Pos	A	C	G	T	Other	Total
1	0	0	0	0	0	0
2	0	0	0	3	0	3
3	0	0	0	4	0	4
4	5	0	0	1	0	6
5	10	0	0	0	0	10
6	12	0	0	0	0	12
7	1	0	13	0	0	14
8	0	0	14	0	0	14
9	0	0	1	16	0	17
10	0	0	0	16	0	16
11	0	0	0	26	0	26
12	107	0	0	11	0	118
13	2	0	0	234	0	236
14	524	0	3	17	0	544
15	3	928	0	0	0	931
16	1	1477	1	2	0	1481
17	9	1	2	2621	0	2633
18	4	2	1	2752	0	2759
19	1	3132	3	5	0	3141
20	0	3276	0	7	0	3283
21	0	3459	0	10	0	3469
22	3618	2	2	16	0	3638
23	3	2	3632	0	0	3637
24	3	4	3576	0	0	3583
25	1	1	2	3961	0	3965
26	4235	0	0	17	0	4252
27	4274	0	1	10	0	4285
28	2	4283	2	0	0	4287
29	5120	4	0	62	0	5186
30	5618	1	0	36	0	5655
31	5774	0	0	22	0	5796
32	3	5797	2	0	0	5802
33	1	5958	1	0	0	5960
34	6155	2	0	11	0	6168
35	6162	0	0	17	0	6179
36	3	6205	0	2	0	6210
37	0	6526	4	2	0	6532
38	6610	1	0	10	0	6621
39	6612	0	0	9	0	6621
40	2	6669	0	11	0	6682
41	4	2	0	6847	0	6853
42	4	0	0	6870	0	6874
43	4	0	0	6842	0	6846
44	1	6822	3	4	0	6830
45	2	7	6712	2	0	6723
46	6421	1	1	11	0	6434
47	6	0	1	6982	0	6989
48	1	6957	3	4	0	6965
49	2	4	1	7079	0	7086
50	2	7071	1	8	0	7082
51	4	4	0	7152	0	7160
52	2	2	1	7238	0	7243
53	0	1	7241	6	0	7248
54	3	1	5	7142	0	7151
55	7265	0	1	16	0	7282
56	10	4	7128	2	0	7144
57	6983	2	6	12	0	7003
58	8	0	1	7319	0	7328
59	1	7312	2	7	0	7322
60	2	6	1	7418	0	7427
61	2	4	7389	7	0	7402
62	11	3	6	7242	0	7262
63	4	1	1	7435	0	7441
64	9	7415	1	10	0	7435
65	8	10	1	7504	0	7523
66	0	7426	2	11	0	7439
67	2	10	0	7550	0	7562
68	7530	4	1	19	0	7554
69	7390	4	3	17	0	7414
70	7471	2	1	12	0	7486
71	13	7496	2	6	0	7517
72	11	16	7323	2	0	7352
73	7216	5	14	20	0	7255
74	7680	2	8	12	0	7702
75	29	7914	3	6	0	7952
76	20	23	2	6591	0	6636
77	12	13	0	6812	0	6837
78	11	6	0	6422	0	6439
79	6436	7	3	99	0	6545
80	6545	4	2	56	0	6607
81	6548	1	0	44	0	6593
82	6695	1	2	26	0	6724
83	106	4	0	6565	0	6675
84	42	6479	2	63	0	6586
85	33	59	1	6715	0	6808
86	16	26	6735	79	0	6856
87	21	10	65	6919	0	7015
88	17	11	7045	100	0	7173
89	26	8	93	7096	0	7223
90	10	4	7253	112	0	7379
91	11	10	7228	48	0	7297
92	4	7558	122	34	0	7718
93	16	103	47	7832	0	7998
94	14	35	8073	115	0	8237
95	26	18	122	7864	0	8030
96	6	8038	48	124	0	8216
97	8092	118	23	67	0	8300
98	111	8325	27	23	0	8486
99	49	135	19	8221	0	8424
100	25	8380	15	116	0	8536
101	8	143	8247	47	0	8445
102	13	50	8150	38	0	8251
103	6	8257	160	36	0	8459
104	25	129	59	8402	0	8615
105	22	56	8455	124	0	8657
106	15	8413	129	57	0	8614
107	8400	131	55	67	0	8653
108	134	58	31	8468	0	8691
109	45	46	8694	124	0	8909
110	35	8685	141	50	0	8911
111	25	147	45	8782	0	8999
112	27	52	31	8808	0	8918
113	8456	43	35	204	0	8738
114	128	29	8400	69	0	8626
115	63	32	134	8206	0	8435
116	29	24	7921	149	0	8123
117	14	7305	162	65	0	7546
118	7107	144	66	51	0	7368
119	112	7132	47	43	0	7334
120	52	141	24	6918	0	7135
121	36	7060	27	130	0	7253
122	6920	149	32	62	0	7163
123	135	6969	20	43	0	7167
124	43	153	6840	34	0	7070
125	32	6837	128	41	0	7038
126	6653	164	50	23	0	6890
127	139	69	6729	27	0	6964
128	60	43	138	6779	0	7020
129	6432	41	59	153	0	6685
130	162	32	42	6232	0	6468
131	6375	34	32	179	0	6620
132	6517	35	31	81	0	6664
133	201	37	24	6466	0	6728
134	100	32	16	6601	0	6749
135	6445	25	30	212	0	6712
136	6500	32	20	91	0	6643
137	218	26	19	6317	0	6580
138	6370	27	15	191	0	6603
139	6457	19	20	84	0	6580
140	210	6319	29	55	0	6613
141	91	139	20	6439	0	6689
142	6460	55	25	199	0	6739
143	6637	34	20	86	0	6777
144	235	30	23	6503	0	6791
145	105	28	21	6643	0	6797
146	6491	18	19	230	0	6758
147	190	6465	26	105	0	6786
148	100	161	22	6488	0	6771
149	73	62	6428	197	0	6760
150	68	53	152	6299	0	6572
151	64	6348	55	193	0	6660
152	63	158	6291	84	0	6596
153	55	65	156	6249	0	6525
154	67	49	61	6174	0	6351
155	57	40	6288	208	0	6593
156	6060	32	156	124	0	6372
157	168	6439	73	89	0	6769
158	6508	152	45	95	0	6800
159	192	84	6406	62	0	6744
160	89	61	6562	56	0	6768
161	6339	43	195	81	0	6658
162	170	6590	85	75	0	6920
163	6540	157	62	67	0	6826
164	189	6666	49	51	0	6955
165	90	194	6653	39	0	6976
166	6591	72	169	63	0	6895
167	169	63	6780	68	0	7080
168	94	39	185	6736	0	7054
169	6770	34	78	174	0	7056
170	6757	46	46	91	0	6940
171	216	6645	38	69	0	6968
172	119	291	50	6451	0	6911
173	73	6600	61	154	0	6888
174	82	160	6450	58	0	6750
175	98	142	155	5826	0	6221
176	52	5756	65	151	0	6024
177	69	141	35	5484	0	5729
178	5220	37	30	127	0	5414
179	112	37	28	5291	0	5468
180	50	5305	24	117	0	5496
181	54	96	22	5367	0	5539
182	47	24	30	5365	0	5466
183	48	5311	20	107	0	5486
184	45	105	18	5402	0	5570
185	31	51	5305	117	0	5504
186	39	5298	88	49	0	5474
187	5025	73	26	58	0	5182
188	66	43	5030	39	0	5178
189	35	28	4864	42	0	4969
190	40	4747	73	34	0	4894
191	80	120	42	4494	0	4736
192	39	18	4341	58	0	4456
193	23	3689	58	34	0	3804
194	27	42	23	3966	0	4058
195	35	20	6	4051	0	4112
196	3942	20	13	62	0	4037
197	39	3925	12	29	0	4005
198	16	45	3752	22	0	3835
199	17	28	3743	19	0	3807
200	23	19	42	3762	0	3846
201	26	17	23	4036	0	4102
202	15	15	19	4122	0	4171
203	17	4710	20	66	0	4813
204	22	93	4851	26	0	4992
205	20	46	84	5211	0	5361
206	11	5427	41	129	0	5608
207	7	5779	26	55	0	5867
208	14	168	6054	49	0	6285
209	22	61	161	5939	0	6183
210	18	45	6587	172	0	6822
211	23	32	218	6495	0	6768
212	35	20	95	6860	0	7010
213	14	18	6719	277	0	7028
214	12	6645	220	115	0	6992
215	6561	195	88	91	0	6935
216	199	80	6717	54	0	7050
217	69	6645	222	34	0	6970
218	35	6948	103	40	0	7126
219	22	273	6626	37	0	6958
220	6498	130	221	47	0	6896
221	237	76	93	6166	0	6572
222	74	6661	80	175	0	6990
223	6671	225	50	92	0	7038
224	230	101	50	6404	0	6785
225	79	6585	46	220	0	6930
226	6626	224	32	111	0	6993
227	217	107	6491	52	0	6867
228	84	6504	219	37	0	6844
229	6298	224	81	57	0	6660
230	208	6323	56	37	0	6624
231	6130	248	32	33	0	6443
232	244	114	35	5869	0	6262
233	90	5873	40	190	0	6193
234	73	212	32	5891	0	6208
235	5810	93	31	247	0	6181
236	197	66	5697	106	0	6066
237	102	52	5837	63	0	6054
238	77	35	262	5619	0	5993
239	57	60	111	5782	0	6010
240	64	43	64	5664	0	5835
241	33	5471	67	291	0	5862
242	38	216	5393	130	0	5777
243	41	100	202	5284	0	5627
244	31	5257	105	216	0	5609
245	44	5528	61	103	0	5736
246	52	238	5405	68	0	5763
247	27	129	5481	52	0	5689
248	38	85	5558	52	0	5733
249	49	61	281	5358	0	5749
250	36	57	5491	216	0	5800
251	54	53	253	5394	0	5754
252	37	54	5457	241	0	5789
253	5133	54	254	122	0	5563
254	204	5468	112	78	0	5862
255	92	5981	70	58	0	6201
256	66	286	6162	49	0	6563
257	5986	120	251	64	0	6421
258	6236	93	119	62	0	6510
259	6256	67	91	58	0	6472
260	330	50	5863	59	0	6302
261	149	50	6060	53	0	6312
262	91	50	308	5872	0	6321
263	5932	53	141	259	0	6385
264	6037	44	107	125	0	6313
265	303	61	5750	100	0	6214
266	5861	65	261	67	0	6254
267	296	57	149	5730	0	6232
268	125	59	5821	265	0	6270
269	86	61	5940	126	0	6213
270	5590	66	345	113	0	6114
271	241	54	5898	86	0	6279
272	5775	46	327	83	0	6231
273	278	47	5890	80	0	6295
274	131	5617	333	82	0	6163
275	103	5938	180	78	0	6299
276	89	288	138	5675	0	6190
277	82	146	128	6000	0	6356
278	86	106	5782	317	0	6291
279	82	73	311	5703	0	6169
280	86	5438	180	296	0	6000
281	82	5689	116	145	0	6032
282	83	5886	126	85	0	6180
283	106	340	107	5640	0	6193
284	98	169	5615	262	0	6144
285	84	145	5723	118	0	6070
286	92	104	342	5512	0	6050
287	100	72	184	5693	0	6049
288	104	71	123	5473	0	5771
289	111	5492	84	315	0	6002
290	5536	250	98	149	0	6033
291	5628	136	81	123	0	5968
292	321	5534	93	88	0	6036
293	172	271	5549	91	0	6083
294	5669	130	266	83	0	6148
295	307	96	5670	72	0	6145
296	5641	77	316	71	0	6105
297	5784	69	164	93	0	6110
298	5829	61	113	89	0	6092
299	5733	67	114	87	0	6001
300	364	5558	90	104	0	6116
301	5285	212	81	113	0	5691
302	279	5308	83	109	0	5779
303	4566	194	68	66	0	4894
304	210	4392	68	59	0	4729
305	88	143	3793	39	0	4063
306	64	375	142	3159	0	3740
307	60	3364	75	131	0	3630
308	43	3131	37	56	0	3267
309	2746	149	113	85	0	3093
310	2451	27	13	22	0	2513
311	71	2489	21	17	0	2598
312	41	41	23	2308	0	2413
313	30	2551	22	36	0	2639
314	2600	47	19	26	0	2692
315	72	20	2600	11	0	2703
316	39	26	52	2480	0	2597
317	35	8	26	2515	0	2584
318	26	10	28	2542	0	2606
319	24	17	2510	62	0	2613
320	22	2496	56	25	0	2599
321	26	2616	24	15	0	2681
322	33	49	19	2653	0	2754
323	19	31	2679	49	0	2778
324	24	20	62	2658	0	2764
325	16	21	26	2710	0	2773
326	21	22	23	2680	0	2746
327	33	23	10	2672	0	2738
328	2623	21	15	71	0	2730
329	56	2650	22	35	0	2763
330	2649	59	21	27	0	2756
331	59	28	2635	27	0	2749
332	23	41	2679	23	0	2766
333	28	19	67	2615	0	2729
334	21	27	28	2654	0	2730
335	19	2673	25	65	0	2782
336	18	54	2704	40	0	2816
337	16	2755	56	34	0	2861
338	15	67	2794	29	0	2905
339	2646	29	59	35	0	2769
340	57	2777	25	29	0	2888
341	30	59	2789	26	0	2904
342	35	29	57	2754	0	2875
343	24	24	2799	64	0	2911
344	20	2812	62	28	0	2922
345	26	51	21	2720	0	2818
346	25	2776	22	60	0	2883
347	32	64	2786	30	0	2912
348	29	25	54	2756	0	2864
349	2766	28	20	57	0	2871
350	60	2740	30	22	0	2852
351	36	65	2681	26	0	2808
352	36	75	55	2583	0	2749
353	26	36	2678	48	0	2788
354	29	22	2448	20	0	2519
355	16	2219	56	24	0	2315
356	17	27	19	1829	0	1892
357	2	4	7	1857	0	1870
358	8	4	3	1832	0	1847
359	2	9	1886	24	0	1921
360	9	7	1849	5	0	1870
361	1733	5	23	7	0	1768
362	19	5	1857	4	0	1885
363	1728	4	24	9	0	1765
364	21	1844	4	9	0	1878
365	1	22	6	1810	0	1839
366	3	1904	5	24	0	1936
367	3	1971	5	7	0	1986
368	4	22	1899	6	0	1931
369	5	5	27	1838	0	1875
370	5	10	1855	22	0	1892
371	1	6	1755	5	0	1767
372	1756	3	22	14	0	1795
373	20	1	1838	7	0	1866
374	3	4	1778	5	0	1790
375	1738	7	17	9	0	1771
376	17	6	1786	7	0	1816
377	1	4	1848	7	0	1860
378	8	0	20	1754	0	1782
379	2	1846	6	18	0	1872
380	3	18	6	1872	0	1899
381	1	3	6	1840	0	1850
382	1904	4	4	24	0	1936
383	14	7	6	1871	0	1898
384	2	1924	8	15	0	1949
385	1911	17	3	6	0	1937
386	15	3	1915	4	0	1937
387	1837	7	17	11	0	1872
388	18	6	1996	6	0	2026
389	10	3	2092	7	0	2112
390	2	2201	31	5	0	2239
391	2253	27	21	4	0	2305
392	27	2328	11	5	0	2371
393	10	29	2365	6	0	2410
394	11	15	28	2168	0	2222
395	0	2388	18	27	0	2433
396	2438	29	8	10	0	2485
397	2431	17	6	7	0	2461
398	37	2421	10	2	0	2470
399	2442	31	9	5	0	2487
400	33	14	13	2364	0	2424
401	12	2399	14	28	0	2453
402	7	32	8	2446	0	2493
403	10	16	8	2558	0	2592
404	2579	11	9	48	0	2647
405	2598	13	5	18	0	2634
406	2608	2	10	16	0	2636
407	47	11	2562	10	0	2630
408	2545	9	33	12	0	2599
409	49	15	19	2590	0	2673
410	18	9	2598	35	0	2660
411	26	3	2482	19	0	2530
412	11	2539	42	17	0	2609
413	2314	34	22	13	0	2383
414	30	2401	5	12	0	2448
415	25	26	5	2378	0	2434
416	15	13	8	2404	0	2440
417	13	5	2430	36	0	2484
418	15	7	34	2323	0	2379
419	9	5	2439	28	0	2481
420	10	5	2355	15	0	2385
421	4	2393	44	14	0	2455
422	6	25	21	2336	0	2388
423	10	17	10	2353	0	2390
424	2344	12	5	37	0	2398
425	30	4	2352	21	0	2407
426	17	10	26	2394	0	2447
427	2440	6	16	40	0	2502
428	27	3	2469	30	0	2529
429	2437	6	29	13	0	2485
430	2493	5	19	12	0	2529
431	38	7	2586	7	0	2638
432	20	5	28	2525	0	2578
433	13	8	14	2581	0	2616
434	13	3	2608	43	0	2667
435	2583	4	32	28	0	2647
436	2664	3	15	9	0	2691
437	2612	2	11	11	0	2636
438	2598	8	8	14	0	2628
439	2597	2	11	12	0	2622
440	46	10	2225	16	0	2297
441	34	11	2547	5	0	2597
442	20	2608	37	9	0	2674
443	12	27	2650	9	0	2698
444	16	16	33	2585	0	2650
445	32	14	27	2029	0	2102
446	20	6	14	2652	0	2692
447	23	6	7	2659	0	2695
448	23	4	2652	42	0	2721
449	20	2604	37	23	0	2684
450	17	2758	23	16	0	2814
451	17	42	10	2724	0	2793
452	10	2821	13	33	0	2877
453	2814	33	16	24	0	2887
454	2834	22	12	23	0	2891
455	51	2917	13	15	0	2996
456	30	31	10	2948	0	3019
457	11	17	12	3004	0	3044
458	13	11	2985	55	0	3064
459	2771	9	34	37	0	2851
460	3038	11	30	19	0	3098
461	54	3096	11	15	0	3176
462	3124	43	12	15	0	3194
463	48	27	3134	15	0	3224
464	28	3080	37	14	0	3159
465	23	3163	25	18	0	3229
466	28	3134	11	17	0	3190
467	20	66	14	3101	0	3201
468	3113	23	13	55	0	3204
469	58	13	22	3206	0	3299
470	43	20	3346	51	0	3460
471	34	20	57	3385	0	3496
472	33	16	3558	64	0	3671
473	23	12	74	3415	0	3524
474	40	11	33	3397	0	3481
475	13	3496	23	90	0	3622
476	3554	63	31	44	0	3692
477	65	31	28	3486	0	3610
478	34	3604	18	72	0	3728
479	3663	60	14	55	0	3792
480	3230	36	20	50	0	3336
481	3732	22	16	39	0	3809
482	86	3644	21	33	0	3784
483	35	63	3679	35	0	3812
484	25	40	68	3673	0	3806
485	35	38	34	3596	0	3703
486	24	3668	21	85	0	3798
487	34	65	3645	31	0	3775
488	26	27	3573	39	0	3665
489	3439	18	72	28	0	3557
490	64	27	29	3455	0	3575
491	22	11	3595	58	0	3686
492	21	3654	50	22	0	3747
493	28	44	27	3512	0	3611
494	15	3669	27	55	0	3766
495	25	57	3637	26	0	3745
496	3494	17	55	28	0	3594
497	3634	19	23	19	0	3695
498	55	3653	19	22	0	3749
499	25	53	13	3665	0	3756
500	22	19	3687	52	0	3780
501	22	3619	59	21	0	3721
502	3606	50	13	25	0	3694
503	53	3489	11	8	0	3561
504	13	3539	11	6	0	3569
505	21	53	9	3489	0	3572
506	10	3522	11	51	0	3594
507	3515	57	15	15	0	3602
508	56	19	5	3500	0	3580
509	15	19	3402	44	0	3480
510	9	18	3237	16	0	3280
511	10	17	44	3270	0	3341
512	8	3322	16	42	0	3388
513	3333	41	11	22	0	3407
514	47	14	6	3245	0	3312
515	11	13	3309	43	0	3376
516	13	10	44	3322	0	3389
517	13	6	10	3343	0	3372
518	3310	11	7	52	0	3380
519	51	3	5	3278	0	3337
520	13	7	3243	60	0	3323
521	13	6	3187	18	0	3224
522	9	6	46	3289	0	3350
523	12	8	15	3340	0	3375
524	15	6	3395	51	0	3467
525	3102	5	50	40	0	3197
526	45	7	3393	14	0	3459
527	11	3405	49	13	0	3478
528	11	43	12	3450	0	3516
529	12	12	3457	52	0	3533
530	13	9	3356	15	0	3393
531	17	9	50	3289	0	3365
532	3331	8	27	49	0	3415
533	41	14	3409	20	0	3484
534	12	3387	51	22	0	3472
535	3418	43	18	18	0	3497
536	44	10	3477	16	0	3547
537	3332	11	48	20	0	3411
538	3506	6	17	19	0	3548
539	48	3564	19	14	0	3645
540	24	46	11	3482	0	3563
541	19	3492	11	41	0	3563
542	14	50	3494	11	0	3569
543	3440	16	44	19	0	3519
544	3554	15	12	17	0	3598
545	52	18	3575	8	0	3653
546	24	12	3561	11	0	3608
547	17	3720	56	9	0	3802
548	3851	43	26	18	0	3938
549	58	15	13	3831	0	3917
550	20	14	17	3683	0	3734
551	14	3748	18	46	0	3826
552	3683	44	14	31	0	3772
553	49	19	3788	9	0	3865
554	22	10	44	3974	0	4050
555	4074	9	15	81	0	4179
556	71	4216	12	22	0	4321
557	21	77	4880	18	0	4996
558	20	23	5014	8	0	5065
559	26	40	121	4807	0	4994
560	10	4969	31	94	0	5104
561	9	96	5074	24	0	5203
562	17	25	112	5008	0	5162
563	5155	18	42	112	0	5327
564	105	11	5296	22	0	5434
565	32	18	106	5341	0	5497
566	15	19	5489	118	0	5641
567	9	10	5618	32	0	5669
568	39	34	137	5495	0	5705
569	30	6	5664	111	0	5811
570	4924	8	136	54	0	5122
571	104	7	5482	29	0	5622
572	5112	3	144	21	0	5280
573	108	5349	45	18	0	5520
574	5527	102	25	45	0	5699
575	114	5645	28	10	0	5797
576	52	106	23	5682	0	5863
577	34	33	21	5864	0	5952
578	30	17	5684	131	0	5862
579	11	24	5707	42	0	5784
580	30	6	138	5797	0	5971
581	6	23	5877	122	0	6028
582	16	5	141	5667	0	5829
583	11	5704	45	133	0	5893
584	20	6003	50	27	0	6100
585	27	137	38	5867	0	6069
586	32	30	26	5993	0	6081
587	13	25	5883	144	0	6065
588	17	26	126	5744	0	5913
589	12	5715	39	135	0	5901
590	12	5791	32	50	0	5885
591	11	5781	23	61	0	5876
592	24	139	32	5496	0	5691
593	12	5555	52	113	0	5732
594	5477	129	32	62	0	5700
595	125	49	33	5473	0	5680
596	22	39	5477	138	0	5676
597	23	34	134	5407	0	5598
598	15	30	5591	151	0	5787
599	20	35	5565	45	0	5665
600	29	20	5600	46	0	5695
601	18	5513	152	53	0	5736
602	17	141	5594	31	0	5783
603	5532	44	138	56	0	5770
604	5691	38	63	36	0	5828
605	5842	30	53	42	0	5967
606	154	23	55	5731	0	5963
607	5720	34	41	152	0	5947
608	140	5528	51	44	0	5763
609	57	5831	40	47	0	5975
610	5850	141	36	44	0	6071
611	138	51	5899	36	0	6124
612	49	32	139	5865	0	6085
613	38	29	5939	140	0	6146
614	22	40	5909	49	0	6020
615	18	5898	151	44	0	6111
616	45	139	63	5552	0	5799
617	26	37	60	6016	0	6139
618	5905	33	32	187	0	6157
619	135	5889	49	57	0	6130
620	44	6098	45	49	0	6236
621	41	164	5970	51	0	6226
622	33	6034	122	48	0	6237
623	5945	155	61	55	0	6216
624	5992	60	50	50	0	6152
625	149	48	6062	38	0	6297
626	33	46	6118	48	0	6245
627	32	37	196	5761	0	6026
628	26	51	80	5808	0	5965
629	44	5834	69	147	0	6094
630	55	145	44	5847	0	6091
631	48	45	66	5902	0	6061
632	43	5850	60	177	0	6130
633	46	135	51	5906	0	6138
634	29	60	60	5811	0	5960
635	25	5728	64	178	0	5995
636	36	141	5708	84	0	5969
637	41	48	164	5794	0	6047
638	5799	54	68	161	0	6082
639	5762	40	66	76	0	5944
640	172	43	5644	54	0	5913
641	5567	66	151	49	0	5833
642	5788	42	61	64	0	5955
643	154	5772	29	81	0	6036
644	67	151	5654	64	0	5936
645	52	50	5680	66	0	5848
646	35	64	186	5787	0	6072
647	5816	49	84	171	0	6120
648	6023	36	51	80	0	6190
649	162	64	50	6486	0	6762
650	7138	47	54	201	0	7440
651	7601	52	45	76	0	7774
652	7439	41	43	102	0	7625
653	250	36	7262	56	0	7604
654	81	28	7325	59	0	7493
655	7138	23	187	71	0	7419
656	175	28	7172	42	0	7417
657	35	6445	126	21	0	6627
658	36	129	61	6303	0	6529
659	20	26	6465	103	0	6614
660	13	20	6352	35	0	6420
661	40	43	128	6093	0	6304
662	16	12	6247	109	0	6384
663	13	20	6099	29	0	6161
664	14	5740	124	17	0	5895
665	8	6045	36	9	0	6098
666	6027	99	24	16	0	6166
667	108	28	17	5966	0	6119
668	6034	12	14	88	0	6148
669	99	11	5981	26	0	6117
670	49	6	87	5907	0	6049
671	19	4	39	6041	0	6103
672	5946	6	14	116	0	6082
673	87	5933	14	40	0	6074
674	47	87	5456	16	0	5606
675	22	31	5620	13	0	5686
676	15	5722	102	17	0	5856
677	14	88	5682	9	0	5793
678	16	5653	92	8	0	5769
679	11	5485	35	12	0	5543
680	19	97	5429	6	0	5551
681	5253	27	87	12	0	5379
682	76	11	31	5551	0	5669
683	35	5648	10	77	0	5770
684	23	70	15	5606	0	5714
685	5628	26	11	71	0	5736
686	5539	5	20	44	0	5608
687	5559	10	16	20	0	5605
688	92	8	5464	16	0	5580
689	49	5	82	5402	0	5538
690	16	5545	38	64	0	5663
691	5698	75	15	38	0	5826
692	90	26	22	5752	0	5890
693	49	12	14	5677	0	5752
694	26	15	12	5885	0	5938
695	19	11	5867	100	0	5997
696	5466	7	88	50	0	5611
697	87	5826	34	22	0	5969
698	42	79	18	5808	0	5947
699	38	32	18	5851	0	5939
700	5821	11	19	112	0	5963
701	98	21	5485	41	0	5645
702	44	13	5855	17	0	5929
703	20	5840	118	21	0	5999
704	23	82	5984	15	0	6104
705	5592	30	110	29	0	5761
706	88	6015	47	18	0	6168
707	37	95	6022	19	0	6173
708	5725	37	98	31	0	5891
709	94	22	6271	25	0	6412
710	43	6264	102	34	0	6443
711	38	86	57	6249	0	6430
712	39	35	25	6359	0	6458
713	22	28	6264	119	0	6433
714	32	20	6170	46	0	6268
715	33	6187	117	27	0	6364
716	6064	91	51	42	0	6248
717	86	6287	48	24	0	6445
718	44	108	30	6300	0	6482
719	27	34	6241	106	0	6408
720	5815	24	108	51	0	5998
721	108	31	51	6090	0	6280
722	39	6009	44	99	0	6191
723	25	6306	45	41	0	6417
724	32	114	36	6285	0	6467
725	25	62	30	6338	0	6455
726	6228	29	31	127	0	6415
727	99	37	20	6293	0	6449
728	52	26	6279	115	0	6472
729	6130	14	113	64	0	6321
730	6394	24	50	37	0	6505
731	122	22	6406	41	0	6591
732	6310	23	117	27	0	6477
733	118	24	38	6568	0	6748
734	60	31	23	6661	0	6775
735	43	22	29	6697	0	6791
736	42	20	24	6544	0	6630
737	16	6570	37	131	0	6754
738	6667	107	26	61	0	6861
739	6861	51	26	54	0	6992
740	141	30	6743	43	0	6957
741	7014	29	104	48	0	7195
742	7481	22	38	41	0	7582
743	7570	24	33	36	0	7663
744	7977	16	42	31	0	8066
745	189	7911	19	41	0	8160
746	85	151	24	7809	0	8069
747	55	51	7868	140	0	8114
748	49	38	7485	51	0	7623
749	6572	109	206	72	0	6959
750	6445	51	84	44	0	6624
751	110	6054	23	15	0	6202
752	6089	78	16	16	0	6199
753	93	6189	8	16	0	6306
754	52	81	13	6126	0	6272
755	6290	30	12	95	0	6427
756	6227	17	11	39	0	6294
757	6297	16	12	23	0	6348
758	112	6200	8	26	0	6346
759	6274	81	8	12	0	6375
760	124	32	9	6275	0	6440
761	6365	25	10	88	0	6488
762	111	12	6182	32	0	6337
763	40	6232	82	28	0	6382
764	6232	80	29	25	0	6366
765	109	28	6220	6	0	6363
766	52	22	88	6252	0	6414
767	40	20	6307	85	0	6452
768	43	13	6222	26	0	6304
769	43	14	102	6183	0	6342
770	29	16	6372	95	0	6512
771	47	12	106	6313	0	6478
772	42	11	36	6390	0	6479
773	6425	14	21	121	0	6581
774	107	6422	29	40	0	6598
775	36	6588	24	35	0	6683
776	42	6737	19	32	0	6830
777	56	129	6605	11	0	6801
778	60	42	103	6535	0	6740
779	31	40	6754	106	0	6931
780	6421	25	122	43	0	6611
781	6649	22	47	38	0	6756
782	133	6641	41	33	0	6848
783	79	102	33	6566	0	6780
784	49	6690	30	106	0	6875
785	6732	116	17	56	0	6921
786	128	41	27	6714	0	6910
787	52	43	6671	121	0	6887
788	43	6564	111	52	0	6770
789	49	112	6679	39	0	6879
790	44	39	123	6605	0	6811
791	34	49	6635	110	0	6828
792	6325	33	129	58	0	6545
793	123	36	6665	43	0	6867
794	61	6668	135	42	0	6906
795	54	105	57	6694	0	6910
796	51	43	42	6855	0	6991
797	6751	39	31	149	0	6970
798	6759	41	31	65	0	6896
799	147	6658	27	63	0	6895
800	57	109	6586	42	0	6794
801	64	45	6449	32	0	6590
802	6393	39	138	47	0	6617
803	132	36	6507	28	0	6703
804	57	35	6405	33	0	6530
805	53	29	6334	28	0	6444
806	50	36	6276	29	0	6391
807	32	6285	169	35	0	6521
808	6301	110	78	44	0	6533
809	135	110	59	6056	0	6360
810	6126	43	40	112	0	6321
811	140	6109	37	54	0	6340
812	6106	121	39	58	0	6324
813	130	6246	42	40	0	6458
814	80	126	46	6203	0	6455
815	59	6420	50	99	0	6628
816	54	141	6301	38	0	6534
817	42	6478	143	28	0	6691
818	46	132	64	7247	0	7489
819	7293	52	82	145	0	7572
820	155	52	52	7316	0	7575
821	79	48	7283	153	0	7563
822	83	40	143	7094	0	7360
823	43	7299	74	158	0	7574
824	55	142	7316	72	0	7585
825	7263	68	145	71	0	7547
826	170	52	70	7503	0	7795
827	7367	53	62	176	0	7658
828	7447	49	57	89	0	7642
829	159	7543	61	65	0	7828
830	7273	134	57	79	0	7543
831	7442	76	52	57	0	7627
832	187	7382	53	56	0	7678
833	96	130	54	7323	0	7603
834	93	70	51	7302	0	7516
835	47	7318	50	167	0	7582
836	58	125	35	7504	0	7722
837	46	72	7402	157	0	7677
838	69	103	124	7309	0	7605
839	60	50	7237	157	0	7504
840	54	47	6828	79	0	7008
841	37	6739	143	71	0	6990
842	41	6575	89	54	0	6759
843	42	6689	63	40	0	6834
844	75	129	58	6119	0	6381
845	28	59	6156	88	0	6331
846	5922	43	85	61	0	6111
847	83	31	48	6145	0	6307
848	45	29	6111	91	0	6276
849	30	30	6014	50	0	6124
850	23	6139	100	41	0	6303
851	43	84	58	6089	0	6274
852	5978	47	36	102	0	6163
853	74	5819	30	55	0	5978
854	38	5817	31	32	0	5918
855	29	5795	28	23	0	5875
856	19	117	25	5758	0	5919
857	15	5921	29	85	0	6050
858	31	101	23	6257	0	6412
859	24	55	25	6499	0	6603
860	34	37	6370	137	0	6578
861	5790	26	96	91	0	6003
862	100	24	6507	40	0	6671
863	52	38	115	6473	0	6678
864	38	22	6593	113	0	6766
865	14	6517	119	63	0	6713
866	6440	99	58	65	0	6662
867	116	52	41	6285	0	6494
868	65	25	25	6481	0	6596
869	6408	23	30	144	0	6605
870	6308	18	22	86	0	6434
871	6520	19	26	52	0	6617
872	154	32	6444	28	0	6658
873	6196	20	95	41	0	6352
874	112	6305	51	30	0	6498
875	60	6401	31	27	0	6519
876	54	121	24	6214	0	6413
877	38	60	15	6143	0	6256
878	32	6140	21	125	0	6318
879	40	108	20	6158	0	6326
880	6124	48	17	124	0	6313
881	105	42	6167	64	0	6378
882	48	6141	95	34	0	6318
883	5907	108	44	55	0	6114
884	86	6081	30	36	0	6233
885	52	115	6021	26	0	6214
886	42	62	92	5959	0	6155
887	19	42	6090	106	0	6257
888	22	6017	105	51	0	6195
889	26	99	47	6026	0	6198
890	28	51	5981	97	0	6157
891	22	42	5946	52	0	6062
892	24	28	132	6039	0	6223
893	5920	22	68	111	0	6121
894	6009	25	35	60	0	6129
895	6052	34	24	46	0	6156
896	134	26	6101	31	0	6292
897	66	6116	94	30	0	6306
898	41	90	54	6118	0	6303
899	32	44	33	6108	0	6217
900	34	6134	28	120	0	6316
901	6109	97	30	72	0	6308
902	112	51	21	6187	0	6371
903	62	40	6213	98	0	6413
904	30	6208	96	62	0	6396
905	6079	102	60	54	0	6295
906	89	6174	33	45	0	6341
907	52	118	26	6100	0	6296
908	39	60	28	6152	0	6279
909	29	35	28	6201	0	6293
910	29	30	6097	148	0	6304
911	33	36	107	5943	0	6119
912	32	5855	59	131	0	6077
913	27	5921	51	69	0	6068
914	37	115	5807	52	0	6011
915	5481	55	98	58	0	5692
916	5830	47	47	56	0	5980
917	120	5727	45	41	0	5933
918	4975	70	26	40	0	5111
919	4954	42	18	38	0	5052
920	96	5141	21	25	0	5283
921	58	76	24	5193	0	5351
922	34	36	5400	92	0	5562
923	33	34	5176	42	0	5285
924	5308	29	110	48	0	5495
925	103	5433	36	41	0	5613
926	56	97	26	5476	0	5655
927	35	48	21	5564	0	5668
928	28	20	27	5545	0	5620
929	5384	29	23	137	0	5573
930	108	26	27	5454	0	5615
931	69	27	21	5505	0	5622
932	41	26	5318	116	0	5501
933	4954	23	90	74	0	5141
934	86	5247	34	52	0	5419
935	5204	85	26	43	0	5358
936	95	5090	27	24	0	5236
937	44	86	22	5180	0	5332
938	5175	42	31	106	0	5354
939	5226	25	24	65	0	5340
940	120	19	5053	40	0	5232
941	5172	26	83	44	0	5325
942	104	31	5205	24	0	5364
943	52	24	5053	40	0	5169
944	36	20	5082	29	0	5167
945	33	26	5550	24	0	5633
946	46	33	130	5653	0	5862
947	26	20	5818	118	0	5982
948	39	28	130	5733	0	5930
949	5785	22	60	147	0	6014
950	127	24	45	5776	0	5972
951	5689	27	42	143	0	5901
952	131	5766	22	76	0	5995
953	68	105	36	5833	0	6042
954	60	55	5797	127	0	6039
955	40	5961	105	64	0	6170
956	53	120	55	5893	0	6121
957	39	50	5906	114	0	6109
958	20	5835	107	58	0	6020
959	14	5857	44	43	0	5958
960	24	127	5709	23	0	5883
961	37	75	101	5489	0	5702
962	11	22	5543	100	0	5676
963	5239	10	104	55	0	5408
964	5450	13	42	43	0	5548
965	120	5391	26	18	0	5555
966	5463	88	17	26	0	5594
967	109	40	10	5466	0	5625
968	50	28	5362	83	0	5523
969	5128	10	86	57	0	5281
970	96	14	5313	27	0	5450
971	42	5260	99	26	0	5427
972	5379	86	57	18	0	5540
973	106	49	29	5352	0	5536
974	54	30	5358	87	0	5529
975	5267	15	97	53	0	5432
976	5293	9	57	37	0	5396
977	5378	21	27	22	0	5448
978	159	11	12	5264	0	5446
979	85	7	14	5393	0	5499
980	37	13	5255	130	0	5435
981	30	5217	106	65	0	5418
982	47	84	45	5185	0	5361
983	32	44	34	5354	0	5464
984	21	28	5262	136	0	5447
985	26	21	5246	64	0	5357
986	21	10	140	5220	0	5391
987	5141	14	76	120	0	5351
988	106	5182	37	66	0	5391
989	5202	95	22	43	0	5362
990	117	5192	25	28	0	5362
991	61	109	5150	25	0	5345
992	44	52	5201	35	0	5332
993	5085	31	144	31	0	5291
994	5733	26	69	37	0	5865
995	167	5718	44	39	0	5968
996	87	136	5559	30	0	5812
997	64	60	143	5544	0	5811
998	44	41	79	5466	0	5630
999	40	5573	47	179	0	5839
1000	48	133	33	5628	0	5842
1001	22	76	5608	172	0	5878
1002	5440	34	144	92	0	5710
1003	5590	29	79	65	0	5763
1004	5526	27	46	46	0	5645
1005	5735	35	32	34	0	5836
1006	240	20	5516	29	0	5805
1007	5559	22	158	25	0	5764
1008	192	20	5556	26	0	5794
1009	105	5484	176	23	0	5788
1010	80	125	97	5556	0	5858
1011	5609	65	64	150	0	5888
1012	171	41	38	5920	0	6170
1013	104	30	5934	188	0	6256
1014	5919	31	172	93	0	6215
1015	6089	26	85	71	0	6271
1016	260	14	52	5962	0	6288
1017	132	24	46	6111	0	6313
1018	81	20	5875	249	0	6225
1019	62	5935	182	118	0	6297
1020	5752	172	76	70	0	6070
1021	197	81	5512	45	0	5835
1022	5384	42	164	42	0	5632
1023	215	5395	79	35	0	5724
1024	5340	162	69	43	0	5614
1025	203	5183	50	34	0	5470
1026	120	5255	53	35	0	5463
1027	92	218	44	5188	0	5542
1028	88	92	29	5328	0	5537
1029	68	59	29	5368	0	5524
1030	66	31	25	5391	0	5513
1031	44	40	5136	258	0	5478
1032	5106	32	175	126	0	5439
1033	5310	20	86	94	0	5510
1034	5426	31	63	65	0	5585
1035	260	26	48	5220	0	5554
1036	139	28	41	5347	0	5555
1037	5235	24	44	237	0	5540
1038	5303	30	36	122	0	5491
1039	5380	31	36	75	0	5522
1040	289	31	33	5111	0	5464
1041	143	45	34	5157	0	5379
1042	101	27	4921	216	0	5265
1043	69	33	4871	118	0	5091
1044	74	4824	201	71	0	5170
1045	4246	187	139	84	0	4656
1046	4231	69	54	62	0	4416
1047	4206	32	32	60	0	4330
1048	196	26	4132	44	0	4398
1049	4135	28	118	58	0	4339
1050	4237	15	53	56	0	4361
1051	4272	18	36	54	0	4380
1052	195	20	32	4068	0	4315
1053	119	14	28	4083	0	4244
1054	96	12	22	4083	0	4213
1055	73	13	3528	187	0	3801
1056	3607	14	106	98	0	3825
1057	165	3645	58	45	0	3913
1058	3286	99	23	35	0	3443
1059	145	3210	19	36	0	3410
1060	71	3301	24	33	0	3429
1061	67	128	33	3223	0	3451
1062	58	55	25	3234	0	3372
1063	39	3185	23	112	0	3359
1064	3162	113	12	47	0	3334
1065	3218	49	13	41	0	3321
1066	138	22	18	3144	0	3322
1067	69	13	3088	125	0	3295
1068	53	16	3090	51	0	3210
1069	56	15	3184	32	0	3287
1070	57	12	3124	28	0	3221
1071	2959	26	154	41	0	3180
1072	2999	9	55	30	0	3093
1073	134	14	32	2895	0	3075
1074	64	9	2860	107	0	3040
1075	55	20	97	2921	0	3093
1076	59	2915	32	94	0	3100
1077	45	3271	22	46	0	3384
1078	3237	109	16	50	0	3412
1079	3279	49	15	46	0	3389
1080	3327	37	11	38	0	3413
1081	124	29	18	3231	0	3402
1082	66	29	17	3282	0	3394
1083	49	26	16	3307	0	3398
1084	62	17	11	3270	0	3360
1085	49	15	3198	130	0	3392
1086	49	7	83	3233	0	3372
1087	3342	8	52	127	0	3529
1088	119	6	37	3426	0	3588
1089	70	12	29	3536	0	3647
1090	55	16	25	3513	0	3609
1091	46	3336	27	141	0	3550
1092	43	3357	20	77	0	3497
1093	37	3395	12	56	0	3500
1094	33	65	16	2848	0	2962
1095	22	26	10	2878	0	2936
1096	2878	13	6	80	0	2977
1097	2875	12	7	41	0	2935
1098	2926	11	11	31	0	2979
1099	84	8	10	2902	0	3004
1100	36	8	7	2902	0	2953
1101	31	2841	6	75	0	2953
1102	29	2993	4	33	0	3059
1103	2986	54	4	24	0	3068
1104	73	22	2	2937	0	3034
1105	2940	12	6	66	0	3024
1106	3145	7	7	47	0	3206
1107	70	6	8	3108	0	3192
1108	37	3240	11	62	0	3350
1109	3339	49	5	30	0	3423
1110	3511	21	9	46	0	3587
1111	70	17	3631	27	0	3745
1112	3356	15	31	19	0	3421
1113	46	3373	12	8	0	3439
1114	25	20	15	3446	0	3506
1115	3751	9	3	45	0	3808
1116	45	12	3	3721	0	3781
1117	29	11	1	3736	0	3777
1118	18	3753	2	44	0	3817
1119	3790	38	1	25	0	3854
1120	3783	13	1	22	0	3819
1121	47	3769	4	13	0	3833
1122	21	3918	6	5	0	3950
1123	3960	36	0	15	0	4011
1124	3952	23	1	10	0	3986
1125	40	17	3842	10	0	3909
1126	31	8	3542	8	0	3589
1127	21	10	3887	7	0	3925
1128	18	8	38	4005	0	4069
1129	13	6	19	4069	0	4107
1130	21	10	4031	35	0	4097
1131	4026	7	29	30	0	4092
1132	4321	10	10	19	0	4360
1133	4370	7	13	12	0	4402
1134	4357	4	8	25	0	4394
1135	56	7	4808	5	0	4876
1136	4854	3	35	20	0	4912
1137	4981	2	15	21	0	5019
1138	4935	1	14	30	0	4980
1139	5030	4	8	19	0	5061
1140	5038	4	4	21	0	5067
1141	55	6	5092	8	0	5161
1142	39	5045	25	8	0	5117
1143	43	29	6	5019	0	5097
1144	19	15	11	5232	0	5277
1145	22	9	5190	34	0	5255
1146	4860	5	27	29	0	4921
1147	44	3	11	5175	0	5233
1148	30	8	5292	29	0	5359
1149	36	10	4950	15	0	5011
1150	21	5413	40	19	0	5493
1151	16	30	21	5549	0	5616
1152	12	14	23	5615	0	5664
1153	13	17	6	5597	0	5633
1154	5647	8	6	67	0	5728
1155	37	8	8	5635	0	5688
1156	22	6	5559	41	0	5628
1157	27	11	4992	25	0	5055
1158	17	5	5691	24	0	5737
1159	23	5	49	5851	0	5928
1160	6012	8	23	48	0	6091
1161	37	12	5998	18	0	6065
1162	5926	4	35	34	0	5999
1163	6848	1	19	56	0	6924
1164	50	7	16	7045	0	7118
1165	36	8	10	7052	0	7106
1166	25	6987	10	43	0	7065
1167	17	27	6986	29	0	7059
1168	6848	12	40	38	0	6938
1169	46	13	21	7242	0	7322
1170	23	7215	20	39	0	7297
1171	33	31	10	7323	0	7397
1172	26	21	7327	40	0	7414
1173	27	19	38	7183	0	7267
1174	19	7223	24	43	0	7309
1175	21	28	14	7303	0	7366
1176	7318	16	11	70	0	7415
1177	49	13	11	7201	0	7274
1178	26	7081	20	45	0	7172
1179	25	7234	11	36	0	7306
1180	7166	41	8	40	0	7255
1181	37	29	7391	12	0	7469
1182	35	15	42	7338	0	7430
1183	24	9	18	7690	0	7741
1184	18	6	7694	64	0	7782
1185	15	7662	42	38	0	7757
1186	20	40	7707	27	0	7794
1187	25	35	46	7580	0	7686
1188	11	7950	26	39	0	8026
1189	8141	40	13	40	0	8234
1190	46	8084	12	16	0	8158
1191	14	8277	9	14	0	8314
1192	8437	42	13	50	0	8542
1193	8567	24	8	45	0	8644
1194	8665	13	8	33	0	8719
1195	59	7	11	8721	0	8798
1196	19	7	8620	40	0	8686
1197	8519	7	38	34	0	8598
1198	9114	8	13	38	0	9173
1199	70	12	11	9393	0	9486
1200	26	23	9464	49	0	9562
1201	16	9431	62	15	0	9524
1202	9486	58	10	37	0	9591
1203	9828	11	8	50	0	9897
1204	69	9897	7	14	0	9987
1205	18	10120	18	9	0	10165
1206	10057	69	10	39	0	10175
1207	10039	21	8	24	0	10092
1208	9938	9	4	31	0	9982
1209	93	10	9	9896	0	10008
1210	23	18	9904	64	0	10009
1211	32	8	60	9536	0	9636
1212	21	8	9679	71	0	9779
1213	14	9432	69	25	0	9540
1214	12	9598	20	23	0	9653
1215	27	66	14	9219	0	9326
1216	27	16	8	9473	0	9524
1217	30	11	7	9277	0	9325
1218	18	9491	7	64	0	9580
1219	9417	57	18	56	0	9548
1220	9350	18	12	42	0	9422
1221	68	9571	15	17	0	9671
1222	46	66	9	9430	0	9551
1223	24	9519	7	49	0	9599
1224	29	76	3	9511	0	9619
1225	26	9543	8	67	0	9644
1226	9581	63	4	53	0	9701
1227	72	22	10	9459	0	9563
1228	37	28	9403	65	0	9533
1229	9218	11	56	49	0	9334
1230	9451	19	19	46	0	9535
1231	69	20	9370	23	0	9482
1232	39	14	56	9322	0	9431
1233	17	26	9417	68	0	9528
1234	22	28	56	9378	0	9484
1235	15	25	8889	78	0	9007
1236	8441	20	56	58	0	8575
1237	67	18	19	8789	0	8893
1238	28	8724	15	63	0	8830
1239	8932	67	10	60	0	9069
1240	79	36	8	9016	0	9139
1241	54	26	9	8965	0	9054
1242	32	27	8897	85	0	9041
1243	37	24	60	9021	0	9142
1244	26	23	9272	94	0	9415
1245	36	25	9258	38	0	9357
1246	48	15	100	9662	0	9825
1247	34	21	10094	100	0	10249
1248	10030	12	116	69	0	10227
1249	12132	14	45	61	0	12252
1250	13676	17	29	78	0	13800
1251	337	14512	31	44	0	14924
1252	200	273	25	14898	0	15396
1253	108	129	24	14563	0	14824
1254	42	15192	40	371	0	15645
1255	15162	307	27	189	0	15685
1256	356	144	15	15169	0	15684
1257	156	69	15354	349	0	15928
1258	90	73	14726	172	0	15061
1259	58	14862	403	107	0	15430
1260	14991	307	175	113	0	15586
1261	335	152	14851	72	0	15410
1262	14268	78	344	95	0	14785
1263	366	13826	175	85	0	14452
1264	184	322	14074	55	0	14635
1265	106	152	13570	74	0	13902
1266	83	86	14289	68	0	14526
1267	87	13916	460	61	0	14524
1268	85	350	14083	36	0	14554
1269	13754	136	392	71	0	14353
1270	376	85	218	13321	0	14000
1271	194	70	132	14239	0	14635
1272	129	65	101	14387	0	14682
1273	117	61	82	14459	0	14719
1274	102	71	14121	492	0	14786
1275	113	53	351	14109	0	14626
1276	106	44	166	14387	0	14703
1277	13918	80	121	525	0	14644
1278	14198	41	117	276	0	14632
1279	13408	58	111	225	0	13802
1280	485	68	13530	136	0	14219
1281	228	13786	344	110	0	14468
1282	131	14558	185	114	0	14988
1283	13522	442	104	165	0	14233
1284	370	14169	103	108	0	14750
1285	226	399	98	14031	0	14754
1286	164	201	84	14422	0	14871
1287	93	123	14011	501	0	14728
1288	87	13713	410	245	0	14455
1289	90	388	13446	159	0	14083
1290	13176	170	404	176	0	13926
1291	13833	104	220	131	0	14288
1292	531	84	125	13539	0	14279
1293	253	88	119	13511	0	13971
1294	152	69	147	13582	0	13950
1295	132	93	89	13696	0	14010
1296	106	89	13249	594	0	14038
1297	131	71	386	13182	0	13770
1298	97	61	13108	495	0	13761
1299	77	47	12587	302	0	13013
1300	61	12592	479	209	0	13341
1301	12506	326	264	187	0	13283
1302	350	12985	111	150	0	13596
1303	208	375	136	12566	0	13285
1304	131	183	13122	406	0	13842
1305	12775	100	382	252	0	13509
1306	397	84	13047	166	0	13694
1307	13019	100	432	150	0	13701
1308	13303	65	206	161	0	13735
1309	557	71	140	13264	0	14032
1310	284	58	136	13323	0	13801
1311	177	77	113	13545	0	13912
1312	161	82	12991	576	0	13810
1313	12742	95	441	296	0	13574
1314	429	12850	212	208	0	13699
1315	264	390	115	13023	0	13792
1316	12949	207	108	513	0	13777
1317	13267	121	115	307	0	13810
1318	13405	89	120	222	0	13836
1319	685	96	12704	160	0	13645
1320	13067	101	436	185	0	13789
1321	13172	174	207	193	0	13746
1322	638	100	11455	267	0	12460
1323	324	93	13120	241	0	13778
1324	255	118	565	12925	0	13863
1325	227	87	13160	496	0	13970
1326	152	12383	604	318	0	13457
1327	160	13142	387	152	0	13841
1328	12604	539	276	136	0	13555
1329	491	13089	192	139	0	13911
1330	372	482	205	12972	0	14031
1331	12492	242	215	487	0	13436
1332	533	12938	167	268	0	13906
1333	274	504	167	12912	0	13857
1334	201	233	209	13274	0	13917
1335	163	134	12817	667	0	13781
1336	162	108	552	12914	0	13736
1337	142	150	12825	594	0	13711
1338	153	82	12932	398	0	13565
1339	236	81	571	12640	0	13528
1340	197	98	252	13009	0	13556
1341	12521	83	153	758	0	13515
1342	481	13159	171	422	0	14233
1343	306	459	131	13193	0	14089
1344	233	349	156	13335	0	14073
1345	12732	132	89	758	0	13711
1346	551	12283	98	390	0	13322
1347	321	12055	85	261	0	12722
1348	189	11367	105	216	0	11877
1349	103	9786	87	125	0	10101
1350	7183	259	320	81	0	7843
1351	6822	69	133	53	0	7077
1352	6440	39	32	55	0	6566
1353	6442	27	26	49	0	6544
1354	236	35	26	6237	0	6534
1355	78	36	6167	188	0	6469
1356	57	6122	176	59	0	6414
1357	58	175	46	6063	0	6342
1358	41	46	6065	199	0	6351
1359	59	47	168	5981	0	6255
1360	43	30	51	6116	0	6240
1361	30	34	5991	220	0	6275
1362	42	30	174	5995	0	6241
1363	70	35	65	5687	0	5857
1364	5969	25	37	223	0	6254
1365	5949	31	28	88	0	6096
1366	5927	24	34	67	0	6052
1367	5918	26	24	61	0	6029
1368	240	26	29	5715	0	6010
1369	100	30	26	5833	0	5989
1370	75	33	24	5817	0	5949
1371	5621	24	27	266	0	5938
1372	218	33	31	5641	0	5923
1373	91	29	32	5784	0	5936
1374	68	39	5460	241	0	5808
1375	67	48	175	5415	0	5705
1376	65	5265	59	216	0	5605
1377	60	5596	33	97	0	5786
1378	5390	196	21	77	0	5684
1379	216	60	5311	60	0	5647
1380	84	5064	164	48	0	5360
1381	4889	157	96	64	0	5206
1382	176	48	38	4892	0	5154
1383	66	42	4867	178	0	5153
1384	68	35	156	4799	0	5058
1385	42	4906	50	187	0	5185
1386	4835	146	44	87	0	5112
1387	159	4927	26	69	0	5181
1388	4943	162	25	67	0	5197
1389	5082	54	25	62	0	5223
1390	212	50	26	4962	0	5250
1391	93	34	20	4934	0	5081
1392	65	4888	19	202	0	5174
1393	4931	158	24	97	0	5210
1394	182	61	4858	74	0	5175
1395	4792	38	149	68	0	5047
1396	4861	34	42	58	0	4995
1397	198	38	4649	55	0	4940
1398	83	49	148	4487	0	4767
1399	4530	33	54	190	0	4807
1400	177	25	4489	81	0	4772
1401	61	26	4323	78	0	4488
1402	3969	19	177	50	0	4215
1403	152	3914	64	45	0	4175
1404	50	3494	38	45	0	3627
1405	77	146	47	3361	0	3631
1406	44	50	3372	124	0	3590
1407	3240	34	125	52	0	3451
1408	137	20	3268	49	0	3474
1409	53	3068	117	33	0	3271
1410	3031	119	63	29	0	3242
1411	125	36	24	3027	0	3212
1412	3034	27	19	124	0	3204
1413	142	18	2978	45	0	3183
1414	54	31	102	2909	0	3096
1415	46	2970	34	110	0	3160
1416	34	108	23	2966	0	3131
1417	34	43	19	3049	0	3145
1418	42	25	2964	140	0	3171
1419	46	2851	113	57	0	3067
1420	46	2950	45	35	0	3076
1421	39	104	2840	33	0	3016
1422	2657	30	109	35	0	2831
1423	2753	23	34	40	0	2850
1424	127	19	30	2657	0	2833
1425	2528	13	23	108	0	2672
1426	102	2450	31	27	0	2610
1427	38	2572	11	39	0	2660
1428	2546	96	28	37	0	2707
1429	110	44	13	2520	0	2687
1430	2568	22	14	102	0	2706
1431	2653	8	21	44	0	2726
1432	118	18	12	2532	0	2680
1433	53	23	2501	93	0	2670
1434	2514	15	83	40	0	2652
1435	2600	15	27	25	0	2667
1436	121	11	22	2516	0	2670
1437	45	2496	16	98	0	2655
1438	39	91	16	2503	0	2649
1439	26	20	2464	114	0	2624
1440	27	18	2470	41	0	2556
1441	22	2410	101	43	0	2576
1442	43	74	31	1581	0	1729
1443	13	5	18	1571	0	1607
1444	19	9	1535	45	0	1608
1445	1470	14	42	12	0	1538
1446	1550	6	10	22	0	1588
1447	1542	4	15	12	0	1573
1448	1563	5	9	13	0	1590
1449	58	1489	5	5	0	1557
1450	21	1566	5	12	0	1604
1451	1614	45	5	16	0	1680
1452	52	17	9	1627	0	1705
1453	21	12	4	1706	0	1743
1454	21	1691	7	54	0	1773
1455	16	49	6	1705	0	1776
1456	16	14	7	1696	0	1733
1457	18	1675	4	61	0	1758
1458	15	51	1666	28	0	1760
1459	10	12	55	1691	0	1768
1460	1687	21	6	63	0	1777
1461	1677	8	13	21	0	1719
1462	56	9	1600	20	0	1685
1463	25	11	1603	12	0	1651
1464	22	11	1623	13	0	1669
1465	14	10	62	1563	0	1649
1466	17	2	1605	55	0	1679
1467	11	11	1622	16	0	1660
1468	15	19	60	1574	0	1668
1469	8	1619	26	56	0	1709
1470	18	45	1619	13	0	1695
1471	12	1609	58	14	0	1693
1472	1573	67	15	19	0	1674
1473	55	1589	16	9	0	1669
1474	10	50	15	1572	0	1647
1475	1584	14	11	54	0	1663
1476	57	17	9	1554	0	1637
1477	11	9	11	1612	0	1643
1478	18	6	1570	61	0	1655
1479	12	1524	44	23	0	1603
1480	12	1586	13	19	0	1630
1481	11	55	14	1499	0	1579
1482	13	17	9	1507	0	1546
1483	17	16	7	1456	0	1496
1484	10	6	1410	60	0	1486
1485	4	10	1381	24	0	1419
1486	1283	7	49	22	0	1361
1487	46	4	1325	16	0	1391
1488	8	3	1310	14	0	1335
1489	5	1249	39	11	0	1304
1490	9	34	24	1220	0	1287
1491	7	10	1255	24	0	1296
1492	7	7	30	1192	0	1236
1493	4	8	1296	30	0	1338
1494	6	3	33	1323	0	1365
1495	5	5	1400	35	0	1445
1496	8	2	34	1372	0	1416
1497	6	3	15	1401	0	1425
1498	10	1396	14	34	0	1454
1499	6	25	7	1435	0	1473
1500	5	1442	11	28	0	1486
1501	5	31	3	1478	0	1517
1502	2	15	5	1492	0	1514
1503	1440	7	10	39	0	1496
1504	24	6	5	1460	0	1495
1505	12	8	1431	35	0	1486
1506	5	8	27	1435	0	1475
1507	7	3	12	1459	0	1481
1508	7	4	1424	40	0	1475
1509	6	5	1389	20	0	1420
1510	8	6	33	1404	0	1451
1511	7	2	12	1455	0	1476
1512	4	3	1433	38	0	1478
1513	4	1371	30	21	0	1426
1514	4	1422	15	12	0	1453
1515	1426	33	13	14	0	1486
1516	34	11	10	1497	0	1552
1517	1559	9	11	38	0	1617
1518	1543	3	7	23	0	1576
1519	30	1577	6	12	0	1625
1520	1592	24	6	17	0	1639
1521	1609	11	10	13	0	1643
1522	36	5	1587	12	0	1640
1523	13	7	34	1582	0	1636
1524	13	3	1625	35	0	1676
1525	12	15	32	1629	0	1688
1526	5	5	1623	36	0	1669
1527	7	1527	36	13	0	1583
1528	2	1595	12	14	0	1623
1529	12	33	11	1553	0	1609
1530	1537	11	8	32	0	1588
1531	25	3	6	1535	0	1569
1532	10	2	6	1530	0	1548
1533	8	2	1547	35	0	1592
1534	1	7	1550	12	0	1570
1535	3	4	1561	14	0	1582
1536	5	3	33	1534	0	1575
1537	5	3	12	1523	0	1543
1538	2	1526	12	33	0	1573
1539	2	1592	11	13	0	1618
1540	1589	29	5	20	0	1643
1541	24	1615	7	9	0	1655
1542	10	32	1614	8	0	1664
1543	9	13	22	1605	0	1649
1544	5	5	1692	33	0	1735
1545	8	1702	28	12	0	1750
1546	7	31	9	1729	0	1776
1547	1671	9	22	29	0	1731
1548	17	4	1714	12	0	1747
1549	9	1714	26	15	0	1764
1550	3	19	1706	10	0	1738
1551	1	1682	25	12	0	1720
1552	17	39	24	1554	0	1634
1553	1582	15	2	19	0	1618
1554	1576	4	4	10	0	1594
1555	17	1570	4	5	0	1596
1556	1606	14	3	13	0	1636
1557	13	6	6	1606	0	1631
1558	1600	4	3	22	0	1629
1559	16	8	1639	7	0	1670
1560	12	6	1616	7	0	1641
1561	10	3	20	1588	0	1621
1562	8	3	6	1687	0	1704
1563	2	3	1688	21	0	1714
1564	9	5	15	1655	0	1684
1565	1679	3	15	17	0	1714
1566	1680	7	1	26	0	1714
1567	19	1638	5	8	0	1670
1568	9	1640	5	10	0	1664
1569	1637	17	4	6	0	1664
1570	17	10	2	1623	0	1652
1571	1620	3	0	21	0	1644
1572	12	1614	5	14	0	1645
1573	1625	12	7	6	0	1650
1574	12	6	1595	6	0	1619
1575	6	5	1581	8	0	1600
1576	9	4	16	1616	0	1645
1577	4	7	1643	18	0	1672
1578	5	7	17	1596	0	1625
1579	11	2	6	1544	0	1563
1580	6	5	1709	20	0	1740
1581	11	2	18	1708	0	1739
1582	13	5	7	1849	0	1874
1583	3	7	1932	21	0	1963
1584	12	6	1911	12	0	1941
1585	1938	2	26	14	0	1980
1586	25	3	1994	5	0	2027
1587	2124	8	22	11	0	2165
1588	2341	4	20	7	0	2372
1589	40	3	2436	7	0	2486
1590	18	4	2520	5	0	2547
1591	16	6	48	2442	0	2512
1592	13	3	27	2374	0	2417
1593	8	2372	13	45	0	2438
1594	9	2410	10	23	0	2452
1595	9	44	2363	12	0	2428
1596	2318	19	36	24	0	2397
1597	2383	10	19	18	0	2430
1598	48	16	2342	6	0	2412
1599	27	11	2334	7	0	2379
1600	23	5	52	2285	0	2365
1601	12	2341	28	30	0	2411
1602	19	33	9	2389	0	2450
1603	13	14	15	2430	0	2472
1604	2413	7	15	55	0	2490
1605	2423	6	14	29	0	2472
1606	49	4	10	2462	0	2525
1607	23	5	2468	48	0	2544
1608	2380	7	38	34	0	2459
1609	39	2495	24	16	0	2574
1610	2514	33	19	15	0	2581
1611	2480	11	7	18	0	2516
1612	57	2472	9	11	0	2549
1613	29	2531	15	6	0	2581
1614	23	47	9	2506	0	2585
1615	19	24	11	2495	0	2549
1616	18	2448	5	47	0	2518
1617	13	42	6	2414	0	2475
1618	19	23	10	2433	0	2485
1619	15	14	2353	52	0	2434
1620	2343	8	40	39	0	2430
1621	2413	9	24	27	0	2473
1622	2411	8	18	25	0	2462
1623	65	4	14	2378	0	2461
1624	2370	6	11	42	0	2429
1625	51	2309	17	21	0	2398
1626	32	38	9	2236	0	2315
1627	25	2261	12	42	0	2340
1628	22	2344	12	22	0	2400
1629	2327	42	10	27	0	2406
1630	2340	20	15	11	0	2386
1631	2307	16	9	17	0	2349
1632	2300	14	4	16	0	2334
1633	2292	15	10	11	0	2328
1634	66	10	2285	11	0	2372
1635	2330	5	35	14	0	2384
1636	58	7	2369	8	0	2442
1637	2310	10	43	11	0	2374
1638	2354	6	22	20	0	2402
1639	2333	8	24	12	0	2377
1640	58	9	2380	12	0	2459
1641	47	14	35	2311	0	2407
1642	25	2423	26	33	0	2507
1643	2457	35	16	20	0	2528
1644	2461	17	14	19	0	2511
1645	62	2431	15	14	0	2522
1646	2492	40	13	14	0	2559
1647	63	24	15	2435	0	2537
1648	29	2480	14	41	0	2564
1649	2505	42	11	30	0	2588
1650	2516	22	6	24	0	2568
1651	65	19	11	2478	0	2573
1652	2514	13	10	45	0	2582
1653	59	19	15	2515	0	2608
1654	40	10	17	2539	0	2606
1655	38	10	2527	60	0	2635
1656	29	15	39	2495	0	2578
1657	27	14	24	2545	0	2610
1658	27	12	2515	58	0	2612
1659	18	12	2460	39	0	2529
1660	34	6	54	2513	0	2607
1661	29	6	2541	46	0	2622
1662	2413	8	46	38	0	2505
1663	54	2538	28	24	0	2644
1664	27	35	18	2566	0	2646
1665	19	20	13	2599	0	2651
1666	29	13	8	2592	0	2642
1667	2609	12	7	63	0	2691
1668	2614	11	4	34	0	2663
1669	2619	14	7	24	0	2664
1670	64	2587	7	24	0	2682
1671	42	40	6	2619	0	2707
1672	39	22	3	2641	0	2705
1673	2617	13	4	57	0	2691
1674	2630	14	2	35	0	2681
1675	61	13	10	2603	0	2687
1676	35	17	2586	51	0	2689
1677	2627	4	38	33	0	2702
1678	2696	8	14	25	0	2743
1679	63	8	2715	21	0	2807
1680	2592	5	37	22	0	2656
1681	55	4	2738	17	0	2814
1682	2640	2	49	16	0	2707
1683	63	58	21	2650	0	2792
1684	34	2806	12	36	0	2888
1685	32	34	2885	15	0	2966
1686	26	2881	48	13	0	2968
1687	20	2747	11	10	0	2788
1688	2737	60	29	32	0	2858
1689	42	5	10	2702	0	2759
1690	6	4	0	2688	0	2698
1691	2752	2	1	34	0	2789
1692	30	1	2	2801	0	2834
1693	5	2	2	2794	0	2803
1694	7	1	0	2815	0	2823
1695	6	1	1	2777	0	2785
1696	1	1	2813	27	0	2842
1697	5	3	2727	3	0	2738
1698	4	2778	24	6	0	2812
1699	2894	25	1	14	0	2934
1700	28	1	3	2983	0	3015
1701	2	3024	4	26	0	3056
1702	2	24	2	3203	0	3231
1703	8	0	1	3209	0	3218
1704	4	2	1	3201	0	3208
1705	2	3	3	3256	0	3264
1706	2	1	0	3244	0	3247
1707	1	3153	3	23	0	3180
1708	7	25	1	3216	0	3249
1709	3	0	3201	27	0	3231
1710	2	3189	23	8	0	3222
1711	4	24	2	3233	0	3263
1712	4	3	0	3240	0	3247
1713	0	3187	4	26	0	3217
1714	4	3249	0	5	0	3258
1715	3231	23	2	12	0	3268
1716	22	3223	2	6	0	3253
1717	3315	23	3	15	0	3356
1718	3310	3	2	11	0	3326
1719	26	5	3642	3	0	3676
1720	7	3	21	3477	0	3508
1721	4	4	3695	24	0	3727
1722	2	3756	23	3	0	3784
1723	18	31	8	3486	0	3543
1724	10	3	0	3804	0	3817
1725	7	0	2	3864	0	3873
1726	9	1	1	3899	0	3910
1727	1	11	4000	28	0	4040
1728	7	4	26	3959	0	3996
1729	1	2	4110	31	0	4144
1730	3	2	4004	6	0	4015
1731	3990	1	31	27	0	4049
1732	4272	1	2	14	0	4289
1733	4314	3	2	9	0	4328
1734	31	4232	3	4	0	4270
1735	7	28	1	4307	0	4343
1736	2	7	4457	30	0	4496
1737	14	1	31	4358	0	4404
1738	7	2	4611	30	0	4650
1739	4524	1	31	11	0	4567
1740	4528	5	6	15	0	4554
1741	4555	3	4	14	0	4576
1742	38	10	4382	2	0	4432
1743	10	6	4409	3	0	4428
1744	12	5	30	4599	0	4646
1745	11	5	9	4422	0	4447
1746	9	1	2	4734	0	4746
1747	4	5	4750	34	0	4793
1748	10	2	4391	6	0	4409
1749	4705	1	32	17	0	4755
1750	35	0	9	5081	0	5125
1751	11	1	1	5115	0	5128
1752	5240	1	3	52	0	5296
1753	39	2	6	5263	0	5310
1754	5618	2	13	69	0	5702
1755	5762	3	6	33	0	5804
1756	5731	2	7	25	0	5765
1757	38	3	5846	8	0	5895
1758	11	5847	36	5	0	5899
1759	6076	34	5	17	0	6132
1760	48	4	3	6046	0	6101
1761	15	0	2	6046	0	6063
1762	5	5984	2	39	0	6030
1763	6022	35	4	23	0	6084
1764	6134	6	5	21	0	6166
1765	6204	3	1	21	0	6229
1766	45	6297	4	4	0	6350
1767	6630	39	5	34	0	6708
1768	6672	6	4	26	0	6708
1769	6676	4	4	17	0	6701
1770	45	3	0	6623	0	6671
1771	18	5	0	6671	0	6694
1772	9	10	6741	49	0	6809
1773	18	5	41	6567	0	6631
1774	21	2	9	6608	0	6640
1775	13	3	6782	42	0	6840
1776	6514	4	31	24	0	6573
1777	6874	3	5	27	0	6909
1778	49	6	5	6829	0	6889
1779	10	6692	6	34	0	6742
1780	9	6814	3	13	0	6839
1781	16	43	1	6783	0	6843
1782	12	10	6670	42	0	6734
1783	18	11	32	6486	0	6547
1784	2	5	6865	31	0	6903
1785	9	6	6751	9	0	6775
1786	16	2	25	6987	0	7030
1787	7097	1	6	45	0	7149
1788	6979	2	4	22	0	7007
1789	34	6	5	7185	0	7230
1790	18	3	4	7199	0	7224
1791	7	2	6	7325	0	7340
1792	12	2	4	7311	0	7329
1793	7383	0	4	49	0	7436
1794	7328	1	7	25	0	7361
1795	7266	3	8	20	0	7297
1796	32	3	7256	7	0	7298
1797	18	2	23	7268	0	7311
1798	10	3	4	7442	0	7459
1799	7375	2	2	43	0	7422
1800	28	7271	7	14	0	7320
1801	7262	23	1	27	0	7313
1802	7233	7	2	24	0	7266
1803	7215	1	5	21	0	7242
1804	7218	2	7	12	0	7239
1805	50	9	7491	3	0	7553
1806	32	19	7022	7	0	7080
1807	7816	2	30	47	0	7895
1808	8028	1	8	16	0	8053
1809	7993	2	4	22	0	8021
1810	8049	3	1	15	0	8068
1811	46	4	8399	7	0	8456
1812	14	8725	46	9	0	8794
1813	39	42	12	9323	0	9416
1814	9837	16	12	85	0	9950
1815	9914	15	4	48	0	9981
1816	10691	4	5	33	0	10733
1817	10896	2	3	29	0	10930
1818	11073	1	4	25	0	11103
1819	10623	4	5	24	0	10656
1820	177	13	9853	32	0	10075
1821	78	7	10212	7	0	10304
1822	80	10	126	10182	0	10398
1823	51	6	10476	101	0	10634
1824	49	10160	131	31	0	10371
1825	49	10203	47	24	0	10323
1826	57	127	37	10622	0	10843
1827	41	40	10962	106	0	11149
1828	34	42	10316	38	0	10430
1829	10421	10	152	65	0	10648
1830	11494	15	75	45	0	11629
1831	201	24	47	11734	0	12006
1832	12051	31	27	196	0	12305
1833	243	17	23	12022	0	12305
1834	100	14	24	12064	0	12202
1835	58	8	12241	249	0	12556
1836	54	15	11721	94	0	11884
1837	77	3	243	11875	0	12198
1838	39	12	11914	222	0	12187
1839	11380	8	230	98	0	11716
1840	12057	8	84	101	0	12250
1841	255	12182	58	61	0	12556
1842	12364	189	49	88	0	12690
1843	263	54	12178	28	0	12523
1844	12141	32	225	58	0	12456
1845	12517	16	86	53	0	12672
1846	12620	12	67	57	0	12756
1847	367	8	48	12124	0	12547
1848	159	12195	37	197	0	12588
1849	12357	201	26	93	0	12677
1850	12323	59	52	68	0	12502
1851	341	46	42	12201	0	12630
1852	12185	22	36	288	0	12531
1853	335	12209	38	95	0	12677
1854	178	227	26	12074	0	12505
1855	111	96	11801	276	0	12284
1856	10927	68	249	141	0	11385
1857	326	31	11811	78	0	12246
1858	154	48	279	11698	0	12179
1859	135	11624	113	268	0	12140
1860	112	12582	96	92	0	12882
1861	110	335	53	12720	0	13218
1862	97	12270	104	308	0	12779
1863	112	384	52	16433	0	16981
1864	135	115	54	17437	0	17741
1865	119	86	52	17761	0	18018
1866	16853	79	35	744	0	17711
1867	599	74	36	16955	0	17664
1868	180	59	16526	694	0	17459
1869	153	16583	516	277	0	17529
1870	16716	507	149	218	0	17590
1871	640	151	87	16674	0	17552
1872	295	102	71	17061	0	17529
1873	256	91	55	17280	0	17682
1874	205	88	16484	748	0	17525
1875	154	16490	545	329	0	17518
1876	16639	548	173	274	0	17634
1877	659	171	129	16064	0	17023
1878	232	16741	139	626	0	17738
1879	16734	597	110	329	0	17770
1880	655	212	16525	211	0	17603
1881	16417	156	605	240	0	17418
1882	679	168	16713	147	0	17707
1883	286	156	16732	138	0	17312
1884	226	16334	692	157	0	17409
1885	214	581	257	15900	0	16952
1886	173	185	16063	649	0	17070
1887	170	15350	691	263	0	16474
1888	201	604	263	15274	0	16342
1889	135	15437	208	640	0	16420
1890	129	630	15487	265	0	16511
1891	156	249	622	15327	0	16354
1892	93	184	15515	742	0	16534
1893	133	159	685	15444	0	16421
1894	152	126	282	16002	0	16562
1895	119	109	15405	855	0	16488
1896	140	131	679	15475	0	16425
1897	14944	94	273	839	0	16150
1898	588	15111	225	386	0	16310
1899	235	597	15181	293	0	16306
1900	14915	204	651	297	0	16067
1901	729	156	252	14631	0	15768
1902	289	15001	200	654	0	16144
1903	15251	602	181	350	0	16384
1904	15708	230	170	261	0	16369
1905	820	202	130	14621	0	15773
1906	374	172	142	15091	0	15779
1907	303	134	120	15146	0	15703
1908	242	157	112	14927	0	15438
1909	184	14257	115	937	0	15493
1910	226	841	134	13842	0	15043
1911	198	13630	110	798	0	14736
1912	151	13653	120	442	0	14366
1913	118	13427	129	381	0	14055
1914	148	708	12380	333	0	13569
1915	123	12733	564	337	0	13757
1916	11437	676	271	301	0	12685
1917	523	11539	156	317	0	12535
1918	262	612	149	10659	0	11682
1919	164	11563	129	658	0	12514
1920	167	600	162	11539	0	12468
1921	199	304	141	11901	0	12545
1922	164	238	11316	779	0	12497
1923	11010	233	552	423	0	12218
1924	11404	238	202	361	0	12205
1925	11385	179	145	357	0	12066
1926	635	10900	192	342	0	12069
1927	303	572	181	10724	0	11780
1928	237	241	10497	721	0	11696
1929	240	10409	577	359	0	11585
1930	223	625	219	9110	0	10177
1931	192	9627	164	554	0	10537
1932	9389	485	204	281	0	10359
1933	9529	290	145	228	0	10192
1934	9744	170	185	215	0	10314
1935	9624	178	208	158	0	10168
1936	622	161	187	9165	0	10135
1937	301	162	143	9233	0	9839
1938	217	9065	190	548	0	10020
1939	219	495	136	9315	0	10165
1940	175	216	9038	597	0	10026
1941	141	177	446	8985	0	9749
1942	88	208	8740	611	0	9647
1943	104	8573	481	366	0	9524
1944	102	463	8620	281	0	9466
1945	112	191	528	8650	0	9481
1946	118	143	8700	594	0	9555
1947	101	139	530	8742	0	9512
1948	120	145	261	8960	0	9486
1949	134	155	174	8993	0	9456
1950	116	171	192	8932	0	9411
1951	8417	163	158	657	0	9395
1952	464	8539	121	336	0	9460
1953	8352	457	107	296	0	9212
1954	432	207	7982	263	0	8884
1955	8110	165	363	238	0	8876
1956	8455	147	128	264	0	8994
1957	578	169	7969	217	0	8933
1958	338	122	7878	235	0	8573
1959	236	7511	413	239	0	8399
1960	169	7234	161	233	0	7797
1961	236	449	6437	274	0	7396
1962	142	5861	301	289	0	6593
1963	202	308	150	2660	0	3320
1964	2255	34	64	91	0	2444
1965	62	13	23	2253	0	2351
1966	2275	32	8	56	0	2371
1967	2302	21	11	34	0	2368
1968	64	2366	15	21	0	2466
1969	2359	51	11	32	0	2453
1970	2402	17	9	30	0	2458
1971	66	14	8	2388	0	2476
1972	2420	18	3	64	0	2505
1973	60	2422	5	29	0	2516
1974	31	39	7	2476	0	2553
1975	2461	24	13	60	0	2558
1976	44	18	2426	26	0	2514
1977	2384	17	28	21	0	2450
1978	44	12	11	2455	0	2522
1979	30	12	2378	18	0	2438
1980	21	11	2270	15	0	2317
1981	2318	14	28	23	0	2383
1982	2356	0	12	19	0	2387
1983	23	2	13	2358	0	2396
1984	13	5	5	2384	0	2407
1985	16	4	4	2389	0	2413
1986	7	2414	4	23	0	2448
1987	2441	15	2	26	0	2484
1988	19	2436	4	11	0	2470
1989	2454	18	4	11	0	2487
1990	22	12	2394	7	0	2435
1991	17	6	16	2443	0	2482
1992	2495	6	9	26	0	2536
1993	22	4	9	2498	0	2533
1994	14	5	5	2464	0	2488
1995	11	2407	5	32	0	2455
1996	2480	15	5	21	0	2521
1997	17	2546	4	30	0	2597
1998	16	23	1	2567	0	2607
1999	9	14	2495	21	0	2539
2000	2308	9	16	21	0	2354
2001	26	11	2449	8	0	2494
2002	2385	3	25	18	0	2431
2003	31	2555	10	11	0	2607
2004	18	23	7	2500	0	2548
2005	7	2557	7	30	0	2601
2006	2609	30	3	15	0	2657
2007	32	13	2	2617	0	2664
2008	15	8	4	2670	0	2697
2009	13	11	2575	33	0	2632
2010	2463	4	24	20	0	2511
2011	30	6	10	2660	0	2706
2012	14	3	2624	31	0	2672
2013	8	2618	30	11	0	2667
2014	15	19	11	2669	0	2714
2015	2656	9	20	48	0	2733
2016	29	5	7	2701	0	2742
2017	12	11	2691	36	0	2750
2018	2786	4	26	24	0	2840
2019	45	5	11	2809	0	2870
2020	15	7	3132	42	0	3196
2021	18	11	55	3195	0	3279
2022	25	2	14	3256	0	3297
2023	16	3265	20	65	0	3366
2024	3269	53	12	46	0	3380
2025	53	3283	14	27	0	3377
2026	3303	67	4	23	0	3397
2027	72	21	5	3274	0	3372
2028	24	3285	10	52	0	3371
2029	25	58	4	3288	0	3375
2030	15	17	3217	78	0	3327
2031	3105	27	49	29	0	3210
2032	66	15	14	3162	0	3257
2033	21	14	18	3167	0	3220
2034	35	4	12	3176	0	3227
2035	15	8	3076	100	0	3199
2036	7	12	3038	50	0	3107
2037	14	3075	64	41	0	3194
2038	15	55	38	3052	0	3160
2039	3039	17	25	67	0	3148
2040	57	3054	15	29	0	3155
2041	23	65	15	3151	0	3254
2042	3170	26	6	84	0	3286
2043	3184	19	12	35	0	3250
2044	81	3184	18	25	0	3308
2045	3398	75	4	31	0	3508
2046	3681	20	7	29	0	3737
2047	121	21	4	3856	0	4002
2048	42	3849	5	97	0	3993
2049	41	93	10	3958	0	4102
2050	3915	24	9	128	0	4076
2051	122	29	3886	46	0	4083
2052	41	25	90	3866	0	4022
2053	58	21	22	3936	0	4037
2054	29	21	3836	136	0	4022
2055	29	15	104	3880	0	4028
2056	3842	18	31	151	0	4042
2057	3626	10	37	87	0	3760
2058	122	18	21	3822	0	3983
2059	52	11	3781	137	0	3981
2060	59	11	3665	64	0	3799
2061	47	3637	111	65	0	3860
2062	32	3801	48	52	0	3933
2063	38	106	37	3701	0	3882
2064	3652	36	31	119	0	3838
2065	106	3643	37	42	0	3828
2066	3590	108	27	63	0	3788
2067	113	45	26	3601	0	3785
2068	34	50	23	3587	0	3694
2069	3448	30	10	144	0	3632
2070	121	3467	9	68	0	3665
2071	3471	100	10	64	0	3645
2072	137	33	3331	57	0	3558
2073	49	43	3299	40	0	3431
2074	63	29	115	3247	0	3454
2075	35	37	3277	121	0	3470
2076	39	35	3267	48	0	3389
2077	43	15	129	3128	0	3315
2078	32	21	3206	118	0	3377
2079	39	17	129	3116	0	3301
2080	31	17	60	3192	0	3300
2081	22	12	3176	149	0	3359
2082	21	15	122	3091	0	3249
2083	32	17	56	3050	0	3155
2084	21	3008	45	144	0	3218
2085	3000	102	34	86	0	3222
2086	106	25	2977	68	0	3176
2087	37	29	116	2943	0	3125
2088	41	24	43	3028	0	3136
2089	32	23	2917	149	0	3121
2090	2788	23	124	83	0	3018
2091	99	2874	54	75	0	3102
2092	41	100	50	2887	0	3078
2093	37	30	39	2955	0	3061
2094	33	2888	44	145	0	3110
2095	26	111	2852	88	0	3077
2096	34	2897	106	75	0	3112
2097	2809	114	43	67	0	3033
2098	106	56	2801	59	0	3022
2099	52	51	108	2793	0	3004
2100	40	23	2836	129	0	3028
2101	28	38	2862	60	0	2988
2102	31	2826	131	56	0	3044
2103	48	95	68	2702	0	2913
2104	2709	33	48	119	0	2909
2105	2726	49	39	53	0	2867
2106	110	2673	53	64	0	2900
2107	57	97	26	2729	0	2909
2108	2686	46	30	121	0	2883
2109	2754	39	36	55	0	2884
2110	119	2702	22	66	0	2909
2111	2767	102	22	35	0	2926
2112	125	33	30	2665	0	2853
2113	57	2748	22	106	0	2933
2114	55	100	29	2836	0	3020
2115	47	47	39	2871	0	3004
2116	51	46	31	2856	0	2984
2117	24	35	2733	152	0	2944
2118	46	24	2552	66	0	2688
2119	35	2586	96	58	0	2775
2120	2211	67	39	52	0	2369
2121	59	2160	32	48	0	2299
2122	26	61	31	2139	0	2257
2123	21	24	2222	69	0	2336
2124	19	31	70	2146	0	2266
2125	25	25	25	2207	0	2282
2126	19	18	19	2254	0	2310
2127	2190	20	15	92	0	2317
2128	54	16	20	2220	0	2310
2129	16	8	2287	95	0	2406
2130	2213	9	62	57	0	2341
2131	2274	10	27	46	0	2357
2132	2323	10	27	37	0	2397
2133	2327	15	15	35	0	2392
2134	2334	14	15	23	0	2386
2135	80	2262	23	23	0	2388
2136	48	56	17	2220	0	2341
2137	43	2247	14	62	0	2366
2138	2268	51	18	31	0	2368
2139	2266	22	7	34	0	2329
2140	2225	19	13	29	0	2286
2141	72	2119	10	24	0	2225
2142	30	2082	9	24	0	2145
2143	26	2113	17	15	0	2171
2144	38	66	2052	14	0	2170
2145	62	136	50	1674	0	1922
2146	13	1478	9	22	0	1522
2147	4	1320	2	4	0	1330
2148	3	11	2	1295	0	1311
2149	3	1	0	1299	0	1303
2150	0	1	1332	10	0	1343
2151	1356	1	7	7	0	1371
2152	9	2	1	1423	0	1435
2153	4	1	1	1436	0	1442
2154	2	0	1409	11	0	1422
2155	3	1	1367	2	0	1373
2156	1	1437	11	3	0	1452
2157	3	11	1	1472	0	1487
2158	6	6	2	1482	0	1496
2159	1	1	1448	14	0	1464
2160	1353	3	13	8	0	1377
2161	1447	0	0	5	0	1452
2162	13	4	1462	3	0	1482
2163	1469	1	12	10	0	1492
2164	15	1	1494	3	0	1513
2165	1494	0	14	4	0	1512
2166	1505	4	3	3	0	1515
2167	17	2	1507	6	0	1532
2168	7	2	12	1506	0	1527
2169	12	2	7	1480	0	1501
2170	4	5	6	1618	0	1633
2171	1600	2	1	28	0	1631
2172	1602	4	2	15	0	1623
2173	24	4	1621	10	0	1659
2174	9	3	1596	7	0	1615
2175	1674	2	19	16	0	1711
2176	1735	2	8	8	0	1753
2177	28	3	1689	0	0	1720
2178	9	5	1655	5	0	1674
2179	7	2	25	1678	0	1712
2180	9	0	1751	19	0	1779
2181	8	3	22	1674	0	1707
2182	1748	2	8	24	0	1782
2183	24	2	1875	11	0	1912
2184	1815	1	31	17	0	1864
2185	33	0	2144	8	0	2185
2186	17	0	40	2130	0	2187
2187	16	1	8	2272	0	2297
2188	8	0	10	2298	0	2316
2189	7	2292	7	51	0	2357
2190	26	38	4	2165	0	2233
2191	9	5	5	2342	0	2361
2192	2308	4	4	53	0	2369
2193	42	3	2267	13	0	2325
2194	2179	2	41	12	0	2234
2195	48	3	2256	6	0	2313
2196	2079	0	45	17	0	2141
2197	51	2220	11	3	0	2285
2198	15	40	2222	2	0	2279
2199	8	8	2214	5	0	2235
2200	19	12	57	2041	0	2129
2201	6	1	12	2213	0	2232
2202	5	6	2176	49	0	2236
2203	1	7	2223	17	0	2248
2204	8	4	2466	14	0	2492
2205	2584	1	50	22	0	2657
2206	2649	0	15	18	0	2682
2207	2674	3	10	9	0	2696
2208	54	2	11	2612	0	2679
2209	17	3	9	2643	0	2672
2210	12	4	2721	49	0	2786
2211	9	5	45	2649	0	2708
2212	19	4	16	2523	0	2562
2213	2611	2	14	57	0	2684
2214	2603	3	6	31	0	2643
2215	2661	3	9	22	0	2695
2216	54	4	14	2632	0	2704
2217	15	2	14	2672	0	2703
2218	17	0	15	2670	0	2702
2219	2625	3	10	56	0	2694
2220	53	3	14	2573	0	2643
2221	22	2569	10	45	0	2646
2222	21	41	4	2554	0	2620
2223	10	2493	10	52	0	2565
2224	2530	43	16	22	0	2611
2225	2533	8	17	20	0	2578
2226	53	2536	13	15	0	2617
2227	24	2639	13	20	0	2696
2228	22	45	17	2611	0	2695
2229	19	8	2574	50	0	2651
2230	21	8	49	2490	0	2568
2231	16	5	2609	64	0	2694
2232	16	2621	48	27	0	2712
2233	26	40	13	2658	0	2737
2234	15	8	17	2703	0	2743
2235	12	11	2826	64	0	2913
2236	14	7	52	2802	0	2875
2237	19	7	2926	59	0	3011
2238	2916	7	50	26	0	2999
2239	3023	6	12	24	0	3065
2240	3063	12	16	12	0	3103
2241	64	8	10	2989	0	3071
2242	21	7	9	3043	0	3080
2243	22	7	3104	71	0	3204
2244	13	13	58	3045	0	3129
2245	14	3066	23	63	0	3166
2246	13	46	3107	27	0	3193
2247	14	12	2998	29	0	3053
2248	26	26	54	2812	0	2918
2249	18	4	3083	53	0	3158
2250	15	9	3012	24	0	3060
2251	2962	8	50	37	0	3057
2252	50	3545	19	20	0	3634
2253	3677	44	14	36	0	3771
2254	3730	14	9	26	0	3779
2255	3793	11	11	29	0	3844
2256	64	8	13	3811	0	3896
2257	19	11	15	3896	0	3941
2258	15	12	3901	61	0	3989
2259	12	7	46	3831	0	3896
2260	13	3886	23	55	0	3977
2261	3950	37	21	33	0	4041
2262	39	3960	26	16	0	4041
2263	16	4040	18	24	0	4098
2264	17	50	14	4062	0	4143
2265	20	17	4085	48	0	4170
2266	36	8	41	3999	0	4084
2267	18	7	4115	56	0	4196
2268	14	4065	49	23	0	4151
2269	4089	36	20	28	0	4173
2270	4155	7	14	30	0	4206
2271	4367	7	14	50	0	4438
2272	48	10	4635	20	0	4713
2273	25	10	4391	16	0	4442
2274	4694	7	46	24	0	4771
2275	4847	9	14	28	0	4898
2276	4914	8	16	29	0	4967
2277	42	9	15	4887	0	4953
2278	24	7	11	4990	0	5032
2279	4985	6	23	59	0	5073
2280	4931	5	20	25	0	4981
2281	47	13	5205	16	0	5281
2282	29	7	5025	16	0	5077
2283	4987	4	20	24	0	5035
2284	26	5	5154	12	0	5197
2285	4930	2	13	15	0	4960
2286	14	2	5032	5	0	5053
2287	12	15	11	4917	0	4955
2288	4	4	5268	8	0	5284
2289	15	1	4	5240	0	5260
2290	9	0	4	5348	0	5361
2291	1	5432	3	9	0	5445
2292	5561	6	2	23	0	5592
2293	5	4	5635	4	0	5648
2294	5453	1	7	18	0	5479
2295	9	5803	4	1	0	5817
2296	6083	5	7	26	0	6121
2297	13	2	4	6074	0	6093
2298	10	2	0	6114	0	6126
2299	2	6293	3	11	0	6309
2300	9	11	0	6559	0	6579
2301	10	3	2	6560	0	6575
2302	2	2	3	6713	0	6720
2303	6592	3	2	37	0	6634
2304	6251	1	1	19	0	6272
2305	34	1	6201	8	0	6244
2306	10	6313	26	7	0	6356
2307	17	21	6	6452	0	6496
2308	11	6	6	6600	0	6623
2309	7	9	6688	34	0	6738
2310	10	4	29	6569	0	6612
2311	6738	1	11	55	0	6805
2312	6811	1	5	30	0	6847
2313	6957	1	5	32	0	6995
2314	53	2	1	7104	0	7160
2315	7387	1	5	76	0	7469
2316	7442	1	1	46	0	7490
2317	7545	1	2	26	0	7574
2318	55	0	3	7517	0	7575
2319	34	1	5	7541	0	7581
2320	27	3	1	7589	0	7620
2321	31	1	0	7391	0	7423
2322	22	2	2	7435	0	7461
2323	8	4	7447	59	0	7518
2324	7	7	7255	29	0	7298
2325	12	7302	41	22	0	7377
2326	17	29	19	7453	0	7518
2327	19	10	12	7486	0	7527
2328	13	7	4	7522	0	7546
2329	5	9	7462	56	0	7532
2330	16	2	33	7334	0	7385
2331	11	4	7443	51	0	7509
2332	17	3	38	7368	0	7426
2333	7	2	7745	52	0	7806
2334	3	7689	43	34	0	7769
2335	10	37	27	7709	0	7783
2336	8	17	7615	51	0	7691
2337	6771	17	44	64	0	6896
2338	41	7613	20	24	0	7698
2339	23	40	11	7788	0	7862
2340	13	7753	12	56	0	7834
2341	25	50	8	7714	0	7797
2342	7852	15	9	82	0	7958
2343	55	15	7	7753	0	7830
2344	20	7777	6	64	0	7867
2345	7795	40	5	54	0	7894
2346	57	14	5	7844	0	7920
2347	26	24	5	7922	0	7977
2348	7967	12	4	95	0	8078
2349	67	8	4	8428	0	8507
2350	45	2	9	10456	0	10512
2351	31	7	10885	212	0	11135
2352	25	11	10553	80	0	10669
2353	40	7	261	10602	0	10910
2354	16	8	10725	229	0	10978
2355	18	11	10511	95	0	10635
2356	9918	3	311	111	0	10343
2357	227	11	10693	40	0	10971
2358	76	10658	281	44	0	11059
2359	76	205	104	10684	0	11069
2360	11011	63	89	275	0	11438
2361	11229	46	51	126	0	11452
2362	11191	18	55	111	0	11375
2363	343	11049	46	52	0	11490
2364	180	235	47	11001	0	11463
2365	128	74	66	11259	0	11527
2366	10654	68	90	375	0	11187
2367	11077	34	49	205	0	11365
2368	11148	31	56	157	0	11392
2369	377	26	10983	71	0	11457
2370	200	10608	291	70	0	11169
2371	148	11651	154	73	0	12026
2372	130	381	113	11243	0	11867
2373	108	178	65	11923	0	12274
2374	91	116	11848	482	0	12537
2375	11618	65	351	261	0	12295
2376	12192	50	164	184	0	12590
2377	525	65	127	11928	0	12645
2378	306	59	73	12132	0	12570
2379	222	47	67	12323	0	12659
2380	11954	37	42	617	0	12650
2381	495	30	11444	310	0	12279
2382	256	42	11585	234	0	12117
2383	223	55	477	11443	0	12198
2384	120	64	11534	447	0	12165
2385	11170	79	450	274	0	11973
2386	11400	39	231	247	0	11917
2387	11632	19	178	207	0	12036
2388	593	10922	140	166	0	11821
2389	11202	324	119	135	0	11780
2390	607	169	79	10880	0	11735
2391	315	106	82	11030	0	11533
2392	249	62	63	11264	0	11638
2393	147	60	10632	670	0	11509
2394	190	42	402	10483	0	11117
2395	171	10405	225	529	0	11330
2396	10149	326	223	314	0	11012
2397	415	10384	143	289	0	11231
2398	233	422	10260	226	0	11141
2399	250	10244	430	172	0	11096
2400	9909	463	216	184	0	10772
2401	475	9956	196	135	0	10762
2402	300	480	158	9074	0	10012
2403	203	9870	161	412	0	10646
2404	9818	457	132	276	0	10683
2405	10008	233	117	242	0	10600
2406	9486	183	109	227	0	10005
2407	613	156	9600	167	0	10536
2408	372	143	9617	138	0	10270
2409	290	150	9463	153	0	10056
2410	9335	130	587	137	0	10189
2411	538	128	291	9146	0	10103
2412	310	111	237	9343	0	10001
2413	248	133	8988	512	0	9881
2414	223	148	404	8984	0	9759
2415	8505	123	220	536	0	9384
2416	453	8517	158	336	0	9464
2417	8693	398	154	288	0	9533
2418	569	226	8524	162	0	9481
2419	8742	165	425	160	0	9492
2420	8960	118	224	147	0	9449
2421	8992	133	218	143	0	9486
2422	654	119	8485	145	0	9403
2423	421	96	460	8496	0	9473
2424	352	69	8540	436	0	9397
2425	308	88	467	8559	0	9422
2426	231	69	8582	540	0	9422
2427	198	78	551	8532	0	9359
2428	180	70	315	8826	0	9391
2429	8524	62	219	604	0	9409
2430	8653	76	165	372	0	9266
2431	8799	74	154	291	0	9318
2432	691	48	184	8231	0	9154
2433	409	7561	163	474	0	8607
2434	359	8167	140	286	0	8952
2435	8128	414	123	239	0	8904
2436	534	235	7914	185	0	8868
2437	8017	152	417	221	0	8807
2438	548	119	7869	174	0	8710
2439	8097	102	459	170	0	8828
2440	7666	85	260	208	0	8219
2441	591	68	7954	181	0	8794
2442	8065	70	413	226	0	8774
2443	8229	67	259	169	0	8724
2444	8273	79	199	153	0	8704
2445	723	7754	131	141	0	8749
2446	444	466	169	7732	0	8811
2447	320	215	7705	431	0	8671
2448	300	198	7809	240	0	8547
2449	286	7183	440	167	0	8076
2450	159	5116	218	88	0	5581
2451	203	210	219	4260	0	4892
2452	4179	109	105	185	0	4578
2453	201	4229	79	110	0	4619
2454	171	164	57	4184	0	4576
2455	134	4219	45	174	0	4572
2456	4251	183	48	132	0	4614
2457	226	123	50	4160	0	4559
2458	166	84	3991	177	0	4418
2459	121	3879	141	132	0	4273
2460	87	3905	112	98	0	4202
2461	92	199	84	3549	0	3924
2462	74	3747	82	123	0	4026
2463	71	204	56	3671	0	4002
2464	3715	140	43	177	0	4075
2465	3769	105	32	116	0	4022
2466	3994	79	42	103	0	4218
2467	4020	67	48	85	0	4220
2468	266	67	3890	59	0	4282
2469	194	3755	124	49	0	4122
2470	151	3852	83	47	0	4133
2471	73	3202	23	27	0	3325
2472	47	3030	25	27	0	3129
2473	2675	72	60	30	0	2837
2474	2627	13	3	17	0	2660
2475	2736	8	5	12	0	2761
2476	2760	6	5	11	0	2782
2477	38	5	2709	4	0	2756
2478	2869	8	22	10	0	2909
2479	2969	4	5	6	0	2984
2480	2985	1	5	8	0	2999
2481	46	4	5	2955	0	3010
2482	16	6	3	2975	0	3000
2483	3029	3	2	33	0	3067
2484	36	5	3	2997	0	3041
2485	19	3002	3	32	0	3056
2486	13	24	4	3085	0	3126
2487	14	5	7	3074	0	3100
2488	12	3084	4	29	0	3129
2489	16	29	0	3104	0	3149
2490	16	10	1	3138	0	3165
2491	3118	8	4	39	0	3169
2492	37	5	2990	19	0	3051
2493	2965	4	23	12	0	3004
2494	43	4	3003	9	0	3059
2495	19	6	2909	9	0	2943
2496	23	5	2972	6	0	3006
2497	2992	1	30	12	0	3035
2498	32	8	3207	7	0	3254
2499	3179	2	30	12	0	3223
2500	3290	3	10	20	0	3323
2501	3332	5	8	10	0	3355
2502	39	3355	10	10	0	3414
2503	3365	26	5	12	0	3408
2504	34	3428	7	8	0	3477
2505	18	29	5	3486	0	3538
2506	18	13	5	3497	0	3533
2507	18	3455	2	35	0	3510
2508	9	3464	11	16	0	3500
2509	19	3539	5	10	0	3573
2510	3557	33	7	12	0	3609
2511	36	3655	8	7	0	3706
2512	3701	34	10	18	0	3763
2513	42	15	3673	6	0	3736
2514	3664	15	25	17	0	3721
2515	3793	8	6	18	0	3825
2516	40	9	3711	9	0	3769
2517	33	4	25	3725	0	3787
2518	20	7	3784	26	0	3837
2519	23	8	29	3769	0	3829
2520	18	11	11	3824	0	3864
2521	3869	9	9	50	0	3937
2522	3851	8	7	33	0	3899
2523	31	3833	10	18	0	3892
2524	3873	24	6	23	0	3926
2525	47	17	3906	8	0	3978
2526	3921	9	30	14	0	3974
2527	44	14	4146	8	0	4212
2528	29	13	4146	9	0	4197
2529	4314	6	44	21	0	4385
2530	4437	9	16	14	0	4476
2531	51	7	4572	4	0	4634
2532	38	8	38	4376	0	4460
2533	18	10	15	4627	0	4670
2534	21	8	4580	38	0	4647
2535	20	8	36	4448	0	4512
2536	23	4324	17	38	0	4402
2537	20	35	11	4720	0	4786
2538	23	14	12	4692	0	4741
2539	23	16	4564	43	0	4646
2540	4271	6	28	33	0	4338
2541	4544	12	18	22	0	4596
2542	4532	7	12	17	0	4568
2543	4495	7	10	26	0	4538
2544	59	4436	16	8	0	4519
2545	28	33	11	4380	0	4452
2546	25	16	4341	38	0	4420
2547	23	9	4305	22	0	4359
2548	26	12	39	4290	0	4367
2549	18	9	4402	47	0	4476
2550	4281	10	39	32	0	4362
2551	46	6	11	4524	0	4587
2552	28	14	17	4523	0	4582
2553	21	4	17	4529	0	4571
2554	4473	11	10	64	0	4558
2555	47	4474	16	23	0	4560
2556	4500	33	20	33	0	4586
2557	4524	10	15	23	0	4572
2558	57	4433	13	21	0	4524
2559	21	4449	19	15	0	4504
2560	4588	41	12	22	0	4663
2561	53	10	16	4589	0	4668
2562	29	17	14	4513	0	4573
2563	4665	7	16	65	0	4753
2564	64	10	4531	16	0	4621
2565	4475	8	60	28	0	4571
2566	4576	9	16	34	0	4635
2567	68	4681	18	13	0	4780
2568	5022	39	14	24	0	5099
2569	5067	24	11	35	0	5137
2570	86	5515	6	20	0	5627
2571	28	5683	15	14	0	5740
2572	48	100	8	5516	0	5672
2573	5585	38	16	96	0	5735
2574	80	5692	6	32	0	5810
2575	37	97	1	5744	0	5879
2576	5875	31	5	110	0	6021
2577	106	29	5838	33	0	6006
2578	59	12	92	5771	0	5934
2579	38	17	5846	106	0	6007
2580	5614	10	116	48	0	5788
2581	5900	19	31	50	0	6000
2582	138	16	5867	23	0	6044
2583	59	5750	109	32	0	5950
2584	59	93	44	5858	0	6054
2585	27	34	5888	109	0	6058
2586	32	25	123	5786	0	5966
2587	53	10	48	5965	0	6076
2588	39	17	5931	141	0	6128
2589	5737	13	119	73	0	5942
2590	5968	14	50	62	0	6094
2591	140	14	5959	39	0	6152
2592	57	5992	124	45	0	6218
2593	58	106	53	5857	0	6074
2594	33	5948	47	114	0	6142
2595	35	6074	31	52	0	6192
2596	5980	141	32	40	0	6193
2597	137	61	24	5985	0	6207
2598	60	42	19	5963	0	6084
2599	40	27	5916	150	0	6133
2600	32	29	5821	74	0	5956
2601	30	28	137	5785	0	5980
2602	43	27	59	5884	0	6013
2603	38	26	5802	150	0	6016
2604	37	21	5781	75	0	5914
2605	42	22	152	5781	0	5997
2606	5792	16	79	163	0	6050
2607	112	5916	67	70	0	6165
2608	5937	126	41	75	0	6179
2609	153	5955	30	50	0	6188
2610	64	6095	34	43	0	6236
2611	5912	153	31	54	0	6150
2612	147	64	5883	48	0	6142
2613	83	45	136	5788	0	6052
2614	76	32	59	5825	0	5992
2615	62	37	46	6290	0	6435
2616	42	48	6240	208	0	6538
2617	51	44	162	6256	0	6513
2618	6382	34	67	205	0	6688
2619	182	27	64	6525	0	6798
2620	80	28	34	6856	0	6998
2621	6699	23	32	266	0	7020
2622	6703	22	33	144	0	6902
2623	214	6586	36	100	0	6936
2624	94	155	6672	77	0	6998
2625	83	65	6564	64	0	6776
2626	81	38	6570	63	0	6752
2627	57	6275	230	66	0	6628
2628	64	176	109	6089	0	6438
2629	68	61	70	6258	0	6457
2630	6154	54	54	221	0	6483
2631	175	44	70	6013	0	6302
2632	73	47	5976	216	0	6312
2633	80	18	186	6005	0	6289
2634	47	38	82	6120	0	6287
2635	45	42	5927	253	0	6267
2636	54	5831	184	145	0	6214
2637	62	162	91	5457	0	5772
2638	43	5773	68	207	0	6091
2639	41	184	5794	114	0	6133
2640	5733	72	213	84	0	6102
2641	5891	61	92	85	0	6129
2642	5955	49	66	93	0	6163
2643	253	47	64	5715	0	6079
2644	106	5821	62	206	0	6195
2645	5782	176	54	108	0	6120
2646	5944	83	58	99	0	6184
2647	5924	64	50	80	0	6118
2648	270	31	5725	81	0	6107
2649	5650	41	188	77	0	5956
2650	241	5671	80	70	0	6062
2651	5568	186	64	70	0	5888
2652	210	5585	69	60	0	5924
2653	5664	197	46	63	0	5970
2654	247	74	5590	58	0	5969
2655	5580	73	185	51	0	5889
2656	5716	52	80	62	0	5910
2657	4932	59	70	93	0	5154
2658	5763	53	39	53	0	5908
2659	277	60	5486	43	0	5866
2660	170	35	172	5459	0	5836
2661	5469	38	81	183	0	5771
2662	226	5408	65	93	0	5792
2663	134	165	62	5351	0	5712
2664	114	63	5261	190	0	5628
2665	92	83	173	5284	0	5632
2666	101	29	5311	210	0	5651
2667	64	5010	203	106	0	5383
2668	69	4660	89	92	0	4910
2669	68	4660	71	62	0	4861
2670	102	201	48	3943	0	4294
2671	58	62	27	3967	0	4114
2672	42	32	3809	138	0	4021
2673	47	3677	97	64	0	3885
2674	3430	88	56	42	0	3616
2675	96	3336	25	33	0	3490
2676	48	3246	21	21	0	3336
2677	63	106	39	3082	0	3290
2678	3063	38	19	86	0	3206
2679	3105	21	25	36	0	3187
2680	108	30	11	3064	0	3213
2681	3037	21	15	88	0	3161
2682	100	22	13	2986	0	3121
2683	49	23	2924	97	0	3093
2684	2944	18	73	50	0	3085
2685	88	23	34	2941	0	3086
2686	49	21	2870	88	0	3028
2687	31	24	2811	44	0	2910
2688	35	28	86	2828	0	2977
2689	2919	18	30	89	0	3056
2690	2908	14	26	45	0	2993
2691	90	2886	25	28	0	3029
2692	2955	66	18	31	0	3070
2693	2976	34	15	25	0	3050
2694	3015	25	14	22	0	3076
2695	101	2965	15	29	0	3110
2696	3037	68	12	21	0	3138
2697	3094	24	12	31	0	3161
2698	109	23	18	3005	0	3155
2699	2939	14	15	74	0	3042
2700	86	2851	15	36	0	2988
2701	48	2941	18	21	0	3028
2702	34	80	15	2916	0	3045
2703	35	29	15	2951	0	3030
2704	34	2947	9	71	0	3061
2705	2885	59	11	35	0	2990
2706	64	2839	14	22	0	2939
2707	2716	56	5	19	0	2796
2708	69	2729	11	17	0	2826
2709	52	56	6	2639	0	2753
2710	39	2785	3	36	0	2863
2711	2814	58	24	30	0	2926
2712	2825	27	13	14	0	2879
2713	2855	20	8	26	0	2909
2714	80	19	2696	19	0	2814
2715	36	11	2418	11	0	2476
2716	16	2363	31	14	0	2424
2717	18	28	2259	9	0	2314
2718	21	26	2088	3	0	2138
2719	13	49	26	1783	0	1871
2720	5	5	1838	21	0	1869
2721	3	1884	20	6	0	1913
2722	1863	21	4	10	0	1898
2723	20	1857	4	2	0	1883
2724	7	1917	2	0	0	1926
2725	1991	18	11	13	0	2033
2726	2036	7	3	7	0	2053
2727	22	2040	5	4	0	2071
2728	2094	15	2	7	0	2118
2729	2090	3	2	5	0	2100
2730	2097	2	0	5	0	2104
2731	23	4	2003	1	0	2031
2732	6	5	1993	1	0	2005
2733	7	3	20	2069	0	2099
2734	6	3	5	2063	0	2077
2735	2131	5	1	20	0	2157
2736	19	2092	4	5	0	2120
2737	9	15	1	2175	0	2200
2738	5	4	4	2200	0	2213
2739	4	4	0	2207	0	2215
2740	6	2	1	2211	0	2220
2741	2	6	2209	24	0	2241
2742	8	6	2169	6	0	2189
2743	10	2	23	2269	0	2304
2744	3	3	2306	20	0	2332
2745	2275	3	21	16	0	2315
2746	24	1	8	2395	0	2428
2747	10	3	2364	18	0	2395
2748	2238	1	22	15	0	2276
2749	18	2370	12	4	0	2404
2750	2374	20	6	11	0	2411
2751	23	2452	1	11	0	2487
2752	12	19	1	2450	0	2482
2753	6	7	2436	29	0	2478
2754	7	3	28	2358	0	2396
2755	5	18	2360	22	0	2405
2756	2359	3	28	14	0	2404
2757	24	4	13	2444	0	2485
2758	2469	5	11	35	0	2520
2759	31	5	2473	16	0	2525
2760	2542	1	32	18	0	2593
2761	2716	3	20	12	0	2751
2762	44	9	2753	3	0	2809
2763	23	10	27	2745	0	2805
2764	16	9	2793	30	0	2848
2765	8	2771	32	15	0	2826
2766	2777	26	18	14	0	2835
2767	2776	10	15	9	0	2810
2768	39	4	2828	11	0	2882
2769	20	3	2804	5	0	2832
2770	19	5	39	2806	0	2869
2771	16	6	17	2884	0	2923
2772	2907	4	12	41	0	2964
2773	34	2919	18	12	0	2983
2774	3043	24	10	21	0	3098
2775	3061	7	16	19	0	3103
2776	38	7	2980	12	0	3037
2777	2916	2	31	24	0	2973
2778	39	9	3048	7	0	3103
2779	29	11	30	3104	0	3174
2780	27	7	3269	24	0	3327
2781	20	2	38	3249	0	3309
2782	10	4	3307	33	0	3354
2783	3210	7	41	25	0	3283
2784	3320	2	16	24	0	3362
2785	45	4	13	3304	0	3366
2786	3420	4	10	50	0	3484
2787	36	5	14	3506	0	3561
2788	25	3535	10	39	0	3609
2789	3559	25	14	22	0	3620
2790	39	3521	8	15	0	3583
2791	25	30	8	3569	0	3632
2792	16	9	9	3532	0	3566
2793	11	10	10	3487	0	3518
2794	18	4	10	3465	0	3497
2795	15	9	3366	40	0	3430
2796	3091	5	34	28	0	3158
2797	3389	5	13	21	0	3428
2798	40	3398	7	20	0	3465
2799	19	26	5	3464	0	3514
2800	14	11	10	3491	0	3526
2801	14	11	3400	42	0	3467
2802	3294	6	33	21	0	3354
2803	42	15	9	3442	0	3508
2804	19	11	3448	35	0	3513
2805	3458	8	23	35	0	3524
2806	3547	4	14	31	0	3596
2807	3582	2	8	24	0	3616
2808	45	6	3526	16	0	3593
2809	24	8	3349	10	0	3391
2810	3417	4	34	20	0	3475
2811	34	6	17	3487	0	3544
2812	24	6	10	3573	0	3613
2813	18	3	3546	34	0	3601
2814	3412	2	26	31	0	3471
2815	33	0	20	3616	0	3669
2816	3774	1	12	51	0	3838
2817	3808	2	7	36	0	3853
2818	3811	4	9	27	0	3851
2819	49	4	3907	8	0	3968
2820	27	4	33	3898	0	3962
2821	3958	3	20	42	0	4023
2822	34	3976	18	24	0	4052
2823	30	27	8	4089	0	4154
2824	20	12	9	4046	0	4087
2825	3958	3	8	62	0	4031
2826	3927	0	13	34	0	3974
2827	50	6	9	3924	0	3989
2828	29	5	3858	39	0	3931
2829	3775	4	34	33	0	3846
2830	50	3	3926	12	0	3991
2831	3935	3	36	26	0	4000
2832	3982	1	18	26	0	4027
2833	51	1	3986	13	0	4051
2834	42	4	33	3947	0	4026
2835	20	10	4192	40	0	4262
2836	23	4412	42	21	0	4498
2837	26	57	21	4326	0	4430
2838	13	4504	16	48	0	4581
2839	15	59	9	4607	0	4690
2840	11	20	4721	58	0	4810
2841	11	4747	65	31	0	4854
2842	6	4918	27	17	0	4968
2843	32	102	20	4918	0	5072
2844	4994	32	5	82	0	5113
2845	78	15	15	5443	0	5551
2846	5587	12	4	103	0	5706
2847	98	5703	4	35	0	5840
2848	6530	89	11	35	0	6665
2849	139	32	6744	9	0	6924
2850	70	21	115	6642	0	6848
2851	51	10	35	6696	0	6792
2852	18	10	6696	161	0	6885
2853	6438	7	129	78	0	6652
2854	6735	7	41	58	0	6841
2855	166	6642	33	22	0	6863
2856	98	131	15	6341	0	6585
2857	54	6616	28	116	0	6814
2858	34	143	6594	57	0	6828
2859	25	50	6597	47	0	6719
2860	42	68	155	6417	0	6682
2861	6422	10	78	140	0	6650
2862	139	6310	38	47	0	6534
2863	6378	126	12	56	0	6572
2864	145	53	6258	30	0	6486
2865	6297	45	129	42	0	6513
2866	6523	31	51	37	0	6642
2867	169	30	6390	15	0	6604
2868	92	21	135	6238	0	6486
2869	6418	21	49	153	0	6641
2870	6458	23	39	57	0	6577
2871	6461	22	32	38	0	6553
2872	200	20	26	6322	0	6568
2873	108	10	6222	131	0	6471
2874	6178	12	135	58	0	6383
2875	182	15	6280	40	0	6517
2876	89	15	158	6173	0	6435
2877	80	16	62	6220	0	6378
2878	73	6191	41	161	0	6466
2879	68	124	6151	67	0	6410
2880	38	5907	150	60	0	6155
2881	43	6107	58	57	0	6265
2882	45	163	61	6052	0	6321
2883	57	64	6033	148	0	6302
2884	61	40	144	6008	0	6253
2885	27	34	6041	186	0	6288
2886	50	33	152	5908	0	6143
2887	45	37	72	5939	0	6093
2888	24	37	5711	180	0	5952
2889	33	33	155	5695	0	5916
2890	23	44	5714	183	0	5964
2891	32	32	5689	93	0	5846
2892	46	5609	190	75	0	5920
2893	5654	152	92	72	0	5970
2894	163	53	5666	54	0	5936
2895	5549	43	162	65	0	5819
2896	189	30	85	5710	0	6014
2897	69	29	5689	178	0	5965
2898	53	5574	180	92	0	5899
2899	57	144	91	5642	0	5934
2900	54	60	5668	158	0	5940
2901	66	65	165	5388	0	5684
2902	61	5578	80	177	0	5896
2903	5629	152	80	82	0	5943
2904	185	60	59	5623	0	5927
2905	5485	57	58	187	0	5787
2906	5564	35	67	101	0	5767
2907	5599	48	44	73	0	5764
2908	5665	34	57	71	0	5827
2909	5536	31	64	79	0	5710
2910	215	5361	49	61	0	5686
2911	112	167	32	5396	0	5707
2912	112	63	49	5436	0	5660
2913	96	47	49	5458	0	5650
2914	88	38	5219	229	0	5574
2915	98	5188	163	107	0	5556
2916	5252	134	71	93	0	5550
2917	5320	62	66	80	0	5528
2918	227	5134	64	72	0	5497
2919	110	5253	61	76	0	5500
2920	5210	180	45	85	0	5520
2921	205	93	5022	65	0	5385
2922	103	86	172	4948	0	5309
2923	4934	58	89	187	0	5268
2924	201	49	73	4835	0	5158
2925	96	4881	48	201	0	5226
2926	89	154	59	4991	0	5293
2927	61	84	4979	197	0	5321
2928	4906	72	182	107	0	5267
2929	5192	41	91	76	0	5400
2930	229	34	76	5018	0	5357
2931	137	40	57	5123	0	5357
2932	4953	44	43	215	0	5255
2933	203	4835	51	113	0	5202
2934	101	136	65	4826	0	5128
2935	109	61	44	4862	0	5076
2936	4460	40	38	194	0	4732
2937	176	4401	36	110	0	4723
2938	4274	121	17	103	0	4515
2939	174	4143	34	76	0	4427
2940	83	4223	34	59	0	4399
2941	4115	127	33	47	0	4322
2942	140	4071	28	73	0	4312
2943	66	200	67	3932	0	4265
2944	68	54	3902	146	0	4170
2945	53	42	3394	49	0	3538
2946	23	31	3281	53	0	3388
2947	22	3203	119	30	0	3374
2948	2325	72	82	33	0	2512
2949	51	22	26	2140	0	2239
2950	23	15	8	2175	0	2221
2951	17	6	2154	57	0	2234
2952	2129	3	47	40	0	2219
2953	43	4	27	2238	0	2312
2954	32	7	12	2242	0	2293
2955	16	5	6	2255	0	2282
2956	2176	3	6	79	0	2264
2957	46	3	2134	44	0	2227
2958	2152	1	44	27	0	2224
2959	56	5	21	2160	0	2242
2960	32	2	2140	48	0	2222
2961	2107	4	44	36	0	2191
2962	48	6	2199	19	0	2272
2963	40	15	46	2161	0	2262
2964	23	7	2212	41	0	2283
2965	14	5	2118	25	0	2162
2966	2017	0	58	26	0	2101
2967	47	3	2058	7	0	2115
2968	29	6	53	2038	0	2126
2969	2054	4	26	51	0	2135
2970	47	7	17	2064	0	2135
2971	26	7	2043	57	0	2133
2972	19	5	2063	27	0	2114
2973	15	2051	62	18	0	2146
2974	22	37	33	2023	0	2115
2975	1959	21	17	49	0	2046
2976	44	1948	8	30	0	2030
2977	1948	44	6	22	0	2020
2978	54	25	6	1929	0	2014
2979	1929	12	13	47	0	2001
2980	50	1915	7	27	0	1999
2981	34	42	4	1926	0	2006
2982	1922	20	8	54	0	2004
2983	45	1928	4	30	0	2007
2984	36	44	5	1922	0	2007
2985	21	24	8	1927	0	1980
2986	1920	17	6	62	0	2005
2987	49	12	7	1937	0	2005
2988	33	4	11	1949	0	1997
2989	22	5	8	1985	0	2020
2990	14	5	1884	70	0	1973
2991	1842	9	39	42	0	1932
2992	48	5	23	2108	0	2184
2993	26	0	2213	59	0	2298
2994	2255	2	55	42	0	2354
2995	58	6	2348	27	0	2439
2996	35	2	66	2261	0	2364
2997	26	2362	34	61	0	2483
2998	19	54	23	2415	0	2511
2999	11	23	2399	76	0	2509
3000	17	11	2460	37	0	2525
3001	17	10	82	2451	0	2560
3002	12	11	2459	67	0	2549
3003	2364	6	75	39	0	2484
3004	61	11	2411	23	0	2506
3005	38	8	73	2346	0	2465
3006	22	7	37	2397	0	2463
3007	14	6	27	2395	0	2442
3008	2338	6	13	99	0	2456
3009	2364	3	21	58	0	2446
3010	2411	3	11	35	0	2460
3011	96	6	13	2337	0	2452
3012	40	8	13	2407	0	2468
3013	31	6	2302	93	0	2432
3014	22	6	2322	51	0	2401
3015	18	2335	79	34	0	2466
3016	34	70	38	2099	0	2241
3017	18	13	20	2027	0	2078
3018	8	2063	15	55	0	2141
3019	2051	42	7	30	0	2130
3020	40	2064	5	28	0	2137
3021	2051	45	12	12	0	2120
3022	52	26	10	2027	0	2115
3023	2033	10	6	51	0	2100
3024	51	7	9	2029	0	2096
3025	27	7	1949	50	0	2033
3026	18	7	42	1987	0	2054
3027	1901	2	23	61	0	1987
3028	50	4	13	1918	0	1985
3029	25	4	10	1917	0	1956
3030	13	2	1872	71	0	1958
3031	19	2	42	1898	0	1961
3032	13	4	23	1875	0	1915
3033	10	1859	15	66	0	1950
3034	14	36	8	1903	0	1961
3035	9	15	9	1941	0	1974
3036	15	6	6	1916	0	1943
3037	8	1856	8	75	0	1947
3038	14	52	3	1867	0	1936
3039	1796	19	5	58	0	1878
3040	39	1748	2	37	0	1826
3041	16	1636	4	14	0	1670
3042	5	1623	5	11	0	1644
3043	8	81	5	1514	0	1608
3044	4	1518	7	36	0	1565
3045	6	1551	10	13	0	1580
3046	1462	33	14	15	0	1524
3047	43	19	1391	6	0	1459
3048	1385	12	33	14	0	1444
3049	38	10	13	1417	0	1478
3050	13	10	1412	34	0	1469
3051	1377	6	40	25	0	1448
3052	35	9	1369	15	0	1428
3053	12	8	1361	17	0	1398
3054	1371	4	49	23	0	1447
3055	36	5	38	1389	0	1468
3056	22	5	1423	42	0	1492
3057	1408	2	54	31	0	1495
3058	1444	1	24	37	0	1506
3059	50	6	1441	23	0	1520
3060	1459	2	39	30	0	1530
3061	1504	1	20	26	0	1551
3062	56	5	1410	22	0	1493
3063	1421	3	38	26	0	1488
3064	1433	1	20	33	0	1487
3065	58	3	1357	23	0	1441
3066	27	9	1445	15	0	1496
3067	21	7	48	1454	0	1530
3068	19	9	1436	50	0	1514
3069	1428	8	45	32	0	1513
3070	40	15	24	1427	0	1506
3071	23	20	13	1456	0	1512
3072	28	12	1390	55	0	1485
3073	16	17	35	1402	0	1470
3074	24	13	1389	53	0	1479
3075	1414	12	35	34	0	1495
3076	1446	9	22	26	0	1503
3077	55	11	1411	24	0	1501
3078	1426	6	45	24	0	1501
3079	1465	5	18	32	0	1520
3080	64	4	1454	25	0	1547
3081	1461	2	44	36	0	1543
3082	1473	4	23	36	0	1536
3083	60	5	1450	24	0	1539
3084	1459	4	36	41	0	1540
3085	45	6	1443	34	0	1528
3086	25	11	43	1450	0	1529
3087	20	7	18	1482	0	1527
3088	11	9	18	1506	0	1544
3089	13	11	1445	72	0	1541
3090	1414	13	29	44	0	1500
3091	41	11	1426	42	0	1520
3092	20	1208	33	23	0	1284
3093	17	1146	14	19	0	1196
3094	1030	25	17	14	0	1086
3095	27	18	11	994	0	1050
3096	15	1014	3	20	0	1052
3097	930	12	4	10	0	956
3098	927	6	7	5	0	945
3099	19	944	1	6	0	970
3100	9	13	4	909	0	935
3101	7	912	4	13	0	936
3102	924	13	3	10	0	950
3103	926	7	4	7	0	944
3104	19	4	6	911	0	940
3105	921	6	1	11	0	939
3106	21	2	4	918	0	945
3107	10	3	910	13	0	936
3108	895	3	10	6	0	914
3109	18	1	887	5	0	911
3110	11	8	15	880	0	914
3111	912	1	9	13	0	935
3112	19	2	6	919	0	946
3113	10	2	926	17	0	955
3114	11	1	910	9	0	931
3115	5	14	18	885	0	922
3116	865	3	12	17	0	897
3117	12	894	7	8	0	921
3118	8	10	6	895	0	919
3119	6	5	890	11	0	912
3120	875	3	11	9	0	898
3121	909	3	7	7	0	926
3122	19	1	897	3	0	920
3123	913	0	15	4	0	932
3124	18	1	9	928	0	956
3125	13	1	934	11	0	959
3126	918	2	8	9	0	937
3127	16	3	9	930	0	958
3128	10	2	9	917	0	938
3129	935	1	4	18	0	958
3130	15	900	5	9	0	929
3131	9	922	3	3	0	937
3132	923	11	5	7	0	946
3133	923	6	6	5	0	940
3134	21	2	934	2	0	959
3135	12	0	897	3	0	912
3136	4	1	13	905	0	923
3137	928	0	15	13	0	956
3138	910	0	4	12	0	926
3139	910	0	6	8	0	924
3140	18	907	4	5	0	934
3141	11	912	3	2	0	928
3142	7	12	2	953	0	974
3143	5	7	4	938	0	954
3144	9	3	2	986	0	1000
3145	2	3	1034	18	0	1057
3146	8	2	966	6	0	982
3147	1033	1	14	7	0	1055
3148	1064	0	9	5	0	1078
3149	20	2	8	1030	0	1060
3150	11	1	4	1029	0	1045
3151	8	3	2	1049	0	1062
3152	5	1	1014	22	0	1042
3153	3	1	1010	15	0	1029
3154	5	0	15	1017	0	1037
3155	4	1	1018	16	0	1039
3156	4	964	17	7	0	992
3157	1	974	7	5	0	987
3158	979	12	4	4	0	999
3159	12	967	3	2	0	984
3160	7	12	2	985	0	1006
3161	8	2	2	979	0	991
3162	1	1015	2	17	0	1035
3163	4	11	4	1039	0	1058
3164	2	5	1010	16	0	1033
3165	2	1024	12	8	0	1046
3166	2	9	3	993	0	1007
3167	2	4	984	10	0	1000
3168	0	982	10	3	0	995
3169	4	8	1	951	0	964
3170	1	973	2	11	0	987
3171	2	12	2	970	0	986
3172	2	3	2	953	0	960
3173	1	953	1	9	0	964
3174	937	9	1	9	0	956
3175	927	3	2	6	0	938
3176	12	926	1	2	0	941
3177	5	948	1	4	0	958
3178	4	10	2	953	0	969
3179	4	6	944	9	0	963
3180	885	3	10	7	0	905
3181	913	2	4	3	0	922
3182	11	5	909	4	0	929
3183	899	0	10	4	0	913
3184	916	2	1	2	0	921
3185	12	2	906	2	0	922
3186	883	3	8	3	0	897
3187	11	3	909	4	0	927
3188	3	922	12	2	0	939
3189	943	10	2	2	0	957
3190	947	3	4	2	0	956
3191	13	3	947	1	0	964
3192	955	1	8	4	0	968
3193	1013	1	4	10	0	1028
3194	13	1	997	3	0	1014
3195	1030	1	11	7	0	1049
3196	1050	3	4	5	0	1062
3197	17	3	1013	2	0	1035
3198	1018	2	12	2	0	1034
3199	16	2	4	987	0	1009
3200	8	1	4	988	0	1001
3201	5	1	985	12	0	1003
3202	6	0	980	7	0	993
3203	7	1	15	997	0	1020
3204	6	1	11	1012	0	1030
3205	1052	0	3	13	0	1068
3206	19	2	1043	6	0	1070
3207	1038	1	15	9	0	1063
3208	20	0	5	1112	0	1137
3209	6	2	1121	16	0	1145
3210	1182	2	18	13	0	1215
3211	19	8	9	1248	0	1284
3212	6	2	1259	20	0	1287
3213	1226	1	19	7	0	1253
3214	19	5	5	1261	0	1290
3215	1273	3	3	16	0	1295
3216	20	0	1340	9	0	1369
3217	9	5	20	1248	0	1282
3218	5	1368	7	13	0	1393
3219	1393	15	5	12	0	1425
3220	1374	4	3	14	0	1395
3221	19	1413	4	6	0	1442
3222	1441	15	4	4	0	1464
3223	1418	6	3	5	0	1432
3224	1439	3	3	5	0	1450
3225	20	1420	5	3	0	1448
3226	10	17	1	1435	0	1463
3227	9	6	1446	17	0	1478
3228	7	3	18	1415	0	1443
3229	7	3	6	1454	0	1470
3230	2	3	1445	25	0	1475
3231	5	3	1438	10	0	1456
3232	12	1	21	1401	0	1435
3233	6	1466	8	17	0	1497
3234	1491	18	10	6	0	1525
3235	1485	7	4	7	0	1503
3236	24	1559	2	7	0	1592
3237	1603	19	2	5	0	1629
3238	1583	8	3	5	0	1599
3239	31	4	1592	4	0	1631
3240	1546	5	17	9	0	1577
3241	23	1622	6	6	0	1657
3242	12	17	1582	3	0	1614
3243	11	11	1536	0	0	1558
3244	9	1551	17	3	0	1580
3245	1536	16	9	4	0	1565
3246	18	7	1611	2	0	1638
3247	12	4	14	1620	0	1650
3248	6	3	1655	12	0	1676
3249	1585	7	17	10	0	1619
3250	21	3	2019	6	0	2049
3251	15	2	1999	5	0	2021
3252	2034	5	22	6	0	2067
3253	22	2114	11	4	0	2151
3254	2237	15	6	6	0	2264
3255	2305	12	10	7	0	2334
3256	29	6	7	2298	0	2340
3257	10	2507	10	12	0	2539
3258	2543	18	13	24	0	2598
3259	27	10	2577	6	0	2620
3260	2524	10	19	10	0	2563
3261	22	2597	15	8	0	2642
3262	2591	14	9	3	0	2617
3263	2597	10	5	4	0	2616
3264	27	2652	14	1	0	2694
3265	14	16	8	2706	0	2744
3266	2735	8	9	19	0	2771
3267	22	2699	6	8	0	2735
3268	17	22	5	2732	0	2776
3269	2806	5	5	25	0	2841
3270	26	4	8	2906	0	2944
3271	17	9	3	2904	0	2933
3272	11	2921	8	28	0	2968
3273	2917	24	7	20	0	2968
3274	2988	10	6	13	0	3017
3275	3020	10	6	12	0	3048
3276	44	3109	4	3	0	3160
3277	3192	26	6	9	0	3233
3278	3224	12	7	6	0	3249
3279	42	7	5	3184	0	3238
3280	23	10	4	3183	0	3220
3281	12	11	3182	33	0	3238
3282	15	5	27	3105	0	3152
3283	19	4	11	3026	0	3060
3284	12	3	3151	42	0	3208
3285	2938	5	29	25	0	2997
3286	30	9	3201	10	0	3250
3287	24	5	3313	7	0	3349
3288	18	8	30	3329	0	3385
3289	16	4	10	3368	0	3398
3290	16	3405	7	36	0	3464
3291	3449	30	3	13	0	3495
3292	3398	13	2	14	0	3427
3293	45	3386	2	10	0	3443
3294	18	3572	4	14	0	3608
3295	16	38	5	3613	0	3672
3296	10	3740	8	31	0	3789
3297	3786	35	4	26	0	3851
3298	3787	14	8	18	0	3827
3299	53	7	6	3761	0	3827
3300	20	6	9	3798	0	3833
3301	3821	3	9	53	0	3886
3302	42	1	3691	24	0	3758
3303	3676	8	35	15	0	3734
3304	46	8	3701	9	0	3764
3305	3730	3	28	11	0	3772
3306	46	6	14	3761	0	3827
3307	20	8	3876	35	0	3939
3308	17	13	3720	12	0	3762
3309	3794	11	45	21	0	3871
3310	3875	7	12	19	0	3913
3311	45	3926	7	7	0	3985
3312	26	28	6	4130	0	4190
3313	23	10	4	4225	0	4262
3314	4195	6	5	69	0	4275
3315	52	4191	6	23	0	4272
3316	4127	42	7	19	0	4195
3317	51	4028	10	6	0	4095
3318	14	4051	10	7	0	4082
3319	4088	42	6	16	0	4152
3320	50	14	4013	7	0	4084
3321	31	12	46	3985	0	4074
3322	19	7	15	4047	0	4088
3323	14	7	4048	51	0	4120
3324	20	4	42	3985	0	4051
3325	40	16	16	3515	0	3587
3326	9	4030	10	48	0	4097
3327	4041	48	4	38	0	4131
3328	55	13	4122	16	0	4206
3329	3956	15	39	12	0	4022
3330	51	4124	15	3	0	4193
3331	18	45	7	4192	0	4262
3332	4338	16	2	55	0	4411
3333	54	10	3	4334	0	4401
3334	23	2	8	4377	0	4410
3335	13	4	4338	57	0	4412
3336	4164	5	39	34	0	4242
3337	4317	5	15	27	0	4364
3338	56	4	4335	11	0	4406
3339	27	5	40	4300	0	4372
3340	17	6	4369	48	0	4440
3341	4304	5	51	24	0	4384
3342	4474	6	10	21	0	4511
3343	57	9	7	4431	0	4504
3344	4463	6	4	59	0	4532
3345	53	6	4645	22	0	4726
3346	24	4	42	4563	0	4633
3347	22	2	18	4559	0	4601
3348	17	2	7	4675	0	4701
3349	12	2	9	4669	0	4692
3350	4244	4	7	69	0	4324
3351	49	4	4163	22	0	4238
3352	22	2	46	4206	0	4276
3353	18	4	4110	50	0	4182
3354	14	3	4014	18	0	4049
3355	13	4	49	4003	0	4069
3356	14	6	21	4048	0	4089
3357	3871	2	14	61	0	3948
3358	47	2	5	3897	0	3951
3359	14	5	5	3887	0	3911
3360	21	4	5	3941	0	3971
3361	3883	0	11	68	0	3962
3362	3909	1	2	32	0	3944
3363	3931	4	6	24	0	3965
3364	3823	3	11	17	0	3854
3365	59	3932	9	17	0	4017
3366	22	48	6	3988	0	4064
3367	20	11	5	4040	0	4076
3368	4095	11	6	77	0	4189
3369	65	4253	4	38	0	4360
3370	31	56	2	4493	0	4582
3371	14	19	4957	73	0	5063
3372	5592	9	78	44	0	5723
3373	120	5931	22	33	0	6106
3374	6250	111	20	20	0	6401
3375	6538	40	6	23	0	6607
3376	198	22	3	6438	0	6661
3377	69	16	6427	148	0	6660
3378	65	11	131	6549	0	6756
3379	6607	16	46	172	0	6841
3380	183	5	24	6602	0	6814
3381	6600	13	21	182	0	6816
3382	173	6536	15	75	0	6799
3383	6841	145	14	49	0	7049
3384	201	46	12	6794	0	7053
3385	101	28	10	7148	0	7287
3386	7138	18	12	217	0	7385
3387	7068	13	14	85	0	7180
3388	7138	15	5	64	0	7222
3389	7105	8	14	51	0	7178
3390	7113	10	7	48	0	7178
3391	267	10	9	6862	0	7148
3392	114	19	6595	172	0	6900
3393	82	6675	135	78	0	6970
3394	6637	137	40	60	0	6874
3395	189	46	6422	32	0	6689
3396	6385	24	130	42	0	6581
3397	194	6338	54	34	0	6620
3398	6539	148	29	35	0	6751
3399	228	54	16	6457	0	6755
3400	122	36	18	6585	0	6761
3401	86	21	6473	197	0	6777
3402	101	20	138	6462	0	6721
3403	72	22	6542	186	0	6822
3404	69	14	6444	98	0	6625
3405	6530	16	190	81	0	6817
3406	6736	22	83	59	0	6900
3407	213	17	6450	67	0	6747
3408	6449	15	154	71	0	6689
3409	6598	27	70	64	0	6759
3410	268	20	6315	38	0	6641
3411	133	6206	154	51	0	6544
3412	132	150	75	6262	0	6619
3413	6341	50	47	176	0	6614
3414	6452	25	35	87	0	6599
3415	6448	18	30	73	0	6569
3416	6490	15	41	50	0	6596
3417	6487	26	30	51	0	6594
3418	284	25	6230	38	0	6577
3419	161	25	6396	38	0	6620
3420	146	38	172	6367	0	6723
3421	6501	42	87	172	0	6802
3422	6644	32	62	92	0	6830
3423	6660	34	44	88	0	6826
3424	6413	27	54	98	0	6592
3425	273	6349	59	89	0	6770
3426	162	6690	47	90	0	6989
3427	6689	166	54	102	0	7011
3428	6741	64	50	98	0	6953
3429	265	6614	30	92	0	7001
3430	6744	160	49	73	0	7026
3431	265	78	6616	65	0	7024
3432	194	53	146	6508	0	6901
3433	171	35	6570	183	0	6959
3434	156	39	6532	97	0	6824
3435	188	41	190	6546	0	6965
3436	180	31	96	6663	0	6970
3437	188	28	6651	206	0	7073
3438	163	39	163	6487	0	6852
3439	149	26	95	6733	0	7003
3440	6697	43	69	230	0	7039
3441	6759	46	67	134	0	7006
3442	284	42	83	6677	0	7086
3443	199	41	6642	187	0	7069
3444	158	6665	172	116	0	7111
3445	6716	143	105	89	0	7053
3446	251	73	6753	87	0	7164
3447	169	6427	180	107	0	6883
3448	126	6828	110	93	0	7157
3449	6929	158	86	103	0	7276
3450	7063	78	81	89	0	7311
3451	286	41	92	6913	0	7332
3452	185	53	7314	179	0	7731
3453	174	47	188	7274	0	7683
3454	177	45	108	7422	0	7752
3455	171	36	85	7531	0	7823
3456	7457	44	72	229	0	7802
3457	274	7216	76	108	0	7674
3458	172	7699	86	70	0	8027
3459	140	185	66	7677	0	8068
3460	123	92	77	7917	0	8209
3461	7842	56	61	250	0	8209
3462	7845	43	54	138	0	8080
3463	7881	34	50	122	0	8087
3464	311	7647	46	85	0	8089
3465	7675	130	63	79	0	7947
3466	266	112	77	7513	0	7968
3467	180	34	7427	189	0	7830
3468	139	41	7026	109	0	7315
3469	7054	33	161	101	0	7349
3470	217	26	6818	62	0	7123
3471	132	31	6199	51	0	6413
3472	5331	21	95	38	0	5485
3473	85	9	5306	18	0	5418
3474	39	10	5100	14	0	5163
3475	38	65	58	4756	0	4917
3476	11	4	5092	24	0	5131
3477	20	5	25	4857	0	4907
3478	15	7	10	4816	0	4848
3479	12	4	5108	23	0	5147
3480	5	5138	28	18	0	5189
3481	5180	22	12	28	0	5242
3482	28	7	5277	6	0	5318
3483	13	6	5129	12	0	5160
3484	4571	9	42	17	0	4639
3485	26	4	4964	8	0	5002
3486	8	4799	22	5	0	4834
3487	19	4313	21	6	0	4359
3488	7	20	6	4927	0	4960
3489	10	4	2	4854	0	4870
3490	5065	2	7	44	0	5118
3491	5034	2	3	24	0	5063
3492	5086	4	2	16	0	5108
3493	28	4	3	5075	0	5110
3494	5155	3	5	38	0	5201
3495	5077	5	3	26	0	5111
3496	24	7	5154	7	0	5192
3497	17	8	4855	6	0	4886
3498	11	5135	22	12	0	5180
3499	7	17	11	5233	0	5268
3500	5249	7	6	23	0	5285
3501	20	5136	7	13	0	5176
3502	14	15	8	5306	0	5343
3503	5302	7	7	32	0	5348
3504	5270	3	5	27	0	5305
3505	26	5327	8	8	0	5369
3506	5365	20	2	16	0	5403
3507	5364	5	2	19	0	5390
3508	33	4	5	5377	0	5419
3509	11	9	5404	20	0	5444
3510	10	5241	19	15	0	5285
3511	11	5325	8	9	0	5353
3512	5260	17	8	20	0	5305
3513	23	15	2	5339	0	5379
3514	15	6	5420	18	0	5459
3515	8	5351	19	12	0	5390
3516	5416	18	10	22	0	5466
3517	5419	7	6	22	0	5454
3518	26	6	5467	7	0	5506
3519	27	4	19	5316	0	5366
3520	13	4	8	5565	0	5590
3521	11	5	5738	29	0	5783
3522	5647	8	31	30	0	5716
3523	6822	4	9	19	0	6854
3524	95	5	7	8187	0	8294
3525	27	8735	15	145	0	8922
3526	52	162	13	9350	0	9577
3527	23	59	9298	218	0	9598
3528	9155	49	176	108	0	9488
3529	222	30	69	9600	0	9921
3530	73	24	9480	230	0	9807
3531	9100	26	212	119	0	9457
3532	251	8	93	9453	0	9805
3533	134	7	77	9468	0	9686
3534	9378	7	40	298	0	9723
3535	221	9335	35	156	0	9747
3536	9450	194	31	123	0	9798
3537	309	66	15	9395	0	9785
3538	9386	68	30	267	0	9751
3539	288	45	9172	128	0	9633
3540	141	9182	213	91	0	9627
3541	130	217	80	9413	0	9840
3542	9403	66	71	273	0	9813
3543	240	9336	65	124	0	9765
3544	160	223	41	9420	0	9844
3545	9440	99	41	289	0	9869
3546	9348	79	26	161	0	9614
3547	367	51	23	9204	0	9645
3548	204	59	9048	277	0	9588
3549	143	57	9020	142	0	9362
3550	9037	33	275	156	0	9501
3551	299	8951	139	95	0	9484
3552	140	8887	118	77	0	9222
3553	8752	264	84	100	0	9200
3554	274	8948	75	66	0	9363
3555	173	284	60	8930	0	9447
3556	167	136	32	9144	0	9479
3557	8991	124	28	351	0	9494
3558	8790	80	24	181	0	9075
3559	8819	71	25	154	0	9069
3560	379	69	8386	123	0	8957
3561	253	38	225	8468	0	8984
3562	175	40	8442	279	0	8936
3563	169	40	8304	125	0	8638
3564	132	53	8587	117	0	8889
3565	115	58	354	8343	0	8870
3566	104	36	8596	276	0	9012
3567	69	73	8674	140	0	8956
3568	81	51	380	8492	0	9004
3569	8498	30	206	337	0	9071
3570	305	40	8625	148	0	9118
3571	172	32	311	8447	0	8962
3572	176	32	168	8681	0	9057
3573	112	32	8688	352	0	9184
3574	124	28	287	8544	0	8983
3575	107	43	8577	364	0	9091
3576	95	48	342	8368	0	8853
3577	95	40	170	8535	0	8840
3578	97	48	137	8556	0	8838
3579	81	38	135	8525	0	8779
3580	8077	24	105	474	0	8680
3581	8157	28	97	317	0	8599
3582	359	26	7974	216	0	8575
3583	196	7855	288	174	0	8513
3584	155	213	8093	159	0	8620
3585	130	75	8071	140	0	8416
3586	7908	68	390	108	0	8474
3587	297	8095	228	120	0	8740
3588	8217	254	204	107	0	8782
3589	326	8406	160	107	0	8999
3590	8429	289	152	123	0	8993
3591	8690	118	133	106	0	9047
3592	397	99	101	8413	0	9010
3593	237	8442	92	308	0	9079
3594	217	273	81	8532	0	9103
3595	152	130	85	8751	0	9118
3596	133	115	8374	406	0	9028
3597	104	8428	305	256	0	9093
3598	80	273	156	8594	0	9103
3599	8263	116	139	391	0	8909
3600	8627	102	113	236	0	9078
3601	8784	70	81	203	0	9138
3602	419	8456	102	132	0	9109
3603	8674	303	82	134	0	9193
3604	425	8968	75	137	0	9605
3605	251	334	77	9395	0	10057
3606	197	159	9325	352	0	10033
3607	165	132	347	9343	0	9987
3608	115	9307	157	417	0	9996
3609	105	341	155	9441	0	10042
3610	104	162	102	9604	0	9972
3611	75	9412	91	504	0	10082
3612	9477	361	97	270	0	10205
3613	390	162	61	9438	0	10051
3614	181	137	9132	435	0	9885
3615	168	112	318	9317	0	9915
3616	154	92	129	9628	0	10003
3617	105	102	9261	523	0	9991
3618	132	86	355	9077	0	9650
3619	81	9142	160	512	0	9895
3620	106	332	9243	276	0	9957
3621	151	161	9212	227	0	9751
3622	68	8897	437	198	0	9600
3623	61	8132	190	146	0	8529
3624	44	6786	108	72	0	7010
3625	5741	240	173	68	0	6222
3626	5460	71	43	54	0	5628
3627	5444	44	33	35	0	5556
3628	196	27	30	5352	0	5605
3629	72	17	5293	169	0	5551
3630	54	35	152	5288	0	5529
3631	58	25	46	5411	0	5540
3632	5307	35	22	205	0	5569
3633	5386	18	33	76	0	5513
3634	184	5322	23	49	0	5578
3635	5327	147	17	56	0	5547
3636	5403	56	19	40	0	5518
3637	5438	35	16	44	0	5533
3638	199	29	5226	37	0	5491
3639	83	12	5281	32	0	5408
3640	73	16	160	5195	0	5444
3641	34	22	5196	146	0	5398
3642	5051	28	144	66	0	5289
3643	5233	16	46	46	0	5341
3644	193	14	5006	30	0	5243
3645	4923	15	138	22	0	5098
3646	162	4957	55	29	0	5203
3647	5024	132	34	31	0	5221
3648	149	44	21	4952	0	5166
3649	67	25	26	4885	0	5003
3650	48	4915	12	163	0	5138
3651	4911	128	24	59	0	5122
3652	4958	48	28	43	0	5077
3653	174	4902	18	21	0	5115
3654	76	135	18	4713	0	4942
3655	65	42	16	4790	0	4913
3656	41	4715	11	175	0	4942
3657	42	140	15	4744	0	4941
3658	41	51	22	4876	0	4990
3659	4722	29	13	190	0	4954
3660	4781	27	17	84	0	4909
3661	174	29	4664	48	0	4915
3662	4645	12	130	56	0	4843
3663	156	27	4693	38	0	4914
3664	79	38	139	4619	0	4875
3665	42	28	4639	148	0	4857
3666	36	4536	143	72	0	4787
3667	59	129	47	4469	0	4704
3668	41	42	19	4604	0	4706
3669	4482	24	30	168	0	4704
3670	141	22	25	4392	0	4580
3671	56	15	4230	154	0	4455
3672	4237	28	114	69	0	4448
3673	4352	13	56	41	0	4462
3674	4380	25	32	45	0	4482
3675	4379	26	22	37	0	4464
3676	199	22	17	4455	0	4693
3677	84	12	15	4667	0	4778
3678	57	20	20	4934	0	5031
3679	45	19	24	4983	0	5071
3680	4842	15	18	218	0	5093
3681	4902	15	19	98	0	5034
3682	201	11	25	4584	0	4821
3683	87	4608	16	155	0	4866
3684	4667	128	21	80	0	4896
3685	157	57	4618	43	0	4875
3686	77	4620	124	50	0	4871
3687	4399	134	46	48	0	4627
3688	167	4391	24	24	0	4606
3689	74	127	4262	35	0	4498
3690	4240	41	132	48	0	4461
3691	4298	30	51	39	0	4418
3692	181	18	4148	38	0	4385
3693	98	17	136	4186	0	4437
3694	78	23	44	4236	0	4381
3695	63	4182	26	165	0	4436
3696	48	144	22	4228	0	4442
3697	4104	46	26	159	0	4335
3698	165	4135	18	72	0	4390
3699	72	128	27	4024	0	4251
3700	58	51	22	4127	0	4258
3701	47	26	3940	174	0	4187
3702	27	3967	134	76	0	4204
3703	3672	130	44	53	0	3899
3704	116	3171	18	28	0	3333
3705	45	2863	17	15	0	2940
3706	2761	86	37	18	0	2902
3707	82	29	14	2669	0	2794
3708	36	20	4	2716	0	2776
3709	2662	20	8	92	0	2782
3710	90	6	5	2691	0	2792
3711	48	9	5	2725	0	2787
3712	2711	17	8	94	0	2830
3713	79	10	2	2721	0	2812
3714	32	2677	13	89	0	2811
3715	2731	74	9	42	0	2856
3716	80	33	2679	22	0	2814
3717	41	2612	63	14	0	2730
3718	22	78	17	2508	0	2625
3719	12	31	2433	60	0	2536
3720	22	11	2411	29	0	2473
3721	13	133	68	2167	0	2381
3722	2104	15	20	52	0	2191
3723	56	2	13	2073	0	2144
3724	20	7	6	2072	0	2105
3725	17	7	3	2086	0	2113
3726	19	8	4	2090	0	2121
3727	11	10	6	2099	0	2126
3728	9	13	1959	65	0	2046
3729	16	5	1940	32	0	1993
3730	10	5	62	1939	0	2016
3731	4	15	1948	53	0	2020
3732	10	1927	46	35	0	2018
3733	11	39	29	1926	0	2005
3734	3	24	1897	54	0	1978
3735	1796	8	43	39	0	1886
3736	46	1829	23	22	0	1920
3737	16	1817	15	24	0	1872
3738	12	1874	7	25	0	1918
3739	12	50	9	1834	0	1905
3740	1805	22	5	61	0	1893
3741	41	9	8	1849	0	1907
3742	1760	4	23	59	0	1846
3743	44	1756	11	32	0	1843
3744	1808	41	8	30	0	1887
3745	49	22	15	1797	0	1883
3746	24	20	7	1814	0	1865
3747	11	1783	10	66	0	1870
3748	16	43	14	1796	0	1869
3749	14	24	7	1825	0	1870
3750	11	21	6	1821	0	1859
3751	1753	16	9	66	0	1844
3752	1656	16	8	41	0	1721
3753	50	11	1714	30	0	1805
3754	1744	12	38	28	0	1822
3755	50	13	1748	26	0	1837
3756	31	8	38	1752	0	1829
3757	18	15	18	1785	0	1836
3758	21	7	11	1803	0	1842
3759	7	7	1722	85	0	1821
3760	14	14	44	1764	0	1836
3761	8	15	1787	56	0	1866
3762	16	7	41	1803	0	1867
3763	1765	12	22	68	0	1867
3764	44	11	1760	38	0	1853
3765	1748	7	44	28	0	1827
3766	50	5	24	1789	0	1868
3767	1770	8	21	57	0	1856
3768	54	1759	9	35	0	1857
3769	22	37	15	1808	0	1882
3770	11	20	1838	62	0	1931
3771	20	6	38	1849	0	1913
3772	12	49	24	1792	0	1877
3773	9	1765	14	66	0	1854
3774	18	44	1744	35	0	1841
3775	6	1740	42	23	0	1811
3776	1456	42	17	22	0	1537
3777	32	1489	9	21	0	1551
3778	1263	28	27	11	0	1329
3779	1263	13	6	16	0	1298
3780	1269	2	3	13	0	1287
3781	40	3	6	1246	0	1295
3782	14	4	1248	36	0	1302
3783	6	3	26	1239	0	1274
3784	5	1256	18	29	0	1308
3785	5	31	4	1272	0	1312
3786	1227	15	4	40	0	1286
3787	29	1223	6	18	0	1276
3788	14	24	5	1189	0	1232
3789	8	13	3	1209	0	1233
3790	1173	5	6	33	0	1217
3791	26	8	1160	17	0	1211
3792	16	1112	21	10	0	1159
3793	6	20	11	1069	0	1106
3794	6	8	1041	20	0	1075
3795	5	6	16	1002	0	1029
3796	6	988	7	19	0	1020
3797	7	14	9	1036	0	1066
3798	6	15	1	1025	0	1047
3799	3	2	2	1038	0	1045
3800	2	3	1002	24	0	1031
3801	975	3	13	16	0	1007
3802	17	4	8	1065	0	1094
3803	1135	4	3	16	0	1158
3804	1204	5	1	15	0	1225
3805	1238	2	4	11	0	1255
3806	1245	3	5	9	0	1262
3807	1262	2	1	10	0	1275
3808	28	5	2	1231	0	1266
3809	11	1206	5	24	0	1246
3810	8	17	5	1212	0	1242
3811	2	1207	5	25	0	1239
3812	5	22	4	1128	0	1159
3813	1124	9	0	23	0	1156
3814	17	3	2	1090	0	1112
3815	12	0	1075	19	0	1106
3816	1058	1	14	13	0	1086
3817	18	1074	10	4	0	1106
3818	1080	14	4	5	0	1103
3819	1070	6	6	7	0	1089
3820	1047	6	0	4	0	1057
3821	24	1069	0	2	0	1095
3822	10	13	0	1076	0	1099
3823	5	7	0	1092	0	1104
3824	2	2	1073	21	0	1098
3825	6	2	13	1046	0	1067
3826	5	0	7	1025	0	1037
3827	3	3	3	1055	0	1064
3828	3	1057	0	22	0	1082
3829	1062	19	1	7	0	1089
3830	1038	7	0	8	0	1053
3831	27	3	1068	1	0	1099
3832	10	1078	13	1	0	1102
3833	4	18	7	1090	0	1119
3834	5	8	1	1110	0	1124
3835	4	6	1	1104	0	1115
3836	6	0	3	1122	0	1131
3837	7	4	0	1120	0	1131
3838	2	0	1092	31	0	1125
3839	2	4	1052	11	0	1069
3840	1097	1	20	10	0	1128
3841	1155	3	9	3	0	1170
3842	1169	0	5	5	0	1179
3843	26	3	3	1167	0	1199
3844	9	3	1123	22	0	1157
3845	1137	2	17	15	0	1171
3846	1167	3	5	9	0	1184
3847	26	1	1124	6	0	1157
3848	1138	1	17	6	0	1162
3849	24	4	1248	7	0	1283
3850	16	0	26	1240	0	1282
3851	10	2	1264	23	0	1299
3852	1239	2	25	14	0	1280
3853	1300	1	7	10	0	1318
3854	1314	1	5	6	0	1326
3855	1330	1	3	9	0	1343
3856	35	5	1344	1	0	1385
3857	18	1360	23	5	0	1406
3858	1377	21	8	8	0	1414
3859	1393	11	4	8	0	1416
3860	32	4	1398	5	0	1439
3861	20	4	23	1352	0	1399
3862	10	2	12	1412	0	1436
3863	13	0	1366	31	0	1410
3864	1331	2	27	12	0	1372
3865	1391	1	14	5	0	1411
3866	41	1407	4	3	0	1455
3867	1496	25	4	7	0	1532
3868	1503	8	3	5	0	1519
3869	1502	4	3	3	0	1512
3870	1480	4	2	6	0	1492
3871	38	7	1442	1	0	1488
3872	1434	0	26	11	0	1471
3873	38	16	11	1429	0	1494
3874	14	1460	7	25	0	1506
3875	8	23	1438	10	0	1479
3876	10	1447	29	4	0	1490
3877	12	39	5	1358	0	1414
3878	4	8	1386	21	0	1419
3879	1305	3	23	5	0	1336
3880	28	2	1368	1	0	1399
3881	1376	4	23	3	0	1406
3882	26	5	5	1378	0	1414
3883	13	0	6	1391	0	1410
3884	5	1367	5	25	0	1402
3885	7	1408	3	4	0	1422
3886	9	20	2	1449	0	1480
3887	1445	6	2	31	0	1484
3888	1446	2	7	5	0	1460
3889	1448	5	5	5	0	1463
3890	28	2	1453	5	0	1488
3891	1451	0	22	7	0	1480
3892	30	2	1483	0	0	1515
3893	9	4	1423	5	0	1441
3894	1455	1	24	5	0	1485
3895	1512	0	8	5	0	1525
3896	30	1	1547	4	0	1582
3897	9	6	24	1521	0	1560
3898	8	5	6	1581	0	1600
3899	1598	1	4	22	0	1625
3900	1587	0	2	9	0	1598
3901	28	2	1663	3	0	1696
3902	9	1599	19	6	0	1633
3903	5	1575	4	4	0	1588
3904	1531	15	5	4	0	1555
3905	26	2	4	1516	0	1548
3906	5	1	5	1547	0	1558
3907	4	3	3	1559	0	1569
3908	1534	2	0	24	0	1560
3909	17	4	3	1562	0	1586
3910	1561	0	2	20	0	1583
3911	1597	2	1	9	0	1609
3912	20	1786	3	2	0	1811
3913	12	16	1	1992	0	2021
3914	6	3	2011	24	0	2044
3915	2006	2	20	7	0	2035
3916	2062	4	6	6	0	2078
3917	2065	4	3	6	0	2078
3918	30	1	2075	4	0	2110
3919	12	1	24	2109	0	2146
3920	2155	2	4	22	0	2183
3921	2101	0	3	9	0	2113
3922	2091	1	4	3	0	2099
3923	30	2052	4	4	0	2090
3924	9	2156	3	3	0	2171
3925	10	27	1	2208	0	2246
3926	7	5	3	2203	0	2218
3927	5	2184	2	28	0	2219
3928	2210	20	3	10	0	2243
3929	23	5	2270	6	0	2304
3930	9	3	19	2274	0	2305
3931	10	3	5	2282	0	2300
3932	7	3	2266	24	0	2300
3933	2203	1	18	11	0	2233
3934	2315	2	6	7	0	2330
3935	25	2266	5	2	0	2298
3936	2305	20	3	7	0	2335
3937	25	11	2406	4	0	2446
3938	2453	3	19	19	0	2494
3939	22	4	2525	7	0	2558
3940	2478	0	32	11	0	2521
3941	2531	1	10	8	0	2550
3942	2524	0	4	13	0	2541
3943	2499	2	7	10	0	2518
3944	31	2529	4	4	0	2568
3945	2602	19	2	10	0	2633
3946	2658	4	3	8	0	2673
3947	35	5	2648	4	0	2692
3948	2667	3	20	8	0	2698
3949	33	6	5	2729	0	2773
3950	12	2	2727	20	0	2761
3951	2766	1	21	13	0	2801
3952	26	6	7	2810	0	2849
3953	2857	2	4	31	0	2894
3954	3094	2	5	19	0	3120
3955	24	6	3194	8	0	3232
3956	3176	2	18	12	0	3208
3957	3266	3	8	7	0	3284
3958	3282	3	6	8	0	3299
3959	3339	1	6	9	0	3355
3960	33	2	5	3254	0	3294
3961	15	3215	2	20	0	3252
3962	3164	19	6	17	0	3206
3963	3316	6	2	8	0	3332
3964	3356	2	4	14	0	3376
3965	29	6	3337	2	0	3374
3966	20	3295	22	3	0	3340
3967	15	18	11	3301	0	3345
3968	20	3	4	3340	0	3367
3969	9	6	3422	22	0	3459
3970	21	5	26	3456	0	3508
3971	13	0	3518	34	0	3565
3972	12	1	31	3487	0	3531
3973	16	2	12	3519	0	3549
3974	11	5	3637	41	0	3694
3975	3552	1	33	18	0	3604
3976	3745	1	16	22	0	3784
3977	46	6	3776	5	0	3833
3978	3745	4	33	15	0	3797
3979	3849	1	7	16	0	3873
3980	47	3	3881	7	0	3938
3981	27	2	35	3834	0	3898
3982	18	5	10	3897	0	3930
3983	3906	0	11	47	0	3964
3984	41	3896	8	14	0	3959
3985	3615	37	14	27	0	3693
3986	3925	12	7	18	0	3962
3987	51	4044	5	7	0	4107
3988	4106	35	7	15	0	4163
3989	4131	8	7	11	0	4157
3990	51	4029	7	7	0	4094
3991	29	34	4	4115	0	4182
3992	17	4107	15	37	0	4176
3993	20	40	4	4174	0	4238
3994	11	10	4184	49	0	4254
3995	14	15	4079	17	0	4125
3996	4067	7	46	24	0	4144
3997	4208	2	19	17	0	4246
3998	65	3	4224	10	0	4302
3999	4205	6	44	20	0	4275
4000	4329	2	16	14	0	4361
4001	4258	3	12	10	0	4283
4002	58	4319	9	11	0	4397
4003	30	39	7	4436	0	4512
4004	4415	15	5	56	0	4491
4005	4390	8	7	30	0	4435
4006	58	6	4447	22	0	4533
4007	26	4	50	4411	0	4491
4008	30	4	12	4461	0	4507
4009	22	4407	12	52	0	4493
4010	22	4580	14	18	0	4634
4011	34	76	3	4463	0	4576
4012	15	4418	11	52	0	4496
4013	4292	46	8	18	0	4364
4014	63	4519	5	6	0	4593
4015	4590	54	16	20	0	4680
4016	70	20	4698	8	0	4796
4017	5126	9	69	31	0	5235
4018	5435	7	15	21	0	5478
4019	5463	1	15	12	0	5491
4020	5361	4	12	27	0	5404
4021	128	5259	9	8	0	5404
4022	52	86	6	5383	0	5527
4023	37	32	4	5392	0	5465
4024	29	19	5357	112	0	5517
4025	27	14	89	5340	0	5470
4026	35	9	25	5448	0	5517
4027	5474	5	14	129	0	5622
4028	113	5472	20	36	0	5641
4029	51	88	10	5514	0	5663
4030	52	23	15	5622	0	5712
4031	53	17	11	5680	0	5761
4032	5629	15	10	139	0	5793
4033	135	9	9	5658	0	5811
4034	5663	14	18	134	0	5829
4035	141	21	6	5664	0	5832
4036	52	15	18	5777	0	5862
4037	30	10	5438	161	0	5639
4038	5199	5	111	75	0	5390
4039	122	5385	36	55	0	5598
4040	5589	95	20	51	0	5755
4041	135	32	14	5527	0	5708
4042	64	33	9	5620	0	5726
4043	5548	21	8	170	0	5747
4044	5583	7	12	83	0	5685
4045	155	11	9	5673	0	5848
4046	82	17	5679	125	0	5903
4047	50	19	5630	63	0	5762
4048	53	5959	122	43	0	6177
4049	5981	129	47	49	0	6206
4050	6011	43	35	47	0	6136
4051	181	23	28	5920	0	6152
4052	86	6071	9	127	0	6293
4053	68	134	4	6078	0	6284
4054	77	39	10	5846	0	5972
4055	33	5604	10	197	0	5844
4056	5651	145	13	88	0	5897
4057	166	39	13	5669	0	5887
4058	62	5649	23	154	0	5888
4059	48	5953	29	56	0	6086
4060	5922	150	28	57	0	6157
4061	157	60	5829	44	0	6090
4062	5889	68	133	39	0	6129
4063	204	47	39	5918	0	6208
4064	107	18	20	5977	0	6122
4065	58	5872	26	181	0	6137
4066	73	171	9	5974	0	6227
4067	46	51	5998	203	0	6298
4068	38	5847	137	98	0	6120
4069	36	6070	39	49	0	6194
4070	5888	159	26	65	0	6138
4071	144	5919	30	46	0	6139
4072	60	166	8	5926	0	6160
4073	36	5975	20	146	0	6177
4074	72	137	16	6008	0	6233
4075	42	59	23	6131	0	6255
4076	43	33	5873	203	0	6152
4077	34	52	114	5851	0	6051
4078	48	24	36	6008	0	6116
4079	5846	42	25	207	0	6120
4080	151	37	5802	90	0	6080
4081	93	35	136	5950	0	6214
4082	56	49	5953	183	0	6241
4083	5905	47	141	89	0	6182
4084	171	6164	66	69	0	6470
4085	6498	149	27	116	0	6790
4086	170	58	41	6703	0	6972
4087	99	55	21	6782	0	6957
4088	40	48	6647	242	0	6977
4089	6329	21	149	146	0	6645
4090	174	6748	65	91	0	7078
4091	6768	160	34	117	0	7079
4092	203	63	39	6835	0	7140
4093	108	6847	27	187	0	7169
4094	6914	182	30	101	0	7227
4095	197	7013	29	74	0	7313
4096	87	156	30	7055	0	7328
4097	77	81	18	7112	0	7288
4098	80	53	23	7037	0	7193
4099	54	6788	29	235	0	7106
4100	58	164	18	6947	0	7187
4101	57	63	23	7079	0	7222
4102	6760	50	29	254	0	7093
4103	6830	61	26	129	0	7046
4104	6848	54	18	91	0	7011
4105	261	45	6709	82	0	7097
4106	6806	52	143	82	0	7083
4107	7008	55	62	76	0	7201
4108	6744	48	32	105	0	6929
4109	215	53	6416	88	0	6772
4110	6658	46	131	70	0	6905
4111	218	55	47	6817	0	7137
4112	100	45	6828	209	0	7182
4113	75	6815	155	110	0	7155
4114	100	230	47	6565	0	6942
4115	48	6457	42	191	0	6738
4116	53	6550	47	82	0	6732
4117	5970	138	79	60	0	6247
4118	123	48	16	5938	0	6125
4119	5969	39	16	126	0	6150
4120	130	34	18	5940	0	6122
4121	5963	21	11	134	0	6129
4122	124	20	15	5960	0	6119
4123	5961	15	19	127	0	6122
4124	124	29	5696	58	0	5907
4125	79	29	97	5762	0	5967
4126	40	34	5837	128	0	6039
4127	57	36	5480	62	0	5635
4128	41	28	5743	41	0	5853
4129	51	39	115	5672	0	5877
4130	36	26	5727	112	0	5901
4131	5628	19	106	68	0	5821
4132	125	19	46	5752	0	5942
4133	51	22	6237	137	0	6447
4134	46	18	104	6213	0	6381
4135	34	16	37	6370	0	6457
4136	37	17	6548	146	0	6748
4137	45	17	118	6469	0	6649
4138	47	14	39	6575	0	6675
4139	35	6555	32	133	0	6755
4140	6605	84	27	66	0	6782
4141	6637	28	21	65	0	6751
4142	138	16	6459	49	0	6662
4143	6376	21	110	58	0	6565
4144	126	18	6499	29	0	6672
4145	60	13	6321	36	0	6430
4146	37	12	6396	38	0	6483
4147	41	91	119	6112	0	6363
4148	27	5	6281	85	0	6398
4149	34	17	74	6126	0	6251
4150	25	13	27	6237	0	6302
4151	35	1	19	6289	0	6344
4152	34	11	16	6272	0	6333
4153	6181	6	19	95	0	6301
4154	6195	8	15	57	0	6275
4155	84	6247	24	32	0	6387
4156	35	55	18	6344	0	6452
4157	23	20	6387	67	0	6497
4158	18	6538	71	48	0	6675
4159	20	76	35	6780	0	6911
4160	22	24	6870	102	0	7018
4161	27	22	91	6643	0	6783
4162	17	8	6813	103	0	6941
4163	23	14	6694	41	0	6772
4164	21	9	107	6863	0	7000
4165	25	10	39	6946	0	7020
4166	6947	7	30	140	0	7124
4167	101	3	24	6963	0	7091
4168	6946	7	18	143	0	7114
4169	97	6835	26	49	0	7007
4170	33	7072	20	37	0	7162
4171	27	93	15	7268	0	7403
4172	7256	27	24	122	0	7429
4173	93	7285	23	47	0	7448
4174	42	95	19	7468	0	7624
4175	7568	24	19	131	0	7742
4176	7621	23	18	62	0	7724
4177	7514	15	24	55	0	7608
4178	7459	12	19	51	0	7541
4179	7645	9	18	45	0	7717
4180	143	15	7345	33	0	7536
4181	46	17	7270	27	0	7360
4182	39	7290	97	31	0	7457
4183	63	95	40	7287	0	7485
4184	35	28	7334	85	0	7482
4185	35	22	7053	24	0	7134
4186	39	25	87	6994	0	7145
4187	24	10	7372	91	0	7497
4188	15	17	7265	21	0	7318
4189	18	8961	89	34	0	9102
4190	9113	147	30	25	0	9315
4191	143	10162	28	19	0	10352
4192	72	200	16	10679	0	10967
4193	10818	52	18	219	0	11107
4194	219	10892	25	61	0	11197
4195	75	220	24	10856	0	11175
4196	44	53	10890	215	0	11202
4197	10809	45	208	71	0	11133
4198	11148	31	53	68	0	11300
4199	11356	16	39	57	0	11468
4200	303	20	29	11228	0	11580
4201	95	21	11182	245	0	11543
4202	53	11252	226	56	0	11587
4203	67	220	63	11378	0	11728
4204	11309	56	39	258	0	11662
4205	250	48	11220	53	0	11571
4206	78	10993	225	56	0	11352
4207	58	222	11257	41	0	11578
4208	11095	63	249	47	0	11454
4209	11550	47	77	57	0	11731
4210	11581	31	45	52	0	11709
4211	325	25	11178	17	0	11545
4212	116	10849	232	25	0	11222
4213	106	220	69	10915	0	11310
4214	80	54	51	11119	0	11304
4215	72	41	43	11152	0	11308
4216	61	43	10855	300	0	11259
4217	10561	24	242	128	0	10955
4218	262	34	10918	66	0	11280
4219	10928	32	265	77	0	11302
4220	11245	28	91	61	0	11425
4221	11269	23	58	66	0	11416
4222	11040	23	53	62	0	11178
4223	358	25	10800	37	0	11220
4224	168	23	255	10842	0	11288
4225	106	47	10815	243	0	11211
4226	86	10447	268	87	0	10888
4227	84	10983	85	78	0	11230
4228	10824	286	59	92	0	11261
4229	10714	97	64	75	0	10950
4230	302	10948	62	71	0	11383
4231	11061	275	59	89	0	11484
4232	343	111	9657	76	0	10187
4233	10431	82	205	71	0	10789
4234	344	10543	72	44	0	11003
4235	10852	275	52	65	0	11244
4236	10799	86	69	51	0	11005
4237	417	78	53	10379	0	10927
4238	195	59	64	10681	0	10999
4239	10564	48	71	347	0	11030
4240	353	85	67	10571	0	11076
4241	10554	72	81	346	0	11053
4242	391	73	53	10556	0	11073
4243	10461	47	66	344	0	10918
4244	10455	52	50	139	0	10696
4245	414	9917	83	94	0	10508
4246	203	10335	68	72	0	10678
4247	10046	299	83	91	0	10519
4248	362	10084	52	60	0	10558
4249	198	314	64	9971	0	10547
4250	186	116	53	10136	0	10491
4251	9827	88	69	377	0	10361
4252	320	9742	68	163	0	10293
4253	154	9659	72	154	0	10039
4254	154	9957	75	120	0	10306
4255	170	343	9626	101	0	10240
4256	172	125	9640	97	0	10034
4257	194	95	9721	90	0	10100
4258	178	190	335	8663	0	9366
4259	149	9195	118	248	0	9710
4260	9202	291	71	132	0	9696
4261	353	121	9052	102	0	9628
4262	155	96	9069	103	0	9423
4263	134	84	9214	97	0	9529
4264	157	80	344	9030	0	9611
4265	163	71	140	9202	0	9576
4266	178	95	79	9240	0	9592
4267	9126	89	70	316	0	9601
4268	9113	84	83	125	0	9405
4269	9197	68	113	88	0	9466
4270	383	78	92	8866	0	9419
4271	184	63	8654	282	0	9183
4272	143	93	8759	119	0	9114
4273	159	74	288	8672	0	9193
4274	160	85	112	8704	0	9061
4275	8511	51	97	297	0	8956
4276	317	8365	90	155	0	8927
4277	8446	218	75	141	0	8880
4278	338	8314	81	130	0	8863
4279	215	235	59	8404	0	8913
4280	145	96	8326	312	0	8879
4281	178	88	231	8351	0	8848
4282	8451	72	73	309	0	8905
4283	359	50	8282	151	0	8842
4284	8171	65	247	138	0	8621
4285	350	56	8150	98	0	8654
4286	191	58	7934	92	0	8275
4287	7536	53	276	104	0	7969
4288	327	49	7539	109	0	8024
4289	129	30	5788	56	0	6003
4290	128	5602	206	58	0	5994
4291	4380	178	186	75	0	4819
4292	4037	34	45	37	0	4153
4293	4023	17	19	26	0	4085
4294	77	10	3858	16	0	3961
4295	3822	10	66	24	0	3922
4296	64	3900	26	17	0	4007
4297	3912	53	17	16	0	3998
4298	72	12	3898	8	0	3990
4299	63	32	54	3698	0	3847
4300	22	12	3669	41	0	3744
4301	14	3648	51	17	0	3730
4302	26	37	16	3445	0	3524
4303	15	15	14	3484	0	3528
4304	3520	3	15	38	0	3576
4305	3519	7	14	11	0	3551
4306	3518	5	5	12	0	3540
4307	3540	2	10	10	0	3562
4308	3471	10	9	12	0	3502
4309	49	6	3472	8	0	3535
4310	23	5	37	3455	0	3520
4311	17	10	3587	30	0	3644
4312	21	6	34	3606	0	3667
4313	3667	3	14	44	0	3728
4314	3718	4	8	18	0	3748
4315	3733	5	15	16	0	3769
4316	3732	9	12	9	0	3762
4317	48	2	3797	15	0	3862
4318	26	3	37	3714	0	3780
4319	17	3	3762	45	0	3827
4320	21	3826	40	17	0	3904
4321	17	3805	12	14	0	3848
4322	36	42	9	3799	0	3886
4323	18	8	10	4165	0	4201
4324	21	5	13	4304	0	4343
4325	17	6	7	4543	0	4573
4326	4495	2	10	86	0	4593
4327	65	4455	7	29	0	4556
4328	4407	57	9	22	0	4495
4329	69	16	8	4386	0	4479
4330	35	8	7	4311	0	4361
4331	13	4298	9	66	0	4386
4332	25	60	7	4291	0	4383
4333	4246	17	6	77	0	4346
4334	61	4100	8	36	0	4205
4335	23	4014	7	22	0	4066
4336	3989	59	6	27	0	4081
4337	63	16	6	4050	0	4135
4338	22	4012	7	57	0	4098
4339	23	55	2	4072	0	4152
4340	4048	20	6	74	0	4148
4341	66	13	2	4022	0	4103
4342	26	13	6	4082	0	4127
4343	4043	8	4	90	0	4145
4344	66	4	1	4065	0	4136
4345	23	4042	5	62	0	4132
4346	14	55	4	4078	0	4151
4347	23	4043	3	63	0	4132
4348	22	55	5	4118	0	4200
4349	4087	24	2	75	0	4188
4350	4117	15	4	41	0	4177
4351	72	10	4	4135	0	4221
4352	27	12	4066	70	0	4175
4353	3957	15	54	45	0	4071
4354	67	10	4046	21	0	4144
4355	4038	8	49	34	0	4129
4356	4116	9	17	34	0	4176
4357	91	11	3970	13	0	4085
4358	31	3909	52	19	0	4011
4359	3945	54	17	25	0	4041
4360	3953	17	11	32	0	4013
4361	72	11	4024	16	0	4123
4362	4014	10	52	24	0	4100
4363	3933	5	17	23	0	3978
4364	3972	8	7	12	0	3999
4365	74	4	11	3923	0	4012
4366	36	11	11	3939	0	3997
4367	34	3902	5	61	0	4002
4368	30	38	12	3937	0	4017
4369	26	14	13	3945	0	3998
4370	23	16	3813	69	0	3921
4371	23	15	3595	30	0	3663
4372	3529	9	53	33	0	3624
4373	3669	11	17	34	0	3731
4374	64	3646	14	20	0	3744
4375	39	47	12	3677	0	3775
4376	32	22	3801	57	0	3912
4377	31	14	48	3842	0	3935
4378	30	13	25	3948	0	4016
4379	27	8	13	4106	0	4154
4380	21	4030	15	76	0	4142
4381	25	56	6	4114	0	4201
4382	23	25	5	4176	0	4229
4383	12	16	4082	95	0	4205
4384	15	19	4091	36	0	4161
4385	3957	7	67	44	0	4075
4386	4092	11	23	42	0	4168
4387	75	8	19	4307	0	4409
4388	40	19	17	4194	0	4270
4389	38	14	5	4317	0	4374
4390	22	4	4081	121	0	4228
4391	17	4033	77	61	0	4188
4392	16	78	4017	42	0	4153
4393	3974	26	92	41	0	4133
4394	99	21	4044	29	0	4193
4395	4016	15	89	33	0	4153
4396	3958	8	40	42	0	4048
4397	4064	11	24	29	0	4128
4398	128	9	27	3940	0	4104
4399	54	11	3932	91	0	4088
4400	42	3904	91	31	0	4068
4401	46	72	32	3879	0	4029
4402	35	23	24	3998	0	4080
4403	24	20	4035	119	0	4198
4404	22	3944	95	53	0	4114
4405	4092	92	31	51	0	4266
4406	94	4277	31	34	0	4436
4407	4704	108	27	30	0	4869
4408	160	45	22	4765	0	4992
4409	61	25	4889	132	0	5107
4410	49	4957	127	48	0	5181
4411	5023	122	43	44	0	5232
4412	145	47	4955	42	0	5189
4413	4992	30	145	35	0	5202
4414	5115	37	45	29	0	5226
4415	184	23	5008	35	0	5250
4416	4956	11	148	34	0	5149
4417	4989	9	64	26	0	5088
4418	4945	17	47	17	0	5026
4419	207	4771	33	19	0	5030
4420	4641	130	22	29	0	4822
4421	180	4687	17	17	0	4901
4422	72	128	4627	32	0	4859
4423	46	4568	127	27	0	4768
4424	4218	137	85	27	0	4467
4425	4286	47	24	23	0	4380
4426	4335	24	32	17	0	4408
4427	167	32	19	4169	0	4387
4428	92	18	18	4281	0	4409
4429	4114	14	20	143	0	4291
4430	4323	14	22	44	0	4403
4431	165	20	15	4198	0	4398
4432	83	9	4155	126	0	4373
4433	63	3963	112	36	0	4174
4434	49	4183	36	33	0	4301
4435	44	140	25	4096	0	4305
4436	30	44	4117	117	0	4308
4437	43	39	103	3953	0	4138
4438	41	3994	42	108	0	4185
4439	44	106	32	4024	0	4206
4440	34	44	3967	120	0	4165
4441	41	28	103	4018	0	4190
4442	27	26	4169	148	0	4370
4443	46	13	126	4170	0	4355
4444	39	26	4277	125	0	4467
4445	36	17	4244	64	0	4361
4446	4139	18	158	48	0	4363
4447	4335	24	53	36	0	4448
4448	4352	19	54	30	0	4455
4449	165	4250	32	35	0	4482
4450	96	104	33	4318	0	4551
4451	4213	35	25	124	0	4397
4452	4369	39	13	46	0	4467
4453	4381	25	19	47	0	4472
4454	173	28	4241	31	0	4473
4455	76	4009	112	45	0	4242
4456	54	4300	48	46	0	4448
4457	4267	132	48	31	0	4478
4458	144	59	49	4218	0	4470
4459	4186	46	40	122	0	4394
4460	160	30	4114	40	0	4344
4461	94	24	112	4057	0	4287
4462	74	20	49	4154	0	4297
4463	69	27	35	4064	0	4195
4464	57	4104	25	155	0	4341
4465	4133	98	24	75	0	4330
4466	4201	35	38	57	0	4331
4467	151	4092	19	50	0	4312
4468	74	127	41	4107	0	4349
4469	4157	54	24	123	0	4358
4470	160	53	24	4123	0	4360
4471	4143	33	15	143	0	4334
4472	151	4089	23	65	0	4328
4473	4109	116	20	49	0	4294
4474	158	53	4053	36	0	4300
4475	84	4074	105	47	0	4310
4476	60	115	3981	36	0	4192
4477	94	109	130	3851	0	4184
4478	3771	55	63	120	0	4009
4479	3832	32	36	41	0	3941
4480	3834	19	31	31	0	3915
4481	165	28	18	3715	0	3926
4482	3747	17	19	131	0	3914
4483	161	16	17	3706	0	3900
4484	3714	20	12	145	0	3891
4485	3822	17	15	60	0	3914
4486	154	24	3732	52	0	3962
4487	59	16	3506	34	0	3615
4488	53	17	3481	20	0	3571
4489	35	19	104	3358	0	3516
4490	3385	5	73	86	0	3549
4491	86	25	28	3385	0	3524
4492	45	11	27	3458	0	3541
4493	3564	13	21	107	0	3705
4494	3593	7	10	53	0	3663
4495	3577	10	18	59	0	3664
4496	3647	7	8	39	0	3701
4497	116	11	15	3559	0	3701
4498	3518	6	10	100	0	3634
4499	113	3457	17	25	0	3612
4500	3516	61	17	27	0	3621
4501	3520	24	17	35	0	3596
4502	103	25	3397	19	0	3544
4503	3293	15	68	30	0	3406
4504	104	5	3252	16	0	3377
4505	46	10	3000	17	0	3073
4506	31	9	2922	20	0	2982
4507	30	70	51	2338	0	2489
4508	11	1	2397	23	0	2432
4509	10	19	26	2174	0	2229
4510	6	3	2301	18	0	2328
4511	7	4	2473	9	0	2493
4512	13	10	19	2456	0	2498
4513	12	9	6	2584	0	2611
4514	5	1	2662	13	0	2681
4515	2577	1	18	11	0	2607
4516	20	1	5	2702	0	2728
4517	7	1	3	2769	0	2780
4518	2776	1	4	21	0	2802
4519	23	0	5	2812	0	2840
4520	2	2	2808	24	0	2836
4521	13	0	2667	6	0	2686
4522	4	3	19	2707	0	2733
4523	5	2	2773	23	0	2803
4524	5	2825	19	3	0	2852
4525	6	15	5	2841	0	2867
4526	2864	0	5	29	0	2898
4527	18	4	2884	4	0	2910
4528	2864	2	16	16	0	2898
4529	22	3	1	3002	0	3028
4530	6	0	3	2989	0	2998
4531	12	0	2	2974	0	2988
4532	8	2	3	2956	0	2969
4533	3000	1	4	28	0	3033
4534	17	3196	8	10	0	3231
4535	7	22	4	3276	0	3309
4536	5	2	8	3304	0	3319
4537	10	8	0	3304	0	3322
4538	8	3	6	3281	0	3298
4539	3287	3	2	36	0	3328
4540	27	3254	3	15	0	3299
4541	3238	21	2	20	0	3281
4542	32	3054	7	9	0	3102
4543	8	3101	2	11	0	3122
4544	3057	24	3	12	0	3096
4545	30	9	3136	6	0	3181
4546	24	10	26	3149	0	3209
4547	3237	3	5	33	0	3278
4548	3257	7	9	19	0	3292
4549	2909	14	15	48	0	2986
4550	3313	1	3	15	0	3332
4551	36	3486	6	13	0	3541
4552	3539	35	2	17	0	3593
4553	3677	5	3	11	0	3696
4554	46	3897	3	9	0	3955
4555	26	52	4	4067	0	4149
4556	12	16	4028	55	0	4111
4557	18	11	50	4057	0	4136
4558	4032	8	17	71	0	4128
4559	58	7	4196	24	0	4285
4560	16	4150	57	25	0	4248
4561	14	61	4225	15	0	4315
4562	20	15	64	4041	0	4140
4563	19	4096	16	54	0	4185
4564	4182	63	13	34	0	4292
4565	68	4237	8	11	0	4324
4566	30	73	6	4221	0	4330
4567	22	22	9	4305	0	4358
4568	4211	18	7	87	0	4323
4569	74	15	11	4132	0	4232
4570	22	4167	11	79	0	4279
4571	4189	65	9	40	0	4303
4572	4265	17	8	31	0	4321
4573	80	4265	9	14	0	4368
4574	4242	66	11	23	0	4342
4575	74	4216	11	15	0	4316
4576	4186	74	4	24	0	4288
4577	80	4203	4	19	0	4306
4578	40	80	5	4043	0	4168
4579	25	32	3	4248	0	4308
4580	4174	19	5	92	0	4290
4581	4216	12	6	52	0	4286
4582	89	4177	7	17	0	4290
4583	38	71	4122	20	0	4251
4584	4218	29	63	25	0	4335
4585	88	21	18	4278	0	4405
4586	45	4256	13	65	0	4379
4587	37	71	8	4310	0	4426
4588	4307	37	5	77	0	4426
4589	4362	21	9	33	0	4425
4590	4416	17	5	37	0	4475
4591	96	19	4	4363	0	4482
4592	44	15	4335	78	0	4472
4593	4142	16	58	50	0	4266
4594	4207	19	14	35	0	4275
4595	4312	15	14	25	0	4366
4596	95	4190	12	17	0	4314
4597	48	70	15	4240	0	4373
4598	38	4276	13	65	0	4392
4599	31	83	8	4305	0	4427
4600	38	35	7	4366	0	4446
4601	27	29	4466	89	0	4611
4602	30	23	70	4793	0	4916
4603	38	18	15	4974	0	5045
4604	4982	19	18	143	0	5162
4605	113	5053	10	55	0	5231
4606	5083	117	12	44	0	5256
4607	5456	39	18	29	0	5542
4608	171	31	8	5374	0	5584
4609	72	26	5399	131	0	5628
4610	46	5166	110	52	0	5374
4611	38	5162	31	38	0	5269
4612	5027	138	21	50	0	5236
4613	141	5025	25	26	0	5217
4614	72	134	11	4921	0	5138
4615	51	53	20	5043	0	5167
4616	34	40	4907	152	0	5133
4617	46	32	4877	64	0	5019
4618	46	4885	142	42	0	5115
4619	42	133	47	4896	0	5118
4620	4882	51	26	142	0	5101
4621	144	34	23	4955	0	5156
4622	49	37	5005	137	0	5228
4623	44	33	124	4985	0	5186
4624	4904	33	39	166	0	5142
4625	4938	31	26	73	0	5068
4626	162	4899	19	54	0	5134
4627	4874	129	12	67	0	5082
4628	152	4925	19	43	0	5139
4629	4920	139	18	49	0	5126
4630	173	62	16	4851	0	5102
4631	74	36	4827	140	0	5077
4632	47	43	4755	62	0	4907
4633	54	4825	141	52	0	5072
4634	61	118	60	4598	0	4837
4635	50	50	23	4758	0	4881
4636	4670	34	23	160	0	4887
4637	4742	30	17	62	0	4851
4638	4813	30	17	60	0	4920
4639	165	28	14	4767	0	4974
4640	78	31	22	4856	0	4987
4641	65	33	19	4919	0	5036
4642	51	31	4763	159	0	5004
4643	43	28	4711	67	0	4849
4644	4708	24	136	63	0	4931
4645	4654	22	49	65	0	4790
4646	152	25	4658	50	0	4885
4647	4612	23	121	47	0	4803
4648	4552	18	48	64	0	4682
4649	160	19	4474	45	0	4698
4650	86	4467	116	39	0	4708
4651	67	121	52	4287	0	4527
4652	49	36	4344	118	0	4547
4653	48	4333	106	67	0	4554
4654	50	131	40	3927	0	4148
4655	39	4043	30	103	0	4215
4656	46	111	4049	37	0	4243
4657	31	53	4077	33	0	4194
4658	40	73	126	4061	0	4300
4659	4088	34	51	120	0	4293
4660	119	26	34	4071	0	4250
4661	4051	22	37	117	0	4227
4662	116	26	36	4093	0	4271
4663	61	25	4057	131	0	4274
4664	4018	23	100	79	0	4220
4665	121	12	4137	48	0	4318
4666	4177	21	121	43	0	4362
4667	126	18	52	4133	0	4329
4668	64	4171	43	108	0	4386
4669	57	103	30	4203	0	4393
4670	39	4239	22	139	0	4439
4671	50	104	26	4125	0	4305
4672	39	4227	32	110	0	4408
4673	4164	110	32	60	0	4366
4674	4223	47	24	55	0	4349
4675	4222	33	27	45	0	4327
4676	144	33	4131	31	0	4339
4677	81	28	102	4126	0	4337
4678	56	26	4193	116	0	4391
4679	53	4036	113	59	0	4261
4680	36	4226	50	53	0	4365
4681	4108	112	48	50	0	4318
4682	119	47	4152	34	0	4352
4683	49	4103	116	35	0	4303
4684	52	120	42	4150	0	4364
4685	4082	49	23	127	0	4281
4686	121	4153	35	50	0	4359
4687	4211	104	37	52	0	4404
4688	137	52	4179	24	0	4392
4689	71	36	107	4293	0	4507
4690	57	27	48	4363	0	4495
4691	50	25	34	4521	0	4630
4692	33	4418	50	157	0	4658
4693	73	124	29	4242	0	4468
4694	38	44	4483	156	0	4721
4695	39	33	118	4461	0	4651
4696	35	29	45	4569	0	4678
4697	46	24	31	4532	0	4633
4698	30	4379	37	169	0	4615
4699	35	119	37	4432	0	4623
4700	45	37	25	4471	0	4578
4701	19	4202	32	170	0	4423
4702	3824	89	17	57	0	3987
4703	84	3751	16	46	0	3897
4704	29	3689	17	37	0	3772
4705	58	101	19	3541	0	3719
4706	20	37	3497	84	0	3638
4707	3119	22	64	31	0	3236
4708	69	16	17	3233	0	3335
4709	19	12	3180	72	0	3283
4710	18	3214	72	29	0	3333
4711	20	72	24	3245	0	3361
4712	15	18	3296	84	0	3413
4713	11	11	76	3232	0	3330
4714	21	21	26	3294	0	3362
4715	3211	12	13	100	0	3336
4716	64	3205	10	37	0	3316
4717	3229	70	11	24	0	3334
4718	76	20	3265	21	0	3382
4719	23	3308	65	21	0	3417
4720	22	71	3334	13	0	3440
4721	21	34	66	3336	0	3457
4722	3315	15	22	70	0	3422
4723	68	15	18	3300	0	3401
4724	3302	11	12	79	0	3404
4725	3390	5	14	30	0	3439
4726	86	8	7	3390	0	3491
4727	37	8	3496	80	0	3621
4728	20	7	3521	34	0	3582
4729	18	10	76	3648	0	3752
4730	16	5	26	3735	0	3782
4731	3689	10	22	99	0	3820
4732	76	10	12	3666	0	3764
4733	28	3579	14	82	0	3703
4734	18	68	8	3694	0	3788
4735	15	27	6	3762	0	3810
4736	3697	11	6	106	0	3820
4737	70	3728	9	49	0	3856
4738	36	77	9	3808	0	3930
4739	15	23	6	3828	0	3872
4740	18	3707	15	104	0	3844
4741	20	76	10	3787	0	3893
4742	10	31	8	3789	0	3838
4743	8	3673	13	114	0	3808
4744	13	78	5	3766	0	3862
4745	12	30	7	3730	0	3779
4746	5	3613	10	112	0	3740
4747	9	78	7	3687	0	3781
4748	3642	28	8	113	0	3791
4749	3672	19	7	56	0	3754
4750	3579	18	5	45	0	3647
4751	3624	20	4	38	0	3686
4752	100	3495	2	33	0	3630
4753	3396	69	2	27	0	3494
4754	84	3309	3	28	0	3424
4755	34	3341	12	14	0	3401
4756	34	87	27	3260	0	3408
4757	14	22	3283	71	0	3390
4758	3144	17	53	38	0	3252
4759	3286	17	14	19	0	3336
4760	64	10	3305	28	0	3407
4761	3317	9	49	26	0	3401
4762	3441	12	14	22	0	3489
4763	71	3303	7	22	0	3403
4764	3572	57	10	36	0	3675
4765	63	19	9	3482	0	3573
4766	37	7	8	3519	0	3571
4767	25	10	6	3529	0	3570
4768	20	21	5	3518	0	3564
4769	3466	6	6	87	0	3565
4770	63	16	3	3434	0	3516
4771	38	13	4	3486	0	3541
4772	16	12	3413	81	0	3522
4773	3156	9	46	36	0	3247
4774	3428	12	14	32	0	3486
4775	3445	8	5	37	0	3495
4776	74	3349	8	24	0	3455
4777	28	3435	7	21	0	3491
4778	3431	61	4	33	0	3529
4779	60	17	9	3427	0	3513
4780	37	3444	6	63	0	3550
4781	21	57	3	3468	0	3549
4782	13	3455	6	70	0	3544
4783	3431	51	1	43	0	3526
4784	56	3458	4	40	0	3558
4785	36	58	4	3441	0	3539
4786	30	21	3	3480	0	3534
4787	22	15	3397	69	0	3503
4788	26	3520	43	31	0	3620
4789	27	75	12	3637	0	3751
4790	18	29	3776	78	0	3901
4791	14	13	3993	36	0	4056
4792	19	15	99	4191	0	4324
4793	22	9	34	4235	0	4300
4794	20	4060	15	135	0	4230
4795	14	4270	18	60	0	4362
4796	22	132	8	4279	0	4441
4797	4264	56	6	112	0	4438
4798	103	21	7	4460	0	4591
4799	4480	22	6	126	0	4634
4800	4614	16	5	73	0	4708
4801	4745	8	5	43	0	4801
4802	152	17	4648	27	0	4844
4803	4680	10	92	34	0	4816
4804	126	14	55	4694	0	4889
4805	87	8	17	4770	0	4882
4806	34	12	4680	164	0	4890
4807	24	14	4679	84	0	4801
4808	34	23	141	4585	0	4783
4809	23	4479	57	106	0	4665
4810	22	4602	22	76	0	4722
4811	25	131	18	4629	0	4803
4812	4605	55	16	123	0	4799
4813	114	17	12	4692	0	4835
4814	78	17	10	4663	0	4768
4815	35	4619	12	139	0	4805
4816	32	93	11	4748	0	4884
4817	30	66	4732	112	0	4940
4818	29	20	4534	84	0	4667
4819	4525	25	128	45	0	4723
4820	94	4619	63	42	0	4818
4821	4677	95	26	36	0	4834
4822	4750	61	26	37	0	4874
4823	151	24	12	4579	0	4766
4824	72	4688	12	90	0	4862
4825	45	90	9	4818	0	4962
4826	4780	58	11	130	0	4979
4827	94	4634	10	79	0	4817
4828	4577	91	9	40	0	4717
4829	88	4581	12	28	0	4709
4830	4613	95	11	30	0	4749
4831	4631	58	14	29	0	4732
4832	142	4525	22	19	0	4708
4833	79	93	11	4631	0	4814
4834	4636	54	9	99	0	4798
4835	107	26	4417	58	0	4608
4836	70	19	4411	25	0	4525
4837	49	66	127	4342	0	4584
4838	4409	16	50	102	0	4577
4839	95	14	15	4445	0	4569
4840	4458	21	10	106	0	4595
4841	100	18	4500	62	0	4680
4842	4636	12	73	38	0	4759
4843	4865	15	50	34	0	4964
4844	149	14	13	4805	0	4981
4845	87	14	15	4842	0	4958
4846	48	11	13	4857	0	4929
4847	35	4778	18	136	0	4967
4848	38	69	19	4807	0	4933
4849	32	46	17	4904	0	4999
4850	4815	16	15	157	0	5003
4851	4859	10	15	86	0	4970
4852	131	17	4717	36	0	4901
4853	4728	11	83	52	0	4874
4854	111	14	4755	36	0	4916
4855	4586	16	88	41	0	4731
4856	109	14	4698	27	0	4848
4857	76	16	4611	29	0	4732
4858	45	10	130	4560	0	4745
4859	33	12	4638	99	0	4782
4860	4525	15	94	90	0	4724
4861	91	15	63	4762	0	4931
4862	4842	11	23	122	0	4998
4863	4862	13	22	90	0	4987
4864	4654	15	21	39	0	4729
4865	4648	12	19	35	0	4714
4866	159	14	4524	24	0	4721
4867	96	6	82	4554	0	4738
4868	60	14	4624	81	0	4779
4869	46	15	92	4618	0	4771
4870	4594	10	63	108	0	4775
4871	111	11	34	4646	0	4802
4872	4686	8	29	110	0	4833
4873	102	10	17	4783	0	4912
4874	78	17	20	4819	0	4934
4875	4756	9	19	159	0	4943
4876	109	4669	23	80	0	4881
4877	4762	75	20	51	0	4908
4878	109	4721	11	31	0	4872
4879	79	92	15	4758	0	4944
4880	4696	57	18	96	0	4867
4881	104	19	4581	81	0	4785
4882	79	16	83	4665	0	4843
4883	4670	18	58	116	0	4862
4884	4684	13	15	90	0	4802
4885	157	11	19	4668	0	4855
4886	93	4679	24	104	0	4900
4887	54	4787	25	79	0	4945
4888	58	246	9	4470	0	4783
4889	4588	65	12	100	0	4765
4890	105	4355	4	60	0	4524
4891	40	4051	4	19	0	4114
4892	3878	65	5	18	0	3966
4893	47	3822	8	6	0	3883
4894	4004	46	9	23	0	4082
4895	65	23	4	4001	0	4093
4896	34	18	4	4000	0	4056
4897	13	3899	4	73	0	3989
4898	6	3886	3	38	0	3933
4899	3731	60	1	21	0	3813
4900	43	3804	6	12	0	3865
4901	22	4060	2	7	0	4091
4902	21	60	4	4058	0	4143
4903	4114	43	1	62	0	4220
4904	59	27	4412	33	0	4531
4905	4471	15	70	22	0	4578
4906	94	12	50	4976	0	5132
4907	60	12	5043	91	0	5206
4908	34	14	5126	68	0	5242
4909	28	10	139	5196	0	5373
4910	12	17	5484	104	0	5617
4911	5448	19	113	85	0	5665
4912	5550	24	76	42	0	5692
4913	177	16	5495	20	0	5708
4914	103	20	116	5435	0	5674
4915	60	16	77	5448	0	5601
4916	5482	12	37	182	0	5713
4917	146	7	32	5311	0	5496
4918	89	5325	27	134	0	5575
4919	5388	99	28	91	0	5606
4920	130	5337	24	57	0	5548
4921	90	5452	26	41	0	5609
4922	60	166	33	5342	0	5601
4923	48	84	18	5439	0	5589
4924	51	41	22	5472	0	5586
4925	41	26	5182	203	0	5452
4926	4926	24	110	132	0	5192
4927	117	5088	77	67	0	5349
4928	5210	110	34	69	0	5423
4929	5208	79	26	56	0	5369
4930	211	41	13	5183	0	5448
4931	107	5140	27	134	0	5408
4932	68	112	20	5301	0	5501
4933	56	83	15	5358	0	5512
4934	5319	39	19	204	0	5581
4935	5316	33	12	129	0	5490
4936	183	40	5011	83	0	5317
4937	5323	24	92	62	0	5501
4938	158	5371	69	54	0	5652
4939	5451	125	27	46	0	5649
4940	173	5689	17	47	0	5926
4941	126	148	13	5524	0	5811
4942	72	99	18	5545	0	5734
4943	73	5377	14	202	0	5666
4944	64	132	19	5566	0	5781
4945	62	100	15	5594	0	5771
4946	58	53	25	5564	0	5700
4947	52	5359	19	243	0	5673
4948	59	138	16	5514	0	5727
4949	60	93	19	5548	0	5720
4950	48	54	20	5613	0	5735
4951	35	48	5337	267	0	5687
4952	5226	51	119	165	0	5561
4953	164	39	5387	100	0	5690
4954	5392	42	139	89	0	5662
4955	160	34	5446	88	0	5728
4956	5406	40	149	88	0	5683
4957	5521	30	94	79	0	5724
4958	235	27	5440	72	0	5774
4959	131	33	151	5396	0	5711
4960	85	24	5159	179	0	5447
4961	5175	35	150	125	0	5485
4962	179	25	5408	80	0	5692
4963	113	27	5312	79	0	5531
4964	5282	13	226	75	0	5596
4965	179	5289	125	63	0	5656
4966	140	120	79	5411	0	5750
4967	5494	84	64	168	0	5810
4968	186	38	54	5553	0	5831
4969	129	28	61	5636	0	5854
4970	5544	21	44	250	0	5859
4971	5593	23	44	147	0	5807
4972	242	25	5408	86	0	5761
4973	164	17	5417	85	0	5683
4974	86	33	217	5382	0	5718
4975	102	22	5475	172	0	5771
4976	78	25	175	5436	0	5714
4977	90	27	121	5424	0	5662
4978	74	28	70	5640	0	5812
4979	5423	32	46	276	0	5777
4980	177	5492	44	176	0	5889
4981	5586	144	51	114	0	5895
4982	5623	78	37	137	0	5875
4983	222	5551	46	105	0	5924
4984	5615	127	36	103	0	5881
4985	197	91	5517	78	0	5883
4986	127	61	124	5445	0	5757
4987	5498	38	89	185	0	5810
4988	176	54	5220	112	0	5562
4989	5276	39	115	83	0	5513
4990	176	5469	79	71	0	5795
4991	5973	115	47	69	0	6204
4992	6041	81	41	67	0	6230
4993	279	5983	37	55	0	6354
4994	6196	163	46	63	0	6468
4995	258	82	32	6197	0	6569
4996	159	49	47	6376	0	6631
4997	6226	41	34	266	0	6567
4998	6202	27	27	142	0	6398
4999	279	6157	31	87	0	6554
5000	157	6194	32	79	0	6462
5001	98	263	23	5768	0	6152
5002	83	5819	16	163	0	6081
5003	74	6075	21	87	0	6257
5004	5525	183	37	71	0	5816
5005	161	5573	11	64	0	5809
5006	5119	124	23	43	0	5309
5007	147	5223	12	33	0	5415
5008	74	127	5171	27	0	5399
5009	44	5193	110	30	0	5377
5010	4954	138	61	42	0	5195
5011	4926	51	21	17	0	5015
5012	127	25	4825	17	0	4994
5013	64	20	101	4711	0	4896
5014	45	15	36	4941	0	5037
5015	22	13	4876	120	0	5031
5016	39	12	91	4731	0	4873
5017	17	13	4910	116	0	5056
5018	26	16	4765	49	0	4856
5019	4804	11	117	44	0	4976
5020	110	4841	48	16	0	5015
5021	4889	100	29	14	0	5032
5022	118	29	18	4921	0	5086
5023	46	22	4985	98	0	5151
5024	33	17	92	4866	0	5008
5025	35	4965	26	98	0	5124
5026	5061	85	31	42	0	5219
5027	5126	29	20	39	0	5214
5028	127	18	10	5108	0	5263
5029	49	20	4996	91	0	5156
5030	4817	11	84	44	0	4956
5031	97	4918	29	24	0	5068
5032	4969	89	18	23	0	5099
5033	138	31	8	4955	0	5132
5034	4980	27	7	108	0	5122
5035	142	26	10	4951	0	5129
5036	58	26	4959	117	0	5160
5037	42	20	4836	52	0	4950
5038	4830	15	103	64	0	5012
5039	102	5033	43	31	0	5209
5040	4910	82	35	34	0	5061
5041	4946	31	21	18	0	5016
5042	101	4989	9	15	0	5114
5043	4967	98	8	22	0	5095
5044	97	41	5111	19	0	5268
5045	47	38	77	5158	0	5320
5046	43	23	22	5212	0	5300
5047	38	23	15	5315	0	5391
5048	33	29	5178	104	0	5344
5049	33	20	5257	44	0	5354
5050	21	26	104	5292	0	5443
5051	12	5217	53	80	0	5362
5052	27	5523	20	43	0	5613
5053	5567	106	17	27	0	5717
5054	5628	42	15	23	0	5708
5055	105	5783	18	29	0	5935
5056	49	90	11	5921	0	6071
5057	28	36	17	5981	0	6062
5058	6035	21	27	140	0	6223
5059	103	14	18	6193	0	6328
5060	52	17	24	6142	0	6235
5061	42	22	14	6194	0	6272
5062	39	20	5826	132	0	6017
5063	32	27	5451	62	0	5572
5064	5771	19	109	55	0	5954
5065	106	9	52	5987	0	6154
5066	51	14	5923	107	0	6095
5067	42	25	5697	51	0	5815
5068	5829	24	124	48	0	6025
5069	122	19	6587	31	0	6759
5070	57	6660	117	34	0	6868
5071	31	102	51	7333	0	7517
5072	35	43	7304	125	0	7507
5073	7319	28	128	68	0	7543
5074	151	26	54	7905	0	8136
5075	73	23	7875	153	0	8124
5076	58	13	147	8122	0	8340
5077	54	13	76	8277	0	8420
5078	8228	6	45	236	0	8515
5079	152	8185	53	113	0	8503
5080	93	139	45	8212	0	8489
5081	8287	73	24	189	0	8573
5082	8397	43	10	106	0	8556
5083	8460	23	28	60	0	8571
5084	8567	25	25	52	0	8669
5085	274	14	17	8334	0	8639
5086	8224	16	35	180	0	8455
5087	8362	15	25	97	0	8499
5088	8060	15	12	99	0	8186
5089	8215	9	17	76	0	8317
5090	262	7654	20	58	0	7994
5091	101	7309	7	22	0	7439
5092	57	159	9	7278	0	7503
5093	35	7251	9	94	0	7389
5094	7202	118	7	72	0	7399
5095	113	66	6	7129	0	7314
5096	7139	20	5	111	0	7275
5097	7285	17	7	77	0	7386
5098	164	11	4	7422	0	7601
5099	86	11	11	7434	0	7542
5100	49	7319	6	153	0	7527
5101	7349	85	7	84	0	7525
5102	114	7354	10	41	0	7519
5103	7463	95	5	42	0	7605
5104	124	61	4	7525	0	7714
5105	78	24	7382	96	0	7580
5106	7318	17	79	80	0	7494
5107	7176	18	46	57	0	7297
5108	159	18	7110	29	0	7316
5109	93	11	7091	28	0	7223
5110	64	18	121	7016	0	7219
5111	7548	11	59	120	0	7738
5112	7789	10	30	95	0	7924
5113	8086	10	22	67	0	8185
5114	8256	14	13	47	0	8330
5115	209	7989	18	27	0	8243
5116	8426	114	12	42	0	8594
5117	186	57	15	8223	0	8481
5118	108	25	10	8316	0	8459
5119	77	22	16	8484	0	8599
5120	68	23	7	8617	0	8715
5121	8433	15	8	227	0	8683
5122	168	14	12	8843	0	9037
5123	81	30	8608	200	0	8919
5124	81	12	138	8966	0	9197
5125	91	15	58	9090	0	9254
5126	94	12	34	9093	0	9233
5127	91	12	29	9057	0	9189
5128	8790	16	14	293	0	9113
5129	206	8631	24	135	0	8996
5130	128	8858	22	91	0	9099
5131	88	209	14	8881	0	9192
5132	8755	87	17	234	0	9093
5133	8995	53	20	139	0	9207
5134	273	37	13	8911	0	9234
5135	127	36	8630	231	0	9024
5136	8709	22	163	141	0	9035
5137	227	26	81	9023	0	9357
5138	119	29	8926	245	0	9319
5139	8576	20	184	165	0	8945
5140	217	8785	81	109	0	9192
5141	9529	158	33	108	0	9828
5142	275	9861	29	75	0	10240
5143	169	262	24	9996	0	10451
5144	112	10496	18	264	0	10890
5145	112	295	9	10863	0	11279
5146	10497	156	20	350	0	11023
5147	313	10579	10	198	0	11100
5148	152	298	10508	144	0	11102
5149	139	161	254	10570	0	11124
5150	109	97	10600	317	0	11123
5151	96	53	301	10469	0	10919
5152	85	47	171	10710	0	11013
5153	80	47	10361	424	0	10912
5154	9618	57	291	274	0	10240
5155	309	41	10219	157	0	10726
5156	173	56	10140	111	0	10480
5157	109	10046	365	146	0	10666
5158	93	288	202	10038	0	10621
5159	99	143	108	10259	0	10609
5160	119	102	71	10005	0	10297
5161	67	94	65	10374	0	10600
5162	52	51	9928	495	0	10526
5163	9464	42	271	330	0	10107
5164	283	38	10075	183	0	10579
5165	153	37	318	10029	0	10537
5166	9842	19	180	382	0	10423
5167	295	9878	142	228	0	10543
5168	205	302	89	9703	0	10299
5169	9283	117	110	349	0	9859
5170	288	8975	91	195	0	9549
5171	138	8875	51	117	0	9181
5172	8656	321	46	145	0	9168
5173	253	8748	38	113	0	9152
5174	8250	276	35	141	0	8702
5175	271	8419	28	118	0	8836
5176	8366	278	63	69	0	8776
5177	8522	139	30	73	0	8764
5178	339	8451	65	61	0	8916
5179	181	247	32	8413	0	8873
5180	144	150	8236	235	0	8765
5181	8210	110	214	139	0	8673
5182	290	64	97	8252	0	8703
5183	170	7904	63	269	0	8406
5184	93	8340	31	143	0	8607
5185	74	319	42	8253	0	8688
5186	8209	146	40	277	0	8672
5187	261	125	8135	141	0	8662
5188	162	70	224	8333	0	8789
5189	118	84	102	8477	0	8781
5190	110	68	65	8607	0	8850
5191	86	46	49	8470	0	8651
5192	69	8119	49	392	0	8629
5193	60	241	44	8388	0	8733
5194	53	123	8109	352	0	8637
5195	79	85	8052	204	0	8420
5196	44	69	8165	177	0	8455
5197	59	95	330	7940	0	8424
5198	7754	99	162	295	0	8310
5199	250	60	7821	196	0	8327
5200	152	45	7942	128	0	8267
5201	109	45	362	7748	0	8264
5202	7743	30	183	334	0	8290
5203	240	7649	127	206	0	8222
5204	7700	231	90	163	0	8184
5205	296	124	74	7706	0	8200
5206	140	111	7705	298	0	8254
5207	126	104	255	7526	0	8011
5208	79	7597	170	296	0	8142
5209	7710	256	138	161	0	8265
5210	275	126	7666	122	0	8189
5211	125	7440	250	118	0	7933
5212	7311	244	152	120	0	7827
5213	269	151	118	7275	0	7813
5214	162	81	78	7422	0	7743
5215	7389	58	66	359	0	7872
5216	7699	48	72	197	0	8016
5217	8008	60	70	123	0	8261
5218	430	70	42	7571	0	8113
5219	228	7575	58	275	0	8136
5220	7700	233	45	189	0	8167
5221	302	7693	28	145	0	8168
5222	7404	262	36	91	0	7793
5223	307	7263	56	72	0	7698
5224	194	263	35	7022	0	7514
5225	7099	165	34	240	0	7538
5226	7213	120	26	153	0	7512
5227	7320	76	24	123	0	7543
5228	7370	78	20	96	0	7564
5229	7399	47	20	82	0	7548
5230	431	58	6967	66	0	7522
5231	273	42	186	7013	0	7514
5232	187	49	6999	218	0	7453
5233	152	53	6995	133	0	7333
5234	6991	58	290	99	0	7438
5235	7141	58	154	72	0	7425
5236	7208	56	95	61	0	7420
5237	378	59	72	6822	0	7331
5238	6891	39	50	236	0	7216
5239	338	6604	57	134	0	7133
5240	228	6772	38	108	0	7146
5241	142	6344	23	56	0	6565
5242	5641	189	47	43	0	5920
5243	180	5542	22	40	0	5784
5244	5115	127	16	39	0	5297
5245	5068	55	15	21	0	5159
5246	163	42	5004	19	0	5228
5247	104	34	98	4948	0	5184
5248	86	29	44	5169	0	5328
5249	5227	15	30	153	0	5425
5250	5271	24	30	74	0	5399
5251	197	13	17	5188	0	5415
5252	108	19	5097	134	0	5358
5253	67	18	5133	73	0	5291
5254	64	25	151	5135	0	5375
5255	60	20	57	5122	0	5259
5256	56	26	30	5236	0	5348
5257	5063	23	19	186	0	5291
5258	5138	23	21	95	0	5277
5259	181	5115	29	58	0	5383
5260	111	108	22	5192	0	5433
5261	82	53	17	5223	0	5375
5262	65	5163	19	173	0	5420
5263	64	129	15	5231	0	5439
5264	5195	57	18	174	0	5444
5265	169	37	24	5188	0	5418
5266	88	38	27	5289	0	5442
5267	5110	16	24	210	0	5360
5268	5137	18	23	117	0	5295
5269	5177	28	24	77	0	5306
5270	229	22	16	5025	0	5292
5271	130	18	4816	146	0	5110
5272	90	22	4775	88	0	4975
5273	80	24	4716	70	0	4890
5274	84	4552	141	52	0	4829
5275	4417	116	95	40	0	4668
5276	134	61	4313	45	0	4553
5277	4258	35	102	50	0	4445
5278	146	31	60	4250	0	4487
5279	4007	23	43	139	0	4212
5280	4369	18	33	70	0	4490
5281	178	4314	23	48	0	4563
5282	4433	90	22	53	0	4598
5283	4452	41	31	62	0	4586
5284	166	4289	31	43	0	4529
5285	109	93	31	4376	0	4609
5286	86	50	4319	107	0	4562
5287	70	38	103	4232	0	4443
5288	67	39	52	4332	0	4490
5289	4301	18	48	158	0	4525
5290	147	19	37	4279	0	4482
5291	87	4298	23	144	0	4552
5292	93	92	17	4357	0	4559
5293	74	46	28	4428	0	4576
5294	57	45	4255	173	0	4530
5295	53	4226	100	104	0	4483
5296	68	4360	52	69	0	4549
5297	4209	138	34	78	0	4459
5298	106	4363	21	65	0	4555
5299	92	124	24	4342	0	4582
5300	70	61	4321	138	0	4590
5301	60	4368	103	94	0	4625
5302	4420	116	45	77	0	4658
5303	136	65	40	4417	0	4658
5304	88	51	34	4515	0	4688
5305	54	48	4418	175	0	4695
5306	52	34	107	4377	0	4570
5307	62	28	70	4475	0	4635
5308	4341	40	43	180	0	4604
5309	4260	35	32	104	0	4431
5310	146	4160	34	85	0	4425
5311	3967	80	24	65	0	4136
5312	131	3811	13	55	0	4010
5313	77	140	20	3489	0	3726
5314	67	3492	17	95	0	3671
5315	55	3591	18	64	0	3728
5316	3186	105	37	64	0	3392
5317	3095	29	14	48	0	3186
5318	78	3040	19	30	0	3167
5319	3082	54	15	32	0	3183
5320	3089	24	5	43	0	3161
5321	3162	18	6	40	0	3226
5322	88	13	12	3190	0	3303
5323	3185	19	14	69	0	3287
5324	77	21	3043	31	0	3172
5325	3028	24	48	37	0	3137
5326	78	23	3161	20	0	3282
5327	46	22	55	3201	0	3324
5328	32	32	22	3275	0	3361
5329	35	18	3224	73	0	3350
5330	3148	16	53	46	0	3263
5331	3234	18	24	37	0	3313
5332	90	13	3356	28	0	3487
5333	62	16	54	3325	0	3457
5334	46	15	29	3366	0	3456
5335	31	12	16	3443	0	3502
5336	3355	12	20	91	0	3478
5337	3378	6	25	49	0	3458
5338	78	18	12	3275	0	3383
5339	46	3196	15	62	0	3319
5340	38	3163	15	31	0	3247
5341	3049	55	12	36	0	3152
5342	53	3068	13	31	0	3165
5343	33	2997	8	30	0	3068
5344	46	55	4	2645	0	2750
5345	18	11	2654	35	0	2718
5346	15	2562	29	15	0	2621
5347	18	52	10	2508	0	2588
5348	9	2532	8	23	0	2572
5349	17	20	6	2452	0	2495
5350	2450	11	5	28	0	2494
5351	20	2537	3	16	0	2576
5352	2563	18	6	17	0	2604
5353	2535	10	5	11	0	2561
5354	26	5	2503	11	0	2545
5355	2500	7	18	10	0	2535
5356	18	14	6	2593	0	2631
5357	11	3	2573	27	0	2614
5358	6	2525	18	11	0	2560
5359	14	15	3	2475	0	2507
5360	13	1	1	2490	0	2505
5361	2450	8	4	25	0	2487
5362	17	4	2	2466	0	2489
5363	14	4	0	2463	0	2481
5364	2446	6	2	30	0	2484
5365	16	2453	6	7	0	2482
5366	2439	16	0	18	0	2473
5367	17	4	2442	5	0	2468
5368	2287	8	11	9	0	2315
5369	16	8	2504	6	0	2534
5370	7	2502	11	10	0	2530
5371	2530	17	4	12	0	2563
5372	2450	7	5	11	0	2473
5373	19	4	2443	10	0	2476
5374	12	8	2429	3	0	2452
5375	14	9	2477	5	0	2505
5376	13	2562	23	5	0	2603
5377	16	24	11	2591	0	2642
5378	6	11	2815	27	0	2859
5379	12	4	2719	7	0	2742
5380	12	7	51	2754	0	2824
5381	14	3	2835	39	0	2891
5382	2846	2	51	26	0	2925
5383	3448	5	24	17	0	3494
5384	79	5	3450	6	0	3540
5385	30	3446	71	12	0	3559
5386	28	66	28	3475	0	3597
5387	19	20	3496	67	0	3602
5388	10	3438	66	28	0	3542
5389	19	62	35	3384	0	3500
5390	3421	26	21	72	0	3540
5391	3428	16	8	32	0	3484
5392	83	3443	9	24	0	3559
5393	41	62	5	3484	0	3592
5394	23	22	10	3522	0	3577
5395	25	15	8	3474	0	3522
5396	23	8	8	3535	0	3574
5397	13	3	3429	101	0	3546
5398	16	14	63	3437	0	3530
5399	3	8	3400	90	0	3501
5400	9	3300	75	29	0	3413
5401	3270	60	27	30	0	3387
5402	59	3437	23	13	0	3532
5403	24	70	11	3452	0	3557
5404	25	18	12	3493	0	3548
5405	3407	21	13	88	0	3529
5406	66	6	7	3445	0	3524
5407	24	3374	13	73	0	3484
5408	26	58	3	3488	0	3575
5409	11	17	8	3525	0	3561
5410	3442	27	9	81	0	3559
5411	71	11	3338	47	0	3467
5412	24	3315	48	29	0	3416
5413	20	3421	23	13	0	3477
5414	22	61	9	3345	0	3437
5415	3289	28	6	69	0	3392
5416	56	3264	4	33	0	3357
5417	24	57	9	3313	0	3403
5418	19	22	3258	63	0	3362
5419	16	16	55	3253	0	3340
5420	3268	10	19	78	0	3375
5421	3234	7	19	33	0	3293
5422	75	11	3	3199	0	3288
5423	3246	5	5	76	0	3332
5424	3248	6	10	40	0	3304
5425	81	8	3185	26	0	3300
5426	3082	8	55	20	0	3165
5427	74	3171	18	18	0	3281
5428	3190	56	17	23	0	3286
5429	74	25	3101	10	0	3210
5430	30	19	56	3140	0	3245
5431	3223	5	22	65	0	3315
5432	68	8	3066	31	0	3173
5433	29	9	3093	20	0	3151
5434	36	9	76	3073	0	3194
5435	9	9	3160	70	0	3248
5436	3125	3	81	34	0	3243
5437	70	10	3216	22	0	3318
5438	33	7	86	3245	0	3371
5439	23	4	27	3335	0	3389
5440	3400	6	21	101	0	3528
5441	81	5	3399	41	0	3526
5442	36	8	3623	24	0	3691
5443	31	3	102	3931	0	4067
5444	12	6	3988	103	0	4109
5445	3938	6	113	42	0	4099
5446	115	2	47	3976	0	4140
5447	34	6	4036	103	0	4179
5448	37	2	102	4056	0	4197
5449	25	7	40	4175	0	4247
5450	4144	2	29	143	0	4318
5451	109	6	4071	58	0	4244
5452	4004	9	113	40	0	4166
5453	120	6	4130	28	0	4284
5454	4063	5	117	29	0	4214
5455	4141	7	55	21	0	4224
5456	4142	7	21	34	0	4204
5457	144	3964	31	17	0	4156
5458	4085	93	15	27	0	4220
5459	4118	32	18	38	0	4206
5460	153	17	17	4077	0	4264
5461	56	6	4052	120	0	4234
5462	4011	7	102	55	0	4175
5463	117	7	4173	39	0	4336
5464	66	4	121	4121	0	4312
5465	50	5	49	4259	0	4363
5466	4212	3	36	146	0	4397
5467	124	4268	27	55	0	4474
5468	65	97	15	4260	0	4437
5469	47	35	24	4325	0	4431
5470	33	24	4203	149	0	4409
5471	34	6	106	4201	0	4347
5472	42	6	44	4313	0	4405
5473	36	9	41	4225	0	4311
5474	33	4107	26	137	0	4303
5475	4050	92	22	74	0	4238
5476	4084	29	20	58	0	4191
5477	129	4021	16	37	0	4203
5478	3782	73	11	28	0	3894
5479	103	35	12	3938	0	4088
5480	49	13	4036	98	0	4196
5481	30	3985	94	51	0	4160
5482	27	4130	36	44	0	4237
5483	3853	77	31	30	0	3991
5484	4158	24	17	32	0	4231
5485	115	11	13	4150	0	4289
5486	52	14	14	4219	0	4299
5487	32	13	6	4273	0	4324
5488	4151	4	11	129	0	4295
5489	101	13	4092	57	0	4263
5490	4130	4	92	43	0	4269
5491	109	5	34	4189	0	4337
5492	57	10	22	4159	0	4248
5493	32	4130	21	115	0	4298
5494	38	81	18	4248	0	4385
5495	36	29	17	4339	0	4421
5496	33	19	4325	134	0	4511
5497	29	4352	75	60	0	4516
5498	4439	87	30	48	0	4604
5499	4367	33	22	44	0	4466
5500	4519	5	23	38	0	4585
5501	4482	27	17	44	0	4570
5502	128	11	4239	33	0	4411
5503	4243	12	83	33	0	4371
5504	121	14	4315	28	0	4478
5505	69	13	85	4224	0	4391
5506	36	4306	41	104	0	4487
5507	44	84	19	4373	0	4520
5508	45	38	24	4471	0	4578
5509	29	18	4417	133	0	4597
5510	4294	16	92	82	0	4484
5511	4420	13	43	54	0	4530
5512	123	4314	24	46	0	4507
5513	66	82	4357	38	0	4543
5514	57	36	90	4362	0	4545
5515	41	21	4381	114	0	4557
5516	43	28	4349	58	0	4478
5517	60	21	119	4390	0	4590
5518	51	21	4391	112	0	4575
5519	43	17	107	4401	0	4568
5520	48	10	4521	125	0	4704
5521	30	18	107	4517	0	4672
5522	4515	28	51	125	0	4719
5523	4574	18	24	78	0	4694
5524	4563	14	27	65	0	4669
5525	4497	18	33	64	0	4612
5526	143	4400	26	50	0	4619
5527	76	81	23	4441	0	4621
5528	53	36	32	4508	0	4629
5529	46	25	4398	154	0	4623
5530	58	22	101	4360	0	4541
5531	36	21	4351	135	0	4543
5532	33	24	4152	87	0	4296
5533	4052	19	114	67	0	4252
5534	101	4400	49	70	0	4620
5535	4484	87	45	50	0	4666
5536	4499	47	32	55	0	4633
5537	140	4557	27	42	0	4766
5538	4648	87	33	51	0	4819
5539	131	47	4628	27	0	4833
5540	76	4530	94	34	0	4734
5541	4557	82	50	47	0	4736
5542	97	40	4340	30	0	4507
5543	4029	14	57	38	0	4138
5544	64	4177	41	19	0	4301
5545	4175	57	18	39	0	4289
5546	4177	27	17	35	0	4256
5547	91	4027	24	21	0	4163
5548	41	4089	19	20	0	4169
5549	32	4219	19	18	0	4288
5550	34	68	21	4224	0	4347
5551	26	28	18	4256	0	4328
5552	4258	24	19	90	0	4391
5553	4192	15	28	58	0	4293
5554	76	9	4173	37	0	4295
5555	36	21	4018	34	0	4109
5556	31	11	4193	31	0	4266
5557	38	5	79	4234	0	4356
5558	27	14	4350	63	0	4454
5559	38	10	66	4278	0	4392
5560	4358	6	38	86	0	4488
5561	76	9	4424	42	0	4551
5562	4385	16	63	38	0	4502
5563	4467	15	30	40	0	4552
5564	87	15	4514	23	0	4639
5565	40	4553	72	28	0	4693
5566	37	60	37	4556	0	4690
5567	32	22	4622	70	0	4746
5568	38	13	66	4528	0	4645
5569	34	13	44	4961	0	5052
5570	4924	13	20	105	0	5062
5571	95	11	27	4938	0	5071
5572	47	17	4921	83	0	5068
5573	40	17	75	4919	0	5051
5574	4988	10	39	92	0	5129
5575	83	5007	27	70	0	5187
5576	5102	74	28	40	0	5244
5577	101	41	22	5099	0	5263
5578	61	22	5080	77	0	5240
5579	37	16	4856	38	0	4947
5580	50	27	4815	16	0	4908
5581	28	4722	75	15	0	4840
5582	4602	69	59	28	0	4758
5583	49	4415	18	16	0	4498
5584	4136	31	1	15	0	4183
5585	33	4079	5	7	0	4124
5586	18	34	5	4139	0	4196
5587	8	15	2	4159	0	4184
5588	6	4	5	4147	0	4162
5589	2	4099	5	51	0	4157
5590	10	28	4	4226	0	4268
5591	8	18	1	4628	0	4655
5592	4891	6	4	75	0	4976
5593	74	4	5	5244	0	5327
5594	25	6	5605	78	0	5714
5595	5547	2	79	39	0	5667
5596	5755	2	29	27	0	5813
5597	112	5801	12	6	0	5931
5598	5879	82	7	23	0	5991
5599	6010	35	7	20	0	6072
5600	155	14	3	5912	0	6084
5601	82	10	9	6035	0	6136
5602	45	10	9	6205	0	6269
5603	6125	3	10	171	0	6309
5604	6198	10	8	73	0	6289
5605	163	13	6107	41	0	6324
5606	6092	14	97	40	0	6243
5607	6221	8	35	36	0	6300
5608	6206	3	14	45	0	6268
5609	181	9	5975	34	0	6199
5610	86	9	6030	29	0	6154
5611	71	2	137	6045	0	6255
5612	53	3	6168	112	0	6336
5613	52	7	140	6030	0	6229
5614	53	9	68	5709	0	5839
5615	46	6109	37	125	0	6317
5616	6137	102	25	66	0	6330
5617	131	44	6177	34	0	6386
5618	6183	21	135	46	0	6385
5619	164	18	59	6326	0	6567
5620	6197	14	38	147	0	6396
5621	155	6073	31	85	0	6344
5622	75	6425	26	53	0	6579
5623	74	174	11	6350	0	6609
5624	72	55	18	6475	0	6620
5625	40	41	6333	189	0	6603
5626	54	21	138	6381	0	6594
5627	6189	15	43	207	0	6454
5628	157	6235	37	84	0	6513
5629	86	143	6264	45	0	6538
5630	85	58	139	6226	0	6508
5631	43	41	6316	161	0	6561
5632	59	18	156	6316	0	6549
5633	35	19	6369	182	0	6605
5634	35	18	6101	89	0	6243
5635	40	23	172	6060	0	6295
5636	6090	20	82	180	0	6372
5637	6046	20	68	80	0	6214
5638	5898	18	53	72	0	6041
5639	199	5735	42	50	0	6026
5640	5913	138	37	52	0	6140
5641	5912	51	51	47	0	6061
5642	207	36	5729	47	0	6019
5643	103	5661	165	41	0	5970
5644	99	145	54	5607	0	5905
5645	5583	50	51	157	0	5841
5646	173	5539	35	73	0	5820
5647	5691	151	29	67	0	5938
5648	5729	68	19	53	0	5869
5649	5671	45	33	48	0	5797
5650	5646	36	35	48	0	5765
5651	236	33	32	5460	0	5761
5652	5543	30	25	162	0	5760
5653	204	30	31	5441	0	5706
5654	97	5319	35	177	0	5628
5655	84	134	23	5474	0	5715
5656	5418	55	29	180	0	5682
5657	187	31	5339	88	0	5645
5658	109	21	147	5397	0	5674
5659	5347	25	55	178	0	5605
5660	190	5255	41	97	0	5583
5661	5235	129	32	68	0	5464
5662	5303	57	35	57	0	5452
5663	216	5177	25	63	0	5481
5664	5195	152	29	50	0	5426
5665	217	59	4924	37	0	5237
5666	109	39	4899	50	0	5097
5667	4870	39	172	52	0	5133
5668	198	45	4821	38	0	5102
5669	118	35	137	4434	0	4724
5670	92	4538	68	120	0	4818
5671	4625	125	34	59	0	4843
5672	181	4515	34	40	0	4770
5673	110	4513	51	26	0	4700
5674	86	150	41	4683	0	4960
5675	81	70	38	4712	0	4901
5676	73	37	34	4704	0	4848
5677	65	40	31	4713	0	4849
5678	52	38	4529	191	0	4810
5679	61	39	116	4459	0	4675
5680	72	36	42	4529	0	4679
5681	4418	41	30	188	0	4677
5682	149	34	37	4443	0	4663
5683	85	27	4302	193	0	4607
5684	4342	20	117	103	0	4582
5685	164	33	43	4387	0	4627
5686	77	20	4466	166	0	4729
5687	76	32	124	4422	0	4654
5688	55	4439	64	156	0	4714
5689	4506	109	33	78	0	4726
5690	154	43	4391	58	0	4646
5691	73	3948	116	46	0	4183
5692	3664	88	49	48	0	3849
5693	116	3233	31	25	0	3405
5694	37	2863	28	15	0	2943
5695	2814	72	32	21	0	2939
5696	78	2692	14	9	0	2793
5697	23	2676	7	12	0	2718
5698	33	68	19	2602	0	2722
5699	19	16	2581	46	0	2662
5700	17	2582	48	15	0	2662
5701	20	55	12	2514	0	2601
5702	12	2451	3	36	0	2502
5703	2464	40	5	14	0	2523
5704	46	8	2405	11	0	2470
5705	16	5	28	2422	0	2471
5706	2489	7	7	43	0	2546
5707	42	7	0	2567	0	2616
5708	11	4	2553	36	0	2604
5709	2504	5	30	14	0	2553
5710	2654	2	8	21	0	2685
5711	33	2820	10	14	0	2877
5712	12	33	6	2873	0	2924
5713	7	10	4	2928	0	2949
5714	2930	5	10	40	0	2985
5715	2913	6	3	16	0	2938
5716	43	12	2997	8	0	3060
5717	16	2961	33	5	0	3015
5718	3028	27	8	9	0	3072
5719	36	12	8	3021	0	3077
5720	18	4	3142	30	0	3194
5721	5	7	2947	11	0	2970
5722	7	28	28	2977	0	3040
5723	3058	2	2	25	0	3087
5724	18	3023	3	3	0	3047
5725	3284	16	2	13	0	3315
5726	20	2	3	3414	0	3439
5727	9	1	1	3456	0	3467
5728	4	3	1	3510	0	3518
5729	3518	2	3	21	0	3544
5730	16	3531	3	7	0	3557
5731	6	11	1	3641	0	3659
5732	4	3	2	3638	0	3647
5733	3	4	3579	17	0	3603
5734	7	5	15	3512	0	3539
5735	4	7	3636	15	0	3662
5736	0	3536	12	6	0	3554
5737	2	9	2	3607	0	3620
5738	3583	2	0	14	0	3599
5739	10	3	3539	1	0	3553
5740	4	4	9	3569	0	3586
5741	2	0	3545	12	0	3559
5742	3397	1	8	7	0	3413
5743	10	6	3643	1	0	3660
5744	3	6	11	3530	0	3550
5745	3619	0	4	13	0	3636
5746	17	3296	9	1	0	3323
5747	3524	8	2	8	0	3542
5748	11	3371	7	4	0	3393
5749	8	8	1	3817	0	3834
5750	6	5	3790	11	0	3812
5751	6	4	3614	6	0	3630
5752	10	2	10	3805	0	3827
5753	3936	3	3	15	0	3957
5754	3851	1	1	6	0	3859
5755	15	0	2	3917	0	3934
5756	4	3	3	3972	0	3982
5757	3933	0	1	19	0	3953
5758	16	3902	2	5	0	3925
5759	4	4056	0	8	0	4068
5760	4199	11	1	17	0	4228
5761	17	4	4203	2	0	4226
5762	12	2	13	4159	0	4186
5763	2	4	4178	18	0	4202
5764	7	0	13	4198	0	4218
5765	6	4	4204	15	0	4229
5766	3	4	4055	8	0	4070
5767	10	1	18	4311	0	4340
5768	1	4163	5	16	0	4185
5769	4423	13	3	11	0	4450
5770	16	4371	6	2	0	4395
5771	6	20	3	4554	0	4583
5772	4606	3	5	20	0	4634
5773	16	4	2	4638	0	4660
5774	4696	3	0	25	0	4724
5775	4664	6	3	12	0	4685
5776	4695	2	3	13	0	4713
5777	19	4568	4	12	0	4603
5778	4765	12	4	9	0	4790
5779	22	4	7	4825	0	4858
5780	4954	1	4	34	0	4993
5781	22	2	5	5046	0	5075
5782	5106	4	5	31	0	5146
5783	5126	1	7	25	0	5159
5784	25	5073	8	14	0	5120
5785	14	23	3	5504	0	5544
5786	8	7	5	5606	0	5626
5787	13	6090	10	42	0	6155
5788	11	62	1	6465	0	6539
5789	6518	24	0	87	0	6629
5790	6875	5	5	44	0	6929
5791	6786	6	8	43	0	6843
5792	97	10	6993	15	0	7115
5793	7235	1	64	35	0	7335
5794	7556	7	23	20	0	7606
5795	7714	9	12	23	0	7758
5796	124	7596	7	16	0	7743
5797	74	73	10	7732	0	7889
5798	38	34	4	7850	0	7926
5799	26	11	7	7816	0	7860
5800	19	13	7650	125	0	7807
5801	30	6	73	7666	0	7775
5802	7780	8	36	114	0	7938
5803	102	6	12	7869	0	7989
5804	61	5	8	8110	0	8184
5805	25	7	8009	132	0	8173
5806	26	8001	89	60	0	8176
5807	8310	86	44	47	0	8487
5808	110	39	17	8348	0	8514
5809	8387	11	9	132	0	8539
5810	109	15	8201	53	0	8378
5811	7859	11	90	47	0	8007
5812	109	8328	52	27	0	8516
5813	59	92	8303	25	0	8479
5814	28	53	8295	22	0	8398
5815	62	32	130	8047	0	8271
5816	16	10	8626	106	0	8758
5817	21	8602	104	60	0	8787
5818	34	88	53	8602	0	8777
5819	31	44	13	8714	0	8802
5820	26	15	14	8734	0	8789
5821	8583	8	14	155	0	8760
5822	91	8552	14	71	0	8728
5823	66	83	14	8771	0	8934
5824	35	51	7	8899	0	8992
5825	8684	14	12	161	0	8871
5826	94	8642	11	76	0	8823
5827	8860	90	9	55	0	9014
5828	8803	49	17	50	0	8919
5829	8780	20	8	47	0	8855
5830	156	22	8615	25	0	8818
5831	83	10	90	8517	0	8700
5832	41	8554	51	99	0	8745
5833	39	8732	21	63	0	8855
5834	49	129	16	8734	0	8928
5835	38	8675	18	105	0	8836
5836	9157	107	17	95	0	9376
5837	113	61	9046	40	0	9260
5838	8995	22	85	57	0	9159
5839	9435	23	46	44	0	9548
5840	159	27	21	9534	0	9741
5841	9613	16	14	142	0	9785
5842	122	10039	14	78	0	10253
5843	10305	101	16	94	0	10516
5844	10356	57	18	59	0	10490
5845	11247	28	17	53	0	11345
5846	205	22	11297	36	0	11560
5847	120	34	11310	39	0	11503
5848	81	17	188	11429	0	11715
5849	65	11188	104	157	0	11514
5850	61	11558	48	103	0	11770
5851	75	198	30	11519	0	11822
5852	11695	105	26	204	0	12030
5853	182	45	24	11774	0	12025
5854	119	32	30	11992	0	12173
5855	11873	29	29	267	0	12198
5856	175	11823	30	144	0	12172
5857	124	156	11824	75	0	12179
5858	89	89	11481	79	0	11738
5859	11874	37	207	72	0	12190
5860	178	46	113	11788	0	12125
5861	111	34	12000	169	0	12314
5862	91	31	155	11830	0	12107
5863	60	38	96	11856	0	12050
5864	67	18	47	12250	0	12382
5865	61	26	46	12125	0	12258
5866	50	11848	39	257	0	12194
5867	62	146	27	12132	0	12367
5868	11965	92	36	212	0	12305
5869	151	11891	38	131	0	12211
5870	12159	154	48	101	0	12462
5871	12235	91	47	96	0	12469
5872	12287	54	31	74	0	12446
5873	253	61	11880	54	0	12248
5874	11969	38	152	83	0	12242
5875	12288	33	87	99	0	12507
5876	12100	31	51	97	0	12279
5877	12320	32	45	80	0	12477
5878	250	12160	32	68	0	12510
5879	12206	147	23	77	0	12453
5880	218	104	12113	64	0	12499
5881	148	56	134	12065	0	12403
5882	106	53	81	12248	0	12488
5883	12417	35	32	258	0	12742
5884	207	12252	26	128	0	12613
5885	12066	125	30	102	0	12323
5886	169	12083	33	50	0	12335
5887	11534	117	13	70	0	11734
5888	11356	62	20	53	0	11491
5889	196	11797	21	20	0	12034
5890	11840	126	11	44	0	12021
5891	12321	72	14	39	0	12446
5892	250	11660	19	17	0	11946
5893	98	12054	32	23	0	12207
5894	12965	201	40	53	0	13259
5895	261	80	18	13323	0	13682
5896	13499	58	9	251	0	13817
5897	13962	33	4	126	0	14125
5898	14373	32	8	79	0	14492
5899	14334	44	7	67	0	14452
5900	399	13713	20	46	0	14178
5901	202	14243	22	25	0	14492
5902	14316	318	17	85	0	14736
5903	340	134	14073	23	0	14570
5904	178	93	245	13830	0	14346
5905	135	55	91	14203	0	14484
5906	13862	34	50	379	0	14325
5907	290	13644	42	164	0	14140
5908	152	254	22	13689	0	14117
5909	127	95	9	14085	0	14316
5910	13898	54	29	408	0	14389
5911	345	50	7	13960	0	14362
5912	13909	49	11	394	0	14363
5913	14058	43	16	191	0	14308
5914	14163	64	7	122	0	14356
5915	498	58	8	13804	0	14368
5916	261	27	26	13921	0	14235
5917	179	20	14240	405	0	14844
5918	152	24	13973	206	0	14355
5919	14342	26	460	150	0	14978
5920	446	44	197	14673	0	15360
5921	243	51	15619	407	0	16320
5922	144	42	15874	213	0	16273
5923	164	21	571	15819	0	16575
5924	106	43	16007	499	0	16655
5925	153	28	518	15862	0	16561
5926	159	36	238	16069	0	16502
5927	111	41	15827	668	0	16647
5928	136	29	482	15957	0	16604
5929	183	40	243	15518	0	15984
5930	143	30	119	16495	0	16787
5931	102	37	15780	767	0	16686
5932	152	35	475	16174	0	16836
5933	15982	32	210	681	0	16905
5934	534	15939	117	351	0	16941
5935	16176	445	104	243	0	16968
5936	602	208	15823	172	0	16805
5937	16020	85	496	189	0	16790
5938	16349	62	246	153	0	16810
5939	16337	77	138	146	0	16698
5940	811	62	105	15655	0	16633
5941	441	70	119	16009	0	16639
5942	251	42	14740	741	0	15774
5943	14277	35	498	397	0	15207
5944	599	14270	265	227	0	15361
5945	299	13574	132	185	0	14190
5946	185	13927	115	164	0	14391
5947	195	620	101	13284	0	14200
5948	13134	249	96	530	0	14009
5949	13368	122	103	304	0	13897
5950	677	76	12892	195	0	13840
5951	364	77	437	12980	0	13858
5952	236	83	216	13252	0	13787
5953	172	76	12792	689	0	13729
5954	168	75	12508	383	0	13134
5955	12314	68	607	257	0	13246
5956	525	12472	276	205	0	13478
5957	12815	402	159	205	0	13581
5958	13038	195	127	177	0	13537
5959	687	118	110	12632	0	13547
5960	374	66	107	13038	0	13585
5961	12605	61	107	682	0	13455
5962	615	64	74	12685	0	13438
5963	356	69	96	12877	0	13398
5964	12546	53	107	742	0	13448
5965	593	53	102	12687	0	13435
5966	12665	51	90	657	0	13463
5967	12867	46	102	388	0	13403
5968	718	55	12292	271	0	13336
5969	12446	54	476	234	0	13210
5970	12621	58	254	226	0	13159
5971	12611	45	158	220	0	13034
5972	760	68	9845	251	0	10924
5973	11826	55	404	202	0	12487
5974	614	11612	231	197	0	12654
5975	12028	405	157	202	0	12792
5976	12312	172	138	185	0	12807
5977	715	88	101	11970	0	12874
5978	404	53	127	12148	0	12732
5979	255	11753	105	709	0	12822
5980	258	393	84	12022	0	12757
5981	240	196	90	12323	0	12849
5982	11894	108	103	745	0	12850
5983	583	81	89	11929	0	12682
5984	383	73	64	12085	0	12605
5985	276	82	74	11982	0	12414
5986	253	11151	74	755	0	12233
5987	11133	426	81	411	0	12051
5988	599	11173	69	271	0	12112
5989	10702	428	76	208	0	11414
5990	608	186	10081	197	0	11072
5991	9708	91	376	183	0	10358
5992	528	82	9584	159	0	10353
5993	306	9119	408	136	0	9969
5994	8197	347	304	162	0	9010
5995	8001	143	129	116	0	8389
5996	452	7441	76	108	0	8077
5997	261	7434	60	89	0	7844
5998	6972	306	61	115	0	7454
5999	7154	154	39	90	0	7437
6000	423	53	48	6910	0	7434
6001	223	56	29	7123	0	7431
6002	136	61	6756	365	0	7318
6003	6729	59	215	187	0	7190
6004	328	40	125	6751	0	7244
6005	197	6705	60	272	0	7234
6006	156	206	24	6913	0	7299
6007	119	120	37	6997	0	7273
6008	103	55	6659	378	0	7195
6009	113	44	201	6790	0	7148
6010	6602	54	114	317	0	7087
6011	266	6460	59	180	0	6965
6012	171	6505	25	135	0	6836
6013	6479	297	30	90	0	6896
6014	6514	139	31	99	0	6783
6015	6520	75	33	89	0	6717
6016	393	6089	28	77	0	6587
6017	119	5549	23	40	0	5731
6018	5953	170	36	28	0	6187
6019	5997	73	39	67	0	6176
6020	258	5697	25	43	0	6023
6021	61	4706	4	20	0	4791
6022	4449	100	26	24	0	4599
6023	113	32	10	4394	0	4549
6024	4332	16	5	112	0	4465
6025	121	10	6	4353	0	4490
6026	38	4343	7	101	0	4489
6027	23	4415	9	34	0	4481
6028	4595	109	8	29	0	4741
6029	4698	42	11	39	0	4790
6030	4940	23	1	22	0	4986
6031	152	4866	9	9	0	5036
6032	47	110	4597	10	0	4764
6033	29	4598	85	5	0	4717
6034	4451	113	28	23	0	4615
6035	4318	31	13	22	0	4384
6036	118	25	4245	8	0	4396
6037	43	4178	82	10	0	4313
6038	39	93	27	4207	0	4366
6039	24	33	13	4149	0	4219
6040	26	3829	14	111	0	3980
6041	20	96	4050	27	0	4193
6042	4161	34	86	23	0	4304
6043	110	26	24	4202	0	4362
6044	4247	16	18	103	0	4384
6045	4332	11	3	32	0	4378
6046	138	17	6	4308	0	4469
6047	61	14	11	4592	0	4678
6048	45	25	15	4663	0	4748
6049	39	23	6	4713	0	4781
6050	4574	15	10	182	0	4781
6051	4673	16	10	71	0	4770
6052	160	14	4583	35	0	4792
6053	72	12	116	4600	0	4800
6054	53	15	33	4740	0	4841
6055	32	24	21	4784	0	4861
6056	31	15	4560	178	0	4784
6057	43	14	111	4483	0	4651
6058	4430	13	42	161	0	4646
6059	147	15	27	4436	0	4625
6060	66	11	4425	153	0	4655
6061	51	9	119	4465	0	4644
6062	30	17	4413	157	0	4617
6063	4394	18	134	74	0	4620
6064	143	7	46	4460	0	4656
6065	4441	11	27	158	0	4637
6066	4479	14	14	75	0	4582
6067	177	14	12	4411	0	4614
6068	4427	11	23	165	0	4626
6069	166	14	19	4325	0	4524
6070	62	4415	26	155	0	4658
6071	4624	122	19	74	0	4839
6072	4709	47	16	48	0	4820
6073	4709	27	12	44	0	4792
6074	203	14	26	4580	0	4823
6075	96	10	9	4637	0	4752
6076	54	15	11	4699	0	4779
6077	36	22	4382	199	0	4639
6078	33	4313	122	90	0	4558
6079	58	136	39	4265	0	4498
6080	58	34	4197	139	0	4428
6081	4184	22	122	84	0	4412
6082	156	17	33	4242	0	4448
6083	73	6	4141	161	0	4381
6084	4231	11	126	83	0	4451
6085	151	18	34	4335	0	4538
6086	67	10	28	4428	0	4533
6087	67	7	12	4473	0	4559
6088	4351	10	18	208	0	4587
6089	4413	10	20	103	0	4546
6090	4340	11	23	69	0	4443
6091	179	4038	22	62	0	4301
6092	78	4236	26	44	0	4384
6093	4244	120	10	73	0	4447
6094	143	39	4122	58	0	4362
6095	71	27	123	4114	0	4335
6096	64	16	46	4212	0	4338
6097	4082	6	30	190	0	4308
6098	4007	17	30	87	0	4141
6099	158	3929	12	65	0	4164
6100	92	112	26	3956	0	4186
6101	64	36	3907	150	0	4157
6102	50	23	3986	74	0	4133
6103	57	11	138	4021	0	4227
6104	56	8	56	4152	0	4272
6105	4024	14	31	188	0	4257
6106	161	18	18	4076	0	4273
6107	4175	12	20	188	0	4395
6108	4172	20	24	76	0	4292
6109	180	12	3946	72	0	4210
6110	4133	15	109	57	0	4314
6111	4215	8	50	56	0	4329
6112	4183	9	36	70	0	4298
6113	188	3961	26	60	0	4235
6114	79	4083	17	72	0	4251
6115	67	152	27	4042	0	4288
6116	60	45	3994	146	0	4245
6117	52	3899	112	72	0	4135
6118	54	107	47	3437	0	3645
6119	47	30	31	3331	0	3439
6120	42	3290	18	103	0	3453
6121	3329	68	14	67	0	3478
6122	3420	29	20	49	0	3518
6123	122	22	3484	42	0	3670
6124	3486	11	72	59	0	3628
6125	107	13	3429	42	0	3591
6126	3205	17	72	36	0	3330
6127	103	16	3244	38	0	3401
6128	57	3064	66	25	0	3212
6129	56	50	51	2748	0	2905
6130	33	26	19	2773	0	2851
6131	2803	11	11	76	0	2901
6132	2826	6	14	34	0	2880
6133	2808	6	11	31	0	2856
6134	70	8	2869	29	0	2976
6135	47	9	47	2901	0	3004
6136	27	7	26	2989	0	3049
6137	2942	6	17	75	0	3040
6138	60	2949	7	38	0	3054
6139	3080	41	9	30	0	3160
6140	69	21	8	3210	0	3308
6141	46	16	10	3279	0	3351
6142	31	6	8	3311	0	3356
6143	23	3	9	3338	0	3373
6144	21	11	6	3322	0	3360
6145	30	3156	5	73	0	3264
6146	21	3064	4	46	0	3135
6147	10	2897	3	17	0	2927
6148	13	40	2	2898	0	2953
6149	13	6	2872	25	0	2916
6150	2688	6	20	14	0	2728
6151	20	2938	8	10	0	2976
6152	18	22	6	2936	0	2982
6153	9	8	6	3016	0	3039
6154	3119	4	3	35	0	3161
6155	3108	3	5	18	0	3134
6156	3187	5	1	15	0	3208
6157	35	1	2	3382	0	3420
6158	12	4	3435	27	0	3478
6159	10	4	3549	10	0	3573
6160	15	1	29	3616	0	3661
6161	7	5	3635	25	0	3672
6162	3515	1	28	13	0	3557
6163	29	1	4	3631	0	3665
6164	15	3	3705	31	0	3754
6165	17	4	25	3601	0	3647
6166	7	5	4008	33	0	4053
6167	9	4	4203	11	0	4227
6168	12	13	31	4539	0	4595
6169	7	3	4812	41	0	4863
6170	5	4	4616	12	0	4637
6171	4	4605	50	9	0	4668
6172	18	45	22	4798	0	4883
6173	5140	16	16	57	0	5229
6174	51	9	10	5114	0	5184
6175	19	8	2	5362	0	5391
6176	12	4	5335	65	0	5416
6177	5084	3	43	35	0	5165
6178	55	2	17	5466	0	5540
6179	22	0	13	5563	0	5598
6180	5525	1	7	72	0	5605
6181	58	1	3	5577	0	5639
6182	5650	2	3	77	0	5732
6183	5633	1	4	41	0	5679
6184	5683	1	2	31	0	5717
6185	69	5501	4	14	0	5588
6186	5658	40	2	14	0	5714
6187	58	5607	3	8	0	5676
6188	34	49	1	5678	0	5762
6189	5710	24	3	56	0	5793
6190	51	5661	6	21	0	5739
6191	5753	50	4	21	0	5828
6192	48	5706	8	12	0	5774
6193	5727	51	3	16	0	5797
6194	57	5684	5	7	0	5753
6195	29	5889	3	11	0	5932
6196	17	6262	5	3	0	6287
6197	22	79	4	6122	0	6227
6198	8	6229	5	49	0	6291
6199	14	75	4	6187	0	6280
6200	16	34	2	6273	0	6325
6201	16	19	3	6290	0	6328
6202	11	11	2	6321	0	6345
6203	6311	10	0	108	0	6429
6204	6391	4	1	65	0	6461
6205	82	11	6429	27	0	6549
6206	6668	4	59	49	0	6780
6207	6963	6	23	38	0	7030
6208	7255	4	19	30	0	7308
6209	118	9	7183	11	0	7321
6210	54	16	7266	13	0	7349
6211	7431	6	108	29	0	7574
6212	128	12	7774	7	0	7921
6213	48	8350	133	17	0	8548
6214	46	118	42	8545	0	8751
6215	8798	37	22	149	0	9006
6216	8858	23	22	67	0	8970
6217	8920	17	20	45	0	9002
6218	192	12	18	8885	0	9107
6219	95	13	9	9034	0	9151
6220	46	10	9038	172	0	9266
6221	61	12	127	9028	0	9228
6222	43	11	43	9253	0	9350
6223	9086	8	23	206	0	9323
6224	153	9097	19	68	0	9337
6225	9254	127	15	67	0	9463
6226	174	43	20	9353	0	9590
6227	9331	23	13	175	0	9542
6228	9322	17	18	91	0	9448
6229	9091	19	22	69	0	9201
6230	193	9044	14	58	0	9309
6231	87	9343	17	36	0	9483
6232	78	159	16	9421	0	9674
6233	9469	62	16	163	0	9710
6234	178	38	13	9346	0	9575
6235	97	24	14	9422	0	9557
6236	56	35	9269	183	0	9543
6237	65	28	126	9267	0	9486
6238	50	21	47	9335	0	9453
6239	58	20	24	9368	0	9470
6240	41	24	9136	205	0	9406
6241	46	17	8923	111	0	9097
6242	38	9019	155	69	0	9281
6243	9144	130	50	83	0	9407
6244	182	50	32	9233	0	9497
6245	81	31	9281	163	0	9556
6246	87	23	137	9202	0	9449
6247	71	18	49	9727	0	9865
6248	9581	20	27	219	0	9847
6249	9560	21	40	104	0	9725
6250	181	9478	29	82	0	9770
6251	9485	128	31	75	0	9719
6252	9508	47	41	64	0	9660
6253	202	42	29	9438	0	9711
6254	101	33	9263	154	0	9551
6255	78	9265	128	85	0	9556
6256	9271	137	48	77	0	9533
6257	9302	57	33	68	0	9460
6258	203	9363	33	51	0	9650
6259	102	147	19	9769	0	10037
6260	10115	55	23	220	0	10413
6261	10307	25	22	116	0	10470
6262	257	31	22	10247	0	10557
6263	10228	32	26	255	0	10541
6264	10948	23	15	123	0	11109
6265	11045	20	29	102	0	11196
6266	297	32	10701	80	0	11110
6267	143	10233	189	67	0	10632
6268	105	10539	60	65	0	10769
6269	10232	206	41	73	0	10552
6270	221	10324	34	49	0	10628
6271	91	208	10203	53	0	10555
6272	107	68	173	10238	0	10586
6273	10226	49	54	215	0	10544
6274	236	54	34	10196	0	10520
6275	10197	29	27	240	0	10493
6276	10256	41	23	104	0	10424
6277	10272	41	33	81	0	10427
6278	273	9845	44	75	0	10237
6279	130	10387	30	69	0	10616
6280	10376	213	28	82	0	10699
6281	10315	71	28	89	0	10503
6282	10449	56	23	83	0	10611
6283	300	36	39	10250	0	10625
6284	10179	36	18	251	0	10484
6285	257	9845	34	96	0	10232
6286	122	10236	28	92	0	10478
6287	119	222	32	10215	0	10588
6288	108	86	10081	218	0	10493
6289	99	62	9972	100	0	10233
6290	105	44	207	10087	0	10443
6291	96	44	10129	242	0	10511
6292	109	48	209	10145	0	10511
6293	10219	43	60	247	0	10569
6294	260	43	38	10155	0	10496
6295	10018	45	46	234	0	10343
6296	245	9707	34	117	0	10103
6297	130	206	9807	59	0	10202
6298	119	74	183	9647	0	10023
6299	124	48	60	10030	0	10262
6300	87	56	9874	256	0	10273
6301	114	37	200	9631	0	9982
6302	92	9733	60	224	0	10109
6303	116	190	48	9907	0	10261
6304	106	74	43	10011	0	10234
6305	121	46	29	10141	0	10337
6306	87	54	9989	292	0	10422
6307	109	28	9515	115	0	9767
6308	8965	39	214	114	0	9332
6309	244	32	9054	69	0	9399
6310	102	8966	200	63	0	9331
6311	8831	159	66	73	0	9129
6312	212	8865	46	57	0	9180
6313	8472	155	73	60	0	8760
6314	8452	78	32	55	0	8617
6315	8341	38	39	54	0	8472
6316	8316	51	28	62	0	8457
6317	231	8005	35	41	0	8312
6318	112	8175	29	41	0	8357
6319	8200	159	26	57	0	8442
6320	211	67	7892	44	0	8214
6321	111	50	146	7785	0	8092
6322	106	45	44	8006	0	8201
6323	90	34	7927	171	0	8222
6324	7541	45	155	79	0	7820
6325	7958	37	55	67	0	8117
6326	7852	47	40	68	0	8007
6327	212	7657	55	49	0	7973
6328	7943	159	27	71	0	8200
6329	220	62	34	7772	0	8088
6330	120	8218	38	163	0	8539
6331	8424	165	28	93	0	8710
6332	8563	84	29	71	0	8747
6333	9218	45	34	70	0	9367
6334	330	56	31	8970	0	9387
6335	185	36	35	9127	0	9383
6336	110	8825	37	278	0	9250
6337	113	211	8899	125	0	9348
6338	98	94	200	9040	0	9432
6339	117	54	86	9028	0	9285
6340	94	53	50	9497	0	9694
6341	76	39	9235	325	0	9675
6342	9058	52	203	179	0	9492
6343	258	34	107	9398	0	9797
6344	131	46	9407	271	0	9855
6345	110	38	245	9342	0	9735
6346	9466	37	115	294	0	9912
6347	255	9519	71	174	0	10019
6348	161	236	63	9796	0	10256
6349	90	100	9778	302	0	10270
6350	9496	54	254	164	0	9968
6351	9850	48	111	136	0	10145
6352	347	38	9639	101	0	10125
6353	178	53	257	9158	0	9646
6354	119	9485	113	236	0	9953
6355	9679	234	102	136	0	10151
6356	308	109	9455	86	0	9958
6357	9392	61	247	104	0	9804
6358	306	55	9340	77	0	9778
6359	164	36	8697	62	0	8959
6360	8327	38	283	59	0	8707
6361	243	8481	129	44	0	8897
6362	157	185	8371	50	0	8763
6363	87	8175	208	55	0	8525
6364	78	189	7891	35	0	8193
6365	42	7912	189	48	0	8191
6366	7521	187	118	46	0	7872
6367	186	98	7473	34	0	7791
6368	105	41	7401	42	0	7589
6369	62	50	7297	36	0	7445
6370	7003	43	266	36	0	7348
6371	7156	29	114	40	0	7339
6372	222	18	69	6971	0	7280
6373	97	20	7228	159	0	7504
6374	60	23	7201	88	0	7372
6375	7168	22	205	43	0	7438
6376	183	16	108	7313	0	7620
6377	7318	15	68	159	0	7560
6378	7342	13	55	98	0	7508
6379	243	20	39	6965	0	7267
6380	116	6944	44	161	0	7265
6381	91	144	35	7068	0	7338
6382	76	63	34	7190	0	7363
6383	56	39	7041	210	0	7346
6384	61	6843	163	108	0	7175
6385	54	7098	90	71	0	7313
6386	55	190	68	6947	0	7260
6387	31	83	6957	172	0	7243
6388	51	6872	153	98	0	7174
6389	45	156	6932	58	0	7191
6390	6784	88	180	72	0	7124
6391	7082	48	113	46	0	7289
6392	215	38	6949	45	0	7247
6393	6959	29	192	42	0	7222
6394	202	44	93	7018	0	7357
6395	116	7247	82	150	0	7595
6396	95	152	61	7406	0	7714
6397	7221	78	56	186	0	7541
6398	7310	48	64	99	0	7521
6399	7322	38	50	63	0	7473
6400	7226	31	45	69	0	7371
6401	252	6893	73	43	0	7261
6402	132	7045	58	50	0	7285
6403	7049	170	48	49	0	7316
6404	214	91	6978	42	0	7325
6405	143	171	146	6837	0	7297
6406	76	7125	102	148	0	7451
6407	57	149	68	7128	0	7402
6408	51	7279	68	172	0	7570
6409	72	176	47	7406	0	7701
6410	49	96	7424	194	0	7763
6411	7349	63	187	105	0	7704
6412	7483	51	97	67	0	7698
6413	239	55	7311	47	0	7652
6414	7321	41	202	45	0	7609
6415	7423	40	111	49	0	7623
6416	249	39	7247	33	0	7568
6417	161	33	192	7071	0	7457
6418	7280	29	118	172	0	7599
6419	210	32	7249	100	0	7591
6420	141	37	194	7087	0	7459
6421	79	28	7452	187	0	7746
6422	72	49	7320	94	0	7535
6423	7252	47	255	76	0	7630
6424	7548	26	124	44	0	7742
6425	7648	20	71	53	0	7792
6426	7888	28	66	44	0	8026
6427	302	29	51	7541	0	7923
6428	157	7134	57	185	0	7533
6429	97	7409	44	108	0	7658
6430	96	226	44	6979	0	7345
6431	7115	70	49	193	0	7427
6432	206	6835	41	79	0	7161
6433	61	6526	33	32	0	6652
6434	6498	144	31	39	0	6712
6435	166	69	23	6437	0	6695
6436	6463	30	24	147	0	6664
6437	162	6443	26	48	0	6679
6438	6467	117	13	45	0	6642
6439	158	42	6489	23	0	6712
6440	7061	33	136	39	0	7269
6441	7298	25	43	51	0	7417
6442	7566	29	28	45	0	7668
6443	240	42	6820	38	0	7140
6444	7258	17	127	53	0	7455
6445	217	7301	43	19	0	7580
6446	78	168	7269	10	0	7525
6447	91	113	165	6782	0	7151
6448	60	36	62	6731	0	6889
6449	41	6731	29	192	0	6993
6450	49	149	21	6853	0	7072
6451	44	41	22	6972	0	7079
6452	43	32	6741	192	0	7008
6453	6420	17	158	91	0	6686
6454	185	12	6837	48	0	7082
6455	89	9	177	6803	0	7078
6456	60	10	6917	169	0	7156
6457	40	15	183	6931	0	7169
6458	6992	9	64	206	0	7271
6459	7236	13	49	71	0	7369
6460	246	11	28	7163	0	7448
6461	91	12	7268	204	0	7575
6462	80	7	177	7288	0	7552
6463	43	18	7169	215	0	7445
6464	6913	17	205	95	0	7230
6465	7190	12	66	71	0	7339
6466	7056	12	53	46	0	7167
6467	7124	17	34	54	0	7229
6468	264	6764	29	34	0	7091
6469	124	175	19	6918	0	7236
6470	6857	65	26	204	0	7152
6471	203	6655	24	93	0	6975
6472	85	6948	24	61	0	7118
6473	85	222	6451	36	0	6794
6474	6449	77	194	39	0	6759
6475	6720	49	70	44	0	6883
6476	277	25	6437	24	0	6763
6477	154	16	202	6393	0	6765
6478	97	14	64	6675	0	6850
6479	76	22	6517	239	0	6854
6480	82	19	208	6471	0	6780
6481	6558	18	82	235	0	6893
6482	233	22	6338	93	0	6686
6483	86	26	6556	69	0	6737
6484	6491	20	241	55	0	6807
6485	236	24	6588	45	0	6893
6486	6523	30	235	47	0	6835
6487	244	6461	89	39	0	6833
6488	6664	187	68	47	0	6966
6489	257	61	43	6597	0	6958
6490	105	48	44	6725	0	6922
6491	6586	37	41	253	0	6917
6492	239	23	32	6613	0	6907
6493	6550	13	37	262	0	6862
6494	241	6469	43	99	0	6852
6495	116	203	31	6240	0	6590
6496	92	63	44	6466	0	6665
6497	6300	39	43	273	0	6655
6498	6395	26	36	113	0	6570
6499	6435	29	25	78	0	6567
6500	304	6010	38	60	0	6412
6501	139	6271	36	51	0	6497
6502	6273	224	24	41	0	6562
6503	246	82	6062	50	0	6440
6504	118	6003	189	57	0	6367
6505	5517	191	161	50	0	5919
6506	5372	50	75	46	0	5543
6507	5337	35	30	39	0	5441
6508	242	37	31	5085	0	5395
6509	5186	18	21	160	0	5385
6510	5156	20	21	67	0	5264
6511	222	20	18	4928	0	5188
6512	4985	20	31	168	0	5204
6513	203	9	4775	67	0	5054
6514	97	24	136	4895	0	5152
6515	77	25	45	4985	0	5132
6516	54	12	44	5080	0	5190
6517	4896	12	22	225	0	5155
6518	5060	11	25	96	0	5192
6519	5090	18	15	81	0	5204
6520	5089	6	19	58	0	5172
6521	4910	15	19	40	0	4984
6522	227	13	23	4672	0	4935
6523	122	7	17	4779	0	4925
6524	4619	14	19	189	0	4841
6525	179	4505	20	90	0	4794
6526	4478	116	21	62	0	4677
6527	175	44	4262	44	0	4525
6528	4481	35	116	30	0	4662
6529	4618	20	41	28	0	4707
6530	202	15	4619	30	0	4866
6531	4700	9	131	32	0	4872
6532	217	11	4722	26	0	4976
6533	105	16	5092	16	0	5229
6534	100	44	207	5200	0	5551
6535	62	18	113	5478	0	5671
6536	55	9	5419	220	0	5703
6537	53	23	5483	114	0	5673
6538	34	5209	221	87	0	5551
6539	39	5315	107	57	0	5518
6540	4508	175	93	40	0	4816
6541	144	4674	28	40	0	4886
6542	4401	156	35	45	0	4637
6543	152	4343	25	26	0	4546
6544	4335	149	27	13	0	4524
6545	161	69	4145	15	0	4390
6546	4205	53	117	21	0	4396
6547	165	42	59	4119	0	4385
6548	90	4188	36	110	0	4424
6549	71	129	26	4280	0	4506
6550	4292	64	17	141	0	4514
6551	4399	50	17	72	0	4538
6552	194	36	18	4268	0	4516
6553	108	21	4231	130	0	4490
6554	78	24	4119	76	0	4297
6555	49	4217	152	56	0	4474
6556	48	148	78	4180	0	4454
6557	42	55	4180	121	0	4398
6558	42	3889	117	70	0	4118
6559	47	106	69	3940	0	4162
6560	26	51	44	4004	0	4125
6561	3706	34	36	142	0	3918
6562	103	24	23	3760	0	3910
6563	61	25	3657	139	0	3882
6564	45	16	102	3714	0	3877
6565	3610	21	60	132	0	3823
6566	101	20	3635	80	0	3836
6567	3675	9	102	64	0	3850
6568	126	3754	56	47	0	3983
6569	3901	88	46	28	0	4063
6570	3918	47	40	31	0	4036
6571	154	33	26	3808	0	4021
6572	103	16	17	3868	0	4004
6573	66	3715	22	142	0	3945
6574	42	93	14	3918	0	4067
6575	3797	53	13	131	0	3994
6576	115	40	3705	69	0	3929
6577	94	17	79	3721	0	3911
6578	59	3692	50	115	0	3916
6579	34	90	39	3824	0	3987
6580	33	60	18	3888	0	3999
6581	3762	47	8	162	0	3979
6582	114	3737	19	100	0	3970
6583	76	90	19	3818	0	4003
6584	3768	61	19	121	0	3969
6585	107	43	15	3803	0	3968
6586	74	34	9	3901	0	4018
6587	3905	15	13	187	0	4120
6588	3889	16	16	110	0	4031
6589	160	20	3811	71	0	4062
6590	3853	18	82	65	0	4018
6591	3972	13	55	52	0	4092
6592	4025	14	36	56	0	4131
6593	169	3694	26	56	0	3945
6594	115	3760	23	35	0	3933
6595	92	120	24	3744	0	3980
6596	3787	68	24	112	0	3991
6597	3863	46	24	67	0	4000
6598	182	29	14	3789	0	4014
6599	108	32	3779	119	0	4038
6600	3873	20	85	76	0	4054
6601	4129	41	48	60	0	4278
6602	165	15	42	4034	0	4256
6603	112	13	31	4102	0	4258
6604	4087	23	13	146	0	4269
6605	131	18	16	4065	0	4230
6606	93	4020	25	126	0	4264
6607	78	88	21	4183	0	4370
6608	4188	59	9	140	0	4396
6609	127	45	4083	85	0	4340
6610	3978	23	83	80	0	4164
6611	136	23	4068	56	0	4283
6612	107	12	112	4114	0	4345
6613	4206	27	61	127	0	4421
6614	121	20	40	4259	0	4440
6615	86	16	31	4337	0	4470
6616	4243	20	24	169	0	4456
6617	132	5	4204	120	0	4461
6618	93	14	4326	78	0	4511
6619	63	15	137	4375	0	4590
6620	47	13	74	4524	0	4658
6621	53	14	46	4549	0	4662
6622	30	10	4388	194	0	4622
6623	4341	11	90	125	0	4567
6624	4614	16	67	72	0	4769
6625	4674	14	53	68	0	4809
6626	4738	11	35	67	0	4851
6627	183	4484	25	55	0	4747
6628	99	4496	21	72	0	4688
6629	61	4589	22	53	0	4725
6630	58	95	18	4097	0	4268
6631	72	54	7	4144	0	4277
6632	39	4	3951	73	0	4067
6633	37	3550	33	34	0	3654
6634	45	26	16	3243	0	3330
6635	3186	11	4	32	0	3233
6636	16	3219	2	17	0	3254
6637	16	7	4	3199	0	3226
6638	10	3242	2	14	0	3268
6639	3308	8	4	10	0	3330
6640	20	10	1	3230	0	3261
6641	15	5	3235	9	0	3264
6642	6	3	3128	10	0	3147
6643	7	12	21	3337	0	3377
6644	11	2	9	3333	0	3355
6645	3	1	2	3463	0	3469
6646	3410	2	3	34	0	3449
6647	19	1	3410	12	0	3442
6648	9	3402	18	9	0	3438
6649	8	16	8	3446	0	3478
6650	3	7	3438	17	0	3465
6651	3	3443	16	10	0	3472
6652	6	24	7	3535	0	3572
6653	5	8	3536	17	0	3566
6654	6	5	19	3476	0	3506
6655	8	1	9	3558	0	3576
6656	3612	1	6	32	0	3651
6657	3627	0	4	20	0	3651
6658	29	1	2	3639	0	3671
6659	3631	0	0	37	0	3668
6660	28	1	3635	13	0	3677
6661	17	1	24	3685	0	3727
6662	5	8	3768	20	0	3801
6663	7	3	21	3781	0	3812
6664	3	3710	18	29	0	3760
6665	1	3781	6	13	0	3801
6666	1	3779	2	16	0	3798
6667	9	33	8	3696	0	3746
6668	7	7	2	3943	0	3959
6669	6	1	3879	42	0	3928
6670	14	5	3789	17	0	3825
6671	10	6	4000	6	0	4022
6672	4380	2	55	16	0	4453
6673	75	4	11	4687	0	4777
6674	4921	1	8	86	0	5016
6675	87	5198	10	27	0	5322
6676	30	98	8	5377	0	5513
6677	5602	40	7	123	0	5772
6678	120	27	4	5628	0	5779
6679	5683	14	1	160	0	5858
6680	152	12	5724	52	0	5940
6681	55	5803	108	37	0	6003
6682	39	121	40	5909	0	6109
6683	5872	36	32	134	0	6074
6684	6009	25	20	60	0	6114
6685	171	9	14	5953	0	6147
6686	89	4	7	6028	0	6128
6687	5843	6	10	178	0	6037
6688	149	10	5	5814	0	5978
6689	56	10	5726	161	0	5953
6690	45	5664	118	66	0	5893
6691	42	112	46	5828	0	6028
6692	5811	41	32	158	0	6042
6693	5836	22	16	79	0	5953
6694	186	16	5878	38	0	6118
6695	79	5724	131	34	0	5968
6696	50	6059	58	25	0	6192
6697	39	175	27	6038	0	6279
6698	40	70	18	6232	0	6360
6699	36	39	6	6235	0	6316
6700	32	22	11	6267	0	6332
6701	21	5943	17	215	0	6196
6702	29	139	9	6112	0	6289
6703	26	61	18	6249	0	6354
6704	6053	38	13	231	0	6335
6705	6070	22	9	132	0	6233
6706	195	6091	9	81	0	6376
6707	6224	137	7	67	0	6435
6708	6270	68	13	52	0	6403
6709	6285	42	11	53	0	6391
6710	243	35	5993	49	0	6320
6711	137	23	138	6036	0	6334
6712	96	14	59	6248	0	6417
6713	47	30	6007	213	0	6297
6714	50	17	148	5989	0	6204
6715	68	24	60	5657	0	5809
6716	5936	20	39	244	0	6239
6717	156	20	5870	132	0	6178
6718	86	21	144	5812	0	6063
6719	5783	24	67	203	0	6077
6720	161	5738	46	102	0	6047
6721	5792	147	29	98	0	6066
6722	5794	67	18	70	0	5949
6723	217	5603	14	59	0	5893
6724	107	150	23	5668	0	5948
6725	5646	73	11	193	0	5923
6726	185	5531	16	109	0	5841
6727	99	165	21	5600	0	5885
6728	5533	77	16	195	0	5821
6729	5545	46	12	116	0	5719
6730	222	5412	21	85	0	5740
6731	5544	151	18	74	0	5787
6732	213	69	18	5488	0	5788
6733	5542	56	9	190	0	5797
6734	216	38	5360	101	0	5715
6735	127	17	141	5461	0	5746
6736	99	13	66	5479	0	5657
6737	5308	30	51	241	0	5630
6738	175	5187	39	127	0	5528
6739	5149	148	26	107	0	5430
6740	216	5090	18	69	0	5393
6741	110	157	4938	67	0	5272
6742	95	73	4970	58	0	5196
6743	67	114	179	4793	0	5153
6744	51	37	4854	171	0	5113
6745	55	41	160	4844	0	5100
6746	52	24	82	4829	0	4987
6747	60	29	39	4960	0	5088
6748	4827	25	33	237	0	5122
6749	4840	30	27	135	0	5032
6750	4961	31	13	114	0	5119
6751	251	4858	20	63	0	5192
6752	139	5289	12	57	0	5497
6753	100	205	5684	55	0	6044
6754	83	95	178	5851	0	6207
6755	62	71	5853	222	0	6208
6756	63	45	222	5861	0	6191
6757	73	32	108	5987	0	6200
6758	49	42	74	6056	0	6221
6759	43	36	5736	358	0	6173
6760	50	15	218	5853	0	6136
6761	5706	24	107	320	0	6157
6762	208	5583	79	188	0	6058
6763	132	184	45	5753	0	6114
6764	5686	101	38	281	0	6106
6765	5776	61	32	174	0	6043
6766	309	47	49	5598	0	6003
6767	175	33	42	5678	0	5928
6768	5432	25	28	326	0	5811
6769	266	32	31	5454	0	5783
6770	5181	31	29	309	0	5550
6771	275	26	25	5067	0	5393
6772	156	17	4571	259	0	5003
6773	101	4206	134	167	0	4608
6774	66	4227	69	128	0	4490
6775	88	162	59	3807	0	4116
6776	113	61	40	3819	0	4033
6777	3569	35	25	160	0	3789
6778	116	31	20	3615	0	3782
6779	74	26	15	3583	0	3698
6780	42	22	15	3345	0	3424
6781	37	3172	12	184	0	3405
6782	42	88	7	3343	0	3480
6783	41	41	10	3374	0	3466
6784	37	31	4	3386	0	3458
6785	3125	23	26	206	0	3380
6786	95	3147	23	120	0	3385
6787	55	96	10	3266	0	3427
6788	43	60	17	3311	0	3431
6789	28	35	8	3348	0	3419
6790	3183	23	5	206	0	3417
6791	115	19	9	3223	0	3366
6792	80	14	8	3232	0	3334
6793	44	20	2944	185	0	3193
6794	26	2841	71	132	0	3070
6795	33	89	33	2950	0	3105
6796	2789	43	21	159	0	3012
6797	92	2784	15	102	0	2993
6798	2674	70	13	80	0	2837
6799	2723	41	13	61	0	2838
6800	116	29	12	2696	0	2853
6801	76	25	7	2740	0	2848
6802	47	23	2684	141	0	2895
6803	54	17	67	2780	0	2918
6804	49	16	2737	126	0	2928
6805	40	14	79	2815	0	2948
6806	2607	7	46	149	0	2809
6807	79	2633	35	88	0	2835
6808	41	74	30	2830	0	2975
6809	28	35	31	2865	0	2959
6810	27	29	23	2864	0	2943
6811	28	14	18	2887	0	2947
6812	2737	21	15	169	0	2942
6813	93	2708	13	109	0	2923
6814	53	78	12	2861	0	3004
6815	2798	35	15	157	0	3005
6816	89	23	2753	119	0	2984
6817	2772	17	75	92	0	2956
6818	2853	17	41	74	0	2985
6819	133	20	2745	66	0	2964
6820	93	16	86	2806	0	3001
6821	2849	20	46	127	0	3042
6822	108	2909	31	85	0	3133
6823	3021	74	22	74	0	3191
6824	3055	44	21	70	0	3190
6825	3066	25	14	72	0	3177
6826	165	18	16	2997	0	3196
6827	94	29	12	3150	0	3285
6828	77	3371	8	152	0	3608
6829	72	100	13	3502	0	3687
6830	3515	49	11	151	0	3726
6831	147	29	3432	84	0	3692
6832	3431	24	97	80	0	3632
6833	3629	25	43	77	0	3774
6834	159	25	34	3553	0	3771
6835	99	23	22	3650	0	3794
6836	3559	19	20	182	0	3780
6837	3586	11	21	105	0	3723
6838	3361	14	17	97	0	3489
6839	176	9	3483	72	0	3740
6840	103	3486	93	69	0	3751
6841	3573	94	33	75	0	3775
6842	151	45	30	3531	0	3757
6843	83	3502	20	139	0	3744
6844	76	112	24	3558	0	3770
6845	3570	43	24	144	0	3781
6846	133	53	19	3632	0	3837
6847	91	28	3577	163	0	3859
6848	66	3531	79	97	0	3773
6849	36	3722	35	97	0	3890
6850	59	110	3498	68	0	3735
6851	3052	96	95	108	0	3351
6852	97	3059	38	41	0	3235
6853	45	50	28	2450	0	2573
6854	2425	13	14	43	0	2495
6855	32	2428	6	6	0	2472
6856	19	34	5	2492	0	2550
6857	2513	10	3	40	0	2566
6858	38	9	2	2517	0	2566
6859	2534	6	4	48	0	2592
6860	42	8	2533	15	0	2598
6861	12	2553	27	15	0	2607
6862	2663	31	6	23	0	2723
6863	2673	3	6	16	0	2698
6864	2654	4	4	13	0	2675
6865	43	5	2556	7	0	2611
6866	2563	6	22	10	0	2601
6867	2679	4	8	5	0	2696
6868	47	4	6	2662	0	2719
6869	2674	0	5	39	0	2718
6870	43	2627	11	6	0	2687
6871	19	28	6	2675	0	2728
6872	21	6	2712	35	0	2774
6873	12	15	27	2663	0	2717
6874	13	5	6	2791	0	2815
6875	2776	8	8	39	0	2831
6876	2762	7	5	24	0	2798
6877	37	4	2738	16	0	2795
6878	2692	2	32	20	0	2746
6879	43	6	2733	13	0	2795
6880	24	3	34	2759	0	2820
6881	24	1	2792	34	0	2851
6882	10	6	42	2775	0	2833
6883	12	2762	10	42	0	2826
6884	11	27	2825	9	0	2872
6885	9	10	2873	16	0	2908
6886	27	14	46	2433	0	2520
6887	2950	7	13	43	0	3013
6888	2953	10	14	17	0	2994
6889	2960	3	13	19	0	2995
6890	49	4	9	2929	0	2991
6891	21	9	7	2958	0	2995
6892	29	4	4	2968	0	3005
6893	27	3	0	2952	0	2982
6894	17	8	2882	45	0	2952
6895	13	3	30	2866	0	2912
6896	12	2813	9	49	0	2883
6897	6	31	6	2886	0	2929
6898	2869	4	6	59	0	2938
6899	39	11	2798	18	0	2866
6900	2655	9	32	29	0	2725
6901	50	12	2858	12	0	2932
6902	21	4	2815	14	0	2854
6903	21	2786	53	7	0	2867
6904	34	44	20	2514	0	2612
6905	21	7	17	2805	0	2850
6906	24	2383	39	44	0	2490
6907	2989	48	18	19	0	3074
6908	60	22	9	3180	0	3271
6909	23	12	6	3486	0	3527
6910	24	7	3	3667	0	3701
6911	4004	12	7	129	0	4152
6912	4359	6	5	63	0	4433
6913	147	5	3	4298	0	4453
6914	64	3	4	4385	0	4456
6915	4262	2	3	172	0	4439
6916	142	2	5	4268	0	4417
6917	66	6	2	4344	0	4418
6918	44	2	7	4407	0	4460
6919	40	3	4158	181	0	4382
6920	4051	2	102	92	0	4247
6921	4176	5	28	87	0	4296
6922	159	5	3954	58	0	4176
6923	72	7	107	3806	0	3992
6924	49	3908	48	131	0	4136
6925	3895	102	27	74	0	4098
6926	141	3870	34	49	0	4094
6927	62	3791	26	50	0	3929
6928	60	128	17	3529	0	3734
6929	3505	51	18	125	0	3699
6930	3621	23	9	65	0	3718
6931	139	40	7	3531	0	3717
6932	74	23	13	3581	0	3691
6933	49	19	13	3578	0	3659
6934	56	21	7	3562	0	3646
6935	50	16	9	3513	0	3588
6936	35	3381	7	171	0	3594
6937	37	92	7	3503	0	3639
6938	3415	40	4	171	0	3630
6939	3494	25	4	107	0	3630
6940	3493	20	7	77	0	3597
6941	151	3370	6	70	0	3597
6942	82	94	8	3443	0	3627
6943	69	47	3387	135	0	3638
6944	3364	22	85	101	0	3572
6945	134	28	34	3400	0	3596
6946	3329	25	23	151	0	3528
6947	3268	12	16	92	0	3388
6948	3289	22	16	57	0	3384
6949	173	17	9	3144	0	3343
6950	3162	11	23	133	0	3329
6951	163	14	13	3161	0	3351
6952	96	17	10	3245	0	3368
6953	3192	12	11	153	0	3368
6954	139	22	10	3190	0	3361
6955	3133	18	4	146	0	3301
6956	3168	17	9	99	0	3293
6957	178	12	6	3096	0	3292
6958	106	12	5	3181	0	3304
6959	69	9	7	3206	0	3291
6960	84	5	2913	180	0	3182
6961	66	8	2956	114	0	3144
6962	62	3	102	2942	0	3109
6963	54	10	40	2995	0	3099
6964	41	13	19	3035	0	3108
6965	37	5	22	3027	0	3091
6966	49	8	17	3050	0	3124
6967	2857	9	19	195	0	3080
6968	124	2804	19	109	0	3056
6969	76	85	17	2919	0	3097
6970	2876	31	19	168	0	3094
6971	129	23	19	2927	0	3098
6972	79	19	14	2904	0	3016
6973	2771	21	13	194	0	2999
6974	2813	13	15	116	0	2957
6975	155	20	2691	83	0	2949
6976	89	9	85	2773	0	2956
6977	79	8	2706	157	0	2950
6978	70	11	94	2794	0	2969
6979	52	7	41	2821	0	2921
6980	59	4	30	2853	0	2946
6981	59	9	2646	192	0	2906
6982	38	2556	113	120	0	2827
6983	44	2718	42	109	0	2913
6984	45	103	35	2703	0	2886
6985	2619	35	30	171	0	2855
6986	119	23	2587	102	0	2831
6987	68	21	2681	89	0	2859
6988	48	21	140	2669	0	2878
6989	35	18	64	2708	0	2825
6990	35	2630	51	155	0	2871
6991	22	85	41	2699	0	2847
6992	38	45	25	2842	0	2950
6993	20	37	27	2885	0	2969
6994	2732	18	24	206	0	2980
6995	2802	25	21	112	0	2960
6996	150	20	18	2830	0	3018
6997	65	2787	26	158	0	3036
6998	56	85	14	2878	0	3033
6999	2760	41	18	173	0	2992
7000	117	2787	19	114	0	3037
7001	64	98	15	2699	0	2876
7002	50	2661	13	137	0	2861
7003	2648	92	11	101	0	2852
7004	2585	53	18	76	0	2732
7005	121	2589	16	68	0	2794
7006	74	2588	9	66	0	2737
7007	49	103	2333	55	0	2540
7008	26	2118	64	48	0	2256
7009	40	124	26	1765	0	1955
7010	30	27	1708	74	0	1839
7011	6	1252	29	24	0	1311
7012	8	22	5	984	0	1019
7013	6	6	7	996	0	1015
7014	5	5	1	990	0	1001
7015	970	2	2	25	0	999
7016	14	3	942	11	0	970
7017	4	2	960	6	0	972
7018	3	3	18	970	0	994
7019	3	7	1016	17	0	1043
7020	3	2	17	1034	0	1056
7021	11	0	7	994	0	1012
7022	5	5	4	1060	0	1074
7023	4	3	5	1065	0	1077
7024	1046	3	4	24	0	1077
7025	1045	2	1	15	0	1063
7026	20	3	2	1056	0	1081
7027	6	5	1091	18	0	1120
7028	4	2	15	1111	0	1132
7029	2	1045	5	24	0	1076
7030	3	14	3	1051	0	1071
7031	1046	5	0	21	0	1072
7032	1067	3	3	12	0	1085
7033	19	6	5	1076	0	1106
7034	7	6	3	1086	0	1102
7035	10	1	3	1092	0	1106
7036	1065	7	2	25	0	1099
7037	13	6	1056	15	0	1090
7038	6	4	1034	14	0	1058
7039	8	1037	15	10	0	1070
7040	1056	14	6	7	0	1083
7041	19	4	5	1057	0	1085
7042	7	4	1056	14	0	1081
7043	5	1002	14	7	0	1028
7044	3	1063	9	9	0	1084
7045	3	15	5	1069	0	1092
7046	2	8	3	1100	0	1113
7047	3	1084	3	20	0	1110
7048	4	16	2	1121	0	1143
7049	5	3	2	1125	0	1135
7050	1107	3	0	24	0	1134
7051	15	1093	2	10	0	1120
7052	8	13	2	1084	0	1107
7053	5	5	1086	17	0	1113
7054	3	6	18	1079	0	1106
7055	1088	6	4	26	0	1124
7056	14	1106	6	12	0	1138
7057	6	14	4	1123	0	1147
7058	6	5	1112	20	0	1143
7059	6	5	1159	11	0	1181
7060	2	5	15	1194	0	1216
7061	5	4	4	1231	0	1244
7062	1220	1	6	22	0	1249
7063	18	1284	7	10	0	1319
7064	1310	16	7	8	0	1341
7065	17	10	1375	12	0	1414
7066	1399	6	18	12	0	1435
7067	19	7	1497	7	0	1530
7068	1524	6	18	11	0	1559
7069	1561	3	11	8	0	1583
7070	30	7	1635	9	0	1681
7071	17	9	1640	9	0	1675
7072	10	1636	31	8	0	1685
7073	8	21	11	1716	0	1756
7074	1760	13	10	29	0	1812
7075	24	6	9	1811	0	1850
7076	10	8	6	1837	0	1861
7077	12	3	2	1842	0	1859
7078	10	2	1816	39	0	1867
7079	1715	7	24	24	0	1770
7080	1833	4	9	20	0	1866
7081	33	1851	12	12	0	1908
7082	19	21	4	1833	0	1877
7083	9	1860	3	25	0	1897
7084	7	25	9	1903	0	1944
7085	1888	11	8	35	0	1942
7086	28	1904	7	21	0	1960
7087	17	29	5	1869	0	1920
7088	1855	14	3	43	0	1915
7089	1854	6	4	17	0	1881
7090	48	7	2	1833	0	1890
7091	19	4	1830	37	0	1890
7092	11	12	28	1768	0	1819
7093	10	1801	9	32	0	1852
7094	1793	25	5	18	0	1841
7095	25	1807	7	13	0	1852
7096	24	23	5	1749	0	1801
7097	1762	14	2	30	0	1808
7098	30	5	2	1804	0	1841
7099	17	5	5	1813	0	1840
7100	7	4	1753	38	0	1802
7101	9	1757	21	18	0	1805
7102	1765	24	10	9	0	1808
7103	1604	16	7	19	0	1646
7104	30	1753	5	6	0	1794
7105	11	1784	3	3	0	1801
7106	7	25	2	1753	0	1787
7107	1733	12	2	22	0	1769
7108	22	1746	0	9	0	1777
7109	13	22	0	1756	0	1791
7110	4	8	1747	24	0	1783
7111	5	6	19	1778	0	1808
7112	1779	4	8	25	0	1816
7113	18	1798	1	14	0	1831
7114	14	19	3	1831	0	1867
7115	4	13	1825	24	0	1866
7116	4	4	1813	12	0	1833
7117	5	3	28	1860	0	1896
7118	5	3	10	1891	0	1909
7119	3	1849	3	31	0	1886
7120	4	22	4	1863	0	1893
7121	1882	13	3	34	0	1932
7122	25	4	2	1913	0	1944
7123	1934	3	4	33	0	1974
7124	25	1934	5	13	0	1977
7125	11	2013	4	12	0	2040
7126	11	28	6	2059	0	2104
7127	9	7	2	2046	0	2064
7128	5	4	2003	38	0	2050
7129	6	5	23	1990	0	2024
7130	1999	4	11	34	0	2048
7131	27	1	1974	14	0	2016
7132	19	3	25	2041	0	2088
7133	4	5	2106	38	0	2153
7134	11	1	29	2126	0	2167
7135	11	5	15	2129	0	2160
7136	6	2	9	2175	0	2192
7137	8	1	2143	44	0	2196
7138	8	4	31	2127	0	2170
7139	5	2136	12	36	0	2189
7140	7	26	8	2188	0	2229
7141	8	14	5	2185	0	2212
7142	2160	6	1	57	0	2224
7143	33	6	2135	27	0	2201
7144	17	5	32	2157	0	2211
7145	10	6	2156	38	0	2210
7146	13	6	2102	17	0	2138
7147	6	3	42	2205	0	2256
7148	7	3	20	2173	0	2203
7149	7	4	9	2287	0	2307
7150	2248	7	3	55	0	2313
7151	36	7	2254	27	0	2324
7152	2402	2	32	20	0	2456
7153	39	10	13	2499	0	2561
7154	19	3	7	2608	0	2637
7155	16	2627	5	44	0	2692
7156	14	31	2	2691	0	2738
7157	10	12	17	2698	0	2737
7158	11	6	10	2712	0	2739
7159	2580	7	11	56	0	2654
7160	31	5	2499	27	0	2562
7161	2374	3	26	27	0	2430
7162	33	2556	19	17	0	2625
7163	2497	27	10	20	0	2554
7164	41	2467	3	16	0	2527
7165	11	2478	10	15	0	2514
7166	30	35	16	2406	0	2487
7167	2439	7	22	41	0	2509
7168	28	9	3	2488	0	2528
7169	5	2400	2	39	0	2446
7170	8	2573	1	21	0	2603
7171	8	29	2	2649	0	2688
7172	4	7	3	2626	0	2640
7173	15	2626	3	36	0	2680
7174	5	30	13	2717	0	2765
7175	15	6	3	2775	0	2799
7176	5	15	3	2869	0	2892
7177	2923	7	2	46	0	2978
7178	31	11	2870	19	0	2931
7179	2936	13	28	23	0	3000
7180	3156	4	6	23	0	3189
7181	3145	5	3	6	0	3159
7182	35	3069	5	17	0	3126
7183	15	36	1	3102	0	3154
7184	3189	13	0	41	0	3243
7185	27	8	1	3309	0	3345
7186	3290	3	2	45	0	3340
7187	23	3541	3	10	0	3577
7188	3728	20	3	36	0	3787
7189	3815	4	1	24	0	3844
7190	3877	5	3	17	0	3902
7191	40	5	3	3899	0	3947
7192	16	1	11	3979	0	4007
7193	4046	1	6	34	0	4087
7194	33	3931	2	14	0	3980
7195	18	3959	3	13	0	3993
7196	4105	33	1	18	0	4157
7197	26	8	2	4185	0	4221
7198	21	4	0	4180	0	4205
7199	12	7	1	4278	0	4298
7200	15	4216	4	36	0	4271
7201	4282	27	1	30	0	4340
7202	36	8	1	4317	0	4362
7203	19	4407	5	26	0	4457
7204	22	21	1	4668	0	4712
7205	12	10	2	4739	0	4763
7206	12	8	2	4743	0	4765
7207	22	4	1	4765	0	4792
7208	4767	10	2	42	0	4821
7209	4719	15	3	22	0	4759
7210	4804	2	1	29	0	4836
7211	31	1	2	4887	0	4921
7212	15	8	4793	33	0	4849
7213	16	14	4443	28	0	4501
7214	6	17	4729	21	0	4773
7215	5012	5	31	26	0	5074
7216	24	1	11	5159	0	5195
7217	13	11	9	5124	0	5157
7218	14	3	3	5219	0	5239
7219	5213	3	0	60	0	5276
7220	5216	1	1	42	0	5260
7221	27	5585	8	22	0	5642
7222	34	19	4	5713	0	5770
7223	20	9	5589	24	0	5642
7224	22	5614	19	12	0	5667
7225	6	18	10	5735	0	5769
7226	5	7	23	5732	0	5767
7227	13	9	13	5656	0	5691
7228	12	4	12	5538	0	5566
7229	19	2	5625	33	0	5679
7230	13	9	5310	26	0	5358
7231	2	5673	24	25	0	5724
7232	4	14	10	5802	0	5830
7233	17	4	7	5741	0	5769
7234	5691	8	4	28	0	5731
7235	16	14	5838	17	0	5885
7236	11	4	11	5853	0	5879
7237	14	2	13	6096	0	6125
7238	8	13	6266	21	0	6308
7239	2	6246	23	27	0	6298
7240	6296	18	7	30	0	6351
7241	21	16	6164	19	0	6220
7242	6078	6	13	21	0	6118
7243	22	9	6592	7	0	6630
7244	17	3	16	6654	0	6690
7245	13	1	6795	19	0	6828
7246	14	10	6716	12	0	6752
7247	7	1	24	7006	0	7038
7248	82	23	30	5779	0	5914
7249	9	3	9	7254	0	7275
7250	17	4	7	7046	0	7074
7251	24	1	0	6969	0	6994
7252	7	5	7111	24	0	7147
7253	12	14	6636	23	0	6685
7254	2	7115	22	10	0	7149
7255	7270	13	12	15	0	7310
7256	24	15	7	7394	0	7440
7257	7442	7	4	39	0	7492
7258	32	2	0	7455	0	7489
7259	7737	0	2	67	0	7806
7260	32	2	1	7837	0	7872
7261	13	1	5	7919	0	7938
7262	8	7951	9	38	0	8006
7263	7	23	4	8213	0	8247
7264	11	7	2	8141	0	8161
7265	10	9	1	8089	0	8109
7266	10	3	2	8093	0	8108
7267	2	7912	7	50	0	7971
7268	7961	19	2	39	0	8021
7269	22	7877	1	16	0	7916
7270	12	23	2	7872	0	7909
7271	7726	10	4	43	0	7783
7272	20	12	7569	12	0	7613
7273	16	17	7455	12	0	7500
7274	16	25	29	7481	0	7551
7275	13	8	17	7760	0	7798
7276	11	0	9	7761	0	7781
7277	21	1	7	7180	0	7209
7278	7	1	2	7537	0	7547
7279	2	7446	8	30	0	7486
7280	3	17	2	7592	0	7614
7281	7543	8	4	50	0	7605
7282	23	5	3	7595	0	7626
7283	11	10	7614	30	0	7665
7284	14	4	19	7476	0	7513
7285	7460	0	11	52	0	7523
7286	19	7681	11	23	0	7734
7287	17	23	5	7745	0	7790
7288	14	11	2	7828	0	7855
7289	10	10	7713	57	0	7790
7290	12	11	9045	22	0	9090
7291	11854	4	133	41	0	12032
7292	294	4	47	12356	0	12701
7293	132	3	56	12850	0	13041
7294	119	10	13520	400	0	14049
7295	80	10	13736	233	0	14059
7296	33	13820	422	205	0	14480
7297	73	321	239	13835	0	14468
7298	12	125	14002	390	0	14529
7299	4	13886	436	167	0	14493
7300	13952	409	208	151	0	14720
7301	14364	158	196	112	0	14830
7302	488	165	113	13957	0	14723
7303	255	14088	65	402	0	14810
7304	14188	406	75	180	0	14849
7305	530	174	53	13631	0	14388
7306	232	175	13892	410	0	14709
7307	217	14082	372	191	0	14862
7308	14048	400	165	227	0	14840
7309	14429	190	151	142	0	14912
7310	544	173	106	14126	0	14949
7311	330	108	71	14447	0	14956
7312	236	83	13962	532	0	14813
7313	199	84	396	14121	0	14800
7314	221	62	146	13551	0	13980
7315	148	35	130	14361	0	14674
7316	116	37	100	14448	0	14701
7317	84	46	65	14095	0	14290
7318	64	13720	76	768	0	14628
7319	13712	356	59	481	0	14608
7320	407	162	13577	379	0	14525
7321	180	13311	382	267	0	14140
7322	232	432	160	13649	0	14473
7323	13573	171	151	555	0	14450
7324	467	176	119	13684	0	14446
7325	240	122	94	13914	0	14370
7326	229	82	93	14034	0	14438
7327	157	70	67	14139	0	14433
7328	96	57	13299	853	0	14305
7329	110	13343	376	520	0	14349
7330	13397	388	149	477	0	14411
7331	438	175	13401	311	0	14325
7332	190	168	457	13545	0	14360
7333	13489	132	227	571	0	14419
7334	486	13400	216	266	0	14368
7335	13478	455	147	313	0	14393
7336	666	211	117	12705	0	13699
7337	311	194	94	13707	0	14306
7338	282	132	67	13655	0	14136
7339	232	87	48	13769	0	14136
7340	13054	92	45	891	0	14082
7341	494	82	60	13463	0	14099
7342	246	62	64	13793	0	14165
7343	12659	53	54	834	0	13600
7344	528	62	12355	516	0	13461
7345	272	57	398	12736	0	13463
7346	12289	48	151	694	0	13182
7347	12497	55	158	376	0	13086
7348	654	61	106	12174	0	12995
7349	405	46	84	12308	0	12843
7350	330	11211	113	685	0	12339
7351	223	393	62	11803	0	12481
7352	176	138	40	11950	0	12304
7353	176	148	10938	786	0	12048
7354	118	111	10896	556	0	11681
7355	85	10775	500	497	0	11857
7356	101	425	254	10897	0	11677
7357	105	167	247	11332	0	11851
7358	10811	164	173	707	0	11855
7359	447	146	135	10823	0	11551
7360	243	93	10437	716	0	11489
7361	255	88	432	10732	0	11507
7362	169	88	10189	766	0	11212
7363	134	72	10491	459	0	11156
7364	140	77	596	10307	0	11120
7365	132	83	306	10747	0	11268
7366	10262	66	302	711	0	11341
7367	10590	63	217	469	0	11339
7368	572	64	159	10582	0	11377
7369	10607	60	146	671	0	11484
7370	10989	43	89	413	0	11534
7371	700	42	63	10754	0	11559
7372	432	48	87	10885	0	11452
7373	10585	53	75	711	0	11424
7374	10348	46	77	501	0	10972
7375	645	35	78	10234	0	10992
7376	419	9747	85	666	0	10917
7377	359	361	57	10241	0	11018
7378	247	137	59	10605	0	11048
7379	203	144	9739	795	0	10881
7380	183	112	379	10345	0	11019
7381	9610	65	161	820	0	10656
7382	456	9790	183	464	0	10893
7383	9896	392	118	431	0	10837
7384	10120	152	80	343	0	10695
7385	10275	170	69	275	0	10789
7386	760	187	56	9591	0	10594
7387	570	74	8957	563	0	10164
7388	477	98	8945	302	0	9822
7389	279	8837	477	329	0	9922
7390	170	7190	219	234	0	7813
7391	87	4325	86	74	0	4572
7392	68	3950	112	77	0	4207
7393	164	128	3490	93	0	3875
7394	2440	136	189	70	0	2835
7395	58	20	14	2365	0	2457
7396	28	7	11	2339	0	2385
7397	27	5	5	2315	0	2352
7398	19	2285	3	52	0	2359
7399	2297	34	10	33	0	2374
7400	43	12	2307	23	0	2385
7401	14	2157	30	11	0	2212
7402	9	36	10	2174	0	2229
7403	2166	9	8	32	0	2215
7404	30	4	10	2164	0	2208
7405	11	2	2112	35	0	2160
7406	8	9	2069	16	0	2102
7407	11	4	30	2133	0	2178
7408	7	3	16	2151	0	2177
7409	2128	2	7	40	0	2177
7410	34	6	2113	14	0	2167
7411	2082	1	30	15	0	2128
7412	2125	3	10	12	0	2150
7413	32	1	7	2146	0	2186
7414	13	5	2156	29	0	2203
7415	18	1	23	2157	0	2199
7416	2168	2	9	40	0	2219
7417	25	2149	10	13	0	2197
7418	2196	25	4	15	0	2240
7419	29	9	3	2231	0	2272
7420	15	2228	5	37	0	2285
7421	13	32	6	2274	0	2325
7422	7	8	9	2323	0	2347
7423	9	2283	3	42	0	2337
7424	12	28	3	2329	0	2372
7425	10	6	2	2338	0	2356
7426	15	5	5	2415	0	2440
7427	8	4	2501	44	0	2557
7428	6	2487	39	14	0	2546
7429	2562	36	10	11	0	2619
7430	45	8	5	2593	0	2651
7431	17	2784	4	41	0	2846
7432	2931	43	4	17	0	2995
7433	51	15	3	2954	0	3023
7434	20	4	1	2971	0	2996
7435	13	5	2	2892	0	2912
7436	11	2	2	2855	0	2870
7437	2805	3	5	67	0	2880
7438	55	3	5	2872	0	2935
7439	26	6	2	2910	0	2944
7440	2897	6	1	80	0	2984
7441	66	7	1	2908	0	2982
7442	19	6	2864	67	0	2956
7443	15	4	51	2894	0	2964
7444	2817	3	16	70	0	2906
7445	57	3	7	2845	0	2912
7446	16	6	2829	70	0	2921
7447	11	8	2760	32	0	2811
7448	2848	4	61	20	0	2933
7449	2944	8	18	25	0	2995
7450	2971	6	15	15	0	3007
7451	2961	4	7	22	0	2994
7452	75	10	2897	14	0	2996
7453	35	2	52	2920	0	3009
7454	22	3	15	3016	0	3056
7455	2953	1	11	88	0	3053
7456	65	3	9	2986	0	3063
7457	25	1	2929	77	0	3032
7458	22	10	53	2941	0	3026
7459	17	5	2942	62	0	3026
7460	10	2889	58	34	0	2991
7461	2955	57	26	27	0	3065
7462	77	16	6	2924	0	3023
7463	23	7	2892	71	0	2993
7464	17	5	61	2925	0	3008
7465	20	3	24	3050	0	3097
7466	11	1	2992	98	0	3102
7467	15	4	66	3033	0	3118
7468	3018	4	24	84	0	3130
7469	77	8	2744	38	0	2867
7470	2754	6	58	37	0	2855
7471	73	2751	23	27	0	2874
7472	34	54	2770	18	0	2876
7473	18	18	2788	26	0	2850
7474	27	45	81	2380	0	2533
7475	9	7	22	2567	0	2605
7476	17	6	2530	73	0	2626
7477	10	2	60	2549	0	2621
7478	2564	3	22	75	0	2664
7479	2601	9	15	36	0	2661
7480	74	3	18	2559	0	2654
7481	39	5	9	2575	0	2628
7482	24	2555	12	79	0	2670
7483	2580	48	11	51	0	2690
7484	60	15	19	2592	0	2686
7485	26	2596	13	81	0	2716
7486	2619	54	10	39	0	2722
7487	2633	17	11	31	0	2692
7488	71	2660	16	38	0	2785
7489	41	59	12	2650	0	2762
7490	33	24	5	2701	0	2763
7491	30	7	2577	90	0	2704
7492	15	11	65	2556	0	2647
7493	2531	13	24	89	0	2657
7494	77	6	11	2571	0	2665
7495	43	8	2527	81	0	2659
7496	2504	12	52	59	0	2627
7497	84	3	23	2547	0	2657
7498	40	10	2508	85	0	2643
7499	35	6	68	2528	0	2637
7500	30	4	2507	93	0	2634
7501	20	11	65	2530	0	2626
7502	29	1	29	2571	0	2630
7503	2483	5	26	107	0	2621
7504	66	2478	33	52	0	2629
7505	2493	49	27	54	0	2623
7506	2483	19	25	31	0	2558
7507	2514	10	19	35	0	2578
7508	93	2467	25	25	0	2610
7509	54	56	2458	26	0	2594
7510	36	18	72	2460	0	2586
7511	2492	14	31	79	0	2616
7512	2527	17	23	44	0	2611
7513	95	3	19	2476	0	2593
7514	2457	9	19	87	0	2572
7515	82	11	2431	52	0	2576
7516	2456	9	68	46	0	2579
7517	77	11	2466	35	0	2589
7518	50	2428	67	34	0	2579
7519	2440	47	31	28	0	2546
7520	2383	19	24	31	0	2457
7521	66	2358	30	38	0	2492
7522	2351	51	28	33	0	2463
7523	2337	23	18	31	0	2409
7524	82	9	2256	34	0	2381
7525	2245	11	61	30	0	2347
7526	70	11	2219	24	0	2324
7527	46	21	46	1989	0	2102
7528	28	2028	26	48	0	2130
7529	27	40	1967	27	0	2061
7530	1757	63	62	69	0	1951
7531	1652	13	24	26	0	1715
7532	50	5	16	1544	0	1615
7533	34	5	1534	32	0	1605
7534	18	8	35	1532	0	1593
7535	1534	8	16	42	0	1600
7536	42	1572	12	19	0	1645
7537	1572	22	15	19	0	1628
7538	1590	12	8	16	0	1626
7539	43	1559	6	17	0	1625
7540	24	20	10	1570	0	1624
7541	1609	13	13	29	0	1664
7542	36	1	5	1631	0	1673
7543	27	6	6	1679	0	1718
7544	14	14	1665	30	0	1723
7545	21	5	23	1673	0	1722
7546	25	5	13	1699	0	1742
7547	1696	14	5	45	0	1760
7548	1708	9	3	20	0	1740
7549	54	4	9	1681	0	1748
7550	23	3	1664	41	0	1731
7551	23	5	1622	21	0	1671
7552	20	9	47	1639	0	1715
7553	9	8	1697	46	0	1760
7554	17	7	39	1667	0	1730
7555	22	5	15	1648	0	1690
7556	1682	3	11	41	0	1737
7557	43	2	1648	26	0	1719
7558	1641	6	32	14	0	1693
7559	1656	3	19	16	0	1694
7560	44	1	1636	16	0	1697
7561	18	7	1609	9	0	1643
7562	11	63	25	1537	0	1636
7563	10	1481	12	26	0	1529
7564	16	1514	8	8	0	1546
7565	24	23	1	1435	0	1483
7566	8	13	4	1378	0	1403
7567	13	2	3	1425	0	1443
7568	12	2	5	1438	0	1457
7569	1408	3	6	35	0	1452
7570	24	2	7	1420	0	1453
7571	11	2	1409	27	0	1449
7572	9	1	18	1402	0	1430
7573	11	1367	8	22	0	1408
7574	10	18	9	1400	0	1437
7575	1393	3	3	30	0	1429
7576	26	0	9	1415	0	1450
7577	9	1	1423	21	0	1454
7578	9	1383	22	10	0	1424
7579	4	16	15	1412	0	1447
7580	1393	6	7	24	0	1430
7581	1399	5	3	10	0	1417
7582	31	1	2	1413	0	1447
7583	11	4	1359	20	0	1394
7584	9	3	1305	6	0	1323
7585	1306	0	24	12	0	1342
7586	26	3	1355	3	0	1387
7587	8	1	1342	7	0	1358
7588	10	7	21	1288	0	1326
7589	1381	0	5	23	0	1409
7590	1364	2	4	9	0	1379
7591	1369	1	3	9	0	1382
7592	18	1	1437	5	0	1461
7593	9	2	1421	3	0	1435
7594	4	1480	17	6	0	1507
7595	5	14	4	1497	0	1520
7596	3	1	7	1510	0	1521
7597	3	2	2	1443	0	1450
7598	2	1	5	1496	0	1504
7599	2	1	1479	19	0	1501
7600	1	1492	16	7	0	1516
7601	1546	15	3	9	0	1573
7602	1754	4	4	9	0	1771
7603	1806	2	2	6	0	1816
7604	31	1895	5	4	0	1935
7605	13	29	3	1958	0	2003
7606	2083	4	2	44	0	2133
7607	39	2170	3	9	0	2221
7608	2149	34	3	13	0	2199
7609	39	2138	5	9	0	2191
7610	2162	40	5	11	0	2218
7611	2185	13	3	10	0	2211
7612	48	8	4	2166	0	2226
7613	29	6	1	2243	0	2279
7614	23	5	2209	55	0	2292
7615	12	4	2158	19	0	2193
7616	2199	1	55	16	0	2271
7617	2262	7	18	13	0	2300
7618	55	5	14	2206	0	2280
7619	29	2	8	2247	0	2286
7620	19	5	2196	56	0	2276
7621	18	3	41	2179	0	2241
7622	6	6	2171	57	0	2240
7623	7	2	50	2197	0	2256
7624	10	4	15	2251	0	2280
7625	2216	6	18	61	0	2301
7626	2197	3	8	31	0	2239
7627	62	5	4	2180	0	2251
7628	36	2	3	2210	0	2251
7629	19	5	2145	69	0	2238
7630	15	0	45	2180	0	2240
7631	10	4	2160	61	0	2235
7632	2135	4	56	28	0	2223
7633	54	8	23	2154	0	2239
7634	2163	4	10	60	0	2237
7635	66	2134	7	30	0	2237
7636	2140	45	4	29	0	2218
7637	63	19	6	2138	0	2226
7638	27	8	9	2152	0	2196
7639	18	2106	14	62	0	2200
7640	22	50	12	2128	0	2212
7641	16	15	2077	73	0	2181
7642	20	7	50	2088	0	2165
7643	16	9	2003	66	0	2094
7644	11	1988	54	30	0	2083
7645	18	37	24	2002	0	2081
7646	10	16	1972	57	0	2055
7647	9	11	1957	25	0	2002
7648	8	6	47	1961	0	2022
7649	1937	5	41	52	0	2035
7650	50	4	1926	27	0	2007
7651	22	5	47	1942	0	2016
7652	1964	7	20	55	0	2046
7653	43	1909	16	28	0	1996
7654	2018	40	13	20	0	2091
7655	58	14	8	2029	0	2109
7656	23	11	7	2063	0	2104
7657	18	7	6	2079	0	2110
7658	2042	2	10	72	0	2126
7659	48	3	7	2067	0	2125
7660	29	2	8	2084	0	2123
7661	2000	6	10	68	0	2084
7662	50	8	1964	42	0	2064
7663	26	5	43	1993	0	2067
7664	20	5	1996	54	0	2075
7665	1978	4	45	31	0	2058
7666	53	4	15	2016	0	2088
7667	20	5	2009	62	0	2096
7668	1989	7	50	31	0	2077
7669	2055	8	15	29	0	2107
7670	61	3	2071	19	0	2154
7671	33	10	39	2045	0	2127
7672	23	1	22	2101	0	2147
7673	15	7	2106	63	0	2191
7674	10	2066	49	43	0	2168
7675	10	38	2115	30	0	2193
7676	2077	13	55	18	0	2163
7677	43	12	2153	23	0	2231
7678	2090	9	55	17	0	2171
7679	68	6	2125	9	0	2208
7680	2089	1	57	22	0	2169
7681	52	2128	24	26	0	2230
7682	23	40	21	2129	0	2213
7683	26	17	10	2211	0	2264
7684	14	9	2174	61	0	2258
7685	15	7	47	2132	0	2201
7686	17	2141	22	63	0	2243
7687	2108	38	17	30	0	2193
7688	46	2109	16	23	0	2194
7689	20	46	12	2120	0	2198
7690	2103	12	13	67	0	2195
7691	45	2140	15	29	0	2229
7692	2097	49	10	25	0	2181
7693	65	16	2130	14	0	2225
7694	31	10	56	2151	0	2248
7695	32	4	25	2183	0	2244
7696	19	7	16	2223	0	2265
7697	2195	9	15	74	0	2293
7698	2220	9	7	37	0	2273
7699	2237	9	13	33	0	2292
7700	2253	3	8	30	0	2294
7701	76	8	2111	18	0	2213
7702	1870	1	39	14	0	1924
7703	54	1842	15	9	0	1920
7704	17	1791	14	11	0	1833
7705	1730	38	44	9	0	1821
7706	1685	11	10	11	0	1717
7707	36	6	1	1590	0	1633
7708	1625	1	4	25	0	1655
7709	1635	2	2	5	0	1644
7710	1793	1	3	13	0	1810
7711	42	5	3	1784	0	1834
7712	11	1787	3	26	0	1827
7713	11	1825	3	3	0	1842
7714	6	38	9	1811	0	1864
7715	1786	7	6	34	0	1833
7716	29	1783	1	4	0	1817
7717	5	30	5	1785	0	1825
7718	6	3	1792	29	0	1830
7719	1730	8	26	7	0	1771
7720	31	1770	5	11	0	1817
7721	6	1837	7	3	0	1853
7722	1810	29	3	11	0	1853
7723	35	6	1840	3	0	1884
7724	8	4	31	1817	0	1860
7725	14	1851	3	28	0	1896
7726	3	31	8	1879	0	1921
7727	6	6	2	1887	0	1901
7728	7	1689	9	32	0	1737
7729	7	26	1	1907	0	1941
7730	10	5	1	1958	0	1974
7731	1929	7	2	36	0	1974
7732	31	1906	5	9	0	1951
7733	1943	27	4	12	0	1986
7734	37	6	1	1927	0	1971
7735	6	1965	4	22	0	1997
7736	11	32	1931	4	0	1978
7737	11	6	28	1932	0	1977
7738	6	6	4	1999	0	2015
7739	6	4	1983	29	0	2022
7740	1952	5	23	12	0	1992
7741	30	3	3	2269	0	2305
7742	2284	2	3	43	0	2332
7743	35	5	2245	8	0	2293
7744	7	5	33	2303	0	2348
7745	13	7	2447	39	0	2506
7746	10	4	45	2490	0	2549
7747	8	7	7	2558	0	2580
7748	2489	5	9	49	0	2552
7749	35	2501	7	24	0	2567
7750	2533	40	3	19	0	2595
7751	51	14	2507	5	0	2577
7752	15	12	39	2498	0	2564
7753	14	4	2564	47	0	2629
7754	2312	8	52	20	0	2392
7755	2521	3	10	17	0	2551
7756	54	6	2487	11	0	2558
7757	2460	8	38	21	0	2527
7758	2529	7	19	14	0	2569
7759	56	6	17	2491	0	2570
7760	23	5	2434	58	0	2520
7761	26	6	2472	21	0	2525
7762	15	9	54	2524	0	2602
7763	27	6	21	2486	0	2540
7764	19	2427	25	49	0	2520
7765	16	2528	8	38	0	2590
7766	2511	50	19	23	0	2603
7767	64	19	11	2515	0	2609
7768	29	2436	15	51	0	2531
7769	18	2544	20	27	0	2609
7770	2472	48	16	30	0	2566
7771	58	23	17	2494	0	2592
7772	24	2494	6	63	0	2587
7773	29	42	14	2507	0	2592
7774	24	21	15	2507	0	2567
7775	16	22	16	2521	0	2575
7776	2452	8	15	75	0	2550
7777	55	2439	13	41	0	2548
7778	17	62	12	2459	0	2550
7779	37	24	13	2479	0	2553
7780	29	21	11	2485	0	2546
7781	23	14	2362	84	0	2483
7782	2305	20	53	37	0	2415
7783	65	18	18	2397	0	2498
7784	2373	11	16	69	0	2469
7785	2421	14	12	38	0	2485
7786	2423	13	13	44	0	2493
7787	64	18	2403	30	0	2515
7788	33	2405	46	42	0	2526
7789	34	46	23	2414	0	2517
7790	16	26	2405	62	0	2509
7791	23	29	2328	33	0	2413
7792	33	19	44	2241	0	2337
7793	12	2227	20	64	0	2323
7794	2278	42	21	35	0	2376
7795	2332	19	14	36	0	2401
7796	2395	20	12	33	0	2460
7797	2379	9	11	39	0	2438
7798	67	16	2328	26	0	2437
7799	2324	14	37	27	0	2402
7800	59	2372	30	20	0	2481
7801	32	41	21	2406	0	2500
7802	28	19	10	2452	0	2509
7803	2420	23	18	55	0	2516
7804	59	6	19	2411	0	2495
7805	28	6	2344	65	0	2443
7806	2253	15	51	34	0	2353
7807	2372	11	17	37	0	2437
7808	2374	12	19	23	0	2428
7809	75	8	2299	21	0	2403
7810	2130	11	32	18	0	2191
7811	64	2127	26	18	0	2235
7812	2166	29	28	25	0	2248
7813	54	19	23	2126	0	2222
7814	27	20	11	2130	0	2188
7815	28	2099	15	47	0	2189
7816	37	27	13	2137	0	2214
7817	19	2108	17	52	0	2196
7818	30	42	17	2095	0	2184
7819	26	2069	12	38	0	2145
7820	34	34	11	2072	0	2151
7821	33	2083	13	40	0	2169
7822	29	36	15	2116	0	2196
7823	27	2100	10	54	0	2191
7824	2253	47	12	25	0	2337
7825	72	21	6	2263	0	2362
7826	34	22	5	2310	0	2371
7827	30	17	6	2449	0	2502
7828	21	17	6	2520	0	2564
7829	15	16	2502	99	0	2632
7830	17	21	55	2525	0	2618
7831	23	10	25	2572	0	2630
7832	2505	17	17	97	0	2636
7833	2477	10	5	50	0	2542
7834	84	2504	4	26	0	2618
7835	39	55	8	2486	0	2588
7836	32	26	9	2663	0	2730
7837	2813	22	8	78	0	2921
7838	75	19	2627	54	0	2775
7839	2663	11	57	44	0	2775
7840	87	2716	15	34	0	2852
7841	2487	53	12	21	0	2573
7842	2491	19	6	20	0	2536
7843	74	2435	7	15	0	2531
7844	24	2461	4	19	0	2508
7845	35	62	12	2260	0	2369
7846	13	19	2231	48	0	2311
7847	2210	11	42	23	0	2286
7848	50	11	2239	9	0	2309
7849	2184	10	49	12	0	2255
7850	60	5	2218	11	0	2294
7851	20	2192	54	9	0	2275
7852	20	47	16	2212	0	2295
7853	2126	17	13	61	0	2217
7854	2175	11	11	22	0	2219
7855	72	5	5	2154	0	2236
7856	2226	6	9	58	0	2299
7857	2253	13	3	19	0	2288
7858	66	2183	6	30	0	2285
7859	2223	58	4	21	0	2306
7860	63	2241	9	15	0	2328
7861	30	51	9	2263	0	2353
7862	2248	13	5	62	0	2328
7863	2324	8	8	26	0	2366
7864	2327	10	7	16	0	2360
7865	74	9	2274	9	0	2366
7866	30	11	2298	4	0	2343
7867	25	9	59	2332	0	2425
7868	13	12	15	2517	0	2557
7869	17	2608	9	83	0	2717
7870	2683	67	8	22	0	2780
7871	95	28	7	2669	0	2799
7872	50	20	6	2740	0	2816
7873	33	12	2700	91	0	2836
7874	17	2619	70	40	0	2746
7875	15	2755	26	30	0	2826
7876	35	87	8	2752	0	2882
7877	2731	31	2	81	0	2845
7878	103	12	12	2737	0	2864
7879	45	6	24	2815	0	2890
7880	2767	9	21	109	0	2906
7881	2825	10	8	62	0	2905
7882	121	17	6	2770	0	2914
7883	49	25	2726	92	0	2892
7884	35	13	72	2788	0	2908
7885	25	14	27	2830	0	2896
7886	2751	6	13	148	0	2918
7887	103	10	21	2734	0	2868
7888	2721	18	12	98	0	2849
7889	96	20	2707	57	0	2880
7890	46	8	87	2775	0	2916
7891	42	7	36	2846	0	2931
7892	26	14	12	2896	0	2948
7893	31	15	6	2861	0	2913
7894	54	9	6	2797	0	2866
7895	42	11	2625	139	0	2817
7896	2625	6	94	78	0	2803
7897	96	12	52	2642	0	2802
7898	40	10	2555	127	0	2732
7899	39	15	2599	68	0	2721
7900	45	10	98	2579	0	2732
7901	2558	15	38	121	0	2732
7902	2630	12	23	64	0	2729
7903	2655	7	27	48	0	2737
7904	130	11	10	2513	0	2664
7905	62	2508	19	113	0	2702
7906	2559	80	25	66	0	2730
7907	2593	31	19	61	0	2704
7908	2580	10	19	54	0	2663
7909	2596	10	24	40	0	2670
7910	149	17	12	2496	0	2674
7911	66	14	2455	111	0	2646
7912	42	12	100	2473	0	2627
7913	32	12	2452	116	0	2612
7914	2416	5	92	72	0	2585
7915	2506	10	39	46	0	2601
7916	149	13	2397	37	0	2596
7917	2437	6	85	50	0	2578
7918	2552	12	45	54	0	2663
7919	132	27	19	2454	0	2632
7920	80	2451	18	105	0	2654
7921	2494	83	20	49	0	2646
7922	133	37	11	2382	0	2563
7923	77	2324	22	97	0	2520
7924	43	70	26	2307	0	2446
7925	40	33	2247	98	0	2418
7926	42	2235	76	61	0	2414
7927	2100	74	49	39	0	2262
7928	2092	29	32	40	0	2193
7929	2036	6	17	34	0	2093
7930	2029	12	25	27	0	2093
7931	101	16	8	1933	0	2058
7932	57	1932	11	72	0	2072
7933	1870	52	12	51	0	1985
7934	64	33	1885	35	0	2017
7935	46	1848	63	29	0	1986
7936	32	43	1774	29	0	1878
7937	25	40	37	1537	0	1639
7938	25	1456	24	59	0	1564
7939	21	37	23	1592	0	1673
7940	22	33	1631	51	0	1737
7941	27	4	49	1618	0	1698
7942	34	12	18	1674	0	1738
7943	34	7	10	1691	0	1742
7944	1639	4	6	69	0	1718
7945	51	1622	10	41	0	1724
7946	36	48	6	1647	0	1737
7947	1618	19	16	50	0	1703
7948	50	1616	18	30	0	1714
7949	1626	42	6	30	0	1704
7950	46	28	1636	21	0	1731
7951	37	8	43	1615	0	1703
7952	26	1638	20	41	0	1725
7953	1642	39	15	44	0	1740
7954	50	19	1614	16	0	1699
7955	39	1552	39	21	0	1651
7956	21	36	19	1555	0	1631
7957	20	26	10	1591	0	1647
7958	1578	5	9	48	0	1640
7959	48	6	8	1567	0	1629
7960	31	9	1529	40	0	1609
7961	14	6	31	1491	0	1542
7962	9	6	1532	43	0	1590
7963	16	18	31	1464	0	1529
7964	13	1494	17	39	0	1563
7965	1502	26	10	17	0	1555
7966	1465	20	6	20	0	1511
7967	45	1376	9	9	0	1439
7968	15	1250	4	6	0	1275
7969	50	16	7	1111	0	1184
7970	1103	4	4	18	0	1129
7971	18	6	4	1103	0	1131
7972	1071	2	0	17	0	1090
7973	16	1043	1	6	0	1066
7974	7	14	0	1069	0	1090
7975	2	5	1101	13	0	1121
7976	5	3	10	1081	0	1099
7977	5	2	3	1110	0	1120
7978	1106	1	3	14	0	1124
7979	8	1121	2	4	0	1135
7980	6	13	1	1120	0	1140
7981	1120	3	0	12	0	1135
7982	6	2	1123	2	0	1133
7983	1135	1	4	5	0	1145
7984	6	5	2	1163	0	1176
7985	4	1196	0	4	0	1204
7986	1195	6	0	5	0	1206
7987	7	4	1200	0	0	1211
7988	4	3	1190	0	0	1197
7989	3	1179	9	0	0	1191
7990	1145	5	10	4	0	1164
7991	7	2	0	1184	0	1193
7992	5	0	1	1171	0	1177
7993	1216	0	1	14	0	1231
7994	7	2	1213	7	0	1229
7995	11	0	6	1254	0	1271
7996	2	0	1334	13	0	1349
7997	7	0	10	1334	0	1351
7998	3	1363	9	14	0	1389
7999	1	9	1	1424	0	1435
8000	2	9	1397	13	0	1421
8001	1387	1	11	15	0	1414
8002	17	2	9	1441	0	1469
8003	8	2	1473	18	0	1501
8004	4	1	18	1455	0	1478
8005	11	1	9	1468	0	1489
8006	3	1	1441	27	0	1472
8007	2	2	1448	12	0	1464
8008	1	2	22	1476	0	1501
8009	0	0	1497	21	0	1518
8010	1469	1	19	13	0	1502
8011	17	0	12	1527	0	1556
8012	1532	1	4	27	0	1564
8013	17	1	1536	10	0	1564
8014	15	0	16	1555	0	1586
8015	2	1	1659	20	0	1682
8016	4	1640	23	12	0	1679
8017	3	17	1681	5	0	1706
8018	1	10	1614	5	0	1630
8019	1607	2	29	10	0	1648
8020	1674	4	11	9	0	1698
8021	30	5	1752	1	0	1788
8022	19	1	26	1680	0	1726
8023	14	0	10	1738	0	1762
8024	4	0	1805	28	0	1837
8025	3	1748	24	13	0	1788
8026	1750	18	12	10	0	1790
8027	23	9	1820	8	0	1860
8028	12	1	30	1850	0	1893
8029	7	3	12	1905	0	1927
8030	1934	2	6	36	0	1978
8031	1946	0	5	21	0	1972
8032	1968	2	3	15	0	1988
8033	1993	0	4	9	0	2006
8034	42	2	5	1960	0	2009
8035	20	1	2023	28	0	2072
8036	8	1	27	2011	0	2047
8037	9	2	14	2048	0	2073
8038	9	3	5	2133	0	2150
8039	5	0	2088	42	0	2135
8040	2046	1	29	18	0	2094
8041	44	0	12	2133	0	2189
8042	17	1	2213	40	0	2271
8043	4	2247	37	24	0	2312
8044	8	30	15	2275	0	2328
8045	8	12	5	2298	0	2323
8046	2246	3	6	51	0	2306
8047	38	2254	8	19	0	2319
8048	13	35	2268	13	0	2329
8049	10	12	40	2240	0	2302
8050	13	4	14	2288	0	2319
8051	2267	6	6	52	0	2331
8052	2275	4	7	19	0	2305
8053	56	2	5	2305	0	2368
8054	2302	2	2	50	0	2356
8055	48	2314	7	17	0	2386
8056	19	37	2448	11	0	2515
8057	10	14	43	2470	0	2537
8058	13	4	16	2530	0	2563
8059	13	7	7	2549	0	2576
8060	9	2	8	2480	0	2499
8061	10	2431	6	56	0	2503
8062	2405	36	3	28	0	2472
8063	43	16	8	2464	0	2531
8064	15	2529	7	46	0	2597
8065	2573	41	1	25	0	2640
8066	2575	13	4	17	0	2609
8067	49	2610	7	14	0	2680
8068	16	43	3	2669	0	2731
8069	22	15	5	2685	0	2727
8070	18	6	2	2665	0	2691
8071	10	9	9	2687	0	2715
8072	2698	4	4	64	0	2770
8073	2734	2	4	32	0	2772
8074	63	2756	6	18	0	2843
8075	18	50	2764	14	0	2846
8076	16	17	49	2755	0	2837
8077	2805	5	17	60	0	2887
8078	52	2724	11	28	0	2815
8079	17	2796	10	17	0	2840
8080	2856	54	6	18	0	2934
8081	2944	18	3	16	0	2981
8082	73	11	10	2892	0	2986
8083	30	11	3031	54	0	3126
8084	27	14	3075	29	0	3145
8085	3217	6	63	29	0	3315
8086	3407	7	21	29	0	3464
8087	3415	10	15	16	0	3456
8088	3404	6	12	13	0	3435
8089	3422	3	7	17	0	3449
8090	75	3504	10	17	0	3606
8091	31	42	6	3544	0	3623
8092	19	3624	4	48	0	3695
8093	3677	58	13	19	0	3767
8094	3664	21	2	23	0	3710
8095	3649	4	11	20	0	3684
8096	3639	9	1	17	0	3666
8097	61	3572	6	5	0	3644
8098	3578	43	3	14	0	3638
8099	50	3575	7	10	0	3642
8100	22	56	1	3625	0	3704
8101	3601	8	1	52	0	3662
8102	47	7	3679	11	0	3744
8103	17	6	38	3626	0	3687
8104	17	7	7	3755	0	3786
8105	17	5	3754	41	0	3817
8106	5	3762	38	17	0	3822
8107	3774	38	8	16	0	3836
8108	3758	9	7	23	0	3797
8109	48	3757	9	7	0	3821
8110	14	46	2	3828	0	3890
8111	11	10	3926	47	0	3994
8112	11	4052	40	12	0	4115
8113	4007	39	8	26	0	4080
8114	40	10	4010	10	0	4070
8115	3765	9	34	7	0	3815
8116	3937	10	10	9	0	3966
8117	45	10	4126	7	0	4188
8118	14	4100	39	11	0	4164
8119	23	37	10	4020	0	4090
8120	12	10	4193	35	0	4250
8121	3945	18	38	20	0	4021
8122	4131	8	9	13	0	4161
8123	43	4208	5	9	0	4265
8124	13	31	8	4272	0	4324
8125	16	7	5	4334	0	4362
8126	16	7	4349	34	0	4406
8127	9	4356	34	11	0	4410
8128	4546	30	8	29	0	4613
8129	4615	6	4	17	0	4642
8130	4692	4	6	17	0	4719
8131	41	11	4617	2	0	4671
8132	4571	4	25	11	0	4611
8133	4721	5	4	11	0	4741
8134	42	3	10	4744	0	4799
8135	12	5	4720	27	0	4764
8136	22	0	26	4655	0	4703
8137	16	3	4795	27	0	4841
8138	13	12	22	4687	0	4734
8139	8	4732	12	28	0	4780
8140	9	4927	5	14	0	4955
8141	10	23	5	5022	0	5060
8142	12	8	3	4867	0	4890
8143	4956	9	2	29	0	4996
8144	26	7	4937	6	0	4976
8145	4742	4	14	23	0	4783
8146	23	5023	5	10	0	5061
8147	5114	15	8	17	0	5154
8148	5108	5	4	10	0	5127
8149	30	6	1	5106	0	5143
8150	13	8	5324	16	0	5361
8151	13	5	16	5326	0	5360
8152	9	5518	9	21	0	5557
8153	9	24	3	5627	0	5663
8154	12	11	3	5660	0	5686
8155	5574	8	2	43	0	5627
8156	25	7	1	5471	0	5504
8157	10	5392	1	33	0	5436
8158	18	23	2	5511	0	5554
8159	5549	5	0	40	0	5594
8160	28	5557	5	7	0	5597
8161	7	27	3	5695	0	5732
8162	13	8	4	5701	0	5726
8163	12	8	3	5857	0	5880
8164	5	3	5	5845	0	5858
8165	5987	3	0	69	0	6059
8166	57	0	3	6116	0	6176
8167	36	1	4	6316	0	6357
8168	26	3	1	6517	0	6547
8169	7	6609	5	89	0	6710
8170	6578	85	2	40	0	6705
8171	88	28	6624	16	0	6756
8172	24	6611	73	11	0	6719
8173	6512	78	29	31	0	6650
8174	82	30	6734	13	0	6859
8175	30	6762	83	11	0	6886
8176	37	94	26	6707	0	6864
8177	16	6827	18	71	0	6932
8178	5	97	6788	31	0	6921
8179	21	37	6743	23	0	6824
8180	11	6828	108	19	0	6966
8181	6827	85	39	32	0	6983
8182	6807	31	15	31	0	6884
8183	102	25	6502	6	0	6635
8184	42	20	6165	7	0	6234
8185	22	17	6444	9	0	6492
8186	25	17	101	6365	0	6508
8187	22	16	40	6361	0	6439
8188	29	8	29	6589	0	6655
8189	7	12	6720	113	0	6852
8190	22	16	91	6339	0	6468
8191	23	10	35	6586	0	6654
8192	12	10	6515	118	0	6655
8193	6318	8	99	59	0	6484
8194	107	11	40	6763	0	6921
8195	35	10	29	6815	0	6889
8196	22	6854	20	113	0	7009
8197	6868	88	25	68	0	7049
8198	98	36	6830	29	0	6993
8199	6753	13	102	37	0	6905
8200	115	22	33	6875	0	7045
8201	45	21	6953	117	0	7136
8202	37	13	112	6840	0	7002
8203	6952	14	47	131	0	7144
8204	107	11	6968	56	0	7142
8205	6872	11	115	59	0	7057
8206	7083	16	42	50	0	7191
8207	7120	11	39	46	0	7216
8208	144	6984	28	37	0	7193
8209	74	97	21	7172	0	7364
8210	7208	33	33	129	0	7403
8211	7186	22	31	53	0	7292
8212	7246	16	22	45	0	7329
8213	166	23	7006	32	0	7227
8214	7264	14	108	46	0	7432
8215	161	10	54	7589	0	7814
8216	75	9	7548	140	0	7772
8217	70	14	138	7612	0	7834
8218	47	14	53	7734	0	7848
8219	35	16	7864	205	0	8120
8220	52	9	165	7806	0	8032
8221	52	11	58	8054	0	8175
8222	41	12	8934	217	0	9204
8223	9242	4	215	128	0	9589
8224	10174	4	94	96	0	10368
8225	360	6	67	10407	0	10840
8226	162	10	10354	295	0	10821
8227	126	10	288	10217	0	10641
8228	109	10104	113	344	0	10670
8229	119	251	69	10211	0	10650
8230	120	75	64	10449	0	10708
8231	10188	49	72	452	0	10761
8232	10295	39	70	248	0	10652
8233	10474	47	57	205	0	10783
8234	423	50	57	10226	0	10756
8235	222	36	42	10477	0	10777
8236	182	37	10028	450	0	10697
8237	186	33	281	9878	0	10378
8238	160	9917	106	403	0	10586
8239	10030	261	76	244	0	10611
8240	339	9877	76	200	0	10492
8241	9998	310	73	187	0	10568
8242	406	130	73	9557	0	10166
8243	190	9710	50	365	0	10315
8244	9788	328	65	183	0	10364
8245	9963	159	52	149	0	10323
8246	477	125	46	9621	0	10269
8247	260	9627	39	353	0	10279
8248	191	351	34	9754	0	10330
8249	167	152	9559	405	0	10283
8250	9320	107	290	235	0	9952
8251	392	9363	111	193	0	10059
8252	9282	331	76	160	0	9849
8253	427	150	62	9254	0	9893
8254	9391	106	72	396	0	9965
8255	443	77	9375	185	0	10080
8256	9580	90	295	190	0	10155
8257	9706	89	138	162	0	10095
8258	516	63	9539	146	0	10264
8259	342	63	322	9480	0	10207
8260	266	53	161	9684	0	10164
8261	9469	66	124	464	0	10123
8262	448	9300	101	282	0	10131
8263	281	303	106	9181	0	9871
8264	217	111	9004	411	0	9743
8265	189	90	8873	259	0	9411
8266	177	8770	342	228	0	9517
8267	180	281	8510	204	0	9175
8268	8168	159	316	229	0	8872
8269	318	119	180	7993	0	8610
8270	8189	83	133	336	0	8741
8271	336	104	8071	172	0	8683
8272	212	79	322	8026	0	8639
8273	171	93	165	8212	0	8641
8274	157	75	7877	383	0	8492
8275	173	78	289	7917	0	8457
8276	7775	71	161	381	0	8388
8277	7964	54	123	257	0	8398
8278	405	59	108	7786	0	8358
8279	7735	53	102	375	0	8265
8280	7785	60	90	268	0	8203
8281	436	7477	87	224	0	8224
8282	292	237	87	7612	0	8228
8283	7696	106	61	379	0	8242
8284	434	76	67	7610	0	8187
8285	7528	69	74	390	0	8061
8286	412	89	67	7418	0	7986
8287	270	78	7323	382	0	8053
8288	233	7264	256	237	0	7990
8289	243	271	116	6616	0	7246
8290	209	7137	110	310	0	7766
8291	7082	274	91	227	0	7674
8292	357	6845	100	204	0	7506
8293	214	6922	96	168	0	7400
8294	168	347	93	6703	0	7311
8295	6634	208	87	349	0	7278
8296	329	160	75	6626	0	7190
8297	6579	154	69	368	0	7170
8298	6613	162	69	239	0	7083
8299	396	6532	66	181	0	7175
8300	6680	279	73	175	0	7207
8301	6722	171	61	157	0	7111
8302	6741	114	77	163	0	7095
8303	483	82	6264	139	0	6968
8304	322	86	245	6226	0	6879
8305	287	74	121	6389	0	6871
8306	246	82	6001	346	0	6675
8307	6239	72	248	229	0	6788
8308	6427	58	131	194	0	6810
8309	6374	51	125	178	0	6728
8310	6229	50	103	198	0	6580
8311	450	5845	95	178	0	6568
8312	5979	208	73	152	0	6412
8313	462	115	68	5778	0	6423
8314	313	83	5216	271	0	5883
8315	5373	68	175	160	0	5776
8316	403	5266	91	127	0	5887
8317	5037	209	65	121	0	5432
8318	359	4807	55	131	0	5352
8319	217	4621	65	135	0	5038
8320	202	4518	70	125	0	4915
8321	171	4432	97	130	0	4830
8322	159	258	3302	105	0	3824
8323	177	290	174	2431	0	3072
8324	84	44	2133	75	0	2336
8325	1635	22	52	42	0	1751
8326	44	1651	26	32	0	1753
8327	33	1625	15	25	0	1698
8328	25	60	6	1593	0	1684
8329	25	26	12	1614	0	1677
8330	26	19	1571	50	0	1666
8331	29	10	1572	33	0	1644
8332	29	23	34	1566	0	1652
8333	24	21	1579	37	0	1661
8334	28	1539	35	27	0	1629
8335	43	31	12	1505	0	1591
8336	38	10	8	1618	0	1674
8337	35	17	1593	41	0	1686
8338	35	8	31	1576	0	1650
8339	1586	12	19	43	0	1660
8340	42	13	19	1543	0	1617
8341	25	7	16	1556	0	1604
8342	31	11	1504	47	0	1593
8343	1479	8	31	39	0	1557
8344	50	1524	18	22	0	1614
8345	42	35	7	1512	0	1596
8346	39	17	1484	33	0	1573
8347	39	25	24	1479	0	1567
8348	1522	14	13	40	0	1589
8349	44	14	1503	24	0	1585
8350	35	6	32	1515	0	1588
8351	25	19	1548	40	0	1632
8352	33	1547	26	31	0	1637
8353	34	31	1502	21	0	1588
8354	25	1452	35	15	0	1527
8355	36	25	1214	9	0	1284
8356	18	29	28	1074	0	1149
8357	8	1080	13	19	0	1120
8358	1033	13	6	8	0	1060
8359	20	8	5	1039	0	1072
8360	1082	6	5	14	0	1107
8361	22	3	4	1128	0	1157
8362	12	6	3	1157	0	1178
8363	1166	9	4	18	0	1197
8364	1208	2	4	10	0	1224
8365	26	6	0	1279	0	1311
8366	13	0	1301	21	0	1335
8367	13	1287	19	13	0	1332
8368	15	25	1306	8	0	1354
8369	13	1336	19	3	0	1371
8370	1289	24	11	5	0	1329
8371	26	8	1278	3	0	1315
8372	13	9	1291	1	0	1314
8373	8	5	24	1236	0	1273
8374	1252	6	11	21	0	1290
8375	21	3	1303	10	0	1337
8376	10	1366	19	10	0	1405
8377	1396	17	11	4	0	1428
8378	1422	7	5	9	0	1443
8379	1431	4	4	7	0	1446
8380	1443	6	2	4	0	1455
8381	1432	3	3	4	0	1442
8382	30	5	1418	8	0	1461
8383	16	5	22	1367	0	1410
8384	9	1380	11	15	0	1415
8385	1400	18	8	11	0	1437
8386	20	1436	3	7	0	1466
8387	1357	21	3	9	0	1390
8388	1369	7	7	4	0	1387
8389	21	1358	3	5	0	1387
8390	1411	18	2	11	0	1442
8391	26	7	4	1400	0	1437
8392	7	6	3	1421	0	1437
8393	6	5	1381	22	0	1414
8394	5	1410	19	13	0	1447
8395	5	16	7	1440	0	1468
8396	9	6	5	1445	0	1465
8397	7	5	5	1450	0	1467
8398	4	6	1408	26	0	1444
8399	1353	0	19	13	0	1385
8400	21	1	8	1426	0	1456
8401	1451	4	6	21	0	1482
8402	24	1	4	1476	0	1505
8403	16	4	1530	19	0	1569
8404	7	4	1539	13	0	1563
8405	1509	2	23	9	0	1543
8406	1564	5	11	4	0	1584
8407	30	1521	9	2	0	1562
8408	17	14	1551	4	0	1586
8409	15	11	16	1501	0	1543
8410	19	6	19	1283	0	1327
8411	1606	6	7	30	0	1649
8412	1616	2	3	17	0	1638
8413	1638	3	3	12	0	1656
8414	24	3	1620	5	0	1652
8415	1696	2	19	8	0	1725
8416	22	4	7	1722	0	1755
8417	14	3	5	1733	0	1755
8418	11	2	3	1749	0	1765
8419	4	1709	1	32	0	1746
8420	1699	12	4	19	0	1734
8421	18	8	3	1711	0	1740
8422	12	5	1727	19	0	1763
8423	11	3	17	1713	0	1744
8424	7	1730	10	20	0	1767
8425	1751	14	6	17	0	1788
8426	20	10	5	1718	0	1753
8427	13	6	2	1708	0	1729
8428	8	5	1710	25	0	1748
8429	8	2	15	1716	0	1741
8430	6	1706	9	22	0	1743
8431	6	14	10	1753	0	1783
8432	11	10	1741	21	0	1783
8433	1601	6	19	19	0	1645
8434	1723	2	11	12	0	1748
8435	27	1776	6	7	0	1816
8436	1755	14	4	10	0	1783
8437	1790	8	4	6	0	1808
8438	25	1787	0	7	0	1819
8439	13	14	2	1830	0	1859
8440	1879	9	13	24	0	1925
8441	20	1919	5	11	0	1955
8442	13	17	1953	8	0	1991
8443	1914	15	27	14	0	1970
8444	2052	4	12	7	0	2075
8445	2079	2	5	9	0	2095
8446	2078	4	0	7	0	2089
8447	41	2072	6	2	0	2121
8448	2117	23	0	12	0	2152
8449	2161	12	4	4	0	2181
8450	2151	7	1	10	0	2169
8451	44	5	4	2134	0	2187
8452	2125	3	0	34	0	2162
8453	33	2297	4	14	0	2348
8454	16	28	2445	9	0	2498
8455	14	10	29	2573	0	2626
8456	2631	8	9	44	0	2692
8457	44	3	2642	12	0	2701
8458	17	2	37	2650	0	2706
8459	15	2	2650	38	0	2705
8460	5	2615	48	15	0	2683
8461	6	37	12	2585	0	2640
8462	4	12	2594	42	0	2652
8463	3	2591	44	10	0	2648
8464	13	39	11	2555	0	2618
8465	2549	10	11	58	0	2628
8466	2579	7	4	16	0	2606
8467	2589	3	0	15	0	2607
8468	2565	3	4	5	0	2577
8469	2603	2	3	8	0	2616
8470	46	2	2564	5	0	2617
8471	2578	2	28	8	0	2616
8472	2656	2	10	5	0	2673
8473	47	0	10	2621	0	2678
8474	2628	7	4	32	0	2671
8475	2559	2	3	16	0	2580
8476	45	2504	4	10	0	2563
8477	28	31	5	2533	0	2597
8478	15	11	3	2572	0	2601
8479	2536	7	0	47	0	2590
8480	44	2459	4	20	0	2527
8481	15	2520	2	13	0	2550
8482	19	40	3	2547	0	2609
8483	15	14	3	2570	0	2602
8484	14	9	5	2569	0	2597
8485	18	2	6	2611	0	2637
8486	2544	4	3	56	0	2607
8487	2536	3	3	30	0	2572
8488	57	4	2531	16	0	2608
8489	28	4	36	2502	0	2570
8490	23	4	11	2535	0	2573
8491	12	7	2492	49	0	2560
8492	2444	3	39	27	0	2513
8493	44	2508	12	18	0	2582
8494	2515	38	10	14	0	2577
8495	60	15	5	2518	0	2598
8496	23	13	2580	42	0	2658
8497	25	5	33	2635	0	2698
8498	17	3	2706	48	0	2774
8499	9	2708	40	21	0	2778
8500	2679	37	10	28	0	2754
8501	2705	7	8	16	0	2736
8502	53	2669	10	4	0	2736
8503	24	39	3	2636	0	2702
8504	2595	11	4	47	0	2657
8505	48	2576	4	16	0	2644
8506	16	38	7	2642	0	2703
8507	2649	10	4	51	0	2714
8508	51	14	2571	13	0	2649
8509	2546	8	36	28	0	2618
8510	48	2576	12	16	0	2652
8511	2591	39	11	15	0	2656
8512	2589	11	11	19	0	2630
8513	50	12	2540	18	0	2620
8514	26	4	41	2474	0	2545
8515	25	4	10	2551	0	2590
8516	20	8	2520	49	0	2597
8517	16	4	39	2483	0	2542
8518	24	8	17	2396	0	2445
8519	2570	4	15	53	0	2642
8520	2581	7	9	24	0	2621
8521	49	5	8	2548	0	2610
8522	24	6	2533	50	0	2613
8523	26	4	42	2523	0	2595
8524	15	4	13	2578	0	2610
8525	12	11	2581	62	0	2666
8526	13	4	42	2595	0	2654
8527	2589	4	9	59	0	2661
8528	2599	5	14	22	0	2640
8529	50	2545	9	20	0	2624
8530	2634	39	8	25	0	2706
8531	2648	10	7	17	0	2682
8532	51	2620	9	15	0	2695
8533	2651	43	5	22	0	2721
8534	2683	9	1	17	0	2710
8535	2690	12	2	19	0	2723
8536	65	7	2591	11	0	2674
8537	2619	3	40	13	0	2675
8538	57	5	9	2670	0	2741
8539	2670	5	10	51	0	2736
8540	57	6	2642	16	0	2721
8541	23	2554	42	20	0	2639
8542	2597	45	9	19	0	2670
8543	55	2680	12	8	0	2755
8544	18	46	7	2657	0	2728
8545	18	8	6	2711	0	2743
8546	2675	9	5	56	0	2745
8547	2684	7	3	27	0	2721
8548	56	5	2616	15	0	2692
8549	26	5	2456	13	0	2500
8550	15	6	2565	8	0	2594
8551	15	36	51	2479	0	2581
8552	10	6	2527	48	0	2591
8553	12	9	2339	12	0	2372
8554	29	44	55	2154	0	2282
8555	2238	0	23	52	0	2313
8556	2289	1	6	19	0	2315
8557	2296	0	5	11	0	2312
8558	2302	1	5	5	0	2313
8559	42	0	4	2276	0	2322
8560	20	1	4	2283	0	2308
8561	7	5	2332	33	0	2377
8562	7	1	30	2288	0	2326
8563	17	0	8	2212	0	2237
8564	2347	3	4	39	0	2393
8565	2373	2	2	18	0	2395
8566	46	0	2	2351	0	2399
8567	2380	1	3	41	0	2425
8568	2444	0	4	14	0	2462
8569	49	1	3	2491	0	2544
8570	23	0	2	2486	0	2511
8571	17	2	2457	47	0	2523
8572	11	3	2428	17	0	2459
8573	9	7	47	2487	0	2550
8574	14	1	15	2526	0	2556
8575	13	0	2505	43	0	2561
8576	2398	1	43	28	0	2470
8577	2450	0	12	26	0	2488
8578	50	0	2471	9	0	2530
8579	18	2484	42	7	0	2551
8580	2593	31	17	16	0	2657
8581	40	11	2743	7	0	2801
8582	20	9	39	2699	0	2767
8583	13	2	12	2769	0	2796
8584	2795	0	6	45	0	2846
8585	2866	0	6	19	0	2891
8586	44	3	3	2852	0	2902
8587	24	1	1	3046	0	3072
8588	3085	0	6	43	0	3134
8589	3109	1	7	30	0	3147
8590	3067	2	2	24	0	3095
8591	51	0	3091	10	0	3152
8592	28	0	35	3119	0	3182
8593	17	0	12	3230	0	3259
8594	3190	0	7	60	0	3257
8595	37	3172	8	18	0	3235
8596	3391	33	3	19	0	3446
8597	59	3441	3	12	0	3515
8598	26	53	6	3598	0	3683
8599	19	13	4	3682	0	3718
8600	11	7	3640	79	0	3737
8601	13	2	64	3661	0	3740
8602	6	5	3618	73	0	3702
8603	15	5	60	3645	0	3725
8604	14	4	25	3651	0	3694
8605	11	3518	10	85	0	3624
8606	10	3648	8	34	0	3700
8607	17	73	7	3601	0	3698
8608	20	20	8	3728	0	3776
8609	16	7	7	3748	0	3778
8610	15	6	5	3835	0	3861
8611	18	4	8	3886	0	3916
8612	14	6	3791	101	0	3912
8613	15	5	73	3759	0	3852
8614	11	6	25	3865	0	3907
8615	6	6	3728	110	0	3850
8616	7	3671	76	48	0	3802
8617	18	69	22	3772	0	3881
8618	9	22	3767	88	0	3886
8619	9	3763	79	38	0	3889
8620	18	73	27	3836	0	3954
8621	3893	19	13	100	0	4025
8622	80	9	15	3897	0	4001
8623	28	10	13	3946	0	3997
8624	16	8	9	3976	0	4009
8625	14	8	12	3911	0	3945
8626	11	3769	10	114	0	3904
8627	15	69	8	3892	0	3984
8628	3995	25	9	111	0	4140
8629	85	9	10	4066	0	4170
8630	39	8	8	4039	0	4094
8631	15	3	7	4140	0	4165
8632	3967	5	14	130	0	4116
8633	4029	8	12	56	0	4105
8634	92	8	5	4069	0	4174
8635	3912	9	12	106	0	4039
8636	4008	12	8	63	0	4091
8637	94	4037	6	37	0	4174
8638	3977	64	8	46	0	4095
8639	74	3997	8	30	0	4109
8640	24	4015	5	35	0	4079
8641	25	74	11	4045	0	4155
8642	58	25	4016	79	0	4178
8643	22	20	61	3909	0	4012
8644	24	10	15	3965	0	4014
8645	15	3917	14	82	0	4028
8646	3929	65	7	41	0	4042
8647	66	17	7	3940	0	4030
8648	22	12	4351	79	0	4464
8649	20	21	55	4309	0	4405
8650	13	4370	18	80	0	4481
8651	4429	56	11	48	0	4544
8652	62	25	9	4433	0	4529
8653	23	15	4447	86	0	4571
8654	28	26	54	4403	0	4511
8655	21	4303	20	76	0	4420
8656	12	64	5	4402	0	4483
8657	4480	24	11	102	0	4617
8658	4582	7	7	54	0	4650
8659	4656	15	14	43	0	4728
8660	85	4716	15	43	0	4859
8661	4790	69	10	38	0	4907
8662	84	19	9	4854	0	4966
8663	4813	18	9	106	0	4946
8664	85	4847	10	50	0	4992
8665	36	80	9	4906	0	5031
8666	15	36	4984	91	0	5126
8667	4667	18	61	64	0	4810
8668	75	4951	17	47	0	5090
8669	43	73	13	4922	0	5051
8670	24	28	6	5024	0	5082
8671	17	12	8	4925	0	4962
8672	20	16	8	4808	0	4852
8673	12	4783	9	101	0	4905
8674	4883	73	6	65	0	5027
8675	4897	19	12	49	0	4977
8676	92	18	4922	28	0	5060
8677	42	19	67	4948	0	5076
8678	21	16	4923	95	0	5055
8679	4830	13	75	47	0	4965
8680	4882	13	20	44	0	4959
8681	4740	7	13	44	0	4804
8682	95	10	15	4665	0	4785
8683	31	4614	6	97	0	4748
8684	4761	69	8	42	0	4880
8685	91	22	7	4763	0	4883
8686	4739	20	8	100	0	4867
8687	88	15	4501	31	0	4635
8688	29	9	4332	36	0	4406
8689	4546	8	69	34	0	4657
8690	87	15	19	4591	0	4712
8691	4515	4	10	99	0	4628
8692	81	4487	10	37	0	4615
8693	4550	63	12	29	0	4654
8694	4587	18	4	32	0	4641
8695	91	18	4573	21	0	4703
8696	27	10	4194	14	0	4245
8697	25	4263	52	8	0	4348
8698	30	66	38	4200	0	4334
8699	4218	14	34	64	0	4330
8700	45	11	3	4176	0	4235
8701	19	3	4	4279	0	4305
8702	11	4	4195	43	0	4253
8703	4108	3	35	24	0	4170
8704	39	7	10	4319	0	4375
8705	18	5	4236	40	0	4299
8706	27	7	4109	14	0	4157
8707	18	40	38	4231	0	4327
8708	15	4	4250	42	0	4311
8709	10	10	4155	13	0	4188
8710	18	12	34	3955	0	4019
8711	13	7	4258	36	0	4314
8712	13	0	38	4161	0	4212
8713	5	4052	18	36	0	4111
8714	4341	28	13	18	0	4400
8715	34	4348	9	17	0	4408
8716	16	38	3	4379	0	4436
8717	10	4402	4	49	0	4465
8718	6	42	4471	21	0	4540
8719	17	14	34	4937	0	5002
8720	8	17	5943	71	0	6039
8721	6108	13	120	31	0	6272
8722	133	6548	42	25	0	6748
8723	6724	141	38	21	0	6924
8724	183	46	20	6650	0	6899
8725	6723	33	18	160	0	6934
8726	192	19	6634	59	0	6904
8727	92	6653	135	37	0	6917
8728	6663	146	50	25	0	6884
8729	185	56	27	6424	0	6692
8730	77	6633	24	132	0	6866
8731	75	155	18	6709	0	6957
8732	6798	68	17	194	0	7077
8733	168	7331	17	69	0	7585
8734	7358	189	15	64	0	7626
8735	212	78	7161	32	0	7483
8736	7202	48	178	38	0	7466
8737	249	17	62	7219	0	7547
8738	7188	30	36	192	0	7446
8739	223	7078	22	68	0	7391
8740	122	174	18	7167	0	7481
8741	74	68	19	7328	0	7489
8742	48	43	6942	253	0	7286
8743	48	23	182	6954	0	7207
8744	49	28	67	7174	0	7318
8745	38	16	44	7207	0	7305
8746	49	9	24	7272	0	7354
8747	30	20	7048	304	0	7402
8748	30	6523	189	142	0	6884
8749	48	178	65	6684	0	6975
8750	6591	65	41	230	0	6927
8751	6665	42	31	125	0	6863
8752	244	6636	36	69	0	6985
8753	6599	200	29	58	0	6886
8754	6698	78	16	68	0	6860
8755	6671	45	19	67	0	6802
8756	299	6438	25	43	0	6805
8757	6388	184	16	51	0	6639
8758	268	96	24	6159	0	6547
8759	118	47	6109	198	0	6472
8760	76	5974	168	108	0	6326
8761	72	204	87	5907	0	6270
8762	50	79	5875	200	0	6204
8763	5823	44	177	102	0	6146
8764	197	46	70	5863	0	6176
8765	110	27	45	5929	0	6111
8766	63	40	24	5831	0	5958
8767	72	19	25	5869	0	5985
8768	53	25	5530	277	0	5885
8769	5319	28	164	142	0	5653
8770	179	5532	62	101	0	5874
8771	5580	163	28	81	0	5852
8772	208	5602	35	62	0	5907
8773	5697	196	32	49	0	5974
8774	231	82	26	5645	0	5984
8775	122	47	5581	197	0	5947
8776	70	46	5593	97	0	5806
8777	67	38	214	5533	0	5852
8778	56	28	94	5625	0	5803
8779	56	24	57	5702	0	5839
8780	5473	23	40	292	0	5828
8781	186	29	5473	139	0	5827
8782	105	30	167	5343	0	5645
8783	55	5449	78	239	0	5821
8784	5424	171	51	126	0	5772
8785	207	78	5332	77	0	5694
8786	99	5334	178	67	0	5678
8787	71	188	5360	59	0	5678
8788	81	82	188	5353	0	5704
8789	55	57	5309	215	0	5636
8790	62	44	5391	106	0	5603
8791	63	49	244	5296	0	5652
8792	56	39	5277	227	0	5599
8793	48	34	5363	114	0	5559
8794	66	29	243	5209	0	5547
8795	5097	35	119	229	0	5480
8796	202	28	5094	118	0	5442
8797	104	35	197	5047	0	5383
8798	67	29	102	5213	0	5411
8799	5010	32	74	272	0	5388
8800	210	27	50	5108	0	5395
8801	4987	24	62	258	0	5331
8802	219	4892	50	139	0	5300
8803	104	164	39	5058	0	5365
8804	4998	69	37	263	0	5367
8805	5118	37	40	137	0	5332
8806	265	32	48	5052	0	5397
8807	120	30	4945	241	0	5336
8808	4860	35	186	130	0	5211
8809	227	4930	90	84	0	5331
8810	4785	179	56	87	0	5107
8811	5057	81	43	75	0	5256
8812	5096	53	45	57	0	5251
8813	283	37	4817	67	0	5204
8814	137	4738	187	58	0	5120
8815	115	224	90	4657	0	5086
8816	80	110	54	4833	0	5077
8817	56	43	4630	256	0	4985
8818	48	4401	193	126	0	4768
8819	45	3873	63	95	0	4076
8820	28	3000	26	49	0	3103
8821	2422	93	163	31	0	2709
8822	85	41	15	2281	0	2422
8823	35	12	16	2284	0	2347
8824	19	14	2235	78	0	2346
8825	2170	10	53	34	0	2267
8826	75	12	17	2231	0	2335
8827	38	36	19	2241	0	2334
8828	27	14	2184	69	0	2294
8829	19	2148	65	23	0	2255
8830	23	92	22	2132	0	2269
8831	9	20	2136	69	0	2234
8832	12	1884	51	26	0	1973
8833	1442	25	11	19	0	1497
8834	20	3	1537	11	0	1571
8835	8	2	20	1459	0	1489
8836	6	1502	4	20	0	1532
8837	1514	16	3	7	0	1540
8838	18	8	7	1519	0	1552
8839	1538	2	1	24	0	1565
8840	1541	5	1	11	0	1558
8841	22	1541	4	5	0	1572
8842	1577	14	5	13	0	1609
8843	1630	4	4	5	0	1643
8844	21	1	1662	8	0	1692
8845	1640	5	18	11	0	1674
8846	20	3	1643	1	0	1667
8847	1636	4	14	4	0	1658
8848	1658	4	7	7	0	1676
8849	21	0	1696	2	0	1719
8850	5	3	16	1701	0	1725
8851	5	2	1745	17	0	1769
8852	4	5	1619	6	0	1634
8853	5	5	1732	3	0	1745
8854	6	3	12	1701	0	1722
8855	2	3	4	1811	0	1820
8856	5	0	5	1828	0	1838
8857	7	1	4	1845	0	1857
8858	3	4	1899	17	0	1923
8859	4	1	13	1903	0	1921
8860	4	1896	8	18	0	1926
8861	7	14	2082	5	0	2108
8862	10	3	23	2068	0	2104
8863	2	2	2180	27	0	2211
8864	1	2184	25	10	0	2220
8865	5	2224	9	3	0	2241
8866	4	28	3	2247	0	2282
8867	2	7	2238	23	0	2270
8868	3	8	2250	9	0	2270
8869	7	7	29	2259	0	2302
8870	4	0	8	2238	0	2250
8871	7	0	3	2292	0	2302
8872	4	0	2266	30	0	2300
8873	2	2190	25	13	0	2230
8874	3	2315	11	5	0	2334
8875	2	28	4	2339	0	2373
8876	4	6	2299	29	0	2338
8877	2	10	2262	8	0	2282
8878	0	2371	33	4	0	2408
8879	2373	29	12	9	0	2423
8880	22	2444	7	5	0	2478
8881	8	28	2547	0	0	2583
8882	2536	9	31	11	0	2587
8883	30	2	7	2684	0	2723
8884	2733	2	6	42	0	2783
8885	36	0	7	2775	0	2818
8886	14	3	5	2804	0	2826
8887	2824	5	2	53	0	2884
8888	31	2937	3	15	0	2986
8889	8	38	2944	8	0	2998
8890	3	2968	37	6	0	3014
8891	2958	35	14	8	0	3015
8892	32	2975	6	0	0	3013
8893	2959	37	4	8	0	3008
8894	2949	15	5	10	0	2979
8895	46	2983	9	12	0	3050
8896	23	36	1	2970	0	3030
8897	2968	12	4	41	0	3025
8898	2976	7	1	23	0	3007
8899	50	2	4	2937	0	2993
8900	20	3	2887	37	0	2947
8901	11	8	2896	13	0	2928
8902	12	11	39	2970	0	3032
8903	5	5	2926	41	0	2977
8904	2826	8	32	22	0	2888
8905	36	2900	15	7	0	2958
8906	19	35	6	2931	0	2991
8907	6	14	10	2958	0	2988
8908	9	11	4	2933	0	2957
8909	12	7	5	2901	0	2925
8910	12	6	5	2920	0	2943
8911	11	7	2879	45	0	2942
8912	10	2860	33	17	0	2920
8913	2905	38	15	9	0	2967
8914	35	13	7	2896	0	2951
8915	19	3	7	2915	0	2944
8916	12	6	5	2912	0	2935
8917	8	2879	7	51	0	2945
8918	14	37	8	2959	0	3018
8919	12	15	8	3000	0	3035
8920	2910	8	2	69	0	2989
8921	39	2814	8	29	0	2890
8922	19	2859	8	17	0	2903
8923	11	43	6	2899	0	2959
8924	2864	22	12	51	0	2949
8925	41	14	2877	21	0	2953
8926	2790	10	34	23	0	2857
8927	41	9	2988	18	0	3056
8928	19	9	37	2966	0	3031
8929	11	10	20	3054	0	3095
8930	11	13	5	3048	0	3077
8931	23	3	5	3044	0	3075
8932	12	8	11	3003	0	3034
8933	3000	8	6	63	0	3077
8934	41	15	2928	26	0	3010
8935	17	13	39	2966	0	3035
8936	10	7	3059	53	0	3129
8937	8	3064	38	32	0	3142
8938	3062	40	18	18	0	3138
8939	42	16	3144	20	0	3222
8940	22	9	38	3192	0	3261
8941	19	9	21	3254	0	3303
8942	9	14	3253	67	0	3343
8943	11	7	3258	33	0	3309
8944	21	8	56	3096	0	3181
8945	3288	7	23	60	0	3378
8946	3293	6	9	43	0	3351
8947	58	3265	11	26	0	3360
8948	3365	42	12	33	0	3452
8949	45	22	7	3265	0	3339
8950	27	3345	8	60	0	3440
8951	26	44	6	3407	0	3483
8952	12	24	3411	55	0	3502
8953	16	10	41	3321	0	3388
8954	15	7	21	3469	0	3512
8955	3383	9	15	64	0	3471
8956	49	3353	12	38	0	3452
8957	3337	41	12	21	0	3411
8958	53	3390	8	19	0	3470
8959	3250	47	8	24	0	3329
8960	44	3212	9	21	0	3286
8961	23	3156	9	19	0	3207
8962	3165	46	11	23	0	3245
8963	48	22	8	3081	0	3159
8964	25	3082	9	32	0	3148
8965	3143	36	2	29	0	3210
8966	3211	14	2	19	0	3246
8967	3264	8	6	19	0	3297
8968	3229	14	2	14	0	3259
8969	41	3253	4	23	0	3321
8970	23	29	10	3351	0	3413
8971	14	11	12	3410	0	3447
8972	3399	8	6	59	0	3472
8973	45	6	8	3397	0	3456
8974	3338	8	3	48	0	3397
8975	39	13	3227	20	0	3299
8976	3253	10	30	20	0	3313
8977	37	10	3368	13	0	3428
8978	24	21	28	3317	0	3390
8979	3348	7	16	35	0	3406
8980	33	3272	14	19	0	3338
8981	3173	31	5	16	0	3225
8982	36	3117	8	12	0	3173
8983	19	33	6	3314	0	3372
8984	9	12	3225	35	0	3281
8985	3005	9	35	30	0	3079
8986	29	3196	11	10	0	3246
8987	23	45	3	3179	0	3250
8988	12	6	4	3122	0	3144
8989	9	9	3	3115	0	3136
8990	9	4	3108	33	0	3154
8991	6	3098	25	12	0	3141
8992	3122	25	5	11	0	3163
8993	3128	10	2	14	0	3154
8994	28	3125	7	3	0	3163
8995	3272	20	9	28	0	3329
8996	30	12	2	3320	0	3364
8997	16	3286	4	21	0	3327
8998	3339	22	3	20	0	3384
8999	31	12	3256	5	0	3304
9000	18	3315	21	5	0	3359
9001	28	21	6	3361	0	3416
9002	8	19	4	3412	0	3443
9003	8	7	3336	31	0	3382
9004	12	5	22	3260	0	3299
9005	13	7	3322	25	0	3367
9006	12	4	19	3302	0	3337
9007	11	5	12	3337	0	3365
9008	11	7	5	3360	0	3383
9009	13	2	5	3371	0	3391
9010	10	5	3334	30	0	3379
9011	8	9	3295	15	0	3327
9012	13	3660	27	10	0	3710
9013	9	34	9	3952	0	4004
9014	13	16	4103	37	0	4169
9015	4	4128	46	19	0	4197
9016	20	50	16	4325	0	4411
9017	17	20	4486	56	0	4579
9018	4265	10	60	38	0	4373
9019	4739	8	22	19	0	4788
9020	86	8	9	4725	0	4828
9021	30	7	4722	69	0	4828
9022	25	5	63	4698	0	4791
9023	4736	5	27	83	0	4851
9024	72	4857	14	32	0	4975
9025	5010	64	5	31	0	5110
9026	5062	25	4	22	0	5113
9027	99	12	6	4914	0	5031
9028	56	8	7	4990	0	5061
9029	23	9	9	5023	0	5064
9030	17	8	11	5008	0	5044
9031	30	6	5	4943	0	4984
9032	4928	12	5	118	0	5063
9033	4986	10	5	63	0	5064
9034	4975	4	9	29	0	5017
9035	113	6	4756	24	0	4899
9036	4743	4	62	31	0	4840
9037	82	4	27	4799	0	4912
9038	43	5	4773	78	0	4899
9039	25	4644	66	51	0	4786
9040	33	55	27	4623	0	4738
9041	21	34	16	4638	0	4709
9042	16	4605	16	87	0	4724
9043	26	57	14	4739	0	4836
9044	9	28	4684	85	0	4806
9045	21	15	4758	39	0	4833
9046	18	13	99	4835	0	4965
9047	4777	9	52	110	0	4948
9048	4751	12	24	58	0	4845
9049	113	11	4715	36	0	4875
9050	50	4546	83	27	0	4706
9051	24	4702	48	20	0	4794
9052	4543	97	24	33	0	4697
9053	89	41	4620	20	0	4770
9054	51	17	83	4568	0	4719
9055	4575	13	40	100	0	4728
9056	92	4472	23	53	0	4640
9057	45	4626	18	28	0	4717
9058	4521	109	14	34	0	4678
9059	98	49	7	4576	0	4730
9060	4787	22	10	107	0	4926
9061	121	11	10	5314	0	5456
9062	63	9	16	5498	0	5586
9063	33	19	5479	165	0	5696
9064	40	12	112	5740	0	5904
9065	28	16	38	5884	0	5966
9066	5808	17	27	200	0	6052
9067	160	12	11	5961	0	6144
9068	66	15	5934	186	0	6201
9069	5892	9	139	97	0	6137
9070	151	9	60	6054	0	6274
9071	6021	9	32	189	0	6251
9072	165	5759	26	93	0	6043
9073	73	6083	18	62	0	6236
9074	6021	172	16	69	0	6278
9075	6135	74	19	46	0	6274
9076	213	34	17	5977	0	6241
9077	98	22	5916	164	0	6200
9078	78	16	147	5993	0	6234
9079	5925	19	68	192	0	6204
9080	159	5884	39	87	0	6169
9081	102	147	20	5917	0	6186
9082	5870	79	14	181	0	6144
9083	178	43	5679	86	0	5986
9084	5798	29	143	49	0	6019
9085	5530	30	73	83	0	5716
9086	213	20	5753	35	0	6021
9087	100	22	5793	50	0	5965
9088	68	14	199	5663	0	5944
9089	58	22	91	5775	0	5946
9090	39	5740	50	215	0	6044
9091	62	142	25	5865	0	6094
9092	49	68	5877	188	0	6182
9093	52	40	154	5956	0	6202
9094	60	16	83	6211	0	6370
9095	53	8	5887	243	0	6191
9096	29	5815	183	127	0	6154
9097	39	145	82	5890	0	6156
9098	38	63	45	6024	0	6170
9099	5857	40	36	243	0	6176
9100	180	32	23	5887	0	6122
9101	76	19	5738	220	0	6053
9102	5664	25	164	127	0	5980
9103	5877	22	80	79	0	6058
9104	5932	14	44	73	0	6063
9105	246	20	5688	50	0	6004
9106	120	21	155	5699	0	5995
9107	61	20	77	5832	0	5990
9108	64	18	50	5910	0	6042
9109	5667	20	33	272	0	5992
9110	176	5609	36	148	0	5969
9111	109	140	5450	86	0	5785
9112	61	5372	165	59	0	5657
9113	49	5165	70	64	0	5348
9114	38	5027	40	59	0	5164
9115	83	214	53	4826	0	5176
9116	42	72	4742	154	0	5010
9117	4327	47	120	94	0	4588
9118	131	4571	63	63	0	4828
9119	4356	111	25	53	0	4545
9120	119	4500	26	44	0	4689
9121	4531	122	23	48	0	4724
9122	132	4579	17	41	0	4769
9123	78	134	4566	30	0	4808
9124	52	62	106	4456	0	4676
9125	36	44	52	4634	0	4766
9126	4550	23	40	156	0	4769
9127	137	22	17	4787	0	4963
9128	75	25	4704	149	0	4953
9129	48	32	113	4782	0	4975
9130	37	31	4788	146	0	5002
9131	39	4754	125	86	0	5004
9132	53	107	57	4591	0	4808
9133	39	4814	36	123	0	5012
9134	4809	121	38	74	0	5042
9135	126	62	35	4813	0	5036
9136	66	30	4785	154	0	5035
9137	45	37	4737	78	0	4897
9138	4669	30	145	62	0	4906
9139	123	22	78	4750	0	4973
9140	56	31	4688	137	0	4912
9141	39	22	4557	81	0	4699
9142	31	4591	154	63	0	4839
9143	33	138	78	4328	0	4577
9144	21	4523	49	122	0	4715
9145	29	106	33	4481	0	4649
9146	4476	50	32	140	0	4698
9147	113	24	32	4553	0	4722
9148	52	29	28	4636	0	4745
9149	4558	19	29	165	0	4771
9150	120	16	30	4867	0	5033
9151	61	23	23	4860	0	4967
9152	41	4870	29	171	0	5111
9153	4907	104	32	87	0	5130
9154	5008	53	22	73	0	5156
9155	159	25	24	4979	0	5187
9156	83	23	16	5026	0	5148
9157	54	22	16	4994	0	5086
9158	37	4672	23	194	0	4926
9159	33	4869	27	92	0	5021
9160	66	152	18	4629	0	4865
9161	3973	44	9	103	0	4129
9162	3920	24	13	67	0	4024
9163	105	3756	15	43	0	3919
9164	3480	62	9	43	0	3594
9165	63	3415	18	23	0	3519
9166	34	3385	5	30	0	3454
9167	81	113	12	3129	0	3335
9168	3072	26	7	66	0	3171
9169	50	2972	9	35	0	3066
9170	25	2997	11	18	0	3051
9171	25	55	6	2954	0	3040
9172	20	27	6	2991	0	3044
9173	21	21	2919	56	0	3017
9174	2844	21	40	26	0	2931
9175	2792	21	13	36	0	2862
9176	49	22	2910	22	0	3003
9177	27	19	2864	17	0	2927
9178	19	17	48	2952	0	3036
9179	17	16	20	3012	0	3065
9180	18	2984	11	66	0	3079
9181	20	50	10	3047	0	3127
9182	15	27	3029	62	0	3133
9183	17	18	57	2983	0	3075
9184	19	19	19	3012	0	3069
9185	2953	10	19	96	0	3078
9186	58	15	2910	35	0	3018
9187	2806	12	48	49	0	2915
9188	60	16	2819	22	0	2917
9189	34	13	55	2789	0	2891
9190	14	13	2784	75	0	2886
9191	19	11	2789	41	0	2860
9192	34	23	61	2690	0	2808
9193	2544	29	38	79	0	2690
9194	2463	12	20	37	0	2532
9195	53	2517	24	31	0	2625
9196	2498	39	18	32	0	2587
9197	2506	15	24	27	0	2572
9198	63	2480	14	29	0	2586
9199	33	51	17	2521	0	2622
9200	32	19	19	2550	0	2620
9201	20	19	18	2538	0	2595
9202	25	11	11	2560	0	2607
9203	25	16	2506	68	0	2615
9204	2459	22	44	39	0	2564
9205	56	17	12	2524	0	2609
9206	38	8	16	2507	0	2569
9207	19	2510	12	71	0	2612
9208	26	45	8	2563	0	2642
9209	24	25	2471	67	0	2587
9210	2479	20	41	47	0	2587
9211	49	21	2579	38	0	2687
9212	29	13	44	2504	0	2590
9213	2501	11	17	79	0	2608
9214	48	2552	8	47	0	2655
9215	23	50	17	2655	0	2745
9216	23	23	2629	63	0	2738
9217	24	15	51	2646	0	2736
9218	2583	12	25	78	0	2698
9219	66	10	2581	35	0	2692
9220	36	22	2440	26	0	2524
9221	23	2412	61	28	0	2524
9222	2341	52	46	20	0	2459
9223	53	2315	20	26	0	2414
9224	28	53	2299	28	0	2408
9225	17	21	2201	28	0	2267
9226	16	2190	56	20	0	2282
9227	1933	45	38	17	0	2033
9228	38	1943	14	14	0	2009
9229	17	39	12	1902	0	1970
9230	14	11	15	1938	0	1978
9231	12	16	1915	44	0	1987
9232	8	8	48	1917	0	1981
9233	10	8	1899	47	0	1964
9234	1848	14	43	25	0	1930
9235	1919	5	16	21	0	1961
9236	1922	12	14	15	0	1963
9237	51	6	1867	12	0	1936
9238	1888	9	43	16	0	1956
9239	44	8	17	1821	0	1890
9240	22	1861	14	40	0	1937
9241	1853	40	5	27	0	1925
9242	45	12	1778	20	0	1855
9243	1810	7	42	20	0	1879
9244	1799	1	21	13	0	1834
9245	46	3	1736	19	0	1804
9246	25	1711	42	18	0	1796
9247	26	53	21	1703	0	1803
9248	17	14	1696	38	0	1765
9249	25	8	1637	14	0	1684
9250	17	49	40	1302	0	1408
9251	14	0	1320	20	0	1354
9252	7	4	26	1255	0	1292
9253	10	7	11	1211	0	1239
9254	8	4	9	1268	0	1289
9255	6	5	1243	31	0	1285
9256	6	6	22	1239	0	1273
9257	6	1	1260	31	0	1298
9258	6	8	33	1244	0	1291
9259	1276	3	10	37	0	1326
9260	26	2	8	1292	0	1328
9261	5	1322	13	26	0	1366
9262	9	22	11	1395	0	1437
9263	1424	8	3	36	0	1471
9264	27	1474	12	13	0	1526
9265	10	26	7	1485	0	1528
9266	1498	7	12	33	0	1550
9267	28	10	1489	17	0	1544
9268	10	8	31	1497	0	1546
9269	18	5	1494	37	0	1554
9270	4	5	1500	13	0	1522
9271	6	3	35	1485	0	1529
9272	1474	1	17	38	0	1530
9273	28	2	1452	11	0	1493
9274	1441	3	29	14	0	1487
9275	37	4	11	1509	0	1561
9276	15	4	1543	26	0	1588
9277	11	2	1511	9	0	1533
9278	10	3	1533	14	0	1560
9279	6	9	43	1415	0	1473
9280	1451	4	16	28	0	1499
9281	24	1440	12	10	0	1486
9282	5	23	5	1422	0	1455
9283	9	4	3	1450	0	1466
9284	1459	8	4	26	0	1497
9285	1478	2	4	14	0	1498
9286	24	1453	9	9	0	1495
9287	1480	20	5	8	0	1513
9288	1502	7	6	4	0	1519
9289	30	4	8	1484	0	1526
9290	12	4	1475	22	0	1513
9291	1469	5	28	8	0	1510
9292	30	2	4	1503	0	1539
9293	6	3	9	1517	0	1535
9294	1508	0	3	31	0	1542
9295	27	2	6	1476	0	1511
9296	8	5	3	1511	0	1527
9297	1489	1	3	32	0	1525
9298	27	1504	1	12	0	1544
9299	1495	19	3	15	0	1532
9300	30	4	1486	5	0	1525
9301	1470	6	24	7	0	1507
9302	29	2	6	1496	0	1533
9303	8	1522	9	22	0	1561
9304	12	21	2	1545	0	1580
9305	8	3	2	1551	0	1564
9306	11	4	3	1564	0	1582
9307	1526	2	5	37	0	1570
9308	26	1491	1	16	0	1534
9309	6	1509	6	8	0	1529
9310	1478	27	1	5	0	1511
9311	25	5	1529	5	0	1564
9312	5	7	1504	6	0	1522
9313	1414	16	40	6	0	1476
9314	21	2	1456	4	0	1483
9315	4	0	19	1383	0	1406
9316	12	0	7	1320	0	1339
9317	4	0	5	1437	0	1446
9318	6	1	1	1435	0	1443
9319	3	1369	4	25	0	1401
9320	4	17	3	1471	0	1495
9321	2	2	1439	25	0	1468
9322	1	3	20	1438	0	1462
9323	0	2	1419	26	0	1447
9324	4	2	1399	7	0	1412
9325	2	3	22	1439	0	1466
9326	2	1	1453	27	0	1483
9327	6	4	22	1432	0	1464
9328	1452	2	6	28	0	1488
9329	21	3	1469	7	0	1500
9330	1416	1	21	12	0	1450
9331	29	0	6	1463	0	1498
9332	7	1	1463	23	0	1494
9333	5	1449	25	6	0	1485
9334	9	19	6	1498	0	1532
9335	4	5	1543	25	0	1577
9336	7	2	24	1536	0	1569
9337	1585	1	6	32	0	1624
9338	1604	1	4	7	0	1616
9339	1619	1	4	13	0	1637
9340	30	1	3	1627	0	1661
9341	11	3	1	1661	0	1676
9342	10	3	2	1706	0	1721
9343	1748	0	5	36	0	1789
9344	27	1785	4	12	0	1828
9345	14	23	2	1809	0	1848
9346	13	5	1	1866	0	1885
9347	1844	6	2	41	0	1893
9348	33	1884	3	18	0	1938
9349	12	27	0	2039	0	2078
9350	2037	8	1	48	0	2094
9351	2047	6	3	12	0	2068
9352	49	6	1	2033	0	2089
9353	2049	1	2	55	0	2107
9354	58	2	3	2039	0	2102
9355	12	3	2094	48	0	2157
9356	14	3	42	2080	0	2139
9357	10	0	9	2149	0	2168
9358	11	0	9	2163	0	2183
9359	2063	2	5	60	0	2130
9360	47	2049	5	21	0	2122
9361	2017	42	9	15	0	2083
9362	49	1948	5	10	0	2012
9363	8	2013	3	7	0	2031
9364	1977	48	1	15	0	2041
9365	44	2017	2	10	0	2073
9366	17	42	4	2025	0	2088
9367	2000	11	1	48	0	2060
9368	2040	7	2	16	0	2065
9369	49	3	3	2017	0	2072
9370	19	4	1	2025	0	2049
9371	7	2021	3	45	0	2076
9372	2060	39	1	23	0	2123
9373	2058	8	1	25	0	2092
9374	46	2137	3	10	0	2196
9375	14	2181	0	9	0	2204
9376	12	43	0	2165	0	2220
9377	2141	15	2	53	0	2211
9378	47	11	1	2132	0	2191
9379	23	6	2	2180	0	2211
9380	10	7	2129	54	0	2200
9381	7	8	2117	23	0	2155
9382	15	4	49	2106	0	2174
9383	8	5	2123	51	0	2187
9384	8	2089	46	21	0	2164
9385	14	43	9	2099	0	2165
9386	9	11	6	2135	0	2161
9387	11	8	6	2151	0	2176
9388	10	8	2110	57	0	2185
9389	3	9	2075	26	0	2113
9390	2060	8	51	22	0	2141
9391	48	2096	15	20	0	2179
9392	2128	44	6	9	0	2187
9393	49	11	5	2122	0	2187
9394	2158	8	4	55	0	2225
9395	49	6	3	2167	0	2225
9396	23	2156	5	44	0	2228
9397	2187	44	3	15	0	2249
9398	47	12	2139	14	0	2212
9399	16	2154	40	10	0	2220
9400	2138	44	9	17	0	2208
9401	45	14	6	2108	0	2173
9402	16	2065	5	44	0	2130
9403	12	42	5	2166	0	2225
9404	2147	12	8	59	0	2226
9405	53	7	5	2165	0	2230
9406	2160	9	6	57	0	2232
9407	54	12	2131	16	0	2213
9408	20	6	41	2138	0	2205
9409	2120	4	9	60	0	2193
9410	50	7	2095	20	0	2172
9411	9	2017	49	26	0	2101
9412	21	41	11	1985	0	2058
9413	10	9	2008	50	0	2077
9414	9	8	1973	21	0	2011
9415	13	9	51	1999	0	2072
9416	5	7	1974	48	0	2034
9417	10	7	1959	21	0	1997
9418	10	8	45	1917	0	1980
9419	1962	8	10	51	0	2031
9420	45	6	9	1973	0	2033
9421	20	7	6	2052	0	2085
9422	16	11	2033	47	0	2107
9423	13	7	42	2092	0	2154
9424	2149	7	4	54	0	2214
9425	46	5	2110	17	0	2178
9426	14	2107	38	13	0	2172
9427	16	37	8	2155	0	2216
9428	2119	9	8	50	0	2186
9429	50	8	7	2090	0	2155
9430	11	2094	14	50	0	2169
9431	12	42	2115	14	0	2183
9432	13	9	37	2158	0	2217
9433	2271	8	9	52	0	2340
9434	48	9	2221	11	0	2289
9435	17	8	43	2367	0	2435
9436	2477	7	8	70	0	2562
9437	2714	4	10	23	0	2751
9438	71	2755	8	21	0	2855
9439	2753	62	9	15	0	2839
9440	86	9	8	2779	0	2882
9441	19	12	2794	75	0	2900
9442	18	2681	68	32	0	2799
9443	10	2767	20	18	0	2815
9444	15	76	16	2680	0	2787
9445	9	32	14	2734	0	2789
9446	3	18	2641	69	0	2731
9447	6	2589	54	32	0	2681
9448	6	2599	19	24	0	2648
9449	18	64	16	2456	0	2554
9450	2415	19	7	59	0	2500
9451	43	2456	9	17	0	2525
9452	17	47	6	2502	0	2572
9453	2599	14	3	54	0	2670
9454	49	13	2	2610	0	2674
9455	21	5	4	2576	0	2606
9456	21	4	3	2585	0	2613
9457	12	5	6	2594	0	2617
9458	2535	9	2	67	0	2613
9459	54	6	5	2547	0	2612
9460	24	7	2495	54	0	2580
9461	2468	5	42	29	0	2544
9462	52	6	2484	19	0	2561
9463	24	7	2474	9	0	2514
9464	19	5	57	2488	0	2569
9465	19	4	15	2510	0	2548
9466	10	3	15	2537	0	2565
9467	2514	6	6	73	0	2599
9468	53	6	2480	34	0	2573
9469	2498	2	50	26	0	2576
9470	2575	4	21	18	0	2618
9471	65	7	2525	13	0	2610
9472	2536	5	48	17	0	2606
9473	55	7	2588	14	0	2664
9474	20	2544	50	12	0	2626
9475	15	62	25	2524	0	2626
9476	13	15	11	2581	0	2620
9477	17	9	4	2580	0	2610
9478	11	3	11	2541	0	2566
9479	10	3	2526	63	0	2602
9480	5	9	2518	29	0	2561
9481	11	5	51	2536	0	2603
9482	7	4	2564	51	0	2626
9483	2482	5	51	27	0	2565
9484	2631	6	18	22	0	2677
9485	52	6	10	2624	0	2692
9486	2616	5	7	54	0	2682
9487	46	2701	9	22	0	2778
9488	2708	38	9	26	0	2781
9489	51	13	2718	14	0	2796
9490	29	8	41	2696	0	2774
9491	12	2733	18	51	0	2814
9492	2802	42	11	24	0	2879
9493	49	14	5	2828	0	2896
9494	21	10	2794	52	0	2877
9495	21	5	45	2770	0	2841
9496	2794	6	20	53	0	2873
9497	47	8	2799	23	0	2877
9498	27	8	43	2811	0	2889
9499	21	3	21	2857	0	2902
9500	12	8	2852	59	0	2931
9501	16	2768	45	35	0	2864
9502	30	2339	33	35	0	2437
9503	17	51	14	2872	0	2954
9504	23	23	8	2969	0	3023
9505	14	12	10	2980	0	3016
9506	2936	12	11	68	0	3027
9507	2953	18	14	32	0	3017
9508	56	15	11	2974	0	3056
9509	2957	10	13	61	0	3041
9510	45	2959	11	39	0	3054
9511	17	47	11	3037	0	3112
9512	25	19	10	3050	0	3104
9513	10	17	8	3078	0	3113
9514	2963	14	6	78	0	3061
9515	44	2912	7	50	0	3013
9516	31	41	12	2996	0	3080
9517	2969	22	6	67	0	3064
9518	53	13	10	3013	0	3089
9519	33	10	7	2972	0	3022
9520	28	2805	9	74	0	2916
9521	20	2883	7	49	0	2959
9522	14	52	9	2901	0	2976
9523	25	18	4	2884	0	2931
9524	2777	7	13	80	0	2877
9525	52	4	9	2818	0	2883
9526	34	10	2788	57	0	2889
9527	18	13	44	2782	0	2857
9528	16	2768	20	68	0	2872
9529	2891	37	16	50	0	2994
9530	46	22	12	2904	0	2984
9531	36	11	9	2904	0	2960
9532	20	2844	12	76	0	2952
9533	2770	35	14	41	0	2860
9534	45	2821	6	30	0	2902
9535	36	44	7	2731	0	2818
9536	19	13	2624	44	0	2700
9537	11	46	27	2379	0	2463
9538	2350	2	25	35	0	2412
9539	22	2395	1	20	0	2438
9540	16	27	0	2367	0	2410
9541	13	2351	1	23	0	2388
9542	6	20	2	2426	0	2454
9543	4	13	2373	35	0	2425
9544	10	27	19	2347	0	2403
9545	10	4	12	2378	0	2404
9546	2	13	3	2402	0	2420
9547	2329	5	0	51	0	2385
9548	2363	6	9	29	0	2407
9549	40	2398	3	19	0	2460
9550	2408	25	4	13	0	2450
9551	25	2352	5	11	0	2393
9552	16	2403	2	16	0	2437
9553	2289	44	0	7	0	2340
9554	26	16	2244	17	0	2303
9555	12	10	29	2249	0	2300
9556	6	6	12	2317	0	2341
9557	5	7	6	2350	0	2368
9558	2287	5	3	51	0	2346
9559	30	2248	5	25	0	2308
9560	22	26	2	2285	0	2335
9561	6	2260	6	32	0	2304
9562	2354	24	3	24	0	2405
9563	35	22	0	2344	0	2401
9564	22	17	0	2742	0	2781
9565	15	3129	2	61	0	3207
9566	12	57	8	3444	0	3521
9567	8	24	1	3500	0	3533
9568	3365	10	6	105	0	3486
9569	67	3261	7	52	0	3387
9570	33	3444	4	25	0	3506
9571	20	87	0	3397	0	3504
9572	15	36	3267	88	0	3406
9573	14	31	3233	38	0	3316
9574	23	18	82	3248	0	3371
9575	8	14	3213	88	0	3323
9576	8	14	76	3266	0	3364
9577	19	23	28	3141	0	3211
9578	11	11	19	3352	0	3393
9579	3214	9	20	125	0	3368
9580	82	6	15	3254	0	3357
9581	30	14	10	3253	0	3307
9582	16	3133	16	109	0	3274
9583	17	68	3	3282	0	3370
9584	10	34	3148	101	0	3293
9585	11	17	73	3211	0	3312
9586	22	10	31	3260	0	3323
9587	3023	8	25	126	0	3182
9588	78	4	15	3086	0	3183
9589	32	18	12	3077	0	3139
9590	17	10	9	3130	0	3166
9591	2890	10	14	132	0	3046
9592	73	2895	5	84	0	3057
9593	42	65	9	2968	0	3084
9594	28	37	3	3006	0	3074
9595	10	18	2873	141	0	3042
9596	16	11	72	2941	0	3040
9597	2759	13	26	130	0	2928
9598	72	2816	17	69	0	2974
9599	36	77	10	2825	0	2948
9600	25	36	10	2881	0	2952
9601	9	17	2755	136	0	2917
9602	2664	11	77	71	0	2823
9603	73	2719	24	55	0	2871
9604	2680	77	19	42	0	2818
9605	79	40	11	2717	0	2847
9606	37	17	8	2768	0	2830
9607	26	18	14	2771	0	2829
9608	21	14	15	2787	0	2837
9609	2682	8	8	131	0	2829
9610	75	22	16	2617	0	2730
9611	42	2545	10	108	0	2705
9612	27	73	10	2648	0	2758
9613	23	23	17	2725	0	2788
9614	2610	12	13	138	0	2773
9615	74	2587	11	83	0	2755
9616	43	69	9	2684	0	2805
9617	2618	33	2	118	0	2771
9618	2693	25	3	66	0	2787
9619	93	7	4	2696	0	2800
9620	41	19	2571	114	0	2745
9621	2641	13	59	64	0	2777
9622	87	20	26	2688	0	2821
9623	41	13	2651	107	0	2812
9624	32	14	72	2732	0	2850
9625	29	7	36	2769	0	2841
9626	25	7	15	2717	0	2764
9627	23	2660	20	132	0	2835
9628	29	66	11	2731	0	2837
9629	25	30	12	2743	0	2810
9630	27	17	16	2748	0	2808
9631	20	14	9	2764	0	2807
9632	19	8	11	2727	0	2765
9633	20	18	9	2730	0	2777
9634	2501	16	14	144	0	2675
9635	70	10	2415	96	0	2591
9636	28	2385	68	66	0	2547
9637	2366	58	22	63	0	2509
9638	65	2357	10	67	0	2499
9639	2307	62	18	53	0	2440
9640	78	23	17	2302	0	2420
9641	2322	15	8	95	0	2440
9642	69	13	13	2320	0	2415
9643	46	19	9	2288	0	2362
9644	30	2259	9	96	0	2394
9645	2312	63	3	64	0	2442
9646	77	17	2295	51	0	2440
9647	33	17	43	2350	0	2443
9648	31	9	2301	87	0	2428
9649	21	16	2229	52	0	2318
9650	2272	15	64	41	0	2392
9651	60	23	19	2311	0	2413
9652	38	7	2258	82	0	2385
9653	20	18	2326	47	0	2411
9654	30	6	59	2344	0	2439
9655	23	12	36	2393	0	2464
9656	2376	11	25	92	0	2504
9657	71	8	18	2417	0	2514
9658	28	9	2455	94	0	2586
9659	31	9	61	2500	0	2601
9660	20	25	29	2476	0	2550
9661	17	2484	28	95	0	2624
9662	2422	45	18	67	0	2552
9663	57	2408	15	53	0	2533
9664	2031	32	12	34	0	2109
9665	29	1568	6	13	0	1616
9666	4	1373	11	15	0	1403
9667	13	13	23	1333	0	1382
9668	12	9	8	1320	0	1349
9669	9	7	2	1296	0	1314
9670	1261	6	2	8	0	1277
9671	4	5	1249	7	0	1265
9672	6	3	3	1244	0	1256
9673	1230	2	2	8	0	1242
9674	4	1223	1	5	0	1233
9675	0	1227	2	8	0	1237
9676	8	8	1	1254	0	1271
9677	2	1	4	1272	0	1279
9678	4	2	2	1261	0	1269
9679	4	1289	4	4	0	1301
9680	2	2	2	1295	0	1301
9681	5	1	1279	4	0	1289
9682	2	3	1194	4	0	1203
9683	1234	3	2	5	0	1244
9684	4	1	1	1290	0	1296
9685	1289	1	1	12	0	1303
9686	1280	2	0	6	0	1288
9687	4	1314	1	1	0	1320
9688	1355	3	3	6	0	1367
9689	1434	1	3	8	0	1446
9690	3	1	3	1447	0	1454
9691	5	0	2	1468	0	1475
9692	3	1	1505	6	0	1515
9693	2	1537	3	4	0	1546
9694	16	3	1	1419	0	1439
9695	1	1	2	1563	0	1567
9696	1575	2	1	9	0	1587
9697	8	1	0	1574	0	1583
9698	1575	2	1	10	0	1588
9699	3	1	1	1603	0	1608
9700	1	1611	4	5	0	1621
9701	1671	7	1	6	0	1685
9702	8	1	1	1847	0	1857
9703	2	1	1	1984	0	1988
9704	6	2	0	2075	0	2083
9705	2	18	2073	25	0	2118
9706	8	1	20	2104	0	2133
9707	2143	0	5	32	0	2180
9708	26	3	3	2245	0	2277
9709	12	2	0	2570	0	2584
9710	8	0	1	2578	0	2587
9711	0	2539	2	54	0	2595
9712	3	2681	2	18	0	2704
9713	2677	52	2	19	0	2750
9714	44	2691	3	20	0	2758
9715	2711	45	1	11	0	2768
9716	2721	12	1	10	0	2744
9717	2745	6	0	11	0	2762
9718	56	3	2696	5	0	2760
9719	15	2708	38	5	0	2766
9720	2744	43	8	19	0	2814
9721	52	13	4	2778	0	2847
9722	24	6	3	2811	0	2844
9723	11	3	1	2804	0	2819
9724	3	2739	1	59	0	2802
9725	19	49	0	2752	0	2820
9726	2754	10	0	60	0	2824
9727	57	10	0	2732	0	2799
9728	24	6	3	2776	0	2809
9729	14	6	2746	58	0	2824
9730	16	6	2786	17	0	2825
9731	13	16	52	2815	0	2896
9732	19	4	14	2854	0	2891
9733	9	2862	7	61	0	2939
9734	8	51	4	2847	0	2910
9735	12	15	4	2903	0	2934
9736	11	7	1	2919	0	2938
9737	2855	7	3	80	0	2945
9738	52	5	2863	33	0	2953
9739	21	8	46	2887	0	2962
9740	2905	6	16	64	0	2991
9741	2894	0	5	35	0	2934
9742	66	2	4	2851	0	2923
9743	26	5	9	2888	0	2928
9744	2820	8	5	79	0	2912
9745	52	2791	7	31	0	2881
9746	15	2857	6	27	0	2905
9747	17	63	4	2870	0	2954
9748	2888	23	4	72	0	2987
9749	2934	12	5	31	0	2982
9750	2920	8	1	33	0	2962
9751	75	6	2899	16	0	2996
9752	2806	11	49	26	0	2892
9753	66	9	2829	20	0	2924
9754	2764	5	52	23	0	2844
9755	60	2781	20	22	0	2883
9756	23	51	2809	30	0	2913
9757	22	19	48	2835	0	2924
9758	13	16	2833	74	0	2936
9759	16	11	50	2834	0	2911
9760	2834	12	14	74	0	2934
9761	59	7	2838	35	0	2939
9762	27	10	47	2854	0	2938
9763	25	2894	20	63	0	3002
9764	20	50	21	3025	0	3116
9765	24	16	10	3030	0	3080
9766	20	13	16	2911	0	2960
9767	2951	11	13	80	0	3055
9768	2986	9	8	48	0	3051
9769	69	10	11	2986	0	3076
9770	24	17	2901	79	0	3021
9771	24	19	2887	34	0	2964
9772	18	11	65	2990	0	3084
9773	26	14	3129	68	0	3237
9774	29	11	57	3134	0	3231
9775	29	5	18	3071	0	3123
9776	22	11	13	3155	0	3201
9777	22	2995	17	83	0	3117
9778	30	2967	15	35	0	3047
9779	21	66	6	3170	0	3263
9780	19	29	12	3174	0	3234
9781	18	13	11	3188	0	3230
9782	3139	8	6	94	0	3247
9783	61	13	3188	51	0	3313
9784	30	11	56	3231	0	3328
9785	3230	4	21	86	0	3341
9786	59	3270	23	38	0	3390
9787	27	46	15	3389	0	3477
9788	24	17	12	3431	0	3484
9789	12	18	17	3361	0	3408
9790	16	5	11	3351	0	3383
9791	13	12	3291	98	0	3414
9792	3138	9	53	50	0	3250
9793	3339	15	18	45	0	3417
9794	63	7	3388	35	0	3493
9795	3384	5	49	42	0	3480
9796	3496	11	23	28	0	3558
9797	68	11	3508	29	0	3616
9798	31	3606	54	31	0	3722
9799	26	48	20	3654	0	3748
9800	24	11	3715	75	0	3825
9801	19	3661	48	40	0	3768
9802	25	37	3493	27	0	3582
9803	13	3380	34	31	0	3458
9804	13	45	29	3344	0	3431
9805	16	12	3370	47	0	3445
9806	28	8	31	3318	0	3385
9807	14	4	3520	38	0	3576
9808	16	3463	27	23	0	3529
9809	3199	9	13	10	0	3231
9810	10	3180	4	7	0	3201
9811	4	3432	0	12	0	3448
9812	18	20	5	3436	0	3479
9813	13	0	1	3491	0	3505
9814	2	1	2	3468	0	3473
9815	4	3	0	3424	0	3431
9816	4	1	1	3525	0	3531
9817	3	6	3902	6	0	3917
9818	9	2	6	3808	0	3825
9819	5	4	1	3976	0	3986
9820	4063	0	2	20	0	4085
9821	4063	3	1	14	0	4081
9822	4114	1	0	6	0	4121
9823	11	2	2	4144	0	4159
9824	4515	2	3	20	0	4540
9825	4907	0	0	19	0	4926
9826	5084	1	1	27	0	5113
9827	46	5	5116	4	0	5171
9828	5094	2	40	13	0	5149
9829	5345	0	8	18	0	5371
9830	5408	0	5	9	0	5422
9831	54	0	2	5392	0	5448
9832	19	6	5425	39	0	5489
9833	15	2	35	5412	0	5464
9834	5632	1	9	56	0	5698
9835	47	5	6	5777	0	5835
9836	12	6044	2	43	0	6101
9837	22	31	0	6261	0	6314
9838	6283	7	0	57	0	6347
9839	6344	5	4	24	0	6377
9840	6321	0	3	20	0	6344
9841	67	4	6490	0	0	6561
9842	33	1	43	6461	0	6538
9843	16	2	13	6694	0	6725
9844	5	3	6677	61	0	6746
9845	3	6508	47	21	0	6579
9846	10	48	6538	8	0	6604
9847	18	13	49	6650	0	6730
9848	6717	8	18	57	0	6800
9849	53	4	7068	18	0	7143
9850	29	0	47	7079	0	7155
9851	14	2	7183	48	0	7247
9852	7103	6	51	21	0	7181
9853	55	4	19	7360	0	7438
9854	18	4	7749	54	0	7825
9855	28	1	45	7613	0	7687
9856	7	3	7893	61	0	7964
9857	8	7884	63	21	0	7976
9858	16	51	15	7979	0	8061
9859	8096	13	17	71	0	8197
9860	66	8	5	8125	0	8204
9861	35	0	8	8103	0	8146
9862	8086	1	15	80	0	8182
9863	59	7820	17	35	0	7931
9864	25	8008	12	19	0	8064
9865	27	63	2	8097	0	8189
9866	11	8066	9	57	0	8143
9867	13	58	6	8200	0	8277
9868	17	14	9	8220	0	8260
9869	8239	13	7	84	0	8343
9870	61	8171	9	38	0	8279
9871	33	57	8115	19	0	8224
9872	22	8408	45	18	0	8493
9873	8412	63	17	37	0	8529
9874	8621	16	12	31	0	8680
9875	87	13	8	8617	0	8725
9876	8901	9	9	81	0	9000
9877	95	10	7	8895	0	9007
9878	8961	5	9	111	0	9086
9879	9130	6	7	52	0	9195
9880	99	6	6	9508	0	9619
9881	9626	4	15	103	0	9748
9882	88	13	9615	35	0	9751
9883	9453	8	76	41	0	9578
9884	102	8	26	9712	0	9848
9885	9816	5	16	106	0	9943
9886	98	9834	20	30	0	9982
9887	44	73	9	9907	0	10033
9888	44	22	15	9893	0	9974
9889	9877	15	12	121	0	10025
9890	93	14	9766	52	0	9925
9891	48	9728	78	44	0	9898
9892	38	78	28	9933	0	10077
9893	35	9781	23	83	0	9922
9894	35	77	9	9968	0	10089
9895	42	24	13	9754	0	9833
9896	38	20	8	9986	0	10052
9897	9876	8	11	135	0	10030
9898	96	20	8	9794	0	9918
9899	9933	17	9	146	0	10105
9900	9943	11	12	80	0	10046
9901	117	14	11	10123	0	10265
9902	10107	12	15	126	0	10260
9903	9964	14	19	81	0	10078
9904	116	17	10083	39	0	10255
9905	61	11	79	9820	0	9971
9906	10136	12	28	115	0	10291
9907	86	9982	28	46	0	10142
9908	10088	81	14	60	0	10243
9909	10077	26	11	61	0	10175
9910	117	27	9884	27	0	10055
9911	81	10	83	9457	0	9631
9912	10185	9	31	156	0	10381
9913	125	9	21	10329	0	10484
9914	56	8	19	10387	0	10470
9915	61	10	17	10425	0	10513
9916	47	8	20	10770	0	10845
9917	10577	12	23	184	0	10796
9918	149	16	10722	71	0	10958
9919	89	32	137	11011	0	11269
9920	46	20	11957	165	0	12188
9921	37	27	12693	77	0	12834
9922	12720	9	376	86	0	13191
9923	336	26	14132	36	0	14530
9924	159	13876	365	40	0	14440
9925	14044	333	224	92	0	14693
9926	14420	157	78	64	0	14719
9927	530	60	40	13977	0	14607
9928	235	34	14173	331	0	14773
9929	110	49	13879	173	0	14211
9930	14214	18	484	94	0	14810
9931	403	25	210	14489	0	15127
9932	14680	10	99	384	0	15173
9933	406	14797	72	186	0	15461
9934	14897	333	64	110	0	15404
9935	14908	167	58	90	0	15223
9936	547	14465	50	54	0	15116
9937	301	359	37	14584	0	15281
9938	14574	183	29	385	0	15171
9939	447	80	14530	183	0	15240
9940	238	14647	354	85	0	15324
9941	146	376	182	14638	0	15342
9942	14726	179	92	388	0	15385
9943	412	14846	64	201	0	15523
9944	15154	391	50	132	0	15727
9945	469	208	14911	67	0	15655
9946	14904	98	383	90	0	15475
9947	500	74	15104	47	0	15725
9948	15013	56	428	73	0	15570
9949	14795	49	224	76	0	15144
9950	613	60	14495	48	0	15216
9951	325	14567	421	48	0	15361
9952	219	373	248	14013	0	14853
9953	140	200	14579	382	0	15301
9954	133	14220	419	190	0	14962
9955	146	416	229	13918	0	14709
9956	162	217	114	14447	0	14940
9957	106	117	14128	546	0	14897
9958	138	80	444	13811	0	14473
9959	119	71	256	14297	0	14743
9960	105	67	14003	599	0	14774
9961	125	62	450	13678	0	14315
9962	101	13908	253	465	0	14727
9963	14012	390	146	317	0	14865
9964	460	222	124	13872	0	14678
9965	246	14006	146	465	0	14863
9966	182	427	120	13528	0	14257
9967	139	14209	134	438	0	14920
9968	146	498	13967	240	0	14851
9969	135	14192	459	166	0	14952
9970	13966	487	265	163	0	14881
9971	14126	291	174	166	0	14757
9972	14319	177	133	169	0	14798
9973	713	140	14062	136	0	15051
9974	400	123	13894	125	0	14542
9975	259	14469	662	118	0	15508
9976	253	498	328	13878	0	14957
9977	237	14815	219	437	0	15708
9978	275	550	177	13712	0	14714
9979	211	14751	154	476	0	15592
9980	14486	589	131	304	0	15510
9981	15472	370	145	198	0	16185
9982	819	238	134	15924	0	17115
9983	469	184	15663	604	0	16920
9984	15742	171	546	386	0	16845
9985	694	16024	333	228	0	17279
9986	463	581	213	15819	0	17076
9987	340	316	184	15800	0	16640
9988	241	16154	170	759	0	17324
9989	16198	633	133	453	0	17417
9990	696	387	15993	247	0	17323
9991	454	284	576	16047	0	17361
9992	16154	199	330	659	0	17342
9993	16314	190	218	390	0	17112
9994	923	15982	157	259	0	17321
9995	564	571	209	15501	0	16845
9996	340	16285	194	609	0	17428
9997	16440	668	174	385	0	17667
9998	711	396	16275	248	0	17630
9999	444	318	16287	212	0	17261
10000	310	238	763	15957	0	17268
10001	270	218	397	15938	0	16823
10002	234	15875	274	787	0	17170
10003	249	619	235	16061	0	17164
10004	195	352	15760	797	0	17104
10005	15644	201	666	507	0	17018
10006	687	167	376	16121	0	17351
10007	377	220	15870	744	0	17211
10008	275	188	626	16023	0	17112
10009	215	186	381	15835	0	16617
10010	194	15746	237	881	0	17058
10011	233	618	196	15937	0	16984
10012	210	367	217	15801	0	16595
10013	186	257	192	15955	0	16590
10014	14803	195	170	1061	0	16229
10015	575	14506	163	621	0	15865
10016	345	14882	146	422	0	15795
10017	14317	724	148	339	0	15528
10018	14133	380	142	319	0	14974
10019	774	13391	136	259	0	14560
10020	369	12855	122	211	0	13557
10021	11064	401	103	167	0	11735
10022	363	10970	92	132	0	11557
10023	147	10378	44	106	0	10675
10024	9875	346	114	123	0	10458
10025	255	9881	31	113	0	10280
10026	9680	313	35	134	0	10162
10027	9585	156	45	111	0	9897
10028	9554	151	33	109	0	9847
10029	367	9306	44	71	0	9788
10030	205	9382	35	81	0	9703
10031	194	339	23	9060	0	9616
10032	144	9196	36	234	0	9610
10033	155	336	29	9293	0	9813
10034	9537	175	34	302	0	10048
10035	309	168	33	9369	0	9879
10036	163	9332	49	312	0	9856
10037	9200	293	52	158	0	9703
10038	287	9098	34	145	0	9564
10039	175	9317	30	119	0	9641
10040	185	401	23	8838	0	9447
10041	126	9015	22	249	0	9412
10042	8893	306	48	147	0	9394
10043	268	171	8682	106	0	9227
10044	137	8607	213	104	0	9061
10045	141	272	103	8634	0	9150
10046	96	159	8563	283	0	9101
10047	106	132	217	8509	0	8964
10048	101	104	112	8675	0	8992
10049	102	115	97	8721	0	9035
10050	109	99	69	8710	0	8987
10051	92	98	8348	407	0	8945
10052	73	8344	256	250	0	8923
10053	8292	262	121	219	0	8894
10054	235	164	8208	180	0	8787
10055	8182	138	234	177	0	8731
10056	309	88	8330	151	0	8878
10057	154	103	291	8352	0	8900
10058	145	91	8317	304	0	8857
10059	115	93	8468	186	0	8862
10060	107	92	321	8399	0	8919
10061	140	82	185	8076	0	8483
10062	102	78	123	8648	0	8951
10063	94	107	87	8597	0	8885
10064	8371	90	103	440	0	9004
10065	261	91	8318	255	0	8925
10066	8353	81	240	215	0	8889
10067	8529	87	137	167	0	8920
10068	8554	86	101	156	0	8897
10069	8505	107	68	150	0	8830
10070	8571	85	62	148	0	8866
10071	443	89	68	8264	0	8864
10072	269	92	7898	270	0	8529
10073	180	84	7703	173	0	8140
10074	155	7712	241	149	0	8257
10075	7163	215	152	157	0	7687
10076	225	151	79	6933	0	7388
10077	154	188	36	6762	0	7140
10078	140	6705	53	244	0	7142
10079	118	6677	40	164	0	6999
10080	128	6646	33	104	0	6911
10081	5693	233	39	79	0	6044
10082	144	175	21	4657	0	4997
10083	71	4564	19	79	0	4733
10084	27	64	11	4507	0	4609
10085	18	41	4492	77	0	4628
10086	26	36	4603	48	0	4713
10087	32	23	76	4956	0	5087
10088	5138	16	45	101	0	5300
10089	5655	19	16	60	0	5750
10090	5687	25	9	45	0	5766
10091	149	32	5640	21	0	5842
10092	86	26	93	5650	0	5855
10093	43	33	52	5901	0	6029
10094	41	31	5670	140	0	5882
10095	5488	17	88	102	0	5695
10096	112	28	5755	40	0	5935
10097	69	23	5633	29	0	5754
10098	35	19	5668	26	0	5748
10099	32	26	150	5518	0	5726
10100	34	10	73	5724	0	5841
10101	19	11	5781	138	0	5949
10102	28	16	110	5816	0	5970
10103	5893	9	69	143	0	6114
10104	111	19	44	5967	0	6141
10105	58	8	6080	144	0	6290
10106	32	8	6283	83	0	6406
10107	27	13	157	6245	0	6442
10108	6366	10	83	145	0	6604
10109	111	6681	57	83	0	6932
10110	7006	123	40	62	0	7231
10111	7072	65	46	54	0	7237
10112	219	33	7103	50	0	7405
10113	127	9	166	7120	0	7422
10114	7211	9	112	176	0	7508
10115	7167	10	53	129	0	7359
10116	222	7106	54	56	0	7438
10117	133	124	46	7128	0	7431
10118	75	67	39	7344	0	7525
10119	56	28	7097	230	0	7411
10120	58	15	154	7089	0	7316
10121	44	18	7133	194	0	7389
10122	52	19	6976	114	0	7161
10123	68	13	222	6927	0	7230
10124	6906	11	113	185	0	7215
10125	162	6721	65	122	0	7070
10126	6752	129	48	97	0	7026
10127	6778	73	52	73	0	6976
10128	226	6709	42	70	0	7047
10129	147	144	32	6533	0	6856
10130	6534	88	39	155	0	6816
10131	188	6532	29	104	0	6853
10132	6430	137	36	64	0	6667
10133	189	6209	38	42	0	6478
10134	114	130	29	5918	0	6191
10135	89	69	26	6045	0	6229
10136	5896	45	30	193	0	6164
10137	5842	32	21	122	0	6017
10138	204	5842	28	75	0	6149
10139	120	117	5653	57	0	5947
10140	67	71	5589	55	0	5782
10141	73	42	179	5494	0	5788
10142	37	5661	104	146	0	5948
10143	44	114	71	5792	0	6021
10144	53	70	49	5770	0	5942
10145	58	38	50	5769	0	5915
10146	51	27	5642	208	0	5928
10147	43	46	5520	114	0	5723
10148	43	5752	183	77	0	6055
10149	46	123	92	5794	0	6055
10150	54	73	48	6010	0	6185
10151	61	49	5823	197	0	6130
10152	5475	44	128	133	0	5780
10153	148	33	92	5926	0	6199
10154	91	34	5961	158	0	6244
10155	5695	33	147	131	0	6006
10156	147	5898	95	90	0	6230
10157	105	127	6142	73	0	6447
10158	92	71	140	6099	0	6402
10159	6103	43	106	159	0	6411
10160	164	38	6084	101	0	6387
10161	112	36	164	6107	0	6419
10162	63	31	106	6152	0	6352
10163	62	31	73	6661	0	6827
10164	6704	30	51	264	0	7049
10165	168	6537	64	159	0	6928
10166	101	149	57	6739	0	7046
10167	50	84	6812	234	0	7180
10168	53	41	183	6725	0	7002
10169	46	6633	122	223	0	7024
10170	44	6994	74	136	0	7248
10171	6836	213	60	127	0	7236
10172	6985	100	51	108	0	7244
10173	258	55	6853	73	0	7239
10174	6771	52	179	75	0	7077
10175	212	6848	105	61	0	7226
10176	7026	177	59	71	0	7333
10177	232	100	37	6984	0	7353
10178	140	73	6977	198	0	7388
10179	124	48	178	7024	0	7374
10180	83	53	7034	214	0	7384
10181	6938	42	203	144	0	7327
10182	186	43	112	7093	0	7434
10183	119	7290	69	210	0	7688
10184	96	196	57	7391	0	7740
10185	82	105	7379	244	0	7810
10186	61	7172	203	152	0	7588
10187	6835	165	113	118	0	7231
10188	173	6640	68	79	0	6960
10189	82	6310	46	54	0	6492
10190	76	217	41	6043	0	6377
10191	37	6132	54	149	0	6372
10192	65	171	55	6164	0	6455
10193	39	93	6037	174	0	6343
10194	5666	58	131	102	0	5957
10195	5995	45	60	58	0	6158
10196	207	53	5888	36	0	6184
10197	5823	38	132	61	0	6054
10198	163	5900	89	37	0	6189
10199	6010	136	46	50	0	6242
10200	193	78	35	5927	0	6233
10201	102	53	5890	147	0	6192
10202	60	5946	129	88	0	6223
10203	55	151	76	5864	0	6146
10204	40	81	43	6006	0	6170
10205	5597	46	35	200	0	5878
10206	5421	24	34	119	0	5598
10207	187	5280	29	55	0	5551
10208	88	5101	29	48	0	5266
10209	36	4990	29	32	0	5087
10210	45	148	24	4712	0	4929
10211	4673	51	42	94	0	4860
10212	4601	14	7	50	0	4672
10213	108	25	14	4526	0	4673
10214	53	24	12	4551	0	4640
10215	4516	30	4	110	0	4660
10216	87	16	14	4655	0	4772
10217	48	13	4710	101	0	4872
10218	4680	17	65	43	0	4805
10219	4795	16	22	44	0	4877
10220	104	27	4808	31	0	4970
10221	4950	24	61	34	0	5069
10222	98	29	22	5091	0	5240
10223	51	14	19	5111	0	5195
10224	36	15	22	5153	0	5226
10225	5009	10	17	127	0	5163
10226	87	5053	17	60	0	5217
10227	51	81	14	5127	0	5273
10228	48	4956	15	85	0	5104
10229	5047	87	13	55	0	5202
10230	99	36	18	5057	0	5210
10231	66	32	12	5126	0	5236
10232	47	5042	17	110	0	5216
10233	42	94	4995	54	0	5185
10234	39	44	78	5103	0	5264
10235	5087	27	30	117	0	5261
10236	5595	18	26	84	0	5723
10237	161	21	6001	50	0	6233
10238	83	27	117	6197	0	6424
10239	41	6364	52	142	0	6599
10240	36	145	29	6569	0	6779
10241	6517	59	27	192	0	6795
10242	6639	41	28	91	0	6799
10243	213	24	24	6505	0	6766
10244	89	6427	26	169	0	6711
10245	6976	161	17	107	0	7261
10246	191	58	18	7245	0	7512
10247	7236	48	11	217	0	7512
10248	7641	37	16	105	0	7799
10249	242	30	16	7580	0	7868
10250	116	30	29	7692	0	7867
10251	80	25	14	7890	0	8009
10252	62	7686	21	262	0	8031
10253	82	174	15	7914	0	8185
10254	76	75	15	7922	0	8088
10255	65	53	7566	277	0	7961
10256	67	42	7396	143	0	7648
10257	64	37	218	7446	0	7765
10258	7381	25	92	261	0	7759
10259	192	7424	48	124	0	7788
10260	7406	162	38	96	0	7702
10261	225	80	7530	89	0	7924
10262	107	53	7385	91	0	7636
10263	69	7407	200	82	0	7758
10264	71	174	112	7322	0	7679
10265	38	69	7321	175	0	7603
10266	35	44	7424	91	0	7594
10267	44	37	198	7380	0	7659
10268	7397	20	107	183	0	7707
10269	7441	18	62	102	0	7623
10270	203	20	37	7417	0	7677
10271	99	23	7953	172	0	8247
10272	90	28	146	8001	0	8265
10273	70	16	75	8006	0	8167
10274	36	8018	61	198	0	8313
10275	8050	137	50	110	0	8347
10276	8064	64	40	87	0	8255
10277	177	8031	37	71	0	8316
10278	111	142	42	7854	0	8149
10279	65	7978	42	160	0	8245
10280	8033	158	35	96	0	8322
10281	182	69	7895	61	0	8207
10282	85	55	7578	64	0	7782
10283	57	34	7510	44	0	7645
10284	42	34	188	7534	0	7798
10285	40	15	84	7617	0	7756
10286	7582	14	58	194	0	7848
10287	148	26	39	7606	0	7819
10288	93	19	24	7989	0	8125
10289	56	33	8279	195	0	8563
10290	49	30	7904	117	0	8100
10291	8043	24	169	108	0	8344
10292	141	8227	82	57	0	8507
10293	8393	126	66	83	0	8668
10294	173	58	51	8371	0	8653
10295	92	39	43	8404	0	8578
10296	72	8281	37	193	0	8583
10297	53	131	32	8431	0	8647
10298	8279	47	35	209	0	8570
10299	149	42	34	8305	0	8530
10300	77	34	8214	201	0	8526
10301	66	8072	140	105	0	8383
10302	8130	129	66	109	0	8434
10303	8330	55	52	90	0	8527
10304	8310	48	43	82	0	8483
10305	8419	37	37	72	0	8565
10306	235	37	20	8265	0	8557
10307	125	29	20	8445	0	8619
10308	94	28	8243	209	0	8574
10309	77	26	132	8254	0	8489
10310	56	29	8253	215	0	8553
10311	57	32	158	8297	0	8544
10312	8333	21	67	240	0	8661
10313	165	8544	60	114	0	8883
10314	94	139	45	8729	0	9007
10315	82	55	41	8917	0	9095
10316	8704	47	31	235	0	9017
10317	8438	26	32	141	0	8637
10318	216	33	8380	83	0	8712
10319	111	8414	148	95	0	8768
10320	79	132	78	8450	0	8739
10321	64	68	62	8501	0	8695
10322	8359	45	54	232	0	8690
10323	8310	27	69	147	0	8553
10324	212	35	8385	95	0	8727
10325	119	38	8221	80	0	8458
10326	89	29	182	8248	0	8548
10327	75	25	92	8439	0	8631
10328	68	24	8319	213	0	8624
10329	8024	29	167	143	0	8363
10330	204	25	86	8479	0	8794
10331	8397	19	63	218	0	8697
10332	178	8270	58	115	0	8621
10333	8502	136	50	141	0	8829
10334	216	63	8832	88	0	9199
10335	121	8717	154	67	0	9059
10336	66	8532	74	53	0	8725
10337	7901	137	120	63	0	8221
10338	7719	49	31	55	0	7854
10339	152	23	16	7615	0	7806
10340	64	7508	21	95	0	7688
10341	53	7695	14	63	0	7825
10342	46	116	24	7729	0	7915
10343	7717	59	9	130	0	7915
10344	7648	36	24	90	0	7798
10345	123	29	7160	31	0	7343
10346	6813	19	62	48	0	6942
10347	103	7170	30	28	0	7331
10348	7293	83	10	44	0	7430
10349	112	8606	13	15	0	8746
10350	46	9568	12	15	0	9641
10351	83	252	21	11055	0	11411
10352	12012	100	12	306	0	12430
10353	12379	82	3	155	0	12619
10354	460	52	11955	83	0	12550
10355	271	29	303	12068	0	12671
10356	12277	11	130	390	0	12808
10357	470	22	92	12311	0	12895
10358	12377	21	76	453	0	12927
10359	12516	11	55	266	0	12848
10360	573	15	12141	154	0	12883
10361	344	22	324	11883	0	12573
10362	237	22	148	12178	0	12585
10363	183	22	93	12289	0	12587
10364	104	22	11665	569	0	12360
10365	107	16	362	11769	0	12254
10366	118	7	156	11518	0	11799
10367	60	11322	122	570	0	12074
10368	50	332	11217	298	0	11897
10369	36	11444	369	236	0	12085
10370	11390	412	144	202	0	12148
10371	392	205	108	10735	0	11440
10372	229	143	105	10610	0	11087
10373	133	10800	73	466	0	11472
10374	10767	379	42	301	0	11489
10375	11020	164	32	236	0	11452
10376	503	10501	49	194	0	11247
10377	269	10975	31	117	0	11392
10378	10894	473	34	106	0	11507
10379	474	236	10613	93	0	11416
10380	247	196	10598	83	0	11124
10381	10300	166	450	104	0	11020
10382	437	10648	245	61	0	11391
10383	10737	361	185	67	0	11350
10384	442	197	10513	75	0	11227
10385	10677	146	363	112	0	11298
10386	507	10796	166	76	0	11545
10387	313	388	144	10799	0	11644
10388	251	172	118	10755	0	11296
10389	238	156	83	10042	0	10519
10390	178	117	41	10497	0	10833
10391	143	87	51	10302	0	10583
10392	100	10000	59	698	0	10857
10393	10109	343	40	415	0	10907
10394	417	175	9963	276	0	10831
10395	232	134	361	10219	0	10946
10396	181	131	10165	459	0	10936
10397	179	90	445	10222	0	10936
10398	141	48	255	10511	0	10955
10399	10121	61	192	635	0	11009
10400	405	71	10012	368	0	10856
10401	197	9977	402	294	0	10870
10402	176	361	207	10205	0	10949
10403	164	165	151	10492	0	10972
10404	119	154	10150	556	0	10979
10405	111	140	384	10260	0	10895
10406	103	98	187	10621	0	11009
10407	9840	71	145	684	0	10740
10408	373	9994	139	382	0	10888
10409	10088	369	89	313	0	10859
10410	10354	190	53	273	0	10870
10411	586	167	51	10106	0	10910
10412	354	138	9884	436	0	10812
10413	275	106	9943	254	0	10578
10414	226	78	511	9762	0	10577
10415	182	79	293	9681	0	10235
10416	110	9691	235	542	0	10578
10417	9676	364	182	351	0	10573
10418	414	9524	137	267	0	10342
10419	235	9981	110	225	0	10551
10420	9856	559	82	164	0	10661
10421	479	313	65	9704	0	10561
10422	283	10159	59	454	0	10955
10423	216	487	58	10248	0	11009
10424	169	241	9920	549	0	10879
10425	141	169	10029	365	0	10704
10426	110	158	487	10143	0	10898
10427	95	124	10178	554	0	10951
10428	112	87	530	10148	0	10877
10429	104	75	305	10281	0	10765
10430	82	78	224	10515	0	10899
10431	9789	74	177	709	0	10749
10432	363	9613	159	449	0	10584
10433	204	10085	84	397	0	10770
10434	9491	453	84	296	0	10324
10435	9822	256	88	218	0	10384
10436	524	237	64	9520	0	10345
10437	298	187	9414	437	0	10336
10438	251	132	351	9569	0	10303
10439	199	111	9446	512	0	10268
10440	130	9405	430	303	0	10268
10441	119	361	217	9627	0	10324
10442	9575	185	182	506	0	10448
10443	408	181	128	9745	0	10462
10444	238	143	9435	487	0	10303
10445	9462	108	353	322	0	10245
10446	457	98	9620	251	0	10426
10447	323	89	9560	164	0	10136
10448	197	9056	508	186	0	9947
10449	116	7594	254	106	0	8070
10450	107	7089	166	108	0	7470
10451	4594	266	238	210	0	5308
10452	4238	22	24	32	0	4316
10453	37	14	12	4261	0	4324
10454	20	8	6	4300	0	4334
10455	11	7	5	4429	0	4452
10456	10	4417	8	34	0	4469
10457	4444	26	6	26	0	4502
10458	29	4437	11	10	0	4487
10459	24	28	5	4519	0	4576
10460	4522	13	8	39	0	4582
10461	29	10	7	4539	0	4585
10462	16	9	5	4612	0	4642
10463	4647	9	4	55	0	4715
10464	4588	6	7	36	0	4637
10465	46	9	4663	14	0	4732
10466	28	7	4561	11	0	4607
10467	12	9	4775	12	0	4808
10468	12	11	35	4786	0	4844
10469	16	9	18	4868	0	4911
10470	15	4859	8	38	0	4920
10471	4990	32	7	32	0	5061
10472	40	14	13	5076	0	5143
10473	24	5	9	5157	0	5195
10474	9	5220	16	50	0	5295
10475	5	5510	8	26	0	5549
10476	14	47	7	5631	0	5699
10477	21	18	7	6329	0	6375
10478	6344	8	5	108	0	6465
10479	6350	8	10	51	0	6419
10480	104	8	7	6370	0	6489
10481	29	15	6343	96	0	6483
10482	24	20	6127	42	0	6213
10483	31	10	94	6346	0	6481
10484	24	8	24	6235	0	6291
10485	19	6182	17	107	0	6325
10486	6145	80	16	61	0	6302
10487	87	25	13	6190	0	6315
10488	29	16	6246	96	0	6387
10489	17	15	80	6394	0	6506
10490	19	8	6429	101	0	6557
10491	21	7	6437	41	0	6506
10492	27	24	112	6560	0	6723
10493	6593	6	39	129	0	6767
10494	77	6	6544	45	0	6672
10495	38	7	93	6437	0	6575
10496	15	8	6842	94	0	6959
10497	29	6	89	6794	0	6918
10498	28	4	39	6797	0	6868
10499	12	10	6756	115	0	6893
10500	23	9	6533	43	0	6608
10501	31	3	107	6170	0	6311
10502	16	13	39	6689	0	6757
10503	16	3	30	6755	0	6804
10504	17	3	27	6663	0	6710
10505	6620	3	18	137	0	6778
10506	6667	5	18	82	0	6772
10507	100	6659	17	37	0	6813
10508	6792	75	21	61	0	6949
10509	94	26	15	6855	0	6990
10510	6837	8	21	120	0	6986
10511	99	19	6713	49	0	6880
10512	6764	7	90	51	0	6912
10513	105	6	43	6801	0	6955
10514	52	7	17	6940	0	7016
10515	6874	3	19	157	0	7053
10516	109	4	23	7216	0	7352
10517	47	13	7523	133	0	7716
10518	7536	10	112	90	0	7748
10519	125	7931	42	49	0	8147
10520	61	104	25	8396	0	8586
10521	28	28	9023	161	0	9240
10522	54	12	156	8955	0	9177
10523	26	25	9028	191	0	9270
10524	51	18	175	9007	0	9251
10525	21	9044	62	189	0	9316
10526	29	134	42	9175	0	9380
10527	27	9346	29	194	0	9596
10528	67	177	42	9031	0	9317
10529	40	52	24	9935	0	10051
10530	42	30	36	9970	0	10078
10531	42	23	31	9971	0	10067
10532	56	30	16	9955	0	10057
10533	28	24	9591	304	0	9947
10534	36	22	206	9648	0	9912
10535	43	20	74	9821	0	9958
10536	9591	16	57	329	0	9993
10537	190	9597	51	153	0	9991
10538	9619	206	32	145	0	10002
10539	242	64	36	9695	0	10037
10540	87	53	9640	259	0	10039
10541	44	9681	198	153	0	10076
10542	9545	205	93	140	0	9983
10543	212	9404	55	119	0	9790
10544	69	9726	44	103	0	9942
10545	9512	240	46	120	0	9918
10546	233	96	41	10117	0	10487
10547	10027	55	35	325	0	10442
10548	289	42	28	9941	0	10300
10549	116	40	9844	330	0	10330
10550	75	48	9745	166	0	10034
10551	9477	40	304	149	0	9970
10552	9810	27	128	128	0	10093
10553	315	40	83	9509	0	9947
10554	156	47	57	9678	0	9938
10555	9315	38	50	373	0	9776
10556	263	9164	50	171	0	9648
10557	119	9463	39	136	0	9757
10558	9304	278	33	142	0	9757
10559	9465	119	39	117	0	9740
10560	328	9268	41	98	0	9735
10561	175	257	26	9292	0	9750
10562	120	111	9151	291	0	9673
10563	89	90	9217	143	0	9539
10564	8977	58	285	118	0	9438
10565	298	49	9160	96	0	9603
10566	157	47	277	8933	0	9414
10567	133	43	109	8926	0	9211
10568	85	8927	98	320	0	9430
10569	8945	253	57	171	0	9426
10570	308	103	52	8942	0	9405
10571	139	78	8772	297	0	9286
10572	109	8783	247	139	0	9278
10573	110	283	86	8713	0	9192
10574	94	102	8571	295	0	9062
10575	73	83	8413	143	0	8712
10576	67	8259	294	115	0	8735
10577	7450	213	136	93	0	7892
10578	212	7594	98	70	0	7974
10579	7579	225	62	84	0	7950
10580	233	89	7438	99	0	7859
10581	7270	77	215	99	0	7661
10582	232	7454	106	72	0	7864
10583	122	213	66	7493	0	7894
10584	94	97	72	7748	0	8011
10585	7564	82	54	295	0	7995
10586	230	70	7545	154	0	7999
10587	7555	63	219	118	0	7955
10588	7641	60	105	104	0	7910
10589	264	57	7345	98	0	7764
10590	135	55	7459	80	0	7729
10591	110	79	252	7207	0	7648
10592	7294	64	116	248	0	7722
10593	7366	45	102	135	0	7648
10594	283	7297	81	96	0	7757
10595	162	219	51	7422	0	7854
10596	137	96	52	7265	0	7550
10597	99	69	55	7290	0	7513
10598	105	58	52	7386	0	7601
10599	7183	48	72	311	0	7614
10600	266	60	54	7315	0	7695
10601	150	49	7245	281	0	7725
10602	110	54	7230	141	0	7535
10603	7075	38	266	129	0	7508
10604	270	7032	126	99	0	7527
10605	135	7358	102	84	0	7679
10606	144	238	68	7352	0	7802
10607	108	111	63	7521	0	7803
10608	105	80	70	7397	0	7652
10609	104	57	62	7515	0	7738
10610	68	65	7207	364	0	7704
10611	94	56	205	7304	0	7659
10612	115	48	83	7385	0	7631
10613	92	45	7077	339	0	7553
10614	6800	43	229	189	0	7261
10615	219	7001	117	161	0	7498
10616	6704	179	103	118	0	7104
10617	232	83	6475	77	0	6867
10618	108	62	6227	72	0	6469
10619	85	6017	211	82	0	6395
10620	5186	287	340	140	0	5953
10621	4857	78	64	79	0	5078
10622	4859	38	38	60	0	4995
10623	181	4708	31	60	0	4980
10624	4669	112	37	48	0	4866
10625	145	55	4685	47	0	4932
10626	73	4670	112	48	0	4903
10627	4486	101	56	58	0	4701
10628	114	4522	47	27	0	4710
10629	4274	104	21	26	0	4425
10630	4180	33	21	35	0	4269
10631	126	26	4240	16	0	4408
10632	57	4258	95	19	0	4429
10633	4259	91	42	18	0	4410
10634	112	36	4246	10	0	4404
10635	55	4243	77	20	0	4395
10636	61	98	34	4117	0	4310
10637	24	37	4098	73	0	4232
10638	23	34	3990	31	0	4078
10639	27	16	89	4045	0	4177
10640	3996	15	49	88	0	4148
10641	79	4055	24	35	0	4193
10642	39	72	4016	32	0	4159
10643	47	28	3960	13	0	4048
10644	3856	21	104	21	0	4002
10645	82	4115	51	13	0	4261
10646	3537	41	14	16	0	3608
10647	40	3564	10	3	0	3617
10648	3602	48	19	13	0	3682
10649	3575	15	6	21	0	3617
10650	51	3564	9	3	0	3627
10651	20	45	9	3590	0	3664
10652	3752	10	5	54	0	3821
10653	51	12	3	3851	0	3917
10654	20	10	4	4129	0	4163
10655	4127	6	7	70	0	4210
10656	59	4171	10	24	0	4264
10657	4268	57	9	22	0	4356
10658	76	21	4221	5	0	4323
10659	33	15	57	4260	0	4365
10660	25	9	18	4307	0	4359
10661	4301	10	11	88	0	4410
10662	4322	7	2	34	0	4365
10663	82	9	4	4285	0	4380
10664	32	8	4341	66	0	4447
10665	23	8	57	4308	0	4396
10666	19	3	16	4340	0	4378
10667	22	4	17	4375	0	4418
10668	23	5	7	4382	0	4417
10669	4308	7	6	102	0	4423
10670	75	8	4286	31	0	4400
10671	27	4324	63	21	0	4435
10672	20	58	23	4288	0	4389
10673	11	17	16	4416	0	4460
10674	15	14	4348	86	0	4463
10675	20	11	4294	35	0	4360
10676	26	5	76	4433	0	4540
10677	11	9	28	4491	0	4539
10678	16	6	4393	99	0	4514
10679	17	5	69	4366	0	4457
10680	4507	13	27	103	0	4650
10681	80	4654	20	42	0	4796
10682	38	78	4622	32	0	4770
10683	24	4621	83	20	0	4748
10684	22	90	39	4646	0	4797
10685	16	33	4656	87	0	4792
10686	19	4582	74	48	0	4723
10687	24	71	36	4571	0	4702
10688	9	27	4633	78	0	4747
10689	19	20	78	4553	0	4670
10690	16	15	30	4625	0	4686
10691	4593	5	30	131	0	4759
10692	90	9	17	4644	0	4760
10693	4638	11	2	131	0	4782
10694	4562	8	13	55	0	4638
10695	4598	14	22	36	0	4670
10696	133	13	14	4539	0	4699
10697	49	13	4477	110	0	4649
10698	38	11	4432	47	0	4528
10699	4494	4	105	59	0	4662
10700	93	10	4511	27	0	4641
10701	4339	5	88	37	0	4469
10702	101	4332	37	76	0	4546
10703	4450	70	19	45	0	4584
10704	114	27	4462	18	0	4621
10705	41	23	4586	29	0	4679
10706	44	6	108	4543	0	4701
10707	20	14	4731	96	0	4861
10708	31	11	4764	50	0	4856
10709	32	9	120	5008	0	5169
10710	27	9	55	5216	0	5307
10711	22	13	31	5434	0	5500
10712	19	5389	33	151	0	5592
10713	29	114	17	5382	0	5542
10714	8	5523	30	150	0	5711
10715	5534	133	22	79	0	5768
10716	5617	52	21	69	0	5759
10717	157	34	20	5384	0	5595
10718	65	5336	35	142	0	5578
10719	40	118	5470	65	0	5693
10720	5550	38	123	63	0	5774
10721	143	37	53	5573	0	5806
10722	63	15	47	5666	0	5791
10723	44	29	24	5731	0	5828
10724	5492	11	32	217	0	5752
10725	159	5288	20	88	0	5555
10726	56	5446	26	67	0	5595
10727	5238	144	14	66	0	5462
10728	125	5260	33	52	0	5470
10729	5320	132	25	34	0	5511
10730	5334	63	22	59	0	5478
10731	169	5222	27	44	0	5462
10732	92	131	20	5145	0	5388
10733	49	5202	22	144	0	5417
10734	70	135	27	5188	0	5420
10735	52	56	13	5507	0	5628
10736	5459	43	14	219	0	5735
10737	5683	28	21	111	0	5843
10738	207	36	25	5626	0	5894
10739	97	31	5492	190	0	5810
10740	5418	33	142	97	0	5690
10741	184	5420	60	71	0	5735
10742	101	151	39	5422	0	5713
10743	81	54	32	5530	0	5697
10744	56	52	35	5551	0	5694
10745	5232	35	31	238	0	5536
10746	5300	34	25	126	0	5485
10747	192	5000	19	100	0	5311
10748	85	5151	31	75	0	5342
10749	86	161	23	5094	0	5364
10750	82	80	16	5184	0	5362
10751	58	56	5064	204	0	5382
10752	56	72	133	4911	0	5172
10753	46	47	4817	188	0	5098
10754	40	25	4499	99	0	4663
10755	32	4465	165	79	0	4741
10756	55	122	89	4420	0	4686
10757	4388	51	54	177	0	4670
10758	144	35	41	4397	0	4617
10759	60	28	4375	167	0	4630
10760	4312	34	118	86	0	4550
10761	4405	31	45	74	0	4555
10762	181	27	4294	60	0	4562
10763	99	23	119	4382	0	4623
10764	4305	30	49	151	0	4535
10765	157	4318	47	76	0	4598
10766	4404	121	35	75	0	4635
10767	4540	49	37	47	0	4673
10768	189	41	25	4446	0	4701
10769	100	37	28	4634	0	4799
10770	4571	37	19	195	0	4822
10771	185	35	20	4625	0	4865
10772	82	29	4566	202	0	4879
10773	4536	24	145	120	0	4825
10774	4614	21	45	101	0	4781
10775	205	4405	49	62	0	4721
10776	109	4525	28	62	0	4724
10777	80	175	29	4397	0	4681
10778	61	4440	29	158	0	4688
10779	75	211	22	4447	0	4755
10780	4358	56	20	187	0	4621
10781	4245	62	18	80	0	4405
10782	170	4156	24	79	0	4429
10783	4143	138	14	65	0	4360
10784	174	4142	21	58	0	4395
10785	4156	148	18	66	0	4388
10786	4269	48	19	51	0	4387
10787	199	56	4071	47	0	4373
10788	4063	41	127	51	0	4282
10789	180	4012	47	39	0	4278
10790	91	4143	31	45	0	4310
10791	4162	149	28	42	0	4381
10792	178	63	29	4107	0	4377
10793	85	55	4091	141	0	4372
10794	79	54	113	4094	0	4340
10795	68	51	33	4220	0	4372
10796	79	41	4028	163	0	4311
10797	3921	29	122	98	0	4170
10798	140	3953	53	84	0	4230
10799	3935	117	48	65	0	4165
10800	184	52	23	3871	0	4130
10801	3887	46	36	154	0	4123
10802	182	3839	28	63	0	4112
10803	101	146	23	3860	0	4130
10804	3860	54	15	150	0	4079
10805	156	53	3578	75	0	3862
10806	78	37	3423	76	0	3614
10807	3253	46	129	64	0	3492
10808	145	3185	53	55	0	3438
10809	57	2846	40	41	0	2984
10810	86	149	48	2577	0	2860
10811	47	2608	32	84	0	2771
10812	60	97	28	2608	0	2793
10813	52	42	17	2678	0	2789
10814	34	44	19	2625	0	2722
10815	42	2537	10	106	0	2695
10816	31	82	17	2562	0	2692
10817	38	30	2497	101	0	2666
10818	27	2522	67	50	0	2666
10819	26	77	19	2330	0	2452
10820	34	2294	17	75	0	2420
10821	2270	76	25	43	0	2414
10822	2287	26	20	41	0	2374
10823	2311	25	19	27	0	2382
10824	86	2323	14	27	0	2450
10825	40	74	11	2350	0	2475
10826	41	25	2305	73	0	2444
10827	36	33	2284	27	0	2380
10828	2204	35	59	36	0	2334
10829	2244	27	23	31	0	2325
10830	80	10	21	2302	0	2413
10831	46	20	14	2426	0	2506
10832	30	23	2438	91	0	2582
10833	28	2333	70	83	0	2514
10834	33	2394	23	48	0	2498
10835	23	51	2238	18	0	2330
10836	29	48	57	2062	0	2196
10837	27	15	12	1876	0	1930
10838	15	15	9	2092	0	2131
10839	13	22	5	2085	0	2125
10840	2053	15	7	58	0	2133
10841	47	13	2017	20	0	2097
10842	2033	11	39	16	0	2099
10843	48	11	9	2077	0	2145
10844	2094	8	7	49	0	2158
10845	46	20	5	2102	0	2173
10846	24	13	2170	45	0	2252
10847	24	9	38	2212	0	2283
10848	11	15	2283	45	0	2354
10849	21	6	40	2260	0	2327
10850	10	8	2333	49	0	2400
10851	13	2317	42	17	0	2389
10852	9	45	11	2338	0	2403
10853	15	14	7	2343	0	2379
10854	10	2350	10	46	0	2416
10855	2373	38	9	23	0	2443
10856	41	12	8	2383	0	2444
10857	15	7	14	2381	0	2417
10858	2422	10	5	61	0	2498
10859	2467	16	10	19	0	2512
10860	2549	15	6	20	0	2590
10861	2549	5	5	23	0	2582
10862	58	9	2467	11	0	2545
10863	2482	9	39	18	0	2548
10864	2577	10	10	18	0	2615
10865	51	9	5	2478	0	2543
10866	20	11	10	2482	0	2523
10867	2405	3	9	48	0	2465
10868	37	2380	11	20	0	2448
10869	19	31	4	2305	0	2359
10870	9	10	2374	40	0	2433
10871	6	2328	18	13	0	2365
10872	2271	31	6	14	0	2322
10873	2290	12	15	6	0	2323
10874	2263	4	4	10	0	2281
10875	2314	4	3	7	0	2328
10876	23	3	2	2271	0	2299
10877	14	2	2258	12	0	2286
10878	13	4	2362	9	0	2388
10879	15	3	24	2501	0	2543
10880	2631	4	10	34	0	2679
10881	30	2	5	2689	0	2726
10882	14	4	2722	27	0	2767
10883	2763	1	27	23	0	2814
10884	2778	1	8	12	0	2799
10885	42	0	5	2776	0	2823
10886	12	1	2850	28	0	2891
10887	13	2	2868	13	0	2896
10888	2787	0	36	17	0	2840
10889	32	2834	15	7	0	2888
10890	18	29	2875	9	0	2931
10891	12	11	37	2838	0	2898
10892	2916	1	12	40	0	2969
10893	34	2834	4	14	0	2886
10894	13	2868	5	12	0	2898
10895	2886	31	15	12	0	2944
10896	36	11	7	2877	0	2931
10897	3088	8	2	37	0	3135
10898	43	7	4	3184	0	3238
10899	23	5	4	3240	0	3272
10900	15	1	3203	58	0	3277
10901	18	12	3045	15	0	3090
10902	10	9	3264	12	0	3295
10903	15	5	57	3296	0	3373
10904	3354	4	20	55	0	3433
10905	52	4	3363	21	0	3440
10906	27	2	52	3355	0	3436
10907	11	6	3464	61	0	3542
10908	19	3514	52	24	0	3609
10909	18	45	21	3600	0	3684
10910	24	9	13	3592	0	3638
10911	22	7	15	3636	0	3680
10912	3598	6	6	84	0	3694
10913	61	5	10	3599	0	3675
10914	31	5	12	3636	0	3684
10915	3608	4	16	83	0	3711
10916	61	5	3571	30	0	3667
10917	3569	5	55	37	0	3666
10918	3595	5	20	26	0	3646
10919	76	12	3543	14	0	3645
10920	3493	3	63	18	0	3577
10921	72	8	20	3682	0	3782
10922	29	10	3713	59	0	3811
10923	3686	8	62	42	0	3798
10924	3733	4	18	33	0	3788
10925	78	3	19	3703	0	3803
10926	37	3	15	3725	0	3780
10927	35	6	12	3752	0	3805
10928	3681	5	15	82	0	3783
10929	67	3668	17	44	0	3796
10930	3614	42	18	40	0	3714
10931	66	3426	19	31	0	3542
10932	37	3432	17	21	0	3507
10933	23	53	19	3449	0	3544
10934	30	14	15	3490	0	3549
10935	33	11	12	3493	0	3549
10936	25	9	19	3488	0	3541
10937	24	4	3427	75	0	3530
10938	3353	8	50	39	0	3450
10939	67	7	25	3469	0	3568
10940	28	10	3566	66	0	3670
10941	29	6	56	3562	0	3653
10942	35	10	20	3623	0	3688
10943	27	16	3694	73	0	3810
10944	31	11	51	3683	0	3776
10945	26	13	17	3681	0	3737
10946	3641	13	20	80	0	3754
10947	61	10	3594	45	0	3710
10948	3485	6	47	41	0	3579
10949	59	3634	23	43	0	3759
10950	3622	40	19	48	0	3729
10951	3620	13	30	29	0	3692
10952	68	14	21	3601	0	3704
10953	33	8	3598	73	0	3712
10954	24	3720	62	39	0	3845
10955	29	45	24	3669	0	3767
10956	22	3903	24	72	0	4021
10957	3922	63	21	46	0	4052
10958	73	19	3846	31	0	3969
10959	25	18	3822	40	0	3905
10960	27	13	71	3790	0	3901
10961	28	7	3891	81	0	4007
10962	31	9	66	3869	0	3975
10963	28	11	22	3889	0	3950
10964	3948	12	13	98	0	4071
10965	73	3965	23	47	0	4108
10966	40	52	16	4050	0	4158
10967	30	13	23	4121	0	4187
10968	33	13	21	4086	0	4153
10969	25	3975	19	88	0	4107
10970	21	4034	26	48	0	4129
10971	3999	67	17	46	0	4129
10972	4041	20	20	35	0	4116
10973	4017	12	25	31	0	4085
10974	97	12	3948	28	0	4085
10975	37	14	76	3942	0	4069
10976	28	15	3927	95	0	4065
10977	22	3910	67	50	0	4049
10978	3778	60	26	48	0	3912
10979	73	22	3793	28	0	3916
10980	27	27	55	3716	0	3825
10981	25	14	3787	72	0	3898
10982	3669	4	67	38	0	3778
10983	3791	9	14	44	0	3858
10984	3806	13	17	33	0	3869
10985	3769	12	14	28	0	3823
10986	74	12	3783	23	0	3892
10987	3713	8	53	31	0	3805
10988	3777	11	22	24	0	3834
10989	73	3732	22	18	0	3845
10990	3709	46	20	25	0	3800
10991	3796	12	13	26	0	3847
10992	74	17	12	3642	0	3745
10993	38	3694	20	57	0	3809
10994	3842	49	17	28	0	3936
10995	4059	11	13	34	0	4117
10996	86	11	4574	19	0	4690
10997	36	15	4755	15	0	4821
10998	31	6	4854	16	0	4907
10999	36	23	117	4744	0	4920
11000	4784	9	48	96	0	4937
11001	92	4794	42	33	0	4961
11002	4702	78	24	38	0	4842
11003	108	4729	16	22	0	4875
11004	4714	96	14	24	0	4848
11005	107	4663	8	13	0	4791
11006	44	4787	13	11	0	4855
11007	4604	108	7	12	0	4731
11008	96	4631	8	7	0	4742
11009	50	108	5	4583	0	4746
11010	40	43	4575	76	0	4734
11011	22	35	4568	26	0	4651
11012	32	15	98	4512	0	4657
11013	20	15	47	4634	0	4716
11014	14	13	4627	104	0	4758
11015	23	12	89	4570	0	4694
11016	21	13	33	4705	0	4772
11017	4667	9	23	130	0	4829
11018	90	4699	17	54	0	4860
11019	45	88	15	4563	0	4711
11020	29	4783	12	92	0	4916
11021	4700	103	11	51	0	4865
11022	90	4678	18	26	0	4812
11023	4685	113	9	32	0	4839
11024	4718	38	14	23	0	4793
11025	132	32	8	4613	0	4785
11026	67	20	8	4663	0	4758
11027	55	12	12	4718	0	4797
11028	35	17	14	4730	0	4796
11029	25	9	4545	151	0	4730
11030	4357	19	86	86	0	4548
11031	103	4561	30	46	0	4740
11032	50	100	24	4645	0	4819
11033	47	42	15	4672	0	4776
11034	31	4678	16	124	0	4849
11035	4704	109	14	68	0	4895
11036	97	4752	18	43	0	4910
11037	48	119	13	4833	0	5013
11038	54	45	7	4937	0	5043
11039	45	39	13	4948	0	5045
11040	31	28	8	4867	0	4934
11041	4712	17	16	175	0	4920
11042	110	19	4684	76	0	4889
11043	54	12	102	4655	0	4823
11044	40	25	44	4701	0	4810
11045	37	15	41	4762	0	4855
11046	31	15	33	4753	0	4832
11047	4583	20	19	185	0	4807
11048	122	18	4579	89	0	4808
11049	63	28	92	4429	0	4612
11050	44	4336	38	117	0	4535
11051	35	4595	26	67	0	4723
11052	4555	123	19	51	0	4748
11053	114	65	4505	35	0	4719
11054	4302	46	93	29	0	4470
11055	131	34	4395	28	0	4588
11056	64	24	97	4210	0	4395
11057	4290	17	49	121	0	4477
11058	94	4340	39	65	0	4538
11059	49	80	29	4251	0	4409
11060	39	4114	35	97	0	4285
11061	4302	104	26	70	0	4502
11062	4357	49	13	61	0	4480
11063	120	38	17	4298	0	4473
11064	58	31	4208	119	0	4416
11065	49	30	4183	60	0	4322
11066	42	30	104	4181	0	4357
11067	38	4177	50	96	0	4361
11068	27	108	29	4383	0	4547
11069	42	56	18	4243	0	4359
11070	47	43	13	4211	0	4314
11071	23	34	4226	151	0	4434
11072	38	17	81	4249	0	4385
11073	29	13	39	4315	0	4396
11074	16	4160	30	173	0	4379
11075	17	85	19	4183	0	4304
11076	13	34	18	4402	0	4467
11077	17	22	19	4450	0	4508
11078	21	16	17	4439	0	4493
11079	23	17	19	4329	0	4388
11080	17	20	9	4315	0	4361
11081	13	20	7	4198	0	4238
11082	18	21	16	4125	0	4180
11083	22	25	3756	265	0	4068
11084	21	20	82	3985	0	4108
11085	3937	18	35	147	0	4137
11086	101	16	24	3953	0	4094
11087	49	12	3973	141	0	4175
11088	3883	12	84	92	0	4071
11089	4078	14	40	66	0	4198
11090	4077	15	29	53	0	4174
11091	4094	15	21	49	0	4179
11092	143	14	13	4075	0	4245
11093	73	8	4003	123	0	4207
11094	39	3872	79	85	0	4075
11095	28	3656	37	62	0	3783
11096	62	137	105	2827	0	3131
11097	25	15	23	2769	0	2832
11098	10	2	2	2711	0	2725
11099	5	1	3	2816	0	2825
11100	6	1	2	3108	0	3117
11101	3493	0	4	70	0	3567
11102	63	3534	3	27	0	3627
11103	31	3767	1	11	0	3810
11104	20	103	3	3769	0	3895
11105	11	35	4	3876	0	3926
11106	13	16	4	3852	0	3885
11107	11	8	1	3863	0	3883
11108	7	10	3693	133	0	3843
11109	9	3670	80	60	0	3819
11110	11	83	26	3722	0	3842
11111	3643	31	14	106	0	3794
11112	82	15	7	3702	0	3806
11113	31	16	3703	112	0	3862
11114	20	16	3598	58	0	3692
11115	12	18	3737	39	0	3806
11116	10	21	115	3620	0	3766
11117	3700	9	47	105	0	3861
11118	76	3	23	3748	0	3850
11119	38	6	10	3882	0	3936
11120	3757	7	8	135	0	3907
11121	85	9	14	3818	0	3926
11122	40	4	19	3882	0	3945
11123	19	9	3927	120	0	4075
11124	10	3905	83	69	0	4067
11125	14	72	41	4140	0	4267
11126	4104	25	26	117	0	4272
11127	93	13	18	4153	0	4277
11128	41	8	4110	118	0	4277
11129	35	13	86	4128	0	4262
11130	19	4124	32	130	0	4305
11131	31	77	19	4210	0	4337
11132	12	36	4168	137	0	4353
11133	9	4373	99	75	0	4556
11134	24	116	42	4420	0	4602
11135	17	50	25	4908	0	5000
11136	21	31	19	5048	0	5119
11137	18	12	22	5098	0	5150
11138	10	23	4928	200	0	5161
11139	8	4920	119	117	0	5164
11140	4949	112	47	75	0	5183
11141	5063	50	34	54	0	5201
11142	162	33	28	4986	0	5209
11143	65	23	4925	155	0	5168
11144	4869	25	119	86	0	5099
11145	133	13	51	5029	0	5226
11146	57	10	5175	149	0	5391
11147	44	28	117	5199	0	5388
11148	31	10	60	5236	0	5337
11149	27	11	35	5319	0	5392
11150	19	12	5187	229	0	5447
11151	46	20	131	5041	0	5238
11152	22	5132	70	173	0	5397
11153	5133	132	44	91	0	5400
11154	5225	50	26	72	0	5373
11155	5218	28	24	64	0	5334
11156	189	5078	22	63	0	5352
11157	5098	127	32	56	0	5313
11158	187	57	22	4989	0	5255
11159	4982	30	16	176	0	5204
11160	5014	19	32	97	0	5162
11161	185	21	4834	82	0	5122
11162	96	4837	122	60	0	5115
11163	4865	119	62	66	0	5112
11164	154	62	56	4852	0	5124
11165	85	40	4817	151	0	5093
11166	58	4839	126	79	0	5102
11167	4799	124	51	61	0	5035
11168	164	53	34	4821	0	5072
11169	103	37	23	4890	0	5053
11170	56	37	22	4893	0	5008
11171	56	4716	24	195	0	4991
11172	41	122	20	4795	0	4978
11173	47	4679	21	173	0	4920
11174	48	146	17	4762	0	4973
11175	34	65	4702	176	0	4977
11176	34	62	121	4770	0	4987
11177	43	26	58	4873	0	5000
11178	33	31	38	4949	0	5051
11179	25	26	4735	242	0	5028
11180	29	37	130	4807	0	5003
11181	46	27	62	4909	0	5044
11182	23	24	47	4995	0	5089
11183	29	22	31	4995	0	5077
11184	30	23	35	5000	0	5088
11185	30	40	4767	242	0	5079
11186	34	16	129	4872	0	5051
11187	38	30	69	4810	0	4947
11188	4521	16	46	254	0	4837
11189	128	4453	45	148	0	4774
11190	66	4609	36	123	0	4834
11191	53	151	28	4626	0	4858
11192	39	69	24	4660	0	4792
11193	35	4417	43	213	0	4708
11194	27	137	22	4511	0	4697
11195	31	4414	26	221	0	4692
11196	42	137	19	4524	0	4722
11197	33	83	22	4534	0	4672
11198	28	60	4279	208	0	4575
11199	34	4163	126	131	0	4454
11200	31	4033	43	96	0	4203
11201	3354	104	52	76	0	3586
11202	82	3418	20	42	0	3562
11203	40	92	19	3271	0	3422
11204	33	56	3205	88	0	3382
11205	34	43	62	3183	0	3322
11206	3151	18	23	117	0	3309
11207	70	34	3203	49	0	3356
11208	35	3288	65	62	0	3450
11209	41	81	32	3066	0	3220
11210	19	27	25	3435	0	3506
11211	3411	26	23	119	0	3579
11212	60	20	26	3484	0	3590
11213	33	31	16	3471	0	3551
11214	28	25	5	3493	0	3551
11215	29	19	8	3471	0	3527
11216	3333	24	15	130	0	3502
11217	3338	15	16	96	0	3465
11218	80	15	18	3345	0	3458
11219	3244	12	13	107	0	3376
11220	82	10	8	3211	0	3311
11221	34	10	3128	108	0	3280
11222	33	22	3039	68	0	3162
11223	24	34	69	2928	0	3055
11224	22	2987	33	95	0	3137
11225	23	52	19	2928	0	3022
11226	2880	24	11	98	0	3013
11227	51	27	11	2930	0	3019
11228	2944	8	8	101	0	3061
11229	64	13	6	2978	0	3061
11230	31	7	2999	90	0	3127
11231	28	2942	42	51	0	3063
11232	11	2998	20	46	0	3075
11233	31	69	12	2691	0	2803
11234	15	22	2693	55	0	2785
11235	5	2271	12	17	0	2305
11236	9	25	19	2121	0	2174
11237	2047	8	5	17	0	2077
11238	6	1	2083	8	0	2098
11239	3	3	6	2082	0	2094
11240	3	2	1	2134	0	2140
11241	1	2	2110	12	0	2125
11242	6	2	1978	6	0	1992
11243	1	6	2115	7	0	2129
11244	4	4	9	2136	0	2153
11245	5	0	2165	11	0	2181
11246	2034	0	11	5	0	2050
11247	17	1	3	2269	0	2290
11248	2	1	2714	20	0	2737
11249	3	2816	20	5	0	2844
11250	5	19	2824	1	0	2849
11251	10	13	22	2813	0	2858
11252	2924	4	2	35	0	2965
11253	22	2	4	3008	0	3036
11254	10	1	2	3065	0	3078
11255	3303	3	1	33	0	3340
11256	42	0	1	3460	0	3503
11257	8	4	3502	50	0	3564
11258	3400	0	48	28	0	3476
11259	45	3510	14	13	0	3582
11260	3598	44	7	7	0	3656
11261	53	15	2	3591	0	3661
11262	16	7	3566	49	0	3638
11263	11	8	3561	15	0	3595
11264	6	9	54	3576	0	3645
11265	6	3	21	3568	0	3598
11266	5	0	3567	55	0	3627
11267	3	5	3437	20	0	3465
11268	3504	1	60	15	0	3580
11269	51	0	21	3585	0	3657
11270	3617	0	14	56	0	3687
11271	66	2	12	3597	0	3677
11272	22	4	3779	58	0	3863
11273	14	9	3864	20	0	3907
11274	14	2	70	3948	0	4034
11275	10	1	28	3987	0	4026
11276	5	0	4035	74	0	4114
11277	3986	1	69	34	0	4090
11278	69	1	22	4206	0	4298
11279	4358	0	16	81	0	4455
11280	79	4929	14	29	0	5051
11281	41	101	12	5118	0	5272
11282	5137	17	6	126	0	5286
11283	124	11	5169	39	0	5343
11284	51	8	112	5191	0	5362
11285	26	3	33	5261	0	5323
11286	29	4	16	5381	0	5430
11287	15	6	5247	156	0	5424
11288	23	4	117	5215	0	5359
11289	9	5234	37	138	0	5418
11290	24	106	23	5352	0	5505
11291	13	27	5288	138	0	5466
11292	17	13	5365	46	0	5441
11293	22	12	139	5359	0	5532
11294	20	11	45	5454	0	5530
11295	16	5	32	5505	0	5558
11296	21	5	24	5556	0	5606
11297	5406	7	17	190	0	5620
11298	5445	9	13	78	0	5545
11299	143	7	5378	53	0	5581
11300	48	5498	128	43	0	5717
11301	35	110	37	5678	0	5860
11302	5757	28	14	162	0	5961
11303	5276	18	28	92	0	5414
11304	5813	13	22	40	0	5888
11305	5812	9	28	45	0	5894
11306	171	8	5692	30	0	5901
11307	5508	8	128	39	0	5683
11308	144	5464	47	35	0	5690
11309	64	110	23	5606	0	5803
11310	39	29	5597	146	0	5811
11311	51	15	130	5544	0	5740
11312	26	19	5594	154	0	5793
11313	33	10	139	5608	0	5790
11314	30	8	50	5787	0	5875
11315	5680	8	36	194	0	5918
11316	157	8	26	5725	0	5916
11317	50	11	5759	175	0	5995
11318	48	11	139	5895	0	6093
11319	5892	5	52	170	0	6119
11320	164	10	31	5915	0	6120
11321	59	14	5895	165	0	6133
11322	28	5822	136	83	0	6069
11323	5956	121	48	75	0	6200
11324	151	33	34	5834	0	6052
11325	48	5992	51	159	0	6250
11326	5983	136	39	77	0	6235
11327	145	44	5958	62	0	6209
11328	56	5916	138	65	0	6175
11329	49	135	52	6048	0	6284
11330	34	41	5977	162	0	6214
11331	41	22	157	5863	0	6083
11332	5887	19	55	190	0	6151
11333	146	12	5872	99	0	6129
11334	64	8	142	5897	0	6111
11335	46	21	5965	171	0	6203
11336	43	14	152	5961	0	6170
11337	46	17	65	6121	0	6249
11338	5966	19	38	212	0	6235
11339	147	5986	41	86	0	6260
11340	63	122	29	6148	0	6362
11341	6069	37	37	174	0	6317
11342	6148	20	37	84	0	6289
11343	174	25	30	6018	0	6247
11344	60	5829	42	172	0	6103
11345	50	6082	36	92	0	6260
11346	71	147	24	5958	0	6200
11347	50	58	23	5947	0	6078
11348	5381	25	42	174	0	5622
11349	118	25	39	5344	0	5526
11350	45	24	5184	167	0	5420
11351	4960	12	109	108	0	5189
11352	123	5048	47	70	0	5288
11353	5079	104	21	68	0	5272
11354	145	30	5217	52	0	5444
11355	46	5200	102	48	0	5396
11356	5080	97	37	64	0	5278
11357	5171	23	27	32	0	5253
11358	120	20	5183	30	0	5353
11359	5149	26	95	37	0	5307
11360	5279	19	30	39	0	5367
11361	129	5274	19	16	0	5438
11362	54	88	20	5455	0	5617
11363	46	31	5392	107	0	5576
11364	43	20	103	5450	0	5616
11365	29	22	5530	116	0	5697
11366	27	17	94	5514	0	5652
11367	5596	17	40	135	0	5788
11368	114	6	22	5738	0	5880
11369	41	10	6108	120	0	6279
11370	6229	9	113	64	0	6415
11371	147	13	50	6461	0	6671
11372	54	9	6316	144	0	6523
11373	6162	5	126	77	0	6370
11374	156	28	49	6324	0	6557
11375	66	13	6221	161	0	6461
11376	41	17	6141	61	0	6260
11377	53	65	144	6044	0	6306
11378	39	11	6191	131	0	6372
11379	30	5951	130	66	0	6177
11380	28	88	46	5366	0	5528
11381	5308	21	26	72	0	5427
11382	71	11	5333	37	0	5452
11383	29	9	5259	29	0	5326
11384	5100	2	96	28	0	5226
11385	72	7	5316	15	0	5410
11386	5093	2	83	27	0	5205
11387	79	1	5246	6	0	5332
11388	47	6	81	5153	0	5287
11389	24	2	5309	71	0	5406
11390	22	4	88	5225	0	5339
11391	15	10	5468	75	0	5568
11392	21	4	5290	47	0	5362
11393	5105	3	100	45	0	5253
11394	57	5412	66	13	0	5548
11395	5548	53	34	30	0	5665
11396	79	5519	30	14	0	5642
11397	49	71	35	5580	0	5735
11398	43	26	22	5679	0	5770
11399	5640	19	26	93	0	5778
11400	82	8	29	5519	0	5638
11401	41	10	5447	78	0	5576
11402	5285	4	75	67	0	5431
11403	5437	4	56	34	0	5531
11404	105	4	41	5427	0	5577
11405	53	9	5529	75	0	5666
11406	36	12	77	5461	0	5586
11407	24	5498	48	81	0	5651
11408	24	69	27	5538	0	5658
11409	28	28	29	5620	0	5705
11410	19	22	5516	111	0	5668
11411	5077	7	84	77	0	5245
11412	69	5399	46	38	0	5552
11413	5426	60	37	33	0	5556
11414	88	5425	24	30	0	5567
11415	51	71	20	5367	0	5509
11416	26	5463	18	77	0	5584
11417	35	71	5333	45	0	5484
11418	32	46	67	5176	0	5321
11419	28	26	48	5197	0	5299
11420	29	8	30	5402	0	5469
11421	5263	12	25	123	0	5423
11422	83	12	30	5265	0	5390
11423	5235	14	31	111	0	5391
11424	5284	19	20	71	0	5394
11425	5232	19	22	53	0	5326
11426	109	18	5205	42	0	5374
11427	67	14	78	5276	0	5435
11428	43	20	59	5418	0	5540
11429	43	18	43	5567	0	5671
11430	5720	19	24	153	0	5916
11431	111	15	27	5769	0	5922
11432	57	19	41	5900	0	6017
11433	6196	18	24	156	0	6394
11434	126	16	33	6384	0	6559
11435	80	23	6483	149	0	6735
11436	60	21	6533	84	0	6698
11437	51	11	154	6645	0	6861
11438	6584	9	87	181	0	6861
11439	6502	6	62	100	0	6670
11440	193	6	38	6507	0	6744
11441	96	5	6439	159	0	6699
11442	82	6319	136	85	0	6622
11443	56	113	78	6497	0	6744
11444	56	41	52	6564	0	6713
11445	52	27	52	6566	0	6697
11446	6466	18	38	250	0	6772
11447	157	14	6461	124	0	6756
11448	6459	16	144	106	0	6725
11449	184	12	72	6441	0	6709
11450	83	6460	63	156	0	6762
11451	6558	117	37	107	0	6819
11452	6519	54	31	104	0	6708
11453	201	41	6690	58	0	6990
11454	97	6226	152	75	0	6550
11455	74	6385	59	72	0	6590
11456	6341	156	53	92	0	6642
11457	183	58	41	6325	0	6607
11458	100	40	31	6237	0	6408
11459	73	29	40	6220	0	6362
11460	67	5879	32	213	0	6191
11461	53	6097	28	104	0	6282
11462	5967	156	20	103	0	6246
11463	169	59	27	5925	0	6180
11464	73	60	6183	168	0	6484
11465	82	35	158	6450	0	6725
11466	50	37	7120	245	0	7452
11467	67	36	7229	120	0	7452
11468	46	54	7271	89	0	7460
11469	35	6526	293	49	0	6903
11470	63	186	200	6189	0	6638
11471	36	6339	98	164	0	6637
11472	56	224	65	5915	0	6260
11473	35	83	42	6363	0	6523
11474	6211	68	37	280	0	6596
11475	197	44	37	6276	0	6554
11476	6150	39	35	272	0	6496
11477	6263	22	32	148	0	6465
11478	263	31	28	6026	0	6348
11479	137	5910	28	244	0	6319
11480	114	171	38	5931	0	6254
11481	73	5935	47	243	0	6298
11482	60	209	38	5972	0	6279
11483	50	111	5797	265	0	6223
11484	56	81	163	5947	0	6247
11485	49	64	72	6119	0	6304
11486	5793	38	57	327	0	6215
11487	189	5797	44	192	0	6222
11488	124	177	33	5932	0	6266
11489	91	83	32	5923	0	6129
11490	71	5737	49	273	0	6130
11491	70	194	27	5813	0	6104
11492	5402	97	16	316	0	5831
11493	5700	86	24	183	0	5993
11494	240	5543	26	145	0	5954
11495	137	202	21	5607	0	5967
11496	5400	103	32	261	0	5796
11497	226	5482	40	145	0	5893
11498	128	205	29	5352	0	5714
11499	93	5449	39	242	0	5823
11500	5458	228	29	128	0	5843
11501	222	142	5338	117	0	5819
11502	115	94	5373	114	0	5696
11503	111	82	242	5370	0	5805
11504	73	76	5405	239	0	5793
11505	58	53	253	5303	0	5667
11506	5254	53	128	273	0	5708
11507	224	38	5367	165	0	5794
11508	120	58	216	5422	0	5816
11509	100	42	116	5562	0	5820
11510	5409	59	81	302	0	5851
11511	201	5416	65	210	0	5892
11512	5478	186	44	183	0	5891
11513	5552	118	42	133	0	5845
11514	303	5314	47	96	0	5760
11515	188	192	66	5391	0	5837
11516	132	109	5266	238	0	5745
11517	97	90	186	5293	0	5666
11518	63	5297	104	282	0	5746
11519	5360	208	79	172	0	5819
11520	230	109	60	5447	0	5846
11521	105	111	5464	268	0	5948
11522	99	78	184	5625	0	5986
11523	81	72	93	5726	0	5972
11524	85	61	80	5768	0	5994
11525	63	72	53	5823	0	6011
11526	100	51	42	5683	0	5876
11527	60	55	5342	408	0	5865
11528	78	71	5284	234	0	5667
11529	46	4913	233	203	0	5395
11530	49	5009	131	143	0	5332
11531	4870	212	103	111	0	5296
11532	199	104	4914	107	0	5324
11533	4472	89	188	78	0	4827
11534	197	58	4381	64	0	4700
11535	85	31	4156	58	0	4330
11536	73	40	194	4010	0	4317
11537	4144	30	114	180	0	4468
11538	142	34	73	4265	0	4514
11539	80	24	59	4310	0	4473
11540	62	18	4492	233	0	4805
11541	49	21	140	4596	0	4806
11542	40	25	86	4628	0	4779
11543	42	30	56	4681	0	4809
11544	50	29	32	4685	0	4796
11545	51	18	33	4704	0	4806
11546	4493	27	33	266	0	4819
11547	142	17	20	4604	0	4783
11548	77	23	4379	218	0	4697
11549	64	21	120	4487	0	4692
11550	46	24	4377	214	0	4661
11551	55	29	148	4427	0	4659
11552	35	17	4536	216	0	4804
11553	32	48	158	4273	0	4511
11554	27	12	103	4502	0	4644
11555	14	15	4326	223	0	4578
11556	4090	17	123	161	0	4391
11557	101	15	4417	122	0	4655
11558	80	12	141	4475	0	4708
11559	4543	10	96	144	0	4793
11560	132	11	63	4614	0	4820
11561	91	18	50	4650	0	4809
11562	62	15	4591	204	0	4872
11563	48	4439	111	146	0	4744
11564	31	4167	80	106	0	4384
11565	16	4062	39	83	0	4200
11566	75	39	39	3170	0	3323
11567	3219	9	9	17	0	3254
11568	10	4	1	3188	0	3203
11569	10	3	0	3188	0	3201
11570	1	1	1	3248	0	3251
11571	6	0	1	3218	0	3225
11572	2	3204	2	17	0	3225
11573	2	7	2	3317	0	3328
11574	1	4	0	3320	0	3325
11575	1	3318	2	20	0	3341
11576	3468	13	1	21	0	3503
11577	13	6	0	3504	0	3523
11578	3531	2	1	22	0	3556
11579	3512	2	2	17	0	3533
11580	21	3619	4	4	0	3648
11581	13	10	1	3803	0	3827
11582	5	6	3733	17	0	3761
11583	6	8	3674	9	0	3697
11584	7	21	20	3763	0	3811
11585	3861	3	6	25	0	3895
11586	3906	0	6	19	0	3931
11587	23	0	4	4006	0	4033
11588	4041	0	2	25	0	4068
11589	16	4033	4	11	0	4064
11590	4087	13	3	15	0	4118
11591	18	4355	8	4	0	4385
11592	14	16	2	4471	0	4503
11593	7	10	0	4471	0	4488
11594	6	4444	6	27	0	4483
11595	4461	15	3	16	0	4495
11596	17	11	4349	10	0	4387
11597	10	1	13	4440	0	4464
11598	5	7	4486	19	0	4517
11599	11	3	15	4438	0	4467
11600	4572	2	8	29	0	4611
11601	16	0	4	4589	0	4609
11602	4538	2	3	29	0	4572
11603	4492	2	5	19	0	4518
11604	25	1	1	4558	0	4585
11605	11	2	4563	21	0	4597
11606	6	4834	15	16	0	4871
11607	5	12	9	4839	0	4865
11608	4793	5	2	39	0	4839
11609	20	9	4756	11	0	4796
11610	16	1	15	4765	0	4797
11611	9	5	10	4789	0	4813
11612	12	2	4	4872	0	4890
11613	4838	2	4	41	0	4885
11614	16	3	5	4763	0	4787
11615	13	2	3	4859	0	4877
11616	9	5	4868	30	0	4912
11617	11	4	16	4901	0	4932
11618	10	4	13	4975	0	5002
11619	9	5	4	5051	0	5069
11620	8	4953	10	35	0	5006
11621	10	14	7	4940	0	4971
11622	12	9	3	4921	0	4945
11623	4819	3	5	58	0	4885
11624	27	10	4710	22	0	4769
11625	19	8	4439	14	0	4480
11626	7	4742	25	19	0	4793
11627	10	14	18	4873	0	4915
11628	4877	10	10	33	0	4930
11629	26	7	4	4814	0	4851
11630	25	3	6	4881	0	4915
11631	8	5	4	4932	0	4949
11632	11	1	3	4819	0	4834
11633	14	6	6	4801	0	4827
11634	5	4	4769	43	0	4821
11635	13	3	14	4771	0	4801
11636	4790	4	9	45	0	4848
11637	23	4651	7	27	0	4708
11638	13	19	8	4735	0	4775
11639	12	12	2	4740	0	4766
11640	7	9	4457	35	0	4508
11641	13	5	17	4382	0	4417
11642	6	5	11	4669	0	4691
11643	4778	2	10	64	0	4854
11644	27	4889	6	33	0	4955
11645	23	30	5	5024	0	5082
11646	11	20	3	5088	0	5122
11647	10	9	5	5141	0	5165
11648	10	8	5108	64	0	5190
11649	4	9	4824	42	0	4879
11650	9	4967	54	30	0	5060
11651	7	5085	24	25	0	5141
11652	11	45	17	5041	0	5114
11653	12	4690	18	51	0	4771
11654	13	62	6	5345	0	5426
11655	9	21	6	5762	0	5798
11656	11	11	4	6105	0	6131
11657	11	10	8	7011	0	7040
11658	6	6	7253	157	0	7422
11659	20	7	99	7332	0	7458
11660	14	10	78	7519	0	7621
11661	12	7	30	7760	0	7809
11662	7487	12	27	277	0	7803
11663	117	7601	33	150	0	7901
11664	81	130	18	7379	0	7608
11665	27	7682	30	191	0	7930
11666	7505	153	18	176	0	7852
11667	6821	113	16	149	0	7099
11668	179	7569	12	99	0	7859
11669	110	7832	11	86	0	8039
11670	68	261	7582	62	0	7973
11671	62	7802	131	64	0	8059
11672	73	218	82	7656	0	8029
11673	7722	157	36	189	0	8104
11674	171	7811	34	129	0	8145
11675	115	216	38	7874	0	8243
11676	55	169	25	7949	0	8198
11677	54	83	33	8142	0	8312
11678	7874	82	23	291	0	8270
11679	166	81	7789	184	0	8220
11680	7614	54	141	144	0	7953
11681	187	7740	89	119	0	8135
11682	142	191	35	7823	0	8191
11683	83	116	7679	214	0	8092
11684	7447	55	168	183	0	7853
11685	210	7729	105	82	0	8126
11686	142	191	60	7648	0	8041
11687	85	7737	57	196	0	8075
11688	79	212	46	7804	0	8141
11689	70	142	33	7933	0	8178
11690	57	101	7634	290	0	8082
11691	55	79	7320	183	0	7637
11692	52	78	223	7429	0	7782
11693	34	69	7485	259	0	7847
11694	40	58	189	7529	0	7816
11695	58	45	152	7384	0	7639
11696	34	46	91	7757	0	7928
11697	7468	38	79	357	0	7942
11698	171	31	88	7671	0	7961
11699	114	27	7569	308	0	8018
11700	7572	28	191	255	0	8046
11701	193	25	121	7814	0	8153
11702	138	32	68	7953	0	8191
11703	7697	34	65	363	0	8159
11704	193	7744	72	224	0	8233
11705	165	147	56	7882	0	8250
11706	79	114	59	7760	0	8012
11707	7523	50	53	370	0	7996
11708	205	59	7432	243	0	7939
11709	140	60	158	7522	0	7880
11710	94	54	111	7618	0	7877
11711	79	55	53	7564	0	7751
11712	76	7336	59	368	0	7839
11713	79	157	61	7596	0	7893
11714	7363	104	46	343	0	7856
11715	190	7374	62	256	0	7882
11716	7286	187	62	193	0	7728
11717	214	7403	38	177	0	7832
11718	7448	212	34	193	0	7887
11719	245	163	7279	140	0	7827
11720	187	119	7233	137	0	7676
11721	7287	91	229	134	0	7741
11722	242	96	7352	104	0	7794
11723	192	64	201	7315	0	7772
11724	143	76	174	6795	0	7188
11725	123	54	99	7548	0	7824
11726	7356	49	96	326	0	7827
11727	202	50	7242	218	0	7712
11728	7232	44	195	170	0	7641
11729	223	49	146	7436	0	7854
11730	7442	38	87	289	0	7856
11731	252	44	71	7547	0	7914
11732	7679	50	63	291	0	8083
11733	278	40	59	8109	0	8486
11734	191	58	8157	283	0	8689
11735	8257	41	198	228	0	8724
11736	8553	38	149	174	0	8914
11737	379	45	74	8391	0	8889
11738	230	35	66	8372	0	8703
11739	145	8263	81	380	0	8869
11740	8190	178	64	243	0	8675
11741	284	8326	75	158	0	8843
11742	8167	198	75	180	0	8620
11743	302	123	8050	138	0	8613
11744	202	69	8022	115	0	8408
11745	137	53	7857	125	0	8172
11746	7806	67	307	115	0	8295
11747	270	7828	156	97	0	8351
11748	213	183	105	7810	0	8311
11749	7769	118	104	226	0	8217
11750	239	7777	104	170	0	8290
11751	204	336	75	7548	0	8163
11752	101	7641	79	253	0	8074
11753	125	7414	57	191	0	7787
11754	115	7514	44	118	0	7791
11755	6693	292	83	133	0	7201
11756	194	6640	40	102	0	6976
11757	90	5544	27	55	0	5716
11758	47	5270	12	44	0	5373
11759	5066	142	76	33	0	5317
11760	5051	64	37	31	0	5183
11761	137	33	4872	21	0	5063
11762	4722	20	82	26	0	4850
11763	4850	19	45	31	0	4945
11764	119	25	27	4752	0	4923
11765	4814	23	16	87	0	4940
11766	97	30	4690	45	0	4862
11767	53	4980	79	25	0	5137
11768	5014	88	39	26	0	5167
11769	105	61	23	5241	0	5430
11770	5250	28	7	96	0	5381
11771	105	25	5030	45	0	5205
11772	5075	26	69	29	0	5199
11773	110	24	31	5164	0	5329
11774	57	18	5088	81	0	5244
11775	37	4892	78	41	0	5048
11776	19	5103	43	28	0	5193
11777	45	116	25	4908	0	5094
11778	43	57	16	4850	0	4966
11779	26	4925	11	99	0	5061
11780	4916	81	13	50	0	5060
11781	4939	39	9	27	0	5014
11782	4898	26	10	32	0	4966
11783	132	4882	8	22	0	5044
11784	75	71	14	4744	0	4904
11785	37	4918	17	74	0	5046
11786	4875	89	17	43	0	5024
11787	4850	46	12	30	0	4938
11788	122	4764	9	28	0	4923
11789	4860	88	14	27	0	4989
11790	105	54	10	4823	0	4992
11791	63	30	7	4876	0	4976
11792	4879	23	11	134	0	5047
11793	4781	25	14	61	0	4881
11794	4866	25	7	34	0	4932
11795	150	21	7	4770	0	4948
11796	74	21	12	4864	0	4971
11797	44	29	4742	130	0	4945
11798	49	38	69	4700	0	4856
11799	47	25	37	4639	0	4748
11800	56	30	4464	118	0	4668
11801	54	28	4309	64	0	4455
11802	36	28	4506	38	0	4608
11803	34	29	125	4463	0	4651
11804	42	26	4476	97	0	4641
11805	47	25	95	4409	0	4576
11806	45	23	49	4520	0	4637
11807	41	31	4458	127	0	4657
11808	51	22	4469	69	0	4611
11809	37	21	115	4425	0	4598
11810	34	19	4638	121	0	4812
11811	47	29	4554	65	0	4695
11812	33	4569	123	50	0	4775
11813	4670	97	64	51	0	4882
11814	4705	50	45	46	0	4846
11815	4690	37	38	34	0	4799
11816	127	4567	33	34	0	4761
11817	67	4608	32	43	0	4750
11818	53	119	25	4616	0	4813
11819	44	62	36	4567	0	4709
11820	40	34	4477	123	0	4674
11821	59	21	100	4496	0	4676
11822	4574	18	62	116	0	4770
11823	111	26	39	4406	0	4582
11824	64	4561	32	112	0	4769
11825	4679	89	42	76	0	4886
11826	4739	53	30	45	0	4867
11827	4786	31	29	43	0	4889
11828	157	32	4616	43	0	4848
11829	96	52	94	4716	0	4958
11830	5171	35	63	120	0	5389
11831	139	36	5270	73	0	5518
11832	93	4999	127	51	0	5270
11833	53	4868	56	34	0	5011
11834	4505	110	41	35	0	4691
11835	102	4512	29	29	0	4672
11836	58	98	15	4378	0	4549
11837	31	41	4475	100	0	4647
11838	39	32	93	4501	0	4665
11839	4468	25	41	100	0	4634
11840	105	4423	30	45	0	4603
11841	4422	75	29	32	0	4558
11842	98	32	4360	30	0	4520
11843	68	35	89	4196	0	4388
11844	33	4453	44	82	0	4612
11845	42	95	34	4519	0	4690
11846	4523	40	17	113	0	4693
11847	4584	30	19	48	0	4681
11848	4585	23	22	31	0	4661
11849	4606	22	12	43	0	4683
11850	132	9	21	4472	0	4634
11851	58	14	4495	94	0	4661
11852	49	18	78	4393	0	4538
11853	43	4497	35	89	0	4664
11854	4569	79	22	57	0	4727
11855	104	31	4531	29	0	4695
11856	4458	20	89	33	0	4600
11857	108	17	34	4558	0	4717
11858	50	22	4737	88	0	4897
11859	44	9	84	4745	0	4882
11860	4818	13	37	96	0	4964
11861	4771	15	26	63	0	4875
11862	4828	12	22	31	0	4893
11863	132	19	4723	28	0	4902
11864	65	16	83	4757	0	4921
11865	38	20	4825	84	0	4967
11866	36	4771	89	52	0	4948
11867	4544	88	56	41	0	4729
11868	86	4489	25	37	0	4637
11869	4226	66	29	23	0	4344
11870	94	31	14	4124	0	4263
11871	40	4209	9	80	0	4338
11872	4284	62	25	24	0	4395
11873	73	23	4286	24	0	4406
11874	44	17	58	4244	0	4363
11875	4311	17	20	74	0	4422
11876	86	11	4263	22	0	4382
11877	37	10	75	4179	0	4301
11878	24	4065	17	86	0	4192
11879	34	60	23	4340	0	4457
11880	22	36	19	4394	0	4471
11881	4316	13	14	91	0	4434
11882	77	4306	11	33	0	4427
11883	34	67	13	4238	0	4352
11884	23	4281	15	89	0	4408
11885	25	72	8	4299	0	4404
11886	30	4375	9	75	0	4489
11887	4416	70	18	31	0	4535
11888	71	36	4399	31	0	4537
11889	46	22	64	4394	0	4526
11890	28	11	31	4428	0	4498
11891	29	12	19	4444	0	4504
11892	29	27	9	4384	0	4449
11893	25	12	4358	96	0	4491
11894	31	4485	68	41	0	4625
11895	4521	68	24	45	0	4658
11896	4599	32	14	33	0	4678
11897	86	4549	15	31	0	4681
11898	4639	79	19	30	0	4767
11899	4640	26	16	37	0	4719
11900	88	4726	11	30	0	4855
11901	61	80	8	4685	0	4834
11902	37	4777	21	57	0	4892
11903	4789	79	20	40	0	4928
11904	87	32	4641	29	0	4789
11905	4441	17	71	40	0	4569
11906	90	18	4764	35	0	4907
11907	46	21	74	4732	0	4873
11908	4808	25	29	78	0	4940
11909	99	12	4720	32	0	4863
11910	4540	15	75	42	0	4672
11911	4760	23	30	38	0	4851
11912	108	13	12	4792	0	4925
11913	51	4807	21	72	0	4951
11914	4966	83	15	36	0	5100
11915	94	29	12	4935	0	5070
11916	43	4813	11	82	0	4949
11917	4909	69	7	39	0	5024
11918	83	33	19	4929	0	5064
11919	47	5097	13	83	0	5240
11920	37	79	23	5249	0	5388
11921	5282	22	16	101	0	5421
11922	5258	13	13	53	0	5337
11923	5251	26	20	35	0	5332
11924	110	15	11	5105	0	5241
11925	44	8	18	5125	0	5195
11926	28	20	5083	87	0	5218
11927	39	36	61	5083	0	5219
11928	39	12	5276	85	0	5412
11929	28	13	4866	34	0	4941
11930	7	9	4590	16	0	4622
11931	4	4793	47	8	0	4852
11932	30	53	45	4608	0	4736
11933	8	5177	12	20	0	5217
11934	5397	62	5	20	0	5484
11935	5483	8	6	16	0	5513
11936	82	9	2	5716	0	5809
11937	21	9	5931	72	0	6033
11938	20	6	76	5893	0	5995
11939	9	10	6105	90	0	6214
11940	18	11	80	5960	0	6069
11941	6	6011	28	89	0	6134
11942	8	6241	25	27	0	6301
11943	6123	97	12	27	0	6259
11944	88	32	6253	16	0	6389
11945	43	21	82	6201	0	6347
11946	24	13	28	6366	0	6431
11947	6382	22	14	126	0	6544
11948	102	6388	14	40	0	6544
11949	6425	83	11	37	0	6556
11950	92	6502	15	36	0	6645
11951	6507	95	21	41	0	6664
11952	6659	34	10	55	0	6758
11953	126	20	15	6651	0	6812
11954	46	26	6638	104	0	6814
11955	6475	28	93	44	0	6640
11956	108	6712	26	20	0	6866
11957	6832	94	21	42	0	6989
11958	126	31	33	6541	0	6731
11959	57	18	12	6564	0	6651
11960	33	6524	14	131	0	6702
11961	56	97	6	6520	0	6679
11962	26	6664	13	108	0	6811
11963	48	102	12	6606	0	6768
11964	41	47	11	6553	0	6652
11965	6426	22	10	146	0	6604
11966	118	28	6400	47	0	6593
11967	41	6376	93	46	0	6556
11968	46	87	41	6451	0	6625
11969	6498	40	19	122	0	6679
11970	6579	34	11	63	0	6687
11971	6509	28	10	51	0	6598
11972	141	19	6400	44	0	6604
11973	6424	22	102	40	0	6588
11974	123	31	34	6563	0	6751
11975	6498	26	26	134	0	6684
11976	127	6439	20	56	0	6642
11977	60	105	17	6515	0	6697
11978	6442	36	16	140	0	6634
11979	135	6526	20	45	0	6726
11980	67	107	27	6654	0	6855
11981	40	60	6527	129	0	6756
11982	6668	25	94	95	0	6882
11983	6979	29	35	47	0	7090
11984	189	22	6914	33	0	7158
11985	85	6752	110	38	0	6985
11986	48	6976	52	26	0	7102
11987	64	127	39	6940	0	7170
11988	73	58	27	6623	0	6781
11989	65	39	18	6945	0	7067
11990	39	43	6913	167	0	7162
11991	6840	33	119	105	0	7097
11992	7258	39	44	67	0	7408
11993	7390	36	38	68	0	7532
11994	7397	25	28	72	0	7522
11995	7440	33	33	66	0	7572
11996	7527	25	24	50	0	7626
11997	239	22	24	7650	0	7935
11998	121	39	7607	178	0	7945
11999	77	46	7770	80	0	7973
12000	84	42	178	7876	0	8180
12001	82	26	70	7852	0	8030
12002	78	23	46	7951	0	8098
12003	58	7952	30	261	0	8301
12004	8060	171	42	114	0	8387
12005	214	8262	36	67	0	8579
12006	124	188	18	8186	0	8516
12007	8123	76	24	219	0	8442
12008	229	8077	28	112	0	8446
12009	117	186	24	8164	0	8491
12010	110	81	18	8278	0	8487
12011	92	58	27	8255	0	8432
12012	58	7966	42	272	0	8338
12013	70	179	34	8113	0	8396
12014	51	94	7931	264	0	8340
12015	73	35	178	8104	0	8390
12016	60	54	68	8192	0	8374
12017	70	56	41	8517	0	8684
12018	83	45	29	8735	0	8892
12019	59	55	8480	352	0	8946
12020	58	8522	236	197	0	9013
12021	78	257	72	8749	0	9156
12022	61	103	58	9087	0	9309
12023	52	63	50	9093	0	9258
12024	39	8594	29	434	0	9096
12025	55	9124	47	236	0	9462
12026	8935	340	34	153	0	9462
12027	289	128	29	8895	0	9341
12028	119	86	8657	327	0	9189
12029	67	8703	225	194	0	9189
12030	8438	265	91	168	0	8962
12031	263	108	8273	137	0	8781
12032	126	68	8289	99	0	8582
12033	71	83	8104	85	0	8343
12034	94	144	334	7664	0	8236
12035	41	63	7815	270	0	8189
12036	54	7362	273	149	0	7838
12037	51	206	130	7127	0	7514
12038	27	91	7205	247	0	7570
12039	53	67	262	7091	0	7473
12040	6997	63	103	289	0	7452
12041	195	35	7022	155	0	7407
12042	6803	54	248	119	0	7224
12043	232	7058	98	120	0	7508
12044	6949	213	89	82	0	7333
12045	250	91	72	6922	0	7335
12046	6912	59	58	264	0	7293
12047	6959	61	69	135	0	7224
12048	6876	42	51	118	0	7087
12049	304	6845	67	85	0	7301
12050	6869	224	56	75	0	7224
12051	6918	85	68	74	0	7145
12052	325	65	6591	72	0	7053
12053	173	6494	235	82	0	6984
12054	150	218	112	6484	0	6964
12055	120	103	83	6681	0	6987
12056	103	80	77	6725	0	6985
12057	87	61	6442	322	0	6912
12058	95	39	242	6528	0	6904
12059	69	60	6485	309	0	6923
12060	6478	46	250	178	0	6952
12061	6705	51	119	145	0	7020
12062	312	50	6569	122	0	7053
12063	6631	54	256	108	0	7049
12064	6839	51	98	117	0	7105
12065	6887	34	107	97	0	7125
12066	383	39	80	6623	0	7125
12067	220	41	6631	259	0	7151
12068	155	6635	247	130	0	7167
12069	150	219	102	6674	0	7145
12070	139	90	6709	258	0	7196
12071	130	73	6463	140	0	6806
12072	6356	65	286	137	0	6844
12073	226	6686	159	126	0	7197
12074	6819	226	96	118	0	7259
12075	6898	111	85	133	0	7227
12076	310	6784	97	109	0	7300
12077	6838	226	115	114	0	7293
12078	319	93	6935	93	0	7440
12079	174	90	6828	82	0	7174
12080	158	69	6867	76	0	7170
12081	148	6540	300	59	0	7047
12082	6384	203	213	57	0	6857
12083	6480	92	125	65	0	6762
12084	306	6106	124	55	0	6591
12085	176	6387	103	69	0	6735
12086	153	224	94	6313	0	6784
12087	112	137	87	6449	0	6785
12088	6377	100	62	253	0	6792
12089	234	6391	91	134	0	6850
12090	6410	210	68	124	0	6812
12091	6346	105	79	99	0	6629
12092	283	97	6163	66	0	6609
12093	175	6083	195	71	0	6524
12094	181	240	95	5997	0	6513
12095	5961	117	76	181	0	6335
12096	287	76	65	5868	0	6296
12097	5725	60	64	179	0	6028
12098	235	48	5460	81	0	5824
12099	139	5255	188	60	0	5642
12100	112	5367	77	73	0	5629
12101	127	181	107	5080	0	5495
12102	105	5360	75	132	0	5672
12103	5301	179	69	90	0	5639
12104	183	97	5164	71	0	5515
12105	4945	88	130	84	0	5247
12106	174	78	5182	72	0	5506
12107	109	57	142	5214	0	5522
12108	99	61	79	5254	0	5493
12109	126	54	56	5289	0	5525
12110	5265	46	63	193	0	5567
12111	205	35	5345	86	0	5671
12112	123	47	127	5386	0	5683
12113	107	56	73	5402	0	5638
12114	106	5248	67	164	0	5585
12115	100	5282	55	106	0	5543
12116	93	5366	63	95	0	5617
12117	79	160	45	5111	0	5395
12118	65	67	32	4857	0	5021
12119	28	4442	16	85	0	4571
12120	27	4488	14	41	0	4570
12121	4446	40	30	36	0	4552
12122	44	44	11	4376	0	4475
12123	14	4291	6	20	0	4331
12124	4337	14	18	15	0	4384
12125	23	8	6	4398	0	4435
12126	4933	3	5	30	0	4971
12127	56	1	1	5121	0	5179
12128	17	2	5292	52	0	5363
12129	11	5326	41	18	0	5396
12130	5249	42	11	28	0	5330
12131	38	21	5389	5	0	5453
12132	16	5355	39	10	0	5420
12133	12	36	14	5332	0	5394
12134	8	14	11	5359	0	5392
12135	14	12	1	5220	0	5247
12136	16	1	2	5118	0	5137
12137	4	5	5268	49	0	5326
12138	1	5216	33	16	0	5266
12139	4	32	11	5236	0	5283
12140	5149	13	5	53	0	5220
12141	30	5214	5	15	0	5264
12142	22	29	1	5551	0	5603
12143	13	15	5476	53	0	5557
12144	1	5540	58	22	0	5621
12145	23	57	22	5121	0	5223
12146	2	5791	15	30	0	5838
12147	5874	69	1	30	0	5974
12148	5971	24	3	27	0	6025
12149	91	12	5815	6	0	5924
12150	5849	6	64	19	0	5938
12151	6069	1	20	17	0	6107
12152	95	9	5910	0	0	6014
12153	44	5930	62	2	0	6038
12154	35	60	20	5968	0	6083
12155	15	20	15	6169	0	6219
12156	6109	13	4	107	0	6233
12157	80	3	2	6147	0	6232
12158	31	4	6130	91	0	6256
12159	5844	11	75	37	0	5967
12160	80	5	5963	24	0	6072
12161	32	6003	87	7	0	6129
12162	5870	82	25	15	0	5992
12163	84	25	5870	12	0	5991
12164	31	20	5686	6	0	5743
12165	21	5872	93	4	0	5990
12166	22	77	39	5921	0	6059
12167	10	36	5818	68	0	5932
12168	29	24	77	5232	0	5362
12169	21	2	28	5800	0	5851
12170	9	6	5721	103	0	5839
12171	13	5692	77	46	0	5828
12172	18	69	28	5733	0	5848
12173	5561	29	30	95	0	5715
12174	5532	18	8	40	0	5598
12175	105	5	8	5554	0	5672
12176	44	13	5466	84	0	5607
12177	33	13	5552	28	0	5626
12178	13	6	118	5538	0	5675
12179	11	7	5556	91	0	5665
12180	5428	9	99	43	0	5579
12181	105	4	36	5587	0	5732
12182	33	8	28	5677	0	5746
12183	27	5617	13	121	0	5778
12184	17	93	11	5796	0	5917
12185	10	29	5683	123	0	5845
12186	5449	27	102	50	0	5628
12187	5701	8	30	48	0	5787
12188	141	4	5661	17	0	5823
12189	60	8	112	5788	0	5968
12190	28	9	34	5947	0	6018
12191	14	7	5892	144	0	6057
12192	25	5	123	5970	0	6123
12193	28	6	39	6015	0	6088
12194	14	6193	39	158	0	6404
12195	26	129	14	6691	0	6860
12196	19	37	12	6872	0	6940
12197	6918	20	21	246	0	7205
12198	7199	14	15	100	0	7328
12199	7378	10	13	74	0	7475
12200	7338	8	21	38	0	7405
12201	7309	12	10	34	0	7365
12202	289	12	6932	32	0	7265
12203	130	9	191	6930	0	7260
12204	79	7	63	7140	0	7289
12205	37	8	7032	258	0	7335
12206	6716	7	210	105	0	7038
12207	7018	6	63	74	0	7161
12208	257	13	6473	48	0	6791
12209	6928	8	181	43	0	7160
12210	7118	6	57	54	0	7235
12211	267	10	6870	39	0	7186
12212	142	13	218	6654	0	7027
12213	82	6880	76	190	0	7228
12214	55	191	53	7165	0	7464
12215	63	65	25	7330	0	7483
12216	72	32	16	7301	0	7421
12217	34	12	7100	303	0	7449
12218	6988	9	212	139	0	7348
12219	7261	14	74	88	0	7437
12220	294	11	64	7090	0	7459
12221	127	10	6963	229	0	7329
12222	103	19	211	6914	0	7247
12223	39	11	7040	257	0	7347
12224	43	11	7186	105	0	7345
12225	44	7114	258	75	0	7491
12226	69	170	114	6574	0	6927
12227	6507	57	61	213	0	6838
12228	6327	35	28	91	0	6481
12229	6378	18	31	63	0	6490
12230	288	10	23	6148	0	6469
12231	113	6223	20	202	0	6558
12232	74	181	23	6420	0	6698
12233	45	64	6597	241	0	6947
12234	7064	37	201	104	0	7406
12235	7578	14	79	71	0	7742
12236	324	7	53	7432	0	7816
12237	128	15	35	7631	0	7809
12238	88	21	31	7689	0	7829
12239	58	8	7353	338	0	7757
12240	6906	14	241	159	0	7320
12241	251	7158	90	97	0	7596
12242	89	7156	52	68	0	7365
12243	76	225	7061	47	0	7409
12244	80	102	204	6882	0	7268
12245	48	45	7022	229	0	7344
12246	6688	46	228	94	0	7056
12247	233	21	75	6775	0	7104
12248	91	19	6691	214	0	7015
12249	63	6802	207	85	0	7157
12250	6849	182	73	79	0	7183
12251	229	59	6989	57	0	7334
12252	92	6742	221	50	0	7105
12253	67	7065	76	51	0	7259
12254	7084	233	56	40	0	7413
12255	241	81	46	7030	0	7398
12256	98	46	7266	219	0	7629
12257	52	7266	208	91	0	7617
12258	7342	205	78	75	0	7700
12259	7515	64	49	63	0	7691
12260	276	7357	49	43	0	7725
12261	103	220	7513	45	0	7881
12262	88	76	224	7567	0	7955
12263	7583	49	86	225	0	7943
12264	7718	26	56	95	0	7895
12265	287	31	7559	69	0	7946
12266	138	35	213	7473	0	7859
12267	105	26	85	7775	0	7991
12268	59	24	7691	282	0	8056
12269	61	45	7594	102	0	7802
12270	7664	32	274	84	0	8054
12271	7999	28	108	69	0	8204
12272	8062	28	78	62	0	8230
12273	8137	24	47	58	0	8266
12274	326	26	7751	39	0	8142
12275	7849	19	227	52	0	8147
12276	296	22	82	7805	0	8205
12277	117	30	7938	209	0	8294
12278	93	32	7947	94	0	8166
12279	79	7875	255	81	0	8290
12280	68	186	118	7830	0	8202
12281	59	76	7939	210	0	8284
12282	7720	42	228	110	0	8100
12283	243	33	103	7329	0	7708
12284	115	7825	74	180	0	8194
12285	7889	187	57	90	0	8223
12286	7943	67	68	70	0	8148
12287	271	50	7801	58	0	8180
12288	134	7673	209	49	0	8065
12289	96	177	97	7643	0	8013
12290	7632	72	74	201	0	7979
12291	253	39	49	7582	0	7923
12292	110	37	7321	195	0	7663
12293	6718	28	167	103	0	7016
12294	179	7060	97	71	0	7407
12295	76	6527	57	54	0	6714
12296	50	6937	44	45	0	7076
12297	6642	169	99	66	0	6976
12298	6575	57	43	31	0	6706
12299	6628	33	24	31	0	6716
12300	156	33	25	6497	0	6711
12301	69	21	6585	119	0	6794
12302	62	15	112	6645	0	6834
12303	6725	17	46	132	0	6920
12304	140	21	31	6785	0	6977
12305	7002	20	30	134	0	7186
12306	7013	22	30	67	0	7132
12307	6999	20	27	49	0	7095
12308	134	6962	32	45	0	7173
12309	6990	109	32	38	0	7169
12310	155	36	6871	29	0	7091
12311	95	24	6900	25	0	7044
12312	50	6818	126	33	0	7027
12313	70	102	63	6587	0	6822
12314	6598	34	39	105	0	6776
12315	126	20	6526	40	0	6712
12316	6441	21	97	37	0	6596
12317	137	11	45	6498	0	6691
12318	67	6574	31	100	0	6772
12319	57	88	33	6748	0	6926
12320	46	45	6685	103	0	6879
12321	6422	25	106	57	0	6610
12322	125	24	6801	24	0	6974
12323	54	21	6487	23	0	6585
12324	6300	19	115	30	0	6464
12325	112	6423	43	22	0	6600
12326	6625	83	21	34	0	6763
12327	6651	27	27	38	0	6743
12328	132	22	6522	10	0	6686
12329	6399	21	111	38	0	6569
12330	120	22	6514	32	0	6688
12331	52	26	6388	31	0	6497
12332	40	16	6479	30	0	6565
12333	34	6213	123	23	0	6393
12334	5688	93	136	44	0	5961
12335	5659	26	26	44	0	5755
12336	5682	9	18	27	0	5736
12337	5699	7	20	22	0	5748
12338	91	15	5690	11	0	5807
12339	52	9	52	5680	0	5793
12340	41	12	24	5691	0	5768
12341	5787	7	22	77	0	5893
12342	61	5752	18	28	0	5859
12343	38	42	16	5728	0	5824
12344	5687	19	19	66	0	5791
12345	67	8	5726	26	0	5827
12346	45	16	58	5567	0	5686
12347	23	14	5713	56	0	5806
12348	30	5657	58	25	0	5770
12349	43	58	28	5501	0	5630
12350	5433	16	14	52	0	5515
12351	58	10	14	5425	0	5507
12352	28	6	5483	57	0	5574
12353	17	5489	46	36	0	5588
12354	5429	46	24	32	0	5531
12355	54	22	5423	9	0	5508
12356	5253	9	51	28	0	5341
12357	63	5442	26	9	0	5540
12358	5502	51	27	17	0	5597
12359	5556	19	8	34	0	5617
12360	88	9	11	5519	0	5627
12361	36	11	5498	51	0	5596
12362	17	5485	56	34	0	5592
12363	27	54	25	5684	0	5790
12364	24	24	19	5669	0	5736
12365	18	15	15	5902	0	5950
12366	25	12	9	6071	0	6117
12367	18	6801	13	120	0	6952
12368	7296	88	17	76	0	7477
12369	133	7371	15	20	0	7539
12370	79	149	8	7875	0	8111
12371	8000	53	8	178	0	8239
12372	192	24	11	8066	0	8293
12373	80	24	7946	192	0	8242
12374	42	7959	163	80	0	8244
12375	66	162	71	7992	0	8291
12376	53	84	36	8159	0	8332
12377	7765	37	14	263	0	8079
12378	195	22	7693	118	0	8028
12379	7656	26	160	82	0	7924
12380	7810	26	76	54	0	7966
12381	7826	34	31	52	0	7943
12382	266	30	7607	48	0	7951
12383	140	22	166	7499	0	7827
12384	104	23	72	7688	0	7887
12385	48	21	7659	255	0	7983
12386	62	22	7677	120	0	7881
12387	7673	29	228	78	0	8008
12388	225	12	106	7819	0	8162
12389	7936	22	63	219	0	8240
12390	8176	13	39	135	0	8363
12391	290	12	36	8105	0	8443
12392	148	12	8556	207	0	8923
12393	8296	7	242	138	0	8683
12394	272	18	98	8748	0	9136
12395	133	12	8730	250	0	9125
12396	87	8561	213	127	0	8988
12397	8553	187	104	95	0	8939
12398	226	8627	78	74	0	9005
12399	164	230	68	8010	0	8472
12400	117	8717	38	208	0	9080
12401	8381	250	36	166	0	8833
12402	8613	104	71	94	0	8882
12403	319	8505	36	78	0	8938
12404	8565	218	44	87	0	8914
12405	8413	121	44	86	0	8664
12406	329	8172	45	99	0	8645
12407	8279	246	53	70	0	8648
12408	318	121	32	8091	0	8562
12409	219	60	31	8292	0	8602
12410	8175	66	43	318	0	8602
12411	342	38	41	7756	0	8177
12412	194	7876	51	249	0	8370
12413	7847	254	33	150	0	8284
12414	7980	97	35	114	0	8226
12415	331	7875	45	93	0	8344
12416	7957	243	49	101	0	8350
12417	8100	111	43	83	0	8337
12418	368	91	42	7752	0	8253
12419	233	64	7680	244	0	8221
12420	177	7672	216	147	0	8212
12421	7779	227	101	120	0	8227
12422	7904	132	46	88	0	8170
12423	414	78	7581	87	0	8160
12424	7757	54	220	109	0	8140
12425	351	52	7509	91	0	8003
12426	7616	52	261	87	0	8016
12427	344	92	118	7507	0	8061
12428	223	74	7455	250	0	8002
12429	163	74	7533	152	0	7922
12430	141	97	299	7334	0	7871
12431	157	73	132	7414	0	7776
12432	110	83	7148	316	0	7657
12433	160	66	223	7186	0	7635
12434	168	56	7176	285	0	7685
12435	148	59	279	7057	0	7543
12436	157	53	143	7051	0	7404
12437	154	6730	74	333	0	7291
12438	143	6769	80	200	0	7192
12439	134	7044	90	130	0	7398
12440	116	296	75	6909	0	7396
12441	126	137	86	7095	0	7444
12442	107	75	6824	392	0	7398
12443	6719	57	238	244	0	7258
12444	6999	84	127	139	0	7349
12445	346	6783	97	118	0	7344
12446	6976	258	71	102	0	7407
12447	352	130	60	6819	0	7361
12448	6933	77	71	313	0	7394
12449	7070	63	98	161	0	7392
12450	418	70	51	6876	0	7415
12451	6743	62	59	287	0	7151
12452	287	6480	82	172	0	7021
12453	193	6731	52	132	0	7108
12454	168	299	64	6380	0	6911
12455	174	6611	66	226	0	7077
12456	173	252	54	6403	0	6882
12457	146	135	58	6581	0	6920
12458	6343	80	57	306	0	6786
12459	293	6168	59	171	0	6691
12460	6120	234	53	130	0	6537
12461	6044	111	63	128	0	6346
12462	300	6028	64	114	0	6506
12463	6047	207	54	126	0	6434
12464	310	106	5900	121	0	6437
12465	157	5748	186	102	0	6193
12466	5525	211	90	103	0	5929
12467	225	72	4779	66	0	5142
12468	96	4137	119	49	0	4401
12469	74	4182	96	50	0	4402
12470	3574	106	79	33	0	3792
12471	3528	54	28	32	0	3642
12472	3486	52	18	26	0	3582
12473	141	3407	18	16	0	3582
12474	75	80	18	3454	0	3627
12475	3465	47	18	92	0	3622
12476	3539	32	12	49	0	3632
12477	116	26	20	3450	0	3612
12478	73	29	3442	78	0	3622
12479	56	27	3449	38	0	3570
12480	38	31	91	3472	0	3632
12481	37	18	42	3534	0	3631
12482	34	17	3434	102	0	3587
12483	51	15	79	3329	0	3474
12484	40	3374	40	99	0	3553
12485	3361	73	35	52	0	3521
12486	90	48	22	3347	0	3507
12487	3257	21	17	97	0	3392
12488	93	3281	18	51	0	3443
12489	66	3322	18	39	0	3445
12490	3225	77	24	50	0	3376
12491	77	39	3116	26	0	3258
12492	2471	42	45	22	0	2580
12493	53	2543	20	9	0	2625
12494	38	21	20	2242	0	2321
12495	2254	13	8	29	0	2304
12496	34	13	3	2234	0	2284
12497	2301	11	4	34	0	2350
12498	2297	6	3	25	0	2331
12499	36	2453	6	11	0	2506
12500	2377	18	2	17	0	2414
12501	24	2337	4	8	0	2373
12502	2349	16	4	7	0	2376
12503	25	9	0	2355	0	2389
12504	2403	7	1	22	0	2433
12505	22	3	3	2441	0	2469
12506	2529	1	2	23	0	2555
12507	2553	6	0	21	0	2580
12508	2588	2	4	7	0	2601
12509	2585	2	3	15	0	2605
12510	2569	5	3	6	0	2583
12511	29	4	1	2602	0	2636
12512	2576	4	3	22	0	2605
12513	25	2516	2	14	0	2557
12514	13	17	2534	6	0	2570
12515	13	8	13	2535	0	2569
12516	7	5	2615	17	0	2644
12517	13	1	15	2698	0	2727
12518	8	3	2767	19	0	2797
12519	2751	3	15	15	0	2784
12520	27	0	9	2845	0	2881
12521	17	3	2828	15	0	2863
12522	9	5	2921	10	0	2945
12523	12	10	23	2954	0	2999
12524	3251	7	10	31	0	3299
12525	24	3440	9	8	0	3481
12526	3475	23	4	14	0	3516
12527	3487	15	2	6	0	3510
12528	46	3486	3	6	0	3541
12529	3642	30	2	14	0	3688
12530	53	13	1	3641	0	3708
12531	25	8	1	3667	0	3701
12532	16	9	1	3687	0	3713
12533	3661	1	4	53	0	3719
12534	29	3714	2	26	0	3771
12535	20	29	3	3812	0	3864
12536	11	14	0	3895	0	3920
12537	3863	6	4	51	0	3924
12538	41	6	2	3851	0	3900
12539	18	5	3994	45	0	4062
12540	13	4275	41	27	0	4356
12541	4353	52	17	13	0	4435
12542	67	30	8	4277	0	4382
12543	25	4420	10	47	0	4502
12544	4452	61	8	25	0	4546
12545	69	25	4392	18	0	4504
12546	28	4416	49	14	0	4507
12547	4499	57	25	21	0	4602
12548	70	37	12	4452	0	4571
12549	41	15	11	4480	0	4547
12550	20	15	4465	76	0	4576
12551	24	9	55	4430	0	4518
12552	13	2	4793	80	0	4888
12553	5	3	4592	41	0	4641
12554	11	11	4868	24	0	4914
12555	4946	6	93	38	0	5083
12556	5064	2	45	21	0	5132
12557	5136	5	27	15	0	5183
12558	105	1	16	5023	0	5145
12559	47	5029	8	54	0	5138
12560	31	5183	7	22	0	5243
12561	5264	74	1	30	0	5369
12562	5234	32	4	36	0	5306
12563	69	5251	5	12	0	5337
12564	5187	58	5	13	0	5263
12565	77	26	5074	8	0	5185
12566	34	17	5010	7	0	5068
12567	23	16	71	4879	0	4989
12568	24	6	35	5179	0	5244
12569	14	5	5164	69	0	5252
12570	23	3	64	5016	0	5106
12571	5103	3	25	92	0	5223
12572	57	5	5093	41	0	5196
12573	5016	5	61	35	0	5117
12574	73	5	29	5236	0	5343
12575	39	6	5370	56	0	5471
12576	26	5414	70	20	0	5530
12577	5501	54	25	31	0	5611
12578	68	23	5404	16	0	5511
12579	5354	12	69	14	0	5449
12580	73	15	29	5430	0	5547
12581	5455	9	19	65	0	5548
12582	77	5	5804	27	0	5913
12583	50	5	61	5897	0	6013
12584	6099	6	22	92	0	6219
12585	6220	8	22	40	0	6290
12586	6353	5	19	37	0	6414
12587	6386	4	12	21	0	6423
12588	110	3	8	6154	0	6275
12589	58	3	12	6178	0	6251
12590	34	7	6179	80	0	6300
12591	31	6	67	6147	0	6251
12592	24	4	25	6049	0	6102
12593	10	6282	20	102	0	6414
12594	6433	68	19	56	0	6576
12595	6783	22	7	48	0	6860
12596	105	7156	15	22	0	7298
12597	51	113	2	7149	0	7315
12598	47	33	5	7283	0	7368
12599	7023	15	5	157	0	7200
12600	116	24	7262	56	0	7458
12601	58	8	106	7396	0	7568
12602	32	6	7519	130	0	7687
12603	7346	8	122	60	0	7536
12604	7593	7	48	40	0	7688
12605	7763	3	22	58	0	7846
12606	173	7	22	7618	0	7820
12607	81	5	15	7675	0	7776
12608	7694	4	5	170	0	7873
12609	139	6	7593	63	0	7801
12610	59	7	116	7691	0	7873
12611	7737	7	43	147	0	7934
12612	154	7	20	7799	0	7980
12613	55	6	8216	136	0	8413
12614	40	15	7931	63	0	8049
12615	8022	4	142	55	0	8223
12616	125	8290	54	29	0	8498
12617	8583	117	49	55	0	8804
12618	8770	33	29	32	0	8864
12619	179	19	14	8747	0	8959
12620	73	20	12	8731	0	8836
12621	47	8661	14	150	0	8872
12622	8591	116	9	80	0	8796
12623	126	8572	22	51	0	8771
12624	47	8604	12	44	0	8707
12625	53	128	16	8370	0	8567
12626	8399	38	17	120	0	8574
12627	8516	21	13	50	0	8600
12628	148	15	13	8401	0	8577
12629	75	14	7	8305	0	8401
12630	48	8	8	8361	0	8425
12631	8205	7	11	154	0	8377
12632	129	16	8198	63	0	8406
12633	46	8241	101	56	0	8444
12634	8252	98	34	47	0	8431
12635	136	55	32	8203	0	8426
12636	63	17	8208	118	0	8406
12637	46	20	8156	48	0	8270
12638	27	8292	130	44	0	8493
12639	22	8502	60	31	0	8615
12640	44	116	37	8153	0	8350
12641	38	7355	37	87	0	7517
12642	25	91	10	7997	0	8123
12643	34	23	12	8189	0	8258
12644	8209	11	10	126	0	8356
12645	98	16	6	8217	0	8337
12646	45	9	11	8295	0	8360
12647	28	16	8164	113	0	8321
12648	42	10	83	8244	0	8379
12649	8289	21	23	126	0	8459
12650	8356	11	14	62	0	8443
12651	124	8516	20	29	0	8689
12652	8297	95	3	47	0	8442
12653	129	33	8251	25	0	8438
12654	42	8388	100	41	0	8571
12655	40	103	29	8520	0	8692
12656	42	35	10	8655	0	8742
12657	39	24	21	8742	0	8826
12658	8643	20	26	169	0	8858
12659	8378	18	11	76	0	8483
12660	134	19	8443	40	0	8636
12661	59	17	8304	44	0	8424
12662	40	20	8476	34	0	8570
12663	49	8446	134	37	0	8666
12664	47	8681	41	33	0	8802
12665	8635	143	23	56	0	8857
12666	8734	47	15	55	0	8851
12667	159	24	23	8874	0	9080
12668	58	18	15	8846	0	8937
12669	44	8933	24	159	0	9160
12670	45	121	16	9157	0	9339
12671	36	41	9058	151	0	9286
12672	29	9026	135	68	0	9258
12673	35	120	58	9194	0	9407
12674	21	51	9243	137	0	9452
12675	69	30	119	8779	0	8997
12676	45	9055	43	135	0	9278
12677	9276	135	26	84	0	9521
12678	9348	45	17	61	0	9471
12679	9564	31	14	64	0	9673
12680	185	30	19	9548	0	9782
12681	72	35	15	9827	0	9949
12682	9493	36	12	223	0	9764
12683	174	9529	17	79	0	9799
12684	9640	165	18	78	0	9901
12685	187	42	10375	44	0	10648
12686	10409	29	190	67	0	10695
12687	10913	27	46	82	0	11068
12688	301	17	34	10719	0	11071
12689	10937	29	21	256	0	11243
12690	11378	25	18	106	0	11527
12691	333	31	18	11256	0	11638
12692	126	18	11123	261	0	11528
12693	10692	18	235	139	0	11084
12694	276	23	11070	56	0	11425
12695	111	11070	223	47	0	11451
12696	78	183	89	11017	0	11367
12697	69	53	30	11414	0	11566
12698	12111	22	28	289	0	12450
12699	272	20	12216	90	0	12598
12700	116	34	249	11785	0	12184
12701	65	11940	74	232	0	12311
12702	43	12142	44	103	0	12332
12703	70	288	18	12171	0	12547
12704	53	75	12024	273	0	12425
12705	66	30	239	12005	0	12340
12706	71	32	85	12062	0	12250
12707	42	41	11748	296	0	12127
12708	16	11982	228	121	0	12347
12709	11642	251	74	102	0	12069
12710	221	11967	40	63	0	12291
12711	104	239	29	11926	0	12298
12712	11525	73	41	289	0	11928
12713	232	11409	50	100	0	11791
12714	88	253	11305	68	0	11714
12715	11049	94	235	69	0	11447
12716	237	11459	91	49	0	11836
12717	11311	243	46	77	0	11677
12718	282	104	10887	48	0	11321
12719	10945	58	232	79	0	11314
12720	301	35	91	11007	0	11434
12721	122	53	11005	249	0	11429
12722	88	50	246	10790	0	11174
12723	65	10739	84	269	0	11157
12724	72	250	50	11034	0	11406
12725	81	92	30	11155	0	11358
12726	69	58	10743	325	0	11195
12727	79	42	252	10832	0	11205
12728	65	72	9570	314	0	10021
12729	55	10832	208	126	0	11221
12730	73	258	72	10901	0	11304
12731	58	107	10912	283	0	11360
12732	54	10847	254	142	0	11297
12733	65	11285	104	98	0	11552
12734	59	301	11154	62	0	11576
12735	63	104	11070	71	0	11308
12736	63	66	321	10872	0	11322
12737	10725	61	107	321	0	11214
12738	260	10758	58	142	0	11218
12739	115	269	59	10638	0	11081
12740	10630	99	54	300	0	11083
12741	283	10703	57	120	0	11163
12742	10654	270	52	104	0	11080
12743	294	10858	66	65	0	11283
12744	10841	303	37	92	0	11273
12745	10811	102	38	88	0	11039
12746	10975	77	47	72	0	11171
12747	366	11134	52	77	0	11629
12748	156	295	56	11321	0	11828
12749	111	118	11102	303	0	11634
12750	109	11064	298	124	0	11595
12751	151	315	104	10766	0	11336
12752	120	135	59	11017	0	11331
12753	95	72	10535	365	0	11067
12754	97	10326	267	173	0	10863
12755	10198	281	138	103	0	10720
12756	294	10238	69	88	0	10689
12757	140	283	61	10200	0	10684
12758	92	119	10181	310	0	10702
12759	9851	81	284	136	0	10352
12760	313	74	101	10296	0	10784
12761	123	56	10102	317	0	10598
12762	9589	80	292	148	0	10109
12763	282	9888	107	106	0	10383
12764	9974	284	83	104	0	10445
12765	10112	124	60	113	0	10409
12766	345	69	62	9930	0	10406
12767	132	71	9777	289	0	10269
12768	97	9710	271	138	0	10216
12769	57	288	9609	104	0	10058
12770	93	142	272	9386	0	9893
12771	87	107	103	9740	0	10037
12772	9450	76	87	369	0	9982
12773	286	67	9364	162	0	9879
12774	109	9217	277	100	0	9703
12775	93	277	125	9213	0	9708
12776	78	124	76	9448	0	9726
12777	9065	89	56	351	0	9561
12778	310	9106	54	142	0	9612
12779	134	260	63	8891	0	9348
12780	8595	134	53	303	0	9085
12781	247	8618	57	143	0	9065
12782	8423	240	60	92	0	8815
12783	8366	115	54	73	0	8608
12784	302	8136	49	92	0	8579
12785	6987	164	31	71	0	7253
12786	196	6999	34	43	0	7272
12787	6884	168	33	48	0	7133
12788	6884	72	37	61	0	7054
12789	224	6736	23	53	0	7036
12790	6304	150	18	52	0	6524
12791	6558	58	25	38	0	6679
12792	6548	54	18	51	0	6671
12793	192	40	6326	43	0	6601
12794	88	29	6136	41	0	6294
12795	41	49	6113	39	0	6242
12796	5941	62	195	30	0	6228
12797	154	30	5772	30	0	5986
12798	65	45	4901	23	0	5034
12799	68	49	116	4427	0	4660
12800	4514	13	53	96	0	4676
12801	100	21	4547	29	0	4697
12802	59	17	4648	28	0	4752
12803	40	19	122	4576	0	4757
12804	43	16	53	4625	0	4737
12805	36	14	24	4689	0	4763
12806	42	17	4576	114	0	4749
12807	37	9	118	4544	0	4708
12808	4499	21	50	114	0	4684
12809	104	4542	26	52	0	4724
12810	50	91	24	4561	0	4726
12811	39	33	23	4622	0	4717
12812	35	27	4579	109	0	4750
12813	26	4498	88	62	0	4674
12814	4518	85	35	46	0	4684
12815	105	4560	30	29	0	4724
12816	45	99	28	4500	0	4672
12817	39	34	4486	116	0	4675
12818	38	24	111	4611	0	4784
12819	39	33	41	4737	0	4850
12820	4778	10	33	139	0	4960
12821	107	36	33	4603	0	4779
12822	55	4629	30	134	0	4848
12823	40	5005	37	55	0	5137
12824	27	119	5019	46	0	5211
12825	5027	49	120	48	0	5244
12826	144	26	54	5088	0	5312
12827	67	22	35	5194	0	5318
12828	43	33	27	5205	0	5308
12829	5202	23	28	171	0	5424
12830	121	5249	41	85	0	5496
12831	5232	109	10	69	0	5420
12832	131	52	4990	45	0	5218
12833	61	30	4956	45	0	5092
12834	5010	16	144	58	0	5228
12835	163	20	72	4960	0	5215
12836	56	34	38	5077	0	5205
12837	61	15	28	5133	0	5237
12838	31	22	5037	164	0	5254
12839	4998	18	125	74	0	5215
12840	5082	20	47	62	0	5211
12841	5011	15	31	57	0	5114
12842	166	17	25	4906	0	5114
12843	79	14	4758	141	0	4992
12844	54	18	4756	66	0	4894
12845	45	29	4884	63	0	5021
12846	46	4692	139	40	0	4917
12847	65	116	103	4206	0	4490
12848	4177	30	46	94	0	4347
12849	82	23	4219	56	0	4380
12850	4291	5	85	59	0	4440
12851	104	13	39	4322	0	4478
12852	55	11	29	4318	0	4413
12853	40	4172	26	116	0	4354
12854	39	4263	24	62	0	4388
12855	30	4409	33	37	0	4509
12856	34	107	31	4410	0	4582
12857	4353	34	33	100	0	4520
12858	4374	25	28	63	0	4490
12859	102	16	4267	49	0	4434
12860	4222	10	78	55	0	4365
12861	93	18	4241	42	0	4394
12862	62	14	95	4243	0	4414
12863	50	12	4217	93	0	4372
12864	4219	14	106	53	0	4392
12865	100	18	45	4321	0	4484
12866	49	13	4466	93	0	4621
12867	37	18	4298	56	0	4409
12868	4318	12	110	58	0	4498
12869	4441	21	58	37	0	4557
12870	104	4481	34	35	0	4654
12871	59	73	27	4593	0	4752
12872	43	44	4548	92	0	4727
12873	42	20	4540	54	0	4656
12874	40	25	101	4599	0	4765
12875	4634	17	70	104	0	4825
12876	89	4601	39	50	0	4779
12877	45	73	25	4725	0	4868
12878	4703	40	26	105	0	4874
12879	94	24	18	4728	0	4864
12880	57	4679	21	100	0	4857
12881	48	76	23	4803	0	4950
12882	4764	34	32	103	0	4933
12883	109	22	22	4777	0	4930
12884	4772	14	27	109	0	4922
12885	96	4833	31	54	0	5014
12886	4884	73	30	54	0	5041
12887	105	33	4758	38	0	4934
12888	4713	21	89	43	0	4866
12889	4874	16	59	35	0	4984
12890	116	4848	40	40	0	5044
12891	66	81	34	4692	0	4873
12892	46	36	4710	68	0	4860
12893	40	31	4554	51	0	4676
12894	4341	35	99	69	0	4544
12895	4271	16	44	42	0	4373
12896	75	4249	26	41	0	4391
12897	51	4374	18	31	0	4474
12898	4350	66	19	23	0	4458
12899	66	4324	19	13	0	4422
12900	40	4442	23	31	0	4536
12901	44	60	20	4458	0	4582
12902	24	33	22	4418	0	4497
12903	30	25	4419	81	0	4555
12904	36	12	48	4408	0	4504
12905	4417	12	31	83	0	4543
12906	59	12	4376	52	0	4499
12907	62	12	4295	34	0	4403
12908	46	12	71	4317	0	4446
12909	40	18	36	4445	0	4539
12910	40	11	26	4445	0	4522
12911	32	16	4371	75	0	4494
12912	25	10	58	4285	0	4378
12913	30	20	41	4539	0	4630
12914	4471	18	24	75	0	4588
12915	55	4458	22	50	0	4585
12916	4498	47	21	35	0	4601
12917	84	21	4528	21	0	4654
12918	4156	18	61	25	0	4260
12919	60	4418	27	15	0	4520
12920	4155	23	28	16	0	4222
12921	34	4151	7	9	0	4201
12922	3950	32	17	17	0	4016
12923	24	3807	4	4	0	3839
12924	7	3752	4	4	0	3767
12925	13	19	16	3749	0	3797
12926	3756	5	1	17	0	3779
12927	3739	4	2	5	0	3750
12928	3732	2	1	9	0	3744
12929	17	3	3649	1	0	3670
12930	14	3	3657	1	0	3675
12931	7	9	17	3821	0	3854
12932	3	3871	9	13	0	3896
12933	3	3982	6	4	0	3995
12934	4	17	0	3908	0	3929
12935	3937	11	2	21	0	3971
12936	3931	3	4	17	0	3955
12937	3959	5	2	10	0	3976
12938	25	2	3919	6	0	3952
12939	12	6	17	4002	0	4037
12940	13	8	4042	21	0	4084
12941	4047	2	19	15	0	4083
12942	4132	2	8	13	0	4155
12943	36	4	4140	3	0	4183
12944	22	3	20	4136	0	4181
12945	4225	4	12	35	0	4276
12946	31	4	9	4351	0	4395
12947	15	4	2	4376	0	4397
12948	24	4	7	4348	0	4383
12949	4743	4	6	57	0	4810
12950	58	0	4	5072	0	5134
12951	5342	1	6	77	0	5426
12952	91	5860	6	28	0	5985
12953	40	96	4	6166	0	6306
12954	32	29	3	6216	0	6280
12955	24	14	4	6215	0	6257
12956	6105	8	6	158	0	6277
12957	129	11	5	6113	0	6258
12958	46	9	1	6183	0	6239
12959	6168	9	4	168	0	6349
12960	6273	5	1	81	0	6360
12961	6293	4	0	51	0	6348
12962	168	4	6003	33	0	6208
12963	72	11	5849	37	0	5969
12964	6151	4	139	33	0	6327
12965	147	5	48	6069	0	6269
12966	76	6	20	5979	0	6081
12967	6099	4	19	167	0	6289
12968	6061	2	15	79	0	6157
12969	6104	1	14	55	0	6174
12970	172	5904	13	37	0	6126
12971	5997	113	6	42	0	6158
12972	5968	28	6	46	0	6048
12973	175	5817	9	37	0	6038
12974	85	5936	9	18	0	6048
12975	70	120	6	5991	0	6187
12976	6109	44	12	123	0	6288
12977	6168	26	10	48	0	6252
12978	6179	18	6	34	0	6237
12979	182	16	4	6041	0	6243
12980	6068	18	5	139	0	6230
12981	162	13	5928	59	0	6162
12982	5948	6	100	55	0	6109
12983	178	12	5970	24	0	6184
12984	81	24	5830	24	0	5959
12985	82	13	137	5827	0	6059
12986	5946	12	53	147	0	6158
12987	156	8	31	5929	0	6124
12988	63	13	5943	153	0	6172
12989	44	14	5975	70	0	6103
12990	57	7	139	5976	0	6179
12991	5980	6	53	156	0	6195
12992	153	5994	26	72	0	6245
12993	88	104	22	6088	0	6302
12994	70	32	29	6170	0	6301
12995	60	22	6091	169	0	6342
12996	63	16	5980	70	0	6129
12997	46	14	152	6069	0	6281
12998	6059	20	60	168	0	6307
12999	148	20	5975	86	0	6229
13000	83	12	136	5906	0	6137
13001	80	10	47	5939	0	6076
13002	58	14	47	6009	0	6128
13003	5795	9	34	209	0	6047
13004	168	16	5385	105	0	5674
13005	89	5744	105	83	0	6021
13006	83	118	44	5873	0	6118
13007	58	40	5837	172	0	6107
13008	67	5710	139	83	0	5999
13009	53	5933	64	74	0	6124
13010	5890	148	46	64	0	6148
13011	171	5958	33	65	0	6227
13012	6064	138	33	79	0	6314
13013	184	52	5902	55	0	6193
13014	96	44	143	6033	0	6316
13015	6001	29	53	183	0	6266
13016	181	6053	39	95	0	6368
13017	104	142	5965	64	0	6275
13018	99	60	143	5620	0	5922
13019	68	5993	51	162	0	6274
13020	79	144	42	6142	0	6407
13021	6036	62	40	193	0	6331
13022	169	6186	48	89	0	6492
13023	6204	150	40	74	0	6468
13024	6294	66	31	83	0	6474
13025	229	38	6142	54	0	6463
13026	123	6357	141	60	0	6681
13027	88	150	71	6733	0	7042
13028	86	61	7120	183	0	7450
13029	85	36	7782	87	0	7990
13030	94	53	272	7954	0	8373
13031	8300	35	127	259	0	8721
13032	8406	22	79	123	0	8630
13033	355	33	49	8295	0	8732
13034	153	31	8349	294	0	8827
13035	101	8361	257	130	0	8849
13036	8505	248	99	103	0	8955
13037	8678	96	63	79	0	8916
13038	340	8472	46	58	0	8916
13039	8601	256	54	63	0	8974
13040	317	117	8356	59	0	8849
13041	8408	72	248	57	0	8785
13042	8178	54	103	73	0	8408
13043	334	46	8358	38	0	8776
13044	178	36	251	8227	0	8692
13045	118	39	8227	247	0	8631
13046	97	7823	277	113	0	8310
13047	77	8100	122	88	0	8387
13048	83	308	82	7735	0	8208
13049	55	94	7771	211	0	8131
13050	32	7228	212	90	0	7562
13051	24	7194	70	64	0	7352
13052	6347	202	70	46	0	6665
13053	6442	76	17	25	0	6560
13054	188	41	22	6425	0	6676
13055	101	19	15	6376	0	6511
13056	50	6462	13	165	0	6690
13057	6440	130	19	77	0	6666
13058	6527	51	14	59	0	6651
13059	183	6472	20	28	0	6703
13060	105	137	7	6488	0	6737
13061	47	67	6417	151	0	6682
13062	57	43	125	6470	0	6695
13063	6525	27	60	171	0	6783
13064	166	26	34	6547	0	6773
13065	92	27	19	6729	0	6867
13066	6661	21	21	208	0	6911
13067	177	9	22	6555	0	6763
13068	76	6416	26	191	0	6709
13069	66	126	9	6636	0	6837
13070	52	58	14	6746	0	6870
13071	46	32	19	6633	0	6730
13072	38	6520	14	210	0	6782
13073	39	157	16	6523	0	6735
13074	30	68	6414	193	0	6705
13075	30	46	145	6454	0	6675
13076	36	30	6390	199	0	6655
13077	34	6244	160	95	0	6533
13078	43	138	69	6417	0	6667
13079	42	66	47	6506	0	6661
13080	49	37	36	6544	0	6666
13081	47	32	28	6470	0	6577
13082	27	35	6279	239	0	6580
13083	25	6206	146	128	0	6505
13084	49	147	64	6429	0	6689
13085	36	66	6421	196	0	6719
13086	42	53	161	6485	0	6741
13087	6476	36	79	221	0	6812
13088	172	41	6228	103	0	6544
13089	6261	25	154	85	0	6525
13090	214	25	80	6390	0	6709
13091	101	33	6417	191	0	6742
13092	72	6269	167	114	0	6622
13093	62	164	75	6351	0	6652
13094	63	80	6450	194	0	6787
13095	61	6353	168	109	0	6691
13096	55	176	87	6428	0	6746
13097	6381	92	57	214	0	6744
13098	6545	59	55	112	0	6771
13099	6649	50	43	90	0	6832
13100	265	39	6450	71	0	6825
13101	143	6556	158	67	0	6924
13102	86	172	84	6648	0	6990
13103	84	83	58	7026	0	7251
13104	6989	60	40	256	0	7345
13105	196	7092	45	118	0	7451
13106	7253	204	25	106	0	7588
13107	7227	98	37	99	0	7461
13108	7441	64	36	85	0	7626
13109	279	58	7159	68	0	7564
13110	7341	44	192	89	0	7666
13111	287	37	81	7290	0	7695
13112	149	34	44	7423	0	7650
13113	7239	24	39	295	0	7597
13114	252	31	36	7101	0	7420
13115	116	7020	27	263	0	7426
13116	99	188	29	7017	0	7333
13117	6892	80	30	288	0	7290
13118	216	59	6775	163	0	7213
13119	103	6729	192	119	0	7143
13120	88	196	64	6832	0	7180
13121	6779	77	47	257	0	7160
13122	228	50	6626	123	0	7027
13123	121	182	220	6476	0	6999
13124	120	46	6526	247	0	6939
13125	93	35	6401	131	0	6660
13126	83	30	6226	105	0	6444
13127	60	17	6049	87	0	6213
13128	55	43	5637	74	0	5809
13129	4495	106	222	68	0	4891
13130	96	4535	75	29	0	4735
13131	4286	69	41	31	0	4427
13132	4281	22	27	27	0	4357
13133	80	4241	29	14	0	4364
13134	35	4300	26	7	0	4368
13135	4295	66	35	24	0	4420
13136	4316	24	20	18	0	4378
13137	93	22	23	4129	0	4267
13138	42	4182	17	60	0	4301
13139	4274	60	14	30	0	4378
13140	79	4194	16	15	0	4304
13141	34	68	19	4260	0	4381
13142	4290	35	9	67	0	4401
13143	4297	22	9	39	0	4367
13144	99	13	8	4276	0	4396
13145	52	17	10	4314	0	4393
13146	37	14	4249	86	0	4386
13147	36	26	60	4203	0	4325
13148	28	19	4192	79	0	4318
13149	36	13	59	4066	0	4174
13150	32	11	26	4183	0	4252
13151	4138	14	17	99	0	4268
13152	4140	9	12	57	0	4218
13153	84	17	4046	36	0	4183
13154	3968	9	74	48	0	4099
13155	83	13	34	4062	0	4192
13156	48	5	4209	85	0	4347
13157	31	13	74	4209	0	4327
13158	36	4	30	4496	0	4566
13159	33	10	4397	105	0	4545
13160	30	7	74	4434	0	4545
13161	36	9	4567	82	0	4694
13162	33	10	84	4734	0	4861
13163	5107	14	48	112	0	5281
13164	101	5237	28	64	0	5430
13165	5385	92	27	59	0	5563
13166	133	5547	29	34	0	5743
13167	5517	122	16	45	0	5700
13168	141	5529	29	29	0	5728
13169	5491	129	24	37	0	5681
13170	135	5507	16	35	0	5693
13171	94	129	18	5495	0	5736
13172	70	66	5454	106	0	5696
13173	43	60	5402	54	0	5559
13174	51	39	139	5410	0	5639
13175	5413	25	77	131	0	5646
13176	127	5488	52	61	0	5728
13177	92	122	27	5544	0	5785
13178	63	81	5534	129	0	5807
13179	58	54	5642	73	0	5827
13180	41	62	150	5428	0	5681
13181	34	5661	90	126	0	5911
13182	5631	109	68	70	0	5878
13183	124	69	5766	61	0	6020
13184	72	49	5649	51	0	5821
13185	45	5735	161	28	0	5969
13186	5681	119	107	40	0	5947
13187	5738	50	60	50	0	5898
13188	159	51	54	5655	0	5919
13189	5801	34	32	134	0	6001
13190	5742	28	37	73	0	5880
13191	160	5721	46	56	0	5983
13192	5823	100	46	51	0	6020
13193	149	49	5921	28	0	6147
13194	93	58	110	5797	0	6058
13195	90	43	55	5870	0	6058
13196	5845	26	56	144	0	6071
13197	127	5804	47	89	0	6067
13198	5809	107	24	71	0	6011
13199	155	5880	28	34	0	6097
13200	100	5995	14	32	0	6141
13201	91	137	5776	33	0	6037
13202	72	86	5581	31	0	5770
13203	5399	84	108	50	0	5641
13204	5493	53	70	36	0	5652
13205	129	32	5306	24	0	5491
13206	89	5006	83	21	0	5199
13207	58	5165	51	18	0	5292
13208	5152	98	28	33	0	5311
13209	5144	80	21	20	0	5265
13210	119	67	17	5209	0	5412
13211	5345	43	25	76	0	5489
13212	117	25	21	5324	0	5487
13213	77	30	5303	83	0	5493
13214	63	29	5061	56	0	5209
13215	5334	23	100	49	0	5506
13216	96	22	69	5308	0	5495
13217	69	5586	56	51	0	5762
13218	5747	69	33	53	0	5902
13219	5719	52	34	47	0	5852
13220	114	49	5704	27	0	5894
13221	5766	32	64	37	0	5899
13222	5947	20	50	43	0	6060
13223	134	22	49	5895	0	6100
13224	83	5904	39	81	0	6107
13225	81	5953	32	47	0	6113
13226	62	114	22	6212	0	6410
13227	58	87	28	6080	0	6253
13228	51	50	27	6230	0	6358
13229	55	39	6133	145	0	6372
13230	48	36	5865	98	0	6047
13231	66	31	130	5938	0	6165
13232	58	35	6087	90	0	6270
13233	48	29	5944	72	0	6093
13234	56	28	141	5913	0	6138
13235	50	32	6310	101	0	6493
13236	42	6249	127	85	0	6503
13237	6467	100	75	76	0	6718
13238	105	74	62	6479	0	6720
13239	82	6469	44	103	0	6698
13240	57	100	6692	82	0	6931
13241	53	73	105	6668	0	6899
13242	32	52	6943	110	0	7137
13243	35	33	148	6975	0	7191
13244	40	20	99	7254	0	7413
13245	28	32	7449	169	0	7678
13246	57	23	134	7321	0	7535
13247	41	7362	106	141	0	7650
13248	49	113	65	7710	0	7937
13249	47	93	7679	142	0	7961
13250	42	60	131	7577	0	7810
13251	7552	43	83	186	0	7864
13252	124	7587	67	123	0	7901
13253	100	122	50	7713	0	7985
13254	70	77	7757	151	0	8055
13255	53	7572	132	114	0	7871
13256	44	7666	96	87	0	7893
13257	36	177	7526	77	0	7816
13258	44	108	134	7289	0	7575
13259	55	86	117	7216	0	7474
13260	33	40	7326	203	0	7602
13261	40	6982	136	127	0	7285
13262	30	7172	86	91	0	7379
13263	6663	103	58	50	0	6874
13264	70	6749	30	37	0	6886
13265	6611	84	21	34	0	6750
13266	84	77	8	6400	0	6569
13267	6780	27	13	115	0	6935
13268	70	25	6741	59	0	6895
13269	6702	31	65	47	0	6845
13270	89	30	54	6928	0	7101
13271	56	7010	45	80	0	7191
13272	7142	59	26	90	0	7317
13273	90	56	21	7256	0	7423
13274	54	7325	30	76	0	7485
13275	25	7693	19	54	0	7791
13276	7684	113	16	46	0	7859
13277	7759	64	13	38	0	7874
13278	7819	41	11	35	0	7906
13279	139	26	6	7514	0	7685
13280	75	7304	15	82	0	7476
13281	37	7532	16	60	0	7645
13282	31	101	25	7617	0	7774
13283	7477	57	21	99	0	7654
13284	7142	36	10	93	0	7281
13285	7375	34	14	59	0	7482
13286	132	30	7185	40	0	7387
13287	90	39	7118	29	0	7276
13288	7679	28	95	45	0	7847
13289	100	27	56	7587	0	7770
13290	78	26	36	7678	0	7818
13291	58	13	23	7543	0	7637
13292	49	21	17	7611	0	7698
13293	27	26	7417	154	0	7624
13294	28	27	76	7405	0	7536
13295	21	30	7454	119	0	7624
13296	6992	21	86	112	0	7211
13297	90	7411	74	42	0	7617
13298	78	77	31	7640	0	7826
13299	49	51	29	7554	0	7683
13300	7438	30	29	148	0	7645
13301	7392	32	26	106	0	7556
13302	7460	34	19	68	0	7581
13303	7450	27	11	61	0	7549
13304	151	29	7336	45	0	7561
13305	102	19	7205	41	0	7367
13306	67	17	114	7279	0	7477
13307	7407	17	78	106	0	7608
13308	7301	19	49	104	0	7473
13309	132	25	7253	46	0	7456
13310	94	16	88	7097	0	7295
13311	7118	22	53	122	0	7315
13312	103	23	35	7186	0	7347
13313	76	15	7371	129	0	7591
13314	53	28	88	7359	0	7528
13315	7430	23	59	124	0	7636
13316	98	7730	39	81	0	7948
13317	7727	81	35	78	0	7921
13318	7730	54	29	65	0	7878
13319	7822	32	28	71	0	7953
13320	143	29	20	7736	0	7928
13321	7680	31	21	109	0	7841
13322	126	7817	22	71	0	8036
13323	90	8049	28	43	0	8210
13324	52	173	25	7869	0	8119
13325	8045	71	11	134	0	8261
13326	124	8391	16	77	0	8608
13327	10077	122	19	57	0	10275
13328	10880	74	18	66	0	11038
13329	303	11332	18	25	0	11678
13330	174	243	9	11445	0	11871
13331	118	106	9	11733	0	11966
13332	87	57	11517	303	0	11964
13333	90	50	215	11375	0	11730
13334	82	41	11503	309	0	11935
13335	68	11151	241	155	0	11615
13336	94	268	121	11373	0	11856
13337	11005	120	65	353	0	11543
13338	11355	59	65	194	0	11673
13339	338	59	60	11255	0	11712
13340	148	43	10963	311	0	11465
13341	10454	46	244	189	0	10933
13342	273	10560	124	128	0	11085
13343	150	10559	62	120	0	10891
13344	125	10782	57	89	0	11053
13345	149	295	55	10269	0	10768
13346	70	111	10431	259	0	10871
13347	87	79	231	10311	0	10708
13348	65	83	10397	242	0	10787
13349	59	87	10281	122	0	10549
13350	44	95	10549	67	0	10755
13351	68	72	300	10072	0	10512
13352	61	53	148	10606	0	10868
13353	47	41	117	10687	0	10892
13354	46	38	116	10451	0	10651
13355	10392	31	110	381	0	10914
13356	199	10366	120	181	0	10866
13357	10386	209	88	164	0	10847
13358	229	10609	66	148	0	11052
13359	115	234	63	10760	0	11172
13360	85	102	40	11108	0	11335
13361	10913	59	38	386	0	11396
13362	11033	69	28	201	0	11331
13363	11131	69	28	140	0	11368
13364	11050	72	22	127	0	11271
13365	11032	50	19	129	0	11230
13366	346	10797	19	106	0	11268
13367	10444	227	10	133	0	10814
13368	347	10439	14	71	0	10871
13369	10501	238	14	71	0	10824
13370	351	110	10330	53	0	10844
13371	231	77	193	10151	0	10652
13372	167	10521	65	203	0	10956
13373	150	251	49	10406	0	10856
13374	123	129	10329	232	0	10813
13375	142	81	213	9854	0	10290
13376	9896	91	94	288	0	10369
13377	253	9960	70	163	0	10446
13378	113	10249	74	131	0	10567
13379	89	285	10468	129	0	10971
13380	86	133	239	10380	0	10838
13381	59	10687	126	282	0	11154
13382	91	265	77	11012	0	11445
13383	57	134	11003	294	0	11488
13384	63	10743	236	163	0	11205
13385	68	281	10877	116	0	11342
13386	71	158	10726	120	0	11075
13387	93	109	292	10678	0	11172
13388	10838	98	124	303	0	11363
13389	255	85	124	10920	0	11384
13390	106	93	11115	291	0	11605
13391	84	105	298	11169	0	11656
13392	74	97	11793	297	0	12261
13393	67	93	11523	175	0	11858
13394	11688	71	350	185	0	12294
13395	12319	53	182	179	0	12733
13396	12373	34	161	173	0	12741
13397	318	44	12143	141	0	12646
13398	150	37	12168	134	0	12489
13399	125	32	389	11904	0	12450
13400	129	36	220	12211	0	12596
13401	12268	34	146	346	0	12794
13402	338	45	105	12272	0	12760
13403	172	43	12323	327	0	12865
13404	137	36	11979	197	0	12349
13405	99	12191	350	165	0	12805
13406	117	220	176	12574	0	13087
13407	111	101	12641	333	0	13186
13408	128	68	305	12426	0	12927
13409	12510	62	174	376	0	13122
13410	277	58	12644	198	0	13177
13411	158	62	323	12526	0	13069
13412	131	55	156	12836	0	13178
13413	118	58	12416	386	0	12978
13414	126	39	316	12154	0	12635
13415	109	59	12150	365	0	12683
13416	11544	44	329	220	0	12137
13417	292	44	186	11830	0	12352
13418	142	11770	143	341	0	12396
13419	11824	234	114	247	0	12419
13420	11876	83	124	196	0	12279
13421	337	11713	124	163	0	12337
13422	281	817	86	10601	0	11785
13423	140	11072	102	239	0	11553
13424	122	11255	54	160	0	11591
13425	235	312	10518	126	0	11191
13426	138	10375	242	105	0	10860
13427	136	214	8427	116	0	8893
13428	7035	85	105	50	0	7275
13429	7089	23	26	41	0	7179
13430	55	7203	22	21	0	7301
13431	24	7264	18	15	0	7321
13432	24	7367	15	7	0	7413
13433	7372	62	11	22	0	7467
13434	74	30	7	7406	0	7517
13435	25	15	7674	59	0	7773
13436	19	7626	68	17	0	7730
13437	21	82	15	7796	0	7914
13438	23	25	21	7693	0	7762
13439	9	8538	8	79	0	8634
13440	9255	112	13	48	0	9428
13441	156	26	9501	19	0	9702
13442	90	22	157	12003	0	12272
13443	11	13392	38	257	0	13698
13444	13416	323	21	86	0	13846
13445	324	85	13279	49	0	13737
13446	92	13001	313	23	0	13429
13447	113	326	72	13136	0	13647
13448	37	87	13120	317	0	13561
13449	12689	81	336	99	0	13205
13450	363	45	80	12992	0	13480
13451	94	24	12983	346	0	13447
13452	59	12941	342	95	0	13437
13453	12691	326	96	109	0	13222
13454	306	12988	81	53	0	13428
13455	12980	365	51	61	0	13457
13456	13243	119	25	70	0	13457
13457	440	97	30	12727	0	13294
13458	160	12383	48	324	0	12915
13459	119	318	12415	76	0	12928
13460	99	111	326	12453	0	12989
13461	176	122	130	10715	0	11143
13462	84	37	88	12654	0	12863
13463	85	27	51	12659	0	12822
13464	86	26	43	12708	0	12863
13465	12274	42	59	500	0	12875
13466	12013	53	45	226	0	12337
13467	12104	50	20	174	0	12348
13468	447	11973	27	95	0	12542
13469	194	332	12040	66	0	12632
13470	150	94	11978	68	0	12290
13471	82	99	12139	71	0	12391
13472	107	79	447	11648	0	12281
13473	90	40	179	12103	0	12412
13474	61	46	124	12180	0	12411
13475	39	42	11754	513	0	12348
13476	32	11491	378	253	0	12154
13477	43	344	11587	181	0	12155
13478	61	102	11782	130	0	12075
13479	122	85	423	11207	0	11837
13480	95	65	11465	384	0	12009
13481	116	68	430	11004	0	11618
13482	10998	80	176	430	0	11684
13483	11105	72	157	164	0	11498
13484	433	40	10841	131	0	11445
13485	188	54	411	10677	0	11330
13486	134	50	10805	435	0	11424
13487	93	10791	420	189	0	11493
13488	10786	357	174	169	0	11486
13489	408	136	10816	122	0	11482
13490	147	10308	442	104	0	11001
13491	121	10426	183	87	0	10817
13492	103	10188	160	112	0	10563
13493	88	491	9560	108	0	10247
13494	106	243	396	9049	0	9794
13495	97	9410	150	401	0	10058
13496	155	407	121	9351	0	10034
13497	148	170	118	9663	0	10099
13498	9190	129	138	498	0	9955
13499	383	9230	125	286	0	10024
13500	9058	386	135	225	0	9804
13501	431	8922	111	164	0	9628
13502	205	9312	108	149	0	9774
13503	174	452	8939	141	0	9706
13504	160	250	406	8791	0	9607
13505	110	221	8806	402	0	9539
13506	103	8687	432	179	0	9401
13507	115	413	8686	171	0	9385
13508	137	137	8880	173	0	9327
13509	109	8715	451	176	0	9451
13510	8395	412	200	193	0	9200
13511	365	8615	178	196	0	9354
13512	8638	420	173	174	0	9405
13513	451	206	8601	152	0	9410
13514	193	143	8766	179	0	9281
13515	144	8561	470	180	0	9355
13516	8427	421	215	185	0	9248
13517	405	8430	213	160	0	9208
13518	189	401	191	8464	0	9245
13519	8574	170	155	401	0	9300
13520	447	165	8482	164	0	9258
13521	177	152	468	8541	0	9338
13522	8383	125	233	436	0	9177
13523	409	8430	217	176	0	9232
13524	173	401	170	8541	0	9285
13525	154	170	8423	480	0	9227
13526	8426	136	427	246	0	9235
13527	390	112	217	8554	0	9273
13528	117	115	8500	477	0	9209
13529	130	127	460	8263	0	8980
13530	131	8302	212	447	0	9092
13531	125	383	8350	229	0	9087
13532	109	146	444	8252	0	8951
13533	8093	111	190	472	0	8866
13534	441	109	171	8053	0	8774
13535	7682	107	141	428	0	8358
13536	440	7680	142	181	0	8443
13537	7616	369	129	156	0	8270
13538	397	173	7408	149	0	8127
13539	170	150	6749	111	0	7180
13540	164	116	5935	94	0	6309
13541	136	5441	442	120	0	6139
13542	181	90	353	1564	0	2188
13543	17	14	52	1534	0	1617
13544	16	9	20	1489	0	1534
13545	8	8	11	1540	0	1567
13546	12	15	1544	36	0	1607
13547	1478	8	31	22	0	1539
13548	29	1572	11	18	0	1630
13549	1570	31	12	13	0	1626
13550	31	13	6	1570	0	1620
13551	10	1620	12	26	0	1668
13552	10	27	13	1653	0	1703
13553	1643	12	11	31	0	1697
13554	21	1709	7	11	0	1748
13555	1701	28	14	25	0	1768
13556	1698	7	11	18	0	1734
13557	29	11	5	1711	0	1756
13558	11	10	1697	32	0	1750
13559	1686	7	24	13	0	1730
13560	33	8	10	1763	0	1814
13561	1807	9	5	31	0	1852
13562	1870	2	12	14	0	1898
13563	1881	4	10	11	0	1906
13564	31	10	1878	7	0	1926
13565	18	6	25	1857	0	1906
13566	1901	4	12	34	0	1951
13567	34	10	1950	14	0	2008
13568	18	1997	29	10	0	2054
13569	21	24	12	1848	0	1905
13570	14	12	2008	26	0	2060
13571	12	7	1933	7	0	1959
13572	25	25	24	1901	0	1975
13573	11	5	11	1992	0	2019
13574	9	3	8	1990	0	2010
13575	15	3	8	1940	0	1966
13576	8	6	1949	23	0	1986
13577	5	1997	21	12	0	2035
13578	13	19	8	2051	0	2091
13579	2075	4	3	27	0	2109
13580	2076	3	9	16	0	2104
13581	2107	9	3	11	0	2130
13582	23	5	3	2105	0	2136
13583	14	11	11	2072	0	2108
13584	11	1989	9	21	0	2030
13585	11	2088	3	13	0	2115
13586	21	26	3	2058	0	2108
13587	2007	10	1	21	0	2039
13588	2017	2	4	8	0	2031
13589	1999	3	1	11	0	2014
13590	1995	1	3	7	0	2006
13591	2000	2	3	7	0	2012
13592	12	2025	3	5	0	2045
13593	7	12	3	2069	0	2091
13594	2154	4	2	16	0	2176
13595	2189	1	4	11	0	2205
13596	19	1	0	2186	0	2206
13597	5	0	1	2202	0	2208
13598	4	2	2269	13	0	2288
13599	4	1	11	2189	0	2205
13600	7	2	3	2231	0	2243
13601	5	3	2328	11	0	2347
13602	3	3	10	2309	0	2325
13603	5	2483	3	12	0	2503
13604	4	11	2477	5	0	2497
13605	5	2525	10	9	0	2549
13606	13	8	5	2493	0	2519
13607	9	3	2	2557	0	2571
13608	6	2509	2	7	0	2524
13609	1	2556	2	6	0	2565
13610	2691	7	1	14	0	2713
13611	2668	5	2	6	0	2681
13612	14	5	2692	4	0	2715
13613	2776	3	14	22	0	2815
13614	2991	2	2	16	0	3011
13615	3015	1	2	8	0	3026
13616	3013	1	4	11	0	3029
13617	14	2	2953	5	0	2974
13618	9	8	2750	4	0	2771
13619	3031	2	8	12	0	3053
13620	9	3172	5	4	0	3190
13621	2	4	3212	3	0	3221
13622	3158	10	10	4	0	3182
13623	3212	0	3	10	0	3225
13624	12	2	3158	1	0	3173
13625	3159	0	14	10	0	3183
13626	11	4	2	3558	0	3575
13627	5	2	3680	10	0	3697
13628	3493	2	10	22	0	3527
13629	9	3765	5	4	0	3783
13630	3889	9	0	18	0	3916
13631	4205	3	5	27	0	4240
13632	19	1	3	4248	0	4271
13633	13	3	1	4215	0	4232
13634	6	1	3	4311	0	4321
13635	4310	1	2	22	0	4335
13636	4403	1	2	15	0	4421
13637	19	1	4	4412	0	4436
13638	8	3	1	4385	0	4397
13639	4	2	4326	22	0	4354
13640	4161	0	17	19	0	4197
13641	24	2	6	4586	0	4618
13642	12	2	2	4572	0	4588
13643	7	4512	6	25	0	4550
13644	12	14	0	4593	0	4619
13645	7	10	1	4556	0	4574
13646	4529	3	5	34	0	4571
13647	21	4593	11	21	0	4646
13648	23	20	1	4683	0	4727
13649	10	8	2	4631	0	4651
13650	13	8	0	4663	0	4684
13651	7	7	4629	36	0	4679
13652	13	0	16	4546	0	4575
13653	4538	3	9	46	0	4596
13654	31	6	4545	21	0	4603
13655	25	5	21	4627	0	4678
13656	17	2	9	4743	0	4771
13657	4762	2	6	49	0	4819
13658	4664	1	7	35	0	4707
13659	34	8	4721	16	0	4779
13660	4485	2	24	33	0	4544
13661	30	7	4808	10	0	4855
13662	4879	2	34	26	0	4941
13663	37	5289	17	16	0	5359
13664	5476	28	9	31	0	5544
13665	42	5580	3	12	0	5637
13666	5793	45	7	34	0	5879
13667	51	5859	6	15	0	5931
13668	36	49	5	6040	0	6130
13669	29	20	10	6047	0	6106
13670	15	12	4	6030	0	6061
13671	11	5921	9	80	0	6021
13672	18	40	6	6026	0	6090
13673	9	6031	6	63	0	6109
13674	20	54	3	6134	0	6211
13675	6133	31	8	68	0	6240
13676	6075	16	5	44	0	6140
13677	64	6059	7	32	0	6162
13678	51	46	3	6131	0	6231
13679	6099	28	7	60	0	6194
13680	56	6152	9	33	0	6250
13681	28	6236	3	27	0	6294
13682	6296	66	6	35	0	6403
13683	6329	45	1	27	0	6402
13684	78	6289	3	17	0	6387
13685	6343	63	4	25	0	6435
13686	81	32	0	6440	0	6553
13687	42	32	6680	59	0	6813
13688	6653	20	47	53	0	6773
13689	6763	19	22	47	0	6851
13690	92	13	6794	19	0	6918
13691	6818	15	57	32	0	6922
13692	6966	15	22	41	0	7044
13693	7227	13	17	38	0	7295
13694	101	7148	10	16	0	7275
13695	7280	67	8	32	0	7387
13696	7316	33	3	30	0	7382
13697	113	30	5	7316	0	7464
13698	73	19	5	7355	0	7452
13699	56	18	8	7498	0	7580
13700	7499	5	3	120	0	7627
13701	86	11	3	7446	0	7546
13702	7499	14	8	118	0	7639
13703	7480	15	4	61	0	7560
13704	124	11	5	7416	0	7556
13705	75	13	12	7497	0	7597
13706	61	9	2	7617	0	7689
13707	7590	15	2	141	0	7748
13708	93	7461	8	73	0	7635
13709	62	82	3	7743	0	7890
13710	63	31	5	7793	0	7892
13711	7697	27	7	136	0	7867
13712	7661	18	4	108	0	7791
13713	134	20	7374	65	0	7593
13714	83	17	7333	47	0	7480
13715	7976	11	114	46	0	8147
13716	156	14	53	8182	0	8405
13717	91	22	32	9826	0	9971
13718	60	21	9844	254	0	10179
13719	72	23	179	9756	0	10030
13720	36	9734	50	257	0	10077
13721	33	10191	42	86	0	10352
13722	9976	233	24	86	0	10319
13723	218	95	9898	36	0	10247
13724	77	10167	175	46	0	10465
13725	90	203	53	10336	0	10682
13726	55	71	10142	213	0	10481
13727	58	48	206	9824	0	10136
13728	52	40	61	10073	0	10226
13729	50	22	9908	274	0	10254
13730	39	9841	221	110	0	10211
13731	67	211	57	9620	0	9955
13732	9692	63	51	256	0	10062
13733	9864	58	38	108	0	10068
13734	9945	33	21	95	0	10094
13735	305	9727	27	62	0	10121
13736	9772	204	33	33	0	10042
13737	294	75	20	9698	0	10087
13738	97	52	9540	227	0	9916
13739	9436	42	189	108	0	9775
13740	234	9660	66	90	0	10050
13741	90	191	55	9602	0	9938
13742	89	60	28	9663	0	9840
13743	57	9493	23	263	0	9836
13744	45	223	17	9784	0	10069
13745	63	69	25	9892	0	10049
13746	78	46	24	10044	0	10192
13747	9719	51	41	313	0	10124
13748	9751	34	27	171	0	9983
13749	272	41	9680	111	0	10104
13750	126	51	217	9661	0	10055
13751	112	38	60	10016	0	10226
13752	62	45	64	10089	0	10260
13753	9841	46	62	334	0	10283
13754	245	47	9549	155	0	9996
13755	9470	36	224	142	0	9872
13756	9868	25	76	108	0	10077
13757	298	32	54	9841	0	10225
13758	9864	31	57	288	0	10240
13759	284	47	9436	139	0	9906
13760	9451	34	199	139	0	9823
13761	281	10128	86	103	0	10598
13762	132	208	9977	64	0	10381
13763	126	66	9874	94	0	10160
13764	107	122	241	9654	0	10124
13765	87	56	9798	240	0	10181
13766	9417	33	236	135	0	9821
13767	238	9589	81	86	0	9994
13768	9646	211	64	96	0	10017
13769	257	73	53	9757	0	10140
13770	108	61	9736	257	0	10162
13771	88	43	9667	136	0	9934
13772	70	61	249	9819	0	10199
13773	9856	31	103	302	0	10292
13774	216	9676	76	125	0	10093
13775	99	10005	46	144	0	10294
13776	9968	234	46	146	0	10394
13777	269	10030	56	100	0	10455
13778	10123	234	65	97	0	10519
13779	279	105	40	10067	0	10491
13780	10014	52	40	281	0	10387
13781	268	51	58	10037	0	10414
13782	10054	46	43	283	0	10426
13783	287	34	58	9944	0	10323
13784	124	9818	58	267	0	10267
13785	9866	203	51	150	0	10270
13786	243	9768	67	130	0	10208
13787	134	221	9356	92	0	9803
13788	104	82	218	9091	0	9495
13789	99	9501	84	216	0	9900
13790	9260	217	58	114	0	9649
13791	9266	90	50	81	0	9487
13792	293	9247	58	58	0	9656
13793	122	231	9170	67	0	9590
13794	110	68	225	8923	0	9326
13795	74	8876	88	236	0	9274
13796	71	208	66	9259	0	9604
13797	114	70	54	9333	0	9571
13798	9126	78	40	267	0	9511
13799	228	9054	55	114	0	9451
13800	116	201	45	9294	0	9656
13801	9283	88	38	277	0	9686
13802	9318	73	45	135	0	9571
13803	9311	51	40	129	0	9531
13804	290	64	27	9159	0	9540
13805	9128	51	33	233	0	9445
13806	273	9085	43	88	0	9489
13807	9018	190	52	106	0	9366
13808	236	9111	45	114	0	9506
13809	9136	191	41	102	0	9470
13810	9142	72	20	107	0	9341
13811	279	132	44	8909	0	9364
13812	173	37	9023	206	0	9439
13813	127	77	8775	89	0	9068
13814	111	8963	184	71	0	9329
13815	8580	185	88	112	0	8965
13816	197	70	8468	56	0	8791
13817	6413	31	41	34	0	6519
13818	77	6503	14	15	0	6609
13819	27	6673	15	17	0	6732
13820	42	60	20	6836	0	6958
13821	18	6956	13	47	0	7034
13822	28	68	7238	23	0	7357
13823	40	29	75	7040	0	7184
13824	25	7487	23	67	0	7602
13825	29	100	15	7603	0	7747
13826	7696	34	17	115	0	7862
13827	113	29	15	7820	0	7977
13828	32	40	7967	127	0	8166
13829	30	8051	106	44	0	8231
13830	43	122	34	8104	0	8303
13831	42	32	23	8201	0	8298
13832	25	41	27	8251	0	8344
13833	8009	40	23	179	0	8251
13834	7932	19	11	99	0	8061
13835	146	25	7919	58	0	8148
13836	56	41	7802	52	0	7951
13837	50	7940	133	43	0	8166
13838	8043	116	41	55	0	8255
13839	138	41	42	8029	0	8250
13840	61	29	38	8045	0	8173
13841	61	35	17	8083	0	8196
13842	83	22	16	8076	0	8197
13843	40	29	7769	197	0	8035
13844	7548	18	122	119	0	7807
13845	172	23	31	8459	0	8685
13846	61	18	8396	212	0	8687
13847	8548	18	182	96	0	8844
13848	9428	18	62	85	0	9593
13849	259	25	10529	54	0	10867
13850	115	24	11049	41	0	11229
13851	119	19	280	10920	0	11338
13852	11114	23	103	272	0	11512
13853	11309	16	88	117	0	11530
13854	326	18	65	10962	0	11371
13855	170	11	50	11277	0	11508
13856	102	21	11070	310	0	11503
13857	109	23	272	10829	0	11233
13858	63	25	10823	340	0	11251
13859	10436	16	271	160	0	10883
13860	289	10740	114	105	0	11248
13861	10387	223	65	106	0	10781
13862	282	10348	70	67	0	10767
13863	10413	252	68	79	0	10812
13864	330	84	43	10117	0	10574
13865	168	59	41	10286	0	10554
13866	10216	44	35	320	0	10615
13867	10259	41	28	151	0	10479
13868	10235	34	30	130	0	10429
13869	10299	35	23	110	0	10467
13870	408	32	9863	63	0	10366
13871	9839	17	228	97	0	10181
13872	10125	19	88	84	0	10316
13873	10167	17	62	66	0	10312
13874	431	28	46	9827	0	10332
13875	9630	15	41	280	0	9966
13876	387	9543	36	91	0	10057
13877	222	216	50	9570	0	10058
13878	169	64	47	9849	0	10129
13879	147	54	9471	348	0	10020
13880	172	42	259	9305	0	9778
13881	128	9439	92	366	0	10025
13882	9390	243	81	190	0	9904
13883	328	9462	75	138	0	10003
13884	9562	276	65	149	0	10052
13885	395	100	45	9548	0	10088
13886	9402	74	52	344	0	9872
13887	368	9230	68	154	0	9820
13888	9373	285	52	160	0	9870
13889	9586	108	50	118	0	9862
13890	430	112	47	9299	0	9888
13891	249	81	29	9549	0	9908
13892	201	56	9163	384	0	9804
13893	187	54	261	9173	0	9675
13894	158	63	74	9361	0	9656
13895	157	58	9026	404	0	9645
13896	187	35	275	9172	0	9669
13897	141	48	8985	405	0	9579
13898	8965	21	294	213	0	9493
13899	360	39	136	8977	0	9512
13900	216	37	8754	341	0	9348
13901	8777	41	300	181	0	9299
13902	414	32	134	8802	0	9382
13903	215	34	8784	379	0	9412
13904	8812	29	307	189	0	9337
13905	399	34	111	8847	0	9391
13906	180	45	99	8993	0	9317
13907	8810	27	95	432	0	9364
13908	375	31	74	8732	0	9212
13909	193	34	81	8925	0	9233
13910	179	55	71	8647	0	8952
13911	163	8454	69	428	0	9114
13912	8270	260	53	265	0	8848
13913	8442	99	50	193	0	8784
13914	406	74	48	8215	0	8743
13915	8245	73	40	379	0	8737
13916	8281	52	44	210	0	8587
13917	8341	39	43	202	0	8625
13918	6661	85	80	250	0	7076
13919	8023	34	64	149	0	8270
13920	485	48	7304	149	0	7986
13921	261	37	7136	146	0	7580
13922	6897	29	268	151	0	7345
13923	354	6735	134	145	0	7368
13924	186	193	100	6508	0	6987
13925	157	82	6396	275	0	6910
13926	143	65	6412	145	0	6765
13927	133	137	283	6108	0	6661
13928	5964	51	194	318	0	6527
13929	273	34	105	5975	0	6387
13930	148	47	5882	271	0	6348
13931	6081	32	202	160	0	6475
13932	270	28	112	6078	0	6488
13933	160	11	89	6235	0	6495
13934	125	15	76	6295	0	6511
13935	143	14	57	6201	0	6415
13936	128	20	5883	357	0	6388
13937	122	26	198	6067	0	6413
13938	6026	16	75	313	0	6430
13939	239	22	5733	197	0	6191
13940	5891	24	201	177	0	6293
13941	6138	23	64	145	0	6370
13942	6114	20	59	142	0	6335
13943	6020	21	73	135	0	6249
13944	346	5705	59	106	0	6216
13945	184	5082	30	96	0	5392
13946	140	5303	43	79	0	5565
13947	4729	231	135	139	0	5234
13948	210	50	4278	74	0	4612
13949	2675	75	164	37	0	2951
13950	104	17	30	2422	0	2573
13951	2414	5	11	58	0	2488
13952	64	4	15	2399	0	2482
13953	2412	2	10	74	0	2498
13954	71	1	10	2413	0	2495
13955	35	4	4	2529	0	2572
13956	2389	9	7	71	0	2476
13957	56	2678	15	32	0	2781
13958	30	47	2667	20	0	2764
13959	20	2634	48	25	0	2727
13960	24	39	2488	11	0	2562
13961	21	62	43	2293	0	2419
13962	2316	15	26	46	0	2403
13963	40	2	6	2263	0	2311
13964	2253	4	4	44	0	2305
13965	37	2405	5	18	0	2465
13966	17	28	2451	10	0	2506
13967	21	2435	33	11	0	2500
13968	12	2449	7	11	0	2479
13969	2299	22	13	7	0	2341
13970	2233	7	9	6	0	2255
13971	27	2268	3	2	0	2300
13972	6	22	1	2304	0	2333
13973	3	7	5	2317	0	2332
13974	2309	3	2	32	0	2346
13975	24	1	2338	7	0	2370
13976	9	4	2273	7	0	2293
13977	13	4	26	2334	0	2377
13978	8	3	2366	24	0	2401
13979	2274	2	22	11	0	2309
13980	2400	3	6	13	0	2422
13981	32	2391	1	6	0	2430
13982	14	24	2585	5	0	2628
13983	12	5	25	2623	0	2665
13984	7	3	2804	26	0	2840
13985	8	5	23	2792	0	2828
13986	2839	3	8	36	0	2886
13987	27	2909	7	7	0	2950
13988	14	27	2961	5	0	3007
13989	7	3039	31	6	0	3083
13990	8	3228	6	8	0	3250
13991	3298	31	5	15	0	3349
13992	3265	4	5	8	0	3282
13993	38	6	3296	9	0	3349
13994	11	3367	32	6	0	3416
13995	13	40	9	3459	0	3521
13996	8	7	8	3457	0	3480
13997	12	3	6	3433	0	3454
13998	9	6	3475	38	0	3528
13999	15	3	30	3426	0	3474
14000	13	4	7	3638	0	3662
14001	3685	3	6	47	0	3741
14002	3709	3	7	22	0	3741
14003	3740	4	4	21	0	3769
14004	3696	4	2	13	0	3715
14005	3718	7	7	16	0	3748
14006	42	3651	10	2	0	3705
14007	3633	32	1	11	0	3677
14008	39	8	3662	6	0	3715
14009	13	16	32	3625	0	3686
14010	3712	11	3	35	0	3761
14011	31	3746	7	10	0	3794
14012	3839	27	5	17	0	3888
14013	3966	3	5	22	0	3996
14014	32	6	7	4056	0	4101
14015	20	7	2	4093	0	4122
14016	9	4289	1	39	0	4338
14017	21	27	4	4403	0	4455
14018	12	10	4457	34	0	4513
14019	20	4	29	4550	0	4603
14020	11	5	4631	39	0	4686
14021	4482	6	34	23	0	4545
14022	44	5	11	4721	0	4781
14023	15	5	4812	37	0	4869
14024	8	4679	44	13	0	4744
14025	11	4819	10	11	0	4851
14026	4901	28	5	19	0	4953
14027	40	13	10	4892	0	4955
14028	10	8	5130	23	0	5171
14029	8	5048	29	8	0	5093
14030	9	25	5144	11	0	5189
14031	5086	6	24	35	0	5151
14032	5196	6	11	13	0	5226
14033	5211	8	6	19	0	5244
14034	32	2	14	5269	0	5317
14035	16	9	5252	24	0	5301
14036	15	5220	26	7	0	5268
14037	19	18	5	5407	0	5449
14038	4	8	5271	30	0	5313
14039	8	16	5031	8	0	5063
14040	6	10	24	5336	0	5376
14041	5467	3	15	42	0	5527
14042	29	5	9	5472	0	5515
14043	12	2	10	5579	0	5603
14044	14	2	5656	28	0	5700
14045	21	9	22	5591	0	5643
14046	10	4	8	5604	0	5626
14047	12	6	5716	34	0	5768
14048	8	6	5527	16	0	5557
14049	15	6	31	5623	0	5675
14050	13	6	5764	32	0	5815
14051	13	5	37	5719	0	5774
14052	5796	4	14	45	0	5859
14053	23	5962	12	23	0	6020
14054	16	23	17	6122	0	6178
14055	8	7	5981	38	0	6034
14056	5386	6	24	43	0	5459
14057	27	5758	11	16	0	5812
14058	5883	21	11	34	0	5949
14059	25	9	17	5884	0	5935
14060	19	3	10	5823	0	5855
14061	5946	7	11	43	0	6007
14062	33	7	5921	17	0	5978
14063	5796	3	26	34	0	5859
14064	28	6	9	5992	0	6035
14065	5836	1	10	45	0	5892
14066	5816	4	14	23	0	5857
14067	45	7	6	5932	0	5990
14068	16	6066	13	38	0	6133
14069	6341	34	4	30	0	6409
14070	6424	7	8	37	0	6476
14071	68	9	6478	12	0	6567
14072	6425	14	48	21	0	6508
14073	80	7	19	6593	0	6699
14074	33	6563	16	50	0	6662
14075	30	47	15	6583	0	6675
14076	23	6534	16	49	0	6622
14077	6576	63	7	50	0	6696
14078	6617	24	10	40	0	6691
14079	80	16	9	7029	0	7134
14080	30	24	6959	78	0	7091
14081	38	16	6804	33	0	6891
14082	36	6	97	7153	0	7292
14083	7184	6	35	121	0	7346
14084	7618	4	31	45	0	7698
14085	129	7730	17	26	0	7902
14086	64	106	12	7819	0	8001
14087	41	41	8125	117	0	8324
14088	28	27	8301	43	0	8399
14089	45	42	182	8940	0	9209
14090	9745	8	76	213	0	10042
14091	222	5	44	9880	0	10151
14092	65	6	9810	236	0	10117
14093	9731	3	214	113	0	10061
14094	247	14	75	9814	0	10150
14095	101	8	43	9963	0	10115
14096	69	8	33	9920	0	10030
14097	41	9716	26	287	0	10070
14098	26	194	9741	121	0	10082
14099	31	72	9850	75	0	10028
14100	47	37	275	9851	0	10210
14101	19	26	9892	245	0	10182
14102	9633	14	274	118	0	10039
14103	249	9	96	9726	0	10080
14104	103	13	51	9881	0	10048
14105	60	11	48	9892	0	10011
14106	41	9742	37	314	0	10134
14107	9933	214	32	157	0	10336
14108	261	66	40	9930	0	10297
14109	9828	36	28	302	0	10194
14110	257	9856	20	122	0	10255
14111	9775	236	35	84	0	10130
14112	9553	75	27	98	0	9753
14113	9706	45	20	85	0	9856
14114	337	9228	40	65	0	9670
14115	146	9515	27	56	0	9744
14116	9183	283	19	80	0	9565
14117	269	9272	29	52	0	9622
14118	122	257	9089	44	0	9512
14119	70	8807	218	60	0	9155
14120	53	9213	76	49	0	9391
14121	9057	285	42	61	0	9445
14122	270	122	8882	29	0	9303
14123	103	78	8891	28	0	9100
14124	91	66	297	8738	0	9192
14125	8929	36	113	269	0	9347
14126	277	30	8862	91	0	9260
14127	112	41	256	8843	0	9252
14128	69	36	8543	270	0	8918
14129	51	53	8461	116	0	8681
14130	8250	43	297	81	0	8671
14131	261	30	8491	57	0	8839
14132	130	44	284	8330	0	8788
14133	79	32	112	8416	0	8639
14134	74	8164	66	289	0	8593
14135	57	8547	64	117	0	8785
14136	76	264	63	8266	0	8669
14137	65	101	8323	271	0	8760
14138	64	60	261	8337	0	8722
14139	50	57	96	8575	0	8778
14140	52	40	8480	334	0	8906
14141	46	38	266	8479	0	8829
14142	8493	37	114	330	0	8974
14143	250	35	8392	137	0	8814
14144	8360	46	290	98	0	8794
14145	284	42	111	8409	0	8846
14146	148	17	77	8732	0	8974
14147	80	8683	82	346	0	9191
14148	75	252	59	8886	0	9272
14149	72	92	55	9225	0	9444
14150	9014	59	72	397	0	9542
14151	295	41	69	9117	0	9522
14152	135	35	56	9321	0	9547
14153	8833	37	71	420	0	9361
14154	312	41	77	8914	0	9344
14155	150	35	66	8737	0	8988
14156	83	8747	81	387	0	9298
14157	8812	252	70	209	0	9343
14158	308	93	56	8878	0	9335
14159	135	77	44	9087	0	9343
14160	102	65	8721	410	0	9298
14161	80	47	268	8786	0	9181
14162	62	43	130	9065	0	9300
14163	8667	43	81	441	0	9232
14164	8860	44	60	243	0	9207
14165	359	43	65	8814	0	9281
14166	170	49	8574	359	0	9152
14167	120	8230	266	184	0	8800
14168	84	8500	122	149	0	8855
14169	147	303	79	8286	0	8815
14170	8279	115	63	336	0	8793
14171	301	75	39	8335	0	8750
14172	8336	70	27	352	0	8785
14173	314	44	43	8474	0	8875
14174	143	53	33	8628	0	8857
14175	8331	48	36	381	0	8796
14176	8342	59	43	191	0	8635
14177	350	8279	25	126	0	8780
14178	158	8679	33	106	0	8976
14179	105	281	41	7989	0	8416
14180	87	111	32	8210	0	8440
14181	85	73	7827	296	0	8281
14182	7202	59	207	162	0	7630
14183	231	7495	78	116	0	7920
14184	72	7228	49	98	0	7447
14185	6946	176	76	70	0	7268
14186	195	58	6899	72	0	7224
14187	77	45	6625	58	0	6805
14188	80	49	6211	43	0	6383
14189	33	5578	132	51	0	5794
14190	39	65	85	4770	0	4959
14191	21	11	21	4740	0	4793
14192	18	13	7	4799	0	4837
14193	4673	11	9	90	0	4783
14194	4654	8	8	47	0	4717
14195	63	4681	6	27	0	4777
14196	28	56	9	4831	0	4924
14197	23	15	4853	71	0	4962
14198	18	4848	54	26	0	4946
14199	4792	65	13	31	0	4901
14200	63	20	4787	17	0	4887
14201	4328	10	48	35	0	4421
14202	53	10	4724	19	0	4806
14203	26	13	51	4632	0	4722
14204	16	4767	14	56	0	4853
14205	4798	48	11	40	0	4897
14206	57	4840	10	22	0	4929
14207	4768	55	14	19	0	4856
14208	53	17	8	4752	0	4830
14209	21	13	4899	58	0	4991
14210	31	10	40	5023	0	5104
14211	15	13	14	5513	0	5555
14212	11	11	5497	92	0	5611
14213	5336	5	70	50	0	5461
14214	80	5676	21	27	0	5804
14215	5702	79	11	36	0	5828
14216	83	5756	7	17	0	5863
14217	34	83	11	5905	0	6033
14218	20	27	5819	99	0	5965
14219	6362	16	87	57	0	6522
14220	135	6639	29	25	0	6828
14221	48	137	16	6688	0	6889
14222	45	44	7	6980	0	7076
14223	7135	30	14	182	0	7361
14224	7641	17	10	91	0	7759
14225	189	7734	17	52	0	7992
14226	8381	165	11	55	0	8612
14227	8536	61	14	47	0	8658
14228	8853	32	7	39	0	8931
14229	283	26	8766	25	0	9100
14230	121	8572	191	19	0	8903
14231	73	8952	72	37	0	9134
14232	82	259	32	8520	0	8893
14233	74	89	26	8834	0	9023
14234	8772	51	26	276	0	9125
14235	209	8727	15	111	0	9062
14236	8835	219	12	77	0	9143
14237	263	96	10	8684	0	9053
14238	133	55	9	8909	0	9106
14239	8637	42	12	295	0	8986
14240	8596	35	9	146	0	8786
14241	306	28	8366	61	0	8761
14242	158	47	192	8343	0	8740
14243	91	23	8242	221	0	8577
14244	75	33	8136	99	0	8343
14245	55	37	8276	50	0	8418
14246	7837	45	308	64	0	8254
14247	221	20	122	7770	0	8133
14248	115	18	67	7798	0	7998
14249	87	19	47	7960	0	8113
14250	48	34	7730	273	0	8085
14251	76	20	186	7680	0	7962
14252	52	13	81	7927	0	8073
14253	7658	10	46	310	0	8024
14254	7752	18	33	156	0	7959
14255	7857	16	32	90	0	7995
14256	7891	7	39	84	0	8021
14257	331	19	30	7641	0	8021
14258	7737	15	41	238	0	8031
14259	294	20	39	7708	0	8061
14260	147	27	7358	231	0	7763
14261	7562	15	178	134	0	7889
14262	257	7551	67	96	0	7971
14263	155	188	41	7550	0	7934
14264	93	96	39	7647	0	7875
14265	77	7583	42	271	0	7973
14266	7490	206	22	160	0	7878
14267	234	7442	22	109	0	7807
14268	144	220	7327	80	0	7771
14269	115	104	7413	63	0	7695
14270	7241	53	242	74	0	7610
14271	7463	49	102	79	0	7693
14272	289	55	7176	80	0	7600
14273	7131	44	219	66	0	7460
14274	293	32	7102	62	0	7489
14275	7108	31	235	73	0	7447
14276	299	24	7114	62	0	7499
14277	160	48	7090	62	0	7360
14278	122	43	277	6688	0	7130
14279	106	21	143	6859	0	7129
14280	6896	49	85	291	0	7321
14281	6864	33	80	166	0	7143
14282	6971	40	70	119	0	7200
14283	7121	29	72	112	0	7334
14284	319	6734	77	98	0	7228
14285	202	179	59	6665	0	7105
14286	155	6715	49	232	0	7151
14287	131	197	71	6683	0	7082
14288	143	102	48	6693	0	6986
14289	132	53	56	6744	0	6985
14290	125	39	6431	336	0	6931
14291	6319	35	220	191	0	6765
14292	241	6135	134	148	0	6658
14293	150	6511	78	131	0	6870
14294	118	227	6426	128	0	6899
14295	137	103	211	6376	0	6827
14296	134	72	110	6455	0	6771
14297	6316	69	65	305	0	6755
14298	273	53	64	6324	0	6714
14299	150	64	60	6438	0	6712
14300	122	46	50	6516	0	6734
14301	117	49	48	6560	0	6774
14302	6244	35	54	378	0	6711
14303	6407	21	66	209	0	6703
14304	6414	32	52	157	0	6655
14305	353	25	68	6283	0	6729
14306	6336	30	66	272	0	6704
14307	295	49	78	6344	0	6766
14308	204	51	76	6583	0	6914
14309	136	31	6162	328	0	6657
14310	115	22	6049	205	0	6391
14311	101	16	5770	132	0	6019
14312	5491	35	291	121	0	5938
14313	249	33	152	5217	0	5651
14314	138	5297	93	222	0	5750
14315	5426	162	65	158	0	5811
14316	245	78	5267	113	0	5703
14317	5211	47	174	78	0	5510
14318	261	5042	116	82	0	5501
14319	4423	112	63	42	0	4640
14320	202	83	36	4261	0	4582
14321	4206	28	35	151	0	4420
14322	172	3915	38	110	0	4235
14323	115	3828	37	72	0	4052
14324	3201	109	48	50	0	3408
14325	120	3136	40	42	0	3338
14326	39	2287	23	25	0	2374
14327	42	2263	33	17	0	2355
14328	1888	63	59	21	0	2031
14329	1749	23	8	11	0	1791
14330	1761	14	4	7	0	1786
14331	43	16	6	1729	0	1794
14332	28	9	2	1741	0	1780
14333	17	13	1721	37	0	1788
14334	26	11	20	1718	0	1775
14335	114	12	1666	31	0	1823
14336	20	11	26	1756	0	1813
14337	18	9	12	1791	0	1830
14338	1770	3	8	50	0	1831
14339	1765	8	9	31	0	1813
14340	34	1767	10	18	0	1829
14341	28	25	10	1775	0	1838
14342	16	11	1840	39	0	1906
14343	19	10	21	1827	0	1877
14344	16	6	14	1859	0	1895
14345	16	9	6	1877	0	1908
14346	12	10	1822	46	0	1890
14347	14	9	1764	25	0	1812
14348	1808	8	36	27	0	1879
14349	28	10	21	1870	0	1929
14350	19	5	1867	39	0	1930
14351	1813	3	27	32	0	1875
14352	36	1915	17	22	0	1990
14353	1938	25	16	19	0	1998
14354	34	19	1942	17	0	2012
14355	1905	8	27	23	0	1963
14356	38	9	20	1912	0	1979
14357	19	5	1934	38	0	1996
14358	15	1913	29	26	0	1983
14359	1873	22	31	14	0	1940
14360	31	18	19	1873	0	1941
14361	28	7	12	1854	0	1901
14362	19	1888	6	42	0	1955
14363	10	22	12	1927	0	1971
14364	10	15	1922	31	0	1978
14365	19	1903	28	15	0	1965
14366	1900	25	15	19	0	1959
14367	25	16	7	1902	0	1950
14368	21	12	8	1885	0	1926
14369	13	9	1868	40	0	1930
14370	12	10	25	1901	0	1948
14371	11	12	2011	29	0	2063
14372	8	2006	26	22	0	2062
14373	1979	23	19	16	0	2037
14374	1982	14	10	26	0	2032
14375	1981	9	7	19	0	2016
14376	29	2118	9	14	0	2170
14377	18	16	15	2126	0	2175
14378	13	16	9	2136	0	2174
14379	25	15	9	1922	0	1971
14380	2116	7	8	37	0	2168
14381	2088	8	3	25	0	2124
14382	37	7	3	2062	0	2109
14383	22	5	2286	31	0	2344
14384	16	7	19	2282	0	2324
14385	12	7	12	2321	0	2352
14386	11	5	5	2304	0	2325
14387	12	2	5	2311	0	2330
14388	2315	6	4	41	0	2366
14389	27	6	6	2349	0	2388
14390	15	3	4	2389	0	2411
14391	8	2386	8	45	0	2447
14392	12	18	4	2490	0	2524
14393	7	2471	2	49	0	2529
14394	12	24	7	2532	0	2575
14395	2488	13	3	41	0	2545
14396	24	2505	7	27	0	2563
14397	2516	23	7	22	0	2568
14398	28	15	2557	24	0	2624
14399	16	19	25	2534	0	2594
14400	12	7	2624	40	0	2683
14401	11	8	28	2616	0	2663
14402	17	27	9	2607	0	2660
14403	12	2579	8	40	0	2639
14404	10	2649	8	24	0	2691
14405	10	2873	5	17	0	2905
14406	2810	29	17	25	0	2881
14407	25	2722	6	14	0	2767
14408	5	2684	5	13	0	2707
14409	30	14	9	2722	0	2775
14410	2724	3	2	32	0	2761
14411	17	2804	6	25	0	2852
14412	2863	12	5	19	0	2899
14413	2872	6	5	13	0	2896
14414	20	7	2981	8	0	3016
14415	9	5	16	2944	0	2974
14416	2	10	1	3035	0	3048
14417	7	11	0	3054	0	3072
14418	6	11	4	3009	0	3030
14419	3	17	2940	14	0	2974
14420	19	12	2676	5	0	2712
14421	2809	9	16	13	0	2847
14422	14	2977	2	7	0	3000
14423	5	2983	3	9	0	3000
14424	3036	14	4	12	0	3066
14425	16	3113	2	5	0	3136
14426	7	17	2	3241	0	3267
14427	3276	5	3	23	0	3307
14428	17	6	3299	7	0	3329
14429	4	2	17	3362	0	3385
14430	5	4	3375	21	0	3405
14431	3320	4	16	21	0	3361
14432	20	5	3631	8	0	3664
14433	3682	4	22	25	0	3733
14434	3882	3	13	17	0	3915
14435	3893	2	5	13	0	3913
14436	3917	8	1	13	0	3939
14437	3942	9	2	9	0	3962
14438	27	6	4	3969	0	4006
14439	4132	4	3	36	0	4175
14440	24	4	3	4160	0	4191
14441	15	1	4	4150	0	4170
14442	12	2	4	4142	0	4160
14443	6	6	4150	27	0	4189
14444	11	2	20	4065	0	4098
14445	8	5	10	4197	0	4220
14446	9	6	4122	26	0	4163
14447	3843	2	19	19	0	3883
14448	32	5	8	4222	0	4267
14449	16	2	4239	24	0	4281
14450	11	2	4128	10	0	4151
14451	12	3	23	4160	0	4198
14452	13	3	4306	26	0	4348
14453	15	3	21	4364	0	4403
14454	13	0	10	4354	0	4377
14455	10	4367	5	32	0	4414
14456	2	4418	5	20	0	4445
14457	4489	20	5	18	0	4532
14458	22	5	5	4568	0	4600
14459	13	2	5	4513	0	4533
14460	8	3	6	4645	0	4662
14461	7	1	4711	30	0	4749
14462	12	2	21	4623	0	4658
14463	4700	4	14	39	0	4757
14464	20	5	4751	14	0	4790
14465	17	3	24	4910	0	4954
14466	5	3	12	4945	0	4965
14467	8	1	6	5067	0	5082
14468	3	5248	6	44	0	5301
14469	5300	40	5	24	0	5369
14470	5441	13	4	14	0	5472
14471	60	5628	4	8	0	5700
14472	22	47	7	6011	0	6087
14473	16	12	6066	70	0	6164
14474	12	12	5912	29	0	5965
14475	6212	3	84	34	0	6333
14476	88	5	36	6414	0	6543
14477	6749	4	20	99	0	6872
14478	115	6915	16	33	0	7079
14479	44	7090	10	25	0	7169
14480	7065	138	5	40	0	7248
14481	116	7382	10	19	0	7527
14482	57	137	6	7523	0	7723
14483	39	54	6	7306	0	7405
14484	20	7504	8	133	0	7665
14485	7573	124	3	75	0	7775
14486	119	58	7620	45	0	7842
14487	7388	26	122	43	0	7579
14488	152	23	7727	15	0	7917
14489	7193	21	136	46	0	7396
14490	164	18	7797	18	0	7997
14491	65	7679	154	16	0	7914
14492	59	143	51	7796	0	8049
14493	7810	52	31	151	0	8044
14494	151	29	7721	42	0	7943
14495	65	22	7837	25	0	7949
14496	50	25	173	7662	0	7910
14497	30	16	8008	131	0	8185
14498	36	14	147	7808	0	8005
14499	47	14	61	7657	0	7779
14500	17	13	7985	174	0	8189
14501	34	9	142	7913	0	8098
14502	8107	5	61	188	0	8361
14503	130	8110	37	68	0	8345
14504	8292	124	27	57	0	8500
14505	150	50	33	8047	0	8280
14506	8102	26	17	175	0	8320
14507	8254	21	21	83	0	8379
14508	198	19	22	8155	0	8394
14509	75	8170	19	146	0	8410
14510	8320	129	16	83	0	8548
14511	156	52	8062	35	0	8305
14512	78	31	8003	30	0	8142
14513	7982	20	173	47	0	8222
14514	160	17	77	8070	0	8324
14515	69	15	8111	149	0	8344
14516	52	10	152	8072	0	8286
14517	8228	19	65	181	0	8493
14518	8455	9	41	101	0	8606
14519	8511	14	35	64	0	8624
14520	203	8636	31	31	0	8901
14521	113	134	23	8797	0	9067
14522	65	65	23	8836	0	8989
14523	8746	30	24	195	0	8995
14524	161	8659	22	89	0	8931
14525	8674	145	18	76	0	8913
14526	176	56	20	8621	0	8873
14527	8593	42	18	166	0	8819
14528	181	51	8230	69	0	8531
14529	82	8329	144	52	0	8607
14530	74	148	62	8261	0	8545
14531	56	8581	43	124	0	8804
14532	55	144	23	8480	0	8702
14533	8373	61	25	164	0	8623
14534	163	57	8027	66	0	8313
14535	7887	32	132	73	0	8124
14536	180	8295	61	39	0	8575
14537	94	146	38	8527	0	8805
14538	60	59	32	8662	0	8813
14539	8368	39	34	219	0	8660
14540	154	30	8276	92	0	8552
14541	87	28	132	8427	0	8674
14542	68	21	59	8518	0	8666
14543	61	22	49	8550	0	8682
14544	53	23	45	8599	0	8720
14545	8434	19	28	234	0	8715
14546	8369	19	29	121	0	8538
14547	196	23	8414	70	0	8703
14548	96	32	8043	69	0	8240
14549	8524	24	159	76	0	8783
14550	8800	22	78	79	0	8979
14551	210	12	49	8737	0	9008
14552	103	20	38	8713	0	8874
14553	8571	21	40	205	0	8837
14554	171	8487	47	98	0	8803
14555	91	122	28	8647	0	8888
14556	78	46	32	8777	0	8933
14557	59	33	8544	200	0	8836
14558	66	25	145	8489	0	8725
14559	63	38	8604	189	0	8894
14560	61	22	141	8579	0	8803
14561	8507	10	71	222	0	8810
14562	171	24	44	8617	0	8856
14563	98	24	8474	184	0	8780
14564	69	8130	152	107	0	8458
14565	51	122	66	8477	0	8716
14566	58	47	8418	176	0	8699
14567	55	8363	132	87	0	8637
14568	59	137	64	8307	0	8567
14569	34	62	8243	156	0	8495
14570	6976	33	116	128	0	7253
14571	128	7822	62	61	0	8073
14572	51	7501	37	50	0	7639
14573	39	7656	27	47	0	7769
14574	75	182	35	7323	0	7615
14575	32	41	7470	104	0	7647
14576	18	7300	97	49	0	7464
14577	45	126	26	7149	0	7346
14578	7448	17	27	113	0	7605
14579	109	18	15	9758	0	9900
14580	39	16	11951	222	0	12228
14581	27	12005	300	63	0	12395
14582	11720	329	70	85	0	12204
14583	315	11970	41	35	0	12361
14584	77	355	11651	53	0	12136
14585	42	11716	343	48	0	12149
14586	76	405	125	11506	0	12112
14587	57	152	11525	317	0	12051
14588	71	11473	364	73	0	11981
14589	126	422	113	11299	0	11960
14590	85	194	105	11364	0	11748
14591	33	11405	114	383	0	11935
14592	56	415	104	11462	0	12037
14593	25	183	11349	418	0	11975
14594	25	160	11543	173	0	11901
14595	53	144	415	11389	0	12001
14596	11197	130	135	492	0	11954
14597	11288	109	99	242	0	11738
14598	392	116	94	10992	0	11594
14599	97	11129	135	433	0	11794
14600	97	351	164	11218	0	11830
14601	10984	110	141	481	0	11716
14602	438	81	83	11009	0	11611
14603	217	64	57	11253	0	11591
14604	10885	80	54	516	0	11535
14605	394	10772	58	260	0	11484
14606	168	382	53	10858	0	11461
14607	10746	132	46	515	0	11439
14608	434	100	10394	264	0	11192
14609	10490	63	313	262	0	11128
14610	475	75	81	10668	0	11299
14611	10676	103	52	500	0	11331
14612	10772	105	37	262	0	11176
14613	10048	80	58	253	0	10439
14614	495	10322	84	161	0	11062
14615	260	326	10271	155	0	11012
14616	231	10405	352	146	0	11134
14617	10362	362	105	170	0	10999
14618	525	10148	74	120	0	10867
14619	313	405	63	10153	0	10934
14620	9911	157	77	386	0	10531
14621	432	9918	87	140	0	10577
14622	203	441	9868	100	0	10612
14623	200	218	352	9821	0	10591
14624	183	179	9884	406	0	10652
14625	164	9957	364	213	0	10698
14626	165	434	118	9810	0	10527
14627	161	215	110	10115	0	10601
14628	121	172	122	10119	0	10534
14629	103	139	145	9821	0	10208
14630	78	9736	141	526	0	10481
14631	9506	445	133	275	0	10359
14632	368	194	9508	257	0	10327
14633	147	149	365	9710	0	10371
14634	9499	116	118	612	0	10345
14635	391	132	9494	320	0	10337
14636	165	9345	372	256	0	10138
14637	161	442	183	9255	0	10041
14638	143	183	9303	472	0	10101
14639	136	9314	430	257	0	10137
14640	8950	386	191	252	0	9779
14641	422	9202	154	176	0	9954
14642	157	471	139	9175	0	9942
14643	148	221	141	9542	0	10052
14644	9048	191	136	559	0	9934
14645	397	9121	147	251	0	9916
14646	196	512	140	9205	0	10053
14647	8901	253	119	491	0	9764
14648	8908	224	101	307	0	9540
14649	496	8720	86	287	0	9589
14650	8747	495	72	262	0	9576
14651	9051	240	64	226	0	9581
14652	538	231	74	8736	0	9579
14653	289	177	8501	513	0	9480
14654	287	161	356	8572	0	9376
14655	286	153	124	8827	0	9390
14656	258	170	8382	535	0	9345
14657	277	8193	353	292	0	9115
14658	250	414	168	8364	0	9196
14659	176	150	153	8765	0	9244
14660	165	115	155	8796	0	9231
14661	146	101	165	8552	0	8964
14662	145	8234	151	623	0	9153
14663	8304	403	121	368	0	9196
14664	8426	190	95	320	0	9031
14665	8398	147	56	369	0	8970
14666	502	7910	72	376	0	8860
14667	211	432	58	8103	0	8804
14668	194	209	7792	577	0	8772
14669	231	204	347	7746	0	8528
14670	285	7889	95	471	0	8740
14671	7774	406	64	246	0	8490
14672	7913	203	56	244	0	8416
14673	7802	189	92	229	0	8312
14674	506	7374	112	229	0	8221
14675	247	7154	133	209	0	7743
14676	239	7524	115	193	0	8071
14677	302	468	7147	163	0	8080
14678	311	286	6544	211	0	7352
14679	364	1004	299	2984	0	4651
14680	1820	29	124	69	0	2042
14681	1755	8	8	16	0	1787
14682	40	6	9	1802	0	1857
14683	11	12	5	1777	0	1805
14684	8	3	8	1833	0	1852
14685	11	6	4	1842	0	1863
14686	1822	10	2	49	0	1883
14687	1864	8	6	20	0	1898
14688	45	1940	0	11	0	1996
14689	1968	40	5	12	0	2025
14690	1982	15	5	8	0	2010
14691	2007	7	3	12	0	2029
14692	51	12	1757	16	0	1836
14693	1935	4	33	12	0	1984
14694	49	1925	11	10	0	1995
14695	15	41	3	2007	0	2066
14696	13	16	1	2042	0	2072
14697	13	1969	2	57	0	2041
14698	14	45	3	2072	0	2134
14699	2061	11	4	57	0	2133
14700	53	7	5	2076	0	2141
14701	16	9	2043	55	0	2123
14702	1976	6	45	25	0	2052
14703	53	2079	16	12	0	2160
14704	16	49	6	2100	0	2171
14705	12	10	5	2123	0	2150
14706	14	6	0	2144	0	2164
14707	12	7	2056	64	0	2139
14708	9	2044	46	27	0	2126
14709	14	51	9	2055	0	2129
14710	11	16	2022	50	0	2099
14711	13	10	46	1986	0	2055
14712	11	4	2001	52	0	2068
14713	13	16	52	1937	0	2018
14714	9	1919	17	45	0	1990
14715	12	49	7	1900	0	1968
14716	1908	12	3	57	0	1980
14717	1934	7	1	21	0	1963
14718	54	4	1891	14	0	1963
14719	14	2	1772	7	0	1795
14720	12	4	1945	6	0	1967
14721	6	11	49	1938	0	2004
14722	7	4	13	2061	0	2085
14723	8	1	4	2127	0	2140
14724	5	2107	8	56	0	2176
14725	4	48	4	2102	0	2158
14726	11	9	3	2199	0	2222
14727	5	5	4	2272	0	2286
14728	2234	6	5	65	0	2310
14729	2278	4	3	23	0	2308
14730	60	6	2257	12	0	2335
14731	17	7	2259	12	0	2295
14732	2258	0	57	17	0	2332
14733	2340	1	19	12	0	2372
14734	61	6	2349	12	0	2428
14735	19	8	2314	10	0	2351
14736	2265	4	56	15	0	2340
14737	2339	4	20	8	0	2371
14738	64	2	2336	10	0	2412
14739	23	5	59	2311	0	2398
14740	15	2	14	2363	0	2394
14741	9	2423	11	64	0	2507
14742	12	47	4	2495	0	2558
14743	12	15	2692	62	0	2781
14744	16	8	52	2712	0	2788
14745	10	4	21	2754	0	2789
14746	9	3	2688	80	0	2780
14747	2623	4	62	34	0	2723
14748	2765	3	23	19	0	2810
14749	77	3	15	2697	0	2792
14750	32	4	13	2767	0	2816
14751	2723	6	13	85	0	2827
14752	2736	3	9	37	0	2785
14753	2507	5	11	40	0	2563
14754	2746	1	8	20	0	2775
14755	79	2656	12	15	0	2762
14756	2652	53	4	31	0	2740
14757	60	2657	12	16	0	2745
14758	29	60	7	2666	0	2762
14759	25	17	4	2659	0	2705
14760	14	2559	12	74	0	2659
14761	7	57	11	2605	0	2680
14762	11	18	13	2568	0	2610
14763	17	2564	11	77	0	2669
14764	19	57	4	2594	0	2674
14765	19	13	10	2631	0	2673
14766	18	15	10	2653	0	2696
14767	13	8	2575	84	0	2680
14768	18	2517	64	32	0	2631
14769	19	53	21	2457	0	2550
14770	15	2528	15	61	0	2619
14771	2504	58	18	31	0	2611
14772	63	20	2500	23	0	2606
14773	28	10	2459	15	0	2512
14774	2346	17	74	11	0	2448
14775	56	13	26	2376	0	2471
14776	19	7	2315	56	0	2397
14777	16	8	2259	28	0	2311
14778	20	10	52	2205	0	2287
14779	2182	5	28	55	0	2270
14780	2198	5	10	30	0	2243
14781	60	2	6	2167	0	2235
14782	27	9	2086	49	0	2171
14783	18	2130	45	25	0	2218
14784	15	40	23	2150	0	2228
14785	13	22	2137	54	0	2226
14786	12	2117	42	25	0	2196
14787	16	38	15	2097	0	2166
14788	2032	14	16	46	0	2108
14789	36	7	10	1986	0	2039
14790	22	1993	5	43	0	2063
14791	1998	30	6	23	0	2057
14792	34	12	2046	18	0	2110
14793	20	2037	31	10	0	2098
14794	16	29	2003	16	0	2064
14795	1934	16	34	20	0	2004
14796	36	16	13	1904	0	1969
14797	18	7	12	1988	0	2025
14798	2003	8	10	43	0	2064
14799	34	7	8	2003	0	2052
14800	15	12	1949	43	0	2019
14801	1893	7	33	22	0	1955
14802	34	1980	17	24	0	2055
14803	14	26	10	1962	0	2012
14804	1960	12	7	40	0	2019
14805	38	1932	7	21	0	1998
14806	19	29	6	1996	0	2050
14807	2011	15	10	33	0	2069
14808	37	11	8	2005	0	2061
14809	19	1960	7	41	0	2027
14810	17	28	1990	18	0	2053
14811	19	17	25	2010	0	2071
14812	21	7	10	1932	0	1970
14813	2020	12	13	40	0	2085
14814	39	6	3	2048	0	2096
14815	2032	9	8	47	0	2096
14816	2048	10	11	26	0	2095
14817	43	5	12	2025	0	2085
14818	23	2034	6	37	0	2100
14819	16	29	4	2065	0	2114
14820	1915	15	5	42	0	1977
14821	36	1950	6	24	0	2016
14822	15	1952	4	17	0	1988
14823	1923	33	4	17	0	1977
14824	1959	18	2	19	0	1998
14825	31	1978	9	14	0	2032
14826	1973	29	15	6	0	2023
14827	1942	14	9	10	0	1975
14828	38	5	4	1921	0	1968
14829	17	1	1969	30	0	2017
14830	12	18	28	1982	0	2040
14831	12	2	2027	38	0	2079
14832	15	4	29	2015	0	2063
14833	6	10	2012	31	0	2059
14834	1932	5	25	22	0	1984
14835	27	5	16	1981	0	2029
14836	2107	2	6	31	0	2146
14837	26	14	8	2062	0	2110
14838	17	2136	7	25	0	2185
14839	2174	24	6	28	0	2232
14840	30	19	2102	9	0	2160
14841	2028	14	18	14	0	2074
14842	24	2013	15	8	0	2060
14843	1840	19	2	8	0	1869
14844	1844	7	2	4	0	1857
14845	31	1818	3	4	0	1856
14846	13	20	1	1937	0	1971
14847	1952	10	0	30	0	1992
14848	31	1950	4	11	0	1996
14849	15	31	2	1996	0	2044
14850	2006	13	3	34	0	2056
14851	38	3	0	2008	0	2049
14852	24	2	2	2029	0	2057
14853	10	10	1	2042	0	2063
14854	9	8	1969	46	0	2032
14855	12	3	30	1984	0	2029
14856	1998	6	8	39	0	2051
14857	34	5	1971	19	0	2029
14858	23	7	29	1985	0	2044
14859	6	4	11	2013	0	2034
14860	10	3	1970	48	0	2031
14861	1932	4	32	23	0	1991
14862	2019	4	16	16	0	2055
14863	45	2	2020	16	0	2083
14864	20	4	33	2002	0	2059
14865	10	2	19	2094	0	2125
14866	10	6	2102	48	0	2166
14867	19	5	31	2150	0	2205
14868	7	2	18	2165	0	2192
14869	14	4	2247	51	0	2316
14870	2238	4	39	28	0	2309
14871	42	3	21	2373	0	2439
14872	2373	6	4	59	0	2442
14873	2372	2	8	35	0	2417
14874	53	4	2393	18	0	2468
14875	25	0	38	2370	0	2433
14876	2374	3	18	58	0	2453
14877	42	2399	13	38	0	2492
14878	35	35	8	2462	0	2540
14879	18	10	9	2511	0	2548
14880	20	2	12	2533	0	2567
14881	19	2	2494	69	0	2584
14882	2335	4	64	39	0	2442
14883	47	6	20	2442	0	2515
14884	34	3	6	2460	0	2503
14885	18	4	2415	62	0	2499
14886	21	4	45	2423	0	2493
14887	20	3	24	2496	0	2543
14888	2426	2	15	79	0	2522
14889	51	2409	14	41	0	2515
14890	26	38	2456	33	0	2553
14891	2451	12	50	41	0	2554
14892	56	1	22	2455	0	2534
14893	25	3	2489	63	0	2580
14894	20	8	2517	39	0	2584
14895	21	5	54	2569	0	2649
14896	22	5	2613	62	0	2702
14897	13	4	2548	42	0	2607
14898	18	2525	73	21	0	2637
14899	27	33	25	2682	0	2767
14900	15	18	2675	61	0	2769
14901	24	6	49	2638	0	2717
14902	2733	6	33	68	0	2840
14903	44	5	21	2780	0	2850
14904	35	5	15	2810	0	2865
14905	2739	5	24	73	0	2841
14906	2756	9	16	48	0	2829
14907	60	2	21	2886	0	2969
14908	28	7	2936	69	0	3040
14909	8	2904	56	45	0	3013
14910	22	41	28	2989	0	3080
14911	3022	18	18	65	0	3123
14912	3049	5	16	49	0	3119
14913	68	2988	20	24	0	3100
14914	29	3067	22	24	0	3142
14915	3052	56	11	33	0	3152
14916	3072	16	21	35	0	3144
14917	68	15	3146	23	0	3252
14918	38	12	53	3103	0	3206
14919	20	3175	35	57	0	3287
14920	3306	55	17	40	0	3418
14921	63	23	15	3320	0	3421
14922	31	3247	25	65	0	3368
14923	19	49	3307	40	0	3415
14924	32	34	54	3161	0	3281
14925	19	3321	28	60	0	3428
14926	3338	53	17	46	0	3454
14927	3324	23	11	42	0	3400
14928	73	3329	13	27	0	3442
14929	3265	45	11	30	0	3351
14930	3296	16	16	23	0	3351
14931	62	3205	13	21	0	3301
14932	23	3300	13	26	0	3362
14933	38	70	15	3242	0	3365
14934	3264	16	10	57	0	3347
14935	63	17	3297	21	0	3398
14936	3121	13	45	26	0	3205
14937	48	3291	16	12	0	3367
14938	3304	56	15	16	0	3391
14939	3329	16	7	19	0	3371
14940	3371	9	6	21	0	3407
14941	67	12	11	3276	0	3366
14942	34	3267	13	43	0	3357
14943	3334	52	4	25	0	3415
14944	65	21	3400	10	0	3496
14945	31	3446	44	11	0	3532
14946	22	40	10	3481	0	3553
14947	12	22	3386	44	0	3464
14948	16	18	3370	16	0	3420
14949	25	18	42	3336	0	3421
14950	16	9	16	3507	0	3548
14951	15	11	2	3545	0	3573
14952	17	11	6	3469	0	3503
14953	20	3388	7	43	0	3458
14954	15	3551	6	16	0	3588
14955	3636	41	2	23	0	3702
14956	45	12	5	3644	0	3706
14957	20	11	10	3715	0	3756
14958	15	10	6	3760	0	3791
14959	3746	13	7	61	0	3827
14960	3795	13	9	31	0	3848
14961	45	12	10	3795	0	3862
14962	3860	7	10	59	0	3936
14963	3845	6	6	33	0	3890
14964	3903	5	4	24	0	3936
14965	57	5	8	3869	0	3939
14966	22	10	3690	45	0	3767
14967	18	13	3438	24	0	3493
14968	26	11	3550	10	0	3597
14969	22	4	3659	9	0	3694
14970	17	35	44	3639	0	3735
14971	3653	5	12	34	0	3704
14972	3622	3	2	25	0	3652
14973	40	3	3595	11	0	3649
14974	20	6	3692	4	0	3722
14975	13	4107	32	11	0	4163
14976	12	25	13	4201	0	4251
14977	4223	13	8	38	0	4282
14978	38	6	4134	13	0	4191
14979	4036	5	26	17	0	4084
14980	25	4303	15	11	0	4354
14981	16	24	14	4462	0	4516
14982	15	8	9	4650	0	4682
14983	9	4	14	4535	0	4562
14984	4691	1	11	56	0	4759
14985	40	4	4	4713	0	4761
14986	25	3	5	4761	0	4794
14987	4758	7	8	50	0	4823
14988	45	3	12	4723	0	4783
14989	17	3	4866	45	0	4931
14990	4785	11	32	33	0	4861
14991	48	1	13	4962	0	5024
14992	20	6	10	4895	0	4931
14993	14	4863	8	46	0	4931
14994	4938	34	2	26	0	5000
14995	5020	14	6	29	0	5069
14996	54	8	4	5053	0	5119
14997	24	6	5027	45	0	5102
14998	4730	0	29	36	0	4795
14999	43	4	5073	20	0	5140
15000	28	5	38	5079	0	5150
15001	20	4	15	5332	0	5371
15002	5282	2	9	65	0	5358
15003	50	3	13	5496	0	5562
15004	27	0	5517	54	0	5598
15005	5403	3	38	36	0	5480
15006	48	6	5833	27	0	5914
15007	18	8	5792	14	0	5832
15008	6125	6	60	22	0	6213
15009	70	16	23	6283	0	6392
15010	24	6466	22	47	0	6559
15011	6530	48	11	27	0	6616
15012	6483	16	12	21	0	6532
15013	71	13	6450	18	0	6552
15014	6455	6	64	18	0	6543
15015	80	2	25	6626	0	6733
15016	30	8	6742	57	0	6837
15017	26	6589	60	28	0	6703
15018	6575	51	27	44	0	6697
15019	59	6657	18	20	0	6754
15020	42	67	9	6678	0	6796
15021	28	22	12	6697	0	6759
15022	32	9	9	6653	0	6703
15023	23	8	8	6503	0	6542
15024	12	6516	11	79	0	6618
15025	14	52	6402	36	0	6504
15026	13	6556	46	26	0	6641
15027	6591	55	17	28	0	6691
15028	58	29	14	6598	0	6699
15029	6643	13	5	66	0	6727
15030	70	14	7	6736	0	6827
15031	7109	4	11	105	0	7229
15032	68	7183	6	36	0	7293
15033	7354	53	9	46	0	7462
15034	7402	22	10	36	0	7470
15035	7287	16	10	35	0	7348
15036	7377	11	11	31	0	7430
15037	85	7267	11	20	0	7383
15038	43	46	7229	14	0	7332
15039	37	16	49	7259	0	7361
15040	7309	14	23	78	0	7424
15041	7421	16	14	34	0	7485
15042	95	8	12	7526	0	7641
15043	45	8	7806	61	0	7920
15044	46	8	57	7599	0	7710
15045	28	7775	23	69	0	7895
15046	7886	65	18	47	0	8016
15047	81	24	17	7962	0	8084
15048	37	7755	16	68	0	7876
15049	30	8193	11	28	0	8262
15050	23	8365	12	27	0	8427
15051	33	107	4	8605	0	8749
15052	8640	45	12	105	0	8802
15053	99	8719	8	43	0	8869
15054	52	104	4	8868	0	9028
15055	8812	31	14	119	0	8976
15056	121	36	5	8817	0	8979
15057	8752	15	5	143	0	8915
15058	8850	15	6	70	0	8941
15059	138	9132	7	36	0	9313
15060	82	103	11	8941	0	9137
15061	49	9200	11	88	0	9348
15062	9181	120	18	56	0	9375
15063	9264	41	7	49	0	9361
15064	9479	27	13	47	0	9566
15065	169	25	15	9439	0	9648
15066	75	17	9309	118	0	9519
15067	9125	25	104	54	0	9308
15068	9444	18	27	56	0	9545
15069	160	12	23	9331	0	9526
15070	82	9439	12	101	0	9634
15071	61	112	12	9591	0	9776
15072	53	42	16	9734	0	9845
15073	9644	34	18	171	0	9867
15074	9423	20	15	84	0	9542
15075	154	26	9037	44	0	9261
15076	82	16	108	9017	0	9223
15077	9116	20	36	134	0	9306
15078	153	21	23	9224	0	9421
15079	67	25	9213	140	0	9445
15080	65	8796	114	69	0	9044
15081	38	9213	36	59	0	9346
15082	9949	129	24	72	0	10174
15083	157	57	17	10791	0	11022
15084	86	41	12	12283	0	12422
15085	12349	20	15	290	0	12674
15086	270	29	12210	129	0	12638
15087	140	14	228	12318	0	12700
15088	85	19	12469	283	0	12856
15089	62	12353	251	126	0	12792
15090	12580	240	107	112	0	13039
15091	12937	96	56	89	0	13178
15092	13106	73	49	68	0	13296
15093	390	43	12679	71	0	13183
15094	12783	31	254	75	0	13143
15095	13276	27	105	67	0	13475
15096	422	27	67	12962	0	13478
15097	10852	57	116	376	0	11401
15098	278	40	12701	125	0	13144
15099	12539	27	258	99	0	12923
15100	364	26	12695	58	0	13143
15101	182	12747	282	46	0	13257
15102	154	310	128	12014	0	12606
15103	113	12701	73	221	0	13108
15104	110	267	12478	103	0	12958
15105	92	12631	252	82	0	13057
15106	12104	257	109	80	0	12550
15107	273	11763	74	47	0	12157
15108	127	11757	62	53	0	11999
15109	100	316	11498	39	0	11953
15110	87	155	254	11379	0	11875
15111	11577	98	97	249	0	12021
15112	257	75	11517	95	0	11944
15113	134	11622	239	78	0	12073
15114	108	258	113	11491	0	11970
15115	77	132	11607	239	0	12055
15116	69	82	11491	137	0	11779
15117	87	69	318	11568	0	12042
15118	82	46	11741	259	0	12128
15119	77	61	306	10889	0	11333
15120	66	11146	155	260	0	11627
15121	81	241	104	11360	0	11786
15122	65	11508	79	273	0	11925
15123	90	274	77	11655	0	12096
15124	11510	127	64	314	0	12015
15125	266	84	71	11557	0	11978
15126	126	11439	72	305	0	11942
15127	113	259	59	11742	0	12173
15128	100	118	11538	313	0	12069
15129	93	74	243	11626	0	12036
15130	11516	68	134	324	0	12042
15131	272	61	11053	170	0	11556
15132	153	65	273	11049	0	11540
15133	10900	50	130	321	0	11401
15134	277	10807	89	167	0	11340
15135	153	267	74	10923	0	11417
15136	10992	122	65	313	0	11492
15137	291	85	86	11020	0	11482
15138	163	80	10877	313	0	11433
15139	10666	65	254	180	0	11165
15140	288	10755	134	120	0	11297
15141	142	11091	101	126	0	11460
15142	11051	312	86	123	0	11572
15143	10885	137	65	101	0	11188
15144	377	96	75	10698	0	11246
15145	10758	87	76	266	0	11187
15146	323	82	10391	162	0	10958
15147	10450	72	247	153	0	10922
15148	315	10377	135	102	0	10929
15149	10427	225	91	118	0	10861
15150	315	118	10396	88	0	10917
15151	209	94	243	10287	0	10833
15152	144	84	137	10408	0	10773
15153	136	71	102	9876	0	10185
15154	107	10151	98	290	0	10646
15155	10228	219	74	173	0	10694
15156	299	113	86	9656	0	10154
15157	193	9901	76	238	0	10408
15158	10528	205	73	179	0	10985
15159	10229	120	71	139	0	10559
15160	10339	90	76	123	0	10628
15161	10331	81	70	128	0	10610
15162	10237	66	66	110	0	10479
15163	352	80	71	9954	0	10457
15164	224	72	65	9939	0	10300
15165	9801	64	74	309	0	10248
15166	290	81	66	9839	0	10276
15167	187	99	60	9941	0	10287
15168	144	94	9386	326	0	9950
15169	9622	92	201	197	0	10112
15170	9830	72	127	176	0	10205
15171	9935	105	75	137	0	10252
15172	352	84	76	9160	0	9672
15173	195	9465	77	247	0	9984
15174	10115	210	73	170	0	10568
15175	9852	111	75	151	0	10189
15176	352	89	80	11068	0	11589
15177	11222	77	72	318	0	11689
15178	395	184	8741	260	0	9580
15179	218	11321	198	158	0	11895
15180	226	11736	117	151	0	12230
15181	270	334	11424	139	0	12167
15182	103	10385	286	105	0	10879
15183	107	9793	134	114	0	10148
15184	8270	167	113	70	0	8620
15185	128	8162	47	48	0	8385
15186	85	158	36	8326	0	8605
15187	8502	84	14	160	0	8760
15188	157	61	8184	73	0	8475
15189	8165	48	110	88	0	8411
15190	160	50	8055	63	0	8328
15191	94	19	7914	72	0	8099
15192	7731	40	156	55	0	7982
15193	146	32	7955	56	0	8189
15194	83	7721	144	85	0	8033
15195	76	125	89	7686	0	7976
15196	7762	50	57	129	0	7998
15197	148	7533	29	59	0	7769
15198	80	119	45	7653	0	7897
15199	57	64	7604	139	0	7864
15200	82	41	108	7657	0	7888
15201	7528	32	49	149	0	7758
15202	132	27	7495	73	0	7727
15203	98	21	126	7500	0	7745
15204	7601	31	55	143	0	7830
15205	7787	19	42	96	0	7944
15206	195	24	39	7729	0	7987
15207	118	34	26	7746	0	7924
15208	80	27	7835	169	0	8111
15209	88	35	7594	84	0	7801
15210	7726	24	148	77	0	7975
15211	7946	22	68	78	0	8114
15212	166	7785	58	52	0	8061
15213	7799	111	49	38	0	7997
15214	8028	41	33	51	0	8153
15215	199	40	8112	29	0	8380
15216	106	8341	112	36	0	8595
15217	8433	127	61	38	0	8659
15218	8457	47	48	21	0	8573
15219	8618	29	30	22	0	8699
15220	206	23	30	8419	0	8678
15221	114	33	25	8474	0	8646
15222	78	8342	22	149	0	8591
15223	74	111	19	8550	0	8754
15224	8477	59	20	163	0	8719
15225	136	42	15	8513	0	8706
15226	80	36	8288	164	0	8568
15227	67	41	8073	78	0	8259
15228	68	22	153	8303	0	8546
15229	52	17	8389	144	0	8602
15230	34	22	8142	89	0	8287
15231	40	16	195	8153	0	8404
15232	44	22	94	8374	0	8534
15233	39	16	8370	184	0	8609
15234	36	20	8294	96	0	8446
15235	30	8409	180	73	0	8692
15236	8487	119	93	76	0	8775
15237	125	8639	75	49	0	8888
15238	8648	146	73	44	0	8911
15239	8762	65	54	34	0	8915
15240	186	8822	40	33	0	9081
15241	8906	154	27	36	0	9123
15242	192	76	29	8835	0	9132
15243	111	41	8940	149	0	9241
15244	88	42	149	8829	0	9108
15245	62	39	66	9097	0	9264
15246	8704	25	49	243	0	9021
15247	8852	22	44	123	0	9041
15248	8896	17	36	89	0	9038
15249	8933	22	25	72	0	9052
15250	8547	23	25	62	0	8657
15251	284	8211	25	30	0	8550
15252	146	150	24	8450	0	8770
15253	96	63	8480	170	0	8809
15254	87	41	162	8485	0	8775
15255	71	27	66	8537	0	8701
15256	54	28	46	8808	0	8936
15257	8876	8	54	260	0	9198
15258	210	8	54	8879	0	9151
15259	9057	12	22	274	0	9365
15260	253	22	9249	118	0	9642
15261	138	19	198	10649	0	11004
15262	93	19	10929	296	0	11337
15263	10916	15	281	145	0	11357
15264	312	16	126	11040	0	11494
15265	125	24	11135	298	0	11582
15266	98	18	280	11217	0	11613
15267	11266	19	123	352	0	11760
15268	308	21	11074	167	0	11570
15269	11201	10	278	133	0	11622
15270	11569	14	131	107	0	11821
15271	11514	19	70	113	0	11716
15272	11469	8	77	89	0	11643
15273	422	10943	63	64	0	11492
15274	207	10606	50	69	0	10932
15275	151	10386	63	56	0	10656
15276	124	490	64	9001	0	9679
15277	73	9173	59	201	0	9506
15278	8841	202	46	83	0	9172
15279	200	8640	31	60	0	8931
15280	100	8735	34	52	0	8921
15281	80	226	40	8713	0	9059
15282	79	93	42	8905	0	9119
15283	8708	58	26	269	0	9061
15284	224	41	40	8728	0	9033
15285	123	40	8458	220	0	8841
15286	87	32	7959	130	0	8208
15287	80	33	8226	67	0	8406
15288	104	29	238	8148	0	8519
15289	98	24	90	8659	0	8871
15290	67	43	8442	254	0	8806
15291	82	37	8354	118	0	8591
15292	63	48	8804	71	0	8986
15293	8885	43	284	85	0	9297
15294	246	43	117	8981	0	9387
15295	123	47	65	9176	0	9411
15296	9023	49	55	296	0	9423
15297	255	46	47	9048	0	9396
15298	118	8918	41	267	0	9344
15299	66	9269	30	155	0	9520
15300	78	251	40	9249	0	9618
15301	9160	114	45	286	0	9605
15302	9195	62	37	152	0	9446
15303	9278	41	47	119	0	9485
15304	303	29	59	9101	0	9492
15305	147	26	8846	264	0	9283
15306	112	13	223	8905	0	9253
15307	78	19	8873	280	0	9250
15308	8503	24	263	164	0	8954
15309	244	29	146	8695	0	9114
15310	8479	20	97	301	0	8897
15311	261	19	8631	157	0	9068
15312	8242	24	251	124	0	8641
15313	281	19	8793	111	0	9204
15314	162	8218	236	108	0	8724
15315	126	8311	121	81	0	8639
15316	8094	238	81	103	0	8516
15317	281	101	52	8043	0	8477
15318	164	64	8051	219	0	8498
15319	107	7929	195	123	0	8354
15320	104	8228	99	65	0	8496
15321	107	272	53	8165	0	8597
15322	8203	99	49	265	0	8616
15323	8283	73	49	148	0	8553
15324	279	8203	61	92	0	8635
15325	8282	224	41	110	0	8657
15326	291	88	49	8268	0	8696
15327	154	66	8179	250	0	8649
15328	104	8226	214	145	0	8689
15329	105	212	113	8291	0	8721
15330	90	89	82	8463	0	8724
15331	8295	51	72	324	0	8742
15332	254	59	8133	137	0	8583
15333	8164	51	228	118	0	8561
15334	8344	53	118	91	0	8606
15335	325	36	89	8148	0	8598
15336	153	40	82	8285	0	8560
15337	8008	59	71	298	0	8436
15338	283	59	57	8016	0	8415
15339	140	50	7889	284	0	8363
15340	91	31	7710	143	0	7975
15341	98	7583	230	81	0	7992
15342	72	8022	109	88	0	8291
15343	102	255	55	7572	0	7984
15344	80	7578	65	222	0	7945
15345	7708	221	46	149	0	8124
15346	208	7747	43	92	0	8090
15347	122	225	33	7786	0	8166
15348	79	117	34	7942	0	8172
15349	83	72	7693	279	0	8127
15350	92	65	201	7684	0	8042
15351	94	50	93	7835	0	8072
15352	80	7719	65	312	0	8176
15353	87	179	60	7834	0	8160
15354	80	87	58	8017	0	8242
15355	94	50	7728	306	0	8178
15356	72	7625	214	179	0	8090
15357	63	513	104	6888	0	7568
15358	54	7264	69	220	0	7607
15359	48	188	6924	121	0	7281
15360	50	6591	183	88	0	6912
15361	5079	174	94	100	0	5447
15362	4946	45	25	32	0	5048
15363	4924	32	24	27	0	5007
15364	131	4868	10	16	0	5025
15365	4819	88	12	19	0	4938
15366	116	35	11	4749	0	4911
15367	4622	32	5	99	0	4758
15368	106	4533	10	39	0	4688
15369	4582	82	9	49	0	4722
15370	4682	36	12	36	0	4766
15371	112	4705	16	27	0	4860
15372	63	102	4698	15	0	4878
15373	55	55	92	5062	0	5264
15374	27	27	5487	122	0	5663
15375	33	32	140	5728	0	5933
15376	35	18	57	6105	0	6215
15377	15	20	6103	227	0	6365
15378	27	14	172	6245	0	6458
15379	6257	16	66	224	0	6563
15380	162	18	6254	101	0	6535
15381	71	6246	172	67	0	6556
15382	57	165	74	6135	0	6431
15383	49	66	37	6438	0	6590
15384	35	42	6255	233	0	6565
15385	43	36	171	6082	0	6332
15386	25	6223	71	207	0	6526
15387	6084	170	49	115	0	6418
15388	164	6147	27	64	0	6402
15389	5794	177	24	56	0	6051
15390	168	5773	23	35	0	5999
15391	64	5874	17	31	0	5986
15392	42	194	5447	30	0	5713
15393	38	99	146	5370	0	5653
15394	43	50	56	5313	0	5462
15395	26	43	31	5535	0	5635
15396	24	5642	28	212	0	5906
15397	20	164	17	5755	0	5956
15398	5725	58	16	222	0	6021
15399	180	44	22	5778	0	6024
15400	5750	23	10	244	0	6027
15401	207	22	5681	99	0	6009
15402	5772	23	164	91	0	6050
15403	225	28	64	5781	0	6098
15404	91	18	39	6139	0	6287
15405	6176	26	37	246	0	6485
15406	205	17	6126	121	0	6469
15407	91	6083	175	87	0	6436
15408	72	186	78	6201	0	6537
15409	6144	64	46	225	0	6479
15410	6308	56	39	96	0	6499
15411	265	40	31	6146	0	6482
15412	104	49	6039	236	0	6428
15413	5846	25	187	113	0	6171
15414	215	45	5916	79	0	6255
15415	105	43	208	5883	0	6239
15416	75	27	5885	242	0	6229
15417	63	32	219	5817	0	6131
15418	55	28	5733	248	0	6064
15419	40	5631	224	124	0	6019
15420	74	179	82	5198	0	5533
15421	35	5643	82	198	0	5958
15422	5651	200	35	113	0	5999
15423	5774	67	61	78	0	5980
15424	261	64	5535	78	0	5938
15425	119	36	198	5550	0	5903
15426	5653	43	69	222	0	5987
15427	239	39	63	5587	0	5928
15428	107	37	35	5671	0	5850
15429	91	25	5439	279	0	5834
15430	5317	26	197	161	0	5701
15431	243	17	5491	99	0	5850
15432	105	19	229	5486	0	5839
15433	91	19	5481	252	0	5843
15434	5416	13	233	141	0	5803
15435	5528	11	105	118	0	5762
15436	5527	24	100	92	0	5743
15437	289	33	67	5352	0	5741
15438	128	19	5304	235	0	5686
15439	118	27	5362	129	0	5636
15440	79	50	271	4943	0	5343
15441	75	5191	111	216	0	5593
15442	5069	177	87	116	0	5449
15443	231	66	75	5043	0	5415
15444	107	58	4994	234	0	5393
15445	83	47	210	5080	0	5420
15446	73	39	5188	251	0	5551
15447	79	57	219	5236	0	5591
15448	63	43	5263	270	0	5639
15449	84	20	5300	126	0	5530
15450	53	5158	240	128	0	5579
15451	66	166	5218	89	0	5539
15452	62	66	5305	98	0	5531
15453	86	44	265	4544	0	4939
15454	68	30	112	4918	0	5128
15455	62	4986	107	223	0	5378
15456	5019	151	85	120	0	5375
15457	200	5022	87	87	0	5396
15458	101	169	70	5084	0	5424
15459	5124	71	72	215	0	5482
15460	213	52	66	5141	0	5472
15461	5175	32	58	238	0	5503
15462	219	43	66	5277	0	5605
15463	119	31	5251	246	0	5647
15464	86	40	192	5353	0	5671
15465	69	21	95	5507	0	5692
15466	5354	29	65	271	0	5719
15467	5373	24	76	165	0	5638
15468	5351	29	78	107	0	5565
15469	230	4991	83	118	0	5422
15470	109	5108	84	71	0	5372
15471	5081	149	69	99	0	5398
15472	194	62	5081	83	0	5420
15473	93	39	4862	64	0	5058
15474	101	189	177	4169	0	4636
15475	48	27	4173	113	0	4361
15476	37	30	3894	56	0	4017
15477	3657	42	145	51	0	3895
15478	3724	14	48	49	0	3835
15479	99	3696	45	38	0	3878
15480	52	3916	48	26	0	4042
15481	51	82	32	3612	0	3777
15482	40	3886	38	78	0	4042
15483	3982	84	37	46	0	4149
15484	98	24	25	3855	0	4002
15485	44	3948	18	93	0	4103
15486	4047	80	27	42	0	4196
15487	96	34	4042	37	0	4209
15488	47	28	3972	32	0	4079
15489	4019	22	93	43	0	4177
15490	91	28	3962	30	0	4111
15491	3911	11	83	36	0	4041
15492	94	15	46	3994	0	4149
15493	42	11	4055	74	0	4182
15494	43	3895	80	36	0	4054
15495	29	4025	56	32	0	4142
15496	3678	56	26	33	0	3793
15497	57	3754	16	25	0	3852
15498	3513	40	19	18	0	3590
15499	3503	16	15	13	0	3547
15500	38	3476	13	10	0	3537
15501	28	36	18	3473	0	3555
15502	15	12	3464	37	0	3528
15503	18	3592	50	7	0	3667
15504	22	132	13	3455	0	3622
15505	6	25	11	3706	0	3748
15506	3622	9	4	57	0	3692
15507	42	5	9	3586	0	3642
15508	17	7	3559	45	0	3628
15509	9	3583	47	22	0	3661
15510	11	46	16	3670	0	3743
15511	3660	11	6	53	0	3730
15512	3739	10	7	32	0	3788
15513	65	6	9	3763	0	3843
15514	3875	10	6	60	0	3951
15515	61	6	3880	25	0	3972
15516	32	9	49	3903	0	3993
15517	21	9	3970	65	0	4065
15518	26	4	58	4360	0	4448
15519	24	3	23	4387	0	4437
15520	17	4	15	4437	0	4473
15521	24	7	13	4436	0	4480
15522	13	7	14	4420	0	4454
15523	4379	10	8	122	0	4519
15524	4447	2	10	66	0	4525
15525	95	4404	9	44	0	4552
15526	4487	73	5	43	0	4608
15527	98	26	9	4495	0	4628
15528	60	13	11	4561	0	4645
15529	37	10	16	4539	0	4602
15530	31	9	4586	119	0	4745
15531	40	13	95	4385	0	4533
15532	21	4524	35	114	0	4694
15533	4568	80	14	82	0	4744
15534	4564	25	21	67	0	4677
15535	112	11	4498	51	0	4672
15536	43	4538	84	53	0	4718
15537	41	90	27	4566	0	4724
15538	39	29	4562	111	0	4741
15539	38	26	90	4339	0	4493
15540	34	4438	28	109	0	4609
15541	4365	87	18	76	0	4546
15542	99	4413	20	50	0	4582
15543	53	99	4481	41	0	4674
15544	36	47	4436	38	0	4557
15545	22	4330	120	47	0	4519
15546	26	4348	40	46	0	4460
15547	4210	105	32	42	0	4389
15548	4250	39	24	48	0	4361
15549	119	34	30	4203	0	4386
15550	43	39	4174	109	0	4365
15551	51	23	88	4176	0	4338
15552	44	20	56	4189	0	4309
15553	4117	24	22	138	0	4301
15554	4106	39	20	65	0	4230
15555	141	25	22	4206	0	4394
15556	57	26	4210	123	0	4416
15557	26	4205	113	66	0	4410
15558	4186	92	56	52	0	4386
15559	96	4285	23	53	0	4457
15560	69	124	22	4388	0	4603
15561	78	46	20	4559	0	4703
15562	61	39	27	4504	0	4631
15563	37	27	25	4433	0	4522
15564	4288	37	27	170	0	4522
15565	133	22	19	4332	0	4506
15566	59	4246	10	162	0	4477
15567	64	94	27	4353	0	4538
15568	4211	44	22	171	0	4448
15569	104	4225	22	114	0	4465
15570	62	114	30	4277	0	4483
15571	58	58	4182	131	0	4429
15572	4149	37	99	78	0	4363
15573	129	46	49	4167	0	4391
15574	56	33	4115	154	0	4358
15575	50	27	4028	89	0	4194
15576	58	60	133	4019	0	4270
15577	4002	33	61	161	0	4257
15578	4034	22	36	93	0	4185
15579	134	4038	26	86	0	4284
15580	3917	98	26	85	0	4126
15581	3966	42	19	82	0	4109
15582	3977	27	26	68	0	4098
15583	3918	40	17	65	0	4040
15584	163	23	18	3842	0	4046
15585	98	20	24	3881	0	4023
15586	74	33	3693	140	0	3940
15587	49	3496	90	96	0	3731
15588	41	3627	59	66	0	3793
15589	45	102	3579	62	0	3788
15590	3543	47	104	77	0	3771
15591	132	33	45	3593	0	3803
15592	3614	28	31	141	0	3814
15593	3607	32	39	83	0	3761
15594	154	29	3504	50	0	3737
15595	98	32	98	3494	0	3722
15596	3572	30	35	111	0	3748
15597	143	27	27	3529	0	3726
15598	82	26	3476	140	0	3724
15599	63	89	93	3378	0	3623
15600	54	3501	58	108	0	3721
15601	47	3645	32	63	0	3787
15602	42	110	3471	57	0	3680
15603	36	3323	101	44	0	3504
15604	3154	96	43	52	0	3345
15605	3064	34	27	45	0	3170
15606	98	22	28	2987	0	3135
15607	56	21	15	3033	0	3125
15608	51	15	26	3086	0	3178
15609	3000	19	15	103	0	3137
15610	91	2998	12	49	0	3150
15611	2986	65	12	43	0	3106
15612	2947	24	23	38	0	3032
15613	98	2919	9	41	0	3067
15614	2772	57	11	28	0	2868
15615	69	2768	8	25	0	2870
15616	2778	60	15	27	0	2880
15617	69	20	2722	29	0	2840
15618	2226	39	68	24	0	2357
15619	50	2253	16	9	0	2328
15620	31	41	27	2245	0	2344
15621	19	13	4	2334	0	2370
15622	16	12	5	2335	0	2368
15623	2347	6	3	72	0	2428
15624	56	7	5	2389	0	2457
15625	23	3	2321	75	0	2422
15626	2302	9	42	29	0	2382
15627	62	9	2314	26	0	2411
15628	31	11	54	2307	0	2403
15629	27	14	2333	60	0	2434
15630	16	13	49	2202	0	2280
15631	11	2226	15	60	0	2312
15632	15	41	16	2232	0	2304
15633	14	2193	13	60	0	2280
15634	12	50	10	2244	0	2316
15635	2219	16	9	59	0	2303
15636	47	16	9	2290	0	2362
15637	2293	6	10	64	0	2373
15638	64	10	2197	20	0	2291
15639	2237	9	40	36	0	2322
15640	2289	8	15	11	0	2323
15641	2298	8	21	11	0	2338
15642	78	5	2	2279	0	2364
15643	2240	6	4	53	0	2303
15644	65	6	2171	20	0	2262
15645	2197	5	43	27	0	2272
15646	68	7	2179	11	0	2265
15647	2202	6	50	14	0	2272
15648	67	9	18	2234	0	2328
15649	24	6	2276	47	0	2353
15650	31	6	42	2239	0	2318
15651	19	6	14	2313	0	2352
15652	18	8	2271	58	0	2355
15653	2182	5	48	31	0	2266
15654	52	2312	17	28	0	2409
15655	2273	39	15	23	0	2350
15656	58	2240	8	12	0	2318
15657	2205	45	12	22	0	2284
15658	54	12	2159	15	0	2240
15659	1959	24	57	17	0	2057
15660	43	1922	14	8	0	1987
15661	10	23	7	1858	0	1898
15662	18	4	7	1892	0	1921
15663	7	8	3	1901	0	1919
15664	8	4	1901	38	0	1951
15665	8	3	27	1875	0	1913
15666	9	1	1937	39	0	1986
15667	1965	4	38	15	0	2022
15668	2143	3	5	21	0	2172
15669	44	2	11	2193	0	2250
15670	15	3	2243	41	0	2302
15671	2220	0	39	15	0	2274
15672	44	1	2751	13	0	2809
15673	18	8	58	2712	0	2796
15674	21	1	13	2825	0	2860
15675	14	3	15	2930	0	2962
15676	12	4	4	3010	0	3030
15677	2868	2	11	88	0	2969
15678	61	2929	5	32	0	3027
15679	18	57	2869	22	0	2966
15680	19	2865	58	17	0	2959
15681	2887	67	13	19	0	2986
15682	71	12	14	2911	0	3008
15683	2950	15	6	86	0	3057
15684	79	3	11	2980	0	3073
15685	23	10	6	3012	0	3051
15686	28	5	15	3030	0	3078
15687	10	13	2941	94	0	3058
15688	17	2915	63	42	0	3037
15689	9	56	2968	40	0	3073
15690	18	12	68	2995	0	3093
15691	3072	14	16	82	0	3184
15692	3068	11	21	38	0	3138
15693	3124	5	14	36	0	3179
15694	76	3103	13	25	0	3217
15695	3236	60	8	28	0	3332
15696	79	14	9	3237	0	3339
15697	38	16	11	3279	0	3344
15698	32	9	7	3323	0	3371
15699	22	3284	10	92	0	3408
15700	25	59	8	3183	0	3275
15701	26	3231	10	62	0	3329
15702	3246	80	4	31	0	3361
15703	3264	20	11	35	0	3330
15704	86	20	6	3296	0	3408
15705	40	9	3209	85	0	3343
15706	3158	10	52	47	0	3267
15707	77	8	18	3279	0	3382
15708	26	22	3235	68	0	3351
15709	3118	11	64	37	0	3230
15710	78	10	18	3325	0	3431
15711	3285	6	17	91	0	3399
15712	81	3229	13	41	0	3364
15713	41	65	7	3242	0	3355
15714	28	3367	14	74	0	3483
15715	18	85	8	3435	0	3546
15716	28	3427	11	73	0	3539
15717	25	63	9	3494	0	3591
15718	21	11	3441	82	0	3555
15719	2833	27	60	54	0	2974
15720	67	3351	14	26	0	3458
15721	19	55	3281	24	0	3379
15722	3227	15	49	26	0	3317
15723	56	13	14	3382	0	3465
15724	23	8	3401	58	0	3490
15725	24	3438	41	22	0	3525
15726	14	49	19	3517	0	3599
15727	15	12	3571	55	0	3653
15728	19	17	46	3569	0	3651
15729	18	7	17	3676	0	3718
15730	9	20	3805	58	0	3892
15731	16	10	45	3825	0	3896
15732	11	12	3936	63	0	4022
15733	19	7	47	3951	0	4024
15734	14	20	4085	63	0	4182
15735	12	9	59	4120	0	4200
15736	23	9	20	4130	0	4182
15737	14	9	21	4127	0	4171
15738	9	4059	17	70	0	4155
15739	4094	48	18	43	0	4203
15740	4166	18	12	47	0	4243
15741	59	13	21	4217	0	4310
15742	4248	5	16	84	0	4353
15743	55	11	4216	42	0	4324
15744	20	4288	61	33	0	4402
15745	4366	50	18	39	0	4473
15746	51	4351	22	28	0	4452
15747	26	48	11	4462	0	4547
15748	23	16	16	4468	0	4523
15749	4355	15	12	87	0	4469
15750	61	8	11	4402	0	4482
15751	23	15	4339	68	0	4445
15752	20	4300	48	29	0	4397
15753	4359	48	14	37	0	4458
15754	55	19	10	4361	0	4445
15755	23	4463	10	62	0	4558
15756	30	42	5	4484	0	4561
15757	19	4533	17	61	0	4630
15758	4590	56	12	35	0	4693
15759	4577	19	8	33	0	4637
15760	61	21	4504	21	0	4607
15761	32	17	4409	22	0	4480
15762	28	15	46	4500	0	4589
15763	25	4565	17	48	0	4655
15764	15	44	13	4664	0	4736
15765	4626	17	16	63	0	4722
15766	47	18	4550	24	0	4639
15767	36	18	36	4398	0	4488
15768	15	12	4433	40	0	4500
15769	13	13	4256	19	0	4301
15770	9	4451	32	29	0	4521
15771	39	109	25	4275	0	4448
15772	4007	9	10	17	0	4043
15773	13	8	4008	9	0	4038
15774	7	3974	14	8	0	4003
15775	3912	4	5	12	0	3933
15776	5	4	8	3969	0	3986
15777	4070	3	2	28	0	4103
15778	4132	5	2	28	0	4167
15779	4239	0	3	26	0	4268
15780	18	4	4411	0	0	4433
15781	4234	1	7	16	0	4258
15782	4463	3	4	9	0	4479
15783	10	4502	9	2	0	4523
15784	13	11	0	4594	0	4618
15785	13	3	2	4542	0	4560
15786	3	4	3	4623	0	4633
15787	4627	2	4	22	0	4655
15788	4501	3	1	19	0	4524
15789	22	3	4615	6	0	4646
15790	18	2	13	4598	0	4631
15791	6	4525	8	20	0	4559
15792	4622	11	4	20	0	4657
15793	16	9	4614	6	0	4645
15794	19	6	14	4514	0	4553
15795	14	2	5	4581	0	4602
15796	9	4599	8	21	0	4637
15797	4	12	5	4688	0	4709
15798	12	9	3	4440	0	4464
15799	10	7	3	4659	0	4679
15800	4649	1	4	35	0	4689
15801	21	3	3	4620	0	4647
15802	12	1	3	4646	0	4662
15803	4721	4	4	48	0	4777
15804	19	7	1	4827	0	4854
15805	11	5037	2	23	0	5073
15806	5225	29	5	31	0	5290
15807	5422	10	2	38	0	5472
15808	5625	9	1	25	0	5660
15809	6315	2	2	24	0	6343
15810	90	6816	5	10	0	6921
15811	7750	86	2	16	0	7854
15812	7915	30	1	29	0	7975
15813	179	23	2	7821	0	8025
15814	62	13	7660	128	0	7863
15815	68	3	114	7640	0	7825
15816	66	3	28	7744	0	7841
15817	52	4	24	7702	0	7782
15818	27	5	26	7756	0	7814
15819	30	6	23	7804	0	7863
15820	7609	6	5	237	0	7857
15821	157	2	5	7692	0	7856
15822	52	4	7737	200	0	7993
15823	53	5	123	7619	0	7800
15824	31	7680	35	175	0	7921
15825	58	127	25	7721	0	7931
15826	24	34	7703	185	0	7946
15827	6988	32	152	96	0	7268
15828	7420	27	38	87	0	7572
15829	175	25	7685	46	0	7931
15830	72	7547	147	52	0	7818
15831	7673	130	55	44	0	7902
15832	7717	33	30	45	0	7825
15833	7737	28	20	43	0	7828
15834	7653	19	29	39	0	7740
15835	235	29	9	7459	0	7732
15836	117	13	7463	158	0	7751
15837	108	16	143	7471	0	7738
15838	85	15	41	7754	0	7895
15839	62	17	7609	211	0	7899
15840	47	19	7507	105	0	7678
15841	7381	18	201	94	0	7694
15842	183	7547	81	85	0	7896
15843	100	142	63	7622	0	7927
15844	72	48	7504	189	0	7813
15845	7190	39	192	115	0	7536
15846	199	26	7517	90	0	7832
15847	7355	33	178	106	0	7672
15848	200	7452	74	100	0	7826
15849	103	136	72	7520	0	7831
15850	94	52	7465	206	0	7817
15851	7078	31	182	132	0	7423
15852	199	7353	73	97	0	7722
15853	85	7621	61	76	0	7843
15854	92	185	57	7535	0	7869
15855	76	90	62	7722	0	7950
15856	7949	63	48	248	0	8308
15857	224	7865	54	119	0	8262
15858	129	212	48	8089	0	8478
15859	8026	71	46	278	0	8421
15860	8363	51	51	162	0	8627
15861	8635	43	44	119	0	8841
15862	334	57	8649	97	0	9137
15863	173	40	8774	125	0	9112
15864	9224	32	274	127	0	9657
15865	338	9258	108	126	0	9830
15866	147	9539	91	124	0	9901
15867	136	297	88	9092	0	9613
15868	85	9386	69	313	0	9853
15869	9389	297	73	173	0	9932
15870	326	128	74	9424	0	9952
15871	163	105	9269	332	0	9869
15872	9320	73	276	182	0	9851
15873	9532	98	133	120	0	9883
15874	435	62	103	9306	0	9906
15875	228	62	88	9489	0	9867
15876	203	60	100	9488	0	9851
15877	181	61	86	9406	0	9734
15878	172	71	8864	415	0	9522
15879	140	8745	281	220	0	9386
15880	164	308	103	8267	0	8842
15881	134	8735	95	365	0	9329
15882	135	327	78	8236	0	8776
15883	133	8593	95	333	0	9154
15884	8569	334	75	212	0	9190
15885	8665	126	89	212	0	9092
15886	388	8577	87	154	0	9206
15887	8648	290	68	181	0	9187
15888	391	148	87	8634	0	9260
15889	8506	124	73	375	0	9078
15890	400	8497	66	186	0	9149
15891	8542	328	77	157	0	9104
15892	8778	137	94	118	0	9127
15893	460	138	78	8410	0	9086
15894	232	116	8304	338	0	8990
15895	186	8284	300	159	0	8929
15896	199	317	116	8367	0	8999
15897	8356	189	77	360	0	8982
15898	370	139	8185	200	0	8894
15899	227	113	300	8183	0	8823
15900	181	134	106	8448	0	8869
15901	8338	105	79	442	0	8964
15902	8479	103	85	243	0	8910
15903	8330	97	60	211	0	8698
15904	448	7986	65	190	0	8689
15905	7880	273	75	176	0	8404
15906	400	119	7498	158	0	8175
15907	209	103	7288	176	0	7776
15908	191	101	7262	154	0	7708
15909	210	435	369	5923	0	6937
15910	143	63	5740	243	0	6189
15911	4883	51	162	91	0	5187
15912	176	49	75	4964	0	5264
15913	109	32	5003	189	0	5333
15914	5133	44	149	116	0	5442
15915	207	35	75	5170	0	5487
15916	140	42	46	5296	0	5524
15917	5299	44	41	198	0	5582
15918	194	47	58	5359	0	5658
15919	108	60	5342	186	0	5696
15920	96	23	179	5421	0	5719
15921	90	38	5466	184	0	5778
15922	98	25	185	5334	0	5642
15923	5222	26	75	231	0	5554
15924	180	5056	64	118	0	5418
15925	126	5247	55	93	0	5521
15926	102	159	46	5199	0	5506
15927	92	67	59	5215	0	5433
15928	86	5070	43	202	0	5401
15929	81	5026	45	130	0	5282
15930	69	168	63	4974	0	5274
15931	74	57	56	5045	0	5232
15932	4839	48	55	226	0	5168
15933	143	4758	64	128	0	5093
15934	83	4735	53	113	0	4984
15935	77	4951	44	79	0	5151
15936	4728	175	46	88	0	5037
15937	172	76	4728	80	0	5056
15938	4663	58	136	89	0	4946
15939	161	55	57	4677	0	4950
15940	85	4433	41	182	0	4741
15941	66	4739	34	97	0	4936
15942	4579	174	32	89	0	4874
15943	167	75	39	4482	0	4763
15944	73	4885	49	182	0	5189
15945	4946	141	57	107	0	5251
15946	5106	70	34	82	0	5292
15947	187	75	4916	67	0	5245
15948	4998	85	128	55	0	5266
15949	5130	65	50	62	0	5307
15950	211	39	41	4937	0	5228
15951	93	4823	52	171	0	5139
15952	85	5016	32	84	0	5217
15953	71	209	25	4945	0	5250
15954	4804	79	32	175	0	5090
15955	180	66	4485	96	0	4827
15956	120	39	4350	68	0	4577
15957	85	50	4289	51	0	4475
15958	118	65	4207	45	0	4435
15959	60	4191	140	30	0	4421
15960	66	4132	63	37	0	4298
15961	85	112	3723	44	0	3964
15962	56	57	3622	48	0	3783
15963	23	3216	98	28	0	3365
15964	32	28	51	2873	0	2984
15965	4	23	3002	25	0	3054
15966	9	12	24	2883	0	2928
15967	4	3	19	3091	0	3117
15968	8	6	8	3141	0	3163
15969	10	2	10	3388	0	3410
15970	6	2	3337	53	0	3398
15971	8	2	42	3246	0	3298
15972	3331	4	27	56	0	3418
15973	44	13	3281	26	0	3364
15974	3349	7	41	14	0	3411
15975	49	4	25	3455	0	3533
15976	25	5	3502	43	0	3575
15977	3483	7	48	27	0	3565
15978	54	4	22	3553	0	3633
15979	3581	4	18	59	0	3662
15980	54	4	12	3506	0	3576
15981	30	3525	14	52	0	3621
15982	12	42	3666	31	0	3751
15983	15	20	44	3687	0	3766
15984	3699	10	30	59	0	3798
15985	3711	12	18	32	0	3773
15986	3740	3	11	26	0	3780
15987	3700	4	15	26	0	3745
15988	3653	11	8	15	0	3687
15989	69	3635	11	22	0	3737
15990	3683	45	14	25	0	3767
15991	61	24	3603	19	0	3707
15992	3638	13	45	21	0	3717
15993	69	12	23	3506	0	3610
15994	35	10	3637	48	0	3730
15995	19	16	3597	32	0	3664
15996	28	11	67	3641	0	3747
15997	3701	6	37	63	0	3807
15998	64	3666	21	34	0	3785
15999	3701	43	8	29	0	3781
16000	69	3704	19	16	0	3808
16001	56	54	13	3834	0	3957
16002	46	28	8	3886	0	3968
16003	3868	20	13	82	0	3983
16004	73	20	13	3897	0	4003
16005	45	13	3860	66	0	3984
16006	3850	4	59	39	0	3952
16007	75	9	28	3929	0	4041
16008	40	8	19	3905	0	3972
16009	36	12	3885	65	0	3998
16010	3601	7	51	62	0	3721
16011	3876	12	24	37	0	3949
16012	83	3831	17	23	0	3954
16013	37	51	3771	24	0	3883
16014	41	28	3657	13	0	3739
16015	29	27	71	3688	0	3815
16016	28	17	35	3662	0	3742
16017	29	3679	16	71	0	3795
16018	22	40	3608	40	0	3710
16019	20	31	56	3497	0	3604
16020	23	12	3643	54	0	3732
16021	21	13	49	3498	0	3581
16022	15	3584	33	61	0	3693
16023	13	43	28	3710	0	3794
16024	30	23	21	3699	0	3773
16025	25	10	18	3677	0	3730
16026	3644	18	12	83	0	3757
16027	50	13	3617	40	0	3720
16028	21	3694	64	34	0	3813
16029	25	44	35	3882	0	3986
16030	4016	33	12	79	0	4140
16031	63	22	14	4122	0	4221
16032	4169	13	17	94	0	4293
16033	72	7	4295	56	0	4430
16034	4336	10	72	47	0	4465
16035	83	6	46	4512	0	4647
16036	43	23	4491	90	0	4647
16037	26	4456	75	57	0	4614
16038	26	62	35	4434	0	4557
16039	26	32	16	4564	0	4638
16040	4464	7	25	114	0	4610
16041	84	4397	28	45	0	4554
16042	42	4343	17	23	0	4425
16043	18	4556	20	45	0	4639
16044	4233	85	38	30	0	4386
16045	82	4250	9	30	0	4371
16046	56	65	11	4193	0	4325
16047	21	37	25	4244	0	4327
16048	4212	11	20	98	0	4341
16049	66	4150	10	53	0	4279
16050	35	66	16	4271	0	4388
16051	4347	40	9	88	0	4484
16052	4394	20	11	49	0	4474
16053	4398	14	6	34	0	4452
16054	93	4322	5	32	0	4452
16055	4326	61	8	26	0	4421
16056	76	40	7	4286	0	4409
16057	36	4204	15	60	0	4315
16058	21	4355	11	28	0	4415
16059	56	70	10	4295	0	4431
16060	4253	23	5	79	0	4360
16061	4316	12	2	49	0	4379
16062	80	14	6	4165	0	4265
16063	31	4101	9	56	0	4197
16064	4174	53	8	35	0	4270
16065	67	27	4069	22	0	4185
16066	36	22	4000	15	0	4073
16067	3972	16	59	12	0	4059
16068	59	20	3941	11	0	4031
16069	27	7	41	3622	0	3697
16070	3676	7	16	52	0	3751
16071	39	17	5	3748	0	3809
16072	25	13	3743	41	0	3822
16073	10	3812	45	25	0	3892
16074	20	34	21	3893	0	3968
16075	14	16	3863	43	0	3936
16076	3714	4	50	32	0	3800
16077	43	16	14	3865	0	3938
16078	22	6	3885	47	0	3960
16079	15	4	42	3842	0	3903
16080	7	3815	23	46	0	3891
16081	18	36	6	3971	0	4031
16082	10	19	10	3891	0	3930
16083	18	11	6	3826	0	3861
16084	16	3842	5	56	0	3919
16085	3930	36	5	32	0	4003
16086	42	17	9	3982	0	4050
16087	20	13	3	3988	0	4024
16088	12	10	4	4031	0	4057
16089	14	8	3968	58	0	4048
16090	18	5	34	3984	0	4041
16091	4006	10	19	59	0	4094
16092	43	4035	8	28	0	4114
16093	27	41	4	4178	0	4250
16094	15	27	2	4202	0	4246
16095	4153	6	3	76	0	4238
16096	37	4124	9	33	0	4203
16097	4186	48	4	28	0	4266
16098	4283	26	4	27	0	4340
16099	76	12	4	4266	0	4358
16100	4278	12	0	66	0	4356
16101	59	4133	4	28	0	4224
16102	4201	46	3	27	0	4277
16103	66	25	5	4252	0	4348
16104	4505	15	3	68	0	4591
16105	4622	16	6	33	0	4677
16106	91	17	4407	22	0	4537
16107	4648	6	49	33	0	4736
16108	4846	11	17	21	0	4895
16109	5135	13	10	35	0	5193
16110	141	17	5415	12	0	5585
16111	45	5485	120	19	0	5669
16112	45	123	35	5524	0	5727
16113	5545	43	17	137	0	5742
16114	129	5449	29	52	0	5659
16115	5452	142	10	30	0	5634
16116	158	34	5	5544	0	5741
16117	60	25	5502	135	0	5722
16118	5657	21	124	58	0	5860
16119	167	8	39	5816	0	6030
16120	51	7	5848	150	0	6056
16121	5901	5	149	60	0	6115
16122	173	8	6030	29	0	6240
16123	85	2	165	6238	0	6490
16124	42	15	63	6571	0	6691
16125	6503	10	30	213	0	6756
16126	6570	8	26	95	0	6699
16127	204	6432	14	67	0	6717
16128	6542	163	7	56	0	6768
16129	210	50	6266	29	0	6555
16130	107	37	6192	12	0	6348
16131	6060	44	191	31	0	6326
16132	184	6074	65	26	0	6349
16133	5846	137	54	31	0	6068
16134	174	5828	37	21	0	6060
16135	5821	153	21	21	0	6016
16136	187	60	16	5717	0	5980
16137	81	36	5764	147	0	6028
16138	74	25	138	5794	0	6031
16139	64	14	55	5982	0	6115
16140	5858	13	27	213	0	6111
16141	162	12	5773	74	0	6021
16142	5709	12	153	71	0	5945
16143	176	5631	57	55	0	5919
16144	5756	138	37	35	0	5966
16145	204	52	37	5610	0	5903
16146	92	48	5590	149	0	5879
16147	72	38	143	5635	0	5888
16148	5693	19	60	186	0	5958
16149	175	15	48	5721	0	5959
16150	93	10	44	5669	0	5816
16151	60	5359	35	210	0	5664
16152	74	136	22	5539	0	5771
16153	53	55	5447	203	0	5758
16154	51	31	156	5486	0	5724
16155	50	29	61	5613	0	5753
16156	5422	22	48	218	0	5710
16157	182	18	41	5443	0	5684
16158	86	17	5342	220	0	5665
16159	74	5374	152	101	0	5701
16160	75	147	64	5433	0	5719
16161	67	61	44	5534	0	5706
16162	5394	48	44	216	0	5702
16163	185	5304	33	100	0	5622
16164	83	150	28	5428	0	5689
16165	5212	56	32	210	0	5510
16166	5427	42	38	97	0	5604
16167	224	36	33	5367	0	5660
16168	104	24	5328	219	0	5675
16169	5394	25	151	104	0	5674
16170	210	30	58	5577	0	5875
16171	5533	26	53	235	0	5847
16172	5563	32	54	120	0	5769
16173	240	5273	33	101	0	5647
16174	5326	144	28	97	0	5595
16175	239	5290	30	60	0	5619
16176	140	175	31	5258	0	5604
16177	96	84	35	5304	0	5519
16178	81	5220	57	203	0	5561
16179	5294	170	32	116	0	5612
16180	5290	64	27	121	0	5502
16181	236	58	5076	89	0	5459
16182	131	52	5108	73	0	5364
16183	84	49	199	5175	0	5507
16184	5245	15	75	215	0	5550
16185	204	28	65	5203	0	5500
16186	105	26	58	5343	0	5532
16187	85	33	5156	267	0	5541
16188	83	38	5174	128	0	5423
16189	77	22	5235	108	0	5442
16190	5057	31	227	96	0	5411
16191	5207	39	114	81	0	5441
16192	234	4960	67	64	0	5325
16193	133	5088	51	58	0	5330
16194	110	177	37	5063	0	5387
16195	81	81	5034	197	0	5393
16196	4955	59	150	125	0	5289
16197	193	52	5075	92	0	5412
16198	99	39	171	4990	0	5299
16199	92	27	77	5133	0	5329
16200	82	27	64	5145	0	5318
16201	75	27	59	5216	0	5377
16202	5024	26	56	265	0	5371
16203	218	22	24	5027	0	5291
16204	86	28	4852	238	0	5204
16205	4693	22	139	125	0	4979
16206	191	27	4818	92	0	5128
16207	81	36	4734	66	0	4917
16208	68	4646	192	71	0	4977
16209	113	106	95	3958	0	4272
16210	3855	33	39	111	0	4038
16211	89	38	20	3866	0	4013
16212	41	21	3880	92	0	4034
16213	37	10	69	3940	0	4056
16214	3906	7	32	104	0	4049
16215	81	3923	28	55	0	4087
16216	3846	62	24	49	0	3981
16217	87	3772	27	32	0	3918
16218	3719	71	32	42	0	3864
16219	80	3572	10	33	0	3695
16220	45	3540	13	23	0	3621
16221	36	60	3352	13	0	3461
16222	28	3307	54	14	0	3403
16223	2877	46	26	11	0	2960
16224	33	18	11	2855	0	2917
16225	2858	7	9	31	0	2905
16226	34	2990	2	11	0	3037
16227	2969	30	7	21	0	3027
16228	39	11	2975	6	0	3031
16229	20	11	27	2935	0	2993
16230	10	3078	12	33	0	3133
16231	13	34	6	3184	0	3237
16232	9	13	4	3250	0	3276
16233	3660	11	3	58	0	3732
16234	66	3769	5	18	0	3858
16235	3837	67	4	25	0	3933
16236	89	19	3916	8	0	4032
16237	30	20	3742	4	0	3796
16238	22	3823	79	6	0	3930
16239	25	67	29	3857	0	3978
16240	8	24	3887	73	0	3992
16241	29	21	90	3706	0	3846
16242	20	13	23	3988	0	4044
16243	7	9	3837	106	0	3959
16244	9	5	3859	34	0	3907
16245	9	8	3998	37	0	4052
16246	12	4	4041	17	0	4074
16247	10	3882	118	240	0	4250
16248	16	85	48	4105	0	4254
16249	8	21	42	4252	0	4323
16250	6	21	4207	111	0	4345
16251	8	12	97	4174	0	4291
16252	11	9	4377	122	0	4519
16253	21	10	115	4309	0	4455
16254	12	7	46	4344	0	4409
16255	6	4320	35	124	0	4485
16256	10	91	25	4403	0	4529
16257	13	25	21	4443	0	4502
16258	15	25	18	4437	0	4495
16259	4	19	4290	144	0	4457
16260	6	4246	97	72	0	4421
16261	4286	100	23	54	0	4463
16262	4326	24	28	48	0	4426
16263	111	19	18	4295	0	4443
16264	55	15	13	4262	0	4345
16265	40	4352	16	113	0	4521
16266	4338	102	20	55	0	4515
16267	100	4402	11	41	0	4554
16268	4307	109	14	37	0	4467
16269	111	37	4228	19	0	4395
16270	4068	41	94	29	0	4232
16271	116	4217	30	22	0	4385
16272	44	95	31	4245	0	4415
16273	34	25	24	4292	0	4375
16274	18	4196	15	122	0	4351
16275	4258	94	18	61	0	4431
16276	109	32	12	4364	0	4517
16277	34	35	10	4508	0	4587
16278	4473	19	16	139	0	4647
16279	4603	18	13	64	0	4698
16280	135	19	4471	46	0	4671
16281	4570	20	102	32	0	4724
16282	143	9	32	4617	0	4801
16283	41	16	4622	125	0	4804
16284	51	13	112	4565	0	4741
16285	28	20	4556	136	0	4740
16286	20	19	4633	56	0	4728
16287	29	19	121	4643	0	4812
16288	15	13	4737	129	0	4894
16289	18	4747	133	50	0	4948
16290	27	99	46	4771	0	4943
16291	23	32	38	5021	0	5114
16292	18	31	4941	144	0	5134
16293	22	4957	117	61	0	5157
16294	4996	116	45	63	0	5220
16295	132	32	41	5074	0	5279
16296	5060	32	28	147	0	5267
16297	129	5091	30	48	0	5298
16298	45	128	5154	49	0	5376
16299	50	39	135	5120	0	5344
16300	5138	40	42	144	0	5364
16301	128	24	5129	59	0	5340
16302	4980	12	137	76	0	5205
16303	140	5048	52	40	0	5280
16304	45	5073	39	35	0	5192
16305	4956	117	44	49	0	5166
16306	140	48	27	4916	0	5131
16307	44	36	26	4959	0	5065
16308	36	4971	25	147	0	5179
16309	25	112	24	5074	0	5235
16310	34	37	15	5142	0	5228
16311	5015	22	16	166	0	5219
16312	116	14	31	4986	0	5147
16313	37	14	5004	146	0	5201
16314	37	25	111	4965	0	5138
16315	32	16	43	5123	0	5214
16316	23	24	5044	156	0	5247
16317	28	18	116	5073	0	5235
16318	5006	21	36	167	0	5230
16319	4990	12	37	69	0	5108
16320	5075	19	22	73	0	5189
16321	147	9	16	5075	0	5247
16322	62	15	5077	138	0	5292
16323	46	5084	102	62	0	5294
16324	46	109	31	5165	0	5351
16325	36	33	5120	134	0	5323
16326	42	27	107	4983	0	5159
16327	23	20	36	5180	0	5259
16328	4968	16	29	169	0	5182
16329	111	5086	29	60	0	5286
16330	45	94	4895	46	0	5080
16331	4652	24	97	63	0	4836
16332	121	4867	42	32	0	5062
16333	19	4508	18	26	0	4571
16334	4562	71	43	29	0	4705
16335	74	24	11	4635	0	4744
16336	22	15	5056	71	0	5164
16337	22	10	67	5027	0	5126
16338	8	5110	26	76	0	5220
16339	5200	67	11	43	0	5321
16340	78	24	7	5271	0	5380
16341	5305	8	12	93	0	5418
16342	84	12	7	5243	0	5346
16343	28	5348	11	78	0	5465
16344	5459	74	7	49	0	5589
16345	5471	21	7	39	0	5538
16346	95	5422	11	19	0	5547
16347	5348	74	14	24	0	5460
16348	77	20	6	5277	0	5380
16349	33	5249	9	66	0	5357
16350	5277	79	6	37	0	5399
16351	80	5350	12	18	0	5460
16352	5245	68	4	28	0	5345
16353	78	25	5	5259	0	5367
16354	5257	20	8	81	0	5366
16355	5291	8	4	41	0	5344
16356	5319	18	10	30	0	5377
16357	98	14	10	5242	0	5364
16358	47	13	2	5310	0	5372
16359	5258	16	4	93	0	5371
16360	89	8	5304	31	0	5432
16361	43	10	59	5310	0	5422
16362	29	5363	23	77	0	5492
16363	31	67	4	5449	0	5551
16364	24	25	7	5466	0	5522
16365	24	18	5344	90	0	5476
16366	40	13	62	5556	0	5671
16367	16	5844	25	100	0	5985
16368	31	94	7	6074	0	6206
16369	15	46	6890	126	0	7077
16370	37	19	148	7108	0	7312
16371	31	14	45	7535	0	7625
16372	7408	15	21	267	0	7711
16373	7509	11	23	116	0	7659
16374	257	11	11	7373	0	7652
16375	95	7140	18	204	0	7457
16376	59	7415	17	101	0	7592
16377	58	214	7246	57	0	7575
16378	48	124	164	7239	0	7575
16379	7239	47	66	213	0	7565
16380	200	46	28	7291	0	7565
16381	82	34	7319	212	0	7647
16382	51	29	172	7332	0	7584
16383	64	28	80	7407	0	7579
16384	48	22	44	7542	0	7656
16385	37	14	7250	291	0	7592
16386	41	7231	163	152	0	7587
16387	7181	160	72	122	0	7535
16388	7202	76	38	96	0	7412
16389	238	50	35	7074	0	7397
16390	101	49	7096	194	0	7440
16391	64	7014	177	100	0	7355
16392	80	172	75	6816	0	7143
16393	57	6962	46	172	0	7237
16394	36	7179	37	107	0	7359
16395	6986	234	28	61	0	7309
16396	183	114	6974	65	0	7336
16397	86	65	6933	57	0	7141
16398	68	64	210	6899	0	7241
16399	62	41	95	7197	0	7395
16400	58	43	7148	217	0	7466
16401	73	33	177	7010	0	7293
16402	51	29	7097	211	0	7388
16403	6749	25	186	146	0	7106
16404	173	24	112	7057	0	7366
16405	90	40	7328	209	0	7667
16406	70	30	187	7034	0	7321
16407	51	7464	90	209	0	7814
16408	7433	167	47	137	0	7784
16409	173	7441	56	74	0	7744
16410	7527	172	52	82	0	7833
16411	188	95	7357	67	0	7707
16412	7448	53	168	80	0	7749
16413	202	47	85	7509	0	7843
16414	106	34	7496	193	0	7829
16415	75	32	194	7491	0	7792
16416	68	34	7376	217	0	7695
16417	7002	25	192	148	0	7367
16418	181	7424	111	96	0	7812
16419	95	155	68	7199	0	7517
16420	56	7552	61	191	0	7860
16421	7549	201	50	117	0	7917
16422	7545	111	38	99	0	7793
16423	237	7504	51	72	0	7864
16424	134	190	33	7567	0	7924
16425	94	97	43	7652	0	7886
16426	89	58	38	7665	0	7850
16427	7447	50	38	297	0	7832
16428	171	7383	31	184	0	7769
16429	109	180	39	7433	0	7761
16430	69	105	52	7531	0	7757
16431	7326	56	44	290	0	7716
16432	197	64	7134	161	0	7556
16433	109	51	6976	144	0	7280
16434	6832	37	214	126	0	7209
16435	208	35	6922	76	0	7241
16436	118	35	6354	67	0	6574
16437	87	51	244	6208	0	6590
16438	6382	32	124	196	0	6734
16439	165	28	84	6410	0	6687
16440	94	23	6361	195	0	6673
16441	6166	29	164	123	0	6482
16442	177	36	6366	75	0	6654
16443	99	6418	183	72	0	6772
16444	76	151	117	6638	0	6982
16445	6696	68	67	181	0	7012
16446	157	40	68	6691	0	6956
16447	83	35	65	6819	0	7002
16448	6800	22	48	240	0	7110
16449	166	24	58	6856	0	7104
16450	97	18	51	6959	0	7125
16451	56	24	6793	247	0	7120
16452	68	20	138	6814	0	7040
16453	6818	19	88	234	0	7159
16454	6862	15	61	152	0	7090
16455	6913	16	56	99	0	7084
16456	224	34	45	6738	0	7041
16457	127	6670	22	166	0	6985
16458	6762	131	30	115	0	7038
16459	169	6780	34	81	0	7064
16460	6769	140	31	77	0	7017
16461	193	78	23	6735	0	7029
16462	6767	51	23	176	0	7017
16463	6682	36	33	114	0	6865
16464	6750	30	35	95	0	6910
16465	220	6498	40	63	0	6821
16466	113	6383	32	66	0	6594
16467	6072	117	24	45	0	6258
16468	130	6052	21	42	0	6245
16469	44	5210	9	11	0	5274
16470	28	4935	10	12	0	4985
16471	4774	25	32	25	0	4856
16472	21	20	4	4764	0	4809
16473	14	9	2	4776	0	4801
16474	4789	4	14	41	0	4848
16475	19	5	4881	14	0	4919
16476	24	2	12	5154	0	5192
16477	13	2	8	5185	0	5208
16478	21	4	9	5636	0	5670
16479	15	6	4	5931	0	5956
16480	4	5923	7	119	0	6053
16481	6	7449	4	46	0	7505
16482	7600	160	2	43	0	7805
16483	175	68	1	7681	0	7925
16484	79	39	2	7874	0	7994
16485	43	16	7704	221	0	7984
16486	40	11	151	7781	0	7983
16487	21	16	7872	219	0	8128
16488	42	13	192	7914	0	8161
16489	17	10	8276	228	0	8531
16490	4	8181	223	105	0	8513
16491	30	179	86	8329	0	8624
16492	8304	65	52	249	0	8670
16493	8406	42	27	119	0	8594
16494	281	33	17	8325	0	8656
16495	117	29	8258	234	0	8638
16496	70	24	8245	107	0	8446
16497	7871	15	264	112	0	8262
16498	218	8004	114	57	0	8393
16499	8125	206	68	70	0	8469
16500	8207	77	49	71	0	8404
16501	285	48	8008	52	0	8393
16502	156	25	231	7878	0	8290
16503	99	29	99	8035	0	8262
16504	75	24	64	8340	0	8503
16505	66	19	39	7951	0	8075
16506	82	17	42	7760	0	7901
16507	46	17	7453	357	0	7873
16508	32	14	7552	182	0	7780
16509	54	18	284	7536	0	7892
16510	60	9	136	7744	0	7949
16511	64	16	73	7886	0	8039
16512	7560	25	53	364	0	8002
16513	265	18	40	7642	0	7965
16514	7692	12	47	327	0	8078
16515	295	17	43	7885	0	8240
16516	7937	10	32	356	0	8335
16517	8113	16	36	180	0	8345
16518	7964	14	34	144	0	8156
16519	8021	10	30	128	0	8189
16520	7997	8	39	106	0	8150
16521	383	15	48	7702	0	8148
16522	7689	16	37	312	0	8054
16523	300	7517	39	165	0	8021
16524	7732	210	28	130	0	8100
16525	325	78	19	7795	0	8217
16526	159	40	7705	312	0	8216
16527	131	31	239	7866	0	8267
16528	91	19	7818	344	0	8272
16529	97	17	271	7862	0	8247
16530	95	27	113	8062	0	8297
16531	94	19	7769	377	0	8259
16532	89	23	7820	199	0	8131
16533	105	16	323	7857	0	8301
16534	7845	16	127	349	0	8337
16535	297	12	7776	177	0	8262
16536	146	7742	269	140	0	8297
16537	117	217	7950	116	0	8400
16538	7853	80	294	122	0	8349
16539	309	48	137	7871	0	8365
16540	7891	29	100	322	0	8342
16541	8091	26	67	175	0	8359
16542	368	27	68	7901	0	8364
16543	183	26	7631	331	0	8171
16544	146	16	264	7613	0	8039
16545	98	14	136	7743	0	7991
16546	7409	14	90	427	0	7940
16547	290	7440	78	228	0	8036
16548	137	220	78	7612	0	8047
16549	113	88	7438	338	0	7977
16550	7238	60	271	185	0	7754
16551	308	7307	138	126	0	7879
16552	166	240	91	7433	0	7930
16553	129	91	86	7566	0	7872
16554	102	59	70	7686	0	7917
16555	7346	43	59	442	0	7890
16556	7588	31	54	234	0	7907
16557	402	27	46	7513	0	7988
16558	187	29	7366	357	0	7939
16559	134	7313	265	196	0	7908
16560	7383	236	132	159	0	7910
16561	7630	88	66	146	0	7930
16562	384	53	60	7472	0	7969
16563	208	34	50	7718	0	8010
16564	122	39	7486	414	0	8061
16565	100	7502	269	210	0	8081
16566	7756	240	107	172	0	8275
16567	7742	100	76	146	0	8064
16568	367	7642	52	122	0	8183
16569	7623	258	51	100	0	8032
16570	363	106	47	7585	0	8101
16571	172	58	7452	336	0	8018
16572	147	50	268	7604	0	8069
16573	115	36	7462	370	0	7983
16574	7365	31	297	192	0	7885
16575	318	7322	130	128	0	7898
16576	138	254	76	7099	0	7567
16577	120	80	6995	294	0	7489
16578	78	55	6763	139	0	7035
16579	6225	66	262	131	0	6684
16580	225	6252	132	79	0	6688
16581	4802	127	115	48	0	5092
16582	4741	39	31	46	0	4857
16583	4675	25	34	39	0	4773
16584	157	33	33	4577	0	4800
16585	75	15	4610	112	0	4812
16586	46	4568	95	50	0	4759
16587	60	101	58	4541	0	4760
16588	39	26	4540	110	0	4715
16589	28	21	4138	31	0	4218
16590	32	26	81	4102	0	4241
16591	15	9	4048	82	0	4154
16592	3924	7	82	37	0	4050
16593	70	9	30	4090	0	4199
16594	31	14	23	4253	0	4321
16595	4237	1	18	87	0	4343
16596	71	4189	20	38	0	4318
16597	4391	63	11	47	0	4512
16598	76	21	19	4396	0	4512
16599	42	15	21	4430	0	4508
16600	33	15	10	4473	0	4531
16601	23	9	9	4384	0	4425
16602	4302	9	14	98	0	4423
16603	74	9	4257	36	0	4376
16604	37	4211	60	36	0	4344
16605	26	57	30	4323	0	4436
16606	4185	24	19	99	0	4327
16607	4350	22	16	46	0	4434
16608	85	4368	11	36	0	4500
16609	4298	57	16	36	0	4407
16610	76	4284	23	25	0	4408
16611	30	4514	17	28	0	4589
16612	29	75	12	4532	0	4648
16613	32	29	4563	74	0	4698
16614	25	32	60	4401	0	4518
16615	4350	12	30	95	0	4487
16616	68	4290	21	34	0	4413
16617	27	54	19	4343	0	4443
16618	34	24	4692	64	0	4814
16619	4722	16	52	59	0	4849
16620	4978	15	23	34	0	5050
16621	5002	11	14	34	0	5061
16622	89	19	4860	22	0	4990
16623	4754	8	58	30	0	4850
16624	72	4872	27	22	0	4993
16625	26	65	17	4750	0	4858
16626	18	4806	13	65	0	4902
16627	4844	57	20	34	0	4955
16628	4684	19	19	47	0	4769
16629	76	18	4854	8	0	4956
16630	40	4841	53	16	0	4950
16631	23	57	20	4898	0	4998
16632	21	19	17	4914	0	4971
16633	22	14	7	4848	0	4891
16634	26	8	12	4824	0	4870
16635	26	10	9	4981	0	5026
16636	19	12	4836	85	0	4952
16637	19	4801	62	41	0	4923
16638	4812	64	22	39	0	4937
16639	78	20	5014	24	0	5136
16640	31	5083	76	34	0	5224
16641	5122	72	22	24	0	5240
16642	98	28	5384	13	0	5523
16643	5216	18	89	30	0	5353
16644	5206	13	26	41	0	5286
16645	5318	14	22	22	0	5376
16646	111	5278	10	21	0	5420
16647	42	94	5245	14	0	5395
16648	21	5314	88	21	0	5444
16649	64	105	19	4579	0	4767
16650	26	5307	23	74	0	5430
16651	5329	99	15	34	0	5477
16652	5471	23	12	30	0	5536
16653	5376	26	10	18	0	5430
16654	130	18	5353	17	0	5518
16655	47	5486	94	17	0	5644
16656	34	99	39	5970	0	6142
16657	6538	36	22	118	0	6714
16658	151	6529	14	43	0	6737
16659	83	147	8	6608	0	6846
16660	50	60	6781	145	0	7036
16661	6887	37	156	75	0	7155
16662	188	25	7308	30	0	7551
16663	79	27	7467	21	0	7594
16664	7059	24	224	30	0	7337
16665	203	18	7299	15	0	7535
16666	6929	8	200	20	0	7157
16667	201	6969	88	12	0	7270
16668	7224	157	49	30	0	7460
16669	218	63	36	7128	0	7445
16670	119	44	26	7099	0	7288
16671	73	18	28	7284	0	7403
16672	7143	10	29	270	0	7452
16673	7096	10	25	131	0	7262
16674	7168	12	26	73	0	7279
16675	269	6885	29	29	0	7212
16676	145	166	19	7012	0	7342
16677	79	71	6903	174	0	7227
16678	59	36	167	6712	0	6974
16679	34	6699	78	212	0	7023
16680	63	160	40	6704	0	6967
16681	64	67	28	6869	0	7028
16682	6747	51	17	257	0	7072
16683	207	28	15	6796	0	7046
16684	97	34	6668	228	0	7027
16685	72	29	6538	108	0	6747
16686	58	13	222	6626	0	6919
16687	6569	24	115	225	0	6933
16688	206	24	48	6607	0	6885
16689	105	20	45	6788	0	6958
16690	75	17	6595	274	0	6961
16691	61	6502	169	147	0	6879
16692	51	158	88	6670	0	6967
16693	6492	63	73	223	0	6851
16694	186	6465	48	100	0	6799
16695	121	162	25	6539	0	6847
16696	85	74	6455	210	0	6824
16697	54	60	175	6406	0	6695
16698	6239	30	96	276	0	6641
16699	189	6205	73	119	0	6586
16700	98	184	6249	91	0	6622
16701	99	79	167	6250	0	6595
16702	52	68	6334	211	0	6665
16703	6221	45	204	141	0	6611
16704	6398	29	101	120	0	6648
16705	255	30	6320	80	0	6685
16706	147	34	182	6224	0	6587
16707	96	33	6328	209	0	6666
16708	59	6235	213	111	0	6618
16709	48	165	131	6340	0	6684
16710	53	78	6292	233	0	6656
16711	68	61	213	5989	0	6331
16712	60	6069	131	212	0	6472
16713	65	177	75	6142	0	6459
16714	48	93	6046	240	0	6427
16715	5806	54	202	157	0	6219
16716	204	6037	109	111	0	6461
16717	6201	186	90	77	0	6554
16718	239	98	5792	77	0	6206
16719	5715	62	208	89	0	6074
16720	254	53	5669	70	0	6046
16721	5672	53	228	91	0	6044
16722	5889	30	123	76	0	6118
16723	276	27	98	5744	0	6145
16724	156	46	61	5922	0	6185
16725	5790	40	38	284	0	6152
16726	219	5780	65	153	0	6217
16727	5953	179	54	123	0	6309
16728	247	96	56	5868	0	6267
16729	162	5821	61	202	0	6246
16730	119	171	51	6070	0	6411
16731	99	88	50	6199	0	6436
16732	69	61	65	6139	0	6334
16733	80	5916	51	338	0	6385
16734	5938	169	47	171	0	6325
16735	223	108	47	5957	0	6335
16736	130	60	5826	230	0	6246
16737	100	43	5776	148	0	6067
16738	68	57	5785	129	0	6039
16739	5623	39	250	109	0	6021
16740	5662	36	155	104	0	5957
16741	229	52	5521	80	0	5882
16742	145	31	167	5124	0	5467
16743	103	33	93	5292	0	5521
16744	69	31	5396	264	0	5760
16745	50	30	5377	159	0	5616
16746	44	26	220	5458	0	5748
16747	5382	28	144	194	0	5748
16748	5313	25	77	128	0	5543
16749	5392	20	60	104	0	5576
16750	251	5176	59	69	0	5555
16751	141	5310	44	81	0	5576
16752	85	176	58	5274	0	5593
16753	5257	95	61	166	0	5579
16754	165	49	5141	110	0	5465
16755	4850	33	131	101	0	5115
16756	152	4528	75	62	0	4817
16757	61	4009	37	33	0	4140
16758	3885	87	28	51	0	4051
16759	74	3866	34	27	0	4001
16760	40	3607	16	21	0	3684
16761	3416	117	55	71	0	3659
16762	39	3421	14	4	0	3478
16763	19	27	5	3302	0	3353
16764	21	12	4	3317	0	3354
16765	3292	7	4	37	0	3340
16766	3264	3	3	22	0	3292
16767	37	3313	4	8	0	3362
16768	20	3277	5	7	0	3309
16769	10	27	3259	5	0	3301
16770	3258	27	17	7	0	3309
16771	3370	11	11	4	0	3396
16772	3485	2	10	3	0	3500
16773	41	2	3	3545	0	3591
16774	16	6	1	3692	0	3715
16775	3828	5	1	44	0	3878
16776	35	4	3	3865	0	3907
16777	16	1	3912	40	0	3969
16778	7	5	25	3928	0	3965
16779	5	4059	15	33	0	4112
16780	14	29	5	4151	0	4199
16781	7	15	0	4349	0	4371
16782	9	8	2	4371	0	4390
16783	4336	3	5	70	0	4414
16784	40	4312	5	27	0	4384
16785	27	38	1	4410	0	4476
16786	11	21	4440	48	0	4520
16787	8	13	4242	22	0	4285
16788	11	3	59	4389	0	4462
16789	13	2	26	4449	0	4490
16790	4383	2	8	76	0	4469
16791	50	6	7	4320	0	4383
16792	22	4358	4	51	0	4435
16793	14	43	4532	26	0	4615
16794	20	21	48	4556	0	4645
16795	7	10	4653	55	0	4725
16796	11	3	47	4635	0	4696
16797	4659	4	21	56	0	4740
16798	4685	10	5	36	0	4736
16799	63	4617	9	16	0	4705
16800	27	43	12	4694	0	4776
16801	4827	20	10	61	0	4918
16802	4814	5	6	44	0	4869
16803	4880	7	7	32	0	4926
16804	4904	2	7	19	0	4932
16805	4851	2	5	21	0	4879
16806	75	4775	11	5	0	4866
16807	4814	44	16	9	0	4883
16808	58	20	4762	16	0	4856
16809	33	6	48	4821	0	4908
16810	4865	3	19	56	0	4943
16811	4855	5	11	29	0	4900
16812	4864	1	7	21	0	4893
16813	77	8	4903	13	0	5001
16814	33	9	50	4977	0	5069
16815	5106	3	21	56	0	5186
16816	59	5027	9	29	0	5124
16817	5223	52	6	26	0	5307
16818	5131	21	2	22	0	5176
16819	5207	8	3	22	0	5240
16820	80	13	6	5237	0	5336
16821	5301	5	5	68	0	5379
16822	67	11	5292	38	0	5408
16823	37	12	5254	23	0	5326
16824	5313	8	69	22	0	5412
16825	72	11	5415	11	0	5509
16826	5148	11	61	26	0	5246
16827	60	4	5312	17	0	5393
16828	40	10	49	5191	0	5290
16829	5181	7	26	66	0	5280
16830	63	5157	17	30	0	5267
16831	5317	47	12	25	0	5401
16832	66	5183	9	23	0	5281
16833	34	5384	11	17	0	5446
16834	25	60	9	5533	0	5627
16835	23	26	14	5527	0	5590
16836	18	9	16	5489	0	5532
16837	19	11	5418	72	0	5520
16838	5332	6	56	32	0	5426
16839	5684	5	24	34	0	5747
16840	5708	9	9	23	0	5749
16841	5713	11	14	13	0	5751
16842	5686	7	7	23	0	5723
16843	90	15	5372	19	0	5496
16844	41	9	5401	16	0	5467
16845	34	5	66	5474	0	5579
16846	30	14	5520	60	0	5624
16847	5562	13	53	38	0	5666
16848	92	5880	27	15	0	6014
16849	53	68	10	6224	0	6355
16850	6426	22	12	105	0	6565
16851	133	3	17	6607	0	6760
16852	61	8	6680	111	0	6860
16853	45	9	6684	48	0	6786
16854	50	2	139	6896	0	7087
16855	27	12	6969	111	0	7119
16856	6717	5	119	55	0	6896
16857	125	13	56	6928	0	7122
16858	64	7	6931	126	0	7128
16859	48	6905	115	51	0	7119
16860	36	101	46	7122	0	7305
16861	38	38	7104	116	0	7296
16862	35	19	119	6884	0	7057
16863	39	12	44	7095	0	7190
16864	33	9	7129	160	0	7331
16865	34	5	126	7139	0	7304
16866	55	6	64	6936	0	7061
16867	31	11	40	7198	0	7280
16868	7033	14	21	180	0	7248
16869	135	6893	22	79	0	7129
16870	71	7154	22	39	0	7286
16871	34	148	7030	41	0	7253
16872	6748	60	114	44	0	6966
16873	132	33	6925	18	0	7108
16874	62	20	6796	34	0	6912
16875	38	12	156	6606	0	6812
16876	6632	4	67	149	0	6852
16877	127	6652	33	65	0	6877
16878	6669	114	31	47	0	6861
16879	6599	53	14	50	0	6716
16880	157	6699	23	24	0	6903
16881	6654	96	16	34	0	6800
16882	6629	41	19	21	0	6710
16883	133	6645	18	9	0	6805
16884	69	106	6	6683	0	6864
16885	44	38	15	6796	0	6893
16886	6809	27	10	141	0	6987
16887	106	6909	11	71	0	7097
16888	7110	109	12	42	0	7273
16889	7198	54	15	35	0	7302
16890	7634	18	13	36	0	7701
16891	197	14	7	7510	0	7728
16892	89	16	7	7658	0	7770
16893	7453	10	6	187	0	7656
16894	7574	16	10	86	0	7686
16895	7652	7	6	51	0	7716
16896	207	15	14	7803	0	8039
16897	90	14	7844	153	0	8101
16898	56	6	149	8002	0	8213
16899	50	8	66	8729	0	8853
16900	27	15	8459	253	0	8754
16901	28	15	9413	107	0	9563
16902	51	7	269	9606	0	9933
16903	46	12	9723	240	0	10021
16904	9783	15	237	150	0	10185
16905	250	15	135	9886	0	10286
16906	153	8	59	10147	0	10367
16907	10126	8	32	358	0	10524
16908	264	13	51	10136	0	10464
16909	176	1	41	10239	0	10457
16910	70	12	50	10366	0	10498
16911	95	6	23	10379	0	10503
16912	59	14	9946	402	0	10421
16913	60	7	218	10096	0	10381
16914	57	11	9786	322	0	10176
16915	41	9750	245	216	0	10252
16916	62	214	130	9850	0	10256
16917	45	107	9607	317	0	10076
16918	9227	34	238	217	0	9716
16919	241	9549	152	105	0	10047
16920	9774	217	50	143	0	10184
16921	288	114	75	9488	0	9965
16922	153	9522	42	255	0	9972
16923	9545	241	38	197	0	10021
16924	264	9671	56	88	0	10079
16925	9737	244	44	86	0	10111
16926	280	157	42	9584	0	10063
16927	9698	58	37	289	0	10082
16928	284	9714	41	170	0	10209
16929	9800	269	24	109	0	10202
16930	314	136	9529	84	0	10063
16931	196	71	244	9629	0	10140
16932	9630	45	137	297	0	10109
16933	9809	36	50	203	0	10098
16934	427	30	41	9637	0	10135
16935	188	62	9602	308	0	10160
16936	126	7685	251	1722	0	9784
16937	92	9672	152	142	0	10058
16938	9713	298	74	153	0	10238
16939	308	141	54	9640	0	10143
16940	201	58	46	9871	0	10176
16941	9683	46	39	424	0	10192
16942	9787	44	73	221	0	10125
16943	393	51	9625	129	0	10198
16944	203	60	233	9783	0	10279
16945	140	35	9726	322	0	10223
16946	132	9621	249	225	0	10227
16947	9347	221	150	173	0	9891
16948	276	9299	73	133	0	9781
16949	192	9352	68	93	0	9705
16950	125	293	86	9072	0	9576
16951	8802	139	58	297	0	9296
16952	228	8788	69	193	0	9278
16953	8731	244	53	137	0	9165
16954	243	8729	57	99	0	9128
16955	186	232	43	8797	0	9258
16956	8733	163	62	268	0	9226
16957	249	87	8745	193	0	9274
16958	209	96	206	8737	0	9248
16959	119	88	8639	249	0	9095
16960	129	8237	214	181	0	8761
16961	99	8669	129	112	0	9009
16962	8373	283	65	156	0	8877
16963	235	8716	50	122	0	9123
16964	8722	237	80	114	0	9153
16965	8857	145	52	144	0	9198
16966	322	97	8631	98	0	9148
16967	8726	90	196	97	0	9109
16968	269	113	8833	88	0	9303
16969	215	8776	224	85	0	9300
16970	8831	223	147	104	0	9305
16971	288	8757	77	83	0	9205
16972	224	213	70	8860	0	9367
16973	8918	139	77	257	0	9391
16974	311	76	54	8911	0	9352
16975	197	80	9022	266	0	9565
16976	123	101	207	9033	0	9464
16977	134	79	134	9199	0	9546
16978	9028	98	56	330	0	9512
16979	264	78	8834	215	0	9391
16980	8860	66	207	129	0	9262
16981	9176	62	129	154	0	9521
16982	361	61	96	9120	0	9638
16983	228	81	66	9198	0	9573
16984	9051	68	53	366	0	9538
16985	319	9040	57	193	0	9609
16986	242	228	73	9020	0	9563
16987	152	130	8715	255	0	9252
16988	164	92	8312	150	0	8718
16989	114	8697	256	124	0	9191
16990	107	232	117	8347	0	8803
16991	116	136	66	8478	0	8796
16992	8278	96	57	302	0	8733
16993	254	87	53	8273	0	8667
16994	8108	66	69	252	0	8495
16995	240	7889	69	155	0	8353
16996	135	7844	44	101	0	8124
16997	108	8061	32	114	0	8315
16998	7879	197	66	118	0	8260
16999	7254	99	39	92	0	7484
17000	217	7099	32	80	0	7428
17001	5973	73	30	27	0	6103
17002	86	5898	2	14	0	6000
17003	40	78	8	5785	0	5911
17004	20	5745	10	75	0	5850
17005	5765	84	5	34	0	5888
17006	5791	29	9	20	0	5849
17007	90	19	7	5635	0	5751
17008	5678	18	3	81	0	5780
17009	87	18	8	5687	0	5800
17010	38	5800	9	64	0	5911
17011	33	65	6	5863	0	5967
17012	28	5800	8	67	0	5903
17013	5814	62	7	48	0	5931
17014	76	33	5627	19	0	5755
17015	5553	17	49	31	0	5650
17016	70	19	14	5727	0	5830
17017	33	15	5625	63	0	5736
17018	5469	16	54	44	0	5583
17019	70	12	5811	17	0	5910
17020	37	15	51	5573	0	5676
17021	30	8	23	5690	0	5751
17022	16	14	13	5575	0	5618
17023	28	6	14	5577	0	5625
17024	20	5375	12	82	0	5489
17025	18	58	14	5725	0	5815
17026	5661	26	10	85	0	5782
17027	73	13	5587	41	0	5714
17028	28	5716	61	27	0	5832
17029	5872	67	17	45	0	6001
17030	6222	29	7	31	0	6289
17031	122	17	8	6961	0	7108
17032	36	20	6928	125	0	7109
17033	38	13	112	6901	0	7064
17034	45	11	56	7694	0	7806
17035	30	10	7671	209	0	7920
17036	19	8325	164	100	0	8608
17037	8572	193	83	50	0	8898
17038	8743	100	23	58	0	8924
17039	8953	49	23	51	0	9076
17040	356	36	20	8669	0	9081
17041	207	15	20	9039	0	9281
17042	9133	11	14	355	0	9513
17043	287	15	20	8791	0	9113
17044	149	8849	26	285	0	9309
17045	9201	216	14	172	0	9603
17046	9223	118	28	148	0	9517
17047	9926	52	18	101	0	10097
17048	10067	40	19	81	0	10207
17049	478	27	9314	58	0	9877
17050	256	45	9428	53	0	9782
17051	189	22	350	9298	0	9859
17052	153	26	155	9587	0	9921
17053	110	25	9321	398	0	9854
17054	99	30	9378	212	0	9719
17055	103	21	363	9348	0	9835
17056	9325	23	179	329	0	9856
17057	335	14	112	9236	0	9697
17058	191	33	9223	338	0	9785
17059	140	9197	283	202	0	9822
17060	9294	250	152	121	0	9817
17061	9427	116	105	114	0	9762
17062	9558	62	88	75	0	9783
17063	9434	35	84	102	0	9655
17064	489	27	8747	72	0	9335
17065	276	26	289	8838	0	9429
17066	8895	23	164	343	0	9425
17067	368	26	120	8888	0	9402
17068	244	19	104	8715	0	9082
17069	155	8563	60	434	0	9212
17070	164	248	58	8831	0	9301
17071	8594	128	53	410	0	9185
17072	348	8605	80	211	0	9244
17073	8633	292	50	163	0	9138
17074	407	8597	44	97	0	9145
17075	282	323	40	8042	0	8687
17076	179	8074	62	318	0	8633
17077	155	8536	41	202	0	8934
17078	8352	378	61	164	0	8955
17079	348	193	8170	139	0	8850
17080	216	125	8083	115	0	8539
17081	170	92	8062	111	0	8435
17082	7672	68	388	149	0	8277
17083	330	7731	217	117	0	8395
17084	197	8108	118	102	0	8525
17085	7687	366	73	114	0	8240
17086	348	7632	69	79	0	8128
17087	232	7962	65	86	0	8345
17088	182	419	58	7840	0	8499
17089	143	223	7745	312	0	8423
17090	136	159	7882	200	0	8377
17091	148	124	379	7853	0	8504
17092	7712	99	206	368	0	8385
17093	337	7775	177	207	0	8496
17094	260	321	126	7878	0	8585
17095	192	196	7737	338	0	8463
17096	180	158	7588	210	0	8136
17097	187	142	379	7525	0	8233
17098	7501	119	215	364	0	8199
17099	7741	115	149	218	0	8223
17100	492	94	7408	180	0	8174
17101	7554	102	338	167	0	8161
17102	454	81	7522	144	0	8201
17103	297	72	377	7240	0	7986
17104	222	7343	258	327	0	8150
17105	7574	296	178	220	0	8268
17106	409	172	139	7563	0	8283
17107	310	141	119	7637	0	8207
17108	247	82	127	7865	0	8321
17109	195	62	144	7842	0	8243
17110	166	65	7277	523	0	8031
17111	178	7102	356	319	0	7955
17112	180	283	223	7394	0	8080
17113	7299	165	157	398	0	8019
17114	398	114	161	7383	0	8056
17115	283	72	143	7532	0	8030
17116	189	90	7149	514	0	7942
17117	189	83	7066	344	0	7682
17118	164	6840	400	255	0	7659
17119	163	7145	235	218	0	7761
17120	154	370	169	7172	0	7865
17121	7125	226	137	412	0	7900
17122	341	159	7085	327	0	7912
17123	287	7119	299	219	0	7924
17124	210	317	208	6963	0	7698
17125	157	7083	140	362	0	7742
17126	165	359	105	6889	0	7518
17127	132	6981	92	382	0	7587
17128	156	332	83	6860	0	7431
17129	6477	232	77	380	0	7166
17130	286	6196	96	267	0	6845
17131	152	312	72	5348	0	5884
17132	5246	157	58	276	0	5737
17133	248	5192	44	153	0	5637
17134	91	4330	41	121	0	4583
17135	113	4343	47	80	0	4583
17136	131	172	71	3429	0	3803
17137	32	64	55	3380	0	3531
17138	28	3264	23	106	0	3421
17139	28	119	22	3261	0	3430
17140	40	51	3244	97	0	3432
17141	18	3201	69	38	0	3326
17142	20	234	18	2786	0	3058
17143	26	2962	21	65	0	3074
17144	12	70	2845	32	0	2959
17145	15	2763	41	34	0	2853
17146	2260	58	20	27	0	2365
17147	20	22	1	2193	0	2236
17148	2178	1	4	25	0	2208
17149	15	3	2247	7	0	2272
17150	11	0	12	2300	0	2323
17151	1	1	2400	16	0	2418
17152	4	4	15	2395	0	2418
17153	2510	1	6	23	0	2540
17154	17	4	1	2513	0	2535
17155	2541	2	1	28	0	2572
17156	15	2623	0	9	0	2647
17157	2627	17	1	7	0	2652
17158	15	6	2676	2	0	2699
17159	6	2836	20	2	0	2864
17160	2	18	6	2935	0	2961
17161	2	9	2	2974	0	2987
17162	6	4	2927	21	0	2958
17163	0	2934	16	8	0	2958
17164	5	17	5	3000	0	3027
17165	3	2980	2	22	0	3007
17166	7	23	0	2999	0	3029
17167	1	2979	3	18	0	3001
17168	2942	18	1	14	0	2975
17169	20	6	3	3019	0	3048
17170	9	5	3028	16	0	3058
17171	1	3017	13	11	0	3042
17172	5	3163	6	4	0	3178
17173	3	20	3158	4	0	3185
17174	1	3176	18	2	0	3197
17175	10	13	8	3255	0	3286
17176	1	7	3330	13	0	3351
17177	7	1	11	3300	0	3319
17178	3	1	5	3373	0	3382
17179	4	4	3414	19	0	3441
17180	3297	0	16	17	0	3330
17181	17	0	8	3549	0	3574
17182	9	2	3845	13	0	3869
17183	1	3863	14	10	0	3888
17184	3938	16	5	10	0	3969
17185	14	3874	1	3	0	3892
17186	9	16	1	3975	0	4001
17187	3935	6	1	28	0	3970
17188	15	1	2	3923	0	3941
17189	11	2	4004	17	0	4034
17190	4	3	18	3977	0	4002
17191	2	1	3993	17	0	4013
17192	3877	2	18	25	0	3922
17193	17	2	4044	3	0	4066
17194	4120	1	19	8	0	4148
17195	4214	2	9	18	0	4243
17196	24	5	4336	2	0	4367
17197	15	5	4120	5	0	4145
17198	2	4409	26	4	0	4441
17199	4631	16	7	18	0	4672
17200	24	9	1	4790	0	4824
17201	19	0	3	4725	0	4747
17202	5100	3	2	67	0	5172
17203	5244	0	3	32	0	5279
17204	5297	5	2	10	0	5314
17205	5341	1	4	12	0	5358
17206	30	1	3	5322	0	5356
17207	5384	2	3	31	0	5420
17208	22	2	4	5447	0	5475
17209	10	2	5	5408	0	5425
17210	4	4	2	5470	0	5480
17211	3	5	5338	27	0	5373
17212	4	5234	25	12	0	5275
17213	6	5330	8	4	0	5348
17214	6	24	1	5473	0	5504
17215	5474	6	2	30	0	5512
17216	28	1	2	5441	0	5472
17217	5433	2	4	36	0	5475
17218	24	6	5746	8	0	5784
17219	5632	1	21	15	0	5669
17220	22	2	3	5918	0	5945
17221	6076	1	3	44	0	6124
17222	5989	5	2	33	0	6029
17223	6101	1	1	19	0	6122
17224	33	3	2	6128	0	6166
17225	7	6	6198	27	0	6238
17226	15	3	22	6199	0	6239
17227	6357	1	8	43	0	6409
17228	31	8	6825	8	0	6872
17229	25	2	29	7167	0	7223
17230	7401	1	13	60	0	7475
17231	51	7	7473	8	0	7539
17232	7818	3	43	35	0	7899
17233	8189	0	9	34	0	8232
17234	61	4	6	8350	0	8421
17235	31	2	2	8439	0	8474
17236	8457	5	3	83	0	8548
17237	70	1	3	8705	0	8779
17238	8683	1	2	99	0	8785
17239	75	8708	8	20	0	8811
17240	17	8846	3	25	0	8891
17241	23	86	5	8916	0	9030
17242	13	26	9012	78	0	9129
17243	8	9000	75	22	0	9105
17244	8956	69	12	48	0	9085
17245	65	8890	20	17	0	8992
17246	21	81	8913	8	0	9023
17247	32	21	67	8835	0	8955
17248	11	22	9178	73	0	9284
17249	13	9307	80	26	0	9426
17250	22	81	17	9443	0	9563
17251	8	9246	26	74	0	9354
17252	16	87	9284	18	0	9405
17253	25	24	70	9176	0	9295
17254	6	26	9470	72	0	9574
17255	23	14	82	9390	0	9509
17256	9473	12	27	110	0	9622
17257	73	19	9308	25	0	9425
17258	8898	8	72	58	0	9036
17259	87	14	9280	13	0	9394
17260	39	9	83	9289	0	9420
17261	28	10	9749	84	0	9871
17262	36	9	87	9740	0	9872
17263	27	11	24	9877	0	9939
17264	40	4	24	9718	0	9786
17265	25	9	17	9870	0	9921
17266	10	7	10459	101	0	10577
17267	10187	7	72	95	0	10361
17268	88	13	28	11248	0	11377
17269	11216	8	25	117	0	11366
17270	11317	4	18	59	0	11398
17271	11496	7	16	56	0	11575
17272	120	7	16	11694	0	11837
17273	54	5	16	11947	0	12022
17274	34	13035	16	122	0	13207
17275	14438	155	18	86	0	14697
17276	15405	57	8	64	0	15534
17277	15698	55	12	70	0	15835
17278	380	34	15637	32	0	16083
17279	239	26	236	15674	0	16175
17280	159	19	15638	255	0	16071
17281	15504	12	290	128	0	15934
17282	15934	12	131	125	0	16202
17283	367	17	100	15724	0	16208
17284	197	17	65	15581	0	15860
17285	151	15957	49	317	0	16474
17286	16309	233	31	199	0	16772
17287	16485	90	30	149	0	16754
17288	357	16151	36	117	0	16661
17289	16630	267	28	121	0	17046
17290	395	123	26	16609	0	17153
17291	222	88	24	16854	0	17188
17292	16795	55	22	374	0	17246
17293	336	49	16569	186	0	17140
17294	16520	35	236	187	0	16978
17295	16938	26	82	151	0	17197
17296	396	16562	79	86	0	17123
17297	16921	257	53	91	0	17322
17298	402	112	16491	43	0	17048
17299	239	83	248	16631	0	17201
17300	16795	54	95	307	0	17251
17301	376	49	77	16806	0	17308
17302	194	34	16583	333	0	17144
17303	170	18	278	16158	0	16624
17304	119	17399	124	346	0	17988
17305	146	254	96	17968	0	18464
17306	113	95	75	18228	0	18511
17307	146	78	49	17752	0	18025
17308	98	57	42	18211	0	18408
17309	65	62	17777	488	0	18392
17310	116	33	241	17943	0	18333
17311	17886	31	109	496	0	18522
17312	287	17633	106	234	0	18260
17313	164	258	54	18456	0	18932
17314	140	119	18427	366	0	19052
17315	137	84	269	18564	0	19054
17316	18762	60	113	450	0	19385
17317	18822	58	106	264	0	19250
17318	18457	36	95	218	0	18806
17319	536	31	72	18384	0	19023
17320	333	35	18284	363	0	19015
17321	263	18051	295	183	0	18792
17322	18446	277	146	222	0	19091
17323	405	108	140	18357	0	19010
17324	235	99	109	18527	0	18970
17325	225	86	18113	434	0	18858
17326	203	17532	301	286	0	18322
17327	182	18305	132	232	0	18851
17328	156	405	116	17764	0	18441
17329	140	197	17357	387	0	18081
17330	16413	154	298	244	0	17109
17331	367	141	16724	189	0	17421
17332	16256	88	292	221	0	16857
17333	403	17321	158	172	0	18054
17334	234	257	17076	147	0	17714
17335	16796	127	288	163	0	17374
17336	379	16987	165	117	0	17648
17337	17639	282	124	166	0	18211
17338	417	161	17594	79	0	18251
17339	274	17659	286	85	0	18304
17340	18000	286	141	125	0	18552
17341	394	149	17656	95	0	18294
17342	17677	114	314	141	0	18246
17343	418	82	159	17865	0	18524
17344	18051	64	141	346	0	18602
17345	435	66	114	17984	0	18599
17346	17934	71	91	410	0	18506
17347	410	62	17821	248	0	18541
17348	230	60	277	18135	0	18702
17349	191	62	133	18145	0	18531
17350	166	64	17826	455	0	18511
17351	155	58	308	17817	0	18338
17352	182	13998	281	473	0	14934
17353	118	246	130	18596	0	19090
17354	136	117	122	19093	0	19468
17355	153	105	95	20618	0	20971
17356	120	108	20454	652	0	21334
17357	20136	72	430	424	0	21062
17358	539	52	185	22465	0	23241
17359	280	57	22877	646	0	23860
17360	22542	38	585	369	0	23534
17361	23558	53	252	282	0	24145
17362	24285	54	158	222	0	24719
17363	967	49	149	23858	0	25023
17364	532	74	110	26653	0	27369
17365	367	77	88	26337	0	26869
17366	232	25983	117	1085	0	27417
17367	26029	699	88	660	0	27476
17368	26106	289	90	459	0	26944
17369	1094	218	95	25884	0	27291
17370	574	132	25446	887	0	27039
17371	411	120	25565	451	0	26547
17372	261	24182	1027	371	0	25841
17373	215	25595	489	297	0	26596
17374	23273	961	364	339	0	24937
17375	691	22654	113	157	0	23615
17376	22311	643	119	167	0	23240
17377	22260	265	78	199	0	22802
17378	22206	152	89	202	0	22649
17379	961	106	77	21489	0	22633
17380	505	130	68	22647	0	23350
17381	22895	97	58	877	0	23927
17382	873	81	58	23185	0	24197
17383	422	83	22779	848	0	24132
17384	23008	81	658	420	0	24167
17385	849	92	299	22843	0	24083
17386	466	116	154	23414	0	24150
17387	379	141	75	23773	0	24368
17388	286	100	22597	1064	0	24047
17389	21375	105	676	585	0	22741
17390	858	88	22494	319	0	23759
17391	506	79	774	22377	0	23736
17392	340	94	22706	814	0	23954
17393	313	76	795	22309	0	23493
17394	252	85	327	23068	0	23732
17395	258	91	22583	1060	0	23992
17396	312	89	762	21237	0	22400
17397	238	22414	404	873	0	23929
17398	22590	661	240	496	0	23987
17399	23108	277	177	453	0	24015
17400	1076	143	159	22672	0	24050
17401	539	87	22457	964	0	24047
17402	336	21103	816	538	0	22793
17403	299	22510	375	386	0	23570
17404	21191	864	302	350	0	22707
17405	866	379	20779	340	0	22364
17406	20902	208	801	363	0	22274
17407	993	113	406	20985	0	22497
17408	509	112	269	21687	0	22577
17409	20589	105	266	1185	0	22145
17410	882	20539	231	650	0	22302
17411	482	742	20692	438	0	22354
17412	427	336	800	20569	0	22132
17413	344	199	20640	951	0	22134
17414	268	20115	914	598	0	21895
17415	282	716	459	20568	0	22025
17416	20123	385	322	1013	0	21843
17417	20708	284	258	583	0	21833
17418	1174	182	19962	412	0	21730
17419	602	19873	867	369	0	21711
17420	19910	744	452	386	0	21492
17421	931	19994	317	378	0	21620
17422	562	867	245	19920	0	21594
17423	19908	435	204	969	0	21516
17424	1006	316	219	20104	0	21645
17425	577	223	19571	1030	0	21401
17426	448	216	818	19990	0	21472
17427	366	220	19712	1079	0	21377
17428	388	257	891	19759	0	21295
17429	19401	199	436	1183	0	21219
17430	997	19285	343	630	0	21255
17431	19496	780	269	520	0	21065
17432	1053	383	323	19195	0	20954
17433	551	337	250	19439	0	20577
17434	451	275	16808	1263	0	18797
17435	394	277	18765	700	0	20136
17436	359	18527	992	554	0	20432
17437	419	821	18455	415	0	20110
17438	17494	378	973	458	0	19303
17439	934	17804	548	410	0	19696
17440	564	18326	394	441	0	19725
17441	404	18583	347	413	0	19747
17442	380	1141	262	18065	0	19848
17443	391	577	17998	999	0	19965
17444	359	18077	895	597	0	19928
17445	383	909	456	17036	0	18784
17446	383	18117	372	942	0	19814
17447	17607	939	283	675	0	19504
17448	18180	468	306	521	0	19475
17449	1156	321	330	17754	0	19561
17450	616	326	292	18150	0	19384
17451	17153	257	315	1246	0	18971
17452	940	16603	278	734	0	18555
17453	507	17335	273	523	0	18638
17454	500	1082	244	15972	0	17798
17455	245	465	14401	810	0	15921
17456	227	14052	660	532	0	15471
17457	12599	621	394	385	0	13999
17458	564	11927	277	299	0	13067
17459	280	11663	160	269	0	12372
17460	10679	637	245	213	0	11774
17461	524	10937	137	192	0	11790
17462	314	549	10303	172	0	11338
17463	189	10248	442	212	0	11091
17464	7544	304	180	103	0	8131
17465	244	7404	74	73	0	7795
17466	7152	254	119	79	0	7604
17467	263	153	44	7055	0	7515
17468	122	116	45	7297	0	7580
17469	91	98	7105	257	0	7551
17470	72	7154	203	136	0	7565
17471	96	219	68	7211	0	7594
17472	7140	116	68	238	0	7562
17473	7121	99	50	121	0	7391
17474	251	7139	50	94	0	7534
17475	134	219	40	7202	0	7595
17476	7144	104	54	240	0	7542
17477	7304	98	43	120	0	7565
17478	284	78	6961	87	0	7410
17479	136	87	6643	69	0	6935
17480	112	74	6530	66	0	6782
17481	64	6016	168	36	0	6284
17482	5423	122	125	46	0	5716
17483	103	5343	46	33	0	5525
17484	5203	125	41	35	0	5404
17485	114	5659	21	20	0	5814
17486	64	108	17	5846	0	6035
17487	5931	46	21	114	0	6112
17488	118	49	5893	37	0	6097
17489	5837	34	101	38	0	6010
17490	6035	27	34	40	0	6136
17491	148	5927	31	36	0	6142
17492	51	6121	31	19	0	6222
17493	6239	101	38	35	0	6413
17494	116	57	6492	12	0	6677
17495	6193	55	106	43	0	6397
17496	6366	44	27	22	0	6459
17497	130	16	24	6230	0	6400
17498	6381	33	16	88	0	6518
17499	124	26	11	6485	0	6646
17500	76	24	9	6693	0	6802
17501	40	19	18	6638	0	6715
17502	49	6576	21	105	0	6751
17503	6648	97	19	46	0	6810
17504	6756	43	7	46	0	6852
17505	123	32	19	6703	0	6877
17506	68	42	10	6654	0	6774
17507	49	6608	17	99	0	6773
17508	6677	91	9	60	0	6837
17509	115	45	6547	33	0	6740
17510	63	28	79	6647	0	6817
17511	58	27	6572	98	0	6755
17512	42	14	89	6587	0	6732
17513	30	23	6650	115	0	6818
17514	46	18	93	6545	0	6702
17515	6651	28	40	126	0	6845
17516	103	26	6914	64	0	7107
17517	6850	20	97	56	0	7023
17518	115	7404	38	39	0	7596
17519	65	93	25	7635	0	7818
17520	50	42	28	7756	0	7876
17521	7978	32	15	151	0	8176
17522	110	39	26	8193	0	8368
17523	62	24	8126	120	0	8332
17524	8039	24	101	73	0	8237
17525	8517	27	36	71	0	8651
17526	8516	17	35	57	0	8625
17527	8498	15	23	64	0	8600
17528	153	8381	24	28	0	8586
17529	75	86	20	8604	0	8785
17530	8616	25	20	125	0	8786
17531	115	31	23	8507	0	8676
17532	8430	25	17	113	0	8585
17533	112	26	8239	55	0	8432
17534	60	13	8170	39	0	8282
17535	70	139	82	7752	0	8043
17536	39	8093	41	79	0	8252
17537	30	8338	27	49	0	8444
17538	8231	60	29	67	0	8387
17539	77	24	8351	16	0	8468
17540	7737	14	51	50	0	7852
17541	68	8339	22	17	0	8446
17542	8455	47	14	38	0	8554
17543	79	14	9	8346	0	8448
17544	33	15	8608	74	0	8730
17545	48	9	49	8527	0	8633
17546	43	9	19	8532	0	8603
17547	30	8414	20	82	0	8546
17548	18	8703	16	36	0	8773
17549	28	66	8	8749	0	8851
17550	24	8747	12	56	0	8839
17551	29	62	8668	29	0	8788
17552	32	31	8273	24	0	8360
17553	7992	15	69	46	0	8122
17554	8606	18	26	24	0	8674
17555	78	8517	18	14	0	8627
17556	43	54	15	8602	0	8714
17557	37	21	16	8657	0	8731
17558	26	15	8708	81	0	8830
17559	44	10	59	8262	0	8375
17560	18	8525	28	84	0	8655
17561	19	67	8386	36	0	8508
17562	27	28	8311	20	0	8386
17563	26	7952	80	25	0	8083
17564	24	71	8434	20	0	8549
17565	31	22	74	8317	0	8444
17566	68	24	45	7518	0	7655
17567	29	18	8624	79	0	8750
17568	41	18	58	8406	0	8523
17569	22	8340	30	80	0	8472
17570	8	8755	23	44	0	8830
17571	30	70	16	8771	0	8887
17572	22	21	8976	74	0	9093
17573	24	9173	74	29	0	9300
17574	39	99	40	9230	0	9408
17575	19	25	9085	63	0	9192
17576	8609	20	62	65	0	8756
17577	9101	15	32	45	0	9193
17578	9118	20	18	37	0	9193
17579	80	10	14	9045	0	9149
17580	35	8	28	9155	0	9226
17581	36	13	9369	75	0	9493
17582	43	13	58	9246	0	9360
17583	45	19	21	9323	0	9408
17584	15	25	9372	94	0	9506
17585	8056	13	63	87	0	8219
17586	61	8688	45	28	0	8822
17587	8714	57	21	64	0	8856
17588	57	8698	21	35	0	8811
17589	42	47	28	8778	0	8895
17590	41	21	8772	56	0	8890
17591	60	32	50	8393	0	8535
17592	37	14	8554	72	0	8677
17593	7394	22	62	82	0	7560
17594	206	11	7843	39	0	8099
17595	27	5	69	7704	0	7805
17596	13	8	7963	71	0	8055
17597	11	7946	72	32	0	8061
17598	52	40	39	8026	0	8157
17599	50	21	42	7899	0	8012
17600	35	14	15	8196	0	8260
17601	28	14	8154	87	0	8283
17602	26	34	8184	44	0	8288
17603	21	13	74	8416	0	8524
17604	31	7	38	9649	0	9725
17605	21	6	38	10383	0	10448
17606	10744	6	35	240	0	11025
17607	165	4	36	11339	0	11544
17608	86	11	12188	208	0	12493
17609	13362	9	189	140	0	13700
17610	278	20	102	14034	0	14434
17611	15031	14	48	303	0	15396
17612	15416	14	23	187	0	15640
17613	480	4	31	15317	0	15832
17614	15481	2	44	378	0	15905
17615	15542	4	35	231	0	15812
17616	502	10	14800	102	0	15414
17617	254	14869	309	87	0	15519
17618	169	291	168	14332	0	14960
17619	147	133	76	14903	0	15259
17620	14747	63	57	477	0	15344
17621	14586	39	47	239	0	14911
17622	14665	29	43	176	0	14913
17623	546	36	13858	113	0	14553
17624	284	14051	306	119	0	14760
17625	14126	294	168	97	0	14685
17626	425	14216	101	60	0	14802
17627	14388	371	48	94	0	14901
17628	496	176	49	14111	0	14832
17629	14258	98	47	404	0	14807
17630	14451	71	38	225	0	14785
17631	14641	51	28	172	0	14892
17632	599	45	14080	106	0	14830
17633	14482	24	322	130	0	14958
17634	513	14339	151	89	0	15092
17635	14791	318	83	89	0	15281
17636	14863	174	54	113	0	15204
17637	15060	89	62	94	0	15305
17638	683	68	49	14218	0	15018
17639	383	14178	44	344	0	14949
17640	14388	351	52	209	0	15000
17641	530	191	14097	132	0	14950
17642	320	14193	329	123	0	14965
17643	295	365	149	13417	0	14226
17644	226	14051	96	306	0	14679
17645	14135	409	71	196	0	14811
17646	14634	206	66	100	0	15006
17647	648	130	58	14264	0	15100
17648	370	122	14028	394	0	14914
17649	271	14063	330	216	0	14880
17650	307	389	173	12428	0	13297
17651	241	204	111	14711	0	15267
17652	219	137	69	15182	0	15607
17653	14895	98	65	629	0	15687
17654	15232	94	55	316	0	15697
17655	15375	89	57	198	0	15719
17656	15561	84	55	168	0	15868
17657	758	76	42	15031	0	15907
17658	428	107	15096	424	0	16055
17659	359	81	345	15356	0	16141
17660	296	58	191	15543	0	16088
17661	246	76	106	15625	0	16053
17662	247	60	71	15771	0	16149
17663	15304	80	72	710	0	16166
17664	577	50	84	15434	0	16145
17665	15443	56	75	623	0	16197
17666	15650	71	53	397	0	16171
17667	732	68	15018	253	0	16071
17668	481	75	14885	205	0	15646
17669	366	59	15442	217	0	16084
17670	348	74	583	15091	0	16096
17671	285	66	15258	529	0	16138
17672	281	56	468	14879	0	15684
17673	282	68	244	15052	0	15646
17674	15091	65	147	730	0	16033
17675	603	72	118	14869	0	15662
17676	413	15169	109	589	0	16280
17677	15605	384	125	368	0	16482
17678	606	15571	115	266	0	16558
17679	400	470	15558	250	0	16678
17680	317	15792	434	228	0	16771
17681	15599	478	256	215	0	16548
17682	634	254	158	15418	0	16464
17683	416	160	15220	524	0	16320
17684	15432	130	435	332	0	16329
17685	628	115	262	15531	0	16536
17686	411	130	15574	536	0	16651
17687	350	105	444	15729	0	16628
17688	322	95	233	16014	0	16664
17689	312	84	158	15911	0	16465
17690	285	15492	134	657	0	16568
17691	15887	406	104	408	0	16805
17692	608	233	114	15648	0	16603
17693	400	15774	134	533	0	16841
17694	324	460	82	16107	0	16973
17695	285	284	15827	574	0	16970
17696	270	15962	437	362	0	17031
17697	15991	467	235	292	0	16985
17698	16225	251	152	246	0	16874
17699	703	180	124	15844	0	16851
17700	450	140	114	16153	0	16857
17701	16052	111	114	685	0	16962
17702	15639	120	124	433	0	16316
17703	665	15714	107	291	0	16777
17704	14583	380	88	238	0	15289
17705	541	170	13726	188	0	14625
17706	371	123	13362	153	0	14009
17707	205	12954	368	168	0	13695
17708	135	12415	208	121	0	12879
17709	10627	296	216	108	0	11247
17710	212	10709	53	82	0	11056
17711	10114	157	30	60	0	10361
17712	9944	55	28	69	0	10096
17713	9893	41	25	56	0	10015
17714	209	32	28	9770	0	10039
17715	9890	26	21	166	0	10103
17716	194	30	9731	69	0	10024
17717	89	33	9777	57	0	9956
17718	65	9941	159	53	0	10218
17719	66	123	10033	40	0	10262
17720	79	50	141	9663	0	9933
17721	40	47	10050	143	0	10280
17722	58	42	9787	62	0	9949
17723	57	25	158	9949	0	10189
17724	10113	27	70	169	0	10379
17725	10171	35	40	85	0	10331
17726	169	32	10379	43	0	10623
17727	10252	29	125	73	0	10479
17728	170	32	10467	39	0	10708
17729	10498	21	149	61	0	10729
17730	10922	18	65	63	0	11068
17731	187	40	44	10723	0	10994
17732	103	17	40	10502	0	10662
17733	72	10117	44	158	0	10391
17734	57	10456	43	83	0	10639
17735	52	139	50	10387	0	10628
17736	62	82	43	10482	0	10669
17737	10178	36	33	174	0	10421
17738	135	10069	33	75	0	10312
17739	10027	128	22	71	0	10248
17740	140	10062	30	40	0	10272
17741	70	142	9919	32	0	10163
17742	79	61	115	9822	0	10077
17743	9939	43	49	147	0	10178
17744	10220	23	31	77	0	10351
17745	190	10222	28	50	0	10490
17746	79	10499	23	33	0	10634
17747	53	10729	33	31	0	10846
17748	78	203	31	11609	0	11921
17749	44	74	12092	191	0	12401
17750	27	12075	200	75	0	12377
17751	84	192	56	12438	0	12770
17752	56	51	33	12734	0	12874
17753	23	46	12508	225	0	12802
17754	34	34	12182	79	0	12329
17755	12081	10	226	98	0	12415
17756	226	19	12692	15	0	12952
17757	12465	26	227	57	0	12775
17758	12390	19	56	60	0	12525
17759	12445	18	59	59	0	12581
17760	12362	19	42	55	0	12478
17761	275	31	11920	30	0	12256
17762	106	12046	208	24	0	12384
17763	105	197	67	11939	0	12308
17764	50	60	12117	212	0	12439
17765	80	53	200	11736	0	12069
17766	76	10828	99	220	0	11223
17767	85	195	58	12091	0	12429
17768	85	54	38	12152	0	12329
17769	76	56	36	11860	0	12028
17770	11877	26	36	305	0	12244
17771	250	34	35	11907	0	12226
17772	118	25	26	12033	0	12202
17773	102	40	40	11912	0	12094
17774	39	11371	47	289	0	11746
17775	11345	214	37	150	0	11746
17776	226	10791	40	96	0	11153
17777	62	10968	45	59	0	11134
17778	89	203	43	11029	0	11364
17779	60	75	31	11115	0	11281
17780	10936	45	28	298	0	11307
17781	246	28	29	11084	0	11387
17782	11126	28	31	286	0	11471
17783	13395	40	30	102	0	13567
17784	405	35	34	13290	0	13764
17785	189	33	44	13361	0	13627
17786	105	13462	30	412	0	14009
17787	13982	323	29	214	0	14548
17788	393	14525	26	116	0	15060
17789	14666	438	29	87	0	15220
17790	468	156	14226	83	0	14933
17791	14325	116	350	118	0	14909
17792	15011	43	129	118	0	15301
17793	574	54	85	14378	0	15091
17794	259	53	14374	449	0	15135
17795	148	14329	387	196	0	15060
17796	161	415	164	14759	0	15499
17797	97	179	14706	466	0	15448
17798	153	121	445	14692	0	15411
17799	14509	75	178	559	0	15321
17800	511	54	14448	235	0	15248
17801	206	14085	441	170	0	14902
17802	170	14675	193	99	0	15137
17803	171	565	146	12955	0	13837
17804	122	14221	76	365	0	14784
17805	14067	480	62	203	0	14812
17806	14186	185	54	176	0	14601
17807	14187	117	78	127	0	14509
17808	636	103	13436	93	0	14268
17809	13849	100	417	122	0	14488
17810	544	84	179	13561	0	14368
17811	252	86	109	13679	0	14126
17812	223	69	52	13818	0	14162
17813	153	64	89	13823	0	14129
17814	137	72	13190	674	0	14073
17815	117	103	13307	302	0	13829
17816	130	62	13138	219	0	13549
17817	12515	84	593	175	0	13367
17818	500	12738	228	156	0	13622
17819	258	418	140	12764	0	13580
17820	12681	173	77	545	0	13476
17821	465	12751	109	263	0	13588
17822	252	13236	90	188	0	13766
17823	12844	555	104	157	0	13660
17824	13072	272	72	146	0	13562
17825	598	12765	68	132	0	13563
17826	322	446	57	11975	0	12800
17827	193	12373	72	469	0	13107
17828	12217	508	76	222	0	13023
17829	12236	227	89	167	0	12719
17830	12384	160	60	110	0	12714
17831	692	11840	55	107	0	12694
17832	344	445	47	12001	0	12837
17833	208	214	11879	489	0	12790
17834	168	184	399	11998	0	12749
17835	167	123	171	12349	0	12810
17836	167	105	11869	610	0	12751
17837	11849	86	415	317	0	12667
17838	525	119	191	12048	0	12883
17839	271	98	128	12095	0	12592
17840	193	11900	83	585	0	12761
17841	11926	466	66	320	0	12778
17842	535	223	74	11725	0	12557
17843	273	11801	95	498	0	12667
17844	11424	450	71	258	0	12203
17845	473	11438	63	225	0	12199
17846	10920	456	109	165	0	11650
17847	513	204	10725	149	0	11591
17848	219	145	9588	134	0	10086
17849	175	82	9174	88	0	9519
17850	122	8937	505	103	0	9667
17851	151	390	296	7787	0	8624
17852	97	8247	101	330	0	8775
17853	8241	380	66	173	0	8860
17854	371	197	8157	105	0	8830
17855	8157	110	316	110	0	8693
17856	8353	108	183	59	0	8703
17857	508	84	112	8012	0	8716
17858	8218	101	67	336	0	8722
17859	459	61	54	8165	0	8739
17860	210	78	8024	384	0	8696
17861	8002	78	331	195	0	8606
17862	360	7943	211	128	0	8642
17863	209	341	120	8038	0	8708
17864	8094	164	66	346	0	8670
17865	379	127	59	8121	0	8686
17866	228	71	7878	405	0	8582
17867	166	65	328	7913	0	8472
17868	122	7889	173	378	0	8562
17869	8014	311	104	183	0	8612
17870	367	161	63	7990	0	8581
17871	8143	119	60	361	0	8683
17872	414	65	44	8131	0	8654
17873	220	52	69	8067	0	8408
17874	163	7933	57	448	0	8601
17875	7890	324	59	257	0	8530
17876	349	8195	55	155	0	8754
17877	243	352	47	7665	0	8307
17878	119	7872	47	355	0	8393
17879	7812	352	46	206	0	8416
17880	7792	159	34	189	0	8174
17881	7828	131	40	139	0	8138
17882	497	7359	52	101	0	8009
17883	116	5301	22	49	0	5488
17884	5172	179	17	51	0	5419
17885	175	5283	12	46	0	5516
17886	119	293	35	4673	0	5120
17887	61	58	4466	137	0	4722
17888	3855	30	84	42	0	4011
17889	3963	18	24	42	0	4047
17890	3935	18	16	19	0	3988
17891	116	3914	5	13	0	4048
17892	3957	80	2	23	0	4062
17893	93	38	4041	7	0	4179
17894	33	4038	58	20	0	4149
17895	30	108	21	3710	0	3869
17896	9	3720	14	29	0	3772
17897	3554	34	3	19	0	3610
17898	33	3652	4	13	0	3702
17899	10	33	2	3636	0	3681
17900	10	3647	4	26	0	3687
17901	7	27	3	3729	0	3766
17902	12	7	5	3651	0	3675
17903	2	10	3682	30	0	3724
17904	9	3	24	3628	0	3664
17905	3674	5	4	36	0	3719
17906	3702	3	7	11	0	3723
17907	33	5	3	3764	0	3805
17908	13	6	3732	28	0	3779
17909	13	9	27	3723	0	3772
17910	3753	5	6	41	0	3805
17911	3958	5	10	21	0	3994
17912	4013	5	2	19	0	4039
17913	37	4218	9	4	0	4268
17914	4317	26	2	24	0	4369
17915	41	10	4216	4	0	4271
17916	4567	8	30	24	0	4629
17917	42	3	10	4809	0	4864
17918	14	7	10	4823	0	4854
17919	19	3	3	4853	0	4878
17920	4745	10	4	55	0	4814
17921	4665	2	3	26	0	4696
17922	44	7	2	4709	0	4762
17923	28	5	4975	40	0	5048
17924	25	4	37	5006	0	5072
17925	12	5	10	5049	0	5076
17926	17	5	5058	44	0	5124
17927	8	5109	34	28	0	5179
17928	19	31	10	5223	0	5283
17929	5324	9	11	55	0	5399
17930	39	13	6	5349	0	5407
17931	22	6	3	5367	0	5398
17932	5415	9	7	66	0	5497
17933	39	5366	4	35	0	5444
17934	26	5485	6	16	0	5533
17935	5508	45	2	26	0	5581
17936	49	17	5448	13	0	5527
17937	5247	12	44	37	0	5340
17938	60	16	5744	10	0	5830
17939	22	5848	48	6	0	5924
17940	5935	42	8	28	0	6013
17941	6041	13	10	22	0	6086
17942	6088	13	6	29	0	6136
17943	6182	4	5	23	0	6214
17944	60	13	6143	5	0	6221
17945	43	4	41	6140	0	6228
17946	6286	10	9	60	0	6365
17947	56	9	6427	11	0	6503
17948	19	10	6303	14	0	6346
17949	27	6370	54	4	0	6455
17950	6447	32	19	17	0	6515
17951	45	14	8	6411	0	6478
17952	6454	6	14	53	0	6527
17953	41	6551	7	9	0	6608
17954	16	34	2	6933	0	6985
17955	19	8	3	6938	0	6968
17956	23	4	3	7088	0	7118
17957	10	9	7204	65	0	7288
17958	10	7289	53	33	0	7385
17959	8018	60	10	32	0	8120
17960	99	11	12	8074	0	8196
17961	8049	14	7	97	0	8167
17962	8028	6	8	46	0	8088
17963	125	7	2	8050	0	8184
17964	49	14	8266	95	0	8424
17965	46	1	81	8229	0	8357
17966	23	8271	30	102	0	8426
17967	21	86	18	8490	0	8615
17968	11	27	8393	104	0	8535
17969	8303	17	90	56	0	8466
17970	95	6	29	8566	0	8696
17971	8420	8	18	105	0	8551
17972	113	18	8370	35	0	8536
17973	8042	6	85	61	0	8194
17974	116	5	8385	24	0	8530
17975	8114	4	92	40	0	8250
17976	116	8197	40	18	0	8371
17977	43	8429	23	27	0	8522
17978	39	101	25	8455	0	8620
17979	69	45	17	7732	0	7863
17980	20	30	10	8470	0	8530
17981	8486	18	10	147	0	8661
17982	99	14	13	8586	0	8712
17983	45	13	8564	117	0	8739
17984	8266	4	85	83	0	8438
17985	103	8641	34	43	0	8821
17986	8730	86	30	44	0	8890
17987	8574	24	14	35	0	8647
17988	130	21	8586	17	0	8754
17989	84	18	86	8415	0	8603
17990	53	17	27	8882	0	8979
17991	26	22	8877	124	0	9049
17992	20	8757	101	64	0	8942
17993	8683	95	28	75	0	8881
17994	8828	29	30	51	0	8938
17995	147	29	18	8962	0	9156
17996	79	11	14	8993	0	9097
17997	48	12	19	9339	0	9418
17998	9069	10	13	203	0	9295
17999	126	9226	9	76	0	9437
18000	9311	125	12	68	0	9516
18001	9363	32	10	45	0	9450
18002	183	30	9593	22	0	9828
18003	81	21	148	9311	0	9561
18004	55	9678	51	153	0	9937
18005	49	136	42	9893	0	10120
18006	40	61	20	10152	0	10273
18007	40	50	10286	204	0	10580
18008	10508	20	162	124	0	10814
18009	11631	15	62	100	0	11808
18010	12279	11	43	80	0	12413
18011	379	17	25	12016	0	12437
18012	196	21	18	12032	0	12267
18013	100	11658	24	366	0	12148
18014	66	12339	43	148	0	12596
18015	12174	360	25	115	0	12674
18016	327	11996	31	62	0	12416
18017	136	336	11889	48	0	12409
18018	108	123	291	12152	0	12674
18019	12346	70	108	354	0	12878
18020	350	54	12264	133	0	12801
18021	156	46	12214	86	0	12502
18022	12324	17	415	84	0	12840
18023	12419	43	145	69	0	12676
18024	474	31	105	12069	0	12679
18025	201	30	12082	372	0	12685
18026	148	48	324	12136	0	12656
18027	101	56	11675	406	0	12238
18028	79	55	12175	177	0	12486
18029	92	12192	408	117	0	12809
18030	12255	332	179	95	0	12861
18031	12388	138	101	107	0	12734
18032	445	12165	104	73	0	12787
18033	238	334	61	12085	0	12718
18034	176	124	89	12284	0	12673
18035	137	70	85	12504	0	12796
18036	12184	67	56	511	0	12818
18037	389	12014	73	227	0	12703
18038	11916	324	57	173	0	12470
18039	12025	149	69	118	0	12361
18040	474	101	11531	102	0	12208
18041	229	11528	343	99	0	12199
18042	178	328	142	11651	0	12299
18043	127	147	11580	356	0	12210
18044	11315	108	361	191	0	11975
18045	11710	74	159	138	0	12081
18046	11826	61	93	131	0	12111
18047	11734	57	89	115	0	11995
18048	527	63	79	11306	0	11975
18049	263	57	11150	406	0	11876
18050	207	50	346	11230	0	11833
18051	11236	52	157	433	0	11878
18052	11391	57	111	218	0	11777
18053	498	10953	79	143	0	11673
18054	10947	310	71	99	0	11427
18055	445	151	10681	103	0	11380
18056	238	108	10692	78	0	11116
18057	10406	86	416	134	0	11042
18058	401	10339	193	89	0	11022
18059	217	264	99	9530	0	10110
18060	155	9731	58	269	0	10213
18061	158	299	49	9820	0	10326
18062	139	121	64	9944	0	10268
18063	136	81	63	10161	0	10441
18064	9631	74	50	435	0	10190
18065	9931	74	61	223	0	10289
18066	9889	58	59	154	0	10160
18067	460	82	9478	84	0	10104
18068	9579	69	282	98	0	10028
18069	411	48	144	9734	0	10337
18070	235	56	103	10143	0	10537
18071	189	45	9934	392	0	10560
18072	172	45	315	10733	0	11265
18073	11054	47	161	435	0	11697
18074	412	57	11033	209	0	11711
18075	241	39	352	11152	0	11784
18076	11239	44	155	439	0	11877
18077	11371	47	95	251	0	11764
18078	518	45	11203	142	0	11908
18079	272	41	11436	132	0	11881
18080	221	46	441	11465	0	12173
18081	11596	37	225	410	0	12268
18082	11792	50	123	212	0	12177
18083	537	54	95	11129	0	11815
18084	278	11342	86	393	0	12099
18085	11407	332	101	218	0	12058
18086	421	11423	106	168	0	12118
18087	247	345	75	11641	0	12308
18088	216	138	11428	399	0	12181
18089	185	104	11239	201	0	11729
18090	158	60	11469	151	0	11838
18091	164	66	480	11113	0	11823
18092	177	38	203	11456	0	11874
18093	11212	51	132	490	0	11885
18094	385	10961	116	252	0	11714
18095	11291	297	92	182	0	11862
18096	480	134	102	10748	0	11464
18097	236	10829	97	335	0	11497
18098	168	11344	78	198	0	11788
18099	160	384	63	11204	0	11811
18100	11146	150	75	385	0	11756
18101	360	11124	85	207	0	11776
18102	10597	301	71	147	0	11116
18103	374	10904	91	107	0	11476
18104	10856	329	75	106	0	11366
18105	397	144	10542	93	0	11176
18106	196	88	10424	101	0	10809
18107	149	10187	317	76	0	10729
18108	9410	335	247	81	0	10073
18109	224	8792	70	46	0	9132
18110	110	8055	57	33	0	8255
18111	174	222	52	8180	0	8628
18112	8186	68	48	173	0	8475
18113	165	8293	47	60	0	8565
18114	8027	127	29	56	0	8239
18115	151	7891	23	94	0	8159
18116	7826	135	21	38	0	8020
18117	140	7727	14	30	0	7911
18118	58	7765	10	21	0	7854
18119	57	152	23	7502	0	7734
18120	22	7625	22	85	0	7754
18121	7535	112	21	56	0	7724
18122	108	53	7445	33	0	7639
18123	68	31	86	7459	0	7644
18124	39	29	7564	100	0	7732
18125	38	28	103	7504	0	7673
18126	40	17	37	7609	0	7703
18127	29	22	7304	127	0	7482
18128	6675	31	87	83	0	6876
18129	111	7131	44	40	0	7326
18130	7281	99	29	41	0	7450
18131	120	7387	21	24	0	7552
18132	63	112	21	7467	0	7663
18133	7451	45	14	116	0	7626
18134	7472	36	28	52	0	7588
18135	7535	28	25	47	0	7635
18136	157	22	27	7419	0	7625
18137	80	18	25	7582	0	7705
18138	53	7756	17	113	0	7939
18139	7852	108	21	85	0	8066
18140	7974	49	8	59	0	8090
18141	7892	38	21	34	0	7985
18142	7864	22	32	39	0	7957
18143	149	7621	28	44	0	7842
18144	81	114	22	7796	0	8013
18145	67	48	7702	110	0	7927
18146	7470	41	98	65	0	7674
18147	7890	32	35	69	0	8026
18148	155	35	7783	39	0	8012
18149	90	47	7662	25	0	7824
18150	71	44	122	7791	0	8028
18151	58	35	49	8014	0	8156
18152	48	25	51	8173	0	8297
18153	7985	40	38	163	0	8226
18154	148	36	26	8016	0	8226
18155	63	27	7854	151	0	8095
18156	55	29	122	7944	0	8150
18157	38	31	8046	155	0	8270
18158	59	26	137	7955	0	8177
18159	40	36	43	8396	0	8515
18160	60	29	8366	175	0	8630
18161	7933	38	132	116	0	8219
18162	157	8469	54	59	0	8739
18163	8675	152	29	75	0	8931
18164	188	61	38	9036	0	9323
18165	9078	53	21	209	0	9361
18166	200	9451	33	88	0	9772
18167	79	10124	25	70	0	10298
18168	91	325	35	10944	0	11395
18169	44	127	11452	272	0	11895
18170	66	77	11149	94	0	11386
18171	51	11289	326	61	0	11727
18172	10189	273	141	59	0	10662
18173	259	103	58	10167	0	10587
18174	10036	47	68	263	0	10414
18175	246	9874	77	122	0	10319
18176	110	10310	79	63	0	10562
18177	112	349	67	10167	0	10695
18178	10016	144	43	294	0	10497
18179	10220	84	24	130	0	10458
18180	364	86	9871	90	0	10411
18181	173	87	9639	59	0	9958
18182	9664	84	293	96	0	10137
18183	302	9752	113	67	0	10234
18184	9819	254	63	78	0	10214
18185	359	101	73	9637	0	10170
18186	182	50	9589	248	0	10069
18187	9256	43	286	105	0	9690
18188	301	9388	139	53	0	9881
18189	155	9765	81	54	0	10055
18190	130	332	60	9620	0	10142
18191	9751	121	61	299	0	10232
18192	308	92	67	9827	0	10294
18193	10005	79	79	313	0	10476
18194	330	110	9542	133	0	10115
18195	9678	98	221	122	0	10119
18196	10039	84	80	123	0	10326
18197	414	68	9439	112	0	10033
18198	9343	48	247	106	0	9744
18199	373	9041	119	88	0	9621
18200	247	240	78	9171	0	9736
18201	180	9199	83	236	0	9698
18202	9569	257	75	104	0	10005
18203	382	117	87	9186	0	9772
18204	188	9102	78	263	0	9631
18205	163	290	58	9195	0	9706
18206	102	9212	56	294	0	9664
18207	130	323	31	9346	0	9830
18208	9317	174	28	343	0	9862
18209	320	118	33	9348	0	9819
18210	155	111	9079	359	0	9704
18211	8953	109	235	198	0	9495
18212	314	104	84	9159	0	9661
18213	165	112	8860	352	0	9489
18214	140	68	8699	220	0	9127
18215	142	60	9045	161	0	9408
18216	158	32	373	8704	0	9267
18217	136	32	208	9136	0	9512
18218	126	43	152	9129	0	9450
18219	106	39	164	9153	0	9462
18220	8963	44	147	413	0	9567
18221	9218	44	125	250	0	9637
18222	9295	65	115	203	0	9678
18223	9419	55	73	226	0	9773
18224	421	64	62	9203	0	9750
18225	236	62	9141	388	0	9827
18226	9122	63	242	231	0	9658
18227	9611	61	103	155	0	9930
18228	492	42	69	9325	0	9928
18229	280	56	71	9604	0	10011
18230	9469	56	73	423	0	10021
18231	431	53	78	9003	0	9565
18232	248	8907	83	371	0	9609
18233	9243	245	90	250	0	9828
18234	9103	107	89	226	0	9525
18235	464	59	9180	187	0	9890
18236	239	74	296	9208	0	9817
18237	188	82	130	9539	0	9939
18238	9352	71	86	465	0	9974
18239	9550	74	92	221	0	9937
18240	465	60	84	9332	0	9941
18241	271	74	9191	395	0	9931
18242	221	44	9259	242	0	9766
18243	221	35	330	9413	0	9999
18244	221	59	143	9561	0	9984
18245	9351	33	108	455	0	9947
18246	428	8958	106	221	0	9713
18247	220	9015	127	192	0	9554
18248	175	9298	122	172	0	9767
18249	180	324	121	9132	0	9757
18250	9040	139	101	402	0	9682
18251	9094	103	68	223	0	9488
18252	416	8895	37	169	0	9517
18253	9062	343	37	135	0	9577
18254	380	185	30	9001	0	9596
18255	201	133	8888	357	0	9579
18256	222	97	261	8629	0	9209
18257	230	82	94	8830	0	9236
18258	218	77	63	8806	0	9164
18259	8396	69	63	418	0	8946
18260	335	103	95	8060	0	8593
18261	179	7985	76	386	0	8626
18262	7806	220	105	284	0	8415
18263	273	7674	69	226	0	8242
18264	160	7394	62	185	0	7801
18265	132	7593	42	157	0	7924
18266	123	213	6790	114	0	7240
18267	82	6482	170	96	0	6830
18268	82	116	5177	50	0	5425
18269	4646	42	46	35	0	4769
18270	4924	12	18	56	0	5010
18271	46	13	5150	27	0	5236
18272	5187	11	28	43	0	5269
18273	5417	12	11	27	0	5467
18274	49	13	5331	24	0	5417
18275	25	5558	30	17	0	5630
18276	46	32	9	5565	0	5652
18277	5620	21	5	53	0	5699
18278	44	15	13	5564	0	5636
18279	5813	18	7	60	0	5898
18280	5803	12	15	30	0	5860
18281	43	14	5815	16	0	5888
18282	5787	13	29	28	0	5857
18283	44	5935	22	21	0	6022
18284	6079	29	8	20	0	6136
18285	41	17	12	6077	0	6147
18286	31	12	5996	31	0	6070
18287	41	8	27	5934	0	6010
18288	5989	12	17	40	0	6058
18289	38	5984	12	24	0	6058
18290	19	37	5981	24	0	6061
18291	37	10	24	5756	0	5827
18292	29	8	6014	40	0	6091
18293	24	5966	34	24	0	6048
18294	6030	32	17	27	0	6106
18295	42	16	19	6008	0	6085
18296	37	12	6043	33	0	6125
18297	25	25	5633	30	0	5713
18298	6070	19	34	26	0	6149
18299	48	8	20	6173	0	6249
18300	27	11	16	6149	0	6203
18301	18	15	6265	46	0	6344
18302	22	16	6153	25	0	6216
18303	26	6368	53	16	0	6463
18304	20	43	26	6434	0	6523
18305	16	19	20	6429	0	6484
18306	23	6398	13	61	0	6495
18307	23	53	6324	25	0	6425
18308	6172	16	54	25	0	6267
18309	58	12	18	6528	0	6616
18310	22	15	6639	52	0	6728
18311	19	12	60	6409	0	6500
18312	29	6557	23	67	0	6676
18313	19	42	6542	35	0	6638
18314	6323	17	60	38	0	6438
18315	57	14	6589	15	0	6675
18316	35	19	6381	16	0	6451
18317	26	23	6298	15	0	6362
18318	15	15	6773	28	0	6831
18319	24	13	68	6919	0	7024
18320	16	16	7351	62	0	7445
18321	28	13	72	7160	0	7273
18322	16	7364	30	78	0	7488
18323	8177	74	19	40	0	8310
18324	125	25	18	8473	0	8641
18325	54	19	8573	115	0	8761
18326	19	8641	134	65	0	8859
18327	23	112	58	8747	0	8940
18328	8692	46	35	139	0	8912
18329	111	8738	25	62	0	8936
18330	54	128	23	8932	0	9137
18331	8975	50	24	145	0	9194
18332	130	21	8818	51	0	9020
18333	8753	12	134	52	0	8951
18334	145	18	8931	12	0	9106
18335	8485	10	134	30	0	8659
18336	8524	5	47	28	0	8604
18337	157	14	8433	11	0	8615
18338	68	8283	130	10	0	8491
18339	72	126	63	7959	0	8220
18340	23	42	8483	120	0	8668
18341	30	28	121	8156	0	8335
18342	19	7	61	8301	0	8388
18343	15	14	8359	174	0	8562
18344	17	20	8229	76	0	8342
18345	37	9	172	8424	0	8642
18346	8642	10	74	150	0	8876
18347	131	8516	42	72	0	8761
18348	58	8715	27	36	0	8836
18349	8744	167	21	53	0	8985
18350	8987	66	15	49	0	9117
18351	203	35	12	8877	0	9127
18352	90	15	19	9002	0	9126
18353	60	16	11	9152	0	9239
18354	8892	11	20	215	0	9138
18355	148	8581	30	80	0	8839
18356	66	8849	31	47	0	8993
18357	56	158	24	8880	0	9118
18358	45	64	21	9027	0	9157
18359	29	31	26	9037	0	9123
18360	8885	32	20	220	0	9157
18361	139	8914	22	94	0	9169
18362	9080	134	31	68	0	9313
18363	163	61	9013	48	0	9285
18364	64	9185	146	58	0	9453
18365	50	148	78	9233	0	9509
18366	9249	61	37	186	0	9533
18367	174	41	9249	86	0	9550
18368	89	26	9193	49	0	9357
18369	55	29	209	9238	0	9531
18370	33	35	88	9254	0	9410
18371	52	24	32	9079	0	9187
18372	57	24	26	8769	0	8876
18373	47	29	22	8858	0	8956
18374	33	8584	22	264	0	8903
18375	40	146	31	8711	0	8928
18376	8493	77	32	218	0	8820
18377	153	8594	32	121	0	8900
18378	8626	165	24	91	0	8906
18379	188	81	8338	69	0	8676
18380	78	47	8407	82	0	8614
18381	63	36	209	8510	0	8818
18382	50	30	9879	195	0	10154
18383	70	33	242	9851	0	10196
18384	80	30	118	9862	0	10090
18385	10411	36	69	357	0	10873
18386	10528	43	35	187	0	10793
18387	400	10884	43	91	0	11418
18388	181	11440	48	66	0	11735
18389	89	405	48	11392	0	11934
18390	11429	167	51	378	0	12025
18391	334	80	11504	192	0	12110
18392	172	40	324	11567	0	12103
18393	107	55	139	11798	0	12099
18394	66	49	11574	490	0	12179
18395	56	11567	342	259	0	12224
18396	99	360	149	11478	0	12086
18397	56	160	11763	410	0	12389
18398	95	96	349	11718	0	12258
18399	11304	64	171	450	0	11989
18400	356	11246	120	201	0	11923
18401	169	11648	70	148	0	12035
18402	101	436	79	11444	0	12060
18403	11231	195	69	411	0	11906
18404	339	11359	63	223	0	11984
18405	11515	347	68	172	0	12102
18406	399	177	11433	133	0	12142
18407	204	100	11823	140	0	12267
18408	164	68	461	11408	0	12101
18409	113	93	193	12123	0	12522
18410	11694	94	101	539	0	12428
18411	428	77	68	11790	0	12363
18412	225	86	11657	470	0	12438
18413	178	90	375	11642	0	12285
18414	136	89	177	12026	0	12428
18415	102	90	11501	579	0	12272
18416	11194	79	390	311	0	11974
18417	429	82	219	11656	0	12386
18418	11251	64	138	496	0	11949
18419	392	10701	110	287	0	11490
18420	10629	333	119	224	0	11305
18421	389	10450	96	183	0	11118
18422	183	10588	100	184	0	11055
18423	197	465	132	9439	0	10233
18424	9215	177	129	381	0	9902
18425	9292	109	59	206	0	9666
18426	387	91	58	9085	0	9621
18427	9132	89	50	346	0	9617
18428	9259	89	54	199	0	9601
18429	438	78	60	9101	0	9677
18430	8891	84	53	345	0	9373
18431	372	8946	51	207	0	9576
18432	9086	302	70	180	0	9638
18433	397	155	8711	125	0	9388
18434	9142	85	272	172	0	9671
18435	391	54	138	9116	0	9699
18436	232	58	95	9356	0	9741
18437	152	53	80	9398	0	9683
18438	157	66	81	9326	0	9630
18439	129	62	68	9295	0	9554
18440	111	8404	76	510	0	9101
18441	129	9061	69	272	0	9531
18442	9002	340	68	213	0	9623
18443	356	168	8918	158	0	9600
18444	8866	129	286	154	0	9435
18445	376	108	8901	151	0	9536
18446	238	94	299	8780	0	9411
18447	178	93	138	9101	0	9510
18448	8763	83	82	455	0	9383
18449	379	105	8639	252	0	9375
18450	255	87	277	8748	0	9367
18451	195	75	8974	386	0	9630
18452	167	9076	317	237	0	9797
18453	187	296	140	9369	0	9992
18454	9379	152	95	406	0	10032
18455	9252	100	68	250	0	9670
18456	9564	65	80	185	0	9894
18457	474	9150	84	186	0	9894
18458	261	9667	82	166	0	10176
18459	8814	387	79	216	0	9496
18460	373	9491	76	169	0	10109
18461	185	9690	73	203	0	10151
18462	173	398	9303	169	0	10043
18463	126	9162	296	182	0	9766
18464	119	9248	145	172	0	9684
18465	122	408	98	9194	0	9822
18466	138	202	9185	361	0	9886
18467	116	137	9006	220	0	9479
18468	8851	109	365	171	0	9496
18469	353	111	9126	133	0	9723
18470	9341	82	336	130	0	9889
18471	392	85	202	9173	0	9852
18472	221	9293	120	344	0	9978
18473	9737	297	105	207	0	10346
18474	10130	155	89	173	0	10547
18475	456	108	93	9915	0	10572
18476	270	77	92	10125	0	10564
18477	219	76	96	10227	0	10618
18478	9891	78	46	522	0	10537
18479	9207	77	70	311	0	9665
18480	9986	86	69	183	0	10324
18481	474	9490	53	137	0	10154
18482	8266	201	45	77	0	8589
18483	279	7956	35	67	0	8337
18484	133	7966	31	67	0	8197
18485	143	338	50	7245	0	7776
18486	74	7288	43	165	0	7570
18487	6829	127	34	72	0	7062
18488	147	58	16	6745	0	6966
18489	6580	27	12	134	0	6753
18490	120	6376	16	49	0	6561
18491	63	6596	11	25	0	6695
18492	6597	112	21	34	0	6764
18493	123	6675	15	21	0	6834
18494	55	96	19	6655	0	6825
18495	42	39	17	6730	0	6828
18496	6640	14	9	127	0	6790
18497	126	17	10	6642	0	6795
18498	49	18	6792	103	0	6962
18499	32	13	104	6831	0	6980
18500	7055	16	36	131	0	7238
18501	128	7212	16	43	0	7399
18502	7736	133	15	39	0	7923
18503	7619	43	18	44	0	7724
18504	7918	32	15	33	0	7998
18505	199	27	7729	19	0	7974
18506	65	25	7476	25	0	7591
18507	7375	19	149	41	0	7584
18508	153	7474	52	25	0	7704
18509	62	136	29	7592	0	7819
18510	55	54	16	7591	0	7716
18511	35	7313	23	153	0	7524
18512	28	7585	17	49	0	7679
18513	34	164	12	7583	0	7793
18514	31	57	12	7690	0	7790
18515	30	40	7422	170	0	7662
18516	38	34	7051	71	0	7194
18517	7309	26	162	48	0	7545
18518	7703	22	52	42	0	7819
18519	190	21	31	7605	0	7847
18520	81	20	7631	156	0	7888
18521	66	29	142	7577	0	7814
18522	7590	18	52	193	0	7853
18523	170	19	7621	64	0	7874
18524	74	32	157	7755	0	8018
18525	51	29	7770	156	0	8006
18526	35	7689	157	72	0	7953
18527	34	144	7773	47	0	7998
18528	50	51	164	7609	0	7874
18529	7759	30	63	169	0	8021
18530	155	18	35	7846	0	8054
18531	7821	12	30	191	0	8054
18532	7954	26	25	83	0	8088
18533	7843	28	25	62	0	7958
18534	207	16	7593	49	0	7865
18535	7749	19	138	52	0	7958
18536	182	14	58	7816	0	8070
18537	90	20	36	7933	0	8079
18538	67	16	7778	186	0	8047
18539	58	40	131	7761	0	7990
18540	7799	18	61	188	0	8066
18541	155	7741	37	81	0	8014
18542	7902	123	22	74	0	8121
18543	7948	42	23	71	0	8084
18544	8048	29	23	56	0	8156
18545	210	14	19	7889	0	8132
18546	90	32	7900	165	0	8187
18547	62	21	150	8181	0	8414
18548	52	16	52	8329	0	8449
18549	8261	15	28	208	0	8512
18550	8102	20	25	97	0	8244
18551	188	18	7824	60	0	8090
18552	84	10	157	7825	0	8076
18553	70	14	7848	175	0	8107
18554	7898	23	172	73	0	8166
18555	175	8552	57	71	0	8855
18556	8555	143	39	60	0	8797
18557	193	8755	32	47	0	9027
18558	8706	176	32	50	0	8964
18559	195	8720	52	37	0	9004
18560	116	182	29	8808	0	9135
18561	88	61	21	9059	0	9229
18562	8993	43	25	239	0	9300
18563	8961	26	24	107	0	9118
18564	8988	22	24	76	0	9110
18565	8713	28	20	77	0	8838
18566	8819	26	36	59	0	8940
18567	290	16	26	8557	0	8889
18568	120	8509	19	193	0	8841
18569	115	179	11	8410	0	8715
18570	91	8363	19	193	0	8666
18571	86	200	19	8251	0	8556
18572	64	8259	18	221	0	8562
18573	65	194	17	8123	0	8399
18574	76	64	7807	218	0	8165
18575	7529	53	161	98	0	7841
18576	222	7770	50	76	0	8118
18577	7819	175	40	67	0	8101
18578	246	70	7678	59	0	8053
18579	7549	57	159	62	0	7827
18580	224	42	7905	67	0	8238
18581	109	42	207	7952	0	8310
18582	86	8592	62	211	0	8951
18583	79	225	8682	71	0	9057
18584	76	90	226	8788	0	9180
18585	8479	48	91	279	0	8897
18586	270	35	65	8948	0	9318
18587	135	42	50	9071	0	9298
18588	99	48	36	9216	0	9399
18589	67	51	8893	340	0	9351
18590	89	31	232	8812	0	9164
18591	63	8593	102	299	0	9057
18592	85	214	61	8777	0	9137
18593	60	90	42	8861	0	9053
18594	8590	50	44	340	0	9024
18595	267	47	37	8783	0	9134
18596	119	41	8834	295	0	9289
18597	93	40	8792	148	0	9073
18598	76	28	8827	115	0	9046
18599	53	8722	296	101	0	9172
18600	8459	221	181	105	0	8966
18601	224	8394	79	73	0	8770
18602	8122	218	47	74	0	8461
18603	238	83	44	8025	0	8390
18604	102	60	8101	236	0	8499
18605	75	49	7837	106	0	8067
18606	65	8165	241	93	0	8564
18607	71	216	104	8136	0	8527
18608	63	83	71	8307	0	8524
18609	63	53	46	8397	0	8559
18610	40	46	8172	325	0	8583
18611	7751	46	242	152	0	8191
18612	231	45	8164	114	0	8554
18613	124	59	236	8062	0	8481
18614	129	31	97	8379	0	8636
18615	82	38	8215	321	0	8656
18616	7895	34	251	168	0	8348
18617	250	8216	126	117	0	8709
18618	8289	228	94	123	0	8734
18619	278	101	78	8146	0	8603
18620	118	8219	57	289	0	8683
18621	109	244	62	8389	0	8804
18622	8297	102	70	317	0	8786
18623	283	67	53	8225	0	8628
18624	128	69	7996	321	0	8514
18625	7927	40	248	180	0	8395
18626	8124	49	116	169	0	8458
18627	323	57	7966	122	0	8468
18628	177	47	255	7999	0	8478
18629	8196	50	124	304	0	8674
18630	311	49	86	8058	0	8504
18631	176	49	64	8047	0	8336
18632	139	45	49	8082	0	8315
18633	127	37	67	8095	0	8326
18634	69	50	7737	411	0	8267
18635	94	44	249	7808	0	8195
18636	91	32	7714	350	0	8187
18637	7600	46	278	207	0	8131
18638	7899	45	135	166	0	8245
18639	7905	42	100	151	0	8198
18640	7952	40	76	158	0	8226
18641	374	37	95	7697	0	8203
18642	7615	30	74	333	0	8052
18643	318	31	7542	181	0	8072
18644	174	31	7485	163	0	7853
18645	7171	27	293	149	0	7640
18646	276	7042	146	142	0	7606
18647	139	7026	103	107	0	7375
18648	122	246	95	6918	0	7381
18649	100	108	6939	252	0	7399
18650	6596	72	252	154	0	7074
18651	276	52	6855	125	0	7308
18652	144	6510	243	132	0	7029
18653	140	196	6509	90	0	6935
18654	93	6200	244	102	0	6639
18655	5559	203	127	98	0	5987
18656	210	5532	91	63	0	5896
18657	98	5359	60	63	0	5580
18658	75	199	69	5244	0	5587
18659	65	90	5172	197	0	5524
18660	74	71	171	5042	0	5358
18661	58	51	79	5183	0	5371
18662	47	30	5019	235	0	5331
18663	51	39	177	4909	0	5176
18664	60	4793	103	190	0	5146
18665	63	143	75	5072	0	5353
18666	4998	78	58	214	0	5348
18667	175	49	60	5079	0	5363
18668	117	45	5005	194	0	5361
18669	94	43	156	5093	0	5386
18670	67	42	4992	218	0	5319
18671	4937	39	180	123	0	5279
18672	176	32	82	5079	0	5369
18673	5081	32	73	202	0	5388
18674	186	25	5030	130	0	5371
18675	4841	29	179	103	0	5152
18676	192	5006	100	81	0	5379
18677	108	150	5046	68	0	5372
18678	82	122	159	4936	0	5299
18679	74	45	5059	185	0	5363
18680	61	4713	175	118	0	5067
18681	68	5012	84	92	0	5256
18682	4269	128	63	58	0	4518
18683	119	4591	49	53	0	4812
18684	4643	116	42	62	0	4863
18685	146	50	35	4677	0	4908
18686	60	39	4623	126	0	4848
18687	45	4648	117	61	0	4871
18688	55	114	79	4606	0	4854
18689	63	59	26	4759	0	4907
18690	53	39	31	4844	0	4967
18691	55	31	26	4836	0	4948
18692	39	4604	40	171	0	4854
18693	39	4877	34	95	0	5045
18694	4727	140	33	68	0	4968
18695	130	4697	41	52	0	4920
18696	55	127	19	4496	0	4697
18697	36	52	4483	120	0	4691
18698	35	4377	84	74	0	4570
18699	41	94	53	4269	0	4457
18700	38	77	27	4285	0	4427
18701	19	4254	28	124	0	4425
18702	4129	89	18	64	0	4300
18703	98	55	4121	37	0	4311
18704	3854	39	75	50	0	4018
18705	91	3987	36	35	0	4149
18706	3678	75	18	16	0	3787
18707	67	3781	6	13	0	3867
18708	33	88	12	3889	0	4022
18709	30	37	15	3975	0	4057
18710	3899	26	7	97	0	4029
18711	72	14	13	3938	0	4037
18712	39	23	3844	84	0	3990
18713	21	3743	58	48	0	3870
18714	19	3842	33	28	0	3922
18715	26	79	13	3732	0	3850
18716	17	36	3717	66	0	3836
18717	26	25	51	3638	0	3740
18718	22	19	25	3687	0	3753
18719	13	22	3619	93	0	3747
18720	10	23	3495	53	0	3581
18721	14	3585	70	33	0	3702
18722	3615	60	29	40	0	3744
18723	60	35	13	3540	0	3648
18724	28	3443	21	68	0	3560
18725	3547	63	18	38	0	3666
18726	59	46	11	3545	0	3661
18727	32	15	19	3509	0	3575
18728	5	3453	19	90	0	3567
18729	13	65	10	3438	0	3526
18730	3433	34	12	81	0	3560
18731	56	16	20	3466	0	3558
18732	39	26	13	3498	0	3576
18733	26	29	3401	88	0	3544
18734	26	20	3236	54	0	3336
18735	3382	21	73	32	0	3508
18736	57	32	28	3373	0	3490
18737	44	17	13	3419	0	3493
18738	27	16	15	3442	0	3500
18739	18	26	3333	103	0	3480
18740	3359	19	54	73	0	3505
18741	63	15	37	3386	0	3501
18742	38	17	20	3457	0	3532
18743	3335	24	18	112	0	3489
18744	63	3313	28	56	0	3460
18745	44	61	3311	45	0	3461
18746	23	33	62	3257	0	3375
18747	28	3281	37	92	0	3438
18748	24	59	27	3376	0	3486
18749	3255	40	21	97	0	3413
18750	73	22	26	3299	0	3420
18751	3222	22	18	107	0	3369
18752	3251	31	17	64	0	3363
18753	94	19	17	3168	0	3298
18754	48	3077	20	98	0	3243
18755	26	3198	15	75	0	3314
18756	20	84	3173	47	0	3324
18757	31	42	73	3057	0	3203
18758	32	31	33	3199	0	3295
18759	23	30	16	3233	0	3302
18760	3129	23	24	120	0	3296
18761	74	18	25	3169	0	3286
18762	48	31	3147	93	0	3319
18763	3178	20	55	81	0	3334
18764	75	21	37	3266	0	3399
18765	53	17	12	3337	0	3419
18766	29	26	3212	123	0	3390
18767	3182	20	77	65	0	3344
18768	80	18	37	3257	0	3392
18769	44	26	3284	104	0	3458
18770	24	24	66	3305	0	3419
18771	41	13	48	3094	0	3196
18772	30	3257	22	115	0	3424
18773	3203	50	28	91	0	3372
18774	3197	28	21	68	0	3314
18775	88	3171	25	64	0	3348
18776	3173	69	21	73	0	3336
18777	3194	36	31	51	0	3312
18778	102	15	27	3211	0	3355
18779	57	18	3101	95	0	3271
18780	36	19	2915	76	0	3046
18781	23	15	2797	39	0	2874
18782	35	9	2811	39	0	2894
18783	36	84	72	2382	0	2574
18784	21	9	41	2467	0	2538
18785	18	12	15	2435	0	2480
18786	13	9	13	2489	0	2524
18787	2486	9	12	81	0	2588
18788	57	2566	11	45	0	2679
18789	2775	41	14	44	0	2874
18790	60	20	2780	31	0	2891
18791	39	16	2830	17	0	2902
18792	28	31	67	2876	0	3002
18793	2911	5	51	87	0	3054
18794	2863	5	23	44	0	2935
18795	76	2863	15	29	0	2983
18796	27	2926	18	20	0	2991
18797	25	68	11	2931	0	3035
18798	2932	23	6	71	0	3032
18799	60	2979	6	43	0	3088
18800	2979	61	7	23	0	3070
18801	3011	30	8	28	0	3077
18802	3035	17	9	25	0	3086
18803	92	16	2974	19	0	3101
18804	49	3026	60	11	0	3146
18805	3009	57	25	33	0	3124
18806	3035	22	15	20	0	3092
18807	89	2921	13	12	0	3035
18808	31	2809	4	10	0	2854
18809	2847	62	3	16	0	2928
18810	70	25	2	2829	0	2926
18811	37	15	2871	48	0	2971
18812	2871	13	47	28	0	2959
18813	64	14	16	3013	0	3107
18814	30	3114	14	51	0	3209
18815	35	50	8	3201	0	3294
18816	22	23	3223	54	0	3322
18817	20	20	44	3193	0	3277
18818	3365	14	13	63	0	3455
18819	75	12	7	3397	0	3491
18820	33	13	14	3456	0	3516
18821	21	17	3466	72	0	3576
18822	33	7	53	3357	0	3450
18823	23	3448	19	64	0	3554
18824	3478	55	14	34	0	3581
18825	3434	23	11	22	0	3490
18826	72	11	3459	22	0	3564
18827	31	19	52	3379	0	3481
18828	16	3355	21	60	0	3452
18829	20	3503	13	27	0	3563
18830	3478	59	9	35	0	3581
18831	65	24	5	3547	0	3641
18832	28	12	3509	67	0	3616
18833	21	11	3453	29	0	3514
18834	19	12	69	3558	0	3658
18835	3573	10	25	75	0	3683
18836	3576	10	17	36	0	3639
18837	83	8	18	3711	0	3820
18838	37	12	3780	66	0	3895
18839	23	3743	64	30	0	3860
18840	3762	63	18	29	0	3872
18841	70	3810	13	18	0	3911
18842	3818	67	11	30	0	3926
18843	68	22	15	3833	0	3938
18844	25	16	3816	67	0	3924
18845	29	8	59	3767	0	3863
18846	3835	14	23	85	0	3957
18847	72	7	3868	29	0	3976
18848	28	3881	58	29	0	3996
18849	27	51	24	3898	0	4000
18850	3911	20	20	76	0	4027
18851	72	16	3925	29	0	4042
18852	28	17	62	3944	0	4051
18853	36	14	22	4073	0	4145
18854	18	16	4050	84	0	4168
18855	32	13	68	3985	0	4098
18856	20	7	4076	85	0	4188
18857	3961	5	69	47	0	4082
18858	66	12	25	4269	0	4372
18859	33	11	4500	67	0	4611
18860	21	4527	71	37	0	4656
18861	4673	75	29	38	0	4815
18862	5057	23	21	40	0	5141
18863	130	21	12	5603	0	5766
18864	48	5804	25	126	0	6003
18865	5876	131	19	62	0	6088
18866	150	24	13	5931	0	6118
18867	48	26	5952	142	0	6168
18868	5808	24	130	71	0	6033
18869	148	5875	38	45	0	6106
18870	61	124	32	6000	0	6217
18871	6020	43	18	152	0	6233
18872	152	31	5939	45	0	6167
18873	54	29	6080	35	0	6198
18874	61	23	145	5958	0	6187
18875	45	12	6187	152	0	6396
18876	40	8	161	6015	0	6224
18877	27	5948	55	152	0	6182
18878	33	134	41	6341	0	6549
18879	6250	39	29	195	0	6513
18880	148	29	6292	63	0	6532
18881	46	6380	145	68	0	6639
18882	68	134	49	6400	0	6651
18883	34	41	6658	168	0	6901
18884	35	67	143	6379	0	6624
18885	31	6417	64	163	0	6675
18886	22	6662	46	49	0	6779
18887	6398	146	38	65	0	6647
18888	119	6571	28	35	0	6753
18889	38	134	6303	28	0	6503
18890	5941	36	135	40	0	6152
18891	106	38	6361	26	0	6531
18892	55	24	113	5917	0	6109
18893	35	17	6335	103	0	6490
18894	24	6299	119	35	0	6477
18895	29	93	40	6371	0	6533
18896	25	30	31	6348	0	6434
18897	24	24	23	6255	0	6326
18898	10	29	6289	130	0	6458
18899	18	14	100	6143	0	6275
18900	20	20	29	6405	0	6474
18901	6207	13	26	149	0	6395
18902	6291	15	18	81	0	6405
18903	114	16	6311	42	0	6483
18904	49	6241	114	27	0	6431
18905	35	101	6334	27	0	6497
18906	25	24	123	6294	0	6466
18907	24	23	6448	110	0	6605
18908	18	19	128	6352	0	6517
18909	12	17	35	6540	0	6604
18910	12	12	6531	137	0	6692
18911	5952	9	123	91	0	6175
18912	101	6565	45	48	0	6759
18913	29	102	38	6634	0	6803
18914	28	28	6767	123	0	6946
18915	29	36	6488	46	0	6599
18916	6406	17	122	50	0	6595
18917	108	6673	53	36	0	6870
18918	39	102	44	6744	0	6929
18919	6935	33	29	128	0	7125
18920	123	18	30	6972	0	7143
18921	42	19	21	7212	0	7294
18922	32	17	7183	142	0	7374
18923	6888	15	105	104	0	7112
18924	7294	9	44	68	0	7415
18925	146	12	36	7283	0	7477
18926	7252	10	26	138	0	7426
18927	140	17	23	7274	0	7454
18928	50	7064	25	150	0	7289
18929	47	7417	26	55	0	7545
18930	36	123	29	7539	0	7727
18931	7388	43	22	153	0	7606
18932	117	41	15	7450	0	7623
18933	7485	24	11	171	0	7691
18934	7560	17	24	79	0	7680
18935	156	14	19	7567	0	7756
18936	71	11	20	7684	0	7786
18937	56	17	7437	160	0	7670
18938	45	13	7405	73	0	7536
18939	36	11	141	7495	0	7683
18940	32	15	7903	145	0	8095
18941	7744	9	157	78	0	7988
18942	134	14	53	8552	0	8753
18943	40	30	9217	161	0	9448
18944	9300	17	183	89	0	9589
18945	10380	10	71	86	0	10547
18946	261	10965	48	56	0	11330
18947	163	194	33	11279	0	11669
18948	99	91	11418	217	0	11825
18949	11377	52	213	139	0	11781
18950	11819	37	94	119	0	12069
18951	312	30	11618	52	0	12012
18952	11723	23	232	70	0	12048
18953	288	25	107	11645	0	12065
18954	172	11	74	11861	0	12118
18955	11752	12	59	319	0	12142
18956	11857	11	37	160	0	12065
18957	353	47	47	11649	0	12096
18958	193	18	11571	256	0	12038
18959	130	11287	202	139	0	11758
18960	92	193	11408	94	0	11787
18961	84	89	11256	72	0	11501
18962	61	10995	301	54	0	11411
18963	109	188	160	10119	0	10576
18964	64	82	74	10361	0	10581
18965	33	46	10330	207	0	10616
18966	56	40	172	10146	0	10414
18967	10295	20	104	228	0	10647
18968	159	30	10427	126	0	10742
18969	10432	18	155	115	0	10720
18970	10696	7	107	89	0	10899
18971	10760	9	63	86	0	10918
18972	297	13	10419	34	0	10763
18973	164	35	10409	39	0	10647
18974	130	25	235	10367	0	10757
18975	97	25	149	10071	0	10342
18976	81	10514	79	202	0	10876
18977	10580	143	60	161	0	10944
18978	10534	71	74	96	0	10775
18979	239	10549	69	61	0	10918
18980	10600	149	58	105	0	10912
18981	221	10464	40	77	0	10802
18982	10661	177	36	84	0	10958
18983	245	104	30	10309	0	10688
18984	178	66	10265	166	0	10675
18985	134	45	10058	92	0	10329
18986	89	53	229	10182	0	10553
18987	94	29	140	10293	0	10556
18988	52	42	10113	242	0	10449
18989	67	31	203	9913	0	10214
18990	63	35	141	9976	0	10215
18991	10056	24	76	299	0	10455
18992	10189	24	70	193	0	10476
18993	10006	26	55	147	0	10234
18994	287	22	9841	90	0	10240
18995	166	9849	187	72	0	10274
18996	151	146	92	10037	0	10426
18997	114	78	10178	186	0	10556
18998	104	10128	193	103	0	10528
18999	10332	159	131	74	0	10696
19000	221	94	83	10366	0	10764
19001	132	63	76	10520	0	10791
19002	10347	40	71	278	0	10736
19003	203	48	44	10403	0	10698
19004	149	34	53	10460	0	10696
19005	10436	40	38	308	0	10822
19006	244	39	10237	168	0	10688
19007	161	10222	169	131	0	10683
19008	10345	173	101	113	0	10732
19009	228	114	10450	75	0	10867
19010	10275	57	187	112	0	10631
19011	237	10603	141	81	0	11062
19012	10542	180	98	86	0	10906
19013	10561	104	76	89	0	10830
19014	10402	62	65	99	0	10628
19015	312	53	66	10164	0	10595
19016	204	48	65	10207	0	10524
19017	141	10066	63	284	0	10554
19018	119	10122	60	168	0	10469
19019	142	10290	51	112	0	10595
19020	10201	226	43	113	0	10583
19021	228	122	10009	87	0	10446
19022	164	85	155	9955	0	10359
19023	102	67	111	9999	0	10279
19024	95	9970	72	226	0	10363
19025	98	187	46	10074	0	10405
19026	103	112	69	9998	0	10282
19027	82	10126	65	251	0	10524
19028	10028	177	52	192	0	10449
19029	181	10157	44	122	0	10504
19030	125	191	9975	109	0	10400
19031	9878	138	145	122	0	10283
19032	194	10156	87	114	0	10551
19033	10106	170	63	120	0	10459
19034	219	122	66	10055	0	10462
19035	168	65	67	10063	0	10363
19036	110	72	10000	215	0	10397
19037	116	56	9822	128	0	10122
19038	116	79	190	9895	0	10280
19039	9851	52	119	205	0	10227
19040	9508	37	68	138	0	9751
19041	228	9462	69	92	0	9851
19042	129	9140	48	70	0	9387
19043	78	8701	37	49	0	8865
19044	228	279	110	7776	0	8393
19045	7424	69	121	134	0	7748
19046	7097	8	1	42	0	7148
19047	6929	6	4	51	0	6990
19048	80	14	6717	12	0	6823
19049	23	7640	71	15	0	7749
19050	33	74	12	8862	0	8981
19051	9134	20	9	158	0	9321
19052	183	12	8	9446	0	9649
19053	51	11	4	10111	0	10177
19054	10119	10	7	269	0	10405
19055	11419	10	4	84	0	11517
19056	325	10	11474	29	0	11838
19057	122	7	267	11602	0	11998
19058	58	18	11572	298	0	11946
19059	86	9	301	11548	0	11944
19060	34	11	11611	335	0	11991
19061	49	17	318	11567	0	11951
19062	11368	14	99	365	0	11846
19063	298	11269	56	127	0	11750
19064	93	11824	48	70	0	12035
19065	116	368	20	10731	0	11235
19066	50	11758	33	255	0	12096
19067	11688	347	20	115	0	12170
19068	11549	105	30	86	0	11770
19069	370	62	11295	59	0	11786
19070	124	11268	297	57	0	11746
19071	111	288	87	11424	0	11910
19072	51	97	11382	315	0	11845
19073	11263	48	326	108	0	11745
19074	348	62	84	11370	0	11864
19075	117	37	11474	322	0	11950
19076	82	42	322	11437	0	11883
19077	11409	22	95	384	0	11910
19078	325	43	11280	116	0	11764
19079	11206	28	313	99	0	11646
19080	11577	14	107	82	0	11780
19081	442	19	64	11231	0	11756
19082	138	36	11138	323	0	11635
19083	96	42	11020	112	0	11270
19084	10989	21	378	103	0	11491
19085	11421	18	120	98	0	11657
19086	412	23	11121	54	0	11610
19087	190	15	333	11079	0	11617
19088	151	15	120	11062	0	11348
19089	82	11083	80	372	0	11617
19090	99	305	73	11245	0	11722
19091	11232	74	65	394	0	11765
19092	387	37	45	11257	0	11726
19093	140	47	11080	382	0	11649
19094	10834	23	347	192	0	11396
19095	406	20	115	10989	0	11530
19096	134	24	10945	372	0	11475
19097	106	10719	352	132	0	11309
19098	10522	308	122	122	0	11074
19099	356	10715	82	106	0	11259
19100	10740	343	67	111	0	11261
19101	387	120	10593	99	0	11199
19102	159	10263	349	80	0	10851
19103	124	10763	108	86	0	11081
19104	136	399	79	10336	0	10950
19105	98	139	92	10670	0	10999
19106	105	85	10294	420	0	10904
19107	98	75	346	10425	0	10944
19108	10295	58	129	453	0	10935
19109	365	57	10088	183	0	10693
19110	167	53	380	10089	0	10689
19111	124	62	9967	415	0	10568
19112	9686	62	399	203	0	10350
19113	375	9918	166	139	0	10598
19114	9952	336	105	155	0	10548
19115	10259	136	108	130	0	10633
19116	10346	87	86	121	0	10640
19117	521	82	9670	97	0	10370
19118	237	9675	366	108	0	10386
19119	162	349	153	9706	0	10370
19120	157	113	110	10294	0	10674
19121	10460	99	117	473	0	11149
19122	475	82	96	10632	0	11285
19123	10693	56	95	530	0	11374
19124	10926	57	137	225	0	11345
19125	11020	59	86	189	0	11354
19126	11016	63	109	153	0	11341
19127	621	52	97	10472	0	11242
19128	10581	47	68	478	0	11174
19129	555	63	10080	202	0	10900
19130	10169	60	423	171	0	10823
19131	10600	49	165	139	0	10953
19132	623	61	9877	260	0	10821
19133	10228	61	415	118	0	10822
19134	10703	35	183	84	0	11005
19135	610	45	119	10243	0	11017
19136	307	44	105	10502	0	10958
19137	10097	205	110	530	0	10942
19138	552	46	87	10274	0	10959
19139	279	30	84	10313	0	10706
19140	204	9756	94	543	0	10597
19141	197	326	88	10013	0	10624
19142	9714	102	94	510	0	10420
19143	526	69	55	9680	0	10330
19144	251	51	77	9699	0	10078
19145	173	8874	97	535	0	9679
19146	208	342	59	8922	0	9531
19147	204	110	81	9050	0	9445
19148	8616	77	79	512	0	9284
19149	487	186	68	7382	0	8123
19150	173	32	6303	336	0	6844
19151	97	5749	227	180	0	6253
19152	85	5661	91	96	0	5933
19153	5079	215	64	94	0	5452
19154	200	5070	41	69	0	5380
19155	3784	94	60	54	0	3992
19156	112	3616	33	29	0	3790
19157	3608	99	39	29	0	3775
19158	127	44	5	3619	0	3795
19159	74	25	3	3699	0	3801
19160	37	3655	6	145	0	3843
19161	47	94	5	3738	0	3884
19162	27	50	3661	124	0	3862
19163	3536	21	91	78	0	3726
19164	107	3845	41	51	0	4044
19165	3859	94	17	43	0	4013
19166	3900	50	10	32	0	3992
19167	3998	24	10	27	0	4059
19168	179	18	11	3803	0	4011
19169	99	13	8	3834	0	3954
19170	54	3794	7	152	0	4007
19171	3819	112	6	82	0	4019
19172	120	3835	5	44	0	4004
19173	3899	123	2	41	0	4065
19174	139	61	3941	33	0	4174
19175	4134	24	102	42	0	4302
19176	154	19	50	4130	0	4353
19177	91	18	4099	138	0	4346
19178	46	25	4167	82	0	4320
19179	49	13	170	4160	0	4392
19180	36	14	4222	146	0	4418
19181	51	11	144	4178	0	4384
19182	4060	13	72	163	0	4308
19183	153	9	30	4131	0	4323
19184	90	15	4021	150	0	4276
19185	52	3909	123	94	0	4178
19186	45	4059	63	43	0	4210
19187	53	184	39	3934	0	4210
19188	3935	82	16	145	0	4178
19189	152	41	10	3991	0	4194
19190	110	19	14	4056	0	4199
19191	66	19	17	4130	0	4232
19192	53	18	16	4117	0	4204
19193	30	22	3949	219	0	4220
19194	34	16	3944	115	0	4109
19195	3922	14	175	63	0	4174
19196	4056	14	78	60	0	4208
19197	203	13	38	3962	0	4216
19198	112	17	30	4069	0	4228
19199	57	12	3924	200	0	4193
19200	42	3938	126	110	0	4216
19201	3916	120	74	66	0	4176
19202	4019	71	32	61	0	4183
19203	201	39	15	3967	0	4222
19204	100	31	3952	154	0	4237
19205	65	20	114	3929	0	4128
19206	44	3939	77	147	0	4207
19207	39	126	3954	94	0	4213
19208	3929	76	129	58	0	4192
19209	151	35	67	4015	0	4268
19210	4079	25	37	160	0	4301
19211	152	19	3893	101	0	4165
19212	3991	23	121	74	0	4209
19213	161	20	75	3963	0	4219
19214	4003	21	38	159	0	4221
19215	170	21	30	3947	0	4168
19216	109	3747	28	154	0	4038
19217	63	3930	31	92	0	4116
19218	64	184	34	3834	0	4116
19219	40	73	3730	141	0	3984
19220	37	3655	115	95	0	3902
19221	60	127	59	3152	0	3398
19222	3036	37	33	103	0	3209
19223	3084	12	15	77	0	3188
19224	119	15	20	3048	0	3202
19225	62	7	24	3044	0	3137
19226	41	2887	19	120	0	3067
19227	30	3063	19	69	0	3181
19228	3012	105	18	52	0	3187
19229	83	51	15	3029	0	3178
19230	62	24	11	3079	0	3176
19231	27	16	3010	136	0	3189
19232	30	16	74	3005	0	3125
19233	26	14	47	2997	0	3084
19234	33	13	23	3032	0	3101
19235	31	15	2913	129	0	3088
19236	28	14	75	2979	0	3096
19237	2944	10	48	120	0	3122
19238	79	17	2858	81	0	3035
19239	3054	16	87	58	0	3215
19240	90	12	54	3082	0	3238
19241	63	14	21	3191	0	3289
19242	40	10	21	3275	0	3346
19243	33	4	3145	140	0	3322
19244	3048	8	83	88	0	3227
19245	85	3211	57	61	0	3414
19246	3300	74	22	54	0	3450
19247	92	3352	19	42	0	3505
19248	63	92	19	3367	0	3541
19249	3371	50	14	112	0	3547
19250	95	18	3296	66	0	3475
19251	3265	21	86	49	0	3421
19252	100	15	3358	41	0	3514
19253	75	10	88	3325	0	3498
19254	34	11	3314	98	0	3457
19255	28	3231	91	73	0	3423
19256	55	84	48	3135	0	3322
19257	3019	40	32	112	0	3203
19258	87	17	20	2971	0	3095
19259	43	2903	24	79	0	3049
19260	26	62	14	2957	0	3059
19261	2888	34	19	79	0	3020
19262	2872	19	9	72	0	2972
19263	99	2796	16	40	0	2951
19264	46	2571	10	27	0	2654
19265	21	58	16	2510	0	2605
19266	30	43	12	2516	0	2601
19267	2476	14	5	79	0	2574
19268	2445	13	7	45	0	2510
19269	76	2451	10	14	0	2551
19270	35	59	3	2403	0	2500
19271	19	34	3	2453	0	2509
19272	22	6	2400	71	0	2499
19273	20	2366	43	35	0	2464
19274	18	2226	14	18	0	2276
19275	18	48	2	2040	0	2108
19276	3	14	2008	26	0	2051
19277	8	10	1961	15	0	1994
19278	11	8	27	1971	0	2017
19279	7	4	17	1983	0	2011
19280	5	10	1961	32	0	2008
19281	6	12	29	1966	0	2013
19282	5	4	1990	42	0	2041
19283	2058	2	34	19	0	2113
19284	35	2	18	2074	0	2129
19285	6	7	2158	43	0	2214
19286	6	5	2183	24	0	2218
19287	17	8	45	2365	0	2435
19288	8	6	2511	47	0	2572
19289	9	5	2526	18	0	2558
19290	13	2492	48	11	0	2564
19291	2579	38	15	24	0	2656
19292	38	12	2729	12	0	2791
19293	18	8	53	2700	0	2779
19294	22	5	16	2787	0	2830
19295	8	10	20	2844	0	2882
19296	6	10	2769	64	0	2849
19297	10	12	45	2748	0	2815
19298	2758	3	19	63	0	2843
19299	56	4	17	2728	0	2805
19300	16	7	2739	65	0	2827
19301	14	5	48	2745	0	2812
19302	2761	5	19	73	0	2858
19303	2824	5	19	34	0	2882
19304	2796	3	13	35	0	2847
19305	75	5	12	2766	0	2858
19306	2764	5	11	65	0	2845
19307	2771	4	12	29	0	2816
19308	2755	2	17	28	0	2802
19309	73	2660	11	22	0	2766
19310	2685	44	12	25	0	2766
19311	74	12	14	2664	0	2764
19312	31	12	2613	60	0	2716
19313	29	2622	44	32	0	2727
19314	2642	45	22	23	0	2732
19315	66	15	13	2643	0	2737
19316	27	19	9	2631	0	2686
19317	28	2567	13	63	0	2671
19318	14	2640	16	32	0	2702
19319	2513	57	18	33	0	2621
19320	51	2529	17	17	0	2614
19321	2450	52	14	18	0	2534
19322	56	2454	10	21	0	2541
19323	2401	54	6	22	0	2483
19324	50	2406	12	17	0	2485
19325	19	2483	9	18	0	2529
19326	2447	56	9	23	0	2535
19327	55	25	2402	22	0	2504
19328	28	2413	48	14	0	2503
19329	26	57	15	2414	0	2512
19330	22	18	14	2498	0	2552
19331	21	18	9	2426	0	2474
19332	21	15	11	2448	0	2495
19333	24	9	2402	65	0	2500
19334	2387	8	52	31	0	2478
19335	57	17	15	2441	0	2530
19336	2459	9	17	64	0	2549
19337	2579	6	12	41	0	2638
19338	2613	10	9	33	0	2665
19339	2506	11	11	28	0	2556
19340	84	9	2471	18	0	2582
19341	38	10	59	2466	0	2573
19342	25	12	2550	74	0	2661
19343	23	2559	69	38	0	2689
19344	34	63	40	2445	0	2582
19345	23	40	15	2536	0	2614
19346	24	7	12	2534	0	2577
19347	17	8	10	2477	0	2512
19348	13	7	2413	101	0	2534
19349	20	9	62	2455	0	2546
19350	17	14	35	2479	0	2545
19351	2467	6	20	98	0	2591
19352	2559	14	16	47	0	2636
19353	112	8	6	2547	0	2673
19354	52	10	17	2599	0	2678
19355	23	7	13	2642	0	2685
19356	2580	10	13	118	0	2721
19357	2653	13	11	60	0	2737
19358	2563	10	9	37	0	2619
19359	2633	12	10	46	0	2701
19360	109	2602	13	27	0	2751
19361	2655	66	5	43	0	2769
19362	2700	28	11	32	0	2771
19363	110	12	7	2633	0	2762
19364	61	7	6	2673	0	2747
19365	2576	7	9	118	0	2710
19366	94	2492	9	44	0	2639
19367	44	2631	7	40	0	2722
19368	2683	76	10	28	0	2797
19369	95	35	0	2688	0	2818
19370	62	17	5	2725	0	2809
19371	39	10	4	2786	0	2839
19372	33	14	8	2771	0	2826
19373	27	14	5	2749	0	2795
19374	26	2634	6	110	0	2776
19375	19	68	3	2678	0	2768
19376	2663	33	3	92	0	2791
19377	80	20	3	2687	0	2790
19378	47	11	6	2718	0	2782
19379	2652	8	4	117	0	2781
19380	75	2662	10	54	0	2801
19381	44	82	6	2622	0	2754
19382	30	2617	3	83	0	2733
19383	25	91	6	2538	0	2660
19384	19	47	2468	82	0	2616
19385	2341	15	47	58	0	2461
19386	62	2369	22	34	0	2487
19387	2183	46	10	32	0	2271
19388	53	27	2123	21	0	2224
19389	40	38	41	1932	0	2051
19390	23	1948	18	55	0	2044
19391	12	2009	4	36	0	2061
19392	1884	63	10	23	0	1980
19393	64	22	4	1910	0	2000
19394	27	10	1985	51	0	2073
19395	13	9	40	2027	0	2089
19396	9	9	2038	58	0	2114
19397	1964	2	42	38	0	2046
19398	47	3	2070	17	0	2137
19399	33	9	44	2055	0	2141
19400	15	2093	23	46	0	2177
19401	20	46	8	2120	0	2194
19402	13	2115	8	52	0	2188
19403	2172	39	5	37	0	2253
19404	55	29	5	2251	0	2340
19405	32	9	2269	61	0	2371
19406	17	10	2167	39	0	2233
19407	2248	12	60	29	0	2349
19408	2373	6	30	27	0	2436
19409	2383	7	12	24	0	2426
19410	2369	5	9	28	0	2411
19411	76	2325	9	19	0	2429
19412	2393	47	8	26	0	2474
19413	2397	26	7	28	0	2458
19414	81	9	2363	29	0	2482
19415	37	15	41	2377	0	2470
19416	2414	10	27	63	0	2514
19417	68	7	2366	46	0	2487
19418	42	11	45	2391	0	2489
19419	24	12	2458	59	0	2553
19420	33	7	46	2447	0	2533
19421	25	2514	25	59	0	2623
19422	2579	39	7	49	0	2674
19423	63	28	2488	21	0	2600
19424	2542	12	44	26	0	2624
19425	72	17	27	2575	0	2691
19426	2685	9	6	65	0	2765
19427	66	9	10	2671	0	2756
19428	2846	13	10	87	0	2956
19429	66	17	2785	42	0	2910
19430	2928	12	46	34	0	3020
19431	63	16	29	2989	0	3097
19432	41	13	6	3059	0	3119
19433	2998	7	17	89	0	3111
19434	61	9	6	3031	0	3107
19435	28	19	2956	66	0	3069
19436	33	10	39	2956	0	3038
19437	2837	6	26	57	0	2926
19438	43	2774	9	40	0	2866
19439	31	2763	10	20	0	2824
19440	2712	37	9	24	0	2782
19441	41	2879	3	18	0	2941
19442	33	22	15	2767	0	2837
19443	2786	9	7	40	0	2842
19444	2806	8	6	20	0	2840
19445	2783	5	4	17	0	2809
19446	32	9	2779	6	0	2826
19447	16	12	19	2761	0	2808
19448	6	2793	11	25	0	2835
19449	12	23	4	2827	0	2866
19450	7	10	2891	22	0	2930
19451	11	2771	15	10	0	2807
19452	15	31	10	2800	0	2856
19453	2762	7	1	22	0	2792
19454	16	2799	5	11	0	2831
19455	8	15	2975	5	0	3003
19456	9	8	20	2940	0	2977
19457	4	3	3007	20	0	3034
19458	8	3	18	2924	0	2953
19459	3066	1	10	29	0	3106
19460	20	4	2	3047	0	3073
19461	3050	1	6	23	0	3080
19462	3114	2	2	23	0	3141
19463	25	3208	10	5	0	3248
19464	3292	15	1	17	0	3325
19465	28	3277	3	2	0	3310
19466	14	27	3347	5	0	3393
19467	17	12	25	3306	0	3360
19468	8	3	12	3563	0	3586
19469	3	5	3495	39	0	3542
19470	9	3503	27	12	0	3551
19471	3603	26	9	15	0	3653
19472	3739	8	8	15	0	3770
19473	41	6	4	3827	0	3878
19474	23	3	2	3832	0	3860
19475	13	2	3	3910	0	3928
19476	3856	5	0	46	0	3907
19477	36	2	3739	14	0	3791
19478	16	6	3767	9	0	3798
19479	11	1	37	3862	0	3911
19480	7	3	3859	34	0	3903
19481	4	6	3818	18	0	3846
19482	17	1	39	3752	0	3809
19483	6	5	4000	30	0	4041
19484	9	3980	35	19	0	4043
19485	8	27	11	4048	0	4094
19486	6	10	4107	38	0	4161
19487	10	7	33	4049	0	4099
19488	5	3938	14	38	0	3995
19489	17	24	12	4079	0	4132
19490	5	11	4121	38	0	4175
19491	13	8	35	3990	0	4046
19492	4129	3	12	47	0	4191
19493	33	4	4123	17	0	4177
19494	3898	1	34	20	0	3953
19495	29	4092	15	11	0	4147
19496	4164	23	9	14	0	4210
19497	33	8	9	4165	0	4215
19498	11	4127	5	30	0	4173
19499	4304	28	4	32	0	4368
19500	40	11	5	4420	0	4476
19501	14	12	4442	40	0	4508
19502	9	4481	41	21	0	4552
19503	11	38	17	4558	0	4624
19504	4480	9	8	50	0	4547
19505	4441	6	6	25	0	4478
19506	56	6	7	4438	0	4507
19507	21	6	4421	49	0	4497
19508	4110	4	45	33	0	4192
19509	44	12	4403	16	0	4475
19510	29	6	51	4340	0	4426
19511	4445	10	15	61	0	4531
19512	48	4448	16	25	0	4537
19513	4520	39	9	32	0	4600
19514	52	16	4382	19	0	4469
19515	4478	6	50	26	0	4560
19516	61	8	25	4580	0	4674
19517	32	4	14	4658	0	4708
19518	21	7	4640	59	0	4727
19519	21	9	46	4527	0	4603
19520	4591	7	16	67	0	4681
19521	51	7	21	4568	0	4647
19522	34	4553	9	52	0	4648
19523	23	42	16	4635	0	4716
19524	24	4602	9	57	0	4692
19525	21	46	4516	29	0	4612
19526	4308	16	51	37	0	4412
19527	55	7	28	4569	0	4659
19528	23	11	4365	67	0	4466
19529	18	4297	56	29	0	4400
19530	16	48	18	4307	0	4389
19531	13	26	12	4338	0	4389
19532	4286	16	18	79	0	4399
19533	55	11	10	4370	0	4446
19534	4375	10	19	68	0	4472
19535	4384	6	16	48	0	4454
19536	65	4419	17	26	0	4527
19537	4560	55	15	37	0	4667
19538	72	24	12	5086	0	5194
19539	31	11	5079	83	0	5204
19540	5088	3	65	48	0	5204
19541	91	9	21	4978	0	5099
19542	39	10	4945	86	0	5080
19543	4833	15	66	40	0	4954
19544	94	14	22	4930	0	5060
19545	38	5022	21	79	0	5160
19546	36	65	16	4963	0	5080
19547	26	5020	18	85	0	5149
19548	4965	80	19	42	0	5106
19549	80	26	5050	28	0	5184
19550	27	4962	74	29	0	5092
19551	33	78	28	5015	0	5154
19552	35	26	5001	83	0	5145
19553	24	21	4802	37	0	4884
19554	22	4898	77	26	0	5023
19555	31	79	26	4743	0	4879
19556	21	24	23	4813	0	4881
19557	35	16	22	5363	0	5436
19558	5629	16	17	134	0	5796
19559	123	25	6253	32	0	6433
19560	31	6315	149	34	0	6529
19561	34	156	38	6435	0	6663
19562	33	38	30	6728	0	6829
19563	20	32	6510	184	0	6746
19564	41	16	148	6477	0	6682
19565	20	14	6396	198	0	6628
19566	20	9	6245	66	0	6340
19567	31	19	6266	40	0	6356
19568	32	21	182	5943	0	6178
19569	18	16	55	6187	0	6276
19570	28	10	42	6306	0	6386
19571	6098	11	27	221	0	6357
19572	141	6009	40	63	0	6253
19573	6166	136	41	67	0	6410
19574	6055	37	63	67	0	6222
19575	6326	19	25	56	0	6426
19576	181	6254	24	39	0	6498
19577	6296	141	32	45	0	6514
19578	6397	42	13	40	0	6492
19579	198	30	16	6251	0	6495
19580	96	21	20	6361	0	6498
19581	72	19	16	6502	0	6609
19582	52	17	6325	206	0	6600
19583	6180	22	147	85	0	6434
19584	187	13	39	6327	0	6566
19585	6252	22	32	195	0	6501
19586	181	6229	40	68	0	6518
19587	76	141	26	6275	0	6518
19588	73	31	23	6452	0	6579
19589	6291	21	33	222	0	6567
19590	186	24	27	6317	0	6554
19591	5943	26	26	240	0	6235
19592	6348	26	18	89	0	6481
19593	209	6051	24	83	0	6367
19594	66	6230	19	64	0	6379
19595	73	199	15	6054	0	6341
19596	57	6125	26	169	0	6377
19597	55	187	26	6141	0	6409
19598	53	57	6063	190	0	6363
19599	40	40	5882	74	0	6036
19600	5710	36	152	57	0	5955
19601	5815	26	52	60	0	5953
19602	175	5726	34	53	0	5988
19603	5709	136	27	52	0	5924
19604	170	5847	27	47	0	6091
19605	64	155	27	5905	0	6151
19606	65	41	28	5997	0	6131
19607	51	45	28	6010	0	6134
19608	37	42	24	6045	0	6148
19609	5857	27	26	237	0	6147
19610	148	5889	27	105	0	6169
19611	5861	151	33	95	0	6140
19612	6029	43	36	76	0	6184
19613	190	36	5851	52	0	6129
19614	5792	31	152	62	0	6037
19615	207	5718	39	50	0	6014
19616	85	157	36	5776	0	6054
19617	76	54	30	5780	0	5940
19618	57	5678	22	177	0	5934
19619	5763	173	26	83	0	6045
19620	170	58	5680	78	0	5986
19621	5672	45	142	92	0	5951
19622	200	31	5744	81	0	6056
19623	95	24	168	5779	0	6066
19624	83	37	59	5944	0	6123
19625	86	35	55	5984	0	6160
19626	5940	41	52	241	0	6274
19627	185	36	5964	123	0	6308
19628	5953	33	168	137	0	6291
19629	6149	39	62	116	0	6366
19630	6162	27	70	98	0	6357
19631	6174	22	69	95	0	6360
19632	231	26	66	6037	0	6360
19633	115	36	5962	195	0	6308
19634	99	46	167	5946	0	6258
19635	87	21	5932	230	0	6270
19636	87	30	5837	105	0	6059
19637	92	5719	174	98	0	6083
19638	96	139	75	5124	0	5434
19639	78	54	41	5309	0	5482
19640	122	53	27	4795	0	4997
19641	99	41	23	5233	0	5396
19642	5238	35	24	188	0	5485
19643	5326	31	23	88	0	5468
19644	221	25	15	5183	0	5444
19645	105	21	5076	189	0	5391
19646	93	14	125	5180	0	5412
19647	67	24	43	5337	0	5471
19648	51	16	5195	222	0	5484
19649	69	12	128	5174	0	5383
19650	5206	20	48	213	0	5487
19651	5284	26	42	100	0	5452
19652	5369	38	32	79	0	5518
19653	192	25	14	5289	0	5520
19654	5271	24	20	193	0	5508
19655	5298	27	20	102	0	5447
19656	197	23	5198	101	0	5519
19657	106	15	4487	59	0	4667
19658	75	12	4386	49	0	4522
19659	3648	10	58	23	0	3739
19660	44	3665	23	23	0	3755
19661	3541	26	23	24	0	3614
19662	34	3797	18	19	0	3868
19663	16	25	9	3838	0	3888
19664	18	9	10	3867	0	3904
19665	21	4	6	3883	0	3914
19666	22	3	3842	43	0	3910
19667	3670	5	32	27	0	3734
19668	51	2	9	3870	0	3932
19669	22	5	3874	33	0	3934
19670	21	6	3679	15	0	3721
19671	3753	4	43	18	0	3818
19672	36	3934	21	10	0	4001
19673	3849	28	18	15	0	3910
19674	3858	9	10	9	0	3886
19675	39	3843	6	14	0	3902
19676	3860	35	5	10	0	3910
19677	39	11	3939	15	0	4004
19678	17	9	3849	13	0	3888
19679	12	8	4007	23	0	4050
19680	21	25	43	3980	0	4069
19681	12	3	4035	31	0	4081
19682	3899	2	34	19	0	3954
19683	3975	1	13	16	0	4005
19684	37	2	4066	7	0	4112
19685	23	1	30	4030	0	4084
19686	4154	10	8	32	0	4204
19687	36	4371	12	7	0	4426
19688	16	4483	4	7	0	4510
19689	4494	37	6	13	0	4550
19690	40	7	4543	3	0	4593
19691	21	18	27	4381	0	4447
19692	11	2	11	4461	0	4485
19693	3	1	9	4518	0	4531
19694	1	4447	1	31	0	4480
19695	24	21	5	4208	0	4258
19696	4851	5	1	37	0	4894
19697	39	2	4	5068	0	5113
19698	9	5191	7	37	0	5244
19699	5428	35	1	24	0	5488
19700	48	5	3	5461	0	5517
19701	10	16	2	5606	0	5634
19702	5659	9	2	56	0	5726
19703	5651	6	2	28	0	5687
19704	53	4	5	5690	0	5752
19705	5872	2	3	64	0	5941
19706	5932	1	2	34	0	5969
19707	68	6027	4	20	0	6119
19708	6130	57	1	19	0	6207
19709	75	6078	3	11	0	6167
19710	26	65	1	6161	0	6253
19711	24	18	6288	62	0	6392
19712	26	24	53	6190	0	6293
19713	22	12	12	6268	0	6314
19714	15	9	16	6407	0	6447
19715	6350	3	9	99	0	6461
19716	69	6331	6	40	0	6446
19717	6625	58	3	49	0	6735
19718	86	6844	5	20	0	6955
19719	7074	87	4	22	0	7187
19720	7141	24	4	15	0	7184
19721	7165	30	5	24	0	7224
19722	7133	10	5	16	0	7164
19723	112	19	7056	14	0	7201
19724	64	9	75	7067	0	7215
19725	54	8	21	7422	0	7505
19726	35	9	7353	110	0	7507
19727	7179	11	99	49	0	7338
19728	113	3	20	7448	0	7584
19729	33	13	7348	114	0	7508
19730	37	17	7284	34	0	7372
19731	50	4	112	7567	0	7733
19732	25	14	7756	114	0	7909
19733	43	5	126	7637	0	7811
19734	34	8	34	7727	0	7803
19735	25	11	7645	138	0	7819
19736	7366	9	116	65	0	7556
19737	121	4	35	7681	0	7841
19738	39	6	7792	127	0	7964
19739	41	10	115	7796	0	7962
19740	7843	1	35	146	0	8025
19741	117	7	7763	44	0	7931
19742	7578	5	117	63	0	7763
19743	7977	6	43	39	0	8065
19744	140	3	41	7925	0	8109
19745	61	3	30	7865	0	7959
19746	56	3	7785	131	0	7975
19747	46	6	112	7806	0	7970
19748	57	8	46	7167	0	7278
19749	32	5	42	7878	0	7957
19750	36	9	7664	167	0	7876
19751	7519	3	116	90	0	7728
19752	7801	7	47	72	0	7927
19753	7934	3	35	73	0	8045
19754	8138	7	22	67	0	8234
19755	164	4	33	8122	0	8323
19756	8031	10	29	147	0	8217
19757	8079	7	26	65	0	8177
19758	6725	34	52	134	0	6945
19759	8027	8	21	75	0	8131
19760	159	7889	28	53	0	8129
19761	8027	93	30	62	0	8212
19762	7905	17	23	62	0	8007
19763	164	7817	18	59	0	8058
19764	7886	113	32	57	0	8088
19765	193	27	17	7903	0	8140
19766	91	36	14	7976	0	8117
19767	7915	23	21	151	0	8110
19768	174	7715	22	71	0	7982
19769	78	7796	27	65	0	7966
19770	81	136	20	7895	0	8132
19771	59	41	7867	149	0	8116
19772	68	35	121	7685	0	7909
19773	60	17	34	7900	0	8011
19774	7723	19	34	180	0	7956
19775	7717	19	28	87	0	7851
19776	163	16	24	7699	0	7902
19777	79	17	7573	155	0	7824
19778	83	10	127	7640	0	7860
19779	7675	15	36	192	0	7918
19780	160	17	7980	73	0	8230
19781	65	8060	160	67	0	8352
19782	8330	130	41	70	0	8571
19783	196	27	41	8324	0	8588
19784	74	28	37	8323	0	8462
19785	83	16	27	8432	0	8558
19786	62	25	8076	215	0	8378
19787	7406	19	166	114	0	7705
19788	193	21	7750	75	0	8039
19789	81	7631	172	66	0	7950
19790	74	127	51	7781	0	8033
19791	64	31	60	7908	0	8063
19792	67	48	36	8119	0	8270
19793	61	18	7972	235	0	8286
19794	54	19	7861	123	0	8057
19795	35	29	8145	107	0	8316
19796	41	8102	233	80	0	8456
19797	54	194	110	8076	0	8434
19798	8234	41	46	244	0	8565
19799	9000	27	42	109	0	9178
19800	294	22	9424	66	0	9806
19801	125	9524	265	64	0	9978
19802	84	266	9568	60	0	9978
19803	62	9803	305	65	0	10235
19804	9518	353	133	104	0	10108
19805	9638	104	68	69	0	9879
19806	339	9461	69	50	0	9919
19807	9444	291	67	51	0	9853
19808	356	114	47	9305	0	9822
19809	165	74	54	9508	0	9801
19810	9370	66	34	340	0	9810
19811	9241	47	23	154	0	9465
19812	9273	38	32	120	0	9463
19813	405	8877	26	87	0	9395
19814	185	9258	38	78	0	9559
19815	9187	314	35	78	0	9614
19816	355	121	9016	66	0	9558
19817	197	112	258	8682	0	9249
19818	8528	64	73	282	0	8947
19819	326	8183	70	104	0	8683
19820	144	8622	40	74	0	8880
19821	8525	334	44	63	0	8966
19822	317	131	8235	41	0	8724
19823	8093	110	251	69	0	8523
19824	338	73	8035	45	0	8491
19825	151	69	7965	29	0	8214
19826	129	77	289	7712	0	8207
19827	97	56	7921	236	0	8310
19828	7675	45	275	99	0	8094
19829	7937	25	132	70	0	8164
19830	8019	33	94	50	0	8196
19831	7953	20	76	51	0	8100
19832	371	32	62	7506	0	7971
19833	7604	36	54	255	0	7949
19834	336	7481	53	85	0	7955
19835	198	223	39	7302	0	7762
19836	140	7570	38	238	0	7986
19837	7808	254	35	102	0	8199
19838	7816	93	29	83	0	8021
19839	342	76	39	7620	0	8077
19840	7728	55	34	271	0	8088
19841	7833	71	34	120	0	8058
19842	363	59	32	7588	0	8042
19843	209	49	28	7685	0	7971
19844	153	40	29	7825	0	8047
19845	138	27	7442	344	0	7951
19846	106	31	7331	177	0	7645
19847	117	33	7526	117	0	7793
19848	106	32	300	7515	0	7953
19849	78	37	7697	292	0	8104
19850	103	28	279	7631	0	8041
19851	75	32	8080	303	0	8490
19852	81	21	7970	137	0	8209
19853	7613	26	334	132	0	8105
19854	254	7615	178	84	0	8131
19855	7834	218	116	102	0	8270
19856	295	84	94	7739	0	8212
19857	136	54	79	7913	0	8182
19858	119	51	7741	305	0	8216
19859	92	7725	257	148	0	8222
19860	104	226	116	7850	0	8296
19861	78	102	7824	278	0	8282
19862	71	7638	252	142	0	8103
19863	72	238	116	7685	0	8111
19864	7568	107	98	269	0	8042
19865	7705	72	76	133	0	7986
19866	298	67	70	7619	0	8054
19867	7618	60	55	274	0	8007
19868	294	7558	57	132	0	8041
19869	163	233	42	7729	0	8167
19870	135	87	7686	275	0	8183
19871	106	77	215	7775	0	8173
19872	110	54	7726	287	0	8177
19873	7646	64	254	140	0	8104
19874	271	57	105	7775	0	8208
19875	139	7851	85	256	0	8331
19876	123	237	68	8221	0	8649
19877	96	88	8131	311	0	8626
19878	99	66	8082	140	0	8387
19879	88	51	8040	118	0	8297
19880	7421	85	335	98	0	7939
19881	227	7510	138	63	0	7938
19882	102	204	100	7402	0	7808
19883	7393	70	75	243	0	7781
19884	210	7467	88	110	0	7875
19885	7765	200	79	100	0	8144
19886	7947	90	68	63	0	8168
19887	8013	58	68	69	0	8208
19888	8140	44	42	61	0	8287
19889	323	55	7730	45	0	8153
19890	7668	37	197	60	0	7962
19891	296	34	7546	43	0	7919
19892	7278	28	202	40	0	7548
19893	292	42	86	7443	0	7863
19894	157	23	7307	166	0	7653
19895	111	7025	167	70	0	7373
19896	145	615	104	6344	0	7208
19897	73	6774	64	103	0	7014
19898	57	6727	49	80	0	6913
19899	5635	103	70	62	0	5870
19900	80	20	5236	13	0	5349
19901	20	5005	48	12	0	5085
19902	4933	40	30	22	0	5025
19903	31	4991	13	20	0	5055
19904	5061	21	5	14	0	5101
19905	33	11	6	5041	0	5091
19906	5079	8	6	27	0	5120
19907	36	2	4	5040	0	5082
19908	5103	8	10	24	0	5145
19909	31	4	4	5114	0	5153
19910	21	5301	4	48	0	5374
19911	10	21	10	5452	0	5493
19912	5434	12	5	36	0	5487
19913	22	5398	6	15	0	5441
19914	14	29	6	5479	0	5528
19915	5548	16	4	40	0	5608
19916	28	6	6	5596	0	5636
19917	19	3	10	5538	0	5570
19918	9	13	5613	31	0	5666
19919	15	7	5410	17	0	5449
19920	14	11	33	5438	0	5496
19921	14	11	5828	22	0	5875
19922	13	3	25	5781	0	5822
19923	33	18	18	5194	0	5263
19924	10	7	7	5817	0	5841
19925	10	11	5855	37	0	5913
19926	25	7	27	5579	0	5638
19927	11	8	11	5811	0	5841
19928	11	5851	6	33	0	5901
19929	17	20	4	5920	0	5961
19930	5879	14	4	34	0	5931
19931	31	6	6	5924	0	5967
19932	25	8	6581	31	0	6645
19933	6379	6	59	36	0	6480
19934	62	7151	32	17	0	7262
19935	55	72	23	7342	0	7492
19936	23	34	7320	84	0	7461
19937	6892	21	79	66	0	7058
19938	83	7340	50	33	0	7506
19939	7440	80	23	38	0	7581
19940	97	50	19	7433	0	7599
19941	7452	23	21	101	0	7597
19942	107	19	7531	47	0	7704
19943	62	7444	81	34	0	7621
19944	34	8007	42	33	0	8116
19945	8086	114	31	40	0	8271
19946	8073	52	12	47	0	8184
19947	124	36	8058	17	0	8235
19948	7877	26	81	30	0	8014
19949	8150	22	42	27	0	8241
19950	8227	18	25	39	0	8309
19951	153	7773	22	14	0	7962
19952	87	7922	20	17	0	8046
19953	7980	110	15	27	0	8132
19954	8051	54	12	16	0	8133
19955	139	8104	10	16	0	8269
19956	82	88	8	8210	0	8388
19957	47	54	8257	77	0	8435
19958	8116	41	84	67	0	8308
19959	7827	44	55	82	0	8008
19960	8669	17	27	46	0	8759
19961	137	8550	19	14	0	8720
19962	67	82	8576	21	0	8746
19963	8769	45	86	24	0	8924
19964	112	27	48	8867	0	9054
19965	89	19	26	8846	0	8980
19966	57	19	13	9123	0	9212
19967	30	21	9027	124	0	9202
19968	47	11	81	8780	0	8919
19969	31	12	8970	111	0	9124
19970	21	8766	90	72	0	8949
19971	8664	81	48	59	0	8852
19972	76	8693	44	32	0	8845
19973	55	8881	27	18	0	8981
19974	8936	111	15	38	0	9100
19975	80	8962	22	11	0	9075
19976	52	101	3	8801	0	8957
19977	46	8649	13	73	0	8781
19978	8704	98	5	47	0	8854
19979	73	8706	11	29	0	8819
19980	55	97	4	8875	0	9031
19981	29	68	8800	83	0	8980
19982	30	38	83	8892	0	9043
19983	18	8897	38	121	0	9074
19984	27	90	27	9003	0	9147
19985	11	55	24	8796	0	8886
19986	41	30	12	8485	0	8568
19987	29	28	19	8951	0	9027
19988	21	22	4	9031	0	9078
19989	26	21	13	9092	0	9152
19990	26	11	9028	181	0	9246
19991	8828	15	102	128	0	9073
19992	130	14	52	9818	0	10014
19993	67	10	9792	179	0	10048
19994	50	21	9742	106	0	9919
19995	42	14	206	10012	0	10274
19996	10168	12	123	199	0	10502
19997	161	18	9938	96	0	10213
19998	9784	16	178	110	0	10088
19999	195	20	10391	56	0	10662
20000	134	19	208	10367	0	10728
20001	102	18	107	10706	0	10933
20002	82	22	10530	218	0	10852
20003	9977	20	210	149	0	10356
20004	201	15	86	10416	0	10718
20005	99	26	10477	198	0	10800
20006	90	18	10474	115	0	10697
20007	89	19	236	10160	0	10504
20008	49	10489	157	179	0	10874
20009	10630	153	106	126	0	11015
20010	10466	81	76	111	0	10734
20011	256	67	10547	57	0	10927
20012	169	49	197	10259	0	10674
20013	10607	27	94	219	0	10947
20014	228	38	10479	109	0	10854
20015	10203	10	214	111	0	10538
20016	252	10146	110	88	0	10596
20017	134	158	97	10615	0	11004
20018	110	80	79	10734	0	11003
20019	10982	50	49	278	0	11359
20020	211	55	62	11022	0	11350
20021	140	32	47	10862	0	11081
20022	99	33	39	11034	0	11205
20023	10732	19	35	367	0	11153
20024	217	18	10625	207	0	11067
20025	10553	19	185	164	0	10921
20026	10706	22	103	139	0	10970
20027	10938	17	91	101	0	11147
20028	353	37	68	10645	0	11103
20029	210	24	10801	218	0	11253
20030	142	10449	220	130	0	10941
20031	115	10671	102	116	0	11004
20032	73	10408	71	92	0	10644
20033	75	223	10315	60	0	10673
20034	75	176	185	11501	0	11937
20035	11894	62	81	289	0	12326
20036	13245	49	54	163	0	13511
20037	413	22	45	13809	0	14289
20038	222	28	13665	362	0	14277
20039	159	22	13740	155	0	14076
20040	120	15	385	13786	0	14306
20041	66	22	14008	374	0	14470
20042	80	16	426	13870	0	14392
20043	94	25	175	13684	0	13978
20044	40	13675	146	464	0	14325
20045	87	297	97	14075	0	14556
20046	73	109	57	14554	0	14793
20047	14120	96	61	549	0	14826
20048	396	57	61	14286	0	14800
20049	182	25	60	14496	0	14763
20050	13946	34	78	573	0	14631
20051	392	13846	78	311	0	14627
20052	13972	320	79	262	0	14633
20053	457	123	13715	159	0	14454
20054	13719	100	370	161	0	14350
20055	13792	74	214	163	0	14243
20056	535	46	13403	131	0	14115
20057	265	51	13319	134	0	13769
20058	259	65	487	12783	0	13594
20059	12968	30	253	460	0	13711
20060	440	40	12844	224	0	13548
20061	247	32	448	12778	0	13505
20062	178	40	12841	484	0	13543
20063	192	29	468	12731	0	13420
20064	158	33	224	13097	0	13512
20065	12798	28	177	610	0	13613
20066	12696	33	166	337	0	13232
20067	13184	32	108	271	0	13595
20068	575	38	12957	207	0	13777
20069	317	44	13015	155	0	13531
20070	270	29	505	12844	0	13648
20071	193	29	277	13121	0	13620
20072	182	36	208	13342	0	13768
20073	12668	32	150	642	0	13492
20074	425	12580	140	358	0	13503
20075	12478	331	135	302	0	13246
20076	12536	130	103	243	0	13012
20077	561	12323	105	183	0	13172
20078	330	12789	116	178	0	13413
20079	12605	413	105	168	0	13291
20080	488	199	108	12301	0	13096
20081	258	12293	94	523	0	13168
20082	310	365	86	12468	0	13229
20083	281	165	12176	562	0	13184
20084	228	130	394	12410	0	13162
20085	12271	95	265	602	0	13233
20086	476	69	12140	358	0	13043
20087	278	75	12179	298	0	12830
20088	246	294	579	11286	0	12405
20089	193	11367	328	547	0	12435
20090	172	11583	229	349	0	12333
20091	151	11994	136	324	0	12605
20092	11332	447	123	350	0	12252
20093	11374	190	101	305	0	11970
20094	11039	133	93	282	0	11547
20095	507	10919	98	293	0	11817
20096	11139	283	99	294	0	11815
20097	11086	150	103	250	0	11589
20098	541	176	10754	176	0	11647
20099	367	10386	366	161	0	11280
20100	289	339	251	10500	0	11379
20101	10509	171	217	388	0	11285
20102	499	131	10363	232	0	11225
20103	303	85	419	10207	0	11014
20104	253	10244	266	444	0	11207
20105	216	298	208	10366	0	11088
20106	229	139	169	10443	0	10980
20107	10256	118	184	570	0	11128
20108	10396	94	161	395	0	11046
20109	493	86	174	10322	0	11075
20110	275	113	10077	534	0	10999
20111	271	112	10005	353	0	10741
20112	10156	81	404	302	0	10943
20113	563	101	10220	189	0	11073
20114	400	85	413	9426	0	10324
20115	329	9705	276	347	0	10657
20116	9845	290	281	219	0	10635
20117	421	9770	223	264	0	10678
20118	9937	341	166	297	0	10741
20119	487	122	163	9923	0	10695
20120	302	142	130	10104	0	10678
20121	9905	151	128	503	0	10687
20122	10101	113	138	287	0	10639
20123	560	130	125	9875	0	10690
20124	385	163	111	9976	0	10635
20125	323	174	9562	426	0	10485
20126	277	143	9491	283	0	10194
20127	9404	130	393	273	0	10200
20128	431	161	9119	243	0	9954
20129	9287	109	389	266	0	10051
20130	9514	90	240	262	0	10106
20131	480	93	9088	260	0	9921
20132	346	8686	343	223	0	9598
20133	307	8879	249	176	0	9611
20134	167	174	7247	102	0	7690
20135	329	619	359	5928	0	7235
20136	5349	74	183	290	0	5896
20137	5129	25	34	48	0	5236
20138	5648	23	25	50	0	5746
20139	6781	14	27	44	0	6866
20140	7018	19	18	49	0	7104
20141	201	7235	25	31	0	7492
20142	7106	160	22	40	0	7328
20143	204	7009	29	22	0	7264
20144	6900	161	40	36	0	7137
20145	199	45	6640	9	0	6893
20146	104	33	140	6448	0	6725
20147	95	22	37	6325	0	6479
20148	45	6432	25	157	0	6659
20149	6440	149	11	48	0	6648
20150	6577	69	10	29	0	6685
20151	251	44	9	6355	0	6659
20152	114	25	32	6492	0	6663
20153	6430	23	14	212	0	6679
20154	194	31	15	6423	0	6663
20155	77	39	14	6552	0	6682
20156	6428	31	8	206	0	6673
20157	234	19	3	6407	0	6663
20158	6408	16	23	218	0	6665
20159	6474	9	8	118	0	6609
20160	232	8	6277	77	0	6594
20161	6335	20	135	94	0	6584
20162	6343	9	22	79	0	6453
20163	6339	10	19	50	0	6418
20164	213	8	5968	79	0	6268
20165	127	10	132	5931	0	6200
20166	131	8	29	6082	0	6250
20167	71	11	5886	189	0	6157
20168	5803	6	153	75	0	6037
20169	252	8	40	5750	0	6050
20170	106	6	5678	181	0	5971
20171	99	13	5822	49	0	5983
20172	100	11	173	5809	0	6093
20173	53	15	5867	200	0	6135
20174	66	10	208	5816	0	6100
20175	95	7	49	5965	0	6116
20176	55	15	5725	233	0	6028
20177	62	9	201	5566	0	5838
20178	44	5414	84	200	0	5742
20179	33	5763	54	119	0	5969
20180	5630	161	83	64	0	5938
20181	5706	42	41	99	0	5888
20182	192	5584	37	99	0	5912
20183	5619	154	68	71	0	5912
20184	5727	32	40	87	0	5886
20185	214	56	35	5615	0	5920
20186	93	53	40	5764	0	5950
20187	5568	40	13	235	0	5856
20188	223	5399	18	89	0	5729
20189	88	5600	42	52	0	5782
20190	123	182	15	5542	0	5862
20191	108	75	5439	185	0	5807
20192	5276	59	159	95	0	5589
20193	5461	26	37	100	0	5624
20194	5333	25	32	78	0	5468
20195	230	5246	32	60	0	5568
20196	130	194	24	5183	0	5531
20197	103	54	28	5416	0	5601
20198	5190	52	46	248	0	5536
20199	242	5166	29	112	0	5549
20200	143	166	39	5148	0	5496
20201	133	67	29	5299	0	5528
20202	120	83	24	5269	0	5496
20203	5114	41	19	283	0	5457
20204	236	5082	39	129	0	5486
20205	154	208	14	4952	0	5328
20206	106	5180	28	210	0	5524
20207	5151	195	33	126	0	5505
20208	235	83	5035	119	0	5472
20209	5023	54	158	159	0	5394
20210	250	44	4902	122	0	5318
20211	120	119	172	4644	0	5055
20212	4659	39	42	252	0	4992
20213	222	68	4539	96	0	4925
20214	4628	30	158	103	0	4919
20215	4770	25	75	114	0	4984
20216	4828	19	43	87	0	4977
20217	244	20	74	4578	0	4916
20218	123	16	47	4684	0	4870
20219	127	27	43	4720	0	4917
20220	4517	14	63	251	0	4845
20221	245	4523	47	116	0	4931
20222	4636	137	49	71	0	4893
20223	4816	30	45	73	0	4964
20224	251	26	4579	76	0	4932
20225	4665	23	154	80	0	4922
20226	4848	24	58	102	0	5032
20227	257	16	49	4690	0	5012
20228	101	55	47	4770	0	4973
20229	123	26	36	4791	0	4976
20230	4655	33	41	222	0	4951
20231	4640	24	69	106	0	4839
20232	4520	21	41	95	0	4677
20233	226	4176	55	77	0	4534
20234	78	3926	53	81	0	4138
20235	71	4002	40	86	0	4199
20236	3945	135	58	89	0	4227
20237	156	36	3861	83	0	4136
20238	84	43	3204	70	0	3401
20239	1984	36	82	27	0	2129
20240	66	6	2044	15	0	2131
20241	7	3	15	1503	0	1528
20242	3	1532	7	16	0	1558
20243	1651	14	3	9	0	1677
20244	1661	4	2	7	0	1674
20245	1673	3	1	0	0	1677
20246	23	2	1	1829	0	1855
20247	8	2	1874	16	0	1900
20248	6	2	1791	5	0	1804
20249	1854	1	11	6	0	1872
20250	1909	1	3	4	0	1917
20251	1874	1	8	4	0	1887
20252	19	0	1	1910	0	1930
20253	5	2	2	1899	0	1908
20254	6	1	1910	14	0	1931
20255	1960	0	15	11	0	1986
20256	17	1	2	2038	0	2058
20257	5	0	2	2038	0	2045
20258	2	2	1	2052	0	2057
20259	4	2037	0	14	0	2055
20260	4	13	3	2063	0	2083
20261	7	3	1	2069	0	2080
20262	2054	1	7	19	0	2081
20263	19	2	2043	5	0	2069
20264	2002	0	15	7	0	2024
20265	2099	1	3	5	0	2108
20266	18	2	2	2100	0	2122
20267	7	0	3	2111	0	2121
20268	2100	1	0	18	0	2119
20269	20	2	2033	4	0	2059
20270	7	2067	13	6	0	2093
20271	4	11	4	2087	0	2106
20272	2082	2	3	17	0	2104
20273	16	2	1	2075	0	2094
20274	10	5	2051	13	0	2079
20275	3	3	2106	4	0	2116
20276	2192	1	11	14	0	2218
20277	15	1	4	2306	0	2326
20278	7	0	2299	9	0	2315
20279	2326	0	8	11	0	2345
20280	2543	1	3	16	0	2563
20281	11	1	2	2578	0	2592
20282	6	2	1	2578	0	2587
20283	3	2567	1	12	0	2583
20284	2703	8	2	10	0	2723
20285	14	2	1	2746	0	2763
20286	5	1	1	2772	0	2779
20287	3	2	2797	9	0	2811
20288	2625	1	7	6	0	2639
20289	2779	2	1	7	0	2789
20290	10	2737	2	6	0	2755
20291	5	6	2689	3	0	2703
20292	5	1	2655	1	0	2662
20293	4	9	12	2662	0	2687
20294	2824	2	3	11	0	2840
20295	7	1	2	2842	0	2852
20296	2962	2	0	17	0	2981
20297	2963	1	1	8	0	2973
20298	2974	1	2	13	0	2990
20299	11	1	1	3006	0	3019
20300	7	0	1	3003	0	3011
20301	3098	0	1	12	0	3111
20302	8	2	3126	2	0	3138
20303	2918	2	5	10	0	2935
20304	2989	0	0	6	0	2995
20305	6	1	3070	0	0	3077
20306	3	1	2983	2	0	2989
20307	2	3015	6	1	0	3024
20308	3	5	0	3091	0	3099
20309	2981	5	2	11	0	2999
20310	8	2	0	3083	0	3093
20311	0	1	3134	6	0	3141
20312	3	3070	5	1	0	3079
20313	8	3091	1	4	0	3104
20314	3	5	2	3147	0	3157
20315	4	2	1	3072	0	3079
20316	2	3027	0	6	0	3035
20317	1	5	2993	2	0	3001
20318	2876	1	6	9	0	2892
20319	3070	1	1	6	0	3078
20320	7	3069	4	0	0	3080
20321	3041	6	0	7	0	3054
20322	10	1	2	3001	0	3014
20323	2971	3	1	13	0	2988
20324	11	1	1	2928	0	2941
20325	2	2977	2	11	0	2992
20326	3	6	2959	2	0	2970
20327	3	2	6	3107	0	3118
20328	15	4	4	2946	0	2969
20329	5	1	1	3234	0	3241
20330	3279	2	0	26	0	3307
20331	21	1	1	3282	0	3305
20332	6	3	3522	23	0	3554
20333	4	6	3603	9	0	3622
20334	3768	0	42	13	0	3823
20335	44	3	3859	2	0	3908
20336	3866	0	41	5	0	3912
20337	49	1	9	4280	0	4339
20338	20	0	3	4398	0	4421
20339	16	3	6	4796	0	4821
20340	18	0	4	4796	0	4818
20341	4791	0	3	101	0	4895
20342	77	8	4793	31	0	4909
20343	31	1	79	4697	0	4808
20344	11	4878	22	78	0	4989
20345	4887	75	13	33	0	5008
20346	91	19	6	4735	0	4851
20347	4707	8	5	96	0	4816
20348	90	5	4680	36	0	4811
20349	39	5	77	4542	0	4663
20350	15	4661	21	86	0	4783
20351	4706	72	10	35	0	4823
20352	91	16	4696	21	0	4824
20353	37	12	88	4611	0	4748
20354	26	7	23	4719	0	4775
20355	4599	8	20	107	0	4734
20356	98	6	4563	38	0	4705
20357	29	9	4566	26	0	4630
20358	30	1	109	4531	0	4671
20359	10	6	4579	103	0	4698
20360	24	7	4580	37	0	4648
20361	29	8	117	4485	0	4639
20362	25	2	40	4558	0	4625
20363	12	10	28	4727	0	4777
20364	4631	1	17	130	0	4779
20365	93	4677	26	49	0	4845
20366	4732	80	15	42	0	4869
20367	105	18	20	4739	0	4882
20368	35	4746	19	116	0	4916
20369	34	90	17	4889	0	5030
20370	4946	26	21	125	0	5118
20371	109	5196	17	54	0	5376
20372	48	102	16	5378	0	5544
20373	29	32	5337	145	0	5543
20374	5291	21	112	62	0	5486
20375	130	14	43	5247	0	5434
20376	50	20	19	5331	0	5420
20377	39	17	5130	163	0	5349
20378	31	19	5106	71	0	5227
20379	4975	13	151	54	0	5193
20380	137	4883	53	40	0	5113
20381	64	123	31	4925	0	5143
20382	4937	38	30	157	0	5162
20383	145	32	4903	56	0	5136
20384	61	4802	133	55	0	5051
20385	48	119	47	4824	0	5038
20386	4801	39	31	176	0	5047
20387	4684	19	35	82	0	4820
20388	4838	16	43	66	0	4963
20389	170	4658	42	59	0	4929
20390	68	130	4674	48	0	4920
20391	55	39	136	4729	0	4959
20392	71	26	65	4467	0	4629
20393	49	22	47	4827	0	4945
20394	40	15	35	4777	0	4867
20395	4615	27	34	209	0	4885
20396	4621	14	38	102	0	4775
20397	186	17	4444	66	0	4713
20398	76	30	4434	67	0	4607
20399	4351	28	162	61	0	4602
20400	4467	24	63	70	0	4624
20401	198	27	34	4272	0	4531
20402	81	4309	34	167	0	4591
20403	4316	133	43	83	0	4575
20404	143	4204	30	87	0	4464
20405	78	4289	34	72	0	4473
20406	72	150	33	4375	0	4630
20407	59	54	38	4468	0	4619
20408	48	34	48	4503	0	4633
20409	62	27	37	4486	0	4612
20410	52	29	4255	199	0	4535
20411	4215	27	151	98	0	4491
20412	4358	18	64	88	0	4528
20413	177	32	39	4242	0	4490
20414	98	29	34	4317	0	4478
20415	4231	33	38	186	0	4488
20416	169	35	4003	96	0	4303
20417	4248	44	126	79	0	4497
20418	4346	22	52	92	0	4512
20419	185	41	4140	70	0	4436
20420	4303	29	142	69	0	4543
20421	187	17	58	4304	0	4566
20422	94	24	44	4412	0	4574
20423	68	23	43	4415	0	4549
20424	66	20	46	4435	0	4567
20425	4206	19	37	196	0	4458
20426	174	20	32	4200	0	4426
20427	73	17	31	4066	0	4187
20428	66	3726	31	190	0	4013
20429	61	3904	44	88	0	4097
20430	66	124	32	3873	0	4095
20431	3835	46	32	160	0	4073
20432	163	36	25	3583	0	3807
20433	82	16	3271	127	0	3496
20434	49	20	3123	72	0	3264
20435	3051	29	111	59	0	3250
20436	114	3098	43	59	0	3314
20437	2722	66	45	27	0	2860
20438	87	25	2756	39	0	2907
20439	67	121	65	2292	0	2545
20440	2215	7	32	55	0	2309
20441	49	2201	11	31	0	2292
20442	2165	37	8	23	0	2233
20443	53	14	2273	13	0	2353
20444	21	12	41	2230	0	2304
20445	15	4	15	2283	0	2317
20446	2298	4	9	56	0	2367
20447	2297	7	4	26	0	2334
20448	2352	3	6	19	0	2380
20449	2336	10	8	15	0	2369
20450	2367	6	3	17	0	2393
20451	58	2315	3	13	0	2389
20452	24	35	6	2342	0	2407
20453	2380	10	7	52	0	2449
20454	48	7	5	2380	0	2440
20455	24	5	3	2398	0	2430
20456	17	6	4	2401	0	2428
20457	11	2326	4	56	0	2397
20458	2376	35	4	27	0	2442
20459	46	11	5	2349	0	2411
20460	2316	4	7	56	0	2383
20461	2314	1	6	19	0	2340
20462	55	2289	2	10	0	2356
20463	2291	31	8	20	0	2350
20464	46	13	2236	9	0	2304
20465	2154	8	36	11	0	2209
20466	44	18	19	2166	0	2247
20467	19	6	2189	38	0	2252
20468	11	2195	28	18	0	2252
20469	11	33	2183	8	0	2235
20470	5	1987	22	4	0	2018
20471	1727	48	29	16	0	1820
20472	1732	2	3	6	0	1743
20473	1696	2	0	3	0	1701
20474	14	1714	1	1	0	1730
20475	1702	9	1	3	0	1715
20476	11	0	1671	1	0	1683
20477	3	1	1663	1	0	1668
20478	4	10	9	1664	0	1687
20479	3	2	0	1791	0	1796
20480	1	1752	0	10	0	1763
20481	1818	10	1	8	0	1837
20482	11	0	1	1849	0	1861
20483	1	1861	3	10	0	1875
20484	1	8	0	1970	0	1979
20485	1968	3	0	17	0	1988
20486	1957	1	0	8	0	1966
20487	14	1	1919	2	0	1936
20488	6	2	11	1933	0	1952
20489	2	4	1918	13	0	1937
20490	3	0	12	1942	0	1957
20491	2	2	1951	13	0	1968
20492	5	0	13	1948	0	1966
20493	3	0	1970	14	0	1987
20494	2	0	13	1969	0	1984
20495	1	4	2037	13	0	2055
20496	5	1	14	2035	0	2055
20497	3	0	4	2109	0	2116
20498	1	2160	2	20	0	2183
20499	1	14	2	2244	0	2261
20500	0	2	2236	18	0	2256
20501	3	1	16	2213	0	2233
20502	1	0	2	2249	0	2252
20503	2239	2	2	24	0	2267
20504	16	1	1	2269	0	2287
20505	4	0	2	2224	0	2230
20506	2	1	2157	17	0	2177
20507	2129	0	16	15	0	2160
20508	16	1	5	2227	0	2249
20509	5	0	2	2235	0	2242
20510	6	1	2	2246	0	2255
20511	2238	1	1	30	0	2270
20512	16	0	0	2262	0	2278
20513	8	2	3	2258	0	2271
20514	2224	0	4	39	0	2267
20515	16	2251	3	11	0	2281
20516	7	16	0	2231	0	2254
20517	6	3	0	2255	0	2264
20518	5	3	2204	25	0	2237
20519	1914	3	18	25	0	1960
20520	21	2	6	2159	0	2188
20521	5	1	2113	25	0	2144
20522	2142	0	16	21	0	2179
20523	19	3	3	2251	0	2276
20524	11	2	5	2284	0	2302
20525	8	2	1	2305	0	2316
20526	4	1	5	2322	0	2332
20527	6	3	2417	32	0	2458
20528	10	3	21	2457	0	2491
20529	13	4	5	2921	0	2943
20530	5	6	3429	55	0	3495
20531	3581	0	70	38	0	3689
20532	3809	0	28	25	0	3862
20533	3860	0	25	25	0	3910
20534	125	1	10	3781	0	3917
20535	3833	2	14	86	0	3935
20536	3945	0	5	42	0	3992
20537	126	1	6	3931	0	4064
20538	3817	0	4	104	0	3925
20539	3846	0	3	59	0	3908
20540	3834	1	4	47	0	3886
20541	3890	1	6	30	0	3927
20542	145	0	3	3722	0	3870
20543	79	3557	5	84	0	3725
20544	56	3597	10	30	0	3693
20545	41	3676	5	31	0	3753
20546	3595	119	0	24	0	3738
20547	3722	51	6	27	0	3806
20548	126	38	3627	14	0	3805
20549	3728	22	75	21	0	3846
20550	137	17	26	3761	0	3941
20551	72	9	25	3801	0	3907
20552	65	8	12	3840	0	3925
20553	3763	5	15	136	0	3919
20554	119	3	5	3763	0	3890
20555	53	3689	8	132	0	3882
20556	55	76	4	3793	0	3928
20557	33	42	3829	129	0	4033
20558	34	40	80	3888	0	4042
20559	3892	21	28	138	0	4079
20560	110	25	3860	52	0	4047
20561	59	9	93	3900	0	4061
20562	52	9	42	3835	0	3938
20563	41	5	27	3942	0	4015
20564	31	3841	18	149	0	4039
20565	21	78	15	3964	0	4078
20566	3907	27	7	154	0	4095
20567	3895	26	8	74	0	4003
20568	126	18	3794	63	0	4001
20569	66	18	3858	42	0	3984
20570	64	14	110	3813	0	4001
20571	40	6	57	3927	0	4030
20572	29	11	3885	130	0	4055
20573	37	9	98	3751	0	3895
20574	24	3801	53	125	0	4003
20575	3963	78	40	76	0	4157
20576	3995	32	20	66	0	4113
20577	3983	31	20	56	0	4090
20578	145	19	3953	39	0	4156
20579	95	20	84	3988	0	4187
20580	73	6	3952	110	0	4141
20581	3857	8	106	53	0	4024
20582	103	3866	54	57	0	4080
20583	69	74	51	3842	0	4036
20584	3863	31	27	115	0	4036
20585	108	29	24	3833	0	3994
20586	58	15	17	3943	0	4033
20587	51	17	3824	130	0	4022
20588	3703	12	82	92	0	3889
20589	122	3810	44	56	0	4032
20590	77	69	38	3876	0	4060
20591	3889	29	18	106	0	4042
20592	129	30	26	3871	0	4056
20593	3854	15	12	143	0	4024
20594	129	3840	18	73	0	4060
20595	3879	83	14	81	0	4057
20596	156	47	3822	40	0	4065
20597	3883	34	85	46	0	4048
20598	3890	18	36	34	0	3978
20599	3885	20	44	32	0	3981
20600	173	8	23	3736	0	3940
20601	108	19	16	3609	0	3752
20602	81	23	17	3776	0	3897
20603	62	3673	8	150	0	3893
20604	3747	97	12	90	0	3946
20605	130	32	12	3729	0	3903
20606	77	41	12	3763	0	3893
20607	65	20	15	3804	0	3904
20608	3736	20	17	148	0	3921
20609	116	15	15	3767	0	3913
20610	73	9	3651	149	0	3882
20611	64	3677	79	90	0	3910
20612	48	81	35	3779	0	3943
20613	37	41	26	3853	0	3957
20614	40	41	20	3879	0	3980
20615	33	25	3730	164	0	3952
20616	40	25	3739	100	0	3904
20617	33	12	106	3817	0	3968
20618	37	14	3999	125	0	4175
20619	32	8	116	4066	0	4222
20620	4085	7	57	162	0	4311
20621	4304	13	46	93	0	4456
20622	4291	12	28	99	0	4430
20623	153	21	4157	52	0	4383
20624	4159	12	90	67	0	4328
20625	163	27	46	4259	0	4495
20626	82	13	4249	123	0	4467
20627	76	4	4134	64	0	4278
20628	48	4032	122	68	0	4270
20629	33	3735	57	49	0	3874
20630	3074	75	78	15	0	3242
20631	69	15	18	2940	0	3042
20632	16	4	3003	40	0	3063
20633	20	7	28	2981	0	3036
20634	3046	2	9	43	0	3100
20635	32	3	3244	23	0	3302
20636	3222	2	36	16	0	3276
20637	3398	1	12	28	0	3439
20638	3412	3	16	20	0	3451
20639	43	3382	14	18	0	3457
20640	3524	33	4	22	0	3583
20641	48	16	9	3552	0	3625
20642	39	5	8	3537	0	3589
20643	24	7	5	3588	0	3624
20644	26	6	6	3586	0	3624
20645	3488	6	10	71	0	3575
20646	55	3410	8	30	0	3503
20647	17	3324	10	22	0	3373
20648	16	3461	9	14	0	3500
20649	3458	46	8	26	0	3538
20650	3475	12	6	23	0	3516
20651	3466	11	15	10	0	3502
20652	3457	16	5	10	0	3488
20653	58	6	3	3452	0	3519
20654	35	7	4	3467	0	3513
20655	3433	5	8	61	0	3507
20656	49	3402	6	27	0	3484
20657	3330	34	0	18	0	3382
20658	3416	14	4	15	0	3449
20659	50	8	4	3397	0	3459
20660	20	3461	4	45	0	3530
20661	28	37	3	3562	0	3630
20662	3538	18	2	51	0	3609
20663	57	7	3611	14	0	3689
20664	41	5	41	3538	0	3625
20665	16	3618	11	51	0	3696
20666	3624	51	9	25	0	3709
20667	3572	8	5	31	0	3616
20668	64	10	3624	14	0	3712
20669	14	3590	45	17	0	3666
20670	19	45	3695	17	0	3776
20671	20	22	45	3563	0	3650
20672	12	15	3608	43	0	3678
20673	21	11	3552	14	0	3598
20674	12	3553	57	12	0	3634
20675	3564	47	19	17	0	3647
20676	3607	14	17	21	0	3659
20677	60	3664	9	20	0	3753
20678	26	3700	13	4	0	3743
20679	24	54	3528	6	0	3612
20680	17	28	3467	12	0	3524
20681	16	12	3590	9	0	3627
20682	21	8	51	3587	0	3667
20683	12	15	3647	48	0	3722
20684	6	14	50	3505	0	3575
20685	20	6	24	3472	0	3522
20686	10	8	3642	54	0	3714
20687	9	3622	50	25	0	3706
20688	18	48	13	3688	0	3767
20689	3680	17	17	58	0	3772
20690	58	12	5	3672	0	3747
20691	23	13	3663	55	0	3754
20692	21	3646	55	13	0	3735
20693	15	3809	18	14	0	3856
20694	18	57	14	3772	0	3861
20695	3749	20	12	56	0	3837
20696	3747	13	15	31	0	3806
20697	67	14	13	3709	0	3803
20698	30	3792	9	57	0	3888
20699	27	53	11	3865	0	3956
20700	24	23	5	3938	0	3990
20701	28	12	6	3952	0	3998
20702	4183	13	9	82	0	4287
20703	69	4214	12	34	0	4329
20704	4293	68	8	30	0	4399
20705	4424	34	8	34	0	4500
20706	4449	16	10	31	0	4506
20707	4609	13	8	26	0	4656
20708	125	10	8	4509	0	4652
20709	51	22	4528	83	0	4684
20710	33	4521	73	47	0	4674
20711	4635	80	31	47	0	4793
20712	4728	35	14	31	0	4808
20713	4791	19	8	35	0	4853
20714	121	21	4636	23	0	4801
20715	4618	11	79	23	0	4731
20716	4746	27	32	17	0	4822
20717	132	33	12	4678	0	4855
20718	70	11	4446	81	0	4608
20719	44	4371	73	44	0	4532
20720	39	80	39	4373	0	4531
20721	4248	44	16	88	0	4396
20722	92	15	13	4221	0	4341
20723	52	14	9	4317	0	4392
20724	4344	11	13	108	0	4476
20725	96	7	4211	44	0	4358
20726	4256	16	67	37	0	4376
20727	4304	8	36	23	0	4371
20728	4305	11	23	30	0	4369
20729	4308	10	13	35	0	4366
20730	124	14	4154	12	0	4304
20731	63	12	67	4107	0	4249
20732	36	14	4101	74	0	4225
20733	31	17	76	3966	0	4090
20734	23	4	4025	84	0	4136
20735	3626	8	69	43	0	3746
20736	79	3577	33	21	0	3710
20737	37	3636	25	14	0	3712
20738	46	85	9	3715	0	3855
20739	41	38	16	3862	0	3957
20740	23	3822	8	95	0	3948
20741	3929	69	14	51	0	4063
20742	4144	34	4	27	0	4209
20743	4403	13	7	28	0	4451
20744	4798	5	12	15	0	4830
20745	162	4	10	4764	0	4940
20746	79	9	9	4976	0	5073
20747	5033	10	7	162	0	5212
20748	141	5	14	5022	0	5182
20749	80	9	4879	144	0	5112
20750	55	12	4924	62	0	5053
20751	37	13	157	4959	0	5166
20752	29	5	4978	136	0	5148
20753	4895	6	145	82	0	5128
20754	139	13	58	4961	0	5171
20755	5011	7	38	136	0	5192
20756	161	10	4973	67	0	5211
20757	95	9	120	4972	0	5196
20758	62	7	4968	130	0	5167
20759	30	4920	150	76	0	5176
20760	4829	119	78	69	0	5095
20761	4887	50	38	35	0	5010
20762	176	4810	24	28	0	5038
20763	4753	112	20	31	0	4916
20764	168	51	27	4622	0	4868
20765	87	35	12	4749	0	4883
20766	4669	10	17	182	0	4878
20767	144	4550	12	98	0	4804
20768	68	4591	18	66	0	4743
20769	66	160	16	4522	0	4764
20770	4467	71	19	133	0	4690
20771	4583	35	20	77	0	4715
20772	4599	15	18	48	0	4680
20773	212	24	4406	22	0	4664
20774	112	24	4396	30	0	4562
20775	72	4355	158	23	0	4608
20776	4342	120	72	31	0	4565
20777	154	58	41	4241	0	4494
20778	4282	37	23	124	0	4466
20779	4345	17	22	82	0	4466
20780	200	14	20	4200	0	4434
20781	118	22	4190	127	0	4457
20782	4251	25	113	73	0	4462
20783	157	12	55	4254	0	4478
20784	95	11	4226	134	0	4466
20785	4189	14	118	85	0	4406
20786	4265	12	66	64	0	4407
20787	190	16	52	4137	0	4395
20788	111	15	4087	146	0	4359
20789	83	16	121	4014	0	4234
20790	59	4060	70	151	0	4340
20791	48	113	4056	88	0	4305
20792	62	4102	132	67	0	4363
20793	4045	133	82	42	0	4302
20794	4156	53	50	49	0	4308
20795	4191	32	48	45	0	4316
20796	4216	25	34	33	0	4308
20797	230	15	31	4025	0	4301
20798	4019	20	34	137	0	4210
20799	194	14	34	3910	0	4152
20800	3829	11	21	161	0	4022
20801	166	3680	30	92	0	3968
20802	88	114	26	3413	0	3641
20803	72	3421	23	124	0	3640
20804	3417	119	14	76	0	3626
20805	3380	61	21	42	0	3504
20806	172	3266	13	36	0	3487
20807	102	107	14	3152	0	3375
20808	80	42	3091	111	0	3324
20809	58	45	94	3061	0	3258
20810	55	27	3044	119	0	3245
20811	42	26	107	2820	0	2995
20812	40	2901	47	128	0	3116
20813	2901	88	32	58	0	3079
20814	2958	45	17	51	0	3071
20815	152	37	14	2871	0	3074
20816	2970	16	38	110	0	3134
20817	142	17	25	2917	0	3101
20818	77	31	24	2956	0	3088
20819	82	11	12	2996	0	3101
20820	2899	21	29	151	0	3100
20821	2979	12	15	86	0	3092
20822	2989	19	18	56	0	3082
20823	164	2802	17	49	0	3032
20824	2784	87	18	38	0	2927
20825	135	2702	11	36	0	2884
20826	2752	97	15	32	0	2896
20827	139	41	18	2695	0	2893
20828	85	33	17	2756	0	2891
20829	2703	25	10	122	0	2860
20830	2724	10	15	75	0	2824
20831	133	2619	24	46	0	2822
20832	2666	79	11	31	0	2787
20833	132	45	14	2597	0	2788
20834	61	34	18	2676	0	2789
20835	2631	29	12	120	0	2792
20836	121	12	2574	72	0	2779
20837	68	2500	76	46	0	2690
20838	81	80	33	2378	0	2572
20839	44	27	2218	74	0	2363
20840	45	115	63	2089	0	2312
20841	2109	11	27	87	0	2234
20842	92	1893	20	37	0	2042
20843	38	1681	10	33	0	1762
20844	23	1343	7	23	0	1396
20845	40	77	38	1145	0	1300
20846	1079	4	35	51	0	1169
20847	30	3	2	1024	0	1059
20848	1007	7	5	17	0	1036
20849	1002	1	2	8	0	1013
20850	13	3	2	984	0	1002
20851	984	0	2	22	0	1008
20852	24	1	1	1000	0	1026
20853	5	5	1022	18	0	1050
20854	1002	8	16	8	0	1034
20855	17	4	1122	4	0	1147
20856	1073	2	13	9	0	1097
20857	10	4	1105	7	0	1126
20858	10	1	11	1052	0	1074
20859	8	1	2	1064	0	1075
20860	1074	4	1	11	0	1090
20861	13	1	2	1107	0	1123
20862	1120	2	1	14	0	1137
20863	14	1130	1	4	0	1149
20864	1190	8	0	11	0	1209
20865	15	2	1	1214	0	1232
20866	5	3	2	1226	0	1236
20867	6	4	0	1238	0	1248
20868	5	2	2	1221	0	1230
20869	5	2	1208	16	0	1231
20870	5	4	1182	4	0	1195
20871	5	1	10	1210	0	1226
20872	3	4	1218	11	0	1236
20873	3	1194	12	6	0	1215
20874	4	7	2	1222	0	1235
20875	5	3	1234	12	0	1254
20876	2	3	1197	7	0	1209
20877	7	2	11	1272	0	1292
20878	7	0	3	1295	0	1305
20879	2	1299	3	17	0	1321
20880	5	13	0	1331	0	1349
20881	1	2	1318	20	0	1341
20882	1295	2	15	11	0	1323
20883	18	1	8	1367	0	1394
20884	1390	0	3	25	0	1418
20885	1378	0	5	13	0	1396
20886	1390	3	4	9	0	1406
20887	19	4	1395	6	0	1424
20888	9	4	1399	5	0	1417
20889	1335	2	22	6	0	1365
20890	19	5	1405	5	0	1434
20891	5	1	18	1369	0	1393
20892	6	4	9	1370	0	1389
20893	5	2	1370	22	0	1399
20894	3	1356	20	16	0	1395
20895	1346	14	8	6	0	1374
20896	17	1359	8	7	0	1391
20897	7	1388	3	6	0	1404
20898	1396	17	8	4	0	1425
20899	20	4	1483	6	0	1513
20900	7	5	1485	6	0	1503
20901	8	5	24	1467	0	1504
20902	1482	4	8	21	0	1515
20903	17	1485	8	8	0	1518
20904	1489	16	7	14	0	1526
20905	21	6	1529	7	0	1563
20906	10	1635	20	8	0	1673
20907	6	25	9	1680	0	1720
20908	10	7	1697	27	0	1741
20909	10	3	27	1706	0	1746
20910	15	8	19	1517	0	1559
20911	9	4	6	1726	0	1745
20912	11	1	9	1717	0	1738
20913	1693	3	5	38	0	1739
20914	1711	6	8	15	0	1740
20915	36	2	1738	10	0	1786
20916	1646	3	31	10	0	1690
20917	30	1688	7	10	0	1735
20918	1699	23	6	13	0	1741
20919	32	7	1690	7	0	1736
20920	15	6	22	1664	0	1707
20921	10	4	1702	26	0	1742
20922	9	6	1699	9	0	1723
20923	12	3	32	1654	0	1701
20924	10	2	16	1679	0	1707
20925	6	5	1670	37	0	1718
20926	10	1637	28	20	0	1695
20927	6	1675	8	10	0	1699
20928	8	29	7	1711	0	1755
20929	1683	6	9	28	0	1726
20930	30	1776	8	9	0	1823
20931	12	30	1774	12	0	1828
20932	11	9	1747	8	0	1775
20933	7	9	1778	8	0	1802
20934	12	4	32	1726	0	1774
20935	1750	1	16	36	0	1803
20936	27	1702	16	13	0	1758
20937	10	27	1751	11	0	1799
20938	10	1759	30	10	0	1809
20939	9	28	18	1791	0	1846
20940	8	14	1801	34	0	1857
20941	8	1822	32	11	0	1873
20942	12	29	11	1799	0	1851
20943	7	8	9	1860	0	1884
20944	6	7	1841	38	0	1892
20945	8	5	38	1768	0	1819
20946	12	1806	9	32	0	1859
20947	7	26	1806	16	0	1855
20948	1789	6	34	14	0	1843
20949	36	12	14	1797	0	1859
20950	17	6	15	1788	0	1826
20951	8	1814	10	33	0	1865
20952	1798	29	6	15	0	1848
20953	31	9	1765	12	0	1817
20954	1745	17	28	12	0	1802
20955	36	5	10	1694	0	1745
20956	7	1678	15	29	0	1729
20957	7	27	9	1682	0	1725
20958	8	4	8	1760	0	1780
20959	1726	12	10	43	0	1791
20960	1771	12	9	16	0	1808
20961	38	7	9	1761	0	1815
20962	16	3	1724	37	0	1780
20963	1632	7	29	16	0	1684
20964	32	1695	7	14	0	1748
20965	16	33	10	1678	0	1737
20966	9	7	12	1733	0	1761
20967	12	6	12	1726	0	1756
20968	10	6	1693	44	0	1753
20969	7	7	35	1676	0	1725
20970	4	1698	10	41	0	1753
20971	10	32	10	1706	0	1758
20972	7	1715	10	40	0	1772
20973	17	40	5	1713	0	1775
20974	9	13	1705	41	0	1768
20975	1609	5	39	16	0	1669
20976	39	3	18	1726	0	1786
20977	10	9	1682	31	0	1732
20978	4	1686	33	15	0	1738
20979	1693	25	6	18	0	1742
20980	24	8	1672	18	0	1722
20981	1648	3	38	10	0	1699
20982	32	5	13	1724	0	1774
20983	5	6	4	1731	0	1746
20984	5	1714	4	33	0	1756
20985	1739	31	4	9	0	1783
20986	1740	8	1	12	0	1761
20987	22	1830	8	7	0	1867
20988	13	24	8	1868	0	1913
20989	13	3	3	1893	0	1912
20990	7	4	4	1895	0	1910
20991	3	6	1846	32	0	1887
20992	1817	5	24	12	0	1858
20993	32	2	8	1881	0	1923
20994	13	3	6	1904	0	1926
20995	11	3	1836	34	0	1884
20996	4	4	1811	19	0	1838
20997	7	6	28	1947	0	1988
20998	7	6	1949	31	0	1993
20999	1839	0	34	13	0	1886
21000	30	6	7	1927	0	1970
21001	6	7	4	1969	0	1986
21002	6	5	2062	39	0	2112
21003	6	1	34	2062	0	2103
21004	4	2	2108	37	0	2151
21005	4	2032	40	8	0	2084
21006	1934	19	17	14	0	1984
21007	1903	3	5	21	0	1932
21008	15	1922	8	10	0	1955
21009	3	16	13	1971	0	2003
21010	8	4	2000	24	0	2036
21011	6	3	20	1992	0	2021
21012	1998	5	10	28	0	2041
21013	24	1992	7	12	0	2035
21014	1997	20	4	17	0	2038
21015	23	3	7	1956	0	1989
21016	1981	6	9	26	0	2022
21017	25	1985	4	8	0	2022
21018	1996	21	8	14	0	2039
21019	27	5	1987	5	0	2024
21020	11	2029	18	6	0	2064
21021	14	19	2	2060	0	2095
21022	2194	10	5	23	0	2232
21023	2230	4	7	13	0	2254
21024	32	3	6	2227	0	2268
21025	2243	5	0	36	0	2284
21026	2235	7	2	10	0	2254
21027	2267	8	3	12	0	2290
21028	40	1	3	2223	0	2267
21029	13	3	2233	31	0	2280
21030	21	5	2015	6	0	2047
21031	11	6	2113	10	0	2140
21032	2164	5	32	7	0	2208
21033	29	4	10	2174	0	2217
21034	5	2181	8	32	0	2226
21035	15	25	5	2180	0	2225
21036	12	2248	7	29	0	2296
21037	2320	29	4	13	0	2366
21038	37	3	7	2340	0	2387
21039	17	5	3	2389	0	2414
21040	2407	3	6	38	0	2454
21041	36	2	3	2401	0	2442
21042	9	2	7	2469	0	2487
21043	2520	5	9	39	0	2573
21044	39	5	2531	9	0	2584
21045	9	3	36	2566	0	2614
21046	8	4	2574	39	0	2625
21047	2529	1	41	9	0	2580
21048	44	4	8	2620	0	2676
21049	2647	1	5	50	0	2703
21050	43	5	4	2703	0	2755
21051	8	4	2782	51	0	2845
21052	17	4	41	2882	0	2944
21053	2961	4	4	53	0	3022
21054	47	2969	5	7	0	3028
21055	12	43	2940	11	0	3006
21056	2858	3	37	13	0	2911
21057	46	2948	8	10	0	3012
21058	8	2943	7	9	0	2967
21059	13	3074	9	4	0	3100
21060	14	48	5	3296	0	3363
21061	3407	6	4	62	0	3479
21062	3619	5	4	15	0	3643
21063	69	7	3543	6	0	3625
21064	3550	4	60	13	0	3627
21065	76	3542	11	8	0	3637
21066	25	63	10	3633	0	3731
21067	3751	7	8	67	0	3833
21068	3817	9	2	25	0	3853
21069	3841	9	8	17	0	3875
21070	3818	8	11	10	0	3847
21071	3859	3	10	12	0	3884
21072	87	10	2	3785	0	3884
21073	31	16	3794	69	0	3910
21074	20	15	62	3835	0	3932
21075	23	8	10	3932	0	3973
21076	3868	7	4	80	0	3959
21077	90	3791	4	19	0	3904
21078	3861	63	9	20	0	3953
21079	3966	9	11	21	0	4007
21080	4025	10	5	21	0	4061
21081	4041	8	6	21	0	4076
21082	97	8	3837	15	0	3957
21083	3909	5	62	20	0	3996
21084	4002	6	16	15	0	4039
21085	3477	17	19	43	0	3556
21086	3987	4	14	16	0	4021
21087	108	6	6	3831	0	3951
21088	39	7	3743	81	0	3870
21089	3746	8	68	24	0	3846
21090	90	3770	18	27	0	3905
21091	46	64	15	3744	0	3869
21092	42	3818	8	67	0	3935
21093	43	72	12	3894	0	4021
21094	3940	15	4	86	0	4045
21095	3979	10	5	25	0	4019
21096	3977	7	12	24	0	4020
21097	114	7	3674	12	0	3807
21098	3760	8	68	28	0	3864
21099	112	12	3694	18	0	3836
21100	54	14	3614	22	0	3704
21101	39	18	3677	12	0	3746
21102	47	4	74	3478	0	3603
21103	46	11	28	3613	0	3698
21104	52	11	11	3622	0	3696
21105	42	19	12	3583	0	3656
21106	50	12	12	3441	0	3515
21107	40	12	11	3612	0	3675
21108	34	3567	20	87	0	3708
21109	3542	70	13	32	0	3657
21110	95	3570	17	27	0	3709
21111	47	66	14	3615	0	3742
21112	42	16	25	3681	0	3764
21113	3627	14	18	94	0	3753
21114	95	3572	19	42	0	3728
21115	3632	71	18	39	0	3760
21116	99	23	23	3617	0	3762
21117	53	14	19	3616	0	3702
21118	44	13	15	3638	0	3710
21119	44	17	3522	109	0	3692
21120	55	12	73	3507	0	3647
21121	37	26	3446	97	0	3606
21122	46	20	3242	44	0	3352
21123	38	22	3422	34	0	3516
21124	52	16	74	3425	0	3567
21125	49	16	20	3544	0	3629
21126	45	8	19	3598	0	3670
21127	3582	8	16	103	0	3709
21128	96	15	17	3707	0	3835
21129	3731	15	17	100	0	3863
21130	103	3735	22	49	0	3909
21131	3997	62	13	55	0	4127
21132	4202	18	19	51	0	4290
21133	116	4240	22	50	0	4428
21134	4280	81	22	42	0	4425
21135	4330	23	24	52	0	4429
21136	4402	18	32	36	0	4488
21137	4361	11	24	47	0	4443
21138	132	16	4179	30	0	4357
21139	68	4147	82	45	0	4342
21140	57	91	27	4106	0	4281
21141	4152	28	27	107	0	4314
21142	119	15	4145	46	0	4325
21143	54	4044	85	42	0	4225
21144	57	75	25	3925	0	4082
21145	47	3975	25	90	0	4137
21146	58	74	19	4024	0	4175
21147	55	34	16	4042	0	4147
21148	54	25	3998	100	0	4177
21149	54	25	3930	42	0	4051
21150	3766	17	76	48	0	3907
21151	104	6	3870	31	0	4011
21152	46	19	3789	24	0	3878
21153	52	19	81	3699	0	3851
21154	46	20	29	3707	0	3802
21155	35	3656	29	84	0	3804
21156	27	3956	22	43	0	4048
21157	34	91	4019	27	0	4171
21158	45	43	109	4162	0	4359
21159	29	22	4190	107	0	4348
21160	22	13	3858	38	0	3931
21161	13	3754	98	24	0	3889
21162	20	79	42	3566	0	3707
21163	3578	13	19	96	0	3706
21164	83	17	13	3610	0	3723
21165	3620	6	10	95	0	3731
21166	3626	7	11	26	0	3670
21167	3651	8	11	32	0	3702
21168	99	12	3536	17	0	3664
21169	3573	9	71	19	0	3672
21170	96	11	27	3661	0	3795
21171	3657	9	29	82	0	3777
21172	3712	5	8	32	0	3757
21173	88	3576	21	19	0	3704
21174	3616	79	13	17	0	3725
21175	92	26	3611	11	0	3740
21176	3531	19	79	27	0	3656
21177	3589	9	24	16	0	3638
21178	83	3565	19	15	0	3682
21179	3566	65	12	12	0	3655
21180	89	15	10	3391	0	3505
21181	36	16	12	3445	0	3509
21182	26	3401	17	77	0	3521
21183	21	74	5	3493	0	3593
21184	24	13	10	3542	0	3589
21185	21	16	3439	87	0	3563
21186	22	16	3396	34	0	3468
21187	3348	15	84	27	0	3474
21188	3480	5	28	17	0	3530
21189	100	11	21	3425	0	3557
21190	46	5	3444	74	0	3569
21191	45	3377	71	18	0	3511
21192	27	78	14	3410	0	3529
21193	33	12	3433	76	0	3554
21194	3326	20	77	26	0	3449
21195	98	7	16	3525	0	3646
21196	33	3563	20	84	0	3700
21197	39	82	14	3639	0	3774
21198	32	19	13	3742	0	3806
21199	31	19	16	3746	0	3812
21200	3672	9	21	127	0	3829
21201	108	17	12	3676	0	3813
21202	3699	8	12	118	0	3837
21203	3733	12	11	46	0	3802
21204	122	5	3650	34	0	3811
21205	51	3678	97	25	0	3851
21206	43	99	24	3487	0	3653
21207	31	3809	28	78	0	3946
21208	3844	108	12	40	0	4004
21209	115	23	13	3857	0	4008
21210	37	39	3822	103	0	4001
21211	30	10	3824	44	0	3908
21212	31	15	3813	34	0	3893
21213	3750	5	127	38	0	3920
21214	115	3820	48	21	0	4004
21215	3825	100	22	28	0	3975
21216	124	3858	17	26	0	4025
21217	48	108	16	3875	0	4047
21218	44	20	25	3854	0	3943
21219	30	3895	15	108	0	4048
21220	33	98	3910	50	0	4091
21221	24	3963	93	33	0	4113
21222	3924	116	23	36	0	4099
21223	108	29	27	3828	0	3992
21224	30	32	3758	116	0	3936
21225	36	15	3759	41	0	3851
21226	27	31	114	3690	0	3862
21227	36	12	3664	104	0	3816
21228	37	17	3539	29	0	3622
21229	3344	11	110	46	0	3511
21230	99	3362	43	31	0	3535
21231	3217	80	31	23	0	3351
21232	109	23	3170	19	0	3321
21233	35	3003	88	20	0	3146
21234	35	3114	29	19	0	3197
21235	40	99	39	3035	0	3213
21236	28	36	16	3163	0	3243
21237	24	21	11	3222	0	3278
21238	23	12	3177	116	0	3328
21239	22	12	95	3179	0	3308
21240	18	13	27	3283	0	3341
21241	3180	14	15	118	0	3327
21242	95	3106	14	52	0	3267
21243	37	93	12	3175	0	3317
21244	3182	25	13	106	0	3326
21245	3210	30	10	35	0	3285
21246	120	14	13	3176	0	3323
21247	47	14	3177	99	0	3337
21248	38	13	86	3188	0	3325
21249	16	15	3151	115	0	3297
21250	3170	14	112	41	0	3337
21251	3387	6	32	39	0	3464
21252	121	23	27	3432	0	3603
21253	51	7	3509	106	0	3673
21254	32	3766	104	35	0	3937
21255	36	115	3877	30	0	4058
21256	41	62	122	3466	0	3691
21257	28	3638	35	104	0	3805
21258	3430	89	14	42	0	3575
21259	99	25	11	3324	0	3459
21260	34	3385	22	84	0	3525
21261	3424	102	12	42	0	3580
21262	104	23	17	3419	0	3563
21263	33	3426	11	99	0	3569
21264	27	101	9	3420	0	3557
21265	15	35	3410	101	0	3561
21266	3308	13	89	48	0	3458
21267	3387	18	26	27	0	3458
21268	123	7	3282	17	0	3429
21269	35	3301	91	17	0	3444
21270	3289	98	25	22	0	3434
21271	88	22	18	3300	0	3428
21272	51	14	15	3294	0	3374
21273	38	6	7	3374	0	3425
21274	25	7	12	3389	0	3433
21275	10	14	19	3331	0	3374
21276	3223	15	8	127	0	3373
21277	3327	4	9	54	0	3394
21278	121	10	10	3249	0	3390
21279	45	10	7	3325	0	3387
21280	18	3	3201	137	0	3359
21281	15	14	3189	63	0	3281
21282	3150	7	109	35	0	3301
21283	116	9	38	3162	0	3325
21284	50	7	3128	110	0	3295
21285	28	8	85	3177	0	3298
21286	3165	7	40	126	0	3338
21287	3270	11	32	49	0	3362
21288	127	8	21	3196	0	3352
21289	63	6	13	3284	0	3366
21290	3219	10	12	146	0	3387
21291	100	10	22	3211	0	3343
21292	47	3182	13	110	0	3352
21293	40	91	9	3172	0	3312
21294	36	31	8	3217	0	3292
21295	17	9	3054	138	0	3218
21296	15	11	2969	59	0	3054
21297	26	2998	104	35	0	3163
21298	2922	79	31	35	0	3067
21299	2913	36	17	24	0	2990
21300	2991	8	3	39	0	3041
21301	109	2825	13	39	0	2986
21302	37	2948	26	16	0	3027
21303	2865	92	19	30	0	3006
21304	78	2936	11	25	0	3050
21305	49	77	2831	22	0	2979
21306	30	2860	67	28	0	2985
21307	24	76	2752	23	0	2875
21308	2681	42	74	26	0	2823
21309	2783	21	30	22	0	2856
21310	119	2693	12	17	0	2841
21311	2794	85	10	31	0	2920
21312	3084	37	19	32	0	3172
21313	3183	21	15	26	0	3245
21314	145	7	20	3094	0	3266
21315	3162	16	7	107	0	3292
21316	132	19	3001	59	0	3211
21317	3075	17	92	39	0	3223
21318	135	10	35	3087	0	3267
21319	84	14	2995	101	0	3194
21320	47	10	3014	57	0	3128
21321	43	26	118	3016	0	3203
21322	35	17	52	3105	0	3209
21323	3054	9	39	140	0	3242
21324	121	12	18	3065	0	3216
21325	44	19	3025	144	0	3232
21326	44	9	100	3030	0	3183
21327	34	3089	47	121	0	3291
21328	3106	95	22	78	0	3301
21329	118	40	24	3107	0	3289
21330	63	20	3041	115	0	3239
21331	41	3014	87	66	0	3208
21332	2922	83	47	46	0	3098
21333	104	38	26	2936	0	3104
21334	51	36	2916	96	0	3099
21335	47	2874	86	48	0	3055
21336	2799	77	50	38	0	2964
21337	2767	30	32	34	0	2863
21338	2851	25	21	22	0	2919
21339	143	14	12	2741	0	2910
21340	71	5	16	2815	0	2907
21341	2746	10	16	113	0	2885
21342	99	2714	14	61	0	2888
21343	2769	68	9	42	0	2888
21344	111	30	10	2717	0	2868
21345	2768	17	10	87	0	2882
21346	95	13	7	2763	0	2878
21347	51	5	9	2774	0	2839
21348	41	9	19	2783	0	2852
21349	37	17	14	2771	0	2839
21350	30	12	2607	128	0	2777
21351	27	13	2465	55	0	2560
21352	2251	5	71	39	0	2366
21353	67	16	2292	23	0	2398
21354	28	5	1943	11	0	1987
21355	1806	13	73	10	0	1902
21356	1844	4	38	5	0	1891
21357	50	5	19	1922	0	1996
21358	2000	0	14	35	0	2049
21359	48	2019	7	20	0	2094
21360	2095	25	7	16	0	2143
21361	2070	15	6	16	0	2107
21362	2142	11	5	14	0	2172
21363	61	15	3	2092	0	2171
21364	42	2054	4	30	0	2130
21365	25	2113	3	19	0	2160
21366	2142	41	3	16	0	2202
21367	2143	24	4	23	0	2194
21368	52	15	5	2130	0	2202
21369	32	11	3	2120	0	2166
21370	26	2103	6	41	0	2176
21371	2115	28	3	34	0	2180
21372	36	17	2156	22	0	2231
21373	27	10	27	2127	0	2191
21374	23	10	14	2183	0	2230
21375	18	2	2200	50	0	2270
21376	15	4	34	2205	0	2258
21377	15	1804	17	48	0	1884
21378	7	28	16	2271	0	2322
21379	14	16	14	2248	0	2292
21380	9	2144	8	55	0	2216
21381	11	2303	8	28	0	2350
21382	6	39	5	2338	0	2388
21383	2372	20	1	46	0	2439
21384	31	17	4	2398	0	2450
21385	20	9	3	2448	0	2480
21386	16	2448	7	50	0	2521
21387	17	29	8	2533	0	2587
21388	12	17	5	2519	0	2553
21389	14	13	4	2537	0	2568
21390	2524	11	3	64	0	2602
21391	32	2	6	2582	0	2622
21392	22	7	4	2570	0	2603
21393	21	6	4	2600	0	2631
21394	20	3	2518	54	0	2595
21395	2387	5	25	48	0	2465
21396	34	2518	16	29	0	2597
21397	2557	25	9	20	0	2611
21398	43	14	8	2551	0	2616
21399	30	10	2509	31	0	2580
21400	2455	11	24	25	0	2515
21401	37	5	3203	22	0	3267
21402	24	2	37	3304	0	3367
21403	3451	5	24	33	0	3513
21404	3429	6	10	22	0	3467
21405	3574	3	8	21	0	3606
21406	50	2	2	3642	0	3696
21407	36	2	3	3669	0	3710
21408	22	6	4	3698	0	3730
21409	15	3528	3	50	0	3596
21410	5	3520	2	41	0	3568
21411	10	3505	5	24	0	3544
21412	1	3459	2	6	0	3468
21413	5	5	0	3535	0	3545
21414	4	2	0	3548	0	3554
21415	3573	2	0	9	0	3584
21416	3513	0	0	13	0	3526
21417	3622	0	0	11	0	3633
21418	10	0	0	3678	0	3688
21419	5	0	0	3751	0	3756
21420	3787	0	1	18	0	3806
21421	3739	0	2	10	0	3751
21422	10	1	3746	2	0	3759
21423	11	9	3629	3	0	3652
21424	5	5	3750	2	0	3762
21425	6	2	3926	2	0	3936
21426	4	1	6	4018	0	4029
21427	4048	0	2	10	0	4060
21428	5	3998	4	2	0	4009
21429	4	4	0	4226	0	4234
21430	5	1	4324	5	0	4335
21431	2	4560	8	0	0	4570
21432	11	7	0	4733	0	4751
21433	2	3	4697	8	0	4710
21434	12	2	7	4696	0	4717
21435	3	1	1	4752	0	4757
21436	4848	0	3	12	0	4863
21437	5	2	0	4867	0	4874
21438	3	4	4919	6	0	4932
21439	3	1	6	4885	0	4895
21440	2	5370	2	11	0	5385
21441	2	5	2	5762	0	5771
21442	5	2	2	5835	0	5844
21443	8	2	0	5819	0	5829
21444	5987	1	0	24	0	6012
21445	6065	0	1	22	0	6088
21446	6288	1	0	29	0	6318
21447	6350	0	5	11	0	6366
21448	11	3	6306	2	0	6322
21449	6246	0	5	11	0	6262
21450	6419	0	2	13	0	6434
21451	9	4	6394	3	0	6410
21452	10	5	6626	4	0	6645
21453	8	2	8	6847	0	6865
21454	3	6947	7	6	0	6963
21455	7244	5	2	25	0	7276
21456	7589	3	3	31	0	7626
21457	7943	3	0	27	0	7973
21458	11	2	1	7955	0	7969
21459	6	8287	4	7	0	8304
21460	8720	3	0	34	0	8757
21461	8799	3	1	21	0	8824
21462	13	1	0	8812	0	8826
21463	10	7	8598	5	0	8620
21464	8632	0	6	25	0	8663
21465	8	0	9	8994	0	9011
21466	9159	1	2	21	0	9183
21467	14	1	1	9339	0	9355
21468	4	3	9414	5	0	9426
21469	10105	2	4	55	0	10166
21470	13	1	5	10456	0	10475
21471	10	1	4	10453	0	10468
21472	7	5	2	10538	0	10552
21473	9	5	1	10484	0	10499
21474	10661	3	1	32	0	10697
21475	9	1	1	10633	0	10644
21476	2	10622	4	16	0	10644
21477	9	16	1	11065	0	11091
21478	2	11065	5	24	0	11096
21479	8	24	1	11436	0	11469
21480	9	4	0	11443	0	11456
21481	1	11265	5	31	0	11302
21482	10	26	0	11589	0	11625
21483	9	5	0	11511	0	11525
21484	11489	1	3	55	0	11548
21485	37	8	11613	8	0	11666
21486	25	1	38	11958	0	12022
21487	12134	0	9	76	0	12219
21488	12122	1	3	25	0	12151
21489	12128	1	1	17	0	12147
21490	69	8	12005	2	0	12084
21491	22	14	12135	6	0	12177
21492	38	14	68	12545	0	12665
21493	12863	1	19	80	0	12963
21494	62	10	12616	18	0	12706
21495	12351	1	60	38	0	12450
21496	66	13071	22	9	0	13168
21497	34	56	3	14284	0	14377
21498	17	17	11	14700	0	14745
21499	14852	5	1	111	0	14969
21500	72	5	3	14971	0	15051
21501	14535	3	2	105	0	14645
21502	14745	3	6	64	0	14818
21503	84	2	4	14706	0	14796
21504	36	3	4	14698	0	14741
21505	14699	0	4	107	0	14810
21506	85	12	15235	23	0	15355
21507	15075	2	63	70	0	15210
21508	79	7	15895	9	0	15990
21509	15898	6	60	60	0	16024
21510	16832	0	19	73	0	16924
21511	16754	6	7	45	0	16812
21512	16595	2	8	50	0	16655
21513	94	16545	17	19	0	16675
21514	17075	66	4	51	0	17196
21515	17125	16	8	38	0	17187
21516	88	17564	12	18	0	17682
21517	17821	64	6	61	0	17952
21518	90	27	17447	6	0	17570
21519	17314	4	73	51	0	17442
21520	93	16	17565	5	0	17679
21521	57	2	77	17728	0	17864
21522	36	4	22	17918	0	17980
21523	29	10	17701	94	0	17834
21524	48	7	81	17679	0	17815
21525	403	142	222	10860	0	11627
21526	18481	10	12	157	0	18660
21527	107	4	9	18599	0	18719
21528	60	8	7	18529	0	18604
21529	36	10	11	18667	0	18724
21530	23	18142	20	139	0	18324
21531	29	91	12	18406	0	18538
21532	18354	25	15	163	0	18557
21533	118	18	18438	61	0	18635
21534	64	8	116	18625	0	18813
21535	42	16	18717	138	0	18913
21536	18274	3	129	104	0	18510
21537	161	7	42	19510	0	19720
21538	68	13	24124	177	0	24382
21539	81	16	438	24453	0	24988
21540	74	11	309	24603	0	24997
21541	36	24550	238	762	0	25586
21542	80	470	142	25819	0	26511
21543	105	317	35	27685	0	28142
21544	50	223	27068	1064	0	28405
21545	136	133	569	27295	0	28133
21546	78	66	375	27950	0	28469
21547	26844	29	261	1213	0	28347
21548	26851	27	180	802	0	27860
21549	898	26794	106	516	0	28314
21550	27587	586	72	419	0	28664
21551	27790	368	104	334	0	28596
21552	1141	27560	169	263	0	29133
21553	751	741	107	27756	0	29355
21554	28004	447	54	933	0	29438
21555	28150	315	60	645	0	29170
21556	27639	231	57	533	0	28460
21557	1397	26163	114	345	0	28019
21558	1015	699	26615	254	0	28583
21559	26946	448	621	317	0	28332
21560	27518	417	369	299	0	28603
21561	1262	27132	284	268	0	28946
21562	27856	777	187	295	0	29115
21563	28608	495	134	216	0	29453
21564	1628	368	83	27561	0	29640
21565	998	333	27600	855	0	29786
21566	806	223	784	28092	0	29905
21567	720	119	468	28539	0	29846
21568	579	200	324	28678	0	29781
21569	452	223	26831	1456	0	28962
21570	566	160	770	26421	0	27917
21571	466	177	455	27808	0	28906
21572	390	115	360	28154	0	29019
21573	431	101	296	28068	0	28896
21574	394	102	175	28078	0	28749
21575	316	26474	121	1902	0	28813
21576	314	783	144	27477	0	28718
21577	269	447	226	27968	0	28910
21578	222	310	26225	1711	0	28468
21579	287	215	776	28203	0	29481
21580	247	150	460	28923	0	29780
21581	277	119	325	29868	0	30589
21582	260	121	262	30388	0	31031
21583	28893	162	189	2263	0	31507
21584	1014	148	172	30284	0	31618
21585	624	142	139	30546	0	31451
21586	491	140	28200	2060	0	30891
21587	380	26997	874	1506	0	29757
21588	231	28790	580	1241	0	30842
21589	27879	1184	468	1084	0	30615
21590	898	28582	350	885	0	30715
21591	666	1210	193	28322	0	30391
21592	27693	701	173	1674	0	30241
21593	1099	511	27335	1227	0	30172
21594	697	387	986	27986	0	30056
21595	521	27431	600	1593	0	30145
21596	471	1039	443	27515	0	29468
21597	369	27035	331	1655	0	29390
21598	340	1304	193	27306	0	29143
21599	26375	816	145	1843	0	29179
21600	1196	568	26427	1217	0	29408
21601	796	472	1025	26218	0	28511
21602	634	26271	633	1503	0	29041
21603	26248	1142	467	1138	0	28995
21604	1163	774	25985	985	0	28907
21605	796	600	1025	26314	0	28735
21606	714	477	25376	1494	0	28061
21607	685	333	1303	25515	0	27836
21608	485	282	25004	1694	0	27465
21609	347	360	1342	24893	0	26942
21610	368	322	882	25244	0	26816
21611	23851	310	603	2030	0	26794
21612	24571	259	529	1376	0	26735
21613	1600	285	397	23831	0	26113
21614	1066	23261	367	1598	0	26292
21615	803	1019	331	24223	0	26376
21616	585	666	315	24237	0	25803
21617	22575	478	330	2192	0	25575
21618	1172	22669	249	1584	0	25674
21619	22888	1068	274	1193	0	25423
21620	23098	652	209	1019	0	24978
21621	1634	21659	255	842	0	24390
21622	1028	22974	229	814	0	25045
21623	22465	1395	260	941	0	25061
21624	1394	809	21624	944	0	24771
21625	22207	646	1029	810	0	24692
21626	22438	541	582	808	0	24369
21627	1900	21230	515	689	0	24334
21628	1318	1047	364	20136	0	22865
21629	869	21460	299	1420	0	24048
21630	21344	1357	321	1060	0	24082
21631	21944	878	319	855	0	23996
21632	1692	672	330	21158	0	23852
21633	1295	564	264	21669	0	23792
21634	20647	455	186	1840	0	23128
21635	1473	20047	202	1357	0	23079
21636	1015	19898	165	1181	0	22259
21637	855	19825	242	833	0	21755
21638	478	13974	144	468	0	15064
21639	432	14191	119	483	0	15225
21640	522	992	231	13201	0	14946
21641	318	446	12567	929	0	14260
21642	314	12537	475	533	0	13859
21643	10615	587	188	350	0	11740
21644	592	351	162	10355	0	11460
21645	10276	277	124	573	0	11250
21646	601	10266	95	324	0	11286
21647	10336	501	132	268	0	11237
21648	601	10265	182	242	0	11290
21649	393	539	177	10162	0	11271
21650	10088	287	177	505	0	11057
21651	10293	251	157	347	0	11048
21652	580	210	164	10058	0	11012
21653	353	184	140	10145	0	10822
21654	328	9661	121	665	0	10775
21655	318	426	98	9969	0	10811
21656	292	240	85	10207	0	10824
21657	284	243	57	10100	0	10684
21658	287	9439	55	730	0	10511
21659	8726	425	46	449	0	9646
21660	454	8796	60	383	0	9693
21661	8460	473	54	288	0	9275
21662	495	8464	49	253	0	9261
21663	331	452	8014	209	0	9006
21664	299	272	305	7877	0	8753
21665	230	257	7546	371	0	8404
21666	231	213	7491	204	0	8139
21667	237	210	372	7307	0	8126
21668	238	150	7323	364	0	8075
21669	215	162	385	7217	0	7979
21670	246	133	209	7354	0	7942
21671	231	149	144	7498	0	8022
21672	7250	120	120	529	0	8019
21673	400	163	82	7347	0	7992
21674	301	139	60	7497	0	7997
21675	7114	139	42	510	0	7805
21676	439	6841	45	354	0	7679
21677	273	6636	27	311	0	7247
21678	259	6843	32	259	0	7393
21679	206	573	44	5200	0	6023
21680	139	136	5154	304	0	5733
21681	4100	188	162	146	0	4596
21682	195	4139	52	81	0	4467
21683	3470	156	38	49	0	3713
21684	3528	68	24	39	0	3659
21685	3562	58	11	36	0	3667
21686	164	56	3449	29	0	3698
21687	88	55	99	3483	0	3725
21688	86	38	44	3558	0	3726
21689	76	32	32	3594	0	3734
21690	61	39	33	3507	0	3640
21691	64	3397	14	147	0	3622
21692	3428	119	15	90	0	3652
21693	110	48	3266	65	0	3489
21694	3089	33	73	60	0	3255
21695	123	81	28	2954	0	3186
21696	71	2908	10	114	0	3103
21697	43	2977	11	61	0	3092
21698	67	174	9	2654	0	2904
21699	33	2646	12	87	0	2778
21700	2183	43	7	20	0	2253
21701	43	14	2089	15	0	2161
21702	14	16	30	1965	0	2025
21703	10	5	6	2028	0	2049
21704	11	5	5	2032	0	2053
21705	6	7	5	2024	0	2042
21706	2029	5	6	30	0	2070
21707	29	2060	6	17	0	2112
21708	2249	24	2	20	0	2295
21709	38	5	6	2315	0	2364
21710	18	11	3	2402	0	2434
21711	10	2446	1	50	0	2507
21712	2542	34	3	32	0	2611
21713	2632	13	3	24	0	2672
21714	51	2620	4	12	0	2687
21715	25	34	4	2407	0	2470
21716	7	2495	6	37	0	2545
21717	2514	38	8	16	0	2576
21718	39	22	2494	11	0	2566
21719	20	13	2421	6	0	2460
21720	2381	7	46	6	0	2440
21721	34	2439	22	4	0	2499
21722	20	34	11	2449	0	2514
21723	15	14	4	2459	0	2492
21724	7	11	2467	49	0	2534
21725	6	7	34	2461	0	2508
21726	10	2	15	2503	0	2530
21727	4	2422	9	55	0	2490
21728	4	35	4	2461	0	2504
21729	6	18	5	2469	0	2498
21730	2412	14	3	63	0	2492
21731	36	2366	6	31	0	2439
21732	18	2430	8	20	0	2476
21733	23	50	4	2427	0	2504
21734	12	26	4	2476	0	2518
21735	8	15	3	2464	0	2490
21736	7	2419	3	56	0	2485
21737	6	33	6	2487	0	2532
21738	9	18	7	2450	0	2484
21739	11	12	3	2459	0	2485
21740	10	10	3	2452	0	2475
21741	10	2332	4	66	0	2412
21742	8	2493	3	33	0	2537
21743	2422	53	4	21	0	2500
21744	2452	27	4	13	0	2496
21745	59	16	0	2455	0	2530
21746	25	11	2450	47	0	2533
21747	23	4	41	2467	0	2535
21748	8	10	11	2456	0	2485
21749	2388	10	10	59	0	2467
21750	44	2449	4	32	0	2529
21751	31	40	3	2463	0	2537
21752	21	20	8	2503	0	2552
21753	12	20	2432	64	0	2528
21754	11	16	2468	37	0	2532
21755	9	12	51	2469	0	2541
21756	12	7	25	2459	0	2503
21757	9	2426	20	59	0	2514
21758	11	2471	13	34	0	2529
21759	2457	47	10	32	0	2546
21760	44	31	5	2501	0	2581
21761	24	17	2506	54	0	2601
21762	12	2479	33	33	0	2557
21763	15	43	25	2524	0	2607
21764	2504	22	8	55	0	2589
21765	38	13	11	2519	0	2581
21766	2470	8	6	57	0	2541
21767	38	2459	8	38	0	2543
21768	2429	35	6	25	0	2495
21769	46	19	0	2456	0	2521
21770	23	21	2593	45	0	2682
21771	18	18	38	2606	0	2680
21772	8	2704	19	61	0	2792
21773	10	44	12	2727	0	2793
21774	8	2824	11	61	0	2904
21775	2	58	8	2915	0	2983
21776	13	29	2821	70	0	2933
21777	13	26	2747	41	0	2827
21778	9	15	2800	37	0	2861
21779	2766	13	68	28	0	2875
21780	46	2780	38	18	0	2882
21781	28	2855	22	18	0	2923
21782	2801	61	14	25	0	2901
21783	2855	38	10	16	0	2919
21784	68	24	4	2822	0	2918
21785	34	12	2812	60	0	2918
21786	23	11	2697	39	0	2770
21787	13	14	64	2734	0	2825
21788	2721	12	33	64	0	2830
21789	47	2711	19	39	0	2816
21790	26	48	14	2766	0	2854
21791	2737	25	11	66	0	2839
21792	2732	16	11	41	0	2800
21793	67	15	2707	30	0	2819
21794	2620	14	46	34	0	2714
21795	64	16	2764	18	0	2862
21796	34	13	2791	23	0	2861
21797	24	11	68	2723	0	2826
21798	18	9	40	2768	0	2835
21799	11	9	28	2809	0	2857
21800	22	12	2721	80	0	2835
21801	2705	16	47	56	0	2824
21802	47	17	26	2828	0	2918
21803	2777	10	17	74	0	2878
21804	2787	8	10	55	0	2860
21805	70	2789	17	32	0	2908
21806	40	2853	18	22	0	2933
21807	25	2864	18	18	0	2925
21808	32	64	16	2610	0	2722
21809	15	28	2591	48	0	2682
21810	21	71	44	2418	0	2554
21811	10	2456	15	61	0	2542
21812	15	2422	13	24	0	2474
21813	15	43	8	2359	0	2425
21814	2291	21	5	42	0	2359
21815	39	2241	9	16	0	2305
21816	13	2275	10	12	0	2310
21817	2322	37	5	22	0	2386
21818	41	18	5	2323	0	2387
21819	18	20	5	2318	0	2361
21820	13	13	5	2368	0	2399
21821	2287	6	4	59	0	2356
21822	2311	6	12	27	0	2356
21823	44	1	10	2321	0	2376
21824	23	10	2220	42	0	2295
21825	2227	10	37	18	0	2292
21826	43	6	15	2263	0	2327
21827	22	9	2226	45	0	2302
21828	16	13	2231	22	0	2282
21829	15	7	41	2281	0	2344
21830	16	7	2353	45	0	2421
21831	13	7	45	2566	0	2631
21832	18	8	16	2579	0	2621
21833	8	5	17	2809	0	2839
21834	2777	5	8	78	0	2868
21835	57	11	9	2773	0	2850
21836	22	14	6	2831	0	2873
21837	25	15	10	2826	0	2876
21838	23	10	3	2836	0	2872
21839	7	14	2724	80	0	2825
21840	8	2721	57	44	0	2830
21841	14	49	24	2714	0	2801
21842	10	21	20	2670	0	2721
21843	8	2561	20	65	0	2654
21844	8	2689	10	44	0	2751
21845	2641	60	8	36	0	2745
21846	49	2591	2	31	0	2673
21847	32	57	3	2578	0	2670
21848	23	20	2585	58	0	2686
21849	2528	16	44	40	0	2628
21850	54	4	2500	41	0	2599
21851	2506	8	56	27	0	2597
21852	2557	10	25	17	0	2609
21853	61	15	2536	29	0	2641
21854	39	5	55	2416	0	2515
21855	33	2474	23	51	0	2581
21856	16	49	15	2637	0	2717
21857	2662	22	21	75	0	2780
21858	2748	18	13	38	0	2817
21859	63	2724	14	41	0	2842
21860	2747	47	16	38	0	2848
21861	71	20	14	2640	0	2745
21862	2626	15	9	91	0	2741
21863	2641	8	18	44	0	2711
21864	86	14	6	2634	0	2740
21865	2631	13	8	95	0	2747
21866	2555	9	15	58	0	2637
21867	84	11	2564	47	0	2706
21868	2565	16	62	44	0	2687
21869	71	17	2562	35	0	2685
21870	37	21	2400	24	0	2482
21871	24	2410	63	28	0	2525
21872	34	55	30	2275	0	2394
21873	21	22	2280	53	0	2376
21874	17	20	2219	31	0	2287
21875	2273	19	54	27	0	2373
21876	61	15	20	2264	0	2360
21877	23	5	14	2354	0	2396
21878	32	6	13	2344	0	2395
21879	17	10	12	2359	0	2398
21880	17	13	16	2372	0	2418
21881	29	12	2290	79	0	2410
21882	14	15	2312	38	0	2379
21883	21	6	71	2315	0	2413
21884	2283	21	26	62	0	2392
21885	57	2256	14	38	0	2365
21886	29	52	16	2264	0	2361
21887	2263	17	10	71	0	2361
21888	68	2255	14	34	0	2371
21889	30	57	10	2297	0	2394
21890	32	18	7	2359	0	2416
21891	29	10	18	2360	0	2417
21892	2307	9	14	89	0	2419
21893	66	8	2249	51	0	2374
21894	2257	6	67	37	0	2367
21895	73	11	27	2274	0	2385
21896	35	9	19	2238	0	2301
21897	24	2213	23	76	0	2336
21898	29	51	2181	33	0	2294
21899	2220	19	59	43	0	2341
21900	2287	17	25	33	0	2362
21901	75	17	2242	34	0	2368
21902	2198	6	57	40	0	2301
21903	66	2265	31	31	0	2393
21904	33	2313	15	34	0	2395
21905	34	2309	16	36	0	2395
21906	2204	64	21	26	0	2315
21907	61	24	2215	23	0	2323
21908	28	29	52	2124	0	2233
21909	27	2082	23	51	0	2183
21910	20	2118	20	27	0	2185
21911	17	2123	21	20	0	2181
21912	53	73	8	1759	0	1893
21913	2011	25	8	47	0	2091
21914	36	2041	14	28	0	2119
21915	24	46	7	2042	0	2119
21916	15	15	11	2086	0	2127
21917	2023	8	11	50	0	2092
21918	48	15	12	2015	0	2090
21919	25	10	12	2083	0	2130
21920	26	14	2055	57	0	2152
21921	19	15	31	2067	0	2132
21922	18	5	17	2129	0	2169
21923	2094	4	15	59	0	2172
21924	2099	7	5	38	0	2149
21925	65	9	2	2102	0	2178
21926	2031	13	12	50	0	2106
21927	2081	8	11	28	0	2128
21928	65	2059	11	19	0	2154
21929	29	35	2019	14	0	2097
21930	18	1964	42	11	0	2035
21931	32	78	15	1691	0	1816
21932	1590	20	19	28	0	1657
21933	18	1565	6	10	0	1599
21934	9	16	3	1565	0	1593
21935	1551	7	8	25	0	1591
21936	1547	2	5	14	0	1568
21937	27	3	2	1547	0	1579
21938	10	5	1667	24	0	1706
21939	9	2	15	1694	0	1720
21940	4	3	4	1738	0	1749
21941	2	0	1728	33	0	1763
21942	10	2	18	1719	0	1749
21943	4	4	11	1737	0	1756
21944	1801	1	6	31	0	1839
21945	21	3	5	1820	0	1849
21946	10	5	2	1838	0	1855
21947	1805	4	2	32	0	1843
21948	1755	6	4	13	0	1778
21949	1765	3	0	12	0	1780
21950	25	3	1729	12	0	1769
21951	14	2	21	1728	0	1765
21952	10	1741	4	26	0	1781
21953	6	18	4	1813	0	1841
21954	11	8	1843	22	0	1884
21955	13	7	21	1736	0	1777
21956	5	5	1827	18	0	1855
21957	1691	7	18	17	0	1733
21958	1724	0	3	14	0	1741
21959	20	1	1	1823	0	1845
21960	7	1	1	1829	0	1838
21961	7	0	0	1847	0	1854
21962	6	1915	2	17	0	1940
21963	1970	11	1	11	0	1993
21964	2008	4	2	16	0	2030
21965	16	2	2	2017	0	2037
21966	6	1	2	2021	0	2030
21967	6	1	2	2029	0	2038
21968	3	2	4	2034	0	2043
21969	1	1	2023	19	0	2044
21970	4	2	9	2030	0	2045
21971	2015	1	4	24	0	2044
21972	2019	0	3	15	0	2037
21973	16	0	3	1999	0	2018
21974	5	1	1943	14	0	1963
21975	1896	1	10	6	0	1913
21976	16	3	5	1981	0	2005
21977	6	1971	2	17	0	1996
21978	1	2024	1	15	0	2041
21979	2054	15	0	13	0	2082
21980	13	6	0	2090	0	2109
21981	6	3	2	2094	0	2105
21982	6	2	1	2155	0	2164
21983	7	0	1	2149	0	2157
21984	5	0	1	2271	0	2277
21985	4	0	2256	28	0	2288
21986	1	1	2220	19	0	2241
21987	4	2	2254	7	0	2267
21988	3	0	24	2242	0	2269
21989	5	4	2330	23	0	2362
21990	11	1	24	2296	0	2332
21991	8	1	13	2318	0	2340
21992	6	0	5	2394	0	2405
21993	2428	2	6	58	0	2494
21994	28	1	10	2468	0	2507
21995	12	2	12	2507	0	2533
21996	2473	3	11	46	0	2533
21997	27	2512	6	26	0	2571
21998	17	2610	9	14	0	2650
21999	2616	42	2	24	0	2684
22000	35	2630	2	20	0	2687
22001	2587	38	3	22	0	2650
22002	2615	19	2	18	0	2654
22003	2597	5	4	19	0	2625
22004	2550	6	4	21	0	2581
22005	2571	4	5	8	0	2588
22006	56	2533	3	12	0	2604
22007	2567	42	3	12	0	2624
22008	2602	15	2	11	0	2630
22009	56	2626	5	9	0	2696
22010	2736	42	1	20	0	2799
22011	2812	11	3	9	0	2835
22012	2998	3	4	11	0	3016
22013	3221	8	3	10	0	3242
22014	106	7	3532	6	0	3651
22015	47	12	84	3900	0	4043
22016	37	8	27	4033	0	4105
22017	23	6	3941	126	0	4096
22018	18	16	3871	45	0	3950
22019	3906	9	126	23	0	4064
22020	128	4	39	3982	0	4153
22021	58	5	3999	97	0	4159
22022	38	6	3950	35	0	4029
22023	3911	5	143	24	0	4083
22024	4052	5	44	26	0	4127
22025	4078	5	21	30	0	4134
22026	145	6	3987	9	0	4147
22027	73	3	109	3942	0	4127
22028	44	2	3967	97	0	4110
22029	3922	5	110	59	0	4096
22030	115	1	4037	32	0	4185
22031	57	7	128	3922	0	4114
22032	44	3	50	3992	0	4089
22033	44	4025	32	118	0	4219
22034	4108	100	25	58	0	4291
22035	114	31	4109	44	0	4298
22036	4077	11	132	49	0	4269
22037	132	11	4231	18	0	4392
22038	81	6	131	4015	0	4233
22039	61	3	57	4090	0	4211
22040	35	1	41	4166	0	4243
22041	4034	5	39	170	0	4248
22042	131	9	38	3993	0	4171
22043	86	4	25	4086	0	4201
22044	54	3944	27	152	0	4177
22045	53	98	29	3997	0	4177
22046	3923	32	42	159	0	4156
22047	120	24	3923	77	0	4144
22048	72	10	121	3922	0	4125
22049	43	11	3911	140	0	4105
22050	45	3787	147	66	0	4045
22051	29	101	3925	50	0	4105
22052	3834	39	124	69	0	4066
22053	3980	29	51	53	0	4113
22054	162	16	43	3858	0	4079
22055	3887	8	40	133	0	4068
22056	3910	4	42	78	0	4034
22057	166	2	37	3848	0	4053
22058	77	17	38	3931	0	4063
22059	32	18	3737	187	0	3974
22060	48	3694	129	78	0	3949
22061	3724	98	59	55	0	3936
22062	129	3618	35	61	0	3843
22063	73	116	35	3630	0	3854
22064	59	52	21	3665	0	3797
22065	50	24	31	3681	0	3786
22066	66	12	25	3696	0	3799
22067	37	11	3530	194	0	3772
22068	3455	10	135	99	0	3699
22069	3635	18	71	53	0	3777
22070	177	23	41	3523	0	3764
22071	3535	21	33	149	0	3738
22072	156	13	25	3553	0	3747
22073	80	14	3481	158	0	3733
22074	53	21	119	3459	0	3652
22075	62	3418	50	151	0	3681
22076	49	114	41	3436	0	3640
22077	33	3395	28	172	0	3628
22078	38	118	30	3325	0	3511
22079	38	3368	29	151	0	3586
22080	3317	122	20	86	0	3545
22081	138	49	3271	58	0	3516
22082	60	3137	123	58	0	3378
22083	42	3265	54	55	0	3416
22084	45	120	59	3095	0	3319
22085	48	38	23	3147	0	3256
22086	33	19	26	3193	0	3271
22087	29	17	41	3145	0	3232
22088	42	2969	32	162	0	3205
22089	48	107	21	3005	0	3181
22090	45	35	24	3086	0	3190
22091	2957	32	23	152	0	3164
22092	118	24	29	3015	0	3186
22093	59	30	2895	142	0	3126
22094	48	24	2862	80	0	3014
22095	2776	18	116	74	0	2984
22096	111	2810	52	54	0	3027
22097	36	2849	31	52	0	2968
22098	38	106	16	2728	0	2888
22099	28	63	18	2784	0	2893
22100	31	30	2631	141	0	2833
22101	2623	26	92	75	0	2816
22102	2730	33	39	56	0	2858
22103	109	25	2733	60	0	2927
22104	48	20	2710	75	0	2853
22105	2733	12	102	63	0	2910
22106	2818	8	42	73	0	2941
22107	2813	22	36	58	0	2929
22108	2771	16	25	52	0	2864
22109	129	2627	15	58	0	2829
22110	2539	75	11	50	0	2675
22111	98	40	2415	42	0	2595
22112	43	21	2257	45	0	2366
22113	24	26	2130	41	0	2221
22114	55	263	102	1252	0	1672
22115	1230	2	16	18	0	1266
22116	1222	3	3	6	0	1234
22117	12	1	6	1228	0	1247
22118	5	6	6	1192	0	1209
22119	5	3	0	1252	0	1260
22120	10	1313	2	12	0	1337
22121	1346	10	1	11	0	1368
22122	1366	4	2	10	0	1382
22123	1368	6	3	9	0	1386
22124	1381	4	2	5	0	1392
22125	1352	1	4	10	0	1367
22126	13	3	8	1340	0	1364
22127	8	1316	4	15	0	1343
22128	8	9	1	1308	0	1326
22129	6	6	3	1306	0	1321
22130	1283	2	2	13	0	1300
22131	11	2	1260	12	0	1285
22132	6	4	1201	1	0	1212
22133	2	1	1193	5	0	1201
22134	1281	1	21	5	0	1308
22135	1329	1	8	4	0	1342
22136	10	11	2	1352	0	1375
22137	3	1	1	1348	0	1353
22138	3	3	0	1397	0	1403
22139	3	0	1445	8	0	1456
22140	0	0	6	1420	0	1426
22141	2	2	1531	4	0	1539
22142	3	1	4	1530	0	1538
22143	3	0	2	1524	0	1529
22144	2	0	2	1564	0	1568
22145	1563	1	3	12	0	1579
22146	1569	0	1	8	0	1578
22147	7	2	1611	1	0	1621
22148	1600	0	5	7	0	1612
22149	1623	0	2	5	0	1630
22150	7	1	0	1654	0	1662
22151	1698	0	2	9	0	1709
22152	7	0	2	1717	0	1726
22153	4	0	2	1709	0	1715
22154	1	0	1683	9	0	1693
22155	1621	1	6	8	0	1636
22156	10	6	1	1696	0	1713
22157	2	2	1717	6	0	1727
22158	2	0	1746	3	0	1751
22159	6	0	8	1757	0	1771
22160	2	5	1	1795	0	1803
22161	1829	0	1	9	0	1839
22162	5	0	0	1850	0	1855
22163	3	1	0	1859	0	1863
22164	2	0	0	1885	0	1887
22165	2	0	1	1948	0	1951
22166	2016	0	1	13	0	2030
22167	2006	1	1	13	0	2021
22168	2119	1	1	9	0	2130
22169	2184	0	1	7	0	2192
22170	22	0	1	2337	0	2360
22171	2365	0	1	23	0	2389
22172	24	0	2	2386	0	2412
22173	2431	0	1	27	0	2459
22174	27	0	0	2430	0	2457
22175	11	1	2	2430	0	2444
22176	4	2410	3	33	0	2450
22177	6	26	0	2466	0	2498
22178	2479	7	0	39	0	2525
22179	2457	3	1	14	0	2475
22180	31	1	2467	7	0	2506
22181	15	2488	25	6	0	2534
22182	2517	24	6	9	0	2556
22183	29	2595	4	8	0	2636
22184	2595	29	1	17	0	2642
22185	29	2746	1	6	0	2782
22186	15	29	2771	4	0	2819
22187	11	2760	29	5	0	2805
22188	11	2788	9	5	0	2813
22189	7	35	5	2876	0	2923
22190	2910	10	2	34	0	2956
22191	37	6	1	2914	0	2958
22192	13	4	2	2950	0	2969
22193	2929	2	1	44	0	2976
22194	3005	6	4	26	0	3041
22195	43	3	4	3024	0	3074
22196	17	7	0	3047	0	3071
22197	11	3	2	3071	0	3087
22198	3009	1	3	50	0	3063
22199	34	4	3022	15	0	3075
22200	15	2	26	3020	0	3063
22201	14	5	3071	33	0	3123
22202	14	3024	29	10	0	3077
22203	6	33	2958	11	0	3008
22204	8	11	30	2939	0	2988
22205	4	10	2999	35	0	3048
22206	2941	5	29	21	0	2996
22207	39	3	9	3088	0	3139
22208	12	3173	8	39	0	3232
22209	10	28	7	3227	0	3272
22210	7	3220	6	36	0	3269
22211	11	3261	5	14	0	3291
22212	9	3241	5	12	0	3267
22213	9	33	4	3162	0	3208
22214	5	3167	8	35	0	3215
22215	3138	33	3	22	0	3196
22216	34	16	3070	15	0	3135
22217	15	14	3021	9	0	3059
22218	15	12	3132	10	0	3169
22219	9	8	39	3190	0	3246
22220	9	14	11	3105	0	3139
22221	8	10	7	3118	0	3143
22222	12	7	5	3161	0	3185
22223	19	8	5	3032	0	3064
22224	12	3233	8	52	0	3305
22225	7	33	3224	20	0	3284
22226	19	12	3131	13	0	3175
22227	15	3258	39	18	0	3330
22228	17	29	14	3325	0	3385
22229	22	11	5	3356	0	3394
22230	14	8	6	3315	0	3343
22231	3280	11	3	63	0	3357
22232	41	9	3263	34	0	3347
22233	3221	11	30	28	0	3290
22234	3240	8	18	24	0	3290
22235	40	3163	14	23	0	3240
22236	18	3281	9	17	0	3325
22237	3344	35	10	23	0	3412
22238	49	17	10	3343	0	3419
22239	24	14	7	3438	0	3483
22240	19	11	3498	46	0	3574
22241	15	22	3432	27	0	3496
22242	21	11	45	3568	0	3645
22243	3598	20	20	55	0	3693
22244	45	22	3741	17	0	3825
22245	3859	21	48	37	0	3965
22246	58	18	18	4077	0	4171
22247	24	18	11	4279	0	4332
22248	34	12	11	4414	0	4471
22249	13	12	4379	87	0	4491
22250	16	4233	64	48	0	4361
22251	14	4450	21	41	0	4526
22252	4486	73	15	34	0	4608
22253	4607	25	14	30	0	4676
22254	97	14	9	4627	0	4747
22255	4655	11	12	108	0	4786
22256	87	8	4571	50	0	4716
22257	34	10	4527	33	0	4604
22258	27	14	86	4464	0	4591
22259	4554	14	41	86	0	4695
22260	74	18	26	4583	0	4701
22261	39	11	24	4677	0	4751
22262	4629	11	17	118	0	4775
22263	4691	9	22	57	0	4779
22264	96	4917	21	49	0	5083
22265	5035	72	19	42	0	5168
22266	116	37	18	5050	0	5221
22267	35	5145	13	104	0	5297
22268	5115	82	12	40	0	5249
22269	91	5093	11	38	0	5233
22270	41	79	15	4972	0	5107
22271	4962	20	8	87	0	5077
22272	94	19	4860	25	0	4998
22273	29	10	4802	22	0	4863
22274	30	13	76	4771	0	4890
22275	24	4	26	4864	0	4918
22276	27	9	14	4774	0	4824
22277	10	4886	10	90	0	4996
22278	4972	74	4	50	0	5100
22279	5036	21	6	36	0	5099
22280	5052	21	8	30	0	5111
22281	109	5276	9	14	0	5408
22282	51	85	12	5835	0	5983
22283	39	20	12	5877	0	5948
22284	32	23	9	5936	0	6000
22285	5615	14	13	155	0	5797
22286	115	5599	19	55	0	5788
22287	59	112	8	5650	0	5829
22288	51	33	3	5750	0	5837
22289	32	21	5551	157	0	5761
22290	22	5526	102	59	0	5709
22291	39	118	33	5528	0	5718
22292	41	36	21	5623	0	5721
22293	38	26	14	5622	0	5700
22294	5371	28	8	191	0	5598
22295	124	5397	8	88	0	5617
22296	5450	120	11	78	0	5659
22297	153	40	10	5448	0	5651
22298	5472	30	13	161	0	5676
22299	139	29	5417	69	0	5654
22300	5451	27	110	69	0	5657
22301	5577	14	38	80	0	5709
22302	153	22	5534	61	0	5770
22303	75	31	112	5603	0	5821
22304	59	27	35	5589	0	5710
22305	5676	21	19	183	0	5899
22306	154	14	16	5678	0	5862
22307	73	27	20	5679	0	5799
22308	59	23	17	5677	0	5776
22309	53	23	5441	178	0	5695
22310	5204	16	112	116	0	5448
22311	146	5454	45	67	0	5712
22312	73	120	34	5477	0	5704
22313	56	5483	24	148	0	5711
22314	52	5782	18	80	0	5932
22315	57	142	17	5776	0	5992
22316	35	56	5705	175	0	5971
22317	35	40	5722	94	0	5891
22318	57	21	144	5762	0	5984
22319	39	24	5766	178	0	6007
22320	5685	28	139	105	0	5957
22321	147	33	50	5854	0	6084
22322	75	23	30	5931	0	6059
22323	45	5856	27	204	0	6132
22324	53	146	22	5846	0	6067
22325	40	57	27	5835	0	5959
22326	18	5675	34	220	0	5947
22327	44	130	27	5840	0	6041
22328	40	48	31	5837	0	5956
22329	32	5716	44	207	0	5999
22330	5758	148	31	111	0	6048
22331	154	67	5721	80	0	6022
22332	80	42	5625	76	0	5823
22333	58	63	157	5658	0	5936
22334	55	35	55	5819	0	5964
22335	38	30	5622	221	0	5911
22336	40	34	5512	109	0	5695
22337	5208	26	157	110	0	5501
22338	141	5457	53	87	0	5738
22339	5394	137	38	90	0	5659
22340	150	56	5361	91	0	5658
22341	64	5318	124	83	0	5589
22342	62	173	62	5386	0	5683
22343	40	62	5444	169	0	5715
22344	34	33	5319	98	0	5484
22345	50	70	168	5323	0	5611
22346	28	27	5297	191	0	5543
22347	25	5077	147	96	0	5345
22348	35	146	63	5011	0	5255
22349	34	59	5075	162	0	5330
22350	38	5142	152	88	0	5420
22351	5124	140	64	61	0	5389
22352	146	64	5089	61	0	5360
22353	65	5111	143	48	0	5367
22354	48	135	72	5044	0	5299
22355	43	52	48	5264	0	5407
22356	5171	40	52	187	0	5450
22357	150	32	24	5174	0	5380
22358	75	24	42	5278	0	5419
22359	5090	23	48	203	0	5364
22360	138	31	24	5142	0	5335
22361	56	25	5003	186	0	5270
22362	52	38	141	4999	0	5230
22363	36	25	4996	175	0	5232
22364	27	21	4671	93	0	4812
22365	25	22	4685	67	0	4799
22366	46	35	183	4374	0	4638
22367	35	16	82	4505	0	4638
22368	4416	20	33	169	0	4638
22369	114	14	32	4347	0	4507
22370	57	4476	32	144	0	4709
22371	39	101	28	4661	0	4829
22372	35	41	31	4611	0	4718
22373	16	4602	35	157	0	4810
22374	4572	99	34	97	0	4802
22375	4563	45	36	67	0	4711
22376	126	4461	39	51	0	4677
22377	60	4446	27	54	0	4587
22378	48	260	33	4261	0	4602
22379	4371	63	37	129	0	4600
22380	112	39	4366	70	0	4587
22381	52	28	3977	52	0	4109
22382	3483	16	78	34	0	3611
22383	68	3598	43	18	0	3727
22384	32	58	26	3641	0	3757
22385	23	35	23	3596	0	3677
22386	16	21	14	3681	0	3732
22387	20	13	11	3727	0	3771
22388	11	3649	12	94	0	3766
22389	14	56	8	3744	0	3822
22390	3724	28	7	82	0	3841
22391	63	17	8	3793	0	3881
22392	34	15	8	3838	0	3895
22393	3825	8	10	107	0	3950
22394	3856	9	8	62	0	3935
22395	3910	7	11	43	0	3971
22396	3918	8	8	40	0	3974
22397	106	9	14	3862	0	3991
22398	3894	9	6	82	0	3991
22399	77	8	11	3831	0	3927
22400	3777	9	10	90	0	3886
22401	3773	5	14	55	0	3847
22402	96	3	15	3703	0	3817
22403	47	12	3708	77	0	3844
22404	3757	6	55	54	0	3872
22405	3835	5	29	43	0	3912
22406	3889	7	16	35	0	3947
22407	3964	8	11	35	0	4018
22408	99	6	6	3938	0	4049
22409	59	10	3916	65	0	4050
22410	40	9	3833	46	0	3928
22411	3849	9	69	35	0	3962
22412	3952	10	38	29	0	4029
22413	89	3894	24	18	0	4025
22414	45	3835	15	21	0	3916
22415	3912	56	17	25	0	4010
22416	74	36	14	3819	0	3943
22417	50	22	10	3935	0	4017
22418	3896	9	9	72	0	3986
22419	63	3930	13	40	0	4046
22420	4018	46	6	49	0	4119
22421	67	21	3953	27	0	4068
22422	3936	16	47	24	0	4023
22423	66	10	23	3956	0	4055
22424	40	9	4053	59	0	4161
22425	25	4055	50	37	0	4167
22426	30	46	22	4197	0	4295
22427	21	22	4390	63	0	4496
22428	27	24	49	4368	0	4468
22429	4493	11	29	85	0	4618
22430	69	10	4444	46	0	4569
22431	4408	7	55	37	0	4507
22432	74	4554	38	22	0	4688
22433	56	52	19	4654	0	4781
22434	39	37	4872	56	0	5004
22435	35	15	63	4847	0	4960
22436	23	14	4989	73	0	5099
22437	25	4887	66	51	0	5029
22438	4830	51	40	41	0	4962
22439	70	4927	23	21	0	5041
22440	50	69	12	4853	0	4984
22441	28	37	16	4885	0	4966
22442	23	18	4727	79	0	4847
22443	4119	20	50	67	0	4256
22444	57	4506	40	33	0	4636
22445	26	4276	18	13	0	4333
22446	21	4350	7	13	0	4391
22447	31	85	16	4209	0	4341
22448	5	4237	8	35	0	4285
22449	18	41	6	4140	0	4205
22450	5	4071	9	21	0	4106
22451	11	50	3	3979	0	4043
22452	3	4001	3	25	0	4032
22453	3938	26	4	27	0	3995
22454	23	22	3895	6	0	3946
22455	3780	8	28	23	0	3839
22456	3931	9	14	10	0	3964
22457	4009	3	3	18	0	4033
22458	33	4016	5	4	0	4058
22459	4089	21	2	12	0	4124
22460	4085	19	2	10	0	4116
22461	4083	1	3	23	0	4110
22462	40	4	4032	5	0	4081
22463	29	3	25	4088	0	4145
22464	15	4	4217	22	0	4258
22465	19	4	24	4139	0	4186
22466	4169	11	17	37	0	4234
22467	34	4142	4	21	0	4201
22468	28	24	4525	7	0	4584
22469	29	20	40	4489	0	4578
22470	6	3	25	4866	0	4900
22471	4	8	5410	86	0	5508
22472	5414	9	81	38	0	5542
22473	5724	6	33	21	0	5784
22474	5864	8	14	13	0	5899
22475	145	7	13	5756	0	5921
22476	54	5542	13	106	0	5715
22477	24	5922	13	50	0	6009
22478	34	121	15	5889	0	6059
22479	30	50	11	5857	0	5948
22480	29	5785	5	121	0	5940
22481	5807	108	6	55	0	5976
22482	108	5775	5	31	0	5919
22483	54	115	5	5690	0	5864
22484	19	60	5653	117	0	5849
22485	28	26	96	5617	0	5767
22486	5683	18	35	138	0	5874
22487	115	24	5643	58	0	5840
22488	5726	21	99	36	0	5882
22489	5886	29	42	33	0	5990
22490	5925	26	16	30	0	5997
22491	5896	14	21	37	0	5968
22492	6011	5	15	40	0	6071
22493	166	15	5737	21	0	5939
22494	94	17	5722	13	0	5846
22495	6082	15	131	21	0	6249
22496	6315	12	52	20	0	6399
22497	195	10	25	6478	0	6708
22498	89	6549	20	133	0	6791
22499	64	134	19	6761	0	6978
22500	6914	52	26	164	0	7156
22501	174	29	26	6716	0	6945
22502	91	6909	16	151	0	7167
22503	6915	141	13	89	0	7158
22504	6825	63	7	64	0	6959
22505	6879	35	10	53	0	6977
22506	219	6687	23	46	0	6975
22507	119	138	22	6683	0	6962
22508	91	58	16	6690	0	6855
22509	67	6419	15	193	0	6694
22510	73	154	5	6614	0	6846
22511	6536	74	4	182	0	6796
22512	6584	42	10	103	0	6739
22513	226	6416	12	51	0	6705
22514	109	154	5	6491	0	6759
22515	70	66	14	6573	0	6723
22516	72	43	13	6643	0	6771
22517	6355	48	17	233	0	6653
22518	186	24	6210	122	0	6542
22519	6088	25	145	78	0	6336
22520	195	43	6180	69	0	6487
22521	113	41	140	6045	0	6339
22522	69	6001	74	185	0	6329
22523	74	6342	27	112	0	6555
22524	6144	188	22	88	0	6442
22525	6194	74	31	71	0	6370
22526	230	5964	37	54	0	6285
22527	106	5989	25	63	0	6183
22528	5989	178	23	73	0	6263
22529	6213	92	33	78	0	6416
22530	230	6295	18	43	0	6586
22531	6433	190	28	51	0	6702
22532	226	84	6296	44	0	6650
22533	6355	62	141	44	0	6602
22534	6392	76	58	47	0	6573
22535	267	53	28	6219	0	6567
22536	148	6174	28	157	0	6507
22537	115	182	21	6313	0	6631
22538	6492	81	15	190	0	6778
22539	244	37	25	6350	0	6656
22540	147	44	24	6488	0	6703
22541	115	57	6464	215	0	6851
22542	114	23	148	6583	0	6868
22543	80	41	67	6745	0	6933
22544	6635	43	35	256	0	6969
22545	223	39	6545	116	0	6923
22546	6581	32	167	112	0	6892
22547	233	44	52	6653	0	6982
22548	121	34	46	6744	0	6945
22549	91	36	37	6755	0	6919
22550	67	6427	29	267	0	6790
22551	82	6670	24	132	0	6908
22552	97	191	40	6654	0	6982
22553	6681	69	25	226	0	7001
22554	6781	53	24	122	0	6980
22555	252	54	26	6675	0	7007
22556	6674	31	28	234	0	6967
22557	247	39	18	6684	0	6988
22558	131	58	16	6800	0	7005
22559	6521	42	16	272	0	6851
22560	214	6762	23	127	0	7126
22561	6775	166	15	97	0	7053
22562	6775	75	12	100	0	6962
22563	6689	36	7	104	0	6836
22564	236	6531	19	79	0	6865
22565	118	190	16	6680	0	7004
22566	121	66	22	6784	0	6993
22567	102	42	6470	235	0	6849
22568	109	73	133	6181	0	6496
22569	89	32	6010	195	0	6326
22570	66	5601	133	90	0	5890
22571	48	4949	40	58	0	5095
22572	39	4882	24	46	0	4991
22573	70	102	45	4887	0	5104
22574	53	47	25	4900	0	5025
22575	26	31	14	4879	0	4950
22576	24	20	7	4932	0	4983
22577	21	19	4935	134	0	5109
22578	16	37	5895	67	0	6015
22579	25	31	123	6328	0	6507
22580	17	22	6511	155	0	6705
22581	6484	18	130	78	0	6710
22582	6620	15	44	63	0	6742
22583	157	23	6518	56	0	6754
22584	74	6	139	6554	0	6773
22585	54	10	52	6674	0	6790
22586	52	8	33	6731	0	6824
22587	55	11	26	6637	0	6729
22588	45	17	33	6714	0	6809
22589	4940	55	42	254	0	5291
22590	6631	11	18	116	0	6776
22591	156	6567	28	75	0	6826
22592	63	129	6372	60	0	6624
22593	49	6326	124	62	0	6561
22594	41	6492	39	60	0	6632
22595	6138	141	26	55	0	6360
22596	120	6104	22	47	0	6293
22597	38	5845	13	28	0	5924
22598	5713	117	33	27	0	5890
22599	111	42	5629	28	0	5810
22600	5433	18	92	24	0	5567
22601	108	17	23	5568	0	5716
22602	35	14	14	5531	0	5594
22603	33	9	10	5559	0	5611
22604	24	10	5362	126	0	5522
22605	23	5392	98	51	0	5564
22606	5414	86	24	47	0	5571
22607	103	17	12	5493	0	5625
22608	25	5551	16	116	0	5708
22609	17	100	18	5767	0	5902
22610	21	26	5669	127	0	5843
22611	33	32	107	5729	0	5901
22612	36	21	23	5882	0	5962
22613	34	20	15	5910	0	5979
22614	5827	15	18	163	0	6023
22615	127	10	15	5906	0	6058
22616	35	10	5800	163	0	6008
22617	22	5819	117	68	0	6026
22618	39	108	24	5931	0	6102
22619	35	33	24	5947	0	6039
22620	27	26	5842	155	0	6050
22621	29	20	5708	68	0	5825
22622	5660	30	156	52	0	5898
22623	5620	26	46	63	0	5755
22624	138	5646	41	50	0	5875
22625	5630	111	30	56	0	5827
22626	144	36	5601	39	0	5820
22627	51	21	5544	50	0	5666
22628	5483	31	133	71	0	5718
22629	5362	23	57	83	0	5525
22630	130	26	5158	66	0	5380
22631	5027	20	113	59	0	5219
22632	141	16	5061	39	0	5257
22633	5019	31	125	37	0	5212
22634	5069	36	40	28	0	5173
22635	146	45	43	4788	0	5022
22636	55	5058	37	114	0	5264
22637	3928	137	83	97	0	4245
22638	111	50	4966	42	0	5169
22639	59	4979	121	31	0	5190
22640	5018	136	32	55	0	5241
22641	4777	58	35	62	0	4932
22642	153	4754	33	48	0	4988
22643	70	110	38	4832	0	5050
22644	53	30	4728	144	0	4955
22645	47	36	125	4774	0	4982
22646	49	23	4714	172	0	4958
22647	36	37	130	4734	0	4937
22648	32	28	59	4805	0	4924
22649	35	38	4644	166	0	4883
22650	40	4669	132	85	0	4926
22651	56	117	39	4669	0	4881
22652	52	67	3597	176	0	3892
22653	4619	40	98	91	0	4848
22654	131	29	53	4700	0	4913
22655	52	32	38	4798	0	4920
22656	4664	23	39	188	0	4914
22657	144	20	34	4606	0	4804
22658	90	23	40	4541	0	4694
22659	65	4504	31	157	0	4757
22660	52	125	39	4458	0	4674
22661	36	67	4393	149	0	4645
22662	57	31	129	4287	0	4504
22663	40	4240	61	158	0	4499
22664	40	4376	63	60	0	4539
22665	54	125	37	4319	0	4535
22666	4307	44	48	139	0	4538
22667	146	42	44	4318	0	4550
22668	4353	46	36	134	0	4569
22669	151	32	47	4355	0	4585
22670	4338	27	49	145	0	4559
22671	4483	16	36	81	0	4616
22672	172	57	43	4300	0	4572
22673	114	164	43	4204	0	4525
22674	70	4120	60	145	0	4395
22675	66	4289	46	81	0	4482
22676	70	126	4173	61	0	4430
22677	66	3996	109	69	0	4240
22678	2651	156	109	53	0	2969
22679	99	38	32	2482	0	2651
22680	25	2378	17	62	0	2482
22681	2437	51	15	34	0	2537
22682	68	24	8	2465	0	2565
22683	30	11	14	2433	0	2488
22684	22	7	21	2464	0	2514
22685	18	14	16	2472	0	2520
22686	15	2401	20	84	0	2520
22687	19	2582	10	37	0	2648
22688	2660	59	9	23	0	2751
22689	64	2716	13	16	0	2809
22690	27	45	7	2686	0	2765
22691	18	18	9	2725	0	2770
22692	18	12	5	2743	0	2778
22693	22	10	4	2756	0	2792
22694	2691	11	12	74	0	2788
22695	2760	7	10	40	0	2817
22696	77	11	2692	22	0	2802
22697	33	5	53	2736	0	2827
22698	20	12	2793	66	0	2891
22699	24	9	57	2780	0	2870
22700	16	14	23	2828	0	2881
22701	2838	11	10	79	0	2938
22702	71	8	8	2891	0	2978
22703	24	10	2880	73	0	2987
22704	26	10	2791	38	0	2865
22705	2839	4	70	30	0	2943
22706	65	12	2898	23	0	2998
22707	31	26	59	2769	0	2885
22708	16	4	2787	65	0	2872
22709	10	16	48	2642	0	2716
22710	7	2644	22	62	0	2735
22711	15	45	15	2610	0	2685
22712	10	2589	4	60	0	2663
22713	6	2652	14	27	0	2699
22714	10	48	6	2563	0	2627
22715	2494	20	6	44	0	2564
22716	36	2571	3	30	0	2640
22717	19	43	5	2556	0	2623
22718	2547	21	4	50	0	2622
22719	2567	4	2	31	0	2604
22720	2602	6	2	18	0	2628
22721	51	6	3	2563	0	2623
22722	20	8	4	2608	0	2640
22723	2591	7	3	58	0	2659
22724	2589	2	6	33	0	2630
22725	2639	5	5	20	0	2669
22726	56	6	5	2610	0	2677
22727	19	5	2562	40	0	2626
22728	2526	4	30	32	0	2592
22729	43	2	15	2517	0	2577
22730	24	2565	4	41	0	2634
22731	19	41	1	2553	0	2614
22732	8	2524	5	41	0	2578
22733	16	32	2	2564	0	2614
22734	8	17	2463	41	0	2529
22735	6	2422	28	23	0	2479
22736	10	23	11	2291	0	2335
22737	10	16	7	2299	0	2332
22738	7	4	1	2299	0	2311
22739	2332	4	2	47	0	2385
22740	32	2389	2	25	0	2448
22741	18	38	4	2461	0	2521
22742	2501	20	4	48	0	2573
22743	2549	6	1	31	0	2587
22744	61	4	3	2575	0	2643
22745	22	5	2708	43	0	2778
22746	16	2	40	2693	0	2751
22747	8	2676	19	54	0	2757
22748	19	45	4	2747	0	2815
22749	2706	18	1	56	0	2781
22750	57	5	6	2791	0	2859
22751	20	5	2883	64	0	2972
22752	13	3054	49	26	0	3142
22753	3101	50	18	21	0	3190
22754	58	23	3136	15	0	3232
22755	3226	8	61	17	0	3312
22756	62	5	23	3371	0	3461
22757	31	11	7	3437	0	3486
22758	12	3421	5	84	0	3522
22759	3550	61	8	41	0	3660
22760	75	27	3	3604	0	3709
22761	35	14	7	3718	0	3774
22762	28	5	3	3808	0	3844
22763	9	9	3778	97	0	3893
22764	20	3	66	3775	0	3864
22765	3824	8	23	91	0	3946
22766	3894	2	11	54	0	3961
22767	93	3	3	3859	0	3958
22768	45	6	4	3899	0	3954
22769	3834	5	5	100	0	3944
22770	74	6	3754	40	0	3874
22771	3750	5	59	37	0	3851
22772	81	7	3729	17	0	3834
22773	33	7	3760	18	0	3818
22774	30	4	83	3782	0	3899
22775	15	3	3862	78	0	3958
22776	3861	10	70	34	0	3975
22777	73	4	26	4022	0	4125
22778	29	4	4048	74	0	4155
22779	4012	10	71	36	0	4129
22780	4113	1	33	31	0	4178
22781	92	6	4227	16	0	4341
22782	45	16	69	4098	0	4228
22783	20	4223	38	61	0	4342
22784	4291	59	19	30	0	4399
22785	72	22	4266	26	0	4386
22786	4089	10	63	18	0	4180
22787	82	4199	21	20	0	4322
22788	4071	53	35	21	0	4180
22789	4111	17	5	29	0	4162
22790	4166	9	20	19	0	4214
22791	85	7	16	4181	0	4289
22792	30	4188	9	60	0	4287
22793	22	54	4154	22	0	4252
22794	20	4227	56	15	0	4318
22795	28	58	24	3974	0	4084
22796	16	4133	15	46	0	4210
22797	14	4238	10	20	0	4282
22798	4132	64	13	20	0	4229
22799	55	34	4140	8	0	4237
22800	28	16	4236	12	0	4292
22801	27	9	4192	10	0	4238
22802	11	4286	61	15	0	4373
22803	4327	53	25	21	0	4426
22804	4346	23	10	14	0	4393
22805	4338	13	9	15	0	4375
22806	79	4295	12	14	0	4400
22807	35	51	7	4522	0	4615
22808	18	24	4548	65	0	4655
22809	21	23	4417	20	0	4481
22810	4620	9	61	25	0	4715
22811	4768	5	22	24	0	4819
22812	4790	10	16	24	0	4840
22813	84	14	4598	15	0	4711
22814	4661	4	60	27	0	4752
22815	76	7	27	4717	0	4827
22816	37	3	17	4748	0	4805
22817	25	11	4886	76	0	4998
22818	18	4896	57	38	0	5009
22819	19	53	21	5028	0	5121
22820	25	17	4941	70	0	5053
22821	4804	12	66	45	0	4927
22822	73	5	28	5065	0	5171
22823	36	6	21	5117	0	5180
22824	5076	5	20	88	0	5189
22825	71	7	14	5098	0	5190
22826	5090	2	14	83	0	5189
22827	5112	4	19	46	0	5181
22828	90	1	13	5126	0	5230
22829	45	6	16	5196	0	5263
22830	5188	2	18	96	0	5304
22831	80	1	19	5305	0	5405
22832	5356	2	18	86	0	5462
22833	5351	6	20	41	0	5418
22834	5365	8	13	38	0	5424
22835	100	4	20	5332	0	5456
22836	52	6	23	5371	0	5452
22837	5376	4	15	92	0	5487
22838	69	5239	27	35	0	5370
22839	39	5194	29	18	0	5280
22840	5190	45	14	21	0	5270
22841	60	25	5109	13	0	5207
22842	5097	15	45	27	0	5184
22843	70	6	15	5325	0	5416
22844	31	13	5271	41	0	5356
22845	5165	3	37	32	0	5237
22846	47	9	21	5370	0	5447
22847	32	8	11	5436	0	5487
22848	35	11	7	5587	0	5640
22849	35	5	6	5601	0	5647
22850	5560	8	17	68	0	5653
22851	45	5395	12	19	0	5471
22852	5225	34	7	26	0	5292
22853	44	14	5161	5	0	5224
22854	21	11	4908	7	0	4947
22855	19	5133	26	9	0	5187
22856	28	68	27	5024	0	5147
22857	6	10	5020	20	0	5056
22858	11	4651	17	4	0	4683
22859	5	11	4806	6	0	4828
22860	6	4	9	4738	0	4757
22861	5	1	2	4769	0	4777
22862	4865	1	0	27	0	4893
22863	14	0	1	4826	0	4841
22864	4803	1	0	27	0	4831
22865	9	5	4833	2	0	4849
22866	2	4945	10	2	0	4959
22867	4	7	1	5103	0	5115
22868	8	1	0	5357	0	5366
22869	5	0	5354	7	0	5366
22870	4	9	4971	2	0	4986
22871	5069	0	9	12	0	5090
22872	5353	0	2	12	0	5367
22873	12	0	1	5369	0	5382
22874	7	1	0	5333	0	5341
22875	0	5237	1	9	0	5247
22876	2	9	1	5357	0	5369
22877	5351	2	0	27	0	5380
22878	5369	0	2	20	0	5391
22879	15	5366	2	1	0	5384
22880	5431	13	0	17	0	5461
22881	5319	3	1	14	0	5337
22882	26	0	1	5815	0	5842
22883	6	5825	4	46	0	5881
22884	9	46	1	5978	0	6034
22885	9	15	0	6015	0	6039
22886	5	3	5854	68	0	5930
22887	5816	3	54	24	0	5897
22888	81	8	12	6277	0	6378
22889	27	1	3	6670	0	6701
22890	8	7615	5	105	0	7733
22891	25	129	2	8391	0	8547
22892	8741	25	1	196	0	8963
22893	9727	10	1	62	0	9800
22894	261	22	9616	31	0	9930
22895	70	16	9809	25	0	9920
22896	74	9	271	9936	0	10290
22897	57	11	69	10404	0	10541
22898	38	7	10210	306	0	10561
22899	48	6	10201	99	0	10354
22900	59	4	326	9850	0	10239
22901	26	2	10251	285	0	10564
22902	22	7	10324	106	0	10459
22903	25	2	343	10098	0	10468
22904	10208	1	137	320	0	10666
22905	10502	6	95	124	0	10727
22906	326	3	72	10303	0	10704
22907	123	6	75	10392	0	10596
22908	10088	4	79	357	0	10528
22909	300	3	52	10056	0	10411
22910	9935	4	51	340	0	10330
22911	10116	3	38	146	0	10303
22912	372	7	31	9960	0	10370
22913	168	16	33	10169	0	10386
22914	9842	9	23	390	0	10264
22915	311	9647	24	184	0	10166
22916	148	9910	35	119	0	10212
22917	142	284	33	9675	0	10134
22918	84	81	9563	331	0	10059
22919	89	45	257	9652	0	10043
22920	9597	31	85	364	0	10077
22921	303	37	50	9700	0	10090
22922	9697	46	49	366	0	10158
22923	320	34	9637	171	0	10162
22924	9847	32	277	140	0	10296
22925	331	26	107	10007	0	10471
22926	170	14	69	10291	0	10544
22927	111	20	10297	391	0	10819
22928	139	15	260	10369	0	10783
22929	106	14	117	10628	0	10865
22930	100	14	71	10726	0	10911
22931	10370	14	47	463	0	10894
22932	325	28	10194	222	0	10769
22933	140	24	10197	170	0	10531
22934	10249	13	323	177	0	10762
22935	10534	5	127	163	0	10829
22936	386	20	10467	140	0	11013
22937	199	17	318	10249	0	10783
22938	126	10419	140	345	0	11030
22939	115	254	126	10784	0	11279
22940	10664	73	112	396	0	11245
22941	10878	36	120	207	0	11241
22942	404	36	134	10584	0	11158
22943	179	10383	114	393	0	11069
22944	143	270	109	10342	0	10864
22945	121	10429	109	398	0	11057
22946	10495	292	100	241	0	11128
22947	10247	104	92	187	0	10630
22948	10392	48	94	203	0	10737
22949	426	9721	100	182	0	10429
22950	206	10178	94	181	0	10659
22951	175	332	79	10292	0	10878
22952	188	122	65	10449	0	10824
22953	187	71	68	10353	0	10679
22954	179	61	52	10528	0	10820
22955	173	66	9947	484	0	10670
22956	9753	67	301	286	0	10407
22957	397	68	10065	223	0	10753
22958	10254	55	314	225	0	10848
22959	414	63	10486	205	0	11168
22960	10552	50	345	235	0	11182
22961	414	50	10692	212	0	11368
22962	10587	54	351	191	0	11183
22963	451	44	171	10776	0	11442
22964	10913	39	131	426	0	11509
22965	463	40	122	10878	0	11503
22966	265	44	96	11021	0	11426
22967	185	38	120	10803	0	11146
22968	189	10179	105	501	0	10974
22969	10382	269	83	289	0	11023
22970	10531	94	82	241	0	10948
22971	484	10263	71	232	0	11050
22972	253	300	69	10545	0	11167
22973	176	119	10230	469	0	10994
22974	10258	79	326	273	0	10936
22975	10672	63	128	228	0	11091
22976	10638	52	95	204	0	10989
22977	501	70	91	10131	0	10793
22978	261	9958	99	406	0	10724
22979	213	291	102	10156	0	10762
22980	10112	120	89	415	0	10736
22981	471	57	92	9772	0	10392
22982	230	9334	89	338	0	9991
22983	9378	254	80	212	0	9924
22984	397	109	9262	155	0	9923
22985	250	84	9164	149	0	9647
22986	168	9048	308	171	0	9695
22987	136	9171	120	142	0	9569
22988	234	288	8599	136	0	9257
22989	243	144	8110	115	0	8612
22990	175	589	258	6135	0	7157
22991	6426	56	110	170	0	6762
22992	154	50	6190	69	0	6463
22993	42	5430	74	42	0	5588
22994	5284	63	90	34	0	5471
22995	67	5216	18	18	0	5319
22996	5006	47	6	14	0	5073
22997	47	4925	12	8	0	4992
22998	18	5012	10	11	0	5051
22999	26	45	12	5066	0	5149
23000	14	20	17	5025	0	5076
23001	11	11	4815	39	0	4876
23002	14	7	30	4753	0	4804
23003	4808	11	12	54	0	4885
23004	4821	3	4	43	0	4871
23005	47	7	3	4758	0	4815
23006	16	7	4690	36	0	4749
23007	10	12	4519	20	0	4561
23008	23	2	38	4714	0	4777
23009	10	7	4813	37	0	4867
23010	9	3	36	4792	0	4840
23011	26	4	17	4655	0	4702
23012	7	7	5012	45	0	5071
23013	4799	2	52	38	0	4891
23014	5021	5	14	32	0	5072
23015	57	8	5052	10	0	5127
23016	24	7	5048	15	0	5094
23017	18	3	79	5223	0	5323
23018	22	5	25	5572	0	5624
23019	21	2	15	5702	0	5740
23020	20	8	10	5599	0	5637
23021	5685	2	11	121	0	5819
23022	5845	6	7	48	0	5906
23023	102	6	8	6181	0	6297
23024	44	3	6	6420	0	6473
23025	21	8	6833	131	0	6993
23026	31	5	129	7042	0	7207
23027	32	1	45	7402	0	7480
23028	7788	0	28	251	0	8067
23029	193	8471	14	94	0	8772
23030	80	222	12	8560	0	8874
23031	45	64	11	8720	0	8840
23032	29	36	10	8630	0	8705
23033	14	7777	15	373	0	8179
23034	19	8450	17	141	0	8627
23035	32	263	9	8442	0	8746
23036	25	88	11	8405	0	8529
23037	22	46	17	8497	0	8582
23038	7960	36	7	392	0	8395
23039	220	8033	12	162	0	8427
23040	8136	238	10	101	0	8485
23041	8319	85	5	84	0	8493
23042	313	58	4	8032	0	8407
23043	113	7942	15	278	0	8348
23044	8004	233	15	146	0	8398
23045	262	95	2	8075	0	8434
23046	8084	56	5	300	0	8445
23047	309	34	5	8151	0	8499
23048	110	48	7964	310	0	8432
23049	79	36	8100	138	0	8353
23050	71	28	277	8069	0	8445
23051	59	26	95	8195	0	8375
23052	66	29	47	8118	0	8260
23053	63	7701	34	347	0	8145
23054	43	8191	29	171	0	8434
23055	8022	285	21	118	0	8446
23056	8099	109	23	117	0	8348
23057	304	7917	28	97	0	8346
23058	122	7781	24	78	0	8005
23059	67	7884	16	82	0	8049
23060	7343	312	16	90	0	7761
23061	232	7405	19	70	0	7726
23062	112	270	16	7402	0	7800
23063	7341	111	18	274	0	7744
23064	7454	75	13	127	0	7669
23065	329	57	11	7154	0	7551
23066	132	64	6983	269	0	7448
23067	84	63	7148	108	0	7403
23068	78	58	266	7139	0	7541
23069	57	46	7250	275	0	7628
23070	73	58	250	7227	0	7608
23071	75	41	80	7328	0	7524
23072	48	49	7153	329	0	7579
23073	52	49	7199	156	0	7456
23074	59	37	291	7119	0	7506
23075	55	31	134	7409	0	7629
23076	7053	40	89	360	0	7542
23077	242	6993	47	211	0	7493
23078	100	7365	47	153	0	7665
23079	7033	289	45	129	0	7496
23080	7338	136	53	122	0	7649
23081	318	7097	54	111	0	7580
23082	150	7316	44	115	0	7625
23083	7201	314	30	133	0	7678
23084	278	146	38	7159	0	7621
23085	7029	102	36	327	0	7494
23086	302	6980	37	204	0	7523
23087	7072	256	30	154	0	7512
23088	328	126	6893	109	0	7456
23089	6969	93	227	120	0	7409
23090	322	77	6929	124	0	7452
23091	165	83	260	6777	0	7285
23092	6743	67	104	324	0	7238
23093	309	63	6524	185	0	7081
23094	167	74	253	6607	0	7101
23095	6591	77	105	324	0	7097
23096	300	74	6500	189	0	7063
23097	156	64	250	6647	0	7117
23098	6477	65	96	348	0	6986
23099	303	6383	94	175	0	6955
23100	149	274	59	6585	0	7067
23101	144	123	42	6679	0	6988
23102	112	89	64	6751	0	7016
23103	108	6419	49	394	0	6970
23104	108	264	47	6730	0	7149
23105	100	131	45	6935	0	7211
23106	119	89	29	6958	0	7195
23107	140	63	45	7125	0	7373
23108	92	87	6726	427	0	7332
23109	6568	71	259	226	0	7124
23110	6889	67	113	166	0	7235
23111	375	6710	62	161	0	7308
23112	165	267	51	6652	0	7135
23113	123	142	41	6764	0	7070
23114	93	6521	56	398	0	7068
23115	78	234	65	6587	0	6964
23116	6278	82	56	371	0	6787
23117	234	6142	59	200	0	6635
23118	6022	239	56	141	0	6458
23119	280	99	46	6018	0	6443
23120	116	72	5885	310	0	6383
23121	69	5900	215	195	0	6379
23122	5607	230	126	146	0	6109
23123	221	5169	67	73	0	5530
23124	117	5074	50	61	0	5302
23125	4355	182	63	56	0	4656
23126	165	66	4193	63	0	4487
23127	52	3697	93	49	0	3891
23128	2756	177	199	106	0	3238
23129	2324	18	20	29	0	2391
23130	56	2282	4	8	0	2350
23131	22	49	2	2362	0	2435
23132	15	16	2378	43	0	2452
23133	10	12	36	2390	0	2448
23134	19	7	17	2324	0	2367
23135	13	11	9	2462	0	2495
23136	13	13	2429	53	0	2508
23137	14	14	39	2361	0	2428
23138	10	11	2409	47	0	2477
23139	14	11	2335	18	0	2378
23140	2191	7	56	17	0	2271
23141	37	2356	15	10	0	2418
23142	20	2402	7	7	0	2436
23143	17	44	6	2467	0	2534
23144	2726	22	4	64	0	2816
23145	2800	6	5	24	0	2835
23146	2761	6	11	16	0	2794
23147	2803	9	8	17	0	2837
23148	2739	4	9	21	0	2773
23149	67	3	2639	17	0	2726
23150	23	10	56	2657	0	2746
23151	13	2660	11	57	0	2741
23152	11	53	16	2722	0	2802
23153	2762	13	13	56	0	2844
23154	57	2736	10	20	0	2823
23155	20	55	5	2825	0	2905
23156	2848	22	7	59	0	2936
23157	2979	12	9	29	0	3029
23158	77	17	5	2938	0	3037
23159	40	7	8	2970	0	3025
23160	25	9	5	3015	0	3054
23161	22	5	2959	67	0	3053
23162	22	10	2987	21	0	3040
23163	17	8	68	3027	0	3120
23164	20	4	11	3106	0	3141
23165	3065	19	10	63	0	3157
23166	3064	12	6	39	0	3121
23167	3144	5	6	30	0	3185
23168	3286	18	7	27	0	3338
23169	3238	13	9	28	0	3288
23170	70	3254	2	20	0	3346
23171	3351	50	5	25	0	3431
23172	3352	16	3	36	0	3407
23173	3364	8	5	27	0	3404
23174	68	4	6	3481	0	3559
23175	23	7	3427	61	0	3518
23176	20	9	58	3498	0	3585
23177	25	3	3656	75	0	3759
23178	17	16	57	3570	0	3660
23179	17	3724	16	68	0	3825
23180	3745	50	6	25	0	3826
23181	3909	14	11	21	0	3955
23182	68	11	6	3967	0	4052
23183	29	6	4	4110	0	4149
23184	19	11	0	4133	0	4163
23185	21	4106	8	58	0	4193
23186	4153	46	3	35	0	4237
23187	4207	15	7	19	0	4248
23188	72	4178	7	16	0	4273
23189	30	51	8	4214	0	4303
23190	19	18	6	4176	0	4219
23191	12	4133	14	78	0	4237
23192	4227	51	4	39	0	4321
23193	4251	23	5	17	0	4296
23194	82	10	6	4218	0	4316
23195	36	9	4229	59	0	4333
23196	26	11	4070	25	0	4132
23197	27	4	63	4296	0	4390
23198	20	7	17	4310	0	4354
23199	16	13	5	4435	0	4469
23200	4385	6	10	97	0	4498
23201	4498	5	7	38	0	4548
23202	86	4693	6	21	0	4806
23203	4829	62	10	30	0	4931
23204	71	22	4825	22	0	4940
23205	35	13	4808	14	0	4870
23206	25	4976	81	10	0	5092
23207	4819	54	32	33	0	4938
23208	49	4798	9	12	0	4868
23209	4801	49	10	21	0	4881
23210	60	26	4777	4	0	4867
23211	44	10	4722	13	0	4789
23212	22	10	60	4710	0	4802
23213	14	7	4907	57	0	4985
23214	24	6	53	4898	0	4981
23215	46	7	28	4380	0	4461
23216	10	4909	12	68	0	4999
23217	26	43	9	5026	0	5104
23218	16	26	14	5051	0	5107
23219	5147	8	18	82	0	5255
23220	54	5145	11	42	0	5252
23221	41	52	12	5295	0	5400
23222	23	33	5253	69	0	5378
23223	4755	14	58	56	0	4883
23224	59	22	5239	24	0	5344
23225	43	8	65	5122	0	5238
23226	18	5327	31	67	0	5443
23227	23	59	22	5402	0	5506
23228	5650	28	14	81	0	5773
23229	5655	12	10	56	0	5733
23230	97	5917	12	30	0	6056
23231	6115	68	5	57	0	6245
23232	6113	40	11	44	0	6208
23233	6107	21	2	49	0	6179
23234	6315	20	7	28	0	6370
23235	5952	7	12	60	0	6031
23236	112	19	6113	17	0	6261
23237	67	12	80	6105	0	6264
23238	48	8	47	6032	0	6135
23239	36	11	14	6175	0	6236
23240	20	6123	15	111	0	6269
23241	34	74	16	6198	0	6322
23242	28	37	6191	90	0	6346
23243	32	6041	78	51	0	6202
23244	25	5922	34	29	0	6010
23245	36	89	23	5903	0	6051
23246	31	40	19	5901	0	5991
23247	27	26	17	5841	0	5911
23248	34	5672	13	107	0	5826
23249	35	5871	16	55	0	5977
23250	5862	95	11	45	0	6013
23251	5893	44	15	33	0	5985
23252	99	5957	23	31	0	6110
23253	6171	70	14	52	0	6307
23254	6430	46	13	61	0	6550
23255	115	27	12	6451	0	6605
23256	65	21	19	6522	0	6627
23257	50	17	18	6524	0	6609
23258	33	23	6407	113	0	6576
23259	32	28	6325	68	0	6453
23260	33	6712	99	46	0	6890
23261	6911	72	60	48	0	7091
23262	88	62	6938	39	0	7127
23263	6969	33	87	55	0	7144
23264	109	31	7508	31	0	7679
23265	7587	18	107	42	0	7754
23266	122	7855	66	29	0	8072
23267	7901	115	30	34	0	8080
23268	138	71	29	7717	0	7955
23269	91	35	22	7855	0	8003
23270	50	27	7674	162	0	7913
23271	44	7830	101	84	0	8059
23272	45	131	54	7939	0	8169
23273	42	70	7876	130	0	8118
23274	7310	37	115	93	0	7555
23275	122	7755	64	51	0	7992
23276	7692	108	36	60	0	7896
23277	121	7529	25	35	0	7710
23278	78	129	25	7604	0	7836
23279	7496	49	32	127	0	7704
23280	105	7535	35	61	0	7736
23281	71	104	27	7603	0	7805
23282	54	60	7433	117	0	7664
23283	7159	36	104	84	0	7383
23284	108	31	48	7452	0	7639
23285	67	30	7362	118	0	7577
23286	52	7354	89	63	0	7558
23287	41	104	49	7403	0	7597
23288	42	56	7404	115	0	7617
23289	60	35	98	7188	0	7381
23290	41	7395	55	107	0	7598
23291	41	7551	36	65	0	7693
23292	37	127	7504	41	0	7709
23293	55	69	89	7349	0	7562
23294	22	38	7582	109	0	7751
23295	7385	23	101	87	0	7596
23296	100	39	54	7478	0	7671
23297	51	7376	30	120	0	7577
23298	49	7691	23	42	0	7805
23299	7560	117	15	58	0	7750
23300	84	7733	30	33	0	7880
23301	7723	103	21	55	0	7902
23302	104	56	7427	25	0	7612
23303	7074	30	83	38	0	7225
23304	94	7260	46	25	0	7425
23305	7249	89	40	25	0	7403
23306	93	7192	22	14	0	7321
23307	59	97	13	7141	0	7310
23308	35	46	11	7371	0	7463
23309	27	28	7249	99	0	7403
23310	6877	19	81	76	0	7053
23311	86	21	7161	34	0	7302
23312	7250	27	88	23	0	7388
23313	108	26	39	7235	0	7408
23314	52	9	27	7404	0	7492
23315	25	7457	26	115	0	7623
23316	35	81	15	7867	0	7998
23317	29	47	29	7996	0	8101
23318	30	29	7869	138	0	8066
23319	7304	28	97	91	0	7520
23320	103	7707	48	53	0	7911
23321	7693	102	34	39	0	7868
23322	111	58	17	7684	0	7870
23323	65	26	12	7770	0	7873
23324	7664	18	30	157	0	7869
23325	120	7737	15	74	0	7946
23326	7586	95	18	51	0	7750
23327	120	7498	21	22	0	7661
23328	49	7350	9	15	0	7423
23329	7310	101	49	39	0	7499
23330	106	49	21	7040	0	7216
23331	47	41	6991	83	0	7162
23332	55	24	73	6900	0	7052
23333	24	28	42	6957	0	7051
23334	27	6901	28	114	0	7070
23335	28	84	14	7060	0	7186
23336	32	57	8	6981	0	7078
23337	36	32	11	7088	0	7167
23338	21	23	13	7164	0	7221
23339	21	20	7073	153	0	7267
23340	17	22	7103	77	0	7219
23341	19	22	110	7337	0	7488
23342	16	23	7346	116	0	7501
23343	19	16	7230	62	0	7327
23344	28	13	137	7418	0	7596
23345	19	22	7787	127	0	7955
23346	34	20	120	7523	0	7697
23347	12	7630	60	117	0	7819
23348	7821	99	37	85	0	8042
23349	100	53	8195	41	0	8389
23350	68	29	118	8095	0	8310
23351	30	27	8350	125	0	8532
23352	46	16	130	8838	0	9030
23353	26	20	67	9142	0	9255
23354	9104	14	42	258	0	9418
23355	204	19	30	9618	0	9871
23356	9297	18	25	279	0	9619
23357	9664	11	37	136	0	9848
23358	286	9568	28	75	0	9957
23359	9536	210	21	81	0	9848
23360	249	9300	32	40	0	9621
23361	103	9522	19	49	0	9693
23362	9248	260	23	59	0	9590
23363	254	109	9062	40	0	9465
23364	93	63	8701	39	0	8896
23365	8406	47	283	49	0	8785
23366	8518	25	111	55	0	8709
23367	262	8508	59	31	0	8860
23368	8705	185	30	60	0	8980
23369	8839	92	28	61	0	9020
23370	8883	59	22	42	0	9006
23371	325	45	19	8633	0	9022
23372	8633	40	27	205	0	8905
23373	247	8730	40	101	0	9118
23374	142	193	26	8885	0	9246
23375	111	91	29	8927	0	9158
23376	71	8833	41	253	0	9198
23377	80	197	37	9021	0	9335
23378	8813	89	29	252	0	9183
23379	8961	55	24	128	0	9168
23380	298	8505	15	95	0	8913
23381	150	8788	28	61	0	9027
23382	8771	256	25	57	0	9109
23383	251	114	8592	63	0	9020
23384	138	72	8619	73	0	8902
23385	116	61	241	8557	0	8975
23386	101	51	103	8821	0	9076
23387	83	43	8619	292	0	9037
23388	89	8254	221	157	0	8721
23389	141	214	98	8047	0	8500
23390	90	129	8729	237	0	9185
23391	129	81	210	8679	0	9099
23392	104	85	103	8694	0	8986
23393	93	8822	68	276	0	9259
23394	98	232	53	8863	0	9246
23395	77	121	61	8956	0	9215
23396	92	71	76	8979	0	9218
23397	8759	66	71	322	0	9218
23398	259	51	61	8638	0	9009
23399	146	8651	54	264	0	9115
23400	8670	208	51	162	0	9091
23401	275	113	8406	101	0	8895
23402	174	77	8433	91	0	8775
23403	8513	57	268	112	0	8950
23404	284	65	122	8588	0	9059
23405	145	61	8644	261	0	9111
23406	122	53	212	8668	0	9055
23407	93	58	100	8956	0	9207
23408	8687	67	77	351	0	9182
23409	8765	50	50	227	0	9092
23410	311	8832	53	145	0	9341
23411	202	215	49	8857	0	9323
23412	125	123	8840	248	0	9336
23413	106	9169	199	141	0	9615
23414	9057	229	111	117	0	9514
23415	256	9107	94	92	0	9549
23416	8835	226	94	87	0	9242
23417	254	116	8721	103	0	9194
23418	8680	57	211	119	0	9067
23419	9083	67	130	95	0	9375
23420	313	66	9273	108	0	9760
23421	170	71	237	9211	0	9689
23422	134	9154	121	246	0	9655
23423	96	9683	80	148	0	10007
23424	89	9772	79	115	0	10055
23425	110	327	59	9501	0	9997
23426	74	160	9672	276	0	10182
23427	95	98	225	9644	0	10062
23428	113	86	101	9928	0	10228
23429	122	74	9762	334	0	10292
23430	84	9705	236	193	0	10218
23431	110	224	108	9679	0	10121
23432	9818	108	69	296	0	10291
23433	266	77	90	9911	0	10344
23434	146	73	68	9959	0	10246
23435	114	9812	58	333	0	10317
23436	9981	256	64	199	0	10500
23437	275	121	67	10347	0	10810
23438	128	80	10231	312	0	10751
23439	86	10166	218	198	0	10668
23440	10038	220	120	153	0	10531
23441	260	112	10039	136	0	10547
23442	9944	74	216	119	0	10353
23443	260	81	116	9930	0	10387
23444	134	10139	67	241	0	10581
23445	10012	221	61	149	0	10443
23446	10131	119	56	111	0	10417
23447	275	10394	56	88	0	10813
23448	160	225	49	10341	0	10775
23449	125	114	48	10266	0	10553
23450	10003	60	50	280	0	10393
23451	236	9985	53	129	0	10403
23452	121	209	46	9320	0	9696
23453	67	9051	31	140	0	9289
23454	48	8823	26	79	0	8976
23455	26	116	35	8314	0	8491
23456	8247	36	22	105	0	8410
23457	76	8209	14	44	0	8343
23458	49	79	9	8195	0	8332
23459	21	27	9	8219	0	8276
23460	12	29	8104	96	0	8241
23461	32	30	7668	42	0	7772
23462	19	8103	79	26	0	8227
23463	22	72	8080	17	0	8191
23464	14	41	68	8110	0	8233
23465	11	24	8185	74	0	8294
23466	25	12	64	8395	0	8496
23467	16	15	38	8476	0	8545
23468	16	13	19	8530	0	8578
23469	8368	19	8	117	0	8512
23470	72	14	12	8377	0	8475
23471	37	10	7	8380	0	8434
23472	20	8330	13	103	0	8466
23473	15	68	9	8440	0	8532
23474	8609	36	8	121	0	8774
23475	71	8753	14	46	0	8884
23476	8825	73	11	61	0	8970
23477	77	36	8724	28	0	8865
23478	41	29	8785	24	0	8879
23479	41	25	92	9146	0	9304
23480	17	17	34	9459	0	9527
23481	14	9377	27	121	0	9539
23482	56	94	19	8754	0	8923
23483	9361	40	11	133	0	9545
23484	9328	21	17	75	0	9441
23485	132	19	6	9602	0	9759
23486	56	22	10149	109	0	10336
23487	35	18	87	10246	0	10386
23488	32	15	38	10567	0	10652
23489	30	11	20	10645	0	10706
23490	35	17	27	10466	0	10545
23491	32	15	17	10296	0	10360
23492	18	10322	20	160	0	10520
23493	10205	104	22	112	0	10443
23494	10376	47	19	94	0	10536
23495	10495	19	17	82	0	10613
23496	149	10736	15	59	0	10959
23497	10711	114	10	71	0	10906
23498	138	10742	16	53	0	10949
23499	69	127	10686	33	0	10915
23500	54	59	120	10445	0	10678
23501	47	33	10826	143	0	11049
23502	41	10838	129	83	0	11091
23503	10715	130	48	89	0	10982
23504	141	62	11108	50	0	11361
23505	61	59	11560	42	0	11722
23506	51	12115	211	51	0	12428
23507	52	179	111	12394	0	12736
23508	48	97	13049	178	0	13372
23509	94	57	199	12679	0	13029
23510	65	35	100	14148	0	14348
23511	60	35	62	15081	0	15238
23512	15784	26	42	391	0	16243
23513	16000	32	31	205	0	16268
23514	403	26	30	16151	0	16610
23515	16549	19	38	402	0	17008
23516	387	25	16344	162	0	16918
23517	167	31	16200	139	0	16537
23518	140	25	16418	111	0	16694
23519	106	23	16557	92	0	16778
23520	98	16130	406	85	0	16719
23521	171	272	210	15830	0	16483
23522	94	96	16358	302	0	16850
23523	15384	56	350	176	0	15966
23524	16306	31	187	171	0	16695
23525	393	16126	163	135	0	16817
23526	16246	281	140	88	0	16755
23527	420	106	148	16163	0	16837
23528	174	104	16583	310	0	17171
23529	174	61	383	15797	0	16415
23530	106	16592	219	303	0	17220
23531	16059	310	158	198	0	16725
23532	16576	130	142	149	0	16997
23533	414	16530	110	111	0	17165
23534	16775	315	100	120	0	17310
23535	16688	147	86	153	0	17074
23536	459	16463	80	93	0	17095
23537	313	308	71	16039	0	16731
23538	205	16234	81	307	0	16827
23539	16488	364	69	193	0	17114
23540	433	201	71	16366	0	17071
23541	16391	155	86	369	0	17001
23542	483	115	66	16267	0	16931
23543	239	138	15922	386	0	16685
23544	15701	133	286	201	0	16321
23545	475	109	15929	149	0	16662
23546	283	116	332	15844	0	16575
23547	228	94	15710	366	0	16398
23548	237	90	342	15675	0	16344
23549	189	106	15737	396	0	16428
23550	15342	71	371	279	0	16063
23551	378	15822	198	210	0	16608
23552	16012	316	161	190	0	16679
23553	424	125	154	16011	0	16714
23554	15940	93	141	429	0	16603
23555	420	15689	151	199	0	16459
23556	239	15664	149	175	0	16227
23557	198	16399	135	146	0	16878
23558	16394	406	125	175	0	17100
23559	395	221	111	16304	0	17031
23560	259	146	113	16487	0	17005
23561	179	145	15989	451	0	16764
23562	191	155	15659	224	0	16229
23563	204	140	360	16014	0	16718
23564	184	129	16217	392	0	16922
23565	169	16086	369	225	0	16849
23566	15902	376	172	211	0	16661
23567	362	194	16294	157	0	17007
23568	213	157	16203	144	0	16717
23569	205	127	445	16105	0	16882
23570	16498	102	265	445	0	17310
23571	375	97	199	16647	0	17318
23572	16531	64	199	460	0	17254
23573	426	80	183	16577	0	17266
23574	229	71	16621	435	0	17356
23575	190	16232	437	223	0	17082
23576	188	319	16590	183	0	17280
23577	169	16506	445	176	0	17296
23578	181	396	264	16379	0	17220
23579	16161	149	200	412	0	16922
23580	382	136	16168	191	0	16877
23581	223	106	356	16106	0	16791
23582	204	92	196	16549	0	17041
23583	16741	105	136	462	0	17444
23584	385	84	142	16534	0	17145
23585	197	16563	148	400	0	17308
23586	16068	328	144	268	0	16808
23587	361	181	15854	193	0	16589
23588	15361	158	324	201	0	16044
23589	401	15771	173	164	0	16509
23590	233	339	144	15478	0	16194
23591	195	15956	110	354	0	16615
23592	15936	325	99	229	0	16589
23593	396	162	15857	163	0	16578
23594	15493	134	297	200	0	16124
23595	390	15889	138	166	0	16583
23596	281	309	113	15914	0	16617
23597	15944	153	94	383	0	16574
23598	16112	140	125	183	0	16560
23599	443	127	93	15864	0	16527
23600	259	148	109	15843	0	16359
23601	208	15623	105	380	0	16316
23602	205	368	84	15745	0	16402
23603	171	16726	99	395	0	17391
23604	150	17575	105	210	0	18040
23605	215	555	99	16367	0	17236
23606	149	16889	101	383	0	17522
23607	217	361	16955	181	0	17714
23608	223	188	17963	183	0	18557
23609	143	18425	469	198	0	19235
23610	153	398	18845	144	0	19540
23611	117	193	18759	99	0	19168
23612	50	115	17565	49	0	17779
23613	18	17134	566	39	0	17757
23614	16337	413	301	80	0	17131
23615	303	16436	130	27	0	16896
23616	135	397	16398	10	0	16940
23617	137	189	363	16025	0	16714
23618	16108	122	170	353	0	16753
23619	343	79	16126	142	0	16690
23620	207	70	382	16050	0	16709
23621	88	49	16366	344	0	16847
23622	92	48	443	15987	0	16570
23623	15875	38	216	425	0	16554
23624	343	46	16111	179	0	16679
23625	161	16049	429	120	0	16759
23626	147	363	222	15529	0	16261
23627	16128	167	135	393	0	16823
23628	390	110	15761	158	0	16419
23629	220	87	400	14822	0	15529
23630	112	15636	223	326	0	16297
23631	15769	360	144	210	0	16483
23632	16261	173	116	148	0	16698
23633	540	119	114	15800	0	16573
23634	260	15830	97	400	0	16587
23635	135	16718	107	196	0	17156
23636	16917	524	75	164	0	17680
23637	523	248	79	16492	0	17342
23638	228	16864	95	424	0	17611
23639	16924	454	73	233	0	17684
23640	494	237	70	17011	0	17812
23641	301	140	85	17309	0	17835
23642	160	116	16115	613	0	17004
23643	109	16473	402	321	0	17305
23644	107	17310	191	182	0	17790
23645	155	560	115	17068	0	17898
23646	17001	276	71	525	0	17873
23647	426	16997	82	249	0	17754
23648	17039	515	75	186	0	17815
23649	517	16944	72	113	0	17646
23650	299	521	52	16924	0	17796
23651	16849	268	65	484	0	17666
23652	516	187	59	16805	0	17567
23653	271	131	16556	553	0	17511
23654	199	128	415	15826	0	16568
23655	122	16241	214	525	0	17102
23656	16026	490	135	291	0	16942
23657	449	16153	90	203	0	16895
23658	263	548	80	15717	0	16608
23659	202	266	75	16284	0	16827
23660	139	211	15717	642	0	16709
23661	111	167	15813	334	0	16425
23662	131	160	591	15725	0	16607
23663	121	139	15728	513	0	16501
23664	103	15481	517	320	0	16421
23665	15402	478	266	227	0	16373
23666	455	268	15614	163	0	16500
23667	15225	203	486	176	0	16090
23668	15760	144	257	161	0	16322
23669	15731	162	167	148	0	16208
23670	15786	136	131	121	0	16174
23671	738	128	123	15205	0	16194
23672	380	109	123	14949	0	15561
23673	243	14775	149	616	0	15783
23674	14589	490	141	340	0	15560
23675	530	284	14264	205	0	15283
23676	302	202	475	14250	0	15229
23677	230	152	285	14539	0	15206
23678	170	138	13965	665	0	14938
23679	178	14026	509	362	0	15075
23680	190	481	343	13616	0	14630
23681	213	258	196	14550	0	15217
23682	13990	207	139	695	0	15031
23683	538	13881	122	420	0	14961
23684	344	499	129	13771	0	14743
23685	215	13721	144	593	0	14673
23686	208	511	113	14121	0	14953
23687	13773	280	114	637	0	14804
23688	14163	200	131	348	0	14842
23689	666	140	110	13870	0	14786
23690	13739	139	107	630	0	14615
23691	13911	116	113	399	0	14539
23692	701	13389	120	241	0	14451
23693	422	458	92	13101	0	14073
23694	273	13233	92	555	0	14153
23695	226	530	76	13394	0	14226
23696	13267	299	72	619	0	14257
23697	546	238	77	13357	0	14218
23698	326	177	76	13616	0	14195
23699	246	197	12723	728	0	13894
23700	235	12087	393	463	0	13178
23701	238	13113	190	298	0	13839
23702	12776	576	127	292	0	13771
23703	525	382	78	11286	0	12271
23704	10553	200	63	456	0	11272
23705	480	10053	52	279	0	10864
23706	270	9358	52	238	0	9918
23707	193	9867	47	167	0	10274
23708	7351	354	182	195	0	8082
23709	230	7395	47	108	0	7780
23710	6166	177	110	104	0	6557
23711	5913	55	26	63	0	6057
23712	6111	39	13	52	0	6215
23713	144	31	17	6422	0	6614
23714	83	31	15	6628	0	6757
23715	54	27	17	6712	0	6810
23716	38	25	17	6626	0	6706
23717	6533	21	12	212	0	6778
23718	144	6379	15	81	0	6619
23719	81	123	15	6524	0	6743
23720	6628	58	14	161	0	6861
23721	150	36	10	6649	0	6845
23722	76	23	13	6701	0	6813
23723	6606	24	16	192	0	6838
23724	138	38	6411	81	0	6668
23725	76	23	103	6485	0	6687
23726	53	23	6514	143	0	6733
23727	44	23	120	6457	0	6644
23728	47	50	44	6511	0	6652
23729	6343	23	24	194	0	6584
23730	117	6169	16	101	0	6403
23731	60	6201	10	54	0	6325
23732	5954	107	13	41	0	6115
23733	101	6178	11	34	0	6324
23734	6065	88	15	66	0	6234
23735	97	25	5931	34	0	6087
23736	5363	18	49	34	0	5464
23737	5603	5	13	23	0	5644
23738	5666	6	14	22	0	5708
23739	72	3	5	5611	0	5691
23740	30	3	5	5589	0	5627
23741	15	5562	5	60	0	5642
23742	15	78	3	5550	0	5646
23743	5550	14	4	70	0	5638
23744	48	5532	7	19	0	5606
23745	16	5492	2	12	0	5522
23746	5473	43	0	26	0	5542
23747	46	11	5487	6	0	5550
23748	21	8	42	5377	0	5448
23749	11	7	5517	42	0	5577
23750	12	4	46	5469	0	5531
23751	7	5448	9	47	0	5511
23752	13	43	6	5594	0	5656
23753	5587	8	1	65	0	5661
23754	48	12	0	5599	0	5659
23755	14	7	5727	45	0	5793
23756	5408	3	47	30	0	5488
23757	51	5837	15	9	0	5912
23758	14	6196	11	12	0	6233
23759	6462	62	3	25	0	6552
23760	7087	17	1	20	0	7125
23761	106	11	7086	3	0	7206
23762	6871	4	86	34	0	6995
23763	106	7108	29	10	0	7253
23764	7253	89	9	18	0	7369
23765	124	34	8	7037	0	7203
23766	38	6733	2	91	0	6864
23767	6953	97	4	54	0	7108
23768	112	38	6999	17	0	7166
23769	65	17	96	7015	0	7193
23770	7188	13	36	114	0	7351
23771	116	24	7080	34	0	7254
23772	7166	15	95	39	0	7315
23773	131	13	31	7107	0	7282
23774	56	16	18	7291	0	7381
23775	45	12	7311	136	0	7504
23776	43	12	109	7213	0	7377
23777	7395	9	42	149	0	7595
23778	121	7261	25	59	0	7466
23779	7413	104	21	42	0	7580
23780	7489	31	10	62	0	7592
23781	153	23	12	7408	0	7596
23782	65	8	7536	136	0	7745
23783	52	7	115	7479	0	7653
23784	7534	11	46	181	0	7772
23785	128	7465	31	67	0	7691
23786	7699	108	16	54	0	7877
23787	157	42	11	7644	0	7854
23788	79	19	8	7790	0	7896
23789	48	17	15	7860	0	7940
23790	35	16	7674	171	0	7896
23791	52	12	114	7658	0	7836
23792	36	24	7594	143	0	7797
23793	43	31	7527	54	0	7655
23794	60	15	139	8023	0	8237
23795	45	15	8141	152	0	8353
23796	8868	10	137	114	0	9129
23797	197	10	68	9555	0	9830
23798	105	15	38	9638	0	9796
23799	56	9866	27	268	0	10217
23800	10014	213	30	164	0	10421
23801	10378	88	38	109	0	10613
23802	306	10285	27	70	0	10688
23803	157	232	28	10396	0	10813
23804	87	106	10370	234	0	10797
23805	10132	37	224	146	0	10539
23806	10557	35	101	102	0	10795
23807	356	47	43	9938	0	10384
23808	160	31	9671	238	0	10100
23809	97	9426	218	135	0	9876
23810	9423	229	104	90	0	9846
23811	265	109	9405	74	0	9853
23812	136	9285	237	71	0	9729
23813	8978	215	128	66	0	9387
23814	9072	111	46	51	0	9280
23815	336	40	44	8875	0	9295
23816	156	8840	54	216	0	9266
23817	115	214	38	9360	0	9727
23818	103	113	38	9491	0	9745
23819	104	52	49	9267	0	9472
23820	86	60	36	9428	0	9610
23821	73	46	9182	349	0	9650
23822	90	33	219	9289	0	9631
23823	83	43	116	9538	0	9780
23824	76	56	9214	351	0	9697
23825	58	9184	229	187	0	9658
23826	9239	221	122	154	0	9736
23827	9432	121	57	134	0	9744
23828	338	49	46	9392	0	9825
23829	9443	38	59	292	0	9832
23830	286	48	43	9540	0	9917
23831	172	49	9501	309	0	10031
23832	99	41	9421	205	0	9766
23833	75	9300	304	130	0	9809
23834	9260	223	134	131	0	9748
23835	265	119	9681	104	0	10169
23836	183	47	281	9366	0	9877
23837	138	48	144	10157	0	10487
23838	115	37	81	10669	0	10902
23839	102	39	85	10636	0	10862
23840	94	53	85	10628	0	10860
23841	89	46	10285	544	0	10964
23842	115	40	299	10504	0	10958
23843	10277	49	183	455	0	10964
23844	336	10271	88	285	0	10980
23845	10330	281	75	206	0	10892
23846	351	10395	87	175	0	11008
23847	10452	344	61	177	0	11034
23848	10771	196	57	148	0	11172
23849	510	88	88	10467	0	11153
23850	266	60	72	10704	0	11102
23851	10489	53	56	528	0	11126
23852	10391	52	58	302	0	10803
23853	10531	66	52	212	0	10861
23854	499	9907	70	172	0	10648
23855	281	10164	79	122	0	10646
23856	177	395	9980	123	0	10675
23857	210	220	278	9726	0	10434
23858	145	114	9643	375	0	10277
23859	120	9316	306	265	0	10007
23860	114	273	171	8739	0	9297
23861	110	147	57	8881	0	9195
23862	106	64	66	9046	0	9282
23863	8663	87	53	450	0	9253
23864	8727	66	39	294	0	9126
23865	392	8606	57	169	0	9224
23866	247	243	55	8721	0	9266
23867	140	160	8622	320	0	9242
23868	125	100	8343	191	0	8759
23869	8358	108	340	157	0	8963
23870	8644	48	177	144	0	9013
23871	406	43	105	8450	0	9004
23872	8576	41	89	324	0	9030
23873	362	57	8297	205	0	8921
23874	222	8228	251	157	0	8858
23875	126	241	162	8330	0	8859
23876	107	131	8432	323	0	8993
23877	109	79	301	8465	0	8954
23878	118	72	158	8602	0	8950
23879	92	57	8415	438	0	9002
23880	8098	64	269	303	0	8734
23881	8540	21	171	222	0	8954
23882	360	8575	108	173	0	9216
23883	8869	275	88	162	0	9394
23884	9209	159	58	159	0	9585
23885	465	73	9036	153	0	9727
23886	9136	74	304	147	0	9661
23887	391	9460	162	129	0	10142
23888	9595	312	100	112	0	10119
23889	9831	163	68	135	0	10197
23890	10151	94	72	118	0	10435
23891	9710	87	56	119	0	9972
23892	10155	63	54	132	0	10404
23893	583	9765	60	107	0	10515
23894	9539	289	74	123	0	10025
23895	464	9284	52	79	0	9879
23896	210	8240	33	73	0	8556
23897	100	8233	40	46	0	8419
23898	7911	294	112	57	0	8374
23899	7854	115	31	63	0	8063
23900	327	59	7531	45	0	7962
23901	7784	58	190	60	0	8092
23902	7935	39	80	57	0	8111
23903	341	46	7890	43	0	8320
23904	186	38	230	7775	0	8229
23905	132	37	94	7748	0	8011
23906	92	35	53	8220	0	8400
23907	109	32	33	8221	0	8395
23908	98	29	32	8340	0	8499
23909	74	27	8049	348	0	8498
23910	70	8018	226	154	0	8468
23911	7879	224	99	96	0	8298
23912	258	7907	45	73	0	8283
23913	7989	248	39	81	0	8357
23914	8028	102	34	69	0	8233
23915	360	54	7754	47	0	8215
23916	185	61	229	7250	0	7725
23917	102	7458	107	226	0	7893
23918	7532	235	61	112	0	7940
23919	7620	91	41	100	0	7852
23920	7704	55	37	79	0	7875
23921	334	7574	41	55	0	8004
23922	7658	237	31	70	0	7996
23923	7803	107	33	58	0	8001
23924	7816	57	37	55	0	7965
23925	378	56	22	7510	0	7966
23926	205	39	19	7705	0	7968
23927	137	43	27	7807	0	8014
23928	7573	29	26	315	0	7943
23929	294	7584	27	127	0	8032
23930	7620	224	28	82	0	7954
23931	7563	103	20	62	0	7748
23932	7395	51	19	66	0	7531
23933	7445	44	23	54	0	7566
23934	392	7094	12	33	0	7531
23935	6691	202	11	42	0	6946
23936	285	6520	16	36	0	6857
23937	123	6218	9	23	0	6373
23938	6037	173	19	41	0	6270
23939	204	5876	18	30	0	6128
23940	99	6060	9	32	0	6200
23941	6040	177	25	40	0	6282
23942	6147	76	9	31	0	6263
23943	229	49	12	5920	0	6210
23944	113	41	11	6031	0	6196
23945	6031	48	9	190	0	6278
23946	6297	42	8	72	0	6419
23947	6105	48	9	50	0	6212
23948	239	31	5834	24	0	6128
23949	6073	48	126	45	0	6292
23950	225	34	46	6063	0	6368
23951	113	51	20	6160	0	6344
23952	98	38	16	6238	0	6390
23953	85	46	17	6204	0	6352
23954	80	36	5930	199	0	6245
23955	82	33	5995	97	0	6207
23956	65	28	173	6016	0	6282
23957	73	28	5977	192	0	6270
23958	84	32	6002	96	0	6214
23959	83	27	178	6057	0	6345
23960	85	30	70	6196	0	6381
23961	78	26	43	6401	0	6548
23962	93	40	37	6229	0	6399
23963	6343	17	42	216	0	6618
23964	6587	30	36	130	0	6783
23965	231	24	30	6476	0	6761
23966	101	34	24	6617	0	6776
23967	80	30	30	6610	0	6750
23968	78	31	24	6585	0	6718
23969	91	26	37	6513	0	6667
23970	76	6379	35	222	0	6712
23971	6382	155	30	114	0	6681
23972	196	6439	24	98	0	6757
23973	6515	158	26	99	0	6798
23974	6595	57	11	107	0	6770
23975	6587	47	18	94	0	6746
23976	251	40	15	6294	0	6600
23977	6361	45	9	187	0	6602
23978	226	51	11	6275	0	6563
23979	143	51	12	6316	0	6522
23980	6439	27	7	231	0	6704
23981	217	6239	16	107	0	6579
23982	99	6066	9	73	0	6247
23983	5942	134	12	70	0	6158
23984	158	50	5817	64	0	6089
23985	5498	57	104	69	0	5728
23986	187	72	26	5589	0	5874
23987	84	5229	14	108	0	5435
23988	81	5356	9	46	0	5492
23989	5469	99	11	55	0	5634
23990	124	45	22	5456	0	5647
23991	72	5522	8	93	0	5695
23992	5464	55	14	64	0	5597
23993	5460	35	4	60	0	5559
23994	5491	32	3	51	0	5577
23995	5506	32	5	49	0	5592
23996	111	5292	9	27	0	5439
23997	45	5273	5	22	0	5345
23998	5314	62	6	26	0	5408
23999	5380	21	11	28	0	5440
24000	80	24	5236	21	0	5361
24001	38	5044	38	15	0	5135
24002	4984	30	16	21	0	5051
24003	5097	14	5	20	0	5136
24004	46	8	5148	7	0	5209
24005	5220	4	35	22	0	5281
24006	51	2	5514	3	0	5570
24007	16	7	6120	2	0	6145
24008	28	9	97	5778	0	5912
24009	6	5952	46	81	0	6085
24010	6399	99	15	53	0	6566
24011	106	34	2	6464	0	6606
24012	57	16	2	6508	0	6583
24013	41	3	8	6613	0	6665
24014	6533	2	2	168	0	6705
24015	117	5	11	6494	0	6627
24016	60	2	11	6646	0	6719
24017	27	4	6522	147	0	6700
24018	6439	9	101	90	0	6639
24019	6800	6	43	43	0	6892
24020	170	7	6716	29	0	6922
24021	6624	5	114	45	0	6788
24022	156	4	47	6604	0	6811
24023	63	6621	28	134	0	6846
24024	48	116	4	6755	0	6923
24025	6648	42	18	162	0	6870
24026	135	6684	20	63	0	6902
24027	82	116	8	6796	0	7002
24028	49	41	15	6918	0	7023
24029	55	26	14	6877	0	6972
24030	46	4	16	6711	0	6777
24031	29	6817	15	180	0	7041
24032	6810	133	9	102	0	7054
24033	6892	55	11	64	0	7022
24034	190	7013	6	28	0	7237
24035	7641	139	8	63	0	7851
24036	7935	63	8	55	0	8061
24037	7946	32	4	68	0	8050
24038	271	13	7682	40	0	8006
24039	132	28	153	7668	0	7981
24040	72	25	7428	193	0	7718
24041	7488	11	174	109	0	7782
24042	202	7606	64	58	0	7930
24043	7514	170	43	48	0	7775
24044	228	7670	26	30	0	7954
24045	136	191	24	7316	0	7667
24046	100	77	26	7534	0	7737
24047	43	60	7435	232	0	7770
24048	46	7562	181	128	0	7917
24049	7539	179	88	80	0	7886
24050	221	93	7511	34	0	7859
24051	7549	66	186	52	0	7853
24052	261	40	73	7579	0	7953
24053	111	48	7644	212	0	8015
24054	82	7570	183	154	0	7989
24055	64	203	100	7591	0	7958
24056	60	90	7661	208	0	8019
24057	64	72	7554	99	0	7789
24058	64	7544	256	81	0	7945
24059	70	207	124	7440	0	7841
24060	81	83	76	7438	0	7678
24061	41	7307	61	263	0	7672
24062	7398	197	54	134	0	7783
24063	201	113	45	7285	0	7644
24064	106	7210	55	225	0	7596
24065	7327	196	61	134	0	7718
24066	7355	108	56	103	0	7622
24067	7462	86	46	87	0	7681
24068	294	7277	36	101	0	7708
24069	7424	221	36	98	0	7779
24070	7532	104	47	70	0	7753
24071	315	88	36	7319	0	7758
24072	7375	65	33	248	0	7721
24073	293	74	27	7340	0	7734
24074	165	54	7124	245	0	7588
24075	147	55	7256	136	0	7594
24076	100	61	238	7359	0	7758
24077	97	71	7353	238	0	7759
24078	7301	59	223	147	0	7730
24079	280	41	96	7467	0	7884
24080	152	34	79	7479	0	7744
24081	125	43	7217	319	0	7704
24082	102	6895	229	182	0	7408
24083	93	7240	123	113	0	7569
24084	77	252	106	7027	0	7462
24085	109	113	62	7159	0	7443
24086	93	75	6894	296	0	7358
24087	101	55	6944	162	0	7262
24088	80	66	266	6989	0	7401
24089	73	49	6704	279	0	7105
24090	6539	64	262	141	0	7006
24091	250	77	116	6629	0	7072
24092	6667	72	84	281	0	7104
24093	280	51	52	6683	0	7066
24094	135	56	81	6828	0	7100
24095	110	55	6554	319	0	7038
24096	80	6536	249	202	0	7067
24097	91	201	118	6597	0	7007
24098	73	105	6524	260	0	6962
24099	96	6318	225	156	0	6795
24100	91	217	118	6462	0	6888
24101	6465	94	77	288	0	6924
24102	231	70	6557	159	0	7017
24103	6332	39	239	134	0	6744
24104	267	64	6252	92	0	6675
24105	5735	50	234	104	0	6123
24106	242	5741	112	92	0	6187
24107	81	5272	87	57	0	5497
24108	86	248	66	4936	0	5336
24109	62	4973	45	165	0	5245
24110	4857	160	59	136	0	5212
24111	171	61	55	4890	0	5177
24112	77	50	37	5002	0	5166
24113	55	43	41	5028	0	5167
24114	44	41	4807	200	0	5092
24115	45	37	142	4819	0	5043
24116	26	48	4776	183	0	5033
24117	33	4661	160	92	0	4946
24118	4363	115	69	81	0	4628
24119	121	4471	50	58	0	4700
24120	4530	128	52	68	0	4778
24121	4604	49	44	68	0	4765
24122	4629	39	26	72	0	4766
24123	4509	39	47	48	0	4643
24124	176	42	4327	47	0	4592
24125	83	35	134	4303	0	4555
24126	83	47	48	4230	0	4408
24127	60	38	36	4397	0	4531
24128	3939	40	41	179	0	4199
24129	4117	28	34	100	0	4279
24130	153	4281	28	82	0	4544
24131	98	103	4189	59	0	4449
24132	73	34	4179	58	0	4344
24133	54	4133	141	46	0	4374
24134	51	4117	60	60	0	4288
24135	119	136	84	3301	0	3640
24136	54	29	20	3206	0	3309
24137	3220	23	19	91	0	3353
24138	69	3181	22	47	0	3319
24139	38	66	20	3326	0	3450
24140	24	35	3382	85	0	3526
24141	39	19	66	3474	0	3598
24142	39	23	31	3540	0	3633
24143	33	21	21	3621	0	3696
24144	31	15	23	3562	0	3631
24145	29	12	3464	110	0	3615
24146	22	3307	84	54	0	3467
24147	24	3432	23	38	0	3517
24148	3268	74	20	32	0	3394
24149	70	3237	23	31	0	3361
24150	25	3424	20	22	0	3491
24151	21	79	16	3402	0	3518
24152	24	28	4	3443	0	3499
24153	18	32	15	3420	0	3485
24154	22	17	3365	87	0	3491
24155	9	3343	67	50	0	3469
24156	24	71	16	3300	0	3411
24157	11	3367	18	88	0	3484
24158	3394	55	19	44	0	3512
24159	65	3387	24	29	0	3505
24160	3387	74	19	32	0	3512
24161	62	34	3338	31	0	3465
24162	3412	26	61	29	0	3528
24163	69	37	16	3453	0	3575
24164	26	31	3467	70	0	3594
24165	3386	16	63	30	0	3495
24166	3454	19	13	37	0	3523
24167	3505	17	9	30	0	3561
24168	76	18	19	3488	0	3601
24169	26	17	3500	79	0	3622
24170	3551	9	62	42	0	3664
24171	78	18	19	3660	0	3775
24172	34	15	9	3731	0	3789
24173	21	21	3851	76	0	3969
24174	26	3797	60	29	0	3912
24175	30	68	17	3703	0	3818
24176	32	3771	15	65	0	3883
24177	3740	62	21	25	0	3848
24178	3752	21	20	12	0	3805
24179	71	20	15	3746	0	3852
24180	3728	14	18	77	0	3837
24181	72	3730	11	31	0	3844
24182	3755	54	9	42	0	3860
24183	69	3809	15	25	0	3918
24184	42	53	9	3891	0	3995
24185	23	24	12	3840	0	3899
24186	27	3812	18	64	0	3921
24187	18	65	18	3862	0	3963
24188	14	28	3823	79	0	3944
24189	10	3762	53	35	0	3860
24190	3640	55	12	28	0	3735
24191	47	3647	7	32	0	3733
24192	25	45	10	3628	0	3708
24193	15	23	3611	51	0	3700
24194	21	14	40	3642	0	3717
24195	17	21	10	3677	0	3725
24196	3640	16	9	59	0	3724
24197	52	12	3595	28	0	3687
24198	9	3661	49	38	0	3757
24199	14	49	3851	27	0	3941
24200	19	14	3897	18	0	3948
24201	13	11	3887	18	0	3929
24202	25	75	41	3668	0	3809
24203	3824	3	14	44	0	3885
24204	35	3796	10	7	0	3848
24205	3875	41	6	14	0	3936
24206	4042	6	3	16	0	4067
24207	43	8	4	3978	0	4033
24208	11	3969	5	37	0	4022
24209	3980	40	5	16	0	4041
24210	39	3967	5	12	0	4023
24211	9	47	3	4010	0	4069
24212	18	7	5	4146	0	4176
24213	7	4127	4	42	0	4180
24214	13	40	2	4172	0	4227
24215	10	10	4090	49	0	4159
24216	8	22	4054	10	0	4094
24217	15	6	43	4135	0	4199
24218	12	6	12	4193	0	4223
24219	6	4	4060	51	0	4121
24220	5	10	4000	16	0	4031
24221	3783	8	47	25	0	3863
24222	45	3932	10	12	0	3999
24223	9	4250	17	16	0	4292
24224	15	48	7	4186	0	4256
24225	7	15	7	4257	0	4286
24226	15	17	3	4284	0	4319
24227	6	10	4242	56	0	4314
24228	7	10	4142	12	0	4171
24229	13	3	48	4302	0	4366
24230	8	6	4231	56	0	4301
24231	8	4167	55	9	0	4239
24232	4146	49	22	16	0	4233
24233	55	12	4146	12	0	4225
24234	15	15	4151	14	0	4195
24235	23	18	54	4175	0	4270
24236	13	12	4551	54	0	4630
24237	11	4645	66	21	0	4743
24238	24	62	13	4786	0	4885
24239	8	13	4830	80	0	4931
24240	7	4728	79	23	0	4837
24241	4720	80	19	34	0	4853
24242	85	21	21	4699	0	4826
24243	23	15	17	4747	0	4802
24244	4714	9	17	88	0	4828
24245	75	4699	11	27	0	4812
24246	4753	72	11	33	0	4869
24247	4751	16	16	29	0	4812
24248	4749	12	9	28	0	4798
24249	95	13	7	4678	0	4793
24250	4567	16	6	85	0	4674
24251	82	4430	11	21	0	4544
24252	24	4534	13	21	0	4592
24253	4664	84	9	31	0	4788
24254	91	21	11	4725	0	4848
24255	29	22	10	4771	0	4832
24256	30	16	10	4800	0	4856
24257	16	14	4614	96	0	4740
24258	18	4614	78	42	0	4752
24259	18	82	17	4730	0	4847
24260	4731	20	20	100	0	4871
24261	96	16	20	4715	0	4847
24262	22	15	4711	106	0	4854
24263	28	4695	83	33	0	4839
24264	4696	93	17	31	0	4837
24265	4715	21	16	30	0	4782
24266	4743	18	15	32	0	4808
24267	111	13	13	4728	0	4865
24268	37	25	4721	97	0	4880
24269	39	19	4927	33	0	5018
24270	31	5010	114	22	0	5177
24271	51	121	24	5052	0	5248
24272	28	26	14	5209	0	5277
24273	4961	19	25	140	0	5145
24274	125	22	23	5036	0	5206
24275	5177	29	13	146	0	5365
24276	137	11	5101	63	0	5312
24277	47	13	5180	45	0	5285
24278	49	12	134	5147	0	5342
24279	37	19	42	5242	0	5340
24280	41	16	30	5350	0	5437
24281	5273	13	35	158	0	5479
24282	5605	16	27	63	0	5711
24283	175	15	13	5617	0	5820
24284	50	11	5504	184	0	5749
24285	39	7	5733	74	0	5853
24286	43	11	181	5769	0	6004
24287	5931	17	61	183	0	6192
24288	163	11	40	5918	0	6132
24289	64	10	39	6065	0	6178
24290	44	11	5954	212	0	6221
24291	27	15	5975	99	0	6116
24292	5761	8	193	79	0	6041
24293	166	14	5939	57	0	6176
24294	79	7	191	5773	0	6050
24295	53	13	76	5930	0	6072
24296	5847	7	57	213	0	6124
24297	182	5782	39	90	0	6093
24298	5687	151	47	83	0	5968
24299	169	5605	34	64	0	5872
24300	5453	149	24	58	0	5684
24301	192	51	5320	37	0	5600
24302	5012	44	172	49	0	5277
24303	5123	14	48	40	0	5225
24304	192	32	44	5061	0	5329
24305	83	9	4991	158	0	5241
24306	60	14	155	4678	0	4907
24307	57	14	49	4830	0	4950
24308	37	4705	35	194	0	4971
24309	48	125	26	4709	0	4908
24310	35	4688	47	166	0	4936
24311	51	141	15	4755	0	4962
24312	4654	43	24	186	0	4907
24313	159	42	23	4679	0	4903
24314	53	25	4640	187	0	4905
24315	4557	27	141	79	0	4804
24316	172	25	4688	68	0	4953
24317	4693	14	156	62	0	4925
24318	4871	16	64	67	0	5018
24319	202	4720	62	43	0	5027
24320	95	4996	35	60	0	5186
24321	4904	173	44	52	0	5173
24322	5093	61	32	59	0	5245
24323	4953	36	28	62	0	5079
24324	4926	28	35	62	0	5051
24325	4935	33	36	57	0	5061
24326	251	17	22	4778	0	5068
24327	119	28	31	4910	0	5088
24328	85	29	4754	210	0	5078
24329	4670	23	166	103	0	4962
24330	197	16	72	4697	0	4982
24331	109	14	39	4849	0	5011
24332	86	28	4728	219	0	5061
24333	60	4542	178	94	0	4874
24334	73	4754	62	76	0	4965
24335	4652	167	58	86	0	4963
24336	4439	57	48	66	0	4610
24337	206	4099	44	51	0	4400
24338	97	4069	26	48	0	4240
24339	4056	138	26	52	0	4272
24340	4172	57	15	69	0	4313
24341	180	35	35	4015	0	4265
24342	101	31	38	4073	0	4243
24343	80	33	20	4127	0	4260
24344	3919	21	27	196	0	4163
24345	3990	21	31	100	0	4142
24346	182	23	22	3972	0	4199
24347	4081	30	27	163	0	4301
24348	180	33	4078	68	0	4359
24349	120	15	119	4107	0	4361
24350	74	27	4114	156	0	4371
24351	58	4049	143	75	0	4325
24352	90	138	59	4037	0	4324
24353	3997	65	51	133	0	4246
24354	171	36	23	3973	0	4203
24355	86	18	29	4059	0	4192
24356	69	30	3883	178	0	4160
24357	63	27	3904	95	0	4089
24358	71	3936	124	67	0	4198
24359	3951	128	60	62	0	4201
24360	4031	45	31	71	0	4178
24361	4045	34	31	52	0	4162
24362	4065	25	29	62	0	4181
24363	195	26	30	3955	0	4206
24364	117	21	25	3975	0	4138
24365	75	3973	36	155	0	4239
24366	4006	125	20	81	0	4232
24367	4020	59	27	58	0	4164
24368	191	40	3826	50	0	4107
24369	3447	18	95	38	0	3598
24370	139	3454	47	44	0	3684
24371	74	124	35	3313	0	3546
24372	66	3406	20	95	0	3587
24373	3381	108	16	69	0	3574
24374	134	3328	14	46	0	3522
24375	89	92	9	3196	0	3386
24376	59	30	13	3257	0	3359
24377	33	23	14	3197	0	3267
24378	27	3091	12	146	0	3276
24379	40	114	13	3127	0	3294
24380	53	58	14	3103	0	3228
24381	34	2853	19	119	0	3025
24382	24	2736	14	55	0	2829
24383	2541	76	14	21	0	2652
24384	55	2595	5	28	0	2683
24385	2408	46	8	24	0	2486
24386	64	28	2348	5	0	2445
24387	26	2268	41	12	0	2347
24388	2252	45	14	18	0	2329
24389	2242	21	6	25	0	2294
24390	61	9	2213	21	0	2304
24391	31	6	39	2224	0	2300
24392	14	13	2269	47	0	2343
24393	12	2211	43	34	0	2300
24394	2174	42	22	23	0	2261
24395	37	2164	10	12	0	2223
24396	27	41	7	2161	0	2236
24397	25	17	8	2192	0	2242
24398	10	19	2175	50	0	2254
24399	14	7	2062	29	0	2112
24400	2101	11	50	10	0	2172
24401	2185	19	19	11	0	2234
24402	2208	10	6	10	0	2234
24403	2205	7	9	10	0	2231
24404	59	2170	13	13	0	2255
24405	26	36	7	2216	0	2285
24406	20	18	11	2231	0	2280
24407	17	2251	7	52	0	2327
24408	2285	34	4	32	0	2355
24409	2309	24	9	13	0	2355
24410	58	9	2298	27	0	2392
24411	2317	8	37	16	0	2378
24412	53	16	22	2338	0	2429
24413	36	5	2331	46	0	2418
24414	30	23	36	2291	0	2380
24415	12	14	2370	44	0	2440
24416	22	10	2288	21	0	2341
24417	24	46	44	2152	0	2266
24418	10	2187	21	32	0	2250
24419	2156	29	8	28	0	2221
24420	2112	15	8	18	0	2153
24421	41	2261	8	7	0	2317
24422	30	2302	6	10	0	2348
24423	2368	42	10	11	0	2431
24424	2382	14	8	19	0	2423
24425	2407	9	6	11	0	2433
24426	2394	10	8	13	0	2425
24427	50	9	12	2431	0	2502
24428	26	7	2464	34	0	2531
24429	16	2453	35	14	0	2518
24430	2443	42	20	10	0	2515
24431	40	2568	5	14	0	2627
24432	2555	37	9	17	0	2618
24433	2563	14	8	18	0	2603
24434	48	12	2621	10	0	2691
24435	20	2704	32	8	0	2764
24436	17	36	16	2723	0	2792
24437	16	19	9	2779	0	2823
24438	25	10	4	2664	0	2703
24439	2724	9	10	50	0	2793
24440	2674	9	3	24	0	2710
24441	2698	6	7	18	0	2729
24442	47	2715	12	6	0	2780
24443	2722	36	6	15	0	2779
24444	39	2734	8	11	0	2792
24445	19	37	2713	12	0	2781
24446	14	2730	32	16	0	2792
24447	37	44	21	2552	0	2654
24448	15	11	4	2540	0	2570
24449	8	11	2508	32	0	2559
24450	16	6	20	2431	0	2473
24451	11	8	7	2510	0	2536
24452	2520	6	5	48	0	2579
24453	2511	7	10	20	0	2548
24454	2554	6	2	15	0	2577
24455	40	2537	6	12	0	2595
24456	2571	23	6	13	0	2613
24457	2531	11	5	9	0	2556
24458	35	2552	3	12	0	2602
24459	25	24	2	2577	0	2628
24460	18	15	6	2584	0	2623
24461	2574	5	7	43	0	2629
24462	35	6	2535	13	0	2589
24463	16	2456	28	11	0	2511
24464	16	54	11	2389	0	2470
24465	10	2368	5	27	0	2410
24466	9	2372	3	10	0	2394
24467	2377	26	5	13	0	2421
24468	2361	10	3	10	0	2384
24469	30	8	1	2355	0	2394
24470	19	4	4	2305	0	2332
24471	17	7	6	2316	0	2346
24472	13	3	2	2297	0	2315
24473	4	9	2239	31	0	2283
24474	11	11	2153	8	0	2183
24475	16	2	22	2296	0	2336
24476	11	7	2351	24	0	2393
24477	6	2343	27	11	0	2387
24478	2370	27	2	18	0	2417
24479	2420	2	5	19	0	2446
24480	33	8	4	2426	0	2471
24481	8	5	7	2429	0	2449
24482	9	6	4	2453	0	2472
24483	7	2444	5	37	0	2493
24484	2467	33	6	12	0	2518
24485	2463	10	2	13	0	2488
24486	41	8	2431	10	0	2490
24487	21	5	27	2555	0	2608
24488	10	9	2609	53	0	2681
24489	16	2	49	2961	0	3028
24490	14	4	5	2952	0	2975
24491	6	7	6	2980	0	2999
24492	16	10	6	3092	0	3124
24493	3057	6	4	84	0	3151
24494	3192	4	11	33	0	3240
24495	3259	6	9	22	0	3296
24496	90	4	8	3243	0	3345
24497	31	3	3193	71	0	3298
24498	3119	3	60	37	0	3219
24499	66	5	15	3251	0	3337
24500	3207	3	13	77	0	3300
24501	80	5	3	3189	0	3277
24502	29	3057	4	81	0	3171
24503	21	3233	4	33	0	3291
24504	16	67	10	3189	0	3282
24505	17	22	12	3184	0	3235
24506	21	7	6	3228	0	3262
24507	12	3135	4	93	0	3244
24508	3128	57	4	50	0	3239
24509	62	3152	7	27	0	3248
24510	20	71	3121	17	0	3229
24511	20	27	59	3114	0	3220
24512	12	3204	19	77	0	3312
24513	12	60	14	3213	0	3299
24514	20	20	5	3260	0	3305
24515	14	10	3157	90	0	3271
24516	2992	8	62	54	0	3116
24517	73	3210	23	32	0	3338
24518	3225	65	13	27	0	3330
24519	3295	24	7	24	0	3350
24520	3285	15	4	24	0	3328
24521	98	10	3027	20	0	3155
24522	47	9	72	2983	0	3111
24523	34	12	25	3027	0	3098
24524	11	14	2946	102	0	3073
24525	2820	11	67	60	0	2958
24526	80	11	2955	38	0	3084
24527	33	10	2885	25	0	2953
24528	22	2844	67	21	0	2954
24529	19	60	26	2840	0	2945
24530	16	28	2854	74	0	2972
24531	2662	9	65	40	0	2776
24532	2752	12	22	24	0	2810
24533	88	7	2738	13	0	2846
24534	46	8	64	2721	0	2839
24535	21	11	2723	65	0	2820
24536	16	2712	73	37	0	2838
24537	2852	68	25	29	0	2974
24538	2950	26	18	29	0	3023
24539	3026	17	7	23	0	3073
24540	101	13	10	2959	0	3083
24541	46	5	11	3045	0	3107
24542	21	11	2940	102	0	3074
24543	2916	15	71	44	0	3046
24544	94	10	33	2953	0	3090
24545	2955	10	18	87	0	3070
24546	94	6	2939	36	0	3075
24547	33	10	3031	27	0	3101
24548	25	11	87	2940	0	3063
24549	21	9	39	3071	0	3140
24550	23	5	2994	101	0	3123
24551	2962	7	82	44	0	3095
24552	97	6	36	2956	0	3095
24553	40	3094	25	83	0	3242
24554	3116	70	19	52	0	3257
24555	85	3157	22	30	0	3294
24556	3202	74	14	23	0	3313
24557	104	24	3233	22	0	3383
24558	49	15	3153	17	0	3234
24559	37	3182	96	27	0	3342
24560	3204	75	38	25	0	3342
24561	94	26	3151	22	0	3293
24562	3108	15	86	33	0	3242
24563	95	3179	46	19	0	3339
24564	44	72	32	3239	0	3387
24565	40	29	17	3245	0	3331
24566	25	3225	23	92	0	3365
24567	3353	70	30	47	0	3500
24568	3456	31	18	34	0	3539
24569	3620	16	16	31	0	3683
24570	113	18	3541	21	0	3693
24571	58	11	84	3554	0	3707
24572	35	15	38	3617	0	3705
24573	27	19	23	3676	0	3745
24574	38	11	3568	107	0	3724
24575	26	3490	86	42	0	3644
24576	3479	75	29	32	0	3615
24577	89	31	3581	26	0	3727
24578	3532	14	88	30	0	3664
24579	88	3546	40	27	0	3701
24580	3607	76	20	32	0	3735
24581	98	28	26	3594	0	3746
24582	3621	18	30	80	0	3749
24583	110	18	20	3609	0	3757
24584	49	17	3689	90	0	3845
24585	52	42	75	3640	0	3809
24586	28	19	3634	93	0	3774
24587	3335	12	65	51	0	3463
24588	76	3431	36	37	0	3580
24589	48	59	20	2994	0	3121
24590	26	3167	16	49	0	3258
24591	3140	47	20	31	0	3238
24592	3105	21	20	22	0	3168
24593	60	3051	17	23	0	3151
24594	3008	42	18	24	0	3092
24595	3055	16	11	27	0	3109
24596	60	11	9	3023	0	3103
24597	30	13	11	3047	0	3101
24598	3112	8	16	59	0	3195
24599	3141	8	11	27	0	3187
24600	72	7	7	3097	0	3183
24601	28	12	14	3371	0	3425
24602	3470	10	6	76	0	3562
24603	71	13	3433	27	0	3544
24604	3336	9	55	31	0	3431
24605	67	12	3419	20	0	3518
24606	30	3358	57	19	0	3464
24607	41	51	21	3337	0	3450
24608	24	19	3417	51	0	3511
24609	28	3477	57	25	0	3587
24610	3437	59	26	30	0	3552
24611	65	24	3497	12	0	3598
24612	3444	9	54	27	0	3534
24613	3560	9	23	21	0	3613
24614	3621	22	12	22	0	3677
24615	87	10	6	3511	0	3614
24616	47	3546	24	46	0	3663
24617	3567	47	13	38	0	3665
24618	72	11	3620	12	0	3715
24619	3368	13	50	27	0	3458
24620	61	9	3601	21	0	3692
24621	21	3534	56	23	0	3634
24622	32	49	13	3565	0	3659
24623	27	13	21	3587	0	3648
24624	23	3528	22	49	0	3622
24625	28	47	22	3560	0	3657
24626	30	25	3628	46	0	3729
24627	34	3597	43	25	0	3699
24628	27	43	19	3598	0	3687
24629	3559	36	13	59	0	3667
24630	3698	20	6	32	0	3756
24631	76	10	22	3698	0	3806
24632	42	3804	13	59	0	3918
24633	36	52	18	3784	0	3890
24634	36	23	17	3752	0	3828
24635	26	13	3616	83	0	3738
24636	22	3634	48	52	0	3756
24637	26	66	13	3572	0	3677
24638	22	19	3493	59	0	3593
24639	16	3462	51	35	0	3564
24640	19	53	28	3499	0	3599
24641	3484	28	25	66	0	3603
24642	55	3607	12	37	0	3711
24643	46	42	18	3649	0	3755
24644	3729	38	12	70	0	3849
24645	3774	24	7	48	0	3853
24646	3791	8	13	36	0	3848
24647	3717	25	12	28	0	3782
24648	79	13	12	3697	0	3801
24649	39	19	3684	58	0	3800
24650	50	20	40	3619	0	3729
24651	30	3622	23	64	0	3739
24652	3673	45	14	44	0	3776
24653	63	19	3523	29	0	3634
24654	3436	25	54	24	0	3539
24655	58	18	3520	26	0	3622
24656	34	14	50	3484	0	3582
24657	32	23	3558	49	0	3662
24658	34	10	49	3531	0	3624
24659	36	15	3589	46	0	3686
24660	34	22	48	3531	0	3635
24661	3587	5	21	75	0	3688
24662	61	3776	29	21	0	3887
24663	45	44	13	3791	0	3893
24664	27	21	21	3785	0	3854
24665	28	16	3826	63	0	3933
24666	21	11	3645	43	0	3720
24667	3600	15	57	31	0	3703
24668	48	3685	35	25	0	3793
24669	3633	44	17	29	0	3723
24670	3714	23	20	23	0	3780
24671	47	11	23	3688	0	3769
24672	27	3767	20	41	0	3855
24673	3867	42	19	42	0	3970
24674	3908	17	10	26	0	3961
24675	3989	13	15	19	0	4036
24676	3958	6	7	35	0	4006
24677	3879	15	13	21	0	3928
24678	63	6	3816	23	0	3908
24679	3797	13	42	11	0	3863
24680	67	14	3824	10	0	3915
24681	40	12	43	3759	0	3854
24682	41	3	17	3904	0	3965
24683	29	2	3836	47	0	3914
24684	3738	7	48	27	0	3820
24685	63	11	21	3820	0	3915
24686	33	9	15	3957	0	4014
24687	29	7	12	3997	0	4045
24688	26	8	19	3943	0	3996
24689	25	5	11	3992	0	4033
24690	24	14	3972	74	0	4084
24691	24	4	54	3961	0	4043
24692	30	4	4003	64	0	4101
24693	23	8	3891	44	0	3966
24694	3953	2	62	39	0	4056
24695	4068	3	36	37	0	4144
24696	4359	9	27	43	0	4438
24697	104	7	4506	29	0	4646
24698	32	6	4619	23	0	4680
24699	28	8	4811	29	0	4876
24700	18	4967	109	29	0	5123
24701	60	97	63	4901	0	5121
24702	5111	16	14	98	0	5239
24703	103	11	19	5483	0	5616
24704	36	5561	19	118	0	5734
24705	5674	96	26	51	0	5847
24706	112	36	16	5668	0	5832
24707	39	5772	15	113	0	5939
24708	41	98	22	5835	0	5996
24709	30	34	17	5837	0	5918
24710	5683	20	22	148	0	5873
24711	129	20	16	5662	0	5827
24712	52	27	5571	137	0	5787
24713	60	21	101	5522	0	5704
24714	35	5384	46	139	0	5604
24715	22	5593	39	63	0	5717
24716	29	127	24	5458	0	5638
24717	36	53	23	5431	0	5543
24718	28	5319	23	158	0	5528
24719	30	5418	19	95	0	5562
24720	30	5508	21	62	0	5621
24721	36	154	12	5228	0	5430
24722	23	5484	14	134	0	5655
24723	5447	144	13	86	0	5690
24724	110	65	5514	82	0	5771
24725	63	69	103	5454	0	5689
24726	37	5594	30	148	0	5809
24727	5546	139	34	94	0	5813
24728	127	78	5610	70	0	5885
24729	56	5617	117	60	0	5850
24730	5546	138	52	64	0	5800
24731	119	5488	39	45	0	5691
24732	39	5633	25	56	0	5753
24733	61	158	19	5573	0	5811
24734	37	5605	17	131	0	5790
24735	5548	152	20	62	0	5782
24736	120	68	20	5577	0	5785
24737	46	69	5550	125	0	5790
24738	60	64	5556	52	0	5732
24739	39	70	123	5530	0	5762
24740	32	58	5640	134	0	5864
24741	42	53	124	5612	0	5831
24742	5486	54	37	160	0	5737
24743	123	47	5494	58	0	5722
24744	50	47	115	5361	0	5573
24745	35	5310	58	127	0	5530
24746	36	126	42	5447	0	5651
24747	39	69	32	5481	0	5621
24748	38	5357	40	157	0	5592
24749	27	127	42	5575	0	5771
24750	44	59	25	5596	0	5724
24751	39	63	5512	152	0	5766
24752	24	5487	120	97	0	5728
24753	5498	133	59	82	0	5772
24754	122	60	41	5586	0	5809
24755	52	56	5553	156	0	5817
24756	43	47	125	5515	0	5730
24757	24	37	5467	174	0	5702
24758	5252	38	143	109	0	5542
24759	121	5468	60	70	0	5719
24760	59	126	47	5522	0	5754
24761	50	53	41	5664	0	5808
24762	5294	44	38	195	0	5571
24763	129	48	41	5373	0	5591
24764	56	36	5325	170	0	5587
24765	41	41	126	5172	0	5380
24766	35	5087	68	158	0	5348
24767	31	5242	43	101	0	5417
24768	32	5311	40	89	0	5472
24769	45	151	20	5271	0	5487
24770	30	67	5118	165	0	5380
24771	28	5118	124	97	0	5367
24772	4967	132	59	87	0	5245
24773	110	5047	42	75	0	5274
24774	5061	160	31	86	0	5338
24775	5085	72	31	78	0	5266
24776	133	64	4968	63	0	5228
24777	5033	61	117	74	0	5285
24778	5268	51	45	78	0	5442
24779	5059	49	49	74	0	5231
24780	5257	48	34	75	0	5414
24781	162	55	5164	54	0	5435
24782	5103	46	114	64	0	5327
24783	5289	47	53	48	0	5437
24784	144	5384	39	48	0	5615
24785	92	127	32	5326	0	5577
24786	86	62	26	5385	0	5559
24787	60	5356	35	128	0	5579
24788	5305	136	29	74	0	5544
24789	142	5351	41	51	0	5585
24790	5226	137	24	38	0	5425
24791	5271	64	27	46	0	5408
24792	145	5255	27	42	0	5469
24793	75	132	19	5236	0	5462
24794	65	52	5194	125	0	5436
24795	62	5132	110	56	0	5360
24796	65	169	33	4643	0	4910
24797	39	4721	36	69	0	4865
24798	45	4926	21	34	0	5026
24799	53	189	19	4561	0	4822
24800	23	55	4729	91	0	4898
24801	19	4520	85	52	0	4676
24802	16	4494	40	20	0	4570
24803	3908	76	14	24	0	4022
24804	51	33	15	3951	0	4050
24805	30	20	4	3933	0	3987
24806	20	14	3	4018	0	4055
24807	13	8	3971	86	0	4078
24808	24	6	54	3978	0	4062
24809	4	4080	26	90	0	4200
24810	4268	61	11	46	0	4386
24811	84	25	11	4269	0	4389
24812	28	16	4282	78	0	4404
24813	4429	14	73	46	0	4562
24814	112	6	26	4622	0	4766
24815	32	8	5064	95	0	5199
24816	17	6	5055	38	0	5116
24817	5199	6	129	28	0	5362
24818	5542	9	40	35	0	5626
24819	5542	5	23	18	0	5588
24820	5645	7	16	16	0	5684
24821	181	4	5481	8	0	5674
24822	65	5549	117	10	0	5741
24823	5542	125	37	12	0	5716
24824	129	5500	18	14	0	5661
24825	5487	132	19	22	0	5660
24826	135	5485	14	11	0	5645
24827	64	132	10	5442	0	5648
24828	44	52	8	5495	0	5599
24829	39	23	11	5460	0	5533
24830	18	5258	16	168	0	5460
24831	18	5439	11	63	0	5531
24832	26	145	11	5143	0	5325
24833	25	5260	10	133	0	5428
24834	33	144	5244	45	0	5466
24835	25	56	131	5210	0	5422
24836	20	36	5263	136	0	5455
24837	5138	23	134	58	0	5353
24838	5250	18	53	41	0	5362
24839	180	20	5164	25	0	5389
24840	75	23	5139	15	0	5252
24841	59	13	155	5077	0	5304
24842	29	24	5181	142	0	5376
24843	41	18	141	4930	0	5130
24844	27	4754	66	131	0	4978
24845	35	144	36	5158	0	5373
24846	28	58	23	5240	0	5349
24847	33	43	18	5246	0	5340
24848	27	31	5050	188	0	5296
24849	26	23	136	4989	0	5174
24850	25	23	54	5063	0	5165
24851	35	26	31	4948	0	5040
24852	28	4983	28	154	0	5193
24853	5008	142	23	77	0	5250
24854	5043	53	27	57	0	5180
24855	5062	31	20	59	0	5172
24856	175	31	34	4938	0	5178
24857	74	18	4920	161	0	5173
24858	68	26	4905	63	0	5062
24859	37	4946	162	52	0	5197
24860	4807	139	66	66	0	5078
24861	125	4888	47	44	0	5104
24862	4913	143	46	45	0	5147
24863	144	4938	27	37	0	5146
24864	4888	151	25	46	0	5110
24865	146	5145	30	47	0	5368
24866	69	149	28	5156	0	5402
24867	45	72	5093	155	0	5365
24868	62	37	5205	77	0	5381
24869	48	38	175	5127	0	5388
24870	48	26	72	5180	0	5326
24871	42	33	48	5308	0	5431
24872	43	35	5158	207	0	5443
24873	49	35	135	5115	0	5334
24874	5041	33	55	188	0	5317
24875	5120	38	36	96	0	5290
24876	181	5067	34	70	0	5352
24877	5021	142	36	76	0	5275
24878	169	4965	34	46	0	5214
24879	4983	161	30	48	0	5222
24880	5036	70	27	52	0	5185
24881	4932	43	42	53	0	5070
24882	206	40	4878	39	0	5163
24883	100	33	4859	42	0	5034
24884	4764	27	170	53	0	5014
24885	4929	32	85	31	0	5077
24886	201	27	48	4819	0	5095
24887	101	30	43	4976	0	5150
24888	80	27	32	5092	0	5231
24889	56	36	36	5174	0	5302
24890	47	31	31	5395	0	5504
24891	5253	40	29	223	0	5545
24892	169	39	23	5322	0	5553
24893	82	46	5251	183	0	5562
24894	5134	30	134	113	0	5411
24895	5368	34	73	70	0	5545
24896	198	5222	43	69	0	5532
24897	88	5380	40	48	0	5556
24898	4914	133	18	30	0	5095
24899	125	5021	21	32	0	5199
24900	4828	124	39	40	0	5031
24901	5129	38	24	47	0	5238
24902	5219	29	22	31	0	5301
24903	177	15	21	4975	0	5188
24904	89	4987	22	128	0	5226
24905	5124	99	21	63	0	5307
24906	146	43	15	5123	0	5327
24907	79	29	17	5068	0	5193
24908	4890	16	18	167	0	5091
24909	125	4797	11	84	0	5017
24910	53	106	10	4786	0	4955
24911	4817	49	12	115	0	4993
24912	111	4843	9	68	0	5031
24913	4836	94	8	57	0	4995
24914	132	46	4512	27	0	4717
24915	4342	33	65	25	0	4465
24916	100	4457	34	19	0	4610
24917	4299	61	44	21	0	4425
24918	4281	42	4	18	0	4345
24919	101	4352	2	11	0	4466
24920	4319	54	7	19	0	4399
24921	80	4271	3	6	0	4360
24922	4406	77	2	19	0	4504
24923	88	39	4	4389	0	4520
24924	61	22	2	4411	0	4496
24925	46	19	5	4480	0	4550
24926	31	14	4318	105	0	4468
24927	30	15	50	4361	0	4456
24928	24	12	4387	77	0	4500
24929	29	13	68	4362	0	4472
24930	20	4389	35	75	0	4519
24931	37	59	21	4473	0	4590
24932	25	44	4463	71	0	4603
24933	16	38	4521	47	0	4622
24934	33	17	80	4536	0	4666
24935	4528	14	49	83	0	4674
24936	4566	14	24	53	0	4657
24937	98	4545	10	48	0	4701
24938	63	54	11	4599	0	4727
24939	32	42	4721	74	0	4869
24940	34	27	56	4712	0	4829
24941	27	12	4731	85	0	4855
24942	4599	9	76	57	0	4741
24943	76	16	42	4744	0	4878
24944	54	22	4705	74	0	4855
24945	48	14	61	4721	0	4844
24946	29	14	40	4812	0	4895
24947	20	11	4761	105	0	4897
24948	38	11	58	4758	0	4865
24949	4772	12	40	106	0	4930
24950	4811	11	32	61	0	4915
24951	104	26	12	4856	0	4998
24952	4897	11	11	97	0	5016
24953	94	19	4873	57	0	5043
24954	63	14	4748	50	0	4875
24955	4880	11	95	39	0	5025
24956	5032	14	65	27	0	5138
24957	117	10	32	4898	0	5057
24958	87	17	26	4941	0	5071
24959	53	13	4874	121	0	5061
24960	28	22	72	4752	0	4874
24961	40	4819	55	96	0	5010
24962	4915	70	32	68	0	5085
24963	5263	44	19	54	0	5380
24964	137	5262	9	39	0	5447
24965	5117	88	21	37	0	5263
24966	5154	40	12	49	0	5255
24967	134	5228	28	26	0	5416
24968	5242	86	28	37	0	5393
24969	124	5212	23	29	0	5388
24970	5280	111	11	38	0	5440
24971	131	57	5171	36	0	5395
24972	72	42	96	5179	0	5389
24973	49	24	55	5323	0	5451
24974	45	13	45	5526	0	5629
24975	5437	22	20	179	0	5658
24976	132	15	19	5595	0	5761
24977	82	13	5552	155	0	5802
24978	5613	18	113	89	0	5833
24979	145	18	59	5636	0	5858
24980	79	5518	48	138	0	5783
24981	59	5756	28	74	0	5917
24982	50	149	19	5721	0	5939
24983	41	77	24	5712	0	5854
24984	49	43	21	5797	0	5910
24985	33	17	5578	212	0	5840
24986	21	5517	119	120	0	5777
24987	5443	106	51	89	0	5689
24988	5380	50	40	67	0	5537
24989	162	5276	28	39	0	5505
24990	74	5338	18	42	0	5472
24991	68	134	29	5200	0	5431
24992	37	59	5162	116	0	5374
24993	4960	52	114	72	0	5198
24994	5189	21	45	50	0	5305
24995	136	18	32	5101	0	5287
24996	73	15	16	5151	0	5255
24997	4967	12	10	151	0	5140
24998	110	13	4947	76	0	5146
24999	4843	9	100	61	0	5013
25000	119	4950	40	45	0	5154
25001	43	77	16	4608	0	4744
25002	33	4622	15	84	0	4754
25003	4682	81	9	43	0	4815
25004	86	31	6	4634	0	4757
25005	44	19	5	4611	0	4679
25006	19	4559	20	102	0	4700
25007	4600	77	15	52	0	4744
25008	4626	27	4	42	0	4699
25009	105	18	4497	28	0	4648
25010	46	22	4265	21	0	4354
25011	4318	12	82	23	0	4435
25012	86	6	4293	17	0	4402
25013	33	9	4047	16	0	4105
25014	4031	13	95	15	0	4154
25015	77	11	4350	13	0	4451
25016	38	11	106	4422	0	4577
25017	34	11	36	4501	0	4582
25018	4763	5	24	140	0	4932
25019	128	14	4864	57	0	5063
25020	5226	5	133	47	0	5411
25021	179	11	54	5321	0	5565
25022	5373	5	33	167	0	5578
25023	5457	9	22	76	0	5564
25024	5533	7	16	49	0	5605
25025	262	10	16	5324	0	5612
25026	5453	8	16	164	0	5641
25027	244	7	12	5373	0	5636
25028	145	10	13	5445	0	5613
25029	111	8	15	5518	0	5652
25030	98	14	10	5533	0	5655
25031	5335	9	11	283	0	5638
25032	5423	7	15	153	0	5598
25033	243	10	5235	113	0	5601
25034	5348	5	148	99	0	5600
25035	5540	5	62	95	0	5702
25036	272	7	47	5330	0	5656
25037	148	5263	29	196	0	5636
25038	5426	149	22	113	0	5710
25039	248	57	26	5229	0	5560
25040	5232	36	32	196	0	5496
25041	255	5161	29	90	0	5535
25042	5309	157	13	92	0	5571
25043	252	76	18	5162	0	5508
25044	134	5103	5	198	0	5440
25045	5210	172	10	111	0	5503
25046	215	5090	12	90	0	5407
25047	126	5331	9	71	0	5537
25048	5335	219	16	71	0	5641
25049	224	124	5172	51	0	5571
25050	5331	71	151	63	0	5616
25051	260	53	59	5239	0	5611
25052	146	45	5241	179	0	5611
25053	137	42	170	5172	0	5521
25054	110	40	83	5333	0	5566
25055	102	31	5241	254	0	5628
25056	5216	26	188	148	0	5578
25057	250	18	90	5316	0	5674
25058	147	20	58	5431	0	5656
25059	123	20	47	5443	0	5633
25060	5281	14	39	334	0	5668
25061	226	21	5157	197	0	5601
25062	133	25	5259	144	0	5561
25063	113	25	203	4940	0	5281
25064	90	15	4873	229	0	5207
25065	4716	17	200	161	0	5094
25066	207	4710	106	121	0	5144
25067	4712	132	88	96	0	5028
25068	232	74	61	4570	0	4937
25069	135	4585	73	171	0	4964
25070	119	149	61	4651	0	4980
25071	93	4670	49	201	0	5013
25072	109	177	37	4731	0	5054
25073	85	97	4599	223	0	5004
25074	81	77	4443	129	0	4730
25075	77	4473	160	128	0	4838
25076	4243	144	98	110	0	4595
25077	164	94	61	4201	0	4520
25078	105	78	38	4228	0	4449
25079	4163	56	43	220	0	4482
25080	4139	41	47	155	0	4382
25081	226	45	45	4114	0	4430
25082	151	38	4019	172	0	4380
25083	114	4011	142	98	0	4365
25084	100	127	75	4087	0	4389
25085	88	65	60	4112	0	4325
25086	87	4095	46	212	0	4440
25087	4156	151	34	148	0	4489
25088	180	83	4147	110	0	4520
25089	108	59	152	4093	0	4412
25090	86	52	81	4101	0	4320
25091	61	53	3972	239	0	4325
25092	63	45	149	4040	0	4297
25093	3962	47	77	233	0	4319
25094	3982	36	68	148	0	4234
25095	4025	33	72	119	0	4249
25096	233	3872	61	98	0	4264
25097	4035	136	51	101	0	4323
25098	224	70	65	3910	0	4269
25099	141	51	50	3959	0	4201
25100	117	4118	36	224	0	4495
25101	4640	160	35	138	0	4973
25102	4928	86	36	104	0	5154
25103	4997	78	41	85	0	5201
25104	5101	59	28	96	0	5284
25105	5084	48	27	104	0	5263
25106	336	55	4813	103	0	5307
25107	5025	50	181	87	0	5343
25108	5160	53	96	77	0	5386
25109	5136	30	74	69	0	5309
25110	388	26	65	4853	0	5332
25111	231	27	45	5006	0	5309
25112	162	39	4770	272	0	5243
25113	4218	29	210	198	0	4655
25114	258	4632	103	130	0	5123
25115	163	4403	70	77	0	4713
25116	130	168	4213	65	0	4576
25117	90	4109	149	72	0	4420
25118	54	4005	78	70	0	4207
25119	108	255	99	3291	0	3753
25120	29	3320	18	85	0	3452
25121	3207	117	10	39	0	3373
25122	3211	35	15	25	0	3286
25123	132	29	10	3094	0	3265
25124	65	21	3062	96	0	3244
25125	3051	12	96	41	0	3200
25126	121	14	3079	38	0	3252
25127	51	9	3143	27	0	3230
25128	50	10	123	2952	0	3135
25129	44	13	43	3082	0	3182
25130	25	9	3071	111	0	3216
25131	24	2959	96	48	0	3127
25132	17	3159	38	39	0	3253
25133	3056	103	33	31	0	3223
25134	3128	36	19	30	0	3213
25135	112	32	2996	17	0	3157
25136	2994	12	85	15	0	3106
25137	3167	15	28	16	0	3226
25138	123	13	27	3075	0	3238
25139	66	13	9	3124	0	3212
25140	51	12	11	3162	0	3236
25141	3102	11	9	128	0	3250
25142	3163	9	5	58	0	3235
25143	3227	3	8	36	0	3274
25144	157	5	6	3137	0	3305
25145	77	11	3070	97	0	3255
25146	3064	8	84	39	0	3195
25147	3102	10	28	30	0	3170
25148	138	6	31	2976	0	3151
25149	74	3001	13	89	0	3177
25150	59	87	5	3005	0	3156
25151	39	3046	12	108	0	3205
25152	31	109	11	2958	0	3109
25153	34	3038	18	101	0	3191
25154	2972	97	7	38	0	3114
25155	113	40	5	2943	0	3101
25156	44	2945	18	91	0	3098
25157	41	97	2915	30	0	3083
25158	2902	37	89	30	0	3058
25159	100	33	34	2890	0	3057
25160	46	2917	22	92	0	3077
25161	42	83	11	2854	0	2990
25162	33	2809	13	93	0	2948
25163	30	3017	11	37	0	3095
25164	2947	103	13	36	0	3099
25165	3073	40	17	28	0	3158
25166	111	33	3028	11	0	3183
25167	3024	19	91	17	0	3151
25168	3077	20	33	13	0	3143
25169	113	2977	23	26	0	3139
25170	45	87	15	2988	0	3135
25171	44	30	15	3021	0	3110
25172	32	29	2937	101	0	3099
25173	42	23	2921	35	0	3021
25174	2963	12	99	27	0	3101
25175	3071	6	43	24	0	3144
25176	3073	7	34	24	0	3138
25177	135	7	2948	15	0	3105
25178	76	5	86	2906	0	3073
25179	2971	10	32	100	0	3113
25180	96	7	30	2971	0	3104
25181	46	11	2889	106	0	3052
25182	2810	10	84	43	0	2947
25183	107	18	3002	20	0	3147
25184	47	2945	77	29	0	3098
25185	2991	79	36	29	0	3135
25186	95	26	2970	16	0	3107
25187	58	25	86	2905	0	3074
25188	2944	16	27	81	0	3068
25189	98	8	29	2973	0	3108
25190	3021	21	12	110	0	3164
25191	98	15	13	3043	0	3169
25192	3081	13	14	111	0	3219
25193	3151	14	5	56	0	3226
25194	3143	15	8	42	0	3208
25195	3116	14	16	30	0	3176
25196	130	25	12	3026	0	3193
25197	56	19	2957	71	0	3103
25198	42	18	2962	35	0	3057
25199	53	2909	74	28	0	3064
25200	21	2640	37	15	0	2713
25201	2100	46	60	19	0	2225
25202	34	13	5	1988	0	2040
25203	8	5	2043	21	0	2077
25204	10	1	2113	8	0	2132
25205	13	4	23	2149	0	2189
25206	2158	0	9	20	0	2187
25207	19	2163	4	7	0	2193
25208	2251	12	2	6	0	2271
25209	24	7	2	2302	0	2335
25210	18	3	1	2288	0	2310
25211	9	3	7	2281	0	2300
25212	3	1	2284	21	0	2309
25213	4	8	2187	7	0	2206
25214	3	2255	20	6	0	2284
25215	10	19	7	2353	0	2389
25216	2328	6	3	22	0	2359
25217	20	4	2310	10	0	2344
25218	9	11	2351	5	0	2376
25219	7	3	23	2399	0	2432
25220	11	3	8	2464	0	2486
25221	6	7	6	2496	0	2515
25222	13	6	4	2600	0	2623
25223	2691	3	2	44	0	2740
25224	42	2	2	2775	0	2821
25225	2798	1	5	54	0	2858
25226	40	1	2869	10	0	2920
25227	13	2903	44	7	0	2967
25228	12	41	14	2925	0	2992
25229	7	15	2951	44	0	3017
25230	13	10	2861	18	0	2902
25231	8	2942	48	9	0	3007
25232	7	35	20	2908	0	2970
25233	9	7	13	2928	0	2957
25234	2	8	2901	52	0	2963
25235	2829	7	44	22	0	2902
25236	39	3	13	2935	0	2990
25237	16	2	10	2926	0	2954
25238	8	5	3010	56	0	3079
25239	9	2969	42	22	0	3042
25240	7	3244	17	18	0	3286
25241	3290	65	9	20	0	3384
25242	64	17	7	3323	0	3411
25243	3524	7	13	76	0	3620
25244	79	4	3542	26	0	3651
25245	28	9	72	3541	0	3650
25246	3552	5	23	87	0	3667
25247	3631	6	15	41	0	3693
25248	98	16	10	3592	0	3716
25249	44	4	3571	80	0	3699
25250	22	5	3657	39	0	3723
25251	22	11	90	3635	0	3758
25252	13	5	3691	81	0	3790
25253	3544	7	77	39	0	3667
25254	85	3628	27	18	0	3758
25255	3688	64	17	22	0	3791
25256	3741	21	10	32	0	3804
25257	95	9	21	3733	0	3858
25258	34	10	26	3790	0	3860
25259	3754	5	18	109	0	3886
25260	79	8	18	3770	0	3875
25261	40	8	3745	83	0	3876
25262	25	3679	66	36	0	3806
25263	33	63	28	3685	0	3809
25264	26	23	17	3701	0	3767
25265	14	9	13	3713	0	3749
25266	26	6	3581	108	0	3721
25267	27	3536	75	47	0	3685
25268	15	67	29	3637	0	3748
25269	8	21	3617	87	0	3733
25270	17	21	78	3611	0	3727
25271	3621	10	30	109	0	3770
25272	81	12	21	3670	0	3784
25273	35	6	3647	98	0	3786
25274	3567	12	84	49	0	3712
25275	77	3687	37	27	0	3828
25276	40	3833	28	32	0	3933
25277	3859	83	26	35	0	4003
25278	88	26	3942	41	0	4097
25279	48	13	82	3918	0	4061
25280	32	7	37	4042	0	4118
25281	16	10	3988	104	0	4118
25282	31	3951	79	55	0	4116
25283	30	81	34	3584	0	3729
25284	30	31	3917	92	0	4070
25285	33	18	96	3901	0	4048
25286	3915	13	39	106	0	4073
25287	86	15	4010	58	0	4169
25288	39	7	86	4041	0	4173
25289	24	16	46	4060	0	4146
25290	16	26	3947	114	0	4103
25291	32	14	86	3822	0	3954
25292	26	3457	56	120	0	3659
25293	29	76	34	3731	0	3870
25294	38	3851	30	90	0	4009
25295	3900	85	30	60	0	4075
25296	3866	28	23	57	0	3974
25297	105	19	3869	44	0	4037
25298	45	15	3818	41	0	3919
25299	25	25	3781	38	0	3869
25300	23	3786	92	31	0	3932
25301	23	80	50	3848	0	4001
25302	28	38	3891	79	0	4036
25303	42	15	72	3685	0	3814
25304	32	15	40	3717	0	3804
25305	32	13	3730	106	0	3881
25306	32	15	90	3712	0	3849
25307	22	17	41	3705	0	3785
25308	15	3646	27	112	0	3800
25309	24	61	25	3698	0	3808
25310	20	24	25	3840	0	3909
25311	13	16	3742	123	0	3894
25312	27	28	79	3712	0	3846
25313	20	15	3743	103	0	3881
25314	19	13	3670	62	0	3764
25315	3547	17	92	53	0	3709
25316	78	33	52	3628	0	3791
25317	29	3656	27	98	0	3810
25318	19	3773	34	59	0	3885
25319	21	83	39	3819	0	3962
25320	13	35	3810	101	0	3959
25321	21	3795	93	46	0	3955
25322	24	70	45	3749	0	3888
25323	19	27	3810	76	0	3932
25324	17	3811	55	51	0	3934
25325	3966	62	36	41	0	4105
25326	3965	30	28	44	0	4067
25327	4072	25	24	47	0	4168
25328	82	20	26	4379	0	4507
25329	38	19	14	4468	0	4539
25330	14	8	17	4485	0	4524
25331	14	17	4378	105	0	4514
25332	4397	20	75	60	0	4552
25333	90	10	37	4442	0	4579
25334	33	12	4436	89	0	4570
25335	4489	9	80	59	0	4637
25336	4633	12	37	57	0	4739
25337	95	55	3825	59	0	4034
25338	4475	12	58	47	0	4592
25339	83	4582	38	37	0	4740
25340	31	49	4443	26	0	4549
25341	4271	23	67	28	0	4389
25342	61	4359	23	27	0	4470
25343	22	36	10	4154	0	4222
25344	8	4144	14	39	0	4205
25345	21	37	9	4187	0	4254
25346	11	17	4209	42	0	4279
25347	3885	5	46	32	0	3968
25348	41	6	4212	10	0	4269
25349	21	4121	42	13	0	4197
25350	9	4146	22	9	0	4186
25351	4093	45	12	13	0	4163
25352	45	22	4096	4	0	4167
25353	27	12	43	4029	0	4111
25354	15	11	4177	37	0	4240
25355	11	4209	40	21	0	4281
25356	14	49	21	3980	0	4064
25357	12	4244	10	39	0	4305
25358	4281	46	17	27	0	4371
25359	4343	20	11	30	0	4404
25360	4344	8	19	15	0	4386
25361	64	15	4258	9	0	4346
25362	28	12	4162	12	0	4214
25363	4207	22	51	18	0	4298
25364	55	14	4366	5	0	4440
25365	40	8	48	4132	0	4228
25366	20	4285	25	40	0	4370
25367	4442	38	18	25	0	4523
25368	4423	17	22	16	0	4478
25369	4552	10	9	26	0	4597
25370	59	10	15	4537	0	4621
25371	25	9	9	4580	0	4623
25372	4561	12	8	67	0	4648
25373	72	4483	8	21	0	4584
25374	4482	46	10	17	0	4555
25375	68	16	10	4372	0	4466
25376	32	6	12	4401	0	4451
25377	4288	6	10	79	0	4383
25378	62	4198	13	30	0	4303
25379	4203	54	7	18	0	4282
25380	58	4245	8	12	0	4323
25381	4236	48	3	21	0	4308
25382	64	22	3	4628	0	4717
25383	4666	9	7	67	0	4749
25384	4782	17	1	44	0	4844
25385	5280	10	4	33	0	5327
25386	86	5475	11	15	0	5587
25387	50	80	5340	2	0	5472
25388	5366	29	71	24	0	5490
25389	5527	4	24	16	0	5571
25390	112	5425	4	18	0	5559
25391	58	68	11	5516	0	5653
25392	28	43	8	5569	0	5648
25393	5557	14	16	104	0	5691
25394	101	22	9	5588	0	5720
25395	64	10	5566	84	0	5724
25396	27	28	5459	41	0	5555
25397	5655	9	105	28	0	5797
25398	108	7	26	5748	0	5889
25399	71	7	14	5787	0	5879
25400	27	20	14	5884	0	5945
25401	30	6	5830	118	0	5984
25402	29	4	93	5829	0	5955
25403	49	8	34	5992	0	6083
25404	25	7	14	6092	0	6138
25405	5918	7	20	152	0	6097
25406	106	6	15	5975	0	6102
25407	60	6	6023	117	0	6206
25408	6085	4	96	96	0	6281
25409	113	15	6315	41	0	6484
25410	6571	11	109	62	0	6753
25411	6645	7	47	36	0	6735
25412	178	6	5	6785	0	6974
25413	61	6779	29	159	0	7028
25414	58	113	14	6934	0	7119
25415	46	46	32	6973	0	7097
25416	37	6946	22	194	0	7199
25417	6966	125	25	96	0	7212
25418	150	6927	17	50	0	7144
25419	6925	144	25	60	0	7154
25420	7068	52	14	54	0	7188
25421	195	20	12	6897	0	7124
25422	88	29	7	6887	0	7011
25423	56	29	6654	188	0	6927
25424	58	31	6430	88	0	6607
25425	6313	14	160	72	0	6559
25426	6398	33	63	66	0	6560
25427	194	6055	24	55	0	6328
25428	85	120	21	5892	0	6118
25429	57	39	6049	149	0	6294
25430	62	92	136	5952	0	6242
25431	5912	15	68	166	0	6161
25432	5829	28	31	80	0	5968
25433	177	5741	31	35	0	5984
25434	102	101	18	5737	0	5958
25435	44	55	26	5830	0	5955
25436	47	24	16	5821	0	5908
25437	46	30	5509	171	0	5756
25438	5184	19	120	118	0	5441
25439	5483	36	46	56	0	5621
25440	181	27	5388	63	0	5659
25441	94	5403	113	56	0	5666
25442	5424	117	50	68	0	5659
25443	5470	47	52	66	0	5635
25444	181	25	5245	69	0	5520
25445	108	26	5460	54	0	5648
25446	78	15	148	5429	0	5670
25447	49	41	5475	131	0	5696
25448	5388	19	132	79	0	5618
25449	5471	24	66	53	0	5614
25450	5586	24	47	56	0	5713
25451	195	24	45	5342	0	5606
25452	102	5538	38	138	0	5816
25453	5639	106	37	82	0	5864
25454	5611	46	44	65	0	5766
25455	197	41	5402	45	0	5685
25456	119	28	5275	46	0	5468
25457	5266	13	152	60	0	5491
25458	167	26	68	5410	0	5671
25459	94	23	5387	145	0	5649
25460	77	5332	122	94	0	5625
25461	78	114	79	5391	0	5662
25462	5365	55	50	136	0	5606
25463	167	5480	48	67	0	5762
25464	105	125	37	5469	0	5736
25465	78	5396	49	156	0	5679
25466	60	5581	48	82	0	5771
25467	94	130	37	5520	0	5781
25468	73	60	45	5533	0	5711
25469	57	5475	63	164	0	5759
25470	5478	122	42	108	0	5750
25471	175	57	5494	60	0	5786
25472	5460	50	116	74	0	5700
25473	166	43	73	5557	0	5839
25474	111	50	41	5636	0	5838
25475	82	43	35	5678	0	5838
25476	95	36	45	5613	0	5789
25477	72	48	5597	176	0	5893
25478	80	29	126	5591	0	5826
25479	71	50	73	5617	0	5811
25480	68	5635	47	184	0	5934
25481	69	129	5691	117	0	6006
25482	55	5795	128	102	0	6080
25483	66	145	5891	77	0	6179
25484	58	5974	146	80	0	6258
25485	86	166	91	5342	0	5685
25486	5386	59	47	132	0	5624
25487	135	5436	37	83	0	5691
25488	94	127	33	5683	0	5937
25489	67	69	5744	145	0	6025
25490	39	5849	142	96	0	6126
25491	5758	131	83	79	0	6051
25492	5870	77	48	67	0	6062
25493	192	5846	36	61	0	6135
25494	93	156	5750	36	0	6035
25495	5654	80	151	48	0	5933
25496	163	69	76	5853	0	6161
25497	5780	38	64	161	0	6043
25498	174	5791	35	81	0	6081
25499	105	6024	28	70	0	6227
25500	92	173	5890	42	0	6197
25501	5905	104	147	64	0	6220
25502	160	77	81	6002	0	6320
25503	5979	49	48	150	0	6226
25504	168	5966	39	83	0	6256
25505	6039	122	35	61	0	6257
25506	6013	75	39	62	0	6189
25507	194	60	5894	56	0	6204
25508	113	5637	135	35	0	5920
25509	83	5737	64	38	0	5922
25510	60	181	41	5049	0	5331
25511	49	5092	30	102	0	5273
25512	5092	118	20	59	0	5289
25513	88	5141	19	30	0	5278
25514	58	124	14	4954	0	5150
25515	33	4961	7	97	0	5098
25516	29	4861	19	47	0	4956
25517	29	5033	9	27	0	5098
25518	40	144	8	4927	0	5119
25519	33	62	9	4975	0	5079
25520	26	41	11	4913	0	4991
25521	19	4826	6	119	0	4970
25522	32	89	4787	63	0	4971
25523	18	60	4724	44	0	4846
25524	4736	38	99	35	0	4908
25525	89	33	49	4881	0	5052
25526	50	31	4940	75	0	5096
25527	26	23	4935	53	0	5037
25528	19	5095	106	28	0	5248
25529	23	90	59	4850	0	5022
25530	17	54	30	5053	0	5154
25531	4980	33	21	122	0	5156
25532	87	29	17	4998	0	5131
25533	43	32	12	5051	0	5138
25534	26	30	5122	131	0	5309
25535	29	21	77	5161	0	5288
25536	26	26	46	5304	0	5402
25537	16	19	5288	136	0	5459
25538	16	18	5251	78	0	5363
25539	12	5227	111	55	0	5405
25540	21	79	5289	42	0	5431
25541	24	45	103	5153	0	5325
25542	63	37	81	4308	0	4489
25543	13	28	5319	118	0	5478
25544	21	5243	85	70	0	5419
25545	5044	81	60	61	0	5246
25546	74	5204	43	45	0	5366
25547	43	103	32	5240	0	5418
25548	25	64	27	5310	0	5426
25549	18	5249	16	139	0	5422
25550	25	98	24	5245	0	5392
25551	31	57	23	5260	0	5371
25552	20	39	5004	143	0	5206
25553	13	4977	95	91	0	5176
25554	13	103	57	5054	0	5227
25555	13	58	5022	128	0	5221
25556	26	43	103	5019	0	5191
25557	24	37	67	5026	0	5154
25558	20	34	37	5143	0	5234
25559	19	36	41	5073	0	5169
25560	24	37	34	4968	0	5063
25561	28	4980	15	169	0	5192
25562	4943	90	25	103	0	5161
25563	85	68	4815	68	0	5036
25564	4375	48	84	83	0	4590
25565	97	29	5018	47	0	5191
25566	50	5125	99	50	0	5324
25567	45	90	5128	49	0	5312
25568	20	5226	112	51	0	5409
25569	35	108	69	4954	0	5166
25570	25	73	43	5101	0	5242
25571	27	5131	34	149	0	5341
25572	20	5404	37	92	0	5553
25573	5445	148	26	65	0	5684
25574	5645	79	24	65	0	5813
25575	5678	46	16	55	0	5795
25576	5767	33	20	46	0	5866
25577	161	29	22	5599	0	5811
25578	87	5642	21	97	0	5847
25579	5662	105	17	88	0	5872
25580	106	67	16	5642	0	5831
25581	5524	42	16	104	0	5686
25582	5395	34	21	73	0	5523
25583	116	5108	20	36	0	5280
25584	63	4871	19	33	0	4986
25585	27	5114	13	31	0	5185
25586	28	181	26	4708	0	4943
25587	21	4854	16	49	0	4940
25588	4651	41	9	47	0	4748
25589	4742	21	6	24	0	4793
25590	4772	10	3	29	0	4814
25591	4862	10	5	31	0	4908
25592	4908	12	5	22	0	4947
25593	67	8	5047	12	0	5134
25594	5051	10	47	22	0	5130
25595	60	13	5139	8	0	5220
25596	5094	6	48	23	0	5171
25597	61	11	25	5152	0	5249
25598	33	9	5048	47	0	5137
25599	23	8	5133	27	0	5191
25600	13	5423	62	11	0	5509
25601	5407	57	31	27	0	5522
25602	5607	26	13	16	0	5662
25603	86	6032	14	6	0	6138
25604	42	77	5	6919	0	7043
25605	7575	30	10	124	0	7739
25606	145	26	7729	31	0	7931
25607	45	7740	134	23	0	7942
25608	7630	143	36	30	0	7839
25609	151	7740	33	16	0	7940
25610	67	170	14	7480	0	7731
25611	53	7820	14	135	0	8022
25612	60	184	16	7574	0	7834
25613	29	7641	23	145	0	7838
25614	25	7956	10	59	0	8050
25615	7688	187	7	61	0	7943
25616	7988	84	19	40	0	8131
25617	172	72	7900	36	0	8180
25618	83	56	7703	33	0	7875
25619	68	50	7899	25	0	8042
25620	52	51	194	7908	0	8205
25621	46	48	8055	163	0	8312
25622	61	50	177	7943	0	8231
25623	59	33	73	7993	0	8158
25624	25	8109	59	186	0	8379
25625	8148	164	36	104	0	8452
25626	174	8321	45	62	0	8602
25627	69	193	39	8598	0	8899
25628	56	79	45	8646	0	8826
25629	66	55	44	8680	0	8845
25630	53	36	8503	226	0	8818
25631	62	48	185	8423	0	8718
25632	66	41	89	8565	0	8761
25633	53	39	58	8706	0	8856
25634	30	51	8372	259	0	8712
25635	37	8338	155	132	0	8662
25636	8322	177	64	124	0	8687
25637	8220	87	42	139	0	8488
25638	185	8578	36	113	0	8912
25639	110	193	31	8638	0	8972
25640	87	86	38	8909	0	9120
25641	59	89	8678	233	0	9059
25642	61	8650	177	143	0	9031
25643	59	185	70	8826	0	9140
25644	50	70	8841	224	0	9185
25645	43	72	201	8680	0	8996
25646	60	60	72	8700	0	8892
25647	49	54	8728	256	0	9087
25648	54	69	186	8702	0	9011
25649	58	68	90	8636	0	8852
25650	59	58	8943	259	0	9319
25651	75	40	199	8980	0	9294
25652	56	65	100	8731	0	8952
25653	34	58	72	9232	0	9396
25654	32	29	9084	318	0	9463
25655	34	39	206	9136	0	9415
25656	9027	41	95	322	0	9485
25657	9101	37	87	191	0	9416
25658	186	9207	81	164	0	9638
25659	9397	180	54	164	0	9795
25660	200	68	9801	137	0	10206
25661	98	62	186	9927	0	10273
25662	86	44	88	10037	0	10255
25663	63	51	55	10226	0	10395
25664	9732	37	68	313	0	10150
25665	172	9658	80	167	0	10077
25666	88	177	41	9556	0	9862
25667	73	9576	61	253	0	9963
25668	9518	193	55	181	0	9947
25669	171	9518	58	137	0	9884
25670	9489	196	50	118	0	9853
25671	205	9293	62	106	0	9666
25672	87	9356	42	107	0	9592
25673	96	197	40	9336	0	9669
25674	75	89	49	9311	0	9524
25675	58	82	56	9244	0	9440
25676	44	76	38	9283	0	9441
25677	43	71	9038	290	0	9442
25678	46	9082	164	163	0	9455
25679	50	178	55	8928	0	9211
25680	35	9088	65	239	0	9427
25681	54	196	9024	140	0	9414
25682	62	107	167	8947	0	9283
25683	61	91	64	9322	0	9538
25684	49	74	9113	259	0	9495
25685	49	8911	168	161	0	9289
25686	30	180	82	9009	0	9301
25687	31	66	8890	260	0	9247
25688	20	8901	176	177	0	9274
25689	26	181	72	8894	0	9173
25690	34	76	8783	255	0	9148
25691	38	79	8514	129	0	8760
25692	35	8448	193	123	0	8799
25693	39	8943	72	116	0	9170
25694	50	211	88	9254	0	9603
25695	50	118	63	9826	0	10057
25696	30	85	9861	285	0	10261
25697	9548	64	216	189	0	10017
25698	9832	67	93	150	0	10142
25699	248	74	9937	119	0	10378
25700	99	9582	223	126	0	10030
25701	60	9686	112	121	0	9979
25702	46	9475	77	97	0	9695
25703	101	7592	87	107	0	7887
25704	178	429	78	7588	0	8273
25705	44	72	16	9067	0	9199
25706	24	37	8	9355	0	9424
25707	19	33	8	9592	0	9652
25708	3	9654	12	352	0	10021
25709	24	222	5	9847	0	10098
25710	5	9802	9	291	0	10107
25711	21	258	7	10000	0	10286
25712	9777	105	5	319	0	10206
25713	227	65	7	9909	0	10208
25714	96	9700	14	324	0	10134
25715	78	227	8	10000	0	10313
25716	51	100	6	10147	0	10304
25717	36	78	5	10206	0	10325
25718	9702	48	8	485	0	10243
25719	239	58	8	10055	0	10360
25720	99	50	9726	372	0	10247
25721	66	9947	216	216	0	10445
25722	60	261	94	10367	0	10782
25723	60	135	48	10602	0	10845
25724	52	90	28	10666	0	10836
25725	10135	74	20	508	0	10737
25726	273	69	9803	292	0	10437
25727	159	72	239	9675	0	10145
25728	84	9773	114	401	0	10372
25729	91	282	57	10001	0	10431
25730	9508	143	34	458	0	10143
25731	253	9772	44	269	0	10338
25732	153	304	36	9882	0	10375
25733	101	167	26	10040	0	10334
25734	46	9713	33	513	0	10305
25735	70	294	23	9992	0	10379
25736	69	148	21	10167	0	10405
25737	54	107	9568	497	0	10226
25738	46	9466	250	324	0	10086
25739	9426	303	123	258	0	10110
25740	267	171	9389	207	0	10034
25741	9217	119	263	206	0	9805
25742	347	104	9338	175	0	9964
25743	184	82	311	9387	0	9964
25744	9260	70	151	448	0	9929
25745	317	97	92	9427	0	9933
25746	9337	77	61	503	0	9978
25747	9417	83	48	342	0	9890
25748	9421	95	59	254	0	9829
25749	442	9146	70	199	0	9857
25750	260	330	54	9080	0	9724
25751	178	180	58	9347	0	9763
25752	144	133	60	9391	0	9728
25753	126	86	8947	553	0	9712
25754	135	79	300	9176	0	9690
25755	8937	74	164	516	0	9691
25756	9119	71	111	353	0	9654
25757	447	67	8803	256	0	9573
25758	8929	62	291	217	0	9499
25759	9044	60	166	193	0	9463
25760	497	84	123	8322	0	9026
25761	8379	85	97	428	0	8989
25762	8526	68	57	323	0	8974
25763	506	72	55	8367	0	9000
25764	8381	53	74	478	0	8986
25765	8523	51	77	305	0	8956
25766	510	65	88	8284	0	8947
25767	335	99	6607	450	0	7491
25768	7986	62	244	288	0	8580
25769	428	70	8113	222	0	8833
25770	301	63	8157	181	0	8702
25771	232	7911	405	208	0	8756
25772	222	250	204	7935	0	8611
25773	195	143	134	8220	0	8692
25774	192	90	92	8210	0	8584
25775	218	63	7878	553	0	8712
25776	220	54	7947	334	0	8555
25777	185	7881	396	256	0	8718
25778	194	296	213	7827	0	8530
25779	208	132	147	8128	0	8615
25780	184	78	125	8215	0	8602
25781	169	67	7771	536	0	8543
25782	167	7661	348	338	0	8514
25783	162	250	204	7894	0	8510
25784	168	145	7847	430	0	8590
25785	169	102	7950	294	0	8515
25786	7778	63	438	258	0	8537
25787	7954	49	263	210	0	8476
25788	8042	84	186	164	0	8476
25789	498	81	141	7618	0	8338
25790	272	60	7582	432	0	8346
25791	195	7430	317	328	0	8270
25792	146	7792	216	272	0	8426
25793	130	336	7126	205	0	7797
25794	176	292	315	6343	0	7126
25795	127	211	197	5833	0	6368
25796	108	5577	164	347	0	6196
25797	123	5639	139	222	0	6123
25798	5391	238	131	165	0	5925
25799	5579	147	92	124	0	5942
25800	5644	90	76	138	0	5948
25801	5611	55	88	118	0	5872
25802	5450	61	78	134	0	5723
25803	365	5068	80	127	0	5640
25804	187	4318	80	82	0	4667
25805	89	3369	48	51	0	3557
25806	2885	125	178	52	0	3240
25807	158	110	65	2604	0	2937
25808	57	15	27	2373	0	2472
25809	2338	14	14	88	0	2454
25810	57	2315	24	45	0	2441
25811	47	49	19	2326	0	2441
25812	39	32	28	2340	0	2439
25813	31	23	28	2360	0	2442
25814	2311	18	23	75	0	2427
25815	70	17	14	2348	0	2449
25816	32	22	2257	64	0	2375
25817	2230	27	43	46	0	2346
25818	62	29	24	2258	0	2373
25819	48	19	2253	53	0	2373
25820	42	2233	43	40	0	2358
25821	19	2024	14	28	0	2085
25822	1820	35	37	15	0	1907
25823	1778	5	12	27	0	1822
25824	27	1786	7	11	0	1831
25825	15	18	7	1903	0	1943
25826	2017	8	4	33	0	2062
25827	33	4	6	2174	0	2217
25828	15	5	7	2231	0	2258
25829	11	7	3	2245	0	2266
25830	8	4	5	2244	0	2261
25831	10	2169	5	50	0	2234
25832	10	35	2	2229	0	2276
25833	9	13	1	2239	0	2262
25834	13	9	1	2241	0	2264
25835	10	9	2164	59	0	2242
25836	2	2179	42	30	0	2253
25837	7	35	9	2231	0	2282
25838	6	11	2196	47	0	2260
25839	2	13	2091	21	0	2127
25840	3	2185	42	18	0	2248
25841	2166	34	19	22	0	2241
25842	33	14	17	2217	0	2281
25843	2221	11	11	48	0	2291
25844	45	2260	10	17	0	2332
25845	19	39	7	2258	0	2323
25846	2201	15	6	45	0	2267
25847	2241	14	6	22	0	2283
25848	59	9	4	2218	0	2290
25849	31	5	3	2235	0	2274
25850	15	8	2199	57	0	2279
25851	14	5	39	2195	0	2253
25852	16	9	10	2262	0	2297
25853	2192	6	11	62	0	2271
25854	40	2205	12	32	0	2289
25855	21	38	2157	25	0	2241
25856	2109	13	36	23	0	2181
25857	44	2186	13	19	0	2262
25858	22	39	14	2185	0	2260
25859	2175	14	7	47	0	2243
25860	43	17	3	2153	0	2216
25861	19	8	7	2171	0	2205
25862	20	9	2109	56	0	2194
25863	14	9	38	2125	0	2186
25864	2105	4	12	70	0	2191
25865	42	9	12	2113	0	2176
25866	2049	7	9	65	0	2130
25867	48	1999	5	38	0	2090
25868	22	2090	5	34	0	2151
25869	21	47	7	2105	0	2180
25870	13	21	5	2136	0	2175
25871	2058	19	9	69	0	2155
25872	48	2069	6	31	0	2154
25873	2097	43	6	38	0	2184
25874	2133	18	7	26	0	2184
25875	60	17	5	2102	0	2184
25876	2109	19	4	51	0	2183
25877	59	9	1991	24	0	2083
25878	35	10	37	2025	0	2107
25879	32	9	2044	51	0	2136
25880	18	9	46	2064	0	2137
25881	2050	4	17	62	0	2133
25882	2112	6	12	35	0	2165
25883	58	2088	12	32	0	2190
25884	30	35	6	2067	0	2138
25885	32	12	10	2095	0	2149
25886	20	2071	13	57	0	2161
25887	17	49	6	2123	0	2195
25888	13	15	8	2159	0	2195
25889	13	2077	5	65	0	2160
25890	2029	43	6	37	0	2115
25891	2042	20	5	35	0	2102
25892	54	24	3	2016	0	2097
25893	28	12	6	2032	0	2078
25894	26	11	1978	62	0	2077
25895	20	17	36	1974	0	2047
25896	13	1936	13	68	0	2030
25897	2002	38	9	35	0	2084
25898	44	18	12	2003	0	2077
25899	18	14	5	1975	0	2012
25900	1915	9	9	55	0	1988
25901	42	1927	5	38	0	2012
25902	24	41	4	1967	0	2036
25903	20	12	5	1985	0	2022
25904	19	1951	3	55	0	2028
25905	1954	49	2	32	0	2037
25906	45	16	1898	31	0	1990
25907	20	18	1923	18	0	1979
25908	19	22	40	1933	0	2014
25909	19	10	1921	42	0	1992
25910	1894	7	46	26	0	1973
25911	42	8	19	1940	0	2009
25912	19	7	1988	46	0	2060
25913	21	8	1954	23	0	2006
25914	20	1982	40	26	0	2068
25915	1960	35	22	17	0	2034
25916	41	1972	21	20	0	2054
25917	1974	40	15	17	0	2046
25918	1982	17	7	20	0	2026
25919	46	1921	6	12	0	1985
25920	1900	38	5	13	0	1956
25921	1918	13	2	14	0	1947
25922	50	15	1851	8	0	1924
25923	30	90	29	1723	0	1872
25924	22	1728	16	31	0	1797
25925	11	1645	12	12	0	1680
25926	34	48	8	1470	0	1560
25927	1348	9	11	20	0	1388
25928	13	3	4	1328	0	1348
25929	1	3	1	1379	0	1384
25930	8	0	3	1425	0	1436
25931	3	1490	3	20	0	1516
25932	6	17	3	1596	0	1622
25933	5	3	1788	29	0	1825
25934	1823	5	30	4	0	1862
25935	1980	4	7	13	0	2004
25936	44	1947	6	3	0	2000
25937	1999	32	3	3	0	2037
25938	44	10	1	2030	0	2085
25939	19	4	1999	34	0	2056
25940	1959	7	31	12	0	2009
25941	36	2008	9	6	0	2059
25942	15	28	4	2001	0	2048
25943	2050	10	4	33	0	2097
25944	34	1989	5	12	0	2040
25945	15	2067	7	8	0	2097
25946	2059	38	4	9	0	2110
25947	36	17	2012	5	0	2070
25948	2035	13	28	5	0	2081
25949	37	10	10	2014	0	2071
25950	20	4	6	2051	0	2081
25951	12	4	1999	40	0	2055
25952	10	3	1978	18	0	2009
25953	10	4	37	2017	0	2068
25954	4	5	1991	39	0	2039
25955	7	3	1996	13	0	2019
25956	14	3	43	1979	0	2039
25957	7	3	17	2026	0	2053
25958	2011	3	12	43	0	2069
25959	38	4	8	1992	0	2042
25960	1995	5	4	44	0	2048
25961	38	1996	2	20	0	2056
25962	21	29	3	2023	0	2076
25963	15	12	2029	35	0	2091
25964	2014	8	31	16	0	2069
25965	2075	9	10	14	0	2108
25966	2091	7	9	14	0	2121
25967	2073	3	10	9	0	2095
25968	2056	3	7	8	0	2074
25969	55	2	7	1992	0	2056
25970	25	4	1970	35	0	2034
25971	15	3	1953	18	0	1989
25972	11	1	1990	13	0	2015
25973	1943	3	49	15	0	2010
25974	2012	3	24	12	0	2051
25975	50	4	15	1945	0	2014
25976	23	2032	13	37	0	2105
25977	20	29	8	2063	0	2120
25978	10	14	2052	47	0	2123
25979	12	8	2053	24	0	2097
25980	2019	7	46	14	0	2086
25981	43	2	2146	14	0	2205
25982	26	4	46	2129	0	2205
25983	2185	3	23	44	0	2255
25984	2065	6	10	26	0	2107
25985	2244	7	14	18	0	2283
25986	2234	5	14	14	0	2267
25987	60	3	2156	15	0	2234
25988	2157	1	42	14	0	2214
25989	65	2150	18	7	0	2240
25990	32	42	9	2190	0	2273
25991	18	20	2192	44	0	2274
25992	25	6	39	2181	0	2251
25993	19	9	2215	43	0	2286
25994	20	8	45	2199	0	2272
25995	22	13	23	2243	0	2301
25996	20	2	2184	57	0	2263
25997	20	7	51	2175	0	2253
25998	2231	3	22	58	0	2314
25999	48	6	12	2265	0	2331
26000	24	10	19	2309	0	2362
26001	2264	4	18	62	0	2348
26002	54	2263	17	31	0	2365
26003	2278	35	12	26	0	2351
26004	52	2321	15	17	0	2405
26005	2371	40	8	27	0	2446
26006	52	17	2348	15	0	2432
26007	37	12	40	2344	0	2433
26008	20	13	21	2388	0	2442
26009	2362	4	16	58	0	2440
26010	48	2325	20	23	0	2416
26011	23	38	14	2369	0	2444
26012	17	13	17	2324	0	2371
26013	25	2266	14	59	0	2364
26014	2257	38	11	29	0	2335
26015	45	2249	14	28	0	2336
26016	26	34	11	2267	0	2338
26017	26	16	9	2231	0	2282
26018	19	2205	14	51	0	2289
26019	2206	38	9	34	0	2287
26020	48	16	2163	22	0	2249
26021	2118	11	42	22	0	2193
26022	53	2152	17	12	0	2234
26023	35	37	7	2188	0	2267
26024	2199	17	12	50	0	2278
26025	47	12	7	2218	0	2284
26026	27	14	5	2249	0	2295
26027	2259	10	14	59	0	2342
26028	48	2203	10	31	0	2292
26029	27	2269	10	21	0	2327
26030	2223	35	6	22	0	2286
26031	41	13	2187	10	0	2251
26032	21	2107	20	7	0	2155
26033	26	37	29	1900	0	1992
26034	10	6	2141	18	0	2175
26035	8	12	28	2025	0	2073
26036	2064	6	2	26	0	2098
26037	23	2085	4	7	0	2119
26038	8	22	5	2018	0	2053
26039	1	2094	2	23	0	2120
26040	2152	23	0	8	0	2183
26041	2182	5	0	6	0	2193
26042	30	2208	1	8	0	2247
26043	8	29	2	2215	0	2254
26044	5	2341	3	34	0	2383
26045	2395	36	3	8	0	2442
26046	2442	8	1	7	0	2458
26047	47	8	1	2417	0	2473
26048	9	6	2	2461	0	2478
26049	11	4	2392	48	0	2455
26050	2290	5	40	12	0	2347
26051	46	3	2396	8	0	2453
26052	16	6	41	2387	0	2450
26053	2388	1	8	41	0	2438
26054	46	2419	2	9	0	2476
26055	2325	42	6	18	0	2391
26056	50	11	2239	13	0	2313
26057	2318	5	34	9	0	2366
26058	47	2421	9	10	0	2487
26059	2415	39	5	17	0	2476
26060	49	2452	6	7	0	2514
26061	22	46	3	2445	0	2516
26062	11	17	2369	98	0	2495
26063	17	14	2366	12	0	2409
26064	14	10	44	2404	0	2472
26065	15	10	2422	46	0	2493
26066	11	10	43	2408	0	2472
26067	13	5	11	2426	0	2455
26068	8	11	2472	49	0	2540
26069	2271	7	39	32	0	2349
26070	2452	8	13	16	0	2489
26071	45	2435	10	15	0	2505
26072	2439	37	7	19	0	2502
26073	53	8	15	2432	0	2508
26074	15	6	2537	46	0	2604
26075	12	6	45	2521	0	2584
26076	18	14	11	2527	0	2570
26077	2482	7	3	56	0	2548
26078	49	2431	10	14	0	2504
26079	14	2439	6	10	0	2469
26080	16	46	6	2440	0	2508
26081	14	18	6	2373	0	2411
26082	9	2342	12	39	0	2402
26083	13	40	5	2334	0	2392
26084	7	11	6	2315	0	2339
26085	11	2269	6	51	0	2337
26086	2265	41	9	24	0	2339
26087	38	11	10	2272	0	2331
26088	12	2290	6	50	0	2358
26089	13	43	7	2327	0	2390
26090	2297	16	5	53	0	2371
26091	42	2302	2	19	0	2365
26092	2339	40	5	24	0	2408
26093	2388	13	4	13	0	2418
26094	58	10	3	2392	0	2463
26095	2417	9	4	59	0	2489
26096	2476	12	2	17	0	2507
26097	2466	8	5	20	0	2499
26098	2451	8	4	11	0	2474
26099	54	9	3	2420	0	2486
26100	20	3	4	2434	0	2461
26101	20	9	2371	50	0	2450
26102	18	9	38	2361	0	2426
26103	21	10	6	2394	0	2431
26104	15	11	2328	57	0	2411
26105	2269	7	41	22	0	2339
26106	54	11	5	2356	0	2426
26107	12	10	2383	63	0	2468
26108	2323	10	49	24	0	2406
26109	59	6	2627	13	0	2705
26110	12	2661	52	20	0	2745
26111	16	2765	11	18	0	2810
26112	16	57	13	2869	0	2955
26113	14	15	3119	71	0	3219
26114	3155	8	63	24	0	3250
26115	3347	9	17	24	0	3397
26116	93	7	3249	13	0	3362
26117	3288	8	75	15	0	3386
26118	3320	4	13	28	0	3365
26119	86	3306	14	15	0	3421
26120	3332	67	12	17	0	3428
26121	90	15	13	3314	0	3432
26122	33	12	3314	72	0	3431
26123	29	9	67	3159	0	3264
26124	19	3316	20	65	0	3420
26125	17	3418	16	30	0	3481
26126	3405	67	21	22	0	3515
26127	3372	24	15	24	0	3435
26128	3377	16	17	18	0	3428
26129	95	13	8	3300	0	3416
26130	36	30	16	3233	0	3315
26131	33	3198	18	80	0	3329
26132	3212	65	16	38	0	3331
26133	78	3267	23	27	0	3395
26134	2972	63	12	26	0	3073
26135	92	2954	19	14	0	3079
26136	2956	60	24	19	0	3059
26137	2904	21	14	26	0	2965
26138	104	31	17	2859	0	3011
26139	49	2910	11	61	0	3031
26140	62	64	2766	19	0	2911
26141	2761	31	44	26	0	2862
26142	76	2701	19	17	0	2813
26143	39	51	2709	33	0	2832
26144	18	29	2680	26	0	2753
26145	32	42	43	2558	0	2675
26146	38	24	11	2485	0	2558
26147	32	2640	12	41	0	2725
26148	2730	52	3	20	0	2805
26149	72	26	4	2708	0	2810
26150	40	2814	4	51	0	2909
26151	37	2974	2	30	0	3043
26152	29	51	2929	31	0	3040
26153	28	37	2912	15	0	2992
26154	2886	30	47	16	0	2979
26155	63	32	2951	9	0	3055
26156	43	35	39	2905	0	3022
26157	44	26	17	2996	0	3083
26158	30	20	3007	54	0	3111
26159	34	17	42	2945	0	3038
26160	29	19	21	2865	0	2934
26161	2970	19	25	57	0	3071
26162	3040	29	25	20	0	3114
26163	71	18	22	2982	0	3093
26164	29	2946	23	40	0	3038
26165	21	3107	27	23	0	3178
26166	3111	47	27	29	0	3214
26167	49	31	3080	31	0	3191
26168	35	17	51	3084	0	3187
26169	3161	24	23	62	0	3270
26170	3220	35	22	30	0	3307
26171	63	29	14	3246	0	3352
26172	32	28	3218	57	0	3335
26173	33	35	3048	25	0	3141
26174	3078	13	65	41	0	3197
26175	3196	23	54	30	0	3303
26176	80	3213	38	28	0	3359
26177	45	3366	28	42	0	3481
26178	3489	58	35	50	0	3632
26179	3572	37	24	49	0	3682
26180	75	20	26	3670	0	3791
26181	56	26	24	3737	0	3843
26182	55	15	26	3807	0	3903
26183	3771	17	27	74	0	3889
26184	99	25	19	3768	0	3911
26185	61	31	3789	68	0	3949
26186	3792	31	57	41	0	3921
26187	91	38	30	3851	0	4010
26188	60	23	3896	66	0	4045
26189	3795	29	55	54	0	3933
26190	3629	32	28	53	0	3742
26191	78	3972	22	48	0	4120
26192	64	4085	31	26	0	4206
26193	49	60	3892	41	0	4042
26194	3985	32	53	37	0	4107
26195	77	4119	43	24	0	4263
26196	74	56	3911	34	0	4075
26197	4008	48	42	42	0	4140
26198	81	4442	23	29	0	4575
26199	59	60	4419	43	0	4581
26200	4371	32	47	41	0	4491
26201	83	4483	21	42	0	4629
26202	54	48	20	4533	0	4655
26203	4547	32	31	79	0	4689
26204	80	4551	17	52	0	4700
26205	45	72	24	4552	0	4693
26206	4556	31	28	65	0	4680
26207	56	18	4537	49	0	4660
26208	41	4436	62	37	0	4576
26209	49	44	4280	23	0	4396
26210	26	41	56	4174	0	4297
26211	28	15	4222	41	0	4306
26212	27	4025	28	23	0	4103
26213	5	3806	32	8	0	3851
26214	16	25	11	3773	0	3825
26215	11	8	6	3640	0	3665
26216	7	11	1	3697	0	3716
26217	4	2	3905	18	0	3929
26218	8	7	14	3889	0	3918
26219	3901	4	7	26	0	3938
26220	3859	2	4	18	0	3883
26221	26	3	4017	6	0	4052
26222	9	4000	15	14	0	4038
26223	4045	15	9	17	0	4086
26224	15	4011	4	10	0	4040
26225	4062	17	2	13	0	4094
26226	4059	7	1	21	0	4088
26227	25	2	4059	4	0	4090
26228	14	4117	17	4	0	4152
26229	12	14	6	4168	0	4200
26230	8	12	4152	16	0	4188
26231	3972	3	20	18	0	4013
26232	29	4	9	4140	0	4182
26233	8	4	4074	16	0	4102
26234	3961	6	12	22	0	4001
26235	23	5	4202	7	0	4237
26236	18	3	21	4231	0	4273
26237	4428	3	15	30	0	4476
26238	25	4526	8	19	0	4578
26239	13	22	4660	8	0	4703
26240	4592	15	25	15	0	4647
26241	5111	4	16	14	0	5145
26242	43	5244	14	11	0	5312
26243	32	32	2	5277	0	5343
26244	12	24	3	5282	0	5321
26245	5231	7	9	62	0	5309
26246	52	4	1	5279	0	5336
26247	30	5	5265	45	0	5345
26248	13	9	44	5223	0	5289
26249	5194	5	18	66	0	5283
26250	44	5133	8	32	0	5217
26251	36	45	9	5018	0	5108
26252	15	5120	2	46	0	5183
26253	5194	43	9	33	0	5279
26254	54	26	7	5618	0	5705
26255	50	7	5	5784	0	5846
26256	10	5815	12	105	0	5942
26257	13	85	5695	47	0	5840
26258	29	42	73	5693	0	5837
26259	18	20	37	5820	0	5895
26260	19	9	14	5801	0	5843
26261	12	5719	9	123	0	5863
26262	12	84	5738	54	0	5888
26263	13	43	5762	26	0	5844
26264	5799	20	116	46	0	5981
26265	5974	11	56	44	0	6085
26266	119	14	6009	18	0	6160
26267	5921	6	88	40	0	6055
26268	100	15	6101	19	0	6235
26269	5907	1	102	45	0	6055
26270	103	6056	49	17	0	6225
26271	6092	83	23	25	0	6223
26272	112	42	6111	17	0	6282
26273	59	25	6149	16	0	6249
26274	54	17	124	6324	0	6519
26275	6448	14	63	127	0	6652
26276	123	6785	35	62	0	7005
26277	63	122	7445	26	0	7656
26278	58	43	154	7515	0	7770
26279	44	24	79	7852	0	7999
26280	7666	17	37	246	0	7966
26281	7742	20	20	101	0	7883
26282	239	22	26	7620	0	7907
26283	7718	14	18	211	0	7961
26284	200	22	7536	88	0	7846
26285	125	11	158	7514	0	7808
26286	77	14	86	7734	0	7911
26287	7586	13	38	255	0	7892
26288	7607	14	38	128	0	7787
26289	262	15	26	7515	0	7818
26290	7549	17	22	218	0	7806
26291	208	16	7339	113	0	7676
26292	113	7284	165	70	0	7632
26293	56	155	7315	54	0	7580
26294	78	86	184	7314	0	7662
26295	7239	26	85	211	0	7561
26296	199	7136	48	126	0	7509
26297	117	169	40	7127	0	7453
26298	60	74	45	6891	0	7070
26299	53	6820	38	251	0	7162
26300	64	168	29	6938	0	7199
26301	73	82	23	6970	0	7148
26302	67	37	26	7061	0	7191
26303	62	29	27	7018	0	7136
26304	68	20	40	6915	0	7043
26305	36	6626	42	280	0	6984
26306	53	165	35	6813	0	7066
26307	65	75	32	6858	0	7030
26308	43	53	6565	273	0	6934
26309	54	6554	169	150	0	6927
26310	47	184	75	6654	0	6960
26311	59	85	48	6719	0	6911
26312	63	48	42	6697	0	6850
26313	32	6473	44	300	0	6849
26314	52	170	6452	170	0	6844
26315	66	79	177	6632	0	6954
26316	61	52	6585	251	0	6949
26317	41	38	6500	158	0	6737
26318	49	38	227	6519	0	6833
26319	6572	38	114	250	0	6974
26320	192	34	66	6646	0	6938
26321	113	30	49	6613	0	6805
26322	65	6561	57	283	0	6966
26323	67	174	36	6809	0	7086
26324	66	85	48	6909	0	7108
26325	32	44	6745	333	0	7154
26326	57	6698	170	182	0	7107
26327	53	182	100	6825	0	7160
26328	6599	92	59	263	0	7013
26329	186	46	6601	165	0	6998
26330	116	35	203	6653	0	7007
26331	63	39	100	6833	0	7035
26332	6589	31	54	323	0	6997
26333	190	6572	43	174	0	6979
26334	6528	169	34	179	0	6910
26335	195	6547	39	129	0	6910
26336	100	194	42	6575	0	6911
26337	6422	98	25	277	0	6822
26338	188	58	6373	167	0	6786
26339	100	6206	180	131	0	6617
26340	60	6319	87	126	0	6592
26341	5779	202	62	113	0	6156
26342	175	103	40	5623	0	5941
26343	88	5545	54	226	0	5913
26344	62	5755	37	156	0	6010
26345	68	204	40	5742	0	6054
26346	65	91	24	5868	0	6048
26347	5608	67	25	280	0	5980
26348	168	5631	39	159	0	5997
26349	90	180	36	5692	0	5998
26350	67	75	5594	211	0	5947
26351	51	5602	156	143	0	5952
26352	53	160	5532	114	0	5859
26353	57	5479	182	92	0	5810
26354	67	203	108	5006	0	5384
26355	39	75	23	4956	0	5093
26356	40	4874	29	186	0	5129
26357	35	141	4825	115	0	5116
26358	4776	78	104	100	0	5058
26359	123	48	61	4985	0	5217
26360	59	46	33	5118	0	5256
26361	43	47	4970	211	0	5271
26362	35	65	118	4990	0	5208
26363	31	43	4900	183	0	5157
26364	30	49	122	4928	0	5129
26365	25	48	4994	175	0	5242
26366	22	5000	133	111	0	5266
26367	27	146	5140	93	0	5406
26368	40	74	138	5269	0	5521
26369	5208	51	51	193	0	5503
26370	125	5198	39	111	0	5473
26371	69	165	36	5280	0	5550
26372	31	58	5209	179	0	5477
26373	25	5285	131	117	0	5558
26374	36	146	68	4974	0	5224
26375	22	73	4959	132	0	5186
26376	15	4473	109	85	0	4682
26377	3638	123	70	73	0	3904
26378	3454	17	19	20	0	3510
26379	52	16	9	3444	0	3521
26380	3474	11	20	67	0	3572
26381	51	7	11	3477	0	3546
26382	24	10	6	3538	0	3578
26383	11	10	3646	60	0	3727
26384	19	5	48	3587	0	3659
26385	9	11	18	3682	0	3720
26386	3643	8	9	71	0	3731
26387	3618	3	4	31	0	3656
26388	53	3647	9	20	0	3729
26389	18	48	3704	15	0	3785
26390	24	16	46	3671	0	3757
26391	12	13	3647	54	0	3726
26392	3400	3	53	38	0	3494
26393	58	5	3565	17	0	3645
26394	21	6	40	3503	0	3570
26395	14	3561	11	44	0	3630
26396	14	42	15	3576	0	3647
26397	11	19	4	3581	0	3615
26398	4	6	3746	62	0	3818
26399	23	4	45	3711	0	3783
26400	3724	2	17	65	0	3808
26401	3761	7	8	21	0	3797
26402	3747	7	16	16	0	3786
26403	3764	5	3	30	0	3802
26404	53	3672	13	11	0	3749
26405	20	3724	4	19	0	3767
26406	34	49	16	3457	0	3556
26407	13	11	12	3726	0	3762
26408	11	3529	6	62	0	3608
26409	17	44	5	3738	0	3804
26410	20	16	3	3774	0	3813
26411	18	8	8	3748	0	3782
26412	15	12	7	3741	0	3775
26413	18	22	7	3763	0	3810
26414	3688	12	5	72	0	3777
26415	49	3601	8	27	0	3685
26416	22	41	3528	26	0	3617
26417	18	19	45	3490	0	3572
26418	8	18	11	3576	0	3613
26419	7	9	8	3483	0	3507
26420	3397	5	8	89	0	3499
26421	45	3620	8	36	0	3709
26422	23	56	7	3692	0	3778
26423	14	3760	9	86	0	3869
26424	18	99	5	3760	0	3882
26425	6	3731	17	102	0	3856
26426	12	97	4062	41	0	4212
26427	19	28	103	4384	0	4534
26428	9	20	5148	130	0	5307
26429	27	12	157	5189	0	5385
26430	26	19	36	5680	0	5761
26431	5594	11	25	215	0	5845
26432	5655	15	14	91	0	5775
26433	5768	11	15	63	0	5857
26434	5752	14	12	38	0	5816
26435	5728	7	18	49	0	5802
26436	240	16	17	5417	0	5690
26437	78	5430	23	200	0	5731
26438	64	173	13	5445	0	5695
26439	40	47	5263	225	0	5575
26440	5313	30	163	75	0	5581
26441	5602	16	40	54	0	5712
26442	247	9	28	5428	0	5712
26443	110	18	14	5448	0	5590
26444	62	5245	12	226	0	5545
26445	49	169	12	5436	0	5666
26446	44	45	16	5439	0	5544
26447	39	5283	17	233	0	5572
26448	39	173	15	5464	0	5691
26449	5038	46	23	256	0	5363
26450	191	31	5187	97	0	5506
26451	5087	25	161	96	0	5369
26452	207	24	5170	70	0	5471
26453	75	31	191	5150	0	5447
26454	54	21	50	5179	0	5304
26455	38	4998	34	238	0	5308
26456	39	5243	27	100	0	5409
26457	55	205	17	5013	0	5290
26458	44	64	5085	203	0	5396
26459	4915	33	180	98	0	5226
26460	197	20	68	5003	0	5288
26461	70	4975	34	212	0	5291
26462	52	182	24	5087	0	5345
26463	62	62	24	5086	0	5234
26464	43	4875	23	245	0	5186
26465	69	196	22	4756	0	5043
26466	41	58	4485	211	0	4795
26467	41	39	4322	86	0	4488
26468	34	56	162	4192	0	4444
26469	22	4305	46	174	0	4547
26470	35	158	36	4337	0	4566
26471	4299	61	20	187	0	4567
26472	4393	32	18	95	0	4538
26473	4269	31	23	67	0	4390
26474	172	4163	29	56	0	4420
26475	61	144	4123	69	0	4397
26476	4102	57	151	54	0	4364
26477	4256	48	48	61	0	4413
26478	180	4101	35	63	0	4379
26479	81	152	29	4138	0	4400
26480	4136	43	20	182	0	4381
26481	4196	38	25	64	0	4323
26482	4201	29	32	57	0	4319
26483	232	25	19	3874	0	4150
26484	3952	25	33	180	0	4190
26485	209	31	21	3921	0	4182
26486	99	27	16	4058	0	4200
26487	3921	23	15	222	0	4181
26488	206	38	16	3864	0	4124
26489	3863	16	19	230	0	4128
26490	209	25	28	3825	0	4087
26491	108	16	21	4008	0	4153
26492	3828	22	19	243	0	4112
26493	203	30	3728	124	0	4085
26494	103	17	131	3877	0	4128
26495	90	25	39	3945	0	4099
26496	78	28	28	3900	0	4034
26497	72	22	24	3958	0	4076
26498	65	25	22	3714	0	3826
26499	58	3533	33	242	0	3866
26500	54	157	21	3653	0	3885
26501	57	51	3526	228	0	3862
26502	68	35	140	3636	0	3879
26503	66	23	54	3728	0	3871
26504	63	26	29	3813	0	3931
26505	42	26	3560	282	0	3910
26506	41	41	3585	137	0	3804
26507	3529	38	179	113	0	3859
26508	3648	34	60	97	0	3839
26509	193	3681	45	90	0	4009
26510	95	149	31	3825	0	4100
26511	70	46	41	3987	0	4144
26512	56	36	38	4053	0	4183
26513	3887	27	39	249	0	4202
26514	4011	26	40	129	0	4206
26515	201	30	37	3951	0	4219
26516	89	28	23	3992	0	4132
26517	63	45	22	4038	0	4168
26518	53	37	24	4027	0	4141
26519	3788	30	29	262	0	4109
26520	174	26	3699	138	0	4037
26521	66	3272	125	122	0	3585
26522	50	3178	32	86	0	3346
26523	3043	110	28	78	0	3259
26524	127	99	44	2949	0	3219
26525	46	33	2963	152	0	3194
26526	47	21	2651	86	0	2805
26527	24	2515	82	67	0	2688
26528	1690	31	46	17	0	1784
26529	35	9	1616	14	0	1674
26530	1300	15	17	4	0	1336
26531	9	8	3	1322	0	1342
26532	7	0	2	1313	0	1322
26533	6	1295	1	8	0	1310
26534	2	1328	0	10	0	1340
26535	1373	7	1	7	0	1388
26536	1373	0	1	8	0	1382
26537	7	1384	0	10	0	1401
26538	6	6	1394	5	0	1411
26539	3	5	1408	6	0	1422
26540	4	3	8	1428	0	1443
26541	1472	3	4	14	0	1493
26542	7	1479	4	6	0	1496
26543	6	7	1	1581	0	1595
26544	1611	4	6	14	0	1635
26545	9	1	4	1688	0	1702
26546	4	1	1	1789	0	1795
26547	1781	1	2	19	0	1803
26548	12	1750	3	9	0	1774
26549	8	1848	1	7	0	1864
26550	6	16	1887	5	0	1914
26551	4	6	12	1907	0	1929
26552	4	5	6	1914	0	1929
26553	1	5	1942	20	0	1968
26554	1758	2	12	18	0	1790
26555	1905	1	6	11	0	1923
26556	14	5	2055	2	0	2076
26557	1860	2	17	6	0	1885
26558	20	3	2198	1	0	2222
26559	8	2277	14	3	0	2302
26560	4	13	8	2405	0	2430
26561	8	6	6	2470	0	2490
26562	2461	4	4	22	0	2491
26563	2420	3	1	13	0	2437
26564	2444	3	3	7	0	2457
26565	2468	1	1	10	0	2480
26566	2478	0	2	9	0	2489
26567	20	8	2443	9	0	2480
26568	12	2476	12	7	0	2507
26569	10	11	6	2516	0	2543
26570	6	2518	3	10	0	2537
26571	3	2549	6	6	0	2564
26572	8	16	4	2543	0	2571
26573	3	9	0	2573	0	2585
26574	10	6	2592	16	0	2624
26575	2520	4	14	18	0	2556
26576	2639	2	6	10	0	2657
26577	19	2600	5	7	0	2631
26578	2677	15	7	6	0	2705
26579	2816	6	0	9	0	2831
26580	22	3	5	2826	0	2856
26581	12	4	2987	13	0	3016
26582	8	4	2945	9	0	2966
26583	3016	1	15	9	0	3041
26584	3050	4	6	8	0	3068
26585	19	3015	5	1	0	3040
26586	10	3125	5	2	0	3142
26587	10	14	3	3303	0	3330
26588	3299	9	3	21	0	3332
26589	13	5	3319	9	0	3346
26590	13	6	12	3394	0	3425
26591	3531	4	7	23	0	3565
26592	3558	1	5	14	0	3578
26593	24	3	2	3660	0	3689
26594	3673	3	2	25	0	3703
26595	22	4	3554	9	0	3589
26596	15	3	3733	4	0	3755
26597	11	11	20	3717	0	3759
26598	12	1	11	3933	0	3957
26599	7	3	9	3898	0	3917
26600	5	3828	7	28	0	3868
26601	8	3906	3	17	0	3934
26602	4	24	6	3990	0	4024
26603	4051	13	5	27	0	4096
26604	24	9	1	4105	0	4139
26605	8	4	4	4127	0	4143
26606	7	4049	6	24	0	4086
26607	5	4162	7	18	0	4192
26608	9	26	2	4190	0	4227
26609	7	13	4	4060	0	4084
26610	4015	6	1	34	0	4056
26611	24	4015	1	14	0	4054
26612	4052	19	6	22	0	4099
26613	23	9	4	4121	0	4157
26614	17	6	4069	22	0	4114
26615	8	9	3992	17	0	4026
26616	4188	0	30	19	0	4237
26617	26	7	12	4349	0	4394
26618	9	7	8	4343	0	4367
26619	13	6	2	4397	0	4418
26620	7	2	4412	33	0	4454
26621	10	3	21	4483	0	4517
26622	3	4453	15	37	0	4508
26623	5	26	7	4631	0	4669
26624	14	11	3	4607	0	4635
26625	9	4586	2	47	0	4644
26626	9	33	3	4785	0	4830
26627	4697	13	2	53	0	4765
26628	39	4702	8	20	0	4769
26629	4932	42	4	21	0	4999
26630	4990	16	4	18	0	5028
26631	71	9	5	4978	0	5063
26632	33	9	4	4955	0	5001
26633	24	4	1	5068	0	5097
26634	12	8	4872	78	0	4970
26635	17	4759	47	35	0	4858
26636	11	4917	18	25	0	4971
26637	14	52	11	4883	0	4960
26638	4848	20	7	67	0	4942
26639	54	18	5	4805	0	4882
26640	17	11	4838	64	0	4930
26641	16	4735	49	28	0	4828
26642	10	4826	12	20	0	4868
26643	4742	56	9	23	0	4830
26644	4781	20	13	27	0	4841
26645	63	4896	9	17	0	4985
26646	4964	47	6	25	0	5042
26647	69	21	4930	10	0	5030
26648	22	20	4837	14	0	4893
26649	5018	8	65	18	0	5109
26650	5164	7	20	23	0	5214
26651	87	10	12	5139	0	5248
26652	5126	11	8	86	0	5231
26653	87	9	5141	26	0	5263
26654	33	10	5311	18	0	5372
26655	45	6	99	5679	0	5829
26656	23	4	34	6452	0	6513
26657	18	8	19	6758	0	6803
26658	33	5	12	6747	0	6797
26659	22	8	13	7439	0	7482
26660	14	13	7185	248	0	7460
26661	31	2	149	7284	0	7466
26662	7261	4	50	251	0	7566
26663	175	1	33	7370	0	7579
26664	7289	5	16	253	0	7563
26665	207	8	19	7341	0	7575
26666	7450	6	21	270	0	7747
26667	7670	8	16	142	0	7836
26668	249	7	24	7554	0	7834
26669	121	6	16	7747	0	7890
26670	7575	7	14	289	0	7885
26671	7631	7	16	170	0	7824
26672	276	12	7437	118	0	7843
26673	151	10	158	7558	0	7877
26674	104	10	74	7756	0	7944
26675	7558	6	43	299	0	7906
26676	7699	12	22	151	0	7884
26677	281	13	23	7652	0	7969
26678	174	3	24	7741	0	7942
26679	120	7	23	7698	0	7848
26680	100	8	31	7614	0	7753
26681	99	7030	24	326	0	7479
26682	65	7254	18	195	0	7532
26683	73	209	25	7226	0	7533
26684	87	7141	22	251	0	7501
26685	72	188	28	7302	0	7590
26686	48	76	7040	293	0	7457
26687	43	60	6801	189	0	7093
26688	33	6957	211	168	0	7369
26689	67	204	81	6980	0	7332
26690	52	101	6937	264	0	7354
26691	53	61	189	6885	0	7188
26692	44	49	90	7110	0	7293
26693	6890	43	57	356	0	7346
26694	222	41	54	7128	0	7445
26695	96	53	7174	296	0	7619
26696	82	50	7191	167	0	7490
26697	68	6949	242	166	0	7425
26698	68	7459	109	131	0	7767
26699	7440	214	76	157	0	7887
26700	222	81	7664	129	0	8096
26701	132	51	223	7696	0	8102
26702	7769	47	101	266	0	8183
26703	7745	39	78	179	0	8041
26704	265	7755	82	128	0	8230
26705	164	194	49	7690	0	8097
26706	121	83	43	8092	0	8339
26707	118	52	40	8070	0	8280
26708	7880	38	48	356	0	8322
26709	229	38	7724	198	0	8189
26710	115	7871	204	163	0	8353
26711	118	203	70	7850	0	8241
26712	76	108	47	8125	0	8356
26713	84	72	7785	333	0	8274
26714	72	55	209	7769	0	8105
26715	65	46	79	7977	0	8167
26716	99	51	60	7926	0	8136
26717	66	44	61	7940	0	8111
26718	39	65	7566	386	0	8056
26719	54	46	201	7697	0	7998
26720	47	37	7650	368	0	8102
26721	36	7483	239	247	0	8005
26722	72	163	124	7666	0	8025
26723	54	73	97	7873	0	8097
26724	53	60	7575	386	0	8074
26725	63	7440	207	266	0	7976
26726	68	170	119	7470	0	7827
26727	67	74	7438	302	0	7881
26728	61	7289	192	220	0	7762
26729	65	189	98	7366	0	7718
26730	79	84	7232	281	0	7676
26731	93	47	187	7273	0	7600
26732	81	42	125	7224	0	7472
26733	69	56	85	7536	0	7746
26734	7278	57	62	331	0	7728
26735	189	7226	73	188	0	7676
26736	7306	182	55	173	0	7716
26737	195	78	7288	182	0	7743
26738	7599	54	192	189	0	8034
26739	8087	55	83	164	0	8389
26740	245	45	60	8047	0	8397
26741	8116	43	69	298	0	8526
26742	8263	66	41	208	0	8578
26743	8384	50	39	199	0	8672
26744	261	51	58	8260	0	8630
26745	139	58	56	8230	0	8483
26746	96	43	7781	297	0	8217
26747	102	41	7478	186	0	7807
26748	7576	45	200	138	0	7959
26749	186	79	95	7698	0	8058
26750	106	7699	93	204	0	8102
26751	7746	127	87	150	0	8110
26752	165	7624	58	142	0	7989
26753	105	7733	51	132	0	8021
26754	85	161	7466	135	0	7847
26755	62	57	7318	79	0	7516
26756	92	210	166	6862	0	7330
26757	38	27	7169	88	0	7322
26758	16	35	6435	45	0	6531
26759	6120	8	22	26	0	6176
26760	6469	3	4	27	0	6503
26761	19	1	2	6618	0	6640
26762	14	4	3	6696	0	6717
26763	5	3	6833	12	0	6853
26764	1	6882	12	5	0	6900
26765	12	14	0	6923	0	6949
26766	7047	0	5	37	0	7089
26767	17	6	2	7063	0	7088
26768	5	7113	5	23	0	7146
26769	9	16	7036	2	0	7063
26770	4	7222	16	7	0	7249
26771	7340	22	0	19	0	7381
26772	7258	4	2	18	0	7282
26773	32	7	3	7227	0	7269
26774	10	5	7425	24	0	7464
26775	22	16	6876	8	0	6922
26776	2	7432	41	9	0	7484
26777	27	32	16	7087	0	7162
26778	7	5	6	7524	0	7542
26779	6	8	7466	35	0	7515
26780	10	2	32	7304	0	7348
26781	3	7651	10	34	0	7698
26782	5	43	7	7780	0	7835
26783	9	10	4	7850	0	7873
26784	1	14	7879	58	0	7952
26785	19	5	50	7677	0	7751
26786	7781	4	14	93	0	7892
26787	60	2	7857	20	0	7939
26788	21	3	7695	11	0	7730
26789	8	7917	79	11	0	8015
26790	18	62	35	8143	0	8258
26791	19	16	12	8603	0	8650
26792	3	9	8455	104	0	8571
26793	7946	6	90	57	0	8099
26794	98	7	22	8471	0	8598
26795	22	13	8260	93	0	8388
26796	37	5	87	7941	0	8070
26797	12	7	8224	105	0	8348
26798	10	7	7919	33	0	7969
26799	4	7932	102	37	0	8075
26800	17	78	47	7668	0	7810
26801	4	7843	30	67	0	7944
26802	7671	100	18	53	0	7842
26803	81	34	7774	28	0	7917
26804	23	7618	100	20	0	7761
26805	24	80	30	7716	0	7850
26806	7643	29	30	97	0	7799
26807	94	7568	23	33	0	7718
26808	34	91	13	7740	0	7878
26809	26	37	16	7719	0	7798
26810	5	7634	14	133	0	7786
26811	7623	93	13	67	0	7796
26812	105	31	18	8384	0	8538
26813	34	30	12	8890	0	8966
26814	30	18	8758	179	0	8985
26815	7	9209	132	102	0	9450
26816	26	153	65	9495	0	9739
26817	23	72	55	10597	0	10747
26818	11	10717	20	253	0	11001
26819	28	218	17	10833	0	11096
26820	47	91	18	11380	0	11536
26821	26	52	11	11563	0	11652
26822	5	11427	20	373	0	11825
26823	11389	229	12	193	0	11823
26824	233	119	11359	77	0	11788
26825	11014	59	230	95	0	11398
26826	265	11350	104	61	0	11780
26827	117	236	54	11375	0	11782
26828	66	118	11379	259	0	11822
26829	63	68	238	11367	0	11736
26830	46	30	126	11456	0	11658
26831	63	35	63	11750	0	11911
26832	25	48	11404	387	0	11864
26833	24	11294	240	210	0	11768
26834	22	232	11499	105	0	11858
26835	15	11558	290	81	0	11944
26836	18	302	11736	66	0	12122
26837	55	121	286	11654	0	12116
26838	11209	71	154	342	0	11776
26839	240	11391	71	165	0	11867
26840	101	286	11391	107	0	11885
26841	60	11376	251	104	0	11791
26842	27	311	11515	70	0	11923
26843	50	145	289	11099	0	11583
26844	61	95	138	11037	0	11331
26845	22	11059	91	377	0	11549
26846	22	11559	89	206	0	11876
26847	11500	370	45	153	0	12068
26848	263	183	88	11602	0	12136
26849	136	127	11691	320	0	12274
26850	101	73	294	11585	0	12053
26851	41	81	11832	388	0	12342
26852	54	73	11804	192	0	12123
26853	72	70	366	11347	0	11855
26854	38	11427	220	313	0	11998
26855	11192	309	115	219	0	11835
26856	285	140	97	11248	0	11770
26857	155	114	79	11109	0	11457
26858	70	11206	89	413	0	11778
26859	10957	320	68	247	0	11592
26860	11122	184	77	144	0	11527
26861	388	116	74	10758	0	11336
26862	179	10663	80	344	0	11266
26863	94	11398	79	195	0	11766
26864	11116	382	73	165	0	11736
26865	286	208	11106	110	0	11710
26866	10893	136	313	118	0	11460
26867	11086	98	167	151	0	11502
26868	11061	102	104	103	0	11370
26869	432	10964	53	113	0	11562
26870	194	294	71	11146	0	11705
26871	11164	175	79	348	0	11766
26872	11236	129	56	207	0	11628
26873	377	11116	79	191	0	11763
26874	11425	279	72	129	0	11905
26875	325	173	68	11507	0	12073
26876	190	112	70	11524	0	11896
26877	126	11372	59	375	0	11932
26878	103	278	60	11648	0	12089
26879	94	179	57	11688	0	12018
26880	101	11414	65	395	0	11975
26881	106	272	47	11125	0	11550
26882	73	11391	52	354	0	11870
26883	11306	323	55	213	0	11897
26884	11065	163	60	175	0	11463
26885	341	11064	60	134	0	11599
26886	184	281	10920	110	0	11495
26887	128	209	225	10851	0	11413
26888	98	135	10796	284	0	11313
26889	99	10355	266	194	0	10914
26890	101	10719	130	149	0	11099
26891	10123	306	83	104	0	10616
26892	244	10469	65	96	0	10874
26893	172	249	52	10178	0	10651
26894	99	10192	74	241	0	10606
26895	84	10518	36	181	0	10819
26896	10370	310	50	125	0	10855
26897	268	182	46	10335	0	10831
26898	169	133	10239	223	0	10764
26899	115	111	10072	182	0	10480
26900	80	10391	267	129	0	10867
26901	10337	254	142	133	0	10866
26902	236	10530	86	84	0	10936
26903	137	287	61	10679	0	11164
26904	10727	166	63	256	0	11212
26905	259	106	57	10851	0	11273
26906	156	124	45	10890	0	11215
26907	121	10786	48	323	0	11278
26908	100	270	34	11027	0	11431
26909	72	178	10884	284	0	11418
26910	10769	118	213	203	0	11303
26911	231	11248	120	154	0	11753
26912	115	11212	66	103	0	11496
26913	10764	238	43	83	0	11128
26914	203	135	10889	74	0	11301
26915	10169	126	186	98	0	10579
26916	211	11252	81	60	0	11604
26917	57	12109	39	32	0	12237
26918	48	261	12272	19	0	12600
26919	35	12471	223	29	0	12758
26920	90	257	94	11271	0	11712
26921	68	96	36	11597	0	11797
26922	9	11775	19	233	0	12036
26923	41	239	14	11830	0	12124
26924	11840	85	32	260	0	12217
26925	208	76	11714	95	0	12093
26926	11616	53	208	109	0	11986
26927	12047	47	70	92	0	12256
26928	11979	49	53	75	0	12156
26929	323	49	11663	52	0	12087
26930	172	48	211	11682	0	12113
26931	90	44	11820	224	0	12178
26932	11409	37	258	113	0	11817
26933	11557	23	99	109	0	11788
26934	309	11627	60	55	0	12051
26935	155	214	52	11553	0	11974
26936	102	11774	47	249	0	12172
26937	72	256	11811	93	0	12232
26938	117	106	242	11736	0	12201
26939	11737	63	101	280	0	12181
26940	11914	53	52	123	0	12142
26941	352	52	45	11400	0	11849
26942	147	11405	44	252	0	11848
26943	91	251	11559	104	0	12005
26944	56	124	11603	82	0	11865
26945	11121	62	327	101	0	11611
26946	300	72	11573	52	0	11997
26947	132	11482	286	64	0	11964
26948	103	278	102	11424	0	11907
26949	57	122	11523	257	0	11959
26950	88	79	309	11209	0	11685
26951	74	45	11328	292	0	11739
26952	10706	46	337	129	0	11218
26953	312	41	131	10980	0	11464
26954	124	10794	109	279	0	11306
26955	78	11182	85	126	0	11471
26956	74	322	87	10920	0	11403
26957	79	137	90	10838	0	11144
26958	68	10805	86	331	0	11290
26959	69	276	10781	156	0	11282
26960	90	138	257	10816	0	11301
26961	40	124	10921	317	0	11402
26962	54	86	10585	161	0	10886
26963	9861	64	346	167	0	10438
26964	266	10208	165	106	0	10745
26965	10256	279	120	86	0	10741
26966	326	130	82	9993	0	10531
26967	136	10245	91	282	0	10754
26968	102	299	100	10351	0	10852
26969	107	145	94	10167	0	10513
26970	71	10015	83	369	0	10538
26971	84	317	9836	175	0	10412
26972	91	148	299	9935	0	10473
26973	9851	113	134	333	0	10431
26974	295	87	101	9745	0	10228
26975	143	77	87	9831	0	10138
26976	90	92	9457	389	0	10028
26977	86	9378	312	189	0	9965
26978	99	294	135	9472	0	10000
26979	89	141	9415	350	0	9995
26980	75	121	9411	200	0	9807
26981	9006	101	359	204	0	9670
26982	275	9290	193	163	0	9921
26983	9217	333	132	133	0	9815
26984	296	9176	137	144	0	9753
26985	147	9463	116	137	0	9863
26986	9292	355	132	140	0	9919
26987	343	181	117	9021	0	9662
26988	182	9269	113	315	0	9879
26989	167	315	96	9447	0	10025
26990	9402	171	100	341	0	10014
26991	370	142	9313	178	0	10003
26992	199	117	9103	131	0	9550
26993	8933	94	370	147	0	9544
26994	338	9074	190	121	0	9723
26995	160	318	9106	122	0	9706
26996	167	9033	319	118	0	9637
26997	129	340	175	8989	0	9633
26998	128	175	9086	312	0	9701
26999	107	121	342	9046	0	9616
27000	95	128	8919	374	0	9516
27001	8500	102	386	216	0	9204
27002	292	8766	196	148	0	9402
27003	8710	302	149	131	0	9292
27004	350	144	122	8406	0	9022
27005	149	8882	131	324	0	9486
27006	8860	335	127	147	0	9469
27007	8464	150	137	171	0	8922
27008	366	148	8864	101	0	9479
27009	198	115	8894	90	0	9297
27010	8038	96	384	106	0	8624
27011	319	8112	167	114	0	8712
27012	108	7917	141	110	0	8276
27013	200	490	130	7360	0	8180
27014	102	126	7349	291	0	7868
27015	87	7040	281	123	0	7531
27016	88	6350	120	91	0	6649
27017	206	199	86	4098	0	4589
27018	4022	40	37	109	0	4208
27019	4027	24	22	30	0	4103
27020	4046	21	14	42	0	4123
27021	116	35	3964	16	0	4131
27022	3960	13	102	28	0	4103
27023	4083	12	36	33	0	4164
27024	4145	17	24	24	0	4210
27025	133	23	20	3983	0	4159
27026	44	3999	18	99	0	4160
27027	4000	99	17	34	0	4150
27028	106	3994	19	22	0	4141
27029	41	98	12	4014	0	4165
27030	26	31	4161	103	0	4321
27031	28	28	97	4142	0	4295
27032	36	30	23	4213	0	4302
27033	25	14	4168	117	0	4324
27034	22	4101	104	31	0	4258
27035	34	88	22	3926	0	4070
27036	3862	27	21	94	0	4004
27037	97	3781	10	24	0	3912
27038	3714	88	14	26	0	3842
27039	102	29	15	3657	0	3803
27040	28	3716	8	86	0	3838
27041	3719	93	10	30	0	3852
27042	92	3787	17	23	0	3919
27043	28	81	3666	8	0	3783
27044	3593	23	84	22	0	3722
27045	3799	25	18	17	0	3859
27046	88	3721	18	13	0	3840
27047	31	77	3553	11	0	3672
27048	20	3750	77	10	0	3857
27049	80	113	26	2852	0	3071
27050	16	24	16	3998	0	4054
27051	12	23	6	4041	0	4082
27052	15	3993	12	99	0	4119
27053	18	93	6	4016	0	4133
27054	21	26	6	4065	0	4118
27055	3989	24	6	113	0	4132
27056	103	11	7	3977	0	4098
27057	39	14	6	4066	0	4125
27058	3962	10	9	116	0	4097
27059	87	4008	3	45	0	4143
27060	4073	85	4	39	0	4201
27061	4109	35	5	18	0	4167
27062	4106	23	8	34	0	4171
27063	129	12	7	4028	0	4176
27064	57	16	7	4116	0	4196
27065	36	15	3961	111	0	4123
27066	27	10	3929	43	0	4009
27067	25	18	3875	30	0	3948
27068	3749	18	107	36	0	3910
27069	100	12	3875	34	0	4021
27070	37	3936	99	27	0	4099
27071	35	99	28	3960	0	4122
27072	28	31	28	3966	0	4053
27073	24	4035	15	110	0	4184
27074	23	99	4050	43	0	4215
27075	24	4116	91	35	0	4266
27076	4143	100	23	46	0	4312
27077	109	35	4150	22	0	4316
27078	51	4159	98	16	0	4324
27079	38	108	4211	17	0	4374
27080	36	33	114	4191	0	4374
27081	44	26	4208	98	0	4376
27082	40	20	110	4106	0	4276
27083	4180	20	37	120	0	4357
27084	105	29	4208	41	0	4383
27085	46	4241	100	33	0	4420
27086	4294	107	35	33	0	4469
27087	104	36	4351	41	0	4532
27088	40	29	4380	36	0	4485
27089	38	22	117	4334	0	4511
27090	22	23	4375	121	0	4541
27091	4156	20	116	60	0	4352
27092	108	4292	45	44	0	4489
27093	42	107	40	4361	0	4550
27094	40	4543	18	105	0	4706
27095	4590	117	14	56	0	4777
27096	119	42	4580	35	0	4776
27097	49	43	4693	33	0	4818
27098	47	25	110	4672	0	4854
27099	43	20	54	4763	0	4880
27100	29	37	35	4821	0	4922
27101	46	35	33	4854	0	4968
27102	26	20	4858	146	0	5050
27103	32	4771	125	56	0	4984
27104	32	96	38	4589	0	4755
27105	23	34	4449	95	0	4601
27106	12	4409	90	38	0	4549
27107	4335	85	43	49	0	4512
27108	104	44	24	4323	0	4495
27109	4227	25	16	101	0	4369
27110	81	4225	15	42	0	4363
27111	4209	79	15	43	0	4346
27112	89	34	4336	25	0	4484
27113	49	57	75	4178	0	4359
27114	26	4290	39	77	0	4432
27115	22	79	4231	31	0	4363
27116	17	4243	79	35	0	4374
27117	68	102	38	3244	0	3452
27118	4056	24	20	71	0	4171
27119	63	4105	14	34	0	4216
27120	4096	63	11	25	0	4195
27121	78	24	4078	8	0	4188
27122	31	20	3998	16	0	4065
27123	4006	7	78	25	0	4116
27124	61	8	44	4037	0	4150
27125	32	16	25	4083	0	4156
27126	24	9	4106	76	0	4215
27127	11	14	4034	30	0	4089
27128	20	4258	74	16	0	4368
27129	4185	63	50	28	0	4326
27130	4066	27	18	20	0	4131
27131	63	4039	11	13	0	4126
27132	34	49	13	4154	0	4250
27133	4240	23	10	56	0	4329
27134	57	15	11	4252	0	4335
27135	4310	8	10	67	0	4395
27136	4317	8	12	37	0	4374
27137	4407	7	9	36	0	4459
27138	73	7	11	4330	0	4421
27139	36	8	12	4514	0	4570
27140	4439	11	9	78	0	4537
27141	4411	6	15	45	0	4477
27142	4434	3	11	27	0	4475
27143	78	4348	6	15	0	4447
27144	4278	36	8	16	0	4338
27145	45	4242	8	8	0	4303
27146	4217	36	10	14	0	4277
27147	45	13	4167	8	0	4233
27148	3817	12	43	21	0	3893
27149	40	3912	9	7	0	3968
27150	7	3775	8	1	0	3791
27151	3868	26	7	13	0	3914
27152	31	8	3	3847	0	3889
27153	14	1	3	3961	0	3979
27154	8	3917	2	28	0	3955
27155	5	4045	5	9	0	4064
27156	4068	26	3	22	0	4119
27157	32	12	4154	3	0	4201
27158	17	4	30	4316	0	4367
27159	4411	4	9	57	0	4481
27160	62	3	4428	9	0	4502
27161	15	4835	55	19	0	4924
27162	5338	81	10	20	0	5449
27163	119	17	5520	6	0	5662
27164	41	8	133	5943	0	6125
27165	17	6	6186	145	0	6354
27166	5946	3	156	47	0	6152
27167	148	6310	28	24	0	6510
27168	6426	155	24	17	0	6622
27169	6460	34	10	10	0	6514
27170	197	24	4	6346	0	6571
27171	6425	7	3	167	0	6602
27172	191	6	3	6398	0	6598
27173	52	6	2	6546	0	6606
27174	30	6	6291	187	0	6514
27175	15	6242	154	54	0	6465
27176	20	162	24	6311	0	6517
27177	25	23	18	6429	0	6495
27178	14	18	4	6432	0	6468
27179	9	9	6255	193	0	6466
27180	5	6170	141	54	0	6370
27181	11	144	26	6319	0	6500
27182	18	24	18	6432	0	6492
27183	5	21	6288	181	0	6495
27184	15	12	153	6108	0	6288
27185	6179	6	31	188	0	6404
27186	144	6176	22	45	0	6387
27187	6126	148	13	41	0	6328
27188	170	27	6216	18	0	6431
27189	47	31	146	6199	0	6423
27190	6328	12	31	173	0	6544
27191	6380	5	19	43	0	6447
27192	182	5	6385	28	0	6600
27193	77	3	145	6266	0	6491
27194	35	8	6292	156	0	6491
27195	6035	4	160	45	0	6244
27196	153	6248	37	33	0	6471
27197	6418	150	23	26	0	6617
27198	6500	30	14	21	0	6565
27199	188	6562	11	17	0	6778
27200	6774	159	8	27	0	6968
27201	188	36	6652	15	0	6891
27202	6676	26	144	18	0	6864
27203	193	17	33	6741	0	6984
27204	55	19	6825	163	0	7062
27205	58	10	164	6821	0	7053
27206	41	5	41	6757	0	6844
27207	25	6	29	6937	0	6997
27208	17	6804	24	199	0	7044
27209	6885	149	16	74	0	7124
27210	168	39	12	6869	0	7088
27211	47	6809	14	171	0	7041
27212	51	159	9	6699	0	6918
27213	35	6701	14	184	0	6934
27214	25	171	6732	55	0	6983
27215	46	35	161	6679	0	6921
27216	29	32	45	6825	0	6931
27217	26	27	6762	196	0	7011
27218	6299	27	169	83	0	6578
27219	163	6639	48	61	0	6911
27220	65	161	32	6773	0	7031
27221	59	41	24	6779	0	6903
27222	61	35	18	6717	0	6831
27223	40	6682	19	201	0	6942
27224	6668	165	18	105	0	6956
27225	192	31	6639	86	0	6948
27226	46	35	6557	59	0	6697
27227	50	24	183	6577	0	6834
27228	41	20	54	6732	0	6847
27229	6583	24	46	223	0	6876
27230	173	6553	45	89	0	6860
27231	44	173	32	6690	0	6939
27232	6597	37	27	225	0	6886
27233	193	35	24	6526	0	6778
27234	6556	27	25	224	0	6832
27235	208	25	6355	84	0	6672
27236	71	6513	171	68	0	6823
27237	6595	175	50	59	0	6879
27238	215	44	6606	48	0	6913
27239	6409	37	191	56	0	6693
27240	223	25	6438	50	0	6736
27241	6463	22	184	47	0	6716
27242	222	32	57	6558	0	6869
27243	6612	19	43	210	0	6884
27244	216	16	45	6611	0	6888
27245	77	27	31	6752	0	6887
27246	6616	16	27	241	0	6900
27247	200	6489	32	95	0	6816
27248	63	169	35	6680	0	6947
27249	6750	39	28	227	0	7044
27250	6981	52	19	77	0	7129
27251	236	30	20	6840	0	7126
27252	98	24	16	7016	0	7154
27253	7019	24	22	250	0	7315
27254	238	29	18	7163	0	7448
27255	80	34	22	7280	0	7416
27256	7163	19	20	277	0	7479
27257	244	17	27	7079	0	7367
27258	65	13	6681	229	0	6988
27259	6464	14	159	107	0	6744
27260	202	16	6719	53	0	6990
27261	68	20	6180	40	0	6308
27262	5619	71	143	40	0	5873
27263	103	5520	48	14	0	5685
27264	55	65	12	5182	0	5314
27265	20	21	16	5067	0	5124
27266	30	3	9	5283	0	5325
27267	14	1	6	5424	0	5445
27268	5303	4	11	121	0	5439
27269	5837	2	3	39	0	5881
27270	5975	10	4	23	0	6012
27271	125	6	6404	14	0	6549
27272	55	4	119	6863	0	7041
27273	32	3	52	7059	0	7146
27274	33	3	11	6946	0	6993
27275	26	6669	14	229	0	6938
27276	22	6885	14	104	0	7025
27277	7048	200	7	61	0	7316
27278	169	80	9	7118	0	7376
27279	105	23	12	7592	0	7732
27280	43	19	6	7834	0	7902
27281	22	19	7523	282	0	7846
27282	25	24	7367	134	0	7550
27283	7394	15	238	73	0	7720
27284	7777	13	94	59	0	7943
27285	279	10	33	7583	0	7905
27286	104	7591	32	199	0	7926
27287	63	173	21	7693	0	7950
27288	53	82	18	7714	0	7867
27289	32	21	7443	285	0	7781
27290	7395	17	172	163	0	7747
27291	219	18	88	7712	0	8037
27292	123	16	34	7660	0	7833
27293	7416	13	29	321	0	7779
27294	208	7602	30	153	0	7993
27295	7839	179	26	97	0	8141
27296	240	100	27	7666	0	8033
27297	129	7408	18	223	0	7778
27298	7497	197	23	139	0	7856
27299	234	110	21	7368	0	7733
27300	7281	44	18	234	0	7577
27301	7175	27	7	159	0	7368
27302	7254	26	12	98	0	7390
27303	306	6910	25	73	0	7314
27304	151	6989	24	53	0	7217
27305	109	268	12	6814	0	7203
27306	79	6942	16	223	0	7260
27307	7052	221	15	138	0	7426
27308	257	123	11	7042	0	7433
27309	7125	57	14	253	0	7449
27310	7207	50	14	160	0	7431
27311	360	50	14	6982	0	7406
27312	186	38	20	7254	0	7498
27313	7106	35	21	358	0	7520
27314	7214	44	19	178	0	7455
27315	7428	33	7	127	0	7595
27316	7510	39	8	106	0	7663
27317	7642	44	16	89	0	7791
27318	385	44	9	7364	0	7802
27319	211	31	6	7542	0	7790
27320	139	38	12	7667	0	7856
27321	7413	30	14	373	0	7830
27322	308	25	15	7368	0	7716
27323	200	7204	20	295	0	7719
27324	132	208	21	7464	0	7825
27325	7274	110	21	319	0	7724
27326	7393	58	18	209	0	7678
27327	376	47	7115	121	0	7659
27328	221	45	192	7082	0	7540
27329	128	7190	94	275	0	7687
27330	7292	207	34	190	0	7723
27331	284	7329	31	139	0	7783
27332	192	225	24	7435	0	7876
27333	7473	119	26	290	0	7908
27334	7584	58	24	190	0	7856
27335	375	7380	18	121	0	7894
27336	231	231	9	7388	0	7859
27337	144	123	7254	291	0	7812
27338	7135	74	220	183	0	7612
27339	328	56	7229	111	0	7724
27340	7333	53	225	131	0	7742
27341	7544	46	112	111	0	7813
27342	405	54	43	7346	0	7848
27343	7560	59	28	314	0	7961
27344	7747	51	33	186	0	8017
27345	7890	62	27	113	0	8092
27346	435	57	20	7578	0	8090
27347	7728	41	25	307	0	8101
27348	376	48	22	7622	0	8068
27349	240	44	31	7618	0	7933
27350	162	7321	39	362	0	7884
27351	177	212	30	7298	0	7717
27352	158	7299	30	278	0	7765
27353	7205	210	13	160	0	7588
27354	7219	115	10	138	0	7482
27355	366	67	10	7019	0	7462
27356	217	52	6	7071	0	7346
27357	6942	48	13	335	0	7338
27358	316	52	6682	179	0	7229
27359	6833	32	176	137	0	7178
27360	317	36	80	6778	0	7211
27361	216	35	6409	243	0	6903
27362	6500	30	170	184	0	6884
27363	6726	47	80	136	0	6989
27364	334	39	6660	122	0	7155
27365	6792	27	173	113	0	7105
27366	294	34	6660	85	0	7073
27367	212	6627	170	70	0	7079
27368	6610	151	153	117	0	7031
27369	6503	86	64	102	0	6755
27370	307	6111	36	77	0	6531
27371	136	5732	46	42	0	5956
27372	5312	100	61	46	0	5519
27373	5311	29	27	55	0	5422
27374	150	30	17	5400	0	5597
27375	74	28	5232	109	0	5443
27376	80	35	4976	51	0	5142
27377	5183	21	99	54	0	5357
27378	126	25	5232	34	0	5417
27379	4945	45	125	41	0	5156
27380	111	20	24	4876	0	5031
27381	53	10	16	4924	0	5003
27382	49	13	4930	85	0	5077
27383	4955	8	75	55	0	5093
27384	95	17	25	5048	0	5185
27385	63	5	25	5331	0	5424
27386	5254	10	13	95	0	5372
27387	5233	7	14	70	0	5324
27388	5229	7	17	46	0	5299
27389	103	5249	16	37	0	5405
27390	59	56	5054	21	0	5190
27391	5003	16	66	39	0	5124
27392	5143	16	14	26	0	5199
27393	85	5012	21	22	0	5140
27394	4822	47	23	20	0	4912
27395	70	11	12	4786	0	4879
27396	29	14	4878	43	0	4964
27397	4839	5	39	28	0	4911
27398	4988	6	12	45	0	5051
27399	5045	8	11	23	0	5087
27400	5061	6	7	21	0	5095
27401	67	1	11	5047	0	5126
27402	31	8	6	5037	0	5082
27403	5049	3	8	68	0	5128
27404	63	1	5	5050	0	5119
27405	31	1	9	5020	0	5061
27406	27	4874	4	50	0	4955
27407	20	40	8	5011	0	5079
27408	21	7	6	5036	0	5070
27409	24	6	7	5038	0	5075
27410	21	5	3	5078	0	5107
27411	15	5014	7	52	0	5088
27412	27	36	1	4995	0	5059
27413	21	19	5	4919	0	4964
27414	10	12	4895	59	0	4976
27415	19	2	4619	29	0	4669
27416	13	4813	37	14	0	4877
27417	5335	26	21	24	0	5406
27418	43	5485	14	12	0	5554
27419	25	46	9	5893	0	5973
27420	14	12	6422	64	0	6512
27421	6859	7	89	43	0	6998
27422	100	5	27	7123	0	7255
27423	7017	6	13	115	0	7151
27424	7143	5	14	53	0	7215
27425	113	7118	14	23	0	7268
27426	7111	87	5	42	0	7245
27427	105	7184	13	19	0	7321
27428	67	108	3	7315	0	7493
27429	24	7347	7	116	0	7494
27430	27	112	7311	33	0	7483
27431	14	7405	103	23	0	7545
27432	34	131	43	7209	0	7417
27433	7178	51	18	145	0	7392
27434	95	7263	18	40	0	7416
27435	65	115	5	7319	0	7504
27436	43	45	8	7496	0	7592
27437	30	29	7378	159	0	7596
27438	38	27	129	7329	0	7523
27439	24	17	7407	155	0	7603
27440	7128	16	137	83	0	7364
27441	147	15	7517	32	0	7711
27442	61	7510	137	39	0	7747
27443	50	145	57	7470	0	7722
27444	53	55	21	7462	0	7591
27445	35	34	21	7526	0	7616
27446	7502	28	17	220	0	7767
27447	177	24	12	7412	0	7625
27448	54	7457	19	188	0	7718
27449	7309	155	9	92	0	7565
27450	150	7308	23	62	0	7543
27451	84	169	15	7308	0	7576
27452	7354	61	16	190	0	7621
27453	171	7174	33	92	0	7470
27454	66	7437	19	58	0	7580
27455	7360	189	25	58	0	7632
27456	7513	86	17	59	0	7675
27457	206	71	7319	39	0	7635
27458	7411	38	155	60	0	7664
27459	197	38	7540	48	0	7823
27460	118	38	175	7573	0	7904
27461	66	32	7609	178	0	7885
27462	56	38	180	7597	0	7871
27463	40	36	7580	207	0	7863
27464	65	23	175	7302	0	7565
27465	49	28	78	7483	0	7638
27466	7244	31	48	254	0	7577
27467	201	37	7134	111	0	7483
27468	6932	40	169	89	0	7230
27469	201	32	7063	62	0	7358
27470	100	32	7057	54	0	7243
27471	72	32	217	6961	0	7282
27472	6988	24	91	204	0	7307
27473	181	6941	58	99	0	7279
27474	6828	171	42	77	0	7118
27475	6896	69	50	63	0	7078
27476	245	6808	39	54	0	7146
27477	6853	179	45	61	0	7138
27478	217	70	6780	52	0	7119
27479	106	57	173	6792	0	7128
27480	6803	40	77	211	0	7131
27481	209	6764	51	93	0	7117
27482	102	160	55	6677	0	6994
27483	81	67	43	6756	0	6947
27484	85	42	47	6785	0	6959
27485	60	42	44	6867	0	7013
27486	6671	30	40	264	0	7005
27487	6749	28	47	127	0	6951
27488	6753	29	41	97	0	6920
27489	6607	25	41	99	0	6772
27490	254	32	6531	65	0	6882
27491	6530	30	174	79	0	6813
27492	6717	32	74	71	0	6894
27493	251	6490	49	67	0	6857
27494	131	6665	40	59	0	6895
27495	130	204	34	6459	0	6827
27496	93	88	37	6580	0	6798
27497	70	58	6390	244	0	6762
27498	68	6482	185	110	0	6845
27499	65	175	82	6381	0	6703
27500	74	6444	51	190	0	6759
27501	81	193	31	6587	0	6892
27502	79	92	33	6615	0	6819
27503	76	6688	28	245	0	7037
27504	76	191	38	6818	0	7123
27505	65	76	6827	225	0	7193
27506	71	55	6864	111	0	7101
27507	6747	44	232	90	0	7113
27508	6983	37	94	96	0	7210
27509	246	6850	69	70	0	7235
27510	6915	183	41	87	0	7226
27511	226	73	48	6924	0	7271
27512	6935	51	32	239	0	7257
27513	224	6943	41	121	0	7329
27514	135	182	6884	83	0	7284
27515	6833	78	208	85	0	7204
27516	269	44	7079	68	0	7460
27517	109	52	6343	45	0	6549
27518	95	48	6274	37	0	6454
27519	67	5909	190	39	0	6205
27520	5082	216	250	66	0	5614
27521	4904	62	51	51	0	5068
27522	150	23	28	4814	0	5015
27523	61	28	25	4823	0	4937
27524	45	4933	25	127	0	5130
27525	4966	95	28	67	0	5156
27526	115	4934	30	40	0	5119
27527	56	4888	21	30	0	4995
27528	4700	98	26	42	0	4866
27529	116	39	19	4648	0	4822
27530	58	18	9	4707	0	4792
27531	40	29	12	4750	0	4831
27532	30	4657	12	111	0	4810
27533	4642	76	19	57	0	4794
27534	101	59	16	4592	0	4768
27535	34	4413	14	81	0	4542
27536	42	4437	7	31	0	4517
27537	30	79	9	4352	0	4470
27538	26	4380	11	68	0	4485
27539	30	73	8	4371	0	4482
27540	4291	34	12	86	0	4423
27541	57	27	4172	33	0	4289
27542	29	4243	44	22	0	4338
27543	36	49	19	4304	0	4408
27544	17	24	4368	54	0	4463
27545	4256	28	47	35	0	4366
27546	67	24	19	4383	0	4493
27547	4378	10	12	71	0	4471
27548	4360	9	9	36	0	4414
27549	61	4565	5	15	0	4646
27550	4651	45	5	24	0	4725
27551	4650	21	3	29	0	4703
27552	4659	15	2	25	0	4701
27553	64	8	7	4567	0	4646
27554	40	13	5	4548	0	4606
27555	27	10	8	4608	0	4653
27556	18	10	4551	59	0	4638
27557	19	4502	39	32	0	4592
27558	4416	34	22	41	0	4513
27559	36	4321	10	14	0	4381
27560	19	37	4	4278	0	4338
27561	14	20	4232	36	0	4302
27562	3970	12	31	38	0	4051
27563	36	4259	13	14	0	4322
27564	24	32	8	4218	0	4282
27565	18	14	6	4211	0	4249
27566	15	12	4151	39	0	4217
27567	11	4147	29	22	0	4209
27568	14	30	13	4161	0	4218
27569	11	16	11	4192	0	4230
27570	15	11	9	4095	0	4130
27571	4015	10	4	67	0	4096
27572	39	7	3980	25	0	4051
27573	18	3993	26	25	0	4062
27574	3993	31	14	33	0	4071
27575	37	4026	6	11	0	4080
27576	22	37	5	4022	0	4086
27577	10	4017	6	27	0	4060
27578	3898	31	3	27	0	3959
27579	3940	22	7	21	0	3990
27580	49	12	2	3974	0	4037
27581	23	10	6	3999	0	4038
27582	20	8	5	4118	0	4151
27583	15	11	4096	67	0	4189
27584	14	4205	48	31	0	4298
27585	14	53	13	4868	0	4948
27586	17	20	11	4983	0	5031
27587	13	17	5	5153	0	5188
27588	25	5	4	5166	0	5200
27589	15	8	5146	130	0	5299
27590	3	5629	86	62	0	5780
27591	16	103	31	5981	0	6131
27592	25	46	15	6644	0	6730
27593	10	33	6538	169	0	6750
27594	28	18	117	6390	0	6553
27595	6	6366	63	144	0	6579
27596	11	6585	26	85	0	6707
27597	30	173	19	6493	0	6715
27598	12	71	6303	140	0	6526
27599	5900	36	119	109	0	6164
27600	106	6251	60	60	0	6477
27601	57	134	6177	49	0	6417
27602	23	69	6147	46	0	6285
27603	18	6104	178	29	0	6329
27604	24	137	6205	29	0	6395
27605	35	103	144	6019	0	6301
27606	6032	35	78	144	0	6289
27607	6087	25	57	88	0	6257
27608	6091	37	32	59	0	6219
27609	6244	36	30	60	0	6370
27610	169	6317	31	46	0	6563
27611	6386	125	24	77	0	6612
27612	156	6404	36	36	0	6632
27613	94	152	6228	36	0	6510
27614	81	90	132	6054	0	6357
27615	43	6346	81	123	0	6593
27616	54	156	49	6201	0	6460
27617	6071	101	38	163	0	6373
27618	137	60	45	6004	0	6246
27619	75	6117	34	157	0	6383
27620	6146	144	32	87	0	6409
27621	151	85	6064	56	0	6356
27622	118	48	137	6034	0	6337
27623	77	47	74	6157	0	6355
27624	5908	41	43	199	0	6191
27625	160	5901	27	105	0	6193
27626	93	141	5853	58	0	6145
27627	74	78	136	5854	0	6142
27628	60	46	5906	153	0	6165
27629	43	5749	145	90	0	6027
27630	43	5971	79	72	0	6165
27631	5845	195	49	67	0	6156
27632	136	111	5835	64	0	6146
27633	5902	80	149	62	0	6193
27634	160	54	89	5790	0	6093
27635	81	5936	59	151	0	6227
27636	5862	146	37	122	0	6167
27637	154	97	5902	74	0	6227
27638	123	62	140	5881	0	6206
27639	81	52	86	5996	0	6215
27640	49	51	67	5919	0	6086
27641	43	5760	49	226	0	6078
27642	5590	142	51	141	0	5924
27643	140	5593	48	88	0	5869
27644	84	5652	36	82	0	5854
27645	81	198	42	5533	0	5854
27646	5539	108	51	165	0	5863
27647	5507	75	43	105	0	5730
27648	5520	75	39	78	0	5712
27649	207	5237	41	49	0	5534
27650	140	167	34	5205	0	5546
27651	83	103	5206	151	0	5543
27652	85	65	141	5185	0	5476
27653	75	48	76	5172	0	5371
27654	70	5198	55	193	0	5516
27655	5254	163	38	122	0	5577
27656	175	105	45	5189	0	5514
27657	88	5204	40	297	0	5629
27658	5349	170	39	128	0	5686
27659	173	100	5280	96	0	5649
27660	5261	84	125	74	0	5544
27661	185	5355	68	68	0	5676
27662	5443	181	41	64	0	5729
27663	5463	112	33	65	0	5673
27664	215	80	5356	71	0	5722
27665	5415	67	148	56	0	5686
27666	191	70	5577	53	0	5891
27667	141	42	5615	62	0	5860
27668	5553	71	188	54	0	5866
27669	5670	61	95	50	0	5876
27670	226	60	5660	55	0	6001
27671	143	48	174	5620	0	5985
27672	110	38	105	5603	0	5856
27673	88	5776	71	200	0	6135
27674	5560	157	54	121	0	5892
27675	5842	97	47	81	0	6067
27676	230	69	5753	66	0	6118
27677	5886	44	148	64	0	6142
27678	6028	61	91	64	0	6244
27679	239	5836	61	71	0	6207
27680	141	166	53	5887	0	6247
27681	124	92	55	5859	0	6130
27682	130	63	43	5890	0	6126
27683	5732	48	58	186	0	6024
27684	167	5552	56	109	0	5884
27685	109	132	37	4877	0	5155
27686	68	4833	31	112	0	5044
27687	74	289	28	4398	0	4789
27688	60	4510	28	103	0	4701
27689	41	4584	33	90	0	4748
27690	3850	130	52	90	0	4122
27691	3802	68	49	67	0	3986
27692	64	22	11	3340	0	3437
27693	25	14	9	3372	0	3420
27694	21	9	7	3416	0	3453
27695	20	11	6	3392	0	3429
27696	13	15	8	3349	0	3385
27697	12	3328	3	62	0	3405
27698	23	43	6	3408	0	3480
27699	26	15	6	3470	0	3517
27700	3425	12	5	72	0	3514
27701	53	8	5	3432	0	3498
27702	23	11	8	3499	0	3541
27703	24	9	3536	69	0	3638
27704	23	18	41	3450	0	3532
27705	16	18	17	3607	0	3658
27706	20	7	3584	78	0	3689
27707	20	3609	48	36	0	3713
27708	18	48	3659	26	0	3751
27709	13	18	3657	26	0	3714
27710	7	3597	51	18	0	3673
27711	3605	44	25	40	0	3714
27712	3649	12	3	28	0	3692
27713	49	5	8	3600	0	3662
27714	3719	6	7	55	0	3787
27715	43	9	3883	17	0	3952
27716	25	4	48	3968	0	4045
27717	11	10	4382	54	0	4457
27718	11	7	41	4399	0	4458
27719	22	5	12	4458	0	4497
27720	12	4	5	4525	0	4546
27721	4478	4	3	80	0	4565
27722	54	4	12	4528	0	4598
27723	4558	4	7	70	0	4639
27724	4626	3	16	33	0	4678
27725	51	4582	15	21	0	4669
27726	4636	47	9	38	0	4730
27727	48	4737	7	33	0	4825
27728	29	47	6	4747	0	4829
27729	22	14	5	4862	0	4903
27730	29	8	6	4918	0	4961
27731	27	5	4831	69	0	4932
27732	12	4766	55	25	0	4858
27733	24	58	11	4707	0	4800
27734	19	27	4	4749	0	4799
27735	12	4828	10	66	0	4916
27736	4859	54	5	46	0	4964
27737	59	4755	10	27	0	4851
27738	4736	53	14	41	0	4844
27739	59	4843	14	22	0	4938
27740	25	60	9	4786	0	4880
27741	10	4930	4	67	0	5011
27742	5033	59	3	51	0	5146
27743	5125	23	2	18	0	5168
27744	5134	14	3	30	0	5181
27745	5122	15	3	34	0	5174
27746	78	14	5090	16	0	5198
27747	5136	10	51	35	0	5232
27748	5302	20	11	28	0	5361
27749	5333	10	5	35	0	5383
27750	75	15	5210	22	0	5322
27751	5208	17	56	29	0	5310
27752	68	5348	12	27	0	5455
27753	5440	59	6	39	0	5544
27754	70	21	5733	22	0	5846
27755	5741	22	53	44	0	5860
27756	5843	11	15	35	0	5904
27757	77	19	2	5784	0	5882
27758	36	9	5699	67	0	5811
27759	5684	12	52	42	0	5790
27760	73	14	15	5846	0	5948
27761	37	15	8	5916	0	5976
27762	17	11	5919	72	0	6019
27763	5624	12	55	41	0	5732
27764	5964	12	9	33	0	6018
27765	76	5966	11	25	0	6078
27766	29	56	19	5951	0	6055
27767	42	15	13	5943	0	6013
27768	33	15	9	5912	0	5969
27769	27	5851	21	67	0	5966
27770	5865	51	16	32	0	5964
27771	83	18	13	5846	0	5960
27772	50	11	9	5879	0	5949
27773	5741	13	9	84	0	5847
27774	5719	5	14	45	0	5783
27775	85	6	15	5745	0	5851
27776	40	6	9	5693	0	5748
27777	27	16	5474	79	0	5596
27778	5207	5	55	47	0	5314
27779	71	5522	17	30	0	5640
27780	36	49	5	5753	0	5843
27781	31	18	9	5847	0	5905
27782	28	5937	9	82	0	6056
27783	33	57	9	6176	0	6275
27784	6593	29	7	110	0	6739
27785	127	20	12	8102	0	8261
27786	61	12	8	8401	0	8482
27787	49	13	8	8710	0	8780
27788	20	17	8415	326	0	8778
27789	45	14	162	8481	0	8702
27790	24	13	8367	279	0	8683
27791	25	8130	201	171	0	8527
27792	31	176	121	8230	0	8558
27793	41	87	54	8397	0	8579
27794	33	47	49	8584	0	8713
27795	22	35	39	8613	0	8709
27796	37	25	26	8727	0	8815
27797	8212	23	27	390	0	8652
27798	181	29	8320	220	0	8750
27799	98	8134	160	183	0	8575
27800	54	8587	96	146	0	8883
27801	50	233	49	8752	0	9084
27802	38	127	58	8870	0	9093
27803	40	77	36	8801	0	8954
27804	32	8604	51	333	0	9020
27805	43	196	33	8771	0	9043
27806	25	143	8603	307	0	9078
27807	9	8613	163	205	0	8990
27808	36	197	92	8734	0	9059
27809	8520	103	57	318	0	8998
27810	170	65	34	8651	0	8920
27811	123	60	28	8570	0	8781
27812	62	8166	44	329	0	8601
27813	48	8714	40	181	0	8983
27814	43	255	20	8639	0	8957
27815	45	145	18	8587	0	8795
27816	36	85	8229	351	0	8701
27817	34	57	153	8078	0	8322
27818	31	57	87	8209	0	8384
27819	24	56	60	8208	0	8348
27820	16	38	68	8274	0	8396
27821	7876	49	47	418	0	8390
27822	8014	39	40	283	0	8376
27823	260	30	32	8106	0	8428
27824	162	20	14	8452	0	8648
27825	8186	16	15	448	0	8665
27826	233	38	12	8639	0	8922
27827	129	42	8481	395	0	9047
27828	106	8442	194	261	0	9003
27829	83	184	111	8645	0	9023
27830	47	102	101	8817	0	9067
27831	8580	72	66	400	0	9118
27832	205	58	45	8846	0	9154
27833	118	46	35	9054	0	9253
27834	8735	38	24	469	0	9266
27835	244	41	22	8900	0	9207
27836	149	8755	19	388	0	9311
27837	104	199	23	9245	0	9571
27838	89	127	30	9565	0	9811
27839	82	74	20	9477	0	9653
27840	82	58	35	9552	0	9727
27841	51	60	9018	474	0	9603
27842	27	77	8910	324	0	9338
27843	28	59	289	9110	0	9486
27844	36	46	148	9054	0	9284
27845	33	8811	84	452	0	9380
27846	37	213	64	8822	0	9136
27847	30	8796	63	409	0	9298
27848	8734	246	75	294	0	9349
27849	207	9217	48	232	0	9704
27850	150	286	26	9408	0	9870
27851	93	162	18	9656	0	9929
27852	62	101	9138	480	0	9781
27853	8815	79	200	350	0	9444
27854	8838	73	114	255	0	9280
27855	314	8788	94	184	0	9380
27856	185	233	84	8749	0	9251
27857	107	134	9066	357	0	9664
27858	64	9181	247	259	0	9751
27859	9065	276	132	217	0	9690
27860	9220	154	66	220	0	9660
27861	341	115	8785	161	0	9402
27862	8977	89	214	173	0	9453
27863	352	70	127	8959	0	9508
27864	203	8903	94	327	0	9527
27865	8966	236	59	245	0	9506
27866	305	140	68	8944	0	9457
27867	9027	92	42	336	0	9497
27868	9403	74	46	256	0	9779
27869	394	80	37	9280	0	9791
27870	207	77	9252	388	0	9924
27871	9316	98	238	270	0	9922
27872	9604	60	137	211	0	10012
27873	9698	35	86	191	0	10010
27874	439	9598	70	141	0	10248
27875	263	216	60	9733	0	10272
27876	199	140	48	10151	0	10538
27877	119	93	9864	447	0	10523
27878	116	132	221	9821	0	10290
27879	109	9721	126	391	0	10347
27880	9544	242	73	295	0	10154
27881	273	9538	65	194	0	10070
27882	184	266	9307	179	0	9936
27883	93	9349	268	175	0	9885
27884	98	9321	185	118	0	9722
27885	141	156	95	7354	0	7746
27886	7266	55	48	140	0	7509
27887	7235	14	11	66	0	7326
27888	7182	22	7	48	0	7259
27889	144	7283	17	30	0	7474
27890	54	97	7200	22	0	7373
27891	7186	49	96	37	0	7368
27892	7380	19	48	48	0	7495
27893	135	7277	11	22	0	7445
27894	7405	95	16	39	0	7555
27895	119	54	10	7432	0	7615
27896	54	29	7775	112	0	7970
27897	7740	19	99	90	0	7948
27898	7869	27	39	60	0	7995
27899	8097	12	20	42	0	8171
27900	146	20	10	7905	0	8081
27901	80	28	9	8023	0	8140
27902	60	11	5	8400	0	8476
27903	31	8333	12	172	0	8548
27904	89	129	26	8640	0	8884
27905	43	57	12	9803	0	9915
27906	38	32	9811	251	0	10132
27907	37	24	196	9817	0	10074
27908	53	24	59	10083	0	10219
27909	44	20	30	10111	0	10205
27910	49	25	21	10036	0	10131
27911	38	9823	25	314	0	10200
27912	53	209	24	9951	0	10237
27913	53	57	30	10011	0	10151
27914	9792	37	16	347	0	10192
27915	218	32	9703	152	0	10105
27916	87	28	9537	104	0	9756
27917	9471	34	258	106	0	9869
27918	9972	30	83	92	0	10177
27919	295	27	44	9298	0	9664
27920	112	9832	35	226	0	10205
27921	9896	208	34	118	0	10256
27922	273	74	50	9737	0	10134
27923	108	9884	34	235	0	10261
27924	9826	191	20	128	0	10165
27925	273	9841	24	64	0	10202
27926	9631	220	18	79	0	9948
27927	9461	78	19	76	0	9634
27928	278	9236	23	49	0	9586
27929	139	195	24	9270	0	9628
27930	81	87	9198	228	0	9594
27931	81	72	184	9130	0	9467
27932	9133	42	60	261	0	9496
27933	227	45	8922	110	0	9304
27934	97	8954	187	74	0	9312
27935	85	216	58	8851	0	9210
27936	48	77	8762	224	0	9111
27937	47	8681	205	106	0	9039
27938	8511	194	69	134	0	8908
27939	222	64	55	8622	0	8963
27940	91	60	40	8751	0	8942
27941	72	46	40	8661	0	8819
27942	42	8534	41	264	0	8881
27943	8553	203	35	117	0	8908
27944	202	8408	29	89	0	8728
27945	84	8724	22	84	0	8914
27946	8671	214	22	100	0	9007
27947	8725	82	22	90	0	8919
27948	231	79	8314	65	0	8689
27949	8090	56	167	65	0	8378
27950	8156	57	49	56	0	8318
27951	265	61	37	7939	0	8302
27952	129	51	7880	198	0	8258
27953	117	49	167	7912	0	8245
27954	7967	33	62	245	0	8307
27955	229	30	7983	87	0	8329
27956	126	36	178	8306	0	8646
27957	139	30	60	8940	0	9169
27958	82	23	59	9971	0	10135
27959	9939	38	51	418	0	10446
27960	349	10130	25	179	0	10683
27961	10262	319	47	123	0	10751
27962	381	90	10232	101	0	10804
27963	151	70	329	10045	0	10595
27964	90	10320	82	399	0	10891
27965	10423	343	61	157	0	10984
27966	400	114	52	10434	0	11000
27967	137	92	10187	391	0	10807
27968	110	63	337	10105	0	10615
27969	9839	44	100	431	0	10414
27970	346	9805	66	165	0	10382
27971	163	448	51	9120	0	9782
27972	107	9716	36	360	0	10219
27973	9658	363	55	162	0	10238
27974	9680	129	35	146	0	9990
27975	435	9375	40	104	0	9954
27976	9298	353	45	95	0	9791
27977	410	101	40	8943	0	9494
27978	134	9200	45	334	0	9713
27979	9200	342	25	129	0	9696
27980	9498	100	29	99	0	9726
27981	416	8836	56	86	0	9394
27982	170	9125	27	73	0	9395
27983	8975	355	23	92	0	9445
27984	406	134	22	8871	0	9433
27985	8954	108	34	346	0	9442
27986	437	81	17	8876	0	9411
27987	189	75	8694	356	0	9314
27988	148	83	282	8894	0	9407
27989	8826	72	61	393	0	9352
27990	385	64	8751	141	0	9341
27991	178	43	304	8838	0	9363
27992	135	51	86	9215	0	9487
27993	87	49	8847	413	0	9396
27994	8606	35	326	167	0	9134
27995	394	49	81	8760	0	9284
27996	117	42	8287	376	0	8822
27997	7801	48	327	159	0	8335
27998	360	8105	99	133	0	8697
27999	118	8151	91	107	0	8467
28000	112	8296	65	89	0	8562
28001	88	338	7864	96	0	8386
28002	123	177	308	7542	0	8150
28003	85	82	7401	312	0	7880
28004	71	254	246	6342	0	6913
28005	44	6115	79	253	0	6491
28006	30	6108	36	93	0	6267
28007	64	234	50	5932	0	6280
28008	5881	62	30	258	0	6231
28009	205	52	30	5990	0	6277
28010	64	33	32	6050	0	6179
28011	34	5893	26	250	0	6203
28012	5870	213	18	84	0	6185
28013	202	5931	10	77	0	6220
28014	83	204	16	5887	0	6190
28015	55	84	33	5950	0	6122
28016	47	5759	20	271	0	6097
28017	51	221	26	5838	0	6136
28018	5769	55	14	290	0	6128
28019	230	85	14	5799	0	6128
28020	111	87	14	5868	0	6080
28021	91	5633	31	254	0	6009
28022	97	216	27	5719	0	6059
28023	5422	83	30	286	0	5821
28024	5680	56	17	134	0	5887
28025	5751	79	11	113	0	5954
28026	293	53	28	5667	0	6041
28027	117	68	5547	261	0	5993
28028	101	47	5606	114	0	5868
28029	101	60	215	5632	0	6008
28030	5689	69	55	259	0	6072
28031	235	74	42	5714	0	6065
28032	5866	52	31	291	0	6240
28033	278	53	27	5935	0	6293
28034	151	55	30	6151	0	6387
28035	6036	58	29	289	0	6412
28036	277	47	5803	109	0	6236
28037	5875	52	194	113	0	6234
28038	289	54	5851	79	0	6273
28039	145	62	192	5825	0	6224
28040	5943	47	64	262	0	6316
28041	279	57	5958	91	0	6385
28042	108	53	6076	65	0	6302
28043	6038	41	239	97	0	6415
28044	289	33	6043	85	0	6450
28045	116	5915	224	110	0	6365
28046	103	212	91	6223	0	6629
28047	6610	67	64	316	0	7057
28048	243	49	6653	133	0	7078
28049	6734	32	239	117	0	7122
28050	6987	29	111	91	0	7218
28051	6967	38	71	99	0	7175
28052	6975	33	79	101	0	7188
28053	313	67	49	6673	0	7102
28054	125	6655	74	244	0	7098
28055	6596	210	58	136	0	7000
28056	257	64	6234	87	0	6642
28057	98	5209	151	52	0	5510
28058	4382	96	72	39	0	4589
28059	66	3923	22	24	0	4035
28060	25	4039	20	14	0	4098
28061	122	67	35	3939	0	4163
28062	28	19	21	4016	0	4084
28063	20	7	7	3999	0	4033
28064	4103	7	7	64	0	4181
28065	4215	9	7	31	0	4262
28066	66	6	8	4399	0	4479
28067	41	8	8	4701	0	4758
28068	21	14	4918	87	0	5040
28069	4954	2	76	46	0	5078
28070	5220	10	33	26	0	5289
28071	120	9	12	5198	0	5339
28072	56	4	10	5287	0	5357
28073	22	13	5213	115	0	5363
28074	31	6	84	5235	0	5356
28075	27	4	5347	96	0	5474
28076	27	5286	96	43	0	5452
28077	20	74	5418	34	0	5546
28078	31	36	91	5240	0	5398
28079	30	15	5449	95	0	5589
28080	25	15	5215	47	0	5302
28081	5396	10	125	38	0	5569
28082	93	12	54	5773	0	5932
28083	48	9	5774	103	0	5934
28084	5539	6	106	43	0	5694
28085	100	12	5858	38	0	6008
28086	43	14	6264	29	0	6350
28087	32	6403	142	22	0	6599
28088	25	91	57	6399	0	6572
28089	23	29	6377	99	0	6528
28090	27	25	6142	44	0	6238
28091	33	8	131	6239	0	6411
28092	31	8	54	6277	0	6370
28093	21	6322	46	123	0	6512
28094	30	94	28	6425	0	6577
28095	6519	28	21	139	0	6707
28096	6525	14	24	77	0	6640
28097	6654	13	39	64	0	6770
28098	154	6	28	6489	0	6677
28099	59	6522	39	125	0	6745
28100	6544	96	39	74	0	6753
28101	113	6513	34	39	0	6699
28102	53	6409	22	49	0	6533
28103	31	6557	42	33	0	6663
28104	6624	128	45	44	0	6841
28105	125	43	39	6625	0	6832
28106	60	27	24	6655	0	6766
28107	37	6644	25	127	0	6833
28108	6578	107	31	73	0	6789
28109	125	43	6550	33	0	6751
28110	64	35	111	6625	0	6835
28111	6653	21	52	116	0	6842
28112	109	6948	34	64	0	7155
28113	7226	115	30	84	0	7455
28114	133	42	30	7432	0	7637
28115	49	7574	34	102	0	7759
28116	38	119	7449	56	0	7662
28117	7519	54	110	66	0	7749
28118	133	41	44	7721	0	7939
28119	7798	21	24	141	0	7984
28120	133	24	18	7773	0	7948
28121	62	7702	24	125	0	7913
28122	65	99	7868	65	0	8097
28123	43	56	7832	44	0	7975
28124	47	76	126	7917	0	8166
28125	7995	30	62	128	0	8215
28126	8005	36	27	69	0	8137
28127	143	24	19	7896	0	8082
28128	72	21	29	7948	0	8070
28129	8043	30	26	158	0	8257
28130	123	21	30	8168	0	8342
28131	8211	24	27	159	0	8421
28132	127	8062	21	75	0	8285
28133	8078	106	33	72	0	8289
28134	150	35	8153	49	0	8387
28135	65	43	120	8169	0	8397
28136	55	21	57	8390	0	8523
28137	51	22	49	8395	0	8517
28138	45	8048	35	182	0	8310
28139	66	7500	34	88	0	7688
28140	59	126	30	8206	0	8421
28141	28	52	8135	148	0	8363
28142	36	27	117	8039	0	8219
28143	48	22	46	8217	0	8333
28144	32	8058	38	155	0	8283
28145	8013	112	42	71	0	8238
28146	114	7795	35	56	0	8000
28147	47	7828	47	39	0	7961
28148	40	117	54	7846	0	8057
28149	57	39	34	7888	0	8018
28150	45	32	19	7829	0	7925
28151	52	27	22	7890	0	7991
28152	7779	35	26	169	0	8009
28153	107	7750	28	74	0	7959
28154	7889	101	32	81	0	8103
28155	8217	45	44	74	0	8380
28156	135	38	17	8200	0	8390
28157	65	28	18	8332	0	8443
28158	8250	27	21	162	0	8460
28159	8307	15	23	88	0	8433
28160	142	40	16	8139	0	8337
28161	84	40	8	8213	0	8345
28162	56	28	8074	159	0	8317
28163	44	7955	87	79	0	8165
28164	43	8226	23	59	0	8351
28165	8111	91	23	67	0	8292
28166	113	18	8301	44	0	8476
28167	33	27	7659	28	0	7747
28168	7291	32	67	38	0	7428
28169	7612	6	29	37	0	7684
28170	57	8044	16	14	0	8131
28171	18	8274	4	20	0	8316
28172	33	41	5	8428	0	8507
28173	8675	16	10	91	0	8792
28174	8669	11	2	54	0	8736
28175	8782	8	1	54	0	8845
28176	59	18	7	8736	0	8820
28177	28	11	4	8784	0	8827
28178	11	20	8571	65	0	8667
28179	22	16	7954	24	0	8016
28180	19	4	8591	21	0	8635
28181	42	97	59	8500	0	8698
28182	8390	7	9	74	0	8480
28183	47	4	8555	16	0	8622
28184	29	3	37	8510	0	8579
28185	6	8729	12	41	0	8788
28186	6	41	6	8608	0	8661
28187	20	6	1	8559	0	8586
28188	7	8	8893	57	0	8965
28189	17	4	56	8742	0	8819
28190	9764	4	5	93	0	9866
28191	111	6	10108	13	0	10238
28192	33	1	102	10159	0	10295
28193	19	8	10623	109	0	10759
28194	17	10599	138	36	0	10790
28195	13	132	10722	25	0	10892
28196	44	39	155	10209	0	10447
28197	34	23	54	10871	0	10982
28198	8	17	11094	193	0	11312
28199	20	15	156	10896	0	11087
28200	44	19	50	10917	0	11030
28201	13	10948	51	187	0	11199
28202	9	136	11106	90	0	11341
28203	35	41	144	11113	0	11333
28204	29	23	64	11411	0	11527
28205	10	11361	42	215	0	11628
28206	17	149	33	11659	0	11858
28207	11574	59	26	230	0	11889
28208	158	34	38	11703	0	11933
28209	45	28	11716	210	0	11999
28210	11472	14	158	146	0	11790
28211	12582	25	54	92	0	12753
28212	241	20	12445	70	0	12776
28213	12091	11	200	101	0	12403
28214	228	12561	76	56	0	12921
28215	104	191	64	12850	0	13209
28216	97	73	35	14355	0	14560
28217	79	46	32	14272	0	14429
28218	61	30	39	14672	0	14802
28219	58	21	21	14809	0	14909
28220	14507	32	24	446	0	15009
28221	284	27	14260	200	0	14771
28222	13815	12	260	164	0	14251
28223	312	24	14146	115	0	14597
28224	144	12	312	14140	0	14608
28225	14267	8	118	378	0	14771
28226	359	13	65	14232	0	14669
28227	137	14399	72	334	0	14942
28228	14895	247	66	198	0	15406
28229	351	77	56	15402	0	15886
28230	131	68	14388	373	0	14960
28231	14456	31	248	206	0	14941
28232	310	15415	102	143	0	15970
28233	145	267	15727	116	0	16255
28234	131	106	309	15506	0	16052
28235	148	63	124	15091	0	15426
28236	75	15525	104	388	0	16092
28237	87	276	15557	193	0	16113
28238	102	133	304	15521	0	16060
28239	67	82	16169	387	0	16705
28240	75	63	341	16034	0	16513
28241	73	49	140	16259	0	16521
28242	58	66	16127	483	0	16734
28243	77	49	342	16085	0	16553
28244	213	71	232	13511	0	14027
28245	70	36	131	16886	0	17123
28246	93	37	122	16926	0	17178
28247	16306	32	94	587	0	17019
28248	345	30	16092	314	0	16781
28249	16780	38	360	258	0	17436
28250	422	34	166	17619	0	18241
28251	180	39	134	18015	0	18368
28252	158	37	90	17937	0	18222
28253	108	17546	102	624	0	18380
28254	17858	337	89	354	0	18638
28255	417	136	99	18800	0	19452
28256	184	18730	95	535	0	19544
28257	137	333	96	19284	0	19850
28258	19323	131	100	597	0	20151
28259	19403	122	56	377	0	19958
28260	19377	100	91	297	0	19865
28261	490	19117	93	228	0	19928
28262	228	351	19214	235	0	20028
28263	19112	162	363	268	0	19905
28264	19702	120	159	255	0	20236
28265	513	19563	120	229	0	20425
28266	19549	361	92	249	0	20251
28267	19300	153	96	226	0	19775
28268	19737	112	74	243	0	20166
28269	586	20151	100	193	0	21030
28270	359	370	81	20111	0	20921
28271	20184	159	75	541	0	20959
28272	20574	127	75	273	0	21049
28273	20084	80	54	252	0	20470
28274	20454	92	49	222	0	20817
28275	656	99	70	19879	0	20704
28276	358	90	19635	496	0	20579
28277	305	92	353	19657	0	20407
28278	239	19863	158	528	0	20788
28279	256	372	98	20686	0	21412
28280	244	175	20612	529	0	21560
28281	20744	111	401	313	0	21569
28282	578	97	165	21324	0	22164
28283	21269	87	145	549	0	22050
28284	21535	97	90	382	0	22104
28285	672	94	92	21467	0	22325
28286	378	92	21486	523	0	22479
28287	364	91	20179	270	0	20904
28288	20046	96	483	255	0	20880
28289	530	20634	239	215	0	21618
28290	307	19873	135	163	0	20478
28291	249	19916	95	195	0	20455
28292	216	20501	88	166	0	20971
28293	19735	453	175	189	0	20552
28294	19863	185	134	195	0	20377
28295	19834	105	81	156	0	20176
28296	19907	113	63	161	0	20244
28297	536	129	53	19389	0	20107
28298	300	19189	59	360	0	19908
28299	19314	316	67	231	0	19928
28300	443	159	19189	159	0	19950
28301	265	19265	309	145	0	19984
28302	254	298	19270	124	0	19946
28303	18874	166	333	179	0	19552
28304	19566	124	153	155	0	19998
28305	19587	138	104	147	0	19976
28306	502	119	75	19419	0	20115
28307	316	102	19375	327	0	20120
28308	258	19278	305	169	0	20010
28309	19015	294	150	189	0	19648
28310	422	18868	103	122	0	19515
28311	275	18162	79	106	0	18622
28312	238	18139	64	100	0	18541
28313	212	18292	69	102	0	18675
28314	186	327	17585	83	0	18181
28315	160	17698	259	85	0	18202
28316	16164	221	135	83	0	16603
28317	258	110	50	16162	0	16580
28318	173	91	29	16320	0	16613
28319	16217	78	39	251	0	16585
28320	216	16061	41	138	0	16456
28321	158	190	16433	64	0	16845
28322	164	130	150	16230	0	16674
28323	150	80	82	16656	0	16968
28324	149	88	53	16721	0	17011
28325	103	91	16577	235	0	17006
28326	100	101	16295	118	0	16614
28327	107	107	210	16401	0	16825
28328	125	61	16394	179	0	16759
28329	116	98	15128	93	0	15435
28330	13957	68	208	130	0	14363
28331	196	15361	112	95	0	15764
28332	117	15036	58	88	0	15299
28333	119	15380	51	53	0	15603
28334	128	224	41	15155	0	15548
28335	83	15676	59	138	0	15956
28336	15836	152	58	133	0	16179
28337	186	89	15741	83	0	16099
28338	15850	67	171	90	0	16178
28339	221	73	90	16005	0	16389
28340	119	59	75	16301	0	16554
28341	70	16689	55	266	0	17080
28342	16606	218	64	151	0	17039
28343	16708	111	103	100	0	17022
28344	340	17782	54	52	0	18228
28345	203	285	43	17562	0	18093
28346	96	145	17935	273	0	18449
28347	71	89	17949	136	0	18245
28348	57	18369	378	87	0	18891
28349	18112	340	152	114	0	18718
28350	333	135	18127	24	0	18619
28351	196	74	307	17765	0	18342
28352	18220	39	129	351	0	18739
28353	18681	49	75	171	0	18976
28354	429	22655	64	82	0	23230
28355	174	24020	65	61	0	24320
28356	23888	688	71	76	0	24723
28357	603	270	23812	41	0	24726
28358	23658	128	561	77	0	24424
28359	24290	66	222	74	0	24652
28360	837	65	121	23675	0	24698
28361	309	82	24004	571	0	24966
28362	181	84	23756	176	0	24197
28363	23250	66	764	131	0	24211
28364	680	84	24094	49	0	24907
28365	23158	44	678	108	0	23988
28366	24020	71	233	98	0	24422
28367	784	23708	147	62	0	24701
28368	349	638	23522	36	0	24545
28369	216	23130	623	44	0	24013
28370	22952	629	276	87	0	23944
28371	707	244	22801	35	0	23787
28372	409	138	647	22028	0	23222
28373	240	93	22848	591	0	23772
28374	176	87	23031	197	0	23491
28375	190	77	23038	101	0	23406
28376	192	83	22793	60	0	23128
28377	159	22016	936	57	0	23168
28378	191	586	22089	63	0	22929
28379	155	21805	709	55	0	22724
28380	139	671	21468	62	0	22340
28381	20945	254	766	71	0	22036
28382	719	170	316	19670	0	20875
28383	314	21268	254	445	0	22281
28384	20897	588	209	220	0	21914
28385	21141	239	211	167	0	21758
28386	19967	176	222	145	0	20510
28387	20918	123	231	110	0	21382
28388	821	20675	240	57	0	21793
28389	19510	632	192	151	0	20485
28390	20889	277	205	108	0	21479
28391	816	20147	211	71	0	21245
28392	365	683	19221	79	0	20348
28393	344	274	680	19048	0	20346
28394	240	19851	330	528	0	20949
28395	217	669	19901	211	0	20998
28396	243	326	20065	113	0	20747
28397	266	19509	845	105	0	20725
28398	278	19859	438	79	0	20654
28399	269	20402	288	90	0	21049
28400	260	20079	224	94	0	20657
28401	19857	957	216	102	0	21132
28402	20456	422	219	107	0	21204
28403	974	317	20084	70	0	21445
28404	497	264	20320	75	0	21156
28405	370	199	945	19524	0	21038
28406	338	243	439	19999	0	21019
28407	344	240	320	20353	0	21257
28408	19774	211	336	859	0	21180
28409	820	19670	283	343	0	21116
28410	461	20493	292	191	0	21437
28411	389	21155	244	132	0	21920
28412	20284	1069	273	135	0	21761
28413	20868	539	282	139	0	21828
28414	1194	337	271	20087	0	21889
28415	20735	302	360	697	0	22094
28416	21087	287	331	320	0	22025
28417	1189	263	335	20441	0	22228
28418	20660	300	287	854	0	22101
28419	1072	20210	379	378	0	22039
28420	646	832	397	20211	0	22086
28421	579	449	19927	746	0	21701
28422	481	19859	995	323	0	21658
28423	499	958	20106	257	0	21820
28424	556	522	1054	18738	0	20870
28425	521	20046	607	682	0	21856
28426	584	851	498	19853	0	21786
28427	517	483	459	20317	0	21776
28428	555	365	19874	1000	0	21794
28429	433	328	21060	470	0	22291
28430	454	300	1193	20589	0	22536
28431	491	335	742	19846	0	21414
28432	408	20665	602	951	0	22626
28433	19758	918	511	455	0	21642
28434	985	20128	511	306	0	21930
28435	550	20808	436	244	0	22038
28436	411	1164	19761	245	0	21581
28437	324	19843	981	275	0	21423
28438	395	1001	659	18201	0	20256
28439	326	19389	490	823	0	21028
28440	362	944	463	18399	0	20168
28441	268	18822	525	806	0	20421
28442	18499	925	398	457	0	20279
28443	878	18708	443	305	0	20334
28444	455	976	305	16356	0	18092
28445	401	17374	280	632	0	18687
28446	16939	904	309	287	0	18439
28447	16775	583	188	249	0	17795
28448	931	16488	262	187	0	17868
28449	15835	808	162	190	0	16995
28450	858	648	187	14991	0	16684
28451	457	374	15068	654	0	16553
28452	406	324	15270	329	0	16329
28453	350	15008	734	252	0	16344
28454	9676	358	249	155	0	10438
28455	9524	156	85	103	0	9868
28456	323	104	9204	76	0	9707
28457	128	114	8965	78	0	9285
28458	8740	84	269	92	0	9185
28459	9045	94	94	78	0	9311
28460	296	105	8694	49	0	9144
28461	8375	84	246	72	0	8777
28462	261	8415	108	68	0	8852
28463	117	8711	73	64	0	8965
28464	82	302	93	8314	0	8791
28465	83	136	88	8424	0	8731
28466	8343	103	66	259	0	8771
28467	8322	88	62	121	0	8593
28468	8373	67	69	97	0	8606
28469	290	85	66	8160	0	8601
28470	155	74	56	8238	0	8523
28471	106	7807	68	266	0	8247
28472	106	8005	59	117	0	8287
28473	111	8330	46	89	0	8576
28474	81	309	52	7851	0	8293
28475	101	8099	52	210	0	8462
28476	85	276	7837	90	0	8288
28477	7510	145	195	97	0	7947
28478	234	112	7825	90	0	8261
28479	131	94	7808	84	0	8117
28480	7571	91	248	68	0	7978
28481	249	7719	102	67	0	8137
28482	7794	246	57	82	0	8179
28483	7865	140	56	79	0	8140
28484	302	103	7524	74	0	8003
28485	135	115	7817	57	0	8124
28486	118	7884	254	69	0	8325
28487	115	274	7909	60	0	8358
28488	117	131	261	7916	0	8425
28489	149	100	128	7002	0	7379
28490	80	7899	106	276	0	8361
28491	113	8276	87	96	0	8572
28492	8238	315	87	89	0	8729
28493	8623	162	81	93	0	8959
28494	332	108	86	8544	0	9070
28495	158	135	66	8762	0	9121
28496	8612	92	70	273	0	9047
28497	8737	90	83	119	0	9029
28498	319	8667	84	92	0	9162
28499	8284	251	88	77	0	8700
28500	278	8079	59	56	0	8472
28501	142	8442	51	62	0	8697
28502	8377	268	63	89	0	8797
28503	8395	125	47	84	0	8651
28504	291	133	47	8165	0	8636
28505	8281	98	43	214	0	8636
28506	297	76	8140	83	0	8596
28507	163	8236	193	77	0	8669
28508	8212	196	70	100	0	8578
28509	236	103	8221	83	0	8643
28510	142	161	178	7376	0	7857
28511	102	7532	72	153	0	7859
28512	101	7767	52	57	0	7977
28513	7757	186	78	62	0	8083
28514	211	97	7545	36	0	7889
28515	7389	53	157	31	0	7630
28516	205	53	64	7505	0	7827
28517	114	35	7470	131	0	7750
28518	7473	41	153	82	0	7749
28519	181	7868	62	39	0	8150
28520	81	8302	55	37	0	8475
28521	8410	186	65	55	0	8716
28522	8507	67	19	53	0	8646
28523	8608	48	23	56	0	8735
28524	211	40	26	8445	0	8722
28525	112	42	25	8494	0	8673
28526	78	39	8351	140	0	8608
28527	77	40	8014	56	0	8187
28528	65	8287	129	53	0	8534
28529	66	166	41	7567	0	7840
28530	7500	26	18	83	0	7627
28531	71	7502	17	40	0	7630
28532	38	83	17	7653	0	7791
28533	7667	30	20	82	0	7799
28534	81	7630	18	32	0	7761
28535	42	8027	13	24	0	8106
28536	43	73	7759	19	0	7894
28537	7722	39	63	28	0	7852
28538	8003	35	15	28	0	8081
28539	90	15	7808	20	0	7933
28540	7442	13	63	24	0	7542
28541	65	25	7846	10	0	7946
28542	26	7776	56	13	0	7871
28543	67	63	24	7737	0	7891
28544	7754	16	15	60	0	7845
28545	65	7616	16	13	0	7710
28546	21	7768	19	21	0	7829
28547	7656	56	10	26	0	7748
28548	57	21	8060	6	0	8144
28549	7904	10	46	30	0	7990
28550	50	8278	10	4	0	8342
28551	19	39	8021	3	0	8082
28552	7937	8	41	12	0	7998
28553	8227	8	8	13	0	8256
28554	53	6	10	8171	0	8240
28555	23	9	7	8288	0	8327
28556	11	8230	8	47	0	8296
28557	14	43	8283	14	0	8354
28558	20	10	39	8244	0	8313
28559	12	13	8796	45	0	8866
28560	16	10	8689	11	0	8726
28561	17	14	65	9297	0	9393
28562	12	9	9548	81	0	9650
28563	16	12	9245	19	0	9292
28564	30	17	106	9301	0	9454
28565	16	5	9608	85	0	9714
28566	9017	3	110	40	0	9170
28567	87	9388	33	24	0	9532
28568	24	82	9859	19	0	9984
28569	28	30	10216	10	0	10284
28570	36	18	114	9893	0	10061
28571	10692	10	40	103	0	10845
28572	10717	7	35	38	0	10797
28573	10723	3	19	28	0	10773
28574	10745	7	19	34	0	10805
28575	130	1	16	10579	0	10726
28576	42	14	10713	95	0	10864
28577	10708	5	87	48	0	10848
28578	10975	7	29	44	0	11055
28579	11052	4	23	34	0	11113
28580	132	9	10751	9	0	10901
28581	10445	8	95	21	0	10569
28582	132	9	29	11270	0	11440
28583	43	11435	32	80	0	11590
28584	45	90	20	11359	0	11514
28585	23	11504	14	100	0	11641
28586	11559	84	20	40	0	11703
28587	112	38	11728	26	0	11904
28588	52	21	106	11545	0	11724
28589	30	11693	47	98	0	11868
28590	24	12037	28	44	0	12133
28591	12020	131	27	49	0	12227
28592	11909	44	22	33	0	12008
28593	136	44	11460	11	0	11651
28594	11465	18	118	32	0	11633
28595	158	17	45	11683	0	11903
28596	60	36	12130	116	0	12342
28597	66	19	11810	48	0	11943
28598	69	29	136	12272	0	12506
28599	13042	15	58	179	0	13294
28600	170	19	58	12954	0	13201
28601	82	6	30	12983	0	13101
28602	75	17	38	12938	0	13068
28603	48	12976	31	198	0	13253
28604	60	133	38	13215	0	13446
28605	12918	44	31	197	0	13190
28606	152	12927	44	84	0	13207
28607	83	154	26	13213	0	13476
28608	13118	48	22	242	0	13430
28609	187	12926	33	71	0	13217
28610	72	13246	37	71	0	13426
28611	64	218	36	13226	0	13544
28612	12970	85	26	231	0	13312
28613	201	54	12786	104	0	13145
28614	107	63	12446	73	0	12689
28615	12734	36	224	94	0	13088
28616	13299	37	87	63	0	13486
28617	271	13588	65	69	0	13993
28618	153	230	43	13214	0	13640
28619	97	81	13188	217	0	13583
28620	89	58	12768	99	0	13014
28621	76	50	13838	64	0	14028
28622	53	13635	347	65	0	14100
28623	63	13963	136	56	0	14218
28624	13822	288	88	101	0	14299
28625	289	134	13880	49	0	14352
28626	13555	63	281	97	0	13996
28627	14014	51	125	69	0	14259
28628	364	46	14064	69	0	14543
28629	154	14348	295	59	0	14856
28630	160	278	105	13992	0	14535
28631	90	132	14665	301	0	15188
28632	83	111	13969	114	0	14277
28633	13716	66	368	111	0	14261
28634	320	14332	151	67	0	14870
28635	131	306	103	13934	0	14474
28636	120	136	77	13986	0	14319
28637	89	13934	77	346	0	14446
28638	80	14308	83	126	0	14597
28639	93	14566	83	93	0	14835
28640	112	365	61	14859	0	15397
28641	15379	160	64	368	0	15971
28642	398	110	60	15646	0	16214
28643	151	98	15508	420	0	16177
28644	109	90	15461	179	0	15839
28645	138	81	457	15604	0	16280
28646	85	72	15589	424	0	16170
28647	90	15526	439	155	0	16210
28648	103	392	174	15991	0	16660
28649	16756	159	124	503	0	17542
28650	17071	111	114	219	0	17515
28651	548	17183	81	139	0	17951
28652	17116	503	92	157	0	17868
28653	17594	191	79	133	0	17997
28654	17714	115	74	148	0	18051
28655	663	130	15785	115	0	16693
28656	16616	81	452	139	0	17288
28657	566	16731	172	125	0	17594
28658	240	480	16779	100	0	17599
28659	186	174	16694	93	0	17147
28660	151	16402	563	104	0	17220
28661	16157	498	222	109	0	16986
28662	582	159	126	15594	0	16461
28663	208	15686	106	435	0	16435
28664	15845	487	103	210	0	16645
28665	569	174	106	15888	0	16737
28666	16121	137	90	539	0	16887
28667	596	123	98	16163	0	16980
28668	265	103	15713	539	0	16620
28669	180	134	15489	208	0	16011
28670	185	121	15645	142	0	16093
28671	184	110	621	15053	0	15968
28672	184	117	243	15669	0	16213
28673	148	135	15362	604	0	16249
28674	172	15172	555	232	0	16131
28675	15442	504	216	203	0	16365
28676	15611	193	161	170	0	16135
28677	670	15464	165	143	0	16442
28678	337	535	155	15757	0	16784
28679	245	207	15934	541	0	16927
28680	15661	137	564	242	0	16604
28681	651	129	16041	161	0	16982
28682	273	148	15104	120	0	15645
28683	206	130	15591	124	0	16051
28684	14876	107	722	138	0	15843
28685	635	113	15224	101	0	16073
28686	288	14472	614	135	0	15509
28687	213	15174	295	118	0	15800
28688	251	601	224	14401	0	15477
28689	224	219	196	14844	0	15483
28690	190	137	14557	598	0	15482
28691	14158	140	592	262	0	15152
28692	14976	131	254	182	0	15543
28693	675	151	209	14600	0	15635
28694	14608	108	209	571	0	15496
28695	611	14441	218	223	0	15493
28696	14181	529	182	185	0	15077
28697	621	13647	176	181	0	14625
28698	275	13996	160	153	0	14584
28699	13281	569	195	158	0	14203
28700	13370	204	154	178	0	13906
28701	13823	154	161	142	0	14280
28702	14020	139	152	160	0	14471
28703	683	143	13014	146	0	13986
28704	13116	115	542	181	0	13954
28705	659	136	250	12757	0	13802
28706	314	12905	179	459	0	13857
28707	12998	484	154	201	0	13837
28708	624	12922	143	170	0	13859
28709	12931	484	146	141	0	13702
28710	638	183	156	12745	0	13722
28711	332	159	134	13143	0	13768
28712	254	161	12233	524	0	13172
28713	259	141	12720	205	0	13325
28714	215	12694	557	167	0	13633
28715	12341	452	236	164	0	13193
28716	577	12143	168	138	0	13026
28717	282	11811	155	137	0	12385
28718	270	12228	139	131	0	12768
28719	288	534	11675	102	0	12599
28720	257	11868	446	106	0	12677
28721	10969	478	207	128	0	11782
28722	11071	214	130	115	0	11530
28723	556	166	138	10570	0	11430
28724	273	10417	132	410	0	11232
28725	191	10909	163	158	0	11421
28726	239	501	121	10664	0	11525
28727	227	206	10651	386	0	11470
28728	212	10320	422	144	0	11098
28729	248	478	167	9965	0	10858
28730	9683	232	107	397	0	10419
28731	9914	179	98	171	0	10362
28732	470	9915	108	143	0	10636
28733	9958	452	117	130	0	10657
28734	10168	179	103	135	0	10585
28735	535	152	112	9799	0	10598
28736	287	134	9624	371	0	10416
28737	207	9683	381	179	0	10450
28738	209	421	181	9476	0	10287
28739	176	185	9426	350	0	10137
28740	175	9068	316	164	0	9723
28741	8300	330	159	132	0	8921
28742	8400	159	84	110	0	8753
28743	378	130	72	8102	0	8682
28744	184	8132	85	274	0	8675
28745	166	294	8033	117	0	8610
28746	182	186	263	7904	0	8535
28747	147	117	8060	280	0	8604
28748	112	7278	239	131	0	7760
28749	212	239	128	6007	0	6586
28750	5871	69	57	162	0	6159
28751	144	5818	37	74	0	6073
28752	5730	162	36	53	0	5981
28753	5705	79	38	41	0	5863
28754	190	5757	24	58	0	6029
28755	103	146	45	5731	0	6025
28756	66	102	34	5746	0	5948
28757	58	5504	41	167	0	5770
28758	73	5732	39	68	0	5912
28759	61	166	39	5392	0	5658
28760	65	5513	23	117	0	5718
28761	5481	136	26	52	0	5695
28762	5508	79	16	47	0	5650
28763	177	66	5363	41	0	5647
28764	93	47	5252	37	0	5429
28765	5072	52	137	50	0	5311
28766	5244	31	64	37	0	5376
28767	138	5376	35	29	0	5578
28768	5337	131	28	51	0	5547
28769	5354	73	23	44	0	5494
28770	168	5286	15	33	0	5502
28771	5453	133	17	42	0	5645
28772	168	76	17	6092	0	6353
28773	93	50	28	6364	0	6535
28774	60	55	6605	192	0	6912
28775	44	6391	140	84	0	6659
28776	36	6732	55	48	0	6871
28777	6186	276	74	94	0	6630
28778	6194	61	31	47	0	6333
28779	6033	40	15	57	0	6145
28780	6327	25	15	31	0	6398
28781	172	38	5888	17	0	6115
28782	71	26	6226	12	0	6335
28783	44	6223	146	25	0	6438
28784	53	130	57	6137	0	6377
28785	54	55	22	6041	0	6172
28786	36	6233	16	132	0	6417
28787	57	131	19	6112	0	6319
28788	6091	58	18	141	0	6308
28789	135	6101	22	53	0	6311
28790	74	130	6221	26	0	6451
28791	41	6331	107	33	0	6512
28792	6316	127	45	49	0	6537
28793	135	62	6229	29	0	6455
28794	6164	44	129	34	0	6371
28795	6344	37	49	35	0	6465
28796	167	37	6202	23	0	6429
28797	76	29	6105	21	0	6231
28798	56	29	6049	18	0	6152
28799	5829	33	154	18	0	6034
28800	146	18	6091	21	0	6276
28801	61	5944	133	10	0	6148
28802	5909	108	61	12	0	6090
28803	125	49	5913	11	0	6098
28804	5703	21	136	28	0	5888
28805	137	22	5868	8	0	6035
28806	67	18	6036	10	0	6131
28807	54	6080	149	11	0	6294
28808	44	101	6152	6	0	6303
28809	35	53	6056	13	0	6157
28810	51	5424	177	13	0	5665
28811	5901	119	81	14	0	6115
28812	123	52	6014	13	0	6202
28813	72	40	137	5609	0	5858
28814	40	6038	69	76	0	6223
28815	6089	114	44	46	0	6293
28816	6006	52	50	36	0	6144
28817	152	37	6036	18	0	6243
28818	69	5789	128	10	0	5996
28819	50	6086	72	10	0	6218
28820	37	146	56	5831	0	6070
28821	40	5606	44	97	0	5787
28822	75	136	46	5389	0	5646
28823	61	71	32	6033	0	6197
28824	48	6050	40	136	0	6274
28825	38	142	44	5963	0	6187
28826	47	6012	28	128	0	6215
28827	54	137	5849	67	0	6107
28828	40	68	133	5813	0	6054
28829	38	67	60	5889	0	6054
28830	32	5841	48	153	0	6074
28831	41	6053	50	66	0	6210
28832	39	178	36	5775	0	6028
28833	34	5901	40	140	0	6115
28834	5859	171	34	77	0	6141
28835	145	81	35	5849	0	6110
28836	63	5893	43	146	0	6145
28837	5788	153	43	73	0	6057
28838	132	5862	39	52	0	6085
28839	80	155	5811	44	0	6090
28840	61	98	130	5741	0	6030
28841	5844	67	73	146	0	6130
28842	145	57	5898	70	0	6170
28843	85	56	144	5710	0	5995
28844	59	5812	71	130	0	6072
28845	63	144	5737	70	0	6014
28846	48	5915	146	40	0	6149
28847	5668	132	93	56	0	5949
28848	5877	84	62	50	0	6073
28849	179	5839	62	18	0	6098
28850	5829	151	67	33	0	6080
28851	153	75	5791	30	0	6049
28852	85	71	153	5676	0	5985
28853	71	51	94	5690	0	5906
28854	64	5781	65	133	0	6043
28855	6102	140	69	72	0	6383
28856	6381	75	55	70	0	6581
28857	167	73	6323	23	0	6586
28858	6345	60	141	28	0	6574
28859	6536	46	80	41	0	6703
28860	6587	45	59	35	0	6726
28861	190	54	56	6337	0	6637
28862	110	51	43	6358	0	6562
28863	77	6402	49	142	0	6670
28864	6270	140	47	80	0	6537
28865	6288	74	42	63	0	6467
28866	177	6244	46	43	0	6510
28867	96	159	34	5935	0	6224
28868	63	5905	31	112	0	6111
28869	47	6229	36	58	0	6370
28870	6094	146	39	54	0	6333
28871	148	75	5840	47	0	6110
28872	59	32	5034	20	0	5145
28873	32	5054	77	32	0	5195
28874	4518	41	47	18	0	4624
28875	51	15	4425	8	0	4499
28876	21	4131	44	21	0	4217
28877	4101	24	8	12	0	4145
28878	25	11	4040	2	0	4078
28879	15	6	26	4000	0	4047
28880	4288	10	12	30	0	4340
28881	38	6	4423	19	0	4486
28882	19	6	4618	7	0	4650
28883	10	11	4887	7	0	4915
28884	16	5	4938	1	0	4960
28885	4708	8	72	13	0	4801
28886	5119	1	22	11	0	5153
28887	42	5132	13	8	0	5195
28888	25	43	7	5272	0	5347
28889	21	15	6	5523	0	5565
28890	9	5422	4	60	0	5495
28891	16	68	6	5515	0	5605
28892	6	5737	4	69	0	5816
28893	7	5886	4	31	0	5928
28894	13	104	7	5831	0	5955
28895	2	36	5841	87	0	5966
28896	7	5837	89	30	0	5963
28897	15	83	36	5883	0	6017
28898	5916	27	20	98	0	6061
28899	84	19	5840	35	0	5978
28900	5734	12	80	34	0	5860
28901	5965	13	32	33	0	6043
28902	113	6	21	6145	0	6285
28903	35	18	6489	97	0	6639
28904	28	15	6582	41	0	6666
28905	15	7037	138	25	0	7215
28906	30	130	59	6907	0	7126
28907	12	49	7079	130	0	7270
28908	11	22	7045	52	0	7130
28909	3	7221	162	27	0	7413
28910	7282	127	60	43	0	7512
28911	7484	49	28	28	0	7589
28912	177	32	29	7750	0	7988
28913	73	13	8108	157	0	8351
28914	45	16	8025	53	0	8139
28915	29	8421	203	35	0	8688
28916	17	158	8536	28	0	8739
28917	28	60	8517	18	0	8623
28918	40	39	247	8035	0	8361
28919	14	46	8585	163	0	8808
28920	8268	16	210	90	0	8584
28921	169	23	111	8667	0	8970
28922	69	22	9016	177	0	9284
28923	40	9006	192	78	0	9316
28924	54	166	99	9079	0	9398
28925	36	75	9184	189	0	9484
28926	18	9267	209	96	0	9590
28927	28	186	133	9116	0	9463
28928	19	9457	75	184	0	9735
28929	33	218	64	9491	0	9806
28930	41	88	69	9504	0	9702
28931	25	44	9511	285	0	9865
28932	17	9496	236	127	0	9876
28933	32	209	107	9554	0	9902
28934	43	82	53	9607	0	9785
28935	24	49	71	9783	0	9927
28936	12	54	9503	286	0	9855
28937	7	9408	221	153	0	9789
28938	25	197	123	9487	0	9832
28939	16	100	9474	235	0	9825
28940	12	9429	222	144	0	9807
28941	28	221	111	9509	0	9869
28942	14	116	9678	241	0	10049
28943	16	9669	236	146	0	10067
28944	32	224	113	9629	0	9998
28945	32	104	70	9972	0	10178
28946	18	76	9968	301	0	10363
28947	9301	56	235	193	0	9785
28948	175	9948	103	142	0	10368
28949	10047	213	92	120	0	10472
28950	212	122	10109	78	0	10521
28951	9973	84	238	107	0	10402
28952	216	61	137	10141	0	10555
28953	94	75	81	10460	0	10710
28954	53	68	10156	326	0	10603
28955	9428	53	255	179	0	9915
28956	9754	60	130	122	0	10066
28957	244	9740	92	95	0	10171
28958	110	10405	65	88	0	10668
28959	10323	262	56	131	0	10772
28960	234	110	10355	79	0	10778
28961	117	10716	246	74	0	11153
28962	76	239	122	10864	0	11301
28963	87	106	90	11132	0	11415
28964	45	76	10928	308	0	11357
28965	10513	47	264	181	0	11005
28966	233	56	11209	118	0	11616
28967	11134	56	284	109	0	11583
28968	288	55	11848	69	0	12260
28969	145	11851	297	73	0	12366
28970	12067	244	159	89	0	12559
28971	12222	136	106	89	0	12553
28972	12105	93	84	78	0	12360
28973	12226	62	82	77	0	12447
28974	352	62	89	11991	0	12494
28975	184	67	12001	267	0	12519
28976	118	60	263	11866	0	12307
28977	90	11936	124	312	0	12462
28978	99	239	105	12170	0	12613
28979	72	102	12075	288	0	12537
28980	84	63	12034	128	0	12309
28981	96	87	320	11788	0	12291
28982	11679	67	161	291	0	12198
28983	11479	57	84	156	0	11776
28984	11591	39	91	92	0	11813
28985	357	51	11587	72	0	12067
28986	188	41	11524	78	0	11831
28987	111	11545	302	74	0	12032
28988	83	11842	133	82	0	12140
28989	11409	239	146	80	0	11874
28990	11528	105	71	78	0	11782
28991	255	11871	57	66	0	12249
28992	11703	179	61	111	0	12054
28993	11789	78	81	68	0	12016
28994	266	11815	61	53	0	12195
28995	12187	203	47	84	0	12521
28996	12196	93	57	75	0	12421
28997	298	12324	47	44	0	12713
28998	12454	208	58	64	0	12784
28999	12370	85	90	74	0	12619
29000	278	58	12367	55	0	12758
29001	159	71	12174	51	0	12455
29002	97	12097	209	47	0	12450
29003	98	12166	94	35	0	12393
29004	11879	203	159	54	0	12295
29005	11580	82	64	43	0	11769
29006	11471	42	53	35	0	11601
29007	199	11596	39	25	0	11859
29008	106	144	24	11721	0	11995
29009	93	55	11726	116	0	11990
29010	96	95	133	11313	0	11637
29011	64	11633	70	123	0	11890
29012	11436	110	24	54	0	11624
29013	141	11068	23	22	0	11254
29014	67	111	26	11145	0	11349
29015	11746	39	21	125	0	11931
29016	11656	23	19	59	0	11757
29017	169	39	11548	22	0	11778
29018	11678	28	119	57	0	11882
29019	12569	19	41	31	0	12660
29020	12823	14	31	32	0	12900
29021	212	22	29	12339	0	12602
29022	87	12346	22	138	0	12593
29023	79	154	23	12746	0	13002
29024	61	52	13070	157	0	13340
29025	53	13349	173	60	0	13635
29026	60	157	48	13348	0	13613
29027	42	60	13389	163	0	13654
29028	43	13316	165	63	0	13587
29029	87	167	67	12850	0	13171
29030	57	66	13270	166	0	13559
29031	11931	46	185	102	0	12264
29032	198	47	13463	34	0	13742
29033	102	54	13248	31	0	13435
29034	71	13485	215	40	0	13811
29035	80	183	80	13578	0	13921
29036	73	88	48	13407	0	13616
29037	49	13210	59	208	0	13526
29038	87	183	58	13878	0	14206
29039	14042	98	36	216	0	14392
29040	14049	33	46	116	0	14244
29041	265	59	13384	49	0	13757
29042	13729	61	154	73	0	14017
29043	14193	32	78	82	0	14385
29044	275	47	14100	36	0	14458
29045	139	14083	194	48	0	14464
29046	88	14221	105	30	0	14444
29047	101	251	66	13110	0	13528
29048	51	14043	66	147	0	14307
29049	77	231	12966	95	0	13369
29050	87	109	13264	66	0	13526
29051	73	13817	245	24	0	14159
29052	13786	221	79	62	0	14148
29053	14094	103	47	61	0	14305
29054	14235	62	48	47	0	14392
29055	14194	64	49	59	0	14366
29056	13420	73	45	83	0	13621
29057	284	13603	57	31	0	13975
29058	135	224	13317	22	0	13698
29059	127	114	194	13211	0	13646
29060	13156	77	71	224	0	13528
29061	259	12928	41	85	0	13313
29062	158	239	45	12880	0	13322
29063	98	84	12881	189	0	13252
29064	71	12506	235	80	0	12892
29065	56	13031	99	41	0	13227
29066	12392	296	84	95	0	12867
29067	224	12347	37	34	0	12642
29068	126	197	42	11853	0	12218
29069	11896	76	27	191	0	12190
29070	11857	50	40	77	0	12024
29071	11870	63	23	44	0	12000
29072	218	56	11634	22	0	11930
29073	103	11697	165	50	0	12015
29074	11934	177	65	51	0	12227
29075	189	116	23	11777	0	12105
29076	11860	36	27	211	0	12134
29077	215	11693	55	56	0	12019
29078	12207	198	16	48	0	12469
29079	13124	87	38	62	0	13311
29080	314	59	32	12837	0	13242
29081	133	83	13513	215	0	13944
29082	112	32	227	13753	0	14124
29083	13766	39	74	284	0	14163
29084	13947	47	52	122	0	14168
29085	345	13585	48	71	0	14049
29086	13251	242	60	86	0	13639
29087	280	13397	49	60	0	13786
29088	13500	267	56	67	0	13890
29089	13165	111	40	124	0	13440
29090	350	78	13313	42	0	13783
29091	158	13119	234	43	0	13554
29092	145	273	77	13157	0	13652
29093	133	99	61	13379	0	13672
29094	96	84	42	12978	0	13200
29095	79	12898	70	299	0	13346
29096	70	254	12721	154	0	13199
29097	90	122	12838	84	0	13134
29098	83	15420	311	76	0	15890
29099	15595	393	115	93	0	16196
29100	415	151	15579	56	0	16201
29101	15249	130	385	83	0	15847
29102	475	15572	149	35	0	16231
29103	197	392	15759	32	0	16380
29104	190	148	429	15507	0	16274
29105	84	155	15965	379	0	16583
29106	100	84	16330	161	0	16675
29107	139	70	492	14976	0	15677
29108	109	15279	233	364	0	15985
29109	77	16077	138	116	0	16408
29110	15843	475	132	117	0	16567
29111	408	206	15867	72	0	16553
29112	16048	164	408	77	0	16697
29113	16357	93	181	56	0	16687
29114	480	16258	174	62	0	16974
29115	15736	388	62	56	0	16242
29116	15854	190	58	62	0	16164
29117	15394	125	76	61	0	15656
29118	550	14833	83	62	0	15528
29119	235	13756	98	54	0	14143
29120	185	14506	72	38	0	14801
29121	14397	457	105	63	0	15022
29122	14427	251	62	61	0	14801
29123	470	145	13447	30	0	14092
29124	242	86	13229	19	0	13576
29125	13423	69	353	34	0	13879
29126	13722	65	156	41	0	13984
29127	13880	58	124	56	0	14118
29128	480	53	72	13407	0	14012
29129	274	42	60	13679	0	14055
29130	214	50	62	13801	0	14127
29131	155	61	46	13897	0	14159
29132	115	74	12724	423	0	13336
29133	111	73	13257	180	0	13621
29134	119	62	13303	111	0	13595
29135	121	52	13177	71	0	13421
29136	13054	46	388	74	0	13562
29137	338	13083	196	69	0	13686
29138	166	13505	140	55	0	13866
29139	13309	328	79	65	0	13781
29140	368	169	13262	50	0	13849
29141	172	136	13026	56	0	13390
29142	13022	98	385	87	0	13592
29143	13411	74	187	85	0	13757
29144	382	13142	142	64	0	13730
29145	219	273	101	13165	0	13758
29146	13358	110	107	265	0	13840
29147	13641	119	107	102	0	13969
29148	431	69	89	13326	0	13915
29149	250	13649	75	254	0	14228
29150	13975	302	46	122	0	14445
29151	371	154	13602	111	0	14238
29152	13416	122	315	103	0	13956
29153	409	13573	130	100	0	14212
29154	13843	295	142	74	0	14354
29155	13665	108	106	90	0	13969
29156	399	137	13823	59	0	14418
29157	256	88	13610	55	0	14009
29158	13847	80	381	60	0	14368
29159	14235	77	199	69	0	14580
29160	392	14316	143	52	0	14903
29161	251	327	93	14500	0	15171
29162	208	125	14410	284	0	15027
29163	14319	131	353	102	0	14905
29164	408	74	171	14542	0	15195
29165	229	68	165	14805	0	15267
29166	14734	72	89	359	0	15254
29167	386	14920	89	174	0	15569
29168	15104	316	72	162	0	15654
29169	15199	122	92	102	0	15515
29170	15274	127	84	104	0	15589
29171	507	14870	81	85	0	15543
29172	15224	308	84	96	0	15712
29173	493	118	95	15048	0	15754
29174	247	150	76	15073	0	15546
29175	264	95	14832	360	0	15551
29176	221	93	14632	155	0	15101
29177	198	14736	355	132	0	15421
29178	160	15201	166	88	0	15615
29179	154	314	14278	51	0	14797
29180	144	14452	275	57	0	14928
29181	14162	359	123	134	0	14778
29182	14368	110	96	59	0	14633
29183	14583	82	58	65	0	14788
29184	433	70	48	14008	0	14559
29185	209	74	43	14423	0	14749
29186	137	56	14375	321	0	14889
29187	96	14291	250	174	0	14811
29188	14312	264	93	132	0	14801
29189	307	14357	99	49	0	14812
29190	14434	298	61	60	0	14853
29191	14658	113	44	66	0	14881
29192	385	92	43	14260	0	14780
29193	203	54	55	14381	0	14693
29194	165	74	33	14718	0	14990
29195	153	40	14105	370	0	14668
29196	92	13865	245	188	0	14390
29197	86	14059	105	136	0	14386
29198	36	11260	34	28	0	11358
29199	29	11244	20	31	0	11324
29200	37	11205	18	30	0	11290
29201	10664	121	68	44	0	10897
29202	115	62	10721	17	0	10915
29203	48	10731	94	32	0	10905
29204	34	109	10410	18	0	10571
29205	32	10800	89	16	0	10937
29206	148	164	50	8027	0	8389
29207	41	36	14	10456	0	10547
29208	18	10792	22	95	0	10927
29209	10697	95	17	62	0	10871
29210	101	55	10617	20	0	10793
29211	36	10777	79	22	0	10914
29212	24	117	10567	20	0	10728
29213	40	42	83	10524	0	10689
29214	36	24	38	10017	0	10115
29215	23	10534	12	100	0	10669
29216	25	94	19	10699	0	10837
29217	21	49	23	10742	0	10835
29218	33	10702	22	115	0	10872
29219	14	105	10663	41	0	10823
29220	25	58	10379	33	0	10495
29221	10255	29	113	45	0	10442
29222	10791	45	34	33	0	10903
29223	126	25	22	10541	0	10714
29224	40	43	10626	93	0	10802
29225	39	30	86	10291	0	10446
29226	30	10985	40	98	0	11153
29227	26	114	10963	49	0	11152
29228	24	10803	95	38	0	10960
29229	22	101	10771	37	0	10931
29230	8	10886	98	30	0	11022
29231	10885	108	43	36	0	11072
29232	98	56	28	10803	0	10985
29233	47	41	20	10676	0	10784
29234	27	34	10843	107	0	11011
29235	31	43	10300	47	0	10421
29236	26	10776	116	33	0	10951
29237	10887	95	45	59	0	11086
29238	90	48	26	10890	0	11054
29239	34	30	11195	104	0	11363
29240	36	43	10528	49	0	10656
29241	10030	31	125	49	0	10235
29242	10402	32	44	52	0	10530
29243	120	41	10787	17	0	10965
29244	61	41	99	10466	0	10667
29245	26	10741	42	90	0	10899
29246	10910	91	38	65	0	11104
29247	79	10863	39	37	0	11018
29248	10639	84	18	44	0	10785
29249	81	10581	27	21	0	10710
29250	33	10683	18	24	0	10758
29251	27	94	25	10712	0	10858
29252	27	41	20	10731	0	10819
29253	23	10722	14	100	0	10859
29254	22	84	10501	35	0	10642
29255	18	43	10209	32	0	10302
29256	22	39	10289	20	0	10370
29257	9789	22	100	45	0	9956
29258	10334	24	44	56	0	10458
29259	92	10573	31	30	0	10726
29260	33	90	10391	20	0	10534
29261	36	49	102	10267	0	10454
29262	21	36	10814	91	0	10962
29263	33	37	10943	43	0	11056
29264	47	31	149	11803	0	12030
29265	38	40	67	12525	0	12670
29266	13	38	13604	274	0	13929
29267	13903	13	244	202	0	14362
29268	265	15022	145	100	0	15532
29269	152	16025	115	39	0	16331
29270	126	445	58	15729	0	16358
29271	16089	252	45	338	0	16724
29272	363	16358	41	177	0	16939
29273	16492	402	41	134	0	17069
29274	422	16714	28	74	0	17238
29275	17541	480	31	100	0	18152
29276	496	267	17533	60	0	18356
29277	284	175	17945	54	0	18458
29278	246	162	548	17447	0	18403
29279	136	115	17889	402	0	18542
29280	124	16892	524	210	0	17750
29281	98	17057	286	112	0	17553
29282	17094	563	196	103	0	17956
29283	457	312	135	16640	0	17544
29284	228	17264	120	393	0	18005
29285	17435	481	92	234	0	18242
29286	17346	314	86	141	0	17887
29287	18035	210	57	108	0	18410
29288	782	142	65	17428	0	18417
29289	465	113	64	17842	0	18484
29290	264	112	17488	628	0	18492
29291	194	110	17435	334	0	18073
29292	17208	64	613	239	0	18124
29293	575	92	328	17188	0	18183
29294	311	92	17260	495	0	18158
29295	16960	98	508	325	0	17891
29296	532	17522	317	211	0	18582
29297	17708	431	227	183	0	18549
29298	18030	256	149	157	0	18592
29299	18177	155	124	136	0	18592
29300	853	118	17241	112	0	18324
29301	17392	92	479	111	0	18074
29302	749	96	252	16689	0	17786
29303	444	16289	205	469	0	17407
29304	346	17491	162	245	0	18244
29305	17361	583	164	171	0	18279
29306	17537	297	115	159	0	18108
29307	17774	176	110	169	0	18229
29308	904	138	91	16933	0	18066
29309	538	141	101	17219	0	17999
29310	429	156	70	16760	0	17415
29311	329	16686	79	704	0	17798
29312	16693	460	79	399	0	17631
29313	17038	251	86	295	0	17670
29314	17280	175	95	233	0	17783
29315	869	152	16636	201	0	17858
29316	17289	158	444	206	0	18097
29317	817	173	243	16293	0	17526
29318	541	16782	156	443	0	17922
29319	16964	516	97	283	0	17860
29320	17054	273	110	215	0	17652
29321	910	186	16681	161	0	17938
29322	578	140	491	16375	0	17584
29323	389	16750	249	544	0	17932
29324	17188	518	180	354	0	18240
29325	750	340	117	17115	0	18322
29326	525	208	130	17048	0	17911
29327	425	146	109	17438	0	18118
29328	361	141	118	18130	0	18750
29329	285	148	17347	913	0	18693
29330	277	17388	541	525	0	18731
29331	288	558	258	17661	0	18765
29332	231	328	17609	743	0	18911
29333	17560	221	557	475	0	18813
29334	18129	171	319	353	0	18972
29335	891	162	250	17828	0	19131
29336	18014	161	179	736	0	19090
29337	18446	168	153	460	0	19227
29338	976	133	17777	328	0	19214
29339	604	17633	573	254	0	19064
29340	18030	541	304	303	0	19178
29341	799	302	234	17892	0	19227
29342	18307	189	182	694	0	19372
29343	855	161	211	17915	0	19142
29344	526	191	167	18345	0	19229
29345	407	152	17491	890	0	18940
29346	16705	138	566	576	0	17985
29347	767	17523	319	400	0	19009
29348	519	565	17440	335	0	18859
29349	404	17629	561	330	0	18924
29350	17407	649	351	297	0	18704
29351	820	346	239	17186	0	18591
29352	17360	242	200	657	0	18459
29353	791	17215	185	401	0	18592
29354	17732	608	141	317	0	18798
29355	18009	307	140	304	0	18760
29356	18105	225	128	294	0	18752
29357	17994	137	128	278	0	18537
29358	1049	17277	122	249	0	18697
29359	17637	549	149	202	0	18537
29360	946	340	132	17058	0	18476
29361	677	296	98	17087	0	18158
29362	484	15708	126	755	0	17073
29363	415	15884	108	424	0	16831
29364	417	15827	84	260	0	16588
29365	14719	618	93	275	0	15705
29366	574	13532	66	198	0	14370
29367	272	12013	57	105	0	12447
29368	11555	390	212	132	0	12289
29369	11304	153	55	117	0	11629
29370	457	11284	36	81	0	11858
29371	11219	293	45	106	0	11663
29372	413	152	10790	69	0	11424
29373	10707	112	218	84	0	11121
29374	379	94	10611	106	0	11190
29375	170	9500	180	76	0	9926
29376	123	9500	66	72	0	9761
29377	280	355	71	8735	0	9441
29378	8925	73	69	178	0	9245
29379	9072	75	21	90	0	9258
29380	9235	63	24	65	0	9387
29381	9206	61	37	67	0	9371
29382	9085	55	19	65	0	9224
29383	217	58	8766	46	0	9087
29384	106	69	8451	59	0	8685
29385	8778	62	133	63	0	9036
29386	185	8890	62	54	0	9191
29387	8666	125	53	47	0	8891
29388	9006	53	28	60	0	9147
29389	9318	42	31	58	0	9449
29390	9331	41	27	54	0	9453
29391	9375	40	25	69	0	9509
29392	192	52	9134	52	0	9430
29393	9340	42	112	67	0	9561
29394	9465	50	46	79	0	9640
29395	180	53	8981	55	0	9269
29396	8759	58	89	78	0	8984
29397	9249	53	46	69	0	9417
29398	192	57	9574	42	0	9865
29399	141	51	9515	34	0	9741
29400	126	9700	134	37	0	9997
29401	130	132	58	9773	0	10093
29402	134	56	9797	110	0	10097
29403	9904	53	111	68	0	10136
29404	215	42	69	10418	0	10744
29405	119	49	10685	127	0	10980
29406	10576	45	120	60	0	10801
29407	10839	48	56	64	0	11007
29408	10872	33	43	58	0	11006
29409	228	11089	30	49	0	11396
29410	149	128	34	10991	0	11302
29411	117	11159	40	134	0	11450
29412	11314	135	44	67	0	11560
29413	11205	63	51	71	0	11390
29414	212	72	11084	25	0	11393
29415	126	10667	124	29	0	10946
29416	104	10678	57	29	0	10868
29417	102	142	43	10514	0	10801
29418	105	69	26	10645	0	10845
29419	10624	54	25	141	0	10844
29420	191	10514	26	48	0	10779
29421	140	10484	16	25	0	10665
29422	149	149	10383	21	0	10702
29423	105	10601	114	23	0	10843
29424	10548	129	43	45	0	10765
29425	181	70	10299	24	0	10574
29426	9526	49	104	41	0	9720
29427	137	38	9873	22	0	10070
29428	8870	20	72	30	0	8992
29429	70	9635	21	6	0	9732
29430	10039	82	12	32	0	10165
29431	107	35	10264	20	0	10426
29432	10271	34	86	48	0	10439
29433	10333	21	31	29	0	10414
29434	114	33	10522	6	0	10675
29435	10414	19	92	33	0	10558
29436	10771	15	34	26	0	10846
29437	10424	13	23	26	0	10486
29438	139	10247	17	2	0	10405
29439	10432	89	19	26	0	10566
29440	125	44	10316	8	0	10493
29441	62	10771	85	6	0	10924
29442	10906	102	46	39	0	11093
29443	10755	35	22	27	0	10839
29444	10921	28	13	24	0	10986
29445	159	10905	20	15	0	11099
29446	85	99	17	12530	0	12731
29447	57	41	12655	179	0	12932
29448	80	16	204	12569	0	12869
29449	37	21	13221	228	0	13507
29450	12750	17	267	96	0	13130
29451	267	13271	87	48	0	13673
29452	140	242	55	13133	0	13570
29453	71	13394	30	223	0	13718
29454	80	285	24	13450	0	13839
29455	69	107	20	13577	0	13773
29456	42	13950	22	330	0	14344
29457	78	278	21	14177	0	14554
29458	71	124	17	14830	0	15042
29459	34	14682	21	409	0	15146
29460	37	15213	29	178	0	15457
29461	62	393	39	15060	0	15554
29462	44	172	14961	349	0	15526
29463	37	15191	341	137	0	15706
29464	80	359	119	15154	0	15712
29465	60	174	15553	343	0	16130
29466	39	15688	363	176	0	16266
29467	15533	409	133	151	0	16226
29468	383	181	15415	84	0	16063
29469	15264	125	384	125	0	15898
29470	446	93	133	15212	0	15884
29471	200	88	82	15490	0	15860
29472	129	84	49	15655	0	15917
29473	71	95	15188	580	0	15934
29474	68	105	15042	242	0	15457
29475	14521	97	472	213	0	15303
29476	408	73	207	15038	0	15726
29477	152	84	15171	442	0	15849
29478	14800	88	403	235	0	15526
29479	455	76	177	14961	0	15669
29480	207	98	139	15154	0	15598
29481	188	81	86	15108	0	15463
29482	104	14900	95	568	0	15667
29483	131	398	84	14596	0	15209
29484	84	14507	57	511	0	15159
29485	72	15172	87	239	0	15570
29486	14724	504	89	219	0	15536
29487	13625	216	95	223	0	14159
29488	14643	132	93	159	0	15027
29489	553	14142	87	128	0	14910
29490	14179	423	71	175	0	14848
29491	14433	176	90	151	0	14850
29492	580	135	84	13994	0	14793
29493	278	98	74	14282	0	14732
29494	167	85	13796	609	0	14657
29495	116	14001	413	319	0	14849
29496	13680	447	161	220	0	14508
29497	13867	208	121	211	0	14407
29498	506	13703	101	143	0	14453
29499	13686	454	82	181	0	14403
29500	13801	199	60	189	0	14249
29501	578	145	78	13417	0	14218
29502	309	12966	78	438	0	13791
29503	212	13669	77	219	0	14177
29504	13179	505	56	237	0	13977
29505	501	267	54	12925	0	13747
29506	233	164	12709	497	0	13603
29507	12465	146	389	292	0	13292
29508	466	110	13037	232	0	13845
29509	207	12736	439	203	0	13585
29510	12774	433	184	205	0	13596
29511	504	228	12676	160	0	13568
29512	260	216	434	12847	0	13757
29513	212	157	13066	504	0	13939
29514	176	13140	473	251	0	14040
29515	170	473	187	13249	0	14079
29516	162	270	13034	504	0	13970
29517	12440	184	422	309	0	13355
29518	448	13323	183	237	0	14191
29519	273	441	151	12819	0	13684
29520	200	13445	154	438	0	14237
29521	13302	521	98	255	0	14176
29522	13331	236	123	259	0	13949
29523	539	13216	119	205	0	14079
29524	327	465	110	13030	0	13932
29525	203	13352	160	473	0	14188
29526	13340	473	142	300	0	14255
29527	458	253	13164	222	0	14097
29528	256	217	13078	196	0	13747
29529	206	12839	493	184	0	13722
29530	172	13012	277	144	0	13605
29531	185	508	183	12525	0	13401
29532	12450	267	113	456	0	13286
29533	12720	179	117	280	0	13296
29534	12519	162	97	209	0	12987
29535	593	12724	104	174	0	13595
29536	314	401	103	12554	0	13372
29537	233	12840	98	414	0	13585
29538	12873	444	103	249	0	13669
29539	492	226	91	12748	0	13557
29540	284	148	12376	420	0	13228
29541	200	12386	370	234	0	13190
29542	12295	383	196	166	0	13040
29543	464	215	12194	144	0	13017
29544	12059	186	334	184	0	12763
29545	471	11974	169	166	0	12780
29546	195	10739	60	94	0	11088
29547	10350	297	79	92	0	10818
29548	280	10679	42	95	0	11096
29549	10189	236	36	83	0	10544
29550	215	10202	48	57	0	10522
29551	10310	221	46	59	0	10636
29552	10344	111	54	40	0	10549
29553	275	72	10353	42	0	10742
29554	145	69	9902	24	0	10140
29555	94	10042	167	34	0	10337
29556	9672	141	103	48	0	9964
29557	141	86	9309	28	0	9564
29558	8707	56	99	25	0	8887
29559	125	60	47	8642	0	8874
29560	48	33	8902	80	0	9063
29561	36	18	8422	38	0	8514
29562	38	25	8984	17	0	9064
29563	18	8969	90	19	0	9096
29564	89	178	91	8596	0	8954
29565	8434	16	20	47	0	8517
29566	42	8	6	8528	0	8584
29567	8574	6	5	44	0	8629
29568	49	2	12	8579	0	8642
29569	8757	6	5	67	0	8835
29570	8782	10	7	63	0	8862
29571	9792	5	8	33	0	9838
29572	90	9968	10	5	0	10073
29573	43	94	9979	2	0	10118
29574	23	34	92	10035	0	10184
29575	242	93	138	5497	0	5970
29576	20	18	12	10460	0	10510
29577	24	13	10	10209	0	10256
29578	15	10075	12	168	0	10270
29579	17	110	9945	58	0	10130
29580	11	10173	120	31	0	10335
29581	45	126	37	9718	0	9926
29582	17	50	15	10421	0	10503
29583	21	19	17	10461	0	10518
29584	24	15	9	10389	0	10437
29585	9	10095	12	178	0	10294
29586	8	10332	25	67	0	10432
29587	11	157	10237	42	0	10447
29588	19	58	119	10311	0	10507
29589	16	25	46	10499	0	10586
29590	18	25	13	10743	0	10799
29591	10850	27	14	225	0	11116
29592	128	10878	21	79	0	11106
29593	56	149	10831	42	0	11078
29594	10885	49	134	58	0	11126
29595	151	28	50	11104	0	11333
29596	11411	24	18	200	0	11653
29597	154	20	19	11529	0	11722
29598	11567	28	10	188	0	11793
29599	169	40	12	11529	0	11750
29600	11424	20	31	187	0	11662
29601	174	20	11503	78	0	11775
29602	88	22	127	11459	0	11696
29603	52	11671	55	156	0	11934
29604	68	144	16	11913	0	12141
29605	11839	65	21	183	0	12108
29606	165	11725	29	76	0	11995
29607	92	163	18	12310	0	12583
29608	44	12005	27	188	0	12264
29609	49	178	22	12238	0	12487
29610	42	84	13	12338	0	12477
29611	39	41	12058	260	0	12398
29612	59	40	165	11763	0	12027
29613	42	39	11634	217	0	11932
29614	31	11459	204	103	0	11797
29615	11522	187	79	81	0	11869
29616	177	77	11492	67	0	11813
29617	11297	41	191	92	0	11621
29618	12070	31	78	77	0	12256
29619	249	48	50	12152	0	12499
29620	80	28	12668	227	0	13003
29621	12380	44	213	124	0	12761
29622	13541	27	82	96	0	13746
29623	317	16	59	13341	0	13733
29624	149	21	50	13489	0	13709
29625	71	13479	34	337	0	13921
29626	71	237	40	13497	0	13845
29627	41	13574	47	278	0	13940
29628	70	243	13487	141	0	13941
29629	48	130	229	13426	0	13833
29630	13258	44	84	312	0	13698
29631	13514	47	31	137	0	13729
29632	284	13307	35	116	0	13742
29633	126	221	32	13428	0	13807
29634	13408	94	33	293	0	13828
29635	266	12885	23	160	0	13334
29636	13145	241	13	113	0	13512
29637	295	98	17	13527	0	13937
29638	14200	72	18	303	0	14593
29639	295	74	15508	127	0	16004
29640	126	15691	318	100	0	16235
29641	15685	312	111	121	0	16229
29642	342	16256	63	89	0	16750
29643	16507	366	43	93	0	17009
29644	16990	144	24	101	0	17259
29645	497	111	16608	54	0	17270
29646	242	69	344	16460	0	17115
29647	17042	64	116	397	0	17619
29648	425	69	16588	141	0	17223
29649	16713	59	364	122	0	17258
29650	485	57	120	16710	0	17372
29651	214	42	16683	399	0	17338
29652	143	58	395	16557	0	17153
29653	16311	59	142	462	0	16974
29654	455	58	16563	178	0	17254
29655	229	59	386	16616	0	17290
29656	197	36	131	16979	0	17343
29657	16941	23	111	527	0	17602
29658	16977	34	115	252	0	17378
29659	503	16865	74	173	0	17615
29660	270	360	76	16870	0	17576
29661	196	127	76	17057	0	17456
29662	164	85	63	16943	0	17255
29663	16545	60	68	586	0	17259
29664	16751	50	83	270	0	17154
29665	574	62	59	16428	0	17123
29666	295	16074	67	450	0	16886
29667	223	390	81	16049	0	16743
29668	175	16387	49	474	0	17085
29669	16148	396	46	279	0	16869
29670	476	15859	79	176	0	16590
29671	15074	352	65	160	0	15651
29672	474	150	62	14893	0	15579
29673	14913	95	102	404	0	15514
29674	442	75	14649	227	0	15393
29675	256	14990	303	197	0	15746
29676	14965	307	180	174	0	15626
29677	15132	140	115	155	0	15542
29678	472	117	72	14657	0	15318
29679	236	14605	88	373	0	15302
29680	205	281	73	15232	0	15791
29681	196	135	65	15301	0	15697
29682	191	97	73	15308	0	15669
29683	15116	71	58	510	0	15755
29684	15263	82	68	303	0	15716
29685	496	88	46	14963	0	15593
29686	275	14965	58	417	0	15715
29687	15201	322	49	261	0	15833
29688	431	145	14878	213	0	15667
29689	277	126	261	15116	0	15780
29690	217	92	14996	443	0	15748
29691	212	105	283	14910	0	15510
29692	181	95	14996	464	0	15736
29693	182	88	312	14930	0	15512
29694	14945	106	134	468	0	15653
29695	15115	89	82	271	0	15557
29696	489	14621	87	170	0	15367
29697	15265	316	69	243	0	15893
29698	457	172	57	15180	0	15866
29699	295	126	76	15568	0	16065
29700	15522	111	80	500	0	16213
29701	451	105	15061	274	0	15891
29702	284	84	14915	221	0	15504
29703	261	100	14980	194	0	15535
29704	14911	103	385	223	0	15622
29705	463	87	15461	181	0	16192
29706	284	77	14839	209	0	15409
29707	14493	90	356	211	0	15150
29708	397	15351	166	188	0	16102
29709	275	264	142	15729	0	16410
29710	222	104	117	16067	0	16510
29711	187	107	15912	452	0	16658
29712	15731	72	309	294	0	16406
29713	16028	66	184	242	0	16520
29714	15472	71	158	243	0	15944
29715	458	74	15943	169	0	16644
29716	15403	65	313	206	0	15987
29717	430	64	15384	196	0	16074
29718	231	15015	324	183	0	15753
29719	236	15310	150	201	0	15897
29720	14661	274	127	166	0	15228
29721	329	14278	115	184	0	14906
29722	214	14184	104	149	0	14651
29723	14061	227	95	175	0	14558
29724	301	13985	102	149	0	14537
29725	14041	243	85	145	0	14514
29726	356	120	81	14038	0	14595
29727	203	108	97	14175	0	14583
29728	197	81	105	14233	0	14616
29729	172	92	101	14025	0	14390
29730	151	13878	136	325	0	14490
29731	13990	227	122	201	0	14540
29732	326	14523	113	139	0	15101
29733	228	15041	120	201	0	15590
29734	214	344	15258	118	0	15934
29735	14599	126	341	181	0	15247
29736	406	116	15943	109	0	16574
29737	252	84	16489	111	0	16936
29738	161	16155	381	111	0	16808
29739	69	16289	164	77	0	16599
29740	16816	388	130	115	0	17449
29741	374	17857	65	84	0	18380
29742	168	417	17533	32	0	18150
29743	79	17254	399	47	0	17779
29744	85	420	17333	23	0	17861
29745	78	179	16969	23	0	17249
29746	16373	130	532	42	0	17077
29747	368	101	16943	29	0	17441
29748	177	84	472	16361	0	17094
29749	16380	49	253	378	0	17060
29750	365	16231	178	146	0	16920
29751	172	351	16419	78	0	17020
29752	16147	123	442	96	0	16808
29753	459	67	188	15820	0	16534
29754	209	15486	122	344	0	16161
29755	118	371	15903	139	0	16531
29756	15476	145	430	111	0	16162
29757	432	87	16043	53	0	16615
29758	223	76	442	15713	0	16454
29759	110	59	15830	366	0	16365
29760	121	35	480	15660	0	16296
29761	15496	43	210	462	0	16211
29762	359	15706	171	189	0	16425
29763	15904	365	114	149	0	16532
29764	449	146	15788	87	0	16470
29765	257	78	416	16022	0	16773
29766	134	80	16332	411	0	16957
29767	15869	76	463	212	0	16620
29768	16487	46	206	125	0	16864
29769	530	16320	158	76	0	17084
29770	16547	393	114	93	0	17147
29771	16835	155	119	77	0	17186
29772	663	86	74	16228	0	17051
29773	292	86	16221	410	0	17009
29774	205	15678	426	170	0	16479
29775	226	398	168	15861	0	16653
29776	15938	181	106	463	0	16688
29777	478	124	15693	204	0	16499
29778	225	101	15814	112	0	16252
29779	154	76	15600	115	0	15945
29780	15119	68	610	117	0	15914
29781	489	83	15517	49	0	16138
29782	15026	68	591	77	0	15762
29783	522	62	14675	48	0	15307
29784	278	14963	549	48	0	15838
29785	207	393	298	14877	0	15775
29786	160	163	15049	406	0	15778
29787	136	14532	539	173	0	15380
29788	107	15036	247	119	0	15509
29789	128	559	166	14794	0	15647
29790	14653	240	159	463	0	15515
29791	432	169	165	14754	0	15520
29792	14428	159	122	502	0	15211
29793	510	133	112	14477	0	15232
29794	290	100	14287	505	0	15182
29795	201	106	14266	246	0	14819
29796	13757	82	585	212	0	14636
29797	13899	73	315	173	0	14460
29798	609	68	13498	152	0	14327
29799	13184	75	560	127	0	13946
29800	566	93	13318	85	0	14062
29801	333	12531	565	92	0	13521
29802	251	12744	320	67	0	13382
29803	220	12808	234	91	0	13353
29804	236	567	223	12416	0	13442
29805	12328	274	180	460	0	13242
29806	12576	214	159	207	0	13156
29807	639	178	137	12209	0	13163
29808	335	165	11473	467	0	12440
29809	250	128	496	11474	0	12348
29810	249	117	11414	494	0	12274
29811	216	79	548	11224	0	12067
29812	11048	55	332	583	0	12018
29813	11395	58	250	288	0	11991
29814	11415	77	218	225	0	11935
29815	11465	88	201	186	0	11940
29816	737	80	162	10898	0	11877
29817	413	67	162	11263	0	11905
29818	11036	54	154	612	0	11856
29819	11383	62	121	295	0	11861
29820	755	57	118	10939	0	11869
29821	415	65	107	11235	0	11822
29822	286	60	122	11200	0	11668
29823	260	55	125	11279	0	11719
29824	10747	58	111	742	0	11658
29825	547	57	10468	439	0	11511
29826	331	62	461	10550	0	11404
29827	10486	69	209	616	0	11380
29828	571	60	10232	363	0	11226
29829	358	61	456	10399	0	11274
29830	265	49	10361	570	0	11245
29831	222	9865	535	323	0	10945
29832	288	397	302	9142	0	10129
29833	8735	135	210	457	0	9537
29834	427	225	197	8038	0	8887
29835	260	7680	172	460	0	8572
29836	193	7361	141	248	0	7943
29837	158	5978	109	145	0	6390
29838	162	5596	96	140	0	5994
29839	2894	469	360	327	0	4050
29840	233	173	107	2009	0	2522
29841	48	11	1530	87	0	1676
29842	26	13	68	1391	0	1498
29843	33	8	1365	73	0	1479
29844	1356	7	62	37	0	1462
29845	77	9	22	1350	0	1458
29846	35	5	23	1400	0	1463
29847	33	10	20	1386	0	1449
29848	24	13	17	1400	0	1454
29849	1334	22	12	67	0	1435
29850	1371	20	9	31	0	1431
29851	74	18	9	1308	0	1409
29852	1272	17	5	68	0	1362
29853	55	11	1243	39	0	1348
29854	24	1227	44	43	0	1338
29855	28	35	27	1254	0	1344
29856	23	11	23	1254	0	1311
29857	16	1219	21	64	0	1320
29858	26	42	9	1228	0	1305
29859	16	32	15	1247	0	1310
29860	1210	3	19	85	0	1317
29861	51	6	1175	38	0	1270
29862	26	6	1114	34	0	1180
29863	1083	4	44	31	0	1162
29864	64	2	1045	14	0	1125
29865	542	3	76	12	0	633
29866	446	1	24	5	0	476
29867	28	11	12	331	0	382
29868	4	3	254	12	0	273
29869	183	4	5	3	0	195
29870	8	182	1	1	0	192
29871	77	10	18	1	0	106
29872	76	4	4	2	0	86
29873	94	4	4	1	0	103
29874	300	0	0	0	0	300
29875	296	0	1	1	0	298
29876	300	0	0	0	0	300
29877	320	0	0	0	0	320
29878	319	0	0	0	0	319
29879	318	0	0	0	0	318
29880	319	0	0	0	0	319
29881	317	0	0	0	0	317
29882	309	0	0	0	0	309
29883	302	0	0	0	0	302
29884	244	0	0	0	0	244
29885	188	0	0	0	0	188
29886	271	0	0	0	0	271
29887	308	0	0	0	0	308
29888	311	0	0	0	0	311
29889	286	0	0	0	0	286
29890	298	0	0	0	0	298
29891	317	0	0	0	0	317
29892	319	0	0	0	0	319
29893	318	0	0	0	0	318
29894	313	0	0	0	0	313
29895	316	0	0	0	0	316
29896	316	0	0	0	0	316
29897	313	0	0	0	0	313
29898	319	0	0	0	0	319
29899	313	0	0	0	0	313
29900	303	0	0	0	0	303
29901	292	0	0	0	0	292
29902	258	0	5	0	0	263
29903	239	1	20	0	0	260
