Pos	A	C	G	T	Other	Total
1	0	0	0	0	0	0
2	0	0	0	0	0	0
3	0	0	0	0	0	0
4	0	0	0	0	0	0
5	0	0	0	0	0	0
6	0	0	0	0	0	0
7	0	0	0	0	0	0
8	0	0	0	0	0	0
9	0	0	0	0	0	0
10	0	0	0	0	0	0
11	0	0	0	0	0	0
12	3	0	0	0	0	3
13	0	0	0	6	0	6
14	25	0	0	2	0	27
15	0	36	0	0	0	36
16	0	86	0	0	0	86
17	0	0	0	222	0	222
18	1	0	0	222	0	223
19	0	281	0	0	0	281
20	0	284	0	0	0	284
21	0	313	0	0	0	313
22	316	0	0	0	0	316
23	0	1	324	0	0	325
24	0	0	328	0	0	328
25	0	0	0	360	0	360
26	379	0	0	0	0	379
27	381	0	0	0	0	381
28	0	381	0	0	0	381
29	482	0	0	5	0	487
30	518	0	0	5	0	523
31	544	0	0	0	0	544
32	0	555	0	0	0	555
33	0	565	0	0	0	565
34	571	0	0	1	0	572
35	566	0	0	3	0	569
36	0	576	0	1	0	577
37	0	616	0	0	0	616
38	619	0	0	1	0	620
39	617	0	0	0	0	617
40	0	621	0	0	0	621
41	0	0	0	671	0	671
42	1	0	0	676	0	677
43	0	0	0	667	0	667
44	0	663	0	0	0	663
45	0	0	668	0	0	668
46	603	0	0	1	0	604
47	0	0	0	679	0	679
48	0	680	0	0	0	680
49	0	0	0	690	0	690
50	0	686	0	0	0	686
51	0	0	0	695	0	695
52	1	0	0	697	0	698
53	0	0	708	0	0	708
54	0	0	0	696	0	696
55	699	0	0	2	0	701
56	1	0	700	0	0	701
57	690	0	0	0	0	690
58	1	0	0	713	0	714
59	0	727	0	0	0	727
60	0	0	0	736	0	736
61	0	0	741	0	0	741
62	1	0	0	731	0	732
63	0	0	0	736	0	736
64	0	761	0	2	0	763
65	0	0	0	767	0	767
66	0	766	0	0	0	766
67	0	0	0	769	0	769
68	763	0	0	0	0	763
69	753	0	0	0	0	753
70	745	0	0	0	0	745
71	0	763	1	6	0	770
72	1	0	756	1	0	758
73	752	0	0	0	0	752
74	797	0	0	0	0	797
75	2	814	1	0	0	817
76	1	2	0	752	0	755
77	1	0	0	770	0	771
78	1	1	0	722	0	724
79	713	0	0	12	0	725
80	724	1	0	4	0	729
81	723	0	0	4	0	727
82	744	0	0	3	0	747
83	8	0	0	730	0	738
84	3	723	0	6	0	732
85	2	5	0	737	0	744
86	1	1	742	7	0	751
87	2	1	6	783	0	792
88	0	0	805	13	0	818
89	0	1	12	792	0	805
90	0	0	814	12	0	826
91	0	0	846	1	0	847
92	0	865	17	2	0	884
93	2	17	2	888	0	909
94	1	1	914	16	0	932
95	0	1	19	906	0	926
96	0	933	2	18	0	953
97	937	19	1	1	0	958
98	18	964	0	2	0	984
99	3	19	1	956	0	979
100	2	981	0	17	0	1000
101	0	20	960	2	0	982
102	1	3	954	2	0	960
103	0	969	19	4	0	992
104	0	17	3	971	0	991
105	0	2	991	17	0	1010
106	0	973	20	7	0	1000
107	987	18	3	2	0	1010
108	19	3	3	982	0	1007
109	1	3	1001	19	0	1024
110	1	993	18	2	0	1014
111	0	20	3	997	0	1020
112	4	1	2	1008	0	1015
113	981	3	0	23	0	1007
114	19	1	988	1	0	1009
115	3	2	17	970	0	992
116	1	2	942	18	0	963
117	0	864	19	4	0	887
118	839	18	4	4	0	865
119	17	825	4	1	0	847
120	2	19	2	801	0	824
121	2	810	2	14	0	828
122	784	21	2	3	0	810
123	20	812	1	5	0	838
124	2	22	802	1	0	827
125	2	794	17	3	0	816
126	766	21	3	1	0	791
127	19	3	787	1	0	810
128	5	3	19	784	0	811
129	710	1	5	19	0	735
130	20	5	1	682	0	708
131	690	0	1	23	0	714
132	712	2	3	6	0	723
133	22	0	3	708	0	733
134	3	5	1	717	0	726
135	698	1	0	24	0	723
136	700	4	2	4	0	710
137	24	1	0	672	0	697
138	668	5	1	24	0	698
139	689	2	1	2	0	694
140	22	679	4	2	0	707
141	4	22	2	659	0	687
142	659	4	2	22	0	687
143	686	4	4	2	0	696
144	30	1	3	655	0	689
145	4	5	2	686	0	697
146	664	0	1	29	0	694
147	22	671	3	5	0	701
148	5	22	1	670	0	698
149	7	3	674	22	0	706
150	6	4	20	652	0	682
151	6	671	5	22	0	704
152	4	23	672	4	0	703
153	6	3	20	660	0	689
154	2	2	4	661	0	669
155	8	2	667	24	0	701
156	640	2	23	9	0	674
157	23	703	4	8	0	738
158	701	22	4	8	0	735
159	23	5	682	7	0	717
160	8	4	702	3	0	717
161	660	6	23	3	0	692
162	24	690	4	7	0	725
163	688	24	3	8	0	723
164	25	692	5	4	0	726
165	1	25	695	7	0	728
166	673	4	23	6	0	706
167	25	4	694	4	0	727
168	7	2	21	704	0	734
169	697	5	6	23	0	731
170	705	3	6	5	0	719
171	25	681	5	4	0	715
172	3	42	5	653	0	703
173	7	668	4	20	0	699
174	6	18	653	3	0	680
175	5	11	22	608	0	646
176	6	601	8	20	0	635
177	6	16	3	567	0	592
178	540	2	4	14	0	560
179	16	5	3	558	0	582
180	5	552	4	19	0	580
181	5	17	1	565	0	588
182	11	4	2	569	0	586
183	3	557	5	18	0	583
184	6	14	3	559	0	582
185	5	3	563	17	0	588
186	4	561	15	5	0	585
187	499	9	2	6	0	516
188	12	5	493	3	0	513
189	4	3	485	2	0	494
190	3	488	9	7	0	507
191	9	6	12	427	0	454
192	5	1	416	6	0	428
193	4	363	3	2	0	372
194	3	3	0	387	0	393
195	1	3	1	394	0	399
196	370	0	1	7	0	378
197	3	376	1	2	0	382
198	1	3	347	3	0	354
199	3	0	344	3	0	350
200	2	2	4	338	0	346
201	3	3	1	393	0	400
202	2	3	2	398	0	405
203	2	481	1	11	0	495
204	1	7	507	6	0	521
205	0	11	8	541	0	560
206	2	594	7	13	0	616
207	1	631	3	9	0	644
208	2	18	665	4	0	689
209	3	11	11	655	0	680
210	1	5	766	12	0	784
211	3	4	15	752	0	774
212	0	2	16	763	0	781
213	1	1	771	29	0	802
214	1	749	16	17	0	783
215	748	15	14	6	0	783
216	14	14	771	5	0	804
217	13	766	18	3	0	800
218	4	791	15	5	0	815
219	5	28	774	3	0	810
220	758	18	19	2	0	797
221	14	10	14	712	0	750
222	16	788	5	22	0	831
223	783	15	9	13	0	820
224	16	16	2	760	0	794
225	13	785	4	19	0	821
226	785	18	4	14	0	821
227	20	16	768	5	0	809
228	16	779	22	2	0	819
229	764	17	17	4	0	802
230	17	776	7	3	0	803
231	758	19	4	4	0	785
232	15	21	5	721	0	762
233	18	732	5	15	0	770
234	3	18	6	750	0	777
235	730	18	6	23	0	777
236	16	5	732	20	0	773
237	17	6	723	18	0	764
238	5	5	29	713	0	752
239	7	6	22	713	0	748
240	6	8	9	693	0	716
241	4	698	8	29	0	739
242	7	23	685	16	0	731
243	11	22	15	668	0	716
244	7	667	17	19	0	710
245	7	703	6	20	0	736
246	14	29	690	7	0	740
247	6	22	689	8	0	725
248	9	18	706	4	0	737
249	12	8	33	671	0	724
250	8	13	699	18	0	738
251	12	7	20	684	0	723
252	10	9	689	24	0	732
253	656	12	20	24	0	712
254	19	693	18	15	0	745
255	26	735	9	7	0	777
256	7	36	755	7	0	805
257	710	23	26	8	0	767
258	733	9	16	15	0	773
259	746	8	11	14	0	779
260	35	6	699	18	0	758
261	24	13	718	7	0	762
262	8	4	46	710	0	768
263	701	5	28	32	0	766
264	702	13	13	23	0	751
265	31	14	689	13	0	747
266	700	6	34	11	0	751
267	22	10	31	687	0	750
268	17	9	703	23	0	752
269	5	11	709	28	0	753
270	671	8	46	11	0	736
271	20	10	711	16	0	757
272	692	11	40	3	0	746
273	31	6	706	7	0	750
274	21	666	35	12	0	734
275	8	703	33	15	0	759
276	9	37	29	677	0	752
277	19	25	11	714	0	769
278	17	5	700	41	0	763
279	19	11	30	677	0	737
280	14	654	31	29	0	728
281	18	682	25	19	0	744
282	10	713	24	13	0	760
283	25	43	10	683	0	761
284	23	23	692	23	0	761
285	24	14	698	16	0	752
286	23	10	38	675	0	746
287	11	14	30	692	0	747
288	21	12	25	663	0	721
289	24	654	18	39	0	735
290	672	23	15	30	0	740
291	679	27	20	9	0	735
292	53	659	17	10	0	739
293	26	32	685	9	0	752
294	687	30	27	11	0	755
295	31	22	689	8	0	750
296	683	14	29	16	0	742
297	693	7	28	20	0	748
298	703	11	21	13	0	748
299	682	15	16	22	0	735
300	39	684	15	14	0	752
301	623	31	9	19	0	682
302	18	640	15	16	0	689
303	523	20	10	19	0	572
304	22	509	15	12	0	558
305	10	12	428	13	0	463
306	3	55	20	342	0	420
307	4	370	12	21	0	407
308	4	346	4	21	0	375
309	301	33	7	15	0	356
310	262	3	5	1	0	271
311	16	268	1	3	0	288
312	7	16	6	245	0	274
313	7	278	7	4	0	296
314	289	11	2	2	0	304
315	13	2	292	2	0	309
316	16	6	10	261	0	293
317	11	1	5	264	0	281
318	12	1	4	270	0	287
319	11	3	263	10	0	287
320	8	261	9	5	0	283
321	10	279	4	1	0	294
322	7	10	1	263	0	281
323	4	3	264	9	0	280
324	1	9	7	252	0	269
325	3	2	9	269	0	283
326	7	4	2	271	0	284
327	4	4	4	263	0	275
328	264	1	1	10	0	276
329	7	261	3	5	0	276
330	257	11	5	4	0	277
331	10	6	257	5	0	278
332	6	7	264	1	0	278
333	7	4	8	253	0	272
334	1	3	9	257	0	270
335	6	258	2	10	0	276
336	2	11	253	9	0	275
337	1	266	14	7	0	288
338	1	11	276	7	0	295
339	256	7	7	5	0	275
340	6	275	7	5	0	293
341	7	8	276	2	0	293
342	4	3	12	271	0	290
343	2	9	281	9	0	301
344	2	275	7	8	0	292
345	1	9	5	264	0	279
346	8	274	1	12	0	295
347	3	9	282	2	0	296
348	4	4	7	277	0	292
349	273	5	3	8	0	289
350	12	272	3	3	0	290
351	1	8	266	3	0	278
352	7	3	6	250	0	266
353	5	3	261	6	0	275
354	1	4	232	0	0	237
355	3	209	2	2	0	216
356	0	4	2	178	0	184
357	1	0	2	178	0	181
358	1	0	1	188	0	190
359	1	2	201	1	0	205
360	1	1	200	1	0	203
361	187	0	3	1	0	191
362	4	1	193	0	0	198
363	182	3	2	2	0	189
364	2	191	0	2	0	195
365	0	8	1	185	0	194
366	2	186	1	3	0	192
367	0	197	1	1	0	199
368	1	2	185	1	0	189
369	0	1	3	182	0	186
370	0	0	183	4	0	187
371	0	0	170	1	0	171
372	172	1	4	1	0	178
373	2	2	185	0	0	189
374	0	1	177	2	0	180
375	177	0	3	1	0	181
376	2	0	184	3	0	189
377	0	0	182	2	0	184
378	0	0	3	180	0	183
379	1	182	1	2	0	186
380	2	2	1	183	0	188
381	1	2	1	178	0	182
382	184	0	0	1	0	185
383	2	1	2	180	0	185
384	0	184	1	4	0	189
385	180	4	0	2	0	186
386	2	1	183	2	0	188
387	170	1	4	1	0	176
388	2	1	194	1	0	198
389	0	0	193	0	0	193
390	1	208	3	0	0	212
391	213	4	2	0	0	219
392	4	216	1	1	0	222
393	3	4	221	1	0	229
394	1	0	4	200	0	205
395	1	226	2	6	0	235
396	229	4	1	0	0	234
397	231	3	0	1	0	235
398	5	244	1	1	0	251
399	245	5	1	2	0	253
400	6	1	1	234	0	242
401	2	259	0	5	0	266
402	1	6	0	262	0	269
403	1	4	0	268	0	273
404	281	0	2	5	0	288
405	275	2	1	1	0	279
406	272	1	3	0	0	276
407	7	0	270	2	0	279
408	251	1	6	1	0	259
409	7	6	1	253	0	267
410	2	1	263	6	0	272
411	1	1	257	0	0	259
412	1	267	7	0	0	275
413	242	5	3	1	0	251
414	4	247	0	1	0	252
415	0	4	1	238	0	243
416	0	0	1	252	0	253
417	1	1	247	3	0	252
418	2	0	3	231	0	236
419	0	1	243	4	0	248
420	0	0	243	1	0	244
421	1	242	4	1	0	248
422	0	4	1	242	0	247
423	0	0	1	245	0	246
424	243	0	2	3	0	248
425	4	1	234	0	0	239
426	1	1	4	242	0	248
427	243	1	0	5	0	249
428	4	0	240	2	0	246
429	246	0	4	1	0	251
430	253	0	2	0	0	255
431	4	0	273	2	0	279
432	1	0	5	275	0	281
433	0	1	2	276	0	279
434	3	1	288	2	0	294
435	285	0	4	3	0	292
436	294	1	1	2	0	298
437	277	0	0	2	0	279
438	278	0	1	2	0	281
439	280	0	1	1	0	282
440	7	1	249	0	0	257
441	2	0	274	1	0	277
442	1	284	5	1	0	291
443	3	4	276	6	0	289
444	1	0	5	276	0	282
445	2	1	4	214	0	221
446	0	1	2	281	0	284
447	1	2	1	284	0	288
448	3	0	283	4	0	290
449	1	272	4	1	0	278
450	1	299	0	2	0	302
451	1	4	0	288	0	293
452	2	301	1	4	0	308
453	303	4	2	2	0	311
454	299	1	1	1	0	302
455	5	307	1	0	0	313
456	1	5	1	306	0	313
457	1	1	0	313	0	315
458	1	0	303	6	0	310
459	272	0	4	1	0	277
460	302	1	1	3	0	307
461	5	306	2	2	0	315
462	301	6	1	1	0	309
463	5	3	322	0	0	330
464	4	312	5	1	0	322
465	3	344	0	0	0	347
466	1	349	1	1	0	352
467	2	5	0	339	0	346
468	331	0	2	7	0	340
469	6	1	1	340	0	348
470	3	1	364	6	0	374
471	3	1	6	362	0	372
472	2	1	393	8	0	404
473	6	0	6	373	0	385
474	3	1	2	374	0	380
475	4	392	3	4	0	403
476	402	6	4	2	0	414
477	7	4	2	394	0	407
478	1	415	2	9	0	427
479	416	9	2	4	0	431
480	360	2	1	3	0	366
481	423	2	0	3	0	428
482	7	413	3	4	0	427
483	0	8	423	3	0	434
484	1	2	7	424	0	434
485	2	4	2	395	0	403
486	2	415	2	8	0	427
487	2	8	412	3	0	425
488	2	2	406	1	0	411
489	398	2	7	3	0	410
490	6	8	1	384	0	399
491	1	0	405	7	0	413
492	2	409	6	2	0	419
493	2	4	2	384	0	392
494	5	401	2	4	0	412
495	2	5	396	2	0	405
496	372	1	5	1	0	379
497	384	1	4	1	0	390
498	5	388	2	0	0	395
499	3	3	0	383	0	389
500	2	0	385	4	0	391
501	1	362	5	1	0	369
502	367	4	1	3	0	375
503	4	358	1	2	0	365
504	0	357	1	1	0	359
505	1	5	1	346	0	353
506	1	354	2	2	0	359
507	356	3	0	1	0	360
508	3	1	0	357	0	361
509	0	2	352	3	0	357
510	1	0	337	2	0	340
511	1	1	3	340	0	345
512	1	336	1	5	0	343
513	343	3	1	0	0	347
514	3	2	0	339	0	344
515	0	2	351	3	0	356
516	1	0	3	347	0	351
517	1	1	0	352	0	354
518	352	0	1	4	0	357
519	3	0	1	347	0	351
520	0	0	336	3	0	339
521	2	0	333	1	0	336
522	0	1	2	338	0	341
523	1	1	1	333	0	336
524	1	0	350	3	0	354
525	310	0	3	2	0	315
526	2	0	345	2	0	349
527	0	341	3	2	0	346
528	5	1	0	355	0	361
529	1	0	348	3	0	352
530	0	1	341	0	0	342
531	0	1	4	319	0	324
532	329	0	2	4	0	335
533	2	0	348	2	0	352
534	0	338	3	2	0	343
535	340	2	1	0	0	343
536	3	0	352	0	0	355
537	331	2	3	1	0	337
538	356	1	0	1	0	358
539	2	373	2	0	0	377
540	1	2	2	348	0	353
541	2	352	1	3	0	358
542	1	3	355	0	0	359
543	349	0	3	0	0	352
544	363	2	1	0	0	366
545	4	1	369	0	0	374
546	2	0	358	0	0	360
547	2	373	3	0	0	378
548	376	3	1	0	0	380
549	5	1	1	381	0	388
550	1	1	0	367	0	369
551	1	376	0	3	0	380
552	364	4	1	1	0	370
553	4	0	374	1	0	379
554	2	1	3	388	0	394
555	426	0	1	7	0	434
556	6	428	3	0	0	437
557	0	13	508	1	0	522
558	3	1	527	0	0	531
559	1	2	9	491	0	503
560	0	518	3	8	0	529
561	0	9	515	2	0	526
562	1	2	8	512	0	523
563	505	2	1	8	0	516
564	8	0	513	2	0	523
565	3	0	8	521	0	532
566	3	1	534	8	0	546
567	0	1	556	1	0	558
568	5	4	12	548	0	569
569	0	0	566	10	0	576
570	450	1	13	1	0	465
571	8	1	537	3	0	549
572	487	0	11	2	0	500
573	12	518	1	1	0	532
574	548	8	4	3	0	563
575	10	547	1	1	0	559
576	1	11	1	533	0	546
577	5	0	3	552	0	560
578	1	3	530	11	0	545
579	0	2	534	4	0	540
580	2	0	11	536	0	549
581	1	0	560	10	0	571
582	4	0	12	530	0	546
583	0	540	5	7	0	552
584	2	569	8	2	0	581
585	1	13	2	562	0	578
586	3	5	1	567	0	576
587	0	4	562	13	0	579
588	1	0	10	541	0	552
589	2	547	4	12	0	565
590	1	555	10	1	0	567
591	1	549	3	6	0	559
592	0	11	3	518	0	532
593	2	520	5	9	0	536
594	515	13	1	5	0	534
595	10	3	4	520	0	537
596	3	5	514	11	0	533
597	3	1	10	503	0	517
598	4	2	526	13	0	545
599	1	4	535	3	0	543
600	4	0	543	6	0	553
601	1	545	14	3	0	563
602	1	13	546	2	0	562
603	530	3	12	7	0	552
604	543	2	7	5	0	557
605	567	2	9	2	0	580
606	15	2	3	558	0	578
607	555	2	5	14	0	576
608	13	548	4	4	0	569
609	3	579	3	7	0	592
610	576	16	1	2	0	595
611	11	5	600	2	0	618
612	4	2	11	593	0	610
613	4	5	604	12	0	625
614	0	3	600	5	0	608
615	1	588	14	7	0	610
616	2	12	5	559	0	578
617	4	4	6	604	0	618
618	592	3	2	19	0	616
619	11	587	5	7	0	610
620	3	618	3	6	0	630
621	4	15	607	3	0	629
622	2	614	14	4	0	634
623	600	13	6	7	0	626
624	612	2	6	5	0	625
625	12	4	619	2	0	637
626	7	1	624	2	0	634
627	4	7	14	586	0	611
628	3	6	8	608	0	625
629	6	604	3	13	0	626
630	6	14	3	602	0	625
631	4	5	3	611	0	623
632	4	603	5	13	0	625
633	6	10	5	584	0	605
634	2	5	8	575	0	590
635	2	570	3	17	0	592
636	2	13	573	6	0	594
637	3	1	16	577	0	597
638	572	9	4	14	0	599
639	563	5	6	6	0	580
640	12	1	561	9	0	583
641	536	5	15	2	0	558
642	569	2	3	5	0	579
643	14	556	3	6	0	579
644	7	13	537	4	0	561
645	5	4	543	3	0	555
646	3	9	12	563	0	587
647	570	6	6	13	0	595
648	587	4	8	1	0	600
649	13	2	6	644	0	665
650	703	0	4	16	0	723
651	729	1	5	4	0	739
652	704	1	5	7	0	717
653	12	6	718	5	0	741
654	6	3	744	6	0	759
655	701	2	8	9	0	720
656	9	3	759	4	0	775
657	3	659	6	2	0	670
658	3	4	1	662	0	670
659	1	2	669	5	0	677
660	1	2	654	1	0	658
661	2	1	4	645	0	652
662	3	2	660	4	0	669
663	4	1	663	0	0	668
664	2	596	6	5	0	609
665	5	633	2	0	0	640
666	629	3	0	1	0	633
667	8	0	1	614	0	623
668	608	0	4	3	0	615
669	5	0	607	0	0	612
670	4	2	4	586	0	596
671	0	1	5	606	0	612
672	601	3	1	3	0	608
673	4	615	1	5	0	625
674	3	4	589	0	0	596
675	2	1	610	1	0	614
676	0	621	4	6	0	631
677	0	3	610	1	0	614
678	0	600	7	1	0	608
679	0	586	2	1	0	589
680	0	5	569	0	0	574
681	548	2	3	0	0	553
682	5	2	1	602	0	610
683	5	609	0	2	0	616
684	2	2	4	606	0	614
685	603	1	0	7	0	611
686	611	0	1	4	0	616
687	614	0	2	2	0	618
688	3	4	614	2	0	623
689	2	0	6	588	0	596
690	1	631	5	3	0	640
691	636	7	2	2	0	647
692	4	1	5	639	0	649
693	3	4	3	615	0	625
694	2	4	2	649	0	657
695	1	2	635	5	0	643
696	581	4	4	1	0	590
697	4	634	3	2	0	643
698	4	6	1	625	0	636
699	3	1	1	624	0	629
700	604	2	1	5	0	612
701	6	1	594	4	0	605
702	7	0	602	3	0	612
703	3	618	8	1	0	630
704	3	3	634	4	0	644
705	581	4	5	2	0	592
706	5	639	5	2	0	651
707	3	6	644	5	0	658
708	579	3	4	4	0	590
709	7	1	676	4	0	688
710	3	686	6	3	0	698
711	5	4	3	661	0	673
712	1	6	3	672	0	682
713	1	0	666	12	0	679
714	1	3	656	7	0	667
715	5	674	8	2	0	689
716	664	6	5	3	0	678
717	6	685	5	2	0	698
718	7	7	2	680	0	696
719	1	5	684	4	0	694
720	610	1	7	3	0	621
721	5	8	4	654	0	671
722	5	640	6	4	0	655
723	5	674	2	5	0	686
724	4	8	5	670	0	687
725	1	5	3	680	0	689
726	658	1	5	9	0	673
727	6	2	2	665	0	675
728	4	5	665	6	0	680
729	630	0	9	7	0	646
730	650	5	4	3	0	662
731	11	0	659	1	0	671
732	626	5	7	1	0	639
733	6	3	5	673	0	687
734	4	4	2	671	0	681
735	4	3	2	677	0	686
736	2	1	2	656	0	661
737	2	650	3	10	0	665
738	662	7	4	6	0	679
739	674	7	0	8	0	689
740	9	3	713	5	0	730
741	733	4	5	4	0	746
742	782	1	7	8	0	798
743	790	0	5	4	0	799
744	840	1	4	1	0	846
745	18	833	2	2	0	855
746	10	9	5	823	0	847
747	11	8	820	8	0	847
748	8	4	790	8	0	810
749	677	1	23	6	0	707
750	703	1	8	1	0	713
751	15	670	4	7	0	696
752	705	7	1	4	0	717
753	12	716	3	1	0	732
754	8	9	2	701	0	720
755	725	7	0	8	0	740
756	700	3	0	8	0	711
757	703	3	0	6	0	712
758	18	684	3	2	0	707
759	706	11	1	2	0	720
760	13	6	1	710	0	730
761	727	4	2	9	0	742
762	15	2	702	6	0	725
763	14	697	9	2	0	722
764	705	13	7	2	0	727
765	14	8	729	1	0	752
766	13	2	10	714	0	739
767	7	3	738	11	0	759
768	6	0	717	8	0	731
769	3	5	17	723	0	748
770	7	1	750	11	0	769
771	5	3	15	743	0	766
772	3	3	6	754	0	766
773	742	1	7	17	0	767
774	11	740	5	9	0	765
775	10	759	2	6	0	777
776	4	779	5	3	0	791
777	4	20	769	3	0	796
778	6	10	9	776	0	801
779	7	4	804	9	0	824
780	732	5	12	10	0	759
781	766	3	7	2	0	778
782	17	797	3	5	0	822
783	11	9	5	779	0	804
784	6	805	2	14	0	827
785	809	14	3	6	0	832
786	14	5	2	808	0	829
787	10	6	790	12	0	818
788	4	771	11	7	0	793
789	2	7	778	7	0	794
790	4	8	11	775	0	798
791	5	3	792	9	0	809
792	727	4	11	12	0	754
793	12	2	797	5	0	816
794	7	796	13	4	0	820
795	7	9	10	783	0	809
796	5	6	7	802	0	820
797	786	3	6	17	0	812
798	790	3	3	9	0	805
799	19	774	5	6	0	804
800	8	15	761	7	0	791
801	8	7	752	7	0	774
802	750	6	13	3	0	772
803	12	6	768	2	0	788
804	10	4	739	3	0	756
805	4	4	736	2	0	746
806	5	1	722	4	0	732
807	6	724	19	3	0	752
808	723	9	11	1	0	744
809	15	8	6	702	0	731
810	700	8	2	10	0	720
811	13	694	9	7	0	723
812	682	13	6	6	0	707
813	14	694	4	4	0	716
814	16	10	4	673	0	703
815	7	702	5	13	0	727
816	9	16	683	3	0	711
817	7	725	13	3	0	748
818	7	16	6	819	0	848
819	831	7	7	13	0	858
820	13	4	4	830	0	851
821	16	7	818	11	0	852
822	8	8	11	794	0	821
823	8	835	9	14	0	866
824	7	11	831	16	0	865
825	832	13	12	7	0	864
826	18	6	13	855	0	892
827	853	4	11	15	0	883
828	851	9	8	17	0	885
829	23	857	11	6	0	897
830	847	9	12	10	0	878
831	885	15	7	7	0	914
832	20	858	14	6	0	898
833	16	13	6	866	0	901
834	7	16	7	856	0	886
835	9	871	9	18	0	907
836	11	15	4	894	0	924
837	10	14	878	22	0	924
838	12	10	16	867	0	905
839	9	8	864	15	0	896
840	3	8	794	11	0	816
841	7	775	23	7	0	812
842	2	755	10	8	0	775
843	12	790	8	3	0	813
844	9	16	6	722	0	753
845	1	7	740	9	0	757
846	698	2	11	13	0	724
847	10	3	11	738	0	762
848	9	5	751	8	0	773
849	7	6	724	7	0	744
850	1	758	13	6	0	778
851	5	15	7	749	0	776
852	719	8	4	11	0	742
853	9	688	8	12	0	717
854	7	702	3	3	0	715
855	2	688	4	7	0	701
856	3	16	7	681	0	707
857	1	714	7	9	0	731
858	2	14	5	792	0	813
859	4	7	0	805	0	816
860	10	6	760	15	0	791
861	665	6	15	15	0	701
862	14	5	786	4	0	809
863	5	6	9	786	0	806
864	4	4	791	14	0	813
865	3	773	14	8	0	798
866	776	13	7	7	0	803
867	10	7	6	754	0	777
868	8	2	6	773	0	789
869	775	3	3	16	0	797
870	754	5	5	10	0	774
871	768	2	3	7	0	780
872	18	3	751	6	0	778
873	710	5	11	5	0	731
874	12	732	9	3	0	756
875	8	733	1	8	0	750
876	5	16	7	703	0	731
877	5	7	5	707	0	724
878	5	698	4	17	0	724
879	4	13	1	704	0	722
880	699	7	4	10	0	720
881	15	4	694	9	0	722
882	6	689	13	3	0	711
883	659	18	5	3	0	685
884	11	676	2	6	0	695
885	7	13	669	4	0	693
886	3	9	11	671	0	694
887	3	3	678	17	0	701
888	4	671	14	7	0	696
889	9	13	10	672	0	704
890	4	11	669	12	0	696
891	5	5	665	9	0	684
892	3	7	17	675	0	702
893	676	2	11	16	0	705
894	685	3	3	12	0	703
895	694	4	6	5	0	709
896	20	6	690	7	0	723
897	10	697	16	6	0	729
898	5	12	10	691	0	718
899	5	6	8	686	0	705
900	4	695	6	21	0	726
901	707	14	5	10	0	736
902	16	12	3	715	0	746
903	11	8	708	15	0	742
904	3	706	17	10	0	736
905	693	13	8	6	0	720
906	15	709	5	8	0	737
907	8	17	2	696	0	723
908	5	13	5	691	0	714
909	5	4	4	708	0	721
910	3	8	682	19	0	712
911	4	8	13	664	0	689
912	4	661	5	17	0	687
913	6	677	6	8	0	697
914	4	21	653	4	0	682
915	598	10	13	7	0	628
916	653	3	10	11	0	677
917	14	636	7	5	0	662
918	534	14	3	3	0	554
919	541	3	2	5	0	551
920	10	539	5	4	0	558
921	4	14	2	543	0	563
922	5	3	560	11	0	579
923	7	1	541	4	0	553
924	544	1	15	1	0	561
925	12	557	4	4	0	577
926	5	12	4	544	0	565
927	3	7	1	540	0	551
928	2	6	1	540	0	549
929	537	2	2	15	0	556
930	13	3	0	536	0	552
931	5	3	2	537	0	547
932	3	2	528	15	0	548
933	498	3	10	5	0	516
934	12	527	6	2	0	547
935	514	10	4	4	0	532
936	10	510	2	2	0	524
937	9	12	1	507	0	529
938	510	2	3	11	0	526
939	517	2	2	4	0	525
940	8	3	500	5	0	516
941	504	3	7	5	0	519
942	10	3	533	4	0	550
943	3	1	527	2	0	533
944	1	3	525	3	0	532
945	3	1	567	3	0	574
946	1	9	15	615	0	640
947	3	1	620	17	0	641
948	3	6	16	596	0	621
949	605	1	3	17	0	626
950	17	5	6	599	0	627
951	586	2	1	21	0	610
952	14	590	3	10	0	617
953	3	16	12	584	0	615
954	6	3	588	16	0	613
955	4	588	15	4	0	611
956	8	15	2	556	0	581
957	4	2	563	14	0	583
958	2	504	13	3	0	522
959	2	511	3	2	0	518
960	1	15	519	2	0	537
961	2	13	13	493	0	521
962	1	2	484	13	0	500
963	462	2	12	2	0	478
964	490	0	3	3	0	496
965	15	480	3	2	0	500
966	487	10	4	1	0	502
967	13	4	1	487	0	505
968	5	2	469	11	0	487
969	453	2	13	5	0	473
970	12	1	458	3	0	474
971	3	469	14	2	0	488
972	477	11	4	2	0	494
973	12	2	2	469	0	485
974	5	2	473	12	0	492
975	472	3	11	4	0	490
976	467	1	3	4	0	475
977	479	0	3	1	0	483
978	16	1	0	463	0	480
979	5	1	0	475	0	481
980	5	1	457	14	0	477
981	2	464	11	5	0	482
982	1	12	2	446	0	461
983	0	3	2	471	0	476
984	0	2	461	15	0	478
985	0	3	456	4	0	463
986	1	1	14	458	0	474
987	442	0	5	11	0	458
988	10	454	3	3	0	470
989	458	10	3	2	0	473
990	15	462	1	2	0	480
991	4	12	448	0	0	464
992	4	4	468	1	0	477
993	472	3	14	1	0	490
994	511	2	4	2	0	519
995	15	507	5	2	0	529
996	5	12	493	4	0	514
997	5	2	14	485	0	506
998	3	5	3	484	0	495
999	5	486	4	14	0	509
1000	1	14	3	488	0	506
1001	3	2	500	16	0	521
1002	477	6	12	6	0	501
1003	491	2	3	6	0	502
1004	493	1	5	2	0	501
1005	502	4	1	5	0	512
1006	23	0	480	5	0	508
1007	486	0	16	2	0	504
1008	21	3	485	0	0	509
1009	5	483	19	4	0	511
1010	6	13	7	492	0	518
1011	498	5	10	14	0	527
1012	16	5	6	552	0	579
1013	5	2	554	20	0	581
1014	559	1	17	5	0	582
1015	573	4	3	8	0	588
1016	21	2	5	557	0	585
1017	11	1	2	564	0	578
1018	7	2	554	21	0	584
1019	5	553	16	9	0	583
1020	550	15	7	8	0	580
1021	15	8	540	3	0	566
1022	500	6	13	3	0	522
1023	19	527	3	5	0	554
1024	527	15	10	2	0	554
1025	20	510	3	0	0	533
1026	8	536	2	1	0	547
1027	9	18	3	523	0	553
1028	5	7	0	552	0	564
1029	3	7	2	555	0	567
1030	2	3	3	558	0	566
1031	2	3	547	21	0	573
1032	537	2	15	10	0	564
1033	552	0	1	12	0	565
1034	558	0	7	5	0	570
1035	22	1	6	546	0	575
1036	10	0	5	560	0	575
1037	554	2	3	18	0	577
1038	558	5	0	8	0	571
1039	555	1	1	13	0	570
1040	21	3	2	540	0	566
1041	9	2	8	530	0	549
1042	8	1	488	14	0	511
1043	8	0	473	7	0	488
1044	5	476	15	7	0	503
1045	384	27	25	15	0	451
1046	380	4	6	2	0	392
1047	392	5	3	3	0	403
1048	10	4	399	2	0	415
1049	401	4	5	1	0	411
1050	400	0	1	5	0	406
1051	405	0	5	3	0	413
1052	12	1	3	390	0	406
1053	10	0	1	382	0	393
1054	8	0	2	385	0	395
1055	6	1	354	11	0	372
1056	358	1	5	10	0	374
1057	7	374	1	9	0	391
1058	347	4	3	5	0	359
1059	7	340	1	8	0	356
1060	5	343	1	3	0	352
1061	6	5	0	341	0	352
1062	5	2	0	338	0	345
1063	1	346	1	6	0	354
1064	338	5	1	5	0	349
1065	342	1	2	5	0	350
1066	8	3	2	326	0	339
1067	5	3	326	4	0	338
1068	7	0	314	1	0	322
1069	3	0	329	3	0	335
1070	4	0	326	2	0	332
1071	317	0	11	0	0	328
1072	326	0	5	0	0	331
1073	5	1	3	318	0	327
1074	6	0	318	5	0	329
1075	5	0	5	317	0	327
1076	2	314	2	8	0	326
1077	1	360	4	3	0	368
1078	357	5	2	4	0	368
1079	363	2	0	2	0	367
1080	365	7	0	1	0	373
1081	9	2	0	364	0	375
1082	5	2	0	376	0	383
1083	5	2	0	376	0	383
1084	2	1	1	373	0	377
1085	2	0	370	12	0	384
1086	1	4	5	365	0	375
1087	380	0	0	11	0	391
1088	5	1	4	379	0	389
1089	1	1	2	382	0	386
1090	3	6	3	375	0	387
1091	2	357	3	10	0	372
1092	1	361	2	3	0	367
1093	1	347	2	4	0	354
1094	3	4	0	313	0	320
1095	2	1	0	311	0	314
1096	310	3	1	5	0	319
1097	317	1	2	1	0	321
1098	320	0	1	3	0	324
1099	4	1	1	323	0	329
1100	3	2	1	320	0	326
1101	3	308	1	2	0	314
1102	3	325	1	2	0	331
1103	326	3	1	2	0	332
1104	5	1	0	327	0	333
1105	326	1	0	6	0	333
1106	347	1	0	3	0	351
1107	4	0	1	339	0	344
1108	2	351	2	5	0	360
1109	354	4	0	2	0	360
1110	364	1	0	4	0	369
1111	4	2	381	3	0	390
1112	324	1	2	1	0	328
1113	6	343	0	1	0	350
1114	1	3	2	356	0	362
1115	407	1	0	6	0	414
1116	3	3	0	403	0	409
1117	2	1	0	403	0	406
1118	3	407	1	7	0	418
1119	408	2	0	5	0	415
1120	413	2	0	4	0	419
1121	5	403	0	2	0	410
1122	5	445	0	2	0	452
1123	441	3	0	1	0	445
1124	437	4	0	0	0	441
1125	3	2	421	0	0	426
1126	4	0	387	2	0	393
1127	4	0	402	0	0	406
1128	0	0	5	410	0	415
1129	1	0	4	416	0	421
1130	0	0	414	3	0	417
1131	400	0	1	5	0	406
1132	424	0	2	1	0	427
1133	425	0	1	0	0	426
1134	424	0	0	1	0	425
1135	5	0	463	0	0	468
1136	469	0	1	2	0	472
1137	479	0	2	0	0	481
1138	472	1	2	0	0	475
1139	487	0	0	0	0	487
1140	488	0	0	0	0	488
1141	5	0	497	0	0	502
1142	4	504	1	0	0	509
1143	2	1	2	494	0	499
1144	0	2	2	509	0	513
1145	0	2	504	3	0	509
1146	455	0	1	4	0	460
1147	1	0	2	471	0	474
1148	2	0	492	2	0	496
1149	3	1	461	3	0	468
1150	1	506	3	2	0	512
1151	2	1	3	512	0	518
1152	0	3	2	514	0	519
1153	0	3	0	513	0	516
1154	528	0	0	5	0	533
1155	2	0	0	531	0	533
1156	2	0	527	3	0	532
1157	2	0	472	2	0	476
1158	1	0	561	2	0	564
1159	0	0	5	558	0	563
1160	581	0	4	2	0	587
1161	1	0	584	2	0	587
1162	572	0	2	2	0	576
1163	657	0	2	8	0	667
1164	6	0	2	666	0	674
1165	5	0	0	669	0	674
1166	2	664	1	8	0	675
1167	3	1	672	5	0	681
1168	665	2	1	4	0	672
1169	4	2	2	695	0	703
1170	3	694	2	1	0	700
1171	4	2	0	704	0	710
1172	0	2	702	4	0	708
1173	0	4	2	689	0	695
1174	0	690	2	6	0	698
1175	0	2	4	694	0	700
1176	678	1	0	5	0	684
1177	3	3	0	685	0	691
1178	2	679	0	5	0	686
1179	3	695	1	2	0	701
1180	664	2	1	6	0	673
1181	1	6	697	0	0	704
1182	2	3	3	679	0	687
1183	4	0	2	712	0	718
1184	0	0	727	4	0	731
1185	1	716	1	5	0	723
1186	1	2	724	4	0	731
1187	3	3	8	706	0	720
1188	0	785	4	1	0	790
1189	798	1	4	4	0	807
1190	1	784	0	5	0	790
1191	3	833	0	1	0	837
1192	848	3	1	0	0	852
1193	848	5	0	2	0	855
1194	868	3	0	3	0	874
1195	6	0	0	874	0	880
1196	5	0	873	2	0	880
1197	865	1	0	6	0	872
1198	955	0	3	3	0	961
1199	5	0	3	998	0	1006
1200	5	0	1007	3	0	1015
1201	3	1009	4	2	0	1018
1202	1007	5	1	6	0	1019
1203	1046	2	4	3	0	1055
1204	4	1052	0	1	0	1057
1205	4	1068	0	0	0	1072
1206	1060	5	0	1	0	1066
1207	1055	4	0	0	0	1059
1208	1054	2	0	1	0	1057
1209	10	1	0	1048	0	1059
1210	4	1	1050	5	0	1060
1211	3	0	5	1018	0	1026
1212	0	1	1028	6	0	1035
1213	0	982	6	3	0	991
1214	0	996	2	12	0	1010
1215	1	5	1	938	0	945
1216	0	1	0	967	0	968
1217	2	1	0	932	0	935
1218	1	973	0	4	0	978
1219	962	5	0	4	0	971
1220	948	0	1	1	0	950
1221	5	1002	0	1	0	1008
1222	4	6	0	951	0	961
1223	4	974	0	6	0	984
1224	3	9	1	966	0	979
1225	0	984	0	4	0	988
1226	983	7	1	0	0	991
1227	11	0	0	975	0	986
1228	4	2	971	5	0	982
1229	937	1	5	3	0	946
1230	960	0	3	3	0	966
1231	7	0	969	3	0	979
1232	4	0	6	966	0	976
1233	1	1	999	7	0	1008
1234	0	3	8	990	0	1001
1235	0	1	954	10	0	965
1236	899	0	6	5	0	910
1237	6	2	0	941	0	949
1238	1	933	12	5	0	951
1239	966	7	0	1	0	974
1240	10	1	0	968	0	979
1241	3	5	0	946	0	954
1242	3	2	933	7	0	945
1243	3	3	4	954	0	964
1244	2	1	989	11	0	1003
1245	0	3	991	5	0	999
1246	4	1	11	1032	0	1048
1247	2	3	1089	11	0	1105
1248	1058	1	14	8	0	1081
1249	1290	2	5	2	0	1299
1250	1452	1	1	1	0	1455
1251	34	1507	3	4	0	1548
1252	16	26	2	1519	0	1563
1253	9	13	3	1480	0	1505
1254	6	1543	2	36	0	1587
1255	1533	28	5	15	0	1581
1256	31	14	1	1530	0	1576
1257	13	6	1544	31	0	1594
1258	4	6	1451	18	0	1479
1259	5	1477	37	4	0	1523
1260	1483	24	15	9	0	1531
1261	29	12	1475	7	0	1523
1262	1398	5	32	4	0	1439
1263	31	1373	15	7	0	1426
1264	19	25	1397	3	0	1444
1265	6	10	1326	3	0	1345
1266	7	5	1389	5	0	1406
1267	3	1358	44	3	0	1408
1268	6	27	1376	3	0	1412
1269	1352	11	33	2	0	1398
1270	28	4	18	1332	0	1382
1271	16	9	6	1396	0	1427
1272	10	4	4	1427	0	1445
1273	7	0	1	1439	0	1447
1274	2	7	1402	47	0	1458
1275	6	5	27	1408	0	1446
1276	3	2	17	1432	0	1454
1277	1372	2	10	51	0	1435
1278	1397	4	12	18	0	1431
1279	1337	7	4	26	0	1374
1280	47	6	1351	8	0	1412
1281	23	1360	37	5	0	1425
1282	13	1430	20	6	0	1469
1283	1334	48	4	4	0	1390
1284	28	1403	11	3	0	1445
1285	17	37	11	1389	0	1454
1286	10	19	9	1428	0	1466
1287	2	13	1400	46	0	1461
1288	4	1330	37	20	0	1391
1289	11	30	1328	8	0	1377
1290	1283	20	35	14	0	1352
1291	1330	6	22	8	0	1366
1292	42	7	12	1298	0	1359
1293	24	5	8	1305	0	1342
1294	10	4	9	1315	0	1338
1295	9	3	7	1317	0	1336
1296	5	3	1281	64	0	1353
1297	8	6	36	1254	0	1304
1298	10	5	1234	41	0	1290
1299	8	2	1170	26	0	1206
1300	8	1170	50	11	0	1239
1301	1167	31	18	10	0	1226
1302	32	1205	10	11	0	1258
1303	22	34	7	1171	0	1234
1304	6	24	1257	38	0	1325
1305	1217	11	43	21	0	1292
1306	39	10	1247	18	0	1314
1307	1255	5	44	8	0	1312
1308	1303	6	22	6	0	1337
1309	59	4	13	1305	0	1381
1310	27	4	7	1316	0	1354
1311	14	6	10	1338	0	1368
1312	13	7	1270	61	0	1351
1313	1232	12	41	30	0	1315
1314	44	1261	23	20	0	1348
1315	25	33	12	1274	0	1344
1316	1274	20	12	47	0	1353
1317	1298	11	5	30	0	1344
1318	1318	5	13	20	0	1356
1319	66	11	1257	13	0	1347
1320	1292	6	48	15	0	1361
1321	1293	13	22	17	0	1345
1322	69	9	1156	17	0	1251
1323	26	7	1304	21	0	1358
1324	21	7	62	1272	0	1362
1325	20	12	1295	45	0	1372
1326	9	1221	54	33	0	1317
1327	9	1303	39	11	0	1362
1328	1258	52	24	10	0	1344
1329	49	1301	15	13	0	1378
1330	35	44	16	1293	0	1388
1331	1241	30	15	43	0	1329
1332	51	1284	11	41	0	1387
1333	23	47	11	1280	0	1361
1334	10	24	20	1315	0	1369
1335	7	9	1270	74	0	1360
1336	15	6	54	1273	0	1348
1337	14	7	1279	55	0	1355
1338	14	7	1272	44	0	1337
1339	17	4	61	1240	0	1322
1340	17	7	23	1292	0	1339
1341	1265	3	12	73	0	1353
1342	55	1341	16	38	0	1450
1343	28	48	12	1315	0	1403
1344	17	38	9	1340	0	1404
1345	1278	10	7	68	0	1363
1346	56	1240	9	33	0	1338
1347	30	1196	9	23	0	1258
1348	17	1149	11	23	0	1200
1349	6	988	13	7	0	1014
1350	747	26	21	4	0	798
1351	753	10	8	2	0	773
1352	718	9	1	3	0	731
1353	733	2	3	2	0	740
1354	29	6	0	704	0	739
1355	9	3	700	27	0	739
1356	5	685	21	18	0	729
1357	4	25	6	692	0	727
1358	4	13	685	26	0	728
1359	5	6	22	682	0	715
1360	6	2	9	707	0	724
1361	6	2	683	27	0	718
1362	1	5	21	693	0	720
1363	1	5	11	661	0	678
1364	684	4	6	31	0	725
1365	693	5	5	16	0	719
1366	697	4	2	8	0	711
1367	697	3	4	8	0	712
1368	34	3	4	668	0	709
1369	14	1	4	683	0	702
1370	10	7	2	680	0	699
1371	655	4	4	31	0	694
1372	23	10	2	667	0	702
1373	11	8	3	675	0	697
1374	7	5	634	33	0	679
1375	11	9	24	626	0	670
1376	11	606	8	27	0	652
1377	10	651	7	9	0	677
1378	618	21	4	9	0	652
1379	29	12	607	7	0	655
1380	15	608	16	6	0	645
1381	590	19	14	4	0	627
1382	25	5	7	582	0	619
1383	12	4	571	23	0	610
1384	10	11	20	560	0	601
1385	2	579	9	29	0	619
1386	568	21	9	10	0	608
1387	18	583	6	17	0	624
1388	591	24	5	10	0	630
1389	619	7	4	10	0	640
1390	28	8	4	602	0	642
1391	13	5	5	599	0	622
1392	10	598	0	24	0	632
1393	610	17	4	16	0	647
1394	23	7	607	9	0	646
1395	587	8	16	8	0	619
1396	599	2	6	9	0	616
1397	24	2	575	9	0	610
1398	9	7	17	543	0	576
1399	539	19	5	25	0	588
1400	19	5	549	10	0	583
1401	11	4	523	13	0	551
1402	497	3	13	10	0	523
1403	11	487	8	10	0	516
1404	7	441	4	3	0	455
1405	10	9	0	431	0	450
1406	1	9	439	9	0	458
1407	414	7	6	6	0	433
1408	14	0	407	6	0	427
1409	7	383	12	3	0	405
1410	388	9	4	3	0	404
1411	11	7	5	384	0	407
1412	382	3	6	15	0	406
1413	11	0	381	8	0	400
1414	10	4	7	372	0	393
1415	6	386	3	9	0	404
1416	5	12	6	372	0	395
1417	3	7	4	382	0	396
1418	7	7	371	10	0	395
1419	10	349	8	4	0	371
1420	6	352	4	9	0	371
1421	7	12	339	4	0	362
1422	319	5	6	4	0	334
1423	320	4	7	7	0	338
1424	8	3	7	318	0	336
1425	318	3	3	8	0	332
1426	9	298	5	5	0	317
1427	5	318	7	7	0	337
1428	323	8	1	8	0	340
1429	14	4	2	314	0	334
1430	309	5	8	14	0	336
1431	330	2	3	9	0	344
1432	14	4	3	308	0	329
1433	10	3	307	12	0	332
1434	307	4	7	7	0	325
1435	313	6	5	8	0	332
1436	19	1	5	301	0	326
1437	9	305	6	12	0	332
1438	8	11	1	311	0	331
1439	6	7	305	13	0	331
1440	6	1	294	6	0	307
1441	5	297	8	12	0	322
1442	7	11	3	187	0	208
1443	1	3	4	193	0	201
1444	3	1	194	5	0	203
1445	186	4	5	2	0	197
1446	188	4	2	4	0	198
1447	189	3	2	3	0	197
1448	181	0	2	7	0	190
1449	7	177	2	1	0	187
1450	6	187	1	1	0	195
1451	190	4	3	4	0	201
1452	5	5	3	189	0	202
1453	7	3	0	202	0	212
1454	1	197	0	9	0	207
1455	4	5	0	192	0	201
1456	1	4	2	193	0	200
1457	2	197	0	8	0	207
1458	2	7	193	2	0	204
1459	1	1	5	198	0	205
1460	195	3	1	6	0	205
1461	198	2	2	3	0	205
1462	6	2	193	4	0	205
1463	1	3	189	2	0	195
1464	5	0	191	0	0	196
1465	6	0	5	184	0	195
1466	4	0	186	7	0	197
1467	2	2	196	3	0	203
1468	3	2	7	194	0	206
1469	2	201	4	5	0	212
1470	1	6	201	0	0	208
1471	2	200	5	2	0	209
1472	190	4	3	7	0	204
1473	6	196	2	2	0	206
1474	6	4	4	198	0	212
1475	196	4	0	7	0	207
1476	7	1	3	197	0	208
1477	5	2	1	200	0	208
1478	5	0	200	7	0	212
1479	3	188	4	3	0	198
1480	1	203	1	1	0	206
1481	4	5	1	197	0	207
1482	1	1	3	204	0	209
1483	0	2	3	202	0	207
1484	0	5	196	6	0	207
1485	1	0	182	6	0	189
1486	172	0	5	5	0	182
1487	4	2	172	2	0	180
1488	2	1	176	1	0	180
1489	2	159	6	3	0	170
1490	3	4	2	160	0	169
1491	3	2	169	3	0	177
1492	0	2	6	166	0	174
1493	0	1	168	5	0	174
1494	1	0	5	161	0	167
1495	0	0	178	8	0	186
1496	0	0	6	179	0	185
1497	0	0	5	180	0	185
1498	1	177	0	5	0	183
1499	0	6	3	177	0	186
1500	0	184	3	4	0	191
1501	0	6	0	189	0	195
1502	2	2	0	190	0	194
1503	182	2	2	5	0	191
1504	4	1	1	186	0	192
1505	5	0	183	4	0	192
1506	2	0	4	178	0	184
1507	2	0	3	181	0	186
1508	0	2	176	6	0	184
1509	0	1	171	2	0	174
1510	1	3	4	163	0	171
1511	0	0	1	175	0	176
1512	1	1	169	7	0	178
1513	0	163	3	6	0	172
1514	0	175	4	4	0	183
1515	170	4	3	5	0	182
1516	5	3	1	167	0	176
1517	169	1	3	4	0	177
1518	170	1	2	4	0	177
1519	6	171	0	2	0	179
1520	171	3	1	4	0	179
1521	168	1	4	2	0	175
1522	5	0	164	3	0	172
1523	2	1	5	167	0	175
1524	0	0	171	6	0	177
1525	1	1	7	168	0	177
1526	0	2	170	5	0	177
1527	1	161	2	5	0	169
1528	0	162	2	1	0	165
1529	1	1	1	161	0	164
1530	156	2	2	3	0	163
1531	4	2	0	153	0	159
1532	1	1	1	156	0	159
1533	2	0	154	6	0	162
1534	2	0	156	2	0	160
1535	0	1	151	4	0	156
1536	0	0	4	150	0	154
1537	0	1	2	149	0	152
1538	0	155	3	4	0	162
1539	0	177	2	1	0	180
1540	171	5	0	0	0	176
1541	4	168	0	2	0	174
1542	1	4	168	0	0	173
1543	0	0	3	161	0	164
1544	0	0	176	6	0	182
1545	0	177	6	0	0	183
1546	0	3	2	177	0	182
1547	176	0	1	5	0	182
1548	3	0	176	2	0	181
1549	0	182	5	1	0	188
1550	0	6	179	0	0	185
1551	0	182	3	0	0	185
1552	5	3	4	159	0	171
1553	164	1	0	4	0	169
1554	170	0	1	1	0	172
1555	4	167	0	1	0	172
1556	166	4	1	0	0	171
1557	4	1	0	166	0	171
1558	164	0	0	4	0	168
1559	5	0	173	0	0	178
1560	0	0	189	1	0	190
1561	0	1	4	178	0	183
1562	0	0	1	198	0	199
1563	0	2	199	3	0	204
1564	0	1	3	206	0	210
1565	203	1	0	3	0	207
1566	208	0	0	1	0	209
1567	4	186	0	0	0	190
1568	1	194	0	1	0	196
1569	183	3	0	2	0	188
1570	4	0	1	186	0	191
1571	183	0	2	3	0	188
1572	3	193	2	0	0	198
1573	187	3	0	2	0	192
1574	3	0	183	0	0	186
1575	0	0	184	0	0	184
1576	0	0	3	186	0	189
1577	0	0	194	3	0	197
1578	0	0	3	195	0	198
1579	0	0	0	192	0	192
1580	0	0	199	3	0	202
1581	0	0	3	194	0	197
1582	1	0	0	202	0	203
1583	0	0	208	3	0	211
1584	0	0	205	0	0	205
1585	200	0	3	0	0	203
1586	3	0	213	0	0	216
1587	209	0	3	1	0	213
1588	226	0	0	0	0	226
1589	4	0	243	0	0	247
1590	0	0	248	0	0	248
1591	1	0	4	234	0	239
1592	0	0	2	228	0	230
1593	0	234	2	3	0	239
1594	0	248	1	1	0	250
1595	0	4	226	1	0	231
1596	213	1	5	0	0	219
1597	227	2	0	2	0	231
1598	4	0	231	1	0	236
1599	2	0	238	1	0	241
1600	3	0	3	226	0	232
1601	2	230	2	3	0	237
1602	1	5	2	232	0	240
1603	0	2	0	237	0	239
1604	233	3	0	4	0	240
1605	239	0	0	3	0	242
1606	5	0	0	247	0	252
1607	3	1	250	4	0	258
1608	235	1	4	0	0	240
1609	5	246	1	2	0	254
1610	251	4	4	0	0	259
1611	247	0	1	1	0	249
1612	4	253	1	1	0	259
1613	2	259	1	1	0	263
1614	2	4	0	255	0	261
1615	0	2	3	258	0	263
1616	0	255	2	6	0	263
1617	0	4	0	265	0	269
1618	0	0	2	269	0	271
1619	0	3	269	5	0	277
1620	258	1	5	3	0	267
1621	274	0	3	1	0	278
1622	285	0	4	0	0	289
1623	9	0	0	279	0	288
1624	280	0	3	4	0	287
1625	7	273	3	3	0	286
1626	3	7	1	269	0	280
1627	2	269	1	5	0	277
1628	0	290	2	3	0	295
1629	289	3	3	3	0	298
1630	283	3	2	4	0	292
1631	282	3	2	4	0	291
1632	285	1	2	3	0	291
1633	283	1	3	3	0	290
1634	8	1	276	1	0	286
1635	279	2	4	0	0	285
1636	6	2	284	2	0	294
1637	266	1	6	1	0	274
1638	270	2	1	3	0	276
1639	255	2	3	4	0	264
1640	6	3	264	2	0	275
1641	3	3	2	258	0	266
1642	5	276	2	3	0	286
1643	284	1	2	3	0	290
1644	279	1	1	5	0	286
1645	2	282	3	2	0	289
1646	286	2	3	0	0	291
1647	3	2	1	277	0	283
1648	4	309	1	2	0	316
1649	301	2	2	4	0	309
1650	300	2	1	5	0	308
1651	4	4	1	295	0	304
1652	300	2	1	5	0	308
1653	3	2	2	299	0	306
1654	1	3	2	302	0	308
1655	5	2	296	4	0	307
1656	5	1	1	291	0	298
1657	7	1	2	299	0	309
1658	4	2	293	5	0	304
1659	4	2	291	5	0	302
1660	3	1	4	285	0	293
1661	4	2	288	3	0	297
1662	265	0	4	5	0	274
1663	6	287	1	2	0	296
1664	2	2	3	299	0	306
1665	4	2	0	303	0	309
1666	0	6	2	297	0	305
1667	306	1	0	9	0	316
1668	308	3	1	4	0	316
1669	322	1	0	4	0	327
1670	9	315	0	3	0	327
1671	7	2	2	322	0	333
1672	6	2	1	316	0	325
1673	324	2	1	3	0	330
1674	323	2	2	2	0	329
1675	3	1	2	315	0	321
1676	7	1	314	1	0	323
1677	309	1	2	3	0	315
1678	309	1	1	3	0	314
1679	4	0	315	3	0	322
1680	300	0	1	3	0	304
1681	4	2	326	0	0	332
1682	316	0	3	3	0	322
1683	4	4	2	334	0	344
1684	3	345	4	3	0	355
1685	5	2	371	1	0	379
1686	3	366	5	4	0	378
1687	3	341	3	2	0	349
1688	365	5	1	17	0	388
1689	2	0	1	368	0	371
1690	2	0	0	367	0	369
1691	369	0	0	5	0	374
1692	3	0	1	375	0	379
1693	3	1	0	379	0	383
1694	0	0	2	371	0	373
1695	1	1	0	377	0	379
1696	0	1	376	5	0	382
1697	2	1	368	1	0	372
1698	1	374	4	1	0	380
1699	371	4	2	2	0	379
1700	6	3	0	395	0	404
1701	3	398	1	4	0	406
1702	1	3	0	419	0	423
1703	0	1	0	424	0	425
1704	2	0	0	413	0	415
1705	0	0	2	417	0	419
1706	1	1	0	415	0	417
1707	1	407	1	5	0	414
1708	2	3	1	407	0	413
1709	0	1	411	4	0	416
1710	0	405	5	5	0	415
1711	2	5	1	412	0	420
1712	2	4	0	407	0	413
1713	0	402	0	9	0	411
1714	0	412	0	4	0	416
1715	407	4	0	4	0	415
1716	4	407	1	1	0	413
1717	419	3	1	2	0	425
1718	416	2	2	1	0	421
1719	5	2	420	1	0	428
1720	1	1	3	413	0	418
1721	0	1	414	6	0	421
1722	1	419	3	2	0	425
1723	3	5	1	386	0	395
1724	1	1	0	415	0	417
1725	0	1	0	425	0	426
1726	2	1	0	423	0	426
1727	2	2	434	4	0	442
1728	0	0	4	428	0	432
1729	1	1	428	3	0	433
1730	1	1	412	2	0	416
1731	410	1	3	3	0	417
1732	437	0	1	3	0	441
1733	441	2	0	3	0	446
1734	2	445	2	1	0	450
1735	1	5	0	453	0	459
1736	0	2	461	4	0	467
1737	1	0	3	463	0	467
1738	2	0	493	5	0	500
1739	474	0	5	3	0	482
1740	491	0	1	2	0	494
1741	499	0	1	1	0	501
1742	4	1	480	1	0	486
1743	0	2	473	3	0	478
1744	2	0	3	476	0	481
1745	1	1	1	462	0	465
1746	0	0	0	503	0	503
1747	0	2	499	3	0	504
1748	2	0	438	2	0	442
1749	449	0	5	1	0	455
1750	4	1	1	488	0	494
1751	1	0	2	495	0	498
1752	503	0	1	4	0	508
1753	4	0	0	504	0	508
1754	549	1	0	10	0	560
1755	568	0	1	3	0	572
1756	557	1	3	0	0	561
1757	3	0	583	3	0	589
1758	1	580	4	6	0	591
1759	595	4	1	2	0	602
1760	5	0	1	581	0	587
1761	3	0	1	592	0	596
1762	1	589	1	6	0	597
1763	590	4	1	2	0	597
1764	569	0	0	4	0	573
1765	580	0	0	3	0	583
1766	4	591	2	2	0	599
1767	614	5	1	0	0	620
1768	623	0	1	3	0	627
1769	616	0	0	2	0	618
1770	4	0	1	600	0	605
1771	0	2	0	610	0	612
1772	3	0	634	3	0	640
1773	1	1	5	604	0	611
1774	2	0	0	626	0	628
1775	1	2	632	4	0	639
1776	603	0	3	1	0	607
1777	632	0	0	1	0	633
1778	5	0	0	621	0	626
1779	0	621	0	3	0	624
1780	1	627	0	1	0	629
1781	1	3	1	618	0	623
1782	2	0	604	4	0	610
1783	3	0	3	580	0	586
1784	0	0	591	3	0	594
1785	1	0	575	0	0	576
1786	2	1	2	614	0	619
1787	634	0	0	2	0	636
1788	611	0	0	1	0	612
1789	4	0	0	631	0	635
1790	1	0	0	619	0	620
1791	1	0	0	637	0	638
1792	0	0	0	636	0	636
1793	636	0	3	3	0	642
1794	642	0	0	0	0	642
1795	637	0	0	0	0	637
1796	3	0	627	0	0	630
1797	0	0	2	622	0	624
1798	0	1	0	639	0	640
1799	656	0	0	2	0	658
1800	1	629	1	1	0	632
1801	639	1	0	1	0	641
1802	634	1	0	1	0	636
1803	633	0	0	0	0	633
1804	634	0	0	0	0	634
1805	2	0	703	1	0	706
1806	1	2	660	1	0	664
1807	722	0	3	1	0	726
1808	745	0	0	1	0	746
1809	747	0	0	0	0	747
1810	756	0	0	3	0	759
1811	2	1	794	1	0	798
1812	1	821	3	0	0	825
1813	1	4	1	883	0	889
1814	923	3	0	6	0	932
1815	946	0	1	6	0	953
1816	1032	0	1	0	0	1033
1817	1033	1	0	0	0	1034
1818	1048	0	0	3	0	1051
1819	1022	2	0	0	0	1024
1820	12	2	954	3	0	971
1821	8	0	1009	1	0	1018
1822	4	0	11	999	0	1014
1823	5	0	1018	7	0	1030
1824	4	988	9	4	0	1005
1825	2	1026	6	1	0	1035
1826	3	12	2	1055	0	1072
1827	4	4	1111	9	0	1128
1828	2	0	1059	3	0	1064
1829	1069	1	12	3	0	1085
1830	1165	2	6	3	0	1176
1831	12	2	2	1200	0	1216
1832	1224	3	3	14	0	1244
1833	15	1	3	1220	0	1239
1834	11	2	3	1217	0	1233
1835	6	0	1237	20	0	1263
1836	4	0	1213	9	0	1226
1837	7	2	18	1194	0	1221
1838	2	1	1205	20	0	1228
1839	1132	0	14	10	0	1156
1840	1215	2	8	5	0	1230
1841	19	1232	6	6	0	1263
1842	1250	14	4	6	0	1274
1843	22	8	1236	2	0	1268
1844	1219	1	14	10	0	1244
1845	1248	2	11	2	0	1263
1846	1252	3	6	6	0	1267
1847	32	1	1	1213	0	1247
1848	15	1231	11	10	0	1267
1849	1239	16	8	9	0	1272
1850	1245	6	7	7	0	1265
1851	28	2	10	1238	0	1278
1852	1243	2	4	23	0	1272
1853	30	1253	3	10	0	1296
1854	17	27	3	1208	0	1255
1855	16	13	1194	25	0	1248
1856	1083	4	29	16	0	1132
1857	38	1	1190	4	0	1233
1858	22	4	20	1186	0	1232
1859	17	1179	8	25	0	1229
1860	8	1297	9	15	0	1329
1861	10	34	6	1313	0	1363
1862	9	1270	12	29	0	1320
1863	14	25	6	1751	0	1796
1864	7	15	8	1908	0	1938
1865	13	9	7	1921	0	1950
1866	1825	15	3	84	0	1927
1867	64	9	6	1860	0	1939
1868	23	3	1808	76	0	1910
1869	21	1812	56	29	0	1918
1870	1839	62	24	18	0	1943
1871	71	20	6	1828	0	1925
1872	25	15	8	1859	0	1907
1873	18	14	7	1881	0	1920
1874	17	6	1805	90	0	1918
1875	14	1806	64	34	0	1918
1876	1803	59	25	29	0	1916
1877	72	22	10	1751	0	1855
1878	22	1829	11	70	0	1932
1879	1838	64	9	23	0	1934
1880	68	20	1818	30	0	1936
1881	1806	13	75	9	0	1903
1882	70	23	1847	8	0	1948
1883	40	8	1858	14	0	1920
1884	16	1825	81	30	0	1952
1885	16	63	31	1800	0	1910
1886	15	20	1796	73	0	1904
1887	12	1720	80	25	0	1837
1888	14	73	28	1670	0	1785
1889	16	1740	17	68	0	1841
1890	3	61	1739	38	0	1841
1891	9	43	63	1715	0	1830
1892	16	13	1730	83	0	1842
1893	7	14	85	1717	0	1823
1894	15	16	32	1789	0	1852
1895	12	8	1734	95	0	1849
1896	7	12	80	1734	0	1833
1897	1670	20	27	80	0	1797
1898	62	1689	14	54	0	1819
1899	29	60	1705	28	0	1822
1900	1667	32	68	30	0	1797
1901	77	11	26	1642	0	1756
1902	24	1717	20	69	0	1830
1903	1742	67	21	36	0	1866
1904	1799	26	11	28	0	1864
1905	92	20	22	1643	0	1777
1906	35	17	12	1695	0	1759
1907	33	8	11	1707	0	1759
1908	17	14	19	1647	0	1697
1909	16	1619	10	91	0	1736
1910	31	88	13	1518	0	1650
1911	12	1559	10	79	0	1660
1912	10	1556	20	43	0	1629
1913	12	1521	14	37	0	1584
1914	9	82	1405	39	0	1535
1915	8	1464	61	24	0	1557
1916	1308	69	22	40	0	1439
1917	62	1336	22	19	0	1439
1918	26	70	14	1214	0	1324
1919	19	1335	10	67	0	1431
1920	14	66	14	1349	0	1443
1921	13	28	19	1390	0	1450
1922	15	27	1330	84	0	1456
1923	1287	19	64	42	0	1412
1924	1342	23	25	34	0	1424
1925	1341	21	18	27	0	1407
1926	78	1284	18	32	0	1412
1927	29	64	17	1231	0	1341
1928	25	30	1219	82	0	1356
1929	22	1210	64	35	0	1331
1930	18	75	25	1048	0	1166
1931	24	1129	17	46	0	1216
1932	1110	58	15	22	0	1205
1933	1136	30	13	25	0	1204
1934	1148	17	13	24	0	1202
1935	1143	12	24	13	0	1192
1936	76	15	14	1069	0	1174
1937	29	19	9	1086	0	1143
1938	18	1081	15	66	0	1180
1939	15	62	16	1104	0	1197
1940	9	31	1076	75	0	1191
1941	8	20	60	1057	0	1145
1942	9	15	1059	62	0	1145
1943	7	1031	57	38	0	1133
1944	8	57	1048	25	0	1138
1945	5	27	58	1056	0	1146
1946	7	12	1069	71	0	1159
1947	7	14	61	1058	0	1140
1948	8	9	30	1099	0	1146
1949	11	12	13	1111	0	1147
1950	11	11	13	1102	0	1137
1951	1049	17	11	65	0	1142
1952	59	1056	7	35	0	1157
1953	1045	52	8	23	0	1128
1954	58	27	1008	18	0	1111
1955	1015	17	47	16	0	1095
1956	1067	12	18	21	0	1118
1957	69	11	1007	25	0	1112
1958	31	14	1001	18	0	1064
1959	27	948	52	18	0	1045
1960	19	921	20	15	0	975
1961	18	51	826	23	0	918
1962	12	744	48	22	0	826
1963	21	38	15	355	0	429
1964	316	2	0	5	0	323
1965	4	1	1	326	0	332
1966	335	0	1	4	0	340
1967	334	0	0	4	0	338
1968	7	325	0	3	0	335
1969	323	5	0	1	0	329
1970	325	2	0	1	0	328
1971	7	1	1	319	0	328
1972	327	2	0	4	0	333
1973	5	322	0	3	0	330
1974	3	3	0	334	0	340
1975	331	2	0	5	0	338
1976	4	1	328	2	0	335
1977	323	1	3	2	0	329
1978	4	1	2	336	0	343
1979	3	1	338	4	0	346
1980	1	1	329	4	0	335
1981	318	0	11	1	0	330
1982	328	4	4	2	0	338
1983	8	0	2	323	0	333
1984	5	1	1	328	0	335
1985	2	1	0	323	0	326
1986	2	321	0	8	0	331
1987	319	4	0	7	0	330
1988	3	320	0	4	0	327
1989	320	5	0	3	0	328
1990	5	5	314	1	0	325
1991	4	1	4	316	0	325
1992	322	1	3	5	0	331
1993	6	0	2	326	0	334
1994	6	1	1	319	0	327
1995	3	311	0	9	0	323
1996	312	5	1	5	0	323
1997	8	328	1	3	0	340
1998	6	8	0	334	0	348
1999	4	4	317	6	0	331
2000	276	1	6	7	0	290
2001	6	3	311	3	0	323
2002	281	1	6	4	0	292
2003	7	296	5	0	0	308
2004	7	8	3	290	0	308
2005	4	305	1	8	0	318
2006	296	9	2	4	0	311
2007	8	5	4	293	0	310
2008	5	3	1	301	0	310
2009	4	3	292	12	0	311
2010	275	1	8	8	0	292
2011	9	1	4	299	0	313
2012	7	2	291	10	0	310
2013	4	289	9	7	0	309
2014	3	10	3	290	0	306
2015	295	5	1	10	0	311
2016	9	3	3	295	0	310
2017	8	3	289	9	0	309
2018	306	1	9	6	0	322
2019	13	1	4	306	0	324
2020	5	1	355	12	0	373
2021	3	0	10	356	0	369
2022	3	2	7	352	0	364
2023	3	363	1	18	0	385
2024	361	9	2	7	0	379
2025	9	370	2	4	0	385
2026	368	10	2	3	0	383
2027	12	7	1	357	0	377
2028	8	358	1	11	0	378
2029	2	10	4	359	0	375
2030	5	7	350	9	0	371
2031	345	2	10	9	0	366
2032	11	3	5	341	0	360
2033	6	2	1	355	0	364
2034	3	2	2	359	0	366
2035	3	3	339	18	0	363
2036	5	0	347	11	0	363
2037	0	347	17	6	0	370
2038	5	10	5	327	0	347
2039	320	5	3	13	0	341
2040	10	330	3	7	0	350
2041	6	14	1	340	0	361
2042	336	5	2	13	0	356
2043	341	3	1	5	0	350
2044	16	329	0	5	0	350
2045	356	12	2	5	0	375
2046	415	7	0	4	0	426
2047	19	2	4	415	0	440
2048	9	414	3	14	0	440
2049	4	13	1	434	0	452
2050	424	4	1	21	0	450
2051	16	4	416	13	0	449
2052	7	4	14	414	0	439
2053	4	3	7	426	0	440
2054	6	1	410	17	0	434
2055	1	3	16	412	0	432
2056	410	3	4	21	0	438
2057	391	2	3	13	0	409
2058	19	3	3	405	0	430
2059	10	0	400	19	0	429
2060	7	2	395	6	0	410
2061	6	378	18	7	0	409
2062	2	407	8	8	0	425
2063	2	15	6	380	0	403
2064	373	6	3	14	0	396
2065	10	375	2	7	0	394
2066	358	15	2	3	0	378
2067	13	5	1	360	0	379
2068	11	2	0	366	0	379
2069	350	3	0	14	0	367
2070	13	353	0	9	0	375
2071	352	11	2	7	0	372
2072	15	4	344	2	0	365
2073	7	3	345	1	0	356
2074	5	6	15	328	0	354
2075	5	1	340	13	0	359
2076	1	0	337	7	0	345
2077	2	2	16	319	0	339
2078	3	2	330	13	0	348
2079	2	1	14	324	0	341
2080	2	1	5	331	0	339
2081	2	0	323	20	0	345
2082	2	3	12	306	0	323
2083	4	3	5	296	0	308
2084	3	297	5	16	0	321
2085	302	11	5	6	0	324
2086	14	4	297	5	0	320
2087	5	3	12	300	0	320
2088	2	5	7	314	0	328
2089	4	0	306	16	0	326
2090	291	1	16	7	0	315
2091	11	304	5	7	0	327
2092	2	10	2	303	0	317
2093	2	4	6	311	0	323
2094	3	305	3	16	0	327
2095	2	13	300	9	0	324
2096	1	307	12	7	0	327
2097	281	14	7	6	0	308
2098	12	6	285	4	0	307
2099	5	2	14	281	0	302
2100	4	5	291	15	0	315
2101	5	0	300	7	0	312
2102	6	296	16	3	0	321
2103	4	11	6	279	0	300
2104	271	4	6	11	0	292
2105	288	2	2	3	0	295
2106	10	293	2	6	0	311
2107	4	10	4	297	0	315
2108	294	5	2	10	0	311
2109	296	3	5	4	0	308
2110	11	282	4	11	0	308
2111	294	8	2	6	0	310
2112	11	3	2	287	0	303
2113	3	290	4	11	0	308
2114	4	11	4	294	0	313
2115	4	3	2	305	0	314
2116	4	2	2	306	0	314
2117	4	2	294	15	0	315
2118	0	1	271	7	0	279
2119	2	271	10	6	0	289
2120	220	6	4	2	0	232
2121	9	213	4	0	0	226
2122	2	8	1	212	0	223
2123	3	3	223	6	0	235
2124	3	2	5	219	0	229
2125	0	3	1	229	0	233
2126	1	1	2	229	0	233
2127	222	0	2	11	0	235
2128	5	0	1	230	0	236
2129	1	1	227	10	0	239
2130	222	0	7	3	0	232
2131	231	1	3	2	0	237
2132	236	0	2	2	0	240
2133	237	1	1	1	0	240
2134	234	1	1	2	0	238
2135	10	230	1	2	0	243
2136	4	5	2	215	0	226
2137	3	229	0	5	0	237
2138	229	6	0	5	0	240
2139	232	4	0	3	0	239
2140	218	2	1	1	0	222
2141	6	219	2	2	0	229
2142	4	214	1	1	0	220
2143	3	212	1	1	0	217
2144	3	3	212	1	0	219
2145	4	16	3	175	0	198
2146	1	137	1	4	0	143
2147	0	138	0	0	0	138
2148	0	0	0	133	0	133
2149	0	1	0	134	0	135
2150	0	0	134	1	0	135
2151	142	0	0	1	0	143
2152	0	0	1	146	0	147
2153	1	0	0	147	0	148
2154	0	1	141	1	0	143
2155	0	0	139	1	0	140
2156	0	156	1	0	0	157
2157	1	0	1	154	0	156
2158	0	1	1	154	0	156
2159	0	0	151	2	0	153
2160	141	0	1	1	0	143
2161	152	0	2	0	0	154
2162	2	1	165	0	0	168
2163	167	0	1	3	0	171
2164	2	0	164	6	0	172
2165	167	0	1	0	0	168
2166	174	1	1	0	0	176
2167	2	0	179	1	0	182
2168	1	0	2	176	0	179
2169	1	0	1	178	0	180
2170	0	1	0	195	0	196
2171	192	0	0	2	0	194
2172	192	0	0	2	0	194
2173	2	1	209	0	0	212
2174	2	0	200	1	0	203
2175	203	0	4	1	0	208
2176	217	0	2	1	0	220
2177	4	0	207	0	0	211
2178	2	0	205	0	0	207
2179	0	1	4	206	0	211
2180	1	0	216	2	0	219
2181	1	1	2	209	0	213
2182	211	0	2	3	0	216
2183	2	0	229	2	0	233
2184	220	0	2	1	0	223
2185	2	0	258	1	0	261
2186	2	0	3	252	0	257
2187	2	0	2	273	0	277
2188	1	0	1	280	0	282
2189	1	274	1	5	0	281
2190	1	2	0	261	0	264
2191	1	4	0	284	0	289
2192	284	1	0	4	0	289
2193	2	0	278	4	0	284
2194	269	0	2	2	0	273
2195	3	0	284	0	0	287
2196	266	0	4	0	0	270
2197	3	275	3	5	0	286
2198	3	2	281	0	0	286
2199	1	1	281	2	0	285
2200	1	4	5	254	0	264
2201	0	0	6	276	0	282
2202	2	0	277	5	0	284
2203	0	1	287	6	0	294
2204	0	0	327	4	0	331
2205	328	0	9	2	0	339
2206	333	0	6	2	0	341
2207	336	2	2	1	0	341
2208	7	0	1	328	0	336
2209	6	1	0	332	0	339
2210	2	1	346	7	0	356
2211	1	0	3	333	0	337
2212	6	1	4	322	0	333
2213	357	0	4	6	0	367
2214	359	0	0	5	0	364
2215	360	1	2	1	0	364
2216	12	0	3	353	0	368
2217	6	1	2	359	0	368
2218	2	0	3	368	0	373
2219	364	0	1	8	0	373
2220	3	1	2	366	0	372
2221	3	353	4	6	0	366
2222	4	2	3	348	0	357
2223	2	345	3	3	0	353
2224	338	3	1	5	0	347
2225	343	3	2	0	0	348
2226	7	347	1	3	0	358
2227	7	354	1	1	0	363
2228	1	5	3	353	0	362
2229	1	4	350	5	0	360
2230	1	1	3	326	0	331
2231	1	1	352	6	0	360
2232	1	350	3	6	0	360
2233	3	2	2	351	0	358
2234	1	3	2	356	0	362
2235	3	1	374	6	0	384
2236	2	0	4	384	0	390
2237	3	0	387	5	0	395
2238	373	0	4	8	0	385
2239	400	1	3	5	0	409
2240	407	1	2	4	0	414
2241	6	4	1	405	0	416
2242	7	0	1	401	0	409
2243	4	1	405	7	0	417
2244	2	2	3	400	0	407
2245	1	410	5	4	0	420
2246	2	4	413	4	0	423
2247	1	2	390	2	0	395
2248	3	2	4	360	0	369
2249	1	0	405	2	0	408
2250	1	2	392	3	0	398
2251	366	0	6	5	0	377
2252	2	451	4	5	0	462
2253	469	2	4	6	0	481
2254	466	3	2	5	0	476
2255	474	3	3	3	0	483
2256	8	0	0	471	0	479
2257	8	0	1	479	0	488
2258	6	1	484	4	0	495
2259	2	0	2	470	0	474
2260	1	481	3	7	0	492
2261	488	1	2	5	0	496
2262	2	485	1	5	0	493
2263	3	492	2	2	0	499
2264	1	3	2	496	0	502
2265	1	4	513	3	0	521
2266	1	2	3	495	0	501
2267	1	0	512	4	0	517
2268	0	508	6	3	0	517
2269	510	0	4	3	0	517
2270	508	2	3	3	0	516
2271	538	2	0	4	0	544
2272	5	1	586	1	0	593
2273	5	1	551	2	0	559
2274	585	0	2	4	0	591
2275	604	2	4	2	0	612
2276	608	1	2	2	0	613
2277	4	0	1	608	0	613
2278	6	1	1	616	0	624
2279	621	1	0	4	0	626
2280	604	1	1	3	0	609
2281	2	0	624	3	0	629
2282	5	0	606	2	0	613
2283	599	2	0	1	0	602
2284	1	0	632	1	0	634
2285	581	0	1	1	0	583
2286	2	1	614	0	0	617
2287	0	0	1	602	0	603
2288	2	0	630	1	0	633
2289	1	0	1	628	0	630
2290	2	0	0	632	0	634
2291	0	646	0	0	0	646
2292	661	0	0	1	0	662
2293	1	0	678	1	0	680
2294	643	2	0	2	0	647
2295	1	698	0	1	0	700
2296	721	1	2	2	0	726
2297	2	0	0	720	0	722
2298	0	1	1	723	0	725
2299	2	747	0	1	0	750
2300	2	2	0	784	0	788
2301	1	2	0	786	0	789
2302	1	2	0	788	0	791
2303	763	0	1	7	0	771
2304	713	0	1	6	0	720
2305	7	0	708	2	0	717
2306	6	710	3	1	0	720
2307	4	3	2	726	0	735
2308	1	3	2	758	0	764
2309	1	1	770	8	0	780
2310	2	1	4	742	0	749
2311	755	0	2	6	0	763
2312	760	0	3	5	0	768
2313	759	0	2	3	0	764
2314	9	0	0	763	0	772
2315	812	0	1	8	0	821
2316	819	0	0	3	0	822
2317	819	0	1	2	0	822
2318	9	0	0	818	0	827
2319	6	0	1	812	0	819
2320	3	0	0	818	0	821
2321	0	1	0	802	0	803
2322	0	1	0	817	0	818
2323	2	0	802	10	0	814
2324	0	0	788	7	0	795
2325	1	799	7	3	0	810
2326	1	5	4	808	0	818
2327	2	3	3	800	0	808
2328	0	2	1	814	0	817
2329	1	1	808	9	0	819
2330	1	1	5	806	0	813
2331	1	0	812	8	0	821
2332	0	0	6	808	0	814
2333	6	0	836	8	0	850
2334	4	836	7	4	0	851
2335	1	4	3	830	0	838
2336	1	3	809	6	0	819
2337	712	1	6	5	0	724
2338	5	813	3	2	0	823
2339	4	6	1	818	0	829
2340	1	816	2	5	0	824
2341	2	7	1	812	0	822
2342	825	4	0	7	0	836
2343	6	1	0	823	0	830
2344	4	828	1	6	0	839
2345	826	5	0	6	0	837
2346	6	3	0	837	0	846
2347	4	1	0	842	0	847
2348	852	1	0	10	0	863
2349	8	0	0	910	0	918
2350	4	0	0	1168	0	1172
2351	4	0	1192	22	0	1218
2352	2	0	1182	6	0	1190
2353	0	0	32	1157	0	1189
2354	0	0	1173	26	0	1199
2355	0	0	1151	14	0	1165
2356	1081	0	37	10	0	1128
2357	22	2	1197	5	0	1226
2358	10	1195	34	2	0	1241
2359	9	20	14	1201	0	1244
2360	1216	9	9	22	0	1256
2361	1243	8	5	11	0	1267
2362	1238	3	1	14	0	1256
2363	39	1223	5	6	0	1273
2364	20	23	4	1227	0	1274
2365	12	9	2	1244	0	1267
2366	1180	9	6	32	0	1227
2367	1231	4	3	24	0	1262
2368	1249	1	6	11	0	1267
2369	39	2	1231	6	0	1278
2370	23	1222	21	10	0	1276
2371	15	1371	16	5	0	1407
2372	12	35	16	1321	0	1384
2373	7	24	8	1381	0	1420
2374	5	15	1392	51	0	1463
2375	1340	9	38	37	0	1424
2376	1433	3	24	30	0	1490
2377	57	0	19	1407	0	1483
2378	40	4	9	1424	0	1477
2379	28	3	4	1441	0	1476
2380	1404	5	4	67	0	1480
2381	40	2	1360	49	0	1451
2382	30	5	1387	30	0	1452
2383	27	7	54	1352	0	1440
2384	12	8	1389	45	0	1454
2385	1327	2	48	38	0	1415
2386	1343	2	38	25	0	1408
2387	1394	3	22	12	0	1431
2388	82	1315	10	7	0	1414
2389	1349	33	10	10	0	1402
2390	65	21	3	1307	0	1396
2391	36	19	7	1318	0	1380
2392	26	13	5	1344	0	1388
2393	17	8	1269	73	0	1367
2394	7	2	46	1262	0	1317
2395	11	1248	29	67	0	1355
2396	1215	32	22	42	0	1311
2397	45	1254	18	28	0	1345
2398	39	44	1227	21	0	1331
2399	29	1227	37	19	0	1312
2400	1172	53	26	15	0	1266
2401	41	1187	22	17	0	1267
2402	40	48	14	1087	0	1189
2403	21	1189	16	42	0	1268
2404	1176	49	13	32	0	1270
2405	1191	28	20	25	0	1264
2406	1147	21	15	21	0	1204
2407	73	14	1169	21	0	1277
2408	55	14	1145	11	0	1225
2409	45	12	1146	17	0	1220
2410	1129	13	72	11	0	1225
2411	47	10	45	1119	0	1221
2412	34	15	19	1148	0	1216
2413	31	9	1112	54	0	1206
2414	14	15	38	1135	0	1202
2415	1058	9	27	65	0	1159
2416	42	1058	21	39	0	1160
2417	1089	39	13	24	0	1165
2418	59	28	1049	21	0	1157
2419	1070	23	41	19	0	1153
2420	1096	15	38	13	0	1162
2421	1114	15	22	13	0	1164
2422	84	9	1050	10	0	1153
2423	48	16	38	1055	0	1157
2424	32	12	1060	49	0	1153
2425	26	5	51	1071	0	1153
2426	26	9	1073	50	0	1158
2427	26	8	53	1066	0	1153
2428	23	12	33	1082	0	1150
2429	1053	9	30	60	0	1152
2430	1060	10	21	41	0	1132
2431	1096	4	15	35	0	1150
2432	80	8	9	1042	0	1139
2433	52	961	15	45	0	1073
2434	34	1014	20	38	0	1106
2435	1001	45	19	28	0	1093
2436	47	38	987	27	0	1099
2437	1002	24	42	19	0	1087
2438	60	12	1000	16	0	1088
2439	1025	12	53	11	0	1101
2440	973	7	32	26	0	1038
2441	70	14	1023	11	0	1118
2442	1063	6	42	10	0	1121
2443	1061	8	32	17	0	1118
2444	1069	5	26	21	0	1121
2445	68	1024	13	19	0	1124
2446	55	49	14	998	0	1116
2447	35	27	1007	46	0	1115
2448	26	17	1026	31	0	1100
2449	22	934	55	26	0	1037
2450	18	685	31	10	0	744
2451	27	20	26	605	0	678
2452	598	19	9	17	0	643
2453	21	642	5	21	0	689
2454	25	15	11	640	0	691
2455	20	656	8	13	0	697
2456	657	23	2	15	0	697
2457	27	19	14	615	0	675
2458	20	11	607	19	0	657
2459	16	581	16	21	0	634
2460	10	592	23	10	0	635
2461	13	22	14	537	0	586
2462	10	589	8	13	0	620
2463	15	23	7	568	0	613
2464	558	15	4	27	0	604
2465	563	9	6	15	0	593
2466	590	11	3	11	0	615
2467	595	5	6	11	0	617
2468	38	8	569	4	0	619
2469	31	534	14	5	0	584
2470	15	557	18	11	0	601
2471	4	417	3	2	0	426
2472	2	401	2	4	0	409
2473	364	5	10	3	0	382
2474	347	3	0	0	0	350
2475	347	1	0	0	0	348
2476	348	0	0	0	0	348
2477	7	0	347	0	0	354
2478	355	0	3	0	0	358
2479	356	0	3	0	0	359
2480	366	0	0	0	0	366
2481	5	0	0	363	0	368
2482	4	0	0	366	0	370
2483	364	0	0	6	0	370
2484	3	0	0	363	0	366
2485	3	373	1	4	0	381
2486	1	3	0	374	0	378
2487	1	3	0	372	0	376
2488	0	360	0	6	0	366
2489	0	3	0	367	0	370
2490	0	3	0	369	0	372
2491	359	1	0	7	0	367
2492	4	1	351	4	0	360
2493	337	0	3	1	0	341
2494	5	1	358	0	0	364
2495	3	0	358	1	0	362
2496	2	0	362	0	0	364
2497	363	1	7	1	0	372
2498	3	0	394	1	0	398
2499	393	1	4	2	0	400
2500	422	1	2	2	0	427
2501	433	0	1	1	0	435
2502	7	430	1	0	0	438
2503	434	5	0	0	0	439
2504	5	441	0	0	0	446
2505	3	4	1	435	0	443
2506	2	4	0	434	0	440
2507	1	435	0	7	0	443
2508	2	436	0	4	0	442
2509	1	451	0	1	0	453
2510	453	5	0	1	0	459
2511	5	463	0	0	0	468
2512	465	4	1	1	0	471
2513	4	5	460	0	0	469
2514	463	1	3	2	0	469
2515	477	0	3	1	0	481
2516	5	2	477	0	0	484
2517	5	0	3	488	0	496
2518	2	0	500	4	0	506
2519	2	0	5	494	0	501
2520	2	0	4	489	0	495
2521	498	0	1	6	0	505
2522	499	0	1	4	0	504
2523	6	486	1	9	0	502
2524	501	3	1	0	0	505
2525	5	4	509	1	0	519
2526	502	1	4	2	0	509
2527	7	1	522	0	0	530
2528	5	2	542	1	0	550
2529	549	1	6	1	0	557
2530	557	1	4	1	0	563
2531	8	0	563	1	0	572
2532	5	6	4	528	0	543
2533	3	1	4	563	0	571
2534	2	2	565	6	0	575
2535	3	2	3	551	0	559
2536	1	544	5	4	0	554
2537	3	3	2	584	0	592
2538	3	3	2	577	0	585
2539	3	2	575	8	0	588
2540	521	2	4	6	0	533
2541	559	3	5	2	0	569
2542	559	0	2	3	0	564
2543	543	2	0	1	0	546
2544	10	546	2	2	0	560
2545	6	3	0	534	0	543
2546	3	2	534	4	0	543
2547	6	1	519	4	0	530
2548	4	6	4	511	0	525
2549	4	2	528	2	0	536
2550	510	0	3	6	0	519
2551	1	2	4	533	0	540
2552	6	1	2	526	0	535
2553	1	0	2	504	0	507
2554	500	2	2	5	0	509
2555	4	495	1	8	0	508
2556	496	0	2	4	0	502
2557	491	3	0	0	0	494
2558	3	489	1	4	0	497
2559	2	496	3	3	0	504
2560	505	3	1	5	0	514
2561	4	1	2	504	0	511
2562	4	3	2	498	0	507
2563	510	1	2	2	0	515
2564	3	3	502	2	0	510
2565	501	0	3	4	0	508
2566	517	3	1	1	0	522
2567	4	559	3	3	0	569
2568	588	2	1	3	0	594
2569	581	3	1	1	0	586
2570	10	620	0	2	0	632
2571	5	627	1	0	0	633
2572	5	12	0	589	0	606
2573	601	4	0	7	0	612
2574	8	627	0	2	0	637
2575	4	9	0	658	0	671
2576	677	4	0	9	0	690
2577	9	3	673	3	0	688
2578	4	1	9	666	0	680
2579	3	1	680	10	0	694
2580	646	0	10	6	0	662
2581	682	1	2	3	0	688
2582	12	1	675	1	0	689
2583	7	668	9	3	0	687
2584	4	8	5	673	0	690
2585	1	3	672	10	0	686
2586	2	4	12	652	0	670
2587	3	0	7	664	0	674
2588	2	1	673	13	0	689
2589	640	0	8	8	0	656
2590	673	1	5	3	0	682
2591	13	1	685	2	0	701
2592	6	678	11	6	0	701
2593	3	9	6	655	0	673
2594	3	679	4	10	0	696
2595	3	677	2	5	0	687
2596	675	14	3	1	0	693
2597	13	7	0	674	0	694
2598	7	2	2	651	0	662
2599	6	2	642	13	0	663
2600	2	3	621	8	0	634
2601	2	1	11	612	0	626
2602	2	3	6	619	0	630
2603	4	3	612	13	0	632
2604	2	2	606	7	0	617
2605	2	1	14	613	0	630
2606	613	1	10	10	0	634
2607	9	606	8	7	0	630
2608	606	10	3	8	0	627
2609	14	608	4	3	0	629
2610	10	613	1	2	0	626
2611	597	11	3	3	0	614
2612	10	7	592	5	0	614
2613	5	5	11	587	0	608
2614	6	3	7	598	0	614
2615	2	3	5	640	0	650
2616	6	2	620	20	0	648
2617	1	5	14	611	0	631
2618	625	2	5	18	0	650
2619	16	2	6	642	0	666
2620	10	3	3	656	0	672
2621	657	2	4	18	0	681
2622	653	3	3	11	0	670
2623	16	648	2	7	0	673
2624	8	14	646	8	0	676
2625	10	4	632	3	0	649
2626	6	5	634	6	0	651
2627	2	612	15	15	0	644
2628	3	11	15	579	0	608
2629	4	5	9	593	0	611
2630	585	3	5	21	0	614
2631	12	2	8	588	0	610
2632	9	3	581	18	0	611
2633	7	2	17	587	0	613
2634	2	1	11	590	0	604
2635	5	6	578	19	0	608
2636	7	564	12	11	0	594
2637	4	14	8	497	0	523
2638	6	560	6	14	0	586
2639	5	15	551	10	0	581
2640	548	7	18	4	0	577
2641	556	7	8	5	0	576
2642	564	3	9	7	0	583
2643	16	1	8	535	0	560
2644	9	543	4	19	0	575
2645	542	11	4	11	0	568
2646	546	7	8	9	0	570
2647	540	6	4	12	0	562
2648	26	1	523	7	0	557
2649	525	1	14	9	0	549
2650	20	524	7	5	0	556
2651	516	14	6	5	0	541
2652	16	518	8	3	0	545
2653	518	19	6	5	0	548
2654	17	8	511	7	0	543
2655	516	5	18	2	0	541
2656	524	6	9	7	0	546
2657	449	4	3	13	0	469
2658	530	2	7	9	0	548
2659	21	3	510	9	0	543
2660	16	3	14	505	0	538
2661	504	3	7	20	0	534
2662	13	505	10	13	0	541
2663	12	13	4	501	0	530
2664	13	6	501	15	0	535
2665	6	7	14	495	0	522
2666	2	6	490	17	0	515
2667	7	427	16	10	0	460
2668	6	397	9	8	0	420
2669	5	396	5	5	0	411
2670	8	11	1	339	0	359
2671	7	3	3	334	0	347
2672	7	6	332	6	0	351
2673	5	313	5	11	0	334
2674	296	2	7	3	0	308
2675	5	253	1	6	0	265
2676	4	230	3	4	0	241
2677	7	6	4	220	0	237
2678	219	4	2	2	0	227
2679	224	2	2	0	0	228
2680	3	5	1	223	0	232
2681	223	0	4	4	0	231
2682	5	1	2	220	0	228
2683	5	2	216	3	0	226
2684	218	1	3	2	0	224
2685	4	1	1	219	0	225
2686	3	3	219	4	0	229
2687	3	1	223	3	0	230
2688	5	2	2	223	0	232
2689	228	3	0	3	0	234
2690	215	4	3	2	0	224
2691	3	215	1	1	0	220
2692	212	3	2	3	0	220
2693	207	1	2	1	0	211
2694	209	4	1	0	0	214
2695	5	214	0	2	0	221
2696	220	3	2	2	0	227
2697	221	3	0	2	0	226
2698	4	0	2	219	0	225
2699	211	1	1	3	0	216
2700	6	215	1	2	0	224
2701	2	217	5	0	0	224
2702	2	2	1	228	0	233
2703	3	2	1	215	0	221
2704	1	226	1	3	0	231
2705	226	3	2	3	0	234
2706	3	230	2	2	0	237
2707	230	2	0	4	0	236
2708	5	232	2	2	0	241
2709	4	4	0	231	0	239
2710	1	235	1	4	0	241
2711	238	3	1	0	0	242
2712	227	2	7	3	0	239
2713	236	0	1	5	0	242
2714	2	2	233	0	0	237
2715	5	3	186	0	0	194
2716	0	190	0	2	0	192
2717	1	1	191	0	0	193
2718	0	1	176	0	0	177
2719	0	0	0	151	0	151
2720	0	0	156	0	0	156
2721	0	152	0	0	0	152
2722	155	0	0	0	0	155
2723	0	154	0	0	0	154
2724	0	157	0	0	0	157
2725	161	0	0	0	0	161
2726	168	0	0	0	0	168
2727	0	180	0	0	0	180
2728	190	0	0	1	0	191
2729	193	0	0	0	0	193
2730	196	0	0	0	0	196
2731	0	0	191	0	0	191
2732	0	0	181	0	0	181
2733	0	0	0	191	0	191
2734	0	0	0	183	0	183
2735	196	0	0	0	0	196
2736	0	190	0	0	0	190
2737	0	1	0	195	0	196
2738	0	1	0	193	0	194
2739	0	1	0	200	0	201
2740	0	1	0	195	0	196
2741	0	1	197	1	0	199
2742	0	0	201	0	0	201
2743	0	1	0	205	0	206
2744	1	0	213	0	0	214
2745	204	0	0	2	0	206
2746	0	1	1	213	0	215
2747	1	0	223	1	0	225
2748	207	0	0	1	0	208
2749	1	223	1	0	0	225
2750	224	0	0	1	0	225
2751	1	234	0	0	0	235
2752	2	0	0	231	0	233
2753	0	1	227	0	0	228
2754	1	0	0	226	0	227
2755	0	0	226	1	0	227
2756	218	0	1	1	0	220
2757	0	0	2	238	0	240
2758	239	0	0	1	0	240
2759	0	0	240	1	0	241
2760	240	0	0	0	0	240
2761	269	1	1	0	0	271
2762	3	0	270	0	0	273
2763	2	0	2	268	0	272
2764	1	0	270	2	0	273
2765	0	270	2	1	0	273
2766	269	6	1	0	0	276
2767	266	1	0	0	0	267
2768	3	0	277	0	0	280
2769	1	0	274	3	0	278
2770	1	0	3	282	0	286
2771	0	0	1	290	0	291
2772	293	0	0	3	0	296
2773	2	292	0	1	0	295
2774	297	2	0	1	0	300
2775	306	1	0	0	0	307
2776	2	0	293	0	0	295
2777	272	0	2	0	0	274
2778	2	0	305	0	0	307
2779	1	0	2	297	0	300
2780	0	0	321	2	0	323
2781	1	0	2	311	0	314
2782	0	0	321	2	0	323
2783	309	0	2	1	0	312
2784	326	0	1	0	0	327
2785	3	0	0	320	0	323
2786	328	0	0	2	0	330
2787	2	0	0	322	0	324
2788	1	327	0	4	0	332
2789	334	2	0	1	0	337
2790	2	335	0	0	0	337
2791	2	2	0	344	0	348
2792	0	0	0	346	0	346
2793	0	0	0	343	0	343
2794	1	0	0	336	0	337
2795	1	0	336	3	0	340
2796	311	0	2	1	0	314
2797	330	0	1	0	0	331
2798	3	337	0	0	0	340
2799	1	2	0	337	0	340
2800	0	1	0	342	0	343
2801	0	0	334	3	0	337
2802	315	0	2	1	0	318
2803	2	0	1	333	0	336
2804	1	0	337	2	0	340
2805	322	0	2	1	0	325
2806	328	0	1	0	0	329
2807	323	0	0	0	0	323
2808	3	0	321	0	0	324
2809	1	0	310	0	0	311
2810	316	0	3	0	0	319
2811	2	0	1	331	0	334
2812	0	0	0	348	0	348
2813	0	0	342	3	0	345
2814	327	0	2	0	0	329
2815	2	0	1	334	0	337
2816	360	0	0	2	0	362
2817	363	0	0	2	0	365
2818	355	0	1	0	0	356
2819	3	0	363	0	0	366
2820	1	0	2	363	0	366
2821	372	0	1	3	0	376
2822	2	378	0	1	0	381
2823	1	3	0	385	0	389
2824	0	1	0	393	0	394
2825	384	0	0	4	0	388
2826	378	0	0	2	0	380
2827	4	0	0	374	0	378
2828	1	0	360	3	0	364
2829	344	0	3	1	0	348
2830	3	0	359	1	0	363
2831	358	1	3	0	0	362
2832	366	0	1	1	0	368
2833	8	0	363	0	0	371
2834	3	0	4	363	0	370
2835	2	0	389	7	0	398
2836	0	414	9	1	0	424
2837	1	13	1	409	0	424
2838	1	428	2	10	0	441
2839	0	15	0	432	0	447
2840	0	2	442	14	0	458
2841	0	446	13	4	0	463
2842	1	464	0	0	0	465
2843	3	15	1	475	0	494
2844	474	2	0	17	0	493
2845	17	1	1	528	0	547
2846	547	0	0	19	0	566
2847	18	549	1	3	0	571
2848	627	19	0	0	0	646
2849	25	2	664	1	0	692
2850	4	1	23	659	0	687
2851	2	1	2	673	0	678
2852	2	0	657	22	0	681
2853	636	2	23	3	0	664
2854	680	0	4	3	0	687
2855	23	672	1	1	0	697
2856	7	23	1	631	0	662
2857	4	648	1	21	0	674
2858	3	23	645	1	0	672
2859	3	4	659	0	0	666
2860	5	6	21	628	0	660
2861	624	3	4	21	0	652
2862	20	616	2	7	0	645
2863	623	21	2	4	0	650
2864	23	5	613	0	0	641
2865	623	3	21	2	0	649
2866	645	1	4	3	0	653
2867	27	1	625	3	0	656
2868	7	1	22	614	0	644
2869	617	3	5	20	0	645
2870	635	1	3	5	0	644
2871	636	1	4	1	0	642
2872	25	4	1	616	0	646
2873	5	0	613	25	0	643
2874	592	5	23	5	0	625
2875	28	1	614	3	0	646
2876	6	0	26	606	0	638
2877	5	2	3	617	0	627
2878	4	607	3	25	0	639
2879	1	27	609	3	0	640
2880	5	586	23	5	0	619
2881	5	606	7	2	0	620
2882	6	25	2	582	0	615
2883	4	5	589	23	0	621
2884	3	7	24	584	0	618
2885	3	3	597	24	0	627
2886	5	2	25	579	0	611
2887	5	1	4	604	0	614
2888	4	3	569	28	0	604
2889	3	1	25	566	0	595
2890	2	3	572	26	0	603
2891	4	2	583	4	0	593
2892	3	562	25	3	0	593
2893	570	24	5	8	0	607
2894	26	3	577	4	0	610
2895	558	5	27	4	0	594
2896	28	2	7	577	0	614
2897	8	3	575	24	0	610
2898	5	562	24	5	0	596
2899	4	23	4	569	0	600
2900	1	5	571	22	0	599
2901	4	3	24	547	0	578
2902	4	566	8	20	0	598
2903	579	24	4	5	0	612
2904	24	4	2	581	0	611
2905	582	3	4	26	0	615
2906	590	1	5	5	0	601
2907	601	1	4	3	0	609
2908	596	1	7	4	0	608
2909	581	2	2	5	0	590
2910	26	551	3	17	0	597
2911	8	19	6	563	0	596
2912	6	2	5	571	0	584
2913	5	2	1	570	0	578
2914	2	6	551	25	0	584
2915	4	549	23	8	0	584
2916	538	23	6	5	0	572
2917	555	4	6	3	0	568
2918	26	538	6	4	0	574
2919	3	563	1	7	0	574
2920	537	26	4	2	0	569
2921	27	8	520	3	0	558
2922	7	3	24	510	0	544
2923	508	1	11	30	0	550
2924	29	1	2	502	0	534
2925	6	510	2	27	0	545
2926	5	22	4	506	0	537
2927	3	4	505	29	0	541
2928	499	2	22	7	0	530
2929	544	4	2	2	0	552
2930	34	1	2	507	0	544
2931	5	3	5	529	0	542
2932	496	2	2	28	0	528
2933	28	496	4	4	0	532
2934	8	21	3	484	0	516
2935	4	5	0	496	0	505
2936	453	1	1	21	0	476
2937	17	454	3	3	0	477
2938	429	14	2	3	0	448
2939	15	430	1	5	0	451
2940	4	435	1	2	0	442
2941	421	16	2	5	0	444
2942	15	438	3	1	0	457
2943	3	14	7	407	0	431
2944	3	1	410	13	0	427
2945	1	2	352	3	0	358
2946	1	1	331	2	0	335
2947	0	318	13	1	0	332
2948	229	10	6	0	0	245
2949	9	2	0	212	0	223
2950	2	0	1	219	0	222
2951	1	1	211	11	0	224
2952	214	1	10	2	0	227
2953	9	0	2	221	0	232
2954	1	0	3	226	0	230
2955	0	0	4	224	0	228
2956	214	1	2	11	0	228
2957	10	1	208	1	0	220
2958	211	0	9	0	0	220
2959	9	3	1	214	0	227
2960	2	1	215	10	0	228
2961	208	0	12	1	0	221
2962	12	0	211	1	0	224
2963	1	0	8	209	0	218
2964	0	0	216	11	0	227
2965	1	0	204	3	0	208
2966	198	0	9	0	0	207
2967	8	0	203	0	0	211
2968	3	0	7	198	0	208
2969	195	0	2	11	0	208
2970	10	0	3	195	0	208
2971	4	0	198	7	0	209
2972	1	0	198	1	0	200
2973	0	192	9	3	0	204
2974	2	7	5	194	0	208
2975	184	1	3	7	0	195
2976	9	187	2	3	0	201
2977	189	7	3	1	0	200
2978	9	1	1	184	0	195
2979	187	1	1	8	0	197
2980	8	184	1	5	0	198
2981	1	7	4	179	0	191
2982	181	2	2	7	0	192
2983	9	184	1	2	0	196
2984	3	7	0	186	0	196
2985	2	2	1	186	0	191
2986	181	2	2	8	0	193
2987	11	2	0	178	0	191
2988	2	0	1	191	0	194
2989	2	1	0	191	0	194
2990	1	3	169	10	0	183
2991	164	1	8	2	0	175
2992	11	1	1	189	0	202
2993	2	2	211	9	0	224
2994	217	2	9	4	0	232
2995	12	0	223	3	0	238
2996	4	0	8	221	0	233
2997	0	222	2	12	0	236
2998	0	10	2	234	0	246
2999	0	2	228	12	0	242
3000	2	0	252	2	0	256
3001	3	1	11	236	0	251
3002	1	1	238	12	0	252
3003	224	1	11	3	0	239
3004	12	0	227	2	0	241
3005	3	1	12	220	0	236
3006	1	2	1	234	0	238
3007	0	1	3	232	0	236
3008	223	0	2	13	0	238
3009	231	1	5	2	0	239
3010	231	1	1	4	0	237
3011	11	1	2	223	0	237
3012	4	0	2	232	0	238
3013	2	0	221	12	0	235
3014	1	0	228	3	0	232
3015	3	215	10	6	0	234
3016	1	11	4	201	0	217
3017	4	1	0	205	0	210
3018	2	195	2	9	0	208
3019	198	6	1	3	0	208
3020	8	199	2	2	0	211
3021	198	6	2	3	0	209
3022	8	1	1	198	0	208
3023	199	1	4	6	0	210
3024	8	1	1	200	0	210
3025	1	1	196	8	0	206
3026	0	0	7	201	0	208
3027	187	1	4	8	0	200
3028	7	1	4	184	0	196
3029	4	3	0	190	0	197
3030	1	1	185	9	0	196
3031	1	0	7	188	0	196
3032	2	2	1	185	0	190
3033	3	181	0	10	0	194
3034	1	8	1	183	0	193
3035	4	1	2	189	0	196
3036	3	1	0	186	0	190
3037	2	184	0	10	0	196
3038	2	5	0	186	0	193
3039	178	3	3	7	0	191
3040	7	173	2	4	0	186
3041	1	164	0	3	0	168
3042	0	155	0	2	0	157
3043	0	7	0	143	0	150
3044	0	141	1	5	0	147
3045	0	150	0	2	0	152
3046	145	3	2	1	0	151
3047	6	1	144	0	0	151
3048	139	0	6	1	0	146
3049	4	0	0	138	0	142
3050	0	2	139	4	0	145
3051	130	1	3	3	0	137
3052	3	1	133	1	0	138
3053	2	0	132	1	0	135
3054	131	1	4	2	0	138
3055	2	0	4	134	0	140
3056	5	0	133	4	0	142
3057	133	0	8	2	0	143
3058	138	0	2	4	0	144
3059	5	1	137	2	0	145
3060	141	0	3	4	0	148
3061	146	0	4	1	0	151
3062	7	0	142	2	0	151
3063	147	0	3	2	0	152
3064	139	0	3	3	0	145
3065	8	0	133	2	0	143
3066	2	0	154	1	0	157
3067	1	0	6	151	0	158
3068	0	2	154	6	0	162
3069	153	0	5	6	0	164
3070	5	0	4	150	0	159
3071	4	2	1	163	0	170
3072	3	1	156	8	0	168
3073	1	2	4	161	0	168
3074	3	0	157	7	0	167
3075	150	2	5	6	0	163
3076	163	0	4	0	0	167
3077	7	1	153	4	0	165
3078	161	0	7	1	0	169
3079	160	0	3	5	0	168
3080	11	1	168	0	0	180
3081	175	0	5	5	0	185
3082	168	1	4	2	0	175
3083	7	0	170	2	0	179
3084	170	0	5	4	0	179
3085	7	0	173	2	0	182
3086	3	1	3	172	0	179
3087	1	0	6	172	0	179
3088	1	0	0	183	0	184
3089	1	0	174	10	0	185
3090	165	2	3	5	0	175
3091	3	0	172	5	0	180
3092	4	147	4	2	0	157
3093	0	130	3	1	0	134
3094	112	5	0	0	0	117
3095	2	3	1	112	0	118
3096	4	113	0	1	0	118
3097	116	3	0	2	0	121
3098	113	3	0	1	0	117
3099	4	121	0	2	0	127
3100	3	4	1	98	0	106
3101	1	109	0	2	0	112
3102	110	2	1	3	0	116
3103	111	3	0	0	0	114
3104	6	0	0	107	0	113
3105	107	1	1	2	0	111
3106	4	0	0	106	0	110
3107	4	0	103	1	0	108
3108	99	0	2	4	0	105
3109	3	0	106	0	0	109
3110	5	0	2	98	0	105
3111	102	0	4	2	0	108
3112	4	0	0	108	0	112
3113	3	0	109	2	0	114
3114	0	0	113	5	0	118
3115	3	1	10	102	0	116
3116	105	0	3	3	0	111
3117	2	111	2	3	0	118
3118	4	1	1	110	0	116
3119	0	3	122	2	0	127
3120	122	0	2	3	0	127
3121	127	2	3	0	0	132
3122	5	0	123	1	0	129
3123	127	0	3	0	0	130
3124	3	1	3	124	0	131
3125	5	0	123	2	0	130
3126	122	0	3	3	0	128
3127	3	1	1	125	0	130
3128	3	0	0	125	0	128
3129	124	1	0	4	0	129
3130	3	117	0	3	0	123
3131	3	124	0	1	0	128
3132	123	4	0	1	0	128
3133	122	3	0	0	0	125
3134	3	1	122	1	0	127
3135	3	1	121	0	0	125
3136	1	0	3	123	0	127
3137	116	0	8	1	0	125
3138	118	0	1	4	0	123
3139	118	0	1	0	0	119
3140	3	113	0	3	0	119
3141	3	123	1	0	0	127
3142	1	4	1	128	0	134
3143	2	3	1	127	0	133
3144	2	1	0	134	0	137
3145	1	2	137	4	0	144
3146	0	0	127	4	0	131
3147	137	0	5	1	0	143
3148	142	0	3	1	0	146
3149	5	2	2	135	0	144
3150	4	0	2	138	0	144
3151	3	0	0	147	0	150
3152	3	0	137	4	0	144
3153	0	0	130	4	0	134
3154	1	0	3	133	0	137
3155	0	0	139	4	0	143
3156	0	137	2	3	0	142
3157	1	137	2	1	0	141
3158	138	2	1	1	0	142
3159	2	140	1	0	0	143
3160	2	1	1	134	0	138
3161	1	3	0	134	0	138
3162	1	145	2	2	0	150
3163	1	2	1	149	0	153
3164	0	1	150	4	0	155
3165	2	142	1	2	0	147
3166	2	1	0	134	0	137
3167	1	0	135	1	0	137
3168	1	132	0	0	0	133
3169	0	0	0	131	0	131
3170	0	132	1	0	0	133
3171	1	0	0	127	0	128
3172	0	0	0	123	0	123
3173	0	126	0	1	0	127
3174	127	0	0	0	0	127
3175	123	1	0	0	0	124
3176	0	127	0	0	0	127
3177	1	126	0	1	0	128
3178	1	0	0	126	0	127
3179	0	0	125	0	0	125
3180	112	0	1	0	0	113
3181	109	1	0	2	0	112
3182	0	1	111	1	0	113
3183	108	0	2	1	0	111
3184	112	0	0	1	0	113
3185	1	2	108	0	0	111
3186	105	1	1	0	0	107
3187	2	0	113	1	0	116
3188	0	111	0	2	0	113
3189	109	1	1	1	0	112
3190	110	0	1	1	0	112
3191	0	0	115	1	0	116
3192	120	0	0	1	0	121
3193	119	0	0	0	0	119
3194	0	0	123	1	0	124
3195	117	1	0	3	0	121
3196	124	0	0	1	0	125
3197	1	0	122	0	0	123
3198	117	0	2	0	0	119
3199	0	0	2	111	0	113
3200	0	0	1	111	0	112
3201	2	1	111	0	0	114
3202	2	1	109	0	0	112
3203	1	0	1	112	0	114
3204	1	2	0	111	0	114
3205	122	1	0	1	0	124
3206	0	0	124	2	0	126
3207	122	1	0	1	0	124
3208	1	0	0	130	0	131
3209	0	0	136	0	0	136
3210	138	1	0	0	0	139
3211	2	0	0	148	0	150
3212	1	0	142	2	0	145
3213	137	1	2	2	0	142
3214	1	0	1	142	0	144
3215	141	1	1	3	0	146
3216	1	0	142	1	0	144
3217	2	0	0	132	0	134
3218	1	141	1	1	0	144
3219	133	1	0	1	0	135
3220	126	2	0	3	0	131
3221	1	139	1	1	0	142
3222	145	1	0	0	0	146
3223	147	1	1	1	0	150
3224	146	0	1	1	0	148
3225	3	145	1	0	0	149
3226	1	2	0	146	0	149
3227	1	2	144	1	0	148
3228	1	0	2	141	0	144
3229	0	2	1	139	0	142
3230	1	1	140	2	0	144
3231	1	0	144	2	0	147
3232	1	1	2	128	0	132
3233	0	143	1	2	0	146
3234	144	1	1	2	0	148
3235	144	2	0	0	0	146
3236	4	148	0	1	0	153
3237	150	3	1	0	0	154
3238	152	2	0	3	0	157
3239	2	0	155	0	0	157
3240	150	1	1	2	0	154
3241	1	150	1	3	0	155
3242	1	1	147	0	0	149
3243	0	2	141	0	0	143
3244	0	138	2	1	0	141
3245	132	2	1	0	0	135
3246	3	1	136	0	0	140
3247	4	0	0	137	0	141
3248	0	1	141	1	0	143
3249	133	0	1	2	0	136
3250	3	0	190	0	0	193
3251	1	0	188	0	0	189
3252	194	0	2	0	0	196
3253	1	200	2	0	0	203
3254	202	1	1	0	0	204
3255	196	1	2	1	0	200
3256	2	2	0	198	0	202
3257	3	224	0	1	0	228
3258	223	1	2	2	0	228
3259	1	1	226	2	0	230
3260	214	0	2	0	0	216
3261	2	229	1	0	0	232
3262	215	1	2	2	0	220
3263	217	1	2	0	0	220
3264	4	224	0	0	0	228
3265	1	3	0	231	0	235
3266	235	1	0	1	0	237
3267	3	231	0	1	0	235
3268	1	1	0	242	0	244
3269	249	2	0	0	0	251
3270	3	0	0	260	0	263
3271	2	0	1	251	0	254
3272	1	259	0	4	0	264
3273	256	4	0	1	0	261
3274	257	1	0	1	0	259
3275	262	0	0	0	0	262
3276	4	275	0	0	0	279
3277	280	3	0	2	0	285
3278	282	1	0	0	0	283
3279	4	1	0	273	0	278
3280	1	0	0	281	0	282
3281	1	0	281	4	0	286
3282	0	0	4	281	0	285
3283	0	0	1	277	0	278
3284	0	1	285	4	0	290
3285	247	0	3	3	0	253
3286	3	0	288	0	0	291
3287	2	0	297	0	0	299
3288	0	1	4	303	0	308
3289	1	0	1	310	0	312
3290	1	312	0	4	0	317
3291	303	3	0	2	0	308
3292	301	1	0	1	0	303
3293	2	303	1	0	0	306
3294	1	307	0	1	0	309
3295	0	4	0	312	0	316
3296	0	317	1	2	0	320
3297	321	3	0	1	0	325
3298	319	1	1	1	0	322
3299	4	0	1	319	0	324
3300	1	0	0	318	0	319
3301	324	0	0	5	0	329
3302	3	0	316	1	0	320
3303	303	0	2	1	0	306
3304	4	0	318	0	0	322
3305	304	1	3	0	0	308
3306	3	1	1	309	0	314
3307	1	0	322	4	0	327
3308	0	1	314	1	0	316
3309	307	0	3	1	0	311
3310	316	0	1	0	0	317
3311	3	324	0	1	0	328
3312	1	3	0	345	0	349
3313	1	1	0	372	0	374
3314	361	0	0	6	0	367
3315	4	361	0	1	0	366
3316	362	5	1	0	0	368
3317	6	355	0	0	0	361
3318	0	352	0	1	0	353
3319	358	5	0	0	0	363
3320	5	0	359	1	0	365
3321	1	0	5	355	0	361
3322	4	0	0	355	0	359
3323	1	1	349	5	0	356
3324	0	0	5	344	0	349
3325	1	0	1	318	0	320
3326	0	352	1	3	0	356
3327	354	5	0	1	0	360
3328	5	0	357	1	0	363
3329	348	1	5	1	0	355
3330	7	370	1	0	0	378
3331	0	5	1	370	0	376
3332	389	0	0	4	0	393
3333	5	2	0	385	0	392
3334	0	1	0	391	0	392
3335	5	1	386	5	0	397
3336	367	0	6	3	0	376
3337	382	0	2	4	0	388
3338	5	0	391	1	0	397
3339	2	0	6	389	0	397
3340	2	1	398	6	0	407
3341	395	0	7	2	0	404
3342	422	1	0	2	0	425
3343	6	0	1	419	0	426
3344	416	0	1	10	0	427
3345	8	0	432	0	0	440
3346	0	1	5	428	0	434
3347	1	1	0	420	0	422
3348	1	1	2	435	0	439
3349	1	0	0	437	0	438
3350	379	0	0	9	0	388
3351	5	0	381	4	0	390
3352	1	0	6	382	0	389
3353	4	0	379	5	0	388
3354	2	0	380	0	0	382
3355	1	0	6	384	0	391
3356	0	0	4	380	0	384
3357	361	0	3	6	0	370
3358	7	0	1	358	0	366
3359	2	0	0	370	0	372
3360	5	0	0	372	0	377
3361	360	0	1	8	0	369
3362	359	1	1	3	0	364
3363	362	0	1	5	0	368
3364	353	0	0	4	0	357
3365	7	374	0	4	0	385
3366	3	6	0	379	0	388
3367	6	0	2	382	0	390
3368	378	3	1	7	0	389
3369	5	388	2	4	0	399
3370	1	4	4	401	0	410
3371	4	1	447	6	0	458
3372	496	2	7	4	0	509
3373	9	540	1	5	0	555
3374	571	8	2	6	0	587
3375	588	0	1	4	0	593
3376	11	2	1	587	0	601
3377	7	1	593	12	0	613
3378	7	1	11	607	0	626
3379	618	0	2	15	0	635
3380	15	0	5	612	0	632
3381	609	1	2	16	0	628
3382	18	613	1	3	0	635
3383	640	12	2	8	0	662
3384	18	1	0	647	0	666
3385	4	5	2	684	0	695
3386	692	2	4	15	0	713
3387	686	2	0	9	0	697
3388	688	0	3	8	0	699
3389	687	1	3	6	0	697
3390	677	2	1	10	0	690
3391	21	1	5	665	0	692
3392	10	0	646	20	0	676
3393	13	663	12	5	0	693
3394	648	12	3	15	0	678
3395	21	1	651	4	0	677
3396	640	6	15	4	0	665
3397	21	646	3	4	0	674
3398	653	16	4	10	0	683
3399	24	1	1	657	0	683
3400	10	6	2	665	0	683
3401	12	2	649	17	0	680
3402	10	3	17	651	0	681
3403	12	1	652	20	0	685
3404	12	1	662	5	0	680
3405	663	3	17	12	0	695
3406	704	2	9	5	0	720
3407	21	6	682	6	0	715
3408	690	2	15	6	0	713
3409	704	2	5	5	0	716
3410	20	4	687	7	0	718
3411	11	683	14	5	0	713
3412	14	14	6	703	0	737
3413	698	1	6	18	0	723
3414	703	8	2	5	0	718
3415	711	1	4	7	0	723
3416	709	3	1	8	0	721
3417	707	2	7	5	0	721
3418	24	2	701	3	0	730
3419	14	2	704	9	0	729
3420	15	7	18	694	0	734
3421	706	4	9	13	0	732
3422	720	4	4	2	0	730
3423	724	3	4	7	0	738
3424	696	1	8	5	0	710
3425	18	704	3	9	0	734
3426	14	753	6	14	0	787
3427	755	11	5	12	0	783
3428	760	5	4	9	0	778
3429	24	750	5	5	0	784
3430	753	13	3	4	0	773
3431	23	7	744	3	0	777
3432	9	2	19	728	0	758
3433	11	2	718	17	0	748
3434	9	4	729	9	0	751
3435	15	0	15	732	0	762
3436	15	2	4	749	0	770
3437	17	1	763	15	0	796
3438	12	1	15	705	0	733
3439	10	5	4	751	0	770
3440	744	5	6	18	0	773
3441	743	2	7	8	0	760
3442	25	4	5	741	0	775
3443	12	6	734	14	0	766
3444	15	735	17	2	0	769
3445	746	11	5	9	0	771
3446	18	4	768	11	0	801
3447	10	749	17	5	0	781
3448	11	781	7	9	0	808
3449	790	11	5	11	0	817
3450	796	3	6	8	0	813
3451	18	4	10	779	0	811
3452	11	2	835	17	0	865
3453	12	2	19	816	0	849
3454	16	6	4	836	0	862
3455	18	2	4	839	0	863
3456	836	1	8	21	0	866
3457	21	816	7	7	0	851
3458	10	877	3	6	0	896
3459	11	12	11	847	0	881
3460	4	7	8	874	0	893
3461	876	8	3	20	0	907
3462	857	6	5	6	0	874
3463	883	2	2	8	0	895
3464	27	870	2	8	0	907
3465	854	12	6	6	0	878
3466	22	2	4	847	0	875
3467	7	3	840	22	0	872
3468	8	0	791	9	0	808
3469	792	3	10	11	0	816
3470	25	0	816	4	0	845
3471	9	4	753	2	0	768
3472	640	5	11	3	0	659
3473	10	1	666	3	0	680
3474	0	1	646	0	0	647
3475	1	2	7	618	0	628
3476	0	0	665	5	0	670
3477	1	0	5	629	0	635
3478	1	0	1	605	0	607
3479	3	0	637	3	0	643
3480	1	654	4	0	0	659
3481	652	3	0	1	0	656
3482	4	2	665	0	0	671
3483	0	0	641	0	0	641
3484	522	0	6	3	0	531
3485	1	0	625	1	0	627
3486	1	607	1	1	0	610
3487	1	553	2	1	0	557
3488	1	1	0	630	0	632
3489	2	1	1	608	0	612
3490	644	1	0	3	0	648
3491	644	1	0	3	0	648
3492	643	0	0	2	0	645
3493	4	0	0	628	0	632
3494	650	1	0	2	0	653
3495	620	0	1	2	0	623
3496	3	0	643	0	0	646
3497	2	0	603	1	0	606
3498	0	644	3	0	0	647
3499	0	1	2	651	0	654
3500	654	1	0	2	0	657
3501	1	652	0	2	0	655
3502	2	0	1	657	0	660
3503	656	1	0	3	0	660
3504	633	0	0	3	0	636
3505	3	655	1	0	0	659
3506	643	1	0	0	0	644
3507	621	1	0	1	0	623
3508	2	0	0	615	0	617
3509	1	1	634	1	0	637
3510	1	613	1	2	0	617
3511	0	614	1	2	0	617
3512	588	1	0	0	0	589
3513	1	1	0	586	0	588
3514	1	0	590	1	0	592
3515	1	594	2	1	0	598
3516	598	1	1	1	0	601
3517	592	1	1	2	0	596
3518	2	0	617	1	0	620
3519	3	0	1	593	0	597
3520	1	0	2	625	0	628
3521	1	2	675	2	0	680
3522	642	2	3	1	0	648
3523	832	1	1	1	0	835
3524	17	0	1	1020	0	1038
3525	7	1072	0	26	0	1105
3526	5	27	0	1144	0	1176
3527	5	18	1145	35	0	1203
3528	1137	5	31	23	0	1196
3529	32	2	21	1187	0	1242
3530	23	1	1169	34	0	1227
3531	1136	4	33	25	0	1198
3532	32	1	23	1178	0	1234
3533	20	2	11	1178	0	1211
3534	1164	1	3	53	0	1221
3535	34	1149	3	31	0	1217
3536	1162	31	4	11	0	1208
3537	43	21	2	1139	0	1205
3538	1156	8	2	37	0	1203
3539	44	2	1137	30	0	1213
3540	28	1138	33	15	0	1214
3541	10	39	22	1153	0	1224
3542	1143	24	7	41	0	1215
3543	33	1147	7	24	0	1211
3544	33	34	4	1152	0	1223
3545	1152	23	6	41	0	1222
3546	1139	12	8	24	0	1183
3547	62	2	4	1110	0	1178
3548	33	3	1107	44	0	1187
3549	14	4	1090	33	0	1141
3550	1073	3	53	20	0	1149
3551	43	1078	27	9	0	1157
3552	34	1067	11	5	0	1117
3553	1042	51	6	10	0	1109
3554	42	1080	5	7	0	1134
3555	24	44	10	1066	0	1144
3556	17	29	5	1105	0	1156
3557	1076	15	3	63	0	1157
3558	1080	8	2	33	0	1123
3559	1097	6	0	14	0	1117
3560	66	10	1033	14	0	1123
3561	38	5	34	1042	0	1119
3562	19	3	1042	43	0	1107
3563	16	0	1050	33	0	1099
3564	14	1	1083	13	0	1111
3565	10	4	67	1013	0	1094
3566	10	5	1059	42	0	1116
3567	10	7	1073	29	0	1119
3568	6	7	64	1016	0	1093
3569	1032	6	33	45	0	1116
3570	46	9	1028	26	0	1109
3571	28	6	45	1014	0	1093
3572	18	1	30	1055	0	1104
3573	13	3	1042	66	0	1124
3574	9	6	44	1046	0	1105
3575	20	5	1050	51	0	1126
3576	13	5	50	1017	0	1085
3577	12	8	24	1055	0	1099
3578	13	4	16	1066	0	1099
3579	6	8	17	1075	0	1106
3580	978	1	16	73	0	1068
3581	1014	2	14	43	0	1073
3582	65	5	982	25	0	1077
3583	32	964	50	20	0	1066
3584	22	37	996	15	0	1070
3585	13	24	991	16	0	1044
3586	955	7	67	11	0	1040
3587	52	983	35	14	0	1084
3588	994	42	19	18	0	1073
3589	53	1007	23	11	0	1094
3590	993	49	15	17	0	1074
3591	1019	27	17	14	0	1077
3592	71	10	14	972	0	1067
3593	34	994	12	45	0	1085
3594	23	42	4	1014	0	1083
3595	16	30	10	1039	0	1095
3596	17	15	973	72	0	1077
3597	16	973	38	44	0	1071
3598	15	41	34	978	0	1068
3599	939	34	14	49	0	1036
3600	996	12	15	39	0	1062
3601	1010	6	16	23	0	1055
3602	72	971	18	12	0	1073
3603	1017	45	9	15	0	1086
3604	57	1049	15	11	0	1132
3605	36	52	7	1064	0	1159
3606	25	31	1045	49	0	1150
3607	18	14	51	1067	0	1150
3608	13	1055	35	53	0	1156
3609	15	46	17	1082	0	1160
3610	12	33	10	1071	0	1126
3611	15	1064	9	76	0	1164
3612	1064	46	15	49	0	1174
3613	57	32	7	1062	0	1158
3614	34	19	1054	60	0	1167
3615	19	8	47	1087	0	1161
3616	15	6	40	1104	0	1165
3617	13	6	1056	80	0	1155
3618	13	8	48	1035	0	1104
3619	12	1027	37	61	0	1137
3620	9	48	1040	42	0	1139
3621	12	31	1006	31	0	1080
3622	13	934	68	15	0	1030
3623	6	822	39	11	0	878
3624	5	631	9	8	0	653
3625	525	37	16	7	0	585
3626	475	7	9	2	0	493
3627	462	1	1	11	0	475
3628	22	4	3	456	0	485
3629	8	3	445	17	0	473
3630	3	1	11	465	0	480
3631	3	5	7	457	0	472
3632	451	0	3	21	0	475
3633	460	1	2	13	0	476
3634	20	454	5	4	0	483
3635	455	14	2	7	0	478
3636	462	8	0	7	0	477
3637	469	3	2	3	0	477
3638	23	2	447	3	0	475
3639	13	5	443	1	0	462
3640	2	5	23	434	0	464
3641	2	0	440	12	0	454
3642	419	4	12	12	0	447
3643	437	5	8	3	0	453
3644	21	3	418	3	0	445
3645	412	1	10	3	0	426
3646	14	417	8	2	0	441
3647	427	12	2	2	0	443
3648	13	8	0	421	0	442
3649	11	2	4	408	0	425
3650	2	420	2	21	0	445
3651	413	11	1	12	0	437
3652	422	9	3	3	0	437
3653	22	413	2	2	0	439
3654	8	12	1	400	0	421
3655	5	8	0	394	0	407
3656	4	396	3	15	0	418
3657	6	10	1	393	0	410
3658	2	12	3	403	0	420
3659	395	5	3	16	0	419
3660	387	1	0	13	0	401
3661	18	1	382	4	0	405
3662	392	3	9	1	0	405
3663	15	0	383	5	0	403
3664	10	0	14	380	0	404
3665	5	1	381	12	0	399
3666	1	373	9	10	0	393
3667	5	9	8	376	0	398
3668	4	7	1	381	0	393
3669	372	3	1	16	0	392
3670	12	3	1	363	0	379
3671	13	2	345	9	0	369
3672	349	1	8	8	0	366
3673	360	2	11	3	0	376
3674	372	1	3	5	0	381
3675	355	0	2	7	0	364
3676	16	2	2	359	0	379
3677	12	2	2	368	0	384
3678	6	3	1	380	0	390
3679	5	1	3	399	0	408
3680	382	1	1	20	0	404
3681	375	3	3	10	0	391
3682	23	1	0	345	0	369
3683	9	347	6	13	0	375
3684	356	9	2	14	0	381
3685	12	10	347	5	0	374
3686	13	349	13	2	0	377
3687	333	9	7	3	0	352
3688	8	342	1	4	0	355
3689	9	12	327	4	0	352
3690	330	8	8	6	0	352
3691	340	4	9	2	0	355
3692	22	1	327	3	0	353
3693	13	2	9	331	0	355
3694	6	1	7	340	0	354
3695	3	327	4	22	0	356
3696	5	7	2	340	0	354
3697	337	7	2	12	0	358
3698	8	336	5	9	0	358
3699	11	9	0	335	0	355
3700	2	9	4	342	0	357
3701	4	5	331	17	0	357
3702	4	327	9	9	0	349
3703	298	10	6	6	0	320
3704	12	252	0	2	0	266
3705	3	224	1	3	0	231
3706	224	8	2	2	0	236
3707	10	3	1	203	0	217
3708	3	2	1	211	0	217
3709	206	0	0	10	0	216
3710	7	1	1	211	0	220
3711	2	1	0	211	0	214
3712	208	0	0	10	0	218
3713	7	0	0	204	0	211
3714	3	197	0	9	0	209
3715	195	3	0	3	0	201
3716	5	2	187	2	0	196
3717	3	185	4	2	0	194
3718	1	5	2	180	0	188
3719	2	1	168	4	0	175
3720	1	0	166	1	0	168
3721	0	2	4	159	0	165
3722	160	0	0	5	0	165
3723	4	0	0	160	0	164
3724	1	0	0	163	0	164
3725	1	0	0	164	0	165
3726	1	0	0	164	0	165
3727	0	0	0	164	0	164
3728	0	1	150	5	0	156
3729	1	0	155	1	0	157
3730	0	0	4	147	0	151
3731	0	0	151	3	0	154
3732	0	149	4	1	0	154
3733	0	4	1	147	0	152
3734	0	1	147	5	0	153
3735	137	0	4	2	0	143
3736	4	144	1	1	0	150
3737	1	144	0	1	0	146
3738	1	149	0	0	0	150
3739	1	4	0	147	0	152
3740	150	1	0	4	0	155
3741	5	1	0	150	0	156
3742	147	0	0	4	0	151
3743	3	148	1	1	0	153
3744	143	4	0	0	0	147
3745	4	1	0	143	0	148
3746	1	1	0	143	0	145
3747	0	141	1	4	0	146
3748	1	3	0	141	0	145
3749	1	1	0	144	0	146
3750	0	0	1	145	0	146
3751	139	0	0	5	0	144
3752	127	0	0	2	0	129
3753	4	0	139	0	0	143
3754	138	0	3	1	0	142
3755	4	0	136	0	0	140
3756	1	1	3	136	0	141
3757	0	0	1	140	0	141
3758	0	0	0	141	0	141
3759	0	0	138	3	0	141
3760	0	1	3	135	0	139
3761	1	0	140	2	0	143
3762	0	1	3	135	0	139
3763	137	1	1	3	0	142
3764	4	0	137	2	0	143
3765	132	0	3	1	0	136
3766	3	1	1	137	0	142
3767	139	0	0	3	0	142
3768	3	135	0	3	0	141
3769	1	3	1	137	0	142
3770	0	2	151	3	0	156
3771	1	4	3	148	0	156
3772	0	2	1	149	0	152
3773	1	141	0	3	0	145
3774	1	3	140	1	0	145
3775	0	146	3	1	0	150
3776	121	2	0	1	0	124
3777	4	132	0	0	0	136
3778	126	3	5	1	0	135
3779	125	0	0	1	0	126
3780	120	0	0	0	0	120
3781	3	1	0	121	0	125
3782	1	1	118	2	0	122
3783	2	0	2	116	0	120
3784	1	116	1	2	0	120
3785	0	3	0	120	0	123
3786	118	0	1	3	0	122
3787	2	116	1	3	0	122
3788	0	2	1	112	0	115
3789	0	0	0	116	0	116
3790	115	0	0	1	0	116
3791	1	0	113	1	0	115
3792	0	109	1	2	0	112
3793	0	1	0	99	0	100
3794	1	0	92	1	0	94
3795	0	0	2	90	0	92
3796	0	91	0	1	0	92
3797	0	1	0	97	0	98
3798	0	0	1	94	0	95
3799	0	0	0	90	0	90
3800	0	1	88	1	0	90
3801	85	0	1	1	0	87
3802	1	0	0	94	0	95
3803	100	0	0	2	0	102
3804	107	0	1	0	0	108
3805	111	0	0	0	0	111
3806	109	0	0	1	0	110
3807	110	0	0	0	0	110
3808	2	0	0	109	0	111
3809	1	106	0	2	0	109
3810	1	1	0	104	0	106
3811	1	107	0	1	0	109
3812	0	1	0	106	0	107
3813	101	1	0	1	0	103
3814	1	0	0	105	0	106
3815	0	1	102	1	0	104
3816	97	0	1	1	0	99
3817	2	104	0	0	0	106
3818	103	1	0	1	0	105
3819	103	0	1	1	0	105
3820	105	0	0	1	0	106
3821	1	106	0	0	0	107
3822	2	1	0	105	0	108
3823	2	0	0	105	0	107
3824	1	0	104	1	0	106
3825	0	1	1	97	0	99
3826	1	0	0	102	0	103
3827	1	0	0	103	0	104
3828	1	101	1	0	0	103
3829	104	1	0	2	0	107
3830	101	0	1	1	0	103
3831	1	0	107	2	0	110
3832	0	108	1	0	0	109
3833	1	1	0	107	0	109
3834	3	0	0	108	0	111
3835	1	1	1	102	0	105
3836	0	1	0	108	0	109
3837	0	0	0	108	0	108
3838	1	0	103	2	0	106
3839	0	0	99	1	0	100
3840	99	1	1	1	0	102
3841	106	0	0	2	0	108
3842	106	0	2	0	0	108
3843	1	0	1	103	0	105
3844	1	1	101	1	0	104
3845	101	0	1	1	0	103
3846	104	0	0	1	0	105
3847	1	0	100	2	0	103
3848	99	0	3	0	0	102
3849	3	0	117	0	0	120
3850	1	0	1	120	0	122
3851	1	0	120	1	0	122
3852	114	0	1	0	0	115
3853	121	0	1	0	0	122
3854	123	0	0	1	0	124
3855	129	0	1	1	0	131
3856	1	0	149	0	0	150
3857	1	151	2	0	0	154
3858	154	1	0	2	0	157
3859	153	0	1	0	0	154
3860	2	0	157	1	0	160
3861	1	1	1	152	0	155
3862	2	0	0	157	0	159
3863	2	0	154	1	0	157
3864	144	0	3	0	0	147
3865	154	1	0	1	0	156
3866	3	153	0	1	0	157
3867	156	1	1	0	0	158
3868	153	0	1	0	0	154
3869	160	1	0	1	0	162
3870	147	1	0	3	0	151
3871	3	0	147	1	0	151
3872	145	0	3	0	0	148
3873	4	0	0	147	0	151
3874	1	148	0	3	0	152
3875	1	1	143	1	0	146
3876	2	145	1	0	0	148
3877	1	1	0	131	0	133
3878	1	0	129	1	0	131
3879	111	0	2	0	0	113
3880	2	0	122	0	0	124
3881	116	0	2	0	0	118
3882	2	1	0	118	0	121
3883	0	0	0	117	0	117
3884	0	118	0	1	0	119
3885	0	126	0	1	0	127
3886	0	1	1	128	0	130
3887	138	0	0	1	0	139
3888	138	0	1	0	0	139
3889	138	0	0	0	0	138
3890	2	0	150	1	0	153
3891	149	0	1	1	0	151
3892	1	2	156	0	0	159
3893	1	1	152	0	0	154
3894	150	2	3	0	0	155
3895	156	0	1	0	0	157
3896	3	0	155	0	0	158
3897	2	1	1	146	0	150
3898	0	0	2	156	0	158
3899	155	0	0	2	0	157
3900	153	1	0	1	0	155
3901	2	0	177	0	0	179
3902	2	177	1	0	0	180
3903	1	174	0	0	0	175
3904	171	2	1	1	0	175
3905	1	1	0	173	0	175
3906	1	0	0	174	0	175
3907	1	0	0	176	0	177
3908	174	0	0	2	0	176
3909	1	0	1	176	0	178
3910	176	1	0	1	0	178
3911	174	1	0	1	0	176
3912	3	194	0	0	0	197
3913	2	1	0	215	0	218
3914	0	1	218	4	0	223
3915	211	0	3	2	0	216
3916	223	0	1	0	0	224
3917	218	0	0	1	0	219
3918	5	0	212	0	0	217
3919	1	0	3	210	0	214
3920	212	1	0	3	0	216
3921	215	0	0	2	0	217
3922	212	0	1	0	0	213
3923	5	211	0	0	0	216
3924	2	215	0	0	0	217
3925	1	3	0	218	0	222
3926	0	1	1	215	0	217
3927	0	215	0	5	0	220
3928	220	3	0	1	0	224
3929	4	1	228	0	0	233
3930	3	0	3	229	0	235
3931	0	1	1	228	0	230
3932	0	1	228	4	0	233
3933	215	0	3	3	0	221
3934	232	0	1	2	0	235
3935	4	230	0	0	0	234
3936	231	3	0	0	0	234
3937	3	1	242	0	0	246
3938	244	0	3	1	0	248
3939	3	0	254	1	0	258
3940	250	0	4	0	0	254
3941	273	0	1	1	0	275
3942	271	0	0	1	0	272
3943	271	1	0	0	0	272
3944	5	278	0	0	0	283
3945	282	3	1	1	0	287
3946	295	1	0	0	0	296
3947	4	0	298	0	0	302
3948	297	0	3	0	0	300
3949	3	0	1	293	0	297
3950	2	0	291	3	0	296
3951	292	0	3	1	0	296
3952	3	0	1	299	0	303
3953	302	0	0	3	0	305
3954	339	0	0	1	0	340
3955	4	0	361	0	0	365
3956	341	0	3	0	0	344
3957	346	0	0	1	0	347
3958	354	0	0	0	0	354
3959	358	0	0	0	0	358
3960	4	0	0	353	0	357
3961	2	357	0	3	0	362
3962	341	3	0	3	0	347
3963	357	1	0	2	0	360
3964	360	0	1	0	0	361
3965	4	0	357	0	0	361
3966	2	351	3	0	0	356
3967	1	3	1	352	0	357
3968	1	1	1	359	0	362
3969	0	0	362	3	0	365
3970	2	0	3	368	0	373
3971	1	0	367	3	0	371
3972	2	0	3	368	0	373
3973	1	1	1	396	0	399
3974	0	2	417	3	0	422
3975	402	1	3	2	0	408
3976	421	0	0	2	0	423
3977	4	0	434	1	0	439
3978	424	1	3	2	0	430
3979	435	0	2	0	0	437
3980	4	0	452	0	0	456
3981	2	0	3	443	0	448
3982	1	0	2	447	0	450
3983	453	0	1	4	0	458
3984	6	471	0	2	0	479
3985	442	5	0	2	0	449
3986	465	3	0	1	0	469
3987	5	467	1	0	0	473
3988	474	3	1	1	0	479
3989	477	1	1	0	0	479
3990	6	456	1	1	0	464
3991	3	5	1	462	0	471
3992	3	462	0	8	0	473
3993	2	6	0	467	0	475
3994	1	0	465	8	0	474
3995	2	2	464	0	0	468
3996	455	0	7	0	0	462
3997	487	1	1	0	0	489
3998	8	0	488	0	0	496
3999	482	0	8	1	0	491
4000	501	0	1	3	0	505
4001	477	0	1	0	0	478
4002	10	489	0	1	0	500
4003	3	7	0	501	0	511
4004	500	0	0	7	0	507
4005	494	1	1	0	0	496
4006	8	0	499	1	0	508
4007	4	0	7	489	0	500
4008	4	0	0	506	0	510
4009	2	498	2	6	0	508
4010	2	517	0	2	0	521
4011	0	7	0	509	0	516
4012	0	508	1	6	0	515
4013	484	6	0	0	0	490
4014	6	512	0	2	0	520
4015	524	8	0	2	0	534
4016	9	0	533	0	0	542
4017	562	1	8	0	0	571
4018	594	0	0	0	0	594
4019	602	0	2	1	0	605
4020	599	0	0	0	0	599
4021	21	574	2	0	0	597
4022	11	9	0	589	0	609
4023	7	4	0	585	0	596
4024	0	7	594	14	0	615
4025	1	1	9	589	0	600
4026	0	1	5	607	0	613
4027	604	1	9	14	0	628
4028	12	603	0	13	0	628
4029	7	10	0	606	0	623
4030	11	5	0	613	0	629
4031	2	8	1	620	0	631
4032	611	2	0	24	0	637
4033	13	0	0	621	0	634
4034	617	0	0	21	0	638
4035	20	0	1	608	0	629
4036	4	1	0	632	0	637
4037	8	0	603	18	0	629
4038	556	1	9	13	0	579
4039	11	601	6	8	0	626
4040	625	11	8	3	0	647
4041	19	5	0	603	0	627
4042	7	7	0	615	0	629
4043	632	1	1	14	0	648
4044	634	0	0	16	0	650
4045	21	0	0	667	0	688
4046	16	0	651	15	0	682
4047	10	1	661	8	0	680
4048	0	685	17	9	0	711
4049	702	14	13	2	0	731
4050	704	7	9	2	0	722
4051	23	8	2	686	0	719
4052	14	710	1	18	0	743
4053	11	17	0	718	0	746
4054	5	8	1	673	0	687
4055	4	638	0	20	0	662
4056	627	19	0	19	0	665
4057	18	5	3	634	0	660
4058	10	639	5	16	0	670
4059	11	679	0	6	0	696
4060	672	19	2	10	0	703
4061	23	14	651	4	0	692
4062	668	8	19	4	0	699
4063	29	5	8	670	0	712
4064	14	2	9	677	0	702
4065	14	670	2	25	0	711
4066	5	23	1	685	0	714
4067	9	6	665	33	0	713
4068	3	662	18	18	0	701
4069	5	671	7	14	0	697
4070	650	25	7	8	0	690
4071	23	664	4	4	0	695
4072	11	25	4	653	0	693
4073	12	653	2	28	0	695
4074	5	24	3	645	0	677
4075	5	10	1	665	0	681
4076	7	10	631	31	0	679
4077	6	4	16	630	0	656
4078	5	3	8	647	0	663
4079	622	5	9	30	0	666
4080	18	6	616	21	0	661
4081	12	4	19	631	0	666
4082	14	8	633	22	0	677
4083	621	3	23	17	0	664
4084	23	647	11	13	0	694
4085	687	22	8	12	0	729
4086	31	18	3	707	0	759
4087	17	8	6	714	0	745
4088	14	7	700	39	0	760
4089	650	3	21	33	0	707
4090	26	710	12	18	0	766
4091	722	19	13	11	0	765
4092	27	15	4	721	0	767
4093	16	724	7	23	0	770
4094	733	22	5	15	0	775
4095	22	745	5	10	0	782
4096	24	27	2	735	0	788
4097	13	18	3	748	0	782
4098	10	11	1	753	0	775
4099	3	714	5	48	0	770
4100	10	19	1	735	0	765
4101	7	16	3	746	0	772
4102	693	13	1	40	0	747
4103	705	9	5	27	0	746
4104	724	10	2	19	0	755
4105	40	10	701	9	0	760
4106	725	7	18	6	0	756
4107	738	9	12	14	0	773
4108	714	9	12	13	0	748
4109	41	8	675	13	0	737
4110	697	13	16	11	0	737
4111	29	7	12	699	0	747
4112	18	2	709	30	0	759
4113	13	709	20	21	0	763
4114	14	30	15	663	0	722
4115	10	657	9	22	0	698
4116	3	675	7	16	0	701
4117	629	25	3	7	0	664
4118	21	7	2	627	0	657
4119	638	4	3	18	0	663
4120	16	4	6	635	0	661
4121	639	3	4	22	0	668
4122	21	4	4	642	0	671
4123	648	6	2	16	0	672
4124	19	6	608	16	0	649
4125	13	6	16	619	0	654
4126	4	8	636	27	0	675
4127	10	8	614	11	0	643
4128	7	8	647	3	0	665
4129	7	10	20	635	0	672
4130	5	3	637	26	0	671
4131	620	7	12	18	0	657
4132	18	3	7	640	0	668
4133	9	6	687	25	0	727
4134	7	3	15	700	0	725
4135	11	8	6	707	0	732
4136	13	2	764	26	0	805
4137	10	3	17	759	0	789
4138	9	1	14	768	0	792
4139	10	771	6	22	0	809
4140	769	14	7	10	0	800
4141	787	5	6	5	0	803
4142	27	4	766	5	0	802
4143	746	5	18	4	0	773
4144	24	0	745	8	0	777
4145	10	5	700	8	0	723
4146	6	3	736	8	0	753
4147	7	9	23	680	0	719
4148	2	4	713	13	0	732
4149	5	5	8	686	0	704
4150	3	1	7	687	0	698
4151	5	2	0	706	0	713
4152	4	0	1	702	0	707
4153	693	3	2	14	0	712
4154	691	3	1	9	0	704
4155	17	702	2	6	0	727
4156	10	7	3	713	0	733
4157	6	3	738	11	0	758
4158	3	743	13	10	0	769
4159	2	14	11	766	0	793
4160	4	4	788	13	0	809
4161	4	0	15	766	0	785
4162	0	1	785	13	0	799
4163	4	3	755	9	0	771
4164	2	1	17	784	0	804
4165	1	2	11	794	0	808
4166	795	2	5	23	0	825
4167	17	0	3	802	0	822
4168	785	1	7	17	0	810
4169	15	789	3	10	0	817
4170	3	808	3	11	0	825
4171	4	17	3	807	0	831
4172	814	6	2	20	0	842
4173	19	808	0	6	0	833
4174	13	10	7	819	0	849
4175	846	6	3	20	0	875
4176	855	1	5	11	0	872
4177	843	2	8	1	0	854
4178	837	2	8	2	0	849
4179	866	0	4	7	0	877
4180	17	2	845	3	0	867
4181	10	10	820	5	0	845
4182	2	840	17	6	0	865
4183	2	13	12	831	0	858
4184	2	2	816	15	0	835
4185	2	0	774	4	0	780
4186	5	3	11	746	0	765
4187	2	1	806	11	0	820
4188	0	0	776	2	0	778
4189	1	1007	10	0	0	1018
4190	1016	17	1	3	0	1037
4191	19	1118	1	2	0	1140
4192	1	22	3	1156	0	1182
4193	1171	3	0	24	0	1198
4194	23	1203	1	3	0	1230
4195	4	24	3	1186	0	1217
4196	3	3	1195	24	0	1225
4197	1174	1	25	6	0	1206
4198	1232	1	4	2	0	1239
4199	1263	1	1	3	0	1268
4200	31	1	0	1258	0	1290
4201	5	1	1258	25	0	1289
4202	2	1255	25	5	0	1287
4203	4	28	3	1256	0	1291
4204	1253	2	0	24	0	1279
4205	26	3	1242	4	0	1275
4206	5	1214	26	7	0	1252
4207	2	25	1244	2	0	1273
4208	1209	4	29	1	0	1243
4209	1268	3	2	6	0	1279
4210	1284	1	2	4	0	1291
4211	31	2	1230	2	0	1265
4212	4	1184	29	3	0	1220
4213	5	27	4	1192	0	1228
4214	6	3	2	1217	0	1228
4215	8	2	1	1231	0	1242
4216	3	1	1202	32	0	1238
4217	1153	5	29	6	0	1193
4218	27	1	1197	6	0	1231
4219	1171	2	29	3	0	1205
4220	1221	2	4	4	0	1231
4221	1227	2	1	6	0	1236
4222	1190	1	6	5	0	1202
4223	29	5	1180	2	0	1216
4224	6	1	27	1192	0	1226
4225	8	3	1169	29	0	1209
4226	6	1135	26	5	0	1172
4227	3	1186	2	4	0	1195
4228	1167	28	7	2	0	1204
4229	1147	10	3	2	0	1162
4230	29	1184	2	6	0	1221
4231	1197	27	1	8	0	1233
4232	36	8	1098	1	0	1143
4233	1109	7	20	2	0	1138
4234	32	1147	8	5	0	1192
4235	1172	30	5	5	0	1212
4236	1136	2	5	3	0	1146
4237	36	7	5	1093	0	1141
4238	12	4	4	1121	0	1141
4239	1096	5	6	34	0	1141
4240	36	3	4	1095	0	1138
4241	1096	5	4	36	0	1141
4242	36	3	4	1098	0	1141
4243	1089	0	7	34	0	1130
4244	1094	1	7	5	0	1107
4245	37	1049	3	5	0	1094
4246	13	1091	6	3	0	1113
4247	1056	32	2	3	0	1093
4248	32	1055	2	5	0	1094
4249	19	28	4	1039	0	1090
4250	15	9	5	1067	0	1096
4251	1028	11	2	42	0	1083
4252	40	1033	6	10	0	1089
4253	13	1006	7	8	0	1034
4254	16	1042	3	9	0	1070
4255	14	31	1010	6	0	1061
4256	23	7	1003	5	0	1038
4257	10	12	999	7	0	1028
4258	25	25	36	860	0	946
4259	12	929	10	29	0	980
4260	923	26	4	15	0	968
4261	31	9	912	15	0	967
4262	15	7	924	10	0	956
4263	13	6	949	15	0	983
4264	10	2	36	910	0	958
4265	17	7	6	940	0	970
4266	15	8	11	940	0	974
4267	935	7	5	31	0	978
4268	937	6	9	8	0	960
4269	939	10	5	9	0	963
4270	38	7	6	914	0	965
4271	14	7	910	28	0	959
4272	13	6	925	9	0	953
4273	6	12	35	907	0	960
4274	9	4	11	918	0	942
4275	874	9	10	30	0	923
4276	37	861	8	12	0	918
4277	869	22	7	8	0	906
4278	38	859	10	6	0	913
4279	18	26	5	856	0	905
4280	15	6	865	24	0	910
4281	13	5	26	865	0	909
4282	874	5	12	31	0	922
4283	32	1	877	13	0	923
4284	855	4	31	9	0	899
4285	30	5	864	10	0	909
4286	17	6	870	8	0	901
4287	806	6	24	9	0	845
4288	39	2	823	7	0	871
4289	12	2	595	3	0	612
4290	9	570	28	4	0	611
4291	438	20	28	9	0	495
4292	424	4	3	5	0	436
4293	421	1	2	4	0	428
4294	7	0	398	4	0	409
4295	380	1	5	4	0	390
4296	9	397	1	1	0	408
4297	376	6	2	2	0	386
4298	9	2	377	0	0	388
4299	2	3	12	337	0	354
4300	0	0	331	5	0	336
4301	2	325	4	2	0	333
4302	2	2	1	314	0	319
4303	1	0	3	317	0	321
4304	322	1	2	3	0	328
4305	330	1	1	0	0	332
4306	330	0	2	1	0	333
4307	331	0	1	1	0	333
4308	326	0	2	0	0	328
4309	3	0	326	0	0	329
4310	2	2	3	321	0	328
4311	3	2	341	2	0	348
4312	2	0	4	338	0	344
4313	345	0	2	3	0	350
4314	353	0	2	2	0	357
4315	361	1	2	0	0	364
4316	353	2	0	0	0	355
4317	4	1	348	6	0	359
4318	3	0	3	351	0	357
4319	1	2	357	3	0	363
4320	2	358	3	3	0	366
4321	2	349	3	1	0	355
4322	2	4	0	342	0	348
4323	1	1	1	368	0	371
4324	1	0	4	384	0	389
4325	2	0	1	416	0	419
4326	419	0	1	7	0	427
4327	6	418	0	6	0	430
4328	412	4	0	3	0	419
4329	7	4	0	404	0	415
4330	8	2	1	397	0	408
4331	4	400	2	9	0	415
4332	1	4	3	403	0	411
4333	390	4	1	11	0	406
4334	5	371	2	4	0	382
4335	4	354	0	2	0	360
4336	355	8	0	0	0	363
4337	2	6	0	362	0	370
4338	4	363	0	3	0	370
4339	4	2	0	370	0	376
4340	360	4	0	6	0	370
4341	4	2	0	360	0	366
4342	4	2	0	359	0	365
4343	355	0	0	7	0	362
4344	2	0	0	362	0	364
4345	4	352	0	6	0	362
4346	2	4	0	347	0	353
4347	0	349	0	6	0	355
4348	2	3	0	352	0	357
4349	342	4	0	4	0	350
4350	349	4	0	4	0	357
4351	8	0	0	352	0	360
4352	6	0	349	4	0	359
4353	329	1	2	4	0	336
4354	3	0	348	3	0	354
4355	346	0	4	0	0	350
4356	351	0	4	2	0	357
4357	7	0	357	2	0	366
4358	8	358	3	1	0	370
4359	360	3	3	3	0	369
4360	374	6	2	2	0	384
4361	7	3	408	3	0	421
4362	415	2	3	0	0	420
4363	397	0	4	3	0	404
4364	407	0	2	1	0	410
4365	11	1	0	390	0	402
4366	5	0	0	397	0	402
4367	3	396	1	7	0	407
4368	2	3	0	393	0	398
4369	0	5	2	388	0	395
4370	4	2	379	7	0	392
4371	1	1	352	7	0	361
4372	336	1	8	4	0	349
4373	360	1	6	2	0	369
4374	9	361	2	1	0	373
4375	7	4	0	365	0	376
4376	2	4	366	5	0	377
4377	4	2	3	376	0	385
4378	1	1	6	364	0	372
4379	1	2	2	395	0	400
4380	1	391	1	13	0	406
4381	0	5	0	399	0	404
4382	1	8	0	391	0	400
4383	3	2	383	10	0	398
4384	3	1	382	9	0	395
4385	368	0	10	7	0	385
4386	378	0	9	4	0	391
4387	11	1	1	430	0	443
4388	8	2	2	419	0	431
4389	3	3	0	438	0	444
4390	2	1	412	19	0	434
4391	0	404	10	10	0	424
4392	0	10	417	6	0	433
4393	405	6	8	3	0	422
4394	10	5	426	3	0	444
4395	420	4	9	3	0	436
4396	415	1	6	3	0	425
4397	441	0	2	3	0	446
4398	15	1	4	420	0	440
4399	10	1	422	11	0	444
4400	7	416	8	11	0	442
4401	2	8	7	418	0	435
4402	1	8	3	431	0	443
4403	3	3	432	14	0	452
4404	1	427	10	10	0	448
4405	434	10	10	5	0	459
4406	11	462	2	3	0	478
4407	505	12	2	1	0	520
4408	13	13	1	520	0	547
4409	9	3	566	13	0	591
4410	7	561	11	9	0	588
4411	568	12	7	5	0	592
4412	13	7	570	2	0	592
4413	572	2	11	5	0	590
4414	572	3	12	2	0	589
4415	20	2	565	1	0	588
4416	564	0	8	6	0	578
4417	575	0	12	2	0	589
4418	565	4	4	0	0	573
4419	22	552	2	2	0	578
4420	549	10	4	2	0	565
4421	16	565	3	2	0	586
4422	11	13	567	3	0	594
4423	6	576	13	4	0	599
4424	529	14	12	0	0	555
4425	529	6	5	1	0	541
4426	532	5	2	5	0	544
4427	19	2	3	520	0	544
4428	8	4	3	531	0	546
4429	508	4	3	16	0	531
4430	532	1	2	8	0	543
4431	15	2	5	510	0	532
4432	12	2	508	11	0	533
4433	6	495	12	7	0	520
4434	9	516	5	1	0	531
4435	7	15	1	509	0	532
4436	7	5	513	14	0	539
4437	2	5	14	496	0	517
4438	6	512	6	11	0	535
4439	3	14	1	517	0	535
4440	3	3	514	13	0	533
4441	3	5	11	523	0	542
4442	5	3	535	15	0	558
4443	5	3	13	528	0	549
4444	3	3	554	13	0	573
4445	4	4	547	8	0	563
4446	542	3	15	5	0	565
4447	542	3	11	6	0	562
4448	555	2	6	2	0	565
4449	18	541	3	8	0	570
4450	10	8	10	544	0	572
4451	538	7	1	13	0	559
4452	564	3	4	5	0	576
4453	552	2	3	8	0	565
4454	20	3	554	3	0	580
4455	12	515	10	7	0	544
4456	8	559	8	3	0	578
4457	544	14	6	5	0	569
4458	14	9	5	538	0	566
4459	539	6	2	14	0	561
4460	13	5	527	6	0	551
4461	10	6	12	496	0	524
4462	11	5	7	498	0	521
4463	9	4	4	483	0	500
4464	8	502	8	14	0	532
4465	508	11	3	7	0	529
4466	510	6	2	12	0	530
4467	18	503	6	4	0	531
4468	11	15	4	507	0	537
4469	519	6	1	13	0	539
4470	16	4	7	511	0	538
4471	516	6	3	10	0	535
4472	16	517	1	9	0	543
4473	509	13	4	5	0	531
4474	19	11	510	4	0	544
4475	16	528	13	5	0	562
4476	6	16	529	9	0	560
4477	6	13	19	519	0	557
4478	525	8	6	14	0	553
4479	530	2	6	7	0	545
4480	520	5	6	7	0	538
4481	26	4	4	500	0	534
4482	514	2	3	16	0	535
4483	20	4	3	508	0	535
4484	510	3	1	17	0	531
4485	520	2	4	8	0	534
4486	17	4	508	11	0	540
4487	11	1	464	1	0	477
4488	6	3	445	4	0	458
4489	2	3	12	413	0	430
4490	422	0	5	9	0	436
4491	10	2	5	422	0	439
4492	5	2	3	429	0	439
4493	432	2	2	10	0	446
4494	430	2	1	4	0	437
4495	427	1	1	5	0	434
4496	435	0	1	4	0	440
4497	13	1	2	422	0	438
4498	419	1	2	10	0	432
4499	12	412	2	3	0	429
4500	421	8	3	3	0	435
4501	420	3	2	2	0	427
4502	12	1	411	2	0	426
4503	383	1	6	3	0	393
4504	9	2	394	1	0	406
4505	1	1	379	3	0	384
4506	3	0	350	1	0	354
4507	2	16	11	288	0	317
4508	3	0	293	6	0	302
4509	1	1	6	243	0	251
4510	0	0	258	6	0	264
4511	0	0	270	1	0	271
4512	1	0	4	257	0	262
4513	0	1	1	280	0	282
4514	0	0	292	5	0	297
4515	276	0	4	1	0	281
4516	5	0	1	286	0	292
4517	2	0	0	292	0	294
4518	289	2	0	6	0	297
4519	5	0	0	289	0	294
4520	2	0	288	4	0	294
4521	1	1	268	1	0	271
4522	0	0	5	261	0	266
4523	0	0	269	4	0	273
4524	1	269	3	1	0	274
4525	1	4	1	274	0	280
4526	280	1	0	3	0	284
4527	3	0	278	2	0	283
4528	266	0	2	0	0	268
4529	3	0	1	281	0	285
4530	2	1	0	279	0	282
4531	1	0	0	283	0	284
4532	1	0	1	274	0	276
4533	277	0	1	4	0	282
4534	2	295	2	1	0	300
4535	1	4	0	300	0	305
4536	1	1	0	298	0	300
4537	0	0	0	289	0	289
4538	1	0	0	287	0	288
4539	282	1	0	5	0	288
4540	4	282	0	1	0	287
4541	271	4	0	1	0	276
4542	5	255	0	2	0	262
4543	1	263	0	1	0	265
4544	238	4	0	0	0	242
4545	5	2	261	0	0	268
4546	2	0	3	262	0	267
4547	267	0	1	5	0	273
4548	279	0	1	1	0	281
4549	252	1	0	1	0	254
4550	278	0	1	0	0	279
4551	4	309	0	0	0	313
4552	314	4	1	1	0	320
4553	322	1	0	1	0	324
4554	6	351	1	2	0	360
4555	2	9	0	355	0	366
4556	0	2	360	10	0	372
4557	0	0	11	364	0	375
4558	348	0	1	11	0	360
4559	9	0	365	3	0	377
4560	2	350	10	0	0	362
4561	1	9	357	0	0	367
4562	0	2	10	350	0	362
4563	0	356	3	9	0	368
4564	360	10	0	3	0	373
4565	10	365	0	1	0	376
4566	1	9	1	358	0	369
4567	0	2	1	373	0	376
4568	366	0	0	12	0	378
4569	9	0	0	356	0	365
4570	3	361	0	10	0	374
4571	369	9	0	3	0	381
4572	377	2	1	1	0	381
4573	9	377	3	0	0	389
4574	370	8	1	1	0	380
4575	7	347	0	2	0	356
4576	351	9	1	1	0	362
4577	8	357	0	2	0	367
4578	4	7	0	341	0	352
4579	1	2	1	351	0	355
4580	348	1	1	10	0	360
4581	358	0	0	4	0	362
4582	8	348	0	3	0	359
4583	2	7	347	3	0	359
4584	354	2	7	3	0	366
4585	8	0	2	358	0	368
4586	3	358	0	5	0	366
4587	1	7	0	365	0	373
4588	363	3	0	8	0	374
4589	368	1	0	3	0	372
4590	370	0	0	1	0	371
4591	10	0	1	357	0	368
4592	3	1	354	8	0	366
4593	355	1	7	2	0	365
4594	359	0	2	1	0	362
4595	359	2	0	1	0	362
4596	11	351	0	0	0	362
4597	2	8	0	349	0	359
4598	1	365	0	6	0	372
4599	2	7	0	369	0	378
4600	2	2	0	377	0	381
4601	2	0	387	9	0	398
4602	2	0	8	446	0	456
4603	1	1	2	457	0	461
4604	462	1	0	9	0	472
4605	7	464	1	4	0	476
4606	470	10	0	0	0	480
4607	512	3	1	1	0	517
4608	10	0	0	503	0	513
4609	2	0	513	9	0	524
4610	2	496	7	3	0	508
4611	1	482	2	5	0	490
4612	466	10	2	1	0	479
4613	8	463	0	2	0	473
4614	2	8	0	453	0	463
4615	2	1	0	467	0	470
4616	0	2	453	10	0	465
4617	2	1	455	2	0	460
4618	2	452	11	0	0	465
4619	1	9	0	454	0	464
4620	452	1	0	11	0	464
4621	10	2	1	454	0	467
4622	2	1	473	10	0	486
4623	0	2	11	459	0	472
4624	456	0	1	12	0	469
4625	453	1	0	2	0	456
4626	11	456	2	1	0	470
4627	454	11	0	0	0	465
4628	10	455	2	0	0	467
4629	459	10	1	1	0	471
4630	10	4	0	458	0	472
4631	2	0	452	12	0	466
4632	1	1	448	3	0	453
4633	0	447	11	6	0	464
4634	0	9	5	434	0	448
4635	1	2	2	457	0	462
4636	453	1	0	12	0	466
4637	457	1	0	3	0	461
4638	462	3	0	2	0	467
4639	13	1	1	456	0	471
4640	4	2	1	466	0	473
4641	4	1	0	472	0	477
4642	5	1	458	12	0	476
4643	3	3	457	2	0	465
4644	453	5	11	1	0	470
4645	447	3	2	0	0	452
4646	13	4	448	1	0	466
4647	444	2	9	5	0	460
4648	426	0	3	5	0	434
4649	11	1	425	1	0	438
4650	3	431	12	2	0	448
4651	1	10	2	401	0	414
4652	1	3	402	12	0	418
4653	4	412	7	4	0	427
4654	3	10	1	367	0	381
4655	2	386	2	5	0	395
4656	3	4	384	4	0	395
4657	3	1	393	4	0	401
4658	3	0	8	396	0	407
4659	394	3	2	6	0	405
4660	9	1	2	389	0	401
4661	397	2	2	5	0	406
4662	9	2	1	390	0	402
4663	4	0	387	10	0	401
4664	371	3	7	4	0	385
4665	9	2	380	1	0	392
4666	384	5	7	4	0	400
4667	6	4	5	369	0	384
4668	2	376	4	12	0	394
4669	7	6	3	373	0	389
4670	6	381	3	7	0	397
4671	6	6	4	338	0	354
4672	4	376	2	10	0	392
4673	367	6	2	7	0	382
4674	368	2	3	4	0	377
4675	360	2	4	6	0	372
4676	10	2	359	3	0	374
4677	7	1	7	359	0	374
4678	9	1	361	7	0	378
4679	3	349	8	6	0	366
4680	3	368	5	5	0	381
4681	361	7	2	3	0	373
4682	7	5	366	2	0	380
4683	6	366	9	3	0	384
4684	5	10	1	364	0	380
4685	359	3	2	4	0	368
4686	8	361	2	3	0	374
4687	360	8	1	4	0	373
4688	6	5	368	7	0	386
4689	1	5	9	372	0	387
4690	4	5	4	376	0	389
4691	5	2	3	388	0	398
4692	5	392	5	11	0	413
4693	5	9	3	382	0	399
4694	5	4	397	13	0	419
4695	4	2	9	397	0	412
4696	3	1	6	402	0	412
4697	7	3	1	394	0	405
4698	4	390	4	13	0	411
4699	9	6	6	386	0	407
4700	4	3	5	389	0	401
4701	4	369	3	14	0	390
4702	299	7	1	6	0	313
4703	7	304	3	4	0	318
4704	3	302	4	2	0	311
4705	5	7	5	287	0	304
4706	2	3	293	10	0	308
4707	244	3	5	7	0	259
4708	7	1	3	262	0	273
4709	3	4	249	9	0	265
4710	1	255	6	7	0	269
4711	2	7	4	262	0	275
4712	1	5	263	7	0	276
4713	6	1	7	261	0	275
4714	1	2	3	263	0	269
4715	256	2	0	9	0	267
4716	4	259	1	5	0	269
4717	268	4	2	2	0	276
4718	7	4	271	1	0	283
4719	2	271	6	4	0	283
4720	1	4	276	0	0	281
4721	1	3	7	274	0	285
4722	263	1	2	6	0	272
4723	4	0	2	265	0	271
4724	262	1	1	7	0	271
4725	266	0	0	5	0	271
4726	7	2	0	268	0	277
4727	4	2	290	4	0	300
4728	3	1	299	2	0	305
4729	2	1	8	299	0	310
4730	1	1	5	302	0	309
4731	300	1	2	8	0	311
4732	5	1	1	308	0	315
4733	4	306	0	5	0	315
4734	2	6	0	316	0	324
4735	4	2	0	313	0	319
4736	314	0	2	7	0	323
4737	4	320	1	5	0	330
4738	2	4	3	318	0	327
4739	1	2	1	317	0	321
4740	0	311	0	5	0	316
4741	2	3	0	319	0	324
4742	3	2	2	307	0	314
4743	0	307	0	11	0	318
4744	0	5	0	322	0	327
4745	0	2	0	309	0	311
4746	1	298	0	8	0	307
4747	2	5	0	310	0	317
4748	300	3	1	4	0	308
4749	304	1	0	5	0	310
4750	305	1	0	3	0	309
4751	298	1	0	2	0	301
4752	6	289	0	2	0	297
4753	274	4	0	3	0	281
4754	4	266	1	2	0	273
4755	0	250	0	2	0	252
4756	3	4	0	250	0	257
4757	0	2	256	4	0	262
4758	237	0	2	1	0	240
4759	251	0	1	0	0	252
4760	5	0	269	0	0	274
4761	269	0	3	1	0	273
4762	288	0	1	0	0	289
4763	2	279	0	1	0	282
4764	324	3	0	1	0	328
4765	3	2	0	335	0	340
4766	2	1	0	335	0	338
4767	0	0	0	338	0	338
4768	0	0	1	339	0	340
4769	340	0	0	4	0	344
4770	4	1	0	333	0	338
4771	2	0	0	339	0	341
4772	1	0	334	3	0	338
4773	296	0	2	3	0	301
4774	324	1	1	1	0	327
4775	339	1	0	0	0	340
4776	2	329	0	2	0	333
4777	1	338	1	1	0	341
4778	335	4	1	2	0	342
4779	3	2	0	333	0	338
4780	3	339	1	3	0	346
4781	0	4	0	338	0	342
4782	2	336	0	7	0	345
4783	344	3	2	2	0	351
4784	5	351	0	0	0	356
4785	3	3	2	356	0	364
4786	2	1	0	364	0	367
4787	1	1	360	5	0	367
4788	1	369	2	2	0	374
4789	1	2	1	374	0	378
4790	1	2	387	3	0	393
4791	2	0	389	2	0	393
4792	0	0	2	410	0	412
4793	1	1	2	409	0	413
4794	0	402	1	4	0	407
4795	0	411	1	4	0	416
4796	3	2	0	421	0	426
4797	421	3	0	2	0	426
4798	1	1	0	457	0	459
4799	463	0	0	3	0	466
4800	463	2	0	3	0	468
4801	480	0	0	3	0	483
4802	3	2	483	3	0	491
4803	471	2	4	1	0	478
4804	3	0	1	485	0	489
4805	3	1	0	480	0	484
4806	1	2	482	5	0	490
4807	2	1	461	3	0	467
4808	3	0	4	460	0	467
4809	3	454	1	5	0	463
4810	2	468	1	2	0	473
4811	2	5	1	466	0	474
4812	462	2	1	5	0	470
4813	4	2	0	467	0	473
4814	1	2	2	462	0	467
4815	1	474	0	6	0	481
4816	3	3	1	474	0	481
4817	0	1	476	6	0	483
4818	2	1	443	3	0	449
4819	430	2	5	1	0	438
4820	4	461	1	1	0	467
4821	462	4	2	1	0	469
4822	472	1	1	1	0	475
4823	4	0	0	463	0	467
4824	2	479	0	7	0	488
4825	1	5	1	489	0	496
4826	488	1	2	6	0	497
4827	4	467	1	4	0	476
4828	455	6	0	2	0	463
4829	5	472	2	1	0	480
4830	469	5	0	1	0	475
4831	471	2	0	1	0	474
4832	8	472	0	1	0	481
4833	3	5	0	473	0	481
4834	467	3	0	6	0	476
4835	5	0	448	4	0	457
4836	3	1	443	1	0	448
4837	0	1	6	444	0	451
4838	455	0	2	4	0	461
4839	5	3	1	449	0	458
4840	454	0	1	6	0	461
4841	6	1	460	2	0	469
4842	466	0	4	1	0	471
4843	482	0	1	3	0	486
4844	7	2	0	470	0	479
4845	2	2	2	474	0	480
4846	3	2	0	473	0	478
4847	4	475	1	6	0	486
4848	2	4	1	464	0	471
4849	1	2	0	486	0	489
4850	480	1	0	7	0	488
4851	472	4	1	2	0	479
4852	8	0	469	3	0	480
4853	455	1	6	2	0	464
4854	7	0	464	2	0	473
4855	441	1	5	4	0	451
4856	5	0	456	3	0	464
4857	4	1	451	1	0	457
4858	0	3	6	449	0	458
4859	2	2	441	6	0	451
4860	424	0	6	3	0	433
4861	7	0	2	435	0	444
4862	446	1	1	6	0	454
4863	448	0	1	3	0	452
4864	414	1	2	4	0	421
4865	406	0	1	2	0	409
4866	8	1	408	0	0	417
4867	3	1	4	405	0	413
4868	0	0	414	9	0	423
4869	3	0	6	405	0	414
4870	402	0	4	5	0	411
4871	4	0	2	410	0	416
4872	411	1	1	4	0	417
4873	6	1	1	413	0	421
4874	5	0	0	415	0	420
4875	416	0	1	5	0	422
4876	6	406	2	2	0	416
4877	406	4	0	6	0	416
4878	5	402	2	1	0	410
4879	3	4	0	406	0	413
4880	400	2	1	6	0	409
4881	5	0	399	4	0	408
4882	5	1	4	389	0	399
4883	392	1	1	8	0	402
4884	401	0	0	3	0	404
4885	8	0	2	392	0	402
4886	2	394	0	8	0	404
4887	3	411	2	1	0	417
4888	3	14	0	379	0	396
4889	386	1	1	6	0	394
4890	7	371	0	2	0	380
4891	1	354	1	0	0	356
4892	342	4	0	2	0	348
4893	5	337	0	0	0	342
4894	347	3	0	1	0	351
4895	3	1	3	340	0	347
4896	1	0	0	343	0	344
4897	0	335	0	5	0	340
4898	1	312	0	1	0	314
4899	294	5	0	2	0	301
4900	5	324	0	1	0	330
4901	0	358	0	0	0	358
4902	0	9	0	354	0	363
4903	364	2	0	7	0	373
4904	7	3	397	2	0	409
4905	405	2	7	2	0	416
4906	10	0	3	446	0	459
4907	7	0	446	8	0	461
4908	3	0	461	5	0	469
4909	2	0	13	473	0	488
4910	0	0	491	11	0	502
4911	480	0	16	4	0	500
4912	503	0	5	4	0	512
4913	13	0	490	3	0	506
4914	8	0	12	488	0	508
4915	6	0	5	491	0	502
4916	499	0	4	14	0	517
4917	9	0	3	481	0	493
4918	5	486	0	15	0	506
4919	487	9	1	4	0	501
4920	11	484	1	9	0	505
4921	4	517	1	4	0	526
4922	6	16	1	500	0	523
4923	3	8	1	502	0	514
4924	0	5	1	501	0	507
4925	2	3	490	15	0	510
4926	464	0	8	12	0	484
4927	8	477	6	6	0	497
4928	479	9	5	4	0	497
4929	478	4	1	5	0	488
4930	15	4	1	489	0	509
4931	10	488	1	10	0	509
4932	6	7	1	494	0	508
4933	4	5	1	499	0	509
4934	503	6	0	15	0	524
4935	498	4	0	9	0	511
4936	14	1	481	7	0	503
4937	491	0	8	4	0	503
4938	15	511	3	2	0	531
4939	513	8	3	3	0	527
4940	12	548	3	1	0	564
4941	9	14	0	524	0	547
4942	5	8	0	530	0	543
4943	5	528	1	14	0	548
4944	2	8	0	542	0	552
4945	0	8	0	544	0	552
4946	1	5	1	543	0	550
4947	1	525	0	15	0	541
4948	3	8	0	538	0	549
4949	4	6	1	540	0	551
4950	1	6	3	542	0	552
4951	1	3	522	17	0	543
4952	499	3	8	12	0	522
4953	11	1	527	9	0	548
4954	519	1	12	3	0	535
4955	13	2	528	4	0	547
4956	515	2	14	6	0	537
4957	537	3	8	3	0	551
4958	16	4	534	2	0	556
4959	14	1	10	527	0	552
4960	9	2	511	11	0	533
4961	502	1	13	10	0	526
4962	10	3	520	6	0	539
4963	6	3	504	7	0	520
4964	506	0	14	8	0	528
4965	11	504	13	7	0	535
4966	7	9	8	523	0	547
4967	537	7	5	12	0	561
4968	17	3	4	538	0	562
4969	7	3	6	547	0	563
4970	544	2	4	17	0	567
4971	544	0	1	14	0	559
4972	18	1	534	10	0	563
4973	11	1	527	6	0	545
4974	10	0	18	530	0	558
4975	7	2	539	13	0	561
4976	6	2	17	527	0	552
4977	8	3	10	522	0	543
4978	6	1	10	541	0	558
4979	529	4	5	23	0	561
4980	10	547	3	15	0	575
4981	551	9	0	14	0	574
4982	551	8	3	8	0	570
4983	18	545	2	8	0	573
4984	539	12	0	6	0	557
4985	15	7	527	5	0	554
4986	10	8	8	523	0	549
4987	526	6	6	12	0	550
4988	12	0	510	12	0	534
4989	505	2	8	9	0	524
4990	13	525	6	7	0	551
4991	590	8	5	5	0	608
4992	597	8	1	6	0	612
4993	20	602	2	6	0	630
4994	634	11	1	6	0	652
4995	18	7	4	638	0	667
4996	13	6	0	650	0	669
4997	642	7	3	18	0	670
4998	646	2	0	16	0	664
4999	20	640	2	12	0	674
5000	13	606	2	4	0	625
5001	8	14	0	543	0	565
5002	2	559	5	9	0	575
5003	4	578	1	7	0	590
5004	510	12	1	3	0	526
5005	8	512	0	0	0	520
5006	474	8	2	1	0	485
5007	7	524	1	1	0	533
5008	2	5	522	0	0	529
5009	1	527	4	0	0	532
5010	507	7	1	3	0	518
5011	501	1	1	2	0	505
5012	5	2	500	1	0	508
5013	3	0	5	474	0	482
5014	3	0	1	508	0	512
5015	2	0	499	6	0	507
5016	0	2	5	485	0	492
5017	2	0	496	6	0	504
5018	0	0	488	4	0	492
5019	468	0	6	3	0	477
5020	5	498	3	1	0	507
5021	490	4	1	1	0	496
5022	5	2	1	485	0	493
5023	3	2	490	4	0	499
5024	1	2	5	478	0	486
5025	3	494	1	4	0	502
5026	504	5	1	1	0	511
5027	500	2	1	1	0	504
5028	7	2	0	498	0	507
5029	3	0	489	5	0	497
5030	451	1	4	2	0	458
5031	5	474	2	1	0	482
5032	482	5	2	0	0	489
5033	8	2	0	479	0	489
5034	479	3	1	4	0	487
5035	6	2	1	476	0	485
5036	6	0	485	6	0	497
5037	1	2	481	4	0	488
5038	474	0	6	4	0	484
5039	6	487	3	2	0	498
5040	479	4	2	2	0	487
5041	480	3	1	0	0	484
5042	5	478	1	0	0	484
5043	471	5	0	0	0	476
5044	10	1	499	0	0	510
5045	2	4	3	499	0	508
5046	4	2	2	491	0	499
5047	2	3	1	520	0	526
5048	3	1	518	9	0	531
5049	2	3	520	3	0	528
5050	6	0	8	505	0	519
5051	1	518	3	5	0	527
5052	2	538	4	1	0	545
5053	535	9	1	2	0	547
5054	544	5	2	3	0	554
5055	9	559	0	3	0	571
5056	3	8	1	560	0	572
5057	5	2	2	565	0	574
5058	593	3	0	11	0	607
5059	7	2	4	600	0	613
5060	2	2	4	598	0	606
5061	5	1	3	602	0	611
5062	2	4	576	7	0	589
5063	9	1	544	3	0	557
5064	569	1	7	6	0	583
5065	6	2	5	604	0	617
5066	5	0	594	11	0	610
5067	2	3	578	4	0	587
5068	578	1	7	5	0	591
5069	7	3	666	4	0	680
5070	3	679	11	3	0	696
5071	4	6	8	720	0	738
5072	5	4	736	6	0	751
5073	713	7	7	6	0	733
5074	9	2	6	773	0	790
5075	7	2	778	15	0	802
5076	6	2	13	789	0	810
5077	2	0	7	807	0	816
5078	801	3	5	19	0	828
5079	15	816	3	13	0	847
5080	12	10	0	810	0	832
5081	810	9	2	15	0	836
5082	820	2	3	10	0	835
5083	830	3	1	4	0	838
5084	835	3	1	3	0	842
5085	26	1	0	821	0	848
5086	805	3	4	13	0	825
5087	812	0	1	10	0	823
5088	787	0	2	6	0	795
5089	808	2	4	5	0	819
5090	23	751	6	1	0	781
5091	7	695	0	2	0	704
5092	3	15	2	701	0	721
5093	1	707	0	8	0	716
5094	697	10	0	7	0	714
5095	8	7	1	694	0	710
5096	698	2	0	8	0	708
5097	714	1	0	9	0	724
5098	15	0	1	728	0	744
5099	10	0	0	721	0	731
5100	2	720	0	16	0	738
5101	728	7	1	10	0	746
5102	7	724	0	2	0	733
5103	730	8	0	5	0	743
5104	9	8	0	733	0	750
5105	9	2	726	6	0	743
5106	710	1	7	8	0	726
5107	679	0	8	2	0	689
5108	15	0	668	1	0	684
5109	9	0	676	2	0	687
5110	7	0	12	660	0	679
5111	691	1	9	9	0	710
5112	739	1	2	9	0	751
5113	783	1	1	3	0	788
5114	783	2	1	1	0	787
5115	17	768	0	0	0	785
5116	795	8	0	1	0	804
5117	10	8	1	778	0	797
5118	10	0	0	776	0	786
5119	3	2	1	805	0	811
5120	6	0	0	816	0	822
5121	817	2	0	19	0	838
5122	11	1	1	843	0	856
5123	9	1	829	13	0	852
5124	2	0	12	863	0	877
5125	3	0	8	864	0	875
5126	3	1	0	871	0	875
5127	3	0	2	865	0	870
5128	846	1	1	25	0	873
5129	16	834	1	11	0	862
5130	10	845	2	5	0	862
5131	4	22	1	844	0	871
5132	836	11	0	15	0	862
5133	862	3	1	10	0	876
5134	22	2	1	854	0	879
5135	13	2	838	14	0	867
5136	819	2	13	16	0	850
5137	15	2	11	861	0	889
5138	14	0	858	14	0	886
5139	824	1	13	11	0	849
5140	17	847	10	5	0	879
5141	952	15	1	6	0	974
5142	26	1016	3	2	0	1047
5143	18	25	0	1007	0	1050
5144	6	1073	3	28	0	1110
5145	6	26	2	1097	0	1131
5146	1041	19	1	35	0	1096
5147	28	1043	1	30	0	1102
5148	24	28	1052	6	0	1110
5149	6	23	27	1047	0	1103
5150	6	4	1060	28	0	1098
5151	5	3	29	1052	0	1089
5152	2	2	19	1076	0	1099
5153	6	4	1043	45	0	1098
5154	939	3	29	32	0	1003
5155	30	3	1033	8	0	1074
5156	22	4	1002	7	0	1035
5157	7	1017	46	8	0	1078
5158	10	25	21	993	0	1049
5159	3	17	8	1020	0	1048
5160	6	4	5	996	0	1011
5161	2	3	5	1040	0	1050
5162	1	4	990	50	0	1045
5163	934	2	26	31	0	993
5164	27	2	1006	10	0	1045
5165	23	0	29	982	0	1034
5166	968	3	22	33	0	1026
5167	27	965	7	25	0	1024
5168	21	31	3	946	0	1001
5169	892	16	4	31	0	943
5170	28	865	6	21	0	920
5171	15	865	1	6	0	887
5172	855	36	2	8	0	901
5173	30	889	1	3	0	923
5174	867	24	2	5	0	898
5175	28	872	3	4	0	907
5176	876	28	2	2	0	908
5177	876	19	1	3	0	899
5178	40	868	2	1	0	911
5179	17	27	2	849	0	895
5180	11	13	842	24	0	890
5181	832	9	23	16	0	880
5182	27	3	14	823	0	867
5183	17	814	2	26	0	859
5184	5	857	2	17	0	881
5185	4	39	3	843	0	889
5186	837	14	3	31	0	885
5187	27	6	841	13	0	887
5188	17	2	24	852	0	895
5189	4	4	13	872	0	893
5190	4	3	5	888	0	900
5191	5	2	4	868	0	879
5192	3	819	1	50	0	873
5193	4	23	4	841	0	872
5194	1	17	817	31	0	866
5195	2	5	808	18	0	833
5196	6	3	829	8	0	846
5197	2	5	40	787	0	834
5198	779	2	19	25	0	825
5199	23	6	775	17	0	821
5200	14	1	799	8	0	822
5201	5	1	38	766	0	810
5202	770	2	20	29	0	821
5203	25	768	10	18	0	821
5204	777	24	3	9	0	813
5205	28	15	7	763	0	813
5206	18	4	783	29	0	834
5207	6	5	28	759	0	798
5208	5	781	15	29	0	830
5209	796	26	4	18	0	844
5210	31	16	792	4	0	843
5211	16	801	24	6	0	847
5212	781	27	20	7	0	835
5213	34	15	6	792	0	847
5214	16	8	6	819	0	849
5215	801	3	1	51	0	856
5216	851	3	4	22	0	880
5217	875	2	5	9	0	891
5218	55	2	1	822	0	880
5219	25	818	5	31	0	879
5220	826	31	2	22	0	881
5221	35	825	2	8	0	870
5222	788	32	7	7	0	834
5223	34	782	5	3	0	824
5224	24	33	1	746	0	804
5225	752	16	2	30	0	800
5226	778	6	3	17	0	804
5227	787	6	1	6	0	800
5228	798	5	1	7	0	811
5229	796	1	0	11	0	808
5230	52	3	763	4	0	822
5231	28	2	27	753	0	810
5232	11	3	777	27	0	818
5233	13	0	771	18	0	802
5234	759	2	44	7	0	812
5235	774	6	20	7	0	807
5236	783	3	8	4	0	798
5237	47	3	6	726	0	782
5238	732	1	6	28	0	767
5239	35	714	1	17	0	767
5240	24	733	0	7	0	764
5241	7	653	1	5	0	666
5242	565	21	7	3	0	596
5243	17	595	0	2	0	614
5244	522	19	0	1	0	542
5245	532	6	0	2	0	540
5246	25	2	519	1	0	547
5247	9	2	17	518	0	546
5248	7	1	6	543	0	557
5249	542	1	4	24	0	571
5250	550	1	3	10	0	564
5251	27	0	0	535	0	562
5252	13	2	523	20	0	558
5253	10	2	532	9	0	553
5254	5	4	22	532	0	563
5255	3	2	7	550	0	562
5256	4	4	5	551	0	564
5257	516	5	3	23	0	547
5258	542	3	1	12	0	558
5259	28	524	0	7	0	559
5260	14	17	1	524	0	556
5261	10	5	0	528	0	543
5262	10	520	2	23	0	555
5263	6	20	4	526	0	556
5264	527	6	2	30	0	565
5265	24	2	2	533	0	561
5266	11	2	5	553	0	571
5267	532	2	1	30	0	565
5268	541	0	3	14	0	558
5269	543	3	10	5	0	561
5270	31	1	3	519	0	554
5271	18	2	495	19	0	534
5272	13	3	479	8	0	503
5273	9	2	469	6	0	486
5274	6	447	17	4	0	474
5275	441	18	6	2	0	467
5276	19	6	427	4	0	456
5277	439	4	19	4	0	466
5278	19	3	7	436	0	465
5279	415	4	3	21	0	443
5280	454	1	4	10	0	469
5281	26	447	2	6	0	481
5282	449	14	2	8	0	473
5283	458	4	5	8	0	475
5284	27	452	3	4	0	486
5285	15	11	3	460	0	489
5286	9	8	455	16	0	488
5287	7	2	13	447	0	469
5288	8	2	10	460	0	480
5289	446	5	7	23	0	481
5290	20	5	6	433	0	464
5291	9	452	3	21	0	485
5292	6	14	3	451	0	474
5293	10	8	1	468	0	487
5294	10	4	449	25	0	488
5295	9	447	13	12	0	481
5296	10	470	8	9	0	497
5297	445	23	4	13	0	485
5298	12	463	4	15	0	494
5299	14	18	5	471	0	508
5300	11	9	470	16	0	506
5301	7	479	13	18	0	517
5302	488	17	7	10	0	522
5303	21	7	8	484	0	520
5304	11	3	6	511	0	531
5305	7	5	491	30	0	533
5306	10	6	17	470	0	503
5307	6	3	10	495	0	514
5308	468	4	3	26	0	501
5309	448	1	7	16	0	472
5310	22	432	6	8	0	468
5311	402	14	4	4	0	424
5312	20	375	2	8	0	405
5313	10	17	5	332	0	364
5314	8	343	1	13	0	365
5315	6	354	4	6	0	370
5316	312	16	2	6	0	336
5317	310	4	4	6	0	324
5318	12	305	3	3	0	323
5319	306	10	1	4	0	321
5320	294	5	4	8	0	311
5321	317	1	3	4	0	325
5322	16	3	1	310	0	330
5323	310	7	0	16	0	333
5324	17	1	302	6	0	326
5325	297	5	11	2	0	315
5326	15	4	308	4	0	331
5327	6	5	10	312	0	333
5328	5	8	3	325	0	341
5329	6	2	315	15	0	338
5330	285	4	14	6	0	309
5331	304	3	3	10	0	320
5332	14	1	319	8	0	342
5333	9	1	12	314	0	336
5334	7	3	2	324	0	336
5335	4	4	1	340	0	349
5336	329	0	6	11	0	346
5337	331	4	2	7	0	344
5338	13	3	3	324	0	343
5339	7	306	4	11	0	328
5340	6	307	4	5	0	322
5341	288	12	3	3	0	306
5342	11	286	4	5	0	306
5343	5	282	2	6	0	295
5344	4	6	2	266	0	278
5345	4	8	255	7	0	274
5346	2	253	3	4	0	262
5347	6	14	1	244	0	265
5348	2	252	2	7	0	263
5349	0	4	0	249	0	253
5350	248	0	0	5	0	253
5351	3	261	0	1	0	265
5352	263	4	0	1	0	268
5353	262	0	0	0	0	262
5354	3	1	244	0	0	248
5355	248	0	3	1	0	252
5356	4	1	0	252	0	257
5357	1	0	258	3	0	262
5358	1	256	3	0	0	260
5359	0	4	0	255	0	259
5360	0	0	2	259	0	261
5361	253	2	0	3	0	258
5362	3	1	1	255	0	260
5363	0	0	0	253	0	253
5364	244	1	0	3	0	248
5365	2	242	1	1	0	246
5366	234	2	0	3	0	239
5367	3	1	238	1	0	243
5368	219	1	2	1	0	223
5369	5	0	238	0	0	243
5370	0	242	4	0	0	246
5371	244	2	0	0	0	246
5372	236	1	2	1	0	240
5373	3	1	236	0	0	240
5374	1	2	225	0	0	228
5375	1	1	231	1	0	234
5376	1	240	5	1	0	247
5377	2	4	1	237	0	244
5378	0	1	257	5	0	263
5379	1	1	251	1	0	254
5380	2	0	5	247	0	254
5381	1	1	253	4	0	259
5382	238	0	6	2	0	246
5383	291	0	2	1	0	294
5384	12	0	288	0	0	300
5385	4	280	11	0	0	295
5386	4	10	3	285	0	302
5387	0	2	300	11	0	313
5388	1	307	10	2	0	320
5389	0	9	5	307	0	321
5390	305	1	5	9	0	320
5391	311	4	1	2	0	318
5392	12	302	1	7	0	322
5393	6	7	1	302	0	316
5394	5	3	1	306	0	315
5395	0	5	1	302	0	308
5396	1	0	1	312	0	314
5397	1	1	297	16	0	315
5398	2	1	9	300	0	312
5399	2	0	282	16	0	300
5400	2	273	14	2	0	291
5401	273	9	2	5	0	289
5402	7	310	4	1	0	322
5403	3	11	1	322	0	337
5404	5	2	0	320	0	327
5405	313	5	1	13	0	332
5406	9	0	2	317	0	328
5407	2	305	1	13	0	321
5408	6	9	1	310	0	326
5409	0	3	2	324	0	329
5410	311	4	1	11	0	327
5411	11	0	322	6	0	339
5412	2	322	7	7	0	338
5413	5	328	3	2	0	338
5414	3	9	3	318	0	333
5415	315	6	0	8	0	329
5416	7	325	1	4	0	337
5417	3	9	0	325	0	337
5418	4	1	315	10	0	330
5419	2	4	10	314	0	330
5420	317	1	3	13	0	334
5421	316	1	4	4	0	325
5422	11	1	0	306	0	318
5423	317	1	0	9	0	327
5424	315	1	1	4	0	321
5425	10	1	300	6	0	317
5426	298	1	8	2	0	309
5427	12	308	3	2	0	325
5428	312	6	5	2	0	325
5429	13	2	307	1	0	323
5430	3	4	8	310	0	325
5431	322	0	3	10	0	335
5432	11	3	313	3	0	330
5433	5	0	329	5	0	339
5434	5	1	12	311	0	329
5435	0	0	325	12	0	337
5436	310	1	13	6	0	330
5437	13	2	318	3	0	336
5438	4	0	16	326	0	346
5439	4	2	4	339	0	349
5440	343	1	3	15	0	362
5441	12	0	349	9	0	370
5442	4	0	376	4	0	384
5443	4	1	14	366	0	385
5444	0	1	381	14	0	396
5445	367	0	21	3	0	391
5446	13	0	6	376	0	395
5447	6	0	383	13	0	402
5448	4	1	14	373	0	392
5449	4	1	3	384	0	392
5450	384	0	6	15	0	405
5451	12	0	380	8	0	400
5452	365	3	12	5	0	385
5453	19	1	406	3	0	429
5454	414	1	18	1	0	434
5455	417	1	10	5	0	433
5456	416	1	10	3	0	430
5457	18	400	3	8	0	429
5458	416	11	4	3	0	434
5459	419	6	1	3	0	429
5460	15	4	4	408	0	431
5461	10	1	406	14	0	431
5462	388	0	14	13	0	415
5463	16	0	419	8	0	443
5464	12	1	19	411	0	443
5465	11	0	9	424	0	444
5466	425	2	6	16	0	449
5467	14	427	7	7	0	455
5468	15	9	1	429	0	454
5469	11	5	2	441	0	459
5470	5	4	430	19	0	458
5471	4	5	13	431	0	453
5472	9	0	6	434	0	449
5473	5	0	5	437	0	447
5474	2	423	4	23	0	452
5475	421	9	6	8	0	444
5476	438	7	2	6	0	453
5477	17	433	4	5	0	459
5478	416	11	2	10	0	439
5479	19	5	2	435	0	461
5480	7	7	456	12	0	482
5481	4	469	11	8	0	492
5482	1	489	5	14	0	509
5483	474	9	2	5	0	490
5484	491	3	4	2	0	500
5485	12	0	1	499	0	512
5486	4	1	1	504	0	510
5487	2	8	1	505	0	516
5488	475	12	0	12	0	499
5489	23	3	473	3	0	502
5490	495	2	8	2	0	507
5491	14	6	2	483	0	505
5492	8	0	3	486	0	497
5493	6	477	3	24	0	510
5494	6	13	8	497	0	524
5495	5	13	6	505	0	529
5496	13	7	499	13	0	532
5497	17	500	9	11	0	537
5498	528	9	5	18	0	560
5499	510	9	2	20	0	541
5500	530	5	1	23	0	559
5501	535	2	4	16	0	557
5502	18	3	495	6	0	522
5503	485	6	19	5	0	515
5504	24	3	497	7	0	531
5505	15	1	10	496	0	522
5506	16	510	3	18	0	547
5507	13	14	4	514	0	545
5508	7	4	8	522	0	541
5509	13	1	512	17	0	543
5510	493	5	23	7	0	528
5511	501	10	5	9	0	525
5512	24	485	6	7	0	522
5513	20	12	489	11	0	532
5514	13	5	16	500	0	534
5515	12	5	502	14	0	533
5516	17	3	495	5	0	520
5517	23	4	16	487	0	530
5518	10	10	500	12	0	532
5519	9	9	15	500	0	533
5520	7	7	508	24	0	546
5521	5	1	18	512	0	536
5522	498	0	20	23	0	541
5523	506	0	15	16	0	537
5524	513	3	11	10	0	537
5525	497	6	6	16	0	525
5526	14	497	13	14	0	538
5527	10	10	13	504	0	537
5528	10	5	6	518	0	539
5529	12	2	509	18	0	541
5530	14	3	16	494	0	527
5531	10	7	491	16	0	524
5532	6	11	472	13	0	502
5533	442	8	15	17	0	482
5534	11	490	11	15	0	527
5535	502	8	8	15	0	533
5536	505	2	7	11	0	525
5537	24	507	9	8	0	548
5538	503	8	15	5	0	531
5539	24	9	502	4	0	539
5540	12	502	11	4	0	529
5541	504	8	3	10	0	525
5542	16	5	469	10	0	500
5543	460	11	9	9	0	489
5544	15	480	7	8	0	510
5545	493	9	14	9	0	525
5546	493	10	9	4	0	516
5547	19	486	8	2	0	515
5548	16	493	5	6	0	520
5549	19	513	8	3	0	543
5550	10	16	4	511	0	541
5551	15	6	4	514	0	539
5552	526	4	8	9	0	547
5553	484	10	6	6	0	506
5554	12	15	473	3	0	503
5555	5	11	455	8	0	479
5556	9	5	485	13	0	512
5557	6	7	8	498	0	519
5558	16	4	507	14	0	541
5559	20	2	9	503	0	534
5560	527	6	11	8	0	552
5561	15	6	534	2	0	557
5562	512	9	16	6	0	543
5563	515	4	8	12	0	539
5564	9	2	525	15	0	551
5565	10	520	11	12	0	553
5566	15	6	8	516	0	545
5567	11	2	537	10	0	560
5568	9	4	19	524	0	556
5569	13	1	11	561	0	586
5570	562	3	12	13	0	590
5571	9	11	7	569	0	596
5572	7	5	558	18	0	588
5573	12	2	10	553	0	577
5574	571	4	8	16	0	599
5575	18	573	8	9	0	608
5576	574	6	5	9	0	594
5577	13	5	9	569	0	596
5578	5	9	562	10	0	586
5579	7	2	525	8	0	542
5580	14	2	509	7	0	532
5581	2	486	6	2	0	496
5582	465	3	6	6	0	480
5583	4	442	0	0	0	446
5584	431	1	0	0	0	432
5585	1	424	0	0	0	425
5586	0	0	0	437	0	437
5587	0	1	0	435	0	436
5588	0	0	0	437	0	437
5589	0	434	0	3	0	437
5590	0	2	0	447	0	449
5591	1	1	1	514	0	517
5592	552	0	0	3	0	555
5593	5	0	0	597	0	602
5594	2	0	661	5	0	668
5595	642	0	8	4	0	654
5596	665	0	2	1	0	668
5597	10	674	1	0	0	685
5598	658	9	1	1	0	669
5599	680	2	2	1	0	685
5600	12	1	0	683	0	696
5601	6	0	1	676	0	683
5602	2	1	0	702	0	705
5603	698	0	0	13	0	711
5604	696	1	0	3	0	700
5605	14	0	685	2	0	701
5606	674	0	8	0	0	682
5607	692	0	2	2	0	696
5608	697	1	1	1	0	700
5609	15	0	678	2	0	695
5610	4	1	692	1	0	698
5611	5	0	13	685	0	703
5612	2	2	707	11	0	722
5613	2	0	12	691	0	705
5614	4	0	3	633	0	640
5615	2	696	3	10	0	711
5616	695	12	1	4	0	712
5617	11	3	695	1	0	710
5618	695	2	13	4	0	714
5619	15	0	4	713	0	732
5620	696	1	4	15	0	716
5621	16	703	2	4	0	725
5622	6	725	2	4	0	737
5623	10	16	0	718	0	744
5624	5	7	3	730	0	745
5625	6	2	721	17	0	746
5626	5	3	12	717	0	737
5627	692	1	3	20	0	716
5628	13	701	2	6	0	722
5629	7	13	699	5	0	724
5630	6	4	14	697	0	721
5631	6	2	711	16	0	735
5632	4	0	18	698	0	720
5633	5	1	708	16	0	730
5634	6	2	681	5	0	694
5635	7	1	18	673	0	699
5636	683	3	12	14	0	712
5637	685	1	5	7	0	698
5638	664	3	3	8	0	678
5639	18	659	3	7	0	687
5640	666	14	3	6	0	689
5641	665	5	4	4	0	678
5642	20	6	652	3	0	681
5643	10	642	13	5	0	670
5644	11	17	6	633	0	667
5645	637	4	2	15	0	658
5646	16	642	1	8	0	667
5647	656	16	2	10	0	684
5648	660	6	3	4	0	673
5649	648	4	3	5	0	660
5650	646	2	4	8	0	660
5651	20	3	4	627	0	654
5652	643	1	3	18	0	665
5653	18	4	3	632	0	657
5654	9	636	2	15	0	662
5655	8	14	3	652	0	677
5656	640	4	9	18	0	671
5657	19	2	635	12	0	668
5658	5	1	20	629	0	655
5659	621	3	7	20	0	651
5660	16	611	7	7	0	641
5661	618	15	4	5	0	642
5662	631	5	3	6	0	645
5663	23	624	3	7	0	657
5664	630	13	2	1	0	646
5665	19	6	592	5	0	622
5666	10	6	613	2	0	631
5667	592	3	18	2	0	615
5668	18	4	579	4	0	605
5669	7	2	18	550	0	577
5670	6	562	6	12	0	586
5671	563	15	6	6	0	590
5672	21	561	3	3	0	588
5673	10	559	6	1	0	576
5674	11	16	4	577	0	608
5675	8	6	3	585	0	602
5676	8	4	1	580	0	593
5677	8	3	2	577	0	590
5678	4	6	561	19	0	590
5679	7	4	12	548	0	571
5680	4	4	3	565	0	576
5681	552	3	4	18	0	577
5682	15	3	4	553	0	575
5683	7	2	539	20	0	568
5684	518	2	12	9	0	541
5685	14	7	2	539	0	562
5686	9	1	565	12	0	587
5687	8	5	11	543	0	567
5688	8	557	7	12	0	584
5689	568	13	3	6	0	590
5690	14	5	555	6	0	580
5691	9	488	15	2	0	514
5692	447	8	6	3	0	464
5693	10	383	2	2	0	397
5694	4	333	1	0	0	338
5695	329	6	1	1	0	337
5696	4	324	2	1	0	331
5697	3	320	0	2	0	325
5698	6	9	2	318	0	335
5699	0	4	318	4	0	326
5700	1	309	4	1	0	315
5701	0	9	2	302	0	313
5702	1	299	1	3	0	304
5703	301	3	0	1	0	305
5704	3	1	292	1	0	297
5705	3	1	1	295	0	300
5706	306	1	1	2	0	310
5707	4	0	1	314	0	319
5708	4	0	308	3	0	315
5709	306	1	2	2	0	311
5710	322	1	2	2	0	327
5711	5	332	1	1	0	339
5712	3	2	1	334	0	340
5713	1	3	1	334	0	339
5714	343	1	0	4	0	348
5715	339	1	0	1	0	341
5716	6	1	341	1	0	349
5717	3	346	3	0	0	352
5718	347	2	1	1	0	351
5719	4	1	0	352	0	357
5720	1	0	361	4	0	366
5721	0	1	345	1	0	347
5722	1	0	4	349	0	354
5723	357	0	0	4	0	361
5724	3	360	0	0	0	363
5725	394	3	0	3	0	400
5726	3	0	0	417	0	420
5727	0	0	1	425	0	426
5728	0	0	0	435	0	435
5729	437	0	0	3	0	440
5730	2	440	0	0	0	442
5731	1	2	1	448	0	452
5732	1	1	0	452	0	454
5733	0	1	448	3	0	452
5734	1	0	3	440	0	444
5735	1	0	455	6	0	462
5736	0	441	4	0	0	445
5737	0	3	0	447	0	450
5738	436	0	0	2	0	438
5739	3	0	450	0	0	453
5740	0	0	3	460	0	463
5741	0	0	456	3	0	459
5742	422	0	3	0	0	425
5743	3	0	462	0	0	465
5744	0	0	3	450	0	453
5745	452	0	0	3	0	455
5746	3	413	0	0	0	416
5747	431	2	0	0	0	433
5748	3	419	0	0	0	422
5749	0	3	0	461	0	464
5750	0	0	443	3	0	446
5751	0	0	439	0	0	439
5752	0	0	2	440	0	442
5753	452	0	0	4	0	456
5754	452	0	1	2	0	455
5755	4	0	0	435	0	439
5756	0	0	0	449	0	449
5757	439	0	0	3	0	442
5758	3	418	0	0	0	421
5759	0	458	0	0	0	458
5760	457	3	0	0	0	460
5761	3	0	454	0	0	457
5762	1	0	2	451	0	454
5763	1	0	460	2	0	463
5764	0	1	3	443	0	447
5765	0	0	452	4	0	456
5766	1	0	438	2	0	441
5767	0	0	3	451	0	454
5768	1	435	0	1	0	437
5769	454	3	1	0	0	458
5770	3	460	1	0	0	464
5771	2	4	0	479	0	485
5772	479	0	0	5	0	484
5773	4	0	2	471	0	477
5774	485	1	1	3	0	490
5775	476	0	0	2	0	478
5776	489	0	0	2	0	491
5777	3	475	1	0	0	479
5778	491	3	1	1	0	496
5779	3	1	0	503	0	507
5780	541	0	0	9	0	550
5781	4	1	0	550	0	555
5782	557	0	0	4	0	561
5783	553	1	0	1	0	555
5784	4	558	0	1	0	563
5785	1	4	0	600	0	605
5786	2	0	1	592	0	595
5787	0	644	0	7	0	651
5788	1	9	0	663	0	673
5789	654	3	0	13	0	670
5790	714	1	1	4	0	720
5791	696	0	0	6	0	702
5792	17	0	760	1	0	778
5793	786	2	12	2	0	802
5794	839	0	4	2	0	845
5795	848	0	3	1	0	852
5796	21	831	2	0	0	854
5797	9	13	0	843	0	865
5798	8	4	2	848	0	862
5799	3	4	1	845	0	853
5800	3	2	826	23	0	854
5801	1	0	14	837	0	852
5802	829	1	5	22	0	857
5803	15	1	5	837	0	858
5804	7	0	2	870	0	879
5805	5	2	839	23	0	869
5806	4	846	18	11	0	879
5807	868	14	7	8	0	897
5808	21	7	2	868	0	898
5809	875	5	0	17	0	897
5810	22	2	854	8	0	886
5811	816	2	16	5	0	839
5812	17	869	6	7	0	899
5813	10	15	877	3	0	905
5814	5	7	885	3	0	900
5815	3	4	21	845	0	873
5816	3	1	909	15	0	928
5817	4	887	14	8	0	913
5818	2	15	10	907	0	934
5819	1	9	5	917	0	932
5820	3	5	3	907	0	918
5821	886	2	0	28	0	916
5822	16	903	1	11	0	931
5823	6	12	3	919	0	940
5824	6	7	1	934	0	948
5825	883	5	1	19	0	908
5826	12	878	2	16	0	908
5827	890	16	3	5	0	914
5828	877	8	4	4	0	893
5829	881	3	2	3	0	889
5830	26	4	867	2	0	899
5831	15	2	14	841	0	872
5832	7	867	7	17	0	898
5833	5	895	4	12	0	916
5834	7	18	2	865	0	892
5835	5	895	2	14	0	916
5836	936	22	1	11	0	970
5837	16	8	942	11	0	977
5838	916	5	14	13	0	948
5839	983	6	6	5	0	1000
5840	27	2	7	987	0	1023
5841	1002	8	1	18	0	1029
5842	27	1067	0	10	0	1104
5843	1104	15	3	10	0	1132
5844	1108	6	3	7	0	1124
5845	1216	7	3	3	0	1229
5846	40	10	1224	3	0	1277
5847	19	5	1257	8	0	1289
5848	10	6	36	1218	0	1270
5849	9	1214	14	31	0	1268
5850	3	1275	11	12	0	1301
5851	8	39	3	1248	0	1298
5852	1261	16	5	33	0	1315
5853	33	9	4	1262	0	1308
5854	15	1	3	1303	0	1322
5855	1271	5	3	46	0	1325
5856	37	1286	2	18	0	1343
5857	11	33	1286	14	0	1344
5858	14	12	1293	8	0	1327
5859	1293	8	41	6	0	1348
5860	33	3	17	1293	0	1346
5861	19	1	1349	32	0	1401
5862	10	8	32	1328	0	1378
5863	7	4	13	1341	0	1365
5864	4	5	11	1363	0	1383
5865	7	4	5	1343	0	1359
5866	3	1311	4	45	0	1363
5867	3	30	5	1341	0	1379
5868	1322	10	2	42	0	1376
5869	30	1311	1	19	0	1361
5870	1338	30	5	14	0	1387
5871	1367	11	4	10	0	1392
5872	1359	7	4	9	0	1379
5873	46	4	1324	7	0	1381
5874	1329	5	27	10	0	1371
5875	1374	6	11	7	0	1398
5876	1335	4	7	10	0	1356
5877	1372	1	5	12	0	1390
5878	45	1347	3	7	0	1402
5879	1353	33	3	4	0	1393
5880	40	12	1314	7	0	1373
5881	18	9	28	1294	0	1349
5882	13	6	13	1320	0	1352
5883	1332	3	7	41	0	1383
5884	40	1317	4	15	0	1376
5885	1286	29	1	8	0	1324
5886	41	1275	4	4	0	1324
5887	1215	32	1	3	0	1251
5888	1220	6	2	4	0	1232
5889	31	1292	5	1	0	1329
5890	1278	29	3	3	0	1313
5891	1331	10	1	5	0	1347
5892	39	1240	3	2	0	1284
5893	11	1279	3	1	0	1294
5894	1355	30	1	5	0	1391
5895	35	8	0	1394	0	1437
5896	1406	3	0	35	0	1444
5897	1447	2	0	14	0	1463
5898	1483	1	1	5	0	1490
5899	1461	5	0	4	0	1470
5900	45	1411	4	2	0	1462
5901	19	1464	4	2	0	1489
5902	1464	41	3	2	0	1510
5903	37	11	1446	3	0	1497
5904	12	5	34	1419	0	1470
5905	8	1	9	1459	0	1477
5906	1408	5	4	46	0	1463
5907	33	1401	1	22	0	1457
5908	14	36	1	1395	0	1446
5909	5	15	1	1460	0	1481
5910	1424	5	1	52	0	1482
5911	43	1	2	1427	0	1473
5912	1405	9	1	44	0	1459
5913	1431	2	3	13	0	1449
5914	1432	3	4	9	0	1448
5915	55	5	3	1393	0	1456
5916	20	1	8	1405	0	1434
5917	16	3	1464	44	0	1527
5918	14	4	1450	21	0	1489
5919	1469	1	58	10	0	1538
5920	49	4	26	1499	0	1578
5921	23	5	1634	57	0	1719
5922	14	4	1673	27	0	1718
5923	8	2	77	1658	0	1745
5924	7	6	1685	55	0	1753
5925	6	6	59	1666	0	1737
5926	14	0	29	1685	0	1728
5927	12	6	1670	75	0	1763
5928	12	3	53	1688	0	1756
5929	16	4	30	1669	0	1719
5930	18	4	10	1749	0	1781
5931	13	3	1669	83	0	1768
5932	12	4	55	1703	0	1774
5933	1685	1	27	69	0	1782
5934	59	1679	19	35	0	1792
5935	1695	51	6	19	0	1771
5936	66	32	1644	15	0	1757
5937	1670	15	52	14	0	1751
5938	1697	10	36	10	0	1753
5939	1692	7	14	14	0	1727
5940	96	9	9	1607	0	1721
5941	52	2	11	1650	0	1715
5942	28	6	1510	88	0	1632
5943	1462	5	51	44	0	1562
5944	62	1476	27	25	0	1590
5945	34	1382	14	17	0	1447
5946	23	1396	10	14	0	1443
5947	22	63	20	1328	0	1433
5948	1298	35	11	45	0	1389
5949	1323	13	14	34	0	1384
5950	66	9	1282	18	0	1375
5951	46	5	36	1289	0	1376
5952	24	3	37	1308	0	1372
5953	15	5	1265	75	0	1360
5954	16	4	1235	53	0	1308
5955	1244	3	69	29	0	1345
5956	40	1259	40	23	0	1362
5957	1283	34	12	22	0	1351
5958	1282	25	10	16	0	1333
5959	68	19	6	1242	0	1335
5960	47	9	8	1281	0	1345
5961	1212	6	11	71	0	1300
5962	58	6	8	1229	0	1301
5963	39	5	8	1254	0	1306
5964	1222	3	7	73	0	1305
5965	52	7	12	1247	0	1318
5966	1238	3	13	60	0	1314
5967	1249	4	16	45	0	1314
5968	79	4	1202	27	0	1312
5969	1233	6	47	13	0	1299
5970	1232	7	34	22	0	1295
5971	1260	6	21	15	0	1302
5972	74	15	1026	25	0	1140
5973	1189	5	46	17	0	1257
5974	63	1154	29	13	0	1259
5975	1192	39	10	22	0	1263
5976	1209	28	13	25	0	1275
5977	73	10	9	1180	0	1272
5978	46	3	13	1203	0	1265
5979	23	1168	13	79	0	1283
5980	29	36	11	1191	0	1267
5981	17	32	9	1221	0	1279
5982	1173	12	9	79	0	1273
5983	55	10	13	1191	0	1269
5984	43	7	8	1209	0	1267
5985	32	4	9	1210	0	1255
5986	32	1146	6	66	0	1250
5987	1144	37	5	46	0	1232
5988	51	1147	11	29	0	1238
5989	1078	39	5	22	0	1144
5990	58	26	992	21	0	1097
5991	979	11	31	17	0	1038
5992	53	5	987	15	0	1060
5993	35	917	38	19	0	1009
5994	838	28	32	13	0	911
5995	780	24	18	10	0	832
5996	55	750	4	14	0	823
5997	37	743	8	14	0	802
5998	742	35	4	7	0	788
5999	745	28	6	7	0	786
6000	48	12	3	718	0	781
6001	40	7	4	737	0	788
6002	20	9	704	42	0	775
6003	711	3	22	33	0	769
6004	28	11	22	717	0	778
6005	30	716	13	25	0	784
6006	19	22	8	730	0	779
6007	21	21	2	743	0	787
6008	14	9	707	49	0	779
6009	8	10	16	735	0	769
6010	699	6	16	39	0	760
6011	25	678	8	31	0	742
6012	29	695	3	16	0	743
6013	686	39	3	13	0	741
6014	711	26	1	14	0	752
6015	709	11	6	10	0	736
6016	49	676	3	8	0	736
6017	23	602	3	3	0	631
6018	652	13	4	2	0	671
6019	646	18	2	2	0	668
6020	20	621	5	4	0	650
6021	3	470	2	1	0	476
6022	453	4	3	0	0	460
6023	5	3	2	444	0	454
6024	447	4	1	4	0	456
6025	13	9	0	431	0	453
6026	0	466	0	8	0	474
6027	4	453	1	3	0	461
6028	453	6	0	3	0	462
6029	457	3	1	6	0	467
6030	465	4	0	1	0	470
6031	10	456	0	5	0	471
6032	0	12	428	0	0	440
6033	2	436	6	0	0	444
6034	426	7	0	0	0	433
6035	419	0	2	1	0	422
6036	15	2	402	0	0	419
6037	2	411	5	0	0	418
6038	2	6	6	401	0	415
6039	0	6	2	394	0	402
6040	7	367	0	3	0	377
6041	6	5	390	2	0	403
6042	395	1	11	2	0	409
6043	6	8	0	401	0	415
6044	404	0	2	12	0	418
6045	407	1	0	6	0	414
6046	7	7	0	422	0	436
6047	12	0	6	443	0	461
6048	11	2	1	445	0	459
6049	1	4	0	459	0	464
6050	461	2	0	10	0	473
6051	471	0	0	6	0	477
6052	9	1	462	10	0	482
6053	4	3	7	464	0	478
6054	4	1	1	481	0	487
6055	1	3	3	479	0	486
6056	10	3	461	10	0	484
6057	8	0	9	451	0	468
6058	456	2	7	9	0	474
6059	9	3	3	461	0	476
6060	2	1	453	18	0	474
6061	6	1	9	456	0	472
6062	3	2	455	11	0	471
6063	447	2	11	7	0	467
6064	16	1	2	459	0	478
6065	452	1	5	16	0	474
6066	461	2	6	2	0	471
6067	11	0	0	466	0	477
6068	463	1	8	12	0	484
6069	17	2	1	445	0	465
6070	2	454	2	21	0	479
6071	481	8	0	3	0	492
6072	483	1	2	4	0	490
6073	476	4	2	7	0	489
6074	19	1	0	472	0	492
6075	4	0	0	481	0	485
6076	4	7	1	478	0	490
6077	8	2	453	15	0	478
6078	8	437	10	9	0	464
6079	12	8	1	445	0	466
6080	3	2	446	16	0	467
6081	430	3	12	10	0	455
6082	12	1	1	459	0	473
6083	1	1	450	12	0	464
6084	447	7	12	3	0	469
6085	12	0	2	467	0	481
6086	3	1	8	468	0	480
6087	12	0	1	469	0	482
6088	465	1	2	19	0	487
6089	464	0	8	7	0	479
6090	464	0	1	8	0	473
6091	9	443	2	9	0	463
6092	4	443	3	9	0	459
6093	452	8	1	10	0	471
6094	20	2	448	2	0	472
6095	11	1	9	442	0	463
6096	8	0	2	452	0	462
6097	445	6	1	11	0	463
6098	418	7	1	5	0	431
6099	13	427	3	3	0	446
6100	6	9	7	424	0	446
6101	4	0	424	17	0	445
6102	4	2	423	6	0	435
6103	10	0	10	419	0	439
6104	9	0	2	429	0	440
6105	413	6	3	10	0	432
6106	13	2	2	417	0	434
6107	421	3	7	15	0	446
6108	422	1	7	5	0	435
6109	12	0	431	9	0	452
6110	436	2	7	9	0	454
6111	437	0	2	3	0	442
6112	441	1	3	7	0	452
6113	14	438	1	1	0	454
6114	11	429	0	5	0	445
6115	3	11	7	417	0	438
6116	10	1	418	13	0	442
6117	8	398	9	3	0	418
6118	4	11	1	349	0	365
6119	2	0	1	337	0	340
6120	1	339	1	6	0	347
6121	339	7	0	0	0	346
6122	343	0	0	3	0	346
6123	7	1	351	0	0	359
6124	339	0	5	0	0	344
6125	6	0	339	3	0	348
6126	303	0	6	2	0	311
6127	9	0	315	1	0	325
6128	2	313	5	1	0	321
6129	6	3	0	290	0	299
6130	1	0	1	288	0	290
6131	295	1	0	2	0	298
6132	299	0	0	2	0	301
6133	293	0	0	2	0	295
6134	4	0	293	2	0	299
6135	1	0	4	298	0	303
6136	1	0	0	308	0	309
6137	296	0	1	4	0	301
6138	3	303	1	1	0	308
6139	313	2	0	2	0	317
6140	3	0	0	319	0	322
6141	0	1	1	328	0	330
6142	5	0	0	324	0	329
6143	1	0	0	328	0	329
6144	0	5	0	325	0	330
6145	0	322	0	7	0	329
6146	1	305	0	1	0	307
6147	1	276	0	0	0	277
6148	1	6	0	277	0	284
6149	0	1	272	3	0	276
6150	247	1	3	0	0	251
6151	4	265	3	0	0	272
6152	0	3	1	269	0	273
6153	0	0	0	275	0	275
6154	280	0	0	5	0	285
6155	279	0	0	0	0	279
6156	290	0	0	0	0	290
6157	3	1	0	323	0	327
6158	2	0	332	4	0	338
6159	0	0	360	0	0	360
6160	1	0	3	362	0	366
6161	0	0	364	4	0	368
6162	352	1	3	1	0	357
6163	4	0	0	361	0	365
6164	0	0	362	5	0	367
6165	3	0	3	354	0	360
6166	2	0	379	3	0	384
6167	2	0	399	1	0	402
6168	1	0	2	434	0	437
6169	1	0	470	5	0	476
6170	0	0	459	2	0	461
6171	1	450	6	0	0	457
6172	0	5	5	484	0	494
6173	517	3	2	7	0	529
6174	3	3	0	512	0	518
6175	3	0	0	528	0	531
6176	3	0	533	8	0	544
6177	500	0	3	8	0	511
6178	4	0	3	545	0	552
6179	3	1	2	551	0	557
6180	550	1	0	8	0	559
6181	4	1	1	553	0	559
6182	555	0	0	7	0	562
6183	548	1	1	6	0	556
6184	555	0	0	4	0	559
6185	8	538	0	0	0	546
6186	552	4	0	2	0	558
6187	7	550	0	1	0	558
6188	5	6	0	549	0	560
6189	551	3	0	3	0	557
6190	4	553	0	3	0	560
6191	563	3	0	4	0	570
6192	6	564	1	0	0	571
6193	545	7	1	5	0	558
6194	7	557	0	1	0	565
6195	3	571	1	7	0	582
6196	5	618	0	0	0	623
6197	1	9	0	604	0	614
6198	1	615	1	3	0	620
6199	0	7	1	612	0	620
6200	1	4	1	611	0	617
6201	0	4	1	616	0	621
6202	1	0	0	624	0	625
6203	609	1	1	9	0	620
6204	610	0	1	10	0	621
6205	9	1	607	4	0	621
6206	621	0	5	3	0	629
6207	660	1	3	1	0	665
6208	716	1	3	3	0	723
6209	13	0	708	1	0	722
6210	8	1	717	0	0	726
6211	709	1	9	2	0	721
6212	9	0	752	3	0	764
6213	7	803	10	2	0	822
6214	8	10	6	817	0	841
6215	855	8	4	12	0	879
6216	853	3	3	10	0	869
6217	864	1	4	4	0	873
6218	25	2	2	858	0	887
6219	12	2	3	877	0	894
6220	7	2	881	22	0	912
6221	2	3	14	877	0	896
6222	5	0	7	900	0	912
6223	876	0	2	25	0	903
6224	17	882	2	12	0	913
6225	895	14	1	9	0	919
6226	18	8	1	927	0	954
6227	927	4	3	15	0	949
6228	919	1	2	10	0	932
6229	891	1	1	6	0	899
6230	24	884	1	2	0	911
6231	14	917	0	1	0	932
6232	8	20	0	913	0	941
6233	912	10	2	15	0	939
6234	17	4	1	910	0	932
6235	11	2	1	925	0	939
6236	6	3	914	20	0	943
6237	3	3	12	911	0	929
6238	2	4	9	907	0	922
6239	3	2	3	904	0	912
6240	5	0	876	27	0	908
6241	3	1	863	17	0	884
6242	3	880	20	11	0	914
6243	874	11	15	4	0	904
6244	12	7	7	889	0	915
6245	8	4	909	18	0	939
6246	10	1	12	896	0	919
6247	5	2	10	934	0	951
6248	922	2	5	22	0	951
6249	914	3	3	14	0	934
6250	22	917	2	8	0	949
6251	927	11	1	5	0	944
6252	918	7	4	4	0	933
6253	23	5	2	909	0	939
6254	15	3	894	16	0	928
6255	5	898	13	10	0	926
6256	889	13	7	7	0	916
6257	872	11	3	5	0	891
6258	24	877	1	6	0	908
6259	15	14	2	905	0	936
6260	960	8	3	22	0	993
6261	970	3	4	16	0	993
6262	25	5	3	971	0	1004
6263	962	2	4	19	0	987
6264	1045	2	2	10	0	1059
6265	1046	4	2	5	0	1057
6266	33	5	1012	5	0	1055
6267	17	998	19	6	0	1040
6268	13	1005	9	2	0	1029
6269	960	18	2	8	0	988
6270	21	962	1	8	0	992
6271	11	21	971	3	0	1006
6272	9	5	17	967	0	998
6273	955	1	7	18	0	981
6274	22	5	2	944	0	973
6275	957	5	2	20	0	984
6276	953	3	6	7	0	969
6277	948	6	2	6	0	962
6278	25	919	4	5	0	953
6279	9	959	3	6	0	977
6280	952	22	2	6	0	982
6281	939	6	1	6	0	952
6282	956	3	0	8	0	967
6283	30	3	1	937	0	971
6284	939	2	1	18	0	960
6285	21	917	1	11	0	950
6286	14	952	2	4	0	972
6287	10	23	3	934	0	970
6288	8	8	929	21	0	966
6289	11	6	919	9	0	945
6290	9	4	21	928	0	962
6291	10	3	938	21	0	972
6292	8	4	20	941	0	973
6293	933	9	8	20	0	970
6294	23	4	1	931	0	959
6295	909	5	5	22	0	941
6296	21	881	7	11	0	920
6297	8	18	890	8	0	924
6298	3	8	20	873	0	904
6299	8	3	9	899	0	919
6300	11	2	895	25	0	933
6301	7	4	20	883	0	914
6302	8	904	8	21	0	941
6303	10	22	1	921	0	954
6304	11	9	4	929	0	953
6305	7	3	5	947	0	962
6306	5	8	931	30	0	974
6307	7	4	912	8	0	931
6308	805	1	25	7	0	838
6309	25	3	816	6	0	850
6310	6	817	24	3	0	850
6311	793	17	8	6	0	824
6312	21	817	2	2	0	842
6313	784	16	3	5	0	808
6314	772	9	5	2	0	788
6315	745	1	4	3	0	753
6316	747	2	4	1	0	754
6317	16	712	2	2	0	732
6318	11	735	2	1	0	749
6319	738	14	2	3	0	757
6320	17	7	717	3	0	744
6321	11	3	12	702	0	728
6322	6	6	3	723	0	738
6323	11	4	708	15	0	738
6324	661	3	16	4	0	684
6325	711	5	4	4	0	724
6326	679	3	0	9	0	691
6327	17	680	7	2	0	706
6328	704	15	5	5	0	729
6329	22	4	2	680	0	708
6330	5	727	6	19	0	757
6331	746	14	2	9	0	771
6332	766	4	3	7	0	780
6333	851	4	3	6	0	864
6334	30	3	2	821	0	856
6335	16	6	2	830	0	854
6336	10	808	3	29	0	850
6337	7	24	814	11	0	856
6338	9	8	20	805	0	842
6339	10	3	9	806	0	828
6340	10	6	2	853	0	871
6341	11	4	814	30	0	859
6342	805	3	20	12	0	840
6343	26	3	6	831	0	866
6344	11	5	823	27	0	866
6345	5	5	27	809	0	846
6346	814	4	12	28	0	858
6347	30	840	7	12	0	889
6348	11	24	9	863	0	907
6349	5	11	862	30	0	908
6350	814	2	27	17	0	860
6351	849	8	13	8	0	878
6352	40	2	842	6	0	890
6353	17	1	27	796	0	841
6354	11	833	13	26	0	883
6355	856	26	7	10	0	899
6356	28	10	840	9	0	887
6357	814	7	27	9	0	857
6358	37	2	838	7	0	884
6359	24	3	774	6	0	807
6360	696	1	33	9	0	739
6361	28	723	10	8	0	769
6362	11	25	718	3	0	757
6363	8	701	32	4	0	745
6364	5	21	670	6	0	702
6365	6	679	20	4	0	709
6366	648	19	17	3	0	687
6367	22	12	632	1	0	667
6368	13	4	638	5	0	660
6369	3	5	621	3	0	632
6370	593	11	29	1	0	634
6371	593	2	15	2	0	612
6372	27	4	9	562	0	602
6373	10	3	606	18	0	637
6374	6	2	625	9	0	642
6375	611	2	30	3	0	646
6376	23	3	12	633	0	671
6377	626	2	10	21	0	659
6378	648	2	11	7	0	668
6379	31	2	5	620	0	658
6380	15	614	4	20	0	653
6381	10	19	4	627	0	660
6382	9	7	6	639	0	661
6383	8	2	628	30	0	668
6384	5	611	24	14	0	654
6385	9	635	9	8	0	661
6386	7	24	3	619	0	653
6387	1	11	630	23	0	665
6388	3	627	21	8	0	659
6389	6	21	631	7	0	665
6390	598	11	23	12	0	644
6391	631	2	13	7	0	653
6392	27	7	626	7	0	667
6393	613	3	30	6	0	652
6394	24	3	13	618	0	658
6395	15	647	4	21	0	687
6396	9	20	9	657	0	695
6397	649	11	4	25	0	689
6398	668	4	5	14	0	691
6399	662	9	7	6	0	684
6400	657	2	5	7	0	671
6401	34	621	3	4	0	662
6402	14	627	6	6	0	653
6403	632	24	6	3	0	665
6404	27	10	622	4	0	663
6405	16	17	19	589	0	641
6406	7	615	10	13	0	645
6407	10	16	4	597	0	627
6408	2	602	10	18	0	632
6409	5	21	5	615	0	646
6410	4	14	621	19	0	658
6411	613	5	19	10	0	647
6412	630	6	10	3	0	649
6413	26	5	623	5	0	659
6414	609	6	24	0	0	639
6415	635	6	8	4	0	653
6416	31	2	626	2	0	661
6417	10	4	22	606	0	642
6418	623	0	14	18	0	655
6419	23	5	626	8	0	662
6420	10	2	22	610	0	644
6421	3	5	634	19	0	661
6422	8	2	634	9	0	653
6423	620	2	29	3	0	654
6424	656	0	12	3	0	671
6425	657	0	5	2	0	664
6426	672	0	5	4	0	681
6427	33	4	4	634	0	675
6428	13	620	1	25	0	659
6429	9	652	4	7	0	672
6430	3	25	5	605	0	638
6431	614	5	0	26	0	645
6432	21	594	3	8	0	626
6433	1	534	0	1	0	536
6434	540	13	0	1	0	554
6435	13	1	0	547	0	561
6436	546	1	1	14	0	562
6437	13	551	1	1	0	566
6438	561	14	0	1	0	576
6439	13	2	594	1	0	610
6440	678	0	13	1	0	692
6441	732	1	4	0	0	737
6442	765	1	0	1	0	767
6443	24	2	717	0	0	743
6444	720	1	14	1	0	736
6445	28	737	1	0	0	766
6446	8	20	734	1	0	763
6447	1	6	23	679	0	709
6448	1	2	2	693	0	698
6449	1	687	2	21	0	711
6450	2	20	1	701	0	724
6451	1	2	2	726	0	731
6452	3	2	697	25	0	727
6453	642	2	21	5	0	670
6454	20	0	695	2	0	717
6455	3	0	23	686	0	712
6456	3	0	708	22	0	733
6457	1	1	22	712	0	736
6458	729	0	4	25	0	758
6459	761	0	2	5	0	768
6460	24	0	4	756	0	784
6461	7	0	800	23	0	830
6462	5	0	23	797	0	825
6463	3	0	790	23	0	816
6464	761	0	23	4	0	788
6465	784	0	3	3	0	790
6466	781	2	2	1	0	786
6467	790	1	2	1	0	794
6468	25	759	0	3	0	787
6469	8	23	1	763	0	795
6470	760	5	1	22	0	788
6471	23	759	1	4	0	787
6472	5	783	0	3	0	791
6473	3	23	722	1	0	749
6474	717	6	19	1	0	743
6475	741	3	4	1	0	749
6476	23	2	697	2	0	724
6477	6	0	23	702	0	731
6478	4	1	3	720	0	728
6479	4	1	705	24	0	734
6480	3	1	22	698	0	724
6481	702	0	5	23	0	730
6482	25	0	677	5	0	707
6483	6	0	704	2	0	712
6484	684	0	24	8	0	716
6485	25	1	704	2	0	732
6486	698	1	24	5	0	728
6487	23	691	7	2	0	723
6488	712	21	3	2	0	738
6489	25	5	2	710	0	742
6490	5	4	1	738	0	748
6491	710	1	2	23	0	736
6492	25	3	1	715	0	744
6493	711	2	2	24	0	739
6494	25	709	2	4	0	740
6495	6	23	1	694	0	724
6496	6	4	1	709	0	720
6497	678	3	2	26	0	709
6498	690	2	0	8	0	700
6499	698	1	0	6	0	705
6500	26	654	4	4	0	688
6501	10	686	2	4	0	702
6502	680	23	2	2	0	707
6503	22	5	667	3	0	697
6504	4	665	23	3	0	695
6505	647	17	7	4	0	675
6506	636	4	6	2	0	648
6507	635	2	1	4	0	642
6508	22	3	0	614	0	639
6509	618	1	4	17	0	640
6510	615	1	2	7	0	625
6511	20	2	5	582	0	609
6512	595	2	1	18	0	616
6513	23	0	572	5	0	600
6514	8	1	15	572	0	596
6515	8	2	2	586	0	598
6516	3	0	3	593	0	599
6517	580	0	1	25	0	606
6518	596	1	1	9	0	607
6519	583	0	1	8	0	592
6520	576	0	1	7	0	584
6521	571	2	4	0	0	577
6522	24	2	1	545	0	572
6523	13	0	1	559	0	573
6524	553	0	3	21	0	577
6525	19	541	2	8	0	570
6526	554	13	0	5	0	572
6527	18	4	535	2	0	559
6528	542	5	12	2	0	561
6529	556	4	3	3	0	566
6530	21	0	576	3	0	600
6531	596	0	16	2	0	614
6532	22	2	610	3	0	637
6533	15	0	652	0	0	667
6534	10	3	24	634	0	671
6535	8	1	19	669	0	697
6536	5	1	667	26	0	699
6537	9	0	667	19	0	695
6538	4	652	28	11	0	695
6539	5	639	18	3	0	665
6540	508	20	14	4	0	546
6541	10	534	3	2	0	549
6542	504	12	3	3	0	522
6543	12	500	2	3	0	517
6544	499	12	1	2	0	514
6545	12	8	491	1	0	512
6546	485	7	6	3	0	501
6547	14	3	6	473	0	496
6548	13	481	3	11	0	508
6549	11	10	0	503	0	524
6550	492	7	7	10	0	516
6551	492	5	10	8	0	515
6552	17	7	1	485	0	510
6553	12	9	475	8	0	504
6554	14	2	474	8	0	498
6555	4	488	12	7	0	511
6556	22	6	9	468	0	505
6557	4	14	471	13	0	502
6558	9	431	14	9	0	463
6559	7	11	27	414	0	459
6560	11	13	3	426	0	453
6561	380	11	2	18	0	411
6562	13	7	3	386	0	409
6563	8	9	378	16	0	411
6564	16	6	5	379	0	406
6565	376	6	8	14	0	404
6566	14	2	383	15	0	414
6567	382	1	16	5	0	404
6568	15	382	12	6	0	415
6569	390	12	6	9	0	417
6570	396	11	1	11	0	419
6571	18	5	8	382	0	413
6572	17	6	4	383	0	410
6573	13	378	3	19	0	413
6574	2	8	4	406	0	420
6575	390	6	9	11	0	416
6576	9	4	394	16	0	423
6577	9	6	12	384	0	411
6578	6	384	10	19	0	419
6579	9	9	12	388	0	418
6580	4	12	7	400	0	423
6581	390	6	2	20	0	418
6582	9	391	6	16	0	422
6583	20	9	1	387	0	417
6584	381	7	4	14	0	406
6585	9	5	8	384	0	406
6586	11	2	2	391	0	406
6587	392	8	4	18	0	422
6588	376	6	8	22	0	412
6589	25	2	379	11	0	417
6590	387	9	13	3	0	412
6591	392	3	7	11	0	413
6592	392	8	5	6	0	411
6593	20	366	1	15	0	402
6594	17	369	2	15	0	403
6595	14	19	2	378	0	413
6596	382	15	1	14	0	412
6597	385	6	5	15	0	411
6598	21	4	5	374	0	404
6599	11	4	380	22	0	417
6600	394	11	5	12	0	422
6601	412	1	6	18	0	437
6602	23	2	4	399	0	428
6603	21	4	7	408	0	440
6604	416	6	1	22	0	445
6605	18	1	6	413	0	438
6606	24	402	3	14	0	443
6607	10	17	2	427	0	456
6608	405	15	3	21	0	444
6609	18	5	400	15	0	438
6610	396	6	6	9	0	417
6611	19	1	402	9	0	431
6612	17	4	8	406	0	435
6613	426	2	13	14	0	455
6614	21	2	7	422	0	452
6615	20	8	6	422	0	456
6616	419	5	3	27	0	454
6617	13	1	422	25	0	461
6618	21	4	436	9	0	470
6619	18	1	12	436	0	467
6620	6	9	13	461	0	489
6621	9	0	11	469	0	489
6622	19	3	449	20	0	491
6623	452	2	14	20	0	488
6624	471	2	9	14	0	496
6625	472	2	12	14	0	500
6626	476	1	5	15	0	497
6627	24	447	3	12	0	486
6628	12	467	4	14	0	497
6629	11	459	2	15	0	487
6630	14	6	2	401	0	423
6631	6	2	12	407	0	427
6632	9	1	386	5	0	401
6633	4	343	6	11	0	364
6634	2	9	2	312	0	325
6635	302	0	0	2	0	304
6636	2	307	0	0	0	309
6637	0	1	0	298	0	299
6638	0	297	0	2	0	299
6639	304	2	0	0	0	306
6640	3	0	0	303	0	306
6641	0	0	310	2	0	312
6642	1	0	314	0	0	315
6643	1	5	2	323	0	331
6644	1	0	0	318	0	319
6645	1	1	0	328	0	330
6646	328	1	0	2	0	331
6647	2	0	326	1	0	329
6648	1	320	1	0	0	322
6649	2	2	0	318	0	322
6650	0	0	318	3	0	321
6651	0	313	3	0	0	316
6652	1	2	0	336	0	339
6653	1	0	340	2	0	343
6654	0	0	2	334	0	336
6655	0	0	0	338	0	338
6656	340	0	0	2	0	342
6657	333	0	0	1	0	334
6658	2	0	0	334	0	336
6659	336	0	1	2	0	339
6660	3	0	337	0	0	340
6661	0	0	3	338	0	341
6662	1	0	341	3	0	345
6663	0	0	4	343	0	347
6664	0	336	0	4	0	340
6665	0	330	1	1	0	332
6666	0	324	0	1	0	325
6667	0	5	0	334	0	339
6668	0	0	0	369	0	369
6669	0	1	362	6	0	369
6670	0	0	361	0	0	361
6671	0	0	412	1	0	413
6672	418	0	6	0	0	424
6673	6	0	1	438	0	445
6674	449	0	1	6	0	456
6675	8	480	0	0	0	488
6676	0	6	0	476	0	482
6677	478	1	0	7	0	486
6678	6	4	0	478	0	488
6679	478	1	0	11	0	490
6680	11	0	491	2	0	504
6681	2	502	7	4	0	515
6682	4	6	1	501	0	512
6683	500	1	3	8	0	512
6684	514	4	1	1	0	520
6685	8	1	0	512	0	521
6686	4	0	0	520	0	524
6687	503	0	0	8	0	511
6688	9	0	0	494	0	503
6689	1	0	486	12	0	499
6690	4	495	7	4	0	510
6691	1	6	1	506	0	514
6692	508	1	4	8	0	521
6693	519	4	1	2	0	526
6694	9	1	523	5	0	538
6695	5	507	8	2	0	522
6696	6	546	1	1	0	554
6697	3	9	4	542	0	558
6698	3	3	2	559	0	567
6699	1	4	0	557	0	562
6700	3	2	0	557	0	562
6701	1	546	1	16	0	564
6702	1	9	1	557	0	568
6703	0	1	1	555	0	557
6704	544	4	1	13	0	562
6705	539	2	1	9	0	551
6706	8	560	1	9	0	578
6707	562	8	3	4	0	577
6708	573	1	1	6	0	581
6709	573	5	0	4	0	582
6710	19	1	552	2	0	574
6711	9	2	9	552	0	572
6712	8	0	3	573	0	584
6713	5	1	550	10	0	566
6714	3	0	9	534	0	546
6715	6	1	5	506	0	518
6716	535	0	8	14	0	557
6717	11	3	523	8	0	545
6718	1	2	11	515	0	529
6719	509	4	1	12	0	526
6720	10	496	4	7	0	517
6721	502	7	1	11	0	521
6722	501	2	0	4	0	507
6723	10	496	1	4	0	511
6724	9	7	0	498	0	514
6725	506	2	3	8	0	519
6726	12	502	1	5	0	520
6727	6	8	1	501	0	516
6728	481	5	1	8	0	495
6729	476	7	0	7	0	490
6730	12	468	1	10	0	491
6731	481	9	1	4	0	495
6732	17	3	2	479	0	501
6733	479	8	2	11	0	500
6734	14	3	473	5	0	495
6735	3	2	8	486	0	499
6736	9	0	2	478	0	489
6737	467	0	4	11	0	482
6738	9	453	1	11	0	474
6739	453	7	2	11	0	473
6740	11	442	1	5	0	459
6741	7	12	425	5	0	449
6742	9	4	423	2	0	438
6743	4	6	11	402	0	423
6744	6	3	420	9	0	438
6745	6	1	12	419	0	438
6746	5	0	5	414	0	424
6747	3	2	7	430	0	442
6748	422	2	3	18	0	445
6749	425	3	3	8	0	439
6750	437	0	0	13	0	450
6751	17	453	2	5	0	477
6752	13	464	1	4	0	482
6753	10	14	492	4	0	520
6754	9	7	11	504	0	531
6755	4	7	514	14	0	539
6756	2	4	18	515	0	539
6757	6	1	8	528	0	543
6758	1	4	7	526	0	538
6759	2	4	507	26	0	539
6760	5	2	11	514	0	532
6761	503	4	7	21	0	535
6762	14	495	6	13	0	528
6763	4	11	4	507	0	526
6764	503	5	2	18	0	528
6765	511	8	4	10	0	533
6766	20	5	1	500	0	526
6767	15	2	3	488	0	508
6768	466	5	1	22	0	494
6769	20	0	2	473	0	495
6770	439	1	2	19	0	461
6771	19	1	0	418	0	438
6772	8	0	375	21	0	404
6773	8	348	9	11	0	376
6774	5	369	5	10	0	389
6775	3	10	2	341	0	356
6776	4	5	1	342	0	352
6777	335	3	1	14	0	353
6778	10	4	1	336	0	351
6779	4	4	1	336	0	345
6780	3	1	0	322	0	326
6781	2	304	0	18	0	324
6782	4	7	1	317	0	329
6783	4	3	0	326	0	333
6784	2	1	0	331	0	334
6785	304	2	0	16	0	322
6786	6	316	2	10	0	334
6787	3	9	1	322	0	335
6788	2	7	1	328	0	338
6789	2	3	1	336	0	342
6790	312	0	2	17	0	331
6791	12	1	0	317	0	330
6792	4	2	0	315	0	321
6793	2	0	292	19	0	313
6794	2	278	5	12	0	297
6795	1	6	2	291	0	300
6796	274	5	0	13	0	292
6797	7	274	2	8	0	291
6798	264	6	1	8	0	279
6799	272	4	1	3	0	280
6800	12	4	1	269	0	286
6801	5	2	1	275	0	283
6802	6	1	276	13	0	296
6803	3	1	7	288	0	299
6804	5	0	287	12	0	304
6805	4	0	7	292	0	303
6806	269	0	5	15	0	289
6807	7	282	4	8	0	301
6808	4	10	4	291	0	309
6809	2	5	0	301	0	308
6810	3	1	2	300	0	306
6811	1	5	0	299	0	305
6812	293	2	0	12	0	307
6813	8	289	2	11	0	310
6814	4	7	1	310	0	322
6815	301	2	2	14	0	319
6816	7	2	300	9	0	318
6817	298	1	7	9	0	315
6818	310	1	6	6	0	323
6819	12	2	298	5	0	317
6820	8	0	5	301	0	314
6821	301	3	4	6	0	314
6822	9	299	3	7	0	318
6823	310	5	1	7	0	323
6824	313	3	1	5	0	322
6825	316	1	1	4	0	322
6826	13	1	0	304	0	318
6827	9	3	1	313	0	326
6828	5	374	1	11	0	391
6829	8	10	0	383	0	401
6830	387	3	1	13	0	404
6831	14	1	376	7	0	398
6832	371	3	11	4	0	389
6833	382	1	5	2	0	390
6834	15	3	2	379	0	399
6835	7	0	2	392	0	401
6836	380	2	1	15	0	398
6837	385	1	3	4	0	393
6838	364	0	1	7	0	372
6839	15	0	375	5	0	395
6840	6	368	8	11	0	393
6841	373	10	3	5	0	391
6842	14	6	0	369	0	389
6843	5	375	1	15	0	396
6844	6	11	1	379	0	397
6845	382	3	2	12	0	399
6846	13	3	1	379	0	396
6847	7	2	388	14	0	411
6848	1	380	8	10	0	399
6849	2	403	3	7	0	415
6850	5	9	375	4	0	393
6851	325	5	3	3	0	336
6852	6	334	2	4	0	346
6853	0	4	3	282	0	289
6854	280	1	0	4	0	285
6855	3	283	0	0	0	286
6856	1	4	0	285	0	290
6857	288	0	1	4	0	293
6858	4	0	0	290	0	294
6859	289	0	0	4	0	293
6860	4	0	286	1	0	291
6861	0	288	3	1	0	292
6862	316	4	0	0	0	320
6863	313	0	0	0	0	313
6864	317	0	0	0	0	317
6865	4	0	309	0	0	313
6866	306	1	3	0	0	310
6867	324	0	0	0	0	324
6868	3	0	0	321	0	324
6869	320	1	0	4	0	325
6870	4	316	0	1	0	321
6871	1	4	0	317	0	322
6872	0	0	320	5	0	325
6873	0	6	5	306	0	317
6874	0	1	0	317	0	318
6875	317	1	0	4	0	322
6876	320	0	1	1	0	322
6877	5	1	321	0	0	327
6878	317	1	4	0	0	322
6879	5	1	325	1	0	332
6880	1	0	4	326	0	331
6881	1	3	324	3	0	331
6882	0	1	3	324	0	328
6883	1	326	0	3	0	330
6884	1	3	328	1	0	333
6885	1	0	338	0	0	339
6886	0	0	9	278	0	287
6887	332	1	3	6	0	342
6888	335	1	1	2	0	339
6889	339	1	0	1	0	341
6890	9	0	0	331	0	340
6891	5	0	1	335	0	341
6892	2	0	1	337	0	340
6893	2	0	0	340	0	342
6894	0	1	322	10	0	333
6895	0	0	6	324	0	330
6896	1	313	2	9	0	325
6897	0	7	2	325	0	334
6898	320	1	1	9	0	331
6899	11	0	309	2	0	322
6900	284	0	7	3	0	294
6901	11	1	321	1	0	334
6902	4	0	310	0	0	314
6903	3	299	12	1	0	315
6904	2	10	8	266	0	286
6905	0	3	5	304	0	312
6906	0	267	2	16	0	285
6907	308	9	2	6	0	325
6908	9	3	1	326	0	339
6909	4	6	0	385	0	395
6910	4	1	1	405	0	411
6911	440	0	2	18	0	460
6912	477	0	0	11	0	488
6913	17	1	1	466	0	485
6914	8	1	0	476	0	485
6915	460	1	0	18	0	479
6916	14	1	1	459	0	475
6917	8	0	0	476	0	484
6918	6	2	0	479	0	487
6919	2	0	451	27	0	480
6920	442	0	12	10	0	464
6921	466	0	5	8	0	479
6922	18	1	447	6	0	472
6923	8	0	14	414	0	436
6924	8	442	5	14	0	469
6925	439	13	3	7	0	462
6926	15	430	4	5	0	454
6927	8	432	3	5	0	448
6928	3	14	3	372	0	392
6929	375	6	0	13	0	394
6930	386	4	3	7	0	400
6931	15	5	2	384	0	406
6932	10	0	0	390	0	400
6933	5	4	0	393	0	402
6934	5	1	1	393	0	400
6935	4	1	0	382	0	387
6936	3	373	0	21	0	397
6937	3	9	1	390	0	403
6938	373	4	0	19	0	396
6939	380	3	1	10	0	394
6940	398	2	0	8	0	408
6941	18	373	1	9	0	401
6942	11	12	2	371	0	396
6943	8	6	370	15	0	399
6944	362	4	11	9	0	386
6945	15	3	4	370	0	392
6946	363	4	3	15	0	385
6947	354	2	4	7	0	367
6948	358	2	1	9	0	370
6949	22	2	1	343	0	368
6950	343	2	3	14	0	362
6951	19	1	0	342	0	362
6952	11	1	2	346	0	360
6953	344	0	1	19	0	364
6954	15	0	0	356	0	371
6955	347	2	0	18	0	367
6956	354	2	1	11	0	368
6957	18	1	0	344	0	363
6958	9	3	1	353	0	366
6959	9	0	1	353	0	363
6960	9	1	329	21	0	360
6961	6	3	332	14	0	355
6962	6	0	14	326	0	346
6963	3	1	7	336	0	347
6964	6	2	5	332	0	345
6965	5	0	4	326	0	335
6966	4	2	2	329	0	337
6967	310	2	2	24	0	338
6968	13	305	2	16	0	336
6969	8	10	2	317	0	337
6970	318	5	1	16	0	340
6971	15	4	1	319	0	339
6972	9	2	0	324	0	335
6973	307	1	0	24	0	332
6974	317	1	1	16	0	335
6975	20	2	302	10	0	334
6976	10	2	9	309	0	330
6977	8	2	295	18	0	323
6978	8	0	13	302	0	323
6979	6	0	6	305	0	317
6980	6	0	5	311	0	322
6981	4	2	293	20	0	319
6982	5	269	12	17	0	303
6983	3	297	7	11	0	318
6984	6	7	5	287	0	305
6985	280	5	3	17	0	305
6986	9	4	286	8	0	307
6987	6	2	282	10	0	300
6988	5	2	12	288	0	307
6989	4	2	5	281	0	292
6990	4	282	5	15	0	306
6991	2	8	3	293	0	306
6992	2	4	4	297	0	307
6993	3	2	1	312	0	318
6994	299	1	2	18	0	320
6995	304	2	3	10	0	319
6996	9	1	3	304	0	317
6997	5	299	1	15	0	320
6998	7	6	0	306	0	319
6999	298	4	0	13	0	315
7000	9	302	2	10	0	323
7001	7	7	3	269	0	286
7002	2	288	3	12	0	305
7003	284	6	1	7	0	298
7004	270	4	0	6	0	280
7005	10	289	2	5	0	306
7006	4	277	2	4	0	287
7007	4	7	261	7	0	279
7008	3	246	6	4	0	259
7009	5	5	3	187	0	200
7010	2	1	177	4	0	184
7011	0	121	3	2	0	126
7012	3	2	0	101	0	106
7013	0	0	0	103	0	103
7014	1	0	0	103	0	104
7015	102	0	0	2	0	104
7016	2	0	100	1	0	103
7017	0	0	107	1	0	108
7018	0	0	2	109	0	111
7019	0	0	122	2	0	124
7020	1	0	3	125	0	129
7021	0	0	0	123	0	123
7022	0	0	0	134	0	134
7023	1	0	0	131	0	132
7024	129	0	0	3	0	132
7025	131	0	0	1	0	132
7026	3	0	0	129	0	132
7027	0	1	133	2	0	136
7028	0	3	2	126	0	131
7029	1	130	0	1	0	132
7030	0	1	0	130	0	131
7031	129	0	0	2	0	131
7032	129	0	0	0	0	129
7033	6	0	0	128	0	134
7034	0	0	1	132	0	133
7035	0	0	0	134	0	134
7036	132	0	1	1	0	134
7037	1	0	129	1	0	131
7038	4	0	125	1	0	130
7039	0	127	1	2	0	130
7040	119	1	0	0	0	120
7041	2	0	0	130	0	132
7042	0	0	137	1	0	138
7043	0	137	1	0	0	138
7044	0	139	0	0	0	139
7045	0	1	0	145	0	146
7046	0	0	0	146	0	146
7047	0	141	0	1	0	142
7048	0	1	0	146	0	147
7049	0	0	0	148	0	148
7050	146	0	0	1	0	147
7051	1	148	0	0	0	149
7052	0	4	0	144	0	148
7053	0	0	144	1	0	145
7054	0	0	1	136	0	137
7055	134	0	0	1	0	135
7056	1	135	0	0	0	136
7057	0	1	0	136	0	137
7058	0	0	141	1	0	142
7059	0	0	145	0	0	145
7060	0	0	1	139	0	140
7061	0	0	0	146	0	146
7062	147	0	0	1	0	148
7063	1	156	0	0	0	157
7064	153	2	0	0	0	155
7065	3	1	164	0	0	168
7066	160	0	2	0	0	162
7067	3	1	175	0	0	179
7068	171	0	2	2	0	175
7069	185	0	1	0	0	186
7070	3	1	195	0	0	199
7071	2	0	194	1	0	197
7072	0	193	3	0	0	196
7073	2	2	1	203	0	208
7074	204	1	1	1	0	207
7075	2	0	0	207	0	209
7076	1	1	0	210	0	212
7077	0	0	1	212	0	213
7078	0	2	210	3	0	215
7079	186	0	3	3	0	192
7080	216	0	2	1	0	219
7081	3	227	0	1	0	231
7082	2	2	0	225	0	229
7083	0	234	1	3	0	238
7084	0	2	1	232	0	235
7085	234	0	0	3	0	237
7086	2	230	2	1	0	235
7087	1	4	0	233	0	238
7088	232	1	0	5	0	238
7089	234	0	2	2	0	238
7090	4	0	0	234	0	238
7091	2	1	238	4	0	245
7092	3	3	3	222	0	231
7093	2	228	1	4	0	235
7094	229	3	2	1	0	235
7095	3	229	1	1	0	234
7096	0	7	1	223	0	231
7097	227	1	0	6	0	234
7098	5	1	0	233	0	239
7099	3	0	0	233	0	236
7100	0	1	236	6	0	243
7101	0	235	2	4	0	241
7102	238	3	2	1	0	244
7103	226	1	1	1	0	229
7104	6	243	1	1	0	251
7105	1	229	1	1	0	232
7106	1	4	1	226	0	232
7107	221	2	0	3	0	226
7108	2	222	0	2	0	226
7109	2	3	0	227	0	232
7110	0	4	229	2	0	235
7111	0	0	2	224	0	226
7112	232	0	1	2	0	235
7113	4	229	0	2	0	235
7114	1	2	0	233	0	236
7115	0	1	227	2	0	230
7116	0	2	224	4	0	230
7117	2	1	3	219	0	225
7118	3	1	1	224	0	229
7119	0	211	0	4	0	215
7120	1	3	1	212	0	217
7121	216	1	1	3	0	221
7122	3	1	0	214	0	218
7123	212	1	0	5	0	218
7124	2	210	3	2	0	217
7125	2	220	0	1	0	223
7126	3	3	1	222	0	229
7127	4	0	0	230	0	234
7128	2	3	220	3	0	228
7129	0	3	3	215	0	221
7130	214	0	3	4	0	221
7131	4	1	220	2	0	227
7132	1	2	2	225	0	230
7133	1	0	235	5	0	241
7134	0	1	4	232	0	237
7135	2	0	1	232	0	235
7136	2	0	1	239	0	242
7137	0	2	239	4	0	245
7138	2	0	3	237	0	242
7139	1	244	3	3	0	251
7140	1	4	2	253	0	260
7141	0	1	0	245	0	246
7142	240	1	1	7	0	249
7143	2	2	242	3	0	249
7144	2	2	2	242	0	248
7145	3	1	242	3	0	249
7146	1	1	244	5	0	251
7147	4	0	3	262	0	269
7148	1	2	3	260	0	266
7149	0	2	0	276	0	278
7150	269	0	2	6	0	277
7151	2	0	266	4	0	272
7152	269	1	4	2	0	276
7153	3	0	2	287	0	292
7154	3	2	0	297	0	302
7155	1	308	2	6	0	317
7156	0	2	1	318	0	321
7157	2	1	2	316	0	321
7158	0	0	1	319	0	320
7159	303	1	1	6	0	311
7160	2	2	297	4	0	305
7161	274	0	4	2	0	280
7162	3	301	1	4	0	309
7163	291	2	1	2	0	296
7164	2	286	0	1	0	289
7165	1	290	2	1	0	294
7166	9	1	2	296	0	308
7167	309	1	5	2	0	317
7168	2	0	0	308	0	310
7169	0	301	1	2	0	304
7170	1	315	1	1	0	318
7171	0	1	1	322	0	324
7172	2	0	0	314	0	316
7173	0	323	2	6	0	331
7174	3	5	0	338	0	346
7175	0	3	2	348	0	353
7176	1	0	0	355	0	356
7177	348	1	0	8	0	357
7178	6	1	356	1	0	364
7179	352	3	5	0	0	360
7180	364	1	0	5	0	370
7181	365	0	0	5	0	370
7182	5	356	0	1	0	362
7183	1	4	1	358	0	364
7184	355	2	0	7	0	364
7185	6	2	0	361	0	369
7186	366	0	0	4	0	370
7187	2	395	3	0	0	400
7188	416	3	0	1	0	420
7189	424	2	0	3	0	429
7190	434	1	0	1	0	436
7191	3	2	1	435	0	441
7192	0	1	0	457	0	458
7193	456	1	0	5	0	462
7194	4	451	0	3	0	458
7195	2	450	0	2	0	454
7196	471	4	1	1	0	477
7197	6	1	0	479	0	486
7198	1	1	1	474	0	477
7199	3	0	0	487	0	490
7200	0	482	0	3	0	485
7201	481	4	0	2	0	487
7202	4	1	0	485	0	490
7203	1	493	0	4	0	498
7204	2	3	0	509	0	514
7205	2	1	1	509	0	513
7206	2	2	0	511	0	515
7207	2	1	0	517	0	520
7208	505	0	0	5	0	510
7209	498	2	0	0	0	500
7210	517	0	0	2	0	519
7211	4	0	0	532	0	536
7212	0	1	520	6	0	527
7213	3	0	486	2	0	491
7214	1	2	520	1	0	524
7215	544	1	3	2	0	550
7216	5	0	0	557	0	562
7217	4	0	0	561	0	565
7218	1	1	0	566	0	568
7219	571	0	0	6	0	577
7220	568	1	0	1	0	570
7221	4	622	1	1	0	628
7222	1	4	0	631	0	636
7223	1	3	631	3	0	638
7224	2	646	3	2	0	653
7225	1	6	0	651	0	658
7226	1	4	0	653	0	658
7227	1	0	0	643	0	644
7228	3	0	0	636	0	639
7229	3	0	656	4	0	663
7230	0	1	624	0	0	625
7231	0	663	3	2	0	668
7232	0	3	0	670	0	673
7233	0	1	0	670	0	671
7234	662	0	0	4	0	666
7235	4	0	678	1	0	683
7236	2	0	3	679	0	684
7237	1	0	1	715	0	717
7238	1	1	735	4	0	741
7239	0	725	5	1	0	731
7240	723	4	1	1	0	729
7241	3	0	727	3	0	733
7242	704	0	3	2	0	709
7243	3	0	785	3	0	791
7244	0	0	4	791	0	795
7245	0	0	805	5	0	810
7246	0	0	814	1	0	815
7247	0	0	4	828	0	832
7248	12	3	6	664	0	685
7249	1	1	0	861	0	863
7250	0	0	1	839	0	840
7251	3	0	0	838	0	841
7252	1	0	849	3	0	853
7253	1	1	792	2	0	796
7254	0	832	4	1	0	837
7255	837	4	0	0	0	841
7256	3	0	0	853	0	856
7257	855	0	0	5	0	860
7258	3	0	0	852	0	855
7259	865	0	0	5	0	870
7260	3	0	0	876	0	879
7261	0	0	1	874	0	875
7262	0	900	1	7	0	908
7263	1	4	0	922	0	927
7264	1	0	1	920	0	922
7265	0	0	0	908	0	908
7266	1	0	0	901	0	902
7267	0	877	0	5	0	882
7268	880	3	0	2	0	885
7269	3	874	0	1	0	878
7270	0	3	0	873	0	876
7271	859	1	0	3	0	863
7272	4	1	841	0	0	846
7273	0	1	829	0	0	830
7274	0	0	3	808	0	811
7275	1	0	0	844	0	845
7276	0	0	1	843	0	844
7277	0	0	2	797	0	799
7278	0	0	0	826	0	826
7279	0	806	0	8	0	814
7280	0	1	0	836	0	837
7281	825	0	0	2	0	827
7282	1	0	0	829	0	830
7283	0	1	838	1	0	840
7284	1	0	2	818	0	821
7285	827	0	0	5	0	832
7286	2	832	0	1	0	835
7287	0	3	1	865	0	869
7288	1	0	0	892	0	893
7289	1	0	872	12	0	885
7290	0	1	1109	1	0	1111
7291	1413	0	28	1	0	1442
7292	36	0	3	1461	0	1500
7293	14	0	4	1526	0	1544
7294	8	1	1601	54	0	1664
7295	8	0	1631	23	0	1662
7296	3	1614	59	18	0	1694
7297	4	48	20	1602	0	1674
7298	2	14	1614	50	0	1680
7299	1	1613	59	14	0	1687
7300	1615	58	19	10	0	1702
7301	1678	18	8	9	0	1713
7302	64	9	10	1591	0	1674
7303	22	1631	8	43	0	1704
7304	1638	54	3	14	0	1709
7305	63	16	1	1546	0	1626
7306	23	15	1595	42	0	1675
7307	9	1618	49	18	0	1694
7308	1618	55	18	11	0	1702
7309	1676	17	10	11	0	1714
7310	62	10	10	1641	0	1723
7311	26	11	4	1674	0	1715
7312	15	5	1619	70	0	1709
7313	18	3	52	1636	0	1709
7314	17	2	19	1589	0	1627
7315	6	3	9	1665	0	1683
7316	6	1	11	1662	0	1680
7317	4	3	12	1602	0	1621
7318	1	1578	8	86	0	1673
7319	1568	49	3	36	0	1656
7320	54	15	1578	28	0	1675
7321	20	1526	54	17	0	1617
7322	14	59	17	1538	0	1628
7323	1539	17	10	62	0	1628
7324	60	11	12	1533	0	1616
7325	19	9	9	1571	0	1608
7326	13	15	4	1589	0	1621
7327	18	3	3	1591	0	1615
7328	6	5	1506	94	0	1611
7329	6	1489	57	45	0	1597
7330	1494	54	19	31	0	1598
7331	68	16	1487	17	0	1588
7332	27	13	63	1489	0	1592
7333	1475	16	20	72	0	1583
7334	67	1487	17	27	0	1598
7335	1488	55	18	24	0	1585
7336	70	19	16	1371	0	1476
7337	30	15	7	1496	0	1548
7338	24	11	5	1479	0	1519
7339	20	10	1	1494	0	1525
7340	1406	5	0	102	0	1513
7341	59	11	2	1439	0	1511
7342	26	1	9	1476	0	1512
7343	1338	10	12	88	0	1448
7344	67	10	1327	39	0	1443
7345	31	4	49	1350	0	1434
7346	1293	4	17	78	0	1392
7347	1325	3	9	42	0	1379
7348	77	5	11	1267	0	1360
7349	31	4	4	1294	0	1333
7350	22	1207	8	86	0	1323
7351	16	51	8	1246	0	1321
7352	10	19	3	1272	0	1304
7353	14	8	1179	92	0	1293
7354	5	12	1217	43	0	1277
7355	11	1175	61	41	0	1288
7356	14	53	28	1171	0	1266
7357	6	24	18	1232	0	1280
7358	1182	12	16	73	0	1283
7359	56	16	11	1189	0	1272
7360	25	15	1147	83	0	1270
7361	16	3	54	1193	0	1266
7362	13	4	1123	87	0	1227
7363	20	6	1166	41	0	1233
7364	2	5	71	1117	0	1195
7365	14	6	30	1173	0	1223
7366	1134	7	23	78	0	1242
7367	1183	4	21	39	0	1247
7368	75	3	13	1162	0	1253
7369	1168	6	10	75	0	1259
7370	1219	7	5	33	0	1264
7371	89	5	4	1171	0	1269
7372	36	7	1	1230	0	1274
7373	1179	9	4	84	0	1276
7374	1186	5	5	50	0	1246
7375	76	2	10	1154	0	1242
7376	33	1114	14	74	0	1235
7377	30	57	7	1153	0	1247
7378	22	19	3	1198	0	1242
7379	12	8	1124	97	0	1241
7380	11	14	53	1167	0	1245
7381	1093	6	17	92	0	1208
7382	52	1111	15	50	0	1228
7383	1136	49	14	31	0	1230
7384	1134	15	12	32	0	1193
7385	1187	13	12	23	0	1235
7386	86	15	7	1114	0	1222
7387	37	6	1026	69	0	1138
7388	34	9	1006	35	0	1084
7389	32	977	56	24	0	1089
7390	21	732	24	16	0	793
7391	1	402	2	2	0	407
7392	13	353	6	2	0	374
7393	11	12	312	4	0	339
7394	200	11	8	1	0	220
7395	3	2	0	200	0	205
7396	0	1	0	205	0	206
7397	1	1	0	203	0	205
7398	0	203	1	4	0	208
7399	201	6	0	2	0	209
7400	5	0	199	0	0	204
7401	0	196	4	1	0	201
7402	0	2	2	197	0	201
7403	192	0	3	4	0	199
7404	2	0	0	195	0	197
7405	0	0	192	3	0	195
7406	0	0	188	0	0	188
7407	0	0	3	191	0	194
7408	0	0	0	189	0	189
7409	189	0	0	3	0	192
7410	3	0	188	0	0	191
7411	183	0	3	0	0	186
7412	191	0	0	0	0	191
7413	3	0	0	192	0	195
7414	0	0	203	3	0	206
7415	1	0	3	200	0	204
7416	208	0	0	3	0	211
7417	2	205	0	0	0	207
7418	206	3	0	1	0	210
7419	3	0	0	214	0	217
7420	0	218	0	3	0	221
7421	0	3	0	220	0	223
7422	0	0	0	231	0	231
7423	0	228	0	3	0	231
7424	0	3	0	220	0	223
7425	0	1	0	242	0	243
7426	1	0	0	243	0	244
7427	0	0	250	4	0	254
7428	0	248	2	1	0	251
7429	245	2	1	1	0	249
7430	2	1	0	248	0	251
7431	1	281	0	4	0	286
7432	310	2	1	2	0	315
7433	3	2	1	307	0	313
7434	2	1	0	306	0	309
7435	1	0	0	307	0	308
7436	0	0	0	305	0	305
7437	318	2	0	4	0	324
7438	5	0	0	319	0	324
7439	1	0	0	323	0	324
7440	321	0	0	7	0	328
7441	3	0	0	324	0	327
7442	2	0	320	5	0	327
7443	1	2	3	317	0	323
7444	309	0	1	6	0	316
7445	6	0	0	317	0	323
7446	3	0	314	4	0	321
7447	0	1	309	2	0	312
7448	315	0	6	2	0	323
7449	327	1	1	4	0	333
7450	334	0	0	2	0	336
7451	332	0	1	4	0	337
7452	4	0	330	2	0	336
7453	3	0	6	325	0	334
7454	3	0	1	338	0	342
7455	337	0	0	6	0	343
7456	7	1	0	337	0	345
7457	4	0	335	5	0	344
7458	1	0	7	334	0	342
7459	0	0	336	10	0	346
7460	2	337	5	4	0	348
7461	337	4	4	4	0	349
7462	6	1	2	337	0	346
7463	1	0	332	6	0	339
7464	1	0	6	329	0	336
7465	2	3	3	332	0	340
7466	4	2	330	5	0	341
7467	4	0	5	329	0	338
7468	329	0	3	8	0	340
7469	6	0	309	4	0	319
7470	295	0	5	6	0	306
7471	6	293	3	3	0	305
7472	1	2	282	4	0	289
7473	3	1	278	3	0	285
7474	3	1	3	236	0	243
7475	2	0	5	260	0	267
7476	3	2	263	4	0	272
7477	1	1	5	265	0	272
7478	265	2	4	4	0	275
7479	269	0	3	4	0	276
7480	4	0	1	266	0	271
7481	1	0	4	265	0	270
7482	1	265	3	5	0	274
7483	265	2	0	8	0	275
7484	7	1	3	266	0	277
7485	4	264	0	6	0	274
7486	268	3	1	3	0	275
7487	264	2	2	3	0	271
7488	8	273	2	2	0	285
7489	3	5	1	268	0	277
7490	1	2	2	272	0	277
7491	1	2	269	6	0	278
7492	4	0	3	267	0	274
7493	268	1	2	7	0	278
7494	4	2	2	263	0	271
7495	4	0	260	9	0	273
7496	249	1	4	5	0	259
7497	7	0	5	250	0	262
7498	1	2	251	8	0	262
7499	3	0	3	256	0	262
7500	1	2	249	8	0	260
7501	4	1	4	241	0	250
7502	4	0	2	251	0	257
7503	245	2	3	4	0	254
7504	8	241	2	2	0	253
7505	240	4	1	4	0	249
7506	239	4	3	3	0	249
7507	247	0	2	4	0	253
7508	6	246	1	7	0	260
7509	3	4	243	2	0	252
7510	1	4	3	240	0	248
7511	253	0	1	6	0	260
7512	253	0	1	4	0	258
7513	5	2	3	241	0	251
7514	241	1	2	6	0	250
7515	3	0	234	7	0	244
7516	229	2	5	2	0	238
7517	8	0	231	4	0	243
7518	3	232	4	4	0	243
7519	234	4	3	6	0	247
7520	230	2	2	3	0	237
7521	10	233	2	1	0	246
7522	231	5	2	1	0	239
7523	225	0	2	4	0	231
7524	5	2	221	2	0	230
7525	210	0	7	0	0	217
7526	6	2	209	4	0	221
7527	2	3	5	198	0	208
7528	1	198	2	6	0	207
7529	4	4	200	2	0	210
7530	178	12	8	3	0	201
7531	152	1	0	4	0	157
7532	5	0	0	132	0	137
7533	1	0	135	3	0	139
7534	1	1	3	127	0	132
7535	131	0	1	3	0	135
7536	1	132	0	2	0	135
7537	115	2	2	0	0	119
7538	118	0	0	2	0	120
7539	2	115	1	0	0	118
7540	1	2	0	118	0	121
7541	117	0	1	3	0	121
7542	4	0	1	114	0	119
7543	1	1	0	123	0	125
7544	1	1	127	3	0	132
7545	2	0	1	120	0	123
7546	2	1	0	124	0	127
7547	123	2	0	3	0	128
7548	119	0	1	1	0	121
7549	4	0	0	120	0	124
7550	1	0	119	2	0	122
7551	1	0	115	1	0	117
7552	1	0	1	120	0	122
7553	2	0	121	2	0	125
7554	1	1	3	115	0	120
7555	3	0	0	119	0	122
7556	123	0	1	2	0	126
7557	3	1	117	0	0	121
7558	117	0	1	2	0	120
7559	119	0	1	0	0	120
7560	1	1	115	1	0	118
7561	1	0	126	1	0	128
7562	1	0	1	124	0	126
7563	0	118	1	1	0	120
7564	2	124	0	0	0	126
7565	1	1	1	117	0	120
7566	2	0	0	114	0	116
7567	0	1	0	123	0	124
7568	0	0	2	122	0	124
7569	121	0	0	2	0	123
7570	3	0	0	120	0	123
7571	1	0	121	2	0	124
7572	0	0	2	121	0	123
7573	1	120	0	2	0	123
7574	1	1	1	123	0	126
7575	122	1	0	1	0	124
7576	2	0	0	124	0	126
7577	1	1	126	1	0	129
7578	1	122	1	0	0	124
7579	1	1	0	122	0	124
7580	123	1	0	1	0	125
7581	125	0	0	1	0	126
7582	2	0	0	130	0	132
7583	0	0	127	1	0	128
7584	1	0	112	0	0	113
7585	115	0	0	0	0	115
7586	0	0	124	0	0	124
7587	1	0	120	0	0	121
7588	0	1	0	114	0	115
7589	119	0	0	0	0	119
7590	117	0	0	0	0	117
7591	119	0	0	0	0	119
7592	0	0	123	0	0	123
7593	0	0	118	0	0	118
7594	0	126	0	0	0	126
7595	0	0	0	123	0	123
7596	0	0	0	127	0	127
7597	0	0	0	121	0	121
7598	0	0	0	122	0	122
7599	0	0	125	0	0	125
7600	0	125	0	0	0	125
7601	145	0	0	0	0	145
7602	158	0	0	0	0	158
7603	165	0	0	1	0	166
7604	3	166	1	0	0	170
7605	1	3	1	171	0	176
7606	175	0	0	4	0	179
7607	2	179	1	0	0	182
7608	180	3	1	1	0	185
7609	3	180	0	1	0	184
7610	185	4	0	0	0	189
7611	180	1	1	1	0	183
7612	5	0	1	175	0	181
7613	2	0	0	191	0	193
7614	0	0	189	5	0	194
7615	0	0	183	1	0	184
7616	182	1	4	1	0	188
7617	185	1	1	0	0	187
7618	4	1	0	180	0	185
7619	2	0	0	179	0	181
7620	1	1	174	4	0	180
7621	1	0	2	164	0	167
7622	1	1	163	4	0	169
7623	1	1	2	164	0	168
7624	2	0	1	173	0	176
7625	169	2	1	4	0	176
7626	172	0	0	1	0	173
7627	4	2	0	168	0	174
7628	2	0	0	173	0	175
7629	2	0	167	5	0	174
7630	1	0	4	170	0	175
7631	0	0	167	4	0	171
7632	163	1	4	1	0	169
7633	4	0	2	174	0	180
7634	186	0	0	5	0	191
7635	5	182	0	1	0	188
7636	190	3	1	2	0	196
7637	3	1	1	191	0	196
7638	1	0	2	191	0	194
7639	1	191	0	5	0	197
7640	0	3	2	191	0	196
7641	1	1	192	4	0	198
7642	2	0	2	188	0	192
7643	2	0	182	4	0	188
7644	2	178	3	2	0	185
7645	1	3	2	178	0	184
7646	0	1	171	5	0	177
7647	0	0	165	1	0	166
7648	1	0	4	166	0	171
7649	170	0	1	3	0	174
7650	5	0	161	1	0	167
7651	1	1	3	158	0	163
7652	160	0	1	3	0	164
7653	3	159	0	2	0	164
7654	155	3	0	0	0	158
7655	3	1	0	152	0	156
7656	1	0	0	157	0	158
7657	0	1	1	161	0	163
7658	161	0	0	6	0	167
7659	3	0	2	167	0	172
7660	1	0	0	168	0	169
7661	151	0	1	5	0	157
7662	3	1	150	1	0	155
7663	1	0	4	150	0	155
7664	0	0	157	4	0	161
7665	150	0	4	1	0	155
7666	3	0	1	166	0	170
7667	2	0	167	9	0	178
7668	168	0	3	2	0	173
7669	174	1	1	1	0	177
7670	6	0	187	0	0	193
7671	1	1	2	183	0	187
7672	1	0	1	190	0	192
7673	1	0	199	5	0	205
7674	1	197	3	2	0	203
7675	0	3	202	2	0	207
7676	193	1	3	0	0	197
7677	4	0	196	1	0	201
7678	187	0	4	0	0	191
7679	4	0	200	1	0	205
7680	189	0	4	2	0	195
7681	4	211	1	2	0	218
7682	1	3	1	201	0	206
7683	1	1	1	207	0	210
7684	0	0	205	3	0	208
7685	1	0	4	189	0	194
7686	1	198	2	2	0	203
7687	200	3	0	2	0	205
7688	3	194	1	0	0	198
7689	1	3	0	205	0	209
7690	199	1	0	5	0	205
7691	4	199	1	2	0	206
7692	195	4	0	1	0	200
7693	3	1	199	2	0	205
7694	3	0	3	204	0	210
7695	1	0	3	201	0	205
7696	2	0	1	208	0	211
7697	205	0	2	5	0	212
7698	203	0	1	1	0	205
7699	210	1	0	1	0	212
7700	205	0	1	2	0	208
7701	5	0	184	1	0	190
7702	157	0	0	1	0	158
7703	1	167	2	0	0	170
7704	1	165	1	1	0	168
7705	170	1	0	2	0	173
7706	166	1	1	1	0	169
7707	1	1	1	162	0	165
7708	164	0	2	0	0	166
7709	157	0	1	1	0	159
7710	172	0	1	1	0	174
7711	1	0	0	173	0	174
7712	2	171	1	0	0	174
7713	2	158	0	0	0	160
7714	1	1	0	162	0	164
7715	160	0	0	0	0	160
7716	0	161	1	2	0	164
7717	1	0	1	162	0	164
7718	0	1	162	1	0	164
7719	143	2	0	2	0	147
7720	1	168	0	0	0	169
7721	2	168	0	1	0	171
7722	165	0	3	2	0	170
7723	2	0	166	0	0	168
7724	2	1	0	159	0	162
7725	2	164	0	0	0	166
7726	1	0	1	169	0	171
7727	0	1	1	170	0	172
7728	0	165	0	2	0	167
7729	0	0	0	190	0	190
7730	1	0	0	187	0	188
7731	186	1	0	0	0	187
7732	2	185	0	1	0	188
7733	182	0	1	0	0	183
7734	2	0	1	168	0	171
7735	0	176	1	0	0	177
7736	1	1	173	0	0	175
7737	1	5	1	172	0	179
7738	1	1	1	177	0	180
7739	1	0	185	1	0	187
7740	176	0	1	1	0	178
7741	2	0	0	227	0	229
7742	233	0	0	5	0	238
7743	6	1	232	1	0	240
7744	3	0	4	240	0	247
7745	0	1	254	6	0	261
7746	2	0	5	257	0	264
7747	0	2	2	265	0	269
7748	266	0	0	8	0	274
7749	5	263	1	2	0	271
7750	270	5	0	2	0	277
7751	5	1	274	2	0	282
7752	3	0	6	274	0	283
7753	1	2	275	6	0	284
7754	256	2	6	3	0	267
7755	276	1	3	0	0	280
7756	7	0	279	3	0	289
7757	272	0	6	0	0	278
7758	285	0	2	1	0	288
7759	6	0	0	286	0	292
7760	2	0	283	5	0	290
7761	1	1	282	2	0	286
7762	2	0	6	284	0	292
7763	1	0	2	285	0	288
7764	0	278	1	9	0	288
7765	1	289	2	1	0	293
7766	273	6	1	1	0	281
7767	6	1	0	261	0	268
7768	1	268	2	4	0	275
7769	2	277	0	2	0	281
7770	260	6	0	1	0	267
7771	6	1	2	263	0	272
7772	2	264	2	6	0	274
7773	1	6	2	255	0	264
7774	2	1	1	258	0	262
7775	0	0	0	262	0	262
7776	254	2	1	7	0	264
7777	5	254	1	3	0	263
7778	2	6	0	255	0	263
7779	1	2	1	253	0	257
7780	1	2	1	253	0	257
7781	1	2	239	7	0	249
7782	235	0	6	3	0	244
7783	7	2	1	240	0	250
7784	240	2	0	6	0	248
7785	241	0	3	2	0	246
7786	244	0	0	3	0	247
7787	6	1	237	2	0	246
7788	4	240	6	2	0	252
7789	1	6	3	236	0	246
7790	1	1	239	7	0	248
7791	2	0	239	3	0	244
7792	1	2	6	227	0	236
7793	0	227	4	5	0	236
7794	233	5	2	1	0	241
7795	232	1	2	1	0	236
7796	240	1	0	3	0	244
7797	236	3	0	3	0	242
7798	9	1	233	0	0	243
7799	231	2	5	1	0	239
7800	8	240	0	1	0	249
7801	2	6	1	244	0	253
7802	1	2	2	246	0	251
7803	243	1	1	8	0	253
7804	7	1	0	242	0	250
7805	3	1	237	7	0	248
7806	226	2	5	5	0	238
7807	238	1	1	4	0	244
7808	242	1	0	4	0	247
7809	7	0	240	3	0	250
7810	224	0	7	1	0	232
7811	8	231	2	1	0	242
7812	236	7	0	3	0	246
7813	8	1	1	238	0	248
7814	3	1	0	239	0	243
7815	2	234	3	5	0	244
7816	3	10	1	229	0	243
7817	0	235	1	10	0	246
7818	2	6	0	236	0	244
7819	3	234	2	4	0	243
7820	3	6	1	223	0	233
7821	0	234	2	8	0	244
7822	2	9	0	251	0	262
7823	2	253	0	5	0	260
7824	263	6	2	3	0	274
7825	10	2	0	260	0	272
7826	3	0	1	273	0	277
7827	2	4	1	282	0	289
7828	3	1	0	274	0	278
7829	1	1	264	14	0	280
7830	1	0	10	273	0	284
7831	2	2	2	278	0	284
7832	267	0	2	13	0	282
7833	268	1	4	4	0	277
7834	10	269	2	3	0	284
7835	5	9	0	265	0	279
7836	7	2	0	294	0	303
7837	288	1	1	9	0	299
7838	10	3	281	4	0	298
7839	275	1	9	4	0	289
7840	11	284	3	2	0	300
7841	238	5	1	0	0	244
7842	243	1	1	0	0	245
7843	7	232	1	0	0	240
7844	1	242	0	1	0	244
7845	2	10	0	214	0	226
7846	2	2	211	4	0	219
7847	215	2	4	2	0	223
7848	5	1	219	1	0	226
7849	213	0	5	1	0	219
7850	7	0	214	1	0	222
7851	3	209	6	3	0	221
7852	1	5	4	212	0	222
7853	208	1	1	6	0	216
7854	212	2	1	2	0	217
7855	8	1	0	213	0	222
7856	231	0	0	7	0	238
7857	233	1	0	2	0	236
7858	8	226	0	2	0	236
7859	212	5	0	3	0	220
7860	9	216	0	0	0	225
7861	2	7	1	218	0	228
7862	211	3	0	7	0	221
7863	222	2	0	1	0	225
7864	223	1	0	1	0	225
7865	10	0	210	1	0	221
7866	3	1	221	0	0	225
7867	2	1	8	215	0	226
7868	1	0	2	213	0	216
7869	0	233	3	6	0	242
7870	239	8	1	2	0	250
7871	8	1	1	242	0	252
7872	2	1	0	247	0	250
7873	1	3	244	9	0	257
7874	3	244	8	2	0	257
7875	1	257	1	5	0	264
7876	1	8	1	259	0	269
7877	251	2	3	9	0	265
7878	9	3	1	254	0	267
7879	3	5	0	268	0	276
7880	263	0	0	12	0	275
7881	268	2	0	3	0	273
7882	11	0	0	263	0	274
7883	3	1	258	12	0	274
7884	5	0	7	264	0	276
7885	6	1	1	268	0	276
7886	262	0	2	12	0	276
7887	8	0	4	264	0	276
7888	258	0	2	13	0	273
7889	9	0	265	6	0	280
7890	4	1	8	276	0	289
7891	3	0	0	284	0	287
7892	3	1	1	285	0	290
7893	2	0	3	291	0	296
7894	1	0	1	285	0	287
7895	1	0	270	15	0	286
7896	265	2	8	7	0	282
7897	8	1	1	279	0	289
7898	2	1	273	13	0	289
7899	2	0	276	5	0	283
7900	4	0	10	266	0	280
7901	266	0	2	13	0	281
7902	269	2	4	3	0	278
7903	273	1	4	3	0	281
7904	12	0	2	263	0	277
7905	5	258	1	13	0	277
7906	267	9	2	1	0	279
7907	271	2	1	3	0	277
7908	263	2	0	5	0	270
7909	267	4	0	2	0	273
7910	15	0	2	253	0	270
7911	9	0	251	11	0	271
7912	5	0	10	251	0	266
7913	5	2	248	10	0	265
7914	248	1	9	7	0	265
7915	255	1	4	6	0	266
7916	11	0	250	5	0	266
7917	246	0	11	5	0	262
7918	272	0	3	3	0	278
7919	16	0	3	258	0	277
7920	4	259	2	10	0	275
7921	261	6	5	3	0	275
7922	12	1	1	234	0	248
7923	4	229	2	12	0	247
7924	3	11	0	230	0	244
7925	6	2	219	9	0	236
7926	4	221	5	6	0	236
7927	208	6	7	3	0	224
7928	213	1	4	3	0	221
7929	211	0	3	2	0	216
7930	212	2	1	2	0	217
7931	8	1	1	207	0	217
7932	3	206	2	6	0	217
7933	201	4	1	3	0	209
7934	8	1	207	1	0	217
7935	4	205	5	4	0	218
7936	5	5	180	2	0	192
7937	2	2	5	172	0	181
7938	3	157	2	6	0	168
7939	2	5	3	172	0	182
7940	0	2	178	8	0	188
7941	2	1	6	171	0	180
7942	3	2	0	180	0	185
7943	2	1	0	182	0	185
7944	170	0	4	7	0	181
7945	4	175	3	3	0	185
7946	3	4	2	181	0	190
7947	174	1	0	8	0	183
7948	9	172	1	2	0	184
7949	175	4	3	0	0	182
7950	6	1	185	6	0	198
7951	6	1	4	181	0	192
7952	4	188	0	5	0	197
7953	185	6	1	1	0	193
7954	9	0	183	1	0	193
7955	2	177	6	1	0	186
7956	1	5	1	170	0	177
7957	4	0	1	177	0	182
7958	177	0	3	5	0	185
7959	4	2	2	175	0	183
7960	2	2	173	6	0	183
7961	2	0	3	167	0	172
7962	4	0	172	3	0	179
7963	3	0	2	165	0	170
7964	2	173	3	3	0	181
7965	175	1	2	2	0	180
7966	170	0	3	2	0	175
7967	4	175	1	0	0	180
7968	1	175	0	2	0	178
7969	0	4	7	155	0	166
7970	158	0	0	0	0	158
7971	0	0	1	152	0	153
7972	153	1	0	0	0	154
7973	1	146	0	0	0	147
7974	1	0	0	152	0	153
7975	1	0	139	0	0	140
7976	1	0	0	144	0	145
7977	0	0	0	149	0	149
7978	149	0	0	0	0	149
7979	0	153	0	0	0	153
7980	0	0	1	163	0	164
7981	159	1	0	0	0	160
7982	0	0	168	0	0	168
7983	160	0	0	1	0	161
7984	0	0	0	174	0	174
7985	1	166	0	1	0	168
7986	170	0	2	0	0	172
7987	1	0	170	0	0	171
7988	0	0	159	2	0	161
7989	0	161	0	1	0	162
7990	154	0	0	0	0	154
7991	0	0	1	159	0	160
7992	0	0	1	153	0	154
7993	158	1	0	1	0	160
7994	1	0	159	1	0	161
7995	3	0	0	160	0	163
7996	0	0	165	1	0	166
7997	1	0	0	170	0	171
7998	0	167	4	0	0	171
7999	0	0	0	172	0	172
8000	0	3	171	0	0	174
8001	160	0	0	4	0	164
8002	0	1	3	171	0	175
8003	4	0	171	1	0	176
8004	0	0	1	170	0	171
8005	4	0	2	176	0	182
8006	0	0	177	4	0	181
8007	0	0	181	3	0	184
8008	0	0	3	180	0	183
8009	0	0	190	1	0	191
8010	181	0	1	3	0	185
8011	0	0	4	182	0	186
8012	183	0	0	1	0	184
8013	0	0	184	2	0	186
8014	4	0	0	184	0	188
8015	0	0	202	1	0	203
8016	1	187	0	3	0	191
8017	0	0	186	4	0	190
8018	0	3	171	1	0	175
8019	182	0	4	0	0	186
8020	182	1	4	0	0	187
8021	3	0	188	0	0	191
8022	5	0	1	179	0	185
8023	1	0	3	184	0	188
8024	1	0	199	4	0	204
8025	1	188	1	4	0	194
8026	190	0	4	1	0	195
8027	1	5	206	0	0	212
8028	5	0	2	212	0	219
8029	0	0	10	213	0	223
8030	214	5	1	5	0	225
8031	213	2	6	6	0	227
8032	215	0	7	3	0	225
8033	222	0	2	2	0	226
8034	13	1	0	207	0	221
8035	8	0	229	2	0	239
8036	2	0	3	229	0	234
8037	2	0	5	226	0	233
8038	0	0	6	239	0	245
8039	0	6	226	5	0	237
8040	217	1	1	9	0	228
8041	1	0	10	222	0	233
8042	6	0	232	6	0	244
8043	2	239	2	12	0	255
8044	5	0	7	249	0	261
8045	7	5	2	248	0	262
8046	245	1	2	7	0	255
8047	6	238	1	8	0	253
8048	7	0	241	7	0	255
8049	2	5	6	238	0	251
8050	1	1	8	235	0	245
8051	226	1	3	11	0	241
8052	223	2	0	12	0	237
8053	7	0	6	231	0	244
8054	235	0	3	2	0	240
8055	5	218	0	12	0	235
8056	6	1	239	3	0	249
8057	1	11	4	228	0	244
8058	1	3	5	245	0	254
8059	1	1	2	251	0	255
8060	8	0	3	242	0	253
8061	3	245	0	8	0	256
8062	237	1	5	9	0	252
8063	2	5	2	245	0	254
8064	6	249	0	9	0	264
8065	252	1	2	7	0	262
8066	250	6	0	1	0	257
8067	8	252	0	9	0	269
8068	13	1	1	252	0	267
8069	3	10	0	243	0	256
8070	1	3	5	242	0	251
8071	3	1	2	255	0	261
8072	258	0	1	14	0	273
8073	265	1	0	14	0	280
8074	7	263	0	9	0	279
8075	4	7	264	3	0	278
8076	9	8	2	262	0	281
8077	268	1	3	10	0	282
8078	1	268	3	9	0	281
8079	11	262	4	3	0	280
8080	262	8	1	2	0	273
8081	264	10	1	1	0	276
8082	10	2	0	261	0	273
8083	6	2	263	10	0	281
8084	3	2	262	11	0	278
8085	280	0	7	11	0	298
8086	301	0	6	5	0	312
8087	315	1	1	1	0	318
8088	309	8	0	1	0	318
8089	306	1	7	1	0	315
8090	11	328	1	7	0	347
8091	11	3	0	330	0	344
8092	3	343	2	4	0	352
8093	341	12	0	6	0	359
8094	338	3	1	1	0	343
8095	341	1	0	3	0	345
8096	342	0	0	6	0	348
8097	7	333	5	2	0	347
8098	340	3	7	0	0	350
8099	10	342	1	0	0	353
8100	8	4	0	350	0	362
8101	353	3	1	3	0	360
8102	11	2	353	2	0	368
8103	10	0	3	345	0	358
8104	1	5	2	358	0	366
8105	2	1	354	6	0	363
8106	1	361	3	3	0	368
8107	361	4	3	1	0	369
8108	357	4	1	1	0	363
8109	9	365	1	2	0	377
8110	10	3	0	359	0	372
8111	3	10	392	3	0	408
8112	5	409	1	4	0	419
8113	422	3	2	3	0	430
8114	5	2	422	0	0	429
8115	398	2	4	1	0	405
8116	414	0	2	2	0	418
8117	6	0	460	1	0	467
8118	3	468	4	1	0	476
8119	3	3	1	450	0	457
8120	2	2	465	3	0	472
8121	447	2	3	1	0	453
8122	465	0	1	2	0	468
8123	3	472	2	0	0	477
8124	1	4	0	476	0	481
8125	3	2	0	480	0	485
8126	0	2	490	3	0	495
8127	0	487	3	1	0	491
8128	507	3	0	1	0	511
8129	502	0	1	0	0	503
8130	514	0	0	0	0	514
8131	4	1	502	0	0	507
8132	486	1	3	0	0	490
8133	509	0	0	1	0	510
8134	2	0	0	514	0	516
8135	1	0	497	3	0	501
8136	1	0	4	486	0	491
8137	0	0	494	4	0	498
8138	2	0	3	492	0	497
8139	1	495	1	3	0	500
8140	1	515	0	0	0	516
8141	2	3	1	524	0	530
8142	2	0	0	507	0	509
8143	499	1	1	3	0	504
8144	5	1	503	1	0	510
8145	484	1	3	0	0	488
8146	4	537	0	0	0	541
8147	537	3	0	2	0	542
8148	547	0	1	1	0	549
8149	4	0	1	543	0	548
8150	1	0	573	3	0	577
8151	1	0	3	570	0	574
8152	1	594	0	3	0	598
8153	2	3	0	599	0	604
8154	2	0	1	596	0	599
8155	603	0	0	3	0	606
8156	5	0	0	583	0	588
8157	0	582	0	4	0	586
8158	1	4	0	589	0	594
8159	594	0	0	4	0	598
8160	4	596	1	1	0	602
8161	2	3	0	612	0	617
8162	2	0	1	608	0	611
8163	2	1	0	625	0	628
8164	1	0	0	613	0	614
8165	637	1	2	6	0	646
8166	7	1	0	634	0	642
8167	2	0	0	650	0	652
8168	1	0	1	680	0	682
8169	1	693	1	8	0	703
8170	682	6	0	5	0	693
8171	12	0	702	2	0	716
8172	1	682	9	1	0	693
8173	665	10	0	3	0	678
8174	10	0	698	0	0	708
8175	1	714	9	0	0	724
8176	3	11	0	697	0	711
8177	1	708	3	8	0	720
8178	0	11	689	0	0	700
8179	1	1	695	3	0	700
8180	0	701	10	1	0	712
8181	706	10	1	0	0	717
8182	711	0	1	1	0	713
8183	8	1	692	0	0	701
8184	1	2	647	1	0	651
8185	2	0	671	1	0	674
8186	2	1	8	666	0	677
8187	2	0	2	660	0	664
8188	1	0	1	695	0	697
8189	0	0	692	12	0	704
8190	0	7	9	632	0	648
8191	1	1	1	664	0	667
8192	1	0	668	11	0	680
8193	660	2	9	4	0	675
8194	11	1	0	699	0	711
8195	2	0	4	694	0	700
8196	2	701	2	13	0	718
8197	698	10	0	4	0	712
8198	10	3	697	4	0	714
8199	686	3	12	1	0	702
8200	11	2	3	692	0	708
8201	4	5	705	8	0	722
8202	4	1	10	696	0	711
8203	720	0	0	13	0	733
8204	11	0	726	3	0	740
8205	695	1	12	3	0	711
8206	715	0	4	5	0	724
8207	722	0	4	4	0	730
8208	12	715	0	4	0	731
8209	8	8	0	716	0	732
8210	721	1	4	11	0	737
8211	702	4	2	2	0	710
8212	704	1	1	4	0	710
8213	15	0	679	1	0	695
8214	687	3	11	1	0	702
8215	18	0	0	737	0	755
8216	3	1	735	19	0	758
8217	3	3	19	741	0	766
8218	4	1	2	756	0	763
8219	1	2	759	23	0	785
8220	4	0	21	770	0	795
8221	4	0	3	797	0	804
8222	1	1	904	25	0	931
8223	953	1	28	9	0	991
8224	1096	1	9	6	0	1112
8225	36	1	13	1130	0	1180
8226	20	1	1125	29	0	1175
8227	17	2	28	1088	0	1135
8228	9	1093	10	38	0	1150
8229	13	28	13	1093	0	1147
8230	6	7	3	1132	0	1148
8231	1102	10	5	47	0	1164
8232	1105	3	9	23	0	1140
8233	1126	3	2	27	0	1158
8234	46	7	6	1098	0	1157
8235	23	3	5	1135	0	1166
8236	18	5	1108	50	0	1181
8237	13	0	31	1086	0	1130
8238	12	1092	11	47	0	1162
8239	1110	28	13	22	0	1173
8240	34	1088	9	18	0	1149
8241	1104	37	6	20	0	1167
8242	41	10	11	1059	0	1121
8243	14	1091	8	39	0	1152
8244	1092	38	6	12	0	1148
8245	1109	13	3	19	0	1144
8246	45	21	3	1046	0	1115
8247	33	1065	5	31	0	1134
8248	19	33	3	1067	0	1122
8249	13	16	1055	46	0	1130
8250	1005	14	31	22	0	1072
8251	42	1028	8	23	0	1101
8252	1013	34	12	17	0	1076
8253	48	13	7	1017	0	1085
8254	1016	14	7	47	0	1084
8255	49	9	1017	18	0	1093
8256	1048	6	32	17	0	1103
8257	1061	9	14	12	0	1096
8258	55	3	1040	18	0	1116
8259	27	12	34	1043	0	1116
8260	34	3	14	1058	0	1109
8261	1025	6	21	51	0	1103
8262	52	1016	8	29	0	1105
8263	26	38	12	1006	0	1082
8264	26	15	994	40	0	1075
8265	18	11	985	28	0	1042
8266	10	961	39	32	0	1042
8267	18	32	973	15	0	1038
8268	908	22	36	22	0	988
8269	40	13	16	898	0	967
8270	910	10	21	36	0	977
8271	34	11	896	22	0	963
8272	19	7	36	890	0	952
8273	24	5	22	897	0	948
8274	18	12	872	37	0	939
8275	16	9	31	881	0	937
8276	864	7	12	47	0	930
8277	883	5	22	24	0	934
8278	48	7	8	879	0	942
8279	863	10	8	40	0	921
8280	889	2	10	23	0	924
8281	46	855	8	28	0	937
8282	37	28	11	850	0	926
8283	868	14	9	40	0	931
8284	44	15	4	874	0	937
8285	869	7	6	43	0	925
8286	50	9	8	846	0	913
8287	29	12	837	44	0	922
8288	28	825	31	26	0	910
8289	24	30	17	749	0	820
8290	20	825	17	41	0	903
8291	822	33	14	28	0	897
8292	39	792	12	31	0	874
8293	26	783	11	23	0	843
8294	26	40	10	768	0	844
8295	769	26	10	39	0	844
8296	34	22	7	775	0	838
8297	774	10	9	45	0	838
8298	773	22	10	22	0	827
8299	43	769	7	22	0	841
8300	790	32	11	19	0	852
8301	797	18	8	18	0	841
8302	785	17	10	18	0	830
8303	66	7	738	13	0	824
8304	36	11	28	734	0	809
8305	28	12	14	752	0	806
8306	26	7	718	45	0	796
8307	754	9	30	24	0	817
8308	781	5	16	23	0	825
8309	766	7	16	17	0	806
8310	756	4	14	25	0	799
8311	55	717	13	21	0	806
8312	740	25	11	15	0	791
8313	57	16	5	711	0	789
8314	33	14	644	30	0	721
8315	674	4	16	16	0	710
8316	44	656	9	16	0	725
8317	607	24	10	12	0	653
8318	43	583	7	9	0	642
8319	18	555	7	15	0	595
8320	24	534	7	12	0	577
8321	23	543	5	16	0	587
8322	17	23	408	15	0	463
8323	13	38	13	293	0	357
8324	3	5	225	7	0	240
8325	160	2	6	1	0	169
8326	5	159	1	3	0	168
8327	1	156	3	1	0	161
8328	3	6	1	150	0	160
8329	1	4	0	154	0	159
8330	2	3	150	5	0	160
8331	1	2	146	3	0	152
8332	1	2	5	151	0	159
8333	2	1	147	4	0	154
8334	1	144	5	2	0	152
8335	1	3	3	138	0	145
8336	1	2	1	155	0	159
8337	1	2	152	4	0	159
8338	2	0	3	151	0	156
8339	156	0	1	4	0	161
8340	5	1	1	154	0	161
8341	1	0	1	153	0	155
8342	2	0	148	6	0	156
8343	144	0	4	3	0	151
8344	3	150	2	1	0	156
8345	2	3	1	147	0	153
8346	3	1	146	3	0	153
8347	1	2	3	146	0	152
8348	147	0	1	5	0	153
8349	3	1	154	3	0	161
8350	2	0	5	154	0	161
8351	1	1	174	5	0	181
8352	1	172	4	2	0	179
8353	1	4	171	3	0	179
8354	1	167	5	1	0	174
8355	0	2	145	1	0	148
8356	3	5	1	121	0	130
8357	0	132	0	1	0	133
8358	121	1	1	2	0	125
8359	1	0	2	125	0	128
8360	126	1	0	2	0	129
8361	4	1	1	130	0	136
8362	1	0	1	131	0	133
8363	136	0	1	2	0	139
8364	138	1	1	3	0	143
8365	2	1	0	143	0	146
8366	1	0	153	2	0	156
8367	2	144	1	1	0	148
8368	0	2	146	1	0	149
8369	0	148	2	2	0	152
8370	143	3	2	0	0	148
8371	2	2	148	1	0	153
8372	1	2	148	1	0	152
8373	2	0	2	145	0	149
8374	144	2	1	3	0	150
8375	2	0	151	1	0	154
8376	1	154	0	3	0	158
8377	156	0	2	0	0	158
8378	165	1	1	2	0	169
8379	165	2	2	1	0	170
8380	167	1	0	1	0	169
8381	168	1	1	1	0	171
8382	3	1	164	2	0	170
8383	3	0	3	161	0	167
8384	2	166	1	1	0	170
8385	168	1	3	2	0	174
8386	1	167	0	3	0	171
8387	168	2	0	0	0	170
8388	170	0	1	1	0	172
8389	1	167	1	2	0	171
8390	167	1	2	1	0	171
8391	3	1	0	167	0	171
8392	2	0	2	173	0	177
8393	1	2	164	2	0	169
8394	3	179	1	1	0	184
8395	1	1	3	177	0	182
8396	2	0	1	181	0	184
8397	1	2	0	185	0	188
8398	3	0	183	2	0	188
8399	162	1	4	0	0	167
8400	2	1	0	176	0	179
8401	179	1	0	1	0	181
8402	3	1	1	177	0	182
8403	3	1	180	2	0	186
8404	2	0	181	2	0	185
8405	175	1	2	2	0	180
8406	183	1	4	0	0	188
8407	2	180	0	1	0	183
8408	2	2	178	1	0	183
8409	1	2	1	182	0	186
8410	0	2	2	137	0	141
8411	190	1	1	1	0	193
8412	183	0	0	1	0	184
8413	182	2	0	1	0	185
8414	2	0	183	1	0	186
8415	183	0	1	1	0	185
8416	1	0	1	185	0	187
8417	2	0	1	185	0	188
8418	1	1	1	184	0	187
8419	0	181	0	4	0	185
8420	181	0	2	3	0	186
8421	0	2	1	178	0	181
8422	3	0	174	0	0	177
8423	3	1	0	172	0	176
8424	1	185	2	1	0	189
8425	184	0	1	2	0	187
8426	1	2	0	182	0	185
8427	2	0	5	181	0	188
8428	0	0	194	3	0	197
8429	3	0	0	192	0	195
8430	2	192	1	1	0	196
8431	1	1	0	199	0	201
8432	0	1	193	2	0	196
8433	174	0	1	3	0	178
8434	184	0	2	3	0	189
8435	2	193	1	1	0	197
8436	187	0	0	1	0	188
8437	194	1	0	1	0	196
8438	1	195	0	2	0	198
8439	3	0	2	188	0	193
8440	196	1	1	1	0	199
8441	1	198	0	1	0	200
8442	2	0	192	2	0	196
8443	204	1	1	0	0	206
8444	204	0	1	0	0	205
8445	207	0	1	2	0	210
8446	201	1	0	1	0	203
8447	5	212	0	0	0	217
8448	219	0	0	0	0	219
8449	208	2	0	1	0	211
8450	201	1	1	1	0	204
8451	4	0	0	185	0	189
8452	188	1	0	0	0	189
8453	1	197	1	2	0	201
8454	2	0	214	2	0	218
8455	2	1	0	220	0	223
8456	228	2	1	0	0	231
8457	1	0	229	2	0	232
8458	1	0	1	232	0	234
8459	3	0	231	0	0	234
8460	2	230	1	1	0	234
8461	3	0	1	220	0	224
8462	0	1	237	2	0	240
8463	2	231	0	2	0	235
8464	0	1	2	219	0	222
8465	222	1	5	1	0	229
8466	234	2	0	3	0	239
8467	240	1	0	2	0	243
8468	243	0	2	1	0	246
8469	243	0	0	2	0	245
8470	1	0	242	0	0	243
8471	241	1	0	1	0	243
8472	248	1	1	1	0	251
8473	3	0	2	243	0	248
8474	248	2	0	1	0	251
8475	246	0	0	3	0	249
8476	3	256	1	1	0	261
8477	3	1	0	258	0	262
8478	2	2	1	249	0	254
8479	248	1	0	2	0	251
8480	3	245	1	2	0	251
8481	3	251	1	1	0	256
8482	4	2	0	257	0	263
8483	1	3	0	253	0	257
8484	2	0	0	263	0	265
8485	2	0	0	267	0	269
8486	260	1	0	5	0	266
8487	254	1	0	5	0	260
8488	6	0	267	2	0	275
8489	2	2	2	260	0	266
8490	2	0	3	269	0	274
8491	1	1	266	5	0	273
8492	248	0	2	3	0	253
8493	3	253	3	2	0	261
8494	253	2	1	1	0	257
8495	3	3	0	255	0	261
8496	3	0	258	3	0	264
8497	4	0	2	260	0	266
8498	2	1	263	4	0	270
8499	0	272	4	4	0	280
8500	273	2	2	2	0	279
8501	268	2	1	1	0	272
8502	3	268	3	0	0	274
8503	2	2	0	266	0	270
8504	258	3	0	3	0	264
8505	2	258	3	1	0	264
8506	3	2	0	254	0	259
8507	268	2	0	3	0	273
8508	4	2	261	2	0	269
8509	253	0	2	3	0	258
8510	4	259	4	0	0	267
8511	258	2	1	1	0	262
8512	257	1	1	0	0	259
8513	5	3	254	0	0	262
8514	4	0	2	246	0	252
8515	3	1	1	256	0	261
8516	2	1	253	3	0	259
8517	1	1	2	244	0	248
8518	3	1	3	238	0	245
8519	260	1	1	5	0	267
8520	257	0	1	4	0	262
8521	4	1	0	260	0	265
8522	2	0	264	3	0	269
8523	5	1	2	258	0	266
8524	2	1	1	255	0	259
8525	1	0	266	3	0	270
8526	1	0	2	262	0	265
8527	255	0	3	5	0	263
8528	249	1	5	2	0	257
8529	5	252	0	3	0	260
8530	259	3	2	1	0	265
8531	265	2	0	0	0	267
8532	4	272	0	3	0	279
8533	283	2	2	0	0	287
8534	284	1	0	1	0	286
8535	293	0	1	1	0	295
8536	6	1	284	1	0	292
8537	280	0	3	1	0	284
8538	5	0	1	292	0	298
8539	289	2	1	3	0	295
8540	4	0	294	3	0	301
8541	2	296	3	1	0	302
8542	296	5	1	6	0	308
8543	4	307	0	1	0	312
8544	4	5	0	305	0	314
8545	1	1	0	311	0	313
8546	314	1	0	6	0	321
8547	312	2	0	1	0	315
8548	8	0	307	1	0	316
8549	3	0	291	1	0	295
8550	1	0	311	0	0	312
8551	3	0	5	306	0	314
8552	0	0	306	7	0	313
8553	1	0	309	1	0	311
8554	0	5	8	292	0	305
8555	328	1	1	9	0	339
8556	337	0	1	1	0	339
8557	333	1	1	0	0	335
8558	324	0	0	4	0	328
8559	7	0	1	323	0	331
8560	3	0	0	327	0	330
8561	2	0	338	7	0	347
8562	2	0	6	323	0	331
8563	0	0	2	308	0	310
8564	334	0	1	8	0	343
8565	335	0	1	4	0	340
8566	8	1	1	321	0	331
8567	317	0	1	8	0	326
8568	332	0	0	2	0	334
8569	10	1	0	334	0	345
8570	3	0	0	335	0	338
8571	4	0	330	9	0	343
8572	4	0	321	2	0	327
8573	2	0	8	324	0	334
8574	2	0	2	338	0	342
8575	0	0	327	9	0	336
8576	300	0	6	3	0	309
8577	311	0	1	4	0	316
8578	9	0	316	0	0	325
8579	4	308	7	0	0	319
8580	314	7	1	1	0	323
8581	9	1	329	0	0	339
8582	3	2	7	326	0	338
8583	3	0	6	333	0	342
8584	338	0	2	8	0	348
8585	355	1	1	2	0	359
8586	9	0	0	351	0	360
8587	4	0	2	373	0	379
8588	376	0	1	8	0	385
8589	385	0	1	3	0	389
8590	382	0	0	3	0	385
8591	10	0	401	1	0	412
8592	6	0	7	400	0	413
8593	3	0	2	415	0	420
8594	409	0	1	7	0	417
8595	8	401	1	3	0	413
8596	432	6	0	2	0	440
8597	7	434	1	1	0	443
8598	1	8	0	464	0	473
8599	1	4	0	471	0	476
8600	2	1	469	10	0	482
8601	0	3	7	463	0	473
8602	1	0	469	10	0	480
8603	2	0	8	462	0	472
8604	2	0	2	465	0	469
8605	0	447	1	13	0	461
8606	1	480	1	4	0	486
8607	1	8	0	448	0	457
8608	1	4	1	468	0	474
8609	0	2	0	486	0	488
8610	0	1	1	486	0	488
8611	0	1	1	496	0	498
8612	0	7	474	13	0	494
8613	0	0	7	484	0	491
8614	0	0	4	491	0	495
8615	1	0	471	13	0	485
8616	1	480	8	6	0	495
8617	0	7	4	482	0	493
8618	0	4	477	7	0	488
8619	0	472	7	6	0	485
8620	0	7	4	483	0	494
8621	494	4	2	10	0	510
8622	8	2	1	493	0	504
8623	6	1	0	502	0	509
8624	3	1	1	511	0	516
8625	2	1	0	498	0	501
8626	0	497	1	16	0	514
8627	2	7	2	512	0	523
8628	521	5	1	12	0	539
8629	9	1	3	526	0	539
8630	3	1	2	519	0	525
8631	2	0	0	530	0	532
8632	498	1	1	14	0	514
8633	505	1	1	7	0	514
8634	15	1	0	507	0	523
8635	475	1	2	8	0	486
8636	493	1	1	9	0	504
8637	12	493	0	6	0	511
8638	490	6	2	5	0	503
8639	12	488	1	3	0	504
8640	8	484	3	3	0	498
8641	4	7	1	479	0	491
8642	2	5	499	10	0	516
8643	2	2	4	481	0	489
8644	3	1	4	482	0	490
8645	4	481	3	10	0	498
8646	476	9	1	7	0	493
8647	6	4	0	481	0	491
8648	5	1	520	10	0	536
8649	2	2	5	511	0	520
8650	1	519	5	10	0	535
8651	522	5	4	9	0	540
8652	5	8	3	524	0	540
8653	5	1	520	12	0	538
8654	5	3	4	524	0	536
8655	1	502	8	9	0	520
8656	0	8	2	506	0	516
8657	504	7	3	8	0	522
8658	504	1	1	17	0	523
8659	514	2	2	10	0	528
8660	13	523	0	15	0	551
8661	539	8	2	5	0	554
8662	8	5	1	561	0	575
8663	562	0	2	13	0	577
8664	8	563	1	13	0	585
8665	10	8	1	562	0	581
8666	2	8	568	10	0	588
8667	545	3	8	10	0	566
8668	8	565	7	6	0	586
8669	7	18	2	565	0	592
8670	2	6	0	580	0	588
8671	2	1	0	572	0	575
8672	2	3	1	558	0	564
8673	6	566	1	15	0	588
8674	564	9	0	11	0	584
8675	573	7	2	5	0	587
8676	14	0	576	6	0	596
8677	7	4	6	580	0	597
8678	4	2	586	10	0	602
8679	573	1	7	11	0	592
8680	575	2	6	8	0	591
8681	576	1	1	5	0	583
8682	16	2	1	559	0	578
8683	7	559	0	10	0	576
8684	565	6	1	10	0	582
8685	9	8	0	556	0	573
8686	563	2	3	11	0	579
8687	8	3	527	9	0	547
8688	7	3	507	2	0	519
8689	516	1	8	7	0	532
8690	10	4	5	522	0	541
8691	507	2	0	8	0	517
8692	8	519	1	6	0	534
8693	527	6	1	4	0	538
8694	528	4	1	4	0	537
8695	10	3	524	1	0	538
8696	6	1	492	2	0	501
8697	2	486	7	0	0	495
8698	3	4	6	460	0	473
8699	456	3	3	8	0	470
8700	6	0	0	452	0	458
8701	6	1	1	459	0	467
8702	1	2	450	8	0	461
8703	449	0	4	5	0	458
8704	7	0	4	466	0	477
8705	6	0	452	4	0	462
8706	0	4	464	4	0	472
8707	3	2	7	456	0	468
8708	2	1	461	6	0	470
8709	2	1	451	4	0	458
8710	0	2	7	415	0	424
8711	1	2	454	8	0	465
8712	2	1	6	450	0	459
8713	5	433	3	5	0	446
8714	458	6	1	6	0	471
8715	5	462	1	5	0	473
8716	1	3	3	460	0	467
8717	2	464	1	4	0	471
8718	1	4	477	5	0	487
8719	3	3	5	550	0	561
8720	2	1	700	10	0	713
8721	689	2	15	7	0	713
8722	17	741	8	1	0	767
8723	745	17	2	2	0	766
8724	21	8	2	725	0	756
8725	733	2	5	16	0	756
8726	20	2	715	10	0	747
8727	10	720	18	2	0	750
8728	720	17	8	3	0	748
8729	20	10	1	697	0	728
8730	10	712	0	16	0	738
8731	4	18	2	728	0	752
8732	745	10	1	19	0	775
8733	19	775	2	10	0	806
8734	790	22	4	4	0	820
8735	26	10	786	1	0	823
8736	781	3	22	6	0	812
8737	27	0	11	779	0	817
8738	784	2	4	21	0	811
8739	23	770	1	14	0	808
8740	10	21	4	783	0	818
8741	4	11	2	807	0	824
8742	3	4	766	32	0	805
8743	3	1	21	753	0	778
8744	2	3	10	782	0	797
8745	0	1	5	790	0	796
8746	2	1	0	798	0	801
8747	3	1	766	34	0	804
8748	4	716	20	16	0	756
8749	2	22	12	721	0	757
8750	717	9	3	28	0	757
8751	732	5	4	9	0	750
8752	34	717	3	4	0	758
8753	712	25	1	4	0	742
8754	722	8	4	5	0	739
8755	727	5	3	3	0	738
8756	31	698	3	7	0	739
8757	696	22	4	6	0	728
8758	33	9	2	664	0	708
8759	11	6	670	23	0	710
8760	7	657	20	12	0	696
8761	2	24	13	646	0	685
8762	8	7	626	21	0	662
8763	613	4	20	13	0	650
8764	21	6	9	609	0	645
8765	12	3	4	634	0	653
8766	7	2	2	630	0	641
8767	6	4	1	627	0	638
8768	4	2	595	33	0	634
8769	560	3	18	11	0	592
8770	22	585	8	8	0	623
8771	594	18	1	7	0	620
8772	19	594	2	4	0	619
8773	599	21	3	3	0	626
8774	23	8	3	594	0	628
8775	14	5	580	22	0	621
8776	6	3	587	14	0	610
8777	4	2	26	578	0	610
8778	1	4	12	577	0	594
8779	4	2	5	585	0	596
8780	557	0	3	38	0	598
8781	22	2	564	16	0	604
8782	12	6	19	546	0	583
8783	6	565	8	22	0	601
8784	560	22	4	10	0	596
8785	23	11	557	6	0	597
8786	13	552	19	5	0	589
8787	8	22	561	3	0	594
8788	9	9	21	555	0	594
8789	4	7	557	20	0	588
8790	9	3	566	10	0	588
8791	6	4	28	554	0	592
8792	7	0	548	21	0	576
8793	3	5	550	15	0	573
8794	5	1	25	535	0	566
8795	526	3	13	27	0	569
8796	21	2	530	15	0	568
8797	11	1	20	528	0	560
8798	3	1	13	544	0	561
8799	523	2	10	30	0	565
8800	24	3	1	548	0	576
8801	530	1	7	26	0	564
8802	24	528	4	11	0	567
8803	8	21	1	532	0	562
8804	536	11	4	23	0	574
8805	553	5	4	15	0	577
8806	31	2	6	524	0	563
8807	14	3	521	23	0	561
8808	512	1	21	14	0	548
8809	18	523	10	4	0	555
8810	515	20	2	7	0	544
8811	533	8	4	5	0	550
8812	542	6	6	4	0	558
8813	30	2	525	6	0	563
8814	14	520	20	6	0	560
8815	9	19	14	514	0	556
8816	1	13	6	533	0	553
8817	6	4	506	28	0	544
8818	3	493	23	15	0	534
8819	2	413	10	4	0	429
8820	2	286	1	2	0	291
8821	232	7	18	2	0	259
8822	6	2	1	235	0	244
8823	2	0	2	245	0	249
8824	1	0	243	7	0	251
8825	229	1	5	4	0	239
8826	6	1	3	240	0	250
8827	6	0	0	249	0	255
8828	2	0	239	8	0	249
8829	1	239	6	4	0	250
8830	2	8	3	241	0	254
8831	1	3	249	6	0	259
8832	0	218	5	2	0	225
8833	175	1	1	1	0	178
8834	1	1	186	0	0	188
8835	2	0	1	176	0	179
8836	0	184	1	1	0	186
8837	182	1	0	0	0	183
8838	1	1	0	180	0	182
8839	190	0	0	1	0	191
8840	183	0	0	1	0	184
8841	2	183	0	0	0	185
8842	187	1	0	0	0	188
8843	195	1	0	0	0	196
8844	3	0	209	0	0	212
8845	204	0	1	3	0	208
8846	1	0	212	0	0	213
8847	210	0	1	0	0	211
8848	211	0	0	0	0	211
8849	2	0	236	0	0	238
8850	2	5	1	224	0	232
8851	0	0	236	1	0	237
8852	1	0	224	1	0	226
8853	1	0	251	0	0	252
8854	0	0	2	239	0	241
8855	1	0	1	246	0	248
8856	0	0	0	247	0	247
8857	0	0	0	249	0	249
8858	0	0	270	2	0	272
8859	0	0	1	263	0	264
8860	0	260	1	2	0	263
8861	0	1	278	2	0	281
8862	0	0	2	273	0	275
8863	0	1	284	3	0	288
8864	0	280	3	1	0	284
8865	0	277	0	0	0	277
8866	0	2	0	277	0	279
8867	0	2	272	1	0	275
8868	0	1	274	0	0	275
8869	1	0	1	273	0	275
8870	0	0	0	271	0	271
8871	0	0	0	287	0	287
8872	0	0	283	3	0	286
8873	0	282	3	1	0	286
8874	0	298	0	0	0	298
8875	0	3	1	297	0	301
8876	0	0	290	4	0	294
8877	0	0	282	0	0	282
8878	0	287	3	3	0	293
8879	288	4	0	2	0	294
8880	3	296	0	1	0	300
8881	0	3	303	0	0	306
8882	299	0	6	0	0	305
8883	6	0	1	307	0	314
8884	319	0	0	8	0	327
8885	6	0	0	320	0	326
8886	1	0	1	326	0	328
8887	320	1	0	7	0	328
8888	5	330	0	2	0	337
8889	1	6	325	1	0	333
8890	0	325	7	2	0	334
8891	325	6	2	0	0	333
8892	5	330	0	0	0	335
8893	331	6	0	2	0	339
8894	335	2	1	0	0	338
8895	7	334	1	0	0	342
8896	2	8	0	337	0	347
8897	339	1	1	7	0	348
8898	342	1	0	1	0	344
8899	7	0	0	334	0	341
8900	1	0	335	7	0	343
8901	1	0	338	1	0	340
8902	0	2	7	334	0	343
8903	1	0	346	6	0	353
8904	319	1	5	2	0	327
8905	7	329	1	2	0	339
8906	2	7	1	338	0	348
8907	1	2	0	343	0	346
8908	2	0	1	350	0	353
8909	1	3	0	342	0	346
8910	0	1	1	348	0	350
8911	2	0	343	8	0	353
8912	1	329	9	1	0	340
8913	342	6	2	1	0	351
8914	7	0	1	342	0	350
8915	0	0	1	355	0	356
8916	0	0	0	353	0	353
8917	0	350	3	7	0	360
8918	2	7	1	346	0	356
8919	0	3	1	349	0	353
8920	341	0	0	10	0	351
8921	6	332	2	4	0	344
8922	1	333	2	3	0	339
8923	1	6	0	335	0	342
8924	327	2	1	7	0	337
8925	7	1	329	0	0	337
8926	314	2	9	1	0	326
8927	9	0	334	1	0	344
8928	1	2	7	343	0	353
8929	2	1	2	338	0	343
8930	2	1	0	340	0	343
8931	0	2	2	330	0	334
8932	1	1	2	330	0	334
8933	327	2	2	9	0	340
8934	8	3	320	2	0	333
8935	1	3	7	319	0	330
8936	1	2	328	7	0	338
8937	0	328	9	2	0	339
8938	323	6	2	2	0	333
8939	6	1	334	3	0	344
8940	4	1	7	341	0	353
8941	1	2	2	354	0	359
8942	1	1	357	11	0	370
8943	2	1	358	4	0	365
8944	0	2	11	324	0	337
8945	344	0	4	12	0	360
8946	350	2	2	3	0	357
8947	11	337	4	1	0	353
8948	348	14	3	3	0	368
8949	14	1	1	330	0	346
8950	3	349	1	11	0	364
8951	1	13	1	355	0	370
8952	3	2	356	12	0	373
8953	1	1	11	339	0	352
8954	3	1	1	356	0	361
8955	345	1	0	17	0	363
8956	10	345	4	3	0	362
8957	347	10	4	1	0	362
8958	10	333	0	4	0	347
8959	323	10	2	3	0	338
8960	13	323	0	1	0	337
8961	2	322	1	0	0	325
8962	311	10	0	1	0	322
8963	8	2	1	300	0	311
8964	1	310	0	11	0	322
8965	314	10	3	3	0	330
8966	319	2	0	2	0	323
8967	340	0	2	4	0	346
8968	329	2	0	2	0	333
8969	12	334	0	2	0	348
8970	4	9	1	339	0	353
8971	2	1	1	349	0	353
8972	351	0	2	10	0	363
8973	10	2	2	347	0	361
8974	344	2	0	8	0	354
8975	8	2	334	3	0	347
8976	323	0	6	4	0	333
8977	9	1	343	5	0	358
8978	3	0	9	345	0	357
8979	349	0	1	11	0	361
8980	8	346	3	3	0	360
8981	332	4	1	2	0	339
8982	5	327	4	3	0	339
8983	2	5	0	361	0	368
8984	2	2	353	6	0	363
8985	335	2	7	1	0	345
8986	7	355	0	1	0	363
8987	2	4	2	349	0	357
8988	0	2	1	348	0	351
8989	2	1	2	345	0	350
8990	2	3	353	4	0	362
8991	1	348	4	2	0	355
8992	339	5	1	3	0	348
8993	348	0	0	3	0	351
8994	6	337	1	3	0	347
8995	360	6	2	1	0	369
8996	8	1	1	356	0	366
8997	1	353	1	4	0	359
8998	354	6	0	1	0	361
8999	6	2	349	3	0	360
9000	2	353	5	2	0	362
9001	1	4	1	358	0	364
9002	3	1	0	363	0	367
9003	2	1	355	5	0	363
9004	2	2	5	349	0	358
9005	1	1	356	5	0	363
9006	1	1	5	351	0	358
9007	1	0	3	358	0	362
9008	1	2	1	348	0	352
9009	2	2	2	353	0	359
9010	2	2	349	6	0	359
9011	1	1	347	4	0	353
9012	1	383	7	2	0	393
9013	2	8	0	418	0	428
9014	1	3	454	10	0	468
9015	1	444	11	3	0	459
9016	1	11	3	469	0	484
9017	0	4	509	12	0	525
9018	480	2	11	5	0	498
9019	545	3	3	3	0	554
9020	13	0	3	534	0	550
9021	5	1	536	12	0	554
9022	5	1	11	531	0	548
9023	542	1	2	14	0	559
9024	12	554	2	5	0	573
9025	580	10	0	5	0	595
9026	585	2	1	4	0	592
9027	13	3	3	558	0	577
9028	6	3	0	565	0	574
9029	4	2	1	578	0	585
9030	3	1	0	575	0	579
9031	2	1	2	567	0	572
9032	565	0	0	19	0	584
9033	568	0	2	7	0	577
9034	570	2	1	7	0	580
9035	16	1	544	4	0	565
9036	547	0	13	5	0	565
9037	15	2	3	547	0	567
9038	4	1	545	14	0	564
9039	4	532	12	4	0	552
9040	3	12	4	522	0	541
9041	4	3	4	518	0	529
9042	2	518	1	11	0	532
9043	0	6	3	536	0	545
9044	1	2	527	11	0	541
9045	4	3	547	5	0	559
9046	1	1	9	560	0	571
9047	557	1	8	8	0	574
9048	553	1	3	4	0	561
9049	13	1	542	4	0	560
9050	5	518	6	2	0	531
9051	3	536	5	2	0	546
9052	521	9	2	3	0	535
9053	9	4	532	4	0	549
9054	5	2	8	532	0	547
9055	532	0	4	9	0	545
9056	10	514	2	6	0	532
9057	5	527	2	5	0	539
9058	533	10	1	1	0	545
9059	9	7	1	529	0	546
9060	566	2	1	10	0	579
9061	10	2	2	630	0	644
9062	9	1	0	652	0	662
9063	3	1	657	14	0	675
9064	0	1	8	686	0	695
9065	0	3	5	696	0	704
9066	692	0	4	20	0	716
9067	11	0	3	706	0	720
9068	9	3	695	15	0	722
9069	686	0	10	14	0	710
9070	16	0	11	702	0	729
9071	701	1	8	13	0	723
9072	18	668	2	17	0	705
9073	10	704	1	7	0	722
9074	695	21	2	1	0	719
9075	703	12	4	1	0	720
9076	23	5	2	690	0	720
9077	16	2	685	16	0	719
9078	9	0	14	703	0	726
9079	684	3	10	20	0	717
9080	15	686	8	10	0	719
9081	12	16	1	687	0	716
9082	682	11	0	17	0	710
9083	17	9	658	11	0	695
9084	676	0	12	10	0	698
9085	639	0	12	7	0	658
9086	24	2	661	7	0	694
9087	16	1	661	10	0	688
9088	10	1	22	660	0	693
9089	6	1	17	652	0	676
9090	4	671	5	26	0	706
9091	8	16	4	674	0	702
9092	10	11	672	19	0	712
9093	6	8	17	690	0	721
9094	6	2	13	704	0	725
9095	5	6	671	26	0	708
9096	4	663	17	25	0	709
9097	7	15	11	660	0	693
9098	3	15	6	684	0	708
9099	664	6	4	32	0	706
9100	22	1	4	665	0	692
9101	13	2	649	26	0	690
9102	651	2	14	17	0	684
9103	665	4	17	11	0	697
9104	678	3	8	7	0	696
9105	39	1	647	4	0	691
9106	18	4	19	643	0	684
9107	10	2	12	662	0	686
9108	9	2	9	667	0	687
9109	631	1	7	34	0	673
9110	20	628	4	25	0	677
9111	19	17	622	8	0	666
9112	8	598	19	10	0	635
9113	7	572	14	4	0	597
9114	2	552	8	9	0	571
9115	15	20	3	540	0	578
9116	6	14	525	17	0	562
9117	449	10	14	13	0	486
9118	12	484	11	11	0	518
9119	454	10	7	6	0	477
9120	16	474	0	5	0	495
9121	474	16	1	5	0	496
9122	15	483	2	2	0	502
9123	11	15	470	4	0	500
9124	10	12	11	466	0	499
9125	7	4	11	472	0	494
9126	460	1	9	21	0	491
9127	12	3	3	492	0	510
9128	12	2	482	18	0	514
9129	6	4	10	496	0	516
9130	10	5	484	15	0	514
9131	3	482	14	14	0	513
9132	5	12	13	463	0	493
9133	7	493	5	12	0	517
9134	490	15	5	8	0	518
9135	18	11	1	485	0	515
9136	12	5	480	15	0	512
9137	5	3	484	12	0	504
9138	475	2	21	11	0	509
9139	13	7	14	480	0	514
9140	14	3	481	15	0	513
9141	6	9	475	8	0	498
9142	5	473	20	8	0	506
9143	6	27	15	410	0	458
9144	3	463	7	12	0	485
9145	5	22	2	432	0	461
9146	435	8	4	20	0	467
9147	12	5	5	441	0	463
9148	12	0	3	455	0	470
9149	439	3	5	22	0	469
9150	14	1	5	473	0	493
9151	9	5	7	448	0	469
9152	8	454	5	20	0	487
9153	453	18	2	10	0	483
9154	464	10	4	6	0	484
9155	20	4	0	456	0	480
9156	11	2	4	465	0	482
9157	12	0	3	465	0	480
9158	2	427	5	26	0	460
9159	6	444	5	12	0	467
9160	10	16	3	411	0	440
9161	333	10	3	13	0	359
9162	330	6	3	7	0	346
9163	16	312	2	5	0	335
9164	287	11	1	4	0	303
9165	12	282	2	6	0	302
9166	4	282	0	3	0	289
9167	11	14	3	254	0	282
9168	252	4	2	8	0	266
9169	6	241	1	3	0	251
9170	3	246	0	2	0	251
9171	1	6	1	245	0	253
9172	1	2	0	255	0	258
9173	0	2	248	7	0	257
9174	244	1	4	3	0	252
9175	241	0	2	3	0	246
9176	7	0	252	3	0	262
9177	4	1	246	2	0	253
9178	1	0	6	248	0	255
9179	1	2	2	252	0	257
9180	1	252	1	6	0	260
9181	1	5	0	255	0	261
9182	2	2	250	6	0	260
9183	3	1	4	255	0	263
9184	2	1	2	258	0	263
9185	251	1	1	7	0	260
9186	5	1	247	3	0	256
9187	242	3	4	1	0	250
9188	4	2	245	4	0	255
9189	4	1	3	229	0	237
9190	3	3	227	3	0	236
9191	1	3	227	2	0	233
9192	2	1	3	224	0	230
9193	214	3	3	5	0	225
9194	213	2	1	2	0	218
9195	6	202	1	1	0	210
9196	206	1	1	2	0	210
9197	203	1	2	2	0	208
9198	2	202	4	0	0	208
9199	1	4	1	205	0	211
9200	1	0	0	211	0	212
9201	0	2	1	207	0	210
9202	3	1	1	206	0	211
9203	2	1	202	5	0	210
9204	201	0	6	3	0	210
9205	3	1	1	206	0	211
9206	2	0	0	207	0	209
9207	1	208	0	5	0	214
9208	0	4	2	213	0	219
9209	1	2	221	5	0	229
9210	219	1	5	1	0	226
9211	4	0	227	3	0	234
9212	1	4	3	222	0	230
9213	212	1	2	5	0	220
9214	6	215	1	2	0	224
9215	4	3	0	225	0	232
9216	0	2	220	7	0	229
9217	1	1	5	227	0	234
9218	221	0	2	7	0	230
9219	7	1	225	2	0	235
9220	1	2	209	1	0	213
9221	3	204	6	2	0	215
9222	195	4	0	1	0	200
9223	5	184	1	3	0	193
9224	1	4	181	1	0	187
9225	1	1	192	0	0	194
9226	1	190	5	0	0	196
9227	162	4	0	1	0	167
9228	3	157	0	0	0	160
9229	1	3	0	158	0	162
9230	0	1	0	163	0	164
9231	0	0	167	4	0	171
9232	0	0	3	169	0	172
9233	0	0	176	3	0	179
9234	169	0	3	2	0	174
9235	177	0	0	0	0	177
9236	178	0	0	0	0	178
9237	4	0	175	0	0	179
9238	172	0	3	0	0	175
9239	3	0	0	166	0	169
9240	1	173	0	3	0	177
9241	169	3	0	1	0	173
9242	3	1	171	0	0	175
9243	174	0	3	0	0	177
9244	169	0	1	0	0	170
9245	4	0	162	0	0	166
9246	1	162	3	0	0	166
9247	0	4	1	164	0	169
9248	0	1	166	3	0	170
9249	0	0	161	1	0	162
9250	0	0	4	133	0	137
9251	0	0	130	4	0	134
9252	0	0	4	128	0	132
9253	0	0	2	130	0	132
9254	1	0	0	135	0	136
9255	0	0	133	4	0	137
9256	0	0	4	135	0	139
9257	1	5	129	3	0	138
9258	1	1	3	129	0	134
9259	142	1	1	4	0	148
9260	3	0	2	150	0	155
9261	1	157	1	3	0	162
9262	1	4	0	158	0	163
9263	163	1	1	3	0	168
9264	3	161	1	1	0	166
9265	1	4	0	163	0	168
9266	167	1	0	4	0	172
9267	3	1	172	1	0	177
9268	1	0	4	175	0	180
9269	0	0	176	3	0	179
9270	1	1	169	1	0	172
9271	3	0	3	164	0	170
9272	168	1	1	3	0	173
9273	3	0	165	2	0	170
9274	167	0	3	1	0	171
9275	3	0	2	167	0	172
9276	1	1	162	4	0	168
9277	1	1	166	1	0	169
9278	1	0	174	0	0	175
9279	0	0	5	154	0	159
9280	164	0	2	5	0	171
9281	4	161	2	2	0	169
9282	3	5	0	152	0	160
9283	0	1	0	160	0	161
9284	156	1	1	6	0	164
9285	159	0	1	3	0	163
9286	5	155	1	1	0	162
9287	159	4	1	1	0	165
9288	163	2	0	2	0	167
9289	6	0	1	159	0	166
9290	2	1	157	5	0	165
9291	156	0	5	3	0	164
9292	4	0	3	156	0	163
9293	2	0	2	163	0	167
9294	159	0	0	9	0	168
9295	5	0	1	163	0	169
9296	2	0	0	167	0	169
9297	166	1	0	7	0	174
9298	3	169	0	4	0	176
9299	176	3	1	0	0	180
9300	3	2	174	1	0	180
9301	166	0	4	1	0	171
9302	4	0	2	170	0	176
9303	2	174	1	3	0	180
9304	1	2	0	176	0	179
9305	1	4	1	173	0	179
9306	1	0	1	167	0	169
9307	170	0	0	6	0	176
9308	3	168	0	2	0	173
9309	1	148	2	0	0	151
9310	150	4	0	0	0	154
9311	3	1	155	2	0	161
9312	1	0	155	2	0	158
9313	155	0	5	1	0	161
9314	2	0	174	1	0	177
9315	2	0	2	169	0	173
9316	1	0	1	164	0	166
9317	0	1	0	175	0	176
9318	1	0	0	174	0	175
9319	0	165	1	3	0	169
9320	1	2	0	167	0	170
9321	0	1	163	3	0	167
9322	0	1	2	165	0	168
9323	0	0	162	3	0	165
9324	0	0	162	2	0	164
9325	0	0	3	159	0	162
9326	1	0	164	2	0	167
9327	0	1	2	164	0	167
9328	159	1	1	2	0	163
9329	3	0	163	1	0	167
9330	155	0	3	0	0	158
9331	2	0	2	151	0	155
9332	2	0	151	2	0	155
9333	0	146	3	1	0	150
9334	0	2	1	154	0	157
9335	0	1	157	3	0	161
9336	0	0	2	158	0	160
9337	169	0	1	4	0	174
9338	169	1	0	1	0	171
9339	180	0	0	1	0	181
9340	3	0	1	179	0	183
9341	1	0	0	179	0	180
9342	0	0	1	187	0	188
9343	199	0	1	3	0	203
9344	4	212	0	2	0	218
9345	1	4	1	209	0	215
9346	2	1	0	216	0	219
9347	211	1	0	6	0	218
9348	3	213	1	2	0	219
9349	2	4	0	219	0	225
9350	224	2	0	7	0	233
9351	229	1	1	3	0	234
9352	8	1	0	220	0	229
9353	227	0	0	7	0	234
9354	7	0	1	228	0	236
9355	1	1	225	7	0	234
9356	2	0	5	226	0	233
9357	1	0	1	239	0	241
9358	4	0	1	235	0	240
9359	218	0	0	8	0	226
9360	5	219	1	3	0	228
9361	207	5	0	3	0	215
9362	7	210	0	0	0	217
9363	1	206	0	0	0	207
9364	199	6	0	1	0	206
9365	5	209	0	1	0	215
9366	2	6	0	207	0	215
9367	197	2	0	5	0	204
9368	201	1	0	2	0	204
9369	7	0	0	202	0	209
9370	3	0	0	197	0	200
9371	1	202	0	6	0	209
9372	206	5	0	1	0	212
9373	201	1	0	2	0	204
9374	6	214	2	1	0	223
9375	2	221	0	0	0	223
9376	1	6	0	235	0	242
9377	227	2	0	6	0	235
9378	5	0	0	225	0	230
9379	1	1	0	233	0	235
9380	2	0	227	6	0	235
9381	0	0	224	2	0	226
9382	0	0	6	228	0	234
9383	0	0	228	5	0	233
9384	0	228	6	1	0	235
9385	0	5	1	225	0	231
9386	0	1	1	233	0	235
9387	0	1	0	229	0	230
9388	0	0	224	6	0	230
9389	0	0	219	2	0	221
9390	219	0	6	1	0	226
9391	5	224	2	0	0	231
9392	229	5	0	0	0	234
9393	6	1	0	228	0	235
9394	234	1	0	6	0	241
9395	6	0	0	223	0	229
9396	1	236	0	6	0	243
9397	233	5	0	2	0	240
9398	6	1	226	1	0	234
9399	1	221	5	0	0	227
9400	230	5	1	0	0	236
9401	7	0	1	223	0	231
9402	1	221	0	4	0	226
9403	1	5	0	227	0	233
9404	237	1	0	6	0	244
9405	5	1	0	238	0	244
9406	239	0	0	6	0	245
9407	6	0	234	1	0	241
9408	1	0	5	235	0	241
9409	234	0	1	4	0	239
9410	5	0	229	1	0	235
9411	1	226	5	1	0	233
9412	0	5	1	224	0	230
9413	0	1	218	5	0	224
9414	0	1	213	1	0	215
9415	0	0	5	210	0	215
9416	0	0	203	4	0	207
9417	0	0	204	1	0	205
9418	0	0	5	207	0	212
9419	209	1	2	4	0	216
9420	4	0	1	209	0	214
9421	2	0	0	213	0	215
9422	2	1	210	5	0	218
9423	0	0	4	230	0	234
9424	232	0	1	6	0	239
9425	5	1	231	1	0	238
9426	2	231	5	2	0	240
9427	2	5	1	234	0	242
9428	235	1	1	6	0	243
9429	5	3	0	230	0	238
9430	1	239	0	8	0	248
9431	3	5	240	1	0	249
9432	1	1	4	249	0	255
9433	256	2	1	6	0	265
9434	6	0	251	1	0	258
9435	1	0	7	264	0	272
9436	264	0	1	9	0	274
9437	293	0	3	1	0	297
9438	8	299	0	2	0	309
9439	293	8	0	1	0	302
9440	10	2	0	282	0	294
9441	2	2	287	9	0	300
9442	2	275	7	2	0	286
9443	0	264	9	2	0	275
9444	1	8	1	251	0	261
9445	0	4	0	261	0	265
9446	1	1	252	7	0	261
9447	0	246	5	4	0	255
9448	2	262	1	2	0	267
9449	1	7	0	260	0	268
9450	250	3	0	4	0	257
9451	4	256	0	2	0	262
9452	0	4	1	262	0	267
9453	264	3	0	4	0	271
9454	4	2	0	263	0	269
9455	1	0	0	267	0	268
9456	1	1	0	264	0	266
9457	1	0	1	264	0	266
9458	257	2	0	6	0	265
9459	4	1	0	261	0	266
9460	1	0	246	7	0	254
9461	246	0	5	1	0	252
9462	5	2	249	2	0	258
9463	3	1	267	1	0	272
9464	2	5	6	263	0	276
9465	1	0	2	266	0	269
9466	0	0	2	273	0	275
9467	263	1	1	7	0	272
9468	4	2	259	3	0	268
9469	260	1	4	2	0	267
9470	268	0	1	2	0	271
9471	5	1	280	1	0	287
9472	266	0	3	1	0	270
9473	6	1	287	0	0	294
9474	1	279	6	1	0	287
9475	1	10	1	278	0	290
9476	0	1	1	275	0	277
9477	0	2	0	274	0	276
9478	2	0	0	276	0	278
9479	1	0	274	7	0	282
9480	1	0	280	3	0	284
9481	2	0	6	269	0	277
9482	0	0	281	6	0	287
9483	273	0	5	2	0	280
9484	292	0	3	4	0	299
9485	5	2	1	292	0	300
9486	293	0	1	8	0	302
9487	9	293	0	2	0	304
9488	296	5	2	3	0	306
9489	6	2	300	1	0	309
9490	2	1	6	301	0	310
9491	2	292	4	4	0	302
9492	304	4	1	4	0	313
9493	5	3	3	305	0	316
9494	2	2	296	6	0	306
9495	4	0	4	298	0	306
9496	299	0	2	7	0	308
9497	6	2	291	2	0	301
9498	3	1	3	297	0	304
9499	3	0	2	301	0	306
9500	3	0	297	8	0	308
9501	0	296	3	6	0	305
9502	3	233	3	3	0	242
9503	4	6	1	303	0	314
9504	1	3	3	307	0	314
9505	0	5	3	311	0	319
9506	300	3	1	9	0	313
9507	308	2	0	9	0	319
9508	9	0	3	306	0	318
9509	305	1	3	8	0	317
9510	7	295	1	4	0	307
9511	3	8	1	301	0	313
9512	3	3	1	305	0	312
9513	3	3	1	304	0	311
9514	284	4	1	11	0	300
9515	5	286	1	10	0	302
9516	5	3	0	297	0	305
9517	292	2	1	8	0	303
9518	8	2	1	296	0	307
9519	2	1	1	298	0	302
9520	5	273	3	11	0	292
9521	3	292	2	5	0	302
9522	2	13	0	299	0	314
9523	0	3	2	294	0	299
9524	275	1	0	11	0	287
9525	6	1	1	280	0	288
9526	4	1	278	6	0	289
9527	3	1	4	268	0	276
9528	3	263	2	11	0	279
9529	288	4	1	7	0	300
9530	5	4	3	287	0	299
9531	2	9	1	277	0	289
9532	2	270	0	8	0	280
9533	271	3	0	5	0	279
9534	6	269	1	3	0	279
9535	5	4	1	268	0	278
9536	1	2	266	4	0	273
9537	2	6	1	220	0	229
9538	225	0	1	2	0	228
9539	1	227	0	3	0	231
9540	1	2	1	237	0	241
9541	0	224	0	2	0	226
9542	2	1	0	232	0	235
9543	0	2	237	3	0	242
9544	1	0	4	221	0	226
9545	0	1	1	233	0	235
9546	0	0	0	239	0	239
9547	237	1	1	3	0	242
9548	236	1	0	2	0	239
9549	3	241	0	1	0	245
9550	242	1	0	4	0	247
9551	3	240	0	1	0	244
9552	2	239	0	1	0	242
9553	232	4	0	0	0	236
9554	3	2	228	1	0	234
9555	2	1	3	225	0	231
9556	0	2	2	239	0	243
9557	1	0	0	243	0	244
9558	242	0	1	5	0	248
9559	2	238	2	3	0	245
9560	2	2	0	247	0	251
9561	0	243	1	3	0	247
9562	244	3	0	4	0	251
9563	3	3	1	244	0	251
9564	1	0	0	298	0	299
9565	1	324	0	6	0	331
9566	2	4	0	365	0	371
9567	2	2	0	366	0	370
9568	346	1	0	10	0	357
9569	4	337	0	4	0	345
9570	6	345	0	2	0	353
9571	1	6	0	335	0	342
9572	1	3	331	7	0	342
9573	2	1	322	4	0	329
9574	0	2	7	319	0	328
9575	2	0	318	8	0	328
9576	1	1	6	317	0	325
9577	1	0	3	312	0	316
9578	2	1	0	335	0	338
9579	319	2	1	8	0	330
9580	6	1	0	321	0	328
9581	2	2	0	323	0	327
9582	1	317	1	9	0	328
9583	2	5	0	321	0	328
9584	1	2	306	9	0	318
9585	1	2	6	314	0	323
9586	1	2	2	317	0	322
9587	302	3	1	10	0	316
9588	7	0	1	310	0	318
9589	3	2	1	301	0	307
9590	1	2	1	311	0	315
9591	294	0	1	10	0	305
9592	6	290	1	7	0	304
9593	3	6	3	294	0	306
9594	3	2	1	302	0	308
9595	1	2	292	9	0	304
9596	1	1	6	293	0	301
9597	281	1	3	8	0	293
9598	5	289	0	7	0	301
9599	2	5	0	283	0	290
9600	0	2	1	289	0	292
9601	0	0	278	8	0	286
9602	270	0	6	3	0	279
9603	5	284	1	2	0	292
9604	275	4	0	3	0	282
9605	4	0	1	275	0	280
9606	1	0	0	271	0	272
9607	0	0	0	273	0	273
9608	1	1	0	274	0	276
9609	265	0	0	7	0	272
9610	4	1	0	262	0	267
9611	2	263	0	5	0	270
9612	1	5	0	271	0	277
9613	0	2	1	276	0	279
9614	269	0	0	7	0	276
9615	4	269	1	2	0	276
9616	1	5	2	272	0	280
9617	272	1	0	7	0	280
9618	279	0	0	2	0	281
9619	5	1	1	283	0	290
9620	2	0	273	6	0	281
9621	274	1	3	3	0	281
9622	6	0	3	277	0	286
9623	3	0	286	6	0	295
9624	0	1	4	293	0	298
9625	2	1	2	292	0	297
9626	0	0	0	293	0	293
9627	0	305	0	8	0	313
9628	0	4	1	303	0	308
9629	1	4	0	304	0	309
9630	2	0	0	305	0	307
9631	0	0	1	315	0	316
9632	2	2	0	306	0	310
9633	0	2	0	313	0	315
9634	302	1	0	10	0	313
9635	6	2	284	3	0	295
9636	3	280	5	2	0	290
9637	280	5	2	4	0	291
9638	5	284	1	3	0	293
9639	277	4	2	2	0	285
9640	4	2	1	277	0	284
9641	291	1	2	8	0	302
9642	6	0	1	294	0	301
9643	3	0	1	278	0	282
9644	0	282	1	10	0	293
9645	284	5	0	5	0	294
9646	4	5	282	2	0	293
9647	4	0	4	292	0	300
9648	0	1	293	8	0	302
9649	1	1	284	5	0	291
9650	285	0	5	5	0	295
9651	3	0	3	290	0	296
9652	4	1	283	4	0	292
9653	1	0	294	6	0	301
9654	2	2	6	285	0	295
9655	3	0	2	309	0	314
9656	299	2	2	9	0	312
9657	4	1	2	302	0	309
9658	4	1	312	4	0	321
9659	1	2	3	314	0	320
9660	2	4	1	311	0	318
9661	2	311	1	8	0	322
9662	315	5	1	4	0	325
9663	3	311	0	3	0	317
9664	265	2	1	1	0	269
9665	1	232	0	2	0	235
9666	1	196	2	0	0	199
9667	0	1	0	200	0	201
9668	0	1	1	199	0	201
9669	0	1	0	200	0	201
9670	190	0	0	1	0	191
9671	0	1	194	1	0	196
9672	2	0	0	192	0	194
9673	188	1	1	0	0	190
9674	0	186	0	1	0	187
9675	0	183	0	1	0	184
9676	0	1	0	191	0	192
9677	0	1	0	188	0	189
9678	1	0	0	185	0	186
9679	0	196	1	1	0	198
9680	0	0	0	199	0	199
9681	1	1	194	0	0	196
9682	0	1	189	1	0	191
9683	194	1	1	0	0	196
9684	0	0	1	204	0	205
9685	204	0	0	1	0	205
9686	201	0	0	2	0	203
9687	1	206	0	0	0	207
9688	208	0	0	1	0	209
9689	228	1	1	1	0	231
9690	1	0	1	225	0	227
9691	2	0	0	233	0	235
9692	0	0	229	4	0	233
9693	1	239	0	1	0	241
9694	4	0	1	211	0	216
9695	0	2	0	236	0	238
9696	240	0	0	1	0	241
9697	1	0	0	238	0	239
9698	235	0	0	1	0	236
9699	0	0	0	237	0	237
9700	1	239	1	0	0	241
9701	245	1	0	1	0	247
9702	1	2	0	288	0	291
9703	2	0	0	316	0	318
9704	1	0	0	336	0	337
9705	0	0	333	11	0	344
9706	1	0	5	339	0	345
9707	334	0	4	8	0	346
9708	6	0	0	357	0	363
9709	5	0	1	396	0	402
9710	1	1	0	413	0	415
9711	1	402	1	14	0	418
9712	0	418	0	6	0	424
9713	425	11	1	1	0	438
9714	8	437	0	3	0	448
9715	435	8	0	3	0	446
9716	437	5	0	3	0	445
9717	454	0	0	4	0	458
9718	12	3	443	3	0	461
9719	6	442	8	1	0	457
9720	443	11	2	3	0	459
9721	12	4	0	443	0	459
9722	5	1	1	449	0	456
9723	4	1	0	443	0	448
9724	4	436	1	11	0	452
9725	3	6	1	436	0	446
9726	434	4	2	8	0	448
9727	9	2	0	425	0	436
9728	6	1	1	434	0	442
9729	0	1	419	19	0	439
9730	4	1	424	9	0	438
9731	0	0	11	416	0	427
9732	1	2	4	419	0	426
9733	3	417	1	14	0	435
9734	3	9	1	426	0	439
9735	0	3	1	439	0	443
9736	1	0	1	437	0	439
9737	418	2	3	14	0	437
9738	8	3	420	7	0	438
9739	4	0	8	432	0	444
9740	431	3	4	12	0	450
9741	422	2	0	6	0	430
9742	14	0	1	416	0	431
9743	6	1	0	423	0	430
9744	411	1	3	14	0	429
9745	10	414	2	5	0	431
9746	7	421	2	4	0	434
9747	4	12	1	415	0	432
9748	419	3	1	13	0	436
9749	425	2	1	9	0	437
9750	434	3	0	4	0	441
9751	11	1	428	6	0	446
9752	428	3	8	3	0	442
9753	10	3	441	4	0	458
9754	433	3	7	7	0	450
9755	10	431	6	4	0	451
9756	8	10	432	1	0	451
9757	4	4	11	428	0	447
9758	6	0	430	11	0	447
9759	4	4	10	420	0	438
9760	425	2	6	13	0	446
9761	9	1	425	9	0	444
9762	7	2	12	416	0	437
9763	3	419	4	13	0	439
9764	6	8	5	436	0	455
9765	2	3	2	440	0	447
9766	3	2	3	423	0	431
9767	433	2	1	17	0	453
9768	442	1	2	9	0	454
9769	12	2	2	442	0	458
9770	8	1	426	13	0	448
9771	5	4	428	6	0	443
9772	3	5	12	440	0	460
9773	7	2	443	16	0	468
9774	8	0	12	446	0	466
9775	8	2	3	443	0	456
9776	6	1	4	448	0	459
9777	2	428	6	17	0	453
9778	4	426	5	10	0	445
9779	3	16	4	440	0	463
9780	0	6	4	451	0	461
9781	2	5	3	449	0	459
9782	430	3	2	19	0	454
9783	12	0	454	12	0	478
9784	4	0	12	465	0	481
9785	460	2	4	17	0	483
9786	9	450	4	8	0	471
9787	5	14	3	454	0	476
9788	4	5	2	473	0	484
9789	3	5	1	456	0	465
9790	3	2	0	451	0	456
9791	2	1	431	20	0	454
9792	412	0	9	15	0	436
9793	437	1	4	7	0	449
9794	16	2	426	5	0	449
9795	431	0	10	8	0	449
9796	450	2	5	6	0	463
9797	15	1	448	9	0	473
9798	10	467	12	6	0	495
9799	7	8	8	471	0	494
9800	7	1	500	14	0	522
9801	5	482	12	8	0	507
9802	5	10	448	3	0	466
9803	4	414	8	1	0	427
9804	3	4	1	410	0	418
9805	2	1	420	5	0	428
9806	2	4	5	399	0	410
9807	1	0	430	8	0	439
9808	2	429	7	0	0	438
9809	384	1	1	3	0	389
9810	1	355	2	0	0	358
9811	0	401	0	0	0	401
9812	5	1	6	395	0	407
9813	0	2	0	397	0	399
9814	0	0	0	380	0	380
9815	0	0	0	371	0	371
9816	0	0	0	393	0	393
9817	0	0	429	3	0	432
9818	0	0	1	416	0	417
9819	1	0	0	427	0	428
9820	439	0	2	1	0	442
9821	447	0	0	4	0	451
9822	459	0	0	3	0	462
9823	3	0	0	457	0	460
9824	507	0	0	5	0	512
9825	546	0	0	0	0	546
9826	552	0	0	2	0	554
9827	4	0	549	0	0	553
9828	531	0	2	1	0	534
9829	563	0	0	0	0	563
9830	564	0	2	2	0	568
9831	4	0	0	563	0	567
9832	2	0	568	2	0	572
9833	2	0	3	559	0	564
9834	582	0	0	5	0	587
9835	3	0	1	587	0	591
9836	0	623	0	5	0	628
9837	4	3	0	634	0	641
9838	637	0	0	6	0	643
9839	635	3	0	0	0	638
9840	628	0	0	4	0	632
9841	6	0	650	0	0	656
9842	3	0	3	632	0	638
9843	3	0	0	664	0	667
9844	1	0	670	3	0	674
9845	0	645	3	2	0	650
9846	0	3	652	2	0	657
9847	1	0	6	651	0	658
9848	654	3	1	3	0	661
9849	4	0	705	0	0	709
9850	0	0	3	699	0	702
9851	3	0	705	3	0	711
9852	677	0	7	1	0	685
9853	5	1	0	694	0	700
9854	1	0	745	4	0	750
9855	4	1	4	725	0	734
9856	1	0	762	7	0	770
9857	1	765	7	0	0	773
9858	1	4	0	768	0	773
9859	776	0	4	5	0	785
9860	5	3	0	777	0	785
9861	1	0	0	776	0	777
9862	786	0	0	4	0	790
9863	5	738	0	5	0	748
9864	1	779	0	4	0	784
9865	4	4	0	779	0	787
9866	1	784	1	4	0	790
9867	6	6	0	780	0	792
9868	2	0	1	784	0	787
9869	788	2	0	6	0	796
9870	4	784	0	3	0	791
9871	0	3	773	3	0	779
9872	2	796	2	0	0	800
9873	800	4	0	0	0	804
9874	808	0	1	1	0	810
9875	5	1	0	796	0	802
9876	816	0	1	4	0	821
9877	6	0	0	817	0	823
9878	819	0	2	6	0	827
9879	824	1	0	3	0	828
9880	7	0	1	877	0	885
9881	888	0	1	5	0	894
9882	8	0	902	1	0	911
9883	854	0	6	3	0	863
9884	5	1	1	879	0	886
9885	886	0	2	5	0	893
9886	8	924	0	2	0	934
9887	1	4	1	922	0	928
9888	3	1	1	921	0	926
9889	922	1	3	5	0	931
9890	6	1	919	3	0	929
9891	3	907	4	7	0	921
9892	3	4	1	932	0	940
9893	1	927	1	7	0	936
9894	1	6	3	937	0	947
9895	1	1	0	897	0	899
9896	4	1	0	925	0	930
9897	916	2	1	6	0	925
9898	4	2	1	894	0	901
9899	904	1	1	9	0	915
9900	889	2	0	0	0	891
9901	7	0	0	911	0	918
9902	906	0	0	6	0	912
9903	893	0	2	1	0	896
9904	4	1	909	5	0	919
9905	3	0	5	863	0	871
9906	905	2	1	4	0	912
9907	5	875	1	2	0	883
9908	875	4	2	3	0	884
9909	877	1	1	4	0	883
9910	8	2	868	1	0	879
9911	4	0	7	808	0	819
9912	880	0	0	9	0	889
9913	5	2	3	887	0	897
9914	2	0	1	890	0	893
9915	5	1	0	891	0	897
9916	2	0	3	946	0	951
9917	913	0	1	11	0	925
9918	11	1	941	5	0	958
9919	4	1	8	970	0	983
9920	2	2	1143	12	0	1159
9921	3	2	1217	3	0	1225
9922	1189	1	45	8	0	1243
9923	39	1	1321	3	0	1364
9924	12	1282	50	2	0	1346
9925	1302	49	14	2	0	1367
9926	1342	11	8	2	0	1363
9927	54	9	1	1290	0	1354
9928	21	2	1293	45	0	1361
9929	10	4	1312	12	0	1338
9930	1279	1	58	12	0	1350
9931	52	0	22	1324	0	1398
9932	1345	0	12	49	0	1406
9933	56	1387	3	12	0	1458
9934	1398	45	4	9	0	1456
9935	1408	11	2	0	0	1421
9936	60	1380	3	3	0	1446
9937	22	48	3	1372	0	1445
9938	1374	13	4	49	0	1440
9939	53	12	1366	12	0	1443
9940	16	1372	50	16	0	1454
9941	16	51	16	1375	0	1458
9942	1385	15	15	52	0	1467
9943	55	1387	5	13	0	1460
9944	1409	52	4	11	0	1476
9945	67	15	1393	5	0	1480
9946	1387	15	52	6	0	1460
9947	72	3	1422	6	0	1503
9948	1399	3	66	4	0	1472
9949	1386	5	17	3	0	1411
9950	69	4	1361	5	0	1439
9951	30	1351	56	6	0	1443
9952	19	56	16	1311	0	1402
9953	8	18	1359	53	0	1438
9954	7	1328	57	16	0	1408
9955	12	53	16	1285	0	1366
9956	9	16	18	1353	0	1396
9957	9	15	1296	66	0	1386
9958	16	4	56	1265	0	1341
9959	10	4	23	1334	0	1371
9960	6	9	1290	68	0	1373
9961	13	4	57	1250	0	1324
9962	10	1274	19	61	0	1364
9963	1292	56	17	20	0	1385
9964	58	18	11	1258	0	1345
9965	20	1298	12	56	0	1386
9966	22	55	11	1231	0	1319
9967	10	1311	15	55	0	1391
9968	23	67	1303	16	0	1409
9969	12	1316	61	19	0	1408
9970	1291	70	22	10	0	1393
9971	1339	24	16	7	0	1386
9972	1341	22	9	12	0	1384
9973	83	9	1312	21	0	1425
9974	31	13	1338	9	0	1391
9975	20	1379	85	6	0	1490
9976	21	69	32	1340	0	1462
9977	17	1431	21	72	0	1541
9978	22	78	16	1317	0	1433
9979	15	1448	13	56	0	1532
9980	1425	78	6	25	0	1534
9981	1556	21	16	22	0	1615
9982	91	32	11	1527	0	1661
9983	39	13	1522	82	0	1656
9984	1517	10	68	26	0	1621
9985	83	1537	33	29	0	1682
9986	31	79	34	1483	0	1627
9987	26	41	13	1522	0	1602
9988	29	1546	11	82	0	1668
9989	1551	86	18	42	0	1697
9990	93	44	1531	27	0	1695
9991	38	33	77	1538	0	1686
9992	1561	19	30	79	0	1689
9993	1586	12	35	33	0	1666
9994	113	1548	19	29	0	1709
9995	59	71	20	1502	0	1652
9996	37	1580	20	70	0	1707
9997	1595	98	13	37	0	1743
9998	97	43	1571	29	0	1740
9999	36	33	1609	19	0	1697
10000	42	26	93	1545	0	1706
10001	21	23	50	1569	0	1663
10002	29	1550	37	88	0	1704
10003	21	80	29	1576	0	1706
10004	18	30	1563	100	0	1711
10005	1539	36	77	47	0	1699
10006	89	13	37	1584	0	1723
10007	35	20	1601	90	0	1746
10008	38	21	83	1598	0	1740
10009	19	19	42	1600	0	1680
10010	22	1593	34	95	0	1744
10011	12	88	20	1620	0	1740
10012	18	34	17	1622	0	1691
10013	12	43	16	1629	0	1700
10014	1519	19	20	128	0	1686
10015	72	1483	16	64	0	1635
10016	33	1521	16	47	0	1617
10017	1486	82	11	34	0	1613
10018	1452	43	15	28	0	1538
10019	93	1360	22	23	0	1498
10020	38	1223	17	21	0	1299
10021	1050	47	6	12	0	1115
10022	45	1034	3	16	0	1098
10023	13	997	3	8	0	1021
10024	956	36	8	13	0	1013
10025	27	972	7	11	0	1017
10026	952	41	1	8	0	1002
10027	964	15	3	9	0	991
10028	971	25	5	6	0	1007
10029	47	946	6	10	0	1009
10030	24	978	6	8	0	1016
10031	22	35	1	934	0	992
10032	12	942	6	30	0	990
10033	10	37	5	937	0	989
10034	953	21	2	37	0	1013
10035	31	17	4	953	0	1005
10036	18	930	6	40	0	994
10037	935	30	6	19	0	990
10038	34	902	12	17	0	965
10039	19	959	4	14	0	996
10040	16	42	1	911	0	970
10041	10	942	1	26	0	979
10042	930	38	4	15	0	987
10043	30	19	914	20	0	983
10044	12	909	23	16	0	960
10045	23	25	15	912	0	975
10046	14	12	915	26	0	967
10047	11	20	25	895	0	951
10048	9	14	12	920	0	955
10049	10	12	17	923	0	962
10050	11	15	9	929	0	964
10051	12	12	888	44	0	956
10052	8	882	28	38	0	956
10053	877	24	14	38	0	953
10054	23	20	880	20	0	943
10055	869	20	23	16	0	928
10056	36	16	896	10	0	958
10057	22	10	36	897	0	965
10058	26	9	889	26	0	950
10059	20	5	906	18	0	949
10060	5	14	35	900	0	954
10061	8	7	32	844	0	891
10062	7	12	18	929	0	966
10063	9	11	8	929	0	957
10064	910	11	13	48	0	982
10065	24	9	897	39	0	969
10066	885	6	21	36	0	948
10067	922	8	17	19	0	966
10068	923	8	14	17	0	962
10069	921	14	11	10	0	956
10070	933	12	8	13	0	966
10071	56	5	9	898	0	968
10072	40	13	868	26	0	947
10073	25	13	836	19	0	893
10074	19	850	28	21	0	918
10075	780	23	17	15	0	835
10076	22	19	12	761	0	814
10077	16	21	10	745	0	792
10078	17	733	6	33	0	789
10079	13	724	5	25	0	767
10080	16	713	4	17	0	750
10081	613	18	0	9	0	640
10082	13	11	1	535	0	560
10083	6	538	2	11	0	557
10084	5	7	0	555	0	567
10085	6	7	561	8	0	582
10086	4	4	572	7	0	587
10087	3	2	10	640	0	655
10088	660	7	8	12	0	687
10089	720	0	5	11	0	736
10090	716	1	4	5	0	726
10091	20	4	708	5	0	737
10092	13	1	7	704	0	725
10093	6	3	12	731	0	752
10094	6	2	702	17	0	727
10095	665	6	9	13	0	693
10096	13	2	704	11	0	730
10097	9	1	679	6	0	695
10098	5	2	711	6	0	724
10099	6	2	14	685	0	707
10100	6	1	12	695	0	714
10101	3	2	718	15	0	738
10102	5	2	10	713	0	730
10103	718	0	11	14	0	743
10104	7	1	7	737	0	752
10105	9	1	743	12	0	765
10106	8	0	749	16	0	773
10107	3	0	16	735	0	754
10108	765	0	13	12	0	790
10109	11	818	8	12	0	849
10110	856	12	5	6	0	879
10111	858	10	5	7	0	880
10112	29	1	896	3	0	929
10113	20	5	15	879	0	919
10114	892	2	16	19	0	929
10115	889	0	10	22	0	921
10116	31	884	10	7	0	932
10117	17	13	7	887	0	924
10118	14	13	4	915	0	946
10119	8	4	902	33	0	947
10120	5	5	17	878	0	905
10121	6	2	901	24	0	933
10122	8	4	892	22	0	926
10123	8	3	34	894	0	939
10124	887	2	21	24	0	934
10125	21	858	13	20	0	912
10126	870	13	10	8	0	901
10127	851	16	5	12	0	884
10128	36	857	5	10	0	908
10129	21	16	4	838	0	879
10130	844	15	7	17	0	883
10131	24	846	2	19	0	891
10132	834	18	5	11	0	868
10133	18	820	7	11	0	856
10134	19	15	10	788	0	832
10135	15	15	2	807	0	839
10136	795	9	2	28	0	834
10137	783	6	4	17	0	810
10138	26	793	3	11	0	833
10139	19	10	757	8	0	794
10140	10	13	753	6	0	782
10141	8	5	23	720	0	756
10142	4	753	16	17	0	790
10143	7	8	8	763	0	786
10144	5	17	6	741	0	769
10145	2	7	4	753	0	766
10146	5	4	751	27	0	787
10147	9	4	727	21	0	761
10148	7	757	24	10	0	798
10149	3	18	15	752	0	788
10150	9	12	10	784	0	815
10151	8	8	774	21	0	811
10152	709	6	11	20	0	746
10153	16	5	15	782	0	818
10154	16	4	790	18	0	828
10155	747	4	16	15	0	782
10156	23	765	12	25	0	825
10157	18	18	796	9	0	841
10158	10	13	18	794	0	835
10159	817	9	14	18	0	858
10160	15	4	817	18	0	854
10161	14	1	18	806	0	839
10162	6	6	15	802	0	829
10163	7	4	6	865	0	882
10164	864	2	10	31	0	907
10165	15	859	8	24	0	906
10166	18	19	7	866	0	910
10167	8	14	873	23	0	918
10168	7	9	17	857	0	890
10169	5	837	10	28	0	880
10170	5	878	5	30	0	918
10171	855	27	12	10	0	904
10172	884	16	8	7	0	915
10173	32	7	861	9	0	909
10174	847	13	22	9	0	891
10175	31	860	17	7	0	915
10176	879	22	8	6	0	915
10177	23	20	7	867	0	917
10178	21	8	874	24	0	927
10179	20	6	17	875	0	918
10180	13	6	891	18	0	928
10181	846	7	22	24	0	899
10182	20	5	17	870	0	912
10183	21	908	11	26	0	966
10184	10	25	12	917	0	964
10185	12	13	896	32	0	953
10186	1	874	23	27	0	925
10187	799	20	16	12	0	847
10188	17	768	5	14	0	804
10189	11	735	6	4	0	756
10190	9	28	5	708	0	750
10191	8	740	5	18	0	771
10192	7	24	3	738	0	772
10193	5	16	707	22	0	750
10194	682	6	13	16	0	717
10195	723	9	9	6	0	747
10196	30	6	709	5	0	750
10197	702	7	18	8	0	735
10198	25	688	12	4	0	729
10199	710	18	7	8	0	743
10200	26	12	5	703	0	746
10201	17	11	704	15	0	747
10202	4	722	17	15	0	758
10203	7	16	10	724	0	757
10204	8	13	10	730	0	761
10205	700	2	9	24	0	735
10206	682	9	1	14	0	706
10207	23	669	4	11	0	707
10208	13	623	3	6	0	645
10209	6	594	1	4	0	605
10210	2	8	3	560	0	573
10211	542	3	13	8	0	566
10212	532	0	1	4	0	537
10213	7	2	1	528	0	538
10214	3	0	1	537	0	541
10215	520	1	0	9	0	530
10216	8	2	0	523	0	533
10217	2	2	550	9	0	563
10218	544	2	8	4	0	558
10219	556	2	1	3	0	562
10220	9	1	572	3	0	585
10221	567	0	5	2	0	574
10222	9	2	1	584	0	596
10223	5	1	0	582	0	588
10224	1	2	2	587	0	592
10225	573	1	1	12	0	587
10226	7	591	2	3	0	603
10227	3	7	0	593	0	603
10228	3	571	3	8	0	585
10229	576	6	2	2	0	586
10230	8	2	1	579	0	590
10231	3	1	1	578	0	583
10232	4	572	0	9	0	585
10233	2	8	567	5	0	582
10234	0	2	9	578	0	589
10235	573	2	4	10	0	589
10236	643	1	0	7	0	651
10237	13	2	694	0	0	709
10238	7	1	13	705	0	726
10239	3	735	5	14	0	757
10240	4	14	4	751	0	773
10241	747	7	3	19	0	776
10242	743	5	1	8	0	757
10243	18	5	1	734	0	758
10244	13	733	1	14	0	761
10245	784	15	0	9	0	808
10246	18	5	1	793	0	817
10247	790	5	0	19	0	814
10248	831	4	3	9	0	847
10249	17	1	1	832	0	851
10250	15	1	3	821	0	840
10251	10	3	0	851	0	864
10252	6	837	1	24	0	868
10253	4	14	3	856	0	877
10254	4	7	1	857	0	869
10255	2	7	823	23	0	855
10256	5	4	790	10	0	809
10257	3	0	17	809	0	829
10258	800	2	9	18	0	829
10259	13	794	6	8	0	821
10260	790	12	2	9	0	813
10261	17	8	802	8	0	835
10262	10	4	788	8	0	810
10263	6	797	18	4	0	825
10264	17	21	16	767	0	821
10265	1	5	780	15	0	801
10266	4	5	783	9	0	801
10267	1	5	16	775	0	797
10268	789	0	9	23	0	821
10269	803	1	7	9	0	820
10270	15	1	6	799	0	821
10271	10	4	866	14	0	894
10272	9	2	11	866	0	888
10273	3	2	8	867	0	880
10274	2	867	9	16	0	894
10275	868	9	3	10	0	890
10276	874	4	2	7	0	887
10277	15	871	3	7	0	896
10278	8	13	2	844	0	867
10279	7	858	1	12	0	878
10280	852	16	3	8	0	879
10281	12	4	857	8	0	881
10282	7	6	803	5	0	821
10283	10	4	782	2	0	798
10284	4	0	18	807	0	829
10285	3	2	11	798	0	814
10286	795	3	6	13	0	817
10287	10	3	3	801	0	817
10288	9	2	2	823	0	836
10289	6	3	855	12	0	876
10290	4	1	798	10	0	813
10291	798	3	13	13	0	827
10292	11	830	8	7	0	856
10293	850	10	9	5	0	874
10294	15	6	3	863	0	887
10295	10	4	2	857	0	873
10296	5	862	3	15	0	885
10297	4	8	3	876	0	891
10298	854	6	4	15	0	879
10299	11	4	5	857	0	877
10300	6	3	847	16	0	872
10301	7	820	10	10	0	847
10302	813	9	6	10	0	838
10303	844	6	5	6	0	861
10304	832	6	3	6	0	847
10305	865	3	3	4	0	875
10306	22	3	2	842	0	869
10307	16	3	0	857	0	876
10308	8	2	859	16	0	885
10309	5	3	12	847	0	867
10310	7	3	849	15	0	874
10311	3	5	13	852	0	873
10312	844	1	6	20	0	871
10313	14	882	5	8	0	909
10314	9	8	5	903	0	925
10315	6	5	5	913	0	929
10316	901	6	6	17	0	930
10317	843	2	4	16	0	865
10318	17	4	834	7	0	862
10319	13	832	11	8	0	864
10320	11	10	7	836	0	864
10321	2	8	7	843	0	860
10322	835	5	4	20	0	864
10323	813	3	5	15	0	836
10324	17	2	849	8	0	876
10325	11	2	830	7	0	850
10326	10	1	15	821	0	847
10327	3	5	12	836	0	856
10328	4	2	838	17	0	861
10329	799	4	11	16	0	830
10330	16	1	8	853	0	878
10331	854	2	6	12	0	874
10332	13	840	6	10	0	869
10333	860	8	6	8	0	882
10334	12	2	912	10	0	936
10335	13	899	6	13	0	931
10336	7	860	7	5	0	879
10337	794	7	8	3	0	812
10338	774	4	1	3	0	782
10339	8	0	3	758	0	769
10340	3	756	2	4	0	765
10341	1	769	1	3	0	774
10342	2	5	2	781	0	790
10343	774	2	0	7	0	783
10344	762	1	0	3	0	766
10345	7	1	725	1	0	734
10346	683	2	3	4	0	692
10347	4	737	2	2	0	745
10348	733	4	1	4	0	742
10349	8	954	0	0	0	962
10350	4	1071	0	1	0	1076
10351	8	24	2	1259	0	1293
10352	1380	11	0	39	0	1430
10353	1432	7	0	15	0	1454
10354	62	1	1371	10	0	1444
10355	29	0	44	1387	0	1460
10356	1409	1	15	50	0	1475
10357	58	0	11	1410	0	1479
10358	1418	0	6	59	0	1483
10359	1433	1	7	22	0	1463
10360	69	1	1392	17	0	1479
10361	35	1	48	1362	0	1446
10362	20	0	16	1419	0	1455
10363	15	1	11	1427	0	1454
10364	9	1	1355	72	0	1437
10365	4	0	54	1358	0	1416
10366	5	0	16	1342	0	1363
10367	3	1314	13	71	0	1401
10368	7	44	1288	34	0	1373
10369	1	1334	49	21	0	1405
10370	1320	54	17	15	0	1406
10371	48	21	14	1247	0	1330
10372	20	20	6	1244	0	1290
10373	13	1246	9	56	0	1324
10374	1229	53	2	23	0	1307
10375	1289	18	3	17	0	1327
10376	71	1225	1	18	0	1315
10377	32	1277	1	19	0	1329
10378	1266	67	1	9	0	1343
10379	65	26	1242	3	0	1336
10380	29	20	1255	4	0	1308
10381	1209	14	64	5	0	1292
10382	50	1242	29	6	0	1327
10383	1256	48	18	5	0	1327
10384	59	19	1243	9	0	1330
10385	1244	12	48	9	0	1313
10386	67	1314	18	5	0	1404
10387	25	61	14	1301	0	1401
10388	27	21	7	1340	0	1395
10389	20	18	6	1261	0	1305
10390	16	9	6	1316	0	1347
10391	9	9	9	1297	0	1324
10392	14	1254	3	87	0	1358
10393	1255	52	5	54	0	1366
10394	55	20	1241	36	0	1352
10395	25	11	51	1263	0	1350
10396	22	14	1268	63	0	1367
10397	19	14	59	1266	0	1358
10398	18	2	27	1314	0	1361
10399	1262	6	24	77	0	1369
10400	55	7	1264	47	0	1373
10401	26	1236	58	36	0	1356
10402	21	50	22	1263	0	1356
10403	10	26	20	1290	0	1346
10404	19	17	1255	73	0	1364
10405	13	13	57	1244	0	1327
10406	8	15	23	1309	0	1355
10407	1228	7	21	76	0	1332
10408	53	1231	14	47	0	1345
10409	1241	56	11	31	0	1339
10410	1285	20	5	25	0	1335
10411	77	15	6	1244	0	1342
10412	44	18	1227	55	0	1344
10413	29	21	1234	24	0	1308
10414	30	7	68	1195	0	1300
10415	18	14	34	1176	0	1242
10416	13	1191	24	68	0	1296
10417	1182	49	24	40	0	1295
10418	56	1181	16	27	0	1280
10419	27	1240	8	23	0	1298
10420	1207	72	8	18	0	1305
10421	68	37	5	1178	0	1288
10422	31	1263	8	55	0	1357
10423	21	64	10	1269	0	1364
10424	18	29	1232	69	0	1348
10425	15	22	1252	44	0	1333
10426	10	16	72	1247	0	1345
10427	8	16	1259	69	0	1352
10428	8	10	67	1245	0	1330
10429	11	8	30	1273	0	1322
10430	4	9	23	1298	0	1334
10431	1207	10	14	96	0	1327
10432	51	1172	19	41	0	1283
10433	20	1218	7	42	0	1287
10434	1140	67	10	31	0	1248
10435	1197	33	7	27	0	1264
10436	76	19	12	1154	0	1261
10437	32	19	1157	61	0	1269
10438	24	15	53	1176	0	1268
10439	22	6	1177	66	0	1271
10440	14	1181	64	37	0	1296
10441	8	48	22	1211	0	1289
10442	1213	16	26	65	0	1320
10443	53	18	13	1245	0	1329
10444	19	15	1203	69	0	1306
10445	1185	15	56	32	0	1288
10446	60	10	1228	26	0	1324
10447	46	8	1236	20	0	1310
10448	19	1196	74	24	0	1313
10449	16	991	29	7	0	1043
10450	13	912	17	15	0	957
10451	610	31	26	16	0	683
10452	535	0	5	3	0	543
10453	4	1	1	542	0	548
10454	1	0	2	542	0	545
10455	0	2	1	560	0	563
10456	4	557	0	4	0	565
10457	563	4	0	3	0	570
10458	3	563	1	1	0	568
10459	4	4	0	572	0	580
10460	561	2	1	4	0	568
10461	3	4	1	568	0	576
10462	2	1	1	572	0	576
10463	569	2	2	3	0	576
10464	553	1	1	5	0	560
10465	5	0	561	4	0	570
10466	0	1	562	2	0	565
10467	1	1	576	3	0	581
10468	3	1	3	565	0	572
10469	1	2	2	571	0	576
10470	2	583	2	4	0	591
10471	607	3	1	2	0	613
10472	4	3	1	609	0	617
10473	1	1	0	617	0	619
10474	4	609	1	4	0	618
10475	1	644	1	3	0	649
10476	1	5	2	661	0	669
10477	1	0	1	742	0	744
10478	733	1	2	10	0	746
10479	736	2	1	4	0	743
10480	8	1	1	738	0	748
10481	5	1	728	10	0	744
10482	2	1	712	2	0	717
10483	2	1	10	735	0	748
10484	2	1	1	720	0	724
10485	2	716	1	16	0	735
10486	686	9	0	3	0	698
10487	8	0	1	686	0	695
10488	0	2	697	10	0	709
10489	3	0	9	698	0	710
10490	1	1	686	10	0	698
10491	0	1	687	3	0	691
10492	3	0	16	692	0	711
10493	689	0	1	9	0	699
10494	8	1	691	1	0	701
10495	1	0	8	682	0	691
10496	2	0	715	8	0	725
10497	0	0	9	708	0	717
10498	0	0	0	713	0	713
10499	1	0	714	8	0	723
10500	0	0	683	1	0	684
10501	1	0	7	639	0	647
10502	0	0	1	717	0	718
10503	0	0	1	716	0	717
10504	1	0	0	700	0	701
10505	688	0	0	11	0	699
10506	699	0	0	2	0	701
10507	8	692	0	2	0	702
10508	715	9	1	2	0	727
10509	10	0	0	713	0	723
10510	713	1	0	11	0	725
10511	11	1	707	1	0	720
10512	702	1	8	2	0	713
10513	11	0	0	707	0	718
10514	2	0	1	719	0	722
10515	720	0	0	11	0	731
10516	11	1	0	761	0	773
10517	3	1	821	15	0	840
10518	813	0	15	4	0	832
10519	14	879	2	3	0	898
10520	1	13	2	914	0	930
10521	4	2	1002	16	0	1024
10522	1	1	18	981	0	1001
10523	0	1	1005	21	0	1027
10524	2	0	22	991	0	1015
10525	0	997	3	22	0	1022
10526	0	21	3	1002	0	1026
10527	0	1044	1	21	0	1066
10528	4	18	3	990	0	1015
10529	2	3	1	1112	0	1118
10530	1	1	2	1119	0	1123
10531	2	0	1	1115	0	1118
10532	1	0	3	1132	0	1136
10533	0	0	1091	29	0	1120
10534	2	0	26	1074	0	1102
10535	1	1	3	1096	0	1101
10536	1076	0	1	31	0	1108
10537	24	1055	2	8	0	1089
10538	1052	24	2	4	0	1082
10539	25	3	2	1069	0	1099
10540	6	1	1060	27	0	1094
10541	2	1065	21	8	0	1096
10542	1036	22	8	5	0	1071
10543	23	1022	3	5	0	1053
10544	5	1057	1	4	0	1067
10545	1035	25	1	8	0	1069
10546	26	7	1	1111	0	1145
10547	1095	2	1	38	0	1136
10548	33	2	1	1062	0	1098
10549	6	1	1068	36	0	1111
10550	3	1	1059	13	0	1076
10551	1010	2	35	10	0	1057
10552	1073	0	8	6	0	1087
10553	33	3	4	1037	0	1077
10554	11	1	2	1045	0	1059
10555	997	3	1	41	0	1042
10556	30	988	5	11	0	1034
10557	9	1032	3	4	0	1048
10558	998	29	1	9	0	1037
10559	1023	11	5	2	0	1041
10560	33	1007	1	5	0	1046
10561	13	31	2	1008	0	1054
10562	5	8	994	37	0	1044
10563	4	5	1015	8	0	1032
10564	987	2	34	13	0	1036
10565	31	3	1011	8	0	1053
10566	10	2	29	978	0	1019
10567	5	4	6	981	0	996
10568	6	983	3	34	0	1026
10569	982	28	7	10	0	1027
10570	37	11	2	971	0	1021
10571	15	4	951	34	0	1004
10572	3	959	28	20	0	1010
10573	4	30	12	952	0	998
10574	10	6	953	32	0	1001
10575	11	4	935	8	0	958
10576	4	920	31	8	0	963
10577	829	26	5	11	0	871
10578	28	860	5	6	0	899
10579	849	27	6	5	0	887
10580	27	8	845	6	0	886
10581	813	2	27	9	0	851
10582	27	835	10	5	0	877
10583	11	24	4	838	0	877
10584	5	8	6	864	0	883
10585	846	1	5	36	0	888
10586	23	6	834	16	0	879
10587	831	5	26	11	0	873
10588	854	4	8	9	0	875
10589	33	7	817	13	0	870
10590	11	8	854	5	0	878
10591	3	4	30	822	0	859
10592	823	6	14	32	0	875
10593	839	6	5	13	0	863
10594	32	837	4	9	0	882
10595	14	33	7	826	0	880
10596	3	11	7	842	0	863
10597	11	6	4	857	0	878
10598	9	7	6	861	0	883
10599	835	2	5	37	0	879
10600	28	8	5	849	0	890
10601	11	10	835	28	0	884
10602	11	5	838	14	0	868
10603	795	6	28	13	0	842
10604	37	817	14	2	0	870
10605	11	841	7	10	0	869
10606	6	29	6	833	0	874
10607	8	9	8	852	0	877
10608	10	4	8	837	0	859
10609	12	7	9	853	0	881
10610	9	5	838	38	0	890
10611	13	6	27	836	0	882
10612	12	13	7	854	0	886
10613	5	5	819	42	0	871
10614	779	5	28	15	0	827
10615	30	826	14	6	0	876
10616	780	20	3	16	0	819
10617	27	9	728	6	0	770
10618	17	2	707	7	0	733
10619	5	676	29	10	0	720
10620	595	34	47	5	0	681
10621	544	8	7	7	0	566
10622	546	3	4	6	0	559
10623	23	523	4	6	0	556
10624	511	11	3	9	0	534
10625	15	8	518	5	0	546
10626	9	508	14	16	0	547
10627	504	11	5	6	0	526
10628	16	507	1	4	0	528
10629	476	7	3	3	0	489
10630	457	4	3	5	0	469
10631	11	2	473	5	0	491
10632	8	476	9	1	0	494
10633	468	9	7	3	0	487
10634	12	5	481	1	0	499
10635	4	485	11	5	0	505
10636	2	10	6	471	0	489
10637	3	7	478	11	0	499
10638	0	1	472	7	0	480
10639	2	4	14	448	0	468
10640	459	0	5	11	0	475
10641	9	447	4	9	0	469
10642	6	9	455	0	0	470
10643	2	3	443	1	0	449
10644	415	6	16	2	0	439
10645	9	463	6	1	0	479
10646	394	2	0	2	0	398
10647	3	382	0	1	0	386
10648	401	3	0	0	0	404
10649	381	2	0	2	0	385
10650	3	380	2	1	0	386
10651	1	3	1	386	0	391
10652	410	1	3	3	0	417
10653	2	0	1	411	0	414
10654	2	0	1	449	0	452
10655	456	0	0	7	0	463
10656	3	461	1	1	0	466
10657	473	2	1	2	0	478
10658	2	1	476	0	0	479
10659	1	1	3	483	0	488
10660	1	0	2	470	0	473
10661	467	1	1	4	0	473
10662	481	0	0	4	0	485
10663	4	1	0	476	0	481
10664	3	2	501	3	0	509
10665	2	0	4	491	0	497
10666	0	1	2	490	0	493
10667	2	0	0	494	0	496
10668	2	0	1	489	0	492
10669	494	0	0	5	0	499
10670	3	4	480	2	0	489
10671	5	479	2	2	0	488
10672	5	3	2	482	0	492
10673	1	2	3	497	0	503
10674	0	3	500	4	0	507
10675	5	0	489	3	0	497
10676	0	0	5	504	0	509
10677	4	2	2	509	0	517
10678	4	1	508	6	0	519
10679	3	3	6	490	0	502
10680	497	1	6	4	0	508
10681	2	523	0	11	0	536
10682	7	2	522	2	0	533
10683	1	527	2	3	0	533
10684	1	3	4	533	0	541
10685	2	1	541	3	0	547
10686	2	535	4	2	0	543
10687	1	3	2	532	0	538
10688	3	1	536	4	0	544
10689	1	3	1	540	0	545
10690	3	0	3	536	0	542
10691	539	1	2	5	0	547
10692	2	2	0	540	0	544
10693	543	0	2	6	0	551
10694	515	3	2	2	0	522
10695	505	0	1	6	0	512
10696	3	0	1	509	0	513
10697	3	0	498	4	0	505
10698	0	2	480	4	0	486
10699	495	0	3	1	0	499
10700	2	0	497	3	0	502
10701	473	2	2	3	0	480
10702	2	488	1	6	0	497
10703	496	4	2	2	0	504
10704	3	3	502	2	0	510
10705	1	0	523	5	0	529
10706	2	12	6	504	0	524
10707	1	2	562	6	0	571
10708	1	0	565	6	0	572
10709	2	1	7	593	0	603
10710	2	2	4	608	0	616
10711	4	1	2	623	0	630
10712	2	618	5	11	0	636
10713	2	12	2	616	0	632
10714	1	638	1	13	0	653
10715	626	8	3	8	0	645
10716	634	6	1	3	0	644
10717	14	0	4	604	0	622
10718	4	610	2	12	0	628
10719	4	7	640	12	0	663
10720	633	5	16	3	0	657
10721	15	1	5	642	0	663
10722	9	2	1	641	0	653
10723	4	3	3	653	0	663
10724	632	0	3	19	0	654
10725	14	616	1	10	0	641
10726	6	649	5	2	0	662
10727	617	14	5	6	0	642
10728	16	623	4	4	0	647
10729	626	13	2	5	0	646
10730	633	4	3	6	0	646
10731	18	615	1	4	0	638
10732	5	13	2	597	0	617
10733	3	617	3	11	0	634
10734	4	14	4	610	0	632
10735	2	7	2	645	0	656
10736	652	1	4	22	0	679
10737	677	5	3	5	0	690
10738	19	0	5	675	0	699
10739	4	2	663	18	0	687
10740	650	0	17	11	0	678
10741	18	651	3	9	0	681
10742	5	15	4	664	0	688
10743	2	8	1	673	0	684
10744	4	2	3	671	0	680
10745	648	7	2	21	0	678
10746	661	2	1	14	0	678
10747	17	635	2	8	0	662
10748	9	640	3	4	0	656
10749	8	23	1	626	0	658
10750	3	7	1	649	0	660
10751	5	5	639	20	0	669
10752	2	3	18	624	0	647
10753	6	3	607	23	0	639
10754	1	4	575	11	0	591
10755	5	554	20	9	0	588
10756	8	18	5	547	0	578
10757	557	5	2	20	0	584
10758	17	6	2	560	0	585
10759	6	4	557	18	0	585
10760	541	3	16	8	0	568
10761	564	3	4	5	0	576
10762	22	4	539	3	0	568
10763	9	3	16	550	0	578
10764	524	4	4	18	0	550
10765	24	520	2	7	0	553
10766	542	22	2	7	0	573
10767	560	5	1	6	0	572
10768	23	5	2	543	0	573
10769	9	4	0	570	0	583
10770	567	2	4	21	0	594
10771	25	1	0	568	0	594
10772	5	5	560	24	0	594
10773	546	3	18	9	0	576
10774	562	2	4	11	0	579
10775	20	539	5	11	0	575
10776	11	540	2	4	0	557
10777	9	20	0	516	0	545
10778	4	540	2	20	0	566
10779	6	22	2	535	0	565
10780	528	5	1	25	0	559
10781	519	7	2	8	0	536
10782	22	498	3	6	0	529
10783	493	19	1	9	0	522
10784	23	501	7	2	0	533
10785	495	21	3	5	0	524
10786	508	6	2	3	0	519
10787	20	5	486	7	0	518
10788	485	6	17	3	0	511
10789	24	467	3	9	0	503
10790	5	497	8	5	0	515
10791	498	20	4	4	0	526
10792	27	7	3	483	0	520
10793	7	5	479	22	0	513
10794	6	2	18	479	0	505
10795	7	2	6	499	0	514
10796	2	6	483	26	0	517
10797	470	3	19	7	0	499
10798	22	481	2	8	0	513
10799	469	17	5	9	0	500
10800	27	5	2	471	0	505
10801	489	6	0	19	0	514
10802	24	485	0	9	0	518
10803	10	18	5	478	0	511
10804	479	3	0	26	0	508
10805	22	4	447	5	0	478
10806	9	3	435	5	0	452
10807	394	5	20	4	0	423
10808	18	391	7	6	0	422
10809	2	347	3	4	0	356
10810	6	11	1	329	0	347
10811	3	339	4	11	0	357
10812	2	14	1	338	0	355
10813	3	2	1	346	0	352
10814	3	4	1	334	0	342
10815	2	325	1	12	0	340
10816	2	11	0	326	0	339
10817	3	2	312	12	0	329
10818	0	311	11	4	0	326
10819	1	5	1	254	0	261
10820	0	263	2	4	0	269
10821	260	9	0	3	0	272
10822	265	0	1	6	0	272
10823	263	3	2	2	0	270
10824	9	267	3	1	0	280
10825	5	5	1	266	0	277
10826	7	1	258	9	0	275
10827	1	3	263	3	0	270
10828	241	0	8	8	0	257
10829	260	2	4	2	0	268
10830	9	1	3	253	0	266
10831	3	2	2	271	0	278
10832	6	0	271	8	0	285
10833	3	272	6	4	0	285
10834	2	274	0	8	0	284
10835	3	13	248	3	0	267
10836	4	7	8	224	0	243
10837	1	3	2	202	0	208
10838	3	2	3	223	0	231
10839	5	2	0	226	0	233
10840	230	2	0	5	0	237
10841	7	1	217	2	0	227
10842	220	5	4	2	0	231
10843	8	1	0	224	0	233
10844	225	3	3	3	0	234
10845	8	1	2	222	0	233
10846	5	1	231	5	0	242
10847	5	0	4	231	0	240
10848	1	3	238	6	0	248
10849	3	2	5	234	0	244
10850	2	2	246	7	0	257
10851	2	237	7	1	0	247
10852	3	3	1	240	0	247
10853	0	2	3	240	0	245
10854	2	237	1	6	0	246
10855	241	4	0	4	0	249
10856	5	1	1	243	0	250
10857	3	3	1	232	0	239
10858	233	1	0	7	0	241
10859	233	0	2	3	0	238
10860	242	1	2	5	0	250
10861	246	1	0	4	0	251
10862	7	2	238	1	0	248
10863	247	0	3	3	0	253
10864	256	2	1	1	0	260
10865	7	0	2	248	0	257
10866	1	1	2	245	0	249
10867	243	0	0	6	0	249
10868	4	240	1	2	0	247
10869	1	2	0	232	0	235
10870	0	1	243	3	0	247
10871	0	235	3	0	0	238
10872	225	1	0	0	0	226
10873	227	0	0	0	0	227
10874	225	0	0	0	0	225
10875	226	0	0	0	0	226
10876	1	0	0	224	0	225
10877	0	0	224	1	0	225
10878	0	1	234	0	0	235
10879	0	0	2	258	0	260
10880	268	0	0	2	0	270
10881	2	0	0	271	0	273
10882	0	0	271	2	0	273
10883	277	0	2	1	0	280
10884	273	0	0	0	0	273
10885	2	0	0	279	0	281
10886	2	0	287	2	0	291
10887	0	0	285	0	0	285
10888	271	0	2	1	0	274
10889	2	283	0	0	0	285
10890	0	2	286	0	0	288
10891	0	0	2	280	0	282
10892	281	0	0	2	0	283
10893	2	272	0	0	0	274
10894	0	280	0	0	0	280
10895	277	2	0	0	0	279
10896	2	0	0	285	0	287
10897	319	0	0	3	0	322
10898	3	0	0	323	0	326
10899	0	0	0	334	0	334
10900	0	0	327	3	0	330
10901	0	0	305	0	0	305
10902	0	0	335	0	0	335
10903	0	0	5	339	0	344
10904	340	0	0	7	0	347
10905	5	0	342	0	0	347
10906	0	0	6	340	0	346
10907	0	2	344	5	0	351
10908	1	353	4	0	0	358
10909	0	5	0	349	0	354
10910	0	0	1	354	0	355
10911	1	0	0	351	0	352
10912	346	0	0	6	0	352
10913	6	0	0	348	0	354
10914	1	0	1	352	0	354
10915	346	0	2	4	0	352
10916	6	0	344	0	0	350
10917	340	1	5	1	0	347
10918	348	0	1	0	0	349
10919	5	0	346	1	0	352
10920	337	1	5	3	0	346
10921	5	1	1	348	0	355
10922	0	2	355	4	0	361
10923	359	0	4	3	0	366
10924	371	0	0	2	0	373
10925	5	0	0	370	0	375
10926	0	0	0	374	0	374
10927	2	0	0	374	0	376
10928	363	0	1	6	0	370
10929	6	368	1	0	0	375
10930	359	4	2	0	0	365
10931	6	345	0	1	0	352
10932	2	340	0	0	0	342
10933	0	7	2	340	0	349
10934	1	1	3	343	0	348
10935	0	1	0	340	0	341
10936	0	1	1	339	0	341
10937	1	0	340	5	0	346
10938	336	0	4	1	0	341
10939	5	0	0	338	0	343
10940	1	0	347	4	0	352
10941	1	0	4	349	0	354
10942	1	1	0	357	0	359
10943	1	1	363	4	0	369
10944	1	0	5	358	0	364
10945	1	1	0	355	0	357
10946	353	1	0	6	0	360
10947	6	0	357	1	0	364
10948	335	0	4	2	0	341
10949	4	361	0	2	0	367
10950	352	4	1	2	0	359
10951	354	0	1	0	0	355
10952	7	0	0	349	0	356
10953	0	0	349	7	0	356
10954	0	372	6	1	0	379
10955	0	7	1	360	0	368
10956	1	396	0	5	0	402
10957	402	7	1	0	0	410
10958	8	0	400	1	0	409
10959	0	1	403	1	0	405
10960	1	1	6	384	0	392
10961	0	0	406	8	0	414
10962	1	0	7	415	0	423
10963	0	1	0	405	0	406
10964	408	0	0	8	0	416
10965	7	407	1	0	0	415
10966	3	7	0	413	0	423
10967	0	0	1	424	0	425
10968	0	1	1	418	0	420
10969	0	401	2	9	0	412
10970	0	405	1	1	0	407
10971	404	6	3	0	0	413
10972	418	0	1	4	0	423
10973	413	0	1	2	0	416
10974	7	0	409	1	0	417
10975	1	0	7	407	0	415
10976	1	0	405	8	0	414
10977	0	405	7	1	0	413
10978	386	6	3	2	0	397
10979	6	1	380	2	0	389
10980	1	0	6	368	0	375
10981	3	0	377	7	0	387
10982	367	0	6	4	0	377
10983	369	1	0	2	0	372
10984	372	1	0	0	0	373
10985	359	0	2	1	0	362
10986	9	0	373	0	0	382
10987	367	0	5	0	0	372
10988	370	0	2	2	0	374
10989	8	368	0	1	0	377
10990	363	6	1	1	0	371
10991	371	0	2	0	0	373
10992	9	0	0	352	0	361
10993	2	365	1	3	0	371
10994	371	6	0	2	0	379
10995	400	0	1	1	0	402
10996	8	0	451	2	0	461
10997	1	0	427	0	0	428
10998	0	0	445	0	0	445
10999	1	1	13	433	0	448
11000	431	8	4	9	0	452
11001	11	450	3	0	0	464
11002	420	8	1	3	0	432
11003	11	428	0	1	0	440
11004	430	11	0	0	0	441
11005	11	432	0	0	0	443
11006	1	451	1	0	0	453
11007	434	9	0	1	0	444
11008	8	443	0	0	0	451
11009	0	11	0	440	0	451
11010	3	1	446	8	0	458
11011	1	3	458	0	0	462
11012	0	1	9	451	0	461
11013	1	0	3	460	0	464
11014	0	0	462	10	0	472
11015	1	0	11	453	0	465
11016	0	0	1	478	0	479
11017	470	0	4	11	0	485
11018	10	467	2	3	0	482
11019	0	11	0	453	0	464
11020	6	486	0	9	0	501
11021	485	14	3	0	0	502
11022	11	484	3	1	0	499
11023	480	13	3	1	0	497
11024	481	1	0	3	0	485
11025	15	4	0	472	0	491
11026	3	4	2	471	0	480
11027	8	0	3	478	0	489
11028	3	3	3	478	0	487
11029	4	0	463	18	0	485
11030	441	2	12	5	0	460
11031	12	467	1	4	0	484
11032	4	12	3	483	0	502
11033	4	5	1	484	0	494
11034	3	487	1	13	0	504
11035	483	13	3	4	0	503
11036	10	488	4	4	0	506
11037	3	13	1	488	0	505
11038	4	4	1	496	0	505
11039	2	4	3	499	0	508
11040	0	2	2	493	0	497
11041	471	1	3	19	0	494
11042	16	1	472	6	0	495
11043	1	4	14	457	0	476
11044	6	0	4	474	0	484
11045	1	4	5	475	0	485
11046	4	1	1	478	0	484
11047	457	3	2	19	0	481
11048	17	3	455	6	0	481
11049	4	2	12	432	0	450
11050	6	421	2	15	0	444
11051	4	457	4	3	0	468
11052	444	15	1	9	0	469
11053	16	4	441	4	0	465
11054	413	7	12	0	0	432
11055	16	2	438	5	0	461
11056	3	3	12	404	0	422
11057	423	1	4	16	0	444
11058	10	428	4	8	0	450
11059	0	11	6	417	0	434
11060	8	405	4	13	0	430
11061	415	17	2	3	0	437
11062	415	4	3	7	0	429
11063	13	3	3	411	0	430
11064	5	7	401	15	0	428
11065	8	1	394	9	0	412
11066	7	4	9	394	0	414
11067	3	398	6	9	0	416
11068	2	11	5	414	0	432
11069	2	5	2	412	0	421
11070	5	3	0	397	0	405
11071	3	5	401	18	0	427
11072	7	1	12	390	0	410
11073	2	1	3	411	0	417
11074	2	402	3	19	0	426
11075	1	13	6	384	0	404
11076	1	4	3	423	0	431
11077	6	3	2	421	0	432
11078	2	2	4	421	0	429
11079	4	1	3	415	0	423
11080	2	4	4	414	0	424
11081	3	5	1	405	0	414
11082	7	2	1	397	0	407
11083	2	7	380	15	0	404
11084	3	3	11	385	0	402
11085	383	6	3	16	0	408
11086	14	0	4	372	0	390
11087	7	2	390	16	0	415
11088	385	3	11	7	0	406
11089	397	1	3	11	0	412
11090	395	3	6	6	0	410
11091	400	4	3	6	0	413
11092	15	4	1	401	0	421
11093	6	1	375	17	0	399
11094	7	369	13	6	0	395
11095	2	354	3	8	0	367
11096	2	10	11	281	0	304
11097	0	1	1	286	0	288
11098	1	1	1	274	0	277
11099	1	1	0	283	0	285
11100	0	1	0	326	0	327
11101	389	0	0	9	0	398
11102	9	392	1	3	0	405
11103	1	402	0	3	0	406
11104	3	13	1	398	0	415
11105	0	2	1	405	0	408
11106	0	2	0	398	0	400
11107	0	3	0	389	0	392
11108	1	0	371	16	0	388
11109	2	368	9	5	0	384
11110	1	8	1	366	0	376
11111	354	3	1	8	0	366
11112	7	2	1	357	0	367
11113	1	1	363	11	0	376
11114	2	0	351	3	0	356
11115	1	0	366	5	0	372
11116	0	0	11	359	0	370
11117	368	1	3	8	0	380
11118	7	0	3	369	0	379
11119	2	0	2	377	0	381
11120	358	2	0	10	0	370
11121	8	0	1	361	0	370
11122	2	0	2	364	0	368
11123	2	0	389	8	0	399
11124	1	383	8	4	0	396
11125	1	7	2	400	0	410
11126	395	1	3	11	0	410
11127	9	2	1	395	0	407
11128	3	0	394	10	0	407
11129	3	2	7	391	0	403
11130	0	397	1	9	0	407
11131	2	7	3	405	0	417
11132	0	2	402	10	0	414
11133	0	429	7	4	0	440
11134	1	8	2	433	0	444
11135	2	1	2	481	0	486
11136	1	3	2	495	0	501
11137	1	2	1	505	0	509
11138	0	3	481	22	0	506
11139	0	487	15	10	0	512
11140	487	14	2	10	0	513
11141	499	4	4	3	0	510
11142	15	3	3	497	0	518
11143	4	2	503	16	0	525
11144	497	2	15	5	0	519
11145	17	0	3	506	0	526
11146	3	0	540	19	0	562
11147	4	1	17	536	0	558
11148	7	1	4	549	0	561
11149	2	0	6	552	0	560
11150	3	1	537	21	0	562
11151	3	1	13	520	0	537
11152	3	531	4	20	0	558
11153	532	14	5	9	0	560
11154	531	4	4	5	0	544
11155	532	3	1	4	0	540
11156	21	513	0	6	0	540
11157	513	14	3	6	0	536
11158	17	2	3	493	0	515
11159	498	3	1	18	0	520
11160	510	2	0	4	0	516
11161	19	1	497	5	0	522
11162	7	491	16	6	0	520
11163	496	14	3	2	0	515
11164	18	3	5	504	0	530
11165	5	7	500	16	0	528
11166	5	499	16	7	0	527
11167	489	17	7	7	0	520
11168	17	1	3	498	0	519
11169	6	4	4	511	0	525
11170	6	3	2	511	0	522
11171	5	502	1	20	0	528
11172	3	13	3	501	0	520
11173	1	489	5	22	0	517
11174	4	18	1	498	0	521
11175	7	5	502	21	0	535
11176	3	5	18	501	0	527
11177	2	5	5	526	0	538
11178	6	1	4	539	0	550
11179	3	2	523	28	0	556
11180	2	3	20	514	0	539
11181	2	2	5	543	0	552
11182	4	4	5	540	0	553
11183	2	0	5	547	0	554
11184	2	2	5	547	0	556
11185	4	1	523	30	0	558
11186	2	4	17	523	0	546
11187	4	2	6	519	0	531
11188	494	4	5	25	0	528
11189	20	480	4	11	0	515
11190	8	511	3	13	0	535
11191	8	16	3	510	0	537
11192	9	6	2	520	0	537
11193	4	502	2	24	0	532
11194	6	16	5	514	0	541
11195	3	506	2	28	0	539
11196	6	19	4	516	0	545
11197	8	11	1	524	0	544
11198	5	7	495	23	0	530
11199	5	491	17	13	0	526
11200	5	462	2	11	0	480
11201	375	12	4	6	0	397
11202	11	379	4	4	0	398
11203	3	15	1	374	0	393
11204	4	5	363	11	0	383
11205	4	4	8	363	0	379
11206	360	1	3	17	0	381
11207	11	1	375	6	0	393
11208	4	381	9	4	0	398
11209	7	9	4	344	0	364
11210	2	7	1	397	0	407
11211	406	2	3	15	0	426
11212	9	5	2	415	0	431
11213	3	0	3	419	0	425
11214	1	3	1	420	0	425
11215	4	1	0	415	0	420
11216	395	0	3	18	0	416
11217	398	2	3	10	0	413
11218	11	1	1	401	0	414
11219	395	2	1	16	0	414
11220	11	0	1	397	0	409
11221	3	2	385	15	0	405
11222	1	2	373	8	0	384
11223	2	4	11	341	0	358
11224	0	347	3	15	0	365
11225	0	9	2	350	0	361
11226	347	2	1	14	0	364
11227	9	4	1	343	0	357
11228	355	2	0	16	0	373
11229	8	1	0	372	0	381
11230	2	2	360	15	0	379
11231	2	346	9	7	0	364
11232	2	365	1	6	0	374
11233	0	8	2	328	0	338
11234	2	2	335	9	0	348
11235	0	295	2	1	0	298
11236	3	2	5	273	0	283
11237	270	0	0	0	0	270
11238	0	0	280	0	0	280
11239	0	0	0	274	0	274
11240	0	0	0	286	0	286
11241	0	0	284	0	0	284
11242	0	0	266	1	0	267
11243	0	0	279	0	0	279
11244	0	0	0	292	0	292
11245	0	0	305	0	0	305
11246	271	0	0	0	0	271
11247	2	0	0	309	0	311
11248	1	0	372	2	0	375
11249	1	373	2	1	0	377
11250	0	2	391	1	0	394
11251	0	2	4	386	0	392
11252	395	1	3	3	0	402
11253	3	1	0	400	0	404
11254	2	0	2	401	0	405
11255	434	1	0	7	0	442
11256	4	0	1	439	0	444
11257	2	0	436	5	0	443
11258	435	0	3	3	0	441
11259	5	448	2	2	0	457
11260	453	4	1	3	0	461
11261	6	2	1	447	0	456
11262	3	1	440	5	0	449
11263	1	1	437	3	0	442
11264	2	3	6	427	0	438
11265	0	1	4	440	0	445
11266	2	0	443	7	0	452
11267	1	0	422	3	0	426
11268	433	0	8	3	0	444
11269	5	0	4	435	0	444
11270	437	0	2	6	0	445
11271	5	0	1	437	0	443
11272	3	0	464	6	0	473
11273	3	0	474	3	0	480
11274	2	1	7	495	0	505
11275	1	0	3	491	0	495
11276	1	0	499	8	0	508
11277	482	0	9	3	0	494
11278	6	0	4	495	0	505
11279	519	0	2	8	0	529
11280	7	612	1	4	0	624
11281	3	8	1	637	0	649
11282	641	2	2	14	0	659
11283	13	1	651	3	0	668
11284	3	2	10	660	0	675
11285	3	0	2	656	0	661
11286	2	0	3	675	0	680
11287	2	0	666	14	0	682
11288	1	1	11	651	0	664
11289	2	671	3	14	0	690
11290	0	11	2	667	0	680
11291	2	1	667	12	0	682
11292	2	1	656	6	0	665
11293	2	1	15	651	0	669
11294	0	1	3	655	0	659
11295	1	1	6	661	0	669
11296	1	0	5	669	0	675
11297	659	0	3	15	0	677
11298	653	1	4	6	0	664
11299	13	2	652	7	0	674
11300	4	664	13	5	0	686
11301	3	9	7	677	0	696
11302	693	4	6	11	0	714
11303	626	4	2	12	0	644
11304	696	4	0	9	0	709
11305	703	1	6	5	0	715
11306	17	1	702	5	0	725
11307	675	0	13	5	0	693
11308	13	674	5	5	0	697
11309	5	13	5	682	0	705
11310	4	3	687	18	0	712
11311	5	3	12	674	0	694
11312	3	2	679	12	0	696
11313	4	1	15	665	0	685
11314	2	2	8	689	0	701
11315	685	1	3	19	0	708
11316	15	0	7	693	0	715
11317	4	4	688	18	0	714
11318	4	2	12	707	0	725
11319	707	1	3	18	0	729
11320	15	0	6	720	0	741
11321	3	0	725	18	0	746
11322	4	707	14	11	0	736
11323	733	12	4	13	0	762
11324	16	4	5	720	0	745
11325	7	746	4	17	0	774
11326	744	15	6	7	0	772
11327	18	3	739	7	0	767
11328	4	715	15	6	0	740
11329	8	13	7	726	0	754
11330	6	5	728	18	0	757
11331	1	3	15	718	0	737
11332	717	2	7	16	0	742
11333	13	2	703	15	0	733
11334	8	2	14	698	0	722
11335	6	1	701	20	0	728
11336	6	0	20	695	0	721
11337	3	6	11	709	0	729
11338	715	3	3	23	0	744
11339	12	735	7	15	0	769
11340	7	11	2	746	0	766
11341	731	1	5	16	0	753
11342	728	2	4	7	0	741
11343	15	3	6	714	0	738
11344	10	690	4	17	0	721
11345	6	727	6	6	0	745
11346	5	17	1	701	0	724
11347	3	6	3	685	0	697
11348	621	2	2	14	0	639
11349	8	2	6	617	0	633
11350	2	3	613	15	0	633
11351	571	1	7	11	0	590
11352	13	600	6	2	0	621
11353	606	7	0	9	0	622
11354	11	1	624	4	0	640
11355	3	620	11	6	0	640
11356	625	8	1	8	0	642
11357	631	3	3	6	0	643
11358	10	1	625	3	0	639
11359	615	3	9	6	0	633
11360	626	1	4	1	0	632
11361	11	637	0	4	0	652
11362	5	11	2	659	0	677
11363	10	4	658	7	0	679
11364	4	3	11	650	0	668
11365	2	6	660	12	0	680
11366	1	4	8	663	0	676
11367	665	3	9	11	0	688
11368	9	0	2	700	0	711
11369	5	0	759	12	0	776
11370	780	0	16	6	0	802
11371	17	0	4	826	0	847
11372	4	0	805	18	0	827
11373	767	0	22	8	0	797
11374	17	2	6	783	0	808
11375	7	0	779	21	0	807
11376	4	3	776	9	0	792
11377	5	10	22	758	0	795
11378	7	2	779	21	0	809
11379	5	740	20	5	0	770
11380	1	12	7	642	0	662
11381	645	4	6	12	0	667
11382	14	3	636	6	0	659
11383	4	2	631	4	0	641
11384	598	2	16	5	0	621
11385	15	1	635	2	0	653
11386	603	0	14	3	0	620
11387	14	0	635	1	0	650
11388	10	0	16	620	0	646
11389	5	0	633	12	0	650
11390	3	0	15	629	0	647
11391	1	2	646	14	0	663
11392	1	1	653	7	0	662
11393	610	0	16	5	0	631
11394	11	649	9	4	0	673
11395	651	13	7	1	0	672
11396	16	658	5	2	0	681
11397	7	13	5	657	0	682
11398	5	7	3	673	0	688
11399	668	5	2	17	0	692
11400	13	2	1	679	0	695
11401	6	1	668	17	0	692
11402	641	0	13	13	0	667
11403	659	0	10	3	0	672
11404	19	0	5	655	0	679
11405	7	0	670	13	0	690
11406	9	1	11	653	0	674
11407	4	647	8	13	0	672
11408	3	11	3	658	0	675
11409	2	6	5	663	0	676
11410	0	3	650	23	0	676
11411	593	2	15	9	0	619
11412	12	640	7	9	0	668
11413	640	11	6	5	0	662
11414	14	655	4	4	0	677
11415	11	15	3	641	0	670
11416	3	657	1	14	0	675
11417	4	14	642	7	0	667
11418	3	5	12	609	0	629
11419	3	3	9	626	0	641
11420	4	2	3	649	0	658
11421	619	2	5	21	0	647
11422	13	0	5	625	0	643
11423	603	1	4	15	0	623
11424	605	1	1	13	0	620
11425	610	0	7	6	0	623
11426	21	2	597	4	0	624
11427	10	3	11	603	0	627
11428	6	2	9	631	0	648
11429	8	2	4	645	0	659
11430	663	1	6	25	0	695
11431	15	0	6	674	0	695
11432	9	4	6	690	0	709
11433	726	1	3	26	0	756
11434	17	3	3	753	0	776
11435	12	2	792	20	0	826
11436	5	3	798	16	0	822
11437	8	0	21	800	0	829
11438	778	1	13	19	0	811
11439	743	0	12	13	0	768
11440	24	0	6	748	0	778
11441	11	4	743	18	0	776
11442	9	745	14	13	0	781
11443	9	10	9	752	0	780
11444	3	8	5	770	0	786
11445	6	3	8	763	0	780
11446	749	2	4	24	0	779
11447	15	2	748	18	0	783
11448	740	1	16	12	0	769
11449	21	1	9	722	0	753
11450	15	726	4	14	0	759
11451	728	12	6	16	0	762
11452	728	8	4	8	0	748
11453	23	4	735	9	0	771
11454	12	691	14	12	0	729
11455	13	699	11	3	0	726
11456	689	17	6	10	0	722
11457	16	8	7	680	0	711
11458	12	8	4	695	0	719
11459	12	5	2	683	0	702
11460	7	660	1	27	0	695
11461	6	680	3	13	0	702
11462	652	18	1	10	0	681
11463	12	13	2	649	0	676
11464	6	7	705	15	0	733
11465	8	3	13	733	0	757
11466	5	5	795	22	0	827
11467	7	1	782	13	0	803
11468	8	2	770	8	0	788
11469	0	666	29	8	0	703
11470	4	20	18	617	0	659
11471	3	631	9	9	0	652
11472	1	16	3	570	0	590
11473	3	12	2	624	0	641
11474	618	5	0	21	0	644
11475	11	3	2	624	0	640
11476	608	1	2	23	0	634
11477	615	1	3	14	0	633
11478	23	2	1	596	0	622
11479	12	597	2	20	0	631
11480	6	15	3	584	0	608
11481	5	601	4	17	0	627
11482	1	15	3	599	0	618
11483	4	11	589	17	0	621
11484	2	3	11	592	0	608
11485	5	5	9	594	0	613
11486	568	0	9	24	0	601
11487	15	572	6	21	0	614
11488	12	12	3	581	0	608
11489	8	9	0	580	0	597
11490	6	576	1	20	0	603
11491	4	15	1	580	0	600
11492	522	10	4	25	0	561
11493	556	6	0	18	0	580
11494	21	544	4	11	0	580
11495	14	14	2	557	0	587
11496	536	8	1	17	0	562
11497	21	541	3	11	0	576
11498	11	18	2	515	0	546
11499	7	545	2	18	0	572
11500	528	17	4	13	0	562
11501	14	17	519	7	0	557
11502	12	6	519	7	0	544
11503	11	4	21	522	0	558
11504	7	1	523	21	0	552
11505	4	4	20	515	0	543
11506	505	9	11	20	0	545
11507	21	2	535	14	0	572
11508	9	6	16	533	0	564
11509	9	3	10	558	0	580
11510	549	5	6	23	0	583
11511	16	542	8	15	0	581
11512	556	13	4	11	0	584
11513	557	10	8	9	0	584
11514	24	537	1	9	0	571
11515	17	14	5	527	0	563
11516	9	10	533	16	0	568
11517	10	6	12	529	0	557
11518	3	536	11	20	0	570
11519	541	14	6	15	0	576
11520	15	12	4	554	0	585
11521	16	7	569	16	0	608
11522	9	9	13	578	0	609
11523	6	3	11	586	0	606
11524	4	4	7	598	0	613
11525	3	4	5	599	0	611
11526	4	3	6	586	0	599
11527	3	3	563	32	0	601
11528	13	5	538	18	0	574
11529	1	513	18	18	0	550
11530	5	512	11	10	0	538
11531	497	15	5	10	0	527
11532	15	10	504	5	0	534
11533	453	3	17	5	0	478
11534	15	2	443	5	0	465
11535	8	0	385	4	0	397
11536	5	0	18	374	0	397
11537	395	1	10	14	0	420
11538	11	3	6	408	0	428
11539	6	1	3	415	0	425
11540	4	2	442	20	0	468
11541	3	1	13	450	0	467
11542	1	0	8	453	0	462
11543	0	1	5	468	0	474
11544	1	1	3	470	0	475
11545	3	0	2	466	0	471
11546	453	1	2	22	0	478
11547	11	0	0	462	0	473
11548	6	0	452	18	0	476
11549	3	1	12	459	0	475
11550	3	0	452	17	0	472
11551	3	6	14	450	0	473
11552	3	1	457	15	0	476
11553	3	2	12	436	0	453
11554	1	1	7	481	0	490
11555	2	1	469	20	0	492
11556	432	1	14	9	0	456
11557	12	0	493	5	0	510
11558	4	2	12	489	0	507
11559	497	1	4	12	0	514
11560	15	0	2	506	0	523
11561	5	0	4	511	0	520
11562	1	1	508	19	0	529
11563	2	493	12	9	0	516
11564	1	443	5	6	0	455
11565	1	454	1	5	0	461
11566	7	4	1	373	0	385
11567	384	0	0	1	0	385
11568	4	0	0	380	0	384
11569	0	0	0	382	0	382
11570	0	0	1	389	0	390
11571	0	0	0	392	0	392
11572	0	393	0	2	0	395
11573	0	0	0	396	0	396
11574	0	1	0	394	0	395
11575	0	392	0	1	0	393
11576	408	0	0	2	0	410
11577	0	1	0	408	0	409
11578	409	0	0	0	0	409
11579	408	0	0	1	0	409
11580	1	415	0	0	0	416
11581	1	2	0	433	0	436
11582	0	1	432	1	0	434
11583	0	0	428	2	0	430
11584	0	0	1	433	0	434
11585	443	0	1	0	0	444
11586	464	0	0	1	0	465
11587	1	0	0	467	0	468
11588	470	0	0	2	0	472
11589	0	469	0	2	0	471
11590	462	0	0	1	0	463
11591	0	512	0	0	0	512
11592	1	0	0	527	0	528
11593	0	1	0	514	0	515
11594	0	520	0	1	0	521
11595	509	0	0	1	0	510
11596	0	2	504	1	0	507
11597	2	0	1	514	0	517
11598	1	0	523	0	0	524
11599	0	1	0	516	0	517
11600	527	0	1	1	0	529
11601	0	0	1	528	0	529
11602	524	0	1	0	0	525
11603	522	0	0	2	0	524
11604	2	0	0	521	0	523
11605	2	0	540	0	0	542
11606	0	550	0	1	0	551
11607	1	0	1	536	0	538
11608	533	2	0	0	0	535
11609	1	0	526	1	0	528
11610	1	1	0	509	0	511
11611	0	0	1	520	0	521
11612	0	0	0	533	0	533
11613	534	1	0	1	0	536
11614	1	0	0	524	0	525
11615	1	0	1	535	0	537
11616	0	0	527	2	0	529
11617	0	0	2	521	0	523
11618	0	0	1	528	0	529
11619	2	0	0	533	0	535
11620	1	526	0	3	0	530
11621	1	0	0	506	0	507
11622	2	1	0	507	0	510
11623	515	1	0	2	0	518
11624	1	0	516	1	0	518
11625	1	3	497	0	0	501
11626	0	511	1	2	0	514
11627	1	0	1	534	0	536
11628	526	2	1	0	0	529
11629	1	0	0	507	0	508
11630	1	0	0	513	0	514
11631	0	0	0	524	0	524
11632	1	0	1	505	0	507
11633	0	0	0	512	0	512
11634	0	0	508	2	0	510
11635	0	0	1	507	0	508
11636	502	0	1	1	0	504
11637	1	501	0	2	0	504
11638	1	0	0	507	0	508
11639	0	2	0	511	0	513
11640	0	1	483	3	0	487
11641	0	0	1	469	0	470
11642	2	5	1	483	0	491
11643	498	0	2	4	0	504
11644	2	511	0	4	0	517
11645	2	3	0	520	0	525
11646	0	2	0	529	0	531
11647	2	0	0	540	0	542
11648	0	0	541	6	0	547
11649	0	0	515	4	0	519
11650	0	531	7	1	0	539
11651	0	544	2	3	0	549
11652	4	6	0	528	0	538
11653	1	533	1	5	0	540
11654	0	7	0	589	0	596
11655	1	6	1	634	0	642
11656	0	3	0	678	0	681
11657	2	1	0	756	0	759
11658	1	0	763	31	0	795
11659	1	0	24	785	0	810
11660	0	1	9	797	0	807
11661	0	1	5	817	0	823
11662	777	1	3	39	0	820
11663	21	800	1	18	0	840
11664	11	26	1	760	0	798
11665	4	788	2	29	0	823
11666	768	32	0	16	0	816
11667	677	18	0	14	0	709
11668	26	782	1	13	0	822
11669	12	816	0	11	0	839
11670	6	32	771	7	0	816
11671	5	810	24	8	0	847
11672	2	33	9	792	0	836
11673	803	13	5	32	0	853
11674	23	836	3	16	0	878
11675	9	28	1	846	0	884
11676	9	12	1	857	0	879
11677	5	8	1	884	0	898
11678	850	10	2	40	0	902
11679	27	5	833	21	0	886
11680	819	3	25	13	0	860
11681	34	835	9	8	0	886
11682	14	30	4	831	0	879
11683	8	13	823	29	0	873
11684	788	10	30	14	0	842
11685	28	835	10	13	0	886
11686	13	27	7	800	0	847
11687	12	828	3	27	0	870
11688	8	33	1	845	0	887
11689	2	16	2	876	0	896
11690	2	7	839	46	0	894
11691	5	6	805	22	0	838
11692	6	4	39	799	0	848
11693	6	3	824	32	0	865
11694	6	5	34	806	0	851
11695	4	6	12	815	0	837
11696	1	3	10	852	0	866
11697	811	1	8	45	0	865
11698	31	4	5	829	0	869
11699	11	5	829	43	0	888
11700	836	6	29	17	0	888
11701	28	7	12	845	0	892
11702	12	3	7	871	0	893
11703	831	2	8	43	0	884
11704	34	858	7	19	0	918
11705	14	28	6	868	0	916
11706	8	10	10	874	0	902
11707	842	9	6	46	0	903
11708	31	6	827	31	0	895
11709	12	5	29	850	0	896
11710	15	5	11	852	0	883
11711	9	7	9	851	0	876
11712	5	824	9	49	0	887
11713	5	27	7	844	0	883
11714	830	11	4	45	0	890
11715	30	822	6	25	0	883
11716	826	31	2	20	0	879
11717	34	851	3	15	0	903
11718	848	34	7	12	0	901
11719	33	17	832	16	0	898
11720	20	6	841	17	0	884
11721	823	5	44	8	0	880
11722	34	5	849	11	0	899
11723	15	4	35	821	0	875
11724	10	4	14	769	0	797
11725	8	6	8	860	0	882
11726	815	5	7	56	0	883
11727	31	5	818	28	0	882
11728	827	5	27	16	0	875
11729	34	6	14	852	0	906
11730	854	4	10	37	0	905
11731	38	6	7	852	0	903
11732	875	4	6	39	0	924
11733	35	5	6	925	0	971
11734	18	3	951	40	0	1012
11735	963	5	34	17	0	1019
11736	982	3	15	20	0	1020
11737	48	4	9	951	0	1012
11738	25	3	7	944	0	979
11739	18	934	7	47	0	1006
11740	928	28	8	23	0	987
11741	34	934	8	15	0	991
11742	916	34	5	14	0	969
11743	40	15	907	14	0	976
11744	19	9	917	11	0	956
11745	18	7	912	11	0	948
11746	872	5	44	12	0	933
11747	31	887	23	11	0	952
11748	20	27	19	879	0	945
11749	890	12	9	29	0	940
11750	36	884	9	16	0	945
11751	17	42	5	845	0	909
11752	11	863	5	36	0	915
11753	9	833	3	17	0	862
11754	9	821	2	12	0	844
11755	724	31	13	13	0	781
11756	25	720	2	6	0	753
11757	8	626	3	5	0	642
11758	7	589	2	8	0	606
11759	577	10	2	7	0	596
11760	587	5	2	4	0	598
11761	15	2	565	10	0	592
11762	560	1	9	0	0	570
11763	579	1	3	4	0	587
11764	14	2	2	565	0	583
11765	574	0	0	13	0	587
11766	10	2	569	6	0	587
11767	6	601	8	4	0	619
11768	606	8	6	1	0	621
11769	13	7	1	621	0	642
11770	627	3	1	12	0	643
11771	11	2	602	8	0	623
11772	621	0	11	2	0	634
11773	16	2	9	620	0	647
11774	9	1	597	12	0	619
11775	3	582	12	7	0	604
11776	3	605	6	6	0	620
11777	1	17	5	562	0	585
11778	1	6	0	548	0	555
11779	1	565	0	12	0	578
11780	570	10	2	6	0	588
11781	570	4	0	3	0	577
11782	572	4	1	0	0	577
11783	17	599	0	4	0	620
11784	8	11	0	572	0	591
11785	4	584	2	8	0	598
11786	592	13	0	2	0	607
11787	593	3	0	5	0	601
11788	13	569	1	1	0	584
11789	585	11	0	1	0	597
11790	14	6	0	590	0	610
11791	5	4	0	592	0	601
11792	597	1	1	14	0	613
11793	575	1	3	9	0	588
11794	583	0	1	4	0	588
11795	20	1	2	576	0	599
11796	8	0	1	590	0	599
11797	7	1	572	15	0	595
11798	0	4	11	556	0	571
11799	2	2	3	558	0	565
11800	3	4	541	12	0	560
11801	5	0	519	9	0	533
11802	3	4	543	4	0	554
11803	5	1	18	534	0	558
11804	1	2	535	12	0	550
11805	3	2	15	515	0	535
11806	4	4	5	524	0	537
11807	4	2	516	15	0	537
11808	5	3	520	9	0	537
11809	1	3	15	510	0	529
11810	3	1	552	14	0	570
11811	2	5	552	3	0	562
11812	2	556	13	8	0	579
11813	551	14	8	2	0	575
11814	561	5	6	2	0	574
11815	565	8	1	1	0	575
11816	20	556	2	0	0	578
11817	9	543	1	2	0	555
11818	8	16	1	528	0	553
11819	5	9	2	540	0	556
11820	3	6	529	14	0	552
11821	6	1	13	525	0	545
11822	541	1	7	16	0	565
11823	15	3	4	504	0	526
11824	8	527	0	14	0	549
11825	555	10	4	5	0	574
11826	559	7	1	4	0	571
11827	561	7	2	1	0	571
11828	22	2	543	4	0	571
11829	13	0	9	532	0	554
11830	576	3	4	16	0	599
11831	20	2	594	5	0	621
11832	5	568	14	6	0	593
11833	4	561	5	4	0	574
11834	498	15	8	1	0	522
11835	12	504	1	2	0	519
11836	1	15	2	491	0	509
11837	6	2	508	11	0	527
11838	2	7	11	506	0	526
11839	502	1	3	15	0	521
11840	13	500	5	3	0	521
11841	501	11	0	9	0	521
11842	15	1	524	0	0	540
11843	1	15	12	475	0	503
11844	5	522	1	13	0	541
11845	1	11	8	536	0	556
11846	535	3	2	15	0	555
11847	555	6	1	2	0	564
11848	555	0	2	7	0	564
11849	555	2	1	1	0	559
11850	20	0	0	537	0	557
11851	7	2	541	13	0	563
11852	8	1	13	524	0	546
11853	1	539	3	16	0	559
11854	547	12	6	5	0	570
11855	13	2	552	6	0	573
11856	526	6	13	1	0	546
11857	19	2	1	547	0	569
11858	5	0	568	13	0	586
11859	7	1	10	549	0	567
11860	569	0	1	15	0	585
11861	568	2	5	2	0	577
11862	560	1	1	5	0	567
11863	14	0	547	3	0	564
11864	8	1	7	558	0	574
11865	7	0	564	9	0	580
11866	1	554	14	4	0	573
11867	530	9	1	7	0	547
11868	9	526	6	1	0	542
11869	499	8	2	2	0	511
11870	10	1	0	487	0	498
11871	2	496	0	7	0	505
11872	504	6	2	0	0	512
11873	8	0	497	3	0	508
11874	0	3	4	488	0	495
11875	498	0	1	7	0	506
11876	6	0	501	1	0	508
11877	1	1	5	498	0	505
11878	7	495	0	5	0	507
11879	1	6	5	523	0	535
11880	1	3	1	518	0	523
11881	502	4	0	6	0	512
11882	7	512	1	5	0	525
11883	2	8	0	491	0	501
11884	5	489	0	9	0	503
11885	1	9	5	495	0	510
11886	3	502	0	11	0	516
11887	498	11	2	1	0	512
11888	9	3	502	2	0	516
11889	4	5	6	480	0	495
11890	3	0	4	483	0	490
11891	1	0	5	490	0	496
11892	2	3	1	484	0	490
11893	4	2	478	10	0	494
11894	2	496	6	6	0	510
11895	499	8	0	7	0	514
11896	496	2	5	2	0	505
11897	6	503	0	4	0	513
11898	505	10	0	3	0	518
11899	510	1	3	3	0	517
11900	10	505	0	2	0	517
11901	6	10	0	499	0	515
11902	7	508	1	6	0	522
11903	507	9	3	2	0	521
11904	8	0	493	6	0	507
11905	456	4	9	4	0	473
11906	8	0	517	4	0	529
11907	1	3	10	508	0	522
11908	527	2	0	10	0	539
11909	11	0	519	1	0	531
11910	470	0	7	2	0	479
11911	497	2	1	5	0	505
11912	9	0	6	482	0	497
11913	3	500	2	9	0	514
11914	512	11	0	1	0	524
11915	12	0	1	505	0	518
11916	5	509	2	5	0	521
11917	528	7	4	3	0	542
11918	5	0	2	541	0	548
11919	2	581	4	5	0	592
11920	5	7	2	587	0	601
11921	589	0	3	8	0	600
11922	584	5	0	3	0	592
11923	588	0	2	4	0	594
11924	9	1	3	566	0	579
11925	6	3	0	563	0	572
11926	5	2	575	7	0	589
11927	1	2	6	598	0	607
11928	6	0	614	13	0	633
11929	3	1	589	3	0	596
11930	0	0	545	4	0	549
11931	0	589	7	0	0	596
11932	1	9	7	560	0	577
11933	1	627	3	7	0	638
11934	654	9	0	5	0	668
11935	668	0	0	2	0	670
11936	11	2	0	695	0	708
11937	2	0	721	12	0	735
11938	2	0	15	717	0	734
11939	1	0	735	16	0	752
11940	2	1	16	711	0	730
11941	0	721	2	14	0	737
11942	0	737	2	2	0	741
11943	718	13	4	3	0	738
11944	14	0	717	4	0	735
11945	0	2	15	699	0	716
11946	2	2	1	707	0	712
11947	707	3	2	14	0	726
11948	13	720	3	2	0	738
11949	711	15	1	6	0	733
11950	13	728	4	3	0	748
11951	722	15	0	5	0	742
11952	773	2	3	3	0	781
11953	16	3	1	778	0	798
11954	3	6	779	14	0	802
11955	762	3	13	1	0	779
11956	19	786	0	9	0	814
11957	781	16	4	3	0	804
11958	19	0	2	761	0	782
11959	2	4	3	765	0	774
11960	6	758	3	12	0	779
11961	6	17	1	745	0	769
11962	3	762	1	19	0	785
11963	3	17	2	763	0	785
11964	4	4	0	765	0	773
11965	737	6	2	20	0	765
11966	17	4	738	6	0	765
11967	1	743	18	10	0	772
11968	4	15	1	744	0	764
11969	747	3	3	20	0	773
11970	757	4	2	5	0	768
11971	760	5	2	6	0	773
11972	20	3	752	5	0	780
11973	748	7	14	3	0	772
11974	24	3	1	779	0	807
11975	780	2	3	17	0	802
11976	22	766	4	5	0	797
11977	7	18	3	763	0	791
11978	758	1	3	21	0	783
11979	23	780	4	2	0	809
11980	6	22	1	782	0	811
11981	8	2	783	23	0	816
11982	782	8	16	6	0	812
11983	830	5	2	6	0	843
11984	24	3	812	7	0	846
11985	2	789	17	7	0	815
11986	8	819	2	8	0	837
11987	10	15	7	816	0	848
11988	9	7	5	801	0	822
11989	7	8	5	823	0	843
11990	1	7	830	27	0	865
11991	826	6	18	9	0	859
11992	868	7	3	8	0	886
11993	868	3	4	14	0	889
11994	860	4	6	8	0	878
11995	869	4	5	5	0	883
11996	883	4	3	7	0	897
11997	34	0	4	909	0	947
11998	10	6	899	28	0	943
11999	12	8	915	4	0	939
12000	13	4	21	950	0	988
12001	12	2	8	951	0	973
12002	8	8	5	946	0	967
12003	8	953	6	29	0	996
12004	965	26	7	10	0	1008
12005	36	1002	2	9	0	1049
12006	12	24	5	999	0	1040
12007	981	7	6	30	0	1024
12008	30	986	6	11	0	1033
12009	16	29	1	984	0	1030
12010	12	11	3	995	0	1021
12011	13	8	3	1000	0	1024
12012	5	969	6	42	0	1022
12013	13	24	10	981	0	1028
12014	11	11	981	33	0	1036
12015	10	7	20	1009	0	1046
12016	11	8	9	1016	0	1044
12017	15	7	2	1064	0	1088
12018	9	13	3	1076	0	1101
12019	15	3	1030	47	0	1095
12020	7	1025	33	22	0	1087
12021	7	33	11	1047	0	1098
12022	10	12	8	1110	0	1140
12023	5	9	9	1086	0	1109
12024	7	1030	8	62	0	1107
12025	5	1092	9	34	0	1140
12026	1045	44	7	25	0	1121
12027	42	17	5	1034	0	1098
12028	10	10	1008	58	0	1086
12029	7	1017	34	29	0	1087
12030	992	44	10	23	0	1069
12031	40	13	958	24	0	1035
12032	12	10	973	26	0	1021
12033	5	16	960	24	0	1005
12034	11	18	47	933	0	1009
12035	12	16	923	44	0	995
12036	9	862	38	29	0	938
12037	5	30	23	852	0	910
12038	8	15	854	44	0	921
12039	9	15	35	844	0	903
12040	832	15	20	43	0	910
12041	30	9	851	30	0	920
12042	827	8	35	23	0	893
12043	29	862	23	21	0	935
12044	868	33	15	17	0	933
12045	36	15	15	863	0	929
12046	883	8	17	37	0	945
12047	880	9	17	22	0	928
12048	863	10	14	12	0	899
12049	36	866	9	19	0	930
12050	869	28	17	17	0	931
12051	885	19	11	15	0	930
12052	51	7	816	15	0	889
12053	24	804	36	13	0	877
12054	21	28	22	802	0	873
12055	24	18	12	804	0	858
12056	20	12	11	826	0	869
12057	18	8	793	44	0	863
12058	13	10	33	805	0	861
12059	17	9	806	44	0	876
12060	832	6	30	31	0	899
12061	853	9	22	17	0	901
12062	51	6	844	18	0	919
12063	852	13	32	15	0	912
12064	877	8	17	19	0	921
12065	895	8	10	14	0	927
12066	46	10	14	847	0	917
12067	28	9	867	30	0	934
12068	22	867	30	23	0	942
12069	24	25	20	854	0	923
12070	18	14	868	39	0	939
12071	17	6	837	24	0	884
12072	810	9	49	16	0	884
12073	35	867	19	19	0	940
12074	870	24	22	15	0	931
12075	883	11	16	20	0	930
12076	40	870	21	13	0	944
12077	893	31	17	7	0	948
12078	42	17	895	18	0	972
12079	26	5	892	8	0	931
12080	20	13	887	9	0	929
12081	23	866	33	15	0	937
12082	850	28	38	7	0	923
12083	858	17	19	8	0	902
12084	42	816	15	9	0	882
12085	25	869	17	11	0	922
12086	20	32	15	842	0	909
12087	22	19	12	860	0	913
12088	851	24	6	36	0	917
12089	39	849	12	22	0	922
12090	849	31	17	10	0	907
12091	833	23	9	16	0	881
12092	48	8	819	12	0	887
12093	21	810	22	14	0	867
12094	27	32	19	810	0	888
12095	802	15	10	23	0	850
12096	33	13	10	779	0	835
12097	743	11	11	22	0	787
12098	29	9	733	13	0	784
12099	23	706	25	12	0	766
12100	16	710	18	8	0	752
12101	15	31	14	659	0	719
12102	17	715	11	20	0	763
12103	713	23	7	9	0	752
12104	25	18	696	12	0	751
12105	647	16	22	9	0	694
12106	21	10	697	15	0	743
12107	18	11	17	683	0	729
12108	13	8	14	704	0	739
12109	18	6	11	706	0	741
12110	696	7	12	25	0	740
12111	30	7	684	10	0	731
12112	12	4	21	703	0	740
12113	15	4	8	709	0	736
12114	13	685	5	27	0	730
12115	10	683	6	11	0	710
12116	10	695	7	13	0	725
12117	13	15	4	632	0	664
12118	5	10	5	601	0	621
12119	2	567	3	6	0	578
12120	3	579	2	4	0	588
12121	570	4	4	10	0	588
12122	6	1	0	571	0	578
12123	1	562	0	3	0	566
12124	565	4	1	2	0	572
12125	6	1	0	556	0	563
12126	623	0	2	5	0	630
12127	6	2	0	639	0	647
12128	4	0	650	9	0	663
12129	1	658	7	3	0	669
12130	652	8	3	2	0	665
12131	8	4	667	2	0	681
12132	3	658	10	0	0	671
12133	2	4	8	639	0	653
12134	2	2	0	646	0	650
12135	1	0	0	623	0	624
12136	0	1	0	622	0	623
12137	0	0	639	7	0	646
12138	0	627	4	3	0	634
12139	0	3	2	646	0	651
12140	635	2	0	5	0	642
12141	4	634	1	3	0	642
12142	1	5	0	671	0	677
12143	0	1	667	9	0	677
12144	1	674	9	3	0	687
12145	1	9	3	633	0	646
12146	0	695	1	4	0	700
12147	696	10	1	1	0	708
12148	708	4	0	0	0	712
12149	13	1	694	0	0	708
12150	690	1	10	0	0	701
12151	715	0	3	0	0	718
12152	15	0	698	0	0	713
12153	4	702	12	0	0	718
12154	3	10	3	701	0	717
12155	2	3	1	729	0	735
12156	711	1	1	13	0	726
12157	11	1	0	718	0	730
12158	3	0	714	10	0	727
12159	669	0	11	5	0	685
12160	13	0	668	1	0	682
12161	3	672	10	1	0	686
12162	658	11	4	0	0	673
12163	12	4	671	0	0	687
12164	3	1	651	0	0	655
12165	1	662	12	2	0	677
12166	1	12	3	672	0	688
12167	2	3	648	10	0	663
12168	2	1	12	596	0	611
12169	0	1	3	644	0	648
12170	0	1	631	15	0	647
12171	0	623	12	10	0	645
12172	0	11	3	647	0	661
12173	613	3	1	12	0	629
12174	615	1	1	3	0	620
12175	12	1	0	612	0	625
12176	4	0	608	11	0	623
12177	1	0	629	3	0	633
12178	1	0	12	604	0	617
12179	0	1	601	12	0	614
12180	584	0	13	3	0	600
12181	11	0	3	596	0	610
12182	4	1	1	611	0	617
12183	1	599	1	14	0	615
12184	2	11	0	616	0	629
12185	1	3	594	13	0	611
12186	556	1	12	6	0	575
12187	595	2	4	2	0	603
12188	17	3	576	1	0	597
12189	7	1	14	606	0	628
12190	3	0	4	642	0	649
12191	3	2	625	23	0	653
12192	1	0	18	643	0	662
12193	1	0	8	667	0	676
12194	2	675	2	27	0	706
12195	2	19	1	712	0	734
12196	2	3	3	736	0	744
12197	745	5	0	33	0	783
12198	770	5	1	9	0	785
12199	783	0	2	8	0	793
12200	780	1	0	6	0	787
12201	780	1	0	3	0	784
12202	40	0	722	1	0	763
12203	15	2	24	722	0	763
12204	9	0	6	751	0	766
12205	8	0	730	30	0	768
12206	693	2	32	8	0	735
12207	731	0	7	11	0	749
12208	31	0	691	7	0	729
12209	711	3	29	1	0	744
12210	742	0	5	3	0	750
12211	40	1	721	3	0	765
12212	12	3	32	694	0	741
12213	9	737	6	25	0	777
12214	8	26	4	769	0	807
12215	3	7	8	790	0	808
12216	3	3	1	780	0	787
12217	1	6	755	39	0	801
12218	738	2	26	16	0	782
12219	779	1	6	13	0	799
12220	38	0	3	764	0	805
12221	12	1	745	33	0	791
12222	11	0	29	744	0	784
12223	11	0	762	30	0	803
12224	6	1	788	13	0	808
12225	3	793	39	8	0	843
12226	6	23	10	744	0	783
12227	729	6	10	24	0	769
12228	716	1	7	9	0	733
12229	734	5	6	4	0	749
12230	33	3	1	706	0	743
12231	16	754	3	23	0	796
12232	15	25	1	758	0	799
12233	13	5	791	32	0	841
12234	878	2	26	17	0	923
12235	953	7	10	5	0	975
12236	39	2	2	950	0	993
12237	13	1	10	965	0	989
12238	13	0	7	965	0	985
12239	13	3	920	41	0	977
12240	865	1	32	26	0	924
12241	34	902	8	15	0	959
12242	9	914	4	14	0	941
12243	6	28	890	6	0	930
12244	13	9	27	867	0	916
12245	9	10	875	28	0	922
12246	829	12	28	9	0	878
12247	33	4	17	847	0	901
12248	15	1	840	34	0	890
12249	10	862	32	9	0	913
12250	865	16	6	12	0	899
12251	27	6	873	16	0	922
12252	8	857	34	11	0	910
12253	5	893	21	5	0	924
12254	889	33	6	5	0	933
12255	27	12	11	885	0	935
12256	13	17	900	25	0	955
12257	7	918	31	11	0	967
12258	907	25	11	11	0	954
12259	931	10	8	15	0	964
12260	40	914	10	4	0	968
12261	10	31	932	12	0	985
12262	11	9	32	939	0	991
12263	922	11	10	31	0	974
12264	952	9	9	7	0	977
12265	37	4	939	7	0	987
12266	12	8	26	925	0	971
12267	13	10	11	944	0	978
12268	21	2	938	35	0	996
12269	10	1	936	16	0	963
12270	919	4	41	14	0	978
12271	967	10	14	11	0	1002
12272	983	4	13	10	0	1010
12273	987	3	17	5	0	1012
12274	46	9	944	6	0	1005
12275	945	7	28	4	0	984
12276	45	1	10	952	0	1008
12277	28	3	952	33	0	1016
12278	17	7	953	17	0	994
12279	16	943	40	9	0	1008
12280	10	26	13	951	0	1000
12281	11	12	954	32	0	1009
12282	924	11	44	13	0	992
12283	29	13	27	852	0	921
12284	15	962	9	37	0	1023
12285	960	29	15	12	0	1016
12286	991	7	13	6	0	1017
12287	43	5	958	9	0	1015
12288	15	959	34	10	0	1018
12289	23	20	9	910	0	962
12290	927	6	6	25	0	964
12291	24	6	22	912	0	964
12292	11	10	895	18	0	934
12293	793	13	16	13	0	835
12294	26	858	9	10	0	903
12295	10	786	10	12	0	818
12296	10	849	18	8	0	885
12297	833	16	12	9	0	870
12298	824	12	4	7	0	847
12299	834	6	6	3	0	849
12300	26	10	5	814	0	855
12301	15	6	814	16	0	851
12302	11	8	13	827	0	859
12303	838	3	8	20	0	869
12304	24	4	5	845	0	878
12305	861	1	12	22	0	896
12306	852	2	10	14	0	878
12307	862	1	5	9	0	877
12308	19	873	8	8	0	908
12309	875	17	9	6	0	907
12310	20	11	867	5	0	903
12311	23	3	858	2	0	886
12312	12	844	17	3	0	876
12313	21	9	15	801	0	846
12314	816	5	8	11	0	840
12315	18	3	809	5	0	835
12316	800	4	10	11	0	825
12317	15	4	13	793	0	825
12318	11	811	10	13	0	845
12319	6	12	6	824	0	848
12320	10	6	815	11	0	842
12321	793	2	14	9	0	818
12322	17	8	827	2	0	854
12323	15	2	789	9	0	815
12324	752	6	17	5	0	780
12325	16	780	12	5	0	813
12326	787	11	8	4	0	810
12327	790	7	6	10	0	813
12328	22	6	773	1	0	802
12329	746	3	11	7	0	767
12330	20	0	757	2	0	779
12331	8	2	696	9	0	715
12332	8	3	717	5	0	733
12333	5	675	12	6	0	698
12334	579	6	14	8	0	607
12335	567	6	2	1	0	576
12336	559	1	2	0	0	562
12337	569	1	1	1	0	572
12338	4	0	585	0	0	589
12339	6	0	0	570	0	576
12340	2	0	3	570	0	575
12341	582	0	1	2	0	585
12342	0	572	1	3	0	576
12343	3	1	0	572	0	576
12344	565	2	0	2	0	569
12345	0	0	565	2	0	567
12346	3	0	1	550	0	554
12347	1	0	555	0	0	556
12348	0	551	2	2	0	555
12349	1	0	2	519	0	522
12350	521	2	1	0	0	524
12351	2	0	0	513	0	515
12352	2	1	524	0	0	527
12353	1	513	1	6	0	521
12354	514	0	1	0	0	515
12355	0	1	525	0	0	526
12356	482	1	5	0	0	488
12357	0	504	2	1	0	507
12358	532	1	2	0	0	535
12359	536	1	0	0	0	537
12360	3	0	0	533	0	536
12361	2	0	529	2	0	533
12362	1	535	2	1	0	539
12363	1	1	0	538	0	540
12364	1	1	0	555	0	557
12365	0	0	0	594	0	594
12366	1	1	2	610	0	614
12367	0	713	0	7	0	720
12368	735	9	0	3	0	747
12369	11	752	1	3	0	767
12370	4	10	1	805	0	820
12371	804	5	0	14	0	823
12372	13	1	1	806	0	821
12373	7	3	813	14	0	837
12374	4	819	13	8	0	844
12375	3	14	5	823	0	845
12376	2	6	3	843	0	854
12377	789	1	3	21	0	814
12378	13	2	782	9	0	806
12379	780	2	15	6	0	803
12380	795	2	6	7	0	810
12381	801	1	2	6	0	810
12382	25	3	784	3	0	815
12383	18	0	15	767	0	800
12384	5	3	8	778	0	794
12385	7	0	792	23	0	822
12386	7	2	795	9	0	813
12387	786	1	20	10	0	817
12388	17	2	14	808	0	841
12389	835	4	3	27	0	869
12390	856	0	4	15	0	875
12391	24	5	4	848	0	881
12392	16	1	911	19	0	947
12393	887	4	19	12	0	922
12394	24	2	5	924	0	955
12395	17	1	908	22	0	948
12396	10	891	15	14	0	930
12397	884	15	14	8	0	921
12398	22	883	5	8	0	918
12399	15	21	4	821	0	861
12400	7	905	7	23	0	942
12401	882	21	7	10	0	920
12402	886	12	7	6	0	911
12403	29	870	3	11	0	913
12404	878	22	4	9	0	913
12405	879	7	4	11	0	901
12406	26	858	8	10	0	902
12407	864	21	7	6	0	898
12408	30	11	2	843	0	886
12409	19	4	6	857	0	886
12410	850	5	8	25	0	888
12411	34	5	5	786	0	830
12412	16	839	7	26	0	888
12413	839	23	3	15	0	880
12414	841	7	3	13	0	864
12415	28	837	8	12	0	885
12416	854	22	8	7	0	891
12417	862	10	6	8	0	886
12418	33	10	5	833	0	881
12419	23	5	826	23	0	877
12420	19	830	17	13	0	879
12421	835	25	8	10	0	878
12422	861	10	4	12	0	887
12423	36	10	830	11	0	887
12424	831	7	25	14	0	877
12425	35	9	823	6	0	873
12426	828	8	20	11	0	867
12427	34	11	9	824	0	878
12428	20	6	831	29	0	886
12429	18	9	834	12	0	873
12430	17	17	25	805	0	864
12431	23	7	13	814	0	857
12432	16	9	790	34	0	849
12433	15	4	23	793	0	835
12434	22	8	783	23	0	836
12435	18	10	25	782	0	835
12436	18	12	10	770	0	810
12437	20	755	9	33	0	817
12438	18	746	9	23	0	796
12439	13	783	8	16	0	820
12440	18	30	12	749	0	809
12441	22	9	5	777	0	813
12442	13	12	754	38	0	817
12443	741	12	29	13	0	795
12444	774	11	12	14	0	811
12445	36	764	6	15	0	821
12446	788	20	9	12	0	829
12447	36	6	13	776	0	831
12448	776	10	12	31	0	829
12449	796	8	16	12	0	832
12450	43	4	3	784	0	834
12451	759	7	6	35	0	807
12452	31	734	13	13	0	791
12453	19	759	8	16	0	802
12454	18	34	7	714	0	773
12455	18	751	7	30	0	806
12456	18	25	11	755	0	809
12457	12	18	8	773	0	811
12458	736	11	10	27	0	784
12459	26	735	7	19	0	787
12460	714	29	2	20	0	765
12461	714	7	5	11	0	737
12462	27	701	10	13	0	751
12463	705	21	6	12	0	744
12464	34	7	668	9	0	718
12465	16	632	19	8	0	675
12466	602	14	5	7	0	628
12467	18	7	496	6	0	527
12468	11	447	14	7	0	479
12469	6	447	4	11	0	468
12470	382	5	2	6	0	395
12471	369	2	4	4	0	379
12472	362	3	1	4	0	370
12473	7	353	2	3	0	365
12474	1	8	3	357	0	369
12475	351	2	1	8	0	362
12476	363	2	2	5	0	372
12477	7	5	1	358	0	371
12478	3	1	360	10	0	374
12479	2	3	353	1	0	359
12480	5	5	4	358	0	372
12481	3	2	0	370	0	375
12482	3	3	361	5	0	372
12483	6	3	6	338	0	353
12484	5	350	1	5	0	361
12485	351	5	2	3	0	361
12486	9	2	1	349	0	361
12487	335	1	3	6	0	345
12488	9	342	4	0	0	355
12489	5	330	0	2	0	337
12490	320	1	1	5	0	327
12491	7	1	319	1	0	328
12492	236	2	2	3	0	243
12493	1	248	5	1	0	255
12494	1	1	0	234	0	236
12495	235	0	0	1	0	236
12496	2	0	0	236	0	238
12497	254	1	0	2	0	257
12498	257	0	0	2	0	259
12499	2	270	0	0	0	272
12500	261	0	0	0	0	261
12501	0	252	0	1	0	253
12502	261	0	1	0	0	262
12503	0	0	1	262	0	263
12504	265	0	0	1	0	266
12505	0	0	0	264	0	264
12506	274	0	0	1	0	275
12507	290	0	0	1	0	291
12508	290	0	0	0	0	290
12509	282	0	0	1	0	283
12510	289	0	0	0	0	289
12511	0	0	0	291	0	291
12512	277	0	0	1	0	278
12513	0	269	0	0	0	269
12514	0	0	276	1	0	277
12515	1	0	0	279	0	280
12516	0	0	293	0	0	293
12517	0	0	0	306	0	306
12518	0	3	304	0	0	307
12519	293	0	0	1	0	294
12520	1	0	0	307	0	308
12521	0	0	302	0	0	302
12522	0	0	301	0	0	301
12523	0	0	0	306	0	306
12524	331	0	0	0	0	331
12525	0	333	0	0	0	333
12526	335	0	0	0	0	335
12527	332	0	0	1	0	333
12528	0	329	0	0	0	329
12529	332	0	0	0	0	332
12530	0	1	0	332	0	333
12531	2	0	0	335	0	337
12532	1	0	0	337	0	338
12533	336	1	0	0	0	337
12534	1	342	0	0	0	343
12535	0	0	1	348	0	349
12536	1	0	0	350	0	351
12537	346	0	0	1	0	347
12538	1	0	0	356	0	357
12539	1	1	371	0	0	373
12540	0	400	0	1	0	401
12541	405	0	0	1	0	406
12542	1	1	3	390	0	395
12543	1	410	0	1	0	412
12544	407	0	1	1	0	409
12545	0	2	398	0	0	400
12546	2	399	0	2	0	403
12547	411	0	1	1	0	413
12548	0	2	0	405	0	407
12549	2	0	0	404	0	406
12550	0	0	412	1	0	413
12551	0	1	0	399	0	400
12552	1	0	439	0	0	440
12553	0	0	413	3	0	416
12554	0	0	451	2	0	453
12555	457	0	2	0	0	459
12556	464	0	1	2	0	467
12557	472	0	1	2	0	475
12558	2	0	1	470	0	473
12559	1	460	2	1	0	464
12560	1	462	0	1	0	464
12561	472	2	0	1	0	475
12562	489	1	0	0	0	490
12563	1	492	0	2	0	495
12564	488	2	0	0	0	490
12565	1	2	477	0	0	480
12566	3	0	477	0	0	480
12567	1	1	1	466	0	469
12568	3	1	1	494	0	499
12569	2	0	494	2	0	498
12570	0	1	1	496	0	498
12571	496	0	3	1	0	500
12572	0	1	499	3	0	503
12573	494	0	2	1	0	497
12574	0	0	3	530	0	533
12575	1	0	533	1	0	535
12576	2	537	0	1	0	540
12577	553	0	2	0	0	555
12578	2	1	543	0	0	546
12579	535	0	0	1	0	536
12580	0	1	2	543	0	546
12581	544	2	0	0	0	546
12582	2	0	584	1	0	587
12583	2	0	1	587	0	590
12584	609	1	2	0	0	612
12585	613	0	0	2	0	615
12586	620	0	2	0	0	622
12587	629	0	3	1	0	633
12588	2	0	2	599	0	603
12589	2	2	0	601	0	605
12590	4	0	611	2	0	617
12591	1	1	2	595	0	599
12592	4	1	1	592	0	598
12593	2	611	1	5	0	619
12594	620	1	1	3	0	625
12595	636	3	2	1	0	642
12596	3	668	1	3	0	675
12597	2	4	0	662	0	668
12598	3	2	0	663	0	668
12599	640	0	2	6	0	648
12600	6	0	654	2	0	662
12601	0	2	4	669	0	675
12602	2	0	674	6	0	682
12603	645	0	6	4	0	655
12604	671	1	1	4	0	677
12605	661	0	2	0	0	663
12606	6	2	1	642	0	651
12607	4	1	1	636	0	642
12608	642	1	0	3	0	646
12609	3	2	631	3	0	639
12610	4	0	3	637	0	644
12611	637	0	4	5	0	646
12612	4	2	0	647	0	653
12613	4	0	688	5	0	697
12614	0	1	660	3	0	664
12615	646	0	6	4	0	656
12616	7	674	2	4	0	687
12617	703	4	0	4	0	711
12618	712	1	2	1	0	716
12619	4	0	1	726	0	731
12620	4	2	0	719	0	725
12621	0	714	1	7	0	722
12622	719	5	1	4	0	729
12623	7	717	1	3	0	728
12624	3	723	1	0	0	727
12625	2	6	0	718	0	726
12626	714	1	2	5	0	722
12627	719	0	3	3	0	725
12628	7	0	0	718	0	725
12629	2	1	0	720	0	723
12630	2	0	1	709	0	712
12631	697	0	1	10	0	708
12632	7	1	710	3	0	721
12633	2	712	6	3	0	723
12634	709	6	2	2	0	719
12635	8	4	0	710	0	722
12636	2	1	708	5	0	716
12637	1	1	700	2	0	704
12638	0	699	8	2	0	709
12639	2	739	1	1	0	743
12640	4	3	1	706	0	714
12641	2	670	0	5	0	677
12642	2	5	0	708	0	715
12643	0	0	0	736	0	736
12644	737	0	0	6	0	743
12645	5	0	2	732	0	739
12646	1	1	0	744	0	746
12647	2	0	729	5	0	736
12648	0	0	5	730	0	735
12649	756	0	2	5	0	763
12650	748	0	2	1	0	751
12651	6	766	1	1	0	774
12652	748	8	1	0	0	757
12653	8	0	762	1	0	771
12654	1	769	7	1	0	778
12655	1	7	0	764	0	772
12656	1	0	0	776	0	777
12657	1	1	0	780	0	782
12658	763	0	0	11	0	774
12659	725	3	1	1	0	730
12660	8	1	751	0	0	760
12661	1	0	732	3	0	736
12662	3	1	727	2	0	733
12663	4	736	8	1	0	749
12664	2	763	1	1	0	767
12665	751	9	0	2	0	762
12666	771	1	1	2	0	775
12667	7	1	0	797	0	805
12668	3	2	1	780	0	786
12669	1	796	0	10	0	807
12670	2	7	1	803	0	813
12671	3	1	804	9	0	817
12672	2	806	7	3	0	818
12673	1	9	2	803	0	815
12674	1	0	800	7	0	808
12675	2	3	8	747	0	760
12676	1	774	0	8	0	783
12677	781	11	1	1	0	794
12678	784	0	0	4	0	788
12679	801	2	0	3	0	806
12680	14	0	0	810	0	824
12681	3	2	0	850	0	855
12682	820	0	0	16	0	836
12683	15	840	2	6	0	863
12684	841	13	1	6	0	861
12685	18	3	950	3	0	974
12686	955	1	18	3	0	977
12687	985	1	6	4	0	996
12688	28	1	5	962	0	996
12689	984	2	3	20	0	1009
12690	1017	5	2	7	0	1031
12691	27	3	3	1027	0	1060
12692	11	1	1004	21	0	1037
12693	957	3	19	12	0	991
12694	23	2	1008	9	0	1042
12695	9	1003	21	13	0	1046
12696	9	19	15	998	0	1041
12697	3	7	7	1064	0	1081
12698	1141	4	5	29	0	1179
12699	21	2	1177	11	0	1211
12700	9	3	24	1136	0	1172
12701	5	1171	9	22	0	1207
12702	4	1196	5	8	0	1213
12703	2	31	2	1180	0	1215
12704	4	10	1181	28	0	1223
12705	5	5	26	1184	0	1220
12706	5	4	7	1190	0	1206
12707	4	5	1157	36	0	1202
12708	4	1174	23	15	0	1216
12709	1148	27	8	12	0	1195
12710	22	1188	8	6	0	1224
12711	12	30	5	1187	0	1234
12712	1122	12	6	26	0	1166
12713	25	1136	4	9	0	1174
12714	9	24	1130	6	0	1169
12715	1088	9	23	8	0	1128
12716	27	1139	8	8	0	1182
12717	1125	23	5	7	0	1160
12718	30	9	1083	5	0	1127
12719	1086	7	21	7	0	1121
12720	28	7	7	1091	0	1133
12721	11	3	1096	26	0	1136
12722	8	7	26	1058	0	1099
12723	4	1062	10	29	0	1105
12724	5	20	11	1083	0	1119
12725	8	10	4	1084	0	1106
12726	7	8	1061	32	0	1108
12727	8	2	24	1069	0	1103
12728	6	5	946	33	0	990
12729	10	1059	20	13	0	1102
12730	5	24	7	1063	0	1099
12731	3	11	1072	28	0	1114
12732	6	1065	24	12	0	1107
12733	2	1110	11	9	0	1132
12734	5	31	1086	8	0	1130
12735	10	13	1080	4	0	1107
12736	5	10	32	1063	0	1110
12737	1066	1	14	25	0	1106
12738	24	1068	12	14	0	1118
12739	18	24	4	1031	0	1077
12740	1036	11	2	30	0	1079
12741	26	1028	6	16	0	1076
12742	1020	26	6	11	0	1063
12743	33	1040	3	8	0	1084
12744	1034	27	5	9	0	1075
12745	1035	14	7	12	0	1068
12746	1051	8	6	13	0	1078
12747	41	1067	4	8	0	1120
12748	22	30	6	1061	0	1119
12749	14	14	1050	27	0	1105
12750	6	1054	27	19	0	1106
12751	13	25	13	1029	0	1080
12752	8	19	8	1040	0	1075
12753	7	8	985	37	0	1037
12754	4	956	27	17	0	1004
12755	964	19	13	11	0	1007
12756	24	969	8	12	0	1013
12757	14	27	9	949	0	999
12758	12	16	964	27	0	1019
12759	940	8	24	17	0	989
12760	23	6	12	971	0	1012
12761	12	9	961	26	0	1008
12762	921	5	20	14	0	960
12763	23	953	13	8	0	997
12764	948	25	13	6	0	992
12765	965	13	3	11	0	992
12766	36	12	5	933	0	986
12767	21	7	909	27	0	964
12768	9	888	28	20	0	945
12769	7	29	904	9	0	949
12770	6	21	24	882	0	933
12771	7	11	18	913	0	949
12772	891	5	8	39	0	943
12773	21	9	888	21	0	939
12774	17	884	24	13	0	938
12775	7	28	12	890	0	937
12776	6	13	12	908	0	939
12777	880	10	7	32	0	929
12778	23	897	4	16	0	940
12779	14	22	5	874	0	915
12780	834	12	5	25	0	876
12781	15	832	9	13	0	869
12782	803	19	4	9	0	835
12783	770	13	6	7	0	796
12784	26	771	4	4	0	805
12785	636	13	4	5	0	658
12786	16	637	2	6	0	661
12787	636	9	4	5	0	654
12788	624	6	5	5	0	640
12789	12	622	6	7	0	647
12790	593	13	1	5	0	612
12791	599	6	1	7	0	613
12792	614	3	1	7	0	625
12793	13	4	612	4	0	633
12794	4	3	576	3	0	586
12795	4	1	573	2	0	580
12796	547	7	15	3	0	572
12797	10	2	524	3	0	539
12798	4	4	426	1	0	435
12799	5	1	3	370	0	379
12800	369	1	6	3	0	379
12801	2	0	383	1	0	386
12802	2	1	395	1	0	399
12803	1	0	3	396	0	400
12804	1	1	2	396	0	400
12805	0	1	0	400	0	401
12806	3	0	399	3	0	405
12807	1	1	2	398	0	402
12808	397	1	2	2	0	402
12809	3	394	1	2	0	400
12810	2	3	0	397	0	402
12811	1	1	1	399	0	402
12812	0	0	396	3	0	399
12813	0	379	2	2	0	383
12814	392	2	1	1	0	396
12815	3	394	1	0	0	398
12816	2	3	0	391	0	396
12817	1	2	393	4	0	400
12818	0	0	5	423	0	428
12819	0	0	4	426	0	430
12820	442	2	2	4	0	450
12821	6	1	1	430	0	438
12822	1	430	3	5	0	439
12823	0	456	3	3	0	462
12824	1	2	464	3	0	470
12825	470	1	4	5	0	480
12826	5	1	3	472	0	481
12827	2	1	1	469	0	473
12828	1	1	2	475	0	479
12829	488	1	0	7	0	496
12830	4	481	2	5	0	492
12831	484	3	2	2	0	491
12832	6	2	459	3	0	470
12833	3	3	452	1	0	459
12834	462	2	5	2	0	471
12835	5	1	5	469	0	480
12836	4	1	2	474	0	481
12837	2	2	3	477	0	484
12838	2	2	467	6	0	477
12839	472	1	6	2	0	481
12840	474	1	2	4	0	481
12841	467	0	1	4	0	472
12842	7	0	3	461	0	471
12843	3	0	452	7	0	462
12844	2	1	444	2	0	449
12845	4	1	442	2	0	449
12846	1	449	5	3	0	458
12847	7	5	6	407	0	425
12848	398	3	8	6	0	415
12849	5	0	402	3	0	410
12850	400	1	4	5	0	410
12851	7	0	3	416	0	426
12852	6	1	2	407	0	416
12853	2	409	3	7	0	421
12854	2	412	2	4	0	420
12855	1	422	2	3	0	428
12856	2	2	1	420	0	425
12857	413	2	3	3	0	421
12858	411	1	1	5	0	418
12859	6	2	411	3	0	422
12860	399	2	3	3	0	407
12861	4	1	408	4	0	417
12862	5	1	3	411	0	420
12863	4	0	414	2	0	420
12864	412	3	3	3	0	421
12865	7	0	4	438	0	449
12866	3	1	453	5	0	462
12867	0	0	442	6	0	448
12868	444	0	6	4	0	454
12869	452	0	4	4	0	460
12870	7	477	1	2	0	487
12871	3	3	2	487	0	495
12872	4	2	489	5	0	500
12873	2	1	493	4	0	500
12874	1	3	6	480	0	490
12875	481	2	5	7	0	495
12876	4	480	2	4	0	490
12877	6	4	1	490	0	501
12878	500	4	1	8	0	513
12879	6	1	0	512	0	519
12880	4	518	3	3	0	528
12881	2	4	1	520	0	527
12882	518	3	0	5	0	526
12883	3	1	2	521	0	527
12884	520	2	3	4	0	529
12885	5	533	1	4	0	543
12886	519	4	1	3	0	527
12887	3	2	514	6	0	525
12888	499	0	4	2	0	505
12889	523	1	5	1	0	530
12890	8	528	2	2	0	540
12891	5	5	1	510	0	521
12892	3	3	498	2	0	506
12893	2	1	466	6	0	475
12894	450	4	14	1	0	469
12895	446	0	4	2	0	452
12896	3	467	2	3	0	475
12897	4	480	2	0	0	486
12898	478	5	1	1	0	485
12899	4	477	0	2	0	483
12900	3	494	0	3	0	500
12901	0	3	2	492	0	497
12902	2	3	1	478	0	484
12903	1	1	489	5	0	496
12904	3	0	2	476	0	481
12905	485	1	2	6	0	494
12906	3	0	481	4	0	488
12907	3	2	489	0	0	494
12908	1	0	4	494	0	499
12909	2	2	3	495	0	502
12910	2	0	1	502	0	505
12911	3	1	500	3	0	507
12912	1	1	2	496	0	500
12913	5	0	2	515	0	522
12914	505	1	0	5	0	511
12915	3	512	1	2	0	518
12916	513	2	1	6	0	522
12917	3	2	525	1	0	531
12918	454	0	2	3	0	459
12919	2	495	2	2	0	501
12920	466	0	0	1	0	467
12921	0	458	1	0	0	459
12922	452	0	0	0	0	452
12923	0	446	0	0	0	446
12924	0	434	0	0	0	434
12925	0	0	2	440	0	442
12926	441	0	1	0	0	442
12927	433	0	0	0	0	433
12928	432	0	0	0	0	432
12929	0	0	428	0	0	428
12930	1	0	426	0	0	427
12931	1	0	0	440	0	441
12932	0	445	0	0	0	445
12933	0	445	0	0	0	445
12934	0	0	0	442	0	442
12935	439	0	0	0	0	439
12936	432	0	0	0	0	432
12937	437	0	0	0	0	437
12938	2	0	440	0	0	442
12939	2	0	0	440	0	442
12940	0	2	451	1	0	454
12941	436	1	1	3	0	441
12942	441	0	1	1	0	443
12943	3	0	452	1	0	456
12944	2	0	1	434	0	437
12945	461	1	1	2	0	465
12946	4	0	1	454	0	459
12947	1	0	2	461	0	464
12948	2	0	0	477	0	479
12949	537	1	0	4	0	542
12950	5	2	0	568	0	575
12951	606	0	0	11	0	617
12952	12	654	1	5	0	672
12953	8	11	1	686	0	706
12954	4	5	0	695	0	704
12955	1	2	1	701	0	705
12956	686	1	1	18	0	706
12957	13	2	1	694	0	710
12958	7	1	0	700	0	708
12959	685	2	0	18	0	705
12960	701	1	1	8	0	711
12961	702	0	0	3	0	705
12962	22	1	666	2	0	691
12963	10	0	656	4	0	670
12964	678	0	18	3	0	699
12965	13	0	7	662	0	682
12966	8	0	4	647	0	659
12967	655	0	2	19	0	676
12968	643	1	1	12	0	657
12969	647	1	1	4	0	653
12970	17	612	0	4	0	633
12971	623	12	1	3	0	639
12972	605	5	1	3	0	614
12973	19	593	1	4	0	617
12974	11	607	0	4	0	622
12975	4	14	0	615	0	633
12976	623	6	0	12	0	641
12977	637	2	1	5	0	645
12978	623	2	1	3	0	629
12979	19	2	2	599	0	622
12980	609	1	1	12	0	623
12981	17	1	594	8	0	620
12982	600	0	11	4	0	615
12983	16	1	604	1	0	622
12984	8	1	605	3	0	617
12985	7	0	17	588	0	612
12986	597	1	7	12	0	617
12987	17	0	2	602	0	621
12988	10	0	604	15	0	629
12989	1	1	623	7	0	632
12990	2	3	15	610	0	630
12991	608	2	9	15	0	634
12992	15	622	2	11	0	650
12993	11	12	3	629	0	655
12994	3	5	3	654	0	665
12995	5	2	643	24	0	674
12996	7	2	628	10	0	647
12997	5	3	19	630	0	657
12998	640	0	12	14	0	666
12999	14	2	638	9	0	663
13000	11	1	15	620	0	647
13001	4	1	7	630	0	642
13002	3	1	1	642	0	647
13003	608	1	0	25	0	634
13004	16	2	574	13	0	605
13005	7	600	15	6	0	628
13006	5	12	4	613	0	634
13007	5	8	603	14	0	630
13008	7	589	13	9	0	618
13009	3	606	10	7	0	626
13010	597	19	4	8	0	628
13011	15	606	1	4	0	626
13012	616	14	3	7	0	640
13013	15	7	607	5	0	634
13014	11	4	15	611	0	641
13015	621	1	8	15	0	645
13016	15	622	4	11	0	652
13017	11	13	611	8	0	643
13018	9	9	17	562	0	597
13019	8	629	7	13	0	657
13020	7	15	5	631	0	658
13021	623	13	4	15	0	655
13022	15	634	4	9	0	662
13023	634	12	3	6	0	655
13024	641	10	0	3	0	654
13025	25	7	620	3	0	655
13026	14	641	16	4	0	675
13027	9	15	9	689	0	722
13028	8	10	727	15	0	760
13029	5	8	793	9	0	815
13030	3	6	22	809	0	840
13031	847	2	7	18	0	874
13032	866	4	5	8	0	883
13033	34	2	3	861	0	900
13034	15	2	865	23	0	905
13035	11	870	24	11	0	916
13036	882	18	11	12	0	923
13037	896	6	7	7	0	916
13038	34	893	5	7	0	939
13039	903	20	7	7	0	937
13040	29	9	881	8	0	927
13041	883	8	20	4	0	915
13042	871	6	8	1	0	886
13043	34	2	894	5	0	935
13044	17	4	22	877	0	920
13045	15	4	878	18	0	915
13046	9	858	26	9	0	902
13047	9	870	12	5	0	896
13048	15	39	5	798	0	857
13049	3	8	812	15	0	838
13050	4	760	17	9	0	790
13051	3	729	9	5	0	746
13052	658	13	7	2	0	680
13053	655	10	4	1	0	670
13054	8	6	5	662	0	681
13055	8	4	3	650	0	665
13056	8	674	4	9	0	695
13057	665	13	0	9	0	687
13058	653	8	2	4	0	667
13059	15	677	1	3	0	696
13060	10	8	3	673	0	694
13061	8	5	669	11	0	693
13062	5	9	7	665	0	686
13063	679	4	9	11	0	703
13064	14	0	6	671	0	691
13065	8	4	3	683	0	698
13066	692	3	0	15	0	710
13067	9	3	5	681	0	698
13068	5	692	2	16	0	715
13069	11	7	3	693	0	714
13070	7	8	1	701	0	717
13071	1	5	1	694	0	701
13072	6	695	3	18	0	722
13073	4	8	4	695	0	711
13074	4	9	675	14	0	702
13075	2	6	8	674	0	690
13076	2	5	670	17	0	694
13077	5	652	11	11	0	679
13078	1	9	7	673	0	690
13079	5	9	4	672	0	690
13080	3	7	5	674	0	689
13081	4	3	4	667	0	678
13082	2	1	647	21	0	671
13083	2	648	11	9	0	670
13084	3	12	3	660	0	678
13085	4	4	661	17	0	686
13086	2	5	10	674	0	691
13087	672	2	8	18	0	700
13088	9	5	657	9	0	680
13089	633	6	10	10	0	659
13090	18	2	3	660	0	683
13091	8	1	665	16	0	690
13092	5	649	12	13	0	679
13093	8	8	9	645	0	670
13094	6	9	656	14	0	685
13095	6	649	11	11	0	677
13096	7	12	10	664	0	693
13097	658	7	9	22	0	696
13098	673	8	8	8	0	697
13099	683	7	3	11	0	704
13100	24	3	672	8	0	707
13101	14	672	11	4	0	701
13102	4	13	11	682	0	710
13103	8	8	4	728	0	748
13104	731	7	5	20	0	763
13105	19	760	5	13	0	797
13106	779	15	5	8	0	807
13107	765	14	6	7	0	792
13108	783	8	3	12	0	806
13109	25	7	768	5	0	805
13110	784	4	11	11	0	810
13111	25	3	12	781	0	821
13112	14	8	8	771	0	801
13113	765	3	4	27	0	799
13114	21	0	1	759	0	781
13115	14	745	7	25	0	791
13116	10	18	4	747	0	779
13117	732	5	1	27	0	765
13118	11	6	724	21	0	762
13119	15	705	10	12	0	742
13120	13	14	9	707	0	743
13121	712	13	4	17	0	746
13122	15	7	706	16	0	744
13123	13	8	15	709	0	745
13124	8	0	713	18	0	739
13125	10	6	679	15	0	710
13126	3	5	665	15	0	688
13127	4	2	655	9	0	670
13128	10	0	608	5	0	623
13129	489	8	26	6	0	529
13130	9	514	6	3	0	532
13131	479	7	3	4	0	493
13132	470	5	2	2	0	479
13133	12	464	3	2	0	481
13134	5	463	3	2	0	473
13135	458	9	8	2	0	477
13136	464	4	0	3	0	471
13137	8	3	2	458	0	471
13138	6	445	1	10	0	462
13139	450	4	1	4	0	459
13140	5	449	4	1	0	459
13141	4	10	1	451	0	466
13142	454	3	1	9	0	467
13143	462	0	1	4	0	467
13144	11	0	1	457	0	469
13145	6	3	0	458	0	467
13146	3	1	457	9	0	470
13147	4	3	6	440	0	453
13148	1	1	456	9	0	467
13149	3	1	6	427	0	437
13150	4	0	5	446	0	455
13151	445	1	1	11	0	458
13152	442	1	2	6	0	451
13153	11	2	432	1	0	446
13154	427	0	6	2	0	435
13155	7	2	7	428	0	444
13156	4	4	434	8	0	450
13157	2	0	5	427	0	434
13158	6	0	4	453	0	463
13159	3	2	453	11	0	469
13160	0	2	9	447	0	458
13161	4	1	453	6	0	464
13162	3	1	8	473	0	485
13163	507	0	7	11	0	525
13164	10	531	3	7	0	551
13165	556	12	1	4	0	573
13166	11	564	3	3	0	581
13167	551	8	1	7	0	567
13168	11	545	6	0	0	562
13169	541	11	1	4	0	557
13170	11	542	2	3	0	558
13171	9	12	2	534	0	557
13172	5	8	537	9	0	559
13173	3	5	534	9	0	551
13174	4	1	19	528	0	552
13175	533	2	9	14	0	558
13176	12	546	3	11	0	572
13177	11	12	0	544	0	567
13178	5	7	546	13	0	571
13179	0	6	549	9	0	564
13180	5	2	18	507	0	532
13181	2	547	10	11	0	570
13182	550	10	5	7	0	572
13183	10	11	570	5	0	596
13184	10	2	567	4	0	583
13185	4	580	17	1	0	602
13186	571	14	11	4	0	600
13187	584	7	4	4	0	599
13188	21	4	3	585	0	613
13189	599	0	4	9	0	612
13190	578	3	3	10	0	594
13191	17	587	4	4	0	612
13192	601	12	4	1	0	618
13193	14	8	603	1	0	626
13194	9	4	12	587	0	612
13195	4	0	9	587	0	600
13196	568	1	1	17	0	587
13197	10	570	1	10	0	591
13198	572	10	0	2	0	584
13199	12	581	2	1	0	596
13200	8	575	4	2	0	589
13201	4	14	565	2	0	585
13202	2	8	552	3	0	565
13203	497	6	10	2	0	515
13204	519	1	5	2	0	527
13205	12	0	489	0	0	501
13206	5	466	6	1	0	478
13207	3	485	5	2	0	495
13208	487	11	1	2	0	501
13209	493	8	0	1	0	502
13210	10	2	2	500	0	514
13211	513	0	4	5	0	522
13212	7	1	1	510	0	519
13213	6	0	513	9	0	528
13214	2	3	488	4	0	497
13215	503	1	10	3	0	517
13216	6	1	7	488	0	502
13217	6	532	3	4	0	545
13218	540	7	0	5	0	552
13219	535	5	0	5	0	545
13220	13	1	545	0	0	559
13221	550	0	7	3	0	560
13222	564	0	5	3	0	572
13223	12	2	2	555	0	571
13224	8	562	0	6	0	576
13225	3	578	2	5	0	588
13226	0	13	3	582	0	598
13227	3	5	1	555	0	564
13228	3	1	0	566	0	570
13229	3	2	562	13	0	580
13230	2	2	530	6	0	540
13231	5	0	12	537	0	554
13232	2	2	548	9	0	561
13233	1	3	549	5	0	558
13234	2	1	14	542	0	559
13235	1	1	559	9	0	570
13236	3	561	7	8	0	579
13237	574	10	4	4	0	592
13238	10	7	4	568	0	589
13239	5	580	3	9	0	597
13240	2	9	596	9	0	616
13241	6	8	9	610	0	633
13242	3	3	628	8	0	642
13243	0	0	10	645	0	655
13244	3	1	7	661	0	672
13245	1	2	668	18	0	689
13246	3	0	13	654	0	670
13247	1	677	10	13	0	701
13248	3	11	2	706	0	722
13249	1	8	709	10	0	728
13250	2	3	10	702	0	717
13251	693	1	8	13	0	715
13252	13	702	3	10	0	728
13253	13	10	2	702	0	727
13254	5	13	709	13	0	740
13255	3	697	13	6	0	719
13256	1	716	8	2	0	727
13257	6	24	691	2	0	723
13258	2	13	12	661	0	688
13259	2	3	7	678	0	690
13260	5	1	684	18	0	708
13261	2	653	7	13	0	675
13262	2	680	9	3	0	694
13263	612	7	5	3	0	627
13264	8	629	1	1	0	639
13265	627	8	1	1	0	637
13266	8	3	1	611	0	623
13267	632	3	1	6	0	642
13268	6	1	636	5	0	648
13269	625	2	6	5	0	638
13270	7	0	6	637	0	650
13271	4	657	3	8	0	672
13272	665	5	2	2	0	674
13273	7	7	1	674	0	689
13274	3	683	1	6	0	693
13275	1	715	3	3	0	722
13276	717	9	0	4	0	730
13277	739	6	1	4	0	750
13278	744	2	0	4	0	750
13279	10	2	5	721	0	738
13280	5	703	3	9	0	720
13281	2	720	2	5	0	729
13282	1	9	3	725	0	738
13283	700	3	6	11	0	720
13284	666	2	7	7	0	682
13285	680	2	2	7	0	691
13286	11	4	675	2	0	692
13287	7	3	680	1	0	691
13288	710	1	11	9	0	731
13289	7	2	6	714	0	729
13290	4	2	4	711	0	721
13291	5	3	2	701	0	711
13292	0	3	1	715	0	719
13293	3	4	699	14	0	720
13294	0	7	9	703	0	719
13295	4	2	704	13	0	723
13296	658	1	13	8	0	680
13297	9	709	4	3	0	725
13298	4	8	5	727	0	744
13299	5	3	4	722	0	734
13300	705	3	5	13	0	726
13301	710	5	0	9	0	724
13302	714	2	1	6	0	723
13303	705	2	3	4	0	714
13304	12	4	699	4	0	719
13305	8	4	691	2	0	705
13306	5	3	10	690	0	708
13307	703	1	6	10	0	720
13308	694	0	6	8	0	708
13309	14	3	686	6	0	709
13310	6	5	7	675	0	693
13311	677	4	6	10	0	697
13312	8	1	4	679	0	692
13313	8	6	722	10	0	746
13314	7	6	8	727	0	748
13315	729	3	5	11	0	748
13316	11	767	6	5	0	789
13317	758	10	3	7	0	778
13318	761	6	4	2	0	773
13319	771	5	2	4	0	782
13320	15	5	0	754	0	774
13321	743	2	1	12	0	758
13322	8	781	3	7	0	799
13323	6	806	2	3	0	817
13324	3	22	1	779	0	805
13325	789	8	3	11	0	811
13326	16	827	3	5	0	851
13327	968	20	0	3	0	991
13328	1063	7	0	9	0	1079
13329	33	1090	1	3	0	1127
13330	13	26	3	1091	0	1133
13331	8	6	0	1119	0	1133
13332	4	8	1098	39	0	1149
13333	6	3	27	1082	0	1118
13334	4	2	1094	34	0	1134
13335	4	1069	34	14	0	1121
13336	4	32	7	1089	0	1132
13337	1046	11	7	32	0	1096
13338	1093	7	1	13	0	1114
13339	41	1	5	1081	0	1128
13340	18	3	1050	32	0	1103
13341	981	4	30	15	0	1030
13342	30	1014	10	13	0	1067
13343	11	1002	7	6	0	1026
13344	10	1010	3	15	0	1038
13345	6	36	4	976	0	1022
13346	4	13	1009	30	0	1056
13347	2	8	28	990	0	1028
13348	5	3	1007	36	0	1051
13349	5	5	993	9	0	1012
13350	4	3	1025	8	0	1040
13351	2	4	41	954	0	1001
13352	2	2	15	1043	0	1062
13353	7	1	9	1058	0	1075
13354	3	4	5	1037	0	1049
13355	1026	4	5	41	0	1076
13356	27	1025	6	15	0	1073
13357	1033	28	7	11	0	1079
13358	33	1049	6	8	0	1096
13359	6	34	2	1067	0	1109
13360	8	7	5	1120	0	1140
13361	1089	8	3	40	0	1140
13362	1095	1	5	18	0	1119
13363	1110	4	3	10	0	1127
13364	1100	4	2	6	0	1112
13365	1094	3	3	8	0	1108
13366	40	1064	2	8	0	1114
13367	1033	29	1	7	0	1070
13368	36	1039	0	6	0	1081
13369	1034	36	1	3	0	1074
13370	41	7	1043	3	0	1094
13371	13	9	28	1012	0	1062
13372	15	1065	6	31	0	1117
13373	10	32	8	1064	0	1114
13374	13	12	1069	33	0	1127
13375	10	14	28	1014	0	1066
13376	1006	3	8	40	0	1057
13377	36	1026	8	9	0	1079
13378	10	1058	3	12	0	1083
13379	13	39	1054	7	0	1113
13380	8	18	28	1034	0	1088
13381	8	1095	9	29	0	1141
13382	7	35	12	1124	0	1178
13383	8	14	1124	31	0	1177
13384	5	1114	29	12	0	1160
13385	2	36	1116	15	0	1169
13386	6	11	1121	3	0	1141
13387	5	7	33	1117	0	1162
13388	1109	6	15	34	0	1164
13389	27	12	6	1136	0	1181
13390	10	6	1133	36	0	1185
13391	8	6	38	1147	0	1199
13392	4	7	1199	40	0	1250
13393	2	7	1194	12	0	1215
13394	1174	4	47	16	0	1241
13395	1257	2	21	10	0	1290
13396	1252	4	10	13	0	1279
13397	42	3	1220	13	0	1278
13398	12	4	1222	13	0	1251
13399	10	1	51	1194	0	1256
13400	10	2	18	1241	0	1271
13401	1227	4	11	47	0	1289
13402	38	5	10	1227	0	1280
13403	14	6	1254	43	0	1317
13404	14	1	1210	14	0	1239
13405	5	1241	45	16	0	1307
13406	11	32	16	1263	0	1322
13407	11	9	1308	36	0	1364
13408	12	8	37	1284	0	1341
13409	1288	3	16	42	0	1349
13410	35	7	1331	14	0	1387
13411	14	5	38	1317	0	1374
13412	11	6	16	1351	0	1384
13413	11	3	1281	47	0	1342
13414	7	3	38	1256	0	1304
13415	6	3	1275	43	0	1327
13416	1182	3	47	17	0	1249
13417	37	7	15	1206	0	1265
13418	9	1209	12	44	0	1274
13419	1206	32	8	23	0	1269
13420	1216	10	8	17	0	1251
13421	45	1204	7	10	0	1266
13422	14	69	9	1090	0	1182
13423	13	1124	7	22	0	1166
13424	7	1145	4	15	0	1171
13425	21	26	1079	9	0	1135
13426	10	1076	20	7	0	1113
13427	9	23	924	6	0	962
13428	758	6	8	7	0	779
13429	779	1	3	3	0	786
13430	8	806	1	0	0	815
13431	5	813	0	2	0	820
13432	1	813	1	1	0	816
13433	816	10	2	1	0	829
13434	10	2	1	828	0	841
13435	3	3	877	10	0	893
13436	2	868	14	5	0	889
13437	0	14	4	911	0	929
13438	2	5	2	900	0	909
13439	0	1043	3	14	0	1060
13440	1106	17	2	5	0	1130
13441	26	3	1135	3	0	1167
13442	9	2	20	1428	0	1459
13443	3	1581	4	37	0	1625
13444	1566	48	3	3	0	1620
13445	49	8	1566	7	0	1630
13446	10	1545	43	9	0	1607
13447	5	56	9	1551	0	1621
13448	8	8	1539	45	0	1600
13449	1470	5	57	11	0	1543
13450	47	11	9	1512	0	1579
13451	8	3	1506	56	0	1573
13452	6	1492	56	8	0	1562
13453	1472	47	10	6	0	1535
13454	44	1500	7	11	0	1562
13455	1494	54	10	4	0	1562
13456	1532	22	2	4	0	1560
13457	69	10	2	1471	0	1552
13458	15	1450	6	46	0	1517
13459	15	46	1453	9	0	1523
13460	12	12	46	1429	0	1499
13461	12	12	25	1225	0	1274
13462	7	11	8	1479	0	1505
13463	6	1	10	1473	0	1490
13464	1	3	8	1491	0	1503
13465	1418	7	5	77	0	1507
13466	1403	5	1	24	0	1433
13467	1396	6	2	18	0	1422
13468	59	1392	2	13	0	1466
13469	27	44	1400	5	0	1476
13470	19	9	1403	8	0	1439
13471	13	10	1415	8	0	1446
13472	6	16	58	1332	0	1412
13473	5	3	26	1375	0	1409
13474	2	2	20	1378	0	1402
13475	2	5	1331	66	0	1404
13476	2	1296	48	36	0	1382
13477	2	42	1326	23	0	1393
13478	10	9	1347	18	0	1384
13479	11	5	66	1289	0	1371
13480	9	14	1316	52	0	1391
13481	10	10	60	1268	0	1348
13482	1271	8	24	51	0	1354
13483	1277	5	16	22	0	1320
13484	63	7	1242	9	0	1321
13485	17	6	54	1226	0	1303
13486	16	3	1240	61	0	1320
13487	16	1214	57	20	0	1307
13488	1210	52	24	17	0	1303
13489	51	14	1201	21	0	1287
13490	16	1175	66	8	0	1265
13491	13	1184	20	10	0	1227
13492	17	1171	15	14	0	1217
13493	9	62	1113	11	0	1195
13494	18	34	49	1025	0	1126
13495	14	1084	16	46	0	1160
13496	11	59	12	1079	0	1161
13497	11	16	19	1129	0	1175
13498	1072	5	16	76	0	1169
13499	50	1075	13	27	0	1165
13500	1068	53	7	29	0	1157
13501	53	1038	9	27	0	1127
13502	25	1093	10	16	0	1144
13503	17	69	1042	9	0	1137
13504	23	23	50	1012	0	1108
13505	9	27	1029	49	0	1114
13506	11	1005	56	17	0	1089
13507	9	51	1006	14	0	1080
13508	8	21	1020	23	0	1072
13509	6	996	68	18	0	1088
13510	961	59	18	24	0	1062
13511	51	976	17	24	0	1068
13512	985	55	22	17	0	1079
13513	53	27	969	15	0	1064
13514	25	13	980	21	0	1039
13515	12	972	58	14	0	1056
13516	958	53	23	13	0	1047
13517	52	949	23	28	0	1052
13518	14	52	27	957	0	1050
13519	971	29	17	50	0	1067
13520	65	12	964	17	0	1058
13521	19	19	61	972	0	1071
13522	939	11	29	57	0	1036
13523	61	961	18	21	0	1061
13524	19	51	24	969	0	1063
13525	15	17	974	62	0	1068
13526	968	11	54	25	0	1058
13527	49	16	24	973	0	1062
13528	11	15	966	60	0	1052
13529	15	15	61	935	0	1026
13530	19	971	17	51	0	1058
13531	4	48	974	28	0	1054
13532	13	12	54	975	0	1054
13533	941	10	22	63	0	1036
13534	50	16	12	950	0	1028
13535	877	9	12	55	0	953
13536	56	884	10	28	0	978
13537	871	50	12	10	0	943
13538	47	20	834	20	0	921
13539	25	10	732	9	0	776
13540	8	16	653	9	0	686
13541	14	624	48	12	0	698
13542	8	10	29	175	0	222
13543	9	1	2	153	0	165
13544	0	0	1	157	0	158
13545	0	2	0	157	0	159
13546	1	0	161	2	0	164
13547	150	0	1	1	0	152
13548	0	165	1	1	0	167
13549	167	1	1	0	0	169
13550	0	1	0	165	0	166
13551	2	166	0	0	0	168
13552	1	1	0	166	0	168
13553	165	1	2	0	0	168
13554	0	176	0	3	0	179
13555	174	0	2	0	0	176
13556	173	3	0	0	0	176
13557	2	0	1	178	0	181
13558	1	0	162	0	0	163
13559	161	0	0	1	0	162
13560	0	0	1	165	0	166
13561	167	0	0	1	0	168
13562	185	0	0	1	0	186
13563	187	0	0	0	0	187
13564	1	0	191	0	0	192
13565	1	0	1	187	0	189
13566	190	0	1	1	0	192
13567	1	0	189	1	0	191
13568	1	201	0	0	0	202
13569	0	0	2	175	0	177
13570	0	1	201	0	0	202
13571	0	1	197	1	0	199
13572	2	0	1	186	0	189
13573	0	1	3	197	0	201
13574	1	0	0	193	0	194
13575	0	0	1	188	0	189
13576	0	0	192	1	0	193
13577	0	193	0	1	0	194
13578	1	0	1	195	0	197
13579	204	1	0	0	0	205
13580	196	0	1	3	0	200
13581	201	0	0	0	0	201
13582	1	0	0	201	0	202
13583	1	0	0	199	0	200
13584	1	188	0	1	0	190
13585	0	197	0	1	0	198
13586	1	0	0	196	0	197
13587	200	0	1	1	0	202
13588	199	0	0	1	0	200
13589	201	0	0	1	0	202
13590	202	0	1	0	0	203
13591	205	0	0	1	0	206
13592	0	214	0	0	0	214
13593	0	0	1	218	0	219
13594	229	0	0	2	0	231
13595	232	0	0	0	0	232
13596	1	0	0	226	0	227
13597	1	0	0	233	0	234
13598	1	1	232	0	0	234
13599	1	0	0	227	0	228
13600	1	0	0	230	0	231
13601	0	0	248	0	0	248
13602	0	1	0	230	0	231
13603	0	247	0	0	0	247
13604	0	0	247	0	0	247
13605	0	250	0	0	0	250
13606	0	0	0	242	0	242
13607	0	0	0	252	0	252
13608	0	255	0	1	0	256
13609	0	248	0	0	0	248
13610	253	0	0	2	0	255
13611	254	0	0	1	0	255
13612	0	0	265	0	0	265
13613	275	0	0	1	0	276
13614	305	0	0	0	0	305
13615	306	0	0	0	0	306
13616	301	0	1	0	0	302
13617	0	0	299	1	0	300
13618	0	0	286	0	0	286
13619	300	0	0	1	0	301
13620	1	312	0	1	0	314
13621	0	0	310	0	0	310
13622	300	0	1	1	0	302
13623	310	0	0	0	0	310
13624	0	0	321	0	0	321
13625	312	0	0	1	0	313
13626	2	0	0	362	0	364
13627	0	0	364	0	0	364
13628	341	0	1	2	0	344
13629	1	371	1	1	0	374
13630	380	0	0	0	0	380
13631	413	0	0	1	0	414
13632	1	0	0	403	0	404
13633	0	0	1	397	0	398
13634	1	0	0	409	0	410
13635	411	0	0	1	0	412
13636	424	0	1	0	0	425
13637	3	0	0	437	0	440
13638	2	1	0	423	0	426
13639	2	0	424	2	0	428
13640	412	0	2	2	0	416
13641	2	1	0	443	0	446
13642	0	1	0	444	0	445
13643	0	433	1	8	0	442
13644	2	5	0	443	0	450
13645	1	1	0	443	0	445
13646	439	0	0	8	0	447
13647	6	440	0	2	0	448
13648	3	5	1	445	0	454
13649	0	1	0	443	0	444
13650	0	0	0	440	0	440
13651	1	1	436	7	0	445
13652	1	1	5	431	0	438
13653	420	0	1	8	0	429
13654	5	0	433	4	0	442
13655	2	1	6	430	0	439
13656	0	1	1	446	0	448
13657	437	0	0	10	0	447
13658	433	0	2	2	0	437
13659	7	1	444	1	0	453
13660	408	1	4	3	0	416
13661	5	1	447	3	0	456
13662	431	1	5	2	0	439
13663	6	475	3	2	0	486
13664	486	8	0	4	0	498
13665	10	495	0	1	0	506
13666	503	10	1	1	0	515
13667	8	501	0	6	0	515
13668	1	10	1	517	0	529
13669	1	1	0	517	0	519
13670	1	1	2	519	0	523
13671	1	513	1	12	0	527
13672	2	11	0	518	0	531
13673	1	520	1	9	0	531
13674	2	9	0	528	0	539
13675	530	2	0	10	0	542
13676	534	2	0	2	0	538
13677	9	523	0	2	0	534
13678	3	9	1	527	0	540
13679	528	2	0	10	0	540
13680	9	517	2	2	0	530
13681	1	541	0	3	0	545
13682	538	11	0	1	0	550
13683	552	2	0	2	0	556
13684	12	538	0	5	0	555
13685	546	10	0	1	0	557
13686	11	3	0	539	0	553
13687	2	1	565	11	0	579
13688	564	0	9	2	0	575
13689	571	1	2	2	0	576
13690	12	1	576	1	0	590
13691	572	0	9	3	0	584
13692	589	2	1	2	0	594
13693	621	2	1	2	0	626
13694	12	601	0	1	0	614
13695	628	11	0	3	0	642
13696	637	2	1	3	0	643
13697	15	1	0	622	0	638
13698	5	3	0	637	0	645
13699	4	1	2	656	0	663
13700	645	1	0	19	0	665
13701	13	0	3	635	0	651
13702	647	0	1	14	0	662
13703	659	1	1	4	0	665
13704	14	1	3	657	0	675
13705	9	0	0	673	0	682
13706	6	2	1	683	0	692
13707	682	1	0	17	0	700
13708	14	667	1	5	0	687
13709	7	12	1	691	0	711
13710	7	2	0	708	0	717
13711	683	2	1	21	0	707
13712	677	1	1	7	0	686
13713	14	1	638	10	0	663
13714	9	0	650	3	0	662
13715	691	1	14	6	0	712
13716	18	2	1	711	0	732
13717	5	2	1	912	0	920
13718	4	0	908	28	0	940
13719	5	1	19	885	0	910
13720	2	914	3	26	0	945
13721	7	955	2	7	0	971
13722	927	24	2	4	0	957
13723	22	2	940	6	0	970
13724	4	952	20	7	0	983
13725	7	20	1	975	0	1003
13726	12	2	933	26	0	973
13727	4	4	24	910	0	942
13728	4	2	6	938	0	950
13729	4	3	930	26	0	963
13730	3	916	22	14	0	955
13731	4	23	2	905	0	934
13732	904	2	5	25	0	936
13733	923	3	4	9	0	939
13734	928	4	1	4	0	937
13735	28	915	2	7	0	952
13736	900	21	2	2	0	925
13737	30	3	5	890	0	928
13738	6	6	903	23	0	938
13739	873	2	17	8	0	900
13740	27	889	6	6	0	928
13741	2	18	3	893	0	916
13742	2	2	2	905	0	911
13743	4	888	6	16	0	914
13744	3	24	1	893	0	921
13745	5	3	1	898	0	907
13746	7	3	2	919	0	931
13747	893	4	4	24	0	925
13748	891	2	4	9	0	906
13749	16	5	908	9	0	938
13750	7	3	17	905	0	932
13751	5	3	2	934	0	944
13752	8	3	8	937	0	956
13753	930	4	5	22	0	961
13754	19	5	904	10	0	938
13755	894	3	18	10	0	925
13756	937	1	3	13	0	954
13757	25	4	5	918	0	952
13758	918	2	4	28	0	952
13759	27	4	897	7	0	935
13760	871	4	19	10	0	904
13761	32	940	3	5	0	980
13762	11	17	929	7	0	964
13763	9	4	943	4	0	960
13764	9	3	20	928	0	960
13765	3	5	939	25	0	972
13766	892	6	19	12	0	929
13767	19	919	3	11	0	952
13768	929	16	8	11	0	964
13769	21	5	5	961	0	992
13770	14	5	953	19	0	991
13771	6	4	959	10	0	979
13772	10	6	20	965	0	1001
13773	978	2	5	29	0	1014
13774	16	964	6	15	0	1001
13775	5	1007	6	12	0	1030
13776	984	21	7	11	0	1023
13777	24	986	12	9	0	1031
13778	1007	18	5	8	0	1038
13779	25	5	10	995	0	1035
13780	1010	2	6	22	0	1040
13781	21	13	3	1000	0	1037
13782	1001	5	0	22	0	1028
13783	24	3	3	989	0	1019
13784	9	982	9	21	0	1021
13785	988	16	8	6	0	1018
13786	21	985	6	9	0	1021
13787	12	15	953	10	0	990
13788	8	6	18	911	0	943
13789	9	978	3	11	0	1001
13790	946	21	4	4	0	975
13791	942	8	3	4	0	957
13792	15	948	6	9	0	978
13793	9	17	946	7	0	979
13794	10	2	20	916	0	948
13795	9	925	9	20	0	963
13796	9	19	3	953	0	984
13797	11	7	2	967	0	987
13798	935	9	1	22	0	967
13799	23	936	2	5	0	966
13800	6	20	4	947	0	977
13801	946	7	8	20	0	981
13802	944	1	7	10	0	962
13803	939	5	1	10	0	955
13804	23	9	2	918	0	952
13805	921	4	5	17	0	947
13806	23	907	2	6	0	938
13807	900	19	3	5	0	927
13808	17	920	3	10	0	950
13809	913	14	7	8	0	942
13810	904	6	4	11	0	925
13811	19	9	6	889	0	923
13812	11	2	897	21	0	931
13813	15	9	862	4	0	890
13814	8	881	11	7	0	907
13815	827	19	4	5	0	855
13816	21	4	828	1	0	854
13817	604	3	6	0	0	613
13818	8	610	1	3	0	622
13819	6	632	0	4	0	642
13820	4	8	0	623	0	635
13821	4	656	1	6	0	667
13822	4	9	681	3	0	697
13823	4	14	6	654	0	678
13824	6	702	3	7	0	718
13825	4	12	0	712	0	728
13826	711	5	3	16	0	735
13827	13	3	6	717	0	739
13828	4	4	734	17	0	759
13829	5	746	14	3	0	768
13830	3	18	6	741	0	768
13831	4	3	4	757	0	768
13832	3	7	0	768	0	778
13833	745	4	1	22	0	772
13834	749	2	0	12	0	763
13835	21	6	760	4	0	791
13836	7	4	761	1	0	773
13837	2	759	22	5	0	788
13838	751	20	5	3	0	779
13839	17	6	2	759	0	784
13840	7	3	0	764	0	774
13841	7	0	0	771	0	778
13842	2	1	4	769	0	776
13843	2	4	736	21	0	763
13844	706	3	19	9	0	737
13845	20	0	3	833	0	856
13846	4	2	823	31	0	860
13847	842	0	22	12	0	876
13848	942	3	5	5	0	955
13849	40	0	1023	4	0	1067
13850	15	2	1080	0	0	1097
13851	6	4	40	1052	0	1102
13852	1061	3	17	32	0	1113
13853	1087	2	7	16	0	1112
13854	44	1	4	1044	0	1093
13855	15	0	4	1084	0	1103
13856	4	1	1049	48	0	1102
13857	6	2	30	1049	0	1087
13858	11	1	1050	36	0	1098
13859	1002	2	35	23	0	1062
13860	30	1056	21	13	0	1120
13861	1037	31	6	8	0	1082
13862	36	1037	6	2	0	1081
13863	1026	33	1	10	0	1070
13864	34	13	7	996	0	1050
13865	20	4	4	1017	0	1045
13866	995	6	3	46	0	1050
13867	1017	1	5	16	0	1039
13868	1016	5	4	7	0	1032
13869	1002	3	1	10	0	1016
13870	54	4	943	7	0	1008
13871	956	1	34	5	0	996
13872	973	1	14	8	0	996
13873	975	1	8	7	0	991
13874	50	0	6	942	0	998
13875	918	3	2	37	0	960
13876	40	916	4	13	0	973
13877	24	31	0	918	0	973
13878	13	13	1	948	0	975
13879	14	5	916	45	0	980
13880	8	4	33	906	0	951
13881	16	896	15	37	0	964
13882	896	34	10	18	0	958
13883	40	905	7	8	0	960
13884	917	38	2	14	0	971
13885	45	18	7	908	0	978
13886	896	7	4	37	0	944
13887	39	879	5	22	0	945
13888	896	26	5	16	0	943
13889	904	18	7	15	0	944
13890	51	8	4	870	0	933
13891	26	9	6	902	0	943
13892	21	4	878	47	0	950
13893	15	9	30	875	0	929
13894	16	6	16	891	0	929
13895	14	8	845	52	0	919
13896	14	6	33	868	0	921
13897	15	2	852	47	0	916
13898	838	4	33	29	0	904
13899	45	2	15	852	0	914
13900	23	5	828	41	0	897
13901	833	3	37	18	0	891
13902	50	5	14	831	0	900
13903	23	3	840	40	0	906
13904	854	1	39	18	0	912
13905	45	5	15	850	0	915
13906	28	3	8	872	0	911
13907	839	4	8	54	0	905
13908	43	1	6	842	0	892
13909	21	4	5	867	0	897
13910	13	3	6	838	0	860
13911	12	821	4	53	0	890
13912	812	32	8	32	0	884
13913	846	11	6	14	0	877
13914	46	8	3	822	0	879
13915	827	6	3	46	0	882
13916	848	6	6	24	0	884
13917	854	6	4	14	0	878
13918	672	10	6	22	0	710
13919	838	3	6	9	0	856
13920	55	5	762	16	0	838
13921	28	4	737	14	0	783
13922	693	4	37	13	0	747
13923	42	676	18	16	0	752
13924	16	23	6	648	0	693
13925	12	8	640	31	0	691
13926	11	8	660	17	0	696
13927	10	13	33	632	0	688
13928	633	3	35	26	0	697
13929	27	4	8	640	0	679
13930	18	2	635	26	0	681
13931	650	2	21	20	0	693
13932	27	2	15	650	0	694
13933	17	1	10	655	0	683
13934	16	1	11	665	0	693
13935	14	0	3	648	0	665
13936	9	2	617	40	0	668
13937	13	0	20	622	0	655
13938	610	1	17	32	0	660
13939	24	1	592	29	0	646
13940	598	2	22	19	0	641
13941	630	2	9	14	0	655
13942	623	3	9	12	0	647
13943	618	0	8	15	0	641
13944	39	592	4	11	0	646
13945	20	496	5	11	0	532
13946	18	518	2	6	0	544
13947	450	35	8	8	0	501
13948	15	6	422	6	0	449
13949	273	5	11	9	0	298
13950	8	0	1	258	0	267
13951	253	0	1	5	0	259
13952	4	0	1	254	0	259
13953	273	0	1	6	0	280
13954	7	0	0	270	0	277
13955	3	0	1	301	0	305
13956	293	0	1	3	0	297
13957	5	322	1	3	0	331
13958	3	4	321	3	0	331
13959	5	321	3	0	0	329
13960	1	3	298	1	0	303
13961	1	9	5	254	0	269
13962	265	1	3	3	0	272
13963	2	0	1	261	0	264
13964	259	0	0	4	0	263
13965	2	282	0	2	0	286
13966	1	2	295	2	0	300
13967	1	288	3	1	0	293
13968	0	295	0	2	0	297
13969	280	2	5	0	0	287
13970	278	2	1	0	0	281
13971	3	280	1	1	0	285
13972	2	3	0	275	0	280
13973	2	0	1	284	0	287
13974	284	1	0	3	0	288
13975	3	1	286	1	0	291
13976	0	1	292	2	0	295
13977	2	1	3	287	0	293
13978	1	0	299	3	0	303
13979	280	0	5	0	0	285
13980	299	1	0	1	0	301
13981	4	298	1	1	0	304
13982	2	5	320	1	0	328
13983	1	0	5	318	0	324
13984	1	2	341	4	0	348
13985	0	0	5	332	0	337
13986	331	0	0	7	0	338
13987	6	353	1	1	0	361
13988	1	5	369	1	0	376
13989	0	361	7	0	0	368
13990	0	373	0	1	0	374
13991	368	5	4	0	0	377
13992	365	1	1	1	0	368
13993	9	1	372	0	0	382
13994	1	370	4	2	0	377
13995	2	5	1	372	0	380
13996	0	1	1	378	0	380
13997	0	1	0	369	0	370
13998	0	1	382	6	0	389
13999	1	1	5	375	0	382
14000	2	1	0	391	0	394
14001	410	0	2	5	0	417
14002	413	1	0	1	0	415
14003	397	1	0	3	0	401
14004	394	0	0	1	0	395
14005	401	0	0	0	0	401
14006	5	389	2	0	0	396
14007	386	7	1	0	0	394
14008	7	1	391	2	0	401
14009	2	1	6	383	0	392
14010	390	0	1	6	0	397
14011	7	392	2	0	0	401
14012	394	6	0	4	0	404
14013	406	0	1	3	0	410
14014	6	1	0	418	0	425
14015	4	0	1	417	0	422
14016	1	449	0	8	0	458
14017	2	5	0	464	0	471
14018	3	1	480	6	0	490
14019	1	2	6	481	0	490
14020	2	1	490	6	0	499
14021	475	2	6	1	0	484
14022	7	0	1	496	0	504
14023	2	1	521	7	0	531
14024	3	504	7	1	0	515
14025	1	525	2	1	0	529
14026	506	6	1	2	0	515
14027	6	2	0	501	0	509
14028	2	1	507	6	0	516
14029	1	515	5	3	0	524
14030	2	5	509	0	0	516
14031	492	2	4	3	0	501
14032	512	0	3	0	0	515
14033	508	2	0	2	0	512
14034	5	1	2	521	0	529
14035	2	0	533	4	0	539
14036	1	530	4	3	0	538
14037	0	4	4	541	0	549
14038	1	2	537	4	0	544
14039	0	2	517	3	0	522
14040	1	0	6	540	0	547
14041	554	0	2	9	0	565
14042	4	2	2	557	0	565
14043	2	0	1	570	0	573
14044	2	0	588	7	0	597
14045	4	0	5	579	0	588
14046	3	0	1	580	0	584
14047	2	0	595	6	0	603
14048	2	0	578	3	0	583
14049	2	1	7	569	0	579
14050	1	2	587	5	0	595
14051	2	0	5	591	0	598
14052	588	1	4	6	0	599
14053	4	590	2	3	0	599
14054	3	5	0	598	0	606
14055	2	3	565	5	0	575
14056	489	0	5	8	0	502
14057	5	530	2	3	0	540
14058	537	4	1	3	0	545
14059	4	2	0	537	0	543
14060	1	1	1	539	0	542
14061	547	0	2	8	0	557
14062	4	1	547	3	0	555
14063	533	0	6	4	0	543
14064	4	0	4	557	0	565
14065	538	0	1	6	0	545
14066	532	1	0	5	0	538
14067	5	1	1	541	0	548
14068	2	558	2	6	0	568
14069	573	5	1	5	0	584
14070	571	4	2	1	0	578
14071	10	3	581	1	0	595
14072	576	1	7	3	0	587
14073	9	1	4	584	0	598
14074	3	596	2	8	0	609
14075	5	4	2	591	0	602
14076	4	587	1	6	0	598
14077	592	6	1	4	0	603
14078	587	2	0	3	0	592
14079	10	2	3	613	0	628
14080	6	0	616	4	0	626
14081	2	1	599	4	0	606
14082	2	1	7	630	0	640
14083	626	1	3	4	0	634
14084	684	0	2	7	0	693
14085	13	695	4	1	0	713
14086	8	15	2	702	0	727
14087	2	6	702	16	0	726
14088	2	3	721	5	0	731
14089	3	4	21	789	0	817
14090	919	2	8	20	0	949
14091	23	0	2	939	0	964
14092	8	1	935	25	0	969
14093	919	0	22	13	0	954
14094	21	0	11	931	0	963
14095	9	1	5	958	0	973
14096	6	0	2	939	0	947
14097	6	925	4	25	0	960
14098	2	21	930	15	0	968
14099	3	6	938	7	0	954
14100	2	4	29	942	0	977
14101	0	1	939	27	0	967
14102	926	2	26	10	0	964
14103	25	1	9	945	0	980
14104	9	3	5	953	0	970
14105	4	4	5	950	0	963
14106	3	959	5	28	0	995
14107	991	20	3	13	0	1027
14108	25	7	3	994	0	1029
14109	985	3	1	26	0	1015
14110	26	990	1	13	0	1030
14111	993	26	3	6	0	1028
14112	964	8	2	6	0	980
14113	983	5	1	7	0	996
14114	33	944	2	7	0	986
14115	14	953	3	4	0	974
14116	917	28	1	4	0	950
14117	27	917	3	6	0	953
14118	14	28	877	5	0	924
14119	5	871	23	8	0	907
14120	4	911	10	4	0	929
14121	885	29	4	8	0	926
14122	23	15	880	2	0	920
14123	10	6	872	3	0	891
14124	4	5	33	850	0	892
14125	865	3	12	27	0	907
14126	26	3	881	9	0	919
14127	9	4	26	885	0	924
14128	6	1	857	29	0	893
14129	1	6	844	16	0	867
14130	827	1	32	6	0	866
14131	23	3	846	6	0	878
14132	15	0	27	829	0	871
14133	5	3	11	838	0	857
14134	8	836	6	28	0	878
14135	9	875	4	5	0	893
14136	9	27	5	841	0	882
14137	7	12	865	27	0	911
14138	3	9	25	856	0	893
14139	6	7	5	887	0	905
14140	4	8	870	29	0	911
14141	4	2	27	866	0	899
14142	864	7	7	30	0	908
14143	25	4	865	15	0	909
14144	851	6	26	8	0	891
14145	25	5	9	863	0	902
14146	11	1	8	883	0	903
14147	7	887	8	33	0	935
14148	7	23	5	887	0	922
14149	9	6	4	934	0	953
14150	922	4	7	35	0	968
14151	27	1	6	930	0	964
14152	8	3	6	949	0	966
14153	935	3	4	35	0	977
14154	26	4	4	939	0	973
14155	16	2	3	916	0	937
14156	5	927	8	31	0	971
14157	931	24	4	19	0	978
14158	23	11	4	937	0	975
14159	9	8	3	952	0	972
14160	9	4	929	32	0	974
14161	4	2	22	917	0	945
14162	3	1	12	937	0	953
14163	902	2	5	39	0	948
14164	934	2	5	19	0	960
14165	33	2	7	919	0	961
14166	11	1	895	34	0	941
14167	10	862	28	13	0	913
14168	5	893	8	13	0	919
14169	10	27	5	878	0	920
14170	878	10	3	29	0	920
14171	27	3	2	882	0	914
14172	884	5	0	34	0	923
14173	29	5	4	882	0	920
14174	7	5	0	899	0	911
14175	866	3	2	37	0	908
14176	867	3	2	16	0	888
14177	31	865	1	9	0	906
14178	10	892	0	13	0	915
14179	7	30	2	834	0	873
14180	9	7	1	854	0	871
14181	5	6	818	34	0	863
14182	750	2	26	15	0	793
14183	24	787	7	13	0	831
14184	7	751	4	9	0	771
14185	713	15	7	11	0	746
14186	17	7	708	5	0	737
14187	6	4	705	5	0	720
14188	6	7	667	5	0	685
14189	9	596	23	4	0	632
14190	5	5	2	483	0	495
14191	0	1	1	471	0	473
14192	2	1	0	477	0	480
14193	461	0	0	6	0	467
14194	460	1	1	2	0	464
14195	6	467	1	0	0	474
14196	1	5	2	469	0	477
14197	1	1	487	5	0	494
14198	1	498	6	3	0	508
14199	487	7	0	1	0	495
14200	6	0	495	4	0	505
14201	443	1	5	8	0	457
14202	7	3	480	1	0	491
14203	2	1	3	472	0	478
14204	2	488	1	6	0	497
14205	495	6	1	1	0	503
14206	6	498	0	2	0	506
14207	471	4	1	3	0	479
14208	4	4	1	469	0	478
14209	4	0	484	6	0	494
14210	3	0	6	484	0	493
14211	3	1	0	542	0	546
14212	0	2	548	7	0	557
14213	514	0	5	4	0	523
14214	7	548	0	2	0	557
14215	556	7	1	2	0	566
14216	7	567	0	2	0	576
14217	1	8	1	573	0	583
14218	3	0	571	6	0	580
14219	658	1	7	3	0	669
14220	13	676	1	15	0	705
14221	3	13	3	685	0	704
14222	2	4	2	714	0	722
14223	711	2	0	21	0	734
14224	775	2	0	4	0	781
14225	21	782	0	4	0	807
14226	858	17	1	6	0	882
14227	864	3	2	2	0	871
14228	885	5	1	1	0	892
14229	32	3	888	2	0	925
14230	10	860	23	4	0	897
14231	9	910	9	1	0	929
14232	4	29	3	874	0	910
14233	5	11	2	893	0	911
14234	873	3	2	30	0	908
14235	23	861	1	13	0	898
14236	873	24	1	3	0	901
14237	28	9	1	848	0	886
14238	11	6	1	876	0	894
14239	847	4	2	30	0	883
14240	852	3	1	13	0	869
14241	32	2	834	7	0	875
14242	13	1	24	831	0	869
14243	5	2	824	23	0	854
14244	3	2	816	9	0	830
14245	4	2	819	6	0	831
14246	769	1	38	5	0	813
14247	25	6	10	762	0	803
14248	9	2	6	765	0	782
14249	7	1	3	788	0	799
14250	7	3	761	34	0	805
14251	5	1	23	772	0	801
14252	3	2	11	782	0	798
14253	741	1	11	34	0	787
14254	761	4	2	12	0	779
14255	780	1	3	5	0	789
14256	781	1	2	6	0	790
14257	40	2	1	752	0	795
14258	766	4	1	25	0	796
14259	29	2	2	766	0	799
14260	13	4	729	32	0	778
14261	745	2	20	15	0	782
14262	30	757	9	8	0	804
14263	20	23	5	735	0	783
14264	10	11	4	757	0	782
14265	11	750	1	28	0	790
14266	749	24	3	14	0	790
14267	27	743	3	12	0	785
14268	11	26	743	4	0	784
14269	7	12	753	8	0	780
14270	731	6	30	4	0	771
14271	757	2	13	7	0	779
14272	35	3	740	4	0	782
14273	737	3	20	5	0	765
14274	32	3	740	5	0	780
14275	733	2	26	10	0	771
14276	29	2	732	7	0	770
14277	15	4	732	5	0	756
14278	10	2	29	687	0	728
14279	3	2	16	697	0	718
14280	706	1	8	32	0	747
14281	696	5	9	15	0	725
14282	708	0	4	11	0	723
14283	730	4	4	7	0	745
14284	33	690	4	8	0	735
14285	24	19	2	678	0	723
14286	15	689	0	26	0	730
14287	10	26	6	681	0	723
14288	11	10	6	683	0	710
14289	6	6	5	682	0	699
14290	7	4	653	36	0	700
14291	640	4	25	19	0	688
14292	31	637	11	8	0	687
14293	19	665	8	10	0	702
14294	11	29	665	10	0	715
14295	9	11	23	659	0	702
14296	10	9	15	672	0	706
14297	642	5	10	35	0	692
14298	29	4	4	643	0	680
14299	19	3	7	658	0	687
14300	11	4	4	661	0	680
14301	12	3	3	670	0	688
14302	632	4	5	39	0	680
14303	649	3	8	19	0	679
14304	652	2	5	10	0	669
14305	36	6	6	633	0	681
14306	635	1	11	24	0	671
14307	32	2	8	643	0	685
14308	20	3	7	678	0	708
14309	15	2	641	32	0	690
14310	12	1	636	18	0	667
14311	8	4	602	12	0	626
14312	576	1	36	12	0	625
14313	23	4	14	550	0	591
14314	13	575	13	24	0	625
14315	585	18	11	12	0	626
14316	26	10	572	12	0	620
14317	579	3	20	10	0	612
14318	30	556	10	8	0	604
14319	467	11	3	6	0	487
14320	19	7	4	455	0	485
14321	463	3	1	15	0	482
14322	16	445	6	11	0	478
14323	8	444	3	5	0	460
14324	383	14	2	6	0	405
14325	12	380	3	3	0	398
14326	5	278	0	1	0	284
14327	2	275	2	1	0	280
14328	258	3	6	3	0	270
14329	239	1	0	1	0	241
14330	241	1	0	1	0	243
14331	2	2	0	241	0	245
14332	1	2	0	243	0	246
14333	2	1	242	1	0	246
14334	3	0	1	241	0	245
14335	2	1	243	1	0	247
14336	1	0	1	244	0	246
14337	0	1	0	250	0	251
14338	246	0	1	3	0	250
14339	244	0	1	2	0	247
14340	1	246	1	2	0	250
14341	0	1	2	245	0	248
14342	1	1	256	3	0	261
14343	1	2	1	250	0	254
14344	3	1	0	250	0	254
14345	0	2	1	253	0	256
14346	1	2	248	3	0	254
14347	0	1	244	2	0	247
14348	255	0	2	1	0	258
14349	2	0	0	258	0	260
14350	1	0	249	5	0	255
14351	242	0	2	3	0	247
14352	1	257	2	2	0	262
14353	262	2	2	0	0	266
14354	4	0	261	2	0	267
14355	248	1	3	1	0	253
14356	2	1	1	255	0	259
14357	2	2	262	2	0	268
14358	3	259	1	1	0	264
14359	257	1	1	2	0	261
14360	3	1	2	255	0	261
14361	0	0	1	265	0	266
14362	0	267	3	3	0	273
14363	1	2	2	268	0	273
14364	1	1	268	4	0	274
14365	1	267	2	2	0	272
14366	272	1	1	3	0	277
14367	1	1	2	263	0	267
14368	1	1	0	262	0	264
14369	1	2	254	3	0	260
14370	1	2	3	259	0	265
14371	2	1	262	3	0	268
14372	2	265	2	1	0	270
14373	265	2	1	4	0	272
14374	258	0	2	2	0	262
14375	267	0	1	2	0	270
14376	2	290	2	3	0	297
14377	0	3	4	304	0	311
14378	2	2	0	308	0	312
14379	3	0	1	276	0	280
14380	309	0	1	3	0	313
14381	310	1	0	0	0	311
14382	2	3	0	308	0	313
14383	1	0	331	5	0	337
14384	0	0	4	334	0	338
14385	3	1	0	338	0	342
14386	3	0	0	336	0	339
14387	1	0	1	345	0	347
14388	341	1	0	5	0	347
14389	5	0	2	341	0	348
14390	1	0	0	342	0	343
14391	0	339	1	5	0	345
14392	0	5	0	355	0	360
14393	2	365	0	6	0	373
14394	2	7	1	366	0	376
14395	358	1	0	10	0	369
14396	8	371	0	1	0	380
14397	360	8	0	2	0	370
14398	7	1	368	3	0	379
14399	0	1	8	362	0	371
14400	1	0	365	9	0	375
14401	1	1	8	371	0	381
14402	1	2	0	375	0	378
14403	2	365	2	4	0	373
14404	1	381	1	2	0	385
14405	1	386	0	2	0	389
14406	380	6	3	1	0	390
14407	6	365	0	3	0	374
14408	2	357	0	1	0	360
14409	0	6	1	350	0	357
14410	356	0	0	8	0	364
14411	7	381	0	2	0	390
14412	387	6	0	4	0	397
14413	386	1	1	1	0	389
14414	7	1	386	2	0	396
14415	3	1	6	363	0	373
14416	0	2	0	391	0	393
14417	1	0	0	386	0	387
14418	1	0	1	388	0	390
14419	0	1	382	8	0	391
14420	0	0	358	1	0	359
14421	342	0	4	2	0	348
14422	6	363	0	0	0	369
14423	1	374	0	0	0	375
14424	370	6	0	0	0	376
14425	6	366	1	0	0	373
14426	1	5	0	370	0	376
14427	370	0	0	7	0	377
14428	6	0	381	1	0	388
14429	0	0	6	371	0	377
14430	0	0	375	6	0	381
14431	354	0	6	1	0	361
14432	7	0	405	0	0	412
14433	394	1	5	0	0	400
14434	405	1	0	0	0	406
14435	409	0	0	0	0	409
14436	410	1	0	1	0	412
14437	412	0	0	2	0	414
14438	7	0	0	403	0	410
14439	425	0	1	7	0	433
14440	6	0	0	430	0	436
14441	0	0	1	427	0	428
14442	1	0	0	428	0	429
14443	0	0	424	6	0	430
14444	1	0	6	403	0	410
14445	1	0	0	429	0	430
14446	1	0	425	6	0	432
14447	384	0	6	0	0	390
14448	7	0	0	433	0	440
14449	0	0	437	7	0	444
14450	1	0	426	1	0	428
14451	0	0	5	422	0	427
14452	1	0	455	7	0	463
14453	0	1	6	463	0	470
14454	0	0	1	477	0	478
14455	0	464	0	6	0	470
14456	1	483	0	1	0	485
14457	475	6	1	1	0	483
14458	7	0	0	476	0	483
14459	0	0	0	477	0	477
14460	0	0	1	476	0	477
14461	0	0	489	6	0	495
14462	0	0	6	475	0	481
14463	486	0	0	7	0	493
14464	7	0	500	1	0	508
14465	0	0	6	512	0	518
14466	0	1	0	521	0	522
14467	0	0	0	523	0	523
14468	1	538	0	4	0	543
14469	540	8	0	1	0	549
14470	560	0	0	8	0	568
14471	8	609	0	1	0	618
14472	0	7	1	663	0	671
14473	2	0	680	9	0	691
14474	3	0	653	0	0	656
14475	679	0	10	0	0	689
14476	11	0	0	685	0	696
14477	727	0	0	12	0	739
14478	13	735	0	2	0	750
14479	4	756	1	3	0	764
14480	748	18	2	1	0	769
14481	16	776	1	2	0	795
14482	6	15	0	787	0	808
14483	2	4	0	769	0	775
14484	2	811	1	18	0	832
14485	825	17	1	4	0	847
14486	17	6	833	0	0	856
14487	793	2	13	5	0	813
14488	15	1	843	3	0	862
14489	779	2	13	5	0	799
14490	14	3	836	1	0	854
14491	8	828	14	1	0	851
14492	4	15	7	818	0	844
14493	824	3	3	9	0	839
14494	12	0	814	4	0	830
14495	6	2	816	1	0	825
14496	3	0	15	798	0	816
14497	0	1	856	9	0	866
14498	1	1	8	831	0	841
14499	3	1	6	817	0	827
14500	2	0	850	15	0	867
14501	0	2	14	821	0	837
14502	858	0	7	14	0	879
14503	10	873	2	8	0	893
14504	875	9	3	6	0	893
14505	9	5	1	867	0	882
14506	876	1	3	11	0	891
14507	882	1	5	8	0	896
14508	19	2	1	869	0	891
14509	8	888	1	9	0	906
14510	893	11	1	5	0	910
14511	15	5	854	2	0	876
14512	8	2	852	1	0	863
14513	829	2	14	5	0	850
14514	14	2	5	859	0	880
14515	6	3	860	13	0	882
14516	2	3	12	856	0	873
14517	867	1	9	11	0	888
14518	890	0	4	9	0	903
14519	876	2	6	3	0	887
14520	17	899	2	4	0	922
14521	7	9	5	900	0	921
14522	4	6	4	894	0	908
14523	893	0	2	17	0	912
14524	16	893	0	6	0	915
14525	894	12	1	4	0	911
14526	17	6	0	881	0	904
14527	885	2	3	13	0	903
14528	13	2	858	6	0	879
14529	10	871	10	4	0	895
14530	8	15	5	858	0	886
14531	5	917	1	11	0	934
14532	6	9	2	889	0	906
14533	880	5	5	12	0	902
14534	16	2	869	6	0	893
14535	850	3	11	1	0	865
14536	9	905	7	2	0	923
14537	7	10	3	904	0	924
14538	4	6	2	913	0	925
14539	893	0	1	17	0	911
14540	17	1	889	5	0	912
14541	7	3	11	892	0	913
14542	5	3	4	878	0	890
14543	4	2	1	898	0	905
14544	4	1	4	899	0	908
14545	886	2	3	15	0	906
14546	873	2	3	7	0	885
14547	16	0	884	7	0	907
14548	8	1	857	7	0	873
14549	894	1	13	6	0	914
14550	927	2	5	7	0	941
14551	19	2	2	917	0	940
14552	15	2	3	893	0	913
14553	880	4	5	14	0	903
14554	14	863	4	11	0	892
14555	9	8	4	875	0	896
14556	12	6	2	879	0	899
14557	4	3	872	17	0	896
14558	5	5	9	868	0	887
14559	4	2	885	19	0	910
14560	9	2	10	882	0	903
14561	846	4	9	13	0	872
14562	11	1	3	861	0	876
14563	5	1	853	18	0	877
14564	2	826	15	10	0	853
14565	3	9	8	866	0	886
14566	6	4	865	14	0	889
14567	6	865	11	9	0	891
14568	6	6	6	863	0	881
14569	1	7	857	11	0	876
14570	710	5	10	11	0	736
14571	12	798	6	6	0	822
14572	8	766	2	5	0	781
14573	3	753	8	3	0	767
14574	9	15	2	731	0	757
14575	8	6	750	11	0	775
14576	3	738	8	12	0	761
14577	2	10	6	730	0	748
14578	806	6	4	7	0	823
14579	6	3	2	1081	0	1092
14580	6	4	1320	14	0	1344
14581	1	1321	27	7	0	1356
14582	1287	27	7	9	0	1330
14583	26	1308	10	7	0	1351
14584	12	30	1259	5	0	1306
14585	4	1253	27	14	0	1298
14586	3	42	4	1230	0	1279
14587	4	15	1239	27	0	1285
14588	3	1245	33	9	0	1290
14589	2	38	12	1223	0	1275
14590	8	14	4	1222	0	1248
14591	1	1248	4	33	0	1286
14592	5	30	12	1245	0	1292
14593	1	17	1232	36	0	1286
14594	3	5	1258	18	0	1284
14595	2	11	41	1232	0	1286
14596	1221	13	8	38	0	1280
14597	1220	11	6	16	0	1253
14598	33	6	10	1190	0	1239
14599	7	1209	7	30	0	1253
14600	5	31	7	1218	0	1261
14601	1196	7	19	35	0	1257
14602	27	9	10	1191	0	1237
14603	9	7	2	1209	0	1227
14604	1176	6	2	45	0	1229
14605	34	1168	5	14	0	1221
14606	7	33	2	1171	0	1213
14607	1150	13	8	41	0	1212
14608	35	4	1135	17	0	1191
14609	1140	4	28	13	0	1185
14610	34	4	5	1156	0	1199
14611	1142	5	3	39	0	1189
14612	1169	5	8	16	0	1198
14613	1065	17	3	16	0	1101
14614	33	1125	7	22	0	1187
14615	22	27	1114	10	0	1173
14616	10	1124	33	12	0	1179
14617	1116	31	4	13	0	1164
14618	40	1105	4	14	0	1163
14619	20	38	2	1110	0	1170
14620	1088	12	5	36	0	1141
14621	45	1083	5	10	0	1143
14622	11	40	1088	7	0	1146
14623	15	8	36	1094	0	1153
14624	10	13	1090	36	0	1149
14625	20	1097	33	8	0	1158
14626	16	41	6	1070	0	1133
14627	15	7	7	1120	0	1149
14628	13	12	6	1104	0	1135
14629	6	14	12	1054	0	1086
14630	5	1077	11	34	0	1127
14631	1050	32	4	27	0	1113
14632	34	15	1045	9	0	1103
14633	8	17	28	1056	0	1109
14634	1043	6	7	45	0	1101
14635	32	13	1041	20	0	1106
14636	11	1028	37	13	0	1089
14637	10	36	9	1031	0	1086
14638	10	15	1041	32	0	1098
14639	10	1046	40	12	0	1108
14640	1006	35	18	17	0	1076
14641	33	1032	5	23	0	1093
14642	16	37	8	1031	0	1092
14643	5	16	13	1067	0	1101
14644	1014	22	8	49	0	1093
14645	37	1029	6	23	0	1095
14646	14	36	18	1044	0	1112
14647	1008	22	12	43	0	1085
14648	1008	12	6	19	0	1045
14649	38	989	11	15	0	1053
14650	979	46	4	21	0	1050
14651	1012	16	11	18	0	1057
14652	46	17	12	979	0	1054
14653	14	21	976	40	0	1051
14654	18	9	32	965	0	1024
14655	20	18	8	988	0	1034
14656	20	8	947	49	0	1024
14657	10	927	30	38	0	1005
14658	19	39	9	942	0	1009
14659	17	10	5	981	0	1013
14660	11	9	10	989	0	1019
14661	9	10	11	959	0	989
14662	8	943	6	61	0	1018
14663	963	35	5	24	0	1027
14664	979	9	8	22	0	1018
14665	956	12	1	16	0	985
14666	41	911	6	22	0	980
14667	18	30	4	904	0	956
14668	20	10	894	46	0	970
14669	15	11	32	861	0	919
14670	10	908	7	34	0	959
14671	885	27	4	18	0	934
14672	885	14	5	15	0	919
14673	877	10	4	18	0	909
14674	37	854	8	15	0	914
14675	18	815	6	19	0	858
14676	18	830	11	8	0	867
14677	13	32	782	16	0	843
14678	20	28	681	14	0	743
14679	30	101	28	279	0	438
14680	154	1	8	3	0	166
14681	141	2	0	0	0	143
14682	3	0	0	147	0	150
14683	1	0	1	145	0	147
14684	1	1	0	149	0	151
14685	1	1	0	152	0	154
14686	151	1	0	3	0	155
14687	162	0	0	2	0	164
14688	2	161	0	2	0	165
14689	160	2	1	1	0	164
14690	167	1	0	1	0	169
14691	166	0	0	3	0	169
14692	4	0	148	0	0	152
14693	162	1	2	0	0	165
14694	3	175	0	1	0	179
14695	1	5	0	178	0	184
14696	1	0	0	180	0	181
14697	0	175	0	6	0	181
14698	0	6	1	180	0	187
14699	181	0	0	6	0	187
14700	6	0	0	179	0	185
14701	0	0	171	4	0	175
14702	160	2	4	0	0	166
14703	5	170	0	1	0	176
14704	0	5	2	172	0	179
14705	0	0	1	174	0	175
14706	0	1	0	175	0	176
14707	3	1	169	4	0	177
14708	3	165	5	0	0	173
14709	2	5	0	163	0	170
14710	1	1	163	6	0	171
14711	0	0	5	154	0	159
14712	0	0	154	7	0	161
14713	1	0	5	146	0	152
14714	0	149	0	4	0	153
14715	0	7	0	155	0	162
14716	156	0	0	4	0	160
14717	157	0	0	0	0	157
14718	7	0	152	0	0	159
14719	0	1	138	1	0	140
14720	1	0	156	1	0	158
14721	0	0	3	153	0	156
14722	0	0	1	180	0	181
14723	0	0	0	175	0	175
14724	0	180	0	4	0	184
14725	0	5	0	177	0	182
14726	1	0	0	196	0	197
14727	0	0	0	201	0	201
14728	196	0	1	5	0	202
14729	196	0	0	1	0	197
14730	5	1	197	0	0	203
14731	1	0	202	1	0	204
14732	199	0	4	1	0	204
14733	214	0	1	1	0	216
14734	5	0	229	0	0	234
14735	1	1	223	0	0	225
14736	218	0	6	1	0	225
14737	225	0	1	0	0	226
14738	6	1	220	1	0	228
14739	1	0	6	211	0	218
14740	0	0	1	226	0	227
14741	0	231	0	5	0	236
14742	0	5	0	244	0	249
14743	3	1	262	5	0	271
14744	1	0	5	265	0	271
14745	0	0	3	266	0	269
14746	4	0	257	6	0	267
14747	254	2	6	1	0	263
14748	263	0	2	2	0	267
14749	6	0	1	260	0	267
14750	2	0	0	267	0	269
14751	255	1	2	6	0	264
14752	256	2	1	2	0	261
14753	242	0	0	4	0	246
14754	261	0	2	1	0	264
14755	5	260	0	2	0	267
14756	253	4	1	1	0	259
14757	4	258	2	1	0	265
14758	1	5	1	257	0	264
14759	1	1	0	256	0	258
14760	3	246	1	4	0	254
14761	3	4	1	243	0	251
14762	1	1	3	243	0	248
14763	1	239	2	6	0	248
14764	1	9	2	233	0	245
14765	1	1	1	243	0	246
14766	1	0	0	249	0	250
14767	1	0	240	7	0	248
14768	1	237	4	1	0	243
14769	0	5	1	212	0	218
14770	1	235	1	4	0	241
14771	236	3	1	5	0	245
14772	6	1	235	3	0	245
14773	4	0	238	2	0	244
14774	226	4	8	0	0	238
14775	2	0	3	230	0	235
14776	4	0	221	4	0	229
14777	3	1	220	1	0	225
14778	1	0	7	220	0	228
14779	222	0	4	6	0	232
14780	221	1	2	3	0	227
14781	8	1	2	213	0	224
14782	3	1	206	4	0	214
14783	2	209	5	5	0	221
14784	1	4	3	211	0	219
14785	3	4	208	3	0	218
14786	1	210	5	6	0	222
14787	1	4	7	198	0	210
14788	201	1	0	8	0	210
14789	6	0	1	193	0	200
14790	1	192	6	5	0	204
14791	190	3	3	3	0	199
14792	8	1	198	2	0	209
14793	4	190	3	5	0	202
14794	3	2	191	3	0	199
14795	184	2	3	3	0	192
14796	4	0	2	184	0	190
14797	5	3	0	186	0	194
14798	192	0	1	4	0	197
14799	4	1	2	188	0	195
14800	3	2	185	3	0	193
14801	183	3	2	4	0	192
14802	6	195	2	3	0	206
14803	5	3	1	199	0	208
14804	197	4	2	3	0	206
14805	3	200	2	5	0	210
14806	3	3	2	203	0	211
14807	210	2	1	2	0	215
14808	3	1	3	207	0	214
14809	2	204	0	6	0	212
14810	2	2	211	7	0	222
14811	2	2	2	217	0	223
14812	3	2	2	215	0	222
14813	221	1	5	5	0	232
14814	5	2	1	225	0	233
14815	218	1	0	7	0	226
14816	214	2	6	2	0	224
14817	5	2	2	213	0	222
14818	6	212	1	5	0	224
14819	2	3	1	215	0	221
14820	188	2	1	6	0	197
14821	5	190	2	5	0	202
14822	3	189	2	3	0	197
14823	189	3	1	0	0	193
14824	182	1	1	4	0	188
14825	1	182	2	4	0	189
14826	177	2	1	3	0	183
14827	178	3	0	2	0	183
14828	3	0	0	178	0	181
14829	2	0	176	5	0	183
14830	2	6	2	173	0	183
14831	0	1	180	4	0	185
14832	2	0	2	176	0	180
14833	0	0	169	3	0	172
14834	151	1	3	1	0	156
14835	2	1	1	154	0	158
14836	162	0	0	5	0	167
14837	2	1	2	160	0	165
14838	2	173	0	2	0	177
14839	174	2	1	2	0	179
14840	3	1	176	0	0	180
14841	149	5	6	1	0	161
14842	2	156	1	0	0	159
14843	137	2	0	0	0	139
14844	137	0	1	0	0	138
14845	3	132	0	0	0	135
14846	0	3	0	141	0	144
14847	143	0	0	2	0	145
14848	3	140	0	0	0	143
14849	0	3	0	145	0	148
14850	145	0	0	3	0	148
14851	4	0	0	142	0	146
14852	0	0	0	138	0	138
14853	1	0	0	144	0	145
14854	1	0	138	2	0	141
14855	1	0	3	135	0	139
14856	140	0	0	3	0	143
14857	2	0	138	1	0	141
14858	0	0	3	136	0	139
14859	0	0	0	140	0	140
14860	1	0	134	2	0	137
14861	134	0	3	0	0	137
14862	140	0	0	1	0	141
14863	2	0	145	1	0	148
14864	0	0	3	142	0	145
14865	1	0	0	153	0	154
14866	1	0	161	2	0	164
14867	0	0	3	154	0	157
14868	2	0	1	157	0	160
14869	0	0	174	4	0	178
14870	169	0	3	0	0	172
14871	3	0	0	180	0	183
14872	176	0	0	4	0	180
14873	180	0	1	0	0	181
14874	3	0	184	2	0	189
14875	1	1	2	181	0	185
14876	191	0	0	2	0	193
14877	3	198	1	0	0	202
14878	0	3	1	207	0	211
14879	1	1	0	207	0	209
14880	1	1	0	210	0	212
14881	1	1	210	4	0	216
14882	192	1	3	1	0	197
14883	3	0	0	206	0	209
14884	1	0	1	205	0	207
14885	1	1	203	3	0	208
14886	1	0	2	197	0	200
14887	1	0	0	210	0	211
14888	202	0	1	5	0	208
14889	3	200	1	2	0	206
14890	0	3	200	3	0	206
14891	198	0	4	1	0	203
14892	4	1	0	204	0	209
14893	1	1	206	3	0	211
14894	1	0	210	1	0	212
14895	1	1	4	210	0	216
14896	0	0	206	6	0	212
14897	0	0	229	0	0	229
14898	1	220	3	3	0	227
14899	1	3	3	237	0	244
14900	1	0	252	3	0	256
14901	0	1	4	223	0	228
14902	239	1	0	5	0	245
14903	4	0	2	245	0	251
14904	0	1	1	253	0	255
14905	246	0	0	5	0	251
14906	246	0	1	1	0	248
14907	5	0	0	261	0	266
14908	1	1	278	5	0	285
14909	4	271	3	0	0	278
14910	2	2	0	275	0	279
14911	268	1	2	4	0	275
14912	275	0	1	2	0	278
14913	4	274	0	1	0	279
14914	1	281	0	0	0	282
14915	277	3	0	3	0	283
14916	273	0	0	1	0	274
14917	3	2	283	2	0	290
14918	3	1	3	286	0	293
14919	3	293	0	6	0	302
14920	313	3	3	1	0	320
14921	7	1	1	307	0	316
14922	2	304	3	4	0	313
14923	1	3	310	4	0	318
14924	3	1	4	308	0	316
14925	1	341	1	5	0	348
14926	333	6	2	2	0	343
14927	337	1	2	6	0	346
14928	5	335	0	4	0	344
14929	335	3	1	0	0	339
14930	342	1	0	0	0	343
14931	4	330	0	2	0	336
14932	2	356	0	2	0	360
14933	0	2	2	357	0	361
14934	368	1	0	5	0	374
14935	2	1	372	3	0	378
14936	363	0	2	1	0	366
14937	3	375	0	1	0	379
14938	373	2	3	1	0	379
14939	379	1	1	0	0	381
14940	389	1	0	4	0	394
14941	4	0	2	395	0	401
14942	3	396	2	2	0	403
14943	395	2	0	3	0	400
14944	2	1	413	1	0	417
14945	1	411	3	2	0	417
14946	2	4	1	422	0	429
14947	0	2	414	4	0	420
14948	0	1	402	3	0	406
14949	1	0	4	402	0	407
14950	2	0	2	427	0	431
14951	1	0	2	441	0	444
14952	2	0	0	424	0	426
14953	2	421	1	6	0	430
14954	2	434	0	3	0	439
14955	459	4	1	4	0	468
14956	3	2	3	456	0	464
14957	3	3	0	461	0	467
14958	2	1	0	474	0	477
14959	473	0	1	5	0	479
14960	469	1	0	4	0	474
14961	4	2	1	468	0	475
14962	481	1	0	4	0	486
14963	478	0	1	2	0	481
14964	476	1	1	1	0	479
14965	6	0	2	470	0	478
14966	3	0	456	4	0	463
14967	1	1	429	3	0	434
14968	1	2	441	1	0	445
14969	0	0	450	1	0	451
14970	1	0	4	444	0	449
14971	454	0	3	2	0	459
14972	445	0	0	2	0	447
14973	4	1	449	0	0	454
14974	3	0	477	0	0	480
14975	1	528	4	0	0	533
14976	1	1	2	548	0	552
14977	552	2	1	2	0	557
14978	3	2	537	2	0	544
14979	508	0	2	1	0	511
14980	3	568	3	0	0	574
14981	3	3	0	590	0	596
14982	0	2	0	614	0	616
14983	0	1	1	607	0	609
14984	615	0	0	6	0	621
14985	6	0	1	612	0	619
14986	2	1	1	619	0	623
14987	616	0	0	8	0	624
14988	6	1	0	612	0	619
14989	3	1	632	4	0	640
14990	608	2	4	3	0	617
14991	4	0	3	632	0	639
14992	3	0	1	616	0	620
14993	0	626	0	9	0	635
14994	630	5	0	4	0	639
14995	642	2	0	0	0	644
14996	8	1	1	641	0	651
14997	2	1	630	5	0	638
14998	572	0	4	3	0	579
14999	7	1	641	0	0	649
15000	4	2	5	610	0	621
15001	0	1	2	648	0	651
15002	651	0	1	7	0	659
15003	5	0	2	670	0	677
15004	3	3	664	4	0	674
15005	632	2	6	3	0	643
15006	5	0	703	1	0	709
15007	4	0	677	0	0	681
15008	677	0	6	0	0	683
15009	5	1	1	696	0	703
15010	2	725	1	5	0	733
15011	721	6	0	1	0	728
15012	707	2	1	1	0	711
15013	6	1	718	0	0	725
15014	706	0	6	2	0	714
15015	5	0	3	737	0	745
15016	2	0	769	5	0	776
15017	0	752	6	3	0	761
15018	758	5	3	0	0	766
15019	7	754	1	1	0	763
15020	1	4	0	747	0	752
15021	0	3	1	746	0	750
15022	2	0	1	736	0	739
15023	7	0	0	709	0	716
15024	0	718	2	15	0	735
15025	2	5	709	0	0	716
15026	1	714	4	2	0	721
15027	714	4	2	0	0	720
15028	4	3	1	719	0	727
15029	726	0	0	4	0	730
15030	4	2	0	723	0	729
15031	749	0	1	5	0	755
15032	4	740	1	5	0	750
15033	746	4	0	3	0	753
15034	735	3	0	2	0	740
15035	729	2	0	2	0	733
15036	731	0	0	3	0	734
15037	5	713	0	8	0	726
15038	4	2	721	1	0	728
15039	0	2	5	722	0	729
15040	708	0	1	5	0	714
15041	705	1	0	3	0	709
15042	8	0	0	707	0	715
15043	1	2	728	6	0	737
15044	5	0	5	723	0	733
15045	3	732	1	6	0	742
15046	739	5	2	2	0	748
15047	7	2	2	757	0	768
15048	4	740	0	5	0	749
15049	3	780	4	1	0	788
15050	1	793	0	4	0	798
15051	4	8	1	814	0	827
15052	814	2	0	8	0	824
15053	8	813	3	2	0	826
15054	1	7	2	827	0	837
15055	810	0	0	12	0	822
15056	11	2	2	807	0	822
15057	807	1	1	12	0	821
15058	818	0	2	3	0	823
15059	9	865	0	4	0	878
15060	4	11	1	843	0	859
15061	3	878	1	7	0	889
15062	870	10	0	7	0	887
15063	894	1	1	3	0	899
15064	896	6	0	1	0	903
15065	12	1	1	916	0	930
15066	5	1	912	11	0	929
15067	881	2	11	3	0	897
15068	928	3	0	5	0	936
15069	13	3	1	906	0	923
15070	5	922	1	10	0	938
15071	3	10	0	936	0	949
15072	3	4	1	947	0	955
15073	942	4	1	13	0	960
15074	896	2	1	5	0	904
15075	15	0	848	3	0	866
15076	6	4	9	833	0	852
15077	847	3	2	10	0	862
15078	15	1	2	852	0	870
15079	5	1	858	14	0	878
15080	5	805	9	5	0	824
15081	5	846	1	3	0	855
15082	942	12	2	3	0	959
15083	15	6	2	1021	0	1044
15084	7	5	1	1231	0	1244
15085	1235	4	2	30	0	1271
15086	32	1	1231	20	0	1284
15087	12	4	26	1244	0	1286
15088	14	3	1251	32	0	1300
15089	4	1232	33	21	0	1290
15090	1289	29	16	8	0	1342
15091	1323	11	6	7	0	1347
15092	1363	10	5	5	0	1383
15093	46	6	1312	9	0	1373
15094	1346	3	32	9	0	1390
15095	1392	6	12	8	0	1418
15096	47	1	8	1349	0	1405
15097	1085	6	11	36	0	1138
15098	33	4	1333	18	0	1388
15099	1303	5	35	9	0	1352
15100	46	4	1313	6	0	1369
15101	21	1354	35	4	0	1414
15102	15	50	17	1221	0	1303
15103	18	1340	9	24	0	1391
15104	11	32	1323	9	0	1375
15105	14	1344	29	11	0	1398
15106	1278	32	15	7	0	1332
15107	33	1281	6	8	0	1328
15108	14	1291	10	4	0	1319
15109	15	41	1257	3	0	1316
15110	12	20	30	1231	0	1293
15111	1254	14	13	35	0	1316
15112	33	9	1258	14	0	1314
15113	17	1243	33	10	0	1303
15114	14	33	15	1249	0	1311
15115	10	16	1259	33	0	1318
15116	10	10	1248	16	0	1284
15117	9	8	43	1240	0	1300
15118	10	4	1256	36	0	1306
15119	9	7	38	1143	0	1197
15120	5	1229	20	28	0	1282
15121	4	32	18	1211	0	1265
15122	6	1250	7	31	0	1294
15123	9	35	5	1250	0	1299
15124	1236	17	10	35	0	1298
15125	32	11	5	1224	0	1272
15126	14	1225	9	40	0	1288
15127	14	30	8	1261	0	1313
15128	8	18	1249	39	0	1314
15129	4	11	31	1263	0	1309
15130	1237	10	19	40	0	1306
15131	33	15	1208	22	0	1278
15132	24	7	37	1212	0	1280
15133	1195	6	16	44	0	1261
15134	38	1195	11	21	0	1265
15135	17	34	9	1214	0	1274
15136	1222	16	7	37	0	1282
15137	37	9	14	1234	0	1294
15138	22	9	1214	42	0	1287
15139	1186	8	38	17	0	1249
15140	37	1235	18	12	0	1302
15141	23	1259	10	15	0	1307
15142	1255	38	8	11	0	1312
15143	1259	16	9	12	0	1296
15144	46	11	11	1211	0	1279
15145	1231	8	7	34	0	1280
15146	37	14	1198	21	0	1270
15147	1195	9	33	17	0	1254
15148	40	1203	18	10	0	1271
15149	1202	30	11	12	0	1255
15150	38	19	1213	10	0	1280
15151	22	11	32	1188	0	1253
15152	15	13	13	1213	0	1254
15153	14	12	9	1145	0	1180
15154	10	1188	13	39	0	1250
15155	1196	29	10	22	0	1257
15156	40	15	10	1141	0	1206
15157	26	1154	10	31	0	1221
15158	1212	35	8	15	0	1270
15159	1164	20	10	14	0	1208
15160	1193	11	9	17	0	1230
15161	1197	8	10	15	0	1230
15162	1186	8	9	14	0	1217
15163	51	7	9	1136	0	1203
15164	32	9	8	1145	0	1194
15165	1112	7	7	48	0	1174
15166	39	13	12	1110	0	1174
15167	25	11	6	1135	0	1177
15168	18	13	1063	48	0	1142
15169	1076	7	30	26	0	1139
15170	1102	9	19	18	0	1148
15171	1123	13	7	17	0	1160
15172	50	10	10	1020	0	1090
15173	23	1074	10	40	0	1147
15174	1189	30	14	25	0	1258
15175	1139	14	11	20	0	1184
15176	52	14	13	1256	0	1335
15177	1281	10	12	43	0	1346
15178	55	22	1029	35	0	1141
15179	29	1300	31	26	0	1386
15180	27	1325	13	31	0	1396
15181	22	51	1292	15	0	1380
15182	10	1133	37	18	0	1198
15183	11	1107	16	17	0	1151
15184	873	21	12	11	0	917
15185	13	871	9	15	0	908
15186	16	20	4	865	0	905
15187	890	15	2	22	0	929
15188	22	5	879	8	0	914
15189	870	10	14	14	0	908
15190	21	9	852	12	0	894
15191	22	5	851	6	0	884
15192	809	5	22	10	0	846
15193	27	3	835	12	0	877
15194	10	799	18	7	0	834
15195	5	15	12	794	0	826
15196	797	8	5	14	0	824
15197	17	784	8	10	0	819
15198	9	15	6	788	0	818
15199	10	10	779	14	0	813
15200	10	6	12	782	0	810
15201	772	8	6	16	0	802
15202	20	4	764	13	0	801
15203	17	3	13	750	0	783
15204	750	3	7	20	0	780
15205	774	3	4	12	0	793
15206	21	2	9	754	0	786
15207	18	4	3	768	0	793
15208	13	7	768	17	0	805
15209	9	7	750	13	0	779
15210	738	2	18	10	0	768
15211	768	1	8	9	0	786
15212	25	757	5	10	0	797
15213	761	10	5	5	0	781
15214	793	5	0	6	0	804
15215	19	4	814	1	0	838
15216	13	829	12	0	0	854
15217	828	14	6	2	0	850
15218	837	8	3	1	0	849
15219	851	4	4	0	0	859
15220	27	3	2	820	0	852
15221	18	1	1	835	0	855
15222	7	832	1	21	0	861
15223	4	19	0	845	0	868
15224	836	10	0	20	0	866
15225	17	5	1	853	0	876
15226	10	5	831	18	0	864
15227	5	3	824	14	0	846
15228	6	1	24	820	0	851
15229	2	5	849	18	0	874
15230	2	1	852	12	0	867
15231	5	1	24	828	0	858
15232	3	1	10	861	0	875
15233	3	2	867	23	0	895
15234	1	1	868	12	0	882
15235	2	861	26	9	0	898
15236	879	15	14	3	0	911
15237	17	903	10	0	0	930
15238	895	20	5	3	0	923
15239	894	11	2	7	0	914
15240	28	891	3	2	0	924
15241	905	21	4	1	0	931
15242	22	10	2	902	0	936
15243	16	11	905	18	0	950
15244	5	7	18	894	0	924
15245	9	0	12	928	0	949
15246	865	2	6	29	0	902
15247	881	4	3	16	0	904
15248	898	1	3	7	0	909
15249	890	3	3	6	0	902
15250	850	1	3	5	0	859
15251	34	813	0	5	0	852
15252	16	16	4	832	0	868
15253	10	8	851	21	0	890
15254	7	5	21	850	0	883
15255	4	2	12	854	0	872
15256	5	3	3	888	0	899
15257	924	0	6	29	0	959
15258	22	4	0	943	0	969
15259	941	2	2	30	0	975
15260	27	1	945	14	0	987
15261	16	1	22	1093	0	1132
15262	5	3	1136	28	0	1172
15263	1119	0	25	18	0	1162
15264	29	1	15	1137	0	1182
15265	19	1	1149	29	0	1198
15266	14	2	25	1153	0	1194
15267	1152	1	16	35	0	1204
15268	27	1	1155	19	0	1202
15269	1158	3	23	12	0	1196
15270	1193	1	15	6	0	1215
15271	1194	0	9	8	0	1211
15272	1179	0	4	8	0	1191
15273	42	1143	8	5	0	1198
15274	26	1049	2	4	0	1081
15275	12	1069	2	6	0	1089
15276	8	53	20	879	0	960
15277	6	931	1	17	0	955
15278	891	16	5	7	0	919
15279	13	863	3	10	0	889
15280	11	889	3	3	0	906
15281	7	18	3	881	0	909
15282	5	13	3	892	0	913
15283	874	3	4	23	0	904
15284	12	3	5	878	0	898
15285	12	1	850	20	0	883
15286	10	3	808	11	0	832
15287	9	2	832	7	0	850
15288	14	1	21	799	0	835
15289	12	1	11	852	0	876
15290	8	3	850	20	0	881
15291	7	5	837	16	0	865
15292	5	8	861	6	0	880
15293	854	6	32	4	0	896
15294	21	6	16	861	0	904
15295	17	6	5	883	0	911
15296	874	3	2	28	0	907
15297	23	5	5	873	0	906
15298	14	866	2	23	0	905
15299	9	888	3	16	0	916
15300	6	27	0	885	0	918
15301	877	16	3	23	0	919
15302	885	9	4	16	0	914
15303	898	3	6	12	0	919
15304	35	4	8	880	0	927
15305	13	4	867	25	0	909
15306	8	2	21	874	0	905
15307	7	1	867	30	0	905
15308	838	2	27	17	0	884
15309	20	2	18	861	0	901
15310	854	2	17	21	0	894
15311	26	1	863	19	0	909
15312	814	1	21	13	0	849
15313	29	2	898	12	0	941
15314	17	812	28	8	0	865
15315	15	825	13	6	0	859
15316	798	22	11	7	0	838
15317	21	15	2	794	0	832
15318	14	10	790	18	0	832
15319	14	775	13	12	0	814
15320	7	809	9	13	0	838
15321	13	23	6	797	0	839
15322	804	14	3	24	0	845
15323	797	8	6	16	0	827
15324	21	809	8	14	0	852
15325	814	17	6	10	0	847
15326	23	11	6	812	0	852
15327	15	8	799	20	0	842
15328	14	804	17	18	0	853
15329	8	14	14	808	0	844
15330	11	7	14	813	0	845
15331	802	8	10	23	0	843
15332	18	3	793	14	0	828
15333	780	6	14	12	0	812
15334	805	3	12	12	0	832
15335	21	7	8	786	0	822
15336	15	6	10	785	0	816
15337	758	4	5	28	0	795
15338	17	5	6	776	0	804
15339	13	7	763	22	0	805
15340	14	5	738	15	0	772
15341	11	728	20	13	0	772
15342	8	777	13	8	0	806
15343	9	20	8	727	0	764
15344	6	734	2	19	0	761
15345	746	18	5	14	0	783
15346	15	754	4	14	0	787
15347	15	19	6	747	0	787
15348	12	11	5	766	0	794
15349	8	10	753	23	0	794
15350	13	0	17	757	0	787
15351	6	3	11	772	0	792
15352	8	766	11	21	0	806
15353	8	17	2	776	0	803
15354	6	8	3	789	0	806
15355	13	4	762	26	0	805
15356	8	766	15	17	0	806
15357	5	46	12	653	0	716
15358	6	678	7	13	0	704
15359	4	16	669	11	0	700
15360	1	657	15	8	0	681
15361	479	21	6	4	0	510
15362	465	3	2	0	0	470
15363	469	4	0	3	0	476
15364	12	459	0	2	0	473
15365	460	10	0	1	0	471
15366	9	3	2	460	0	474
15367	449	4	0	8	0	461
15368	12	445	0	4	0	461
15369	447	9	0	2	0	458
15370	460	3	0	5	0	468
15371	16	463	1	1	0	481
15372	4	10	462	3	0	479
15373	0	3	13	487	0	503
15374	1	0	514	14	0	529
15375	0	2	16	554	0	572
15376	3	1	3	588	0	595
15377	1	0	605	22	0	628
15378	0	2	18	604	0	624
15379	601	2	6	18	0	627
15380	19	2	597	4	0	622
15381	3	603	19	2	0	627
15382	1	17	4	596	0	618
15383	3	4	2	624	0	633
15384	2	2	604	20	0	628
15385	1	3	17	576	0	597
15386	2	605	4	18	0	629
15387	588	18	3	3	0	612
15388	18	605	2	3	0	628
15389	546	18	1	4	0	569
15390	17	561	1	2	0	581
15391	3	586	1	4	0	594
15392	3	16	570	3	0	592
15393	3	2	15	565	0	585
15394	2	5	2	568	0	577
15395	1	4	2	580	0	587
15396	1	588	2	14	0	605
15397	1	18	1	591	0	611
15398	583	5	1	16	0	605
15399	15	4	2	585	0	606
15400	585	2	2	18	0	607
15401	20	0	594	7	0	621
15402	602	2	15	4	0	623
15403	17	3	3	600	0	623
15404	4	5	1	640	0	650
15405	644	0	4	21	0	669
15406	20	3	651	9	0	683
15407	6	633	18	6	0	663
15408	4	21	4	645	0	674
15409	636	7	3	18	0	664
15410	649	3	2	6	0	660
15411	22	2	1	644	0	669
15412	6	2	632	23	0	663
15413	596	2	16	6	0	620
15414	18	3	608	6	0	635
15415	4	2	21	612	0	639
15416	2	0	614	26	0	642
15417	7	3	17	615	0	642
15418	6	2	610	18	0	636
15419	3	599	20	18	0	640
15420	6	15	4	550	0	575
15421	3	625	4	19	0	651
15422	631	17	2	5	0	655
15423	639	5	5	5	0	654
15424	19	4	616	7	0	646
15425	7	4	17	610	0	638
15426	624	2	4	20	0	650
15427	21	1	5	623	0	650
15428	6	3	2	629	0	640
15429	2	3	613	22	0	640
15430	589	3	19	9	0	620
15431	21	1	608	5	0	635
15432	8	2	19	606	0	635
15433	5	1	609	24	0	639
15434	601	3	20	10	0	634
15435	619	1	8	9	0	637
15436	620	2	6	6	0	634
15437	21	3	9	604	0	637
15438	9	4	582	22	0	617
15439	9	3	586	10	0	608
15440	6	1	21	538	0	566
15441	6	566	11	18	0	601
15442	559	16	8	9	0	592
15443	24	4	5	560	0	593
15444	10	4	559	21	0	594
15445	9	6	20	567	0	602
15446	4	2	600	23	0	629
15447	10	2	23	589	0	624
15448	6	5	592	22	0	625
15449	6	5	580	9	0	600
15450	4	573	22	12	0	611
15451	6	15	586	7	0	614
15452	7	4	580	7	0	598
15453	7	4	20	479	0	510
15454	10	10	5	521	0	546
15455	6	535	8	18	0	567
15456	545	14	6	12	0	577
15457	18	538	9	7	0	572
15458	6	17	6	543	0	572
15459	541	3	8	16	0	568
15460	16	1	8	546	0	571
15461	540	1	8	22	0	571
15462	15	2	7	547	0	571
15463	4	6	549	18	0	577
15464	5	4	18	546	0	573
15465	10	2	6	555	0	573
15466	540	3	4	22	0	569
15467	532	3	4	9	0	548
15468	528	4	8	7	0	547
15469	22	496	8	7	0	533
15470	7	508	5	12	0	532
15471	505	12	3	10	0	530
15472	15	4	507	9	0	535
15473	13	3	487	10	0	513
15474	7	17	14	470	0	508
15475	6	1	440	14	0	461
15476	4	0	414	7	0	425
15477	365	0	13	10	0	388
15478	387	1	9	2	0	399
15479	15	393	2	3	0	413
15480	8	410	5	1	0	424
15481	5	8	4	363	0	380
15482	0	409	6	9	0	424
15483	419	8	3	5	0	435
15484	10	4	4	404	0	422
15485	6	422	3	5	0	436
15486	432	7	1	7	0	447
15487	9	7	422	4	0	442
15488	5	2	419	4	0	430
15489	403	1	13	3	0	420
15490	9	1	404	4	0	418
15491	381	1	11	4	0	397
15492	6	2	6	389	0	403
15493	2	1	396	7	0	406
15494	3	383	5	5	0	396
15495	4	386	6	3	0	399
15496	358	6	2	1	0	367
15497	2	369	3	0	0	374
15498	350	2	5	0	0	357
15499	359	1	0	1	0	361
15500	3	359	0	0	0	362
15501	4	1	0	348	0	353
15502	0	2	357	2	0	361
15503	1	369	3	2	0	375
15504	5	8	2	367	0	382
15505	1	2	1	389	0	393
15506	375	1	1	2	0	379
15507	3	0	1	371	0	375
15508	2	2	374	2	0	380
15509	0	375	2	2	0	379
15510	0	2	1	374	0	377
15511	374	2	1	2	0	379
15512	384	1	0	1	0	386
15513	3	0	1	381	0	385
15514	375	2	2	4	0	383
15515	4	0	382	3	0	389
15516	2	0	4	388	0	394
15517	1	0	391	3	0	395
15518	1	2	3	426	0	432
15519	2	0	4	419	0	425
15520	1	1	2	424	0	428
15521	1	1	1	412	0	415
15522	0	0	3	419	0	422
15523	411	3	0	6	0	420
15524	415	1	1	3	0	420
15525	5	416	0	2	0	423
15526	411	6	1	3	0	421
15527	5	3	0	413	0	421
15528	3	1	1	422	0	427
15529	4	2	1	419	0	426
15530	3	1	416	8	0	428
15531	3	1	6	394	0	404
15532	2	410	1	7	0	420
15533	414	4	1	5	0	424
15534	410	2	1	4	0	417
15535	8	1	405	2	0	416
15536	4	407	4	4	0	419
15537	2	4	1	402	0	409
15538	3	3	407	8	0	421
15539	3	4	5	383	0	395
15540	5	402	4	5	0	416
15541	396	7	1	2	0	406
15542	5	398	4	5	0	412
15543	4	6	421	1	0	432
15544	2	5	407	4	0	418
15545	3	396	8	4	0	411
15546	1	381	4	4	0	390
15547	384	11	0	3	0	398
15548	389	3	1	4	0	397
15549	8	3	3	387	0	401
15550	1	4	387	6	0	398
15551	0	2	10	380	0	392
15552	3	3	3	382	0	391
15553	382	6	1	5	0	394
15554	378	3	0	5	0	386
15555	14	1	2	397	0	414
15556	4	1	401	11	0	417
15557	0	412	8	7	0	427
15558	406	6	5	6	0	423
15559	7	428	3	6	0	444
15560	4	6	0	436	0	446
15561	6	4	0	462	0	472
15562	5	1	1	465	0	472
15563	3	1	3	466	0	473
15564	456	4	5	9	0	474
15565	11	3	2	462	0	478
15566	3	458	1	11	0	473
15567	1	8	1	465	0	475
15568	445	2	0	17	0	464
15569	10	450	0	10	0	470
15570	3	8	0	462	0	473
15571	4	3	457	11	0	475
15572	451	2	9	9	0	471
15573	9	7	2	452	0	470
15574	1	3	435	12	0	451
15575	8	0	438	7	0	453
15576	10	7	7	426	0	450
15577	433	3	1	12	0	449
15578	435	2	5	4	0	446
15579	13	441	4	5	0	463
15580	427	8	2	8	0	445
15581	432	1	3	7	0	443
15582	424	0	5	6	0	435
15583	415	1	4	7	0	427
15584	11	1	0	423	0	435
15585	9	1	1	419	0	430
15586	6	4	403	8	0	421
15587	8	396	6	0	0	410
15588	7	402	1	4	0	414
15589	8	7	395	2	0	412
15590	408	0	8	5	0	421
15591	8	2	2	414	0	426
15592	404	1	4	16	0	425
15593	413	3	6	4	0	426
15594	12	4	399	3	0	418
15595	2	7	6	400	0	415
15596	400	3	5	6	0	414
15597	12	2	3	397	0	414
15598	6	1	396	10	0	413
15599	4	4	7	378	0	393
15600	7	380	0	11	0	398
15601	4	404	6	1	0	415
15602	5	7	381	4	0	397
15603	5	371	7	5	0	388
15604	328	9	4	10	0	351
15605	324	1	7	5	0	337
15606	5	0	3	327	0	335
15607	4	5	0	326	0	335
15608	5	5	0	327	0	337
15609	310	4	5	5	0	324
15610	7	325	2	4	0	338
15611	325	7	3	1	0	336
15612	324	1	0	4	0	329
15613	11	322	1	5	0	339
15614	311	7	0	9	0	327
15615	6	299	1	8	0	314
15616	312	5	2	6	0	325
15617	10	6	309	1	0	326
15618	260	7	3	0	0	270
15619	9	269	4	0	0	282
15620	7	6	0	266	0	279
15621	2	3	1	271	0	277
15622	6	2	0	266	0	274
15623	271	3	0	8	0	282
15624	8	0	4	266	0	278
15625	2	3	268	11	0	284
15626	261	2	5	3	0	271
15627	12	2	267	6	0	287
15628	2	2	6	277	0	287
15629	8	3	269	12	0	292
15630	5	3	7	263	0	278
15631	3	269	2	5	0	279
15632	2	6	3	263	0	274
15633	1	268	3	6	0	278
15634	3	4	5	268	0	280
15635	273	2	1	8	0	284
15636	7	0	1	295	0	303
15637	286	2	1	7	0	296
15638	5	2	274	5	0	286
15639	277	1	5	4	0	287
15640	287	3	2	2	0	294
15641	291	0	0	4	0	295
15642	10	2	4	279	0	295
15643	260	2	1	9	0	272
15644	10	1	249	4	0	264
15645	256	3	6	2	0	267
15646	10	1	251	1	0	263
15647	248	4	6	3	0	261
15648	9	2	3	250	0	264
15649	5	2	259	6	0	272
15650	5	0	4	253	0	262
15651	2	2	3	262	0	269
15652	5	0	248	10	0	263
15653	245	0	7	3	0	255
15654	5	252	2	8	0	267
15655	239	4	2	2	0	247
15656	10	241	1	2	0	254
15657	226	4	5	3	0	238
15658	5	1	217	6	0	229
15659	202	1	4	1	0	208
15660	10	190	1	4	0	205
15661	8	2	2	171	0	183
15662	3	1	2	173	0	179
15663	1	2	0	175	0	178
15664	3	0	176	3	0	182
15665	1	0	3	176	0	180
15666	1	0	175	5	0	181
15667	185	1	3	1	0	190
15668	194	0	2	3	0	199
15669	7	1	1	194	0	203
15670	4	0	201	5	0	210
15671	184	1	6	2	0	193
15672	6	0	240	3	0	249
15673	2	0	9	240	0	251
15674	2	1	3	263	0	269
15675	1	1	0	273	0	275
15676	1	0	1	278	0	280
15677	254	0	1	11	0	266
15678	7	264	0	4	0	275
15679	4	7	258	0	0	269
15680	0	266	4	2	0	272
15681	266	6	4	2	0	278
15682	7	3	1	268	0	279
15683	271	0	0	8	0	279
15684	9	1	0	277	0	287
15685	3	2	1	279	0	285
15686	1	0	2	285	0	288
15687	0	2	277	10	0	289
15688	2	271	7	4	0	284
15689	0	5	285	4	0	294
15690	2	3	7	280	0	292
15691	290	0	3	8	0	301
15692	293	0	0	5	0	298
15693	297	1	0	4	0	302
15694	9	288	4	1	0	302
15695	311	9	0	0	0	320
15696	7	3	3	312	0	325
15697	3	0	0	317	0	320
15698	3	0	0	323	0	326
15699	2	317	0	10	0	329
15700	2	6	0	306	0	314
15701	1	314	0	5	0	320
15702	312	7	1	3	0	323
15703	310	3	1	2	0	316
15704	9	1	0	308	0	318
15705	4	0	296	9	0	309
15706	284	2	6	4	0	296
15707	8	0	3	304	0	315
15708	3	2	306	7	0	318
15709	298	1	6	4	0	309
15710	9	0	3	318	0	330
15711	317	0	1	9	0	327
15712	6	312	2	5	0	325
15713	5	6	1	308	0	320
15714	0	327	0	8	0	335
15715	1	19	2	328	0	350
15716	4	346	0	5	0	355
15717	2	5	0	352	0	359
15718	3	3	347	7	0	360
15719	268	1	7	5	0	281
15720	6	341	3	4	0	354
15721	3	7	348	1	0	359
15722	338	3	6	4	0	351
15723	7	2	3	349	0	361
15724	3	0	357	8	0	368
15725	0	374	7	3	0	384
15726	3	5	2	379	0	389
15727	0	4	390	5	0	399
15728	0	0	8	391	0	399
15729	1	1	2	395	0	399
15730	2	0	397	10	0	409
15731	0	0	6	404	0	410
15732	2	1	409	6	0	418
15733	0	1	5	395	0	401
15734	0	0	446	7	0	453
15735	1	1	6	445	0	453
15736	2	0	3	434	0	439
15737	0	1	1	441	0	443
15738	1	431	2	7	0	441
15739	430	6	1	4	0	441
15740	440	2	1	2	0	445
15741	8	0	1	426	0	435
15742	438	0	1	9	0	448
15743	6	2	428	4	0	440
15744	3	459	7	1	0	470
15745	466	7	2	2	0	477
15746	9	477	0	1	0	487
15747	4	6	1	487	0	498
15748	1	4	0	490	0	495
15749	472	1	0	9	0	482
15750	7	1	1	470	0	479
15751	3	1	481	7	0	492
15752	2	479	6	4	0	491
15753	475	7	2	2	0	486
15754	6	3	1	472	0	482
15755	3	485	0	7	0	495
15756	2	8	0	490	0	500
15757	1	495	2	7	0	505
15758	517	6	1	2	0	526
15759	520	3	0	2	0	525
15760	10	0	507	1	0	518
15761	4	1	504	1	0	510
15762	0	2	7	510	0	519
15763	1	538	3	6	0	548
15764	1	4	0	540	0	545
15765	544	3	1	7	0	555
15766	7	0	539	4	0	550
15767	2	1	5	508	0	516
15768	0	0	524	4	0	528
15769	1	0	506	3	0	510
15770	0	532	5	1	0	538
15771	2	3	1	538	0	544
15772	493	3	3	5	0	504
15773	2	0	508	0	0	510
15774	0	496	1	0	0	497
15775	496	2	0	0	0	498
15776	2	0	0	498	0	500
15777	525	0	0	2	0	527
15778	533	0	0	0	0	533
15779	529	0	0	0	0	529
15780	2	0	539	0	0	541
15781	492	0	2	1	0	495
15782	542	0	0	0	0	542
15783	2	540	1	0	0	543
15784	0	2	0	541	0	543
15785	0	0	0	537	0	537
15786	0	0	0	543	0	543
15787	536	0	0	2	0	538
15788	524	0	0	0	0	524
15789	2	0	528	0	0	530
15790	1	0	2	513	0	516
15791	0	515	0	1	0	516
15792	518	2	0	1	0	521
15793	2	0	513	0	0	515
15794	1	0	2	499	0	502
15795	0	0	0	514	0	514
15796	0	514	0	3	0	517
15797	0	1	1	515	0	517
15798	2	0	1	474	0	477
15799	0	0	0	509	0	509
15800	511	0	0	2	0	513
15801	3	0	0	503	0	506
15802	0	0	0	504	0	504
15803	511	0	0	2	0	513
15804	2	1	0	517	0	520
15805	0	556	0	1	0	557
15806	582	3	0	1	0	586
15807	601	2	0	2	0	605
15808	612	1	0	1	0	614
15809	699	0	0	0	0	699
15810	10	712	0	4	0	726
15811	835	11	0	0	0	846
15812	850	2	1	0	0	853
15813	16	2	0	834	0	852
15814	5	1	839	17	0	862
15815	5	0	11	823	0	839
15816	5	1	2	825	0	833
15817	2	0	1	825	0	828
15818	0	1	3	825	0	829
15819	1	0	1	828	0	830
15820	801	0	0	22	0	823
15821	14	0	1	797	0	812
15822	2	0	810	19	0	831
15823	3	0	13	799	0	815
15824	4	807	1	17	0	829
15825	1	14	2	787	0	804
15826	2	2	787	15	0	806
15827	688	2	15	7	0	712
15828	734	2	9	4	0	749
15829	17	1	784	1	0	803
15830	4	778	18	1	0	801
15831	795	13	2	0	0	810
15832	803	2	2	2	0	809
15833	801	2	3	1	0	807
15834	778	3	1	0	0	782
15835	23	1	0	743	0	767
15836	8	0	758	14	0	780
15837	7	0	14	743	0	764
15838	7	0	2	772	0	781
15839	4	1	775	19	0	799
15840	2	1	767	5	0	775
15841	742	1	17	6	0	766
15842	18	771	4	5	0	798
15843	7	14	6	773	0	800
15844	3	4	756	19	0	782
15845	711	2	18	8	0	739
15846	16	4	739	7	0	766
15847	707	1	17	13	0	738
15848	18	730	6	8	0	762
15849	7	16	2	742	0	767
15850	4	2	739	21	0	766
15851	673	2	18	5	0	698
15852	19	719	3	7	0	748
15853	2	756	5	7	0	770
15854	5	19	5	747	0	776
15855	4	10	3	772	0	789
15856	790	6	2	22	0	820
15857	18	798	3	10	0	829
15858	10	18	3	807	0	838
15859	798	7	2	21	0	828
15860	830	4	4	8	0	846
15861	857	6	2	7	0	872
15862	33	2	852	7	0	894
15863	18	1	869	5	0	893
15864	927	5	24	4	0	960
15865	36	917	7	8	0	968
15866	14	946	5	7	0	972
15867	10	28	7	897	0	942
15868	8	936	3	32	0	979
15869	935	31	4	15	0	985
15870	31	11	9	932	0	983
15871	12	8	927	33	0	980
15872	922	9	25	16	0	972
15873	946	7	8	9	0	970
15874	40	4	6	923	0	973
15875	16	4	9	931	0	960
15876	18	2	10	936	0	966
15877	12	2	9	913	0	936
15878	13	4	860	38	0	915
15879	8	849	23	23	0	903
15880	14	29	13	757	0	813
15881	8	854	7	35	0	904
15882	9	36	6	785	0	836
15883	11	856	2	38	0	907
15884	850	33	6	18	0	907
15885	859	14	8	13	0	894
15886	40	854	5	12	0	911
15887	874	29	6	13	0	922
15888	42	15	5	863	0	925
15889	860	6	4	40	0	910
15890	39	868	3	14	0	924
15891	863	30	6	15	0	914
15892	892	12	8	13	0	925
15893	49	11	8	858	0	926
15894	21	9	861	33	0	924
15895	18	849	30	14	0	911
15896	17	32	12	862	0	923
15897	862	23	7	35	0	927
15898	35	8	861	20	0	924
15899	20	12	29	844	0	905
15900	14	13	10	877	0	914
15901	884	9	5	42	0	940
15902	882	9	15	23	0	929
15903	874	8	5	20	0	907
15904	49	846	6	15	0	916
15905	814	31	7	12	0	864
15906	43	9	770	15	0	837
15907	19	10	758	18	0	805
15908	11	10	764	17	0	802
15909	18	37	31	631	0	717
15910	9	9	635	28	0	681
15911	526	6	14	9	0	555
15912	20	7	12	530	0	569
15913	11	4	544	21	0	580
15914	563	9	15	17	0	604
15915	29	3	10	565	0	607
15916	16	7	3	588	0	614
15917	592	7	5	24	0	628
15918	25	8	6	597	0	636
15919	18	9	612	23	0	662
15920	12	2	23	623	0	660
15921	12	6	628	23	0	669
15922	4	3	30	609	0	646
15923	603	6	8	29	0	646
15924	26	579	7	15	0	627
15925	19	606	6	11	0	642
15926	9	24	4	601	0	638
15927	10	7	5	602	0	624
15928	10	568	7	25	0	610
15929	11	581	5	17	0	614
15930	6	24	9	563	0	602
15931	11	5	5	585	0	606
15932	559	10	8	28	0	605
15933	22	540	8	22	0	592
15934	9	541	7	14	0	571
15935	11	570	8	9	0	598
15936	550	23	5	13	0	591
15937	22	11	553	9	0	595
15938	543	8	20	6	0	577
15939	21	8	7	539	0	575
15940	11	518	3	29	0	561
15941	9	553	7	10	0	579
15942	544	24	3	5	0	576
15943	21	10	7	521	0	559
15944	6	577	4	31	0	618
15945	589	17	7	11	0	624
15946	589	8	3	11	0	611
15947	24	8	582	6	0	620
15948	577	8	14	9	0	608
15949	612	9	9	7	0	637
15950	27	4	2	587	0	620
15951	10	573	7	22	0	612
15952	10	607	2	10	0	629
15953	6	21	3	586	0	616
15954	561	7	7	22	0	597
15955	19	8	532	8	0	567
15956	4	5	517	3	0	529
15957	8	2	480	7	0	497
15958	13	2	494	2	0	511
15959	0	487	17	2	0	506
15960	5	494	5	2	0	506
15961	5	18	452	4	0	479
15962	3	5	452	4	0	464
15963	3	411	16	3	0	433
15964	0	8	0	358	0	366
15965	0	1	381	7	0	389
15966	1	0	7	359	0	367
15967	0	1	0	387	0	388
15968	1	0	1	394	0	396
15969	0	0	2	412	0	414
15970	0	1	413	7	0	421
15971	2	1	6	394	0	403
15972	396	1	0	8	0	405
15973	6	0	401	2	0	409
15974	403	0	7	1	0	411
15975	7	1	0	414	0	422
15976	1	0	412	7	0	420
15977	403	0	8	0	0	411
15978	7	1	1	410	0	419
15979	416	0	1	12	0	429
15980	6	0	1	414	0	421
15981	2	415	1	6	0	424
15982	0	7	429	3	0	439
15983	1	0	7	429	0	437
15984	438	0	2	7	0	447
15985	437	2	1	0	0	440
15986	436	0	1	2	0	439
15987	429	0	2	2	0	433
15988	424	1	2	2	0	429
15989	7	428	1	0	0	436
15990	434	6	0	4	0	444
15991	9	1	431	1	0	442
15992	414	1	6	2	0	423
15993	7	4	1	404	0	416
15994	2	0	418	6	0	426
15995	0	1	407	4	0	412
15996	4	1	7	414	0	426
15997	426	2	2	7	0	437
15998	10	423	1	5	0	439
15999	425	6	3	2	0	436
16000	8	429	1	2	0	440
16001	4	9	0	445	0	458
16002	3	3	2	452	0	460
16003	447	1	1	9	0	458
16004	8	1	0	445	0	454
16005	3	1	447	8	0	459
16006	448	0	7	4	0	459
16007	8	1	3	458	0	470
16008	2	1	1	458	0	462
16009	2	0	456	9	0	467
16010	416	2	5	1	0	424
16011	457	1	2	2	0	462
16012	8	458	0	2	0	468
16013	4	5	430	2	0	441
16014	4	1	404	1	0	410
16015	4	1	9	402	0	416
16016	4	7	11	384	0	406
16017	1	398	3	5	0	407
16018	1	2	383	1	0	387
16019	1	7	1	360	0	369
16020	0	0	379	2	0	381
16021	1	0	2	373	0	376
16022	0	384	2	3	0	389
16023	2	1	2	391	0	396
16024	0	2	1	394	0	397
16025	2	0	0	395	0	397
16026	389	1	1	3	0	394
16027	2	2	385	1	0	390
16028	2	405	2	7	0	416
16029	1	3	2	430	0	436
16030	457	1	2	3	0	463
16031	3	0	1	470	0	474
16032	468	1	0	3	0	472
16033	2	0	490	4	0	496
16034	493	1	5	3	0	502
16035	5	0	3	508	0	516
16036	4	1	516	6	0	527
16037	2	514	6	2	0	524
16038	1	6	3	500	0	510
16039	2	0	2	516	0	520
16040	511	0	1	8	0	520
16041	5	506	1	2	0	514
16042	3	488	2	1	0	494
16043	2	515	2	1	0	520
16044	471	4	1	1	0	477
16045	5	468	0	3	0	476
16046	4	6	0	459	0	469
16047	6	2	1	463	0	472
16048	453	1	0	8	0	462
16049	5	448	1	3	0	457
16050	3	4	0	457	0	464
16051	464	2	2	3	0	471
16052	449	2	0	2	0	453
16053	450	1	1	3	0	455
16054	9	450	0	1	0	460
16055	442	6	0	1	0	449
16056	6	1	2	437	0	446
16057	1	434	1	4	0	440
16058	2	435	0	4	0	441
16059	1	12	0	430	0	443
16060	432	1	1	5	0	439
16061	439	2	0	2	0	443
16062	5	1	1	428	0	435
16063	4	414	0	3	0	421
16064	415	4	0	3	0	422
16065	5	3	397	1	0	406
16066	1	1	396	3	0	401
16067	383	3	3	2	0	391
16068	5	1	388	1	0	395
16069	2	0	3	349	0	354
16070	356	0	1	6	0	363
16071	4	0	1	364	0	369
16072	3	1	362	4	0	370
16073	1	362	3	2	0	368
16074	1	5	1	362	0	369
16075	3	1	362	3	0	369
16076	339	1	4	1	0	345
16077	5	2	1	358	0	366
16078	1	3	369	3	0	376
16079	2	0	3	368	0	373
16080	2	375	1	3	0	381
16081	1	5	0	391	0	397
16082	1	2	1	379	0	383
16083	2	2	0	374	0	378
16084	3	371	0	7	0	381
16085	377	4	2	1	0	384
16086	7	1	1	389	0	398
16087	4	1	0	392	0	397
16088	2	0	3	395	0	400
16089	0	2	392	7	0	401
16090	2	2	5	392	0	401
16091	396	0	1	9	0	406
16092	5	407	1	3	0	416
16093	2	7	0	422	0	431
16094	1	2	0	427	0	430
16095	418	2	2	6	0	428
16096	8	418	1	6	0	433
16097	422	6	0	5	0	433
16098	435	3	2	3	0	443
16099	8	1	2	434	0	445
16100	430	0	1	8	0	439
16101	7	412	0	4	0	423
16102	413	7	1	2	0	423
16103	6	2	1	423	0	432
16104	443	1	1	8	0	453
16105	464	1	0	2	0	467
16106	10	2	462	2	0	476
16107	473	2	7	4	0	486
16108	482	2	1	3	0	488
16109	517	1	2	5	0	525
16110	14	1	538	2	0	555
16111	5	546	10	1	0	562
16112	4	12	2	547	0	565
16113	553	1	2	12	0	568
16114	13	548	0	5	0	566
16115	551	14	0	2	0	567
16116	14	4	0	546	0	564
16117	5	1	539	13	0	558
16118	561	0	12	6	0	579
16119	15	2	2	561	0	580
16120	6	1	557	13	0	577
16121	564	1	15	6	0	586
16122	20	0	571	3	0	594
16123	5	1	16	598	0	620
16124	2	1	5	623	0	631
16125	607	2	2	21	0	632
16126	605	2	0	5	0	612
16127	20	616	1	2	0	639
16128	605	15	2	1	0	623
16129	19	3	574	2	0	598
16130	4	1	561	2	0	568
16131	541	0	19	1	0	561
16132	14	543	5	1	0	563
16133	504	12	0	1	0	517
16134	13	509	0	1	0	523
16135	505	13	1	0	0	519
16136	14	4	2	483	0	503
16137	5	1	487	13	0	506
16138	3	0	12	489	0	504
16139	4	0	4	506	0	514
16140	496	1	2	16	0	515
16141	13	1	492	5	0	511
16142	488	1	13	2	0	504
16143	14	483	6	1	0	504
16144	493	13	1	0	0	507
16145	14	5	0	488	0	507
16146	6	2	484	12	0	504
16147	1	1	13	487	0	502
16148	490	1	5	14	0	510
16149	15	0	0	493	0	508
16150	7	0	1	486	0	494
16151	2	476	1	15	0	494
16152	2	11	1	483	0	497
16153	1	2	477	15	0	495
16154	1	1	13	476	0	491
16155	3	0	5	488	0	496
16156	478	2	0	15	0	495
16157	16	1	0	478	0	495
16158	6	2	470	14	0	492
16159	3	470	12	5	0	490
16160	0	12	7	465	0	484
16161	3	4	3	472	0	482
16162	464	2	1	18	0	485
16163	12	464	0	8	0	484
16164	5	14	0	464	0	483
16165	449	6	1	13	0	469
16166	478	1	1	5	0	485
16167	18	1	2	475	0	496
16168	5	1	469	17	0	492
16169	469	0	14	9	0	492
16170	16	0	4	491	0	511
16171	487	0	2	16	0	505
16172	492	1	3	4	0	500
16173	18	477	0	4	0	499
16174	473	14	1	2	0	490
16175	16	486	0	2	0	504
16176	5	13	1	479	0	498
16177	2	2	3	469	0	476
16178	4	469	0	18	0	491
16179	468	13	1	7	0	489
16180	474	4	0	4	0	482
16181	16	3	448	3	0	470
16182	7	1	453	1	0	462
16183	3	2	16	451	0	472
16184	451	1	5	15	0	472
16185	16	0	1	452	0	469
16186	5	1	1	454	0	461
16187	4	2	436	16	0	458
16188	2	1	444	7	0	454
16189	2	1	458	2	0	463
16190	429	0	16	5	0	450
16191	436	0	4	6	0	446
16192	18	418	2	2	0	440
16193	7	426	1	2	0	436
16194	5	12	1	415	0	433
16195	7	5	419	11	0	442
16196	405	3	14	4	0	426
16197	16	1	433	3	0	453
16198	6	1	16	411	0	434
16199	4	2	5	431	0	442
16200	4	1	1	436	0	442
16201	2	3	1	445	0	451
16202	434	1	1	16	0	452
16203	17	4	1	425	0	447
16204	7	0	417	12	0	436
16205	383	0	13	7	0	403
16206	12	0	374	2	0	388
16207	2	1	382	3	0	388
16208	2	367	13	4	0	386
16209	5	8	1	308	0	322
16210	301	2	4	7	0	314
16211	7	0	0	302	0	309
16212	2	1	307	6	0	316
16213	2	0	7	298	0	307
16214	296	0	1	7	0	304
16215	6	299	2	3	0	310
16216	300	7	0	3	0	310
16217	7	311	0	0	0	318
16218	297	4	0	3	0	304
16219	4	285	1	0	0	290
16220	2	284	1	1	0	288
16221	0	4	273	1	0	278
16222	1	265	3	1	0	270
16223	223	2	0	0	0	225
16224	3	0	0	224	0	227
16225	225	0	0	2	0	227
16226	2	229	0	0	0	231
16227	222	2	0	1	0	225
16228	2	0	241	0	0	243
16229	0	0	2	238	0	240
16230	0	247	0	2	0	249
16231	0	2	0	248	0	250
16232	1	0	0	250	0	251
16233	311	0	0	3	0	314
16234	4	315	0	0	0	319
16235	315	4	0	1	0	320
16236	4	2	318	0	0	324
16237	2	1	314	0	0	317
16238	0	315	7	1	0	323
16239	0	3	1	321	0	325
16240	0	2	324	4	0	330
16241	2	0	6	301	0	309
16242	0	0	3	329	0	332
16243	0	0	322	7	0	329
16244	3	0	315	1	0	319
16245	1	0	330	0	0	331
16246	0	0	326	0	0	326
16247	0	338	7	2	0	347
16248	1	4	2	327	0	334
16249	1	3	1	342	0	347
16250	1	0	332	7	0	340
16251	0	0	6	333	0	339
16252	0	0	357	4	0	361
16253	0	0	5	353	0	358
16254	1	0	4	347	0	352
16255	0	353	0	9	0	362
16256	2	5	0	353	0	360
16257	0	3	3	347	0	353
16258	0	0	2	363	0	365
16259	1	2	350	8	0	361
16260	0	351	5	5	0	361
16261	350	5	6	0	0	361
16262	351	5	0	1	0	357
16263	8	0	0	346	0	354
16264	4	0	1	331	0	336
16265	0	354	1	9	0	364
16266	352	4	2	5	0	363
16267	3	350	0	1	0	354
16268	356	5	0	0	0	361
16269	4	4	344	1	0	353
16270	338	0	4	1	0	343
16271	4	349	5	0	0	358
16272	5	4	0	360	0	369
16273	1	4	1	350	0	356
16274	0	360	0	8	0	368
16275	348	3	2	5	0	358
16276	4	6	0	354	0	364
16277	5	0	0	372	0	377
16278	375	2	0	10	0	387
16279	379	0	0	7	0	386
16280	9	2	374	1	0	386
16281	388	1	3	0	0	392
16282	5	0	6	394	0	405
16283	6	1	399	5	0	411
16284	3	1	4	395	0	403
16285	2	0	394	6	0	402
16286	0	0	397	7	0	404
16287	2	0	8	404	0	414
16288	0	2	427	6	0	435
16289	2	429	7	5	0	443
16290	0	5	6	419	0	430
16291	2	3	2	441	0	448
16292	0	2	436	8	0	446
16293	0	435	5	6	0	446
16294	443	6	6	2	0	457
16295	5	7	1	453	0	466
16296	458	1	0	8	0	467
16297	6	443	0	7	0	456
16298	6	5	456	2	0	469
16299	2	5	5	450	0	462
16300	450	1	5	9	0	465
16301	6	2	455	6	0	469
16302	433	0	5	3	0	441
16303	7	438	6	2	0	453
16304	7	449	4	0	0	460
16305	447	10	1	4	0	462
16306	6	6	4	443	0	459
16307	7	1	5	441	0	454
16308	3	451	4	11	0	469
16309	1	5	3	459	0	468
16310	0	8	3	457	0	468
16311	453	2	3	13	0	471
16312	4	2	3	454	0	463
16313	6	0	451	9	0	466
16314	2	4	5	447	0	458
16315	1	2	8	455	0	466
16316	2	3	446	12	0	463
16317	4	2	6	448	0	460
16318	432	1	6	13	0	452
16319	426	2	4	8	0	440
16320	441	3	3	5	0	452
16321	12	0	3	437	0	452
16322	9	1	447	8	0	465
16323	5	457	6	9	0	477
16324	2	7	7	458	0	474
16325	6	7	461	7	0	481
16326	3	3	5	463	0	474
16327	5	3	5	469	0	482
16328	452	1	3	11	0	467
16329	7	456	3	9	0	475
16330	6	7	443	4	0	460
16331	429	8	5	6	0	448
16332	7	455	6	6	0	474
16333	4	393	3	6	0	406
16334	397	6	1	4	0	408
16335	2	6	2	402	0	412
16336	3	1	473	4	0	481
16337	3	0	4	478	0	485
16338	3	479	4	7	0	493
16339	488	4	3	6	0	501
16340	7	4	2	493	0	506
16341	509	1	2	8	0	520
16342	7	2	2	508	0	519
16343	8	534	2	4	0	548
16344	535	5	1	8	0	549
16345	538	3	3	1	0	545
16346	9	544	0	5	0	558
16347	537	5	3	4	0	549
16348	8	1	2	532	0	543
16349	4	536	1	6	0	547
16350	539	6	2	4	0	551
16351	11	535	0	3	0	549
16352	523	9	2	2	0	536
16353	7	5	1	523	0	536
16354	523	3	0	6	0	532
16355	525	4	0	4	0	533
16356	519	2	1	2	0	524
16357	8	3	1	520	0	532
16358	5	2	1	528	0	536
16359	525	1	1	10	0	537
16360	8	3	530	5	0	546
16361	6	1	3	523	0	533
16362	4	529	2	8	0	543
16363	4	6	2	540	0	552
16364	2	3	1	546	0	552
16365	6	3	538	8	0	555
16366	4	3	5	561	0	573
16367	6	607	2	13	0	628
16368	4	14	1	621	0	640
16369	1	9	691	16	0	717
16370	6	3	17	692	0	718
16371	2	4	10	718	0	734
16372	681	3	3	29	0	716
16373	693	2	3	15	0	713
16374	30	1	1	677	0	709
16375	11	659	1	23	0	694
16376	11	676	2	6	0	695
16377	4	23	649	10	0	686
16378	3	13	20	643	0	679
16379	647	6	6	26	0	685
16380	22	5	5	655	0	687
16381	8	0	657	27	0	692
16382	4	2	24	658	0	688
16383	7	1	6	678	0	692
16384	2	1	4	691	0	698
16385	3	0	661	29	0	693
16386	2	666	19	12	0	699
16387	658	21	7	10	0	696
16388	649	9	4	5	0	667
16389	27	5	4	629	0	665
16390	7	4	633	27	0	671
16391	6	628	22	10	0	666
16392	5	20	7	620	0	652
16393	1	641	3	23	0	668
16394	1	653	6	9	0	669
16395	626	29	2	7	0	664
16396	22	10	629	6	0	667
16397	8	6	635	5	0	654
16398	5	3	27	612	0	647
16399	3	4	9	658	0	674
16400	2	1	658	26	0	687
16401	3	2	22	626	0	653
16402	2	2	642	29	0	675
16403	606	1	27	10	0	644
16404	20	4	10	641	0	675
16405	9	1	682	24	0	716
16406	5	3	22	643	0	673
16407	4	706	6	22	0	738
16408	711	21	4	14	0	750
16409	21	713	5	5	0	744
16410	712	24	4	6	0	746
16411	26	10	717	5	0	758
16412	710	5	21	6	0	742
16413	26	4	10	732	0	772
16414	11	1	743	24	0	779
16415	4	3	26	738	0	771
16416	8	1	731	27	0	767
16417	659	5	21	14	0	699
16418	20	738	8	11	0	777
16419	11	22	6	715	0	754
16420	5	765	5	19	0	794
16421	752	22	2	14	0	790
16422	750	13	4	4	0	771
16423	31	753	2	9	0	795
16424	11	27	6	752	0	796
16425	9	7	1	769	0	786
16426	7	5	6	759	0	777
16427	744	4	3	35	0	786
16428	18	740	4	20	0	782
16429	10	22	4	745	0	781
16430	6	9	2	752	0	769
16431	722	7	3	30	0	762
16432	26	3	723	12	0	764
16433	7	6	703	12	0	728
16434	681	1	29	11	0	722
16435	27	2	710	6	0	745
16436	10	2	646	4	0	662
16437	5	0	26	625	0	656
16438	644	3	13	20	0	680
16439	19	3	5	641	0	668
16440	9	1	635	18	0	663
16441	586	5	19	11	0	621
16442	21	1	619	11	0	652
16443	6	612	21	6	0	645
16444	15	18	15	617	0	665
16445	637	7	6	21	0	671
16446	21	5	6	638	0	670
16447	9	5	3	655	0	672
16448	646	2	3	29	0	680
16449	19	1	4	649	0	673
16450	8	1	5	678	0	692
16451	7	1	664	30	0	702
16452	4	2	19	680	0	705
16453	679	2	9	25	0	715
16454	691	2	3	13	0	709
16455	694	0	9	8	0	711
16456	28	4	3	675	0	710
16457	14	675	1	23	0	713
16458	678	15	3	6	0	702
16459	17	686	3	6	0	712
16460	685	20	2	9	0	716
16461	23	8	4	682	0	717
16462	681	4	0	24	0	709
16463	679	2	3	13	0	697
16464	687	1	6	5	0	699
16465	25	652	2	9	0	688
16466	8	637	1	3	0	649
16467	584	12	1	0	0	597
16468	12	591	1	1	0	605
16469	0	514	0	0	0	514
16470	1	507	0	1	0	509
16471	513	1	0	2	0	516
16472	1	0	1	511	0	513
16473	0	1	1	510	0	512
16474	509	1	0	1	0	511
16475	2	1	525	0	0	528
16476	0	0	2	583	0	585
16477	0	0	0	579	0	579
16478	2	2	0	654	0	658
16479	0	2	1	680	0	683
16480	2	681	1	16	0	700
16481	1	844	0	7	0	852
16482	862	22	4	6	0	894
16483	20	11	0	864	0	895
16484	8	7	2	880	0	897
16485	8	4	865	29	0	906
16486	6	0	16	870	0	892
16487	4	0	873	32	0	909
16488	5	0	23	879	0	907
16489	0	2	918	28	0	948
16490	0	911	23	18	0	952
16491	3	18	11	933	0	965
16492	906	9	4	29	0	948
16493	906	6	5	14	0	931
16494	31	4	2	906	0	943
16495	12	4	901	27	0	944
16496	11	2	909	10	0	932
16497	862	1	30	10	0	903
16498	17	869	14	11	0	911
16499	886	22	15	2	0	925
16500	880	8	5	9	0	902
16501	32	5	869	4	0	910
16502	15	7	22	847	0	891
16503	11	0	10	857	0	878
16504	10	4	8	882	0	904
16505	5	5	7	827	0	844
16506	9	3	2	809	0	823
16507	7	3	763	37	0	810
16508	6	1	778	20	0	805
16509	5	1	34	780	0	820
16510	1	4	21	792	0	818
16511	8	1	13	798	0	820
16512	767	3	6	43	0	819
16513	25	4	4	775	0	808
16514	768	1	1	37	0	807
16515	31	1	6	771	0	809
16516	776	2	5	36	0	819
16517	796	0	3	28	0	827
16518	783	0	1	20	0	804
16519	780	1	6	17	0	804
16520	785	2	5	14	0	806
16521	48	3	7	750	0	808
16522	758	2	5	35	0	800
16523	36	734	5	18	0	793
16524	748	26	1	17	0	792
16525	34	8	5	758	0	805
16526	24	7	735	30	0	796
16527	13	5	28	756	0	802
16528	19	0	747	39	0	805
16529	10	2	31	755	0	798
16530	10	2	16	777	0	805
16531	13	4	747	41	0	805
16532	12	5	762	19	0	798
16533	13	1	33	755	0	802
16534	746	2	17	36	0	801
16535	32	5	763	16	0	816
16536	19	749	30	19	0	817
16537	13	25	787	15	0	840
16538	784	12	37	9	0	842
16539	29	5	18	791	0	843
16540	777	8	16	30	0	831
16541	797	0	12	21	0	830
16542	48	0	6	783	0	837
16543	22	2	761	33	0	818
16544	14	2	31	763	0	810
16545	11	3	15	762	0	791
16546	727	1	14	47	0	789
16547	30	737	12	28	0	807
16548	20	26	1	749	0	796
16549	11	10	739	35	0	795
16550	732	7	30	13	0	782
16551	25	735	16	22	0	798
16552	18	24	12	732	0	786
16553	16	10	6	757	0	789
16554	15	6	2	762	0	785
16555	734	5	4	44	0	787
16556	756	2	4	33	0	795
16557	39	2	6	748	0	795
16558	28	1	743	35	0	807
16559	18	740	25	19	0	802
16560	735	26	10	16	0	787
16561	765	10	10	17	0	802
16562	41	9	8	733	0	791
16563	18	9	3	766	0	796
16564	23	1	749	35	0	808
16565	12	757	26	23	0	818
16566	760	25	14	25	0	824
16567	763	11	9	16	0	799
16568	38	763	10	10	0	821
16569	772	26	4	12	0	814
16570	40	11	4	759	0	814
16571	17	8	748	30	0	803
16572	12	8	29	768	0	817
16573	9	4	749	30	0	792
16574	750	3	34	18	0	805
16575	30	737	15	17	0	799
16576	14	22	4	689	0	729
16577	8	7	695	22	0	732
16578	6	7	659	16	0	688
16579	602	3	26	7	0	638
16580	19	599	10	9	0	637
16581	440	11	13	4	0	468
16582	420	3	5	0	0	428
16583	419	2	3	3	0	427
16584	10	1	3	411	0	425
16585	5	0	424	11	0	440
16586	8	416	8	3	0	435
16587	5	11	0	419	0	435
16588	3	3	414	9	0	429
16589	3	1	365	2	0	371
16590	3	2	9	358	0	372
16591	4	1	357	8	0	370
16592	346	2	9	3	0	360
16593	7	0	3	369	0	379
16594	3	1	3	381	0	388
16595	381	0	1	10	0	392
16596	9	368	1	5	0	383
16597	392	6	3	3	0	404
16598	7	3	2	392	0	404
16599	2	2	2	406	0	412
16600	3	2	2	405	0	412
16601	4	0	1	410	0	415
16602	393	2	0	12	0	407
16603	7	1	403	5	0	416
16604	3	405	7	4	0	419
16605	2	7	2	410	0	421
16606	393	3	1	8	0	405
16607	415	1	1	3	0	420
16608	8	412	0	4	0	424
16609	407	6	1	2	0	416
16610	8	410	0	3	0	421
16611	2	426	1	2	0	431
16612	2	6	1	424	0	433
16613	1	2	421	7	0	431
16614	2	1	6	414	0	423
16615	426	2	0	4	0	432
16616	3	420	1	1	0	425
16617	0	2	2	431	0	435
16618	2	0	466	4	0	472
16619	463	1	4	1	0	469
16620	476	2	0	2	0	480
16621	478	0	1	1	0	480
16622	7	0	462	0	0	469
16623	453	1	4	0	0	458
16624	6	466	0	3	0	475
16625	0	4	2	437	0	443
16626	0	464	0	5	0	469
16627	466	4	1	1	0	472
16628	450	1	1	0	0	452
16629	5	0	458	1	0	464
16630	1	468	5	1	0	475
16631	1	4	2	469	0	476
16632	3	0	0	470	0	473
16633	1	1	1	461	0	464
16634	0	0	1	453	0	454
16635	2	1	0	465	0	468
16636	1	2	447	6	0	456
16637	1	427	7	3	0	438
16638	415	7	2	1	0	425
16639	7	3	424	1	0	435
16640	2	439	6	2	0	449
16641	442	5	1	3	0	451
16642	7	2	466	1	0	476
16643	443	0	7	4	0	454
16644	454	0	2	2	0	458
16645	451	0	1	1	0	453
16646	7	445	0	0	0	452
16647	2	7	441	1	0	451
16648	0	454	9	0	0	463
16649	2	9	2	396	0	409
16650	3	443	0	6	0	452
16651	437	6	6	1	0	450
16652	454	1	1	0	0	456
16653	454	1	0	2	0	457
16654	11	0	455	0	0	466
16655	3	483	6	0	0	492
16656	1	6	6	511	0	524
16657	566	6	1	7	0	580
16658	12	561	0	5	0	578
16659	3	17	2	558	0	580
16660	8	6	567	13	0	594
16661	568	1	15	4	0	588
16662	20	2	603	1	0	626
16663	8	2	665	3	0	678
16664	607	6	22	2	0	637
16665	20	3	640	6	0	669
16666	617	1	22	6	0	646
16667	23	621	8	1	0	653
16668	637	18	5	5	0	665
16669	24	5	8	626	0	663
16670	11	4	7	631	0	653
16671	8	1	9	644	0	662
16672	615	2	10	27	0	654
16673	633	0	4	9	0	646
16674	642	3	8	6	0	659
16675	33	608	1	3	0	645
16676	10	22	2	621	0	655
16677	12	6	597	21	0	636
16678	4	5	19	583	0	611
16679	6	573	8	28	0	615
16680	6	15	5	573	0	599
16681	14	6	0	596	0	616
16682	584	7	3	23	0	617
16683	26	1	2	589	0	618
16684	8	9	573	23	0	613
16685	6	2	565	16	0	589
16686	2	4	29	570	0	605
16687	572	2	9	29	0	612
16688	21	6	3	572	0	602
16689	9	2	1	590	0	602
16690	5	3	581	33	0	622
16691	7	588	19	16	0	630
16692	5	18	10	610	0	643
16693	579	4	11	25	0	619
16694	23	584	9	12	0	628
16695	6	15	5	593	0	619
16696	12	7	586	21	0	626
16697	6	5	23	584	0	618
16698	559	2	8	30	0	599
16699	20	555	10	10	0	595
16700	9	26	555	9	0	599
16701	8	8	25	560	0	601
16702	8	8	566	26	0	608
16703	541	8	23	15	0	587
16704	566	4	9	13	0	592
16705	34	4	560	4	0	602
16706	15	4	18	554	0	591
16707	14	2	568	18	0	602
16708	4	557	27	11	0	599
16709	3	23	16	556	0	598
16710	7	6	554	30	0	597
16711	8	6	27	518	0	559
16712	7	534	12	24	0	577
16713	9	22	6	547	0	584
16714	4	7	545	25	0	581
16715	505	7	24	15	0	551
16716	20	515	18	11	0	564
16717	515	23	12	2	0	552
16718	30	9	490	10	0	539
16719	480	9	30	5	0	524
16720	29	2	490	12	0	533
16721	473	9	26	6	0	514
16722	510	3	10	6	0	529
16723	30	5	9	489	0	533
16724	19	3	6	511	0	539
16725	489	8	5	29	0	531
16726	33	486	3	14	0	536
16727	509	21	10	7	0	547
16728	38	8	5	497	0	548
16729	14	507	7	21	0	549
16730	15	19	5	520	0	559
16731	13	6	5	531	0	555
16732	7	9	4	530	0	550
16733	7	504	3	36	0	550
16734	513	19	5	12	0	549
16735	24	10	2	520	0	556
16736	18	11	508	20	0	557
16737	8	3	499	20	0	530
16738	3	7	512	14	0	536
16739	509	2	26	10	0	547
16740	513	8	9	15	0	545
16741	29	1	500	12	0	542
16742	9	2	19	454	0	484
16743	6	1	9	481	0	497
16744	2	0	500	24	0	526
16745	3	1	504	11	0	519
16746	4	2	26	501	0	533
16747	505	1	10	18	0	534
16748	505	2	5	6	0	518
16749	500	2	3	9	0	514
16750	22	481	5	6	0	514
16751	10	503	5	4	0	522
16752	6	16	6	500	0	528
16753	484	8	3	20	0	515
16754	23	3	465	8	0	499
16755	418	3	14	6	0	441
16756	14	418	5	5	0	442
16757	2	372	2	5	0	381
16758	363	10	1	1	0	375
16759	10	362	4	0	0	376
16760	1	356	1	0	0	358
16761	337	11	9	1	0	358
16762	10	350	1	0	0	361
16763	0	3	1	312	0	316
16764	0	0	0	315	0	315
16765	312	0	0	5	0	317
16766	313	0	1	0	0	314
16767	3	309	1	0	0	313
16768	0	310	1	4	0	315
16769	0	2	320	0	0	322
16770	308	0	3	0	0	311
16771	325	0	0	0	0	325
16772	346	1	0	0	0	347
16773	5	1	0	358	0	364
16774	0	0	0	367	0	367
16775	372	0	0	5	0	377
16776	5	0	0	376	0	381
16777	2	0	391	5	0	398
16778	0	1	5	384	0	390
16779	0	394	1	4	0	399
16780	2	5	0	398	0	405
16781	2	1	0	403	0	406
16782	4	1	0	412	0	417
16783	401	0	2	12	0	415
16784	5	413	3	8	0	429
16785	8	5	0	417	0	430
16786	1	5	398	14	0	418
16787	3	0	395	7	0	405
16788	5	0	6	398	0	409
16789	1	8	0	404	0	413
16790	396	1	1	13	0	411
16791	4	3	1	374	0	382
16792	2	371	1	15	0	389
16793	7	6	391	3	0	407
16794	3	7	7	389	0	406
16795	0	0	392	18	0	410
16796	2	1	13	396	0	412
16797	398	1	9	6	0	414
16798	390	1	2	12	0	405
16799	8	408	4	6	0	426
16800	9	5	5	410	0	429
16801	416	2	4	13	0	435
16802	419	6	3	5	0	433
16803	426	0	5	7	0	438
16804	420	0	2	10	0	432
16805	425	1	8	2	0	436
16806	6	417	1	13	0	437
16807	426	2	0	6	0	434
16808	14	1	422	0	0	437
16809	7	7	3	419	0	436
16810	432	2	0	9	0	443
16811	434	2	1	2	0	439
16812	429	2	0	2	0	433
16813	13	4	419	3	0	439
16814	10	1	4	454	0	469
16815	475	0	5	4	0	484
16816	5	472	0	7	0	484
16817	499	5	2	0	0	506
16818	478	1	7	1	0	487
16819	476	4	1	7	0	488
16820	12	2	4	491	0	509
16821	503	0	1	6	0	510
16822	12	4	503	2	0	521
16823	6	4	502	3	0	515
16824	503	1	3	8	0	515
16825	15	0	514	1	0	530
16826	480	6	5	2	0	493
16827	11	0	519	5	0	535
16828	12	1	4	515	0	532
16829	516	1	5	3	0	525
16830	4	504	4	8	0	520
16831	514	3	1	1	0	519
16832	7	497	9	1	0	514
16833	4	519	8	1	0	532
16834	8	3	3	527	0	541
16835	2	1	8	521	0	532
16836	9	2	2	513	0	526
16837	3	3	513	5	0	524
16838	490	1	4	9	0	504
16839	529	4	1	1	0	535
16840	514	9	2	2	0	527
16841	535	1	0	5	0	541
16842	531	6	1	4	0	542
16843	6	7	493	5	0	511
16844	4	0	488	7	0	499
16845	6	1	4	495	0	506
16846	6	1	499	10	0	516
16847	487	0	9	2	0	498
16848	15	528	2	2	0	547
16849	11	6	2	584	0	603
16850	594	1	6	8	0	609
16851	16	1	3	596	0	616
16852	10	1	608	13	0	632
16853	6	0	613	3	0	622
16854	6	2	15	631	0	654
16855	1	5	627	16	0	649
16856	600	0	17	5	0	622
16857	17	0	4	629	0	650
16858	2	7	621	14	0	644
16859	3	626	12	8	0	649
16860	9	8	6	646	0	669
16861	1	3	648	16	0	668
16862	1	2	16	591	0	610
16863	6	0	9	614	0	629
16864	2	1	627	20	0	650
16865	2	2	20	623	0	647
16866	7	4	4	595	0	610
16867	3	0	2	637	0	642
16868	617	0	6	13	0	636
16869	10	624	2	9	0	645
16870	2	620	1	14	0	637
16871	3	9	615	0	0	627
16872	566	5	7	12	0	590
16873	11	3	585	9	0	608
16874	2	1	572	3	0	578
16875	3	1	8	557	0	569
16876	564	0	4	9	0	577
16877	8	564	4	1	0	577
16878	563	7	2	3	0	575
16879	557	1	1	4	0	563
16880	7	593	1	3	0	604
16881	590	12	1	2	0	605
16882	584	3	1	2	0	590
16883	10	593	0	1	0	604
16884	4	7	2	588	0	601
16885	2	2	1	607	0	612
16886	626	2	1	11	0	640
16887	7	627	1	4	0	639
16888	638	8	0	1	0	647
16889	647	1	0	1	0	649
16890	669	4	0	2	0	675
16891	12	1	1	669	0	683
16892	6	1	0	675	0	682
16893	661	1	1	8	0	671
16894	674	1	1	4	0	680
16895	680	0	0	4	0	684
16896	12	1	0	701	0	714
16897	4	2	726	11	0	743
16898	4	1	8	733	0	746
16899	4	0	1	790	0	795
16900	3	2	771	9	0	785
16901	3	0	862	5	0	870
16902	1	1	17	896	0	915
16903	1	1	899	18	0	919
16904	908	0	20	9	0	937
16905	17	0	5	930	0	952
16906	5	0	9	945	0	959
16907	951	1	1	26	0	979
16908	19	0	7	964	0	990
16909	6	1	2	978	0	987
16910	9	0	5	976	0	990
16911	7	1	1	980	0	989
16912	2	1	953	32	0	988
16913	3	0	17	942	0	962
16914	6	0	906	26	0	938
16915	3	907	20	13	0	943
16916	0	21	3	932	0	956
16917	1	3	909	26	0	939
16918	846	5	19	17	0	887
16919	17	900	10	11	0	938
16920	893	19	10	7	0	929
16921	24	4	4	868	0	900
16922	4	880	4	20	0	908
16923	887	17	4	7	0	915
16924	18	893	5	9	0	925
16925	908	24	4	3	0	939
16926	26	9	2	899	0	936
16927	906	8	1	24	0	939
16928	27	912	3	10	0	952
16929	914	27	1	7	0	949
16930	31	7	908	5	0	951
16931	7	7	19	922	0	955
16932	901	2	5	22	0	930
16933	922	5	5	10	0	942
16934	31	2	0	904	0	937
16935	10	6	914	20	0	950
16936	11	872	22	9	0	914
16937	6	931	8	10	0	955
16938	942	22	7	8	0	979
16939	29	8	1	936	0	974
16940	11	4	7	949	0	971
16941	926	3	6	29	0	964
16942	928	6	5	13	0	952
16943	28	3	942	8	0	981
16944	15	8	20	955	0	998
16945	12	1	944	31	0	988
16946	7	944	23	12	0	986
16947	906	19	5	13	0	943
16948	24	918	7	7	0	956
16949	10	898	5	8	0	921
16950	5	21	8	890	0	924
16951	858	9	6	26	0	899
16952	24	868	9	6	0	907
16953	850	24	4	11	0	889
16954	24	864	4	7	0	899
16955	9	24	4	866	0	903
16956	868	11	5	22	0	906
16957	21	10	881	15	0	927
16958	14	6	16	876	0	912
16959	10	12	874	19	0	915
16960	11	826	18	15	0	870
16961	7	882	6	15	0	910
16962	851	19	6	13	0	889
16963	22	863	6	12	0	903
16964	869	23	11	10	0	913
16965	897	8	5	12	0	922
16966	20	10	876	8	0	914
16967	856	8	20	6	0	890
16968	24	8	884	9	0	925
16969	17	883	19	5	0	924
16970	901	20	7	5	0	933
16971	28	896	6	7	0	937
16972	16	21	7	897	0	941
16973	914	5	8	24	0	951
16974	25	8	6	904	0	943
16975	6	8	934	28	0	976
16976	13	9	17	931	0	970
16977	11	10	4	943	0	968
16978	936	5	4	29	0	974
16979	23	3	936	18	0	980
16980	922	7	23	11	0	963
16981	958	5	7	12	0	982
16982	29	2	13	953	0	997
16983	14	5	5	956	0	980
16984	942	6	4	32	0	984
16985	34	944	4	15	0	997
16986	10	25	7	930	0	972
16987	17	7	925	25	0	974
16988	10	7	892	14	0	923
16989	7	922	24	11	0	964
16990	11	27	10	893	0	941
16991	9	10	4	918	0	941
16992	895	10	5	31	0	941
16993	31	8	6	889	0	934
16994	868	6	15	27	0	916
16995	27	867	7	15	0	916
16996	11	874	3	19	0	907
16997	10	890	5	9	0	914
16998	862	27	3	10	0	902
16999	813	6	7	6	0	832
17000	24	804	3	7	0	838
17001	684	13	1	2	0	700
17002	13	668	0	0	0	681
17003	4	14	0	663	0	681
17004	2	655	1	10	0	668
17005	655	15	1	4	0	675
17006	669	3	0	1	0	673
17007	16	1	0	634	0	651
17008	623	1	1	10	0	635
17009	11	0	0	626	0	637
17010	3	641	1	10	0	655
17011	0	9	0	651	0	660
17012	2	652	0	9	0	663
17013	649	11	0	4	0	664
17014	10	1	642	1	0	654
17015	632	0	9	1	0	642
17016	10	1	2	643	0	656
17017	3	0	642	10	0	655
17018	599	0	9	4	0	612
17019	12	1	653	1	0	667
17020	4	0	9	621	0	634
17021	3	0	4	647	0	654
17022	2	0	0	651	0	653
17023	1	0	1	654	0	656
17024	0	613	0	12	0	625
17025	1	7	0	664	0	672
17026	654	2	0	9	0	665
17027	8	1	641	3	0	653
17028	2	660	7	2	0	671
17029	680	8	3	1	0	692
17030	705	2	0	1	0	708
17031	11	1	1	808	0	821
17032	2	2	818	17	0	839
17033	5	3	16	806	0	830
17034	6	3	4	916	0	929
17035	3	0	898	30	0	931
17036	1	932	25	13	0	971
17037	953	30	11	6	0	1000
17038	966	9	2	9	0	986
17039	981	3	7	6	0	997
17040	41	8	4	956	0	1009
17041	21	4	2	1010	0	1037
17042	1005	1	1	41	0	1048
17043	37	3	2	960	0	1002
17044	12	971	4	39	0	1026
17045	1010	31	4	17	0	1062
17046	1021	9	2	14	0	1046
17047	1077	7	1	6	0	1091
17048	1092	9	1	9	0	1111
17049	63	7	1000	5	0	1075
17050	27	1	1022	10	0	1060
17051	23	1	42	1011	0	1077
17052	15	3	19	1047	0	1084
17053	4	6	1013	52	0	1075
17054	12	4	1034	19	0	1069
17055	16	2	43	1002	0	1063
17056	1015	3	17	42	0	1077
17057	47	3	16	993	0	1059
17058	24	0	996	43	0	1063
17059	18	982	38	18	0	1056
17060	997	32	13	21	0	1063
17061	1004	11	16	13	0	1044
17062	1012	9	15	11	0	1047
17063	1029	9	14	6	0	1058
17064	58	3	947	14	0	1022
17065	35	1	36	959	0	1031
17066	971	3	19	38	0	1031
17067	43	6	19	958	0	1026
17068	26	4	12	937	0	979
17069	26	920	5	50	0	1001
17070	17	32	7	958	0	1014
17071	930	14	9	45	0	998
17072	46	936	6	22	0	1010
17073	939	40	6	15	0	1000
17074	56	937	6	15	0	1014
17075	33	41	3	872	0	949
17076	26	888	7	37	0	958
17077	15	926	8	28	0	977
17078	896	45	6	25	0	972
17079	43	25	881	18	0	967
17080	24	16	882	19	0	941
17081	23	15	871	19	0	928
17082	813	14	53	18	0	898
17083	41	851	28	15	0	935
17084	21	877	20	16	0	934
17085	817	41	11	12	0	881
17086	50	832	5	8	0	895
17087	26	861	4	13	0	904
17088	20	42	11	832	0	905
17089	22	25	831	37	0	915
17090	21	18	851	18	0	908
17091	21	16	42	842	0	921
17092	818	11	32	38	0	899
17093	42	823	30	16	0	911
17094	26	40	15	841	0	922
17095	31	22	805	46	0	904
17096	21	25	801	22	0	869
17097	18	16	50	790	0	874
17098	776	15	29	49	0	869
17099	812	9	24	22	0	867
17100	50	12	771	28	0	861
17101	786	9	39	24	0	858
17102	60	13	786	20	0	879
17103	28	12	48	754	0	842
17104	33	765	27	41	0	866
17105	785	39	27	21	0	872
17106	51	22	16	789	0	878
17107	32	17	17	786	0	852
17108	37	8	18	814	0	877
17109	32	6	21	815	0	874
17110	29	8	746	66	0	849
17111	32	721	43	37	0	833
17112	19	37	27	753	0	836
17113	750	21	25	50	0	846
17114	44	15	17	744	0	820
17115	21	14	17	782	0	834
17116	24	16	729	62	0	831
17117	21	13	713	41	0	788
17118	22	694	46	44	0	806
17119	18	747	30	27	0	822
17120	12	46	25	735	0	818
17121	724	25	14	52	0	815
17122	50	28	713	24	0	815
17123	32	726	37	30	0	825
17124	29	43	20	684	0	776
17125	25	712	20	43	0	800
17126	23	48	20	681	0	772
17127	8	705	19	53	0	785
17128	16	44	10	676	0	746
17129	652	21	11	41	0	725
17130	38	629	15	26	0	708
17131	18	34	6	511	0	569
17132	492	24	7	32	0	555
17133	31	491	4	23	0	549
17134	14	391	3	15	0	423
17135	14	411	4	8	0	437
17136	15	24	3	332	0	374
17137	4	14	2	337	0	357
17138	1	321	2	20	0	344
17139	5	16	1	319	0	341
17140	1	9	316	15	0	341
17141	7	305	11	6	0	329
17142	3	36	5	262	0	306
17143	3	278	4	7	0	292
17144	1	10	263	3	0	277
17145	4	254	8	3	0	269
17146	203	5	1	5	0	214
17147	3	0	0	197	0	200
17148	203	0	0	3	0	206
17149	3	0	202	0	0	205
17150	1	0	3	209	0	213
17151	0	0	215	3	0	218
17152	0	0	3	217	0	220
17153	230	0	0	3	0	233
17154	3	0	0	230	0	233
17155	227	0	0	3	0	230
17156	3	238	0	0	0	241
17157	228	3	0	2	0	233
17158	2	0	237	0	0	239
17159	0	255	3	0	0	258
17160	0	1	0	260	0	261
17161	3	0	0	259	0	262
17162	0	0	261	3	0	264
17163	0	264	3	0	0	267
17164	0	4	0	252	0	256
17165	0	254	0	3	0	257
17166	1	3	0	252	0	256
17167	0	250	0	4	0	254
17168	248	3	0	0	0	251
17169	3	0	0	252	0	255
17170	0	0	263	4	0	267
17171	0	257	2	0	0	259
17172	0	267	0	0	0	267
17173	0	3	263	0	0	266
17174	0	267	3	0	0	270
17175	0	1	0	263	0	264
17176	0	0	262	1	0	263
17177	1	0	1	248	0	250
17178	0	0	0	253	0	253
17179	0	0	259	1	0	260
17180	239	0	1	1	0	241
17181	1	0	0	258	0	259
17182	0	0	275	1	0	276
17183	0	276	1	0	0	277
17184	285	1	0	0	0	286
17185	1	286	0	0	0	287
17186	0	1	0	285	0	286
17187	277	0	0	1	0	278
17188	2	0	0	272	0	274
17189	0	0	292	1	0	293
17190	0	0	1	288	0	289
17191	0	0	292	1	0	293
17192	281	0	1	0	0	282
17193	1	0	307	0	0	308
17194	302	0	1	0	0	303
17195	317	0	0	3	0	320
17196	1	0	324	0	0	325
17197	0	0	305	0	0	305
17198	0	322	1	0	0	323
17199	340	1	0	2	0	343
17200	1	0	1	355	0	357
17201	0	0	0	352	0	352
17202	410	0	0	5	0	415
17203	423	0	0	2	0	425
17204	426	0	0	1	0	427
17205	431	0	0	2	0	433
17206	1	0	0	426	0	427
17207	435	1	0	1	0	437
17208	3	0	0	438	0	441
17209	0	0	0	435	0	435
17210	0	0	1	439	0	440
17211	1	0	437	1	0	439
17212	0	415	1	1	0	417
17213	0	440	1	0	0	441
17214	0	1	0	441	0	442
17215	438	0	3	2	0	443
17216	2	1	0	439	0	442
17217	439	0	0	2	0	441
17218	2	0	459	0	0	461
17219	442	0	1	2	0	445
17220	2	0	1	471	0	474
17221	498	0	0	2	0	500
17222	494	0	1	0	0	495
17223	503	0	0	2	0	505
17224	1	0	1	508	0	510
17225	1	0	502	1	0	504
17226	1	0	1	507	0	509
17227	508	0	1	1	0	510
17228	1	0	604	1	0	606
17229	0	1	2	625	0	628
17230	656	0	0	5	0	661
17231	3	0	665	0	0	668
17232	676	0	3	1	0	680
17233	723	0	0	3	0	726
17234	6	0	0	745	0	751
17235	1	0	0	753	0	754
17236	766	0	0	6	0	772
17237	5	0	0	773	0	778
17238	771	0	0	9	0	780
17239	7	775	0	3	0	785
17240	1	802	0	1	0	804
17241	0	8	0	813	0	821
17242	0	2	820	6	0	828
17243	0	815	7	1	0	823
17244	806	7	1	2	0	816
17245	8	801	1	1	0	811
17246	2	3	824	0	0	829
17247	0	1	7	818	0	826
17248	1	0	845	7	0	853
17249	0	858	8	8	0	874
17250	1	6	1	865	0	873
17251	1	857	0	7	0	865
17252	0	5	861	1	0	867
17253	3	1	8	846	0	858
17254	1	1	871	7	0	880
17255	2	1	7	856	0	866
17256	864	0	3	8	0	875
17257	8	0	853	2	0	863
17258	795	1	8	0	0	804
17259	7	0	847	1	0	855
17260	2	1	8	843	0	854
17261	3	0	892	7	0	902
17262	1	2	7	895	0	905
17263	2	0	2	892	0	896
17264	1	2	0	889	0	892
17265	2	1	0	898	0	901
17266	0	1	960	12	0	973
17267	931	1	7	2	0	941
17268	7	3	1	1023	0	1034
17269	1019	2	2	7	0	1030
17270	1021	3	0	5	0	1029
17271	1041	1	2	3	0	1047
17272	8	4	1	1059	0	1072
17273	4	1	3	1058	0	1066
17274	0	1172	2	11	0	1185
17275	1283	10	5	5	0	1303
17276	1363	10	1	14	0	1388
17277	1413	0	4	2	0	1419
17278	22	6	1454	3	0	1485
17279	12	0	16	1467	0	1495
17280	3	1	1466	17	0	1487
17281	1435	0	15	10	0	1460
17282	1473	1	10	3	0	1487
17283	23	1	3	1462	0	1489
17284	9	3	4	1421	0	1437
17285	8	1492	1	20	0	1521
17286	1505	14	5	10	0	1534
17287	1515	10	1	7	0	1533
17288	26	1498	4	6	0	1534
17289	1534	16	2	7	0	1559
17290	17	9	8	1522	0	1556
17291	16	0	4	1526	0	1546
17292	1522	2	4	27	0	1555
17293	19	2	1517	15	0	1553
17294	1507	1	13	11	0	1532
17295	1514	3	11	7	0	1535
17296	27	1508	1	4	0	1540
17297	1530	14	2	5	0	1551
17298	22	11	1518	2	0	1553
17299	21	3	12	1513	0	1549
17300	1524	5	9	17	0	1555
17301	25	3	0	1534	0	1562
17302	22	0	1493	20	0	1535
17303	6	3	23	1436	0	1468
17304	11	1620	13	23	0	1667
17305	12	15	8	1654	0	1689
17306	12	11	4	1667	0	1694
17307	14	3	5	1654	0	1676
17308	9	4	2	1679	0	1694
17309	5	5	1653	33	0	1696
17310	10	4	18	1645	0	1677
17311	1656	2	11	26	0	1695
17312	22	1643	2	20	0	1687
17313	18	19	5	1673	0	1715
17314	8	15	1687	23	0	1733
17315	10	3	16	1707	0	1736
17316	1737	6	9	28	0	1780
17317	1743	5	3	25	0	1776
17318	1719	2	6	12	0	1739
17319	35	2	5	1695	0	1737
17320	22	2	1680	25	0	1729
17321	15	1670	17	16	0	1718
17322	1688	16	14	4	0	1722
17323	24	13	7	1670	0	1714
17324	16	3	6	1685	0	1710
17325	8	4	1661	35	0	1708
17326	12	1626	21	18	0	1677
17327	10	1688	15	7	0	1720
17328	12	31	4	1586	0	1633
17329	10	16	1569	23	0	1618
17330	1448	5	19	23	0	1495
17331	19	8	1500	9	0	1536
17332	1448	4	14	14	0	1480
17333	25	1570	12	13	0	1620
17334	18	17	1546	11	0	1592
17335	1503	8	18	17	0	1546
17336	21	1531	14	17	0	1583
17337	1634	19	3	12	0	1668
17338	18	17	1624	6	0	1665
17339	16	1626	17	5	0	1664
17340	1645	15	15	11	0	1686
17341	22	10	1620	8	0	1660
17342	1627	3	14	4	0	1648
17343	24	4	16	1635	0	1679
17344	1651	4	10	17	0	1682
17345	21	4	11	1640	0	1676
17346	1641	9	5	16	0	1671
17347	24	6	1606	18	0	1654
17348	18	4	15	1613	0	1650
17349	12	4	14	1602	0	1632
17350	9	9	1618	24	0	1660
17351	11	7	21	1601	0	1640
17352	9	1318	17	27	0	1371
17353	6	15	6	1685	0	1712
17354	12	9	10	1743	0	1774
17355	8	4	8	1911	0	1931
17356	13	3	1909	49	0	1974
17357	1861	5	36	30	0	1932
17358	43	7	20	2031	0	2101
17359	26	2	2101	55	0	2184
17360	2026	1	52	29	0	2108
17361	2130	3	24	19	0	2176
17362	2189	5	11	13	0	2218
17363	79	6	12	2124	0	2221
17364	35	6	6	2400	0	2447
17365	21	2	5	2389	0	2417
17366	13	2327	12	89	0	2441
17367	2320	57	10	40	0	2427
17368	2345	22	3	21	0	2391
17369	90	10	9	2310	0	2419
17370	35	7	2278	71	0	2391
17371	29	8	2281	29	0	2347
17372	28	2169	87	20	0	2304
17373	19	2301	31	23	0	2374
17374	2109	94	23	26	0	2252
17375	57	2082	18	12	0	2169
17376	2027	63	11	7	0	2108
17377	2026	26	1	9	0	2062
17378	2009	11	3	21	0	2044
17379	89	8	3	1938	0	2038
17380	31	16	6	2088	0	2141
17381	2113	4	7	80	0	2204
17382	91	7	3	2136	0	2237
17383	30	9	2114	91	0	2244
17384	2131	4	78	35	0	2248
17385	89	5	26	2133	0	2253
17386	35	16	17	2185	0	2253
17387	26	14	13	2230	0	2283
17388	25	13	2124	98	0	2260
17389	1979	19	68	37	0	2103
17390	90	10	2104	28	0	2232
17391	44	9	76	2092	0	2221
17392	34	8	2113	80	0	2235
17393	20	3	84	2097	0	2204
17394	25	8	30	2185	0	2248
17395	26	5	2152	107	0	2290
17396	14	5	78	2052	0	2149
17397	19	2158	35	85	0	2297
17398	2167	71	18	41	0	2297
17399	2229	22	18	37	0	2306
17400	106	13	14	2162	0	2295
17401	39	10	2136	102	0	2287
17402	31	2040	82	39	0	2192
17403	27	2179	32	30	0	2268
17404	1983	85	29	29	0	2126
17405	89	26	1958	30	0	2103
17406	1958	16	94	22	0	2090
17407	93	13	33	1969	0	2108
17408	42	10	19	2044	0	2115
17409	1933	1	27	117	0	2078
17410	90	1925	16	63	0	2094
17411	34	80	1942	39	0	2095
17412	31	25	85	1918	0	2059
17413	27	19	1954	101	0	2101
17414	25	1906	92	47	0	2070
17415	28	78	45	1940	0	2091
17416	1889	34	32	97	0	2052
17417	1956	22	23	55	0	2056
17418	111	25	1885	31	0	2052
17419	48	1888	93	29	0	2058
17420	1885	83	31	29	0	2028
17421	101	1891	27	26	0	2045
17422	47	87	24	1874	0	2032
17423	1882	36	13	104	0	2035
17424	93	33	17	1897	0	2040
17425	46	18	1861	101	0	2026
17426	34	18	86	1891	0	2029
17427	30	17	1859	109	0	2015
17428	26	20	97	1863	0	2006
17429	1832	16	45	117	0	2010
17430	104	1834	31	43	0	2012
17431	1837	83	17	42	0	1979
17432	107	30	37	1814	0	1988
17433	52	28	19	1844	0	1943
17434	40	24	1643	120	0	1827
17435	24	31	1777	62	0	1894
17436	33	1749	99	47	0	1928
17437	39	85	1700	35	0	1859
17438	1595	34	104	46	0	1779
17439	95	1660	55	38	0	1848
17440	47	1742	31	37	0	1857
17441	26	1765	37	31	0	1859
17442	26	101	24	1716	0	1867
17443	36	46	1717	94	0	1893
17444	28	1744	88	44	0	1904
17445	29	100	35	1591	0	1755
17446	35	1732	25	100	0	1892
17447	1714	90	19	61	0	1884
17448	1779	34	40	35	0	1888
17449	103	25	28	1725	0	1881
17450	48	27	22	1760	0	1857
17451	1640	26	29	113	0	1808
17452	100	1613	26	49	0	1788
17453	41	1681	23	42	0	1787
17454	33	105	19	1536	0	1693
17455	18	33	1394	73	0	1518
17456	9	1368	66	38	0	1481
17457	1233	66	39	23	0	1361
17458	59	1226	20	29	0	1334
17459	23	1189	10	30	0	1252
17460	1119	65	28	16	0	1228
17461	60	1143	14	20	0	1237
17462	34	55	1090	15	0	1194
17463	16	1088	45	31	0	1180
17464	843	34	20	8	0	905
17465	34	827	5	12	0	878
17466	813	32	6	8	0	859
17467	35	16	7	808	0	866
17468	15	12	1	844	0	872
17469	9	6	815	41	0	871
17470	5	813	27	20	0	865
17471	9	28	11	835	0	883
17472	821	14	8	30	0	873
17473	833	11	5	13	0	862
17474	34	852	7	11	0	904
17475	14	24	2	826	0	866
17476	843	13	7	25	0	888
17477	862	10	4	14	0	890
17478	33	8	839	6	0	886
17479	7	10	811	8	0	836
17480	9	5	778	1	0	793
17481	4	722	23	2	0	751
17482	644	19	9	3	0	675
17483	14	645	4	4	0	667
17484	638	13	1	6	0	658
17485	11	688	5	1	0	705
17486	2	15	4	695	0	716
17487	719	6	2	13	0	740
17488	12	5	716	6	0	739
17489	715	2	11	3	0	731
17490	736	8	3	2	0	749
17491	15	720	1	6	0	742
17492	6	736	1	2	0	745
17493	745	11	6	4	0	766
17494	9	4	757	1	0	771
17495	710	2	15	3	0	730
17496	721	0	9	1	0	731
17497	11	3	5	709	0	728
17498	724	1	1	7	0	733
17499	7	3	1	753	0	764
17500	4	2	1	773	0	780
17501	1	6	0	755	0	762
17502	3	768	0	7	0	778
17503	786	7	1	1	0	795
17504	782	4	3	1	0	790
17505	9	4	0	786	0	799
17506	6	1	0	766	0	773
17507	5	782	4	7	0	798
17508	793	8	4	3	0	808
17509	7	3	795	2	0	807
17510	4	3	10	788	0	805
17511	4	4	785	5	0	798
17512	4	4	7	780	0	795
17513	4	2	803	8	0	817
17514	4	2	7	786	0	799
17515	795	4	1	7	0	807
17516	8	3	810	5	0	826
17517	794	2	5	6	0	807
17518	9	863	5	2	0	879
17519	5	5	3	872	0	885
17520	5	2	2	879	0	888
17521	908	2	2	10	0	922
17522	7	6	2	902	0	917
17523	5	4	931	6	0	946
17524	922	1	7	6	0	936
17525	965	5	3	1	0	974
17526	963	1	1	4	0	969
17527	966	4	2	5	0	977
17528	12	965	2	3	0	982
17529	5	6	4	980	0	995
17530	981	2	2	11	0	996
17531	12	0	2	978	0	992
17532	964	6	1	5	0	976
17533	10	5	953	2	0	970
17534	8	4	951	3	0	966
17535	9	4	6	907	0	926
17536	5	939	4	10	0	958
17537	9	966	1	2	0	978
17538	937	9	3	5	0	954
17539	9	12	955	4	0	980
17540	884	1	2	6	0	893
17541	5	941	4	9	0	959
17542	941	1	1	4	0	947
17543	4	3	3	938	0	948
17544	3	5	971	5	0	984
17545	5	2	2	967	0	976
17546	7	2	2	956	0	967
17547	3	963	4	4	0	974
17548	6	997	0	8	0	1011
17549	6	4	0	989	0	999
17550	1	999	2	9	0	1011
17551	5	3	989	4	0	1001
17552	4	4	955	5	0	968
17553	900	1	6	10	0	917
17554	980	1	4	4	0	989
17555	6	977	1	2	0	986
17556	7	2	0	975	0	984
17557	4	4	3	973	0	984
17558	5	2	976	6	0	989
17559	2	2	3	913	0	920
17560	5	971	3	4	0	983
17561	8	3	949	5	0	965
17562	6	3	948	2	0	959
17563	2	934	4	6	0	946
17564	2	3	964	3	0	972
17565	2	1	3	969	0	975
17566	4	4	3	868	0	879
17567	2	5	982	5	0	994
17568	7	5	6	961	0	979
17569	3	969	6	4	0	982
17570	5	1004	2	2	0	1013
17571	4	9	2	975	0	990
17572	2	6	993	8	0	1009
17573	3	989	6	8	0	1006
17574	9	13	2	992	0	1016
17575	0	3	993	7	0	1003
17576	899	2	5	5	0	911
17577	963	0	2	3	0	968
17578	966	1	3	1	0	971
17579	6	2	0	946	0	954
17580	3	0	1	972	0	976
17581	1	3	999	4	0	1007
17582	4	2	3	988	0	997
17583	5	2	2	997	0	1006
17584	3	1	1005	10	0	1019
17585	866	1	8	5	0	880
17586	4	937	3	5	0	949
17587	916	4	2	5	0	927
17588	3	918	4	2	0	927
17589	2	4	0	926	0	932
17590	4	1	934	4	0	943
17591	5	2	5	895	0	907
17592	1	4	907	6	0	918
17593	767	0	3	5	0	775
17594	6	2	852	0	0	860
17595	3	0	3	814	0	820
17596	2	0	851	5	0	858
17597	2	838	5	3	0	848
17598	4	3	4	849	0	860
17599	2	2	1	840	0	845
17600	2	0	4	872	0	878
17601	0	3	872	10	0	885
17602	0	0	887	4	0	891
17603	1	3	10	890	0	904
17604	1	0	0	1016	0	1017
17605	1	1	4	1138	0	1144
17606	1162	1	1	25	0	1189
17607	18	1	5	1215	0	1239
17608	5	0	1288	24	0	1317
17609	1411	0	23	13	0	1447
17610	28	2	9	1456	0	1495
17611	1525	0	4	34	0	1563
17612	1572	0	3	10	0	1585
17613	46	0	1	1539	0	1586
17614	1542	1	11	36	0	1590
17615	1556	1	3	21	0	1581
17616	48	2	1503	17	0	1570
17617	32	1516	30	8	0	1586
17618	17	30	14	1458	0	1519
17619	11	13	9	1522	0	1555
17620	1500	6	6	43	0	1555
17621	1468	4	6	24	0	1502
17622	1500	4	7	16	0	1527
17623	57	5	1389	13	0	1464
17624	29	1417	30	14	0	1490
17625	1413	30	15	12	0	1470
17626	46	1435	11	5	0	1497
17627	1434	38	13	3	0	1488
17628	49	21	4	1419	0	1493
17629	1423	10	9	37	0	1479
17630	1433	14	1	19	0	1467
17631	1453	5	2	14	0	1474
17632	59	6	1393	13	0	1471
17633	1444	1	33	10	0	1488
17634	59	1422	18	10	0	1509
17635	1461	37	11	9	0	1518
17636	1491	17	5	5	0	1518
17637	1502	11	5	10	0	1528
17638	73	6	9	1429	0	1517
17639	44	1399	3	38	0	1484
17640	1423	39	2	18	0	1482
17641	60	12	1408	12	0	1492
17642	37	1438	34	6	0	1515
17643	24	43	17	1333	0	1417
17644	24	1400	6	39	0	1469
17645	1409	53	9	10	0	1481
17646	1461	19	5	11	0	1496
17647	66	21	6	1408	0	1501
17648	35	22	1389	43	0	1489
17649	25	1404	42	26	0	1497
17650	31	44	18	1196	0	1289
17651	26	16	11	1466	0	1519
17652	22	16	8	1532	0	1578
17653	1483	14	7	63	0	1567
17654	1528	7	9	31	0	1575
17655	1548	11	5	21	0	1585
17656	1561	6	4	17	0	1588
17657	76	10	5	1505	0	1596
17658	48	6	1535	55	0	1644
17659	38	9	38	1558	0	1643
17660	37	4	14	1573	0	1628
17661	28	3	10	1586	0	1627
17662	23	7	9	1605	0	1644
17663	1546	4	6	83	0	1639
17664	60	12	5	1572	0	1649
17665	1556	4	9	74	0	1643
17666	1590	5	8	39	0	1642
17667	73	9	1527	30	0	1639
17668	42	5	1521	30	0	1598
17669	42	12	1575	15	0	1644
17670	33	8	61	1529	0	1631
17671	29	3	1558	57	0	1647
17672	31	7	55	1535	0	1628
17673	21	5	34	1550	0	1610
17674	1507	13	20	70	0	1610
17675	59	10	12	1487	0	1568
17676	37	1508	15	66	0	1626
17677	1540	41	11	35	0	1627
17678	62	1536	10	30	0	1638
17679	44	50	1524	26	0	1644
17680	39	1526	48	21	0	1634
17681	1509	55	24	25	0	1613
17682	65	24	18	1493	0	1600
17683	36	23	1468	53	0	1580
17684	1480	16	48	38	0	1582
17685	66	12	22	1493	0	1593
17686	42	11	1485	61	0	1599
17687	37	10	47	1479	0	1573
17688	40	5	24	1521	0	1590
17689	21	11	24	1507	0	1563
17690	31	1468	14	72	0	1585
17691	1491	45	18	40	0	1594
17692	60	21	15	1474	0	1570
17693	37	1504	17	55	0	1613
17694	30	45	12	1522	0	1609
17695	28	24	1493	72	0	1617
17696	24	1504	43	37	0	1608
17697	1493	47	24	39	0	1603
17698	1498	27	22	26	0	1573
17699	67	23	11	1460	0	1561
17700	38	20	10	1489	0	1557
17701	1459	18	12	63	0	1552
17702	1429	12	12	44	0	1497
17703	68	1423	8	28	0	1527
17704	1319	28	12	22	0	1381
17705	46	20	1199	14	0	1279
17706	39	14	1166	13	0	1232
17707	25	1124	38	21	0	1208
17708	14	1067	31	16	0	1128
17709	884	22	23	10	0	939
17710	17	918	6	12	0	953
17711	873	17	3	12	0	905
17712	854	12	2	11	0	879
17713	863	6	3	9	0	881
17714	24	4	3	844	0	875
17715	863	10	2	12	0	887
17716	29	3	845	7	0	884
17717	13	4	854	7	0	878
17718	9	853	15	10	0	887
17719	13	11	867	6	0	897
17720	12	5	19	839	0	875
17721	7	6	860	17	0	890
17722	5	6	859	11	0	881
17723	8	2	17	870	0	897
17724	881	1	13	12	0	907
17725	885	8	8	11	0	912
17726	23	4	904	11	0	942
17727	901	4	16	5	0	926
17728	21	5	941	3	0	970
17729	930	3	21	4	0	958
17730	982	6	8	5	0	1001
17731	22	1	6	965	0	994
17732	15	4	3	938	0	960
17733	12	916	9	14	0	951
17734	7	936	2	14	0	959
17735	11	12	6	930	0	959
17736	7	9	4	916	0	936
17737	904	6	5	13	0	928
17738	14	896	6	10	0	926
17739	900	9	5	10	0	924
17740	13	893	5	2	0	913
17741	8	13	867	5	0	893
17742	6	6	10	842	0	864
17743	842	5	6	11	0	864
17744	887	2	9	6	0	904
17745	16	895	3	7	0	921
17746	12	919	2	5	0	938
17747	10	937	2	4	0	953
17748	5	19	5	1022	0	1051
17749	5	7	1033	16	0	1061
17750	4	1024	14	6	0	1048
17751	6	14	4	1042	0	1066
17752	1	6	2	1046	0	1055
17753	4	3	1041	14	0	1062
17754	0	2	1013	7	0	1022
17755	980	1	13	5	0	999
17756	13	1	1055	1	0	1070
17757	1037	3	13	3	0	1056
17758	1005	0	6	2	0	1013
17759	1002	4	4	2	0	1012
17760	993	0	3	3	0	999
17761	16	1	967	3	0	987
17762	7	972	13	17	0	1009
17763	6	10	6	983	0	1005
17764	4	3	985	10	0	1002
17765	2	6	14	949	0	971
17766	3	895	7	14	0	919
17767	5	11	4	972	0	992
17768	5	3	5	962	0	975
17769	5	6	1	936	0	948
17770	946	1	3	16	0	966
17771	15	2	2	946	0	965
17772	6	2	2	946	0	956
17773	5	2	5	936	0	948
17774	4	904	2	20	0	930
17775	887	11	4	10	0	912
17776	10	859	4	10	0	883
17777	2	884	4	7	0	897
17778	4	13	2	881	0	900
17779	7	4	3	888	0	902
17780	881	5	3	21	0	910
17781	12	3	3	898	0	916
17782	895	0	4	20	0	919
17783	1084	2	2	8	0	1096
17784	33	1	5	1073	0	1112
17785	14	4	1	1080	0	1099
17786	6	1101	0	30	0	1137
17787	1123	23	1	13	0	1160
17788	29	1152	1	6	0	1188
17789	1156	32	2	6	0	1196
17790	32	14	1137	6	0	1189
17791	1124	4	31	15	0	1174
17792	1173	3	12	10	0	1198
17793	40	2	5	1127	0	1174
17794	15	5	1137	33	0	1190
17795	8	1176	32	17	0	1233
17796	9	40	9	1187	0	1245
17797	8	11	1202	39	0	1260
17798	10	7	34	1204	0	1255
17799	1198	1	8	41	0	1248
17800	42	5	1201	13	0	1261
17801	13	1183	35	9	0	1240
17802	8	1239	12	8	0	1267
17803	13	48	7	1059	0	1127
17804	7	1231	5	26	0	1269
17805	1214	37	3	10	0	1264
17806	1208	12	3	15	0	1238
17807	1222	6	6	12	0	1246
17808	47	7	1169	6	0	1229
17809	1164	7	37	16	0	1224
17810	41	9	11	1160	0	1221
17811	15	8	2	1180	0	1205
17812	11	7	1	1194	0	1213
17813	13	5	9	1173	0	1200
17814	13	14	1133	40	0	1200
17815	16	6	1132	14	0	1168
17816	9	7	1123	11	0	1150
17817	1074	4	38	13	0	1129
17818	41	1095	12	9	0	1157
17819	19	30	6	1078	0	1133
17820	1081	12	6	40	0	1139
17821	37	1092	7	22	0	1158
17822	14	1118	10	16	0	1158
17823	1080	41	9	14	0	1144
17824	1100	12	7	12	0	1131
17825	39	1110	8	8	0	1165
17826	16	38	3	1016	0	1073
17827	10	1065	7	34	0	1116
17828	1041	37	7	14	0	1099
17829	1038	16	5	7	0	1066
17830	1045	10	3	7	0	1065
17831	46	1009	3	9	0	1067
17832	17	35	1	1014	0	1067
17833	15	13	1020	37	0	1085
17834	13	11	33	1004	0	1061
17835	13	11	9	1041	0	1074
17836	12	9	1010	42	0	1073
17837	1015	5	34	18	0	1072
17838	39	6	14	1022	0	1081
17839	16	6	7	1030	0	1059
17840	8	1022	9	43	0	1082
17841	1016	41	7	16	0	1080
17842	42	10	10	997	0	1059
17843	20	1007	5	36	0	1068
17844	964	37	8	19	0	1028
17845	38	955	4	12	0	1009
17846	899	35	8	12	0	954
17847	40	13	896	12	0	961
17848	15	6	779	9	0	809
17849	10	7	778	8	0	803
17850	7	776	29	7	0	819
17851	10	36	8	657	0	711
17852	8	717	3	24	0	752
17853	720	29	1	12	0	762
17854	32	9	715	4	0	760
17855	703	2	29	4	0	738
17856	725	11	10	5	0	751
17857	37	2	4	695	0	738
17858	702	6	5	29	0	742
17859	30	4	3	708	0	745
17860	12	3	700	27	0	742
17861	693	4	29	12	0	738
17862	29	699	14	2	0	744
17863	11	28	3	704	0	746
17864	695	9	1	30	0	735
17865	28	6	3	701	0	738
17866	15	3	690	26	0	734
17867	9	1	27	683	0	720
17868	2	691	12	24	0	729
17869	695	26	1	8	0	730
17870	26	15	3	685	0	729
17871	693	2	3	29	0	727
17872	34	2	4	693	0	733
17873	9	6	5	692	0	712
17874	7	686	7	27	0	727
17875	684	30	1	8	0	723
17876	25	715	4	7	0	751
17877	13	28	2	635	0	678
17878	7	664	0	32	0	703
17879	665	28	4	7	0	704
17880	661	6	1	7	0	675
17881	669	4	2	8	0	683
17882	32	642	3	6	0	683
17883	1	461	2	4	0	468
17884	454	14	0	3	0	471
17885	11	464	1	7	0	483
17886	4	17	0	439	0	460
17887	8	1	436	8	0	453
17888	400	2	6	4	0	412
17889	414	3	0	0	0	417
17890	410	0	0	0	0	410
17891	6	415	0	1	0	422
17892	422	5	0	1	0	428
17893	5	0	436	0	0	441
17894	1	429	3	0	0	433
17895	3	11	0	370	0	384
17896	0	376	0	1	0	377
17897	359	1	0	1	0	361
17898	1	363	1	0	0	365
17899	1	2	0	356	0	359
17900	2	347	0	1	0	350
17901	1	2	0	368	0	371
17902	1	1	0	358	0	360
17903	1	0	364	1	0	366
17904	0	0	2	336	0	338
17905	337	0	1	1	0	339
17906	336	1	0	0	0	337
17907	1	0	0	341	0	342
17908	0	1	341	1	0	343
17909	1	0	1	336	0	338
17910	344	0	0	1	0	345
17911	371	0	0	1	0	372
17912	374	0	0	1	0	375
17913	1	385	1	2	0	389
17914	383	1	0	0	0	384
17915	1	0	370	4	0	375
17916	391	0	2	0	0	393
17917	2	0	0	410	0	412
17918	0	1	0	410	0	411
17919	1	0	0	414	0	415
17920	407	0	0	4	0	411
17921	397	0	0	2	0	399
17922	4	0	0	398	0	402
17923	1	0	416	5	0	422
17924	0	1	4	414	0	419
17925	0	0	0	392	0	392
17926	0	0	392	5	0	397
17927	1	405	4	0	0	410
17928	0	4	0	422	0	426
17929	423	0	0	6	0	429
17930	4	1	0	432	0	437
17931	1	0	0	440	0	441
17932	456	1	0	5	0	462
17933	4	436	1	1	0	442
17934	1	456	0	0	0	457
17935	452	4	0	0	0	456
17936	4	0	441	1	0	446
17937	440	0	5	1	0	446
17938	4	1	505	1	0	511
17939	0	525	4	1	0	530
17940	532	4	1	1	0	538
17941	540	1	0	0	0	541
17942	544	0	0	2	0	546
17943	554	0	0	1	0	555
17944	4	0	564	1	0	569
17945	0	0	4	554	0	558
17946	557	0	0	4	0	561
17947	5	1	592	0	0	598
17948	0	1	581	0	0	582
17949	1	578	4	1	0	584
17950	566	3	5	0	0	574
17951	4	0	0	564	0	568
17952	567	0	1	3	0	571
17953	3	590	0	0	0	593
17954	1	8	0	626	0	635
17955	1	0	0	634	0	635
17956	1	0	0	647	0	648
17957	1	0	656	7	0	664
17958	0	654	5	3	0	662
17959	718	4	1	2	0	725
17960	9	2	1	721	0	733
17961	721	1	1	9	0	732
17962	717	0	1	4	0	722
17963	12	1	0	716	0	729
17964	5	4	729	10	0	748
17965	0	0	9	736	0	745
17966	1	750	3	5	0	759
17967	0	9	1	754	0	764
17968	0	3	751	11	0	765
17969	729	1	9	4	0	743
17970	9	0	2	762	0	773
17971	761	0	2	10	0	773
17972	10	1	754	4	0	769
17973	708	0	10	5	0	723
17974	10	0	757	1	0	768
17975	726	0	10	1	0	737
17976	11	739	3	1	0	754
17977	2	764	2	1	0	769
17978	1	10	1	766	0	778
17979	0	5	1	708	0	714
17980	0	2	0	776	0	778
17981	769	0	0	12	0	781
17982	9	0	1	777	0	787
17983	5	0	771	10	0	786
17984	753	0	9	5	0	767
17985	10	788	3	2	0	803
17986	800	9	2	3	0	814
17987	776	4	1	1	0	782
17988	13	3	776	0	0	792
17989	7	0	11	761	0	779
17990	1	1	5	804	0	811
17991	1	1	803	14	0	819
17992	1	795	11	7	0	814
17993	774	10	4	3	0	791
17994	787	4	2	1	0	794
17995	14	1	0	801	0	816
17996	4	1	0	797	0	802
17997	2	0	1	820	0	823
17998	802	0	3	17	0	822
17999	11	810	1	6	0	828
18000	820	11	0	3	0	834
18001	806	6	0	1	0	813
18002	18	1	864	1	0	884
18003	8	1	11	840	0	860
18004	2	882	7	11	0	902
18005	2	11	2	897	0	912
18006	2	9	0	930	0	941
18007	2	4	965	16	0	987
18008	1019	1	14	11	0	1045
18009	1126	2	7	4	0	1139
18010	1183	0	3	9	0	1195
18011	35	1	0	1141	0	1177
18012	21	3	2	1124	0	1150
18013	8	1123	1	37	0	1169
18014	7	1169	5	21	0	1202
18015	1164	31	2	8	0	1205
18016	28	1153	1	5	0	1187
18017	17	22	1145	7	0	1191
18018	10	12	20	1192	0	1234
18019	1205	7	12	29	0	1253
18020	26	4	1210	18	0	1258
18021	18	6	1201	9	0	1234
18022	1210	6	36	6	0	1258
18023	1223	4	17	8	0	1252
18024	37	2	12	1197	0	1248
18025	22	3	1213	27	0	1265
18026	10	9	25	1222	0	1266
18027	9	7	1179	27	0	1222
18028	9	4	1196	17	0	1226
18029	9	1222	37	10	0	1278
18030	1209	22	20	8	0	1259
18031	1223	13	10	7	0	1253
18032	36	1206	12	9	0	1263
18033	23	26	8	1205	0	1262
18034	17	16	5	1211	0	1249
18035	7	18	5	1233	0	1263
18036	1202	6	6	43	0	1257
18037	31	1190	4	26	0	1251
18038	1162	25	4	15	0	1206
18039	1144	15	9	15	0	1183
18040	39	11	1113	13	0	1176
18041	25	1119	29	11	0	1184
18042	16	27	19	1136	0	1198
18043	16	16	1147	27	0	1206
18044	1130	12	28	15	0	1185
18045	1158	6	15	19	0	1198
18046	1171	4	11	12	0	1198
18047	1146	4	12	14	0	1176
18048	45	8	7	1120	0	1180
18049	30	7	1115	30	0	1182
18050	18	5	28	1136	0	1187
18051	1134	5	19	30	0	1188
18052	1138	5	10	19	0	1172
18053	45	1103	3	18	0	1169
18054	1091	23	8	7	0	1129
18055	31	13	1074	12	0	1130
18056	23	9	1080	11	0	1123
18057	1067	4	38	7	0	1116
18058	39	1080	18	5	0	1142
18059	28	21	7	995	0	1051
18060	17	1025	5	20	0	1067
18061	8	24	6	1042	0	1080
18062	12	13	8	1044	0	1077
18063	10	11	5	1080	0	1106
18064	1038	8	6	34	0	1086
18065	1064	7	5	18	0	1094
18066	1048	10	1	12	0	1071
18067	38	6	1019	8	0	1071
18068	1002	7	26	10	0	1045
18069	31	3	14	1041	0	1089
18070	22	3	12	1060	0	1097
18071	18	4	1046	31	0	1099
18072	17	3	22	1162	0	1204
18073	1199	2	13	34	0	1248
18074	30	5	1183	23	0	1241
18075	18	3	33	1188	0	1242
18076	1210	0	18	36	0	1264
18077	1203	6	11	21	0	1241
18078	46	3	1198	14	0	1261
18079	28	6	1215	10	0	1259
18080	20	6	36	1223	0	1285
18081	1265	3	22	30	0	1320
18082	1274	4	15	24	0	1317
18083	44	4	5	1225	0	1278
18084	29	1234	5	33	0	1301
18085	1235	27	6	20	0	1288
18086	36	1233	11	13	0	1293
18087	22	32	3	1231	0	1288
18088	20	10	1212	35	0	1277
18089	15	10	1182	16	0	1223
18090	12	5	1227	14	0	1258
18091	12	7	38	1182	0	1239
18092	16	5	23	1200	0	1244
18093	1192	2	18	37	0	1249
18094	34	1190	10	25	0	1259
18095	1195	26	7	17	0	1245
18096	38	13	6	1143	0	1200
18097	23	1177	8	31	0	1239
18098	17	1218	6	19	0	1260
18099	11	40	6	1237	0	1294
18100	1230	15	7	30	0	1282
18101	33	1230	7	18	0	1288
18102	1142	24	4	16	0	1186
18103	36	1177	12	8	0	1233
18104	1149	33	8	10	0	1200
18105	37	14	1139	6	0	1196
18106	19	10	1116	10	0	1155
18107	15	1083	29	9	0	1136
18108	957	28	42	8	0	1035
18109	20	914	6	5	0	945
18110	5	865	6	4	0	880
18111	10	24	4	870	0	908
18112	877	5	3	18	0	903
18113	17	886	2	4	0	909
18114	859	16	0	5	0	880
18115	17	872	1	1	0	891
18116	851	21	3	0	0	875
18117	16	839	6	1	0	862
18118	3	817	0	3	0	823
18119	6	13	0	788	0	807
18120	3	804	2	8	0	817
18121	790	12	2	2	0	806
18122	11	5	785	2	0	803
18123	5	2	10	794	0	811
18124	2	5	805	11	0	823
18125	2	2	12	783	0	799
18126	0	1	4	794	0	799
18127	3	1	764	13	0	781
18128	669	2	13	7	0	691
18129	12	746	1	5	0	764
18130	763	13	2	3	0	781
18131	16	770	2	3	0	791
18132	6	14	2	763	0	785
18133	760	5	4	12	0	781
18134	763	3	1	6	0	773
18135	773	4	0	4	0	781
18136	19	3	1	755	0	778
18137	6	1	7	776	0	790
18138	7	778	3	16	0	804
18139	791	13	3	9	0	816
18140	791	5	1	4	0	801
18141	795	6	5	3	0	809
18142	784	4	4	4	0	796
18143	22	742	4	5	0	773
18144	15	13	4	749	0	781
18145	8	9	746	13	0	776
18146	714	4	14	8	0	740
18147	757	7	5	4	0	773
18148	22	3	755	3	0	783
18149	9	6	748	3	0	766
18150	8	4	16	735	0	763
18151	3	7	10	765	0	785
18152	5	4	9	765	0	783
18153	754	5	4	20	0	783
18154	16	1	5	757	0	779
18155	9	3	740	18	0	770
18156	5	6	14	743	0	768
18157	8	4	745	17	0	774
18158	6	4	11	715	0	736
18159	4	4	7	763	0	778
18160	7	9	763	15	0	794
18161	707	8	12	12	0	739
18162	17	767	6	6	0	796
18163	789	20	4	5	0	818
18164	20	9	4	823	0	856
18165	818	7	3	18	0	846
18166	23	857	0	8	0	888
18167	12	908	4	3	0	927
18168	7	33	5	1021	0	1066
18169	6	18	1077	26	0	1127
18170	2	13	1059	12	0	1086
18171	8	1064	40	7	0	1119
18172	931	32	13	5	0	981
18173	27	12	6	915	0	960
18174	917	7	1	28	0	953
18175	29	887	3	12	0	931
18176	11	923	3	8	0	945
18177	8	36	2	896	0	942
18178	882	13	0	29	0	924
18179	895	5	2	12	0	914
18180	37	2	871	8	0	918
18181	13	3	835	3	0	854
18182	811	3	34	3	0	851
18183	27	834	14	6	0	881
18184	841	24	7	5	0	877
18185	34	9	1	820	0	864
18186	9	10	812	25	0	856
18187	781	2	25	10	0	818
18188	22	801	12	10	0	845
18189	12	814	6	2	0	834
18190	9	34	2	794	0	839
18191	802	17	2	24	0	845
18192	24	7	5	811	0	847
18193	820	1	4	32	0	857
18194	32	6	776	10	0	824
18195	785	6	21	9	0	821
18196	817	5	8	4	0	834
18197	35	1	769	5	0	810
18198	746	3	23	8	0	780
18199	29	763	13	2	0	807
18200	11	25	11	745	0	792
18201	11	771	3	21	0	806
18202	779	29	3	12	0	823
18203	30	9	4	752	0	795
18204	15	751	3	25	0	794
18205	9	28	4	730	0	771
18206	5	747	2	31	0	785
18207	6	31	2	756	0	795
18208	752	10	3	30	0	795
18209	29	7	3	755	0	794
18210	12	3	744	30	0	789
18211	727	4	25	12	0	768
18212	26	7	10	729	0	772
18213	16	5	712	26	0	759
18214	11	5	706	13	0	735
18215	7	3	714	12	0	736
18216	5	2	37	706	0	750
18217	10	3	17	729	0	759
18218	8	4	8	748	0	768
18219	3	6	6	754	0	769
18220	718	4	6	38	0	766
18221	748	5	5	15	0	773
18222	759	4	3	13	0	779
18223	768	4	1	9	0	782
18224	44	3	5	733	0	785
18225	18	1	759	34	0	812
18226	773	6	27	13	0	819
18227	802	5	10	10	0	827
18228	36	5	7	774	0	822
18229	21	4	5	808	0	838
18230	798	4	4	41	0	847
18231	28	7	5	768	0	808
18232	17	763	5	33	0	818
18233	785	26	5	14	0	830
18234	792	8	5	14	0	819
18235	38	13	823	8	0	882
18236	22	5	31	809	0	867
18237	13	5	10	862	0	890
18238	837	5	11	45	0	898
18239	875	5	8	18	0	906
18240	47	6	10	851	0	914
18241	18	6	836	39	0	899
18242	20	2	848	20	0	890
18243	12	5	39	848	0	904
18244	12	6	15	870	0	903
18245	847	7	11	45	0	910
18246	43	844	7	21	0	915
18247	19	841	4	18	0	882
18248	17	873	7	9	0	906
18249	15	38	5	841	0	899
18250	851	10	7	39	0	907
18251	870	10	6	11	0	897
18252	45	847	3	11	0	906
18253	871	36	2	8	0	917
18254	43	11	6	863	0	923
18255	16	7	872	43	0	938
18256	17	4	34	865	0	920
18257	15	4	10	902	0	931
18258	12	6	9	900	0	927
18259	854	7	2	47	0	910
18260	35	1	4	840	0	880
18261	20	832	4	37	0	893
18262	806	29	9	23	0	867
18263	34	793	2	13	0	842
18264	11	766	8	7	0	792
18265	17	774	3	8	0	802
18266	15	27	702	4	0	748
18267	6	667	19	7	0	699
18268	9	15	533	3	0	560
18269	465	8	10	3	0	486
18270	491	0	1	0	0	492
18271	10	1	518	1	0	530
18272	509	0	11	4	0	524
18273	564	0	1	0	0	565
18274	10	0	555	2	0	567
18275	0	581	12	0	0	593
18276	2	11	1	581	0	595
18277	589	1	0	12	0	602
18278	12	0	0	576	0	588
18279	606	1	0	13	0	620
18280	606	1	1	2	0	610
18281	13	0	607	1	0	621
18282	585	2	10	4	0	601
18283	12	625	1	2	0	640
18284	637	11	0	1	0	649
18285	11	2	2	644	0	659
18286	1	1	651	12	0	665
18287	1	2	11	639	0	653
18288	634	0	1	13	0	648
18289	10	625	1	3	0	639
18290	6	9	626	2	0	643
18291	0	2	10	624	0	636
18292	2	0	645	12	0	659
18293	1	666	11	2	0	680
18294	668	10	3	4	0	685
18295	12	2	0	676	0	690
18296	3	1	672	12	0	688
18297	1	4	636	3	0	644
18298	679	1	13	0	0	693
18299	11	1	1	663	0	676
18300	2	1	1	667	0	671
18301	3	0	672	10	0	685
18302	2	2	666	1	0	671
18303	2	697	11	2	0	712
18304	1	12	2	693	0	708
18305	2	1	4	694	0	701
18306	0	694	0	9	0	703
18307	1	12	689	2	0	704
18308	650	1	11	2	0	664
18309	12	0	1	703	0	716
18310	1	2	739	12	0	754
18311	2	2	13	707	0	724
18312	4	738	1	13	0	756
18313	2	13	739	1	0	755
18314	705	3	13	2	0	723
18315	12	2	758	2	0	774
18316	4	3	746	1	0	754
18317	1	2	729	3	0	735
18318	3	0	778	2	0	783
18319	5	1	15	764	0	785
18320	1	1	836	14	0	852
18321	0	0	13	805	0	818
18322	3	829	2	11	0	845
18323	906	14	0	3	0	923
18324	15	2	2	900	0	919
18325	4	0	875	16	0	895
18326	1	863	17	20	0	901
18327	2	17	2	890	0	911
18328	889	3	0	17	0	909
18329	15	891	3	4	0	913
18330	4	17	4	897	0	922
18331	918	4	2	21	0	945
18332	19	2	898	4	0	923
18333	882	3	16	3	0	904
18334	18	2	919	4	0	943
18335	845	0	17	3	0	865
18336	853	0	7	1	0	861
18337	16	0	847	0	0	863
18338	6	830	10	0	0	846
18339	1	9	5	805	0	820
18340	3	3	851	10	0	867
18341	2	1	15	816	0	834
18342	1	1	5	847	0	854
18343	1	3	851	15	0	870
18344	0	0	848	6	0	854
18345	0	0	16	837	0	853
18346	860	1	5	15	0	881
18347	13	858	2	5	0	878
18348	3	870	2	6	0	881
18349	876	14	3	2	0	895
18350	881	6	1	2	0	890
18351	16	3	0	869	0	888
18352	8	3	1	876	0	888
18353	2	4	1	887	0	894
18354	863	1	0	18	0	882
18355	17	823	1	6	0	847
18356	2	840	3	6	0	851
18357	4	14	2	838	0	858
18358	1	5	3	841	0	850
18359	3	3	0	847	0	853
18360	837	2	1	20	0	860
18361	12	858	2	8	0	880
18362	876	17	1	5	0	899
18363	18	5	882	5	0	910
18364	6	895	14	5	0	920
18365	7	21	5	891	0	924
18366	895	12	3	21	0	931
18367	20	2	901	6	0	929
18368	9	1	919	2	0	931
18369	2	3	24	897	0	926
18370	4	1	7	911	0	923
18371	3	1	3	896	0	903
18372	2	2	5	857	0	866
18373	3	0	2	859	0	864
18374	2	816	2	28	0	848
18375	0	15	1	833	0	849
18376	810	4	2	21	0	837
18377	13	825	2	16	0	856
18378	822	15	1	7	0	845
18379	18	9	801	3	0	831
18380	5	6	816	2	0	829
18381	5	1	20	812	0	838
18382	3	2	998	21	0	1024
18383	3	1	27	967	0	998
18384	3	1	11	956	0	971
18385	989	4	8	34	0	1035
18386	1016	1	3	15	0	1035
18387	34	1033	5	8	0	1080
18388	15	1096	1	6	0	1118
18389	5	37	2	1077	0	1121
18390	1091	15	2	30	0	1138
18391	30	8	1088	12	0	1138
18392	14	5	30	1085	0	1134
18393	7	4	10	1091	0	1112
18394	4	0	1066	45	0	1115
18395	2	1058	32	20	0	1112
18396	1	27	11	1068	0	1107
18397	3	10	1080	37	0	1130
18398	3	9	31	1067	0	1110
18399	1021	3	13	41	0	1078
18400	31	1053	8	15	0	1107
18401	9	1064	5	10	0	1088
18402	7	38	2	1044	0	1091
18403	1015	15	4	32	0	1066
18404	30	1036	4	13	0	1083
18405	1041	33	5	10	0	1089
18406	33	13	1044	6	0	1096
18407	14	7	1075	9	0	1105
18408	10	3	45	1016	0	1074
18409	9	2	17	1090	0	1118
18410	1028	3	6	47	0	1084
18411	40	7	4	1025	0	1076
18412	14	9	1019	42	0	1084
18413	11	6	31	1009	0	1057
18414	7	6	15	1050	0	1078
18415	6	3	988	50	0	1047
18416	950	1	35	29	0	1015
18417	40	5	17	992	0	1054
18418	956	5	10	38	0	1009
18419	35	918	8	18	0	979
18420	910	30	8	13	0	961
18421	36	894	5	11	0	946
18422	19	910	3	12	0	944
18423	10	38	5	820	0	873
18424	803	19	14	32	0	868
18425	832	8	2	18	0	860
18426	40	6	3	800	0	849
18427	806	7	2	32	0	847
18428	820	3	4	15	0	842
18429	42	4	5	803	0	854
18430	776	2	4	34	0	816
18431	37	792	4	15	0	848
18432	807	28	5	11	0	851
18433	33	14	775	10	0	832
18434	830	10	26	9	0	875
18435	34	5	13	829	0	881
18436	16	1	4	858	0	879
18437	10	1	6	866	0	883
18438	6	0	7	869	0	882
18439	4	1	5	845	0	855
18440	7	772	7	47	0	833
18441	7	831	4	21	0	863
18442	822	34	2	11	0	869
18443	33	17	808	9	0	867
18444	809	12	25	4	0	850
18445	33	10	802	3	0	848
18446	19	7	26	785	0	837
18447	9	6	17	836	0	868
18448	813	3	6	44	0	866
18449	31	1	807	27	0	866
18450	21	3	26	826	0	876
18451	13	4	833	33	0	883
18452	11	839	29	19	0	898
18453	5	31	17	855	0	908
18454	856	15	6	38	0	915
18455	855	8	5	19	0	887
18456	905	6	4	7	0	922
18457	47	879	4	9	0	939
18458	23	935	3	10	0	971
18459	826	43	5	13	0	887
18460	35	896	3	18	0	952
18461	10	901	9	13	0	933
18462	9	40	862	11	0	922
18463	5	844	32	12	0	893
18464	5	845	12	9	0	871
18465	8	40	6	821	0	875
18466	7	20	838	30	0	895
18467	10	6	821	13	0	850
18468	813	6	38	7	0	864
18469	34	3	841	10	0	888
18470	852	4	34	9	0	899
18471	39	4	16	846	0	905
18472	20	854	7	30	0	911
18473	888	28	5	20	0	941
18474	933	14	6	8	0	961
18475	42	13	4	907	0	966
18476	21	8	4	932	0	965
18477	7	7	2	946	0	962
18478	910	4	2	47	0	963
18479	827	7	5	27	0	866
18480	915	4	3	9	0	931
18481	40	883	4	11	0	938
18482	707	15	3	4	0	729
18483	18	708	5	1	0	732
18484	13	701	0	3	0	717
18485	12	39	8	634	0	693
18486	6	651	0	14	0	671
18487	610	14	2	8	0	634
18488	17	6	1	615	0	639
18489	594	0	2	16	0	612
18490	15	580	0	12	0	607
18491	6	638	1	3	0	648
18492	622	19	0	1	0	642
18493	17	631	0	4	0	652
18494	8	15	0	639	0	662
18495	5	7	9	649	0	670
18496	641	2	2	18	0	663
18497	15	4	0	644	0	663
18498	6	2	658	16	0	682
18499	1	4	17	660	0	682
18500	689	2	6	17	0	714
18501	19	712	2	6	0	739
18502	765	20	0	1	0	786
18503	749	8	1	3	0	761
18504	776	0	1	2	0	779
18505	24	1	762	2	0	789
18506	7	3	736	4	0	750
18507	712	1	22	1	0	736
18508	14	732	6	0	0	752
18509	6	19	0	733	0	758
18510	2	7	0	744	0	753
18511	1	711	2	21	0	735
18512	5	747	0	7	0	759
18513	3	21	3	757	0	784
18514	2	6	2	769	0	779
18515	4	2	745	22	0	773
18516	4	2	719	7	0	732
18517	733	3	23	2	0	761
18518	770	0	7	3	0	780
18519	25	1	0	756	0	782
18520	11	3	754	16	0	784
18521	3	2	18	752	0	775
18522	745	2	8	18	0	773
18523	20	3	775	9	0	807
18524	10	3	17	784	0	814
18525	3	6	785	18	0	812
18526	3	781	17	9	0	810
18527	4	16	777	3	0	800
18528	3	14	17	766	0	800
18529	779	2	9	24	0	814
18530	18	1	2	803	0	824
18531	784	2	3	17	0	806
18532	806	3	3	9	0	821
18533	802	1	4	6	0	813
18534	30	1	766	4	0	801
18535	773	4	14	6	0	797
18536	16	5	10	782	0	813
18537	16	2	1	794	0	813
18538	8	1	778	24	0	811
18539	5	4	17	778	0	804
18540	784	2	14	20	0	820
18541	20	784	3	12	0	819
18542	801	18	1	5	0	825
18543	799	9	4	7	0	819
18544	816	0	3	9	0	828
18545	29	3	2	792	0	826
18546	14	6	804	17	0	841
18547	5	3	16	812	0	836
18548	3	4	8	832	0	847
18549	810	2	6	26	0	844
18550	806	6	6	8	0	826
18551	27	3	810	4	0	844
18552	12	4	13	812	0	841
18553	6	4	838	13	0	861
18554	827	2	15	10	0	854
18555	18	925	9	5	0	957
18556	904	13	0	7	0	924
18557	20	931	3	3	0	957
18558	922	15	6	5	0	948
18559	20	933	1	4	0	958
18560	9	17	3	930	0	959
18561	5	8	2	952	0	967
18562	935	2	7	21	0	965
18563	943	1	3	14	0	961
18564	952	1	1	7	0	961
18565	928	3	4	3	0	938
18566	929	2	2	5	0	938
18567	30	2	3	905	0	940
18568	15	909	4	17	0	945
18569	11	13	3	883	0	910
18570	8	881	5	15	0	909
18571	6	16	0	864	0	886
18572	2	877	3	21	0	903
18573	9	15	3	852	0	879
18574	8	6	821	17	0	852
18575	792	4	16	9	0	821
18576	17	836	6	7	0	866
18577	845	12	5	5	0	867
18578	26	7	837	3	0	873
18579	805	8	13	4	0	830
18580	21	2	863	7	0	893
18581	8	4	18	864	0	894
18582	8	917	6	18	0	949
18583	2	18	924	10	0	954
18584	7	9	17	934	0	967
18585	895	6	14	23	0	938
18586	20	0	7	947	0	974
18587	12	5	3	964	0	984
18588	9	4	2	983	0	998
18589	9	2	946	31	0	988
18590	8	2	21	917	0	948
18591	7	884	11	22	0	924
18592	3	20	7	899	0	929
18593	5	12	4	904	0	925
18594	882	7	3	25	0	917
18595	17	3	3	903	0	926
18596	12	2	887	24	0	925
18597	9	3	889	10	0	911
18598	5	0	883	10	0	898
18599	4	872	25	5	0	906
18600	840	15	19	9	0	883
18601	18	835	7	2	0	862
18602	798	21	2	3	0	824
18603	22	7	0	810	0	839
18604	9	6	827	18	0	860
18605	9	2	805	9	0	825
18606	4	832	20	8	0	864
18607	5	18	14	842	0	879
18608	3	7	9	862	0	881
18609	2	5	3	879	0	889
18610	0	4	848	35	0	887
18611	788	0	21	18	0	827
18612	21	3	842	9	0	875
18613	9	2	26	819	0	856
18614	11	1	7	863	0	882
18615	2	0	841	28	0	871
18616	802	1	25	17	0	845
18617	21	833	8	11	0	873
18618	843	24	9	3	0	879
18619	32	3	3	823	0	861
18620	8	846	2	21	0	877
18621	9	19	2	858	0	888
18622	846	9	4	32	0	891
18623	25	5	6	826	0	862
18624	7	4	819	27	0	857
18625	806	3	21	11	0	841
18626	831	3	6	12	0	852
18627	29	4	819	6	0	858
18628	15	2	22	804	0	843
18629	837	3	7	24	0	871
18630	29	0	7	800	0	836
18631	8	4	7	811	0	830
18632	10	2	3	816	0	831
18633	7	3	3	807	0	820
18634	4	3	774	37	0	818
18635	5	1	22	781	0	809
18636	7	3	775	31	0	816
18637	762	3	25	13	0	803
18638	785	1	12	14	0	812
18639	787	1	12	7	0	807
18640	792	2	4	6	0	804
18641	32	8	4	754	0	798
18642	758	2	2	29	0	791
18643	30	2	747	13	0	792
18644	12	2	758	11	0	783
18645	725	0	30	6	0	761
18646	25	709	16	4	0	754
18647	6	719	9	5	0	739
18648	13	23	6	694	0	736
18649	3	13	694	25	0	735
18650	652	6	30	8	0	696
18651	25	2	675	13	0	715
18652	10	643	25	8	0	686
18653	13	17	610	8	0	648
18654	6	594	24	7	0	631
18655	512	24	8	5	0	549
18656	14	505	7	9	0	535
18657	6	493	4	4	0	507
18658	9	18	5	481	0	513
18659	5	13	475	16	0	509
18660	3	10	16	457	0	486
18661	5	3	6	484	0	498
18662	3	2	467	23	0	495
18663	2	3	17	457	0	479
18664	5	451	6	23	0	485
18665	4	16	7	467	0	494
18666	462	4	5	23	0	494
18667	17	4	3	468	0	492
18668	7	4	463	24	0	498
18669	12	1	17	461	0	491
18670	3	2	466	24	0	495
18671	452	3	17	11	0	483
18672	19	0	6	476	0	501
18673	475	3	8	18	0	504
18674	24	1	463	12	0	500
18675	455	1	16	12	0	484
18676	18	460	6	13	0	497
18677	10	13	466	3	0	492
18678	9	10	19	446	0	484
18679	7	5	465	18	0	495
18680	8	419	24	6	0	457
18681	4	432	6	12	0	454
18682	365	15	7	4	0	391
18683	16	398	5	5	0	424
18684	398	16	5	4	0	423
18685	20	2	5	410	0	437
18686	4	4	411	18	0	437
18687	6	411	20	2	0	439
18688	6	16	3	399	0	424
18689	4	3	6	417	0	430
18690	6	8	3	423	0	440
18691	4	6	3	424	0	437
18692	4	405	5	23	0	437
18693	5	431	3	10	0	449
18694	402	19	7	7	0	435
18695	15	409	1	5	0	430
18696	5	15	2	417	0	439
18697	4	6	418	20	0	448
18698	7	415	15	4	0	441
18699	4	20	3	398	0	425
18700	2	9	4	395	0	410
18701	3	395	2	16	0	416
18702	372	14	3	6	0	395
18703	12	4	361	9	0	386
18704	329	4	13	8	0	354
18705	12	337	5	1	0	355
18706	306	9	2	2	0	319
18707	10	314	2	2	0	328
18708	4	8	1	331	0	344
18709	3	3	4	336	0	346
18710	328	5	2	8	0	343
18711	9	3	2	329	0	343
18712	1	1	332	14	0	348
18713	1	317	10	3	0	331
18714	6	327	1	2	0	336
18715	0	11	4	323	0	338
18716	3	3	329	9	0	344
18717	1	6	8	317	0	332
18718	6	3	0	328	0	337
18719	1	4	315	11	0	331
18720	1	1	314	5	0	321
18721	0	315	8	6	0	329
18722	326	9	2	2	0	339
18723	8	1	2	320	0	331
18724	0	310	5	11	0	326
18725	324	10	0	4	0	338
18726	10	3	0	317	0	330
18727	0	3	1	323	0	327
18728	2	314	3	5	0	324
18729	1	10	1	304	0	316
18730	302	2	0	14	0	318
18731	9	2	4	304	0	319
18732	0	4	4	312	0	320
18733	2	4	298	11	0	315
18734	4	1	281	5	0	291
18735	304	2	8	7	0	321
18736	9	6	1	308	0	324
18737	5	1	3	312	0	321
18738	4	3	2	314	0	323
18739	3	3	304	13	0	323
18740	300	4	8	5	0	317
18741	9	2	3	303	0	317
18742	3	1	2	305	0	311
18743	294	1	2	15	0	312
18744	9	293	1	8	0	311
18745	1	8	298	8	0	315
18746	2	2	11	289	0	304
18747	5	293	1	10	0	309
18748	2	10	0	302	0	314
18749	293	1	2	12	0	308
18750	9	2	0	300	0	311
18751	289	3	3	10	0	305
18752	298	0	1	3	0	302
18753	9	2	2	287	0	300
18754	0	279	1	16	0	296
18755	4	294	0	3	0	301
18756	2	11	283	3	0	299
18757	2	0	12	272	0	286
18758	0	2	2	290	0	294
18759	4	4	1	285	0	294
18760	279	1	2	9	0	291
18761	13	1	0	280	0	294
18762	1	1	292	13	0	307
18763	293	1	8	5	0	307
18764	12	1	2	291	0	306
18765	2	1	1	315	0	319
18766	0	2	302	12	0	316
18767	290	4	9	2	0	305
18768	11	1	3	303	0	318
18769	0	1	303	15	0	319
18770	0	2	11	300	0	313
18771	3	1	2	285	0	291
18772	3	300	0	8	0	311
18773	300	7	2	7	0	316
18774	300	1	5	3	0	309
18775	12	296	2	4	0	314
18776	287	10	2	5	0	304
18777	308	0	2	4	0	314
18778	9	1	3	297	0	310
18779	4	1	289	7	0	301
18780	2	0	285	3	0	290
18781	2	2	289	0	0	293
18782	1	0	306	4	0	311
18783	1	6	6	259	0	272
18784	0	1	0	271	0	272
18785	1	1	1	258	0	261
18786	2	0	0	259	0	261
18787	266	0	0	5	0	271
18788	6	271	0	2	0	279
18789	282	2	0	2	0	286
18790	2	0	280	2	0	284
18791	0	1	291	0	0	292
18792	2	1	2	281	0	286
18793	289	0	1	5	0	295
18794	273	1	1	3	0	278
18795	3	284	0	3	0	290
18796	0	278	2	1	0	281
18797	1	2	1	274	0	278
18798	270	0	0	3	0	273
18799	3	276	1	0	0	280
18800	282	2	0	0	0	284
18801	279	1	0	1	0	281
18802	281	1	0	1	0	283
18803	1	0	293	2	0	296
18804	2	300	2	0	0	304
18805	294	2	0	2	0	298
18806	295	0	1	0	0	296
18807	2	283	0	1	0	286
18808	1	266	0	0	0	267
18809	265	0	1	2	0	268
18810	0	1	0	268	0	269
18811	1	0	268	0	0	269
18812	255	0	0	1	0	256
18813	0	1	0	274	0	275
18814	0	292	0	0	0	292
18815	1	0	0	293	0	294
18816	0	0	294	1	0	295
18817	1	1	0	281	0	283
18818	315	0	0	1	0	316
18819	1	0	0	319	0	320
18820	0	1	0	312	0	313
18821	0	0	314	2	0	316
18822	0	0	1	294	0	295
18823	0	312	0	2	0	314
18824	308	1	0	0	0	309
18825	294	0	0	1	0	295
18826	1	0	304	3	0	308
18827	0	0	2	295	0	297
18828	0	302	0	2	0	304
18829	0	314	0	0	0	314
18830	318	1	0	2	0	321
18831	2	0	0	320	0	322
18832	0	0	323	1	0	324
18833	1	0	319	1	0	321
18834	0	1	1	317	0	319
18835	318	1	0	1	0	320
18836	319	0	0	0	0	319
18837	1	0	1	326	0	328
18838	0	0	336	1	0	337
18839	0	334	2	1	0	337
18840	329	1	0	1	0	331
18841	3	340	0	0	0	343
18842	341	2	0	1	0	344
18843	1	1	0	342	0	344
18844	0	0	343	2	0	345
18845	1	1	1	337	0	340
18846	340	0	0	3	0	343
18847	2	1	352	0	0	355
18848	2	350	1	0	0	353
18849	1	1	0	360	0	362
18850	361	0	2	1	0	364
18851	1	1	370	1	0	373
18852	2	0	1	368	0	371
18853	1	0	1	377	0	379
18854	0	1	378	2	0	381
18855	1	0	1	370	0	372
18856	2	0	379	2	0	383
18857	359	0	2	2	0	363
18858	1	0	2	386	0	389
18859	1	0	429	2	0	432
18860	0	436	2	1	0	439
18861	447	2	0	2	0	451
18862	485	0	1	1	0	487
18863	5	0	2	569	0	576
18864	1	592	1	11	0	605
18865	593	12	3	3	0	611
18866	11	6	0	610	0	627
18867	6	2	610	11	0	629
18868	592	0	12	3	0	607
18869	9	607	2	7	0	625
18870	5	14	3	607	0	629
18871	615	1	0	11	0	627
18872	12	2	602	5	0	621
18873	1	0	623	2	0	626
18874	6	0	12	592	0	610
18875	0	5	619	11	0	635
18876	1	3	13	597	0	614
18877	5	602	1	13	0	621
18878	0	13	6	626	0	645
18879	618	1	4	14	0	637
18880	11	2	615	7	0	635
18881	1	627	16	3	0	647
18882	3	12	1	630	0	646
18883	1	5	646	12	0	664
18884	0	2	12	620	0	634
18885	5	630	2	11	0	648
18886	0	673	7	4	0	684
18887	642	17	1	3	0	663
18888	12	670	1	3	0	686
18889	1	14	655	1	0	671
18890	606	2	12	6	0	626
18891	14	5	659	1	0	679
18892	1	3	17	619	0	640
18893	5	0	661	19	0	685
18894	1	671	16	2	0	690
18895	4	15	4	688	0	711
18896	4	1	4	690	0	699
18897	1	5	5	676	0	687
18898	3	1	687	19	0	710
18899	5	1	17	661	0	684
18900	1	2	2	695	0	700
18901	668	1	2	19	0	690
18902	668	2	1	10	0	681
18903	15	0	665	7	0	687
18904	4	654	17	3	0	678
18905	3	11	670	3	0	687
18906	3	2	15	664	0	684
18907	3	4	689	15	0	711
18908	4	0	16	685	0	705
18909	2	1	5	720	0	728
18910	1	4	701	14	0	720
18911	639	2	17	4	0	662
18912	13	704	2	7	0	726
18913	2	13	7	693	0	715
18914	3	3	708	18	0	732
18915	1	3	692	8	0	704
18916	641	2	18	6	0	667
18917	17	697	4	0	0	718
18918	2	17	3	693	0	715
18919	697	3	0	18	0	718
18920	16	3	4	704	0	727
18921	2	1	7	734	0	744
18922	5	0	737	17	0	759
18923	691	4	14	11	0	720
18924	747	2	4	7	0	760
18925	17	0	4	745	0	766
18926	736	1	2	19	0	758
18927	17	1	1	742	0	761
18928	4	712	6	18	0	740
18929	6	738	2	7	0	753
18930	7	15	0	729	0	751
18931	728	3	3	18	0	752
18932	16	4	1	734	0	755
18933	735	0	4	20	0	759
18934	737	4	0	4	0	745
18935	15	3	1	748	0	767
18936	7	0	4	755	0	766
18937	7	1	735	17	0	760
18938	0	2	735	10	0	747
18939	4	1	15	752	0	772
18940	5	0	795	13	0	813
18941	769	1	17	7	0	794
18942	14	2	2	860	0	878
18943	2	5	907	16	0	930
18944	891	0	21	8	0	920
18945	958	1	8	7	0	974
18946	22	1017	7	2	0	1048
18947	14	19	1	1020	0	1054
18948	4	7	1043	22	0	1076
18949	1020	4	20	8	0	1052
18950	1059	3	7	6	0	1075
18951	27	1	1066	3	0	1097
18952	1065	3	17	1	0	1086
18953	22	0	8	1067	0	1097
18954	9	1	5	1084	0	1099
18955	1084	1	2	25	0	1112
18956	1086	1	2	13	0	1102
18957	28	5	3	1073	0	1109
18958	15	0	1068	20	0	1103
18959	6	1024	15	9	0	1054
18960	2	16	1030	7	0	1055
18961	2	8	1018	4	0	1032
18962	5	972	20	6	0	1003
18963	7	12	13	847	0	879
18964	3	7	4	882	0	896
18965	1	2	873	16	0	892
18966	0	1	11	863	0	875
18967	870	0	8	11	0	889
18968	10	0	905	9	0	924
18969	913	0	10	3	0	926
18970	931	1	6	5	0	943
18971	938	0	6	3	0	947
18972	18	2	925	1	0	946
18973	13	0	921	3	0	937
18974	5	3	17	918	0	943
18975	4	1	9	896	0	910
18976	4	938	7	13	0	962
18977	936	9	3	12	0	960
18978	934	6	4	2	0	946
18979	14	944	2	3	0	963
18980	953	9	1	3	0	966
18981	12	942	3	5	0	962
18982	951	11	2	4	0	968
18983	14	7	1	918	0	940
18984	10	2	931	13	0	956
18985	5	2	908	6	0	921
18986	5	1	24	901	0	931
18987	4	2	9	897	0	912
18988	2	1	894	15	0	912
18989	4	2	9	863	0	878
18990	3	3	11	868	0	885
18991	886	1	5	18	0	910
18992	891	4	2	20	0	917
18993	875	1	4	7	0	887
18994	18	3	864	5	0	890
18995	15	845	11	3	0	874
18996	6	7	10	855	0	878
18997	7	8	876	7	0	898
18998	4	868	12	8	0	892
18999	894	9	7	5	0	915
19000	12	7	7	890	0	916
19001	9	5	4	899	0	917
19002	905	2	3	20	0	930
19003	9	1	7	910	0	927
19004	12	2	4	908	0	926
19005	915	2	2	19	0	938
19006	16	4	901	11	0	932
19007	10	900	14	6	0	930
19008	904	9	11	2	0	926
19009	14	12	933	5	0	964
19010	926	3	10	5	0	944
19011	13	949	12	7	0	981
19012	955	8	10	4	0	977
19013	956	7	1	9	0	973
19014	944	3	4	8	0	959
19015	20	4	4	933	0	961
19016	10	6	3	930	0	949
19017	9	926	2	20	0	957
19018	6	919	4	11	0	940
19019	10	966	4	4	0	984
19020	948	13	4	5	0	970
19021	16	9	932	5	0	962
19022	10	3	11	934	0	958
19023	7	3	11	917	0	938
19024	3	927	7	18	0	955
19025	5	8	2	942	0	957
19026	4	8	2	925	0	939
19027	7	946	8	16	0	977
19028	939	10	4	12	0	965
19029	12	974	3	8	0	997
19030	14	11	942	6	0	973
19031	939	13	10	8	0	970
19032	16	955	10	5	0	986
19033	957	11	4	7	0	979
19034	15	7	5	958	0	985
19035	10	6	2	952	0	970
19036	9	2	945	16	0	972
19037	2	10	937	7	0	956
19038	13	5	12	933	0	963
19039	917	6	9	16	0	948
19040	884	2	3	11	0	900
19041	15	875	5	4	0	899
19042	8	837	1	4	0	850
19043	5	807	2	4	0	818
19044	5	19	5	781	0	810
19045	766	1	9	19	0	795
19046	734	2	1	3	0	740
19047	724	2	0	3	0	729
19048	12	2	702	2	0	718
19049	5	840	8	0	0	853
19050	5	7	3	980	0	995
19051	1026	4	2	16	0	1048
19052	18	2	2	1040	0	1062
19053	8	1	1	1088	0	1098
19054	1083	4	0	19	0	1106
19055	1199	2	0	5	0	1206
19056	27	3	1197	5	0	1232
19057	13	3	24	1208	0	1248
19058	5	2	1214	25	0	1246
19059	1	1	28	1204	0	1234
19060	4	0	1201	30	0	1235
19061	2	8	27	1201	0	1238
19062	1164	3	10	32	0	1209
19063	24	1167	5	13	0	1209
19064	10	1222	0	5	0	1237
19065	7	31	4	1097	0	1139
19066	1	1233	0	22	0	1256
19067	1222	28	2	9	0	1261
19068	1186	9	0	4	0	1199
19069	36	4	1174	0	0	1214
19070	14	1179	22	2	0	1217
19071	5	27	10	1190	0	1232
19072	4	7	1185	23	0	1219
19073	1166	3	25	8	0	1202
19074	25	1	9	1174	0	1209
19075	11	2	1181	27	0	1221
19076	6	2	24	1180	0	1212
19077	1187	2	10	29	0	1228
19078	25	2	1174	12	0	1213
19079	1160	2	26	7	0	1195
19080	1200	1	13	3	0	1217
19081	36	0	1	1169	0	1206
19082	15	2	1185	24	0	1226
19083	6	4	1184	11	0	1205
19084	1164	1	30	7	0	1202
19085	1199	2	15	6	0	1222
19086	36	2	1177	4	0	1219
19087	18	3	25	1166	0	1212
19088	7	2	12	1154	0	1175
19089	6	1176	8	35	0	1225
19090	9	24	3	1194	0	1230
19091	1178	11	4	33	0	1226
19092	32	3	5	1180	0	1220
19093	17	2	1163	35	0	1217
19094	1138	2	32	16	0	1188
19095	32	0	16	1155	0	1203
19096	18	3	1160	29	0	1210
19097	7	1126	32	17	0	1182
19098	1114	25	12	11	0	1162
19099	30	1138	7	11	0	1186
19100	1141	32	7	8	0	1188
19101	35	12	1147	5	0	1199
19102	18	1108	24	4	0	1154
19103	10	1152	14	3	0	1179
19104	11	36	3	1114	0	1164
19105	9	11	7	1134	0	1161
19106	4	8	1115	40	0	1167
19107	8	4	30	1117	0	1159
19108	1096	5	16	36	0	1153
19109	32	5	1057	17	0	1111
19110	11	7	28	1061	0	1107
19111	10	5	1049	32	0	1096
19112	1013	4	33	19	0	1069
19113	33	1043	13	9	0	1098
19114	1043	27	19	9	0	1098
19115	1074	12	6	11	0	1103
19116	1084	6	9	5	0	1104
19117	45	6	1012	6	0	1069
19118	21	1011	27	9	0	1068
19119	14	24	17	1010	0	1065
19120	13	12	10	1052	0	1087
19121	1082	4	9	42	0	1137
19122	38	5	13	1101	0	1157
19123	1109	2	6	46	0	1163
19124	1110	5	15	21	0	1151
19125	1128	5	8	8	0	1149
19126	1132	4	8	13	0	1157
19127	55	4	4	1075	0	1138
19128	1093	5	7	41	0	1146
19129	46	4	1046	19	0	1115
19130	1064	2	42	11	0	1119
19131	1091	6	15	6	0	1118
19132	53	7	1009	32	0	1101
19133	1054	5	38	9	0	1106
19134	1091	3	14	10	0	1118
19135	53	4	10	1044	0	1111
19136	24	6	8	1066	0	1104
19137	1027	27	7	46	0	1107
19138	49	8	5	1047	0	1109
19139	17	3	5	1050	0	1075
19140	12	1002	13	49	0	1076
19141	17	35	5	1020	0	1077
19142	998	12	4	47	0	1061
19143	45	5	9	1013	0	1072
19144	20	4	6	1015	0	1045
19145	15	915	11	42	0	983
19146	12	31	7	913	0	963
19147	18	11	5	913	0	947
19148	880	3	8	44	0	935
19149	44	5	2	734	0	785
19150	15	2	582	30	0	629
19151	10	503	23	12	0	548
19152	10	517	7	7	0	541
19153	473	22	4	7	0	506
19154	22	472	4	6	0	504
19155	359	12	2	4	0	377
19156	12	332	1	8	0	353
19157	347	12	2	3	0	364
19158	14	4	1	354	0	373
19159	6	3	0	359	0	368
19160	3	347	1	17	0	368
19161	4	14	1	353	0	372
19162	5	1	358	17	0	381
19163	345	2	14	7	0	368
19164	16	362	4	5	0	387
19165	340	14	1	5	0	360
19166	349	4	1	2	0	356
19167	357	1	0	3	0	361
19168	17	2	1	337	0	357
19169	2	1	0	342	0	345
19170	4	333	0	15	0	352
19171	333	15	0	6	0	354
19172	14	337	0	3	0	354
19173	335	16	0	1	0	352
19174	14	6	340	2	0	362
19175	367	0	14	2	0	383
19176	19	1	4	365	0	389
19177	8	1	358	19	0	386
19178	1	2	372	6	0	381
19179	1	2	24	356	0	383
19180	1	0	366	18	0	385
19181	2	0	18	360	0	380
19182	336	2	6	17	0	361
19183	19	0	1	342	0	362
19184	8	2	331	15	0	356
19185	3	324	17	7	0	351
19186	1	342	7	4	0	354
19187	1	23	1	331	0	356
19188	330	9	0	17	0	356
19189	21	1	0	335	0	357
19190	9	1	1	344	0	355
19191	5	0	1	363	0	369
19192	2	2	1	364	0	369
19193	5	2	342	23	0	372
19194	5	1	351	8	0	365
19195	340	0	23	2	0	365
19196	358	1	8	4	0	371
19197	25	1	1	345	0	372
19198	11	2	3	357	0	373
19199	4	0	346	26	0	376
19200	4	340	19	8	0	371
19201	342	15	8	2	0	367
19202	362	7	3	1	0	373
19203	25	1	0	345	0	371
19204	10	2	341	20	0	373
19205	2	2	16	342	0	362
19206	5	341	8	18	0	372
19207	1	17	345	12	0	375
19208	342	9	16	3	0	370
19209	17	2	6	349	0	374
19210	354	2	1	19	0	376
19211	18	0	335	12	0	365
19212	347	0	18	4	0	369
19213	18	2	7	340	0	367
19214	335	2	2	21	0	360
19215	18	1	1	331	0	351
19216	8	307	1	20	0	336
19217	3	328	2	12	0	345
19218	1	23	4	316	0	344
19219	3	8	308	18	0	337
19220	3	296	15	9	0	323
19221	3	12	7	246	0	268
19222	232	6	0	11	0	249
19223	238	1	1	7	0	247
19224	15	1	0	235	0	251
19225	8	0	0	236	0	244
19226	2	227	0	14	0	243
19227	1	238	0	7	0	246
19228	230	13	0	1	0	244
19229	8	7	1	222	0	238
19230	6	1	1	234	0	242
19231	0	0	227	15	0	242
19232	2	0	10	230	0	242
19233	2	0	6	231	0	239
19234	4	0	0	240	0	244
19235	2	0	243	19	0	264
19236	1	0	10	254	0	265
19237	244	2	8	8	0	262
19238	10	2	239	8	0	259
19239	279	1	9	3	0	292
19240	10	0	6	286	0	302
19241	7	1	1	294	0	303
19242	1	0	1	306	0	308
19243	0	1	284	18	0	303
19244	270	3	10	7	0	290
19245	9	295	10	0	0	314
19246	296	9	1	2	0	308
19247	11	299	1	1	0	312
19248	8	9	0	299	0	316
19249	299	6	1	12	0	318
19250	10	2	294	9	0	315
19251	290	1	11	3	0	305
19252	12	1	310	0	0	323
19253	6	1	11	311	0	329
19254	3	0	309	10	0	322
19255	2	306	11	8	0	327
19256	0	7	7	303	0	317
19257	280	6	2	14	0	302
19258	5	1	1	278	0	285
19259	4	276	2	6	0	288
19260	3	5	1	287	0	296
19261	281	5	1	6	0	293
19262	274	1	1	6	0	282
19263	12	268	2	1	0	283
19264	5	257	0	3	0	265
19265	1	8	0	262	0	271
19266	2	4	5	262	0	273
19267	256	1	0	7	0	264
19268	247	1	0	6	0	254
19269	4	245	0	5	0	254
19270	3	9	1	240	0	253
19271	2	3	1	251	0	257
19272	0	2	246	7	0	255
19273	1	248	4	5	0	258
19274	1	241	3	2	0	247
19275	2	1	1	219	0	223
19276	0	0	214	1	0	215
19277	0	1	208	0	0	209
19278	0	0	1	216	0	217
19279	0	0	3	216	0	219
19280	0	0	218	1	0	219
19281	0	0	1	217	0	218
19282	0	0	220	2	0	222
19283	219	0	2	1	0	222
19284	2	0	0	227	0	229
19285	0	1	234	1	0	236
19286	2	0	231	0	0	233
19287	0	0	2	250	0	252
19288	0	0	273	2	0	275
19289	0	0	281	0	0	281
19290	0	277	2	1	0	280
19291	281	2	1	0	0	284
19292	2	0	301	0	0	303
19293	0	1	2	292	0	295
19294	1	0	0	301	0	302
19295	0	0	1	309	0	310
19296	0	0	306	3	0	309
19297	0	0	3	301	0	304
19298	301	1	0	2	0	304
19299	3	0	1	297	0	301
19300	0	0	296	3	0	299
19301	1	0	3	292	0	296
19302	302	1	0	5	0	308
19303	304	0	1	1	0	306
19304	300	0	2	1	0	303
19305	3	0	0	302	0	305
19306	304	0	0	3	0	307
19307	299	0	0	2	0	301
19308	298	0	2	1	0	301
19309	3	300	0	2	0	305
19310	303	1	0	0	0	304
19311	4	0	0	302	0	306
19312	1	1	309	2	0	313
19313	1	306	2	2	0	311
19314	307	2	0	1	0	310
19315	4	0	1	307	0	312
19316	1	1	0	310	0	312
19317	1	308	0	3	0	312
19318	2	313	0	1	0	316
19319	306	2	0	2	0	310
19320	3	301	1	0	0	305
19321	299	4	0	0	0	303
19322	3	299	0	0	0	302
19323	299	3	0	2	0	304
19324	3	300	0	1	0	304
19325	0	319	0	0	0	319
19326	324	3	0	0	0	327
19327	2	1	322	1	0	326
19328	0	321	2	1	0	324
19329	2	5	0	320	0	327
19330	0	5	1	323	0	329
19331	0	1	0	318	0	319
19332	0	2	1	323	0	326
19333	1	1	324	3	0	329
19334	311	1	2	2	0	316
19335	3	0	2	313	0	318
19336	313	2	2	3	0	320
19337	330	2	0	1	0	333
19338	334	0	0	2	0	336
19339	300	0	2	2	0	304
19340	4	1	292	1	0	298
19341	3	0	6	289	0	298
19342	2	0	298	7	0	307
19343	0	299	7	3	0	309
19344	3	6	3	275	0	287
19345	2	1	1	295	0	299
19346	2	0	1	296	0	299
19347	0	0	2	296	0	298
19348	1	1	290	7	0	299
19349	3	0	5	293	0	301
19350	2	0	4	300	0	306
19351	308	1	1	7	0	317
19352	311	0	1	5	0	317
19353	9	0	1	318	0	328
19354	2	0	3	327	0	332
19355	1	2	0	333	0	336
19356	318	1	1	10	0	330
19357	325	0	2	4	0	331
19358	306	0	3	4	0	313
19359	309	1	2	4	0	316
19360	12	306	1	2	0	321
19361	312	8	2	3	0	325
19362	317	1	1	6	0	325
19363	12	0	0	309	0	321
19364	5	0	0	311	0	316
19365	291	2	2	11	0	306
19366	10	291	1	4	0	306
19367	6	310	0	2	0	318
19368	312	10	0	2	0	324
19369	12	2	1	313	0	328
19370	4	0	3	323	0	330
19371	4	2	0	324	0	330
19372	5	2	0	318	0	325
19373	6	1	0	309	0	316
19374	4	311	1	12	0	328
19375	3	12	0	308	0	323
19376	312	2	0	13	0	327
19377	11	0	1	309	0	321
19378	3	4	1	315	0	323
19379	309	2	0	12	0	323
19380	11	313	1	6	0	331
19381	3	12	1	300	0	316
19382	2	313	1	10	0	326
19383	3	12	0	308	0	323
19384	3	2	296	10	0	311
19385	278	0	9	8	0	295
19386	9	287	1	4	0	301
19387	268	8	2	3	0	281
19388	9	1	258	2	0	270
19389	2	1	7	239	0	249
19390	0	240	2	6	0	248
19391	2	244	0	2	0	248
19392	223	8	0	3	0	234
19393	8	1	0	224	0	233
19394	2	0	231	10	0	243
19395	2	1	7	235	0	245
19396	1	1	229	8	0	239
19397	219	2	8	2	0	231
19398	8	0	237	3	0	248
19399	3	1	7	232	0	243
19400	1	233	1	9	0	244
19401	0	7	1	244	0	252
19402	2	235	0	5	0	242
19403	249	8	2	3	0	262
19404	9	2	0	258	0	269
19405	2	1	265	8	0	276
19406	2	0	259	2	0	263
19407	258	1	8	3	0	270
19408	279	2	1	2	0	284
19409	277	0	0	0	0	277
19410	270	0	0	3	0	273
19411	9	270	2	2	0	283
19412	262	8	0	2	0	272
19413	270	1	2	0	0	273
19414	9	0	261	1	0	271
19415	3	2	8	256	0	269
19416	262	1	3	8	0	274
19417	9	2	258	2	0	271
19418	3	0	7	260	0	270
19419	2	1	267	10	0	280
19420	2	1	8	259	0	270
19421	2	270	1	5	0	278
19422	279	8	1	1	0	289
19423	8	1	268	4	0	281
19424	261	0	8	2	0	271
19425	10	0	1	259	0	270
19426	266	2	0	9	0	277
19427	11	1	0	270	0	282
19428	305	2	0	8	0	315
19429	8	0	293	3	0	304
19430	326	2	7	1	0	336
19431	9	0	2	330	0	341
19432	3	0	2	334	0	339
19433	330	0	0	10	0	340
19434	7	2	1	324	0	334
19435	3	0	325	8	0	336
19436	1	1	7	319	0	328
19437	307	1	1	8	0	317
19438	5	300	1	2	0	308
19439	4	303	0	1	0	308
19440	302	4	1	2	0	309
19441	6	329	0	1	0	336
19442	2	4	0	317	0	323
19443	313	0	4	5	0	322
19444	313	1	2	2	0	318
19445	313	0	0	2	0	315
19446	4	1	316	1	0	322
19447	2	5	3	310	0	320
19448	1	326	1	5	0	333
19449	1	5	0	325	0	331
19450	1	0	332	3	0	336
19451	0	321	3	2	0	326
19452	1	1	1	318	0	321
19453	307	1	0	1	0	309
19454	0	301	0	1	0	302
19455	0	0	318	0	0	318
19456	0	1	1	314	0	316
19457	0	0	321	1	0	322
19458	0	0	2	315	0	317
19459	330	0	1	2	0	333
19460	1	0	0	329	0	330
19461	333	0	0	2	0	335
19462	342	0	0	2	0	344
19463	2	357	0	0	0	359
19464	360	1	0	0	0	361
19465	1	363	0	0	0	364
19466	1	1	362	0	0	364
19467	0	1	1	348	0	350
19468	0	0	1	377	0	378
19469	0	1	376	1	0	378
19470	0	364	1	2	0	367
19471	374	1	0	0	0	375
19472	395	1	0	1	0	397
19473	2	0	0	408	0	410
19474	2	0	0	399	0	401
19475	0	0	0	411	0	411
19476	404	0	0	2	0	406
19477	1	0	399	1	0	401
19478	1	0	400	0	0	401
19479	1	0	2	408	0	411
19480	1	0	403	1	0	405
19481	0	0	403	1	0	404
19482	2	0	2	392	0	396
19483	0	0	423	1	0	424
19484	0	428	1	1	0	430
19485	1	0	1	436	0	438
19486	1	1	439	1	0	442
19487	0	0	1	433	0	434
19488	1	418	1	1	0	421
19489	1	2	0	437	0	440
19490	0	1	449	1	0	451
19491	2	0	2	421	0	425
19492	437	0	2	2	0	441
19493	1	0	442	2	0	445
19494	410	0	1	0	0	411
19495	1	445	1	1	0	448
19496	450	1	0	1	0	452
19497	2	1	0	444	0	447
19498	1	450	0	1	0	452
19499	467	2	0	1	0	470
19500	2	2	0	474	0	478
19501	1	0	472	2	0	475
19502	0	475	2	2	0	479
19503	0	2	1	469	0	472
19504	458	1	1	4	0	464
19505	451	2	0	1	0	454
19506	3	0	0	454	0	457
19507	2	0	443	2	0	447
19508	414	1	2	3	0	420
19509	2	0	445	1	0	448
19510	1	0	2	430	0	433
19511	448	0	3	3	0	454
19512	2	443	5	3	0	453
19513	452	3	1	0	0	456
19514	2	1	453	3	0	459
19515	447	0	3	2	0	452
19516	4	0	1	460	0	465
19517	1	1	0	470	0	472
19518	0	0	474	3	0	477
19519	1	2	3	458	0	464
19520	466	0	3	3	0	472
19521	2	0	1	475	0	478
19522	2	475	0	5	0	482
19523	0	3	1	479	0	483
19524	1	479	0	2	0	482
19525	2	2	472	1	0	477
19526	449	1	1	2	0	453
19527	4	0	2	477	0	483
19528	1	2	439	3	0	445
19529	2	423	3	2	0	430
19530	2	3	1	413	0	419
19531	4	1	1	416	0	422
19532	421	0	1	5	0	427
19533	2	2	1	436	0	441
19534	447	0	2	4	0	453
19535	447	1	3	2	0	453
19536	3	470	3	2	0	478
19537	476	4	1	2	0	483
19538	5	3	0	519	0	527
19539	4	0	509	7	0	520
19540	513	1	8	2	0	524
19541	7	0	2	503	0	512
19542	3	1	502	7	0	513
19543	483	0	7	2	0	492
19544	6	0	3	502	0	511
19545	2	518	2	9	0	531
19546	5	9	0	506	0	520
19547	3	514	1	10	0	528
19548	521	10	1	3	0	535
19549	9	3	521	3	0	536
19550	4	505	8	2	0	519
19551	2	11	1	505	0	519
19552	2	1	508	9	0	520
19553	2	1	490	2	0	495
19554	2	494	8	4	0	508
19555	1	7	1	482	0	491
19556	1	3	1	501	0	506
19557	1	1	1	592	0	595
19558	606	3	0	9	0	618
19559	10	0	673	2	0	685
19560	2	680	8	3	0	693
19561	4	10	0	672	0	686
19562	2	1	3	689	0	695
19563	2	3	686	9	0	700
19564	3	0	10	681	0	694
19565	0	2	680	12	0	694
19566	3	0	669	3	0	675
19567	2	0	670	5	0	677
19568	5	0	10	634	0	649
19569	3	0	2	662	0	667
19570	4	2	2	659	0	667
19571	661	2	1	11	0	675
19572	9	643	0	2	0	654
19573	652	9	2	5	0	668
19574	632	1	1	0	0	634
19575	656	2	2	3	0	663
19576	12	654	3	3	0	672
19577	654	12	3	1	0	670
19578	656	0	3	3	0	662
19579	8	3	2	650	0	663
19580	5	1	2	664	0	672
19581	3	2	2	664	0	671
19582	3	2	649	17	0	671
19583	627	1	10	5	0	643
19584	12	3	0	645	0	660
19585	622	0	7	12	0	641
19586	15	630	2	3	0	650
19587	2	11	4	634	0	651
19588	6	4	4	639	0	653
19589	630	2	3	11	0	646
19590	12	0	1	621	0	634
19591	588	4	1	19	0	612
19592	631	0	2	7	0	640
19593	12	617	5	4	0	638
19594	5	624	3	1	0	633
19595	6	11	1	599	0	617
19596	4	623	0	12	0	639
19597	6	16	2	625	0	649
19598	2	4	611	13	0	630
19599	3	3	595	2	0	603
19600	567	1	11	5	0	584
19601	590	2	2	5	0	599
19602	10	591	2	6	0	609
19603	602	10	1	7	0	620
19604	15	623	4	0	0	642
19605	2	12	2	624	0	640
19606	3	2	3	637	0	645
19607	4	3	2	633	0	642
19608	2	2	1	626	0	631
19609	627	1	3	16	0	647
19610	10	622	2	7	0	641
19611	624	10	3	5	0	642
19612	643	2	2	2	0	649
19613	13	5	631	3	0	652
19614	617	3	10	5	0	635
19615	13	618	2	3	0	636
19616	2	12	5	616	0	635
19617	3	1	2	611	0	617
19618	1	616	2	14	0	633
19619	620	9	5	7	0	641
19620	13	1	608	6	0	628
19621	598	4	14	5	0	621
19622	15	4	618	5	0	642
19623	7	0	14	612	0	633
19624	6	1	3	628	0	638
19625	4	3	7	631	0	645
19626	625	4	2	18	0	649
19627	12	2	624	11	0	649
19628	618	2	12	11	0	643
19629	646	2	5	8	0	661
19630	643	1	5	7	0	656
19631	649	0	5	3	0	657
19632	13	5	5	628	0	651
19633	7	0	626	12	0	645
19634	6	2	8	606	0	622
19635	4	0	599	19	0	622
19636	6	10	572	7	0	595
19637	7	580	8	6	0	601
19638	4	7	4	510	0	525
19639	5	1	2	536	0	544
19640	9	3	2	469	0	483
19641	7	1	0	515	0	523
19642	518	3	3	7	0	531
19643	520	0	0	7	0	527
19644	7	1	4	518	0	530
19645	4	0	502	6	0	512
19646	1	2	3	509	0	515
19647	3	1	2	514	0	520
19648	4	1	502	4	0	511
19649	3	3	5	501	0	512
19650	509	2	0	11	0	522
19651	518	1	2	4	0	525
19652	519	2	1	5	0	527
19653	8	0	0	522	0	530
19654	522	1	2	7	0	532
19655	514	1	4	3	0	522
19656	7	2	520	6	0	535
19657	3	0	404	2	0	409
19658	3	0	410	1	0	414
19659	327	0	3	0	0	330
19660	2	330	0	1	0	333
19661	326	2	3	0	0	331
19662	4	366	0	0	0	370
19663	1	3	0	359	0	363
19664	0	0	0	360	0	360
19665	1	1	0	361	0	363
19666	1	0	359	3	0	363
19667	331	0	3	0	0	334
19668	2	0	0	355	0	357
19669	0	0	359	1	0	360
19670	2	0	333	0	0	335
19671	328	1	1	2	0	332
19672	2	349	1	0	0	352
19673	343	7	1	1	0	352
19674	346	0	0	2	0	348
19675	1	347	0	1	0	349
19676	347	1	0	0	0	348
19677	1	0	366	1	0	368
19678	1	0	356	0	0	357
19679	0	0	374	1	0	375
19680	1	0	2	370	0	373
19681	0	0	377	1	0	378
19682	344	0	1	2	0	347
19683	362	1	0	0	0	363
19684	1	0	375	0	0	376
19685	1	0	1	366	0	368
19686	379	1	0	1	0	381
19687	2	388	0	0	0	390
19688	0	397	1	0	0	398
19689	411	1	1	0	0	413
19690	1	1	429	0	0	431
19691	0	1	3	399	0	403
19692	0	0	0	398	0	398
19693	1	0	0	404	0	405
19694	0	397	0	0	0	397
19695	2	1	0	362	0	365
19696	421	0	0	1	0	422
19697	1	0	0	439	0	440
19698	0	449	0	1	0	450
19699	468	1	0	1	0	470
19700	3	0	0	466	0	469
19701	0	0	0	476	0	476
19702	477	0	0	3	0	480
19703	476	0	0	0	0	476
19704	3	0	0	474	0	477
19705	481	0	0	4	0	485
19706	488	0	0	3	0	491
19707	7	505	0	0	0	512
19708	508	4	0	2	0	514
19709	5	508	0	0	0	513
19710	2	4	0	512	0	518
19711	0	2	529	5	0	536
19712	1	0	5	513	0	519
19713	0	1	2	520	0	523
19714	0	0	0	535	0	535
19715	531	0	1	8	0	540
19716	5	529	0	3	0	537
19717	566	5	0	3	0	574
19718	4	587	0	1	0	592
19719	599	5	0	0	0	604
19720	592	5	0	1	0	598
19721	607	0	0	1	0	608
19722	596	0	1	1	0	598
19723	9	2	593	1	0	605
19724	4	0	6	598	0	608
19725	1	2	4	634	0	641
19726	2	0	630	9	0	641
19727	599	1	8	4	0	612
19728	7	0	3	640	0	650
19729	4	1	626	8	0	639
19730	1	1	627	3	0	632
19731	3	0	9	634	0	646
19732	1	1	670	8	0	680
19733	2	0	8	666	0	676
19734	2	0	5	673	0	680
19735	2	1	663	11	0	677
19736	648	0	7	4	0	659
19737	7	0	5	669	0	681
19738	5	2	690	11	0	708
19739	1	1	9	695	0	706
19740	695	1	5	9	0	710
19741	10	0	692	6	0	708
19742	677	1	8	4	0	690
19743	716	0	5	2	0	723
19744	13	0	2	707	0	722
19745	5	1	0	705	0	711
19746	4	1	693	12	0	710
19747	4	2	8	690	0	704
19748	7	1	5	652	0	665
19749	2	3	2	702	0	709
19750	4	1	690	14	0	709
19751	664	1	10	7	0	682
19752	684	0	12	4	0	700
19753	691	0	0	5	0	696
19754	716	1	3	3	0	723
19755	14	0	2	723	0	739
19756	718	2	1	11	0	732
19757	739	1	4	4	0	748
19758	590	8	2	7	0	607
19759	721	1	2	6	0	730
19760	13	717	3	2	0	735
19761	727	9	2	6	0	744
19762	706	3	2	6	0	717
19763	19	713	4	2	0	738
19764	725	14	3	3	0	745
19765	17	6	1	723	0	747
19766	9	1	3	735	0	748
19767	717	1	2	23	0	743
19768	18	700	3	13	0	734
19769	6	716	3	6	0	731
19770	6	18	2	740	0	766
19771	5	6	749	15	0	775
19772	4	2	16	732	0	754
19773	6	0	7	750	0	763
19774	736	3	3	22	0	764
19775	749	0	2	11	0	762
19776	22	1	3	740	0	766
19777	9	1	720	22	0	752
19778	6	0	18	729	0	753
19779	731	1	8	21	0	761
19780	18	0	767	11	0	796
19781	10	770	19	4	0	803
19782	806	17	8	4	0	835
19783	22	6	3	797	0	828
19784	10	2	1	800	0	813
19785	8	1	2	825	0	836
19786	5	0	788	27	0	820
19787	703	0	19	16	0	738
19788	20	1	764	6	0	791
19789	10	756	19	5	0	790
19790	8	15	7	746	0	776
19791	5	6	6	761	0	778
19792	7	2	2	809	0	820
19793	5	7	782	28	0	822
19794	4	1	796	11	0	812
19795	5	1	807	7	0	820
19796	4	809	23	6	0	842
19797	4	15	10	801	0	830
19798	797	8	12	18	0	835
19799	850	4	2	9	0	865
19800	27	2	865	9	0	903
19801	10	904	19	6	0	939
19802	8	19	891	3	0	921
19803	3	913	23	5	0	944
19804	871	21	7	8	0	907
19805	875	6	5	4	0	890
19806	24	871	1	4	0	900
19807	861	19	3	2	0	885
19808	25	6	2	848	0	881
19809	8	5	1	872	0	886
19810	849	2	3	23	0	877
19811	828	2	3	11	0	844
19812	836	2	1	7	0	846
19813	29	805	0	3	0	837
19814	13	841	1	4	0	859
19815	836	23	0	3	0	862
19816	20	10	821	4	0	855
19817	6	7	19	789	0	821
19818	771	2	5	19	0	797
19819	21	752	3	7	0	783
19820	8	786	1	5	0	800
19821	770	22	1	2	0	795
19822	22	12	753	3	0	790
19823	735	5	19	3	0	762
19824	24	2	746	1	0	773
19825	7	0	725	4	0	736
19826	9	2	20	712	0	743
19827	3	5	731	17	0	756
19828	703	4	19	4	0	730
19829	733	1	4	5	0	743
19830	735	2	5	2	0	744
19831	740	1	2	1	0	744
19832	28	0	4	684	0	716
19833	691	1	3	17	0	712
19834	21	689	1	7	0	718
19835	7	20	4	652	0	683
19836	8	692	2	15	0	717
19837	695	21	1	3	0	720
19838	686	5	4	6	0	701
19839	25	5	2	668	0	700
19840	683	2	4	19	0	708
19841	694	4	4	3	0	705
19842	23	2	4	668	0	697
19843	11	5	3	674	0	693
19844	11	3	4	677	0	695
19845	9	3	659	24	0	695
19846	7	3	638	12	0	660
19847	7	3	659	10	0	679
19848	10	3	25	656	0	694
19849	10	1	680	19	0	710
19850	5	5	21	672	0	703
19851	6	3	713	27	0	749
19852	6	2	704	11	0	723
19853	679	3	24	8	0	714
19854	24	678	14	1	0	717
19855	682	19	7	3	0	711
19856	24	9	4	677	0	714
19857	12	9	5	671	0	697
19858	9	3	668	24	0	704
19859	7	666	19	13	0	705
19860	5	18	11	681	0	715
19861	9	6	655	19	0	689
19862	6	648	12	10	0	676
19863	7	15	8	630	0	660
19864	622	6	8	19	0	655
19865	635	4	7	8	0	654
19866	16	2	12	626	0	656
19867	632	5	7	15	0	659
19868	18	642	6	7	0	673
19869	12	12	8	640	0	672
19870	7	10	629	16	0	662
19871	13	6	10	636	0	665
19872	13	2	642	14	0	671
19873	642	3	12	10	0	667
19874	18	5	6	664	0	693
19875	11	674	6	14	0	705
19876	9	20	2	696	0	727
19877	5	5	702	21	0	733
19878	7	8	703	6	0	724
19879	12	2	699	8	0	721
19880	634	4	17	9	0	664
19881	19	647	5	7	0	678
19882	12	12	3	628	0	655
19883	634	7	3	15	0	659
19884	13	633	6	11	0	663
19885	655	8	6	11	0	680
19886	665	4	9	9	0	687
19887	692	4	9	5	0	710
19888	694	5	6	6	0	711
19889	16	7	679	3	0	705
19890	667	0	15	10	0	692
19891	18	1	668	3	0	690
19892	621	4	14	6	0	645
19893	16	0	13	635	0	664
19894	11	1	624	12	0	648
19895	11	615	9	3	0	638
19896	6	27	7	577	0	617
19897	11	592	6	6	0	615
19898	6	603	3	4	0	616
19899	539	4	1	3	0	547
19900	5	1	510	4	0	520
19901	1	481	0	5	0	487
19902	469	1	3	1	0	474
19903	0	505	0	1	0	506
19904	504	1	0	1	0	506
19905	1	2	0	497	0	500
19906	505	1	0	1	0	507
19907	2	0	0	504	0	506
19908	512	0	1	1	0	514
19909	0	1	1	514	0	516
19910	2	557	0	0	0	559
19911	0	1	1	572	0	574
19912	570	1	0	0	0	571
19913	0	579	0	3	0	582
19914	1	0	1	577	0	579
19915	586	2	0	1	0	589
19916	1	0	0	588	0	589
19917	1	0	0	580	0	581
19918	0	2	587	1	0	590
19919	1	0	569	2	0	572
19920	0	0	2	567	0	569
19921	0	4	601	0	0	605
19922	1	0	0	596	0	597
19923	3	2	1	539	0	545
19924	1	0	0	592	0	593
19925	0	0	601	3	0	604
19926	1	0	1	574	0	576
19927	2	0	2	590	0	594
19928	1	610	0	2	0	613
19929	0	0	1	616	0	617
19930	612	2	0	3	0	617
19931	1	0	0	617	0	618
19932	2	1	744	1	0	748
19933	712	1	7	3	0	723
19934	6	796	5	7	0	814
19935	6	6	2	819	0	833
19936	3	7	815	7	0	832
19937	769	4	6	8	0	787
19938	10	818	6	4	0	838
19939	829	8	5	2	0	844
19940	10	5	3	832	0	850
19941	827	4	3	7	0	841
19942	12	3	830	5	0	850
19943	7	809	6	5	0	827
19944	6	857	5	3	0	871
19945	879	9	4	4	0	896
19946	878	8	3	2	0	891
19947	12	6	887	1	0	906
19948	843	4	5	5	0	857
19949	882	2	4	3	0	891
19950	914	1	3	1	0	919
19951	14	874	2	1	0	891
19952	8	883	3	0	0	894
19953	893	9	1	0	0	903
19954	902	9	0	1	0	912
19955	12	931	0	1	0	944
19956	9	10	1	921	0	941
19957	7	6	938	6	0	957
19958	896	5	6	4	0	911
19959	839	5	5	3	0	852
19960	945	2	4	4	0	955
19961	14	943	3	5	0	965
19962	11	6	962	0	0	979
19963	988	5	6	1	0	1000
19964	12	5	4	1014	0	1035
19965	9	3	3	993	0	1008
19966	6	1	2	1029	0	1038
19967	4	0	1024	13	0	1041
19968	6	1	6	995	0	1008
19969	1	1	1014	12	0	1028
19970	1	995	10	8	0	1014
19971	977	6	5	7	0	995
19972	7	964	7	3	0	981
19973	6	973	3	2	0	984
19974	980	13	2	0	0	995
19975	9	982	0	3	0	994
19976	6	12	0	952	0	970
19977	4	942	0	6	0	952
19978	934	13	0	6	0	953
19979	11	950	1	5	0	967
19980	4	14	0	957	0	975
19981	4	5	958	10	0	977
19982	3	6	9	963	0	981
19983	3	959	5	13	0	980
19984	2	17	4	976	0	999
19985	1	4	2	977	0	984
19986	1	7	2	939	0	949
19987	0	2	1	983	0	986
19988	1	3	1	991	0	996
19989	1	0	0	1005	0	1006
19990	0	0	995	22	0	1017
19991	957	1	11	15	0	984
19992	12	0	6	1043	0	1061
19993	5	2	1054	16	0	1077
19994	6	2	1053	8	0	1069
19995	3	2	19	1058	0	1082
19996	1081	1	13	18	0	1113
19997	13	2	1069	6	0	1090
19998	1040	3	16	8	0	1067
19999	22	1	1108	3	0	1134
20000	10	2	19	1102	0	1133
20001	12	0	9	1128	0	1149
20002	3	2	1123	22	0	1150
20003	1036	2	15	12	0	1065
20004	12	4	8	1100	0	1124
20005	8	1	1100	17	0	1126
20006	9	1	1109	9	0	1128
20007	5	2	21	1062	0	1090
20008	4	1092	13	16	0	1125
20009	1114	12	9	8	0	1143
20010	1082	6	5	10	0	1103
20011	19	9	1097	5	0	1130
20012	17	6	16	1057	0	1096
20013	1086	3	11	18	0	1118
20014	19	2	1099	8	0	1128
20015	1051	1	17	11	0	1080
20016	20	1061	10	6	0	1097
20017	11	12	10	1102	0	1135
20018	11	3	6	1107	0	1127
20019	1118	7	4	22	0	1151
20020	18	3	4	1128	0	1153
20021	8	3	4	1115	0	1130
20022	8	2	3	1126	0	1139
20023	1101	0	5	29	0	1135
20024	17	0	1103	16	0	1136
20025	1069	1	13	14	0	1097
20026	1085	1	9	9	0	1104
20027	1110	1	11	5	0	1127
20028	28	0	5	1072	0	1105
20029	17	3	1098	14	0	1132
20030	16	1065	15	6	0	1102
20031	8	1088	7	11	0	1114
20032	4	989	9	5	0	1007
20033	0	13	996	2	0	1011
20034	4	5	10	1159	0	1178
20035	1205	5	5	20	0	1235
20036	1321	0	4	19	0	1344
20037	37	2	1	1371	0	1411
20038	25	2	1357	32	0	1416
20039	13	1	1354	23	0	1391
20040	7	0	39	1375	0	1421
20041	3	1	1404	29	0	1437
20042	5	5	37	1356	0	1403
20043	2	1	19	1318	0	1340
20044	6	1370	11	49	0	1436
20045	4	23	7	1388	0	1422
20046	6	17	1	1429	0	1453
20047	1392	10	2	50	0	1454
20048	29	3	3	1424	0	1459
20049	21	3	3	1416	0	1443
20050	1353	3	5	47	0	1408
20051	27	1340	3	32	0	1402
20052	1354	27	5	14	0	1400
20053	40	19	1333	10	0	1402
20054	1320	9	32	4	0	1365
20055	1322	2	21	10	0	1355
20056	48	0	1300	11	0	1359
20057	37	2	1294	4	0	1337
20058	19	1	50	1242	0	1312
20059	1270	2	32	36	0	1340
20060	33	0	1274	21	0	1328
20061	23	4	34	1255	0	1316
20062	13	3	1264	36	0	1316
20063	8	5	43	1222	0	1278
20064	10	1	23	1235	0	1269
20065	1212	3	13	54	0	1282
20066	1227	0	13	31	0	1271
20067	1272	2	4	21	0	1299
20068	61	3	1236	12	0	1312
20069	36	4	1243	10	0	1293
20070	23	3	47	1220	0	1293
20071	16	3	33	1223	0	1275
20072	8	4	18	1264	0	1294
20073	1209	4	7	59	0	1279
20074	36	1194	9	41	0	1280
20075	1185	27	14	18	0	1244
20076	1172	19	5	17	0	1213
20077	54	1164	4	12	0	1234
20078	35	1211	7	8	0	1261
20079	1183	37	8	15	0	1243
20080	40	26	7	1161	0	1234
20081	29	1164	10	34	0	1237
20082	26	25	3	1181	0	1235
20083	19	23	1153	45	0	1240
20084	16	10	32	1160	0	1218
20085	1142	8	32	45	0	1227
20086	38	2	1138	32	0	1210
20087	30	7	1138	22	0	1197
20088	24	21	53	1044	0	1142
20089	13	1062	40	36	0	1151
20090	11	1090	20	30	0	1151
20091	11	1134	11	27	0	1183
20092	1083	46	6	24	0	1159
20093	1077	28	6	21	0	1132
20094	1055	12	7	18	0	1092
20095	54	1044	6	21	0	1125
20096	1066	23	7	15	0	1111
20097	1042	24	8	12	0	1086
20098	55	12	1026	11	0	1104
20099	36	991	30	15	0	1072
20100	30	24	29	984	0	1067
20101	982	20	17	32	0	1051
20102	33	14	971	33	0	1051
20103	32	7	39	936	0	1014
20104	13	967	33	46	0	1059
20105	14	24	15	982	0	1035
20106	17	21	15	974	0	1027
20107	957	12	10	59	0	1038
20108	966	6	15	47	0	1034
20109	59	7	8	963	0	1037
20110	34	10	933	41	0	1018
20111	25	10	911	38	0	984
20112	914	7	44	19	0	984
20113	48	9	939	13	0	1009
20114	41	9	38	828	0	916
20115	29	881	34	28	0	972
20116	884	26	25	29	0	964
20117	36	899	16	25	0	976
20118	914	31	13	25	0	983
20119	47	20	17	894	0	978
20120	34	15	13	916	0	978
20121	904	9	16	44	0	973
20122	909	8	15	39	0	971
20123	56	12	9	894	0	971
20124	44	11	11	909	0	975
20125	29	13	870	47	0	959
20126	27	4	883	40	0	954
20127	870	8	50	23	0	951
20128	29	11	849	24	0	913
20129	858	5	39	16	0	918
20130	874	3	26	28	0	931
20131	59	5	851	17	0	932
20132	43	791	29	21	0	884
20133	24	819	32	13	0	888
20134	10	11	616	9	0	646
20135	32	60	24	463	0	579
20136	424	9	24	23	0	480
20137	415	3	2	5	0	425
20138	472	2	3	1	0	478
20139	583	0	4	3	0	590
20140	617	2	0	4	0	623
20141	26	617	1	2	0	646
20142	621	16	4	0	0	641
20143	20	617	3	3	0	643
20144	586	19	0	5	0	610
20145	19	4	570	0	0	593
20146	5	1	17	556	0	579
20147	3	0	3	551	0	557
20148	4	562	2	18	0	586
20149	571	17	0	5	0	593
20150	588	5	1	0	0	594
20151	23	4	0	570	0	597
20152	8	2	0	594	0	604
20153	578	2	2	19	0	601
20154	20	1	2	583	0	606
20155	5	1	1	600	0	607
20156	582	2	0	20	0	604
20157	19	2	1	588	0	610
20158	598	0	0	19	0	617
20159	601	1	0	6	0	608
20160	21	1	575	5	0	602
20161	583	0	18	4	0	605
20162	591	0	4	5	0	600
20163	592	0	2	6	0	600
20164	25	1	557	4	0	587
20165	8	1	16	546	0	571
20166	7	0	3	564	0	574
20167	5	1	544	22	0	572
20168	534	0	19	5	0	558
20169	21	1	6	532	0	560
20170	8	1	523	19	0	551
20171	5	1	544	5	0	555
20172	5	2	21	540	0	568
20173	4	0	551	19	0	574
20174	5	0	18	546	0	569
20175	3	0	5	571	0	579
20176	5	0	544	20	0	569
20177	7	0	15	533	0	555
20178	4	526	5	20	0	555
20179	4	554	5	4	0	567
20180	536	22	4	3	0	565
20181	545	4	3	6	0	558
20182	21	536	5	5	0	567
20183	529	17	3	5	0	554
20184	548	2	3	5	0	558
20185	21	2	3	532	0	558
20186	9	2	2	552	0	565
20187	526	5	1	22	0	554
20188	22	524	2	5	0	553
20189	10	533	3	4	0	550
20190	11	21	0	513	0	545
20191	5	9	511	21	0	546
20192	497	3	20	6	0	526
20193	509	0	5	11	0	525
20194	493	5	2	11	0	511
20195	29	488	2	5	0	524
20196	13	22	1	482	0	518
20197	13	4	2	498	0	517
20198	487	5	0	29	0	521
20199	27	481	3	10	0	521
20200	13	18	6	479	0	516
20201	14	3	2	499	0	518
20202	14	5	0	498	0	517
20203	485	5	3	24	0	517
20204	25	485	2	9	0	521
20205	17	22	0	455	0	494
20206	11	481	6	24	0	522
20207	488	23	4	6	0	521
20208	30	4	478	7	0	519
20209	476	5	19	14	0	514
20210	26	0	469	14	0	509
20211	12	5	21	471	0	509
20212	468	5	5	27	0	505
20213	26	4	478	15	0	523
20214	492	1	17	13	0	523
20215	503	3	8	14	0	528
20216	514	1	5	13	0	533
20217	31	1	6	487	0	525
20218	11	3	8	490	0	512
20219	14	4	9	491	0	518
20220	476	1	5	30	0	512
20221	25	475	7	17	0	524
20222	485	17	8	6	0	516
20223	503	4	9	7	0	523
20224	29	3	468	8	0	508
20225	480	4	22	7	0	513
20226	500	4	8	10	0	522
20227	32	3	5	487	0	527
20228	12	5	9	495	0	521
20229	13	5	3	498	0	519
20230	475	6	5	31	0	517
20231	483	1	9	8	0	501
20232	466	0	5	11	0	482
20233	26	431	5	10	0	472
20234	7	428	11	3	0	449
20235	7	436	2	9	0	454
20236	426	20	6	11	0	463
20237	15	6	424	8	0	453
20238	12	0	363	10	0	385
20239	208	1	6	2	0	217
20240	4	0	208	1	0	213
20241	2	0	1	161	0	164
20242	0	166	1	2	0	169
20243	172	0	0	2	0	174
20244	173	1	0	1	0	175
20245	180	0	0	0	0	180
20246	2	1	0	208	0	211
20247	2	0	208	0	0	210
20248	0	2	200	3	0	205
20249	206	1	1	0	0	208
20250	207	1	2	3	0	213
20251	220	0	1	0	0	221
20252	3	0	1	215	0	219
20253	1	1	2	216	0	220
20254	1	0	209	1	0	211
20255	201	2	1	2	0	206
20256	2	0	1	218	0	221
20257	2	1	1	215	0	219
20258	3	0	0	210	0	213
20259	1	206	1	2	0	210
20260	1	0	1	211	0	213
20261	1	0	1	209	0	211
20262	210	0	2	1	0	213
20263	2	0	209	0	0	211
20264	202	0	0	0	0	202
20265	212	0	1	1	0	214
20266	2	0	0	209	0	211
20267	0	0	1	210	0	211
20268	210	0	0	3	0	213
20269	1	0	208	2	0	211
20270	2	209	0	1	0	212
20271	0	0	1	209	0	210
20272	211	2	0	1	0	214
20273	0	0	1	207	0	208
20274	2	1	200	1	0	204
20275	2	0	190	2	0	194
20276	194	0	2	1	0	197
20277	1	0	0	214	0	215
20278	2	0	210	1	0	213
20279	211	0	0	3	0	214
20280	230	0	1	1	0	232
20281	3	0	0	225	0	228
20282	2	1	0	226	0	229
20283	1	227	0	1	0	229
20284	233	1	1	2	0	237
20285	2	2	0	236	0	240
20286	1	0	1	239	0	241
20287	1	0	238	1	0	240
20288	215	0	1	3	0	219
20289	238	0	3	0	0	241
20290	1	234	1	2	0	238
20291	1	1	231	0	0	233
20292	2	1	233	1	0	237
20293	2	0	1	225	0	228
20294	245	0	1	2	0	248
20295	1	0	0	250	0	251
20296	257	1	0	2	0	260
20297	257	0	1	3	0	261
20298	260	1	0	1	0	262
20299	2	0	0	264	0	266
20300	1	0	1	268	0	270
20301	270	0	0	3	0	273
20302	0	0	277	2	0	279
20303	252	0	0	0	0	252
20304	261	0	1	0	0	262
20305	0	0	274	0	0	274
20306	2	0	267	0	0	269
20307	0	273	0	0	0	273
20308	2	0	1	278	0	281
20309	262	1	4	1	0	268
20310	0	0	0	279	0	279
20311	0	0	273	0	0	273
20312	0	265	0	1	0	266
20313	0	265	1	0	0	266
20314	0	0	0	285	0	285
20315	0	0	0	278	0	278
20316	0	272	0	0	0	272
20317	0	0	281	0	0	281
20318	268	0	0	0	0	268
20319	291	0	0	0	0	291
20320	0	290	0	0	0	290
20321	285	0	0	1	0	286
20322	0	2	0	286	0	288
20323	281	0	0	0	0	281
20324	0	0	0	279	0	279
20325	1	280	0	0	0	281
20326	0	0	274	1	0	275
20327	0	1	0	290	0	291
20328	0	1	1	272	0	274
20329	1	0	0	301	0	302
20330	306	0	0	1	0	307
20331	0	0	0	314	0	314
20332	1	0	339	0	0	340
20333	0	0	354	1	0	355
20334	357	0	5	0	0	362
20335	4	2	360	0	0	366
20336	353	0	4	0	0	357
20337	5	0	1	391	0	397
20338	3	0	0	397	0	400
20339	0	0	0	442	0	442
20340	0	0	0	446	0	446
20341	446	0	0	10	0	456
20342	7	0	447	2	0	456
20343	2	0	7	439	0	448
20344	1	446	2	7	0	456
20345	438	7	1	2	0	448
20346	9	2	0	415	0	426
20347	409	1	0	8	0	418
20348	9	0	401	2	0	412
20349	2	0	8	386	0	396
20350	1	399	2	8	0	410
20351	396	8	0	2	0	406
20352	8	2	395	1	0	406
20353	2	1	8	391	0	402
20354	2	0	2	400	0	404
20355	389	0	1	10	0	400
20356	8	0	392	3	0	403
20357	2	0	402	1	0	405
20358	1	0	10	390	0	401
20359	0	0	396	8	0	404
20360	0	0	410	3	0	413
20361	0	0	10	399	0	409
20362	1	0	3	402	0	406
20363	0	0	1	417	0	418
20364	405	0	0	12	0	417
20365	7	412	0	4	0	423
20366	415	8	0	1	0	424
20367	10	2	0	418	0	430
20368	3	420	0	9	0	432
20369	3	8	1	433	0	445
20370	444	2	0	13	0	459
20371	10	468	0	2	0	480
20372	4	11	0	476	0	491
20373	2	3	477	13	0	495
20374	469	3	12	4	0	488
20375	12	1	2	477	0	492
20376	5	1	3	487	0	496
20377	4	1	468	14	0	487
20378	1	1	463	7	0	472
20379	441	1	15	7	0	464
20380	14	448	5	5	0	472
20381	4	11	7	450	0	472
20382	454	2	3	13	0	472
20383	15	2	462	6	0	485
20384	3	455	17	7	0	482
20385	8	12	3	456	0	479
20386	461	4	4	16	0	485
20387	455	2	2	8	0	467
20388	465	1	4	9	0	479
20389	15	455	1	9	0	480
20390	11	13	444	6	0	474
20391	6	3	14	457	0	480
20392	8	2	9	429	0	448
20393	3	4	8	475	0	490
20394	3	1	5	471	0	480
20395	451	2	5	22	0	480
20396	454	1	1	11	0	467
20397	18	0	439	9	0	466
20398	7	0	438	8	0	453
20399	415	2	16	9	0	442
20400	430	3	5	7	0	445
20401	23	4	7	408	0	442
20402	5	420	6	16	0	447
20403	421	12	4	9	0	446
20404	15	413	2	10	0	440
20405	6	423	5	8	0	442
20406	9	22	3	409	0	443
20407	7	3	4	439	0	453
20408	3	1	9	433	0	446
20409	4	3	4	435	0	446
20410	6	3	414	24	0	447
20411	412	4	14	8	0	438
20412	426	1	7	10	0	444
20413	15	1	5	413	0	434
20414	9	4	3	405	0	421
20415	400	2	4	18	0	424
20416	16	3	378	10	0	407
20417	393	5	11	9	0	418
20418	398	2	4	9	0	413
20419	16	2	391	2	0	411
20420	409	3	13	3	0	428
20421	16	4	3	417	0	440
20422	8	1	3	423	0	435
20423	8	1	4	427	0	440
20424	8	3	3	423	0	437
20425	415	4	0	21	0	440
20426	15	6	3	410	0	434
20427	2	3	3	396	0	404
20428	5	367	3	16	0	391
20429	3	386	5	9	0	403
20430	4	15	0	380	0	399
20431	364	4	1	21	0	390
20432	15	3	3	344	0	365
20433	6	1	309	12	0	328
20434	6	2	296	3	0	307
20435	299	1	8	6	0	314
20436	11	297	4	5	0	317
20437	262	8	5	1	0	276
20438	14	1	266	3	0	284
20439	4	14	6	227	0	251
20440	235	3	2	7	0	247
20441	8	228	4	2	0	242
20442	229	5	2	4	0	240
20443	7	2	251	4	0	264
20444	3	2	5	252	0	262
20445	4	1	3	257	0	265
20446	250	1	3	7	0	261
20447	251	0	2	5	0	258
20448	267	1	1	7	0	276
20449	275	1	1	4	0	281
20450	272	2	1	2	0	277
20451	8	271	2	2	0	283
20452	3	6	2	275	0	286
20453	286	2	1	5	0	294
20454	7	1	0	284	0	292
20455	5	2	1	282	0	290
20456	5	1	2	279	0	287
20457	3	274	3	5	0	285
20458	279	5	2	4	0	290
20459	6	1	1	278	0	286
20460	265	3	1	10	0	279
20461	268	0	1	6	0	275
20462	7	273	1	5	0	286
20463	272	4	1	5	0	282
20464	8	1	269	2	0	280
20465	268	2	7	1	0	278
20466	8	4	5	264	0	281
20467	4	1	277	3	0	285
20468	4	269	3	4	0	280
20469	4	3	266	3	0	276
20470	1	247	2	3	0	253
20471	234	0	0	2	0	236
20472	242	0	0	0	0	242
20473	232	0	0	0	0	232
20474	0	239	0	0	0	239
20475	232	0	0	0	0	232
20476	0	0	235	0	0	235
20477	0	0	230	2	0	232
20478	0	0	1	229	0	230
20479	0	1	1	246	0	248
20480	0	240	1	0	0	241
20481	251	0	0	0	0	251
20482	0	0	0	252	0	252
20483	0	244	0	0	0	244
20484	0	0	0	252	0	252
20485	253	0	0	0	0	253
20486	238	0	0	0	0	238
20487	1	0	234	0	0	235
20488	0	0	1	234	0	235
20489	0	0	239	1	0	240
20490	0	0	1	245	0	246
20491	1	0	248	3	0	252
20492	0	0	2	247	0	249
20493	0	0	247	3	0	250
20494	0	0	3	250	0	253
20495	0	0	258	3	0	261
20496	0	0	3	258	0	261
20497	0	0	0	275	0	275
20498	0	283	0	2	0	285
20499	0	2	0	287	0	289
20500	0	0	286	3	0	289
20501	0	0	4	282	0	286
20502	0	0	0	286	0	286
20503	289	0	0	5	0	294
20504	4	0	0	293	0	297
20505	0	0	0	289	0	289
20506	0	0	282	4	0	286
20507	269	0	4	2	0	275
20508	4	0	0	284	0	288
20509	0	0	0	286	0	286
20510	0	0	0	293	0	293
20511	288	0	0	4	0	292
20512	4	0	0	290	0	294
20513	0	0	0	297	0	297
20514	290	0	0	4	0	294
20515	4	298	0	0	0	302
20516	0	4	0	290	0	294
20517	0	0	0	302	0	302
20518	0	0	286	4	0	290
20519	236	0	3	0	0	239
20520	5	0	1	272	0	278
20521	0	0	266	5	0	271
20522	258	0	4	2	0	264
20523	3	1	0	271	0	275
20524	0	0	0	274	0	274
20525	0	0	1	279	0	280
20526	0	0	0	294	0	294
20527	1	0	308	5	0	314
20528	2	0	5	307	0	314
20529	2	0	0	383	0	385
20530	0	0	469	12	0	481
20531	486	0	15	0	0	501
20532	512	0	0	0	0	512
20533	516	0	2	2	0	520
20534	18	0	0	504	0	522
20535	507	0	1	15	0	523
20536	527	0	0	1	0	528
20537	16	0	0	514	0	530
20538	504	0	0	17	0	521
20539	514	0	0	1	0	515
20540	506	1	0	3	0	510
20541	512	0	0	1	0	513
20542	18	0	0	497	0	515
20543	3	471	1	17	0	492
20544	4	480	0	0	0	484
20545	1	486	0	3	0	490
20546	469	19	1	0	0	489
20547	494	1	0	1	0	496
20548	17	3	458	1	0	479
20549	466	1	17	1	0	485
20550	19	1	0	464	0	484
20551	2	1	2	476	0	481
20552	4	0	1	480	0	485
20553	456	0	0	21	0	477
20554	17	0	0	456	0	473
20555	1	454	1	19	0	475
20556	3	18	0	458	0	479
20557	2	0	468	21	0	491
20558	2	1	16	472	0	491
20559	471	0	1	23	0	495
20560	19	1	475	1	0	496
20561	4	0	15	472	0	491
20562	3	0	2	480	0	485
20563	5	0	3	481	0	489
20564	3	472	1	22	0	498
20565	4	18	1	472	0	495
20566	475	0	0	21	0	496
20567	475	2	1	5	0	483
20568	19	1	453	5	0	478
20569	8	1	479	1	0	489
20570	6	1	18	462	0	487
20571	6	0	3	488	0	497
20572	5	0	468	20	0	493
20573	4	2	19	449	0	474
20574	6	464	1	17	0	488
20575	472	20	2	5	0	499
20576	481	1	1	6	0	489
20577	481	4	1	2	0	488
20578	25	2	472	2	0	501
20579	9	2	19	475	0	505
20580	7	1	474	23	0	505
20581	460	0	20	6	0	486
20582	23	469	3	5	0	500
20583	3	18	3	471	0	495
20584	471	3	0	22	0	496
20585	21	6	2	476	0	505
20586	6	3	0	508	0	517
20587	6	3	484	20	0	513
20588	460	2	17	8	0	487
20589	24	481	1	5	0	511
20590	3	17	7	480	0	507
20591	480	1	1	24	0	506
20592	22	3	2	484	0	511
20593	478	0	2	23	0	503
20594	20	481	3	7	0	511
20595	483	15	1	13	0	512
20596	23	1	483	5	0	512
20597	470	4	14	6	0	494
20598	476	3	3	3	0	485
20599	475	2	6	6	0	489
20600	24	2	2	460	0	488
20601	11	3	4	436	0	454
20602	7	2	5	462	0	476
20603	4	450	3	22	0	479
20604	455	17	0	12	0	484
20605	21	3	3	453	0	480
20606	8	3	2	466	0	479
20607	10	2	1	461	0	474
20608	449	4	3	23	0	479
20609	22	1	1	451	0	475
20610	7	3	448	20	0	478
20611	9	457	19	9	0	494
20612	4	20	4	472	0	500
20613	3	7	5	478	0	493
20614	6	3	3	484	0	496
20615	3	1	456	26	0	486
20616	5	3	461	12	0	481
20617	3	2	24	465	0	494
20618	8	0	480	23	0	511
20619	6	3	19	496	0	524
20620	492	1	6	23	0	522
20621	525	4	5	9	0	543
20622	522	1	3	10	0	536
20623	29	0	502	5	0	536
20624	498	4	17	4	0	523
20625	23	2	8	514	0	547
20626	6	0	506	17	0	529
20627	9	2	508	7	0	526
20628	4	510	18	7	0	539
20629	2	445	4	5	0	456
20630	325	18	8	5	0	356
20631	5	3	1	320	0	329
20632	4	0	326	5	0	335
20633	0	0	5	333	0	338
20634	332	0	4	4	0	340
20635	4	0	349	4	0	357
20636	346	0	6	0	0	352
20637	390	0	4	1	0	395
20638	386	1	1	0	0	388
20639	8	389	1	1	0	399
20640	406	5	0	0	0	411
20641	5	2	0	405	0	412
20642	3	0	2	396	0	401
20643	0	0	1	407	0	408
20644	2	1	1	403	0	407
20645	398	1	2	8	0	409
20646	5	395	1	2	0	403
20647	2	386	0	1	0	389
20648	1	412	0	0	0	413
20649	405	8	0	2	0	415
20650	416	3	1	0	0	420
20651	416	0	1	3	0	420
20652	414	0	0	0	0	414
20653	8	0	1	414	0	423
20654	6	0	0	415	0	421
20655	417	1	1	7	0	426
20656	7	419	0	3	0	429
20657	403	5	0	1	0	409
20658	406	2	0	1	0	409
20659	7	1	0	402	0	410
20660	4	411	0	6	0	421
20661	1	4	0	423	0	428
20662	414	3	0	8	0	425
20663	6	1	425	3	0	435
20664	4	2	5	395	0	406
20665	3	417	3	5	0	428
20666	419	7	0	3	0	429
20667	419	4	0	1	0	424
20668	12	1	423	0	0	436
20669	5	414	5	3	0	427
20670	2	6	423	2	0	433
20671	3	2	4	404	0	413
20672	3	0	408	5	0	416
20673	4	0	399	5	0	408
20674	1	403	8	1	0	413
20675	403	5	3	1	0	412
20676	413	5	0	2	0	420
20677	7	419	0	3	0	429
20678	5	410	0	3	0	418
20679	2	6	399	2	0	409
20680	3	5	391	0	0	399
20681	0	2	406	1	0	409
20682	2	1	8	392	0	403
20683	1	2	398	6	0	407
20684	3	1	5	381	0	390
20685	3	1	3	376	0	383
20686	2	0	383	7	0	392
20687	3	383	5	4	0	395
20688	1	5	3	381	0	390
20689	383	3	0	7	0	393
20690	5	0	3	384	0	392
20691	4	1	382	4	0	391
20692	2	378	5	1	0	386
20693	3	388	3	1	0	395
20694	4	7	0	387	0	398
20695	373	4	1	6	0	384
20696	386	2	1	5	0	394
20697	8	1	1	383	0	393
20698	3	416	2	5	0	426
20699	1	4	3	419	0	427
20700	2	3	1	429	0	435
20701	1	0	2	428	0	431
20702	450	1	0	8	0	459
20703	5	458	2	6	0	471
20704	460	6	0	2	0	468
20705	468	4	2	0	0	474
20706	473	0	1	2	0	476
20707	484	2	1	2	0	489
20708	9	0	1	478	0	488
20709	7	1	480	4	0	492
20710	2	471	5	5	0	483
20711	473	4	5	3	0	485
20712	479	2	2	2	0	485
20713	483	3	0	1	0	487
20714	7	6	464	0	0	477
20715	470	0	3	1	0	474
20716	470	1	3	2	0	476
20717	4	1	1	469	0	475
20718	6	0	457	5	0	468
20719	1	448	3	3	0	455
20720	1	4	3	458	0	466
20721	446	3	2	4	0	455
20722	3	3	1	441	0	448
20723	5	0	0	446	0	451
20724	448	0	0	7	0	455
20725	4	0	429	4	0	437
20726	432	0	4	3	0	439
20727	417	1	3	1	0	422
20728	419	1	2	1	0	423
20729	416	1	1	2	0	420
20730	6	0	404	1	0	411
20731	4	2	3	399	0	408
20732	2	0	405	5	0	412
20733	3	0	5	394	0	402
20734	0	2	395	5	0	402
20735	348	2	4	9	0	363
20736	5	354	3	3	0	365
20737	2	334	3	0	0	339
20738	3	4	0	340	0	347
20739	3	3	1	342	0	349
20740	1	349	2	6	0	358
20741	354	4	1	4	0	363
20742	383	4	1	1	0	389
20743	416	3	0	1	0	420
20744	446	0	1	0	0	447
20745	11	0	1	443	0	455
20746	9	0	1	446	0	456
20747	465	1	0	13	0	479
20748	9	1	0	453	0	463
20749	10	1	446	7	0	464
20750	4	1	440	7	0	452
20751	5	0	12	446	0	463
20752	4	1	451	8	0	464
20753	445	0	7	10	0	462
20754	9	0	8	444	0	461
20755	448	0	1	8	0	457
20756	9	0	449	7	0	465
20757	9	0	9	453	0	471
20758	1	0	459	10	0	470
20759	1	448	10	8	0	467
20760	436	8	13	3	0	460
20761	436	6	3	8	0	453
20762	16	433	0	2	0	451
20763	438	7	2	2	0	449
20764	16	7	3	425	0	451
20765	16	1	3	427	0	447
20766	426	2	1	13	0	442
20767	11	412	0	13	0	436
20768	11	420	1	8	0	440
20769	11	15	0	417	0	443
20770	411	10	2	14	0	437
20771	418	2	5	8	0	433
20772	429	0	8	5	0	442
20773	18	0	411	9	0	438
20774	9	3	422	1	0	435
20775	8	410	15	1	0	434
20776	401	8	9	9	0	427
20777	15	9	1	397	0	422
20778	413	1	6	8	0	428
20779	408	1	1	12	0	422
20780	17	2	9	393	0	421
20781	9	6	399	9	0	423
20782	402	3	9	8	0	422
20783	17	1	7	398	0	423
20784	10	7	395	10	0	422
20785	398	1	9	9	0	417
20786	402	1	8	8	0	419
20787	14	2	1	399	0	416
20788	16	0	390	11	0	417
20789	5	6	9	388	0	408
20790	2	398	8	10	0	418
20791	3	8	393	13	0	417
20792	8	398	9	3	0	418
20793	401	8	7	0	0	416
20794	401	7	1	3	0	412
20795	397	1	8	2	0	408
20796	395	0	10	3	0	408
20797	18	8	1	379	0	406
20798	358	2	3	11	0	374
20799	10	3	3	359	0	375
20800	344	1	1	11	0	357
20801	19	333	1	14	0	367
20802	11	9	3	307	0	330
20803	5	306	8	8	0	327
20804	306	9	2	11	0	328
20805	305	6	3	9	0	323
20806	18	293	7	4	0	322
20807	16	5	2	282	0	305
20808	11	6	279	6	0	302
20809	1	7	9	286	0	303
20810	3	2	289	11	0	305
20811	3	1	10	265	0	279
20812	4	269	6	4	0	283
20813	264	9	7	5	0	285
20814	271	12	2	2	0	287
20815	18	3	3	263	0	287
20816	280	0	1	9	0	290
20817	15	1	3	270	0	289
20818	13	1	1	264	0	279
20819	5	2	1	268	0	276
20820	261	2	0	11	0	274
20821	257	2	0	13	0	272
20822	256	1	1	5	0	263
20823	16	251	0	2	0	269
20824	251	7	0	9	0	267
20825	10	249	0	6	0	265
20826	247	7	3	3	0	260
20827	17	5	2	236	0	260
20828	9	9	1	242	0	261
20829	238	1	3	17	0	259
20830	240	3	6	8	0	257
20831	17	234	1	5	0	257
20832	251	6	7	1	0	265
20833	8	5	2	251	0	266
20834	11	7	2	247	0	267
20835	251	1	0	15	0	267
20836	14	0	241	9	0	264
20837	9	246	8	7	0	270
20838	13	6	3	230	0	252
20839	3	4	219	6	0	232
20840	2	7	6	201	0	216
20841	204	0	5	5	0	214
20842	6	173	0	5	0	184
20843	4	141	0	1	0	146
20844	1	118	1	0	0	120
20845	1	6	0	109	0	116
20846	103	0	6	4	0	113
20847	1	0	1	96	0	98
20848	96	1	0	3	0	100
20849	101	0	0	1	0	102
20850	4	1	0	99	0	104
20851	101	0	0	3	0	104
20852	5	0	0	104	0	109
20853	0	0	103	5	0	108
20854	100	0	3	0	0	103
20855	3	0	116	2	0	121
20856	101	0	2	2	0	105
20857	2	0	110	1	0	113
20858	1	0	1	111	0	113
20859	0	0	1	113	0	114
20860	120	0	0	2	0	122
20861	2	1	0	123	0	126
20862	126	0	0	2	0	128
20863	2	118	0	0	0	120
20864	124	2	0	0	0	126
20865	2	0	0	129	0	131
20866	0	0	0	128	0	128
20867	1	0	0	128	0	129
20868	1	0	0	124	0	125
20869	0	0	125	2	0	127
20870	1	0	123	0	0	124
20871	0	0	2	127	0	129
20872	0	0	122	2	0	124
20873	0	125	2	0	0	127
20874	1	2	0	124	0	127
20875	0	0	138	3	0	141
20876	0	0	141	1	0	142
20877	1	0	1	139	0	141
20878	1	0	0	145	0	146
20879	0	145	0	2	0	147
20880	1	2	0	149	0	152
20881	0	0	151	3	0	154
20882	140	0	2	1	0	143
20883	2	0	1	151	0	154
20884	160	0	1	4	0	165
20885	162	0	1	0	0	163
20886	166	0	0	2	0	168
20887	2	0	165	1	0	168
20888	1	0	167	1	0	169
20889	155	0	2	1	0	158
20890	3	0	170	0	0	173
20891	0	2	2	163	0	167
20892	1	1	0	167	0	169
20893	0	0	167	4	0	171
20894	1	164	2	1	0	168
20895	167	2	0	2	0	171
20896	3	169	0	1	0	173
20897	1	174	1	0	0	176
20898	172	2	1	1	0	176
20899	3	0	174	1	0	178
20900	0	0	175	1	0	176
20901	0	1	3	166	0	170
20902	171	0	0	3	0	174
20903	2	173	3	0	0	178
20904	173	2	2	0	0	177
20905	2	0	179	2	0	183
20906	1	195	2	2	0	200
20907	0	4	0	195	0	199
20908	1	0	193	6	0	200
20909	0	0	4	195	0	199
20910	3	0	0	168	0	171
20911	0	1	0	204	0	205
20912	2	0	1	201	0	204
20913	200	0	0	4	0	204
20914	197	0	0	2	0	199
20915	2	0	200	2	0	204
20916	186	0	3	4	0	193
20917	4	199	1	0	0	204
20918	195	2	2	0	0	199
20919	2	0	205	2	0	209
20920	1	0	3	197	0	201
20921	0	2	202	2	0	206
20922	1	1	200	1	0	203
20923	1	0	4	190	0	195
20924	0	1	0	194	0	195
20925	0	1	197	2	0	200
20926	1	189	3	0	0	193
20927	0	193	2	1	0	196
20928	0	2	2	198	0	202
20929	191	0	2	4	0	197
20930	2	206	0	4	0	212
20931	0	6	202	1	0	209
20932	1	1	184	3	0	189
20933	0	0	193	1	0	194
20934	2	2	3	188	0	195
20935	193	0	0	5	0	198
20936	3	184	2	1	0	190
20937	3	2	183	1	0	189
20938	3	181	2	1	0	187
20939	2	2	2	184	0	190
20940	0	1	185	3	0	189
20941	3	186	4	0	0	193
20942	2	3	2	186	0	193
20943	0	0	2	191	0	193
20944	0	0	187	5	0	192
20945	0	2	3	177	0	182
20946	0	188	1	3	0	192
20947	1	3	186	1	0	191
20948	180	1	2	1	0	184
20949	1	3	1	183	0	188
20950	2	2	0	184	0	188
20951	1	174	2	2	0	179
20952	181	1	3	1	0	186
20953	1	0	185	3	0	189
20954	183	1	1	1	0	186
20955	2	3	0	178	0	183
20956	2	187	0	2	0	191
20957	1	2	2	182	0	187
20958	2	2	1	182	0	187
20959	189	1	0	4	0	194
20960	191	1	0	1	0	193
20961	2	0	1	196	0	199
20962	0	0	191	6	0	197
20963	171	0	2	3	0	176
20964	4	187	0	2	0	193
20965	1	2	0	188	0	191
20966	3	0	2	195	0	200
20967	3	0	2	200	0	205
20968	2	2	199	2	0	205
20969	1	2	2	191	0	196
20970	2	204	0	4	0	210
20971	3	2	2	200	0	207
20972	0	211	3	4	0	218
20973	0	2	1	211	0	214
20974	0	2	210	2	0	214
20975	183	0	2	2	0	187
20976	2	2	0	201	0	205
20977	0	0	210	3	0	213
20978	0	200	3	0	0	203
20979	202	1	0	0	0	203
20980	1	0	200	2	0	203
20981	192	0	3	0	0	195
20982	1	1	0	205	0	207
20983	2	0	0	201	0	203
20984	0	194	1	1	0	196
20985	202	1	0	0	0	203
20986	197	0	0	1	0	198
20987	1	213	0	2	0	216
20988	0	2	1	216	0	219
20989	2	0	0	216	0	218
20990	2	1	0	209	0	212
20991	0	1	216	1	0	218
20992	204	1	1	2	0	208
20993	1	0	0	217	0	218
20994	0	0	1	216	0	217
20995	1	1	216	1	0	219
20996	1	0	211	1	0	213
20997	0	0	1	211	0	212
20998	0	1	209	3	0	213
20999	206	0	2	0	0	208
21000	1	0	2	212	0	215
21001	1	0	0	213	0	214
21002	0	0	230	2	0	232
21003	1	0	1	247	0	249
21004	0	1	255	2	0	258
21005	1	239	1	1	0	242
21006	222	1	1	1	0	225
21007	224	1	0	1	0	226
21008	1	228	1	1	0	231
21009	0	2	0	228	0	230
21010	1	0	228	2	0	231
21011	1	0	0	229	0	230
21012	231	1	0	0	0	232
21013	0	229	0	2	0	231
21014	233	1	1	1	0	236
21015	1	0	1	236	0	238
21016	228	0	1	1	0	230
21017	0	227	0	1	0	228
21018	230	1	1	0	0	232
21019	2	0	220	1	0	223
21020	1	224	1	1	0	227
21021	0	2	0	225	0	227
21022	226	0	1	3	0	230
21023	228	0	2	1	0	231
21024	1	1	1	234	0	237
21025	233	2	0	3	0	238
21026	234	0	0	2	0	236
21027	241	1	0	0	0	242
21028	1	1	0	238	0	240
21029	2	1	236	2	0	241
21030	1	0	220	1	0	222
21031	1	1	226	2	0	230
21032	230	0	2	2	0	234
21033	1	2	3	233	0	239
21034	4	244	2	1	0	251
21035	0	1	2	246	0	249
21036	3	252	0	1	0	256
21037	260	3	0	2	0	265
21038	3	2	0	263	0	268
21039	1	7	2	261	0	271
21040	273	2	0	2	0	277
21041	2	0	0	269	0	271
21042	3	1	0	277	0	281
21043	281	1	2	5	0	289
21044	3	0	292	4	0	299
21045	5	0	2	290	0	297
21046	0	1	296	3	0	300
21047	288	0	1	3	0	292
21048	3	0	3	295	0	301
21049	294	0	1	5	0	300
21050	2	0	4	292	0	298
21051	5	0	311	2	0	318
21052	1	0	2	318	0	321
21053	325	0	4	4	0	333
21054	4	332	1	3	0	340
21055	3	3	328	2	0	336
21056	311	4	3	4	0	322
21057	4	321	5	2	0	332
21058	2	335	2	3	0	342
21059	2	350	2	4	0	358
21060	5	9	0	367	0	381
21061	376	4	1	10	0	391
21062	396	0	0	6	0	402
21063	14	1	383	2	0	400
21064	380	1	11	2	0	394
21065	13	389	4	0	0	406
21066	3	10	1	384	0	398
21067	410	3	1	13	0	427
21068	429	0	1	3	0	433
21069	430	1	0	2	0	433
21070	424	1	1	1	0	427
21071	429	2	0	0	0	431
21072	15	0	0	408	0	423
21073	6	0	412	11	0	429
21074	2	1	11	411	0	425
21075	1	1	4	428	0	434
21076	412	0	2	14	0	428
21077	13	397	1	4	0	415
21078	403	11	0	3	0	417
21079	415	4	2	1	0	422
21080	442	1	1	0	0	444
21081	444	1	1	3	0	449
21082	17	0	422	2	0	441
21083	428	1	14	1	0	444
21084	447	0	4	1	0	452
21085	387	1	3	0	0	391
21086	437	0	0	1	0	438
21087	15	2	0	413	0	430
21088	6	0	410	12	0	428
21089	405	1	12	5	0	423
21090	13	407	3	3	0	426
21091	6	12	1	404	0	423
21092	5	409	1	9	0	424
21093	4	13	0	415	0	432
21094	417	4	1	12	0	434
21095	435	2	2	4	0	443
21096	432	1	3	2	0	438
21097	19	0	417	0	0	436
21098	417	2	9	1	0	429
21099	13	2	417	5	0	437
21100	8	1	423	1	0	433
21101	9	0	431	1	0	441
21102	5	15	15	365	0	400
21103	5	0	4	397	0	406
21104	3	3	2	390	0	398
21105	4	0	0	396	0	400
21106	6	1	1	369	0	377
21107	4	0	1	397	0	402
21108	4	391	1	17	0	413
21109	394	12	1	7	0	414
21110	16	402	1	2	0	421
21111	6	13	1	402	0	422
21112	3	3	3	410	0	419
21113	402	2	2	18	0	424
21114	15	394	0	9	0	418
21115	406	14	3	2	0	425
21116	17	5	1	403	0	426
21117	8	2	1	408	0	419
21118	8	1	0	419	0	428
21119	4	3	397	21	0	425
21120	6	1	12	410	0	429
21121	4	3	407	15	0	429
21122	4	1	402	8	0	415
21123	5	2	421	8	0	436
21124	4	2	18	409	0	433
21125	7	3	7	431	0	448
21126	5	2	4	440	0	451
21127	428	2	3	18	0	451
21128	19	4	3	437	0	463
21129	460	3	2	16	0	481
21130	19	450	2	10	0	481
21131	468	13	1	8	0	490
21132	486	3	3	7	0	499
21133	21	477	5	3	0	506
21134	471	13	4	4	0	492
21135	480	4	3	6	0	493
21136	482	2	5	6	0	495
21137	477	2	2	8	0	489
21138	22	1	460	4	0	487
21139	11	455	14	4	0	484
21140	9	15	3	451	0	478
21141	456	4	1	16	0	477
21142	18	3	451	6	0	478
21143	11	441	13	3	0	468
21144	6	13	3	417	0	439
21145	7	437	3	15	0	462
21146	8	15	0	432	0	455
21147	3	4	4	449	0	460
21148	9	4	435	13	0	461
21149	4	4	440	7	0	455
21150	394	2	14	5	0	415
21151	16	1	420	6	0	443
21152	6	4	407	2	0	419
21153	3	3	16	377	0	399
21154	8	2	6	383	0	399
21155	4	381	2	17	0	404
21156	3	421	3	7	0	434
21157	5	11	421	3	0	440
21158	5	6	18	423	0	452
21159	4	1	417	12	0	434
21160	1	1	384	4	0	390
21161	1	372	11	1	0	385
21162	0	4	5	354	0	363
21163	356	3	1	5	0	365
21164	4	2	1	359	0	366
21165	357	0	0	6	0	363
21166	360	1	2	3	0	366
21167	353	0	1	3	0	357
21168	11	2	342	0	0	355
21169	340	1	5	2	0	348
21170	9	0	3	345	0	357
21171	357	1	1	6	0	365
21172	362	1	0	4	0	367
21173	9	347	1	4	0	361
21174	355	3	0	1	0	359
21175	8	2	350	1	0	361
21176	343	1	5	0	0	349
21177	342	1	5	1	0	349
21178	8	343	0	1	0	352
21179	344	4	0	3	0	351
21180	6	3	2	322	0	333
21181	5	2	1	321	0	329
21182	1	316	1	8	0	326
21183	2	5	0	322	0	329
21184	2	3	0	322	0	327
21185	1	1	319	10	0	331
21186	2	1	321	6	0	330
21187	300	1	9	2	0	312
21188	317	0	4	3	0	324
21189	7	1	3	318	0	329
21190	4	0	321	6	0	331
21191	1	324	6	5	0	336
21192	1	5	5	323	0	334
21193	2	3	327	6	0	338
21194	314	2	5	6	0	327
21195	6	1	4	325	0	336
21196	6	335	2	5	0	348
21197	3	4	2	336	0	345
21198	1	4	3	339	0	347
21199	2	4	1	347	0	354
21200	340	2	2	9	0	353
21201	7	0	0	346	0	353
21202	344	1	3	9	0	357
21203	341	1	5	7	0	354
21204	11	2	340	3	0	356
21205	9	337	6	2	0	354
21206	6	6	3	323	0	338
21207	3	362	3	5	0	373
21208	367	6	0	5	0	378
21209	9	3	0	366	0	378
21210	9	1	368	5	0	383
21211	4	1	374	3	0	382
21212	5	4	375	1	0	385
21213	370	0	9	2	0	381
21214	7	375	2	2	0	386
21215	378	6	2	2	0	388
21216	8	379	1	3	0	391
21217	7	6	2	366	0	381
21218	3	4	4	361	0	372
21219	3	377	4	9	0	393
21220	2	6	376	5	0	389
21221	3	374	7	2	0	386
21222	369	6	2	6	0	383
21223	8	5	4	355	0	372
21224	5	2	355	7	0	369
21225	3	2	354	7	0	366
21226	4	2	8	347	0	361
21227	2	4	345	8	0	359
21228	1	1	331	5	0	338
21229	306	4	9	4	0	323
21230	7	305	4	2	0	318
21231	294	4	3	6	0	307
21232	9	3	301	2	0	315
21233	4	282	5	5	0	296
21234	3	301	4	3	0	311
21235	2	6	6	305	0	319
21236	4	4	2	315	0	325
21237	2	3	2	322	0	329
21238	5	2	317	9	0	333
21239	5	1	4	321	0	331
21240	2	1	8	322	0	333
21241	318	4	4	9	0	335
21242	4	311	3	8	0	326
21243	7	5	1	314	0	327
21244	315	4	1	7	0	327
21245	316	1	3	5	0	325
21246	9	3	3	309	0	324
21247	5	2	311	7	0	325
21248	5	2	4	314	0	325
21249	2	4	313	6	0	325
21250	307	4	6	7	0	324
21251	330	4	4	4	0	342
21252	11	2	1	352	0	366
21253	6	0	360	8	0	374
21254	2	376	6	6	0	390
21255	0	4	407	4	0	415
21256	4	4	6	349	0	363
21257	2	369	5	3	0	379
21258	345	4	1	3	0	353
21259	7	1	0	337	0	345
21260	2	345	3	5	0	355
21261	348	4	2	3	0	357
21262	4	2	4	344	0	354
21263	2	345	2	6	0	355
21264	1	6	2	345	0	354
21265	3	2	346	7	0	358
21266	331	1	6	6	0	344
21267	339	3	2	3	0	347
21268	5	2	343	1	0	351
21269	2	340	6	4	0	352
21270	341	8	2	2	0	353
21271	5	3	1	332	0	341
21272	2	2	1	341	0	346
21273	2	3	1	340	0	346
21274	6	1	0	338	0	345
21275	2	1	1	341	0	345
21276	334	4	1	7	0	346
21277	341	2	1	3	0	347
21278	5	1	2	343	0	351
21279	3	1	2	340	0	346
21280	4	0	325	8	0	337
21281	3	0	323	3	0	329
21282	322	2	6	3	0	333
21283	8	1	3	326	0	338
21284	4	2	323	7	0	336
21285	2	2	5	329	0	338
21286	329	0	1	11	0	341
21287	334	1	1	7	0	343
21288	6	1	2	344	0	353
21289	5	0	0	341	0	346
21290	339	1	0	8	0	348
21291	7	1	1	328	0	337
21292	3	333	1	10	0	347
21293	2	4	3	330	0	339
21294	2	3	4	327	0	336
21295	4	0	331	7	0	342
21296	2	0	315	5	0	322
21297	3	324	7	3	0	337
21298	307	4	6	4	0	321
21299	304	2	1	4	0	311
21300	313	1	1	3	0	318
21301	6	297	0	6	0	309
21302	3	299	1	4	0	307
21303	312	4	3	3	0	322
21304	5	301	2	6	0	314
21305	3	5	297	2	0	307
21306	3	288	5	6	0	302
21307	1	1	265	13	0	280
21308	264	3	5	2	0	274
21309	275	2	3	1	0	281
21310	7	276	1	1	0	285
21311	276	5	1	2	0	284
21312	293	2	3	0	0	298
21313	304	2	0	1	0	307
21314	9	1	1	296	0	307
21315	305	3	0	5	0	313
21316	9	1	294	3	0	307
21317	304	3	6	2	0	315
21318	8	2	2	306	0	318
21319	5	1	306	6	0	318
21320	1	3	308	1	0	313
21321	3	0	7	299	0	309
21322	7	1	1	307	0	316
21323	306	1	4	7	0	318
21324	8	1	2	298	0	309
21325	4	1	300	8	0	313
21326	4	1	7	291	0	303
21327	3	314	1	7	0	325
21328	316	5	0	4	0	325
21329	7	1	1	311	0	320
21330	3	1	309	6	0	319
21331	3	305	4	6	0	318
21332	296	5	5	1	0	307
21333	6	1	3	297	0	307
21334	2	2	295	6	0	305
21335	1	291	5	4	0	301
21336	291	4	2	2	0	299
21337	285	0	1	4	0	290
21338	289	2	2	3	0	296
21339	9	1	1	282	0	293
21340	2	1	0	299	0	302
21341	291	1	2	6	0	300
21342	8	295	0	3	0	306
21343	299	4	1	2	0	306
21344	7	1	1	297	0	306
21345	308	1	0	7	0	316
21346	7	1	1	302	0	311
21347	2	1	2	305	0	310
21348	1	1	3	307	0	312
21349	2	3	0	305	0	310
21350	4	0	294	6	0	304
21351	4	1	278	2	0	285
21352	251	0	4	1	0	256
21353	5	0	273	1	0	279
21354	0	0	244	0	0	244
21355	216	0	2	0	0	218
21356	232	0	0	0	0	232
21357	3	0	0	240	0	243
21358	253	0	1	3	0	257
21359	3	259	0	0	0	262
21360	261	3	0	0	0	264
21361	259	0	0	1	0	260
21362	282	0	0	2	0	284
21363	4	1	0	283	0	288
21364	1	284	0	3	0	288
21365	2	290	0	0	0	292
21366	296	6	0	0	0	302
21367	295	0	0	1	0	296
21368	3	0	0	287	0	290
21369	0	1	0	289	0	290
21370	1	287	0	3	0	291
21371	288	3	0	0	0	291
21372	3	0	286	1	0	290
21373	0	0	3	283	0	286
21374	0	0	0	289	0	289
21375	0	0	292	3	0	295
21376	0	0	4	286	0	290
21377	0	249	0	3	0	252
21378	1	2	0	290	0	293
21379	0	0	1	292	0	293
21380	0	271	0	1	0	272
21381	0	296	0	0	0	296
21382	0	2	0	292	0	294
21383	299	0	0	4	0	303
21384	3	1	0	294	0	298
21385	0	1	0	309	0	310
21386	0	303	0	3	0	306
21387	1	2	0	307	0	310
21388	0	0	0	301	0	301
21389	0	0	0	300	0	300
21390	300	1	0	3	0	304
21391	3	1	0	301	0	305
21392	1	0	0	296	0	297
21393	1	0	0	296	0	297
21394	1	0	293	3	0	297
21395	258	0	3	3	0	264
21396	3	287	0	1	0	291
21397	290	3	0	2	0	295
21398	3	0	1	287	0	291
21399	1	0	280	3	0	284
21400	274	0	3	0	0	277
21401	6	0	382	0	0	388
21402	1	0	3	392	0	396
21403	397	0	1	3	0	401
21404	395	0	0	1	0	396
21405	415	0	1	0	0	416
21406	4	0	0	413	0	417
21407	1	0	0	415	0	416
21408	2	0	0	424	0	426
21409	1	404	0	2	0	407
21410	0	391	0	2	0	393
21411	0	401	0	1	0	402
21412	0	424	0	1	0	425
21413	2	1	0	424	0	427
21414	0	1	0	429	0	430
21415	427	0	0	2	0	429
21416	426	0	0	1	0	427
21417	431	0	0	1	0	432
21418	2	0	0	436	0	438
21419	0	0	0	436	0	436
21420	439	0	0	2	0	441
21421	427	0	0	1	0	428
21422	1	0	435	0	0	436
21423	2	0	421	0	0	423
21424	0	1	417	0	0	418
21425	1	0	446	0	0	447
21426	0	0	1	456	0	457
21427	451	0	1	1	0	453
21428	2	440	0	0	0	442
21429	2	1	1	460	0	464
21430	0	0	469	3	0	472
21431	1	482	1	1	0	485
21432	2	1	0	499	0	502
21433	2	0	493	1	0	496
21434	0	0	2	474	0	476
21435	0	0	1	472	0	473
21436	481	0	1	2	0	484
21437	1	1	1	485	0	488
21438	0	2	497	2	0	501
21439	1	1	2	490	0	494
21440	0	565	0	2	0	567
21441	0	2	0	586	0	588
21442	0	0	1	586	0	587
21443	1	1	0	576	0	578
21444	583	0	0	7	0	590
21445	580	0	1	1	0	582
21446	581	0	0	3	0	584
21447	581	0	0	3	0	584
21448	4	0	586	1	0	591
21449	566	1	2	1	0	570
21450	592	0	1	1	0	594
21451	2	0	582	2	0	586
21452	0	1	618	2	0	621
21453	1	1	3	614	0	619
21454	0	624	0	5	0	629
21455	643	2	0	5	0	650
21456	653	1	0	2	0	656
21457	674	0	1	2	0	677
21458	4	0	1	658	0	663
21459	1	693	0	2	0	696
21460	709	1	1	1	0	712
21461	721	0	1	4	0	726
21462	2	0	1	697	0	700
21463	1	0	692	2	0	695
21464	689	0	3	1	0	693
21465	1	0	0	723	0	724
21466	727	1	1	3	0	732
21467	3	0	0	745	0	748
21468	1	7	750	1	0	759
21469	800	0	1	4	0	805
21470	1	0	0	826	0	827
21471	1	1	0	811	0	813
21472	3	1	0	828	0	832
21473	2	1	0	826	0	829
21474	828	0	0	4	0	832
21475	3	1	1	825	0	830
21476	1	833	1	2	0	837
21477	1	1	0	854	0	856
21478	3	863	0	0	0	866
21479	1	4	1	874	0	880
21480	2	0	2	880	0	884
21481	1	879	0	3	0	883
21482	0	2	0	895	0	897
21483	2	0	0	888	0	890
21484	888	0	0	3	0	891
21485	2	0	894	1	0	897
21486	2	0	2	921	0	925
21487	929	0	0	5	0	934
21488	931	1	0	0	0	932
21489	930	0	0	1	0	931
21490	5	1	940	0	0	946
21491	0	0	948	1	0	949
21492	0	0	4	967	0	971
21493	992	1	0	6	0	999
21494	6	0	981	1	0	988
21495	948	0	6	2	0	956
21496	7	1019	0	3	0	1029
21497	0	6	1	1111	0	1118
21498	0	0	0	1169	0	1169
21499	1170	0	0	10	0	1180
21500	8	1	0	1168	0	1177
21501	1097	0	0	8	0	1105
21502	1113	0	1	5	0	1119
21503	7	0	1	1119	0	1127
21504	0	0	0	1132	0	1132
21505	1135	0	0	8	0	1143
21506	7	0	1224	0	0	1231
21507	1200	0	7	7	0	1214
21508	8	1	1290	0	0	1299
21509	1305	0	8	2	0	1315
21510	1374	0	1	9	0	1384
21511	1373	2	0	2	0	1377
21512	1339	0	0	2	0	1341
21513	8	1356	0	1	0	1365
21514	1371	5	1	5	0	1382
21515	1389	0	1	1	0	1391
21516	7	1467	1	3	0	1478
21517	1460	7	0	4	0	1471
21518	9	0	1440	0	0	1449
21519	1422	0	7	2	0	1431
21520	9	5	1434	2	0	1450
21521	3	1	7	1450	0	1461
21522	1	0	1	1470	0	1472
21523	3	1	1456	7	0	1467
21524	3	0	8	1443	0	1454
21525	22	8	30	842	0	902
21526	1484	1	0	9	0	1494
21527	8	0	2	1483	0	1493
21528	0	0	1	1481	0	1482
21529	3	0	0	1492	0	1495
21530	2	1465	2	7	0	1476
21531	2	8	0	1465	0	1475
21532	1460	1	1	11	0	1473
21533	11	0	1494	1	0	1506
21534	3	1	10	1497	0	1511
21535	1	2	1517	16	0	1536
21536	1468	0	12	2	0	1482
21537	14	1	1	1582	0	1598
21538	2	1	2038	15	0	2056
21539	1	0	54	2066	0	2121
21540	4	1	34	2031	0	2070
21541	1	2017	20	94	0	2132
21542	3	54	9	2152	0	2218
21543	2	35	7	2322	0	2366
21544	3	19	2236	120	0	2378
21545	3	10	68	2281	0	2362
21546	3	5	41	2351	0	2400
21547	2223	1	22	129	0	2375
21548	2253	4	10	69	0	2336
21549	103	2228	10	37	0	2378
21550	2293	65	1	28	0	2387
21551	2312	37	6	18	0	2373
21552	125	2277	9	10	0	2421
21553	63	81	1	2273	0	2418
21554	2284	48	3	84	0	2419
21555	2328	21	4	48	0	2401
21556	2307	11	0	32	0	2350
21557	134	2221	7	15	0	2377
21558	82	71	2233	12	0	2398
21559	2269	42	74	12	0	2397
21560	2372	29	39	12	0	2452
21561	131	2304	23	11	0	2469
21562	2381	93	12	13	0	2499
21563	2431	50	6	15	0	2502
21564	145	28	6	2327	0	2506
21565	78	19	2338	94	0	2529
21566	47	8	90	2384	0	2529
21567	39	6	45	2428	0	2518
21568	25	9	26	2455	0	2515
21569	19	11	2252	163	0	2445
21570	28	6	86	2233	0	2353
21571	27	7	45	2355	0	2434
21572	18	13	23	2391	0	2445
21573	18	7	15	2397	0	2437
21574	21	4	7	2391	0	2423
21575	15	2236	7	176	0	2434
21576	13	86	7	2322	0	2428
21577	11	45	10	2380	0	2446
21578	11	27	2232	158	0	2428
21579	14	8	88	2477	0	2587
21580	13	12	47	2529	0	2601
21581	9	7	25	2660	0	2701
21582	12	8	14	2698	0	2732
21583	2558	8	8	202	0	2776
21584	98	4	9	2675	0	2786
21585	56	9	7	2703	0	2775
21586	36	5	2516	186	0	2743
21587	22	2416	87	133	0	2658
21588	17	2581	56	77	0	2731
21589	2494	139	40	45	0	2718
21590	94	2562	17	50	0	2723
21591	60	122	10	2502	0	2694
21592	2469	73	9	130	0	2681
21593	102	34	2439	100	0	2675
21594	68	17	94	2475	0	2654
21595	40	2448	58	121	0	2667
21596	23	99	34	2426	0	2582
21597	19	2421	15	134	0	2589
21598	11	127	14	2395	0	2547
21599	2346	67	10	140	0	2563
21600	112	39	2375	91	0	2617
21601	63	28	96	2313	0	2500
21602	44	2337	57	123	0	2561
21603	2334	101	34	85	0	2554
21604	106	62	2297	64	0	2529
21605	68	43	104	2290	0	2505
21606	44	20	2226	126	0	2416
21607	31	17	123	2221	0	2392
21608	23	20	2169	144	0	2356
21609	21	11	131	2122	0	2285
21610	21	21	70	2156	0	2268
21611	2037	14	41	175	0	2267
21612	2112	12	22	116	0	2262
21613	160	16	17	2004	0	2197
21614	95	1986	21	124	0	2226
21615	50	101	11	2059	0	2221
21616	31	55	19	2051	0	2156
21617	1900	38	17	189	0	2144
21618	106	1907	15	127	0	2155
21619	1948	105	14	72	0	2139
21620	1999	67	10	51	0	2127
21621	151	1853	14	44	0	2062
21622	100	1982	6	37	0	2125
21623	1941	149	17	40	0	2147
21624	117	81	1880	57	0	2135
21625	1943	46	103	48	0	2140
21626	1983	28	63	51	0	2125
21627	175	1869	46	36	0	2126
21628	109	103	20	1706	0	1938
21629	51	1914	23	126	0	2114
21630	1862	128	23	73	0	2086
21631	1950	68	17	63	0	2098
21632	166	54	16	1846	0	2082
21633	110	27	14	1927	0	2078
21634	1813	28	14	170	0	2025
21635	112	1785	14	116	0	2027
21636	88	1792	8	83	0	1971
21637	56	1839	15	47	0	1957
21638	26	1245	8	30	0	1309
21639	20	1268	16	21	0	1325
21640	21	94	3	1182	0	1300
21641	16	45	1147	60	0	1268
21642	18	1120	42	47	0	1227
21643	972	41	14	24	0	1051
21644	48	24	19	965	0	1056
21645	963	20	5	46	0	1034
21646	47	958	10	28	0	1043
21647	988	39	2	25	0	1054
21648	47	982	20	9	0	1058
21649	32	42	11	973	0	1058
21650	974	26	16	41	0	1057
21651	991	16	11	33	0	1051
21652	48	9	16	975	0	1048
21653	36	11	6	969	0	1022
21654	20	953	10	54	0	1037
21655	23	29	2	974	0	1028
21656	25	23	8	971	0	1027
21657	18	24	4	969	0	1015
21658	17	902	1	67	0	987
21659	818	30	3	38	0	889
21660	28	830	1	26	0	885
21661	801	28	2	17	0	848
21662	32	807	1	12	0	852
21663	27	35	784	12	0	858
21664	25	20	20	772	0	837
21665	19	24	751	21	0	815
21666	10	19	754	15	0	798
21667	18	13	29	734	0	794
21668	15	9	750	22	0	796
21669	21	8	29	736	0	794
21670	21	7	19	739	0	786
21671	16	14	10	757	0	797
21672	735	9	9	46	0	799
21673	29	17	2	752	0	800
21674	30	8	2	757	0	797
21675	741	9	2	38	0	790
21676	32	707	0	37	0	776
21677	21	696	0	25	0	742
21678	24	714	1	15	0	754
21679	8	46	0	501	0	555
21680	14	11	504	19	0	548
21681	374	9	18	8	0	409
21682	14	385	1	8	0	408
21683	327	13	3	5	0	348
21684	331	3	8	5	0	347
21685	320	7	2	4	0	333
21686	18	3	312	2	0	335
21687	8	4	9	318	0	339
21688	7	3	3	327	0	340
21689	8	2	3	328	0	341
21690	5	1	3	322	0	331
21691	2	318	5	10	0	335
21692	316	10	0	9	0	335
21693	11	5	305	4	0	325
21694	289	2	13	6	0	310
21695	15	9	1	279	0	304
21696	4	275	2	9	0	290
21697	9	288	0	4	0	301
21698	4	15	5	269	0	293
21699	3	271	1	9	0	284
21700	235	7	0	1	0	243
21701	5	1	227	2	0	235
21702	0	1	5	222	0	228
21703	2	0	1	228	0	231
21704	1	0	1	232	0	234
21705	2	1	0	232	0	235
21706	228	0	0	6	0	234
21707	5	220	0	2	0	227
21708	254	5	0	2	0	261
21709	5	0	1	259	0	265
21710	0	1	0	288	0	289
21711	1	292	0	7	0	300
21712	305	8	0	2	0	315
21713	322	0	0	3	0	325
21714	8	319	0	0	0	327
21715	4	9	0	310	0	323
21716	2	320	1	6	0	329
21717	316	10	0	0	0	326
21718	9	0	311	1	0	321
21719	0	1	316	0	0	317
21720	294	0	7	0	0	301
21721	5	301	1	0	0	307
21722	1	8	1	301	0	311
21723	1	0	0	306	0	307
21724	0	1	303	8	0	312
21725	0	0	7	301	0	308
21726	1	0	0	309	0	310
21727	0	297	1	8	0	306
21728	0	8	1	302	0	311
21729	0	0	0	313	0	313
21730	303	1	1	8	0	313
21731	8	302	1	1	0	312
21732	0	312	0	1	0	313
21733	1	8	1	309	0	319
21734	0	1	0	319	0	320
21735	0	1	0	316	0	317
21736	0	307	0	10	0	317
21737	2	7	0	300	0	309
21738	0	1	0	312	0	313
21739	0	0	0	316	0	316
21740	2	1	0	315	0	318
21741	1	292	0	16	0	309
21742	0	319	1	1	0	321
21743	306	9	1	1	0	317
21744	324	0	0	1	0	325
21745	8	2	1	315	0	326
21746	2	0	333	11	0	346
21747	2	1	9	327	0	339
21748	1	1	1	324	0	327
21749	323	0	1	10	0	334
21750	8	336	0	2	0	346
21751	0	11	1	340	0	352
21752	1	0	0	353	0	354
21753	0	2	341	11	0	354
21754	2	0	348	1	0	351
21755	0	0	10	351	0	361
21756	0	3	2	353	0	358
21757	2	339	1	10	0	352
21758	0	358	1	2	0	361
21759	347	8	0	2	0	357
21760	9	2	0	351	0	362
21761	0	1	355	10	0	366
21762	1	347	5	2	0	355
21763	0	5	0	357	0	362
21764	353	1	1	6	0	361
21765	5	1	0	347	0	353
21766	343	1	0	11	0	355
21767	6	356	0	0	0	362
21768	349	6	0	2	0	357
21769	7	1	0	354	0	362
21770	2	2	373	6	0	383
21771	1	1	6	373	0	381
21772	1	386	0	8	0	395
21773	2	8	1	387	0	398
21774	0	404	0	10	0	414
21775	0	7	1	421	0	429
21776	0	0	413	10	0	423
21777	1	1	398	3	0	403
21778	1	1	416	2	0	420
21779	400	1	8	2	0	411
21780	7	407	1	1	0	416
21781	2	423	2	1	0	428
21782	410	8	2	1	0	421
21783	418	2	2	0	0	422
21784	7	2	0	415	0	424
21785	1	1	414	7	0	423
21786	4	3	399	0	0	406
21787	1	2	8	402	0	413
21788	410	0	2	9	0	421
21789	7	400	2	3	0	412
21790	0	8	2	406	0	416
21791	402	0	1	9	0	412
21792	407	1	0	3	0	411
21793	8	2	399	3	0	412
21794	369	0	8	3	0	380
21795	10	1	397	2	0	410
21796	2	3	394	0	0	399
21797	2	0	8	383	0	393
21798	1	1	2	385	0	389
21799	0	1	3	388	0	392
21800	0	1	381	9	0	391
21801	370	2	7	2	0	381
21802	7	0	1	394	0	402
21803	380	0	1	9	0	390
21804	384	2	1	2	0	389
21805	8	384	1	2	0	395
21806	2	398	1	3	0	404
21807	3	408	2	1	0	414
21808	1	8	0	376	0	385
21809	0	2	369	13	0	384
21810	0	13	9	353	0	375
21811	1	362	0	6	0	369
21812	2	363	0	1	0	366
21813	0	6	1	350	0	357
21814	341	0	1	7	0	349
21815	7	342	1	0	0	350
21816	0	341	0	3	0	344
21817	348	6	0	1	0	355
21818	6	2	0	348	0	356
21819	0	1	0	350	0	351
21820	1	1	1	349	0	352
21821	340	0	0	7	0	347
21822	343	1	2	1	0	347
21823	9	1	0	340	0	350
21824	0	1	328	8	0	337
21825	327	1	7	0	0	335
21826	7	1	0	329	0	337
21827	1	1	323	8	0	333
21828	1	1	328	1	0	331
21829	1	1	7	324	0	333
21830	2	0	333	9	0	344
21831	0	0	8	362	0	370
21832	3	1	1	362	0	367
21833	2	1	0	390	0	393
21834	376	2	1	10	0	389
21835	7	2	1	374	0	384
21836	2	2	0	381	0	385
21837	1	1	2	390	0	394
21838	3	1	3	389	0	396
21839	1	0	367	12	0	380
21840	1	368	9	5	0	383
21841	1	11	2	363	0	377
21842	2	3	0	356	0	361
21843	2	346	3	8	0	359
21844	2	360	1	2	0	365
21845	353	8	0	5	0	366
21846	8	329	2	10	0	349
21847	1	8	2	323	0	334
21848	0	2	339	12	0	353
21849	330	0	9	2	0	341
21850	8	3	315	1	0	327
21851	311	1	7	6	0	325
21852	315	0	4	2	0	321
21853	11	1	315	4	0	331
21854	1	2	12	298	0	313
21855	2	322	0	10	0	334
21856	3	8	1	328	0	340
21857	350	1	3	13	0	367
21858	360	0	0	7	0	367
21859	9	359	0	4	0	372
21860	365	10	0	7	0	382
21861	11	0	4	350	0	365
21862	352	4	1	10	0	367
21863	369	4	2	2	0	377
21864	13	2	1	364	0	380
21865	358	1	0	14	0	373
21866	357	4	2	1	0	364
21867	12	3	356	2	0	373
21868	352	5	9	2	0	368
21869	14	2	350	3	0	369
21870	3	3	327	2	0	335
21871	5	323	9	1	0	338
21872	5	8	2	307	0	322
21873	4	0	319	9	0	332
21874	5	1	291	6	0	303
21875	292	4	8	0	0	304
21876	10	2	2	294	0	308
21877	3	1	2	312	0	318
21878	2	1	3	314	0	320
21879	4	3	1	312	0	320
21880	3	3	2	314	0	322
21881	4	2	302	11	0	319
21882	3	2	310	4	0	319
21883	4	1	9	309	0	323
21884	307	2	1	12	0	322
21885	12	301	2	3	0	318
21886	5	7	2	303	0	317
21887	304	1	2	15	0	322
21888	13	302	3	5	0	323
21889	2	9	1	313	0	325
21890	4	0	3	321	0	328
21891	4	1	3	321	0	329
21892	308	2	4	13	0	327
21893	9	2	310	4	0	325
21894	304	2	11	3	0	320
21895	9	2	2	313	0	326
21896	3	1	3	310	0	317
21897	2	301	6	10	0	319
21898	5	8	291	5	0	309
21899	296	2	10	7	0	315
21900	304	1	0	16	0	321
21901	9	2	306	7	0	324
21902	288	0	12	7	0	307
21903	12	309	2	5	0	328
21904	2	307	3	5	0	317
21905	3	308	3	4	0	318
21906	290	14	2	3	0	309
21907	10	1	296	4	0	311
21908	2	11	8	262	0	283
21909	4	275	1	6	0	286
21910	2	259	3	4	0	268
21911	3	259	1	2	0	265
21912	10	7	0	212	0	229
21913	239	3	1	8	0	251
21914	7	238	0	3	0	248
21915	4	6	0	241	0	251
21916	1	1	3	246	0	251
21917	239	0	0	6	0	245
21918	6	2	1	239	0	248
21919	0	1	1	247	0	249
21920	1	3	251	7	0	262
21921	1	1	7	252	0	261
21922	3	0	2	256	0	261
21923	252	1	1	7	0	261
21924	254	0	2	2	0	258
21925	6	1	0	251	0	258
21926	244	1	1	7	0	253
21927	257	1	0	1	0	259
21928	7	253	0	2	0	262
21929	1	6	247	2	0	256
21930	1	238	6	1	0	246
21931	14	11	3	198	0	226
21932	184	2	3	2	0	191
21933	3	183	0	0	0	186
21934	1	2	0	190	0	193
21935	185	0	1	1	0	187
21936	189	0	0	1	0	190
21937	2	2	0	186	0	190
21938	0	1	198	2	0	201
21939	0	2	2	200	0	204
21940	0	0	0	208	0	208
21941	2	0	198	2	0	202
21942	0	2	2	202	0	206
21943	0	0	0	207	0	207
21944	214	0	0	3	0	217
21945	3	0	0	209	0	212
21946	0	0	0	215	0	215
21947	219	0	1	3	0	223
21948	205	0	1	1	0	207
21949	208	0	0	1	0	209
21950	3	0	204	1	0	208
21951	1	0	3	203	0	207
21952	1	204	0	3	0	208
21953	1	2	0	208	0	211
21954	1	3	205	4	0	213
21955	1	0	3	187	0	191
21956	1	1	201	3	0	206
21957	171	0	2	0	0	173
21958	175	0	0	0	0	175
21959	2	0	0	177	0	179
21960	0	0	0	180	0	180
21961	0	0	0	178	0	178
21962	0	181	1	1	0	183
21963	178	2	0	0	0	180
21964	180	0	0	0	0	180
21965	2	0	1	176	0	179
21966	0	0	0	171	0	171
21967	0	0	0	174	0	174
21968	0	0	0	176	0	176
21969	0	0	173	2	0	175
21970	0	0	2	173	0	175
21971	177	0	0	2	0	179
21972	176	0	0	0	0	176
21973	2	0	0	173	0	175
21974	0	0	173	2	0	175
21975	169	0	2	0	0	171
21976	3	0	0	175	0	178
21977	0	167	0	3	0	170
21978	0	178	0	0	0	178
21979	180	3	0	0	0	183
21980	3	0	0	181	0	184
21981	0	1	0	187	0	188
21982	1	0	0	190	0	191
21983	0	0	0	190	0	190
21984	0	0	0	216	0	216
21985	0	0	213	6	0	219
21986	0	0	205	0	0	205
21987	0	0	209	1	0	210
21988	0	0	6	205	0	211
21989	0	0	207	5	0	212
21990	0	0	7	205	0	212
21991	0	0	0	209	0	209
21992	0	0	1	216	0	217
21993	218	0	1	9	0	228
21994	6	0	1	222	0	229
21995	0	0	2	229	0	231
21996	226	0	0	8	0	234
21997	7	226	3	1	0	237
21998	0	236	0	6	0	242
21999	244	6	3	1	0	254
22000	7	249	0	3	0	259
22001	234	6	1	3	0	244
22002	245	2	0	2	0	249
22003	243	2	0	2	0	247
22004	245	1	0	2	0	248
22005	252	0	0	3	0	255
22006	9	243	0	2	0	254
22007	240	7	0	2	0	249
22008	242	2	0	1	0	245
22009	8	242	0	1	0	251
22010	246	9	1	0	0	256
22011	261	0	1	0	0	262
22012	282	1	1	0	0	284
22013	312	1	0	1	0	314
22014	13	0	348	0	0	361
22015	6	1	8	372	0	387
22016	5	2	1	383	0	391
22017	4	1	375	12	0	392
22018	5	1	372	2	0	380
22019	372	1	12	4	0	389
22020	15	0	2	379	0	396
22021	5	1	385	11	0	402
22022	5	1	389	0	0	395
22023	377	2	13	1	0	393
22024	395	0	4	3	0	402
22025	390	1	4	2	0	397
22026	13	1	382	3	0	399
22027	7	0	12	383	0	402
22028	5	0	387	14	0	406
22029	389	0	13	2	0	404
22030	13	0	391	4	0	408
22031	2	1	15	378	0	396
22032	4	0	5	386	0	395
22033	5	395	2	13	0	415
22034	392	13	5	2	0	412
22035	16	1	392	4	0	413
22036	392	1	14	2	0	409
22037	16	2	401	3	0	422
22038	7	0	16	384	0	407
22039	4	0	6	397	0	407
22040	3	0	5	397	0	405
22041	386	0	4	15	0	405
22042	14	1	2	385	0	402
22043	3	1	3	395	0	402
22044	5	373	0	16	0	394
22045	2	12	4	381	0	399
22046	380	1	1	14	0	396
22047	13	1	374	2	0	390
22048	5	2	11	360	0	378
22049	4	1	360	14	0	379
22050	4	354	12	5	0	375
22051	3	9	354	5	0	371
22052	359	2	12	9	0	382
22053	374	1	4	4	0	383
22054	11	4	4	359	0	378
22055	357	0	3	17	0	377
22056	364	1	2	6	0	373
22057	11	0	3	357	0	371
22058	5	1	4	365	0	375
22059	7	1	359	14	0	381
22060	7	360	12	5	0	384
22061	352	11	6	6	0	375
22062	14	342	6	10	0	372
22063	6	12	6	351	0	375
22064	5	2	3	356	0	366
22065	10	1	2	362	0	375
22066	8	1	3	364	0	376
22067	3	1	348	22	0	374
22068	338	0	13	11	0	362
22069	357	1	5	6	0	369
22070	14	2	5	350	0	371
22071	346	0	7	16	0	369
22072	17	4	4	347	0	372
22073	8	1	344	15	0	368
22074	4	2	14	342	0	362
22075	8	330	4	13	0	355
22076	2	8	6	337	0	353
22077	5	330	8	12	0	355
22078	6	9	5	308	0	328
22079	8	324	1	11	0	344
22080	319	10	4	10	0	343
22081	18	4	312	7	0	341
22082	5	306	14	9	0	334
22083	4	316	3	9	0	332
22084	4	11	6	288	0	309
22085	4	3	2	295	0	304
22086	4	2	6	285	0	297
22087	4	4	1	296	0	305
22088	5	284	4	12	0	305
22089	1	11	5	288	0	305
22090	6	2	3	293	0	304
22091	280	1	5	17	0	303
22092	14	3	2	285	0	304
22093	4	0	276	13	0	293
22094	3	2	273	7	0	285
22095	270	0	9	6	0	285
22096	10	264	2	7	0	283
22097	6	265	2	6	0	279
22098	5	11	5	252	0	273
22099	3	3	3	256	0	265
22100	3	5	240	12	0	260
22101	237	6	9	3	0	255
22102	246	2	2	7	0	257
22103	9	1	247	6	0	263
22104	3	2	248	6	0	259
22105	242	1	11	5	0	259
22106	253	2	2	4	0	261
22107	249	1	4	3	0	257
22108	254	1	2	2	0	259
22109	12	243	0	5	0	260
22110	240	7	1	6	0	254
22111	10	2	226	8	0	246
22112	2	1	201	4	0	208
22113	1	0	183	3	0	187
22114	3	11	10	112	0	136
22115	106	0	0	2	0	108
22116	108	0	0	1	0	109
22117	3	0	0	107	0	110
22118	0	0	0	116	0	116
22119	0	0	1	115	0	116
22120	0	112	1	2	0	115
22121	116	2	0	1	0	119
22122	117	0	0	1	0	118
22123	118	1	0	1	0	120
22124	121	0	0	1	0	122
22125	121	0	0	1	0	122
22126	2	0	1	117	0	120
22127	0	117	0	2	0	119
22128	0	2	0	111	0	113
22129	0	0	1	112	0	113
22130	113	0	1	3	0	117
22131	3	0	118	0	0	121
22132	1	0	109	0	0	110
22133	0	0	105	0	0	105
22134	104	0	2	0	0	106
22135	104	0	2	0	0	106
22136	2	0	0	109	0	111
22137	0	0	0	119	0	119
22138	0	0	0	121	0	121
22139	0	0	119	3	0	122
22140	0	0	3	113	0	116
22141	0	0	122	3	0	125
22142	0	0	3	123	0	126
22143	0	0	0	126	0	126
22144	0	0	0	134	0	134
22145	133	0	0	3	0	136
22146	134	0	0	0	0	134
22147	3	0	132	0	0	135
22148	128	0	3	0	0	131
22149	135	0	0	0	0	135
22150	3	0	0	131	0	134
22151	137	0	0	2	0	139
22152	3	0	0	133	0	136
22153	0	0	0	136	0	136
22154	0	0	132	3	0	135
22155	127	0	3	0	0	130
22156	3	0	0	133	0	136
22157	0	0	149	3	0	152
22158	0	0	171	0	0	171
22159	0	1	3	157	0	161
22160	0	0	0	159	0	159
22161	158	0	0	3	0	161
22162	3	0	0	156	0	159
22163	0	0	0	163	0	163
22164	0	0	0	165	0	165
22165	0	0	0	171	0	171
22166	171	0	1	3	0	175
22167	178	0	0	1	0	179
22168	189	0	1	0	0	190
22169	191	0	0	2	0	193
22170	3	0	0	192	0	195
22171	192	0	0	4	0	196
22172	4	0	0	193	0	197
22173	195	0	0	3	0	198
22174	3	0	1	194	0	198
22175	1	0	0	195	0	196
22176	1	200	0	3	0	204
22177	1	3	0	208	0	212
22178	208	0	0	3	0	211
22179	204	0	0	1	0	205
22180	3	1	207	0	0	211
22181	0	208	4	0	0	212
22182	208	3	0	0	0	211
22183	2	216	0	1	0	219
22184	210	2	0	1	0	213
22185	2	226	1	0	0	229
22186	0	2	234	1	0	237
22187	0	239	2	0	0	241
22188	1	241	0	0	0	242
22189	0	2	0	243	0	245
22190	255	0	0	6	0	261
22191	2	0	0	261	0	263
22192	0	0	0	260	0	260
22193	259	0	0	3	0	262
22194	264	0	0	0	0	264
22195	3	0	0	268	0	271
22196	1	0	0	264	0	265
22197	0	0	0	272	0	272
22198	274	0	0	2	0	276
22199	2	0	270	1	0	273
22200	1	0	2	268	0	271
22201	0	0	286	3	0	289
22202	0	284	2	0	0	286
22203	0	3	274	0	0	277
22204	0	0	2	268	0	270
22205	1	0	274	2	0	277
22206	265	0	2	0	0	267
22207	2	0	1	284	0	287
22208	0	294	0	2	0	296
22209	2	2	0	296	0	300
22210	0	296	0	2	0	298
22211	1	300	0	0	0	301
22212	0	289	0	0	0	289
22213	0	2	1	277	0	280
22214	0	281	0	2	0	283
22215	280	2	0	0	0	282
22216	1	1	272	1	0	275
22217	1	1	265	0	0	267
22218	0	0	274	0	0	274
22219	0	0	1	280	0	281
22220	1	0	0	270	0	271
22221	0	0	0	269	0	269
22222	0	0	0	266	0	266
22223	0	0	0	252	0	252
22224	0	269	0	2	0	271
22225	1	1	269	0	0	271
22226	0	0	273	0	0	273
22227	0	284	1	1	0	286
22228	1	1	1	287	0	290
22229	0	0	0	286	0	286
22230	2	0	1	285	0	288
22231	282	0	0	3	0	285
22232	2	0	285	0	0	287
22233	280	0	1	1	0	282
22234	292	1	0	2	0	295
22235	1	292	0	1	0	294
22236	0	291	0	2	0	293
22237	289	0	0	1	0	290
22238	2	0	0	293	0	295
22239	0	0	2	313	0	315
22240	1	1	319	4	0	325
22241	3	1	305	3	0	312
22242	0	1	3	319	0	323
22243	326	1	0	5	0	332
22244	6	1	327	0	0	334
22245	336	0	7	1	0	344
22246	6	1	0	353	0	360
22247	0	1	1	381	0	383
22248	0	0	1	400	0	401
22249	1	0	395	8	0	404
22250	2	387	5	2	0	396
22251	0	407	1	3	0	411
22252	404	7	2	2	0	415
22253	409	1	0	7	0	417
22254	7	1	1	406	0	415
22255	418	1	0	9	0	428
22256	8	1	412	1	0	422
22257	3	0	396	1	0	400
22258	3	1	8	371	0	383
22259	388	0	2	9	0	399
22260	9	0	2	389	0	400
22261	1	0	2	403	0	406
22262	402	1	2	8	0	413
22263	410	1	1	4	0	416
22264	10	436	2	1	0	449
22265	456	8	0	3	0	467
22266	12	1	0	439	0	452
22267	3	438	0	7	0	448
22268	434	8	1	4	0	447
22269	8	432	1	2	0	443
22270	4	10	0	436	0	450
22271	437	2	1	10	0	450
22272	10	3	431	3	0	447
22273	3	1	437	3	0	444
22274	2	2	10	420	0	434
22275	3	0	2	438	0	443
22276	2	2	1	429	0	434
22277	1	432	2	11	0	446
22278	438	10	1	5	0	454
22279	435	2	1	2	0	440
22280	445	1	1	2	0	449
22281	12	460	0	4	0	476
22282	4	11	1	497	0	513
22283	4	1	1	494	0	500
22284	1	2	1	500	0	504
22285	462	0	1	13	0	476
22286	10	454	0	5	0	469
22287	3	9	1	461	0	474
22288	3	2	0	467	0	472
22289	0	3	441	15	0	459
22290	2	434	7	7	0	450
22291	1	10	2	439	0	452
22292	3	1	1	444	0	449
22293	2	3	0	444	0	449
22294	425	4	1	14	0	444
22295	12	425	0	5	0	442
22296	426	10	1	8	0	445
22297	13	6	1	429	0	449
22298	429	3	1	11	0	444
22299	13	3	426	6	0	448
22300	421	3	10	7	0	441
22301	437	0	2	4	0	443
22302	13	3	434	3	0	453
22303	6	2	13	433	0	454
22304	6	3	3	433	0	445
22305	448	0	1	20	0	469
22306	12	0	3	449	0	464
22307	4	5	4	448	0	461
22308	10	0	1	452	0	463
22309	5	2	433	16	0	456
22310	411	1	11	8	0	431
22311	13	438	3	6	0	460
22312	5	12	2	436	0	455
22313	5	436	2	17	0	460
22314	2	457	3	8	0	470
22315	5	10	2	454	0	471
22316	0	9	449	15	0	473
22317	5	2	440	10	0	457
22318	4	4	11	447	0	466
22319	2	4	446	15	0	467
22320	447	3	11	7	0	468
22321	11	7	5	455	0	478
22322	4	2	4	458	0	468
22323	3	451	3	21	0	478
22324	6	10	8	454	0	478
22325	3	10	5	451	0	469
22326	5	445	2	17	0	469
22327	4	16	1	452	0	473
22328	4	7	2	455	0	468
22329	3	449	5	20	0	477
22330	454	14	2	11	0	481
22331	20	6	445	5	0	476
22332	5	1	449	11	0	466
22333	4	8	12	439	0	463
22334	4	6	5	447	0	462
22335	6	2	434	20	0	462
22336	3	2	433	14	0	452
22337	400	6	16	7	0	429
22338	15	437	6	7	0	465
22339	418	10	6	9	0	443
22340	14	5	410	7	0	436
22341	4	414	11	5	0	434
22342	5	11	13	424	0	453
22343	1	9	437	11	0	458
22344	5	4	421	7	0	437
22345	7	5	17	429	0	458
22346	6	4	443	13	0	466
22347	1	422	14	9	0	446
22348	5	11	5	420	0	441
22349	2	6	439	13	0	460
22350	5	448	15	8	0	476
22351	439	12	10	5	0	466
22352	12	7	443	6	0	468
22353	10	446	10	4	0	470
22354	8	12	9	440	0	469
22355	1	6	0	461	0	468
22356	444	3	3	20	0	470
22357	11	1	4	443	0	459
22358	6	2	2	457	0	467
22359	444	4	3	19	0	470
22360	14	0	2	446	0	462
22361	5	2	435	14	0	456
22362	2	1	11	435	0	449
22363	3	3	446	16	0	468
22364	2	3	405	6	0	416
22365	1	0	405	4	0	410
22366	1	1	14	383	0	399
22367	0	1	7	415	0	423
22368	407	0	2	13	0	422
22369	7	1	2	392	0	402
22370	6	413	2	8	0	429
22371	0	8	2	434	0	444
22372	0	3	3	429	0	435
22373	2	426	0	15	0	443
22374	427	8	0	6	0	441
22375	431	5	2	4	0	442
22376	11	424	1	3	0	439
22377	5	430	1	1	0	437
22378	9	13	6	414	0	442
22379	429	3	2	10	0	444
22380	9	1	434	6	0	450
22381	5	2	399	2	0	408
22382	354	2	12	2	0	370
22383	8	380	4	1	0	393
22384	5	8	1	374	0	388
22385	1	4	1	382	0	388
22386	1	0	3	387	0	391
22387	1	2	0	405	0	408
22388	0	388	0	14	0	402
22389	0	5	2	400	0	407
22390	396	6	0	9	0	411
22391	10	0	0	398	0	408
22392	4	0	2	408	0	414
22393	404	3	0	13	0	420
22394	408	0	0	7	0	415
22395	417	0	0	2	0	419
22396	419	0	0	1	0	420
22397	12	0	0	403	0	415
22398	408	0	0	10	0	418
22399	11	0	0	405	0	416
22400	406	0	0	10	0	416
22401	399	0	2	4	0	405
22402	11	0	0	393	0	404
22403	6	0	393	8	0	407
22404	383	1	10	5	0	399
22405	402	0	7	0	0	409
22406	403	0	0	2	0	405
22407	393	0	1	3	0	397
22408	14	1	1	415	0	431
22409	5	0	426	11	0	442
22410	1	1	440	4	0	446
22411	415	2	12	1	0	430
22412	441	0	4	2	0	447
22413	12	438	2	1	0	453
22414	5	448	0	0	0	453
22415	448	12	0	5	0	465
22416	8	6	2	445	0	461
22417	5	3	0	450	0	458
22418	442	0	0	15	0	457
22419	9	439	1	6	0	455
22420	447	9	1	0	0	457
22421	9	3	444	3	0	459
22422	446	0	10	1	0	457
22423	9	2	4	449	0	464
22424	3	0	467	10	0	480
22425	1	470	10	5	0	486
22426	1	8	4	478	0	491
22427	1	3	518	11	0	533
22428	1	2	8	514	0	525
22429	523	0	5	10	0	538
22430	9	0	514	8	0	531
22431	496	2	9	2	0	509
22432	9	527	4	3	0	543
22433	5	8	1	539	0	553
22434	1	6	556	11	0	574
22435	1	0	7	557	0	565
22436	3	0	576	9	0	588
22437	1	565	7	7	0	580
22438	550	7	4	0	0	561
22439	6	559	1	5	0	571
22440	7	8	0	550	0	565
22441	2	6	1	555	0	564
22442	0	0	540	14	0	554
22443	440	1	6	6	0	453
22444	6	501	5	1	0	513
22445	3	475	1	1	0	480
22446	0	483	1	0	0	484
22447	2	3	5	454	0	464
22448	1	456	0	0	0	457
22449	1	1	0	440	0	442
22450	1	437	0	2	0	440
22451	0	1	1	432	0	434
22452	1	444	1	1	0	447
22453	439	2	1	2	0	444
22454	3	3	427	0	0	433
22455	424	1	3	0	0	428
22456	423	1	2	1	0	427
22457	444	2	0	0	0	446
22458	4	454	0	1	0	459
22459	460	2	0	1	0	463
22460	456	1	0	2	0	459
22461	466	1	0	0	0	467
22462	4	1	452	0	0	457
22463	4	0	2	442	0	448
22464	1	0	478	1	0	480
22465	3	0	1	471	0	475
22466	468	0	2	2	0	472
22467	1	458	1	4	0	464
22468	3	3	496	0	0	502
22469	1	2	1	500	0	504
22470	1	0	3	549	0	553
22471	0	0	627	10	0	637
22472	612	0	8	4	0	624
22473	636	0	3	1	0	640
22474	650	0	0	1	0	651
22475	13	0	0	649	0	662
22476	3	641	0	12	0	656
22477	1	671	1	2	0	675
22478	0	15	0	670	0	685
22479	2	3	0	661	0	666
22480	0	655	1	13	0	669
22481	661	12	0	3	0	676
22482	12	655	1	1	0	669
22483	4	12	0	651	0	667
22484	2	2	648	12	0	664
22485	1	2	12	646	0	661
22486	643	1	2	13	0	659
22487	12	1	644	3	0	660
22488	635	1	11	2	0	649
22489	660	1	2	1	0	664
22490	662	0	1	1	0	664
22491	679	2	0	0	0	681
22492	683	0	0	2	0	685
22493	15	1	660	0	0	676
22494	3	0	676	2	0	681
22495	721	0	15	2	0	738
22496	759	0	4	2	0	765
22497	18	0	1	776	0	795
22498	6	794	1	14	0	815
22499	5	16	0	804	0	825
22500	836	2	0	20	0	858
22501	18	2	0	814	0	834
22502	3	864	1	18	0	886
22503	866	15	0	0	0	881
22504	851	2	1	3	0	857
22505	851	3	1	1	0	856
22506	20	851	0	1	0	872
22507	6	16	0	843	0	865
22508	4	3	0	825	0	832
22509	2	798	0	17	0	817
22510	6	14	0	809	0	829
22511	799	3	0	24	0	826
22512	814	4	0	6	0	824
22513	18	800	0	4	0	822
22514	10	15	0	797	0	822
22515	10	2	1	800	0	813
22516	2	5	0	811	0	818
22517	783	5	2	24	0	814
22518	20	3	779	7	0	809
22519	766	1	16	9	0	792
22520	27	2	793	1	0	823
22521	8	6	19	766	0	799
22522	7	774	2	23	0	806
22523	2	820	5	10	0	837
22524	775	23	0	9	0	807
22525	786	6	0	11	0	803
22526	23	775	0	9	0	807
22527	11	760	0	6	0	777
22528	760	20	3	3	0	786
22529	784	5	3	8	0	800
22530	23	800	2	11	0	836
22531	805	19	4	6	0	834
22532	30	2	796	5	0	833
22533	785	7	19	4	0	815
22534	805	7	3	1	0	816
22535	21	2	7	780	0	810
22536	11	768	3	25	0	807
22537	8	24	2	777	0	811
22538	791	12	1	21	0	825
22539	30	5	0	769	0	804
22540	12	4	1	793	0	810
22541	8	6	792	23	0	829
22542	5	10	18	804	0	837
22543	8	2	3	815	0	828
22544	814	1	4	22	0	841
22545	21	7	810	8	0	846
22546	819	4	18	9	0	850
22547	28	3	7	813	0	851
22548	15	2	6	832	0	855
22549	16	3	2	822	0	843
22550	5	801	0	29	0	835
22551	3	823	4	13	0	843
22552	5	19	2	811	0	837
22553	810	9	0	20	0	839
22554	817	4	2	11	0	834
22555	24	7	2	802	0	835
22556	808	3	6	20	0	837
22557	28	3	4	796	0	831
22558	8	4	1	818	0	831
22559	781	5	1	23	0	810
22560	23	789	7	10	0	829
22561	797	20	4	4	0	825
22562	801	4	2	11	0	818
22563	790	7	1	11	0	809
22564	22	755	4	13	0	794
22565	10	25	1	756	0	792
22566	7	15	2	770	0	794
22567	3	9	746	28	0	786
22568	11	21	14	703	0	749
22569	15	1	699	23	0	738
22570	7	649	16	9	0	681
22571	9	563	1	12	0	585
22572	7	556	3	10	0	576
22573	7	11	3	568	0	589
22574	14	4	1	562	0	581
22575	4	8	0	547	0	559
22576	6	3	0	554	0	563
22577	7	2	537	13	0	559
22578	9	2	675	7	0	693
22579	7	8	10	709	0	734
22580	2	4	731	21	0	758
22581	726	2	10	11	0	749
22582	738	2	7	7	0	754
22583	14	3	731	11	0	759
22584	10	0	15	729	0	754
22585	8	6	6	734	0	754
22586	8	6	3	744	0	761
22587	9	6	3	732	0	750
22588	7	4	5	742	0	758
22589	558	8	0	27	0	593
22590	731	2	4	16	0	753
22591	14	723	0	15	0	752
22592	6	12	713	6	0	737
22593	5	701	16	7	0	729
22594	2	696	5	15	0	718
22595	639	11	2	4	0	656
22596	8	623	3	5	0	639
22597	5	586	2	2	0	595
22598	580	13	1	2	0	596
22599	8	4	582	1	0	595
22600	546	2	6	2	0	556
22601	6	4	4	551	0	565
22602	4	2	0	527	0	533
22603	3	3	2	530	0	538
22604	3	2	516	9	0	530
22605	4	509	5	5	0	523
22606	516	6	5	4	0	531
22607	8	3	1	522	0	534
22608	2	519	2	18	0	541
22609	1	7	5	533	0	546
22610	4	6	527	10	0	547
22611	3	1	9	535	0	548
22612	3	3	5	544	0	555
22613	5	4	2	536	0	547
22614	537	1	2	13	0	553
22615	9	1	7	545	0	562
22616	4	1	541	17	0	563
22617	0	552	10	11	0	573
22618	4	7	3	560	0	574
22619	4	4	1	562	0	571
22620	2	2	533	16	0	553
22621	5	1	521	6	0	533
22622	520	5	11	6	0	542
22623	505	3	6	6	0	520
22624	13	511	4	4	0	532
22625	500	9	4	6	0	519
22626	11	4	503	5	0	523
22627	9	3	495	6	0	513
22628	490	10	13	7	0	520
22629	470	4	16	8	0	498
22630	14	3	452	5	0	474
22631	447	2	12	6	0	467
22632	14	1	456	6	0	477
22633	456	1	12	5	0	474
22634	455	6	4	5	0	470
22635	15	2	7	432	0	456
22636	8	468	5	9	0	490
22637	358	16	4	7	0	385
22638	14	5	459	4	0	482
22639	6	462	11	3	0	482
22640	463	14	4	7	0	488
22641	443	3	3	3	0	452
22642	13	438	6	6	0	463
22643	8	10	3	442	0	463
22644	5	4	429	19	0	457
22645	6	1	11	429	0	447
22646	4	2	425	18	0	449
22647	4	2	14	422	0	442
22648	3	5	4	433	0	445
22649	4	4	413	16	0	437
22650	1	419	13	11	0	444
22651	3	13	8	413	0	437
22652	6	3	303	22	0	334
22653	412	3	15	8	0	438
22654	14	3	7	421	0	445
22655	6	5	1	433	0	445
22656	419	2	5	18	0	444
22657	16	3	3	409	0	431
22658	7	1	6	407	0	421
22659	5	411	5	18	0	439
22660	6	11	5	415	0	437
22661	4	4	414	15	0	437
22662	7	0	10	399	0	416
22663	6	404	7	10	0	427
22664	4	421	7	4	0	436
22665	10	11	3	411	0	435
22666	417	3	5	12	0	437
22667	13	6	5	406	0	430
22668	416	6	2	11	0	435
22669	14	3	5	409	0	431
22670	409	5	7	11	0	432
22671	421	3	3	6	0	433
22672	18	4	2	411	0	435
22673	10	22	6	388	0	426
22674	12	384	1	20	0	417
22675	7	409	9	7	0	432
22676	8	13	398	9	0	428
22677	9	401	10	7	0	427
22678	225	13	6	4	0	248
22679	5	0	1	222	0	228
22680	2	204	3	8	0	217
22681	214	4	1	2	0	221
22682	5	1	1	215	0	222
22683	2	0	3	216	0	221
22684	3	2	2	216	0	223
22685	3	1	1	214	0	219
22686	2	217	2	5	0	226
22687	2	227	2	2	0	233
22688	232	3	0	2	0	237
22689	5	229	1	1	0	236
22690	1	4	1	220	0	226
22691	2	1	0	225	0	228
22692	1	0	2	223	0	226
22693	2	1	2	222	0	227
22694	222	1	0	5	0	228
22695	218	0	2	2	0	222
22696	6	1	216	0	0	223
22697	1	1	3	219	0	224
22698	0	1	215	5	0	221
22699	0	3	4	230	0	237
22700	3	0	0	232	0	235
22701	243	0	3	4	0	250
22702	4	2	0	246	0	252
22703	1	1	250	5	0	257
22704	2	1	242	1	0	246
22705	244	1	3	4	0	252
22706	4	0	247	4	0	255
22707	0	0	5	243	0	248
22708	3	0	240	5	0	248
22709	0	6	4	228	0	238
22710	1	229	2	4	0	236
22711	2	4	1	225	0	232
22712	1	223	2	4	0	230
22713	1	230	3	4	0	238
22714	0	3	0	227	0	230
22715	219	0	3	4	0	226
22716	3	219	2	2	0	226
22717	1	3	2	212	0	218
22718	213	1	4	2	0	220
22719	217	2	1	1	0	221
22720	215	2	3	1	0	221
22721	3	0	1	219	0	223
22722	1	1	2	220	0	224
22723	219	2	2	5	0	228
22724	219	3	1	4	0	227
22725	223	2	0	2	0	227
22726	4	2	1	224	0	231
22727	3	3	211	1	0	218
22728	201	2	1	4	0	208
22729	2	0	0	200	0	202
22730	4	212	0	0	0	216
22731	3	1	0	209	0	213
22732	5	202	0	1	0	208
22733	3	1	0	212	0	216
22734	3	0	217	2	0	222
22735	4	203	0	2	0	209
22736	1	1	3	188	0	193
22737	3	2	0	182	0	187
22738	4	0	0	182	0	186
22739	193	2	0	0	0	195
22740	5	197	0	3	0	205
22741	0	1	3	208	0	212
22742	208	3	1	2	0	214
22743	213	0	0	4	0	217
22744	1	3	0	214	0	218
22745	1	1	220	6	0	228
22746	2	2	2	224	0	230
22747	1	239	1	3	0	244
22748	1	2	2	238	0	243
22749	238	2	1	4	0	245
22750	4	1	0	248	0	253
22751	2	0	258	8	0	268
22752	0	277	3	3	0	283
22753	281	3	0	4	0	288
22754	5	4	284	1	0	294
22755	291	2	2	4	0	299
22756	7	0	0	303	0	310
22757	3	0	1	302	0	306
22758	1	305	3	6	0	315
22759	310	6	2	1	0	319
22760	6	1	2	316	0	325
22761	1	2	2	323	0	328
22762	3	1	1	340	0	345
22763	2	0	334	8	0	344
22764	1	2	4	339	0	346
22765	339	2	3	5	0	349
22766	343	2	2	1	0	348
22767	7	2	0	339	0	348
22768	1	0	2	345	0	348
22769	337	0	1	7	0	345
22770	5	2	326	3	0	336
22771	324	0	5	6	0	335
22772	6	3	312	3	0	324
22773	6	1	324	2	0	333
22774	2	0	7	331	0	340
22775	2	0	330	10	0	342
22776	336	0	5	7	0	348
22777	6	0	4	354	0	364
22778	3	1	352	6	0	362
22779	343	0	4	4	0	351
22780	356	1	3	4	0	364
22781	6	0	372	7	0	385
22782	2	2	7	368	0	379
22783	5	373	1	7	0	386
22784	381	4	3	5	0	393
22785	8	0	400	1	0	409
22786	368	2	6	2	0	378
22787	5	380	4	3	0	392
22788	379	4	4	4	0	391
22789	379	0	3	4	0	386
22790	386	2	2	1	0	391
22791	7	0	0	399	0	406
22792	1	393	5	7	0	406
22793	6	5	394	0	0	405
22794	5	397	3	2	0	407
22795	5	5	3	368	0	381
22796	5	396	7	6	0	414
22797	3	410	2	3	0	418
22798	404	4	2	4	0	414
22799	5	3	396	2	0	406
22800	3	2	396	2	0	403
22801	3	0	393	0	0	396
22802	1	405	4	4	0	414
22803	396	5	0	1	0	402
22804	401	1	1	1	0	404
22805	394	0	1	3	0	398
22806	5	394	1	1	0	401
22807	1	5	2	413	0	421
22808	1	1	417	5	0	424
22809	1	0	412	3	0	416
22810	418	1	6	1	0	426
22811	445	1	0	0	0	446
22812	443	0	0	3	0	446
22813	4	1	438	0	0	443
22814	425	1	4	2	0	432
22815	6	0	1	439	0	446
22816	0	0	1	456	0	457
22817	1	1	473	6	0	481
22818	2	467	2	1	0	472
22819	1	4	1	475	0	481
22820	0	0	471	7	0	478
22821	444	0	4	2	0	450
22822	5	0	2	477	0	484
22823	2	0	0	486	0	488
22824	480	0	1	5	0	486
22825	7	0	1	476	0	484
22826	480	0	1	7	0	488
22827	481	0	0	1	0	482
22828	6	0	2	484	0	492
22829	0	1	2	495	0	498
22830	508	0	1	5	0	514
22831	5	1	1	511	0	518
22832	520	1	1	5	0	527
22833	517	0	1	2	0	520
22834	504	0	2	2	0	508
22835	7	1	1	508	0	517
22836	2	0	1	517	0	520
22837	519	1	2	4	0	526
22838	6	504	0	0	0	510
22839	2	506	0	0	0	508
22840	494	3	1	0	0	498
22841	4	1	505	0	0	510
22842	505	0	5	2	0	512
22843	5	1	1	549	0	556
22844	2	1	555	3	0	561
22845	547	0	2	0	0	549
22846	2	0	0	567	0	569
22847	0	0	0	573	0	573
22848	0	0	0	573	0	573
22849	0	0	0	577	0	577
22850	579	0	0	2	0	581
22851	2	558	0	0	0	560
22852	538	2	2	1	0	543
22853	1	0	544	0	0	545
22854	0	0	522	0	0	522
22855	0	538	2	1	0	541
22856	0	3	3	534	0	540
22857	0	0	533	0	0	533
22858	0	479	0	2	0	481
22859	0	0	516	0	0	516
22860	1	0	0	512	0	513
22861	0	1	0	505	0	506
22862	517	0	0	1	0	518
22863	0	0	0	506	0	506
22864	510	0	0	0	0	510
22865	0	0	509	1	0	510
22866	0	534	0	0	0	534
22867	1	0	0	543	0	544
22868	0	0	0	586	0	586
22869	0	0	586	0	0	586
22870	0	0	544	0	0	544
22871	542	0	0	1	0	543
22872	585	0	0	0	0	585
22873	0	0	0	592	0	592
22874	0	0	0	587	0	587
22875	0	587	0	0	0	587
22876	0	0	0	609	0	609
22877	606	0	0	2	0	608
22878	608	0	0	0	0	608
22879	0	598	0	0	0	598
22880	608	0	0	0	0	608
22881	587	0	0	0	0	587
22882	1	0	0	652	0	653
22883	0	656	0	5	0	661
22884	0	3	0	661	0	664
22885	0	0	0	660	0	660
22886	0	0	645	4	0	649
22887	627	0	3	0	0	630
22888	4	0	0	683	0	687
22889	0	0	0	759	0	759
22890	1	896	0	11	0	908
22891	0	11	0	991	0	1002
22892	1005	1	0	17	0	1023
22893	1076	3	1	5	0	1085
22894	20	1	1075	4	0	1100
22895	6	2	1087	2	0	1097
22896	7	0	21	1141	0	1169
22897	1	0	4	1177	0	1182
22898	0	0	1165	23	0	1188
22899	4	0	1152	6	0	1162
22900	1	0	23	1129	0	1153
22901	1	0	1174	25	0	1200
22902	2	2	1174	3	0	1181
22903	3	0	29	1141	0	1173
22904	1170	0	10	25	0	1205
22905	1198	2	8	3	0	1211
22906	22	0	4	1186	0	1212
22907	9	0	3	1194	0	1206
22908	1173	0	3	27	0	1203
22909	27	0	1	1148	0	1176
22910	1143	0	4	32	0	1179
22911	1161	0	4	9	0	1174
22912	27	2	1	1157	0	1187
22913	10	2	1	1177	0	1190
22914	1155	2	2	30	0	1189
22915	29	1147	0	11	0	1187
22916	8	1159	2	9	0	1178
22917	7	23	4	1112	0	1146
22918	5	8	1111	28	0	1152
22919	7	6	21	1099	0	1133
22920	1119	2	7	31	0	1159
22921	25	2	8	1118	0	1153
22922	1118	2	6	30	0	1156
22923	27	3	1115	10	0	1155
22924	1096	0	25	10	0	1131
22925	30	1	6	1110	0	1147
22926	12	1	6	1156	0	1175
22927	11	4	1175	27	0	1217
22928	7	3	22	1166	0	1198
22929	6	0	3	1200	0	1209
22930	6	2	9	1189	0	1206
22931	1161	3	3	36	0	1203
22932	29	1	1157	16	0	1203
22933	13	3	1146	13	0	1175
22934	1126	2	25	14	0	1167
22935	1161	0	14	15	0	1190
22936	36	1	1188	9	0	1234
22937	13	3	28	1151	0	1195
22938	10	1193	9	33	0	1245
22939	7	24	14	1224	0	1269
22940	1206	4	12	39	0	1261
22941	1224	6	7	17	0	1254
22942	31	2	13	1196	0	1242
22943	20	1171	8	31	0	1230
22944	18	19	9	1120	0	1166
22945	13	1150	17	24	0	1204
22946	1154	26	8	16	0	1204
22947	1116	7	5	26	0	1154
22948	1145	7	10	15	0	1177
22949	32	1098	9	22	0	1161
22950	15	1134	9	19	0	1177
22951	20	21	6	1132	0	1179
22952	14	7	7	1137	0	1165
22953	12	8	6	1129	0	1155
22954	18	6	6	1162	0	1192
22955	15	7	1115	39	0	1176
22956	1085	7	29	22	0	1143
22957	36	5	1126	21	0	1188
22958	1172	3	30	20	0	1225
22959	35	8	1204	16	0	1263
22960	1193	3	27	21	0	1244
22961	43	7	1224	12	0	1286
22962	1186	5	30	17	0	1238
22963	43	1	9	1235	0	1288
22964	1249	2	12	38	0	1301
22965	45	3	8	1242	0	1298
22966	15	7	8	1260	0	1290
22967	18	7	7	1222	0	1254
22968	11	1174	10	42	0	1237
22969	1184	24	7	22	0	1237
22970	1189	5	6	24	0	1224
22971	41	1193	7	15	0	1256
22972	19	29	3	1196	0	1247
22973	16	7	1184	37	0	1244
22974	1166	6	33	22	0	1227
22975	1210	6	7	19	0	1242
22976	1189	3	12	19	0	1223
22977	44	3	10	1140	0	1197
22978	20	1141	10	30	0	1201
22979	16	26	10	1158	0	1210
22980	1154	6	10	40	0	1210
22981	44	8	4	1113	0	1169
22982	15	1095	9	31	0	1150
22983	1085	23	9	14	0	1131
22984	41	7	1087	11	0	1146
22985	26	10	1069	11	0	1116
22986	16	1067	24	13	0	1120
22987	17	1069	8	9	0	1103
22988	23	25	1026	13	0	1087
22989	14	16	945	15	0	990
22990	17	53	21	728	0	819
22991	734	2	11	13	0	760
22992	15	7	729	2	0	753
22993	0	665	12	4	0	681
22994	651	7	3	1	0	662
22995	8	639	6	2	0	655
22996	597	4	2	0	0	603
22997	4	592	0	2	0	598
22998	3	601	0	0	0	604
22999	0	4	2	601	0	607
23000	1	2	1	601	0	605
23001	3	0	577	3	0	583
23002	1	2	4	571	0	578
23003	580	0	0	3	0	583
23004	576	1	0	1	0	578
23005	4	2	0	576	0	582
23006	0	1	560	6	0	567
23007	0	0	547	4	0	551
23008	2	0	4	560	0	566
23009	1	1	565	7	0	574
23010	3	2	3	563	0	571
23011	4	0	0	542	0	546
23012	0	1	583	5	0	589
23013	551	0	7	2	0	560
23014	579	2	3	1	0	585
23015	4	2	583	2	0	591
23016	3	0	591	0	0	594
23017	3	0	7	599	0	609
23018	1	0	1	632	0	634
23019	2	1	4	647	0	654
23020	3	0	2	629	0	634
23021	636	2	0	6	0	644
23022	682	0	3	2	0	687
23023	11	3	2	729	0	745
23024	4	0	3	782	0	789
23025	4	2	849	19	0	874
23026	1	3	27	881	0	912
23027	5	1	4	954	0	964
23028	986	1	4	34	0	1025
23029	36	1085	5	8	0	1134
23030	6	33	2	1086	0	1127
23031	7	6	1	1119	0	1133
23032	5	3	3	1099	0	1110
23033	2	1001	1	49	0	1053
23034	4	1081	2	14	0	1101
23035	4	37	2	1070	0	1113
23036	2	16	1	1054	0	1073
23037	1	7	2	1065	0	1075
23038	990	6	2	50	0	1048
23039	33	1008	0	19	0	1060
23040	1016	35	1	10	0	1062
23041	1042	8	1	3	0	1054
23042	42	6	2	999	0	1049
23043	13	997	3	39	0	1052
23044	1004	36	2	14	0	1056
23045	39	11	0	1003	0	1053
23046	1003	8	2	43	0	1056
23047	39	4	4	1014	0	1061
23048	14	1	1015	48	0	1078
23049	13	5	1063	12	0	1093
23050	7	6	38	1038	0	1089
23051	6	6	11	1059	0	1082
23052	5	3	10	1056	0	1074
23053	4	1006	9	48	0	1067
23054	7	1072	3	26	0	1108
23055	1036	42	3	14	0	1095
23056	1022	18	5	6	0	1051
23057	41	1013	7	12	0	1073
23058	13	977	1	13	0	1004
23059	6	1002	1	17	0	1026
23060	913	46	1	10	0	970
23061	32	937	1	10	0	980
23062	11	40	0	931	0	982
23063	927	12	0	43	0	982
23064	939	5	3	18	0	965
23065	42	6	4	904	0	956
23066	14	8	880	42	0	944
23067	12	4	908	20	0	944
23068	12	5	34	891	0	942
23069	5	6	909	45	0	965
23070	5	11	38	899	0	953
23071	11	4	10	908	0	933
23072	8	4	887	50	0	949
23073	13	7	902	19	0	941
23074	5	6	40	888	0	939
23075	6	6	19	926	0	957
23076	880	4	14	47	0	945
23077	31	879	8	24	0	942
23078	11	925	4	20	0	960
23079	881	40	0	22	0	943
23080	919	16	4	13	0	952
23081	47	899	4	8	0	958
23082	18	917	6	13	0	954
23083	895	47	7	14	0	963
23084	45	16	4	882	0	947
23085	869	14	5	46	0	934
23086	42	876	3	19	0	940
23087	875	39	1	20	0	935
23088	47	14	859	11	0	931
23089	860	15	37	12	0	924
23090	47	7	861	16	0	931
23091	23	7	36	845	0	911
23092	841	5	14	49	0	909
23093	42	9	827	18	0	896
23094	17	10	39	835	0	901
23095	828	6	13	53	0	900
23096	46	7	839	17	0	909
23097	14	13	33	857	0	917
23098	832	12	13	50	0	907
23099	43	827	14	24	0	908
23100	18	36	8	848	0	910
23101	13	19	11	866	0	909
23102	8	17	6	875	0	906
23103	18	843	0	54	0	915
23104	9	43	8	872	0	932
23105	11	18	4	899	0	932
23106	17	11	3	895	0	926
23107	17	15	5	912	0	949
23108	18	14	858	58	0	948
23109	847	10	36	28	0	921
23110	887	7	13	23	0	930
23111	49	871	5	20	0	945
23112	25	39	9	858	0	931
23113	13	15	8	876	0	912
23114	16	838	3	53	0	910
23115	9	39	9	870	0	927
23116	829	13	11	49	0	902
23117	35	815	14	24	0	888
23118	809	35	5	26	0	875
23119	43	14	9	801	0	867
23120	15	9	792	46	0	862
23121	9	789	32	29	0	859
23122	733	40	13	14	0	800
23123	28	696	8	16	0	748
23124	13	688	4	9	0	714
23125	576	18	15	3	0	612
23126	18	10	543	5	0	576
23127	9	465	9	5	0	488
23128	363	28	24	15	0	430
23129	307	4	3	0	0	314
23130	5	316	1	0	0	322
23131	3	2	0	334	0	339
23132	2	3	335	1	0	341
23133	2	2	1	326	0	331
23134	2	1	3	316	0	322
23135	0	1	1	348	0	350
23136	0	1	350	6	0	357
23137	3	0	1	338	0	342
23138	0	2	347	3	0	352
23139	0	2	320	5	0	327
23140	292	0	4	2	0	298
23141	2	328	4	2	0	336
23142	4	344	2	1	0	351
23143	1	4	1	356	0	362
23144	381	5	2	4	0	392
23145	383	2	1	5	0	391
23146	381	1	1	2	0	385
23147	371	3	1	2	0	377
23148	360	1	2	1	0	364
23149	10	0	321	2	0	333
23150	7	0	5	331	0	343
23151	3	326	5	5	0	339
23152	4	3	2	332	0	341
23153	331	4	2	2	0	339
23154	2	330	1	6	0	339
23155	4	3	0	337	0	344
23156	334	4	1	4	0	343
23157	358	3	1	7	0	369
23158	7	1	0	358	0	366
23159	7	0	0	346	0	353
23160	4	2	1	349	0	356
23161	1	1	342	10	0	354
23162	0	0	340	7	0	347
23163	1	2	6	351	0	360
23164	3	0	5	351	0	359
23165	348	1	3	7	0	359
23166	347	2	3	5	0	357
23167	383	0	0	6	0	389
23168	384	2	0	3	0	389
23169	389	1	0	3	0	393
23170	10	377	0	2	0	389
23171	394	4	0	2	0	400
23172	391	5	0	2	0	398
23173	393	3	1	1	0	398
23174	9	2	0	394	0	405
23175	7	2	395	3	0	407
23176	4	1	2	394	0	401
23177	3	0	419	6	0	428
23178	2	6	6	397	0	411
23179	1	402	5	4	0	412
23180	405	2	1	5	0	413
23181	431	3	2	4	0	440
23182	5	2	0	436	0	443
23183	3	1	0	452	0	456
23184	3	0	0	454	0	457
23185	2	453	2	4	0	461
23186	461	2	1	5	0	469
23187	454	3	1	2	0	460
23188	4	462	1	2	0	469
23189	5	2	0	473	0	480
23190	4	3	0	465	0	472
23191	3	478	0	4	0	485
23192	480	1	1	4	0	486
23193	485	2	0	3	0	490
23194	5	3	1	489	0	498
23195	6	1	481	2	0	490
23196	5	1	444	2	0	452
23197	5	1	4	467	0	477
23198	1	1	3	474	0	479
23199	0	0	4	485	0	489
23200	475	2	0	8	0	485
23201	472	0	2	4	0	478
23202	7	501	0	2	0	510
23203	506	2	0	3	0	511
23204	7	1	498	0	0	506
23205	4	2	490	1	0	497
23206	1	518	2	4	0	525
23207	510	6	2	6	0	524
23208	1	507	1	3	0	512
23209	505	3	0	0	0	508
23210	6	2	517	0	0	525
23211	2	2	527	3	0	534
23212	4	2	5	514	0	525
23213	3	0	544	2	0	549
23214	1	0	4	543	0	548
23215	4	2	3	487	0	496
23216	2	546	1	5	0	554
23217	2	1	2	558	0	563
23218	3	2	1	565	0	571
23219	584	4	2	3	0	593
23220	3	580	3	4	0	590
23221	3	1	3	606	0	613
23222	2	2	608	3	0	615
23223	550	3	3	5	0	561
23224	7	1	598	3	0	609
23225	4	3	3	587	0	597
23226	3	636	1	3	0	643
23227	2	5	3	644	0	654
23228	663	0	2	7	0	672
23229	669	2	2	3	0	676
23230	9	674	3	5	0	691
23231	670	6	2	4	0	682
23232	674	5	1	5	0	685
23233	684	4	2	1	0	691
23234	705	0	2	4	0	711
23235	668	2	1	4	0	675
23236	15	1	676	1	0	693
23237	8	2	8	665	0	683
23238	1	1	3	663	0	668
23239	3	1	3	677	0	684
23240	3	684	0	13	0	700
23241	3	8	2	683	0	696
23242	2	3	690	12	0	707
23243	5	676	7	3	0	691
23244	3	664	3	5	0	675
23245	4	11	1	663	0	679
23246	4	3	2	655	0	664
23247	5	1	0	657	0	663
23248	1	641	1	10	0	653
23249	4	660	0	6	0	670
23250	658	13	1	2	0	674
23251	650	3	3	4	0	660
23252	8	663	1	2	0	674
23253	679	8	1	2	0	690
23254	697	5	0	7	0	709
23255	11	1	0	699	0	711
23256	4	0	2	722	0	728
23257	2	3	3	710	0	718
23258	2	3	700	11	0	716
23259	3	3	696	4	0	706
23260	2	737	13	5	0	757
23261	758	11	2	5	0	776
23262	14	4	765	3	0	786
23263	742	2	16	5	0	765
23264	14	9	799	4	0	826
23265	824	2	12	5	0	843
23266	15	865	11	0	0	891
23267	850	18	2	2	0	872
23268	21	5	10	824	0	860
23269	15	4	1	839	0	859
23270	5	8	854	20	0	887
23271	10	864	18	5	0	897
23272	2	19	5	873	0	899
23273	2	3	877	25	0	907
23274	804	1	23	6	0	834
23275	20	879	5	1	0	905
23276	869	18	2	8	0	897
23277	18	855	9	2	0	884
23278	12	17	1	854	0	884
23279	850	8	6	19	0	883
23280	24	855	2	7	0	888
23281	5	24	1	843	0	873
23282	3	6	826	22	0	857
23283	794	2	17	9	0	822
23284	20	6	5	826	0	857
23285	7	3	819	23	0	852
23286	0	815	23	5	0	843
23287	6	16	4	808	0	834
23288	3	5	815	26	0	849
23289	5	5	24	780	0	814
23290	1	833	5	16	0	855
23291	3	831	1	13	0	848
23292	6	20	828	0	0	854
23293	4	3	16	827	0	850
23294	3	9	837	17	0	866
23295	795	10	15	3	0	823
23296	18	3	10	818	0	849
23297	3	823	4	22	0	852
23298	2	874	7	4	0	887
23299	837	20	0	5	0	862
23300	14	861	4	7	0	886
23301	854	25	2	2	0	883
23302	16	11	836	3	0	866
23303	776	0	19	4	0	799
23304	17	812	5	1	0	835
23305	810	18	0	2	0	830
23306	16	805	9	0	0	830
23307	15	17	1	792	0	825
23308	1	12	0	836	0	849
23309	9	2	828	18	0	857
23310	782	8	17	7	0	814
23311	18	0	805	11	0	834
23312	800	3	15	8	0	826
23313	17	5	10	800	0	832
23314	14	0	1	809	0	824
23315	1	817	10	19	0	847
23316	15	17	0	851	0	883
23317	2	7	2	884	0	895
23318	5	1	872	27	0	905
23319	784	11	19	6	0	820
23320	20	841	4	12	0	877
23321	829	21	1	8	0	859
23322	19	6	8	827	0	860
23323	11	0	2	845	0	858
23324	828	7	4	21	0	860
23325	30	844	0	6	0	880
23326	793	16	0	11	0	820
23327	16	790	3	15	0	824
23328	9	789	0	2	0	800
23329	762	22	2	3	0	789
23330	25	2	4	749	0	780
23331	1	8	758	17	0	784
23332	3	11	14	734	0	762
23333	12	3	0	738	0	753
23334	1	733	2	24	0	760
23335	4	13	9	745	0	771
23336	1	5	2	769	0	777
23337	4	2	1	771	0	778
23338	3	10	0	775	0	788
23339	0	4	749	25	0	778
23340	2	3	780	11	0	796
23341	4	1	15	795	0	815
23342	3	3	779	27	0	812
23343	2	2	786	5	0	795
23344	0	2	24	779	0	805
23345	4	2	800	27	0	833
23346	3	3	24	776	0	806
23347	2	803	14	17	0	836
23348	831	16	1	14	0	862
23349	18	1	921	6	0	946
23350	2	2	25	898	0	927
23351	1	10	940	24	0	975
23352	10	0	26	1007	0	1043
23353	2	2	11	1019	0	1034
23354	1019	1	5	40	0	1065
23355	28	0	12	1066	0	1106
23356	996	3	4	41	0	1044
23357	1040	3	2	14	0	1059
23358	39	1029	2	7	0	1077
23359	1019	31	2	9	0	1061
23360	36	985	5	3	0	1029
23361	12	1022	4	4	0	1042
23362	986	37	3	4	0	1030
23363	33	9	994	4	0	1040
23364	8	4	999	5	0	1016
23365	906	6	39	2	0	953
23366	928	3	7	6	0	944
23367	31	927	8	4	0	970
23368	937	23	6	5	0	971
23369	974	8	5	3	0	990
23370	969	2	3	4	0	978
23371	34	7	2	944	0	987
23372	946	6	2	27	0	981
23373	35	935	6	6	0	982
23374	16	24	3	983	0	1026
23375	7	5	8	995	0	1015
23376	9	973	4	31	0	1017
23377	6	26	1	979	0	1012
23378	963	9	2	30	0	1004
23379	980	5	2	17	0	1004
23380	34	942	3	6	0	985
23381	19	980	1	8	0	1008
23382	966	30	3	7	0	1006
23383	33	9	953	7	0	1002
23384	14	7	952	3	0	976
23385	8	7	30	940	0	985
23386	8	7	7	967	0	989
23387	9	6	941	28	0	984
23388	9	907	27	9	0	952
23389	11	28	9	883	0	931
23390	10	6	943	27	0	986
23391	8	5	28	919	0	960
23392	10	9	8	927	0	954
23393	7	963	5	32	0	1007
23394	6	25	5	954	0	990
23395	8	11	6	963	0	988
23396	8	1	4	983	0	996
23397	940	6	3	36	0	985
23398	30	5	3	925	0	963
23399	12	930	5	37	0	984
23400	932	26	4	14	0	976
23401	32	6	915	13	0	966
23402	11	9	909	9	0	938
23403	890	8	30	7	0	935
23404	33	5	6	933	0	977
23405	12	2	958	29	0	1001
23406	10	5	28	949	0	992
23407	3	8	8	987	0	1006
23408	948	2	2	42	0	994
23409	955	4	10	11	0	980
23410	29	943	5	19	0	996
23411	8	28	5	960	0	1001
23412	11	7	953	33	0	1004
23413	7	1015	30	17	0	1069
23414	1008	33	12	11	0	1064
23415	33	1029	3	9	0	1074
23416	996	28	6	12	0	1042
23417	30	12	1003	7	0	1052
23418	964	4	26	13	0	1007
23419	1036	6	6	11	0	1059
23420	39	14	1042	7	0	1102
23421	13	12	33	1023	0	1081
23422	13	1043	5	36	0	1097
23423	6	1094	9	17	0	1126
23424	9	1108	9	6	0	1132
23425	9	37	4	1053	0	1103
23426	4	13	1088	38	0	1143
23427	8	8	34	1059	0	1109
23428	7	4	12	1119	0	1142
23429	7	8	1118	38	0	1171
23430	14	1093	29	14	0	1150
23431	12	31	11	1104	0	1158
23432	1098	13	11	31	0	1153
23433	35	4	2	1112	0	1153
23434	12	10	8	1110	0	1140
23435	6	1108	5	42	0	1161
23436	1116	39	4	14	0	1173
23437	36	13	2	1184	0	1235
23438	15	3	1164	37	0	1219
23439	3	1159	36	20	0	1218
23440	1141	33	7	14	0	1195
23441	34	9	1128	7	0	1178
23442	1094	9	32	7	0	1142
23443	33	7	7	1118	0	1165
23444	15	1140	3	27	0	1185
23445	1137	32	3	14	0	1186
23446	1139	9	6	10	0	1164
23447	35	1175	7	6	0	1223
23448	17	27	9	1156	0	1209
23449	5	9	2	1116	0	1132
23450	1080	3	8	27	0	1118
23451	25	1080	2	6	0	1113
23452	13	28	0	991	0	1032
23453	2	991	9	20	0	1022
23454	9	976	2	7	0	994
23455	2	12	3	940	0	957
23456	932	9	1	11	0	953
23457	14	940	1	5	0	960
23458	5	11	2	943	0	961
23459	0	10	0	954	0	964
23460	0	0	943	17	0	960
23461	3	1	885	8	0	897
23462	6	914	11	1	0	932
23463	0	13	907	2	0	922
23464	1	1	8	916	0	926
23465	0	5	955	8	0	968
23466	0	6	10	944	0	960
23467	2	2	2	967	0	973
23468	6	0	2	977	0	985
23469	939	5	1	11	0	956
23470	8	0	2	934	0	944
23471	2	1	0	937	0	940
23472	0	933	5	11	0	949
23473	0	9	5	938	0	952
23474	929	6	0	12	0	947
23475	8	937	6	3	0	954
23476	938	8	0	11	0	957
23477	8	3	949	1	0	961
23478	1	0	995	7	0	1003
23479	2	1	10	1009	0	1022
23480	1	2	1	1043	0	1047
23481	10	1029	1	13	0	1053
23482	1	9	1	980	0	991
23483	1038	3	2	16	0	1059
23484	1027	6	1	4	0	1038
23485	13	0	2	1047	0	1062
23486	9	2	1107	12	0	1130
23487	2	5	10	1106	0	1123
23488	7	1	5	1146	0	1159
23489	3	0	5	1155	0	1163
23490	0	1	6	1156	0	1163
23491	2	2	1	1133	0	1138
23492	0	1139	0	19	0	1158
23493	1107	18	0	6	0	1131
23494	1132	2	1	8	0	1143
23495	1131	1	0	4	0	1136
23496	20	1155	1	4	0	1180
23497	1158	15	1	5	0	1179
23498	16	1154	4	1	0	1175
23499	5	14	1147	6	0	1172
23500	4	3	13	1119	0	1139
23501	0	3	1172	18	0	1193
23502	2	1178	14	8	0	1202
23503	1171	18	3	7	0	1199
23504	15	9	1212	2	0	1238
23505	11	1	1235	3	0	1250
23506	6	1315	21	1	0	1343
23507	4	19	5	1335	0	1363
23508	4	9	1387	24	0	1424
23509	2	1	24	1348	0	1375
23510	1	5	7	1534	0	1547
23511	1	5	8	1639	0	1653
23512	1751	2	1	38	0	1792
23513	1753	0	7	9	0	1769
23514	34	5	3	1748	0	1790
23515	1790	1	0	33	0	1824
23516	32	0	1778	13	0	1823
23517	11	2	1746	7	0	1766
23518	10	5	1745	2	0	1762
23519	6	1	1744	3	0	1754
23520	4	1720	35	5	0	1764
23521	12	29	7	1670	0	1718
23522	12	6	1720	22	0	1760
23523	1580	3	32	12	0	1627
23524	1714	0	12	8	0	1734
23525	38	1722	11	3	0	1774
23526	1703	28	11	10	0	1752
23527	34	9	10	1710	0	1763
23528	12	2	1737	25	0	1776
23529	8	4	44	1639	0	1695
23530	4	1736	15	29	0	1784
23531	1697	28	13	9	0	1747
23532	1722	15	10	5	0	1752
23533	39	1729	3	11	0	1782
23534	1736	31	10	9	0	1786
23535	1749	11	8	4	0	1772
23536	45	1752	1	9	0	1807
23537	14	33	7	1677	0	1731
23538	17	1695	6	34	0	1752
23539	1711	33	3	20	0	1767
23540	36	21	8	1696	0	1761
23541	1722	5	8	32	0	1767
23542	38	9	8	1718	0	1773
23543	20	12	1700	31	0	1763
23544	1655	9	31	11	0	1706
23545	40	12	1686	11	0	1749
23546	25	8	35	1688	0	1756
23547	19	4	1693	36	0	1752
23548	13	11	31	1683	0	1738
23549	13	6	1705	41	0	1765
23550	1646	9	34	15	0	1704
23551	49	1700	9	9	0	1767
23552	1700	31	13	21	0	1765
23553	42	5	19	1689	0	1755
23554	1676	7	12	39	0	1734
23555	35	1686	20	16	0	1757
23556	15	1682	17	13	0	1727
23557	18	1762	16	7	0	1803
23558	1754	39	11	25	0	1829
23559	35	10	18	1754	0	1817
23560	19	10	8	1779	0	1816
23561	22	16	1737	40	0	1815
23562	22	10	1718	17	0	1767
23563	16	23	32	1738	0	1809
23564	26	15	1765	33	0	1839
23565	13	1735	31	23	0	1802
23566	1715	33	13	14	0	1775
23567	38	20	1770	15	0	1843
23568	22	17	1788	6	0	1833
23569	19	15	36	1771	0	1841
23570	1814	9	21	38	0	1882
23571	44	8	16	1801	0	1869
23572	1804	7	17	45	0	1873
23573	44	6	18	1807	0	1875
23574	12	9	1862	37	0	1920
23575	18	1782	40	22	0	1862
23576	15	36	1828	16	0	1895
23577	16	1820	48	12	0	1896
23578	16	38	20	1757	0	1831
23579	1756	6	17	41	0	1820
23580	36	7	1755	18	0	1816
23581	19	8	39	1718	0	1784
23582	23	10	9	1755	0	1797
23583	1779	7	15	45	0	1846
23584	46	7	11	1739	0	1803
23585	14	1784	8	46	0	1852
23586	1716	37	17	15	0	1785
23587	36	17	1722	15	0	1790
23588	1643	18	31	15	0	1707
23589	41	1702	14	9	0	1766
23590	16	33	10	1614	0	1673
23591	16	1713	5	36	0	1770
23592	1686	29	14	18	0	1747
23593	41	5	1714	16	0	1776
23594	1649	16	32	21	0	1718
23595	46	1722	11	15	0	1794
23596	16	32	12	1722	0	1782
23597	1736	16	10	33	0	1795
23598	1751	10	13	19	0	1793
23599	41	11	21	1721	0	1794
23600	22	13	11	1726	0	1772
23601	15	1698	13	38	0	1764
23602	18	42	9	1672	0	1741
23603	13	1899	14	42	0	1968
23604	24	2027	6	13	0	2070
23605	16	48	16	1880	0	1960
23606	19	1946	10	45	0	2020
23607	21	49	1993	13	0	2076
23608	20	16	2072	14	0	2122
23609	10	2068	54	29	0	2161
23610	19	46	2095	12	0	2172
23611	11	18	2061	13	0	2103
23612	5	11	1929	4	0	1949
23613	3	1841	60	7	0	1911
23614	1772	60	31	7	0	1870
23615	44	1791	11	1	0	1847
23616	11	48	1776	4	0	1839
23617	7	16	46	1730	0	1799
23618	1762	11	9	48	0	1830
23619	48	5	1766	11	0	1830
23620	11	4	56	1737	0	1808
23621	9	2	1775	49	0	1835
23622	4	8	57	1748	0	1817
23623	1730	5	14	50	0	1799
23624	47	11	1743	11	0	1812
23625	8	1724	56	16	0	1804
23626	7	49	17	1693	0	1766
23627	1750	13	9	46	0	1818
23628	52	10	1709	12	0	1783
23629	15	8	53	1571	0	1647
23630	9	1681	16	44	0	1750
23631	1708	50	9	15	0	1782
23632	1785	8	10	6	0	1809
23633	63	10	8	1696	0	1777
23634	15	1743	9	56	0	1823
23635	9	1827	9	13	0	1858
23636	1845	54	6	10	0	1915
23637	61	18	9	1772	0	1860
23638	11	1832	11	57	0	1911
23639	1830	61	7	16	0	1914
23640	60	13	9	1845	0	1927
23641	18	10	10	1892	0	1930
23642	9	11	1757	69	0	1846
23643	6	1800	59	22	0	1887
23644	9	1908	15	13	0	1945
23645	11	63	10	1844	0	1928
23646	1844	17	8	60	0	1929
23647	58	1844	9	17	0	1928
23648	1839	67	4	12	0	1922
23649	63	1849	6	11	0	1929
23650	19	59	3	1848	0	1929
23651	1840	22	5	54	0	1921
23652	59	16	11	1832	0	1918
23653	19	13	1827	62	0	1921
23654	13	11	59	1727	0	1810
23655	14	1801	14	65	0	1894
23656	1762	62	12	17	0	1853
23657	55	1774	10	11	0	1850
23658	18	71	7	1724	0	1820
23659	20	16	4	1793	0	1833
23660	14	19	1732	66	0	1831
23661	10	17	1739	23	0	1789
23662	6	16	68	1715	0	1805
23663	5	14	1715	70	0	1804
23664	15	1685	61	21	0	1782
23665	1688	60	21	14	0	1783
23666	59	18	1728	13	0	1818
23667	1658	19	61	18	0	1756
23668	1737	19	15	13	0	1784
23669	1750	12	14	11	0	1787
23670	1750	12	17	10	0	1789
23671	68	19	14	1694	0	1795
23672	34	12	9	1642	0	1697
23673	20	1659	15	65	0	1759
23674	1598	63	14	27	0	1702
23675	63	21	1590	18	0	1692
23676	18	20	68	1570	0	1676
23677	19	22	22	1601	0	1664
23678	21	11	1576	70	0	1678
23679	13	1570	73	17	0	1673
23680	9	65	28	1512	0	1614
23681	20	18	14	1636	0	1688
23682	1572	18	14	73	0	1677
23683	63	1551	16	22	0	1652
23684	24	63	14	1498	0	1599
23685	17	1526	10	82	0	1635
23686	20	57	13	1575	0	1665
23687	1547	13	13	73	0	1646
23688	1602	22	16	24	0	1664
23689	71	16	13	1580	0	1680
23690	1558	13	5	83	0	1659
23691	1581	6	14	29	0	1630
23692	77	1540	12	16	0	1645
23693	26	68	9	1460	0	1563
23694	22	1516	12	66	0	1616
23695	24	66	6	1521	0	1617
23696	1514	23	8	66	0	1611
23697	64	23	9	1512	0	1608
23698	24	23	4	1553	0	1604
23699	20	14	1476	83	0	1593
23700	29	1405	48	39	0	1521
23701	22	1503	14	21	0	1560
23702	1456	67	17	22	0	1562
23703	64	25	4	1188	0	1281
23704	1083	14	3	50	0	1150
23705	48	1052	2	20	0	1122
23706	23	965	2	10	0	1000
23707	9	967	3	17	0	996
23708	772	21	13	15	0	821
23709	19	785	13	7	0	824
23710	690	16	9	3	0	718
23711	678	4	2	4	0	688
23712	719	1	2	5	0	727
23713	17	2	0	770	0	789
23714	4	5	2	787	0	798
23715	5	1	1	798	0	805
23716	4	5	2	789	0	800
23717	791	0	0	16	0	807
23718	16	771	0	8	0	795
23719	2	9	2	787	0	800
23720	792	2	2	15	0	811
23721	11	2	3	795	0	811
23722	3	5	1	792	0	801
23723	788	3	1	14	0	806
23724	12	3	775	3	0	793
23725	1	3	9	790	0	803
23726	1	1	797	13	0	812
23727	4	2	12	772	0	790
23728	4	3	3	787	0	797
23729	777	2	0	20	0	799
23730	12	761	2	6	0	781
23731	1	743	0	4	0	748
23732	713	8	0	3	0	724
23733	7	739	2	4	0	752
23734	736	8	0	5	0	749
23735	7	0	714	3	0	724
23736	635	0	5	3	0	643
23737	657	0	0	3	0	660
23738	666	0	1	2	0	669
23739	7	0	1	646	0	654
23740	0	0	2	648	0	650
23741	0	653	2	4	0	659
23742	1	10	1	652	0	664
23743	661	1	0	8	0	670
23744	6	644	1	4	0	655
23745	2	639	0	0	0	641
23746	630	6	0	1	0	637
23747	6	2	627	1	0	636
23748	2	1	4	600	0	607
23749	1	1	623	4	0	629
23750	2	0	6	618	0	626
23751	2	613	1	4	0	620
23752	4	4	0	634	0	642
23753	638	0	0	5	0	643
23754	5	0	0	632	0	637
23755	0	2	641	6	0	649
23756	589	1	4	4	0	598
23757	4	654	1	7	0	666
23758	1	723	0	1	0	725
23759	738	7	0	1	0	746
23760	778	2	0	2	0	782
23761	10	2	795	0	0	807
23762	746	1	10	1	0	758
23763	10	780	2	2	0	794
23764	793	10	1	2	0	806
23765	10	1	3	771	0	785
23766	4	748	1	7	0	760
23767	742	12	1	2	0	757
23768	14	0	741	2	0	757
23769	4	2	10	730	0	746
23770	746	4	1	12	0	763
23771	14	2	743	1	0	760
23772	747	3	11	1	0	762
23773	11	4	0	734	0	749
23774	6	2	1	762	0	771
23775	3	1	773	10	0	787
23776	5	0	11	749	0	765
23777	769	1	4	12	0	786
23778	13	758	2	2	0	775
23779	767	10	3	3	0	783
23780	772	1	0	7	0	780
23781	13	2	1	766	0	782
23782	2	3	803	11	0	819
23783	4	0	12	786	0	802
23784	805	1	1	13	0	820
23785	13	781	1	3	0	798
23786	796	9	4	1	0	810
23787	13	4	1	788	0	806
23788	6	0	1	807	0	814
23789	1	2	4	804	0	811
23790	4	0	798	13	0	815
23791	4	2	11	779	0	796
23792	5	4	789	12	0	810
23793	4	4	778	3	0	789
23794	4	3	12	875	0	894
23795	6	0	897	21	0	924
23796	954	0	19	10	0	983
23797	17	1	10	1013	0	1041
23798	10	0	4	999	0	1013
23799	5	1029	7	26	0	1067
23800	1048	23	4	11	0	1086
23801	1089	8	2	10	0	1109
23802	28	1098	3	7	0	1136
23803	14	25	2	1101	0	1142
23804	8	8	1097	31	0	1144
23805	1055	6	23	14	0	1098
23806	1109	7	10	6	0	1132
23807	37	1	5	1062	0	1105
23808	16	2	1049	23	0	1090
23809	10	1013	24	14	0	1061
23810	1007	23	13	8	0	1051
23811	27	8	1020	12	0	1067
23812	13	990	27	14	0	1044
23813	947	28	10	10	0	995
23814	973	13	6	4	0	996
23815	38	6	6	933	0	983
23816	20	950	3	20	0	993
23817	12	28	2	1000	0	1042
23818	7	13	8	1015	0	1043
23819	8	6	9	993	0	1016
23820	15	7	1	1019	0	1042
23821	11	0	988	46	0	1045
23822	5	2	28	1019	0	1054
23823	2	9	15	1037	0	1063
23824	9	8	992	37	0	1046
23825	6	993	30	22	0	1051
23826	991	27	16	19	0	1053
23827	1013	16	10	12	0	1051
23828	43	7	4	997	0	1051
23829	1017	5	6	33	0	1061
23830	31	10	4	1019	0	1064
23831	17	9	998	36	0	1060
23832	10	4	1002	26	0	1042
23833	11	983	30	18	0	1042
23834	972	24	10	19	0	1025
23835	30	9	1061	13	0	1113
23836	16	7	37	1017	0	1077
23837	12	6	14	1121	0	1153
23838	7	6	16	1162	0	1191
23839	5	11	13	1166	0	1195
23840	13	12	6	1158	0	1189
23841	19	5	1124	56	0	1204
23842	14	2	34	1149	0	1199
23843	1116	8	13	57	0	1194
23844	40	1122	10	29	0	1201
23845	1129	30	13	24	0	1196
23846	39	1142	11	19	0	1211
23847	1142	43	11	11	0	1207
23848	1182	23	6	11	0	1222
23849	53	8	11	1144	0	1216
23850	28	9	9	1172	0	1218
23851	1149	3	2	63	0	1217
23852	1115	8	7	33	0	1163
23853	1141	6	6	28	0	1181
23854	53	1072	3	29	0	1157
23855	28	1110	10	20	0	1168
23856	14	43	1094	18	0	1169
23857	17	28	35	1054	0	1134
23858	16	11	1031	42	0	1100
23859	12	1012	33	22	0	1079
23860	11	31	18	936	0	996
23861	11	17	8	963	0	999
23862	15	10	7	984	0	1016
23863	958	5	3	54	0	1020
23864	958	3	5	37	0	1003
23865	41	959	5	19	0	1024
23866	34	25	7	957	0	1023
23867	21	14	964	33	0	1032
23868	15	15	943	19	0	992
23869	944	16	35	16	0	1011
23870	977	8	24	12	0	1021
23871	39	3	16	965	0	1023
23872	973	2	14	40	0	1029
23873	40	9	961	20	0	1030
23874	21	943	26	22	0	1012
23875	11	27	11	961	0	1010
23876	10	14	961	39	0	1024
23877	13	13	30	969	0	1025
23878	21	7	12	996	0	1036
23879	17	7	967	47	0	1038
23880	929	11	28	34	0	1002
23881	971	4	18	25	0	1018
23882	41	1015	19	16	0	1091
23883	1043	32	11	17	0	1103
23884	1093	13	6	15	0	1127
23885	48	14	1057	14	0	1133
23886	1058	7	31	14	0	1110
23887	54	1079	20	10	0	1163
23888	1096	40	16	6	0	1158
23889	1119	22	7	11	0	1159
23890	1159	19	7	11	0	1196
23891	1106	7	11	16	0	1140
23892	1159	3	3	20	0	1185
23893	61	1119	9	16	0	1205
23894	1054	30	11	12	0	1107
23895	54	1022	5	7	0	1088
23896	17	943	3	6	0	969
23897	12	955	3	7	0	977
23898	930	35	9	5	0	979
23899	934	15	5	5	0	959
23900	34	10	912	4	0	960
23901	927	0	25	2	0	954
23902	970	5	5	5	0	985
23903	32	5	952	4	0	993
23904	11	4	29	951	0	995
23905	9	3	7	956	0	975
23906	5	2	3	1001	0	1011
23907	8	1	5	1002	0	1016
23908	7	3	1	998	0	1009
23909	4	6	973	38	0	1021
23910	5	980	33	10	0	1028
23911	957	30	8	6	0	1001
23912	32	956	10	2	0	1000
23913	954	37	1	3	0	995
23914	980	3	2	6	0	991
23915	41	5	948	6	0	1000
23916	13	4	31	876	0	924
23917	14	904	6	23	0	947
23918	913	34	7	3	0	957
23919	937	7	5	7	0	956
23920	948	6	3	4	0	961
23921	42	932	2	4	0	980
23922	933	26	4	3	0	966
23923	961	4	2	2	0	969
23924	951	8	3	3	0	965
23925	46	3	3	918	0	970
23926	16	9	1	936	0	962
23927	13	7	0	947	0	967
23928	912	7	4	34	0	957
23929	40	926	3	8	0	977
23930	927	31	1	6	0	965
23931	934	9	7	3	0	953
23932	935	11	3	2	0	951
23933	940	5	0	1	0	946
23934	40	897	7	2	0	946
23935	821	25	2	3	0	851
23936	33	808	1	6	0	848
23937	15	770	2	3	0	790
23938	740	22	8	3	0	773
23939	27	716	3	6	0	752
23940	7	754	1	3	0	765
23941	751	23	2	3	0	779
23942	760	6	2	4	0	772
23943	24	8	2	735	0	769
23944	15	5	0	763	0	783
23945	758	6	1	24	0	789
23946	790	3	2	7	0	802
23947	770	5	4	6	0	785
23948	28	9	736	1	0	774
23949	764	10	16	3	0	793
23950	32	5	5	764	0	806
23951	14	4	2	784	0	804
23952	13	6	3	788	0	810
23953	13	4	3	785	0	805
23954	15	1	751	26	0	793
23955	10	5	770	8	0	793
23956	9	6	25	764	0	804
23957	10	7	759	24	0	800
23958	18	1	761	6	0	786
23959	8	5	22	757	0	792
23960	8	7	4	791	0	810
23961	15	1	4	813	0	833
23962	11	6	5	799	0	821
23963	794	4	2	26	0	826
23964	829	9	3	11	0	852
23965	34	6	4	794	0	838
23966	20	4	2	800	0	826
23967	17	4	6	814	0	841
23968	10	9	4	810	0	833
23969	21	3	1	796	0	821
23970	14	778	3	28	0	823
23971	789	23	7	9	0	828
23972	28	787	1	12	0	828
23973	791	29	3	8	0	831
23974	802	9	2	9	0	822
23975	799	7	1	11	0	818
23976	41	6	2	764	0	813
23977	771	4	5	25	0	805
23978	32	5	4	748	0	789
23979	11	6	4	763	0	784
23980	771	4	1	25	0	801
23981	30	735	1	13	0	779
23982	9	679	1	7	0	696
23983	648	17	2	5	0	672
23984	25	3	638	3	0	669
23985	614	6	15	6	0	641
23986	25	8	2	628	0	663
23987	8	600	0	16	0	624
23988	6	616	1	9	0	632
23989	598	15	3	5	0	621
23990	15	9	1	596	0	621
23991	7	635	0	14	0	656
23992	615	13	5	5	0	638
23993	623	5	1	2	0	631
23994	612	1	0	4	0	617
23995	617	3	0	6	0	626
23996	15	593	0	5	0	613
23997	6	588	1	7	0	602
23998	603	12	0	2	0	617
23999	609	1	0	5	0	615
24000	11	3	569	1	0	584
24001	1	545	7	2	0	555
24002	518	4	1	0	0	523
24003	581	0	0	2	0	583
24004	4	1	569	1	0	575
24005	543	0	4	3	0	550
24006	6	0	589	1	0	596
24007	1	0	669	0	0	670
24008	1	0	10	617	0	628
24009	0	640	3	11	0	654
24010	680	11	4	6	0	701
24011	13	4	0	675	0	692
24012	5	4	0	683	0	692
24013	5	0	1	696	0	702
24014	678	1	1	20	0	700
24015	13	0	2	690	0	705
24016	5	1	0	706	0	712
24017	6	1	696	16	0	719
24018	686	0	14	8	0	708
24019	694	0	6	5	0	705
24020	18	1	702	1	0	722
24021	674	0	13	2	0	689
24022	19	2	5	679	0	705
24023	7	687	4	13	0	711
24024	5	13	1	698	0	717
24025	686	3	2	18	0	709
24026	12	697	2	7	0	718
24027	8	13	0	709	0	730
24028	3	5	3	718	0	729
24029	5	3	0	712	0	720
24030	2	1	2	698	0	703
24031	2	698	0	22	0	722
24032	686	13	2	10	0	711
24033	703	4	2	5	0	714
24034	19	736	0	2	0	757
24035	829	18	1	5	0	853
24036	893	7	2	2	0	904
24037	909	5	1	4	0	919
24038	40	3	872	2	0	917
24039	15	4	25	873	0	917
24040	15	1	836	26	0	878
24041	840	2	30	10	0	882
24042	26	857	7	12	0	902
24043	854	23	9	6	0	892
24044	38	845	4	3	0	890
24045	15	32	5	803	0	855
24046	11	10	3	831	0	855
24047	9	12	816	31	0	868
24048	12	822	25	13	0	872
24049	815	29	7	12	0	863
24050	27	10	813	5	0	855
24051	820	11	28	5	0	864
24052	36	6	8	822	0	872
24053	12	7	831	29	0	879
24054	15	828	27	11	0	881
24055	7	27	11	821	0	866
24056	6	10	827	29	0	872
24057	5	9	824	11	0	849
24058	7	825	32	14	0	878
24059	7	24	16	804	0	851
24060	3	9	17	797	0	826
24061	7	797	6	27	0	837
24062	799	26	5	23	0	853
24063	27	11	8	791	0	837
24064	12	788	9	29	0	838
24065	808	26	5	13	0	852
24066	817	12	5	13	0	847
24067	821	15	8	12	0	856
24068	39	804	7	12	0	862
24069	822	27	7	7	0	863
24070	845	11	7	8	0	871
24071	40	18	2	800	0	860
24072	825	10	5	24	0	864
24073	47	9	1	823	0	880
24074	15	8	799	42	0	864
24075	17	7	843	20	0	887
24076	13	4	33	852	0	902
24077	18	6	842	29	0	895
24078	828	9	35	16	0	888
24079	37	3	13	860	0	913
24080	18	6	16	866	0	906
24081	22	2	839	41	0	904
24082	11	808	34	22	0	875
24083	10	871	14	18	0	913
24084	9	33	13	841	0	896
24085	9	16	10	841	0	876
24086	5	18	817	37	0	877
24087	12	5	822	21	0	860
24088	12	8	35	829	0	884
24089	8	8	848	33	0	897
24090	814	9	35	18	0	876
24091	38	6	16	809	0	869
24092	806	5	15	42	0	868
24093	37	9	11	803	0	860
24094	17	11	10	835	0	873
24095	21	5	796	45	0	867
24096	12	804	35	24	0	875
24097	10	31	15	808	0	864
24098	12	13	799	42	0	866
24099	12	791	34	19	0	856
24100	11	29	16	808	0	864
24101	792	12	16	41	0	861
24102	36	12	788	19	0	855
24103	698	8	33	19	0	758
24104	38	7	725	8	0	778
24105	674	4	38	11	0	727
24106	35	687	15	7	0	744
24107	12	626	11	8	0	657
24108	13	20	5	587	0	625
24109	8	606	6	21	0	641
24110	611	24	6	12	0	653
24111	21	12	7	612	0	652
24112	10	11	5	626	0	652
24113	10	7	0	631	0	648
24114	4	5	599	31	0	639
24115	5	6	19	597	0	627
24116	2	7	599	25	0	633
24117	6	574	25	12	0	617
24118	547	14	9	16	0	586
24119	17	571	11	7	0	606
24120	580	19	4	10	0	613
24121	588	7	5	8	0	608
24122	587	6	3	11	0	607
24123	572	4	7	8	0	591
24124	27	5	551	5	0	588
24125	15	7	17	550	0	589
24126	10	5	8	536	0	559
24127	8	3	9	566	0	586
24128	497	5	6	24	0	532
24129	522	5	3	14	0	544
24130	33	563	2	12	0	610
24131	13	16	550	4	0	583
24132	15	6	562	3	0	586
24133	6	552	16	9	0	583
24134	8	540	11	5	0	564
24135	28	12	18	397	0	455
24136	2	3	2	389	0	396
24137	391	1	2	8	0	402
24138	3	400	4	7	0	414
24139	3	4	2	412	0	421
24140	1	3	413	6	0	423
24141	1	2	4	423	0	430
24142	2	0	3	430	0	435
24143	4	1	0	437	0	442
24144	1	1	2	435	0	439
24145	2	1	428	8	0	439
24146	0	406	6	5	0	417
24147	1	429	4	2	0	436
24148	406	7	2	1	0	416
24149	4	418	0	4	0	426
24150	4	442	2	2	0	450
24151	2	8	2	430	0	442
24152	3	4	0	438	0	445
24153	1	3	2	439	0	445
24154	4	1	436	7	0	448
24155	1	431	4	7	0	443
24156	0	6	4	430	0	440
24157	2	432	2	8	0	444
24158	440	7	2	5	0	454
24159	7	438	1	4	0	450
24160	437	6	5	4	0	452
24161	7	6	432	1	0	446
24162	430	2	5	3	0	440
24163	7	4	3	441	0	455
24164	4	1	439	6	0	450
24165	408	3	5	5	0	421
24166	427	1	4	3	0	435
24167	431	1	2	3	0	437
24168	9	1	3	417	0	430
24169	4	3	438	8	0	453
24170	420	0	6	5	0	431
24171	6	3	2	454	0	465
24172	9	0	3	461	0	473
24173	5	1	464	10	0	480
24174	3	451	7	10	0	471
24175	1	8	5	435	0	449
24176	4	445	4	4	0	457
24177	433	15	0	7	0	455
24178	441	2	2	3	0	448
24179	10	7	1	437	0	455
24180	452	1	2	8	0	463
24181	11	448	1	8	0	468
24182	451	6	1	5	0	463
24183	9	452	1	3	0	465
24184	5	6	1	455	0	467
24185	4	1	0	463	0	468
24186	2	467	2	7	0	478
24187	0	7	1	475	0	483
24188	1	4	466	9	0	480
24189	0	439	7	1	0	447
24190	425	3	1	0	0	429
24191	3	434	0	2	0	439
24192	1	3	0	429	0	433
24193	1	1	434	3	0	439
24194	0	2	3	444	0	449
24195	0	0	1	446	0	447
24196	436	1	1	5	0	443
24197	4	1	438	2	0	445
24198	2	449	3	1	0	455
24199	0	5	475	1	0	481
24200	2	1	471	0	0	474
24201	0	2	478	1	0	481
24202	7	0	8	467	0	482
24203	492	1	1	11	0	505
24204	7	494	1	2	0	504
24205	500	9	0	2	0	511
24206	535	2	0	1	0	538
24207	9	1	0	515	0	525
24208	2	518	1	7	0	528
24209	518	10	0	1	0	529
24210	8	525	0	0	0	533
24211	1	9	1	527	0	538
24212	1	1	0	544	0	546
24213	0	541	2	8	0	551
24214	0	8	2	547	0	557
24215	1	1	529	8	0	539
24216	2	0	541	1	0	544
24217	1	0	10	529	0	540
24218	0	2	0	536	0	538
24219	2	1	520	9	0	532
24220	2	0	514	2	0	518
24221	470	0	11	2	0	483
24222	7	507	1	2	0	517
24223	4	545	1	0	0	550
24224	1	13	0	525	0	539
24225	1	1	0	540	0	542
24226	1	1	1	541	0	544
24227	1	1	531	11	0	544
24228	1	2	525	3	0	531
24229	3	0	9	533	0	545
24230	1	1	509	8	0	519
24231	0	505	8	3	0	516
24232	484	8	3	3	0	498
24233	9	4	485	0	0	498
24234	1	1	491	1	0	494
24235	1	0	10	495	0	506
24236	1	2	543	9	0	555
24237	0	548	10	4	0	562
24238	2	9	3	557	0	571
24239	3	2	566	10	0	581
24240	1	558	12	3	0	574
24241	548	13	2	3	0	566
24242	11	3	3	549	0	566
24243	2	3	2	561	0	568
24244	555	0	3	14	0	572
24245	10	558	1	8	0	577
24246	567	11	1	4	0	583
24247	576	2	1	3	0	582
24248	578	3	3	1	0	585
24249	14	1	2	565	0	582
24250	537	1	2	11	0	551
24251	11	527	1	2	0	541
24252	3	545	2	4	0	554
24253	555	9	3	1	0	568
24254	10	4	1	559	0	574
24255	4	4	0	565	0	573
24256	2	3	0	573	0	578
24257	0	2	556	16	0	574
24258	2	555	11	6	0	574
24259	0	10	5	560	0	575
24260	557	4	4	13	0	578
24261	14	3	1	559	0	577
24262	3	1	555	15	0	574
24263	3	550	13	6	0	572
24264	557	11	2	3	0	573
24265	558	5	3	1	0	567
24266	567	6	1	1	0	575
24267	17	0	3	566	0	586
24268	9	3	572	13	0	597
24269	3	1	595	6	0	605
24270	2	614	18	5	0	639
24271	2	12	9	594	0	617
24272	1	4	4	610	0	619
24273	584	4	3	17	0	608
24274	13	2	2	605	0	622
24275	623	1	0	18	0	642
24276	18	3	620	5	0	646
24277	3	0	624	5	0	632
24278	9	4	16	605	0	634
24279	5	2	4	635	0	646
24280	7	2	4	633	0	646
24281	644	1	2	22	0	669
24282	682	0	4	9	0	695
24283	23	4	1	684	0	712
24284	10	2	667	22	0	701
24285	5	1	686	9	0	701
24286	4	1	25	686	0	716
24287	688	0	9	26	0	723
24288	21	2	8	679	0	710
24289	11	2	6	710	0	729
24290	8	2	697	29	0	736
24291	2	0	716	15	0	733
24292	674	1	28	10	0	713
24293	22	0	692	7	0	721
24294	8	2	26	648	0	684
24295	13	1	7	669	0	690
24296	658	0	8	28	0	694
24297	22	649	4	15	0	690
24298	658	22	8	9	0	697
24299	24	630	4	5	0	663
24300	626	20	4	3	0	653
24301	24	6	614	2	0	646
24302	577	8	21	7	0	613
24303	595	1	7	7	0	610
24304	25	3	9	579	0	616
24305	11	3	574	19	0	607
24306	11	3	19	545	0	578
24307	5	3	6	563	0	577
24308	4	547	7	25	0	583
24309	7	17	4	532	0	560
24310	5	548	5	25	0	583
24311	6	21	3	537	0	567
24312	533	6	2	25	0	566
24313	21	7	6	533	0	567
24314	8	2	527	28	0	565
24315	521	1	18	13	0	553
24316	23	3	540	8	0	574
24317	531	2	20	9	0	562
24318	546	2	8	5	0	561
24319	24	539	7	6	0	576
24320	15	570	2	5	0	592
24321	563	24	5	5	0	597
24322	583	8	6	7	0	604
24323	577	6	2	7	0	592
24324	570	4	5	6	0	585
24325	574	1	4	6	0	585
24326	37	2	2	543	0	584
24327	15	4	3	562	0	584
24328	11	6	541	27	0	585
24329	538	0	20	11	0	569
24330	26	2	9	546	0	583
24331	12	3	7	563	0	585
24332	16	3	541	25	0	585
24333	9	513	24	15	0	561
24334	7	552	6	12	0	577
24335	533	25	6	12	0	576
24336	496	10	7	3	0	516
24337	35	476	4	2	0	517
24338	13	469	4	5	0	491
24339	453	23	1	9	0	486
24340	463	7	5	9	0	484
24341	24	6	6	445	0	481
24342	12	4	4	477	0	497
24343	14	1	1	486	0	502
24344	464	3	3	32	0	502
24345	474	4	2	12	0	492
24346	24	8	3	467	0	502
24347	492	5	0	23	0	520
24348	31	3	480	7	0	521
24349	14	1	20	491	0	526
24350	6	3	488	28	0	525
24351	7	482	24	12	0	525
24352	5	24	10	466	0	505
24353	464	6	3	21	0	494
24354	25	2	3	462	0	492
24355	9	2	2	474	0	487
24356	5	1	458	30	0	494
24357	5	2	458	14	0	479
24358	4	473	26	9	0	512
24359	474	25	10	2	0	511
24360	491	7	4	7	0	509
24361	497	4	4	3	0	508
24362	508	1	3	6	0	518
24363	34	1	1	487	0	523
24364	12	2	4	498	0	516
24365	5	489	7	27	0	528
24366	487	23	1	10	0	521
24367	493	7	3	7	0	510
24368	32	2	460	5	0	499
24369	398	1	18	3	0	420
24370	22	401	5	2	0	430
24371	11	21	3	382	0	417
24372	7	397	3	20	0	427
24373	397	21	0	8	0	426
24374	22	391	0	3	0	416
24375	9	18	1	368	0	396
24376	7	5	1	378	0	391
24377	2	3	2	366	0	373
24378	2	347	0	23	0	372
24379	1	22	3	356	0	382
24380	4	12	1	352	0	369
24381	3	309	0	22	0	334
24382	2	292	0	9	0	303
24383	270	13	2	5	0	290
24384	11	274	1	2	0	288
24385	260	10	0	2	0	272
24386	10	4	255	2	0	271
24387	6	252	8	0	0	266
24388	249	7	3	3	0	262
24389	251	3	2	2	0	258
24390	10	2	252	3	0	267
24391	3	3	7	243	0	256
24392	2	1	247	9	0	259
24393	2	245	9	2	0	258
24394	241	9	3	3	0	256
24395	7	249	1	3	0	260
24396	4	9	2	244	0	259
24397	3	5	0	254	0	262
24398	1	3	245	11	0	260
24399	1	4	238	3	0	246
24400	230	3	8	2	0	243
24401	250	1	3	1	0	255
24402	247	0	3	1	0	251
24403	248	0	1	3	0	252
24404	12	242	1	4	0	259
24405	5	10	0	241	0	256
24406	6	3	0	246	0	255
24407	2	249	0	13	0	264
24408	253	9	1	4	0	267
24409	253	3	2	2	0	260
24410	11	2	253	3	0	269
24411	251	2	11	2	0	266
24412	12	4	2	252	0	270
24413	6	0	252	10	0	268
24414	4	4	8	251	0	267
24415	3	0	248	13	0	264
24416	1	2	249	7	0	259
24417	1	1	10	237	0	249
24418	1	246	5	7	0	259
24419	249	7	3	3	0	262
24420	242	4	1	2	0	249
24421	10	251	1	3	0	265
24422	6	254	1	1	0	262
24423	253	8	0	1	0	262
24424	252	3	0	4	0	259
24425	261	1	2	2	0	266
24426	259	5	1	1	0	266
24427	12	0	1	253	0	266
24428	6	0	256	5	0	267
24429	2	255	7	4	0	268
24430	247	7	2	0	0	256
24431	8	252	1	2	0	263
24432	253	4	3	1	0	261
24433	252	5	1	2	0	260
24434	10	1	264	0	0	275
24435	3	265	4	0	0	272
24436	5	4	2	266	0	277
24437	2	6	0	268	0	276
24438	4	0	1	258	0	263
24439	268	3	0	8	0	279
24440	262	1	3	4	0	270
24441	269	3	1	3	0	276
24442	6	252	0	2	0	260
24443	251	4	0	1	0	256
24444	7	252	0	1	0	260
24445	7	3	249	0	0	259
24446	1	255	3	1	0	260
24447	2	3	4	225	0	234
24448	0	4	0	227	0	231
24449	2	1	223	4	0	230
24450	1	4	3	215	0	223
24451	3	0	2	226	0	231
24452	222	1	1	5	0	229
24453	218	0	2	2	0	222
24454	222	1	0	3	0	226
24455	4	222	3	2	0	231
24456	219	4	0	3	0	226
24457	217	1	1	3	0	222
24458	4	209	2	1	0	216
24459	3	5	0	214	0	222
24460	4	2	0	215	0	221
24461	214	1	0	4	0	219
24462	5	1	210	1	0	217
24463	2	201	3	1	0	207
24464	1	3	1	196	0	201
24465	1	197	0	2	0	200
24466	0	208	2	3	0	213
24467	200	4	0	7	0	211
24468	209	1	1	1	0	212
24469	3	1	1	207	0	212
24470	2	1	1	204	0	208
24471	0	0	0	212	0	212
24472	0	1	0	209	0	210
24473	2	1	205	3	0	211
24474	2	0	196	1	0	199
24475	2	0	2	205	0	209
24476	0	1	208	4	0	213
24477	1	211	3	3	0	218
24478	223	2	1	2	0	228
24479	228	2	1	1	0	232
24480	6	0	2	228	0	236
24481	4	0	1	227	0	232
24482	2	0	1	230	0	233
24483	0	224	2	13	0	239
24484	229	5	0	3	0	237
24485	234	2	0	3	0	239
24486	6	2	225	1	0	234
24487	4	1	3	247	0	255
24488	3	0	258	5	0	266
24489	1	1	4	262	0	268
24490	2	1	2	250	0	255
24491	1	0	2	256	0	259
24492	2	0	1	260	0	263
24493	257	0	1	8	0	266
24494	263	0	2	5	0	270
24495	274	0	2	2	0	278
24496	7	0	0	274	0	281
24497	4	0	257	6	0	267
24498	247	1	3	4	0	255
24499	5	1	2	253	0	261
24500	257	0	2	3	0	262
24501	7	0	0	254	0	261
24502	3	237	1	7	0	248
24503	2	252	1	3	0	258
24504	1	5	1	261	0	268
24505	2	4	0	263	0	269
24506	2	0	0	264	0	266
24507	2	253	0	9	0	264
24508	255	5	0	8	0	268
24509	6	268	3	2	0	279
24510	2	10	257	4	0	273
24511	2	2	6	255	0	265
24512	0	269	3	8	0	280
24513	0	6	3	272	0	281
24514	3	4	0	273	0	280
24515	2	3	266	11	0	282
24516	248	1	12	7	0	268
24517	9	281	3	7	0	300
24518	286	8	4	1	0	299
24519	284	3	0	3	0	290
24520	282	2	1	5	0	290
24521	15	0	265	1	0	281
24522	8	0	10	261	0	279
24523	4	5	3	274	0	286
24524	4	1	261	13	0	279
24525	235	2	11	6	0	254
24526	12	3	255	5	0	275
24527	3	1	261	6	0	271
24528	2	253	11	5	0	271
24529	2	8	4	261	0	275
24530	1	5	254	10	0	270
24531	238	3	12	1	0	254
24532	255	1	1	3	0	260
24533	10	3	252	1	0	266
24534	4	0	12	241	0	257
24535	4	2	247	12	0	265
24536	1	259	12	4	0	276
24537	265	9	3	4	0	281
24538	271	3	3	1	0	278
24539	275	3	2	1	0	281
24540	17	2	2	257	0	278
24541	8	1	0	274	0	283
24542	5	0	259	13	0	277
24543	249	1	12	7	0	269
24544	13	2	1	259	0	275
24545	252	0	5	13	0	270
24546	15	0	248	3	0	266
24547	3	0	267	3	0	273
24548	5	0	15	250	0	270
24549	1	3	6	261	0	271
24550	1	0	256	14	0	271
24551	242	1	15	6	0	264
24552	15	2	2	247	0	266
24553	5	263	3	11	0	282
24554	266	12	3	2	0	283
24555	15	272	0	4	0	291
24556	281	13	3	2	0	299
24557	14	3	290	1	0	308
24558	3	2	293	1	0	299
24559	5	287	9	2	0	303
24560	293	11	4	2	0	310
24561	14	1	292	1	0	308
24562	284	2	9	3	0	298
24563	13	295	5	1	0	314
24564	3	10	3	309	0	325
24565	1	3	1	310	0	315
24566	3	310	3	10	0	326
24567	315	10	3	5	0	333
24568	321	1	2	5	0	329
24569	321	4	1	3	0	329
24570	14	0	316	3	0	333
24571	4	1	14	312	0	331
24572	5	0	3	324	0	332
24573	1	2	5	327	0	335
24574	2	3	314	14	0	333
24575	5	306	9	6	0	326
24576	298	13	2	2	0	315
24577	16	3	295	1	0	315
24578	286	2	12	1	0	301
24579	11	294	3	2	0	310
24580	294	12	1	2	0	309
24581	12	0	2	294	0	308
24582	302	2	4	9	0	317
24583	15	1	2	308	0	326
24584	2	2	320	9	0	333
24585	2	1	11	314	0	328
24586	2	0	312	13	0	327
24587	276	2	10	3	0	291
24588	12	287	1	2	0	302
24589	5	10	1	273	0	289
24590	3	281	3	5	0	292
24591	277	10	4	1	0	292
24592	284	0	2	3	0	289
24593	8	289	2	1	0	300
24594	281	15	0	2	0	298
24595	293	1	4	2	0	300
24596	14	1	3	283	0	301
24597	3	2	2	297	0	304
24598	290	1	4	11	0	306
24599	299	1	2	2	0	304
24600	13	2	3	283	0	301
24601	4	1	1	343	0	349
24602	345	1	2	14	0	362
24603	15	1	348	2	0	366
24604	324	1	10	3	0	338
24605	10	2	340	3	0	355
24606	5	327	10	4	0	346
24607	3	9	7	325	0	344
24608	8	1	339	8	0	356
24609	1	357	11	6	0	375
24610	351	8	2	1	0	362
24611	8	2	361	2	0	373
24612	348	0	9	2	0	359
24613	362	1	2	5	0	370
24614	373	2	0	2	0	377
24615	10	1	4	350	0	365
24616	6	359	2	6	0	373
24617	343	8	2	4	0	357
24618	10	4	342	1	0	357
24619	326	1	7	3	0	337
24620	11	3	349	1	0	364
24621	3	347	4	3	0	357
24622	2	4	1	343	0	350
24623	3	1	2	344	0	350
24624	1	345	3	9	0	358
24625	3	6	2	339	0	350
24626	1	2	345	6	0	354
24627	3	351	4	3	0	361
24628	0	8	3	346	0	357
24629	342	3	1	7	0	353
24630	354	3	2	3	0	362
24631	11	0	1	354	0	366
24632	2	378	2	7	0	389
24633	5	6	0	374	0	385
24634	4	1	1	388	0	394
24635	4	0	374	10	0	388
24636	1	378	6	5	0	390
24637	2	5	1	375	0	383
24638	3	1	367	6	0	377
24639	1	368	5	6	0	380
24640	1	4	1	375	0	381
24641	382	2	2	6	0	392
24642	9	393	1	1	0	404
24643	2	6	2	412	0	422
24644	419	4	1	8	0	432
24645	427	2	1	3	0	433
24646	426	1	0	4	0	431
24647	423	1	3	3	0	430
24648	7	3	1	415	0	426
24649	4	1	424	7	0	436
24650	4	1	6	410	0	421
24651	3	418	2	7	0	430
24652	421	4	0	5	0	430
24653	12	1	406	0	0	419
24654	383	1	7	4	0	395
24655	6	3	401	3	0	413
24656	3	0	6	387	0	396
24657	1	0	384	6	0	391
24658	2	1	7	374	0	384
24659	1	1	371	6	0	379
24660	1	1	5	373	0	380
24661	378	1	4	5	0	388
24662	5	420	1	4	0	430
24663	2	5	1	420	0	428
24664	5	1	0	414	0	420
24665	3	1	438	6	0	448
24666	2	1	408	2	0	413
24667	404	0	7	3	0	414
24668	7	421	2	2	0	432
24669	418	5	2	2	0	427
24670	434	2	1	2	0	439
24671	10	0	2	423	0	435
24672	2	431	2	5	0	440
24673	446	5	0	4	0	455
24674	447	3	4	1	0	455
24675	453	0	0	4	0	457
24676	455	2	2	0	0	459
24677	455	0	1	1	0	457
24678	7	0	444	0	0	451
24679	439	0	4	2	0	445
24680	8	1	445	0	0	454
24681	3	1	6	432	0	442
24682	2	1	4	446	0	453
24683	2	0	436	10	0	448
24684	432	1	7	1	0	441
24685	7	1	2	436	0	446
24686	3	0	1	450	0	454
24687	1	3	1	458	0	463
24688	2	0	1	451	0	454
24689	2	0	1	462	0	465
24690	1	1	464	8	0	474
24691	1	3	6	459	0	469
24692	2	0	470	6	0	478
24693	2	2	446	3	0	453
24694	453	0	7	4	0	464
24695	480	1	1	1	0	483
24696	505	0	8	1	0	514
24697	9	2	541	1	0	553
24698	7	1	541	1	0	550
24699	1	0	570	1	0	572
24700	4	584	14	3	0	605
24701	7	12	6	570	0	595
24702	599	3	1	13	0	616
24703	16	1	1	623	0	641
24704	5	633	0	21	0	659
24705	638	19	1	6	0	664
24706	21	4	0	646	0	671
24707	5	651	0	18	0	674
24708	2	16	1	653	0	672
24709	1	3	2	644	0	650
24710	621	1	1	26	0	649
24711	20	1	1	619	0	641
24712	5	1	612	23	0	641
24713	4	0	19	607	0	630
24714	1	590	5	22	0	618
24715	2	622	2	4	0	630
24716	1	23	2	597	0	623
24717	1	7	2	612	0	622
24718	1	595	3	24	0	623
24719	3	610	0	6	0	619
24720	2	618	1	3	0	624
24721	2	23	1	569	0	595
24722	1	605	3	19	0	628
24723	603	21	2	5	0	631
24724	22	6	618	3	0	649
24725	5	4	19	609	0	637
24726	2	633	4	19	0	658
24727	625	19	2	6	0	652
24728	19	6	642	6	0	673
24729	6	648	22	1	0	677
24730	634	24	3	4	0	665
24731	21	625	5	3	0	654
24732	6	648	3	4	0	661
24733	5	24	8	620	0	657
24734	1	635	3	23	0	662
24735	637	21	5	6	0	669
24736	21	6	1	632	0	660
24737	5	5	628	20	0	658
24738	4	1	639	5	0	649
24739	1	8	23	633	0	665
24740	4	5	636	21	0	666
24741	2	3	20	633	0	658
24742	614	4	4	23	0	645
24743	21	2	609	6	0	638
24744	5	2	18	585	0	610
24745	4	597	5	16	0	622
24746	2	20	3	602	0	627
24747	1	5	2	611	0	619
24748	2	593	4	23	0	622
24749	2	19	1	607	0	629
24750	1	7	2	619	0	629
24751	0	7	599	24	0	630
24752	3	597	18	8	0	626
24753	597	24	4	3	0	628
24754	20	5	4	606	0	635
24755	4	3	611	22	0	640
24756	2	5	18	598	0	623
24757	2	2	608	22	0	634
24758	582	2	17	12	0	613
24759	20	619	6	2	0	647
24760	6	21	3	626	0	656
24761	5	6	2	643	0	656
24762	576	5	4	25	0	610
24763	21	2	1	590	0	614
24764	6	10	577	23	0	616
24765	4	3	20	550	0	577
24766	4	544	6	22	0	576
24767	1	570	3	8	0	582
24768	3	585	5	3	0	596
24769	3	28	2	567	0	600
24770	2	9	558	19	0	588
24771	1	566	20	11	0	598
24772	544	22	6	9	0	581
24773	20	557	3	11	0	591
24774	579	20	4	5	0	608
24775	594	8	2	5	0	609
24776	23	7	564	3	0	597
24777	572	3	18	7	0	600
24778	606	5	4	5	0	620
24779	567	5	3	7	0	582
24780	599	0	3	8	0	610
24781	25	4	581	3	0	613
24782	569	5	18	5	0	597
24783	596	7	4	2	0	609
24784	25	601	1	3	0	630
24785	7	20	2	591	0	620
24786	5	9	3	604	0	621
24787	4	582	3	24	0	613
24788	581	23	3	8	0	615
24789	18	587	2	4	0	611
24790	577	27	1	4	0	609
24791	590	6	1	2	0	599
24792	28	578	4	2	0	612
24793	9	20	3	580	0	612
24794	6	5	595	21	0	627
24795	4	572	22	6	0	604
24796	4	22	2	526	0	554
24797	2	532	5	12	0	551
24798	2	582	2	2	0	588
24799	6	32	10	525	0	573
24800	2	9	547	20	0	578
24801	2	508	17	10	0	537
24802	1	512	6	1	0	520
24803	455	17	6	5	0	483
24804	10	6	2	459	0	477
24805	5	4	0	456	0	465
24806	1	2	0	468	0	471
24807	2	2	459	18	0	481
24808	1	1	13	465	0	480
24809	2	465	7	21	0	495
24810	497	19	1	7	0	524
24811	17	6	2	500	0	525
24812	6	2	505	19	0	532
24813	515	5	17	6	0	543
24814	19	2	6	540	0	567
24815	8	2	573	18	0	601
24816	3	2	580	8	0	593
24817	582	0	23	5	0	610
24818	603	1	9	5	0	618
24819	611	2	4	0	0	617
24820	616	1	3	4	0	624
24821	29	4	595	0	0	628
24822	13	585	19	8	0	625
24823	599	19	7	4	0	629
24824	21	584	3	2	0	610
24825	582	18	3	4	0	607
24826	19	589	1	4	0	613
24827	9	21	5	587	0	622
24828	3	11	5	582	0	601
24829	9	1	1	580	0	591
24830	4	559	1	23	0	587
24831	5	577	2	12	0	596
24832	5	26	2	543	0	576
24833	2	549	7	21	0	579
24834	5	24	549	10	0	588
24835	7	8	16	533	0	564
24836	3	8	539	19	0	569
24837	529	7	20	7	0	563
24838	539	5	10	6	0	560
24839	27	4	531	9	0	571
24840	10	3	544	8	0	565
24841	6	3	25	537	0	571
24842	5	8	549	19	0	581
24843	5	7	21	526	0	559
24844	4	510	11	24	0	549
24845	3	22	4	552	0	581
24846	5	7	8	560	0	580
24847	4	6	3	569	0	582
24848	3	6	540	29	0	578
24849	7	3	20	533	0	563
24850	5	5	9	549	0	568
24851	2	5	8	540	0	555
24852	6	535	9	22	0	572
24853	542	22	1	14	0	579
24854	548	9	6	8	0	571
24855	557	4	8	6	0	575
24856	26	9	3	535	0	573
24857	13	6	537	26	0	582
24858	12	4	545	12	0	573
24859	7	536	23	12	0	578
24860	511	22	15	6	0	554
24861	15	522	6	13	0	556
24862	522	22	4	11	0	559
24863	23	520	5	15	0	563
24864	524	25	3	6	0	558
24865	27	552	3	5	0	587
24866	15	21	5	543	0	584
24867	7	11	540	24	0	582
24868	8	5	549	16	0	578
24869	2	7	34	531	0	574
24870	4	4	14	540	0	562
24871	5	12	7	559	0	583
24872	11	2	541	33	0	587
24873	7	5	23	536	0	571
24874	511	1	14	28	0	554
24875	534	4	5	16	0	559
24876	30	523	7	9	0	569
24877	512	22	5	8	0	547
24878	28	516	4	7	0	555
24879	519	28	5	6	0	558
24880	532	8	5	7	0	552
24881	519	9	3	10	0	541
24882	33	5	492	8	0	538
24883	14	3	507	10	0	534
24884	476	3	33	6	0	518
24885	513	4	12	9	0	538
24886	32	5	5	495	0	537
24887	17	4	5	525	0	551
24888	5	8	4	537	0	554
24889	11	3	5	540	0	559
24890	5	6	1	560	0	572
24891	537	5	5	30	0	577
24892	26	7	2	541	0	576
24893	17	4	529	23	0	573
24894	497	7	21	10	0	535
24895	530	3	13	7	0	553
24896	32	518	3	11	0	564
24897	13	540	4	2	0	559
24898	469	12	3	4	0	488
24899	13	475	4	5	0	497
24900	472	10	1	4	0	487
24901	509	2	5	3	0	519
24902	518	1	1	5	0	525
24903	20	2	0	482	0	504
24904	5	490	0	16	0	511
24905	489	15	2	5	0	511
24906	17	3	1	493	0	514
24907	6	2	0	490	0	498
24908	466	1	0	18	0	485
24909	12	454	2	8	0	476
24910	3	10	1	446	0	460
24911	458	1	1	12	0	472
24912	10	452	1	2	0	465
24913	438	10	0	2	0	450
24914	12	2	405	1	0	420
24915	399	1	7	2	0	409
24916	10	427	1	1	0	439
24917	403	8	1	0	0	412
24918	419	1	0	1	0	421
24919	9	433	2	0	0	444
24920	430	7	0	3	0	440
24921	10	427	0	0	0	437
24922	441	10	0	1	0	452
24923	9	3	1	440	0	453
24924	4	1	0	444	0	449
24925	2	2	1	451	0	456
24926	3	1	425	9	0	438
24927	2	2	6	428	0	438
24928	3	0	443	10	0	456
24929	2	1	9	429	0	441
24930	1	434	1	9	0	445
24931	2	8	1	446	0	457
24932	2	3	441	10	0	456
24933	4	3	443	6	0	456
24934	3	1	9	447	0	460
24935	446	2	4	9	0	461
24936	446	0	0	4	0	450
24937	10	448	1	2	0	461
24938	6	10	0	451	0	467
24939	3	3	460	10	0	476
24940	3	2	10	450	0	465
24941	3	3	455	11	0	472
24942	430	3	12	2	0	447
24943	14	0	2	448	0	464
24944	6	1	449	10	0	466
24945	4	2	9	447	0	462
24946	3	4	1	457	0	465
24947	4	1	455	10	0	470
24948	3	1	9	456	0	469
24949	459	2	3	14	0	478
24950	472	0	2	5	0	479
24951	12	3	1	475	0	491
24952	479	1	3	13	0	496
24953	13	1	492	3	0	509
24954	2	2	490	6	0	500
24955	495	1	13	4	0	513
24956	515	1	4	5	0	525
24957	13	1	3	491	0	508
24958	4	1	3	500	0	508
24959	1	1	493	16	0	511
24960	5	1	13	473	0	492
24961	4	495	2	14	0	515
24962	504	11	2	6	0	523
24963	541	6	3	2	0	552
24964	15	543	3	5	0	566
24965	523	10	4	2	0	539
24966	525	5	3	3	0	536
24967	14	528	1	12	0	555
24968	539	11	2	3	0	555
24969	12	539	3	5	0	559
24970	540	13	5	2	0	560
24971	16	3	541	4	0	564
24972	6	5	12	521	0	544
24973	5	0	3	547	0	555
24974	2	2	5	558	0	567
24975	554	2	2	15	0	573
24976	13	1	0	576	0	590
24977	6	2	566	17	0	591
24978	578	1	12	7	0	598
24979	12	4	4	572	0	592
24980	7	563	4	13	0	587
24981	6	584	2	8	0	600
24982	5	15	2	586	0	608
24983	3	8	2	579	0	592
24984	6	2	3	587	0	598
24985	5	1	556	18	0	580
24986	4	556	16	6	0	582
24987	539	9	3	8	0	559
24988	542	5	2	3	0	552
24989	16	527	1	5	0	549
24990	5	550	2	4	0	561
24991	6	11	2	541	0	560
24992	1	5	542	12	0	560
24993	511	5	8	7	0	531
24994	534	3	3	3	0	543
24995	13	3	1	529	0	546
24996	6	1	4	528	0	539
24997	504	3	4	13	0	524
24998	10	1	519	11	0	541
24999	494	3	9	7	0	513
25000	11	510	3	4	0	528
25001	3	5	2	479	0	489
25002	2	472	4	7	0	485
25003	488	6	2	3	0	499
25004	8	1	2	478	0	489
25005	5	4	1	477	0	487
25006	4	479	1	8	0	492
25007	480	6	2	6	0	494
25008	481	1	1	5	0	488
25009	8	3	476	4	0	491
25010	5	1	459	4	0	469
25011	462	3	9	4	0	478
25012	9	1	469	1	0	480
25013	8	0	457	1	0	466
25014	443	2	9	3	0	457
25015	6	2	510	2	0	520
25016	4	1	9	500	0	514
25017	2	1	5	495	0	503
25018	542	0	4	12	0	558
25019	18	3	553	3	0	577
25020	586	0	17	2	0	605
25021	22	1	7	582	0	612
25022	592	1	3	20	0	616
25023	601	0	2	8	0	611
25024	607	0	2	3	0	612
25025	28	3	0	583	0	614
25026	592	1	1	21	0	615
25027	25	2	1	589	0	617
25028	12	1	2	590	0	605
25029	6	0	2	600	0	608
25030	5	1	0	604	0	610
25031	579	1	1	28	0	609
25032	590	1	2	12	0	605
25033	30	0	577	6	0	613
25034	583	0	19	9	0	611
25035	603	0	9	4	0	616
25036	30	2	3	569	0	604
25037	11	581	3	18	0	613
25038	582	17	4	9	0	612
25039	23	8	2	564	0	597
25040	571	3	2	22	0	598
25041	21	572	2	12	0	607
25042	577	18	3	6	0	604
25043	26	6	2	563	0	597
25044	13	578	1	17	0	609
25045	593	18	2	8	0	621
25046	23	576	1	8	0	608
25047	12	602	1	10	0	625
25048	597	25	2	6	0	630
25049	26	9	583	6	0	624
25050	593	6	17	5	0	621
25051	26	4	7	582	0	619
25052	15	3	584	21	0	623
25053	11	2	18	566	0	597
25054	10	3	7	580	0	600
25055	10	1	564	31	0	606
25056	572	3	19	16	0	610
25057	30	3	8	585	0	626
25058	17	0	4	598	0	619
25059	10	2	5	598	0	615
25060	577	3	5	32	0	617
25061	25	2	566	18	0	611
25062	12	1	569	14	0	596
25063	7	2	24	541	0	574
25064	8	2	541	21	0	572
25065	531	0	19	10	0	560
25066	19	536	12	9	0	576
25067	537	19	3	6	0	565
25068	25	7	5	511	0	548
25069	13	510	8	18	0	549
25070	8	24	2	512	0	546
25071	8	518	2	19	0	547
25072	6	16	5	523	0	550
25073	7	12	508	21	0	548
25074	6	5	503	13	0	527
25075	7	495	24	6	0	532
25076	473	20	7	7	0	507
25077	21	10	4	477	0	512
25078	11	3	5	483	0	502
25079	474	6	4	20	0	504
25080	486	3	1	10	0	500
25081	26	1	4	464	0	495
25082	11	4	464	20	0	499
25083	9	466	16	11	0	502
25084	7	17	8	465	0	497
25085	8	6	5	478	0	497
25086	3	473	2	27	0	505
25087	475	20	5	11	0	511
25088	21	9	475	6	0	511
25089	8	4	18	465	0	495
25090	8	3	10	460	0	481
25091	5	4	450	27	0	486
25092	8	3	20	457	0	488
25093	443	2	9	25	0	479
25094	454	4	5	14	0	477
25095	466	0	6	6	0	478
25096	27	449	5	4	0	485
25097	464	16	5	6	0	491
25098	22	10	1	445	0	478
25099	13	4	3	457	0	477
25100	8	487	1	25	0	521
25101	538	22	2	10	0	572
25102	581	8	3	8	0	600
25103	594	4	1	9	0	608
25104	605	5	3	8	0	621
25105	613	3	3	6	0	625
25106	38	4	578	3	0	623
25107	592	3	20	7	0	622
25108	604	2	14	8	0	628
25109	606	3	4	4	0	617
25110	36	1	4	566	0	607
25111	17	6	4	591	0	618
25112	9	0	559	33	0	601
25113	502	3	21	18	0	544
25114	21	558	14	6	0	599
25115	15	508	1	6	0	530
25116	7	24	486	5	0	522
25117	8	485	16	5	0	514
25118	1	455	9	5	0	470
25119	8	21	7	385	0	421
25120	3	409	2	4	0	418
25121	402	6	1	7	0	416
25122	405	9	0	3	0	417
25123	14	1	2	394	0	411
25124	10	1	392	6	0	409
25125	386	2	5	7	0	400
25126	9	0	404	0	0	413
25127	8	1	398	3	0	410
25128	2	1	13	381	0	397
25129	2	1	7	388	0	398
25130	2	2	388	11	0	403
25131	4	385	6	8	0	403
25132	3	409	8	2	0	422
25133	430	12	1	3	0	446
25134	431	9	3	1	0	444
25135	15	2	426	0	0	443
25136	423	5	6	2	0	436
25137	439	1	7	4	0	451
25138	16	0	2	438	0	456
25139	9	1	1	447	0	458
25140	3	1	1	454	0	459
25141	441	0	2	14	0	457
25142	451	3	1	10	0	465
25143	465	1	2	2	0	470
25144	16	1	0	434	0	451
25145	12	3	418	6	0	439
25146	413	0	7	6	0	426
25147	416	1	7	1	0	425
25148	11	3	4	401	0	419
25149	10	408	4	7	0	429
25150	6	5	1	411	0	423
25151	7	414	0	9	0	430
25152	6	7	1	411	0	425
25153	3	424	1	12	0	440
25154	405	9	4	8	0	426
25155	11	7	4	407	0	429
25156	12	395	2	5	0	414
25157	4	10	395	6	0	415
25158	385	7	10	4	0	406
25159	9	2	8	389	0	408
25160	7	397	4	8	0	416
25161	3	11	1	396	0	411
25162	5	389	0	9	0	403
25163	6	395	0	6	0	407
25164	387	13	2	7	0	409
25165	400	8	1	4	0	413
25166	13	4	405	3	0	425
25167	400	1	9	3	0	413
25168	408	2	7	2	0	419
25169	16	395	5	3	0	419
25170	8	6	4	405	0	423
25171	3	7	1	409	0	420
25172	4	2	401	13	0	420
25173	4	4	391	6	0	405
25174	390	5	12	5	0	412
25175	407	4	7	2	0	420
25176	417	0	3	3	0	423
25177	16	1	396	4	0	417
25178	11	3	10	389	0	413
25179	405	3	6	7	0	421
25180	11	4	2	406	0	423
25181	6	1	401	13	0	421
25182	383	4	5	12	0	404
25183	11	2	405	5	0	423
25184	11	400	7	3	0	421
25185	405	8	6	2	0	421
25186	9	7	399	4	0	419
25187	8	2	10	393	0	413
25188	404	1	10	7	0	422
25189	12	1	3	402	0	418
25190	414	1	1	10	0	426
25191	9	5	1	404	0	419
25192	406	4	2	12	0	424
25193	407	4	1	13	0	425
25194	406	2	2	4	0	414
25195	397	2	1	4	0	404
25196	16	6	3	382	0	407
25197	13	1	381	7	0	402
25198	6	2	378	8	0	394
25199	2	372	14	1	0	389
25200	3	306	8	2	0	319
25201	264	2	3	0	0	269
25202	2	2	0	253	0	257
25203	2	2	245	3	0	252
25204	1	0	245	2	0	248
25205	2	0	3	239	0	244
25206	242	0	1	4	0	247
25207	5	251	1	2	0	259
25208	263	3	0	2	0	268
25209	5	0	0	267	0	272
25210	1	1	1	270	0	273
25211	0	0	1	271	0	272
25212	1	1	267	4	0	273
25213	0	1	254	1	0	256
25214	1	261	4	2	0	268
25215	0	4	1	264	0	269
25216	253	0	1	4	0	258
25217	4	1	249	1	0	255
25218	1	1	269	2	0	273
25219	3	0	4	267	0	274
25220	0	1	1	278	0	280
25221	2	0	1	290	0	293
25222	0	1	0	296	0	297
25223	301	0	1	6	0	308
25224	5	0	1	307	0	313
25225	303	1	1	6	0	311
25226	5	0	306	3	0	314
25227	2	310	4	1	0	317
25228	1	4	2	305	0	312
25229	2	1	304	4	0	311
25230	0	1	316	1	0	318
25231	0	318	6	2	0	326
25232	0	4	0	294	0	298
25233	0	1	0	281	0	282
25234	1	0	283	6	0	290
25235	278	0	4	3	0	285
25236	6	0	1	288	0	295
25237	1	0	1	277	0	279
25238	2	0	298	5	0	305
25239	0	304	6	2	0	312
25240	0	346	2	0	0	348
25241	343	8	1	1	0	353
25242	7	2	1	336	0	346
25243	354	0	0	7	0	361
25244	9	1	350	2	0	362
25245	3	0	10	349	0	362
25246	353	0	2	9	0	364
25247	355	0	1	3	0	359
25248	11	0	0	350	0	361
25249	3	0	351	10	0	364
25250	1	1	360	2	0	364
25251	0	1	12	350	0	363
25252	2	1	352	7	0	362
25253	337	1	7	3	0	348
25254	9	344	2	1	0	356
25255	345	6	3	2	0	356
25256	364	2	2	1	0	369
25257	10	0	2	359	0	371
25258	3	0	1	365	0	369
25259	358	0	1	10	0	369
25260	9	1	1	357	0	368
25261	3	1	355	8	0	367
25262	2	365	7	3	0	377
25263	1	6	3	362	0	372
25264	1	2	0	373	0	376
25265	1	1	1	365	0	368
25266	3	1	351	9	0	364
25267	2	349	6	3	0	360
25268	1	7	4	352	0	364
25269	1	5	350	10	0	366
25270	3	0	7	347	0	357
25271	347	0	1	12	0	360
25272	9	0	1	354	0	364
25273	2	2	356	8	0	368
25274	340	1	9	5	0	355
25275	7	359	5	3	0	374
25276	4	374	2	2	0	382
25277	379	9	1	4	0	393
25278	9	4	383	3	0	399
25279	3	0	10	370	0	383
25280	3	1	4	390	0	398
25281	1	2	396	11	0	410
25282	4	390	9	3	0	406
25283	3	10	0	362	0	375
25284	3	2	386	10	0	401
25285	4	0	12	393	0	409
25286	390	2	2	15	0	409
25287	10	1	393	6	0	410
25288	6	3	10	395	0	414
25289	1	3	5	402	0	411
25290	3	2	391	17	0	413
25291	1	3	12	383	0	399
25292	3	356	7	13	0	379
25293	6	11	6	353	0	376
25294	4	393	1	14	0	412
25295	401	10	2	8	0	421
25296	400	3	5	5	0	413
25297	12	1	399	4	0	416
25298	4	1	401	6	0	412
25299	1	4	399	7	0	411
25300	4	392	13	5	0	414
25301	3	13	4	401	0	421
25302	5	4	419	10	0	438
25303	4	3	13	399	0	419
25304	3	2	4	414	0	423
25305	5	1	409	13	0	428
25306	4	2	10	406	0	422
25307	2	2	5	393	0	402
25308	5	394	5	14	0	418
25309	3	7	2	393	0	405
25310	2	4	4	403	0	413
25311	2	2	405	15	0	424
25312	3	1	10	398	0	412
25313	2	2	404	16	0	424
25314	2	2	409	5	0	418
25315	393	4	10	6	0	413
25316	12	4	4	384	0	404
25317	5	401	2	15	0	423
25318	4	400	3	9	0	416
25319	5	12	7	399	0	423
25320	2	2	390	12	0	406
25321	3	374	11	8	0	396
25322	2	10	6	375	0	393
25323	4	6	394	10	0	414
25324	3	407	9	2	0	421
25325	407	10	8	4	0	429
25326	415	1	4	3	0	423
25327	420	2	3	5	0	430
25328	9	2	3	455	0	469
25329	4	4	3	458	0	469
25330	1	1	3	460	0	465
25331	1	2	444	15	0	462
25332	434	1	11	9	0	455
25333	12	1	4	448	0	465
25334	3	2	440	16	0	461
25335	429	0	14	10	0	453
25336	443	0	7	7	0	457
25337	12	8	369	6	0	395
25338	408	0	15	6	0	429
25339	13	424	6	3	0	446
25340	5	7	401	6	0	419
25341	383	4	12	2	0	401
25342	11	399	3	3	0	416
25343	1	6	0	384	0	391
25344	0	395	1	5	0	401
25345	1	6	0	405	0	412
25346	0	2	412	6	0	420
25347	378	0	6	3	0	387
25348	5	2	420	0	0	427
25349	1	416	5	3	0	425
25350	0	421	4	2	0	427
25351	416	4	1	2	0	423
25352	7	1	422	0	0	430
25353	2	0	5	408	0	415
25354	1	1	419	6	0	427
25355	1	423	6	3	0	433
25356	2	5	3	396	0	406
25357	0	422	1	8	0	431
25358	448	7	2	1	0	458
25359	454	2	0	2	0	458
25360	449	2	0	1	0	452
25361	9	0	445	1	0	455
25362	4	1	423	0	0	428
25363	417	0	9	2	0	428
25364	10	0	449	0	0	459
25365	1	0	10	420	0	431
25366	0	441	4	5	0	450
25367	458	6	0	2	0	466
25368	452	2	2	0	0	456
25369	466	0	0	2	0	468
25370	8	1	1	461	0	471
25371	2	0	0	470	0	472
25372	461	0	0	9	0	470
25373	8	448	1	3	0	460
25374	450	7	0	2	0	459
25375	7	1	0	445	0	453
25376	2	1	0	444	0	447
25377	430	1	1	8	0	440
25378	7	425	0	4	0	436
25379	421	6	2	3	0	432
25380	5	410	0	2	0	417
25381	404	6	0	0	0	410
25382	6	2	0	452	0	460
25383	460	1	0	5	0	466
25384	478	1	0	1	0	480
25385	525	0	0	1	0	526
25386	11	547	0	1	0	559
25387	4	7	545	0	0	556
25388	542	2	8	2	0	554
25389	567	1	1	1	0	570
25390	10	559	1	2	0	572
25391	3	10	2	560	0	575
25392	3	3	2	566	0	574
25393	559	0	1	10	0	570
25394	12	2	1	559	0	574
25395	2	2	558	14	0	576
25396	3	0	546	5	0	554
25397	560	2	10	3	0	575
25398	13	1	2	572	0	588
25399	2	1	4	581	0	588
25400	5	0	4	578	0	587
25401	2	1	601	14	0	618
25402	3	0	12	589	0	604
25403	3	0	2	601	0	606
25404	3	1	1	605	0	610
25405	586	1	1	15	0	603
25406	11	1	3	600	0	615
25407	4	1	596	16	0	617
25408	607	2	11	6	0	626
25409	13	1	637	4	0	655
25410	671	3	12	5	0	691
25411	668	1	6	6	0	681
25412	20	3	3	671	0	697
25413	8	686	2	16	0	712
25414	4	12	5	693	0	714
25415	10	1	1	693	0	705
25416	3	704	4	20	0	731
25417	723	16	2	6	0	747
25418	13	721	2	8	0	744
25419	730	12	3	6	0	751
25420	729	4	5	4	0	742
25421	20	2	0	722	0	744
25422	9	3	1	718	0	731
25423	4	4	680	18	0	706
25424	5	1	649	10	0	665
25425	636	3	15	10	0	664
25426	658	0	8	10	0	676
25427	18	635	3	6	0	662
25428	3	9	4	621	0	637
25429	8	1	654	12	0	675
25430	6	1	10	657	0	674
25431	653	0	6	11	0	670
25432	639	3	2	3	0	647
25433	13	623	6	4	0	646
25434	8	10	3	629	0	650
25435	7	4	3	641	0	655
25436	4	3	2	646	0	655
25437	2	5	625	18	0	650
25438	555	4	11	8	0	578
25439	607	1	2	10	0	620
25440	11	7	595	5	0	618
25441	7	601	8	7	0	623
25442	595	12	4	3	0	614
25443	601	1	1	7	0	610
25444	15	0	576	6	0	597
25445	6	3	583	5	0	597
25446	6	3	14	565	0	588
25447	7	0	561	10	0	578
25448	553	3	13	3	0	572
25449	564	2	5	3	0	574
25450	585	4	3	6	0	598
25451	14	5	4	561	0	584
25452	5	593	5	13	0	616
25453	609	9	4	5	0	627
25454	602	3	3	6	0	614
25455	19	4	594	4	0	621
25456	8	3	582	6	0	599
25457	578	4	9	7	0	598
25458	17	0	2	595	0	614
25459	5	2	593	15	0	615
25460	6	582	13	8	0	609
25461	9	9	9	582	0	609
25462	589	1	7	11	0	608
25463	14	586	4	12	0	616
25464	7	9	8	582	0	606
25465	4	583	3	13	0	603
25466	7	604	6	7	0	624
25467	7	10	4	583	0	604
25468	1	6	5	583	0	595
25469	4	578	5	13	0	600
25470	588	14	3	6	0	611
25471	15	4	588	7	0	614
25472	587	3	12	6	0	608
25473	16	3	3	609	0	631
25474	9	5	2	610	0	626
25475	9	2	2	614	0	627
25476	9	6	4	601	0	620
25477	10	1	618	16	0	645
25478	4	3	16	615	0	638
25479	7	6	7	602	0	622
25480	7	625	5	17	0	654
25481	9	12	637	5	0	663
25482	3	661	15	7	0	686
25483	4	11	669	10	0	694
25484	5	671	13	3	0	692
25485	3	16	5	609	0	633
25486	610	1	3	12	0	626
25487	11	616	2	4	0	633
25488	2	13	2	617	0	634
25489	4	3	620	12	0	639
25490	1	651	18	4	0	674
25491	648	12	4	2	0	666
25492	669	3	4	2	0	678
25493	14	673	0	3	0	690
25494	5	10	657	2	0	674
25495	650	4	11	0	0	665
25496	11	4	3	676	0	694
25497	699	2	3	16	0	720
25498	13	716	1	2	0	732
25499	2	727	2	3	0	734
25500	2	13	727	3	0	745
25501	704	6	12	2	0	724
25502	17	4	2	716	0	739
25503	720	3	5	14	0	742
25504	13	733	1	5	0	752
25505	733	15	3	7	0	758
25506	729	7	0	3	0	739
25507	17	6	735	4	0	762
25508	10	703	13	4	0	730
25509	2	722	6	2	0	732
25510	5	15	7	659	0	686
25511	6	652	3	11	0	672
25512	666	11	2	6	0	685
25513	12	652	2	6	0	672
25514	7	21	4	624	0	656
25515	2	635	2	10	0	649
25516	4	610	1	4	0	619
25517	7	625	0	3	0	635
25518	3	13	3	616	0	635
25519	3	9	1	619	0	632
25520	5	4	1	613	0	623
25521	6	600	0	18	0	624
25522	3	11	610	4	0	628
25523	5	6	597	1	0	609
25524	591	8	11	1	0	611
25525	11	1	2	614	0	628
25526	4	7	620	9	0	640
25527	3	3	621	2	0	629
25528	1	637	11	1	0	650
25529	2	12	2	620	0	636
25530	1	7	0	633	0	641
25531	623	3	2	13	0	641
25532	13	7	1	617	0	638
25533	2	5	2	636	0	645
25534	0	2	653	18	0	673
25535	2	1	9	664	0	676
25536	1	5	2	705	0	713
25537	0	3	705	12	0	720
25538	0	1	708	7	0	716
25539	3	688	13	5	0	709
25540	1	10	701	7	0	719
25541	1	3	12	689	0	705
25542	7	5	14	530	0	556
25543	1	3	710	12	0	726
25544	1	707	9	8	0	725
25545	689	10	5	8	0	712
25546	12	706	3	7	0	728
25547	4	10	3	721	0	738
25548	2	5	3	717	0	727
25549	1	708	6	16	0	731
25550	2	12	1	700	0	715
25551	3	2	3	700	0	708
25552	1	0	685	17	0	703
25553	0	674	12	7	0	693
25554	0	12	9	683	0	704
25555	1	4	664	13	0	682
25556	3	2	10	673	0	688
25557	1	4	7	676	0	688
25558	1	3	7	686	0	697
25559	0	8	3	664	0	675
25560	5	4	6	660	0	675
25561	5	658	0	31	0	694
25562	665	9	2	12	0	688
25563	10	4	668	4	0	686
25564	576	9	9	7	0	601
25565	10	3	686	8	0	707
25566	4	685	13	7	0	709
25567	4	7	692	7	0	710
25568	0	711	9	8	0	728
25569	3	16	4	677	0	700
25570	1	3	6	712	0	722
25571	2	718	2	19	0	741
25572	2	736	3	9	0	750
25573	743	15	2	7	0	767
25574	776	6	4	8	0	794
25575	781	4	2	6	0	793
25576	795	4	2	6	0	807
25577	16	6	1	774	0	797
25578	6	780	4	12	0	802
25579	791	12	1	4	0	808
25580	10	4	4	762	0	780
25581	740	8	1	10	0	759
25582	706	1	3	4	0	714
25583	10	687	2	2	0	701
25584	5	676	0	3	0	684
25585	4	708	0	5	0	717
25586	2	13	0	680	0	695
25587	1	700	0	6	0	707
25588	702	7	0	4	0	713
25589	723	4	0	2	0	729
25590	709	2	0	0	0	711
25591	711	1	0	2	0	714
25592	713	0	0	2	0	715
25593	12	2	743	0	0	757
25594	739	1	4	0	0	744
25595	8	1	746	2	0	757
25596	730	1	6	0	0	737
25597	8	2	5	703	0	718
25598	6	2	686	4	0	698
25599	3	1	701	4	0	709
25600	2	731	7	2	0	742
25601	717	4	4	2	0	727
25602	736	4	2	0	0	742
25603	9	831	0	0	0	840
25604	5	5	0	971	0	981
25605	1075	5	0	6	0	1086
25606	14	3	1097	6	0	1120
25607	7	1083	13	7	0	1110
25608	1056	14	7	3	0	1080
25609	16	1081	5	0	0	1102
25610	9	19	3	1037	0	1068
25611	4	1086	0	15	0	1105
25612	6	19	0	1049	0	1074
25613	1	1072	0	16	0	1089
25614	2	1106	0	10	0	1118
25615	1080	24	2	5	0	1111
25616	1103	13	3	4	0	1123
25617	26	9	1113	2	0	1150
25618	18	4	1081	0	0	1103
25619	11	2	1106	3	0	1122
25620	6	5	27	1099	0	1137
25621	2	3	1146	17	0	1168
25622	2	5	26	1113	0	1146
25623	2	6	11	1111	0	1130
25624	4	1129	7	26	0	1166
25625	1125	17	4	14	0	1160
25626	20	1154	1	9	0	1184
25627	10	21	4	1186	0	1221
25628	8	15	4	1179	0	1206
25629	6	8	6	1185	0	1205
25630	3	7	1166	31	0	1207
25631	7	2	21	1152	0	1182
25632	4	2	13	1182	0	1201
25633	4	2	6	1189	0	1201
25634	3	4	1140	32	0	1179
25635	4	1111	18	21	0	1154
25636	1096	20	11	15	0	1142
25637	1059	16	6	12	0	1093
25638	28	1115	7	10	0	1160
25639	18	24	2	1110	0	1154
25640	10	9	8	1143	0	1170
25641	5	12	1124	27	0	1168
25642	6	1116	19	23	0	1164
25643	1	24	12	1131	0	1168
25644	3	11	1138	28	0	1180
25645	4	14	23	1116	0	1157
25646	7	7	9	1133	0	1156
25647	6	6	1145	30	0	1187
25648	5	10	20	1126	0	1161
25649	8	5	13	1130	0	1156
25650	8	5	1161	33	0	1207
25651	5	7	28	1160	0	1200
25652	5	5	14	1113	0	1137
25653	9	5	14	1171	0	1199
25654	1	3	1153	40	0	1197
25655	1	7	23	1156	0	1187
25656	1136	4	13	40	0	1193
25657	1141	5	12	24	0	1182
25658	25	1145	9	20	0	1199
25659	1170	23	4	13	0	1210
25660	29	12	1203	7	0	1251
25661	14	12	18	1213	0	1257
25662	8	7	15	1217	0	1247
25663	5	2	15	1246	0	1268
25664	1188	2	12	43	0	1245
25665	18	1185	6	35	0	1244
25666	11	20	3	1172	0	1206
25667	7	1189	8	31	0	1235
25668	1161	25	4	21	0	1211
25669	21	1179	9	11	0	1220
25670	1149	22	7	18	0	1196
25671	24	1143	5	12	0	1184
25672	17	1153	3	14	0	1187
25673	14	25	7	1141	0	1187
25674	9	15	4	1123	0	1151
25675	4	12	10	1120	0	1146
25676	3	9	6	1124	0	1142
25677	4	6	1098	39	0	1147
25678	4	1096	21	23	0	1144
25679	6	19	12	1065	0	1102
25680	5	1104	5	25	0	1139
25681	9	22	1099	18	0	1148
25682	6	22	16	1083	0	1127
25683	6	10	14	1116	0	1146
25684	3	11	1098	33	0	1145
25685	5	1051	18	31	0	1105
25686	2	24	14	1065	0	1105
25687	4	15	1057	27	0	1103
25688	3	1051	21	18	0	1093
25689	5	17	13	1032	0	1067
25690	3	15	1024	26	0	1068
25691	3	8	997	21	0	1029
25692	4	990	26	12	0	1032
25693	5	1016	11	12	0	1044
25694	7	25	13	1059	0	1104
25695	4	15	4	1127	0	1150
25696	3	9	1126	36	0	1174
25697	1083	7	24	29	0	1143
25698	1100	5	12	17	0	1134
25699	30	5	1099	16	0	1150
25700	11	1081	34	12	0	1138
25701	10	1107	13	7	0	1137
25702	7	1077	6	8	0	1098
25703	8	868	6	16	0	898
25704	16	59	8	782	0	865
25705	2	8	3	935	0	948
25706	3	4	0	967	0	974
25707	3	3	0	1009	0	1015
25708	1	1015	1	41	0	1058
25709	1	23	1	1024	0	1049
25710	0	1021	1	35	0	1057
25711	3	27	0	1046	0	1076
25712	1017	20	0	27	0	1064
25713	23	3	3	1039	0	1068
25714	14	1024	0	28	0	1066
25715	1	24	0	1039	0	1064
25716	4	18	0	1061	0	1083
25717	1	5	0	1075	0	1081
25718	1011	5	0	49	0	1065
25719	25	6	0	1058	0	1089
25720	15	2	1019	40	0	1076
25721	4	1033	25	28	0	1090
25722	5	31	16	1055	0	1107
25723	6	19	2	1096	0	1123
25724	3	7	2	1113	0	1125
25725	1052	7	1	61	0	1121
25726	28	3	1028	31	0	1090
25727	24	1	28	993	0	1046
25728	10	1007	19	37	0	1073
25729	7	27	6	1032	0	1072
25730	966	24	6	36	0	1032
25731	26	1012	5	28	0	1071
25732	20	36	2	1015	0	1073
25733	5	22	0	1040	0	1067
25734	6	1006	2	58	0	1072
25735	4	32	3	1039	0	1078
25736	5	20	1	1051	0	1077
25737	1	11	1010	57	0	1079
25738	0	1000	28	36	0	1064
25739	985	33	16	23	0	1057
25740	33	26	984	14	0	1057
25741	966	6	32	14	0	1018
25742	36	13	986	10	0	1045
25743	22	6	32	989	0	1049
25744	976	10	20	43	0	1049
25745	33	4	5	1012	0	1054
25746	1000	4	5	47	0	1056
25747	996	8	4	37	0	1045
25748	999	4	6	19	0	1028
25749	50	968	5	15	0	1038
25750	32	31	6	954	0	1023
25751	16	21	8	980	0	1025
25752	12	7	6	992	0	1017
25753	10	11	936	58	0	1015
25754	6	5	33	981	0	1025
25755	952	3	19	47	0	1021
25756	966	3	12	35	0	1016
25757	61	3	934	14	0	1012
25758	952	5	34	13	0	1004
25759	954	8	23	15	0	1000
25760	58	11	8	871	0	948
25761	884	8	4	46	0	942
25762	903	5	5	31	0	944
25763	50	8	5	885	0	948
25764	891	5	3	46	0	945
25765	893	5	6	30	0	934
25766	57	7	3	870	0	937
25767	32	12	699	43	0	786
25768	820	7	29	31	0	887
25769	50	3	855	12	0	920
25770	33	11	849	12	0	905
25771	21	816	52	27	0	916
25772	17	27	24	817	0	885
25773	16	22	10	847	0	895
25774	12	7	8	871	0	898
25775	15	3	819	64	0	901
25776	17	3	834	32	0	886
25777	14	823	46	22	0	905
25778	21	32	22	803	0	878
25779	11	22	18	845	0	896
25780	14	7	9	860	0	890
25781	6	7	822	64	0	899
25782	6	808	34	45	0	893
25783	11	29	22	819	0	881
25784	14	15	820	49	0	898
25785	12	5	846	29	0	892
25786	814	6	54	11	0	885
25787	825	7	29	10	0	871
25788	855	9	10	18	0	892
25789	60	3	7	801	0	871
25790	33	2	791	43	0	869
25791	15	773	35	31	0	854
25792	12	819	27	16	0	874
25793	10	47	738	13	0	808
25794	12	28	28	663	0	731
25795	13	6	19	617	0	655
25796	9	587	17	37	0	650
25797	16	617	10	20	0	663
25798	592	40	6	9	0	647
25799	617	15	9	10	0	651
25800	629	5	6	6	0	646
25801	613	3	10	7	0	633
25802	611	5	5	12	0	633
25803	43	571	2	8	0	624
25804	16	494	5	10	0	525
25805	5	372	3	8	0	388
25806	305	16	21	1	0	343
25807	16	16	2	277	0	311
25808	2	4	0	264	0	270
25809	262	0	1	9	0	272
25810	6	265	1	8	0	280
25811	3	5	1	262	0	271
25812	3	3	3	264	0	273
25813	2	3	0	265	0	270
25814	258	0	2	9	0	269
25815	6	0	2	266	0	274
25816	2	1	253	9	0	265
25817	231	0	4	3	0	238
25818	6	1	1	243	0	251
25819	3	0	236	5	0	244
25820	2	230	4	2	0	238
25821	1	215	1	1	0	218
25822	196	12	5	0	0	213
25823	176	0	7	0	0	183
25824	2	198	0	0	0	200
25825	1	1	0	200	0	202
25826	223	0	0	4	0	227
25827	5	0	0	232	0	237
25828	1	0	0	253	0	254
25829	0	0	0	254	0	254
25830	1	0	0	249	0	250
25831	1	240	0	6	0	247
25832	0	3	0	236	0	239
25833	0	1	0	244	0	245
25834	1	0	0	243	0	244
25835	0	1	238	6	0	245
25836	0	236	6	2	0	244
25837	1	6	1	236	0	244
25838	0	1	236	6	0	243
25839	1	0	230	3	0	234
25840	0	244	6	2	0	252
25841	241	5	2	1	0	249
25842	6	2	1	234	0	243
25843	232	1	0	7	0	240
25844	5	228	0	4	0	237
25845	1	4	0	233	0	238
25846	228	1	1	6	0	236
25847	236	2	1	1	0	240
25848	6	1	0	236	0	243
25849	1	0	1	239	0	241
25850	0	0	237	7	0	244
25851	0	1	7	230	0	238
25852	2	1	1	237	0	241
25853	232	0	0	7	0	239
25854	7	241	1	1	0	250
25855	1	6	241	0	0	248
25856	230	2	5	2	0	239
25857	7	241	1	0	0	249
25858	2	4	0	246	0	252
25859	246	1	0	6	0	253
25860	6	1	0	236	0	243
25861	1	0	1	240	0	242
25862	1	0	240	7	0	248
25863	1	1	5	239	0	246
25864	249	0	1	7	0	257
25865	5	1	0	251	0	257
25866	247	0	2	6	0	255
25867	6	238	0	6	0	250
25868	1	247	0	3	0	251
25869	1	6	0	250	0	257
25870	0	3	0	251	0	254
25871	239	0	1	9	0	249
25872	6	244	0	3	0	253
25873	244	6	1	1	0	252
25874	244	1	1	3	0	249
25875	8	1	0	241	0	250
25876	241	0	1	9	0	251
25877	5	0	229	2	0	236
25878	1	1	7	226	0	235
25879	0	2	237	6	0	245
25880	2	0	6	233	0	241
25881	232	1	1	7	0	241
25882	233	0	0	1	0	234
25883	6	231	0	0	0	237
25884	2	6	0	230	0	238
25885	2	2	0	233	0	237
25886	1	226	0	10	0	237
25887	2	4	0	228	0	234
25888	1	2	1	235	0	239
25889	1	231	1	6	0	239
25890	227	5	1	3	0	236
25891	231	1	1	3	0	236
25892	9	0	0	228	0	237
25893	2	1	1	228	0	232
25894	1	1	225	7	0	234
25895	1	1	6	219	0	227
25896	1	225	2	6	0	234
25897	213	6	0	3	0	222
25898	7	2	0	214	0	223
25899	1	1	0	210	0	212
25900	202	1	0	9	0	212
25901	6	213	0	3	0	222
25902	2	6	0	216	0	224
25903	1	1	1	214	0	217
25904	0	208	0	10	0	218
25905	207	5	2	1	0	215
25906	6	3	199	2	0	210
25907	1	2	205	2	0	210
25908	1	1	7	203	0	212
25909	0	1	207	8	0	216
25910	195	1	6	3	0	205
25911	7	1	1	201	0	210
25912	2	2	199	6	0	209
25913	3	2	207	2	0	214
25914	1	214	5	3	0	223
25915	210	5	1	2	0	218
25916	7	213	1	2	0	223
25917	223	5	1	2	0	231
25918	222	1	2	2	0	227
25919	2	215	0	4	0	221
25920	209	5	3	0	0	217
25921	213	1	0	1	0	215
25922	6	1	201	2	0	210
25923	3	18	6	185	0	212
25924	0	177	1	5	0	183
25925	0	164	2	2	0	168
25926	5	5	0	145	0	155
25927	137	2	2	1	0	142
25928	0	0	0	125	0	125
25929	0	0	0	128	0	128
25930	0	0	0	139	0	139
25931	0	149	0	0	0	149
25932	0	0	0	158	0	158
25933	0	0	195	1	0	196
25934	180	2	2	0	0	184
25935	202	1	1	2	0	206
25936	6	199	1	0	0	206
25937	208	4	1	1	0	214
25938	6	2	0	206	0	214
25939	3	2	207	4	0	216
25940	197	1	4	2	0	204
25941	5	213	2	2	0	222
25942	2	3	2	226	0	233
25943	225	2	1	3	0	231
25944	6	225	0	1	0	232
25945	2	232	0	2	0	236
25946	225	6	3	1	0	235
25947	6	5	218	0	0	229
25948	221	3	5	2	0	231
25949	7	1	5	217	0	230
25950	5	0	1	223	0	229
25951	4	0	221	7	0	232
25952	1	2	219	4	0	226
25953	2	0	7	222	0	231
25954	0	0	211	8	0	219
25955	0	0	216	1	0	217
25956	2	0	9	213	0	224
25957	2	2	3	217	0	224
25958	214	0	3	10	0	227
25959	7	0	1	215	0	223
25960	217	2	0	7	0	226
25961	7	215	0	4	0	226
25962	5	5	0	214	0	224
25963	2	2	222	6	0	232
25964	209	3	5	1	0	218
25965	223	1	2	5	0	231
25966	224	0	1	3	0	228
25967	224	1	4	1	0	230
25968	230	1	2	0	0	233
25969	11	1	0	218	0	230
25970	5	0	217	6	0	228
25971	5	0	220	2	0	227
25972	1	1	222	4	0	228
25973	214	1	9	4	0	228
25974	231	0	4	0	0	235
25975	7	0	3	219	0	229
25976	8	226	1	6	0	241
25977	3	7	1	238	0	249
25978	1	2	238	10	0	251
25979	1	3	236	4	0	244
25980	222	1	9	4	0	236
25981	9	0	261	2	0	272
25982	5	0	9	260	0	274
25983	273	0	3	6	0	282
25984	263	2	3	1	0	269
25985	272	0	1	5	0	278
25986	273	0	3	2	0	278
25987	13	0	268	0	0	281
25988	260	0	9	0	0	269
25989	12	262	2	0	0	276
25990	5	7	2	267	0	281
25991	4	1	269	8	0	282
25992	2	5	7	266	0	280
25993	2	1	275	11	0	289
25994	1	0	11	278	0	290
25995	1	0	6	286	0	293
25996	5	0	275	10	0	290
25997	1	0	10	281	0	292
25998	282	0	3	14	0	299
25999	9	1	4	285	0	299
26000	3	0	3	300	0	306
26001	288	0	1	11	0	300
26002	11	288	2	4	0	305
26003	295	7	3	3	0	308
26004	11	292	1	1	0	305
26005	300	11	0	4	0	315
26006	11	3	303	2	0	319
26007	4	2	10	298	0	314
26008	5	1	1	312	0	319
26009	307	0	5	10	0	322
26010	7	300	2	8	0	317
26011	2	7	1	307	0	317
26012	4	3	2	306	0	315
26013	3	284	0	11	0	298
26014	290	8	1	2	0	301
26015	7	285	1	6	0	299
26016	4	9	1	284	0	298
26017	4	3	0	277	0	284
26018	1	281	1	10	0	293
26019	272	8	3	5	0	288
26020	7	4	270	4	0	285
26021	264	2	8	1	0	275
26022	9	270	3	2	0	284
26023	3	7	2	281	0	293
26024	286	3	2	9	0	300
26025	10	3	0	300	0	313
26026	3	3	1	305	0	312
26027	289	1	1	13	0	304
26028	11	282	0	8	0	301
26029	2	309	2	3	0	316
26030	297	9	0	2	0	308
26031	8	1	303	1	0	313
26032	2	295	7	1	0	305
26033	3	5	1	273	0	282
26034	0	0	317	4	0	321
26035	1	4	5	297	0	307
26036	312	0	3	6	0	321
26037	7	312	0	2	0	321
26038	2	7	0	303	0	312
26039	0	308	0	4	0	312
26040	314	6	1	1	0	322
26041	299	2	0	1	0	302
26042	8	293	1	0	0	302
26043	1	5	0	297	0	303
26044	0	320	0	7	0	327
26045	317	7	1	0	0	325
26046	326	2	0	2	0	330
26047	12	1	0	317	0	330
26048	4	0	0	326	0	330
26049	1	0	316	10	0	327
26050	304	0	8	2	0	314
26051	8	1	317	1	0	327
26052	3	0	8	315	0	326
26053	316	1	2	8	0	327
26054	9	319	1	2	0	331
26055	317	8	1	1	0	327
26056	9	2	304	1	0	316
26057	300	2	5	1	0	308
26058	8	329	1	1	0	339
26059	332	9	1	0	0	342
26060	9	328	0	1	0	338
26061	3	9	0	331	0	343
26062	1	4	327	8	0	340
26063	2	0	317	1	0	320
26064	1	1	10	320	0	332
26065	1	2	326	9	0	338
26066	1	0	9	322	0	332
26067	1	2	2	327	0	332
26068	2	0	326	11	0	339
26069	274	0	8	5	0	287
26070	329	0	3	2	0	334
26071	11	319	1	1	0	332
26072	321	8	2	1	0	332
26073	11	2	0	329	0	342
26074	3	1	341	9	0	354
26075	1	1	8	341	0	351
26076	1	0	2	343	0	346
26077	332	2	2	10	0	346
26078	10	325	0	3	0	338
26079	3	331	1	1	0	336
26080	2	9	1	327	0	339
26081	0	4	0	302	0	306
26082	1	296	0	10	0	307
26083	0	8	2	296	0	306
26084	0	2	1	304	0	307
26085	1	294	0	9	0	304
26086	299	6	2	3	0	310
26087	6	2	0	303	0	311
26088	2	309	1	7	0	319
26089	1	5	1	311	0	318
26090	308	1	2	8	0	319
26091	6	307	1	2	0	316
26092	308	7	0	1	0	316
26093	308	2	0	0	0	310
26094	8	2	0	302	0	312
26095	309	0	1	6	0	316
26096	323	0	0	4	0	327
26097	324	0	1	1	0	326
26098	328	0	0	1	0	329
26099	10	1	0	316	0	327
26100	5	0	0	309	0	314
26101	2	1	302	10	0	315
26102	2	1	4	299	0	306
26103	2	1	3	308	0	314
26104	0	0	305	15	0	320
26105	312	0	9	7	0	328
26106	9	1	5	312	0	327
26107	5	0	320	11	0	336
26108	304	1	10	5	0	320
26109	10	2	358	2	0	372
26110	5	371	11	2	0	389
26111	4	383	3	1	0	391
26112	1	14	2	396	0	413
26113	3	3	449	11	0	466
26114	446	1	16	4	0	467
26115	491	2	4	4	0	501
26116	23	1	492	0	0	516
26117	477	1	16	2	0	496
26118	492	0	5	3	0	500
26119	23	487	3	1	0	514
26120	498	16	1	2	0	517
26121	19	5	2	486	0	512
26122	5	2	502	17	0	526
26123	5	1	14	463	0	483
26124	0	498	6	17	0	521
26125	4	513	4	5	0	526
26126	507	21	0	2	0	530
26127	517	5	2	3	0	527
26128	522	2	3	0	0	527
26129	22	1	1	486	0	510
26130	8	2	2	473	0	485
26131	5	464	2	19	0	490
26132	454	15	1	7	0	477
26133	15	464	1	9	0	489
26134	413	15	3	2	0	433
26135	18	417	0	5	0	440
26136	414	16	2	2	0	434
26137	409	5	2	2	0	418
26138	22	2	0	403	0	427
26139	8	432	1	15	0	456
26140	5	14	416	4	0	439
26141	414	2	10	5	0	431
26142	14	426	4	4	0	448
26143	7	13	431	2	0	453
26144	1	6	438	0	0	445
26145	2	4	11	423	0	440
26146	3	1	3	418	0	425
26147	3	431	2	11	0	447
26148	445	9	2	2	0	458
26149	12	3	3	428	0	446
26150	5	463	1	10	0	479
26151	4	486	1	3	0	494
26152	2	12	481	1	0	496
26153	7	3	475	0	0	485
26154	462	3	11	4	0	480
26155	12	3	484	1	0	500
26156	4	3	11	469	0	487
26157	5	2	4	494	0	505
26158	2	2	475	14	0	493
26159	3	4	10	468	0	485
26160	4	4	4	442	0	454
26161	468	1	1	13	0	483
26162	478	2	2	4	0	486
26163	14	2	2	474	0	492
26164	4	458	4	10	0	476
26165	2	480	2	6	0	490
26166	479	13	0	3	0	495
26167	13	5	476	4	0	498
26168	7	3	11	479	0	500
26169	482	2	5	15	0	504
26170	490	5	3	4	0	502
26171	16	5	0	489	0	510
26172	7	3	490	11	0	511
26173	6	2	470	4	0	482
26174	460	3	14	2	0	479
26175	479	7	4	2	0	492
26176	13	483	5	4	0	505
26177	9	500	5	4	0	518
26178	498	13	6	5	0	522
26179	521	4	8	3	0	536
26180	17	2	3	523	0	545
26181	9	3	1	528	0	541
26182	7	7	0	529	0	543
26183	524	3	4	12	0	543
26184	14	4	2	523	0	543
26185	9	2	539	14	0	564
26186	517	3	13	7	0	540
26187	15	4	6	533	0	558
26188	7	4	541	13	0	565
26189	525	6	10	6	0	547
26190	507	8	2	0	0	517
26191	20	558	2	3	0	583
26192	4	566	7	7	0	584
26193	3	13	542	5	0	563
26194	552	6	11	3	0	572
26195	14	570	5	8	0	597
26196	5	15	540	4	0	564
26197	553	4	11	2	0	570
26198	17	614	3	0	0	634
26199	9	10	601	6	0	626
26200	579	4	12	5	0	600
26201	15	613	3	4	0	635
26202	6	9	0	609	0	624
26203	608	4	3	9	0	624
26204	13	620	0	2	0	635
26205	6	12	1	591	0	610
26206	594	2	3	13	0	612
26207	9	2	589	8	0	608
26208	2	586	10	4	0	602
26209	3	8	570	8	0	589
26210	4	10	8	534	0	556
26211	4	2	538	10	0	554
26212	2	521	7	2	0	532
26213	0	477	4	0	0	481
26214	4	4	3	453	0	464
26215	1	0	1	433	0	435
26216	0	0	0	442	0	442
26217	0	0	472	2	0	474
26218	1	0	3	482	0	486
26219	485	1	0	3	0	489
26220	471	1	0	1	0	473
26221	4	2	484	0	0	490
26222	0	478	3	0	0	481
26223	483	2	3	0	0	488
26224	3	478	1	1	0	483
26225	480	3	0	3	0	486
26226	488	0	0	0	0	488
26227	3	0	487	1	0	491
26228	0	499	4	0	0	503
26229	1	3	0	502	0	506
26230	0	0	501	4	0	505
26231	480	0	4	0	0	484
26232	4	0	0	501	0	505
26233	0	0	492	3	0	495
26234	448	0	3	1	0	452
26235	3	0	504	0	0	507
26236	0	0	3	503	0	506
26237	525	0	0	3	0	528
26238	3	538	0	0	0	541
26239	2	3	540	0	0	545
26240	535	0	3	0	0	538
26241	581	0	0	2	0	583
26242	3	580	0	8	0	591
26243	2	4	1	588	0	595
26244	2	2	1	580	0	585
26245	573	2	0	7	0	582
26246	5	0	1	596	0	602
26247	3	0	599	10	0	612
26248	5	1	6	582	0	594
26249	591	1	1	9	0	602
26250	7	560	2	4	0	573
26251	2	8	2	561	0	573
26252	2	582	1	7	0	592
26253	584	10	1	2	0	597
26254	8	3	1	634	0	646
26255	3	2	1	656	0	662
26256	2	660	2	11	0	675
26257	1	12	657	3	0	673
26258	0	3	10	637	0	650
26259	0	2	3	671	0	676
26260	1	1	2	666	0	670
26261	0	657	2	13	0	672
26262	1	9	662	8	0	680
26263	2	2	663	4	0	671
26264	660	2	12	5	0	679
26265	692	1	5	2	0	700
26266	13	1	694	0	0	708
26267	675	2	12	0	0	689
26268	17	1	714	0	0	732
26269	685	1	11	2	0	699
26270	14	718	4	0	0	736
26271	729	11	3	0	0	743
26272	11	1	741	1	0	754
26273	4	4	744	2	0	754
26274	3	2	15	751	0	771
26275	779	0	6	13	0	798
26276	11	835	6	3	0	855
26277	2	12	962	5	0	981
26278	9	2	20	960	0	991
26279	4	5	4	980	0	993
26280	958	2	4	26	0	990
26281	980	1	2	9	0	992
26282	26	1	0	976	0	1003
26283	992	1	3	24	0	1020
26284	25	2	967	4	0	998
26285	7	1	21	952	0	981
26286	5	1	4	977	0	987
26287	970	0	4	26	0	1000
26288	965	1	3	11	0	980
26289	25	0	1	959	0	985
26290	956	1	0	28	0	985
26291	29	0	934	4	0	967
26292	5	928	23	10	0	966
26293	5	23	934	5	0	967
26294	5	10	25	937	0	977
26295	923	4	8	25	0	960
26296	25	919	5	11	0	960
26297	4	22	3	902	0	931
26298	7	3	1	878	0	889
26299	4	895	1	24	0	924
26300	1	29	1	890	0	921
26301	2	6	5	901	0	914
26302	0	8	3	915	0	926
26303	3	2	0	910	0	915
26304	4	0	2	894	0	900
26305	2	871	0	31	0	904
26306	4	21	3	882	0	910
26307	2	4	2	897	0	905
26308	2	5	859	30	0	896
26309	2	851	24	9	0	886
26310	3	25	3	855	0	886
26311	5	3	6	870	0	884
26312	7	4	3	844	0	858
26313	5	845	2	30	0	882
26314	3	23	839	13	0	878
26315	8	4	22	865	0	899
26316	2	6	850	37	0	895
26317	3	4	837	7	0	851
26318	2	0	28	826	0	856
26319	842	1	9	30	0	882
26320	25	3	6	839	0	873
26321	6	1	4	836	0	847
26322	8	868	2	28	0	906
26323	5	20	1	880	0	906
26324	4	6	2	902	0	914
26325	5	4	874	29	0	912
26326	2	871	21	13	0	907
26327	7	21	5	871	0	904
26328	844	6	8	29	0	887
26329	23	6	856	8	0	893
26330	4	4	23	854	0	885
26331	7	2	5	876	0	890
26332	845	1	7	30	0	883
26333	23	849	4	11	0	887
26334	846	21	0	15	0	882
26335	23	838	2	12	0	875
26336	7	26	3	839	0	875
26337	827	7	3	28	0	865
26338	21	3	816	13	0	853
26339	8	788	22	10	0	828
26340	6	809	9	9	0	833
26341	770	23	5	9	0	807
26342	22	5	6	755	0	788
26343	6	758	2	27	0	793
26344	4	788	1	12	0	805
26345	12	23	4	771	0	810
26346	7	6	2	784	0	799
26347	751	4	1	30	0	786
26348	22	751	4	9	0	786
26349	3	23	6	744	0	776
26350	1	7	743	26	0	777
26351	4	747	22	8	0	781
26352	6	27	717	11	0	761
26353	5	721	24	10	0	760
26354	8	21	4	675	0	708
26355	4	3	2	663	0	672
26356	4	663	2	20	0	689
26357	2	17	661	9	0	689
26358	653	5	16	6	0	680
26359	18	6	5	665	0	694
26360	3	3	3	686	0	695
26361	6	1	663	20	0	690
26362	3	3	19	663	0	688
26363	0	5	657	20	0	682
26364	4	5	18	654	0	681
26365	3	4	650	21	0	678
26366	3	640	19	8	0	670
26367	2	22	652	7	0	683
26368	2	8	22	646	0	678
26369	646	5	3	23	0	677
26370	16	635	3	9	0	663
26371	7	23	0	640	0	670
26372	3	5	637	20	0	665
26373	2	658	16	9	0	685
26374	4	21	5	609	0	639
26375	2	4	620	16	0	642
26376	1	544	17	4	0	566
26377	405	14	2	1	0	422
26378	392	0	1	1	0	394
26379	5	0	0	395	0	400
26380	395	1	0	6	0	402
26381	5	0	1	391	0	397
26382	1	0	0	396	0	397
26383	1	0	393	5	0	399
26384	0	0	5	389	0	394
26385	1	1	1	397	0	400
26386	390	0	1	6	0	397
26387	379	1	1	1	0	382
26388	5	391	0	2	0	398
26389	0	5	396	0	0	401
26390	0	1	5	390	0	396
26391	0	1	384	6	0	391
26392	348	1	4	1	0	354
26393	4	2	363	4	0	373
26394	3	1	3	357	0	364
26395	1	368	1	2	0	372
26396	2	3	1	366	0	372
26397	2	1	0	363	0	366
26398	0	0	380	5	0	385
26399	2	1	3	368	0	374
26400	374	1	1	4	0	380
26401	366	0	0	5	0	371
26402	369	1	1	2	0	373
26403	372	0	0	3	0	375
26404	4	368	1	2	0	375
26405	2	374	0	2	0	378
26406	1	2	3	346	0	352
26407	1	1	2	369	0	373
26408	0	356	2	4	0	362
26409	3	1	0	370	0	374
26410	2	0	3	368	0	373
26411	1	0	0	373	0	374
26412	2	1	3	369	0	375
26413	1	0	0	369	0	370
26414	367	1	1	6	0	375
26415	3	357	2	3	0	365
26416	0	2	356	3	0	361
26417	0	0	3	353	0	356
26418	2	2	2	354	0	360
26419	4	0	0	337	0	341
26420	333	2	2	4	0	341
26421	4	362	2	2	0	370
26422	1	10	1	339	0	351
26423	1	351	1	9	0	362
26424	3	9	2	354	0	368
26425	2	355	2	10	0	369
26426	1	10	421	8	0	440
26427	1	5	14	428	0	448
26428	1	4	536	15	0	556
26429	3	0	21	547	0	571
26430	3	0	4	599	0	606
26431	582	3	2	27	0	614
26432	598	3	1	7	0	609
26433	614	1	2	8	0	625
26434	607	1	2	5	0	615
26435	609	3	3	4	0	619
26436	26	1	0	585	0	612
26437	8	572	1	27	0	608
26438	4	25	1	571	0	601
26439	4	3	563	29	0	599
26440	559	7	21	8	0	595
26441	579	1	3	8	0	591
26442	30	3	4	556	0	593
26443	6	2	3	569	0	580
26444	4	539	3	29	0	575
26445	2	23	5	550	0	580
26446	3	3	1	560	0	567
26447	7	539	1	29	0	576
26448	5	26	2	554	0	587
26449	524	3	1	34	0	562
26450	21	7	536	6	0	570
26451	520	1	25	10	0	556
26452	28	1	521	11	0	561
26453	8	5	27	507	0	547
26454	10	3	4	524	0	541
26455	7	501	4	29	0	541
26456	7	539	3	9	0	558
26457	8	30	1	508	0	547
26458	5	6	507	25	0	543
26459	501	4	25	12	0	542
26460	28	3	5	503	0	539
26461	6	496	5	33	0	540
26462	10	25	1	505	0	541
26463	9	16	1	504	0	530
26464	3	493	0	35	0	531
26465	5	27	3	479	0	514
26466	5	6	459	27	0	497
26467	6	6	462	6	0	480
26468	3	2	27	438	0	470
26469	1	450	5	27	0	483
26470	5	24	6	458	0	493
26471	454	5	1	29	0	489
26472	470	7	2	5	0	484
26473	440	2	3	7	0	452
26474	22	417	4	6	0	449
26475	7	24	420	6	0	457
26476	419	4	24	8	0	455
26477	438	11	4	3	0	456
26478	28	426	7	4	0	465
26479	9	23	1	421	0	454
26480	429	5	4	24	0	462
26481	444	4	1	9	0	458
26482	449	2	2	7	0	460
26483	29	4	2	403	0	438
26484	416	3	1	30	0	450
26485	24	5	1	417	0	447
26486	3	4	2	441	0	450
26487	415	2	1	31	0	449
26488	30	0	3	415	0	448
26489	412	3	3	28	0	446
26490	31	4	1	412	0	448
26491	7	2	3	438	0	450
26492	411	2	1	33	0	447
26493	28	0	404	11	0	443
26494	8	6	25	410	0	449
26495	7	3	3	430	0	443
26496	6	1	5	420	0	432
26497	10	2	3	434	0	449
26498	14	0	0	413	0	427
26499	9	398	1	29	0	437
26500	7	28	2	406	0	443
26501	6	5	396	32	0	439
26502	6	4	24	405	0	439
26503	10	2	5	423	0	440
26504	7	4	3	423	0	437
26505	6	6	399	36	0	447
26506	5	4	422	12	0	443
26507	398	2	26	13	0	439
26508	425	2	5	7	0	439
26509	29	436	7	9	0	481
26510	9	25	0	452	0	486
26511	7	3	1	476	0	487
26512	4	3	3	479	0	489
26513	460	4	2	34	0	500
26514	485	2	4	13	0	504
26515	30	3	5	457	0	495
26516	7	1	3	482	0	493
26517	5	3	3	476	0	487
26518	3	4	1	484	0	492
26519	449	3	1	38	0	491
26520	26	3	434	13	0	476
26521	7	385	20	5	0	417
26522	4	394	4	8	0	410
26523	367	17	4	7	0	395
26524	22	3	4	365	0	394
26525	5	5	365	26	0	401
26526	2	3	294	6	0	305
26527	0	314	13	7	0	334
26528	204	4	7	1	0	216
26529	5	0	199	2	0	206
26530	153	0	2	0	0	155
26531	4	0	0	161	0	165
26532	0	0	0	154	0	154
26533	1	158	0	2	0	161
26534	0	162	0	0	0	162
26535	164	2	0	0	0	166
26536	166	0	0	0	0	166
26537	2	175	0	0	0	177
26538	0	1	169	0	0	170
26539	0	0	170	0	0	170
26540	0	0	1	174	0	175
26541	183	0	0	2	0	185
26542	1	186	0	0	0	187
26543	0	2	0	190	0	192
26544	196	0	0	2	0	198
26545	1	0	0	201	0	202
26546	0	0	0	205	0	205
26547	206	0	0	3	0	209
26548	3	207	0	0	0	210
26549	0	226	0	0	0	226
26550	0	3	228	0	0	231
26551	0	0	3	225	0	228
26552	0	0	0	221	0	221
26553	0	0	228	3	0	231
26554	191	0	3	2	0	196
26555	204	0	0	0	0	204
26556	3	0	232	0	0	235
26557	191	0	2	1	0	194
26558	3	0	247	0	0	250
26559	1	274	3	0	0	278
26560	0	3	0	278	0	281
26561	0	0	0	294	0	294
26562	292	0	0	3	0	295
26563	294	0	0	0	0	294
26564	300	0	0	0	0	300
26565	297	0	0	0	0	297
26566	294	0	0	0	0	294
26567	3	0	290	0	0	293
26568	0	301	3	0	0	304
26569	0	2	0	300	0	302
26570	0	298	0	2	0	300
26571	0	297	0	0	0	297
26572	0	3	0	299	0	302
26573	0	0	0	305	0	305
26574	0	0	300	3	0	303
26575	276	0	3	1	0	280
26576	307	0	0	0	0	307
26577	3	297	0	0	0	300
26578	296	3	0	0	0	299
26579	315	0	0	1	0	316
26580	3	0	0	315	0	318
26581	0	0	324	3	0	327
26582	0	0	314	0	0	314
26583	318	0	3	0	0	321
26584	319	0	0	0	0	319
26585	3	316	0	1	0	320
26586	0	327	0	0	0	327
26587	0	3	0	350	0	353
26588	348	0	0	4	0	352
26589	3	0	352	0	0	355
26590	0	0	3	360	0	363
26591	369	0	0	3	0	372
26592	379	0	1	0	0	380
26593	3	0	0	386	0	389
26594	385	0	0	4	0	389
26595	3	0	363	0	0	366
26596	0	0	388	0	0	388
26597	0	0	3	365	0	368
26598	0	0	0	406	0	406
26599	0	0	0	402	0	402
26600	0	399	0	3	0	402
26601	0	411	0	0	0	411
26602	0	2	0	411	0	413
26603	416	0	0	4	0	420
26604	3	0	0	422	0	425
26605	0	0	0	423	0	423
26606	0	413	0	3	0	416
26607	0	426	0	0	0	426
26608	0	2	0	427	0	429
26609	0	0	0	392	0	392
26610	385	0	0	4	0	389
26611	3	383	0	0	0	386
26612	388	2	0	1	0	391
26613	3	0	0	388	0	391
26614	0	0	390	3	0	393
26615	0	0	378	2	0	380
26616	384	0	3	0	0	387
26617	2	0	0	409	0	411
26618	0	0	0	411	0	411
26619	1	0	0	413	0	414
26620	0	0	419	4	0	423
26621	0	0	4	417	0	421
26622	0	419	0	6	0	425
26623	0	4	0	428	0	432
26624	0	0	0	429	0	429
26625	0	421	0	4	0	425
26626	0	4	0	432	0	436
26627	412	0	0	4	0	416
26628	4	412	0	0	0	416
26629	418	3	0	1	0	422
26630	421	0	0	0	0	421
26631	6	1	0	429	0	436
26632	3	0	1	430	0	434
26633	0	1	0	435	0	436
26634	0	1	416	7	0	424
26635	0	411	5	4	0	420
26636	2	420	2	3	0	427
26637	1	7	2	410	0	420
26638	404	2	0	6	0	412
26639	7	1	0	404	0	412
26640	2	0	407	7	0	416
26641	0	394	5	3	0	402
26642	1	410	1	1	0	413
26643	404	4	3	0	0	411
26644	411	3	1	0	0	415
26645	4	432	0	1	0	437
26646	441	3	0	2	0	446
26647	5	1	451	1	0	458
26648	1	2	448	1	0	452
26649	460	1	5	0	0	466
26650	477	1	2	2	0	482
26651	7	0	1	475	0	483
26652	485	0	0	5	0	490
26653	8	0	506	2	0	516
26654	1	2	533	2	0	538
26655	3	1	9	584	0	597
26656	0	0	5	681	0	686
26657	0	0	4	731	0	735
26658	2	0	3	754	0	759
26659	1	0	0	797	0	798
26660	3	0	772	27	0	802
26661	1	0	20	766	0	787
26662	770	0	9	25	0	804
26663	20	0	5	776	0	801
26664	776	1	2	27	0	806
26665	24	0	2	778	0	804
26666	787	1	1	27	0	816
26667	814	1	0	8	0	823
26668	25	0	1	797	0	823
26669	9	0	2	816	0	827
26670	791	1	1	26	0	819
26671	804	0	0	10	0	814
26672	27	0	812	8	0	847
26673	10	1	18	807	0	836
26674	7	0	3	837	0	847
26675	810	0	3	29	0	842
26676	835	1	1	8	0	845
26677	25	1	4	825	0	855
26678	8	1	1	845	0	855
26679	7	0	0	842	0	849
26680	7	0	0	832	0	839
26681	5	775	2	28	0	810
26682	2	801	3	11	0	817
26683	1	23	0	801	0	825
26684	4	793	2	23	0	822
26685	4	22	1	811	0	838
26686	3	6	792	27	0	828
26687	3	6	773	10	0	792
26688	2	774	18	10	0	804
26689	0	21	8	770	0	799
26690	2	6	781	26	0	815
26691	3	6	24	750	0	783
26692	4	1	5	781	0	791
26693	758	5	5	31	0	799
26694	25	2	3	777	0	807
26695	5	0	783	29	0	817
26696	7	1	787	6	0	801
26697	2	761	21	14	0	798
26698	6	806	7	11	0	830
26699	818	21	5	9	0	853
26700	25	7	844	6	0	882
26701	7	3	24	848	0	882
26702	849	4	8	25	0	886
26703	855	3	5	15	0	878
26704	31	865	4	8	0	908
26705	12	21	5	852	0	890
26706	11	7	3	899	0	920
26707	7	7	1	892	0	907
26708	872	3	3	32	0	910
26709	26	3	876	12	0	917
26710	5	914	23	16	0	958
26711	9	21	3	910	0	943
26712	8	5	5	941	0	959
26713	6	8	896	31	0	941
26714	5	4	25	891	0	925
26715	4	3	6	932	0	945
26716	5	4	6	932	0	947
26717	9	3	2	918	0	932
26718	6	3	891	37	0	937
26719	1	4	26	897	0	928
26720	2	3	881	36	0	922
26721	2	865	25	24	0	916
26722	7	21	10	871	0	909
26723	2	7	10	905	0	924
26724	4	6	866	37	0	913
26725	6	853	23	22	0	904
26726	9	22	9	856	0	896
26727	7	8	886	30	0	931
26728	4	876	23	22	0	925
26729	7	21	8	893	0	929
26730	10	8	899	24	0	941
26731	9	4	21	885	0	919
26732	8	2	14	888	0	912
26733	7	5	6	920	0	938
26734	896	7	3	37	0	943
26735	26	883	5	19	0	933
26736	893	19	8	19	0	939
26737	25	7	890	17	0	939
26738	908	6	16	17	0	947
26739	998	3	5	16	0	1022
26740	25	5	6	990	0	1026
26741	1000	3	5	32	0	1040
26742	1011	4	7	16	0	1038
26743	1033	2	4	22	0	1061
26744	31	12	1	1021	0	1065
26745	11	5	1	1015	0	1032
26746	8	4	989	31	0	1032
26747	8	5	954	16	0	983
26748	954	7	17	16	0	994
26749	21	0	10	965	0	996
26750	7	988	12	23	0	1030
26751	986	19	6	10	0	1021
26752	16	984	4	15	0	1019
26753	10	974	5	10	0	999
26754	5	20	956	14	0	995
26755	9	1	960	10	0	980
26756	7	10	19	903	0	939
26757	4	6	909	10	0	929
26758	0	4	819	5	0	828
26759	755	4	1	0	0	760
26760	804	0	2	3	0	809
26761	3	1	0	834	0	838
26762	1	1	0	835	0	837
26763	0	1	855	1	0	857
26764	2	849	1	0	0	852
26765	1	1	0	868	0	870
26766	891	1	1	4	0	897
26767	0	0	1	907	0	908
26768	1	914	1	1	0	917
26769	2	0	902	1	0	905
26770	1	933	1	1	0	936
26771	925	0	3	3	0	931
26772	894	4	2	2	0	902
26773	4	2	2	889	0	897
26774	4	2	916	2	0	924
26775	3	0	860	3	0	866
26776	1	918	7	2	0	928
26777	0	1	7	885	0	893
26778	0	6	4	918	0	928
26779	1	2	923	5	0	931
26780	1	2	0	908	0	911
26781	1	955	6	6	0	968
26782	1	3	1	980	0	985
26783	0	8	3	971	0	982
26784	1	1	982	14	0	998
26785	2	3	5	960	0	970
26786	951	0	9	9	0	969
26787	6	0	966	10	0	982
26788	8	0	959	2	0	969
26789	0	964	15	4	0	983
26790	2	8	9	999	0	1018
26791	0	8	3	1050	0	1061
26792	0	1	1038	18	0	1057
26793	968	2	10	13	0	993
26794	11	0	10	1048	0	1069
26795	10	13	1032	12	0	1067
26796	1	0	11	1014	0	1026
26797	2	0	1073	11	0	1086
26798	2	0	1020	12	0	1034
26799	0	1031	19	1	0	1051
26800	1	10	10	989	0	1010
26801	0	1031	3	4	0	1038
26802	990	11	1	8	0	1010
26803	10	14	1021	2	0	1047
26804	10	1013	11	3	0	1037
26805	1	14	11	1014	0	1040
26806	1017	10	5	11	0	1043
26807	8	1009	4	12	0	1033
26808	11	14	1	1014	0	1040
26809	1	8	3	1007	0	1019
26810	2	989	3	19	0	1013
26811	995	14	2	12	0	1023
26812	13	11	1	1095	0	1120
26813	11	2	1	1156	0	1170
26814	1	5	1131	33	0	1170
26815	3	1166	23	16	0	1208
26816	0	27	15	1179	0	1221
26817	2	11	5	1350	0	1368
26818	2	1381	3	40	0	1426
26819	1	35	3	1401	0	1440
26820	1	13	1	1474	0	1489
26821	3	6	3	1506	0	1518
26822	0	1478	2	53	0	1533
26823	1449	38	1	23	0	1511
26824	40	15	1475	7	0	1537
26825	1424	5	40	8	0	1477
26826	41	1467	14	5	0	1527
26827	15	42	7	1458	0	1522
26828	6	14	1476	41	0	1537
26829	4	6	42	1466	0	1518
26830	3	4	15	1484	0	1506
26831	1	2	3	1518	0	1524
26832	3	4	1475	60	0	1542
26833	2	1418	39	27	0	1486
26834	1	36	1463	16	0	1516
26835	1	1471	46	9	0	1527
26836	1	42	1517	5	0	1565
26837	3	17	43	1487	0	1550
26838	1443	5	19	45	0	1512
26839	37	1457	14	20	0	1528
26840	17	43	1478	8	0	1546
26841	5	1489	42	6	0	1542
26842	5	46	1494	10	0	1555
26843	3	19	45	1423	0	1490
26844	3	8	24	1418	0	1453
26845	1	1466	7	54	0	1528
26846	3	1497	9	25	0	1534
26847	1472	60	6	16	0	1554
26848	42	25	3	1496	0	1566
26849	16	7	1492	51	0	1566
26850	6	12	46	1477	0	1541
26851	10	7	1499	55	0	1571
26852	3	8	1513	33	0	1557
26853	7	7	61	1404	0	1479
26854	2	1439	26	46	0	1513
26855	1384	46	16	19	0	1465
26856	46	21	8	1383	0	1458
26857	21	8	10	1391	0	1430
26858	7	1407	7	58	0	1479
26859	1394	50	7	28	0	1479
26860	1429	18	9	17	0	1473
26861	65	12	7	1358	0	1442
26862	25	1347	9	49	0	1430
26863	12	1416	12	32	0	1472
26864	1379	59	13	19	0	1470
26865	47	28	1382	13	0	1470
26866	1332	14	55	13	0	1414
26867	1354	12	24	15	0	1405
26868	1348	11	14	12	0	1385
26869	65	1339	7	15	0	1426
26870	23	48	4	1353	0	1428
26871	1346	25	5	56	0	1432
26872	1378	19	10	20	0	1427
26873	62	1361	6	13	0	1442
26874	1366	41	2	20	0	1429
26875	53	22	6	1362	0	1443
26876	17	20	4	1367	0	1408
26877	15	1350	5	58	0	1428
26878	14	46	8	1372	0	1440
26879	11	21	12	1381	0	1425
26880	15	1351	4	59	0	1429
26881	20	45	8	1260	0	1333
26882	12	1317	9	59	0	1397
26883	1324	50	7	25	0	1406
26884	1298	22	4	23	0	1347
26885	54	1288	9	25	0	1376
26886	33	49	1286	13	0	1381
26887	15	20	41	1293	0	1369
26888	10	15	1304	52	0	1381
26889	8	1251	46	26	0	1331
26890	8	1294	11	21	0	1334
26891	1211	45	14	15	0	1285
26892	41	1260	7	17	0	1325
26893	14	48	8	1211	0	1281
26894	11	1221	8	44	0	1284
26895	10	1263	9	18	0	1300
26896	1241	53	8	13	0	1315
26897	45	17	8	1236	0	1306
26898	22	17	1220	41	0	1300
26899	13	19	1205	13	0	1250
26900	10	1216	47	17	0	1290
26901	1212	39	17	19	0	1287
26902	38	1228	15	8	0	1289
26903	11	55	12	1233	0	1311
26904	1243	19	5	46	0	1313
26905	45	15	9	1267	0	1336
26906	13	16	10	1264	0	1303
26907	11	1252	6	65	0	1334
26908	13	49	4	1262	0	1328
26909	7	26	1274	44	0	1351
26910	1266	12	37	21	0	1336
26911	45	1308	10	19	0	1382
26912	9	1300	14	9	0	1332
26913	1213	37	11	10	0	1271
26914	35	15	1237	9	0	1296
26915	1177	14	26	6	0	1223
26916	31	1321	8	10	0	1370
26917	10	1414	3	6	0	1433
26918	8	35	1427	5	0	1475
26919	4	1452	33	6	0	1495
26920	7	40	14	1332	0	1393
26921	5	18	1	1339	0	1363
26922	1	1346	4	40	0	1391
26923	6	27	4	1359	0	1396
26924	1378	18	2	28	0	1426
26925	29	11	1355	13	0	1408
26926	1354	10	26	5	0	1395
26927	1397	3	17	7	0	1424
26928	1400	6	8	2	0	1416
26929	44	3	1342	6	0	1395
26930	22	13	23	1348	0	1406
26931	4	9	1376	30	0	1419
26932	1318	5	31	20	0	1374
26933	1327	8	17	16	0	1368
26934	42	1359	4	12	0	1417
26935	21	30	4	1326	0	1381
26936	8	1365	3	30	0	1406
26937	10	28	1341	18	0	1397
26938	10	22	30	1344	0	1406
26939	1318	7	22	30	0	1377
26940	1329	16	7	19	0	1371
26941	52	3	3	1259	0	1317
26942	28	1260	8	28	0	1324
26943	7	24	1288	20	0	1339
26944	3	19	1311	14	0	1347
26945	1233	12	47	8	0	1300
26946	41	5	1297	6	0	1349
26947	19	1273	34	6	0	1332
26948	9	32	17	1250	0	1308
26949	6	22	1281	27	0	1336
26950	10	5	31	1234	0	1280
26951	8	4	1258	33	0	1303
26952	1184	2	39	20	0	1245
26953	32	7	18	1195	0	1252
26954	21	1197	7	30	0	1255
26955	10	1225	9	13	0	1257
26956	5	46	9	1191	0	1251
26957	2	22	8	1183	0	1215
26958	6	1181	6	43	0	1236
26959	3	28	1185	22	0	1238
26960	5	20	34	1169	0	1228
26961	7	10	1198	36	0	1251
26962	6	7	1187	22	0	1222
26963	1105	3	47	10	0	1165
26964	34	1152	23	6	0	1215
26965	1159	30	9	6	0	1204
26966	38	19	8	1118	0	1183
26967	21	1155	10	36	0	1222
26968	8	36	12	1170	0	1226
26969	10	25	5	1155	0	1195
26970	5	1135	6	43	0	1189
26971	9	38	1120	21	0	1188
26972	6	24	32	1139	0	1201
26973	1127	17	19	35	0	1198
26974	32	7	18	1120	0	1177
26975	19	8	11	1130	0	1168
26976	12	10	1093	51	0	1166
26977	11	1088	34	23	0	1156
26978	9	31	23	1075	0	1138
26979	8	30	1085	40	0	1163
26980	7	14	1091	28	0	1140
26981	1042	8	45	20	0	1115
26982	35	1065	33	10	0	1143
26983	1058	34	10	17	0	1119
26984	35	1056	12	16	0	1119
26985	21	1080	14	11	0	1126
26986	1055	45	15	14	0	1129
26987	36	23	11	1016	0	1086
26988	29	1047	7	32	0	1115
26989	18	31	12	1066	0	1127
26990	1057	21	11	43	0	1132
26991	28	17	1056	30	0	1131
26992	31	13	1042	12	0	1098
26993	1017	10	51	14	0	1092
26994	35	1027	27	14	0	1103
26995	20	34	1020	15	0	1089
26996	17	1026	36	8	0	1087
26997	10	36	24	1000	0	1070
26998	9	25	1022	34	0	1090
26999	13	10	38	1024	0	1085
27000	10	12	1013	37	0	1072
27001	973	10	33	27	0	1043
27002	33	1002	26	14	0	1075
27003	983	34	13	13	0	1043
27004	35	23	19	911	0	988
27005	27	987	12	29	0	1055
27006	982	27	16	20	0	1045
27007	930	29	11	9	0	979
27008	43	15	972	10	0	1040
27009	22	12	969	10	0	1013
27010	866	8	40	15	0	929
27011	23	886	32	12	0	953
27012	21	843	10	11	0	885
27013	13	51	15	800	0	879
27014	15	17	810	22	0	864
27015	4	778	29	22	0	833
27016	7	685	16	6	0	714
27017	18	16	9	382	0	425
27018	369	6	1	6	0	382
27019	362	4	1	4	0	371
27020	366	4	2	4	0	376
27021	10	3	364	2	0	379
27022	363	0	7	4	0	374
27023	371	1	6	0	0	378
27024	369	0	5	3	0	377
27025	11	2	2	356	0	371
27026	6	358	2	3	0	369
27027	364	8	2	1	0	375
27028	6	356	1	5	0	368
27029	3	7	1	365	0	376
27030	4	3	395	7	0	409
27031	3	6	8	380	0	397
27032	3	3	1	393	0	400
27033	1	2	402	8	0	413
27034	2	384	9	3	0	398
27035	4	5	1	369	0	379
27036	366	2	3	5	0	376
27037	5	371	1	1	0	378
27038	352	4	0	0	0	356
27039	6	1	0	338	0	345
27040	2	358	0	2	0	362
27041	362	4	0	1	0	367
27042	4	368	0	3	0	375
27043	0	4	342	1	0	347
27044	353	0	3	0	0	356
27045	356	1	0	1	0	358
27046	2	356	1	2	0	361
27047	1	2	344	0	0	347
27048	1	366	2	1	0	370
27049	7	7	6	233	0	253
27050	2	2	1	383	0	388
27051	0	2	1	395	0	398
27052	1	392	2	5	0	400
27053	3	4	0	396	0	403
27054	1	5	0	395	0	401
27055	390	1	1	7	0	399
27056	4	1	1	394	0	400
27057	3	2	2	402	0	409
27058	399	1	0	5	0	405
27059	4	394	1	1	0	400
27060	399	4	2	2	0	407
27061	403	1	2	0	0	406
27062	398	2	0	0	0	400
27063	5	3	0	400	0	408
27064	1	1	2	394	0	398
27065	2	1	388	6	0	397
27066	2	4	379	2	0	387
27067	3	1	373	3	0	380
27068	346	0	6	3	0	355
27069	7	2	362	1	0	372
27070	4	360	5	3	0	372
27071	3	5	2	357	0	367
27072	2	3	1	362	0	368
27073	1	378	1	6	0	386
27074	4	4	386	4	0	398
27075	2	394	5	1	0	402
27076	388	6	4	2	0	400
27077	5	3	383	1	0	392
27078	2	383	4	4	0	393
27079	5	5	386	1	0	397
27080	1	3	5	382	0	391
27081	2	1	386	6	0	395
27082	2	0	7	368	0	377
27083	384	2	3	5	0	394
27084	4	4	385	2	0	395
27085	5	388	4	2	0	399
27086	383	6	4	4	0	397
27087	6	5	412	2	0	425
27088	4	1	410	5	0	420
27089	1	5	10	403	0	419
27090	2	4	415	7	0	428
27091	384	3	7	5	0	399
27092	7	413	3	5	0	428
27093	5	8	2	410	0	425
27094	1	444	4	9	0	458
27095	444	10	1	5	0	460
27096	9	2	444	5	0	460
27097	5	5	452	5	0	467
27098	3	6	14	448	0	471
27099	3	3	1	461	0	468
27100	5	1	0	469	0	475
27101	4	2	2	471	0	479
27102	2	5	472	11	0	490
27103	3	466	10	3	0	482
27104	2	6	4	444	0	456
27105	2	2	418	8	0	430
27106	2	418	5	4	0	429
27107	411	7	4	2	0	424
27108	8	6	1	413	0	428
27109	420	0	0	9	0	429
27110	7	419	1	4	0	431
27111	415	6	0	7	0	428
27112	7	2	438	3	0	450
27113	1	2	6	427	0	436
27114	2	425	2	12	0	441
27115	1	6	429	3	0	439
27116	1	430	9	2	0	442
27117	8	10	3	302	0	323
27118	428	1	1	9	0	439
27119	6	430	3	4	0	443
27120	435	8	0	4	0	447
27121	9	1	434	3	0	447
27122	2	1	429	3	0	435
27123	423	2	7	1	0	433
27124	7	3	2	431	0	443
27125	4	1	3	434	0	442
27126	2	1	442	6	0	451
27127	1	1	431	2	0	435
27128	1	438	8	1	0	448
27129	432	5	4	3	0	444
27130	406	2	0	1	0	409
27131	6	398	1	1	0	406
27132	2	5	0	405	0	412
27133	403	1	0	5	0	409
27134	4	0	2	398	0	404
27135	412	1	1	5	0	419
27136	426	0	0	2	0	428
27137	438	0	1	2	0	441
27138	5	0	1	432	0	438
27139	1	0	0	447	0	448
27140	427	0	1	6	0	434
27141	424	1	0	1	0	426
27142	426	1	0	1	0	428
27143	6	415	2	2	0	425
27144	401	7	0	0	0	408
27145	7	404	0	0	0	411
27146	398	5	2	1	0	406
27147	5	1	405	0	0	411
27148	360	6	4	1	0	371
27149	6	371	0	1	0	378
27150	0	348	0	1	0	349
27151	357	3	0	2	0	362
27152	4	0	1	358	0	363
27153	0	1	0	363	0	364
27154	1	369	0	3	0	373
27155	2	403	1	0	0	406
27156	407	5	0	0	0	412
27157	5	0	454	1	0	460
27158	0	1	4	483	0	488
27159	497	0	0	7	0	504
27160	9	2	492	0	0	503
27161	2	539	8	1	0	550
27162	565	8	1	0	0	574
27163	9	0	591	0	0	600
27164	0	1	8	600	0	609
27165	1	0	620	9	0	630
27166	606	0	9	3	0	618
27167	9	643	1	1	0	654
27168	640	9	3	0	0	652
27169	657	3	0	0	0	660
27170	10	0	0	654	0	664
27171	674	0	1	9	0	684
27172	8	1	0	667	0	676
27173	2	0	0	672	0	674
27174	0	1	648	10	0	659
27175	2	648	8	2	0	660
27176	0	8	3	661	0	672
27177	1	1	0	674	0	676
27178	1	0	1	670	0	672
27179	0	1	654	10	0	665
27180	1	650	7	1	0	659
27181	2	8	2	664	0	676
27182	1	3	0	673	0	677
27183	0	0	667	12	0	679
27184	1	0	9	641	0	651
27185	658	1	1	8	0	668
27186	10	658	0	14	0	682
27187	647	6	0	1	0	654
27188	9	1	654	6	0	670
27189	3	0	7	655	0	665
27190	669	0	1	11	0	681
27191	674	0	0	3	0	677
27192	9	0	675	1	0	685
27193	2	2	8	656	0	668
27194	2	1	657	7	0	667
27195	617	0	9	3	0	629
27196	6	657	2	3	0	668
27197	672	7	1	5	0	685
27198	669	1	5	0	0	675
27199	10	687	2	1	0	700
27200	696	10	1	0	0	707
27201	11	2	693	1	0	707
27202	695	1	9	2	0	707
27203	9	2	2	706	0	719
27204	5	0	725	9	0	739
27205	1	2	8	736	0	747
27206	9	2	2	703	0	716
27207	4	0	3	733	0	740
27208	2	741	1	12	0	756
27209	734	8	1	4	0	747
27210	11	3	1	728	0	743
27211	2	732	1	12	0	747
27212	0	8	2	708	0	718
27213	4	717	2	9	0	732
27214	0	9	736	5	0	750
27215	2	4	8	733	0	747
27216	2	0	3	748	0	753
27217	2	2	736	11	0	751
27218	653	4	11	2	0	670
27219	11	728	2	5	0	746
27220	4	8	3	731	0	746
27221	5	2	3	714	0	724
27222	4	3	5	700	0	712
27223	5	717	2	14	0	738
27224	711	9	3	10	0	733
27225	14	3	718	4	0	739
27226	5	2	689	4	0	700
27227	5	3	12	697	0	717
27228	5	2	2	725	0	734
27229	716	1	4	13	0	734
27230	13	705	4	6	0	728
27231	3	11	1	717	0	732
27232	727	2	1	11	0	741
27233	14	1	3	715	0	733
27234	730	5	1	11	0	747
27235	11	1	701	10	0	723
27236	5	706	12	3	0	726
27237	706	9	2	8	0	725
27238	10	5	704	7	0	726
27239	672	2	11	6	0	691
27240	8	2	692	4	0	706
27241	690	1	9	7	0	707
27242	10	2	4	708	0	724
27243	717	4	3	12	0	736
27244	12	1	2	715	0	730
27245	3	2	3	723	0	731
27246	713	4	3	14	0	734
27247	13	698	2	7	0	720
27248	3	10	3	718	0	734
27249	737	2	5	12	0	756
27250	760	3	1	7	0	771
27251	14	3	4	745	0	766
27252	5	2	3	750	0	760
27253	767	2	2	16	0	787
27254	14	1	2	773	0	790
27255	7	4	0	764	0	775
27256	745	1	4	12	0	762
27257	16	3	1	687	0	707
27258	1	2	642	7	0	652
27259	623	1	5	4	0	633
27260	7	2	640	1	0	650
27261	3	2	562	1	0	568
27262	543	0	9	1	0	553
27263	6	540	4	1	0	551
27264	3	4	2	529	0	538
27265	6	0	5	531	0	542
27266	3	0	1	534	0	538
27267	0	1	0	570	0	571
27268	560	0	1	11	0	572
27269	597	0	0	4	0	601
27270	620	1	0	8	0	629
27271	11	0	682	3	0	696
27272	4	2	15	734	0	755
27273	3	0	3	762	0	768
27274	5	0	3	730	0	738
27275	2	707	3	28	0	740
27276	0	724	1	15	0	740
27277	741	23	1	9	0	774
27278	22	8	1	742	0	773
27279	8	5	1	804	0	818
27280	5	3	0	829	0	837
27281	5	0	792	28	0	825
27282	2	3	788	13	0	806
27283	780	2	25	8	0	815
27284	824	0	10	4	0	838
27285	25	2	8	794	0	829
27286	10	804	5	24	0	843
27287	10	20	1	817	0	848
27288	6	7	1	814	0	828
27289	1	6	780	32	0	819
27290	770	5	21	14	0	810
27291	27	2	8	822	0	859
27292	9	1	6	808	0	824
27293	785	1	3	33	0	822
27294	29	796	2	15	0	842
27295	813	28	2	12	0	855
27296	34	6	4	796	0	840
27297	8	791	3	29	0	831
27298	799	29	3	10	0	841
27299	37	7	2	782	0	828
27300	765	6	1	34	0	806
27301	771	4	1	15	0	791
27302	780	1	1	10	0	792
27303	38	747	2	7	0	794
27304	19	748	1	5	0	773
27305	13	33	2	699	0	747
27306	6	726	1	29	0	762
27307	736	35	0	12	0	783
27308	31	9	2	743	0	785
27309	740	7	1	31	0	779
27310	764	6	1	11	0	782
27311	42	3	0	732	0	777
27312	18	3	2	761	0	784
27313	749	6	3	36	0	794
27314	751	2	0	19	0	772
27315	781	4	0	15	0	800
27316	795	3	2	6	0	806
27317	795	5	3	6	0	809
27318	45	4	0	762	0	811
27319	20	3	1	778	0	802
27320	14	3	1	799	0	817
27321	768	6	1	42	0	817
27322	35	6	0	758	0	799
27323	15	756	2	35	0	808
27324	15	28	2	768	0	813
27325	756	8	0	39	0	803
27326	773	7	0	23	0	803
27327	39	4	748	20	0	811
27328	21	3	29	728	0	781
27329	22	738	7	34	0	801
27330	760	29	8	12	0	809
27331	34	764	4	16	0	818
27332	15	35	1	761	0	812
27333	769	11	0	43	0	823
27334	785	11	3	17	0	816
27335	41	770	3	17	0	831
27336	24	30	2	769	0	825
27337	21	8	759	36	0	824
27338	729	9	28	18	0	784
27339	35	8	757	20	0	820
27340	756	5	33	13	0	807
27341	790	3	10	12	0	815
27342	43	6	9	760	0	818
27343	790	4	4	36	0	834
27344	821	6	1	11	0	839
27345	821	6	0	20	0	847
27346	45	5	2	803	0	855
27347	819	4	1	41	0	865
27348	48	1	6	814	0	869
27349	21	3	3	818	0	845
27350	15	799	5	35	0	854
27351	14	28	2	783	0	827
27352	13	793	2	35	0	843
27353	778	33	2	14	0	827
27354	781	13	3	12	0	809
27355	37	8	2	765	0	812
27356	24	7	2	778	0	811
27357	776	4	1	36	0	817
27358	35	4	733	23	0	795
27359	746	5	23	22	0	796
27360	43	2	7	755	0	807
27361	21	5	723	29	0	778
27362	726	5	24	11	0	766
27363	757	5	4	14	0	780
27364	36	5	735	10	0	786
27365	733	4	24	13	0	774
27366	36	4	740	10	0	790
27367	19	733	27	8	0	787
27368	739	23	8	8	0	778
27369	723	9	8	11	0	751
27370	27	687	5	6	0	725
27371	14	620	4	5	0	643
27372	570	9	9	3	0	591
27373	560	2	2	4	0	568
27374	16	3	1	561	0	581
27375	4	0	549	11	0	564
27376	5	2	521	4	0	532
27377	534	2	10	5	0	551
27378	12	2	544	2	0	560
27379	490	11	11	6	0	518
27380	14	0	0	486	0	500
27381	2	0	2	506	0	510
27382	5	0	501	10	0	516
27383	491	0	9	7	0	507
27384	10	0	0	511	0	521
27385	2	0	3	522	0	527
27386	506	0	2	11	0	519
27387	509	0	0	3	0	512
27388	502	0	1	4	0	507
27389	12	517	1	2	0	532
27390	4	5	502	1	0	512
27391	484	1	7	0	0	492
27392	498	2	2	1	0	503
27393	5	491	3	1	0	500
27394	473	3	0	1	0	477
27395	5	1	0	468	0	474
27396	1	3	498	4	0	506
27397	473	0	4	2	0	479
27398	494	0	2	2	0	498
27399	501	0	0	2	0	503
27400	504	1	1	1	0	507
27401	6	0	1	505	0	512
27402	3	0	1	501	0	505
27403	505	0	1	5	0	511
27404	6	0	1	512	0	519
27405	2	0	0	511	0	513
27406	1	500	0	6	0	507
27407	0	3	0	506	0	509
27408	2	1	0	502	0	505
27409	1	1	0	506	0	508
27410	2	0	0	505	0	507
27411	1	496	0	7	0	504
27412	1	4	0	498	0	503
27413	1	1	0	482	0	484
27414	0	1	471	5	0	477
27415	0	0	430	3	0	433
27416	0	452	4	1	0	457
27417	519	4	2	1	0	526
27418	7	526	1	0	0	534
27419	3	7	0	566	0	576
27420	2	1	634	8	0	645
27421	664	1	10	3	0	678
27422	11	0	2	690	0	703
27423	680	0	1	10	0	691
27424	700	0	0	2	0	702
27425	12	709	0	1	0	722
27426	709	9	0	1	0	719
27427	8	740	0	1	0	749
27428	3	10	0	737	0	750
27429	1	751	0	13	0	765
27430	1	10	748	5	0	764
27431	0	753	7	1	0	761
27432	0	10	4	750	0	764
27433	727	7	1	10	0	745
27434	8	744	1	7	0	760
27435	6	11	1	747	0	765
27436	0	8	0	784	0	792
27437	1	2	773	19	0	795
27438	3	2	11	775	0	791
27439	0	1	781	14	0	796
27440	737	0	14	10	0	761
27441	13	1	781	3	0	798
27442	10	780	13	2	0	805
27443	4	15	8	769	0	796
27444	2	8	3	778	0	791
27445	4	3	4	777	0	788
27446	767	2	1	22	0	792
27447	15	4	1	756	0	776
27448	12	760	0	20	0	792
27449	733	19	3	10	0	765
27450	17	737	0	4	0	758
27451	12	20	3	735	0	770
27452	741	10	1	18	0	770
27453	20	729	2	11	0	762
27454	10	764	1	4	0	779
27455	760	23	2	4	0	789
27456	764	12	1	5	0	782
27457	26	2	750	5	0	783
27458	764	6	17	4	0	791
27459	21	3	796	4	0	824
27460	13	5	19	795	0	832
27461	4	2	795	23	0	824
27462	5	4	24	795	0	828
27463	2	1	798	29	0	830
27464	5	3	25	779	0	812
27465	4	4	9	774	0	791
27466	750	3	6	37	0	796
27467	21	2	747	16	0	786
27468	729	2	24	6	0	761
27469	23	3	745	10	0	781
27470	10	5	741	5	0	761
27471	11	2	29	716	0	758
27472	720	5	12	20	0	757
27473	21	716	4	13	0	754
27474	712	21	2	9	0	744
27475	724	10	4	6	0	744
27476	27	716	2	8	0	753
27477	711	22	3	4	0	740
27478	29	11	740	1	0	781
27479	12	8	23	738	0	781
27480	749	4	8	25	0	786
27481	21	744	9	11	0	785
27482	14	19	5	734	0	772
27483	5	10	7	747	0	769
27484	6	6	2	755	0	769
27485	5	5	6	757	0	773
27486	739	4	5	33	0	781
27487	758	2	3	19	0	782
27488	758	3	9	8	0	778
27489	736	1	5	11	0	753
27490	34	2	726	6	0	768
27491	719	1	21	7	0	748
27492	736	7	14	3	0	760
27493	35	713	4	16	0	768
27494	18	739	7	2	0	766
27495	7	24	5	701	0	737
27496	10	10	3	709	0	732
27497	13	7	685	27	0	732
27498	5	696	21	13	0	735
27499	14	18	9	665	0	706
27500	6	686	9	22	0	723
27501	6	21	5	699	0	731
27502	5	8	8	702	0	723
27503	7	691	3	32	0	733
27504	6	20	3	708	0	737
27505	7	11	706	24	0	748
27506	10	3	713	15	0	741
27507	680	6	27	11	0	724
27508	716	3	13	12	0	744
27509	24	711	11	11	0	757
27510	731	18	3	11	0	763
27511	32	9	4	718	0	763
27512	723	9	4	21	0	757
27513	29	718	0	14	0	761
27514	18	20	720	9	0	767
27515	702	13	27	9	0	751
27516	28	5	758	10	0	801
27517	13	3	686	6	0	708
27518	8	5	690	3	0	706
27519	9	651	21	2	0	683
27520	567	21	30	3	0	621
27521	555	7	9	6	0	577
27522	19	4	5	552	0	580
27523	8	9	1	550	0	568
27524	8	585	1	15	0	609
27525	590	14	0	9	0	613
27526	14	581	2	11	0	608
27527	7	568	1	7	0	583
27528	553	12	8	2	0	575
27529	14	4	5	539	0	562
27530	4	1	6	551	0	562
27531	5	3	2	569	0	579
27532	7	560	1	12	0	580
27533	561	12	0	5	0	578
27534	13	3	1	553	0	570
27535	4	531	1	10	0	546
27536	5	524	0	5	0	534
27537	2	10	1	516	0	529
27538	2	519	2	8	0	531
27539	3	9	2	509	0	523
27540	513	1	1	8	0	523
27541	7	2	504	0	0	513
27542	1	526	7	3	0	537
27543	3	7	1	528	0	539
27544	1	1	549	9	0	560
27545	516	3	10	3	0	532
27546	12	2	1	557	0	572
27547	539	0	3	8	0	550
27548	545	2	0	2	0	549
27549	6	578	0	8	0	592
27550	589	6	0	1	0	596
27551	576	2	0	2	0	580
27552	582	5	0	1	0	588
27553	9	1	1	566	0	577
27554	4	0	2	566	0	572
27555	5	0	1	572	0	578
27556	2	2	561	9	0	574
27557	1	562	6	3	0	572
27558	555	3	1	4	0	563
27559	4	550	2	2	0	558
27560	1	4	0	545	0	550
27561	2	0	545	2	0	549
27562	480	2	3	4	0	489
27563	2	556	0	2	0	560
27564	1	3	2	558	0	564
27565	4	0	0	556	0	560
27566	1	3	559	2	0	565
27567	0	552	2	7	0	561
27568	1	1	0	552	0	554
27569	0	1	2	560	0	563
27570	0	2	1	557	0	560
27571	546	1	1	6	0	554
27572	3	1	549	2	0	555
27573	3	541	2	3	0	549
27574	543	2	1	2	0	548
27575	3	549	4	0	0	556
27576	5	4	0	548	0	557
27577	3	548	0	7	0	558
27578	518	5	0	1	0	524
27579	523	2	0	2	0	527
27580	2	1	2	532	0	537
27581	4	1	0	538	0	543
27582	3	1	1	553	0	558
27583	1	0	548	9	0	558
27584	1	574	7	5	0	587
27585	2	7	2	637	0	648
27586	4	1	5	660	0	670
27587	1	4	3	678	0	686
27588	2	1	0	697	0	700
27589	1	2	686	18	0	707
27590	3	740	10	8	0	761
27591	3	16	4	782	0	805
27592	2	6	2	865	0	875
27593	3	6	852	24	0	885
27594	3	1	18	833	0	855
27595	2	824	6	24	0	856
27596	2	851	5	13	0	871
27597	2	21	1	851	0	875
27598	0	13	826	24	0	863
27599	752	5	18	17	0	792
27600	15	818	7	14	0	854
27601	6	23	815	7	0	851
27602	7	9	807	11	0	834
27603	2	809	25	11	0	847
27604	2	22	819	6	0	849
27605	3	14	20	796	0	833
27606	794	6	10	21	0	831
27607	808	1	11	9	0	829
27608	787	4	3	9	0	803
27609	837	7	1	3	0	848
27610	27	830	5	8	0	870
27611	847	17	8	8	0	880
27612	27	863	4	2	0	896
27613	11	25	847	9	0	892
27614	13	8	21	818	0	860
27615	5	849	10	29	0	893
27616	6	25	10	823	0	864
27617	802	13	5	28	0	848
27618	23	13	4	787	0	827
27619	8	798	7	32	0	845
27620	808	23	3	10	0	844
27621	23	14	794	9	0	840
27622	13	12	24	774	0	823
27623	12	7	11	800	0	830
27624	741	11	9	32	0	793
27625	24	737	10	18	0	789
27626	14	26	735	13	0	788
27627	15	13	24	736	0	788
27628	5	16	748	29	0	798
27629	10	721	28	12	0	771
27630	13	759	12	10	0	794
27631	724	31	11	15	0	781
27632	25	15	738	12	0	790
27633	747	12	21	13	0	793
27634	33	8	15	724	0	780
27635	8	755	14	25	0	802
27636	749	25	6	16	0	796
27637	26	11	745	18	0	800
27638	16	17	23	734	0	790
27639	11	8	11	761	0	791
27640	11	9	11	742	0	773
27641	8	720	8	35	0	771
27642	697	29	8	18	0	752
27643	21	705	8	16	0	750
27644	11	702	7	12	0	732
27645	16	25	6	690	0	737
27646	687	20	11	25	0	743
27647	695	8	11	16	0	730
27648	689	10	5	18	0	722
27649	36	653	7	8	0	704
27650	15	30	2	646	0	693
27651	13	15	645	24	0	697
27652	13	14	21	639	0	687
27653	9	12	12	636	0	669
27654	12	651	10	29	0	702
27655	655	23	7	22	0	707
27656	29	16	3	641	0	689
27657	17	656	6	21	0	700
27658	663	25	8	15	0	711
27659	25	10	661	19	0	715
27660	644	15	23	6	0	688
27661	30	674	8	17	0	729
27662	683	28	7	16	0	734
27663	678	15	6	9	0	708
27664	29	16	666	11	0	722
27665	678	9	22	11	0	720
27666	28	13	689	15	0	745
27667	19	10	698	4	0	731
27668	678	9	29	9	0	725
27669	711	5	15	9	0	740
27670	32	15	695	6	0	748
27671	20	7	26	679	0	732
27672	17	6	15	687	0	725
27673	13	726	13	31	0	783
27674	713	23	8	10	0	754
27675	760	16	6	12	0	794
27676	35	8	753	7	0	803
27677	747	6	24	13	0	790
27678	772	6	12	9	0	799
27679	35	736	10	9	0	790
27680	18	26	8	739	0	791
27681	24	9	3	729	0	765
27682	13	17	8	731	0	769
27683	725	5	9	28	0	767
27684	29	687	3	17	0	736
27685	12	24	10	606	0	652
27686	16	610	4	16	0	646
27687	9	30	7	549	0	595
27688	7	574	4	15	0	600
27689	10	591	4	8	0	613
27690	500	10	7	13	0	530
27691	494	4	6	7	0	511
27692	3	4	1	426	0	434
27693	3	1	1	435	0	440
27694	4	0	0	443	0	447
27695	0	2	1	442	0	445
27696	0	1	0	448	0	449
27697	1	441	0	2	0	444
27698	1	1	0	451	0	453
27699	2	1	0	448	0	451
27700	447	3	0	2	0	452
27701	1	0	1	451	0	453
27702	2	1	0	458	0	461
27703	3	0	465	3	0	471
27704	1	2	1	468	0	472
27705	1	2	0	488	0	491
27706	1	0	485	5	0	491
27707	2	492	3	2	0	499
27708	1	2	509	3	0	515
27709	1	0	474	2	0	477
27710	0	479	4	0	0	483
27711	466	2	5	2	0	475
27712	471	0	1	1	0	473
27713	2	1	1	468	0	472
27714	492	1	0	3	0	496
27715	3	0	519	1	0	523
27716	0	0	3	524	0	527
27717	1	1	578	2	0	582
27718	1	0	3	574	0	578
27719	1	0	1	585	0	587
27720	0	0	1	591	0	592
27721	578	0	0	3	0	581
27722	3	0	1	578	0	582
27723	582	1	0	4	0	587
27724	583	0	1	2	0	586
27725	2	579	0	4	0	585
27726	587	2	0	3	0	592
27727	4	598	0	1	0	603
27728	1	4	0	585	0	590
27729	2	0	0	586	0	588
27730	0	2	2	593	0	597
27731	0	0	589	6	0	595
27732	0	585	3	2	0	590
27733	3	4	0	563	0	570
27734	2	2	1	559	0	564
27735	2	583	0	8	0	593
27736	597	3	0	3	0	603
27737	4	589	1	5	0	599
27738	583	5	0	2	0	590
27739	6	590	2	1	0	599
27740	0	6	0	581	0	587
27741	2	593	1	3	0	599
27742	601	6	0	6	0	613
27743	615	0	0	4	0	619
27744	608	1	1	3	0	613
27745	609	1	0	3	0	613
27746	5	0	595	3	0	603
27747	599	2	5	0	0	606
27748	613	1	0	4	0	618
27749	606	2	1	3	0	612
27750	6	2	601	2	0	611
27751	599	2	3	2	0	606
27752	4	615	1	4	0	624
27753	617	3	4	2	0	626
27754	4	3	665	3	0	675
27755	667	1	4	3	0	675
27756	679	2	1	1	0	683
27757	5	3	1	671	0	680
27758	6	1	655	4	0	666
27759	644	3	6	1	0	654
27760	7	1	0	653	0	661
27761	2	2	3	657	0	664
27762	5	0	653	7	0	665
27763	604	2	5	7	0	618
27764	646	1	0	3	0	650
27765	5	657	3	2	0	667
27766	5	3	0	669	0	677
27767	5	2	2	668	0	677
27768	6	1	1	663	0	671
27769	3	665	1	8	0	677
27770	663	3	2	3	0	671
27771	8	2	1	659	0	670
27772	2	1	1	661	0	665
27773	634	1	1	4	0	640
27774	614	2	1	3	0	620
27775	6	1	3	625	0	635
27776	5	2	2	608	0	617
27777	6	2	596	3	0	607
27778	561	1	5	2	0	569
27779	7	608	0	4	0	619
27780	2	3	2	627	0	634
27781	5	0	1	646	0	652
27782	0	699	2	6	0	707
27783	2	6	0	717	0	725
27784	791	2	1	11	0	805
27785	13	2	0	951	0	966
27786	4	0	2	982	0	988
27787	5	3	0	1014	0	1022
27788	5	0	984	41	0	1030
27789	1	2	23	986	0	1012
27790	1	0	983	37	0	1021
27791	2	944	26	21	0	993
27792	2	25	20	951	0	998
27793	4	13	6	959	0	982
27794	2	4	5	979	0	990
27795	5	3	2	983	0	993
27796	2	1	2	982	0	987
27797	925	2	1	48	0	976
27798	26	0	916	29	0	971
27799	12	904	27	14	0	957
27800	4	959	13	12	0	988
27801	4	37	3	947	0	991
27802	3	14	5	970	0	992
27803	2	9	6	960	0	977
27804	0	947	1	44	0	992
27805	1	26	2	951	0	980
27806	3	16	935	35	0	989
27807	0	918	24	26	0	968
27808	1	26	12	931	0	970
27809	902	14	4	33	0	953
27810	24	3	4	927	0	958
27811	12	5	3	943	0	963
27812	3	904	2	43	0	952
27813	3	953	4	17	0	977
27814	4	33	1	912	0	950
27815	1	16	2	914	0	933
27816	0	10	884	42	0	936
27817	1	4	23	855	0	883
27818	2	4	14	869	0	889
27819	0	4	1	872	0	877
27820	2	1	6	886	0	895
27821	840	3	5	48	0	896
27822	856	1	4	28	0	889
27823	35	3	2	856	0	896
27824	15	3	2	896	0	916
27825	857	4	0	49	0	910
27826	33	0	1	893	0	927
27827	15	2	901	43	0	961
27828	3	901	31	27	0	962
27829	5	27	12	910	0	954
27830	6	12	4	942	0	964
27831	920	2	8	49	0	979
27832	25	6	7	939	0	977
27833	13	7	3	969	0	992
27834	948	4	2	54	0	1008
27835	30	1	1	968	0	1000
27836	16	966	2	47	0	1031
27837	8	30	0	1016	0	1054
27838	6	22	2	1049	0	1079
27839	5	4	3	1041	0	1053
27840	3	6	2	1058	0	1069
27841	3	6	1008	56	0	1073
27842	3	3	999	31	0	1036
27843	5	5	40	994	0	1044
27844	1	3	14	1020	0	1038
27845	1	1008	8	51	0	1068
27846	6	34	8	999	0	1047
27847	2	1012	6	51	0	1071
27848	985	37	4	32	0	1058
27849	29	1060	3	19	0	1111
27850	16	36	4	1077	0	1133
27851	3	19	2	1111	0	1135
27852	6	8	1043	58	0	1115
27853	1000	7	35	27	0	1069
27854	996	7	15	20	0	1038
27855	44	989	3	20	0	1056
27856	17	34	4	981	0	1036
27857	9	17	1041	36	0	1103
27858	11	1053	33	25	0	1122
27859	1048	38	14	16	0	1116
27860	1068	17	4	17	0	1106
27861	48	8	1013	11	0	1080
27862	1033	7	33	15	0	1088
27863	42	6	13	1045	0	1106
27864	25	1047	5	39	0	1116
27865	1031	32	3	26	0	1092
27866	40	15	6	1024	0	1085
27867	1020	9	4	45	0	1078
27868	1071	7	2	30	0	1110
27869	51	6	6	1049	0	1112
27870	24	10	1047	47	0	1128
27871	1037	2	35	36	0	1110
27872	1082	7	16	23	0	1128
27873	1094	5	8	20	0	1127
27874	51	1083	7	20	0	1161
27875	23	35	8	1099	0	1165
27876	19	16	4	1148	0	1187
27877	20	7	1122	58	0	1207
27878	8	13	34	1126	0	1181
27879	10	1117	15	49	0	1191
27880	1089	36	4	30	0	1159
27881	38	1094	5	26	0	1163
27882	23	40	1060	21	0	1144
27883	12	1078	35	15	0	1140
27884	11	1027	20	20	0	1078
27885	13	26	9	837	0	885
27886	832	5	8	33	0	878
27887	833	8	1	9	0	851
27888	822	5	2	8	0	837
27889	17	840	3	9	0	869
27890	7	21	840	8	0	876
27891	825	7	21	6	0	859
27892	860	4	4	12	0	880
27893	17	862	5	10	0	894
27894	877	22	2	6	0	907
27895	30	4	3	879	0	916
27896	11	7	929	19	0	966
27897	931	9	21	4	0	965
27898	943	7	5	6	0	961
27899	973	3	5	10	0	991
27900	25	3	6	947	0	981
27901	14	4	2	951	0	971
27902	14	6	1	1013	0	1034
27903	12	997	3	22	0	1034
27904	7	30	6	1015	0	1058
27905	8	4	8	1153	0	1173
27906	10	6	1156	29	0	1201
27907	10	6	25	1148	0	1189
27908	7	4	6	1189	0	1206
27909	10	2	2	1180	0	1194
27910	11	2	2	1180	0	1195
27911	10	1145	4	30	0	1189
27912	6	30	5	1154	0	1195
27913	8	9	5	1168	0	1190
27914	1150	0	3	38	0	1191
27915	30	3	1130	15	0	1178
27916	11	7	1118	10	0	1146
27917	1092	6	28	15	0	1141
27918	1148	3	9	15	0	1175
27919	34	8	6	1053	0	1101
27920	14	1126	5	24	0	1169
27921	1134	24	6	12	0	1176
27922	35	9	3	1117	0	1164
27923	15	1130	3	32	0	1180
27924	1129	20	3	17	0	1169
27925	22	1136	2	12	0	1172
27926	1119	28	2	3	0	1152
27927	1089	9	2	11	0	1111
27928	26	1061	3	8	0	1098
27929	15	25	4	1060	0	1104
27930	10	6	1060	25	0	1101
27931	3	5	24	1044	0	1076
27932	1037	2	8	24	0	1071
27933	28	2	1017	14	0	1061
27934	10	1005	21	5	0	1041
27935	5	25	7	999	0	1036
27936	5	10	987	22	0	1024
27937	5	970	19	15	0	1009
27938	947	22	9	5	0	983
27939	20	9	3	960	0	992
27940	13	6	0	958	0	977
27941	8	1	1	958	0	968
27942	5	956	2	24	0	987
27943	950	25	1	10	0	986
27944	22	954	3	6	0	985
27945	8	963	5	10	0	986
27946	969	25	3	7	0	1004
27947	974	7	2	8	0	991
27948	27	6	955	3	0	991
27949	893	5	17	5	0	920
27950	899	5	7	4	0	915
27951	25	7	3	895	0	930
27952	10	6	890	19	0	925
27953	11	2	18	879	0	910
27954	900	2	9	24	0	935
27955	23	2	891	10	0	926
27956	12	1	19	954	0	986
27957	6	6	7	1036	0	1055
27958	5	4	3	1151	0	1163
27959	1147	7	3	37	0	1194
27960	33	1195	2	12	0	1242
27961	1205	31	3	7	0	1246
27962	36	10	1185	9	0	1240
27963	17	3	31	1155	0	1206
27964	5	1205	16	29	0	1255
27965	1214	33	3	10	0	1260
27966	36	12	3	1214	0	1265
27967	13	5	1199	37	0	1254
27968	3	6	35	1194	0	1238
27969	1154	2	14	40	0	1210
27970	30	1152	3	22	0	1207
27971	14	33	5	1058	0	1110
27972	4	1153	3	33	0	1193
27973	1133	33	3	18	0	1187
27974	1125	13	0	14	0	1152
27975	44	1108	4	8	0	1164
27976	1107	39	1	7	0	1154
27977	37	13	2	1044	0	1096
27978	18	1077	4	29	0	1128
27979	1079	31	1	17	0	1128
27980	1111	15	1	7	0	1134
27981	39	1040	5	5	0	1089
27982	17	1045	1	8	0	1071
27983	1030	36	2	7	0	1075
27984	32	15	4	1019	0	1070
27985	1038	5	3	28	0	1074
27986	34	8	3	1018	0	1063
27987	16	6	1003	34	0	1059
27988	10	5	24	1027	0	1066
27989	998	6	10	32	0	1046
27990	34	2	1015	20	0	1071
27991	17	3	31	1017	0	1068
27992	7	5	12	1055	0	1079
27993	9	3	1013	38	0	1063
27994	975	7	30	14	0	1026
27995	34	4	11	994	0	1043
27996	17	2	933	31	0	983
27997	872	6	27	18	0	923
27998	30	906	12	7	0	955
27999	11	897	7	6	0	921
28000	9	925	6	7	0	947
28001	6	32	877	10	0	925
28002	12	17	23	821	0	873
28003	3	8	829	26	0	866
28004	8	24	23	726	0	781
28005	4	703	15	25	0	747
28006	3	695	6	14	0	718
28007	7	23	6	674	0	710
28008	658	9	4	33	0	704
28009	24	7	3	680	0	714
28010	10	7	3	679	0	699
28011	7	669	3	29	0	708
28012	660	22	5	13	0	700
28013	23	666	2	11	0	702
28014	11	22	2	682	0	717
28015	6	10	3	683	0	702
28016	8	669	3	32	0	712
28017	7	27	3	675	0	712
28018	674	13	1	28	0	716
28019	28	9	3	684	0	724
28020	13	11	5	682	0	711
28021	13	683	4	25	0	725
28022	14	27	4	692	0	737
28023	681	12	3	32	0	728
28024	688	13	4	16	0	721
28025	706	10	2	14	0	732
28026	37	9	3	676	0	725
28027	19	9	660	29	0	717
28028	18	9	664	16	0	707
28029	19	8	22	679	0	728
28030	691	11	7	29	0	738
28031	30	11	4	690	0	735
28032	710	12	6	27	0	755
28033	33	2	6	716	0	757
28034	21	7	2	740	0	770
28035	729	10	4	31	0	774
28036	32	3	694	19	0	748
28037	702	7	22	16	0	747
28038	32	8	701	17	0	758
28039	20	5	26	710	0	761
28040	714	7	10	29	0	760
28041	32	7	702	16	0	757
28042	21	5	727	6	0	759
28043	702	6	30	14	0	752
28044	35	5	716	12	0	768
28045	15	708	32	14	0	769
28046	12	25	16	738	0	791
28047	812	7	17	32	0	868
28048	29	10	804	18	0	861
28049	807	9	29	12	0	857
28050	831	5	18	16	0	870
28051	836	6	9	13	0	864
28052	833	6	12	19	0	870
28053	41	4	11	796	0	852
28054	23	794	5	31	0	853
28055	789	29	10	16	0	844
28056	37	8	716	11	0	772
28057	11	585	20	6	0	622
28058	504	13	3	6	0	526
28059	12	453	4	1	0	470
28060	2	468	0	1	0	471
28061	14	10	2	452	0	478
28062	4	4	8	452	0	468
28063	0	3	1	455	0	459
28064	456	0	0	13	0	469
28065	463	1	0	2	0	466
28066	8	2	0	466	0	476
28067	6	0	0	493	0	499
28068	1	1	510	12	0	524
28069	498	2	9	7	0	516
28070	531	0	2	2	0	535
28071	13	0	1	530	0	544
28072	4	0	0	541	0	545
28073	2	0	532	14	0	548
28074	1	0	11	530	0	542
28075	2	0	540	12	0	554
28076	1	522	9	3	0	535
28077	1	9	528	2	0	540
28078	1	2	10	519	0	532
28079	1	1	561	10	0	573
28080	1	0	540	5	0	546
28081	555	0	15	2	0	572
28082	10	2	4	601	0	617
28083	2	0	607	12	0	621
28084	561	0	13	3	0	577
28085	12	1	619	2	0	634
28086	4	0	696	0	0	700
28087	3	710	18	2	0	733
28088	1	13	5	714	0	733
28089	0	2	716	17	0	735
28090	3	1	690	3	0	697
28091	2	0	17	684	0	703
28092	3	0	5	694	0	702
28093	2	703	1	13	0	719
28094	1	13	2	711	0	727
28095	726	2	3	15	0	746
28096	747	2	1	4	0	754
28097	747	1	2	4	0	754
28098	16	2	3	735	0	756
28099	5	751	3	12	0	771
28100	750	13	1	6	0	770
28101	13	760	1	3	0	777
28102	2	762	1	2	0	767
28103	5	784	1	2	0	792
28104	796	13	1	5	0	815
28105	13	4	3	778	0	798
28106	7	2	0	785	0	794
28107	3	779	4	14	0	800
28108	768	14	1	6	0	789
28109	14	3	773	3	0	793
28110	5	4	12	774	0	795
28111	779	2	5	14	0	800
28112	12	793	4	6	0	815
28113	826	14	3	2	0	845
28114	16	3	1	830	0	850
28115	2	850	4	13	0	869
28116	2	9	836	5	0	852
28117	845	3	15	4	0	867
28118	13	2	6	856	0	877
28119	869	2	3	14	0	888
28120	15	1	4	863	0	883
28121	4	868	1	16	0	889
28122	4	10	882	6	0	902
28123	1	4	882	4	0	891
28124	3	6	15	887	0	911
28125	897	2	6	15	0	920
28126	894	2	5	5	0	906
28127	19	4	0	897	0	920
28128	7	0	4	902	0	913
28129	910	2	5	16	0	933
28130	16	1	3	922	0	942
28131	923	3	3	18	0	947
28132	13	908	2	6	0	929
28133	901	16	4	4	0	925
28134	19	6	918	3	0	946
28135	9	4	14	907	0	934
28136	5	1	3	928	0	937
28137	5	3	3	928	0	939
28138	4	902	4	15	0	925
28139	6	843	2	7	0	858
28140	5	15	0	921	0	941
28141	3	7	934	12	0	956
28142	4	4	10	920	0	938
28143	3	5	7	929	0	944
28144	3	915	2	16	0	936
28145	903	12	1	6	0	922
28146	8	882	1	6	0	897
28147	6	862	2	2	0	872
28148	4	10	4	861	0	879
28149	4	1	6	867	0	878
28150	3	0	4	859	0	866
28151	4	4	1	861	0	870
28152	856	3	1	14	0	874
28153	13	859	1	4	0	877
28154	862	12	1	4	0	879
28155	885	6	2	1	0	894
28156	11	2	5	880	0	898
28157	6	2	3	888	0	899
28158	879	0	0	17	0	896
28159	919	2	0	7	0	928
28160	11	4	0	883	0	898
28161	7	7	1	890	0	905
28162	5	3	893	10	0	911
28163	3	857	9	6	0	875
28164	4	899	2	7	0	912
28165	888	11	0	4	0	903
28166	11	1	932	5	0	949
28167	2	2	874	5	0	883
28168	819	3	12	7	0	841
28169	856	1	2	4	0	863
28170	7	946	1	3	0	957
28171	3	971	1	1	0	976
28172	1	7	1	980	0	989
28173	1022	2	1	7	0	1032
28174	1026	0	1	3	0	1030
28175	1046	1	1	6	0	1054
28176	7	1	2	1031	0	1041
28177	3	2	0	1054	0	1059
28178	3	2	1049	7	0	1061
28179	1	2	964	2	0	969
28180	0	2	1043	3	0	1048
28181	1	19	3	982	0	1005
28182	973	1	2	0	0	976
28183	2	0	994	0	0	996
28184	2	0	1	988	0	991
28185	2	1021	1	2	0	1026
28186	2	2	0	979	0	983
28187	2	1	1	968	0	972
28188	1	0	981	3	0	985
28189	3	0	1	967	0	971
28190	1032	0	0	5	0	1037
28191	7	0	1088	0	0	1095
28192	2	5	7	1088	0	1102
28193	2	1	1143	7	0	1153
28194	2	1153	12	1	0	1168
28195	8	8	1159	4	0	1179
28196	0	4	21	1081	0	1106
28197	1	1	6	1164	0	1172
28198	2	2	1194	13	0	1211
28199	2	10	11	1171	0	1194
28200	1	1	13	1158	0	1173
28201	0	1174	3	26	0	1203
28202	1	8	1200	15	0	1224
28203	2	4	19	1184	0	1209
28204	1	3	6	1211	0	1221
28205	2	1208	2	23	0	1235
28206	1	16	2	1224	0	1243
28207	1230	6	10	15	0	1261
28208	11	2	2	1246	0	1261
28209	6	3	1255	23	0	1287
28210	1223	8	13	12	0	1256
28211	1351	0	8	12	0	1371
28212	31	1	1368	4	0	1404
28213	1296	1	19	12	0	1328
28214	19	1355	17	4	0	1395
28215	18	16	3	1400	0	1437
28216	10	11	3	1610	0	1634
28217	2	3	10	1599	0	1614
28218	10	3	1	1643	0	1657
28219	4	9	0	1650	0	1663
28220	1619	2	4	62	0	1687
28221	33	1	1596	33	0	1663
28222	1521	0	33	21	0	1575
28223	38	5	1574	17	0	1634
28224	14	1	38	1572	0	1625
28225	1578	0	14	43	0	1635
28226	40	0	16	1567	0	1623
28227	27	1597	8	33	0	1665
28228	1637	32	14	17	0	1700
28229	39	19	3	1690	0	1751
28230	26	3	1591	51	0	1671
28231	1562	2	34	45	0	1643
28232	40	1735	14	32	0	1821
28233	26	36	1759	24	0	1845
28234	21	18	41	1730	0	1810
28235	15	8	38	1672	0	1733
28236	28	1735	11	57	0	1831
28237	7	44	1770	27	0	1848
28238	11	14	51	1746	0	1822
28239	16	7	1791	65	0	1879
28240	11	7	43	1778	0	1839
28241	5	21	23	1795	0	1844
28242	16	8	1761	67	0	1852
28243	12	5	46	1778	0	1841
28244	19	6	58	1434	0	1517
28245	21	5	14	1898	0	1938
28246	16	16	12	1898	0	1942
28247	1794	5	29	78	0	1906
28248	46	3	1786	63	0	1898
28249	1853	7	45	47	0	1952
28250	52	18	21	1931	0	2022
28251	26	7	26	1983	0	2042
28252	23	5	14	1967	0	2009
28253	15	1924	27	77	0	2043
28254	1936	45	13	62	0	2056
28255	50	19	15	2000	0	2084
28256	25	1978	26	77	0	2106
28257	14	45	13	2050	0	2122
28258	2014	26	13	91	0	2144
28259	2002	8	10	63	0	2083
28260	1988	14	9	52	0	2063
28261	78	1981	8	28	0	2095
28262	30	45	1978	38	0	2091
28263	1968	20	50	28	0	2066
28264	2029	9	27	39	0	2104
28265	77	2005	11	44	0	2137
28266	2005	59	14	31	0	2109
28267	1972	32	20	33	0	2057
28268	2035	14	12	30	0	2091
28269	81	2034	12	48	0	2175
28270	37	66	10	2021	0	2134
28271	2021	31	14	66	0	2132
28272	2115	11	13	36	0	2175
28273	2047	13	10	30	0	2100
28274	2086	18	9	29	0	2142
28275	76	21	8	2016	0	2121
28276	53	11	1996	68	0	2128
28277	51	8	50	1978	0	2087
28278	51	2012	23	63	0	2149
28279	36	60	14	2072	0	2182
28280	33	28	2082	77	0	2220
28281	2097	8	64	43	0	2212
28282	79	15	23	2151	0	2268
28283	2138	31	19	67	0	2255
28284	2166	12	10	69	0	2257
28285	94	12	16	2147	0	2269
28286	63	11	2147	69	0	2290
28287	45	10	2087	52	0	2194
28288	2073	13	66	26	0	2178
28289	89	2094	28	38	0	2249
28290	43	2067	24	28	0	2162
28291	26	2024	17	29	0	2096
28292	30	2111	15	20	0	2176
28293	2005	55	29	34	0	2123
28294	2042	30	24	20	0	2116
28295	2060	18	10	17	0	2105
28296	2074	20	4	30	0	2128
28297	79	21	11	1985	0	2096
28298	57	1967	6	51	0	2081
28299	1955	45	7	35	0	2042
28300	68	19	1986	15	0	2088
28301	41	1954	51	18	0	2064
28302	39	41	1962	21	0	2063
28303	1910	34	43	17	0	2004
28304	2006	22	20	20	0	2068
28305	2007	29	11	17	0	2064
28306	72	28	13	1969	0	2082
28307	49	17	1980	48	0	2094
28308	38	1980	43	24	0	2085
28309	1945	39	18	21	0	2023
28310	65	1948	8	23	0	2044
28311	31	1869	7	26	0	1933
28312	29	1849	9	13	0	1900
28313	42	1872	7	16	0	1937
28314	32	44	1805	10	0	1891
28315	21	1811	38	18	0	1888
28316	1577	21	11	7	0	1616
28317	16	12	6	1583	0	1617
28318	12	8	6	1583	0	1609
28319	1577	9	6	20	0	1612
28320	20	1563	4	8	0	1595
28321	15	13	1599	9	0	1636
28322	11	7	13	1576	0	1607
28323	19	1	4	1593	0	1617
28324	13	8	6	1613	0	1640
28325	5	6	1606	23	0	1640
28326	9	1	1569	13	0	1592
28327	9	12	20	1560	0	1601
28328	10	7	1561	20	0	1598
28329	8	9	1453	8	0	1478
28330	1302	10	24	10	0	1346
28331	19	1458	10	8	0	1495
28332	15	1373	3	4	0	1395
28333	9	1464	5	7	0	1485
28334	14	13	1	1422	0	1450
28335	11	1498	6	11	0	1526
28336	1499	18	7	7	0	1531
28337	16	9	1502	5	0	1532
28338	1496	9	14	4	0	1523
28339	17	8	4	1516	0	1545
28340	9	9	5	1493	0	1516
28341	8	1571	4	14	0	1597
28342	1576	16	4	7	0	1603
28343	1565	5	9	4	0	1583
28344	27	1729	3	8	0	1767
28345	10	19	3	1664	0	1696
28346	6	8	1707	23	0	1744
28347	8	4	1737	6	0	1755
28348	2	1768	30	3	0	1803
28349	1743	30	5	7	0	1785
28350	29	10	1748	4	0	1791
28351	10	4	31	1717	0	1762
28352	1761	9	5	27	0	1802
28353	1781	4	8	10	0	1803
28354	32	2190	12	2	0	2236
28355	12	2294	6	4	0	2316
28356	2268	63	2	4	0	2337
28357	59	19	2261	8	0	2347
28358	2252	16	57	6	0	2331
28359	2332	13	11	7	0	2363
28360	67	10	12	2271	0	2360
28361	23	8	2277	55	0	2363
28362	14	12	2275	10	0	2311
28363	2162	9	64	12	0	2247
28364	66	4	2247	11	0	2328
28365	2136	0	70	10	0	2216
28366	2219	9	14	4	0	2246
28367	69	2238	9	4	0	2320
28368	18	61	2238	8	0	2325
28369	10	2197	63	3	0	2273
28370	2142	62	23	4	0	2231
28371	68	17	2155	2	0	2242
28372	21	18	64	2058	0	2161
28373	19	10	2103	58	0	2190
28374	12	6	2124	13	0	2155
28375	14	5	2135	7	0	2161
28376	7	6	2131	9	0	2153
28377	15	2025	78	4	0	2122
28378	17	57	2026	1	0	2101
28379	14	1996	65	10	0	2085
28380	6	61	1952	8	0	2027
28381	1910	17	70	3	0	2000
28382	73	16	16	1784	0	1889
28383	14	1951	20	54	0	2039
28384	1954	58	14	9	0	2035
28385	1949	17	15	11	0	1992
28386	1860	12	13	7	0	1892
28387	1909	8	22	3	0	1942
28388	68	1873	20	16	0	1977
28389	1790	63	14	6	0	1873
28390	1918	16	18	6	0	1958
28391	68	1836	12	15	0	1931
28392	20	66	1789	2	0	1877
28393	28	17	70	1731	0	1846
28394	16	1827	27	55	0	1925
28395	13	70	1831	11	0	1925
28396	16	16	1846	9	0	1887
28397	20	1782	74	8	0	1884
28398	21	1838	25	4	0	1888
28399	15	1909	26	4	0	1954
28400	24	1898	12	9	0	1943
28401	1873	82	17	6	0	1978
28402	1937	30	18	2	0	1987
28403	90	17	1908	4	0	2019
28404	31	22	1952	0	0	2005
28405	31	15	77	1850	0	1973
28406	18	17	31	1908	0	1974
28407	25	17	20	1934	0	1996
28408	1860	16	26	76	0	1978
28409	72	1860	15	24	0	1971
28410	27	1929	21	12	0	1989
28411	23	2032	24	4	0	2083
28412	1924	107	15	11	0	2057
28413	1992	33	18	9	0	2052
28414	100	30	21	1912	0	2063
28415	1977	14	25	77	0	2093
28416	2030	19	21	13	0	2083
28417	99	21	23	1972	0	2115
28418	1963	24	20	84	0	2091
28419	96	1958	20	22	0	2096
28420	47	88	24	1946	0	2105
28421	43	20	1931	82	0	2076
28422	35	1930	98	18	0	2081
28423	40	96	1940	13	0	2089
28424	37	29	98	1797	0	1961
28425	29	1964	29	76	0	2098
28426	51	95	31	1915	0	2092
28427	38	27	22	2005	0	2092
28428	34	31	1941	98	0	2104
28429	32	24	2084	25	0	2165
28430	42	12	110	2009	0	2173
28431	25	23	47	1972	0	2067
28432	23	2052	45	83	0	2203
28433	1928	104	30	33	0	2095
28434	105	1978	20	25	0	2128
28435	33	2046	37	12	0	2128
28436	29	106	1924	20	0	2079
28437	14	1948	108	17	0	2087
28438	22	110	42	1774	0	1948
28439	24	1896	36	93	0	2049
28440	23	104	29	1862	0	2018
28441	25	1897	32	92	0	2046
28442	1889	104	24	30	0	2047
28443	103	1884	23	32	0	2042
28444	29	97	23	1605	0	1754
28445	24	1695	18	75	0	1812
28446	1665	95	20	24	0	1804
28447	1646	38	14	22	0	1720
28448	92	1620	13	10	0	1735
28449	1586	87	10	11	0	1694
28450	96	54	6	1513	0	1669
28451	32	30	1523	70	0	1655
28452	31	20	1582	19	0	1652
28453	25	1538	84	19	0	1666
28454	1055	43	27	13	0	1138
28455	1078	13	4	4	0	1099
28456	42	9	1054	8	0	1113
28457	13	6	1056	8	0	1083
28458	986	8	36	8	0	1038
28459	1048	10	9	3	0	1070
28460	36	5	1019	11	0	1071
28461	970	11	34	4	0	1019
28462	40	993	5	8	0	1046
28463	8	1057	4	7	0	1076
28464	11	41	6	1028	0	1086
28465	8	16	2	1063	0	1089
28466	1048	6	5	41	0	1100
28467	1041	5	10	9	0	1065
28468	1045	10	7	12	0	1074
28469	42	10	4	1023	0	1079
28470	15	6	3	1044	0	1068
28471	10	979	4	40	0	1033
28472	6	1012	18	7	0	1043
28473	7	1042	7	14	0	1070
28474	15	50	8	973	0	1046
28475	8	1008	8	38	0	1062
28476	6	34	998	10	0	1048
28477	951	8	33	9	0	1001
28478	38	14	994	6	0	1052
28479	14	11	998	3	0	1026
28480	951	9	39	7	0	1006
28481	32	995	8	10	0	1045
28482	995	38	6	4	0	1043
28483	1004	17	3	5	0	1029
28484	44	9	973	7	0	1033
28485	15	9	1001	6	0	1031
28486	12	1015	32	7	0	1066
28487	11	36	1018	5	0	1070
28488	12	16	35	1022	0	1085
28489	13	16	7	885	0	921
28490	10	1018	9	31	0	1068
28491	9	1075	4	8	0	1096
28492	1041	36	5	7	0	1089
28493	1089	11	3	8	0	1111
28494	38	13	7	1075	0	1133
28495	15	6	8	1112	0	1141
28496	1060	10	11	37	0	1118
28497	1085	8	10	9	0	1112
28498	39	1086	9	7	0	1141
28499	1004	34	7	5	0	1050
28500	35	943	9	4	0	991
28501	13	1005	5	7	0	1030
28502	1004	32	10	4	0	1050
28503	1016	9	8	2	0	1035
28504	39	7	3	976	0	1025
28505	993	7	4	30	0	1034
28506	39	6	982	7	0	1034
28507	11	984	28	6	0	1029
28508	980	29	5	8	0	1022
28509	27	10	1004	6	0	1047
28510	11	7	16	920	0	954
28511	8	930	5	20	0	963
28512	10	970	4	5	0	989
28513	961	19	3	7	0	990
28514	24	13	953	6	0	996
28515	907	5	15	8	0	935
28516	20	4	5	934	0	963
28517	7	6	921	13	0	947
28518	887	7	19	4	0	917
28519	18	970	5	5	0	998
28520	4	992	7	3	0	1006
28521	1012	16	6	1	0	1035
28522	1026	3	2	2	0	1033
28523	1047	6	0	2	0	1055
28524	18	3	5	1028	0	1054
28525	12	0	4	1021	0	1037
28526	10	2	1021	11	0	1044
28527	4	5	988	4	0	1001
28528	5	1009	16	7	0	1037
28529	8	13	5	926	0	952
28530	923	1	7	11	0	942
28531	8	925	1	5	0	939
28532	2	10	1	943	0	956
28533	941	3	3	9	0	956
28534	14	929	2	2	0	947
28535	6	981	3	4	0	994
28536	4	10	941	6	0	961
28537	930	6	9	6	0	951
28538	982	4	4	7	0	997
28539	12	11	971	2	0	996
28540	867	4	8	4	0	883
28541	12	3	932	3	0	950
28542	5	922	7	2	0	936
28543	5	7	11	923	0	946
28544	918	2	3	9	0	932
28545	11	913	0	3	0	927
28546	1	918	3	4	0	926
28547	893	9	4	1	0	907
28548	13	3	978	0	0	994
28549	944	4	6	3	0	957
28550	11	1000	2	5	0	1018
28551	7	17	960	0	0	984
28552	938	3	6	0	0	947
28553	984	3	2	1	0	990
28554	10	1	2	991	0	1004
28555	4	1	1	1000	0	1006
28556	4	984	1	7	0	996
28557	4	7	1018	3	0	1032
28558	2	3	8	1017	0	1030
28559	2	1	1073	9	0	1085
28560	3	0	1068	1	0	1072
28561	3	1	11	1110	0	1125
28562	2	1	1145	12	0	1160
28563	2	1	1099	1	0	1103
28564	1	1	14	1106	0	1122
28565	2	1	1149	12	0	1164
28566	1035	1	18	5	0	1059
28567	13	1135	3	3	0	1154
28568	4	13	1194	1	0	1212
28569	3	2	1238	1	0	1244
28570	6	2	14	1189	0	1211
28571	1275	2	6	16	0	1299
28572	1286	0	5	1	0	1292
28573	1270	0	0	5	0	1275
28574	1281	2	2	0	0	1285
28575	19	3	2	1245	0	1269
28576	6	1	1271	14	0	1292
28577	1239	1	14	3	0	1257
28578	1301	1	3	4	0	1309
28579	1294	1	4	3	0	1302
28580	22	2	1276	1	0	1301
28581	1232	0	16	1	0	1249
28582	14	1	4	1328	0	1347
28583	5	1340	4	14	0	1363
28584	9	15	2	1313	0	1339
28585	4	1364	0	13	0	1381
28586	1370	14	2	2	0	1388
28587	16	1	1413	4	0	1434
28588	2	3	16	1360	0	1381
28589	3	1381	6	17	0	1407
28590	2	1425	4	5	0	1436
28591	1418	17	3	5	0	1443
28592	1422	3	2	2	0	1429
28593	16	3	1360	1	0	1380
28594	1361	2	16	4	0	1383
28595	14	2	7	1380	0	1403
28596	5	1	1431	17	0	1454
28597	6	2	1413	1	0	1422
28598	5	0	15	1457	0	1477
28599	1573	0	8	18	0	1599
28600	23	0	3	1568	0	1594
28601	8	0	3	1562	0	1573
28602	5	2	4	1544	0	1555
28603	4	1536	2	24	0	1566
28604	6	18	2	1578	0	1604
28605	1537	6	2	26	0	1571
28606	18	1553	4	11	0	1586
28607	11	25	2	1568	0	1606
28608	1557	8	2	25	0	1592
28609	21	1524	2	9	0	1556
28610	10	1551	2	7	0	1570
28611	6	30	2	1538	0	1576
28612	1516	10	2	24	0	1552
28613	26	7	1510	7	0	1550
28614	9	2	1467	9	0	1487
28615	1484	3	27	3	0	1517
28616	1558	2	12	2	0	1574
28617	30	1601	6	3	0	1640
28618	14	22	3	1577	0	1616
28619	8	11	1561	24	0	1604
28620	6	3	1512	10	0	1531
28621	7	4	1652	5	0	1668
28622	2	1629	47	4	0	1682
28623	3	1670	16	4	0	1693
28624	1658	41	11	4	0	1714
28625	35	12	1678	2	0	1727
28626	1623	9	34	5	0	1671
28627	1696	7	15	6	0	1724
28628	51	5	1701	3	0	1760
28629	12	1756	45	3	0	1816
28630	9	38	16	1704	0	1767
28631	11	12	1775	39	0	1837
28632	10	8	1706	9	0	1733
28633	1639	12	43	9	0	1703
28634	43	1730	13	12	0	1798
28635	15	44	14	1668	0	1741
28636	10	13	10	1668	0	1701
28637	8	1686	8	44	0	1746
28638	5	1723	9	8	0	1745
28639	4	1760	8	12	0	1784
28640	7	54	8	1802	0	1871
28641	1865	17	8	48	0	1938
28642	58	13	4	1867	0	1942
28643	16	13	1845	54	0	1928
28644	10	7	1839	18	0	1874
28645	11	7	58	1846	0	1922
28646	6	6	1891	55	0	1958
28647	8	1867	61	15	0	1951
28648	4	53	20	1907	0	1984
28649	1961	11	13	59	0	2044
28650	1957	9	14	15	0	1995
28651	60	1970	10	15	0	2055
28652	1965	58	7	18	0	2048
28653	2012	20	5	9	0	2046
28654	2000	13	9	10	0	2032
28655	74	16	1788	9	0	1887
28656	1872	9	47	10	0	1938
28657	70	1856	20	25	0	1971
28658	29	62	1868	7	0	1966
28659	18	21	1873	11	0	1923
28660	20	1856	64	7	0	1947
28661	1819	58	32	8	0	1917
28662	61	16	15	1768	0	1860
28663	20	1790	9	46	0	1865
28664	1797	60	10	20	0	1887
28665	67	20	6	1790	0	1883
28666	1822	12	7	70	0	1911
28667	73	10	9	1839	0	1931
28668	32	11	1775	68	0	1886
28669	15	11	1755	25	0	1806
28670	18	14	1769	16	0	1817
28671	10	12	79	1694	0	1795
28672	13	10	27	1774	0	1824
28673	13	14	1730	72	0	1829
28674	9	1722	67	26	0	1824
28675	1743	64	19	21	0	1847
28676	1767	17	18	20	0	1822
28677	82	1769	16	9	0	1876
28678	25	74	13	1773	0	1885
28679	22	21	1803	61	0	1907
28680	1774	12	69	23	0	1878
28681	73	13	1823	17	0	1926
28682	26	12	1718	11	0	1767
28683	25	14	1761	13	0	1813
28684	1666	8	84	10	0	1768
28685	70	12	1702	3	0	1787
28686	33	1612	76	12	0	1733
28687	22	1654	34	9	0	1719
28688	30	70	23	1564	0	1687
28689	13	26	27	1615	0	1681
28690	20	22	1581	74	0	1697
28691	1526	22	70	24	0	1642
28692	1632	15	28	17	0	1692
28693	84	15	22	1601	0	1722
28694	1582	10	26	65	0	1683
28695	75	1561	23	31	0	1690
28696	1541	62	23	17	0	1643
28697	70	1512	18	23	0	1623
28698	30	1527	18	19	0	1594
28699	1410	70	21	15	0	1516
28700	1445	14	13	13	0	1485
28701	1489	21	16	11	0	1537
28702	1521	17	13	11	0	1562
28703	87	13	1397	15	0	1512
28704	1398	19	64	11	0	1492
28705	76	14	24	1351	0	1465
28706	26	1395	16	55	0	1492
28707	1389	64	18	20	0	1491
28708	76	1397	13	13	0	1499
28709	1408	55	14	15	0	1492
28710	72	24	11	1368	0	1475
28711	41	6	14	1420	0	1481
28712	14	15	1314	65	0	1408
28713	20	14	1377	16	0	1427
28714	13	1375	64	19	0	1471
28715	1309	59	20	18	0	1406
28716	63	1313	16	15	0	1407
28717	28	1253	17	10	0	1308
28718	22	1317	13	10	0	1362
28719	30	57	1248	11	0	1346
28720	22	1261	52	10	0	1345
28721	1105	51	24	8	0	1188
28722	1133	22	7	7	0	1169
28723	55	10	10	1055	0	1130
28724	23	1057	3	43	0	1126
28725	13	1094	8	17	0	1132
28726	16	51	13	1056	0	1136
28727	19	18	1081	33	0	1151
28728	20	1027	31	15	0	1093
28729	20	45	13	963	0	1041
28730	945	20	10	32	0	1007
28731	972	13	10	11	0	1006
28732	45	977	9	13	0	1044
28733	996	38	3	14	0	1051
28734	1022	18	9	8	0	1057
28735	46	9	9	957	0	1021
28736	24	12	949	24	0	1009
28737	20	956	29	17	0	1022
28738	15	44	15	925	0	999
28739	14	21	924	31	0	990
28740	8	868	26	16	0	918
28741	789	31	19	9	0	848
28742	815	17	9	10	0	851
28743	38	11	8	787	0	844
28744	20	811	8	22	0	861
28745	16	21	816	12	0	865
28746	9	16	24	813	0	862
28747	7	13	843	25	0	888
28748	9	786	25	13	0	833
28749	20	24	10	655	0	709
28750	654	11	4	16	0	685
28751	14	638	7	16	0	675
28752	642	17	4	5	0	668
28753	641	10	4	3	0	658
28754	25	643	4	6	0	678
28755	14	17	3	648	0	682
28756	11	10	2	650	0	673
28757	9	621	1	20	0	651
28758	7	662	3	14	0	686
28759	5	25	2	606	0	638
28760	7	629	2	12	0	650
28761	624	15	3	10	0	652
28762	628	9	4	4	0	645
28763	25	5	602	6	0	638
28764	13	4	572	3	0	592
28765	571	4	14	2	0	591
28766	556	5	8	3	0	572
28767	13	581	4	2	0	600
28768	574	5	5	4	0	588
28769	567	11	3	0	0	581
28770	18	564	3	1	0	586
28771	599	9	1	4	0	613
28772	11	8	1	687	0	707
28773	12	6	3	714	0	735
28774	6	5	739	22	0	772
28775	8	712	18	8	0	746
28776	4	768	4	4	0	780
28777	722	33	6	11	0	772
28778	755	4	2	11	0	772
28779	744	2	1	3	0	750
28780	774	2	1	0	0	777
28781	23	2	724	1	0	750
28782	5	1	764	1	0	771
28783	4	781	23	0	0	808
28784	5	22	4	772	0	803
28785	4	5	2	766	0	777
28786	4	799	3	20	0	826
28787	5	21	3	787	0	816
28788	784	6	1	20	0	811
28789	20	776	1	4	0	801
28790	6	17	797	2	0	822
28791	2	809	20	3	0	834
28792	804	20	2	4	0	830
28793	21	5	802	4	0	832
28794	782	8	22	1	0	813
28795	813	5	4	2	0	824
28796	25	3	798	2	0	828
28797	8	1	797	3	0	809
28798	5	3	785	1	0	794
28799	724	2	27	3	0	756
28800	24	2	778	2	0	806
28801	6	766	22	0	0	794
28802	769	18	9	0	0	796
28803	21	5	766	0	0	792
28804	714	2	21	1	0	738
28805	23	1	761	1	0	786
28806	6	3	801	0	0	810
28807	7	790	21	1	0	819
28808	7	16	791	1	0	815
28809	3	3	783	1	0	790
28810	2	712	29	1	0	744
28811	770	20	7	2	0	799
28812	22	4	803	4	0	833
28813	6	4	22	740	0	772
28814	5	783	8	19	0	815
28815	790	21	5	5	0	821
28816	813	8	4	5	0	830
28817	22	2	786	4	0	814
28818	5	761	24	2	0	792
28819	7	820	3	3	0	833
28820	4	24	6	775	0	809
28821	8	740	6	18	0	772
28822	7	24	3	715	0	749
28823	7	8	5	798	0	818
28824	11	798	2	21	0	832
28825	5	22	7	782	0	816
28826	4	792	7	21	0	824
28827	4	32	764	6	0	806
28828	8	9	21	756	0	794
28829	5	7	6	762	0	780
28830	2	767	5	25	0	799
28831	6	797	5	12	0	820
28832	9	26	6	737	0	778
28833	3	759	7	24	0	793
28834	754	25	5	11	0	795
28835	24	13	2	747	0	786
28836	8	755	7	20	0	790
28837	735	21	7	9	0	772
28838	28	738	5	5	0	776
28839	10	26	731	4	0	771
28840	7	8	25	716	0	756
28841	730	9	8	23	0	770
28842	22	7	738	8	0	775
28843	14	10	21	689	0	734
28844	5	711	10	22	0	748
28845	5	26	705	6	0	742
28846	8	711	22	2	0	743
28847	654	23	11	2	0	690
28848	673	6	9	3	0	691
28849	26	665	11	5	0	707
28850	668	24	12	1	0	705
28851	26	15	656	1	0	698
28852	11	4	29	633	0	677
28853	7	5	13	641	0	666
28854	8	656	10	17	0	691
28855	711	21	8	10	0	750
28856	757	5	8	8	0	778
28857	23	6	756	4	0	789
28858	729	11	24	6	0	770
28859	780	7	6	3	0	796
28860	769	6	8	4	0	787
28861	28	2	9	755	0	794
28862	10	7	5	771	0	793
28863	7	770	8	17	0	802
28864	763	19	4	7	0	793
28865	757	8	7	8	0	780
28866	21	767	4	8	0	800
28867	10	22	3	735	0	770
28868	12	734	3	22	0	771
28869	7	781	4	5	0	797
28870	743	22	16	6	0	787
28871	21	7	739	5	0	772
28872	7	2	630	4	0	643
28873	3	621	11	4	0	639
28874	581	8	6	1	0	596
28875	7	1	586	1	0	595
28876	2	533	7	1	0	543
28877	498	1	1	1	0	501
28878	1	1	484	0	0	486
28879	1	0	1	463	0	465
28880	491	0	1	2	0	494
28881	1	1	517	0	0	519
28882	2	0	531	0	0	533
28883	0	0	589	0	0	589
28884	0	1	573	2	0	576
28885	547	0	6	1	0	554
28886	596	0	1	0	0	597
28887	5	583	1	9	0	598
28888	0	4	1	605	0	610
28889	0	0	1	639	0	640
28890	1	623	0	12	0	636
28891	1	8	0	649	0	658
28892	0	682	0	7	0	689
28893	0	710	0	2	0	712
28894	0	10	0	700	0	710
28895	0	4	696	9	0	709
28896	0	702	9	2	0	713
28897	0	7	1	709	0	717
28898	706	2	2	10	0	720
28899	11	2	706	2	0	721
28900	681	1	11	3	0	696
28901	717	0	0	2	0	719
28902	11	0	3	743	0	757
28903	2	1	768	11	0	782
28904	2	1	761	1	0	765
28905	2	805	15	3	0	825
28906	1	13	4	773	0	791
28907	2	3	787	13	0	805
28908	1	5	789	3	0	798
28909	0	801	19	3	0	823
28910	791	17	8	6	0	822
28911	812	5	10	1	0	828
28912	17	6	6	832	0	861
28913	9	4	861	20	0	894
28914	10	3	877	6	0	896
28915	3	903	27	7	0	940
28916	5	21	898	5	0	929
28917	4	9	917	4	0	934
28918	2	14	36	840	0	892
28919	2	3	915	20	0	940
28920	864	4	33	10	0	911
28921	25	4	13	916	0	958
28922	11	2	939	26	0	978
28923	6	945	29	10	0	990
28924	3	22	12	974	0	1011
28925	2	9	1000	27	0	1038
28926	4	1016	31	7	0	1058
28927	4	32	13	983	0	1032
28928	4	1037	13	29	0	1083
28929	2	32	11	1034	0	1079
28930	3	13	17	1037	0	1070
28931	2	8	1030	41	0	1081
28932	3	1037	34	17	0	1091
28933	2	34	13	1032	0	1081
28934	0	9	13	1056	0	1078
28935	2	8	10	1073	0	1093
28936	2	9	1036	49	0	1096
28937	2	1014	31	20	0	1067
28938	2	29	10	1040	0	1081
28939	0	10	1043	36	0	1089
28940	2	1040	31	13	0	1086
28941	2	33	11	1053	0	1099
28942	2	11	1088	35	0	1136
28943	1	1086	35	16	0	1138
28944	0	34	13	1074	0	1121
28945	2	14	11	1102	0	1129
28946	0	11	1109	47	0	1167
28947	1022	6	38	21	0	1087
28948	30	1114	15	15	0	1174
28949	1120	34	12	15	0	1181
28950	40	10	1155	8	0	1213
28951	1139	11	34	11	0	1195
28952	37	8	13	1157	0	1215
28953	12	3	19	1179	0	1213
28954	9	10	1157	37	0	1213
28955	1023	8	28	27	0	1086
28956	1054	5	18	17	0	1094
28957	36	1034	15	9	0	1094
28958	16	1091	8	8	0	1123
28959	1081	40	8	5	0	1134
28960	39	21	1076	7	0	1143
28961	14	1125	34	11	0	1184
28962	15	31	18	1139	0	1203
28963	8	14	14	1189	0	1225
28964	5	10	1168	44	0	1227
28965	1106	9	39	22	0	1176
28966	42	7	1204	14	0	1267
28967	1170	4	48	13	0	1235
28968	45	10	1244	7	0	1306
28969	20	1267	45	8	0	1340
28970	1287	42	23	6	0	1358
28971	1304	17	16	6	0	1343
28972	1294	16	11	7	0	1328
28973	1315	10	4	14	0	1343
28974	62	6	10	1265	0	1343
28975	28	7	1278	44	0	1357
28976	16	10	45	1226	0	1297
28977	10	1278	18	51	0	1357
28978	6	37	19	1289	0	1351
28979	8	15	1287	46	0	1356
28980	12	15	1315	22	0	1364
28981	11	10	56	1243	0	1320
28982	1237	5	35	45	0	1322
28983	1201	5	21	19	0	1246
28984	1218	8	9	21	0	1256
28985	63	3	1239	12	0	1317
28986	25	9	1257	5	0	1296
28987	23	1230	46	11	0	1310
28988	12	1270	24	10	0	1316
28989	1221	48	18	10	0	1297
28990	1205	20	20	6	0	1251
28991	46	1249	6	12	0	1313
28992	1200	41	10	6	0	1257
28993	1222	12	5	14	0	1253
28994	51	1215	11	7	0	1284
28995	1254	39	10	10	0	1313
28996	1263	13	8	12	0	1296
28997	50	1267	10	9	0	1336
28998	1279	38	3	7	0	1327
28999	1289	15	5	7	0	1316
29000	51	10	1273	4	0	1338
29001	26	11	1280	6	0	1323
29002	17	1218	43	9	0	1287
29003	5	1260	22	3	0	1290
29004	1240	43	14	4	0	1301
29005	1207	12	6	1	0	1226
29006	1211	9	4	2	0	1226
29007	39	1210	4	4	0	1257
29008	18	29	4	1233	0	1284
29009	11	14	1253	30	0	1308
29010	9	10	28	1221	0	1268
29011	8	1251	9	28	0	1296
29012	1221	24	7	9	0	1261
29013	29	1203	4	9	0	1245
29014	8	28	6	1194	0	1236
29015	1237	7	4	23	0	1271
29016	1240	7	7	7	0	1261
29017	36	4	1212	4	0	1256
29018	1223	3	28	4	0	1258
29019	1314	2	11	1	0	1328
29020	1335	1	9	1	0	1346
29021	43	2	3	1266	0	1314
29022	15	1261	2	25	0	1303
29023	7	29	1	1279	0	1316
29024	7	11	1309	27	0	1354
29025	8	1308	26	17	0	1359
29026	14	24	7	1284	0	1329
29027	6	11	1297	20	0	1334
29028	6	1275	21	10	0	1312
29029	6	22	13	1247	0	1288
29030	8	11	1283	23	0	1325
29031	1144	8	20	16	0	1188
29032	28	3	1316	5	0	1352
29033	13	6	1290	2	0	1311
29034	12	1312	29	6	0	1359
29035	7	24	14	1298	0	1343
29036	9	9	4	1297	0	1319
29037	5	1297	7	25	0	1334
29038	6	26	1	1344	0	1377
29039	1355	8	8	26	0	1397
29040	1359	7	8	9	0	1383
29041	32	10	1292	10	0	1344
29042	1305	7	20	4	0	1336
29043	1365	2	12	7	0	1386
29044	34	7	1364	1	0	1406
29045	17	1372	24	11	0	1424
29046	11	1378	13	5	0	1407
29047	7	36	9	1271	0	1323
29048	6	1369	5	19	0	1399
29049	5	28	1279	11	0	1323
29050	9	13	1284	6	0	1312
29051	10	1348	30	6	0	1394
29052	1372	27	13	2	0	1414
29053	1413	11	9	4	0	1437
29054	1429	8	5	5	0	1447
29055	1430	7	4	4	0	1445
29056	1356	13	4	3	0	1376
29057	36	1392	2	7	0	1437
29058	19	28	1363	3	0	1413
29059	15	12	24	1345	0	1396
29060	1347	7	11	25	0	1390
29061	24	1306	10	12	0	1352
29062	14	27	4	1287	0	1332
29063	10	8	1296	21	0	1335
29064	7	1254	24	6	0	1291
29065	10	1294	5	6	0	1315
29066	1233	33	5	8	0	1279
29067	20	1226	1	6	0	1253
29068	10	20	5	1170	0	1205
29069	1172	8	4	13	0	1197
29070	1169	8	4	7	0	1188
29071	1180	5	3	4	0	1192
29072	21	3	1148	5	0	1177
29073	8	1166	18	3	0	1195
29074	1187	17	4	4	0	1212
29075	18	8	2	1160	0	1188
29076	1188	4	0	16	0	1208
29077	17	1175	5	4	0	1201
29078	1225	16	1	4	0	1246
29079	1356	5	0	1	0	1362
29080	31	2	4	1331	0	1368
29081	14	4	1407	24	0	1449
29082	8	4	25	1417	0	1454
29083	1418	5	7	29	0	1459
29084	1441	3	6	7	0	1457
29085	30	1376	5	14	0	1425
29086	1319	22	4	5	0	1350
29087	26	1348	4	7	0	1385
29088	1357	28	1	4	0	1390
29089	1336	10	3	5	0	1354
29090	33	8	1345	7	0	1393
29091	21	1327	25	2	0	1375
29092	9	26	10	1328	0	1373
29093	10	14	8	1363	0	1395
29094	12	15	7	1313	0	1347
29095	5	1310	5	47	0	1367
29096	12	24	1282	18	0	1336
29097	12	16	1304	7	0	1339
29098	8	1603	27	7	0	1645
29099	1615	37	12	10	0	1674
29100	35	19	1624	5	0	1683
29101	1590	13	31	7	0	1641
29102	45	1602	19	7	0	1673
29103	19	37	1621	2	0	1679
29104	11	16	38	1619	0	1684
29105	8	9	1660	37	0	1714
29106	11	9	1688	19	0	1727
29107	12	13	43	1552	0	1620
29108	9	1580	26	31	0	1646
29109	10	1651	16	17	0	1694
29110	1631	44	11	9	0	1695
29111	40	22	1631	3	0	1696
29112	1653	16	31	9	0	1709
29113	1664	8	18	5	0	1695
29114	45	1683	15	2	0	1745
29115	1647	39	5	3	0	1694
29116	1639	18	7	4	0	1668
29117	1599	12	6	10	0	1627
29118	51	1580	6	7	0	1644
29119	16	1477	12	8	0	1513
29120	14	1534	8	6	0	1562
29121	1532	40	4	6	0	1582
29122	1547	22	2	12	0	1583
29123	41	10	1471	4	0	1526
29124	21	7	1422	5	0	1455
29125	1463	12	35	3	0	1513
29126	1502	6	16	2	0	1526
29127	1529	7	8	2	0	1546
29128	44	6	8	1482	0	1540
29129	25	4	6	1496	0	1531
29130	17	3	6	1528	0	1554
29131	12	7	4	1533	0	1556
29132	7	10	1438	38	0	1493
29133	15	9	1460	18	0	1502
29134	12	2	1457	10	0	1481
29135	10	3	1453	7	0	1473
29136	1419	5	38	8	0	1470
29137	32	1435	20	6	0	1493
29138	18	1499	11	5	0	1533
29139	1485	32	7	7	0	1531
29140	37	12	1481	7	0	1537
29141	16	11	1497	9	0	1533
29142	1476	10	38	9	0	1533
29143	1527	6	17	9	0	1559
29144	44	1508	11	4	0	1567
29145	24	27	6	1484	0	1541
29146	1504	17	8	20	0	1549
29147	1539	12	6	10	0	1567
29148	42	11	6	1507	0	1566
29149	27	1547	4	21	0	1599
29150	1555	27	6	10	0	1598
29151	34	16	1513	6	0	1569
29152	1454	10	29	7	0	1500
29153	35	1502	19	8	0	1564
29154	1515	27	9	10	0	1561
29155	1480	18	4	10	0	1512
29156	41	10	1537	12	0	1600
29157	19	6	1505	12	0	1542
29158	1512	8	42	10	0	1572
29159	1569	6	22	8	0	1605
29160	41	1592	17	4	0	1654
29161	21	32	12	1629	0	1694
29162	17	17	1625	24	0	1683
29163	1592	13	33	11	0	1649
29164	38	6	23	1617	0	1684
29165	18	15	11	1644	0	1688
29166	1632	8	12	33	0	1685
29167	32	1671	15	19	0	1737
29168	1693	29	15	10	0	1747
29169	1689	15	12	10	0	1726
29170	1699	9	14	7	0	1729
29171	52	1659	8	9	0	1728
29172	1699	35	5	10	0	1749
29173	47	18	7	1667	0	1739
29174	33	10	7	1676	0	1726
29175	25	10	1688	41	0	1764
29176	18	10	1653	20	0	1701
29177	24	1658	32	12	0	1726
29178	19	1698	11	8	0	1736
29179	13	29	1554	5	0	1601
29180	15	1601	22	3	0	1641
29181	1578	35	16	5	0	1634
29182	1588	12	3	6	0	1609
29183	1606	8	2	4	0	1620
29184	35	6	4	1518	0	1563
29185	19	4	4	1571	0	1598
29186	18	1	1612	27	0	1658
29187	7	1586	21	17	0	1631
29188	1577	23	15	6	0	1621
29189	23	1591	7	8	0	1629
29190	1619	23	4	3	0	1649
29191	1628	11	3	3	0	1645
29192	33	3	3	1595	0	1634
29193	14	3	4	1608	0	1629
29194	9	4	3	1649	0	1665
29195	8	3	1607	34	0	1652
29196	6	1575	23	15	0	1619
29197	9	1574	11	5	0	1599
29198	4	1286	1	6	0	1297
29199	5	1271	0	2	0	1278
29200	3	1275	2	4	0	1284
29201	1217	16	0	4	0	1237
29202	14	7	1226	0	0	1247
29203	3	1230	13	6	0	1252
29204	5	12	1191	2	0	1210
29205	3	1246	10	3	0	1262
29206	8	21	10	936	0	975
29207	2	9	2	1189	0	1202
29208	3	1210	5	15	0	1233
29209	1191	16	3	5	0	1215
29210	15	6	1207	5	0	1233
29211	5	1225	13	4	0	1247
29212	5	16	1196	2	0	1219
29213	3	5	13	1184	0	1205
29214	8	8	6	1125	0	1147
29215	4	1178	5	13	0	1200
29216	4	17	2	1199	0	1222
29217	8	4	1	1200	0	1213
29218	5	1203	4	15	0	1227
29219	4	17	1188	8	0	1217
29220	2	3	1168	8	0	1181
29221	1123	4	16	9	0	1152
29222	1206	1	8	5	0	1220
29223	20	4	3	1164	0	1191
29224	7	6	1184	13	0	1210
29225	8	8	11	1129	0	1156
29226	2	1185	7	14	0	1208
29227	2	17	1189	6	0	1214
29228	3	1176	14	3	0	1196
29229	3	16	1170	8	0	1197
29230	3	1174	12	5	0	1194
29231	1156	17	9	2	0	1184
29232	12	14	2	1153	0	1181
29233	4	3	5	1142	0	1154
29234	3	9	1169	17	0	1198
29235	3	8	1110	6	0	1127
29236	7	1155	18	3	0	1183
29237	1171	15	6	4	0	1196
29238	16	6	5	1160	0	1187
29239	3	5	1175	15	0	1198
29240	3	9	1104	5	0	1121
29241	1019	5	22	8	0	1054
29242	1063	7	5	8	0	1083
29243	14	5	1075	3	0	1097
29244	5	11	13	1028	0	1057
29245	8	1069	7	10	0	1094
29246	1079	18	3	6	0	1106
29247	14	1065	4	6	0	1089
29248	1030	13	6	9	0	1058
29249	15	1026	2	5	0	1048
29250	8	1035	4	4	0	1051
29251	4	20	2	1040	0	1066
29252	4	5	2	1048	0	1059
29253	2	1048	4	17	0	1071
29254	3	11	1033	12	0	1059
29255	4	7	1015	3	0	1029
29256	4	3	1008	3	0	1018
29257	958	4	11	2	0	975
29258	1011	0	7	6	0	1024
29259	11	1064	5	2	0	1082
29260	6	12	1031	4	0	1053
29261	3	11	11	1012	0	1037
29262	6	7	1071	12	0	1096
29263	3	8	1102	5	0	1118
29264	2	5	21	1197	0	1225
29265	3	8	9	1282	0	1302
29266	4	5	1442	26	0	1477
29267	1440	4	23	22	0	1489
29268	25	1564	23	16	0	1628
29269	20	1686	10	7	0	1723
29270	13	44	12	1649	0	1718
29271	1697	30	4	26	0	1757
29272	27	1740	7	20	0	1794
29273	1756	37	2	13	0	1808
29274	36	1782	4	10	0	1832
29275	1868	44	2	6	0	1920
29276	49	32	1852	2	0	1935
29277	33	16	1888	11	0	1948
29278	16	9	60	1810	0	1895
29279	9	6	1864	41	0	1920
29280	10	1751	51	19	0	1831
29281	6	1757	30	8	0	1801
29282	1773	58	12	8	0	1851
29283	42	26	11	1714	0	1793
29284	20	1795	11	35	0	1861
29285	1835	43	8	21	0	1907
29286	1817	25	7	10	0	1859
29287	1861	16	4	20	0	1901
29288	71	13	4	1821	0	1909
29289	40	6	6	1848	0	1900
29290	21	11	1821	60	0	1913
29291	15	8	1821	30	0	1874
29292	1772	6	62	20	0	1860
29293	52	6	33	1773	0	1864
29294	28	9	1777	46	0	1860
29295	1751	6	50	26	0	1833
29296	48	1833	23	16	0	1920
29297	1849	43	17	10	0	1919
29298	1870	25	15	9	0	1919
29299	1895	13	11	5	0	1924
29300	80	11	1797	21	0	1909
29301	1812	4	45	10	0	1871
29302	65	6	22	1733	0	1826
29303	40	1719	15	45	0	1819
29304	25	1830	12	20	0	1887
29305	1791	59	9	19	0	1878
29306	1806	31	10	11	0	1858
29307	1846	11	11	12	0	1880
29308	79	7	9	1763	0	1858
29309	46	10	7	1804	0	1867
29310	27	12	6	1738	0	1783
29311	24	1747	3	66	0	1840
29312	1747	48	7	30	0	1832
29313	1781	23	10	19	0	1833
29314	1810	12	8	13	0	1843
29315	84	12	1761	14	0	1871
29316	1799	7	45	13	0	1864
29317	71	12	21	1710	0	1814
29318	37	1765	11	46	0	1859
29319	1773	47	7	22	0	1849
29320	1773	26	7	17	0	1823
29321	84	16	1752	13	0	1865
29322	50	10	46	1692	0	1798
29323	36	1757	22	51	0	1866
29324	1813	48	11	34	0	1906
29325	58	32	10	1799	0	1899
29326	45	18	7	1832	0	1902
29327	29	19	9	1854	0	1911
29328	31	10	8	1894	0	1943
29329	25	7	1841	84	0	1957
29330	21	1842	50	46	0	1959
29331	11	56	28	1854	0	1949
29332	23	27	1861	65	0	1976
29333	1838	23	56	32	0	1949
29334	1912	17	27	19	0	1975
29335	82	10	21	1879	0	1992
29336	1906	5	17	66	0	1994
29337	1970	14	16	33	0	2033
29338	93	10	1892	24	0	2019
29339	46	1896	52	24	0	2018
29340	1921	57	25	25	0	2028
29341	77	26	18	1914	0	2035
29342	1949	15	20	66	0	2050
29343	80	14	15	1928	0	2037
29344	45	14	10	1978	0	2047
29345	29	16	1903	86	0	2034
29346	1801	13	54	46	0	1914
29347	73	1915	29	32	0	2049
29348	38	54	1920	27	0	2039
29349	29	1931	58	22	0	2040
29350	1904	62	27	20	0	2013
29351	68	30	21	1881	0	2000
29352	1913	22	15	59	0	2009
29353	73	1892	10	42	0	2017
29354	1935	61	9	21	0	2026
29355	1962	29	8	19	0	2018
29356	1982	13	9	20	0	2024
29357	1976	13	7	26	0	2022
29358	101	1905	6	25	0	2037
29359	1894	53	16	21	0	1984
29360	86	26	12	1859	0	1983
29361	43	32	10	1850	0	1935
29362	39	1729	11	62	0	1841
29363	34	1725	4	37	0	1800
29364	33	1673	9	20	0	1735
29365	1564	52	5	17	0	1638
29366	55	1406	3	10	0	1474
29367	23	1252	11	5	0	1291
29368	1217	39	20	7	0	1283
29369	1182	8	6	6	0	1202
29370	43	1155	6	8	0	1212
29371	1164	34	1	4	0	1203
29372	40	7	1097	9	0	1153
29373	1077	8	28	5	0	1118
29374	40	14	1079	10	0	1143
29375	14	917	23	1	0	955
29376	6	959	5	5	0	975
29377	16	34	4	909	0	963
29378	925	4	13	18	0	960
29379	954	5	1	3	0	963
29380	954	5	0	6	0	965
29381	955	3	1	10	0	969
29382	923	2	0	6	0	931
29383	18	5	894	3	0	920
29384	8	3	849	3	0	863
29385	880	7	12	3	0	902
29386	17	910	3	4	0	934
29387	895	12	5	2	0	914
29388	939	3	1	2	0	945
29389	964	1	0	4	0	969
29390	959	2	0	6	0	967
29391	960	2	1	1	0	964
29392	18	1	945	0	0	964
29393	955	2	14	1	0	972
29394	967	5	1	1	0	974
29395	15	4	935	2	0	956
29396	889	7	7	4	0	907
29397	940	4	1	2	0	947
29398	16	0	968	6	0	990
29399	5	5	982	3	0	995
29400	6	1010	14	2	0	1032
29401	10	12	0	1005	0	1027
29402	6	3	1016	11	0	1036
29403	1017	3	17	4	0	1041
29404	15	4	4	1084	0	1107
29405	4	2	1123	14	0	1143
29406	1116	2	12	3	0	1133
29407	1130	4	1	2	0	1137
29408	1124	4	2	1	0	1131
29409	22	1128	1	16	0	1167
29410	11	11	0	1126	0	1148
29411	8	1150	2	11	0	1171
29412	1169	13	4	0	0	1186
29413	1157	4	2	3	0	1166
29414	18	0	1151	3	0	1172
29415	2	1108	14	2	0	1126
29416	2	1102	1	1	0	1106
29417	1	13	2	1082	0	1098
29418	4	2	1	1096	0	1103
29419	1090	1	0	12	0	1103
29420	15	1075	1	11	0	1102
29421	5	1077	0	6	0	1088
29422	4	13	1081	0	0	1098
29423	4	1115	8	1	0	1128
29424	1089	13	0	1	0	1103
29425	13	0	1076	2	0	1091
29426	964	3	11	0	0	978
29427	12	1	1027	0	0	1040
29428	925	1	6	0	0	932
29429	9	1042	1	1	0	1053
29430	1072	12	2	1	0	1087
29431	12	3	1119	1	0	1135
29432	1109	4	12	3	0	1128
29433	1128	0	1	2	0	1131
29434	15	2	1152	0	0	1169
29435	1130	3	12	1	0	1146
29436	1162	2	2	0	0	1166
29437	1119	3	2	1	0	1125
29438	15	1102	1	0	0	1118
29439	1105	13	1	2	0	1121
29440	15	3	1104	1	0	1123
29441	3	1154	12	4	0	1173
29442	1159	15	6	1	0	1181
29443	1143	4	2	3	0	1152
29444	1167	3	2	3	0	1175
29445	20	1154	2	0	0	1176
29446	5	13	4	1346	0	1368
29447	5	4	1343	20	0	1372
29448	2	3	24	1349	0	1378
29449	4	1	1420	29	0	1454
29450	1378	2	33	3	0	1416
29451	29	1440	5	9	0	1483
29452	11	27	7	1399	0	1444
29453	9	1434	4	24	0	1471
29454	5	33	1	1435	0	1474
29455	3	7	4	1446	0	1460
29456	6	1483	2	31	0	1522
29457	6	31	2	1483	0	1522
29458	10	8	2	1551	0	1571
29459	5	1542	2	36	0	1585
29460	2	1589	2	23	0	1616
29461	6	35	8	1577	0	1626
29462	4	21	1575	38	0	1638
29463	6	1605	36	11	0	1658
29464	8	35	11	1609	0	1663
29465	10	16	1661	36	0	1723
29466	3	1677	37	15	0	1732
29467	1662	41	8	17	0	1728
29468	37	13	1653	6	0	1709
29469	1618	14	36	11	0	1679
29470	47	11	11	1628	0	1697
29471	14	7	12	1643	0	1676
29472	17	5	2	1658	0	1682
29473	5	7	1625	57	0	1694
29474	7	15	1606	23	0	1651
29475	1555	8	43	21	0	1627
29476	37	2	26	1609	0	1674
29477	8	12	1639	41	0	1700
29478	1625	6	39	19	0	1689
29479	37	6	16	1647	0	1706
29480	13	15	18	1657	0	1703
29481	21	12	6	1645	0	1684
29482	7	1656	7	63	0	1733
29483	11	36	9	1610	0	1666
29484	7	1601	6	53	0	1667
29485	7	1675	2	25	0	1709
29486	1638	41	9	26	0	1714
29487	1480	33	9	18	0	1540
29488	1604	18	11	16	0	1649
29489	52	1564	9	7	0	1632
29490	1560	44	4	16	0	1624
29491	1591	11	12	12	0	1626
29492	50	19	11	1541	0	1621
29493	30	5	6	1588	0	1629
29494	20	6	1558	60	0	1644
29495	7	1565	39	40	0	1651
29496	1530	42	15	16	0	1603
29497	1536	13	15	16	0	1580
29498	40	1572	13	13	0	1638
29499	1555	39	6	18	0	1618
29500	1559	18	5	17	0	1599
29501	53	15	5	1532	0	1605
29502	32	1515	5	41	0	1593
29503	22	1560	8	19	0	1609
29504	1507	43	7	22	0	1579
29505	49	19	6	1466	0	1540
29506	21	17	1437	48	0	1523
29507	1389	12	34	31	0	1466
29508	41	10	1491	26	0	1568
29509	14	1480	49	12	0	1555
29510	1480	38	18	19	0	1555
29511	43	18	1474	14	0	1549
29512	23	21	33	1497	0	1574
29513	18	15	1505	47	0	1585
29514	19	1517	42	16	0	1594
29515	20	43	13	1524	0	1600
29516	15	19	1522	43	0	1599
29517	1421	30	35	23	0	1509
29518	52	1543	12	18	0	1625
29519	17	42	13	1489	0	1561
29520	26	1548	11	41	0	1626
29521	1539	54	8	18	0	1619
29522	1541	18	12	27	0	1598
29523	50	1532	9	18	0	1609
29524	32	41	13	1484	0	1570
29525	23	1541	9	40	0	1613
29526	1533	44	15	17	0	1609
29527	45	23	1512	24	0	1604
29528	24	26	1475	13	0	1538
29529	27	1468	43	19	0	1557
29530	8	1487	30	13	0	1538
29531	20	37	16	1427	0	1500
29532	1404	35	10	35	0	1484
29533	1429	26	6	21	0	1482
29534	1393	10	9	25	0	1437
29535	56	1447	17	11	0	1531
29536	34	37	9	1401	0	1481
29537	26	1474	8	37	0	1545
29538	1473	46	8	18	0	1545
29539	45	18	6	1482	0	1551
29540	30	16	1463	31	0	1540
29541	23	1445	33	24	0	1525
29542	1427	29	20	20	0	1496
29543	32	19	1426	9	0	1486
29544	1391	28	25	13	0	1457
29545	42	1409	16	18	0	1485
29546	13	1251	6	7	0	1277
29547	1228	22	4	9	0	1263
29548	24	1250	3	13	0	1290
29549	1174	18	10	8	0	1210
29550	19	1189	3	6	0	1217
29551	1191	22	2	5	0	1220
29552	1188	9	4	2	0	1203
29553	22	10	1203	5	0	1240
29554	14	5	1174	3	0	1196
29555	10	1172	19	3	0	1204
29556	1148	12	7	3	0	1170
29557	12	10	1108	3	0	1133
29558	1046	2	12	2	0	1062
29559	8	5	13	1032	0	1058
29560	3	2	1056	4	0	1065
29561	2	1	1006	4	0	1013
29562	6	1	1042	0	0	1049
29563	3	1051	6	1	0	1061
29564	32	7	11	988	0	1038
29565	978	1	5	4	0	988
29566	4	0	1	972	0	977
29567	978	0	1	4	0	983
29568	5	0	1	981	0	987
29569	1029	0	0	7	0	1036
29570	1052	0	0	2	0	1054
29571	1187	1	1	3	0	1192
29572	7	1192	2	2	0	1203
29573	1	7	1189	1	0	1198
29574	3	4	7	1190	0	1204
29575	11	14	25	591	0	641
29576	3	1	2	1208	0	1214
29577	2	2	0	1155	0	1159
29578	2	1126	1	10	0	1139
29579	2	10	1106	11	0	1129
29580	4	1119	10	9	0	1142
29581	1	14	5	1081	0	1101
29582	2	7	2	1137	0	1148
29583	2	3	0	1143	0	1148
29584	3	1	2	1139	0	1145
29585	3	1089	0	19	0	1111
29586	1	1101	2	8	0	1112
29587	1	17	1093	5	0	1116
29588	3	8	12	1096	0	1119
29589	4	4	6	1118	0	1132
29590	2	2	4	1159	0	1167
29591	1170	5	1	18	0	1194
29592	13	1172	3	10	0	1198
29593	6	13	1175	5	0	1199
29594	1176	8	14	2	0	1200
29595	14	2	8	1180	0	1204
29596	1206	4	4	12	0	1226
29597	14	6	1	1218	0	1239
29598	1198	1	4	18	0	1221
29599	16	2	2	1186	0	1206
29600	1180	3	1	18	0	1202
29601	18	1	1193	7	0	1219
29602	9	2	14	1171	0	1196
29603	9	1221	5	14	0	1249
29604	3	15	3	1265	0	1286
29605	1270	7	2	16	0	1295
29606	15	1252	4	10	0	1281
29607	11	18	0	1318	0	1347
29608	6	1274	1	15	0	1296
29609	4	17	3	1290	0	1314
29610	6	6	3	1297	0	1312
29611	3	8	1268	25	0	1304
29612	3	2	21	1218	0	1244
29613	1	5	1221	20	0	1247
29614	6	1188	18	8	0	1220
29615	1198	19	7	12	0	1236
29616	20	6	1204	3	0	1233
29617	1173	6	15	5	0	1199
29618	1248	1	10	7	0	1266
29619	26	5	2	1262	0	1295
29620	14	1	1321	21	0	1357
29621	1281	1	26	13	0	1321
29622	1430	3	11	5	0	1449
29623	35	4	4	1416	0	1459
29624	13	0	6	1429	0	1448
29625	8	1417	3	33	0	1461
29626	10	24	1	1403	0	1438
29627	5	1414	5	31	0	1455
29628	4	30	1408	18	0	1460
29629	3	11	26	1392	0	1432
29630	1364	5	9	27	0	1405
29631	1399	3	6	14	0	1422
29632	32	1386	3	10	0	1431
29633	15	23	3	1386	0	1427
29634	1378	11	0	30	0	1419
29635	27	1322	1	16	0	1366
29636	1335	27	3	8	0	1373
29637	24	9	3	1393	0	1429
29638	1489	5	2	27	0	1523
29639	30	4	1674	8	0	1716
29640	13	1684	40	6	0	1743
29641	1691	39	11	6	0	1747
29642	45	1755	5	5	0	1810
29643	1796	41	2	7	0	1846
29644	1873	15	2	10	0	1900
29645	58	9	1844	3	0	1914
29646	18	5	43	1829	0	1895
29647	1874	9	11	44	0	1938
29648	52	1	1856	15	0	1924
29649	1845	8	48	10	0	1911
29650	56	6	13	1847	0	1922
29651	21	9	1826	47	0	1903
29652	15	7	48	1811	0	1881
29653	1793	5	12	52	0	1862
29654	57	5	1864	16	0	1942
29655	15	4	49	1864	0	1932
29656	17	1	16	1907	0	1941
29657	1925	2	7	67	0	2001
29658	1935	0	12	18	0	1965
29659	54	1895	16	16	0	1981
29660	20	47	6	1895	0	1968
29661	16	13	7	1920	0	1956
29662	12	8	11	1911	0	1942
29663	1865	4	6	69	0	1944
29664	1899	4	10	28	0	1941
29665	61	4	11	1856	0	1932
29666	25	1828	3	62	0	1918
29667	27	45	8	1821	0	1901
29668	21	1877	8	48	0	1954
29669	1826	46	3	30	0	1905
29670	54	1777	5	23	0	1859
29671	1673	41	5	17	0	1736
29672	62	13	5	1656	0	1736
29673	1656	13	8	49	0	1726
29674	55	4	1628	22	0	1709
29675	20	1661	42	21	0	1744
29676	1678	43	12	20	0	1753
29677	1704	20	5	13	0	1742
29678	60	8	11	1637	0	1716
29679	17	1641	10	51	0	1719
29680	21	43	5	1721	0	1790
29681	15	10	11	1749	0	1785
29682	19	10	6	1737	0	1772
29683	1730	5	5	57	0	1797
29684	1752	10	8	21	0	1791
29685	59	8	6	1723	0	1796
29686	19	1747	3	53	0	1822
29687	1764	39	5	24	0	1832
29688	56	12	1747	17	0	1832
29689	19	15	38	1764	0	1836
29690	22	10	1761	58	0	1851
29691	21	4	41	1744	0	1810
29692	14	8	1779	66	0	1867
29693	16	15	44	1756	0	1831
29694	1754	11	11	61	0	1837
29695	1766	10	7	26	0	1809
29696	59	1724	6	22	0	1811
29697	1783	44	7	15	0	1849
29698	63	13	7	1766	0	1849
29699	22	16	15	1792	0	1845
29700	1769	13	7	65	0	1854
29701	60	9	1752	18	0	1839
29702	28	5	1737	21	0	1791
29703	26	14	1740	17	0	1797
29704	1646	8	60	19	0	1733
29705	51	11	1737	28	0	1827
29706	26	10	1701	22	0	1759
29707	1610	9	49	22	0	1690
29708	63	1735	14	18	0	1830
29709	28	42	10	1754	0	1834
29710	17	15	16	1797	0	1845
29711	23	6	1790	57	0	1876
29712	1767	10	50	26	0	1853
29713	1835	5	23	18	0	1881
29714	1781	7	15	20	0	1823
29715	45	10	1809	23	0	1887
29716	1734	5	52	19	0	1810
29717	60	6	1764	21	0	1851
29718	29	1707	42	14	0	1792
29719	14	1753	21	20	0	1808
29720	1654	42	13	19	0	1728
29721	51	1619	12	21	0	1703
29722	24	1594	15	11	0	1644
29723	1574	32	8	15	0	1629
29724	39	1590	7	20	0	1656
29725	1603	37	12	15	0	1667
29726	46	12	10	1616	0	1684
29727	26	8	9	1641	0	1684
29728	22	10	10	1648	0	1690
29729	14	12	14	1620	0	1660
29730	22	1606	10	43	0	1681
29731	1633	42	13	17	0	1705
29732	48	1725	8	7	0	1788
29733	18	1810	10	34	0	1872
29734	20	55	1858	12	0	1945
29735	1760	18	53	11	0	1842
29736	57	8	1951	16	0	2032
29737	23	6	2048	19	0	2096
29738	17	1978	67	16	0	2078
29739	11	1942	17	5	0	1975
29740	1944	66	20	11	0	2041
29741	60	2110	6	10	0	2186
29742	23	57	2048	8	0	2136
29743	6	1998	69	5	0	2078
29744	8	66	1996	3	0	2073
29745	3	29	2005	0	0	2037
29746	1892	6	80	2	0	1980
29747	55	9	1972	1	0	2037
29748	19	3	61	1905	0	1988
29749	1893	4	27	52	0	1976
29750	56	1902	10	19	0	1987
29751	22	53	1922	8	0	2005
29752	1871	17	54	12	0	1954
29753	65	8	20	1815	0	1908
29754	20	1805	8	52	0	1885
29755	9	45	1851	19	0	1924
29756	1813	15	56	6	0	1890
29757	55	7	1854	9	0	1925
29758	22	9	57	1828	0	1916
29759	9	0	1846	56	0	1911
29760	8	2	63	1831	0	1904
29761	1792	2	31	59	0	1884
29762	49	1821	9	34	0	1913
29763	1845	56	9	7	0	1917
29764	56	22	1838	10	0	1926
29765	31	7	57	1869	0	1964
29766	6	9	1903	58	0	1976
29767	1833	4	57	27	0	1921
29768	1892	2	28	7	0	1929
29769	69	1911	7	8	0	1995
29770	1917	56	14	5	0	1992
29771	1961	20	5	6	0	1992
29772	81	6	5	1886	0	1978
29773	29	9	1876	56	0	1970
29774	17	1810	60	23	0	1910
29775	12	56	22	1831	0	1921
29776	1841	20	4	64	0	1929
29777	58	6	1834	22	0	1920
29778	22	13	1852	8	0	1895
29779	7	4	1841	13	0	1865
29780	1763	7	78	1	0	1849
29781	60	1	1808	4	0	1873
29782	1747	1	64	3	0	1815
29783	62	5	1701	2	0	1770
29784	29	1743	60	1	0	1833
29785	14	56	30	1713	0	1813
29786	15	22	1725	56	0	1818
29787	5	1670	66	26	0	1767
29788	6	1739	28	10	0	1783
29789	5	70	13	1703	0	1791
29790	1678	31	15	57	0	1781
29791	57	15	8	1684	0	1764
29792	1644	12	12	56	0	1724
29793	60	6	7	1656	0	1729
29794	30	8	1627	59	0	1724
29795	14	6	1647	32	0	1699
29796	1597	5	77	8	0	1687
29797	1619	5	32	13	0	1669
29798	79	8	1557	5	0	1649
29799	1525	5	65	8	0	1603
29800	70	14	1555	6	0	1645
29801	37	1460	64	4	0	1565
29802	13	1494	39	2	0	1548
29803	16	1486	16	6	0	1524
29804	11	80	19	1431	0	1541
29805	1417	36	14	59	0	1526
29806	1464	17	13	22	0	1516
29807	82	16	8	1418	0	1524
29808	29	8	1345	67	0	1449
29809	20	12	59	1354	0	1445
29810	23	5	1349	59	0	1436
29811	14	12	61	1300	0	1387
29812	1269	7	42	60	0	1378
29813	1317	5	21	35	0	1378
29814	1321	3	23	13	0	1360
29815	1329	5	15	18	0	1367
29816	90	7	12	1247	0	1356
29817	40	10	10	1297	0	1357
29818	1268	8	7	79	0	1362
29819	1315	6	11	30	0	1362
29820	83	7	13	1252	0	1355
29821	37	3	11	1304	0	1355
29822	24	4	12	1289	0	1329
29823	21	5	12	1302	0	1340
29824	1221	10	12	89	0	1332
29825	67	5	1205	38	0	1315
29826	36	2	55	1207	0	1300
29827	1190	6	28	71	0	1295
29828	73	3	1172	33	0	1281
29829	41	5	65	1169	0	1280
29830	12	7	1189	71	0	1279
29831	21	1130	62	29	0	1242
29832	27	46	34	994	0	1101
29833	936	12	14	58	0	1020
29834	56	13	19	844	0	932
29835	28	818	11	52	0	909
29836	19	761	13	32	0	825
29837	16	567	6	9	0	598
29838	9	542	7	13	0	571
29839	310	54	19	21	0	404
29840	26	9	28	192	0	255
29841	2	0	126	4	0	132
29842	1	0	5	113	0	119
29843	2	0	112	5	0	119
29844	113	0	5	0	0	118
29845	4	1	0	112	0	117
29846	0	0	1	116	0	117
29847	2	1	0	114	0	117
29848	1	0	0	117	0	118
29849	113	1	0	5	0	119
29850	116	0	0	2	0	118
29851	4	2	0	112	0	118
29852	111	2	0	5	0	118
29853	5	1	110	0	0	116
29854	0	110	5	1	0	116
29855	2	3	1	107	0	113
29856	1	0	0	115	0	116
29857	0	111	3	4	0	118
29858	0	4	0	112	0	116
29859	0	2	1	114	0	117
29860	112	2	0	4	0	118
29861	4	0	110	3	0	117
29862	1	0	104	2	0	107
29863	100	0	3	2	0	105
29864	3	1	96	1	0	101
29865	40	0	4	1	0	45
29866	34	0	0	0	0	34
29867	1	0	1	23	0	25
29868	1	0	11	1	0	13
29869	6	0	0	0	0	6
29870	0	6	0	0	0	6
29871	5	0	0	0	0	5
29872	5	0	2	0	0	7
29873	12	0	0	0	0	12
29874	27	0	0	0	0	27
29875	27	0	0	0	0	27
29876	27	0	0	0	0	27
29877	27	0	0	0	0	27
29878	26	0	0	0	0	26
29879	27	0	0	0	0	27
29880	27	0	0	0	0	27
29881	25	0	0	0	0	25
29882	26	0	0	0	0	26
29883	26	0	0	0	0	26
29884	18	0	0	0	0	18
29885	19	0	0	0	0	19
29886	26	0	0	0	0	26
29887	27	0	0	0	0	27
29888	19	0	0	0	0	19
29889	20	0	0	0	0	20
29890	22	0	0	0	0	22
29891	24	0	0	0	0	24
29892	26	0	0	0	0	26
29893	27	0	0	0	0	27
29894	27	0	0	0	0	27
29895	25	0	0	0	0	25
29896	21	0	0	0	0	21
29897	12	0	0	0	0	12
29898	19	0	0	0	0	19
29899	26	0	0	0	0	26
29900	26	0	0	0	0	26
29901	18	0	0	0	0	18
29902	21	0	0	0	0	21
29903	18	0	5	0	0	23
