Pos	A	C	G	T	Other	Total
1	0	0	0	0	0	0
2	0	0	0	0	0	0
3	0	0	0	0	0	0
4	0	0	0	0	0	0
5	0	0	0	0	0	0
6	0	0	0	0	0	0
7	0	0	0	0	0	0
8	0	0	0	0	0	0
9	0	0	0	0	0	0
10	0	0	0	0	0	0
11	0	0	0	0	0	0
12	1	0	0	0	0	1
13	0	0	0	326	0	326
14	610	0	0	0	0	610
15	0	832	0	0	0	832
16	0	1621	2	4	0	1627
17	1	1	0	3672	0	3674
18	0	2	1	4026	0	4029
19	0	5464	3	13	0	5480
20	0	6060	3	5	0	6068
21	1	6798	3	7	0	6809
22	7128	7	18	1	0	7154
23	14	5	7330	3	0	7352
24	22	2	7279	6	0	7309
25	1	2	9	7557	0	7569
26	8013	0	8	4	0	8025
27	8047	0	1	11	0	8059
28	12	8073	0	5	0	8090
29	9308	4	0	2	0	9314
30	9712	10	4	11	0	9737
31	10175	1	0	17	0	10193
32	10	10365	2	9	0	10386
33	6	10585	0	14	0	10605
34	10921	11	1	29	0	10962
35	10822	9	0	20	0	10851
36	10	10990	0	12	0	11012
37	8	11733	0	80	0	11821
38	11758	13	2	15	0	11788
39	11790	7	5	16	0	11818
40	12	12203	4	8	0	12227
41	7	8	2	12316	0	12333
42	5	10	1	12340	0	12356
43	4	4	3	12350	0	12361
44	6	12324	2	69	0	12401
45	14	8	12364	11	0	12397
46	11624	10	11	15	0	11660
47	10	6	6	12612	0	12634
48	13	12882	0	19	0	12914
49	3	12	1	13007	0	13023
50	4	13090	0	23	0	13117
51	6	14	1	13107	0	13128
52	5	18	1	13298	0	13322
53	12	5	13607	36	0	13660
54	5	5	13	13466	0	13489
55	13644	4	15	26	0	13689
56	23	3	13656	28	0	13710
57	13286	7	15	20	0	13328
58	17	3	19	13647	0	13686
59	18	13732	0	72	0	13822
60	4	16	3	13913	0	13936
61	7	25	14042	27	0	14101
62	5	2	16	13781	0	13804
63	3	5	21	14020	0	14049
64	2	14088	4	55	0	14149
65	1	20	0	14223	0	14244
66	1	14118	1	30	0	14150
67	1	22	2	14199	0	14224
68	14140	20	4	34	0	14198
69	13495	7	8	34	0	13544
70	13921	5	2	18	0	13946
71	41	14366	3	23	0	14433
72	36	22	14746	9	0	14813
73	14258	27	26	22	0	14333
74	15570	8	33	8	0	15619
75	75	16176	8	19	0	16278
76	47	52	7	14959	0	15065
77	15	74	14	15571	0	15674
78	9	18	12	15406	0	15445
79	15534	18	5	192	0	15749
80	15510	10	8	112	0	15640
81	15562	15	11	23	0	15611
82	15914	6	7	20	0	15947
83	188	7	7	15646	0	15848
84	105	15704	3	104	0	15916
85	28	106	1	16309	0	16444
86	21	92	16244	111	0	16468
87	17	16	101	16951	0	17085
88	29	16	17305	141	0	17491
89	20	5	145	17624	0	17794
90	29	12	18126	159	0	18326
91	18	15	18280	146	0	18459
92	8	18682	284	74	0	19048
93	10	191	141	19726	0	20068
94	162	137	20378	195	0	20872
95	18	37	193	19794	0	20042
96	14	20377	149	193	0	20733
97	20266	189	21	151	0	20627
98	186	21514	22	41	0	21763
99	142	214	12	20767	0	21135
100	21	21492	4	189	0	21706
101	38	210	21217	155	0	21620
102	45	152	21074	50	0	21321
103	16	21194	321	102	0	21633
104	22	208	165	21037	0	21432
105	67	153	21302	218	0	21740
106	20	21254	206	190	0	21670
107	21088	211	159	43	0	21501
108	207	158	32	21063	0	21460
109	179	38	21790	219	0	22226
110	33	21880	211	192	0	22316
111	22	224	164	21450	0	21860
112	16	167	37	21789	0	22009
113	21287	38	52	360	0	21737
114	212	39	21501	206	0	21958
115	177	33	214	21150	0	21574
116	63	31	20992	243	0	21329
117	30	19358	239	227	0	19854
118	18637	231	176	70	0	19114
119	198	18270	45	87	0	18600
120	173	254	45	17157	0	17629
121	40	17360	42	251	0	17693
122	17103	239	58	182	0	17582
123	216	17277	44	99	0	17636
124	192	246	17014	72	0	17524
125	43	17113	241	67	0	17464
126	16726	259	185	59	0	17229
127	234	193	17398	80	0	17905
128	171	63	246	17469	0	17949
129	17153	68	206	272	0	17699
130	262	54	71	16625	0	17012
131	16735	47	65	303	0	17150
132	16762	70	58	241	0	17131
133	434	60	58	16457	0	17009
134	235	73	52	16575	0	16935
135	16501	56	64	458	0	17079
136	16357	83	59	261	0	16760
137	449	58	58	15924	0	16489
138	16073	69	65	295	0	16502
139	15894	74	66	243	0	16277
140	446	15863	67	106	0	16482
141	252	290	49	16152	0	16743
142	16289	256	69	311	0	16925
143	16622	94	79	263	0	17058
144	448	86	75	16484	0	17093
145	251	72	84	16754	0	17161
146	16489	67	79	481	0	17116
147	288	16717	74	297	0	17376
148	252	279	79	16469	0	17079
149	104	241	16730	320	0	17395
150	106	105	280	16384	0	16875
151	94	17063	227	311	0	17695
152	83	263	17442	288	0	18076
153	87	246	282	16670	0	17285
154	113	91	227	17400	0	17831
155	91	89	17700	476	0	18356
156	16639	76	291	307	0	17313
157	290	18633	237	151	0	19311
158	18802	279	113	112	0	19306
159	329	247	18660	111	0	19347
160	276	113	19423	85	0	19897
161	18255	88	437	132	0	18912
162	299	19691	241	131	0	20362
163	19744	294	82	135	0	20255
164	327	20236	67	124	0	20754
165	305	298	20145	133	0	20881
166	19881	259	263	121	0	20524
167	365	97	20505	113	0	21080
168	263	100	290	20112	0	20765
169	20280	74	232	345	0	20931
170	20229	88	80	271	0	20668
171	460	20575	95	135	0	21265
172	265	473	71	19688	0	20497
173	109	20358	77	303	0	20847
174	130	255	19702	241	0	20328
175	97	454	302	18236	0	19089
176	79	18459	178	250	0	18966
177	98	175	114	17501	0	17888
178	16352	150	59	220	0	16781
179	209	55	47	17215	0	17526
180	169	17401	48	226	0	17844
181	90	175	46	17554	0	17865
182	85	159	47	17324	0	17615
183	76	17682	55	296	0	18109
184	72	166	68	18094	0	18400
185	134	136	18126	200	0	18596
186	97	18158	161	170	0	18586
187	17136	135	124	69	0	17464
188	158	101	16905	60	0	17224
189	139	34	16361	48	0	16582
190	65	16107	140	55	0	16367
191	152	109	178	15318	0	15757
192	57	79	15416	88	0	15640
193	51	14338	71	275	0	14735
194	48	56	62	14035	0	14201
195	38	67	31	14265	0	14401
196	14307	26	18	119	0	14470
197	73	14519	24	136	0	14752
198	94	62	14102	40	0	14298
199	48	78	14306	42	0	14474
200	35	33	106	14237	0	14411
201	32	31	74	16509	0	16646
202	27	30	34	16954	0	17045
203	25	19438	23	254	0	19740
204	57	160	19830	151	0	20198
205	31	231	157	20259	0	20678
206	26	21271	206	209	0	21712
207	26	21804	55	244	0	22129
208	54	409	22574	69	0	23106
209	30	276	225	22092	0	22623
210	48	70	23986	275	0	24379
211	32	52	300	23407	0	23791
212	34	50	309	24221	0	24614
213	57	34	24206	544	0	24841
214	28	24136	279	382	0	24825
215	23708	275	338	90	0	24411
216	277	308	24712	53	0	25350
217	305	24585	295	77	0	25262
218	75	25194	318	53	0	25640
219	82	577	24807	53	0	25519
220	23773	383	330	47	0	24533
221	281	149	334	22946	0	23710
222	305	24652	99	239	0	25295
223	24465	286	69	296	0	25116
224	288	351	50	23696	0	24385
225	319	24456	52	323	0	25150
226	24451	311	77	336	0	25175
227	283	346	23947	125	0	24701
228	297	23792	312	85	0	24486
229	23338	308	324	69	0	24039
230	245	23549	109	81	0	23984
231	23240	315	96	52	0	23703
232	280	343	75	22360	0	23058
233	299	22838	84	274	0	23495
234	62	291	92	23027	0	23472
235	22599	318	78	348	0	23343
236	264	109	22458	355	0	23186
237	303	111	22637	125	0	23176
238	117	103	594	22030	0	22844
239	71	76	404	22244	0	22795
240	58	115	141	22496	0	22810
241	64	378	87	21925	0	22454
242	72	95	21859	593	0	22619
243	66	105	298	21485	0	21954
244	89	21246	334	359	0	22028
245	73	21880	132	376	0	22461
246	115	552	21563	115	0	22345
247	135	388	21353	88	0	21964
248	84	199	21818	87	0	22188
249	120	136	579	20796	0	21631
250	112	113	21463	297	0	21985
251	122	122	370	20666	0	21280
252	100	109	20698	353	0	21260
253	19225	132	381	347	0	20085
254	327	20327	349	143	0	21146
255	360	21160	127	134	0	21781
256	152	621	21354	126	0	22253
257	20072	426	332	129	0	20959
258	20586	137	363	142	0	21228
259	20620	107	158	152	0	21037
260	664	104	19757	109	0	20634
261	421	79	20002	150	0	20652
262	124	99	643	19353	0	20219
263	19210	89	452	407	0	20158
264	19081	110	176	473	0	19840
265	595	101	18950	240	0	19886
266	19069	88	417	199	0	19773
267	368	131	438	18854	0	19791
268	349	142	19236	412	0	20139
269	123	132	19193	429	0	19877
270	18290	132	775	201	0	19398
271	322	118	19223	169	0	19832
272	18352	126	528	180	0	19186
273	408	115	18966	160	0	19649
274	363	18256	518	193	0	19330
275	145	18764	483	175	0	19567
276	237	646	280	18072	0	19235
277	148	467	204	18751	0	19570
278	129	219	18530	650	0	19528
279	167	185	463	17966	0	18781
280	145	17938	500	431	0	19014
281	193	18216	244	392	0	19045
282	220	18612	175	190	0	19197
283	219	973	213	17465	0	18870
284	209	461	17541	343	0	18554
285	232	170	16996	397	0	17795
286	239	214	712	16415	0	17580
287	230	137	482	16523	0	17372
288	261	126	237	15748	0	16372
289	203	16656	208	612	0	17679
290	16731	360	162	396	0	17649
291	16611	374	199	193	0	17377
292	699	16630	200	158	0	17687
293	509	382	16694	133	0	17718
294	16576	398	454	136	0	17564
295	465	177	16978	137	0	17757
296	16799	126	511	130	0	17566
297	16586	134	482	141	0	17343
298	16654	185	221	146	0	17206
299	16433	138	171	190	0	16932
300	681	16189	186	206	0	17262
301	13788	310	155	177	0	14430
302	326	13916	196	242	0	14680
303	10666	269	108	105	0	11148
304	233	10527	121	104	0	10985
305	173	234	9100	75	0	9582
306	72	976	202	7712	0	8962
307	48	8592	209	191	0	9040
308	36	7858	79	139	0	8112
309	6519	508	708	109	0	7844
310	5788	113	30	37	0	5968
311	123	6226	41	39	0	6429
312	65	78	24	5665	0	5832
313	39	6745	38	139	0	6961
314	7012	86	33	46	0	7177
315	113	59	7082	25	0	7279
316	76	128	115	6697	0	7016
317	32	15	87	6671	0	6805
318	45	17	38	6796	0	6896
319	48	17	6731	136	0	6932
320	39	6618	112	83	0	6852
321	43	6787	72	25	0	6927
322	39	146	31	6929	0	7145
323	41	83	7055	88	0	7267
324	48	37	112	6954	0	7151
325	56	34	90	6965	0	7145
326	62	32	44	6963	0	7101
327	68	27	34	7195	0	7324
328	7071	24	52	143	0	7290
329	109	7137	41	84	0	7371
330	7155	112	55	33	0	7355
331	133	83	7110	43	0	7369
332	99	41	7278	49	0	7467
333	62	31	166	6941	0	7200
334	40	47	96	6985	0	7168
335	34	7308	55	159	0	7556
336	45	119	7388	99	0	7651
337	39	7196	123	251	0	7609
338	41	108	7564	34	0	7747
339	7050	75	160	37	0	7322
340	113	7521	91	37	0	7762
341	90	129	7569	35	0	7823
342	51	96	111	7337	0	7595
343	39	50	7628	126	0	7843
344	32	7603	109	98	0	7842
345	29	120	83	7428	0	7660
346	45	7591	26	143	0	7805
347	47	128	7585	89	0	7849
348	37	91	122	7444	0	7694
349	7486	70	62	119	0	7737
350	104	7565	37	97	0	7803
351	88	121	7612	53	0	7874
352	37	92	118	7296	0	7543
353	42	46	7625	121	0	7834
354	32	43	7045	74	0	7194
355	13	6269	110	37	0	6429
356	8	70	48	5815	0	5941
357	9	67	44	5671	0	5791
358	14	20	12	5740	0	5786
359	12	23	5862	87	0	5984
360	14	10	5849	52	0	5925
361	5398	13	81	23	0	5515
362	51	22	5733	11	0	5817
363	5472	10	57	15	0	5554
364	55	5798	45	20	0	5918
365	31	108	29	5675	0	5843
366	8	5780	15	62	0	5865
367	4	5875	10	49	0	5938
368	12	76	5996	17	0	6101
369	3	35	68	5840	0	5946
370	6	33	6086	55	0	6180
371	9	26	5830	34	0	5899
372	5771	15	86	14	0	5886
373	55	18	5953	11	0	6037
374	30	14	5772	23	0	5839
375	5591	8	76	41	0	5716
376	44	12	5819	33	0	5908
377	31	21	5725	24	0	5801
378	7	24	81	5442	0	5554
379	8	5827	34	55	0	5924
380	10	55	26	5801	0	5892
381	8	37	34	5765	0	5844
382	5795	15	20	89	0	5919
383	46	21	21	5720	0	5808
384	33	5942	23	73	0	6071
385	5925	54	18	61	0	6058
386	56	43	5953	24	0	6076
387	5924	23	68	19	0	6034
388	63	26	6422	17	0	6528
389	46	162	6411	23	0	6642
390	6	6754	111	24	0	6895
391	6794	55	61	33	0	6943
392	45	6899	32	49	0	7025
393	53	56	6935	25	0	7069
394	26	59	68	6388	0	6541
395	5	6943	73	51	0	7072
396	6865	68	34	39	0	7006
397	6723	60	28	18	0	6829
398	100	6816	24	28	0	6968
399	7032	72	30	21	0	7155
400	61	63	27	6848	0	6999
401	47	7249	43	76	0	7415
402	13	72	24	7305	0	7414
403	14	68	30	7663	0	7775
404	7822	27	38	105	0	7992
405	7698	23	36	62	0	7819
406	7747	13	39	26	0	7825
407	124	19	7799	20	0	7962
408	7654	28	81	19	0	7782
409	66	29	84	8065	0	8244
410	60	12	8170	77	0	8319
411	19	13	7704	69	0	7805
412	12	7715	127	26	0	7880
413	6659	45	42	9	0	6755
414	33	6889	10	10	0	6942
415	38	40	14	6672	0	6764
416	13	40	9	6920	0	6982
417	13	10	7079	69	0	7171
418	8	10	48	6831	0	6897
419	7	7	7095	51	0	7160
420	14	8	7268	43	0	7333
421	10	7291	78	15	0	7394
422	11	46	39	6888	0	6984
423	8	35	9	7031	0	7083
424	7055	5	11	74	0	7145
425	50	3	7041	40	0	7134
426	39	7	46	6974	0	7066
427	6961	5	45	42	0	7053
428	48	8	6961	92	0	7109
429	6819	6	47	17	0	6889
430	7021	11	41	8	0	7081
431	83	9	7348	16	0	7456
432	45	11	49	7206	0	7311
433	22	11	46	7394	0	7473
434	28	9	7530	75	0	7642
435	7337	10	60	49	0	7456
436	7555	15	54	14	0	7638
437	7368	13	25	16	0	7422
438	7367	20	21	14	0	7422
439	7328	11	37	17	0	7393
440	93	28	7360	28	0	7509
441	65	19	7571	17	0	7672
442	25	7554	84	32	0	7695
443	40	61	7447	13	0	7561
444	30	59	55	7220	0	7364
445	38	27	64	6972	0	7101
446	26	22	27	7305	0	7380
447	25	25	24	7400	0	7474
448	36	24	7527	98	0	7685
449	36	7371	62	68	0	7537
450	40	7620	58	34	0	7752
451	52	88	25	7263	0	7428
452	38	7602	24	69	0	7733
453	7425	55	26	61	0	7567
454	7259	53	27	49	0	7388
455	111	8136	24	36	0	8307
456	74	55	30	8043	0	8202
457	46	48	41	8372	0	8507
458	64	22	8469	106	0	8661
459	7900	23	73	76	0	8072
460	8370	25	68	32	0	8495
461	123	8735	39	65	0	8962
462	9079	56	46	59	0	9240
463	328	61	9078	50	0	9517
464	87	9139	88	60	0	9374
465	63	9273	78	55	0	9469
466	67	9185	42	34	0	9328
467	200	131	48	8913	0	9292
468	9177	70	21	108	0	9376
469	97	24	35	9371	0	9527
470	105	10	9764	108	0	9987
471	57	25	130	9683	0	9895
472	54	20	10114	130	0	10318
473	49	34	143	9560	0	9786
474	63	50	108	9361	0	9582
475	47	9840	43	342	0	10272
476	10114	110	49	112	0	10385
477	128	80	55	9912	0	10175
478	95	10107	50	133	0	10385
479	9997	100	58	104	0	10259
480	9207	111	57	76	0	9451
481	9905	44	55	50	0	10054
482	187	10098	55	68	0	10408
483	111	108	10186	56	0	10461
484	60	96	119	9986	0	10261
485	49	74	114	9741	0	9978
486	50	10240	57	184	0	10531
487	51	109	10041	111	0	10312
488	51	75	9725	67	0	9918
489	9125	20	179	59	0	9383
490	135	70	89	9354	0	9648
491	92	24	9784	115	0	10015
492	56	10211	103	100	0	10470
493	52	89	102	9574	0	9817
494	42	10407	64	107	0	10620
495	52	104	10300	91	0	10547
496	9631	75	120	51	0	9877
497	10001	40	70	56	0	10167
498	159	10254	33	58	0	10504
499	95	98	24	10136	0	10353
500	62	62	10104	114	0	10342
501	50	9862	106	71	0	10089
502	9674	102	62	36	0	9874
503	97	9266	33	35	0	9431
504	61	9220	22	47	0	9350
505	26	125	30	9155	0	9336
506	9	9349	36	98	0	9492
507	9241	94	25	71	0	9431
508	80	60	20	9285	0	9445
509	53	28	8932	87	0	9100
510	29	21	8632	60	0	8742
511	23	18	117	8526	0	8684
512	23	8699	60	138	0	8920
513	8742	78	28	58	0	8906
514	81	59	28	8469	0	8637
515	58	40	8498	84	0	8680
516	20	28	68	8372	0	8488
517	18	29	47	8353	0	8447
518	8325	20	31	100	0	8476
519	83	21	17	8268	0	8389
520	62	20	8234	73	0	8389
521	25	28	8140	60	0	8253
522	16	21	109	8113	0	8259
523	9	33	67	8126	0	8235
524	17	32	8355	108	0	8512
525	7647	37	72	65	0	7821
526	80	34	8425	31	0	8570
527	48	8554	83	42	0	8727
528	30	82	57	8623	0	8792
529	39	55	8710	87	0	8891
530	36	34	8695	69	0	8834
531	26	16	116	8311	0	8469
532	8474	36	74	89	0	8673
533	84	22	9094	70	0	9270
534	51	9619	82	102	0	9854
535	9686	91	55	38	0	9870
536	98	55	9736	42	0	9931
537	9292	26	92	47	0	9457
538	9622	31	69	40	0	9762
539	111	10379	45	61	0	10596
540	70	87	35	9906	0	10098
541	32	10171	37	86	0	10326
542	37	80	10155	70	0	10342
543	9618	109	102	47	0	9876
544	9985	44	75	38	0	10142
545	126	26	10420	50	0	10622
546	68	34	10547	46	0	10695
547	43	10662	130	33	0	10868
548	10727	85	82	41	0	10935
549	95	68	58	10493	0	10714
550	71	44	46	10255	0	10416
551	37	10623	42	122	0	10824
552	10539	90	59	74	0	10762
553	105	64	10856	45	0	11070
554	69	39	94	11631	0	11833
555	11786	29	90	111	0	12016
556	148	12541	53	114	0	12856
557	108	144	14653	44	0	14949
558	71	100	15298	30	0	15499
559	35	33	308	14399	0	14775
560	30	15379	137	185	0	15731
561	50	203	15296	113	0	15662
562	20	130	202	14703	0	15055
563	14960	39	128	215	0	15342
564	212	25	15372	120	0	15729
565	128	70	221	15441	0	15860
566	53	19	15809	216	0	16097
567	47	25	16595	118	0	16785
568	22	82	311	16124	0	16539
569	21	18	16994	207	0	17240
570	14801	15	204	111	0	15131
571	184	18	16234	31	0	16467
572	15425	5	190	26	0	15646
573	178	16440	106	26	0	16750
574	16860	175	24	17	0	17076
575	187	17238	26	59	0	17510
576	103	176	39	16914	0	17232
577	34	100	15	17649	0	17798
578	33	19	17620	278	0	17950
579	36	32	17899	123	0	18090
580	16	11	291	17911	0	18229
581	32	15	18278	196	0	18521
582	21	64	219	17403	0	17707
583	12	17749	142	204	0	18107
584	41	18288	64	136	0	18529
585	10	298	66	17792	0	18166
586	21	137	54	17886	0	18098
587	23	37	17936	279	0	18275
588	19	39	230	17466	0	17754
589	25	17743	152	225	0	18145
590	25	17680	77	163	0	17945
591	31	17688	52	74	0	17845
592	75	309	52	16426	0	16862
593	24	17049	67	182	0	17322
594	16639	188	63	150	0	17040
595	194	111	62	16681	0	17048
596	125	35	16887	207	0	17254
597	46	23	237	16626	0	16932
598	50	20	17025	205	0	17300
599	56	24	16956	151	0	17187
600	44	38	17236	61	0	17379
601	47	17001	334	73	0	17455
602	64	216	17235	57	0	17572
603	16625	144	242	65	0	17076
604	16815	51	175	66	0	17107
605	16974	41	125	85	0	17225
606	297	49	91	16866	0	17303
607	16839	51	105	232	0	17227
608	187	16739	110	183	0	17219
609	121	17160	93	120	0	17494
610	16988	312	115	73	0	17488
611	214	152	17303	136	0	17805
612	128	78	257	17060	0	17523
613	70	67	17669	246	0	18052
614	58	66	17499	197	0	17820
615	36	17724	338	115	0	18213
616	40	262	211	16633	0	17146
617	37	178	102	17781	0	18098
618	17678	106	85	356	0	18225
619	195	17724	111	241	0	18271
620	138	17996	92	144	0	18370
621	105	331	17915	108	0	18459
622	57	18129	266	104	0	18556
623	17616	267	208	109	0	18200
624	17237	196	167	123	0	17723
625	350	105	17926	117	0	18498
626	171	93	17940	126	0	18330
627	71	85	451	16747	0	17354
628	72	97	271	16621	0	17061
629	63	17044	174	369	0	17650
630	103	260	159	16809	0	17331
631	105	179	164	16713	0	17161
632	96	16358	138	369	0	16961
633	119	301	127	16144	0	16691
634	99	197	130	15347	0	15773
635	93	15472	128	391	0	16084
636	107	256	15439	218	0	16020
637	102	189	300	15417	0	16008
638	15401	126	211	299	0	16037
639	14674	120	180	187	0	15161
640	360	107	14897	128	0	15492
641	14514	146	306	108	0	15074
642	14825	123	211	101	0	15260
643	309	15113	135	142	0	15699
644	187	272	14971	143	0	15573
645	101	213	14861	150	0	15325
646	80	134	377	15176	0	15767
647	15285	117	226	301	0	15929
648	15268	108	162	206	0	15744
649	345	134	128	16685	0	17292
650	17919	111	128	313	0	18471
651	18224	129	135	228	0	18716
652	18469	144	164	124	0	18901
653	471	131	18242	111	0	18955
654	234	114	18258	106	0	18712
655	17256	68	371	110	0	17805
656	228	188	17672	111	0	18199
657	131	15268	141	47	0	15587
658	45	222	186	14812	0	15265
659	43	129	15277	186	0	15635
660	34	34	14609	128	0	14805
661	28	27	221	14223	0	14499
662	25	23	14805	120	0	14973
663	25	24	14743	122	0	14914
664	29	14228	198	52	0	14507
665	16	14115	117	37	0	14285
666	14137	174	29	26	0	14366
667	257	115	18	13528	0	13918
668	13593	23	31	91	0	13738
669	119	18	13583	100	0	13820
670	122	15	115	13030	0	13282
671	43	16	119	13437	0	13615
672	13590	16	39	179	0	13824
673	105	13587	31	139	0	13862
674	146	105	13155	37	0	13443
675	43	141	13204	32	0	13420
676	31	13509	187	40	0	13767
677	29	85	13372	25	0	13511
678	13	13026	166	40	0	13245
679	32	12447	111	31	0	12621
680	51	163	12639	16	0	12869
681	11866	105	112	10	0	12093
682	102	18	101	12383	0	12604
683	106	12813	28	91	0	13038
684	41	85	41	12755	0	12922
685	12721	91	46	97	0	12955
686	12621	23	31	108	0	12783
687	12656	19	38	32	0	12745
688	186	16	13052	22	0	13276
689	101	29	112	12658	0	12900
690	15	13011	123	99	0	13248
691	13400	92	53	97	0	13642
692	88	94	44	13315	0	13541
693	113	30	48	13194	0	13385
694	26	39	32	13752	0	13849
695	33	41	13504	185	0	13763
696	12686	28	118	118	0	12950
697	132	13494	107	30	0	13763
698	114	105	36	13225	0	13480
699	44	98	33	13312	0	13487
700	13282	23	47	213	0	13565
701	132	33	13190	110	0	13465
702	132	27	13648	41	0	13848
703	50	13699	217	41	0	14007
704	49	127	14369	29	0	14574
705	12988	128	171	47	0	13334
706	136	14246	161	42	0	14585
707	143	148	14393	33	0	14717
708	13200	153	168	42	0	13563
709	149	54	14941	65	0	15209
710	156	15175	154	57	0	15542
711	66	163	149	14708	0	15086
712	72	133	65	14899	0	15169
713	59	38	14863	242	0	15202
714	63	41	14755	174	0	15033
715	66	14550	239	93	0	14948
716	14256	135	166	64	0	14621
717	161	14811	97	54	0	15123
718	144	163	73	14524	0	14904
719	66	159	14706	145	0	15076
720	13690	58	195	143	0	14086
721	155	65	164	14188	0	14572
722	142	14504	88	156	0	14890
723	51	14925	100	162	0	15238
724	88	248	74	14713	0	15123
725	70	170	77	14883	0	15200
726	14946	68	70	263	0	15347
727	154	69	73	15110	0	15406
728	167	66	15280	171	0	15684
729	14847	44	195	166	0	15252
730	15157	61	176	88	0	15482
731	261	62	15489	113	0	15925
732	15420	74	183	50	0	15727
733	188	85	176	15977	0	16426
734	189	80	98	15916	0	16283
735	92	69	99	16118	0	16378
736	80	60	63	15794	0	15997
737	71	16145	72	301	0	16589
738	16229	193	97	183	0	16702
739	16380	196	73	85	0	16734
740	326	66	17184	89	0	17665
741	17058	83	172	74	0	17387
742	17610	59	195	90	0	17954
743	18013	67	72	99	0	18251
744	18915	70	85	83	0	19153
745	390	18959	67	123	0	19539
746	215	210	59	18292	0	18776
747	99	180	18920	222	0	19421
748	85	78	18328	177	0	18668
749	15124	341	398	123	0	15986
750	15097	27	213	68	0	15405
751	203	14747	32	36	0	15018
752	14845	108	17	31	0	15001
753	130	15244	18	50	0	15442
754	108	122	18	14884	0	15132
755	15263	96	14	127	0	15500
756	14601	40	28	115	0	14784
757	14966	26	22	35	0	15049
758	221	15037	10	34	0	15302
759	15224	115	20	27	0	15386
760	157	205	21	15171	0	15554
761	15467	30	22	126	0	15645
762	156	20	15401	116	0	15693
763	129	15323	117	37	0	15606
764	15301	120	101	35	0	15557
765	150	128	15364	19	0	15661
766	111	28	140	15401	0	15680
767	67	18	15803	129	0	16017
768	48	21	15602	106	0	15777
769	47	27	219	15268	0	15561
770	50	22	16015	145	0	16232
771	47	30	156	15629	0	15862
772	38	33	113	15680	0	15864
773	16150	30	35	227	0	16442
774	177	16534	40	143	0	16894
775	152	16964	24	52	0	17192
776	76	17986	23	53	0	18138
777	126	269	18035	29	0	18459
778	57	145	163	17661	0	18026
779	62	50	18302	177	0	18591
780	16847	39	189	136	0	17211
781	17659	30	145	55	0	17889
782	284	18159	49	68	0	18560
783	178	160	50	17690	0	18078
784	78	18353	36	160	0	18627
785	18300	185	36	131	0	18652
786	194	144	38	18345	0	18721
787	171	50	18754	185	0	19160
788	75	18564	163	168	0	18970
789	104	161	18803	105	0	19173
790	74	137	181	18333	0	18725
791	79	53	18505	192	0	18829
792	17351	40	201	151	0	17743
793	225	42	18691	66	0	19024
794	178	18544	186	65	0	18973
795	94	187	150	17946	0	18377
796	66	149	75	18510	0	18800
797	18334	60	75	282	0	18751
798	18263	48	78	169	0	18558
799	316	18717	74	98	0	19205
800	197	182	18791	56	0	19226
801	109	139	18484	46	0	18778
802	17866	68	284	67	0	18285
803	241	60	18560	66	0	18927
804	192	45	17875	56	0	18168
805	92	50	18301	64	0	18507
806	107	62	18193	63	0	18425
807	81	18337	279	55	0	18752
808	18324	186	188	58	0	18756
809	271	160	90	17602	0	18123
810	17795	69	77	159	0	18100
811	208	17733	61	169	0	18171
812	17740	178	71	67	0	18056
813	224	18308	74	67	0	18673
814	198	189	66	18088	0	18541
815	94	18848	64	193	0	19199
816	109	187	18683	171	0	19150
817	89	19009	197	79	0	19374
818	97	220	176	20896	0	21389
819	21040	160	94	215	0	21509
820	238	78	86	21037	0	21439
821	223	66	21663	233	0	22185
822	120	68	230	20635	0	21053
823	85	21469	235	210	0	21999
824	96	212	21462	208	0	21978
825	20436	219	241	90	0	20986
826	237	79	239	21596	0	22151
827	21912	82	121	236	0	22351
828	21328	81	100	224	0	21733
829	374	21837	93	118	0	22422
830	21811	213	94	100	0	22218
831	21406	218	91	86	0	21801
832	331	21433	115	86	0	21965
833	194	225	95	21212	0	21726
834	98	205	97	21046	0	21446
835	62	21491	113	348	0	22014
836	68	219	104	21887	0	22278
837	75	210	21695	225	0	22205
838	74	163	249	21246	0	21732
839	129	72	21396	242	0	21839
840	112	67	20191	202	0	20572
841	83	20160	329	101	0	20673
842	77	20098	208	84	0	20467
843	71	20011	98	60	0	20240
844	192	315	86	18550	0	19143
845	56	175	19178	152	0	19561
846	18195	64	190	150	0	18599
847	170	53	167	18909	0	19299
848	173	41	19320	176	0	19710
849	84	34	19208	178	0	19504
850	49	19348	282	75	0	19754
851	64	175	173	19192	0	19604
852	18817	176	65	161	0	19219
853	152	18583	53	194	0	18982
854	143	18323	48	82	0	18596
855	45	18444	53	70	0	18612
856	62	278	46	18534	0	18920
857	34	19129	58	165	0	19386
858	48	184	56	20313	0	20601
859	36	161	55	20800	0	21052
860	45	50	20651	349	0	21095
861	18663	61	240	233	0	19197
862	231	42	21301	117	0	21691
863	208	53	238	21043	0	21542
864	70	54	21490	228	0	21842
865	31	21382	243	209	0	21865
866	20772	210	221	86	0	21289
867	207	205	82	19889	0	20383
868	187	55	53	21153	0	21448
869	21332	52	62	354	0	21800
870	20619	67	64	238	0	20988
871	21377	55	56	76	0	21564
872	382	64	21174	54	0	21674
873	19492	52	202	51	0	19797
874	200	20220	190	66	0	20676
875	166	20310	61	70	0	20607
876	53	333	49	18895	0	19330
877	33	225	35	18652	0	18945
878	43	19198	38	345	0	19624
879	48	191	32	19224	0	19495
880	18891	189	38	222	0	19340
881	211	70	19138	216	0	19635
882	190	18930	192	84	0	19396
883	18328	205	174	71	0	18778
884	165	18868	68	81	0	19182
885	187	208	18539	107	0	19041
886	54	197	189	18234	0	18674
887	52	73	18302	226	0	18653
888	59	18061	216	238	0	18574
889	64	201	191	17917	0	18373
890	70	184	18016	230	0	18500
891	87	67	18050	194	0	18398
892	69	98	333	17800	0	18300
893	17848	83	205	215	0	18351
894	17364	92	90	208	0	17754
895	17919	69	63	102	0	18153
896	355	77	18393	102	0	18927
897	214	18363	200	122	0	18899
898	88	211	192	17846	0	18337
899	63	225	99	17541	0	17928
900	87	18124	77	337	0	18625
901	17855	220	79	240	0	18394
902	218	229	76	18383	0	18906
903	217	94	18500	262	0	19073
904	91	18534	225	238	0	19088
905	17824	258	222	112	0	18416
906	193	18467	106	120	0	18886
907	202	270	94	17705	0	18271
908	93	254	101	17664	0	18112
909	86	120	110	17954	0	18270
910	99	95	18103	415	0	18712
911	115	91	243	17534	0	17983
912	110	17747	278	299	0	18434
913	117	17600	145	278	0	18140
914	146	358	17186	150	0	17840
915	16146	262	301	133	0	16842
916	16660	128	240	171	0	17199
917	374	16866	102	163	0	17505
918	14791	221	92	135	0	15239
919	14665	175	92	138	0	15070
920	297	15711	102	200	0	16310
921	240	236	112	15458	0	16046
922	156	193	16395	236	0	16980
923	175	127	15948	223	0	16473
924	15990	109	366	126	0	16591
925	282	16483	216	186	0	17167
926	259	234	114	16187	0	16794
927	135	235	107	16262	0	16739
928	130	139	100	16505	0	16874
929	16225	115	109	391	0	16840
930	286	130	119	16037	0	16572
931	241	137	102	16415	0	16895
932	147	135	15982	403	0	16667
933	14844	106	245	252	0	15447
934	268	15897	200	141	0	16506
935	15603	253	109	100	0	16065
936	255	15452	81	217	0	16005
937	198	257	121	15401	0	15977
938	15433	226	102	226	0	15987
939	15592	112	110	225	0	16039
940	328	114	15573	115	0	16130
941	15631	99	251	126	0	16107
942	310	109	15648	131	0	16198
943	218	92	15351	112	0	15773
944	113	95	15345	112	0	15665
945	103	83	17009	109	0	17304
946	98	150	349	16872	0	17469
947	133	102	17318	251	0	17804
948	93	90	291	16935	0	17409
949	16744	80	218	294	0	17336
950	267	88	124	16863	0	17342
951	16609	104	91	306	0	17110
952	261	16732	78	261	0	17332
953	292	268	92	16562	0	17214
954	128	221	16696	289	0	17334
955	85	17320	248	278	0	17931
956	83	445	197	16706	0	17431
957	93	200	17124	253	0	17670
958	79	16135	190	173	0	16577
959	52	16261	143	84	0	16540
960	79	367	16022	48	0	16516
961	60	154	167	15304	0	15685
962	36	45	15504	177	0	15762
963	14299	17	179	134	0	14629
964	14708	7	127	47	0	14889
965	255	14713	48	42	0	15058
966	14825	149	24	30	0	15028
967	172	130	25	14727	0	15054
968	142	33	14604	158	0	14937
969	13860	20	165	158	0	14203
970	170	19	14438	58	0	14685
971	149	14534	173	37	0	14893
972	14904	157	136	44	0	15241
973	159	137	50	14887	0	15233
974	164	47	14973	174	0	15358
975	14620	21	170	156	0	14967
976	14472	30	156	53	0	14711
977	14807	29	54	32	0	14922
978	289	24	39	14479	0	14831
979	165	25	42	14659	0	14891
980	67	25	14550	285	0	14927
981	32	14565	162	191	0	14950
982	34	164	173	14024	0	14395
983	39	147	58	14665	0	14909
984	44	46	14586	287	0	14963
985	50	21	14561	175	0	14807
986	41	23	302	14473	0	14839
987	14298	33	181	183	0	14695
988	175	14439	68	176	0	14858
989	14469	174	54	69	0	14766
990	190	14493	55	58	0	14796
991	171	202	14323	46	0	14742
992	89	158	14349	42	0	14638
993	13614	68	333	54	0	14069
994	14988	38	203	51	0	15280
995	348	15111	81	80	0	15620
996	232	185	14714	60	0	15191
997	102	186	203	14365	0	14856
998	89	61	200	14114	0	14464
999	64	14713	81	358	0	15216
1000	67	201	84	14903	0	15255
1001	73	185	14729	251	0	15238
1002	14122	74	230	200	0	14626
1003	14324	59	220	89	0	14692
1004	14356	46	107	79	0	14588
1005	14647	42	90	72	0	14851
1006	411	51	14275	70	0	14807
1007	14249	49	233	56	0	14587
1008	282	46	14448	75	0	14851
1009	239	14231	254	93	0	14817
1010	99	225	249	14271	0	14844
1011	14426	191	110	233	0	14960
1012	241	68	93	15092	0	15494
1013	238	68	15049	261	0	15616
1014	14772	66	251	247	0	15336
1015	15073	59	247	107	0	15486
1016	413	55	126	15079	0	15673
1017	270	58	107	15260	0	15695
1018	134	65	14994	424	0	15617
1019	118	14974	247	292	0	15631
1020	14044	244	232	123	0	14643
1021	257	219	13624	79	0	14179
1022	13005	84	230	55	0	13374
1023	274	13059	224	67	0	13624
1024	13063	220	105	37	0	13425
1025	303	12773	70	69	0	13215
1026	249	12588	80	81	0	12998
1027	133	375	88	12297	0	12893
1028	94	228	81	12540	0	12943
1029	97	93	85	12507	0	12782
1030	119	52	71	12774	0	13016
1031	90	57	12395	420	0	12962
1032	12146	47	237	256	0	12686
1033	12533	48	224	106	0	12911
1034	12765	43	95	96	0	12999
1035	448	40	84	12432	0	13004
1036	319	34	71	12648	0	13072
1037	12580	47	69	371	0	13067
1038	12515	53	84	248	0	12900
1039	12535	52	91	90	0	12768
1040	423	49	95	12269	0	12836
1041	275	64	70	12146	0	12555
1042	139	50	11907	370	0	12466
1043	103	59	11834	239	0	12235
1044	93	11782	376	107	0	12358
1045	9390	226	512	111	0	10239
1046	9166	127	81	49	0	9423
1047	9325	48	41	45	0	9459
1048	249	44	9382	57	0	9732
1049	9232	33	130	62	0	9457
1050	9260	34	134	50	0	9478
1051	9437	41	63	48	0	9589
1052	259	31	49	9253	0	9592
1053	187	25	56	9153	0	9421
1054	105	27	44	9303	0	9479
1055	86	40	8484	246	0	8856
1056	7876	29	108	144	0	8157
1057	139	8094	115	64	0	8412
1058	7277	94	22	40	0	7433
1059	125	7004	19	35	0	7183
1060	117	6952	20	46	0	7135
1061	57	150	55	6912	0	7174
1062	142	86	26	6681	0	6935
1063	51	6655	28	162	0	6896
1064	6663	90	21	99	0	6873
1065	6557	83	30	47	0	6717
1066	166	41	37	6551	0	6795
1067	125	24	6585	101	0	6835
1068	73	23	6545	102	0	6743
1069	72	21	6722	48	0	6863
1070	64	21	6847	44	0	6976
1071	6211	55	144	31	0	6441
1072	6094	17	85	33	0	6229
1073	168	14	27	5842	0	6051
1074	110	18	5782	93	0	6003
1075	59	16	71	5774	0	5920
1076	40	5883	83	95	0	6101
1077	57	6183	19	107	0	6366
1078	6288	133	35	40	0	6496
1079	6301	95	17	35	0	6448
1080	6371	36	20	39	0	6466
1081	179	21	19	6241	0	6460
1082	117	26	20	6307	0	6470
1083	52	32	30	6374	0	6488
1084	62	21	24	6426	0	6533
1085	54	34	6416	163	0	6667
1086	61	21	72	6469	0	6623
1087	6606	15	89	108	0	6818
1088	109	22	45	6830	0	7006
1089	115	24	33	7011	0	7183
1090	71	22	28	7001	0	7122
1091	54	6947	36	163	0	7200
1092	50	6950	27	127	0	7154
1093	40	6836	27	59	0	6962
1094	109	113	24	6155	0	6401
1095	49	78	19	6237	0	6383
1096	6215	24	22	135	0	6396
1097	6187	10	21	98	0	6316
1098	6315	20	13	49	0	6397
1099	151	23	18	6254	0	6446
1100	109	15	20	6199	0	6343
1101	45	6298	16	140	0	6499
1102	41	6307	15	98	0	6461
1103	6249	101	14	42	0	6406
1104	91	66	17	6037	0	6211
1105	6140	21	12	72	0	6245
1106	6258	13	14	86	0	6371
1107	114	10	17	6209	0	6350
1108	83	6770	35	73	0	6961
1109	6831	54	25	82	0	6992
1110	6830	71	17	30	0	6948
1111	125	33	6999	28	0	7185
1112	6551	10	32	15	0	6608
1113	56	6457	47	19	0	6579
1114	57	32	14	6927	0	7030
1115	7829	46	8	51	0	7934
1116	58	22	9	7850	0	7939
1117	68	12	5	7799	0	7884
1118	25	8000	4	109	0	8138
1119	7998	49	13	73	0	8133
1120	7986	61	7	29	0	8083
1121	113	7977	5	27	0	8122
1122	59	7968	1	24	0	8052
1123	7970	74	4	25	0	8073
1124	7952	49	7	18	0	8026
1125	98	21	7909	18	0	8046
1126	64	19	7668	22	0	7773
1127	26	17	8263	61	0	8367
1128	17	9	88	8056	0	8170
1129	9	9	53	8307	0	8378
1130	14	7	8340	98	0	8459
1131	8206	10	44	64	0	8324
1132	8432	8	40	29	0	8509
1133	8456	10	19	26	0	8511
1134	8289	12	4	21	0	8326
1135	111	12	9218	18	0	9359
1136	9104	17	45	22	0	9188
1137	9170	23	72	22	0	9287
1138	9243	15	19	29	0	9306
1139	9216	10	10	29	0	9265
1140	9233	13	5	45	0	9296
1141	112	15	9483	54	0	9664
1142	70	9597	44	60	0	9771
1143	36	82	47	9512	0	9677
1144	33	93	17	9629	0	9772
1145	29	64	9608	101	0	9802
1146	9269	47	52	97	0	9465
1147	76	33	42	9559	0	9710
1148	98	24	9571	86	0	9779
1149	92	15	9601	75	0	9783
1150	72	10152	85	50	0	10359
1151	61	57	60	10232	0	10410
1152	48	69	19	10285	0	10421
1153	57	51	17	10378	0	10503
1154	10480	52	19	126	0	10677
1155	91	37	14	10413	0	10555
1156	102	30	10323	108	0	10563
1157	85	29	9880	89	0	10083
1158	100	23	10936	54	0	11113
1159	71	29	100	10757	0	10957
1160	11040	36	67	86	0	11229
1161	122	37	11086	62	0	11307
1162	10893	26	63	47	0	11029
1163	13127	25	68	61	0	13281
1164	147	25	48	13188	0	13408
1165	121	38	24	13243	0	13426
1166	75	13578	29	118	0	13800
1167	88	59	13773	104	0	14024
1168	13387	64	72	72	0	13595
1169	92	80	70	14380	0	14622
1170	93	14462	39	106	0	14700
1171	80	89	21	14652	0	14842
1172	82	70	14687	111	0	14950
1173	78	77	72	14362	0	14589
1174	81	14645	72	92	0	14890
1175	85	88	34	14555	0	14762
1176	14602	69	59	85	0	14815
1177	115	38	60	14390	0	14603
1178	100	14275	74	95	0	14544
1179	68	14473	75	86	0	14702
1180	14307	100	56	79	0	14542
1181	110	69	15034	72	0	15285
1182	102	38	104	14898	0	15142
1183	86	70	90	15359	0	15605
1184	102	12	15488	161	0	15763
1185	83	15422	97	133	0	15735
1186	92	91	15444	45	0	15672
1187	81	70	161	14585	0	14897
1188	65	16083	84	70	0	16302
1189	16506	85	30	55	0	16676
1190	100	16508	33	38	0	16679
1191	68	16704	33	57	0	16862
1192	16819	186	25	34	0	17064
1193	17548	60	29	42	0	17679
1194	17986	27	35	38	0	18086
1195	121	12	34	18001	0	18168
1196	80	12	18099	99	0	18290
1197	17570	13	90	70	0	17743
1198	18351	21	66	44	0	18482
1199	164	16	35	19528	0	19743
1200	102	14	19592	134	0	19842
1201	48	19503	125	102	0	19778
1202	19389	177	75	45	0	19686
1203	20822	73	39	40	0	20974
1204	191	21093	25	34	0	21343
1205	77	22268	21	41	0	22407
1206	22347	187	26	29	0	22589
1207	21985	87	22	33	0	22127
1208	21862	28	14	39	0	21943
1209	204	22	17	21793	0	22036
1210	111	22	23292	143	0	23568
1211	35	20	130	22993	0	23178
1212	39	14	23485	153	0	23691
1213	25	23094	142	105	0	23366
1214	23	23055	71	46	0	23195
1215	27	205	25	21579	0	21836
1216	59	76	25	22309	0	22469
1217	22	42	17	22054	0	22135
1218	24	22754	12	159	0	22949
1219	22514	108	10	90	0	22722
1220	21981	71	28	36	0	22116
1221	176	23250	9	62	0	23497
1222	73	119	11	22948	0	23151
1223	31	23365	8	129	0	23533
1224	40	127	8	23319	0	23494
1225	30	23767	17	134	0	23948
1226	24022	124	21	96	0	24263
1227	121	84	19	23683	0	23907
1228	99	20	23619	135	0	23873
1229	22796	30	117	96	0	23039
1230	23237	26	69	61	0	23393
1231	181	24	23774	36	0	24015
1232	83	36	120	23703	0	23942
1233	50	51	24544	137	0	24782
1234	33	39	123	24458	0	24653
1235	52	39	23969	205	0	24265
1236	22991	39	131	102	0	23263
1237	138	31	73	23680	0	23922
1238	89	24104	20	149	0	24362
1239	24255	133	32	92	0	24512
1240	135	101	20	24372	0	24628
1241	94	56	23	24416	0	24589
1242	66	36	24286	208	0	24596
1243	41	43	121	24768	0	24973
1244	64	39	25750	179	0	26032
1245	69	52	26475	114	0	26710
1246	67	45	222	27184	0	27518
1247	86	30	29737	183	0	30036
1248	29144	46	213	151	0	29554
1249	33785	59	172	52	0	34068
1250	35866	65	40	63	0	36034
1251	541	37674	49	303	0	38567
1252	329	372	50	37542	0	38293
1253	121	333	49	37091	0	37594
1254	71	39088	36	611	0	39806
1255	38786	365	71	336	0	39558
1256	382	319	34	38600	0	39335
1257	353	96	39948	387	0	40784
1258	133	62	38982	352	0	39529
1259	78	39191	635	155	0	40059
1260	39179	364	346	86	0	39975
1261	412	313	39384	86	0	40195
1262	37298	97	399	80	0	37874
1263	417	37266	336	145	0	38164
1264	372	360	37898	95	0	38725
1265	141	335	37428	94	0	37998
1266	149	97	38656	81	0	38983
1267	97	38131	666	107	0	39001
1268	124	364	38177	85	0	38750
1269	36929	323	400	70	0	37722
1270	388	119	361	37019	0	37887
1271	331	82	112	37703	0	38228
1272	105	67	81	38150	0	38403
1273	89	70	50	38849	0	39058
1274	95	67	38577	694	0	39433
1275	81	78	361	38109	0	38629
1276	78	56	338	38469	0	38941
1277	37807	63	116	704	0	38690
1278	37465	77	117	404	0	38063
1279	37685	96	107	159	0	38047
1280	742	78	39291	107	0	40218
1281	404	39131	442	123	0	40100
1282	130	39595	376	85	0	40186
1283	38296	725	129	114	0	39264
1284	395	39509	110	123	0	40137
1285	394	475	109	38453	0	39431
1286	108	408	103	39430	0	40049
1287	120	120	39465	733	0	40438
1288	93	38921	465	472	0	39951
1289	131	420	38780	156	0	39487
1290	37279	395	506	136	0	38316
1291	38479	107	438	110	0	39134
1292	789	72	156	38109	0	39126
1293	428	77	145	36864	0	37514
1294	154	69	120	37226	0	37569
1295	119	66	117	37967	0	38269
1296	127	72	37631	840	0	38670
1297	126	54	465	36869	0	37514
1298	145	58	37181	530	0	37914
1299	123	69	36013	426	0	36631
1300	103	35899	706	181	0	36889
1301	35984	411	452	131	0	36978
1302	435	36892	149	138	0	37614
1303	437	505	114	35081	0	36137
1304	141	413	36681	467	0	37702
1305	34549	140	500	452	0	35641
1306	498	107	35855	159	0	36619
1307	35252	139	493	132	0	36016
1308	35635	94	481	120	0	36330
1309	829	91	188	36245	0	37353
1310	522	128	149	34814	0	35613
1311	191	136	161	35610	0	36098
1312	192	117	34717	923	0	35949
1313	33599	125	503	570	0	34797
1314	544	34422	514	254	0	35734
1315	519	476	195	34637	0	35827
1316	34216	478	197	579	0	35470
1317	34378	172	242	556	0	35348
1318	34572	154	214	254	0	35194
1319	1007	199	33748	194	0	35148
1320	33759	200	551	246	0	34756
1321	34033	199	569	248	0	35049
1322	951	159	33779	283	0	35172
1323	582	170	34686	240	0	35678
1324	308	211	989	33985	0	35493
1325	283	132	34778	603	0	35796
1326	208	33497	715	608	0	35028
1327	199	34364	729	251	0	35543
1328	33869	868	347	220	0	35304
1329	600	34882	260	270	0	36012
1330	645	551	287	34541	0	36024
1331	33497	525	309	609	0	34940
1332	568	35024	233	701	0	36526
1333	569	601	269	34449	0	35888
1334	285	519	305	34874	0	35983
1335	240	186	34397	1059	0	35882
1336	265	153	637	34374	0	35429
1337	275	187	34514	743	0	35719
1338	293	129	34184	693	0	35299
1339	310	116	923	33283	0	34632
1340	238	143	589	33700	0	34670
1341	33493	139	255	1096	0	34983
1342	618	36123	220	769	0	37730
1343	591	658	211	34940	0	36400
1344	277	714	233	35214	0	36438
1345	33865	203	180	1112	0	35360
1346	630	33189	219	770	0	34808
1347	571	30961	171	305	0	32008
1348	248	29234	187	199	0	29868
1349	141	25958	122	154	0	26375
1350	22145	581	572	105	0	23403
1351	20698	282	173	93	0	21246
1352	20047	95	85	89	0	20316
1353	20148	143	69	87	0	20447
1354	528	56	60	19596	0	20240
1355	308	52	19639	315	0	20314
1356	124	19535	292	299	0	20250
1357	97	274	252	19318	0	19941
1358	79	228	19416	336	0	20059
1359	86	74	306	19212	0	19678
1360	87	57	264	19390	0	19798
1361	76	65	19298	510	0	19949
1362	80	65	308	19204	0	19657
1363	116	70	282	18954	0	19422
1364	18987	91	111	500	0	19689
1365	18404	81	91	304	0	18880
1366	18365	85	73	131	0	18654
1367	18391	68	69	121	0	18649
1368	546	63	81	17882	0	18572
1369	345	65	66	17804	0	18280
1370	164	71	82	17816	0	18133
1371	17214	70	81	562	0	17927
1372	340	76	82	17430	0	17928
1373	316	67	67	17452	0	17902
1374	159	69	16956	534	0	17718
1375	147	178	294	16582	0	17201
1376	120	16664	255	382	0	17421
1377	115	17227	96	340	0	17778
1378	16528	471	74	133	0	17206
1379	363	288	16325	128	0	17104
1380	266	15266	232	109	0	15873
1381	14656	231	267	88	0	15242
1382	279	241	76	14620	0	15216
1383	225	77	14577	273	0	15152
1384	126	77	237	14080	0	14520
1385	74	14879	192	272	0	15417
1386	14604	222	83	242	0	15151
1387	242	14771	65	153	0	15231
1388	14463	243	60	123	0	14889
1389	14572	203	64	95	0	14934
1390	441	83	54	14436	0	15014
1391	240	68	53	14178	0	14539
1392	103	14475	56	490	0	15124
1393	14624	229	49	279	0	15181
1394	282	195	14383	138	0	14998
1395	13995	104	214	103	0	14416
1396	13872	67	178	127	0	14244
1397	398	51	13582	128	0	14159
1398	233	124	202	13081	0	13640
1399	13127	61	179	283	0	13650
1400	250	67	13022	252	0	13591
1401	228	72	12695	128	0	13123
1402	11812	58	323	133	0	12326
1403	216	12152	201	111	0	12680
1404	214	11066	69	94	0	11443
1405	116	291	36	11115	0	11558
1406	100	181	11040	186	0	11507
1407	10392	76	149	186	0	10803
1408	192	79	10945	155	0	11371
1409	156	10100	153	79	0	10488
1410	10066	155	103	86	0	10410
1411	174	134	68	9925	0	10301
1412	10194	74	47	166	0	10481
1413	186	48	10186	219	0	10639
1414	173	52	139	10010	0	10374
1415	101	10170	119	166	0	10556
1416	89	175	55	10011	0	10330
1417	109	144	53	10241	0	10547
1418	111	70	10194	245	0	10620
1419	105	10044	131	182	0	10462
1420	106	10034	123	113	0	10376
1421	115	194	9389	96	0	9794
1422	8378	163	181	66	0	8788
1423	8680	48	107	76	0	8911
1424	241	33	60	8696	0	9030
1425	8612	29	62	139	0	8842
1426	158	8279	53	157	0	8647
1427	134	8452	50	109	0	8745
1428	8548	183	62	78	0	8871
1429	150	113	49	8501	0	8813
1430	8489	49	102	154	0	8794
1431	8539	50	59	132	0	8780
1432	230	52	39	7809	0	8130
1433	155	52	7788	158	0	8153
1434	7601	48	133	132	0	7914
1435	7640	40	118	72	0	7870
1436	231	39	70	7565	0	7905
1437	154	7862	66	137	0	8219
1438	84	165	39	7909	0	8197
1439	82	130	7802	167	0	8181
1440	91	54	7785	145	0	8075
1441	82	7754	218	88	0	8142
1442	215	63	95	5049	0	5422
1443	28	47	22	5146	0	5243
1444	40	25	5190	83	0	5338
1445	4891	20	59	47	0	5017
1446	5093	16	49	22	0	5180
1447	5011	12	20	22	0	5065
1448	5160	16	20	25	0	5221
1449	101	5110	23	24	0	5258
1450	64	5297	22	32	0	5415
1451	5304	79	25	28	0	5436
1452	72	51	19	5599	0	5741
1453	61	21	23	5738	0	5843
1454	20	5912	21	101	0	6054
1455	38	74	18	5832	0	5962
1456	28	57	22	5609	0	5716
1457	26	5722	27	109	0	5884
1458	34	66	5775	58	0	5933
1459	35	59	63	5776	0	5933
1460	5770	34	51	74	0	5929
1461	5687	22	31	69	0	5809
1462	128	19	5706	29	0	5882
1463	84	18	5638	23	0	5763
1464	46	13	5573	33	0	5665
1465	40	13	97	5453	0	5603
1466	35	23	5561	78	0	5697
1467	44	22	5530	58	0	5654
1468	36	199	98	5141	0	5474
1469	27	5582	59	80	0	5748
1470	49	71	5452	57	0	5629
1471	26	5556	54	37	0	5673
1472	5428	69	45	31	0	5573
1473	64	5572	25	32	0	5693
1474	48	58	25	5511	0	5642
1475	5552	48	20	71	0	5691
1476	74	26	20	5494	0	5614
1477	57	19	23	5701	0	5800
1478	51	18	6060	100	0	6229
1479	47	5874	77	62	0	6060
1480	36	6077	65	37	0	6215
1481	36	149	27	5729	0	5941
1482	29	58	25	5707	0	5819
1483	22	17	22	5861	0	5922
1484	24	23	5808	114	0	5969
1485	29	18	5446	61	0	5554
1486	5082	16	97	39	0	5234
1487	70	26	5646	37	0	5779
1488	43	21	5725	17	0	5806
1489	35	5642	105	24	0	5806
1490	27	77	48	5538	0	5690
1491	23	47	5598	81	0	5749
1492	20	12	85	5516	0	5633
1493	32	10	5665	95	0	5802
1494	24	10	82	5660	0	5776
1495	15	16	6132	94	0	6257
1496	17	15	98	5980	0	6110
1497	21	23	53	5884	0	5981
1498	13	6289	21	118	0	6441
1499	11	86	25	6261	0	6383
1500	11	6417	25	102	0	6555
1501	12	97	20	6477	0	6606
1502	14	52	32	6514	0	6612
1503	6423	27	28	130	0	6608
1504	88	21	17	6400	0	6526
1505	92	21	6173	103	0	6389
1506	19	12	103	6204	0	6338
1507	27	21	51	6250	0	6349
1508	30	19	6231	145	0	6425
1509	21	23	6137	72	0	6253
1510	13	22	129	5934	0	6098
1511	17	35	67	6163	0	6282
1512	27	25	6146	149	0	6347
1513	17	5887	106	92	0	6102
1514	11	6101	69	53	0	6234
1515	5992	118	42	54	0	6206
1516	86	72	33	6126	0	6317
1517	6156	26	46	113	0	6341
1518	6047	28	51	76	0	6202
1519	123	6153	38	63	0	6377
1520	6168	94	52	52	0	6366
1521	6124	49	54	59	0	6286
1522	123	35	6146	65	0	6369
1523	54	69	118	6070	0	6311
1524	30	22	6160	125	0	6337
1525	18	20	138	6081	0	6257
1526	27	24	6147	126	0	6324
1527	7	5743	125	88	0	5963
1528	17	5877	77	47	0	6018
1529	86	113	37	5592	0	5828
1530	5491	59	38	103	0	5691
1531	71	31	42	5612	0	5756
1532	49	26	32	5695	0	5802
1533	24	15	5688	149	0	5876
1534	23	17	5663	82	0	5785
1535	16	21	5730	46	0	5813
1536	15	31	121	5588	0	5755
1537	20	32	66	5318	0	5436
1538	12	5516	46	133	0	5707
1539	17	5782	38	94	0	5931
1540	5642	118	30	55	0	5845
1541	71	5696	41	59	0	5867
1542	53	82	5429	48	0	5612
1543	27	65	90	5326	0	5508
1544	17	25	5529	112	0	5683
1545	12	5431	107	87	0	5637
1546	21	86	68	5444	0	5619
1547	5283	54	41	127	0	5505
1548	72	26	5394	79	0	5571
1549	47	5412	88	69	0	5616
1550	12	65	5407	71	0	5555
1551	19	5297	104	40	0	5460
1552	57	105	129	4707	0	4998
1553	4635	42	29	83	0	4789
1554	4617	18	20	66	0	4721
1555	78	4653	28	42	0	4801
1556	4644	62	28	36	0	4770
1557	68	53	19	4620	0	4760
1558	4565	21	30	79	0	4695
1559	66	18	4530	64	0	4678
1560	47	10	4514	39	0	4610
1561	23	21	90	4333	0	4467
1562	22	17	59	4533	0	4631
1563	32	21	4516	98	0	4667
1564	21	15	73	4482	0	4591
1565	4460	16	50	92	0	4618
1566	4423	21	35	54	0	4533
1567	85	4431	20	39	0	4575
1568	52	4451	20	35	0	4558
1569	4301	95	21	31	0	4448
1570	65	57	19	4276	0	4417
1571	4226	29	16	77	0	4348
1572	74	4242	25	57	0	4398
1573	4200	63	30	37	0	4330
1574	68	40	4037	41	0	4186
1575	46	12	4088	38	0	4184
1576	19	165	102	3901	0	4187
1577	12	27	3996	63	0	4098
1578	16	18	38	3454	0	3526
1579	16	15	37	3394	0	3462
1580	13	22	3670	67	0	3772
1581	17	12	39	3626	0	3694
1582	16	14	35	3894	0	3959
1583	23	13	4175	64	0	4275
1584	12	19	4112	44	0	4187
1585	4013	12	66	26	0	4117
1586	45	15	4379	59	0	4498
1587	3982	13	258	6	0	4259
1588	4373	8	41	9	0	4431
1589	66	5	4527	13	0	4611
1590	38	6	4621	13	0	4678
1591	16	41	74	4465	0	4596
1592	7	20	42	4410	0	4479
1593	8	4495	12	142	0	4657
1594	17	4678	5	42	0	4742
1595	19	67	4668	18	0	4772
1596	4493	52	45	10	0	4600
1597	4595	13	50	8	0	4666
1598	78	5	4511	14	0	4608
1599	51	6	4512	10	0	4579
1600	14	9	73	4212	0	4308
1601	17	4419	45	38	0	4519
1602	13	40	13	4362	0	4428
1603	13	41	13	4451	0	4518
1604	4452	5	14	76	0	4547
1605	4423	9	14	48	0	4494
1606	70	9	11	4497	0	4587
1607	49	5	4506	47	0	4607
1608	4283	3	43	53	0	4382
1609	38	4495	47	34	0	4614
1610	4530	40	11	16	0	4597
1611	4435	38	17	14	0	4504
1612	81	4502	16	12	0	4611
1613	46	4575	20	11	0	4652
1614	15	68	18	4548	0	4649
1615	16	46	17	4502	0	4581
1616	13	4543	6	78	0	4640
1617	15	43	13	4479	0	4550
1618	12	42	16	4552	0	4622
1619	13	11	4522	94	0	4640
1620	4437	10	51	54	0	4552
1621	4522	6	52	31	0	4611
1622	4593	10	34	18	0	4655
1623	109	8	30	4508	0	4655
1624	4488	2	24	55	0	4569
1625	68	4405	18	62	0	4553
1626	57	49	14	4257	0	4377
1627	23	4363	21	57	0	4464
1628	17	4421	16	51	0	4505
1629	4391	85	15	24	0	4515
1630	4381	59	64	23	0	4527
1631	4249	26	21	20	0	4316
1632	4252	14	16	17	0	4299
1633	4313	8	17	18	0	4356
1634	116	11	4308	12	0	4447
1635	4388	8	57	12	0	4465
1636	73	12	4331	14	0	4430
1637	4057	14	63	17	0	4151
1638	4083	11	48	13	0	4155
1639	4000	13	34	17	0	4064
1640	91	19	4034	23	0	4167
1641	60	14	49	3914	0	4037
1642	35	4178	49	51	0	4313
1643	4250	49	32	42	0	4373
1644	4190	42	22	28	0	4282
1645	87	4181	20	23	0	4311
1646	4239	55	13	19	0	4326
1647	76	44	18	4026	0	4164
1648	52	4142	19	57	0	4270
1649	4070	47	20	46	0	4183
1650	4013	40	22	35	0	4110
1651	100	33	19	4000	0	4152
1652	4059	18	25	62	0	4164
1653	82	22	25	4108	0	4237
1654	65	18	25	4137	0	4245
1655	52	18	4086	94	0	4250
1656	43	26	52	4086	0	4207
1657	42	19	51	4107	0	4219
1658	38	22	4107	93	0	4260
1659	41	30	4150	72	0	4293
1660	44	18	88	4249	0	4399
1661	39	29	4319	67	0	4454
1662	4168	25	79	51	0	4323
1663	79	4246	46	45	0	4416
1664	72	62	46	4229	0	4409
1665	59	50	19	4385	0	4513
1666	44	44	14	4444	0	4546
1667	4364	24	13	105	0	4506
1668	4321	23	9	85	0	4438
1669	4407	23	17	55	0	4502
1670	124	4375	14	36	0	4549
1671	104	58	11	4337	0	4510
1672	76	54	12	4369	0	4511
1673	4382	41	14	92	0	4529
1674	4386	22	15	66	0	4489
1675	110	30	14	4312	0	4466
1676	103	27	4399	63	0	4592
1677	4412	33	48	58	0	4551
1678	4462	30	37	52	0	4581
1679	110	34	4459	31	0	4634
1680	4220	26	50	37	0	4333
1681	98	19	4105	39	0	4261
1682	3924	27	74	23	0	4048
1683	98	10	54	3921	0	4083
1684	78	4150	34	60	0	4322
1685	76	49	4610	45	0	4780
1686	48	4337	70	42	0	4497
1687	39	3997	36	15	0	4087
1688	3558	61	116	11	0	3746
1689	119	35	7	3416	0	3577
1690	20	20	4	3375	0	3419
1691	3481	3	3	52	0	3539
1692	38	1	3	3758	0	3800
1693	19	4	4	3725	0	3752
1694	25	3	3	3690	0	3721
1695	8	3	2	3702	0	3715
1696	4	2	3632	74	0	3712
1697	7	2	3622	42	0	3673
1698	4	3623	52	28	0	3707
1699	3774	36	33	7	0	3850
1700	41	15	24	3704	0	3784
1701	18	3834	6	44	0	3902
1702	20	40	4	4051	0	4115
1703	8	16	1	4048	0	4073
1704	3	23	4	4052	0	4082
1705	5	4	7	4104	0	4120
1706	4	2	4	4168	0	4178
1707	3	4054	6	76	0	4139
1708	12	36	2	4226	0	4276
1709	11	18	4117	59	0	4205
1710	6	4192	42	37	0	4277
1711	3	43	19	4237	0	4302
1712	3	21	22	4306	0	4352
1713	10	4209	2	62	0	4283
1714	12	4222	2	39	0	4275
1715	4191	53	2	28	0	4274
1716	39	4228	3	22	0	4292
1717	4159	57	6	16	0	4238
1718	4094	16	3	11	0	4124
1719	51	6	4514	10	0	4581
1720	19	2	30	4380	0	4431
1721	12	3	4681	38	0	4734
1722	6	4790	37	26	0	4859
1723	10	39	22	4787	0	4858
1724	8	18	10	4941	0	4977
1725	4	11	6	5163	0	5184
1726	12	6	4	5214	0	5236
1727	7	6	5335	73	0	5421
1728	6	10	38	5367	0	5421
1729	11	4	5458	60	0	5533
1730	10	9	5430	42	0	5491
1731	5475	7	68	20	0	5570
1732	5840	7	33	13	0	5893
1733	5877	8	9	23	0	5917
1734	79	5856	8	22	0	5965
1735	36	52	5	5865	0	5958
1736	16	31	6126	57	0	6230
1737	15	11	49	6078	0	6153
1738	7	4	6530	65	0	6606
1739	6408	10	49	44	0	6511
1740	6362	9	33	16	0	6420
1741	6369	9	13	18	0	6409
1742	83	8	6179	14	0	6284
1743	40	12	6172	16	0	6240
1744	18	6	76	6272	0	6372
1745	12	7	39	6311	0	6369
1746	5	9	17	6552	0	6583
1747	11	10	6638	86	0	6745
1748	18	4	6418	56	0	6496
1749	6498	11	73	26	0	6608
1750	49	6	35	6751	0	6841
1751	34	5	13	6833	0	6885
1752	6969	6	12	87	0	7074
1753	56	4	10	6948	0	7018
1754	7690	13	15	67	0	7785
1755	7953	7	14	49	0	8023
1756	7891	9	20	24	0	7944
1757	92	8	8257	31	0	8388
1758	49	8292	54	19	0	8414
1759	8678	50	35	17	0	8780
1760	68	36	10	8503	0	8617
1761	43	15	11	8454	0	8523
1762	15	8537	8	154	0	8714
1763	8592	55	13	44	0	8704
1764	8543	29	13	26	0	8611
1765	8819	11	16	16	0	8862
1766	85	8955	14	22	0	9076
1767	9539	57	9	20	0	9625
1768	9454	34	11	33	0	9532
1769	9592	12	12	26	0	9642
1770	92	11	13	9525	0	9641
1771	43	10	6	9723	0	9782
1772	26	5	10211	104	0	10346
1773	15	1	62	9937	0	10015
1774	13	8	48	10215	0	10284
1775	22	10	10231	97	0	10360
1776	9647	6	59	54	0	9766
1777	10156	7	36	27	0	10226
1778	92	9	13	10088	0	10202
1779	52	10067	14	63	0	10196
1780	25	10318	8	57	0	10408
1781	26	114	14	10258	0	10412
1782	24	40	10090	74	0	10228
1783	22	65	82	9828	0	9997
1784	22	10	10655	97	0	10784
1785	19	5	11263	30	0	11317
1786	16	4	48	11509	0	11577
1787	11777	4	23	53	0	11857
1788	11530	5	16	30	0	11581
1789	54	5	10	12109	0	12178
1790	35	5	10	12463	0	12513
1791	16	5	13	12547	0	12581
1792	15	4	11	12790	0	12820
1793	13156	2	10	58	0	13226
1794	12839	5	17	37	0	12898
1795	13075	7	10	19	0	13111
1796	66	5	13426	18	0	13515
1797	36	4	35	13227	0	13302
1798	23	8	23	13574	0	13628
1799	13455	6	8	79	0	13548
1800	40	13922	13	41	0	14016
1801	14136	32	9	22	0	14199
1802	13765	26	10	24	0	13825
1803	13830	16	5	37	0	13888
1804	13884	9	12	28	0	13933
1805	79	11	15694	20	0	15804
1806	53	11	15479	18	0	15561
1807	16214	12	51	28	0	16305
1808	16313	7	27	32	0	16379
1809	16125	9	16	26	0	16176
1810	16185	3	14	32	0	16234
1811	75	11	16979	17	0	17082
1812	41	17476	38	26	0	17581
1813	30	41	27	18263	0	18361
1814	20208	28	12	74	0	20322
1815	20198	8	12	65	0	20283
1816	20877	10	13	32	0	20932
1817	21113	5	13	31	0	21162
1818	21107	6	8	35	0	21156
1819	20708	9	19	39	0	20775
1820	143	13	20536	20	0	20712
1821	76	11	20449	11	0	20547
1822	26	8	88	20192	0	20314
1823	41	8	20908	145	0	21102
1824	16	20431	73	57	0	20577
1825	16	21562	61	71	0	21710
1826	11	121	11	21894	0	22037
1827	23	26	24466	57	0	24572
1828	22	80	23685	36	0	23823
1829	23180	17	90	40	0	23327
1830	25856	5	34	29	0	25924
1831	105	7	10	26448	0	26570
1832	26857	5	11	108	0	26981
1833	97	3	12	26594	0	26706
1834	71	8	9	26816	0	26904
1835	31	1	28396	164	0	28592
1836	32	6	27927	80	0	28045
1837	14	8	154	27987	0	28163
1838	42	6	28161	108	0	28317
1839	25783	10	116	159	0	26068
1840	28453	5	78	42	0	28578
1841	167	29919	17	56	0	30159
1842	30453	102	12	56	0	30623
1843	164	85	30482	20	0	30751
1844	29679	11	121	43	0	29854
1845	30774	14	97	33	0	30918
1846	31069	9	16	31	0	31125
1847	237	13	23	30830	0	31103
1848	125	31351	29	143	0	31648
1849	31523	133	27	116	0	31799
1850	31137	98	48	52	0	31335
1851	236	10	32	31617	0	31895
1852	31666	10	25	165	0	31866
1853	167	32233	16	151	0	32567
1854	133	154	24	32068	0	32379
1855	62	121	31915	178	0	32276
1856	27969	27	191	191	0	28378
1857	209	23	31996	57	0	32285
1858	147	9	172	31713	0	32041
1859	42	31891	141	196	0	32270
1860	44	33390	47	182	0	33663
1861	52	350	34	34342	0	34778
1862	83	36312	63	282	0	36740
1863	53	318	44	45982	0	46397
1864	53	240	41	48047	0	48381
1865	54	41	35	49009	0	49139
1866	47891	41	37	866	0	48835
1867	550	19	35	48271	0	48875
1868	431	23	47738	602	0	48794
1869	109	47818	512	439	0	48878
1870	47690	519	367	91	0	48667
1871	563	466	56	46807	0	47892
1872	435	82	53	46771	0	47341
1873	111	67	27	48340	0	48545
1874	141	31	47623	935	0	48730
1875	78	47648	529	490	0	48745
1876	47140	538	490	127	0	48295
1877	569	436	76	45030	0	46111
1878	419	47951	61	524	0	48955
1879	47753	560	53	414	0	48780
1880	606	407	47306	152	0	48471
1881	46949	79	577	142	0	47747
1882	673	85	48165	120	0	49043
1883	528	62	47616	120	0	48326
1884	124	47113	918	379	0	48534
1885	130	602	470	45394	0	46596
1886	161	441	45840	632	0	47074
1887	129	44941	668	568	0	46306
1888	116	619	439	44089	0	45263
1889	96	45449	116	637	0	46298
1890	141	626	44781	517	0	46065
1891	90	490	617	43926	0	45123
1892	184	138	44738	722	0	45782
1893	130	132	626	44024	0	44912
1894	138	91	467	44451	0	45147
1895	155	119	44124	1091	0	45489
1896	158	98	654	44047	0	44957
1897	42985	111	503	764	0	44363
1898	630	43576	163	850	0	45219
1899	542	612	43847	278	0	45279
1900	42218	584	662	282	0	43746
1901	708	171	507	41832	0	43218
1902	527	43367	186	743	0	44823
1903	43321	651	189	584	0	44745
1904	43310	540	154	284	0	44288
1905	1023	206	178	41024	0	42431
1906	585	212	153	41088	0	42038
1907	222	170	168	41670	0	42230
1908	218	146	202	41246	0	41812
1909	174	40735	180	1259	0	42348
1910	267	759	206	39905	0	41137
1911	213	40173	190	877	0	41453
1912	226	39646	221	764	0	40857
1913	180	39762	203	470	0	40615
1914	291	1083	37133	356	0	38863
1915	189	37820	706	355	0	39070
1916	36179	811	570	455	0	38015
1917	693	36837	221	515	0	38266
1918	527	737	229	34116	0	35609
1919	252	36822	236	941	0	38251
1920	247	772	249	35952	0	37220
1921	276	655	272	36747	0	37950
1922	296	304	35967	1340	0	37907
1923	33867	307	770	919	0	35863
1924	34949	317	689	539	0	36494
1925	34378	335	319	507	0	35539
1926	1114	34160	344	577	0	36195
1927	655	833	344	32205	0	34037
1928	339	683	31749	1000	0	33771
1929	295	31983	814	895	0	33987
1930	240	884	653	28050	0	29827
1931	292	29605	335	830	0	31062
1932	29012	821	325	665	0	30823
1933	29560	666	321	401	0	30948
1934	29773	403	270	398	0	30844
1935	29149	316	379	379	0	30223
1936	1115	286	395	28125	0	29921
1937	661	338	380	27787	0	29166
1938	314	28211	404	1135	0	30064
1939	320	783	364	28902	0	30369
1940	268	672	27946	896	0	29782
1941	257	348	837	26832	0	28274
1942	211	416	26569	865	0	28061
1943	210	25995	738	757	0	27700
1944	233	796	26283	451	0	27763
1945	270	663	832	25509	0	27274
1946	206	394	26109	863	0	27572
1947	256	335	727	25552	0	26870
1948	304	346	627	25234	0	26511
1949	275	294	297	25597	0	26463
1950	295	278	321	25855	0	26749
1951	24796	284	260	1178	0	26518
1952	691	25146	242	831	0	26910
1953	24727	709	227	497	0	26160
1954	654	599	24196	465	0	25914
1955	23645	334	625	420	0	25024
1956	23948	322	480	448	0	25198
1957	1174	355	23326	375	0	25230
1958	762	343	22964	370	0	24439
1959	378	22978	774	376	0	24506
1960	258	21990	421	385	0	23054
1961	625	843	19946	474	0	21888
1962	308	17676	566	578	0	19128
1963	842	490	285	6852	0	8469
1964	6061	63	105	164	0	6393
1965	52	32	101	6038	0	6223
1966	6596	24	17	76	0	6713
1967	6609	35	10	60	0	6714
1968	88	7140	17	41	0	7286
1969	7284	53	10	26	0	7373
1970	7275	55	16	31	0	7377
1971	72	41	13	7204	0	7330
1972	7307	22	19	61	0	7409
1973	47	7900	17	57	0	8021
1974	94	56	12	7828	0	7990
1975	7942	37	15	65	0	8059
1976	58	28	7974	44	0	8104
1977	7737	16	50	25	0	7828
1978	63	17	34	7964	0	8078
1979	48	17	8060	53	0	8178
1980	27	15	7919	41	0	8002
1981	7489	12	82	37	0	7620
1982	7802	6	33	17	0	7858
1983	61	10	12	7805	0	7888
1984	36	7	6	7839	0	7888
1985	19	9	8	7894	0	7930
1986	14	8101	5	65	0	8185
1987	8239	39	6	40	0	8324
1988	44	8297	7	23	0	8371
1989	8246	43	14	20	0	8323
1990	49	23	8528	19	0	8619
1991	31	13	36	8436	0	8516
1992	8696	14	31	52	0	8793
1993	45	8	10	8722	0	8785
1994	33	8	18	8611	0	8670
1995	22	8537	10	76	0	8645
1996	8622	40	14	42	0	8718
1997	40	9204	10	25	0	9279
1998	24	54	18	9404	0	9500
1999	26	31	9374	128	0	9559
2000	8478	13	67	52	0	8610
2001	75	9	9438	32	0	9554
2002	8735	9	68	33	0	8845
2003	76	9640	52	21	0	9789
2004	56	70	19	9441	0	9586
2005	35	9696	9	83	0	9823
2006	9991	87	14	55	0	10147
2007	84	49	14	9963	0	10110
2008	67	18	14	10125	0	10224
2009	41	12	9937	132	0	10122
2010	9099	12	79	92	0	9282
2011	88	14	52	10058	0	10212
2012	66	13	9922	104	0	10105
2013	37	10087	72	79	0	10275
2014	21	79	56	10163	0	10319
2015	10300	62	23	94	0	10479
2016	108	31	13	10334	0	10486
2017	71	15	10590	97	0	10773
2018	11170	5	97	68	0	11340
2019	116	11	70	11471	0	11668
2020	101	6	12243	119	0	12469
2021	35	12	115	12352	0	12514
2022	23	30	88	12139	0	12280
2023	21	12552	29	211	0	12813
2024	12482	129	11	124	0	12746
2025	123	12651	13	59	0	12846
2026	12643	138	18	35	0	12834
2027	146	107	17	12367	0	12637
2028	113	12547	21	132	0	12813
2029	46	130	21	12490	0	12687
2030	36	95	12207	162	0	12500
2031	11720	41	126	112	0	11999
2032	140	27	95	11996	0	12258
2033	114	22	31	11636	0	11803
2034	48	21	17	11878	0	11964
2035	32	15	11578	248	0	11873
2036	46	22	11432	137	0	11637
2037	38	11491	204	68	0	11801
2038	33	118	118	11283	0	11552
2039	11235	98	48	135	0	11516
2040	123	11472	26	159	0	11780
2041	109	161	21	11881	0	12172
2042	11996	107	23	150	0	12276
2043	11841	41	25	124	0	12031
2044	236	12231	29	57	0	12553
2045	12615	131	18	50	0	12814
2046	13387	131	23	45	0	13586
2047	268	44	22	14023	0	14357
2048	172	14024	31	241	0	14468
2049	59	162	27	14327	0	14575
2050	14096	160	70	206	0	14532
2051	203	46	14224	180	0	14653
2052	182	39	150	13974	0	14345
2053	52	23	167	14127	0	14369
2054	65	42	14081	322	0	14510
2055	43	34	172	14146	0	14395
2056	13914	40	169	235	0	14358
2057	13492	31	61	210	0	13794
2058	318	30	42	13830	0	14220
2059	217	29	13675	218	0	14139
2060	74	21	13388	228	0	13711
2061	38	13408	305	103	0	13854
2062	46	13580	187	100	0	13913
2063	125	315	55	13251	0	13746
2064	13073	190	38	199	0	13500
2065	178	13221	33	212	0	13644
2066	12793	182	34	81	0	13090
2067	194	184	36	12462	0	12876
2068	191	70	28	12142	0	12431
2069	11877	43	35	336	0	12291
2070	191	11955	29	233	0	12408
2071	12108	182	20	101	0	12411
2072	226	180	11736	90	0	12232
2073	210	49	11146	69	0	11474
2074	72	81	289	10958	0	11400
2075	65	35	11120	190	0	11410
2076	60	39	10910	211	0	11220
2077	56	30	300	10578	0	10964
2078	54	32	10848	190	0	11124
2079	66	27	194	10606	0	10893
2080	59	38	179	10624	0	10900
2081	70	34	10704	333	0	11141
2082	55	33	180	10556	0	10824
2083	62	47	194	10145	0	10448
2084	57	10367	68	342	0	10834
2085	10325	157	59	225	0	10766
2086	173	183	10248	112	0	10716
2087	196	56	175	10052	0	10479
2088	89	48	174	10143	0	10454
2089	65	62	9985	337	0	10449
2090	9215	44	169	240	0	9668
2091	176	9550	182	191	0	10099
2092	221	166	68	9409	0	9864
2093	94	180	57	9387	0	9718
2094	74	9546	55	334	0	10009
2095	275	171	9536	227	0	10209
2096	61	9943	168	116	0	10288
2097	9168	229	210	149	0	9756
2098	161	169	9016	76	0	9422
2099	162	83	163	8785	0	9193
2100	63	46	9071	172	0	9352
2101	51	45	8869	198	0	9163
2102	44	8651	258	115	0	9068
2103	93	152	258	8118	0	8621
2104	8110	143	109	171	0	8533
2105	8168	43	55	188	0	8454
2106	235	7830	69	257	0	8391
2107	155	117	55	8002	0	8329
2108	7933	135	54	168	0	8290
2109	8000	43	60	160	0	8263
2110	232	8069	46	102	0	8449
2111	8208	117	55	88	0	8468
2112	167	193	58	7865	0	8283
2113	150	8126	41	168	0	8485
2114	59	127	51	8207	0	8444
2115	57	211	56	7960	0	8284
2116	53	241	85	7974	0	8353
2117	46	61	7712	240	0	8059
2118	39	46	6685	151	0	6921
2119	43	6738	176	71	0	7028
2120	5880	88	116	48	0	6132
2121	85	5761	46	56	0	5948
2122	103	74	34	5653	0	5864
2123	29	92	5784	105	0	6010
2124	40	24	103	5641	0	5808
2125	34	37	114	5681	0	5866
2126	52	35	35	5845	0	5967
2127	5785	37	33	158	0	6013
2128	90	36	39	5869	0	6034
2129	99	25	5968	109	0	6201
2130	5931	34	88	120	0	6173
2131	6012	25	106	56	0	6199
2132	6143	34	31	58	0	6266
2133	6189	16	40	50	0	6295
2134	6168	28	43	45	0	6284
2135	154	6133	31	73	0	6391
2136	104	84	39	5996	0	6223
2137	46	6245	40	102	0	6433
2138	6190	79	32	115	0	6416
2139	6054	95	30	57	0	6236
2140	5763	24	28	46	0	5861
2141	137	5780	39	40	0	5996
2142	72	5674	33	39	0	5818
2143	33	5769	25	40	0	5867
2144	73	150	5562	26	0	5811
2145	65	286	53	4987	0	5391
2146	17	4168	30	32	0	4247
2147	8	3647	3	57	0	3715
2148	10	20	2	3667	0	3699
2149	5	19	1	3643	0	3668
2150	4	7	3922	35	0	3968
2151	3903	4	18	20	0	3945
2152	21	4	17	4139	0	4181
2153	21	5	5	4176	0	4207
2154	6	3	4165	41	0	4215
2155	9	5	4089	33	0	4136
2156	5	4247	34	14	0	4300
2157	4	21	25	4202	0	4252
2158	3	18	8	4257	0	4286
2159	8	7	4231	40	0	4286
2160	4006	4	22	27	0	4059
2161	4255	8	23	11	0	4297
2162	39	4	4305	7	0	4355
2163	4297	7	22	8	0	4334
2164	33	5	4344	10	0	4392
2165	4282	6	26	9	0	4323
2166	4319	5	25	11	0	4360
2167	48	4	4284	9	0	4345
2168	33	3	19	4198	0	4253
2169	12	5	34	4352	0	4403
2170	6	6	7	4664	0	4683
2171	4647	6	3	56	0	4712
2172	4688	6	6	37	0	4737
2173	58	8	4990	13	0	5069
2174	43	10	4965	8	0	5026
2175	5108	7	54	10	0	5179
2176	5168	8	36	14	0	5226
2177	70	11	5138	9	0	5228
2178	43	11	5158	12	0	5224
2179	9	1	50	4927	0	4987
2180	6	3	5083	33	0	5125
2181	5	6	36	5056	0	5103
2182	5301	3	33	39	0	5376
2183	33	5	5770	41	0	5849
2184	5704	2	44	13	0	5763
2185	50	7	6570	4	0	6631
2186	43	3	57	6425	0	6528
2187	17	6	48	6867	0	6938
2188	14	1	13	6825	0	6853
2189	10	7069	9	113	0	7201
2190	13	57	15	6893	0	6978
2191	16	56	8	7103	0	7183
2192	7069	9	8	114	0	7200
2193	66	3	7110	63	0	7242
2194	6953	1	60	17	0	7031
2195	77	4	7155	10	0	7246
2196	6446	5	79	23	0	6553
2197	72	7022	64	24	0	7182
2198	70	56	7005	11	0	7142
2199	33	57	7072	13	0	7175
2200	22	46	123	6571	0	6762
2201	11	5	67	6826	0	6909
2202	21	3	6929	112	0	7065
2203	20	1	6898	68	0	6987
2204	16	6	7180	21	0	7223
2205	7120	1	123	7	0	7251
2206	7174	2	84	11	0	7271
2207	7251	1	26	21	0	7299
2208	119	3	23	7130	0	7275
2209	75	3	22	7155	0	7255
2210	28	1	7336	121	0	7486
2211	14	3	68	7226	0	7311
2212	14	10	72	7254	0	7350
2213	7161	4	21	132	0	7318
2214	7036	5	20	81	0	7142
2215	7268	7	17	37	0	7329
2216	133	6	23	7168	0	7330
2217	79	11	22	7172	0	7284
2218	31	5	27	7255	0	7318
2219	7259	3	30	138	0	7430
2220	72	14	29	7037	0	7152
2221	76	7293	29	75	0	7473
2222	32	62	26	7109	0	7229
2223	23	7202	32	80	0	7337
2224	7195	63	40	71	0	7369
2225	6942	62	31	29	0	7064
2226	128	7151	40	26	0	7345
2227	89	7171	44	24	0	7328
2228	50	116	34	7081	0	7281
2229	33	64	6958	83	0	7138
2230	34	17	93	6761	0	6905
2231	27	8	6876	103	0	7014
2232	27	6762	93	109	0	6991
2233	23	62	89	6689	0	6863
2234	35	65	26	6875	0	7001
2235	28	11	7102	145	0	7286
2236	44	10	80	7073	0	7207
2237	48	5	7208	137	0	7398
2238	7030	3	99	96	0	7228
2239	7161	16	78	47	0	7302
2240	7326	8	30	49	0	7413
2241	146	15	29	6989	0	7179
2242	96	13	34	6792	0	6935
2243	34	9	7024	161	0	7228
2244	41	139	79	6592	0	6851
2245	31	6974	90	114	0	7209
2246	41	67	6994	88	0	7190
2247	44	57	6812	45	0	6958
2248	44	19	131	6560	0	6754
2249	50	19	6928	89	0	7086
2250	39	18	6715	93	0	6865
2251	6299	15	120	66	0	6500
2252	70	7352	77	67	0	7566
2253	7587	68	41	58	0	7754
2254	7544	60	38	61	0	7703
2255	7591	26	38	62	0	7717
2256	140	19	34	7585	0	7778
2257	101	21	43	7755	0	7920
2258	65	17	7914	144	0	8140
2259	48	26	88	7646	0	7808
2260	49	7981	79	114	0	8223
2261	7894	70	50	101	0	8115
2262	95	8005	53	48	0	8201
2263	73	7990	55	48	0	8166
2264	48	112	37	8014	0	8211
2265	41	64	8331	99	0	8535
2266	49	22	89	8318	0	8478
2267	32	22	8537	104	0	8695
2268	34	8278	104	112	0	8528
2269	8029	58	152	46	0	8285
2270	7988	47	38	55	0	8128
2271	8177	13	35	50	0	8275
2272	119	14	9008	49	0	9190
2273	79	10	8530	44	0	8663
2274	8591	13	103	51	0	8758
2275	8847	15	50	57	0	8969
2276	8944	15	23	63	0	9045
2277	116	8	25	8870	0	9019
2278	78	11	20	9004	0	9113
2279	9035	11	19	127	0	9192
2280	8817	15	29	90	0	8951
2281	106	16	9328	57	0	9507
2282	71	8	9030	51	0	9160
2283	8581	9	59	34	0	8683
2284	55	14	9119	30	0	9218
2285	8353	9	20	28	0	8410
2286	30	7	8719	32	0	8788
2287	11	4	14	8150	0	8179
2288	11	0	8962	15	0	8988
2289	4	1	7	9019	0	9031
2290	2	4	9	9147	0	9162
2291	3	9397	5	66	0	9471
2292	9577	4	5	52	0	9638
2293	17	6	9734	11	0	9768
2294	9181	2	8	4	0	9195
2295	10	10006	7	12	0	10035
2296	10650	7	2	21	0	10680
2297	18	6	2	10580	0	10606
2298	10	1	2	10581	0	10594
2299	2	11474	10	25	0	11511
2300	3	16	4	12047	0	12070
2301	4	14	4	12128	0	12150
2302	6	4	0	12275	0	12285
2303	12159	3	2	62	0	12226
2304	11571	5	5	36	0	11617
2305	50	3	11908	15	0	11976
2306	29	11974	23	25	0	12051
2307	6	23	25	12337	0	12391
2308	6	24	4	12613	0	12647
2309	16	4	12902	59	0	12981
2310	11	5	23	12600	0	12639
2311	12812	7	32	46	0	12897
2312	12664	3	10	44	0	12721
2313	13037	5	10	26	0	13078
2314	57	5	7	13731	0	13800
2315	15459	2	10	46	0	15517
2316	15269	3	11	58	0	15341
2317	15896	2	6	22	0	15926
2318	76	7	5	15845	0	15933
2319	53	3	3	15859	0	15918
2320	15	6	5	15848	0	15874
2321	12	5	6	15670	0	15693
2322	14	4	6	15826	0	15850
2323	23	6	15897	76	0	16002
2324	22	35	16026	53	0	16136
2325	12	16083	65	39	0	16199
2326	8	27	43	16298	0	16376
2327	7	43	9	16510	0	16569
2328	6	9	7	16700	0	16722
2329	24	4	16638	96	0	16762
2330	13	2	40	16409	0	16464
2331	21	4	16793	79	0	16897
2332	11	7	41	16759	0	16818
2333	24	4	19552	67	0	19647
2334	14	19543	44	120	0	19721
2335	16	36	48	19506	0	19606
2336	21	40	19468	63	0	19592
2337	17456	12	54	92	0	17614
2338	49	20316	55	39	0	20459
2339	58	42	9	20723	0	20832
2340	14	20778	10	84	0	20886
2341	18	67	15	20863	0	20963
2342	21313	55	13	78	0	21459
2343	69	11	19	20924	0	21023
2344	64	21396	12	80	0	21552
2345	21497	58	8	69	0	21632
2346	66	60	10	21573	0	21709
2347	66	14	3	22053	0	22136
2348	22477	9	9	172	0	22667
2349	98	14	17	24007	0	24136
2350	83	5	11	29591	0	29690
2351	43	13	30760	412	0	31228
2352	46	24	30125	206	0	30401
2353	21	15	478	29920	0	30434
2354	43	8	30472	349	0	30872
2355	40	6	30017	229	0	30292
2356	28213	16	556	102	0	28887
2357	361	5	30966	69	0	31401
2358	201	31057	373	70	0	31701
2359	56	329	227	30972	0	31584
2360	31553	204	58	359	0	32174
2361	31373	46	45	252	0	31716
2362	31832	27	29	82	0	31970
2363	561	32070	29	81	0	32741
2364	278	352	43	31073	0	31746
2365	76	219	21	31845	0	32161
2366	30779	78	47	580	0	31484
2367	30761	34	41	302	0	31138
2368	31342	31	42	105	0	31520
2369	617	21	31779	81	0	32498
2370	284	31315	373	113	0	32085
2371	84	34754	271	103	0	35212
2372	61	674	142	33197	0	34074
2373	59	343	92	34838	0	35332
2374	72	77	34940	788	0	35877
2375	33144	50	555	439	0	34188
2376	34913	26	394	142	0	35475
2377	801	44	151	34417	0	35413
2378	418	58	86	34544	0	35106
2379	148	52	70	35235	0	35505
2380	34800	42	69	889	0	35800
2381	579	51	34029	465	0	35124
2382	442	49	34306	215	0	35012
2383	164	62	787	33681	0	34694
2384	105	50	34213	574	0	34942
2385	32767	32	558	424	0	33781
2386	32947	56	379	153	0	33535
2387	34044	38	106	123	0	34311
2388	918	32920	80	132	0	34050
2389	33063	495	88	93	0	33739
2390	613	387	70	32270	0	33340
2391	412	153	82	32142	0	32789
2392	151	84	86	33168	0	33489
2393	116	63	32277	953	0	33409
2394	112	72	550	31614	0	32348
2395	128	32004	404	642	0	33178
2396	31047	482	150	439	0	32118
2397	539	31806	96	317	0	32758
2398	440	549	31402	213	0	32604
2399	170	30952	533	311	0	31966
2400	30034	533	449	172	0	31188
2401	534	30308	222	223	0	31287
2402	397	559	210	27393	0	28559
2403	196	30066	196	526	0	30984
2404	29824	533	176	415	0	30948
2405	29616	365	182	179	0	30342
2406	29067	145	254	183	0	29649
2407	978	106	29387	169	0	30640
2408	585	100	29029	151	0	29865
2409	310	100	29006	218	0	29634
2410	28495	94	864	210	0	29663
2411	708	97	453	28390	0	29648
2412	496	95	217	28973	0	29781
2413	242	92	28568	948	0	29850
2414	199	121	606	28346	0	29272
2415	26594	122	474	741	0	27931
2416	661	26835	225	535	0	28256
2417	27125	536	188	244	0	28093
2418	760	415	26530	332	0	28037
2419	26722	234	606	157	0	27719
2420	27030	209	429	162	0	27830
2421	27311	207	190	198	0	27906
2422	990	205	26502	226	0	27923
2423	717	149	570	26279	0	27715
2424	402	131	26319	663	0	27515
2425	391	114	652	26291	0	27448
2426	340	130	26314	682	0	27466
2427	310	135	639	25732	0	26816
2428	280	120	452	26079	0	26931
2429	25615	124	240	927	0	26906
2430	25217	135	223	534	0	26109
2431	25767	115	220	288	0	26390
2432	1000	91	254	24823	0	26168
2433	556	22538	220	640	0	23954
2434	304	23325	173	559	0	24361
2435	23110	791	165	332	0	24398
2436	727	457	22888	263	0	24335
2437	22899	200	562	210	0	23871
2438	790	338	22187	202	0	23517
2439	22115	133	658	209	0	23115
2440	22127	112	453	229	0	22921
2441	969	83	21806	234	0	23092
2442	21692	77	624	252	0	22645
2443	21581	94	496	251	0	22422
2444	21617	108	272	211	0	22208
2445	977	21362	212	285	0	22836
2446	596	685	246	20857	0	22384
2447	341	370	20742	755	0	22208
2448	264	174	21113	482	0	22033
2449	257	18632	732	328	0	19949
2450	119	12570	340	105	0	13134
2451	160	299	127	11073	0	11659
2452	10843	173	118	255	0	11389
2453	285	11090	56	246	0	11677
2454	297	214	68	10889	0	11468
2455	157	11336	54	242	0	11789
2456	11190	232	64	208	0	11694
2457	271	214	63	10962	0	11510
2458	223	83	10681	286	0	11273
2459	117	10285	230	230	0	10862
2460	95	10152	215	109	0	10571
2461	108	299	76	9220	0	9703
2462	126	9933	77	166	0	10302
2463	116	224	67	9733	0	10140
2464	9640	179	56	221	0	10096
2465	9676	95	71	171	0	10013
2466	9852	79	55	84	0	10070
2467	9969	84	68	54	0	10175
2468	403	67	9721	67	0	10258
2469	250	9403	188	65	0	9906
2470	133	9187	173	60	0	9553
2471	48	6859	37	24	0	6968
2472	33	6611	23	17	0	6684
2473	5958	88	70	10	0	6126
2474	5548	40	43	4	0	5635
2475	5837	16	4	5	0	5862
2476	5919	8	5	7	0	5939
2477	86	6	6016	5	0	6113
2478	6482	4	38	8	0	6532
2479	6534	5	42	9	0	6590
2480	6619	3	11	7	0	6640
2481	84	7	6	6518	0	6615
2482	60	5	0	6515	0	6580
2483	6478	3	3	74	0	6558
2484	47	2	7	6478	0	6534
2485	43	6375	2	51	0	6471
2486	15	38	5	6553	0	6611
2487	9	42	5	6540	0	6596
2488	6	6810	4	85	0	6905
2489	7	40	9	6733	0	6789
2490	11	44	5	6704	0	6764
2491	6678	17	5	85	0	6785
2492	55	8	6611	53	0	6727
2493	6600	8	40	18	0	6666
2494	58	9	6826	8	0	6901
2495	57	6	6676	4	0	6743
2496	28	6	6912	3	0	6949
2497	6582	5	88	6	0	6681
2498	53	5	7402	9	0	7469
2499	7430	6	55	8	0	7499
2500	7582	7	46	14	0	7649
2501	7636	5	12	9	0	7662
2502	98	7611	11	13	0	7733
2503	7620	46	1	16	0	7683
2504	59	7754	1	18	0	7832
2505	52	58	2	7736	0	7848
2506	12	53	5	7747	0	7817
2507	12	7816	3	87	0	7918
2508	15	7823	1	61	0	7900
2509	10	8089	7	35	0	8141
2510	8050	95	7	9	0	8161
2511	49	8232	9	21	0	8311
2512	8252	57	9	16	0	8334
2513	69	54	8185	13	0	8321
2514	7971	25	51	6	0	8053
2515	8188	8	51	14	0	8261
2516	114	6	8061	5	0	8186
2517	74	10	54	8120	0	8258
2518	36	8	8381	55	0	8480
2519	31	14	55	8173	0	8273
2520	26	12	54	8258	0	8350
2521	8290	18	20	99	0	8427
2522	8187	18	7	60	0	8272
2523	92	8280	9	33	0	8414
2524	8640	51	8	21	0	8720
2525	78	56	8758	20	0	8912
2526	8810	26	57	13	0	8906
2527	87	14	9589	22	0	9712
2528	80	13	9834	18	0	9945
2529	9973	14	127	13	0	10127
2530	10212	18	77	15	0	10322
2531	148	15	10724	14	0	10901
2532	98	18	84	10276	0	10476
2533	35	15	72	10723	0	10845
2534	38	16	10714	129	0	10897
2535	31	8	81	10469	0	10589
2536	26	10747	84	92	0	10949
2537	34	80	25	11102	0	11241
2538	32	72	19	11448	0	11571
2539	37	37	11437	131	0	11642
2540	10817	34	80	82	0	11013
2541	11257	23	73	41	0	11394
2542	11320	15	31	32	0	11398
2543	11342	9	16	20	0	11387
2544	183	11273	25	27	0	11508
2545	111	81	23	11103	0	11318
2546	61	78	11004	78	0	11221
2547	53	21	10945	77	0	11096
2548	45	21	132	10624	0	10822
2549	43	9	11094	100	0	11246
2550	10531	12	147	85	0	10775
2551	90	5	71	10814	0	10980
2552	85	20	18	10775	0	10898
2553	34	21	19	11142	0	11216
2554	10971	15	22	148	0	11156
2555	65	11128	18	117	0	11328
2556	11215	63	21	52	0	11351
2557	11106	64	22	36	0	11228
2558	146	11200	14	36	0	11396
2559	94	11348	31	39	0	11512
2560	11787	113	26	16	0	11942
2561	92	70	32	11561	0	11755
2562	80	22	41	11505	0	11648
2563	11865	15	44	128	0	12052
2564	100	9	12116	70	0	12295
2565	11946	12	98	32	0	12088
2566	12237	10	86	29	0	12362
2567	168	12542	28	22	0	12760
2568	13495	80	35	24	0	13634
2569	13564	79	13	42	0	13698
2570	190	15622	16	45	0	15873
2571	84	15652	11	35	0	15782
2572	20	249	9	15357	0	15635
2573	15512	102	15	139	0	15768
2574	146	16202	6	114	0	16468
2575	101	158	13	16368	0	16640
2576	16549	107	7	174	0	16837
2577	193	19	16769	117	0	17098
2578	133	19	159	16483	0	16794
2579	40	13	16767	189	0	17009
2580	15757	17	197	123	0	16094
2581	16578	10	131	37	0	16756
2582	284	4	16675	36	0	16999
2583	143	16655	181	54	0	17033
2584	41	169	121	16573	0	16904
2585	41	113	16999	175	0	17328
2586	33	23	184	16462	0	16702
2587	27	66	126	17228	0	17447
2588	38	18	17106	278	0	17440
2589	15854	25	203	176	0	16258
2590	16780	19	137	199	0	17135
2591	315	21	17392	40	0	17768
2592	148	17374	182	73	0	17777
2593	63	196	130	16635	0	17024
2594	41	17069	30	173	0	17313
2595	29	17208	30	161	0	17428
2596	17070	288	22	50	0	17430
2597	198	139	26	16999	0	17362
2598	157	47	30	16641	0	16875
2599	70	34	16856	302	0	17262
2600	64	31	16683	165	0	16943
2601	58	41	302	16180	0	16581
2602	49	35	148	16885	0	17117
2603	50	36	16918	332	0	17336
2604	67	47	16876	176	0	17166
2605	31	45	317	16677	0	17070
2606	16842	39	163	237	0	17281
2607	219	16937	56	207	0	17419
2608	17044	202	51	85	0	17382
2609	258	17376	43	71	0	17748
2610	186	17518	54	81	0	17839
2611	17315	334	47	59	0	17755
2612	252	182	17413	68	0	17915
2613	191	62	252	16963	0	17468
2614	84	53	166	17197	0	17500
2615	78	42	68	18335	0	18523
2616	92	53	18460	380	0	18985
2617	87	57	236	18251	0	18631
2618	18289	39	215	285	0	18828
2619	268	65	96	18286	0	18715
2620	207	60	55	19448	0	19770
2621	19475	47	75	469	0	20066
2622	19074	73	74	264	0	19485
2623	463	19581	59	149	0	20252
2624	276	276	19570	87	0	20209
2625	143	226	19321	80	0	19770
2626	134	82	19546	85	0	19847
2627	86	18579	443	94	0	19202
2628	152	284	317	17533	0	18286
2629	55	211	88	18038	0	18392
2630	17851	68	92	442	0	18453
2631	286	59	86	17637	0	18068
2632	239	52	17403	314	0	18008
2633	91	51	296	17338	0	17776
2634	82	58	251	17375	0	17766
2635	82	59	17310	475	0	17926
2636	60	16938	304	313	0	17615
2637	72	279	246	15366	0	15963
2638	72	16947	101	300	0	17420
2639	103	263	16545	241	0	17152
2640	16199	213	305	118	0	16835
2641	16218	80	225	122	0	16645
2642	16369	73	141	108	0	16691
2643	459	87	101	16003	0	16650
2644	247	16498	101	308	0	17154
2645	16309	300	105	244	0	16958
2646	16369	240	103	124	0	16836
2647	16437	76	94	147	0	16754
2648	456	55	16420	153	0	17084
2649	15938	63	303	145	0	16449
2650	309	16307	252	140	0	17008
2651	16146	271	117	137	0	16671
2652	307	16487	114	149	0	17057
2653	16330	280	128	130	0	16868
2654	309	226	16214	124	0	16873
2655	15722	84	313	125	0	16244
2656	15873	93	241	155	0	16362
2657	15709	75	130	124	0	16038
2658	16116	84	104	110	0	16414
2659	491	71	15788	128	0	16478
2660	279	88	299	15475	0	16141
2661	15384	92	269	315	0	16060
2662	299	15465	113	309	0	16186
2663	252	257	98	15411	0	16018
2664	109	226	15114	351	0	15800
2665	105	84	278	15233	0	15700
2666	126	73	15206	344	0	15749
2667	94	14644	304	312	0	15354
2668	86	13648	221	136	0	14091
2669	107	13738	88	112	0	14045
2670	109	405	92	11185	0	11791
2671	69	153	49	11145	0	11416
2672	71	47	11102	292	0	11512
2673	61	10718	156	160	0	11095
2674	9543	231	116	49	0	9939
2675	143	9419	41	37	0	9640
2676	124	9253	41	32	0	9450
2677	287	198	44	8586	0	9115
2678	8515	103	28	115	0	8761
2679	8434	32	29	104	0	8599
2680	204	28	25	8387	0	8644
2681	8523	22	32	124	0	8701
2682	142	18	26	8542	0	8728
2683	109	23	8411	130	0	8673
2684	8229	23	116	124	0	8492
2685	140	22	107	8081	0	8350
2686	121	26	8074	112	0	8333
2687	50	39	7944	111	0	8144
2688	44	28	183	7944	0	8199
2689	7975	34	105	132	0	8246
2690	7946	31	42	107	0	8126
2691	197	7825	26	32	0	8080
2692	7997	114	32	39	0	8182
2693	7903	105	40	36	0	8084
2694	8102	33	34	42	0	8211
2695	201	8181	39	44	0	8465
2696	8379	122	34	31	0	8566
2697	8301	114	20	34	0	8469
2698	209	169	18	8083	0	8479
2699	7821	33	32	114	0	8000
2700	132	7724	22	119	0	7997
2701	122	7877	25	45	0	8069
2702	62	178	22	7692	0	7954
2703	67	138	23	7632	0	7860
2704	47	7855	31	171	0	8104
2705	7810	112	35	90	0	8047
2706	130	7530	24	48	0	7732
2707	7370	101	20	35	0	7526
2708	133	7510	22	30	0	7695
2709	110	107	38	7100	0	7355
2710	65	7641	25	104	0	7835
2711	7597	158	26	93	0	7874
2712	7587	98	37	34	0	7756
2713	7689	42	27	39	0	7797
2714	205	33	7510	37	0	7785
2715	111	26	6984	28	0	7149
2716	44	6693	131	35	0	6903
2717	49	88	6682	36	0	6855
2718	46	143	6302	22	0	6513
2719	26	128	93	5445	0	5692
2720	19	11	5353	59	0	5442
2721	16	5413	46	58	0	5533
2722	5284	49	37	12	0	5382
2723	54	5234	8	16	0	5312
2724	38	5229	8	15	0	5290
2725	5288	73	5	15	0	5381
2726	5166	39	6	9	0	5220
2727	75	5539	7	20	0	5641
2728	5593	50	4	15	0	5662
2729	5478	37	5	12	0	5532
2730	5578	17	6	16	0	5617
2731	90	16	5411	12	0	5529
2732	48	15	5464	13	0	5540
2733	24	9	67	5383	0	5483
2734	20	17	38	5446	0	5521
2735	5518	11	14	82	0	5625
2736	59	5498	15	43	0	5615
2737	47	52	15	5507	0	5621
2738	22	38	16	5363	0	5439
2739	23	17	17	5525	0	5582
2740	18	17	15	5575	0	5625
2741	20	15	5610	82	0	5727
2742	20	21	5638	41	0	5720
2743	22	15	83	5668	0	5788
2744	29	12	5789	50	0	5880
2745	5591	18	64	52	0	5725
2746	65	16	49	5748	0	5878
2747	48	18	5700	56	0	5822
2748	5273	12	55	39	0	5379
2749	58	5611	39	16	0	5724
2750	5546	54	13	6	0	5619
2751	64	5860	10	12	0	5946
2752	44	58	9	5594	0	5705
2753	31	42	5768	51	0	5892
2754	30	12	48	5568	0	5658
2755	21	14	5674	62	0	5771
2756	5445	9	53	33	0	5540
2757	54	8	38	5692	0	5792
2758	5817	6	19	53	0	5895
2759	62	10	5855	51	0	5978
2760	6275	7	57	22	0	6361
2761	7196	7	42	13	0	7258
2762	116	11	7238	18	0	7383
2763	66	4	78	7043	0	7191
2764	27	7	7151	84	0	7269
2765	6	7204	85	65	0	7360
2766	7129	65	60	18	0	7272
2767	7124	50	25	6	0	7205
2768	122	16	7137	29	0	7304
2769	64	7	7282	7	0	7360
2770	20	9	120	7001	0	7150
2771	11	3	59	7272	0	7345
2772	7326	8	21	114	0	7469
2773	71	7439	11	70	0	7591
2774	7794	71	13	20	0	7898
2775	7769	52	8	15	0	7844
2776	128	17	7685	13	0	7843
2777	7515	8	71	16	0	7610
2778	97	3	7783	19	0	7902
2779	68	7	82	7843	0	8000
2780	29	3	8173	82	0	8287
2781	17	5	91	8009	0	8122
2782	22	4	8150	95	0	8271
2783	8003	5	87	62	0	8157
2784	8132	6	67	21	0	8226
2785	133	5	26	8137	0	8301
2786	8363	6	16	80	0	8465
2787	98	7	25	8362	0	8492
2788	63	8581	23	165	0	8832
2789	8747	66	21	73	0	8907
2790	72	8859	28	35	0	8994
2791	74	82	13	8823	0	8992
2792	44	53	18	8611	0	8726
2793	35	19	19	8599	0	8672
2794	33	7	29	8592	0	8661
2795	24	9	8283	191	0	8507
2796	7594	5	79	80	0	7758
2797	8193	5	63	31	0	8292
2798	129	8199	28	23	0	8379
2799	77	78	19	8074	0	8248
2800	47	47	18	8289	0	8401
2801	27	17	8217	130	0	8391
2802	7860	3	85	82	0	8030
2803	90	8	72	8082	0	8252
2804	75	6	8076	88	0	8245
2805	7941	10	84	67	0	8102
2806	8153	10	63	32	0	8258
2807	8222	13	34	33	0	8302
2808	156	7	8129	21	0	8313
2809	75	6	7727	30	0	7838
2810	7597	9	113	21	0	7740
2811	65	6	51	7712	0	7834
2812	63	67	19	7692	0	7841
2813	28	8	7770	95	0	7901
2814	7413	12	57	58	0	7540
2815	68	10	45	7731	0	7854
2816	7945	10	18	63	0	8036
2817	7911	7	19	60	0	7997
2818	8005	8	16	50	0	8079
2819	111	5	8306	29	0	8451
2820	57	6	70	8173	0	8306
2821	8352	8	60	68	0	8488
2822	82	8629	17	93	0	8821
2823	78	65	19	8851	0	9013
2824	40	49	20	8894	0	9003
2825	8750	13	22	121	0	8906
2826	8662	9	28	78	0	8777
2827	136	4	23	8573	0	8736
2828	87	8	8701	88	0	8884
2829	8637	12	87	63	0	8799
2830	91	16	9080	27	0	9214
2831	9001	8	84	33	0	9126
2832	8963	9	67	23	0	9062
2833	146	6	9366	17	0	9535
2834	86	18	86	9554	0	9744
2835	50	3	10061	97	0	10211
2836	33	10611	97	92	0	10833
2837	34	79	72	10499	0	10684
2838	35	11186	30	95	0	11346
2839	39	165	22	11163	0	11389
2840	42	67	11634	115	0	11858
2841	30	11497	91	98	0	11716
2842	40	11712	75	46	0	11873
2843	34	155	35	11919	0	12143
2844	12122	83	20	109	0	12334
2845	105	22	28	13019	0	13174
2846	13156	7	15	161	0	13339
2847	157	13487	25	125	0	13794
2848	15222	146	14	48	0	15430
2849	205	117	15946	30	0	16298
2850	148	27	170	15719	0	16064
2851	59	15	127	15691	0	15892
2852	52	14	15721	322	0	16109
2853	14838	20	179	177	0	15214
2854	15489	15	137	53	0	15694
2855	299	15725	38	41	0	16103
2856	163	174	31	14702	0	15070
2857	56	15835	15	187	0	16093
2858	58	185	15684	131	0	16058
2859	40	142	15683	57	0	15922
2860	34	458	271	14701	0	15464
2861	14479	17	125	143	0	14764
2862	139	14530	22	131	0	14822
2863	14669	143	13	37	0	14862
2864	179	117	14443	17	0	14756
2865	14621	29	149	11	0	14810
2866	14993	23	112	20	0	15148
2867	278	20	14984	23	0	15305
2868	143	15	167	14744	0	15069
2869	14807	19	128	169	0	15123
2870	14673	15	35	154	0	14877
2871	14826	17	31	38	0	14912
2872	306	21	19	14613	0	14959
2873	180	23	14528	160	0	14891
2874	14165	26	162	148	0	14501
2875	196	21	14690	43	0	14950
2876	153	28	186	14220	0	14587
2877	65	34	155	13867	0	14121
2878	43	14544	48	308	0	14943
2879	66	164	14407	179	0	14816
2880	51	14216	176	69	0	14512
2881	53	14365	151	50	0	14619
2882	38	315	57	14193	0	14603
2883	67	153	14113	197	0	14530
2884	56	49	187	14102	0	14394
2885	70	37	14324	211	0	14642
2886	57	42	201	13968	0	14268
2887	58	45	159	13992	0	14254
2888	71	85	13495	316	0	13967
2889	71	44	211	13379	0	13705
2890	72	34	13550	241	0	13897
2891	79	35	13395	207	0	13716
2892	71	13428	327	102	0	13928
2893	13440	175	204	73	0	13892
2894	248	157	13478	80	0	13963
2895	13104	64	226	80	0	13474
2896	267	50	185	13433	0	13935
2897	226	60	13586	213	0	14085
2898	98	13507	236	239	0	14080
2899	83	200	223	13507	0	14013
2900	83	183	13616	248	0	14130
2901	106	80	234	12890	0	13310
2902	82	13532	217	215	0	14046
2903	13618	203	89	200	0	14110
2904	257	181	90	13733	0	14261
2905	13639	88	82	242	0	14051
2906	13629	71	84	195	0	13979
2907	13825	72	108	102	0	14107
2908	13926	58	98	100	0	14182
2909	13668	53	97	84	0	13902
2910	410	13389	101	95	0	13995
2911	253	204	86	13356	0	13899
2912	143	183	80	13328	0	13734
2913	143	60	89	13441	0	13733
2914	153	50	13157	359	0	13719
2915	129	13054	246	269	0	13698
2916	13672	202	225	132	0	14231
2917	13555	180	139	113	0	13987
2918	387	13595	110	128	0	14220
2919	240	13606	126	112	0	14084
2920	13482	345	109	119	0	14055
2921	274	232	13187	107	0	13800
2922	250	108	270	12767	0	13395
2923	12781	75	231	267	0	13354
2924	285	80	148	12515	0	13028
2925	194	12723	111	278	0	13306
2926	133	233	108	12884	0	13358
2927	117	184	12908	317	0	13526
2928	12203	89	348	320	0	12960
2929	12605	80	234	137	0	13056
2930	422	64	110	12209	0	12805
2931	272	48	123	12559	0	13002
2932	12306	59	109	403	0	12877
2933	281	12077	111	255	0	12724
2934	229	198	121	11649	0	12197
2935	145	164	106	11680	0	12095
2936	10817	63	71	370	0	11321
2937	235	10636	92	234	0	11197
2938	10232	276	74	125	0	10707
2939	264	10325	71	110	0	10770
2940	176	10056	103	97	0	10432
2941	9778	370	90	90	0	10328
2942	217	10145	55	108	0	10525
2943	175	307	127	9530	0	10139
2944	93	155	9214	247	0	9709
2945	64	77	8048	171	0	8360
2946	79	55	7975	100	0	8209
2947	56	7584	213	74	0	7927
2948	5763	96	294	41	0	6194
2949	81	68	48	5278	0	5475
2950	77	31	26	5421	0	5555
2951	38	18	5375	136	0	5567
2952	5237	28	95	78	0	5438
2953	86	31	68	5476	0	5661
2954	86	17	39	5526	0	5668
2955	49	16	33	5505	0	5603
2956	5303	18	21	153	0	5495
2957	108	17	5202	98	0	5425
2958	5088	17	91	48	0	5244
2959	104	36	70	5138	0	5348
2960	85	26	5017	108	0	5236
2961	4885	21	91	89	0	5086
2962	95	29	5129	54	0	5307
2963	89	67	90	4948	0	5194
2964	61	27	5151	90	0	5329
2965	32	17	4618	66	0	4733
2966	4290	15	198	36	0	4539
2967	77	21	4434	16	0	4548
2968	56	18	74	4359	0	4507
2969	4467	18	47	77	0	4609
2970	65	18	30	4515	0	4628
2971	59	17	4495	86	0	4657
2972	43	14	4702	65	0	4824
2973	23	4721	101	39	0	4884
2974	16	82	52	4526	0	4676
2975	4445	41	24	64	0	4574
2976	60	4478	16	56	0	4610
2977	4463	59	18	32	0	4572
2978	76	35	16	4358	0	4485
2979	4397	21	17	61	0	4496
2980	73	4398	17	62	0	4550
2981	49	58	19	4372	0	4498
2982	4358	41	25	64	0	4488
2983	68	4399	21	49	0	4537
2984	52	64	15	4375	0	4506
2985	38	42	20	4311	0	4411
2986	4351	25	16	98	0	4490
2987	80	12	17	4329	0	4438
2988	58	12	27	4321	0	4418
2989	33	18	20	4445	0	4516
2990	29	7	4327	109	0	4472
2991	4108	10	83	70	0	4271
2992	79	10	52	4795	0	4936
2993	63	10	5082	91	0	5246
2994	5017	13	100	68	0	5198
2995	106	14	5324	41	0	5485
2996	68	113	107	5036	0	5324
2997	33	5172	68	91	0	5364
2998	27	75	34	5209	0	5345
2999	23	54	5266	107	0	5450
3000	28	23	5535	75	0	5661
3001	29	17	123	5565	0	5734
3002	29	19	5615	89	0	5752
3003	5376	21	99	71	0	5567
3004	96	12	5376	43	0	5527
3005	62	13	101	5150	0	5326
3006	40	19	69	5218	0	5346
3007	21	22	37	5190	0	5270
3008	5323	16	25	142	0	5506
3009	5307	16	25	85	0	5433
3010	5505	25	18	49	0	5597
3011	142	9	22	5440	0	5613
3012	79	12	23	5544	0	5658
3013	46	13	5410	141	0	5610
3014	30	10	5374	91	0	5505
3015	17	5471	128	71	0	5687
3016	104	85	48	4239	0	4476
3017	12	32	19	4244	0	4307
3018	11	4415	12	80	0	4518
3019	4425	48	8	48	0	4529
3020	50	4431	15	74	0	4570
3021	4476	52	33	15	0	4576
3022	66	35	12	4433	0	4546
3023	4426	13	10	69	0	4518
3024	61	6	10	4467	0	4544
3025	37	4	4417	68	0	4526
3026	20	2	64	4423	0	4509
3027	4325	3	51	64	0	4443
3028	59	4	17	4381	0	4461
3029	42	2	10	4395	0	4449
3030	24	3	4404	94	0	4525
3031	14	4	54	4385	0	4457
3032	13	5	44	4300	0	4362
3033	8	4341	17	101	0	4467
3034	11	51	10	4473	0	4545
3035	16	42	10	4460	0	4528
3036	14	15	6	4558	0	4593
3037	12	29	5	4466	0	4512
3038	9	6	8	4626	0	4649
3039	4328	4	7	103	0	4442
3040	52	4250	7	55	0	4364
3041	32	4121	6	20	0	4179
3042	15	4101	3	10	0	4129
3043	9	81	4	3895	0	3989
3044	11	3914	9	59	0	3993
3045	11	3962	14	37	0	4024
3046	3931	69	15	18	0	4033
3047	57	36	3911	13	0	4017
3048	3708	14	53	20	0	3795
3049	53	11	42	3756	0	3862
3050	38	9	3736	70	0	3853
3051	3629	8	70	49	0	3756
3052	52	4	3674	43	0	3773
3053	42	3	3574	23	0	3642
3054	3601	6	102	25	0	3734
3055	62	10	54	3719	0	3845
3056	38	9	3751	73	0	3871
3057	3699	7	58	63	0	3827
3058	3787	8	57	48	0	3900
3059	95	3	3805	50	0	3953
3060	3805	8	65	34	0	3912
3061	3880	8	41	37	0	3966
3062	102	8	3749	32	0	3891
3063	3763	11	65	35	0	3874
3064	3798	8	46	40	0	3892
3065	86	17	3751	39	0	3893
3066	56	16	4007	32	0	4111
3067	28	18	97	4071	0	4214
3068	29	14	4205	81	0	4329
3069	4063	25	58	68	0	4214
3070	72	17	49	4044	0	4182
3071	65	19	23	4141	0	4248
3072	32	24	3913	108	0	4077
3073	39	16	69	3971	0	4095
3074	31	24	3964	83	0	4102
3075	3877	13	77	73	0	4040
3076	3898	24	58	49	0	4029
3077	113	12	3884	33	0	4042
3078	3867	24	60	42	0	3993
3079	3944	16	57	34	0	4051
3080	114	7	3952	54	0	4127
3081	4095	18	70	37	0	4220
3082	4123	9	59	47	0	4238
3083	110	15	4071	43	0	4239
3084	4058	17	78	35	0	4188
3085	83	17	4117	57	0	4274
3086	57	13	80	4062	0	4212
3087	29	20	48	4076	0	4173
3088	23	5	37	4208	0	4273
3089	18	11	4072	148	0	4249
3090	3778	8	66	94	0	3946
3091	71	15	4039	59	0	4184
3092	44	3314	48	44	0	3450
3093	20	3077	41	26	0	3164
3094	2807	49	60	17	0	2933
3095	39	28	19	2821	0	2907
3096	37	2852	13	39	0	2941
3097	2811	29	16	33	0	2889
3098	2750	26	15	16	0	2807
3099	67	2765	13	20	0	2865
3100	46	29	21	2368	0	2464
3101	25	2527	13	33	0	2598
3102	2525	32	12	32	0	2601
3103	2528	28	21	18	0	2595
3104	70	8	13	2522	0	2613
3105	2562	5	11	41	0	2619
3106	48	5	23	2626	0	2702
3107	51	6	2604	41	0	2702
3108	2410	6	47	37	0	2500
3109	44	9	2439	20	0	2512
3110	43	8	39	2308	0	2398
3111	2299	8	41	61	0	2409
3112	49	4	22	2345	0	2420
3113	49	5	2329	39	0	2422
3114	22	7	2356	36	0	2421
3115	18	33	59	2223	0	2333
3116	2237	5	75	42	0	2359
3117	44	2249	26	25	0	2344
3118	34	21	13	2194	0	2262
3119	23	21	2184	26	0	2254
3120	2079	7	76	24	0	2186
3121	2142	3	30	11	0	2186
3122	49	10	2053	11	0	2123
3123	1978	4	26	9	0	2017
3124	35	6	22	1969	0	2032
3125	32	4	1977	26	0	2039
3126	1970	2	25	18	0	2015
3127	34	6	26	1953	0	2019
3128	23	4	15	1908	0	1950
3129	1928	3	10	35	0	1976
3130	31	1948	12	22	0	2013
3131	26	2125	8	15	0	2174
3132	2169	27	13	14	0	2223
3133	1976	17	28	7	0	2028
3134	39	6	2070	7	0	2122
3135	18	4	2031	7	0	2060
3136	11	3	31	1977	0	2022
3137	2136	33	14	22	0	2205
3138	2072	5	10	16	0	2103
3139	2122	1	7	6	0	2136
3140	32	2084	8	11	0	2135
3141	16	2091	8	11	0	2126
3142	17	21	8	2133	0	2179
3143	13	14	6	2098	0	2131
3144	12	4	10	2195	0	2221
3145	12	8	2211	27	0	2258
3146	15	6	2094	24	0	2139
3147	2156	3	32	12	0	2203
3148	2264	6	18	8	0	2296
3149	35	4	10	2254	0	2303
3150	25	3	11	2230	0	2269
3151	17	6	10	2306	0	2339
3152	18	3	2289	33	0	2343
3153	14	4	2440	23	0	2481
3154	6	2	31	2365	0	2404
3155	8	0	2364	21	0	2393
3156	6	2281	22	22	0	2331
3157	14	2309	18	9	0	2350
3158	2255	31	9	3	0	2298
3159	18	2244	4	10	0	2276
3160	18	20	7	2213	0	2258
3161	9	18	6	2225	0	2258
3162	9	2517	6	34	0	2566
3163	10	19	8	2583	0	2620
3164	13	19	2517	29	0	2578
3165	10	2502	19	22	0	2553
3166	5	35	22	2294	0	2356
3167	6	20	2234	15	0	2275
3168	3	2155	16	20	0	2194
3169	9	34	13	2070	0	2126
3170	5	2151	4	10	0	2170
3171	1	18	1	2138	0	2158
3172	4	17	4	2060	0	2085
3173	8	2108	1	20	0	2137
3174	2080	12	4	13	0	2109
3175	1994	14	10	3	0	2021
3176	29	2071	3	8	0	2111
3177	16	2131	4	6	0	2157
3178	9	28	4	2126	0	2167
3179	10	15	2117	18	0	2160
3180	1935	7	13	21	0	1976
3181	1889	6	13	10	0	1918
3182	29	3	1907	6	0	1945
3183	1871	4	15	8	0	1898
3184	1959	5	15	5	0	1984
3185	31	0	1893	8	0	1932
3186	1846	3	18	7	0	1874
3187	20	4	1940	5	0	1969
3188	17	1935	17	6	0	1975
3189	1940	13	19	6	0	1978
3190	1932	14	7	10	0	1963
3191	30	6	1922	8	0	1966
3192	1927	6	16	6	0	1955
3193	1923	11	16	5	0	1955
3194	34	5	1958	6	0	2003
3195	1999	10	17	5	0	2031
3196	2041	6	23	7	0	2077
3197	30	4	2031	10	0	2075
3198	2034	14	15	11	0	2074
3199	24	7	17	1953	0	2001
3200	19	5	12	1951	0	1987
3201	10	10	1952	32	0	2004
3202	8	9	1927	27	0	1971
3203	9	13	29	1921	0	1972
3204	3	5	22	1943	0	1973
3205	2027	6	9	33	0	2075
3206	22	10	1976	24	0	2032
3207	2050	9	24	14	0	2097
3208	26	2	21	2135	0	2184
3209	20	14	2192	21	0	2247
3210	2314	13	18	19	0	2364
3211	22	3	19	2461	0	2505
3212	23	6	2492	28	0	2549
3213	2428	9	24	29	0	2490
3214	31	4	24	2414	0	2473
3215	2488	7	14	23	0	2532
3216	35	2	2534	29	0	2600
3217	27	4	27	2360	0	2418
3218	10	2568	25	24	0	2627
3219	2545	28	10	19	0	2602
3220	2420	19	6	9	0	2454
3221	39	2493	6	7	0	2545
3222	2547	27	7	8	0	2589
3223	2548	20	4	13	0	2585
3224	2602	11	15	4	0	2632
3225	49	2585	4	11	0	2649
3226	34	24	8	2589	0	2655
3227	15	25	2594	24	0	2658
3228	21	8	25	2556	0	2610
3229	17	1	27	2558	0	2603
3230	13	9	2572	43	0	2637
3231	19	5	2536	24	0	2584
3232	12	0	43	2305	0	2360
3233	10	2596	30	20	0	2656
3234	2580	25	14	20	0	2639
3235	2510	19	6	16	0	2551
3236	41	2638	12	10	0	2701
3237	2656	17	10	11	0	2694
3238	2640	19	5	7	0	2671
3239	40	13	2656	8	0	2717
3240	2615	2	21	5	0	2643
3241	39	2716	18	12	0	2785
3242	26	22	2714	5	0	2767
3243	22	24	2692	2	0	2740
3244	15	2688	38	14	0	2755
3245	2660	22	25	9	0	2716
3246	34	25	2674	11	0	2744
3247	26	5	28	2660	0	2719
3248	15	3	2670	25	0	2713
3249	2526	3	33	29	0	2591
3250	38	3	3206	17	0	3264
3251	23	6	3141	8	0	3178
3252	3092	4	36	6	0	3138
3253	30	3141	19	14	0	3204
3254	3252	32	13	7	0	3304
3255	3428	16	9	3	0	3456
3256	49	10	7	3446	0	3512
3257	30	3943	12	27	0	4012
3258	4106	28	5	17	0	4156
3259	34	19	4114	17	0	4184
3260	4007	7	37	6	0	4057
3261	38	4241	24	11	0	4314
3262	3905	22	6	4	0	3937
3263	3860	10	12	3	0	3885
3264	28	3915	10	6	0	3959
3265	16	21	5	3914	0	3956
3266	4023	13	8	17	0	4061
3267	22	4005	12	19	0	4058
3268	21	16	8	4009	0	4054
3269	4043	20	10	19	0	4092
3270	32	5	5	4529	0	4571
3271	21	4	10	4480	0	4515
3272	10	4614	9	48	0	4681
3273	4627	27	6	39	0	4699
3274	4609	32	8	14	0	4663
3275	4709	4	7	7	0	4727
3276	56	4869	9	10	0	4944
3277	4934	28	7	12	0	4981
3278	4891	31	9	12	0	4943
3279	59	6	6	4865	0	4936
3280	34	5	10	4999	0	5048
3281	18	7	5007	51	0	5083
3282	14	9	33	4899	0	4955
3283	20	8	28	4901	0	4957
3284	19	16	4992	53	0	5080
3285	4543	11	37	37	0	4628
3286	46	4	4987	13	0	5050
3287	43	13	5172	7	0	5235
3288	20	7	54	5071	0	5152
3289	13	10	40	5116	0	5179
3290	14	5350	9	51	0	5424
3291	5385	32	5	36	0	5458
3292	5217	38	6	10	0	5271
3293	60	5523	10	9	0	5602
3294	41	6041	15	12	0	6109
3295	25	69	7	6031	0	6132
3296	13	6412	7	50	0	6482
3297	6490	51	11	43	0	6595
3298	6459	45	8	16	0	6528
3299	96	13	9	6356	0	6474
3300	66	6	5	6492	0	6569
3301	6508	8	10	92	0	6618
3302	58	11	6431	54	0	6554
3303	6409	6	46	19	0	6480
3304	64	13	6469	10	0	6556
3305	6380	8	49	12	0	6449
3306	63	7	50	6392	0	6512
3307	157	9	6323	47	0	6536
3308	23	5	6324	54	0	6406
3309	6099	50	87	14	0	6250
3310	6131	8	48	8	0	6195
3311	76	6325	9	14	0	6424
3312	48	33	7	6457	0	6545
3313	11	48	5	6631	0	6695
3314	6646	8	6	87	0	6747
3315	51	6604	4	62	0	6721
3316	6732	42	6	16	0	6796
3317	56	6662	2	15	0	6735
3318	47	6722	2	12	0	6783
3319	6848	92	5	13	0	6958
3320	61	61	6750	9	0	6881
3321	57	11	51	6702	0	6821
3322	22	10	84	6758	0	6874
3323	17	8	6760	103	0	6888
3324	12	13	49	6594	0	6668
3325	24	14	58	6307	0	6403
3326	13	6811	13	95	0	6932
3327	6841	52	11	59	0	6963
3328	68	47	6915	17	0	7047
3329	6678	10	57	13	0	6758
3330	62	6989	51	19	0	7121
3331	60	54	15	6986	0	7115
3332	7324	52	13	70	0	7459
3333	68	20	11	7196	0	7295
3334	61	12	12	7221	0	7306
3335	37	9	7210	118	0	7374
3336	6708	8	65	79	0	6860
3337	7059	11	58	34	0	7162
3338	132	12	7133	17	0	7294
3339	80	13	64	7095	0	7252
3340	48	10	7201	71	0	7330
3341	6990	12	66	66	0	7134
3342	7242	15	58	31	0	7346
3343	113	9	15	7199	0	7336
3344	7291	8	16	70	0	7385
3345	80	13	7782	72	0	7947
3346	74	15	54	7761	0	7904
3347	25	18	62	7751	0	7856
3348	21	17	17	7964	0	8019
3349	20	14	13	7950	0	7997
3350	7390	9	14	125	0	7538
3351	71	11	7426	81	0	7589
3352	66	6	58	7477	0	7607
3353	39	11	7483	80	0	7613
3354	23	9	7425	71	0	7528
3355	26	13	102	7297	0	7438
3356	17	10	73	7281	0	7381
3357	6981	11	28	112	0	7132
3358	78	14	7	6887	0	6986
3359	66	23	22	6876	0	6987
3360	37	9	17	7074	0	7137
3361	6951	9	15	128	0	7103
3362	6836	10	21	81	0	6948
3363	6869	13	11	40	0	6933
3364	6944	12	10	31	0	6997
3365	122	7319	8	40	0	7489
3366	83	136	11	7020	0	7250
3367	32	65	17	7226	0	7340
3368	7394	18	18	135	0	7565
3369	84	7775	18	92	0	7969
3370	65	72	8	7788	0	7933
3371	32	51	8507	100	0	8690
3372	9101	12	102	83	0	9298
3373	158	9618	83	35	0	9894
3374	10091	144	35	25	0	10295
3375	10307	102	20	21	0	10450
3376	302	28	17	10123	0	10470
3377	150	12	10102	201	0	10465
3378	49	9	183	10356	0	10597
3379	10509	7	117	221	0	10854
3380	198	4	30	10595	0	10827
3381	10636	6	12	219	0	10873
3382	210	10460	14	156	0	10840
3383	10975	176	12	62	0	11225
3384	228	126	15	10610	0	10979
3385	152	34	18	11452	0	11656
3386	11595	12	9	322	0	11938
3387	11317	11	21	173	0	11522
3388	11520	8	8	65	0	11601
3389	11386	9	15	37	0	11447
3390	11387	12	14	37	0	11450
3391	378	15	9	11116	0	11518
3392	192	10	10992	222	0	11416
3393	72	10877	188	175	0	11312
3394	10416	185	140	64	0	10805
3395	220	121	10286	29	0	10656
3396	10164	36	192	27	0	10419
3397	239	10199	119	27	0	10584
3398	10363	178	34	35	0	10610
3399	233	117	21	10111	0	10482
3400	157	37	17	10360	0	10571
3401	70	23	10337	312	0	10742
3402	55	10	185	10335	0	10585
3403	50	11	10588	237	0	10886
3404	50	11	10616	162	0	10839
3405	10498	18	297	60	0	10873
3406	10869	15	142	39	0	11065
3407	351	27	10570	43	0	10991
3408	10504	11	193	56	0	10764
3409	10680	23	125	49	0	10877
3410	351	20	10523	60	0	10954
3411	203	10467	191	54	0	10915
3412	174	219	118	10770	0	11281
3413	11062	125	41	202	0	11430
3414	11420	35	29	156	0	11640
3415	11604	32	36	58	0	11730
3416	11486	31	27	47	0	11591
3417	11508	29	35	47	0	11619
3418	373	32	11274	53	0	11732
3419	219	24	11529	57	0	11829
3420	122	69	300	11478	0	11969
3421	11742	33	168	224	0	12167
3422	11775	28	61	163	0	12027
3423	12067	30	44	76	0	12217
3424	11978	35	39	77	0	12129
3425	390	11864	41	89	0	12384
3426	239	12637	61	87	0	13024
3427	12655	280	50	87	0	13072
3428	12652	142	60	91	0	12945
3429	402	12600	48	110	0	13160
3430	12794	185	46	84	0	13109
3431	328	137	12783	83	0	13331
3432	271	51	199	12362	0	12883
3433	182	51	12687	233	0	13153
3434	185	39	12700	180	0	13104
3435	146	41	298	12533	0	13018
3436	162	35	155	13246	0	13598
3437	174	40	13464	322	0	14000
3438	172	33	213	12954	0	13372
3439	182	34	142	13417	0	13775
3440	13356	32	73	342	0	13803
3441	13268	43	78	179	0	13568
3442	432	44	60	13494	0	14030
3443	279	78	13745	225	0	14327
3444	173	13964	203	211	0	14551
3445	13531	188	167	103	0	13989
3446	307	141	14368	98	0	14914
3447	258	14279	233	71	0	14841
3448	161	14874	164	78	0	15277
3449	15084	272	83	94	0	15533
3450	15416	159	78	96	0	15749
3451	427	57	85	15162	0	15731
3452	274	50	16290	249	0	16863
3453	190	41	255	16218	0	16704
3454	160	36	232	16206	0	16634
3455	155	38	125	16503	0	16821
3456	16338	32	101	384	0	16855
3457	327	16115	98	212	0	16752
3458	281	17187	97	103	0	17668
3459	207	328	79	16775	0	17389
3460	154	187	84	17468	0	17893
3461	17422	65	99	372	0	17958
3462	16215	78	106	229	0	16628
3463	17387	44	85	112	0	17628
3464	483	17245	75	83	0	17886
3465	17168	208	86	68	0	17530
3466	350	256	61	16913	0	17580
3467	280	57	17088	266	0	17691
3468	185	34	16414	159	0	16792
3469	16046	72	302	91	0	16511
3470	260	22	16286	56	0	16624
3471	164	17	15196	41	0	15418
3472	13578	17	174	49	0	13818
3473	116	15	13897	39	0	14067
3474	72	8	13496	20	0	13596
3475	47	37	76	12899	0	13059
3476	28	8	13996	54	0	14086
3477	13	12	51	13349	0	13425
3478	22	12	46	13727	0	13807
3479	33	2	14489	83	0	14607
3480	9	15040	48	62	0	15159
3481	15389	40	47	32	0	15508
3482	58	36	16086	17	0	16197
3483	37	22	15807	10	0	15876
3484	14153	4	77	34	0	14268
3485	54	3	15691	17	0	15765
3486	26	15163	32	19	0	15240
3487	32	15187	50	32	0	15301
3488	5	53	12	15612	0	15682
3489	10	39	15	15397	0	15461
3490	16177	6	9	62	0	16254
3491	15626	12	11	43	0	15692
3492	15920	6	9	27	0	15962
3493	51	1	6	16149	0	16207
3494	16185	3	7	47	0	16242
3495	15614	8	14	46	0	15682
3496	62	3	16121	17	0	16203
3497	52	1	15792	15	0	15860
3498	9	16286	51	19	0	16365
3499	12	30	33	16352	0	16427
3500	16388	27	13	49	0	16477
3501	38	16344	11	51	0	16444
3502	29	34	8	16674	0	16745
3503	16662	31	12	46	0	16751
3504	16252	21	10	54	0	16337
3505	58	16742	11	36	0	16847
3506	16720	27	13	22	0	16782
3507	16650	33	16	17	0	16716
3508	57	15	12	16953	0	17037
3509	53	14	17144	35	0	17246
3510	24	16891	33	65	0	17013
3511	17	16960	32	39	0	17048
3512	16528	54	17	16	0	16615
3513	40	38	16	16355	0	16449
3514	53	15	16683	46	0	16797
3515	17	16640	42	59	0	16758
3516	16575	32	38	33	0	16678
3517	16470	34	14	32	0	16550
3518	80	12	17361	11	0	17464
3519	50	9	46	16654	0	16759
3520	21	18	38	17662	0	17739
3521	27	13	18936	78	0	19054
3522	19164	6	71	66	0	19307
3523	23681	11	76	38	0	23806
3524	240	11	34	27663	0	27948
3525	163	28793	25	226	0	29207
3526	50	230	19	30052	0	30351
3527	55	210	30029	280	0	30574
3528	29269	38	272	256	0	29835
3529	249	22	240	30831	0	31342
3530	260	11	30804	277	0	31352
3531	29257	21	285	266	0	29829
3532	263	26	244	29949	0	30482
3533	251	14	62	30395	0	30722
3534	30248	7	32	476	0	30763
3535	266	30327	28	304	0	30925
3536	30199	244	32	62	0	30537
3537	305	236	16	29799	0	30356
3538	29833	44	41	282	0	30200
3539	327	31	29795	265	0	30418
3540	266	29846	249	101	0	30462
3541	63	266	247	30001	0	30577
3542	29944	262	58	312	0	30576
3543	278	30031	57	314	0	30680
3544	290	322	49	30188	0	30849
3545	30082	257	46	320	0	30705
3546	29180	68	50	433	0	29731
3547	572	41	41	29255	0	29909
3548	391	37	29167	379	0	29974
3549	132	53	28837	353	0	29375
3550	28266	35	505	166	0	28972
3551	320	28558	317	154	0	29349
3552	327	27707	103	125	0	28262
3553	27220	496	138	120	0	27974
3554	358	28361	71	133	0	28923
3555	332	307	98	27938	0	28675
3556	150	292	72	28669	0	29183
3557	28486	103	68	603	0	29260
3558	27670	84	69	396	0	28219
3559	28102	104	37	188	0	28431
3560	650	76	27431	158	0	28315
3561	419	84	299	27393	0	28195
3562	273	71	27709	370	0	28423
3563	195	68	27217	375	0	27855
3564	192	62	27857	158	0	28269
3565	154	66	594	27188	0	28002
3566	177	81	27797	389	0	28444
3567	186	101	27691	356	0	28334
3568	184	132	536	27453	0	28305
3569	27777	125	317	424	0	28643
3570	460	111	28163	362	0	29096
3571	411	112	351	27604	0	28478
3572	220	92	332	28381	0	29025
3573	205	91	28769	637	0	29702
3574	195	111	361	28553	0	29220
3575	222	99	28944	451	0	29716
3576	222	122	402	27948	0	28694
3577	194	130	351	27760	0	28435
3578	181	120	143	28008	0	28452
3579	183	101	140	28012	0	28436
3580	26766	94	164	689	0	27713
3581	26003	83	166	462	0	26714
3582	654	77	26309	237	0	27277
3583	450	25957	412	292	0	27111
3584	249	328	26528	175	0	27280
3585	221	319	26202	171	0	26913
3586	25366	113	701	183	0	26363
3587	423	26107	457	247	0	27234
3588	26375	341	266	208	0	27190
3589	410	26864	237	261	0	27772
3590	26475	370	239	238	0	27322
3591	26565	305	242	215	0	27327
3592	701	97	230	26114	0	27142
3593	431	26422	225	603	0	27681
3594	200	349	208	26660	0	27417
3595	184	303	225	26974	0	27686
3596	177	90	26834	820	0	27921
3597	185	26629	496	695	0	28005
3598	220	329	480	26785	0	27814
3599	26431	337	276	540	0	27584
3600	26776	124	243	525	0	27668
3601	27335	104	233	317	0	27989
3602	746	26883	192	452	0	28273
3603	27703	388	178	265	0	28534
3604	544	29252	173	280	0	30249
3605	538	462	159	29718	0	30877
3606	288	386	29612	553	0	30839
3607	309	164	519	28932	0	29924
3608	222	29166	518	562	0	30468
3609	232	461	278	28963	0	29934
3610	188	445	211	28923	0	29767
3611	163	29222	188	879	0	30452
3612	29350	456	184	590	0	30580
3613	526	454	185	29189	0	30354
3614	573	186	28667	545	0	29971
3615	281	165	480	28665	0	29591
3616	241	138	485	29089	0	29953
3617	253	145	29140	857	0	30395
3618	225	264	514	27232	0	28235
3619	208	28149	457	610	0	29424
3620	293	522	27838	505	0	29158
3621	440	466	26463	275	0	27644
3622	151	25153	677	369	0	26350
3623	126	21227	396	182	0	21931
3624	94	17061	120	92	0	17367
3625	15383	384	178	89	0	16034
3626	14114	172	67	52	0	14405
3627	14173	55	28	66	0	14322
3628	288	33	44	14143	0	14508
3629	180	107	14006	182	0	14475
3630	54	48	157	13997	0	14256
3631	38	47	148	14123	0	14356
3632	13894	46	57	299	0	14296
3633	13861	43	46	194	0	14144
3634	279	14226	50	73	0	14628
3635	14232	171	33	65	0	14501
3636	14014	150	32	61	0	14257
3637	14217	69	41	76	0	14403
3638	315	36	13925	68	0	14344
3639	180	40	13872	57	0	14149
3640	66	46	273	13726	0	14111
3641	45	51	13918	184	0	14198
3642	13073	57	182	153	0	13465
3643	13457	40	137	64	0	13698
3644	282	41	13237	46	0	13606
3645	12981	41	161	42	0	13225
3646	181	13123	132	146	0	13582
3647	13368	171	43	47	0	13629
3648	196	131	36	12964	0	13327
3649	150	53	49	12510	0	12762
3650	75	12931	23	275	0	13304
3651	12779	167	32	163	0	13141
3652	12838	153	40	57	0	13088
3653	276	12900	36	63	0	13275
3654	181	175	33	12034	0	12423
3655	85	147	28	11964	0	12224
3656	72	11845	42	305	0	12264
3657	57	172	56	11841	0	12126
3658	66	156	44	12006	0	12272
3659	11796	70	43	295	0	12204
3660	11741	51	34	198	0	12024
3661	306	65	11757	80	0	12208
3662	11573	61	172	85	0	11891
3663	215	57	11698	87	0	12057
3664	188	56	193	11502	0	11939
3665	107	55	11555	211	0	11928
3666	65	11377	185	217	0	11844
3667	74	161	211	10586	0	11032
3668	73	141	49	10705	0	10968
3669	10658	69	64	261	0	11052
3670	191	52	55	10446	0	10744
3671	169	54	10266	207	0	10696
3672	9826	68	173	177	0	10244
3673	9829	64	137	100	0	10130
3674	10038	92	60	72	0	10262
3675	10029	56	53	79	0	10217
3676	291	57	53	10223	0	10624
3677	202	64	46	10369	0	10681
3678	111	64	46	10844	0	11065
3679	105	54	57	11062	0	11278
3680	10855	46	60	327	0	11288
3681	10707	58	52	217	0	11034
3682	342	44	57	10102	0	10545
3683	229	10450	65	191	0	10935
3684	10416	182	103	167	0	10868
3685	272	161	10252	98	0	10783
3686	194	10388	180	98	0	10860
3687	9712	159	143	64	0	10078
3688	198	9770	55	61	0	10084
3689	188	171	9457	53	0	9869
3690	9323	159	143	64	0	9689
3691	9327	48	195	45	0	9615
3692	313	43	9257	57	0	9670
3693	212	37	161	9198	0	9608
3694	114	40	154	9032	0	9340
3695	101	9134	50	297	0	9582
3696	87	139	47	9153	0	9426
3697	8700	123	42	190	0	9055
3698	213	8810	30	189	0	9242
3699	173	122	49	8248	0	8592
3700	128	109	27	8361	0	8625
3701	109	38	8165	226	0	8538
3702	105	8096	129	150	0	8480
3703	7172	125	124	52	0	7473
3704	121	5778	25	45	0	5969
3705	62	5135	18	40	0	5255
3706	5091	117	75	30	0	5313
3707	92	47	21	4969	0	5129
3708	58	22	20	5087	0	5187
3709	5081	14	16	115	0	5226
3710	97	15	9	5075	0	5196
3711	62	18	15	5145	0	5240
3712	5107	12	18	117	0	5254
3713	102	18	20	5054	0	5194
3714	64	5113	10	90	0	5277
3715	5130	88	4	55	0	5277
3716	103	54	5008	80	0	5245
3717	66	4763	77	33	0	4939
3718	34	163	70	4608	0	4875
3719	41	48	4691	92	0	4872
3720	34	25	4536	58	0	4653
3721	22	294	110	3848	0	4274
3722	3841	12	46	119	0	4018
3723	67	4	12	3746	0	3829
3724	43	15	16	3725	0	3799
3725	14	11	8	3797	0	3830
3726	13	13	6	3756	0	3788
3727	15	23	7	3812	0	3857
3728	11	11	3655	94	0	3771
3729	12	17	3584	55	0	3668
3730	24	17	73	3615	0	3729
3731	17	16	3591	65	0	3689
3732	14	3552	55	67	0	3688
3733	23	50	41	3579	0	3693
3734	26	48	3459	70	0	3603
3735	3209	14	57	57	0	3337
3736	65	3402	35	32	0	3534
3737	40	3325	9	42	0	3416
3738	40	3416	37	25	0	3518
3739	24	80	12	3311	0	3427
3740	3268	35	20	75	0	3398
3741	61	34	6	3313	0	3414
3742	3289	11	18	70	0	3388
3743	50	3167	7	72	0	3296
3744	3188	55	18	34	0	3295
3745	69	46	15	3157	0	3287
3746	59	25	13	3142	0	3239
3747	33	3126	15	94	0	3268
3748	21	57	17	3101	0	3196
3749	27	47	16	3059	0	3149
3750	32	29	11	3064	0	3136
3751	3013	16	20	107	0	3156
3752	3040	19	20	68	0	3147
3753	85	25	3024	41	0	3175
3754	3034	19	53	47	0	3153
3755	66	22	3165	38	0	3291
3756	57	20	61	3133	0	3271
3757	23	27	45	3185	0	3280
3758	27	23	25	3241	0	3316
3759	29	18	3160	105	0	3312
3760	18	29	56	3182	0	3285
3761	23	18	3203	74	0	3318
3762	25	16	63	3206	0	3310
3763	3143	13	54	86	0	3296
3764	61	27	3157	65	0	3310
3765	3055	25	43	59	0	3182
3766	56	13	46	3121	0	3236
3767	3112	21	25	69	0	3227
3768	64	3132	13	73	0	3282
3769	44	65	14	3194	0	3317
3770	32	54	3278	76	0	3440
3771	23	87	58	3073	0	3241
3772	23	23	49	3064	0	3159
3773	22	3167	20	121	0	3330
3774	27	46	3037	75	0	3185
3775	23	3010	53	36	0	3122
3776	2518	37	25	32	0	2612
3777	32	2554	15	29	0	2630
3778	2093	26	60	10	0	2189
3779	2088	19	9	12	0	2128
3780	2089	7	8	13	0	2117
3781	39	4	7	2112	0	2162
3782	22	4	2130	32	0	2188
3783	6	6	29	2081	0	2122
3784	8	2115	18	33	0	2174
3785	3	28	14	2156	0	2201
3786	2062	18	3	40	0	2123
3787	32	2085	3	26	0	2146
3788	20	28	4	1957	0	2009
3789	13	17	6	2011	0	2047
3790	2015	5	6	50	0	2076
3791	34	2	2078	26	0	2140
3792	18	2071	23	14	0	2126
3793	4	20	13	1874	0	1911
3794	2	13	1857	20	0	1892
3795	2	2	17	1789	0	1810
3796	2	1838	11	23	0	1874
3797	3	19	5	1921	0	1948
3798	5	13	2	1818	0	1838
3799	5	3	1	1816	0	1825
3800	7	1	1817	31	0	1856
3801	1812	3	15	15	0	1845
3802	18	3	17	1974	0	2012
3803	2288	4	1	19	0	2312
3804	2311	6	6	16	0	2339
3805	2414	2	2	14	0	2432
3806	2346	2	5	6	0	2359
3807	2415	4	1	14	0	2434
3808	51	2	4	2359	0	2416
3809	27	2387	2	34	0	2450
3810	8	24	5	2347	0	2384
3811	4	2340	3	33	0	2380
3812	7	28	4	2315	0	2354
3813	2257	23	5	27	0	2312
3814	28	3	1	2265	0	2297
3815	22	0	2215	34	0	2271
3816	2152	3	23	27	0	2205
3817	24	2209	19	10	0	2262
3818	2207	20	2	9	0	2238
3819	2107	19	5	6	0	2137
3820	2029	2	2	3	0	2036
3821	41	2046	2	4	0	2093
3822	25	22	1	2052	0	2100
3823	9	18	1	2074	0	2102
3824	12	2	2038	38	0	2090
3825	11	3	19	2006	0	2039
3826	8	4	22	2017	0	2051
3827	9	2	2	2019	0	2032
3828	7	2051	3	43	0	2104
3829	2061	20	3	26	0	2110
3830	1902	23	3	11	0	1939
3831	41	6	2034	11	0	2092
3832	21	2055	15	15	0	2106
3833	6	25	23	2072	0	2126
3834	15	19	2	2067	0	2103
3835	12	3	4	2087	0	2106
3836	9	8	4	2154	0	2175
3837	11	5	3	2183	0	2202
3838	12	4	2100	54	0	2170
3839	9	5	2047	31	0	2092
3840	2140	8	43	9	0	2200
3841	2307	7	21	11	0	2346
3842	2353	6	2	19	0	2380
3843	55	5	8	2339	0	2407
3844	32	5	2364	37	0	2438
3845	2361	4	30	30	0	2425
3846	2411	2	25	19	0	2457
3847	61	3	2398	13	0	2475
3848	2405	7	30	11	0	2453
3849	41	11	2610	8	0	2670
3850	43	6	32	2558	0	2639
3851	18	3	2600	42	0	2663
3852	2477	5	40	32	0	2554
3853	2524	7	29	10	0	2570
3854	2554	7	10	16	0	2587
3855	2478	5	10	15	0	2508
3856	68	9	2476	12	0	2565
3857	41	2459	31	15	0	2546
3858	2502	37	26	15	0	2580
3859	2549	29	9	13	0	2600
3860	71	9	2549	15	0	2644
3861	39	16	38	2484	0	2577
3862	18	8	30	2556	0	2612
3863	17	7	2521	71	0	2616
3864	2441	5	38	43	0	2527
3865	2576	5	32	16	0	2629
3866	66	2624	6	28	0	2724
3867	2805	38	10	21	0	2874
3868	2749	30	12	10	0	2801
3869	2748	7	8	11	0	2774
3870	2638	5	9	11	0	2663
3871	82	5	2595	13	0	2695
3872	2545	9	41	10	0	2605
3873	58	11	33	2451	0	2553
3874	48	2549	2	54	0	2653
3875	64	40	2523	53	0	2680
3876	10	2589	45	19	0	2663
3877	24	33	55	2449	0	2561
3878	14	25	2457	45	0	2541
3879	2354	5	40	39	0	2438
3880	49	6	2450	10	0	2515
3881	2450	4	36	13	0	2503
3882	44	4	33	2402	0	2483
3883	40	5	12	2405	0	2462
3884	21	2403	11	54	0	2489
3885	17	2479	9	34	0	2539
3886	24	59	3	2533	0	2619
3887	2533	29	10	47	0	2619
3888	2532	5	10	40	0	2587
3889	2529	4	11	10	0	2554
3890	82	4	2511	9	0	2606
3891	2486	3	45	9	0	2543
3892	52	2	2476	7	0	2537
3893	52	7	2420	7	0	2486
3894	2371	4	92	10	0	2477
3895	2476	5	32	12	0	2525
3896	77	4	2521	3	0	2605
3897	45	5	43	2422	0	2515
3898	22	9	30	2485	0	2546
3899	2468	3	15	61	0	2547
3900	2439	3	9	32	0	2483
3901	69	3	2547	11	0	2630
3902	32	2470	44	17	0	2563
3903	14	2220	30	8	0	2272
3904	2164	40	7	3	0	2214
3905	94	15	5	2043	0	2157
3906	23	3	2	2049	0	2077
3907	6	2	4	2061	0	2073
3908	1870	2	3	38	0	1913
3909	33	3	4	2028	0	2068
3910	2039	2	2	25	0	2068
3911	2034	3	5	16	0	2058
3912	50	2265	6	5	0	2326
3913	31	21	4	2582	0	2638
3914	20	13	2636	29	0	2698
3915	2615	4	32	19	0	2670
3916	2651	1	30	6	0	2688
3917	2699	7	4	4	0	2714
3918	53	1	2820	8	0	2882
3919	30	6	31	2786	0	2853
3920	2835	3	25	31	0	2894
3921	2796	7	12	23	0	2838
3922	2875	2	4	12	0	2893
3923	55	2885	10	9	0	2959
3924	32	3141	1	12	0	3186
3925	13	51	7	3188	0	3259
3926	13	24	5	3154	0	3196
3927	9	3193	3	61	0	3266
3928	3208	37	2	28	0	3275
3929	52	24	3335	5	0	3416
3930	33	8	38	3276	0	3355
3931	12	4	25	3386	0	3427
3932	18	2	3325	60	0	3405
3933	3156	3	43	22	0	3224
3934	3382	5	23	8	0	3418
3935	64	3334	12	5	0	3415
3936	3297	39	4	10	0	3350
3937	46	44	3354	8	0	3452
3938	3391	4	45	11	0	3451
3939	58	4	3471	8	0	3541
3940	3304	4	83	6	0	3397
3941	3380	4	20	10	0	3414
3942	3426	4	10	10	0	3450
3943	3408	8	7	7	0	3430
3944	56	3444	4	13	0	3517
3945	3528	33	4	5	0	3570
3946	3521	18	9	5	0	3553
3947	53	10	3632	10	0	3705
3948	3499	4	29	11	0	3543
3949	37	2	16	3635	0	3690
3950	25	2	3682	35	0	3744
3951	3663	2	26	22	0	3713
3952	35	3	22	3704	0	3764
3953	3769	7	7	30	0	3813
3954	4223	4	4	24	0	4255
3955	56	2	4546	8	0	4612
3956	4568	1	25	8	0	4602
3957	4524	6	76	6	0	4612
3958	4615	38	4	8	0	4665
3959	4788	3	5	4	0	4800
3960	60	4	7	4647	0	4718
3961	35	4723	6	81	0	4845
3962	4753	31	7	25	0	4816
3963	4824	18	9	5	0	4856
3964	4898	5	6	14	0	4923
3965	65	1	4882	11	0	4959
3966	31	4825	34	44	0	4934
3967	21	31	20	4796	0	4868
3968	17	17	8	4891	0	4933
3969	22	9	4995	49	0	5075
3970	16	1	40	5043	0	5100
3971	23	6	5148	46	0	5223
3972	16	1	48	5054	0	5119
3973	13	1	34	5116	0	5164
3974	21	7	5382	64	0	5474
3975	5126	6	41	35	0	5208
3976	5427	4	29	10	0	5470
3977	79	13	5658	6	0	5756
3978	5543	13	40	14	0	5610
3979	5845	6	30	14	0	5895
3980	82	5	6095	12	0	6194
3981	50	13	44	6005	0	6112
3982	23	6	34	6135	0	6198
3983	6157	3	18	71	0	6249
3984	42	6316	7	49	0	6414
3985	6188	43	12	18	0	6261
3986	6208	32	13	13	0	6266
3987	80	6636	11	18	0	6745
3988	6711	39	6	16	0	6772
3989	6592	38	12	13	0	6655
3990	81	6781	10	20	0	6892
3991	50	42	16	6848	0	6956
3992	26	6919	13	42	0	7000
3993	29	38	13	6938	0	7018
3994	23	25	6988	50	0	7086
3995	32	11	6943	36	0	7022
3996	6820	4	67	21	0	6912
3997	7131	7	44	8	0	7190
3998	97	14	7220	5	0	7336
3999	7283	7	45	12	0	7347
4000	7477	9	42	11	0	7539
4001	7402	4	17	16	0	7439
4002	95	7724	17	13	0	7849
4003	66	37	15	7870	0	7988
4004	7842	33	15	52	0	7942
4005	7720	13	13	43	0	7789
4006	96	7	7940	20	0	8063
4007	66	8	42	7828	0	7944
4008	46	10	35	7803	0	7894
4009	31	7918	20	68	0	8037
4010	31	8147	14	50	0	8242
4011	42	91	12	7964	0	8109
4012	33	8149	14	51	0	8247
4013	7965	48	11	47	0	8071
4014	62	8514	12	28	0	8616
4015	8721	59	9	17	0	8806
4016	93	41	8749	15	0	8898
4017	8721	35	68	10	0	8834
4018	8838	6	48	11	0	8903
4019	8884	8	13	13	0	8918
4020	8870	10	15	10	0	8905
4021	125	8816	11	21	0	8973
4022	73	62	14	8779	0	8928
4023	29	43	12	8817	0	8901
4024	22	15	8846	111	0	8994
4025	15	6	60	8721	0	8802
4026	26	7	46	8846	0	8925
4027	8957	11	17	105	0	9090
4028	68	8970	13	71	0	9122
4029	69	64	12	9077	0	9222
4030	29	57	12	9198	0	9296
4031	25	17	9	9322	0	9373
4032	9337	12	11	135	0	9495
4033	81	13	14	9365	0	9473
4034	9473	16	6	90	0	9585
4035	95	14	14	9395	0	9518
4036	86	11	15	9625	0	9737
4037	52	13	9538	133	0	9736
4038	8841	14	78	85	0	9018
4039	105	9520	66	28	0	9719
4040	9760	77	22	18	0	9877
4041	98	73	12	9455	0	9638
4042	84	20	14	9583	0	9701
4043	9728	19	10	142	0	9899
4044	9622	22	16	92	0	9752
4045	156	17	14	10351	0	10538
4046	99	16	10456	106	0	10677
4047	60	15	11129	92	0	11296
4048	31	11734	160	43	0	11968
4049	11925	111	90	31	0	12157
4050	11624	98	28	41	0	11791
4051	205	32	9	12080	0	12326
4052	127	12476	10	131	0	12744
4053	46	122	12	12451	0	12631
4054	31	105	13	11919	0	12068
4055	32	11673	11	230	0	11946
4056	11755	123	12	123	0	12013
4057	139	155	18	11553	0	11865
4058	116	11899	20	137	0	12172
4059	40	12175	15	124	0	12354
4060	12187	181	15	46	0	12429
4061	145	113	12215	36	0	12509
4062	12229	34	120	76	0	12459
4063	162	55	88	12089	0	12394
4064	128	18	22	12014	0	12182
4065	47	12234	23	238	0	12542
4066	46	154	15	12321	0	12536
4067	48	100	12417	164	0	12729
4068	50	12277	118	252	0	12697
4069	47	12505	89	60	0	12701
4070	12330	189	26	59	0	12604
4071	133	12502	23	62	0	12720
4072	109	143	15	12355	0	12622
4073	51	12570	11	157	0	12789
4074	36	143	10	12383	0	12572
4075	49	105	7	12559	0	12720
4076	43	49	12386	242	0	12720
4077	51	36	123	11990	0	12200
4078	46	34	99	12267	0	12446
4079	12173	34	33	233	0	12473
4080	162	31	12359	132	0	12684
4081	135	29	134	12360	0	12658
4082	62	37	12511	178	0	12788
4083	12233	30	138	137	0	12538
4084	167	12722	96	77	0	13062
4085	13430	151	31	78	0	13690
4086	190	125	34	13344	0	13693
4087	138	56	35	13554	0	13783
4088	71	53	13638	298	0	14060
4089	12568	59	156	187	0	12970
4090	200	13629	124	103	0	14056
4091	13138	187	46	81	0	13452
4092	203	165	26	13431	0	13825
4093	157	13998	22	218	0	14395
4094	13953	176	29	201	0	14359
4095	177	14400	34	115	0	14726
4096	169	192	27	14195	0	14583
4097	82	152	19	14153	0	14406
4098	68	71	29	14192	0	14360
4099	54	14011	33	330	0	14428
4100	54	191	39	13960	0	14244
4101	69	167	39	14037	0	14312
4102	13696	77	44	295	0	14112
4103	13574	60	41	205	0	13880
4104	13746	67	36	101	0	13950
4105	310	71	14243	98	0	14722
4106	14133	64	169	121	0	14487
4107	14293	68	149	108	0	14618
4108	14332	79	68	85	0	14564
4109	323	81	14131	93	0	14628
4110	13926	85	157	91	0	14259
4111	213	78	129	14310	0	14730
4112	168	75	14316	223	0	14782
4113	78	14187	147	180	0	14592
4114	54	162	120	13679	0	14015
4115	39	13771	50	199	0	14059
4116	55	13895	43	192	0	14185
4117	13594	227	85	90	0	13996
4118	187	184	29	13634	0	14034
4119	13778	56	39	186	0	14059
4120	178	41	31	13780	0	14030
4121	13729	51	45	186	0	14011
4122	182	54	46	13730	0	14012
4123	13669	50	49	185	0	13953
4124	177	66	13528	153	0	13924
4125	166	65	135	13450	0	13816
4126	98	61	14136	173	0	14468
4127	80	75	13521	155	0	13831
4128	77	50	14142	95	0	14364
4129	65	122	215	13766	0	14168
4130	70	55	14097	179	0	14401
4131	13768	48	127	160	0	14103
4132	137	49	99	13945	0	14230
4133	145	56	15626	171	0	15998
4134	71	51	109	15358	0	15589
4135	62	59	103	15695	0	15919
4136	80	45	17617	258	0	18000
4137	68	56	143	17201	0	17468
4138	74	47	118	17175	0	17414
4139	66	18134	42	251	0	18493
4140	18132	122	48	162	0	18464
4141	18100	117	32	109	0	18358
4142	248	45	18059	93	0	18445
4143	17626	33	125	87	0	17871
4144	199	29	17708	74	0	18010
4145	151	26	16844	69	0	17090
4146	155	35	17178	56	0	17424
4147	132	183	186	15744	0	16245
4148	69	31	16558	124	0	16782
4149	40	47	107	16082	0	16276
4150	45	31	78	16183	0	16337
4151	44	28	27	16296	0	16395
4152	42	20	23	16389	0	16474
4153	16342	26	19	154	0	16541
4154	15912	22	27	105	0	16066
4155	134	16599	21	84	0	16838
4156	95	59	23	16564	0	16741
4157	66	64	16818	93	0	17041
4158	57	16828	77	93	0	17055
4159	45	85	75	17335	0	17540
4160	64	65	17653	100	0	17882
4161	43	19	88	17101	0	17251
4162	39	15	17576	105	0	17735
4163	46	16	17617	100	0	17779
4164	39	18	144	17610	0	17811
4165	35	17	105	17515	0	17672
4166	17757	17	32	162	0	17968
4167	94	12	34	17596	0	17736
4168	17443	14	19	95	0	17571
4169	86	17529	22	113	0	17750
4170	83	17680	21	68	0	17852
4171	36	128	22	17776	0	17962
4172	17752	79	19	95	0	17945
4173	80	18131	20	107	0	18338
4174	83	64	29	18790	0	18966
4175	19041	67	22	91	0	19221
4176	19019	17	34	89	0	19159
4177	19056	14	32	42	0	19144
4178	19091	10	38	37	0	19176
4179	19131	8	44	35	0	19218
4180	156	8	18906	29	0	19099
4181	103	9	18918	29	0	19059
4182	23	19163	139	59	0	19384
4183	12	88	95	19023	0	19218
4184	34	62	19631	91	0	19818
4185	17	69	18937	69	0	19092
4186	7	5	114	19207	0	19333
4187	24	5	20686	91	0	20806
4188	59	6	21234	68	0	21367
4189	19	27142	158	61	0	27380
4190	27416	192	67	29	0	27704
4191	190	30890	20	53	0	31153
4192	128	279	16	31496	0	31919
4193	31972	174	9	266	0	32421
4194	269	32952	15	222	0	33458
4195	175	288	8	32987	0	33458
4196	44	182	33368	306	0	33900
4197	32261	39	286	203	0	32789
4198	33040	21	199	46	0	33306
4199	33619	22	38	160	0	33839
4200	490	7	15	34152	0	34664
4201	259	12	34530	379	0	35180
4202	57	34465	284	247	0	35053
4203	35	288	207	34316	0	34846
4204	33764	216	64	304	0	34348
4205	299	32	34183	214	0	34728
4206	209	33998	306	70	0	34583
4207	76	285	34498	39	0	34898
4208	32823	233	341	33	0	33430
4209	33749	49	246	39	0	34083
4210	34036	52	55	34	0	34177
4211	554	27	33973	44	0	34598
4212	265	33775	305	57	0	34402
4213	82	334	245	32752	0	33413
4214	96	238	68	32948	0	33350
4215	46	59	54	33817	0	33976
4216	67	42	33263	535	0	33907
4217	31908	38	335	279	0	32560
4218	366	43	33301	86	0	33796
4219	32911	39	359	69	0	33378
4220	33134	48	321	50	0	33553
4221	33497	65	120	56	0	33738
4222	32908	51	96	75	0	33130
4223	601	66	33477	47	0	34191
4224	332	56	346	32759	0	33493
4225	161	62	33288	350	0	33861
4226	127	32149	369	298	0	32943
4227	118	32875	261	124	0	33378
4228	32364	565	113	74	0	33116
4229	31908	342	87	81	0	32418
4230	590	32892	82	141	0	33705
4231	33304	392	62	89	0	33847
4232	498	335	32001	106	0	32940
4233	31188	112	377	129	0	31806
4234	442	31767	321	133	0	32663
4235	32457	376	127	114	0	33074
4236	30536	308	114	104	0	31062
4237	751	115	109	30039	0	31014
4238	484	91	111	30442	0	31128
4239	29903	105	159	609	0	30776
4240	523	109	120	30148	0	30900
4241	30066	85	129	469	0	30749
4242	549	197	125	30043	0	30914
4243	29941	96	147	446	0	30630
4244	29503	119	155	337	0	30114
4245	706	29417	180	177	0	30480
4246	481	29757	163	141	0	30542
4247	29098	639	135	118	0	29990
4248	528	29336	146	160	0	30170
4249	478	435	179	28478	0	29570
4250	274	388	175	28870	0	29707
4251	28189	156	162	663	0	29170
4252	509	28409	186	430	0	29534
4253	469	28173	166	216	0	29024
4254	289	28846	157	191	0	29483
4255	321	671	28018	149	0	29159
4256	301	392	28022	171	0	28886
4257	312	182	28251	170	0	28915
4258	341	290	710	24971	0	26312
4259	302	27183	404	405	0	28294
4260	27126	401	187	342	0	28056
4261	586	350	26708	174	0	27818
4262	562	149	26511	203	0	27425
4263	353	150	26788	157	0	27448
4264	385	166	678	25986	0	27215
4265	400	156	410	26163	0	27129
4266	376	153	225	26683	0	27437
4267	26512	166	159	645	0	27482
4268	26305	184	148	391	0	27028
4269	26591	163	136	183	0	27073
4270	871	175	169	25929	0	27144
4271	548	181	25831	421	0	26981
4272	322	221	26083	342	0	26968
4273	451	158	602	25434	0	26645
4274	433	156	373	25276	0	26238
4275	24950	171	185	629	0	25935
4276	582	24503	138	613	0	25836
4277	25017	413	146	206	0	25782
4278	604	24925	106	260	0	25895
4279	532	436	125	24695	0	25788
4280	299	366	24634	511	0	25810
4281	331	211	431	24285	0	25258
4282	24429	173	333	486	0	25421
4283	544	165	24284	435	0	25428
4284	23411	161	442	210	0	24224
4285	638	128	23447	202	0	24415
4286	540	194	22611	137	0	23482
4287	20985	159	550	165	0	21859
4288	504	147	20805	170	0	21626
4289	276	84	14402	107	0	14869
4290	222	13732	594	221	0	14769
4291	10323	180	596	65	0	11164
4292	9503	151	27	44	0	9725
4293	9541	25	31	44	0	9641
4294	150	25	9210	44	0	9429
4295	8726	18	67	36	0	8847
4296	91	8711	77	31	0	8910
4297	8680	71	21	30	0	8802
4298	79	70	8593	27	0	8769
4299	72	69	52	7892	0	8085
4300	33	19	7764	50	0	7866
4301	22	7494	46	57	0	7619
4302	57	34	48	7005	0	7144
4303	30	47	15	7165	0	7257
4304	7154	14	12	76	0	7256
4305	7162	5	7	59	0	7233
4306	7099	6	10	23	0	7138
4307	7081	6	14	22	0	7123
4308	7032	6	11	18	0	7067
4309	83	7	7074	14	0	7178
4310	61	6	40	7022	0	7129
4311	25	9	7272	42	0	7348
4312	23	8	51	7185	0	7267
4313	7116	6	48	61	0	7231
4314	7245	15	17	51	0	7328
4315	7213	8	17	22	0	7260
4316	7310	12	12	20	0	7354
4317	101	3	7884	13	0	8001
4318	53	49	54	7808	0	7964
4319	36	7	7997	54	0	8094
4320	17	7927	61	52	0	8057
4321	27	7711	58	28	0	7824
4322	45	97	29	7705	0	7876
4323	22	47	20	8428	0	8517
4324	25	19	23	9554	0	9621
4325	19	11	21	10078	0	10129
4326	9937	8	21	180	0	10146
4327	106	9959	16	120	0	10201
4328	9631	86	20	28	0	9765
4329	107	80	14	9447	0	9648
4330	95	26	19	9000	0	9140
4331	31	9314	13	155	0	9513
4332	28	125	18	9315	0	9486
4333	9317	80	14	105	0	9516
4334	102	9185	14	94	0	9395
4335	90	8800	12	26	0	8928
4336	8786	155	8	22	0	8971
4337	106	82	15	8726	0	8929
4338	84	8993	11	108	0	9196
4339	44	109	62	9106	0	9321
4340	9036	76	14	110	0	9236
4341	109	20	12	8971	0	9112
4342	91	13	9	9013	0	9126
4343	8935	14	12	182	0	9143
4344	110	11	7	8903	0	9031
4345	90	9011	12	114	0	9227
4346	33	92	10	9054	0	9189
4347	30	9084	10	117	0	9241
4348	22	99	8	9100	0	9229
4349	8999	82	15	113	0	9209
4350	8949	21	6	100	0	9076
4351	176	15	12	9206	0	9409
4352	103	6	9109	112	0	9330
4353	8887	12	95	99	0	9093
4354	117	13	9142	33	0	9305
4355	9019	15	102	33	0	9169
4356	8994	15	79	16	0	9104
4357	185	9	9230	26	0	9450
4358	109	9117	101	34	0	9361
4359	9336	101	86	20	0	9543
4360	9411	97	17	25	0	9550
4361	185	21	10024	24	0	10254
4362	9865	18	97	23	0	10003
4363	9764	18	82	27	0	9891
4364	9897	19	18	28	0	9962
4365	187	13	9	9827	0	10036
4366	105	13	10	9921	0	10049
4367	34	10162	6	182	0	10384
4368	30	96	6	10272	0	10404
4369	29	87	5	10312	0	10433
4370	22	27	10171	206	0	10426
4371	33	22	9834	123	0	10012
4372	9198	24	160	47	0	9429
4373	9672	24	88	49	0	9833
4374	190	9704	22	43	0	9959
4375	115	104	14	9758	0	9991
4376	54	105	10083	122	0	10364
4377	42	41	99	10197	0	10379
4378	37	35	87	10426	0	10585
4379	44	26	23	10661	0	10754
4380	32	10668	14	230	0	10944
4381	41	129	14	10837	0	11021
4382	58	106	4	10995	0	11163
4383	43	44	10902	238	0	11227
4384	60	36	10943	161	0	11200
4385	10419	36	189	92	0	10736
4386	10804	37	106	82	0	11029
4387	222	39	30	11355	0	11646
4388	145	32	21	11069	0	11267
4389	85	37	15	11535	0	11672
4390	78	50	10983	311	0	11422
4391	80	10805	144	214	0	11243
4392	86	170	10829	96	0	11181
4393	10511	148	198	106	0	10963
4394	192	72	11071	101	0	11436
4395	10840	88	159	92	0	11179
4396	10865	66	134	94	0	11159
4397	11113	62	38	80	0	11293
4398	324	70	31	10792	0	11217
4399	200	65	10768	194	0	11227
4400	98	10817	158	196	0	11269
4401	101	174	196	10669	0	11140
4402	85	151	46	10886	0	11168
4403	77	56	11441	318	0	11892
4404	90	11445	156	228	0	11919
4405	11913	160	132	135	0	12340
4406	222	12160	46	116	0	12544
4407	12881	211	34	112	0	13238
4408	297	168	40	12894	0	13399
4409	233	72	13243	273	0	13821
4410	91	13496	237	222	0	14046
4411	13633	226	176	106	0	14141
4412	301	180	13599	80	0	14160
4413	13616	59	253	70	0	13998
4414	13646	33	177	82	0	13938
4415	452	33	13491	99	0	14075
4416	13250	28	285	66	0	13629
4417	13033	25	228	61	0	13347
4418	12972	29	108	39	0	13148
4419	459	12637	74	49	0	13219
4420	12709	228	58	49	0	13044
4421	316	12827	68	55	0	13266
4422	215	260	12647	49	0	13171
4423	88	12225	212	55	0	12580
4424	10452	217	429	27	0	11125
4425	10464	106	37	27	0	10634
4426	10633	33	28	26	0	10720
4427	270	32	23	10176	0	10501
4428	134	20	23	10486	0	10663
4429	9990	143	27	251	0	10411
4430	10323	22	22	118	0	10485
4431	268	20	26	10150	0	10464
4432	151	15	10286	158	0	10610
4433	59	10070	172	111	0	10412
4434	57	10400	97	39	0	10593
4435	37	249	36	10323	0	10645
4436	51	111	10329	164	0	10655
4437	39	54	162	9948	0	10203
4438	43	10214	107	166	0	10530
4439	42	168	38	10252	0	10500
4440	54	109	10193	182	0	10538
4441	47	41	167	10244	0	10499
4442	67	27	10451	185	0	10730
4443	54	30	185	10322	0	10591
4444	62	32	10571	188	0	10853
4445	75	24	10428	132	0	10659
4446	9853	29	288	45	0	10215
4447	10213	38	124	36	0	10411
4448	10337	30	50	37	0	10454
4449	290	10213	50	44	0	10597
4450	174	182	37	10224	0	10617
4451	9923	133	36	189	0	10281
4452	10144	47	49	121	0	10361
4453	10165	41	46	52	0	10304
4454	323	37	10066	47	0	10473
4455	161	9717	177	63	0	10118
4456	93	10119	137	45	0	10394
4457	9845	267	64	38	0	10214
4458	238	142	48	9733	0	10161
4459	9722	54	51	180	0	10007
4460	240	52	9511	126	0	9929
4461	195	37	184	8911	0	9327
4462	106	45	144	9227	0	9522
4463	111	43	69	8883	0	9106
4464	97	9120	43	264	0	9524
4465	9056	186	52	131	0	9425
4466	8967	142	51	54	0	9214
4467	314	8868	45	47	0	9274
4468	185	201	42	8755	0	9183
4469	8790	127	73	186	0	9176
4470	240	77	41	8776	0	9134
4471	8799	45	41	204	0	9089
4472	257	8701	49	150	0	9157
4473	8709	193	52	65	0	9019
4474	265	125	8569	62	0	9021
4475	176	8565	179	69	0	8989
4476	113	188	8341	60	0	8702
4477	138	296	192	7943	0	8569
4478	7710	62	138	187	0	8097
4479	7750	51	68	124	0	7993
4480	7771	52	39	65	0	7927
4481	282	49	69	7409	0	7809
4482	7487	41	51	195	0	7774
4483	239	45	56	7276	0	7616
4484	7144	41	46	213	0	7444
4485	7171	56	61	131	0	7419
4486	292	38	7088	79	0	7497
4487	133	33	6296	52	0	6514
4488	76	32	6318	60	0	6486
4489	103	32	192	5887	0	6214
4490	5988	31	116	149	0	6284
4491	170	21	54	6104	0	6349
4492	121	36	43	6356	0	6556
4493	6951	32	32	189	0	7204
4494	6893	31	32	95	0	7051
4495	6945	34	29	63	0	7071
4496	7019	39	36	40	0	7134
4497	219	25	38	6866	0	7148
4498	6924	24	26	151	0	7125
4499	185	6895	38	101	0	7219
4500	6904	127	33	51	0	7115
4501	6866	85	81	48	0	7080
4502	219	49	6607	35	0	6910
4503	5834	36	96	36	0	6002
4504	147	23	5830	38	0	6038
4505	86	14	5108	34	0	5242
4506	58	40	5101	25	0	5224
4507	70	229	58	3821	0	4178
4508	20	2	4011	37	0	4070
4509	17	129	54	3576	0	3776
4510	16	5	3688	26	0	3735
4511	9	2	4505	23	0	4539
4512	7	5	25	4166	0	4203
4513	9	1	12	4704	0	4726
4514	12	1	5161	26	0	5200
4515	4975	5	20	25	0	5025
4516	21	7	27	5101	0	5156
4517	27	5	3	5147	0	5182
4518	5161	2	4	42	0	5209
4519	20	0	3	5329	0	5352
4520	32	1	5337	20	0	5390
4521	10	5	5251	28	0	5294
4522	8	2	33	5071	0	5114
4523	13	3	5444	16	0	5476
4524	10	5570	16	25	0	5621
4525	6	13	28	5506	0	5553
4526	5539	22	4	25	0	5590
4527	20	2	5605	24	0	5651
4528	5558	1	20	14	0	5593
4529	23	2	24	5863	0	5912
4530	27	1	6	5834	0	5868
4531	6	2	5	5859	0	5872
4532	5	2	6	5915	0	5928
4533	5870	1	6	46	0	5923
4534	27	6575	8	36	0	6646
4535	25	40	4	6815	0	6884
4536	6	37	6	6796	0	6845
4537	4	6	3	6830	0	6843
4538	5	1	5	6887	0	6898
4539	6835	5	6	91	0	6937
4540	52	6779	3	59	0	6893
4541	6734	44	7	14	0	6799
4542	48	6577	3	13	0	6641
4543	36	6622	5	10	0	6673
4544	6518	73	3	11	0	6605
4545	45	39	6694	8	0	6786
4546	44	10	45	6638	0	6737
4547	6876	3	38	49	0	6966
4548	6796	9	16	44	0	6865
4549	6924	12	7	18	0	6961
4550	7283	3	1	13	0	7300
4551	87	7787	2	16	0	7892
4552	7839	66	2	11	0	7918
4553	8006	56	6	9	0	8077
4554	126	8838	5	23	0	8992
4555	67	86	6	9080	0	9239
4556	14	69	9054	103	0	9240
4557	11	9	92	9003	0	9115
4558	8988	9	73	112	0	9182
4559	95	9	9395	84	0	9583
4560	75	9216	94	41	0	9426
4561	32	95	9610	17	0	9754
4562	15	86	98	8748	0	8947
4563	14	9364	86	89	0	9553
4564	9417	98	14	75	0	9604
4565	92	9640	6	28	0	9766
4566	88	101	10	9340	0	9539
4567	16	83	9	9649	0	9757
4568	9576	13	7	179	0	9775
4569	102	8	8	9457	0	9575
4570	80	9624	5	108	0	9817
4571	9657	100	4	83	0	9844
4572	9582	81	6	28	0	9697
4573	183	9766	11	18	0	9978
4574	9870	98	5	25	0	9998
4575	112	9808	10	31	0	9961
4576	9797	105	9	31	0	9942
4577	111	9859	7	30	0	10007
4578	94	112	10	9409	0	9625
4579	31	92	8	9891	0	10022
4580	9800	30	13	205	0	10048
4581	10042	20	10	114	0	10186
4582	187	9953	6	149	0	10295
4583	112	119	10157	30	0	10418
4584	10225	104	112	35	0	10476
4585	136	30	91	10538	0	10795
4586	107	10635	15	126	0	10883
4587	47	124	10	10715	0	10896
4588	10607	94	21	135	0	10857
4589	10633	41	10	112	0	10796
4590	10874	28	10	37	0	10949
4591	236	22	10	10617	0	10885
4592	137	34	10604	133	0	10908
4593	9709	34	107	105	0	9955
4594	9848	35	98	41	0	10022
4595	10095	37	19	39	0	10190
4596	223	9982	10	43	0	10258
4597	140	128	16	10005	0	10289
4598	48	10147	16	136	0	10347
4599	54	143	26	9999	0	10222
4600	55	118	31	10085	0	10289
4601	44	47	10530	224	0	10845
4602	43	36	134	10888	0	11101
4603	47	34	107	11072	0	11260
4604	11240	43	24	276	0	11583
4605	171	11284	23	156	0	11634
4606	11375	176	16	69	0	11636
4607	11749	146	17	60	0	11972
4608	309	48	17	11767	0	12141
4609	208	47	12008	178	0	12441
4610	76	11797	149	163	0	12185
4611	62	11478	139	63	0	11742
4612	11184	333	40	49	0	11606
4613	198	11478	24	63	0	11763
4614	156	201	14	10878	0	11249
4615	88	155	30	11091	0	11364
4616	75	56	11002	290	0	11423
4617	82	56	10876	161	0	11175
4618	61	10959	265	78	0	11363
4619	61	198	127	10898	0	11284
4620	10943	152	44	193	0	11332
4621	197	64	30	11099	0	11390
4622	166	67	11443	212	0	11888
4623	72	51	177	11233	0	11533
4624	10862	53	148	219	0	11282
4625	10898	55	36	177	0	11166
4626	302	10914	31	90	0	11337
4627	10958	210	28	53	0	11249
4628	223	10834	19	71	0	11147
4629	10778	204	30	64	0	11076
4630	243	194	16	10564	0	11017
4631	194	69	10553	211	0	11027
4632	108	55	10522	177	0	10862
4633	92	10828	261	66	0	11247
4634	70	165	194	10014	0	10443
4635	77	131	25	10219	0	10452
4636	10206	52	20	262	0	10540
4637	10209	54	20	172	0	10455
4638	10299	46	30	52	0	10427
4639	282	59	14	10069	0	10424
4640	165	52	21	10127	0	10365
4641	79	46	19	10372	0	10516
4642	60	45	10182	280	0	10567
4643	65	49	10081	157	0	10352
4644	9882	41	229	75	0	10227
4645	9957	60	131	51	0	10199
4646	281	43	9996	63	0	10383
4647	9744	54	146	60	0	10004
4648	9519	41	125	82	0	9767
4649	271	53	9524	69	0	9917
4650	163	9451	146	69	0	9829
4651	101	258	108	8751	0	9218
4652	83	105	9142	146	0	9476
4653	56	9374	136	123	0	9689
4654	58	129	89	8193	0	8469
4655	34	8716	32	118	0	8900
4656	48	240	8427	100	0	8815
4657	43	99	8629	63	0	8834
4658	53	151	167	8575	0	8946
4659	8613	24	97	140	0	8874
4660	131	39	36	8662	0	8868
4661	8450	33	22	134	0	8639
4662	143	38	27	8439	0	8647
4663	131	26	8579	142	0	8878
4664	8426	31	117	133	0	8707
4665	138	32	8481	57	0	8708
4666	8401	47	125	51	0	8624
4667	153	39	100	8131	0	8423
4668	125	8426	39	135	0	8725
4669	63	112	45	8438	0	8658
4670	57	8758	35	163	0	9013
4671	59	122	44	8328	0	8553
4672	60	8809	51	132	0	9052
4673	8685	132	43	116	0	8976
4674	8603	113	40	69	0	8825
4675	8591	48	47	68	0	8754
4676	231	34	8644	60	0	8969
4677	140	28	133	8651	0	8952
4678	65	38	8812	149	0	9064
4679	63	8562	134	143	0	8902
4680	67	8623	138	62	0	8890
4681	8350	182	48	56	0	8636
4682	159	106	8315	51	0	8631
4683	118	8153	118	75	0	8464
4684	65	113	120	8044	0	8342
4685	7873	98	49	137	0	8157
4686	114	8010	70	139	0	8333
4687	8167	110	53	62	0	8392
4688	149	108	8469	62	0	8788
4689	136	48	118	8494	0	8796
4690	59	34	122	8582	0	8797
4691	70	41	45	8962	0	9118
4692	58	8965	47	242	0	9312
4693	78	138	43	9194	0	9453
4694	60	106	9403	180	0	9749
4695	62	51	146	9317	0	9576
4696	52	28	129	9392	0	9601
4697	62	36	60	9283	0	9441
4698	57	9181	41	245	0	9524
4699	65	125	60	9281	0	9531
4700	63	116	40	9189	0	9408
4701	43	8552	53	215	0	8863
4702	7958	94	25	114	0	8191
4703	96	8079	32	43	0	8250
4704	86	7734	18	120	0	7958
4705	73	194	84	7642	0	7993
4706	74	89	7606	93	0	7862
4707	6776	20	80	86	0	6962
4708	91	11	72	7212	0	7386
4709	75	20	7050	91	0	7236
4710	28	7105	78	95	0	7306
4711	15	103	71	7170	0	7359
4712	15	84	7310	93	0	7502
4713	18	53	74	6835	0	6980
4714	14	23	72	6971	0	7080
4715	6721	13	15	139	0	6888
4716	65	6740	13	103	0	6921
4717	6790	70	13	31	0	6904
4718	82	72	6863	36	0	7053
4719	73	6874	65	36	0	7048
4720	31	74	6874	17	0	6996
4721	11	126	74	6779	0	6990
4722	6536	15	58	88	0	6697
4723	72	13	16	6564	0	6665
4724	6598	20	12	74	0	6704
4725	6582	15	7	78	0	6682
4726	119	17	17	6669	0	6822
4727	87	20	7156	86	0	7349
4728	27	15	7306	78	0	7426
4729	25	12	125	7402	0	7564
4730	14	19	73	7586	0	7692
4731	7553	14	18	152	0	7737
4732	88	15	17	7550	0	7670
4733	74	7611	9	93	0	7787
4734	32	77	14	7591	0	7714
4735	21	86	22	7513	0	7642
4736	7391	32	12	164	0	7599
4737	84	7581	16	101	0	7782
4738	98	88	16	7815	0	8017
4739	27	93	15	7810	0	7945
4740	19	7849	17	176	0	8061
4741	18	91	19	7993	0	8121
4742	28	89	12	7853	0	7982
4743	16	7838	15	178	0	8047
4744	22	94	17	8031	0	8164
4745	15	89	26	7928	0	8058
4746	11	7834	23	186	0	8054
4747	12	91	21	7971	0	8095
4748	7922	88	12	120	0	8142
4749	7897	22	16	112	0	8047
4750	7868	25	18	47	0	7958
4751	7980	26	9	60	0	8075
4752	160	7768	16	57	0	8001
4753	7084	82	13	31	0	7210
4754	85	7027	7	37	0	7156
4755	70	6986	12	35	0	7103
4756	72	152	8	6931	0	7163
4757	24	72	6970	95	0	7161
4758	6405	25	70	78	0	6578
4759	6655	19	57	32	0	6763
4760	123	13	7121	36	0	7293
4761	6969	24	82	34	0	7109
4762	7213	17	61	40	0	7331
4763	132	6993	17	42	0	7184
4764	8030	75	13	44	0	8162
4765	93	69	9	7988	0	8159
4766	83	14	6	7993	0	8096
4767	34	18	10	8059	0	8121
4768	29	19	8	8096	0	8152
4769	7976	15	11	164	0	8166
4770	89	22	7	7876	0	7994
4771	82	24	7	7889	0	8002
4772	23	25	7791	148	0	7987
4773	7042	22	80	90	0	7234
4774	7644	20	62	39	0	7765
4775	7813	16	22	40	0	7891
4776	150	7745	16	37	0	7948
4777	84	7714	16	35	0	7849
4778	7674	127	17	43	0	7861
4779	95	74	15	7628	0	7812
4780	68	7793	9	100	0	7970
4781	25	86	11	7815	0	7937
4782	25	7781	12	116	0	7934
4783	7812	88	6	97	0	8003
4784	93	7983	4	46	0	8126
4785	72	119	5	7951	0	8147
4786	35	69	3	8031	0	8138
4787	118	23	8105	146	0	8392
4788	22	8169	73	104	0	8368
4789	29	130	60	8435	0	8654
4790	31	68	8748	158	0	9005
4791	30	17	9147	88	0	9282
4792	26	108	229	8844	0	9207
4793	26	21	78	8902	0	9027
4794	26	8677	18	186	0	8907
4795	19	8919	12	105	0	9055
4796	26	179	10	8980	0	9195
4797	8936	97	8	117	0	9158
4798	108	36	5	9253	0	9402
4799	9718	20	12	131	0	9881
4800	9787	15	7	106	0	9915
4801	9926	22	4	39	0	9991
4802	210	26	10027	35	0	10298
4803	10050	20	107	35	0	10212
4804	140	28	90	10039	0	10297
4805	128	15	18	10116	0	10277
4806	46	16	10132	212	0	10406
4807	41	17	10093	121	0	10272
4808	33	16	190	9791	0	10030
4809	31	9863	105	139	0	10138
4810	23	10103	27	111	0	10264
4811	29	198	21	10098	0	10346
4812	10096	114	11	139	0	10360
4813	128	42	8	10138	0	10316
4814	117	31	15	10012	0	10175
4815	38	10203	13	213	0	10467
4816	37	113	8	10384	0	10542
4817	41	94	10303	218	0	10656
4818	35	37	10102	121	0	10295
4819	9663	26	190	47	0	9926
4820	127	10174	103	42	0	10446
4821	10262	115	33	34	0	10444
4822	10257	100	24	33	0	10414
4823	211	34	17	9781	0	10043
4824	118	10340	16	119	0	10593
4825	49	123	15	10408	0	10595
4826	10408	100	19	140	0	10667
4827	124	10039	15	126	0	10304
4828	9928	117	8	53	0	10106
4829	120	10043	16	44	0	10223
4830	10001	123	16	36	0	10176
4831	10042	88	11	40	0	10181
4832	195	10054	15	43	0	10307
4833	109	105	17	9841	0	10072
4834	9832	83	17	125	0	10057
4835	123	27	9755	99	0	10004
4836	87	19	9757	48	0	9911
4837	36	127	175	9429	0	9767
4838	9631	14	89	111	0	9845
4839	118	11	36	9653	0	9818
4840	9626	18	25	132	0	9801
4841	123	22	9991	102	0	10238
4842	10107	20	101	49	0	10277
4843	10480	24	70	40	0	10614
4844	185	23	27	10341	0	10576
4845	113	28	20	10313	0	10474
4846	48	38	12	10474	0	10572
4847	43	10461	10	193	0	10707
4848	37	106	17	10390	0	10550
4849	41	78	14	10450	0	10583
4850	10501	32	24	183	0	10740
4851	10427	16	18	114	0	10575
4852	193	21	10378	52	0	10644
4853	10229	19	102	42	0	10392
4854	143	23	10333	40	0	10539
4855	9788	23	134	46	0	9991
4856	128	20	10173	51	0	10372
4857	95	25	10055	54	0	10229
4858	44	97	166	9743	0	10050
4859	42	34	9973	131	0	10180
4860	9598	32	118	94	0	9842
4861	123	22	83	10040	0	10268
4862	10386	28	25	136	0	10575
4863	10399	45	21	110	0	10575
4864	9746	42	19	75	0	9882
4865	9622	27	27	56	0	9732
4866	197	15	9799	48	0	10059
4867	139	19	102	9636	0	9896
4868	80	21	9880	121	0	10102
4869	83	21	101	9806	0	10011
4870	9821	19	86	123	0	10049
4871	140	15	46	9903	0	10104
4872	10030	21	38	131	0	10220
4873	140	23	17	10016	0	10196
4874	104	25	26	10084	0	10239
4875	10007	34	44	178	0	10263
4876	116	10145	38	122	0	10421
4877	10223	111	27	61	0	10422
4878	129	10251	15	57	0	10452
4879	105	124	11	10576	0	10816
4880	10553	103	15	116	0	10787
4881	130	26	10598	122	0	10876
4882	117	23	92	10681	0	10913
4883	10622	28	90	148	0	10888
4884	10526	28	49	113	0	10716
4885	186	31	40	10458	0	10715
4886	118	10766	46	164	0	11094
4887	69	10899	43	104	0	11115
4888	116	401	75	10118	0	10710
4889	10171	104	51	102	0	10428
4890	122	9725	10	90	0	9947
4891	68	9068	3	33	0	9172
4892	8760	114	6	16	0	8896
4893	77	8782	7	48	0	8914
4894	8930	83	11	15	0	9039
4895	107	53	22	8902	0	9084
4896	63	43	4	8944	0	9054
4897	18	8924	8	127	0	9077
4898	13	8882	3	76	0	8974
4899	8240	99	36	15	0	8390
4900	71	8803	10	21	0	8905
4901	49	9807	4	21	0	9881
4902	93	140	4	9889	0	10126
4903	10116	85	3	99	0	10303
4904	116	17	10339	89	0	10561
4905	10330	9	115	21	0	10475
4906	129	8	95	11085	0	11317
4907	123	1	11323	120	0	11567
4908	35	8	11397	137	0	11577
4909	15	6	232	11341	0	11594
4910	23	3	11806	135	0	11967
4911	11551	4	146	134	0	11835
4912	11770	6	135	35	0	11946
4913	265	3	11901	28	0	12197
4914	157	7	140	11568	0	11872
4915	39	16	146	11695	0	11896
4916	11808	5	26	253	0	12092
4917	142	13	17	11474	0	11646
4918	140	11587	13	150	0	11890
4919	11579	136	8	140	0	11863
4920	139	11560	5	46	0	11750
4921	141	11827	5	24	0	11997
4922	34	260	6	11759	0	12059
4923	22	169	7	11622	0	11820
4924	16	39	5	11972	0	12032
4925	29	27	11707	274	0	12037
4926	10893	19	147	173	0	11232
4927	150	11470	131	57	0	11808
4928	11684	141	33	43	0	11901
4929	11498	134	31	20	0	11683
4930	284	31	26	11408	0	11749
4931	166	11368	24	153	0	11711
4932	64	138	28	11466	0	11696
4933	51	136	12	11705	0	11904
4934	11811	42	19	275	0	12147
4935	11563	31	29	188	0	11811
4936	299	27	11719	72	0	12117
4937	11877	21	140	46	0	12084
4938	192	11979	142	47	0	12360
4939	12179	156	35	32	0	12402
4940	189	12666	27	34	0	12916
4941	186	182	25	11837	0	12230
4942	48	198	15	11895	0	12156
4943	41	12148	17	325	0	12531
4944	41	182	18	12242	0	12483
4945	46	172	17	12227	0	12462
4946	46	57	13	12079	0	12195
4947	35	11964	26	396	0	12421
4948	45	209	20	11993	0	12267
4949	30	194	22	11880	0	12126
4950	53	66	11	12215	0	12345
4951	48	44	11835	371	0	12298
4952	11365	44	164	236	0	11809
4953	198	52	11950	85	0	12285
4954	11749	45	192	78	0	12064
4955	230	75	11941	66	0	12312
4956	11689	52	196	56	0	11993
4957	11858	47	196	63	0	12164
4958	375	49	11930	61	0	12415
4959	235	55	187	11815	0	12292
4960	117	57	11693	200	0	12067
4961	11092	52	208	220	0	11572
4962	217	50	11821	97	0	12185
4963	228	42	11461	92	0	11823
4964	11143	42	346	107	0	11638
4965	218	11449	237	75	0	11979
4966	217	183	95	11292	0	11787
4967	11329	206	62	243	0	11840
4968	230	67	77	11343	0	11717
4969	231	56	66	11473	0	11826
4970	11230	41	72	401	0	11744
4971	11199	44	54	287	0	11584
4972	383	41	11170	151	0	11745
4973	272	41	11188	105	0	11606
4974	133	48	354	11115	0	11650
4975	107	44	11409	285	0	11845
4976	102	52	231	11087	0	11472
4977	100	49	225	10870	0	11244
4978	112	54	84	11380	0	11630
4979	10739	68	63	418	0	11288
4980	222	10887	73	292	0	11474
4981	10918	210	41	161	0	11330
4982	10779	207	49	132	0	11167
4983	371	10810	56	137	0	11374
4984	10872	212	50	113	0	11247
4985	264	190	10670	108	0	11232
4986	246	115	162	10162	0	10685
4987	10406	65	163	215	0	10849
4988	220	65	10417	214	0	10916
4989	10154	40	162	110	0	10466
4990	201	10250	176	141	0	10768
4991	11903	141	67	94	0	12205
4992	11890	161	86	77	0	12214
4993	421	12063	48	88	0	12620
4994	12454	177	72	60	0	12763
4995	303	209	64	12216	0	12792
4996	304	74	51	12382	0	12811
4997	12226	60	63	378	0	12727
4998	11695	61	42	303	0	12101
4999	392	12144	49	161	0	12746
5000	275	11888	37	120	0	12320
5001	87	392	35	10249	0	10763
5002	65	10534	41	155	0	10795
5003	55	10499	33	192	0	10779
5004	9885	305	63	63	0	10316
5005	138	10241	26	65	0	10470
5006	9404	135	26	37	0	9602
5007	137	9859	14	54	0	10064
5008	135	132	9807	55	0	10129
5009	49	9960	104	55	0	10168
5010	9343	201	228	46	0	9818
5011	9075	100	39	37	0	9251
5012	179	30	9273	29	0	9511
5013	135	19	91	8844	0	9089
5014	56	20	111	9264	0	9451
5015	45	11	9423	173	0	9652
5016	38	15	84	9294	0	9431
5017	32	17	9456	121	0	9626
5018	39	9	9273	126	0	9447
5019	9117	17	177	50	0	9361
5020	100	9343	128	41	0	9612
5021	9297	74	44	22	0	9437
5022	128	108	47	9227	0	9510
5023	135	37	9362	86	0	9620
5024	63	27	86	9016	0	9192
5025	46	9299	109	111	0	9565
5026	9347	87	36	115	0	9585
5027	9370	112	29	50	0	9561
5028	190	33	24	9505	0	9752
5029	135	27	9457	104	0	9723
5030	9010	26	76	122	0	9234
5031	120	9368	104	43	0	9635
5032	9342	95	31	28	0	9496
5033	137	124	14	9209	0	9484
5034	9093	50	17	84	0	9244
5035	143	27	7	8984	0	9161
5036	149	37	8916	112	0	9214
5037	71	26	8865	135	0	9097
5038	8399	19	150	65	0	8633
5039	96	9055	112	39	0	9302
5040	8810	79	72	26	0	8987
5041	8852	104	14	18	0	8988
5042	138	8900	11	28	0	9077
5043	8693	86	6	30	0	8815
5044	99	115	10050	26	0	10290
5045	105	62	48	9969	0	10184
5046	52	45	79	10033	0	10209
5047	34	50	21	10300	0	10405
5048	51	35	10269	145	0	10500
5049	31	39	10205	104	0	10379
5050	31	46	133	10031	0	10241
5051	39	10165	107	64	0	10375
5052	38	10531	36	86	0	10691
5053	10666	146	27	32	0	10871
5054	10643	112	25	33	0	10813
5055	144	11155	30	49	0	11378
5056	115	72	32	11215	0	11434
5057	44	94	27	11250	0	11415
5058	11376	37	34	163	0	11610
5059	93	19	43	11924	0	12079
5060	108	27	38	11755	0	11928
5061	65	30	25	11996	0	12116
5062	57	27	11600	177	0	11861
5063	51	28	11286	130	0	11495
5064	11549	24	157	72	0	11802
5065	95	20	130	12160	0	12405
5066	121	26	12214	107	0	12468
5067	62	44	11971	117	0	12194
5068	11814	38	172	66	0	12090
5069	125	29	13541	51	0	13746
5070	127	13665	114	48	0	13954
5071	64	94	126	15128	0	15412
5072	73	122	15327	110	0	15632
5073	15146	63	110	152	0	15471
5074	153	31	137	16123	0	16444
5075	180	28	16185	139	0	16532
5076	71	24	139	16160	0	16394
5077	41	24	173	16399	0	16637
5078	16400	16	59	287	0	16762
5079	141	16719	52	202	0	17114
5080	185	122	48	16596	0	16951
5081	16614	168	24	149	0	16955
5082	16563	53	33	187	0	16836
5083	16883	35	28	64	0	17010
5084	17130	32	29	53	0	17244
5085	326	26	47	16871	0	17270
5086	16808	31	40	154	0	17033
5087	16478	20	35	209	0	16742
5088	15924	43	46	88	0	16101
5089	16408	24	35	76	0	16543
5090	309	16075	49	75	0	16508
5091	121	14687	21	17	0	14846
5092	25	220	18	14495	0	14758
5093	16	14501	23	93	0	14633
5094	14543	83	45	109	0	14780
5095	85	102	10	14507	0	14704
5096	14738	16	12	95	0	14861
5097	14724	11	11	113	0	14859
5098	177	17	16	15297	0	15507
5099	125	7	14	15241	0	15387
5100	35	15384	17	200	0	15636
5101	15505	78	15	119	0	15717
5102	105	15553	14	41	0	15713
5103	15609	93	17	41	0	15760
5104	116	97	11	15653	0	15877
5105	142	14	15335	222	0	15713
5106	15248	18	90	116	0	15472
5107	14528	20	99	46	0	14693
5108	224	15	14600	38	0	14877
5109	155	19	14840	22	0	15036
5110	70	31	178	14411	0	14690
5111	15893	16	110	122	0	16141
5112	16232	19	36	126	0	16413
5113	16934	34	27	61	0	17056
5114	17311	28	19	51	0	17409
5115	282	17090	21	55	0	17448
5116	17603	130	18	45	0	17796
5117	199	134	10	17332	0	17675
5118	178	39	25	17704	0	17946
5119	80	41	25	18374	0	18520
5120	76	25	22	18633	0	18756
5121	18364	29	31	303	0	18727
5122	183	30	28	19126	0	19367
5123	194	31	18879	211	0	19315
5124	75	34	150	19587	0	19846
5125	91	22	155	19627	0	19895
5126	74	32	46	19587	0	19739
5127	79	22	34	19713	0	19848
5128	19335	31	34	372	0	19772
5129	222	19283	23	232	0	19760
5130	225	19411	28	87	0	19751
5131	107	312	37	19411	0	19867
5132	19092	203	46	211	0	19552
5133	19296	54	60	229	0	19639
5134	391	41	24	19584	0	20040
5135	278	27	19416	220	0	19941
5136	19279	28	173	244	0	19724
5137	254	40	173	19991	0	20458
5138	272	42	20113	233	0	20660
5139	18912	48	169	254	0	19383
5140	274	19766	178	137	0	20355
5141	21869	182	40	113	0	22204
5142	331	22519	33	118	0	23001
5143	353	269	17	22397	0	23036
5144	172	22440	17	306	0	22935
5145	138	306	29	22933	0	23406
5146	22205	288	28	357	0	22878
5147	329	22436	20	512	0	23297
5148	350	269	22556	154	0	23329
5149	179	340	236	22460	0	23215
5150	151	74	23027	350	0	23602
5151	145	66	285	22076	0	22572
5152	128	48	280	22788	0	23244
5153	120	79	22411	544	0	23154
5154	20654	62	279	373	0	21368
5155	346	59	22346	172	0	22923
5156	366	55	22188	126	0	22735
5157	165	22295	483	165	0	23108
5158	123	301	315	21860	0	22599
5159	135	298	79	21814	0	22326
5160	121	116	56	21786	0	22079
5161	107	76	45	22427	0	22655
5162	109	66	21849	628	0	22652
5163	20295	68	282	424	0	21069
5164	357	53	21916	202	0	22528
5165	331	66	291	21465	0	22153
5166	21348	56	303	333	0	22040
5167	320	21673	97	381	0	22471
5168	352	407	66	21284	0	22109
5169	20500	279	81	314	0	21174
5170	288	20204	55	369	0	20916
5171	279	19293	60	137	0	19769
5172	19148	425	75	93	0	19741
5173	249	19569	47	118	0	19983
5174	18941	262	73	92	0	19368
5175	275	19352	39	99	0	19765
5176	19512	268	38	92	0	19910
5177	19457	232	53	98	0	19840
5178	442	20052	49	96	0	20639
5179	304	234	48	19757	0	20343
5180	103	241	19581	283	0	20208
5181	18843	79	245	287	0	19454
5182	264	56	237	19222	0	19779
5183	250	18904	84	282	0	19520
5184	85	19291	67	302	0	19745
5185	80	405	51	19364	0	19900
5186	19453	268	59	289	0	20069
5187	243	88	19784	312	0	20427
5188	266	68	232	19750	0	20316
5189	106	56	259	19810	0	20231
5190	82	62	86	20152	0	20382
5191	94	45	64	19888	0	20091
5192	49	19483	60	678	0	20270
5193	70	242	53	20041	0	20406
5194	113	267	19400	334	0	20114
5195	97	119	18893	315	0	19424
5196	97	78	19347	134	0	19656
5197	102	112	449	18908	0	19571
5198	18619	85	311	290	0	19305
5199	296	79	18788	300	0	19463
5200	313	113	18891	136	0	19453
5201	118	90	449	18423	0	19080
5202	18896	82	299	300	0	19577
5203	281	18791	134	312	0	19518
5204	18983	272	100	180	0	19535
5205	307	286	89	18755	0	19437
5206	299	127	19020	299	0	19745
5207	142	147	243	18296	0	18828
5208	106	19061	298	309	0	19774
5209	19492	268	137	329	0	20226
5210	275	297	19543	193	0	20308
5211	272	18907	239	144	0	19562
5212	18701	246	256	127	0	19330
5213	233	278	104	18342	0	18957
5214	285	120	110	18522	0	19037
5215	18601	65	92	511	0	19269
5216	18324	51	93	388	0	18856
5217	19072	77	102	148	0	19399
5218	523	92	92	18341	0	19048
5219	368	18173	66	313	0	18920
5220	18309	243	91	318	0	18961
5221	261	18468	71	184	0	18984
5222	17806	263	70	119	0	18258
5223	292	17624	87	102	0	18105
5224	318	279	63	16824	0	17484
5225	16980	265	61	243	0	17549
5226	16756	137	51	281	0	17225
5227	17060	90	46	133	0	17329
5228	17187	99	39	99	0	17424
5229	17102	74	44	95	0	17315
5230	537	63	16747	86	0	17433
5231	371	86	214	16489	0	17160
5232	154	79	16869	254	0	17356
5233	138	67	16605	281	0	17091
5234	16427	83	423	118	0	17051
5235	16570	67	301	120	0	17058
5236	16495	76	105	89	0	16765
5237	517	152	62	15985	0	16716
5238	16034	79	38	266	0	16417
5239	346	15796	45	293	0	16480
5240	293	15833	61	178	0	16365
5241	110	14237	37	74	0	14458
5242	13330	287	142	57	0	13816
5243	177	13609	26	51	0	13863
5244	12998	146	91	33	0	13268
5245	12587	164	17	34	0	12802
5246	304	49	12582	37	0	12972
5247	218	35	125	12144	0	12522
5248	95	38	155	12683	0	12971
5249	12855	26	40	266	0	13187
5250	12748	27	33	190	0	12998
5251	319	29	25	12702	0	13075
5252	236	30	12599	157	0	13022
5253	105	28	12580	181	0	12894
5254	85	30	276	12499	0	12890
5255	82	30	187	12268	0	12567
5256	87	31	51	12654	0	12823
5257	12255	37	25	309	0	12626
5258	12309	36	23	206	0	12574
5259	314	12274	25	80	0	12693
5260	239	159	30	12263	0	12691
5261	115	177	29	12255	0	12576
5262	138	12392	25	276	0	12831
5263	85	174	26	12536	0	12821
5264	12470	195	33	199	0	12897
5265	219	78	33	12475	0	12805
5266	232	45	34	12523	0	12834
5267	12234	47	29	303	0	12613
5268	12145	53	41	215	0	12454
5269	12441	37	29	88	0	12595
5270	396	47	38	12173	0	12654
5271	279	39	11921	192	0	12431
5272	143	39	11652	204	0	12038
5273	149	88	11558	103	0	11898
5274	119	11280	285	80	0	11764
5275	10868	158	208	59	0	11293
5276	225	147	10506	64	0	10942
5277	10249	57	133	72	0	10511
5278	232	36	133	9933	0	10334
5279	9932	52	53	174	0	10211
5280	10075	43	42	186	0	10346
5281	301	10102	29	99	0	10531
5282	10284	140	32	85	0	10541
5283	10180	149	36	91	0	10456
5284	324	10003	29	90	0	10446
5285	250	144	35	10129	0	10558
5286	144	130	10105	178	0	10557
5287	121	56	140	9663	0	9980
5288	110	40	148	9796	0	10094
5289	9803	50	59	291	0	10203
5290	216	33	43	9831	0	10123
5291	210	10015	44	205	0	10474
5292	137	159	49	9873	0	10218
5293	118	157	47	10224	0	10546
5294	113	64	10027	304	0	10508
5295	117	9927	149	227	0	10420
5296	110	9975	154	112	0	10351
5297	9659	259	62	85	0	10065
5298	222	9996	48	113	0	10379
5299	210	196	51	9993	0	10450
5300	144	162	10033	204	0	10543
5301	107	10045	167	187	0	10506
5302	9932	176	171	94	0	10373
5303	231	159	78	9774	0	10242
5304	230	59	52	10106	0	10447
5305	141	46	9982	319	0	10488
5306	112	46	173	9661	0	9992
5307	101	35	152	9898	0	10186
5308	9672	48	75	328	0	10123
5309	8800	39	45	229	0	9113
5310	310	8831	36	137	0	9314
5311	7861	125	33	72	0	8091
5312	168	7496	38	57	0	7759
5313	109	144	22	6844	0	7119
5314	61	7117	31	135	0	7344
5315	48	7301	35	122	0	7506
5316	6876	223	156	132	0	7387
5317	6685	86	18	80	0	6869
5318	162	6603	18	53	0	6836
5319	6682	93	17	43	0	6835
5320	6588	77	17	45	0	6727
5321	6694	36	17	49	0	6796
5322	174	30	19	6772	0	6995
5323	6859	31	17	119	0	7026
5324	118	32	6693	106	0	6949
5325	6663	27	91	49	0	6830
5326	125	29	6763	47	0	6964
5327	99	35	99	6535	0	6768
5328	62	31	79	6735	0	6907
5329	50	28	6780	151	0	7009
5330	6670	30	96	108	0	6904
5331	6844	35	71	55	0	7005
5332	174	25	7158	51	0	7408
5333	107	25	100	7011	0	7243
5334	54	26	82	7092	0	7254
5335	45	35	31	7260	0	7371
5336	7153	29	29	174	0	7385
5337	7134	30	22	103	0	7289
5338	167	35	20	6920	0	7142
5339	104	6854	19	111	0	7088
5340	57	6577	15	80	0	6729
5341	6165	134	20	36	0	6355
5342	88	6273	12	37	0	6410
5343	60	6000	12	57	0	6129
5344	30	89	10	5617	0	5746
5345	30	51	5763	70	0	5914
5346	20	5771	49	57	0	5897
5347	24	54	65	5558	0	5701
5348	71	5746	20	60	0	5897
5349	22	60	82	5544	0	5708
5350	5454	40	11	67	0	5572
5351	57	5659	14	49	0	5779
5352	5676	64	3	25	0	5768
5353	5503	40	11	27	0	5581
5354	87	20	5582	17	0	5706
5355	5460	30	44	22	0	5556
5356	64	75	33	5561	0	5733
5357	40	20	5746	50	0	5856
5358	26	5717	43	37	0	5823
5359	29	123	69	5498	0	5719
5360	15	30	13	5523	0	5581
5361	5513	16	9	78	0	5616
5362	51	12	15	5497	0	5575
5363	39	12	7	5519	0	5577
5364	5469	12	5	78	0	5564
5365	62	5451	7	47	0	5567
5366	5453	48	8	37	0	5546
5367	62	39	5380	23	0	5504
5368	5049	18	34	16	0	5117
5369	51	20	5589	13	0	5673
5370	35	5533	37	17	0	5622
5371	5478	42	31	18	0	5569
5372	5267	36	15	14	0	5332
5373	74	18	5441	16	0	5549
5374	55	14	5337	8	0	5414
5375	33	19	5512	14	0	5578
5376	25	5709	56	22	0	5812
5377	27	36	27	5972	0	6062
5378	32	34	6585	47	0	6698
5379	25	19	6331	41	0	6416
5380	32	8	82	6382	0	6504
5381	25	16	6573	50	0	6664
5382	6443	13	56	60	0	6572
5383	7955	12	63	24	0	8054
5384	129	14	8049	19	0	8211
5385	101	8032	63	32	0	8228
5386	33	63	87	7889	0	8072
5387	31	74	8089	71	0	8265
5388	28	8135	63	97	0	8323
5389	78	58	82	8037	0	8255
5390	7810	69	19	63	0	7961
5391	7756	14	8	80	0	7858
5392	119	7934	16	22	0	8091
5393	86	51	14	7836	0	7987
5394	27	72	11	7819	0	7929
5395	15	20	14	7861	0	7910
5396	16	10	12	8011	0	8049
5397	21	14	7914	133	0	8082
5398	12	7	53	7940	0	8012
5399	23	12	7793	79	0	7907
5400	8	7451	52	90	0	7601
5401	7429	39	72	24	0	7564
5402	37	7725	22	12	0	7796
5403	67	57	4	7646	0	7774
5404	16	63	4	7545	0	7628
5405	7603	15	8	109	0	7735
5406	47	7	6	7598	0	7658
5407	66	7584	7	58	0	7715
5408	16	42	10	7712	0	7780
5409	8	68	8	7646	0	7730
5410	7590	18	10	100	0	7718
5411	46	14	7606	82	0	7748
5412	67	7492	42	28	0	7629
5413	18	7605	62	17	0	7702
5414	10	87	10	7408	0	7515
5415	7284	66	2	37	0	7389
5416	36	7428	5	79	0	7548
5417	54	37	7	7525	0	7623
5418	14	63	7467	43	0	7587
5419	3	11	36	7473	0	7523
5420	7435	6	58	50	0	7549
5421	7345	2	15	68	0	7430
5422	91	8	7	7365	0	7471
5423	7688	8	8	38	0	7742
5424	7483	14	12	66	0	7575
5425	91	11	7700	22	0	7824
5426	7562	7	34	24	0	7627
5427	40	7702	59	18	0	7819
5428	7811	36	6	22	0	7875
5429	47	56	7697	12	0	7812
5430	62	11	38	7785	0	7896
5431	8058	9	61	50	0	8178
5432	54	11	7876	69	0	8010
5433	70	8	7907	19	0	8004
5434	17	10	119	7784	0	7930
5435	10	9	8025	67	0	8111
5436	7783	7	72	71	0	7933
5437	72	7	8175	25	0	8279
5438	68	11	71	8295	0	8445
5439	15	13	70	8444	0	8542
5440	8933	5	11	149	0	9098
5441	95	2	8954	90	0	9141
5442	89	7	9520	22	0	9638
5443	18	8	166	10141	0	10333
5444	17	6	10187	122	0	10332
5445	9778	10	121	109	0	10018
5446	116	10	98	9862	0	10086
5447	109	9	9941	111	0	10170
5448	26	17	122	9646	0	9811
5449	15	8	104	9821	0	9948
5450	9932	11	28	196	0	10167
5451	127	12	9855	116	0	10110
5452	9632	9	128	37	0	9806
5453	142	13	10121	19	0	10295
5454	9705	6	133	26	0	9870
5455	9779	7	112	23	0	9921
5456	9839	7	35	22	0	9903
5457	219	9621	17	26	0	9883
5458	9830	110	22	20	0	9982
5459	9725	97	21	20	0	9863
5460	213	19	20	9733	0	9985
5461	127	8	9696	133	0	9964
5462	9397	10	136	122	0	9665
5463	146	8	10052	31	0	10237
5464	116	8	130	9703	0	9957
5465	33	7	127	10042	0	10209
5466	9960	5	37	219	0	10221
5467	130	10028	30	141	0	10329
5468	122	111	30	9886	0	10149
5469	39	97	25	9908	0	10069
5470	35	57	9937	228	0	10257
5471	32	9	129	9915	0	10085
5472	22	12	125	9982	0	10141
5473	37	9	35	9593	0	9674
5474	28	9890	37	220	0	10175
5475	9752	115	35	122	0	10024
5476	9497	104	33	44	0	9678
5477	225	9472	26	43	0	9766
5478	8843	111	23	36	0	9013
5479	139	95	25	9042	0	9301
5480	108	16	9319	140	0	9583
5481	27	9461	131	121	0	9740
5482	29	9576	92	48	0	9745
5483	8547	149	105	26	0	8827
5484	9014	64	30	21	0	9129
5485	173	15	38	9042	0	9268
5486	99	9	19	9108	0	9235
5487	35	8	25	9153	0	9221
5488	8896	10	14	204	0	9124
5489	144	13	8803	112	0	9072
5490	8760	11	130	42	0	8943
5491	147	14	102	8703	0	8966
5492	98	8	43	8759	0	8908
5493	63	8780	38	193	0	9074
5494	45	102	32	9110	0	9289
5495	44	80	36	9246	0	9406
5496	59	18	9466	209	0	9752
5497	44	9432	137	129	0	9742
5498	9860	125	90	67	0	10142
5499	9687	79	50	49	0	9865
5500	9901	33	39	60	0	10033
5501	9991	26	62	50	0	10129
5502	250	16	9794	54	0	10114
5503	9646	12	153	76	0	9887
5504	186	10	10012	56	0	10264
5505	128	24	148	9586	0	9886
5506	69	10074	111	162	0	10416
5507	78	129	50	10021	0	10278
5508	68	87	35	10164	0	10354
5509	75	35	10060	238	0	10408
5510	9319	25	165	140	0	9649
5511	9744	27	117	77	0	9965
5512	232	9756	65	90	0	10143
5513	134	133	9884	78	0	10229
5514	98	102	161	9764	0	10125
5515	93	51	10012	171	0	10327
5516	84	30	9720	136	0	9970
5517	74	44	206	9651	0	9975
5518	93	32	9778	178	0	10081
5519	98	31	157	9666	0	9952
5520	90	41	10073	179	0	10383
5521	87	29	175	9870	0	10161
5522	10031	25	112	207	0	10375
5523	9728	22	79	152	0	9981
5524	9761	42	33	101	0	9937
5525	9737	45	49	101	0	9932
5526	262	9812	31	88	0	10193
5527	160	160	36	9794	0	10150
5528	113	90	42	9926	0	10171
5529	65	58	9747	271	0	10141
5530	64	46	154	9546	0	9810
5531	81	49	9646	200	0	9976
5532	77	22	9160	139	0	9398
5533	8833	39	189	82	0	9143
5534	147	9605	115	88	0	9955
5535	9657	114	39	98	0	9908
5536	9631	103	50	57	0	9841
5537	212	10063	39	85	0	10399
5538	10059	114	111	83	0	10367
5539	209	82	10426	67	0	10784
5540	108	10176	109	58	0	10451
5541	10195	110	90	59	0	10454
5542	124	81	9625	43	0	9873
5543	8812	66	64	40	0	8982
5544	82	9369	49	52	0	9552
5545	9374	63	31	42	0	9510
5546	9242	53	25	46	0	9366
5547	125	9273	36	37	0	9471
5548	80	9351	21	37	0	9489
5549	48	9670	33	26	0	9777
5550	36	108	33	9571	0	9748
5551	33	60	27	9704	0	9824
5552	9829	29	38	124	0	10020
5553	9493	20	33	97	0	9643
5554	122	20	9710	46	0	9898
5555	80	21	9492	55	0	9648
5556	45	15	9833	38	0	9931
5557	35	18	130	9753	0	9936
5558	46	15	10152	84	0	10297
5559	56	12	95	10013	0	10176
5560	10329	12	68	87	0	10496
5561	115	10	10515	60	0	10700
5562	10139	26	85	42	0	10292
5563	10502	16	78	75	0	10671
5564	142	15	10953	50	0	11160
5565	74	11674	97	50	0	11895
5566	48	80	88	11866	0	12082
5567	35	73	12092	107	0	12307
5568	38	30	109	12034	0	12211
5569	43	15	95	12916	0	13069
5570	12747	21	47	170	0	12985
5571	126	16	29	12813	0	12984
5572	131	25	12786	108	0	13050
5573	53	30	104	12708	0	12895
5574	12843	22	107	115	0	13087
5575	108	13277	51	110	0	13546
5576	13341	107	36	44	0	13528
5577	119	123	44	13248	0	13534
5578	104	24	13585	114	0	13827
5579	61	12	13342	95	0	13510
5580	49	26	13527	42	0	13644
5581	56	13078	164	36	0	13334
5582	12812	74	88	43	0	13017
5583	77	12746	31	23	0	12877
5584	12041	64	9	13	0	12127
5585	66	12235	7	19	0	12327
5586	54	68	13	12221	0	12356
5587	18	52	11	12285	0	12366
5588	9	15	9	12370	0	12403
5589	6	12541	10	120	0	12677
5590	9	65	5	13142	0	13221
5591	6	53	11	14909	0	14979
5592	16104	14	7	188	0	16313
5593	148	10	7	16982	0	17147
5594	124	9	18098	170	0	18401
5595	17468	11	173	141	0	17793
5596	18167	10	151	33	0	18361
5597	308	18705	32	62	0	19107
5598	18595	191	15	19	0	18820
5599	18778	158	21	24	0	18981
5600	354	33	16	18424	0	18827
5601	195	16	14	18596	0	18821
5602	43	19	14	19126	0	19202
5603	18780	18	12	375	0	19185
5604	18728	23	20	200	0	18971
5605	374	17	18808	50	0	19249
5606	18457	17	201	34	0	18709
5607	18395	18	177	29	0	18619
5608	18764	23	36	28	0	18851
5609	401	12	18321	42	0	18776
5610	224	10	18487	36	0	18757
5611	56	17	371	18465	0	18909
5612	35	12	19107	221	0	19375
5613	43	16	251	18448	0	18758
5614	66	37	200	17315	0	17618
5615	47	19132	45	353	0	19577
5616	19105	223	36	177	0	19541
5617	278	178	19184	48	0	19688
5618	19388	37	237	48	0	19710
5619	294	26	201	19645	0	20166
5620	19419	21	51	274	0	19765
5621	313	19183	30	250	0	19776
5622	269	19640	21	85	0	20015
5623	102	412	41	19515	0	20070
5624	85	235	29	19790	0	20139
5625	113	36	19576	488	0	20213
5626	97	27	251	19529	0	19904
5627	19105	17	237	330	0	19689
5628	319	19334	71	287	0	20011
5629	283	246	19319	112	0	19960
5630	141	267	300	19091	0	19799
5631	124	42	19438	305	0	19909
5632	122	26	313	19161	0	19622
5633	112	38	19333	322	0	19805
5634	101	32	18744	274	0	19151
5635	91	29	488	18528	0	19136
5636	18679	23	274	323	0	19299
5637	18056	41	127	266	0	18490
5638	18108	47	65	118	0	18338
5639	523	17777	71	97	0	18468
5640	17912	286	46	85	0	18329
5641	17610	238	65	100	0	18013
5642	537	68	17505	104	0	18214
5643	312	17330	266	120	0	18028
5644	148	272	237	16987	0	17644
5645	16981	235	79	313	0	17608
5646	300	17038	58	307	0	17703
5647	17339	289	69	122	0	17819
5648	17110	240	74	121	0	17545
5649	16956	77	84	121	0	17238
5650	17046	63	92	112	0	17313
5651	539	58	76	16481	0	17154
5652	16621	51	94	324	0	17090
5653	343	70	102	16375	0	16890
5654	296	16252	83	353	0	16984
5655	135	261	90	16438	0	16924
5656	16211	209	107	358	0	16885
5657	332	60	16248	326	0	16966
5658	307	41	318	16052	0	16718
5659	15986	43	251	321	0	16601
5660	360	15725	98	360	0	16543
5661	15825	262	108	114	0	16309
5662	15609	230	82	107	0	16028
5663	549	15416	99	94	0	16158
5664	15407	275	77	104	0	15863
5665	401	226	14191	89	0	14907
5666	328	96	13942	82	0	14448
5667	13771	68	443	112	0	14394
5668	348	71	13750	100	0	14269
5669	304	61	262	12249	0	12876
5670	180	12666	210	248	0	13304
5671	12639	247	70	224	0	13180
5672	335	12737	58	103	0	13233
5673	299	12841	81	125	0	13346
5674	209	366	74	13028	0	13677
5675	156	203	75	12784	0	13218
5676	178	77	67	12752	0	13074
5677	162	60	66	12959	0	13247
5678	120	79	12393	450	0	13042
5679	134	75	237	12082	0	12528
5680	123	61	200	12068	0	12452
5681	11827	72	89	404	0	12392
5682	302	68	76	12007	0	12453
5683	294	52	11706	301	0	12353
5684	11332	79	253	222	0	11886
5685	316	110	206	11303	0	11935
5686	306	70	11630	269	0	12275
5687	163	117	303	11158	0	11741
5688	142	11480	206	264	0	12092
5689	11546	233	107	205	0	12091
5690	409	190	10914	80	0	11593
5691	200	9217	172	62	0	9651
5692	7736	172	207	47	0	8162
5693	133	7013	84	50	0	7280
5694	98	5736	76	27	0	5937
5695	5724	133	22	26	0	5905
5696	87	5183	43	26	0	5339
5697	59	4712	15	23	0	4809
5698	79	127	27	4583	0	4816
5699	26	44	4602	58	0	4730
5700	24	4665	48	61	0	4798
5701	16	39	32	4231	0	4318
5702	23	4329	14	46	0	4412
5703	4318	35	9	50	0	4412
5704	54	31	4290	19	0	4394
5705	47	12	34	4258	0	4351
5706	4354	13	25	53	0	4445
5707	57	10	12	4504	0	4583
5708	46	8	4485	51	0	4590
5709	4304	13	41	40	0	4398
5710	4407	12	35	21	0	4475
5711	66	4491	15	24	0	4596
5712	40	44	11	4376	0	4471
5713	24	35	12	4421	0	4492
5714	4574	15	12	66	0	4667
5715	4464	21	13	38	0	4536
5716	82	17	4557	11	0	4667
5717	35	4361	41	13	0	4450
5718	4146	33	14	7	0	4200
5719	33	16	4	4070	0	4123
5720	22	8	4223	34	0	4287
5721	37	10	4087	21	0	4155
5722	40	48	30	3859	0	3977
5723	3869	0	13	18	0	3900
5724	16	3876	5	16	0	3913
5725	4290	16	1	5	0	4312
5726	22	10	0	4380	0	4412
5727	11	5	1	4440	0	4457
5728	3	3	3	4509	0	4518
5729	4437	2	2	33	0	4474
5730	19	4517	2	21	0	4559
5731	12	19	1	4585	0	4617
5732	3	11	2	4605	0	4621
5733	4	5	4710	40	0	4759
5734	3	1	19	4625	0	4648
5735	9	2	4764	23	0	4798
5736	3	4754	17	21	0	4795
5737	3	14	15	4858	0	4890
5738	4834	15	2	23	0	4874
5739	24	3	4641	15	0	4683
5740	17	2	19	4689	0	4727
5741	4	2	4791	22	0	4819
5742	4564	7	23	21	0	4615
5743	23	2	4920	9	0	4954
5744	14	6	25	4769	0	4814
5745	4866	4	16	25	0	4911
5746	28	4463	9	31	0	4531
5747	4763	21	3	8	0	4795
5748	28	4714	6	10	0	4758
5749	19	24	5	4957	0	5005
5750	12	16	5173	25	0	5226
5751	5	9	5432	22	0	5468
5752	8	3	35	5428	0	5474
5753	5508	5	19	31	0	5563
5754	5319	3	11	23	0	5356
5755	34	44	5	5406	0	5489
5756	27	33	5	5508	0	5573
5757	5450	5	5	49	0	5509
5758	21	5519	12	34	0	5586
5759	23	5711	5	18	0	5757
5760	5926	38	12	9	0	5985
5761	37	23	6100	21	0	6181
5762	24	8	34	5979	0	6045
5763	17	9	6082	38	0	6146
5764	9	2	31	6017	0	6059
5765	9	7	6143	43	0	6202
5766	6	5	6081	26	0	6118
5767	7	9	45	5966	0	6027
5768	8	5904	32	37	0	5981
5769	6221	30	10	29	0	6290
5770	34	6207	11	15	0	6267
5771	30	41	6	6132	0	6209
5772	6243	21	10	37	0	6311
5773	33	15	9	6142	0	6199
5774	6213	6	8	40	0	6267
5775	6094	6	11	41	0	6152
5776	6198	5	11	23	0	6237
5777	53	6102	14	51	0	6220
5778	6271	29	11	19	0	6330
5779	45	23	5	6305	0	6378
5780	6423	12	5	39	0	6479
5781	43	6	5	6579	0	6633
5782	6514	6	10	53	0	6583
5783	6512	5	9	42	0	6568
5784	66	6620	7	29	0	6722
5785	39	42	9	7306	0	7396
5786	22	36	8	7208	0	7274
5787	17	7598	11	90	0	7716
5788	19	92	14	7751	0	7876
5789	7709	55	12	116	0	7892
5790	7872	14	14	71	0	7971
5791	7850	12	10	30	0	7902
5792	122	12	8404	14	0	8552
5793	8479	8	61	23	0	8571
5794	8812	6	73	22	0	8913
5795	8895	10	20	16	0	8941
5796	129	8996	11	20	0	9156
5797	90	62	15	8952	0	9119
5798	31	94	7	9123	0	9255
5799	31	17	11	9085	0	9144
5800	19	12	9091	136	0	9258
5801	18	8	60	9213	0	9299
5802	9306	10	77	85	0	9478
5803	86	7	22	9317	0	9432
5804	86	23	16	9678	0	9803
5805	36	11	9686	172	0	9905
5806	28	9565	84	175	0	9852
5807	9820	78	78	38	0	10014
5808	88	80	24	9753	0	9945
5809	9813	25	15	94	0	9947
5810	118	11	9714	93	0	9936
5811	9227	16	73	45	0	9361
5812	106	10227	84	73	0	10490
5813	96	77	10226	32	0	10431
5814	45	79	10164	20	0	10308
5815	30	34	139	9707	0	9910
5816	41	8	10893	85	0	11027
5817	26	10729	86	115	0	10956
5818	31	68	73	10435	0	10607
5819	31	71	20	10716	0	10838
5820	23	21	14	11019	0	11077
5821	10923	18	8	146	0	11095
5822	80	10979	8	107	0	11174
5823	80	70	12	11087	0	11249
5824	39	73	9	11278	0	11399
5825	11006	28	20	145	0	11199
5826	80	10870	11	148	0	11109
5827	11279	69	13	46	0	11407
5828	11012	71	14	41	0	11138
5829	11004	28	17	39	0	11088
5830	172	16	11206	30	0	11424
5831	100	20	77	10834	0	11031
5832	49	11090	74	107	0	11320
5833	34	11187	37	123	0	11381
5834	44	140	19	11234	0	11437
5835	39	11865	28	96	0	12028
5836	12284	88	21	93	0	12486
5837	100	84	12177	48	0	12409
5838	11865	31	75	40	0	12011
5839	12249	19	83	50	0	12401
5840	168	18	28	12626	0	12840
5841	12638	33	29	114	0	12814
5842	119	13761	20	137	0	14037
5843	14236	85	18	78	0	14417
5844	14086	89	25	66	0	14266
5845	15285	51	33	62	0	15431
5846	236	22	15595	61	0	15914
5847	196	34	16090	57	0	16377
5848	99	66	204	15823	0	16192
5849	71	15835	146	155	0	16207
5850	78	16310	63	172	0	16623
5851	59	218	38	15969	0	16284
5852	16458	178	30	166	0	16832
5853	157	131	32	16376	0	16696
5854	159	44	32	16789	0	17024
5855	16802	28	48	283	0	17161
5856	156	16962	42	303	0	17463
5857	157	140	16964	118	0	17379
5858	95	128	16723	112	0	17058
5859	17232	61	207	83	0	17583
5860	157	47	152	16952	0	17308
5861	183	29	17596	139	0	17947
5862	101	37	126	17180	0	17444
5863	90	51	132	16794	0	17067
5864	75	37	77	17512	0	17701
5865	79	48	50	17346	0	17523
5866	63	17347	48	326	0	17784
5867	66	119	70	17694	0	17949
5868	17510	150	50	180	0	17890
5869	139	17414	54	194	0	17801
5870	18050	123	65	114	0	18352
5871	17993	149	41	101	0	18284
5872	18195	69	58	75	0	18397
5873	272	63	18386	78	0	18799
5874	18114	63	112	94	0	18383
5875	18437	56	145	88	0	18726
5876	18497	51	69	85	0	18702
5877	18671	63	31	87	0	18852
5878	272	18517	40	96	0	18925
5879	18751	133	34	73	0	18991
5880	195	151	18817	63	0	19226
5881	192	64	121	18351	0	18728
5882	86	64	140	18860	0	19150
5883	19111	37	59	228	0	19435
5884	158	18864	38	233	0	19293
5885	18471	111	25	110	0	18717
5886	137	18766	20	82	0	19005
5887	18571	105	6	44	0	18726
5888	18375	100	30	39	0	18544
5889	192	20387	26	50	0	20655
5890	20535	118	22	28	0	20703
5891	20983	123	14	46	0	21166
5892	285	20244	25	37	0	20591
5893	174	20819	18	63	0	21074
5894	22102	263	44	32	0	22441
5895	237	164	20	22580	0	23001
5896	22935	40	16	227	0	23218
5897	23137	31	17	162	0	23347
5898	23495	30	12	68	0	23605
5899	23997	18	28	40	0	24083
5900	464	23097	24	54	0	23639
5901	237	23804	14	42	0	24097
5902	23983	344	11	47	0	24385
5903	261	194	24036	28	0	24519
5904	193	84	183	23168	0	23628
5905	53	23	175	23865	0	24116
5906	23963	18	44	355	0	24380
5907	203	23802	19	229	0	24253
5908	199	208	15	23285	0	23707
5909	61	192	13	24169	0	24435
5910	24246	47	13	393	0	24699
5911	224	29	19	24313	0	24585
5912	24026	19	15	281	0	24341
5913	23822	32	15	226	0	24095
5914	23981	33	10	70	0	24094
5915	457	33	20	23546	0	24056
5916	268	29	20	23487	0	23804
5917	125	33	25533	407	0	26098
5918	94	45	24917	247	0	25303
5919	25376	35	495	85	0	25991
5920	323	23	295	26117	0	26758
5921	322	31	27970	301	0	28624
5922	128	28	27999	312	0	28467
5923	86	29	615	28058	0	28788
5924	100	36	28263	346	0	28745
5925	68	49	367	27552	0	28036
5926	63	47	393	27675	0	28178
5927	86	24	28157	685	0	28952
5928	68	36	303	27834	0	28241
5929	92	52	407	27326	0	27877
5930	107	22	78	28624	0	28831
5931	99	44	27919	882	0	28944
5932	78	37	304	28679	0	29098
5933	28431	28	365	453	0	29277
5934	385	28231	87	529	0	29232
5935	28591	341	50	127	0	29109
5936	489	400	28034	79	0	29002
5937	28240	104	336	71	0	28751
5938	28184	61	426	51	0	28722
5939	28401	59	126	62	0	28648
5940	835	53	65	27420	0	28373
5941	581	57	62	27624	0	28324
5942	204	41	26183	760	0	27188
5943	24899	43	388	511	0	25841
5944	438	25544	399	219	0	26600
5945	427	23904	118	130	0	24579
5946	144	24754	72	131	0	25101
5947	150	664	76	23717	0	24607
5948	23301	407	63	381	0	24152
5949	23274	92	80	424	0	23870
5950	692	50	23132	190	0	24064
5951	470	49	342	22954	0	23815
5952	161	41	399	22985	0	23586
5953	150	44	22768	721	0	23683
5954	152	57	22209	488	0	22906
5955	22043	42	670	190	0	22945
5956	389	22381	443	222	0	23435
5957	22822	315	141	149	0	23427
5958	22484	363	107	133	0	23087
5959	769	96	100	21815	0	22780
5960	534	33	85	22408	0	23060
5961	21751	54	103	735	0	22643
5962	447	57	94	21857	0	22455
5963	524	54	106	21898	0	22582
5964	21830	52	119	779	0	22780
5965	478	57	118	22186	0	22839
5966	22054	42	123	490	0	22709
5967	22046	45	108	526	0	22725
5968	766	45	21810	242	0	22863
5969	21984	50	421	199	0	22654
5970	21563	46	460	231	0	22300
5971	21738	51	201	221	0	22211
5972	802	60	20762	210	0	21834
5973	20707	46	442	226	0	21421
5974	490	20615	460	247	0	21812
5975	21169	314	219	239	0	21941
5976	21118	352	158	244	0	21872
5977	775	107	148	20835	0	21865
5978	566	62	151	20937	0	21716
5979	243	21316	158	906	0	22623
5980	210	339	116	21459	0	22124
5981	200	386	123	21499	0	22208
5982	21264	117	156	842	0	22379
5983	521	61	148	21436	0	22166
5984	550	69	110	21294	0	22023
5985	301	68	114	21200	0	21683
5986	222	20325	142	862	0	21551
5987	19940	344	150	599	0	21033
5988	491	20272	143	303	0	21209
5989	18276	369	105	190	0	18940
5990	541	352	17553	181	0	18627
5991	16699	114	329	178	0	17320
5992	490	77	16871	199	0	17637
5993	460	16139	357	212	0	17168
5994	14763	254	659	201	0	15877
5995	14294	287	171	149	0	14901
5996	559	13902	82	147	0	14690
5997	416	13707	150	121	0	14394
5998	13824	449	113	115	0	14501
5999	13778	309	56	144	0	14287
6000	555	101	69	13674	0	14399
6001	477	66	76	13848	0	14467
6002	212	48	13601	497	0	14358
6003	13315	54	200	402	0	13971
6004	311	70	279	13347	0	14007
6005	381	13612	115	289	0	14397
6006	219	202	73	13618	0	14112
6007	178	279	52	13694	0	14203
6008	179	111	13324	495	0	14109
6009	178	63	183	13576	0	14000
6010	13245	58	240	319	0	13862
6011	277	13046	85	433	0	13841
6012	347	13222	59	170	0	13798
6013	13280	377	46	132	0	13835
6014	13147	288	53	130	0	13618
6015	13420	107	49	121	0	13697
6016	523	12912	59	120	0	13614
6017	267	10847	29	100	0	11243
6018	11651	243	49	51	0	11994
6019	11717	180	37	57	0	11991
6020	336	11544	69	74	0	12023
6021	103	9570	14	36	0	9723
6022	9503	164	14	40	0	9721
6023	152	80	8	9330	0	9570
6024	9483	22	8	127	0	9640
6025	141	19	69	9431	0	9660
6026	97	9528	10	131	0	9766
6027	37	9531	8	91	0	9667
6028	10057	160	34	39	0	10290
6029	10093	94	29	33	0	10249
6030	10248	28	14	31	0	10321
6031	210	10202	15	29	0	10456
6032	101	104	9640	16	0	9861
6033	21	9640	100	26	0	9787
6034	9328	108	145	15	0	9596
6035	8995	87	20	22	0	9124
6036	164	25	8995	15	0	9199
6037	84	8799	74	17	0	8974
6038	30	111	55	8774	0	8970
6039	17	80	10	8513	0	8620
6040	26	8658	9	135	0	8828
6041	28	88	8776	72	0	8964
6042	8703	63	82	16	0	8864
6043	94	23	64	8910	0	9091
6044	8952	22	10	90	0	9074
6045	8935	14	16	70	0	9035
6046	157	17	7	9211	0	9392
6047	89	19	9	9606	0	9723
6048	29	19	10	9795	0	9853
6049	24	27	9	9971	0	10031
6050	9686	19	14	196	0	9915
6051	9730	26	10	102	0	9868
6052	211	23	10033	32	0	10299
6053	128	23	106	9953	0	10210
6054	53	22	86	10046	0	10207
6055	34	28	19	10222	0	10303
6056	45	19	9960	210	0	10234
6057	38	19	108	9937	0	10102
6058	9835	21	101	130	0	10087
6059	133	22	25	9922	0	10102
6060	114	36	9905	144	0	10199
6061	44	25	115	9921	0	10105
6062	58	31	9920	144	0	10153
6063	9959	26	123	113	0	10221
6064	139	26	100	9972	0	10237
6065	10033	26	23	140	0	10222
6066	9826	26	14	123	0	9989
6067	220	35	13	9883	0	10151
6068	9931	30	15	138	0	10114
6069	172	34	15	9723	0	9944
6070	137	9963	20	180	0	10300
6071	10080	134	13	114	0	10341
6072	9975	108	18	50	0	10151
6073	10252	34	15	46	0	10347
6074	260	35	21	9971	0	10287
6075	141	29	22	9921	0	10113
6076	66	29	12	10191	0	10298
6077	59	26	9806	272	0	10163
6078	63	9735	136	168	0	10102
6079	44	128	104	9302	0	9578
6080	49	107	9281	156	0	9593
6081	9119	33	134	135	0	9421
6082	154	17	107	9138	0	9416
6083	135	17	9083	164	0	9399
6084	9126	12	129	145	0	9412
6085	153	20	109	9255	0	9537
6086	129	16	38	9240	0	9423
6087	59	17	22	9454	0	9552
6088	9347	17	14	263	0	9641
6089	9309	16	29	155	0	9509
6090	9423	17	23	64	0	9527
6091	258	9174	29	62	0	9523
6092	159	9396	21	57	0	9633
6093	9403	193	24	58	0	9678
6094	177	108	9333	65	0	9683
6095	128	26	128	9044	0	9326
6096	70	18	143	9226	0	9457
6097	9016	13	35	259	0	9323
6098	8425	19	27	156	0	8627
6099	241	8688	24	68	0	9021
6100	153	116	27	8575	0	8871
6101	79	101	8373	163	0	8716
6102	67	25	8407	150	0	8649
6103	52	12	210	8293	0	8567
6104	58	17	111	8488	0	8674
6105	8283	14	43	274	0	8614
6106	164	12	33	8352	0	8561
6107	8617	20	22	190	0	8849
6108	8474	16	40	155	0	8685
6109	249	15	8606	91	0	8961
6110	8551	15	141	85	0	8792
6111	8477	15	118	94	0	8704
6112	8519	19	44	83	0	8665
6113	256	8499	37	92	0	8884
6114	144	8666	54	84	0	8948
6115	79	273	18	8580	0	8950
6116	77	108	8568	201	0	8954
6117	60	8158	122	191	0	8531
6118	98	212	89	6855	0	7254
6119	57	74	34	6704	0	6869
6120	52	6820	33	157	0	7062
6121	6804	90	23	110	0	7027
6122	6828	69	31	66	0	6994
6123	186	22	7085	58	0	7351
6124	6979	17	89	61	0	7146
6125	131	18	6815	55	0	7019
6126	6482	22	90	53	0	6647
6127	139	17	6551	53	0	6760
6128	105	5985	71	37	0	6198
6129	56	60	50	5602	0	5768
6130	55	53	25	5669	0	5802
6131	5698	14	21	131	0	5864
6132	5628	18	27	90	0	5763
6133	5615	15	18	66	0	5714
6134	126	17	5839	62	0	6044
6135	101	20	67	5828	0	6016
6136	56	18	60	5946	0	6080
6137	5945	11	31	141	0	6128
6138	93	5957	30	93	0	6173
6139	6239	56	27	84	0	6406
6140	100	56	24	6412	0	6592
6141	86	25	26	6466	0	6603
6142	54	21	20	6585	0	6680
6143	35	22	24	6612	0	6693
6144	45	19	26	6616	0	6706
6145	47	6470	31	140	0	6688
6146	48	6294	12	80	0	6434
6147	23	5896	16	32	0	5967
6148	24	107	11	5884	0	6026
6149	34	37	5823	48	0	5942
6150	5336	73	38	39	0	5486
6151	91	5851	98	20	0	6060
6152	37	34	13	5767	0	5851
6153	32	25	11	5857	0	5925
6154	5967	11	15	55	0	6048
6155	5850	15	12	33	0	5910
6156	5825	18	13	21	0	5877
6157	70	9	15	6351	0	6445
6158	43	12	6497	52	0	6604
6159	24	9	6961	49	0	7043
6160	27	4	55	6964	0	7050
6161	24	8	7116	52	0	7200
6162	6676	8	49	39	0	6772
6163	47	8	33	7017	0	7105
6164	44	8	7085	65	0	7202
6165	27	6	46	6961	0	7040
6166	31	10	7541	57	0	7639
6167	30	4	8382	41	0	8457
6168	26	42	63	9617	0	9748
6169	23	14	10746	81	0	10864
6170	25	9	10616	69	0	10719
6171	6	10401	102	33	0	10542
6172	7	119	99	10328	0	10553
6173	10981	49	18	83	0	11131
6174	58	22	6	11058	0	11144
6175	50	2	2	11536	0	11590
6176	23	2	11517	115	0	11657
6177	10715	6	71	73	0	10865
6178	54	4	51	11652	0	11761
6179	52	7	20	11823	0	11902
6180	11871	2	7	114	0	11994
6181	58	2	1	12006	0	12067
6182	12216	5	7	92	0	12320
6183	11935	2	5	84	0	12026
6184	12112	2	11	34	0	12159
6185	115	12168	4	18	0	12305
6186	12419	56	3	17	0	12495
6187	63	12362	4	15	0	12444
6188	58	73	4	12446	0	12581
6189	12524	53	9	69	0	12655
6190	61	12481	9	80	0	12631
6191	12650	62	9	46	0	12767
6192	76	12551	10	118	0	12755
6193	12460	74	12	18	0	12564
6194	81	12446	5	20	0	12552
6195	62	12698	8	29	0	12797
6196	32	13552	10	24	0	13618
6197	9	131	6	13339	0	13485
6198	7	13610	11	71	0	13699
6199	11	76	11	13457	0	13555
6200	15	61	9	13478	0	13563
6201	8	14	10	13452	0	13484
6202	6	6	14	13630	0	13656
6203	13492	7	7	150	0	13656
6204	13369	10	11	89	0	13479
6205	150	9	13636	33	0	13828
6206	14201	10	61	24	0	14296
6207	15138	6	68	23	0	15235
6208	16217	15	30	26	0	16288
6209	260	12	16790	22	0	17084
6210	142	14	16944	16	0	17116
6211	16609	12	272	35	0	16928
6212	191	16	17799	32	0	18038
6213	138	18779	185	41	0	19143
6214	58	193	132	18915	0	19298
6215	19676	155	26	213	0	20070
6216	19605	42	30	174	0	19851
6217	20081	24	44	49	0	20198
6218	367	24	19	20211	0	20621
6219	189	25	27	20704	0	20945
6220	68	12	21378	381	0	21839
6221	34	25	207	21370	0	21636
6222	23	20	173	21708	0	21924
6223	21491	14	39	392	0	21936
6224	228	22050	18	241	0	22537
6225	22469	215	17	76	0	22777
6226	276	177	15	22375	0	22843
6227	22431	44	16	246	0	22737
6228	22037	25	33	219	0	22314
6229	21432	21	37	91	0	21581
6230	416	21983	33	75	0	22507
6231	239	22354	28	55	0	22676
6232	89	432	32	22440	0	22993
6233	22482	216	32	252	0	22982
6234	272	60	26	22346	0	22704
6235	231	39	24	22544	0	22838
6236	123	44	22517	411	0	23095
6237	86	45	229	22320	0	22680
6238	75	44	200	22030	0	22349
6239	68	46	60	22337	0	22511
6240	87	37	21957	470	0	22551
6241	89	39	21536	314	0	21978
6242	80	21751	371	158	0	22360
6243	21843	232	231	90	0	22396
6244	292	200	68	21774	0	22334
6245	246	75	22610	301	0	23232
6246	139	41	253	22248	0	22681
6247	119	61	187	23832	0	24199
6248	23867	43	65	451	0	24426
6249	23623	40	50	276	0	23989
6250	474	23766	38	139	0	24417
6251	23831	242	60	75	0	24208
6252	23163	217	67	79	0	23526
6253	489	67	53	23415	0	24024
6254	315	58	23525	295	0	24193
6255	126	23445	244	283	0	24098
6256	23511	266	196	119	0	24092
6257	23958	207	74	126	0	24365
6258	512	24573	41	130	0	25256
6259	318	288	51	24986	0	25643
6260	25766	213	56	414	0	26449
6261	25887	64	67	342	0	26360
6262	590	56	66	26099	0	26811
6263	26569	65	92	421	0	27147
6264	27227	84	70	337	0	27718
6265	27330	87	105	189	0	27711
6266	703	62	28587	170	0	29522
6267	389	27540	354	183	0	28466
6268	188	27370	252	210	0	28020
6269	26768	520	64	148	0	27500
6270	454	27412	55	158	0	28079
6271	359	407	27161	136	0	28063
6272	177	269	397	27260	0	28103
6273	27156	98	266	484	0	28004
6274	502	69	78	27157	0	27806
6275	27206	81	68	484	0	27839
6276	27061	106	58	336	0	27561
6277	27075	70	53	191	0	27389
6278	742	26667	62	182	0	27653
6279	389	28310	77	161	0	28937
6280	28129	588	57	179	0	28953
6281	27714	326	74	182	0	28296
6282	28197	114	56	168	0	28535
6283	776	76	69	27698	0	28619
6284	27641	74	55	514	0	28284
6285	543	26995	66	490	0	28094
6286	394	27801	74	258	0	28527
6287	197	632	87	27599	0	28515
6288	206	320	27322	510	0	28358
6289	182	126	27155	383	0	27846
6290	210	80	618	27278	0	28186
6291	215	84	27661	505	0	28465
6292	227	90	439	27480	0	28236
6293	27409	118	287	531	0	28345
6294	591	152	83	27406	0	28232
6295	27417	94	72	536	0	28119
6296	548	26464	90	379	0	27481
6297	432	459	26704	166	0	27761
6298	229	323	419	25971	0	26942
6299	216	138	297	26981	0	27632
6300	204	120	27044	705	0	28073
6301	199	134	404	26304	0	27041
6302	231	27062	292	588	0	28173
6303	267	440	92	27450	0	28249
6304	227	327	62	27748	0	28364
6305	197	137	95	29312	0	29741
6306	241	100	28386	809	0	29536
6307	241	74	26939	385	0	27639
6308	24735	65	617	143	0	25560
6309	473	62	25030	100	0	25665
6310	304	24496	388	93	0	25281
6311	24121	370	225	64	0	24780
6312	407	24355	62	194	0	25018
6313	23215	393	148	75	0	23831
6314	23097	220	54	72	0	23443
6315	22569	82	66	73	0	22790
6316	23014	62	51	74	0	23201
6317	540	22374	48	108	0	23070
6318	280	22399	53	102	0	22834
6319	22288	454	42	90	0	22874
6320	414	228	21575	127	0	22344
6321	273	84	309	20816	0	21482
6322	145	66	269	21652	0	22132
6323	128	70	21568	483	0	22249
6324	20230	76	332	254	0	20892
6325	21375	86	208	103	0	21772
6326	21321	91	78	98	0	21588
6327	547	21104	78	104	0	21833
6328	21865	351	78	96	0	22390
6329	427	226	81	21123	0	21857
6330	283	22220	72	410	0	22985
6331	22847	377	94	277	0	23595
6332	22664	269	97	117	0	23147
6333	24147	121	69	114	0	24451
6334	708	108	76	23469	0	24361
6335	399	121	80	23570	0	24170
6336	184	23426	82	632	0	24324
6337	206	392	23725	343	0	24666
6338	213	299	395	23367	0	24274
6339	229	146	307	22821	0	23503
6340	224	90	92	24188	0	24594
6341	214	91	23777	651	0	24733
6342	23019	106	384	374	0	23883
6343	512	126	269	23787	0	24694
6344	371	115	23995	463	0	24944
6345	217	102	432	23241	0	23992
6346	23505	95	310	474	0	24384
6347	480	23059	124	390	0	24053
6348	396	419	107	23706	0	24628
6349	190	314	23647	491	0	24642
6350	22489	116	463	375	0	23443
6351	23533	99	310	182	0	24124
6352	743	203	23444	175	0	24565
6353	422	123	469	21950	0	22964
6354	173	23265	344	438	0	24220
6355	23519	451	129	364	0	24463
6356	492	328	23262	197	0	24279
6357	22490	102	465	164	0	23221
6358	504	74	21953	154	0	22685
6359	423	61	20516	138	0	21138
6360	19125	56	815	120	0	20116
6361	366	20198	272	223	0	21059
6362	287	329	20122	129	0	20867
6363	137	19737	324	124	0	20322
6364	259	303	18908	115	0	19585
6365	101	18825	316	185	0	19427
6366	17342	271	231	120	0	17964
6367	296	196	17148	98	0	17738
6368	250	71	16995	86	0	17402
6369	131	44	15986	241	0	16402
6370	15314	107	330	58	0	15809
6371	15738	37	187	61	0	16023
6372	320	37	66	15451	0	15874
6373	203	30	16572	216	0	17021
6374	88	43	16525	229	0	16885
6375	16342	31	331	66	0	16770
6376	232	31	197	16487	0	16947
6377	16559	22	79	198	0	16858
6378	16292	42	73	162	0	16569
6379	357	44	57	15273	0	15731
6380	212	15448	70	192	0	15922
6381	113	194	75	15508	0	15890
6382	89	163	54	15631	0	15937
6383	83	61	15565	321	0	16030
6384	88	15402	219	184	0	15893
6385	100	15677	191	79	0	16047
6386	83	323	99	15232	0	15737
6387	74	195	15389	204	0	15862
6388	70	15437	240	209	0	15956
6389	87	200	15824	66	0	16177
6390	15077	173	247	68	0	15565
6391	15484	71	221	73	0	15849
6392	345	53	15572	70	0	16040
6393	15277	43	269	61	0	15650
6394	287	44	205	15562	0	16098
6395	213	16279	121	218	0	16831
6396	107	191	110	16482	0	16890
6397	16240	178	74	222	0	16714
6398	16157	53	110	188	0	16508
6399	16087	55	90	78	0	16310
6400	15897	41	73	85	0	16096
6401	369	15885	86	86	0	16426
6402	219	15646	88	70	0	16023
6403	15538	276	78	78	0	15970
6404	222	175	16040	63	0	16500
6405	183	226	185	15489	0	16083
6406	82	16400	172	183	0	16837
6407	72	182	89	16202	0	16545
6408	52	16740	73	199	0	17064
6409	81	218	63	16619	0	16981
6410	77	248	16713	191	0	17229
6411	16299	68	222	179	0	16768
6412	16317	48	217	62	0	16644
6413	336	57	16322	46	0	16761
6414	16182	49	208	47	0	16486
6415	16363	52	210	52	0	16677
6416	359	51	16142	48	0	16600
6417	241	45	228	15867	0	16381
6418	16140	36	215	190	0	16581
6419	240	45	16225	172	0	16682
6420	225	42	208	15810	0	16285
6421	121	42	17291	189	0	17643
6422	93	45	16788	182	0	17108
6423	16547	38	341	72	0	16998
6424	17006	46	267	65	0	17384
6425	16908	34	83	49	0	17074
6426	17496	47	56	56	0	17655
6427	367	61	46	17112	0	17586
6428	218	16685	59	175	0	17137
6429	87	16855	71	200	0	17213
6430	59	308	44	16050	0	16461
6431	15930	155	45	145	0	16275
6432	165	15759	45	152	0	16121
6433	128	15082	37	51	0	15298
6434	14986	210	39	19	0	15254
6435	142	124	40	15014	0	15320
6436	15202	30	32	146	0	15410
6437	147	15094	38	129	0	15408
6438	15517	122	44	44	0	15727
6439	164	117	16445	31	0	16757
6440	17739	28	158	29	0	17954
6441	18232	28	132	30	0	18422
6442	18631	23	43	37	0	18734
6443	366	43	18198	41	0	18648
6444	18235	28	164	36	0	18463
6445	210	18486	152	50	0	18898
6446	184	171	18436	28	0	18819
6447	58	174	171	17530	0	17933
6448	51	98	169	16407	0	16725
6449	35	17431	34	276	0	17776
6450	45	157	29	17260	0	17491
6451	35	149	25	17458	0	17667
6452	54	28	17312	290	0	17684
6453	16491	13	170	180	0	16854
6454	176	14	17521	50	0	17761
6455	161	16	165	17038	0	17380
6456	64	13	17407	172	0	17656
6457	31	14	175	17330	0	17550
6458	17648	15	151	181	0	17995
6459	17925	10	43	152	0	18130
6460	326	9	29	18011	0	18375
6461	207	16	17976	187	0	18386
6462	76	27	183	18010	0	18296
6463	58	27	17879	210	0	18174
6464	17508	43	205	172	0	17928
6465	17449	31	174	75	0	17729
6466	17345	64	59	44	0	17512
6467	17457	34	30	60	0	17581
6468	474	17029	46	79	0	17628
6469	210	187	37	17211	0	17645
6470	16944	185	50	207	0	17386
6471	217	16823	45	204	0	17289
6472	211	17178	55	100	0	17544
6473	99	326	16151	72	0	16648
6474	15829	182	236	62	0	16309
6475	16161	55	198	56	0	16470
6476	427	25	15972	90	0	16514
6477	256	30	240	15704	0	16230
6478	158	21	198	15891	0	16268
6479	117	25	16053	351	0	16546
6480	143	65	244	15809	0	16261
6481	15884	23	241	244	0	16392
6482	294	22	15778	210	0	16304
6483	242	24	15938	78	0	16282
6484	15585	18	351	147	0	16101
6485	269	33	16024	77	0	16403
6486	15798	42	247	59	0	16146
6487	278	15704	207	84	0	16273
6488	16003	191	80	75	0	16349
6489	325	197	59	15467	0	16048
6490	285	83	68	15599	0	16035
6491	15672	63	46	380	0	16161
6492	289	64	44	15724	0	16121
6493	15797	84	50	242	0	16173
6494	288	15686	57	229	0	16260
6495	243	238	56	14703	0	15240
6496	134	205	69	15232	0	15640
6497	14959	96	66	384	0	15505
6498	14752	77	52	228	0	15109
6499	15021	63	67	107	0	15258
6500	461	14657	64	126	0	15308
6501	265	14634	87	77	0	15063
6502	14654	323	65	67	0	15109
6503	295	306	14308	65	0	14974
6504	235	13517	213	78	0	14043
6505	11792	191	265	104	0	12352
6506	11207	121	112	53	0	11493
6507	10965	38	48	43	0	11094
6508	339	28	58	10708	0	11133
6509	10824	88	43	156	0	11111
6510	10654	27	49	137	0	10867
6511	285	24	42	10526	0	10877
6512	10694	40	47	167	0	10948
6513	188	42	10466	160	0	10856
6514	207	42	142	10237	0	10628
6515	129	45	130	10188	0	10492
6516	104	29	63	10495	0	10691
6517	10406	31	46	299	0	10782
6518	10475	28	43	184	0	10730
6519	10513	33	49	79	0	10674
6520	10551	20	29	87	0	10687
6521	9670	38	55	55	0	9818
6522	286	38	53	9429	0	9806
6523	218	27	51	9449	0	9745
6524	9063	23	66	242	0	9394
6525	190	8937	55	179	0	9361
6526	8863	113	64	60	0	9100
6527	197	113	8711	59	0	9080
6528	9102	40	137	41	0	9320
6529	9283	44	128	49	0	9504
6530	284	28	9515	58	0	9885
6531	9388	25	161	51	0	9625
6532	225	23	9568	63	0	9879
6533	203	23	9832	43	0	10101
6534	148	78	311	9613	0	10150
6535	111	21	155	9877	0	10164
6536	75	43	9971	275	0	10364
6537	143	25	10265	177	0	10610
6538	74	10009	255	79	0	10417
6539	67	9119	135	68	0	9389
6540	7237	169	41	21	0	7468
6541	133	7388	28	25	0	7574
6542	7121	94	48	20	0	7283
6543	89	6985	15	34	0	7123
6544	6856	82	19	16	0	6973
6545	99	61	6704	23	0	6887
6546	6589	26	76	16	0	6707
6547	108	18	63	6543	0	6732
6548	93	6678	27	85	0	6883
6549	32	77	16	6747	0	6872
6550	6647	68	13	92	0	6820
6551	6692	22	11	80	0	6805
6552	160	12	8	6680	0	6860
6553	80	13	6502	88	0	6683
6554	40	12	6501	62	0	6615
6555	25	6554	129	29	0	6737
6556	27	198	68	6438	0	6731
6557	49	67	6475	82	0	6673
6558	20	6020	62	62	0	6164
6559	73	81	116	5611	0	5881
6560	11	49	12	5750	0	5822
6561	5537	18	11	96	0	5662
6562	60	5	7	5499	0	5571
6563	59	7	5404	64	0	5534
6564	14	4	46	5326	0	5390
6565	5287	5	49	69	0	5410
6566	64	8	5330	56	0	5458
6567	5160	5	58	16	0	5239
6568	66	5332	46	14	0	5458
6569	5362	47	15	6	0	5430
6570	5337	50	9	13	0	5409
6571	98	7	13	5268	0	5386
6572	52	8	11	5279	0	5350
6573	25	5251	5	100	0	5381
6574	12	50	11	5361	0	5434
6575	5294	46	11	60	0	5411
6576	57	15	5273	51	0	5396
6577	51	11	51	5116	0	5229
6578	15	5184	48	59	0	5306
6579	21	49	20	5260	0	5350
6580	8	50	15	5361	0	5434
6581	5336	16	7	94	0	5453
6582	47	5252	13	60	0	5372
6583	58	52	9	5304	0	5423
6584	5257	48	18	59	0	5382
6585	59	15	12	5232	0	5318
6586	52	16	10	5297	0	5375
6587	5494	9	10	102	0	5615
6588	5282	13	12	60	0	5367
6589	104	7	5323	26	0	5460
6590	5264	18	53	21	0	5356
6591	5320	12	50	26	0	5408
6592	5441	13	18	20	0	5492
6593	100	5325	17	23	0	5465
6594	65	5206	17	24	0	5312
6595	26	100	13	5215	0	5354
6596	5244	52	8	60	0	5364
6597	5288	25	19	54	0	5386
6598	105	14	13	5285	0	5417
6599	55	16	5417	68	0	5556
6600	5344	18	48	50	0	5460
6601	5556	16	55	29	0	5656
6602	97	18	18	5495	0	5628
6603	67	11	18	5532	0	5628
6604	5511	13	10	101	0	5635
6605	68	18	17	5458	0	5561
6606	56	5589	12	83	0	5740
6607	34	55	18	5669	0	5776
6608	5697	49	8	71	0	5825
6609	69	20	5601	61	0	5751
6610	5343	18	56	28	0	5445
6611	60	12	5607	37	0	5716
6612	68	24	49	5509	0	5650
6613	5571	14	50	67	0	5702
6614	85	9	16	5628	0	5738
6615	67	12	25	5667	0	5771
6616	5614	14	15	113	0	5756
6617	67	15	5570	74	0	5726
6618	65	8	6187	47	0	6307
6619	47	9	89	6192	0	6337
6620	21	17	55	6550	0	6643
6621	21	9	20	6744	0	6794
6622	29	12	7209	108	0	7358
6623	6934	10	57	68	0	7069
6624	7184	10	49	46	0	7289
6625	7274	16	16	34	0	7340
6626	7250	12	17	27	0	7306
6627	114	7159	8	41	0	7322
6628	64	6964	16	34	0	7078
6629	30	7101	3	39	0	7173
6630	17	265	10	6328	0	6620
6631	18	21	7	6360	0	6406
6632	18	1	6134	42	0	6195
6633	10	5739	19	23	0	5791
6634	31	3	5	5259	0	5298
6635	5172	4	0	6	0	5182
6636	4	5286	3	24	0	5317
6637	36	3	1	5256	0	5296
6638	6	5310	2	9	0	5327
6639	5618	4	2	9	0	5633
6640	20	2	5	5476	0	5503
6641	11	1	5729	9	0	5750
6642	6	1	5771	7	0	5785
6643	2	2	15	5824	0	5843
6644	2	4	7	5819	0	5832
6645	4	0	2	6012	0	6018
6646	6015	1	3	31	0	6050
6647	21	1	6011	15	0	6048
6648	12	6007	16	8	0	6043
6649	4	15	7	5985	0	6011
6650	6	8	6290	18	0	6322
6651	0	6327	16	18	0	6361
6652	1	33	5	6359	0	6398
6653	5	6	6653	18	0	6682
6654	0	2	18	6539	0	6559
6655	0	1	6	6705	0	6712
6656	6820	1	0	24	0	6845
6657	6855	5	4	11	0	6875
6658	24	0	0	6940	0	6964
6659	6969	1	0	19	0	6989
6660	22	1	7165	13	0	7201
6661	11	0	15	7122	0	7148
6662	6	0	7527	20	0	7553
6663	1	1	21	7560	0	7583
6664	2	7578	14	24	0	7618
6665	4	7733	2	34	0	7773
6666	2	7882	4	10	0	7898
6667	8	54	12	7947	0	8021
6668	2	23	0	9031	0	9056
6669	15	1	9087	58	0	9161
6670	11	5	9195	40	0	9251
6671	9	3	9724	9	0	9745
6672	9793	5	92	10	0	9900
6673	52	2	50	10365	0	10469
6674	10743	4	8	70	0	10825
6675	81	11281	8	72	0	11442
6676	76	107	12	11441	0	11636
6677	11608	97	4	116	0	11825
6678	101	10	9	11734	0	11854
6679	11570	12	5	126	0	11713
6680	123	4	11717	125	0	11969
6681	117	11829	103	31	0	12080
6682	16	106	101	11903	0	12126
6683	11786	108	12	112	0	12018
6684	11898	16	10	109	0	12033
6685	199	13	9	11874	0	12095
6686	114	3	6	11999	0	12122
6687	11699	3	20	212	0	11934
6688	118	6	18	11759	0	11901
6689	119	6	11699	134	0	11958
6690	28	11656	120	132	0	11936
6691	22	113	113	11770	0	12018
6692	11632	107	34	133	0	11906
6693	11347	29	30	129	0	11535
6694	248	16	11693	43	0	12000
6695	150	11357	113	53	0	11673
6696	43	11563	126	56	0	11788
6697	45	234	30	11337	0	11646
6698	29	140	36	11427	0	11632
6699	35	43	22	11581	0	11681
6700	31	30	19	11793	0	11873
6701	41	11669	22	288	0	12020
6702	54	126	23	11768	0	11971
6703	48	139	17	11853	0	12057
6704	11691	24	22	296	0	12033
6705	11548	35	22	190	0	11795
6706	263	11797	21	103	0	12184
6707	12099	124	30	79	0	12332
6708	11841	151	18	77	0	12087
6709	12044	34	23	68	0	12169
6710	289	32	11798	68	0	12187
6711	199	34	129	11708	0	12070
6712	83	27	144	12089	0	12343
6713	64	28	11899	293	0	12284
6714	61	37	129	11752	0	11979
6715	65	44	163	11581	0	11853
6716	11695	36	53	307	0	12091
6717	160	40	11816	208	0	12224
6718	170	35	137	11179	0	11521
6719	11062	37	150	194	0	11443
6720	152	11080	47	216	0	11495
6721	11076	155	35	99	0	11365
6722	10566	170	29	105	0	10870
6723	297	10482	16	95	0	10890
6724	214	158	18	10604	0	10994
6725	10529	164	21	204	0	10918
6726	190	10501	28	219	0	10938
6727	207	155	25	10542	0	10929
6728	10298	174	29	197	0	10698
6729	10038	57	33	206	0	10334
6730	306	9865	28	177	0	10376
6731	10004	143	25	104	0	10276
6732	215	155	38	9944	0	10352
6733	10086	54	36	215	0	10391
6734	216	41	9880	227	0	10364
6735	217	41	152	9865	0	10275
6736	97	36	169	9914	0	10216
6737	9743	30	57	341	0	10171
6738	201	9667	57	239	0	10164
6739	9503	147	50	110	0	9810
6740	218	9503	53	121	0	9895
6741	232	173	9044	88	0	9537
6742	121	177	8846	108	0	9252
6743	112	89	305	8668	0	9174
6744	102	52	8852	188	0	9194
6745	81	59	151	8786	0	9077
6746	94	54	166	8597	0	8911
6747	124	48	38	9003	0	9213
6748	8785	61	29	332	0	9207
6749	8692	51	30	230	0	9003
6750	8903	61	37	112	0	9113
6751	347	8872	19	111	0	9349
6752	229	9404	29	114	0	9776
6753	147	331	9716	94	0	10288
6754	111	207	187	9856	0	10361
6755	124	65	9776	267	0	10232
6756	95	66	222	9613	0	9996
6757	104	51	209	9530	0	9894
6758	90	59	58	9791	0	9998
6759	106	49	9290	445	0	9890
6760	90	59	204	9364	0	9717
6761	9179	47	201	300	0	9727
6762	227	8892	86	276	0	9481
6763	218	201	58	8903	0	9380
6764	8800	192	65	265	0	9322
6765	8698	70	43	260	0	9071
6766	373	56	45	8528	0	9002
6767	246	27	42	8203	0	8518
6768	7277	31	40	380	0	7728
6769	212	28	39	7375	0	7654
6770	6613	24	30	250	0	6917
6771	216	22	27	6399	0	6664
6772	172	20	5775	219	0	6186
6773	68	5489	130	185	0	5872
6774	46	5406	107	98	0	5657
6775	159	160	39	4643	0	5001
6776	55	99	15	4748	0	4917
6777	4457	39	12	243	0	4751
6778	90	15	12	4563	0	4680
6779	83	9	6	4565	0	4663
6780	41	7	5	4221	0	4274
6781	21	4107	9	184	0	4321
6782	19	84	5	4253	0	4361
6783	16	70	9	4189	0	4284
6784	14	31	7	4247	0	4299
6785	4012	14	12	203	0	4241
6786	94	4048	4	139	0	4285
6787	80	93	12	4072	0	4257
6788	37	79	9	4022	0	4147
6789	24	33	9	4161	0	4227
6790	3918	16	13	197	0	4144
6791	95	11	12	3983	0	4101
6792	76	10	9	3985	0	4080
6793	44	33	3673	185	0	3935
6794	18	3716	80	119	0	3933
6795	17	86	67	3825	0	3995
6796	3631	71	84	111	0	3897
6797	95	3730	13	89	0	3927
6798	3644	93	8	51	0	3796
6799	3624	61	8	40	0	3733
6800	149	25	8	3492	0	3674
6801	91	15	6	3529	0	3641
6802	56	6	3472	159	0	3693
6803	17	12	80	3650	0	3759
6804	19	5	3608	144	0	3776
6805	26	15	100	3640	0	3781
6806	3317	9	64	134	0	3524
6807	97	3391	28	98	0	3614
6808	65	93	21	3534	0	3713
6809	36	65	13	3573	0	3687
6810	22	27	13	3589	0	3651
6811	14	21	8	3671	0	3714
6812	3389	5	13	206	0	3613
6813	97	3398	9	128	0	3632
6814	66	86	6	3571	0	3729
6815	3536	60	13	127	0	3736
6816	104	36	3460	104	0	3704
6817	3466	18	89	64	0	3637
6818	3586	24	66	39	0	3715
6819	157	20	3548	52	0	3777
6820	95	10	91	3479	0	3675
6821	3589	14	64	122	0	3789
6822	102	3559	33	107	0	3801
6823	3679	79	22	74	0	3854
6824	3643	64	12	56	0	3775
6825	3694	29	9	57	0	3789
6826	169	23	8	3624	0	3824
6827	114	13	14	3824	0	3965
6828	58	4239	10	156	0	4463
6829	51	104	6	4473	0	4634
6830	4414	73	11	146	0	4644
6831	109	40	4354	109	0	4612
6832	4340	21	78	69	0	4508
6833	4553	14	55	54	0	4676
6834	164	13	28	4333	0	4538
6835	108	8	15	4527	0	4658
6836	4512	7	16	166	0	4701
6837	4490	17	11	121	0	4639
6838	4528	14	12	78	0	4632
6839	172	17	4454	53	0	4696
6840	96	4421	80	51	0	4648
6841	4480	86	61	35	0	4662
6842	107	75	25	4446	0	4653
6843	70	4492	14	109	0	4685
6844	51	92	7	4508	0	4658
6845	4490	67	8	137	0	4702
6846	92	34	2	4627	0	4755
6847	151	41	4682	141	0	5015
6848	37	4765	70	120	0	4992
6849	36	4877	56	58	0	5027
6850	50	112	4510	36	0	4708
6851	3832	140	140	61	0	4173
6852	43	3978	35	28	0	4084
6853	97	18	18	3119	0	3252
6854	3125	11	2	12	0	3150
6855	12	3228	5	14	0	3259
6856	15	11	1	3261	0	3288
6857	3293	11	1	13	0	3318
6858	14	4	0	3272	0	3290
6859	3306	3	2	20	0	3331
6860	21	1	3367	17	0	3406
6861	18	3373	9	6	0	3406
6862	3640	10	9	9	0	3668
6863	3606	11	8	6	0	3631
6864	3624	7	5	2	0	3638
6865	33	4	3612	0	0	3649
6866	3521	2	10	7	0	3540
6867	3654	4	12	2	0	3672
6868	22	3	5	3678	0	3708
6869	3700	1	2	16	0	3719
6870	17	3696	3	20	0	3736
6871	16	9	2	3746	0	3773
6872	14	13	3916	16	0	3959
6873	6	7	11	3871	0	3895
6874	7	5	13	3927	0	3952
6875	3918	2	6	23	0	3949
6876	3793	5	3	21	0	3822
6877	21	4	3892	12	0	3929
6878	3824	1	10	8	0	3843
6879	25	3	3943	8	0	3979
6880	15	6	14	3893	0	3928
6881	13	1	4006	17	0	4037
6882	8	3	15	3933	0	3959
6883	8	3977	14	17	0	4016
6884	11	9	4055	18	0	4093
6885	11	19	4072	7	0	4109
6886	7	10	30	3740	0	3787
6887	4087	1	15	16	0	4119
6888	4048	2	6	13	0	4069
6889	4103	5	8	6	0	4122
6890	28	3	2	4064	0	4097
6891	23	3	2	4081	0	4109
6892	9	2	2	4077	0	4090
6893	9	2	2	4111	0	4124
6894	6	7	4052	28	0	4093
6895	3	4	12	3994	0	4013
6896	5	3985	14	28	0	4032
6897	5	15	5	4057	0	4082
6898	4178	13	4	28	0	4223
6899	27	4	4220	14	0	4265
6900	3925	1	20	12	0	3958
6901	31	3	4326	11	0	4371
6902	18	1	4279	8	0	4306
6903	9	4230	36	5	0	4280
6904	9	28	25	3943	0	4005
6905	7	16	10	4168	0	4201
6906	13	4154	8	42	0	4217
6907	4651	32	6	21	0	4710
6908	34	31	4	4771	0	4840
6909	39	7	6	5086	0	5138
6910	11	2	1	5390	0	5404
6911	6074	6	5	101	0	6186
6912	6373	4	8	57	0	6442
6913	123	5	4	6358	0	6490
6914	66	3	4	6357	0	6430
6915	6342	0	5	131	0	6478
6916	73	5	3	6344	0	6425
6917	63	7	0	6331	0	6401
6918	15	0	8	6485	0	6508
6919	12	5	6223	142	0	6382
6920	5979	6	72	77	0	6134
6921	6094	3	61	22	0	6180
6922	137	2	6044	11	0	6194
6923	73	13	73	5735	0	5894
6924	19	5997	59	79	0	6154
6925	5930	70	14	64	0	6078
6926	76	5995	7	24	0	6102
6927	63	5619	9	22	0	5713
6928	28	112	5	5347	0	5492
6929	5238	57	6	74	0	5375
6930	5351	10	7	56	0	5424
6931	122	3	4	5275	0	5404
6932	65	5	3	5194	0	5267
6933	22	2	4	5248	0	5276
6934	13	8	4	5247	0	5272
6935	16	4	6	5183	0	5209
6936	16	5060	3	136	0	5215
6937	11	60	7	5158	0	5236
6938	5042	55	10	91	0	5198
6939	4998	16	6	72	0	5092
6940	5078	1	8	32	0	5119
6941	125	5030	10	20	0	5185
6942	73	69	4	4973	0	5119
6943	27	54	5009	84	0	5174
6944	4925	12	69	74	0	5080
6945	81	67	52	5053	0	5253
6946	5090	13	9	87	0	5199
6947	4794	10	7	63	0	4874
6948	4759	9	6	55	0	4829
6949	135	11	5	4652	0	4803
6950	4712	10	5	88	0	4815
6951	91	13	7	4721	0	4832
6952	76	10	6	4759	0	4851
6953	4696	8	4	141	0	4849
6954	80	10	6	4745	0	4841
6955	4658	11	5	105	0	4779
6956	4743	11	2	81	0	4837
6957	135	9	3	4646	0	4793
6958	83	10	7	4689	0	4789
6959	44	7	3	4774	0	4828
6960	38	10	4552	155	0	4755
6961	44	6	4597	97	0	4744
6962	37	9	110	4382	0	4538
6963	34	8	58	4378	0	4478
6964	29	12	16	4465	0	4522
6965	37	8	10	4425	0	4480
6966	42	6	13	4469	0	4530
6967	4357	7	12	161	0	4537
6968	96	4293	17	97	0	4503
6969	89	73	11	4362	0	4535
6970	4298	55	16	100	0	4469
6971	92	22	18	4309	0	4441
6972	84	16	7	4171	0	4278
6973	4080	22	13	147	0	4262
6974	4075	16	3	99	0	4193
6975	148	21	4040	51	0	4260
6976	99	15	67	4067	0	4248
6977	42	17	4067	117	0	4243
6978	47	14	70	4088	0	4219
6979	37	9	54	4026	0	4126
6980	35	7	14	4087	0	4143
6981	31	9	3920	182	0	4142
6982	28	3851	67	119	0	4065
6983	30	3935	57	68	0	4090
6984	32	115	16	3857	0	4020
6985	3800	69	11	115	0	3995
6986	96	13	3758	114	0	3981
6987	86	17	4044	48	0	4195
6988	45	9	121	3964	0	4139
6989	45	15	72	3885	0	4017
6990	29	4035	20	149	0	4233
6991	48	71	11	4070	0	4200
6992	41	68	20	4145	0	4274
6993	52	15	5	4297	0	4369
6994	4148	14	17	175	0	4354
6995	4160	11	5	108	0	4284
6996	171	9	18	4351	0	4549
6997	102	4339	10	119	0	4570
6998	39	67	14	4268	0	4388
6999	4125	61	7	128	0	4321
7000	92	4221	11	122	0	4446
7001	84	78	13	3979	0	4154
7002	40	4033	15	112	0	4200
7003	3926	73	38	112	0	4149
7004	3858	66	13	47	0	3984
7005	129	3908	15	56	0	4108
7006	67	3762	11	54	0	3894
7007	36	92	3508	37	0	3673
7008	19	3343	56	32	0	3450
7009	10	96	174	2759	0	3039
7010	8	48	2751	58	0	2865
7011	5	1952	22	30	0	2009
7012	3	16	18	1667	0	1704
7013	5	18	4	1687	0	1714
7014	5	3	2	1703	0	1713
7015	1662	3	0	37	0	1702
7016	16	3	1651	22	0	1692
7017	23	0	1631	7	0	1661
7018	6	1	30	1613	0	1650
7019	6	2	1773	15	0	1796
7020	0	0	18	1773	0	1791
7021	1	4	23	1739	0	1767
7022	2	0	4	1751	0	1757
7023	2	2	3	1784	0	1791
7024	1749	5	1	35	0	1790
7025	1700	2	2	23	0	1727
7026	32	3	2	1745	0	1782
7027	20	3	2065	17	0	2105
7028	6	0	14	2149	0	2169
7029	4	2113	21	15	0	2153
7030	0	12	8	2096	0	2116
7031	2087	19	4	19	0	2129
7032	2222	7	2	23	0	2254
7033	29	4	0	2220	0	2253
7034	23	3	1	2221	0	2248
7035	8	1	2	2263	0	2274
7036	2208	2	4	37	0	2251
7037	17	2	2210	26	0	2255
7038	19	2	2200	10	0	2231
7039	6	2210	28	7	0	2251
7040	2211	14	20	5	0	2250
7041	15	22	7	2233	0	2277
7042	21	6	2252	22	0	2301
7043	9	2271	12	22	0	2314
7044	6	2361	15	7	0	2389
7045	2	27	3	2439	0	2471
7046	2	22	3	2383	0	2410
7047	2	2384	1	35	0	2422
7048	3	15	2	2469	0	2489
7049	5	23	2	2456	0	2486
7050	2440	6	4	32	0	2482
7051	13	2431	3	34	0	2481
7052	20	15	1	2397	0	2433
7053	9	20	2447	20	0	2496
7054	2	11	11	2460	0	2484
7055	2438	5	16	23	0	2482
7056	15	2447	9	26	0	2497
7057	21	15	4	2489	0	2529
7058	6	21	2435	22	0	2484
7059	5	6	2883	33	0	2927
7060	5	6	30	2919	0	2960
7061	6	5	23	3015	0	3049
7062	3095	5	9	37	0	3146
7063	20	3477	6	34	0	3537
7064	3496	25	1	13	0	3535
7065	27	31	3567	11	0	3636
7066	3625	9	28	14	0	3676
7067	39	7	3913	14	0	3973
7068	3865	8	37	8	0	3918
7069	3959	5	33	11	0	4008
7070	61	5	4207	12	0	4285
7071	44	5	4338	12	0	4399
7072	15	4353	68	14	0	4450
7073	8	33	42	4411	0	4494
7074	4388	37	14	38	0	4477
7075	33	20	6	4387	0	4446
7076	32	9	9	4453	0	4503
7077	13	5	6	4545	0	4569
7078	7	6	4489	84	0	4586
7079	4113	3	34	57	0	4207
7080	4400	2	42	22	0	4466
7081	73	4550	17	46	0	4686
7082	48	38	7	4559	0	4652
7083	14	5031	8	131	0	5184
7084	8	45	12	5181	0	5246
7085	5052	41	38	64	0	5195
7086	49	5214	9	49	0	5321
7087	44	43	5	5039	0	5131
7088	4978	44	8	46	0	5076
7089	4957	18	12	47	0	5034
7090	87	7	14	5004	0	5112
7091	60	5	5026	50	0	5141
7092	24	42	45	4820	0	4931
7093	17	4960	36	53	0	5066
7094	4916	44	20	39	0	5019
7095	45	5030	10	26	0	5111
7096	34	45	13	4779	0	4871
7097	4691	29	10	45	0	4775
7098	37	17	7	4839	0	4900
7099	32	6	5	4873	0	4916
7100	29	4	4789	72	0	4894
7101	13	4782	34	56	0	4885
7102	4748	38	32	25	0	4843
7103	4468	41	20	25	0	4554
7104	60	4766	8	15	0	4849
7105	45	4755	7	12	0	4819
7106	25	64	3	4740	0	4832
7107	4657	44	3	44	0	4748
7108	44	4660	5	44	0	4753
7109	33	40	6	4693	0	4772
7110	33	32	4669	42	0	4776
7111	14	17	39	4638	0	4708
7112	4614	12	33	58	0	4717
7113	45	4713	17	41	0	4816
7114	43	39	7	4870	0	4959
7115	31	33	4787	46	0	4897
7116	14	22	4807	46	0	4889
7117	12	14	64	4786	0	4876
7118	15	14	38	4739	0	4806
7119	21	4788	13	81	0	4903
7120	14	48	16	4766	0	4844
7121	4822	32	9	66	0	4929
7122	45	51	15	4832	0	4943
7123	4845	14	11	66	0	4936
7124	60	4826	16	44	0	4946
7125	39	4939	10	35	0	5023
7126	37	80	16	4936	0	5069
7127	21	53	14	4701	0	4789
7128	34	24	4593	88	0	4739
7129	20	22	51	4645	0	4738
7130	4663	31	31	77	0	4802
7131	62	22	4657	56	0	4797
7132	54	18	53	4578	0	4703
7133	41	18	4718	60	0	4837
7134	27	26	57	4686	0	4796
7135	23	20	45	4640	0	4728
7136	38	17	26	4733	0	4814
7137	25	26	4705	105	0	4861
7138	27	20	53	4630	0	4730
7139	18	4705	46	79	0	4848
7140	15	58	34	4721	0	4828
7141	27	38	20	4740	0	4825
7142	4739	25	20	92	0	4876
7143	62	26	4704	78	0	4870
7144	54	22	50	4721	0	4847
7145	39	28	4516	84	0	4667
7146	29	18	4447	77	0	4571
7147	39	20	70	4442	0	4571
7148	33	34	56	4373	0	4496
7149	27	26	21	4571	0	4645
7150	4477	32	14	112	0	4635
7151	75	25	4493	81	0	4674
7152	4555	24	58	65	0	4702
7153	78	23	46	4694	0	4841
7154	50	21	28	4829	0	4928
7155	39	4969	20	109	0	5137
7156	36	57	21	4946	0	5060
7157	23	46	32	4933	0	5034
7158	18	30	26	5036	0	5110
7159	4432	13	17	110	0	4572
7160	57	20	4416	73	0	4566
7161	4030	18	51	57	0	4156
7162	65	4254	46	44	0	4409
7163	3589	44	16	30	0	3679
7164	52	3617	15	26	0	3710
7165	22	3704	14	60	0	3800
7166	55	50	79	3242	0	3426
7167	3198	23	16	46	0	3283
7168	37	14	8	3197	0	3256
7169	16	3144	11	54	0	3225
7170	15	3411	10	31	0	3467
7171	16	45	12	3478	0	3551
7172	13	34	11	3440	0	3498
7173	10	3582	9	78	0	3679
7174	11	34	11	3674	0	3730
7175	6	29	17	3649	0	3701
7176	8	16	10	3752	0	3786
7177	3779	6	11	82	0	3878
7178	41	6	3798	49	0	3894
7179	3844	7	34	33	0	3918
7180	3961	3	30	22	0	4016
7181	3879	8	12	20	0	3919
7182	64	3888	5	25	0	3982
7183	27	32	4	3642	0	3705
7184	3681	20	7	43	0	3751
7185	31	81	9	3725	0	3846
7186	3701	5	4	41	0	3751
7187	28	4049	5	30	0	4112
7188	4149	27	7	16	0	4199
7189	4314	24	4	14	0	4356
7190	4431	13	4	17	0	4465
7191	50	8	6	4461	0	4525
7192	25	7	3	4700	0	4735
7193	4779	7	5	63	0	4854
7194	31	4738	6	37	0	4812
7195	26	4794	3	23	0	4846
7196	5050	48	3	19	0	5120
7197	29	22	7	5092	0	5150
7198	28	9	6	5206	0	5249
7199	12	5	7	5413	0	5437
7200	12	5470	3	60	0	5545
7201	5761	31	2	39	0	5833
7202	33	24	5	5785	0	5847
7203	32	5940	5	59	0	6036
7204	11	33	4	6161	0	6209
7205	11	29	4	6234	0	6278
7206	10	11	6	6248	0	6275
7207	13	8	2	6302	0	6325
7208	6352	6	3	70	0	6431
7209	6208	7	4	42	0	6261
7210	6444	6	5	28	0	6483
7211	62	5	6	6646	0	6719
7212	44	7	6777	42	0	6870
7213	23	8	6377	36	0	6444
7214	17	9	6897	20	0	6943
7215	7155	5	53	21	0	7234
7216	41	8	30	7281	0	7360
7217	39	5	8	7246	0	7298
7218	12	7	4	7437	0	7460
7219	7426	12	1	71	0	7510
7220	7279	7	3	45	0	7334
7221	62	8522	6	31	0	8621
7222	38	52	3	8764	0	8857
7223	26	32	8762	54	0	8874
7224	14	9060	29	50	0	9153
7225	12	36	20	9132	0	9200
7226	13	28	6	9158	0	9205
7227	17	10	6	9100	0	9133
7228	17	14	1	9072	0	9104
7229	30	5	9153	70	0	9258
7230	25	12	8974	48	0	9059
7231	13	9596	45	26	0	9680
7232	11	30	28	9589	0	9658
7233	13	27	10	9556	0	9606
7234	9537	6	11	63	0	9617
7235	44	10	10000	93	0	10147
7236	36	9	32	9857	0	9934
7237	20	7	29	10644	0	10700
7238	39	24	11138	74	0	11275
7239	14	11222	31	55	0	11322
7240	11351	32	25	39	0	11447
7241	43	29	11263	37	0	11372
7242	10904	8	32	26	0	10970
7243	46	15	12543	22	0	12626
7244	46	7	25	12437	0	12515
7245	28	7	13210	47	0	13292
7246	22	15	13967	49	0	14053
7247	12	10	57	14047	0	14126
7248	23	12	63	14004	0	14102
7249	13	10	12	14767	0	14802
7250	14	13	16	14783	0	14826
7251	15	8	8	14791	0	14822
7252	20	14	15395	77	0	15506
7253	45	11	14740	68	0	14864
7254	12	15325	51	43	0	15431
7255	15699	30	32	39	0	15800
7256	49	41	8	15964	0	16062
7257	16111	9	14	100	0	16234
7258	55	18	8	16021	0	16102
7259	16702	9	44	86	0	16841
7260	57	10	15	16751	0	16833
7261	50	12	9	16883	0	16954
7262	20	18154	18	109	0	18301
7263	12	43	19	18597	0	18671
7264	16	51	20	18431	0	18518
7265	17	11	20	18485	0	18533
7266	13	12	12	18496	0	18533
7267	12	18345	18	125	0	18500
7268	18444	46	12	101	0	18603
7269	51	18321	13	72	0	18457
7270	33	39	10	18041	0	18123
7271	17844	32	10	73	0	17959
7272	63	9	17678	48	0	17798
7273	43	9	17752	25	0	17829
7274	20	12	59	17439	0	17530
7275	11	10	41	18021	0	18083
7276	11	11	15	18062	0	18099
7277	16	11	12	17556	0	17595
7278	17	5	11	17833	0	17866
7279	15	17697	10	86	0	17808
7280	8	32	16	17993	0	18049
7281	17817	27	16	76	0	17936
7282	39	9	12	17852	0	17912
7283	45	9	18077	61	0	18192
7284	13	12	37	17771	0	17833
7285	17866	10	43	99	0	18018
7286	40	18956	15	84	0	19095
7287	50	42	14	19747	0	19853
7288	13	46	11	20377	0	20447
7289	41	18	20235	148	0	20442
7290	53	20	25562	102	0	25737
7291	29794	18	268	54	0	30134
7292	306	24	168	30510	0	31008
7293	243	6	50	30993	0	31292
7294	97	15	32503	592	0	33207
7295	83	8	32513	353	0	32957
7296	25	33840	612	172	0	34649
7297	24	430	336	33538	0	34328
7298	87	283	33545	413	0	34328
7299	15	33497	396	341	0	34249
7300	33113	402	298	109	0	33922
7301	33365	297	84	72	0	33818
7302	670	142	41	32677	0	33530
7303	347	33592	26	419	0	34384
7304	33442	400	38	316	0	34196
7305	462	381	53	30148	0	31044
7306	355	85	33094	323	0	33857
7307	95	33192	396	344	0	34027
7308	32782	414	292	92	0	33580
7309	33038	311	80	90	0	33519
7310	690	84	53	32682	0	33509
7311	377	48	42	33234	0	33701
7312	134	43	32538	754	0	33469
7313	87	118	415	32539	0	33159
7314	64	61	333	31597	0	32055
7315	54	33	121	32358	0	32566
7316	44	50	87	32452	0	32633
7317	65	37	70	31839	0	32011
7318	55	31966	54	845	0	32920
7319	31644	428	67	484	0	32623
7320	475	325	31788	256	0	32844
7321	341	31053	449	175	0	32018
7322	117	457	347	31153	0	32074
7323	30685	338	129	518	0	31670
7324	452	121	101	30862	0	31536
7325	360	99	81	30627	0	31167
7326	128	89	84	31012	0	31313
7327	116	79	80	31475	0	31750
7328	137	76	30579	869	0	31661
7329	86	30684	467	548	0	31785
7330	30566	467	350	235	0	31618
7331	534	360	30192	206	0	31292
7332	405	126	497	30276	0	31304
7333	30326	97	353	564	0	31340
7334	493	30246	137	499	0	31375
7335	30398	465	122	223	0	31208
7336	592	401	100	29256	0	30349
7337	414	138	110	29907	0	30569
7338	206	112	111	29683	0	30112
7339	160	95	93	29857	0	30205
7340	28816	98	94	1018	0	30026
7341	511	96	78	29249	0	29934
7342	431	68	90	29507	0	30096
7343	27816	93	86	920	0	28915
7344	557	79	27602	612	0	28850
7345	408	83	440	27381	0	28312
7346	26165	70	371	656	0	27262
7347	26149	100	165	515	0	26929
7348	778	82	130	25865	0	26855
7349	455	84	110	25937	0	26586
7350	215	25316	105	898	0	26534
7351	159	453	128	25807	0	26547
7352	156	398	100	25308	0	25962
7353	179	131	24591	943	0	25844
7354	147	100	24505	627	0	25379
7355	111	24216	721	370	0	25418
7356	134	464	414	23559	0	24571
7357	151	348	180	24342	0	25021
7358	23955	142	131	916	0	25144
7359	521	116	121	23825	0	24583
7360	430	108	23139	718	0	24395
7361	224	102	483	23388	0	24197
7362	177	117	21992	702	0	22988
7363	172	125	21766	556	0	22619
7364	202	111	802	20975	0	22090
7365	197	162	447	21889	0	22695
7366	21608	114	167	909	0	22798
7367	21873	92	139	589	0	22693
7368	821	101	128	21745	0	22795
7369	22180	105	85	681	0	23051
7370	22468	99	92	547	0	23206
7371	871	101	100	22275	0	23347
7372	571	93	114	22508	0	23286
7373	22032	119	125	913	0	23189
7374	22436	104	106	618	0	23264
7375	954	85	106	22201	0	23346
7376	534	22256	100	727	0	23617
7377	297	473	82	22702	0	23554
7378	211	352	99	23054	0	23716
7379	169	118	22146	1101	0	23534
7380	134	77	512	22855	0	23578
7381	21710	77	403	881	0	23071
7382	493	22045	154	749	0	23441
7383	22243	445	118	458	0	23264
7384	22071	356	107	393	0	22927
7385	22419	153	106	353	0	23031
7386	893	431	123	20796	0	22243
7387	729	117	19521	622	0	20989
7388	280	94	19233	508	0	20115
7389	223	19029	693	309	0	20254
7390	125	12833	238	160	0	13356
7391	53	7656	49	94	0	7852
7392	50	7490	128	107	0	7775
7393	573	163	6703	74	0	7513
7394	4722	173	290	48	0	5233
7395	51	16	32	4659	0	4758
7396	40	9	15	4566	0	4630
7397	20	12	16	4558	0	4606
7398	18	4592	13	90	0	4713
7399	4553	52	14	49	0	4668
7400	62	30	4575	37	0	4704
7401	37	4079	32	22	0	4170
7402	17	103	27	4049	0	4196
7403	4114	24	11	46	0	4195
7404	39	6	8	4149	0	4202
7405	34	10	4066	42	0	4152
7406	17	10	4157	45	0	4229
7407	14	5	46	4207	0	4272
7408	15	7	25	4239	0	4286
7409	4238	6	11	66	0	4321
7410	40	8	4188	36	0	4272
7411	4083	5	34	29	0	4151
7412	4165	7	25	30	0	4227
7413	65	5	10	4211	0	4291
7414	41	3	4282	48	0	4374
7415	17	11	28	4321	0	4377
7416	4322	7	25	48	0	4402
7417	51	4276	7	44	0	4378
7418	4359	33	13	20	0	4425
7419	37	32	10	4291	0	4370
7420	35	4593	10	54	0	4692
7421	19	43	7	4671	0	4740
7422	10	32	18	4680	0	4740
7423	19	4821	20	75	0	4935
7424	18	48	11	4884	0	4961
7425	11	45	7	4977	0	5040
7426	20	15	8	4950	0	4993
7427	25	13	5091	89	0	5218
7428	15	5021	50	52	0	5138
7429	5043	44	40	22	0	5149
7430	55	37	10	5041	0	5143
7431	42	5521	8	59	0	5630
7432	5881	57	10	52	0	6000
7433	60	49	4	5806	0	5919
7434	60	10	10	5790	0	5870
7435	12	13	9	5729	0	5763
7436	17	13	5	5714	0	5749
7437	5605	10	5	173	0	5793
7438	70	7	8	5690	0	5775
7439	61	6	6	5698	0	5771
7440	5636	4	8	127	0	5775
7441	65	8	7	5686	0	5766
7442	64	6	5587	83	0	5740
7443	17	6	64	5660	0	5747
7444	5339	8	56	86	0	5489
7445	71	17	11	5451	0	5550
7446	67	14	5502	76	0	5659
7447	22	7	5465	74	0	5568
7448	5524	12	116	21	0	5673
7449	5751	12	56	25	0	5844
7450	5778	7	12	23	0	5820
7451	5982	21	7	26	0	6036
7452	123	15	5935	21	0	6094
7453	75	10	66	5753	0	5904
7454	35	9	55	5909	0	6008
7455	5890	3	13	130	0	6036
7456	70	11	11	6019	0	6111
7457	72	9	5782	95	0	5958
7458	23	5	69	5859	0	5956
7459	14	13	5929	100	0	6056
7460	16	6043	78	85	0	6222
7461	6204	69	64	38	0	6375
7462	82	67	13	6165	0	6327
7463	69	15	6235	100	0	6419
7464	18	10	78	6278	0	6384
7465	21	13	74	6525	0	6633
7466	31	10	6594	161	0	6796
7467	19	6	92	6635	0	6752
7468	6695	10	82	118	0	6905
7469	104	13	6358	99	0	6574
7470	6102	3	86	51	0	6242
7471	93	6188	79	39	0	6399
7472	101	72	6187	33	0	6393
7473	34	65	5967	30	0	6096
7474	23	135	139	5310	0	5607
7475	20	4	73	5481	0	5578
7476	26	8	5570	139	0	5743
7477	20	15	69	5568	0	5672
7478	5672	9	71	96	0	5848
7479	5656	6	21	92	0	5775
7480	136	6	13	5497	0	5652
7481	86	8	10	5501	0	5605
7482	30	5631	13	145	0	5819
7483	5793	56	13	103	0	5965
7484	85	65	20	5769	0	5939
7485	85	5886	13	113	0	6097
7486	5911	56	9	114	0	6090
7487	5919	59	26	62	0	6066
7488	134	6112	24	61	0	6331
7489	97	71	23	6075	0	6266
7490	46	66	22	6067	0	6201
7491	46	19	5874	169	0	6108
7492	37	12	88	5776	0	5913
7493	5804	14	90	122	0	6030
7494	106	6	47	5866	0	6025
7495	96	4	5797	137	0	6034
7496	5735	12	89	113	0	5949
7497	112	6	91	5796	0	6005
7498	112	5	5758	126	0	6001
7499	51	7	96	5822	0	5976
7500	38	9	5804	136	0	5987
7501	51	8	109	5839	0	6007
7502	62	8	81	5914	0	6065
7503	5842	14	41	181	0	6078
7504	107	5873	39	129	0	6148
7505	6091	70	33	76	0	6270
7506	5833	79	47	53	0	6012
7507	5978	26	31	69	0	6104
7508	173	6089	29	72	0	6363
7509	120	74	6180	53	0	6427
7510	52	83	101	6223	0	6459
7511	6204	20	103	124	0	6451
7512	6262	17	55	120	0	6454
7513	174	24	43	6154	0	6395
7514	6217	20	34	109	0	6380
7515	132	9	6050	118	0	6309
7516	6017	12	121	60	0	6210
7517	133	15	6099	58	0	6305
7518	104	6002	110	71	0	6287
7519	5934	79	113	56	0	6182
7520	5585	71	55	56	0	5767
7521	152	5696	46	64	0	5958
7522	5634	68	64	59	0	5825
7523	5466	65	50	60	0	5641
7524	149	33	5433	53	0	5668
7525	5273	27	89	42	0	5431
7526	116	12	5474	53	0	5655
7527	83	15	88	4906	0	5092
7528	45	5104	86	93	0	5328
7529	32	68	5080	99	0	5279
7530	4733	114	97	82	0	5026
7531	4367	48	52	138	0	4605
7532	84	9	24	4141	0	4258
7533	67	11	4214	54	0	4346
7534	25	7	45	4237	0	4314
7535	4219	8	49	57	0	4333
7536	54	4227	22	62	0	4365
7537	4270	42	13	34	0	4359
7538	4246	42	18	15	0	4321
7539	87	4236	16	28	0	4367
7540	69	42	14	4261	0	4386
7541	4287	45	18	49	0	4399
7542	54	19	11	4286	0	4370
7543	56	6	19	4325	0	4406
7544	29	9	4440	91	0	4569
7545	27	9	52	4268	0	4356
7546	33	7	44	4225	0	4309
7547	4158	17	21	96	0	4292
7548	4141	10	17	56	0	4224
7549	107	50	9	4054	0	4220
7550	70	16	4063	61	0	4210
7551	36	7	3906	50	0	3999
7552	22	59	80	3858	0	4019
7553	29	9	4151	46	0	4235
7554	23	5	50	3979	0	4057
7555	19	9	45	4007	0	4080
7556	4082	6	17	80	0	4185
7557	52	14	4087	48	0	4201
7558	3980	6	48	21	0	4055
7559	3974	5	41	15	0	4035
7560	80	9	3787	13	0	3889
7561	48	9	3777	15	0	3849
7562	29	118	69	3502	0	3718
7563	17	3521	45	34	0	3617
7564	27	3546	10	32	0	3615
7565	54	47	29	3154	0	3284
7566	15	21	6	3077	0	3119
7567	17	7	5	3132	0	3161
7568	13	4	13	3217	0	3247
7569	3098	4	6	52	0	3160
7570	28	5	10	3135	0	3178
7571	30	8	3138	32	0	3208
7572	22	6	21	3061	0	3110
7573	12	3121	21	32	0	3186
7574	11	25	10	3127	0	3173
7575	3054	20	7	32	0	3113
7576	30	4	3	3198	0	3235
7577	27	2	3167	31	0	3227
7578	11	3033	25	35	0	3104
7579	7	19	29	3075	0	3130
7580	3064	20	10	32	0	3126
7581	3042	13	8	25	0	3088
7582	46	3	9	3228	0	3286
7583	39	1	3009	29	0	3078
7584	13	2	2921	28	0	2964
7585	2886	3	47	15	0	2951
7586	29	4	3083	9	0	3125
7587	25	3	2920	11	0	2959
7588	13	31	24	2728	0	2796
7589	2763	2	35	14	0	2814
7590	2696	1	4	20	0	2721
7591	2772	2	4	6	0	2784
7592	32	2	3159	6	0	3199
7593	19	1	3094	4	0	3118
7594	2	3235	28	11	0	3276
7595	0	11	19	3187	0	3217
7596	2	14	2	3205	0	3223
7597	1	7	6	3116	0	3130
7598	3	2	3	3229	0	3237
7599	4	0	3219	28	0	3251
7600	5	3257	14	23	0	3299
7601	3462	11	15	17	0	3505
7602	3809	19	6	5	0	3839
7603	3865	2	7	6	0	3880
7604	46	4029	2	11	0	4088
7605	29	25	7	4056	0	4117
7606	4550	21	11	31	0	4613
7607	43	4602	6	39	0	4690
7608	4444	40	12	10	0	4506
7609	46	4348	13	12	0	4419
7610	4380	47	8	18	0	4453
7611	4378	27	15	10	0	4430
7612	70	6	13	4384	0	4473
7613	36	2	6	4551	0	4595
7614	18	1	4515	73	0	4607
7615	8	1	4453	40	0	4502
7616	4419	2	80	13	0	4514
7617	4520	0	39	11	0	4570
7618	75	8	15	4428	0	4526
7619	36	9	10	4488	0	4543
7620	12	6	4429	86	0	4533
7621	4	8	49	4509	0	4570
7622	14	11	4505	65	0	4595
7623	8	10	50	4455	0	4523
7624	11	7	30	4600	0	4648
7625	4588	6	7	92	0	4693
7626	4413	7	12	54	0	4486
7627	93	8	6	4444	0	4551
7628	45	17	4	4521	0	4587
7629	29	9	4464	92	0	4594
7630	26	12	49	4504	0	4591
7631	15	11	4497	68	0	4591
7632	4365	11	60	51	0	4487
7633	66	12	40	4488	0	4606
7634	4466	11	13	73	0	4563
7635	72	4417	17	53	0	4559
7636	4484	55	10	16	0	4565
7637	62	40	9	4471	0	4582
7638	53	9	17	4426	0	4505
7639	28	4470	16	100	0	4614
7640	25	55	12	4604	0	4696
7641	29	36	4582	68	0	4715
7642	17	10	70	4564	0	4661
7643	21	3	4571	83	0	4678
7644	22	4392	66	58	0	4538
7645	17	46	53	4387	0	4503
7646	25	34	4386	75	0	4520
7647	33	13	4286	52	0	4384
7648	22	8	86	4247	0	4363
7649	4242	36	48	71	0	4397
7650	63	3	4251	52	0	4369
7651	48	7	51	4235	0	4341
7652	4296	4	48	62	0	4410
7653	57	4056	20	54	0	4187
7654	4268	52	13	30	0	4363
7655	76	36	9	4166	0	4287
7656	44	18	9	4204	0	4275
7657	34	11	11	4329	0	4385
7658	4308	16	8	110	0	4442
7659	68	6	18	4311	0	4403
7660	41	21	14	4392	0	4468
7661	4211	5	19	105	0	4340
7662	65	11	4211	64	0	4351
7663	48	6	65	4262	0	4381
7664	32	10	4284	75	0	4401
7665	4219	13	68	65	0	4365
7666	66	9	59	4355	0	4489
7667	57	14	4437	77	0	4585
7668	4210	7	66	66	0	4349
7669	4289	17	54	38	0	4398
7670	102	8	4427	45	0	4582
7671	63	11	68	4318	0	4460
7672	31	15	41	4422	0	4509
7673	30	7	4489	105	0	4631
7674	27	4497	58	83	0	4665
7675	30	49	4620	46	0	4745
7676	4365	44	59	48	0	4516
7677	70	22	4555	38	0	4685
7678	4477	10	67	52	0	4606
7679	84	12	4553	53	0	4702
7680	4398	4	76	47	0	4525
7681	71	4554	52	57	0	4734
7682	56	47	37	4333	0	4473
7683	33	42	34	4568	0	4677
7684	39	13	4618	112	0	4782
7685	28	7	75	4435	0	4545
7686	26	4521	47	91	0	4685
7687	4402	47	29	65	0	4543
7688	63	4522	24	53	0	4662
7689	50	46	28	4584	0	4708
7690	4567	42	27	83	0	4719
7691	62	4560	24	79	0	4725
7692	4317	47	32	40	0	4436
7693	69	37	4229	51	0	4386
7694	58	12	76	4119	0	4265
7695	29	19	54	4117	0	4219
7696	32	8	33	4231	0	4304
7697	4219	15	32	117	0	4383
7698	4223	7	39	78	0	4347
7699	4292	13	28	40	0	4373
7700	4255	12	39	35	0	4341
7701	105	8	3962	36	0	4111
7702	3390	15	50	29	0	3484
7703	54	3430	43	30	0	3557
7704	35	3319	15	26	0	3395
7705	3003	51	203	19	0	3276
7706	2756	22	36	15	0	2829
7707	28	6	7	2695	0	2736
7708	2720	4	8	20	0	2752
7709	2614	1	16	20	0	2651
7710	3369	3	6	12	0	3390
7711	45	7	7	3318	0	3377
7712	29	3321	5	37	0	3392
7713	9	3323	5	27	0	3364
7714	11	35	10	3357	0	3413
7715	3301	21	9	36	0	3367
7716	33	3340	5	31	0	3409
7717	27	24	13	3327	0	3391
7718	18	25	3421	33	0	3497
7719	3171	7	32	30	0	3240
7720	40	3419	23	10	0	3492
7721	27	3324	6	9	0	3366
7722	3299	46	7	10	0	3362
7723	31	24	3345	13	0	3413
7724	31	5	24	3158	0	3218
7725	9	3267	25	34	0	3335
7726	10	27	5	3282	0	3324
7727	12	22	4	3259	0	3297
7728	16	3298	8	54	0	3376
7729	11	29	4	3408	0	3452
7730	14	25	7	3392	0	3438
7731	3378	5	7	51	0	3441
7732	34	3389	4	32	0	3459
7733	3459	34	7	12	0	3512
7734	34	29	6	3409	0	3478
7735	31	3640	6	37	0	3714
7736	20	35	3787	30	0	3872
7737	8	25	29	3612	0	3674
7738	15	4	19	3802	0	3840
7739	13	4	3931	49	0	3997
7740	3740	9	28	22	0	3799
7741	33	10	20	4814	0	4877
7742	4873	9	4	51	0	4937
7743	53	5	4827	62	0	4947
7744	59	5	47	4872	0	4983
7745	26	7	5163	54	0	5250
7746	6	16	57	5087	0	5166
7747	10	8	64	5151	0	5233
7748	5137	6	16	116	0	5275
7749	45	5137	6	90	0	5278
7750	5213	55	3	25	0	5296
7751	71	65	5234	16	0	5386
7752	80	19	48	5190	0	5337
7753	22	17	5465	56	0	5560
7754	4930	15	66	78	0	5089
7755	5288	11	70	26	0	5395
7756	114	12	5326	19	0	5471
7757	5277	9	61	14	0	5361
7758	5297	10	65	18	0	5390
7759	123	7	12	5309	0	5451
7760	83	11	5272	63	0	5429
7761	29	13	5535	76	0	5653
7762	19	15	108	5494	0	5636
7763	16	17	77	5328	0	5438
7764	13	5469	28	130	0	5640
7765	20	5457	12	83	0	5572
7766	5450	115	14	34	0	5613
7767	60	78	12	5500	0	5650
7768	80	5446	17	71	0	5614
7769	28	5590	13	89	0	5720
7770	5310	116	8	41	0	5475
7771	70	80	17	5380	0	5547
7772	76	5505	13	69	0	5663
7773	30	61	23	5478	0	5592
7774	26	70	14	5419	0	5529
7775	23	32	14	5420	0	5489
7776	5307	12	17	144	0	5480
7777	65	5356	15	106	0	5542
7778	78	66	15	5381	0	5540
7779	31	68	25	5384	0	5508
7780	30	17	12	5516	0	5575
7781	21	19	5290	142	0	5472
7782	5067	14	67	106	0	5254
7783	75	14	74	5206	0	5369
7784	5119	13	30	85	0	5247
7785	4975	17	27	84	0	5103
7786	5107	13	29	39	0	5188
7787	140	9	5102	45	0	5296
7788	94	5084	66	33	0	5277
7789	48	61	78	5041	0	5228
7790	31	72	5098	79	0	5280
7791	34	26	4960	94	0	5114
7792	34	16	119	4816	0	4985
7793	18	5085	85	78	0	5266
7794	5209	57	36	91	0	5393
7795	5277	74	27	38	0	5416
7796	5350	27	19	45	0	5441
7797	5300	17	17	42	0	5376
7798	143	22	5261	28	0	5454
7799	5169	17	64	41	0	5291
7800	97	5314	75	31	0	5517
7801	90	57	34	5299	0	5480
7802	37	69	27	5410	0	5543
7803	5437	24	32	128	0	5621
7804	76	11	21	5477	0	5585
7805	89	15	5416	95	0	5615
7806	5166	14	74	101	0	5355
7807	5233	20	75	41	0	5369
7808	5336	11	35	38	0	5420
7809	137	17	5410	50	0	5614
7810	4642	8	51	22	0	4723
7811	60	4721	64	29	0	4874
7812	4982	45	22	23	0	5072
7813	85	50	22	4851	0	5008
7814	68	30	11	4890	0	4999
7815	34	4894	18	91	0	5037
7816	27	43	13	4954	0	5037
7817	23	5002	9	68	0	5102
7818	19	81	11	4889	0	5000
7819	20	4912	7	59	0	4998
7820	31	50	9	4902	0	4992
7821	13	4985	19	62	0	5079
7822	23	53	6	5100	0	5182
7823	16	5343	15	69	0	5443
7824	5691	56	13	64	0	5824
7825	75	60	7	5843	0	5985
7826	87	27	15	5831	0	5960
7827	42	11	11	6123	0	6187
7828	32	10	13	6140	0	6195
7829	32	15	6250	150	0	6447
7830	22	11	65	6277	0	6375
7831	23	9	84	6354	0	6470
7832	6286	7	23	149	0	6465
7833	6039	14	18	108	0	6179
7834	131	6254	14	39	0	6438
7835	100	64	12	6060	0	6236
7836	44	108	7	6329	0	6488
7837	6432	27	8	145	0	6612
7838	94	25	6309	112	0	6540
7839	6127	17	71	47	0	6262
7840	88	6478	89	25	0	6680
7841	5452	51	30	9	0	5542
7842	5369	56	5	6	0	5436
7843	102	5377	1	8	0	5488
7844	51	5521	6	14	0	5592
7845	8	85	3	5303	0	5399
7846	7	48	5267	53	0	5375
7847	5146	4	47	51	0	5248
7848	53	4	5304	13	0	5374
7849	5187	2	49	11	0	5249
7850	57	2	5351	12	0	5422
7851	54	5154	46	12	0	5266
7852	9	44	49	5149	0	5251
7853	4929	49	6	54	0	5038
7854	5063	7	2	60	0	5132
7855	93	7	4	5075	0	5179
7856	5149	6	6	55	0	5216
7857	5156	4	8	58	0	5226
7858	103	5169	2	20	0	5294
7859	5251	50	5	14	0	5320
7860	54	5233	5	15	0	5307
7861	49	52	7	5256	0	5364
7862	5218	50	4	56	0	5328
7863	5249	10	7	63	0	5329
7864	5318	5	11	15	0	5349
7865	117	5	5287	9	0	5418
7866	67	8	5344	14	0	5433
7867	16	10	100	5284	0	5410
7868	20	8	56	5523	0	5607
7869	12	5780	17	109	0	5918
7870	5808	71	8	74	0	5961
7871	72	70	12	5772	0	5926
7872	83	14	7	5836	0	5940
7873	33	5	5801	133	0	5972
7874	20	5688	65	92	0	5865
7875	23	5791	70	25	0	5909
7876	20	136	12	5798	0	5966
7877	5708	77	44	75	0	5904
7878	82	19	10	5634	0	5745
7879	73	19	6	5841	0	5939
7880	5758	16	9	131	0	5914
7881	5788	12	10	88	0	5898
7882	145	11	11	5791	0	5958
7883	101	14	5793	84	0	5992
7884	30	17	69	5844	0	5960
7885	27	20	82	5808	0	5937
7886	5768	13	19	149	0	5949
7887	94	15	15	5882	0	6006
7888	5842	10	11	112	0	5975
7889	94	9	5774	112	0	5989
7890	100	19	72	5833	0	6024
7891	37	23	78	5836	0	5974
7892	36	15	32	5934	0	6017
7893	41	22	14	5762	0	5839
7894	37	22	17	5722	0	5798
7895	46	20	5467	201	0	5734
7896	5400	22	76	112	0	5610
7897	106	31	94	5516	0	5747
7898	122	23	5463	112	0	5720
7899	54	18	5456	114	0	5642
7900	61	24	144	5323	0	5552
7901	5350	31	94	99	0	5574
7902	5348	31	27	112	0	5518
7903	5417	34	12	50	0	5513
7904	194	32	21	5069	0	5316
7905	129	5304	20	92	0	5545
7906	5324	99	28	110	0	5561
7907	5356	107	31	41	0	5535
7908	5373	34	20	55	0	5482
7909	5281	23	43	42	0	5389
7910	202	32	28	5152	0	5414
7911	129	22	5147	117	0	5415
7912	66	20	102	5027	0	5215
7913	55	14	5033	125	0	5227
7914	4873	26	107	120	0	5126
7915	4979	17	86	73	0	5155
7916	192	18	4888	58	0	5156
7917	4876	17	85	53	0	5031
7918	5024	17	89	81	0	5211
7919	193	92	24	4816	0	5125
7920	150	4975	16	117	0	5258
7921	5004	94	16	120	0	5234
7922	129	112	28	4784	0	5053
7923	106	4532	19	123	0	4780
7924	41	65	15	4187	0	4308
7925	48	61	3922	87	0	4118
7926	29	3943	60	92	0	4124
7927	3690	50	62	33	0	3835
7928	3652	51	56	34	0	3793
7929	3435	10	65	26	0	3536
7930	3460	7	16	30	0	3513
7931	111	13	17	3284	0	3425
7932	72	3368	15	69	0	3524
7933	3338	49	10	78	0	3475
7934	69	45	3317	33	0	3464
7935	66	3203	56	33	0	3358
7936	30	38	2811	26	0	2905
7937	115	36	44	2478	0	2673
7938	26	2519	37	42	0	2624
7939	25	32	14	2580	0	2651
7940	27	30	2661	53	0	2771
7941	34	8	36	2613	0	2691
7942	27	7	43	2619	0	2696
7943	27	10	13	2713	0	2763
7944	2533	11	10	67	0	2621
7945	52	2537	11	61	0	2661
7946	53	31	8	2577	0	2669
7947	2497	32	17	43	0	2589
7948	45	2641	5	67	0	2758
7949	2705	29	16	21	0	2771
7950	57	32	2733	17	0	2839
7951	54	9	35	2680	0	2778
7952	30	2734	40	47	0	2851
7953	2750	29	14	52	0	2845
7954	54	36	2651	28	0	2769
7955	51	2485	33	27	0	2596
7956	24	33	41	2370	0	2468
7957	26	34	11	2359	0	2430
7958	2301	8	13	72	0	2394
7959	42	15	16	2324	0	2397
7960	47	7	2295	47	0	2396
7961	18	8	27	2195	0	2248
7962	23	9	2334	40	0	2406
7963	21	67	34	2081	0	2203
7964	18	2211	31	34	0	2294
7965	2114	80	13	37	0	2244
7966	2040	30	8	16	0	2094
7967	52	1929	10	11	0	2002
7968	20	1628	3	3	0	1654
7969	10	16	4	1528	0	1558
7970	1523	10	5	12	0	1550
7971	14	3	1	1530	0	1548
7972	1532	2	4	9	0	1547
7973	10	1501	5	16	0	1532
7974	9	11	7	1555	0	1582
7975	10	9	1571	9	0	1599
7976	6	4	5	1563	0	1578
7977	8	5	12	1529	0	1554
7978	1602	2	4	16	0	1624
7979	10	1536	6	9	0	1561
7980	6	41	1	1516	0	1564
7981	1540	7	2	8	0	1557
7982	13	2	1524	13	0	1552
7983	1473	2	5	2	0	1482
7984	9	2	6	1587	0	1604
7985	7	1586	0	10	0	1603
7986	1684	8	3	5	0	1700
7987	9	9	1748	0	0	1766
7988	9	0	1796	3	0	1808
7989	2	1811	13	4	0	1830
7990	1702	4	4	1	0	1711
7991	5	2	2	1719	0	1728
7992	2	3	0	1742	0	1747
7993	1776	0	0	15	0	1791
7994	9	0	1831	12	0	1852
7995	6	0	8	1891	0	1905
7996	9	0	2103	11	0	2123
7997	2	1	14	2066	0	2083
7998	1	2167	4	14	0	2186
7999	0	10	7	2211	0	2228
8000	5	6	2189	12	0	2212
8001	2197	6	12	6	0	2221
8002	10	0	4	2449	0	2463
8003	8	2	2437	14	0	2461
8004	8	1	9	2366	0	2384
8005	4	0	8	2376	0	2388
8006	2	2	2426	17	0	2447
8007	2	1	2493	14	0	2510
8008	1	1	20	2515	0	2537
8009	1	1	2542	12	0	2556
8010	2534	2	17	12	0	2565
8011	15	0	9	2599	0	2623
8012	2583	3	9	13	0	2608
8013	24	2	2571	13	0	2610
8014	14	0	16	2555	0	2585
8015	9	1	3082	22	0	3114
8016	2	3094	22	23	0	3141
8017	5	20	3134	12	0	3171
8018	5	13	3003	6	0	3027
8019	2922	9	34	4	0	2969
8020	3036	2	19	7	0	3064
8021	32	3	3074	7	0	3116
8022	21	4	23	2989	0	3037
8023	13	3	16	3101	0	3133
8024	7	2	3286	39	0	3334
8025	2	3250	30	25	0	3307
8026	3226	25	21	17	0	3289
8027	29	18	3316	6	0	3369
8028	19	10	32	3233	0	3294
8029	9	3	22	3429	0	3463
8030	3585	2	17	49	0	3653
8031	3585	2	10	34	0	3631
8032	3567	5	5	17	0	3594
8033	3636	1	10	12	0	3659
8034	56	2	13	3576	0	3647
8035	34	2	3671	40	0	3747
8036	10	3	38	3645	0	3696
8037	7	3	35	3587	0	3632
8038	5	1	15	3852	0	3873
8039	11	1	3873	70	0	3955
8040	3855	2	50	36	0	3943
8041	45	6	29	4027	0	4107
8042	42	2	4113	52	0	4209
8043	12	4185	58	43	0	4298
8044	14	41	44	4178	0	4277
8045	11	35	17	4245	0	4308
8046	4198	10	15	76	0	4299
8047	46	4243	14	59	0	4362
8048	40	38	4166	27	0	4271
8049	16	35	53	4011	0	4115
8050	12	16	40	4063	0	4131
8051	4028	5	20	78	0	4131
8052	4015	5	16	54	0	4090
8053	84	3	14	4113	0	4214
8054	4105	5	11	57	0	4178
8055	57	4107	14	55	0	4233
8056	55	44	4185	20	0	4304
8057	29	35	51	4105	0	4220
8058	26	12	44	4155	0	4237
8059	15	6	19	4229	0	4269
8060	16	3	18	4155	0	4192
8061	12	4105	16	98	0	4231
8062	4047	44	16	67	0	4174
8063	60	42	9	4129	0	4240
8064	55	4600	16	55	0	4726
8065	4607	48	21	51	0	4727
8066	4520	39	20	32	0	4611
8067	78	4676	19	30	0	4803
8068	54	53	17	4726	0	4850
8069	29	40	18	4785	0	4872
8070	28	18	14	4709	0	4769
8071	28	7	14	4865	0	4914
8072	4835	13	12	110	0	4970
8073	4789	7	29	62	0	4887
8074	94	4880	19	38	0	5031
8075	55	51	4869	40	0	5015
8076	31	37	60	4852	0	4980
8077	4891	17	53	58	0	5019
8078	64	4756	20	71	0	4911
8079	59	4830	21	38	0	4948
8080	4923	94	18	28	0	5063
8081	4996	57	18	32	0	5103
8082	102	20	21	5050	0	5193
8083	72	13	5173	83	0	5341
8084	42	10	5370	69	0	5491
8085	5534	14	113	39	0	5700
8086	5555	24	109	32	0	5720
8087	5504	13	27	37	0	5581
8088	5484	4	17	47	0	5552
8089	5502	13	15	38	0	5568
8090	139	5550	7	32	0	5728
8091	87	54	11	5404	0	5556
8092	39	5700	22	58	0	5819
8093	5909	63	13	65	0	6050
8094	5591	52	25	48	0	5716
8095	5521	15	12	49	0	5597
8096	5544	9	16	39	0	5608
8097	107	5515	6	42	0	5670
8098	5505	48	10	33	0	5596
8099	69	5578	13	36	0	5696
8100	68	51	27	5565	0	5711
8101	5577	44	10	85	0	5716
8102	69	16	5730	61	0	5876
8103	65	18	56	5760	0	5899
8104	35	38	40	6139	0	6252
8105	33	23	6143	103	0	6302
8106	30	6058	60	72	0	6220
8107	5953	53	38	51	0	6095
8108	5895	62	17	42	0	6016
8109	89	6020	29	40	0	6178
8110	64	57	6	6011	0	6138
8111	54	44	6361	78	0	6537
8112	51	6585	47	62	0	6745
8113	6334	81	40	28	0	6483
8114	68	47	6395	30	0	6540
8115	5815	20	50	37	0	5922
8116	6055	16	33	29	0	6133
8117	99	14	6677	31	0	6821
8118	60	6818	45	28	0	6951
8119	45	39	33	6775	0	6892
8120	33	38	6948	54	0	7073
8121	6624	22	48	50	0	6744
8122	6917	28	36	24	0	7005
8123	82	7145	12	32	0	7271
8124	53	42	6	6992	0	7093
8125	32	40	4	7161	0	7237
8126	44	17	7307	67	0	7435
8127	25	7557	40	40	0	7662
8128	8049	37	32	24	0	8142
8129	7907	32	9	14	0	7962
8130	7980	13	12	9	0	8014
8131	73	16	7986	9	0	8084
8132	7640	6	32	20	0	7698
8133	7917	11	30	16	0	7974
8134	61	11	9	8036	0	8117
8135	37	6	8010	38	0	8091
8136	21	14	34	7885	0	7954
8137	30	9	8186	38	0	8263
8138	19	102	25	7775	0	7921
8139	16	7894	25	33	0	7968
8140	8	8565	3	25	0	8601
8141	8	35	5	8678	0	8726
8142	13	15	11	8432	0	8471
8143	8680	9	8	40	0	8737
8144	28	12	8764	17	0	8821
8145	8358	3	22	15	0	8398
8146	25	8771	18	15	0	8829
8147	8776	22	7	13	0	8818
8148	8728	17	8	6	0	8759
8149	142	7	7	8672	0	8828
8150	32	9	9292	26	0	9359
8151	12	5	21	9207	0	9245
8152	6	9810	14	26	0	9856
8153	10	25	6	9773	0	9814
8154	9	18	9	9802	0	9838
8155	9710	13	6	55	0	9784
8156	34	9	4	9750	0	9797
8157	28	9690	4	41	0	9763
8158	13	27	4	9775	0	9819
8159	9971	20	4	44	0	10039
8160	45	10124	8	30	0	10207
8161	35	43	4	10744	0	10826
8162	17	31	5	10754	0	10807
8163	16	8	6	11211	0	11241
8164	20	4	3	11113	0	11140
8165	11436	6	9	101	0	11552
8166	67	5	13	11574	0	11659
8167	56	9	4	11869	0	11938
8168	15	14	4	12305	0	12338
8169	10	12739	10	141	0	12900
8170	12793	97	10	86	0	12986
8171	123	58	12884	21	0	13086
8172	66	12924	95	23	0	13108
8173	12833	103	67	12	0	13015
8174	120	66	13765	20	0	13971
8175	81	14254	100	29	0	14464
8176	21	199	69	13891	0	14180
8177	12	14468	13	102	0	14595
8178	12	105	14498	73	0	14688
8179	19	70	14669	34	0	14792
8180	4	14918	159	47	0	15128
8181	14743	104	75	15	0	14937
8182	14508	65	26	11	0	14610
8183	174	16	14484	13	0	14687
8184	90	16	13765	21	0	13892
8185	30	6	14595	21	0	14652
8186	13	9	163	14237	0	14422
8187	15	5	88	14194	0	14302
8188	11	11	17	14797	0	14836
8189	26	5	15513	186	0	15730
8190	12	11	109	15039	0	15171
8191	16	18	64	15464	0	15562
8192	27	10	15498	184	0	15719
8193	14273	17	132	94	0	14516
8194	117	21	77	15867	0	16082
8195	73	18	22	15718	0	15831
8196	28	16046	17	184	0	16275
8197	16076	117	32	95	0	16320
8198	132	84	16158	34	0	16408
8199	15744	29	119	36	0	15928
8200	125	30	85	16086	0	16326
8201	108	18	16673	130	0	16929
8202	25	23	138	16615	0	16801
8203	16684	36	87	158	0	16965
8204	138	17	16812	98	0	17065
8205	16305	21	151	40	0	16517
8206	16657	27	104	31	0	16819
8207	16950	18	45	28	0	17041
8208	208	16822	37	41	0	17108
8209	108	120	31	17353	0	17612
8210	17793	83	42	162	0	18080
8211	17489	43	39	108	0	17679
8212	17695	22	44	59	0	17820
8213	227	16	17513	46	0	17802
8214	17599	26	138	54	0	17817
8215	166	25	107	18638	0	18936
8216	129	15	18671	187	0	19002
8217	30	27	184	19025	0	19266
8218	39	29	118	19055	0	19241
8219	60	23	19669	310	0	20062
8220	49	30	195	19476	0	19750
8221	49	18	146	20002	0	20215
8222	41	16	22944	371	0	23372
8223	23083	27	279	225	0	23614
8224	25900	21	236	100	0	26257
8225	537	24	81	27033	0	27675
8226	324	22	27001	388	0	27735
8227	114	25	357	26577	0	27073
8228	74	26580	297	453	0	27404
8229	65	343	84	26337	0	26829
8230	71	289	48	26842	0	27250
8231	26650	73	61	634	0	27418
8232	26292	55	80	374	0	26801
8233	27165	31	56	139	0	27391
8234	670	52	51	26263	0	27036
8235	365	52	55	26976	0	27448
8236	145	29	26733	661	0	27568
8237	104	43	376	26020	0	26543
8238	97	26703	310	430	0	27540
8239	26754	353	107	331	0	27545
8240	399	26395	82	163	0	27039
8241	26876	387	75	112	0	27450
8242	467	298	69	25344	0	26178
8243	324	26215	79	440	0	27058
8244	26122	374	84	348	0	26928
8245	25423	315	92	242	0	26072
8246	669	83	60	26023	0	26835
8247	380	26282	83	457	0	27202
8248	166	360	57	26665	0	27248
8249	123	295	26248	497	0	27163
8250	25159	84	397	380	0	26020
8251	430	25655	306	218	0	26609
8252	25614	364	107	157	0	26242
8253	472	290	87	25252	0	26101
8254	25681	85	77	442	0	26285
8255	505	56	25651	390	0	26602
8256	25947	53	419	183	0	26602
8257	26394	42	331	159	0	26926
8258	761	147	26425	148	0	27481
8259	458	60	493	25695	0	26706
8260	215	63	335	25974	0	26587
8261	25379	56	121	751	0	26307
8262	469	25295	98	517	0	26379
8263	390	380	68	25035	0	25873
8264	183	307	24588	505	0	25583
8265	169	108	24205	394	0	24876
8266	170	24066	592	262	0	25090
8267	203	396	24001	149	0	24749
8268	22675	332	440	131	0	23578
8269	412	136	329	22093	0	22970
8270	22726	62	114	393	0	23295
8271	431	77	22587	347	0	23442
8272	351	80	346	22181	0	22958
8273	171	82	295	22452	0	23000
8274	166	84	21646	619	0	22515
8275	155	78	346	21453	0	22032
8276	21293	74	305	442	0	22114
8277	21214	77	101	361	0	21753
8278	659	67	62	21218	0	22006
8279	21138	69	79	415	0	21701
8280	20826	77	67	386	0	21356
8281	632	20691	71	210	0	21604
8282	430	324	81	20862	0	21697
8283	20935	293	83	402	0	21713
8284	439	115	77	20980	0	21611
8285	20150	85	82	444	0	20761
8286	491	76	85	20452	0	21104
8287	416	79	20414	468	0	21377
8288	215	20482	355	404	0	21456
8289	194	372	317	18024	0	18907
8290	179	19992	129	392	0	20692
8291	19470	379	114	352	0	20315
8292	417	19492	127	202	0	20238
8293	374	19412	101	187	0	20074
8294	221	594	94	18843	0	19752
8295	18827	353	128	439	0	19747
8296	479	146	92	18855	0	19572
8297	18865	111	81	470	0	19527
8298	18674	109	115	376	0	19274
8299	641	18682	101	233	0	19657
8300	18942	355	101	186	0	19584
8301	18273	309	125	160	0	18867
8302	18452	120	128	156	0	18856
8303	743	92	17630	174	0	18639
8304	532	81	377	17075	0	18065
8305	278	91	333	17757	0	18459
8306	227	91	17427	671	0	18416
8307	17308	86	388	431	0	18213
8308	17733	83	345	204	0	18365
8309	17407	102	135	189	0	17833
8310	16891	74	113	196	0	17274
8311	729	16444	110	191	0	17474
8312	16563	337	90	194	0	17184
8313	539	311	80	16182	0	17112
8314	470	124	15802	413	0	16809
8315	14935	92	338	364	0	15729
8316	478	15051	274	211	0	16014
8317	13944	330	108	136	0	14518
8318	450	13982	88	157	0	14677
8319	364	13223	72	166	0	13825
8320	211	13160	77	147	0	13595
8321	157	12632	125	212	0	13126
8322	314	354	9044	96	0	9808
8323	309	900	221	6904	0	8334
8324	57	38	5695	136	0	5926
8325	4278	26	95	83	0	4482
8326	97	4295	67	53	0	4512
8327	78	4261	29	86	0	4454
8328	63	114	28	4177	0	4382
8329	45	72	12	4127	0	4256
8330	53	37	4193	215	0	4498
8331	45	34	4306	69	0	4454
8332	41	31	105	4271	0	4448
8333	39	29	4428	86	0	4582
8334	47	4401	83	75	0	4606
8335	56	70	64	4330	0	4520
8336	56	61	23	4535	0	4675
8337	59	28	4459	127	0	4673
8338	63	24	62	4437	0	4586
8339	4421	25	66	90	0	4602
8340	114	17	26	4383	0	4540
8341	89	20	20	4287	0	4416
8342	50	17	4325	141	0	4533
8343	4161	18	74	90	0	4343
8344	93	4363	72	52	0	4580
8345	116	65	23	4426	0	4630
8346	70	74	4409	83	0	4636
8347	60	30	63	4334	0	4487
8348	4369	40	66	85	0	4560
8349	101	29	4390	91	0	4611
8350	105	33	68	4368	0	4574
8351	53	29	4611	94	0	4787
8352	56	4497	81	95	0	4729
8353	53	129	4546	55	0	4783
8354	38	4591	84	52	0	4765
8355	33	57	4209	15	0	4314
8356	14	171	128	3516	0	3829
8357	15	3703	56	37	0	3811
8358	3394	38	14	41	0	3487
8359	39	44	10	3397	0	3490
8360	3493	11	4	39	0	3547
8361	42	10	10	3521	0	3583
8362	51	13	3	3597	0	3664
8363	3587	7	6	77	0	3677
8364	3542	10	7	58	0	3617
8365	76	5	11	3622	0	3714
8366	59	7	3758	39	0	3863
8367	21	3915	38	48	0	4022
8368	21	37	3957	24	0	4039
8369	13	3951	46	16	0	4026
8370	3929	46	55	10	0	4040
8371	49	53	3731	9	0	3842
8372	58	19	3723	8	0	3808
8373	13	9	88	3620	0	3730
8374	3714	7	56	46	0	3823
8375	40	5	3840	55	0	3940
8376	61	3929	39	15	0	4044
8377	3928	38	57	14	0	4037
8378	3908	53	11	19	0	3991
8379	3961	16	15	12	0	4004
8380	3983	14	5	18	0	4020
8381	3932	12	11	13	0	3968
8382	92	12	3752	5	0	3861
8383	56	34	37	3533	0	3660
8384	16	3672	60	42	0	3790
8385	3684	41	16	46	0	3787
8386	40	3772	9	26	0	3847
8387	3452	35	7	12	0	3506
8388	3278	41	10	10	0	3339
8389	64	3291	10	9	0	3374
8390	3352	32	9	12	0	3405
8391	39	40	8	3292	0	3379
8392	44	7	12	3319	0	3382
8393	13	7	3303	70	0	3393
8394	14	3443	36	45	0	3538
8395	7	39	43	3429	0	3518
8396	9	40	16	3412	0	3477
8397	12	17	12	3480	0	3521
8398	17	7	3427	72	0	3523
8399	3205	8	35	54	0	3302
8400	35	6	46	3536	0	3623
8401	3607	6	19	46	0	3678
8402	45	6	16	3602	0	3669
8403	48	12	3783	43	0	3886
8404	21	11	3878	45	0	3955
8405	3500	14	64	19	0	3597
8406	3712	7	51	10	0	3780
8407	63	3713	14	16	0	3806
8408	48	31	3810	11	0	3900
8409	33	35	24	3652	0	3744
8410	15	14	38	3711	0	3778
8411	4030	5	17	63	0	4115
8412	4053	9	14	46	0	4122
8413	4109	10	4	26	0	4149
8414	76	10	4064	10	0	4160
8415	4265	8	31	14	0	4318
8416	48	5	39	4275	0	4367
8417	52	7	21	4247	0	4327
8418	32	11	11	4314	0	4368
8419	16	4295	16	68	0	4395
8420	4331	33	10	50	0	4424
8421	35	38	23	4316	0	4412
8422	41	19	4376	40	0	4476
8423	25	16	38	4307	0	4386
8424	20	4345	45	70	0	4480
8425	4396	32	26	40	0	4494
8426	41	38	18	4331	0	4428
8427	57	16	10	4302	0	4385
8428	38	12	4513	63	0	4626
8429	26	8	35	4435	0	4504
8430	31	4338	38	42	0	4449
8431	26	29	16	4426	0	4497
8432	23	41	4461	42	0	4567
8433	3768	13	32	39	0	3852
8434	3984	5	37	17	0	4043
8435	66	4089	14	9	0	4178
8436	3893	23	10	10	0	3936
8437	3929	30	3	13	0	3975
8438	54	3914	6	54	0	4028
8439	44	26	5	3980	0	4055
8440	4033	31	6	32	0	4102
8441	43	4140	8	36	0	4227
8442	38	27	4138	15	0	4218
8443	4071	26	30	11	0	4138
8444	4213	6	24	11	0	4254
8445	4192	7	8	15	0	4222
8446	4241	6	5	16	0	4268
8447	54	4258	7	14	0	4333
8448	4270	29	4	14	0	4317
8449	4363	23	9	12	0	4407
8450	4604	10	6	17	0	4637
8451	63	3	7	4581	0	4654
8452	4593	2	9	46	0	4650
8453	42	4993	9	37	0	5081
8454	41	45	5271	16	0	5373
8455	20	34	55	5508	0	5617
8456	5587	8	45	73	0	5713
8457	68	9	5658	58	0	5793
8458	59	4	68	5561	0	5692
8459	23	5	5633	78	0	5739
8460	16	5650	59	75	0	5800
8461	15	63	52	5607	0	5737
8462	22	52	5682	65	0	5821
8463	13	5512	60	54	0	5639
8464	12	52	42	5398	0	5504
8465	5621	46	11	57	0	5735
8466	5498	8	4	46	0	5556
8467	5567	2	4	12	0	5585
8468	5523	4	3	8	0	5538
8469	5741	4	6	3	0	5754
8470	120	3	5665	7	0	5795
8471	5622	7	56	10	0	5695
8472	5691	3	45	11	0	5750
8473	101	5	12	5762	0	5880
8474	5750	7	4	60	0	5821
8475	5578	4	4	50	0	5636
8476	100	5464	7	16	0	5587
8477	63	56	10	5381	0	5510
8478	11	48	10	5456	0	5525
8479	5414	9	7	105	0	5535
8480	65	5361	9	63	0	5498
8481	51	5509	10	25	0	5595
8482	22	98	6	5543	0	5669
8483	16	53	12	5556	0	5637
8484	16	15	12	5531	0	5574
8485	23	5	13	5626	0	5667
8486	5534	9	11	125	0	5679
8487	5408	15	8	61	0	5492
8488	125	9	5485	21	0	5640
8489	73	15	70	5308	0	5466
8490	31	12	47	5483	0	5573
8491	28	8	5441	114	0	5591
8492	5224	9	67	71	0	5371
8493	78	5422	59	27	0	5586
8494	5352	69	14	14	0	5449
8495	95	59	6	5293	0	5453
8496	73	9	5471	73	0	5626
8497	31	14	68	5502	0	5615
8498	65	12	5603	75	0	5755
8499	27	5722	71	71	0	5891
8500	5374	65	170	19	0	5628
8501	5387	52	12	19	0	5470
8502	117	5413	10	16	0	5556
8503	74	62	10	5329	0	5475
8504	5170	54	10	69	0	5303
8505	76	5221	14	65	0	5376
8506	72	62	11	5187	0	5332
8507	5219	55	4	73	0	5351
8508	78	9	5096	66	0	5249
8509	5008	8	63	19	0	5098
8510	77	5061	50	26	0	5214
8511	4965	61	16	16	0	5058
8512	4869	55	13	26	0	4963
8513	123	12	4864	27	0	5026
8514	76	11	67	4725	0	4879
8515	38	20	50	4973	0	5081
8516	27	15	5026	120	0	5188
8517	34	8	69	4934	0	5045
8518	32	14	57	5001	0	5104
8519	5033	13	16	127	0	5189
8520	5061	15	13	75	0	5164
8521	136	9	12	5045	0	5202
8522	74	16	5062	76	0	5228
8523	35	16	64	5069	0	5184
8524	30	7	57	5121	0	5215
8525	35	10	5192	120	0	5357
8526	47	14	62	5234	0	5357
8527	5138	14	59	73	0	5284
8528	4952	23	20	66	0	5061
8529	115	4971	8	46	0	5140
8530	5077	57	14	35	0	5183
8531	5013	55	15	28	0	5111
8532	119	5021	14	35	0	5189
8533	5099	66	10	25	0	5200
8534	5007	53	11	25	0	5096
8535	5187	17	12	23	0	5239
8536	128	16	5097	27	0	5268
8537	4964	12	58	33	0	5067
8538	92	8	51	5058	0	5209
8539	5072	16	16	72	0	5176
8540	82	15	5050	63	0	5210
8541	82	5008	50	33	0	5173
8542	5069	56	61	27	0	5213
8543	70	5348	24	28	0	5470
8544	64	64	11	5279	0	5418
8545	22	66	14	5508	0	5610
8546	5472	13	13	113	0	5611
8547	5429	11	11	83	0	5534
8548	124	11	5534	27	0	5696
8549	74	13	5184	26	0	5297
8550	23	8	5062	25	0	5118
8551	21	55	90	4802	0	4968
8552	19	10	4945	56	0	5030
8553	17	5	4444	47	0	4513
8554	8	187	48	3924	0	4167
8555	4173	3	20	18	0	4214
8556	4079	1	3	22	0	4105
8557	4131	3	1	13	0	4148
8558	4098	4	3	12	0	4117
8559	34	2	2	4128	0	4166
8560	23	0	4	4224	0	4251
8561	3	2	4640	36	0	4681
8562	3	2	20	4492	0	4517
8563	9	1	25	4636	0	4671
8564	4705	2	4	47	0	4758
8565	4705	4	3	24	0	4736
8566	40	1	3	4714	0	4758
8567	4830	0	3	30	0	4863
8568	4799	3	4	27	0	4833
8569	39	2	6	4945	0	4992
8570	25	1	4	4942	0	4972
8571	8	2	4896	52	0	4958
8572	15	1	5038	29	0	5083
8573	10	0	46	4953	0	5009
8574	5	1	25	5082	0	5113
8575	8	5	5110	47	0	5170
8576	4957	4	29	25	0	5015
8577	5051	9	24	10	0	5094
8578	52	1	5341	13	0	5407
8579	25	5426	26	11	0	5488
8580	5581	25	21	11	0	5638
8581	48	23	6086	16	0	6173
8582	31	6	30	5919	0	5986
8583	10	1	26	6113	0	6150
8584	6467	1	10	56	0	6534
8585	6677	2	5	40	0	6724
8586	61	1	10	6702	0	6774
8587	28	3	10	7183	0	7224
8588	7406	1	7	67	0	7481
8589	7279	2	9	38	0	7328
8590	7311	2	7	16	0	7336
8591	85	2	7583	9	0	7679
8592	48	1	41	7572	0	7662
8593	11	2	39	7724	0	7776
8594	7728	2	10	88	0	7828
8595	47	7736	15	51	0	7849
8596	8530	41	13	22	0	8606
8597	65	8955	8	28	0	9056
8598	59	74	10	9196	0	9339
8599	20	61	14	9247	0	9342
8600	27	6	9211	144	0	9388
8601	17	4	82	9186	0	9289
8602	23	5	9291	99	0	9418
8603	23	4	85	9217	0	9329
8604	15	3	68	9162	0	9248
8605	16	9010	20	162	0	9208
8606	17	9372	16	85	0	9490
8607	23	147	15	9152	0	9337
8608	23	93	13	9384	0	9513
8609	18	15	11	9468	0	9512
8610	21	8	13	9624	0	9666
8611	22	5	7	9828	0	9862
8612	26	6	9672	174	0	9878
8613	29	14	90	9479	0	9612
8614	28	14	74	9731	0	9847
8615	24	9	9363	187	0	9583
8616	13	9321	98	141	0	9573
8617	19	87	81	9365	0	9552
8618	32	70	9523	120	0	9745
8619	21	9678	101	99	0	9899
8620	15	94	85	9634	0	9828
8621	9964	71	15	128	0	10178
8622	110	18	12	9909	0	10049
8623	95	25	16	9830	0	9966
8624	31	27	13	10085	0	10156
8625	24	16	18	9926	0	9984
8626	15	9744	21	223	0	10003
8627	12	96	29	9987	0	10124
8628	10607	71	19	162	0	10859
8629	94	18	39	10816	0	10967
8630	88	10	26	10802	0	10926
8631	20	17	26	11022	0	11085
8632	10842	24	17	222	0	11105
8633	10804	27	24	134	0	10989
8634	170	31	21	11012	0	11234
8635	11006	31	23	161	0	11221
8636	10951	20	30	125	0	11126
8637	165	11154	18	97	0	11434
8638	11109	95	22	87	0	11313
8639	107	11311	35	89	0	11542
8640	72	11354	31	95	0	11552
8641	30	218	27	11336	0	11611
8642	29	80	12074	162	0	12345
8643	24	41	104	11735	0	11904
8644	31	23	84	11850	0	11988
8645	27	11806	38	250	0	12121
8646	11785	117	27	141	0	12070
8647	105	74	24	11852	0	12055
8648	88	37	13168	156	0	13449
8649	31	20	95	12941	0	13087
8650	31	13350	68	179	0	13628
8651	13507	89	16	168	0	13780
8652	115	75	23	13560	0	13773
8653	88	38	13909	179	0	14214
8654	35	35	121	13806	0	13997
8655	41	13818	85	143	0	14087
8656	26	106	17	13964	0	14113
8657	14236	78	28	191	0	14533
8658	14332	36	34	167	0	14569
8659	14801	40	27	104	0	14972
8660	179	14903	28	113	0	15223
8661	14718	104	28	90	0	14940
8662	132	105	14	14633	0	14884
8663	14616	39	21	184	0	14860
8664	126	14874	11	170	0	15181
8665	112	113	30	15196	0	15451
8666	40	125	15807	189	0	16161
8667	14687	53	104	188	0	15032
8668	99	16012	103	165	0	16379
8669	97	123	41	15982	0	16243
8670	37	88	31	16220	0	16376
8671	41	50	52	16078	0	16221
8672	39	52	20	15953	0	16064
8673	40	16117	25	266	0	16448
8674	16118	123	28	176	0	16445
8675	15828	108	27	89	0	16052
8676	205	39	16571	109	0	16924
8677	127	50	107	16552	0	16836
8678	82	25	16903	168	0	17178
8679	16145	49	109	164	0	16467
8680	16546	32	91	113	0	16782
8681	16062	37	26	95	0	16220
8682	196	52	29	16096	0	16373
8683	117	16119	17	186	0	16439
8684	16369	109	24	136	0	16638
8685	143	109	18	16224	0	16494
8686	16431	44	36	164	0	16675
8687	158	45	16148	137	0	16488
8688	143	29	16021	63	0	16256
8689	16238	30	162	76	0	16506
8690	139	62	102	16425	0	16728
8691	16462	29	27	152	0	16670
8692	144	16475	13	166	0	16798
8693	16682	129	30	71	0	16912
8694	16596	106	15	67	0	16784
8695	211	68	17417	58	0	17754
8696	121	21	15821	39	0	16002
8697	39	16346	122	37	0	16544
8698	71	64	111	16388	0	16634
8699	16450	68	38	87	0	16643
8700	72	20	11	16485	0	16588
8701	73	18	8	16929	0	17028
8702	43	125	16821	132	0	17121
8703	16027	11	56	105	0	16199
8704	78	13	66	17265	0	17422
8705	101	14	17246	76	0	17437
8706	60	24	17006	80	0	17170
8707	32	41	115	17078	0	17266
8708	34	14	17461	77	0	17586
8709	50	11	17275	74	0	17410
8710	29	86	126	16741	0	16982
8711	45	12	18081	71	0	18209
8712	26	27	75	17588	0	17716
8713	30	17969	80	88	0	18167
8714	18811	60	23	81	0	18975
8715	74	19347	11	41	0	19473
8716	95	180	16	19005	0	19296
8717	32	19700	13	287	0	20032
8718	41	84	20600	95	0	20820
8719	32	94	106	22226	0	22458
8720	41	23	26789	169	0	27022
8721	25681	16	258	157	0	26112
8722	246	27648	219	62	0	28175
8723	27877	248	38	33	0	28196
8724	300	222	45	27151	0	27718
8725	27669	54	38	259	0	28020
8726	316	27	27516	442	0	28301
8727	265	27700	251	90	0	28306
8728	26984	261	251	34	0	27530
8729	297	276	65	25291	0	25929
8730	243	26892	40	248	0	27423
8731	83	274	26	27042	0	27425
8732	27075	239	34	348	0	27696
8733	276	28437	28	285	0	29026
8734	28676	299	32	87	0	29094
8735	371	258	28294	49	0	28972
8736	27695	66	329	38	0	28128
8737	349	36	276	28142	0	28803
8738	28203	14	77	322	0	28616
8739	345	28125	59	302	0	28831
8740	295	314	45	27799	0	28453
8741	75	277	48	28250	0	28650
8742	73	63	27223	574	0	27933
8743	58	40	327	26774	0	27199
8744	67	37	279	27122	0	27505
8745	53	52	103	26980	0	27188
8746	45	43	50	27641	0	27779
8747	65	42	27141	632	0	27880
8748	50	25529	356	554	0	26489
8749	53	374	309	25955	0	26691
8750	25444	302	84	437	0	26267
8751	25535	86	61	310	0	25992
8752	586	26031	55	127	0	26799
8753	25929	343	62	77	0	26411
8754	25463	291	74	61	0	25889
8755	25679	83	81	66	0	25909
8756	661	25474	55	80	0	26270
8757	25111	338	82	49	0	25580
8758	410	389	42	24346	0	25187
8759	326	80	24228	373	0	25007
8760	123	24160	326	329	0	24938
8761	103	387	287	24123	0	24900
8762	98	296	23957	368	0	24719
8763	23174	79	343	325	0	23921
8764	367	60	278	23556	0	24261
8765	309	45	98	23548	0	24000
8766	109	71	78	22842	0	23100
8767	81	88	42	23453	0	23664
8768	163	37	22552	677	0	23429
8769	21197	42	363	396	0	21998
8770	353	22375	305	162	0	23195
8771	22365	329	86	128	0	22908
8772	428	22359	72	156	0	23015
8773	22572	367	54	105	0	23098
8774	389	305	51	22276	0	23021
8775	356	108	22232	386	0	23082
8776	148	84	21980	336	0	22548
8777	124	72	626	21395	0	22217
8778	119	99	328	21299	0	21845
8779	124	87	98	21770	0	22079
8780	21406	76	66	655	0	22203
8781	412	73	21337	390	0	22212
8782	460	20845	338	165	0	21808
8783	154	21443	283	160	0	22040
8784	20810	584	78	129	0	21601
8785	405	350	20703	142	0	21600
8786	359	20518	334	185	0	21396
8787	165	355	20425	123	0	21068
8788	147	335	351	19799	0	20632
8789	142	130	19983	390	0	20645
8790	163	104	19930	330	0	20527
8791	179	88	546	19593	0	20406
8792	140	87	19623	400	0	20250
8793	136	76	19494	347	0	20053
8794	293	80	551	18838	0	19762
8795	18371	72	314	413	0	19170
8796	367	91	18412	362	0	19232
8797	334	81	343	18045	0	18803
8798	175	69	289	18049	0	18582
8799	17835	63	124	625	0	18647
8800	395	94	70	17831	0	18390
8801	17558	73	63	474	0	18168
8802	411	17339	87	376	0	18213
8803	388	328	84	17596	0	18396
8804	17400	291	105	400	0	18196
8805	17411	122	85	328	0	17946
8806	616	94	53	17189	0	17952
8807	378	71	17149	440	0	18038
8808	16548	102	344	342	0	17336
8809	356	17021	306	195	0	17878
8810	17073	330	118	181	0	17702
8811	16637	273	111	155	0	17176
8812	16863	104	104	158	0	17229
8813	606	71	16274	164	0	17115
8814	331	15681	353	147	0	16512
8815	176	443	293	14914	0	15826
8816	107	504	115	14998	0	15724
8817	125	104	14708	538	0	15475
8818	114	13634	302	326	0	14376
8819	80	11174	197	139	0	11590
8820	39	7196	117	50	0	7402
8821	6456	169	388	39	0	7052
8822	99	88	22	6122	0	6331
8823	89	21	21	6205	0	6336
8824	42	21	6230	155	0	6448
8825	6151	14	94	99	0	6358
8826	97	28	78	6368	0	6571
8827	158	90	31	6389	0	6668
8828	119	20	6498	163	0	6800
8829	40	6532	104	100	0	6776
8830	27	96	70	6507	0	6700
8831	36	57	6505	113	0	6711
8832	23	5633	81	79	0	5816
8833	4600	45	39	24	0	4708
8834	48	35	4772	16	0	4871
8835	40	17	43	4353	0	4453
8836	25	4557	30	35	0	4647
8837	4515	45	8	35	0	4603
8838	40	38	7	4528	0	4613
8839	4529	15	10	44	0	4598
8840	4546	8	9	36	0	4599
8841	65	4593	10	19	0	4687
8842	4502	42	12	6	0	4562
8843	4629	29	9	14	0	4681
8844	69	6	4678	17	0	4770
8845	4611	5	45	15	0	4676
8846	46	9	4713	9	0	4777
8847	4498	7	63	11	0	4579
8848	4637	5	33	11	0	4686
8849	58	6	4862	9	0	4935
8850	27	8	34	4804	0	4873
8851	11	11	5146	40	0	5208
8852	8	5	4832	20	0	4865
8853	13	122	4958	12	0	5105
8854	6	6	38	4713	0	4763
8855	6	6	17	5146	0	5175
8856	6	4	6	5248	0	5264
8857	6	5	4	5463	0	5478
8858	12	1	5516	61	0	5590
8859	5	4	35	5655	0	5699
8860	10	5664	31	52	0	5757
8861	13	41	5866	31	0	5951
8862	8	31	45	5807	0	5891
8863	16	8	6179	42	0	6245
8864	5	6223	40	40	0	6308
8865	6	6348	39	14	0	6407
8866	4	70	7	6239	0	6320
8867	12	38	6270	38	0	6358
8868	10	11	6258	35	0	6314
8869	6	9	79	6151	0	6245
8870	6	12	37	6159	0	6214
8871	8	6	10	6361	0	6385
8872	15	42	6402	85	0	6544
8873	9	6311	42	46	0	6408
8874	10	6456	36	16	0	6518
8875	13	76	10	6416	0	6515
8876	15	37	6372	57	0	6481
8877	13	12	6450	45	0	6520
8878	8	6576	83	14	0	6681
8879	6532	49	42	15	0	6638
8880	47	6630	12	18	0	6707
8881	45	47	7150	18	0	7260
8882	7032	46	62	15	0	7155
8883	67	7	56	7331	0	7461
8884	7405	10	12	71	0	7498
8885	68	7	17	7479	0	7571
8886	59	7	14	7635	0	7715
8887	7833	8	19	138	0	7998
8888	99	8059	7	105	0	8270
8889	72	89	8015	27	0	8203
8890	13	8191	90	26	0	8320
8891	8059	100	70	19	0	8248
8892	85	8245	24	22	0	8376
8893	8222	95	22	18	0	8357
8894	8180	85	16	20	0	8301
8895	161	8210	16	21	0	8408
8896	82	101	17	8072	0	8272
8897	7960	80	15	92	0	8147
8898	7957	19	13	83	0	8072
8899	150	21	20	7949	0	8140
8900	80	12	7769	112	0	7973
8901	33	12	7952	83	0	8080
8902	22	105	160	7836	0	8123
8903	25	13	7775	109	0	7922
8904	7358	16	105	77	0	7556
8905	79	7542	78	27	0	7726
8906	77	91	23	7552	0	7743
8907	31	77	20	7570	0	7698
8908	22	23	24	7530	0	7599
8909	15	24	25	7517	0	7581
8910	18	18	18	7537	0	7591
8911	25	16	7391	175	0	7607
8912	22	7447	95	104	0	7668
8913	7568	93	84	33	0	7778
8914	99	88	30	7449	0	7666
8915	80	34	25	7486	0	7625
8916	29	29	16	7689	0	7763
8917	35	7584	20	180	0	7819
8918	26	107	27	7774	0	7934
8919	30	94	22	7773	0	7919
8920	7607	41	24	184	0	7856
8921	97	7461	30	123	0	7711
8922	85	7490	20	55	0	7650
8923	46	167	24	7444	0	7681
8924	7387	92	17	123	0	7619
8925	112	40	7405	99	0	7656
8926	7088	23	128	53	0	7292
8927	111	22	7525	53	0	7711
8928	90	15	114	7238	0	7457
8929	39	30	85	7428	0	7582
8930	35	25	30	7389	0	7479
8931	14	24	33	7458	0	7529
8932	20	20	27	7538	0	7605
8933	7363	18	21	209	0	7611
8934	118	22	7255	130	0	7525
8935	88	25	101	7438	0	7652
8936	35	33	7792	134	0	7994
8937	33	7760	111	139	0	8043
8938	7707	111	86	60	0	7964
8939	138	90	8032	60	0	8320
8940	100	32	111	8073	0	8316
8941	37	39	90	8237	0	8403
8942	33	29	8303	214	0	8579
8943	39	30	8377	132	0	8578
8944	34	26	194	8069	0	8323
8945	8421	27	102	141	0	8691
8946	8468	29	48	112	0	8657
8947	181	8545	28	83	0	8837
8948	8647	113	23	63	0	8846
8949	146	93	25	8209	0	8473
8950	115	8529	26	138	0	8808
8951	40	112	25	8534	0	8711
8952	56	96	8641	157	0	8950
8953	36	37	116	8350	0	8539
8954	30	31	92	8617	0	8770
8955	8229	15	24	231	0	8499
8956	118	8189	34	149	0	8490
8957	8255	106	27	63	0	8451
8958	130	8246	33	57	0	8466
8959	7834	100	28	41	0	8003
8960	104	7869	47	46	0	8066
8961	81	7833	18	61	0	7993
8962	7908	155	60	43	0	8166
8963	117	84	127	7457	0	7785
8964	73	7415	19	124	0	7631
8965	7533	83	19	100	0	7735
8966	7469	77	33	52	0	7631
8967	7794	26	21	51	0	7892
8968	7785	16	30	43	0	7874
8969	150	7901	24	44	0	8119
8970	91	94	12	7861	0	8058
8971	40	74	21	7957	0	8092
8972	7915	24	19	163	0	8121
8973	96	24	15	7925	0	8060
8974	7944	21	19	128	0	8112
8975	102	24	7779	105	0	8010
8976	7815	24	83	67	0	7989
8977	113	21	8135	48	0	8317
8978	83	206	87	7697	0	8073
8979	7911	18	66	105	0	8100
8980	96	7929	22	101	0	8148
8981	7527	73	16	36	0	7652
8982	87	7523	13	37	0	7660
8983	53	80	11	7736	0	7880
8984	36	50	7810	84	0	7980
8985	7042	130	50	55	0	7277
8986	53	7668	37	27	0	7785
8987	39	50	14	7295	0	7398
8988	13	36	9	7179	0	7237
8989	23	12	7	7174	0	7216
8990	23	9	7339	69	0	7440
8991	16	7327	41	42	0	7426
8992	7215	37	35	20	0	7307
8993	7192	32	12	17	0	7253
8994	64	7266	12	17	0	7359
8995	7549	35	11	16	0	7611
8996	48	33	5	7537	0	7623
8997	34	7561	6	52	0	7653
8998	7602	35	6	38	0	7681
8999	47	33	7483	24	0	7587
9000	42	7607	36	24	0	7709
9001	24	35	27	7632	0	7718
9002	18	37	8	7633	0	7696
9003	18	16	7542	60	0	7636
9004	16	8	33	7374	0	7431
9005	16	7	7674	48	0	7745
9006	17	14	33	7585	0	7649
9007	18	18	25	7675	0	7736
9008	21	67	14	7708	0	7810
9009	16	14	12	7745	0	7787
9010	19	16	7779	75	0	7889
9011	27	19	8335	47	0	8428
9012	17	9233	67	27	0	9344
9013	19	84	39	9730	0	9872
9014	28	69	10150	91	0	10338
9015	16	10152	78	87	0	10333
9016	20	92	54	10200	0	10366
9017	117	71	10495	82	0	10765
9018	9743	12	101	68	0	9924
9019	10915	16	56	19	0	11006
9020	157	15	12	10937	0	11121
9021	89	8	10932	109	0	11138
9022	24	15	96	10992	0	11127
9023	11197	5	68	117	0	11387
9024	97	11799	27	93	0	12016
9025	12666	105	11	23	0	12805
9026	12726	74	10	26	0	12836
9027	176	18	18	12432	0	12644
9028	89	17	11	12572	0	12689
9029	30	6	11	12584	0	12631
9030	21	8	11	12542	0	12582
9031	12	20	15	12636	0	12683
9032	12623	10	10	199	0	12842
9033	12476	10	21	109	0	12616
9034	12573	14	15	38	0	12640
9035	197	14	12383	32	0	12626
9036	12005	9	111	37	0	12162
9037	120	14	81	12247	0	12462
9038	91	13	12388	131	0	12623
9039	30	12298	115	103	0	12546
9040	18	116	80	12083	0	12297
9041	18	75	26	12231	0	12350
9042	28	12519	25	182	0	12754
9043	31	111	18	12802	0	12962
9044	44	82	12703	144	0	12973
9045	22	19	12808	118	0	12967
9046	20	37	210	12859	0	13126
9047	12700	15	117	165	0	12997
9048	12458	15	41	111	0	12625
9049	243	19	12867	49	0	13178
9050	143	12214	118	46	0	12521
9051	57	12571	97	56	0	12781
9052	12059	207	33	46	0	12345
9053	150	97	12359	67	0	12673
9054	116	29	133	12161	0	12439
9055	12252	20	107	161	0	12540
9056	159	12009	25	192	0	12385
9057	136	12079	25	63	0	12303
9058	11969	210	22	38	0	12239
9059	169	121	20	11997	0	12307
9060	12343	24	24	166	0	12557
9061	170	22	37	13243	0	13472
9062	129	16	23	13486	0	13654
9063	62	12	13570	283	0	13927
9064	42	38	145	13756	0	13981
9065	44	36	129	13942	0	14151
9066	13838	25	40	296	0	14199
9067	164	33	29	14321	0	14547
9068	155	28	14385	211	0	14779
9069	13957	15	179	184	0	14335
9070	172	21	162	14323	0	14678
9071	14459	16	67	211	0	14753
9072	193	13921	32	199	0	14345
9073	174	14438	34	93	0	14739
9074	14366	274	42	57	0	14739
9075	14325	192	41	63	0	14621
9076	320	58	41	14282	0	14701
9077	223	36	14239	195	0	14693
9078	78	22	182	14402	0	14684
9079	14146	37	167	210	0	14560
9080	194	14438	52	204	0	14888
9081	194	181	33	14336	0	14744
9082	14445	180	44	199	0	14868
9083	219	69	14055	198	0	14541
9084	13839	42	163	118	0	14162
9085	13890	34	178	92	0	14194
9086	331	28	14034	100	0	14493
9087	224	28	14156	84	0	14492
9088	104	42	302	13541	0	13989
9089	86	37	189	13898	0	14210
9090	67	14327	58	348	0	14800
9091	93	173	50	14548	0	14864
9092	92	163	14946	256	0	15457
9093	92	60	201	14787	0	15140
9094	76	38	178	15384	0	15676
9095	81	38	15122	387	0	15628
9096	75	15021	198	278	0	15572
9097	71	199	188	14833	0	15291
9098	90	197	57	15192	0	15536
9099	15266	55	45	394	0	15760
9100	257	41	59	15321	0	15678
9101	235	44	15114	275	0	15668
9102	14808	50	214	239	0	15311
9103	15047	51	196	123	0	15417
9104	15279	55	72	96	0	15502
9105	421	57	14940	88	0	15506
9106	258	55	215	14678	0	15206
9107	125	44	200	14805	0	15174
9108	99	40	95	15082	0	15316
9109	14690	44	64	411	0	15209
9110	242	14587	64	317	0	15210
9111	230	184	13907	115	0	14436
9112	91	13284	148	89	0	13612
9113	67	12729	153	81	0	13030
9114	61	12744	71	88	0	12964
9115	107	300	104	12370	0	12881
9116	64	157	12466	194	0	12881
9117	11083	64	144	185	0	11476
9118	132	11956	140	113	0	12341
9119	11250	115	45	80	0	11490
9120	132	11446	40	83	0	11701
9121	11764	115	85	76	0	12040
9122	155	11803	29	90	0	12077
9123	145	114	11745	76	0	12080
9124	71	130	121	11045	0	11367
9125	67	36	137	11510	0	11750
9126	11454	32	54	272	0	11812
9127	176	32	27	12622	0	12857
9128	194	37	12442	215	0	12888
9129	79	19	159	12606	0	12863
9130	65	42	12640	195	0	12942
9131	67	12567	175	253	0	13062
9132	79	157	172	11925	0	12333
9133	70	12704	58	176	0	13008
9134	12543	226	61	197	0	13027
9135	184	178	40	12445	0	12847
9136	202	44	12354	199	0	12799
9137	91	37	12304	209	0	12641
9138	11985	44	312	77	0	12418
9139	195	48	181	11915	0	12339
9140	181	40	11802	175	0	12198
9141	84	46	11347	170	0	11647
9142	54	11288	271	111	0	11724
9143	100	148	225	10458	0	10931
9144	45	11156	52	154	0	11407
9145	46	149	37	10577	0	10809
9146	10632	126	41	172	0	10971
9147	132	54	44	10763	0	10993
9148	141	38	41	10837	0	11057
9149	10829	34	45	265	0	11173
9150	133	49	46	11479	0	11707
9151	149	44	32	11361	0	11586
9152	61	11634	45	287	0	12027
9153	11619	146	55	188	0	12008
9154	11674	154	40	73	0	11941
9155	279	45	35	11586	0	11945
9156	175	36	53	11613	0	11877
9157	57	33	53	11680	0	11823
9158	44	11372	55	341	0	11812
9159	47	11653	54	203	0	11957
9160	44	271	92	11349	0	11756
9161	9901	140	42	161	0	10244
9162	9701	45	47	135	0	9928
9163	216	9751	36	86	0	10089
9164	9369	132	38	46	0	9585
9165	137	9409	31	57	0	9634
9166	118	9443	37	63	0	9661
9167	95	206	164	8858	0	9323
9168	8658	114	31	136	0	8939
9169	118	8498	24	133	0	8773
9170	100	8624	33	63	0	8820
9171	35	186	36	8373	0	8630
9172	38	114	26	8541	0	8719
9173	38	38	8398	215	0	8689
9174	8055	33	106	146	0	8340
9175	8189	27	109	73	0	8398
9176	200	40	8380	60	0	8680
9177	117	30	8267	78	0	8492
9178	47	39	181	8170	0	8437
9179	45	25	104	8418	0	8592
9180	45	8185	30	237	0	8497
9181	45	133	20	8480	0	8678
9182	41	110	8228	197	0	8576
9183	51	64	127	8160	0	8402
9184	46	46	85	8276	0	8453
9185	8145	38	36	252	0	8471
9186	146	54	8001	165	0	8366
9187	7805	47	127	101	0	8080
9188	165	48	7978	81	0	8272
9189	117	54	127	7579	0	7877
9190	66	50	7587	171	0	7874
9191	43	43	7568	149	0	7803
9192	39	52	210	7025	0	7326
9193	6756	137	140	192	0	7225
9194	6578	54	57	124	0	6813
9195	181	6754	39	93	0	7067
9196	6707	127	59	56	0	6949
9197	6665	125	47	60	0	6897
9198	194	6704	36	85	0	7019
9199	113	129	39	6525	0	6806
9200	63	99	47	6600	0	6809
9201	51	52	50	6538	0	6691
9202	54	37	46	6708	0	6845
9203	49	40	6570	233	0	6892
9204	6341	42	117	142	0	6642
9205	128	32	102	6474	0	6736
9206	111	39	48	6482	0	6680
9207	53	6521	38	232	0	6844
9208	62	130	31	6684	0	6907
9209	62	91	6567	172	0	6892
9210	6279	46	118	163	0	6606
9211	128	36	6623	115	0	6902
9212	106	36	108	6310	0	6560
9213	6354	45	78	176	0	6653
9214	130	6441	38	147	0	6756
9215	117	126	25	6676	0	6944
9216	72	93	6547	165	0	6877
9217	59	47	111	6583	0	6800
9218	6500	55	92	156	0	6803
9219	157	54	6585	123	0	6919
9220	127	54	6476	73	0	6730
9221	63	6158	164	84	0	6469
9222	5945	182	98	64	0	6289
9223	131	6080	29	90	0	6330
9224	107	202	5713	57	0	6079
9225	41	92	5387	41	0	5561
9226	27	5251	120	68	0	5466
9227	4057	63	38	25	0	4183
9228	59	4124	19	36	0	4238
9229	39	56	12	3971	0	4078
9230	26	31	15	4093	0	4165
9231	23	13	4009	88	0	4133
9232	25	10	59	3990	0	4084
9233	16	10	3962	71	0	4059
9234	3873	11	65	50	0	3999
9235	3962	13	41	26	0	4042
9236	4036	9	24	26	0	4095
9237	83	9	3956	31	0	4079
9238	3944	12	59	25	0	4040
9239	62	9	44	3848	0	3963
9240	41	3988	19	73	0	4121
9241	3992	51	19	34	0	4096
9242	64	31	3887	24	0	4006
9243	3819	13	65	20	0	3917
9244	3891	7	41	18	0	3957
9245	82	14	3924	46	0	4066
9246	40	3951	60	31	0	4082
9247	42	115	46	3793	0	3996
9248	21	30	3864	67	0	3982
9249	24	19	3667	34	0	3744
9250	59	13	77	2858	0	3007
9251	8	7	2908	31	0	2954
9252	9	7	29	2801	0	2846
9253	14	4	23	2699	0	2740
9254	7	9	17	2934	0	2967
9255	17	2	2909	35	0	2963
9256	10	9	33	2960	0	3012
9257	7	8	2986	36	0	3037
9258	10	8	33	2983	0	3034
9259	3010	5	25	32	0	3072
9260	31	5	9	3083	0	3128
9261	20	3216	12	30	0	3278
9262	11	32	11	3470	0	3524
9263	3468	22	9	38	0	3537
9264	33	3526	5	32	0	3596
9265	22	32	11	3520	0	3585
9266	3478	22	7	36	0	3543
9267	39	6	3483	24	0	3552
9268	24	4	38	3460	0	3526
9269	15	5	3590	38	0	3648
9270	11	5	3556	28	0	3600
9271	12	10	48	3528	0	3598
9272	3562	6	26	37	0	3631
9273	37	7	3555	32	0	3631
9274	3458	8	38	14	0	3518
9275	41	3	28	3664	0	3736
9276	24	11	3745	41	0	3821
9277	9	7	3658	32	0	3706
9278	18	7	3786	11	0	3822
9279	5	90	54	3443	0	3592
9280	3658	7	49	34	0	3748
9281	23	3535	16	26	0	3600
9282	19	25	12	3427	0	3483
9283	7	23	10	3487	0	3527
9284	3496	4	11	45	0	3556
9285	3525	3	16	24	0	3568
9286	42	3578	17	13	0	3650
9287	3667	24	11	15	0	3717
9288	3665	24	15	8	0	3712
9289	47	8	9	3671	0	3735
9290	27	7	3717	31	0	3782
9291	3612	11	29	32	0	3684
9292	37	9	28	3784	0	3858
9293	35	8	14	3796	0	3853
9294	3791	9	14	52	0	3866
9295	30	7	10	3606	0	3653
9296	34	7	12	3744	0	3797
9297	3722	6	6	62	0	3796
9298	29	3981	17	36	0	4063
9299	3982	25	14	23	0	4044
9300	41	19	4067	10	0	4137
9301	4057	6	33	19	0	4115
9302	35	4	32	4030	0	4101
9303	36	4221	15	36	0	4308
9304	15	26	12	4288	0	4341
9305	17	25	9	4195	0	4246
9306	10	8	18	4265	0	4301
9307	4229	4	18	54	0	4305
9308	34	4193	14	41	0	4282
9309	40	4215	11	21	0	4287
9310	4217	41	17	21	0	4296
9311	52	30	4381	12	0	4475
9312	34	8	4264	24	0	4330
9313	4041	19	90	20	0	4170
9314	24	10	4301	12	0	4347
9315	22	2	23	3980	0	4027
9316	10	7	27	3986	0	4030
9317	20	5	12	4140	0	4177
9318	12	4	12	4137	0	4165
9319	11	4127	13	43	0	4194
9320	11	15	14	4253	0	4293
9321	17	24	4183	35	0	4259
9322	9	6	29	4128	0	4172
9323	13	2	4049	29	0	4093
9324	16	3	3965	28	0	4012
9325	12	6	33	3935	0	3986
9326	16	7	4013	31	0	4067
9327	9	10	25	4022	0	4066
9328	4028	4	26	41	0	4099
9329	31	5	4050	35	0	4121
9330	3920	5	23	21	0	3969
9331	33	11	24	4048	0	4116
9332	34	10	4085	23	0	4152
9333	22	4064	21	43	0	4150
9334	28	17	27	4083	0	4155
9335	18	26	4294	29	0	4367
9336	28	12	24	4246	0	4310
9337	4311	9	32	39	0	4391
9338	4251	6	14	42	0	4313
9339	4492	8	10	27	0	4537
9340	75	7	10	4477	0	4569
9341	45	10	11	4563	0	4629
9342	27	12	9	4635	0	4683
9343	4824	7	8	64	0	4903
9344	36	4881	16	45	0	4978
9345	49	28	14	4829	0	4920
9346	32	37	11	4865	0	4945
9347	4844	11	14	73	0	4942
9348	39	5111	11	61	0	5222
9349	39	41	9	5309	0	5398
9350	5229	35	11	74	0	5349
9351	5129	14	12	62	0	5217
9352	85	13	6	5186	0	5290
9353	5207	11	14	52	0	5284
9354	49	17	10	5199	0	5275
9355	60	8	5239	62	0	5369
9356	24	16	51	5163	0	5254
9357	19	10	51	5154	0	5234
9358	15	8	24	5273	0	5320
9359	5132	1	18	94	0	5245
9360	44	5041	17	70	0	5172
9361	4994	36	8	32	0	5070
9362	45	4557	10	19	0	4631
9363	38	4735	11	17	0	4801
9364	4693	63	4	20	0	4780
9365	40	4877	7	23	0	4947
9366	36	50	7	4877	0	4970
9367	4885	38	7	54	0	4984
9368	4798	16	8	50	0	4872
9369	82	9	11	4799	0	4901
9370	49	4	9	4783	0	4845
9371	24	4902	4	78	0	5008
9372	5062	44	7	52	0	5165
9373	5015	38	12	26	0	5091
9374	74	5316	10	32	0	5432
9375	51	5442	10	25	0	5528
9376	22	82	6	5495	0	5605
9377	5522	46	8	76	0	5652
9378	62	22	5	5439	0	5528
9379	51	10	9	5583	0	5653
9380	24	9	5448	116	0	5597
9381	22	18	5626	56	0	5722
9382	10	34	92	5591	0	5727
9383	27	11	5704	72	0	5814
9384	22	5636	61	61	0	5780
9385	21	60	48	5650	0	5779
9386	21	43	15	5731	0	5810
9387	18	15	12	5807	0	5852
9388	21	14	5650	114	0	5799
9389	25	9	5555	71	0	5660
9390	5396	8	96	33	0	5533
9391	65	5680	45	41	0	5831
9392	5555	56	11	25	0	5647
9393	70	47	9	5519	0	5645
9394	5690	18	8	66	0	5782
9395	72	17	8	5758	0	5855
9396	57	5734	8	65	0	5864
9397	5752	56	7	60	0	5875
9398	73	43	5526	40	0	5682
9399	65	5530	51	30	0	5676
9400	5482	55	42	26	0	5605
9401	69	44	11	5335	0	5459
9402	58	5474	10	68	0	5610
9403	21	59	7	5538	0	5625
9404	5450	47	13	82	0	5592
9405	65	19	10	5485	0	5579
9406	5459	22	7	87	0	5575
9407	75	12	5421	68	0	5576
9408	67	16	59	5354	0	5496
9409	5395	27	43	76	0	5541
9410	73	13	5448	68	0	5602
9411	61	5335	57	39	0	5492
9412	36	67	45	5184	0	5332
9413	26	56	5212	82	0	5376
9414	35	20	5184	62	0	5301
9415	24	46	96	5069	0	5235
9416	29	14	5214	75	0	5332
9417	24	32	5075	68	0	5199
9418	17	13	90	5053	0	5173
9419	5070	10	47	77	0	5204
9420	70	11	21	5031	0	5133
9421	53	19	5	5285	0	5362
9422	27	49	5328	104	0	5508
9423	20	24	61	5319	0	5424
9424	5708	15	44	83	0	5850
9425	74	17	5701	65	0	5857
9426	54	5730	57	38	0	5879
9427	31	59	45	5731	0	5866
9428	5799	48	17	70	0	5934
9429	69	14	17	5885	0	5985
9430	51	5950	13	68	0	6082
9431	32	65	6079	50	0	6226
9432	18	53	63	6062	0	6196
9433	6558	20	42	76	0	6696
9434	89	16	6511	59	0	6675
9435	52	8	80	6891	0	7031
9436	7173	16	49	97	0	7335
9437	7651	11	27	83	0	7772
9438	167	7866	15	42	0	8090
9439	7788	102	8	26	0	7924
9440	120	75	13	7665	0	7873
9441	79	14	7799	119	0	8011
9442	22	7622	108	93	0	7845
9443	13	7733	72	31	0	7849
9444	12	152	23	7550	0	7737
9445	18	76	14	7706	0	7814
9446	26	18	7720	163	0	7927
9447	11	7346	98	185	0	7640
9448	10	7265	65	35	0	7375
9449	7	131	18	7081	0	7237
9450	7065	58	19	87	0	7229
9451	77	7075	11	73	0	7236
9452	58	74	12	7139	0	7283
9453	7179	54	7	85	0	7325
9454	80	17	9	7183	0	7289
9455	60	9	9	7030	0	7108
9456	25	5	12	7161	0	7203
9457	12	8	10	7217	0	7247
9458	7147	10	11	142	0	7310
9459	89	11	12	7263	0	7375
9460	57	15	7210	100	0	7382
9461	6995	14	85	70	0	7164
9462	97	13	7197	30	0	7337
9463	67	11	7355	24	0	7457
9464	19	18	122	7309	0	7468
9465	12	14	66	7224	0	7316
9466	17	12	20	7528	0	7577
9467	7391	15	11	142	0	7559
9468	92	15	7346	77	0	7530
9469	7162	9	85	40	0	7296
9470	7254	4	64	33	0	7355
9471	140	14	7464	26	0	7644
9472	7172	17	87	26	0	7302
9473	105	13	7410	34	0	7562
9474	65	7259	80	36	0	7440
9475	27	64	66	7043	0	7200
9476	23	63	18	7098	0	7202
9477	30	23	14	6988	0	7055
9478	23	12	10	7112	0	7157
9479	24	13	7046	132	0	7215
9480	19	8	6945	82	0	7054
9481	21	18	108	6869	0	7016
9482	25	12	6993	85	0	7115
9483	6485	16	83	87	0	6671
9484	6924	8	63	37	0	7032
9485	120	21	15	6807	0	6963
9486	6850	13	19	85	0	6967
9487	88	7046	17	84	0	7235
9488	7099	67	20	43	0	7229
9489	97	55	7206	38	0	7396
9490	65	21	75	7016	0	7177
9491	32	7278	61	88	0	7459
9492	7274	96	32	76	0	7478
9493	83	54	19	7403	0	7559
9494	73	18	7290	116	0	7497
9495	45	13	73	7133	0	7264
9496	7119	15	76	100	0	7310
9497	97	18	7245	89	0	7449
9498	99	16	93	7138	0	7346
9499	45	20	97	7154	0	7316
9500	48	31	7366	158	0	7603
9501	55	7213	76	135	0	7479
9502	66	7047	85	91	0	7289
9503	87	139	32	7251	0	7509
9504	66	108	26	7350	0	7550
9505	58	57	39	7615	0	7769
9506	7530	53	36	185	0	7804
9507	7332	57	44	135	0	7568
9508	160	63	54	7546	0	7823
9509	7568	74	36	139	0	7817
9510	102	7882	36	138	0	8158
9511	94	121	40	7910	0	8165
9512	59	110	37	7893	0	8099
9513	33	63	50	8029	0	8175
9514	7714	66	31	215	0	8026
9515	107	7763	28	160	0	8058
9516	113	107	32	7786	0	8038
9517	7746	108	21	145	0	8020
9518	119	47	26	7835	0	8027
9519	132	25	23	7802	0	7982
9520	76	7659	30	225	0	7990
9521	37	7734	29	201	0	8001
9522	71	127	28	7705	0	7931
9523	47	71	39	7774	0	7931
9524	7291	17	38	251	0	7597
9525	144	22	36	7438	0	7640
9526	130	11	7272	164	0	7577
9527	67	18	137	7189	0	7411
9528	72	7141	125	145	0	7483
9529	7148	88	95	129	0	7460
9530	128	75	69	7177	0	7449
9531	102	19	49	7079	0	7249
9532	48	7120	50	222	0	7440
9533	6694	65	17	141	0	6917
9534	105	6842	39	72	0	7058
9535	69	59	25	6465	0	6618
9536	86	40	6076	67	0	6269
9537	29	154	41	5377	0	5601
9538	5401	9	30	42	0	5482
9539	37	5359	2	53	0	5451
9540	39	37	7	5319	0	5402
9541	7	5168	2	45	0	5222
9542	9	43	4	5316	0	5372
9543	6	39	5321	52	0	5418
9544	4	27	36	5206	0	5273
9545	8	9	33	5177	0	5227
9546	4	5	5	5323	0	5337
9547	5215	5	7	79	0	5306
9548	5121	6	1	57	0	5185
9549	72	5236	6	17	0	5331
9550	5235	43	32	14	0	5324
9551	44	5179	1	17	0	5241
9552	36	5200	8	18	0	5262
9553	5141	71	1	15	0	5228
9554	47	37	5043	14	0	5141
9555	38	15	38	4932	0	5023
9556	9	9	32	5003	0	5053
9557	4	11	12	5168	0	5195
9558	5017	5	1	89	0	5112
9559	45	4906	8	61	0	5020
9560	35	43	3	5057	0	5138
9561	14	5070	6	52	0	5142
9562	5313	54	3	50	0	5420
9563	47	44	2	5210	0	5303
9564	50	9	6	6115	0	6180
9565	9	6586	4	110	0	6709
9566	14	70	7	6915	0	7006
9567	6	71	4	6972	0	7053
9568	6798	23	3	160	0	6984
9569	80	6679	4	107	0	6870
9570	71	6855	3	41	0	6970
9571	21	135	3	6677	0	6836
9572	14	95	6508	89	0	6706
9573	17	25	6449	95	0	6586
9574	16	11	159	6358	0	6544
9575	10	13	6465	106	0	6594
9576	16	14	88	6394	0	6512
9577	15	20	81	6271	0	6387
9578	9	11	21	6557	0	6598
9579	6375	14	13	175	0	6577
9580	81	19	7	6432	0	6539
9581	78	14	10	6343	0	6445
9582	27	6314	8	170	0	6519
9583	12	91	9	6620	0	6732
9584	16	82	6438	127	0	6663
9585	15	25	78	6484	0	6602
9586	22	14	77	6518	0	6631
9587	6152	19	21	181	0	6373
9588	82	22	14	6309	0	6427
9589	86	20	11	6092	0	6209
9590	23	25	11	6263	0	6322
9591	5821	14	20	191	0	6046
9592	83	5959	10	136	0	6188
9593	78	89	16	5891	0	6074
9594	23	83	10	5983	0	6099
9595	26	26	5826	191	0	6069
9596	15	24	85	5942	0	6066
9597	5618	14	69	134	0	5835
9598	81	5721	24	135	0	5961
9599	70	91	14	5596	0	5771
9600	32	87	11	5613	0	5743
9601	22	34	5507	194	0	5757
9602	5120	20	75	130	0	5345
9603	82	5313	69	72	0	5536
9604	5182	89	22	59	0	5352
9605	90	88	13	5136	0	5327
9606	83	33	18	5127	0	5261
9607	29	25	21	5253	0	5328
9608	36	24	20	5289	0	5369
9609	5109	32	19	191	0	5351
9610	93	34	17	4795	0	4939
9611	71	4756	24	148	0	4999
9612	32	70	35	4873	0	5010
9613	24	72	41	4909	0	5046
9614	4801	29	16	202	0	5048
9615	93	4804	21	140	0	5058
9616	83	88	15	4925	0	5111
9617	4771	80	5	160	0	5016
9618	4837	33	15	142	0	5027
9619	142	24	20	4922	0	5108
9620	104	22	4723	142	0	4991
9621	4628	32	66	123	0	4849
9622	87	30	71	4743	0	4931
9623	83	24	4745	144	0	4996
9624	26	14	83	4939	0	5062
9625	33	12	72	4827	0	4944
9626	24	29	29	4870	0	4952
9627	38	4988	16	184	0	5226
9628	32	104	12	5064	0	5212
9629	23	72	18	5045	0	5158
9630	23	43	18	5060	0	5144
9631	31	21	17	5060	0	5129
9632	28	32	17	4899	0	4976
9633	29	25	26	4913	0	4993
9634	4581	26	22	203	0	4832
9635	76	21	4424	134	0	4655
9636	81	4294	70	97	0	4542
9637	4213	59	58	83	0	4413
9638	79	4244	33	61	0	4417
9639	4273	78	15	75	0	4441
9640	98	63	13	4266	0	4440
9641	4341	26	29	115	0	4511
9642	89	25	16	4398	0	4528
9643	88	20	11	4208	0	4327
9644	40	4385	17	165	0	4607
9645	4421	61	12	128	0	4622
9646	66	64	4506	105	0	4741
9647	75	25	54	4552	0	4706
9648	42	14	4556	139	0	4751
9649	35	20	4497	123	0	4675
9650	4492	27	90	102	0	4711
9651	72	29	67	4629	0	4797
9652	89	24	4630	110	0	4853
9653	44	12	4742	130	0	4928
9654	41	26	105	4694	0	4866
9655	40	27	72	4882	0	5021
9656	4818	23	26	160	0	5027
9657	84	16	20	4917	0	5037
9658	90	13	5235	121	0	5459
9659	39	14	61	5436	0	5550
9660	29	17	62	5336	0	5444
9661	30	5487	31	134	0	5682
9662	5321	47	13	107	0	5488
9663	46	5290	27	73	0	5436
9664	4387	27	9	39	0	4462
9665	21	3951	2	25	0	3999
9666	7	3657	8	18	0	3690
9667	7	18	6	3695	0	3726
9668	11	5	6	3677	0	3699
9669	9	10	7	3665	0	3691
9670	3609	5	3	22	0	3639
9671	10	4	3575	13	0	3602
9672	10	2	8	3544	0	3564
9673	3473	1	4	25	0	3503
9674	8	3519	4	17	0	3548
9675	8	3511	6	12	0	3537
9676	3	36	3	3484	0	3526
9677	4	5	5	3427	0	3441
9678	3	3	3	3450	0	3459
9679	4	3477	4	15	0	3500
9680	2	3	2	3489	0	3496
9681	5	6	3435	9	0	3455
9682	8	0	3283	8	0	3299
9683	3209	0	7	9	0	3225
9684	2	3	6	3370	0	3381
9685	3366	0	1	12	0	3379
9686	3336	3	4	11	0	3354
9687	7	3340	1	8	0	3356
9688	3321	3	3	8	0	3335
9689	3522	4	4	4	0	3534
9690	7	4	1	3524	0	3536
9691	5	0	3	3499	0	3507
9692	4	2	3654	11	0	3671
9693	2	3772	2	10	0	3786
9694	2	6	7	3698	0	3713
9695	5	3	1	3844	0	3853
9696	3870	3	5	11	0	3889
9697	7	3	3	3860	0	3873
9698	3848	1	0	9	0	3858
9699	7	7	0	4025	0	4039
9700	6	4163	2	15	0	4186
9701	4430	14	2	11	0	4457
9702	20	9	1	5109	0	5139
9703	12	2	5	5486	0	5505
9704	4	3	1	5898	0	5906
9705	11	3	5795	76	0	5885
9706	2	4	43	5936	0	5985
9707	5964	2	35	59	0	6060
9708	49	6	8	6133	0	6196
9709	38	3	5	6941	0	6987
9710	8	9	2	6938	0	6957
9711	9	6857	1	145	0	7012
9712	36	7014	4	76	0	7130
9713	7038	138	3	15	0	7194
9714	85	7137	6	9	0	7237
9715	7079	87	5	10	0	7181
9716	6902	65	1	17	0	6985
9717	6843	14	3	17	0	6877
9718	164	7	6925	15	0	7111
9719	69	6904	79	11	0	7063
9720	6948	82	60	10	0	7100
9721	84	71	15	6838	0	7008
9722	63	13	5	6882	0	6963
9723	18	5	4	6906	0	6933
9724	9	6718	2	162	0	6891
9725	6	82	3	6839	0	6930
9726	6717	66	4	110	0	6897
9727	90	12	1	6653	0	6756
9728	62	10	6	6628	0	6706
9729	23	8	6570	168	0	6769
9730	21	6	6676	97	0	6800
9731	11	8	147	6634	0	6800
9732	14	7	72	6632	0	6725
9733	19	6700	20	162	0	6901
9734	14	89	10	6707	0	6820
9735	20	69	9	6703	0	6801
9736	19	21	7	6797	0	6844
9737	6673	15	2	181	0	6871
9738	97	18	6681	100	0	6896
9739	77	23	83	6704	0	6887
9740	6715	28	60	109	0	6912
9741	6697	15	13	94	0	6819
9742	170	25	10	6480	0	6685
9743	95	19	14	6671	0	6799
9744	6461	23	14	180	0	6678
9745	119	6471	16	106	0	6712
9746	97	6507	19	45	0	6668
9747	36	166	15	6478	0	6695
9748	6445	80	8	136	0	6669
9749	6414	36	10	106	0	6566
9750	6320	34	20	62	0	6436
9751	185	27	6339	62	0	6613
9752	6186	28	90	63	0	6367
9753	130	23	6311	62	0	6526
9754	6187	34	105	63	0	6389
9755	136	6142	77	73	0	6428
9756	92	97	6160	85	0	6434
9757	46	76	112	6128	0	6362
9758	31	39	5923	162	0	6155
9759	38	44	108	5709	0	5899
9760	5661	20	83	196	0	5960
9761	136	36	5637	151	0	5960
9762	104	29	102	5546	0	5781
9763	47	5841	84	174	0	6146
9764	51	111	33	5952	0	6147
9765	65	89	33	5753	0	5940
9766	67	48	24	5793	0	5932
9767	5715	31	29	241	0	6016
9768	5755	43	24	157	0	5979
9769	208	39	30	5758	0	6035
9770	136	42	5665	190	0	6033
9771	58	85	5647	158	0	5948
9772	80	54	163	5727	0	6024
9773	71	61	5918	181	0	6231
9774	72	54	115	5901	0	6142
9775	95	40	91	5803	0	6029
9776	98	34	44	5818	0	5994
9777	87	5612	47	256	0	6002
9778	73	5749	51	169	0	6042
9779	92	178	37	5844	0	6151
9780	88	115	39	5822	0	6064
9781	76	65	43	5969	0	6153
9782	5796	47	37	280	0	6160
9783	171	40	6032	172	0	6415
9784	136	45	132	6024	0	6337
9785	6028	37	102	185	0	6352
9786	142	6026	74	170	0	6412
9787	135	140	52	6195	0	6522
9788	81	95	60	6346	0	6582
9789	78	38	58	6181	0	6355
9790	57	32	51	6262	0	6402
9791	55	33	6031	280	0	6399
9792	5760	42	126	195	0	6123
9793	5899	41	115	125	0	6180
9794	202	42	5966	137	0	6347
9795	5876	36	123	111	0	6146
9796	5988	25	109	103	0	6225
9797	208	24	5968	122	0	6322
9798	119	6073	147	115	0	6454
9799	84	121	112	5946	0	6263
9800	97	71	6078	144	0	6390
9801	56	5813	110	146	0	6125
9802	59	78	5206	82	0	5425
9803	40	4784	81	92	0	4997
9804	20	137	79	4376	0	4612
9805	20	40	4650	85	0	4795
9806	23	22	69	4560	0	4674
9807	39	12	4783	79	0	4913
9808	20	4522	52	61	0	4655
9809	3710	12	14	12	0	3748
9810	9	3568	7	9	0	3593
9811	4	3727	7	17	0	3755
9812	68	11	10	3669	0	3758
9813	3	2	0	3653	0	3658
9814	0	1	2	3659	0	3662
9815	1	1	0	3664	0	3666
9816	1	1	0	3666	0	3668
9817	4	1	4129	10	0	4144
9818	0	1	5	4030	0	4036
9819	1	2	6	4349	0	4358
9820	4373	0	0	22	0	4395
9821	4368	2	2	15	0	4387
9822	4475	0	5	6	0	4486
9823	25	1	1	4489	0	4516
9824	5433	1	0	21	0	5455
9825	6368	1	2	14	0	6385
9826	6627	2	2	6	0	6637
9827	70	2	6743	4	0	6819
9828	6608	0	47	3	0	6658
9829	6738	4	24	9	0	6775
9830	6858	2	9	7	0	6876
9831	73	1	6	6766	0	6846
9832	37	1	6989	47	0	7074
9833	10	6	47	6970	0	7033
9834	7241	4	26	59	0	7330
9835	46	2	9	7418	0	7475
9836	24	7994	4	51	0	8073
9837	12	43	3	8221	0	8279
9838	8156	28	4	60	0	8248
9839	8270	12	2	49	0	8333
9840	8279	1	6	20	0	8306
9841	96	1	8967	10	0	9074
9842	44	4	56	8785	0	8889
9843	14	3	41	9222	0	9280
9844	19	2	9562	93	0	9676
9845	5	9412	54	71	0	9542
9846	18	54	9478	22	0	9572
9847	11	41	63	9356	0	9471
9848	9504	11	43	64	0	9622
9849	74	3	10105	51	0	10233
9850	50	1	57	10037	0	10145
9851	36	2	10317	71	0	10426
9852	9879	3	70	51	0	10003
9853	65	2	47	10206	0	10320
9854	55	4	10957	69	0	11085
9855	24	5	54	10818	0	10901
9856	24	5	11196	78	0	11303
9857	19	11145	61	67	0	11292
9858	23	54	47	11092	0	11216
9859	11241	39	22	71	0	11373
9860	70	12	16	11261	0	11359
9861	62	6	18	11148	0	11234
9862	11165	1	8	111	0	11285
9863	80	10771	8	78	0	10937
9864	61	11129	9	38	0	11237
9865	29	98	10	11200	0	11337
9866	20	11358	16	80	0	11474
9867	27	68	8	11429	0	11532
9868	22	46	14	11430	0	11512
9869	11557	17	10	128	0	11712
9870	67	11655	6	106	0	11834
9871	71	61	11930	50	0	12112
9872	40	12167	66	27	0	12300
9873	12232	70	57	28	0	12387
9874	12521	52	27	29	0	12629
9875	133	15	26	12675	0	12849
9876	13043	12	14	100	0	13169
9877	101	8	17	12985	0	13111
9878	13301	10	23	105	0	13439
9879	13390	14	18	89	0	13511
9880	144	7	25	14362	0	14538
9881	14632	5	24	104	0	14765
9882	124	14	14657	78	0	14873
9883	14363	9	98	36	0	14506
9884	101	16	78	14745	0	14940
9885	14987	8	38	101	0	15134
9886	111	15444	18	96	0	15669
9887	91	74	20	15425	0	15610
9888	53	69	27	15423	0	15572
9889	15529	21	24	167	0	15741
9890	111	23	15788	108	0	16030
9891	94	15765	80	66	0	16005
9892	52	79	77	15675	0	15883
9893	50	16323	33	106	0	16512
9894	42	110	22	16400	0	16574
9895	52	76	31	16245	0	16404
9896	52	34	17	16483	0	16586
9897	16561	37	26	177	0	16801
9898	112	26	23	16438	0	16599
9899	16613	29	21	133	0	16796
9900	16695	28	29	121	0	16873
9901	168	20	19	17042	0	17249
9902	17096	18	29	134	0	17277
9903	16691	35	28	109	0	16863
9904	182	35	17311	64	0	17592
9905	111	29	96	17056	0	17292
9906	17428	30	84	129	0	17671
9907	118	17688	35	127	0	17968
9908	18053	85	36	66	0	18240
9909	17844	76	34	65	0	18019
9910	202	21	17866	111	0	18200
9911	106	21	105	17317	0	17549
9912	19633	21	86	115	0	19855
9913	119	27	41	20501	0	20688
9914	133	21	35	20863	0	21052
9915	62	28	29	21072	0	21191
9916	53	16	37	22060	0	22166
9917	22325	14	23	224	0	22586
9918	179	21	23018	159	0	23377
9919	149	23	150	23698	0	24020
9920	76	28	26935	180	0	27219
9921	66	29	28079	178	0	28352
9922	27350	23	523	81	0	27977
9923	309	23	29950	67	0	30349
9924	277	28798	281	57	0	29413
9925	29254	244	305	44	0	29847
9926	29338	262	49	44	0	29693
9927	518	47	28	28752	0	29345
9928	344	22	29630	251	0	30247
9929	90	16	29530	267	0	29903
9930	29407	16	503	60	0	29986
9931	270	17	308	30557	0	31152
9932	31008	9	59	264	0	31340
9933	296	31566	32	363	0	32257
9934	31852	243	32	64	0	32191
9935	31423	281	24	39	0	31767
9936	535	31427	29	48	0	32039
9937	316	257	22	31847	0	32442
9938	31626	285	47	300	0	32258
9939	315	48	32036	305	0	32704
9940	308	32377	301	93	0	33079
9941	91	275	308	32232	0	32906
9942	32141	292	89	315	0	32837
9943	325	32563	49	325	0	33262
9944	33137	302	53	90	0	33582
9945	407	390	32581	42	0	33420
9946	32397	72	323	56	0	32848
9947	419	48	33333	34	0	33834
9948	32200	38	389	56	0	32683
9949	32202	44	357	52	0	32655
9950	660	46	32591	62	0	33359
9951	420	32425	344	65	0	33254
9952	164	328	365	31773	0	32630
9953	157	303	32943	338	0	33741
9954	117	32580	341	383	0	33421
9955	123	350	372	31750	0	32595
9956	103	337	130	32703	0	33273
9957	147	88	32485	646	0	33366
9958	129	71	380	31672	0	32252
9959	145	67	375	32447	0	33034
9960	146	55	32563	687	0	33451
9961	136	89	404	31770	0	32399
9962	131	32381	424	435	0	33371
9963	32711	332	180	385	0	33608
9964	418	364	187	32076	0	33045
9965	463	32956	209	377	0	34005
9966	258	376	191	31794	0	32619
9967	268	33653	163	403	0	34487
9968	299	431	33731	359	0	34820
9969	231	34018	439	296	0	34984
9970	33482	433	451	179	0	34545
9971	33151	382	218	142	0	33893
9972	33650	159	228	138	0	34175
9973	798	127	34466	135	0	35526
9974	663	118	33652	173	0	34606
9975	295	34860	752	186	0	36093
9976	289	458	498	33700	0	34945
9977	279	35842	189	471	0	36781
9978	266	596	213	32796	0	33871
9979	282	35589	184	518	0	36573
9980	34965	529	185	434	0	36113
9981	37067	523	204	222	0	38016
9982	949	228	201	38735	0	40113
9983	721	154	38810	623	0	40308
9984	37469	211	647	563	0	38890
9985	682	39441	580	295	0	40998
9986	655	611	266	38757	0	40289
9987	392	619	241	37449	0	38701
9988	323	39659	212	908	0	41102
9989	39899	592	238	605	0	41334
9990	781	620	39511	239	0	41151
9991	755	276	635	39337	0	41003
9992	39364	198	628	613	0	40803
9993	38584	228	306	594	0	39712
9994	1102	38957	238	320	0	40617
9995	753	682	263	37753	0	39451
9996	342	39473	236	628	0	40679
9997	39614	713	252	638	0	41217
9998	723	663	39825	323	0	41534
9999	712	361	39646	247	0	40966
10000	369	270	1022	38239	0	39900
10001	285	243	722	37829	0	39079
10002	244	39026	363	1061	0	40694
10003	308	674	234	39176	0	40392
10004	298	649	38557	793	0	40297
10005	37555	297	697	692	0	39241
10006	705	282	610	38652	0	40249
10007	691	313	38678	734	0	40416
10008	404	246	656	38724	0	40030
10009	270	278	668	37441	0	38657
10010	215	38762	311	1131	0	40419
10011	262	700	256	38774	0	39992
10012	275	709	262	36931	0	38177
10013	253	382	227	37016	0	37878
10014	35478	242	219	1196	0	37135
10015	711	35249	241	796	0	36997
10016	674	35033	216	400	0	36323
10017	33775	957	219	263	0	35214
10018	32334	586	261	259	0	33440
10019	876	31912	230	284	0	33302
10020	410	28508	128	189	0	29235
10021	25554	553	81	123	0	26311
10022	347	25836	65	146	0	26394
10023	270	25371	84	159	0	25884
10024	24753	532	155	132	0	25572
10025	359	24994	72	147	0	25572
10026	24857	384	88	107	0	25436
10027	24067	303	108	123	0	24601
10028	23903	157	107	120	0	24287
10029	539	24374	75	226	0	25214
10030	300	24425	66	142	0	24933
10031	160	522	59	23754	0	24495
10032	113	24262	87	344	0	24806
10033	138	391	63	23992	0	24584
10034	24119	298	78	407	0	24902
10035	364	152	76	23986	0	24578
10036	341	23906	74	418	0	24739
10037	23131	352	87	334	0	23904
10038	360	23474	78	181	0	24093
10039	313	23641	44	160	0	24158
10040	196	711	72	22551	0	23530
10041	118	23068	67	340	0	23593
10042	22757	357	70	293	0	23477
10043	354	315	22482	152	0	23303
10044	312	22156	280	141	0	22889
10045	159	316	243	22259	0	22977
10046	129	334	22312	366	0	23141
10047	140	156	283	21691	0	22270
10048	149	130	262	21758	0	22299
10049	111	162	109	22019	0	22401
10050	138	115	76	22245	0	22574
10051	146	122	21842	589	0	22699
10052	115	21720	313	377	0	22525
10053	21542	352	272	236	0	22402
10054	346	326	21119	187	0	21978
10055	21051	174	291	182	0	21698
10056	420	128	21590	190	0	22328
10057	358	153	347	21194	0	22052
10058	202	148	21426	395	0	22171
10059	146	156	21434	398	0	22134
10060	167	155	516	20929	0	21767
10061	159	161	316	20714	0	21350
10062	150	143	130	21579	0	22002
10063	129	188	90	21608	0	22015
10064	21341	155	69	650	0	22215
10065	359	146	21269	414	0	22188
10066	21247	194	304	220	0	21965
10067	21092	149	269	216	0	21726
10068	20756	172	119	162	0	21209
10069	20623	194	61	183	0	21061
10070	20791	171	56	184	0	21202
10071	653	138	68	20284	0	21143
10072	409	186	19694	381	0	20670
10073	172	173	18851	334	0	19530
10074	155	18971	445	165	0	19736
10075	17489	532	273	145	0	18439
10076	431	475	86	16744	0	17736
10077	299	217	62	16583	0	17161
10078	143	16765	47	480	0	17435
10079	117	16603	47	317	0	17084
10080	127	16327	79	139	0	16672
10081	13060	329	107	157	0	13653
10082	169	316	22	11207	0	11714
10083	127	11023	22	192	0	11364
10084	44	127	25	11032	0	11228
10085	77	116	11149	152	0	11494
10086	61	49	11471	116	0	11697
10087	57	42	187	12537	0	12823
10088	12901	40	114	163	0	13218
10089	13449	58	43	121	0	13671
10090	13672	50	23	64	0	13809
10091	322	42	13982	60	0	14406
10092	181	52	169	13555	0	13957
10093	73	43	145	14357	0	14618
10094	65	42	14130	300	0	14537
10095	13277	66	189	189	0	13721
10096	213	50	14243	93	0	14599
10097	151	37	13701	39	0	13928
10098	75	35	14020	48	0	14178
10099	37	42	262	13318	0	13659
10100	44	32	149	13879	0	14104
10101	42	42	14233	255	0	14572
10102	46	40	158	14188	0	14432
10103	14259	38	159	198	0	14654
10104	159	39	52	14501	0	14751
10105	143	33	14834	202	0	15212
10106	62	41	15612	186	0	15901
10107	49	30	279	14845	0	15203
10108	16138	38	177	191	0	16544
10109	174	16719	66	196	0	17155
10110	17355	184	51	86	0	17676
10111	17387	182	54	68	0	17691
10112	391	48	18058	66	0	18563
10113	259	19	238	17755	0	18271
10114	18024	22	233	266	0	18545
10115	17815	19	88	262	0	18184
10116	380	18224	94	110	0	18808
10117	255	198	72	18083	0	18608
10118	108	180	79	18588	0	18955
10119	80	38	18378	402	0	18898
10120	63	18	236	18236	0	18553
10121	82	15	18445	287	0	18829
10122	72	14	18286	267	0	18639
10123	75	18	426	17753	0	18272
10124	17882	12	281	245	0	18420
10125	222	17362	103	276	0	17963
10126	17389	181	87	109	0	17766
10127	17198	189	78	97	0	17562
10128	403	17435	78	95	0	18011
10129	233	179	62	16495	0	16969
10130	16449	159	66	224	0	16898
10131	237	16541	62	206	0	17046
10132	16337	189	66	77	0	16669
10133	232	15819	61	75	0	16187
10134	305	183	56	14629	0	15173
10135	92	153	44	15205	0	15494
10136	14924	53	33	319	0	15329
10137	14625	32	49	194	0	14900
10138	317	15020	48	120	0	15505
10139	201	156	14519	85	0	14961
10140	100	137	14466	80	0	14783
10141	78	61	304	13738	0	14181
10142	75	14570	202	198	0	15045
10143	70	161	95	14706	0	15032
10144	81	149	92	14537	0	14859
10145	69	43	82	14862	0	15056
10146	66	39	14576	362	0	15043
10147	78	23	14443	249	0	14793
10148	69	14563	327	119	0	15078
10149	79	164	219	14103	0	14565
10150	98	163	102	14729	0	15092
10151	98	66	14604	328	0	15096
10152	13149	111	209	270	0	13739
10153	222	43	218	14534	0	15017
10154	223	33	14729	243	0	15228
10155	13912	51	224	230	0	14417
10156	242	14851	190	150	0	15433
10157	259	195	15350	118	0	15922
10158	142	172	282	15167	0	15763
10159	15337	69	226	254	0	15886
10160	249	56	15567	227	0	16099
10161	205	60	252	15326	0	15843
10162	136	61	227	15308	0	15732
10163	125	53	117	16250	0	16545
10164	16541	63	101	418	0	17123
10165	260	16095	106	321	0	16782
10166	231	233	98	16316	0	16878
10167	147	187	16958	322	0	17614
10168	124	84	308	16431	0	16947
10169	80	16509	263	356	0	17208
10170	101	17063	106	311	0	17581
10171	16838	395	94	179	0	17506
10172	17024	261	97	133	0	17515
10173	486	104	17015	126	0	17731
10174	16718	90	294	126	0	17228
10175	325	16952	259	141	0	17677
10176	17191	272	109	146	0	17718
10177	383	236	74	17016	0	17709
10178	324	140	17284	285	0	18033
10179	186	108	285	17243	0	17822
10180	173	87	17464	362	0	18086
10181	16618	90	318	316	0	17342
10182	310	122	256	17024	0	17712
10183	278	17732	112	350	0	18472
10184	177	390	95	17914	0	18576
10185	133	263	17585	395	0	18376
10186	105	17141	296	366	0	17908
10187	15233	249	251	167	0	15900
10188	238	15154	112	121	0	15625
10189	171	14278	83	104	0	14636
10190	117	334	76	13809	0	14336
10191	60	14160	67	220	0	14507
10192	111	266	44	14216	0	14637
10193	77	196	13986	249	0	14508
10194	12903	97	203	189	0	13392
10195	13643	70	167	85	0	13965
10196	347	71	13674	68	0	14160
10197	13096	64	203	76	0	13439
10198	239	13340	167	111	0	13857
10199	13484	203	66	73	0	13826
10200	236	172	48	13271	0	13727
10201	188	78	13602	224	0	14092
10202	80	13767	185	207	0	14239
10203	66	182	152	13629	0	14029
10204	55	143	80	13759	0	14037
10205	13022	61	55	318	0	13456
10206	11946	62	41	185	0	12234
10207	285	12225	59	90	0	12659
10208	110	10652	42	58	0	10862
10209	43	10155	33	40	0	10271
10210	309	343	46	9450	0	10148
10211	9535	88	72	118	0	9813
10212	9393	35	21	76	0	9525
10213	157	27	13	9337	0	9534
10214	84	29	19	9326	0	9458
10215	9315	24	9	175	0	9523
10216	112	22	22	9482	0	9638
10217	85	24	9806	117	0	10032
10218	9766	23	97	86	0	9972
10219	9874	28	70	40	0	10012
10220	171	20	10133	33	0	10357
10221	10454	23	96	40	0	10613
10222	126	30	66	10537	0	10759
10223	91	25	21	10533	0	10670
10224	35	38	31	10671	0	10775
10225	10578	31	21	186	0	10816
10226	115	10762	30	118	0	11025
10227	83	120	26	10816	0	11045
10228	43	10721	25	126	0	10915
10229	10689	132	29	85	0	10935
10230	138	101	15	10750	0	11004
10231	97	42	26	10860	0	11025
10232	56	10884	32	217	0	11189
10233	61	126	11080	94	0	11361
10234	55	95	110	11068	0	11328
10235	11126	42	75	142	0	11385
10236	12034	34	38	113	0	12219
10237	236	33	13116	58	0	13443
10238	141	32	165	13066	0	13404
10239	52	13616	119	183	0	13970
10240	53	173	41	13794	0	14061
10241	13578	136	76	205	0	13995
10242	13540	44	28	163	0	13775
10243	292	41	30	13468	0	13831
10244	156	13445	32	197	0	13830
10245	14024	186	22	150	0	14382
10246	201	145	29	14339	0	14714
10247	14357	53	21	218	0	14649
10248	15251	51	23	148	0	15473
10249	335	47	25	15249	0	15656
10250	179	44	14	15259	0	15496
10251	61	42	20	15707	0	15830
10252	58	15803	16	353	0	16230
10253	52	207	22	15945	0	16226
10254	51	157	27	15889	0	16124
10255	63	47	15452	361	0	15923
10256	70	38	15066	180	0	15354
10257	62	76	309	14730	0	15177
10258	14678	24	151	226	0	15079
10259	221	14937	44	202	0	15404
10260	14803	206	34	93	0	15136
10261	229	165	15040	71	0	15505
10262	171	44	14919	66	0	15200
10263	53	15167	276	71	0	15567
10264	42	160	248	14458	0	14908
10265	89	131	14460	174	0	14854
10266	34	32	15148	142	0	15356
10267	30	86	215	14583	0	14914
10268	14708	15	114	147	0	14984
10269	14572	16	25	130	0	14743
10270	238	15	13	14657	0	14923
10271	140	24	16380	152	0	16696
10272	34	13	138	16734	0	16919
10273	31	18	110	16461	0	16620
10274	32	17036	31	234	0	17333
10275	16911	131	19	148	0	17209
10276	16877	109	12	68	0	17066
10277	238	17186	21	68	0	17513
10278	130	139	28	16564	0	16861
10279	43	17177	24	169	0	17413
10280	17087	143	26	160	0	17416
10281	175	119	17209	64	0	17567
10282	134	30	16698	53	0	16915
10283	56	24	16780	47	0	16907
10284	36	22	212	16288	0	16558
10285	32	18	104	16481	0	16635
10286	16594	38	25	251	0	16908
10287	145	25	31	16454	0	16655
10288	111	19	40	17533	0	17703
10289	48	16	19341	246	0	19651
10290	38	35	19028	129	0	19230
10291	18589	19	215	92	0	18915
10292	153	19255	118	64	0	19590
10293	19596	126	47	57	0	19826
10294	155	107	35	19522	0	19819
10295	130	32	35	19506	0	19703
10296	45	19714	40	259	0	20058
10297	41	140	49	19917	0	20147
10298	19665	110	48	189	0	20012
10299	155	34	41	19870	0	20100
10300	155	35	20566	190	0	20946
10301	56	20243	148	185	0	20632
10302	20115	139	114	96	0	20464
10303	20073	127	50	103	0	20353
10304	20033	53	35	120	0	20241
10305	20324	60	45	84	0	20513
10306	256	32	59	20179	0	20526
10307	147	35	63	20438	0	20683
10308	97	44	20457	280	0	20878
10309	81	40	154	20312	0	20587
10310	102	39	20357	222	0	20720
10311	97	30	145	20270	0	20542
10312	20227	37	133	235	0	20632
10313	161	21142	66	188	0	21557
10314	145	200	54	21404	0	21803
10315	82	112	59	21712	0	21965
10316	21582	54	85	273	0	21994
10317	20537	42	88	189	0	20856
10318	265	40	21543	110	0	21958
10319	144	21986	163	111	0	22404
10320	97	153	135	21621	0	22006
10321	105	139	65	21580	0	21889
10322	21628	42	72	280	0	22022
10323	21039	62	83	193	0	21377
10324	269	41	21863	98	0	22271
10325	175	46	21838	80	0	22139
10326	92	39	277	21255	0	21663
10327	74	46	162	21785	0	22067
10328	86	43	21861	287	0	22277
10329	20679	44	167	187	0	21077
10330	183	46	128	21875	0	22232
10331	21809	32	76	211	0	22128
10332	207	21682	75	231	0	22195
10333	21927	133	96	126	0	22282
10334	187	107	24803	107	0	25204
10335	161	24540	175	108	0	24984
10336	109	23699	114	89	0	24011
10337	22693	134	107	64	0	22998
10338	21676	60	307	55	0	22098
10339	119	17	20	21862	0	22018
10340	64	21909	26	95	0	22094
10341	22	22087	32	79	0	22220
10342	25	108	16	22297	0	22446
10343	22478	55	19	102	0	22654
10344	22676	29	26	75	0	22806
10345	142	20	22801	36	0	22999
10346	21452	9	63	31	0	21555
10347	62	23434	60	40	0	23596
10348	23932	76	12	58	0	24078
10349	134	29639	6	55	0	29834
10350	109	31683	17	221	0	32030
10351	248	543	34	35578	0	36403
10352	38038	277	87	444	0	38846
10353	38426	73	11	315	0	38825
10354	820	26	38194	92	0	39132
10355	413	28	472	37975	0	38888
10356	38262	19	327	503	0	39111
10357	523	26	85	38651	0	39285
10358	38671	25	31	590	0	39317
10359	38417	27	26	378	0	38848
10360	858	14	39038	122	0	40032
10361	449	15	500	37868	0	38832
10362	133	22	342	38346	0	38843
10363	61	14	92	38955	0	39122
10364	72	14	38077	903	0	39066
10365	54	27	514	37744	0	38339
10366	36	38	347	35903	0	36324
10367	40	37356	99	837	0	38332
10368	99	519	37075	428	0	38121
10369	31	37710	493	165	0	38399
10370	37315	602	339	85	0	38341
10371	539	398	110	34890	0	35937
10372	387	147	56	34312	0	34902
10373	156	35517	55	791	0	36519
10374	34999	527	44	439	0	36009
10375	35083	365	43	152	0	35643
10376	1016	34978	39	116	0	36149
10377	490	35723	50	132	0	36395
10378	35422	848	43	94	0	36407
10379	664	448	35049	104	0	36265
10380	488	152	34934	91	0	35665
10381	33751	86	846	104	0	34787
10382	591	34754	448	146	0	35939
10383	35202	538	154	140	0	36034
10384	700	423	34878	133	0	36134
10385	34533	151	565	164	0	35413
10386	673	35575	405	172	0	36825
10387	496	584	139	35383	0	36602
10388	232	391	133	34751	0	35507
10389	186	164	112	33122	0	33584
10390	222	99	91	33510	0	33922
10391	176	109	93	32882	0	33260
10392	167	33141	92	1065	0	34465
10393	33112	592	79	614	0	34397
10394	712	424	32817	306	0	34259
10395	544	188	558	32936	0	34226
10396	330	136	33098	707	0	34271
10397	213	157	698	32806	0	33874
10398	220	115	505	33052	0	33892
10399	32644	121	221	1070	0	34056
10400	713	106	31935	687	0	33441
10401	541	31698	660	325	0	33224
10402	299	635	541	30775	0	32250
10403	257	487	226	32224	0	33194
10404	257	271	31982	1101	0	33611
10405	224	195	628	32023	0	33070
10406	227	237	472	32553	0	33489
10407	31444	187	198	1112	0	32941
10408	665	31827	150	721	0	33363
10409	31964	669	120	393	0	33146
10410	31898	576	117	368	0	32959
10411	1054	334	113	31495	0	32996
10412	718	236	31391	775	0	33120
10413	426	222	31287	591	0	32526
10414	318	221	1004	30341	0	31884
10415	356	203	624	29156	0	30339
10416	336	30402	315	1071	0	32124
10417	30330	664	281	646	0	31921
10418	805	30121	261	463	0	31650
10419	702	30041	200	402	0	31345
10420	29883	1041	206	367	0	31497
10421	889	601	215	29553	0	31258
10422	722	30691	214	839	0	32466
10423	470	697	226	31093	0	32486
10424	282	534	30308	1047	0	32171
10425	272	262	30320	879	0	31733
10426	297	205	1035	30433	0	31970
10427	280	177	30888	1006	0	32351
10428	320	198	860	30531	0	31909
10429	284	228	637	30172	0	31321
10430	278	282	366	31041	0	31967
10431	30005	209	294	1331	0	31839
10432	665	29973	279	933	0	31850
10433	574	30279	236	568	0	31657
10434	27331	1014	239	442	0	29026
10435	27561	620	159	459	0	28799
10436	1128	373	157	27242	0	28900
10437	721	343	27432	848	0	29344
10438	412	324	697	27969	0	29402
10439	351	331	27900	908	0	29490
10440	308	27890	776	728	0	29702
10441	289	756	588	27902	0	29535
10442	27778	575	353	821	0	29527
10443	773	394	295	27940	0	29402
10444	695	218	26903	802	0	28618
10445	26341	249	751	640	0	27981
10446	814	242	27162	399	0	28617
10447	857	208	26365	312	0	27742
10448	331	25277	957	346	0	26911
10449	171	19234	405	205	0	20015
10450	166	17332	553	217	0	18268
10451	12129	510	582	407	0	13628
10452	10183	55	26	32	0	10296
10453	61	18	17	10617	0	10713
10454	42	12	9	10676	0	10739
10455	22	10	8	10883	0	10923
10456	18	11371	16	86	0	11491
10457	11380	39	14	58	0	11491
10458	42	11480	11	34	0	11567
10459	47	43	12	11629	0	11731
10460	11568	40	15	59	0	11682
10461	45	21	23	11568	0	11657
10462	43	19	20	11786	0	11868
10463	11845	9	23	101	0	11978
10464	11378	24	33	67	0	11502
10465	89	21	11945	33	0	12088
10466	70	24	11903	27	0	12024
10467	36	25	12618	29	0	12708
10468	24	42	96	12322	0	12484
10469	21	15	65	12487	0	12588
10470	18	12473	34	127	0	12652
10471	12706	60	22	98	0	12886
10472	51	56	28	12787	0	12922
10473	56	26	20	12808	0	12910
10474	31	13188	13	123	0	13355
10475	20	14402	15	94	0	14531
10476	28	105	16	15233	0	15382
10477	23	68	22	17465	0	17578
10478	17709	27	13	182	0	17931
10479	17452	30	18	127	0	17627
10480	198	20	12	17802	0	18032
10481	133	22	17833	144	0	18132
10482	59	22	17655	128	0	17864
10483	34	22	200	17525	0	17781
10484	27	16	122	17376	0	17541
10485	20	17722	45	221	0	18008
10486	17512	111	33	146	0	17802
10487	114	101	26	17517	0	17758
10488	129	39	17843	141	0	18152
10489	38	27	115	18096	0	18276
10490	60	22	18313	147	0	18542
10491	49	21	18857	121	0	19048
10492	18	58	209	18871	0	19156
10493	19020	59	117	149	0	19345
10494	128	18	19023	120	0	19289
10495	93	19	112	18716	0	18940
10496	57	22	20625	137	0	20841
10497	41	20	121	20290	0	20472
10498	27	25	99	20452	0	20603
10499	41	19	20513	233	0	20806
10500	43	22	20480	134	0	20679
10501	45	27	199	20138	0	20409
10502	40	19	108	20714	0	20881
10503	33	26	43	20834	0	20936
10504	31	20	33	20727	0	20811
10505	20586	11	43	254	0	20894
10506	20412	15	51	165	0	20643
10507	191	20753	44	89	0	21077
10508	21436	124	31	74	0	21665
10509	146	110	41	21624	0	21921
10510	21883	29	41	171	0	22124
10511	177	51	21567	144	0	21939
10512	21485	21	156	66	0	21728
10513	142	25	138	21722	0	22027
10514	111	20	73	22298	0	22502
10515	22487	25	52	274	0	22838
10516	154	25	44	24763	0	24986
10517	167	26	25615	244	0	26052
10518	25086	28	208	236	0	25558
10519	208	26530	188	131	0	27057
10520	181	244	59	27497	0	27981
10521	86	182	30088	294	0	30650
10522	40	45	276	29753	0	30114
10523	74	26	30466	371	0	30937
10524	52	103	309	30260	0	30724
10525	42	30645	248	384	0	31319
10526	53	268	66	30706	0	31093
10527	54	31800	49	366	0	32269
10528	84	336	72	31203	0	31695
10529	62	263	54	32965	0	33344
10530	64	68	67	33242	0	33441
10531	65	33	56	33121	0	33275
10532	70	17	52	33537	0	33676
10533	83	25	32929	720	0	33757
10534	58	24	363	32812	0	33257
10535	42	32	338	32965	0	33377
10536	32643	19	119	681	0	33462
10537	322	32414	64	489	0	33289
10538	32499	332	66	162	0	33059
10539	389	301	76	32534	0	33300
10540	364	71	32682	435	0	33552
10541	82	32681	370	465	0	33598
10542	32045	340	365	181	0	32931
10543	350	32621	111	171	0	33253
10544	321	32994	96	180	0	33591
10545	32618	635	87	155	0	33495
10546	364	393	83	34506	0	35346
10547	34538	85	71	516	0	35210
10548	423	52	92	34157	0	34724
10549	419	57	34230	564	0	35270
10550	123	40	33659	541	0	34363
10551	32029	42	772	262	0	33105
10552	33475	44	466	195	0	34180
10553	746	66	128	32832	0	33772
10554	447	46	87	33262	0	33842
10555	32739	70	70	867	0	33746
10556	418	32235	86	589	0	33328
10557	414	32776	64	273	0	33527
10558	32330	714	78	185	0	33307
10559	32044	467	82	186	0	32779
10560	775	32275	80	160	0	33290
10561	508	442	60	32077	0	33087
10562	187	467	31536	674	0	32864
10563	161	134	31557	520	0	32372
10564	31136	80	756	228	0	32200
10565	485	82	32062	301	0	32930
10566	452	78	473	30465	0	31468
10567	167	84	422	30239	0	30912
10568	132	30792	146	804	0	31874
10569	30470	418	111	516	0	31515
10570	618	393	82	30719	0	31812
10571	477	132	30338	643	0	31590
10572	175	30428	405	588	0	31596
10573	148	561	415	30288	0	31412
10574	187	408	30048	491	0	31134
10575	201	161	29206	477	0	30045
10576	126	28287	697	243	0	29353
10577	25744	385	436	154	0	26719
10578	380	26347	129	155	0	27011
10579	26190	420	105	162	0	26877
10580	449	372	25691	171	0	26683
10581	25248	124	386	183	0	25941
10582	409	25660	371	388	0	26828
10583	381	375	139	25729	0	26624
10584	141	374	120	26437	0	27072
10585	26029	149	99	741	0	27018
10586	407	103	25810	531	0	26851
10587	25479	114	390	258	0	26241
10588	25422	112	388	226	0	26148
10589	699	99	24860	236	0	25894
10590	456	111	25174	218	0	25959
10591	181	136	693	24021	0	25031
10592	24157	128	431	501	0	25217
10593	24348	123	186	507	0	25164
10594	688	24613	119	252	0	25672
10595	491	421	107	24650	0	25669
10596	254	415	124	23308	0	24101
10597	207	173	121	23631	0	24132
10598	209	134	130	24128	0	24601
10599	23513	133	144	806	0	24596
10600	508	144	138	23945	0	24735
10601	476	161	23737	523	0	24897
10602	260	146	23649	459	0	24514
10603	22964	138	721	216	0	24039
10604	509	23643	445	196	0	24793
10605	491	24103	208	170	0	24972
10606	281	715	163	23785	0	24944
10607	219	480	161	23922	0	24782
10608	208	185	160	23645	0	24198
10609	217	134	155	23953	0	24459
10610	232	156	23250	791	0	24429
10611	248	184	413	23141	0	23986
10612	239	128	418	23148	0	23933
10613	201	130	22555	798	0	23684
10614	21220	122	458	527	0	22327
10615	496	22011	426	260	0	23193
10616	19626	346	191	188	0	20351
10617	443	302	19147	178	0	20070
10618	402	107	18509	154	0	19172
10619	201	17855	533	139	0	18728
10620	15819	626	1236	309	0	17990
10621	14050	229	180	99	0	14558
10622	14200	82	99	82	0	14463
10623	420	13527	96	104	0	14147
10624	13287	212	108	92	0	13699
10625	275	186	13656	86	0	14203
10626	221	13648	198	105	0	14172
10627	13165	176	252	75	0	13668
10628	187	13581	76	72	0	13916
10629	12338	148	49	60	0	12595
10630	12117	142	94	57	0	12410
10631	284	40	12452	52	0	12828
10632	179	12504	151	57	0	12891
10633	12291	144	157	46	0	12638
10634	170	139	12564	51	0	12924
10635	165	12662	167	71	0	13065
10636	65	150	154	12565	0	12934
10637	68	145	12611	167	0	12991
10638	67	48	12586	161	0	12862
10639	61	31	243	12568	0	12903
10640	12532	26	158	158	0	12874
10641	142	12581	49	196	0	12968
10642	150	132	12605	55	0	12942
10643	72	117	12389	38	0	12616
10644	11642	40	221	36	0	11939
10645	149	12568	125	42	0	12884
10646	10476	74	21	14	0	10585
10647	80	10742	21	18	0	10861
10648	10869	78	24	22	0	10993
10649	10343	57	14	17	0	10431
10650	120	10365	22	22	0	10529
10651	70	78	16	10401	0	10565
10652	10756	66	15	79	0	10916
10653	82	22	22	10706	0	10832
10654	62	11	30	11593	0	11696
10655	11684	14	22	170	0	11890
10656	117	11737	26	96	0	11976
10657	12041	113	19	28	0	12201
10658	136	87	11951	16	0	12190
10659	84	19	127	11803	0	12033
10660	28	20	83	12100	0	12231
10661	12054	20	26	180	0	12280
10662	11928	20	22	102	0	12072
10663	193	15	24	12032	0	12264
10664	104	24	12664	127	0	12919
10665	44	27	115	12412	0	12598
10666	39	24	91	12680	0	12834
10667	35	30	24	12748	0	12837
10668	40	23	15	12884	0	12962
10669	12672	27	14	209	0	12922
10670	142	23	12725	113	0	13003
10671	100	12970	127	53	0	13250
10672	57	126	87	12768	0	13038
10673	44	99	22	13065	0	13230
10674	54	36	13003	201	0	13294
10675	51	25	12926	114	0	13116
10676	47	23	192	12985	0	13247
10677	44	15	104	13145	0	13308
10678	53	24	13064	225	0	13366
10679	39	37	131	12965	0	13172
10680	13127	14	121	160	0	13422
10681	330	13622	51	145	0	14148
10682	131	130	13868	71	0	14200
10683	46	13903	132	65	0	14146
10684	47	134	102	14029	0	14312
10685	59	95	14081	155	0	14390
10686	43	14156	134	192	0	14525
10687	41	130	115	14378	0	14664
10688	53	114	14646	166	0	14979
10689	42	45	141	14461	0	14689
10690	47	24	126	14660	0	14857
10691	14773	22	46	250	0	15091
10692	148	29	31	14821	0	15029
10693	14760	24	38	187	0	15009
10694	14191	32	50	143	0	14416
10695	14320	33	34	91	0	14478
10696	244	112	33	14179	0	14568
10697	131	211	14064	169	0	14575
10698	51	30	14128	147	0	14356
10699	14332	30	227	90	0	14679
10700	149	27	14876	75	0	15127
10701	13666	19	146	75	0	13906
10702	140	14120	125	69	0	14454
10703	14191	116	53	63	0	14423
10704	163	103	14245	62	0	14573
10705	124	62	14444	62	0	14692
10706	55	22	211	14825	0	15113
10707	48	28	15541	206	0	15823
10708	56	20	15856	157	0	16089
10709	43	28	276	16933	0	17280
10710	36	39	177	17051	0	17303
10711	39	34	57	17891	0	18021
10712	40	18103	45	430	0	18618
10713	42	202	49	17980	0	18273
10714	33	18569	49	273	0	18924
10715	18338	234	31	240	0	18843
10716	18165	199	56	109	0	18529
10717	384	60	56	17591	0	18091
10718	241	18053	47	239	0	18580
10719	91	219	18251	240	0	18801
10720	18101	195	237	110	0	18643
10721	229	57	241	18229	0	18756
10722	224	56	104	17975	0	18359
10723	82	21	63	18774	0	18940
10724	18210	24	71	469	0	18774
10725	232	17633	64	315	0	18244
10726	227	17919	61	118	0	18325
10727	17032	373	59	61	0	17525
10728	224	17231	62	75	0	17592
10729	17223	248	60	70	0	17601
10730	16930	215	51	80	0	17276
10731	382	16911	77	90	0	17460
10732	243	220	71	16784	0	17318
10733	81	17134	59	242	0	17516
10734	46	245	55	16636	0	16982
10735	46	210	57	17343	0	17656
10736	17027	82	62	456	0	17627
10737	17359	43	58	299	0	17759
10738	462	37	54	17459	0	18012
10739	297	36	17138	308	0	17779
10740	16451	37	256	284	0	17028
10741	275	17067	245	127	0	17714
10742	250	251	94	16936	0	17531
10743	100	237	83	16964	0	17384
10744	77	75	71	17274	0	17497
10745	16318	74	52	538	0	16982
10746	16333	60	58	334	0	16785
10747	469	15919	62	135	0	16585
10748	295	16142	50	102	0	16589
10749	129	445	47	15875	0	16496
10750	91	288	55	16234	0	16668
10751	95	110	16105	471	0	16781
10752	82	67	258	15869	0	16276
10753	91	59	15803	348	0	16301
10754	80	28	14720	267	0	15095
10755	73	14567	372	126	0	15138
10756	230	221	273	14431	0	15155
10757	14487	257	66	238	0	15048
10758	237	82	37	14606	0	14962
10759	237	69	14361	283	0	14950
10760	13789	55	203	244	0	14291
10761	14026	57	204	91	0	14378
10762	418	67	14369	81	0	14935
10763	273	53	192	14401	0	14919
10764	13959	55	186	241	0	14441
10765	241	14016	57	252	0	14566
10766	14025	260	34	139	0	14458
10767	14219	213	48	91	0	14571
10768	408	93	30	13959	0	14490
10769	267	59	35	14211	0	14572
10770	14146	48	50	423	0	14667
10771	256	66	38	14190	0	14550
10772	243	77	14106	322	0	14748
10773	13541	62	234	277	0	14114
10774	13703	71	206	138	0	14118
10775	409	13650	68	148	0	14275
10776	265	14058	45	116	0	14484
10777	115	424	40	13655	0	14234
10778	81	14005	40	287	0	14413
10779	99	294	37	13984	0	14414
10780	13670	229	26	323	0	14248
10781	13211	100	32	269	0	13612
10782	415	12987	47	162	0	13611
10783	12961	245	37	119	0	13362
10784	310	12870	51	94	0	13325
10785	12811	283	54	90	0	13238
10786	12589	211	54	100	0	12954
10787	425	85	12222	127	0	12859
10788	12239	87	230	88	0	12644
10789	308	11993	182	128	0	12611
10790	256	12170	75	98	0	12599
10791	12127	392	44	93	0	12656
10792	309	249	31	12104	0	12693
10793	269	108	12114	278	0	12769
10794	187	73	227	11956	0	12443
10795	122	76	182	12255	0	12635
10796	105	88	11961	439	0	12593
10797	11465	73	233	284	0	12055
10798	297	11508	178	159	0	12142
10799	11142	238	76	117	0	11573
10800	320	196	39	10790	0	11345
10801	10868	98	33	288	0	11287
10802	300	10942	33	245	0	11520
10803	256	261	44	10862	0	11423
10804	10785	187	38	295	0	11305
10805	288	76	10231	232	0	10827
10806	206	55	9172	115	0	9548
10807	8898	44	285	83	0	9310
10808	207	8753	205	67	0	9232
10809	113	6745	70	47	0	6975
10810	251	301	84	6103	0	6739
10811	48	6241	21	126	0	6436
10812	38	137	25	6266	0	6466
10813	46	75	31	6243	0	6395
10814	50	33	36	6285	0	6404
10815	44	6132	32	191	0	6399
10816	69	119	29	6180	0	6397
10817	44	81	6024	147	0	6296
10818	49	6020	95	107	0	6271
10819	42	163	71	5511	0	5787
10820	38	5506	30	111	0	5685
10821	5501	104	23	62	0	5690
10822	5487	63	18	45	0	5613
10823	5502	30	22	42	0	5596
10824	164	5562	24	36	0	5786
10825	97	99	11	5537	0	5744
10826	59	65	5445	104	0	5673
10827	66	37	5388	54	0	5545
10828	5099	115	109	45	0	5368
10829	5198	28	65	35	0	5326
10830	131	40	28	5685	0	5884
10831	86	32	11	5870	0	5999
10832	50	41	5901	159	0	6151
10833	35	5890	95	107	0	6127
10834	43	5965	64	65	0	6137
10835	42	109	5534	40	0	5725
10836	60	90	62	5147	0	5359
10837	31	35	105	4912	0	5083
10838	19	26	23	5101	0	5169
10839	23	29	17	5132	0	5201
10840	5113	22	8	102	0	5245
10841	73	30	4979	54	0	5136
10842	4940	23	54	35	0	5052
10843	78	26	36	4997	0	5137
10844	5018	24	19	56	0	5117
10845	73	29	16	5014	0	5132
10846	70	15	5024	74	0	5183
10847	43	20	53	5047	0	5163
10848	28	22	5256	70	0	5376
10849	34	48	55	5118	0	5255
10850	32	20	5343	69	0	5464
10851	26	5473	53	60	0	5612
10852	26	49	41	5506	0	5622
10853	19	48	28	5419	0	5514
10854	21	5682	19	83	0	5805
10855	5753	58	14	61	0	5886
10856	57	50	13	5609	0	5729
10857	45	32	20	5548	0	5645
10858	5883	22	13	93	0	6011
10859	5696	16	118	71	0	5901
10860	6010	14	19	46	0	6089
10861	6054	19	10	41	0	6124
10862	112	19	5779	23	0	5933
10863	5562	17	53	25	0	5657
10864	5730	14	46	29	0	5819
10865	95	19	17	5590	0	5721
10866	58	21	17	5586	0	5682
10867	5431	12	11	90	0	5544
10868	56	5400	18	66	0	5540
10869	44	45	23	5389	0	5501
10870	29	41	5901	60	0	6031
10871	17	5757	40	48	0	5862
10872	5575	35	56	29	0	5695
10873	5475	34	14	21	0	5544
10874	5397	12	9	11	0	5429
10875	5509	12	8	15	0	5544
10876	62	7	7	5374	0	5450
10877	40	12	5350	31	0	5433
10878	12	8	5606	36	0	5662
10879	11	7	58	6112	0	6188
10880	6484	2	45	55	0	6586
10881	51	5	14	6681	0	6751
10882	57	3	6680	61	0	6801
10883	6523	6	54	57	0	6640
10884	6525	6	55	22	0	6608
10885	96	3	12	6740	0	6851
10886	62	3	7090	59	0	7214
10887	27	4	7131	57	0	7219
10888	6873	5	93	24	0	6995
10889	55	7168	54	34	0	7311
10890	55	42	7089	18	0	7204
10891	16	38	55	7001	0	7110
10892	7089	9	41	52	0	7191
10893	44	7052	18	57	0	7171
10894	48	7114	9	26	0	7197
10895	7224	76	8	20	0	7328
10896	51	44	7	7202	0	7304
10897	7795	11	8	58	0	7872
10898	66	5	9	7871	0	7951
10899	54	9	7	8141	0	8211
10900	15	8	8178	126	0	8327
10901	35	8	7845	70	0	7958
10902	17	5	8271	21	0	8314
10903	23	7	113	8153	0	8296
10904	8350	9	67	77	0	8503
10905	86	2	8573	69	0	8730
10906	68	3	72	8581	0	8724
10907	24	3	8850	87	0	8964
10908	17	8909	82	79	0	9087
10909	15	66	71	8880	0	9032
10910	27	67	21	8818	0	8933
10911	27	13	21	9081	0	9142
10912	8922	8	12	160	0	9102
10913	82	7	13	8962	0	9064
10914	86	8	14	8910	0	9018
10915	8959	8	18	156	0	9141
10916	98	9	8851	87	0	9045
10917	8773	5	82	31	0	8891
10918	8796	8	76	23	0	8903
10919	153	6	8793	26	0	8978
10920	8468	9	85	21	0	8583
10921	96	14	78	8950	0	9138
10922	89	10	9154	80	0	9333
10923	9004	9	76	82	0	9171
10924	9408	9	75	27	0	9519
10925	146	8	21	9270	0	9445
10926	101	4	16	9349	0	9470
10927	31	12	18	9488	0	9549
10928	9341	4	17	179	0	9541
10929	92	9406	34	102	0	9634
10930	8991	62	23	37	0	9113
10931	85	8718	25	25	0	8853
10932	68	8715	18	43	0	8844
10933	30	115	22	9020	0	9187
10934	22	57	29	9074	0	9182
10935	22	24	27	8993	0	9066
10936	23	10	27	9128	0	9188
10937	27	13	9120	151	0	9311
10938	8724	12	90	89	0	8915
10939	94	6	79	9089	0	9268
10940	86	8	9238	111	0	9443
10941	36	10	87	9199	0	9332
10942	37	19	63	9302	0	9421
10943	37	8	10119	161	0	10325
10944	32	11	84	10012	0	10139
10945	37	9	86	9985	0	10117
10946	10316	18	30	145	0	10509
10947	100	12	10643	94	0	10849
10948	10217	13	89	54	0	10373
10949	105	10632	79	56	0	10872
10950	10533	68	33	50	0	10684
10951	9853	74	39	44	0	10010
10952	155	16	23	10135	0	10329
10953	103	9	10160	102	0	10374
10954	38	10919	79	112	0	11148
10955	36	204	81	10749	0	11070
10956	23	11996	41	130	0	12190
10957	11956	143	33	111	0	12243
10958	170	101	11603	54	0	11928
10959	115	31	11620	51	0	11817
10960	40	17	229	11593	0	11879
10961	49	18	12082	183	0	12332
10962	50	12	157	12031	0	12250
10963	35	21	106	12109	0	12271
10964	12653	8	32	261	0	12954
10965	170	12777	27	151	0	13125
10966	119	141	31	12994	0	13285
10967	49	93	32	13136	0	13310
10968	48	19	28	13070	0	13165
10969	32	12947	46	276	0	13301
10970	38	12859	38	146	0	13081
10971	12634	215	38	75	0	12962
10972	12503	103	41	54	0	12701
10973	12589	32	26	49	0	12696
10974	265	14	12592	64	0	12935
10975	127	45	166	12438	0	12776
10976	51	34	12598	198	0	12881
10977	47	12500	165	160	0	12872
10978	12156	141	115	68	0	12480
10979	164	81	11943	67	0	12255
10980	106	33	182	11488	0	11809
10981	45	17	11630	151	0	11843
10982	11295	9	137	129	0	11570
10983	11703	23	101	60	0	11887
10984	11730	10	39	48	0	11827
10985	11447	23	40	38	0	11548
10986	236	11	11698	43	0	11988
10987	11420	16	138	44	0	11618
10988	11656	15	101	32	0	11804
10989	199	11621	30	56	0	11906
10990	11620	117	29	50	0	11816
10991	11930	83	30	42	0	12085
10992	220	31	23	11583	0	11857
10993	115	12101	28	145	0	12389
10994	12627	142	23	127	0	12919
10995	13390	84	27	71	0	13572
10996	279	43	14954	80	0	15356
10997	138	26	15107	27	0	15298
10998	58	23	15698	36	0	15815
10999	36	42	311	15226	0	15615
11000	15235	23	153	211	0	15622
11001	191	15399	54	172	0	15816
11002	15215	189	19	51	0	15474
11003	206	15262	25	37	0	15530
11004	15057	204	10	43	0	15314
11005	211	14875	23	33	0	15142
11006	135	14948	19	41	0	15143
11007	14733	285	18	28	0	15064
11008	188	14766	19	35	0	15008
11009	127	202	20	14721	0	15070
11010	51	119	14818	195	0	15183
11011	56	54	14894	122	0	15126
11012	37	23	290	14487	0	14837
11013	26	27	143	14973	0	15169
11014	52	18	14983	295	0	15348
11015	43	19	209	14728	0	14999
11016	36	25	135	14985	0	15181
11017	14906	27	41	317	0	15291
11018	222	14959	46	183	0	15410
11019	142	220	39	14355	0	14756
11020	56	15342	40	203	0	15641
11021	15070	230	49	127	0	15476
11022	234	15102	40	175	0	15551
11023	15172	228	48	46	0	15494
11024	15100	148	50	36	0	15334
11025	345	70	46	14844	0	15305
11026	190	52	58	15155	0	15455
11027	94	61	43	15304	0	15502
11028	71	58	50	15474	0	15653
11029	77	55	15033	346	0	15511
11030	14186	66	213	187	0	14652
11031	244	14850	144	216	0	15454
11032	172	252	56	15195	0	15675
11033	96	162	66	15024	0	15348
11034	81	15100	59	347	0	15587
11035	15035	251	58	194	0	15538
11036	253	15443	64	93	0	15853
11037	175	525	62	14900	0	15662
11038	93	168	58	15446	0	15765
11039	100	81	60	15480	0	15721
11040	93	81	49	15591	0	15814
11041	15418	67	65	377	0	15927
11042	293	66	15400	205	0	15964
11043	194	69	244	14670	0	15177
11044	101	72	170	14688	0	15031
11045	88	74	86	14869	0	15117
11046	100	58	77	14692	0	14927
11047	14137	65	62	422	0	14686
11048	305	64	14100	220	0	14689
11049	200	74	241	13525	0	14040
11050	131	13764	144	280	0	14319
11051	103	14239	75	205	0	14622
11052	14165	354	92	121	0	14732
11053	316	199	14100	98	0	14713
11054	12989	166	205	85	0	13445
11055	260	130	13271	100	0	13761
11056	152	70	172	12443	0	12837
11057	12485	69	119	227	0	12900
11058	202	12743	79	224	0	13248
11059	146	193	73	12197	0	12609
11060	87	12506	74	216	0	12883
11061	12468	205	68	194	0	12935
11062	12392	146	69	137	0	12744
11063	280	86	46	12613	0	13025
11064	177	77	11974	244	0	12472
11065	108	85	11934	207	0	12334
11066	91	91	235	11602	0	12019
11067	82	12009	126	250	0	12467
11068	77	221	52	12078	0	12428
11069	90	178	42	11838	0	12148
11070	96	108	38	11946	0	12188
11071	89	87	11883	337	0	12396
11072	99	73	180	11987	0	12339
11073	85	67	127	11925	0	12204
11074	58	11987	74	451	0	12570
11075	81	186	66	11711	0	12044
11076	72	140	56	12466	0	12734
11077	69	72	71	12538	0	12750
11078	83	74	69	12421	0	12647
11079	82	71	48	12294	0	12495
11080	101	73	46	12256	0	12476
11081	104	71	44	12144	0	12363
11082	79	85	51	12033	0	12248
11083	99	80	11461	471	0	12111
11084	105	93	163	11662	0	12023
11085	11562	78	122	281	0	12043
11086	210	80	46	11439	0	11775
11087	178	52	11813	273	0	12316
11088	11323	60	183	237	0	11803
11089	11679	63	125	169	0	12036
11090	11847	61	78	147	0	12133
11091	11847	54	59	179	0	12139
11092	289	61	44	11737	0	12131
11093	166	53	11592	286	0	12097
11094	84	11066	158	232	0	11540
11095	59	10333	120	134	0	10646
11096	68	133	343	7857	0	8401
11097	11	40	53	8033	0	8137
11098	11	17	12	8079	0	8119
11099	11	5	11	8184	0	8211
11100	10	8	13	9106	0	9137
11101	10001	11	13	136	0	10161
11102	107	10222	14	84	0	10427
11103	67	10381	7	48	0	10503
11104	24	211	11	10591	0	10837
11105	16	92	11	10744	0	10863
11106	13	25	12	10698	0	10748
11107	15	10	13	10682	0	10720
11108	14	9	10478	269	0	10770
11109	15	10359	142	129	0	10645
11110	13	139	77	10300	0	10529
11111	10061	71	25	170	0	10327
11112	135	21	14	10231	0	10401
11113	84	10	10271	228	0	10593
11114	39	9	10006	104	0	10158
11115	24	11	10346	49	0	10430
11116	19	12	222	10088	0	10341
11117	10478	11	90	164	0	10743
11118	152	8	24	10535	0	10719
11119	91	15	10	10696	0	10812
11120	10386	18	5	239	0	10648
11121	154	15	12	10434	0	10615
11122	84	19	14	10518	0	10635
11123	37	13	10742	247	0	11039
11124	14	10655	147	133	0	10949
11125	10	157	90	10972	0	11229
11126	10829	85	33	189	0	11136
11127	143	28	19	11053	0	11243
11128	105	13	11019	210	0	11347
11129	31	78	151	10994	0	11254
11130	25	11105	97	190	0	11417
11131	16	156	27	11407	0	11606
11132	34	97	11064	207	0	11402
11133	15	11967	161	142	0	12285
11134	16	227	96	12101	0	12440
11135	13	121	33	12786	0	12953
11136	14	44	31	12872	0	12961
11137	12	16	18	13202	0	13248
11138	22	15	12738	368	0	13143
11139	14	12764	203	196	0	13177
11140	12714	206	129	83	0	13132
11141	12758	133	41	56	0	12988
11142	320	36	28	12700	0	13084
11143	154	19	12568	238	0	12979
11144	12115	9	226	168	0	12518
11145	211	14	143	12622	0	12990
11146	146	14	12849	246	0	13255
11147	39	16	224	12873	0	13152
11148	33	15	141	12804	0	12993
11149	35	14	35	13190	0	13274
11150	44	10	13166	388	0	13608
11151	30	25	207	12743	0	13005
11152	27	13270	139	248	0	13684
11153	13173	213	44	174	0	13604
11154	13047	144	40	86	0	13317
11155	13191	55	27	69	0	13342
11156	345	12961	23	84	0	13413
11157	13006	215	36	81	0	13338
11158	230	140	34	12666	0	13070
11159	12691	47	32	285	0	13055
11160	12663	29	36	197	0	12925
11161	341	37	12504	112	0	12994
11162	159	12294	227	88	0	12768
11163	12198	221	143	68	0	12630
11164	215	144	51	12246	0	12656
11165	159	44	12235	264	0	12702
11166	60	12225	221	218	0	12724
11167	11909	203	155	104	0	12371
11168	223	145	62	11942	0	12372
11169	146	64	41	12036	0	12287
11170	72	56	43	12115	0	12286
11171	59	11842	32	410	0	12343
11172	56	216	40	11955	0	12267
11173	54	11854	42	308	0	12258
11174	60	234	38	11811	0	12143
11175	62	144	11737	301	0	12244
11176	72	66	226	11771	0	12135
11177	64	40	158	11907	0	12169
11178	69	42	66	12135	0	12312
11179	72	34	11644	510	0	12260
11180	55	35	248	11793	0	12131
11181	85	38	173	12050	0	12346
11182	68	34	85	12182	0	12369
11183	72	49	66	12214	0	12401
11184	87	43	46	12399	0	12575
11185	80	48	12074	437	0	12639
11186	90	54	207	12041	0	12392
11187	78	34	149	11813	0	12074
11188	11370	34	72	419	0	11895
11189	230	11342	45	280	0	11897
11190	163	11522	62	168	0	11915
11191	84	338	54	11378	0	11854
11192	70	174	54	11442	0	11740
11193	74	11205	51	402	0	11732
11194	85	226	54	11418	0	11783
11195	58	11370	70	322	0	11820
11196	81	230	56	11262	0	11629
11197	74	196	52	11171	0	11493
11198	77	70	10699	400	0	11246
11199	65	10506	226	249	0	11046
11200	54	9746	132	139	0	10071
11201	8241	211	42	100	0	8594
11202	112	8277	38	87	0	8514
11203	109	119	32	8337	0	8597
11204	56	88	8050	162	0	8356
11205	49	62	108	7847	0	8066
11206	7892	38	87	171	0	8188
11207	128	33	8350	137	0	8648
11208	99	8544	101	89	0	8833
11209	83	113	85	8403	0	8684
11210	65	93	42	8757	0	8957
11211	8767	51	23	223	0	9064
11212	114	35	32	8927	0	9108
11213	102	40	29	8905	0	9076
11214	51	33	35	9039	0	9158
11215	43	50	27	9009	0	9129
11216	8724	43	33	235	0	9035
11217	8534	33	37	164	0	8768
11218	175	45	28	8718	0	8966
11219	8523	37	41	166	0	8767
11220	120	42	39	8478	0	8679
11221	103	42	8481	174	0	8800
11222	61	43	8489	157	0	8750
11223	58	29	138	8040	0	8265
11224	37	8291	89	155	0	8572
11225	36	128	30	8125	0	8319
11226	7952	75	21	153	0	8201
11227	89	32	34	8029	0	8184
11228	8046	35	30	149	0	8260
11229	99	34	28	8178	0	8339
11230	77	29	8342	137	0	8585
11231	24	8160	88	124	0	8396
11232	21	8354	57	95	0	8527
11233	19	185	20	7369	0	7593
11234	14	40	7484	83	0	7621
11235	6	6674	16	39	0	6735
11236	49	17	35	6463	0	6564
11237	6393	10	6	27	0	6436
11238	6	6	6953	25	0	6990
11239	10	4	8	6912	0	6934
11240	6	7	11	7133	0	7157
11241	9	7	7172	29	0	7217
11242	13	7	6871	24	0	6915
11243	9	6	7307	20	0	7342
11244	10	7	20	7276	0	7313
11245	9	5	7509	23	0	7546
11246	6703	4	20	31	0	6758
11247	13	2	15	7705	0	7735
11248	18	8	10339	29	0	10394
11249	4	10648	12	45	0	10709
11250	10	12	10760	22	0	10804
11251	5	39	24	10568	0	10636
11252	11371	6	19	45	0	11441
11253	30	9	5	11753	0	11797
11254	27	5	6	12003	0	12041
11255	12927	3	5	68	0	13003
11256	71	3	3	13298	0	13375
11257	53	3	13857	90	0	14003
11258	13473	7	85	65	0	13630
11259	83	14346	57	15	0	14501
11260	14386	77	8	14	0	14485
11261	82	57	3	14399	0	14541
11262	76	9	14280	93	0	14458
11263	21	11	14504	75	0	14611
11264	6	3	129	14274	0	14412
11265	3	2	63	14229	0	14297
11266	17	2	14525	133	0	14677
11267	20	5	14161	68	0	14254
11268	14167	6	132	32	0	14337
11269	87	3	71	14552	0	14713
11270	14580	4	18	91	0	14693
11271	88	3	16	14583	0	14690
11272	73	2	15294	110	0	15479
11273	31	6	15807	77	0	15921
11274	6	38	153	15649	0	15846
11275	8	4	75	15885	0	15972
11276	26	3	16642	159	0	16830
11277	16284	10	131	87	0	16512
11278	167	5	80	17307	0	17559
11279	18406	7	20	189	0	18622
11280	206	21799	21	105	0	22131
11281	105	266	19	22200	0	22590
11282	22206	149	13	309	0	22677
11283	301	20	22210	184	0	22715
11284	167	14	293	21951	0	22425
11285	38	10	179	21862	0	22089
11286	28	1	31	22858	0	22918
11287	38	10	22579	481	0	23108
11288	28	15	308	22180	0	22531
11289	19	22650	180	342	0	23191
11290	21	290	44	22941	0	23296
11291	35	168	22659	338	0	23200
11292	28	26	22990	204	0	23248
11293	18	23	475	22543	0	23059
11294	22	22	229	22474	0	22747
11295	25	21	72	23006	0	23124
11296	24	11	41	23445	0	23521
11297	22901	11	47	534	0	23493
11298	22514	20	46	257	0	22837
11299	510	8	22864	89	0	23471
11300	219	23079	331	85	0	23714
11301	68	320	213	23330	0	23931
11302	23260	186	67	368	0	23881
11303	22639	64	73	268	0	23044
11304	23418	30	49	99	0	23596
11305	23362	18	59	92	0	23531
11306	563	13	23206	98	0	23880
11307	22443	19	347	105	0	22914
11308	368	22525	236	111	0	23240
11309	220	317	74	22848	0	23459
11310	93	187	22911	390	0	23581
11311	74	46	363	22759	0	23242
11312	86	33	23079	441	0	23639
11313	70	26	386	22856	0	23338
11314	53	37	246	23146	0	23482
11315	22871	22	110	612	0	23615
11316	371	33	78	23192	0	23674
11317	259	41	23033	480	0	23813
11318	105	36	380	23314	0	23835
11319	22969	38	263	486	0	23756
11320	383	35	133	23565	0	24116
11321	307	38	23374	479	0	24198
11322	105	23020	398	355	0	23878
11323	23486	346	265	201	0	24298
11324	408	228	145	22152	0	22933
11325	286	23856	132	438	0	24712
11326	23935	351	126	333	0	24745
11327	437	214	23867	214	0	24732
11328	282	23481	415	248	0	24426
11329	120	355	306	23699	0	24480
11330	134	206	23500	500	0	24340
11331	131	71	451	23041	0	23694
11332	23048	38	299	551	0	23936
11333	415	57	22973	398	0	23843
11334	317	53	400	22840	0	23610
11335	184	51	23179	524	0	23938
11336	164	54	461	22726	0	23405
11337	144	77	313	23320	0	23854
11338	22589	49	156	692	0	23486
11339	433	22586	125	448	0	23592
11340	343	354	135	22796	0	23628
11341	22637	223	119	545	0	23524
11342	22591	86	131	383	0	23191
11343	634	95	144	22168	0	23041
11344	332	22077	135	519	0	23063
11345	157	22880	118	413	0	23568
11346	157	555	172	22329	0	23213
11347	130	276	147	22532	0	23085
11348	20050	95	129	700	0	20974
11349	428	64	141	20072	0	20705
11350	268	57	19187	566	0	20078
11351	17905	45	450	396	0	18796
11352	398	18639	254	259	0	19550
11353	18190	326	135	229	0	18880
11354	428	181	18331	213	0	19153
11355	228	18398	332	200	0	19158
11356	18338	324	230	148	0	19040
11357	18186	225	100	164	0	18675
11358	518	67	18240	145	0	18970
11359	17948	78	338	123	0	18487
11360	18230	60	216	128	0	18634
11361	497	18048	105	134	0	18784
11362	311	324	73	18305	0	19013
11363	167	207	17918	390	0	18682
11364	177	91	335	18540	0	19143
11365	138	82	19089	428	0	19737
11366	89	77	392	18868	0	19426
11367	19344	72	258	425	0	20099
11368	360	55	100	19923	0	20438
11369	248	55	21475	462	0	22240
11370	21748	34	389	327	0	22498
11371	445	33	271	22578	0	23327
11372	310	52	22113	465	0	22940
11373	20871	35	424	345	0	21675
11374	425	100	295	21306	0	22126
11375	333	65	21408	469	0	22275
11376	142	60	21004	302	0	21508
11377	93	363	493	20057	0	21006
11378	124	64	20800	359	0	21347
11379	86	19394	299	417	0	20196
11380	63	196	126	15917	0	16302
11381	15775	113	44	214	0	16146
11382	177	25	16059	124	0	16385
11383	147	13	16097	51	0	16308
11384	15315	13	249	38	0	15615
11385	169	8	16253	32	0	16462
11386	15247	6	163	34	0	15450
11387	156	4	15875	38	0	16073
11388	115	32	166	15505	0	15818
11389	40	8	16031	154	0	16233
11390	17	11	160	15868	0	16056
11391	24	16	16353	165	0	16558
11392	34	25	16099	130	0	16288
11393	14877	11	232	60	0	15180
11394	136	16314	142	46	0	16638
11395	16342	118	50	20	0	16530
11396	154	16559	46	25	0	16784
11397	127	133	47	16353	0	16660
11398	51	100	48	16767	0	16966
11399	16832	19	46	232	0	17129
11400	143	13	45	16692	0	16893
11401	129	33	16621	168	0	16951
11402	15985	5	163	148	0	16301
11403	16297	17	150	51	0	16515
11404	230	10	64	16483	0	16787
11405	140	20	16575	149	0	16884
11406	62	18	150	16294	0	16524
11407	44	16583	135	164	0	16926
11408	34	139	63	16269	0	16505
11409	54	120	43	16626	0	16843
11410	48	32	16375	261	0	16716
11411	14703	16	175	188	0	15082
11412	171	16112	145	74	0	16502
11413	16087	126	72	72	0	16357
11414	169	16348	61	60	0	16638
11415	156	131	69	15956	0	16312
11416	54	16522	53	186	0	16815
11417	57	132	16351	161	0	16701
11418	37	120	187	15463	0	15807
11419	50	41	163	15715	0	15969
11420	54	25	72	16253	0	16404
11421	15898	26	77	292	0	16293
11422	170	21	91	15968	0	16250
11423	15706	26	77	204	0	16013
11424	15634	35	93	176	0	15938
11425	15313	34	102	85	0	15534
11426	317	37	15617	84	0	16055
11427	176	39	212	15478	0	15905
11428	81	45	206	16006	0	16338
11429	69	35	129	16297	0	16530
11430	16618	27	150	356	0	17151
11431	209	38	131	16672	0	17050
11432	178	31	127	17047	0	17383
11433	17867	38	115	353	0	18373
11434	262	28	136	18532	0	18958
11435	237	35	19009	279	0	19560
11436	135	49	19435	233	0	19852
11437	131	32	437	19470	0	20070
11438	19152	46	319	318	0	19835
11439	18180	34	197	254	0	18665
11440	425	29	123	19071	0	19648
11441	247	30	19145	315	0	19737
11442	121	19021	313	256	0	19711
11443	119	235	264	19140	0	19758
11444	119	184	130	19485	0	19918
11445	130	58	125	19688	0	20001
11446	19739	63	103	476	0	20381
11447	311	42	19747	292	0	20392
11448	19552	46	307	144	0	20049
11449	328	60	248	19179	0	19815
11450	257	19604	106	333	0	20300
11451	19675	236	85	272	0	20268
11452	19112	191	97	153	0	19553
11453	471	61	20462	138	0	21132
11454	256	19727	302	144	0	20429
11455	116	19215	205	130	0	19666
11456	19024	354	61	137	0	19576
11457	278	192	71	18834	0	19375
11458	235	65	66	18579	0	18945
11459	98	58	103	18456	0	18715
11460	95	18459	61	459	0	19074
11461	88	18891	57	297	0	19333
11462	18687	379	57	151	0	19274
11463	291	210	51	18613	0	19165
11464	222	66	19360	285	0	19933
11465	111	65	260	19952	0	20388
11466	93	77	21995	324	0	22489
11467	104	67	21531	233	0	21935
11468	85	71	21637	112	0	21905
11469	89	19341	429	68	0	19927
11470	135	300	369	17676	0	18480
11471	17	18649	92	225	0	18983
11472	32	280	31	17908	0	18251
11473	28	183	22	18470	0	18703
11474	18734	45	20	412	0	19211
11475	239	22	26	18823	0	19110
11476	18482	15	33	289	0	18819
11477	18553	15	23	211	0	18802
11478	405	21	26	17892	0	18344
11479	217	18185	29	268	0	18699
11480	86	235	22	18128	0	18471
11481	41	18202	35	307	0	18585
11482	32	271	30	17940	0	18273
11483	35	180	17560	317	0	18092
11484	36	67	248	17552	0	17903
11485	45	30	187	17752	0	18014
11486	17177	28	64	449	0	17718
11487	239	17398	59	262	0	17958
11488	196	247	37	17259	0	17739
11489	75	185	37	17019	0	17316
11490	58	16980	40	429	0	17507
11491	57	237	52	17026	0	17372
11492	15996	221	53	355	0	16625
11493	16379	82	65	237	0	16763
11494	417	16443	34	138	0	17032
11495	244	268	45	16415	0	16972
11496	15849	197	47	328	0	16421
11497	273	16087	48	278	0	16686
11498	210	271	45	15564	0	16090
11499	114	16001	67	312	0	16494
11500	15770	305	52	255	0	16382
11501	285	206	15607	155	0	16253
11502	239	105	15697	95	0	16136
11503	117	62	407	15617	0	16203
11504	107	74	15830	314	0	16325
11505	71	64	317	15703	0	16155
11506	15600	75	223	355	0	16253
11507	301	67	15610	275	0	16253
11508	245	68	284	15318	0	15915
11509	133	63	210	15699	0	16105
11510	15524	84	102	492	0	16202
11511	285	15840	71	315	0	16511
11512	15852	305	48	167	0	16372
11513	15745	244	55	138	0	16182
11514	449	15557	48	174	0	16228
11515	267	306	53	15635	0	16261
11516	147	223	15303	364	0	16037
11517	104	120	267	15181	0	15672
11518	99	15339	206	367	0	16011
11519	15357	310	101	280	0	16048
11520	296	254	79	15490	0	16119
11521	237	138	15703	388	0	16466
11522	116	114	288	15752	0	16270
11523	82	98	224	15624	0	16028
11524	63	95	116	15952	0	16226
11525	84	91	91	16047	0	16313
11526	93	104	82	15610	0	15889
11527	87	93	15182	578	0	15940
11528	73	97	14918	376	0	15464
11529	81	14457	403	217	0	15158
11530	57	14313	243	170	0	14783
11531	14068	408	86	165	0	14727
11532	301	244	13949	150	0	14644
11533	12606	220	280	120	0	13226
11534	270	66	12324	135	0	12795
11535	201	118	11551	95	0	11965
11536	104	62	299	11016	0	11481
11537	11083	66	194	223	0	11566
11538	211	61	75	11231	0	11578
11539	191	80	41	11233	0	11545
11540	83	65	11848	390	0	12386
11541	77	60	181	11937	0	12255
11542	67	42	157	11880	0	12146
11543	75	56	68	11695	0	11894
11544	76	42	46	11578	0	11742
11545	81	32	37	11666	0	11816
11546	11119	49	38	379	0	11585
11547	199	36	38	11262	0	11535
11548	142	45	10937	296	0	11420
11549	103	61	159	11140	0	11463
11550	53	52	11045	292	0	11442
11551	72	77	208	10989	0	11346
11552	69	43	11144	287	0	11543
11553	52	96	216	10015	0	10379
11554	48	51	142	10414	0	10655
11555	51	50	10218	307	0	10626
11556	9570	46	164	201	0	9981
11557	158	39	10258	117	0	10572
11558	143	26	191	10070	0	10430
11559	10192	29	152	186	0	10559
11560	150	34	79	10215	0	10478
11561	137	25	40	10420	0	10622
11562	99	16	10133	282	0	10530
11563	52	9988	149	219	0	10408
11564	28	8727	116	119	0	8990
11565	20	7857	63	103	0	8043
11566	276	49	169	4956	0	5450
11567	5114	23	87	33	0	5257
11568	24	6	5	5182	0	5217
11569	20	3	8	5248	0	5279
11570	7	2	7	5397	0	5413
11571	3	1	5	5393	0	5402
11572	6	5512	2	55	0	5575
11573	5	23	7	5677	0	5712
11574	1	20	5	5640	0	5666
11575	2	5628	6	56	0	5692
11576	5819	26	5	42	0	5892
11577	27	26	4	5804	0	5861
11578	5937	5	5	46	0	5993
11579	5865	2	5	42	0	5914
11580	55	6184	10	29	0	6278
11581	38	26	12	6814	0	6890
11582	9	31	6721	52	0	6813
11583	8	5	6640	49	0	6702
11584	2	6	61	6700	0	6769
11585	6923	50	43	48	0	7064
11586	7026	5	22	50	0	7103
11587	59	3	20	7313	0	7395
11588	7391	7	16	47	0	7461
11589	41	7293	10	123	0	7467
11590	7471	34	12	21	0	7538
11591	38	8771	19	32	0	8860
11592	44	37	17	8965	0	9063
11593	19	43	14	9009	0	9085
11594	9	9144	13	84	0	9250
11595	9167	31	7	72	0	9277
11596	46	40	9060	30	0	9176
11597	43	11	35	9075	0	9164
11598	21	10	9339	55	0	9425
11599	10	14	36	9122	0	9182
11600	9483	8	38	65	0	9594
11601	37	9	18	9618	0	9682
11602	9570	7	7	69	0	9653
11603	9399	6	13	71	0	9489
11604	68	5	7	9532	0	9612
11605	55	7	9468	63	0	9593
11606	18	10149	37	70	0	10274
11607	14	32	42	10283	0	10371
11608	10240	39	19	65	0	10363
11609	50	21	10682	61	0	10814
11610	49	15	42	10569	0	10675
11611	24	14	45	10525	0	10608
11612	18	8	21	10770	0	10817
11613	10779	4	14	95	0	10892
11614	44	6	18	10609	0	10677
11615	53	9	15	10834	0	10911
11616	37	13	11639	104	0	11793
11617	18	11	46	11519	0	11594
11618	22	11	51	11756	0	11840
11619	20	12	18	12086	0	12136
11620	19	11910	17	107	0	12053
11621	14	42	16	11666	0	11738
11622	17	48	9	11723	0	11797
11623	11550	21	9	96	0	11676
11624	53	16	11618	66	0	11753
11625	56	11	11342	40	0	11449
11626	22	11862	62	32	0	11978
11627	54	39	88	12038	0	12219
11628	11976	35	61	88	0	12160
11629	39	15	14	11801	0	11869
11630	45	8	14	12236	0	12303
11631	21	14	12	12315	0	12362
11632	16	13	6	12366	0	12401
11633	23	10	3	12384	0	12420
11634	25	12	12340	84	0	12461
11635	19	11	31	12226	0	12287
11636	12212	9	44	65	0	12330
11637	35	12153	16	74	0	12278
11638	46	37	13	12297	0	12393
11639	18	37	10	12227	0	12292
11640	23	14	12143	88	0	12268
11641	19	14	35	11790	0	11858
11642	17	11	43	12537	0	12608
11643	12776	8	19	99	0	12902
11644	63	13109	11	94	0	13277
11645	62	65	11	13356	0	13494
11646	41	65	11	13482	0	13599
11647	23	35	11	13471	0	13540
11648	26	18	13726	182	0	13952
11649	23	14	13221	121	0	13379
11650	18	13482	144	63	0	13707
11651	12	14041	103	40	0	14196
11652	10	152	52	14101	0	14315
11653	20	14478	34	116	0	14648
11654	16	186	20	15664	0	15886
11655	18	108	13	16906	0	17045
11656	12	30	14	17603	0	17659
11657	16	14	14	19651	0	19695
11658	32	16	19482	367	0	19897
11659	11	12	153	19541	0	19717
11660	14	29	206	19306	0	19555
11661	9	12	50	19905	0	19976
11662	19462	9	25	442	0	19938
11663	151	19959	31	331	0	20472
11664	213	187	17	19095	0	19512
11665	52	20371	19	210	0	20652
11666	19679	208	15	240	0	20142
11667	18461	259	29	111	0	18860
11668	327	20244	16	91	0	20678
11669	244	20728	10	59	0	21041
11670	97	384	20270	54	0	20805
11671	32	20925	166	61	0	21184
11672	81	256	219	20364	0	20920
11673	20439	295	55	204	0	20993
11674	166	21028	26	288	0	21508
11675	203	193	34	20993	0	21423
11676	47	244	25	20972	0	21288
11677	27	82	20	21723	0	21852
11678	21264	33	22	477	0	21796
11679	197	49	21393	337	0	21976
11680	20450	32	180	153	0	20815
11681	238	21105	229	116	0	21688
11682	240	210	55	21315	0	21820
11683	92	241	21123	239	0	21695
11684	19728	126	219	281	0	20354
11685	214	21269	234	98	0	21815
11686	250	218	61	20772	0	21301
11687	77	21388	32	237	0	21734
11688	41	274	35	21138	0	21488
11689	34	261	35	21514	0	21844
11690	59	102	21127	482	0	21770
11691	39	68	19792	349	0	20248
11692	36	58	397	20010	0	20501
11693	60	56	20648	276	0	21040
11694	37	52	240	20223	0	20552
11695	36	50	267	19966	0	20319
11696	29	43	85	20741	0	20898
11697	20254	42	45	541	0	20882
11698	224	40	53	20778	0	21095
11699	278	47	20735	341	0	21401
11700	20067	53	216	352	0	20688
11701	228	50	253	20459	0	20990
11702	272	52	91	20772	0	21187
11703	20532	60	51	506	0	21149
11704	214	21408	83	499	0	22204
11705	285	235	59	21579	0	22158
11706	97	299	38	21140	0	21574
11707	20869	109	44	559	0	21581
11708	235	87	20973	405	0	21700
11709	291	80	204	20489	0	21064
11710	92	92	280	20574	0	21038
11711	73	63	100	20337	0	20573
11712	76	20476	75	569	0	21196
11713	65	261	71	20799	0	21196
11714	20283	291	78	378	0	21030
11715	225	20361	65	423	0	21074
11716	19504	261	63	218	0	20046
11717	270	19867	62	204	0	20403
11718	19741	297	71	165	0	20274
11719	319	304	19405	173	0	20201
11720	325	146	19241	169	0	19881
11721	19117	113	425	182	0	19837
11722	297	75	19839	192	0	20403
11723	312	92	291	19343	0	20038
11724	160	80	311	18872	0	19423
11725	111	147	152	19724	0	20134
11726	19381	76	96	598	0	20151
11727	273	87	19120	428	0	19908
11728	18974	74	257	247	0	19552
11729	324	81	266	19962	0	20633
11730	19908	91	103	399	0	20501
11731	355	94	80	20125	0	20654
11732	20668	101	84	397	0	21250
11733	364	101	101	22024	0	22590
11734	345	104	23066	469	0	23984
11735	23624	95	311	426	0	24456
11736	24114	93	338	226	0	24771
11737	666	103	127	24098	0	24994
11738	430	127	99	23571	0	24227
11739	162	24477	118	706	0	25463
11740	23664	324	117	474	0	24579
11741	371	24197	101	256	0	24925
11742	23445	337	123	219	0	24124
11743	390	306	23100	188	0	23984
11744	381	110	23125	188	0	23804
11745	176	76	22942	190	0	23384
11746	21708	59	589	170	0	22526
11747	372	22791	409	154	0	23726
11748	347	269	139	22253	0	23008
11749	22072	308	76	360	0	22816
11750	332	22598	90	470	0	23490
11751	364	593	90	21410	0	22457
11752	123	21895	98	418	0	22534
11753	141	21052	104	381	0	21678
11754	104	20467	88	179	0	20838
11755	18207	475	157	119	0	18958
11756	233	18457	55	136	0	18881
11757	174	16161	51	79	0	16465
11758	69	16250	48	101	0	16468
11759	15900	262	58	73	0	16293
11760	15835	151	39	57	0	16082
11761	344	45	15637	51	0	16077
11762	15124	44	185	69	0	15422
11763	15398	32	143	59	0	15632
11764	291	64	52	15333	0	15740
11765	15643	28	48	204	0	15923
11766	229	52	15356	159	0	15796
11767	188	15872	160	63	0	16283
11768	15894	185	148	49	0	16276
11769	202	150	43	16157	0	16552
11770	16346	46	30	202	0	16624
11771	228	55	15587	182	0	16052
11772	15475	50	163	48	0	15736
11773	220	48	141	15702	0	16111
11774	188	40	15598	197	0	16023
11775	58	15174	167	179	0	15578
11776	123	15512	163	50	0	15848
11777	47	314	31	14928	0	15320
11778	50	188	20	14771	0	15029
11779	45	15169	19	265	0	15498
11780	15044	166	23	133	0	15366
11781	14630	159	24	33	0	14846
11782	14706	34	26	36	0	14802
11783	309	15190	31	46	0	15576
11784	191	174	28	14446	0	14839
11785	60	15231	30	151	0	15472
11786	15174	178	24	137	0	15513
11787	14843	155	28	37	0	15063
11788	308	14806	30	42	0	15186
11789	15050	183	16	48	0	15297
11790	223	163	28	14789	0	15203
11791	204	52	29	14858	0	15143
11792	14903	48	57	298	0	15306
11793	14210	48	54	154	0	14466
11794	14650	52	50	51	0	14803
11795	338	58	44	14390	0	14830
11796	209	64	41	14669	0	14983
11797	87	74	14560	313	0	15034
11798	91	92	176	14268	0	14627
11799	106	83	159	14114	0	14462
11800	101	79	14024	326	0	14530
11801	103	93	13802	177	0	14175
11802	101	72	14132	65	0	14370
11803	107	86	323	13829	0	14345
11804	121	94	13271	190	0	13676
11805	101	106	194	13030	0	13431
11806	112	116	148	13294	0	13670
11807	115	103	13163	325	0	13706
11808	111	111	13113	188	0	13523
11809	126	113	287	12806	0	13332
11810	99	126	13586	214	0	14025
11811	126	113	13436	193	0	13868
11812	122	13607	291	80	0	14100
11813	13610	236	171	68	0	14085
11814	13527	218	53	55	0	13853
11815	13742	102	43	80	0	13967
11816	393	13542	46	117	0	14098
11817	239	13634	53	96	0	14022
11818	152	341	71	13357	0	13921
11819	163	197	73	13319	0	13752
11820	132	64	13304	358	0	13858
11821	141	75	208	13260	0	13684
11822	13126	63	194	247	0	13630
11823	278	61	87	12377	0	12803
11824	252	12977	84	239	0	13552
11825	13036	216	88	212	0	13552
11826	12768	200	65	118	0	13151
11827	13129	85	74	113	0	13401
11828	401	58	12880	101	0	13440
11829	234	115	195	12604	0	13148
11830	13821	58	251	242	0	14372
11831	310	56	13904	226	0	14496
11832	220	13342	244	127	0	13933
11833	78	12056	177	94	0	12405
11834	10010	292	65	36	0	10403
11835	165	9829	39	32	0	10065
11836	152	149	134	9370	0	9805
11837	54	106	9593	165	0	9918
11838	32	82	149	9534	0	9797
11839	9370	31	115	168	0	9684
11840	151	9346	29	159	0	9685
11841	9346	130	26	46	0	9548
11842	151	112	9291	45	0	9599
11843	117	66	147	8926	0	9256
11844	30	9495	131	138	0	9794
11845	27	136	39	9720	0	9922
11846	9700	109	29	165	0	10003
11847	9606	18	28	142	0	9794
11848	9598	17	37	46	0	9698
11849	9760	22	41	40	0	9863
11850	231	27	41	9264	0	9563
11851	128	23	9302	155	0	9608
11852	49	16	144	9064	0	9273
11853	28	9227	128	179	0	9562
11854	9327	137	59	112	0	9635
11855	154	115	9276	46	0	9591
11856	8867	20	127	39	0	9053
11857	148	18	117	8843	0	9126
11858	115	36	9410	133	0	9694
11859	34	33	128	9359	0	9554
11860	9447	22	114	166	0	9749
11861	9296	17	42	139	0	9494
11862	9444	23	48	49	0	9564
11863	238	21	9455	53	0	9767
11864	135	28	131	9265	0	9559
11865	43	21	9558	152	0	9774
11866	30	9450	127	122	0	9729
11867	8936	125	98	41	0	9200
11868	135	8748	31	38	0	8952
11869	8044	109	79	20	0	8252
11870	110	70	16	7737	0	7933
11871	81	8270	25	93	0	8469
11872	8360	94	21	91	0	8566
11873	112	69	8642	28	0	8851
11874	64	29	95	8158	0	8346
11875	8342	22	64	109	0	8537
11876	114	20	8318	80	0	8532
11877	92	19	92	7836	0	8039
11878	46	7936	78	99	0	8159
11879	26	99	29	8081	0	8235
11880	34	80	19	8112	0	8245
11881	8039	25	17	164	0	8245
11882	124	8201	14	93	0	8432
11883	89	108	20	7960	0	8177
11884	43	8195	34	111	0	8383
11885	31	117	28	8299	0	8475
11886	38	8491	19	117	0	8665
11887	8520	129	30	84	0	8763
11888	152	88	8816	37	0	9093
11889	108	32	121	8636	0	8897
11890	54	18	88	8608	0	8768
11891	42	67	28	8666	0	8803
11892	41	28	27	8754	0	8850
11893	59	20	8614	227	0	8920
11894	46	8788	112	104	0	9050
11895	8787	112	78	38	0	9015
11896	8722	84	35	39	0	8880
11897	183	8800	29	54	0	9066
11898	8932	111	36	40	0	9119
11899	8661	90	33	53	0	8837
11900	174	9171	19	47	0	9411
11901	137	116	18	8777	0	9048
11902	59	9202	28	106	0	9395
11903	9163	118	19	91	0	9391
11904	139	88	9080	41	0	9348
11905	8639	29	129	55	0	8852
11906	139	18	9398	60	0	9615
11907	110	34	116	9272	0	9532
11908	9397	24	79	132	0	9632
11909	152	27	9263	101	0	9543
11910	8628	23	117	46	0	8814
11911	8880	26	96	64	0	9066
11912	190	28	40	8975	0	9233
11913	101	9193	28	133	0	9455
11914	9295	121	28	96	0	9540
11915	148	99	25	9185	0	9457
11916	132	9256	15	140	0	9543
11917	9484	113	32	105	0	9734
11918	128	107	27	9573	0	9835
11919	109	9954	30	138	0	10231
11920	36	130	32	10140	0	10338
11921	10250	87	30	145	0	10512
11922	10240	36	24	114	0	10414
11923	10465	33	35	55	0	10588
11924	186	27	34	10318	0	10565
11925	115	47	33	10504	0	10699
11926	53	37	10832	217	0	11139
11927	43	33	119	10910	0	11105
11928	80	38	11535	145	0	11798
11929	51	31	10767	87	0	10936
11930	14	15	10046	27	0	10102
11931	22	10531	86	36	0	10675
11932	30	82	56	10074	0	10242
11933	7	11265	12	51	0	11335
11934	11516	63	9	55	0	11643
11935	11252	68	15	27	0	11362
11936	130	42	5	11714	0	11891
11937	75	7	12223	82	0	12387
11938	17	15	87	12191	0	12310
11939	21	12	13167	98	0	13298
11940	16	10	91	12804	0	12921
11941	14	13084	78	92	0	13268
11942	10	13449	10	87	0	13556
11943	13293	161	7	27	0	13488
11944	105	84	13433	16	0	13638
11945	85	17	93	13078	0	13273
11946	30	9	85	13337	0	13461
11947	13592	12	18	179	0	13801
11948	94	13741	18	126	0	13979
11949	13772	92	19	35	0	13918
11950	101	14073	17	71	0	14262
11951	14008	94	13	30	0	14145
11952	14262	98	11	20	0	14391
11953	185	24	13	14605	0	14827
11954	109	18	14755	112	0	14994
11955	14269	22	98	113	0	14502
11956	111	14813	99	50	0	15073
11957	14937	111	31	35	0	15114
11958	121	105	24	14332	0	14582
11959	108	35	25	14257	0	14425
11960	29	14880	14	194	0	15117
11961	34	117	19	14777	0	14947
11962	35	15276	18	126	0	15455
11963	42	113	27	15172	0	15354
11964	51	104	25	15095	0	15275
11965	14770	21	35	213	0	15039
11966	124	29	14953	123	0	15229
11967	115	14961	107	48	0	15231
11968	45	112	102	15187	0	15446
11969	15411	108	24	126	0	15669
11970	15355	42	38	126	0	15561
11971	15323	30	34	50	0	15437
11972	220	40	15269	66	0	15595
11973	14898	30	130	47	0	15105
11974	145	34	103	15148	0	15430
11975	15089	35	37	147	0	15308
11976	142	14986	34	137	0	15299
11977	131	136	25	15150	0	15442
11978	15171	117	47	145	0	15480
11979	144	15460	42	142	0	15788
11980	142	134	31	15552	0	15859
11981	86	132	16004	155	0	16377
11982	15400	49	151	156	0	15756
11983	16457	45	128	76	0	16706
11984	293	58	16688	56	0	17095
11985	176	16215	151	73	0	16615
11986	79	16856	137	56	0	17128
11987	73	270	152	16652	0	17147
11988	64	172	38	16136	0	16410
11989	62	66	23	16722	0	16873
11990	73	49	16953	302	0	17377
11991	16509	41	173	188	0	16911
11992	17770	53	140	84	0	18047
11993	18209	54	37	79	0	18379
11994	18213	42	34	68	0	18357
11995	18585	56	48	75	0	18764
11996	18630	49	49	78	0	18806
11997	369	42	50	19640	0	20101
11998	232	63	19378	237	0	19910
11999	124	58	19464	202	0	19848
12000	100	45	331	19623	0	20099
12001	76	64	204	19260	0	19604
12002	99	59	58	19194	0	19410
12003	93	19640	42	391	0	20166
12004	19873	231	29	234	0	20367
12005	269	20255	39	120	0	20683
12006	220	238	34	19977	0	20469
12007	19647	214	50	277	0	20188
12008	267	19787	56	251	0	20361
12009	242	243	57	19913	0	20455
12010	111	208	50	19946	0	20315
12011	115	71	40	19991	0	20217
12012	119	19806	38	435	0	20398
12013	125	257	37	20170	0	20589
12014	99	212	20025	321	0	20657
12015	111	81	226	20209	0	20627
12016	115	66	193	20072	0	20446
12017	119	63	71	21177	0	21430
12018	117	75	40	21665	0	21897
12019	119	66	21289	544	0	22018
12020	119	21431	265	351	0	22166
12021	133	288	226	20848	0	21495
12022	135	257	74	21273	0	21739
12023	123	99	76	20798	0	21096
12024	125	20894	58	530	0	21607
12025	119	21542	56	369	0	22086
12026	21071	467	67	141	0	21746
12027	316	297	44	20719	0	21376
12028	274	84	20257	369	0	20984
12029	110	20159	252	311	0	20832
12030	19565	285	251	170	0	20271
12031	314	222	19113	137	0	19786
12032	242	97	18781	115	0	19235
12033	114	60	18618	112	0	18904
12034	75	189	434	17945	0	18643
12035	91	54	18336	301	0	18782
12036	63	17771	275	287	0	18396
12037	76	285	196	16784	0	17341
12038	86	185	16952	272	0	17495
12039	57	82	237	16403	0	16779
12040	16233	47	203	303	0	16786
12041	255	57	16293	240	0	16845
12042	15667	52	247	135	0	16101
12043	254	16146	190	131	0	16721
12044	16127	226	70	125	0	16548
12045	279	204	65	15894	0	16442
12046	15959	99	56	299	0	16413
12047	15705	63	71	244	0	16083
12048	15665	67	70	141	0	15943
12049	407	15765	66	141	0	16379
12050	15663	241	83	115	0	16102
12051	15515	170	90	114	0	15889
12052	421	92	15135	111	0	15759
12053	246	14951	245	135	0	15577
12054	137	364	219	14580	0	15300
12055	110	212	74	14706	0	15102
12056	106	92	81	14994	0	15273
12057	94	83	14661	453	0	15291
12058	102	68	243	14723	0	15136
12059	104	70	14676	350	0	15200
12060	14156	68	296	279	0	14799
12061	14464	76	228	156	0	14924
12062	400	80	14120	160	0	14760
12063	14072	73	272	138	0	14555
12064	14122	86	208	171	0	14587
12065	14337	69	119	145	0	14670
12066	448	70	109	14079	0	14706
12067	268	81	14047	332	0	14728
12068	129	13920	250	284	0	14583
12069	122	236	207	13716	0	14281
12070	121	197	13992	312	0	14622
12071	114	125	13733	256	0	14228
12072	13020	92	394	159	0	13665
12073	256	13612	234	162	0	14264
12074	13579	234	112	179	0	14104
12075	13546	192	104	152	0	13994
12076	361	13671	91	174	0	14297
12077	13637	237	99	196	0	14169
12078	300	199	14102	121	0	14722
12079	254	75	14127	139	0	14595
12080	143	69	14288	133	0	14633
12081	125	13315	389	125	0	13954
12082	12322	198	289	83	0	12892
12083	12260	151	110	82	0	12603
12084	305	11911	108	90	0	12414
12085	205	12391	100	126	0	12822
12086	114	261	91	12011	0	12477
12087	103	280	96	12007	0	12486
12088	12070	93	92	318	0	12573
12089	224	12504	111	189	0	13028
12090	12122	204	97	114	0	12537
12091	11633	141	80	111	0	11965
12092	285	92	11308	103	0	11788
12093	212	10997	162	85	0	11456
12094	144	208	149	10868	0	11369
12095	10414	139	75	148	0	10776
12096	223	68	75	10217	0	10583
12097	9429	39	72	171	0	9711
12098	186	34	9316	111	0	9647
12099	141	9223	170	63	0	9597
12100	97	9296	118	33	0	9544
12101	107	211	74	8742	0	9134
12102	89	9471	92	101	0	9753
12103	9361	174	138	98	0	9771
12104	144	89	9270	57	0	9560
12105	8920	64	130	51	0	9165
12106	138	66	9329	62	0	9595
12107	123	35	107	9156	0	9421
12108	74	47	107	9213	0	9441
12109	86	44	51	9291	0	9472
12110	9300	36	62	148	0	9546
12111	157	39	9500	90	0	9786
12112	131	40	105	9213	0	9489
12113	72	50	81	9181	0	9384
12114	84	9192	42	142	0	9460
12115	66	9078	35	108	0	9287
12116	79	9385	29	60	0	9553
12117	48	101	28	8383	0	8560
12118	36	35	25	7977	0	8073
12119	16	7570	14	65	0	7665
12120	21	7546	9	31	0	7607
12121	7817	53	13	17	0	7900
12122	40	29	8	7787	0	7864
12123	30	7766	15	33	0	7844
12124	7809	27	41	29	0	7906
12125	34	20	15	8001	0	8070
12126	9362	14	11	40	0	9427
12127	55	4	13	9717	0	9789
12128	52	6	10382	63	0	10503
12129	21	10398	49	59	0	10527
12130	10342	53	42	24	0	10461
12131	64	40	11107	8	0	11219
12132	40	11052	45	17	0	11154
12133	13	46	36	11196	0	11291
12134	1	41	11	11217	0	11270
12135	3	16	9	10984	0	11012
12136	4	4	3	11113	0	11124
12137	6	5	11178	98	0	11287
12138	4	11181	45	57	0	11287
12139	0	46	39	11317	0	11402
12140	11027	46	11	47	0	11131
12141	35	11296	1	58	0	11390
12142	36	44	4	12237	0	12321
12143	33	40	12487	74	0	12634
12144	2	12687	58	80	0	12827
12145	22	75	79	11744	0	11920
12146	3	13083	18	59	0	13163
12147	13095	94	3	61	0	13253
12148	12910	79	4	21	0	13014
12149	171	24	13046	8	0	13249
12150	12827	6	84	13	0	12930
12151	13185	9	83	10	0	13287
12152	161	4	13299	15	0	13479
12153	96	13629	88	15	0	13828
12154	28	91	85	13542	0	13746
12155	3	78	20	13885	0	13986
12156	13829	21	5	173	0	14028
12157	89	6	4	14073	0	14172
12158	89	8	13990	115	0	14202
12159	13126	6	96	92	0	13320
12160	115	7	14290	30	0	14442
12161	88	14183	107	30	0	14408
12162	13902	94	138	16	0	14150
12163	105	93	14201	10	0	14409
12164	98	28	13857	71	0	14054
12165	31	14120	167	29	0	14347
12166	10	96	99	14236	0	14441
12167	23	88	14214	102	0	14427
12168	15	29	110	13423	0	13577
12169	11	13	91	14053	0	14168
12170	15	9	13864	195	0	14083
12171	6	14039	99	129	0	14273
12172	10	100	92	14085	0	14287
12173	13997	87	27	124	0	14235
12174	13846	33	17	111	0	14007
12175	166	23	13	14060	0	14262
12176	127	19	14098	115	0	14359
12177	42	14	14698	96	0	14850
12178	24	15	180	14382	0	14601
12179	32	21	14409	113	0	14575
12180	13781	15	139	103	0	14038
12181	116	23	99	14352	0	14590
12182	106	18	33	14618	0	14775
12183	36	14625	23	193	0	14877
12184	21	118	18	14843	0	15000
12185	34	96	14371	139	0	14640
12186	13566	35	124	123	0	13848
12187	14260	16	100	48	0	14424
12188	210	17	14388	31	0	14646
12189	120	14	118	15158	0	15410
12190	53	18	104	15460	0	15635
12191	39	19	15678	280	0	16016
12192	23	50	168	15528	0	15769
12193	33	27	154	15734	0	15948
12194	22	16258	50	276	0	16606
12195	31	169	30	16891	0	17121
12196	30	140	31	17235	0	17436
12197	17516	43	36	331	0	17926
12198	17918	24	39	192	0	18173
12199	18273	24	29	74	0	18400
12200	18124	22	27	50	0	18223
12201	18116	19	31	63	0	18229
12202	386	26	17652	46	0	18110
12203	206	18	205	17422	0	17851
12204	67	17	177	17783	0	18044
12205	43	23	17770	366	0	18202
12206	16964	19	213	219	0	17415
12207	17602	15	189	72	0	17878
12208	377	25	17330	50	0	17782
12209	17319	18	204	43	0	17584
12210	17580	17	177	53	0	17827
12211	372	23	17723	40	0	18158
12212	213	22	208	16975	0	17418
12213	69	17862	188	232	0	18351
12214	42	197	56	18210	0	18505
12215	54	154	35	18194	0	18437
12216	48	39	37	18170	0	18294
12217	57	22	17834	380	0	18293
12218	16937	20	213	227	0	17397
12219	17878	13	185	72	0	18148
12220	360	13	58	17855	0	18286
12221	216	14	17635	243	0	18108
12222	60	64	222	17465	0	17811
12223	45	17	18175	263	0	18500
12224	70	20	18669	209	0	18968
12225	36	18600	380	93	0	19109
12226	42	169	166	16816	0	17193
12227	16589	140	69	215	0	17013
12228	15907	34	35	172	0	16148
12229	16271	11	28	62	0	16372
12230	359	14	26	16068	0	16467
12231	190	17054	22	208	0	17474
12232	64	216	29	17350	0	17659
12233	51	153	17631	258	0	18093
12234	18103	28	241	200	0	18572
12235	19769	12	192	65	0	20038
12236	442	16	56	20052	0	20566
12237	252	16	35	20140	0	20443
12238	68	8	35	20494	0	20605
12239	63	11	19942	494	0	20510
12240	17220	33	321	323	0	17897
12241	289	19910	225	112	0	20536
12242	186	19468	42	72	0	19768
12243	74	372	19284	49	0	19779
12244	49	242	273	18691	0	19255
12245	45	27	19189	276	0	19537
12246	17824	21	253	191	0	18289
12247	250	16	170	18562	0	18998
12248	198	12	18643	254	0	19107
12249	59	19310	224	233	0	19826
12250	19297	214	186	58	0	19755
12251	272	159	19831	50	0	20312
12252	198	19510	241	58	0	20007
12253	60	19674	174	72	0	19980
12254	19401	369	57	51	0	19878
12255	252	181	37	19384	0	19854
12256	212	32	19991	267	0	20502
12257	59	19927	263	216	0	20465
12258	19859	246	197	62	0	20364
12259	20140	183	41	72	0	20436
12260	424	19893	51	67	0	20435
12261	241	248	20503	49	0	21041
12262	83	192	260	20372	0	20907
12263	20147	44	218	274	0	20683
12264	20228	40	63	228	0	20559
12265	455	22	20247	91	0	20815
12266	236	29	286	19633	0	20184
12267	89	38	209	20352	0	20688
12268	95	30	20175	423	0	20723
12269	78	42	19924	251	0	20295
12270	19853	38	440	82	0	20413
12271	20266	34	240	62	0	20602
12272	20400	43	85	73	0	20601
12273	20495	28	73	77	0	20673
12274	483	55	20057	66	0	20661
12275	19984	49	270	95	0	20398
12276	326	34	228	19861	0	20449
12277	257	41	20234	307	0	20839
12278	113	46	20067	235	0	20461
12279	86	19900	430	147	0	20563
12280	78	266	247	19728	0	20319
12281	92	204	20081	308	0	20685
12282	19335	79	293	229	0	19936
12283	318	69	241	18095	0	18723
12284	235	20183	100	236	0	20754
12285	20234	269	75	225	0	20803
12286	20177	202	101	97	0	20577
12287	502	53	20485	101	0	21141
12288	283	20449	298	101	0	21131
12289	101	263	218	19135	0	19717
12290	18985	188	89	251	0	19513
12291	296	72	67	18971	0	19406
12292	228	87	18762	257	0	19334
12293	16945	74	258	192	0	17469
12294	248	18245	213	92	0	18798
12295	186	17371	123	88	0	17768
12296	137	18254	107	75	0	18573
12297	17624	321	287	71	0	18303
12298	17045	188	113	85	0	17431
12299	17313	62	93	62	0	17530
12300	359	58	60	17110	0	17587
12301	208	57	17244	211	0	17720
12302	96	52	233	17119	0	17500
12303	17270	59	175	229	0	17733
12304	254	57	90	17587	0	17988
12305	18027	47	89	208	0	18371
12306	17884	71	73	166	0	18194
12307	17846	73	84	88	0	18091
12308	333	18020	85	96	0	18534
12309	18148	194	100	96	0	18538
12310	270	151	18020	59	0	18500
12311	239	75	18388	65	0	18767
12312	124	18523	332	67	0	19046
12313	203	194	189	17726	0	18312
12314	17844	170	135	196	0	18345
12315	267	61	17753	160	0	18241
12316	17063	52	219	67	0	17401
12317	278	55	183	17297	0	17813
12318	225	18392	101	196	0	18914
12319	121	197	90	18776	0	19184
12320	85	164	18767	233	0	19249
12321	17621	64	241	193	0	18119
12322	253	59	19174	92	0	19578
12323	231	45	18333	65	0	18674
12324	17221	41	280	68	0	17610
12325	249	17604	172	65	0	18090
12326	18178	169	80	53	0	18480
12327	18110	140	70	60	0	18380
12328	360	46	17965	53	0	18424
12329	17476	41	228	70	0	17815
12330	244	53	17762	77	0	18136
12331	177	39	16618	86	0	16920
12332	156	36	17271	82	0	17545
12333	91	16605	225	106	0	17027
12334	15155	148	602	77	0	15982
12335	14485	76	155	109	0	14825
12336	14368	31	26	27	0	14452
12337	14658	15	29	39	0	14741
12338	168	14	15084	20	0	15286
12339	101	26	89	14694	0	14910
12340	73	25	75	14813	0	14986
12341	14771	26	39	121	0	14957
12342	99	14896	31	90	0	15116
12343	94	78	33	14874	0	15079
12344	14882	64	41	92	0	15079
12345	111	23	15306	71	0	15511
12346	99	19	82	15057	0	15257
12347	63	113	15814	108	0	16098
12348	46	15681	95	94	0	15916
12349	69	184	64	14793	0	15110
12350	14567	70	31	64	0	14732
12351	82	26	19	14596	0	14723
12352	76	25	14644	68	0	14813
12353	38	14864	69	79	0	15050
12354	14899	52	58	34	0	15043
12355	71	89	15054	25	0	15239
12356	13922	18	56	31	0	14027
12357	69	14577	58	24	0	14728
12358	14557	46	21	19	0	14643
12359	14305	50	17	21	0	14393
12360	97	23	14	14511	0	14645
12361	71	10	14601	74	0	14756
12362	37	14863	56	67	0	15023
12363	30	51	65	15214	0	15360
12364	35	62	24	15177	0	15298
12365	26	15	21	16136	0	16198
12366	19	17	28	17267	0	17331
12367	30	19501	16	209	0	19756
12368	20827	136	21	127	0	21111
12369	186	21020	17	47	0	21270
12370	179	195	20	22033	0	22427
12371	22467	157	23	207	0	22854
12372	234	24	15	22619	0	22892
12373	219	15	22697	253	0	23184
12374	53	22733	220	252	0	23258
12375	38	232	211	22249	0	22730
12376	28	202	46	22962	0	23238
12377	22357	38	20	398	0	22813
12378	249	16	22217	223	0	22705
12379	21684	19	224	52	0	21979
12380	21871	18	217	31	0	22137
12381	22104	24	31	31	0	22190
12382	451	20	22403	39	0	22913
12383	241	30	227	21863	0	22361
12384	66	22	205	22110	0	22403
12385	46	24	22219	428	0	22717
12386	56	41	22201	235	0	22533
12387	21977	30	407	63	0	22477
12388	248	29	240	22501	0	23018
12389	22936	30	49	268	0	23283
12390	23083	40	44	246	0	23413
12391	470	31	82	23073	0	23656
12392	307	39	24755	277	0	25378
12393	22767	41	313	316	0	23437
12394	314	39	258	24967	0	25578
12395	321	40	24801	352	0	25514
12396	97	24408	304	324	0	25133
12397	24228	289	278	93	0	24888
12398	325	24665	79	103	0	25172
12399	365	358	51	22409	0	23183
12400	142	24876	42	298	0	25358
12401	24207	353	60	297	0	24917
12402	24401	306	72	125	0	24904
12403	607	24492	61	149	0	25309
12404	24235	295	69	133	0	24732
12405	23948	289	87	110	0	24434
12406	584	23744	87	137	0	24552
12407	24003	317	59	125	0	24504
12408	427	276	65	23296	0	24064
12409	392	70	73	23551	0	24086
12410	23546	42	105	584	0	24277
12411	448	45	89	21953	0	22535
12412	398	22600	73	379	0	23450
12413	22549	291	99	314	0	23253
12414	22361	297	108	139	0	22905
12415	602	22577	111	296	0	23586
12416	22818	339	97	131	0	23385
12417	22684	294	100	123	0	23201
12418	665	77	102	22019	0	22863
12419	441	75	21792	382	0	22690
12420	212	21733	334	384	0	22663
12421	21922	344	293	148	0	22707
12422	21863	321	90	143	0	22417
12423	742	118	21482	131	0	22473
12424	21691	119	347	137	0	22294
12425	536	105	21437	149	0	22227
12426	21231	129	344	145	0	21849
12427	471	113	334	21199	0	22117
12428	474	134	21152	414	0	22174
12429	248	162	21395	408	0	22213
12430	243	129	584	20933	0	21889
12431	224	179	327	20969	0	21699
12432	248	139	20207	684	0	21278
12433	247	146	357	20279	0	21029
12434	303	158	20388	415	0	21264
12435	306	157	384	19976	0	20823
12436	322	154	331	19296	0	20103
12437	316	19371	132	623	0	20442
12438	333	19096	103	438	0	19970
12439	303	19675	136	240	0	20354
12440	310	642	138	19144	0	20234
12441	342	375	117	19517	0	20351
12442	291	137	19049	699	0	20176
12443	18223	134	419	474	0	19250
12444	19162	144	368	204	0	19878
12445	783	18502	161	216	0	19662
12446	18803	348	139	176	0	19466
12447	652	355	153	17905	0	19065
12448	18319	158	161	451	0	19089
12449	18386	110	167	411	0	19074
12450	848	103	158	17896	0	19005
12451	17741	146	181	510	0	18578
12452	529	17405	231	438	0	18603
12453	482	17553	155	256	0	18446
12454	333	653	180	16539	0	17705
12455	308	17592	160	424	0	18484
12456	289	464	153	16982	0	17888
12457	306	432	154	17440	0	18332
12458	17174	193	128	672	0	18167
12459	577	16983	127	508	0	18195
12460	16918	438	151	213	0	17720
12461	16250	354	160	201	0	16965
12462	747	16130	167	211	0	17255
12463	16066	421	118	231	0	16836
12464	568	343	15713	223	0	16847
12465	412	14931	338	220	0	15901
12466	13718	316	248	209	0	14491
12467	424	224	11426	166	0	12240
12468	251	10000	190	151	0	10592
12469	164	10050	185	129	0	10528
12470	8418	271	251	90	0	9030
12471	8062	175	53	73	0	8363
12472	8150	80	44	72	0	8346
12473	283	7911	55	73	0	8322
12474	215	149	43	7853	0	8260
12475	7766	137	49	188	0	8140
12476	7770	63	68	152	0	8053
12477	305	60	44	7697	0	8106
12478	188	71	7729	169	0	8157
12479	115	67	7803	159	0	8144
12480	105	54	233	7687	0	8079
12481	112	46	154	7875	0	8187
12482	94	60	7467	260	0	7881
12483	97	47	163	7227	0	7534
12484	89	7313	152	182	0	7736
12485	7227	140	74	157	0	7598
12486	170	136	68	7244	0	7618
12487	6600	44	66	141	0	6851
12488	160	6864	49	152	0	7225
12489	123	6907	50	98	0	7178
12490	6812	184	46	74	0	7116
12491	140	106	6712	82	0	7040
12492	4752	57	151	36	0	4996
12493	63	4892	59	53	0	5067
12494	45	44	82	4465	0	4636
12495	4459	42	10	42	0	4553
12496	41	11	8	4426	0	4486
12497	4431	10	13	46	0	4500
12498	4368	7	10	53	0	4438
12499	64	4645	13	19	0	4741
12500	4280	24	12	16	0	4332
12501	29	4270	4	18	0	4321
12502	4277	31	11	12	0	4331
12503	90	28	5	4204	0	4327
12504	4391	12	6	26	0	4435
12505	36	11	2	4541	0	4590
12506	4762	10	5	22	0	4799
12507	4889	12	1	29	0	4931
12508	4876	10	4	11	0	4901
12509	4911	7	6	7	0	4931
12510	4861	7	3	11	0	4882
12511	51	6	5	4895	0	4957
12512	4808	9	7	24	0	4848
12513	31	4746	6	31	0	4814
12514	33	20	4711	55	0	4819
12515	16	23	23	4689	0	4751
12516	16	7	4807	31	0	4861
12517	8	6	25	5155	0	5194
12518	11	8	5353	85	0	5457
12519	5230	9	27	35	0	5301
12520	28	8	28	5352	0	5416
12521	40	6	5417	34	0	5497
12522	13	6	5740	36	0	5795
12523	9	10	51	5750	0	5820
12524	6384	9	70	29	0	6492
12525	32	6918	15	47	0	7012
12526	6979	40	6	14	0	7039
12527	6870	47	9	8	0	6934
12528	81	6926	5	16	0	7028
12529	7047	47	3	9	0	7106
12530	53	44	4	7084	0	7185
12531	58	13	5	7051	0	7127
12532	17	6	4	7203	0	7230
12533	7138	11	4	83	0	7236
12534	48	7291	1	66	0	7406
12535	51	49	4	7322	0	7426
12536	21	43	3	7496	0	7563
12537	7454	13	4	101	0	7572
12538	60	7	4	7510	0	7581
12539	54	8	8191	80	0	8333
12540	14	8863	52	60	0	8989
12541	9127	70	55	20	0	9272
12542	84	72	33	8653	0	8842
12543	84	9286	7	69	0	9446
12544	9330	79	11	69	0	9489
12545	101	75	9227	35	0	9438
12546	89	9264	71	12	0	9436
12547	9406	79	77	17	0	9579
12548	91	84	30	9231	0	9436
12549	88	31	9	9372	0	9500
12550	36	14	9383	144	0	9577
12551	24	9	74	9288	0	9395
12552	19	16	10361	104	0	10500
12553	28	9	10041	81	0	10159
12554	22	10	10537	46	0	10615
12555	10163	5	173	15	0	10356
12556	10004	14	107	23	0	10148
12557	10383	7	32	19	0	10441
12558	169	9	19	10070	0	10267
12559	115	10129	13	82	0	10339
12560	57	10278	6	94	0	10435
12561	10596	144	10	30	0	10780
12562	10628	106	5	20	0	10759
12563	152	10791	8	22	0	10973
12564	10628	83	15	21	0	10747
12565	109	81	10374	21	0	10585
12566	102	31	10304	20	0	10457
12567	39	18	146	9824	0	10027
12568	22	26	95	10474	0	10617
12569	35	10	10485	151	0	10681
12570	18	15	91	10348	0	10472
12571	10476	9	85	118	0	10688
12572	95	6	10504	87	0	10692
12573	10169	18	92	51	0	10330
12574	120	16	79	10389	0	10604
12575	99	9	10847	99	0	11054
12576	42	10787	95	90	0	11014
12577	10836	87	83	48	0	11054
12578	113	74	10745	27	0	10959
12579	10458	34	131	23	0	10646
12580	119	21	80	10580	0	10800
12581	10721	16	40	98	0	10875
12582	123	18	11013	86	0	11240
12583	102	18	99	11091	0	11310
12584	11341	14	79	106	0	11540
12585	11418	22	51	89	0	11580
12586	11816	21	27	46	0	11910
12587	12027	13	33	23	0	12096
12588	193	14	30	11495	0	11732
12589	124	22	23	11496	0	11665
12590	73	22	12003	169	0	12267
12591	47	20	118	11776	0	11961
12592	52	24	93	11823	0	11992
12593	35	12452	44	170	0	12701
12594	12647	116	33	116	0	12912
12595	13016	81	33	56	0	13186
12596	200	14005	39	58	0	14302
12597	142	142	34	13842	0	14160
12598	79	101	33	14137	0	14350
12599	13906	36	33	246	0	14221
12600	182	21	14367	149	0	14719
12601	135	21	153	14532	0	14841
12602	67	15	14758	176	0	15016
12603	14029	18	196	118	0	14361
12604	14405	14	114	70	0	14603
12605	14591	17	53	50	0	14711
12606	300	23	29	14064	0	14416
12607	175	18	27	14158	0	14378
12608	14223	12	32	265	0	14532
12609	193	32	14083	134	0	14442
12610	144	24	155	14105	0	14428
12611	14183	17	118	187	0	14505
12612	208	17	58	14212	0	14495
12613	163	21	15558	214	0	15956
12614	88	18	15369	149	0	15624
12615	14884	23	267	86	0	15260
12616	175	15628	147	71	0	16021
12617	15917	145	46	58	0	16166
12618	16029	100	34	52	0	16215
12619	281	32	34	16200	0	16547
12620	158	28	39	16193	0	16418
12621	95	16243	37	298	0	16673
12622	15872	141	40	142	0	16195
12623	183	16336	28	94	0	16641
12624	121	16313	39	119	0	16592
12625	108	200	27	15811	0	16146
12626	15840	96	32	172	0	16140
12627	16044	44	33	106	0	16227
12628	226	15	34	15962	0	16237
12629	155	15	29	15689	0	15888
12630	84	27	32	15839	0	15982
12631	15672	8	35	264	0	15979
12632	182	13	15746	158	0	16099
12633	132	15714	146	82	0	16074
12634	15694	119	94	59	0	15966
12635	184	72	50	15612	0	15918
12636	128	42	15576	159	0	15905
12637	92	23	16077	129	0	16321
12638	67	16057	187	92	0	16403
12639	66	16143	81	68	0	16358
12640	46	213	205	15283	0	15747
12641	43	15344	31	131	0	15549
12642	54	101	25	15490	0	15670
12643	43	47	24	15545	0	15659
12644	15864	20	24	153	0	16061
12645	124	18	26	15808	0	15976
12646	74	22	19	15904	0	16019
12647	61	23	15783	152	0	16019
12648	55	21	92	15873	0	16041
12649	16351	24	52	122	0	16549
12650	16219	27	36	80	0	16362
12651	155	17637	22	79	0	17893
12652	16965	104	17	63	0	17149
12653	156	63	17172	65	0	17456
12654	87	17707	113	68	0	17975
12655	52	129	74	17641	0	17896
12656	63	74	25	17806	0	17968
12657	57	40	28	18119	0	18244
12658	18082	26	28	195	0	18331
12659	17165	28	67	138	0	17398
12660	190	27	17914	83	0	18214
12661	129	36	18067	78	0	18310
12662	101	35	18958	65	0	19159
12663	58	18876	168	67	0	19169
12664	54	19393	77	78	0	19602
12665	19408	172	26	83	0	19689
12666	19636	89	33	78	0	19836
12667	190	47	35	19994	0	20266
12668	130	31	29	19912	0	20102
12669	44	20884	29	233	0	21190
12670	53	126	30	21229	0	21438
12671	77	78	21038	175	0	21368
12672	64	21271	127	174	0	21636
12673	59	131	83	21600	0	21873
12674	70	90	22780	161	0	23101
12675	72	59	119	21719	0	21969
12676	55	22433	91	167	0	22746
12677	22783	133	49	138	0	23103
12678	22366	117	44	71	0	22598
12679	23348	54	31	97	0	23530
12680	233	51	26	23263	0	23573
12681	135	56	39	24047	0	24277
12682	24264	42	46	275	0	24627
12683	178	24419	34	172	0	24803
12684	25586	180	43	96	0	25905
12685	221	142	26583	73	0	27019
12686	26351	47	191	86	0	26675
12687	27395	46	175	88	0	27704
12688	348	41	47	27728	0	28164
12689	28101	29	38	238	0	28406
12690	28252	46	39	225	0	28562
12691	365	40	41	28565	0	29011
12692	272	56	28626	219	0	29173
12693	26319	50	190	260	0	26819
12694	226	29	29115	83	0	29453
12695	226	29741	207	72	0	30246
12696	46	198	238	28844	0	29326
12697	33	212	59	29599	0	29903
12698	32233	47	33	382	0	32695
12699	243	27	33117	253	0	33640
12700	246	89	244	31722	0	32301
12701	68	32628	229	262	0	33187
12702	38	32800	47	289	0	33174
12703	39	473	34	32941	0	33487
12704	55	275	33010	282	0	33622
12705	38	75	244	32665	0	33022
12706	41	39	243	32686	0	33009
12707	68	38	32932	479	0	33517
12708	46	33258	239	311	0	33854
12709	32238	270	255	95	0	32858
12710	234	33762	56	100	0	34152
12711	259	307	39	33300	0	33905
12712	32507	283	44	260	0	33094
12713	253	32440	41	332	0	33066
12714	291	265	32369	86	0	33011
12715	31216	270	252	67	0	31805
12716	266	32733	264	136	0	33399
12717	32541	254	63	81	0	32939
12718	339	275	31833	72	0	32519
12719	31297	82	253	75	0	31707
12720	331	53	281	31379	0	32044
12721	310	44	32219	303	0	32876
12722	112	71	278	31270	0	31731
12723	79	31576	289	291	0	32235
12724	67	270	78	31538	0	31953
12725	88	296	51	31477	0	31912
12726	100	83	31287	542	0	32012
12727	99	60	277	31325	0	31761
12728	113	59	30938	361	0	31471
12729	73	31418	274	416	0	32181
12730	93	291	282	31407	0	32073
12731	104	299	31735	319	0	32457
12732	94	31729	299	367	0	32489
12733	92	32311	298	159	0	32860
12734	139	558	32090	119	0	32906
12735	134	340	32021	119	0	32614
12736	130	119	565	31317	0	32131
12737	31216	92	345	342	0	31995
12738	352	31313	122	422	0	32209
12739	365	342	66	30582	0	31355
12740	30503	314	85	349	0	31251
12741	370	30847	84	494	0	31795
12742	31004	315	88	167	0	31574
12743	394	31353	90	163	0	32000
12744	31109	356	81	155	0	31701
12745	30769	346	111	112	0	31338
12746	31291	121	125	136	0	31673
12747	665	33242	100	173	0	34180
12748	438	357	82	33250	0	34127
12749	224	368	32611	449	0	33652
12750	148	32785	405	455	0	33793
12751	153	386	386	31076	0	32001
12752	160	375	161	31554	0	32250
12753	159	149	31089	702	0	32099
12754	158	30282	387	464	0	31291
12755	29924	368	444	199	0	30935
12756	411	30173	133	191	0	30908
12757	390	412	118	29722	0	30642
12758	163	385	29699	449	0	30696
12759	28134	139	423	447	0	29143
12760	420	147	389	29675	0	30631
12761	387	131	29230	466	0	30214
12762	27158	148	462	419	0	28187
12763	408	28440	388	211	0	29447
12764	28265	431	168	175	0	29039
12765	28071	422	110	161	0	28764
12766	669	277	127	27987	0	29060
12767	431	147	28186	455	0	29219
12768	176	27929	393	523	0	29021
12769	139	465	27667	178	0	28449
12770	143	452	432	26576	0	27603
12771	122	232	392	27246	0	27992
12772	27001	162	170	706	0	28039
12773	403	132	26921	505	0	27961
12774	362	25788	423	206	0	26779
12775	166	452	364	24990	0	25972
12776	139	405	180	26094	0	26818
12777	25730	184	179	615	0	26708
12778	398	26001	84	484	0	26967
12779	414	405	97	25275	0	26191
12780	24592	397	107	413	0	25509
12781	340	24450	112	387	0	25289
12782	23914	352	95	139	0	24500
12783	23462	323	109	115	0	24009
12784	546	22697	124	156	0	23523
12785	20325	314	75	84	0	20798
12786	325	20566	82	114	0	21087
12787	20002	301	143	99	0	20545
12788	19756	243	94	116	0	20209
12789	456	19571	77	140	0	20244
12790	18429	282	174	98	0	18983
12791	18510	222	80	79	0	18891
12792	18647	105	63	109	0	18924
12793	437	88	18373	109	0	19007
12794	248	68	17215	102	0	17633
12795	100	78	17272	72	0	17522
12796	16815	140	411	65	0	17431
12797	248	72	16708	80	0	17108
12798	155	43	13718	47	0	13963
12799	52	129	232	12480	0	12893
12800	12777	31	133	151	0	13092
12801	164	40	13194	128	0	13526
12802	137	44	13834	61	0	14076
12803	61	48	245	13260	0	13614
12804	59	45	143	13330	0	13577
12805	55	44	51	13631	0	13781
12806	66	45	13431	265	0	13807
12807	66	48	149	13442	0	13705
12808	13379	55	118	196	0	13748
12809	186	13572	51	169	0	13978
12810	163	181	46	13294	0	13684
12811	89	152	28	13622	0	13891
12812	77	62	13816	276	0	14231
12813	62	13568	171	167	0	13968
12814	13558	183	123	66	0	13930
12815	185	13788	64	79	0	14116
12816	162	186	58	13590	0	13996
12817	80	151	13629	183	0	14043
12818	74	62	177	13870	0	14183
12819	87	37	160	14287	0	14571
12820	14713	57	82	305	0	15157
12821	225	41	69	14163	0	14498
12822	192	14222	52	239	0	14705
12823	82	15183	66	189	0	15520
12824	91	318	15481	64	0	15954
12825	15107	189	295	56	0	15647
12826	237	74	187	15227	0	15725
12827	198	44	74	14984	0	15300
12828	93	36	66	15503	0	15698
12829	15667	30	46	362	0	16105
12830	215	15871	46	231	0	16363
12831	15971	198	58	100	0	16327
12832	252	172	15147	62	0	15633
12833	187	65	15100	75	0	15427
12834	15207	27	333	51	0	15618
12835	205	50	208	14940	0	15403
12836	193	41	79	15259	0	15572
12837	78	34	72	15591	0	15775
12838	59	50	15372	383	0	15864
12839	15044	31	211	232	0	15518
12840	15257	34	198	94	0	15583
12841	14700	56	101	75	0	14932
12842	403	39	52	14538	0	15032
12843	247	44	14342	237	0	14870
12844	109	54	14098	211	0	14472
12845	122	45	14241	115	0	14523
12846	29	13491	428	87	0	14035
12847	192	132	140	11585	0	12049
12848	11407	122	47	150	0	11726
12849	153	32	11519	143	0	11847
12850	11576	21	140	93	0	11830
12851	154	27	125	11610	0	11916
12852	145	35	57	11461	0	11698
12853	63	11601	60	245	0	11969
12854	67	11620	45	169	0	11901
12855	35	11997	54	87	0	12173
12856	54	250	57	11864	0	12225
12857	11719	125	55	163	0	12062
12858	11759	47	52	156	0	12014
12859	244	36	11725	106	0	12111
12860	11593	11	150	84	0	11838
12861	170	26	11742	88	0	12026
12862	144	32	154	11482	0	11812
12863	87	28	11578	150	0	11843
12864	11431	24	157	165	0	11777
12865	160	44	143	11199	0	11546
12866	146	39	11985	157	0	12327
12867	73	26	11694	159	0	11952
12868	11261	22	234	82	0	11599
12869	11574	26	166	70	0	11836
12870	214	11653	64	89	0	12020
12871	169	118	49	11993	0	12329
12872	89	114	12035	155	0	12393
12873	80	46	12075	158	0	12359
12874	80	76	231	11873	0	12260
12875	11826	44	169	154	0	12193
12876	135	11871	72	191	0	12269
12877	172	120	47	12008	0	12347
12878	11996	157	42	164	0	12359
12879	150	53	34	11895	0	12132
12880	161	11986	49	199	0	12395
12881	105	115	60	12180	0	12460
12882	12094	137	42	168	0	12441
12883	174	55	57	12256	0	12542
12884	12300	42	131	175	0	12648
12885	161	12492	73	196	0	12922
12886	12521	124	84	84	0	12813
12887	186	118	12229	82	0	12615
12888	11908	43	169	85	0	12205
12889	12111	34	173	79	0	12397
12890	263	12325	88	89	0	12765
12891	181	178	70	11944	0	12373
12892	117	129	11942	131	0	12319
12893	109	60	11956	178	0	12303
12894	11460	68	216	108	0	11852
12895	11286	35	175	60	0	11556
12896	202	11413	85	101	0	11801
12897	164	11589	53	64	0	11870
12898	11453	192	40	64	0	11749
12899	133	11507	37	80	0	11757
12900	144	11789	54	57	0	12044
12901	85	159	81	11406	0	11731
12902	61	120	51	11025	0	11257
12903	62	37	11270	217	0	11586
12904	79	23	84	11248	0	11434
12905	11223	38	123	148	0	11532
12906	158	20	11217	150	0	11545
12907	152	28	11676	75	0	11931
12908	93	31	181	11313	0	11618
12909	83	31	137	11468	0	11719
12910	72	39	56	11702	0	11869
12911	85	23	11481	197	0	11786
12912	54	28	106	11049	0	11237
12913	49	36	126	11550	0	11761
12914	11321	36	71	169	0	11597
12915	97	11216	58	179	0	11550
12916	11157	73	59	63	0	11352
12917	120	99	11433	39	0	11691
12918	10452	35	58	34	0	10579
12919	83	10875	85	39	0	11082
12920	9623	34	26	23	0	9706
12921	40	9557	17	30	0	9644
12922	9251	109	38	18	0	9416
12923	38	9046	6	13	0	9103
12924	71	9017	8	10	0	9106
12925	21	110	17	8993	0	9141
12926	8995	36	1	28	0	9060
12927	8948	15	6	36	0	9005
12928	8994	16	10	17	0	9037
12929	65	5	8991	9	0	9070
12930	42	2	8987	2	0	9033
12931	17	5	45	9027	0	9094
12932	7	9156	36	31	0	9230
12933	8	9359	10	35	0	9412
12934	52	50	6	9078	0	9186
12935	9206	34	8	29	0	9277
12936	9219	13	5	36	0	9273
12937	9326	7	3	20	0	9356
12938	56	8	9479	9	0	9552
12939	37	5	21	9608	0	9671
12940	25	3	9781	31	0	9840
12941	9589	3	36	42	0	9670
12942	9780	6	39	17	0	9842
12943	63	6	9917	11	0	9997
12944	50	3	27	9933	0	10013
12945	10097	6	36	41	0	10180
12946	39	4	10	10191	0	10244
12947	47	9	5	10452	0	10513
12948	21	11	13	11299	0	11344
12949	11959	7	7	114	0	12087
12950	84	5	7	12832	0	12928
12951	13574	8	3	117	0	13702
12952	129	14977	3	90	0	15199
12953	92	144	9	15696	0	15941
12954	23	99	12	15727	0	15861
12955	19	23	7	15934	0	15983
12956	15882	9	9	238	0	16138
12957	152	9	5	15572	0	15738
12958	120	15	4	15501	0	15640
12959	15931	12	5	238	0	16186
12960	15801	10	15	129	0	15955
12961	16046	9	13	29	0	16097
12962	276	11	15696	16	0	15999
12963	155	42	15386	12	0	15595
12964	15847	7	232	22	0	16108
12965	150	10	125	15894	0	16179
12966	126	10	26	15277	0	15439
12967	16143	7	8	252	0	16410
12968	15714	17	12	131	0	15874
12969	15855	16	12	38	0	15921
12970	255	15930	8	34	0	16227
12971	15957	131	10	23	0	16121
12972	15376	113	8	27	0	15524
12973	241	15829	22	29	0	16121
12974	123	15852	12	36	0	16023
12975	80	210	11	16012	0	16313
12976	16238	101	6	161	0	16506
12977	16217	14	10	123	0	16364
12978	16201	12	8	43	0	16264
12979	263	8	9	16271	0	16551
12980	16363	10	11	174	0	16558
12981	188	53	16486	132	0	16859
12982	16115	18	139	45	0	16317
12983	195	10	16625	44	0	16874
12984	140	18	16055	41	0	16254
12985	34	21	222	15968	0	16245
12986	16058	9	131	183	0	16381
12987	160	10	21	16137	0	16328
12988	138	12	16501	196	0	16847
12989	68	11	16531	152	0	16762
12990	56	4	221	16521	0	16802
12991	16364	8	101	209	0	16682
12992	186	17267	30	139	0	17622
12993	152	139	20	17266	0	17577
12994	96	108	25	17693	0	17922
12995	69	18	17773	278	0	18138
12996	96	82	17728	155	0	18061
12997	99	11	233	18021	0	18364
12998	18275	13	128	214	0	18630
12999	234	17	18337	173	0	18761
13000	188	28	148	17958	0	18322
13001	115	24	108	17955	0	18202
13002	102	35	27	18169	0	18333
13003	17855	47	26	306	0	18234
13004	256	39	17384	191	0	17870
13005	190	18069	126	147	0	18532
13006	115	177	95	18186	0	18573
13007	131	132	18095	236	0	18594
13008	122	18064	164	224	0	18574
13009	144	18398	128	128	0	18798
13010	18290	248	44	115	0	18697
13011	266	18455	52	130	0	18903
13012	18557	168	50	131	0	18906
13013	290	128	18154	131	0	18703
13014	234	47	206	18224	0	18711
13015	18292	27	151	283	0	18753
13016	281	18532	73	275	0	19161
13017	266	158	18204	221	0	18849
13018	187	134	185	16766	0	17272
13019	188	18147	162	222	0	18719
13020	178	192	63	18558	0	18991
13021	18408	156	72	265	0	18901
13022	287	18658	74	256	0	19275
13023	18789	183	76	160	0	19208
13024	18780	157	72	145	0	19154
13025	442	64	19092	155	0	19753
13026	303	20004	237	149	0	20693
13027	209	269	169	20808	0	21455
13028	228	168	21934	338	0	22668
13029	249	49	23482	231	0	24011
13030	198	87	524	23909	0	24718
13031	24216	51	307	385	0	24959
13032	23136	70	199	299	0	23704
13033	666	55	96	24396	0	25213
13034	402	57	24580	434	0	25473
13035	189	24652	377	330	0	25548
13036	24700	352	267	163	0	25482
13037	24968	270	124	114	0	25476
13038	654	25033	85	212	0	25984
13039	25289	385	136	124	0	25934
13040	535	271	24766	100	0	25672
13041	24577	126	393	94	0	25190
13042	24301	111	302	116	0	24830
13043	628	80	24734	92	0	25534
13044	338	70	439	24255	0	25102
13045	206	43	24554	422	0	25225
13046	139	24004	443	327	0	24913
13047	123	23971	351	183	0	24628
13048	143	542	188	22394	0	23267
13049	109	230	22588	368	0	23295
13050	65	21078	310	265	0	21718
13051	40	20614	208	107	0	20969
13052	18490	390	102	55	0	19037
13053	18269	165	43	33	0	18510
13054	338	67	29	18504	0	18938
13055	186	32	42	18227	0	18487
13056	80	18734	38	342	0	19194
13057	18317	218	41	192	0	18768
13058	18687	138	34	84	0	18943
13059	368	18541	25	277	0	19211
13060	215	234	29	18769	0	19247
13061	104	153	18696	278	0	19231
13062	70	70	235	18652	0	19027
13063	18718	50	149	273	0	19190
13064	285	38	67	18847	0	19237
13065	197	44	48	19282	0	19571
13066	19236	50	47	362	0	19695
13067	291	31	47	18795	0	19164
13068	183	18963	58	253	0	19457
13069	106	234	54	19123	0	19517
13070	73	169	46	19203	0	19491
13071	60	81	63	18797	0	19001
13072	53	19164	49	391	0	19657
13073	41	275	50	18969	0	19335
13074	73	197	18812	293	0	19375
13075	58	109	244	18677	0	19088
13076	63	76	18974	303	0	19416
13077	57	18707	282	221	0	19267
13078	69	271	260	18623	0	19223
13079	70	197	74	18627	0	18968
13080	84	86	66	18754	0	18990
13081	92	70	42	18673	0	18877
13082	92	84	18493	472	0	19141
13083	81	18519	235	293	0	19128
13084	95	279	183	18562	0	19119
13085	121	205	18881	317	0	19524
13086	98	105	311	18954	0	19468
13087	18920	91	231	360	0	19602
13088	338	56	18698	275	0	19367
13089	18196	53	317	171	0	18737
13090	405	54	222	18669	0	19350
13091	296	66	18684	425	0	19471
13092	183	18217	309	343	0	19052
13093	181	285	233	18057	0	18756
13094	359	228	17721	388	0	18696
13095	131	17703	326	281	0	18441
13096	141	358	215	17370	0	18084
13097	17236	247	142	377	0	18002
13098	17321	155	112	246	0	17834
13099	17603	137	108	176	0	18024
13100	559	116	17428	154	0	18257
13101	330	17685	337	166	0	18518
13102	217	317	283	17599	0	18416
13103	176	266	151	18824	0	19417
13104	18876	165	304	521	0	19866
13105	361	19194	99	367	0	20021
13106	19457	386	125	226	0	20194
13107	18894	314	108	199	0	19515
13108	19286	195	122	166	0	19769
13109	577	175	19028	158	0	19938
13110	19203	128	372	165	0	19868
13111	478	146	287	19115	0	20026
13112	339	139	127	19391	0	19996
13113	19053	118	107	653	0	19931
13114	447	98	86	18925	0	19556
13115	342	18763	90	546	0	19741
13116	196	394	69	18809	0	19468
13117	18414	295	77	504	0	19290
13118	416	160	18347	378	0	19301
13119	307	18157	355	247	0	19066
13120	161	394	266	18040	0	18861
13121	17917	286	111	492	0	18806
13122	413	120	18144	389	0	19066
13123	301	211	412	17644	0	18568
13124	217	82	17834	452	0	18585
13125	165	78	17187	366	0	17796
13126	210	38	16426	191	0	16865
13127	164	48	15831	155	0	16198
13128	109	60	14442	127	0	14738
13129	11814	100	704	64	0	12682
13130	134	12213	117	59	0	12523
13131	11875	104	69	35	0	12083
13132	11868	91	27	25	0	12011
13133	204	12096	16	42	0	12358
13134	103	12363	27	42	0	12535
13135	12250	207	18	33	0	12508
13136	12294	95	12	40	0	12441
13137	188	25	20	11777	0	12010
13138	116	12120	10	123	0	12369
13139	12119	104	17	117	0	12357
13140	126	12122	21	45	0	12314
13141	115	115	33	12012	0	12275
13142	12059	84	31	125	0	12299
13143	11870	28	44	108	0	12050
13144	194	27	33	11912	0	12166
13145	120	12	42	11980	0	12154
13146	60	23	11985	189	0	12257
13147	34	23	124	11805	0	11986
13148	45	16	11942	135	0	12138
13149	51	20	126	11482	0	11679
13150	38	19	113	11704	0	11874
13151	11671	24	50	207	0	11952
13152	11401	30	42	125	0	11598
13153	216	31	11775	40	0	12062
13154	11496	23	122	54	0	11695
13155	148	36	99	11617	0	11900
13156	143	25	11843	119	0	12130
13157	66	38	134	11711	0	11949
13158	60	40	111	12454	0	12665
13159	67	35	12413	239	0	12754
13160	65	24	160	12392	0	12641
13161	73	31	13060	167	0	13331
13162	55	188	177	13535	0	13955
13163	14576	31	156	208	0	14971
13164	235	14641	38	206	0	15120
13165	14996	217	70	178	0	15461
13166	232	15446	37	70	0	15785
13167	15173	219	35	48	0	15475
13168	247	15406	25	92	0	15770
13169	15051	224	31	59	0	15365
13170	257	15435	22	68	0	15782
13171	202	272	32	15274	0	15780
13172	92	177	15326	245	0	15840
13173	82	53	15276	184	0	15595
13174	81	28	354	15029	0	15492
13175	15048	31	198	234	0	15511
13176	246	15458	61	207	0	15972
13177	209	214	41	15420	0	15884
13178	84	163	15360	260	0	15867
13179	79	42	15545	218	0	15884
13180	79	117	381	14492	0	15069
13181	44	15474	210	250	0	15978
13182	15308	209	61	207	0	15785
13183	279	189	15498	92	0	16058
13184	206	65	15576	65	0	15912
13185	72	15539	355	75	0	16041
13186	15325	223	202	51	0	15801
13187	15344	183	62	47	0	15636
13188	374	53	54	15167	0	15648
13189	15527	51	57	212	0	15847
13190	15140	42	60	195	0	15437
13191	354	15202	71	73	0	15700
13192	15198	209	81	44	0	15532
13193	253	168	15865	58	0	16344
13194	206	63	226	15459	0	15954
13195	78	53	198	15691	0	16020
13196	15470	48	112	388	0	16018
13197	230	15532	77	245	0	16084
13198	15439	222	64	71	0	15796
13199	240	15633	41	73	0	15987
13200	206	15649	49	80	0	15984
13201	125	353	15179	57	0	15714
13202	86	187	14621	46	0	14940
13203	13193	126	277	29	0	13625
13204	13431	53	166	108	0	13758
13205	352	53	13329	34	0	13768
13206	162	12985	146	48	0	13341
13207	64	13297	135	38	0	13534
13208	13058	242	88	42	0	13430
13209	13007	162	33	18	0	13220
13210	267	76	33	13050	0	13426
13211	13281	52	44	146	0	13523
13212	179	54	53	13343	0	13629
13213	169	55	13296	175	0	13695
13214	93	45	13081	140	0	13359
13215	13010	61	239	66	0	13376
13216	186	52	136	12765	0	13139
13217	157	13938	69	142	0	14306
13218	13981	167	60	144	0	14352
13219	13868	144	58	65	0	14135
13220	274	68	13918	46	0	14306
13221	13872	51	172	63	0	14158
13222	14149	49	155	56	0	14409
13223	282	48	79	13917	0	14326
13224	187	13931	58	169	0	14345
13225	82	14727	72	149	0	15030
13226	89	277	61	14697	0	15124
13227	100	180	68	14482	0	14830
13228	96	71	59	15036	0	15262
13229	117	59	14821	296	0	15293
13230	102	75	14169	185	0	14531
13231	113	67	283	13994	0	14457
13232	98	62	14249	185	0	14594
13233	98	64	14039	172	0	14373
13234	90	71	295	13734	0	14190
13235	114	70	15091	201	0	15476
13236	91	14744	216	203	0	15254
13237	15285	202	186	80	0	15753
13238	241	186	100	14939	0	15466
13239	222	15381	79	199	0	15881
13240	113	216	15736	195	0	16260
13241	101	206	214	15603	0	16124
13242	116	74	16425	214	0	16829
13243	100	74	238	16376	0	16788
13244	93	82	196	16991	0	17362
13245	114	73	17691	362	0	18240
13246	114	68	233	17094	0	17509
13247	88	17689	225	245	0	18247
13248	108	222	104	18025	0	18459
13249	125	207	18227	259	0	18818
13250	112	87	242	18194	0	18635
13251	17926	72	218	272	0	18488
13252	267	18220	85	268	0	18840
13253	267	272	95	18102	0	18736
13254	123	210	18917	255	0	19505
13255	112	18542	251	266	0	19171
13256	98	18834	202	123	0	19257
13257	195	361	18569	87	0	19212
13258	93	193	212	17411	0	17909
13259	78	206	201	17626	0	18111
13260	125	56	18014	336	0	18531
13261	65	17141	175	253	0	17634
13262	70	16781	177	97	0	17125
13263	14888	171	83	42	0	15184
13264	104	15257	35	56	0	15452
13265	14655	116	75	32	0	14878
13266	100	99	17	14407	0	14623
13267	15057	36	31	110	0	15234
13268	97	18	14908	122	0	15145
13269	14964	18	105	58	0	15145
13270	114	23	106	15364	0	15607
13271	107	15707	43	129	0	15986
13272	15651	106	31	134	0	15922
13273	102	165	54	15787	0	16108
13274	99	16077	46	124	0	16346
13275	32	16785	35	142	0	16994
13276	16528	159	38	55	0	16780
13277	16497	109	33	44	0	16683
13278	16593	36	29	46	0	16704
13279	177	30	26	16300	0	16533
13280	106	16166	30	120	0	16422
13281	41	16414	46	116	0	16617
13282	14	173	35	16367	0	16589
13283	16289	107	57	114	0	16567
13284	15713	55	51	137	0	15956
13285	15808	29	34	66	0	15937
13286	202	31	15901	62	0	16196
13287	127	35	15953	98	0	16213
13288	16448	59	187	53	0	16747
13289	114	62	127	16379	0	16682
13290	123	45	55	16476	0	16699
13291	66	59	39	16468	0	16632
13292	48	48	49	16764	0	16909
13293	30	64	16110	267	0	16471
13294	33	52	137	16038	0	16260
13295	45	41	16163	190	0	16439
13296	15264	52	145	184	0	15645
13297	113	16274	156	115	0	16658
13298	117	117	75	16592	0	16901
13299	47	138	66	16635	0	16886
13300	16570	76	62	260	0	16968
13301	16249	62	66	212	0	16589
13302	16196	63	64	124	0	16447
13303	16304	69	58	120	0	16551
13304	249	77	16510	108	0	16944
13305	161	89	16429	96	0	16775
13306	83	68	220	16463	0	16834
13307	16535	91	167	195	0	16988
13308	16283	92	82	197	0	16654
13309	211	96	16691	105	0	17103
13310	142	87	144	16317	0	16690
13311	16444	57	158	206	0	16865
13312	141	94	91	16466	0	16792
13313	157	101	16583	211	0	17052
13314	73	112	162	16598	0	16945
13315	16730	128	164	173	0	17195
13316	169	18351	56	177	0	18753
13317	18061	178	70	92	0	18401
13318	18178	161	58	122	0	18519
13319	17989	95	63	122	0	18269
13320	280	60	81	18118	0	18539
13321	17962	83	65	166	0	18276
13322	177	18314	63	158	0	18712
13323	174	18663	51	114	0	19002
13324	142	432	42	18248	0	18864
13325	18612	196	38	157	0	19003
13326	196	19574	35	201	0	20006
13327	22944	196	37	90	0	23267
13328	24798	199	45	104	0	25146
13329	531	25995	38	75	0	26639
13330	348	313	38	25820	0	26519
13331	162	339	22	26606	0	27129
13332	136	122	27379	535	0	28172
13333	109	79	300	27169	0	27657
13334	111	99	27658	401	0	28269
13335	95	26568	311	291	0	27265
13336	106	382	224	26675	0	27387
13337	25717	249	66	320	0	26352
13338	25846	88	44	252	0	26230
13339	515	48	25	26229	0	26817
13340	273	48	25900	343	0	26564
13341	23783	72	282	270	0	24407
13342	299	25197	218	146	0	25860
13343	206	24451	51	77	0	24785
13344	68	24768	74	70	0	24980
13345	128	501	21	23696	0	24346
13346	75	216	25291	264	0	25846
13347	37	55	249	25056	0	25397
13348	44	25	25378	297	0	25744
13349	51	23	24907	215	0	25196
13350	60	42	25712	59	0	25873
13351	33	54	460	24560	0	25107
13352	23	44	273	24640	0	24980
13353	18	30	74	25463	0	25585
13354	21	27	46	25072	0	25166
13355	25101	18	35	476	0	25630
13356	258	25083	47	267	0	25655
13357	25335	251	42	82	0	25710
13358	279	25911	39	63	0	26292
13359	201	281	33	25607	0	26122
13360	56	206	20	26898	0	27180
13361	27063	51	22	468	0	27604
13362	27009	35	25	265	0	27334
13363	27357	41	25	89	0	27512
13364	27433	49	19	63	0	27564
13365	27554	40	14	53	0	27661
13366	485	27620	21	77	0	28203
13367	27332	264	22	65	0	27683
13368	300	27435	26	78	0	27839
13369	26946	274	32	42	0	27294
13370	334	191	27283	48	0	27856
13371	232	60	239	26480	0	27011
13372	87	27566	170	248	0	28071
13373	61	259	52	27518	0	27890
13374	78	204	27465	309	0	28056
13375	72	93	261	26781	0	27207
13376	26392	69	192	370	0	27023
13377	254	26909	74	293	0	27530
13378	182	27568	51	136	0	27937
13379	101	407	28821	94	0	29423
13380	49	227	272	27884	0	28432
13381	45	30319	202	300	0	30866
13382	117	279	86	30918	0	31400
13383	69	205	31510	352	0	32136
13384	68	31193	268	349	0	31878
13385	90	339	31682	101	0	32212
13386	96	224	31417	94	0	31831
13387	61	98	430	30831	0	31420
13388	31487	67	231	317	0	32102
13389	286	61	86	31800	0	32233
13390	238	62	32792	361	0	33453
13391	101	65	312	33295	0	33773
13392	94	85	35709	352	0	36240
13393	69	67	35543	262	0	35941
13394	34883	63	587	148	0	35681
13395	36474	52	275	146	0	36947
13396	36394	56	115	139	0	36704
13397	549	56	36594	130	0	37329
13398	307	44	36709	197	0	37257
13399	109	57	534	35955	0	36655
13400	89	84	305	36940	0	37418
13401	37023	67	121	559	0	37770
13402	386	69	82	37132	0	37669
13403	297	48	37415	425	0	38185
13404	150	57	36972	309	0	37488
13405	101	38320	518	164	0	39103
13406	108	337	290	38986	0	39721
13407	147	247	39803	388	0	40585
13408	110	108	353	39254	0	39825
13409	39417	93	265	441	0	40216
13410	380	79	40424	320	0	41203
13411	309	72	384	39696	0	40461
13412	180	74	284	40348	0	40886
13413	230	74	40513	557	0	41374
13414	91	58	378	39769	0	40296
13415	113	56	40860	423	0	41452
13416	37440	66	404	362	0	38272
13417	369	55	302	38624	0	39350
13418	276	39151	131	423	0	39981
13419	38964	321	89	351	0	39725
13420	38255	257	94	174	0	38780
13421	645	39173	85	159	0	40062
13422	790	1486	78	36090	0	38444
13423	138	38110	73	339	0	38660
13424	123	38048	69	265	0	38505
13425	334	492	36752	128	0	37706
13426	123	36085	265	161	0	36634
13427	147	335	31988	112	0	32582
13428	26349	202	152	56	0	26759
13429	27488	22	113	40	0	27663
13430	153	29140	31	82	0	29406
13431	80	29107	39	51	0	29277
13432	32	29144	30	49	0	29255
13433	29283	164	27	38	0	29512
13434	116	85	30	29473	0	29704
13435	108	16	31223	133	0	31480
13436	15	31274	150	139	0	31578
13437	24	131	119	31686	0	31960
13438	30	115	40	30933	0	31118
13439	18	35673	32	246	0	35969
13440	38395	240	35	134	0	38804
13441	343	165	38856	51	0	39415
13442	241	73	351	45254	0	45919
13443	40	49890	232	424	0	50586
13444	49534	515	44	315	0	50408
13445	576	333	49581	241	0	50731
13446	345	48648	530	105	0	49628
13447	82	535	360	48501	0	49478
13448	73	343	48709	517	0	49642
13449	46615	87	583	356	0	47641
13450	535	50	360	47796	0	48741
13451	404	43	48471	554	0	49472
13452	94	48339	543	499	0	49475
13453	47368	549	376	111	0	48404
13454	520	48521	107	94	0	49242
13455	48127	601	68	63	0	48859
13456	47464	402	76	88	0	48030
13457	863	114	67	46735	0	47779
13458	427	47143	53	560	0	48183
13459	164	537	46936	371	0	48008
13460	72	390	568	45773	0	46803
13461	102	169	443	44161	0	44875
13462	69	103	127	45464	0	45763
13463	86	87	89	45890	0	46152
13464	77	82	73	46027	0	46259
13465	45174	71	71	954	0	46270
13466	43665	98	111	479	0	44353
13467	43936	81	102	164	0	44283
13468	868	44276	108	145	0	45397
13469	480	573	44452	97	0	45602
13470	201	405	43988	107	0	44701
13471	140	180	44562	91	0	44973
13472	109	151	963	42100	0	43323
13473	96	106	501	42874	0	43577
13474	99	105	147	44145	0	44496
13475	126	96	43605	966	0	44793
13476	79	42946	606	685	0	44316
13477	124	617	43448	174	0	44363
13478	135	426	43313	151	0	44025
13479	128	156	949	41269	0	42502
13480	173	154	42186	632	0	43145
13481	146	102	676	40346	0	41270
13482	39735	133	479	678	0	41025
13483	39076	114	171	464	0	39825
13484	989	142	39052	201	0	40384
13485	523	148	649	38204	0	39524
13486	241	163	39273	669	0	40346
13487	151	38972	718	588	0	40429
13488	38601	691	500	220	0	40012
13489	710	481	39004	186	0	40381
13490	509	37491	660	217	0	38877
13491	189	37258	483	208	0	38138
13492	163	35815	205	213	0	36396
13493	200	1000	34114	172	0	35486
13494	223	624	670	32140	0	33657
13495	159	33756	485	639	0	35039
13496	162	648	252	33256	0	34318
13497	174	532	191	33760	0	34657
13498	32512	181	175	1017	0	33885
13499	619	32709	182	773	0	34283
13500	32081	661	172	259	0	33173
13501	700	32257	164	288	0	33409
13502	504	32640	185	266	0	33595
13503	296	1010	32018	270	0	33594
13504	197	635	665	31468	0	32965
13505	190	214	31310	742	0	32456
13506	156	30113	699	803	0	31771
13507	231	665	30033	333	0	31262
13508	268	467	30052	313	0	31100
13509	200	29641	990	305	0	31136
13510	28381	683	598	258	0	29920
13511	658	28978	302	316	0	30254
13512	28922	713	324	273	0	30232
13513	746	570	28391	283	0	29990
13514	581	202	28762	285	0	29830
13515	210	28015	1086	301	0	29612
13516	27046	678	601	253	0	28578
13517	643	27795	314	325	0	29077
13518	559	713	332	27272	0	28876
13519	27565	524	268	700	0	29057
13520	685	238	27488	577	0	28988
13521	528	243	773	27481	0	29025
13522	26966	235	562	740	0	28503
13523	674	27373	325	594	0	28966
13524	583	690	243	27306	0	28822
13525	268	478	27257	788	0	28791
13526	26724	202	750	586	0	28262
13527	690	195	580	26955	0	28420
13528	452	207	26872	774	0	28305
13529	197	168	782	26164	0	27311
13530	169	26579	542	826	0	28116
13531	225	635	26515	598	0	27973
13532	176	490	689	25720	0	27075
13533	25038	241	522	672	0	26473
13534	647	196	299	24830	0	25972
13535	23075	216	246	604	0	24141
13536	612	23134	232	435	0	24413
13537	22586	625	261	190	0	23662
13538	609	476	22101	176	0	23362
13539	321	207	18618	161	0	19307
13540	205	155	15617	106	0	16083
13541	213	14420	857	201	0	15691
13542	432	95	685	3402	0	4614
13543	13	58	75	3439	0	3585
13544	18	29	17	3373	0	3437
13545	10	23	19	3497	0	3549
13546	12	22	3419	100	0	3553
13547	3259	15	56	67	0	3397
13548	49	3452	53	16	0	3570
13549	3258	49	19	20	0	3346
13550	52	48	20	3182	0	3302
13551	49	3192	18	41	0	3300
13552	14	52	15	3241	0	3322
13553	3144	51	20	49	0	3264
13554	42	3289	19	52	0	3402
13555	3253	56	13	21	0	3343
13556	3074	53	94	9	0	3230
13557	69	18	21	2997	0	3105
13558	53	11	2982	43	0	3089
13559	2920	20	49	39	0	3028
13560	54	23	37	3027	0	3141
13561	3067	18	19	44	0	3148
13562	3135	16	20	42	0	3213
13563	3176	11	23	20	0	3230
13564	87	14	3163	7	0	3271
13565	50	18	50	3117	0	3235
13566	3174	13	38	54	0	3279
13567	48	19	3254	54	0	3375
13568	50	3161	41	29	0	3281
13569	19	106	45	3053	0	3223
13570	19	35	2976	38	0	3068
13571	12	11	3013	44	0	3080
13572	21	10	63	2816	0	2910
13573	9	12	44	2751	0	2816
13574	14	9	16	2783	0	2822
13575	8	12	14	2694	0	2728
13576	15	11	2650	69	0	2745
13577	11	2674	36	50	0	2771
13578	13	34	37	2717	0	2801
13579	2817	32	13	42	0	2904
13580	2793	15	5	34	0	2847
13581	2825	11	14	16	0	2866
13582	65	4	12	2797	0	2878
13583	40	10	17	2803	0	2870
13584	16	2716	10	67	0	2809
13585	14	2725	16	37	0	2792
13586	9	99	6	2203	0	2317
13587	2250	58	2	26	0	2336
13588	2091	1	5	15	0	2112
13589	2065	3	5	10	0	2083
13590	2086	3	5	7	0	2101
13591	2106	4	4	8	0	2122
13592	26	2090	5	10	0	2131
13593	15	19	6	2177	0	2217
13594	2204	11	4	19	0	2238
13595	2273	6	5	18	0	2302
13596	28	4	8	2287	0	2327
13597	19	2	5	2299	0	2325
13598	12	6	2479	27	0	2524
13599	8	2	20	2393	0	2423
13600	9	2	11	2470	0	2492
13601	7	4	2616	30	0	2657
13602	3	6	18	2578	0	2605
13603	8	2827	16	23	0	2874
13604	12	19	2848	19	0	2898
13605	7	2744	14	8	0	2773
13606	10	58	11	2675	0	2754
13607	5	11	2	2707	0	2725
13608	3	2689	4	23	0	2719
13609	5	2783	2	15	0	2805
13610	2831	16	2	14	0	2863
13611	2841	13	4	5	0	2863
13612	27	3	2869	4	0	2903
13613	2879	2	7	4	0	2892
13614	2962	2	13	7	0	2984
13615	2982	0	3	12	0	2997
13616	2992	4	17	7	0	3020
13617	25	4	3000	10	0	3039
13618	17	2	2865	10	0	2894
13619	3095	3	19	5	0	3122
13620	17	3211	16	3	0	3247
13621	15	6	3098	5	0	3124
13622	3085	10	9	13	0	3117
13623	3110	0	14	4	0	3128
13624	20	5	3231	3	0	3259
13625	3191	7	18	4	0	3220
13626	20	3	14	3715	0	3752
13627	20	4	3914	19	0	3957
13628	3635	3	23	21	0	3682
13629	16	3945	18	13	0	3992
13630	4081	18	7	14	0	4120
13631	4660	16	4	17	0	4697
13632	31	1	6	4650	0	4688
13633	16	5	8	4674	0	4703
13634	5	6	3	4766	0	4780
13635	4763	2	7	46	0	4818
13636	5007	7	3	21	0	5038
13637	40	5	3	5061	0	5109
13638	29	1	2	5095	0	5127
13639	11	1	5042	48	0	5102
13640	4760	3	19	30	0	4812
13641	19	9	22	5166	0	5216
13642	26	7	2	5205	0	5240
13643	8	5223	4	54	0	5289
13644	11	22	4	5289	0	5326
13645	13	30	4	5265	0	5312
13646	5224	4	2	59	0	5289
13647	35	5323	3	33	0	5394
13648	39	21	2	5436	0	5498
13649	11	33	7	5365	0	5416
13650	8	4	2	5534	0	5548
13651	12	5	5535	55	0	5607
13652	11	6	21	5444	0	5482
13653	5471	9	31	33	0	5544
13654	31	3	5584	43	0	5661
13655	39	0	31	5686	0	5756
13656	11	2	33	5785	0	5831
13657	5957	5	9	66	0	6037
13658	5762	2	10	47	0	5821
13659	71	3	5959	12	0	6045
13660	5809	12	24	19	0	5864
13661	43	3	6194	14	0	6254
13662	6230	6	32	15	0	6283
13663	45	7015	40	11	0	7111
13664	7290	39	4	3	0	7336
13665	52	7342	3	29	0	7426
13666	7563	48	2	13	0	7626
13667	56	7741	7	10	0	7814
13668	54	56	7	7980	0	8097
13669	13	48	4	8023	0	8088
13670	12	9	5	8049	0	8075
13671	7	8006	7	127	0	8147
13672	8	50	7	8026	0	8091
13673	9	8089	4	72	0	8174
13674	15	58	3	8205	0	8281
13675	8252	55	3	65	0	8375
13676	8094	11	9	68	0	8182
13677	112	8218	1	41	0	8372
13678	66	56	4	8268	0	8394
13679	8174	55	6	66	0	8301
13680	69	8276	8	85	0	8438
13681	67	8377	5	20	0	8469
13682	8349	115	12	23	0	8499
13683	8365	68	7	19	0	8459
13684	120	8385	7	21	0	8533
13685	8380	63	3	19	0	8465
13686	78	66	4	8350	0	8498
13687	76	17	8931	71	0	9095
13688	8779	12	60	77	0	8928
13689	8824	9	62	34	0	8929
13690	135	14	9133	22	0	9304
13691	8937	15	66	19	0	9037
13692	9162	14	60	20	0	9256
13693	9488	12	13	27	0	9540
13694	131	9509	9	30	0	9679
13695	9607	71	5	24	0	9707
13696	9553	72	6	23	0	9654
13697	137	27	5	9549	0	9718
13698	88	18	8	9594	0	9708
13699	38	18	6	9743	0	9805
13700	9784	23	7	148	0	9962
13701	94	20	3	9630	0	9747
13702	9679	20	9	104	0	9812
13703	9611	19	7	92	0	9729
13704	152	21	9	9597	0	9779
13705	103	19	5	9701	0	9828
13706	37	25	10	9872	0	9944
13707	9913	18	10	163	0	10104
13708	93	9948	12	98	0	10151
13709	99	85	8	9942	0	10134
13710	51	93	6	10018	0	10168
13711	9951	30	11	156	0	10148
13712	9896	28	7	110	0	10041
13713	170	24	10011	45	0	10250
13714	120	25	10072	31	0	10248
13715	10619	20	156	39	0	10834
13716	128	23	106	10884	0	11141
13717	132	21	19	12849	0	13021
13718	59	21	13257	276	0	13613
13719	48	62	191	13078	0	13379
13720	47	13576	134	196	0	13953
13721	48	13965	20	160	0	14193
13722	13828	295	21	41	0	14185
13723	223	163	14024	39	0	14449
13724	167	13933	150	54	0	14304
13725	67	170	126	14002	0	14365
13726	68	141	13830	188	0	14227
13727	42	71	152	13378	0	13643
13728	42	28	135	13664	0	13869
13729	59	21	13792	319	0	14191
13730	49	13841	167	183	0	14240
13731	53	175	141	13187	0	13556
13732	13230	152	34	184	0	13600
13733	13045	44	29	163	0	13281
13734	13303	27	13	66	0	13409
13735	329	13216	21	67	0	13633
13736	13128	169	17	43	0	13357
13737	215	144	17	13023	0	13399
13738	168	40	12895	202	0	13305
13739	12574	30	152	165	0	12921
13740	195	13021	131	72	0	13419
13741	159	163	48	12804	0	13174
13742	69	133	30	12712	0	12944
13743	47	12778	25	312	0	13162
13744	56	173	23	12970	0	13222
13745	55	130	37	12930	0	13152
13746	43	48	27	13243	0	13361
13747	12871	46	34	343	0	13294
13748	12689	38	33	207	0	12967
13749	330	52	13065	84	0	13531
13750	173	48	189	12790	0	13200
13751	82	49	140	13123	0	13394
13752	63	50	61	13367	0	13541
13753	13129	57	51	344	0	13581
13754	207	37	12948	227	0	13419
13755	12496	45	198	97	0	12836
13756	12944	46	145	94	0	13229
13757	332	41	60	12805	0	13238
13758	12967	35	65	214	0	13281
13759	256	43	12850	183	0	13332
13760	12271	27	168	112	0	12578
13761	230	14058	159	110	0	14557
13762	174	181	13653	72	0	14080
13763	83	153	13381	142	0	13759
13764	84	49	309	13121	0	13563
13765	92	42	13479	195	0	13808
13766	12757	56	185	194	0	13192
13767	184	13011	171	89	0	13455
13768	13085	151	45	77	0	13358
13769	188	165	39	13052	0	13444
13770	192	64	13141	201	0	13598
13771	82	44	13336	210	0	13672
13772	55	42	271	13354	0	13722
13773	13673	32	177	238	0	14120
13774	174	13588	54	225	0	14041
13775	162	13906	37	144	0	14249
13776	13839	267	39	106	0	14251
13777	178	14010	34	121	0	14343
13778	14043	167	62	88	0	14360
13779	219	165	38	13869	0	14291
13780	13907	44	47	204	0	14202
13781	203	35	68	13995	0	14301
13782	14195	34	46	228	0	14503
13783	220	23	49	14026	0	14318
13784	195	14074	65	233	0	14567
13785	14110	157	53	201	0	14521
13786	191	14192	67	137	0	14587
13787	229	173	13817	87	0	14306
13788	106	180	176	12993	0	13455
13789	85	14144	184	172	0	14585
13790	13743	177	83	156	0	14159
13791	13606	177	81	101	0	13965
13792	309	13873	55	103	0	14340
13793	205	189	13951	91	0	14436
13794	116	161	202	13474	0	13953
13795	84	13754	188	208	0	14234
13796	87	175	96	14176	0	14534
13797	105	155	83	14160	0	14503
13798	14035	83	60	316	0	14494
13799	221	14213	53	223	0	14710
13800	228	179	50	14322	0	14779
13801	14249	177	54	219	0	14699
13802	14057	75	55	203	0	14390
13803	14192	64	55	107	0	14418
13804	349	77	57	14115	0	14598
13805	14209	61	59	212	0	14541
13806	236	14256	48	219	0	14759
13807	14259	199	48	95	0	14601
13808	230	14528	35	120	0	14913
13809	14588	208	48	76	0	14920
13810	14323	158	38	115	0	14634
13811	329	158	62	14144	0	14693
13812	220	63	15160	216	0	15659
13813	143	57	14821	175	0	15196
13814	108	14878	223	107	0	15316
13815	14529	160	191	83	0	14963
13816	192	145	14380	54	0	14771
13817	11402	37	85	25	0	11549
13818	61	11737	54	22	0	11874
13819	70	12238	20	30	0	12358
13820	32	91	15	12603	0	12741
13821	30	13350	14	66	0	13460
13822	44	70	13427	74	0	13615
13823	33	90	56	12831	0	13010
13824	35	13868	87	78	0	14068
13825	29	91	18	13924	0	14062
13826	13889	123	15	95	0	14122
13827	97	38	17	13979	0	14131
13828	129	33	14131	117	0	14410
13829	42	14542	90	140	0	14814
13830	25	107	119	14253	0	14504
13831	33	134	41	14153	0	14361
13832	39	39	19	14647	0	14744
13833	14457	39	11	221	0	14728
13834	14072	31	19	149	0	14271
13835	237	24	14317	95	0	14673
13836	174	27	14230	31	0	14462
13837	34	14421	194	50	0	14699
13838	14617	97	123	49	0	14886
13839	126	133	27	14456	0	14742
13840	139	44	20	14522	0	14725
13841	55	35	13	14630	0	14733
13842	46	40	6	14778	0	14870
13843	61	30	14518	224	0	14833
13844	14018	31	105	161	0	14315
13845	125	31	126	16179	0	16461
13846	162	24	16055	155	0	16396
13847	16143	36	153	199	0	16531
13848	17401	31	178	77	0	17687
13849	383	29	19670	59	0	20141
13850	289	36	20467	33	0	20825
13851	72	32	442	20192	0	20738
13852	20358	41	295	244	0	20938
13853	20455	28	80	283	0	20846
13854	478	41	42	19761	0	20322
13855	314	56	36	20424	0	20830
13856	90	28	20570	495	0	21183
13857	48	84	248	20414	0	20794
13858	52	41	20753	317	0	21163
13859	19443	59	267	299	0	20068
13860	249	20500	269	116	0	21134
13861	19585	213	45	41	0	19884
13862	263	19499	24	157	0	19943
13863	19521	254	38	38	0	19851
13864	275	242	24	18717	0	19258
13865	281	45	33	19100	0	19459
13866	19126	21	23	453	0	19623
13867	18836	19	41	281	0	19177
13868	19165	18	26	66	0	19275
13869	19203	21	24	37	0	19285
13870	540	13	18588	36	0	19177
13871	18068	21	241	54	0	18384
13872	18285	16	257	68	0	18626
13873	18287	11	69	55	0	18422
13874	523	15	38	17933	0	18509
13875	17725	20	39	267	0	18051
13876	312	17482	54	334	0	18182
13877	290	232	53	17490	0	18065
13878	100	261	35	17791	0	18187
13879	76	70	17604	485	0	18235
13880	99	29	235	17264	0	17627
13881	81	17520	255	325	0	18181
13882	17258	237	82	309	0	17886
13883	286	17527	61	139	0	18013
13884	17570	274	42	101	0	17987
13885	355	254	55	17306	0	17970
13886	17376	58	61	300	0	17795
13887	336	17007	64	341	0	17748
13888	17337	247	60	108	0	17752
13889	17168	272	80	78	0	17598
13890	586	74	69	16746	0	17475
13891	379	41	64	17154	0	17638
13892	178	36	16852	548	0	17614
13893	162	45	268	16784	0	17259
13894	139	58	276	16902	0	17375
13895	156	39	16664	631	0	17490
13896	153	38	276	16666	0	17133
13897	117	35	16623	405	0	17180
13898	16086	41	323	357	0	16807
13899	376	40	304	16145	0	16865
13900	383	54	15932	320	0	16689
13901	15715	45	287	323	0	16370
13902	392	64	281	15924	0	16661
13903	396	54	16176	318	0	16944
13904	15964	58	262	337	0	16621
13905	396	51	272	16031	0	16750
13906	401	36	89	16031	0	16557
13907	16050	38	70	563	0	16721
13908	393	38	64	15927	0	16422
13909	425	35	70	15992	0	16522
13910	216	44	92	15531	0	15883
13911	172	15717	73	603	0	16565
13912	14952	263	78	411	0	15704
13913	14971	285	89	157	0	15502
13914	630	91	62	14612	0	15395
13915	14781	51	63	367	0	15262
13916	14483	54	67	387	0	14991
13917	14739	67	71	180	0	15057
13918	14240	67	80	167	0	14554
13919	14004	68	87	162	0	14321
13920	659	56	13003	126	0	13844
13921	417	61	12353	150	0	12981
13922	12105	61	444	139	0	12749
13923	353	12078	278	148	0	12857
13924	387	227	112	11495	0	12221
13925	193	232	11596	317	0	12338
13926	163	69	11745	319	0	12296
13927	150	172	398	11469	0	12189
13928	11277	113	459	284	0	12133
13929	352	46	90	11499	0	11987
13930	329	63	11429	312	0	12133
13931	11815	28	213	315	0	12371
13932	318	44	263	11743	0	12368
13933	341	23	107	11748	0	12219
13934	187	22	79	12078	0	12366
13935	145	21	67	12087	0	12320
13936	143	22	11633	553	0	12351
13937	144	14	252	11833	0	12243
13938	11555	28	277	339	0	12199
13939	301	26	11415	334	0	12076
13940	11475	47	252	150	0	11924
13941	11612	30	253	135	0	12030
13942	11593	29	100	147	0	11869
13943	11442	31	79	122	0	11674
13944	493	11042	58	156	0	11749
13945	244	9458	57	91	0	9850
13946	129	9715	49	120	0	10013
13947	8608	399	182	194	0	9383
13948	199	180	7998	93	0	8470
13949	5034	14	247	35	0	5330
13950	106	15	57	4577	0	4755
13951	4627	10	17	64	0	4718
13952	63	5	10	4628	0	4706
13953	4630	9	15	69	0	4723
13954	69	3	14	4566	0	4652
13955	64	28	11	4869	0	4972
13956	4384	3	23	114	0	4524
13957	77	5360	10	71	0	5518
13958	60	44	5194	32	0	5330
13959	28	5198	57	31	0	5314
13960	29	43	4970	19	0	5061
13961	18	116	43	4592	0	4769
13962	4664	5	84	40	0	4793
13963	39	6	9	4580	0	4634
13964	4582	6	9	43	0	4640
13965	37	4989	11	67	0	5104
13966	63	26	5439	17	0	5545
13967	15	5362	35	23	0	5435
13968	18	5386	35	18	0	5457
13969	5212	58	57	11	0	5338
13970	5154	35	27	13	0	5229
13971	58	5245	7	16	0	5326
13972	44	29	8	5383	0	5464
13973	24	28	6	5414	0	5472
13974	5446	8	13	72	0	5539
13975	47	11	5450	43	0	5551
13976	52	9	5442	13	0	5516
13977	14	11	70	5488	0	5583
13978	22	8	5584	50	0	5664
13979	5271	8	47	49	0	5375
13980	5549	6	41	24	0	5620
13981	86	5617	13	21	0	5737
13982	60	43	5703	11	0	5817
13983	22	45	43	5594	0	5704
13984	21	13	5919	46	0	5999
13985	20	9	48	5850	0	5927
13986	5862	8	48	53	0	5971
13987	52	5847	11	73	0	5983
13988	61	45	6118	21	0	6245
13989	22	6263	56	27	0	6368
13990	16	6398	53	21	0	6488
13991	6457	87	21	19	0	6584
13992	6335	54	13	20	0	6422
13993	99	13	6487	30	0	6629
13994	59	6585	58	35	0	6737
13995	28	51	54	6524	0	6657
13996	17	52	15	6458	0	6542
13997	21	19	15	6517	0	6572
13998	21	18	6657	115	0	6811
13999	24	9	63	6571	0	6667
14000	29	13	62	6792	0	6896
14001	6824	11	22	110	0	6967
14002	6714	11	20	71	0	6816
14003	6741	11	13	27	0	6792
14004	6669	15	15	22	0	6721
14005	6684	17	17	20	0	6738
14006	111	6644	9	34	0	6798
14007	6547	55	15	10	0	6627
14008	67	46	6624	13	0	6750
14009	60	15	58	6371	0	6504
14010	6415	15	38	54	0	6522
14011	60	6608	17	57	0	6742
14012	6679	48	8	18	0	6753
14013	6700	52	10	22	0	6784
14014	81	18	11	6808	0	6918
14015	49	21	11	6937	0	7018
14016	25	7529	11	86	0	7651
14017	26	53	18	7693	0	7790
14018	23	56	8465	64	0	8608
14019	13	20	59	8686	0	8778
14020	22	23	8825	63	0	8933
14021	8436	11	68	84	0	8599
14022	68	14	60	8804	0	8946
14023	74	12	8984	76	0	9146
14024	20	8959	67	93	0	9139
14025	14	8974	60	37	0	9085
14026	8886	107	46	19	0	9058
14027	84	65	13	8956	0	9118
14028	60	15	9651	59	0	9785
14029	13	9659	51	83	0	9806
14030	15	79	9707	14	0	9815
14031	9212	51	48	9	0	9320
14032	9217	15	53	16	0	9301
14033	9351	3	64	18	0	9436
14034	100	4	11	9515	0	9630
14035	64	2	9595	55	0	9716
14036	10	9905	47	72	0	10034
14037	9	45	57	9896	0	10007
14038	18	57	9912	51	0	10038
14039	14	11	9768	62	0	9855
14040	6	9	96	9853	0	9964
14041	9924	7	65	55	0	10051
14042	47	6	17	9878	0	9948
14043	57	3	6	10173	0	10239
14044	15	3	10602	115	0	10735
14045	17	8	47	10464	0	10536
14046	7	10	69	10582	0	10668
14047	20	9	10761	107	0	10897
14048	20	9	10732	72	0	10833
14049	16	14	103	10656	0	10789
14050	29	11	10969	64	0	11073
14051	18	13	58	10879	0	10968
14052	10979	11	70	72	0	11132
14053	51	11749	19	102	0	11921
14054	63	60	23	11896	0	12042
14055	24	64	11705	60	0	11853
14056	10470	16	62	86	0	10634
14057	58	11045	70	30	0	11203
14058	11178	49	26	38	0	11291
14059	65	65	16	11103	0	11249
14060	70	26	19	11070	0	11185
14061	11458	3	24	125	0	11610
14062	72	8	11524	91	0	11695
14063	11284	9	70	30	0	11393
14064	61	17	75	11497	0	11650
14065	11195	10	31	69	0	11305
14066	10788	11	30	89	0	10918
14067	115	11	18	10774	0	10918
14068	82	11129	33	71	0	11315
14069	11425	53	24	102	0	11604
14070	11326	71	24	40	0	11461
14071	140	23	11508	30	0	11701
14072	11222	12	80	36	0	11350
14073	78	11	88	11310	0	11487
14074	81	11683	32	77	0	11873
14075	31	67	25	11491	0	11614
14076	28	11677	22	84	0	11811
14077	11596	62	27	95	0	11780
14078	11587	93	31	37	0	11748
14079	126	24	26	12356	0	12532
14080	91	14	12411	89	0	12605
14081	46	19	12303	100	0	12468
14082	35	9	151	12525	0	12720
14083	12586	14	96	99	0	12795
14084	13418	17	36	113	0	13584
14085	167	13864	27	55	0	14113
14086	123	128	27	13873	0	14151
14087	56	99	14308	114	0	14577
14088	49	29	14633	127	0	14838
14089	57	91	235	16057	0	16440
14090	17706	17	149	175	0	18047
14091	185	12	38	17844	0	18079
14092	191	22	17683	212	0	18108
14093	17912	9	184	180	0	18285
14094	203	25	173	17791	0	18192
14095	178	17	52	18027	0	18274
14096	60	23	34	17670	0	17787
14097	35	18196	36	364	0	18631
14098	53	188	18106	211	0	18558
14099	58	161	18373	87	0	18679
14100	48	35	349	18166	0	18598
14101	40	23	18429	228	0	18720
14102	17874	21	217	200	0	18312
14103	209	27	190	17804	0	18230
14104	189	36	58	17563	0	17846
14105	64	23	47	17987	0	18121
14106	56	18172	35	387	0	18650
14107	18272	188	33	225	0	18718
14108	215	173	44	18134	0	18566
14109	18164	40	37	236	0	18477
14110	226	18186	42	219	0	18673
14111	18012	189	45	87	0	18333
14112	17312	194	57	65	0	17628
14113	17840	53	39	72	0	18004
14114	388	17619	45	69	0	18121
14115	223	17572	48	88	0	17931
14116	17002	323	48	80	0	17453
14117	208	17341	51	95	0	17695
14118	219	198	16539	78	0	17034
14119	58	16224	195	82	0	16559
14120	48	16426	175	77	0	16726
14121	16206	302	68	59	0	16635
14122	228	171	16164	63	0	16626
14123	186	51	16014	61	0	16312
14124	91	125	312	15601	0	16129
14125	15887	33	196	225	0	16341
14126	216	35	16026	183	0	16460
14127	187	26	205	15835	0	16253
14128	64	32	15280	222	0	15598
14129	77	27	14926	191	0	15221
14130	14490	32	301	93	0	14916
14131	216	38	15020	70	0	15344
14132	172	35	214	14332	0	14753
14133	74	48	181	14283	0	14586
14134	75	14497	60	311	0	14943
14135	70	14848	51	214	0	15183
14136	103	318	49	14488	0	14958
14137	85	185	14673	239	0	15182
14138	87	77	214	14640	0	15018
14139	83	56	170	14801	0	15110
14140	65	57	15067	381	0	15570
14141	81	54	211	15144	0	15490
14142	15332	73	194	266	0	15865
14143	251	62	15222	186	0	15721
14144	14809	63	230	107	0	15209
14145	251	49	217	14603	0	15120
14146	218	55	102	15024	0	15399
14147	112	15110	74	381	0	15677
14148	98	211	75	15130	0	15514
14149	96	184	76	15429	0	15785
14150	15196	79	84	395	0	15754
14151	238	81	93	15338	0	15750
14152	234	56	85	15326	0	15701
14153	14834	60	91	408	0	15393
14154	239	81	97	15006	0	15423
14155	232	68	105	14412	0	14817
14156	98	14938	109	385	0	15530
14157	15006	212	110	258	0	15586
14158	269	180	111	14840	0	15400
14159	233	99	90	15101	0	15523
14160	118	75	14991	414	0	15598
14161	98	67	218	14629	0	15012
14162	91	65	218	14890	0	15264
14163	14625	91	112	413	0	15241
14164	14556	82	80	270	0	14988
14165	398	81	93	14646	0	15218
14166	277	58	14694	305	0	15334
14167	111	14395	245	249	0	15000
14168	103	14663	204	136	0	15106
14169	127	354	114	14345	0	14940
14170	14399	196	59	271	0	14925
14171	243	86	77	14587	0	14993
14172	14726	79	59	272	0	15136
14173	256	91	70	14942	0	15359
14174	243	77	73	14728	0	15121
14175	14573	62	75	388	0	15098
14176	14262	92	76	235	0	14665
14177	346	14891	81	138	0	15456
14178	223	15496	53	132	0	15904
14179	109	303	74	14613	0	15099
14180	63	184	64	14796	0	15107
14181	121	73	14495	380	0	15069
14182	13157	46	211	247	0	13661
14183	196	14124	158	185	0	14663
14184	144	13295	75	137	0	13651
14185	12904	214	215	98	0	13431
14186	191	119	13079	108	0	13497
14187	160	28	12712	76	0	12976
14188	78	64	12627	58	0	12827
14189	44	11063	188	46	0	11341
14190	48	21	26	9490	0	9585
14191	7	26	10	9311	0	9354
14192	9	8	9	9360	0	9386
14193	9369	3	4	57	0	9433
14194	9144	3	8	39	0	9194
14195	47	9582	6	45	0	9680
14196	30	25	4	10156	0	10215
14197	40	25	10806	40	0	10911
14198	11	10819	22	47	0	10899
14199	10589	23	35	29	0	10676
14200	33	27	10753	14	0	10827
14201	9792	14	30	29	0	9865
14202	38	34	11013	22	0	11107
14203	31	7	24	10711	0	10773
14204	15	11060	25	31	0	11131
14205	11006	22	7	39	0	11074
14206	27	11113	9	29	0	11178
14207	11012	31	9	22	0	11074
14208	28	20	6	10901	0	10955
14209	23	9	11484	38	0	11554
14210	21	8	25	11731	0	11785
14211	13	10	15	13124	0	13162
14212	28	6	13308	92	0	13434
14213	12243	9	72	73	0	12397
14214	66	13563	42	36	0	13707
14215	13590	64	12	21	0	13687
14216	74	13650	6	24	0	13754
14217	62	80	4	13886	0	14032
14218	21	57	13776	95	0	13949
14219	16097	13	77	78	0	16265
14220	116	16796	56	39	0	17007
14221	122	118	13	16536	0	16789
14222	33	117	9	17197	0	17356
14223	17641	34	5	239	0	17919
14224	18382	18	11	149	0	18560
14225	289	19976	9	54	0	20328
14226	21771	175	15	30	0	21991
14227	21445	161	13	28	0	21647
14228	22000	42	11	31	0	22084
14229	458	136	22213	30	0	22837
14230	262	21859	211	79	0	22411
14231	62	22356	217	36	0	22671
14232	46	453	57	21210	0	21766
14233	38	263	15	21990	0	22306
14234	22120	55	20	420	0	22615
14235	236	22064	14	274	0	22588
14236	22381	233	13	70	0	22697
14237	264	236	18	21744	0	22262
14238	236	63	15	22151	0	22465
14239	21785	20	17	446	0	22268
14240	21388	29	20	281	0	21718
14241	472	29	21421	66	0	21988
14242	279	26	218	21179	0	21702
14243	79	25	21241	243	0	21588
14244	62	17	20790	230	0	21099
14245	60	26	21270	60	0	21416
14246	20710	28	456	30	0	21224
14247	250	45	268	20647	0	21210
14248	250	57	71	20257	0	20635
14249	69	42	31	21222	0	21364
14250	57	18	20990	489	0	21554
14251	46	41	241	20822	0	21150
14252	59	38	227	21120	0	21444
14253	20574	37	53	463	0	21127
14254	20385	41	32	284	0	20742
14255	20803	32	32	94	0	20961
14256	20917	42	28	68	0	21055
14257	535	40	26	20466	0	21067
14258	20714	33	36	287	0	21070
14259	336	56	28	20676	0	21096
14260	324	52	20077	323	0	20776
14261	20084	40	266	274	0	20664
14262	336	20442	236	102	0	21116
14263	314	260	91	20139	0	20804
14264	149	289	39	20020	0	20497
14265	109	20471	34	547	0	21161
14266	20320	286	42	298	0	20946
14267	327	20387	44	268	0	21026
14268	350	287	20121	103	0	20861
14269	150	303	20096	89	0	20638
14270	19531	103	486	83	0	20203
14271	20061	76	284	104	0	20525
14272	571	54	19715	112	0	20452
14273	19837	50	295	112	0	20294
14274	443	58	19891	100	0	20492
14275	19846	82	349	97	0	20374
14276	410	74	19885	132	0	20501
14277	383	65	19792	140	0	20380
14278	201	77	522	18118	0	18918
14279	165	76	381	18566	0	19188
14280	19020	65	119	548	0	19752
14281	18671	94	89	396	0	19250
14282	18985	82	90	222	0	19379
14283	19225	84	73	194	0	19576
14284	676	18705	109	151	0	19641
14285	474	299	111	18357	0	19241
14286	252	18670	111	399	0	19432
14287	241	326	125	18274	0	18966
14288	203	308	121	17512	0	18144
14289	237	112	110	17632	0	18091
14290	244	94	17056	647	0	18041
14291	16391	78	348	449	0	17266
14292	461	16681	319	286	0	17747
14293	425	17147	117	233	0	17922
14294	245	506	17054	215	0	18020
14295	235	362	344	16583	0	17524
14296	226	151	318	16493	0	17188
14297	15979	64	131	644	0	16818
14298	475	68	126	16005	0	16674
14299	493	77	124	15946	0	16640
14300	308	81	137	16068	0	16594
14301	265	82	162	16205	0	16714
14302	15487	58	175	639	0	16359
14303	15498	62	191	450	0	16201
14304	15855	53	155	216	0	16279
14305	724	46	131	15741	0	16642
14306	16051	68	173	420	0	16712
14307	475	53	149	16373	0	17050
14308	455	56	185	16789	0	17485
14309	266	59	15855	672	0	16852
14310	206	51	15306	474	0	16037
14311	220	66	14545	197	0	15028
14312	13875	48	552	183	0	14658
14313	419	66	393	13181	0	14059
14314	422	13834	140	368	0	14764
14315	14122	244	130	344	0	14840
14316	445	235	13822	204	0	14706
14317	13547	77	300	172	0	14096
14318	413	13051	321	147	0	13932
14319	9650	169	93	90	0	10002
14320	276	158	87	9586	0	10107
14321	9265	41	72	209	0	9587
14322	263	8941	66	241	0	9511
14323	216	8699	72	119	0	9106
14324	7467	224	41	67	0	7799
14325	163	7273	116	77	0	7629
14326	78	5250	17	28	0	5373
14327	34	5341	28	27	0	5430
14328	4791	104	264	21	0	5180
14329	4560	43	15	21	0	4639
14330	4571	16	8	8	0	4603
14331	96	5	13	4493	0	4607
14332	50	8	14	4579	0	4651
14333	34	5	4514	83	0	4636
14334	19	10	56	4538	0	4623
14335	27	6	4557	68	0	4658
14336	17	11	62	4474	0	4564
14337	21	6	38	4546	0	4611
14338	4489	5	19	94	0	4607
14339	4442	13	13	50	0	4518
14340	92	4481	11	32	0	4616
14341	51	53	10	4436	0	4550
14342	26	39	4496	69	0	4630
14343	16	25	53	4516	0	4610
14344	21	12	42	4528	0	4603
14345	21	15	15	4597	0	4648
14346	23	17	4522	96	0	4658
14347	21	17	4371	55	0	4464
14348	4307	14	74	28	0	4423
14349	59	11	45	4443	0	4558
14350	58	10	4244	61	0	4373
14351	4151	16	49	50	0	4266
14352	62	4327	40	37	0	4466
14353	4412	46	27	21	0	4506
14354	76	38	4377	30	0	4521
14355	4132	21	45	29	0	4227
14356	61	13	42	4156	0	4272
14357	49	7	4166	55	0	4277
14358	24	4165	46	49	0	4284
14359	4156	109	44	27	0	4336
14360	40	34	26	4022	0	4122
14361	52	18	16	3974	0	4060
14362	33	4039	9	68	0	4149
14363	18	43	13	4062	0	4136
14364	30	43	4013	58	0	4144
14365	18	4008	39	51	0	4116
14366	4016	33	40	30	0	4119
14367	43	42	14	3935	0	4034
14368	49	22	16	3925	0	4012
14369	29	16	3955	75	0	4075
14370	18	18	37	3948	0	4021
14371	43	16	4045	45	0	4149
14372	21	4091	42	45	0	4199
14373	3808	39	72	46	0	3965
14374	3776	40	18	17	0	3851
14375	3808	20	21	18	0	3867
14376	69	4064	13	22	0	4168
14377	53	31	14	3903	0	4001
14378	33	32	12	3919	0	3996
14379	27	14	17	3901	0	3959
14380	3973	9	19	68	0	4069
14381	3941	10	9	56	0	4016
14382	66	10	16	3936	0	4028
14383	50	9	4231	53	0	4343
14384	25	14	32	4132	0	4203
14385	21	14	29	4135	0	4199
14386	26	9	19	4159	0	4213
14387	30	12	17	4276	0	4335
14388	4205	15	8	77	0	4305
14389	39	12	14	4293	0	4358
14390	43	11	14	4224	0	4292
14391	17	4279	14	169	0	4479
14392	27	33	13	4470	0	4543
14393	11	4648	16	62	0	4737
14394	10	41	20	4623	0	4694
14395	4571	43	13	61	0	4688
14396	41	4733	14	57	0	4845
14397	4684	39	16	23	0	4762
14398	65	43	4790	18	0	4916
14399	56	19	45	4675	0	4795
14400	30	9	4786	67	0	4892
14401	15	13	58	4709	0	4795
14402	22	24	42	4665	0	4753
14403	21	4774	20	87	0	4902
14404	17	4809	21	58	0	4905
14405	8	4516	11	31	0	4566
14406	4354	49	13	19	0	4435
14407	24	3867	6	18	0	3915
14408	14	3815	5	9	0	3843
14409	3	75	5	3901	0	3984
14410	3956	13	1	25	0	3995
14411	17	4136	3	21	0	4177
14412	4194	18	3	13	0	4228
14413	4133	16	3	8	0	4160
14414	38	5	4457	8	0	4508
14415	16	4	23	4459	0	4502
14416	4	9	19	4567	0	4599
14417	9	4	3	4626	0	4642
14418	7	5	5	4592	0	4609
14419	8	6	4444	39	0	4497
14420	10	5	4161	26	0	4202
14421	4224	4	31	16	0	4275
14422	13	4399	14	13	0	4439
14423	12	4359	5	5	0	4381
14424	4355	26	2	11	0	4394
14425	16	4323	4	81	0	4424
14426	19	21	1	4474	0	4515
14427	4530	19	3	28	0	4580
14428	25	7	4667	25	0	4724
14429	20	7	20	4611	0	4658
14430	10	3	4778	24	0	4815
14431	4613	4	19	28	0	4664
14432	16	8	5386	10	0	5420
14433	5452	9	16	14	0	5491
14434	5589	9	20	14	0	5632
14435	5611	7	5	9	0	5632
14436	5739	11	4	9	0	5763
14437	5799	11	6	9	0	5825
14438	46	5	4	5810	0	5865
14439	6246	6	3	25	0	6280
14440	19	7	6	6236	0	6268
14441	27	5	4	6456	0	6492
14442	11	4	3	6637	0	6655
14443	10	7	6646	44	0	6707
14444	6	9	17	6463	0	6495
14445	6	8	21	6625	0	6660
14446	10	5	6640	48	0	6703
14447	6115	7	21	38	0	6181
14448	17	6	25	6800	0	6848
14449	40	5	6835	26	0	6906
14450	13	5	6717	27	0	6762
14451	28	8	39	6664	0	6739
14452	22	6	7153	28	0	7209
14453	13	5	24	7341	0	7383
14454	10	8	28	7268	0	7314
14455	9	7392	6	49	0	7456
14456	8	7437	10	40	0	7495
14457	7713	34	6	27	0	7780
14458	21	27	6	7663	0	7717
14459	29	80	12	7497	0	7618
14460	14	7	8	7705	0	7734
14461	25	2	7956	50	0	8033
14462	9	8	25	7792	0	7834
14463	7887	7	25	35	0	7954
14464	34	5	8215	36	0	8290
14465	30	10	22	8313	0	8375
14466	12	7	28	8393	0	8440
14467	15	4	10	8477	0	8506
14468	12	9718	11	53	0	9794
14469	9789	44	8	47	0	9888
14470	10184	49	8	14	0	10255
14471	122	10659	7	29	0	10817
14472	66	77	12	11470	0	11625
14473	49	53	11706	107	0	11915
14474	26	12	11578	92	0	11708
14475	11615	10	186	42	0	11853
14476	116	3	107	12045	0	12271
14477	12893	5	33	127	0	13058
14478	129	13284	19	124	0	13556
14479	118	13582	15	38	0	13753
14480	13467	230	11	31	0	13739
14481	129	14215	14	27	0	14385
14482	119	153	11	14104	0	14387
14483	39	124	11	13530	0	13704
14484	17	14595	10	242	0	14864
14485	14559	141	11	135	0	14846
14486	155	117	14495	37	0	14804
14487	13906	23	132	24	0	14085
14488	165	14	14548	15	0	14742
14489	13532	16	160	36	0	13744
14490	184	5	14661	24	0	14874
14491	132	14289	162	26	0	14609
14492	30	213	167	14208	0	14618
14493	14089	118	29	156	0	14392
14494	161	31	13989	127	0	14308
14495	141	12	14209	30	0	14392
14496	41	10	250	13750	0	14051
14497	46	16	14386	155	0	14603
14498	23	11	171	14019	0	14224
14499	26	24	129	13989	0	14168
14500	31	18	14291	261	0	14601
14501	21	26	153	14239	0	14439
14502	14528	18	127	187	0	14860
14503	157	14619	41	150	0	14967
14504	14766	155	29	45	0	14995
14505	188	132	22	14497	0	14839
14506	14524	47	31	167	0	14769
14507	14807	34	29	135	0	15005
14508	277	27	35	14939	0	15278
14509	160	15457	33	169	0	15819
14510	15561	156	38	136	0	15891
14511	178	155	15278	65	0	15676
14512	161	51	15176	42	0	15430
14513	14933	37	266	32	0	15268
14514	175	40	158	15070	0	15443
14515	160	33	15355	175	0	15723
14516	65	32	172	15251	0	15520
14517	15328	38	158	200	0	15724
14518	15398	47	72	158	0	15675
14519	15485	36	54	73	0	15648
14520	304	16244	49	69	0	16666
14521	180	172	47	16293	0	16692
14522	86	147	54	16310	0	16597
14523	16254	62	65	290	0	16671
14524	182	16337	51	199	0	16769
14525	16616	169	48	86	0	16919
14526	203	190	53	16258	0	16704
14527	16391	57	61	198	0	16707
14528	225	51	16073	177	0	16526
14529	180	16299	181	83	0	16743
14530	110	246	162	15547	0	16065
14531	70	16659	78	173	0	16980
14532	79	192	61	16058	0	16390
14533	16007	141	66	203	0	16417
14534	215	63	15755	173	0	16206
14535	15357	41	190	90	0	15678
14536	212	16186	175	137	0	16710
14537	206	172	76	16413	0	16867
14538	103	148	81	16582	0	16914
14539	16213	60	67	295	0	16635
14540	233	52	16403	187	0	16875
14541	190	57	197	16123	0	16567
14542	124	50	168	16091	0	16433
14543	112	42	77	16139	0	16370
14544	89	55	80	16399	0	16623
14545	16250	52	64	336	0	16702
14546	15913	58	55	213	0	16239
14547	352	49	16565	90	0	17056
14548	221	59	16213	159	0	16652
14549	16702	51	283	101	0	17137
14550	17346	42	177	89	0	17654
14551	336	59	65	17169	0	17629
14552	250	49	54	16883	0	17236
14553	16633	59	53	327	0	17072
14554	242	17206	56	212	0	17716
14555	231	170	61	17235	0	17697
14556	141	159	63	17442	0	17805
14557	103	63	17101	334	0	17601
14558	104	47	191	17063	0	17405
14559	99	49	17551	262	0	17961
14560	108	37	219	17519	0	17883
14561	17162	46	191	261	0	17660
14562	232	39	79	17412	0	17762
14563	237	38	17352	254	0	17881
14564	99	17059	198	264	0	17620
14565	87	193	290	17636	0	18206
14566	117	155	17999	243	0	18514
14567	99	18082	184	248	0	18613
14568	93	150	157	17152	0	17552
14569	107	139	17072	195	0	17513
14570	13753	58	128	211	0	14150
14571	138	16139	126	95	0	16498
14572	117	15441	28	68	0	15654
14573	43	15782	24	48	0	15897
14574	74	303	15	15090	0	15482
14575	59	81	15835	102	0	16077
14576	31	15460	89	107	0	15687
14577	66	96	126	14664	0	14952
14578	15842	118	13	67	0	16040
14579	93	17	10	20611	0	20731
14580	131	14	23625	218	0	23988
14581	19	23715	228	202	0	24164
14582	23223	239	194	45	0	23701
14583	233	24026	43	39	0	24341
14584	236	276	23101	37	0	23650
14585	41	23525	235	44	0	23845
14586	181	277	192	22931	0	23581
14587	36	210	23069	237	0	23552
14588	16	23012	248	239	0	23515
14589	19	284	219	22061	0	22583
14590	26	221	60	22318	0	22625
14591	8	22908	23	418	0	23357
14592	17	251	29	23116	0	23413
14593	14	233	22829	284	0	23360
14594	37	55	22847	225	0	23164
14595	8	41	418	22741	0	23208
14596	22625	38	233	272	0	23168
14597	22276	39	69	239	0	22623
14598	419	37	26	22156	0	22638
14599	229	22384	40	263	0	22916
14600	53	256	41	22606	0	22956
14601	22177	230	60	288	0	22755
14602	254	84	65	22027	0	22430
14603	237	58	50	22290	0	22635
14604	22091	63	36	440	0	22630
14605	252	22215	49	294	0	22810
14606	224	289	41	22151	0	22705
14607	21832	257	32	293	0	22414
14608	270	70	21191	275	0	21806
14609	20765	86	258	99	0	21208
14610	284	61	216	20974	0	21535
14611	21112	61	56	377	0	21606
14612	20907	56	37	280	0	21280
14613	20623	80	63	124	0	20890
14614	472	21003	63	102	0	21640
14615	298	266	20656	70	0	21290
14616	93	20906	274	95	0	21368
14617	20450	296	227	82	0	21055
14618	310	20588	67	96	0	21061
14619	282	311	42	20503	0	21138
14620	19761	249	55	318	0	20383
14621	298	19931	36	295	0	20560
14622	307	306	19965	132	0	20710
14623	123	267	265	19718	0	20373
14624	71	122	20047	350	0	20590
14625	89	19772	295	324	0	20480
14626	72	336	244	19379	0	20031
14627	91	274	109	19413	0	19887
14628	85	113	51	19777	0	20026
14629	102	59	79	19270	0	19510
14630	113	19378	78	543	0	20112
14631	19069	308	57	363	0	19797
14632	336	265	19147	203	0	19951
14633	302	132	356	19082	0	19872
14634	19026	149	350	343	0	19868
14635	418	219	19238	310	0	20185
14636	364	18698	342	169	0	19573
14637	142	478	323	18206	0	19149
14638	125	384	18545	369	0	19423
14639	104	18580	337	381	0	19402
14640	17876	388	354	242	0	18860
14641	328	18497	191	187	0	19203
14642	295	473	109	17727	0	18604
14643	120	349	106	18355	0	18930
14644	17950	218	99	663	0	18930
14645	310	18082	143	486	0	19021
14646	283	398	200	18158	0	19039
14647	17438	322	245	439	0	18444
14648	17084	146	205	434	0	17869
14649	606	17070	111	315	0	18102
14650	17058	375	73	215	0	17721
14651	17031	365	43	221	0	17660
14652	624	244	60	16820	0	17748
14653	373	223	16636	476	0	17708
14654	280	140	340	16160	0	16920
14655	273	129	269	16309	0	16980
14656	196	100	15967	730	0	16993
14657	202	15839	334	486	0	16861
14658	236	479	258	15476	0	16449
14659	193	359	112	15686	0	16350
14660	215	172	114	15729	0	16230
14661	270	123	161	15554	0	16108
14662	219	15366	184	666	0	16435
14663	15446	329	136	433	0	16344
14664	15310	253	93	317	0	15973
14665	15111	132	42	212	0	15497
14666	763	14263	44	195	0	15265
14667	446	436	62	14156	0	15100
14668	190	402	14121	411	0	15124
14669	190	259	361	13794	0	14604
14670	239	14217	241	407	0	15104
14671	13805	422	109	310	0	14646
14672	13611	375	91	254	0	14331
14673	13443	161	72	235	0	13911
14674	622	13329	113	171	0	14235
14675	286	12765	177	192	0	13420
14676	174	13032	194	237	0	13637
14677	132	517	12831	217	0	13697
14678	103	519	10886	369	0	11877
14679	128	1749	336	4656	0	6869
14680	3092	62	139	40	0	3333
14681	2739	10	9	22	0	2780
14682	40	13	4	2778	0	2835
14683	26	7	12	2743	0	2788
14684	14	10	6	2797	0	2827
14685	9	11	6	2861	0	2887
14686	2895	10	11	47	0	2963
14687	2989	13	5	28	0	3035
14688	46	3079	10	24	0	3159
14689	3353	37	9	19	0	3418
14690	3300	31	6	22	0	3359
14691	3334	16	7	28	0	3385
14692	59	18	3255	23	0	3355
14693	3255	8	29	15	0	3307
14694	43	3451	16	16	0	3526
14695	40	36	7	3590	0	3673
14696	24	31	6	3606	0	3667
14697	21	3599	5	75	0	3700
14698	17	43	8	3713	0	3781
14699	3643	34	8	52	0	3737
14700	44	17	6	3813	0	3880
14701	42	5	3848	59	0	3954
14702	3794	13	40	46	0	3893
14703	42	4027	31	29	0	4129
14704	37	42	14	4031	0	4124
14705	22	40	3	3944	0	4009
14706	19	20	4	3944	0	3987
14707	11	17	3911	87	0	4026
14708	13	3879	35	57	0	3984
14709	20	41	28	3961	0	4050
14710	27	36	3900	42	0	4005
14711	19	21	38	3817	0	3895
14712	18	17	3807	60	0	3902
14713	24	10	41	3736	0	3811
14714	20	3652	34	54	0	3760
14715	11	45	12	3643	0	3711
14716	3573	38	8	55	0	3674
14717	3560	18	7	51	0	3636
14718	81	17	3623	24	0	3745
14719	41	9	3349	14	0	3413
14720	18	12	3687	19	0	3736
14721	18	11	54	3569	0	3652
14722	20	9	33	3734	0	3796
14723	15	14	10	3841	0	3880
14724	10	3944	3	87	0	4044
14725	16	37	8	3940	0	4001
14726	16	39	9	3948	0	4012
14727	15	21	8	4069	0	4113
14728	4038	11	7	96	0	4152
14729	3996	12	12	62	0	4082
14730	80	9	4094	33	0	4216
14731	61	8	4040	22	0	4131
14732	3975	17	61	26	0	4079
14733	4103	11	45	26	0	4185
14734	80	5	4195	19	0	4299
14735	53	10	4220	23	0	4306
14736	4160	12	67	18	0	4257
14737	4255	12	47	21	0	4335
14738	81	12	4360	22	0	4475
14739	48	8	40	4311	0	4407
14740	19	8	44	4266	0	4337
14741	15	4497	17	76	0	4605
14742	14	44	15	4689	0	4762
14743	17	48	5108	60	0	5233
14744	9	14	62	5122	0	5207
14745	12	5	54	5220	0	5291
14746	16	15	5204	109	0	5344
14747	4950	12	56	76	0	5094
14748	5181	12	54	25	0	5272
14749	100	13	22	4976	0	5111
14750	59	6	20	5111	0	5196
14751	5062	8	15	104	0	5189
14752	4960	15	21	70	0	5066
14753	4923	15	28	38	0	5004
14754	5116	7	18	34	0	5175
14755	106	5022	19	33	0	5180
14756	5046	56	15	25	0	5142
14757	70	5058	12	32	0	5172
14758	60	61	20	5005	0	5146
14759	19	52	20	5027	0	5118
14760	24	4979	18	117	0	5138
14761	27	53	22	5038	0	5140
14762	21	50	26	4923	0	5020
14763	17	4977	36	111	0	5141
14764	19	54	25	4935	0	5033
14765	27	57	19	4929	0	5032
14766	25	10	26	4999	0	5060
14767	26	6	4909	125	0	5066
14768	24	4779	68	81	0	4952
14769	31	54	59	4625	0	4769
14770	28	4759	33	74	0	4894
14771	4741	50	26	68	0	4885
14772	79	43	4693	32	0	4847
14773	70	17	4629	36	0	4752
14774	4475	10	104	39	0	4628
14775	91	17	70	4738	0	4916
14776	72	9	4644	70	0	4795
14777	45	11	4452	73	0	4581
14778	33	13	92	4338	0	4476
14779	4310	16	56	77	0	4459
14780	4249	21	21	63	0	4354
14781	115	16	12	4519	0	4662
14782	70	11	4496	91	0	4668
14783	25	4769	57	88	0	4939
14784	30	62	50	4810	0	4952
14785	37	48	4795	88	0	4968
14786	30	4664	58	284	0	5036
14787	24	57	48	4600	0	4729
14788	4506	43	36	79	0	4664
14789	54	17	11	4477	0	4559
14790	50	4547	17	76	0	4690
14791	4572	44	24	54	0	4694
14792	62	45	4925	36	0	5068
14793	47	4829	47	42	0	4965
14794	31	51	4792	24	0	4898
14795	4403	35	98	24	0	4560
14796	56	13	46	4373	0	4488
14797	42	12	25	4621	0	4700
14798	4657	11	12	83	0	4763
14799	56	5	18	4703	0	4782
14800	45	13	4559	55	0	4672
14801	4326	8	49	57	0	4440
14802	54	4530	46	30	0	4660
14803	55	49	15	4453	0	4572
14804	4469	33	17	64	0	4583
14805	39	4452	16	66	0	4573
14806	46	43	20	4489	0	4598
14807	4498	40	11	64	0	4613
14808	58	13	16	4471	0	4558
14809	43	4615	21	60	0	4739
14810	20	56	4630	50	0	4756
14811	26	47	47	4602	0	4722
14812	24	14	48	4587	0	4673
14813	4700	18	16	92	0	4826
14814	60	15	11	4729	0	4815
14815	4754	9	15	60	0	4838
14816	4680	17	21	60	0	4778
14817	87	16	15	4678	0	4796
14818	62	4795	16	56	0	4929
14819	35	54	8	4830	0	4927
14820	4585	49	14	68	0	4716
14821	57	4605	15	62	0	4739
14822	45	4467	9	24	0	4545
14823	4531	63	9	29	0	4632
14824	4423	32	17	16	0	4488
14825	77	4474	12	20	0	4583
14826	4568	55	8	23	0	4654
14827	4542	34	13	23	0	4612
14828	88	13	9	4617	0	4727
14829	45	18	4828	58	0	4949
14830	17	6	44	4889	0	4956
14831	25	4	5214	71	0	5314
14832	14	16	48	5178	0	5256
14833	14	14	5316	59	0	5403
14834	5096	51	61	54	0	5262
14835	96	8	42	5046	0	5192
14836	5441	8	12	61	0	5522
14837	68	27	60	5228	0	5383
14838	50	5504	10	68	0	5632
14839	5544	54	7	48	0	5653
14840	67	50	5575	19	0	5711
14841	5130	59	43	9	0	5241
14842	49	5115	33	16	0	5213
14843	4772	39	68	7	0	4886
14844	4887	29	3	3	0	4922
14845	60	4928	3	10	0	5001
14846	40	28	3	5061	0	5132
14847	5017	31	3	39	0	5090
14848	36	5104	2	46	0	5188
14849	44	39	3	5128	0	5214
14850	5108	39	1	47	0	5195
14851	42	6	2	5120	0	5170
14852	43	7	3	5061	0	5114
14853	7	7	2	5172	0	5188
14854	12	4	5075	80	0	5171
14855	13	7	38	5055	0	5113
14856	5095	7	38	51	0	5191
14857	51	7	5057	46	0	5161
14858	40	9	41	4988	0	5078
14859	15	3	36	5068	0	5122
14860	20	5	5063	80	0	5168
14861	4878	10	34	55	0	4977
14862	5117	6	50	12	0	5185
14863	87	2	5083	14	0	5186
14864	42	7	46	4927	0	5022
14865	14	9	41	5053	0	5117
14866	16	3	5254	80	0	5353
14867	19	6	43	5227	0	5295
14868	14	7	44	5257	0	5322
14869	17	6	5493	93	0	5609
14870	5290	1	51	52	0	5394
14871	51	13	47	5514	0	5625
14872	5495	6	15	54	0	5570
14873	5491	8	14	55	0	5568
14874	102	6	5489	22	0	5619
14875	68	7	47	5302	0	5424
14876	5313	8	46	66	0	5433
14877	69	5459	14	60	0	5602
14878	59	63	5	5506	0	5633
14879	24	51	15	5451	0	5541
14880	19	11	4	5679	0	5713
14881	15	14	5385	120	0	5534
14882	5091	10	65	66	0	5232
14883	72	6	54	5039	0	5171
14884	59	6	12	5135	0	5212
14885	29	4	5119	118	0	5270
14886	20	7	69	4971	0	5067
14887	20	5	57	5013	0	5095
14888	4953	7	21	123	0	5104
14889	73	5179	13	78	0	5343
14890	69	54	5180	31	0	5334
14891	5019	48	66	37	0	5170
14892	67	9	59	4862	0	4997
14893	66	2	5056	80	0	5204
14894	31	7	5179	69	0	5286
14895	23	5	108	5127	0	5263
14896	25	3	5206	90	0	5324
14897	29	5	5163	79	0	5276
14898	14	5219	118	42	0	5393
14899	28	60	66	5299	0	5453
14900	26	48	5370	88	0	5532
14901	23	20	75	5339	0	5457
14902	5568	9	60	88	0	5725
14903	75	10	27	5518	0	5630
14904	64	9	18	5621	0	5712
14905	5518	9	16	126	0	5669
14906	5364	14	28	81	0	5487
14907	118	8	20	5823	0	5969
14908	64	13	5830	107	0	6014
14909	31	5684	77	92	0	5884
14910	19	75	72	5691	0	5857
14911	5681	47	20	106	0	5854
14912	5641	19	16	96	0	5772
14913	126	5556	28	56	0	5766
14914	72	5671	29	39	0	5811
14915	5600	105	22	44	0	5771
14916	5561	48	24	53	0	5686
14917	134	9	5797	38	0	5978
14918	69	86	88	5475	0	5718
14919	20	5865	68	106	0	6059
14920	5923	66	37	72	0	6098
14921	91	44	25	5817	0	5977
14922	55	5946	33	109	0	6143
14923	32	70	5993	77	0	6172
14924	32	45	91	5665	0	5833
14925	25	6187	66	103	0	6381
14926	6135	72	36	72	0	6315
14927	6104	51	25	45	0	6225
14928	110	6075	20	60	0	6265
14929	5570	64	25	38	0	5697
14930	5491	37	18	41	0	5587
14931	109	5537	18	44	0	5708
14932	61	5618	18	37	0	5734
14933	29	121	24	5362	0	5536
14934	5346	40	17	82	0	5485
14935	79	17	5790	52	0	5938
14936	5322	18	63	24	0	5427
14937	72	5583	38	32	0	5725
14938	5530	68	25	29	0	5652
14939	5497	44	23	30	0	5594
14940	5483	23	16	22	0	5544
14941	99	18	20	5440	0	5577
14942	55	5511	19	69	0	5654
14943	5507	74	19	46	0	5646
14944	73	42	5554	32	0	5701
14945	52	5540	66	33	0	5691
14946	29	64	39	5449	0	5581
14947	30	32	5401	67	0	5530
14948	22	27	5447	39	0	5535
14949	25	22	74	5373	0	5494
14950	38	22	34	5481	0	5575
14951	32	20	17	5556	0	5625
14952	30	26	16	5514	0	5586
14953	32	5454	16	93	0	5595
14954	28	5580	13	50	0	5671
14955	5662	87	15	29	0	5793
14956	81	40	14	5606	0	5741
14957	58	28	5	5625	0	5716
14958	33	26	15	5710	0	5784
14959	5681	14	17	94	0	5806
14960	5656	27	13	51	0	5747
14961	92	27	13	5676	0	5808
14962	5889	20	14	69	0	5992
14963	5834	23	11	43	0	5911
14964	6069	26	17	22	0	6134
14965	99	23	16	6043	0	6181
14966	65	21	5776	55	0	5917
14967	38	23	5565	42	0	5668
14968	29	23	5856	21	0	5929
14969	27	12	5881	28	0	5948
14970	33	25	59	5794	0	5911
14971	5858	24	33	52	0	5967
14972	5776	20	14	32	0	5842
14973	69	22	5899	19	0	6009
14974	47	13	6226	25	0	6311
14975	23	6809	61	26	0	6919
14976	11	40	40	6816	0	6907
14977	6834	26	18	48	0	6926
14978	40	18	6843	34	0	6935
14979	6652	7	37	20	0	6716
14980	37	7113	25	24	0	7199
14981	27	36	12	7250	0	7325
14982	15	20	14	7566	0	7615
14983	11	18	9	7575	0	7613
14984	7672	15	9	69	0	7765
14985	55	8	8	7709	0	7780
14986	50	9	11	7664	0	7734
14987	7673	11	8	78	0	7770
14988	57	13	2	7677	0	7749
14989	52	15	7742	57	0	7866
14990	7562	13	42	48	0	7665
14991	57	13	33	7832	0	7935
14992	54	13	16	7729	0	7812
14993	28	7800	17	80	0	7925
14994	7767	43	14	62	0	7886
14995	7806	41	12	27	0	7886
14996	92	18	11	7995	0	8116
14997	63	10	7995	55	0	8123
14998	7461	5	53	56	0	7575
14999	65	11	8051	25	0	8152
15000	57	10	50	7871	0	7988
15001	30	14	43	8354	0	8441
15002	8353	7	21	112	0	8493
15003	76	7	20	9517	0	9620
15004	69	14	9551	77	0	9711
15005	9478	8	76	84	0	9646
15006	89	9	10497	26	0	10621
15007	88	9	10559	80	0	10736
15008	10963	5	130	26	0	11124
15009	94	13	71	11134	0	11312
15010	80	11785	17	82	0	11964
15011	11778	67	15	93	0	11953
15012	11652	79	16	28	0	11775
15013	152	12	11766	23	0	11953
15014	11622	8	75	26	0	11731
15015	86	5	76	12006	0	12173
15016	93	7	12639	88	0	12827
15017	16	12447	89	91	0	12643
15018	12252	68	77	110	0	12507
15019	76	12684	12	30	0	12802
15020	76	103	12	12703	0	12894
15021	17	69	12	12697	0	12795
15022	17	15	5	12770	0	12807
15023	12	8	11	12463	0	12494
15024	11	12574	10	144	0	12739
15025	23	56	12380	84	0	12543
15026	13	12539	62	28	0	12642
15027	12402	64	75	24	0	12565
15028	72	64	14	12340	0	12490
15029	12520	6	15	76	0	12617
15030	72	9	11	12450	0	12542
15031	13087	3	10	76	0	13176
15032	72	13183	11	223	0	13489
15033	13762	58	19	24	0	13863
15034	13646	68	13	31	0	13758
15035	13187	14	21	24	0	13246
15036	13333	13	17	17	0	13380
15037	137	13361	12	37	0	13547
15038	87	58	13356	20	0	13521
15039	34	69	68	13294	0	13465
15040	13317	14	73	81	0	13485
15041	13521	15	23	77	0	13636
15042	134	12	18	14113	0	14277
15043	95	13	14856	95	0	15059
15044	35	12	87	14548	0	14682
15045	25	15302	91	103	0	15521
15046	15294	91	18	101	0	15504
15047	107	99	18	15359	0	15583
15048	105	16213	21	124	0	16463
15049	31	16856	13	122	0	17022
15050	31	17219	27	78	0	17355
15051	39	204	20	17364	0	17627
15052	17471	114	23	129	0	17737
15053	123	17538	21	175	0	17857
15054	124	122	18	17839	0	18103
15055	17647	106	17	139	0	17909
15056	132	24	22	17766	0	17944
15057	17793	23	23	138	0	17977
15058	17788	22	21	137	0	17968
15059	241	18579	24	59	0	18903
15060	157	125	24	17960	0	18266
15061	57	18730	23	119	0	18929
15062	18411	128	30	118	0	18687
15063	18245	133	29	38	0	18445
15064	18470	34	28	43	0	18575
15065	259	29	28	18719	0	19035
15066	178	37	18744	134	0	19093
15067	18231	32	128	145	0	18536
15068	18636	33	130	58	0	18857
15069	265	40	32	18300	0	18637
15070	165	18924	29	146	0	19264
15071	76	147	26	18802	0	19051
15072	60	151	28	19286	0	19525
15073	19232	76	34	258	0	19600
15074	18711	74	24	162	0	18971
15075	282	55	18557	70	0	18964
15076	165	63	123	18256	0	18607
15077	18292	62	122	173	0	18649
15078	179	75	35	18689	0	18978
15079	169	62	18497	206	0	18934
15080	107	17983	119	193	0	18402
15081	89	18589	113	103	0	18894
15082	20318	245	21	80	0	20664
15083	220	146	23	21242	0	21631
15084	190	67	15	23621	0	23893
15085	23589	56	13	411	0	24069
15086	321	70	23854	221	0	24466
15087	263	48	229	23556	0	24096
15088	113	53	23915	296	0	24377
15089	99	23809	248	262	0	24418
15090	24293	255	196	102	0	24846
15091	24456	215	47	72	0	24790
15092	24877	67	40	74	0	25058
15093	518	68	24449	83	0	25118
15094	24527	68	237	85	0	24917
15095	25111	62	190	71	0	25434
15096	499	54	50	24801	0	25404
15097	24479	67	64	290	0	24900
15098	339	66	24581	237	0	25223
15099	23906	75	245	102	0	24328
15100	340	62	24702	98	0	25202
15101	264	24693	229	126	0	25312
15102	146	501	191	22569	0	23407
15103	119	23884	59	251	0	24313
15104	120	267	23406	211	0	24004
15105	104	23579	225	146	0	24054
15106	22208	241	169	127	0	22745
15107	249	21875	54	98	0	22276
15108	209	21598	54	95	0	21956
15109	136	359	21412	67	0	21974
15110	91	210	212	21003	0	21516
15111	21194	92	185	235	0	21706
15112	266	60	21313	239	0	21878
15113	245	21389	226	133	0	21993
15114	168	230	184	20881	0	21463
15115	138	194	21186	284	0	21802
15116	136	68	20908	275	0	21387
15117	153	54	409	21299	0	21915
15118	159	65	21815	303	0	22342
15119	164	89	364	19409	0	20026
15120	145	20739	287	255	0	21426
15121	186	272	104	20362	0	20924
15122	193	21059	116	239	0	21607
15123	216	273	89	20896	0	21474
15124	20856	219	85	276	0	21436
15125	372	89	99	20474	0	21034
15126	347	20697	100	296	0	21440
15127	206	248	106	20981	0	21541
15128	210	231	20881	308	0	21630
15129	197	85	310	20992	0	21584
15130	20992	118	282	297	0	21689
15131	354	93	20414	263	0	21124
15132	283	141	319	20091	0	20834
15133	19661	118	270	318	0	20367
15134	307	19723	145	276	0	20451
15135	298	335	124	19614	0	20371
15136	19741	308	127	274	0	20450
15137	351	161	131	19853	0	20496
15138	313	137	19804	306	0	20560
15139	19041	144	307	288	0	19780
15140	346	19682	302	135	0	20465
15141	270	19797	192	135	0	20394
15142	19468	419	166	174	0	20227
15143	18814	244	148	140	0	19346
15144	432	157	138	18555	0	19282
15145	18344	133	141	257	0	18875
15146	358	120	18404	279	0	19161
15147	17935	108	308	190	0	18541
15148	271	17377	311	219	0	18178
15149	17203	256	192	149	0	17800
15150	341	205	17450	179	0	18175
15151	272	183	292	16866	0	17613
15152	152	155	269	16774	0	17350
15153	168	204	164	16025	0	16561
15154	149	17014	147	422	0	17732
15155	17186	269	110	270	0	17835
15156	381	234	140	15956	0	16711
15157	337	16699	145	309	0	17490
15158	17825	261	150	252	0	18488
15159	16902	224	153	205	0	17484
15160	17503	107	196	196	0	18002
15161	17430	98	147	222	0	17897
15162	17374	108	160	188	0	17830
15163	491	123	182	17027	0	17823
15164	363	144	166	17084	0	17757
15165	16707	168	133	434	0	17442
15166	351	166	121	16745	0	17383
15167	325	210	129	16799	0	17463
15168	185	199	16376	445	0	17205
15169	16156	172	292	323	0	16943
15170	16324	180	290	224	0	17018
15171	16548	226	147	182	0	17103
15172	447	241	144	15455	0	16287
15173	280	16257	151	290	0	16978
15174	17496	294	139	319	0	18248
15175	17159	257	134	225	0	17775
15176	553	151	151	18487	0	19342
15177	18786	157	158	374	0	19475
15178	458	167	17533	403	0	18561
15179	377	18780	350	242	0	19749
15180	268	19415	360	230	0	20273
15181	428	506	18911	220	0	20065
15182	131	16745	304	199	0	17379
15183	129	15417	282	191	0	16019
15184	12929	260	158	100	0	13447
15185	143	13111	62	108	0	13424
15186	197	165	62	13001	0	13425
15187	13519	170	31	179	0	13899
15188	194	62	13491	189	0	13936
15189	13566	73	115	121	0	13875
15190	165	93	13733	92	0	14083
15191	215	41	13546	94	0	13896
15192	13391	47	252	76	0	13766
15193	170	27	14174	113	0	14484
15194	195	13412	113	71	0	13791
15195	51	167	164	13341	0	13723
15196	13280	144	87	146	0	13657
15197	169	13068	18	162	0	13417
15198	141	116	33	13166	0	13456
15199	69	141	13259	150	0	13619
15200	123	34	85	13329	0	13571
15201	13070	31	138	156	0	13395
15202	154	34	12954	171	0	13313
15203	215	35	97	12838	0	13185
15204	13062	65	120	116	0	13363
15205	13419	101	32	164	0	13716
15206	277	37	24	13494	0	13832
15207	198	34	22	13577	0	13831
15208	77	25	14403	244	0	14749
15209	108	30	14549	155	0	14842
15210	14345	24	207	50	0	14626
15211	14944	27	131	52	0	15154
15212	253	15008	31	39	0	15331
15213	15190	90	53	33	0	15366
15214	15297	119	42	60	0	15518
15215	248	49	17373	63	0	17733
15216	170	17719	122	60	0	18071
15217	17338	111	112	16	0	17577
15218	17291	118	27	18	0	17454
15219	17929	32	15	26	0	18002
15220	242	13	18	17700	0	17973
15221	154	20	16	17672	0	17862
15222	48	17923	18	218	0	18207
15223	30	125	17	18154	0	18326
15224	17939	113	28	162	0	18242
15225	135	29	9	18137	0	18310
15226	141	19	17811	251	0	18222
15227	52	22	17729	133	0	17936
15228	23	10	228	17667	0	17928
15229	41	17	18042	148	0	18248
15230	47	17	17963	139	0	18166
15231	40	11	249	17406	0	17706
15232	31	15	147	18233	0	18426
15233	33	14	18674	239	0	18960
15234	60	16	18803	173	0	19052
15235	44	19127	242	51	0	19464
15236	19144	134	140	37	0	19455
15237	142	19979	43	100	0	20264
15238	20293	156	34	27	0	20510
15239	20232	138	19	37	0	20426
15240	244	21084	32	97	0	21457
15241	21175	179	30	25	0	21409
15242	203	155	20	20764	0	21142
15243	196	41	21415	168	0	21820
15244	76	35	159	21046	0	21316
15245	44	36	157	21631	0	21868
15246	21060	18	52	309	0	21439
15247	20704	40	40	176	0	20960
15248	20932	26	46	66	0	21070
15249	20977	18	42	32	0	21069
15250	20506	22	40	58	0	20626
15251	329	20142	45	42	0	20558
15252	203	161	38	20468	0	20870
15253	77	140	20837	200	0	21254
15254	58	38	214	20570	0	20880
15255	56	40	184	20545	0	20825
15256	57	22	56	21451	0	21586
15257	23004	19	42	352	0	23417
15258	245	22	50	22846	0	23163
15259	23280	36	46	241	0	23603
15260	273	31	23492	258	0	24054
15261	257	25	224	27466	0	27972
15262	98	33	28493	317	0	28941
15263	28012	27	311	294	0	28644
15264	325	24	261	28386	0	28996
15265	301	41	28688	374	0	29404
15266	93	22	292	28837	0	29244
15267	28947	32	285	347	0	29611
15268	341	29	29503	304	0	30177
15269	29121	42	308	105	0	29576
15270	29779	30	292	75	0	30176
15271	29290	33	103	85	0	29511
15272	29239	34	73	89	0	29435
15273	548	29173	75	121	0	29917
15274	250	27970	56	94	0	28370
15275	118	27974	73	99	0	28264
15276	61	687	55	25410	0	26213
15277	60	26425	56	242	0	26783
15278	25962	243	56	191	0	26452
15279	240	25782	54	96	0	26172
15280	204	25892	49	84	0	26229
15281	95	370	57	25477	0	25999
15282	91	210	39	25886	0	26226
15283	25593	67	58	395	0	26113
15284	273	39	46	25935	0	26293
15285	224	49	25371	298	0	25942
15286	126	51	24489	232	0	24898
15287	94	38	25324	107	0	25563
15288	110	43	397	24187	0	24737
15289	124	27	197	25484	0	25832
15290	128	35	24968	412	0	25543
15291	151	58	24770	248	0	25227
15292	133	62	25286	90	0	25571
15293	24945	61	445	84	0	25535
15294	290	72	265	25350	0	25977
15295	265	48	76	25643	0	26032
15296	25619	66	67	474	0	26226
15297	300	59	68	25554	0	25981
15298	262	25833	66	345	0	26506
15299	111	26463	56	309	0	26939
15300	117	436	44	26306	0	26903
15301	26391	244	41	337	0	27013
15302	26013	74	67	289	0	26443
15303	26584	55	89	129	0	26857
15304	513	52	86	26384	0	27035
15305	300	51	25961	350	0	26662
15306	130	38	296	25858	0	26322
15307	109	55	25882	394	0	26440
15308	24054	50	338	307	0	24749
15309	333	41	279	24425	0	25078
15310	23996	41	124	327	0	24488
15311	380	28	24274	294	0	24976
15312	23359	31	322	163	0	23875
15313	388	45	25252	122	0	25807
15314	345	24226	291	156	0	25018
15315	169	23364	229	142	0	23904
15316	22785	403	149	123	0	23460
15317	303	253	57	22567	0	23180
15318	282	93	22609	290	0	23274
15319	132	22090	240	282	0	22744
15320	106	22531	236	130	0	23003
15321	119	407	64	22322	0	22912
15322	22283	234	64	299	0	22880
15323	22243	76	64	305	0	22688
15324	429	22472	89	156	0	23146
15325	22512	243	85	138	0	22978
15326	291	223	103	22568	0	23185
15327	304	71	22543	308	0	23226
15328	123	22653	279	320	0	23375
15329	145	226	272	22522	0	23165
15330	123	216	134	22512	0	22985
15331	22559	73	111	436	0	23179
15332	293	63	22246	298	0	22900
15333	21766	79	273	118	0	22236
15334	22011	85	265	112	0	22473
15335	489	69	112	21658	0	22328
15336	365	80	74	22189	0	22708
15337	21411	91	93	483	0	22078
15338	302	115	67	21441	0	21925
15339	305	119	21156	287	0	21867
15340	138	85	20505	248	0	20976
15341	100	20407	350	139	0	20996
15342	157	21739	221	130	0	22247
15343	117	404	92	20413	0	21026
15344	113	21235	70	277	0	21695
15345	21177	245	67	269	0	21758
15346	237	21442	97	139	0	21915
15347	238	273	72	21252	0	21835
15348	103	224	82	21615	0	22024
15349	99	94	21559	450	0	22202
15350	110	49	245	21285	0	21689
15351	122	59	254	21419	0	21854
15352	114	22131	117	460	0	22822
15353	113	233	102	21889	0	22337
15354	100	213	92	22089	0	22494
15355	190	75	21834	495	0	22594
15356	97	21829	274	351	0	22551
15357	82	1204	232	18189	0	19707
15358	72	19777	104	241	0	20194
15359	81	235	19146	222	0	19684
15360	73	18619	226	110	0	19028
15361	13831	215	283	105	0	14434
15362	12861	108	47	95	0	13111
15363	13079	60	19	28	0	13186
15364	193	13267	22	50	0	13532
15365	13203	117	20	46	0	13386
15366	130	106	26	13037	0	13299
15367	12780	60	16	119	0	12975
15368	125	12331	62	129	0	12647
15369	12395	116	22	55	0	12588
15370	12750	100	30	48	0	12928
15371	183	12988	25	58	0	13254
15372	152	125	13272	36	0	13585
15373	50	135	108	14123	0	14416
15374	49	38	15684	176	0	15947
15375	41	30	205	16084	0	16360
15376	42	37	161	16680	0	16920
15377	42	44	16646	378	0	17110
15378	31	35	225	16951	0	17242
15379	16896	34	200	257	0	17387
15380	244	33	16976	213	0	17466
15381	191	16965	226	102	0	17484
15382	65	242	200	16269	0	16776
15383	40	212	35	17123	0	17410
15384	58	52	17024	403	0	17537
15385	46	58	234	16360	0	16698
15386	52	16940	179	263	0	17434
15387	16498	241	46	219	0	17004
15388	224	17002	34	96	0	17356
15389	16174	250	26	55	0	16505
15390	237	16271	22	55	0	16585
15391	155	16570	29	59	0	16813
15392	69	353	15715	45	0	16182
15393	32	212	224	15278	0	15746
15394	39	63	167	15021	0	15290
15395	42	41	50	15541	0	15674
15396	26	16007	30	402	0	16465
15397	34	250	49	16117	0	16450
15398	15975	166	46	306	0	16493
15399	260	50	43	15939	0	16292
15400	15913	24	48	334	0	16319
15401	286	45	15612	227	0	16170
15402	15693	40	271	95	0	16099
15403	288	53	196	15616	0	16153
15404	200	60	72	16226	0	16558
15405	16482	60	55	485	0	17082
15406	295	52	16528	278	0	17153
15407	192	16571	297	106	0	17166
15408	64	309	212	16550	0	17135
15409	16417	238	58	296	0	17009
15410	16595	101	55	229	0	16980
15411	449	95	45	16388	0	16977
15412	251	88	16428	325	0	17092
15413	15217	94	298	242	0	15851
15414	303	86	15765	114	0	16268
15415	224	76	300	15505	0	16105
15416	77	116	15731	352	0	16276
15417	60	73	285	15512	0	15930
15418	74	62	15442	379	0	15957
15419	73	15498	284	282	0	16137
15420	99	293	197	14010	0	14599
15421	86	15616	65	289	0	16056
15422	15527	276	67	239	0	16109
15423	15638	211	61	111	0	16021
15424	481	78	15394	105	0	16058
15425	266	59	287	15152	0	15764
15426	15346	51	216	341	0	15954
15427	331	54	74	15236	0	15695
15428	247	64	66	15315	0	15692
15429	121	54	15001	484	0	15660
15430	14212	75	305	301	0	14893
15431	322	69	15151	141	0	15683
15432	273	51	302	14844	0	15470
15433	133	40	15118	360	0	15651
15434	14553	48	331	288	0	15220
15435	14656	49	256	169	0	15130
15436	14645	57	134	140	0	14976
15437	489	54	110	14405	0	15058
15438	257	74	14206	364	0	14901
15439	111	64	14708	290	0	15173
15440	108	228	472	13470	0	14278
15441	79	14331	273	333	0	15016
15442	13330	287	115	265	0	13997
15443	325	225	89	13364	0	14003
15444	254	85	13354	376	0	14069
15445	169	69	294	13368	0	13900
15446	138	65	13951	368	0	14522
15447	149	62	323	13974	0	14508
15448	113	50	14286	400	0	14849
15449	136	62	14161	315	0	14674
15450	124	14008	461	220	0	14813
15451	109	261	14068	161	0	14599
15452	132	192	13804	136	0	14264
15453	159	54	432	12112	0	12757
15454	139	55	255	11999	0	12448
15455	123	13084	117	415	0	13739
15456	12846	221	145	219	0	13431
15457	322	12906	121	160	0	13509
15458	292	249	113	12577	0	13231
15459	12698	185	108	310	0	13301
15460	322	47	118	12820	0	13307
15461	13113	57	141	333	0	13644
15462	304	32	131	13286	0	13753
15463	264	58	13427	337	0	14086
15464	129	61	298	13538	0	14026
15465	124	61	254	13786	0	14225
15466	13485	54	150	484	0	14173
15467	13280	32	143	322	0	13777
15468	13371	42	161	155	0	13729
15469	407	12908	175	156	0	13646
15470	218	12800	143	159	0	13320
15471	12757	323	164	133	0	13377
15472	263	185	12781	129	0	13358
15473	183	73	12122	87	0	12465
15474	97	673	289	10117	0	11176
15475	77	40	10327	157	0	10601
15476	76	17	10071	124	0	10288
15477	9500	38	243	105	0	9886
15478	9466	21	135	78	0	9700
15479	194	9720	66	92	0	10072
15480	119	10275	78	80	0	10552
15481	94	175	64	9126	0	9459
15482	54	10115	80	128	0	10377
15483	10093	113	85	125	0	10416
15484	142	90	77	9720	0	10029
15485	114	10218	56	161	0	10549
15486	10238	111	67	116	0	10532
15487	147	92	10347	81	0	10667
15488	133	36	10206	87	0	10462
15489	9991	36	193	73	0	10293
15490	141	30	10363	74	0	10608
15491	9369	24	144	66	0	9603
15492	109	90	134	9786	0	10119
15493	118	111	10003	114	0	10346
15494	65	9970	130	115	0	10280
15495	57	10191	115	66	0	10429
15496	9406	100	61	48	0	9615
15497	65	9589	58	59	0	9771
15498	9117	55	43	38	0	9253
15499	8980	43	51	43	0	9117
15500	89	9225	53	38	0	9405
15501	54	89	44	9337	0	9524
15502	36	51	9682	55	0	9824
15503	24	10262	85	49	0	10420
15504	26	273	65	10608	0	10972
15505	21	36	30	10809	0	10896
15506	10716	15	24	121	0	10876
15507	73	16	24	10833	0	10946
15508	61	13	10792	102	0	10968
15509	19	10801	87	67	0	10974
15510	21	71	57	10860	0	11009
15511	10882	58	23	87	0	11050
15512	10932	26	14	67	0	11039
15513	136	19	15	11146	0	11316
15514	11950	18	22	97	0	12087
15515	126	14	11935	68	0	12143
15516	100	13	115	11974	0	12202
15517	38	20	12375	105	0	12538
15518	24	20	124	13344	0	13512
15519	24	16	118	13337	0	13495
15520	23	21	32	13521	0	13597
15521	25	25	28	13570	0	13648
15522	30	31	25	13716	0	13802
15523	13658	22	13	291	0	13984
15524	13701	26	10	164	0	13901
15525	274	13737	13	50	0	14074
15526	13838	147	20	38	0	14043
15527	166	146	17	13690	0	14019
15528	148	38	22	13689	0	13897
15529	40	21	28	14003	0	14092
15530	38	9	14022	305	0	14374
15531	47	16	148	13487	0	13698
15532	37	13916	148	193	0	14294
15533	13762	148	34	154	0	14098
15534	13679	148	27	50	0	13904
15535	283	40	13899	44	0	14266
15536	156	13877	143	91	0	14267
15537	47	156	136	13848	0	14187
15538	48	137	13981	230	0	14396
15539	29	35	162	12885	0	13111
15540	29	13462	144	188	0	13823
15541	13293	146	47	153	0	13639
15542	160	13579	28	111	0	13878
15543	179	168	13465	35	0	13847
15544	74	151	13369	47	0	13641
15545	45	12945	256	57	0	13303
15546	35	12734	141	57	0	12967
15547	12385	246	35	58	0	12724
15548	12155	148	27	53	0	12383
15549	250	38	28	12136	0	12452
15550	158	29	12030	177	0	12394
15551	56	36	139	11822	0	12053
15552	67	19	136	11988	0	12210
15553	11776	29	35	291	0	12131
15554	11492	39	54	175	0	11760
15555	263	31	31	12240	0	12565
15556	166	24	12242	190	0	12622
15557	57	12297	147	209	0	12710
15558	12287	156	150	65	0	12658
15559	157	12829	38	79	0	13103
15560	163	189	28	12665	0	13045
15561	59	158	43	12978	0	13238
15562	53	42	41	12995	0	13131
15563	39	49	47	12763	0	12898
15564	12416	45	42	348	0	12851
15565	199	46	25	12502	0	12772
15566	194	12252	23	240	0	12709
15567	68	177	33	12468	0	12746
15568	12138	156	39	224	0	12557
15569	180	12216	38	233	0	12667
15570	173	177	34	12364	0	12748
15571	72	168	12087	247	0	12574
15572	11718	36	177	214	0	12145
15573	202	38	160	11756	0	12156
15574	189	40	11529	236	0	11994
15575	78	53	11429	220	0	11780
15576	78	142	294	11300	0	11814
15577	11232	58	205	234	0	11729
15578	11196	49	62	213	0	11520
15579	315	11618	32	123	0	12088
15580	11356	176	25	104	0	11661
15581	11190	150	47	104	0	11491
15582	11304	55	40	107	0	11506
15583	11318	43	59	112	0	11532
15584	333	51	44	11052	0	11480
15585	201	42	40	11154	0	11437
15586	100	46	11012	353	0	11511
15587	70	10658	171	252	0	11151
15588	59	10782	162	142	0	11145
15589	89	300	10698	103	0	11190
15590	10414	179	175	101	0	10869
15591	203	75	163	10688	0	11129
15592	10808	52	61	224	0	11145
15593	10522	53	52	213	0	10840
15594	338	40	10386	106	0	10870
15595	215	52	167	10088	0	10522
15596	10122	46	183	215	0	10566
15597	208	63	65	10143	0	10479
15598	198	48	10096	231	0	10573
15599	107	489	170	9432	0	10198
15600	90	10376	175	178	0	10819
15601	88	10484	67	186	0	10825
15602	102	299	9887	80	0	10368
15603	66	9414	149	107	0	9736
15604	8266	158	226	101	0	8751
15605	8166	137	65	52	0	8420
15606	247	59	32	8104	0	8442
15607	163	45	41	8263	0	8512
15608	77	41	40	8496	0	8654
15609	8247	35	35	276	0	8593
15610	160	8256	20	182	0	8618
15611	8216	109	32	71	0	8428
15612	7897	139	27	59	0	8122
15613	228	7780	44	66	0	8118
15614	6756	90	31	60	0	6937
15615	126	6795	23	68	0	7012
15616	6636	96	56	59	0	6847
15617	116	77	6384	57	0	6634
15618	4834	97	205	45	0	5181
15619	58	5079	37	39	0	5213
15620	62	44	42	5021	0	5169
15621	31	46	11	5121	0	5209
15622	25	22	10	5133	0	5190
15623	5073	12	15	114	0	5214
15624	80	11	11	5121	0	5223
15625	63	20	5102	84	0	5269
15626	5015	20	60	82	0	5177
15627	78	25	5084	60	0	5247
15628	66	83	75	5098	0	5322
15629	44	23	5254	78	0	5399
15630	30	63	69	4992	0	5154
15631	29	5102	51	81	0	5263
15632	38	56	30	5078	0	5202
15633	36	5142	24	85	0	5287
15634	44	67	24	5150	0	5285
15635	4975	55	21	80	0	5131
15636	95	20	28	5429	0	5572
15637	5462	16	22	87	0	5587
15638	104	17	5133	62	0	5316
15639	5108	18	53	47	0	5226
15640	5191	27	49	26	0	5293
15641	5187	23	25	25	0	5260
15642	133	22	17	5244	0	5416
15643	5260	30	17	71	0	5378
15644	93	27	5113	55	0	5288
15645	5129	18	70	45	0	5262
15646	99	22	5157	37	0	5315
15647	5200	22	73	34	0	5329
15648	87	28	57	5198	0	5370
15649	59	34	5509	81	0	5683
15650	41	22	74	5773	0	5910
15651	46	22	50	5828	0	5946
15652	54	18	5945	111	0	6128
15653	5460	17	66	82	0	5625
15654	81	6034	58	54	0	6227
15655	5754	60	29	37	0	5880
15656	73	5777	29	26	0	5905
15657	5684	61	20	26	0	5791
15658	70	33	5657	26	0	5786
15659	5023	11	45	25	0	5104
15660	40	5047	22	15	0	5124
15661	20	20	7	4898	0	4945
15662	10	14	3	4916	0	4943
15663	9	3	2	4911	0	4925
15664	10	3	4986	44	0	5043
15665	9	5	23	4979	0	5016
15666	11	2	5589	31	0	5633
15667	5957	5	36	22	0	6020
15668	6316	5	22	9	0	6352
15669	72	1	9	6406	0	6488
15670	38	1	6337	76	0	6452
15671	6414	2	47	33	0	6496
15672	56	1	8254	13	0	8324
15673	35	1	71	8124	0	8231
15674	13	9	49	8424	0	8495
15675	8	14	18	8695	0	8735
15676	6	3	5	9070	0	9084
15677	8750	6	4	143	0	8903
15678	88	8836	4	85	0	9013
15679	61	90	8544	22	0	8717
15680	14	8595	91	12	0	8712
15681	8562	98	55	7	0	8722
15682	93	50	15	8556	0	8714
15683	8635	16	6	100	0	8757
15684	102	4	8	8760	0	8874
15685	53	10	7	8687	0	8757
15686	13	2	13	8845	0	8873
15687	17	6	8602	150	0	8775
15688	11	8642	95	77	0	8825
15689	14	92	8773	22	0	8901
15690	8	52	102	8700	0	8862
15691	8670	12	64	101	0	8847
15692	8550	13	21	77	0	8661
15693	8711	3	14	33	0	8761
15694	147	8706	8	35	0	8896
15695	8907	91	8	34	0	9040
15696	125	50	9	8840	0	9024
15697	68	28	13	8752	0	8861
15698	28	14	28	8844	0	8914
15699	32	8869	12	156	0	9069
15700	47	97	16	8085	0	8245
15701	20	8402	20	144	0	8586
15702	8351	103	26	67	0	8547
15703	8353	55	19	51	0	8478
15704	159	17	24	8461	0	8661
15705	79	11	8379	137	0	8606
15706	8080	16	112	87	0	8295
15707	109	20	56	8254	0	8439
15708	70	19	8177	129	0	8395
15709	7829	18	107	90	0	8044
15710	124	27	70	8156	0	8377
15711	8162	19	29	134	0	8344
15712	135	8127	14	89	0	8365
15713	84	114	14	7990	0	8202
15714	56	8287	12	138	0	8493
15715	38	118	15	8337	0	8508
15716	26	8345	23	153	0	8547
15717	36	129	17	8549	0	8731
15718	33	74	8412	146	0	8665
15719	7233	43	115	104	0	7495
15720	112	8327	64	47	0	8550
15721	95	94	8171	45	0	8405
15722	7943	61	91	59	0	8154
15723	130	14	57	8258	0	8459
15724	94	20	8221	128	0	8463
15725	55	8160	86	109	0	8410
15726	28	101	58	8177	0	8364
15727	56	53	8388	115	0	8612
15728	50	24	82	8283	0	8439
15729	46	20	53	8304	0	8423
15730	48	28	8481	163	0	8720
15731	34	45	88	8595	0	8762
15732	43	29	8786	143	0	9001
15733	39	43	87	8794	0	8963
15734	54	22	9274	144	0	9494
15735	41	38	100	9192	0	9371
15736	48	26	66	8970	0	9110
15737	46	34	44	8823	0	8947
15738	49	9064	27	169	0	9309
15739	9063	105	36	110	0	9314
15740	9005	71	47	54	0	9177
15741	179	28	31	9060	0	9298
15742	9174	29	41	155	0	9399
15743	141	26	9154	109	0	9430
15744	80	9512	95	88	0	9775
15745	9518	97	75	87	0	9777
15746	106	9692	51	73	0	9922
15747	112	97	23	9596	0	9828
15748	52	95	32	9714	0	9893
15749	9335	35	56	173	0	9599
15750	120	43	29	9187	0	9379
15751	105	33	9170	142	0	9450
15752	39	9011	96	130	0	9276
15753	9001	105	84	71	0	9261
15754	111	73	31	8874	0	9089
15755	87	9189	42	162	0	9480
15756	60	104	40	8911	0	9115
15757	34	9378	42	121	0	9575
15758	9327	118	46	92	0	9583
15759	9228	70	56	68	0	9422
15760	157	29	9224	90	0	9500
15761	104	27	9238	62	0	9431
15762	47	26	160	9059	0	9292
15763	35	9504	76	137	0	9752
15764	37	100	57	9499	0	9693
15765	9348	74	37	146	0	9605
15766	92	31	8969	125	0	9217
15767	53	17	76	8218	0	8364
15768	45	20	8416	87	0	8568
15769	28	17	8304	95	0	8444
15770	27	8929	122	61	0	9139
15771	308	208	215	8004	0	8735
15772	7000	30	34	42	0	7106
15773	57	12	6922	42	0	7033
15774	24	6646	22	25	0	6717
15775	6364	8	12	2	0	6386
15776	9	14	3	6321	0	6347
15777	6790	2	3	13	0	6808
15778	6777	2	5	15	0	6799
15779	7004	5	2	10	0	7021
15780	25	2	7511	6	0	7544
15781	7172	3	11	6	0	7192
15782	7543	2	17	7	0	7569
15783	19	8184	11	7	0	8221
15784	20	8	0	8258	0	8286
15785	7	15	8	8068	0	8098
15786	3	8	3	8292	0	8306
15787	8337	6	3	31	0	8377
15788	7881	1	4	21	0	7907
15789	28	5	8266	7	0	8306
15790	31	2	9	8110	0	8152
15791	9	8174	20	19	0	8222
15792	8270	12	7	30	0	8319
15793	18	18	8392	7	0	8435
15794	25	7	11	8124	0	8167
15795	8	4	21	8165	0	8198
15796	5	8236	7	40	0	8288
15797	5	10	4	8312	0	8331
15798	4	24	8	8177	0	8213
15799	8	6	5	8514	0	8533
15800	8565	7	6	41	0	8619
15801	14	3	2	8565	0	8584
15802	26	1	7	8521	0	8555
15803	8860	5	4	42	0	8911
15804	16	9	1	8849	0	8875
15805	30	9972	2	26	0	10030
15806	10471	29	2	24	0	10526
15807	10475	45	8	19	0	10547
15808	10766	19	3	13	0	10801
15809	11993	7	5	2	0	12007
15810	136	13073	7	74	0	13290
15811	14716	83	6	11	0	14816
15812	14715	92	10	14	0	14831
15813	230	22	1	14894	0	15147
15814	135	14	14809	117	0	15075
15815	39	10	108	14748	0	14905
15816	20	7	112	14708	0	14847
15817	11	10	33	14643	0	14697
15818	12	14	15	14679	0	14720
15819	12	10	5	14842	0	14869
15820	14631	3	9	255	0	14898
15821	122	6	8	14756	0	14892
15822	126	9	15374	157	0	15666
15823	43	8	119	15188	0	15358
15824	20	16223	117	155	0	16515
15825	13	151	26	16392	0	16582
15826	30	116	16285	147	0	16578
15827	14435	31	153	157	0	14776
15828	15289	23	139	48	0	15499
15829	277	7	17657	45	0	17986
15830	157	17618	120	31	0	17926
15831	17787	133	116	24	0	18060
15832	17530	123	32	18	0	17703
15833	17603	33	13	19	0	17668
15834	17281	18	10	31	0	17340
15835	289	12	12	17095	0	17408
15836	182	17	17566	159	0	17924
15837	72	17	126	17649	0	17864
15838	51	13	129	18086	0	18279
15839	52	14	17983	301	0	18350
15840	55	23	17816	181	0	18075
15841	17620	19	259	80	0	17978
15842	166	18375	160	91	0	18792
15843	172	139	51	18458	0	18820
15844	82	135	17989	208	0	18414
15845	16912	38	168	224	0	17342
15846	181	20	18156	123	0	18480
15847	17408	14	185	124	0	17731
15848	204	18093	158	138	0	18593
15849	182	142	47	18132	0	18503
15850	84	152	18026	223	0	18485
15851	17010	54	166	214	0	17444
15852	211	18167	164	103	0	18645
15853	183	18869	62	100	0	19214
15854	91	280	66	18508	0	18945
15855	62	202	54	19206	0	19524
15856	20228	88	37	336	0	20689
15857	277	20104	41	258	0	20680
15858	243	206	57	20433	0	20939
15859	20305	178	55	261	0	20799
15860	20407	68	65	228	0	20768
15861	20801	50	101	125	0	21077
15862	486	49	21288	105	0	21928
15863	334	32	21266	103	0	21735
15864	22306	22	450	126	0	22904
15865	348	22954	285	130	0	23717
15866	302	23224	102	160	0	23788
15867	100	503	84	22388	0	23075
15868	78	22998	81	420	0	23577
15869	23048	325	77	329	0	23779
15870	335	256	71	22647	0	23309
15871	318	87	22668	345	0	23418
15872	22361	57	328	308	0	23054
15873	22824	57	283	133	0	23297
15874	540	74	114	22629	0	23357
15875	331	68	93	22633	0	23125
15876	152	64	112	22781	0	23109
15877	159	44	88	22800	0	23091
15878	150	64	22101	581	0	22896
15879	156	21834	297	356	0	22643
15880	139	347	280	20311	0	21077
15881	112	21759	127	345	0	22343
15882	155	374	99	20162	0	20790
15883	145	21221	62	352	0	21780
15884	20731	369	84	311	0	21495
15885	20855	309	82	131	0	21377
15886	601	20944	85	165	0	21795
15887	21149	349	103	127	0	21728
15888	451	292	88	20813	0	21644
15889	20836	145	85	358	0	21424
15890	452	20719	98	332	0	21601
15891	20934	321	119	135	0	21509
15892	20874	298	117	104	0	21393
15893	661	135	102	20521	0	21419
15894	374	127	20481	384	0	21366
15895	158	20431	359	365	0	21313
15896	183	336	310	20458	0	21287
15897	20383	355	126	366	0	21230
15898	406	190	20299	344	0	21239
15899	333	153	322	19963	0	20771
15900	156	133	283	20272	0	20844
15901	20214	76	132	619	0	21041
15902	20149	131	107	389	0	20776
15903	20125	124	113	207	0	20569
15904	620	19853	84	204	0	20761
15905	18834	335	68	186	0	19423
15906	410	274	17862	212	0	18758
15907	322	135	17679	199	0	18335
15908	182	117	17917	167	0	18383
15909	172	738	516	15519	0	16945
15910	126	100	15276	264	0	15766
15911	13476	82	185	206	0	13949
15912	232	65	162	13796	0	14255
15913	219	80	13947	231	0	14477
15914	14165	88	179	201	0	14633
15915	255	71	159	14225	0	14710
15916	245	77	43	14330	0	14695
15917	14315	74	41	352	0	14782
15918	254	81	42	14703	0	15080
15919	241	71	15027	239	0	15578
15920	125	74	194	15152	0	15545
15921	159	68	15412	240	0	15879
15922	132	76	210	14932	0	15350
15923	14578	68	183	262	0	15091
15924	260	14055	73	238	0	14626
15925	237	14450	58	116	0	14861
15926	146	323	64	14245	0	14778
15927	119	206	81	14194	0	14600
15928	113	14198	73	454	0	14838
15929	124	13174	74	234	0	13606
15930	129	312	120	12779	0	13340
15931	116	198	67	12844	0	13225
15932	12596	64	77	378	0	13115
15933	253	12638	65	273	0	13229
15934	229	12757	74	143	0	13203
15935	113	13194	81	129	0	13517
15936	12525	312	81	107	0	13025
15937	251	152	12328	112	0	12843
15938	12002	45	219	105	0	12371
15939	246	37	192	11992	0	12467
15940	196	11824	84	246	0	12350
15941	93	12098	73	224	0	12488
15942	11898	280	62	105	0	12345
15943	232	165	79	11361	0	11837
15944	180	12565	76	306	0	13127
15945	12862	200	74	204	0	13340
15946	12737	179	55	136	0	13107
15947	357	66	12679	118	0	13220
15948	12627	70	207	107	0	13011
15949	12728	70	186	112	0	13096
15950	356	60	64	12523	0	13003
15951	214	12610	61	244	0	13129
15952	106	12482	47	226	0	12861
15953	79	320	41	12059	0	12499
15954	11802	194	137	229	0	12362
15955	206	80	11302	201	0	11789
15956	240	61	10136	76	0	10513
15957	172	58	10310	77	0	10617
15958	87	51	10305	68	0	10511
15959	46	10316	246	97	0	10705
15960	51	10251	144	80	0	10526
15961	124	213	9654	113	0	10104
15962	105	112	9348	41	0	9606
15963	27	9069	143	35	0	9274
15964	41	48	114	7572	0	7775
15965	11	46	7811	53	0	7921
15966	21	12	51	7577	0	7661
15967	7	12	58	7784	0	7861
15968	5	12	13	8163	0	8193
15969	7	12	9	9073	0	9101
15970	9	9	9214	124	0	9356
15971	13	8	58	8974	0	9053
15972	9163	9	73	79	0	9324
15973	75	11	9134	81	0	9301
15974	9206	12	71	21	0	9310
15975	72	11	77	9437	0	9597
15976	90	12	9570	75	0	9747
15977	9402	16	73	89	0	9580
15978	76	11	82	9543	0	9712
15979	9652	14	18	83	0	9767
15980	79	19	19	9418	0	9535
15981	91	9594	9	94	0	9788
15982	38	79	9785	93	0	9995
15983	18	86	77	9762	0	9943
15984	9817	24	92	86	0	10019
15985	9741	15	38	106	0	9900
15986	9848	20	26	32	0	9926
15987	9854	28	17	28	0	9927
15988	9855	24	15	30	0	9924
15989	164	9918	20	33	0	10135
15990	10016	75	19	36	0	10146
15991	104	94	9868	29	0	10095
15992	9877	27	82	41	0	10027
15993	113	44	103	8987	0	9247
15994	117	27	9925	76	0	10145
15995	60	18	9851	96	0	10025
15996	48	21	157	9759	0	9985
15997	9941	19	104	95	0	10159
15998	96	9871	36	117	0	10120
15999	9967	80	31	40	0	10118
16000	102	10038	34	44	0	10218
16001	125	91	33	10146	0	10395
16002	66	101	26	10207	0	10400
16003	10171	30	36	177	0	10414
16004	103	32	31	10345	0	10511
16005	110	31	10358	108	0	10607
16006	10181	19	95	124	0	10419
16007	117	24	107	10188	0	10436
16008	129	28	45	10137	0	10339
16009	65	25	10298	171	0	10559
16010	9587	32	104	121	0	9844
16011	10173	27	122	46	0	10368
16012	181	10101	41	67	0	10390
16013	123	78	9647	40	0	9888
16014	52	87	9220	29	0	9388
16015	46	39	156	8825	0	9066
16016	41	49	109	8702	0	8901
16017	31	9015	149	155	0	9350
16018	45	60	8812	110	0	9027
16019	49	80	85	8477	0	8691
16020	49	16	8723	98	0	8886
16021	45	27	97	8225	0	8394
16022	51	8425	101	94	0	8671
16023	47	68	46	8535	0	8696
16024	46	83	50	8466	0	8645
16025	55	28	32	8399	0	8514
16026	8285	18	41	176	0	8520
16027	93	17	8283	120	0	8513
16028	112	8435	82	66	0	8695
16029	55	77	105	8511	0	8748
16030	8748	90	50	112	0	9000
16031	110	29	37	9002	0	9178
16032	8990	23	40	122	0	9175
16033	138	26	9052	132	0	9348
16034	8666	16	100	74	0	8856
16035	147	20	125	9019	0	9311
16036	164	24	9037	116	0	9341
16037	63	8941	108	150	0	9262
16038	63	88	129	8749	0	9029
16039	64	100	49	8789	0	9002
16040	8678	39	35	197	0	8949
16041	113	8700	41	149	0	9003
16042	125	8503	52	60	0	8740
16043	49	8815	56	56	0	8976
16044	8025	233	25	51	0	8334
16045	105	8186	28	53	0	8372
16046	114	91	38	7908	0	8151
16047	61	107	20	8004	0	8192
16048	7966	27	14	194	0	8201
16049	92	7939	23	123	0	8177
16050	120	75	31	7964	0	8190
16051	8218	99	24	98	0	8439
16052	8091	26	34	118	0	8269
16053	8226	20	25	52	0	8323
16054	184	8162	29	52	0	8427
16055	8296	75	29	42	0	8442
16056	94	104	33	8043	0	8274
16057	110	7742	19	96	0	7967
16058	46	7852	57	112	0	8067
16059	141	135	26	7672	0	7974
16060	7525	95	22	125	0	7767
16061	7649	31	25	95	0	7800
16062	128	16	23	7402	0	7569
16063	96	7217	19	90	0	7422
16064	7204	68	16	93	0	7381
16065	77	77	7131	31	0	7316
16066	91	28	6939	25	0	7083
16067	6826	19	111	35	0	6991
16068	61	24	6777	33	0	6895
16069	52	7	42	5671	0	5772
16070	5750	5	41	49	0	5845
16071	40	3	11	5966	0	6020
16072	52	10	5992	48	0	6102
16073	19	6143	34	66	0	6262
16074	14	32	40	6095	0	6181
16075	12	40	5979	41	0	6072
16076	5563	46	34	46	0	5689
16077	25	13	35	5885	0	5958
16078	44	9	5987	44	0	6084
16079	16	1	26	5924	0	5967
16080	14	5904	40	44	0	6002
16081	7	38	12	6166	0	6223
16082	12	44	4	6067	0	6127
16083	15	15	9	6014	0	6053
16084	16	6085	8	75	0	6184
16085	6379	35	5	57	0	6476
16086	31	45	8	6392	0	6476
16087	48	12	12	6479	0	6551
16088	25	11	3	6580	0	6619
16089	11	9	6568	84	0	6672
16090	8	10	33	6627	0	6678
16091	6752	14	41	50	0	6857
16092	37	6865	10	60	0	6972
16093	51	42	6	6873	0	6972
16094	19	50	7	6892	0	6968
16095	6936	21	5	91	0	7053
16096	39	7025	6	65	0	7135
16097	7325	42	5	29	0	7401
16098	7370	50	4	25	0	7449
16099	90	21	3	7314	0	7428
16100	7333	7	5	59	0	7404
16101	61	7068	7	68	0	7204
16102	7137	43	3	27	0	7210
16103	64	60	5	7282	0	7411
16104	7804	18	8	55	0	7885
16105	8059	8	9	58	0	8134
16106	117	14	8263	24	0	8418
16107	8426	11	48	22	0	8507
16108	8476	18	54	20	0	8568
16109	9188	7	13	36	0	9244
16110	160	8	9507	22	0	9697
16111	87	9554	84	66	0	9791
16112	34	98	79	9655	0	9866
16113	9668	91	16	103	0	9878
16114	100	9660	8	100	0	9868
16115	9878	94	10	27	0	10009
16116	116	81	12	9968	0	10177
16117	95	24	9867	114	0	10100
16118	10015	10	92	91	0	10208
16119	114	13	84	10260	0	10471
16120	108	13	10440	112	0	10673
16121	10328	9	102	112	0	10551
16122	128	10	10686	35	0	10859
16123	125	17	119	11001	0	11262
16124	40	17	101	11913	0	12071
16125	12113	8	24	228	0	12373
16126	11917	11	19	149	0	12096
16127	253	12330	10	58	0	12651
16128	12446	119	25	28	0	12618
16129	165	124	12033	17	0	12339
16130	161	25	12057	22	0	12265
16131	11753	12	208	25	0	11998
16132	138	12207	149	15	0	12509
16133	12045	111	42	16	0	12214
16134	133	12078	13	17	0	12241
16135	12006	114	10	18	0	12148
16136	134	107	15	11848	0	12104
16137	142	19	12024	109	0	12294
16138	51	10	114	11887	0	12062
16139	31	15	126	12218	0	12390
16140	12202	6	32	212	0	12452
16141	143	17	12303	138	0	12601
16142	12038	14	120	43	0	12215
16143	142	12122	112	41	0	12417
16144	12183	118	36	28	0	12365
16145	148	115	26	12017	0	12306
16146	153	39	12028	127	0	12347
16147	65	27	118	12069	0	12279
16148	12028	10	134	143	0	12315
16149	153	25	41	12019	0	12238
16150	168	25	33	11886	0	12112
16151	70	11563	36	286	0	11955
16152	59	118	41	11948	0	12166
16153	62	130	11810	136	0	12138
16154	66	35	125	11751	0	11977
16155	58	22	145	11726	0	11951
16156	11536	25	49	237	0	11847
16157	174	18	32	11510	0	11734
16158	168	23	11370	163	0	11724
16159	79	11396	136	158	0	11769
16160	80	128	137	11146	0	11491
16161	75	133	48	11339	0	11595
16162	11479	46	40	225	0	11790
16163	188	11395	39	158	0	11780
16164	183	130	46	11577	0	11936
16165	11306	134	50	149	0	11639
16166	11460	39	35	166	0	11700
16167	272	35	46	11661	0	12014
16168	207	33	11858	246	0	12344
16169	11775	51	142	176	0	12144
16170	201	38	156	12220	0	12615
16171	12408	47	59	194	0	12708
16172	12297	29	57	181	0	12564
16173	290	12122	39	109	0	12560
16174	12217	138	48	84	0	12487
16175	218	12647	35	68	0	12968
16176	194	174	44	12436	0	12848
16177	96	148	52	12280	0	12576
16178	78	12445	50	371	0	12944
16179	12531	143	58	187	0	12919
16180	12229	134	69	119	0	12551
16181	316	48	12171	79	0	12614
16182	199	61	12050	90	0	12400
16183	108	30	249	12056	0	12443
16184	12245	43	156	197	0	12641
16185	203	37	57	11980	0	12277
16186	195	37	53	12106	0	12391
16187	91	33	12158	310	0	12592
16188	100	37	12072	204	0	12413
16189	90	26	12277	116	0	12509
16190	11440	108	276	97	0	11921
16191	11659	41	175	83	0	11958
16192	286	11718	51	92	0	12147
16193	202	11845	32	93	0	12172
16194	114	279	34	11919	0	12346
16195	71	161	11981	197	0	12410
16196	11641	50	209	207	0	12107
16197	194	40	12243	103	0	12580
16198	193	45	155	11765	0	12158
16199	104	27	137	11917	0	12185
16200	68	48	61	12019	0	12196
16201	89	42	34	12256	0	12421
16202	12188	37	37	324	0	12586
16203	184	28	54	12307	0	12573
16204	174	18	12046	199	0	12437
16205	11126	23	152	188	0	11489
16206	173	22	11501	85	0	11781
16207	181	16	11249	56	0	11502
16208	63	11294	230	58	0	11645
16209	196	157	225	10053	0	10631
16210	10029	102	49	90	0	10270
16211	81	28	19	10094	0	10222
16212	119	24	10074	110	0	10327
16213	36	13	73	10159	0	10281
16214	10003	13	113	102	0	10231
16215	80	9934	29	153	0	10196
16216	9773	71	23	45	0	9912
16217	91	9781	17	43	0	9932
16218	9186	155	10	40	0	9391
16219	76	9300	22	42	0	9440
16220	84	9189	12	53	0	9338
16221	69	112	9076	26	0	9283
16222	24	9053	58	33	0	9168
16223	7919	36	222	46	0	8223
16224	34	49	15	7763	0	7861
16225	7655	9	4	35	0	7703
16226	38	7738	8	64	0	7848
16227	7727	32	6	16	0	7781
16228	46	51	7741	11	0	7849
16229	60	8	40	7645	0	7753
16230	18	7596	56	44	0	7714
16231	9	35	15	7745	0	7804
16232	7	53	8	7649	0	7717
16233	9310	11	12	98	0	9431
16234	78	9574	8	76	0	9736
16235	9810	79	16	17	0	9922
16236	114	108	9787	18	0	10027
16237	128	33	9583	12	0	9756
16238	42	9641	192	27	0	9902
16239	21	90	138	9506	0	9755
16240	22	118	9621	90	0	9851
16241	25	37	94	9151	0	9307
16242	19	16	120	9507	0	9662
16243	33	17	9335	192	0	9577
16244	30	12	9356	149	0	9547
16245	30	9	9816	45	0	9900
16246	29	14	9779	33	0	9855
16247	18	9804	230	191	0	10243
16248	33	97	157	9708	0	9995
16249	31	141	47	9973	0	10192
16250	30	44	9831	206	0	10111
16251	23	28	102	9961	0	10114
16252	29	23	10378	126	0	10556
16253	29	25	123	10217	0	10394
16254	16	29	146	9992	0	10183
16255	30	10304	49	228	0	10611
16256	29	101	25	10457	0	10612
16257	35	148	36	10188	0	10407
16258	34	52	22	10523	0	10631
16259	42	26	10297	258	0	10623
16260	33	10276	101	184	0	10594
16261	10154	113	140	55	0	10462
16262	10064	150	55	41	0	10310
16263	217	56	30	9954	0	10257
16264	173	29	32	9910	0	10144
16265	56	10265	32	215	0	10568
16266	10171	102	24	154	0	10451
16267	108	10222	27	60	0	10417
16268	9935	117	33	25	0	10110
16269	158	145	9672	30	0	10005
16270	9232	49	134	38	0	9453
16271	108	9360	148	38	0	9654
16272	128	105	46	9283	0	9562
16273	42	139	27	9217	0	9425
16274	24	9375	43	218	0	9660
16275	9123	98	44	148	0	9413
16276	99	138	42	9247	0	9526
16277	133	49	44	9467	0	9693
16278	9433	28	46	231	0	9738
16279	9435	32	41	177	0	9685
16280	221	35	9512	71	0	9839
16281	9621	28	119	53	0	9821
16282	117	24	143	9667	0	9951
16283	141	16	9655	142	0	9954
16284	40	34	122	9585	0	9781
16285	35	29	9668	163	0	9895
16286	31	27	9714	159	0	9931
16287	21	26	231	9611	0	9889
16288	23	31	9772	145	0	9971
16289	17	9926	144	180	0	10267
16290	28	125	149	9793	0	10095
16291	24	131	67	10077	0	10299
16292	40	43	10081	255	0	10419
16293	31	9997	138	179	0	10345
16294	9904	118	140	72	0	10234
16295	117	129	54	9998	0	10298
16296	10050	57	35	148	0	10290
16297	131	9760	37	173	0	10101
16298	152	129	9797	73	0	10151
16299	48	147	138	9625	0	9958
16300	9662	51	161	142	0	10016
16301	123	39	9868	176	0	10206
16302	9465	28	137	84	0	9714
16303	146	9557	158	47	0	9908
16304	106	9433	61	61	0	9661
16305	9412	189	46	33	0	9680
16306	140	131	58	9293	0	9622
16307	123	35	48	9282	0	9488
16308	36	9842	40	284	0	10202
16309	28	104	40	10115	0	10287
16310	22	114	52	10069	0	10257
16311	10058	36	39	249	0	10382
16312	111	19	42	10095	0	10267
16313	112	16	10061	156	0	10345
16314	37	22	134	10119	0	10312
16315	24	24	139	10320	0	10507
16316	26	22	10374	247	0	10669
16317	33	36	114	10323	0	10506
16318	10290	23	116	179	0	10608
16319	9868	23	59	161	0	10111
16320	10155	26	39	78	0	10298
16321	219	24	27	10298	0	10568
16322	150	32	10484	132	0	10798
16323	54	10377	101	189	0	10721
16324	44	104	107	10554	0	10809
16325	42	128	10699	131	0	11000
16326	43	42	98	10606	0	10789
16327	30	40	111	10678	0	10859
16328	10547	27	45	213	0	10832
16329	116	10974	34	180	0	11304
16330	131	113	10805	58	0	11107
16331	10089	170	105	42	0	10406
16332	111	10709	109	53	0	10982
16333	49	8904	21	37	0	9011
16334	9090	90	87	24	0	9291
16335	62	44	12	9106	0	9224
16336	63	17	10871	86	0	11037
16337	21	11	72	10782	0	10886
16338	14	10994	57	114	0	11179
16339	10984	72	25	72	0	11153
16340	74	65	14	11180	0	11333
16341	11434	13	11	94	0	11552
16342	91	17	13	11205	0	11326
16343	68	11703	16	96	0	11883
16344	11918	85	10	79	0	12092
16345	11997	64	25	35	0	12121
16346	147	12253	18	43	0	12461
16347	12075	93	12	26	0	12206
16348	104	61	21	11729	0	11915
16349	76	11901	13	109	0	12099
16350	11920	102	11	94	0	12127
16351	100	12171	14	38	0	12323
16352	11905	99	16	33	0	12053
16353	107	71	5	11797	0	11980
16354	11933	16	21	121	0	12091
16355	11788	26	18	92	0	11924
16356	11821	24	17	45	0	11907
16357	156	26	8	11784	0	11974
16358	91	21	15	11933	0	12060
16359	11900	23	10	177	0	12110
16360	119	18	12144	93	0	12374
16361	78	27	93	12076	0	12274
16362	44	12351	74	110	0	12579
16363	40	115	14	12396	0	12565
16364	37	86	16	12370	0	12509
16365	49	33	12183	180	0	12445
16366	44	23	93	12828	0	12988
16367	28	13754	79	140	0	14001
16368	35	126	17	13989	0	14167
16369	39	142	15675	149	0	16005
16370	43	45	136	15697	0	15921
16371	47	23	178	16020	0	16268
16372	15837	20	43	350	0	16250
16373	15706	31	14	234	0	15985
16374	341	32	15	15656	0	16044
16375	239	15504	17	227	0	15987
16376	68	15584	11	338	0	16001
16377	93	299	15534	87	0	16013
16378	74	254	148	15329	0	15805
16379	15372	60	192	181	0	15805
16380	162	30	46	15692	0	15930
16381	203	31	15835	221	0	16290
16382	54	33	158	15779	0	16024
16383	46	34	206	15447	0	15733
16384	53	16	43	16211	0	16323
16385	51	28	15794	390	0	16263
16386	51	15774	152	269	0	16246
16387	15375	166	194	96	0	15831
16388	14670	209	64	59	0	15002
16389	329	50	18	15092	0	15489
16390	240	28	15117	362	0	15747
16391	71	15456	158	240	0	15925
16392	45	162	198	14659	0	15064
16393	42	15524	47	174	0	15787
16394	41	15729	17	218	0	16005
16395	15503	315	36	96	0	15950
16396	197	228	15554	59	0	16038
16397	226	62	15646	63	0	15997
16398	74	33	305	15450	0	15862
16399	52	35	220	15975	0	16282
16400	59	36	16033	353	0	16481
16401	54	42	155	15765	0	16016
16402	71	38	15788	229	0	16126
16403	14786	34	196	263	0	15279
16404	180	38	199	15454	0	15871
16405	246	46	15917	191	0	16400
16406	109	62	161	15221	0	15553
16407	59	16701	204	277	0	17241
16408	16290	177	67	231	0	16765
16409	188	16631	42	123	0	16984
16410	16697	201	49	98	0	17045
16411	242	208	16372	105	0	16927
16412	16196	83	163	123	0	16565
16413	220	76	206	16567	0	17069
16414	259	56	16797	210	0	17322
16415	113	53	173	16708	0	17047
16416	92	51	16726	266	0	17135
16417	15690	61	200	294	0	16245
16418	212	16695	211	157	0	17275
16419	268	174	103	16027	0	16572
16420	111	16996	68	228	0	17403
16421	16783	212	63	279	0	17337
16422	16520	217	74	162	0	16973
16423	370	17049	76	136	0	17631
16424	276	169	86	16884	0	17415
16425	91	231	62	16742	0	17126
16426	79	107	63	16863	0	17112
16427	16582	60	93	448	0	17183
16428	176	16688	96	344	0	17304
16429	239	175	90	16336	0	16840
16430	87	216	82	16465	0	16850
16431	16324	94	96	436	0	16950
16432	217	61	16231	333	0	16842
16433	262	56	16053	176	0	16547
16434	15398	58	343	160	0	15959
16435	201	50	15784	143	0	16178
16436	221	68	13874	105	0	14268
16437	97	67	304	13460	0	13928
16438	13768	55	239	180	0	14242
16439	152	78	79	13842	0	14151
16440	213	50	13751	194	0	14208
16441	13189	61	172	222	0	13644
16442	174	43	13788	129	0	14134
16443	207	13762	183	97	0	14249
16444	198	218	204	14394	0	15014
16445	14439	180	76	157	0	14852
16446	126	73	67	14369	0	14635
16447	197	37	93	14359	0	14686
16448	14718	23	61	299	0	15101
16449	137	41	70	14831	0	15079
16450	207	42	62	14930	0	15241
16451	86	30	15152	297	0	15565
16452	64	44	128	15030	0	15266
16453	15265	33	197	177	0	15672
16454	14999	45	69	215	0	15328
16455	15414	44	69	95	0	15622
16456	300	41	64	15019	0	15424
16457	221	15177	44	152	0	15594
16458	15124	116	62	207	0	15509
16459	123	15530	59	109	0	15821
16460	15309	138	43	63	0	15553
16461	152	216	69	15039	0	15476
16462	15259	52	60	136	0	15507
16463	14968	26	58	207	0	15259
16464	15135	21	66	69	0	15291
16465	266	15206	48	89	0	15609
16466	128	14444	56	76	0	14704
16467	13813	133	32	49	0	14027
16468	86	14119	29	47	0	14281
16469	22	12000	5	18	0	12045
16470	4	11872	5	13	0	11894
16471	12035	40	143	13	0	12231
16472	11	33	6	11963	0	12013
16473	28	7	2	12110	0	12147
16474	12346	5	1	50	0	12402
16475	21	4	12937	37	0	12999
16476	33	7	16	14440	0	14496
16477	10	8	41	14425	0	14484
16478	4	2	7	16074	0	16087
16479	5	6	0	16711	0	16722
16480	3	16864	8	268	0	17143
16481	1	20494	6	132	0	20633
16482	20738	293	4	25	0	21060
16483	203	220	4	20663	0	21090
16484	219	53	4	20992	0	21268
16485	72	18	20919	436	0	21445
16486	19	10	203	21105	0	21337
16487	39	6	21324	290	0	21659
16488	10	5	253	21308	0	21576
16489	22	4	21939	295	0	22260
16490	5	21487	274	286	0	22052
16491	8	227	250	21554	0	22039
16492	21639	230	54	263	0	22186
16493	21196	55	31	253	0	21535
16494	467	21	10	21523	0	22021
16495	300	14	21445	270	0	22029
16496	92	14	21366	265	0	21737
16497	20335	14	470	73	0	20892
16498	256	20828	283	61	0	21428
16499	21181	249	73	43	0	21546
16500	20935	250	39	41	0	21265
16501	517	62	21198	38	0	21815
16502	306	38	253	20684	0	21281
16503	98	26	286	20743	0	21153
16504	43	13	63	21359	0	21478
16505	27	21	60	20753	0	20861
16506	29	29	52	20843	0	20953
16507	28	21	19542	603	0	20194
16508	49	26	19537	366	0	19978
16509	32	28	489	19304	0	19853
16510	38	32	317	19490	0	19877
16511	29	31	104	20060	0	20224
16512	19544	33	55	613	0	20245
16513	283	28	54	19675	0	20040
16514	19480	29	40	387	0	19936
16515	347	20	48	19892	0	20307
16516	19961	21	55	376	0	20413
16517	19922	19	62	346	0	20349
16518	19644	29	67	136	0	19876
16519	19828	42	53	102	0	20025
16520	19984	33	57	84	0	20158
16521	633	39	38	19513	0	20223
16522	19804	25	45	340	0	20214
16523	374	19354	61	363	0	20152
16524	19635	276	57	161	0	20129
16525	361	273	64	19807	0	20505
16526	350	85	19736	375	0	20546
16527	127	87	323	19878	0	20415
16528	113	34	19914	423	0	20484
16529	86	37	382	19672	0	20177
16530	81	25	336	20124	0	20566
16531	91	25	19792	675	0	20583
16532	92	14	19737	452	0	20295
16533	83	21	578	19673	0	20355
16534	19560	15	363	429	0	20367
16535	349	27	20085	408	0	20869
16536	359	20014	350	211	0	20934
16537	167	284	20587	169	0	21207
16538	19847	303	377	119	0	20646
16539	365	81	346	20074	0	20866
16540	20381	47	113	426	0	20967
16541	20081	40	90	414	0	20625
16542	654	30	66	20255	0	21005
16543	462	24	19871	453	0	20810
16544	173	36	335	19209	0	19753
16545	152	32	327	19198	0	19709
16546	18863	31	131	710	0	19735
16547	380	19099	103	514	0	20096
16548	388	288	81	19132	0	19889
16549	167	308	18899	459	0	19833
16550	18111	74	372	417	0	18974
16551	390	18689	334	242	0	19655
16552	402	348	157	18595	0	19502
16553	168	303	129	18390	0	18990
16554	161	91	114	19059	0	19425
16555	18324	68	106	738	0	19236
16556	18513	38	104	496	0	19151
16557	725	36	107	18598	0	19466
16558	463	36	18533	475	0	19507
16559	189	18210	392	524	0	19315
16560	18339	309	358	213	0	19219
16561	18496	297	158	195	0	19146
16562	719	85	113	18182	0	19099
16563	464	61	112	18790	0	19427
16564	204	42	19004	726	0	19976
16565	165	19036	399	493	0	20093
16566	19319	336	401	230	0	20286
16567	19132	326	139	191	0	19788
16568	682	19113	107	172	0	20074
16569	19289	356	99	160	0	19904
16570	486	307	72	19159	0	20024
16571	434	82	19020	478	0	20014
16572	189	47	375	19353	0	19964
16573	147	39	19147	572	0	19905
16574	18239	34	422	478	0	19173
16575	413	18349	378	250	0	19390
16576	345	346	103	16540	0	17334
16577	189	272	16463	387	0	17311
16578	123	79	15422	338	0	15962
16579	13999	51	430	154	0	14634
16580	265	14276	314	121	0	14976
16581	10624	120	316	59	0	11119
16582	10251	95	56	44	0	10446
16583	10382	24	27	40	0	10473
16584	221	27	21	10166	0	10435
16585	136	21	10192	167	0	10516
16586	55	10375	108	117	0	10655
16587	42	178	91	10352	0	10663
16588	45	90	10804	130	0	11069
16589	72	21	10254	98	0	10445
16590	35	49	152	10060	0	10296
16591	34	12	9973	102	0	10121
16592	9478	22	98	94	0	9692
16593	102	26	89	10003	0	10220
16594	98	18	32	10215	0	10363
16595	10159	17	21	177	0	10374
16596	90	10125	32	110	0	10357
16597	10866	82	38	43	0	11029
16598	116	87	34	10715	0	10952
16599	113	31	25	10666	0	10835
16600	58	17	21	10779	0	10875
16601	46	31	24	10614	0	10715
16602	10430	18	32	173	0	10653
16603	121	22	10705	122	0	10970
16604	106	10612	96	57	0	10871
16605	46	90	98	10671	0	10905
16606	10568	94	46	111	0	10819
16607	10776	27	37	113	0	10953
16608	182	10784	34	57	0	11057
16609	10605	97	36	58	0	10796
16610	119	10780	40	55	0	10994
16611	144	10998	44	60	0	11246
16612	55	152	38	11148	0	11393
16613	48	99	11093	120	0	11360
16614	57	144	97	10873	0	11171
16615	10804	34	86	110	0	11034
16616	125	11023	31	102	0	11281
16617	99	92	23	11245	0	11459
16618	43	72	12901	130	0	13146
16619	12953	30	115	109	0	13207
16620	13444	33	92	60	0	13629
16621	13511	32	35	51	0	13629
16622	183	19	13130	37	0	13369
16623	12820	24	95	50	0	12989
16624	107	13061	94	50	0	13312
16625	91	74	35	12703	0	12903
16626	51	12996	27	92	0	13166
16627	13011	86	26	93	0	13216
16628	12502	79	37	53	0	12671
16629	144	35	13422	44	0	13645
16630	93	13144	78	56	0	13371
16631	41	101	71	13001	0	13214
16632	45	65	28	12972	0	13110
16633	35	33	28	12905	0	13001
16634	31	19	30	12879	0	12959
16635	47	23	27	13126	0	13223
16636	47	29	13000	152	0	13228
16637	44	12876	87	123	0	13130
16638	12963	88	77	69	0	13197
16639	143	66	13208	53	0	13470
16640	101	13468	94	66	0	13729
16641	13542	100	67	60	0	13769
16642	138	77	13925	38	0	14178
16643	13314	44	118	51	0	13527
16644	13282	52	83	37	0	13454
16645	13085	45	37	51	0	13218
16646	184	13784	29	64	0	14061
16647	119	110	13527	37	0	13793
16648	53	13746	114	43	0	13956
16649	62	155	86	12423	0	12726
16650	36	13669	29	122	0	13856
16651	13448	126	26	77	0	13677
16652	13687	77	16	55	0	13835
16653	13580	24	31	48	0	13683
16654	218	22	13957	40	0	14237
16655	127	14321	115	48	0	14611
16656	54	145	94	15364	0	15657
16657	17212	105	30	161	0	17508
16658	168	17202	36	150	0	17556
16659	178	167	21	17290	0	17656
16660	92	169	17574	162	0	17997
16661	17055	59	188	159	0	17461
16662	217	29	18991	51	0	19288
16663	231	26	19271	28	0	19556
16664	17762	38	355	26	0	18181
16665	211	25	18493	41	0	18770
16666	17500	15	273	17	0	17805
16667	194	17630	193	26	0	18043
16668	18011	160	44	27	0	18242
16669	205	182	11	17625	0	18023
16670	201	42	40	17355	0	17638
16671	42	24	17	18059	0	18142
16672	17659	16	17	370	0	18062
16673	17373	12	25	215	0	17625
16674	17638	16	20	45	0	17719
16675	380	17468	19	43	0	17910
16676	231	173	11	17430	0	17845
16677	64	349	17059	185	0	17657
16678	30	44	185	16915	0	17174
16679	28	16875	190	217	0	17310
16680	40	179	49	16753	0	17021
16681	36	193	26	16907	0	17162
16682	16839	43	19	349	0	17250
16683	211	38	18	17074	0	17341
16684	228	21	16771	237	0	17257
16685	85	27	16749	209	0	17070
16686	55	44	361	16714	0	17174
16687	16743	31	225	218	0	17217
16688	227	28	91	16274	0	16620
16689	232	26	51	16709	0	17018
16690	89	20	16614	364	0	17087
16691	46	16443	234	255	0	16978
16692	80	197	212	16347	0	16836
16693	16147	201	90	206	0	16644
16694	233	16353	63	237	0	16886
16695	239	200	59	16479	0	16977
16696	107	202	16506	224	0	17039
16697	95	101	221	15980	0	16397
16698	15693	36	215	260	0	16204
16699	244	15745	59	273	0	16321
16700	274	201	15754	104	0	16333
16701	116	204	203	15606	0	16129
16702	88	51	15914	282	0	16335
16703	15151	51	250	246	0	15698
16704	15419	46	214	124	0	15803
16705	434	37	15562	95	0	16128
16706	286	42	227	15388	0	15943
16707	133	66	15578	264	0	16041
16708	88	15314	258	301	0	15961
16709	82	214	238	15390	0	15924
16710	87	228	15448	267	0	16030
16711	69	70	247	14812	0	15198
16712	69	15119	246	310	0	15744
16713	87	204	106	15424	0	15821
16714	87	203	15060	328	0	15678
16715	14492	77	247	272	0	15088
16716	254	14878	254	148	0	15534
16717	14971	206	89	132	0	15398
16718	283	214	13427	115	0	14039
16719	12969	83	280	116	0	13448
16720	290	54	13152	134	0	13630
16721	12848	47	254	121	0	13270
16722	12929	71	238	120	0	13358
16723	428	72	85	12692	0	13277
16724	275	67	87	12989	0	13418
16725	12732	70	88	462	0	13352
16726	265	13043	98	322	0	13728
16727	13294	258	90	147	0	13789
16728	298	235	112	13038	0	13683
16729	278	13087	98	331	0	13794
16730	145	252	123	13425	0	13945
16731	149	224	108	13614	0	14095
16732	128	88	110	13612	0	13938
16733	102	13692	137	489	0	14420
16734	13654	232	100	331	0	14317
16735	300	220	99	13705	0	14324
16736	288	95	13461	306	0	14150
16737	133	69	13319	327	0	13848
16738	115	50	13417	155	0	13737
16739	12833	57	436	149	0	13475
16740	12796	77	271	142	0	13286
16741	422	58	12578	155	0	13213
16742	292	74	248	11782	0	12396
16743	130	78	239	11977	0	12424
16744	93	65	12145	418	0	12721
16745	103	70	12137	297	0	12607
16746	99	46	391	12277	0	12813
16747	12319	58	264	250	0	12891
16748	11956	62	119	272	0	12409
16749	12136	55	90	131	0	12412
16750	427	11990	87	119	0	12623
16751	292	12301	81	121	0	12795
16752	134	314	69	11872	0	12389
16753	11817	202	141	231	0	12391
16754	215	80	11708	236	0	12239
16755	10826	74	181	121	0	11202
16756	182	9906	174	105	0	10367
16757	123	8203	40	62	0	8428
16758	8028	180	38	49	0	8295
16759	127	8116	45	48	0	8336
16760	136	7714	33	47	0	7930
16761	7113	237	331	109	0	7790
16762	64	6507	23	26	0	6620
16763	36	51	17	6277	0	6381
16764	19	28	9	6338	0	6394
16765	6407	12	14	75	0	6508
16766	6321	10	12	42	0	6385
16767	74	6457	13	26	0	6570
16768	35	6734	15	19	0	6803
16769	33	67	6757	47	0	6904
16770	6649	98	140	19	0	6906
16771	6991	20	25	21	0	7057
16772	7209	11	8	23	0	7251
16773	88	9	10	7451	0	7558
16774	44	11	13	7818	0	7886
16775	8173	11	15	106	0	8305
16776	88	6	11	8218	0	8323
16777	66	9	8221	84	0	8380
16778	29	19	70	8099	0	8217
16779	22	8196	49	88	0	8355
16780	12	88	15	8296	0	8411
16781	11	57	18	8564	0	8650
16782	22	20	13	8722	0	8777
16783	8619	10	18	143	0	8790
16784	84	8735	13	96	0	8928
16785	74	78	11	8720	0	8883
16786	30	70	8643	91	0	8834
16787	37	13	8446	82	0	8578
16788	23	17	134	8405	0	8579
16789	14	19	78	8562	0	8673
16790	8553	11	30	142	0	8736
16791	85	16	14	8454	0	8569
16792	86	8515	8	102	0	8711
16793	31	77	8876	90	0	9074
16794	24	74	75	8880	0	9053
16795	27	24	9358	98	0	9507
16796	15	19	83	9315	0	9432
16797	9360	11	74	93	0	9538
16798	9494	17	20	93	0	9624
16799	143	9445	22	64	0	9674
16800	88	80	11	9510	0	9689
16801	9989	77	10	93	0	10169
16802	10052	14	16	84	0	10166
16803	10240	16	21	33	0	10310
16804	10264	18	17	27	0	10326
16805	10329	16	13	23	0	10381
16806	160	10112	20	26	0	10318
16807	10289	78	22	22	0	10411
16808	111	76	10342	23	0	10552
16809	101	20	79	10246	0	10446
16810	10319	16	65	103	0	10503
16811	10136	16	19	86	0	10257
16812	10140	17	16	40	0	10213
16813	170	16	10243	31	0	10460
16814	101	16	81	10330	0	10528
16815	10590	11	79	108	0	10788
16816	104	10442	23	105	0	10674
16817	10870	84	20	37	0	11011
16818	10653	79	9	46	0	10787
16819	10743	22	12	51	0	10828
16820	166	23	15	11108	0	11312
16821	11384	23	12	118	0	11537
16822	121	30	11529	94	0	11774
16823	107	23	11539	38	0	11707
16824	11400	17	171	38	0	11626
16825	109	19	11761	36	0	11925
16826	10920	13	83	36	0	11052
16827	109	19	11488	25	0	11641
16828	88	15	81	11178	0	11362
16829	11065	14	77	91	0	11247
16830	88	11213	40	103	0	11444
16831	11282	65	17	43	0	11407
16832	88	11082	16	51	0	11237
16833	86	11567	16	36	0	11705
16834	36	129	12	11687	0	11864
16835	24	83	13	11676	0	11796
16836	19	23	17	11812	0	11871
16837	25	20	11749	155	0	11949
16838	11142	9	94	98	0	11343
16839	12157	10	73	53	0	12293
16840	12238	9	21	36	0	12304
16841	12277	8	17	34	0	12336
16842	12320	17	22	36	0	12395
16843	208	15	12159	33	0	12415
16844	129	9	12324	28	0	12490
16845	58	11	154	12421	0	12644
16846	58	13	12679	103	0	12853
16847	12055	16	103	98	0	12272
16848	131	12995	92	37	0	13255
16849	116	104	25	13682	0	13927
16850	14021	86	20	126	0	14253
16851	151	16	20	14309	0	14496
16852	143	17	14381	149	0	14690
16853	66	7	14683	128	0	14884
16854	60	9	214	15231	0	15514
16855	58	9	15633	138	0	15838
16856	14907	8	149	124	0	15188
16857	153	12	121	15472	0	15758
16858	161	9	15577	145	0	15892
16859	52	15965	130	166	0	16313
16860	63	127	110	16153	0	16453
16861	63	107	16823	155	0	17148
16862	50	32	137	16238	0	16457
16863	48	18	135	16402	0	16603
16864	44	11	16946	263	0	17264
16865	55	7	145	16658	0	16865
16866	53	24	157	16107	0	16341
16867	52	13	38	16837	0	16940
16868	16299	9	33	273	0	16614
16869	161	16263	26	174	0	16624
16870	155	16745	22	55	0	16977
16871	60	229	16685	45	0	17019
16872	15705	122	126	25	0	15978
16873	128	32	16232	23	0	16415
16874	138	16	15923	22	0	16099
16875	30	8	185	15285	0	15508
16876	15532	6	108	121	0	15767
16877	98	15586	29	135	0	15848
16878	15605	87	29	42	0	15763
16879	15618	93	13	33	0	15757
16880	184	15999	16	30	0	16229
16881	15794	91	12	21	0	15918
16882	15466	79	15	34	0	15594
16883	166	15765	24	31	0	15986
16884	90	94	17	15510	0	15711
16885	49	78	20	15804	0	15951
16886	16431	21	24	161	0	16637
16887	102	16746	13	176	0	17037
16888	17574	92	19	39	0	17724
16889	17473	96	27	28	0	17624
16890	18578	23	17	37	0	18655
16891	242	6	26	18320	0	18594
16892	139	9	28	18614	0	18790
16893	18484	4	20	257	0	18765
16894	18429	15	33	155	0	18632
16895	18486	12	20	47	0	18565
16896	261	14	17	19484	0	19776
16897	151	18	19733	166	0	20068
16898	44	18	153	19772	0	19987
16899	30	12	159	21246	0	21447
16900	37	19	20939	313	0	21308
16901	39	28	23201	203	0	23471
16902	23	19	354	23470	0	23866
16903	43	13	23769	242	0	24067
16904	23761	14	260	282	0	24317
16905	224	22	276	24023	0	24545
16906	273	12	70	24790	0	25145
16907	25606	15	34	484	0	26139
16908	250	28	28	25792	0	26098
16909	293	26	43	25593	0	25955
16910	79	25	29	26210	0	26343
16911	52	28	30	26432	0	26542
16912	58	29	25979	563	0	26629
16913	43	19	245	26074	0	26381
16914	57	24	25770	329	0	26180
16915	47	25828	269	427	0	26571
16916	53	247	288	25778	0	26366
16917	74	284	25489	309	0	26156
16918	23606	66	280	347	0	24299
16919	258	25257	302	140	0	25957
16920	25203	240	104	93	0	25640
16921	319	284	69	23734	0	24406
16922	309	24978	47	279	0	25613
16923	24841	254	39	298	0	25432
16924	284	25363	44	107	0	25798
16925	25342	280	64	81	0	25767
16926	302	295	34	24896	0	25527
16927	25255	60	41	305	0	25661
16928	310	25316	48	349	0	26023
16929	25563	254	33	133	0	25983
16930	348	294	24994	97	0	25733
16931	342	89	269	25045	0	25745
16932	24710	37	320	328	0	25395
16933	24736	34	88	365	0	25223
16934	580	30	50	24653	0	25313
16935	385	38	24742	346	0	25511
16936	141	24357	266	374	0	25138
16937	93	24981	315	167	0	25556
16938	25143	509	125	112	0	25889
16939	297	321	72	24496	0	25186
16940	335	80	70	24901	0	25386
16941	24629	42	68	579	0	25318
16942	23656	50	72	417	0	24195
16943	590	41	24662	161	0	25454
16944	396	52	271	24390	0	25109
16945	147	42	24573	375	0	25137
16946	111	24289	295	400	0	25095
16947	23626	240	307	185	0	24358
16948	273	23809	105	160	0	24347
16949	332	23795	72	165	0	24364
16950	180	479	125	23362	0	24146
16951	22745	303	77	333	0	23458
16952	289	22961	83	401	0	23734
16953	22608	243	79	180	0	23110
16954	293	22456	95	161	0	23005
16955	313	283	67	22220	0	22883
16956	22054	298	77	339	0	22768
16957	320	105	22396	367	0	23188
16958	355	113	247	22013	0	22728
16959	180	65	21974	373	0	22592
16960	151	20931	288	450	0	21820
16961	145	21320	293	227	0	21985
16962	20820	443	170	238	0	21671
16963	288	21298	90	288	0	21964
16964	21348	286	97	186	0	21917
16965	21188	305	98	181	0	21772
16966	519	104	21283	191	0	22097
16967	21008	107	281	179	0	21575
16968	357	99	21799	193	0	22448
16969	359	21751	312	176	0	22598
16970	21447	291	328	164	0	22230
16971	321	21402	133	180	0	22036
16972	406	319	94	21385	0	22204
16973	21519	323	95	346	0	22283
16974	393	133	83	21529	0	22138
16975	393	123	21751	366	0	22633
16976	210	141	246	21677	0	22274
16977	203	134	305	21993	0	22635
16978	21908	123	111	567	0	22709
16979	326	122	21832	431	0	22711
16980	21845	123	263	189	0	22420
16981	22064	130	297	157	0	22648
16982	625	140	173	21719	0	22657
16983	457	130	99	22043	0	22729
16984	21910	139	102	544	0	22695
16985	394	22459	87	387	0	23327
16986	433	289	79	21812	0	22613
16987	236	328	21462	300	0	22326
16988	181	149	20239	557	0	21126
16989	158	20963	424	139	0	21684
16990	188	261	291	19906	0	20646
16991	127	312	97	20130	0	20666
16992	19953	143	74	460	0	20630
16993	308	110	60	19649	0	20127
16994	18773	142	51	307	0	19273
16995	283	18585	78	367	0	19313
16996	275	18300	65	135	0	18775
16997	123	18946	64	112	0	19245
16998	18115	395	93	152	0	18755
16999	16096	213	54	69	0	16432
17000	331	15945	62	126	0	16464
17001	12718	82	14	35	0	12849
17002	93	12677	22	40	0	12832
17003	82	92	20	12396	0	12590
17004	34	12745	13	81	0	12873
17005	12748	85	17	67	0	12917
17006	12658	82	11	31	0	12782
17007	134	20	13	12162	0	12329
17008	12314	18	22	92	0	12446
17009	91	31	25	12487	0	12634
17010	91	12736	23	100	0	12950
17011	45	128	24	12806	0	13003
17012	32	12888	18	103	0	13041
17013	12818	80	25	73	0	12996
17014	91	70	12636	34	0	12831
17015	11940	27	54	30	0	12051
17016	67	32	55	12895	0	13049
17017	68	26	13023	71	0	13188
17018	12637	25	48	75	0	12785
17019	87	24	13527	26	0	13664
17020	75	30	56	13061	0	13222
17021	39	21	62	13275	0	13397
17022	36	21	18	13143	0	13218
17023	24	26	23	13259	0	13332
17024	29	13190	13	125	0	13357
17025	32	76	15	14126	0	14249
17026	14091	67	7	98	0	14263
17027	93	20	14534	83	0	14730
17028	89	15727	69	37	0	15922
17029	15897	99	63	28	0	16087
17030	16344	96	17	27	0	16484
17031	182	29	16	18619	0	18846
17032	120	30	18786	167	0	19103
17033	44	17	119	18404	0	18584
17034	40	15	154	19518	0	19727
17035	54	18	19826	294	0	20192
17036	26	20472	135	228	0	20861
17037	20654	209	188	43	0	21094
17038	20332	213	26	47	0	20618
17039	20794	30	31	33	0	20888
17040	354	35	27	20396	0	20812
17041	233	31	10	21616	0	21890
17042	22040	8	8	386	0	22442
17043	225	22	14	20929	0	21190
17044	239	21565	12	286	0	22102
17045	22453	187	9	231	0	22880
17046	23147	235	36	50	0	23468
17047	23817	36	27	54	0	23934
17048	24238	38	19	33	0	24328
17049	552	27	23147	34	0	23760
17050	349	20	23136	40	0	23545
17051	72	22	458	22730	0	23282
17052	58	59	280	23373	0	23770
17053	58	25	23119	478	0	23680
17054	62	24	23051	302	0	23439
17055	44	29	461	22984	0	23518
17056	23001	37	273	263	0	23574
17057	271	18	47	22937	0	23273
17058	316	24	22787	278	0	23405
17059	80	22706	238	326	0	23350
17060	22541	233	304	85	0	23163
17061	22286	268	61	91	0	22706
17062	22286	56	53	76	0	22471
17063	22701	51	46	61	0	22859
17064	569	49	21878	60	0	22556
17065	396	31	236	21998	0	22661
17066	22007	23	272	253	0	22555
17067	331	31	54	22090	0	22506
17068	353	39	54	20678	0	21124
17069	112	21325	57	526	0	22020
17070	117	233	50	21773	0	22173
17071	21351	276	60	306	0	21993
17072	310	21499	51	365	0	22225
17073	21412	243	58	95	0	21808
17074	326	21573	58	120	0	22077
17075	362	314	67	19777	0	20520
17076	131	20620	83	305	0	21139
17077	113	20903	85	338	0	21439
17078	20674	462	103	125	0	21364
17079	337	304	20195	124	0	20960
17080	364	65	19623	115	0	20167
17081	139	62	19808	104	0	20113
17082	18679	90	501	107	0	19377
17083	327	19422	322	118	0	20189
17084	374	19670	106	143	0	20293
17085	18744	434	95	135	0	19408
17086	321	18929	86	159	0	19495
17087	354	19016	98	150	0	19618
17088	165	483	84	19033	0	19765
17089	222	316	18816	319	0	19673
17090	216	87	18994	354	0	19651
17091	218	84	493	18721	0	19516
17092	18715	90	332	331	0	19468
17093	351	18996	119	396	0	19862
17094	411	277	87	19052	0	19827
17095	216	315	18995	357	0	19883
17096	214	113	18117	394	0	18838
17097	195	139	491	17799	0	18624
17098	17767	102	336	379	0	18584
17099	17792	111	137	396	0	18436
17100	645	109	17799	158	0	18711
17101	17901	116	307	172	0	18496
17102	456	115	17843	152	0	18566
17103	491	116	318	16597	0	17522
17104	248	17322	349	433	0	18352
17105	17588	310	154	330	0	18382
17106	413	345	163	17452	0	18373
17107	464	138	178	17319	0	18099
17108	271	108	160	17738	0	18277
17109	283	90	147	17735	0	18255
17110	241	121	16946	591	0	17899
17111	236	16912	345	442	0	17935
17112	256	302	391	16898	0	17847
17113	16812	349	187	382	0	17730
17114	401	140	176	16936	0	17653
17115	450	140	169	16961	0	17720
17116	244	131	16486	592	0	17453
17117	231	112	16308	449	0	17100
17118	210	16116	571	264	0	17161
17119	211	16075	431	214	0	16931
17120	197	528	192	15748	0	16665
17121	15675	354	177	390	0	16596
17122	376	179	15546	408	0	16509
17123	437	15514	319	217	0	16487
17124	271	307	344	14411	0	15333
17125	215	15066	141	360	0	15782
17126	229	318	130	14069	0	14746
17127	183	14365	139	343	0	15030
17128	173	277	129	12788	0	13367
17129	12223	319	99	316	0	12957
17130	281	11713	84	338	0	12416
17131	227	426	65	9182	0	9900
17132	9099	180	73	245	0	9597
17133	201	9202	77	239	0	9719
17134	159	8008	61	105	0	8333
17135	131	7854	50	97	0	8132
17136	155	232	115	6557	0	7059
17137	52	166	126	6377	0	6721
17138	41	6441	44	195	0	6721
17139	56	163	55	6412	0	6686
17140	123	117	6374	127	0	6741
17141	42	5773	104	90	0	6009
17142	40	321	62	4851	0	5274
17143	31	5255	52	76	0	5414
17144	36	95	5295	56	0	5482
17145	20	5105	65	61	0	5251
17146	3645	142	23	62	0	3872
17147	30	18	5	3608	0	3661
17148	3614	4	36	33	0	3687
17149	35	2	3710	29	0	3776
17150	23	1	35	3621	0	3680
17151	6	3	3750	43	0	3802
17152	5	4	39	3710	0	3758
17153	3804	6	28	40	0	3878
17154	38	6	4	3833	0	3881
17155	3837	4	2	47	0	3890
17156	39	4050	3	35	0	4127
17157	4059	37	6	11	0	4113
17158	43	22	4085	15	0	4165
17159	24	4441	40	7	0	4512
17160	2	39	29	4537	0	4607
17161	38	23	4	4616	0	4681
17162	8	10	4562	63	0	4643
17163	4	4650	37	50	0	4741
17164	5	41	28	4562	0	4636
17165	5	4756	12	38	0	4811
17166	3	41	8	4576	0	4628
17167	1	4750	1	38	0	4790
17168	4612	42	6	27	0	4687
17169	36	32	3	4694	0	4765
17170	35	7	4811	42	0	4895
17171	5	4914	37	40	0	4996
17172	7	5016	24	15	0	5062
17173	20	63	4952	5	0	5040
17174	3	4966	69	9	0	5047
17175	2	39	24	4964	0	5029
17176	7	25	5272	36	0	5340
17177	3	4	33	5083	0	5123
17178	0	6	25	5243	0	5274
17179	9	6	5343	54	0	5412
17180	5045	7	36	36	0	5124
17181	39	1	24	5394	0	5458
17182	26	6	6097	36	0	6165
17183	4	6240	33	35	0	6312
17184	6178	36	29	18	0	6261
17185	35	6127	7	18	0	6187
17186	28	34	5	6184	0	6251
17187	6248	24	6	35	0	6313
17188	40	5	6	6227	0	6278
17189	30	10	6521	41	0	6602
17190	7	6	38	6323	0	6374
17191	12	7	6454	34	0	6507
17192	6167	9	38	32	0	6246
17193	38	10	6381	15	0	6444
17194	6351	3	35	16	0	6405
17195	6287	9	27	12	0	6335
17196	62	13	6702	4	0	6781
17197	28	10	6589	15	0	6642
17198	10	6760	50	13	0	6833
17199	6886	36	31	20	0	6973
17200	37	36	9	7160	0	7242
17201	28	14	10	7141	0	7193
17202	8061	9	5	65	0	8140
17203	8330	6	17	39	0	8392
17204	8376	16	7	8	0	8407
17205	8462	10	10	21	0	8503
17206	63	14	11	8347	0	8435
17207	8519	11	11	67	0	8608
17208	41	13	7	8578	0	8639
17209	31	8	8	8537	0	8584
17210	12	10	11	8689	0	8722
17211	15	7	8708	70	0	8800
17212	7	8538	45	53	0	8643
17213	9	8670	41	20	0	8740
17214	9	59	12	8683	0	8763
17215	8652	32	15	47	0	8746
17216	46	11	8	8577	0	8642
17217	8598	9	8	62	0	8677
17218	48	14	9339	38	0	9439
17219	8968	14	41	19	0	9042
17220	47	8	36	9676	0	9767
17221	9975	12	16	48	0	10051
17222	9757	13	12	44	0	9826
17223	10236	5	8	25	0	10274
17224	72	10	11	10368	0	10461
17225	45	7	10426	50	0	10528
17226	12	10	44	10358	0	10424
17227	10576	6	37	58	0	10677
17228	57	11	12286	44	0	12398
17229	49	9	52	12838	0	12948
17230	13369	12	47	66	0	13494
17231	75	8	13861	48	0	13992
17232	14624	8	71	24	0	14727
17233	15104	9	49	22	0	15184
17234	130	8	14	15252	0	15404
17235	71	8	18	15667	0	15764
17236	15732	6	16	138	0	15892
17237	87	8	6	16248	0	16349
17238	16166	9	10	98	0	16283
17239	94	16274	11	116	0	16495
17240	83	16417	7	45	0	16552
17241	28	156	3	16568	0	16755
17242	25	92	17482	93	0	17692
17243	13	17589	81	121	0	17804
17244	17156	89	81	27	0	17353
17245	74	17070	17	33	0	17194
17246	83	80	16965	13	0	17141
17247	17	78	69	16490	0	16654
17248	14	17	17397	80	0	17508
17249	4	17816	74	104	0	17998
17250	9	110	72	17569	0	17760
17251	5	17835	16	71	0	17927
17252	22	71	17748	66	0	17907
17253	4	70	67	17222	0	17363
17254	17	14	17958	76	0	18065
17255	4	5	79	17591	0	17679
17256	17675	3	72	97	0	17847
17257	72	10	17612	73	0	17767
17258	16848	5	68	27	0	16948
17259	84	6	17587	18	0	17695
17260	81	3	75	17221	0	17380
17261	33	4	18083	75	0	18195
17262	18	5	77	17879	0	17979
17263	13	6	75	17895	0	17989
17264	16	19	33	17607	0	17675
17265	12	2	8	18041	0	18063
17266	19	12	19111	158	0	19300
17267	18228	19	70	94	0	18411
17268	66	14	68	20086	0	20234
17269	20304	10	29	88	0	20431
17270	20280	12	18	91	0	20401
17271	20552	10	16	39	0	20617
17272	179	18	10	20931	0	21138
17273	121	15	19	21431	0	21586
17274	28	24327	12	192	0	24559
17275	26993	153	27	123	0	27296
17276	28425	145	23	52	0	28645
17277	28863	39	25	26	0	28953
17278	461	34	29338	39	0	29872
17279	270	18	224	29170	0	29682
17280	91	28	29268	280	0	29667
17281	28564	14	263	259	0	29100
17282	29041	19	229	79	0	29368
17283	435	14	65	28680	0	29194
17284	292	46	48	27979	0	28365
17285	78	29586	40	422	0	30126
17286	29510	216	37	275	0	30038
17287	29446	214	29	81	0	29770
17288	448	29394	47	64	0	29953
17289	29888	217	34	74	0	30213
17290	285	224	44	29660	0	30213
17291	254	73	37	30349	0	30713
17292	30396	32	33	464	0	30925
17293	298	27	30347	299	0	30971
17294	30196	25	240	109	0	30570
17295	30733	40	233	77	0	31083
17296	472	30365	65	135	0	31037
17297	30843	250	37	85	0	31215
17298	378	242	30336	62	0	31018
17299	337	78	252	30295	0	30962
17300	30156	47	250	276	0	30729
17301	326	45	100	30321	0	30792
17302	328	60	29713	354	0	30455
17303	146	40	306	29087	0	29579
17304	133	33002	301	341	0	33777
17305	136	301	125	33508	0	34070
17306	141	263	81	33797	0	34282
17307	111	88	83	33790	0	34072
17308	113	67	68	34341	0	34589
17309	120	76	34008	598	0	34802
17310	141	73	257	33901	0	34372
17311	33943	68	270	357	0	34638
17312	331	33827	97	386	0	34641
17313	357	288	61	34716	0	35422
17314	175	263	35239	377	0	36054
17315	135	87	291	35256	0	35769
17316	35316	52	295	398	0	36061
17317	34362	49	114	359	0	34884
17318	34363	42	93	181	0	34679
17319	647	55	84	34686	0	35472
17320	444	50	34645	349	0	35488
17321	209	34308	328	399	0	35244
17322	35047	264	315	183	0	35809
17323	385	266	135	34439	0	35225
17324	393	76	69	34911	0	35449
17325	246	52	35007	621	0	35926
17326	161	34787	305	472	0	35725
17327	153	35739	298	220	0	36410
17328	192	765	158	33692	0	34807
17329	182	299	33509	380	0	34370
17330	31697	103	273	421	0	32494
17331	359	88	33533	234	0	34214
17332	30812	54	301	206	0	31373
17333	334	34212	352	224	0	35122
17334	363	225	34099	212	0	34899
17335	32575	238	280	139	0	33232
17336	363	33575	262	169	0	34369
17337	35603	261	108	131	0	36103
17338	393	241	35880	159	0	36673
17339	335	36159	289	184	0	36967
17340	36528	250	300	132	0	37210
17341	425	209	36141	153	0	36928
17342	35524	70	278	153	0	36025
17343	401	60	246	35570	0	36277
17344	36285	84	127	325	0	36821
17345	402	77	107	36189	0	36775
17346	36325	92	85	364	0	36866
17347	392	90	37246	320	0	38048
17348	349	71	282	37042	0	37744
17349	194	91	236	37050	0	37571
17350	145	91	37557	512	0	38305
17351	162	96	288	36974	0	37520
17352	143	37154	306	454	0	38057
17353	166	254	129	39296	0	39845
17354	170	233	127	40543	0	41073
17355	190	115	107	43538	0	43950
17356	181	92	43857	669	0	44799
17357	43101	77	414	438	0	44030
17358	531	94	345	46228	0	47198
17359	447	76	47863	536	0	48922
17360	47124	64	591	456	0	48235
17361	47887	75	426	246	0	48634
17362	49244	101	158	168	0	49671
17363	922	106	141	48925	0	50094
17364	547	99	116	52836	0	53598
17365	273	113	130	51528	0	52044
17366	156	52392	114	1196	0	53858
17367	51752	593	138	660	0	53143
17368	51093	490	155	311	0	52049
17369	1102	156	107	51728	0	53093
17370	778	87	51000	727	0	52592
17371	288	61	51643	623	0	52615
17372	158	50329	1061	302	0	51850
17373	144	51410	581	266	0	52401
17374	46972	1199	400	367	0	48938
17375	546	45989	74	121	0	46730
17376	44811	490	93	63	0	45457
17377	44085	352	38	74	0	44549
17378	44831	59	41	61	0	44992
17379	846	47	54	44912	0	45859
17380	440	36	44	48006	0	48526
17381	49072	35	52	908	0	50067
17382	632	40	37	50635	0	51344
17383	472	58	50238	722	0	51490
17384	50271	47	621	495	0	51434
17385	734	66	441	49506	0	50747
17386	526	67	101	49823	0	50517
17387	155	42	69	51609	0	51875
17388	160	56	50366	1142	0	51724
17389	47924	52	675	602	0	49253
17390	746	61	50390	182	0	51379
17391	526	55	694	49854	0	51129
17392	194	68	51081	713	0	52056
17393	137	80	730	49600	0	50547
17394	131	77	517	50409	0	51134
17395	173	78	50819	1160	0	52230
17396	182	87	711	47466	0	48446
17397	140	51037	510	729	0	52416
17398	50646	689	134	562	0	52031
17399	50321	517	121	213	0	51172
17400	1213	108	88	51025	0	52434
17401	706	87	51528	844	0	53165
17402	256	50060	703	670	0	51689
17403	190	51475	535	298	0	52498
17404	48285	1097	169	238	0	49789
17405	828	542	47401	222	0	48993
17406	47265	116	738	213	0	48332
17407	844	88	551	46809	0	48292
17408	626	66	189	47921	0	48802
17409	46796	46	167	1291	0	48300
17410	767	47123	139	841	0	48870
17411	643	666	47775	329	0	49413
17412	246	577	794	46742	0	48359
17413	201	125	47661	902	0	48889
17414	178	46539	825	759	0	48301
17415	169	698	635	46681	0	48183
17416	45921	535	223	955	0	47634
17417	45922	140	237	755	0	47054
17418	1322	184	46187	356	0	48049
17419	746	46365	798	319	0	48228
17420	46066	736	642	299	0	47743
17421	877	46788	244	322	0	48231
17422	714	826	212	45700	0	47452
17423	45548	594	209	909	0	47260
17424	958	198	193	45874	0	47223
17425	764	166	45100	1033	0	47063
17426	383	140	842	45361	0	46726
17427	393	178	45048	1017	0	46636
17428	369	180	887	44693	0	46129
17429	44230	163	687	1056	0	46136
17430	902	44506	301	887	0	46596
17431	44392	807	278	428	0	45905
17432	984	673	286	43436	0	45379
17433	833	273	259	43108	0	44473
17434	417	284	41623	1457	0	43781
17435	388	226	42849	875	0	44338
17436	348	42521	1336	508	0	44713
17437	397	869	41211	423	0	42900
17438	37989	701	977	354	0	40021
17439	951	40228	761	395	0	42335
17440	819	40808	347	397	0	42371
17441	455	41483	276	406	0	42620
17442	474	1409	243	39992	0	42118
17443	433	774	40134	1101	0	42442
17444	352	40321	894	996	0	42563
17445	411	885	788	37111	0	39195
17446	377	40881	295	1007	0	42560
17447	38701	882	320	912	0	40815
17448	38947	701	333	508	0	40489
17449	1451	280	309	38408	0	40448
17450	861	245	332	38479	0	39917
17451	37126	198	317	1571	0	39212
17452	938	36342	357	1088	0	38725
17453	841	36751	350	569	0	38511
17454	374	1350	369	33626	0	35719
17455	318	658	31576	974	0	33526
17456	265	31071	802	770	0	32908
17457	28309	831	752	334	0	30226
17458	662	28289	295	360	0	29606
17459	538	27498	259	335	0	28630
17460	25570	971	261	253	0	27055
17461	592	26078	292	361	0	27323
17462	524	677	25101	262	0	26564
17463	211	25195	588	237	0	26231
17464	20010	539	368	181	0	21098
17465	405	20300	162	190	0	21057
17466	20045	468	137	147	0	20797
17467	453	404	130	19605	0	20592
17468	382	190	139	20058	0	20769
17469	185	180	19744	668	0	20777
17470	148	19889	400	421	0	20858
17471	156	438	325	19561	0	20480
17472	19297	375	140	435	0	20247
17473	19320	189	143	370	0	20022
17474	578	19991	125	209	0	20903
17475	344	428	118	19653	0	20543
17476	19857	399	92	420	0	20768
17477	20055	214	118	349	0	20736
17478	603	205	19074	166	0	20048
17479	408	166	18008	142	0	18724
17480	127	192	16554	103	0	16976
17481	67	15091	371	97	0	15626
17482	13371	197	378	87	0	14033
17483	179	13439	53	60	0	13731
17484	13020	186	96	45	0	13347
17485	174	13709	31	49	0	13963
17486	154	180	37	13592	0	13963
17487	13938	171	37	155	0	14301
17488	174	80	13907	148	0	14309
17489	13523	77	145	56	0	13801
17490	13786	67	157	33	0	14043
17491	274	13705	40	53	0	14072
17492	125	13562	32	36	0	13755
17493	13748	265	85	32	0	14130
17494	144	135	14205	42	0	14526
17495	13322	153	112	34	0	13621
17496	13118	38	185	24	0	13365
17497	213	38	27	12856	0	13134
17498	12975	30	24	96	0	13125
17499	119	40	22	13497	0	13678
17500	114	31	18	13708	0	13871
17501	46	46	18	13128	0	13238
17502	44	13146	17	178	0	13385
17503	13166	118	23	114	0	13421
17504	13148	112	27	46	0	13333
17505	203	38	31	13097	0	13369
17506	138	49	32	12942	0	13161
17507	74	13192	28	177	0	13471
17508	13152	123	40	110	0	13425
17509	138	115	13097	44	0	13394
17510	130	57	113	13101	0	13401
17511	92	53	12896	122	0	13163
17512	69	54	121	12781	0	13025
17513	74	59	13251	117	0	13501
17514	96	53	109	12927	0	13185
17515	13032	59	108	129	0	13328
17516	158	50	13503	136	0	13847
17517	13078	44	114	55	0	13291
17518	173	14066	110	50	0	14399
17519	168	120	54	13961	0	14303
17520	85	134	46	14104	0	14369
17521	14856	63	40	180	0	15139
17522	172	55	38	15750	0	16015
17523	176	61	16477	129	0	16843
17524	16029	58	113	144	0	16344
17525	16716	60	107	73	0	16956
17526	16751	54	37	66	0	16908
17527	16756	45	39	73	0	16913
17528	262	16716	34	86	0	17098
17529	161	101	46	16539	0	16847
17530	16285	106	31	201	0	16623
17531	148	49	23	15857	0	16077
17532	15532	53	39	125	0	15749
17533	166	47	15376	103	0	15692
17534	154	38	15654	48	0	15894
17535	99	246	153	14438	0	14936
17536	75	15255	106	126	0	15562
17537	72	15802	48	135	0	16057
17538	15622	172	52	82	0	15928
17539	130	97	15632	72	0	15931
17540	14676	24	87	91	0	14878
17541	110	15884	93	77	0	16164
17542	16114	78	42	81	0	16315
17543	126	78	39	15810	0	16053
17544	133	32	16652	118	0	16935
17545	95	29	84	16428	0	16636
17546	74	42	92	16197	0	16405
17547	71	16681	36	167	0	16955
17548	74	17772	53	113	0	18012
17549	85	140	34	17566	0	17825
17550	74	18093	49	188	0	18404
17551	95	94	18261	113	0	18563
17552	96	78	18061	59	0	18294
17553	16649	44	171	79	0	16943
17554	17922	22	102	85	0	18131
17555	189	18075	44	76	0	18384
17556	149	84	37	17925	0	18195
17557	112	90	42	18108	0	18352
17558	102	40	18179	159	0	18480
17559	78	55	96	17214	0	17443
17560	131	18158	84	152	0	18525
17561	93	96	18056	135	0	18380
17562	88	95	18034	66	0	18283
17563	89	17969	169	97	0	18324
17564	97	119	18334	77	0	18627
17565	89	97	111	17834	0	18131
17566	95	75	130	17294	0	17594
17567	86	51	18539	165	0	18841
17568	81	113	87	18118	0	18399
17569	68	18146	104	150	0	18468
17570	63	18958	48	304	0	19373
17571	73	265	35	18850	0	19223
17572	126	100	19102	120	0	19448
17573	54	19121	112	130	0	19417
17574	112	95	95	18752	0	19054
17575	39	172	18528	113	0	18852
17576	16698	36	85	100	0	16919
17577	17710	25	75	35	0	17845
17578	17768	24	38	26	0	17856
17579	150	13	18	17657	0	17838
17580	82	24	36	17777	0	17919
17581	62	13	18689	135	0	18899
17582	24	29	75	18345	0	18473
17583	21	37	87	18579	0	18724
17584	28	24	18820	159	0	19031
17585	15726	22	101	112	0	15961
17586	65	17899	72	52	0	18088
17587	17698	69	30	13	0	17810
17588	75	17885	20	27	0	18007
17589	66	207	18	17781	0	18072
17590	41	67	17885	90	0	18083
17591	19	79	68	17400	0	17566
17592	16	27	17573	91	0	17707
17593	14937	17	97	86	0	15137
17594	77	13	16899	27	0	17016
17595	59	17	84	16239	0	16399
17596	39	13	17043	75	0	17170
17597	25	17080	78	82	0	17265
17598	32	78	87	17059	0	17256
17599	29	74	38	17103	0	17244
17600	19	17	13	17674	0	17723
17601	25	9	17682	169	0	17885
17602	32	20	17827	107	0	17986
17603	14	20	162	17858	0	18054
17604	23	17	109	20858	0	21007
17605	24	20	34	22797	0	22875
17606	23547	22	25	329	0	23923
17607	201	23	27	24723	0	24974
17608	204	25	26246	259	0	26734
17609	27657	21	249	240	0	28167
17610	269	30	241	28980	0	29520
17611	30202	12	75	326	0	30615
17612	30289	16	61	286	0	30652
17613	552	8	51	30566	0	31177
17614	30694	22	61	323	0	31100
17615	30225	30	244	317	0	30816
17616	580	19	30681	107	0	31387
17617	345	30856	301	72	0	31574
17618	116	327	289	28926	0	29658
17619	37	288	100	30512	0	30937
17620	30373	76	42	585	0	31076
17621	29280	34	60	393	0	29767
17622	29400	21	60	140	0	29621
17623	637	21	28147	95	0	28900
17624	366	28338	314	115	0	29133
17625	28268	282	330	72	0	28952
17626	324	28441	103	99	0	28967
17627	28726	343	67	90	0	29226
17628	383	293	62	28359	0	29097
17629	28502	74	52	364	0	28992
17630	28223	35	53	382	0	28693
17631	28616	15	60	134	0	28825
17632	696	109	28895	112	0	29812
17633	28946	25	322	95	0	29388
17634	431	28723	322	223	0	29699
17635	29445	303	96	105	0	29949
17636	29267	295	64	125	0	29751
17637	29602	91	66	117	0	29876
17638	715	42	65	28971	0	29793
17639	462	28954	59	393	0	29868
17640	28984	313	46	370	0	29713
17641	465	307	28642	158	0	29572
17642	435	28585	323	155	0	29498
17643	245	343	319	26200	0	27107
17644	183	27695	103	322	0	28303
17645	27639	375	75	316	0	28405
17646	27915	334	67	147	0	28463
17647	742	109	58	27713	0	28622
17648	511	76	27042	416	0	28045
17649	262	27010	334	416	0	28022
17650	285	371	401	24389	0	25446
17651	240	358	137	27126	0	27861
17652	221	113	90	28368	0	28792
17653	28130	94	82	698	0	29004
17654	28128	90	86	455	0	28759
17655	28352	94	70	166	0	28682
17656	28815	78	54	132	0	29079
17657	902	72	81	28241	0	29296
17658	609	97	29041	455	0	30202
17659	336	76	386	29227	0	30025
17660	281	94	370	28840	0	29585
17661	275	97	133	29240	0	29745
17662	288	100	95	29516	0	29999
17663	28881	93	92	835	0	29901
17664	614	98	126	29082	0	29920
17665	29021	93	106	533	0	29753
17666	29048	94	124	499	0	29765
17667	979	100	28169	264	0	29512
17668	730	92	27969	236	0	29027
17669	466	90	29037	240	0	29833
17670	389	99	770	27783	0	29041
17671	406	123	28437	500	0	29466
17672	494	99	441	27515	0	28549
17673	342	150	407	27775	0	28674
17674	27971	114	141	782	0	29008
17675	654	125	118	27285	0	28182
17676	671	28812	106	560	0	30149
17677	29424	370	145	505	0	30444
17678	672	29730	117	336	0	30855
17679	728	411	29507	243	0	30889
17680	403	29847	385	236	0	30871
17681	29390	455	385	203	0	30433
17682	679	462	164	29036	0	30341
17683	731	220	28992	475	0	30418
17684	28950	158	377	493	0	29978
17685	727	148	403	29072	0	30350
17686	712	133	29503	501	0	30849
17687	493	146	391	29584	0	30614
17688	439	127	432	29459	0	30457
17689	471	129	195	29662	0	30457
17690	438	29571	154	751	0	30914
17691	29674	413	139	531	0	30757
17692	718	424	144	29069	0	30355
17693	687	29695	142	492	0	31016
17694	491	450	99	30181	0	31221
17695	399	460	29922	560	0	31341
17696	362	30182	380	540	0	31464
17697	29863	430	437	266	0	30996
17698	30426	496	182	244	0	31348
17699	871	220	150	29354	0	30595
17700	647	211	111	29917	0	30886
17701	29889	178	136	778	0	30981
17702	28882	172	156	517	0	29727
17703	851	29925	127	293	0	31196
17704	26531	346	120	299	0	27296
17705	548	284	25139	169	0	26140
17706	421	107	24886	177	0	25591
17707	178	24496	458	181	0	25313
17708	133	23656	368	177	0	24334
17709	20855	342	686	111	0	21994
17710	310	21053	140	159	0	21662
17711	20271	140	82	75	0	20568
17712	19921	147	27	63	0	20158
17713	19576	29	29	74	0	19708
17714	261	32	37	19633	0	19963
17715	19859	24	37	177	0	20097
17716	205	15	19900	180	0	20300
17717	194	17	20214	79	0	20504
17718	68	20488	227	124	0	20907
17719	88	119	20744	85	0	21036
17720	79	118	145	19798	0	20140
17721	67	38	20719	174	0	20998
17722	79	28	20437	174	0	20718
17723	62	36	245	20292	0	20635
17724	20490	32	143	186	0	20851
17725	20232	29	64	190	0	20515
17726	295	39	21737	98	0	22169
17727	21304	44	140	83	0	21571
17728	197	31	22726	105	0	23059
17729	22439	43	163	66	0	22711
17730	23530	43	161	73	0	23807
17731	300	41	63	23366	0	23770
17732	178	47	68	22643	0	22936
17733	87	22682	57	288	0	23114
17734	74	23310	53	195	0	23632
17735	94	246	50	22837	0	23227
17736	77	147	49	22943	0	23216
17737	22379	62	51	245	0	22737
17738	160	22348	46	177	0	22731
17739	22560	154	51	82	0	22847
17740	162	22683	59	80	0	22984
17741	171	160	22610	62	0	23003
17742	67	148	145	22403	0	22763
17743	22599	65	147	177	0	22988
17744	23216	47	77	170	0	23510
17745	297	24033	50	103	0	24483
17746	177	25244	56	82	0	25559
17747	85	25695	52	105	0	25937
17748	79	328	41	27719	0	28167
17749	101	189	28646	271	0	29207
17750	68	28257	264	239	0	28828
17751	126	356	219	27381	0	28082
17752	43	208	58	28065	0	28374
17753	68	42	27984	413	0	28507
17754	80	38	27493	238	0	27849
17755	27068	36	435	74	0	27613
17756	285	33	28792	49	0	29159
17757	28008	37	262	47	0	28354
17758	27318	41	238	33	0	27630
17759	27248	37	72	42	0	27399
17760	27604	30	48	40	0	27722
17761	480	39	27381	50	0	27950
17762	255	27340	237	68	0	27900
17763	114	262	260	26901	0	27537
17764	88	216	27461	254	0	28019
17765	71	61	265	26757	0	27154
17766	81	27305	254	326	0	27966
17767	79	277	64	28201	0	28621
17768	69	242	55	28017	0	28383
17769	77	81	54	27671	0	27883
17770	27765	73	66	477	0	28381
17771	298	81	71	27777	0	28227
17772	252	82	71	27713	0	28118
17773	100	60	80	27838	0	28078
17774	75	27435	92	506	0	28108
17775	27344	271	96	272	0	27983
17776	301	26164	88	109	0	26662
17777	233	26028	93	83	0	26437
17778	125	412	79	25796	0	26412
17779	114	251	73	26074	0	26512
17780	25998	64	68	456	0	26586
17781	327	54	77	25915	0	26373
17782	26253	49	74	313	0	26689
17783	30542	61	90	263	0	30956
17784	617	59	70	30370	0	31116
17785	439	81	93	30262	0	30875
17786	124	30874	119	734	0	31851
17787	31450	420	77	468	0	32415
17788	411	32442	101	220	0	33174
17789	32492	511	107	148	0	33258
17790	555	444	32124	147	0	33270
17791	31528	142	482	154	0	32306
17792	32890	85	417	167	0	33559
17793	851	91	150	32424	0	33516
17794	579	82	32683	549	0	33893
17795	187	32865	501	582	0	34135
17796	145	495	487	33231	0	34358
17797	169	468	33168	596	0	34401
17798	120	266	506	32791	0	33683
17799	32351	103	483	593	0	33530
17800	567	77	32445	544	0	33633
17801	524	31958	511	256	0	33249
17802	235	32306	464	170	0	33175
17803	219	937	124	28880	0	30160
17804	159	31994	99	425	0	32677
17805	31526	549	160	453	0	32688
17806	31027	507	105	199	0	31838
17807	31357	184	73	174	0	31788
17808	943	117	30054	161	0	31275
17809	30462	100	456	164	0	31182
17810	585	133	438	29520	0	30676
17811	523	122	130	29468	0	30243
17812	190	98	104	29732	0	30124
17813	143	100	168	30297	0	30708
17814	167	102	29329	1039	0	30637
17815	164	80	29161	689	0	30094
17816	160	89	29199	314	0	29762
17817	27404	120	907	230	0	28661
17818	551	28138	542	244	0	29475
17819	537	513	194	27979	0	29223
17820	28204	524	103	589	0	29420
17821	576	28179	94	607	0	29456
17822	529	28651	100	304	0	29584
17823	28297	916	87	175	0	29475
17824	28264	584	99	171	0	29118
17825	968	28398	96	229	0	29691
17826	685	552	89	26483	0	27809
17827	326	27455	88	560	0	28429
17828	26355	586	80	554	0	27575
17829	26048	532	78	250	0	26908
17830	25939	221	106	201	0	26467
17831	1049	25346	94	225	0	26714
17832	678	522	104	25488	0	26792
17833	298	497	25057	774	0	26626
17834	254	199	500	25312	0	26265
17835	226	129	480	25717	0	26552
17836	254	140	25268	1011	0	26673
17837	24757	147	546	676	0	26126
17838	545	141	537	25332	0	26555
17839	607	154	200	25005	0	25966
17840	270	25145	145	988	0	26548
17841	25030	600	118	645	0	26393
17842	629	644	126	24629	0	26028
17843	565	24826	119	664	0	26174
17844	23649	561	108	554	0	24872
17845	571	23691	118	270	0	24650
17846	21852	579	221	178	0	22830
17847	635	504	21642	165	0	22946
17848	468	163	19164	146	0	19941
17849	235	110	18477	108	0	18930
17850	148	18771	676	136	0	19731
17851	267	508	623	16533	0	17931
17852	145	18219	162	339	0	18865
17853	17965	424	97	379	0	18865
17854	416	390	17859	185	0	18850
17855	17661	174	354	136	0	18325
17856	17587	128	374	116	0	18205
17857	727	109	160	17173	0	18169
17858	17660	138	92	386	0	18276
17859	564	97	89	17593	0	18343
17860	439	101	17425	443	0	18408
17861	17143	126	343	424	0	18036
17862	441	17289	349	190	0	18269
17863	436	364	155	17176	0	18131
17864	16994	398	102	367	0	17861
17865	468	188	78	17193	0	17927
17866	428	109	16270	485	0	17292
17867	254	123	356	16224	0	16957
17868	152	16225	357	482	0	17216
17869	16373	371	126	413	0	17283
17870	412	380	108	16281	0	17181
17871	16506	178	98	405	0	17187
17872	503	117	83	16474	0	17177
17873	439	93	93	15870	0	16495
17874	213	16237	69	660	0	17179
17875	16221	365	79	452	0	17117
17876	438	16787	85	228	0	17538
17877	430	430	81	15540	0	16481
17878	165	16225	97	402	0	16889
17879	15753	429	73	388	0	16643
17880	15609	382	126	183	0	16300
17881	15854	181	65	153	0	16253
17882	712	15251	71	149	0	16183
17883	213	10619	26	65	0	10923
17884	10311	292	34	56	0	10693
17885	224	10601	30	50	0	10905
17886	156	353	73	9752	0	10334
17887	90	153	9759	170	0	10172
17888	8700	62	238	125	0	9125
17889	8913	35	102	72	0	9122
17890	8697	43	42	48	0	8830
17891	231	8767	22	60	0	9080
17892	8302	124	18	29	0	8473
17893	165	85	8580	35	0	8865
17894	90	8313	91	96	0	8590
17895	152	198	54	7371	0	7775
17896	20	7578	21	64	0	7683
17897	7184	72	30	47	0	7333
17898	63	7375	13	20	0	7471
17899	46	62	10	7335	0	7453
17900	27	7455	13	56	0	7551
17901	21	65	5	7463	0	7554
17902	16	50	7	7396	0	7469
17903	23	29	7395	98	0	7545
17904	23	13	53	7203	0	7292
17905	7150	23	53	68	0	7294
17906	7139	14	20	66	0	7239
17907	101	24	8	7164	0	7297
17908	80	9	7050	64	0	7203
17909	28	18	59	7085	0	7190
17910	7089	13	53	75	0	7230
17911	7719	17	27	69	0	7832
17912	7939	26	7	37	0	8009
17913	122	8576	14	26	0	8738
17914	8868	64	17	29	0	8978
17915	99	46	8914	12	0	9071
17916	9739	29	60	18	0	9846
17917	84	15	53	9932	0	10084
17918	66	28	20	9901	0	10015
17919	49	24	7	10098	0	10178
17920	9792	18	15	128	0	9953
17921	9587	18	12	84	0	9701
17922	125	20	13	9601	0	9759
17923	95	24	10043	83	0	10245
17924	58	15	61	10107	0	10241
17925	54	19	44	10126	0	10243
17926	39	20	10288	123	0	10470
17927	27	10317	64	118	0	10526
17928	37	72	62	10660	0	10831
17929	10919	75	19	96	0	11109
17930	95	38	13	10905	0	11051
17931	78	23	12	11043	0	11156
17932	11072	22	14	140	0	11248
17933	99	11205	12	95	0	11411
17934	72	11192	8	53	0	11325
17935	11207	122	9	38	0	11376
17936	80	82	11112	24	0	11298
17937	10923	27	73	34	0	11057
17938	101	28	12820	25	0	12974
17939	68	12943	66	27	0	13104
17940	13043	65	52	29	0	13189
17941	13006	55	22	21	0	13104
17942	13095	35	8	32	0	13170
17943	13252	18	16	26	0	13312
17944	130	28	13493	19	0	13670
17945	81	15	58	13436	0	13590
17946	13625	20	54	80	0	13779
17947	94	20	14396	63	0	14573
17948	83	13	14382	31	0	14509
17949	35	14419	104	33	0	14591
17950	14391	43	42	19	0	14495
17951	93	38	13	14202	0	14346
17952	14345	15	9	74	0	14443
17953	52	14787	12	88	0	14939
17954	55	51	6	15520	0	15632
17955	20	53	11	15503	0	15587
17956	16	13	12	16311	0	16352
17957	45	4	16818	147	0	17014
17958	11	17001	84	117	0	17213
17959	18402	86	76	44	0	18608
17960	113	90	18	18311	0	18532
17961	18367	21	12	135	0	18535
17962	18042	11	15	139	0	18207
17963	211	16	9	18348	0	18584
17964	140	10	19109	126	0	19385
17965	41	12	105	18925	0	19083
17966	25	19270	114	146	0	19555
17967	27	109	25	19499	0	19660
17968	33	107	19409	138	0	19687
17969	19154	29	118	124	0	19425
17970	125	17	112	19753	0	20007
17971	19823	17	35	169	0	20044
17972	142	9	20056	138	0	20345
17973	19339	9	123	48	0	19519
17974	144	33	20222	35	0	20434
17975	19074	16	116	30	0	19236
17976	129	19665	116	41	0	19951
17977	120	19895	35	40	0	20090
17978	42	282	21	19942	0	20287
17979	44	144	38	19347	0	19573
17980	20	36	12	20233	0	20301
17981	20244	22	14	240	0	20520
17982	122	13	15	20513	0	20663
17983	148	17	20800	144	0	21109
17984	20115	14	101	151	0	20381
17985	119	21687	125	62	0	21993
17986	21946	108	29	63	0	22146
17987	21132	113	30	44	0	21319
17988	240	32	21918	44	0	22234
17989	166	32	121	21771	0	22090
17990	60	15	130	22680	0	22885
17991	51	14	22926	243	0	23234
17992	38	22919	132	170	0	23259
17993	22767	121	133	55	0	23076
17994	22805	143	35	38	0	23021
17995	242	39	33	22931	0	23245
17996	173	20	31	22722	0	22946
17997	59	21	30	23489	0	23599
17998	23205	21	24	288	0	23538
17999	153	23792	31	174	0	24150
18000	23838	129	41	62	0	24070
18001	23518	144	25	55	0	23742
18002	291	33	25592	47	0	25963
18003	175	37	153	24838	0	25203
18004	73	26250	171	174	0	26668
18005	52	165	55	26358	0	26630
18006	53	195	35	27399	0	27682
18007	65	49	28551	381	0	29046
18008	29009	37	222	275	0	29543
18009	32387	36	226	97	0	32746
18010	33908	31	71	83	0	34093
18011	591	34	60	33402	0	34087
18012	375	62	181	32556	0	33174
18013	116	32972	41	630	0	33759
18014	91	34338	58	537	0	35024
18015	34034	591	65	129	0	34819
18016	358	33851	52	194	0	34455
18017	389	383	33979	83	0	34834
18018	165	350	341	33839	0	34695
18019	34198	85	408	392	0	35083
18020	425	49	34037	382	0	34893
18021	434	45	33680	123	0	34282
18022	33680	55	654	114	0	34503
18023	33861	44	399	113	0	34417
18024	703	52	113	33582	0	34450
18025	474	68	33791	419	0	34752
18026	165	56	357	34055	0	34633
18027	174	74	34611	466	0	35325
18028	177	40	34788	422	0	35427
18029	120	35049	650	187	0	36006
18030	35014	358	421	121	0	35914
18031	34718	367	128	128	0	35341
18032	707	35125	83	138	0	36053
18033	480	446	80	34237	0	35243
18034	204	393	94	34527	0	35218
18035	174	125	67	35476	0	35842
18036	35020	85	97	735	0	35937
18037	424	34657	90	510	0	35681
18038	33578	360	104	188	0	34230
18039	33252	383	88	141	0	33864
18040	762	125	33133	128	0	34148
18041	481	33067	385	117	0	34050
18042	215	397	391	33310	0	34313
18043	207	387	33312	425	0	34331
18044	32336	288	420	452	0	33496
18045	32851	92	412	176	0	33531
18046	32881	71	161	154	0	33267
18047	32650	64	154	117	0	32985
18048	784	80	125	32147	0	33136
18049	525	69	31699	610	0	32903
18050	224	76	392	31631	0	32323
18051	31622	82	405	464	0	32573
18052	31338	86	162	453	0	32039
18053	727	31819	126	211	0	32883
18054	31676	347	125	149	0	32297
18055	505	356	30917	147	0	31925
18056	552	130	30824	123	0	31629
18057	29807	104	616	94	0	30621
18058	438	30480	350	143	0	31411
18059	385	289	104	28465	0	29243
18060	155	29208	84	350	0	29797
18061	136	349	61	29364	0	29910
18062	157	329	79	28996	0	29561
18063	160	143	69	29951	0	30323
18064	28977	116	67	584	0	29744
18065	28926	108	98	336	0	29468
18066	28988	105	109	135	0	29337
18067	656	82	28812	145	0	29695
18068	28312	77	351	130	0	28870
18069	424	80	373	28996	0	29873
18070	430	64	155	29475	0	30124
18071	274	62	29385	603	0	30324
18072	236	73	381	32740	0	33430
18073	33965	82	354	493	0	34894
18074	568	60	33928	435	0	34991
18075	471	66	492	33886	0	34915
18076	34050	59	471	493	0	35073
18077	33851	93	208	443	0	34595
18078	863	94	34111	197	0	35265
18079	574	111	34301	150	0	35136
18080	270	115	750	34307	0	35442
18081	34394	115	467	499	0	35475
18082	34318	110	168	480	0	35076
18083	881	111	130	32517	0	33639
18084	518	34306	122	480	0	35426
18085	33552	474	108	441	0	34575
18086	549	34155	118	364	0	35186
18087	553	480	133	34009	0	35175
18088	275	388	33623	534	0	34820
18089	249	121	32918	478	0	33766
18090	219	91	33779	206	0	34295
18091	246	123	811	32153	0	33333
18092	267	66	484	32858	0	33675
18093	32722	65	189	797	0	33773
18094	584	32462	139	533	0	33718
18095	33149	403	125	209	0	33886
18096	636	391	131	31007	0	32165
18097	520	32336	136	525	0	33517
18098	236	33011	154	467	0	33868
18099	222	719	141	32582	0	33664
18100	32414	395	116	515	0	33440
18101	560	32825	134	483	0	34002
18102	30903	418	97	154	0	31572
18103	542	31749	102	213	0	32606
18104	31249	411	208	127	0	31995
18105	545	362	30803	121	0	31831
18106	457	132	30098	117	0	30804
18107	182	29278	613	134	0	30207
18108	26355	542	943	152	0	27992
18109	279	24473	96	170	0	25018
18110	232	22942	102	118	0	23394
18111	309	361	65	22660	0	23395
18112	22927	201	78	231	0	23437
18113	248	23348	59	236	0	23891
18114	22204	185	49	70	0	22508
18115	251	22244	50	78	0	22623
18116	21576	195	136	45	0	21952
18117	215	21496	60	65	0	21836
18118	153	21773	36	88	0	22050
18119	95	291	22	20949	0	21357
18120	71	21667	29	200	0	21967
18121	21463	201	33	158	0	21855
18122	201	167	21475	60	0	21903
18123	180	45	183	21318	0	21726
18124	67	68	21857	201	0	22193
18125	59	47	200	21074	0	21380
18126	54	47	169	21214	0	21484
18127	67	35	20257	305	0	20664
18128	18355	59	232	221	0	18867
18129	232	19659	151	107	0	20149
18130	19842	191	77	91	0	20201
18131	243	20288	51	94	0	20676
18132	194	224	50	20120	0	20588
18133	20040	151	54	220	0	20465
18134	19797	89	78	173	0	20137
18135	20254	80	82	77	0	20493
18136	343	95	42	19919	0	20399
18137	244	74	40	19957	0	20315
18138	158	21097	46	295	0	21596
18139	21181	239	63	196	0	21679
18140	21091	209	70	76	0	21446
18141	21070	122	54	89	0	21335
18142	21300	113	54	68	0	21535
18143	381	21068	83	84	0	21616
18144	220	242	103	21008	0	21573
18145	133	222	21046	214	0	21615
18146	20421	103	237	194	0	20955
18147	21268	147	152	114	0	21681
18148	392	119	21378	96	0	21985
18149	278	87	21530	84	0	21979
18150	148	145	349	21259	0	21901
18151	156	145	205	21783	0	22289
18152	133	113	61	22350	0	22657
18153	21236	155	51	416	0	21858
18154	300	136	55	21476	0	21967
18155	242	135	21191	286	0	21854
18156	196	111	233	21251	0	21791
18157	128	130	22008	287	0	22553
18158	129	139	243	21250	0	21761
18159	112	129	199	22110	0	22550
18160	124	104	22023	399	0	22650
18161	20464	95	261	281	0	21101
18162	279	22046	238	151	0	22714
18163	22294	310	59	113	0	22776
18164	322	258	55	23055	0	23690
18165	23116	155	74	272	0	23617
18166	338	24573	61	302	0	25274
18167	292	26181	65	132	0	26670
18168	194	854	32	27976	0	29056
18169	141	393	29405	356	0	30295
18170	181	145	29139	354	0	29819
18171	186	29355	650	129	0	30320
18172	24259	554	363	50	0	25226
18173	387	267	178	23637	0	24469
18174	23871	57	44	277	0	24249
18175	311	23605	35	295	0	24246
18176	280	24081	27	79	0	24467
18177	68	526	25	24177	0	24796
18178	23623	312	27	303	0	24265
18179	23672	73	27	294	0	24066
18180	572	35	23716	74	0	24397
18181	336	39	23320	60	0	23755
18182	22803	25	509	63	0	23400
18183	306	23466	300	140	0	24212
18184	23401	285	61	49	0	23796
18185	329	276	37	23088	0	23730
18186	314	75	22709	296	0	23394
18187	21575	41	282	292	0	22190
18188	286	22185	289	94	0	22854
18189	277	22440	85	65	0	22867
18190	72	510	91	21960	0	22633
18191	21955	369	52	292	0	22668
18192	288	76	48	22254	0	22666
18193	22509	59	47	313	0	22928
18194	344	84	21902	294	0	22624
18195	21402	78	271	96	0	21847
18196	21848	61	269	82	0	22260
18197	583	54	21268	70	0	21975
18198	20797	51	264	60	0	21172
18199	350	20980	311	74	0	21715
18200	313	291	93	20677	0	21374
18201	127	21068	62	257	0	21514
18202	20890	326	62	280	0	21558
18203	338	289	70	20061	0	20758
18204	330	20137	72	328	0	20867
18205	124	295	86	20007	0	20512
18206	115	20474	53	320	0	20962
18207	88	343	47	20500	0	20978
18208	20174	323	44	344	0	20885
18209	317	119	54	20352	0	20842
18210	370	85	20032	350	0	20837
18211	19550	84	285	363	0	20282
18212	362	72	290	19931	0	20655
18213	365	74	19414	329	0	20182
18214	193	81	18985	318	0	19577
18215	145	71	19776	117	0	20109
18216	138	79	583	19029	0	19829
18217	154	82	350	19214	0	19800
18218	126	108	136	19101	0	19471
18219	138	89	101	19725	0	20053
18220	19292	91	109	598	0	20090
18221	19568	86	113	376	0	20143
18222	19874	101	100	154	0	20229
18223	20051	130	81	118	0	20380
18224	625	115	66	19791	0	20597
18225	453	114	20273	354	0	21194
18226	20202	100	279	386	0	20967
18227	21044	122	306	141	0	21613
18228	654	120	97	20768	0	21639
18229	436	121	92	21133	0	21782
18230	21178	102	98	618	0	21996
18231	435	104	106	20255	0	20900
18232	434	20357	127	445	0	21363
18233	20520	327	152	396	0	21395
18234	20284	338	145	175	0	20942
18235	664	142	21223	176	0	22205
18236	446	117	372	20710	0	21645
18237	205	115	366	21127	0	21813
18238	20520	102	161	687	0	21470
18239	20760	110	130	440	0	21440
18240	736	124	108	20903	0	21871
18241	499	109	20933	457	0	21998
18242	257	101	20961	450	0	21769
18243	280	84	570	20564	0	21498
18244	268	94	388	20973	0	21723
18245	20519	76	145	647	0	21387
18246	497	20392	135	482	0	21506
18247	468	20338	128	210	0	21144
18248	255	20827	126	186	0	21394
18249	278	712	121	20032	0	21143
18250	19920	387	126	396	0	20829
18251	19755	141	76	371	0	20343
18252	642	19804	56	218	0	20720
18253	20227	361	70	159	0	20817
18254	473	329	75	19955	0	20832
18255	407	130	20449	431	0	21417
18256	234	103	303	20084	0	20724
18257	211	110	280	19851	0	20452
18258	202	97	116	20237	0	20652
18259	19501	75	88	700	0	20364
18260	424	146	103	19110	0	19783
18261	402	19063	117	487	0	20069
18262	18487	283	171	410	0	19351
18263	411	18553	115	235	0	19314
18264	315	17685	102	151	0	18253
18265	153	18203	117	139	0	18612
18266	211	426	15785	109	0	16531
18267	149	15255	235	122	0	15761
18268	179	213	12546	94	0	13032
18269	10386	151	98	73	0	10708
18270	10762	18	61	51	0	10892
18271	137	13	11354	33	0	11537
18272	11257	17	64	46	0	11384
18273	11884	17	53	44	0	11998
18274	121	19	12106	25	0	12271
18275	72	12445	67	35	0	12619
18276	31	73	79	12345	0	12528
18277	12403	48	11	86	0	12548
18278	82	19	16	12424	0	12541
18279	12851	27	12	231	0	13121
18280	12728	28	10	74	0	12840
18281	127	18	12899	40	0	13084
18282	12652	23	68	41	0	12784
18283	81	13235	51	49	0	13416
18284	13178	79	14	51	0	13322
18285	88	59	16	13441	0	13604
18286	81	26	13421	95	0	13623
18287	42	20	72	13325	0	13459
18288	13229	24	63	102	0	13418
18289	94	13456	19	126	0	13695
18290	83	106	13479	53	0	13721
18291	39	62	73	12939	0	13113
18292	55	31	13496	97	0	13679
18293	31	13576	79	85	0	13771
18294	13475	83	61	38	0	13657
18295	98	64	32	13458	0	13652
18296	86	29	13744	96	0	13955
18297	60	35	13305	80	0	13480
18298	13614	33	116	33	0	13796
18299	116	33	69	14069	0	14287
18300	82	34	24	14162	0	14302
18301	48	32	14369	134	0	14583
18302	68	30	14541	72	0	14711
18303	55	15281	123	53	0	15512
18304	46	91	75	15236	0	15448
18305	60	66	41	14864	0	15031
18306	63	15274	26	144	0	15507
18307	58	97	15404	77	0	15636
18308	14289	90	106	53	0	14538
18309	117	27	76	15318	0	15538
18310	106	23	15589	120	0	15838
18311	62	26	99	14842	0	15029
18312	51	15914	70	126	0	16161
18313	82	93	16103	84	0	16362
18314	15154	83	100	61	0	15398
18315	159	41	16145	40	0	16385
18316	117	47	15739	38	0	15941
18317	62	33	15677	35	0	15807
18318	39	26	16976	53	0	17094
18319	42	63	176	16959	0	17240
18320	52	28	18230	137	0	18447
18321	44	45	122	17224	0	17435
18322	32	18013	113	147	0	18305
18323	19232	118	52	115	0	19517
18324	167	105	39	19249	0	19560
18325	160	32	18864	307	0	19363
18326	42	19112	155	163	0	19472
18327	38	140	133	18907	0	19218
18328	18630	117	46	195	0	18988
18329	132	18907	44	173	0	19256
18330	123	139	35	19476	0	19773
18331	19647	118	33	146	0	19944
18332	156	32	19797	128	0	20113
18333	19618	23	151	49	0	19841
18334	167	22	20066	31	0	20286
18335	18381	22	125	28	0	18556
18336	18761	16	123	24	0	18924
18337	219	15	19132	20	0	19386
18338	110	18588	105	39	0	18842
18339	97	98	128	18147	0	18470
18340	30	90	18703	106	0	18929
18341	20	25	111	17734	0	17890
18342	22	16	110	18182	0	18330
18343	31	10	18702	202	0	18945
18344	27	7	18545	110	0	18689
18345	18	12	211	18540	0	18781
18346	19072	16	118	124	0	19330
18347	116	19090	36	114	0	19356
18348	110	19315	26	51	0	19502
18349	19608	198	40	29	0	19875
18350	19924	123	20	34	0	20101
18351	218	29	29	20141	0	20417
18352	127	20	22	20171	0	20340
18353	27	22	17	20608	0	20674
18354	20244	12	37	248	0	20541
18355	134	19560	26	138	0	19858
18356	110	20155	31	48	0	20344
18357	38	215	30	19912	0	20195
18358	27	116	30	19875	0	20048
18359	24	35	25	20146	0	20230
18360	19967	17	35	247	0	20266
18361	150	20148	27	191	0	20516
18362	20422	133	30	50	0	20635
18363	168	110	20556	53	0	20887
18364	131	20639	151	41	0	20962
18365	36	158	135	20532	0	20861
18366	20487	125	48	175	0	20835
18367	167	32	20472	147	0	20818
18368	147	23	20467	54	0	20691
18369	38	25	271	20282	0	20616
18370	44	38	145	20446	0	20673
18371	46	38	40	20209	0	20333
18372	36	39	47	19573	0	19695
18373	39	44	40	19494	0	19617
18374	34	19270	32	310	0	19646
18375	48	155	41	19199	0	19443
18376	18890	145	35	206	0	19276
18377	166	19355	45	202	0	19768
18378	19318	159	47	71	0	19595
18379	209	149	18924	50	0	19332
18380	164	51	19015	68	0	19298
18381	65	44	272	19593	0	19974
18382	77	36	24478	198	0	24789
18383	66	44	255	24089	0	24454
18384	73	49	408	24218	0	24748
18385	24217	48	88	502	0	24855
18386	23903	46	70	340	0	24359
18387	504	24856	67	121	0	25548
18388	326	25514	54	95	0	25989
18389	98	511	54	25299	0	25962
18390	25519	343	57	297	0	26216
18391	299	90	25785	334	0	26508
18392	323	59	309	25566	0	26257
18393	108	48	331	25933	0	26420
18394	86	44	25876	624	0	26630
18395	75	25871	303	433	0	26682
18396	87	302	338	25648	0	26375
18397	115	323	25925	345	0	26708
18398	82	99	309	25605	0	26095
18399	24609	60	328	385	0	25382
18400	307	24817	91	424	0	25639
18401	323	25006	68	153	0	25550
18402	123	577	68	24416	0	25184
18403	23622	344	89	341	0	24396
18404	308	23737	51	376	0	24472
18405	24135	294	72	149	0	24650
18406	337	321	24117	133	0	24908
18407	354	93	24688	136	0	25271
18408	129	65	600	23246	0	24040
18409	99	74	370	24939	0	25482
18410	24522	79	106	625	0	25332
18411	343	88	64	24761	0	25256
18412	371	91	24203	431	0	25096
18413	134	90	326	23528	0	24078
18414	107	87	313	24352	0	24859
18415	119	88	23818	632	0	24657
18416	22302	92	352	440	0	23186
18417	325	84	338	23650	0	24397
18418	22722	56	107	392	0	23277
18419	342	21532	80	409	0	22363
18420	21175	299	69	166	0	21709
18421	315	21141	79	158	0	21693
18422	275	20919	94	146	0	21434
18423	118	477	128	19648	0	20371
18424	19437	282	54	284	0	20057
18425	19247	92	71	293	0	19703
18426	450	71	67	19086	0	19674
18427	19278	53	66	333	0	19730
18428	19053	64	78	348	0	19543
18429	501	88	79	19064	0	19732
18430	18730	77	71	340	0	19218
18431	352	18719	79	366	0	19516
18432	18679	289	87	163	0	19218
18433	363	334	18478	173	0	19348
18434	18877	135	337	167	0	19516
18435	352	100	305	18795	0	19552
18436	331	62	140	19201	0	19734
18437	218	48	124	19220	0	19610
18438	195	98	130	19165	0	19588
18439	99	142	134	19138	0	19513
18440	75	18175	140	661	0	19051
18441	86	18703	138	537	0	19464
18442	18374	463	131	252	0	19220
18443	343	325	18362	212	0	19242
18444	18081	149	312	249	0	18791
18445	375	143	18307	330	0	19155
18446	369	177	356	17522	0	18424
18447	183	256	269	17866	0	18574
18448	17484	192	93	622	0	18391
18449	386	162	17438	426	0	18412
18450	437	143	267	17085	0	17932
18451	283	135	17948	373	0	18739
18452	221	18353	330	366	0	19270
18453	183	370	331	18460	0	19344
18454	18306	292	167	497	0	19262
18455	17731	128	106	461	0	18426
18456	18792	172	102	274	0	19340
18457	670	18655	135	246	0	19706
18458	410	19085	203	258	0	19956
18459	18321	502	304	255	0	19382
18460	338	19171	159	348	0	20016
18461	377	19021	116	375	0	19889
18462	286	476	18710	274	0	19746
18463	201	18521	280	310	0	19312
18464	152	18259	362	244	0	19017
18465	189	552	120	17929	0	18790
18466	173	429	17793	427	0	18822
18467	205	195	17489	357	0	18246
18468	17089	156	501	202	0	17948
18469	393	135	17900	241	0	18669
18470	18071	106	321	198	0	18696
18471	461	159	311	17680	0	18611
18472	521	18080	116	395	0	19112
18473	18880	327	85	406	0	19698
18474	19522	395	84	234	0	20235
18475	654	115	98	19738	0	20605
18476	532	120	104	19826	0	20582
18477	355	101	98	20160	0	20714
18478	19754	112	109	676	0	20651
18479	19496	108	92	430	0	20126
18480	19737	99	94	218	0	20148
18481	650	18401	60	279	0	19390
18482	13588	155	31	58	0	13832
18483	183	13338	28	61	0	13610
18484	142	13300	26	55	0	13523
18485	121	366	62	12753	0	13302
18486	51	13060	18	244	0	13373
18487	12559	129	14	107	0	12809
18488	234	107	11	12179	0	12531
18489	12148	41	18	127	0	12334
18490	130	11760	16	88	0	11994
18491	91	12220	16	39	0	12366
18492	12349	149	21	42	0	12561
18493	116	12897	28	38	0	13079
18494	103	126	53	13117	0	13399
18495	49	84	87	13223	0	13443
18496	13271	35	26	185	0	13517
18497	132	20	17	13467	0	13636
18498	196	24	14023	147	0	14390
18499	43	28	128	14200	0	14399
18500	14615	24	84	153	0	14876
18501	142	15165	25	111	0	15443
18502	15899	158	23	50	0	16130
18503	15678	128	24	39	0	15869
18504	16107	49	25	41	0	16222
18505	298	47	16435	39	0	16819
18506	149	48	15855	37	0	16089
18507	15268	48	205	17	0	15538
18508	148	15860	113	27	0	16148
18509	116	151	28	15833	0	16128
18510	42	158	26	15596	0	15822
18511	23	15612	37	218	0	15890
18512	33	15936	24	119	0	16112
18513	24	264	24	16085	0	16397
18514	33	147	22	16264	0	16466
18515	30	56	16161	242	0	16489
18516	52	50	15586	136	0	15824
18517	15514	54	226	56	0	15850
18518	16334	39	137	48	0	16558
18519	254	32	48	16359	0	16693
18520	157	34	16442	162	0	16795
18521	74	52	147	16264	0	16537
18522	16271	33	134	163	0	16601
18523	209	39	16453	137	0	16838
18524	156	33	131	16841	0	17161
18525	71	55	17053	193	0	17372
18526	77	16821	138	183	0	17219
18527	105	156	16967	62	0	17290
18528	69	147	153	16733	0	17102
18529	16906	35	172	188	0	17301
18530	166	64	27	17460	0	17717
18531	17864	49	21	174	0	18108
18532	17843	60	30	146	0	18079
18533	17234	63	22	243	0	17562
18534	298	59	17562	63	0	17982
18535	17762	76	141	53	0	18032
18536	228	41	126	17898	0	18293
18537	167	66	36	17965	0	18234
18538	103	51	18074	272	0	18500
18539	59	58	128	18340	0	18585
18540	18572	69	115	174	0	18930
18541	191	19038	36	181	0	19446
18542	19283	153	72	79	0	19587
18543	19249	137	35	85	0	19506
18544	19193	76	32	90	0	19391
18545	299	59	39	19308	0	19705
18546	188	51	19596	194	0	20029
18547	85	46	171	19954	0	20256
18548	70	41	129	20264	0	20504
18549	20474	41	53	312	0	20880
18550	19586	66	52	209	0	19913
18551	346	43	19793	90	0	20272
18552	183	76	185	19476	0	19920
18553	114	42	20269	208	0	20633
18554	20162	49	212	186	0	20609
18555	244	22504	153	126	0	23027
18556	22333	192	54	66	0	22645
18557	229	23016	46	61	0	23352
18558	22906	236	39	64	0	23245
18559	264	23086	42	65	0	23457
18560	219	248	82	22674	0	23223
18561	87	183	37	23415	0	23722
18562	23503	49	38	399	0	23989
18563	23178	31	43	242	0	23494
18564	23438	23	44	90	0	23595
18565	23042	26	48	78	0	23194
18566	23483	19	48	66	0	23616
18567	430	18	38	23057	0	23543
18568	272	23027	50	246	0	23595
18569	106	212	41	22796	0	23155
18570	82	22545	33	272	0	22932
18571	80	234	38	22165	0	22517
18572	72	22472	38	273	0	22855
18573	77	230	38	22071	0	22416
18574	80	175	21375	281	0	21911
18575	19904	57	226	221	0	20408
18576	243	20874	190	101	0	21408
18577	20876	215	64	67	0	21222
18578	284	189	20612	66	0	21151
18579	20382	56	215	75	0	20728
18580	297	39	21765	66	0	22167
18581	249	34	252	21629	0	22164
18582	112	23295	204	396	0	24007
18583	113	262	23486	231	0	24092
18584	105	232	280	23380	0	23997
18585	23064	89	270	340	0	23763
18586	329	45	84	24013	0	24471
18587	294	31	45	23998	0	24368
18588	125	43	35	24579	0	24782
18589	115	40	24166	580	0	24901
18590	94	43	280	23911	0	24328
18591	93	23883	262	365	0	24603
18592	104	297	83	23827	0	24311
18593	84	278	36	23710	0	24108
18594	23238	83	35	525	0	23881
18595	327	64	37	23716	0	24144
18596	302	51	23857	375	0	24585
18597	171	54	23671	287	0	24183
18598	113	48	23522	128	0	23811
18599	78	23484	535	164	0	24261
18600	22960	261	305	197	0	23723
18601	284	22871	101	114	0	23370
18602	22710	308	52	60	0	23130
18603	385	291	40	22206	0	22922
18604	327	86	22476	299	0	23188
18605	135	59	21925	306	0	22425
18606	99	22859	478	163	0	23599
18607	58	307	306	22391	0	23062
18608	80	313	90	22318	0	22801
18609	56	118	53	22986	0	23213
18610	82	69	22701	592	0	23444
18611	21320	58	285	406	0	22069
18612	334	53	22705	177	0	23269
18613	341	46	325	21763	0	22475
18614	142	53	310	22582	0	23087
18615	115	53	22196	583	0	22947
18616	21219	72	316	391	0	21998
18617	316	22460	313	183	0	23272
18618	22608	335	122	105	0	23170
18619	367	305	68	21723	0	22463
18620	309	22489	72	354	0	23224
18621	168	291	70	22907	0	23436
18622	22569	323	79	399	0	23370
18623	359	111	91	22539	0	23100
18624	353	95	21904	414	0	22766
18625	21376	88	341	357	0	22162
18626	21729	85	326	200	0	22340
18627	612	111	21750	144	0	22617
18628	421	71	318	21676	0	22486
18629	22024	72	321	414	0	22831
18630	358	79	150	21533	0	22120
18631	357	68	123	20752	0	21300
18632	154	72	130	21083	0	21439
18633	126	77	120	21323	0	21646
18634	115	77	20648	707	0	21547
18635	135	99	322	20583	0	21139
18636	123	68	20561	487	0	21239
18637	19893	77	412	430	0	20812
18638	20115	87	368	222	0	20792
18639	19983	90	173	173	0	20419
18640	19940	91	131	194	0	20356
18641	628	89	137	19378	0	20232
18642	19375	97	119	408	0	19999
18643	439	82	19076	431	0	20028
18644	398	65	19033	208	0	19704
18645	18056	66	571	178	0	18871
18646	331	18365	432	177	0	19305
18647	338	18025	171	186	0	18720
18648	152	485	141	17774	0	18552
18649	140	332	17688	401	0	18561
18650	16910	119	318	434	0	17781
18651	329	70	17762	251	0	18412
18652	320	16917	344	230	0	17811
18653	186	234	16889	182	0	17491
18654	107	15832	304	205	0	16448
18655	13684	318	388	177	0	14567
18656	217	13819	112	146	0	14294
18657	232	13100	84	137	0	13553
18658	200	317	64	13081	0	13662
18659	111	220	12803	253	0	13387
18660	97	69	202	12558	0	12926
18661	105	55	230	12589	0	12979
18662	90	57	12441	398	0	12986
18663	114	42	229	12027	0	12412
18664	106	12246	235	274	0	12861
18665	113	187	117	12540	0	12957
18666	12418	192	91	272	0	12973
18667	249	76	85	12547	0	12957
18668	258	42	12481	263	0	13044
18669	136	59	219	12605	0	13019
18670	115	53	12674	267	0	13109
18671	12231	58	243	269	0	12801
18672	213	64	251	12393	0	12921
18673	12566	66	112	273	0	13017
18674	254	71	12358	269	0	12952
18675	11766	75	224	164	0	12229
18676	240	12519	237	137	0	13133
18677	232	164	12356	156	0	12908
18678	115	256	248	12187	0	12806
18679	133	69	12481	241	0	12924
18680	95	11694	212	241	0	12242
18681	101	11944	209	100	0	12354
18682	10183	214	51	76	0	10524
18683	137	10689	47	76	0	10949
18684	10346	126	51	62	0	10585
18685	197	129	50	10549	0	10925
18686	146	43	10361	157	0	10707
18687	52	10465	130	170	0	10817
18688	53	124	126	10415	0	10718
18689	53	126	53	10667	0	10899
18690	55	36	50	10970	0	11111
18691	64	36	38	10646	0	10784
18692	66	10499	50	245	0	10860
18693	55	10817	40	171	0	11083
18694	10336	192	46	66	0	10640
18695	132	10402	45	71	0	10650
18696	107	103	89	9587	0	9886
18697	78	101	9468	127	0	9774
18698	37	9397	150	121	0	9705
18699	22	148	92	8993	0	9255
18700	33	110	28	8787	0	8958
18701	17	9066	22	153	0	9258
18702	8673	86	26	88	0	8873
18703	97	98	8838	32	0	9065
18704	8151	29	83	22	0	8285
18705	89	8665	76	18	0	8848
18706	7846	83	12	15	0	7956
18707	79	8046	13	19	0	8157
18708	57	87	11	8560	0	8715
18709	18	67	16	8734	0	8835
18710	8639	35	4	168	0	8846
18711	82	28	8	8790	0	8908
18712	92	16	8793	103	0	9004
18713	16	8668	80	102	0	8866
18714	19	8754	84	32	0	8889
18715	16	164	23	8686	0	8889
18716	21	99	8785	105	0	9010
18717	11	30	74	8337	0	8452
18718	11	19	71	8358	0	8459
18719	13	21	8310	162	0	8506
18720	28	14	8172	119	0	8333
18721	11	8227	143	52	0	8433
18722	8255	85	79	25	0	8444
18723	74	103	12	8137	0	8326
18724	82	8027	23	88	0	8220
18725	8184	95	12	79	0	8370
18726	77	96	12	8129	0	8314
18727	84	27	14	8034	0	8159
18728	19	8034	13	165	0	8231
18729	18	82	17	7950	0	8067
18730	7949	99	14	109	0	8171
18731	84	40	18	8012	0	8154
18732	98	34	13	8051	0	8196
18733	34	36	8060	164	0	8294
18734	40	24	7644	116	0	7824
18735	7706	31	154	50	0	7941
18736	87	42	84	7690	0	7903
18737	91	34	34	7657	0	7816
18738	28	33	21	7939	0	8021
18739	24	42	7858	189	0	8113
18740	7790	31	81	114	0	8016
18741	85	36	95	7626	0	7842
18742	100	29	39	7854	0	8022
18743	7749	36	37	178	0	8000
18744	93	7800	32	144	0	8069
18745	101	107	7820	80	0	8108
18746	34	96	99	7490	0	7719
18747	29	7445	96	268	0	7838
18748	36	98	37	7748	0	7919
18749	7582	93	33	151	0	7859
18750	99	75	43	7480	0	7697
18751	7413	53	31	155	0	7652
18752	7489	47	31	129	0	7696
18753	176	41	29	7308	0	7554
18754	105	7439	34	141	0	7719
18755	35	7512	34	149	0	7730
18756	36	165	7520	85	0	7806
18757	44	109	114	7222	0	7489
18758	39	62	95	7338	0	7534
18759	46	47	36	7639	0	7768
18760	7199	34	317	228	0	7778
18761	113	43	31	7559	0	7746
18762	129	48	7475	151	0	7803
18763	7319	25	99	165	0	7608
18764	120	44	100	7676	0	7940
18765	121	52	40	7932	0	8145
18766	45	39	7800	243	0	8127
18767	7541	43	102	175	0	7861
18768	111	37	107	7783	0	8038
18769	123	21	8302	188	0	8634
18770	66	39	108	8388	0	8601
18771	56	44	133	7723	0	7956
18772	58	8456	65	251	0	8830
18773	8402	101	54	152	0	8709
18774	8266	115	49	108	0	8538
18775	204	8418	32	109	0	8763
18776	8273	109	40	108	0	8530
18777	8281	109	53	98	0	8541
18778	202	46	35	8394	0	8677
18779	143	33	7980	152	0	8308
18780	79	27	7723	167	0	7996
18781	48	53	7653	69	0	7823
18782	56	34	7725	77	0	7892
18783	47	147	114	7033	0	7341
18784	34	37	90	7420	0	7581
18785	34	31	37	7268	0	7370
18786	36	27	33	7451	0	7547
18787	7285	22	31	178	0	7516
18788	89	7635	22	147	0	7893
18789	7598	66	28	81	0	7773
18790	97	71	7655	61	0	7884
18791	91	28	7792	63	0	7974
18792	49	82	140	7904	0	8175
18793	8049	16	129	129	0	8323
18794	7351	26	42	145	0	7564
18795	155	8082	20	89	0	8346
18796	104	8292	40	65	0	8501
18797	52	145	28	8402	0	8627
18798	8327	84	31	123	0	8565
18799	86	8426	29	127	0	8668
18800	8854	78	19	50	0	9001
18801	8769	86	23	55	0	8933
18802	8798	29	30	52	0	8909
18803	177	13	8962	42	0	9194
18804	115	9008	73	48	0	9244
18805	8830	72	72	52	0	9026
18806	8691	74	39	41	0	8845
18807	139	8647	22	42	0	8850
18808	51	7985	3	24	0	8063
18809	8076	93	31	13	0	8213
18810	65	47	7	8108	0	8227
18811	52	12	8406	62	0	8532
18812	8073	8	59	46	0	8186
18813	63	6	41	8427	0	8537
18814	42	8716	11	64	0	8833
18815	17	62	6	8831	0	8916
18816	20	50	8985	67	0	9122
18817	13	14	60	8920	0	9007
18818	9549	12	41	79	0	9681
18819	82	11	11	9589	0	9693
18820	59	5	4	9585	0	9653
18821	31	12	10517	117	0	10677
18822	23	16	65	10159	0	10263
18823	18	10492	47	84	0	10641
18824	10482	68	16	58	0	10624
18825	9929	61	12	25	0	10027
18826	115	17	10922	22	0	11076
18827	67	13	65	10546	0	10691
18828	26	10822	44	74	0	10966
18829	17	11113	14	60	0	11204
18830	10980	113	10	15	0	11118
18831	78	54	8	11309	0	11449
18832	68	14	11376	76	0	11534
18833	27	18	11452	58	0	11555
18834	16	13	118	11513	0	11660
18835	11597	11	59	97	0	11764
18836	11462	16	22	67	0	11567
18837	131	8	16	12127	0	12282
18838	67	9	12277	94	0	12447
18839	20	12364	83	78	0	12545
18840	12435	73	59	27	0	12594
18841	73	12650	21	33	0	12777
18842	12572	90	10	26	0	12698
18843	94	60	12	12557	0	12723
18844	81	14	12543	102	0	12740
18845	18	17	86	12346	0	12467
18846	12422	12	61	96	0	12591
18847	101	15	12976	80	0	13172
18848	70	13056	88	38	0	13252
18849	26	85	64	12955	0	13130
18850	13063	59	31	87	0	13240
18851	98	23	13496	79	0	13696
18852	84	21	96	13503	0	13704
18853	33	13	67	13935	0	14048
18854	30	11	13850	155	0	14046
18855	25	17	102	13656	0	13800
18856	37	16	14011	112	0	14176
18857	13129	22	97	90	0	13338
18858	113	23	75	14654	0	14865
18859	102	32	15890	100	0	16124
18860	34	16358	109	96	0	16597
18861	16772	121	84	31	0	17008
18862	17830	92	28	31	0	17981
18863	258	62	36	19751	0	20107
18864	151	21717	18	190	0	22076
18865	21807	205	19	168	0	22199
18866	231	182	26	21840	0	22279
18867	194	43	21903	229	0	22369
18868	20948	30	213	193	0	21384
18869	237	21340	177	65	0	21819
18870	190	212	33	21258	0	21693
18871	21319	179	31	221	0	21750
18872	240	30	21112	200	0	21582
18873	186	39	21224	47	0	21496
18874	54	29	376	20256	0	20715
18875	69	26	21778	224	0	22097
18876	37	22	254	20917	0	21230
18877	31	21426	192	247	0	21896
18878	27	211	52	21764	0	22054
18879	21591	173	41	268	0	22073
18880	225	36	21489	217	0	21967
18881	183	21691	220	69	0	22163
18882	48	211	178	21515	0	21952
18883	75	169	22384	235	0	22863
18884	33	42	214	21035	0	21324
18885	28	21579	184	213	0	22004
18886	31	22194	39	210	0	22474
18887	21461	339	27	61	0	21888
18888	257	21830	25	205	0	22317
18889	180	296	21279	44	0	21799
18890	19894	167	196	37	0	20294
18891	219	43	21534	25	0	21821
18892	164	37	195	20197	0	20593
18893	68	15	21536	187	0	21806
18894	31	21276	188	251	0	21746
18895	28	185	183	21074	0	21470
18896	44	162	44	21023	0	21273
18897	37	37	31	21448	0	21553
18898	34	40	21504	341	0	21919
18899	39	25	194	20984	0	21242
18900	35	27	172	21085	0	21319
18901	20645	26	63	336	0	21070
18902	20310	23	53	207	0	20593
18903	334	20	21127	78	0	21559
18904	182	20888	204	81	0	21355
18905	72	198	21098	54	0	21422
18906	43	157	209	20836	0	21245
18907	49	103	21241	211	0	21604
18908	44	38	224	20819	0	21125
18909	29	35	177	21120	0	21361
18910	41	33	21236	364	0	21674
18911	19232	36	233	205	0	19706
18912	209	21355	169	86	0	21819
18913	161	199	68	21319	0	21747
18914	54	175	22370	205	0	22804
18915	75	56	22040	191	0	22362
18916	21240	52	335	82	0	21709
18917	189	22085	190	87	0	22551
18918	168	186	68	21881	0	22303
18919	21932	167	56	223	0	22378
18920	197	49	62	22088	0	22396
18921	172	54	55	22018	0	22299
18922	76	54	21958	349	0	22437
18923	20792	43	218	230	0	21283
18924	21847	47	202	93	0	22189
18925	345	34	75	22029	0	22483
18926	21777	51	67	222	0	22117
18927	220	39	66	21772	0	22097
18928	191	21414	62	260	0	21927
18929	69	21994	59	247	0	22369
18930	51	405	72	22117	0	22645
18931	21618	181	122	257	0	22178
18932	206	68	53	21770	0	22097
18933	21775	49	70	256	0	22150
18934	21682	55	62	229	0	22028
18935	355	50	70	21649	0	22124
18936	220	37	66	22040	0	22363
18937	103	45	21504	362	0	22014
18938	70	53	22008	225	0	22356
18939	72	62	369	21663	0	22166
18940	54	45	23326	267	0	23692
18941	22857	47	289	233	0	23426
18942	231	52	241	25389	0	25913
18943	218	49	27178	282	0	27727
18944	26672	38	293	321	0	27324
18945	28725	44	326	112	0	29207
18946	547	30466	117	127	0	31257
18947	422	392	70	30776	0	31660
18948	141	327	31691	378	0	32537
18949	31526	92	352	371	0	32341
18950	32398	64	375	139	0	32976
18951	646	79	32004	108	0	32837
18952	31815	41	361	113	0	32330
18953	416	54	375	30784	0	31629
18954	386	46	103	31830	0	32365
18955	31458	50	82	653	0	32243
18956	31153	52	80	422	0	31707
18957	668	255	134	30920	0	31977
18958	437	41	30992	405	0	31875
18959	125	29846	361	472	0	30804
18960	132	297	29812	151	0	30392
18961	185	285	29257	120	0	29847
18962	185	28035	657	125	0	29002
18963	166	289	378	23402	0	24235
18964	63	223	83	24239	0	24608
18965	72	80	24348	409	0	24909
18966	63	43	241	24176	0	24523
18967	24247	47	243	296	0	24833
18968	288	124	24520	277	0	25209
18969	24632	31	270	122	0	25055
18970	24768	21	289	76	0	25154
18971	25028	29	120	86	0	25263
18972	583	32	24897	99	0	25611
18973	407	36	25156	86	0	25685
18974	208	34	456	24680	0	25378
18975	207	127	315	23529	0	24178
18976	156	25320	134	474	0	26084
18977	25241	245	129	314	0	25929
18978	24972	261	131	131	0	25495
18979	530	25384	130	154	0	26198
18980	25474	266	203	124	0	26067
18981	369	25307	116	133	0	25925
18982	25381	293	105	130	0	25909
18983	367	262	109	24257	0	24995
18984	330	103	24777	340	0	25550
18985	165	76	24617	366	0	25224
18986	144	62	526	24233	0	24965
18987	134	58	390	24739	0	25321
18988	157	61	24617	521	0	25356
18989	136	75	360	24088	0	24659
18990	169	66	386	24484	0	25105
18991	24169	52	212	700	0	25133
18992	24324	65	184	381	0	24954
18993	24096	52	157	196	0	24501
18994	595	54	23818	172	0	24639
18995	402	23832	334	192	0	24760
18996	245	253	340	23808	0	24646
18997	260	261	24812	295	0	25628
18998	241	24788	339	314	0	25682
18999	25003	301	344	133	0	25781
19000	416	311	156	24743	0	25626
19001	449	123	122	25002	0	25696
19002	24885	108	144	567	0	25704
19003	420	104	150	24970	0	25644
19004	406	100	165	24907	0	25578
19005	25320	92	145	611	0	26168
19006	422	109	25107	418	0	26056
19007	403	25079	378	233	0	26093
19008	25200	321	351	208	0	26080
19009	433	298	25599	219	0	26549
19010	25098	128	378	192	0	25796
19011	449	25656	399	201	0	26705
19012	25541	303	191	225	0	26260
19013	25193	287	195	199	0	25874
19014	24393	112	197	208	0	24910
19015	679	103	190	23806	0	24778
19016	465	111	195	23675	0	24446
19017	270	24068	188	638	0	25164
19018	249	24251	197	439	0	25136
19019	256	24771	160	293	0	25480
19020	24612	510	182	240	0	25544
19021	427	332	24341	331	0	25431
19022	460	154	333	24230	0	25177
19023	270	116	323	24032	0	24741
19024	229	24349	180	620	0	25378
19025	259	339	174	24414	0	25186
19026	263	334	159	24061	0	24817
19027	211	24911	156	646	0	25924
19028	24747	344	242	409	0	25742
19029	418	25287	154	254	0	26113
19030	419	373	24998	211	0	26001
19031	24468	319	342	222	0	25351
19032	464	25075	333	222	0	26094
19033	24672	321	175	201	0	25369
19034	484	323	145	24345	0	25297
19035	473	143	148	24481	0	25245
19036	314	148	24460	578	0	25500
19037	308	174	24382	364	0	25228
19038	262	156	482	23901	0	24801
19039	23980	150	325	343	0	24798
19040	22233	155	257	319	0	22964
19041	560	22910	141	198	0	23809
19042	271	21119	100	136	0	21626
19043	146	19842	80	109	0	20177
19044	573	433	104	18080	0	19190
19045	17092	108	660	299	0	18159
19046	16382	42	116	108	0	16648
19047	16214	36	23	57	0	16330
19048	221	26	16179	57	0	16483
19049	107	18503	123	89	0	18822
19050	61	146	100	20144	0	20451
19051	20707	130	26	186	0	21049
19052	200	43	26	20942	0	21211
19053	169	35	22	21690	0	21916
19054	21709	29	31	343	0	22112
19055	23168	46	26	189	0	23429
19056	410	39	23814	48	0	24311
19057	267	21	224	23674	0	24186
19058	79	26	23645	253	0	24003
19059	49	32	226	23594	0	23901
19060	60	33	23592	248	0	23933
19061	35	111	234	23301	0	23681
19062	22621	28	218	260	0	23127
19063	223	22674	36	279	0	23212
19064	235	23003	25	79	0	23342
19065	85	462	20	21354	0	21921
19066	51	23332	20	193	0	23596
19067	22930	235	30	198	0	23393
19068	22097	236	18	64	0	22415
19069	445	48	22495	35	0	23023
19070	254	22604	212	80	0	23150
19071	62	212	219	22512	0	23005
19072	64	222	22472	236	0	22994
19073	21917	37	220	245	0	22419
19074	229	131	226	22219	0	22805
19075	243	27	22100	239	0	22609
19076	49	27	208	22077	0	22361
19077	21829	34	211	251	0	22325
19078	231	25	21733	248	0	22237
19079	21300	33	211	65	0	21609
19080	21696	24	228	50	0	21998
19081	403	36	45	21477	0	21961
19082	272	28	21420	240	0	21960
19083	81	32	21004	233	0	21350
19084	20498	33	401	68	0	21000
19085	21080	26	244	59	0	21409
19086	432	37	21123	48	0	21640
19087	284	35	219	20807	0	21345
19088	85	45	244	20370	0	20744
19089	64	21366	63	432	0	21925
19090	78	231	50	21420	0	21779
19091	21115	232	53	295	0	21695
19092	270	53	50	21356	0	21729
19093	284	40	21148	297	0	21769
19094	20113	41	263	294	0	20711
19095	275	35	266	20864	0	21440
19096	300	39	20944	287	0	21570
19097	89	20124	262	301	0	20776
19098	19500	230	259	108	0	20097
19099	261	20204	81	116	0	20662
19100	20055	251	61	97	0	20464
19101	318	237	19964	119	0	20638
19102	302	19685	254	97	0	20338
19103	111	19742	264	111	0	20228
19104	91	426	182	19163	0	19862
19105	132	266	72	19396	0	19866
19106	124	65	19284	493	0	19966
19107	111	57	270	19240	0	19678
19108	19028	57	285	329	0	19699
19109	315	66	18638	316	0	19335
19110	309	65	276	18573	0	19223
19111	150	65	18669	302	0	19186
19112	17706	70	310	327	0	18413
19113	291	18349	283	185	0	19108
19114	18475	251	121	139	0	18986
19115	18131	273	114	139	0	18657
19116	18640	80	111	136	0	18967
19117	520	78	17896	158	0	18652
19118	359	17598	295	203	0	18455
19119	170	267	304	17021	0	17762
19120	131	275	159	17599	0	18164
19121	17913	88	113	520	0	18634
19122	388	64	127	18081	0	18660
19123	18208	74	140	373	0	18795
19124	18084	95	143	356	0	18678
19125	18291	77	137	188	0	18693
19126	18341	87	171	130	0	18729
19127	639	84	112	17562	0	18397
19128	17632	82	135	347	0	18196
19129	387	87	17107	376	0	17957
19130	17062	99	340	163	0	17664
19131	17184	109	329	156	0	17778
19132	637	86	17038	163	0	17924
19133	17300	104	332	132	0	17868
19134	17482	108	336	122	0	18048
19135	610	64	139	17030	0	17843
19136	431	95	134	17176	0	17836
19137	16909	154	134	598	0	17795
19138	409	66	135	17260	0	17870
19139	431	56	156	16894	0	17537
19140	191	16833	125	580	0	17729
19141	188	246	111	16722	0	17267
19142	16164	253	148	349	0	16914
19143	366	75	110	16054	0	16605
19144	379	38	103	15397	0	15917
19145	168	15210	123	526	0	16027
19146	180	227	93	14788	0	15288
19147	179	229	114	14519	0	15041
19148	14126	60	99	471	0	14756
19149	310	133	56	11170	0	11669
19150	266	26	9654	218	0	10164
19151	82	8750	150	196	0	9178
19152	64	8402	166	69	0	8701
19153	7968	233	109	58	0	8368
19154	156	8365	36	52	0	8609
19155	6711	92	39	32	0	6874
19156	105	6579	14	33	0	6731
19157	6606	85	23	25	0	6739
19158	112	69	16	6628	0	6825
19159	87	19	10	6743	0	6859
19160	35	6752	12	169	0	6968
19161	27	90	14	7024	0	7155
19162	40	76	7104	114	0	7334
19163	6741	28	87	83	0	6939
19164	111	7921	76	40	0	8148
19165	7866	90	18	33	0	8007
19166	7696	100	16	16	0	7828
19167	7860	28	12	32	0	7932
19168	207	12	16	7555	0	7790
19169	134	17	9	7411	0	7571
19170	41	7906	7	200	0	8154
19171	7885	93	12	115	0	8105
19172	105	8024	4	48	0	8181
19173	8090	115	8	26	0	8239
19174	139	103	8364	34	0	8640
19175	8542	29	110	32	0	8713
19176	153	19	98	8546	0	8816
19177	130	20	8564	144	0	8858
19178	58	20	8617	134	0	8829
19179	30	22	216	8629	0	8897
19180	59	13	8766	140	0	8978
19181	34	26	135	8596	0	8791
19182	8196	18	129	150	0	8493
19183	139	23	31	8562	0	8755
19184	146	69	8406	163	0	8784
19185	63	8371	109	142	0	8685
19186	48	8613	116	57	0	8834
19187	65	247	31	8141	0	8484
19188	8224	123	13	113	0	8473
19189	121	34	14	8302	0	8471
19190	133	22	10	8274	0	8439
19191	69	20	17	8375	0	8481
19192	42	19	11	8414	0	8486
19193	43	17	8264	222	0	8546
19194	46	16	8117	160	0	8339
19195	7997	23	193	49	0	8262
19196	8189	24	122	42	0	8377
19197	223	19	33	8100	0	8375
19198	147	23	26	8262	0	8458
19199	80	13	8081	220	0	8394
19200	41	8028	101	162	0	8332
19201	7942	109	112	70	0	8233
19202	7952	114	39	53	0	8158
19203	217	42	24	7978	0	8261
19204	155	25	8165	137	0	8482
19205	59	24	114	7905	0	8102
19206	46	8131	106	146	0	8429
19207	47	116	8119	140	0	8422
19208	7892	109	121	63	0	8185
19209	134	48	122	8136	0	8440
19210	8275	22	47	149	0	8493
19211	150	34	7992	134	0	8310
19212	8001	24	116	81	0	8222
19213	143	33	122	8027	0	8325
19214	8060	26	45	152	0	8283
19215	139	34	38	7942	0	8153
19216	132	7805	40	159	0	8136
19217	64	7960	33	145	0	8202
19218	45	274	33	7923	0	8275
19219	59	130	8016	122	0	8327
19220	48	7989	121	138	0	8296
19221	28	175	105	7174	0	7482
19222	6955	82	58	151	0	7246
19223	6918	32	28	118	0	7096
19224	162	20	23	6971	0	7176
19225	112	17	33	6903	0	7065
19226	43	6854	32	167	0	7096
19227	39	6983	25	121	0	7168
19228	7002	139	27	70	0	7238
19229	95	104	34	6821	0	7054
19230	100	33	30	6912	0	7075
19231	52	19	6885	185	0	7141
19232	40	19	87	6811	0	6957
19233	39	16	105	6632	0	6792
19234	43	26	41	6798	0	6908
19235	43	51	6755	194	0	7043
19236	34	21	104	6780	0	6939
19237	6827	27	101	114	0	7069
19238	102	20	6636	133	0	6891
19239	6890	14	92	82	0	7078
19240	117	26	107	7019	0	7269
19241	115	24	41	7172	0	7352
19242	50	30	34	7586	0	7700
19243	56	85	7294	255	0	7690
19244	6963	20	103	157	0	7243
19245	107	7690	114	83	0	7994
19246	8047	92	53	61	0	8253
19247	126	8103	30	65	0	8324
19248	127	118	33	8100	0	8378
19249	8079	108	27	153	0	8367
19250	127	35	7930	138	0	8230
19251	7728	27	103	75	0	7933
19252	135	60	8251	57	0	8503
19253	131	46	118	7938	0	8233
19254	62	21	8086	129	0	8298
19255	43	7926	120	133	0	8222
19256	29	88	163	7601	0	7881
19257	7443	123	28	128	0	7722
19258	85	39	18	7280	0	7422
19259	88	7319	23	106	0	7536
19260	42	72	20	7268	0	7402
19261	6990	78	25	106	0	7199
19262	6739	30	24	110	0	6903
19263	156	6986	30	47	0	7219
19264	50	6066	9	29	0	6154
19265	19	93	8	5898	0	6018
19266	18	51	16	5941	0	6026
19267	5907	16	9	110	0	6042
19268	5813	19	12	59	0	5903
19269	101	6251	10	34	0	6396
19270	54	68	12	5955	0	6089
19271	30	47	19	6059	0	6155
19272	21	20	6031	111	0	6183
19273	18	5954	59	74	0	6105
19274	14	5638	41	22	0	5715
19275	13	60	6	5426	0	5505
19276	19	32	5443	49	0	5543
19277	19	15	5512	43	0	5589
19278	18	12	75	5482	0	5587
19279	17	16	33	5678	0	5744
19280	17	10	5705	79	0	5811
19281	25	6	40	5696	0	5767
19282	21	7	5807	50	0	5885
19283	5865	17	45	52	0	5979
19284	55	16	48	6006	0	6125
19285	61	13	6017	73	0	6164
19286	26	7	6274	63	0	6370
19287	17	20	103	6640	0	6780
19288	20	16	6961	93	0	7090
19289	27	15	7346	73	0	7461
19290	13	7406	133	36	0	7588
19291	7523	88	70	28	0	7709
19292	106	73	7744	27	0	7950
19293	79	25	94	7475	0	7673
19294	19	25	78	7755	0	7877
19295	21	22	13	7934	0	7990
19296	20	15	7811	178	0	8024
19297	16	15	92	7743	0	7866
19298	7739	17	79	119	0	7954
19299	95	16	18	7889	0	8018
19300	92	7	7872	125	0	8096
19301	19	16	114	7812	0	7961
19302	7783	13	88	124	0	8008
19303	8049	19	21	113	0	8202
19304	7930	19	27	35	0	8011
19305	168	13	27	7907	0	8115
19306	7999	17	29	122	0	8167
19307	7864	9	32	96	0	8001
19308	8005	8	34	50	0	8097
19309	163	7874	34	45	0	8116
19310	7960	96	36	34	0	8126
19311	116	80	28	7957	0	8181
19312	95	17	8013	124	0	8249
19313	27	7974	119	116	0	8236
19314	7953	99	100	53	0	8205
19315	116	76	47	7941	0	8180
19316	90	24	45	7681	0	7840
19317	26	7914	42	187	0	8169
19318	21	8044	39	129	0	8233
19319	7755	149	43	58	0	8005
19320	105	7844	45	49	0	8043
19321	7651	100	36	55	0	7842
19322	111	7643	36	58	0	7848
19323	7554	101	32	53	0	7740
19324	120	7572	32	68	0	7792
19325	93	7705	31	59	0	7888
19326	7645	156	36	49	0	7886
19327	134	78	7529	57	0	7798
19328	106	7497	110	49	0	7762
19329	50	99	97	7411	0	7657
19330	45	79	43	7608	0	7775
19331	47	25	41	7402	0	7515
19332	54	18	37	7530	0	7639
19333	53	25	7455	195	0	7728
19334	7264	28	117	113	0	7522
19335	136	20	97	7581	0	7834
19336	7830	24	45	138	0	8037
19337	8109	26	33	122	0	8290
19338	8171	29	31	57	0	8288
19339	8097	39	33	56	0	8225
19340	236	31	8039	61	0	8367
19341	117	35	129	7740	0	8021
19342	54	25	7809	157	0	8045
19343	44	7703	147	143	0	8037
19344	79	146	126	7315	0	7666
19345	60	106	41	7277	0	7484
19346	36	30	41	7132	0	7239
19347	53	26	29	7219	0	7327
19348	46	24	6999	243	0	7312
19349	49	28	126	7018	0	7221
19350	59	26	111	7142	0	7338
19351	7123	21	34	242	0	7420
19352	7345	21	41	133	0	7540
19353	234	32	40	7340	0	7646
19354	139	29	42	7296	0	7506
19355	66	25	46	7511	0	7648
19356	7242	21	42	254	0	7559
19357	7263	22	30	158	0	7473
19358	7224	33	44	68	0	7369
19359	7243	38	34	71	0	7386
19360	255	7069	27	77	0	7428
19361	7152	137	31	62	0	7382
19362	7133	111	29	56	0	7329
19363	268	39	19	6788	0	7114
19364	155	32	28	6937	0	7152
19365	6775	32	23	243	0	7073
19366	174	6668	26	154	0	7022
19367	156	6819	24	60	0	7059
19368	6674	277	83	75	0	7109
19369	184	117	23	6659	0	6983
19370	142	42	22	6730	0	6936
19371	84	40	23	6795	0	6942
19372	69	42	14	6782	0	6907
19373	74	33	19	6684	0	6810
19374	58	6513	19	257	0	6847
19375	70	126	20	6513	0	6729
19376	6420	107	17	182	0	6726
19377	173	33	20	6309	0	6535
19378	136	44	12	6261	0	6453
19379	6085	32	17	221	0	6355
19380	158	6102	14	147	0	6421
19381	126	128	23	5893	0	6170
19382	59	5967	19	155	0	6200
19383	38	190	8	5365	0	5601
19384	70	74	5262	131	0	5537
19385	5013	25	83	90	0	5211
19386	113	5093	62	38	0	5306
19387	4708	85	12	32	0	4837
19388	103	49	4677	28	0	4857
19389	62	22	73	4183	0	4340
19390	32	4317	47	77	0	4473
19391	30	4482	8	75	0	4595
19392	4202	103	10	24	0	4339
19393	136	44	8	4185	0	4373
19394	58	10	4520	94	0	4682
19395	16	8	66	4586	0	4676
19396	21	12	4604	101	0	4738
19397	4430	6	68	78	0	4582
19398	87	10	4650	33	0	4780
19399	61	11	66	4432	0	4570
19400	18	4506	56	126	0	4706
19401	23	70	4	4460	0	4557
19402	18	4530	9	90	0	4647
19403	4501	67	6	75	0	4649
19404	89	48	5	4695	0	4837
19405	71	13	4820	100	0	5004
19406	30	14	4805	79	0	4928
19407	4741	13	109	42	0	4905
19408	5021	13	51	38	0	5123
19409	5058	16	7	36	0	5117
19410	5030	6	9	36	0	5081
19411	130	4944	6	37	0	5117
19412	5032	75	10	35	0	5152
19413	4989	59	6	49	0	5103
19414	138	15	4982	36	0	5171
19415	84	19	65	4906	0	5074
19416	5006	14	61	93	0	5174
19417	91	13	4935	80	0	5119
19418	74	18	71	4887	0	5050
19419	32	20	5225	101	0	5378
19420	31	23	72	5072	0	5198
19421	33	5296	51	99	0	5479
19422	5388	71	12	74	0	5545
19423	81	61	5314	49	0	5505
19424	5245	22	68	46	0	5381
19425	100	19	54	5249	0	5422
19426	5367	22	18	94	0	5501
19427	86	22	13	5475	0	5596
19428	6221	15	12	101	0	6349
19429	93	18	6294	85	0	6490
19430	6708	20	74	43	0	6845
19431	86	27	52	6816	0	6981
19432	82	23	10	6880	0	6995
19433	6891	22	18	146	0	7077
19434	82	22	18	6961	0	7083
19435	74	18	7054	93	0	7239
19436	32	71	51	6797	0	6951
19437	6296	10	56	56	0	6418
19438	51	6288	16	59	0	6414
19439	46	6138	15	22	0	6221
19440	5954	57	6	19	0	6036
19441	45	6636	16	16	0	6713
19442	29	27	5	6518	0	6579
19443	6646	25	8	43	0	6722
19444	6493	12	6	30	0	6541
19445	6531	7	6	21	0	6565
19446	54	9	6699	9	0	6771
19447	18	35	36	6517	0	6606
19448	13	6721	21	34	0	6789
19449	15	28	12	6888	0	6943
19450	16	17	7192	27	0	7252
19451	17	7125	36	43	0	7221
19452	7	47	21	6923	0	6998
19453	6763	15	1	26	0	6805
19454	20	6869	1	24	0	6914
19455	20	15	7381	8	0	7424
19456	11	16	29	7236	0	7292
19457	24	0	7536	28	0	7588
19458	7	3	30	7320	0	7360
19459	7684	2	22	32	0	7740
19460	32	0	3	7944	0	7979
19461	8046	5	8	36	0	8095
19462	8024	2	4	23	0	8053
19463	56	8385	4	19	0	8464
19464	8578	31	2	11	0	8622
19465	43	8549	5	16	0	8613
19466	36	36	9059	10	0	9141
19467	14	31	46	9040	0	9131
19468	8	5	35	9765	0	9813
19469	19	3	9731	111	0	9864
19470	9	9660	68	52	0	9789
19471	9685	71	41	18	0	9815
19472	9811	46	9	8	0	9874
19473	109	10	10	10159	0	10288
19474	47	13	8	10125	0	10193
19475	17	5	7	10451	0	10480
19476	10400	9	5	113	0	10527
19477	81	3	10291	54	0	10429
19478	64	6	10464	19	0	10553
19479	11	4	117	10484	0	10616
19480	22	6	10691	82	0	10801
19481	26	7	10672	62	0	10767
19482	9	9	116	10382	0	10516
19483	21	10	11171	82	0	11284
19484	11	11071	82	93	0	11257
19485	13	74	56	11018	0	11161
19486	15	51	11388	89	0	11543
19487	16	14	80	11104	0	11214
19488	11	10734	62	88	0	10895
19489	25	70	19	11056	0	11170
19490	18	49	11066	94	0	11227
19491	14	13	81	10631	0	10739
19492	10764	13	53	84	0	10914
19493	78	12	10962	63	0	11115
19494	10208	1	75	21	0	10305
19495	70	10908	47	32	0	11057
19496	11000	69	44	26	0	11139
19497	75	47	13	11014	0	11149
19498	55	11058	11	81	0	11205
19499	11489	70	19	51	0	11629
19500	88	56	16	11646	0	11806
19501	63	7	11842	105	0	12017
19502	10	11915	99	80	0	12104
19503	10	82	73	12026	0	12191
19504	11934	61	22	104	0	12121
19505	11491	20	24	76	0	11611
19506	154	19	13	11647	0	11833
19507	90	9	11663	107	0	11869
19508	10705	5	107	88	0	10905
19509	109	6	11849	40	0	12004
19510	71	15	107	11682	0	11875
19511	11951	13	80	110	0	12154
19512	100	11827	31	100	0	12058
19513	12002	92	29	34	0	12157
19514	117	69	11765	36	0	11987
19515	12000	14	116	26	0	12156
19516	112	21	90	12189	0	12412
19517	89	18	21	12546	0	12674
19518	46	15	12742	168	0	12971
19519	26	18	97	12508	0	12649
19520	12702	20	77	123	0	12922
19521	104	18	28	12709	0	12859
19522	96	13003	22	135	0	13256
19523	25	110	33	12828	0	12996
19524	28	13144	21	122	0	13315
19525	20	106	13137	87	0	13350
19526	12083	82	115	52	0	12332
19527	127	15	92	13103	0	13337
19528	93	15	12473	183	0	12764
19529	50	12291	113	96	0	12550
19530	42	112	81	11973	0	12208
19531	34	88	35	12130	0	12287
19532	12102	24	26	195	0	12347
19533	119	46	19	12052	0	12236
19534	12094	26	38	142	0	12300
19535	12044	31	29	107	0	12211
19536	197	12251	35	73	0	12556
19537	12570	135	38	41	0	12784
19538	170	85	26	13954	0	14235
19539	124	21	13997	200	0	14342
19540	13819	22	182	130	0	14153
19541	207	14	116	13659	0	13996
19542	131	21	13557	206	0	13915
19543	12775	16	180	151	0	13122
19544	198	31	116	13404	0	13749
19545	127	13726	44	215	0	14112
19546	81	170	41	13432	0	13724
19547	38	13722	49	207	0	14016
19548	13575	188	43	134	0	13940
19549	185	109	13736	72	0	14102
19550	128	13417	176	84	0	13805
19551	61	168	122	13473	0	13824
19552	50	111	13454	207	0	13822
19553	54	34	13279	146	0	13513
19554	44	13347	249	73	0	13713
19555	44	230	145	12508	0	12927
19556	38	104	44	12506	0	12692
19557	49	57	39	15039	0	15184
19558	15441	30	34	361	0	15866
19559	288	33	17012	191	0	17524
19560	173	17020	294	144	0	17631
19561	78	301	211	16454	0	17044
19562	58	194	57	17518	0	17827
19563	70	55	17149	501	0	17775
19564	40	47	322	17245	0	17654
19565	65	19	17305	383	0	17772
19566	51	25	16585	245	0	16906
19567	69	19	16490	80	0	16658
19568	92	26	457	15260	0	15835
19569	45	50	220	15483	0	15798
19570	42	24	62	16367	0	16495
19571	16108	31	47	475	0	16661
19572	290	15975	36	243	0	16544
19573	16007	280	32	103	0	16422
19574	15555	186	53	73	0	15867
19575	16113	61	53	44	0	16271
19576	478	15965	34	70	0	16547
19577	15982	318	92	55	0	16447
19578	15943	194	35	57	0	16229
19579	461	87	33	15500	0	16081
19580	241	62	32	15684	0	16019
19581	100	34	38	16319	0	16491
19582	64	49	15998	514	0	16625
19583	15313	37	311	273	0	15934
19584	331	32	208	15772	0	16343
19585	15669	38	115	355	0	16177
19586	335	15480	79	249	0	16143
19587	210	308	71	15489	0	16078
19588	74	192	67	15823	0	16156
19589	15414	68	68	528	0	16078
19590	328	45	54	15613	0	16040
19591	15042	56	70	419	0	15587
19592	15284	51	66	244	0	15645
19593	501	14987	49	138	0	15675
19594	239	15194	46	265	0	15744
19595	111	507	48	14641	0	15307
19596	71	15122	63	336	0	15592
19597	77	359	56	15013	0	15505
19598	76	204	14737	418	0	15435
19599	75	70	14099	236	0	14480
19600	13345	58	474	149	0	14026
19601	13874	38	242	112	0	14266
19602	444	13642	93	112	0	14291
19603	13658	285	100	88	0	14131
19604	346	13776	54	104	0	14280
19605	211	337	44	13616	0	14208
19606	90	181	64	13805	0	14140
19607	85	71	58	13894	0	14108
19608	73	51	73	14136	0	14333
19609	13582	26	74	532	0	14214
19610	318	13548	77	280	0	14223
19611	13574	295	60	171	0	14100
19612	13682	167	84	125	0	14058
19613	484	98	13448	118	0	14148
19614	13363	64	308	133	0	13868
19615	371	13113	183	136	0	13803
19616	244	319	95	13018	0	13676
19617	138	206	68	12771	0	13183
19618	113	12807	73	469	0	13462
19619	12734	337	86	272	0	13429
19620	365	204	12586	142	0	13297
19621	12456	95	316	121	0	12988
19622	400	63	12502	148	0	13113
19623	253	73	369	12297	0	12992
19624	134	81	221	12575	0	13011
19625	115	63	108	12667	0	12953
19626	12455	84	91	575	0	13205
19627	369	74	12546	367	0	13356
19628	12619	76	333	208	0	13236
19629	12750	76	231	184	0	13241
19630	12730	76	137	170	0	13113
19631	12755	63	109	185	0	13112
19632	589	63	103	12446	0	13201
19633	311	51	12433	412	0	13207
19634	220	64	312	12403	0	12999
19635	150	73	12235	428	0	12886
19636	186	60	11915	289	0	12450
19637	126	11730	392	179	0	12427
19638	163	250	199	10084	0	10696
19639	159	190	58	10217	0	10624
19640	152	112	43	9981	0	10288
19641	189	78	45	10185	0	10497
19642	10005	66	45	428	0	10544
19643	10119	74	41	244	0	10478
19644	466	55	33	9962	0	10516
19645	264	56	9784	364	0	10468
19646	150	57	239	9933	0	10379
19647	128	54	157	10255	0	10594
19648	135	53	10026	437	0	10651
19649	104	63	253	9845	0	10265
19650	9939	48	143	359	0	10489
19651	9919	66	65	256	0	10306
19652	10057	63	54	155	0	10329
19653	447	69	35	9778	0	10329
19654	9697	58	40	343	0	10138
19655	9722	48	52	232	0	10054
19656	443	63	9524	123	0	10153
19657	160	38	7103	73	0	7374
19658	111	33	7029	55	0	7228
19659	4877	41	81	18	0	5017
19660	59	5004	54	21	0	5138
19661	4793	50	13	19	0	4875
19662	63	5748	11	21	0	5843
19663	26	50	13	5707	0	5796
19664	27	25	6	5837	0	5895
19665	13	16	14	5794	0	5837
19666	20	9	5777	82	0	5888
19667	5454	6	40	37	0	5537
19668	51	7	23	5618	0	5699
19669	33	6	5811	43	0	5893
19670	21	9	5640	29	0	5699
19671	5472	50	51	24	0	5597
19672	40	5751	26	84	0	5901
19673	5821	27	13	12	0	5873
19674	5765	15	13	12	0	5805
19675	47	5696	9	11	0	5763
19676	5657	28	9	22	0	5716
19677	43	14	6079	12	0	6148
19678	102	6	5916	11	0	6035
19679	17	4	6509	15	0	6545
19680	8	23	33	6025	0	6089
19681	12	2	6309	22	0	6345
19682	5909	0	12	22	0	5943
19683	6021	0	11	13	0	6045
19684	25	1	6187	9	0	6222
19685	18	2	9	6071	0	6100
19686	6225	0	11	19	0	6255
19687	11	6631	6	19	0	6667
19688	16	6747	8	11	0	6782
19689	6766	17	6	10	0	6799
19690	17	12	7359	5	0	7393
19691	11	29	14	7162	0	7216
19692	11	3	50	7109	0	7173
19693	7	3	2	7245	0	7257
19694	2	7305	2	26	0	7335
19695	7	11	11	7316	0	7345
19696	7842	7	2	19	0	7870
19697	15	5	2	8052	0	8074
19698	12	8306	3	29	0	8350
19699	8518	18	5	17	0	8558
19700	23	13	2	8491	0	8529
19701	15	7	3	8869	0	8894
19702	9521	3	2	47	0	9573
19703	9495	4	4	28	0	9531
19704	54	1	4	9975	0	10034
19705	10398	3	0	53	0	10454
19706	10468	2	3	42	0	10515
19707	84	10635	6	16	0	10741
19708	10695	50	0	13	0	10758
19709	61	10668	2	12	0	10743
19710	41	57	3	10861	0	10962
19711	17	40	11566	59	0	11682
19712	9	4	56	11440	0	11509
19713	3	5	40	11470	0	11518
19714	5	2	7	11988	0	12002
19715	11975	5	5	108	0	12093
19716	63	12068	2	70	0	12203
19717	12657	60	0	10	0	12727
19718	78	13184	3	21	0	13286
19719	13487	76	4	9	0	13576
19720	13176	57	9	10	0	13252
19721	13348	9	6	5	0	13368
19722	13287	7	18	6	0	13318
19723	147	5	13848	5	0	14005
19724	68	4	91	13650	0	13813
19725	23	7	67	14362	0	14459
19726	23	9	14352	170	0	14554
19727	13829	7	109	85	0	14030
19728	117	12	69	14211	0	14409
19729	93	7	14199	115	0	14414
19730	36	8	14061	77	0	14182
19731	16	8	172	14435	0	14631
19732	36	9	14985	136	0	15166
19733	15	8	123	14514	0	14660
19734	17	6	85	14695	0	14803
19735	24	9	14800	196	0	15029
19736	13876	9	120	102	0	14107
19737	121	10	73	14719	0	14923
19738	104	7	14951	131	0	15193
19739	31	12	116	14888	0	15047
19740	14964	9	80	142	0	15195
19741	138	8	14910	97	0	15153
19742	14550	13	118	37	0	14718
19743	15420	8	80	17	0	15525
19744	209	11	19	15377	0	15616
19745	106	8	18	15364	0	15496
19746	50	12	15132	276	0	15470
19747	31	9	116	15088	0	15244
19748	48	20	107	14446	0	14621
19749	31	10	30	15354	0	15425
19750	42	8	14948	212	0	15210
19751	14488	11	130	115	0	14744
19752	14913	12	99	56	0	15080
19753	15247	16	37	42	0	15342
19754	15309	13	35	39	0	15396
19755	224	17	29	15347	0	15617
19756	15211	8	29	166	0	15414
19757	15424	11	40	145	0	15620
19758	14931	20	51	80	0	15082
19759	15657	9	37	66	0	15769
19760	220	15598	39	63	0	15920
19761	15771	110	41	72	0	15994
19762	15165	79	43	71	0	15358
19763	220	15157	46	89	0	15512
19764	15226	131	43	53	0	15453
19765	186	90	39	15116	0	15431
19766	143	22	37	15228	0	15430
19767	15100	16	49	255	0	15420
19768	168	15011	55	161	0	15395
19769	129	15093	46	98	0	15366
19770	68	193	45	15553	0	15859
19771	74	96	15799	181	0	16150
19772	74	23	155	15426	0	15678
19773	69	20	123	15757	0	15969
19774	15604	8	61	248	0	15921
19775	15530	15	53	158	0	15756
19776	253	14	42	15699	0	16008
19777	158	17	15568	186	0	15929
19778	102	8	154	16058	0	16322
19779	16077	10	205	190	0	16482
19780	195	11	17062	159	0	17427
19781	157	17168	188	92	0	17605
19782	17561	158	131	75	0	17925
19783	232	108	60	17098	0	17498
19784	184	35	56	17201	0	17476
19785	101	27	46	17763	0	17937
19786	95	20	17401	344	0	17860
19787	15780	13	206	201	0	16200
19788	247	21	17114	106	0	17488
19789	196	16927	221	93	0	17437
19790	106	169	151	16461	0	16887
19791	93	118	67	16618	0	16896
19792	94	37	64	17619	0	17814
19793	99	26	17571	386	0	18082
19794	112	15	17297	232	0	17656
19795	110	22	17845	115	0	18092
19796	86	17680	343	117	0	18226
19797	177	212	207	17740	0	18336
19798	17859	139	62	273	0	18333
19799	18630	36	66	208	0	18940
19800	421	30	19796	106	0	20353
19801	244	19653	258	155	0	20310
19802	130	247	19470	96	0	19943
19803	86	19738	284	70	0	20178
19804	18866	356	240	75	0	19537
19805	18789	174	92	59	0	19114
19806	408	18642	48	94	0	19192
19807	18749	231	29	88	0	19097
19808	306	160	57	18209	0	18732
19809	219	62	48	18603	0	18932
19810	18432	42	41	400	0	18915
19811	17234	36	50	230	0	17550
19812	17638	27	44	99	0	17808
19813	443	17400	38	110	0	17991
19814	227	17654	31	88	0	18000
19815	17635	343	37	79	0	18094
19816	301	173	17407	64	0	17945
19817	197	225	231	16539	0	17192
19818	16036	31	189	235	0	16491
19819	257	15851	55	188	0	16351
19820	199	16313	43	91	0	16646
19821	16243	353	30	41	0	16667
19822	277	197	16088	33	0	16595
19823	15225	121	208	32	0	15586
19824	262	44	15342	31	0	15679
19825	170	36	14974	22	0	15202
19826	61	24	304	14514	0	14903
19827	48	31	14942	186	0	15207
19828	14483	23	211	144	0	14861
19829	14740	26	144	45	0	14955
19830	14906	29	46	32	0	15013
19831	14671	32	35	29	0	14767
19832	337	33	26	14253	0	14649
19833	14314	28	28	196	0	14566
19834	237	14090	31	149	0	14507
19835	175	185	30	13585	0	13975
19836	77	14478	26	230	0	14811
19837	14756	212	20	134	0	15122
19838	14587	157	29	57	0	14830
19839	347	54	24	14534	0	14959
19840	14769	39	52	207	0	15067
19841	14919	46	34	161	0	15160
19842	348	39	37	14552	0	14976
19843	200	40	53	14316	0	14609
19844	101	46	43	14628	0	14818
19845	92	35	14274	343	0	14744
19846	85	47	14033	181	0	14346
19847	94	51	14457	66	0	14668
19848	81	45	340	14319	0	14785
19849	97	45	14741	208	0	15091
19850	91	44	250	14540	0	14925
19851	95	56	15013	252	0	15416
19852	101	48	14583	178	0	14910
19853	13947	46	348	87	0	14428
19854	245	14610	195	87	0	15137
19855	14752	208	101	45	0	15106
19856	300	169	62	14400	0	14931
19857	228	63	54	14409	0	14754
19858	134	66	14401	345	0	14946
19859	118	14341	215	264	0	14938
19860	103	264	171	14440	0	14978
19861	128	164	14611	235	0	15138
19862	103	14249	231	194	0	14777
19863	112	231	169	14122	0	14634
19864	13982	167	110	267	0	14526
19865	13942	102	78	157	0	14279
19866	382	75	55	13996	0	14508
19867	14047	55	66	275	0	14443
19868	296	14288	69	184	0	14837
19869	227	222	67	14162	0	14678
19870	148	165	14435	228	0	14976
19871	151	75	230	14246	0	14702
19872	110	71	14466	292	0	14939
19873	13785	49	249	187	0	14270
19874	325	49	168	14067	0	14609
19875	227	14520	79	272	0	15098
19876	164	276	68	14753	0	15261
19877	130	161	14335	281	0	14907
19878	118	80	14040	211	0	14449
19879	100	68	14082	103	0	14353
19880	12375	94	528	70	0	13067
19881	231	12747	222	79	0	13279
19882	178	189	88	12577	0	13032
19883	12676	149	59	194	0	13078
19884	218	12811	52	173	0	13254
19885	13289	201	71	79	0	13640
19886	13271	145	63	122	0	13601
19887	13416	59	64	84	0	13623
19888	13578	32	78	69	0	13757
19889	342	46	13359	55	0	13802
19890	12980	29	206	85	0	13300
19891	256	18	13283	73	0	13630
19892	11133	35	226	56	0	11450
19893	222	26	135	12282	0	12665
19894	167	19	12147	174	0	12507
19895	88	11704	163	138	0	12093
19896	173	819	121	10427	0	11540
19897	55	10849	54	142	0	11100
19898	55	10987	38	105	0	11185
19899	9537	176	18	47	0	9778
19900	87	57	9099	27	0	9270
19901	43	8890	73	40	0	9046
19902	8414	68	118	20	0	8620
19903	62	9043	22	62	0	9189
19904	8890	53	10	16	0	8969
19905	58	27	8	8784	0	8877
19906	8841	17	9	56	0	8923
19907	55	10	15	8801	0	8881
19908	9150	8	11	61	0	9230
19909	61	8	14	9070	0	9153
19910	38	9444	8	70	0	9560
19911	26	52	13	9538	0	9629
19912	9455	28	18	70	0	9571
19913	60	9462	15	36	0	9573
19914	51	47	13	9710	0	9821
19915	9798	28	10	60	0	9896
19916	56	17	14	9763	0	9850
19917	41	12	12	9757	0	9822
19918	22	11	10038	90	0	10161
19919	13	15	9906	43	0	9977
19920	15	17	76	9962	0	10070
19921	25	16	10673	66	0	10780
19922	24	17	62	10329	0	10432
19923	18	20	50	10251	0	10339
19924	24	18	24	10543	0	10609
19925	31	23	10751	90	0	10895
19926	20	13	59	10433	0	10525
19927	30	17	42	10663	0	10752
19928	16	10910	17	82	0	11025
19929	29	49	8	11154	0	11240
19930	11141	37	18	66	0	11262
19931	64	20	13	11360	0	11457
19932	61	10	13898	77	0	14046
19933	13330	23	122	60	0	13535
19934	142	15777	90	57	0	16066
19935	107	135	35	16026	0	16303
19936	49	111	15755	159	0	16074
19937	14797	33	149	117	0	15096
19938	155	15722	112	55	0	16044
19939	15747	146	49	42	0	15984
19940	176	98	26	15512	0	15812
19941	15584	41	35	151	0	15811
19942	184	23	15626	120	0	15953
19943	132	15415	157	54	0	15758
19944	48	17087	119	33	0	17287
19945	17176	305	39	31	0	17551
19946	17104	127	24	25	0	17280
19947	256	45	17088	22	0	17411
19948	16319	24	144	28	0	16515
19949	16842	16	110	24	0	16992
19950	17173	29	44	13	0	17259
19951	268	17082	20	28	0	17398
19952	151	17340	17	33	0	17541
19953	17262	241	16	25	0	17544
19954	17333	133	14	39	0	17519
19955	246	17704	21	34	0	18005
19956	146	319	13	17699	0	18177
19957	58	119	17788	163	0	18128
19958	17643	41	155	132	0	17971
19959	18112	52	120	75	0	18359
19960	18836	32	52	39	0	18959
19961	267	18881	26	42	0	19216
19962	175	160	19471	25	0	19831
19963	19379	118	152	40	0	19689
19964	177	55	123	19673	0	20028
19965	141	35	56	19821	0	20053
19966	75	70	23	20406	0	20574
19967	69	30	20333	277	0	20709
19968	50	24	148	19792	0	20014
19969	83	24	20649	211	0	20967
19970	47	20098	176	172	0	20493
19971	19648	160	116	54	0	19978
19972	145	19742	44	43	0	19974
19973	130	20390	25	124	0	20669
19974	20505	241	22	29	0	20797
19975	166	20852	23	35	0	21076
19976	132	173	154	20315	0	20774
19977	72	20756	21	137	0	20986
19978	20353	152	160	104	0	20769
19979	156	20612	24	72	0	20864
19980	139	184	15	20533	0	20871
19981	81	131	20728	151	0	21091
19982	60	76	139	20526	0	20801
19983	52	20763	131	165	0	21111
19984	51	158	42	20949	0	21200
19985	38	124	47	20612	0	20821
19986	67	55	44	20415	0	20581
19987	60	36	29	21082	0	21207
19988	76	45	27	20966	0	21114
19989	54	45	41	21435	0	21575
19990	65	50	21260	303	0	21678
19991	20004	53	186	174	0	20417
19992	216	44	136	21987	0	22383
19993	162	63	21994	236	0	22455
19994	108	53	22071	173	0	22405
19995	79	60	311	22379	0	22829
19996	22772	39	175	231	0	23217
19997	242	64	22477	163	0	22946
19998	22157	67	213	79	0	22516
19999	283	74	24251	57	0	24665
20000	225	80	232	23592	0	24129
20001	114	68	167	24604	0	24953
20002	123	87	24542	318	0	25070
20003	22848	77	226	208	0	23359
20004	256	74	156	24271	0	24757
20005	224	68	24451	233	0	24976
20006	139	69	24642	181	0	25031
20007	146	79	339	23372	0	23936
20008	91	24571	197	206	0	25065
20009	24990	215	76	188	0	25469
20010	24398	177	67	76	0	24718
20011	384	106	25002	76	0	25568
20012	240	69	235	24367	0	24911
20013	24933	58	168	269	0	25428
20014	283	48	25217	223	0	25771
20015	24401	37	241	153	0	24832
20016	269	25263	218	128	0	25878
20017	223	220	89	25829	0	26361
20018	127	157	91	26006	0	26381
20019	26843	63	70	397	0	27373
20020	265	79	59	26845	0	27248
20021	218	57	76	26393	0	26744
20022	104	60	83	26906	0	27153
20023	26477	47	77	467	0	27068
20024	293	64	26389	274	0	27020
20025	25827	53	284	164	0	26328
20026	26039	71	217	111	0	26438
20027	26418	49	101	129	0	26697
20028	430	57	93	26217	0	26797
20029	264	68	26232	324	0	26888
20030	113	25623	287	241	0	26264
20031	77	25677	222	155	0	26131
20032	50	24280	65	84	0	24479
20033	260	267	24011	61	0	24599
20034	117	279	180	27579	0	28155
20035	28452	34	132	286	0	28904
20036	30222	16	49	236	0	30523
20037	489	19	36	31879	0	32423
20038	283	14	31721	346	0	32364
20039	93	22	31714	293	0	32122
20040	52	11	527	31900	0	32490
20041	66	4	32451	363	0	32884
20042	40	110	361	31959	0	32470
20043	63	32	301	31227	0	31623
20044	39	32023	80	649	0	32791
20045	68	313	61	31749	0	32191
20046	57	263	50	32708	0	33078
20047	32699	52	43	626	0	33420
20048	356	31	56	32646	0	33089
20049	303	20	50	32828	0	33201
20050	32498	22	42	638	0	33200
20051	358	32426	59	395	0	33238
20052	33054	322	64	103	0	33543
20053	427	283	32506	80	0	33296
20054	31922	58	354	85	0	32419
20055	32054	30	328	76	0	32488
20056	634	31	31635	90	0	32390
20057	385	34	31484	144	0	32047
20058	141	67	622	30439	0	31269
20059	30634	26	364	398	0	31422
20060	406	25	30392	352	0	31175
20061	335	31	417	30147	0	30930
20062	134	30	30467	437	0	31068
20063	93	44	449	29429	0	30015
20064	97	34	375	29664	0	30170
20065	29675	40	127	703	0	30545
20066	28954	52	98	461	0	29565
20067	30125	52	93	188	0	30458
20068	702	38	30208	205	0	31153
20069	434	36	29835	176	0	30481
20070	155	272	654	29091	0	30172
20071	145	64	396	29095	0	29700
20072	139	66	171	30361	0	30737
20073	29022	69	127	737	0	29955
20074	430	29077	107	565	0	30179
20075	28862	384	115	228	0	29589
20076	28424	302	127	202	0	29055
20077	708	28407	102	247	0	29464
20078	459	28864	129	200	0	29652
20079	28400	595	157	212	0	29364
20080	471	334	131	28030	0	28966
20081	442	28223	131	545	0	29341
20082	296	389	123	28459	0	29267
20083	283	312	28018	569	0	29182
20084	218	111	471	27929	0	28729
20085	27777	84	471	582	0	28914
20086	514	80	27693	523	0	28810
20087	438	58	27497	331	0	28324
20088	231	262	776	25504	0	26773
20089	201	26762	472	624	0	28059
20090	225	26860	247	524	0	27856
20091	169	27290	226	561	0	28246
20092	26877	573	195	352	0	27997
20093	26579	344	172	340	0	27435
20094	26234	113	157	355	0	26859
20095	731	26327	167	401	0	27626
20096	26700	325	184	328	0	27537
20097	26244	328	178	305	0	27055
20098	839	157	26115	332	0	27443
20099	600	24972	454	294	0	26320
20100	378	459	471	24827	0	26135
20101	24763	341	253	571	0	25928
20102	570	140	24840	539	0	26089
20103	487	97	567	24001	0	25152
20104	295	24258	476	695	0	25724
20105	342	394	326	23786	0	24848
20106	364	319	279	24166	0	25128
20107	24106	134	284	911	0	25435
20108	23991	191	300	612	0	25094
20109	833	164	303	23748	0	25048
20110	528	155	23642	728	0	25053
20111	365	153	23320	610	0	24448
20112	23075	167	633	477	0	24352
20113	669	156	23773	424	0	25022
20114	677	176	486	21077	0	22416
20115	413	22269	479	530	0	23691
20116	21790	335	302	471	0	22898
20117	578	22331	336	302	0	23547
20118	22478	443	290	350	0	23561
20119	667	331	250	21967	0	23215
20120	630	190	244	22257	0	23321
20121	22180	241	245	698	0	23364
20122	22116	173	223	502	0	23014
20123	844	185	241	21848	0	23118
20124	633	206	236	21923	0	22998
20125	421	224	21367	674	0	22686
20126	356	173	21401	475	0	22405
20127	21104	159	679	351	0	22293
20128	543	164	21451	375	0	22533
20129	20682	148	521	333	0	21684
20130	20815	151	598	366	0	21930
20131	778	137	20465	370	0	21750
20132	536	19618	465	246	0	20865
20133	352	19268	419	282	0	20321
20134	267	251	14152	100	0	14770
20135	408	1086	643	11519	0	13656
20136	10400	170	518	358	0	11446
20137	10035	31	28	88	0	10182
20138	11699	33	26	50	0	11808
20139	14260	25	32	60	0	14377
20140	14429	32	35	41	0	14537
20141	315	14648	23	60	0	15046
20142	14609	172	24	39	0	14844
20143	197	14501	48	25	0	14771
20144	13780	186	12	17	0	13995
20145	191	183	13489	11	0	13874
20146	131	12	140	12905	0	13188
20147	26	23	120	12207	0	12376
20148	32	12862	11	237	0	13142
20149	12832	145	16	192	0	13185
20150	13074	113	16	21	0	13224
20151	261	26	4	12842	0	13133
20152	129	21	17	13020	0	13187
20153	12898	14	18	252	0	13182
20154	169	10	12	12868	0	13059
20155	123	15	7	12983	0	13128
20156	12877	6	10	267	0	13160
20157	173	12	6	12977	0	13168
20158	12924	9	10	173	0	13116
20159	12920	12	12	133	0	13077
20160	351	15	12805	25	0	13196
20161	12742	12	150	111	0	13015
20162	12465	11	117	31	0	12624
20163	12634	16	21	23	0	12694
20164	304	10	12334	26	0	12674
20165	158	21	153	12056	0	12388
20166	59	13	117	12275	0	12464
20167	44	52	12022	261	0	12379
20168	11515	31	155	145	0	11846
20169	186	26	115	11589	0	11916
20170	161	22	11482	169	0	11834
20171	69	7	11690	136	0	11902
20172	57	8	258	11632	0	11955
20173	69	11	11905	206	0	12191
20174	58	14	166	11782	0	12020
20175	67	17	125	11781	0	11990
20176	57	20	11745	306	0	12128
20177	70	21	161	11203	0	11455
20178	71	11337	145	177	0	11730
20179	60	11680	38	178	0	11956
20180	11514	269	33	40	0	11856
20181	11453	128	40	46	0	11667
20182	307	11476	27	57	0	11867
20183	11543	173	27	44	0	11787
20184	11492	131	39	49	0	11711
20185	331	35	36	11273	0	11675
20186	180	40	36	11516	0	11772
20187	11130	31	38	306	0	11505
20188	239	11054	29	195	0	11517
20189	196	11058	33	69	0	11356
20190	96	285	32	11022	0	11435
20191	88	141	10777	286	0	11292
20192	10237	38	190	166	0	10631
20193	10371	30	150	79	0	10630
20194	10386	43	31	80	0	10540
20195	361	10425	45	63	0	10894
20196	218	198	39	10075	0	10530
20197	129	135	32	10442	0	10738
20198	10234	44	48	315	0	10641
20199	253	10123	33	193	0	10602
20200	209	198	40	10048	0	10495
20201	132	147	31	9994	0	10304
20202	140	51	33	10035	0	10259
20203	9842	52	47	325	0	10266
20204	291	9777	41	214	0	10323
20205	239	207	34	9510	0	9990
20206	143	9874	43	232	0	10292
20207	9624	212	48	213	0	10097
20208	282	156	9537	118	0	10093
20209	9505	57	246	116	0	9924
20210	290	53	9424	135	0	9902
20211	245	142	191	9035	0	9613
20212	9036	46	149	245	0	9476
20213	272	36	8611	199	0	9118
20214	8686	33	176	108	0	9003
20215	8661	40	150	106	0	8957
20216	8775	38	39	109	0	8961
20217	376	32	53	8068	0	8529
20218	243	28	47	8004	0	8322
20219	160	18	39	8188	0	8405
20220	7869	23	39	350	0	8281
20221	238	8002	52	220	0	8512
20222	8207	161	46	118	0	8532
20223	8278	123	43	110	0	8554
20224	362	40	8024	74	0	8500
20225	8148	39	182	77	0	8446
20226	8240	40	153	84	0	8517
20227	372	28	74	8089	0	8563
20228	206	38	81	8168	0	8493
20229	106	30	66	8358	0	8560
20230	8096	30	87	337	0	8550
20231	8063	36	78	206	0	8383
20232	7718	36	65	111	0	7930
20233	296	7469	65	109	0	7939
20234	170	7178	73	84	0	7505
20235	68	7225	73	91	0	7457
20236	7091	250	59	93	0	7493
20237	210	132	6879	93	0	7314
20238	150	32	5183	75	0	5440
20239	2556	16	100	20	0	2692
20240	47	8	2571	13	0	2639
20241	20	4	18	1842	0	1884
20242	8	1886	9	22	0	1925
20243	1949	20	0	18	0	1987
20244	1941	15	2	9	0	1967
20245	1942	5	2	5	0	1954
20246	35	5	3	2094	0	2137
20247	21	4	2130	19	0	2174
20248	9	5	2111	11	0	2136
20249	2106	1	31	5	0	2143
20250	2110	2	14	8	0	2134
20251	2125	0	6	3	0	2134
20252	36	3	3	2157	0	2199
20253	22	2	1	2178	0	2203
20254	12	2	2210	33	0	2257
20255	2242	5	19	16	0	2282
20256	27	4	9	2340	0	2380
20257	19	4	1	2271	0	2295
20258	10	3	2	2311	0	2326
20259	7	2317	3	33	0	2360
20260	7	22	1	2283	0	2313
20261	9	15	5	2279	0	2308
20262	2299	3	4	33	0	2339
20263	31	3	2258	13	0	2305
20264	2190	3	22	7	0	2222
20265	2263	4	15	7	0	2289
20266	36	5	4	2254	0	2299
20267	19	4	2	2316	0	2341
20268	2328	1	5	37	0	2371
20269	33	4	2302	13	0	2352
20270	21	2260	18	11	0	2310
20271	11	17	11	2208	0	2247
20272	2196	13	2	21	0	2232
20273	21	3	8	2060	0	2092
20274	17	4	2090	19	0	2130
20275	15	2	2314	10	0	2341
20276	2348	1	26	2	0	2377
20277	23	1	12	2587	0	2623
20278	16	1	2517	23	0	2557
20279	2577	2	10	16	0	2605
20280	2914	2	8	6	0	2930
20281	24	1	0	2885	0	2910
20282	14	2	1	2893	0	2910
20283	6	2900	3	24	0	2933
20284	3213	11	5	12	0	3241
20285	19	8	4	3199	0	3230
20286	18	2	3	3282	0	3305
20287	8	3	3329	19	0	3359
20288	3062	4	11	14	0	3091
20289	3287	2	8	11	0	3308
20290	19	3290	1	13	0	3323
20291	14	10	3321	6	0	3351
20292	5	5	3240	4	0	3254
20293	10	3	15	3191	0	3219
20294	3267	0	71	15	0	3353
20295	5	0	4	3255	0	3264
20296	3377	3	0	7	0	3387
20297	3397	0	1	10	0	3408
20298	3430	1	2	10	0	3443
20299	13	0	1	3641	0	3655
20300	7	3	4	3730	0	3744
20301	3839	0	2	17	0	3858
20302	12	0	3978	9	0	3999
20303	3719	2	3	7	0	3731
20304	3745	3	7	9	0	3764
20305	15	3	4018	2	0	4038
20306	6	2	3948	4	0	3960
20307	1	3976	10	10	0	3997
20308	42	5	1	3927	0	3975
20309	3521	10	14	9	0	3554
20310	3	1	3	3997	0	4004
20311	7	2	3990	5	0	4004
20312	1	3927	2	9	0	3939
20313	3	4069	3	4	0	4079
20314	0	5	2	4376	0	4383
20315	2	4	3	4369	0	4378
20316	1	4415	2	10	0	4428
20317	5	2	4400	10	0	4417
20318	4035	3	2	8	0	4048
20319	4406	0	4	7	0	4417
20320	6	4486	2	6	0	4500
20321	4368	7	2	1	0	4378
20322	6	8	1	4281	0	4296
20323	4282	0	3	11	0	4296
20324	6	2	3	4286	0	4297
20325	10	4488	4	13	0	4515
20326	11	5	4646	9	0	4671
20327	4	8	6	4766	0	4784
20328	6	11	13	4793	0	4823
20329	1	2	4	5135	0	5142
20330	5259	4	0	28	0	5291
20331	11	2	0	5303	0	5316
20332	23	1	5647	13	0	5684
20333	6	1	5907	23	0	5937
20334	5950	2	49	5	0	6006
20335	56	2	6269	9	0	6336
20336	6245	2	26	9	0	6282
20337	32	4	38	6925	0	6999
20338	35	1	11	7015	0	7062
20339	5	3	8	7372	0	7388
20340	6	3	4	7665	0	7678
20341	7662	3	4	117	0	7786
20342	63	0	8093	67	0	8223
20343	65	6	68	7889	0	8028
20344	11	8270	65	60	0	8406
20345	8217	67	6	67	0	8357
20346	70	65	5	8097	0	8237
20347	8147	4	2	80	0	8233
20348	83	7	8210	74	0	8374
20349	73	3	73	7889	0	8038
20350	9	8152	70	76	0	8307
20351	8197	69	8	79	0	8353
20352	88	65	8136	22	0	8311
20353	74	12	77	7967	0	8130
20354	12	4	75	8097	0	8188
20355	8007	5	8	146	0	8166
20356	85	9	7970	82	0	8146
20357	89	5	8015	24	0	8133
20358	14	6	139	7965	0	8124
20359	27	2	8078	79	0	8186
20360	16	5	8100	78	0	8199
20361	10	5	147	7892	0	8054
20362	27	23	87	7660	0	7797
20363	15	6	22	8417	0	8460
20364	8282	5	12	157	0	8456
20365	82	8382	16	105	0	8585
20366	8418	73	17	34	0	8542
20367	96	74	18	8278	0	8466
20368	85	8381	22	105	0	8593
20369	29	88	21	8501	0	8639
20370	8774	76	26	103	0	8979
20371	98	9021	15	124	0	9258
20372	97	103	13	9383	0	9596
20373	41	88	9360	141	0	9630
20374	9233	15	113	130	0	9491
20375	135	12	96	9152	0	9395
20376	114	15	29	9281	0	9439
20377	35	15	9045	213	0	9308
20378	42	21	9028	117	0	9208
20379	8649	16	197	50	0	8912
20380	129	8701	118	42	0	8990
20381	123	111	32	8677	0	8943
20382	8659	100	30	141	0	8930
20383	140	28	8686	134	0	8988
20384	118	8457	133	62	0	8770
20385	51	119	129	8361	0	8660
20386	8379	105	37	149	0	8670
20387	8176	22	52	146	0	8396
20388	8509	11	34	66	0	8620
20389	214	8365	37	71	0	8687
20390	121	108	8372	70	0	8671
20391	48	110	142	8339	0	8639
20392	55	27	149	8044	0	8275
20393	36	27	47	8436	0	8546
20394	51	21	48	8532	0	8652
20395	8214	13	51	261	0	8539
20396	8135	28	46	158	0	8367
20397	246	22	8059	85	0	8412
20398	152	27	7978	64	0	8221
20399	7674	30	217	75	0	7996
20400	7703	30	135	58	0	7926
20401	230	28	62	7534	0	7854
20402	146	7516	47	179	0	7888
20403	7494	123	50	162	0	7829
20404	153	7527	37	86	0	7803
20405	132	7408	46	109	0	7695
20406	65	203	47	7525	0	7840
20407	77	115	42	7564	0	7798
20408	65	35	45	7633	0	7778
20409	70	32	50	7704	0	7856
20410	64	33	7405	267	0	7769
20411	7269	25	152	174	0	7620
20412	7461	45	124	70	0	7700
20413	272	34	42	7240	0	7588
20414	171	47	39	7114	0	7371
20415	7016	35	47	249	0	7347
20416	171	37	6795	154	0	7157
20417	6918	41	132	79	0	7170
20418	7002	42	135	66	0	7245
20419	240	31	6859	86	0	7216
20420	7052	36	171	78	0	7337
20421	178	28	120	7061	0	7387
20422	148	25	61	7134	0	7368
20423	76	35	55	7194	0	7360
20424	69	24	49	7260	0	7402
20425	6944	28	60	257	0	7289
20426	154	32	61	6876	0	7123
20427	137	32	48	6530	0	6747
20428	75	6188	45	256	0	6564
20429	73	6285	34	152	0	6544
20430	57	193	40	6108	0	6398
20431	5998	93	36	172	0	6299
20432	149	55	37	5424	0	5665
20433	91	52	4859	141	0	5143
20434	63	20	4652	114	0	4849
20435	4410	39	142	55	0	4646
20436	126	4468	86	56	0	4736
20437	3726	81	30	37	0	3874
20438	102	56	3843	43	0	4044
20439	311	177	107	3212	0	3807
20440	3132	9	89	80	0	3310
20441	82	3155	11	65	0	3313
20442	3136	55	15	34	0	3240
20443	66	26	3417	37	0	3546
20444	57	15	47	3304	0	3423
20445	32	11	52	3425	0	3520
20446	3532	14	16	93	0	3655
20447	3468	13	14	59	0	3554
20448	3575	12	17	28	0	3632
20449	3577	14	3	30	0	3624
20450	3604	14	13	26	0	3657
20451	89	3638	14	21	0	3762
20452	53	42	19	3689	0	3803
20453	3884	31	16	62	0	3993
20454	64	19	14	3878	0	3975
20455	64	10	12	3904	0	3990
20456	30	14	8	3948	0	4000
20457	29	3819	10	91	0	3949
20458	3857	46	12	54	0	3969
20459	50	39	10	3821	0	3920
20460	3801	15	15	57	0	3888
20461	3781	8	13	63	0	3865
20462	81	3722	13	41	0	3857
20463	3718	36	14	26	0	3794
20464	71	25	3686	30	0	3812
20465	3634	7	51	17	0	3709
20466	70	4	70	3656	0	3800
20467	95	7	3751	42	0	3895
20468	26	3842	29	52	0	3949
20469	21	38	3882	29	0	3970
20470	13	3396	19	14	0	3442
20471	3084	135	23	7	0	3249
20472	3025	5	2	3	0	3035
20473	3002	2	1	2	0	3007
20474	8	3164	1	4	0	3177
20475	3200	4	1	4	0	3209
20476	8	2	3275	3	0	3288
20477	5	2	3353	1	0	3361
20478	3	1	40	3251	0	3295
20479	1	0	3	3508	0	3512
20480	0	3554	2	12	0	3568
20481	3626	7	0	4	0	3637
20482	8	3	0	3647	0	3658
20483	2	3702	1	9	0	3714
20484	2	11	2	3790	0	3805
20485	3848	3	21	12	0	3884
20486	3753	3	0	8	0	3764
20487	38	1	3689	4	0	3732
20488	36	1	10	3659	0	3706
20489	7	3	3766	15	0	3791
20490	3	2	13	3785	0	3803
20491	6	2	3875	16	0	3899
20492	1	0	16	3844	0	3861
20493	4	0	3926	18	0	3948
20494	1	1	16	3840	0	3858
20495	5	0	4148	19	0	4172
20496	1	2	17	4126	0	4146
20497	5	2	10	4229	0	4246
20498	0	4495	10	27	0	4532
20499	0	13	3	4657	0	4673
20500	2	9	4615	21	0	4647
20501	1	6	14	4500	0	4521
20502	2	2	12	4628	0	4644
20503	4658	2	5	26	0	4691
20504	14	1	1	4709	0	4725
20505	11	2	3	4639	0	4655
20506	8	0	4637	30	0	4675
20507	4501	2	15	18	0	4536
20508	15	1	10	4810	0	4836
20509	11	1	9	4759	0	4780
20510	4	1	2	4827	0	4834
20511	4798	1	5	29	0	4833
20512	15	0	2	4832	0	4849
20513	11	1	4	4823	0	4839
20514	4832	1	2	27	0	4862
20515	13	4822	3	30	0	4868
20516	14	13	0	4810	0	4837
20517	5	15	4	4813	0	4837
20518	5	3	4773	35	0	4816
20519	3854	9	19	34	0	3916
20520	12	3	11	4639	0	4665
20521	14	1	4585	21	0	4621
20522	4523	2	14	20	0	4559
20523	15	0	17	4739	0	4771
20524	18	4	6	4792	0	4820
20525	10	0	4	4865	0	4879
20526	2	3	1	5090	0	5096
20527	7	2	5533	58	0	5600
20528	5	2	42	5518	0	5567
20529	3	1	23	6728	0	6755
20530	13	1	7854	117	0	7985
20531	7922	2	117	76	0	8117
20532	8297	1	81	23	0	8402
20533	8431	3	25	10	0	8469
20534	231	2	9	8326	0	8568
20535	8453	2	6	138	0	8599
20536	8562	3	5	101	0	8671
20537	223	5	7	8587	0	8822
20538	8413	2	6	140	0	8561
20539	8304	3	7	106	0	8420
20540	8403	2	7	28	0	8440
20541	8532	1	6	18	0	8557
20542	247	6	2	8219	0	8474
20543	116	7909	13	130	0	8168
20544	36	7859	6	119	0	8020
20545	13	8120	6	40	0	8179
20546	7841	227	8	27	0	8103
20547	8152	113	6	14	0	8285
20548	234	27	8129	21	0	8411
20549	8168	8	135	15	0	8326
20550	163	5	106	8300	0	8574
20551	127	5	26	8167	0	8325
20552	39	3	18	8400	0	8460
20553	8110	2	5	268	0	8385
20554	145	3	7	8173	0	8328
20555	124	7969	11	232	0	8336
20556	40	130	6	8245	0	8421
20557	36	137	8135	170	0	8478
20558	37	23	136	8260	0	8456
20559	8231	14	111	170	0	8526
20560	174	9	8283	134	0	8600
20561	151	8	144	8152	0	8455
20562	60	12	114	8067	0	8253
20563	50	15	23	8274	0	8362
20564	37	8292	10	261	0	8600
20565	44	147	5	8444	0	8640
20566	8296	113	6	177	0	8592
20567	8093	31	8	141	0	8273
20568	279	12	7909	62	0	8262
20569	181	13	8001	39	0	8234
20570	66	11	249	7861	0	8187
20571	45	15	141	8094	0	8295
20572	44	16	8187	285	0	8532
20573	39	26	155	7804	0	8024
20574	37	8095	127	174	0	8433
20575	8208	153	34	146	0	8541
20576	8031	133	28	65	0	8257
20577	8107	37	22	47	0	8213
20578	321	14	8009	48	0	8392
20579	190	6	150	7946	0	8292
20580	70	8	7962	193	0	8233
20581	7663	4	167	176	0	8010
20582	174	7750	137	70	0	8131
20583	152	150	24	7694	0	8020
20584	7667	138	25	175	0	8005
20585	171	38	20	7599	0	7828
20586	162	24	19	7798	0	8003
20587	87	13	7665	294	0	8059
20588	7385	11	175	200	0	7771
20589	196	7648	143	79	0	8066
20590	174	137	71	7646	0	8028
20591	7629	122	27	190	0	7968
20592	207	36	21	7731	0	7995
20593	7673	22	20	216	0	7931
20594	210	7580	26	178	0	7994
20595	7594	149	18	86	0	7847
20596	229	127	7436	65	0	7857
20597	7510	35	168	63	0	7776
20598	7306	23	151	57	0	7537
20599	7424	15	68	59	0	7566
20600	360	20	51	7175	0	7606
20601	237	45	32	7138	0	7452
20602	125	52	19	7288	0	7484
20603	83	7111	30	313	0	7537
20604	7148	162	15	205	0	7530
20605	264	134	29	7031	0	7458
20606	225	39	40	7149	0	7453
20607	135	35	38	7205	0	7413
20608	6984	20	46	332	0	7382
20609	237	27	32	7152	0	7448
20610	193	29	6915	258	0	7395
20611	91	6986	155	241	0	7473
20612	60	183	130	7040	0	7413
20613	81	172	40	7122	0	7415
20614	69	78	39	7334	0	7520
20615	75	48	7125	328	0	7576
20616	90	21	7291	225	0	7627
20617	92	24	286	7306	0	7708
20618	84	16	7571	232	0	7903
20619	73	28	189	7584	0	7874
20620	7462	20	147	278	0	7907
20621	7693	29	58	223	0	8003
20622	7883	42	26	125	0	8076
20623	346	44	7516	87	0	7993
20624	7409	42	162	72	0	7685
20625	222	28	141	7418	0	7809
20626	189	11	7172	189	0	7561
20627	98	11	7118	169	0	7396
20628	66	7030	228	97	0	7421
20629	40	5942	112	60	0	6154
20630	4774	82	94	31	0	4981
20631	39	79	48	4345	0	4511
20632	91	15	4297	43	0	4446
20633	18	1	26	4497	0	4542
20634	4568	6	41	46	0	4661
20635	38	5	5088	48	0	5179
20636	4973	3	41	19	0	5036
20637	5034	4	48	18	0	5104
20638	5122	1	17	20	0	5160
20639	82	5066	14	20	0	5182
20640	5254	36	14	20	0	5324
20641	53	44	12	5263	0	5372
20642	54	15	10	5253	0	5332
20643	31	5	8	5341	0	5385
20644	14	6	8	5332	0	5360
20645	5181	2	12	91	0	5286
20646	41	5077	9	76	0	5203
20647	39	4780	15	23	0	4857
20648	15	4922	12	19	0	4968
20649	4916	66	5	11	0	4998
20650	4801	36	8	25	0	4870
20651	4786	13	14	11	0	4824
20652	4822	6	8	17	0	4853
20653	77	7	5	4837	0	4926
20654	38	8	9	4820	0	4875
20655	4826	4	9	74	0	4913
20656	40	4815	9	44	0	4908
20657	4823	36	8	21	0	4888
20658	4884	30	5	13	0	4932
20659	75	7	5	4920	0	5007
20660	48	5121	4	42	0	5215
20661	21	39	8	5207	0	5275
20662	5143	30	2	52	0	5227
20663	54	12	5395	37	0	5498
20664	40	26	37	5217	0	5320
20665	19	5403	28	44	0	5494
20666	5364	36	11	34	0	5445
20667	5154	31	4	21	0	5210
20668	70	13	5529	13	0	5625
20669	32	5499	32	18	0	5581
20670	25	34	5673	5	0	5737
20671	16	28	37	5555	0	5636
20672	10	7	5488	35	0	5540
20673	22	6	5423	28	0	5479
20674	13	5436	45	17	0	5511
20675	5402	30	25	4	0	5461
20676	5505	18	10	11	0	5544
20677	48	5693	8	16	0	5765
20678	28	5738	5	17	0	5788
20679	18	47	5771	16	0	5852
20680	23	28	5695	12	0	5758
20681	19	9	5914	7	0	5949
20682	5	12	51	5838	0	5906
20683	18	8	5975	32	0	6033
20684	13	5	33	5766	0	5817
20685	18	3	29	5706	0	5756
20686	13	6	5928	50	0	5997
20687	14	5867	30	37	0	5948
20688	18	43	24	5787	0	5872
20689	5784	23	12	35	0	5854
20690	36	12	8	5841	0	5897
20691	35	6	5965	40	0	6046
20692	22	5907	32	30	0	5991
20693	16	6054	25	16	0	6111
20694	16	57	15	5994	0	6082
20695	5942	29	13	44	0	6028
20696	5998	18	5	36	0	6057
20697	60	7	9	5946	0	6022
20698	42	6099	7	50	0	6198
20699	22	90	6	6088	0	6206
20700	18	37	7	6234	0	6296
20701	26	20	8	6364	0	6418
20702	6904	11	13	68	0	6996
20703	62	7074	12	40	0	7188
20704	7459	54	14	23	0	7550
20705	7550	51	13	15	0	7629
20706	7449	18	17	18	0	7502
20707	7674	12	12	17	0	7715
20708	125	12	16	7644	0	7797
20709	83	16	7721	66	0	7886
20710	32	7759	59	72	0	7922
20711	8021	63	58	32	0	8174
20712	8001	66	23	23	0	8113
20713	8236	29	16	12	0	8293
20714	159	13	8094	10	0	8276
20715	7850	9	77	11	0	7947
20716	7937	12	68	13	0	8030
20717	144	13	26	8031	0	8214
20718	91	11	7769	80	0	7951
20719	29	7730	76	140	0	7975
20720	16	69	68	7845	0	7998
20721	7747	128	25	73	0	7973
20722	72	24	18	7752	0	7866
20723	73	9	9	7814	0	7905
20724	7939	8	15	143	0	8105
20725	85	17	7926	89	0	8117
20726	7908	11	71	37	0	8027
20727	7667	16	74	20	0	7777
20728	7586	22	31	22	0	7661
20729	7677	12	9	20	0	7718
20730	156	16	7493	18	0	7683
20731	100	5	71	7282	0	7458
20732	38	16	7397	71	0	7522
20733	17	12	79	7122	0	7230
20734	24	11	7146	77	0	7258
20735	6481	6	79	76	0	6642
20736	68	6622	70	42	0	6802
20737	73	6911	29	16	0	7029
20738	37	122	17	7485	0	7661
20739	27	100	11	7507	0	7645
20740	19	8012	17	152	0	8200
20741	8088	97	7	100	0	8292
20742	8355	85	16	33	0	8489
20743	8599	28	15	12	0	8654
20744	9205	15	10	19	0	9249
20745	256	4	16	8984	0	9260
20746	154	12	9	9382	0	9557
20747	9487	11	12	245	0	9755
20748	147	5	14	9568	0	9734
20749	145	6	9360	164	0	9675
20750	54	11	9388	138	0	9591
20751	30	7	242	9476	0	9755
20752	34	8	9669	144	0	9855
20753	9361	5	155	135	0	9656
20754	148	8	135	9517	0	9808
20755	9639	10	41	150	0	9840
20756	182	12	9510	138	0	9842
20757	148	6	133	9436	0	9723
20758	55	12	9557	149	0	9773
20759	28	9402	162	141	0	9733
20760	9074	139	166	50	0	9429
20761	9260	122	32	23	0	9437
20762	261	9184	18	49	0	9512
20763	9180	139	14	26	0	9359
20764	183	125	15	8808	0	9131
20765	164	31	13	8976	0	9184
20766	8866	15	16	253	0	9150
20767	165	8760	24	171	0	9120
20768	161	8882	16	54	0	9113
20769	65	249	34	8730	0	9078
20770	8495	143	16	164	0	8818
20771	8433	30	36	138	0	8637
20772	8497	17	17	57	0	8588
20773	315	12	8305	42	0	8674
20774	183	12	8282	50	0	8527
20775	71	8237	258	63	0	8629
20776	8096	148	164	40	0	8448
20777	194	133	55	7983	0	8365
20778	8031	32	40	163	0	8266
20779	7924	17	37	148	0	8126
20780	302	23	45	7855	0	8225
20781	213	21	7858	163	0	8255
20782	7828	17	154	167	0	8166
20783	201	17	145	7868	0	8231
20784	195	17	7838	187	0	8237
20785	7752	29	171	166	0	8118
20786	7906	35	133	77	0	8151
20787	319	27	58	7823	0	8227
20788	192	29	7826	196	0	8243
20789	88	25	164	7637	0	7914
20790	84	7821	139	213	0	8257
20791	108	154	7775	167	0	8204
20792	87	7866	171	71	0	8195
20793	7667	169	146	58	0	8040
20794	7662	129	62	56	0	7909
20795	7814	47	50	58	0	7969
20796	7865	36	47	57	0	8005
20797	327	24	44	7524	0	7919
20798	7597	26	41	194	0	7858
20799	216	38	48	7502	0	7804
20800	7287	24	54	189	0	7554
20801	198	6999	48	173	0	7418
20802	149	185	86	6293	0	6713
20803	80	6391	42	148	0	6661
20804	6140	124	31	131	0	6426
20805	5989	108	49	52	0	6198
20806	260	5967	29	56	0	6312
20807	149	114	36	5921	0	6220
20808	72	99	5800	164	0	6135
20809	82	39	124	5709	0	5954
20810	65	30	5759	152	0	6006
20811	73	30	119	5084	0	5306
20812	70	5310	109	110	0	5599
20813	5200	106	34	101	0	5441
20814	5204	89	40	41	0	5374
20815	216	36	32	5144	0	5428
20816	5335	26	22	134	0	5517
20817	174	19	44	5313	0	5550
20818	147	30	29	5445	0	5651
20819	89	30	31	5524	0	5674
20820	5432	23	28	209	0	5692
20821	5322	34	26	115	0	5497
20822	5371	20	26	51	0	5468
20823	224	5359	20	52	0	5655
20824	5437	111	34	35	0	5617
20825	167	5284	28	42	0	5521
20826	5359	118	25	46	0	5548
20827	163	90	37	5153	0	5443
20828	130	36	29	5324	0	5519
20829	5272	32	23	178	0	5505
20830	5239	38	17	121	0	5415
20831	212	5218	29	51	0	5510
20832	5300	114	27	38	0	5479
20833	161	89	15	5184	0	5449
20834	126	34	33	5227	0	5420
20835	5182	29	30	191	0	5432
20836	152	30	5085	114	0	5381
20837	115	4778	107	48	0	5048
20838	53	113	60	3923	0	4149
20839	55	58	3682	73	0	3868
20840	38	112	55	3421	0	3626
20841	3394	16	52	78	0	3540
20842	73	2873	14	50	0	3010
20843	50	2628	52	29	0	2759
20844	13	2298	9	10	0	2330
20845	189	32	36	1965	0	2222
20846	2009	9	11	24	0	2053
20847	17	1	0	1927	0	1945
20848	1912	2	2	20	0	1936
20849	1913	2	1	6	0	1922
20850	21	1	1	1925	0	1948
20851	1948	4	3	14	0	1969
20852	14	2	0	2089	0	2105
20853	9	2	2262	15	0	2288
20854	2254	0	15	5	0	2274
20855	16	3	2512	1	0	2532
20856	2436	2	16	6	0	2460
20857	108	1	2474	4	0	2587
20858	5	0	12	2461	0	2478
20859	1	2	3	2501	0	2507
20860	2528	2	2	17	0	2549
20861	15	4	0	2725	0	2744
20862	2789	3	4	13	0	2809
20863	17	2779	0	9	0	2805
20864	2814	15	1	3	0	2833
20865	20	3	2	2933	0	2958
20866	7	3	1	2952	0	2963
20867	5	2	1	2942	0	2950
20868	0	1	3	2963	0	2967
20869	8	0	2926	20	0	2954
20870	3	1	2900	6	0	2910
20871	5	1	19	3031	0	3056
20872	5	2	3183	23	0	3213
20873	5	3171	18	9	0	3203
20874	3	15	3	3108	0	3129
20875	4	4	3346	22	0	3376
20876	8	3	3297	8	0	3316
20877	4	0	31	3450	0	3485
20878	6	2	7	3509	0	3524
20879	0	3539	2	39	0	3580
20880	1	26	1	3561	0	3589
20881	5	12	3638	32	0	3687
20882	3483	1	32	10	0	3526
20883	30	1	15	3647	0	3693
20884	3829	2	1	37	0	3869
20885	3703	1	8	16	0	3728
20886	3770	5	3	8	0	3786
20887	45	4	3815	6	0	3870
20888	17	1	3804	3	0	3825
20889	3564	2	46	4	0	3616
20890	31	0	3839	9	0	3879
20891	19	2	29	3668	0	3718
20892	3	5	13	3719	0	3740
20893	6	1	3766	45	0	3818
20894	3	3742	33	17	0	3795
20895	3674	31	13	9	0	3727
20896	32	3672	3	7	0	3714
20897	20	3779	2	7	0	3808
20898	3749	41	7	9	0	3806
20899	33	15	3813	4	0	3865
20900	19	2	3807	8	0	3836
20901	4	1	49	3748	0	3802
20902	3775	3	18	35	0	3831
20903	33	3867	8	35	0	3943
20904	3900	33	7	11	0	3951
20905	42	17	4118	11	0	4188
20906	17	4414	39	19	0	4489
20907	7	47	18	4459	0	4531
20908	15	27	4539	51	0	4632
20909	9	7	48	4515	0	4579
20910	14	8	39	4331	0	4392
20911	14	8	13	4540	0	4575
20912	18	3	12	4667	0	4700
20913	4586	1	13	82	0	4682
20914	4513	3	18	37	0	4571
20915	84	4	4768	10	0	4866
20916	4639	5	56	11	0	4711
20917	56	4560	42	10	0	4668
20918	4488	45	16	8	0	4557
20919	55	32	4590	14	0	4691
20920	32	7	54	4537	0	4630
20921	8	8	4770	55	0	4841
20922	20	9	4708	40	0	4777
20923	12	70	88	4444	0	4614
20924	14	13	37	4505	0	4569
20925	18	8	4599	87	0	4712
20926	17	4559	57	42	0	4675
20927	13	4660	50	11	0	4734
20928	18	88	20	4619	0	4745
20929	4530	48	18	60	0	4656
20930	54	4640	15	58	0	4767
20931	51	55	4665	24	0	4795
20932	19	44	4640	23	0	4726
20933	15	14	4650	28	0	4707
20934	19	8	93	4453	0	4573
20935	4542	8	51	75	0	4676
20936	66	4636	15	63	0	4780
20937	64	52	4654	32	0	4802
20938	21	4708	66	32	0	4827
20939	27	58	52	4704	0	4841
20940	28	47	4749	63	0	4887
20941	23	4689	62	65	0	4839
20942	23	54	57	4597	0	4731
20943	22	50	21	4747	0	4840
20944	28	9	4760	96	0	4893
20945	15	15	76	4551	0	4657
20946	22	4653	54	70	0	4799
20947	14	58	4691	62	0	4825
20948	4512	49	70	21	0	4652
20949	57	23	58	4629	0	4767
20950	49	17	21	4606	0	4693
20951	10	4682	29	105	0	4826
20952	4555	61	20	56	0	4692
20953	65	57	4403	22	0	4547
20954	4354	20	77	17	0	4468
20955	57	13	64	4343	0	4477
20956	49	4414	20	91	0	4574
20957	23	60	25	4384	0	4492
20958	14	62	31	4416	0	4523
20959	4408	19	26	103	0	4556
20960	4390	19	29	64	0	4502
20961	92	18	27	4298	0	4435
20962	51	18	4193	74	0	4336
20963	3996	20	74	54	0	4144
20964	48	4231	61	31	0	4371
20965	49	58	28	4082	0	4217
20966	11	65	22	4310	0	4408
20967	8	21	29	4382	0	4440
20968	11	21	4329	125	0	4486
20969	14	21	69	4243	0	4347
20970	16	4336	76	74	0	4502
20971	15	63	25	4170	0	4273
20972	10	4163	27	79	0	4279
20973	16	87	21	4123	0	4247
20974	27	70	4061	62	0	4220
20975	3585	15	67	70	0	3737
20976	54	15	65	3922	0	4056
20977	56	16	3750	57	0	3879
20978	13	3746	53	71	0	3883
20979	3733	49	56	29	0	3867
20980	59	47	3758	30	0	3894
20981	3550	11	45	25	0	3631
20982	54	12	53	3673	0	3792
20983	58	16	17	3554	0	3645
20984	17	3575	19	90	0	3701
20985	3551	41	20	44	0	3656
20986	3469	60	12	17	0	3558
20987	74	3597	17	21	0	3709
20988	58	41	22	3606	0	3727
20989	16	45	21	3623	0	3705
20990	9	14	20	3649	0	3692
20991	15	11	3580	99	0	3705
20992	3404	15	49	65	0	3533
20993	43	19	57	3518	0	3637
20994	46	19	20	3626	0	3711
20995	18	24	3593	90	0	3725
20996	17	22	3601	59	0	3699
20997	12	18	90	3616	0	3736
20998	18	12	3706	63	0	3799
20999	3303	13	52	64	0	3432
21000	42	9	66	3392	0	3509
21001	56	14	19	3471	0	3560
21002	21	14	3720	85	0	3840
21003	12	70	70	3672	0	3824
21004	24	15	3821	52	0	3912
21005	8	3709	47	62	0	3826
21006	3334	33	39	19	0	3425
21007	3227	39	91	33	0	3390
21008	59	3310	6	28	0	3403
21009	34	34	8	3354	0	3430
21010	11	34	3371	38	0	3454
21011	11	10	28	3279	0	3328
21012	3252	6	36	35	0	3329
21013	31	3312	11	39	0	3393
21014	3304	24	4	14	0	3346
21015	31	32	1	3252	0	3316
21016	3262	8	5	33	0	3308
21017	34	3320	2	42	0	3398
21018	3351	28	2	18	0	3399
21019	32	28	3279	13	0	3352
21020	36	3330	28	8	0	3402
21021	7	24	21	3186	0	3238
21022	3264	25	7	34	0	3330
21023	3382	12	2	34	0	3430
21024	53	6	3	3387	0	3449
21025	3361	1	4	36	0	3402
21026	3312	3	6	30	0	3351
21027	3506	2	4	22	0	3534
21028	46	1	8	3471	0	3526
21029	30	5	3486	30	0	3551
21030	18	9	3411	24	0	3462
21031	8	3	3451	12	0	3474
21032	3503	7	45	13	0	3568
21033	30	4	28	3591	0	3653
21034	22	3716	9	34	0	3781
21035	10	27	6	3655	0	3698
21036	8	3656	5	34	0	3703
21037	3655	32	6	26	0	3719
21038	30	26	5	3694	0	3755
21039	28	9	6	3766	0	3809
21040	3783	6	7	58	0	3854
21041	35	5	10	3848	0	3898
21042	31	1	4	3946	0	3982
21043	4006	2	9	66	0	4083
21044	45	7	3998	36	0	4086
21045	32	4	38	3966	0	4040
21046	16	5	4028	49	0	4098
21047	3892	3	46	31	0	3972
21048	43	6	31	4044	0	4124
21049	4035	2	10	46	0	4093
21050	53	3	9	4099	0	4164
21051	36	2	4075	56	0	4169
21052	9	5	42	4243	0	4299
21053	4256	3	31	48	0	4338
21054	42	4390	14	47	0	4493
21055	32	40	4297	18	0	4387
21056	4022	25	37	14	0	4098
21057	48	4263	26	9	0	4346
21058	35	4295	9	6	0	4345
21059	8	4553	3	17	0	4581
21060	8	69	3	4981	0	5061
21061	5045	32	15	49	0	5141
21062	5152	11	5	45	0	5213
21063	94	3	5096	13	0	5206
21064	5082	6	51	10	0	5149
21065	58	5072	39	14	0	5183
21066	39	40	6	5009	0	5094
21067	5277	29	2	49	0	5357
21068	5245	9	8	35	0	5297
21069	5276	7	3	12	0	5298
21070	5254	3	8	14	0	5279
21071	5349	7	4	7	0	5367
21072	80	26	11	5303	0	5420
21073	42	5	5368	52	0	5467
21074	18	3	48	5410	0	5479
21075	10	10	30	5451	0	5501
21076	5435	6	5	90	0	5536
21077	63	5357	9	34	0	5463
21078	5502	52	3	12	0	5569
21079	5402	33	3	14	0	5452
21080	5809	12	10	10	0	5841
21081	6133	5	10	14	0	6162
21082	100	6	6023	14	0	6143
21083	6005	11	55	11	0	6082
21084	6329	5	35	19	0	6388
21085	6214	14	13	19	0	6260
21086	6435	2	8	18	0	6463
21087	109	12	6	6299	0	6426
21088	77	5	6225	57	0	6364
21089	6143	6	60	51	0	6260
21090	66	6303	45	27	0	6441
21091	58	53	22	6356	0	6489
21092	29	6493	10	71	0	6603
21093	34	57	8	6626	0	6725
21094	6585	41	8	75	0	6709
21095	6577	17	13	63	0	6670
21096	6625	16	12	29	0	6682
21097	118	10	6483	18	0	6629
21098	6381	10	55	29	0	6475
21099	85	7	6420	18	0	6530
21100	76	12	6362	20	0	6470
21101	45	19	6607	28	0	6699
21102	48	46	96	6062	0	6252
21103	33	20	49	6198	0	6300
21104	38	18	20	6178	0	6254
21105	38	19	13	6328	0	6398
21106	47	22	14	6289	0	6372
21107	41	18	16	6340	0	6415
21108	44	6364	18	99	0	6525
21109	6335	58	13	52	0	6458
21110	79	6601	21	32	0	6733
21111	71	65	14	6631	0	6781
21112	44	54	13	6645	0	6756
21113	6626	13	16	99	0	6754
21114	100	6611	20	57	0	6788
21115	6732	47	11	32	0	6822
21116	95	41	23	6616	0	6775
21117	88	18	18	6689	0	6813
21118	60	23	17	6781	0	6881
21119	52	11	6626	107	0	6796
21120	65	12	57	6556	0	6690
21121	60	25	6516	82	0	6683
21122	71	15	6306	70	0	6462
21123	74	18	6704	43	0	6839
21124	83	16	84	6550	0	6733
21125	84	17	56	6759	0	6916
21126	65	10	36	6931	0	7042
21127	7069	17	16	104	0	7206
21128	98	26	27	7416	0	7567
21129	7638	16	34	96	0	7784
21130	129	7660	11	81	0	7881
21131	8300	72	13	52	0	8437
21132	8783	49	16	41	0	8889
21133	183	8953	24	33	0	9193
21134	9032	64	18	40	0	9154
21135	8819	67	25	52	0	8963
21136	8905	24	38	40	0	9007
21137	9092	17	19	61	0	9189
21138	169	13	9060	59	0	9301
21139	133	9001	68	56	0	9258
21140	65	72	65	8964	0	9166
21141	8968	57	30	79	0	9134
21142	111	29	8949	83	0	9172
21143	107	8826	64	55	0	9052
21144	79	73	68	8549	0	8769
21145	49	8899	34	77	0	9059
21146	76	72	24	8756	0	8928
21147	53	65	29	8826	0	8973
21148	65	24	8840	118	0	9047
21149	77	11	8650	87	0	8825
21150	8272	17	120	50	0	8459
21151	110	12	8895	32	0	9049
21152	99	15	8813	37	0	8964
21153	46	30	113	8561	0	8750
21154	57	18	70	8549	0	8694
21155	41	8742	35	118	0	8936
21156	45	9280	24	115	0	9464
21157	52	109	9707	38	0	9906
21158	48	110	77	9984	0	10219
21159	60	20	10017	101	0	10198
21160	36	10	9265	73	0	9384
21161	20	9246	115	40	0	9421
21162	16	71	77	9051	0	9215
21163	9105	58	22	71	0	9256
21164	74	30	14	9278	0	9396
21165	9420	13	15	80	0	9528
21166	9174	12	12	77	0	9275
21167	9168	14	19	22	0	9223
21168	143	13	9178	16	0	9350
21169	9018	12	69	16	0	9115
21170	83	11	67	9243	0	9404
21171	9088	8	26	71	0	9193
21172	9166	13	14	81	0	9274
21173	127	9137	14	38	0	9316
21174	9199	65	15	14	0	9293
21175	91	63	9316	17	0	9487
21176	8999	20	71	16	0	9106
21177	9158	12	70	18	0	9258
21178	124	9128	21	30	0	9303
21179	9222	66	13	18	0	9319
21180	79	69	14	8615	0	8777
21181	69	23	16	8579	0	8687
21182	33	8621	19	121	0	8794
21183	19	103	22	8726	0	8870
21184	22	64	19	8820	0	8925
21185	31	24	8685	124	0	8864
21186	22	22	8537	83	0	8664
21187	8133	12	125	35	0	8305
21188	8587	13	75	24	0	8699
21189	138	6	30	8697	0	8871
21190	102	12	8643	68	0	8825
21191	37	8505	77	88	0	8707
21192	29	68	75	8470	0	8642
21193	23	71	8592	87	0	8773
21194	8280	22	75	80	0	8457
21195	83	19	76	8774	0	8952
21196	88	8967	32	77	0	9164
21197	44	83	19	8945	0	9091
21198	38	97	31	8949	0	9115
21199	37	29	22	9121	0	9209
21200	9059	17	31	162	0	9269
21201	102	15	29	9018	0	9164
21202	8950	24	27	106	0	9107
21203	8894	22	30	101	0	9047
21204	181	20	8996	34	0	9231
21205	118	8925	79	58	0	9180
21206	73	80	87	8229	0	8469
21207	29	9181	43	95	0	9348
21208	9242	107	28	84	0	9461
21209	116	94	27	9212	0	9449
21210	123	25	9163	108	0	9419
21211	62	17	9120	108	0	9307
21212	51	16	9230	43	0	9340
21213	8881	26	186	43	0	9136
21214	118	9140	109	43	0	9410
21215	9023	104	43	37	0	9207
21216	135	9104	31	47	0	9317
21217	113	148	30	8878	0	9169
21218	63	90	43	8769	0	8965
21219	120	9414	28	185	0	9747
21220	78	106	9435	126	0	9745
21221	48	9551	107	78	0	9784
21222	9316	106	101	52	0	9575
21223	127	94	31	9075	0	9327
21224	131	35	9025	134	0	9325
21225	65	37	9022	107	0	9231
21226	67	29	202	8806	0	9104
21227	60	14	8734	142	0	8950
21228	65	24	8003	107	0	8199
21229	7537	18	162	39	0	7756
21230	99	7638	95	32	0	7864
21231	7195	82	31	30	0	7338
21232	111	74	6910	41	0	7136
21233	97	6720	86	38	0	6941
21234	46	6827	81	39	0	6993
21235	238	134	30	6536	0	6938
21236	39	80	32	6527	0	6678
21237	45	35	24	6812	0	6916
21238	36	19	6675	150	0	6880
21239	46	32	73	6554	0	6705
21240	48	23	72	6636	0	6779
21241	6660	21	32	148	0	6861
21242	99	6643	18	111	0	6871
21243	97	89	34	6655	0	6875
21244	6630	83	32	104	0	6849
21245	6504	33	42	94	0	6673
21246	165	26	31	6538	0	6760
21247	105	23	6606	106	0	6840
21248	39	33	107	6623	0	6802
21249	39	27	6593	118	0	6777
21250	6507	27	102	106	0	6742
21251	6838	26	101	54	0	7019
21252	157	23	47	6989	0	7216
21253	102	26	7240	117	0	7485
21254	39	7645	109	109	0	7902
21255	47	127	7737	29	0	7940
21256	42	132	110	6249	0	6533
21257	16	6862	85	92	0	7055
21258	6307	90	27	61	0	6485
21259	90	63	16	6115	0	6284
21260	52	6224	26	150	0	6452
21261	6454	84	23	67	0	6628
21262	87	62	26	6347	0	6522
21263	68	6577	18	100	0	6763
21264	25	90	23	6659	0	6797
21265	24	61	6496	106	0	6687
21266	6256	25	95	76	0	6452
21267	6389	24	74	39	0	6526
21268	151	9	6387	28	0	6575
21269	79	6379	85	25	0	6568
21270	6374	93	81	26	0	6574
21271	89	79	32	6190	0	6390
21272	70	29	33	6139	0	6271
21273	29	17	20	6182	0	6248
21274	26	64	26	6198	0	6314
21275	27	18	29	6162	0	6236
21276	6002	17	25	174	0	6218
21277	6104	15	27	92	0	6238
21278	143	24	30	6058	0	6255
21279	88	18	26	6199	0	6331
21280	39	28	6091	159	0	6317
21281	31	25	6061	98	0	6215
21282	5958	27	145	40	0	6170
21283	99	26	83	5917	0	6125
21284	83	20	5965	115	0	6183
21285	39	21	87	5938	0	6085
21286	5904	20	79	109	0	6112
21287	5949	18	36	99	0	6102
21288	150	29	31	5858	0	6068
21289	103	13	28	5915	0	6059
21290	5991	17	24	166	0	6198
21291	113	17	36	5963	0	6129
21292	79	6178	31	115	0	6403
21293	37	92	32	5991	0	6152
21294	29	76	24	5930	0	6059
21295	38	17	5734	145	0	5934
21296	35	22	5642	76	0	5775
21297	31	5858	113	53	0	6055
21298	5638	84	110	37	0	5869
21299	5471	71	31	39	0	5612
21300	5588	24	14	41	0	5667
21301	150	5479	24	30	0	5683
21302	82	5568	17	33	0	5700
21303	5428	132	18	31	0	5609
21304	86	5601	17	41	0	5745
21305	81	89	5359	150	0	5679
21306	43	5542	79	38	0	5702
21307	34	72	5302	31	0	5439
21308	4994	68	87	36	0	5185
21309	5123	29	71	23	0	5246
21310	135	5074	26	58	0	5293
21311	5256	74	29	27	0	5386
21312	5830	66	19	33	0	5948
21313	5890	25	17	35	0	5967
21314	180	17	22	5782	0	6001
21315	5919	15	20	105	0	6059
21316	130	21	5738	107	0	5996
21317	5689	28	93	44	0	5854
21318	125	13	79	5687	0	5904
21319	105	22	5311	115	0	5553
21320	63	19	5360	96	0	5538
21321	38	18	157	5237	0	5450
21322	42	23	98	5318	0	5481
21323	5304	21	41	176	0	5542
21324	114	22	22	5320	0	5478
21325	102	26	5242	125	0	5495
21326	51	20	93	5159	0	5323
21327	25	5267	91	124	0	5507
21328	5231	83	30	99	0	5443
21329	115	81	14	5222	0	5432
21330	107	33	5182	105	0	5427
21331	41	5140	87	122	0	5390
21332	4932	85	92	43	0	5152
21333	117	110	29	4789	0	5045
21334	112	26	4759	103	0	5000
21335	42	4754	89	99	0	4984
21336	4682	77	82	36	0	4877
21337	4588	76	31	32	0	4727
21338	4712	25	27	24	0	4788
21339	187	13	15	4553	0	4768
21340	107	8	18	4667	0	4800
21341	4515	12	24	159	0	4710
21342	100	4496	18	101	0	4715
21343	4599	77	14	45	0	4735
21344	121	70	18	4509	0	4718
21345	4572	20	15	103	0	4710
21346	103	15	19	4501	0	4638
21347	87	13	26	4444	0	4570
21348	55	19	18	4498	0	4590
21349	39	26	22	4570	0	4657
21350	36	12	4098	162	0	4308
21351	27	7	3878	102	0	4014
21352	3246	9	107	29	0	3391
21353	60	12	3104	20	0	3196
21354	49	4	2370	17	0	2440
21355	2248	7	80	8	0	2343
21356	2315	10	57	8	0	2390
21357	77	6	14	2317	0	2414
21358	2386	6	9	38	0	2439
21359	51	2423	12	45	0	2531
21360	2467	34	7	20	0	2528
21361	2437	42	10	18	0	2507
21362	2448	21	8	16	0	2493
21363	96	17	6	2337	0	2456
21364	70	2327	8	39	0	2444
21365	25	2378	8	59	0	2470
21366	2355	65	14	21	0	2455
21367	2413	62	9	12	0	2496
21368	83	13	14	2345	0	2455
21369	58	4	8	2331	0	2401
21370	22	2334	17	81	0	2454
21371	2325	40	9	58	0	2432
21372	55	40	2281	33	0	2409
21373	63	10	38	2308	0	2419
21374	28	8	39	2294	0	2369
21375	15	6	2274	84	0	2379
21376	17	6	37	2251	0	2311
21377	20	2121	43	55	0	2239
21378	20	38	17	2209	0	2284
21379	24	42	12	2099	0	2177
21380	25	2087	11	78	0	2201
21381	22	2138	8	61	0	2229
21382	25	59	9	2126	0	2219
21383	2143	41	16	47	0	2247
21384	47	11	5	2109	0	2172
21385	50	10	10	2129	0	2199
21386	27	2154	24	61	0	2266
21387	24	31	14	2218	0	2287
21388	28	38	5	2204	0	2275
21389	20	11	10	2246	0	2287
21390	2076	10	8	87	0	2181
21391	56	7	4	2098	0	2165
21392	52	8	11	1945	0	2016
21393	30	9	3	1981	0	2023
21394	21	17	1881	80	0	1999
21395	1765	10	30	63	0	1868
21396	45	1826	40	39	0	1950
21397	1718	22	18	16	0	1774
21398	41	32	5	1708	0	1786
21399	36	11	1716	34	0	1797
21400	1657	13	26	39	0	1735
21401	39	8	2163	14	0	2224
21402	36	14	37	2140	0	2227
21403	2233	2	31	31	0	2297
21404	2142	3	16	40	0	2201
21405	2248	7	7	21	0	2283
21406	62	10	1	2245	0	2318
21407	47	8	4	2251	0	2310
21408	26	8	6	2243	0	2283
21409	14	2201	2	71	0	2288
21410	14	2099	2	41	0	2156
21411	9	1924	10	22	0	1965
21412	0	1451	1	1	0	1453
21413	0	5	0	1475	0	1480
21414	0	3	0	1483	0	1486
21415	1499	0	0	8	0	1507
21416	1444	1	0	7	0	1452
21417	1505	0	1	0	0	1506
21418	5	0	0	1523	0	1528
21419	2	0	1	1521	0	1524
21420	1528	0	0	8	0	1536
21421	1450	0	3	3	0	1456
21422	6	0	1586	0	0	1592
21423	3	0	1611	2	0	1616
21424	2	2	1656	0	0	1660
21425	4	0	1686	2	0	1692
21426	0	0	4	1677	0	1681
21427	1667	1	2	4	0	1674
21428	2	1664	0	5	0	1671
21429	2	2	0	1741	0	1745
21430	1	3	1816	2	0	1822
21431	0	1996	5	11	0	2012
21432	0	2	3	2029	0	2034
21433	4	2	2085	3	0	2094
21434	4	0	4	2040	0	2048
21435	2	0	2	2141	0	2145
21436	2202	0	1	7	0	2210
21437	4	2	1	2188	0	2195
21438	6	1	2207	3	0	2217
21439	2	0	2	2180	0	2184
21440	0	2388	4	4	0	2396
21441	2	2	1	2538	0	2543
21442	1	3	1	2659	0	2664
21443	0	1	3	2670	0	2674
21444	2672	2	0	5	0	2679
21445	2810	0	0	4	0	2814
21446	2867	1	0	6	0	2874
21447	2859	0	1	5	0	2865
21448	7	0	2902	4	0	2913
21449	2773	1	2	4	0	2780
21450	2844	0	3	7	0	2854
21451	6	2	2887	4	0	2899
21452	3	2	3335	7	0	3347
21453	2	0	3	3329	0	3334
21454	1	3419	3	7	0	3430
21455	3578	1	1	10	0	3590
21456	3664	2	3	13	0	3682
21457	3870	2	1	4	0	3877
21458	8	1	1	3965	0	3975
21459	3	4301	3	7	0	4314
21460	4582	5	0	8	0	4595
21461	4654	4	1	6	0	4665
21462	8	0	0	4686	0	4694
21463	8	0	4663	5	0	4676
21464	4625	1	7	9	0	4642
21465	6	0	2	4890	0	4898
21466	5025	0	3	16	0	5044
21467	8	1	1	5257	0	5267
21468	7	0	5302	11	0	5320
21469	5723	0	7	8	0	5738
21470	6	1	3	5845	0	5855
21471	2	2	2	5921	0	5927
21472	0	3	1	6001	0	6005
21473	2	3	0	6027	0	6032
21474	6179	2	0	15	0	6196
21475	7	1	2	6195	0	6205
21476	3	6346	0	36	0	6385
21477	1	8	2	6530	0	6541
21478	4	6738	5	13	0	6760
21479	1	8	0	6881	0	6890
21480	3	9	1	6940	0	6953
21481	0	7018	3	26	0	7047
21482	3	10	0	7080	0	7093
21483	3	14	0	7038	0	7055
21484	7123	0	3	27	0	7153
21485	13	0	7499	14	0	7526
21486	12	0	9	7584	0	7605
21487	7651	1	9	15	0	7676
21488	7395	3	1	24	0	7423
21489	7592	0	1	15	0	7608
21490	32	0	7916	19	0	7967
21491	23	3	8178	4	0	8208
21492	6	4	29	8373	0	8412
21493	8609	1	12	31	0	8653
21494	26	3	8555	15	0	8599
21495	8267	1	21	12	0	8301
21496	20	8860	13	9	0	8902
21497	13	18	1	9368	0	9400
21498	3	18	1	9716	0	9738
21499	9968	1	1	37	0	10007
21500	18	1	2	10312	0	10333
21501	10428	2	1	26	0	10457
21502	10779	0	3	21	0	10803
21503	35	4	2	10728	0	10769
21504	15	1	2	10952	0	10970
21505	11254	1	6	39	0	11300
21506	32	5	13278	17	0	13332
21507	13387	0	25	15	0	13427
21508	62	3	14649	3	0	14717
21509	15278	4	25	10	0	15317
21510	17028	4	16	17	0	17065
21511	16898	7	7	17	0	16929
21512	16930	3	3	20	0	16956
21513	35	17343	10	19	0	17407
21514	17727	20	1	22	0	17770
21515	17655	16	7	26	0	17704
21516	40	19422	9	34	0	19505
21517	19680	21	5	25	0	19731
21518	41	14	19741	12	0	19808
21519	19257	5	23	19	0	19304
21520	59	28	20333	16	0	20436
21521	23	3	33	19945	0	20004
21522	10	2	20	20219	0	20251
21523	24	4	20958	50	0	21036
21524	13	4	29	20290	0	20336
21525	34	28	40	20161	0	20263
21526	21868	6	10	78	0	21962
21527	43	4	5	22060	0	22112
21528	37	7	9	22002	0	22055
21529	18	3	9	22381	0	22411
21530	7	22170	11	93	0	22281
21531	13	36	5	22601	0	22655
21532	22935	34	7	78	0	23054
21533	72	7	23446	192	0	23717
21534	51	6	50	23599	0	23706
21535	26	8	23816	63	0	23913
21536	22771	9	54	89	0	22923
21537	63	3	49	24623	0	24738
21538	78	9	30678	128	0	30893
21539	29	7	194	30796	0	31026
21540	21	13	224	30823	0	31081
21541	23	31814	59	441	0	32337
21542	20	192	32	32405	0	32649
21543	21	240	9	33784	0	34054
21544	42	57	34145	504	0	34748
21545	24	33	241	33596	0	33894
21546	23	21	263	34363	0	34670
21547	34136	16	68	537	0	34757
21548	33586	17	56	364	0	34023
21549	496	34215	21	148	0	34880
21550	34652	234	26	90	0	35002
21551	34323	271	31	65	0	34690
21552	525	35332	16	63	0	35936
21553	339	262	18	35434	0	36053
21554	35334	279	21	281	0	35915
21555	34674	79	34	311	0	35098
21556	35427	42	26	131	0	35626
21557	576	35299	34	101	0	36010
21558	406	241	36124	69	0	36840
21559	35887	296	270	86	0	36539
21560	36752	91	280	103	0	37226
21561	587	37906	73	101	0	38667
21562	38009	321	44	96	0	38470
21563	37988	332	50	93	0	38463
21564	656	88	32	38172	0	38948
21565	481	50	39186	378	0	40095
21566	176	34	316	39771	0	40297
21567	119	64	347	38923	0	39453
21568	85	66	94	40218	0	40463
21569	120	36	39239	774	0	40169
21570	108	61	344	38607	0	39120
21571	85	58	357	39074	0	39574
21572	98	50	104	39422	0	39674
21573	102	58	63	39581	0	39804
21574	106	31	44	39705	0	39886
21575	114	39447	49	982	0	40592
21576	121	344	57	39972	0	40494
21577	95	354	46	41000	0	41495
21578	124	110	40474	784	0	41492
21579	114	75	360	43992	0	44541
21580	108	79	406	44195	0	44788
21581	118	78	112	46280	0	46588
21582	121	63	69	47596	0	47849
21583	47275	57	66	1276	0	48674
21584	627	79	82	47173	0	47961
21585	630	97	58	47812	0	48597
21586	288	88	46784	1232	0	48392
21587	197	45577	516	972	0	47262
21588	148	47394	593	418	0	48553
21589	46754	1004	217	303	0	48278
21590	585	47668	145	355	0	48753
21591	644	662	92	47034	0	48432
21592	46643	614	87	805	0	48149
21593	664	213	46813	938	0	48628
21594	668	136	564	46301	0	47669
21595	249	47301	622	912	0	49084
21596	151	609	211	47107	0	48078
21597	107	47605	128	972	0	48812
21598	130	711	107	47497	0	48445
21599	46521	669	76	993	0	48259
21600	674	233	47580	993	0	49480
21601	717	191	613	45503	0	47024
21602	253	47224	658	935	0	49070
21603	47054	657	236	904	0	48851
21604	759	669	46817	552	0	48797
21605	723	236	654	46614	0	48227
21606	359	180	45051	1000	0	46590
21607	278	139	754	44958	0	46129
21608	259	173	44120	1115	0	45667
21609	206	188	810	42274	0	43478
21610	204	125	750	42130	0	43209
21611	41158	180	289	1508	0	43135
21612	40921	176	221	1095	0	42413
21613	1356	186	143	40960	0	42645
21614	888	41314	162	971	0	43335
21615	411	745	124	41996	0	43276
21616	313	800	136	40950	0	42199
21617	39926	292	167	1545	0	41930
21618	755	40001	172	1203	0	42131
21619	40168	774	164	627	0	41733
21620	39545	793	149	528	0	41015
21621	1317	39237	151	554	0	41259
21622	886	40219	150	573	0	41828
21623	39221	1268	140	588	0	41217
21624	859	834	38819	615	0	41127
21625	38385	331	769	640	0	40125
21626	38492	262	732	635	0	40121
21627	1413	38479	345	604	0	40841
21628	1002	784	235	35785	0	37806
21629	434	38620	273	1061	0	40388
21630	38002	884	273	1077	0	40236
21631	37838	873	288	676	0	39675
21632	1351	421	309	36262	0	38343
21633	982	356	256	37495	0	39089
21634	36126	308	238	1681	0	38353
21635	900	36355	209	1367	0	38831
21636	934	36441	204	852	0	38431
21637	469	36150	261	717	0	37597
21638	257	28958	172	544	0	29931
21639	243	29112	190	561	0	30106
21640	349	1175	166	28114	0	29804
21641	264	777	27277	910	0	29228
21642	266	27501	477	877	0	29121
21643	25880	712	464	480	0	27536
21644	711	651	226	25531	0	27119
21645	25739	383	199	748	0	27069
21646	718	25486	184	790	0	27178
21647	25662	662	254	429	0	27007
21648	743	25828	224	428	0	27223
21649	697	711	287	25582	0	27277
21650	25364	632	304	793	0	27093
21651	25711	322	286	771	0	27090
21652	1022	283	278	25535	0	27118
21653	774	316	238	25542	0	26870
21654	463	25378	195	1169	0	27205
21655	442	708	202	25543	0	26895
21656	421	658	154	25416	0	26649
21657	449	395	139	25468	0	26451
21658	424	23995	172	1230	0	25821
21659	22452	581	179	812	0	24024
21660	573	23026	159	558	0	24316
21661	21922	660	110	455	0	23147
21662	677	22258	152	401	0	23488
21663	676	673	21454	386	0	23189
21664	491	622	492	21187	0	22792
21665	393	391	20528	617	0	21929
21666	372	341	19924	589	0	21226
21667	347	296	761	19847	0	21251
21668	387	308	19874	584	0	21153
21669	392	267	543	19461	0	20663
21670	434	287	482	19348	0	20551
21671	423	279	206	19979	0	20887
21672	19549	321	154	943	0	20967
21673	672	292	129	19612	0	20705
21674	655	361	113	19502	0	20631
21675	18710	271	104	963	0	20048
21676	677	18513	81	733	0	20004
21677	646	17723	72	398	0	18839
21678	434	17974	58	328	0	18794
21679	211	1396	22	12665	0	14294
21680	194	333	13008	370	0	13905
21681	10124	182	207	275	0	10788
21682	209	10688	145	113	0	11155
21683	9716	174	70	73	0	10033
21684	9528	162	34	58	0	9782
21685	9626	104	23	54	0	9807
21686	287	115	9577	52	0	10031
21687	182	101	125	9517	0	9925
21688	100	85	119	9556	0	9860
21689	109	69	49	9654	0	9881
21690	99	66	43	9427	0	9635
21691	85	9507	42	270	0	9904
21692	9527	155	40	187	0	9909
21693	165	138	9086	82	0	9471
21694	8604	49	104	63	0	8820
21695	151	132	85	8317	0	8685
21696	129	8149	17	170	0	8465
21697	55	8535	20	146	0	8756
21698	83	447	19	7941	0	8490
21699	46	8195	16	140	0	8397
21700	6606	83	17	78	0	6784
21701	73	70	6389	43	0	6575
21702	66	31	54	6157	0	6308
21703	29	36	54	6398	0	6517
21704	32	30	17	6450	0	6529
21705	23	32	19	6529	0	6603
21706	6464	18	13	126	0	6621
21707	67	6753	14	117	0	6951
21708	7300	69	15	35	0	7419
21709	89	70	11	7716	0	7886
21710	83	33	18	7941	0	8075
21711	38	8234	13	147	0	8432
21712	8389	82	17	110	0	8598
21713	8454	81	17	49	0	8601
21714	165	8454	17	60	0	8696
21715	90	103	16	7807	0	8016
21716	32	8095	14	117	0	8258
21717	7951	105	18	89	0	8163
21718	112	84	7927	40	0	8163
21719	94	35	7693	34	0	7856
21720	7194	15	147	37	0	7393
21721	87	7649	83	42	0	7861
21722	79	88	27	7603	0	7797
21723	24	84	16	7655	0	7779
21724	28	28	7737	169	0	7962
21725	23	25	86	7668	0	7802
21726	23	17	77	7726	0	7843
21727	17	7532	27	159	0	7735
21728	20	89	19	7429	0	7557
21729	21	80	15	7424	0	7540
21730	7379	27	11	166	0	7583
21731	84	7346	13	109	0	7552
21732	78	7320	11	47	0	7456
21733	30	151	12	7218	0	7411
21734	26	72	13	7276	0	7387
21735	14	32	18	7382	0	7446
21736	22	7285	7	169	0	7483
21737	20	84	15	7414	0	7533
21738	20	109	8	7249	0	7386
21739	18	31	12	7394	0	7455
21740	14	26	12	7340	0	7392
21741	25	7107	11	249	0	7392
21742	22	7506	7	100	0	7635
21743	7416	147	9	44	0	7616
21744	7397	92	5	36	0	7530
21745	198	39	8	7462	0	7707
21746	104	20	7520	95	0	7739
21747	42	14	78	7598	0	7732
21748	18	20	69	7539	0	7646
21749	7447	17	24	163	0	7651
21750	92	7884	11	103	0	8090
21751	81	91	11	7644	0	7827
21752	30	72	15	7907	0	8024
21753	27	25	7779	156	0	7987
21754	31	26	7862	96	0	8015
21755	23	26	135	7780	0	7964
21756	26	23	82	7671	0	7802
21757	22	7819	30	154	0	8025
21758	14	7884	24	101	0	8023
21759	7782	143	15	46	0	7986
21760	100	82	5	7831	0	8018
21761	70	45	7842	101	0	8058
21762	20	7741	81	92	0	7934
21763	22	82	57	7825	0	7986
21764	7774	68	21	108	0	7971
21765	83	37	15	7816	0	7951
21766	7701	30	18	112	0	7861
21767	96	7821	14	101	0	8032
21768	7656	88	6	60	0	7810
21769	100	73	5	7843	0	8021
21770	70	46	8246	112	0	8474
21771	27	35	87	8020	0	8169
21772	19	8389	56	141	0	8605
21773	21	107	27	8562	0	8717
21774	15	8915	15	136	0	9081
21775	16	141	12	9282	0	9451
21776	26	91	9135	165	0	9417
21777	29	39	8970	124	0	9162
21778	46	32	9151	79	0	9308
21779	8803	47	198	66	0	9114
21780	124	9091	95	78	0	9388
21781	92	9314	40	52	0	9498
21782	8942	192	22	52	0	9208
21783	8924	94	30	52	0	9100
21784	200	68	25	8879	0	9172
21785	115	37	8914	182	0	9248
21786	56	40	8629	127	0	8852
21787	52	25	194	8565	0	8836
21788	8635	26	111	173	0	8945
21789	126	8743	57	128	0	9054
21790	93	142	23	8949	0	9207
21791	8715	105	22	181	0	9023
21792	8647	48	32	146	0	8873
21793	190	38	8798	96	0	9122
21794	8509	24	135	99	0	8767
21795	161	38	8918	69	0	9186
21796	110	50	9021	63	0	9244
21797	51	52	191	8608	0	8902
21798	42	36	109	8571	0	8758
21799	28	33	56	9019	0	9136
21800	31	44	8759	239	0	9073
21801	8492	62	133	150	0	8837
21802	136	45	77	8932	0	9190
21803	8576	30	39	201	0	8846
21804	8408	39	41	147	0	8635
21805	194	8556	35	103	0	8888
21806	108	8659	39	80	0	8886
21807	54	8516	38	72	0	8680
21808	80	225	31	7446	0	7782
21809	25	96	7421	119	0	7661
21810	29	305	147	6647	0	7128
21811	38	6914	74	109	0	7135
21812	27	6746	34	82	0	6889
21813	96	123	31	6652	0	6902
21814	6581	60	32	95	0	6768
21815	95	6562	27	65	0	6749
21816	53	6630	21	57	0	6761
21817	6894	108	29	39	0	7070
21818	97	64	30	6947	0	7138
21819	61	33	27	6845	0	6966
21820	58	22	18	7003	0	7101
21821	6679	22	22	136	0	6859
21822	6693	27	26	79	0	6825
21823	138	18	26	6708	0	6890
21824	94	15	6584	97	0	6790
21825	6525	12	101	66	0	6704
21826	103	19	60	6706	0	6888
21827	64	17	6597	115	0	6793
21828	39	20	6572	73	0	6704
21829	37	13	133	6653	0	6836
21830	32	21	6740	133	0	6926
21831	25	14	109	7384	0	7532
21832	45	43	69	7429	0	7586
21833	38	22	34	7810	0	7904
21834	7716	40	34	186	0	7976
21835	138	25	23	7661	0	7847
21836	75	44	30	7743	0	7892
21837	44	38	31	7715	0	7828
21838	31	44	35	7821	0	7931
21839	37	48	7612	214	0	7911
21840	25	7641	125	133	0	7924
21841	25	171	71	7476	0	7743
21842	31	78	41	7310	0	7460
21843	32	7350	37	168	0	7587
21844	34	7567	19	119	0	7739
21845	7422	165	41	62	0	7690
21846	139	7300	33	56	0	7528
21847	88	138	28	7113	0	7367
21848	55	90	7059	142	0	7346
21849	6868	53	116	91	0	7128
21850	153	39	6555	65	0	6812
21851	6464	21	126	70	0	6681
21852	6425	17	77	56	0	6575
21853	198	15	6414	67	0	6694
21854	99	21	137	6137	0	6394
21855	63	6152	89	149	0	6453
21856	53	115	54	6412	0	6634
21857	6441	60	52	175	0	6728
21858	6594	33	43	108	0	6778
21859	186	6601	34	104	0	6925
21860	6648	109	49	99	0	6905
21861	163	69	43	6477	0	6752
21862	6506	35	34	184	0	6759
21863	6603	33	35	129	0	6800
21864	187	25	32	6457	0	6701
21865	6425	31	25	201	0	6682
21866	6346	28	28	152	0	6554
21867	185	40	6230	95	0	6550
21868	6199	35	116	88	0	6438
21869	149	34	6148	83	0	6414
21870	93	31	5719	75	0	5918
21871	40	5731	160	70	0	6001
21872	83	103	176	5233	0	5595
21873	36	58	5236	102	0	5432
21874	25	64	4978	61	0	5128
21875	4739	16	167	32	0	4954
21876	85	10	49	4655	0	4799
21877	47	16	31	4776	0	4870
21878	18	13	24	4764	0	4819
21879	25	18	12	4673	0	4728
21880	15	22	10	4858	0	4905
21881	28	13	4761	128	0	4930
21882	39	11	4715	192	0	4957
21883	37	25	93	4854	0	5009
21884	4832	14	44	95	0	4985
21885	79	4838	15	80	0	5012
21886	62	70	17	4867	0	5016
21887	4811	48	17	104	0	4980
21888	92	4868	13	92	0	5065
21889	68	70	19	4809	0	4966
21890	45	44	23	4720	0	4832
21891	44	19	25	4751	0	4839
21892	4640	14	20	142	0	4816
21893	90	23	4548	90	0	4751
21894	4422	16	85	50	0	4573
21895	88	25	67	4416	0	4596
21896	66	24	25	4263	0	4378
21897	38	4345	36	142	0	4561
21898	32	82	4425	99	0	4638
21899	4350	52	85	61	0	4548
21900	4493	27	55	63	0	4638
21901	123	28	4378	74	0	4603
21902	4176	26	82	66	0	4350
21903	91	4315	55	77	0	4538
21904	61	4507	38	65	0	4671
21905	45	4594	38	45	0	4722
21906	4417	116	36	50	0	4619
21907	107	57	4474	49	0	4687
21908	77	89	81	4217	0	4464
21909	40	4229	61	91	0	4421
21910	47	4389	25	70	0	4531
21911	36	4392	20	53	0	4501
21912	51	134	72	4060	0	4317
21913	4081	55	24	89	0	4249
21914	100	4234	23	66	0	4423
21915	73	76	22	4207	0	4378
21916	64	43	21	4253	0	4381
21917	4037	17	27	118	0	4199
21918	110	18	24	3993	0	4145
21919	70	20	23	4136	0	4249
21920	48	26	4143	131	0	4348
21921	47	22	73	4098	0	4240
21922	58	18	51	4221	0	4348
21923	4193	12	33	118	0	4356
21924	4160	15	32	69	0	4276
21925	129	22	31	4087	0	4269
21926	4080	25	32	90	0	4227
21927	4074	24	22	71	0	4191
21928	122	4199	30	40	0	4391
21929	80	73	4131	44	0	4328
21930	49	4032	78	31	0	4190
21931	126	85	58	2991	0	3260
21932	2890	21	12	22	0	2945
21933	18	2861	6	26	0	2911
21934	23	21	8	2804	0	2856
21935	2800	18	5	28	0	2851
21936	2809	5	7	26	0	2847
21937	42	5	6	2858	0	2911
21938	25	6	3139	34	0	3204
21939	6	7	25	3240	0	3278
21940	10	6	19	3301	0	3336
21941	7	8	3292	49	0	3356
21942	10	2	21	3218	0	3251
21943	7	4	20	3276	0	3307
21944	3423	5	4	43	0	3475
21945	22	5	6	3517	0	3550
21946	23	3	5	3556	0	3587
21947	3560	3	6	40	0	3609
21948	3484	4	1	26	0	3515
21949	3536	8	4	8	0	3556
21950	36	6	3545	16	0	3603
21951	21	7	20	3469	0	3517
21952	9	3691	17	26	0	3743
21953	13	29	3	3726	0	3771
21954	9	21	4105	34	0	4169
21955	14	8	26	3991	0	4039
21956	13	6	4204	32	0	4255
21957	3913	7	21	13	0	3954
21958	4048	4	10	11	0	4073
21959	29	4	3	4083	0	4119
21960	10	2	7	4148	0	4167
21961	6	4	4	4167	0	4181
21962	2	4654	5	38	0	4699
21963	4682	20	2	19	0	4723
21964	4814	14	4	14	0	4846
21965	28	3	4	4831	0	4866
21966	16	4	2	4822	0	4844
21967	8	6	2	4856	0	4872
21968	3	7	2	4865	0	4877
21969	9	5	4817	42	0	4873
21970	9	2	19	4875	0	4905
21971	4897	3	14	28	0	4942
21972	4800	1	4	26	0	4831
21973	29	7	6	4780	0	4822
21974	11	5	4816	35	0	4867
21975	4573	3	21	21	0	4618
21976	26	3	10	4746	0	4785
21977	17	5036	9	30	0	5092
21978	8	5320	5	24	0	5357
21979	5603	30	6	18	0	5657
21980	24	14	1	5596	0	5635
21981	18	7	3	5607	0	5635
21982	4	0	2	5739	0	5745
21983	8	3	1	5712	0	5724
21984	7	2	2	5913	0	5924
21985	10	4	5911	40	0	5965
21986	11	3	5799	19	0	5832
21987	6	2	5869	12	0	5889
21988	5	2	38	5792	0	5837
21989	16	1	6385	34	0	6436
21990	2	2	31	6231	0	6266
21991	7	4	19	6299	0	6329
21992	9	3	7	6433	0	6452
21993	6463	0	1	60	0	6524
21994	33	2	4	6428	0	6467
21995	21	4	2	6619	0	6646
21996	6465	2	4	52	0	6523
21997	33	6524	5	32	0	6594
21998	20	6800	10	16	0	6846
21999	6745	50	1	15	0	6811
22000	31	7068	7	15	0	7121
22001	7117	33	4	19	0	7173
22002	7143	23	8	12	0	7186
22003	7314	5	8	21	0	7348
22004	7293	5	7	15	0	7320
22005	7323	3	2	14	0	7342
22006	58	7278	5	14	0	7355
22007	7274	36	6	16	0	7332
22008	7263	23	4	18	0	7308
22009	58	7469	4	13	0	7544
22010	8058	38	5	11	0	8112
22011	8111	25	10	19	0	8165
22012	9036	5	4	22	0	9067
22013	9322	8	6	19	0	9355
22014	164	5	10474	20	0	10663
22015	87	9	109	10938	0	11143
22016	28	2	92	11467	0	11589
22017	28	10	11372	231	0	11641
22018	26	4	11167	123	0	11320
22019	11133	6	217	27	0	11383
22020	136	8	113	11435	0	11692
22021	121	12	11485	134	0	11752
22022	39	6	11350	110	0	11505
22023	11112	11	231	32	0	11386
22024	11418	9	115	23	0	11565
22025	11523	8	25	18	0	11574
22026	253	8	11354	22	0	11637
22027	127	6	132	11293	0	11558
22028	56	7	11391	140	0	11594
22029	11086	8	153	111	0	11358
22030	167	6	11569	25	0	11767
22031	119	8	153	11190	0	11470
22032	43	16	118	11292	0	11469
22033	30	11781	32	222	0	12065
22034	11912	136	28	122	0	12198
22035	172	101	11900	33	0	12206
22036	11957	16	159	26	0	12158
22037	182	6	12148	25	0	12361
22038	131	5	171	11578	0	11885
22039	40	8	136	11586	0	11770
22040	49	4	48	11789	0	11890
22041	11743	8	33	270	0	12054
22042	182	15	39	11682	0	11918
22043	149	9	41	11616	0	11815
22044	48	11355	46	276	0	11725
22045	47	129	54	11482	0	11712
22046	11180	103	56	204	0	11543
22047	201	18	11305	153	0	11677
22048	155	13	192	11230	0	11590
22049	85	9	11343	194	0	11631
22050	72	11098	207	169	0	11546
22051	90	138	11292	69	0	11589
22052	10834	105	216	54	0	11209
22053	11036	18	187	50	0	11291
22054	300	12	96	10621	0	11029
22055	10747	10	82	194	0	11033
22056	10557	12	91	163	0	10823
22057	310	8	85	10608	0	11011
22058	185	14	102	10784	0	11085
22059	102	14	10693	307	0	11116
22060	90	10592	212	177	0	11071
22061	10575	158	170	82	0	10985
22062	219	10331	87	72	0	10709
22063	194	262	84	10101	0	10641
22064	115	123	81	10196	0	10515
22065	91	37	92	10270	0	10490
22066	94	25	84	10379	0	10582
22067	92	20	10117	331	0	10560
22068	9788	29	236	205	0	10258
22069	10202	28	176	121	0	10527
22070	324	27	77	10056	0	10484
22071	10095	28	68	253	0	10444
22072	243	37	58	10110	0	10448
22073	203	33	9968	266	0	10470
22074	121	28	199	9840	0	10188
22075	92	9827	183	244	0	10346
22076	102	157	78	9771	0	10108
22077	87	9582	111	248	0	10028
22078	82	175	87	9090	0	9434
22079	77	9129	93	262	0	9561
22080	8908	187	86	221	0	9402
22081	229	142	9026	135	0	9532
22082	183	8778	204	137	0	9302
22083	133	8972	166	167	0	9438
22084	186	260	85	8591	0	9122
22085	111	135	89	8581	0	8916
22086	130	56	83	8615	0	8884
22087	115	34	96	8786	0	9031
22088	107	8554	87	353	0	9101
22089	100	162	86	8319	0	8667
22090	102	156	74	8409	0	8741
22091	8185	62	84	338	0	8669
22092	246	53	54	8388	0	8741
22093	196	53	8064	265	0	8578
22094	112	50	8017	246	0	8425
22095	7638	39	256	158	0	8091
22096	199	7889	151	163	0	8402
22097	171	8021	67	137	0	8396
22098	104	246	72	7603	0	8025
22099	163	137	63	7728	0	8091
22100	78	66	7381	330	0	7855
22101	7138	68	176	217	0	7599
22102	7329	59	125	156	0	7669
22103	284	58	7251	148	0	7741
22104	163	50	7266	154	0	7633
22105	7175	54	234	157	0	7620
22106	7335	45	142	142	0	7664
22107	7387	73	61	136	0	7657
22108	7361	47	60	132	0	7600
22109	295	7057	71	108	0	7531
22110	6410	157	41	92	0	6700
22111	212	122	6080	87	0	6501
22112	83	43	5200	72	0	5398
22113	82	72	5257	56	0	5467
22114	105	606	63	3254	0	4028
22115	3165	13	121	47	0	3346
22116	3081	9	12	28	0	3130
22117	44	10	10	3061	0	3125
22118	28	10	9	3005	0	3052
22119	13	12	12	3048	0	3085
22120	15	3140	10	51	0	3216
22121	3163	28	10	27	0	3228
22122	3130	20	8	26	0	3184
22123	3170	12	8	21	0	3211
22124	3172	14	10	17	0	3213
22125	3168	9	7	26	0	3210
22126	41	7	11	3162	0	3221
22127	20	3130	12	39	0	3201
22128	20	32	11	3214	0	3277
22129	14	18	32	3079	0	3143
22130	3059	9	14	45	0	3127
22131	33	10	2977	25	0	3045
22132	18	1	2784	16	0	2819
22133	11	3	2812	10	0	2836
22134	2759	2	26	4	0	2791
22135	2715	2	130	5	0	2852
22136	9	1	8	2640	0	2658
22137	8	2	3	2642	0	2655
22138	5	3	0	2704	0	2712
22139	7	1	2812	15	0	2835
22140	2	0	6	2776	0	2784
22141	3	1	2967	11	0	2982
22142	2	5	7	2927	0	2941
22143	4	1	8	2909	0	2922
22144	0	3	3	3089	0	3095
22145	3071	2	2	15	0	3090
22146	3065	2	2	12	0	3081
22147	11	0	3170	8	0	3189
22148	3105	0	6	5	0	3116
22149	3149	2	8	2	0	3161
22150	11	3	6	3163	0	3183
22151	3170	1	2	12	0	3185
22152	11	1	2	3267	0	3281
22153	8	1	1	3278	0	3288
22154	5	2	3324	21	0	3352
22155	3109	0	8	14	0	3131
22156	9	0	11	3334	0	3354
22157	6	0	3364	10	0	3380
22158	7	1	3675	10	0	3693
22159	3	1	13	3521	0	3538
22160	0	1	9	3600	0	3610
22161	3710	0	3	16	0	3729
22162	7	0	1	3714	0	3722
22163	9	1	1	3648	0	3659
22164	5	0	3	3756	0	3764
22165	3	2	3	4313	0	4321
22166	4685	0	0	25	0	4710
22167	4596	0	4	26	0	4626
22168	4975	2	1	8	0	4986
22169	5202	0	3	5	0	5210
22170	70	1	4	5420	0	5495
22171	5480	1	2	41	0	5524
22172	48	1	4	5512	0	5565
22173	5512	0	2	53	0	5567
22174	50	1	6	5474	0	5531
22175	38	3	7	5528	0	5576
22176	13	5714	5	82	0	5814
22177	4	46	1	5668	0	5719
22178	5503	39	3	56	0	5601
22179	5392	7	2	49	0	5450
22180	88	2	5730	20	0	5840
22181	48	5794	50	11	0	5903
22182	5790	45	40	11	0	5886
22183	47	6057	14	11	0	6129
22184	6020	54	8	7	0	6089
22185	54	6533	7	22	0	6616
22186	48	54	6743	12	0	6857
22187	14	6855	49	16	0	6934
22188	11	6956	43	20	0	7030
22189	6	92	8	7144	0	7250
22190	7345	46	4	65	0	7460
22191	46	13	5	7444	0	7508
22192	47	3	2	7544	0	7596
22193	7612	2	3	98	0	7715
22194	7736	3	2	63	0	7804
22195	102	2	6	7818	0	7928
22196	62	6	2	7812	0	7882
22197	22	4	3	7941	0	7970
22198	7854	4	6	113	0	7977
22199	64	3	7858	63	0	7988
22200	59	5	49	7825	0	7938
22201	24	5	8249	62	0	8340
22202	16	8104	60	69	0	8249
22203	21	59	8012	19	0	8111
22204	10	49	63	7835	0	7957
22205	25	18	7968	66	0	8077
22206	7652	10	65	64	0	7791
22207	66	6	52	7922	0	8046
22208	55	8359	14	87	0	8515
22209	25	59	8	8466	0	8558
22210	23	8515	5	79	0	8622
22211	23	8509	4	72	0	8608
22212	20	8536	5	39	0	8600
22213	29	104	8	8029	0	8170
22214	25	8269	5	64	0	8363
22215	8208	70	2	66	0	8346
22216	78	53	8098	28	0	8257
22217	70	15	7967	32	0	8084
22218	42	10	8316	27	0	8395
22219	25	9	107	8301	0	8442
22220	29	9	60	8121	0	8219
22221	31	15	17	8180	0	8243
22222	33	14	10	8292	0	8349
22223	38	20	17	8268	0	8343
22224	33	8636	10	142	0	8821
22225	40	67	8725	81	0	8913
22226	46	54	8543	47	0	8690
22227	41	8880	104	42	0	9067
22228	37	70	55	8801	0	8963
22229	28	63	17	8755	0	8863
22230	23	33	10	8789	0	8855
22231	8736	22	16	132	0	8906
22232	92	29	8657	80	0	8858
22233	8403	23	68	42	0	8536
22234	8482	26	54	47	0	8609
22235	109	8511	22	36	0	8678
22236	78	8852	13	37	0	8980
22237	8913	132	19	45	0	9109
22238	88	67	16	8860	0	9031
22239	75	35	17	9135	0	9262
22240	37	32	9439	149	0	9657
22241	36	37	9403	79	0	9555
22242	29	35	114	9586	0	9764
22243	9780	26	74	102	0	9982
22244	96	33	10624	87	0	10840
22245	10567	28	141	47	0	10783
22246	107	27	88	10727	0	10949
22247	92	29	25	10714	0	10860
22248	36	28	25	11241	0	11330
22249	35	12	11152	214	0	11413
22250	19	11056	113	137	0	11325
22251	24	11490	94	72	0	11680
22252	11559	177	26	51	0	11813
22253	11633	102	24	45	0	11804
22254	191	22	21	11654	0	11888
22255	11768	23	23	135	0	11949
22256	124	30	11594	112	0	11860
22257	113	28	11490	41	0	11672
22258	24	26	204	11020	0	11274
22259	11479	25	118	141	0	11763
22260	119	32	38	11595	0	11784
22261	104	19	34	11871	0	12028
22262	11807	29	28	226	0	12090
22263	11856	23	35	136	0	12050
22264	197	12439	32	65	0	12733
22265	12381	125	23	38	0	12567
22266	122	205	56	11840	0	12223
22267	103	12309	15	134	0	12561
22268	11931	112	14	101	0	12158
22269	101	11938	17	34	0	12090
22270	87	97	56	11325	0	11565
22271	11326	86	8	101	0	11521
22272	106	17	11302	97	0	11522
22273	88	9	11250	19	0	11366
22274	21	47	235	10995	0	11298
22275	24	9	87	10994	0	11114
22276	20	15	25	11035	0	11095
22277	20	11286	28	170	0	11504
22278	11517	83	11	97	0	11708
22279	11285	89	16	56	0	11446
22280	11420	21	12	33	0	11486
22281	182	12063	16	34	0	12295
22282	111	105	23	12724	0	12963
22283	43	107	8	12732	0	12890
22284	32	32	13	12910	0	12987
22285	12229	22	9	242	0	12502
22286	134	12230	14	147	0	12525
22287	120	130	14	12100	0	12364
22288	48	109	12	12088	0	12257
22289	34	30	11860	230	0	12154
22290	25	11656	129	138	0	11948
22291	28	117	114	11478	0	11737
22292	41	109	26	11345	0	11521
22293	60	29	12	11433	0	11534
22294	11067	24	20	248	0	11359
22295	152	11120	14	153	0	11439
22296	11237	124	17	59	0	11437
22297	155	121	22	11050	0	11348
22298	11223	31	21	147	0	11422
22299	155	31	11227	152	0	11565
22300	11227	34	117	73	0	11451
22301	11268	21	108	63	0	11460
22302	237	34	11403	54	0	11728
22303	151	30	119	11324	0	11624
22304	77	39	115	11306	0	11537
22305	11575	30	35	262	0	11902
22306	145	38	37	11838	0	12058
22307	135	37	28	11692	0	11892
22308	65	37	21	11593	0	11716
22309	62	33	11229	283	0	11607
22310	10675	38	136	183	0	11032
22311	173	11458	116	104	0	11851
22312	166	140	47	11335	0	11688
22313	73	11705	28	207	0	12013
22314	58	11857	36	190	0	12141
22315	73	256	31	11844	0	12204
22316	74	158	11798	219	0	12249
22317	75	66	11888	190	0	12219
22318	105	39	242	11716	0	12102
22319	96	51	11860	196	0	12203
22320	11604	59	157	190	0	12010
22321	207	45	137	11962	0	12351
22322	171	38	65	12097	0	12371
22323	84	12101	38	356	0	12579
22324	81	159	31	12013	0	12284
22325	87	138	32	11737	0	11994
22326	55	11681	43	365	0	12144
22327	68	157	46	11887	0	12158
22328	87	143	37	11735	0	12002
22329	73	11783	40	312	0	12208
22330	11811	173	34	216	0	12234
22331	208	163	11704	120	0	12195
22332	185	60	11646	134	0	12025
22333	94	137	242	11420	0	11893
22334	70	71	152	11727	0	12020
22335	78	51	11670	324	0	12123
22336	66	52	11386	229	0	11733
22337	10699	47	264	135	0	11145
22338	173	11324	159	119	0	11775
22339	11105	168	55	92	0	11420
22340	198	132	10821	116	0	11267
22341	149	10616	164	105	0	11034
22342	88	150	180	10559	0	10977
22343	92	141	10623	289	0	11145
22344	36	51	9827	169	0	10083
22345	42	93	195	10435	0	10765
22346	54	30	10684	195	0	10963
22347	42	10682	143	199	0	11066
22348	49	153	127	10403	0	10732
22349	66	126	10603	165	0	10960
22350	47	10612	146	166	0	10971
22351	10342	135	120	87	0	10684
22352	156	123	10255	65	0	10599
22353	127	10187	153	74	0	10541
22354	55	144	129	9867	0	10195
22355	43	118	62	10307	0	10530
22356	10260	51	45	267	0	10623
22357	164	27	37	10275	0	10503
22358	142	29	41	10349	0	10561
22359	10104	36	47	271	0	10458
22360	141	32	32	10174	0	10379
22361	124	27	9722	200	0	10073
22362	46	106	147	9595	0	9894
22363	20	39	9716	169	0	9944
22364	24	13	8976	140	0	9153
22365	53	15	8758	62	0	8888
22366	78	46	197	8103	0	8424
22367	24	21	114	8356	0	8515
22368	8363	15	35	194	0	8607
22369	99	19	25	8223	0	8366
22370	85	8862	19	130	0	9096
22371	25	108	29	9016	0	9178
22372	18	91	24	8887	0	9020
22373	10	9003	35	190	0	9238
22374	8957	107	30	121	0	9215
22375	8712	87	30	59	0	8888
22376	174	8901	29	46	0	9150
22377	97	8815	27	39	0	8978
22378	26	364	29	8554	0	8973
22379	8638	93	102	126	0	8959
22380	107	36	8664	110	0	8917
22381	89	24	7850	39	0	8002
22382	7032	20	135	21	0	7208
22383	71	7206	79	31	0	7387
22384	67	125	36	7222	0	7450
22385	23	89	18	7205	0	7335
22386	22	31	17	7292	0	7362
22387	11	15	30	7362	0	7418
22388	8	7180	23	148	0	7359
22389	14	76	18	7301	0	7409
22390	7368	67	23	109	0	7567
22391	83	28	23	7483	0	7617
22392	70	14	17	7553	0	7654
22393	7617	14	26	155	0	7812
22394	7497	26	18	103	0	7644
22395	7722	10	23	53	0	7808
22396	7785	15	31	41	0	7872
22397	158	20	20	7668	0	7866
22398	7670	12	25	107	0	7814
22399	96	11	24	7507	0	7638
22400	7401	17	22	116	0	7556
22401	7335	16	17	107	0	7475
22402	146	7	19	7289	0	7461
22403	100	10	7334	98	0	7542
22404	7284	15	86	103	0	7488
22405	7520	11	82	53	0	7666
22406	7624	14	36	42	0	7716
22407	7839	22	30	39	0	7930
22408	152	20	33	8057	0	8262
22409	101	15	7995	112	0	8223
22410	35	22	8078	102	0	8237
22411	7698	24	178	65	0	7965
22412	8087	19	88	31	0	8225
22413	126	7971	27	169	0	8293
22414	76	8170	26	38	0	8310
22415	8574	121	23	40	0	8758
22416	92	81	18	8341	0	8532
22417	85	41	19	8771	0	8916
22418	8776	24	30	139	0	8969
22419	84	9013	19	108	0	9224
22420	9177	82	9	57	0	9325
22421	94	68	9015	45	0	9222
22422	8948	27	61	53	0	9089
22423	94	16	58	9005	0	9173
22424	85	17	9490	107	0	9699
22425	38	9466	67	141	0	9712
22426	39	67	66	9848	0	10020
22427	33	67	10430	109	0	10639
22428	38	37	86	10273	0	10434
22429	10592	8	86	116	0	10802
22430	97	12	10577	101	0	10787
22431	10298	12	85	65	0	10460
22432	94	10968	87	63	0	11212
22433	107	68	30	11088	0	11293
22434	52	75	11547	116	0	11790
22435	43	30	72	11394	0	11539
22436	34	18	11794	137	0	11983
22437	40	11689	84	125	0	11938
22438	11250	113	72	63	0	11498
22439	107	12165	18	41	0	12331
22440	112	92	11	11965	0	12180
22441	55	75	9	12022	0	12161
22442	51	33	11886	142	0	12112
22443	9987	32	84	117	0	10220
22444	95	11532	76	49	0	11752
22445	67	10574	15	53	0	10709
22446	19	10760	16	31	0	10826
22447	43	292	16	10233	0	10584
22448	20	10673	8	44	0	10745
22449	14	72	8	10416	0	10510
22450	13	10527	9	49	0	10598
22451	27	41	4	10349	0	10421
22452	13	10650	5	37	0	10705
22453	10570	33	12	54	0	10669
22454	43	43	10571	14	0	10671
22455	10060	32	31	21	0	10144
22456	10122	11	42	15	0	10190
22457	10630	5	17	13	0	10665
22458	68	10685	7	10	0	10770
22459	10678	30	5	11	0	10724
22460	10490	39	7	15	0	10551
22461	10702	13	5	16	0	10736
22462	71	9	10760	10	0	10850
22463	47	4	33	10587	0	10671
22464	22	11	10877	34	0	10944
22465	16	10	36	10790	0	10852
22466	10842	9	44	45	0	10940
22467	35	10882	13	69	0	10999
22468	52	34	12244	22	0	12352
22469	16	46	71	12357	0	12490
22470	9	15	56	13170	0	13250
22471	16	15	14397	153	0	14581
22472	13870	13	122	84	0	14089
22473	14470	18	93	24	0	14605
22474	14993	9	20	14	0	15036
22475	225	12	12	14773	0	15022
22476	118	14495	13	141	0	14767
22477	38	14993	8	122	0	15161
22478	20	204	14	14785	0	15023
22479	30	140	11	14486	0	14667
22480	18	14736	10	212	0	14976
22481	14645	128	12	106	0	14891
22482	137	14696	12	48	0	14893
22483	93	141	14	14526	0	14774
22484	35	93	14531	189	0	14848
22485	15	32	125	14473	0	14645
22486	14648	22	89	150	0	14909
22487	147	10	14536	94	0	14787
22488	14406	24	131	36	0	14597
22489	14700	12	97	26	0	14835
22490	14614	17	31	26	0	14688
22491	14750	16	22	29	0	14817
22492	15158	19	26	27	0	15230
22493	251	23	14676	22	0	14972
22494	144	24	14981	22	0	15171
22495	15403	20	225	17	0	15665
22496	15988	18	123	29	0	16158
22497	278	22	34	16574	0	16908
22498	144	16906	17	175	0	17242
22499	47	179	17	17173	0	17416
22500	17400	158	24	201	0	17783
22501	195	55	10	16995	0	17255
22502	170	17575	12	208	0	17965
22503	17521	190	18	168	0	17897
22504	16785	181	23	56	0	17045
22505	17142	52	21	41	0	17256
22506	361	16966	24	42	0	17393
22507	207	178	18	16710	0	17113
22508	82	164	18	16338	0	16602
22509	56	16067	35	326	0	16484
22510	54	203	26	16370	0	16653
22511	16066	158	20	211	0	16455
22512	15935	52	27	174	0	16188
22513	348	16021	29	69	0	16467
22514	221	174	23	15920	0	16338
22515	86	165	31	15615	0	15897
22516	68	51	32	15953	0	16104
22517	15355	26	36	355	0	15772
22518	226	33	15143	207	0	15609
22519	14715	30	175	91	0	15011
22520	244	37	14975	69	0	15325
22521	228	41	199	14293	0	14761
22522	117	14419	164	211	0	14911
22523	102	14830	43	209	0	15184
22524	14158	333	32	82	0	14605
22525	14128	214	22	70	0	14434
22526	362	13889	28	77	0	14356
22527	206	13551	18	95	0	13870
22528	13563	327	20	71	0	13981
22529	13816	205	26	65	0	14112
22530	373	14458	39	125	0	14995
22531	15014	208	34	73	0	15329
22532	277	195	14568	86	0	15126
22533	14667	68	195	88	0	15018
22534	14387	57	168	84	0	14696
22535	404	54	46	14215	0	14719
22536	264	14165	45	246	0	14720
22537	154	204	45	14353	0	14756
22538	14490	193	39	261	0	14983
22539	291	79	36	13966	0	14372
22540	264	59	43	14199	0	14565
22541	168	64	14590	386	0	15208
22542	138	63	199	14645	0	15045
22543	156	63	188	14900	0	15307
22544	14853	74	64	402	0	15393
22545	287	80	14796	259	0	15422
22546	14931	87	208	113	0	15339
22547	316	82	167	14832	0	15397
22548	274	78	54	14873	0	15279
22549	171	89	39	14954	0	15253
22550	151	14558	47	402	0	15158
22551	151	14934	56	235	0	15376
22552	164	380	42	14599	0	15185
22553	14685	226	50	265	0	15226
22554	14728	92	40	240	0	15100
22555	479	87	31	14707	0	15304
22556	14870	73	39	274	0	15256
22557	370	58	46	14646	0	15120
22558	310	68	45	14832	0	15255
22559	14670	64	42	415	0	15191
22560	305	15006	49	287	0	15647
22561	15029	228	41	146	0	15444
22562	14910	214	36	120	0	15280
22563	14771	79	50	144	0	15044
22564	454	14972	43	144	0	15613
22565	283	317	35	14987	0	15622
22566	150	203	36	15248	0	15637
22567	136	85	14847	441	0	15509
22568	103	91	161	13548	0	13903
22569	128	93	12965	251	0	13437
22570	116	12106	156	212	0	12590
22571	68	10633	124	92	0	10917
22572	89	10812	35	80	0	11016
22573	222	224	174	10675	0	11295
22574	61	131	18	10634	0	10844
22575	54	54	16	10758	0	10882
22576	70	48	8	10913	0	11039
22577	55	46	10894	243	0	11238
22578	71	28	13414	188	0	13701
22579	75	30	241	14165	0	14511
22580	68	36	14334	219	0	14657
22581	13985	26	179	206	0	14396
22582	14386	31	150	97	0	14664
22583	315	38	14244	90	0	14687
22584	214	25	174	14042	0	14455
22585	99	29	165	14003	0	14296
22586	86	31	57	14296	0	14470
22587	84	35	43	14201	0	14363
22588	69	38	40	14468	0	14615
22589	13308	71	38	383	0	13800
22590	13698	47	34	248	0	14027
22591	329	14160	28	134	0	14651
22592	196	171	13763	105	0	14235
22593	82	13637	167	104	0	13990
22594	71	13428	137	103	0	13739
22595	12830	262	37	69	0	13198
22596	163	12680	37	75	0	12955
22597	126	11812	25	55	0	12018
22598	11585	214	131	50	0	11980
22599	193	112	11584	37	0	11926
22600	11160	48	133	43	0	11384
22601	148	40	109	11208	0	11505
22602	122	34	42	11003	0	11201
22603	62	17	39	11354	0	11472
22604	62	18	11231	253	0	11564
22605	53	11256	139	163	0	11611
22606	11243	118	98	100	0	11559
22607	147	87	56	11247	0	11537
22608	110	11389	35	210	0	11744
22609	37	160	29	11762	0	11988
22610	54	111	11672	222	0	12059
22611	54	58	159	11520	0	11791
22612	56	59	120	11601	0	11836
22613	77	52	45	11806	0	11980
22614	11587	65	35	284	0	11971
22615	175	55	52	11835	0	12117
22616	146	39	11820	257	0	12262
22617	63	11816	159	317	0	12355
22618	67	174	118	11806	0	12165
22619	79	122	38	12174	0	12413
22620	72	63	11900	307	0	12342
22621	84	56	11719	183	0	12042
22622	11364	51	294	103	0	11812
22623	11683	58	162	133	0	12036
22624	281	11813	84	132	0	12310
22625	11912	186	73	111	0	12282
22626	237	148	11745	94	0	12224
22627	180	63	11545	93	0	11881
22628	11387	104	272	112	0	11875
22629	11379	150	140	128	0	11797
22630	283	51	10813	142	0	11289
22631	10388	47	239	124	0	10798
22632	217	40	10437	124	0	10818
22633	10206	32	175	106	0	10519
22634	10292	49	147	102	0	10590
22635	258	65	66	10046	0	10435
22636	144	10741	88	212	0	11185
22637	10194	216	88	160	0	10658
22638	200	159	10849	75	0	11283
22639	175	10964	176	100	0	11415
22640	10790	220	128	89	0	11227
22641	10248	163	111	115	0	10637
22642	272	10293	82	129	0	10776
22643	165	164	114	10311	0	10754
22644	135	116	10160	229	0	10640
22645	107	62	181	10168	0	10518
22646	123	62	10160	254	0	10599
22647	85	83	191	10029	0	10388
22648	83	66	197	10098	0	10444
22649	94	77	10037	287	0	10495
22650	105	9853	210	219	0	10387
22651	114	164	155	9867	0	10300
22652	112	138	9392	242	0	9884
22653	9562	70	210	202	0	10044
22654	235	79	182	9721	0	10217
22655	188	55	100	9917	0	10260
22656	9795	64	85	310	0	10254
22657	245	77	78	9636	0	10036
22658	223	64	67	9441	0	9795
22659	118	9582	92	280	0	10072
22660	124	192	115	9422	0	9853
22661	115	156	9415	232	0	9918
22662	130	71	197	9037	0	9435
22663	118	9150	154	236	0	9658
22664	119	9111	109	182	0	9521
22665	110	250	114	9138	0	9612
22666	9148	153	103	226	0	9630
22667	231	97	103	9127	0	9558
22668	9145	104	89	240	0	9578
22669	228	75	100	9100	0	9503
22670	9062	63	127	230	0	9482
22671	9092	63	106	201	0	9462
22672	328	97	101	8696	0	9222
22673	296	455	145	8207	0	9103
22674	149	8586	106	293	0	9134
22675	126	8735	87	243	0	9191
22676	129	223	8875	151	0	9378
22677	131	8711	192	155	0	9189
22678	5398	178	289	62	0	5927
22679	156	54	89	5131	0	5430
22680	68	5091	39	77	0	5275
22681	5217	67	21	78	0	5383
22682	75	57	37	5180	0	5349
22683	81	29	30	5200	0	5340
22684	54	18	23	5329	0	5424
22685	28	34	35	5316	0	5413
22686	41	5752	30	128	0	5951
22687	35	6181	22	91	0	6329
22688	6612	110	24	52	0	6798
22689	96	6841	26	37	0	7000
22690	68	83	24	6717	0	6892
22691	36	73	20	6700	0	6829
22692	40	26	17	6732	0	6815
22693	32	20	14	6812	0	6878
22694	6705	27	15	157	0	6904
22695	6830	21	19	108	0	6978
22696	147	16	6925	42	0	7130
22697	96	23	80	6951	0	7150
22698	50	15	7149	108	0	7322
22699	29	24	91	7255	0	7399
22700	27	31	72	7346	0	7476
22701	7558	21	27	177	0	7783
22702	91	32	16	7527	0	7666
22703	92	17	7485	129	0	7723
22704	39	17	7338	109	0	7503
22705	7281	27	140	52	0	7500
22706	109	24	7481	43	0	7657
22707	75	33	78	7176	0	7362
22708	36	16	7492	110	0	7654
22709	22	10	71	7272	0	7375
22710	11	7292	66	107	0	7476
22711	27	67	17	7212	0	7323
22712	12	7284	16	92	0	7404
22713	24	7302	16	79	0	7421
22714	60	148	10	7157	0	7375
22715	7145	69	5	89	0	7308
22716	61	7089	10	72	0	7232
22717	65	70	7	7047	0	7189
22718	6958	61	2	91	0	7112
22719	7026	19	8	83	0	7136
22720	7341	14	6	39	0	7400
22721	135	12	6	7224	0	7377
22722	74	7	7	7303	0	7391
22723	7311	12	9	135	0	7467
22724	7234	17	14	87	0	7352
22725	7328	8	13	41	0	7390
22726	119	18	13	7291	0	7441
22727	79	15	7204	84	0	7382
22728	6951	17	63	85	0	7116
22729	67	15	59	6893	0	7034
22730	67	7011	17	87	0	7182
22731	31	67	16	6990	0	7104
22732	28	7054	8	89	0	7179
22733	28	66	18	7209	0	7321
22734	22	63	6994	102	0	7181
22735	19	7120	71	112	0	7322
22736	17	96	59	6545	0	6717
22737	15	59	12	6381	0	6467
22738	20	20	15	6468	0	6523
22739	6666	14	9	125	0	6814
22740	74	6919	15	86	0	7094
22741	73	83	7	6978	0	7141
22742	7094	78	10	114	0	7296
22743	7135	23	12	108	0	7278
22744	157	23	6	7171	0	7357
22745	111	15	7234	115	0	7475
22746	42	15	85	7051	0	7193
22747	35	7128	84	137	0	7384
22748	22	96	26	7299	0	7443
22749	7144	87	15	137	0	7383
22750	107	21	20	7368	0	7516
22751	104	20	7312	146	0	7582
22752	37	7674	88	135	0	7934
22753	7745	110	88	56	0	7999
22754	118	98	7934	66	0	8216
22755	7916	19	124	45	0	8104
22756	137	16	113	8044	0	8310
22757	126	19	38	8018	0	8201
22758	38	8204	29	239	0	8510
22759	8660	110	34	157	0	8961
22760	145	109	34	8616	0	8904
22761	127	25	33	8686	0	8871
22762	51	24	29	8918	0	9022
22763	38	19	8825	266	0	9148
22764	32	26	133	8838	0	9029
22765	8751	22	124	167	0	9064
22766	8871	14	42	161	0	9088
22767	237	26	30	8727	0	9020
22768	143	23	25	8889	0	9080
22769	8815	21	20	252	0	9108
22770	154	23	8743	156	0	9076
22771	8806	32	124	61	0	9023
22772	161	27	8853	49	0	9090
22773	130	26	8722	85	0	8963
22774	61	36	223	8503	0	8823
22775	52	29	8683	163	0	8927
22776	8298	32	138	147	0	8615
22777	156	27	114	8334	0	8631
22778	152	18	8288	162	0	8620
22779	7991	23	124	145	0	8283
22780	8231	29	107	53	0	8420
22781	253	23	8412	55	0	8743
22782	153	68	117	7973	0	8311
22783	55	8487	107	139	0	8788
22784	8520	118	23	123	0	8784
22785	156	109	8446	61	0	8772
22786	7603	29	116	38	0	7786
22787	127	7567	94	48	0	7836
22788	7052	89	74	33	0	7248
22789	6862	74	9	36	0	6981
22790	6931	19	16	40	0	7006
22791	169	47	25	6910	0	7151
22792	106	7010	13	115	0	7244
22793	45	99	7014	98	0	7256
22794	41	7002	84	165	0	7292
22795	46	170	91	6462	0	6769
22796	29	6773	31	113	0	6946
22797	23	6886	29	107	0	7045
22798	6674	154	32	41	0	6901
22799	118	82	6575	45	0	6820
22800	99	29	6797	48	0	6973
22801	45	44	6428	50	0	6567
22802	34	6360	140	50	0	6584
22803	6231	84	110	47	0	6472
22804	6177	73	36	44	0	6330
22805	6271	25	28	38	0	6362
22806	158	6191	27	46	0	6422
22807	92	71	25	6505	0	6693
22808	51	71	6355	116	0	6593
22809	43	32	6358	97	0	6530
22810	6261	19	136	68	0	6484
22811	6419	26	92	45	0	6582
22812	6493	14	30	43	0	6580
22813	161	9	6349	69	0	6588
22814	6295	14	98	68	0	6475
22815	126	16	89	6315	0	6546
22816	120	18	43	6341	0	6522
22817	64	24	6663	178	0	6929
22818	58	6655	102	135	0	6950
22819	62	88	93	6588	0	6831
22820	60	73	6450	143	0	6726
22821	6179	33	113	130	0	6455
22822	153	19	94	6420	0	6686
22823	111	23	63	6458	0	6655
22824	6397	20	58	187	0	6662
22825	144	14	48	6449	0	6655
22826	6473	19	61	153	0	6706
22827	6441	23	48	141	0	6653
22828	200	18	59	6452	0	6729
22829	141	19	68	6499	0	6727
22830	6399	17	43	198	0	6657
22831	155	13	72	6430	0	6670
22832	6569	14	70	130	0	6783
22833	6368	28	55	121	0	6572
22834	6286	21	69	104	0	6480
22835	217	20	65	6099	0	6401
22836	144	25	69	6140	0	6378
22837	6063	24	67	169	0	6323
22838	137	6024	75	106	0	6342
22839	107	5634	58	45	0	5844
22840	5406	107	60	34	0	5607
22841	112	60	5518	30	0	5720
22842	5355	24	84	34	0	5497
22843	99	16	70	5708	0	5893
22844	81	25	5950	64	0	6120
22845	5931	21	65	49	0	6066
22846	89	27	65	5925	0	6106
22847	83	18	42	6214	0	6357
22848	54	33	29	6550	0	6666
22849	66	33	25	6584	0	6708
22850	6480	29	28	90	0	6627
22851	87	6478	27	56	0	6648
22852	6064	44	19	27	0	6154
22853	69	44	5992	11	0	6116
22854	70	14	5815	10	0	5909
22855	30	6178	43	18	0	6269
22856	33	172	18	5918	0	6141
22857	18	26	6165	27	0	6236
22858	15	5809	15	81	0	5920
22859	2	8	5503	7	0	5520
22860	3	8	8	5402	0	5421
22861	1	2	5	5349	0	5357
22862	5462	2	2	13	0	5479
22863	7	0	1	5372	0	5380
22864	5450	1	1	11	0	5463
22865	14	0	5592	9	0	5615
22866	1	5597	7	6	0	5611
22867	3	5	2	5846	0	5856
22868	3	5	2	6575	0	6585
22869	4	5	6939	8	0	6956
22870	7	2	6748	6	0	6763
22871	6599	1	11	13	0	6624
22872	7060	2	5	11	0	7078
22873	8	3	1	6953	0	6965
22874	2	0	1	6926	0	6929
22875	4	6963	3	8	0	6978
22876	1	12	1	7155	0	7169
22877	7289	3	3	10	0	7305
22878	7274	4	2	8	0	7288
22879	6	7608	1	14	0	7629
22880	7623	10	1	12	0	7646
22881	7286	3	1	8	0	7298
22882	14	3	2	7878	0	7897
22883	8	8081	1	24	0	8114
22884	6	18	4	8249	0	8277
22885	2	11	1	8426	0	8440
22886	7	2	8377	41	0	8427
22887	8497	2	24	23	0	8546
22888	27	1	15	9009	0	9052
22889	25	5	2	9605	0	9637
22890	5	12089	4	67	0	12165
22891	6	111	2	12528	0	12647
22892	12594	61	12	138	0	12805
22893	13232	9	7	89	0	13337
22894	203	4	13422	17	0	13646
22895	106	6	13516	7	0	13635
22896	16	19	227	13310	0	13572
22897	8	5	95	14107	0	14215
22898	19	5	14030	224	0	14278
22899	29	5	14053	112	0	14199
22900	0	2	232	13627	0	13861
22901	16	5	14300	143	0	14464
22902	21	6	14323	104	0	14454
22903	7	2	232	14070	0	14311
22904	14244	6	111	143	0	14504
22905	14502	4	22	107	0	14635
22906	234	14	14	14270	0	14532
22907	114	7	10	14508	0	14639
22908	14426	8	6	233	0	14673
22909	141	3	7	14327	0	14478
22910	14341	8	11	147	0	14507
22911	14276	15	15	123	0	14429
22912	246	15	11	14281	0	14553
22913	122	13	12	14580	0	14727
22914	14327	13	17	262	0	14619
22915	146	14406	16	156	0	14724
22916	122	14667	25	48	0	14862
22917	27	252	28	14215	0	14522
22918	34	112	14275	162	0	14583
22919	18	18	161	14257	0	14454
22920	14296	7	137	178	0	14618
22921	140	13	42	14387	0	14582
22922	14526	11	42	168	0	14747
22923	158	9	14385	156	0	14708
22924	14293	11	168	48	0	14520
22925	156	7	144	14686	0	14993
22926	132	4	49	14919	0	15104
22927	64	5	16088	281	0	16438
22928	46	7	159	15903	0	16115
22929	42	8	141	15964	0	16155
22930	41	7	42	16601	0	16691
22931	16688	15	36	301	0	17040
22932	183	16	16625	180	0	17004
22933	173	16	16547	71	0	16807
22934	16331	8	268	84	0	16691
22935	16658	14	146	61	0	16879
22936	308	22	17211	83	0	17624
22937	176	64	171	16786	0	17197
22938	59	17523	162	203	0	17947
22939	58	167	59	17858	0	18142
22940	17794	123	57	236	0	18210
22941	17830	29	71	193	0	18123
22942	301	22	81	17722	0	18126
22943	167	18299	96	247	0	18809
22944	72	149	84	17896	0	18201
22945	84	18260	75	243	0	18662
22946	18263	152	91	221	0	18727
22947	17611	140	113	98	0	17962
22948	17709	24	93	142	0	17968
22949	300	17653	93	159	0	18205
22950	162	17874	112	148	0	18296
22951	100	280	87	17962	0	18429
22952	109	125	78	17930	0	18242
22953	129	30	80	17980	0	18219
22954	107	17	77	18320	0	18521
22955	111	17	17792	397	0	18317
22956	16888	27	200	262	0	17377
22957	273	27	18170	147	0	18617
22958	18287	39	210	148	0	18684
22959	287	35	19006	143	0	19471
22960	18971	26	221	169	0	19387
22961	275	38	19729	161	0	20203
22962	19211	28	210	165	0	19614
22963	306	49	190	19564	0	20109
22964	20314	59	90	277	0	20740
22965	285	46	74	21142	0	21547
22966	277	45	85	21193	0	21600
22967	147	39	73	20974	0	21233
22968	124	20326	54	424	0	20928
22969	20073	200	63	290	0	20626
22970	19839	173	65	153	0	20230
22971	375	20548	72	186	0	21181
22972	283	200	61	20628	0	21172
22973	145	170	20501	321	0	21137
22974	19903	61	204	303	0	20471
22975	20336	42	208	180	0	20766
22976	20307	34	95	160	0	20596
22977	405	35	66	20126	0	20632
22978	270	20074	65	291	0	20700
22979	137	182	87	20189	0	20595
22980	20077	163	90	287	0	20617
22981	257	59	99	19899	0	20314
22982	231	19754	95	264	0	20344
22983	19519	164	76	234	0	19993
22984	265	162	19909	113	0	20449
22985	268	44	19877	130	0	20319
22986	119	19851	327	177	0	20474
22987	118	19606	177	127	0	20028
22988	338	284	19121	110	0	19853
22989	186	149	18419	90	0	18844
22990	54	187	185	15068	0	15494
22991	15959	31	114	88	0	16192
22992	96	20	16199	164	0	16479
22993	73	15976	54	44	0	16147
22994	16026	47	94	25	0	16192
22995	59	15943	14	68	0	16084
22996	15708	50	3	21	0	15782
22997	52	15783	5	27	0	15867
22998	51	16116	13	26	0	16206
22999	25	90	28	16255	0	16398
23000	18	49	7	16317	0	16391
23001	29	16	16082	80	0	16207
23002	14	10	41	15812	0	15877
23003	16016	12	39	60	0	16127
23004	15855	9	18	63	0	15945
23005	84	7	4	15863	0	15958
23006	68	10	15847	55	0	15980
23007	25	8	15447	54	0	15534
23008	11	10	74	15713	0	15808
23009	27	10	16275	58	0	16370
23010	15	11	44	15961	0	16031
23011	14	18	69	15579	0	15680
23012	18	12	17066	135	0	17231
23013	16070	11	69	80	0	16230
23014	16995	11	80	24	0	17110
23015	120	11	17134	15	0	17280
23016	92	10	16919	101	0	17122
23017	28	14	137	16826	0	17005
23018	19	16	95	18088	0	18218
23019	22	23	25	18489	0	18559
23020	18	22	34	18334	0	18408
23021	18570	15	15	186	0	18786
23022	19192	9	18	139	0	19358
23023	182	23	17	20418	0	20640
23024	132	15	14	21623	0	21784
23025	53	22	22995	240	0	23310
23026	27	16	150	23269	0	23462
23027	27	14	194	24149	0	24384
23028	25173	17	44	424	0	25658
23029	246	27594	18	304	0	28162
23030	262	332	18	27094	0	27706
23031	49	278	22	27229	0	27578
23032	29	53	23	27063	0	27168
23033	29	26034	25	622	0	26710
23034	27	27261	27	351	0	27666
23035	25	684	27	26680	0	27416
23036	26	326	25	26255	0	26632
23037	29	49	22	27181	0	27281
23038	25998	39	24	613	0	26674
23039	281	26358	19	479	0	27137
23040	26770	290	23	92	0	27175
23041	26713	291	25	70	0	27099
23042	566	65	29	26153	0	26813
23043	344	25887	26	348	0	26605
23044	25913	295	24	344	0	26576
23045	315	316	16	25843	0	26490
23046	26208	66	33	350	0	26657
23047	363	25	25	26380	0	26793
23048	327	42	26140	408	0	26917
23049	120	34	26289	379	0	26822
23050	60	51	564	25929	0	26604
23051	53	59	344	25695	0	26151
23052	48	51	74	25913	0	26086
23053	58	25705	46	698	0	26507
23054	46	26428	33	441	0	26948
23055	25836	592	34	165	0	26627
23056	25353	383	28	142	0	25906
23057	586	25571	32	166	0	26355
23058	332	25062	33	165	0	25592
23059	89	25553	25	164	0	25831
23060	24244	591	107	153	0	25095
23061	298	24805	21	147	0	25271
23062	319	386	16	24520	0	25241
23063	24258	335	13	380	0	24986
23064	23650	123	19	401	0	24193
23065	597	65	21	22867	0	23550
23066	406	66	22561	377	0	23410
23067	143	71	22650	384	0	23248
23068	117	68	519	22584	0	23288
23069	131	61	22896	397	0	23485
23070	102	66	337	22576	0	23081
23071	86	75	305	22251	0	22717
23072	121	65	22160	653	0	22999
23073	115	60	22292	451	0	22918
23074	126	58	575	21775	0	22534
23075	102	83	357	22604	0	23146
23076	22219	85	111	681	0	23096
23077	332	22193	95	476	0	23096
23078	336	23087	81	284	0	23788
23079	22378	622	59	196	0	23255
23080	23013	410	49	213	0	23685
23081	640	22992	43	242	0	23917
23082	421	23071	51	206	0	23749
23083	22899	677	49	173	0	23798
23084	414	431	42	22512	0	23399
23085	22331	168	57	468	0	23024
23086	426	22172	52	493	0	23143
23087	22390	415	45	272	0	23122
23088	470	392	22033	225	0	23120
23089	22042	165	343	215	0	22765
23090	474	119	22151	247	0	22991
23091	434	167	399	21516	0	22516
23092	21315	111	353	499	0	22278
23093	422	99	20842	550	0	21913
23094	393	117	379	20777	0	21666
23095	20601	124	380	500	0	21605
23096	418	139	20679	543	0	21779
23097	428	137	369	20539	0	21473
23098	19995	132	344	508	0	20979
23099	379	20004	117	560	0	21060
23100	417	413	92	19971	0	20893
23101	240	398	104	19829	0	20571
23102	208	195	83	19993	0	20479
23103	154	20021	65	769	0	21009
23104	254	457	54	20448	0	21213
23105	210	410	61	20428	0	21109
23106	231	213	69	20640	0	21153
23107	261	179	59	21103	0	21602
23108	250	184	20505	781	0	21720
23109	19646	170	367	476	0	20659
23110	20173	171	344	212	0	20900
23111	729	20070	124	218	0	21141
23112	479	416	97	19102	0	20094
23113	266	362	105	19226	0	19959
23114	190	19270	101	746	0	20307
23115	170	369	130	19412	0	20081
23116	18550	344	137	505	0	19536
23117	417	18448	136	459	0	19460
23118	17662	350	175	193	0	18380
23119	416	301	157	17357	0	18231
23120	352	130	17344	458	0	18284
23121	147	17474	364	399	0	18384
23122	16071	460	315	217	0	17063
23123	341	15523	107	150	0	16121
23124	328	14870	77	142	0	15417
23125	12835	406	99	121	0	13461
23126	305	192	12520	102	0	13119
23127	131	11110	187	68	0	11496
23128	8485	424	550	432	0	9891
23129	6904	119	67	19	0	7109
23130	120	6966	14	26	0	7126
23131	63	72	10	7218	0	7363
23132	22	51	7426	94	0	7593
23133	15	21	72	7340	0	7448
23134	16	15	56	7255	0	7342
23135	22	15	22	7576	0	7635
23136	18	9	7467	141	0	7635
23137	25	14	68	7289	0	7396
23138	13	16	7458	96	0	7583
23139	20	14	7161	75	0	7270
23140	6385	13	102	34	0	6534
23141	73	7036	52	29	0	7190
23142	44	7181	13	24	0	7262
23143	20	105	31	7201	0	7357
23144	7792	49	7	70	0	7918
23145	7743	20	13	47	0	7823
23146	7570	16	11	32	0	7629
23147	7612	20	13	15	0	7660
23148	7306	8	9	18	0	7341
23149	116	21	7418	21	0	7576
23150	70	23	64	7233	0	7390
23151	33	7237	49	75	0	7394
23152	25	72	18	7338	0	7453
23153	7361	54	12	89	0	7516
23154	76	7439	8	78	0	7601
23155	63	73	12	7526	0	7674
23156	7663	62	17	80	0	7822
23157	7971	14	16	69	0	8070
23158	117	11	25	7951	0	8104
23159	60	24	11	7802	0	7897
23160	31	17	17	7965	0	8030
23161	22	12	7739	145	0	7918
23162	24	24	7983	70	0	8101
23163	19	20	106	8058	0	8203
23164	28	7	62	8149	0	8246
23165	8158	21	19	123	0	8321
23166	8088	23	15	72	0	8198
23167	8067	11	10	51	0	8139
23168	8420	18	22	23	0	8483
23169	8380	32	11	38	0	8461
23170	133	8617	15	27	0	8792
23171	8718	79	14	42	0	8853
23172	8676	64	16	35	0	8791
23173	8652	31	6	35	0	8724
23174	138	17	15	9036	0	9206
23175	72	26	8964	106	0	9168
23176	50	107	82	9005	0	9244
23177	51	23	9872	112	0	10058
23178	25	25	94	9030	0	9174
23179	27	9362	56	164	0	9609
23180	9176	60	19	62	0	9317
23181	9118	60	15	39	0	9232
23182	110	19	8	9231	0	9368
23183	69	10	10	9713	0	9802
23184	28	12	16	9866	0	9922
23185	21	10101	7	124	0	10253
23186	10101	59	15	70	0	10245
23187	9999	58	18	26	0	10101
23188	123	10219	14	21	0	10377
23189	78	71	10	10220	0	10379
23190	36	60	16	10006	0	10118
23191	31	10432	5	130	0	10598
23192	10507	72	7	69	0	10655
23193	10470	67	17	28	0	10582
23194	150	20	10	10607	0	10787
23195	99	14	10748	81	0	10942
23196	45	12	10553	85	0	10695
23197	32	9	133	10912	0	11086
23198	23	25	78	10681	0	10807
23199	31	19	19	11163	0	11232
23200	11341	10	24	170	0	11545
23201	11357	12	15	125	0	11509
23202	148	11833	18	129	0	12128
23203	12431	80	46	44	0	12601
23204	114	70	12640	24	0	12848
23205	104	24	12548	34	0	12710
23206	30	13196	146	35	0	13407
23207	12826	91	103	26	0	13046
23208	91	12820	10	33	0	12954
23209	12858	90	15	22	0	12985
23210	117	75	12980	23	0	13195
23211	100	22	12952	24	0	13098
23212	39	146	142	12759	0	13086
23213	44	16	13660	93	0	13813
23214	32	14	89	13431	0	13566
23215	36	27	97	12937	0	13097
23216	24	13544	21	169	0	13758
23217	25	95	16	13697	0	13833
23218	29	77	17	13815	0	13938
23219	14225	25	13	184	0	14447
23220	112	14323	19	113	0	14567
23221	97	105	22	14744	0	14968
23222	46	87	14657	137	0	14927
23223	13337	30	113	134	0	13614
23224	127	24	14455	54	0	14660
23225	121	58	105	13764	0	14048
23226	56	14869	95	125	0	15145
23227	38	129	28	14777	0	14972
23228	14917	118	19	159	0	15213
23229	14870	34	24	147	0	15075
23230	235	15458	21	71	0	15785
23231	15702	123	18	51	0	15894
23232	15436	137	17	40	0	15630
23233	15763	59	26	49	0	15897
23234	15981	34	19	64	0	16098
23235	15725	29	31	71	0	15856
23236	252	51	15624	42	0	15969
23237	167	27	136	15338	0	15668
23238	62	33	137	15388	0	15620
23239	45	39	41	15435	0	15560
23240	52	15514	41	269	0	15876
23241	59	116	38	15580	0	15793
23242	60	137	15617	179	0	15993
23243	51	15327	140	180	0	15698
23244	51	15220	130	77	0	15478
23245	59	231	47	15239	0	15576
23246	55	148	38	15092	0	15333
23247	62	48	50	15097	0	15257
23248	65	14933	36	363	0	15397
23249	64	15257	54	168	0	15543
23250	15345	247	43	85	0	15720
23251	15251	154	45	63	0	15513
23252	266	15432	51	60	0	15809
23253	15789	148	39	67	0	16043
23254	16630	138	49	64	0	16881
23255	270	47	60	16652	0	17029
23256	165	51	67	16811	0	17094
23257	84	36	51	16854	0	17025
23258	79	55	16743	285	0	17162
23259	94	54	16895	200	0	17243
23260	93	17498	245	120	0	17956
23261	17863	175	175	86	0	18299
23262	210	174	17994	84	0	18462
23263	17796	81	184	87	0	18148
23264	245	60	19217	93	0	19615
23265	18978	76	235	84	0	19373
23266	257	20028	199	102	0	20586
23267	20316	225	85	95	0	20721
23268	272	225	71	19861	0	20429
23269	229	84	69	20633	0	21015
23270	140	69	21723	404	0	22336
23271	88	22070	203	321	0	22682
23272	86	254	204	22407	0	22951
23273	113	223	22272	264	0	22872
23274	19684	83	240	226	0	20233
23275	221	21803	220	123	0	22367
23276	21550	226	66	93	0	21935
23277	248	21081	56	121	0	21506
23278	190	227	50	20912	0	21379
23279	20693	182	42	263	0	21180
23280	199	20688	68	269	0	21224
23281	200	209	61	21100	0	21570
23282	102	198	20813	255	0	21368
23283	19159	88	215	205	0	19667
23284	229	62	174	20538	0	21003
23285	206	56	20424	244	0	20930
23286	106	20464	189	265	0	21024
23287	95	210	176	20603	0	21084
23288	122	177	20972	251	0	21522
23289	101	83	197	20057	0	20438
23290	105	21150	178	216	0	21649
23291	86	21222	55	212	0	21575
23292	124	306	21323	81	0	21834
23293	134	196	227	20632	0	21189
23294	88	72	21287	227	0	21674
23295	19933	53	205	200	0	20391
23296	203	79	164	20762	0	21208
23297	181	20814	55	223	0	21273
23298	95	21778	48	169	0	22090
23299	21449	298	75	74	0	21896
23300	195	21962	39	84	0	22280
23301	21894	200	62	61	0	22217
23302	239	179	21457	54	0	21929
23303	19486	66	154	52	0	19758
23304	189	20596	141	62	0	20988
23305	20531	155	52	60	0	20798
23306	173	20356	44	53	0	20626
23307	156	177	32	19944	0	20309
23308	65	159	33	20696	0	20953
23309	56	65	20931	274	0	21326
23310	19492	53	154	192	0	19891
23311	152	59	21032	204	0	21447
23312	20510	44	186	61	0	20801
23313	169	65	142	20417	0	20793
23314	144	56	61	20857	0	21118
23315	65	21426	61	276	0	21828
23316	58	182	45	21519	0	21804
23317	50	159	43	22009	0	22261
23318	73	67	22179	281	0	22600
23319	19943	66	164	178	0	20351
23320	171	21573	141	92	0	21977
23321	21596	165	54	69	0	21884
23322	188	154	36	21211	0	21589
23323	141	52	52	21628	0	21873
23324	21648	37	60	290	0	22035
23325	194	22503	55	238	0	22990
23326	22322	196	35	59	0	22612
23327	222	22138	41	70	0	22471
23328	139	22319	38	60	0	22556
23329	22361	282	124	63	0	22830
23330	196	173	41	21835	0	22245
23331	162	63	22048	205	0	22478
23332	58	59	184	21692	0	21993
23333	38	53	148	21490	0	21729
23334	60	21741	64	305	0	22170
23335	52	218	34	22052	0	22356
23336	56	162	43	21777	0	22038
23337	62	66	39	22156	0	22323
23338	43	54	32	22675	0	22804
23339	65	62	22642	347	0	23116
23340	52	67	23100	205	0	23424
23341	55	62	323	23395	0	23835
23342	63	51	23474	258	0	23846
23343	81	59	23345	174	0	23659
23344	76	70	345	23245	0	23736
23345	74	58	24110	273	0	24515
23346	75	86	242	22803	0	23206
23347	65	23744	185	243	0	24237
23348	25243	235	60	199	0	25737
23349	265	191	26509	96	0	27061
23350	250	85	247	26462	0	27044
23351	72	78	27199	303	0	27652
23352	82	85	285	28947	0	29399
23353	64	68	255	29894	0	30281
23354	29570	60	86	578	0	30294
23355	335	61	58	30514	0	30968
23356	29397	91	54	439	0	29981
23357	29532	73	65	367	0	30037
23358	601	30045	58	152	0	30856
23359	29777	348	30	117	0	30272
23360	358	29376	62	112	0	29908
23361	304	30058	60	105	0	30527
23362	29436	590	240	104	0	30370
23363	458	323	29197	93	0	30071
23364	330	57	28103	97	0	28587
23365	26714	141	598	87	0	27540
23366	27025	30	385	82	0	27522
23367	491	27294	83	102	0	27970
23368	27545	283	66	79	0	27973
23369	26598	281	75	83	0	27037
23370	25997	68	53	92	0	26210
23371	551	294	60	25404	0	26309
23372	25389	32	68	343	0	25832
23373	313	25720	73	351	0	26457
23374	301	276	78	25772	0	26427
23375	116	264	65	25851	0	26296
23376	74	25966	68	591	0	26699
23377	103	283	74	26355	0	26815
23378	25787	283	63	391	0	26524
23379	25780	98	71	358	0	26307
23380	591	25591	74	160	0	26416
23381	367	25934	63	141	0	26505
23382	25887	563	79	113	0	26642
23383	409	331	25517	123	0	26380
23384	383	96	25538	143	0	26160
23385	207	83	583	24627	0	25500
23386	162	79	376	25303	0	25920
23387	181	81	25138	600	0	26000
23388	189	24160	338	576	0	25263
23389	197	374	336	24229	0	25136
23390	223	342	24497	361	0	25423
23391	205	117	364	24250	0	24936
23392	161	121	360	23527	0	24169
23393	179	24655	118	576	0	25528
23394	189	365	104	24299	0	24957
23395	161	389	121	24194	0	24865
23396	199	145	101	24773	0	25218
23397	24315	105	113	650	0	25183
23398	453	104	94	23383	0	24034
23399	449	23623	83	599	0	24754
23400	23539	354	86	383	0	24362
23401	495	376	22819	249	0	23939
23402	499	150	22486	195	0	23330
23403	370	132	22959	210	0	23671
23404	219	140	599	22761	0	23719
23405	241	122	23342	462	0	24167
23406	212	125	412	22722	0	23471
23407	198	157	369	22863	0	23587
23408	22359	163	209	686	0	23417
23409	21721	166	154	492	0	22533
23410	703	22202	145	283	0	23333
23411	517	382	152	21865	0	22916
23412	299	392	22285	485	0	23461
23413	364	23479	518	508	0	24869
23414	23393	399	366	253	0	24411
23415	483	23782	171	249	0	24685
23416	24028	430	135	228	0	24821
23417	559	384	23558	239	0	24740
23418	22970	223	397	225	0	23815
23419	23784	189	371	212	0	24556
23420	746	187	24327	238	0	25498
23421	497	227	414	23182	0	24320
23422	292	24147	384	468	0	25291
23423	251	24726	178	479	0	25634
23424	227	24986	193	268	0	25674
23425	561	638	176	23344	0	24719
23426	276	403	23116	475	0	24270
23427	297	231	321	22801	0	23650
23428	299	181	300	23219	0	23999
23429	297	143	22988	622	0	24050
23430	256	22923	369	431	0	23979
23431	258	382	349	22692	0	23681
23432	22814	331	178	470	0	23793
23433	421	204	180	22821	0	23626
23434	399	186	146	22830	0	23561
23435	225	22790	131	815	0	23961
23436	23224	386	131	492	0	24233
23437	434	387	125	23809	0	24755
23438	420	195	23472	492	0	24579
23439	248	23285	321	435	0	24289
23440	22694	339	343	232	0	23608
23441	375	387	22675	190	0	23627
23442	22040	297	340	197	0	22874
23443	438	213	348	21793	0	22792
23444	346	22476	226	360	0	23408
23445	22153	336	181	358	0	23028
23446	21932	331	165	261	0	22689
23447	522	23127	183	239	0	24071
23448	286	297	170	21722	0	22475
23449	118	263	111	20625	0	21117
23450	19792	165	126	432	0	20515
23451	245	20038	127	322	0	20732
23452	122	289	76	16885	0	17372
23453	57	16527	65	195	0	16844
23454	37	16074	60	151	0	16322
23455	30	225	23	15221	0	15499
23456	15206	106	29	145	0	15486
23457	87	15370	40	102	0	15599
23458	150	184	35	15163	0	15532
23459	41	58	15	15098	0	15212
23460	87	40	15172	163	0	15462
23461	41	38	14753	103	0	14935
23462	26	15314	115	91	0	15546
23463	45	94	15316	51	0	15506
23464	36	63	102	15154	0	15355
23465	44	55	15893	121	0	16113
23466	26	42	112	15764	0	15944
23467	39	44	67	16283	0	16433
23468	50	35	36	16435	0	16556
23469	16408	27	41	167	0	16643
23470	100	45	26	16455	0	16626
23471	71	41	21	16410	0	16543
23472	61	16515	30	153	0	16759
23473	56	115	25	16462	0	16658
23474	16966	62	26	147	0	17201
23475	96	17719	25	109	0	17949
23476	17884	130	21	79	0	18114
23477	137	74	17785	66	0	18062
23478	95	66	18167	49	0	18377
23479	60	56	127	18060	0	18303
23480	35	52	75	18515	0	18677
23481	30	18819	48	174	0	19071
23482	55	152	31	18535	0	18773
23483	18633	88	31	178	0	18930
23484	18181	70	42	117	0	18410
23485	152	133	23	18960	0	19268
23486	105	49	20707	164	0	21025
23487	67	49	123	20486	0	20725
23488	48	65	80	21072	0	21265
23489	37	56	66	21457	0	21616
23490	36	64	52	21246	0	21398
23491	32	48	44	21086	0	21210
23492	34	21313	63	309	0	21719
23493	21136	141	52	169	0	21498
23494	20752	109	52	119	0	21032
23495	21190	66	49	119	0	21424
23496	216	22130	34	109	0	22489
23497	22001	146	36	112	0	22295
23498	161	22227	29	115	0	22532
23499	142	176	22242	101	0	22661
23500	91	124	128	21640	0	21983
23501	91	72	22458	282	0	22903
23502	62	22874	151	181	0	23268
23503	22388	207	219	113	0	22927
23504	160	141	23228	92	0	23621
23505	157	84	24405	95	0	24741
23506	80	25140	264	93	0	25577
23507	94	210	160	25524	0	25988
23508	78	163	27023	240	0	27504
23509	74	89	238	26638	0	27039
23510	79	59	192	29226	0	29556
23511	43	46	76	31406	0	31571
23512	33181	52	56	539	0	33828
23513	32177	61	34	353	0	32625
23514	566	46	40	32615	0	33267
23515	33180	52	63	426	0	33721
23516	480	43	32566	341	0	33430
23517	344	39	32327	126	0	32836
23518	131	60	32798	111	0	33100
23519	102	29	33041	83	0	33255
23520	48	31900	593	123	0	32664
23521	78	476	361	30985	0	31900
23522	75	254	32007	312	0	32648
23523	29667	66	355	287	0	30375
23524	31654	31	300	80	0	32065
23525	526	31840	85	88	0	32539
23526	31950	300	63	60	0	32373
23527	346	266	56	31778	0	32446
23528	306	61	33018	344	0	33729
23529	89	50	343	31285	0	31767
23530	62	33576	286	353	0	34277
23531	33192	322	85	299	0	33898
23532	33078	281	63	110	0	33532
23533	556	33558	48	177	0	34339
23534	33757	312	55	78	0	34202
23535	33289	266	77	53	0	33685
23536	577	33919	49	111	0	34656
23537	329	339	47	32868	0	33583
23538	105	33402	51	343	0	33901
23539	33389	364	60	306	0	34119
23540	368	307	70	33150	0	33895
23541	33515	87	62	358	0	34022
23542	423	64	46	33543	0	34076
23543	342	70	33468	382	0	34262
23544	32458	55	357	332	0	33202
23545	420	57	33751	116	0	34344
23546	341	52	402	32955	0	33750
23547	139	51	33272	384	0	33846
23548	95	58	410	32849	0	33412
23549	110	78	33562	413	0	34163
23550	32119	42	412	371	0	32944
23551	394	33131	336	125	0	33986
23552	33322	348	115	109	0	33894
23553	455	304	79	32861	0	33699
23554	32928	98	78	388	0	33492
23555	435	32887	88	397	0	33807
23556	347	32689	96	169	0	33301
23557	159	34465	76	140	0	34840
23558	34299	626	131	97	0	35153
23559	405	392	134	33849	0	34780
23560	365	114	85	34308	0	34872
23561	170	78	33866	631	0	34745
23562	174	80	33355	348	0	33957
23563	139	94	598	33424	0	34255
23564	150	93	34761	420	0	35424
23565	128	34356	425	407	0	35316
23566	34235	376	383	156	0	35150
23567	449	340	34568	141	0	35498
23568	400	120	34460	122	0	35102
23569	157	156	675	33188	0	34176
23570	34220	65	383	403	0	35071
23571	429	57	161	34513	0	35160
23572	34397	82	153	442	0	35074
23573	503	85	132	34496	0	35216
23574	392	95	35405	435	0	36327
23575	174	35038	443	431	0	36086
23576	205	382	36386	196	0	37169
23577	129	36587	474	165	0	37355
23578	144	433	390	35591	0	36558
23579	35697	339	150	435	0	36621
23580	461	124	35856	409	0	36850
23581	433	87	414	34960	0	35894
23582	211	107	340	35859	0	36517
23583	36619	98	150	693	0	37560
23584	489	106	124	36214	0	36933
23585	375	37123	142	452	0	38092
23586	35602	408	138	388	0	36536
23587	468	381	35487	167	0	36503
23588	34085	128	432	147	0	34792
23589	483	35797	339	213	0	36832
23590	453	481	132	34615	0	35681
23591	184	36131	101	406	0	36822
23592	35581	435	121	346	0	36483
23593	479	358	35953	147	0	36937
23594	34688	171	406	161	0	35426
23595	466	36147	340	141	0	37094
23596	388	394	121	35971	0	36874
23597	35945	303	123	441	0	36812
23598	36132	124	113	353	0	36722
23599	661	83	98	35620	0	36462
23600	370	93	112	35914	0	36489
23601	184	36081	92	722	0	37079
23602	125	615	120	35780	0	36640
23603	115	40424	119	472	0	41130
23604	121	42198	117	398	0	42834
23605	172	1213	121	39344	0	40850
23606	114	41548	96	442	0	42200
23607	223	427	41357	384	0	42391
23608	170	427	41940	177	0	42714
23609	114	42923	687	266	0	43990
23610	256	396	42428	128	0	43208
23611	137	408	42382	98	0	43025
23612	98	73	39958	69	0	40198
23613	46	39824	639	78	0	40587
23614	38624	378	494	60	0	39556
23615	286	39082	83	101	0	39552
23616	463	334	38390	220	0	39407
23617	74	314	321	37716	0	38425
23618	38112	85	285	305	0	38787
23619	335	38	38252	298	0	38923
23620	315	51	308	37778	0	38452
23621	94	45	38777	312	0	39228
23622	46	42	337	37601	0	38026
23623	37569	36	313	334	0	38252
23624	345	45	37794	321	0	38505
23625	295	37155	314	725	0	38489
23626	82	346	339	36598	0	37365
23627	37646	340	85	319	0	38390
23628	338	90	36964	309	0	37701
23629	327	92	374	34573	0	35366
23630	64	36570	358	270	0	37262
23631	36122	346	118	308	0	36894
23632	36454	341	110	80	0	36985
23633	611	134	85	36599	0	37429
23634	377	37579	99	365	0	38420
23635	114	38513	104	351	0	39082
23636	38696	661	101	112	0	39570
23637	383	449	116	37495	0	38443
23638	382	38926	105	379	0	39792
23639	38285	408	128	382	0	39203
23640	378	442	176	38181	0	39177
23641	416	132	122	38653	0	39323
23642	164	103	38675	723	0	39665
23643	82	38387	419	475	0	39363
23644	84	39146	431	188	0	39849
23645	94	700	172	38933	0	39899
23646	38845	438	129	423	0	39835
23647	392	38840	105	463	0	39800
23648	38909	418	110	149	0	39586
23649	498	38825	110	144	0	39577
23650	467	461	109	38562	0	39599
23651	38482	447	103	429	0	39461
23652	444	190	122	38900	0	39656
23653	461	149	38661	471	0	39742
23654	167	169	427	37301	0	38064
23655	132	38235	463	587	0	39417
23656	37759	482	153	448	0	38842
23657	431	37754	133	201	0	38519
23658	441	520	167	35732	0	36860
23659	187	506	127	37036	0	37856
23660	173	200	36605	820	0	37798
23661	181	227	36397	699	0	37504
23662	109	208	803	36488	0	37608
23663	183	190	36841	495	0	37709
23664	142	36046	487	537	0	37212
23665	35692	488	453	198	0	36831
23666	477	536	36354	151	0	37518
23667	35431	248	478	195	0	36352
23668	35958	224	484	188	0	36854
23669	35833	200	241	183	0	36457
23670	36210	201	197	176	0	36784
23671	830	227	209	35282	0	36548
23672	524	239	202	34754	0	35719
23673	250	35251	200	803	0	36504
23674	34033	478	238	540	0	35289
23675	523	560	33458	228	0	34769
23676	513	289	487	31960	0	33249
23677	244	238	531	32021	0	33034
23678	231	230	32103	772	0	33336
23679	203	31958	483	637	0	33281
23680	334	532	550	30641	0	32057
23681	236	553	255	31993	0	33037
23682	31383	267	188	870	0	32708
23683	483	31037	163	655	0	32338
23684	577	474	191	30699	0	31941
23685	258	30520	205	565	0	31548
23686	271	506	176	30736	0	31689
23687	30124	501	186	589	0	31400
23688	29910	237	186	577	0	30910
23689	884	204	163	29558	0	30809
23690	29767	206	181	555	0	30709
23691	29247	235	164	568	0	30214
23692	836	29471	137	338	0	30782
23693	674	477	156	28291	0	29598
23694	318	29238	163	506	0	30225
23695	476	529	159	28653	0	29817
23696	28381	538	122	590	0	29631
23697	549	327	124	28480	0	29480
23698	616	249	120	28646	0	29631
23699	331	258	28380	902	0	29871
23700	240	27947	372	713	0	29272
23701	302	28405	391	361	0	29459
23702	27760	803	165	309	0	29037
23703	404	597	106	22279	0	23386
23704	20052	212	82	417	0	20763
23705	382	19379	80	474	0	20315
23706	374	18305	92	216	0	18987
23707	165	19188	79	221	0	19653
23708	16150	491	589	211	0	17441
23709	211	16036	71	140	0	16458
23710	14315	183	218	82	0	14798
23711	13374	164	33	67	0	13638
23712	14277	81	30	75	0	14463
23713	283	54	33	15586	0	15956
23714	202	59	33	16266	0	16560
23715	104	59	33	16372	0	16568
23716	84	66	36	16576	0	16762
23717	16343	56	34	391	0	16824
23718	204	16386	44	245	0	16879
23719	206	191	35	16332	0	16764
23720	16443	180	46	231	0	16900
23721	226	64	46	16157	0	16493
23722	199	67	30	16399	0	16695
23723	16433	48	47	355	0	16883
23724	235	58	16570	227	0	17090
23725	187	61	163	16384	0	16795
23726	94	42	17014	232	0	17382
23727	57	58	191	16658	0	16964
23728	64	163	185	16744	0	17156
23729	16607	44	51	347	0	17049
23730	185	16411	43	235	0	16874
23731	181	16079	37	74	0	16371
23732	15090	253	16	54	0	15413
23733	143	15759	24	50	0	15976
23734	15869	121	65	47	0	16102
23735	149	110	15836	33	0	16128
23736	14844	18	86	28	0	14976
23737	15128	14	78	22	0	15242
23738	15368	7	14	27	0	15416
23739	183	6	10	15056	0	15255
23740	101	7	5	15017	0	15130
23741	18	15111	9	196	0	15334
23742	15	94	9	14957	0	15075
23743	14643	87	11	127	0	14868
23744	96	15071	13	128	0	15308
23745	73	15083	7	41	0	15204
23746	15030	154	5	25	0	15214
23747	118	85	14939	22	0	15164
23748	80	19	96	14606	0	14801
23749	27	11	15372	108	0	15518
23750	22	10	100	14745	0	14877
23751	13	15208	71	100	0	15392
23752	19	99	11	15496	0	15625
23753	15212	74	20	105	0	15411
23754	97	12	9	15259	0	15377
23755	98	7	15528	143	0	15776
23756	14542	10	100	96	0	14748
23757	108	16143	78	46	0	16375
23758	92	17730	20	33	0	17875
23759	18343	194	8	14	0	18559
23760	19241	105	5	18	0	19369
23761	249	26	19569	21	0	19865
23762	18781	21	147	29	0	18978
23763	168	19355	109	41	0	19673
23764	19730	147	20	33	0	19930
23765	175	116	13	19023	0	19327
23766	132	18678	10	162	0	18982
23767	18815	156	10	127	0	19108
23768	183	127	19206	43	0	19559
23769	129	34	144	19062	0	19369
23770	19516	19	116	186	0	19837
23771	185	18	19472	149	0	19824
23772	19443	23	152	67	0	19685
23773	180	23	127	19167	0	19497
23774	150	20	29	19567	0	19766
23775	62	23	20156	304	0	20545
23776	39	18	159	20065	0	20281
23777	20205	22	131	220	0	20578
23778	178	19972	32	191	0	20373
23779	20116	171	15	76	0	20378
23780	20044	140	22	66	0	20272
23781	302	46	13	20066	0	20427
23782	187	33	20506	214	0	20940
23783	67	25	167	20537	0	20796
23784	20588	27	136	220	0	20971
23785	208	20434	49	168	0	20859
23786	20990	170	35	70	0	21265
23787	233	137	30	20598	0	20998
23788	188	46	30	20929	0	21193
23789	93	33	33	21241	0	21400
23790	81	37	21101	334	0	21553
23791	67	38	176	21236	0	21517
23792	76	50	21403	227	0	21756
23793	89	41	21440	168	0	21738
23794	76	51	303	23142	0	23572
23795	87	48	23811	235	0	24181
23796	25377	37	238	229	0	25881
23797	302	40	210	26836	0	27388
23798	346	38	59	26331	0	26774
23799	105	27577	35	532	0	28249
23800	27543	271	43	324	0	28181
23801	28349	320	188	98	0	28955
23802	596	29480	24	93	0	30193
23803	373	284	36	29626	0	30319
23804	123	317	29617	302	0	30359
23805	28362	87	285	345	0	29079
23806	29735	51	314	108	0	30208
23807	589	66	69	28725	0	29449
23808	396	54	28291	325	0	29066
23809	109	28333	285	402	0	29129
23810	27882	277	420	122	0	28701
23811	351	313	28009	87	0	28760
23812	307	27267	279	142	0	27995
23813	25481	200	323	51	0	26055
23814	24775	243	84	45	0	25147
23815	439	57	38	24484	0	25018
23816	310	24749	40	232	0	25331
23817	85	209	45	25737	0	26076
23818	64	252	46	25707	0	26069
23819	70	59	43	25453	0	25625
23820	57	35	44	26024	0	26160
23821	73	39	25660	517	0	26289
23822	77	30	210	25836	0	26153
23823	85	32	269	26168	0	26554
23824	93	40	25979	488	0	26600
23825	66	25806	225	375	0	26472
23826	25558	236	285	111	0	26190
23827	25354	301	87	71	0	25813
23828	499	75	47	25607	0	26228
23829	25910	35	57	268	0	26270
23830	301	43	48	26005	0	26397
23831	336	49	26394	313	0	27092
23832	152	34	26142	339	0	26667
23833	77	25641	491	144	0	26353
23834	24963	237	369	94	0	25663
23835	286	281	27091	93	0	27751
23836	335	81	266	25923	0	26605
23837	114	47	367	27504	0	28032
23838	93	49	104	28305	0	28551
23839	104	41	70	28581	0	28796
23840	90	45	60	28825	0	29020
23841	91	59	28302	751	0	29203
23842	103	51	281	28599	0	29034
23843	28393	63	407	381	0	29244
23844	332	28161	87	543	0	29123
23845	28397	289	66	177	0	28929
23846	347	28616	67	162	0	29192
23847	28505	352	72	117	0	29046
23848	28800	420	89	125	0	29434
23849	696	101	77	28215	0	29089
23850	501	63	80	28538	0	29182
23851	28173	62	68	715	0	29018
23852	27005	71	87	534	0	27697
23853	27977	65	97	175	0	28314
23854	700	27316	87	367	0	28470
23855	464	27621	91	321	0	28497
23856	204	600	27519	163	0	28486
23857	238	538	296	26050	0	27122
23858	127	103	25881	380	0	26491
23859	125	24993	303	503	0	25924
23860	87	390	377	23723	0	24577
23861	99	388	82	23547	0	24116
23862	85	109	74	24469	0	24737
23863	23974	66	74	627	0	24741
23864	23575	85	59	499	0	24218
23865	606	23951	68	211	0	24836
23866	477	251	77	24189	0	24994
23867	181	385	24081	330	0	24977
23868	155	116	23249	447	0	23967
23869	23130	75	582	174	0	23961
23870	23390	73	434	127	0	24024
23871	668	83	110	23242	0	24103
23872	23808	71	76	324	0	24279
23873	365	74	23251	467	0	24157
23874	433	23178	266	206	0	24083
23875	202	244	393	22653	0	23492
23876	126	392	23295	370	0	24183
23877	121	130	263	23329	0	23843
23878	138	91	414	23426	0	24069
23879	119	77	23517	722	0	24435
23880	22361	78	277	563	0	23279
23881	23443	73	391	265	0	24172
23882	604	24024	136	258	0	25022
23883	24911	292	101	228	0	25532
23884	24915	415	74	241	0	25645
23885	729	116	25177	225	0	26247
23886	24855	75	308	210	0	25448
23887	414	25842	424	279	0	26959
23888	26096	311	138	201	0	26746
23889	26316	449	106	200	0	27071
23890	26820	146	116	177	0	27259
23891	26384	126	111	168	0	26789
23892	26475	107	98	156	0	26836
23893	836	25894	90	226	0	27046
23894	24195	297	93	138	0	24723
23895	413	23644	83	192	0	24332
23896	348	20341	49	140	0	20878
23897	146	20677	57	110	0	20990
23898	20129	462	372	107	0	21070
23899	19697	286	54	133	0	20170
23900	514	67	19851	141	0	20573
23901	19804	70	233	94	0	20201
23902	19514	60	271	110	0	19955
23903	562	64	19777	89	0	20492
23904	365	88	233	19277	0	19963
23905	152	77	311	19380	0	19920
23906	117	78	77	19986	0	20258
23907	120	60	64	20192	0	20436
23908	130	74	69	20529	0	20802
23909	122	71	19952	575	0	20720
23910	124	20097	260	383	0	20864
23911	19983	263	294	123	0	20663
23912	348	20372	69	114	0	20903
23913	20417	274	58	77	0	20826
23914	20047	330	58	88	0	20523
23915	605	104	19838	79	0	20626
23916	436	246	271	18372	0	19325
23917	140	19337	316	239	0	20032
23918	19247	250	94	284	0	19875
23919	19237	324	75	77	0	19713
23920	19738	81	78	90	0	19987
23921	586	19559	60	108	0	20313
23922	19549	237	84	69	0	19939
23923	19234	295	59	76	0	19664
23924	19282	88	54	147	0	19571
23925	559	69	72	18666	0	19366
23926	395	67	70	18867	0	19399
23927	167	68	67	19323	0	19625
23928	18793	69	71	504	0	19437
23929	350	18931	58	325	0	19664
23930	19226	246	52	81	0	19605
23931	18344	301	57	56	0	18758
23932	18290	99	60	59	0	18508
23933	18443	76	56	57	0	18632
23934	598	18048	59	77	0	18782
23935	15761	209	37	48	0	16055
23936	306	15543	35	53	0	15937
23937	229	14578	34	49	0	14890
23938	14442	292	19	26	0	14779
23939	232	14386	22	31	0	14671
23940	209	14509	26	35	0	14779
23941	14558	282	59	30	0	14929
23942	14632	180	21	29	0	14862
23943	349	55	26	14220	0	14650
23944	227	49	21	14525	0	14822
23945	15038	47	25	291	0	15401
23946	15350	44	28	171	0	15593
23947	15504	53	31	64	0	15652
23948	381	56	14865	95	0	15397
23949	15398	51	153	61	0	15663
23950	258	60	148	15264	0	15730
23951	248	51	40	15313	0	15652
23952	141	57	33	15521	0	15752
23953	145	61	34	15611	0	15851
23954	150	60	15275	317	0	15802
23955	147	57	15390	184	0	15778
23956	123	70	281	15368	0	15842
23957	147	76	15596	213	0	16032
23958	143	62	15672	217	0	16094
23959	140	73	296	15491	0	16000
23960	154	63	191	15820	0	16228
23961	143	81	55	16067	0	16346
23962	154	86	40	15973	0	16253
23963	16064	88	33	397	0	16582
23964	17389	90	38	305	0	17822
23965	459	88	39	16968	0	17554
23966	334	74	47	16919	0	17374
23967	198	80	51	17081	0	17410
23968	176	79	35	16953	0	17243
23969	174	79	34	16984	0	17271
23970	192	17040	47	402	0	17681
23971	17121	221	52	239	0	17633
23972	314	17189	49	145	0	17697
23973	17471	248	40	114	0	17873
23974	17323	221	27	108	0	17679
23975	17460	77	37	94	0	17668
23976	489	80	31	16476	0	17076
23977	16764	78	43	262	0	17147
23978	340	85	37	16509	0	16971
23979	319	93	34	16396	0	16842
23980	16594	83	35	364	0	17076
23981	338	16416	30	247	0	17031
23982	254	15665	28	110	0	16057
23983	15299	263	19	94	0	15675
23984	285	146	15118	85	0	15634
23985	13914	78	159	69	0	14220
23986	261	104	210	14523	0	15098
23987	204	13965	23	176	0	14368
23988	115	14032	18	138	0	14303
23989	14354	212	40	76	0	14682
23990	180	126	10	15327	0	15643
23991	149	15854	11	148	0	16162
23992	15830	140	7	109	0	16086
23993	15456	112	11	59	0	15638
23994	15631	56	7	54	0	15748
23995	15957	49	11	63	0	16080
23996	219	15612	14	65	0	15910
23997	115	15782	11	43	0	15951
23998	16297	150	5	47	0	16499
23999	16188	91	11	46	0	16336
24000	186	38	16110	49	0	16383
24001	86	15848	78	34	0	16046
24002	15945	99	44	21	0	16109
24003	16572	67	9	28	0	16676
24004	194	20	16941	27	0	17182
24005	16658	16	108	50	0	16832
24006	175	9	17893	19	0	18096
24007	104	8	19142	18	0	19272
24008	36	12	224	17891	0	18163
24009	29	19015	136	161	0	19341
24010	19737	161	21	117	0	20036
24011	173	118	3	19578	0	19872
24012	119	30	7	19569	0	19725
24013	26	16	14	20033	0	20089
24014	19830	10	5	313	0	20158
24015	172	8	8	19737	0	19925
24016	126	13	6	20448	0	20593
24017	46	13	20754	289	0	21102
24018	20542	14	193	168	0	20917
24019	21400	13	123	53	0	21589
24020	356	15	21568	26	0	21965
24021	20858	9	206	34	0	21107
24022	250	23	145	21105	0	21523
24023	170	21174	112	266	0	21722
24024	62	202	10	21493	0	21767
24025	21293	146	15	257	0	21711
24026	227	21816	15	174	0	22232
24027	166	213	24	21768	0	22171
24028	58	155	16	22025	0	22254
24029	30	45	19	22149	0	22243
24030	40	28	19	21383	0	21470
24031	46	22354	14	388	0	22802
24032	22238	228	24	183	0	22673
24033	22374	174	28	71	0	22647
24034	403	22957	15	72	0	23447
24035	25348	251	26	49	0	25674
24036	25310	194	30	52	0	25586
24037	25512	54	18	53	0	25637
24038	603	25	25333	42	0	26003
24039	314	28	285	25053	0	25680
24040	124	37	24961	307	0	25429
24041	24366	28	322	276	0	24992
24042	322	24954	228	125	0	25629
24043	24787	299	71	55	0	25212
24044	380	25173	33	56	0	25642
24045	287	328	49	23642	0	24306
24046	107	251	37	24279	0	24674
24047	102	85	24188	514	0	24889
24048	78	24380	293	332	0	25083
24049	24046	313	277	119	0	24755
24050	378	261	24074	74	0	24787
24051	23885	93	325	75	0	24378
24052	416	55	259	24057	0	24787
24053	331	35	24089	362	0	24817
24054	128	24118	313	318	0	24877
24055	104	314	260	23994	0	24672
24056	118	282	24089	348	0	24837
24057	118	106	23968	297	0	24489
24058	100	23634	501	175	0	24410
24059	99	302	294	22918	0	23613
24060	103	281	80	22475	0	22939
24061	121	23015	51	535	0	23722
24062	23174	285	69	317	0	23845
24063	353	259	64	22645	0	23321
24064	312	21939	74	339	0	22664
24065	22441	310	65	282	0	23098
24066	21745	278	88	130	0	22241
24067	22620	111	93	91	0	22915
24068	603	22439	78	122	0	23242
24069	22655	297	115	124	0	23191
24070	22450	283	77	108	0	22918
24071	554	147	50	22113	0	22864
24072	22444	79	74	414	0	23011
24073	434	94	55	22360	0	22943
24074	355	97	21920	438	0	22810
24075	189	68	22225	368	0	22850
24076	141	81	537	22311	0	23070
24077	163	72	22446	399	0	23080
24078	21575	90	374	356	0	22395
24079	418	81	306	22013	0	22818
24080	397	80	138	22123	0	22738
24081	212	92	21988	588	0	22880
24082	147	21654	341	420	0	22562
24083	164	21989	300	194	0	22647
24084	160	576	119	21113	0	21968
24085	154	345	91	21699	0	22289
24086	137	142	21302	625	0	22206
24087	132	107	21420	402	0	22061
24088	178	118	537	21318	0	22151
24089	144	121	21054	423	0	21742
24090	19700	101	390	346	0	20537
24091	443	111	288	19693	0	20535
24092	19922	110	105	438	0	20575
24093	453	103	97	19404	0	20057
24094	381	107	88	19876	0	20452
24095	218	108	19376	608	0	20310
24096	171	19670	340	416	0	20597
24097	174	333	322	19640	0	20469
24098	170	305	19168	364	0	20007
24099	145	18850	318	363	0	19676
24100	168	339	332	18941	0	19780
24101	19136	306	129	418	0	19989
24102	411	122	19136	327	0	19996
24103	18305	68	361	151	0	18885
24104	436	84	18075	113	0	18708
24105	16443	55	398	105	0	17001
24106	341	16481	299	110	0	17231
24107	238	15430	119	96	0	15883
24108	114	575	75	14610	0	15374
24109	55	15059	73	277	0	15464
24110	14489	266	131	255	0	15141
24111	255	222	84	14402	0	14963
24112	222	99	55	14605	0	14981
24113	84	52	51	14960	0	15147
24114	43	55	14575	483	0	15156
24115	62	98	264	14473	0	14897
24116	75	48	14225	327	0	14675
24117	42	13477	277	264	0	14060
24118	12089	185	214	111	0	12599
24119	211	12941	89	79	0	13320
24120	12987	199	58	75	0	13319
24121	12863	170	54	78	0	13165
24122	12902	64	48	78	0	13092
24123	12897	50	61	72	0	13080
24124	378	43	12746	80	0	13247
24125	213	56	194	12515	0	12978
24126	92	56	198	12162	0	12508
24127	44	44	101	12669	0	12858
24128	11835	74	50	387	0	12346
24129	11806	50	57	255	0	12168
24130	322	12282	56	139	0	12799
24131	201	168	11827	81	0	12277
24132	110	151	11882	73	0	12216
24133	73	11636	301	79	0	12089
24134	50	11394	189	84	0	11717
24135	96	245	257	8384	0	8982
24136	29	116	25	8272	0	8442
24137	8427	45	20	161	0	8653
24138	109	8385	15	126	0	8635
24139	96	109	20	8599	0	8824
24140	60	79	8698	122	0	8959
24141	40	24	98	9269	0	9431
24142	27	20	94	9321	0	9462
24143	31	17	47	9389	0	9484
24144	34	22	42	9249	0	9347
24145	44	18	9023	219	0	9304
24146	42	8832	121	124	0	9119
24147	37	8896	95	51	0	9079
24148	8520	173	34	48	0	8775
24149	123	8647	33	39	0	8842
24150	104	9012	33	34	0	9183
24151	73	188	37	9055	0	9353
24152	37	102	38	9063	0	9240
24153	42	50	26	9338	0	9456
24154	30	35	9207	217	0	9489
24155	40	9204	121	146	0	9511
24156	48	134	77	8869	0	9128
24157	35	9586	44	144	0	9809
24158	9512	122	38	124	0	9796
24159	114	9601	45	71	0	9831
24160	9547	140	40	74	0	9801
24161	128	106	9536	74	0	9844
24162	9416	59	185	66	0	9726
24163	124	59	97	9553	0	9833
24164	94	69	9583	148	0	9894
24165	9094	63	110	126	0	9393
24166	9334	70	76	73	0	9553
24167	9342	49	47	65	0	9503
24168	207	61	29	9434	0	9731
24169	119	46	9556	176	0	9897
24170	9229	42	151	149	0	9571
24171	145	50	109	10012	0	10316
24172	94	55	42	10164	0	10355
24173	52	45	10551	238	0	10886
24174	46	10604	125	148	0	10923
24175	78	160	74	10000	0	10312
24176	55	10634	29	131	0	10849
24177	10496	170	37	103	0	10806
24178	10561	115	39	58	0	10773
24179	226	53	40	10641	0	10960
24180	10688	53	45	179	0	10965
24181	156	10543	53	137	0	10889
24182	10467	146	33	92	0	10738
24183	154	10616	33	66	0	10869
24184	114	150	25	10508	0	10797
24185	81	94	38	10080	0	10293
24186	70	10414	42	176	0	10702
24187	73	153	41	10362	0	10629
24188	72	91	10543	172	0	10878
24189	54	10298	128	123	0	10603
24190	9868	119	66	79	0	10132
24191	121	10167	45	79	0	10412
24192	87	122	34	10367	0	10610
24193	70	91	10614	146	0	10921
24194	45	47	136	10444	0	10672
24195	51	43	80	10635	0	10809
24196	10420	35	35	204	0	10694
24197	168	30	10670	114	0	10982
24198	104	10964	115	110	0	11293
24199	61	161	11354	52	0	11628
24200	46	87	10885	58	0	11076
24201	43	36	10745	63	0	10887
24202	97	110	127	10440	0	10774
24203	10789	17	50	123	0	10979
24204	97	10811	25	92	0	11025
24205	11018	111	11	43	0	11183
24206	11163	64	23	41	0	11291
24207	142	32	24	11093	0	11291
24208	65	11237	15	134	0	11451
24209	11160	113	10	67	0	11350
24210	111	11320	13	54	0	11498
24211	71	120	19	11495	0	11705
24212	21	69	27	11809	0	11926
24213	24	11938	23	172	0	12157
24214	21	121	16	12051	0	12209
24215	39	68	11903	134	0	12144
24216	30	46	11840	69	0	11985
24217	34	49	148	11835	0	12066
24218	14	33	73	12075	0	12195
24219	38	24	11607	164	0	11833
24220	30	26	11547	84	0	11687
24221	10812	32	168	43	0	11055
24222	123	11447	69	50	0	11689
24223	77	12254	39	42	0	12412
24224	54	173	28	11736	0	11991
24225	54	80	24	11749	0	11907
24226	45	35	21	12210	0	12311
24227	53	34	12111	176	0	12374
24228	53	32	11946	80	0	12111
24229	50	34	157	12277	0	12518
24230	29	35	12338	152	0	12554
24231	19	12336	138	131	0	12624
24232	12212	121	103	48	0	12484
24233	129	86	12259	48	0	12522
24234	98	32	12264	58	0	12452
24235	47	29	184	12371	0	12631
24236	47	84	13500	156	0	13787
24237	52	13678	152	145	0	14027
24238	34	159	98	14108	0	14399
24239	66	101	14312	177	0	14656
24240	49	14107	166	137	0	14459
24241	13692	143	101	132	0	14068
24242	129	101	42	13337	0	13609
24243	103	30	30	13531	0	13694
24244	13580	24	28	222	0	13854
24245	127	13544	22	127	0	13820
24246	13707	136	28	53	0	13924
24247	13815	100	28	40	0	13983
24248	13796	30	31	41	0	13898
24249	221	25	35	13602	0	13883
24250	13388	14	36	146	0	13584
24251	154	12899	29	114	0	13196
24252	109	13218	26	72	0	13425
24253	13315	222	36	33	0	13606
24254	147	117	29	13595	0	13888
24255	113	44	25	13782	0	13964
24256	45	41	26	14062	0	14174
24257	43	25	13582	281	0	13931
24258	17	13538	154	174	0	13883
24259	17	147	127	13760	0	14051
24260	13619	129	46	172	0	13966
24261	153	50	30	13684	0	13917
24262	130	29	13599	188	0	13946
24263	38	13539	163	160	0	13900
24264	13531	152	133	76	0	13892
24265	13354	130	53	57	0	13594
24266	13518	50	56	51	0	13675
24267	270	37	50	13646	0	14003
24268	141	45	13649	176	0	14011
24269	74	30	14104	155	0	14363
24270	34	14425	280	79	0	14818
24271	46	240	154	14006	0	14446
24272	43	149	36	14322	0	14550
24273	13758	42	34	308	0	14142
24274	211	47	20	14105	0	14383
24275	14513	36	25	234	0	14808
24276	244	30	14130	168	0	14572
24277	175	38	14414	74	0	14701
24278	79	26	317	14088	0	14510
24279	53	44	167	14024	0	14288
24280	52	35	55	14816	0	14958
24281	14766	49	34	359	0	15208
24282	15310	44	45	194	0	15593
24283	365	46	37	15576	0	16024
24284	214	40	15414	260	0	15928
24285	82	27	15454	210	0	15773
24286	52	34	378	15597	0	16061
24287	16021	27	244	264	0	16556
24288	243	41	74	15505	0	15863
24289	199	32	57	16077	0	16365
24290	76	36	15902	406	0	16420
24291	62	41	15448	231	0	15782
24292	14791	46	493	97	0	15427
24293	255	31	15286	86	0	15658
24294	201	29	248	14503	0	14981
24295	83	33	174	14848	0	15138
24296	14836	21	69	381	0	15307
24297	241	14493	59	338	0	15131
24298	14408	210	58	84	0	14760
24299	241	14211	58	95	0	14605
24300	14094	222	49	75	0	14440
24301	255	166	13678	85	0	14184
24302	12474	45	193	73	0	12785
24303	12908	28	165	62	0	13163
24304	342	97	59	12897	0	13395
24305	214	27	12882	207	0	13330
24306	69	27	212	12504	0	12812
24307	61	33	155	12322	0	12571
24308	57	12560	55	360	0	13032
24309	67	170	60	12285	0	12582
24310	67	12540	41	227	0	12875
24311	103	187	40	12203	0	12533
24312	12048	145	58	269	0	12520
24313	230	36	40	12127	0	12433
24314	205	25	11975	256	0	12461
24315	11704	42	200	222	0	12168
24316	248	25	12197	105	0	12575
24317	11929	30	225	76	0	12260
24318	12088	35	171	110	0	12404
24319	353	11987	80	107	0	12527
24320	228	12825	69	149	0	13271
24321	12667	346	58	80	0	13151
24322	12880	193	66	77	0	13216
24323	12575	49	61	91	0	12776
24324	12637	26	57	105	0	12825
24325	12608	27	68	114	0	12817
24326	415	23	64	12273	0	12775
24327	233	47	76	12523	0	12879
24328	111	54	12344	401	0	12910
24329	11903	49	230	259	0	12441
24330	276	35	196	12038	0	12545
24331	228	40	85	12214	0	12567
24332	132	42	12000	391	0	12565
24333	94	11761	240	249	0	12344
24334	118	12045	199	129	0	12491
24335	11467	294	201	112	0	12074
24336	10704	144	58	89	0	10995
24337	335	10352	61	89	0	10837
24338	184	9925	58	56	0	10223
24339	9768	262	53	66	0	10149
24340	10211	130	52	58	0	10451
24341	299	40	53	9873	0	10265
24342	185	36	39	9900	0	10160
24343	103	31	36	10287	0	10457
24344	10049	31	46	308	0	10434
24345	10274	35	43	190	0	10542
24346	335	40	48	10381	0	10804
24347	10779	29	47	212	0	11067
24348	233	42	10681	211	0	11167
24349	227	25	196	10701	0	11149
24350	104	39	10851	222	0	11216
24351	86	10842	193	216	0	11337
24352	81	183	172	10737	0	11173
24353	10628	144	73	237	0	11082
24354	236	41	59	10387	0	10723
24355	193	37	45	10369	0	10644
24356	91	38	10185	337	0	10651
24357	101	35	10323	195	0	10654
24358	89	10484	298	88	0	10959
24359	10476	207	150	64	0	10897
24360	10547	165	48	71	0	10831
24361	10679	55	44	55	0	10833
24362	10772	45	34	53	0	10904
24363	364	40	47	10612	0	11063
24364	236	40	42	10364	0	10682
24365	122	10719	36	299	0	11176
24366	10652	181	33	189	0	11055
24367	10582	168	44	76	0	10870
24368	353	52	10213	70	0	10688
24369	9094	31	135	44	0	9304
24370	185	9115	126	61	0	9487
24371	165	290	33	8608	0	9096
24372	74	9094	29	150	0	9347
24373	8884	186	42	154	0	9266
24374	155	8999	30	57	0	9241
24375	136	124	28	8463	0	8751
24376	56	114	35	8453	0	8658
24377	54	32	28	8475	0	8589
24378	51	8385	23	242	0	8701
24379	53	195	20	8282	0	8550
24380	51	112	27	8083	0	8273
24381	45	7674	22	205	0	7946
24382	41	7320	19	102	0	7482
24383	6891	156	18	41	0	7106
24384	119	6977	18	47	0	7161
24385	6843	96	22	28	0	6989
24386	117	90	6719	28	0	6954
24387	100	6405	71	36	0	6612
24388	6364	79	59	36	0	6538
24389	6222	74	9	30	0	6335
24390	162	23	6215	24	0	6424
24391	107	26	72	6079	0	6284
24392	43	19	6233	108	0	6403
24393	37	6199	82	92	0	6410
24394	6066	89	82	30	0	6267
24395	85	5990	22	116	0	6213
24396	85	84	16	5927	0	6112
24397	50	77	14	5980	0	6121
24398	39	19	5853	147	0	6058
24399	28	32	5670	94	0	5824
24400	5541	28	129	38	0	5736
24401	5709	28	74	41	0	5852
24402	5794	30	22	26	0	5872
24403	5761	47	11	32	0	5851
24404	154	5863	16	44	0	6077
24405	96	88	17	5741	0	5942
24406	50	80	14	5728	0	5872
24407	39	5871	18	142	0	6070
24408	5955	89	21	92	0	6157
24409	6001	78	19	42	0	6140
24410	177	31	6079	32	0	6319
24411	6176	27	84	26	0	6313
24412	112	30	69	6121	0	6332
24413	110	26	6239	94	0	6469
24414	53	42	89	6173	0	6357
24415	41	33	6376	108	0	6558
24416	47	28	6154	82	0	6311
24417	36	86	126	5623	0	5871
24418	34	5821	68	71	0	5994
24419	5809	73	22	69	0	5973
24420	5492	72	26	28	0	5618
24421	122	6170	18	42	0	6352
24422	81	6287	14	32	0	6414
24423	6277	120	45	28	0	6470
24424	6240	70	14	35	0	6359
24425	6288	23	17	24	0	6352
24426	6231	32	22	18	0	6303
24427	133	28	16	6343	0	6520
24428	92	24	6265	77	0	6458
24429	42	6325	71	74	0	6512
24430	6214	80	56	21	0	6371
24431	88	6526	16	25	0	6655
24432	6512	74	9	18	0	6613
24433	6491	60	14	22	0	6587
24434	131	25	7114	19	0	7289
24435	79	7289	65	28	0	7461
24436	32	72	63	7285	0	7452
24437	34	62	26	7342	0	7464
24438	28	25	26	7332	0	7411
24439	7370	25	21	120	0	7536
24440	6947	23	17	72	0	7059
24441	7116	19	16	30	0	7181
24442	126	7147	24	30	0	7327
24443	6978	66	19	23	0	7086
24444	71	6999	20	29	0	7119
24445	55	65	6836	32	0	6988
24446	22	6455	48	29	0	6554
24447	36	130	72	5698	0	5936
24448	24	25	8	5694	0	5751
24449	23	11	5728	53	0	5815
24450	21	45	33	5520	0	5619
24451	20	9	27	5623	0	5679
24452	5891	9	9	59	0	5968
24453	5710	15	11	29	0	5765
24454	5883	13	6	13	0	5915
24455	68	5964	7	16	0	6055
24456	5870	31	16	12	0	5929
24457	5736	25	11	19	0	5791
24458	54	6154	13	20	0	6241
24459	25	47	11	6222	0	6305
24460	14	84	10	6272	0	6380
24461	6329	12	5	73	0	6419
24462	67	8	6233	35	0	6343
24463	49	6007	42	28	0	6126
24464	20	52	29	5627	0	5728
24465	16	5691	7	51	0	5765
24466	12	5711	8	38	0	5769
24467	5738	72	12	11	0	5833
24468	5666	36	7	7	0	5716
24469	71	10	2	5698	0	5781
24470	39	9	3	5627	0	5678
24471	19	10	7	5690	0	5726
24472	27	7	5	5694	0	5733
24473	22	83	5528	72	0	5705
24474	15	17	5320	35	0	5387
24475	18	13	54	5518	0	5603
24476	17	11	5869	54	0	5951
24477	9	5844	48	39	0	5940
24478	5881	42	31	16	0	5970
24479	5868	28	7	16	0	5919
24480	73	9	6	5870	0	5958
24481	38	12	5	5809	0	5864
24482	20	8	10	5921	0	5959
24483	16	6054	8	76	0	6154
24484	6051	51	9	37	0	6148
24485	5989	41	11	8	0	6049
24486	80	15	6221	14	0	6330
24487	43	17	44	6527	0	6631
24488	23	16	6899	74	0	7012
24489	27	10	58	7738	0	7833
24490	29	18	43	7707	0	7797
24491	17	17	16	7893	0	7943
24492	15	13	5	8120	0	8153
24493	8052	7	2	171	0	8232
24494	8011	18	16	86	0	8131
24495	8290	19	13	19	0	8341
24496	177	8	6	8277	0	8468
24497	92	12	8413	98	0	8615
24498	8198	23	87	94	0	8402
24499	95	12	79	8487	0	8673
24500	8626	4	14	101	0	8745
24501	95	14	10	8503	0	8622
24502	84	8299	13	104	0	8500
24503	27	8711	9	97	0	8844
24504	12	151	5	8646	0	8814
24505	14	90	12	8665	0	8781
24506	18	52	16	8952	0	9038
24507	21	8817	5	182	0	9025
24508	8717	86	15	94	0	8912
24509	92	8816	8	25	0	8941
24510	84	105	8886	28	0	9103
24511	21	74	93	8582	0	8770
24512	10	9025	84	156	0	9275
24513	12	90	24	8890	0	9016
24514	10	89	7	9023	0	9129
24515	14	20	8888	189	0	9111
24516	8277	11	94	133	0	8515
24517	107	8911	82	51	0	9151
24518	9004	95	17	28	0	9144
24519	9021	86	15	34	0	9156
24520	9390	22	16	38	0	9466
24521	200	52	8709	39	0	9000
24522	128	14	109	8568	0	8819
24523	45	14	86	8839	0	8984
24524	36	12	8698	210	0	8956
24525	8092	18	107	127	0	8344
24526	115	22	8838	62	0	9037
24527	114	27	8610	40	0	8791
24528	33	8901	159	64	0	9157
24529	106	103	95	8797	0	9101
24530	32	98	8904	124	0	9158
24531	8383	31	99	127	0	8640
24532	8598	25	99	57	0	8779
24533	199	26	8683	48	0	8956
24534	111	28	97	8194	0	8430
24535	45	28	8352	129	0	8554
24536	35	8281	107	155	0	8578
24537	8795	117	169	62	0	9143
24538	8697	95	30	53	0	8875
24539	9003	37	24	52	0	9116
24540	226	29	24	8885	0	9164
24541	147	26	10	9159	0	9342
24542	53	23	9170	229	0	9475
24543	8986	16	119	147	0	9268
24544	143	26	115	9158	0	9442
24545	9226	21	47	151	0	9445
24546	154	17	9120	140	0	9431
24547	131	26	9411	56	0	9624
24548	64	16	224	9033	0	9337
24549	38	20	131	9421	0	9610
24550	45	22	9397	242	0	9706
24551	9095	16	154	153	0	9418
24552	157	28	121	8995	0	9301
24553	129	9655	64	146	0	9994
24554	9617	119	111	142	0	9989
24555	145	9770	38	82	0	10035
24556	9732	133	53	65	0	9983
24557	186	107	9993	71	0	10357
24558	150	33	9573	59	0	9815
24559	69	9478	211	56	0	9814
24560	9551	109	135	42	0	9837
24561	166	105	9487	50	0	9808
24562	9314	27	147	50	0	9538
24563	167	9408	114	53	0	9742
24564	146	118	51	9427	0	9742
24565	74	99	53	9303	0	9529
24566	64	9774	46	216	0	10100
24567	10000	107	51	144	0	10302
24568	9973	102	56	59	0	10190
24569	10176	43	42	62	0	10323
24570	251	19	10173	60	0	10503
24571	154	25	158	9990	0	10327
24572	79	27	128	9998	0	10232
24573	60	25	70	10307	0	10462
24574	58	32	10110	247	0	10447
24575	58	9911	145	177	0	10291
24576	9733	120	133	75	0	10061
24577	155	111	9835	59	0	10160
24578	9676	52	149	34	0	9911
24579	173	9736	136	73	0	10118
24580	9877	130	75	52	0	10134
24581	177	156	48	9677	0	10058
24582	9860	44	66	147	0	10117
24583	176	37	65	9847	0	10125
24584	158	38	10117	141	0	10454
24585	98	89	150	10035	0	10372
24586	74	38	9908	144	0	10164
24587	9060	27	191	114	0	9392
24588	128	9251	126	60	0	9565
24589	161	71	42	8151	0	8425
24590	49	8504	46	130	0	8729
24591	8358	79	75	84	0	8596
24592	8357	58	33	39	0	8487
24593	127	8346	41	42	0	8556
24594	8412	55	65	37	0	8569
24595	8456	54	40	33	0	8583
24596	126	30	30	8290	0	8476
24597	73	22	32	8258	0	8385
24598	8431	19	27	126	0	8603
24599	8484	21	38	70	0	8613
24600	143	28	30	8342	0	8543
24601	100	21	22	9236	0	9379
24602	9752	22	33	150	0	9957
24603	129	21	9709	80	0	9939
24604	9140	25	109	40	0	9314
24605	139	12	9399	39	0	9589
24606	92	9074	99	39	0	9304
24607	48	164	83	8932	0	9227
24608	52	204	9349	102	0	9707
24609	35	9892	97	101	0	10125
24610	9636	93	67	78	0	9874
24611	104	92	9706	27	0	9929
24612	9316	30	83	11	0	9440
24613	9537	25	54	15	0	9631
24614	9521	11	25	24	0	9581
24615	136	17	30	9127	0	9310
24616	82	10275	19	118	0	10494
24617	10387	86	21	75	0	10569
24618	98	53	10469	30	0	10650
24619	9808	17	84	29	0	9938
24620	112	8	10571	19	0	10710
24621	67	10408	84	36	0	10595
24622	35	76	62	10207	0	10380
24623	37	57	20	10170	0	10284
24624	35	10226	25	120	0	10406
24625	38	75	9	10540	0	10662
24626	40	57	10625	90	0	10812
24627	30	10638	81	68	0	10817
24628	33	86	67	10451	0	10637
24629	10355	51	30	101	0	10537
24630	10816	19	32	73	0	10940
24631	143	26	20	11034	0	11223
24632	87	11495	27	100	0	11709
24633	34	98	23	11366	0	11521
24634	45	71	20	11390	0	11526
24635	48	21	11282	155	0	11506
24636	45	11340	101	83	0	11569
24637	42	89	54	10924	0	11109
24638	49	61	10846	82	0	11038
24639	31	10691	64	79	0	10865
24640	34	109	50	10624	0	10817
24641	10629	52	20	91	0	10792
24642	103	10779	18	62	0	10962
24643	82	72	23	10898	0	11075
24644	11427	59	16	84	0	11586
24645	11241	27	18	73	0	11359
24646	11394	12	18	35	0	11459
24647	11222	16	23	24	0	11285
24648	133	23	16	11165	0	11337
24649	71	17	11634	90	0	11812
24650	39	22	86	11310	0	11457
24651	30	11609	58	91	0	11788
24652	11701	77	38	74	0	11890
24653	103	71	11298	26	0	11498
24654	10997	23	75	36	0	11131
24655	89	23	11305	37	0	11454
24656	74	27	81	11150	0	11332
24657	59	24	11217	82	0	11382
24658	35	15	76	11215	0	11341
24659	45	28	11416	98	0	11587
24660	33	27	74	11110	0	11244
24661	11158	28	58	95	0	11339
24662	87	12120	23	78	0	12308
24663	65	88	14	12196	0	12363
24664	36	64	7	12219	0	12326
24665	43	10	12414	132	0	12599
24666	38	26	12248	65	0	12377
24667	11640	20	118	53	0	11831
24668	86	12198	61	40	0	12385
24669	12138	80	29	27	0	12274
24670	12222	53	27	33	0	12335
24671	134	24	27	11951	0	12136
24672	82	12262	23	87	0	12454
24673	12495	76	30	75	0	12676
24674	12493	62	32	35	0	12622
24675	12850	28	20	39	0	12937
24676	12792	19	28	43	0	12882
24677	12793	17	36	46	0	12892
24678	146	30	12721	27	0	12924
24679	12529	32	80	46	0	12687
24680	115	20	12782	44	0	12961
24681	99	25	99	12439	0	12662
24682	60	20	67	12868	0	13015
24683	51	23	12919	145	0	13138
24684	12474	26	101	89	0	12690
24685	120	35	66	12867	0	13088
24686	97	26	38	13191	0	13352
24687	56	33	36	13208	0	13333
24688	44	24	28	13234	0	13330
24689	30	35	39	13316	0	13420
24690	40	34	13844	166	0	14084
24691	47	28	103	13684	0	13862
24692	56	29	13928	125	0	14138
24693	58	31	13689	109	0	13887
24694	13394	32	169	65	0	13660
24695	13898	29	117	64	0	14108
24696	14488	36	56	54	0	14634
24697	263	27	15290	47	0	15627
24698	154	26	15493	60	0	15733
24699	79	23	15971	53	0	16126
24700	65	15919	252	73	0	16309
24701	236	276	260	15442	0	16214
24702	16667	98	56	141	0	16962
24703	161	27	22	18311	0	18521
24704	132	18710	37	189	0	19068
24705	18813	171	31	160	0	19175
24706	198	141	21	18588	0	18948
24707	169	19529	31	237	0	19966
24708	61	167	41	19336	0	19605
24709	42	152	31	19198	0	19423
24710	18828	29	42	330	0	19229
24711	201	21	47	18917	0	19186
24712	187	22	18863	229	0	19301
24713	76	23	194	18646	0	18939
24714	51	18568	168	223	0	19010
24715	52	18968	45	209	0	19274
24716	49	309	40	17736	0	18134
24717	41	185	55	17503	0	17784
24718	35	17807	48	333	0	18223
24719	41	18097	45	219	0	18402
24720	50	18256	44	77	0	18427
24721	67	345	42	17158	0	17612
24722	66	18216	38	189	0	18509
24723	18173	220	46	178	0	18617
24724	214	187	18388	76	0	18865
24725	195	70	209	17520	0	17994
24726	72	18258	173	224	0	18727
24727	18038	215	62	219	0	18534
24728	241	184	18207	110	0	18742
24729	201	18182	198	98	0	18679
24730	17452	211	183	67	0	17913
24731	189	17322	158	75	0	17744
24732	165	17297	42	141	0	17645
24733	58	369	90	17055	0	17572
24734	47	17548	27	214	0	17836
24735	17230	211	21	197	0	17659
24736	177	196	34	17043	0	17450
24737	179	82	17042	241	0	17544
24738	81	74	17175	194	0	17524
24739	38	62	301	16802	0	17203
24740	41	69	17244	209	0	17563
24741	53	53	187	17100	0	17393
24742	16765	58	158	251	0	17232
24743	211	61	17054	188	0	17514
24744	175	60	197	16368	0	16800
24745	70	16452	178	222	0	16922
24746	52	220	66	16642	0	16980
24747	51	207	42	16518	0	16818
24748	53	17139	85	367	0	17644
24749	36	226	44	17082	0	17388
24750	40	217	73	17118	0	17448
24751	65	105	16987	356	0	17513
24752	37	17005	186	238	0	17466
24753	16840	250	175	94	0	17359
24754	204	218	54	16745	0	17221
24755	204	98	16894	245	0	17441
24756	76	85	194	17049	0	17404
24757	56	83	17117	273	0	17529
24758	16181	81	228	221	0	16711
24759	210	17047	174	141	0	17572
24760	181	242	75	16880	0	17378
24761	76	237	69	17277	0	17659
24762	16282	100	70	402	0	16854
24763	229	103	68	16470	0	16870
24764	189	122	16263	286	0	16860
24765	72	121	214	15531	0	15938
24766	60	15654	179	333	0	16226
24767	56	15999	79	289	0	16423
24768	66	16330	55	177	0	16628
24769	83	391	72	16273	0	16819
24770	67	248	16343	315	0	16973
24771	60	16244	225	260	0	16789
24772	15998	295	184	163	0	16640
24773	215	16468	89	143	0	16915
24774	16229	285	63	161	0	16738
24775	16030	268	71	137	0	16506
24776	370	131	16053	129	0	16683
24777	16081	125	231	140	0	16577
24778	16480	147	192	119	0	16938
24779	16725	124	90	132	0	17071
24780	16691	106	82	134	0	17013
24781	380	103	16684	120	0	17287
24782	16345	107	231	144	0	16827
24783	16510	121	215	126	0	16972
24784	361	16877	116	112	0	17466
24785	232	271	61	16575	0	17139
24786	124	287	84	16421	0	16916
24787	84	16832	84	404	0	17404
24788	16515	277	85	250	0	17127
24789	213	16901	78	140	0	17332
24790	15854	258	74	127	0	16313
24791	15753	240	66	99	0	16158
24792	349	16012	74	100	0	16535
24793	204	234	67	15813	0	16318
24794	112	196	15793	290	0	16391
24795	105	15474	218	252	0	16049
24796	166	421	179	14017	0	14783
24797	79	14405	97	184	0	14765
24798	92	15236	61	179	0	15568
24799	96	639	52	14269	0	15056
24800	150	189	15258	193	0	15790
24801	68	14525	193	196	0	14982
24802	149	13803	158	75	0	14185
24803	11433	191	48	29	0	11701
24804	109	127	18	11457	0	11711
24805	106	46	21	11356	0	11529
24806	44	25	17	11812	0	11898
24807	45	17	11411	238	0	11711
24808	31	33	105	11351	0	11520
24809	23	11517	115	146	0	11801
24810	11741	124	36	134	0	12035
24811	133	132	17	11778	0	12060
24812	143	48	11669	126	0	11986
24813	11599	44	110	142	0	11895
24814	133	25	129	12265	0	12552
24815	148	44	13066	136	0	13394
24816	74	40	13089	188	0	13391
24817	13156	32	252	47	0	13487
24818	13540	35	155	32	0	13762
24819	13165	33	49	31	0	13278
24820	13528	28	34	32	0	13622
24821	301	36	13413	36	0	13786
24822	184	13641	131	46	0	14002
24823	13567	153	143	38	0	13901
24824	165	13504	44	50	0	13763
24825	13284	164	28	39	0	13515
24826	161	13400	18	41	0	13620
24827	150	174	17	13207	0	13548
24828	51	154	21	13246	0	13472
24829	34	58	20	13217	0	13329
24830	32	13081	16	286	0	13415
24831	32	13286	18	201	0	13537
24832	35	257	25	12821	0	13138
24833	32	13107	27	257	0	13423
24834	49	169	13055	156	0	13429
24835	34	173	140	12980	0	13327
24836	41	52	13191	155	0	13439
24837	12571	39	170	166	0	12946
24838	12831	41	154	63	0	13089
24839	288	32	12808	53	0	13181
24840	194	49	12775	46	0	13064
24841	75	39	279	12614	0	13007
24842	48	46	12944	161	0	13199
24843	48	55	178	12130	0	12411
24844	72	12553	178	171	0	12974
24845	61	180	69	12782	0	13092
24846	80	173	40	12789	0	13082
24847	61	91	37	12972	0	13161
24848	70	68	12147	332	0	12617
24849	65	61	159	12004	0	12289
24850	55	78	191	11638	0	11962
24851	60	100	59	11632	0	11851
24852	60	12047	46	317	0	12470
24853	12047	195	47	193	0	12482
24854	11856	190	38	126	0	12210
24855	11989	88	53	107	0	12237
24856	317	65	58	11822	0	12262
24857	209	68	12001	213	0	12491
24858	161	70	11749	212	0	12192
24859	67	11886	292	128	0	12373
24860	11757	207	200	113	0	12277
24861	163	11913	103	127	0	12306
24862	11961	198	82	97	0	12338
24863	215	11902	76	112	0	12305
24864	11899	197	76	96	0	12268
24865	209	12936	99	73	0	13317
24866	220	233	82	12676	0	13211
24867	126	199	12583	201	0	13109
24868	125	79	12619	235	0	13058
24869	95	104	303	12078	0	12580
24870	89	69	233	12043	0	12434
24871	101	77	111	12466	0	12755
24872	114	66	12235	348	0	12763
24873	112	70	168	12112	0	12462
24874	11859	64	193	238	0	12354
24875	11927	79	102	228	0	12336
24876	301	11861	82	165	0	12409
24877	11692	185	81	113	0	12071
24878	224	11804	70	122	0	12220
24879	11606	221	60	110	0	11997
24880	11586	196	86	102	0	11970
24881	11437	105	86	93	0	11721
24882	353	87	11201	97	0	11738
24883	258	87	11030	87	0	11462
24884	10802	80	290	82	0	11254
24885	11211	70	222	81	0	11584
24886	344	109	101	11066	0	11620
24887	286	73	81	11270	0	11710
24888	148	93	80	11483	0	11804
24889	109	67	104	11720	0	12000
24890	86	100	77	12036	0	12299
24891	11821	97	85	358	0	12361
24892	178	111	65	11753	0	12107
24893	206	98	11827	267	0	12398
24894	11259	90	183	249	0	11781
24895	11532	78	197	163	0	11970
24896	297	11818	89	173	0	12377
24897	176	11908	63	134	0	12281
24898	10657	229	44	89	0	11019
24899	142	10847	63	66	0	11118
24900	10432	149	78	72	0	10731
24901	10976	106	71	117	0	11270
24902	10977	49	65	68	0	11159
24903	240	29	67	10721	0	11057
24904	166	10882	45	164	0	11257
24905	11071	114	50	137	0	11372
24906	149	118	51	11072	0	11390
24907	152	44	35	11156	0	11387
24908	10920	29	34	250	0	11233
24909	114	10832	46	187	0	11179
24910	116	137	28	10785	0	11066
24911	10997	119	22	127	0	11265
24912	129	10998	21	176	0	11324
24913	11317	114	15	73	0	11519
24914	162	124	11049	58	0	11393
24915	10232	25	89	37	0	10383
24916	125	10452	93	58	0	10728
24917	10336	96	50	21	0	10503
24918	10247	98	13	23	0	10381
24919	204	10559	10	35	0	10808
24920	10639	103	8	20	0	10770
24921	135	10534	3	52	0	10724
24922	10834	109	5	18	0	10966
24923	109	109	13	10688	0	10919
24924	120	27	14	10735	0	10896
24925	50	23	8	10936	0	11017
24926	52	18	10708	195	0	10973
24927	25	28	95	10708	0	10856
24928	49	21	10685	119	0	10874
24929	45	20	110	10543	0	10718
24930	26	10650	99	119	0	10894
24931	47	104	22	10843	0	11016
24932	55	105	10646	123	0	10929
24933	49	38	10988	126	0	11201
24934	34	30	177	10933	0	11174
24935	10890	24	108	122	0	11144
24936	10877	23	26	123	0	11049
24937	206	11051	19	68	0	11344
24938	145	100	7	11131	0	11383
24939	69	120	11581	106	0	11876
24940	43	86	93	11394	0	11616
24941	54	35	11576	133	0	11798
24942	11213	23	116	131	0	11483
24943	138	30	108	11589	0	11865
24944	139	21	11306	135	0	11601
24945	62	28	112	11208	0	11410
24946	46	37	103	11377	0	11563
24947	61	31	11410	227	0	11729
24948	50	29	106	11397	0	11582
24949	11397	23	115	157	0	11692
24950	11330	34	47	140	0	11551
24951	226	36	31	11560	0	11853
24952	11703	29	27	147	0	11906
24953	168	27	11600	132	0	11927
24954	148	34	11340	83	0	11605
24955	11240	36	399	68	0	11743
24956	11623	23	132	53	0	11831
24957	223	33	57	11411	0	11724
24958	157	26	46	11610	0	11839
24959	79	21	11408	256	0	11764
24960	64	37	120	10835	0	11056
24961	53	11629	127	171	0	11980
24962	11764	128	52	132	0	12076
24963	12477	126	52	59	0	12714
24964	262	12676	44	79	0	13061
24965	11882	156	33	65	0	12136
24966	11820	150	24	55	0	12049
24967	314	12114	36	53	0	12517
24968	12172	170	43	71	0	12456
24969	198	12195	37	73	0	12503
24970	12208	182	46	57	0	12493
24971	215	156	12080	67	0	12518
24972	213	44	172	11952	0	12381
24973	93	39	172	12166	0	12470
24974	75	26	63	12885	0	13049
24975	12759	34	45	370	0	13208
24976	233	27	33	13684	0	13977
24977	207	25	13550	268	0	14050
24978	13248	40	207	239	0	13734
24979	244	26	206	13279	0	13755
24980	226	13178	64	244	0	13712
24981	77	13656	43	249	0	14025
24982	66	352	48	13505	0	13971
24983	64	206	49	13371	0	13690
24984	54	46	57	13691	0	13848
24985	62	33	13097	415	0	13607
24986	71	12880	200	257	0	13408
24987	12588	193	186	85	0	13052
24988	12304	178	51	71	0	12604
24989	354	12331	51	64	0	12800
24990	186	12504	47	63	0	12800
24991	133	309	28	12194	0	12664
24992	57	169	12155	208	0	12589
24993	11222	63	417	181	0	11883
24994	11334	29	155	67	0	11585
24995	295	16	49	11307	0	11667
24996	167	18	40	11281	0	11506
24997	11110	22	29	295	0	11456
24998	194	18	11202	175	0	11589
24999	11015	27	145	75	0	11262
25000	175	10931	155	64	0	11325
25001	158	144	34	10043	0	10379
25002	37	10214	24	246	0	10521
25003	10256	134	34	149	0	10573
25004	151	126	27	9906	0	10210
25005	155	22	24	9786	0	9987
25006	49	9822	27	251	0	10149
25007	9834	133	30	145	0	10142
25008	9859	117	25	58	0	10059
25009	263	32	9677	50	0	10022
25010	149	27	9377	42	0	9595
25011	9147	28	218	34	0	9427
25012	157	27	9267	44	0	9495
25013	123	22	8464	35	0	8644
25014	8280	12	186	36	0	8514
25015	122	13	9141	35	0	9311
25016	108	20	117	8885	0	9130
25017	34	22	131	8926	0	9113
25018	9286	23	25	246	0	9580
25019	152	19	9225	149	0	9545
25020	9578	15	146	42	0	9781
25021	166	22	145	9547	0	9880
25022	9773	22	31	155	0	9981
25023	9778	27	18	162	0	9985
25024	10005	22	21	40	0	10088
25025	332	22	10	9775	0	10139
25026	9931	23	15	172	0	10141
25027	200	27	11	9919	0	10157
25028	188	21	21	9830	0	10060
25029	63	35	23	9894	0	10015
25030	65	22	23	10181	0	10291
25031	9837	22	27	317	0	10203
25032	9826	25	25	199	0	10075
25033	320	23	9736	62	0	10141
25034	9876	26	166	55	0	10123
25035	10063	19	175	45	0	10302
25036	333	32	44	9896	0	10305
25037	210	9920	22	190	0	10342
25038	10031	168	32	197	0	10428
25039	205	171	27	9552	0	9955
25040	9616	37	28	202	0	9883
25041	219	9391	27	209	0	9846
25042	9698	166	39	69	0	9972
25043	227	161	22	9348	0	9758
25044	205	9427	23	189	0	9844
25045	9773	167	36	184	0	10160
25046	199	9907	32	74	0	10212
25047	203	10205	41	68	0	10517
25048	10260	298	39	88	0	10685
25049	208	176	10101	88	0	10573
25050	10275	47	168	78	0	10568
25051	260	33	177	10094	0	10564
25052	234	20	10164	189	0	10607
25053	119	20	177	10002	0	10318
25054	106	19	176	10274	0	10575
25055	120	26	10098	353	0	10597
25056	9990	30	187	216	0	10423
25057	268	16	174	10017	0	10475
25058	257	22	38	10104	0	10421
25059	135	17	29	10092	0	10273
25060	9975	36	29	402	0	10442
25061	254	20	9573	271	0	10118
25062	229	30	9639	126	0	10024
25063	91	15	251	8762	0	9119
25064	113	19	8861	184	0	9177
25065	8584	22	154	175	0	8935
25066	183	8690	156	81	0	9110
25067	8567	121	38	52	0	8778
25068	206	151	30	8018	0	8405
25069	196	8339	34	159	0	8728
25070	93	201	27	8403	0	8724
25071	94	8573	33	164	0	8864
25072	96	146	16	8676	0	8934
25073	93	144	8353	172	0	8762
25074	76	53	7849	160	0	8138
25075	73	7835	188	98	0	8194
25076	7089	99	102	64	0	7354
25077	128	105	25	6823	0	7081
25078	138	47	24	7031	0	7240
25079	7017	48	13	178	0	7256
25080	6830	51	22	128	0	7031
25081	215	26	34	6855	0	7130
25082	158	25	6795	117	0	7095
25083	91	6691	105	192	0	7079
25084	66	99	109	6817	0	7091
25085	63	111	57	6739	0	6970
25086	55	7005	31	197	0	7288
25087	7125	102	35	139	0	7401
25088	137	101	7074	65	0	7377
25089	149	40	97	6828	0	7114
25090	65	36	95	6729	0	6925
25091	56	33	6759	235	0	7083
25092	73	29	101	6790	0	6993
25093	6765	27	124	139	0	7055
25094	6713	33	71	134	0	6951
25095	6889	35	55	79	0	7058
25096	197	6782	46	85	0	7110
25097	7108	101	51	62	0	7322
25098	165	115	39	6837	0	7156
25099	170	54	37	6716	0	6977
25100	84	7752	42	196	0	8074
25101	8716	134	37	157	0	9044
25102	9045	152	41	85	0	9323
25103	9194	51	36	81	0	9362
25104	9300	56	38	80	0	9474
25105	9327	44	49	82	0	9502
25106	330	37	9333	61	0	9761
25107	9484	59	178	64	0	9785
25108	9459	45	162	80	0	9746
25109	9490	42	59	76	0	9667
25110	336	31	42	9244	0	9653
25111	207	28	53	9393	0	9681
25112	107	21	9244	328	0	9700
25113	8545	38	177	237	0	8997
25114	191	9161	175	112	0	9639
25115	146	8337	43	59	0	8585
25116	70	201	8291	48	0	8610
25117	50	8327	119	55	0	8551
25118	46	8102	159	37	0	8344
25119	97	252	102	7146	0	7597
25120	25	7678	15	95	0	7813
25121	7688	97	12	91	0	7888
25122	7383	97	18	19	0	7517
25123	191	23	11	7243	0	7468
25124	108	22	7268	100	0	7498
25125	7086	16	99	95	0	7296
25126	124	23	7316	25	0	7488
25127	112	11	7354	29	0	7506
25128	41	24	168	6761	0	6994
25129	43	15	93	7204	0	7355
25130	45	4	7166	178	0	7393
25131	35	7064	105	103	0	7307
25132	29	7318	105	36	0	7488
25133	7118	193	17	25	0	7353
25134	7117	83	18	17	0	7235
25135	172	19	6945	14	0	7150
25136	6793	13	79	15	0	6900
25137	7075	7	78	19	0	7179
25138	175	19	22	6796	0	7012
25139	106	18	14	6910	0	7048
25140	37	27	19	7002	0	7085
25141	7044	21	9	161	0	7235
25142	7088	18	9	93	0	7208
25143	7252	11	13	22	0	7298
25144	197	11	17	7038	0	7263
25145	133	17	6785	90	0	7025
25146	6549	14	87	88	0	6738
25147	6446	13	87	28	0	6574
25148	181	22	28	6280	0	6511
25149	129	6435	19	90	0	6673
25150	73	84	14	6408	0	6579
25151	61	6514	18	100	0	6693
25152	56	97	22	6341	0	6516
25153	51	6718	25	108	0	6902
25154	6629	101	35	78	0	6843
25155	135	133	20	6434	0	6722
25156	118	6651	19	93	0	6881
25157	59	101	6678	83	0	6921
25158	6489	98	103	29	0	6719
25159	112	42	92	6560	0	6806
25160	108	6580	32	119	0	6839
25161	63	104	23	6443	0	6633
25162	57	6445	19	94	0	6615
25163	52	6806	22	106	0	6986
25164	6737	160	37	38	0	6972
25165	6822	108	37	35	0	7002
25166	197	36	6822	26	0	7081
25167	6759	34	107	31	0	6931
25168	6740	38	114	39	0	6931
25169	178	6690	42	28	0	6938
25170	133	101	29	6563	0	6826
25171	59	104	32	6601	0	6796
25172	54	49	6651	164	0	6918
25173	71	45	6624	103	0	6843
25174	6663	37	163	31	0	6894
25175	6753	20	115	39	0	6927
25176	6746	21	39	43	0	6849
25177	202	20	6648	44	0	6914
25178	156	21	101	6511	0	6789
25179	6599	27	100	113	0	6839
25180	116	31	38	6655	0	6840
25181	121	31	6578	124	0	6854
25182	6430	24	96	113	0	6663
25183	144	35	6882	43	0	7104
25184	127	6808	98	45	0	7078
25185	6874	105	95	37	0	7111
25186	151	93	6790	53	0	7087
25187	129	38	107	6663	0	6937
25188	6769	26	92	124	0	7011
25189	139	27	33	6867	0	7066
25190	7052	31	29	120	0	7232
25191	131	34	37	6924	0	7126
25192	7316	24	24	145	0	7509
25193	7147	41	31	121	0	7340
25194	7144	31	28	67	0	7270
25195	7146	37	22	46	0	7251
25196	196	74	21	6952	0	7243
25197	111	47	6753	96	0	7007
25198	70	32	7027	94	0	7223
25199	68	6882	153	51	0	7154
25200	37	5873	64	18	0	5992
25201	4580	105	152	11	0	4848
25202	36	19	7	4475	0	4537
25203	27	9	4597	20	0	4653
25204	12	8	4649	22	0	4691
25205	7	2	27	4647	0	4683
25206	4636	6	14	29	0	4685
25207	18	4727	9	20	0	4774
25208	4989	15	3	13	0	5020
25209	27	18	2	5312	0	5359
25210	23	5	5	5287	0	5320
25211	13	8	6	5479	0	5506
25212	10	5	5546	32	0	5593
25213	17	6	5389	23	0	5435
25214	13	5497	29	13	0	5552
25215	5	16	22	5523	0	5566
25216	5473	21	7	17	0	5518
25217	21	5	5370	16	0	5412
25218	25	9	5616	8	0	5658
25219	9	6	28	5568	0	5611
25220	10	5	23	5632	0	5670
25221	6	6	9	5683	0	5704
25222	13	8	9	5969	0	5999
25223	6202	8	6	51	0	6267
25224	34	8	5	6176	0	6223
25225	6259	0	15	38	0	6312
25226	42	2	6520	29	0	6593
25227	31	6729	37	13	0	6810
25228	15	43	25	6701	0	6784
25229	20	26	6780	47	0	6873
25230	13	6	7079	41	0	7139
25231	4	7299	70	29	0	7402
25232	10	44	49	7099	0	7202
25233	6	31	15	7239	0	7291
25234	16	9	7246	70	0	7341
25235	7056	13	42	38	0	7149
25236	52	7	39	7327	0	7425
25237	33	3	14	7257	0	7307
25238	17	4	7654	86	0	7761
25239	9	7602	63	59	0	7733
25240	12	8556	49	22	0	8639
25241	8763	106	19	18	0	8906
25242	89	60	14	8767	0	8930
25243	9364	20	14	100	0	9498
25244	117	9	9420	75	0	9621
25245	85	3	104	9384	0	9576
25246	9346	9	85	110	0	9550
25247	9312	11	29	83	0	9435
25248	159	7	18	9307	0	9491
25249	96	8	9308	113	0	9525
25250	42	9	9391	90	0	9532
25251	19	2	179	9242	0	9442
25252	21	9	9369	115	0	9514
25253	8758	7	113	85	0	8963
25254	102	9090	81	36	0	9309
25255	9174	100	20	21	0	9315
25256	9192	79	18	21	0	9310
25257	177	20	15	9123	0	9335
25258	87	20	15	9251	0	9373
25259	9193	13	14	175	0	9395
25260	111	10	16	9206	0	9343
25261	80	14	9194	128	0	9416
25262	26	9275	116	91	0	9508
25263	25	107	86	9013	0	9231
25264	19	80	27	9011	0	9137
25265	21	26	26	9249	0	9322
25266	24	11	9005	210	0	9250
25267	30	8971	108	135	0	9244
25268	25	98	93	9090	0	9306
25269	27	79	9006	141	0	9253
25270	25	30	126	9011	0	9192
25271	8921	20	92	135	0	9168
25272	118	21	38	8912	0	9089
25273	106	16	8817	140	0	9079
25274	8595	15	125	117	0	8852
25275	144	9063	89	62	0	9358
25276	98	9339	49	55	0	9541
25277	9581	174	46	47	0	9848
25278	152	105	9862	48	0	10167
25279	121	34	132	9588	0	9875
25280	64	20	100	9874	0	10058
25281	54	16	10133	223	0	10426
25282	42	10044	152	149	0	10387
25283	41	124	108	9683	0	9956
25284	40	96	9908	154	0	10198
25285	53	29	145	9837	0	10064
25286	9879	38	117	167	0	10201
25287	156	35	10521	142	0	10854
25288	133	28	131	10431	0	10723
25289	55	25	120	10531	0	10731
25290	51	65	10395	241	0	10752
25291	58	44	142	10008	0	10252
25292	42	9633	117	283	0	10075
25293	61	120	61	9539	0	9781
25294	42	10097	69	167	0	10375
25295	10049	138	52	153	0	10392
25296	9729	116	60	97	0	10002
25297	224	37	10102	91	0	10454
25298	145	25	9731	80	0	9981
25299	62	42	9903	71	0	10078
25300	53	9668	241	98	0	10060
25301	64	125	138	9774	0	10101
25302	55	101	9926	165	0	10247
25303	75	45	149	9603	0	9872
25304	57	47	120	9758	0	9982
25305	55	35	9778	249	0	10117
25306	84	29	146	9681	0	9940
25307	62	40	127	9463	0	9692
25308	46	9764	66	255	0	10131
25309	54	131	62	9546	0	9793
25310	43	113	69	9655	0	9880
25311	53	46	9510	247	0	9856
25312	52	44	153	9465	0	9714
25313	39	33	9620	205	0	9897
25314	34	41	9480	171	0	9726
25315	9084	33	222	124	0	9463
25316	148	32	166	9134	0	9480
25317	100	9366	68	205	0	9739
25318	62	9298	61	158	0	9579
25319	72	218	110	9493	0	9893
25320	49	117	9541	206	0	9913
25321	55	9546	159	186	0	9946
25322	91	455	139	8768	0	9453
25323	41	106	9131	149	0	9427
25324	53	9258	125	132	0	9568
25325	9224	127	121	79	0	9551
25326	9158	120	73	62	0	9413
25327	9671	48	51	75	0	9845
25328	245	39	63	9853	0	10200
25329	127	50	46	9914	0	10137
25330	41	23	51	10176	0	10291
25331	28	24	10171	261	0	10484
25332	9879	50	146	187	0	10262
25333	134	28	138	10204	0	10504
25334	155	28	10172	171	0	10526
25335	9799	33	153	170	0	10155
25336	10049	22	141	88	0	10300
25337	214	49	10002	74	0	10339
25338	9775	17	151	79	0	10022
25339	138	10491	118	67	0	10814
25340	88	80	9873	36	0	10077
25341	9223	76	94	45	0	9438
25342	82	9595	93	47	0	9817
25343	54	72	22	8985	0	9133
25344	10	9037	18	79	0	9144
25345	15	73	17	9148	0	9253
25346	16	58	9191	83	0	9348
25347	8394	15	98	88	0	8595
25348	84	10	9450	33	0	9577
25349	60	9208	89	27	0	9384
25350	10	9352	68	28	0	9458
25351	9321	129	15	19	0	9484
25352	84	68	9389	19	0	9560
25353	63	11	71	9114	0	9259
25354	15	13	9325	75	0	9428
25355	13	9617	73	89	0	9792
25356	15	74	69	9088	0	9246
25357	9	9621	21	62	0	9713
25358	9661	69	16	60	0	9806
25359	9638	69	18	20	0	9745
25360	9682	14	14	18	0	9728
25361	135	13	9687	12	0	9847
25362	74	12	9391	17	0	9494
25363	9393	3	139	24	0	9559
25364	84	10	9950	17	0	10061
25365	80	15	83	9436	0	9614
25366	14	9783	79	79	0	9955
25367	9997	81	19	76	0	10173
25368	9800	79	19	18	0	9916
25369	10090	12	19	34	0	10155
25370	150	10	21	10250	0	10431
25371	77	10	28	10394	0	10509
25372	10483	11	18	164	0	10676
25373	81	10463	16	99	0	10659
25374	10528	76	21	28	0	10653
25375	92	82	18	10111	0	10303
25376	91	13	13	10108	0	10225
25377	9847	11	22	147	0	10027
25378	79	9705	16	96	0	9896
25379	9831	78	21	24	0	9954
25380	87	9946	18	27	0	10078
25381	9708	75	19	17	0	9819
25382	89	81	7	10260	0	10437
25383	10553	15	14	80	0	10662
25384	10560	15	13	80	0	10668
25385	12462	11	21	19	0	12513
25386	189	12730	15	35	0	12969
25387	127	123	12223	22	0	12495
25388	11880	107	126	30	0	12143
25389	12219	22	115	26	0	12382
25390	232	12440	29	16	0	12717
25391	135	122	75	12324	0	12656
25392	39	113	11	12506	0	12669
25393	12499	29	19	223	0	12770
25394	147	23	20	12847	0	13037
25395	143	19	12742	135	0	13039
25396	42	20	12788	128	0	12978
25397	12929	20	236	35	0	13220
25398	147	18	126	13063	0	13354
25399	144	18	25	13160	0	13347
25400	42	17	23	13519	0	13601
25401	45	22	13463	259	0	13789
25402	44	20	140	13385	0	13589
25403	52	32	122	13544	0	13750
25404	56	12	31	13793	0	13892
25405	13757	23	24	266	0	14070
25406	167	24	27	13896	0	14114
25407	149	31	13890	170	0	14240
25408	14225	14	145	144	0	14528
25409	190	31	14615	45	0	14881
25410	14688	22	177	35	0	14922
25411	13214	58	196	62	0	13530
25412	336	28	35	14902	0	15301
25413	187	15187	17	270	0	15661
25414	80	176	33	15259	0	15548
25415	41	231	29	15276	0	15577
25416	36	15528	39	334	0	15937
25417	15540	168	26	181	0	15915
25418	173	15720	36	77	0	16006
25419	15571	172	21	55	0	15819
25420	15604	143	33	53	0	15833
25421	320	26	27	15380	0	15753
25422	194	26	25	15485	0	15730
25423	71	19	15005	331	0	15426
25424	60	15	14628	195	0	14898
25425	14146	17	279	83	0	14525
25426	14600	16	162	50	0	14828
25427	282	14009	42	64	0	14397
25428	164	134	30	13695	0	14023
25429	78	129	14131	168	0	14506
25430	106	206	143	13935	0	14390
25431	13724	12	131	192	0	14059
25432	13488	21	49	150	0	13708
25433	255	13634	34	61	0	13984
25434	173	135	27	13455	0	13790
25435	65	144	17	13444	0	13670
25436	55	43	16	13770	0	13884
25437	56	43	13138	291	0	13528
25438	11833	49	158	187	0	12227
25439	12460	27	123	78	0	12688
25440	299	29	12701	77	0	13106
25441	180	12594	129	79	0	12982
25442	12461	144	132	55	0	12792
25443	12435	126	47	72	0	12680
25444	296	33	12300	64	0	12693
25445	185	28	12463	59	0	12735
25446	85	77	253	12198	0	12613
25447	74	33	12469	164	0	12740
25448	11931	47	165	150	0	12293
25449	11977	25	136	80	0	12218
25450	12380	33	44	66	0	12523
25451	292	30	26	11903	0	12251
25452	177	12920	33	238	0	13368
25453	13165	137	41	155	0	13498
25454	13116	128	39	100	0	13383
25455	270	42	12769	100	0	13181
25456	181	37	12631	81	0	12930
25457	11816	31	252	83	0	12182
25458	194	29	153	12612	0	12988
25459	188	36	12640	193	0	13057
25460	88	12758	156	196	0	13198
25461	91	140	148	12700	0	13079
25462	12765	129	58	174	0	13126
25463	201	12959	57	162	0	13379
25464	168	148	60	12660	0	13036
25465	81	12760	52	176	0	13069
25466	81	12882	64	179	0	13206
25467	96	236	50	12943	0	13325
25468	107	128	39	12969	0	13243
25469	79	13139	74	266	0	13558
25470	13055	149	49	171	0	13424
25471	206	131	13005	87	0	13429
25472	12809	47	155	84	0	13095
25473	237	48	121	12926	0	13332
25474	180	38	76	12868	0	13162
25475	106	41	69	13081	0	13297
25476	95	42	65	13116	0	13318
25477	111	28	13188	278	0	13605
25478	92	52	169	13033	0	13346
25479	105	41	134	12876	0	13156
25480	88	13411	77	254	0	13830
25481	93	163	13859	166	0	14281
25482	97	14667	173	120	0	15057
25483	102	161	15026	97	0	15386
25484	71	15375	183	88	0	15717
25485	68	235	112	13263	0	13678
25486	13268	102	114	137	0	13621
25487	140	13436	38	162	0	13776
25488	145	134	48	13574	0	13901
25489	90	118	13455	136	0	13799
25490	53	13944	140	144	0	14281
25491	13938	124	132	57	0	14251
25492	13745	143	63	78	0	14029
25493	233	14116	58	52	0	14459
25494	171	130	13895	44	0	14240
25495	13268	134	139	43	0	13584
25496	163	49	131	14073	0	14416
25497	13867	42	61	156	0	14126
25498	167	13961	34	177	0	14339
25499	145	14109	46	76	0	14376
25500	91	245	13961	49	0	14346
25501	13438	165	138	97	0	13838
25502	205	47	142	14136	0	14530
25503	14222	50	58	135	0	14465
25504	167	14497	51	148	0	14863
25505	14346	131	115	63	0	14655
25506	14281	142	45	46	0	14514
25507	255	62	14735	53	0	15105
25508	143	13880	106	52	0	14181
25509	53	14188	111	52	0	14404
25510	30	268	49	13358	0	13705
25511	34	13628	31	107	0	13800
25512	13395	119	23	113	0	13650
25513	104	13387	15	173	0	13679
25514	104	125	20	13109	0	13358
25515	47	13173	26	104	0	13350
25516	30	12923	21	116	0	13090
25517	47	13360	29	40	0	13476
25518	44	204	126	13168	0	13542
25519	37	170	18	13115	0	13340
25520	47	56	26	13046	0	13175
25521	48	13042	23	183	0	13296
25522	56	121	12944	118	0	13239
25523	47	122	12943	38	0	13150
25524	12638	79	163	35	0	12915
25525	117	54	106	12986	0	13263
25526	134	55	13373	106	0	13668
25527	57	70	13711	113	0	13951
25528	51	14056	173	57	0	14337
25529	46	138	111	13081	0	13376
25530	58	130	31	13563	0	13782
25531	13599	77	32	200	0	13908
25532	139	64	33	13610	0	13846
25533	127	75	34	13625	0	13861
25534	75	52	14114	199	0	14440
25535	50	80	110	13908	0	14148
25536	44	63	118	14479	0	14704
25537	61	79	14492	192	0	14824
25538	41	84	14666	167	0	14958
25539	46	14751	180	78	0	15055
25540	64	155	14702	67	0	14988
25541	50	151	116	14234	0	14551
25542	43	122	134	13911	0	14210
25543	69	80	14763	226	0	15138
25544	29	14781	118	174	0	15102
25545	14374	161	116	95	0	14746
25546	129	15002	51	94	0	15276
25547	122	160	51	14837	0	15170
25548	50	157	59	15054	0	15320
25549	45	15215	73	340	0	15673
25550	56	168	64	14923	0	15211
25551	50	145	86	15072	0	15353
25552	73	84	14240	237	0	14634
25553	48	14225	142	192	0	14607
25554	50	169	139	14250	0	14608
25555	58	175	14658	160	0	15051
25556	82	80	151	14490	0	14803
25557	68	101	127	14370	0	14666
25558	70	67	69	14910	0	15116
25559	70	87	67	14795	0	15019
25560	73	87	66	14477	0	14703
25561	67	14697	61	296	0	15121
25562	14436	145	84	190	0	14855
25563	125	149	14416	122	0	14812
25564	13195	92	189	123	0	13599
25565	149	75	15469	111	0	15804
25566	111	16053	161	141	0	16466
25567	81	151	15895	111	0	16238
25568	37	16196	166	132	0	16531
25569	53	290	152	15428	0	15923
25570	48	170	84	15414	0	15716
25571	56	16339	73	242	0	16710
25572	39	16870	64	202	0	17175
25573	16922	239	43	121	0	17325
25574	16828	174	62	117	0	17181
25575	16947	93	49	131	0	17220
25576	16988	84	66	112	0	17250
25577	198	87	86	16944	0	17315
25578	123	17065	67	180	0	17435
25579	17175	161	67	197	0	17600
25580	100	147	67	17391	0	17705
25581	16661	84	86	153	0	16984
25582	15331	63	69	161	0	15624
25583	139	15430	50	118	0	15737
25584	61	14400	43	70	0	14574
25585	39	15383	40	52	0	15514
25586	149	385	30	14548	0	15112
25587	7	15531	34	155	0	15727
25588	15315	66	31	86	0	15498
25589	15404	63	24	62	0	15553
25590	15470	36	17	62	0	15585
25591	15729	19	32	50	0	15830
25592	15729	25	73	44	0	15871
25593	119	31	16308	33	0	16491
25594	16305	23	83	52	0	16463
25595	97	23	16737	39	0	16896
25596	16431	23	81	50	0	16585
25597	84	51	71	16260	0	16466
25598	76	33	17078	83	0	17270
25599	44	47	17486	65	0	17642
25600	27	18695	123	60	0	18905
25601	19070	136	101	43	0	19350
25602	19358	80	30	34	0	19502
25603	207	21643	23	49	0	21922
25604	110	199	20	25636	0	25965
25605	27279	147	21	276	0	27723
25606	301	55	27767	229	0	28352
25607	232	27599	260	57	0	28148
25608	27128	285	236	36	0	27685
25609	282	27788	42	45	0	28157
25610	221	307	20	26249	0	26797
25611	45	27794	22	271	0	28132
25612	39	361	21	26808	0	27229
25613	34	27088	14	353	0	27489
25614	27	27847	18	218	0	28110
25615	27051	458	58	56	0	27623
25616	27267	239	24	27	0	27557
25617	482	54	27339	59	0	27934
25618	264	45	26910	20	0	27239
25619	79	40	27526	28	0	27673
25620	42	41	472	27105	0	27660
25621	54	35	27896	295	0	28280
25622	42	50	303	27252	0	27647
25623	54	38	248	26989	0	27329
25624	37	27824	64	456	0	28381
25625	27733	298	27	251	0	28309
25626	300	28057	39	67	0	28463
25627	239	323	41	28336	0	28939
25628	72	253	38	28319	0	28682
25629	55	90	36	28864	0	29045
25630	89	57	28785	545	0	29476
25631	64	71	304	28531	0	28970
25632	66	90	260	28325	0	28741
25633	90	60	51	29191	0	29392
25634	100	98	28385	526	0	29109
25635	70	28495	305	406	0	29276
25636	28081	349	249	104	0	28783
25637	27501	283	94	87	0	27965
25638	494	28445	56	227	0	29222
25639	300	364	69	27994	0	28727
25640	110	307	60	28832	0	29309
25641	121	132	28559	546	0	29358
25642	94	28545	326	374	0	29339
25643	89	364	269	28736	0	29458
25644	103	310	28956	375	0	29744
25645	88	270	332	28402	0	29092
25646	108	102	289	28449	0	28948
25647	136	111	28795	568	0	29610
25648	101	97	367	28246	0	28811
25649	101	102	338	27950	0	28491
25650	111	94	29055	589	0	29849
25651	85	113	372	28911	0	29481
25652	99	120	343	28187	0	28749
25653	78	115	115	29481	0	29789
25654	112	108	29024	672	0	29916
25655	85	122	370	28755	0	29332
25656	28355	127	291	472	0	29245
25657	28335	130	123	395	0	28983
25658	517	28673	94	249	0	29533
25659	28957	333	121	196	0	29607
25660	381	323	30083	248	0	31035
25661	300	116	385	30316	0	31117
25662	119	104	330	29761	0	30314
25663	89	118	140	31012	0	31359
25664	29954	109	121	689	0	30873
25665	326	29699	119	529	0	30673
25666	267	380	104	28650	0	29401
25667	113	29423	95	449	0	30080
25668	29139	391	99	373	0	30002
25669	342	29253	97	225	0	29917
25670	29085	379	111	215	0	29790
25671	313	28819	103	276	0	29511
25672	261	28615	148	250	0	29274
25673	111	570	145	28347	0	29173
25674	103	308	136	28306	0	28853
25675	112	140	164	28198	0	28614
25676	93	123	135	28659	0	29010
25677	99	128	27981	718	0	28926
25678	80	28000	382	485	0	28947
25679	111	369	302	27073	0	27855
25680	84	28142	127	482	0	28835
25681	335	393	27946	431	0	29105
25682	121	300	355	27498	0	28274
25683	113	143	307	28399	0	28962
25684	128	101	28214	708	0	29151
25685	96	27178	406	530	0	28210
25686	106	331	354	27100	0	27891
25687	128	272	26913	503	0	27816
25688	99	26916	390	491	0	27896
25689	120	358	318	26471	0	27267
25690	131	305	26478	505	0	27419
25691	106	130	26167	520	0	26923
25692	76	26295	533	301	0	27205
25693	106	27698	291	245	0	28340
25694	84	590	202	27642	0	28518
25695	110	365	104	29397	0	29976
25696	115	163	29673	745	0	30696
25697	27787	143	401	525	0	28856
25698	28290	146	356	260	0	29052
25699	638	124	28591	229	0	29582
25700	316	26828	383	219	0	27746
25701	117	25662	341	177	0	26297
25702	75	25056	114	157	0	25402
25703	140	22831	106	205	0	23282
25704	292	833	197	19225	0	20547
25705	224	105	20	20883	0	21232
25706	13	31	18	21148	0	21210
25707	12	36	15	21345	0	21408
25708	7	21889	16	374	0	22286
25709	10	213	14	21939	0	22176
25710	14	22001	13	260	0	22288
25711	6	224	12	22131	0	22373
25712	21796	181	16	261	0	22254
25713	189	39	22	21995	0	22245
25714	165	21926	12	261	0	22364
25715	41	198	24	22177	0	22440
25716	27	183	28	22421	0	22659
25717	21	57	22	22735	0	22835
25718	22110	43	13	427	0	22593
25719	205	38	17	22512	0	22772
25720	197	51	22486	272	0	23006
25721	44	23208	196	285	0	23733
25722	27	253	172	23425	0	23877
25723	27	214	40	23641	0	23922
25724	23	52	26	24109	0	24210
25725	23534	42	12	496	0	24084
25726	263	51	23111	401	0	23826
25727	208	81	217	22511	0	23017
25728	39	22775	205	309	0	23328
25729	31	272	44	23184	0	23531
25730	22149	239	21	341	0	22750
25731	232	22585	22	314	0	23153
25732	204	279	17	22399	0	22899
25733	48	244	16	22482	0	22790
25734	22	22590	19	555	0	23186
25735	22	281	19	22797	0	23119
25736	42	247	8	22886	0	23183
25737	57	85	22542	566	0	23250
25738	30	22468	231	384	0	23113
25739	22516	295	209	183	0	23203
25740	275	258	22298	171	0	23002
25741	21938	89	242	190	0	22459
25742	308	103	22277	170	0	22858
25743	256	53	267	22195	0	22771
25744	21864	56	233	452	0	22605
25745	275	63	75	22186	0	22599
25746	22111	90	52	466	0	22719
25747	21976	87	52	438	0	22553
25748	21927	121	67	237	0	22352
25749	482	21915	55	218	0	22670
25750	300	339	54	21500	0	22193
25751	113	303	53	21771	0	22240
25752	132	135	45	21882	0	22194
25753	123	133	21397	669	0	22322
25754	84	112	286	21934	0	22416
25755	21753	114	231	533	0	22631
25756	21804	115	72	502	0	22493
25757	537	108	21652	308	0	22605
25758	21749	101	293	257	0	22400
25759	21834	119	274	250	0	22477
25760	526	120	128	20668	0	21442
25761	20280	130	96	491	0	20997
25762	20225	141	71	482	0	20919
25763	520	114	77	20308	0	21019
25764	20284	77	77	546	0	20984
25765	20035	112	120	438	0	20705
25766	595	109	97	20073	0	20874
25767	427	131	19140	488	0	20186
25768	18903	144	329	465	0	19841
25769	444	123	19579	268	0	20414
25770	387	154	19377	276	0	20194
25771	212	19360	614	312	0	20498
25772	216	337	312	18966	0	19831
25773	233	281	104	19207	0	19825
25774	221	161	107	19270	0	19759
25775	223	106	19072	784	0	20185
25776	262	103	18998	511	0	19874
25777	176	19182	522	375	0	20255
25778	268	343	323	18704	0	19638
25779	270	296	132	18955	0	19653
25780	284	110	150	19160	0	19704
25781	249	120	18483	700	0	19552
25782	225	18352	371	560	0	19508
25783	266	319	310	18368	0	19263
25784	265	253	18481	559	0	19558
25785	263	118	18438	475	0	19294
25786	18285	74	520	323	0	19202
25787	18402	58	352	263	0	19075
25788	18453	112	167	262	0	18994
25789	731	140	135	17545	0	18551
25790	493	102	18318	491	0	19404
25791	238	18182	339	576	0	19335
25792	247	18400	346	344	0	19337
25793	241	423	16379	283	0	17326
25794	397	686	358	14245	0	15686
25795	246	312	269	12864	0	13691
25796	237	13200	198	429	0	14064
25797	205	13299	222	363	0	14089
25798	13166	317	164	159	0	13806
25799	13416	209	121	169	0	13915
25800	13491	81	112	210	0	13894
25801	13469	51	142	196	0	13858
25802	12995	86	121	208	0	13410
25803	440	12799	128	219	0	13586
25804	235	10116	115	152	0	10618
25805	124	8100	106	126	0	8456
25806	7586	177	198	138	0	8099
25807	264	244	153	7006	0	7667
25808	102	35	60	6759	0	6956
25809	6739	24	59	157	0	6979
25810	134	6695	54	121	0	7004
25811	129	67	49	6761	0	7006
25812	96	56	71	6776	0	6999
25813	95	27	77	6864	0	7063
25814	6727	30	54	155	0	6966
25815	155	22	46	6911	0	7134
25816	125	24	6571	122	0	6842
25817	6434	31	88	104	0	6657
25818	151	28	74	6599	0	6852
25819	122	31	6907	124	0	7184
25820	100	6782	93	103	0	7078
25821	52	5939	51	38	0	6080
25822	5641	136	151	26	0	5954
25823	5638	59	13	26	0	5736
25824	95	5823	6	18	0	5942
25825	56	55	10	6214	0	6335
25826	6376	37	8	84	0	6505
25827	84	9	16	7210	0	7319
25828	67	10	9	7493	0	7579
25829	26	4	17	7599	0	7646
25830	16	12	19	7539	0	7586
25831	14	7471	16	176	0	7677
25832	17	86	12	7646	0	7761
25833	6	72	13	7512	0	7603
25834	16	21	12	7677	0	7726
25835	10	12	7534	188	0	7744
25836	10	7488	92	128	0	7718
25837	9	96	76	7444	0	7625
25838	16	68	7365	110	0	7559
25839	27	25	7118	79	0	7249
25840	6	7315	156	54	0	7531
25841	7241	101	90	24	0	7456
25842	104	76	27	7348	0	7555
25843	7337	25	16	116	0	7494
25844	112	7260	15	91	0	7478
25845	85	110	9	7307	0	7511
25846	7052	82	13	117	0	7264
25847	7119	28	20	92	0	7259
25848	171	20	15	7080	0	7286
25849	99	17	9	7127	0	7252
25850	37	16	7047	186	0	7286
25851	27	15	93	7024	0	7159
25852	18	16	74	7141	0	7249
25853	7025	17	28	195	0	7265
25854	106	6932	10	115	0	7163
25855	80	98	6621	52	0	6851
25856	6442	76	86	41	0	6645
25857	91	6720	76	33	0	6920
25858	79	96	29	6672	0	6876
25859	6546	75	12	107	0	6740
25860	102	25	8	6567	0	6702
25861	76	13	11	6619	0	6719
25862	34	19	6494	185	0	6732
25863	16	21	95	6585	0	6717
25864	6538	14	71	143	0	6766
25865	106	15	25	6617	0	6763
25866	6511	13	14	140	0	6678
25867	107	6339	15	126	0	6587
25868	78	6556	15	75	0	6724
25869	40	155	15	6474	0	6684
25870	16	98	17	6519	0	6650
25871	6162	32	14	198	0	6406
25872	103	6157	15	131	0	6406
25873	6164	103	13	69	0	6349
25874	6149	79	20	48	0	6296
25875	176	32	14	6148	0	6370
25876	6226	27	13	137	0	6403
25877	127	18	5958	118	0	6221
25878	96	23	100	6023	0	6242
25879	55	22	6089	140	0	6306
25880	30	25	116	6123	0	6294
25881	6037	16	93	149	0	6295
25882	6195	27	37	128	0	6387
25883	176	6241	17	73	0	6507
25884	104	102	20	6046	0	6272
25885	62	89	17	6089	0	6257
25886	40	6135	10	190	0	6375
25887	31	112	19	6286	0	6448
25888	40	87	14	6205	0	6346
25889	40	6152	16	205	0	6413
25890	5839	101	22	137	0	6099
25891	5747	94	11	94	0	5946
25892	182	47	18	5746	0	5993
25893	116	31	15	5828	0	5990
25894	57	26	5790	215	0	6088
25895	51	27	94	5686	0	5858
25896	40	5864	85	155	0	6144
25897	5851	100	46	134	0	6131
25898	136	92	24	5852	0	6104
25899	113	51	19	5626	0	5809
25900	5468	29	20	219	0	5736
25901	125	5626	23	145	0	5919
25902	116	109	22	5711	0	5958
25903	68	86	17	5671	0	5842
25904	44	5652	24	210	0	5930
25905	5626	113	43	129	0	5911
25906	128	104	5541	77	0	5850
25907	103	44	5507	72	0	5726
25908	82	25	145	5528	0	5780
25909	51	38	5601	130	0	5820
25910	5512	36	110	127	0	5785
25911	131	24	80	5612	0	5847
25912	105	23	5637	150	0	5915
25913	81	23	5594	121	0	5819
25914	46	5551	145	74	0	5816
25915	5421	93	81	49	0	5644
25916	114	5492	33	56	0	5695
25917	5436	101	26	62	0	5625
25918	5413	68	15	62	0	5558
25919	128	4970	18	58	0	5174
25920	4953	89	20	50	0	5112
25921	4796	66	21	62	0	4945
25922	145	41	4698	50	0	4934
25923	104	96	57	4440	0	4697
25924	57	4267	54	79	0	4457
25925	37	4002	20	58	0	4117
25926	140	325	143	3419	0	4027
25927	2897	51	66	73	0	3087
25928	22	7	3	2863	0	2895
25929	16	8	6	2975	0	3005
25930	6	1	1	3132	0	3140
25931	7	3281	5	54	0	3347
25932	10	31	2	3522	0	3565
25933	13	31	3866	43	0	3953
25934	3524	10	41	52	0	3627
25935	3850	5	38	18	0	3911
25936	77	3908	7	10	0	4002
25937	4019	39	5	9	0	4072
25938	47	41	1	3999	0	4088
25939	45	9	3974	43	0	4071
25940	3804	2	35	44	0	3885
25941	45	4015	40	16	0	4116
25942	40	36	6	3962	0	4044
25943	4115	37	2	42	0	4196
25944	34	4076	3	49	0	4162
25945	40	4177	0	13	0	4230
25946	4192	82	0	5	0	4279
25947	43	53	4114	12	0	4222
25948	4130	8	43	8	0	4189
25949	47	5	46	4050	0	4148
25950	43	4	10	4125	0	4182
25951	19	4	4110	87	0	4220
25952	10	6	4095	46	0	4157
25953	10	2	78	4142	0	4232
25954	6	3	4141	49	0	4199
25955	7	5	4138	48	0	4198
25956	8	9	79	4026	0	4122
25957	6	5	52	4036	0	4099
25958	4032	4	10	85	0	4131
25959	51	7	3	4099	0	4160
25960	4086	8	6	50	0	4150
25961	56	4058	5	52	0	4171
25962	54	43	2	4028	0	4127
25963	21	46	4092	47	0	4206
25964	3897	16	45	49	0	4007
25965	4074	8	45	17	0	4144
25966	4093	13	11	16	0	4133
25967	4056	9	9	12	0	4086
25968	4081	9	9	10	0	4109
25969	91	9	8	3990	0	4098
25970	67	8	3931	44	0	4050
25971	19	10	3879	57	0	3965
25972	14	9	4010	20	0	4053
25973	3804	5	92	18	0	3919
25974	3903	11	91	17	0	4022
25975	93	9	20	3787	0	3909
25976	59	4024	18	48	0	4149
25977	23	46	43	4036	0	4148
25978	20	46	4014	64	0	4144
25979	20	19	3983	55	0	4077
25980	3786	9	91	25	0	3911
25981	62	6	4136	25	0	4229
25982	58	3	58	4013	0	4132
25983	4228	7	50	52	0	4337
25984	4201	12	23	63	0	4299
25985	4426	11	13	23	0	4473
25986	4388	4	12	25	0	4429
25987	98	7	4274	27	0	4406
25988	4216	14	50	17	0	4297
25989	68	4402	52	17	0	4539
25990	67	53	21	4424	0	4565
25991	34	51	4509	57	0	4651
25992	30	20	53	4498	0	4601
25993	28	13	4670	72	0	4783
25994	28	14	64	4570	0	4676
25995	36	4	63	4619	0	4722
25996	36	77	4410	107	0	4630
25997	38	8	55	4435	0	4536
25998	4463	11	69	73	0	4616
25999	77	10	26	4477	0	4590
26000	72	15	27	4476	0	4590
26001	4278	18	23	116	0	4435
26002	71	4372	30	80	0	4553
26003	4469	49	32	27	0	4577
26004	91	4442	20	28	0	4581
26005	4520	61	21	33	0	4635
26006	77	60	4468	33	0	4638
26007	72	23	67	4436	0	4598
26008	50	13	66	4457	0	4586
26009	4447	17	40	101	0	4605
26010	69	4355	25	78	0	4527
26011	88	51	32	4418	0	4589
26012	39	46	33	4383	0	4501
26013	42	4401	18	115	0	4576
26014	4364	49	22	80	0	4515
26015	72	4494	31	41	0	4638
26016	72	53	34	4427	0	4586
26017	43	50	32	4287	0	4412
26018	27	4356	31	105	0	4519
26019	4365	50	23	83	0	4521
26020	75	50	4439	39	0	4603
26021	4348	13	71	36	0	4468
26022	82	4394	71	38	0	4585
26023	90	52	27	4381	0	4550
26024	4352	59	27	74	0	4512
26025	83	14	18	4381	0	4496
26026	62	17	23	4213	0	4315
26027	4284	4	23	112	0	4423
26028	73	4188	27	79	0	4367
26029	75	4236	12	29	0	4352
26030	4231	61	22	18	0	4332
26031	63	43	4198	28	0	4332
26032	49	3973	32	24	0	4078
26033	19	24	95	3585	0	3723
26034	18	20	4626	29	0	4693
26035	11	12	30	4516	0	4569
26036	4593	1	49	43	0	4686
26037	34	4676	11	70	0	4791
26038	62	40	7	4456	0	4565
26039	7	4733	5	40	0	4785
26040	4741	39	4	45	0	4829
26041	4636	58	5	12	0	4711
26042	87	4759	3	16	0	4865
26043	55	35	4	4600	0	4694
26044	12	4878	36	38	0	4964
26045	4898	38	5	51	0	4992
26046	4944	63	6	15	0	5028
26047	97	4	5	4890	0	4996
26048	69	6	3	4992	0	5070
26049	24	12	4947	96	0	5079
26050	4752	2	39	72	0	4865
26051	58	5	5016	19	0	5098
26052	70	8	49	4907	0	5034
26053	4890	12	67	46	0	5015
26054	49	4883	17	75	0	5024
26055	4828	43	13	23	0	4907
26056	55	71	4720	19	0	4865
26057	4608	13	39	27	0	4687
26058	60	4932	65	9	0	5066
26059	4982	50	11	14	0	5057
26060	59	5081	13	12	0	5165
26061	67	58	12	4984	0	5121
26062	27	69	4993	54	0	5143
26063	22	29	4880	62	0	4993
26064	20	12	100	4947	0	5079
26065	18	17	4997	60	0	5092
26066	16	12	50	4939	0	5017
26067	19	12	68	4853	0	4952
26068	24	11	5001	112	0	5148
26069	4378	15	49	87	0	4529
26070	4901	12	69	27	0	5009
26071	101	4911	19	28	0	5059
26072	5013	48	12	16	0	5089
26073	62	66	14	4944	0	5086
26074	80	14	5116	53	0	5263
26075	21	11	48	5114	0	5194
26076	19	10	64	5088	0	5181
26077	5073	14	21	108	0	5216
26078	58	5135	9	82	0	5284
26079	73	5216	8	23	0	5320
26080	22	90	6	5202	0	5320
26081	22	73	10	5103	0	5208
26082	20	5096	10	103	0	5229
26083	20	50	11	5024	0	5105
26084	12	71	15	4819	0	4917
26085	12	4844	10	127	0	4993
26086	4825	52	16	77	0	4970
26087	48	72	18	4798	0	4936
26088	82	4845	9	69	0	5005
26089	27	54	17	4779	0	4877
26090	4681	74	15	68	0	4838
26091	55	4667	16	84	0	4822
26092	4717	52	11	38	0	4818
26093	4657	78	12	28	0	4775
26094	119	24	8	4704	0	4855
26095	4865	24	7	59	0	4955
26096	4809	18	11	78	0	4916
26097	4817	30	7	26	0	4880
26098	4870	18	17	19	0	4924
26099	126	20	12	4845	0	5003
26100	91	22	11	4923	0	5047
26101	44	20	4870	121	0	5055
26102	40	14	50	4867	0	4971
26103	31	14	72	4919	0	5036
26104	35	19	4870	138	0	5062
26105	4730	16	55	100	0	4901
26106	76	21	76	5043	0	5216
26107	94	34	5137	70	0	5335
26108	4916	15	57	114	0	5102
26109	86	25	5368	46	0	5525
26110	101	5405	75	38	0	5619
26111	41	5543	84	44	0	5712
26112	44	128	41	5912	0	6125
26113	40	92	6334	95	0	6561
26114	6294	34	89	106	0	6523
26115	6586	29	96	41	0	6752
26116	183	25	6570	28	0	6806
26117	6481	16	96	37	0	6630
26118	6602	16	109	26	0	6753
26119	192	6611	33	32	0	6868
26120	6608	87	22	35	0	6752
26121	111	87	35	6499	0	6732
26122	109	24	6632	112	0	6877
26123	45	21	83	6380	0	6529
26124	36	6668	94	100	0	6898
26125	37	6858	32	112	0	7039
26126	6819	153	23	45	0	7040
26127	6628	109	34	29	0	6800
26128	6766	37	24	40	0	6867
26129	181	21	23	6513	0	6738
26130	120	19	30	6410	0	6579
26131	42	6303	18	191	0	6554
26132	6325	90	20	122	0	6557
26133	119	6556	24	50	0	6749
26134	5428	74	14	18	0	5534
26135	94	5446	12	21	0	5573
26136	5368	79	18	12	0	5477
26137	5160	53	12	21	0	5246
26138	126	60	16	5027	0	5229
26139	84	5396	11	68	0	5559
26140	41	75	5177	51	0	5344
26141	4974	56	64	32	0	5126
26142	79	5175	52	28	0	5334
26143	63	66	5192	17	0	5338
26144	33	44	5265	14	0	5356
26145	21	49	89	4892	0	5051
26146	23	13	42	4952	0	5030
26147	19	5248	17	82	0	5366
26148	5224	55	14	44	0	5337
26149	73	44	4	5115	0	5236
26150	45	5500	2	57	0	5604
26151	28	6015	8	41	0	6092
26152	30	80	6034	20	0	6164
26153	26	54	6023	9	0	6112
26154	5885	27	81	14	0	6007
26155	72	14	6127	7	0	6220
26156	48	21	53	5917	0	6039
26157	38	15	37	6168	0	6258
26158	26	18	6128	90	0	6262
26159	28	17	52	6000	0	6097
26160	28	23	43	5982	0	6076
26161	5809	12	19	91	0	5931
26162	6089	15	12	46	0	6162
26163	92	16	14	6073	0	6195
26164	49	6028	17	69	0	6163
26165	21	6363	15	55	0	6454
26166	6346	84	17	25	0	6472
26167	75	54	6319	19	0	6467
26168	54	22	61	6206	0	6343
26169	6408	14	51	71	0	6544
26170	6675	28	18	50	0	6771
26171	107	23	21	6684	0	6835
26172	72	18	6701	74	0	6865
26173	31	26	6530	49	0	6636
26174	6190	26	114	30	0	6360
26175	6607	20	71	19	0	6717
26176	107	6767	36	20	0	6930
26177	68	7007	21	25	0	7121
26178	7082	93	34	22	0	7231
26179	7060	59	31	27	0	7177
26180	129	18	26	7084	0	7257
26181	81	26	23	7287	0	7417
26182	54	23	23	7360	0	7460
26183	7263	22	34	117	0	7436
26184	109	27	22	7294	0	7452
26185	91	27	7527	87	0	7732
26186	7313	31	78	62	0	7484
26187	111	26	53	7528	0	7718
26188	81	26	7837	87	0	8031
26189	7402	35	66	65	0	7568
26190	7598	38	55	38	0	7729
26191	113	8817	23	56	0	9009
26192	82	9013	28	36	0	9159
26193	64	112	8968	29	0	9173
26194	8496	72	67	28	0	8663
26195	91	9288	52	56	0	9487
26196	87	76	9444	25	0	9632
26197	8986	70	75	25	0	9156
26198	107	10221	56	39	0	10423
26199	86	84	10161	32	0	10363
26200	9558	69	68	40	0	9735
26201	105	10222	51	29	0	10407
26202	72	97	20	10196	0	10385
26203	10158	54	22	94	0	10328
26204	99	10200	18	63	0	10380
26205	63	81	20	10126	0	10290
26206	9922	46	30	121	0	10119
26207	87	20	10104	60	0	10271
26208	56	10087	75	40	0	10258
26209	98	105	10001	23	0	10227
26210	19	80	70	9736	0	9905
26211	31	17	9893	76	0	10017
26212	14	9413	53	58	0	9538
26213	40	9065	90	17	0	9212
26214	47	80	11	8863	0	9001
26215	2	20	14	8622	0	8658
26216	4	3	4	8869	0	8880
26217	12	6	9401	55	0	9474
26218	7	2	40	9382	0	9431
26219	9327	2	29	52	0	9410
26220	8851	6	14	33	0	8904
26221	88	3	9616	11	0	9718
26222	31	9811	35	18	0	9895
26223	9822	38	24	14	0	9898
26224	44	9734	3	5	0	9786
26225	9670	44	8	10	0	9732
26226	9501	27	4	14	0	9546
26227	72	10	9653	6	0	9741
26228	30	9903	41	13	0	9987
26229	9	39	27	10015	0	10090
26230	17	25	10084	42	0	10168
26231	9626	7	43	29	0	9705
26232	41	6	27	10002	0	10076
26233	29	7	10032	41	0	10109
26234	9499	9	38	33	0	9579
26235	58	5	10444	12	0	10519
26236	35	7	41	10676	0	10759
26237	10963	7	32	54	0	11056
26238	49	11755	17	48	0	11869
26239	57	45	11850	21	0	11973
26240	11470	46	45	20	0	11581
26241	12669	14	41	19	0	12743
26242	89	13314	14	16	0	13433
26243	66	60	10	13260	0	13396
26244	18	62	7	13107	0	13194
26245	13110	14	13	114	0	13251
26246	58	12	13	13228	0	13311
26247	64	12	13244	65	0	13385
26248	14	10	60	13154	0	13238
26249	13185	8	65	78	0	13336
26250	55	13059	20	105	0	13239
26251	66	63	14	12645	0	12788
26252	21	12936	7	65	0	13029
26253	13146	71	10	85	0	13312
26254	71	79	10	14354	0	14514
26255	82	17	19	14909	0	15027
26256	23	15149	18	207	0	15397
26257	32	124	14932	117	0	15205
26258	18	114	119	14543	0	14794
26259	20	35	118	14676	0	14849
26260	17	29	34	14812	0	14892
26261	16	15112	12	234	0	15374
26262	36	120	15260	125	0	15541
26263	25	126	15407	28	0	15586
26264	15122	28	221	37	0	15408
26265	15474	18	129	26	0	15647
26266	244	13	16134	16	0	16407
26267	15831	13	136	29	0	16009
26268	166	18	16384	28	0	16596
26269	15419	16	156	26	0	15617
26270	145	16115	117	38	0	16415
26271	16324	133	41	32	0	16530
26272	173	113	16471	33	0	16790
26273	148	35	16615	28	0	16826
26274	39	24	253	17317	0	17633
26275	17939	14	133	211	0	18297
26276	188	18861	36	177	0	19262
26277	175	219	21372	60	0	21826
26278	52	165	269	21271	0	21757
26279	43	41	210	22053	0	22347
26280	22120	20	49	486	0	22675
26281	21941	32	22	259	0	22254
26282	483	26	23	21992	0	22524
26283	22352	35	30	307	0	22724
26284	334	34	21923	320	0	22611
26285	268	24	277	21273	0	21842
26286	61	23	237	22025	0	22346
26287	21609	35	45	510	0	22199
26288	21465	39	41	281	0	21826
26289	500	26	46	21411	0	21983
26290	21405	38	47	317	0	21807
26291	342	24	20377	267	0	21010
26292	261	20340	276	107	0	20984
26293	88	283	20455	67	0	20893
26294	57	232	310	20379	0	20978
26295	19892	62	272	375	0	20601
26296	305	19799	76	274	0	20454
26297	249	288	59	19354	0	19950
26298	95	232	59	18751	0	19137
26299	74	18963	51	493	0	19581
26300	80	301	65	19227	0	19673
26301	74	317	72	18974	0	19437
26302	78	62	50	19256	0	19446
26303	82	45	49	19126	0	19302
26304	92	29	63	19216	0	19400
26305	95	18895	54	580	0	19624
26306	95	292	66	19266	0	19719
26307	117	238	59	19205	0	19619
26308	133	61	18718	572	0	19484
26309	89	18713	330	354	0	19486
26310	108	306	262	18649	0	19325
26311	112	242	105	18497	0	18956
26312	136	63	86	18641	0	18926
26313	123	18554	69	607	0	19353
26314	154	305	18568	369	0	19396
26315	162	253	345	18583	0	19343
26316	124	93	18804	420	0	19441
26317	144	60	18300	381	0	18885
26318	132	62	534	18283	0	19011
26319	18444	73	307	395	0	19219
26320	359	74	116	18411	0	18960
26321	337	50	87	18134	0	18608
26322	154	18242	69	624	0	19089
26323	132	325	89	18526	0	19072
26324	121	263	80	18776	0	19240
26325	134	72	18790	633	0	19629
26326	130	18775	317	424	0	19646
26327	120	324	294	18906	0	19644
26328	18433	276	114	452	0	19275
26329	364	116	18682	400	0	19562
26330	309	104	347	18516	0	19276
26331	108	83	308	18856	0	19355
26332	18477	99	112	680	0	19368
26333	348	18514	87	517	0	19466
26334	18411	329	99	284	0	19123
26335	340	18296	94	297	0	19027
26336	280	332	105	17861	0	18578
26337	17520	289	88	504	0	18401
26338	371	94	17062	483	0	18010
26339	306	16837	338	308	0	17789
26340	144	16981	308	277	0	17710
26341	15827	479	144	246	0	16696
26342	321	308	123	15289	0	16041
26343	260	15462	105	490	0	16317
26344	120	15908	91	458	0	16577
26345	139	477	88	15722	0	16426
26346	121	300	82	15934	0	16437
26347	15489	106	93	697	0	16385
26348	350	15524	119	474	0	16467
26349	296	356	213	15687	0	16552
26350	158	282	15456	480	0	16376
26351	117	15398	370	433	0	16318
26352	190	313	15265	288	0	16056
26353	122	15107	383	269	0	15881
26354	260	490	359	13126	0	14235
26355	134	214	67	12758	0	13173
26356	122	13050	62	502	0	13736
26357	134	267	12967	325	0	13693
26358	12589	236	232	230	0	13287
26359	252	148	183	12989	0	13572
26360	211	113	94	13311	0	13729
26361	89	129	13055	506	0	13779
26362	93	187	261	13036	0	13577
26363	85	144	12998	393	0	13620
26364	76	144	231	13027	0	13478
26365	91	129	13241	393	0	13854
26366	60	13033	226	408	0	13727
26367	86	284	13584	243	0	14197
26368	43	279	244	13513	0	14079
26369	13548	125	170	421	0	14264
26370	226	13869	82	384	0	14561
26371	230	306	71	13821	0	14428
26372	83	248	13675	392	0	14398
26373	62	13815	294	345	0	14516
26374	43	442	211	12520	0	13216
26375	52	216	12418	278	0	12964
26376	39	11242	188	181	0	11650
26377	8257	121	209	93	0	8680
26378	7443	81	50	54	0	7628
26379	100	12	9	7537	0	7658
26380	7564	13	9	66	0	7652
26381	71	9	6	7471	0	7557
26382	48	3	9	7641	0	7701
26383	22	6	7914	110	0	8052
26384	7	6	67	7831	0	7911
26385	5	13	41	7965	0	8024
26386	7838	8	15	108	0	7969
26387	7599	12	9	63	0	7683
26388	106	7882	9	30	0	8027
26389	49	67	7917	19	0	8052
26390	15	50	73	7902	0	8040
26391	19	19	7965	72	0	8075
26392	7534	9	80	54	0	7677
26393	73	11	7976	28	0	8088
26394	70	29	61	7533	0	7693
26395	17	7764	40	65	0	7886
26396	8	54	13	7708	0	7783
26397	8	51	15	7748	0	7822
26398	12	22	8069	100	0	8203
26399	5	15	56	8043	0	8119
26400	8026	7	55	77	0	8165
26401	7915	15	19	55	0	8004
26402	7939	13	17	19	0	7988
26403	8114	10	9	24	0	8157
26404	100	7926	17	25	0	8068
26405	49	7765	8	21	0	7843
26406	24	87	13	7537	0	7661
26407	14	46	13	7670	0	7743
26408	8	7610	19	103	0	7740
26409	11	54	13	7732	0	7810
26410	8	48	11	7670	0	7737
26411	19	14	12	7638	0	7683
26412	22	7	11	7675	0	7715
26413	19	19	13	7689	0	7740
26414	7600	15	17	105	0	7737
26415	54	7512	16	79	0	7661
26416	51	54	7406	31	0	7542
26417	24	51	57	7286	0	7418
26418	18	16	52	7171	0	7257
26419	12	20	21	7243	0	7296
26420	7188	24	19	99	0	7330
26421	68	7744	11	77	0	7900
26422	58	86	14	7622	0	7780
26423	21	7950	23	107	0	8101
26424	22	101	21	7788	0	7932
26425	25	7647	16	120	0	7808
26426	32	103	7975	91	0	8201
26427	30	61	118	8362	0	8571
26428	33	29	9727	168	0	9957
26429	32	23	155	9436	0	9646
26430	25	26	120	10141	0	10312
26431	10068	18	29	298	0	10413
26432	9916	35	36	155	0	10142
26433	10183	24	29	59	0	10295
26434	10149	18	30	66	0	10263
26435	10225	18	32	43	0	10318
26436	317	31	18	9841	0	10207
26437	160	10004	28	212	0	10404
26438	60	179	26	9983	0	10248
26439	41	136	9712	229	0	10118
26440	9519	54	170	171	0	9914
26441	9826	26	141	80	0	10073
26442	291	22	50	9766	0	10129
26443	178	25	32	9520	0	9755
26444	71	9490	13	318	0	9892
26445	67	164	24	9714	0	9969
26446	52	139	23	9461	0	9675
26447	46	9464	19	354	0	9883
26448	41	180	20	9745	0	9986
26449	9171	137	36	234	0	9578
26450	197	45	9277	189	0	9708
26451	9199	36	181	88	0	9504
26452	225	39	9387	79	0	9730
26453	155	31	192	9096	0	9474
26454	58	33	136	8816	0	9043
26455	43	8897	43	355	0	9338
26456	40	9156	42	189	0	9427
26457	52	290	40	8843	0	9225
26458	70	152	8912	220	0	9354
26459	8541	43	195	162	0	8941
26460	204	22	137	8724	0	9087
26461	155	8763	57	228	0	9203
26462	78	174	17	8781	0	9050
26463	64	153	24	8590	0	8831
26464	65	8437	23	337	0	8862
26465	76	190	21	8148	0	8435
26466	64	122	7577	220	0	7983
26467	71	35	7070	136	0	7312
26468	54	51	189	6288	0	6582
26469	31	6533	100	146	0	6810
26470	27	137	30	6471	0	6665
26471	6398	108	18	168	0	6692
26472	6422	40	20	131	0	6613
26473	6211	26	15	64	0	6316
26474	233	6207	15	61	0	6516
26475	138	128	6080	59	0	6405
26476	5933	114	131	56	0	6234
26477	6115	42	94	53	0	6304
26478	209	6037	37	70	0	6353
26479	127	132	24	6033	0	6316
26480	5972	117	16	168	0	6273
26481	6022	42	25	143	0	6232
26482	6117	40	22	58	0	6237
26483	248	23	43	5597	0	5911
26484	5665	25	30	150	0	5870
26485	168	21	44	5705	0	5938
26486	135	29	26	5756	0	5946
26487	5628	36	34	266	0	5964
26488	166	46	21	5643	0	5876
26489	5556	46	36	202	0	5840
26490	176	44	28	5504	0	5752
26491	153	27	37	5569	0	5786
26492	5463	43	28	262	0	5796
26493	193	34	5341	197	0	5765
26494	166	48	129	5428	0	5771
26495	80	38	114	5370	0	5602
26496	86	34	41	5347	0	5508
26497	72	51	39	5441	0	5603
26498	81	38	33	5145	0	5297
26499	77	4999	43	305	0	5424
26500	99	148	38	5146	0	5431
26501	109	119	4971	207	0	5406
26502	115	65	131	5082	0	5393
26503	96	39	117	5052	0	5304
26504	117	46	30	5247	0	5440
26505	75	44	4921	297	0	5337
26506	74	59	4965	192	0	5290
26507	4896	54	220	117	0	5287
26508	5000	47	134	81	0	5262
26509	269	5117	53	96	0	5535
26510	197	145	31	5242	0	5615
26511	82	144	38	5379	0	5643
26512	88	50	34	5511	0	5683
26513	5300	44	39	308	0	5691
26514	5433	41	33	207	0	5714
26515	269	38	30	5418	0	5755
26516	161	54	27	5493	0	5735
26517	90	47	35	5590	0	5762
26518	74	36	37	5644	0	5791
26519	5358	35	55	322	0	5770
26520	179	34	5166	215	0	5594
26521	118	4570	120	129	0	4937
26522	59	4385	91	88	0	4623
26523	4027	166	23	101	0	4317
26524	108	182	51	3975	0	4316
26525	107	48	4043	155	0	4353
26526	42	23	3753	120	0	3938
26527	28	3526	105	63	0	3722
26528	2124	22	42	20	0	2208
26529	27	19	2096	16	0	2158
26530	1609	38	6	5	0	1658
26531	7	0	7	1703	0	1717
26532	10	0	1	1709	0	1720
26533	7	1714	1	11	0	1733
26534	3	1871	1	15	0	1890
26535	1874	8	0	9	0	1891
26536	1852	6	2	7	0	1867
26537	8	1889	2	15	0	1914
26538	7	7	1884	5	0	1903
26539	5	8	1884	4	0	1901
26540	4	7	11	1856	0	1878
26541	1900	1	9	14	0	1924
26542	5	1919	6	10	0	1940
26543	7	6	2	2176	0	2191
26544	2204	7	4	13	0	2228
26545	11	4	2	2217	0	2234
26546	11	3	4	2322	0	2340
26547	2358	2	3	22	0	2385
26548	12	2374	3	24	0	2413
26549	17	2529	2	11	0	2559
26550	12	20	2607	7	0	2646
26551	2	17	11	2577	0	2607
26552	2	8	13	2557	0	2580
26553	4	3	2656	25	0	2688
26554	2292	5	10	21	0	2328
26555	2506	5	15	12	0	2538
26556	22	2	2681	7	0	2712
26557	2381	1	13	15	0	2410
26558	21	2	2794	10	0	2827
26559	12	2935	16	10	0	2973
26560	13	14	10	3136	0	3173
26561	6	10	8	3267	0	3291
26562	3318	7	1	31	0	3357
26563	3293	3	4	25	0	3325
26564	3245	4	5	16	0	3270
26565	3287	3	2	11	0	3303
26566	3273	5	3	12	0	3293
26567	29	2	3316	8	0	3355
26568	22	3333	9	9	0	3373
26569	12	12	14	3286	0	3324
26570	11	3327	9	17	0	3364
26571	6	3339	7	10	0	3362
26572	4	23	25	3317	0	3369
26573	6	18	6	3300	0	3330
26574	8	49	3348	23	0	3428
26575	3070	5	15	29	0	3119
26576	3351	4	14	11	0	3380
26577	24	3368	11	12	0	3415
26578	3392	14	2	15	0	3423
26579	3487	8	7	8	0	3510
26580	24	8	6	3501	0	3539
26581	31	3	3737	15	0	3786
26582	12	4	3694	14	0	3724
26583	3624	3	17	15	0	3659
26584	3771	1	15	9	0	3796
26585	23	3682	7	8	0	3720
26586	23	3878	5	8	0	3914
26587	11	24	4	3971	0	4010
26588	3985	14	2	17	0	4018
26589	24	10	4212	14	0	4260
26590	14	4	17	4198	0	4233
26591	4336	5	16	19	0	4376
26592	4333	7	6	22	0	4368
26593	28	8	5	4531	0	4572
26594	4598	8	5	19	0	4630
26595	31	7	4490	19	0	4547
26596	19	7	5112	15	0	5153
26597	11	5	36	4971	0	5023
26598	9	4	19	5215	0	5247
26599	8	9	6	5166	0	5189
26600	9	5113	13	30	0	5165
26601	18	5191	7	25	0	5241
26602	15	27	4	5255	0	5301
26603	5404	23	8	23	0	5458
26604	24	7	8	5456	0	5495
26605	22	3	10	5524	0	5559
26606	15	5569	3	36	0	5623
26607	11	5685	9	30	0	5735
26608	12	30	6	5709	0	5757
26609	13	26	4	5507	0	5550
26610	5409	12	4	48	0	5473
26611	26	5382	4	64	0	5476
26612	5477	24	4	16	0	5521
26613	35	16	5	5584	0	5640
26614	27	9	5575	26	0	5637
26615	19	10	5608	23	0	5660
26616	5678	3	28	22	0	5731
26617	25	7	21	6013	0	6066
26618	24	6	16	5957	0	6003
26619	12	4	11	6043	0	6070
26620	11	1	6189	49	0	6250
26621	9	5	22	6146	0	6182
26622	12	6053	13	37	0	6115
26623	13	20	8	6307	0	6348
26624	10	24	2	6319	0	6355
26625	10	6622	12	38	0	6682
26626	11	38	8	6754	0	6811
26627	6601	21	4	59	0	6685
26628	36	6610	8	37	0	6691
26629	7089	38	6	25	0	7158
26630	7039	36	5	12	0	7092
26631	77	20	0	7100	0	7197
26632	55	6	7	7069	0	7137
26633	24	9	6	7246	0	7285
26634	15	7	7050	105	0	7177
26635	18	6931	46	61	0	7056
26636	11	7083	42	26	0	7162
26637	3	87	16	7055	0	7161
26638	7021	38	4	54	0	7117
26639	51	8	7	7066	0	7132
26640	47	17	7313	62	0	7439
26641	18	7218	40	56	0	7332
26642	13	7287	34	21	0	7355
26643	7028	65	7	13	0	7113
26644	7063	35	5	11	0	7114
26645	64	7936	3	9	0	8012
26646	8129	42	8	7	0	8186
26647	55	30	8112	11	0	8208
26648	45	11	8051	9	0	8116
26649	8056	5	84	18	0	8163
26650	8263	5	41	11	0	8320
26651	98	7	5	8278	0	8388
26652	8362	7	1	72	0	8442
26653	83	3	8479	50	0	8615
26654	50	8	8964	14	0	9036
26655	23	13	110	10282	0	10428
26656	8	6	56	11541	0	11611
26657	7	7	11	11985	0	12010
26658	13	14	11	12340	0	12378
26659	6	7	6	13133	0	13152
26660	17	7	12712	389	0	13125
26661	8	13	229	12774	0	13024
26662	12640	7	139	302	0	13088
26663	247	3	26	12762	0	13038
26664	12697	8	17	298	0	13020
26665	279	7	10	12769	0	13065
26666	12740	10	15	293	0	13058
26667	13047	11	8	188	0	13254
26668	404	12	9	13092	0	13517
26669	181	5	15	13381	0	13582
26670	12994	10	77	413	0	13494
26671	13085	17	13	204	0	13319
26672	413	14	13240	66	0	13733
26673	199	7	249	13099	0	13554
26674	62	5	151	13566	0	13784
26675	13306	14	32	415	0	13767
26676	13454	13	21	199	0	13687
26677	412	12	13	13307	0	13744
26678	188	13	20	13604	0	13825
26679	67	4	26	13775	0	13872
26680	42	9	14	13625	0	13690
26681	33	12898	50	482	0	13463
26682	35	13317	11	247	0	13610
26683	42	379	17	13153	0	13591
26684	71	13290	30	316	0	13707
26685	41	274	17	13492	0	13824
26686	49	161	13148	334	0	13692
26687	55	35	12951	249	0	13290
26688	38	13108	374	124	0	13644
26689	37	258	165	12960	0	13420
26690	61	166	13014	315	0	13556
26691	38	49	262	12883	0	13232
26692	48	23	166	13227	0	13464
26693	12911	23	41	480	0	13455
26694	313	17	32	13108	0	13470
26695	201	9	13202	363	0	13775
26696	102	8	13162	241	0	13513
26697	65	13006	382	131	0	13584
26698	66	13548	190	108	0	13912
26699	13674	389	53	90	0	14206
26700	308	185	14676	109	0	15278
26701	206	53	272	14544	0	15075
26702	14729	20	171	350	0	15270
26703	14699	23	52	245	0	15019
26704	435	14876	54	125	0	15490
26705	227	284	40	14688	0	15239
26706	93	176	33	15086	0	15388
26707	67	57	27	15128	0	15279
26708	14769	42	28	505	0	15344
26709	315	29	14749	287	0	15380
26710	189	14891	271	137	0	15488
26711	90	284	171	14888	0	15433
26712	64	176	58	15246	0	15544
26713	49	60	15085	535	0	15729
26714	58	57	286	14851	0	15252
26715	49	34	184	15063	0	15330
26716	44	47	86	15105	0	15282
26717	51	39	58	15189	0	15337
26718	76	28	14727	561	0	15392
26719	60	35	311	14765	0	15171
26720	65	43	14949	455	0	15512
26721	53	14915	319	331	0	15618
26722	63	277	220	14901	0	15461
26723	70	186	74	15397	0	15727
26724	72	53	14946	570	0	15641
26725	81	14658	279	342	0	15360
26726	97	299	206	14651	0	15253
26727	112	157	14861	366	0	15496
26728	77	14785	307	289	0	15458
26729	98	278	177	14513	0	15066
26730	81	167	14675	388	0	15311
26731	125	73	271	14369	0	14838
26732	120	46	180	14439	0	14785
26733	88	44	72	15053	0	15257
26734	14565	43	53	486	0	15147
26735	299	14629	41	314	0	15283
26736	14763	260	56	163	0	15242
26737	320	160	14676	143	0	15299
26738	15143	73	260	163	0	15639
26739	16228	58	169	160	0	16615
26740	433	56	62	16024	0	16575
26741	16278	46	66	387	0	16777
26742	16353	61	66	265	0	16745
26743	16716	57	65	167	0	17005
26744	416	70	53	16698	0	17237
26745	198	56	55	16297	0	16606
26746	73	57	15978	470	0	16578
26747	58	43	15806	277	0	16184
26748	15137	47	372	159	0	15715
26749	243	130	180	15620	0	16173
26750	141	16282	95	328	0	16846
26751	16203	241	91	221	0	16756
26752	235	16278	86	134	0	16733
26753	126	16405	60	142	0	16733
26754	73	390	15830	121	0	16414
26755	46	106	16443	76	0	16671
26756	190	347	143	15002	0	15682
26757	33	24	16560	98	0	16715
26758	24	15	15498	81	0	15618
26759	14776	8	46	27	0	14857
26760	15215	5	24	28	0	15272
26761	25	6	7	15822	0	15860
26762	16	9	8	15914	0	15947
26763	21	6	16468	50	0	16545
26764	8	16603	24	31	0	16666
26765	7	32	10	16518	0	16567
26766	17589	10	8	28	0	17635
26767	20	5	10	18109	0	18144
26768	10	18375	11	62	0	18458
26769	32	26	18532	30	0	18620
26770	4	18681	29	94	0	18808
26771	18795	29	11	30	0	18865
26772	18393	19	7	29	0	18448
26773	45	4	6	18708	0	18763
26774	31	8	19582	44	0	19665
26775	21	3	19114	26	0	19164
26776	5	19743	59	24	0	19831
26777	16	38	44	19280	0	19378
26778	9	29	12	19697	0	19747
26779	19	12	19855	60	0	19946
26780	12	8	34	19414	0	19468
26781	2	20564	34	61	0	20661
26782	5	52	19	20645	0	20721
26783	7	43	5	20818	0	20873
26784	21	6	20926	107	0	21060
26785	10	2	60	20562	0	20634
26786	20933	8	58	90	0	21089
26787	86	3	21297	64	0	21450
26788	83	2	21574	24	0	21683
26789	15	22097	142	22	0	22276
26790	11	76	86	22093	0	22266
26791	5	87	15	23194	0	23301
26792	23	12	23275	176	0	23486
26793	21833	11	109	121	0	22074
26794	102	9	107	23315	0	23533
26795	115	12	23334	113	0	23574
26796	22	5	106	22501	0	22634
26797	19	8	23314	123	0	23464
26798	31	6	22824	124	0	22985
26799	8	23196	201	49	0	23454
26800	11	107	151	21630	0	21899
26801	6	22840	17	117	0	22980
26802	22339	113	15	99	0	22566
26803	111	100	22582	81	0	22874
26804	99	22563	105	47	0	22814
26805	12	110	108	22474	0	22704
26806	22328	110	30	129	0	22597
26807	95	22461	24	169	0	22749
26808	102	102	29	22559	0	22792
26809	26	120	21	22270	0	22437
26810	10	22951	24	229	0	23214
26811	23150	124	24	132	0	23430
26812	124	124	28	25921	0	26197
26813	116	29	30	27479	0	27654
26814	52	24	27636	430	0	28142
26815	16	28646	244	327	0	29233
26816	25	268	304	28409	0	29006
26817	13	267	87	31305	0	31672
26818	21	32333	35	576	0	32965
26819	20	324	45	32618	0	33007
26820	22	356	66	32579	0	33023
26821	25	100	191	32908	0	33224
26822	19	33194	34	752	0	33999
26823	32846	339	48	446	0	33679
26824	367	369	33148	137	0	34021
26825	31824	89	375	75	0	32363
26826	414	33019	381	81	0	33895
26827	373	350	112	32872	0	33707
26828	120	383	33248	395	0	34146
26829	45	123	374	32940	0	33482
26830	38	75	403	32175	0	32691
26831	42	45	110	33564	0	33761
26832	52	60	32999	807	0	33918
26833	37	33131	384	616	0	34168
26834	70	372	33623	187	0	34252
26835	38	33957	459	176	0	34630
26836	108	463	34234	135	0	34940
26837	24	430	463	33492	0	34409
26838	32804	143	430	467	0	33844
26839	341	33180	124	723	0	34368
26840	386	411	33687	327	0	34811
26841	110	33993	404	216	0	34723
26842	117	496	34493	182	0	35288
26843	74	478	473	32740	0	33765
26844	82	201	468	31636	0	32387
26845	61	33455	173	840	0	34529
26846	66	34187	114	584	0	34951
26847	33847	812	105	270	0	35034
26848	412	557	115	34212	0	35296
26849	480	263	34214	566	0	35523
26850	153	147	468	34342	0	35110
26851	140	142	34690	648	0	35620
26852	106	155	34791	605	0	35657
26853	80	145	834	33054	0	34113
26854	85	34159	583	619	0	35446
26855	32545	491	232	573	0	33841
26856	450	515	173	31866	0	33004
26857	454	219	189	30830	0	31692
26858	133	31910	176	933	0	33152
26859	31266	540	174	621	0	32601
26860	31074	535	208	307	0	32124
26861	797	237	193	30319	0	31546
26862	501	30674	200	669	0	32044
26863	159	32657	188	622	0	33626
26864	32041	890	180	312	0	33423
26865	481	626	32305	274	0	33686
26866	30735	301	655	266	0	31957
26867	30519	262	624	226	0	31631
26868	30891	188	277	271	0	31627
26869	836	31030	177	417	0	32460
26870	527	549	181	31374	0	32631
26871	31510	592	193	616	0	32911
26872	31482	268	208	670	0	32628
26873	785	31820	255	375	0	33235
26874	31840	551	179	306	0	32876
26875	511	576	191	32301	0	33579
26876	480	261	198	31992	0	32931
26877	149	32213	219	982	0	33563
26878	167	563	173	32867	0	33770
26879	167	566	170	32548	0	33451
26880	172	32404	162	1039	0	33777
26881	190	675	197	31170	0	32232
26882	139	32260	173	786	0	33358
26883	31769	594	224	606	0	33193
26884	30520	584	216	361	0	31681
26885	813	31496	186	352	0	32847
26886	550	525	31115	330	0	32520
26887	289	688	458	31028	0	32463
26888	225	321	31363	588	0	32497
26889	170	30575	515	652	0	31912
26890	196	30947	465	394	0	32002
26891	29326	721	231	252	0	30530
26892	470	31009	208	224	0	31911
26893	537	515	213	29851	0	31116
26894	257	30768	200	548	0	31773
26895	244	31051	168	487	0	31950
26896	30795	748	159	310	0	32012
26897	490	532	156	30828	0	32006
26898	487	290	30785	513	0	32075
26899	257	255	30146	584	0	31242
26900	210	30710	643	328	0	31891
26901	30372	519	462	285	0	31638
26902	438	31097	223	245	0	32003
26903	459	612	144	30794	0	32009
26904	30771	537	172	499	0	31979
26905	466	309	157	31140	0	32072
26906	448	251	157	31367	0	32223
26907	238	31549	145	861	0	32793
26908	251	506	138	32143	0	33038
26909	194	552	32176	577	0	33499
26910	31814	271	465	499	0	33049
26911	496	33869	401	295	0	35061
26912	354	32979	128	176	0	33637
26913	31121	558	82	129	0	31890
26914	387	364	31427	121	0	32299
26915	29593	226	342	97	0	30258
26916	383	33187	266	106	0	33942
26917	176	34170	46	88	0	34480
26918	98	527	34371	51	0	35047
26919	38	34940	353	172	0	35503
26920	118	405	276	32064	0	32863
26921	41	344	38	32610	0	33033
26922	33	34055	17	506	0	34611
26923	18	334	13	34424	0	34789
26924	34369	250	10	349	0	34978
26925	356	54	34082	268	0	34760
26926	33425	40	330	45	0	33840
26927	34056	34	269	19	0	34378
26928	33953	38	39	26	0	34056
26929	631	35	33914	40	0	34620
26930	308	40	322	33588	0	34258
26931	79	54	33984	346	0	34463
26932	32178	35	367	301	0	32881
26933	32835	51	271	69	0	33226
26934	555	33708	64	56	0	34383
26935	309	415	21	33368	0	34113
26936	64	34799	26	363	0	35252
26937	100	386	34864	275	0	35625
26938	45	440	356	34267	0	35108
26939	33916	82	323	401	0	34722
26940	33644	55	69	291	0	34059
26941	628	59	67	32369	0	33123
26942	353	33464	41	317	0	34175
26943	111	367	33834	266	0	34578
26944	103	387	33933	64	0	34487
26945	31565	88	679	43	0	32375
26946	399	59	33941	77	0	34476
26947	325	33405	404	112	0	34246
26948	91	399	331	32708	0	33529
26949	80	334	33405	366	0	34185
26950	53	89	401	32574	0	33117
26951	106	63	33160	413	0	33742
26952	30423	72	466	353	0	31314
26953	401	74	348	31552	0	32375
26954	359	31812	94	392	0	32657
26955	111	32560	73	374	0	33118
26956	114	696	68	31803	0	32681
26957	106	377	87	31356	0	31926
26958	113	31995	71	652	0	32831
26959	130	416	31889	391	0	32826
26960	102	374	427	31409	0	32312
26961	117	115	32273	427	0	32932
26962	105	85	31386	384	0	31960
26963	28684	111	719	109	0	29623
26964	420	30182	410	148	0	31160
26965	30031	442	128	89	0	30690
26966	469	410	84	28932	0	29895
26967	399	29804	124	436	0	30763
26968	159	491	127	29728	0	30505
26969	130	443	134	29137	0	29844
26970	138	28959	136	714	0	29947
26971	167	472	28611	437	0	29687
26972	163	425	467	28408	0	29463
26973	28250	193	412	506	0	29361
26974	485	162	168	27982	0	28797
26975	446	152	179	27657	0	28434
26976	210	154	27557	774	0	28695
26977	191	27145	496	559	0	28391
26978	197	472	442	27046	0	28157
26979	197	463	27161	494	0	28315
26980	170	212	27277	469	0	28128
26981	25865	204	813	243	0	27125
26982	511	26793	518	295	0	28117
26983	26789	523	240	196	0	27748
26984	553	26835	197	254	0	27839
26985	506	27099	170	231	0	28006
26986	26562	830	154	218	0	27764
26987	512	512	231	25659	0	26914
26988	496	26229	225	547	0	27497
26989	316	479	219	26531	0	27545
26990	26149	437	212	562	0	27360
26991	592	182	26342	516	0	27632
26992	550	169	25439	250	0	26408
26993	24326	186	850	232	0	25594
26994	528	24784	590	308	0	26210
26995	507	470	24823	228	0	26028
26996	259	24889	575	251	0	25974
26997	298	569	512	23968	0	25347
26998	242	513	24412	579	0	25746
26999	209	251	550	24376	0	25386
27000	123	242	24266	656	0	25287
27001	23076	217	638	553	0	24484
27002	526	23614	542	268	0	24950
27003	23573	500	273	244	0	24590
27004	562	527	226	21281	0	22596
27005	437	24601	218	553	0	25809
27006	24059	546	318	468	0	25391
27007	23979	479	272	269	0	24999
27008	771	241	23911	254	0	25177
27009	495	191	23602	223	0	24511
27010	20102	154	681	196	0	21133
27011	330	20552	491	216	0	21589
27012	276	18890	232	185	0	19583
27013	521	779	242	17645	0	19187
27014	133	329	17707	357	0	18526
27015	119	16915	325	336	0	17695
27016	91	14546	258	204	0	15099
27017	514	269	97	9425	0	10305
27018	9499	111	88	127	0	9825
27019	9385	36	43	108	0	9572
27020	9492	39	27	60	0	9618
27021	181	47	9545	33	0	9806
27022	9227	40	105	40	0	9412
27023	9272	38	100	56	0	9466
27024	9509	92	46	34	0	9681
27025	182	46	35	9378	0	9641
27026	121	9647	31	115	0	9914
27027	9505	115	25	98	0	9743
27028	105	9649	40	35	0	9829
27029	98	104	35	9681	0	9918
27030	47	88	10237	112	0	10484
27031	32	46	110	10159	0	10347
27032	32	25	93	10253	0	10403
27033	37	29	10263	187	0	10516
27034	33	9946	98	118	0	10195
27035	22	188	72	9127	0	9409
27036	8793	75	31	82	0	8981
27037	84	8626	23	72	0	8805
27038	8405	78	18	16	0	8517
27039	87	136	19	8181	0	8423
27040	66	8314	21	77	0	8478
27041	8216	82	18	66	0	8382
27042	79	8465	15	26	0	8585
27043	65	73	8029	18	0	8185
27044	7723	105	66	58	0	7952
27045	7977	52	53	14	0	8096
27046	117	8031	11	20	0	8179
27047	87	145	7579	13	0	7824
27048	30	8050	64	12	0	8156
27049	28	208	102	7468	0	7806
27050	18	70	19	7755	0	7862
27051	15	29	12	7801	0	7857
27052	16	7812	6	124	0	7958
27053	14	79	10	7755	0	7858
27054	21	62	21	7838	0	7942
27055	7691	28	13	123	0	7855
27056	81	29	10	7653	0	7773
27057	68	19	9	7791	0	7887
27058	7707	18	12	136	0	7873
27059	92	7978	12	79	0	8161
27060	8014	78	14	35	0	8141
27061	7891	76	19	26	0	8012
27062	8037	31	17	26	0	8111
27063	161	19	17	7895	0	8092
27064	100	16	18	7974	0	8108
27065	51	31	7752	139	0	7973
27066	47	36	7530	166	0	7779
27067	54	32	7742	46	0	7874
27068	7399	34	158	31	0	7622
27069	114	39	7921	35	0	8109
27070	91	8016	99	38	0	8244
27071	40	108	68	7772	0	7988
27072	50	89	29	7566	0	7734
27073	89	8017	26	149	0	8281
27074	48	107	8112	90	0	8357
27075	34	8197	101	48	0	8380
27076	7937	104	75	43	0	8159
27077	126	103	8032	36	0	8297
27078	110	8053	99	44	0	8306
27079	59	107	8154	53	0	8373
27080	59	100	89	8055	0	8303
27081	68	41	8135	108	0	8352
27082	42	63	93	7945	0	8143
27083	8146	36	77	126	0	8385
27084	120	34	8151	100	0	8405
27085	106	8156	88	82	0	8432
27086	8181	108	75	65	0	8429
27087	116	96	8277	52	0	8541
27088	102	64	8137	47	0	8350
27089	61	102	149	7923	0	8235
27090	62	36	8144	130	0	8372
27091	7645	47	114	128	0	7934
27092	121	7966	91	79	0	8257
27093	113	109	40	7860	0	8122
27094	53	8383	48	137	0	8621
27095	8385	123	50	140	0	8698
27096	135	105	8445	91	0	8776
27097	112	60	8898	74	0	9144
27098	74	60	177	8638	0	8949
27099	50	68	110	8729	0	8957
27100	65	70	61	8917	0	9113
27101	77	58	52	9203	0	9390
27102	76	84	9323	200	0	9683
27103	67	9235	120	171	0	9593
27104	62	125	94	8665	0	8946
27105	60	113	8044	121	0	8338
27106	54	7987	86	131	0	8258
27107	7883	105	94	52	0	8134
27108	178	91	102	7709	0	8080
27109	7629	39	34	103	0	7805
27110	97	7602	31	116	0	7846
27111	7590	94	31	71	0	7786
27112	93	91	8458	38	0	8680
27113	87	119	96	8001	0	8303
27114	56	8470	82	107	0	8715
27115	58	72	8412	111	0	8653
27116	32	8430	82	79	0	8623
27117	38	112	89	7898	0	8137
27118	8017	78	41	113	0	8249
27119	86	8159	42	110	0	8397
27120	8192	76	35	58	0	8361
27121	96	82	8074	55	0	8307
27122	107	35	8025	54	0	8221
27123	8048	31	130	44	0	8253
27124	165	43	97	7914	0	8219
27125	94	91	49	7933	0	8167
27126	60	21	8559	125	0	8765
27127	55	71	8406	90	0	8622
27128	31	8827	135	69	0	9062
27129	8269	64	73	41	0	8447
27130	7557	60	175	26	0	7818
27131	80	7741	22	25	0	7868
27132	58	50	19	7910	0	8037
27133	8195	54	26	43	0	8318
27134	49	19	20	8232	0	8320
27135	8244	17	17	61	0	8339
27136	8227	14	18	65	0	8324
27137	8657	14	20	28	0	8719
27138	96	15	24	8619	0	8754
27139	60	22	16	8756	0	8854
27140	8653	12	15	104	0	8784
27141	8441	13	20	75	0	8549
27142	8457	18	21	36	0	8532
27143	100	8492	22	26	0	8640
27144	8152	39	7	27	0	8225
27145	43	8134	11	32	0	8220
27146	8045	40	17	22	0	8124
27147	52	36	8306	20	0	8414
27148	7662	8	33	14	0	7717
27149	28	8141	32	12	0	8213
27150	31	8110	13	14	0	8168
27151	8176	43	12	63	0	8294
27152	23	36	5	8137	0	8201
27153	40	11	7	8462	0	8520
27154	10	8714	9	59	0	8792
27155	14	9391	8	42	0	9455
27156	9788	58	8	18	0	9872
27157	53	43	10202	7	0	10305
27158	45	18	43	10679	0	10785
27159	10976	8	53	60	0	11097
27160	75	10	11309	65	0	11459
27161	77	12401	66	33	0	12577
27162	12763	96	66	21	0	12946
27163	127	85	13325	8	0	13545
27164	108	31	114	13633	0	13886
27165	54	16	14086	140	0	14296
27166	13243	6	157	124	0	13530
27167	128	14110	118	42	0	14398
27168	14397	133	32	23	0	14585
27169	14156	123	16	12	0	14307
27170	261	37	12	14058	0	14368
27171	14290	18	11	145	0	14464
27172	171	20	13	14193	0	14397
27173	134	14	13	14170	0	14331
27174	43	19	14040	253	0	14355
27175	25	14158	133	154	0	14470
27176	31	135	120	14084	0	14370
27177	21	126	33	13960	0	14140
27178	27	32	10	14246	0	14315
27179	26	20	14032	266	0	14344
27180	15	14006	143	186	0	14350
27181	29	150	119	13929	0	14227
27182	23	117	37	14056	0	14233
27183	48	41	13904	256	0	14249
27184	22	25	145	13841	0	14033
27185	13848	16	126	175	0	14165
27186	152	14047	39	136	0	14374
27187	14070	142	51	52	0	14315
27188	203	124	14077	22	0	14426
27189	151	51	147	14002	0	14351
27190	14142	26	135	150	0	14453
27191	13870	35	46	144	0	14095
27192	292	25	14559	102	0	14978
27193	168	17	167	14389	0	14741
27194	75	22	14446	172	0	14715
27195	13717	23	189	148	0	14077
27196	180	14213	141	62	0	14596
27197	14293	165	46	51	0	14555
27198	14102	140	48	41	0	14331
27199	302	14519	35	58	0	14914
27200	14671	158	47	39	0	14915
27201	222	129	14640	52	0	15043
27202	14472	60	168	50	0	14750
27203	212	42	148	14501	0	14903
27204	192	34	15130	175	0	15531
27205	88	40	185	14993	0	15306
27206	100	36	154	14807	0	15097
27207	76	37	86	15010	0	15209
27208	88	15106	66	324	0	15584
27209	15179	178	65	198	0	15620
27210	227	160	56	15068	0	15511
27211	194	15215	66	264	0	15739
27212	115	171	75	14178	0	14539
27213	97	14601	66	252	0	15016
27214	111	201	14678	212	0	15202
27215	108	176	192	14336	0	14812
27216	97	88	191	14606	0	14982
27217	101	66	14708	361	0	15236
27218	13652	67	236	279	0	14234
27219	229	14492	164	201	0	15086
27220	222	188	96	14508	0	15014
27221	127	174	114	13988	0	14403
27222	111	92	102	14221	0	14526
27223	112	14291	98	400	0	14901
27224	14309	197	94	288	0	14888
27225	259	167	14305	182	0	14913
27226	231	100	13701	152	0	14184
27227	154	87	326	13364	0	13931
27228	137	86	196	13478	0	13897
27229	13448	80	124	383	0	14035
27230	267	13516	102	290	0	14175
27231	218	196	117	13607	0	14138
27232	13494	172	105	296	0	14067
27233	282	105	92	13219	0	13698
27234	13321	83	112	301	0	13817
27235	307	69	13078	270	0	13724
27236	239	13334	237	202	0	14012
27237	13226	199	199	159	0	13783
27238	296	203	13125	120	0	13744
27239	12967	106	224	134	0	13431
27240	298	75	13080	166	0	13619
27241	13029	89	253	161	0	13532
27242	314	68	217	13014	0	13613
27243	13190	88	138	276	0	13692
27244	316	77	100	13122	0	13615
27245	248	79	88	13191	0	13606
27246	13179	83	104	398	0	13764
27247	256	12963	114	316	0	13649
27248	223	227	71	13050	0	13571
27249	13104	180	78	282	0	13644
27250	13325	120	67	253	0	13765
27251	351	96	93	13297	0	13837
27252	246	77	92	13440	0	13855
27253	13292	94	84	377	0	13847
27254	275	85	79	13214	0	13653
27255	204	77	75	12700	0	13056
27256	12251	69	94	340	0	12754
27257	215	59	69	11887	0	12230
27258	146	44	10888	266	0	11344
27259	9870	28	188	163	0	10249
27260	188	43	10392	91	0	10714
27261	103	27	8954	47	0	9131
27262	8036	98	277	48	0	8459
27263	64	7835	59	31	0	7989
27264	46	37	67	7341	0	7491
27265	25	35	15	7165	0	7240
27266	20	20	15	7500	0	7555
27267	23	9	4	7746	0	7782
27268	7846	9	12	95	0	7962
27269	8106	10	10	57	0	8183
27270	8407	6	9	32	0	8454
27271	131	2	9154	15	0	9302
27272	74	7	77	9549	0	9707
27273	26	8	78	9772	0	9884
27274	31	7	26	9614	0	9678
27275	26	9583	10	209	0	9828
27276	20	9536	18	149	0	9723
27277	9904	184	8	41	0	10137
27278	121	115	14	9850	0	10100
27279	115	31	16	10450	0	10612
27280	43	10	12	10777	0	10842
27281	40	14	10497	258	0	10809
27282	22	9	10336	167	0	10534
27283	10281	14	232	68	0	10595
27284	10644	9	126	34	0	10813
27285	242	14	35	10376	0	10667
27286	142	10370	26	164	0	10702
27287	64	125	20	10315	0	10524
27288	33	114	12	10380	0	10539
27289	29	36	10142	258	0	10465
27290	9808	10	131	157	0	10106
27291	150	14	113	10368	0	10645
27292	128	12	36	9843	0	10019
27293	9628	9	25	263	0	9925
27294	160	9817	16	187	0	10180
27295	10052	139	17	69	0	10277
27296	182	164	14	9754	0	10114
27297	130	9432	11	168	0	9741
27298	9469	152	12	135	0	9768
27299	160	121	19	9277	0	9577
27300	9203	36	13	182	0	9434
27301	8766	27	14	149	0	8956
27302	8942	17	17	59	0	9035
27303	277	8796	18	56	0	9147
27304	156	8472	22	82	0	8732
27305	52	248	22	8213	0	8535
27306	35	8422	17	177	0	8651
27307	8429	166	20	138	0	8753
27308	178	125	17	8427	0	8747
27309	8520	32	16	180	0	8748
27310	8558	20	24	155	0	8757
27311	287	10	23	8320	0	8640
27312	175	22	24	8625	0	8846
27313	8614	18	25	291	0	8948
27314	8570	26	20	193	0	8809
27315	8923	30	18	94	0	9065
27316	9024	24	14	73	0	9135
27317	9144	30	8	72	0	9254
27318	350	29	11	8827	0	9217
27319	210	33	14	8898	0	9155
27320	98	34	22	9104	0	9258
27321	8815	29	20	367	0	9231
27322	222	31	11	8853	0	9117
27323	181	8817	19	289	0	9306
27324	91	177	21	9050	0	9339
27325	8771	155	14	243	0	9183
27326	8861	61	22	179	0	9123
27327	334	36	8673	125	0	9168
27328	214	86	171	8233	0	8704
27329	101	8663	125	217	0	9106
27330	8583	176	27	203	0	8989
27331	214	8802	22	96	0	9134
27332	181	209	23	8795	0	9208
27333	8860	166	20	221	0	9267
27334	8971	45	16	187	0	9219
27335	336	8941	12	127	0	9416
27336	218	196	11	8720	0	9145
27337	119	151	8624	239	0	9133
27338	8464	47	168	196	0	8875
27339	247	42	8692	102	0	9083
27340	8721	31	185	91	0	9028
27341	8874	28	130	83	0	9115
27342	363	38	40	8783	0	9224
27343	9149	42	24	237	0	9452
27344	9339	37	13	222	0	9611
27345	9466	50	24	128	0	9668
27346	389	53	22	9190	0	9654
27347	9166	41	11	247	0	9465
27348	279	63	20	9130	0	9492
27349	216	49	30	9057	0	9352
27350	123	9058	32	360	0	9573
27351	124	191	19	8735	0	9069
27352	122	8961	20	248	0	9351
27353	8665	200	14	176	0	9055
27354	8660	159	16	97	0	8932
27355	347	65	10	8518	0	8940
27356	225	50	10	8664	0	8949
27357	8629	44	16	320	0	9009
27358	263	38	8431	194	0	8926
27359	8682	29	160	105	0	8976
27360	284	38	120	8624	0	9066
27361	217	47	8483	217	0	8964
27362	8389	43	158	192	0	8782
27363	8712	51	119	93	0	8975
27364	368	42	8816	77	0	9303
27365	8848	38	149	87	0	9122
27366	269	29	8563	78	0	8939
27367	226	8608	165	78	0	9077
27368	8771	146	196	72	0	9185
27369	8412	119	110	95	0	8736
27370	292	8338	37	69	0	8736
27371	144	7680	29	52	0	7905
27372	7098	137	73	49	0	7357
27373	7039	64	9	46	0	7158
27374	189	34	6	7408	0	7637
27375	108	60	7219	128	0	7515
27376	77	29	7122	86	0	7314
27377	7296	23	120	64	0	7503
27378	147	30	7450	35	0	7662
27379	6833	36	121	36	0	7026
27380	193	16	38	6710	0	6957
27381	73	14	22	6867	0	6976
27382	60	12	7052	111	0	7235
27383	7173	18	69	62	0	7322
27384	92	15	41	7345	0	7493
27385	72	9	23	7406	0	7510
27386	7617	9	19	107	0	7752
27387	7429	9	22	72	0	7532
27388	7630	12	17	51	0	7710
27389	129	7956	21	96	0	8202
27390	90	62	7870	30	0	8052
27391	7512	37	66	33	0	7648
27392	7855	23	45	24	0	7947
27393	120	7816	23	26	0	7985
27394	7522	49	15	25	0	7611
27395	79	28	13	7397	0	7517
27396	58	23	7676	61	0	7818
27397	7626	14	50	41	0	7731
27398	7783	17	49	27	0	7876
27399	7871	15	19	23	0	7928
27400	7859	12	10	31	0	7912
27401	87	9	18	7802	0	7916
27402	58	9	13	7806	0	7886
27403	7943	9	19	81	0	8052
27404	67	17	16	7783	0	7883
27405	58	10	12	7833	0	7913
27406	48	7710	12	82	0	7852
27407	41	48	14	7854	0	7957
27408	36	16	12	7839	0	7903
27409	42	9	16	7822	0	7889
27410	35	10	18	7869	0	7932
27411	41	7766	14	86	0	7907
27412	34	54	14	7725	0	7827
27413	34	19	12	7517	0	7582
27414	43	20	7455	84	0	7602
27415	18	8	7057	37	0	7120
27416	19	7302	39	29	0	7389
27417	8753	34	19	12	0	8818
27418	58	9025	7	37	0	9127
27419	46	61	11	9840	0	9958
27420	26	38	10457	74	0	10595
27421	11143	9	80	53	0	11285
27422	88	14	52	12016	0	12170
27423	11916	12	22	88	0	12038
27424	11886	11	10	66	0	11973
27425	133	12004	11	76	0	12224
27426	12103	81	9	15	0	12208
27427	101	12672	15	27	0	12815
27428	70	116	9	12896	0	13091
27429	24	13106	6	111	0	13247
27430	34	106	13197	86	0	13423
27431	18	13255	96	37	0	13406
27432	33	128	67	12836	0	13064
27433	13147	69	17	107	0	13340
27434	101	13217	7	117	0	13442
27435	80	110	10	13606	0	13806
27436	20	89	7	13790	0	13906
27437	18	24	13858	211	0	14111
27438	13	15	126	13712	0	13866
27439	30	11	13854	143	0	14038
27440	13076	12	146	120	0	13354
27441	153	7	14333	43	0	14536
27442	118	14480	139	41	0	14778
27443	45	144	102	14335	0	14626
27444	45	126	27	13750	0	13948
27445	33	50	21	14500	0	14604
27446	14534	19	19	258	0	14830
27447	164	32	18	14401	0	14615
27448	122	14652	22	173	0	14969
27449	14436	161	13	125	0	14735
27450	158	14328	24	53	0	14563
27451	132	166	15	14251	0	14564
27452	14290	144	12	164	0	14610
27453	168	14178	19	157	0	14522
27454	127	14633	7	97	0	14864
27455	14533	250	26	64	0	14873
27456	14443	138	26	62	0	14669
27457	277	42	14346	61	0	14726
27458	14441	36	164	48	0	14689
27459	203	39	14713	50	0	15005
27460	159	44	180	14527	0	14910
27461	62	40	14753	209	0	15064
27462	47	44	193	14730	0	15014
27463	50	38	14844	232	0	15164
27464	43	50	201	14093	0	14387
27465	52	54	145	14487	0	14738
27466	14436	52	52	317	0	14857
27467	210	52	14181	190	0	14633
27468	13619	64	191	99	0	13973
27469	221	61	13988	83	0	14353
27470	166	53	14009	90	0	14318
27471	78	61	290	13684	0	14113
27472	13767	46	284	220	0	14317
27473	194	13732	64	190	0	14180
27474	13446	187	49	97	0	13779
27475	13397	154	53	69	0	13673
27476	318	13327	59	65	0	13769
27477	13424	210	55	68	0	13757
27478	236	153	13684	100	0	14173
27479	184	59	198	13625	0	14066
27480	13707	44	168	238	0	14157
27481	223	13788	69	210	0	14290
27482	180	200	56	13509	0	13945
27483	91	173	64	13254	0	13582
27484	82	69	61	13409	0	13621
27485	73	60	57	13698	0	13888
27486	13332	42	66	357	0	13797
27487	13329	55	72	217	0	13673
27488	13511	53	75	115	0	13754
27489	13161	55	64	111	0	13391
27490	377	59	13090	74	0	13600
27491	12943	58	206	91	0	13298
27492	13153	66	177	89	0	13485
27493	376	13160	95	88	0	13719
27494	231	13464	83	92	0	13870
27495	146	316	87	13075	0	13624
27496	117	203	92	13160	0	13572
27497	111	86	13071	365	0	13633
27498	112	13379	223	242	0	13956
27499	98	219	177	13275	0	13769
27500	117	13624	83	255	0	14079
27501	127	217	82	13763	0	14189
27502	131	180	67	13840	0	14218
27503	111	14644	91	382	0	15228
27504	126	226	79	14906	0	15337
27505	116	172	15219	307	0	15814
27506	140	71	15429	263	0	15903
27507	14756	79	387	113	0	15335
27508	15522	77	214	111	0	15924
27509	438	15495	104	120	0	16157
27510	15731	232	71	94	0	16128
27511	325	203	90	15554	0	16172
27512	15695	91	60	267	0	16113
27513	288	15671	92	295	0	16346
27514	306	234	15668	143	0	16351
27515	15275	204	291	127	0	15897
27516	340	100	16036	115	0	16591
27517	229	76	14390	102	0	14797
27518	131	58	14386	103	0	14678
27519	78	13465	316	128	0	13987
27520	12576	355	228	139	0	13298
27521	11851	167	107	87	0	12212
27522	278	53	78	11355	0	11764
27523	182	76	66	11245	0	11569
27524	94	11781	74	283	0	12232
27525	11964	137	60	191	0	12352
27526	194	12147	60	97	0	12498
27527	171	11716	57	91	0	12035
27528	11194	197	56	56	0	11503
27529	173	119	84	11076	0	11452
27530	143	53	56	10886	0	11138
27531	80	44	61	11085	0	11270
27532	85	11006	47	229	0	11367
27533	10753	103	36	146	0	11038
27534	143	201	42	10588	0	10974
27535	133	10136	31	105	0	10405
27536	69	10034	23	111	0	10237
27537	55	144	32	9745	0	9976
27538	54	9834	30	101	0	10019
27539	51	109	31	9796	0	9987
27540	9648	86	23	106	0	9863
27541	104	65	9626	104	0	9899
27542	83	9609	68	43	0	9803
27543	37	88	67	9557	0	9749
27544	41	63	9606	88	0	9798
27545	9110	22	68	80	0	9280
27546	88	65	77	9488	0	9718
27547	9485	22	37	67	0	9611
27548	9416	14	17	70	0	9517
27549	125	10714	18	33	0	10890
27550	10866	57	15	28	0	10966
27551	10746	67	15	15	0	10843
27552	10818	29	9	18	0	10874
27553	112	24	14	10610	0	10760
27554	78	18	16	10499	0	10611
27555	24	22	18	10623	0	10687
27556	35	19	10580	114	0	10748
27557	20	10628	60	85	0	10793
27558	10440	66	62	29	0	10597
27559	56	10670	16	26	0	10768
27560	61	46	14	10578	0	10699
27561	26	51	10542	61	0	10680
27562	9653	20	45	69	0	9787
27563	57	10582	46	24	0	10709
27564	67	41	13	10427	0	10548
27565	26	60	12	10547	0	10645
27566	29	25	10547	90	0	10691
27567	24	10728	48	65	0	10865
27568	21	54	53	10710	0	10838
27569	25	57	19	10641	0	10742
27570	24	20	14	10571	0	10629
27571	10538	17	18	87	0	10660
27572	62	23	10507	65	0	10657
27573	56	10462	56	31	0	10605
27574	10406	52	54	21	0	10533
27575	56	10531	17	26	0	10630
27576	67	50	16	10399	0	10532
27577	23	10639	12	49	0	10723
27578	10052	46	13	70	0	10181
27579	10257	61	16	26	0	10360
27580	97	26	13	10523	0	10659
27581	76	29	11	10529	0	10645
27582	29	29	5	11077	0	11140
27583	37	16	11286	117	0	11456
27584	24	11928	50	98	0	12100
27585	17	70	71	14204	0	14362
27586	26	87	18	14374	0	14505
27587	29	31	16	14456	0	14532
27588	22	38	8	14772	0	14840
27589	41	24	14596	253	0	14914
27590	30	15545	94	197	0	15866
27591	26	141	130	15678	0	15975
27592	11	163	22	16825	0	17021
27593	37	38	16459	317	0	16851
27594	23	35	140	15873	0	16071
27595	21	16126	173	172	0	16492
27596	14	16429	35	196	0	16674
27597	19	315	18	16213	0	16565
27598	31	194	15982	173	0	16380
27599	14486	49	158	209	0	14902
27600	149	15680	180	98	0	16107
27601	164	133	15252	50	0	15599
27602	43	163	15141	54	0	15401
27603	29	14818	274	61	0	15182
27604	38	142	14780	80	0	15040
27605	10	358	144	13875	0	14387
27606	13866	51	150	149	0	14216
27607	13568	29	37	166	0	13800
27608	13847	24	41	39	0	13951
27609	14224	20	18	32	0	14294
27610	272	14508	21	54	0	14855
27611	14618	140	29	32	0	14819
27612	153	14809	22	68	0	15052
27613	161	166	14657	45	0	15029
27614	39	163	162	13967	0	14331
27615	27	14692	157	168	0	15044
27616	28	162	39	14473	0	14702
27617	14089	182	27	182	0	14480
27618	165	46	23	13719	0	13953
27619	160	14192	36	227	0	14615
27620	14256	154	29	187	0	14626
27621	163	166	14332	75	0	14736
27622	158	67	164	14096	0	14485
27623	41	42	182	14170	0	14435
27624	13864	45	47	318	0	14274
27625	142	13837	48	238	0	14265
27626	178	166	13616	98	0	14058
27627	61	213	153	13450	0	13877
27628	54	57	13812	184	0	14107
27629	43	13393	172	212	0	13820
27630	43	13738	171	97	0	14049
27631	13622	309	66	89	0	14086
27632	166	203	13610	93	0	14072
27633	13596	76	179	94	0	13945
27634	172	59	200	13136	0	13567
27635	165	13630	88	213	0	14096
27636	13615	192	62	215	0	14084
27637	180	205	13722	118	0	14225
27638	195	88	183	13540	0	14006
27639	72	58	201	13476	0	13807
27640	68	85	73	13260	0	13486
27641	80	13381	63	337	0	13861
27642	12974	218	72	232	0	13496
27643	188	13163	69	115	0	13535
27644	191	13171	74	108	0	13544
27645	77	331	77	13144	0	13629
27646	12980	243	82	196	0	13501
27647	12685	110	98	225	0	13118
27648	12768	104	94	122	0	13088
27649	321	11694	86	144	0	12245
27650	216	209	80	11649	0	12154
27651	124	235	11704	214	0	12277
27652	113	112	199	11673	0	12097
27653	108	94	218	11292	0	11712
27654	122	11728	105	338	0	12293
27655	11909	212	77	249	0	12447
27656	227	240	71	11697	0	12235
27657	243	12014	82	228	0	12567
27658	11966	235	112	233	0	12546
27659	236	246	11739	133	0	12354
27660	11604	136	206	138	0	12084
27661	244	11820	222	132	0	12418
27662	11926	235	96	121	0	12378
27663	11715	249	85	91	0	12140
27664	381	161	11696	91	0	12329
27665	11782	144	198	87	0	12211
27666	275	93	12033	114	0	12515
27667	263	114	11749	101	0	12227
27668	11651	95	342	97	0	12185
27669	11708	103	241	109	0	12161
27670	396	118	11905	100	0	12519
27671	269	111	222	11700	0	12302
27672	156	100	249	11317	0	11822
27673	122	12101	107	367	0	12697
27674	12355	230	109	256	0	12950
27675	12371	259	53	127	0	12810
27676	424	139	12334	94	0	12991
27677	12310	119	196	90	0	12715
27678	12326	125	209	99	0	12759
27679	424	12023	86	105	0	12638
27680	254	236	87	11617	0	12194
27681	164	241	77	11567	0	12049
27682	123	111	70	11449	0	11753
27683	10896	122	85	329	0	11432
27684	246	10216	52	282	0	10796
27685	137	210	51	7615	0	8013
27686	103	7751	28	148	0	8030
27687	75	353	46	7185	0	7659
27688	66	7349	44	116	0	7575
27689	72	7315	40	109	0	7536
27690	6112	165	92	34	0	6403
27691	5965	50	68	39	0	6122
27692	92	21	21	4942	0	5076
27693	56	17	23	5124	0	5220
27694	44	10	19	5154	0	5227
27695	31	15	18	5149	0	5213
27696	26	12	15	5133	0	5186
27697	30	5070	14	105	0	5219
27698	34	59	18	5159	0	5270
27699	39	45	14	5224	0	5322
27700	5026	20	18	93	0	5157
27701	82	18	18	5003	0	5121
27702	62	16	12	5020	0	5110
27703	42	38	5145	109	0	5334
27704	33	16	55	5091	0	5195
27705	25	18	39	5353	0	5435
27706	39	19	5478	115	0	5651
27707	23	5799	62	82	0	5966
27708	30	68	5864	37	0	5999
27709	30	49	5829	34	0	5942
27710	14	5865	79	16	0	5974
27711	5699	59	69	16	0	5843
27712	5695	86	7	19	0	5807
27713	74	19	6	5628	0	5727
27714	5887	10	2	51	0	5950
27715	63	9	6142	53	0	6267
27716	54	6	38	6200	0	6298
27717	16	18	6822	66	0	6922
27718	16	9	42	6742	0	6809
27719	8	11	43	6766	0	6828
27720	14	9	11	6917	0	6951
27721	6808	16	7	113	0	6944
27722	57	9	4	7029	0	7099
27723	6997	11	9	80	0	7097
27724	6980	12	6	75	0	7073
27725	99	7044	6	51	0	7200
27726	7110	51	20	42	0	7223
27727	57	7430	12	50	0	7549
27728	63	56	15	7394	0	7528
27729	17	48	21	7548	0	7634
27730	20	21	14	7688	0	7743
27731	19	20	7606	129	0	7774
27732	14	7574	68	93	0	7749
27733	23	78	62	7062	0	7225
27734	26	65	24	7220	0	7335
27735	30	7554	15	108	0	7707
27736	7557	71	17	83	0	7728
27737	72	7540	20	53	0	7685
27738	7470	70	15	41	0	7596
27739	71	7602	18	40	0	7731
27740	64	72	19	7340	0	7495
27741	22	7571	18	124	0	7735
27742	7703	66	19	93	0	7881
27743	7744	60	12	48	0	7864
27744	7742	17	12	49	0	7820
27745	7716	19	12	49	0	7796
27746	130	18	8227	56	0	8431
27747	8145	11	66	51	0	8273
27748	8244	19	56	51	0	8370
27749	8281	25	15	53	0	8374
27750	139	19	8216	45	0	8419
27751	8034	25	63	54	0	8176
27752	83	8259	54	64	0	8460
27753	8419	73	25	68	0	8585
27754	91	66	9225	69	0	9451
27755	9058	31	65	58	0	9212
27756	9117	20	54	50	0	9241
27757	109	57	16	9100	0	9282
27758	86	17	9084	100	0	9287
27759	9048	20	60	81	0	9209
27760	73	13	53	9221	0	9360
27761	64	17	32	9286	0	9399
27762	39	16	9430	136	0	9621
27763	8625	23	86	97	0	8831
27764	9301	17	63	58	0	9439
27765	114	9345	23	50	0	9532
27766	67	62	27	9183	0	9339
27767	40	54	25	9112	0	9231
27768	38	21	36	9111	0	9206
27769	40	9152	34	105	0	9331
27770	8974	68	24	74	0	9140
27771	82	52	13	8883	0	9030
27772	82	16	19	8894	0	9011
27773	8739	18	24	122	0	8903
27774	8395	20	24	82	0	8521
27775	113	17	35	8501	0	8666
27776	74	20	34	8451	0	8579
27777	37	26	8369	128	0	8560
27778	7953	23	54	95	0	8125
27779	87	8582	46	50	0	8765
27780	77	66	12	9004	0	9159
27781	50	53	12	9120	0	9235
27782	47	9550	20	146	0	9763
27783	47	95	19	9764	0	9925
27784	10594	98	18	175	0	10885
27785	140	47	17	13113	0	13317
27786	135	30	9	13325	0	13499
27787	47	35	9	13745	0	13836
27788	51	16	13248	418	0	13733
27789	43	22	188	13475	0	13728
27790	49	22	13443	287	0	13801
27791	37	12967	199	203	0	13406
27792	42	188	223	12707	0	13160
27793	29	162	39	12796	0	13026
27794	28	40	19	13034	0	13121
27795	25	30	19	12977	0	13051
27796	23	19	9	13226	0	13277
27797	12596	22	15	396	0	13029
27798	203	10	12801	225	0	13239
27799	150	12485	192	80	0	12907
27800	39	13044	150	47	0	13280
27801	29	325	36	12730	0	13120
27802	28	173	14	12923	0	13138
27803	12	43	17	12939	0	13011
27804	16	12864	7	375	0	13262
27805	22	220	7	13160	0	13409
27806	31	147	12750	240	0	13168
27807	13	12500	184	197	0	12894
27808	18	205	172	12464	0	12859
27809	12324	154	32	218	0	12728
27810	174	33	17	12390	0	12614
27811	156	27	16	12240	0	12439
27812	41	11961	8	355	0	12365
27813	28	12443	16	216	0	12703
27814	36	305	16	12091	0	12448
27815	18	165	8	12096	0	12287
27816	31	42	11982	361	0	12416
27817	10	26	167	11676	0	11879
27818	8	19	146	11695	0	11868
27819	10	14	50	11657	0	11731
27820	19	20	23	11921	0	11983
27821	11502	15	23	384	0	11924
27822	11435	29	19	229	0	11712
27823	313	27	12	11531	0	11883
27824	167	16	22	11853	0	12058
27825	11601	14	12	402	0	12029
27826	210	16	17	12101	0	12344
27827	175	16	11988	305	0	12484
27828	44	11977	183	262	0	12466
27829	30	184	175	12052	0	12441
27830	17	163	78	12308	0	12566
27831	12107	57	39	397	0	12600
27832	180	44	34	12283	0	12541
27833	167	38	16	12531	0	12752
27834	12413	23	23	421	0	12880
27835	191	36	25	12605	0	12857
27836	157	12657	14	318	0	13146
27837	40	192	26	13354	0	13612
27838	49	185	35	13688	0	13957
27839	35	60	37	13943	0	14075
27840	28	48	36	14113	0	14225
27841	27	142	13568	468	0	14205
27842	23	42	13576	317	0	13958
27843	11	54	343	13532	0	13940
27844	24	52	184	13521	0	13781
27845	23	13733	64	464	0	14284
27846	25	228	45	13258	0	13556
27847	20	13384	54	365	0	13823
27848	13273	262	43	293	0	13871
27849	206	14096	35	171	0	14508
27850	194	270	26	14364	0	14854
27851	56	208	21	14709	0	14994
27852	57	75	14367	523	0	15022
27853	13504	61	206	346	0	14117
27854	13356	69	181	188	0	13794
27855	344	13536	70	216	0	14166
27856	219	234	55	13380	0	13888
27857	105	208	14308	338	0	14959
27858	45	14663	244	325	0	15277
27859	14409	250	201	205	0	15065
27860	14350	206	53	197	0	14806
27861	408	86	14106	208	0	14808
27862	14176	54	205	175	0	14610
27863	304	51	184	14191	0	14730
27864	227	14158	58	349	0	14792
27865	14198	236	51	312	0	14797
27866	289	206	39	14177	0	14711
27867	14231	83	39	361	0	14714
27868	14788	84	37	326	0	15235
27869	415	69	41	15133	0	15658
27870	236	61	15446	388	0	16131
27871	15314	57	236	360	0	15967
27872	15757	52	200	210	0	16219
27873	16152	44	75	192	0	16463
27874	437	16327	66	188	0	17018
27875	262	250	38	16326	0	16876
27876	108	238	31	16793	0	17170
27877	92	103	16502	535	0	17232
27878	62	84	224	16318	0	16688
27879	60	16338	203	408	0	17009
27880	15885	248	54	332	0	16519
27881	237	16024	51	191	0	16503
27882	200	230	15812	175	0	16417
27883	63	16199	256	140	0	16658
27884	76	15643	157	100	0	15976
27885	150	152	65	12757	0	13124
27886	12723	91	13	109	0	12936
27887	12369	35	10	92	0	12506
27888	12629	22	24	49	0	12724
27889	149	13322	21	49	0	13541
27890	117	74	13200	45	0	13436
27891	12865	82	73	46	0	13066
27892	13315	26	80	45	0	13466
27893	153	13286	27	42	0	13508
27894	13517	72	20	47	0	13656
27895	103	92	14	13388	0	13597
27896	104	29	14921	101	0	15155
27897	14852	38	84	110	0	15084
27898	14909	19	86	56	0	15070
27899	15793	23	26	38	0	15880
27900	176	252	25	15099	0	15552
27901	123	41	29	15298	0	15491
27902	54	28	18	16503	0	16603
27903	38	16658	22	232	0	16950
27904	65	138	30	17899	0	18132
27905	37	136	23	18821	0	19017
27906	51	44	19205	333	0	19633
27907	47	37	184	19231	0	19499
27908	38	32	201	19381	0	19652
27909	47	32	43	19483	0	19605
27910	54	43	33	19551	0	19681
27911	39	19411	26	450	0	19926
27912	46	219	17	19429	0	19711
27913	44	168	29	19451	0	19692
27914	19405	54	32	372	0	19863
27915	261	40	19309	190	0	19800
27916	217	38	18913	77	0	19245
27917	18751	34	338	67	0	19190
27918	19463	26	188	48	0	19725
27919	399	48	50	18231	0	18728
27920	214	19550	32	199	0	19995
27921	19999	212	26	177	0	20414
27922	239	188	25	19621	0	20073
27923	212	20843	38	265	0	21358
27924	20894	204	31	182	0	21311
27925	226	21198	31	62	0	21517
27926	20890	206	17	65	0	21178
27927	20250	179	32	61	0	20522
27928	368	20185	27	76	0	20656
27929	197	212	17	20161	0	20587
27930	90	168	19992	235	0	20485
27931	59	105	188	19807	0	20159
27932	19865	39	157	259	0	20320
27933	227	39	19966	227	0	20459
27934	182	20136	200	139	0	20657
27935	63	203	160	19914	0	20340
27936	87	166	20039	247	0	20539
27937	38	19793	198	236	0	20265
27938	19827	182	152	90	0	20251
27939	202	161	40	19950	0	20353
27940	160	47	47	19944	0	20198
27941	53	54	38	19798	0	19943
27942	58	19970	35	366	0	20429
27943	19836	182	43	214	0	20275
27944	207	19730	38	230	0	20205
27945	170	19978	25	90	0	20263
27946	20018	306	18	76	0	20418
27947	19760	182	25	77	0	20044
27948	339	54	19733	70	0	20196
27949	18935	62	186	68	0	19251
27950	18835	57	150	56	0	19098
27951	351	40	37	18684	0	19112
27952	223	45	18736	213	0	19217
27953	94	54	176	18611	0	18935
27954	18942	46	163	217	0	19368
27955	256	48	19239	201	0	19744
27956	198	53	200	20614	0	21065
27957	87	65	181	22154	0	22487
27958	82	47	50	24481	0	24660
27959	24533	55	36	618	0	25242
27960	371	24820	44	428	0	25663
27961	25136	373	38	133	0	25680
27962	412	304	25120	122	0	25958
27963	333	87	354	24386	0	25160
27964	95	25758	302	430	0	26585
27965	25691	376	72	368	0	26507
27966	393	325	68	25865	0	26651
27967	360	94	25828	503	0	26785
27968	100	83	355	25642	0	26180
27969	24726	71	301	473	0	25571
27970	364	24714	86	451	0	25615
27971	360	409	66	22840	0	23675
27972	102	24692	60	424	0	25278
27973	24137	414	52	342	0	24945
27974	23985	321	41	148	0	24495
27975	634	23991	35	152	0	24812
27976	23999	386	49	111	0	24545
27977	475	317	45	23120	0	23957
27978	364	23880	45	407	0	24696
27979	23763	399	64	331	0	24557
27980	23822	317	76	99	0	24314
27981	677	23404	73	133	0	24287
27982	394	23587	51	101	0	24133
27983	23243	610	46	95	0	23994
27984	483	389	52	22965	0	23889
27985	23253	107	51	438	0	23849
27986	472	112	47	23278	0	23909
27987	405	84	22983	451	0	23923
27988	166	86	355	23319	0	23926
27989	22811	104	295	445	0	23655
27990	478	89	23076	367	0	24010
27991	388	77	394	22502	0	23361
27992	128	89	298	23310	0	23825
27993	144	86	23007	685	0	23922
27994	22065	80	405	391	0	22941
27995	437	77	326	22557	0	23397
27996	355	68	21405	455	0	22283
27997	19960	74	395	368	0	20797
27998	431	21262	305	141	0	22139
27999	321	20889	99	162	0	21471
28000	123	21441	83	144	0	21791
28001	161	626	20370	131	0	21288
28002	154	382	334	19306	0	20176
28003	94	126	19733	401	0	20354
28004	90	387	295	17123	0	17895
28005	74	16758	224	331	0	17387
28006	79	16623	55	263	0	17020
28007	142	464	71	16288	0	16965
28008	16215	247	98	313	0	16873
28009	287	101	36	16644	0	17068
28010	259	69	48	16438	0	16814
28011	94	16650	42	503	0	17289
28012	16555	269	54	282	0	17160
28013	283	16844	37	159	0	17323
28014	274	293	36	16655	0	17258
28015	107	330	51	16406	0	16894
28016	101	16556	37	527	0	17221
28017	105	314	52	16633	0	17104
28018	16449	243	44	399	0	17135
28019	367	124	60	16672	0	17223
28020	308	143	44	16517	0	17012
28021	174	16458	58	498	0	17188
28022	170	318	77	16606	0	17171
28023	15411	298	65	391	0	16165
28024	15651	156	61	303	0	16171
28025	15972	168	49	156	0	16345
28026	581	123	57	15762	0	16523
28027	352	120	15570	408	0	16450
28028	214	124	15661	341	0	16340
28029	206	107	451	15676	0	16440
28030	15723	146	252	387	0	16508
28031	402	166	79	15978	0	16625
28032	16168	140	76	410	0	16794
28033	489	115	64	16078	0	16746
28034	389	131	57	16228	0	16805
28035	16202	129	77	556	0	16964
28036	448	108	15738	336	0	16630
28037	15855	130	292	215	0	16492
28038	442	130	15652	160	0	16384
28039	385	112	304	15170	0	15971
28040	15340	98	274	355	0	16067
28041	399	128	15467	329	0	16323
28042	350	138	15613	141	0	16242
28043	15322	146	462	148	0	16078
28044	410	103	15751	186	0	16450
28045	327	15350	341	274	0	16292
28046	147	308	311	15737	0	16503
28047	16622	272	125	426	0	17445
28048	352	122	16587	391	0	17452
28049	16672	114	344	185	0	17315
28050	16796	107	293	184	0	17380
28051	16908	94	133	215	0	17350
28052	16942	83	126	224	0	17375
28053	564	105	125	16327	0	17121
28054	317	16381	121	424	0	17243
28055	15816	320	116	359	0	16611
28056	325	231	13947	162	0	14665
28057	144	10694	138	80	0	11056
28058	9362	115	124	54	0	9655
28059	83	8746	23	43	0	8895
28060	61	8999	29	45	0	9134
28061	344	112	165	8546	0	9167
28062	155	53	15	8571	0	8794
28063	23	14	23	8676	0	8736
28064	8908	8	15	117	0	9048
28065	9050	9	18	66	0	9143
28066	134	11	19	9360	0	9524
28067	89	16	18	10420	0	10543
28068	38	12	11267	193	0	11510
28069	10972	14	171	97	0	11254
28070	11553	13	109	44	0	11719
28071	264	9	42	11558	0	11873
28072	133	20	14	11903	0	12070
28073	45	10	11848	280	0	12183
28074	37	13	184	11813	0	12047
28075	31	11	12182	203	0	12427
28076	38	12234	181	144	0	12597
28077	42	161	12287	31	0	12521
28078	26	158	208	11632	0	12024
28079	47	28	12277	159	0	12511
28080	36	4	11997	118	0	12155
28081	12158	11	245	33	0	12447
28082	183	21	115	12742	0	13061
28083	126	12	12951	173	0	13262
28084	12323	20	188	120	0	12651
28085	205	10	13154	50	0	13419
28086	133	14	13973	37	0	14157
28087	39	13999	269	40	0	14347
28088	34	169	127	13668	0	13998
28089	45	105	13765	177	0	14092
28090	38	33	13427	138	0	13636
28091	38	21	268	13218	0	13545
28092	40	14	147	13143	0	13344
28093	31	13538	55	262	0	13886
28094	27	172	27	13686	0	13912
28095	13518	107	49	220	0	13894
28096	13437	36	34	157	0	13664
28097	13954	22	43	60	0	14079
28098	303	19	37	13697	0	14056
28099	152	13987	47	232	0	14418
28100	13843	170	45	159	0	14217
28101	197	14039	57	77	0	14370
28102	138	13670	58	66	0	13932
28103	69	13850	35	67	0	14021
28104	13805	267	61	63	0	14196
28105	186	133	61	13614	0	13994
28106	128	48	68	13391	0	13635
28107	46	13746	71	289	0	14152
28108	13596	187	83	143	0	14009
28109	218	125	13436	72	0	13851
28110	127	45	240	13358	0	13770
28111	13236	29	179	209	0	13653
28112	202	13573	96	158	0	14029
28113	13958	185	73	83	0	14299
28114	236	116	84	13646	0	14082
28115	159	14126	61	211	0	14557
28116	75	186	14143	150	0	14554
28117	13707	125	239	71	0	14142
28118	221	62	168	14013	0	14464
28119	14115	45	95	229	0	14484
28120	231	43	65	13963	0	14302
28121	145	13941	69	267	0	14422
28122	90	194	14473	170	0	14927
28123	72	133	14406	99	0	14710
28124	108	155	287	13980	0	14530
28125	14017	45	180	224	0	14466
28126	13992	46	59	160	0	14257
28127	297	50	45	13946	0	14338
28128	187	37	45	14051	0	14320
28129	14115	34	41	293	0	14483
28130	219	55	53	14301	0	14628
28131	14327	51	64	243	0	14685
28132	225	14367	51	174	0	14817
28133	14532	215	48	91	0	14886
28134	227	168	14753	85	0	15233
28135	190	91	192	14529	0	15002
28136	92	61	178	14696	0	15027
28137	93	59	99	14854	0	15105
28138	103	14631	85	363	0	15182
28139	92	14527	77	276	0	14972
28140	75	298	78	14892	0	15343
28141	86	165	14929	271	0	15451
28142	91	77	243	14792	0	15203
28143	89	71	203	15030	0	15393
28144	98	74	96	15231	0	15499
28145	14873	63	97	357	0	15390
28146	218	14388	78	272	0	14956
28147	199	14570	97	128	0	14994
28148	122	319	101	14415	0	14957
28149	149	175	98	14633	0	15055
28150	122	94	85	14660	0	14961
28151	118	67	76	14912	0	15173
28152	14511	67	79	377	0	15034
28153	226	14551	101	215	0	15093
28154	14705	216	98	127	0	15146
28155	15072	163	111	126	0	15472
28156	329	92	98	15124	0	15643
28157	208	80	65	15318	0	15671
28158	15246	56	55	388	0	15745
28159	15054	62	67	239	0	15422
28160	337	75	42	14872	0	15326
28161	228	118	18	14984	0	15348
28162	143	73	15068	371	0	15655
28163	129	15002	171	224	0	15526
28164	132	15462	108	139	0	15841
28165	15141	299	52	120	0	15612
28166	291	152	15502	82	0	16027
28167	131	71	14044	65	0	14311
28168	12533	43	106	46	0	12728
28169	12465	32	63	39	0	12599
28170	101	14416	32	49	0	14598
28171	55	14878	23	47	0	15003
28172	38	101	9	15062	0	15210
28173	15917	59	14	79	0	16069
28174	15973	36	15	74	0	16098
28175	16228	19	15	61	0	16323
28176	108	13	10	16189	0	16320
28177	75	19	5	16257	0	16356
28178	59	20	16552	102	0	16733
28179	47	22	15866	75	0	16010
28180	31	27	16457	58	0	16573
28181	16	136	45	15598	0	15795
28182	15621	9	52	38	0	15720
28183	31	8	16180	34	0	16253
28184	29	8	22	15898	0	15957
28185	12	16730	25	49	0	16816
28186	13	27	5	16588	0	16633
28187	11	24	5	16933	0	16973
28188	21	10	18119	66	0	18216
28189	18	6	68	17908	0	18000
28190	19147	8	51	107	0	19313
28191	103	12	20441	62	0	20618
28192	84	9	97	20354	0	20544
28193	28	8	21171	135	0	21342
28194	14	21621	113	108	0	21856
28195	52	111	21926	41	0	22130
28196	12	94	131	20843	0	21080
28197	5	65	99	21472	0	21641
28198	19	12	22529	209	0	22769
28199	14	9	124	22048	0	22195
28200	15	18	104	21706	0	21843
28201	8	22294	26	223	0	22551
28202	28	105	22703	125	0	22961
28203	12	96	116	22373	0	22597
28204	24	34	104	22664	0	22826
28205	17	23214	23	227	0	23481
28206	21	155	11	23370	0	23557
28207	23340	105	13	173	0	23631
28208	139	26	9	23538	0	23712
28209	120	13	23853	166	0	24152
28210	23454	14	141	139	0	23748
28211	25161	9	122	52	0	25344
28212	281	12	26361	38	0	26692
28213	25791	18	175	41	0	26025
28214	189	26743	160	52	0	27144
28215	160	167	50	26804	0	27181
28216	37	159	37	29724	0	29957
28217	25	62	45	29427	0	29559
28218	18	28	30	29956	0	30032
28219	18	7	32	30564	0	30621
28220	30298	13	24	479	0	30814
28221	227	17	30138	274	0	30656
28222	29037	20	233	119	0	29409
28223	287	27	29873	75	0	30262
28224	215	23	272	29438	0	29948
28225	29580	17	234	279	0	30110
28226	252	12	70	29209	0	29543
28227	220	29723	44	299	0	30286
28228	30368	221	63	241	0	30893
28229	272	212	32	31595	0	32111
28230	240	88	31335	283	0	31946
28231	29897	34	249	270	0	30450
28232	264	33131	227	201	0	33823
28233	240	244	33385	87	0	33956
28234	70	265	279	32466	0	33080
28235	81	203	268	31801	0	32353
28236	47	33182	79	535	0	33843
28237	62	246	33208	321	0	33837
28238	59	246	272	32894	0	33471
28239	58	72	34151	367	0	34648
28240	33	66	323	33631	0	34053
28241	47	26	278	33689	0	34040
28242	62	29	34349	581	0	35021
28243	61	37	373	34041	0	34512
28244	95	85	356	32654	0	33190
28245	65	43	124	35329	0	35561
28246	74	33	104	35754	0	35965
28247	34726	24	80	677	0	35507
28248	348	37	34725	447	0	35557
28249	36177	52	335	195	0	36759
28250	393	60	313	37156	0	37922
28251	367	77	139	37756	0	38339
28252	136	53	103	37882	0	38174
28253	98	37939	97	788	0	38922
28254	38291	366	90	469	0	39216
28255	379	326	103	38885	0	39693
28256	360	39202	113	467	0	40142
28257	138	338	105	39645	0	40226
28258	39596	330	113	514	0	40553
28259	38818	124	115	500	0	39557
28260	39539	101	128	257	0	40025
28261	687	39909	112	246	0	40954
28262	423	354	41052	262	0	42091
28263	39985	335	412	256	0	40988
28264	40969	107	357	261	0	41694
28265	653	41477	167	255	0	42552
28266	41088	349	141	236	0	41814
28267	40055	349	131	248	0	40783
28268	41201	116	105	256	0	41678
28269	743	43755	119	273	0	44890
28270	523	358	111	43518	0	44510
28271	43681	356	121	500	0	44658
28272	44211	139	123	502	0	44975
28273	43741	100	110	325	0	44276
28274	44191	82	120	280	0	44673
28275	844	94	81	43946	0	44965
28276	546	100	44008	602	0	45256
28277	249	109	429	43854	0	44641
28278	178	44193	412	675	0	45458
28279	196	426	151	45274	0	46047
28280	199	391	45720	699	0	47009
28281	45358	170	500	571	0	46599
28282	619	99	440	46378	0	47536
28283	46207	96	204	678	0	47185
28284	46223	111	175	593	0	47102
28285	929	112	146	46980	0	48167
28286	617	357	47378	697	0	49049
28287	369	106	45820	535	0	46830
28288	43321	104	747	392	0	44564
28289	566	45403	446	300	0	46715
28290	493	44985	186	228	0	45892
28291	274	45274	109	279	0	45936
28292	297	46555	106	251	0	47209
28293	45259	738	368	253	0	46618
28294	44902	456	96	214	0	45668
28295	44787	163	94	272	0	45316
28296	45291	136	87	234	0	45748
28297	778	127	120	44345	0	45370
28298	516	44849	97	463	0	45925
28299	44443	395	206	452	0	45496
28300	541	356	46038	241	0	47176
28301	468	45966	389	361	0	47184
28302	277	413	46091	231	0	47012
28303	44033	354	483	227	0	45097
28304	45133	125	411	224	0	45893
28305	45384	111	149	249	0	45893
28306	784	116	131	45762	0	46793
28307	571	105	46699	484	0	47859
28308	301	46376	367	566	0	47610
28309	45253	348	357	245	0	46203
28310	440	45472	163	275	0	46350
28311	432	44147	76	225	0	44880
28312	257	44529	74	181	0	45041
28313	270	44532	60	207	0	45069
28314	280	538	44453	158	0	45429
28315	230	44529	360	251	0	45370
28316	41545	279	194	139	0	42157
28317	338	248	94	41349	0	42029
28318	299	130	65	41825	0	42319
28319	41751	110	59	424	0	42344
28320	352	41910	57	339	0	42658
28321	365	253	44829	149	0	45596
28322	234	261	237	43617	0	44349
28323	216	121	214	44017	0	44568
28324	233	103	87	45174	0	45597
28325	204	110	45329	423	0	46066
28326	185	107	45258	274	0	45824
28327	201	95	403	45336	0	46035
28328	225	79	46067	263	0	46634
28329	227	98	44018	211	0	44554
28330	37799	132	475	148	0	38554
28331	313	44170	228	157	0	44868
28332	263	42345	91	112	0	42811
28333	226	44198	78	104	0	44606
28334	208	452	56	43348	0	44064
28335	163	45530	71	251	0	46015
28336	45714	274	104	193	0	46285
28337	356	212	46665	120	0	47353
28338	46119	124	265	103	0	46611
28339	352	127	211	46794	0	47484
28340	332	120	111	47149	0	47712
28341	164	49034	98	457	0	49753
28342	48739	317	103	271	0	49430
28343	48589	270	153	126	0	49138
28344	563	53239	81	138	0	54021
28345	363	497	68	52445	0	53373
28346	213	304	53440	339	0	54296
28347	166	138	53683	315	0	54302
28348	104	54378	599	198	0	55279
28349	53473	392	395	246	0	54506
28350	436	289	53928	55	0	54708
28351	384	101	330	52570	0	53385
28352	53464	80	335	330	0	54209
28353	52990	81	118	326	0	53515
28354	665	67415	78	124	0	68282
28355	409	69949	60	130	0	70548
28356	70454	1006	72	62	0	71594
28357	642	620	71016	58	0	72336
28358	69598	194	596	68	0	70456
28359	70335	134	552	56	0	71077
28360	1092	110	128	70456	0	71786
28361	679	101	72343	582	0	73705
28362	224	95	70439	532	0	71290
28363	68780	74	1147	160	0	70161
28364	781	141	71423	97	0	72442
28365	65977	110	808	97	0	66992
28366	69269	95	604	57	0	70025
28367	1133	70395	184	152	0	71864
28368	775	635	70371	99	0	71880
28369	216	68683	639	119	0	69657
28370	67367	701	567	100	0	68735
28371	678	613	67183	69	0	68543
28372	609	212	669	64777	0	66267
28373	245	108	66716	579	0	67648
28374	207	80	66598	547	0	67432
28375	184	82	66960	140	0	67366
28376	226	65	66875	113	0	67279
28377	143	66386	1221	211	0	67961
28378	192	647	66700	97	0	67636
28379	172	66189	731	164	0	67256
28380	252	686	65389	84	0	66411
28381	63459	606	778	56	0	64899
28382	798	213	667	59146	0	60824
28383	710	65187	278	483	0	66658
28384	64684	641	221	495	0	66041
28385	63265	670	242	132	0	64309
28386	61940	278	249	122	0	62589
28387	63629	188	283	69	0	64169
28388	1278	63984	312	106	0	65680
28389	62244	693	246	112	0	63295
28390	62819	609	283	139	0	63850
28391	1215	62105	301	388	0	64009
28392	826	736	60846	110	0	62518
28393	390	703	802	58905	0	60800
28394	321	61669	845	605	0	63440
28395	355	756	61625	541	0	63277
28396	432	652	61319	185	0	62588
28397	323	60639	1352	217	0	62531
28398	300	61098	915	175	0	62488
28399	343	62925	469	166	0	63903
28400	389	61915	440	157	0	62901
28401	60600	1361	441	106	0	62508
28402	59198	890	470	166	0	60724
28403	1445	404	61857	166	0	63872
28404	1038	344	61837	372	0	63591
28405	558	452	1597	59322	0	61929
28406	504	303	1076	59676	0	61559
28407	534	319	541	61281	0	62675
28408	60865	356	469	1212	0	62902
28409	1038	61189	454	826	0	63507
28410	1037	62807	500	300	0	64644
28411	646	63859	492	281	0	65278
28412	61560	1566	507	155	0	63788
28413	61932	1036	530	140	0	63638
28414	1761	524	527	60333	0	63145
28415	62608	428	545	727	0	64308
28416	62402	422	484	734	0	64042
28417	1810	511	526	62053	0	64900
28418	62721	534	588	849	0	64692
28419	1338	62628	666	808	0	65440
28420	1290	1133	704	62202	0	65329
28421	811	1047	60249	831	0	62938
28422	645	60081	1419	883	0	63028
28423	743	1222	60925	349	0	63239
28424	757	1135	1442	56833	0	60167
28425	659	60132	1402	847	0	63040
28426	841	1143	918	58738	0	61640
28427	762	1156	846	59423	0	62187
28428	792	622	59006	1512	0	61932
28429	678	605	61049	917	0	63249
28430	709	539	1974	59871	0	63093
28431	749	628	1468	55667	0	58512
28432	711	61031	907	1462	0	64111
28433	58314	1258	772	884	0	61228
28434	1355	59835	776	471	0	62437
28435	1400	59416	655	383	0	61854
28436	822	1859	58065	366	0	61112
28437	541	57996	1249	461	0	60247
28438	725	1324	1319	52866	0	56234
28439	645	56634	752	933	0	58964
28440	578	1321	648	54101	0	56648
28441	498	55460	735	1003	0	57696
28442	53992	1296	617	837	0	56742
28443	1146	54757	665	435	0	57003
28444	977	1227	599	46594	0	49397
28445	584	50329	568	779	0	52260
28446	49001	1172	811	723	0	51707
28447	48772	1134	379	358	0	50643
28448	1527	48767	405	346	0	51045
28449	47116	1176	344	253	0	48889
28450	1188	1415	293	44875	0	47771
28451	974	570	45104	883	0	47531
28452	664	504	45241	683	0	47092
28453	496	44841	1537	403	0	47277
28454	29453	648	650	253	0	31004
28455	28740	413	166	219	0	29538
28456	655	198	28375	117	0	29345
28457	413	177	27199	100	0	27889
28458	26055	238	564	126	0	26983
28459	26703	137	301	112	0	27253
28460	566	159	26564	104	0	27393
28461	24438	137	401	121	0	25097
28462	352	24806	302	135	0	25595
28463	278	24994	83	123	0	25478
28464	360	572	161	24073	0	25166
28465	97	349	75	24517	0	25038
28466	24581	179	75	521	0	25356
28467	24012	138	107	293	0	24550
28468	24306	142	82	131	0	24661
28469	520	147	89	23861	0	24617
28470	333	126	77	23511	0	24047
28471	150	22909	64	555	0	23678
28472	122	23271	94	344	0	23831
28473	102	23833	108	194	0	24237
28474	133	675	109	21853	0	22770
28475	126	22893	88	316	0	23423
28476	125	403	22233	270	0	23031
28477	20618	338	331	129	0	21416
28478	383	196	22134	100	0	22813
28479	297	180	21703	116	0	22296
28480	20563	182	485	99	0	21329
28481	355	21519	264	171	0	22309
28482	21643	370	111	123	0	22247
28483	21601	323	112	133	0	22169
28484	548	179	20943	125	0	21795
28485	335	169	21178	124	0	21806
28486	186	21256	463	160	0	22065
28487	209	408	21496	121	0	22234
28488	210	326	347	20834	0	21717
28489	190	201	299	19736	0	20426
28490	160	21385	139	482	0	22166
28491	150	21940	131	296	0	22517
28492	21522	617	121	133	0	22393
28493	21702	381	122	143	0	22348
28494	573	254	126	21371	0	22324
28495	375	190	129	21875	0	22569
28496	21588	192	131	547	0	22458
28497	21499	182	159	316	0	22156
28498	591	21850	162	146	0	22749
28499	20416	392	124	90	0	21022
28500	460	19858	110	93	0	20521
28501	347	20575	122	74	0	21118
28502	20344	553	155	98	0	21150
28503	19870	354	136	100	0	20460
28504	572	198	113	19688	0	20571
28505	19821	148	112	331	0	20412
28506	446	156	19895	251	0	20748
28507	351	19803	328	127	0	20609
28508	19381	376	238	119	0	20114
28509	424	283	19240	124	0	20071
28510	266	307	265	16386	0	17224
28511	148	17035	196	258	0	17637
28512	173	17483	98	175	0	17929
28513	17425	389	88	77	0	17979
28514	365	228	17287	65	0	17945
28515	15406	101	225	50	0	15782
28516	288	80	170	15582	0	16120
28517	211	80	15446	202	0	15939
28518	15599	73	236	140	0	16048
28519	273	16240	168	68	0	16749
28520	200	17040	99	52	0	17391
28521	17193	288	170	53	0	17704
28522	17114	165	64	68	0	17411
28523	17321	99	47	78	0	17545
28524	338	134	61	16986	0	17519
28525	240	62	64	17115	0	17481
28526	148	75	17324	256	0	17803
28527	125	83	17181	148	0	17537
28528	101	17431	243	106	0	17881
28529	64	307	181	15358	0	15910
28530	15162	104	60	143	0	15469
28531	149	15051	32	292	0	15524
28532	472	180	31	14835	0	15518
28533	14790	104	30	129	0	15053
28534	157	14932	28	112	0	15229
28535	120	16331	34	56	0	16541
28536	85	182	16200	90	0	16557
28537	15222	105	172	42	0	15541
28538	16020	57	90	47	0	16214
28539	192	64	16115	38	0	16409
28540	14955	52	119	26	0	15152
28541	160	44	16043	27	0	16274
28542	101	15676	116	35	0	15928
28543	51	108	79	15395	0	15633
28544	15344	67	67	110	0	15588
28545	102	15002	31	86	0	15221
28546	69	14715	24	31	0	14839
28547	14102	109	17	19	0	14247
28548	103	61	15939	62	0	16165
28549	15359	27	57	29	0	15472
28550	82	16466	46	81	0	16675
28551	62	68	16376	20	0	16526
28552	15990	40	62	25	0	16117
28553	16555	28	34	22	0	16639
28554	96	18	11	16705	0	16830
28555	56	22	13	16755	0	16846
28556	30	17100	10	87	0	17227
28557	44	77	17593	46	0	17760
28558	27	38	78	17248	0	17391
28559	45	14	18216	89	0	18364
28560	47	24	18264	61	0	18396
28561	22	21	119	19118	0	19280
28562	43	11	19917	107	0	20078
28563	41	22	20421	62	0	20546
28564	21	32	154	19928	0	20135
28565	30	15	20693	120	0	20858
28566	18711	15	127	72	0	18925
28567	104	20258	74	117	0	20553
28568	78	103	21265	27	0	21473
28569	65	71	22819	21	0	22976
28570	41	27	169	22313	0	22550
28571	23451	27	69	108	0	23655
28572	22983	24	39	78	0	23124
28573	23163	16	27	32	0	23238
28574	23401	17	24	30	0	23472
28575	166	26	22	23223	0	23437
28576	102	19	24246	109	0	24476
28577	23966	18	112	89	0	24185
28578	24218	29	67	25	0	24339
28579	24588	31	34	25	0	24678
28580	197	15	24516	27	0	24755
28581	22584	19	118	39	0	22760
28582	119	21	73	25321	0	25534
28583	77	26013	41	137	0	26268
28584	36	198	30	26413	0	26677
28585	30	26995	29	147	0	27201
28586	26944	155	33	110	0	27242
28587	179	102	27921	92	0	28294
28588	114	21	169	26926	0	27230
28589	29	28397	133	160	0	28719
28590	21	28884	45	123	0	29073
28591	28780	251	72	36	0	29139
28592	28516	118	35	40	0	28709
28593	292	40	28279	27	0	28638
28594	27864	25	187	19	0	28095
28595	186	22	131	28424	0	28763
28596	158	10	30667	173	0	31008
28597	73	11	30340	121	0	30545
28598	46	17	275	31445	0	31783
28599	33785	13	136	198	0	34132
28600	277	115	39	33266	0	33697
28601	180	25	31	33336	0	33572
28602	55	22	39	33574	0	33690
28603	45	33957	31	369	0	34402
28604	60	204	40	34199	0	34503
28605	33702	164	32	241	0	34139
28606	216	33633	37	264	0	34150
28607	183	216	27	34037	0	34463
28608	33769	164	38	234	0	34205
28609	224	33593	28	203	0	34048
28610	178	34038	113	72	0	34401
28611	96	378	39	34115	0	34628
28612	33393	195	39	260	0	33887
28613	235	61	33623	228	0	34147
28614	216	53	33236	52	0	33557
28615	32237	43	399	60	0	32739
28616	34030	41	209	62	0	34342
28617	414	35354	69	111	0	35948
28618	223	254	60	34432	0	34969
28619	110	178	34652	257	0	35197
28620	100	55	33524	212	0	33891
28621	79	26	36326	95	0	36526
28622	63	35571	464	96	0	36194
28623	59	36348	246	95	0	36748
28624	35863	435	97	70	0	36465
28625	322	203	36336	70	0	36931
28626	34233	75	306	76	0	34690
28627	35715	53	234	85	0	36087
28628	508	40	38143	167	0	38858
28629	260	39164	312	111	0	39847
28630	123	369	253	38264	0	39009
28631	111	243	39554	325	0	40233
28632	139	110	38456	269	0	38974
28633	36411	122	517	104	0	37154
28634	356	38972	246	117	0	39691
28635	285	335	86	37000	0	37706
28636	127	265	87	37155	0	37634
28637	94	37979	70	518	0	38661
28638	105	38631	77	297	0	39110
28639	113	39228	97	126	0	39564
28640	129	585	81	40042	0	40837
28641	41781	289	83	400	0	42553
28642	495	115	101	42424	0	43135
28643	387	85	42273	486	0	43231
28644	182	80	42046	347	0	42655
28645	117	86	729	42137	0	43069
28646	133	81	43086	483	0	43783
28647	108	42734	517	417	0	43776
28648	118	532	368	42986	0	44004
28649	44838	335	155	540	0	45868
28650	44757	123	125	408	0	45413
28651	865	46052	112	194	0	47223
28652	46367	602	88	135	0	47192
28653	46211	420	107	155	0	46893
28654	46801	139	101	145	0	47186
28655	1015	186	45260	119	0	46580
28656	44269	110	561	154	0	45094
28657	620	45816	421	182	0	47039
28658	435	588	45692	127	0	46842
28659	194	433	45515	123	0	46265
28660	127	45025	881	161	0	46194
28661	44485	562	442	99	0	45588
28662	642	412	152	43314	0	44520
28663	425	43734	119	562	0	44840
28664	44037	551	117	416	0	45121
28665	572	452	105	44269	0	45398
28666	44636	152	116	643	0	45547
28667	640	116	121	45183	0	46060
28668	487	131	44163	641	0	45422
28669	217	139	42591	487	0	43434
28670	184	139	43239	201	0	43763
28671	162	165	963	40686	0	41976
28672	162	145	494	42895	0	43696
28673	198	149	42775	928	0	44050
28674	170	42647	627	511	0	43955
28675	42844	634	472	165	0	44115
28676	42675	471	205	138	0	43489
28677	1031	43501	190	129	0	44851
28678	643	753	237	43447	0	45080
28679	273	495	44457	607	0	45832
28680	42955	177	745	470	0	44347
28681	780	158	44540	181	0	45659
28682	587	164	42205	119	0	43075
28683	263	120	42590	137	0	43110
28684	40003	127	1040	108	0	41278
28685	686	153	41066	129	0	42034
28686	499	39650	698	129	0	40976
28687	211	40725	500	128	0	41564
28688	301	905	241	38483	0	39930
28689	221	465	195	39039	0	39920
28690	192	166	38963	868	0	40189
28691	36691	155	661	467	0	37974
28692	38754	147	486	163	0	39550
28693	951	128	214	38947	0	40240
28694	39186	142	202	578	0	40108
28695	672	38907	191	508	0	40278
28696	37648	579	201	189	0	38617
28697	672	37351	232	164	0	38419
28698	457	36951	188	175	0	37771
28699	34920	806	253	166	0	36145
28700	34601	415	229	154	0	35399
28701	35493	172	199	143	0	36007
28702	35880	128	192	155	0	36355
28703	1002	118	34758	114	0	35992
28704	34296	154	631	124	0	35205
28705	693	163	478	33607	0	34941
28706	458	34752	255	552	0	36017
28707	34378	551	225	385	0	35539
28708	642	34750	227	200	0	35819
28709	34861	573	219	140	0	35793
28710	697	402	269	34037	0	35405
28711	529	198	205	34545	0	35477
28712	298	163	34083	829	0	35373
28713	289	196	34314	465	0	35264
28714	245	34280	858	247	0	35630
28715	33187	591	478	165	0	34421
28716	644	33711	211	208	0	34774
28717	508	33058	209	234	0	34009
28718	374	34236	197	170	0	34977
28719	410	824	33331	138	0	34703
28720	319	33601	556	142	0	34618
28721	30601	653	481	127	0	31862
28722	30513	439	218	126	0	31296
28723	901	195	182	29354	0	30632
28724	516	29997	194	489	0	31196
28725	282	30535	184	370	0	31371
28726	310	786	158	30113	0	31367
28727	298	437	30009	527	0	31271
28728	304	28434	554	416	0	29708
28729	295	713	396	27155	0	28559
28730	26699	403	196	505	0	27803
28731	26681	193	197	383	0	27454
28732	727	27253	172	240	0	28392
28733	27350	533	185	154	0	28222
28734	27353	420	191	153	0	28117
28735	811	219	196	26796	0	28022
28736	559	192	26580	487	0	27818
28737	266	27122	572	442	0	28402
28738	248	671	408	26572	0	27899
28739	277	392	26387	472	0	27528
28740	223	25235	489	426	0	26373
28741	22748	417	334	115	0	23614
28742	22397	336	150	95	0	22978
28743	570	276	139	21946	0	22931
28744	368	22544	120	344	0	23376
28745	214	402	22308	302	0	23226
28746	208	437	351	21577	0	22573
28747	210	188	22455	352	0	23205
28748	167	20482	305	274	0	21228
28749	368	692	233	17226	0	18519
28750	16974	186	75	197	0	17432
28751	221	16471	79	156	0	16927
28752	15979	224	69	64	0	16336
28753	15727	181	53	65	0	16026
28754	310	16082	45	79	0	16516
28755	241	197	39	15787	0	16264
28756	161	179	44	15841	0	16225
28757	130	15823	52	264	0	16269
28758	138	16222	50	168	0	16578
28759	141	267	58	15571	0	16037
28760	106	15989	62	177	0	16334
28761	15702	210	54	151	0	16117
28762	15179	168	35	79	0	15461
28763	284	98	15357	67	0	15806
28764	192	109	15329	51	0	15681
28765	14356	102	200	63	0	14721
28766	14744	91	116	64	0	15015
28767	243	15280	75	70	0	15668
28768	15305	197	45	63	0	15610
28769	15124	166	60	55	0	15405
28770	269	14953	48	62	0	15332
28771	15534	187	33	68	0	15822
28772	184	175	97	18388	0	18844
28773	131	118	60	19394	0	19703
28774	108	99	20171	365	0	20743
28775	81	19309	230	185	0	19805
28776	53	19183	154	62	0	19452
28777	18103	635	222	174	0	19134
28778	17990	143	19	25	0	18177
28779	17676	46	43	28	0	17793
28780	17997	32	38	15	0	18082
28781	321	42	18098	16	0	18477
28782	151	23	18099	23	0	18296
28783	33	18144	274	40	0	18491
28784	23	208	130	17643	0	18004
28785	29	161	37	16989	0	17216
28786	29	18200	9	269	0	18507
28787	37	227	24	17681	0	17969
28788	17432	147	19	206	0	17804
28789	208	17690	17	163	0	18078
28790	168	205	18004	39	0	18416
28791	34	18272	201	45	0	18552
28792	18142	213	128	29	0	18512
28793	230	191	18012	21	0	18454
28794	17537	43	197	22	0	17799
28795	17905	32	123	32	0	18092
28796	383	30	17804	26	0	18243
28797	162	34	17771	16	0	17983
28798	60	24	17733	11	0	17828
28799	16709	31	308	25	0	17073
28800	223	30	17587	31	0	17871
28801	140	17130	196	52	0	17518
28802	17067	193	120	19	0	17399
28803	212	121	17002	21	0	17356
28804	16365	37	206	20	0	16628
28805	224	34	16819	27	0	17104
28806	144	26	17281	19	0	17470
28807	54	17400	281	63	0	17798
28808	57	200	17680	21	0	17958
28809	87	129	17350	21	0	17587
28810	46	16570	309	51	0	16976
28811	17005	214	137	34	0	17390
28812	228	128	17358	38	0	17752
28813	153	57	206	15886	0	16302
28814	55	17544	148	214	0	17961
28815	17547	217	49	133	0	17946
28816	17367	149	59	55	0	17630
28817	338	57	17427	48	0	17870
28818	163	16877	233	43	0	17316
28819	79	16978	169	59	0	17285
28820	109	332	73	16100	0	16614
28821	95	16864	78	181	0	17218
28822	151	253	69	16233	0	16706
28823	128	145	78	16837	0	17188
28824	107	17077	98	319	0	17601
28825	112	239	95	16746	0	17192
28826	100	16985	116	253	0	17454
28827	114	269	17089	148	0	17620
28828	89	241	288	16589	0	17207
28829	116	125	194	16326	0	16761
28830	137	16905	96	326	0	17464
28831	165	17225	91	171	0	17652
28832	176	373	101	16135	0	16785
28833	126	16939	160	234	0	17459
28834	16813	306	136	147	0	17402
28835	326	224	132	16591	0	17273
28836	234	16850	141	250	0	17475
28837	16138	288	118	176	0	16720
28838	328	16296	132	82	0	16838
28839	252	312	16266	99	0	16929
28840	159	214	333	16016	0	16722
28841	16188	160	253	247	0	16848
28842	321	113	16575	185	0	17194
28843	231	153	344	15671	0	16399
28844	182	16331	245	253	0	17011
28845	195	310	16398	153	0	17056
28846	156	16657	336	68	0	17217
28847	15864	289	270	54	0	16477
28848	15681	207	224	44	0	16156
28849	414	15900	188	62	0	16564
28850	15987	277	239	64	0	16567
28851	333	211	15988	54	0	16586
28852	235	125	382	15430	0	16172
28853	113	148	302	15064	0	15627
28854	241	15778	172	345	0	16536
28855	16912	281	216	149	0	17558
28856	17408	217	180	63	0	17868
28857	401	157	17492	40	0	18090
28858	17098	121	367	53	0	17639
28859	17128	147	261	50	0	17586
28860	17234	130	213	44	0	17621
28861	419	136	177	16863	0	17595
28862	220	166	175	16765	0	17326
28863	129	17153	152	342	0	17776
28864	16740	341	160	162	0	17403
28865	16501	231	147	110	0	16989
28866	364	16992	123	90	0	17569
28867	187	663	119	16066	0	17035
28868	138	16556	88	261	0	17043
28869	95	17011	135	167	0	17408
28870	16518	413	136	204	0	17271
28871	272	292	15949	118	0	16631
28872	122	78	12617	54	0	12871
28873	59	12335	150	65	0	12609
28874	11181	129	112	32	0	11454
28875	102	87	11356	45	0	11590
28876	66	11177	81	47	0	11371
28877	10143	73	42	18	0	10276
28878	61	43	10118	18	0	10240
28879	39	15	50	9722	0	9826
28880	10296	33	41	49	0	10419
28881	78	21	10660	49	0	10808
28882	53	21	10936	26	0	11036
28883	18	29	11844	15	0	11906
28884	27	12	11905	21	0	11965
28885	11014	23	100	16	0	11153
28886	12187	12	52	15	0	12266
28887	96	12491	3	18	0	12608
28888	48	84	11	12563	0	12706
28889	10	62	11	12774	0	12857
28890	14	12669	6	140	0	12829
28891	12	98	8	12887	0	13005
28892	8	13117	8	95	0	13228
28893	17	13225	9	74	0	13325
28894	19	154	10	13160	0	13343
28895	11	78	13395	100	0	13584
28896	16	13465	97	89	0	13667
28897	18	112	73	13311	0	13514
28898	13388	80	18	107	0	13593
28899	207	20	13311	88	0	13626
28900	13020	18	105	22	0	13165
28901	13583	10	95	14	0	13702
28902	179	23	15	14260	0	14477
28903	123	12	14832	128	0	15095
28904	35	18	14900	106	0	15059
28905	17	15535	238	30	0	15820
28906	29	144	118	15146	0	15437
28907	39	119	15274	142	0	15574
28908	30	15	15569	119	0	15733
28909	17	15631	245	34	0	15927
28910	15450	151	132	80	0	15813
28911	15320	130	31	16	0	15497
28912	247	27	14	16610	0	16898
28913	134	23	17744	220	0	18121
28914	26	16	17942	160	0	18144
28915	18	18252	323	67	0	18660
28916	33	171	18769	25	0	18998
28917	41	160	18642	24	0	18867
28918	23	33	346	17912	0	18314
28919	25	24	18869	184	0	19102
28920	17725	17	201	182	0	18125
28921	220	13	180	18692	0	19105
28922	184	14	19238	236	0	19672
28923	39	19631	177	194	0	20041
28924	21	180	166	19854	0	20221
28925	33	174	20087	199	0	20493
28926	20	20411	193	205	0	20829
28927	37	195	184	19506	0	19922
28928	19	20491	45	176	0	20731
28929	15	202	37	20348	0	20602
28930	17	186	42	20307	0	20552
28931	31	38	20420	345	0	20834
28932	21	20431	195	226	0	20873
28933	22	200	195	20152	0	20569
28934	24	181	75	19724	0	20004
28935	15	47	61	20627	0	20750
28936	32	40	20363	360	0	20795
28937	24	20186	211	270	0	20691
28938	22	257	204	20196	0	20679
28939	37	188	20383	208	0	20816
28940	21	20272	224	261	0	20778
28941	26	213	216	20313	0	20768
28942	55	192	20380	216	0	20843
28943	31	20443	227	262	0	20963
28944	36	214	217	19778	0	20245
28945	32	210	93	20593	0	20928
28946	45	68	21810	379	0	22302
28947	20304	56	247	247	0	20854
28948	180	21739	231	100	0	22250
28949	21799	216	85	73	0	22173
28950	220	218	22115	79	0	22632
28951	21933	79	263	63	0	22338
28952	229	115	238	21557	0	22139
28953	202	64	110	22567	0	22943
28954	70	62	22327	397	0	22856
28955	20060	68	260	271	0	20659
28956	20539	53	263	111	0	20966
28957	344	20708	108	117	0	21277
28958	211	21208	96	104	0	21619
28959	21226	381	122	82	0	21811
28960	238	255	21298	98	0	21889
28961	198	22174	264	124	0	22760
28962	69	236	272	21943	0	22520
28963	53	223	129	22606	0	23011
28964	53	87	22540	419	0	23099
28965	21758	72	296	267	0	22393
28966	238	81	23621	140	0	24080
28967	23454	54	331	106	0	23945
28968	269	81	24728	89	0	25167
28969	228	24720	286	111	0	25345
28970	24915	253	287	106	0	25561
28971	24740	377	138	102	0	25357
28972	24350	96	116	131	0	24693
28973	24643	67	159	96	0	24965
28974	431	106	112	24484	0	25133
28975	255	92	24791	498	0	25636
28976	83	65	310	24238	0	24696
28977	49	25156	297	466	0	25968
28978	69	234	141	25453	0	25897
28979	85	255	25432	295	0	26067
28980	80	98	25865	281	0	26324
28981	60	103	447	25257	0	25867
28982	25268	86	309	259	0	25922
28983	24403	88	137	276	0	24904
28984	24800	70	170	146	0	25186
28985	434	89	25305	112	0	25940
28986	248	78	25871	120	0	26317
28987	96	25664	395	209	0	26364
28988	59	25653	261	115	0	26088
28989	25211	348	106	109	0	25774
28990	25242	240	94	83	0	25659
28991	347	26746	70	114	0	27277
28992	26632	205	83	86	0	27006
28993	26250	203	84	78	0	26615
28994	332	26761	65	122	0	27280
28995	27035	182	85	88	0	27390
28996	26463	220	134	80	0	26897
28997	338	27642	67	190	0	28237
28998	27842	180	88	86	0	28196
28999	27015	189	184	105	0	27493
29000	343	98	27921	86	0	28448
29001	253	63	27761	79	0	28156
29002	108	27078	277	108	0	27571
29003	80	27274	192	72	0	27618
29004	26990	285	220	52	0	27547
29005	26079	182	53	137	0	26451
29006	26162	58	77	58	0	26355
29007	280	26865	57	76	0	27278
29008	173	117	54	26847	0	27191
29009	105	119	27429	116	0	27769
29010	64	274	136	26290	0	26764
29011	62	27506	147	135	0	27850
29012	26349	123	50	82	0	26604
29013	119	25964	25	42	0	26150
29014	119	100	23	26010	0	26252
29015	27978	91	23	102	0	28194
29016	27616	41	25	98	0	27780
29017	258	32	28024	22	0	28336
29018	27959	37	111	25	0	28132
29019	29300	40	131	23	0	29494
29020	29786	39	52	39	0	29916
29021	310	85	31	29059	0	29485
29022	203	29209	31	152	0	29595
29023	91	142	31	29750	0	30014
29024	88	160	30209	155	0	30612
29025	79	30526	171	313	0	31089
29026	63	182	187	30245	0	30677
29027	74	193	30594	187	0	31048
29028	83	30442	182	207	0	30914
29029	86	190	182	29840	0	30298
29030	111	194	30298	160	0	30763
29031	26772	78	228	218	0	27296
29032	238	53	30683	71	0	31045
29033	238	51	30699	56	0	31044
29034	94	31276	337	72	0	31779
29035	88	227	206	30931	0	31452
29036	99	237	78	30236	0	30650
29037	117	31399	74	298	0	31888
29038	121	214	46	32011	0	32392
29039	32205	204	49	216	0	32674
29040	31469	67	55	218	0	31809
29041	466	72	32299	63	0	32900
29042	31998	54	212	63	0	32327
29043	32764	67	232	51	0	33114
29044	454	77	33820	79	0	34430
29045	305	33790	228	92	0	34415
29046	128	33041	224	80	0	33473
29047	169	474	91	29777	0	30511
29048	116	33181	73	193	0	33563
29049	140	288	32730	183	0	33341
29050	147	254	32743	55	0	33199
29051	102	33772	427	82	0	34383
29052	33650	264	298	50	0	34262
29053	33756	293	94	54	0	34197
29054	34434	127	69	71	0	34701
29055	34043	109	124	75	0	34351
29056	34014	92	85	73	0	34264
29057	495	34109	72	95	0	34771
29058	361	276	33886	62	0	34585
29059	165	273	256	33476	0	34170
29060	33391	118	264	254	0	34027
29061	305	33003	101	324	0	33733
29062	328	333	71	32869	0	33601
29063	194	262	32863	309	0	33628
29064	133	32401	263	272	0	33069
29065	114	32780	265	122	0	33281
29066	30900	658	259	338	0	32155
29067	241	31332	63	114	0	31750
29068	248	305	60	29879	0	30492
29069	30018	233	62	203	0	30516
29070	29020	103	66	196	0	29385
29071	29547	75	52	55	0	29729
29072	445	73	29670	46	0	30234
29073	267	29821	225	44	0	30357
29074	30398	230	229	34	0	30891
29075	258	239	77	29731	0	30305
29076	30401	95	67	207	0	30770
29077	276	30006	67	230	0	30579
29078	31233	242	66	73	0	31614
29079	33150	244	54	59	0	33507
29080	526	106	44	32724	0	33400
29081	357	89	33733	306	0	34485
29082	152	77	311	34235	0	34775
29083	33891	92	306	335	0	34624
29084	34282	98	104	309	0	34793
29085	580	34711	78	132	0	35501
29086	33814	323	65	84	0	34286
29087	378	34218	71	128	0	34795
29088	34124	360	73	83	0	34640
29089	33450	373	55	73	0	33951
29090	601	133	34145	85	0	34964
29091	371	33696	321	98	0	34486
29092	169	418	305	32942	0	33834
29093	160	333	116	33268	0	33877
29094	170	153	105	32438	0	32866
29095	130	33430	77	564	0	34201
29096	159	357	33458	344	0	34318
29097	159	350	33306	106	0	33921
29098	157	39948	539	173	0	40817
29099	40256	448	376	94	0	41174
29100	516	455	40403	119	0	41493
29101	39691	180	454	88	0	40413
29102	562	40000	428	136	0	41126
29103	590	471	40395	109	0	41565
29104	288	481	442	39673	0	40884
29105	205	196	41131	477	0	42009
29106	223	142	41484	459	0	42308
29107	247	228	807	37314	0	38596
29108	223	39672	518	375	0	40788
29109	199	40589	163	407	0	41358
29110	40257	808	196	138	0	41399
29111	577	532	40122	127	0	41358
29112	39217	299	521	116	0	40153
29113	39803	163	500	144	0	40610
29114	829	39828	158	123	0	40938
29115	37993	484	118	57	0	38652
29116	37428	446	87	79	0	38040
29117	36879	172	100	83	0	37234
29118	824	36709	93	108	0	37734
29119	507	34179	83	106	0	34875
29120	227	35649	80	85	0	36041
29121	35298	735	224	66	0	36323
29122	34948	487	186	164	0	35785
29123	755	164	34475	119	0	35513
29124	482	115	33413	72	0	34082
29125	32928	105	616	79	0	33728
29126	33417	94	384	81	0	33976
29127	33834	112	151	70	0	34167
29128	699	101	110	32939	0	33849
29129	452	111	93	33105	0	33761
29130	207	104	102	33482	0	33895
29131	167	98	102	34023	0	34390
29132	176	107	33193	662	0	34138
29133	193	95	32785	389	0	33462
29134	216	103	32873	119	0	33311
29135	223	103	32509	81	0	32916
29136	31194	122	639	86	0	32041
29137	463	32304	396	93	0	33256
29138	434	33254	151	117	0	33956
29139	32959	617	128	79	0	33783
29140	492	414	32808	100	0	33814
29141	440	170	31609	84	0	32303
29142	30399	131	709	98	0	31337
29143	30853	117	546	81	0	31597
29144	636	30995	207	114	0	31952
29145	450	341	149	30808	0	31748
29146	31325	331	116	331	0	32103
29147	31455	183	117	323	0	32078
29148	696	158	105	30885	0	31844
29149	473	31860	96	366	0	32795
29150	31839	382	123	342	0	32686
29151	466	381	31056	147	0	32050
29152	30539	158	405	126	0	31228
29153	448	30735	416	125	0	31724
29154	30771	405	176	110	0	31462
29155	30523	399	158	126	0	31206
29156	665	169	30624	110	0	31568
29157	461	145	30538	159	0	31303
29158	29770	146	681	81	0	30678
29159	30742	154	447	75	0	31418
29160	629	31348	215	91	0	32283
29161	488	405	176	31525	0	32594
29162	262	370	31372	335	0	32339
29163	30798	155	432	316	0	31701
29164	498	162	409	31118	0	32187
29165	475	170	184	31552	0	32381
29166	31513	146	187	568	0	32414
29167	454	31713	182	616	0	32965
29168	32650	382	169	137	0	33338
29169	32416	370	171	108	0	33065
29170	32811	189	166	108	0	33274
29171	753	32747	133	171	0	33804
29172	33013	416	132	86	0	33647
29173	637	437	153	32249	0	33476
29174	582	183	145	32497	0	33407
29175	314	156	33139	589	0	34198
29176	344	166	32626	356	0	33492
29177	276	32605	606	172	0	33659
29178	248	33685	381	121	0	34435
29179	292	560	31524	69	0	32445
29180	218	32023	332	74	0	32647
29181	30780	562	474	317	0	32133
29182	30632	292	104	68	0	31096
29183	31055	99	83	79	0	31316
29184	629	103	69	30393	0	31194
29185	397	59	176	30616	0	31248
29186	214	67	31989	575	0	32845
29187	134	31697	314	346	0	32491
29188	31522	321	309	102	0	32254
29189	356	32035	113	75	0	32579
29190	31610	358	76	47	0	32091
29191	31328	290	77	52	0	31747
29192	636	83	71	31402	0	32192
29193	405	80	99	31597	0	32181
29194	185	60	70	32424	0	32739
29195	235	70	31305	619	0	32229
29196	118	31088	314	443	0	31963
29197	108	30762	295	150	0	31315
29198	93	22955	38	36	0	23122
29199	44	22866	28	46	0	22984
29200	41	23030	31	236	0	23338
29201	22117	294	35	43	0	22489
29202	193	141	23261	26	0	23621
29203	140	23094	152	63	0	23449
29204	80	165	23014	37	0	23296
29205	35	23355	162	54	0	23606
29206	60	229	163	21348	0	21800
29207	55	160	43	21810	0	22068
29208	44	23150	28	252	0	23474
29209	22857	152	26	146	0	23181
29210	187	135	22891	47	0	23260
29211	156	23000	146	53	0	23355
29212	76	167	23289	38	0	23570
29213	51	138	180	22778	0	23147
29214	56	90	151	21441	0	21738
29215	64	23167	38	250	0	23519
29216	64	168	29	23393	0	23654
29217	65	191	23	23313	0	23592
29218	53	23770	35	335	0	24193
29219	67	168	23985	164	0	24384
29220	65	149	23737	60	0	24011
29221	22632	81	264	70	0	23047
29222	23535	60	160	48	0	23803
29223	281	70	50	23274	0	23675
29224	207	70	24086	166	0	24529
29225	89	63	147	23423	0	23722
29226	54	26094	140	283	0	26571
29227	73	192	26352	152	0	26769
29228	43	26305	159	100	0	26607
29229	82	327	25973	53	0	26435
29230	39	26206	190	60	0	26495
29231	25869	202	151	50	0	26272
29232	156	190	65	25373	0	25784
29233	142	106	39	25315	0	25602
29234	79	75	25827	275	0	26256
29235	87	73	25428	181	0	25769
29236	63	25824	285	80	0	26252
29237	25578	276	167	61	0	26082
29238	181	168	82	24877	0	25308
29239	163	107	25504	177	0	25951
29240	64	89	24731	173	0	25057
29241	22638	100	305	115	0	23158
29242	24125	106	176	74	0	24481
29243	291	91	25006	46	0	25434
29244	191	315	188	23596	0	24290
29245	112	24934	170	188	0	25404
29246	24965	190	81	170	0	25406
29247	195	24887	60	122	0	25264
29248	24260	190	57	95	0	24602
29249	192	24094	56	114	0	24456
29250	145	24285	74	101	0	24605
29251	100	287	61	24180	0	24628
29252	80	192	64	23934	0	24270
29253	69	24645	59	272	0	25045
29254	96	205	24296	162	0	24759
29255	113	176	23854	81	0	24224
29256	91	103	24002	75	0	24271
29257	22048	87	330	97	0	22562
29258	23465	89	155	95	0	23804
29259	220	24832	85	121	0	25258
29260	159	216	24507	80	0	24962
29261	67	235	170	23904	0	24376
29262	52	136	25292	191	0	25671
29263	44	139	25804	174	0	26161
29264	63	138	331	26597	0	27129
29265	68	114	227	28108	0	28517
29266	82	123	30704	440	0	31349
29267	30297	121	328	301	0	31047
29268	290	32999	325	149	0	33763
29269	330	33879	132	97	0	34438
29270	127	824	78	33623	0	34652
29271	34484	441	70	335	0	35330
29272	315	35553	78	406	0	36352
29273	36034	402	74	134	0	36644
29274	414	36283	75	138	0	36910
29275	37392	460	80	63	0	37995
29276	496	565	37187	71	0	38319
29277	455	161	37602	62	0	38280
29278	165	152	737	35230	0	36284
29279	144	50	35763	355	0	36312
29280	44	33974	420	396	0	34834
29281	51	33622	404	140	0	34217
29282	33666	638	129	35	0	34468
29283	336	482	66	32639	0	33523
29284	345	33942	46	367	0	34700
29285	34066	344	48	339	0	34797
29286	32619	382	38	116	0	33155
29287	34038	128	31	43	0	34240
29288	763	55	33	33058	0	33909
29289	472	51	30	33614	0	34167
29290	188	52	33629	692	0	34561
29291	89	40	33309	467	0	33905
29292	32705	47	677	131	0	33560
29293	373	42	439	32706	0	33560
29294	412	48	33062	362	0	33884
29295	32282	41	379	393	0	33095
29296	362	34018	413	155	0	34948
29297	34376	348	157	60	0	34941
29298	34223	383	95	62	0	34763
29299	34597	127	74	63	0	34861
29300	836	64	33857	59	0	34816
29301	33389	61	392	57	0	33899
29302	517	81	403	32188	0	33189
29303	487	32357	153	393	0	33390
29304	198	33815	73	498	0	34584
29305	33710	718	74	137	0	34639
29306	33487	495	69	77	0	34128
29307	34037	164	62	68	0	34331
29308	933	93	51	32690	0	33767
29309	582	100	68	33014	0	33764
29310	250	106	62	32212	0	32630
29311	151	33029	62	847	0	34089
29312	32866	437	78	499	0	33880
29313	32655	448	90	186	0	33379
29314	33367	197	207	120	0	33891
29315	946	120	32933	122	0	34121
29316	32975	126	414	112	0	33627
29317	620	124	454	31403	0	32601
29318	579	32478	191	407	0	33655
29319	31688	427	134	417	0	32666
29320	31211	453	135	172	0	31971
29321	881	186	32394	134	0	33595
29322	653	129	448	31453	0	32683
29323	286	32505	482	427	0	33700
29324	33039	483	190	448	0	34160
29325	594	513	111	32820	0	34038
29326	612	262	123	31568	0	32565
29327	346	161	135	31472	0	32114
29328	282	152	114	33139	0	33687
29329	291	156	32379	1034	0	33860
29330	251	32474	496	734	0	33955
29331	246	584	497	32445	0	33772
29332	302	555	32676	603	0	34136
29333	31937	274	551	578	0	33340
29334	32890	198	565	275	0	33928
29335	1104	175	245	32506	0	34030
29336	33120	195	193	609	0	34117
29337	33602	199	178	572	0	34551
29338	1164	202	33456	292	0	35114
29339	862	33277	508	189	0	34836
29340	33637	570	542	175	0	34924
29341	828	573	260	33261	0	34922
29342	34391	238	226	571	0	35426
29343	892	161	225	33556	0	34834
29344	772	205	200	34295	0	35472
29345	486	202	33388	1043	0	35119
29346	30851	218	556	753	0	32378
29347	762	33955	552	420	0	35689
29348	798	571	33879	322	0	35570
29349	475	34257	554	297	0	35583
29350	33747	642	563	283	0	35235
29351	861	598	254	33387	0	35100
29352	33778	246	155	669	0	34848
29353	857	33307	175	683	0	35022
29354	34758	570	162	319	0	35809
29355	34956	557	172	265	0	35950
29356	35101	238	191	256	0	35786
29357	35270	141	204	245	0	35860
29358	1322	34204	208	389	0	36123
29359	34030	533	187	243	0	34993
29360	942	546	166	33078	0	34732
29361	823	286	144	32831	0	34084
29362	539	31559	128	964	0	33190
29363	452	31040	130	685	0	32307
29364	386	30570	131	337	0	31424
29365	28516	802	114	204	0	29636
29366	630	26401	107	208	0	27346
29367	451	22933	216	135	0	23735
29368	22656	429	261	149	0	23495
29369	21793	248	66	130	0	22237
29370	506	21769	73	165	0	22513
29371	21605	293	64	115	0	22077
29372	415	221	20605	109	0	21350
29373	19797	118	328	100	0	20343
29374	399	119	20163	114	0	20795
29375	282	18113	198	191	0	18784
29376	159	18224	135	118	0	18636
29377	478	361	43	17568	0	18450
29378	17904	143	62	248	0	18357
29379	18057	63	56	185	0	18361
29380	18489	75	47	91	0	18702
29381	18630	90	46	79	0	18845
29382	18154	85	93	76	0	18408
29383	331	100	17971	78	0	18480
29384	234	89	17558	99	0	17980
29385	17825	78	210	104	0	18217
29386	247	18210	118	104	0	18679
29387	18037	183	132	75	0	18427
29388	18444	145	35	69	0	18693
29389	19264	77	40	79	0	19460
29390	19253	72	45	72	0	19442
29391	19189	86	49	77	0	19401
29392	329	91	19375	80	0	19875
29393	19605	93	136	109	0	19943
29394	19879	74	106	130	0	20189
29395	313	74	20015	126	0	20528
29396	18982	167	154	128	0	19431
29397	19396	140	126	89	0	19751
29398	301	118	20924	86	0	21429
29399	246	102	20754	63	0	21165
29400	179	21161	189	81	0	21610
29401	186	267	188	21052	0	21693
29402	207	154	21277	151	0	21789
29403	21597	121	131	133	0	21982
29404	287	84	96	23173	0	23640
29405	223	89	25096	144	0	25552
29406	24458	65	162	135	0	24820
29407	24928	97	132	63	0	25220
29408	25420	77	76	68	0	25641
29409	298	26168	50	144	0	26660
29410	243	214	52	25934	0	26443
29411	140	26371	51	225	0	26787
29412	26557	194	69	158	0	26978
29413	25989	171	64	81	0	26305
29414	377	94	26265	51	0	26787
29415	251	25729	154	57	0	26191
29416	190	25910	175	37	0	26312
29417	186	273	124	25102	0	25685
29418	169	164	66	25545	0	25944
29419	25598	92	47	219	0	25956
29420	297	25668	25	144	0	26134
29421	268	25803	40	83	0	26194
29422	366	234	25589	50	0	26239
29423	225	26184	147	53	0	26609
29424	26012	168	126	47	0	26353
29425	295	142	25723	34	0	26194
29426	22198	72	156	44	0	22470
29427	217	65	24809	43	0	25134
29428	20726	63	131	80	0	21000
29429	140	25478	82	49	0	25749
29430	26070	141	70	32	0	26313
29431	221	104	27410	18	0	27753
29432	27560	25	162	34	0	27781
29433	27738	32	124	18	0	27912
29434	308	31	28765	8	0	29112
29435	28178	28	159	22	0	28387
29436	28626	38	107	34	0	28805
29437	28181	28	30	29	0	28268
29438	286	28218	35	53	0	28592
29439	29144	164	33	24	0	29365
29440	256	140	30261	21	0	30678
29441	159	31183	161	81	0	31584
29442	31416	183	127	57	0	31783
29443	30554	134	102	31	0	30821
29444	31419	35	38	22	0	31514
29445	327	31666	22	43	0	32058
29446	161	203	24	36889	0	37277
29447	90	141	36748	268	0	37247
29448	49	46	281	36816	0	37192
29449	68	47	38033	331	0	38479
29450	36123	24	356	264	0	36767
29451	330	38470	275	80	0	39155
29452	311	321	62	37721	0	38415
29453	89	38860	46	286	0	39281
29454	83	381	46	38348	0	38858
29455	73	296	40	38291	0	38700
29456	55	40016	39	617	0	40727
29457	74	398	35	39815	0	40322
29458	68	341	41	40926	0	41376
29459	61	41192	45	764	0	42062
29460	70	42468	44	426	0	43008
29461	101	738	22	42758	0	43619
29462	117	431	42602	454	0	43604
29463	149	43114	426	463	0	44152
29464	80	517	365	42879	0	43841
29465	167	617	44160	576	0	45520
29466	96	44672	481	437	0	45686
29467	44547	506	421	125	0	45599
29468	577	437	44235	82	0	45331
29469	43820	150	492	59	0	44521
29470	585	102	427	43581	0	44695
29471	462	101	124	44124	0	44811
29472	159	90	76	45044	0	45369
29473	133	97	44165	960	0	45355
29474	134	101	43831	501	0	44567
29475	40644	112	935	191	0	41882
29476	521	118	498	43529	0	44666
29477	502	99	43848	562	0	45011
29478	42698	141	532	484	0	43855
29479	562	131	446	43184	0	44323
29480	474	147	139	43306	0	44066
29481	178	144	112	43129	0	43563
29482	133	43614	99	1000	0	44846
29483	159	619	89	42140	0	43007
29484	137	42869	102	616	0	43724
29485	151	43547	93	522	0	44313
29486	42746	966	103	201	0	44016
29487	40911	624	149	186	0	41870
29488	42516	208	119	189	0	43032
29489	943	41502	146	212	0	42803
29490	41561	599	143	169	0	42472
29491	40978	517	146	187	0	41828
29492	996	196	148	40135	0	41475
29493	585	199	140	40734	0	41658
29494	261	134	40299	1038	0	41732
29495	149	40519	619	677	0	41964
29496	39546	598	534	298	0	40976
29497	39292	512	243	245	0	40292
29498	925	38585	169	262	0	39941
29499	38531	598	154	264	0	39547
29500	37209	530	178	255	0	38172
29501	975	226	148	36895	0	38244
29502	582	36985	171	686	0	38424
29503	249	37085	132	671	0	38137
29504	35696	942	199	338	0	37175
29505	617	600	121	34636	0	35974
29506	518	275	34408	730	0	35931
29507	33299	220	636	641	0	34796
29508	652	224	35042	382	0	36300
29509	543	33820	614	474	0	35451
29510	33681	646	561	298	0	35186
29511	652	576	33633	359	0	35220
29512	548	346	596	33737	0	35227
29513	319	275	34754	771	0	36119
29514	218	34454	641	854	0	36167
29515	333	660	561	34421	0	35975
29516	253	635	34370	822	0	36080
29517	32631	329	615	694	0	34269
29518	680	34832	500	453	0	36465
29519	614	750	223	33515	0	35102
29520	318	35257	147	831	0	36553
29521	34120	766	211	699	0	35796
29522	33485	670	180	458	0	34793
29523	974	34073	194	498	0	35739
29524	649	762	227	33129	0	34767
29525	290	34427	185	758	0	35660
29526	33761	755	274	699	0	35489
29527	718	642	33657	372	0	35389
29528	713	412	33358	297	0	34780
29529	349	32310	841	383	0	33883
29530	271	32424	579	356	0	33630
29531	322	913	335	30928	0	32498
29532	30313	615	231	648	0	31807
29533	30009	267	409	594	0	31279
29534	29667	206	253	337	0	30463
29535	1007	30652	248	346	0	32253
29536	649	549	262	29554	0	31014
29537	417	30815	224	659	0	32115
29538	30386	559	275	636	0	31856
29539	642	496	227	29694	0	31059
29540	610	232	28559	664	0	30065
29541	319	27935	529	628	0	29411
29542	27321	493	501	333	0	28648
29543	614	494	27382	225	0	28715
29544	26759	262	425	293	0	27739
29545	598	26764	423	306	0	28091
29546	323	21718	102	154	0	22297
29547	20990	507	83	132	0	21712
29548	413	21601	65	141	0	22220
29549	20116	331	103	126	0	20676
29550	336	20154	70	104	0	20664
29551	20046	318	112	103	0	20579
29552	19873	269	62	91	0	20295
29553	467	142	20126	87	0	20822
29554	265	127	19085	61	0	19538
29555	160	19092	314	82	0	19648
29556	18020	298	220	56	0	18594
29557	253	176	17568	57	0	18054
29558	16149	163	189	110	0	16611
29559	217	152	119	15769	0	16257
29560	135	69	16058	114	0	16376
29561	92	52	15314	87	0	15545
29562	71	61	15986	51	0	16169
29563	54	15693	120	41	0	15908
29564	202	814	356	13710	0	15082
29565	13262	42	105	32	0	13441
29566	42	14	7	13416	0	13479
29567	13572	10	12	48	0	13642
29568	47	13	16	13684	0	13760
29569	14019	20	9	47	0	14095
29570	14781	12	20	47	0	14860
29571	17171	21	15	21	0	17228
29572	111	18171	7	88	0	18377
29573	103	71	18889	17	0	19080
29574	38	93	64	18486	0	18681
29575	54	72	113	17440	0	17679
29576	27	23	26	19358	0	19434
29577	28	17	13	19148	0	19206
29578	23	18905	14	194	0	19136
29579	43	95	18928	109	0	19175
29580	23	19195	89	53	0	19360
29581	36	262	116	18248	0	18662
29582	24	115	37	19055	0	19231
29583	26	44	16	19259	0	19345
29584	28	24	22	19297	0	19371
29585	22	19077	19	202	0	19320
29586	30	19252	16	150	0	19448
29587	59	176	19332	50	0	19617
29588	30	118	101	19096	0	19345
29589	22	58	115	18873	0	19068
29590	27	40	41	19717	0	19825
29591	19920	26	17	232	0	20195
29592	112	20194	24	169	0	20499
29593	150	106	20228	54	0	20538
29594	19863	120	96	47	0	20126
29595	115	50	107	20373	0	20645
29596	21242	30	37	130	0	21439
29597	146	89	16	21159	0	21410
29598	21384	33	25	140	0	21582
29599	148	33	18	21378	0	21577
29600	21330	33	25	139	0	21527
29601	162	37	22399	134	0	22732
29602	146	25	107	22048	0	22326
29603	46	23249	127	123	0	23545
29604	55	115	41	23612	0	23823
29605	23415	139	34	157	0	23745
29606	139	23830	38	165	0	24172
29607	145	141	25	24517	0	24828
29608	57	24419	32	180	0	24688
29609	47	171	33	24631	0	24882
29610	33	170	37	24671	0	24911
29611	68	52	24603	296	0	25019
29612	42	37	160	23958	0	24197
29613	71	39	23920	212	0	24242
29614	39	23623	178	234	0	24074
29615	23513	164	160	102	0	23939
29616	186	156	23702	132	0	24176
29617	22687	67	183	72	0	23009
29618	23959	47	164	64	0	24234
29619	327	30	57	24186	0	24600
29620	241	55	25657	212	0	26165
29621	25220	34	213	230	0	25697
29622	26941	28	187	110	0	27266
29623	347	46	63	26394	0	26850
29624	240	40	45	26622	0	26947
29625	79	27371	41	407	0	27898
29626	52	320	32	27123	0	27527
29627	52	27594	40	281	0	27967
29628	109	234	27186	244	0	27773
29629	39	254	177	26550	0	27020
29630	25904	60	182	353	0	26499
29631	25969	46	58	231	0	26304
29632	328	26257	31	128	0	26744
29633	215	193	27	26526	0	26961
29634	26676	194	36	223	0	27129
29635	186	25787	34	237	0	26244
29636	26207	183	24	139	0	26553
29637	218	219	21	26888	0	27346
29638	28457	77	36	270	0	28840
29639	321	45	31370	290	0	32026
29640	266	31694	293	145	0	32398
29641	31538	320	288	105	0	32251
29642	302	32281	104	269	0	32956
29643	32539	368	59	116	0	33082
29644	32824	289	50	99	0	33262
29645	636	103	33102	101	0	33942
29646	404	56	335	32985	0	33780
29647	33965	63	293	418	0	34739
29648	418	52	33806	366	0	34642
29649	33549	62	373	145	0	34129
29650	433	74	306	33651	0	34464
29651	367	73	33621	431	0	34492
29652	128	57	358	33435	0	33978
29653	33036	64	316	468	0	33884
29654	422	96	34608	362	0	35488
29655	373	89	352	34034	0	34848
29656	143	89	343	34642	0	35217
29657	34790	62	99	715	0	35666
29658	34626	64	81	439	0	35210
29659	695	35395	87	175	0	36352
29660	440	365	57	35040	0	35902
29661	198	355	89	34607	0	35249
29662	141	122	79	35167	0	35509
29663	34563	70	82	726	0	35441
29664	33912	96	103	444	0	34555
29665	766	80	56	34395	0	35297
29666	473	34646	75	470	0	35664
29667	215	389	78	34037	0	34719
29668	181	34851	117	449	0	35598
29669	34202	415	106	448	0	35171
29670	490	33523	96	191	0	34300
29671	30953	386	84	111	0	31534
29672	464	359	79	30095	0	30997
29673	30111	110	77	403	0	30701
29674	489	61	30359	355	0	31264
29675	379	30827	368	179	0	31753
29676	30256	352	428	147	0	31183
29677	30505	274	115	172	0	31066
29678	624	114	101	29587	0	30426
29679	400	31034	96	427	0	31957
29680	213	334	77	31892	0	32516
29681	206	264	92	31554	0	32116
29682	180	100	100	31901	0	32281
29683	31753	97	81	690	0	32621
29684	31969	75	104	414	0	32562
29685	700	99	82	32126	0	33007
29686	456	32505	66	548	0	33575
29687	32747	354	81	373	0	33555
29688	516	284	32498	228	0	33526
29689	442	125	344	32582	0	33493
29690	257	116	33235	484	0	34092
29691	199	92	372	32748	0	33411
29692	238	116	33790	629	0	34773
29693	199	93	394	33651	0	34337
29694	33551	111	288	521	0	34471
29695	33716	101	116	425	0	34358
29696	705	32988	101	249	0	34043
29697	33829	414	92	195	0	34530
29698	545	360	98	33166	0	34169
29699	447	186	87	33684	0	34404
29700	33922	143	110	672	0	34847
29701	559	147	33358	456	0	34520
29702	498	145	33279	253	0	34175
29703	307	157	34371	239	0	35074
29704	32717	126	602	247	0	33692
29705	582	112	35278	239	0	36211
29706	505	118	33977	254	0	34854
29707	32717	171	549	230	0	33667
29708	501	35926	335	329	0	37091
29709	427	373	170	36069	0	37039
29710	294	325	114	36782	0	37515
29711	273	131	38026	669	0	39099
29712	37316	102	416	485	0	38319
29713	37922	89	319	334	0	38664
29714	37972	103	184	248	0	38507
29715	728	87	38449	276	0	39540
29716	36724	104	394	274	0	37496
29717	531	105	38169	282	0	39087
29718	436	37063	361	345	0	38205
29719	311	37608	262	308	0	38489
29720	35881	495	131	247	0	36754
29721	441	35257	111	275	0	36084
29722	343	35651	104	305	0	36403
29723	35508	473	143	300	0	36424
29724	449	35614	106	305	0	36474
29725	35770	352	106	272	0	36500
29726	506	275	90	35992	0	36863
29727	392	166	109	36225	0	36892
29728	264	134	77	36588	0	37063
29729	212	155	116	36217	0	36700
29730	229	36549	112	613	0	37503
29731	37085	365	138	370	0	37958
29732	481	40083	123	235	0	40922
29733	393	41068	129	284	0	41874
29734	392	609	42364	173	0	43538
29735	39217	339	509	201	0	40266
29736	704	179	43711	172	0	44766
29737	464	115	45584	145	0	46308
29738	213	45127	681	168	0	46189
29739	98	45316	337	110	0	45861
29740	44818	731	182	73	0	45804
29741	468	48683	81	126	0	49358
29742	490	613	48441	80	0	49624
29743	125	47939	447	136	0	48647
29744	117	463	48575	64	0	49219
29745	97	392	47622	55	0	48166
29746	45020	91	872	77	0	46060
29747	458	55	47322	210	0	48045
29748	385	43	484	46138	0	47050
29749	45944	47	425	401	0	46817
29750	403	46284	114	558	0	47359
29751	401	374	46746	106	0	47627
29752	45240	517	440	63	0	46260
29753	450	121	421	43304	0	44296
29754	394	44492	129	398	0	45413
29755	135	391	45068	375	0	45969
29756	43411	382	445	113	0	44351
29757	457	102	45299	63	0	45921
29758	408	56	499	43964	0	44927
29759	145	56	44432	418	0	45051
29760	86	52	495	43804	0	44437
29761	43217	82	427	460	0	44186
29762	391	44029	152	496	0	45068
29763	44594	396	101	117	0	45208
29764	499	392	44498	53	0	45442
29765	428	111	475	44756	0	45770
29766	139	76	46034	434	0	46683
29767	43777	72	567	420	0	44836
29768	44830	71	474	112	0	45487
29769	826	45301	176	216	0	46519
29770	45876	458	138	51	0	46523
29771	45554	440	130	47	0	46171
29772	860	145	89	45136	0	46230
29773	528	104	45217	489	0	46338
29774	183	44069	553	431	0	45236
29775	136	465	452	44121	0	45174
29776	44154	448	164	462	0	45228
29777	514	148	43964	415	0	45041
29778	511	96	43639	123	0	44369
29779	203	92	43057	112	0	43464
29780	41051	98	937	78	0	42164
29781	553	121	42945	62	0	43681
29782	41293	115	579	66	0	42053
29783	559	94	41485	82	0	42220
29784	481	41085	586	120	0	42272
29785	188	473	545	40591	0	41797
29786	153	472	41116	442	0	42183
29787	116	40275	618	481	0	41490
29788	148	40686	547	140	0	41521
29789	155	809	225	40303	0	41492
29790	39816	524	192	438	0	40970
29791	509	198	174	40168	0	41049
29792	38710	188	183	516	0	39597
29793	573	133	187	39085	0	39978
29794	557	161	38817	521	0	40056
29795	217	166	38368	476	0	39227
29796	37089	162	965	161	0	38377
29797	37680	152	650	128	0	38610
29798	915	136	37735	114	0	38900
29799	36875	172	640	119	0	37806
29800	673	157	37700	158	0	38688
29801	622	35819	674	152	0	37267
29802	292	35553	649	166	0	36660
29803	262	34743	329	169	0	35503
29804	344	972	321	33703	0	35340
29805	33293	609	282	496	0	34680
29806	33284	288	338	473	0	34383
29807	1000	248	304	33189	0	34741
29808	666	222	30938	530	0	32356
29809	393	169	664	30848	0	32074
29810	333	187	30660	570	0	31750
29811	321	181	770	28939	0	30211
29812	28534	136	707	592	0	29969
29813	28741	165	383	548	0	29837
29814	28859	161	325	257	0	29602
29815	28856	162	329	192	0	29539
29816	1207	153	290	27617	0	29267
29817	785	165	312	28149	0	29411
29818	27927	164	276	929	0	29296
29819	28272	165	282	596	0	29315
29820	1046	174	311	27747	0	29278
29821	757	155	293	27938	0	29143
29822	460	151	273	27181	0	28065
29823	392	152	248	27731	0	28523
29824	27051	122	288	996	0	28457
29825	698	132	26470	657	0	27957
29826	660	132	646	25927	0	27365
29827	25718	127	614	607	0	27066
29828	673	129	25626	596	0	27024
29829	658	153	629	25354	0	26794
29830	396	151	25578	613	0	26738
29831	364	23972	629	560	0	25525
29832	391	410	538	20473	0	21812
29833	18971	445	312	431	0	20159
29834	474	439	220	16791	0	17924
29835	477	16606	191	471	0	17745
29836	264	15570	170	404	0	16408
29837	192	12492	118	169	0	12971
29838	147	11529	188	158	0	12022
29839	6585	617	639	419	0	8260
29840	242	283	106	4806	0	5437
29841	87	23	3777	113	0	4000
29842	55	15	92	3298	0	3460
29843	66	16	3268	96	0	3446
29844	3161	89	79	63	0	3392
29845	125	15	44	2966	0	3150
29846	102	15	36	2990	0	3143
29847	68	20	20	3011	0	3119
29848	67	20	16	3067	0	3170
29849	2996	18	26	125	0	3165
29850	3010	19	14	95	0	3138
29851	125	14	17	3014	0	3170
29852	3035	9	24	110	0	3178
29853	88	13	2955	104	0	3160
29854	66	2946	64	88	0	3164
29855	67	54	62	2889	0	3072
29856	46	36	35	2905	0	3022
29857	58	2884	34	114	0	3090
29858	48	53	38	2834	0	2973
29859	39	76	35	2868	0	3018
29860	2840	14	35	120	0	3009
29861	78	19	2809	74	0	2980
29862	64	22	2642	50	0	2778
29863	2390	14	78	49	0	2531
29864	57	18	2107	41	0	2223
29865	639	6	165	13	0	823
29866	495	3	16	8	0	522
29867	21	6	5	409	0	441
29868	6	6	320	14	0	346
29869	203	9	6	4	0	222
29870	3	199	8	14	0	224
29871	109	46	22	5	0	182
29872	76	2	27	3	0	108
29873	37	3	1	6	0	47
29874	0	1	5	1	0	7
29875	0	1	1	5	0	7
29876	0	2	4	1	0	7
29877	2	0	0	5	0	7
29878	5	0	0	1	0	6
29879	5	1	1	1	0	8
29880	4	2	0	1	0	7
29881	5	2	1	0	0	8
29882	1	1	0	4	0	6
29883	1	1	0	5	0	7
29884	6	0	0	2	0	8
29885	4	0	1	2	0	7
29886	0	0	1	7	0	8
29887	1	0	2	3	0	6
29888	2	0	1	4	0	7
29889	1	0	0	3	0	4
29890	6	0	0	2	0	8
29891	0	0	5	1	0	6
29892	0	1	0	6	0	7
29893	6	0	0	2	0	8
29894	2	0	5	1	0	8
29895	1	1	0	6	0	8
29896	1	0	5	2	0	8
29897	1	4	1	1	0	7
29898	1	1	1	2	0	5
29899	2	1	1	1	0	5
