Pos	A	C	G	T	Other	Total
1	0	0	0	0	0	0
2	0	0	0	0	0	0
3	0	0	0	0	0	0
4	0	0	0	0	0	0
5	1	0	0	0	0	1
6	1	0	0	0	0	1
7	0	0	1	0	0	1
8	0	0	1	0	0	1
9	0	0	0	1	0	1
10	0	0	0	1	0	1
11	0	0	0	1	0	1
12	1	0	0	0	0	1
13	0	0	0	3	0	3
14	18	0	0	0	0	18
15	0	25	0	0	0	25
16	0	49	0	0	0	49
17	0	0	0	158	0	158
18	2	0	0	164	0	166
19	0	194	0	0	0	194
20	0	205	0	0	0	205
21	0	250	0	0	0	250
22	256	0	0	5	0	261
23	1	0	275	0	0	276
24	0	1	269	0	0	270
25	0	0	0	306	0	306
26	316	0	0	4	0	320
27	316	0	0	2	0	318
28	0	320	0	0	0	320
29	369	0	0	5	0	374
30	383	0	0	3	0	386
31	396	0	0	3	0	399
32	0	405	0	0	0	405
33	0	409	0	0	0	409
34	417	0	0	2	0	419
35	425	0	1	5	0	431
36	0	443	0	0	0	443
37	0	469	0	1	0	470
38	472	0	0	4	0	476
39	470	0	0	5	0	475
40	0	474	1	0	0	475
41	1	0	0	485	0	486
42	0	0	0	486	0	486
43	1	0	0	482	0	483
44	0	483	0	0	0	483
45	0	0	473	0	0	473
46	438	0	0	2	0	440
47	0	0	0	491	0	491
48	0	493	0	0	0	493
49	0	3	0	498	0	501
50	0	497	0	0	0	497
51	0	0	0	495	0	495
52	0	0	0	499	0	499
53	0	1	500	0	0	501
54	1	0	0	491	0	492
55	499	0	0	2	0	501
56	0	0	495	0	0	495
57	482	0	1	0	0	483
58	1	0	0	505	0	506
59	0	500	0	0	0	500
60	0	0	0	506	0	506
61	0	0	500	0	0	500
62	0	0	0	494	0	494
63	1	0	0	506	0	507
64	0	512	0	0	0	512
65	1	0	0	518	0	519
66	0	512	0	0	0	512
67	0	0	0	510	0	510
68	509	0	1	3	0	513
69	506	0	0	0	0	506
70	508	0	0	2	0	510
71	0	509	0	0	0	509
72	0	1	492	0	0	493
73	475	0	0	2	0	477
74	499	0	0	0	0	499
75	0	510	2	2	0	514
76	0	0	0	447	0	447
77	2	0	0	434	0	436
78	0	0	0	413	0	413
79	430	0	0	1	0	431
80	414	0	0	3	0	417
81	420	0	0	0	0	420
82	418	0	1	3	0	422
83	1	0	0	416	0	417
84	0	413	0	0	0	413
85	0	1	0	419	0	420
86	0	0	413	0	0	413
87	3	0	0	434	0	437
88	0	0	446	2	0	448
89	1	1	2	442	0	446
90	1	0	472	2	0	475
91	0	0	466	1	0	467
92	0	486	3	1	0	490
93	2	4	0	498	0	504
94	1	1	512	2	0	516
95	3	0	2	497	0	502
96	2	503	2	3	0	510
97	514	2	0	5	0	521
98	3	525	0	1	0	529
99	4	12	0	515	0	531
100	1	543	1	2	0	547
101	2	4	524	1	0	531
102	1	0	519	3	0	523
103	0	530	4	0	0	534
104	1	2	8	535	0	546
105	0	9	541	2	0	552
106	1	536	3	9	0	549
107	533	3	9	4	0	549
108	3	1	1	551	0	556
109	1	9	559	2	0	571
110	7	558	5	3	0	573
111	0	10	3	555	0	568
112	1	2	0	559	0	562
113	546	9	1	7	0	563
114	3	0	551	3	0	557
115	2	4	9	546	0	561
116	2	9	537	3	0	551
117	0	460	3	10	0	473
118	452	3	9	3	0	467
119	2	461	2	2	0	467
120	9	3	2	451	0	465
121	1	426	1	10	0	438
122	414	2	8	5	0	429
123	5	423	1	2	0	431
124	2	4	404	9	0	419
125	0	404	5	10	0	419
126	396	6	4	4	0	410
127	5	2	413	3	0	423
128	4	1	7	410	0	422
129	374	1	11	7	0	393
130	7	9	0	372	0	388
131	394	1	2	8	0	405
132	389	9	2	5	0	405
133	7	2	1	390	0	400
134	1	11	0	395	0	407
135	388	0	2	8	0	398
136	373	11	1	2	0	387
137	9	1	7	360	0	377
138	359	12	0	8	0	379
139	366	0	3	8	0	377
140	9	362	8	0	0	379
141	6	5	1	383	0	395
142	375	4	2	8	0	389
143	388	0	3	10	0	401
144	17	2	1	377	0	397
145	13	0	0	385	0	398
146	377	0	1	17	0	395
147	7	382	1	10	0	400
148	13	6	0	376	0	395
149	9	1	380	9	0	399
150	3	0	4	378	0	385
151	10	385	0	4	0	399
152	9	3	393	6	0	411
153	6	7	6	380	0	399
154	6	1	1	372	0	380
155	9	3	383	5	0	400
156	363	1	4	6	0	374
157	6	391	5	9	0	411
158	392	4	1	10	0	407
159	14	4	391	2	0	411
160	4	9	399	2	0	414
161	385	1	6	12	0	404
162	5	406	10	4	0	425
163	400	4	1	13	0	418
164	6	405	3	1	0	415
165	3	5	407	3	0	418
166	389	5	5	12	0	411
167	9	2	401	9	0	421
168	1	2	15	393	0	411
169	397	0	3	10	0	410
170	389	8	1	4	0	402
171	13	386	0	2	0	401
172	5	8	8	381	0	402
173	4	390	8	5	0	407
174	10	5	393	2	0	410
175	2	13	6	365	0	386
176	9	356	3	5	0	373
177	3	11	2	355	0	371
178	335	3	7	12	0	357
179	12	3	0	339	0	354
180	3	337	9	5	0	354
181	2	6	0	349	0	357
182	5	2	2	346	0	355
183	8	337	4	7	0	356
184	2	12	1	347	0	362
185	2	4	346	14	0	366
186	4	361	4	5	0	374
187	313	2	8	2	0	325
188	3	3	327	9	0	342
189	3	7	307	3	0	320
190	1	298	3	10	0	312
191	6	5	0	271	0	282
192	3	1	280	4	0	288
193	1	243	7	2	0	253
194	5	3	1	261	0	270
195	3	1	1	264	0	269
196	260	1	1	6	0	268
197	6	260	3	1	0	270
198	3	4	248	1	0	256
199	2	1	257	2	0	262
200	1	0	5	241	0	247
201	1	2	1	273	0	277
202	3	2	1	272	0	278
203	1	312	4	6	0	323
204	1	6	320	5	0	332
205	3	6	6	327	0	342
206	1	325	8	9	0	343
207	2	347	1	7	0	357
208	0	16	386	1	0	403
209	6	5	10	384	0	405
210	0	1	419	13	0	433
211	2	3	12	410	0	427
212	1	1	7	418	0	427
213	1	2	420	17	0	440
214	2	409	9	10	0	430
215	398	11	8	4	0	421
216	10	7	417	1	0	435
217	9	398	11	2	0	420
218	1	417	8	1	0	427
219	4	17	392	3	0	416
220	391	9	13	2	0	415
221	13	3	12	341	0	369
222	8	386	2	8	0	404
223	392	12	2	6	0	412
224	12	7	3	382	0	404
225	9	384	2	11	0	406
226	391	14	4	9	0	418
227	10	9	380	2	0	401
228	10	382	11	4	0	407
229	371	11	9	4	0	395
230	8	382	3	1	0	394
231	355	12	2	5	0	374
232	11	6	5	338	0	360
233	8	338	4	11	0	361
234	4	9	0	357	0	370
235	345	10	4	13	0	372
236	12	3	337	8	0	360
237	7	3	353	4	0	367
238	4	3	17	339	0	363
239	3	4	10	351	0	368
240	5	5	3	340	0	353
241	1	335	5	16	0	357
242	6	10	329	9	0	354
243	6	10	10	318	0	344
244	3	328	5	13	0	349
245	5	343	1	13	0	362
246	2	16	349	5	0	372
247	1	14	346	3	0	364
248	8	3	353	1	0	365
249	3	3	23	339	0	368
250	2	9	348	11	0	370
251	5	5	13	350	0	373
252	2	4	347	14	0	367
253	330	5	11	10	0	356
254	11	346	10	6	0	373
255	7	373	6	2	0	388
256	5	20	390	7	0	422
257	383	10	15	6	0	414
258	402	9	9	4	0	424
259	401	2	6	8	0	417
260	19	4	388	3	0	414
261	9	7	389	4	0	409
262	8	1	20	377	0	406
263	384	6	9	17	0	416
264	403	5	4	8	0	420
265	17	3	392	8	0	420
266	393	6	15	1	0	415
267	18	8	10	386	0	422
268	12	5	396	13	0	426
269	5	4	406	8	0	423
270	372	3	25	8	0	408
271	15	4	400	7	0	426
272	393	6	16	10	0	425
273	18	3	397	8	0	426
274	7	380	25	5	0	417
275	7	400	14	5	0	426
276	8	19	6	386	0	419
277	9	14	7	401	0	431
278	8	9	397	18	0	432
279	10	6	20	382	0	418
280	5	376	19	14	0	414
281	10	389	10	12	0	421
282	9	396	5	9	0	419
283	8	21	14	386	0	429
284	8	8	391	19	0	426
285	8	5	401	12	0	426
286	9	6	23	381	0	419
287	8	7	13	388	0	416
288	8	9	10	355	0	382
289	9	373	7	22	0	411
290	384	12	9	11	0	416
291	386	11	9	5	0	411
292	24	387	3	6	0	420
293	11	18	401	2	0	432
294	399	15	20	2	0	436
295	17	6	405	9	0	437
296	399	6	17	7	0	429
297	405	6	13	6	0	430
298	403	3	11	8	0	425
299	386	4	4	9	0	403
300	20	391	7	11	0	429
301	341	15	7	7	0	370
302	16	347	7	6	0	376
303	299	12	7	3	0	321
304	14	296	3	2	0	315
305	4	7	267	4	0	282
306	4	36	10	215	0	265
307	2	257	7	6	0	272
308	3	222	4	1	0	230
309	209	5	3	5	0	222
310	185	1	4	1	0	191
311	6	187	1	3	0	197
312	4	7	2	186	0	199
313	3	205	3	4	0	215
314	207	4	4	1	0	216
315	9	4	204	0	0	217
316	7	2	5	189	0	203
317	6	1	1	202	0	210
318	2	2	6	205	0	215
319	3	3	202	4	0	212
320	3	200	5	2	0	210
321	6	207	0	2	0	215
322	6	3	1	215	0	225
323	2	4	219	2	0	227
324	7	1	3	217	0	228
325	5	4	2	218	0	229
326	2	5	4	210	0	221
327	3	2	4	212	0	221
328	211	1	3	4	0	219
329	5	210	4	2	0	221
330	212	4	4	3	0	223
331	3	3	213	5	0	224
332	4	5	207	3	0	219
333	5	3	3	205	0	216
334	0	4	3	207	0	214
335	5	208	1	5	0	219
336	1	5	207	4	0	217
337	3	205	5	3	0	216
338	0	9	206	0	0	215
339	198	6	3	4	0	211
340	1	211	2	5	0	219
341	3	3	206	4	0	216
342	3	1	10	200	0	214
343	3	1	203	4	0	211
344	1	196	2	6	0	205
345	2	5	0	200	0	207
346	2	196	2	7	0	207
347	2	8	195	1	0	206
348	8	1	2	193	0	204
349	197	3	2	4	0	206
350	2	197	4	2	0	205
351	2	3	191	2	0	198
352	8	7	3	176	0	194
353	2	2	186	2	0	192
354	5	2	166	0	0	173
355	2	150	2	0	0	154
356	1	1	2	113	0	117
357	2	0	2	115	0	119
358	2	1	0	114	0	117
359	1	1	115	1	0	118
360	0	1	122	1	0	124
361	124	0	0	3	0	127
362	1	1	125	0	0	127
363	112	1	0	1	0	114
364	1	116	0	0	0	117
365	0	0	1	117	0	118
366	0	133	1	0	0	134
367	0	137	0	1	0	138
368	0	0	133	0	0	133
369	0	1	0	131	0	132
370	0	0	130	0	0	130
371	0	1	127	0	0	128
372	128	0	1	0	0	129
373	1	0	135	0	0	136
374	0	1	124	0	0	125
375	128	0	1	0	0	129
376	0	0	132	1	0	133
377	0	0	139	1	0	140
378	0	0	0	127	0	127
379	0	134	1	0	0	135
380	1	0	0	137	0	138
381	0	0	1	134	0	135
382	139	0	1	1	0	141
383	0	0	0	132	0	132
384	0	141	0	1	0	142
385	136	0	1	0	0	137
386	0	0	138	0	0	138
387	139	1	0	0	0	140
388	1	0	146	1	0	148
389	0	0	144	0	0	144
390	0	148	0	1	0	149
391	149	1	0	1	0	151
392	2	148	0	1	0	151
393	0	1	146	0	0	147
394	2	0	2	138	0	142
395	0	148	0	2	0	150
396	145	2	0	1	0	148
397	149	0	1	0	0	150
398	2	144	1	0	0	147
399	145	2	0	1	0	148
400	3	0	0	139	0	142
401	0	144	0	3	0	147
402	0	3	1	145	0	149
403	0	1	0	158	0	159
404	164	0	1	3	0	168
405	166	0	0	0	0	166
406	164	1	0	0	0	165
407	3	0	163	0	0	166
408	163	0	3	2	0	168
409	4	6	1	168	0	179
410	0	1	168	3	0	172
411	0	0	164	1	0	165
412	0	166	3	0	0	169
413	153	2	0	0	0	155
414	3	154	0	0	0	157
415	0	3	0	154	0	157
416	0	0	0	157	0	157
417	0	0	166	3	0	169
418	0	0	3	151	0	154
419	0	0	164	4	0	168
420	1	0	161	0	0	162
421	0	174	4	0	0	178
422	1	4	0	166	0	171
423	1	0	0	168	0	169
424	164	1	0	3	0	168
425	2	0	163	1	0	166
426	0	0	3	170	0	173
427	169	0	1	4	0	174
428	3	0	169	1	0	173
429	162	0	4	0	0	166
430	174	0	1	1	0	176
431	3	1	190	0	0	194
432	0	0	3	191	0	194
433	1	0	0	192	0	193
434	2	0	195	3	0	200
435	186	0	4	0	0	190
436	212	0	0	1	0	213
437	211	0	0	0	0	211
438	216	0	1	0	0	217
439	220	0	0	1	0	221
440	4	1	216	0	0	221
441	0	1	231	0	0	232
442	0	234	3	2	0	239
443	0	3	229	1	0	233
444	0	0	3	233	0	236
445	3	1	1	165	0	170
446	1	0	0	243	0	244
447	1	0	0	241	0	242
448	2	0	242	3	0	247
449	2	238	5	1	0	246
450	0	250	1	0	0	251
451	1	4	1	247	0	253
452	0	253	0	3	0	256
453	252	4	1	0	0	257
454	249	0	0	4	0	253
455	4	258	0	1	0	263
456	0	4	0	258	0	262
457	0	0	0	267	0	267
458	0	0	264	4	0	268
459	252	1	3	0	0	256
460	259	1	0	1	0	261
461	4	262	0	1	0	267
462	267	5	0	0	0	272
463	5	0	281	0	0	286
464	1	271	4	0	0	276
465	0	277	0	0	0	277
466	0	277	0	1	0	278
467	1	4	0	275	0	280
468	278	0	1	6	0	285
469	5	0	0	283	0	288
470	2	0	281	4	0	287
471	1	1	4	277	0	283
472	1	0	289	4	0	294
473	2	0	5	275	0	282
474	1	1	0	280	0	282
475	1	292	2	3	0	298
476	298	5	2	1	0	306
477	5	1	0	290	0	296
478	2	288	0	4	0	294
479	292	5	1	2	0	300
480	268	0	2	5	0	275
481	287	1	0	4	0	292
482	5	289	2	0	0	296
483	1	5	290	2	0	298
484	0	0	5	297	0	302
485	1	1	1	296	0	299
486	1	298	1	4	0	304
487	1	3	285	2	0	291
488	0	1	287	1	0	289
489	291	0	4	1	0	296
490	5	1	1	297	0	304
491	1	0	302	5	0	308
492	2	299	3	1	0	305
493	2	3	2	294	0	301
494	1	304	2	3	0	310
495	2	4	318	2	0	326
496	299	1	4	2	0	306
497	318	1	2	2	0	323
498	4	323	2	1	0	330
499	3	2	1	321	0	327
500	2	0	323	2	0	327
501	1	325	3	2	0	331
502	321	4	1	2	0	328
503	5	307	2	2	0	316
504	0	312	1	0	0	313
505	1	4	1	307	0	313
506	1	306	1	5	0	313
507	306	5	0	0	0	311
508	5	1	0	303	0	309
509	0	1	288	4	0	293
510	1	1	287	0	0	289
511	1	0	3	286	0	290
512	1	290	1	4	0	296
513	289	3	0	1	0	293
514	4	2	0	286	0	292
515	0	3	289	4	0	296
516	2	0	3	285	0	290
517	1	1	0	289	0	291
518	282	1	1	7	0	291
519	5	0	1	280	0	286
520	0	0	283	5	0	288
521	2	0	257	1	0	260
522	2	0	4	265	0	271
523	0	2	1	269	0	272
524	1	1	277	4	0	283
525	248	0	4	4	0	256
526	4	1	272	1	0	278
527	1	282	6	1	0	290
528	4	4	0	293	0	301
529	2	1	298	3	0	304
530	1	2	292	1	0	296
531	0	1	6	265	0	272
532	282	1	3	9	0	295
533	5	2	293	1	0	301
534	1	298	3	2	0	304
535	297	3	2	6	0	308
536	6	1	292	1	0	300
537	285	1	6	2	0	294
538	289	2	1	1	0	293
539	5	282	2	2	0	291
540	1	5	2	260	0	268
541	2	273	2	3	0	280
542	0	5	268	3	0	276
543	261	3	4	2	0	270
544	275	3	1	1	0	280
545	6	2	268	1	0	277
546	3	1	276	1	0	281
547	2	297	8	0	0	307
548	295	5	2	2	0	304
549	8	0	1	292	0	301
550	0	3	0	283	0	286
551	1	291	3	4	0	299
552	285	5	2	3	0	295
553	4	0	295	2	0	301
554	2	2	4	306	0	314
555	326	0	1	8	0	335
556	5	333	5	0	0	343
557	2	6	366	1	0	375
558	1	1	375	2	0	379
559	2	11	9	337	0	359
560	0	355	4	10	0	369
561	1	9	370	1	0	381
562	3	2	11	353	0	369
563	356	2	0	14	0	372
564	13	0	378	2	0	393
565	0	0	14	378	0	392
566	2	4	381	14	0	401
567	2	1	400	0	0	403
568	2	5	15	382	0	404
569	1	0	396	15	0	412
570	338	0	15	2	0	355
571	14	2	387	1	0	404
572	366	0	18	4	0	388
573	15	377	2	1	0	395
574	383	13	1	2	0	399
575	14	402	2	0	0	418
576	1	15	1	416	0	433
577	3	0	1	436	0	440
578	1	1	433	14	0	449
579	1	0	439	2	0	442
580	1	0	15	437	0	453
581	1	1	439	14	0	455
582	3	0	15	410	0	428
583	1	415	0	16	0	432
584	0	442	3	1	0	446
585	3	15	0	435	0	453
586	2	3	1	446	0	452
587	2	1	436	12	0	451
588	4	3	12	408	0	427
589	3	416	1	13	0	433
590	0	421	1	1	0	423
591	0	431	1	2	0	434
592	1	13	2	404	0	420
593	1	410	2	11	0	424
594	412	14	3	1	0	430
595	15	1	1	399	0	416
596	2	1	397	14	0	414
597	3	1	14	391	0	409
598	0	1	400	14	0	415
599	1	3	393	2	0	399
600	0	3	393	2	0	398
601	0	387	14	3	0	404
602	1	10	402	0	0	413
603	395	1	13	2	0	411
604	412	0	0	3	0	415
605	417	1	2	1	0	421
606	15	2	1	404	0	422
607	397	3	4	14	0	418
608	14	395	5	0	0	414
609	2	414	1	3	0	420
610	402	11	3	7	0	423
611	13	3	406	3	0	425
612	4	2	13	408	0	427
613	2	2	428	12	0	444
614	1	1	423	4	0	429
615	4	418	16	2	0	440
616	4	15	3	395	0	417
617	1	1	9	433	0	444
618	418	3	2	15	0	438
619	13	419	5	3	0	440
620	3	436	6	1	0	446
621	2	11	411	7	0	431
622	2	419	15	6	0	442
623	407	16	7	4	0	434
624	416	4	4	5	0	429
625	14	7	424	5	0	450
626	1	1	435	6	0	443
627	2	2	18	392	0	414
628	5	1	9	390	0	405
629	2	392	8	13	0	415
630	9	13	5	384	0	411
631	6	3	5	392	0	406
632	6	383	6	13	0	408
633	4	14	6	381	0	405
634	4	5	6	370	0	385
635	3	370	8	15	0	396
636	2	12	368	8	0	390
637	6	4	16	369	0	395
638	373	2	6	19	0	400
639	386	5	7	4	0	402
640	16	2	376	3	0	397
641	358	4	17	5	0	384
642	369	3	1	12	0	385
643	16	357	7	2	0	382
644	5	15	354	5	0	379
645	3	2	351	11	0	367
646	5	1	14	349	0	369
647	344	2	7	15	0	368
648	374	3	5	7	0	389
649	15	3	6	403	0	427
650	432	4	5	15	0	456
651	448	3	1	5	0	457
652	426	7	4	8	0	445
653	18	3	418	4	0	443
654	4	3	412	7	0	426
655	391	4	16	5	0	416
656	14	3	394	4	0	415
657	0	363	11	1	0	375
658	1	10	2	369	0	382
659	2	0	371	8	0	381
660	2	2	373	0	0	377
661	2	11	8	348	0	369
662	2	0	363	8	0	373
663	0	1	365	2	0	368
664	3	322	7	1	0	333
665	4	346	1	1	0	352
666	351	5	3	1	0	360
667	5	2	2	332	0	341
668	330	1	0	14	0	345
669	7	0	329	0	0	336
670	3	1	8	327	0	339
671	6	1	1	338	0	346
672	337	0	2	7	0	346
673	5	342	3	1	0	351
674	1	5	317	3	0	326
675	3	1	318	2	0	324
676	4	311	7	0	0	322
677	1	5	313	3	0	322
678	2	313	7	2	0	324
679	2	308	1	1	0	312
680	4	5	300	2	0	311
681	293	2	7	2	0	304
682	7	1	2	301	0	311
683	2	301	2	7	0	312
684	2	5	3	306	0	316
685	307	1	1	7	0	316
686	311	3	0	2	0	316
687	308	2	2	5	0	317
688	8	2	310	0	0	320
689	1	2	6	298	0	307
690	2	310	2	4	0	318
691	316	5	4	3	0	328
692	5	3	0	323	0	331
693	0	4	0	321	0	325
694	4	2	1	331	0	338
695	2	2	326	7	0	337
696	295	0	7	1	0	303
697	7	319	3	1	0	330
698	1	7	2	324	0	334
699	4	1	2	323	0	330
700	318	4	0	7	0	329
701	8	3	303	2	0	316
702	1	0	322	2	0	325
703	3	315	7	3	0	328
704	1	6	329	3	0	339
705	302	2	7	1	0	312
706	5	332	1	5	0	343
707	5	7	334	1	0	347
708	324	0	7	5	0	336
709	10	1	337	3	0	351
710	3	331	8	4	0	346
711	3	7	4	333	0	347
712	5	1	3	340	0	349
713	4	4	334	6	0	348
714	2	2	318	4	0	326
715	3	331	7	5	0	346
716	327	6	5	4	0	342
717	4	340	5	1	0	350
718	3	9	3	336	0	351
719	4	3	337	6	0	350
720	305	3	7	4	0	319
721	7	1	2	328	0	338
722	3	317	2	7	0	329
723	2	334	9	0	0	345
724	2	6	3	336	0	347
725	1	8	1	333	0	343
726	327	3	4	7	0	341
727	6	1	1	339	0	347
728	2	1	335	10	0	348
729	334	1	10	0	0	345
730	340	1	2	3	0	346
731	5	3	337	4	0	349
732	324	3	7	2	0	336
733	11	4	1	338	0	354
734	4	2	3	347	0	356
735	3	1	4	344	0	352
736	9	3	1	321	0	334
737	1	333	4	8	0	346
738	341	9	3	4	0	357
739	350	5	1	4	0	360
740	10	2	350	4	0	366
741	348	1	9	4	0	362
742	404	0	4	2	0	410
743	408	2	2	2	0	414
744	418	2	2	2	0	424
745	17	406	2	2	0	427
746	10	11	0	392	0	413
747	4	6	397	10	0	417
748	3	1	346	12	0	362
749	284	7	14	3	0	308
750	294	3	5	0	0	302
751	6	285	2	2	0	295
752	299	6	0	0	0	305
753	5	306	1	1	0	313
754	5	6	3	311	0	325
755	327	4	2	6	0	339
756	325	1	1	4	0	331
757	327	1	0	4	0	332
758	9	321	0	1	0	331
759	335	4	0	4	0	343
760	6	6	1	340	0	353
761	345	1	1	11	0	358
762	7	2	328	5	0	342
763	6	330	6	2	0	344
764	346	5	4	0	0	355
765	8	5	328	0	0	341
766	8	2	4	326	0	340
767	3	2	348	7	0	360
768	4	2	350	6	0	362
769	3	0	12	340	0	355
770	2	3	354	6	0	365
771	2	2	7	346	0	357
772	7	1	4	343	0	355
773	345	2	2	13	0	362
774	10	337	4	4	0	355
775	2	365	2	2	0	371
776	0	382	2	3	0	387
777	3	13	370	0	0	386
778	5	6	8	363	0	382
779	3	2	373	9	0	387
780	348	2	8	6	0	364
781	372	3	8	5	0	388
782	9	374	2	2	0	387
783	12	9	3	362	0	386
784	3	388	3	7	0	401
785	388	8	1	9	0	406
786	9	6	3	389	0	407
787	10	1	395	7	0	413
788	2	374	7	9	0	392
789	6	9	383	3	0	401
790	8	5	9	374	0	396
791	2	3	389	10	0	404
792	360	0	11	9	0	380
793	9	6	393	3	0	411
794	9	398	7	3	0	417
795	5	8	9	397	0	419
796	3	7	8	406	0	424
797	396	4	2	17	0	419
798	391	2	9	8	0	410
799	13	396	3	5	0	417
800	8	8	392	4	0	412
801	5	9	376	4	0	394
802	379	2	14	5	0	400
803	11	3	395	6	0	415
804	9	4	382	2	0	397
805	6	5	387	4	0	402
806	7	3	383	2	0	395
807	5	378	13	2	0	398
808	374	8	12	5	0	399
809	11	8	5	374	0	398
810	386	4	5	5	0	400
811	17	375	4	6	0	402
812	374	9	5	7	0	395
813	9	380	7	4	0	400
814	7	12	6	366	0	391
815	7	379	7	7	0	400
816	3	10	381	7	0	401
817	6	372	14	5	0	397
818	7	10	10	411	0	438
819	415	9	8	10	0	442
820	9	7	3	420	0	439
821	11	4	417	15	0	447
822	8	4	11	404	0	427
823	9	413	12	9	0	443
824	5	15	419	2	0	441
825	420	12	11	3	0	446
826	13	7	8	421	0	449
827	426	1	3	12	0	442
828	413	4	4	13	0	434
829	17	413	6	4	0	440
830	407	13	8	3	0	431
831	412	10	2	8	0	432
832	16	423	5	2	0	446
833	12	9	4	416	0	441
834	7	9	4	413	0	433
835	1	423	7	16	0	447
836	7	9	4	434	0	454
837	2	10	427	12	0	451
838	8	4	12	416	0	440
839	4	3	423	15	0	445
840	2	4	391	9	0	406
841	5	383	13	3	0	404
842	3	353	7	4	0	367
843	4	367	2	3	0	376
844	4	9	0	352	0	365
845	2	3	349	7	0	361
846	339	3	6	8	0	356
847	8	0	5	366	0	379
848	4	2	376	7	0	389
849	2	3	373	5	0	383
850	2	388	9	1	0	400
851	2	7	4	388	0	401
852	385	4	2	11	0	402
853	5	383	2	4	0	394
854	5	380	1	0	0	386
855	0	365	3	3	0	371
856	4	7	10	351	0	372
857	2	367	2	6	0	377
858	1	6	0	385	0	392
859	3	4	1	386	0	394
860	1	1	375	9	0	386
861	340	2	6	5	0	353
862	8	3	400	1	0	412
863	7	1	8	404	0	420
864	0	1	407	10	0	418
865	1	402	7	2	0	412
866	407	8	4	5	0	424
867	10	2	1	388	0	401
868	3	2	1	410	0	416
869	400	0	0	12	0	412
870	398	0	1	7	0	406
871	416	1	1	5	0	423
872	11	1	403	0	0	415
873	385	1	7	1	0	394
874	9	408	1	2	0	420
875	2	393	2	0	0	397
876	1	9	1	380	0	391
877	3	3	0	375	0	381
878	2	378	1	9	0	390
879	6	8	0	380	0	394
880	376	3	0	8	0	387
881	10	3	379	2	0	394
882	2	375	4	1	0	382
883	364	11	2	2	0	379
884	8	368	0	3	0	379
885	1	7	366	2	0	376
886	0	3	8	360	0	371
887	0	0	370	10	0	380
888	2	359	7	2	0	370
889	0	10	4	366	0	380
890	2	4	360	8	0	374
891	1	1	365	0	0	367
892	0	2	8	377	0	387
893	360	0	3	8	0	371
894	361	1	0	5	0	367
895	363	0	1	2	0	366
896	9	1	371	1	0	382
897	2	368	7	2	0	379
898	3	7	2	366	0	378
899	1	1	2	372	0	376
900	3	374	0	7	0	384
901	372	9	1	5	0	387
902	10	2	0	375	0	387
903	2	2	383	9	0	396
904	0	386	7	3	0	396
905	375	9	1	3	0	388
906	7	386	0	4	0	397
907	2	7	2	381	0	392
908	5	1	1	386	0	393
909	4	1	2	383	0	390
910	0	1	378	10	0	389
911	2	2	8	370	0	382
912	1	374	2	7	0	384
913	2	367	0	3	0	372
914	1	8	351	2	0	362
915	330	3	6	7	0	346
916	345	2	3	4	0	354
917	9	343	1	2	0	355
918	306	6	1	1	0	314
919	305	0	4	3	0	312
920	9	304	1	1	0	315
921	4	9	0	300	0	313
922	3	2	308	7	0	320
923	3	0	298	2	0	303
924	300	3	8	3	0	314
925	9	311	1	1	0	322
926	0	11	0	321	0	332
927	2	2	0	326	0	330
928	2	1	2	324	0	329
929	312	3	0	14	0	329
930	13	1	2	315	0	331
931	0	4	1	322	0	327
932	2	1	306	6	0	315
933	274	1	9	6	0	290
934	7	295	2	1	0	305
935	295	9	1	1	0	306
936	8	286	1	4	0	299
937	1	6	3	283	0	293
938	286	1	2	9	0	298
939	289	1	3	6	0	299
940	9	1	285	0	0	295
941	291	1	7	2	0	301
942	9	1	289	3	0	302
943	3	0	287	1	0	291
944	2	3	291	2	0	298
945	3	0	317	4	0	324
946	3	1	8	312	0	324
947	3	3	305	8	0	319
948	6	2	9	292	0	309
949	293	3	0	14	0	310
950	8	2	2	293	0	305
951	279	2	2	11	0	294
952	9	281	1	1	0	292
953	3	10	1	285	0	299
954	1	2	280	11	0	294
955	2	293	7	4	0	306
956	2	10	4	289	0	305
957	1	0	295	9	0	305
958	0	270	7	2	0	279
959	2	289	1	1	0	293
960	1	7	279	2	0	289
961	4	7	12	246	0	269
962	1	0	252	6	0	259
963	232	0	5	0	0	237
964	257	0	2	2	0	261
965	7	251	0	0	0	258
966	251	7	1	0	0	259
967	5	1	1	249	0	256
968	0	0	246	5	0	251
969	235	1	6	0	0	242
970	5	0	238	2	0	245
971	1	232	7	0	0	240
972	239	6	2	1	0	248
973	7	2	0	238	0	247
974	1	0	242	4	0	247
975	243	0	4	3	0	250
976	243	1	3	2	0	249
977	248	1	1	2	0	252
978	7	0	3	242	0	252
979	0	4	1	249	0	254
980	3	0	252	8	0	263
981	1	248	9	1	0	259
982	5	7	2	250	0	264
983	6	1	1	261	0	269
984	1	0	260	6	0	267
985	3	2	262	1	0	268
986	2	2	7	253	0	264
987	241	1	1	8	0	251
988	7	255	5	3	0	270
989	260	8	3	3	0	274
990	7	268	1	3	0	279
991	2	6	265	5	0	278
992	1	3	264	2	0	270
993	252	3	4	5	0	264
994	298	0	5	4	0	307
995	8	308	5	3	0	324
996	5	7	299	1	0	312
997	6	3	8	295	0	312
998	1	4	5	293	0	303
999	4	303	7	7	0	321
1000	6	12	1	314	0	333
1001	6	3	324	9	0	342
1002	310	2	10	9	0	331
1003	324	3	4	4	0	335
1004	316	2	5	1	0	324
1005	329	3	3	5	0	340
1006	13	2	310	4	0	329
1007	318	3	8	3	0	332
1008	13	2	309	5	0	329
1009	4	313	13	2	0	332
1010	7	8	4	315	0	334
1011	314	5	8	11	0	338
1012	15	3	5	322	0	345
1013	8	2	319	15	0	344
1014	319	1	12	7	0	339
1015	340	2	8	3	0	353
1016	21	2	5	326	0	354
1017	8	4	0	344	0	356
1018	7	0	334	12	0	353
1019	3	328	11	9	0	351
1020	329	8	7	7	0	351
1021	13	4	322	3	0	342
1022	313	6	8	5	0	332
1023	9	329	7	3	0	348
1024	319	6	1	7	0	333
1025	9	304	8	5	0	326
1026	3	316	8	2	0	329
1027	12	9	0	309	0	330
1028	7	5	3	320	0	335
1029	9	7	3	318	0	337
1030	9	1	3	326	0	339
1031	2	5	319	13	0	339
1032	314	1	12	6	0	333
1033	319	8	5	3	0	335
1034	330	3	1	6	0	340
1035	15	3	2	318	0	338
1036	7	6	5	318	0	336
1037	323	0	10	12	0	345
1038	326	0	2	12	0	340
1039	330	1	2	7	0	340
1040	13	7	3	312	0	335
1041	8	2	3	308	0	321
1042	7	2	301	10	0	320
1043	7	0	294	5	0	306
1044	9	293	7	4	0	313
1045	269	5	5	5	0	284
1046	268	3	1	5	0	277
1047	269	2	4	1	0	276
1048	11	2	266	3	0	282
1049	263	3	9	4	0	279
1050	264	2	5	5	0	276
1051	275	2	2	5	0	284
1052	13	1	1	268	0	283
1053	8	2	5	267	0	282
1054	7	2	6	260	0	275
1055	8	1	227	9	0	245
1056	233	0	4	5	0	242
1057	9	236	3	4	0	252
1058	222	3	2	5	0	232
1059	6	221	1	2	0	230
1060	6	223	2	0	0	231
1061	6	10	0	214	0	230
1062	4	5	0	207	0	216
1063	4	214	1	10	0	229
1064	200	4	1	6	0	211
1065	198	3	2	4	0	207
1066	8	3	1	200	0	212
1067	5	3	206	4	0	218
1068	6	1	199	5	0	211
1069	3	2	206	4	0	215
1070	3	2	206	2	0	213
1071	190	3	12	5	0	210
1072	202	1	4	3	0	210
1073	10	1	2	195	0	208
1074	7	0	202	4	0	213
1075	7	0	4	201	0	212
1076	2	205	3	7	0	217
1077	3	225	2	5	0	235
1078	230	6	2	3	0	241
1079	230	3	2	0	0	235
1080	225	1	1	2	0	229
1081	6	1	1	218	0	226
1082	4	2	0	222	0	228
1083	3	0	1	227	0	231
1084	1	0	5	223	0	229
1085	3	2	221	7	0	233
1086	4	1	3	220	0	228
1087	236	2	2	6	0	246
1088	7	0	0	232	0	239
1089	3	0	2	230	0	235
1090	4	0	3	218	0	225
1091	3	209	3	6	0	221
1092	5	209	0	2	0	216
1093	2	234	0	4	0	240
1094	5	1	0	185	0	191
1095	1	0	1	180	0	182
1096	180	0	2	4	0	186
1097	183	1	0	1	0	185
1098	178	1	0	1	0	180
1099	4	2	0	174	0	180
1100	2	0	0	163	0	165
1101	0	154	1	1	0	156
1102	2	161	0	1	0	164
1103	154	1	0	3	0	158
1104	1	1	0	156	0	158
1105	155	2	0	3	0	160
1106	158	1	1	3	0	163
1107	0	1	1	158	0	160
1108	2	170	1	2	0	175
1109	175	0	0	2	0	177
1110	186	1	0	4	0	191
1111	2	0	202	3	0	207
1112	187	1	0	2	0	190
1113	0	198	0	1	0	199
1114	3	2	0	198	0	203
1115	224	0	0	2	0	226
1116	0	1	0	255	0	256
1117	4	0	0	244	0	248
1118	3	250	0	1	0	254
1119	247	0	0	3	0	250
1120	246	1	0	2	0	249
1121	2	248	0	2	0	252
1122	3	262	0	0	0	265
1123	266	2	1	1	0	270
1124	267	1	0	0	0	268
1125	1	3	258	0	0	262
1126	4	0	230	1	0	235
1127	3	1	262	0	0	266
1128	0	1	2	267	0	270
1129	3	1	2	277	0	283
1130	2	2	276	1	0	281
1131	260	0	0	5	0	265
1132	281	1	3	1	0	286
1133	281	0	1	1	0	283
1134	279	2	0	1	0	282
1135	3	1	323	1	0	328
1136	333	1	0	2	0	336
1137	336	0	2	5	0	343
1138	344	0	2	1	0	347
1139	342	1	2	1	0	346
1140	340	0	1	2	0	343
1141	3	0	354	1	0	358
1142	2	356	1	1	0	360
1143	5	2	1	350	0	358
1144	2	2	3	357	0	364
1145	4	1	357	2	0	364
1146	324	0	2	4	0	330
1147	2	0	3	362	0	367
1148	4	0	392	0	0	396
1149	4	0	362	3	0	369
1150	2	401	1	3	0	407
1151	2	0	3	415	0	420
1152	3	1	1	421	0	426
1153	3	2	1	413	0	419
1154	421	1	0	5	0	427
1155	1	0	1	419	0	421
1156	2	1	409	2	0	414
1157	3	0	387	3	0	393
1158	3	0	433	3	0	439
1159	1	1	3	440	0	445
1160	462	0	2	2	0	466
1161	2	0	463	2	0	467
1162	449	1	3	6	0	459
1163	540	1	3	3	0	547
1164	3	2	0	555	0	560
1165	4	0	0	555	0	559
1166	3	556	2	3	0	564
1167	1	2	545	5	0	553
1168	514	1	2	4	0	521
1169	2	2	3	560	0	567
1170	2	553	4	0	0	559
1171	2	2	1	565	0	570
1172	1	2	561	3	0	567
1173	1	1	2	549	0	553
1174	3	547	1	3	0	554
1175	3	1	2	545	0	551
1176	535	1	1	9	0	546
1177	1	1	2	528	0	532
1178	1	522	4	3	0	530
1179	1	527	4	4	0	536
1180	518	3	0	4	0	525
1181	2	3	528	1	0	534
1182	3	6	1	511	0	521
1183	3	1	1	529	0	534
1184	1	1	533	2	0	537
1185	2	522	0	4	0	528
1186	0	3	534	2	0	539
1187	3	2	2	521	0	528
1188	1	541	2	1	0	545
1189	560	1	1	8	0	570
1190	3	554	0	3	0	560
1191	1	574	0	0	0	575
1192	578	2	0	8	0	588
1193	569	0	0	8	0	577
1194	588	1	0	5	0	594
1195	3	1	0	588	0	592
1196	4	2	583	1	0	590
1197	567	0	1	3	0	571
1198	609	0	2	3	0	614
1199	3	0	1	630	0	634
1200	3	0	625	3	0	631
1201	2	617	3	1	0	623
1202	622	3	1	5	0	631
1203	655	1	3	5	0	664
1204	2	658	1	1	0	662
1205	4	677	0	0	0	681
1206	681	3	0	4	0	688
1207	687	3	0	2	0	692
1208	656	4	12	7	0	679
1209	9	1	0	660	0	670
1210	4	0	670	2	0	676
1211	6	0	2	636	0	644
1212	1	1	645	5	0	652
1213	0	633	5	2	0	640
1214	1	648	1	2	0	652
1215	4	2	1	616	0	623
1216	0	2	1	620	0	623
1217	2	2	1	601	0	606
1218	0	617	0	3	0	620
1219	602	2	1	3	0	608
1220	600	0	0	4	0	604
1221	2	616	0	1	0	619
1222	1	4	0	605	0	610
1223	3	596	2	2	0	603
1224	2	4	0	601	0	607
1225	2	600	0	3	0	605
1226	608	3	0	8	0	619
1227	2	3	0	596	0	601
1228	0	3	583	4	0	590
1229	574	0	3	2	0	579
1230	587	2	0	4	0	593
1231	3	2	578	1	0	584
1232	5	0	2	570	0	577
1233	3	0	589	3	0	595
1234	2	0	3	597	0	602
1235	0	2	570	3	0	575
1236	520	1	3	6	0	530
1237	4	2	1	553	0	560
1238	0	549	2	5	0	556
1239	554	3	1	6	0	564
1240	6	0	0	561	0	567
1241	4	2	0	552	0	558
1242	4	1	542	2	0	549
1243	6	1	2	548	0	557
1244	3	2	558	8	0	571
1245	1	0	580	3	0	584
1246	1	2	7	581	0	591
1247	0	1	637	8	0	646
1248	616	2	9	4	0	631
1249	755	1	1	5	0	762
1250	801	0	1	13	0	815
1251	19	841	5	1	0	866
1252	18	15	1	839	0	873
1253	14	5	0	819	0	838
1254	4	870	3	14	0	891
1255	863	17	0	10	0	890
1256	15	5	2	862	0	884
1257	4	4	869	21	0	898
1258	8	1	826	3	0	838
1259	6	820	17	8	0	851
1260	826	17	10	8	0	861
1261	17	4	817	2	0	840
1262	766	9	17	5	0	797
1263	21	730	6	4	0	761
1264	5	15	745	6	0	771
1265	7	7	740	3	0	757
1266	6	6	743	4	0	759
1267	2	747	26	5	0	780
1268	4	15	759	2	0	780
1269	732	6	23	6	0	767
1270	24	8	12	703	0	747
1271	13	4	5	760	0	782
1272	19	3	5	759	0	786
1273	12	3	5	761	0	781
1274	5	5	759	24	0	793
1275	3	2	17	762	0	784
1276	6	4	6	770	0	786
1277	749	2	12	21	0	784
1278	767	2	3	17	0	789
1279	739	3	7	13	0	762
1280	25	1	745	5	0	776
1281	13	768	19	6	0	806
1282	9	800	5	8	0	822
1283	749	19	7	14	0	789
1284	13	800	9	7	0	829
1285	12	24	3	793	0	832
1286	8	9	8	821	0	846
1287	7	7	804	22	0	840
1288	5	775	19	13	0	812
1289	7	18	769	10	0	804
1290	742	9	23	7	0	781
1291	773	6	9	5	0	793
1292	24	6	6	776	0	812
1293	12	6	7	776	0	801
1294	19	2	1	772	0	794
1295	10	3	3	790	0	806
1296	5	2	762	28	0	797
1297	6	1	16	764	0	787
1298	1	3	755	28	0	787
1299	4	3	727	10	0	744
1300	5	738	21	8	0	772
1301	734	12	13	6	0	765
1302	22	752	7	3	0	784
1303	9	20	4	720	0	753
1304	10	10	761	17	0	798
1305	741	7	20	7	0	775
1306	17	7	747	14	0	785
1307	751	6	22	3	0	782
1308	759	1	5	10	0	775
1309	19	3	12	757	0	791
1310	14	2	12	754	0	782
1311	14	4	6	772	0	796
1312	10	5	750	28	0	793
1313	732	5	19	13	0	769
1314	20	746	11	14	0	791
1315	14	18	12	738	0	782
1316	754	7	3	21	0	785
1317	762	8	9	13	0	792
1318	770	1	8	13	0	792
1319	35	6	743	6	0	790
1320	770	7	18	9	0	804
1321	758	8	10	12	0	788
1322	26	2	726	13	0	767
1323	14	7	789	10	0	820
1324	19	12	26	754	0	811
1325	14	6	773	24	0	817
1326	3	735	33	17	0	788
1327	11	779	16	9	0	815
1328	752	25	18	9	0	804
1329	25	781	9	4	0	819
1330	25	25	12	767	0	829
1331	746	10	11	23	0	790
1332	29	779	2	9	0	819
1333	15	23	11	771	0	820
1334	10	10	12	786	0	818
1335	6	11	760	32	0	809
1336	7	4	20	770	0	801
1337	1	11	763	32	0	807
1338	4	9	761	18	0	792
1339	13	4	29	743	0	789
1340	10	5	15	762	0	792
1341	740	8	11	37	0	796
1342	26	795	4	21	0	846
1343	15	20	9	784	0	828
1344	20	20	9	782	0	831
1345	745	12	8	42	0	807
1346	24	741	7	25	0	797
1347	14	678	4	18	0	714
1348	18	635	6	6	0	665
1349	4	543	4	8	0	559
1350	405	11	30	9	0	455
1351	401	9	5	4	0	419
1352	381	10	0	2	0	393
1353	387	3	2	4	0	396
1354	18	2	2	374	0	396
1355	11	2	371	10	0	394
1356	8	364	10	5	0	387
1357	4	8	4	372	0	388
1358	1	7	374	10	0	392
1359	5	5	8	369	0	387
1360	3	4	4	374	0	385
1361	2	0	374	15	0	391
1362	4	1	10	373	0	388
1363	6	2	6	351	0	365
1364	368	2	5	14	0	389
1365	361	1	3	10	0	375
1366	367	2	3	6	0	378
1367	358	3	2	5	0	368
1368	18	1	2	335	0	356
1369	13	2	2	347	0	364
1370	8	2	2	355	0	367
1371	343	1	1	21	0	366
1372	13	1	1	351	0	366
1373	7	0	3	358	0	368
1374	7	1	334	19	0	361
1375	5	1	12	329	0	347
1376	4	327	5	14	0	350
1377	3	351	4	7	0	365
1378	333	11	1	6	0	351
1379	9	10	327	5	0	351
1380	7	325	6	4	0	342
1381	315	8	4	4	0	331
1382	14	3	4	309	0	330
1383	7	5	309	8	0	329
1384	6	5	6	288	0	305
1385	3	307	5	14	0	329
1386	297	10	6	7	0	320
1387	10	299	2	6	0	317
1388	304	14	2	5	0	325
1389	313	4	2	2	0	321
1390	13	5	1	304	0	323
1391	9	2	1	305	0	317
1392	8	310	2	13	0	333
1393	315	7	1	12	0	335
1394	9	7	313	3	0	332
1395	311	5	10	5	0	331
1396	317	2	2	2	0	323
1397	18	1	303	1	0	323
1398	13	8	9	277	0	307
1399	292	0	6	11	0	309
1400	10	1	283	8	0	302
1401	7	2	270	6	0	285
1402	255	3	12	4	0	274
1403	10	246	10	3	0	269
1404	5	226	3	0	0	234
1405	6	13	2	216	0	237
1406	1	9	217	8	0	235
1407	195	8	8	6	0	217
1408	14	1	210	4	0	229
1409	7	204	13	1	0	225
1410	208	10	7	3	0	228
1411	12	4	3	199	0	218
1412	208	7	2	11	0	228
1413	13	1	213	5	0	232
1414	8	2	7	212	0	229
1415	6	213	5	8	0	232
1416	3	14	4	201	0	222
1417	2	7	2	214	0	225
1418	3	5	207	14	0	229
1419	5	193	8	7	0	213
1420	3	194	4	7	0	208
1421	5	10	190	2	0	207
1422	165	5	8	3	0	181
1423	181	4	4	1	0	190
1424	8	9	5	169	0	191
1425	169	0	2	11	0	182
1426	10	155	3	4	0	172
1427	3	161	2	9	0	175
1428	163	9	1	6	0	179
1429	10	5	2	163	0	180
1430	164	4	2	10	0	180
1431	172	1	2	5	0	180
1432	15	1	1	161	0	178
1433	7	1	159	9	0	176
1434	166	2	7	3	0	178
1435	170	1	2	5	0	178
1436	11	1	4	160	0	176
1437	9	162	2	10	0	183
1438	5	9	1	166	0	181
1439	4	3	160	12	0	179
1440	2	4	159	7	0	172
1441	1	161	9	8	0	179
1442	3	5	2	100	0	110
1443	2	1	2	108	0	113
1444	1	1	102	6	0	110
1445	98	0	6	2	0	106
1446	109	0	1	1	0	111
1447	106	0	1	0	0	107
1448	108	0	0	0	0	108
1449	5	97	0	0	0	102
1450	2	101	0	1	0	104
1451	105	6	0	0	0	111
1452	5	1	1	104	0	111
1453	1	2	0	104	0	107
1454	2	104	0	4	0	110
1455	0	6	0	109	0	115
1456	1	1	1	106	0	109
1457	1	105	1	6	0	113
1458	2	4	108	2	0	116
1459	3	1	5	106	0	115
1460	106	0	2	6	0	114
1461	110	0	1	2	0	113
1462	8	1	96	7	0	112
1463	3	0	109	0	0	112
1464	1	0	111	0	0	112
1465	1	0	7	105	0	113
1466	0	2	106	5	0	113
1467	0	1	106	2	0	109
1468	0	2	7	96	0	105
1469	2	110	2	3	0	117
1470	1	4	110	1	0	116
1471	0	113	5	1	0	119
1472	114	5	1	0	0	120
1473	6	115	0	0	0	121
1474	2	4	0	117	0	123
1475	114	1	1	6	0	122
1476	5	0	2	117	0	124
1477	3	0	0	121	0	124
1478	0	2	120	5	0	127
1479	0	112	5	2	0	119
1480	0	123	1	1	0	125
1481	1	4	1	110	0	116
1482	3	2	2	110	0	117
1483	1	2	0	112	0	115
1484	1	1	108	5	0	115
1485	1	1	102	2	0	106
1486	98	1	3	2	0	104
1487	3	1	104	1	0	109
1488	1	0	97	1	0	99
1489	0	95	4	1	0	100
1490	2	9	2	89	0	102
1491	1	1	98	1	0	101
1492	0	1	4	84	0	89
1493	1	1	94	3	0	99
1494	0	0	3	94	0	97
1495	1	0	104	3	0	108
1496	1	1	2	102	0	106
1497	1	0	2	104	0	107
1498	0	109	1	2	0	112
1499	0	2	1	113	0	116
1500	0	113	1	4	0	118
1501	1	1	0	115	0	117
1502	1	1	1	114	0	117
1503	111	0	1	4	0	116
1504	4	1	1	111	0	117
1505	1	0	110	3	0	114
1506	1	0	3	111	0	115
1507	2	1	1	113	0	117
1508	0	1	107	4	0	112
1509	0	0	104	2	0	106
1510	1	0	3	107	0	111
1511	1	0	0	111	0	112
1512	0	0	108	2	0	110
1513	0	84	3	1	0	88
1514	0	94	0	2	0	96
1515	96	2	1	3	0	102
1516	2	0	2	101	0	105
1517	101	1	0	3	0	105
1518	97	1	0	3	0	101
1519	3	98	1	0	0	102
1520	101	2	0	2	0	105
1521	98	1	0	3	0	102
1522	5	1	99	0	0	105
1523	0	1	2	97	0	100
1524	2	0	99	2	0	103
1525	3	0	2	97	0	102
1526	0	1	100	3	0	104
1527	1	96	3	1	0	101
1528	1	93	2	0	0	96
1529	2	1	0	92	0	95
1530	91	0	1	4	0	96
1531	0	1	2	92	0	95
1532	1	2	0	91	0	94
1533	0	2	93	1	0	96
1534	2	0	93	0	0	95
1535	0	1	87	2	0	90
1536	2	0	0	85	0	87
1537	2	0	1	87	0	90
1538	0	89	1	1	0	91
1539	1	87	1	2	0	91
1540	84	0	1	2	0	87
1541	0	90	1	1	0	92
1542	0	0	90	1	0	91
1543	0	1	1	87	0	89
1544	1	0	89	3	0	93
1545	0	97	1	0	0	98
1546	0	0	1	95	0	96
1547	90	1	0	3	0	94
1548	0	1	96	2	0	99
1549	1	93	1	0	0	95
1550	0	0	94	4	0	98
1551	1	90	2	1	0	94
1552	0	0	2	85	0	87
1553	84	1	0	3	0	88
1554	84	1	2	1	0	88
1555	0	85	1	1	0	87
1556	86	2	0	1	0	89
1557	1	0	1	86	0	88
1558	84	2	0	1	0	87
1559	2	1	85	1	0	89
1560	2	1	84	1	0	88
1561	1	0	2	86	0	89
1562	1	1	0	94	0	96
1563	1	0	88	1	0	90
1564	1	0	2	86	0	89
1565	88	0	0	3	0	91
1566	88	0	1	2	0	91
1567	0	89	3	1	0	93
1568	0	90	1	2	0	93
1569	84	1	1	1	0	87
1570	1	2	0	79	0	82
1571	80	1	0	2	0	83
1572	0	72	0	1	0	73
1573	71	0	0	2	0	73
1574	1	0	67	1	0	69
1575	1	0	64	0	0	65
1576	1	1	0	63	0	65
1577	2	0	64	1	0	67
1578	0	0	2	66	0	68
1579	0	0	1	67	0	68
1580	0	0	75	1	0	76
1581	0	0	0	74	0	74
1582	0	0	1	73	0	74
1583	0	1	75	1	0	77
1584	1	0	75	0	0	76
1585	77	0	0	1	0	78
1586	1	1	81	0	0	83
1587	87	1	0	1	0	89
1588	92	0	0	1	0	93
1589	0	0	106	1	0	107
1590	1	0	109	0	0	110
1591	1	1	0	106	0	108
1592	2	0	0	104	0	106
1593	0	108	1	1	0	110
1594	0	110	1	1	0	112
1595	0	0	103	1	0	104
1596	98	0	2	0	0	100
1597	102	0	1	1	0	104
1598	0	0	101	2	0	103
1599	0	1	95	1	0	97
1600	0	1	0	97	0	98
1601	0	103	0	1	0	104
1602	2	0	2	103	0	107
1603	1	1	1	103	0	106
1604	103	0	1	0	0	104
1605	100	0	1	1	0	102
1606	2	0	0	115	0	117
1607	1	1	115	0	0	117
1608	104	0	1	2	0	107
1609	1	122	1	0	0	124
1610	121	0	1	2	0	124
1611	121	1	1	2	0	125
1612	0	122	1	0	0	123
1613	0	120	0	0	0	120
1614	1	0	1	123	0	125
1615	3	0	0	119	0	122
1616	2	120	0	0	0	122
1617	0	1	1	127	0	129
1618	1	0	1	124	0	126
1619	0	0	128	2	0	130
1620	128	1	1	2	0	132
1621	130	0	1	1	0	132
1622	133	0	1	1	0	135
1623	2	0	0	133	0	135
1624	132	0	0	2	0	134
1625	1	127	1	1	0	130
1626	0	1	2	121	0	124
1627	1	122	2	1	0	126
1628	2	131	1	0	0	134
1629	130	2	0	3	0	135
1630	128	1	0	2	0	131
1631	123	1	1	2	0	127
1632	127	1	1	0	0	129
1633	129	0	0	1	0	130
1634	3	0	128	1	0	132
1635	123	1	2	3	0	129
1636	1	1	131	1	0	134
1637	128	0	2	1	0	131
1638	125	1	1	1	0	128
1639	128	0	0	1	0	129
1640	2	1	139	2	0	144
1641	3	1	1	129	0	134
1642	0	146	1	2	0	149
1643	148	1	2	2	0	153
1644	152	1	1	1	0	155
1645	3	146	1	1	0	151
1646	151	3	1	1	0	156
1647	2	1	1	152	0	156
1648	2	147	1	2	0	152
1649	151	3	0	1	0	155
1650	154	1	0	2	0	157
1651	3	0	1	151	0	155
1652	153	0	2	3	0	158
1653	3	1	3	150	0	157
1654	1	0	3	153	0	157
1655	0	0	152	4	0	156
1656	5	1	2	146	0	154
1657	2	3	1	151	0	157
1658	3	2	152	1	0	158
1659	3	1	159	0	0	163
1660	3	1	1	150	0	155
1661	3	1	159	1	0	164
1662	140	1	3	1	0	145
1663	1	160	2	3	0	166
1664	0	4	1	165	0	170
1665	0	1	0	168	0	169
1666	2	1	0	164	0	167
1667	171	0	1	3	0	175
1668	172	0	0	1	0	173
1669	167	0	0	1	0	168
1670	3	169	1	1	0	174
1671	0	1	2	177	0	180
1672	3	1	1	176	0	181
1673	175	2	1	1	0	179
1674	177	1	0	1	0	179
1675	4	2	0	173	0	179
1676	2	1	174	1	0	178
1677	175	0	2	1	0	178
1678	173	1	0	3	0	177
1679	2	0	178	2	0	182
1680	160	1	1	3	0	165
1681	3	1	184	2	0	190
1682	188	0	3	3	0	194
1683	4	0	1	203	0	208
1684	2	237	2	2	0	243
1685	4	2	246	0	0	252
1686	3	240	1	1	0	245
1687	4	233	0	1	0	238
1688	267	4	3	5	0	279
1689	1	1	0	259	0	261
1690	1	0	0	258	0	259
1691	284	0	0	2	0	286
1692	2	0	0	288	0	290
1693	1	0	0	287	0	288
1694	1	0	0	284	0	285
1695	0	0	0	290	0	290
1696	1	3	293	2	0	299
1697	2	1	276	1	0	280
1698	0	287	2	3	0	292
1699	292	1	1	3	0	297
1700	3	1	0	312	0	316
1701	1	298	0	3	0	302
1702	0	1	0	332	0	333
1703	0	1	0	324	0	325
1704	1	0	0	325	0	326
1705	0	0	2	328	0	330
1706	0	0	2	322	0	324
1707	0	322	0	2	0	324
1708	2	1	0	327	0	330
1709	1	1	314	3	0	319
1710	0	316	1	2	0	319
1711	0	1	0	316	0	317
1712	0	1	0	320	0	321
1713	0	313	0	4	0	317
1714	0	317	0	3	0	320
1715	313	1	0	3	0	317
1716	1	319	0	0	0	320
1717	307	0	0	2	0	309
1718	299	2	1	0	0	302
1719	1	2	312	0	0	315
1720	1	0	0	304	0	305
1721	0	0	324	2	0	326
1722	0	330	0	1	0	331
1723	0	2	1	316	0	319
1724	2	2	0	338	0	342
1725	1	2	1	345	0	349
1726	3	1	0	346	0	350
1727	2	1	349	1	0	353
1728	1	0	2	347	0	350
1729	0	0	358	2	0	360
1730	2	0	352	2	0	356
1731	329	2	1	2	0	334
1732	353	0	2	3	0	358
1733	358	0	0	3	0	361
1734	1	353	1	3	0	358
1735	3	0	0	364	0	367
1736	1	1	384	0	0	386
1737	0	0	1	380	0	381
1738	0	1	394	0	0	395
1739	385	0	2	2	0	389
1740	386	0	1	2	0	389
1741	389	1	0	0	0	390
1742	3	0	372	1	0	376
1743	1	3	357	1	0	362
1744	0	0	1	379	0	380
1745	1	0	3	361	0	365
1746	0	0	0	380	0	380
1747	0	2	380	1	0	383
1748	3	0	361	2	0	366
1749	373	1	2	1	0	377
1750	4	1	1	395	0	401
1751	1	0	2	399	0	402
1752	405	0	2	3	0	410
1753	0	1	0	410	0	411
1754	430	1	0	5	0	436
1755	440	0	0	5	0	445
1756	441	3	1	1	0	446
1757	2	0	460	0	0	462
1758	4	452	0	0	0	456
1759	464	0	2	4	0	470
1760	1	1	0	473	0	475
1761	4	0	1	456	0	461
1762	0	460	0	2	0	462
1763	459	0	0	5	0	464
1764	458	1	0	2	0	461
1765	457	0	0	2	0	459
1766	1	468	4	0	0	473
1767	499	2	1	6	0	508
1768	501	1	1	3	0	506
1769	504	0	2	2	0	508
1770	5	0	0	504	0	509
1771	4	2	0	502	0	508
1772	4	0	514	1	0	519
1773	3	2	0	503	0	508
1774	3	1	0	493	0	497
1775	0	2	508	2	0	512
1776	497	0	1	2	0	500
1777	515	0	1	2	0	518
1778	7	0	1	509	0	517
1779	2	506	0	2	0	510
1780	4	503	0	2	0	509
1781	1	2	3	498	0	504
1782	0	2	491	2	0	495
1783	2	1	0	479	0	482
1784	0	0	482	1	0	483
1785	2	4	463	2	0	471
1786	0	1	2	483	0	486
1787	503	0	1	1	0	505
1788	483	0	0	1	0	484
1789	2	1	0	501	0	504
1790	3	2	0	493	0	498
1791	3	0	0	488	0	491
1792	0	1	0	483	0	484
1793	494	0	0	3	0	497
1794	483	0	0	2	0	485
1795	484	0	1	1	0	486
1796	0	1	470	0	0	471
1797	0	2	0	476	0	478
1798	1	1	0	478	0	480
1799	470	0	0	4	0	474
1800	0	456	1	1	0	458
1801	455	0	0	1	0	456
1802	439	0	0	2	0	441
1803	435	1	0	0	0	436
1804	437	0	0	2	0	439
1805	0	0	460	0	0	460
1806	0	0	438	0	0	438
1807	476	0	0	3	0	479
1808	493	0	0	1	0	494
1809	488	0	0	4	0	492
1810	501	0	0	1	0	502
1811	2	0	532	0	0	534
1812	0	552	4	0	0	556
1813	0	2	0	617	0	619
1814	640	1	0	9	0	650
1815	650	0	0	6	0	656
1816	677	0	0	3	0	680
1817	691	1	0	6	0	698
1818	703	0	1	3	0	707
1819	683	1	0	1	0	685
1820	15	0	638	0	0	653
1821	8	1	640	0	0	649
1822	9	0	12	639	0	660
1823	5	0	657	5	0	667
1824	2	625	7	6	0	640
1825	2	624	10	1	0	637
1826	6	12	0	647	0	665
1827	2	6	676	5	0	689
1828	1	4	646	6	0	657
1829	643	4	18	4	0	669
1830	692	0	9	8	0	709
1831	18	1	4	685	0	708
1832	699	2	4	13	0	718
1833	11	2	0	703	0	716
1834	14	1	1	694	0	710
1835	1	1	708	22	0	732
1836	4	1	672	8	0	685
1837	3	0	19	672	0	694
1838	2	0	675	14	0	691
1839	645	0	12	12	0	669
1840	676	0	11	7	0	694
1841	17	711	0	7	0	735
1842	721	11	3	4	0	739
1843	14	8	708	1	0	731
1844	701	0	13	5	0	719
1845	712	3	9	6	0	730
1846	734	0	1	3	0	738
1847	21	0	3	700	0	724
1848	14	703	0	12	0	729
1849	719	12	0	13	0	744
1850	727	9	1	1	0	738
1851	23	0	1	737	0	761
1852	734	3	1	17	0	755
1853	20	737	1	10	0	768
1854	16	14	0	725	0	755
1855	1	10	714	19	0	744
1856	653	1	17	11	0	682
1857	16	3	703	3	0	725
1858	13	1	18	699	0	731
1859	6	700	11	15	0	732
1860	7	753	2	7	0	769
1861	8	24	3	741	0	776
1862	4	725	2	18	0	749
1863	11	18	4	972	0	1005
1864	13	14	2	1011	0	1040
1865	10	1	4	1047	0	1062
1866	983	5	1	45	0	1034
1867	40	3	0	980	0	1023
1868	19	6	956	40	0	1021
1869	9	944	31	20	0	1004
1870	958	28	14	14	0	1014
1871	38	14	5	944	0	1001
1872	23	3	5	962	0	993
1873	15	10	2	986	0	1013
1874	13	6	928	46	0	993
1875	8	942	35	24	0	1009
1876	939	36	16	17	0	1008
1877	38	17	13	894	0	962
1878	17	951	9	34	0	1011
1879	933	34	4	28	0	999
1880	36	17	923	15	0	991
1881	921	5	36	15	0	977
1882	33	15	947	6	0	1001
1883	25	8	952	8	0	993
1884	14	931	45	8	0	998
1885	9	33	21	929	0	992
1886	14	16	925	30	0	985
1887	8	888	36	19	0	951
1888	16	33	20	846	0	915
1889	5	874	12	39	0	930
1890	7	32	878	16	0	933
1891	14	21	35	852	0	922
1892	4	12	884	41	0	941
1893	18	4	38	872	0	932
1894	12	11	25	897	0	945
1895	9	13	874	51	0	947
1896	16	8	39	882	0	945
1897	837	7	24	48	0	916
1898	33	870	9	35	0	947
1899	18	31	872	18	0	939
1900	866	17	39	18	0	940
1901	46	9	15	850	0	920
1902	21	886	12	42	0	961
1903	906	35	15	21	0	977
1904	939	22	9	12	0	982
1905	56	12	2	880	0	950
1906	30	10	13	899	0	952
1907	22	9	6	907	0	944
1908	13	2	9	891	0	915
1909	11	861	11	54	0	937
1910	18	40	5	829	0	892
1911	14	787	6	45	0	852
1912	9	813	7	31	0	860
1913	10	776	3	22	0	811
1914	12	40	710	17	0	779
1915	7	727	37	23	0	794
1916	676	40	20	16	0	752
1917	36	677	10	17	0	740
1918	16	36	11	623	0	686
1919	13	682	7	41	0	743
1920	15	32	9	686	0	742
1921	11	15	11	708	0	745
1922	13	20	679	41	0	753
1923	648	16	28	31	0	723
1924	678	13	18	20	0	729
1925	692	18	12	19	0	741
1926	40	665	10	23	0	738
1927	15	34	14	665	0	728
1928	13	14	652	46	0	725
1929	12	655	33	23	0	723
1930	15	28	23	565	0	631
1931	13	622	13	26	0	674
1932	616	33	8	17	0	674
1933	615	19	13	18	0	665
1934	622	18	13	15	0	668
1935	631	7	13	19	0	670
1936	37	13	18	601	0	669
1937	20	13	13	607	0	653
1938	14	621	15	33	0	683
1939	18	25	14	628	0	685
1940	10	17	613	38	0	678
1941	13	14	24	593	0	644
1942	8	10	582	42	0	642
1943	5	572	28	24	0	629
1944	6	26	564	28	0	624
1945	9	18	33	564	0	624
1946	6	15	590	37	0	648
1947	14	12	29	574	0	629
1948	9	12	15	582	0	618
1949	8	11	16	592	0	627
1950	13	13	10	589	0	625
1951	544	9	10	30	0	593
1952	24	553	6	25	0	608
1953	524	25	6	27	0	582
1954	26	15	506	18	0	565
1955	515	12	22	19	0	568
1956	534	8	10	19	0	571
1957	31	7	510	18	0	566
1958	23	8	489	14	0	534
1959	17	475	22	16	0	530
1960	13	457	11	14	0	495
1961	9	27	432	19	0	487
1962	4	394	21	21	0	440
1963	2	10	4	167	0	183
1964	140	0	3	3	0	146
1965	1	1	0	142	0	144
1966	142	0	1	2	0	145
1967	137	0	0	2	0	139
1968	2	146	0	1	0	149
1969	145	1	0	1	0	147
1970	143	1	0	0	0	144
1971	1	0	0	144	0	145
1972	150	0	0	1	0	151
1973	1	160	0	0	0	161
1974	0	1	0	160	0	161
1975	160	0	0	1	0	161
1976	1	0	167	0	0	168
1977	168	0	1	0	0	169
1978	1	0	0	169	0	170
1979	0	0	170	1	0	171
1980	0	0	163	0	0	163
1981	164	4	1	0	0	169
1982	161	0	0	0	0	161
1983	1	0	0	158	0	159
1984	0	0	0	159	0	159
1985	0	0	0	155	0	155
1986	0	159	0	1	0	160
1987	157	1	0	1	0	159
1988	1	163	0	0	0	164
1989	162	1	0	1	0	164
1990	1	0	160	0	0	161
1991	0	0	1	156	0	157
1992	161	0	0	1	0	162
1993	1	0	0	162	0	163
1994	0	0	0	160	0	160
1995	0	165	1	1	0	167
1996	166	1	0	0	0	167
1997	1	168	0	0	0	169
1998	0	0	0	171	0	171
1999	0	0	161	1	0	162
2000	144	0	2	3	0	149
2001	1	0	160	0	0	161
2002	144	0	1	0	0	145
2003	1	150	0	0	0	151
2004	0	1	0	138	0	139
2005	0	145	0	1	0	146
2006	153	1	0	0	0	154
2007	1	0	0	153	0	154
2008	0	0	0	154	0	154
2009	0	0	148	1	0	149
2010	140	0	2	1	0	143
2011	1	0	0	156	0	157
2012	0	0	144	1	0	145
2013	0	146	1	0	0	147
2014	0	1	0	149	0	150
2015	150	0	0	1	0	151
2016	2	0	0	149	0	151
2017	0	0	145	1	0	146
2018	166	0	1	0	0	167
2019	3	1	0	161	0	165
2020	0	0	180	4	0	184
2021	1	0	3	181	0	185
2022	0	0	0	178	0	178
2023	1	184	0	5	0	190
2024	172	5	0	2	0	179
2025	4	175	1	0	0	180
2026	172	6	1	0	0	179
2027	6	0	0	176	0	182
2028	1	174	0	5	0	180
2029	0	5	0	177	0	182
2030	0	0	170	5	0	175
2031	170	0	4	0	0	174
2032	5	1	0	174	0	180
2033	1	0	0	179	0	180
2034	0	1	1	178	0	180
2035	1	1	171	5	0	178
2036	0	0	166	1	0	167
2037	1	168	5	1	0	175
2038	1	6	0	151	0	158
2039	152	0	1	5	0	158
2040	6	158	0	1	0	165
2041	0	4	0	162	0	166
2042	169	1	0	5	0	175
2043	169	1	0	1	0	171
2044	8	163	0	2	0	173
2045	181	9	1	1	0	192
2046	203	1	0	0	0	204
2047	11	0	1	193	0	205
2048	3	195	1	9	0	208
2049	0	12	0	204	0	216
2050	204	4	0	13	0	221
2051	12	1	206	3	0	222
2052	6	0	12	205	0	223
2053	0	0	3	224	0	227
2054	1	2	209	23	0	235
2055	2	6	11	215	0	234
2056	212	0	3	20	0	235
2057	217	1	3	6	0	227
2058	14	0	8	212	0	234
2059	3	1	204	20	0	228
2060	1	1	198	12	0	212
2061	2	199	16	5	0	222
2062	3	213	3	10	0	229
2063	11	14	3	205	0	233
2064	208	3	2	16	0	229
2065	12	203	2	13	0	230
2066	201	12	10	3	0	226
2067	11	4	8	202	0	225
2068	6	8	1	208	0	223
2069	190	6	1	17	0	214
2070	16	193	0	11	0	220
2071	202	15	1	3	0	221
2072	14	9	185	1	0	209
2073	10	2	178	2	0	192
2074	1	4	15	181	0	201
2075	4	2	179	20	0	205
2076	7	2	177	6	0	192
2077	4	7	14	159	0	184
2078	9	2	169	12	0	192
2079	5	1	19	165	0	190
2080	3	0	9	174	0	186
2081	1	1	171	23	0	196
2082	2	1	20	174	0	197
2083	1	2	10	174	0	187
2084	2	168	4	19	0	193
2085	166	12	10	5	0	193
2086	11	3	176	11	0	201
2087	4	0	14	186	0	204
2088	1	0	11	184	0	196
2089	0	0	175	23	0	198
2090	166	1	11	13	0	191
2091	13	183	5	3	0	204
2092	10	9	2	180	0	201
2093	0	5	7	192	0	204
2094	2	179	2	21	0	204
2095	0	11	171	11	0	193
2096	2	169	17	3	0	191
2097	176	14	2	2	0	194
2098	13	9	176	2	0	200
2099	6	0	14	177	0	197
2100	2	3	176	20	0	201
2101	1	6	179	6	0	192
2102	1	174	22	2	0	199
2103	5	19	2	171	0	197
2104	179	4	4	14	0	201
2105	178	1	7	10	0	196
2106	14	175	2	10	0	201
2107	3	13	10	178	0	204
2108	174	6	8	11	0	199
2109	182	8	2	6	0	198
2110	19	177	2	7	0	205
2111	190	12	2	2	0	206
2112	17	6	2	180	0	205
2113	5	182	3	11	0	201
2114	3	12	2	190	0	207
2115	9	7	0	192	0	208
2116	7	4	1	194	0	206
2117	6	7	179	15	0	207
2118	10	1	164	5	0	180
2119	0	166	12	7	0	185
2120	150	12	2	5	0	169
2121	10	150	2	10	0	172
2122	5	8	0	160	0	173
2123	3	4	161	14	0	182
2124	2	1	15	152	0	170
2125	1	3	9	164	0	177
2126	1	8	2	169	0	180
2127	166	2	2	13	0	183
2128	8	7	0	166	0	181
2129	4	1	177	14	0	196
2130	163	0	17	7	0	187
2131	170	1	5	9	0	185
2132	183	2	1	3	0	189
2133	187	2	0	7	0	196
2134	185	2	0	4	0	191
2135	9	171	4	10	0	194
2136	6	7	7	166	0	186
2137	7	172	0	11	0	190
2138	179	7	0	4	0	190
2139	189	3	0	3	0	195
2140	183	0	2	2	0	187
2141	10	165	2	3	0	180
2142	4	158	2	2	0	166
2143	4	157	1	6	0	168
2144	6	11	148	0	0	165
2145	4	11	4	118	0	137
2146	8	105	3	2	0	118
2147	0	101	0	0	0	101
2148	0	0	0	100	0	100
2149	0	0	0	101	0	101
2150	0	0	99	0	0	99
2151	90	0	0	0	0	90
2152	0	0	0	101	0	101
2153	0	0	0	101	0	101
2154	0	0	100	0	0	100
2155	0	0	89	0	0	89
2156	0	110	0	0	0	110
2157	0	0	0	110	0	110
2158	0	0	0	109	0	109
2159	0	0	110	0	0	110
2160	96	0	0	0	0	96
2161	106	0	0	1	0	107
2162	0	0	102	0	0	102
2163	99	0	0	0	0	99
2164	0	1	107	0	0	108
2165	102	0	0	1	0	103
2166	108	0	0	1	0	109
2167	0	0	115	0	0	115
2168	1	0	0	111	0	112
2169	2	0	0	103	0	105
2170	0	0	1	114	0	115
2171	116	0	0	1	0	117
2172	113	0	1	0	0	114
2173	1	0	120	0	0	121
2174	1	0	102	0	0	103
2175	117	0	1	1	0	119
2176	121	0	0	2	0	123
2177	1	0	120	1	0	122
2178	1	0	111	1	0	113
2179	2	0	0	120	0	122
2180	1	1	121	0	0	123
2181	0	0	2	116	0	118
2182	121	0	1	0	0	122
2183	1	0	149	0	0	150
2184	130	0	0	2	0	132
2185	0	0	160	0	0	160
2186	0	0	2	154	0	156
2187	1	0	0	155	0	156
2188	0	0	1	161	0	162
2189	0	164	0	2	0	166
2190	2	0	0	160	0	162
2191	0	0	1	169	0	170
2192	168	0	0	1	0	169
2193	0	0	167	1	0	168
2194	152	0	1	2	0	155
2195	0	0	173	0	0	173
2196	154	0	0	1	0	155
2197	0	173	0	1	0	174
2198	1	0	164	3	0	168
2199	1	0	168	1	0	170
2200	2	0	1	166	0	169
2201	2	0	1	177	0	180
2202	1	0	187	0	0	188
2203	1	1	201	1	0	204
2204	1	0	197	1	0	199
2205	237	1	0	2	0	240
2206	229	1	1	0	0	231
2207	237	0	2	2	0	241
2208	0	0	0	240	0	240
2209	2	0	0	241	0	243
2210	0	0	280	1	0	281
2211	2	0	1	270	0	273
2212	3	0	2	253	0	258
2213	277	0	1	0	0	278
2214	271	1	1	1	0	274
2215	270	0	1	2	0	273
2216	0	0	1	267	0	268
2217	0	0	1	269	0	270
2218	0	0	2	275	0	277
2219	273	0	1	2	0	276
2220	1	0	2	267	0	270
2221	1	260	1	1	0	263
2222	3	0	0	264	0	267
2223	2	263	1	0	0	266
2224	265	0	0	0	0	265
2225	256	0	1	4	0	261
2226	1	260	0	2	0	263
2227	1	264	1	1	0	267
2228	1	0	0	265	0	266
2229	0	2	255	1	0	258
2230	1	0	0	248	0	249
2231	1	1	258	1	0	261
2232	2	251	0	0	0	253
2233	1	0	2	252	0	255
2234	1	1	0	257	0	259
2235	0	1	271	2	0	274
2236	2	1	0	266	0	269
2237	1	8	268	0	0	277
2238	266	1	1	2	0	270
2239	276	0	2	2	0	280
2240	278	2	0	1	0	281
2241	1	0	1	278	0	280
2242	1	0	1	269	0	271
2243	0	0	285	0	0	285
2244	1	1	1	282	0	285
2245	1	277	2	1	0	281
2246	3	0	282	0	0	285
2247	2	0	266	4	0	272
2248	3	4	2	265	0	274
2249	0	1	280	3	0	284
2250	0	0	277	3	0	280
2251	271	1	2	2	0	276
2252	0	307	2	1	0	310
2253	316	1	0	3	0	320
2254	311	0	2	4	0	317
2255	316	0	2	1	0	319
2256	1	0	0	314	0	315
2257	1	0	1	322	0	324
2258	1	0	323	1	0	325
2259	4	0	0	309	0	313
2260	0	317	2	1	0	320
2261	328	0	1	1	0	330
2262	1	331	0	1	0	333
2263	1	337	1	0	0	339
2264	0	0	2	336	0	338
2265	0	0	343	2	0	345
2266	1	0	2	342	0	345
2267	2	1	340	0	0	343
2268	1	337	1	1	0	340
2269	338	2	0	2	0	342
2270	335	0	0	3	0	338
2271	359	1	0	2	0	362
2272	1	0	380	0	0	381
2273	1	0	364	2	0	367
2274	390	1	0	3	0	394
2275	395	1	1	1	0	398
2276	412	0	0	3	0	415
2277	2	1	1	406	0	410
2278	1	0	0	418	0	419
2279	417	0	1	1	0	419
2280	410	2	0	3	0	415
2281	1	0	435	2	0	438
2282	0	1	412	2	0	415
2283	386	0	1	1	0	388
2284	1	0	398	1	0	400
2285	385	0	0	1	0	386
2286	0	0	400	0	0	400
2287	0	0	0	391	0	391
2288	0	0	421	0	0	421
2289	3	0	0	416	0	419
2290	2	0	0	415	0	417
2291	0	438	0	0	0	438
2292	436	0	0	4	0	440
2293	0	0	440	0	0	440
2294	408	0	0	2	0	410
2295	0	451	0	0	0	451
2296	470	0	0	2	0	472
2297	1	0	0	482	0	483
2298	0	0	0	474	0	474
2299	0	504	0	0	0	504
2300	1	0	0	513	0	514
2301	0	0	0	521	0	521
2302	0	0	0	518	0	518
2303	480	1	0	5	0	486
2304	479	0	1	0	0	480
2305	1	1	454	0	0	456
2306	0	460	0	0	0	460
2307	3	0	0	470	0	473
2308	2	0	0	479	0	481
2309	0	0	489	1	0	490
2310	0	0	1	442	0	443
2311	461	0	0	3	0	464
2312	463	0	0	2	0	465
2313	470	0	1	4	0	475
2314	3	1	0	490	0	494
2315	513	1	1	4	0	519
2316	512	0	0	6	0	518
2317	514	0	1	3	0	518
2318	1	0	0	520	0	521
2319	4	0	0	520	0	524
2320	3	0	0	519	0	522
2321	3	0	0	505	0	508
2322	0	0	0	503	0	503
2323	1	0	505	2	0	508
2324	2	0	500	1	0	503
2325	1	504	1	1	0	507
2326	2	1	0	509	0	512
2327	1	0	1	510	0	512
2328	0	0	0	518	0	518
2329	0	1	513	3	0	517
2330	1	0	2	511	0	514
2331	1	0	514	3	0	518
2332	2	0	2	511	0	515
2333	1	1	530	2	0	534
2334	1	525	2	3	0	531
2335	1	2	3	514	0	520
2336	0	0	510	5	0	515
2337	456	0	3	4	0	463
2338	2	516	0	3	0	521
2339	1	2	2	510	0	515
2340	0	507	1	5	0	513
2341	2	1	2	508	0	513
2342	516	2	0	3	0	521
2343	5	0	0	511	0	516
2344	0	512	3	3	0	518
2345	512	2	0	3	0	517
2346	4	3	0	527	0	534
2347	3	0	0	534	0	537
2348	537	3	1	12	0	553
2349	10	0	0	563	0	573
2350	7	0	0	755	0	762
2351	2	0	775	20	0	797
2352	2	3	757	6	0	768
2353	3	0	23	752	0	778
2354	1	2	771	21	0	795
2355	1	1	758	8	0	768
2356	698	0	24	5	0	727
2357	21	1	744	6	0	772
2358	6	747	19	7	0	779
2359	3	16	12	736	0	767
2360	762	5	6	24	0	797
2361	780	3	4	12	0	799
2362	761	2	5	14	0	782
2363	26	758	10	4	0	798
2364	16	21	5	750	0	792
2365	12	7	5	766	0	790
2366	734	5	5	30	0	774
2367	750	5	3	17	0	775
2368	759	2	2	9	0	772
2369	33	1	747	7	0	788
2370	16	743	23	2	0	784
2371	7	814	8	7	0	836
2372	10	28	4	783	0	825
2373	9	11	6	843	0	869
2374	7	10	819	34	0	870
2375	801	6	27	16	0	850
2376	828	2	11	14	0	855
2377	38	4	9	806	0	857
2378	23	3	7	820	0	853
2379	20	4	5	829	0	858
2380	811	2	4	49	0	866
2381	33	2	790	26	0	851
2382	12	7	808	17	0	844
2383	22	5	34	788	0	849
2384	13	2	804	34	0	853
2385	778	0	37	28	0	843
2386	805	1	21	20	0	847
2387	811	0	12	13	0	836
2388	48	759	12	8	0	827
2389	777	26	9	8	0	820
2390	46	10	5	748	0	809
2391	22	9	6	777	0	814
2392	23	7	6	789	0	825
2393	12	8	757	42	0	819
2394	18	4	33	729	0	784
2395	5	738	16	48	0	807
2396	722	28	13	25	0	788
2397	37	739	8	19	0	803
2398	18	32	725	15	0	790
2399	14	724	31	11	0	780
2400	684	37	15	14	0	750
2401	37	697	11	8	0	753
2402	20	37	11	612	0	680
2403	13	693	8	28	0	742
2404	693	38	5	21	0	757
2405	701	18	9	16	0	744
2406	686	10	6	17	0	719
2407	44	14	679	8	0	745
2408	36	10	679	5	0	730
2409	23	9	691	9	0	732
2410	661	12	46	13	0	732
2411	37	11	25	652	0	725
2412	24	10	20	670	0	724
2413	17	8	652	48	0	725
2414	10	6	39	646	0	701
2415	606	6	19	44	0	675
2416	36	610	13	24	0	683
2417	636	25	13	17	0	691
2418	41	18	616	13	0	688
2419	634	6	34	14	0	688
2420	645	12	19	13	0	689
2421	656	9	20	7	0	692
2422	52	5	623	11	0	691
2423	34	7	34	621	0	696
2424	21	5	631	40	0	697
2425	21	5	37	633	0	696
2426	18	4	629	38	0	689
2427	18	7	37	626	0	688
2428	19	7	18	635	0	679
2429	621	9	15	38	0	683
2430	621	4	14	23	0	662
2431	637	3	10	22	0	672
2432	55	3	9	588	0	655
2433	32	559	7	39	0	637
2434	25	607	9	18	0	659
2435	597	36	8	21	0	662
2436	39	21	590	13	0	663
2437	600	14	32	14	0	660
2438	42	9	594	9	0	654
2439	611	6	33	9	0	659
2440	588	6	18	19	0	631
2441	50	3	619	8	0	680
2442	625	4	33	10	0	672
2443	637	3	21	5	0	666
2444	636	2	10	17	0	665
2445	54	603	11	7	0	675
2446	32	27	7	588	0	654
2447	24	14	597	28	0	663
2448	26	7	584	14	0	631
2449	18	555	32	13	0	618
2450	11	365	17	3	0	396
2451	16	16	11	317	0	360
2452	309	8	9	12	0	338
2453	16	319	9	9	0	353
2454	14	16	6	314	0	350
2455	10	321	5	17	0	353
2456	324	16	3	9	0	352
2457	18	10	5	311	0	344
2458	5	10	297	21	0	333
2459	7	292	15	9	0	323
2460	6	294	7	9	0	316
2461	12	10	8	261	0	291
2462	5	281	5	11	0	302
2463	9	14	2	276	0	301
2464	276	9	4	15	0	304
2465	275	10	4	8	0	297
2466	280	11	1	6	0	298
2467	280	10	2	7	0	299
2468	20	3	267	8	0	298
2469	16	252	7	4	0	279
2470	15	267	6	4	0	292
2471	4	190	4	3	0	201
2472	4	182	2	1	0	189
2473	156	1	7	1	0	165
2474	150	1	0	1	0	152
2475	153	0	0	2	0	155
2476	155	0	1	0	0	156
2477	2	0	163	0	0	165
2478	170	0	1	1	0	172
2479	178	0	0	1	0	179
2480	180	1	0	0	0	181
2481	4	0	0	178	0	182
2482	0	0	1	171	0	172
2483	172	0	1	3	0	176
2484	1	1	0	168	0	170
2485	0	179	0	1	0	180
2486	0	1	0	179	0	180
2487	1	0	0	180	0	181
2488	0	174	1	1	0	176
2489	0	1	0	180	0	181
2490	1	1	0	178	0	180
2491	174	1	0	2	0	177
2492	1	0	173	1	0	175
2493	169	0	2	0	0	171
2494	2	1	171	0	0	174
2495	0	0	162	0	0	162
2496	0	0	170	1	0	171
2497	171	1	1	2	0	175
2498	1	1	186	1	0	189
2499	181	0	1	1	0	183
2500	183	0	0	0	0	183
2501	187	0	0	2	0	189
2502	2	184	0	0	0	186
2503	184	1	1	0	0	186
2504	1	186	0	0	0	187
2505	0	2	0	184	0	186
2506	0	1	0	188	0	189
2507	0	179	1	1	0	181
2508	0	173	0	0	0	173
2509	0	181	0	0	0	181
2510	179	0	0	1	0	180
2511	0	188	1	0	0	189
2512	188	0	0	0	0	188
2513	0	1	180	0	0	181
2514	186	0	0	0	0	186
2515	191	0	0	0	0	191
2516	1	0	188	0	0	189
2517	0	0	0	182	0	182
2518	0	0	187	0	0	187
2519	0	0	0	183	0	183
2520	0	0	0	181	0	181
2521	184	0	0	0	0	184
2522	178	0	0	1	0	179
2523	0	176	0	0	0	176
2524	182	0	0	0	0	182
2525	0	0	182	0	0	182
2526	182	0	0	2	0	184
2527	0	0	198	0	0	198
2528	0	1	200	0	0	201
2529	205	0	0	0	0	205
2530	209	1	1	0	0	211
2531	1	0	225	1	0	227
2532	2	0	0	208	0	210
2533	1	1	1	221	0	224
2534	0	0	221	2	0	223
2535	0	0	0	209	0	209
2536	1	209	1	0	0	211
2537	0	0	1	227	0	228
2538	1	1	0	229	0	231
2539	0	0	222	1	0	223
2540	188	0	1	2	0	191
2541	207	0	2	2	0	211
2542	212	0	0	1	0	213
2543	207	0	1	1	0	209
2544	3	205	0	0	0	208
2545	3	0	0	195	0	198
2546	1	1	197	0	0	199
2547	1	1	201	1	0	204
2548	2	0	1	195	0	198
2549	1	1	210	0	0	212
2550	202	0	0	3	0	205
2551	0	0	1	213	0	214
2552	2	0	0	213	0	215
2553	0	1	0	215	0	216
2554	211	2	0	2	0	215
2555	1	222	1	2	0	226
2556	221	1	0	2	0	224
2557	212	2	0	1	0	215
2558	0	217	1	1	0	219
2559	0	218	0	1	0	219
2560	223	1	0	1	0	225
2561	0	1	2	226	0	229
2562	2	0	0	213	0	215
2563	218	0	2	1	0	221
2564	1	0	213	2	0	216
2565	210	0	2	2	0	214
2566	212	0	1	2	0	215
2567	2	232	1	1	0	236
2568	241	2	0	1	0	244
2569	247	0	0	2	0	249
2570	4	285	1	1	0	291
2571	2	289	0	2	0	293
2572	2	7	1	289	0	299
2573	293	3	1	4	0	301
2574	5	304	0	2	0	311
2575	5	6	1	316	0	328
2576	331	2	2	6	0	341
2577	9	1	306	4	0	320
2578	4	0	8	299	0	311
2579	1	0	300	10	0	311
2580	296	0	8	4	0	308
2581	306	2	2	1	0	311
2582	11	1	297	0	0	309
2583	6	290	8	1	0	305
2584	5	6	3	296	0	310
2585	1	5	298	6	0	310
2586	1	3	7	295	0	306
2587	2	1	2	307	0	312
2588	1	1	306	12	0	320
2589	289	0	8	5	0	302
2590	310	1	3	3	0	317
2591	11	0	306	1	0	318
2592	6	306	7	1	0	320
2593	4	9	4	288	0	305
2594	2	296	1	8	0	307
2595	3	305	0	2	0	310
2596	304	11	1	3	0	319
2597	9	5	0	307	0	321
2598	4	2	2	300	0	308
2599	1	1	297	11	0	310
2600	1	2	293	5	0	301
2601	3	2	10	285	0	300
2602	1	0	3	301	0	305
2603	3	0	291	11	0	305
2604	1	1	298	4	0	304
2605	3	0	12	293	0	308
2606	291	2	5	9	0	307
2607	11	301	2	4	0	318
2608	300	10	1	4	0	315
2609	9	299	2	1	0	311
2610	2	319	1	2	0	324
2611	300	10	0	4	0	314
2612	10	5	295	3	0	313
2613	4	0	9	300	0	313
2614	6	0	4	295	0	305
2615	3	1	5	311	0	320
2616	3	2	307	17	0	329
2617	5	0	15	304	0	324
2618	310	0	5	14	0	329
2619	11	3	2	314	0	330
2620	4	2	3	329	0	338
2621	316	4	0	15	0	335
2622	321	2	1	4	0	328
2623	13	311	1	3	0	328
2624	4	12	318	3	0	337
2625	3	4	313	4	0	324
2626	1	2	326	0	0	329
2627	3	299	16	2	0	320
2628	2	12	2	295	0	311
2629	1	1	3	316	0	321
2630	301	1	4	13	0	319
2631	11	1	3	286	0	301
2632	3	2	287	15	0	307
2633	3	2	11	288	0	304
2634	6	2	2	292	0	302
2635	4	2	282	14	0	302
2636	1	280	13	5	0	299
2637	4	12	2	247	0	265
2638	3	269	5	8	0	285
2639	0	15	274	5	0	294
2640	271	2	14	3	0	290
2641	281	3	3	3	0	290
2642	281	1	3	4	0	289
2643	15	1	2	269	0	287
2644	5	273	3	10	0	291
2645	272	11	2	6	0	291
2646	279	1	3	6	0	289
2647	272	3	0	7	0	282
2648	16	1	260	3	0	280
2649	255	0	13	4	0	272
2650	14	253	3	3	0	273
2651	249	11	3	5	0	268
2652	10	268	4	3	0	285
2653	264	12	2	5	0	283
2654	14	4	267	1	0	286
2655	258	3	13	2	0	276
2656	272	2	2	2	0	278
2657	240	1	5	4	0	250
2658	267	0	2	4	0	273
2659	14	2	255	2	0	273
2660	6	2	11	255	0	274
2661	255	1	3	12	0	271
2662	14	252	5	3	0	274
2663	6	10	1	250	0	267
2664	1	3	257	14	0	275
2665	2	2	9	254	0	267
2666	1	1	258	14	0	274
2667	5	230	11	4	0	250
2668	1	221	5	1	0	228
2669	3	224	1	3	0	231
2670	3	8	1	175	0	187
2671	2	3	2	172	0	179
2672	1	1	168	8	0	178
2673	3	158	7	1	0	169
2674	144	7	1	1	0	153
2675	8	130	0	0	0	138
2676	2	131	0	1	0	134
2677	3	5	0	127	0	135
2678	130	0	0	4	0	134
2679	131	0	1	0	0	132
2680	5	0	0	129	0	134
2681	131	0	1	4	0	136
2682	5	1	0	130	0	136
2683	0	1	129	5	0	135
2684	128	1	5	0	0	134
2685	4	1	0	132	0	137
2686	1	0	124	4	0	129
2687	0	1	123	0	0	124
2688	1	0	4	127	0	132
2689	125	1	0	5	0	131
2690	124	0	0	1	0	125
2691	4	127	0	1	0	132
2692	130	4	0	2	0	136
2693	138	1	0	3	0	142
2694	146	0	0	0	0	146
2695	3	154	0	0	0	157
2696	141	4	0	4	0	149
2697	149	0	1	1	0	151
2698	7	0	0	143	0	150
2699	144	0	1	5	0	150
2700	5	146	0	0	0	151
2701	1	148	0	2	0	151
2702	0	5	0	145	0	150
2703	0	1	1	148	0	150
2704	2	151	1	4	0	158
2705	152	4	0	2	0	158
2706	3	147	1	0	0	151
2707	146	4	1	0	0	151
2708	3	154	0	1	0	158
2709	1	5	0	150	0	156
2710	1	160	0	2	0	163
2711	160	5	1	0	0	166
2712	162	0	0	0	0	162
2713	158	0	0	0	0	158
2714	5	0	156	0	0	161
2715	0	1	142	0	0	143
2716	2	149	1	0	0	152
2717	1	1	150	0	0	152
2718	0	0	143	2	0	145
2719	1	0	1	131	0	133
2720	0	3	137	1	0	141
2721	0	142	1	1	0	144
2722	138	1	1	1	0	141
2723	1	136	0	1	0	138
2724	0	142	1	0	0	143
2725	146	2	0	1	0	149
2726	144	1	0	0	0	145
2727	1	143	3	0	0	147
2728	153	1	0	0	0	154
2729	153	0	0	1	0	154
2730	151	0	1	0	0	152
2731	1	1	147	1	0	150
2732	1	0	139	0	0	140
2733	1	2	1	132	0	136
2734	0	2	0	145	0	147
2735	146	0	0	4	0	150
2736	2	144	1	0	0	147
2737	1	1	0	149	0	151
2738	1	0	0	152	0	153
2739	1	0	0	151	0	152
2740	1	1	1	141	0	144
2741	0	0	151	2	0	153
2742	1	0	156	1	0	158
2743	0	1	2	159	0	162
2744	0	1	161	1	0	163
2745	152	0	1	1	0	154
2746	1	0	1	165	0	167
2747	2	0	162	1	0	165
2748	147	0	1	3	0	151
2749	1	159	1	0	0	161
2750	157	1	0	3	0	161
2751	3	170	0	0	0	173
2752	2	1	0	162	0	165
2753	0	2	160	2	0	164
2754	1	0	2	151	0	154
2755	2	0	155	1	0	158
2756	150	0	1	3	0	154
2757	3	0	1	157	0	161
2758	159	0	0	1	0	160
2759	1	1	158	1	0	161
2760	167	0	1	0	0	168
2761	172	1	1	0	0	174
2762	2	0	179	1	0	182
2763	1	0	2	177	0	180
2764	0	0	179	2	0	181
2765	0	179	2	1	0	182
2766	181	1	3	0	0	185
2767	177	1	0	2	0	180
2768	2	0	184	0	0	186
2769	3	0	182	0	0	185
2770	1	0	1	182	0	184
2771	1	0	1	197	0	199
2772	194	0	1	1	0	196
2773	0	198	0	2	0	200
2774	202	0	1	0	0	203
2775	203	2	0	1	0	206
2776	2	0	198	0	0	200
2777	196	0	0	1	0	197
2778	0	0	199	0	0	199
2779	1	0	1	195	0	197
2780	0	0	210	1	0	211
2781	1	0	0	213	0	214
2782	0	1	213	0	0	214
2783	208	1	0	1	0	210
2784	211	0	1	1	0	213
2785	2	0	0	209	0	211
2786	216	0	1	2	0	219
2787	1	0	0	224	0	225
2788	1	224	1	0	0	226
2789	226	0	0	4	0	230
2790	0	232	1	0	0	233
2791	0	0	0	241	0	241
2792	0	1	1	238	0	240
2793	2	0	0	228	0	230
2794	3	0	0	218	0	221
2795	0	0	218	2	0	220
2796	203	0	0	1	0	204
2797	218	0	1	1	0	220
2798	1	216	2	0	0	219
2799	2	0	0	223	0	225
2800	0	2	0	220	0	222
2801	0	0	218	2	0	220
2802	199	0	0	4	0	203
2803	2	0	1	213	0	216
2804	1	0	208	1	0	210
2805	209	0	1	5	0	215
2806	219	0	1	0	0	220
2807	221	0	0	0	0	221
2808	0	1	214	0	0	215
2809	1	0	214	0	0	215
2810	213	0	1	2	0	216
2811	0	0	2	215	0	217
2812	4	0	0	216	0	220
2813	0	0	214	2	0	216
2814	208	0	1	1	0	210
2815	1	0	1	219	0	221
2816	233	0	0	1	0	234
2817	231	0	0	3	0	234
2818	235	0	0	1	0	236
2819	1	0	239	0	0	240
2820	2	0	0	232	0	234
2821	239	0	1	2	0	242
2822	0	248	0	4	0	252
2823	2	0	1	252	0	255
2824	1	2	0	252	0	255
2825	247	0	0	3	0	250
2826	243	0	0	3	0	246
2827	3	0	0	246	0	249
2828	3	0	242	0	0	245
2829	235	0	1	3	0	239
2830	0	0	248	1	0	249
2831	245	0	0	2	0	247
2832	244	1	3	2	0	250
2833	3	1	246	1	0	251
2834	2	0	0	252	0	254
2835	1	1	259	0	0	261
2836	1	265	0	4	0	270
2837	0	1	3	264	0	268
2838	0	262	1	0	0	263
2839	2	0	0	271	0	273
2840	0	3	271	0	0	274
2841	2	269	1	3	0	275
2842	0	270	3	0	0	273
2843	1	3	0	266	0	270
2844	267	3	1	3	0	274
2845	7	0	0	292	0	299
2846	299	0	0	6	0	305
2847	2	301	0	4	0	307
2848	338	2	0	5	0	345
2849	5	4	341	0	0	350
2850	4	2	4	343	0	353
2851	4	0	4	331	0	339
2852	0	1	329	6	0	336
2853	314	0	4	7	0	325
2854	325	0	6	5	0	336
2855	9	328	0	1	0	338
2856	7	6	0	299	0	312
2857	2	323	3	5	0	333
2858	2	5	317	3	0	327
2859	1	7	309	4	0	321
2860	2	3	8	305	0	318
2861	296	2	6	11	0	315
2862	7	298	1	5	0	311
2863	304	5	1	2	0	312
2864	6	6	299	2	0	313
2865	301	2	4	3	0	310
2866	304	2	6	3	0	315
2867	11	3	301	0	0	315
2868	8	2	7	293	0	310
2869	291	1	5	9	0	306
2870	300	1	2	7	0	310
2871	307	2	2	4	0	315
2872	15	0	3	299	0	317
2873	6	0	283	6	0	295
2874	296	3	5	8	0	312
2875	11	0	302	3	0	316
2876	6	5	8	297	0	316
2877	7	0	7	288	0	302
2878	4	297	5	8	0	314
2879	4	5	290	7	0	306
2880	6	283	5	5	0	299
2881	0	294	11	2	0	307
2882	5	9	3	291	0	308
2883	4	6	292	7	0	309
2884	6	4	7	289	0	306
2885	4	2	296	11	0	313
2886	2	4	10	291	0	307
2887	3	4	7	295	0	309
2888	7	3	283	9	0	302
2889	2	3	7	289	0	301
2890	5	1	280	11	0	297
2891	1	2	274	12	0	289
2892	5	271	13	4	0	293
2893	275	5	10	3	0	293
2894	8	7	276	4	0	295
2895	264	4	6	7	0	281
2896	7	1	11	276	0	295
2897	5	8	271	7	0	291
2898	4	268	11	6	0	289
2899	7	6	10	267	0	290
2900	5	7	273	8	0	293
2901	6	4	4	257	0	271
2902	3	266	13	7	0	289
2903	265	7	4	7	0	283
2904	7	5	7	274	0	293
2905	260	2	5	10	0	277
2906	268	2	3	14	0	287
2907	267	3	7	5	0	282
2908	275	1	5	8	0	289
2909	264	2	4	5	0	275
2910	16	251	3	5	0	275
2911	11	9	3	254	0	277
2912	9	4	2	260	0	275
2913	9	3	5	263	0	280
2914	10	1	254	11	0	276
2915	7	250	8	7	0	272
2916	252	8	7	7	0	274
2917	253	10	5	5	0	273
2918	12	250	3	10	0	275
2919	6	253	9	4	0	272
2920	246	14	4	9	0	273
2921	12	10	242	3	0	267
2922	11	3	10	230	0	254
2923	236	2	8	10	0	256
2924	12	6	3	226	0	247
2925	10	234	3	11	0	258
2926	7	8	3	243	0	261
2927	4	5	236	11	0	256
2928	231	2	10	13	0	256
2929	240	3	9	4	0	256
2930	10	2	4	234	0	250
2931	9	3	2	238	0	252
2932	230	1	3	14	0	248
2933	10	224	7	6	0	247
2934	8	8	4	222	0	242
2935	10	0	4	225	0	239
2936	198	3	3	13	0	217
2937	12	206	3	5	0	226
2938	206	11	1	4	0	222
2939	10	192	2	4	0	208
2940	4	197	2	7	0	210
2941	185	6	3	5	0	199
2942	9	197	1	9	0	216
2943	4	8	7	189	0	208
2944	3	3	196	10	0	212
2945	0	2	168	4	0	174
2946	1	2	168	2	0	173
2947	2	157	4	2	0	165
2948	108	8	2	1	0	119
2949	2	0	0	108	0	110
2950	0	0	1	109	0	110
2951	0	0	106	2	0	108
2952	108	0	3	0	0	111
2953	2	1	0	109	0	112
2954	2	0	0	111	0	113
2955	1	0	0	112	0	113
2956	111	0	0	3	0	114
2957	2	0	118	0	0	120
2958	123	0	2	0	0	125
2959	2	0	0	126	0	128
2960	0	0	123	3	0	126
2961	121	0	2	1	0	124
2962	3	0	123	0	0	126
2963	2	0	2	117	0	121
2964	0	0	121	2	0	123
2965	0	0	118	0	0	118
2966	115	0	3	0	0	118
2967	3	0	115	0	0	118
2968	0	1	2	117	0	120
2969	115	1	0	3	0	119
2970	4	0	0	114	0	118
2971	0	0	117	2	0	119
2972	0	0	108	1	0	109
2973	1	126	2	0	0	129
2974	1	2	0	121	0	124
2975	117	1	1	5	0	124
2976	2	112	0	1	0	115
2977	119	2	1	1	0	123
2978	3	0	0	120	0	123
2979	122	0	0	2	0	124
2980	2	119	0	1	0	122
2981	0	2	0	122	0	124
2982	121	0	0	1	0	122
2983	2	118	0	0	0	120
2984	0	2	0	123	0	125
2985	1	0	0	120	0	121
2986	129	1	0	3	0	133
2987	5	1	0	129	0	135
2988	2	0	0	132	0	134
2989	2	0	0	135	0	137
2990	0	2	130	2	0	134
2991	125	0	1	1	0	127
2992	4	1	0	145	0	150
2993	0	1	152	4	0	157
2994	145	0	4	1	0	150
2995	3	0	153	0	0	156
2996	1	0	4	151	0	156
2997	1	162	0	4	0	167
2998	1	2	1	166	0	170
2999	0	0	161	6	0	167
3000	1	1	164	1	0	167
3001	1	0	4	168	0	173
3002	1	0	167	4	0	172
3003	155	0	5	4	0	164
3004	4	1	162	2	0	169
3005	0	0	4	153	0	157
3006	2	0	0	158	0	160
3007	0	1	3	157	0	161
3008	156	0	0	6	0	162
3009	153	0	2	2	0	157
3010	157	0	2	2	0	161
3011	4	1	0	155	0	160
3012	1	0	2	158	0	161
3013	2	0	154	2	0	158
3014	0	0	156	1	0	157
3015	0	155	3	3	0	161
3016	4	2	2	145	0	153
3017	1	0	1	145	0	147
3018	1	148	1	1	0	151
3019	150	1	0	2	0	153
3020	2	151	0	2	0	155
3021	150	2	0	3	0	155
3022	3	0	0	153	0	156
3023	153	1	1	1	0	156
3024	3	0	1	152	0	156
3025	0	1	147	3	0	151
3026	2	0	1	148	0	151
3027	147	0	1	2	0	150
3028	1	1	1	142	0	145
3029	1	1	0	145	0	147
3030	1	1	144	2	0	148
3031	1	0	1	142	0	144
3032	0	1	0	141	0	142
3033	2	142	1	1	0	146
3034	0	2	0	145	0	147
3035	1	0	0	144	0	145
3036	0	0	0	143	0	143
3037	2	138	0	1	0	141
3038	0	1	0	139	0	140
3039	132	0	1	5	0	138
3040	1	133	1	1	0	136
3041	2	130	0	2	0	134
3042	1	129	0	3	0	133
3043	0	3	0	124	0	127
3044	1	119	1	2	0	123
3045	0	121	3	3	0	127
3046	117	1	2	6	0	126
3047	4	3	116	0	0	123
3048	122	1	5	5	0	133
3049	5	2	1	123	0	131
3050	0	3	123	4	0	130
3051	123	1	3	6	0	133
3052	1	3	122	2	0	128
3053	2	0	118	5	0	125
3054	125	2	6	3	0	136
3055	3	2	5	126	0	136
3056	3	1	122	3	0	129
3057	113	0	7	3	0	123
3058	117	0	0	6	0	123
3059	2	1	116	5	0	124
3060	117	0	2	4	0	123
3061	116	0	1	3	0	120
3062	6	0	110	3	0	119
3063	114	0	3	3	0	120
3064	113	0	1	5	0	119
3065	3	1	108	3	0	115
3066	1	0	126	3	0	130
3067	2	2	3	121	0	128
3068	2	2	124	3	0	131
3069	116	0	5	7	0	128
3070	2	5	0	116	0	123
3071	7	3	1	115	0	126
3072	5	2	115	2	0	124
3073	4	5	2	107	0	118
3074	5	1	102	5	0	113
3075	107	2	3	3	0	115
3076	110	0	1	4	0	115
3077	3	0	103	5	0	111
3078	102	0	4	4	0	110
3079	105	0	0	6	0	111
3080	4	1	106	1	0	112
3081	105	0	1	9	0	115
3082	106	0	2	5	0	113
3083	2	1	110	4	0	117
3084	105	0	1	8	0	114
3085	2	2	107	5	0	116
3086	0	2	3	98	0	103
3087	2	0	0	101	0	103
3088	0	1	2	102	0	105
3089	1	2	93	6	0	102
3090	88	3	1	5	0	97
3091	4	0	92	6	0	102
3092	3	76	1	0	0	80
3093	1	69	0	0	0	70
3094	66	0	0	0	0	66
3095	0	0	0	67	0	67
3096	0	69	0	0	0	69
3097	58	0	0	0	0	58
3098	58	0	0	0	0	58
3099	0	61	0	0	0	61
3100	0	0	0	60	0	60
3101	0	61	0	0	0	61
3102	61	0	0	0	0	61
3103	61	0	0	0	0	61
3104	0	0	0	60	0	60
3105	60	0	0	0	0	60
3106	0	0	0	58	0	58
3107	0	0	59	0	0	59
3108	59	0	0	0	0	59
3109	0	0	60	0	0	60
3110	0	0	0	60	0	60
3111	58	0	0	1	0	59
3112	0	0	0	60	0	60
3113	0	0	59	0	0	59
3114	1	0	56	0	0	57
3115	0	0	1	54	0	55
3116	45	0	1	2	0	48
3117	1	63	0	0	0	64
3118	1	1	0	64	0	66
3119	0	0	62	1	0	63
3120	61	2	1	0	0	64
3121	64	0	0	2	0	66
3122	1	0	62	0	0	63
3123	62	0	1	1	0	64
3124	2	0	0	63	0	65
3125	0	0	64	0	0	64
3126	62	0	2	0	0	64
3127	0	0	0	64	0	64
3128	0	0	1	62	0	63
3129	63	0	0	3	0	66
3130	1	62	0	1	0	64
3131	0	68	0	1	0	69
3132	70	1	1	0	0	72
3133	64	0	0	2	0	66
3134	1	0	72	0	0	73
3135	1	0	68	0	0	69
3136	1	0	1	68	0	70
3137	70	0	1	1	0	72
3138	69	0	0	0	0	69
3139	70	0	0	1	0	71
3140	1	69	1	0	0	71
3141	1	69	0	0	0	70
3142	1	1	0	68	0	70
3143	0	0	1	69	0	70
3144	2	0	0	70	0	72
3145	0	0	76	1	0	77
3146	0	0	69	1	0	70
3147	74	0	1	1	0	76
3148	70	0	0	1	0	71
3149	1	0	1	70	0	72
3150	1	0	0	70	0	71
3151	0	0	1	72	0	73
3152	0	0	70	1	0	71
3153	0	1	67	0	0	68
3154	1	0	1	76	0	78
3155	0	0	82	1	0	83
3156	0	78	1	0	0	79
3157	0	81	0	0	0	81
3158	79	2	0	1	0	82
3159	2	83	0	0	0	85
3160	1	2	0	84	0	87
3161	1	0	0	86	0	87
3162	0	87	0	2	0	89
3163	1	2	0	86	0	89
3164	0	0	87	1	0	88
3165	1	84	1	0	0	86
3166	2	2	0	71	0	75
3167	0	0	77	0	0	77
3168	1	82	2	0	0	85
3169	0	2	0	82	0	84
3170	0	81	2	2	0	85
3171	2	2	0	80	0	84
3172	1	0	0	80	0	81
3173	0	79	1	3	0	83
3174	81	2	0	0	0	83
3175	81	0	0	1	0	82
3176	2	80	0	0	0	82
3177	2	83	0	0	0	85
3178	1	2	0	81	0	84
3179	0	0	81	2	0	83
3180	75	1	1	0	0	77
3181	79	0	0	2	0	81
3182	3	1	83	0	0	87
3183	77	0	1	0	0	78
3184	87	0	0	0	0	87
3185	3	1	78	0	0	82
3186	80	1	2	0	0	83
3187	1	0	84	3	0	88
3188	1	83	2	1	0	87
3189	85	2	0	1	0	88
3190	87	0	0	1	0	88
3191	1	0	88	1	0	90
3192	85	1	2	0	0	88
3193	89	1	0	1	0	91
3194	2	1	89	2	0	94
3195	86	0	1	2	0	89
3196	91	0	1	1	0	93
3197	2	0	86	0	0	88
3198	85	0	3	2	0	90
3199	4	0	0	85	0	89
3200	1	0	1	90	0	92
3201	1	0	84	3	0	88
3202	0	0	85	1	0	86
3203	2	0	2	85	0	89
3204	0	2	1	89	0	92
3205	89	0	0	5	0	94
3206	2	0	90	2	0	94
3207	89	2	1	2	0	94
3208	3	1	1	95	0	100
3209	1	0	100	2	0	103
3210	102	2	2	0	0	106
3211	4	0	0	105	0	109
3212	0	0	103	4	0	107
3213	106	2	2	1	0	111
3214	1	0	0	115	0	116
3215	113	1	1	1	0	116
3216	1	1	126	1	0	129
3217	1	1	1	111	0	114
3218	0	120	0	1	0	121
3219	129	1	0	0	0	130
3220	128	0	0	0	0	128
3221	2	125	0	0	0	127
3222	132	2	0	0	0	134
3223	132	0	0	0	0	132
3224	130	0	0	1	0	131
3225	2	129	0	0	0	131
3226	0	2	0	131	0	133
3227	0	0	131	2	0	133
3228	2	0	2	126	0	130
3229	1	2	0	122	0	125
3230	0	0	132	2	0	134
3231	0	1	121	0	0	122
3232	1	0	2	118	0	121
3233	0	127	0	1	0	128
3234	127	2	0	0	0	129
3235	129	0	0	0	0	129
3236	2	131	0	0	0	133
3237	132	2	0	0	0	134
3238	135	0	0	0	0	135
3239	2	0	137	0	0	139
3240	128	0	2	0	0	130
3241	2	138	0	0	0	140
3242	0	2	135	0	0	137
3243	0	0	131	0	0	131
3244	0	131	2	0	0	133
3245	131	2	0	1	0	134
3246	2	0	133	0	0	135
3247	0	0	2	133	0	135
3248	0	0	133	2	0	135
3249	126	0	2	0	0	128
3250	2	0	149	0	0	151
3251	0	0	145	0	0	145
3252	146	0	2	0	0	148
3253	2	157	0	0	0	159
3254	156	1	0	0	0	157
3255	149	0	0	0	0	149
3256	1	0	0	149	0	150
3257	0	166	0	1	0	167
3258	165	1	0	1	0	167
3259	1	0	167	0	0	168
3260	163	0	1	0	0	164
3261	1	175	0	0	0	176
3262	172	1	1	2	0	176
3263	177	0	0	1	0	178
3264	1	177	0	1	0	179
3265	1	1	0	177	0	179
3266	175	0	1	2	0	178
3267	1	172	0	1	0	174
3268	0	2	0	172	0	174
3269	180	0	0	2	0	182
3270	3	0	0	188	0	191
3271	0	1	1	187	0	189
3272	2	182	0	1	0	185
3273	186	1	0	4	0	191
3274	184	0	1	2	0	187
3275	191	1	0	1	0	193
3276	1	194	0	2	0	197
3277	197	1	1	1	0	200
3278	199	0	0	1	0	200
3279	1	0	0	196	0	197
3280	1	0	1	199	0	201
3281	0	0	202	1	0	203
3282	1	0	2	192	0	195
3283	1	3	0	193	0	197
3284	2	0	200	1	0	203
3285	180	0	1	2	0	183
3286	1	2	202	0	0	205
3287	2	0	220	0	0	222
3288	3	0	1	221	0	225
3289	2	0	1	218	0	221
3290	1	229	1	0	0	231
3291	230	2	1	3	0	236
3292	230	0	2	1	0	233
3293	1	234	2	1	0	238
3294	1	260	0	1	0	262
3295	1	1	2	251	0	255
3296	1	253	2	1	0	257
3297	256	2	1	2	0	261
3298	257	1	1	0	0	259
3299	3	0	1	254	0	258
3300	2	2	2	253	0	259
3301	256	1	1	2	0	260
3302	5	2	241	0	0	248
3303	245	1	1	3	0	250
3304	3	0	252	1	0	256
3305	240	0	1	1	0	242
3306	2	1	1	251	0	255
3307	2	1	252	1	0	256
3308	0	0	249	0	0	249
3309	242	0	1	1	0	244
3310	241	0	1	2	0	244
3311	2	259	1	0	0	262
3312	1	1	1	258	0	261
3313	1	1	0	261	0	263
3314	255	0	0	4	0	259
3315	2	255	0	1	0	258
3316	247	2	0	1	0	250
3317	1	239	0	2	0	242
3318	2	243	0	0	0	245
3319	239	1	0	1	0	241
3320	1	0	230	0	0	231
3321	0	2	0	230	0	232
3322	3	1	0	223	0	227
3323	2	4	230	1	0	237
3324	1	0	1	228	0	230
3325	1	2	0	202	0	205
3326	3	229	0	0	0	232
3327	243	0	1	1	0	245
3328	2	0	240	1	0	243
3329	229	2	0	2	0	233
3330	1	236	1	0	0	238
3331	2	0	0	243	0	245
3332	259	0	1	3	0	263
3333	3	0	1	262	0	266
3334	2	2	1	259	0	264
3335	2	0	259	2	0	263
3336	246	1	1	3	0	251
3337	260	1	1	2	0	264
3338	2	0	267	1	0	270
3339	0	1	3	266	0	270
3340	1	0	264	1	0	266
3341	265	0	0	2	0	267
3342	266	0	2	3	0	271
3343	0	1	0	269	0	270
3344	270	0	1	2	0	273
3345	2	1	288	0	0	291
3346	4	0	0	291	0	295
3347	1	1	1	279	0	282
3348	3	0	0	290	0	293
3349	1	3	1	284	0	289
3350	269	0	0	6	0	275
3351	3	0	262	1	0	266
3352	2	0	1	267	0	270
3353	0	0	263	4	0	267
3354	2	0	255	0	0	257
3355	3	0	3	258	0	264
3356	2	1	0	267	0	270
3357	250	0	3	1	0	254
3358	3	0	0	258	0	261
3359	1	0	1	262	0	264
3360	2	0	1	268	0	271
3361	273	0	1	2	0	276
3362	260	0	0	4	0	264
3363	278	0	0	2	0	280
3364	275	1	1	4	0	281
3365	2	290	0	2	0	294
3366	1	3	0	300	0	304
3367	4	0	0	301	0	305
3368	309	1	0	4	0	314
3369	4	320	0	0	0	324
3370	1	5	1	332	0	339
3371	1	1	346	7	0	355
3372	364	0	6	2	0	372
3373	8	394	3	1	0	406
3374	396	8	0	2	0	406
3375	405	1	1	3	0	410
3376	11	0	0	407	0	418
3377	2	1	404	11	0	418
3378	4	0	9	407	0	420
3379	411	0	1	10	0	422
3380	13	0	0	413	0	426
3381	412	0	0	10	0	422
3382	10	409	0	2	0	421
3383	430	10	0	2	0	442
3384	11	3	0	430	0	444
3385	6	0	0	452	0	458
3386	449	1	0	12	0	462
3387	451	1	0	2	0	454
3388	455	1	0	2	0	458
3389	456	0	0	2	0	458
3390	446	0	2	1	0	449
3391	16	0	1	432	0	449
3392	2	1	424	12	0	439
3393	2	424	10	1	0	437
3394	409	9	2	2	0	422
3395	11	2	407	2	0	422
3396	403	2	10	1	0	416
3397	11	405	2	1	0	419
3398	416	10	1	1	0	428
3399	13	2	0	410	0	425
3400	7	1	0	416	0	424
3401	1	1	419	12	0	433
3402	5	0	8	416	0	429
3403	3	0	433	10	0	446
3404	3	0	423	3	0	429
3405	435	0	13	2	0	450
3406	442	2	2	1	0	447
3407	15	1	435	1	0	452
3408	433	0	10	1	0	444
3409	447	0	3	3	0	453
3410	14	0	426	1	0	441
3411	4	423	10	2	0	439
3412	3	10	2	464	0	479
3413	481	1	0	13	0	495
3414	499	0	0	6	0	505
3415	505	1	3	5	0	514
3416	497	0	1	5	0	503
3417	489	1	8	3	0	501
3418	14	0	485	3	0	502
3419	4	1	492	0	0	497
3420	8	1	12	486	0	507
3421	495	2	4	11	0	512
3422	505	2	0	5	0	512
3423	507	2	1	2	0	512
3424	480	0	2	5	0	487
3425	15	477	3	2	0	497
3426	1	527	2	6	0	536
3427	518	12	3	3	0	536
3428	518	4	1	7	0	530
3429	19	519	1	2	0	541
3430	522	12	0	7	0	541
3431	16	4	512	2	0	534
3432	10	2	12	501	0	525
3433	5	0	514	13	0	532
3434	4	1	514	8	0	527
3435	11	1	13	509	0	534
3436	11	0	3	522	0	536
3437	8	0	546	15	0	569
3438	11	0	11	521	0	543
3439	9	2	4	543	0	558
3440	553	1	1	19	0	574
3441	560	3	3	8	0	574
3442	21	2	2	542	0	567
3443	8	4	552	9	0	573
3444	6	545	11	6	0	568
3445	527	12	8	5	0	552
3446	16	6	550	4	0	576
3447	9	532	12	3	0	556
3448	5	568	4	8	0	585
3449	570	12	3	7	0	592
3450	575	6	2	8	0	591
3451	21	0	5	572	0	598
3452	8	0	597	15	0	620
3453	4	1	15	596	0	616
3454	11	1	5	592	0	609
3455	16	1	4	601	0	622
3456	598	1	4	18	0	621
3457	16	581	4	3	0	604
3458	9	645	6	3	0	663
3459	7	15	4	624	0	650
3460	3	7	4	642	0	656
3461	627	3	1	18	0	649
3462	619	1	2	10	0	632
3463	618	0	1	4	0	623
3464	24	604	4	0	0	632
3465	601	9	2	4	0	616
3466	18	7	4	586	0	615
3467	6	1	594	10	0	611
3468	3	1	551	7	0	562
3469	527	0	9	7	0	543
3470	9	1	537	4	0	551
3471	11	0	499	1	0	511
3472	460	2	8	0	0	470
3473	4	0	455	3	0	462
3474	3	2	451	1	0	457
3475	1	3	5	437	0	446
3476	3	0	463	2	0	468
3477	3	0	3	431	0	437
3478	0	2	4	436	0	442
3479	1	2	462	3	0	468
3480	3	473	1	3	0	480
3481	470	1	4	3	0	478
3482	2	2	495	1	0	500
3483	2	0	479	2	0	483
3484	423	1	9	1	0	434
3485	1	3	466	1	0	471
3486	3	458	2	1	0	464
3487	1	439	3	0	0	443
3488	1	3	1	460	0	465
3489	1	4	0	457	0	462
3490	476	0	0	5	0	481
3491	464	0	0	5	0	469
3492	471	0	0	3	0	474
3493	3	0	1	476	0	480
3494	478	0	0	4	0	482
3495	468	1	0	6	0	475
3496	4	0	472	1	0	477
3497	3	1	443	1	0	448
3498	0	469	3	1	0	473
3499	1	2	2	474	0	479
3500	485	2	3	2	0	492
3501	1	483	1	3	0	488
3502	4	1	0	505	0	510
3503	490	2	0	4	0	496
3504	485	0	1	4	0	490
3505	3	488	0	0	0	491
3506	487	1	0	2	0	490
3507	487	2	1	3	0	493
3508	4	0	1	484	0	489
3509	2	1	485	2	0	490
3510	1	474	2	2	0	479
3511	0	482	3	0	0	485
3512	459	2	1	1	0	463
3513	1	1	1	461	0	464
3514	1	0	459	2	0	462
3515	1	456	2	2	0	461
3516	457	3	3	2	0	465
3517	454	2	0	3	0	459
3518	4	1	461	0	0	466
3519	1	0	3	454	0	458
3520	1	0	1	462	0	464
3521	2	0	491	4	0	497
3522	481	2	3	5	0	491
3523	610	0	2	2	0	614
3524	10	0	1	725	0	736
3525	5	734	1	14	0	754
3526	6	18	0	750	0	774
3527	0	5	743	22	0	770
3528	725	6	18	6	0	755
3529	20	1	3	755	0	779
3530	5	2	743	20	0	770
3531	727	1	18	9	0	755
3532	20	2	7	749	0	778
3533	11	0	7	749	0	767
3534	737	1	1	25	0	764
3535	20	745	2	14	0	781
3536	737	18	3	10	0	768
3537	27	5	2	726	0	760
3538	711	6	0	24	0	741
3539	26	1	707	8	0	742
3540	7	705	14	9	0	735
3541	12	20	4	711	0	747
3542	711	5	7	25	0	748
3543	22	713	2	9	0	746
3544	12	25	5	732	0	774
3545	738	8	2	30	0	778
3546	718	10	4	15	0	747
3547	32	9	1	692	0	734
3548	13	7	689	29	0	738
3549	16	5	687	13	0	721
3550	685	3	26	14	0	728
3551	27	671	14	14	0	726
3552	12	687	15	11	0	725
3553	679	19	12	10	0	720
3554	29	691	5	9	0	734
3555	17	27	4	680	0	728
3556	18	18	1	715	0	752
3557	699	14	1	37	0	751
3558	666	13	7	21	0	707
3559	690	6	4	17	0	717
3560	34	5	664	18	0	721
3561	25	5	20	675	0	725
3562	22	6	673	22	0	723
3563	16	10	661	14	0	701
3564	12	7	676	17	0	712
3565	16	6	28	670	0	720
3566	9	10	676	26	0	721
3567	14	3	687	15	0	719
3568	12	3	30	669	0	714
3569	679	2	20	28	0	729
3570	25	5	673	13	0	716
3571	16	4	35	646	0	701
3572	20	7	15	676	0	718
3573	18	7	671	27	0	723
3574	11	13	28	660	0	712
3575	11	10	651	33	0	705
3576	12	6	26	647	0	691
3577	12	8	13	665	0	698
3578	14	2	14	674	0	704
3579	13	3	14	655	0	685
3580	616	0	14	40	0	670
3581	623	2	12	25	0	662
3582	27	7	596	25	0	655
3583	16	574	30	20	0	640
3584	19	16	598	12	0	645
3585	12	7	604	9	0	632
3586	571	8	36	15	0	630
3587	21	592	25	14	0	652
3588	594	20	23	17	0	654
3589	32	594	23	10	0	659
3590	610	25	11	16	0	662
3591	628	10	10	17	0	665
3592	37	11	11	586	0	645
3593	16	606	11	27	0	660
3594	21	20	11	606	0	658
3595	15	8	14	620	0	657
3596	8	10	583	38	0	639
3597	11	583	25	26	0	645
3598	13	21	15	597	0	646
3599	575	10	12	44	0	641
3600	602	8	11	30	0	651
3601	600	9	12	22	0	643
3602	40	578	6	18	0	642
3603	608	17	9	13	0	647
3604	38	630	13	13	0	694
3605	22	29	16	643	0	710
3606	17	18	643	27	0	705
3607	16	12	34	629	0	691
3608	8	642	15	32	0	697
3609	11	26	11	636	0	684
3610	18	12	10	657	0	697
3611	17	644	8	35	0	704
3612	649	33	6	22	0	710
3613	35	9	7	643	0	694
3614	15	14	621	39	0	689
3615	15	10	28	632	0	685
3616	13	11	14	651	0	689
3617	8	4	639	43	0	694
3618	7	12	31	606	0	656
3619	6	622	13	39	0	680
3620	9	32	635	23	0	699
3621	19	7	612	17	0	655
3622	18	576	26	8	0	628
3623	10	488	10	6	0	514
3624	4	343	5	3	0	355
3625	313	10	9	2	0	334
3626	303	14	1	3	0	321
3627	305	5	1	2	0	313
3628	10	5	2	305	0	322
3629	5	1	298	9	0	313
3630	7	1	7	298	0	313
3631	6	0	2	309	0	317
3632	299	1	1	11	0	312
3633	304	2	2	1	0	309
3634	9	295	1	10	0	315
3635	297	9	2	6	0	314
3636	304	1	0	2	0	307
3637	309	1	0	1	0	311
3638	10	1	293	0	0	304
3639	8	1	292	1	0	302
3640	1	4	9	286	0	300
3641	1	1	284	9	0	295
3642	278	0	9	3	0	290
3643	275	1	2	5	0	283
3644	9	2	261	2	0	274
3645	254	1	8	4	0	267
3646	8	268	0	4	0	280
3647	270	9	1	3	0	283
3648	10	3	0	273	0	286
3649	10	0	1	260	0	271
3650	2	260	1	8	0	271
3651	264	10	1	3	0	278
3652	267	1	2	4	0	274
3653	9	268	2	1	0	280
3654	6	9	2	252	0	269
3655	1	2	2	262	0	267
3656	1	259	1	11	0	272
3657	1	12	2	250	0	265
3658	4	9	1	253	0	267
3659	251	4	0	11	0	266
3660	246	2	1	4	0	253
3661	13	3	239	0	0	255
3662	243	1	8	4	0	256
3663	12	1	241	1	0	255
3664	5	0	10	240	0	255
3665	1	1	240	12	0	254
3666	2	237	10	4	0	253
3667	5	9	1	233	0	248
3668	5	3	0	239	0	247
3669	236	1	2	10	0	249
3670	10	2	0	230	0	242
3671	4	2	223	9	0	238
3672	227	1	10	3	0	241
3673	237	1	2	1	0	241
3674	242	2	1	1	0	246
3675	239	2	3	1	0	245
3676	14	0	3	235	0	252
3677	5	3	1	243	0	252
3678	2	1	2	258	0	263
3679	3	1	1	267	0	272
3680	258	1	2	11	0	272
3681	258	1	1	2	0	262
3682	14	1	0	242	0	257
3683	2	248	1	11	0	262
3684	245	9	3	1	0	258
3685	9	3	245	1	0	258
3686	3	248	8	2	0	261
3687	233	9	0	0	0	242
3688	10	235	0	1	0	246
3689	3	8	226	2	0	239
3690	226	3	8	1	0	238
3691	234	0	1	2	0	237
3692	10	0	223	3	0	236
3693	2	1	8	228	0	239
3694	2	0	2	228	0	232
3695	2	220	0	11	0	233
3696	3	9	2	225	0	239
3697	221	2	1	9	0	233
3698	8	218	2	3	0	231
3699	3	8	2	207	0	220
3700	5	2	1	210	0	218
3701	0	1	203	11	0	215
3702	1	203	10	1	0	215
3703	182	9	1	6	0	198
3704	5	143	0	2	0	150
3705	1	131	1	0	0	133
3706	132	5	0	0	0	137
3707	6	1	0	130	0	137
3708	2	0	0	135	0	137
3709	131	0	0	6	0	137
3710	4	0	0	134	0	138
3711	1	0	0	138	0	139
3712	134	0	0	6	0	140
3713	4	0	0	128	0	132
3714	2	132	0	4	0	138
3715	133	4	0	2	0	139
3716	4	1	131	2	0	138
3717	1	116	4	0	0	121
3718	2	4	1	123	0	130
3719	0	0	109	2	0	111
3720	0	0	98	1	0	99
3721	0	2	2	87	0	91
3722	87	0	0	2	0	89
3723	3	0	0	84	0	87
3724	0	0	0	88	0	88
3725	0	0	0	87	0	87
3726	0	0	0	86	0	86
3727	0	0	0	85	0	85
3728	0	0	83	2	0	85
3729	0	0	84	0	0	84
3730	0	0	2	80	0	82
3731	0	0	82	2	0	84
3732	0	85	2	0	0	87
3733	0	2	0	85	0	87
3734	0	0	84	2	0	86
3735	79	0	2	0	0	81
3736	2	80	0	0	0	82
3737	1	83	0	0	0	84
3738	0	81	0	0	0	81
3739	1	2	1	79	0	83
3740	82	0	0	3	0	85
3741	2	0	0	83	0	85
3742	78	0	0	2	0	80
3743	4	77	0	0	0	81
3744	78	2	0	1	0	81
3745	2	1	0	78	0	81
3746	2	0	0	80	0	82
3747	0	81	1	2	0	84
3748	1	3	0	81	0	85
3749	2	0	0	84	0	86
3750	0	1	0	84	0	85
3751	72	1	1	3	0	77
3752	70	0	0	0	0	70
3753	3	1	86	0	0	90
3754	86	1	3	1	0	91
3755	3	0	81	1	0	85
3756	0	2	2	88	0	92
3757	0	1	0	89	0	90
3758	1	0	0	89	0	90
3759	1	0	87	3	0	91
3760	2	2	3	81	0	88
3761	1	1	86	4	0	92
3762	1	1	2	87	0	91
3763	86	2	1	3	0	92
3764	2	1	85	1	0	89
3765	92	1	2	1	0	96
3766	5	2	0	86	0	93
3767	89	2	0	3	0	94
3768	3	90	0	2	0	95
3769	1	2	0	88	0	91
3770	2	0	87	4	0	93
3771	3	0	2	91	0	96
3772	1	1	0	94	0	96
3773	1	94	0	5	0	100
3774	1	1	87	1	0	90
3775	0	89	2	1	0	92
3776	82	3	0	2	0	87
3777	2	79	1	0	0	82
3778	66	1	1	0	0	68
3779	61	0	1	1	0	63
3780	61	1	0	0	0	62
3781	1	0	0	59	0	60
3782	0	0	57	2	0	59
3783	0	0	1	64	0	65
3784	0	63	1	3	0	67
3785	1	1	0	67	0	69
3786	67	0	1	2	0	70
3787	1	62	1	1	0	65
3788	0	1	0	64	0	65
3789	0	0	1	63	0	64
3790	59	1	0	2	0	62
3791	1	0	61	1	0	63
3792	0	60	3	0	0	63
3793	0	1	0	55	0	56
3794	0	0	52	0	0	52
3795	0	0	0	49	0	49
3796	0	55	0	0	0	55
3797	0	0	0	55	0	55
3798	0	0	0	55	0	55
3799	0	0	0	53	0	53
3800	0	0	54	0	0	54
3801	54	0	0	0	0	54
3802	0	0	0	57	0	57
3803	58	0	0	0	0	58
3804	57	0	0	0	0	57
3805	61	0	0	1	0	62
3806	62	0	0	0	0	62
3807	64	0	0	0	0	64
3808	0	0	0	63	0	63
3809	0	58	0	0	0	58
3810	0	0	0	63	0	63
3811	0	61	0	0	0	61
3812	0	0	0	61	0	61
3813	61	0	0	0	0	61
3814	0	0	0	59	0	59
3815	0	0	62	0	0	62
3816	59	0	0	0	0	59
3817	0	60	0	0	0	60
3818	60	0	0	0	0	60
3819	57	0	0	0	0	57
3820	59	0	0	0	0	59
3821	0	62	0	0	0	62
3822	0	0	0	62	0	62
3823	0	0	0	61	0	61
3824	0	0	64	0	0	64
3825	0	0	0	62	0	62
3826	0	0	0	63	0	63
3827	0	0	0	63	0	63
3828	0	61	0	0	0	61
3829	63	0	0	0	0	63
3830	63	0	0	1	0	64
3831	0	0	73	0	0	73
3832	0	72	0	0	0	72
3833	0	0	0	71	0	71
3834	0	0	0	72	0	72
3835	0	0	0	78	0	78
3836	0	0	1	75	0	76
3837	0	0	0	79	0	79
3838	0	0	77	0	0	77
3839	0	0	68	1	0	69
3840	80	0	0	1	0	81
3841	84	0	0	1	0	85
3842	85	0	1	0	0	86
3843	1	0	0	83	0	84
3844	0	0	88	1	0	89
3845	88	0	0	0	0	88
3846	90	0	0	0	0	90
3847	0	0	80	0	0	80
3848	84	0	0	0	0	84
3849	1	0	87	0	0	88
3850	0	0	0	86	0	86
3851	0	1	86	0	0	87
3852	79	0	0	3	0	82
3853	75	1	0	1	0	77
3854	74	0	0	1	0	75
3855	76	0	0	0	0	76
3856	0	0	79	1	0	80
3857	0	78	1	0	0	79
3858	81	0	0	0	0	81
3859	77	1	0	2	0	80
3860	1	0	77	0	0	78
3861	1	0	0	74	0	75
3862	1	0	0	75	0	76
3863	0	1	70	0	0	71
3864	72	0	0	1	0	73
3865	80	0	0	1	0	81
3866	1	88	1	0	0	90
3867	91	2	0	1	0	94
3868	91	0	0	1	0	92
3869	92	0	0	1	0	93
3870	88	1	0	0	0	89
3871	3	0	85	0	0	88
3872	82	0	2	0	0	84
3873	2	0	1	82	0	85
3874	0	84	0	2	0	86
3875	0	2	81	1	0	84
3876	0	86	2	1	0	89
3877	1	2	0	86	0	89
3878	0	0	85	3	0	88
3879	81	0	2	1	0	84
3880	2	0	90	0	0	92
3881	88	0	3	0	0	91
3882	3	0	0	89	0	92
3883	1	0	0	87	0	88
3884	1	83	0	2	0	86
3885	0	93	0	1	0	94
3886	0	2	1	92	0	95
3887	101	0	0	4	0	105
3888	101	0	0	0	0	101
3889	103	0	1	0	0	104
3890	4	0	103	0	0	107
3891	99	0	3	0	0	102
3892	2	0	106	1	0	109
3893	0	0	96	0	0	96
3894	102	0	2	0	0	104
3895	107	0	0	0	0	107
3896	2	0	104	0	0	106
3897	0	0	1	98	0	99
3898	1	0	0	105	0	106
3899	100	0	0	3	0	103
3900	104	0	0	0	0	104
3901	2	0	119	0	0	121
3902	0	120	2	0	0	122
3903	0	119	0	0	0	119
3904	125	2	0	1	0	128
3905	1	0	0	125	0	126
3906	0	0	0	126	0	126
3907	0	0	0	129	0	129
3908	125	0	0	2	0	127
3909	2	0	0	127	0	129
3910	127	0	0	2	0	129
3911	131	0	0	0	0	131
3912	1	136	0	0	0	137
3913	0	2	0	163	0	165
3914	0	1	160	2	0	163
3915	150	0	3	0	0	153
3916	164	0	0	0	0	164
3917	164	0	0	0	0	164
3918	3	0	160	0	0	163
3919	0	0	3	160	0	163
3920	164	0	0	3	0	167
3921	157	0	0	1	0	158
3922	159	0	0	1	0	160
3923	1	159	0	1	0	161
3924	0	172	0	0	0	172
3925	0	3	0	178	0	181
3926	1	0	0	177	0	178
3927	1	174	0	4	0	179
3928	176	4	0	0	0	180
3929	3	1	184	0	0	188
3930	1	0	2	182	0	185
3931	0	0	0	178	0	178
3932	0	1	172	3	0	176
3933	157	0	3	1	0	161
3934	176	0	1	0	0	177
3935	3	170	0	1	0	174
3936	169	3	0	2	0	174
3937	3	0	189	0	0	192
3938	189	0	2	0	0	191
3939	4	2	193	0	0	199
3940	182	0	4	2	0	188
3941	191	0	0	0	0	191
3942	195	0	1	0	0	196
3943	191	0	0	1	0	192
3944	4	179	2	0	0	185
3945	197	3	1	0	0	201
3946	195	0	0	2	0	197
3947	5	2	187	0	0	194
3948	192	0	3	1	0	196
3949	5	0	0	196	0	201
3950	1	1	191	2	0	195
3951	187	1	3	1	0	192
3952	5	0	1	193	0	199
3953	205	0	0	5	0	210
3954	216	1	0	2	0	219
3955	5	0	242	1	0	248
3956	247	0	3	1	0	251
3957	252	0	0	3	0	255
3958	250	0	0	3	0	253
3959	251	0	1	1	0	253
3960	4	1	1	248	0	254
3961	2	252	0	4	0	258
3962	252	4	1	0	0	257
3963	258	0	0	1	0	259
3964	260	0	1	1	0	262
3965	4	0	248	0	0	252
3966	0	243	3	0	0	246
3967	4	1	0	246	0	251
3968	5	0	0	251	0	256
3969	3	0	256	1	0	260
3970	2	0	2	246	0	250
3971	0	0	252	1	0	253
3972	1	1	1	251	0	254
3973	3	0	0	258	0	261
3974	0	0	269	2	0	271
3975	262	1	1	1	0	265
3976	268	0	1	2	0	271
3977	1	0	296	1	0	298
3978	282	0	2	4	0	288
3979	294	0	1	2	0	297
3980	2	0	303	0	0	305
3981	4	0	1	298	0	303
3982	1	0	2	301	0	304
3983	310	0	0	2	0	312
3984	4	312	0	2	0	318
3985	295	1	1	1	0	298
3986	310	0	1	3	0	314
3987	1	306	1	2	0	310
3988	311	2	0	2	0	315
3989	306	1	0	1	0	308
3990	4	300	0	0	0	304
3991	3	1	0	306	0	310
3992	0	316	1	0	0	317
3993	2	2	0	317	0	321
3994	2	0	311	1	0	314
3995	0	1	304	1	0	306
3996	304	0	1	2	0	307
3997	313	1	0	4	0	318
3998	1	1	321	1	0	324
3999	305	0	2	2	0	309
4000	318	0	1	3	0	322
4001	304	0	1	2	0	307
4002	3	310	0	0	0	313
4003	3	1	2	320	0	326
4004	313	0	1	1	0	315
4005	311	0	0	1	0	312
4006	3	0	310	0	0	313
4007	1	1	2	304	0	308
4008	1	0	0	312	0	313
4009	1	312	0	2	0	315
4010	3	329	0	1	0	333
4011	2	3	1	323	0	329
4012	1	329	0	1	0	331
4013	304	0	0	5	0	309
4014	1	322	1	0	0	324
4015	326	2	0	1	0	329
4016	4	0	329	1	0	334
4017	344	1	5	1	0	351
4018	366	0	1	1	0	368
4019	362	1	0	2	0	365
4020	364	0	0	3	0	367
4021	8	349	3	0	0	360
4022	4	6	2	358	0	370
4023	5	3	0	354	0	362
4024	2	1	345	8	0	356
4025	2	1	6	344	0	353
4026	1	1	2	352	0	356
4027	350	0	2	10	0	362
4028	5	347	0	5	0	357
4029	4	4	1	351	0	360
4030	4	2	1	360	0	367
4031	3	2	0	364	0	369
4032	359	0	2	11	0	372
4033	6	1	2	363	0	372
4034	363	1	2	10	0	376
4035	9	0	0	364	0	373
4036	5	0	3	368	0	376
4037	5	0	339	8	0	352
4038	321	0	5	6	0	332
4039	10	335	2	2	0	349
4040	365	6	3	5	0	379
4041	13	2	1	362	0	378
4042	8	1	2	363	0	374
4043	367	1	1	10	0	379
4044	374	1	1	7	0	383
4045	14	1	0	378	0	393
4046	6	2	399	8	0	415
4047	3	1	392	4	0	400
4048	4	427	7	2	0	440
4049	431	7	3	5	0	446
4050	432	3	2	3	0	440
4051	11	1	1	438	0	451
4052	6	444	3	6	0	459
4053	4	7	0	441	0	452
4054	3	3	1	431	0	438
4055	2	406	0	10	0	418
4056	402	5	2	4	0	413
4057	7	2	3	405	0	417
4058	5	395	2	5	0	407
4059	4	423	0	5	0	432
4060	428	8	0	3	0	439
4061	9	3	419	2	0	433
4062	415	2	6	2	0	425
4063	12	2	3	427	0	444
4064	9	2	1	425	0	437
4065	4	417	1	11	0	433
4066	6	10	2	423	0	441
4067	5	3	422	8	0	438
4068	2	399	7	4	0	412
4069	2	415	2	7	0	426
4070	410	10	3	2	0	425
4071	8	425	4	3	0	440
4072	5	9	2	419	0	435
4073	4	414	0	10	0	428
4074	4	9	0	422	0	435
4075	4	5	0	426	0	435
4076	2	4	413	11	0	430
4077	2	1	6	390	0	399
4078	3	3	2	404	0	412
4079	395	3	1	12	0	411
4080	10	1	396	6	0	413
4081	4	1	8	403	0	416
4082	3	1	394	13	0	411
4083	396	3	9	9	0	417
4084	10	417	3	5	0	435
4085	448	8	3	5	0	464
4086	17	4	2	471	0	494
4087	9	1	2	487	0	499
4088	3	5	474	18	0	500
4089	442	2	10	8	0	462
4090	17	478	6	5	0	506
4091	469	12	2	7	0	490
4092	14	5	2	471	0	492
4093	6	480	6	13	0	505
4094	481	13	2	7	0	503
4095	12	501	2	3	0	518
4096	14	11	0	502	0	527
4097	3	5	1	513	0	522
4098	3	4	2	513	0	522
4099	4	495	2	18	0	519
4100	4	12	2	508	0	526
4101	6	7	0	519	0	532
4102	495	6	2	23	0	526
4103	500	3	2	13	0	518
4104	498	7	1	9	0	515
4105	18	5	480	8	0	511
4106	497	3	10	8	0	518
4107	518	4	5	8	0	535
4108	501	3	5	5	0	514
4109	23	3	469	3	0	498
4110	465	2	11	11	0	489
4111	17	3	6	481	0	507
4112	14	4	462	10	0	490
4113	6	454	12	9	0	481
4114	7	12	4	430	0	453
4115	4	423	2	8	0	437
4116	2	429	2	5	0	438
4117	405	9	1	2	0	417
4118	6	5	3	402	0	416
4119	404	0	0	11	0	415
4120	7	5	0	408	0	420
4121	407	1	1	10	0	419
4122	10	3	0	400	0	413
4123	403	0	1	12	0	416
4124	9	1	386	5	0	401
4125	9	2	4	387	0	402
4126	6	3	389	7	0	405
4127	7	0	377	5	0	389
4128	2	3	383	5	0	393
4129	5	3	6	390	0	404
4130	6	1	398	7	0	412
4131	385	4	7	3	0	399
4132	8	2	4	389	0	403
4133	5	1	421	10	0	437
4134	3	1	5	426	0	435
4135	5	5	6	418	0	434
4136	5	2	460	12	0	479
4137	3	2	6	465	0	476
4138	3	0	4	469	0	476
4139	4	478	1	11	0	494
4140	467	6	1	10	0	484
4141	469	4	3	5	0	481
4142	14	2	458	3	0	477
4143	447	1	5	10	0	463
4144	13	2	442	1	0	458
4145	7	0	429	2	0	438
4146	6	3	420	0	0	429
4147	5	1	12	408	0	426
4148	3	0	407	8	0	418
4149	4	2	8	400	0	414
4150	5	1	4	404	0	414
4151	3	1	3	405	0	412
4152	2	0	2	409	0	413
4153	391	1	2	15	0	409
4154	397	0	2	10	0	409
4155	8	404	0	4	0	416
4156	2	6	4	407	0	419
4157	4	5	410	9	0	428
4158	5	426	6	6	0	443
4159	7	6	6	433	0	452
4160	1	4	434	11	0	450
4161	4	1	6	416	0	427
4162	2	3	423	8	0	436
4163	5	1	401	4	0	411
4164	4	0	9	420	0	433
4165	1	1	7	424	0	433
4166	417	0	5	9	0	431
4167	5	1	6	425	0	437
4168	423	0	4	10	0	437
4169	4	409	5	8	0	426
4170	4	418	2	6	0	430
4171	3	7	1	423	0	434
4172	414	3	1	13	0	431
4173	7	408	2	6	0	423
4174	5	5	0	424	0	434
4175	427	4	1	11	0	443
4176	442	1	0	9	0	452
4177	431	2	0	6	0	439
4178	430	3	2	6	0	441
4179	441	1	0	7	0	449
4180	8	2	414	0	0	424
4181	6	4	413	2	0	425
4182	4	419	9	4	0	436
4183	9	5	5	398	0	417
4184	1	3	412	4	0	420
4185	4	0	391	3	0	398
4186	3	3	5	361	0	372
4187	0	1	395	4	0	400
4188	0	1	376	2	0	379
4189	1	541	2	0	0	544
4190	531	6	1	8	0	546
4191	8	575	2	0	0	585
4192	7	8	1	568	0	584
4193	575	2	0	11	0	588
4194	8	582	1	1	0	592
4195	6	8	1	568	0	583
4196	0	3	577	8	0	588
4197	564	1	8	3	0	576
4198	584	3	1	3	0	591
4199	592	0	1	3	0	596
4200	11	0	2	586	0	599
4201	3	1	581	8	0	593
4202	2	567	7	3	0	579
4203	3	7	1	572	0	583
4204	568	1	2	10	0	581
4205	9	2	560	1	0	572
4206	2	550	6	6	0	564
4207	1	8	574	3	0	586
4208	550	0	9	7	0	566
4209	582	2	3	1	0	588
4210	581	3	5	1	0	590
4211	12	0	565	4	0	581
4212	4	566	11	2	0	583
4213	7	7	2	551	0	567
4214	4	1	2	579	0	586
4215	5	1	0	582	0	588
4216	5	3	570	12	0	590
4217	555	2	9	5	0	571
4218	10	2	572	3	0	587
4219	569	1	8	4	0	582
4220	580	1	3	4	0	588
4221	589	1	2	6	0	598
4222	568	2	2	4	0	576
4223	13	2	575	1	0	591
4224	9	1	9	577	0	596
4225	7	2	574	8	0	591
4226	8	562	9	2	0	581
4227	4	580	4	1	0	589
4228	589	11	4	7	0	611
4229	587	5	3	2	0	597
4230	11	609	2	2	0	624
4231	606	11	2	4	0	623
4232	11	2	548	2	0	563
4233	582	4	6	4	0	596
4234	12	608	5	2	0	627
4235	612	10	5	3	0	630
4236	589	3	2	7	0	601
4237	16	4	4	574	0	598
4238	12	4	3	576	0	595
4239	575	4	2	14	0	595
4240	16	2	1	574	0	593
4241	573	3	6	13	0	595
4242	15	5	2	579	0	601
4243	574	2	4	12	0	592
4244	574	1	5	5	0	585
4245	16	555	2	4	0	577
4246	9	585	5	3	0	602
4247	562	11	5	5	0	583
4248	14	571	3	3	0	591
4249	10	15	4	558	0	587
4250	11	5	2	566	0	584
4251	551	7	4	14	0	576
4252	14	545	5	6	0	570
4253	11	547	4	8	0	570
4254	11	559	6	4	0	580
4255	8	15	545	4	0	572
4256	8	4	537	5	0	554
4257	11	3	557	3	0	574
4258	14	3	13	462	0	492
4259	12	517	7	8	0	544
4260	532	10	4	7	0	553
4261	14	2	526	6	0	548
4262	5	7	510	0	0	522
4263	5	8	530	5	0	548
4264	13	2	12	512	0	539
4265	13	1	8	531	0	553
4266	5	10	4	538	0	557
4267	532	7	6	12	0	557
4268	531	3	6	4	0	544
4269	530	3	4	5	0	542
4270	25	3	0	519	0	547
4271	10	2	508	11	0	531
4272	10	5	513	1	0	529
4273	8	4	11	510	0	533
4274	8	2	0	533	0	543
4275	511	2	3	19	0	535
4276	14	499	4	9	0	526
4277	494	9	5	7	0	515
4278	17	493	6	4	0	520
4279	14	11	2	492	0	519
4280	12	3	483	10	0	508
4281	17	3	7	481	0	508
4282	490	5	4	10	0	509
4283	19	1	484	5	0	509
4284	462	2	12	7	0	483
4285	16	4	459	7	0	486
4286	6	3	457	6	0	472
4287	425	6	14	2	0	447
4288	17	5	441	4	0	467
4289	4	1	265	0	0	270
4290	3	270	7	0	0	280
4291	238	3	1	1	0	243
4292	230	1	0	5	0	236
4293	232	0	1	2	0	235
4294	3	0	221	1	0	225
4295	209	0	2	1	0	212
4296	3	221	0	1	0	225
4297	216	3	0	2	0	221
4298	4	1	227	0	0	232
4299	3	5	2	219	0	229
4300	0	2	216	2	0	220
4301	1	230	2	1	0	234
4302	1	1	1	231	0	234
4303	0	2	0	229	0	231
4304	248	0	0	5	0	253
4305	245	0	0	2	0	247
4306	240	0	0	2	0	242
4307	244	1	0	1	0	246
4308	237	1	0	1	0	239
4309	2	1	239	0	0	242
4310	3	0	2	235	0	240
4311	0	0	251	1	0	252
4312	2	0	2	242	0	246
4313	252	0	1	2	0	255
4314	249	1	1	2	0	253
4315	254	0	0	2	0	256
4316	264	0	1	0	0	265
4317	4	0	271	0	0	275
4318	3	0	4	263	0	270
4319	1	0	267	4	0	272
4320	0	263	4	2	0	269
4321	1	264	1	2	0	268
4322	3	3	1	272	0	279
4323	2	2	0	289	0	293
4324	3	1	0	294	0	298
4325	0	0	0	317	0	317
4326	309	0	1	10	0	320
4327	4	309	1	4	0	318
4328	299	5	0	1	0	305
4329	7	3	0	294	0	304
4330	3	1	0	293	0	297
4331	1	294	0	7	0	302
4332	0	5	1	297	0	303
4333	293	3	0	7	0	303
4334	4	282	0	5	0	291
4335	3	285	0	0	0	288
4336	277	6	0	1	0	284
4337	5	4	0	275	0	284
4338	3	286	0	5	0	294
4339	3	5	0	296	0	304
4340	298	1	0	8	0	307
4341	5	1	0	298	0	304
4342	3	0	0	295	0	298
4343	289	0	0	7	0	296
4344	7	0	0	290	0	297
4345	4	289	0	4	0	297
4346	1	5	0	281	0	287
4347	0	278	0	6	0	284
4348	1	6	0	281	0	288
4349	280	1	0	8	0	289
4350	277	1	0	3	0	281
4351	8	0	0	279	0	287
4352	3	0	278	5	0	286
4353	260	0	5	4	0	269
4354	5	0	275	1	0	281
4355	276	0	5	2	0	283
4356	270	0	1	2	0	273
4357	7	0	266	0	0	273
4358	3	266	4	0	0	273
4359	266	4	2	2	0	274
4360	267	2	1	3	0	273
4361	6	1	274	0	0	281
4362	273	0	5	2	0	280
4363	272	0	1	0	0	273
4364	274	0	1	1	0	276
4365	10	0	0	266	0	276
4366	4	0	0	272	0	276
4367	1	270	0	6	0	277
4368	0	5	0	277	0	282
4369	1	2	0	281	0	284
4370	0	1	275	7	0	283
4371	1	0	266	3	0	270
4372	246	0	6	1	0	253
4373	261	0	3	2	0	266
4374	7	260	1	0	0	268
4375	4	5	0	264	0	273
4376	1	2	278	5	0	286
4377	1	1	6	282	0	290
4378	3	0	2	284	0	289
4379	1	0	1	293	0	295
4380	0	282	0	10	0	292
4381	2	6	0	285	0	293
4382	0	3	0	290	0	293
4383	1	1	280	9	0	291
4384	0	0	285	4	0	289
4385	272	0	8	1	0	281
4386	287	0	4	2	0	293
4387	9	0	1	307	0	317
4388	4	0	0	305	0	309
4389	3	0	0	298	0	301
4390	0	0	294	10	0	304
4391	0	289	4	4	0	297
4392	0	6	284	1	0	291
4393	275	3	7	4	0	289
4394	7	1	287	0	0	295
4395	284	0	7	3	0	294
4396	280	0	3	2	0	285
4397	289	0	1	4	0	294
4398	9	0	0	271	0	280
4399	4	0	262	5	0	271
4400	1	268	6	4	0	279
4401	0	7	3	262	0	272
4402	2	3	1	265	0	271
4403	3	1	267	9	0	280
4404	1	255	6	4	0	266
4405	262	6	2	4	0	274
4406	5	270	1	0	0	276
4407	292	7	0	1	0	300
4408	14	3	0	287	0	304
4409	4	1	297	10	0	312
4410	2	298	11	3	0	314
4411	307	10	4	1	0	322
4412	10	4	317	2	0	333
4413	319	0	11	4	0	334
4414	328	0	4	3	0	335
4415	13	1	318	2	0	334
4416	306	0	10	3	0	319
4417	311	2	5	2	0	320
4418	309	0	2	6	0	317
4419	14	301	0	4	0	319
4420	292	8	2	4	0	306
4421	11	315	1	0	0	327
4422	4	9	285	5	0	303
4423	2	294	11	3	0	310
4424	261	10	9	6	0	286
4425	264	1	5	2	0	272
4426	273	1	0	3	0	277
4427	15	0	2	261	0	278
4428	2	3	0	275	0	280
4429	257	0	2	14	0	273
4430	265	2	1	4	0	272
4431	14	0	3	254	0	271
4432	2	4	252	11	0	269
4433	1	239	15	2	0	257
4434	4	260	1	1	0	266
4435	1	9	4	254	0	268
4436	4	2	253	9	0	268
4437	4	0	10	251	0	265
4438	5	231	3	7	0	246
4439	4	8	1	240	0	253
4440	4	1	241	7	0	253
4441	2	3	9	237	0	251
4442	3	0	249	12	0	264
4443	2	3	9	249	0	263
4444	3	0	250	10	0	263
4445	0	7	250	3	0	260
4446	249	1	12	0	0	262
4447	256	7	2	0	0	265
4448	262	0	1	0	0	263
4449	8	248	2	3	0	261
4450	6	8	3	251	0	268
4451	250	4	0	10	0	264
4452	256	0	1	2	0	259
4453	254	1	3	4	0	262
4454	15	0	244	1	0	260
4455	5	235	9	1	0	250
4456	4	252	5	1	0	262
4457	244	8	2	3	0	257
4458	14	3	3	237	0	257
4459	248	2	1	10	0	261
4460	11	5	240	1	0	257
4461	8	1	7	235	0	251
4462	6	2	2	238	0	248
4463	2	0	2	235	0	239
4464	0	244	4	8	0	256
4465	243	9	1	5	0	258
4466	243	4	2	1	0	250
4467	12	230	5	2	0	249
4468	5	9	3	235	0	252
4469	238	2	1	14	0	255
4470	14	0	3	234	0	251
4471	240	2	2	9	0	253
4472	12	230	1	6	0	249
4473	234	10	4	2	0	250
4474	10	6	225	3	0	244
4475	8	229	8	0	0	245
4476	3	9	223	4	0	239
4477	6	2	10	210	0	228
4478	210	4	0	8	0	222
4479	217	2	1	1	0	221
4480	210	2	1	4	0	217
4481	9	2	3	205	0	219
4482	208	2	0	12	0	222
4483	11	1	1	207	0	220
4484	206	0	1	12	0	219
4485	210	1	7	2	0	220
4486	7	1	205	6	0	219
4487	0	0	188	2	0	190
4488	1	1	191	2	0	195
4489	2	2	8	179	0	191
4490	182	1	2	9	0	194
4491	11	0	2	194	0	207
4492	3	0	1	204	0	208
4493	204	2	0	8	0	214
4494	209	1	1	2	0	213
4495	210	0	1	4	0	215
4496	210	0	1	1	0	212
4497	8	1	2	201	0	212
4498	204	0	0	9	0	213
4499	8	203	5	0	0	216
4500	200	9	0	1	0	210
4501	206	3	1	0	0	210
4502	10	0	196	2	0	208
4503	189	0	9	2	0	200
4504	9	2	188	0	0	199
4505	2	0	169	1	0	172
4506	2	0	175	2	0	179
4507	2	2	4	137	0	145
4508	0	2	140	4	0	146
4509	3	0	2	121	0	126
4510	0	0	132	4	0	136
4511	1	0	136	0	0	137
4512	2	0	1	119	0	122
4513	1	0	0	124	0	125
4514	0	0	131	2	0	133
4515	124	0	2	0	0	126
4516	3	0	0	125	0	128
4517	0	0	0	130	0	130
4518	127	0	0	4	0	131
4519	2	0	0	134	0	136
4520	0	0	136	2	0	138
4521	0	0	125	0	0	125
4522	1	0	1	124	0	126
4523	0	0	134	2	0	136
4524	0	140	1	0	0	141
4525	0	1	0	139	0	140
4526	140	0	0	2	0	142
4527	0	0	139	0	0	139
4528	131	0	0	2	0	133
4529	0	0	0	147	0	147
4530	0	0	0	148	0	148
4531	0	0	0	151	0	151
4532	0	0	0	150	0	150
4533	151	0	0	1	0	152
4534	0	167	0	0	0	167
4535	1	1	0	172	0	174
4536	1	0	0	166	0	167
4537	1	0	0	166	0	167
4538	0	0	0	166	0	166
4539	165	0	0	3	0	168
4540	1	166	0	0	0	167
4541	163	1	0	1	0	165
4542	1	153	0	1	0	155
4543	1	158	0	0	0	159
4544	150	1	0	0	0	151
4545	1	0	156	0	0	157
4546	0	0	1	152	0	153
4547	157	0	1	2	0	160
4548	158	0	0	3	0	161
4549	150	1	0	0	0	151
4550	162	0	0	1	0	163
4551	2	168	0	0	0	170
4552	161	1	0	2	0	164
4553	170	1	0	1	0	172
4554	1	186	0	0	0	187
4555	1	1	0	191	0	193
4556	0	1	190	1	0	192
4557	0	0	1	185	0	186
4558	185	0	1	1	0	187
4559	1	0	185	1	0	187
4560	1	180	2	0	0	183
4561	0	1	186	0	0	187
4562	2	2	1	180	0	185
4563	0	182	1	1	0	184
4564	181	1	0	2	0	184
4565	1	190	0	0	0	191
4566	2	1	0	187	0	190
4567	0	1	0	192	0	193
4568	187	0	0	2	0	189
4569	1	0	0	188	0	189
4570	1	189	0	1	0	191
4571	193	1	0	2	0	196
4572	195	1	0	1	0	197
4573	2	195	0	0	0	197
4574	202	1	0	0	0	203
4575	1	203	0	0	0	204
4576	190	1	0	1	0	192
4577	1	196	0	0	0	197
4578	3	1	0	186	0	190
4579	0	1	0	193	0	194
4580	195	0	0	4	0	199
4581	197	0	0	2	0	199
4582	3	194	1	0	0	198
4583	1	2	194	0	0	197
4584	186	1	2	1	0	190
4585	3	0	1	189	0	193
4586	1	189	0	4	0	194
4587	1	1	0	187	0	189
4588	183	1	0	2	0	186
4589	187	0	0	2	0	189
4590	193	0	0	0	0	193
4591	4	0	0	181	0	185
4592	2	0	182	1	0	185
4593	178	1	2	2	0	183
4594	184	1	2	1	0	188
4595	190	0	1	2	0	193
4596	4	190	0	2	0	196
4597	2	3	0	192	0	197
4598	0	199	0	7	0	206
4599	1	3	0	196	0	200
4600	2	2	0	204	0	208
4601	2	1	210	5	0	218
4602	3	0	4	225	0	232
4603	0	0	2	231	0	233
4604	232	0	2	7	0	241
4605	7	235	1	3	0	246
4606	237	6	0	3	0	246
4607	256	3	1	1	0	261
4608	8	2	0	256	0	266
4609	3	2	260	6	0	271
4610	1	255	5	3	0	264
4611	0	253	3	3	0	259
4612	254	5	1	2	0	262
4613	5	259	1	2	0	267
4614	3	6	0	268	0	277
4615	4	2	1	267	0	274
4616	1	3	263	8	0	275
4617	2	1	262	4	0	269
4618	2	261	9	1	0	273
4619	1	7	3	254	0	265
4620	258	2	3	7	0	270
4621	6	2	1	260	0	269
4622	3	1	265	6	0	275
4623	5	2	5	259	0	271
4624	251	3	1	6	0	261
4625	254	1	1	3	0	259
4626	8	255	0	4	0	267
4627	256	5	1	2	0	264
4628	6	258	2	1	0	267
4629	241	8	2	0	0	251
4630	10	3	0	241	0	254
4631	4	1	238	7	0	250
4632	2	2	227	3	0	234
4633	1	245	9	3	0	258
4634	2	4	5	230	0	241
4635	4	2	1	237	0	244
4636	239	2	0	9	0	250
4637	237	3	0	6	0	246
4638	243	1	0	3	0	247
4639	12	1	0	235	0	248
4640	7	1	0	238	0	246
4641	4	1	2	239	0	246
4642	0	3	234	8	0	245
4643	1	2	220	4	0	227
4644	227	0	7	3	0	237
4645	232	4	2	2	0	240
4646	5	0	231	6	0	242
4647	228	0	4	5	0	237
4648	229	0	2	2	0	233
4649	8	1	227	1	0	237
4650	4	226	4	3	0	237
4651	3	6	2	218	0	229
4652	6	1	219	6	0	232
4653	1	229	6	4	0	240
4654	0	4	4	205	0	213
4655	2	215	2	8	0	227
4656	5	6	212	1	0	224
4657	5	2	222	1	0	230
4658	3	4	6	219	0	232
4659	221	1	2	9	0	233
4660	9	3	2	220	0	234
4661	224	1	1	11	0	237
4662	7	2	2	221	0	232
4663	1	0	221	9	0	231
4664	209	2	6	3	0	220
4665	6	3	211	2	0	222
4666	211	2	6	5	0	224
4667	8	1	1	214	0	224
4668	4	213	3	3	0	223
4669	5	5	1	216	0	227
4670	3	214	0	7	0	224
4671	4	7	1	199	0	211
4672	2	220	0	9	0	231
4673	211	6	3	4	0	224
4674	216	1	3	5	0	225
4675	218	2	3	2	0	225
4676	13	1	208	1	0	223
4677	8	1	6	207	0	222
4678	5	0	216	6	0	227
4679	4	202	6	4	0	216
4680	3	208	3	2	0	216
4681	194	6	5	1	0	206
4682	5	5	195	0	0	205
4683	1	196	5	3	0	205
4684	1	6	3	208	0	218
4685	208	3	1	6	0	218
4686	4	211	2	2	0	219
4687	219	5	1	4	0	229
4688	7	2	218	0	0	227
4689	4	1	6	219	0	230
4690	3	2	1	213	0	219
4691	4	0	0	222	0	226
4692	1	212	1	7	0	221
4693	4	5	0	204	0	213
4694	0	1	209	8	0	218
4695	3	3	4	206	0	216
4696	2	1	3	212	0	218
4697	4	0	4	206	0	214
4698	3	191	1	4	0	199
4699	3	4	0	194	0	201
4700	2	3	0	194	0	199
4701	2	183	0	3	0	188
4702	167	2	0	1	0	170
4703	2	174	1	0	0	177
4704	2	173	1	0	0	176
4705	2	1	1	170	0	174
4706	2	0	168	2	0	172
4707	145	0	2	3	0	150
4708	2	1	0	159	0	162
4709	0	0	154	4	0	158
4710	0	158	3	0	0	161
4711	0	2	0	159	0	161
4712	1	0	167	4	0	172
4713	2	0	4	150	0	156
4714	0	1	0	151	0	152
4715	147	0	0	5	0	152
4716	3	149	0	1	0	153
4717	147	5	0	1	0	153
4718	5	0	147	0	0	152
4719	0	157	3	0	0	160
4720	0	4	157	0	0	161
4721	0	0	3	165	0	168
4722	155	0	2	3	0	160
4723	3	0	0	153	0	156
4724	155	0	0	5	0	160
4725	159	0	1	0	0	160
4726	2	0	0	165	0	167
4727	0	1	184	4	0	189
4728	0	1	182	0	0	183
4729	1	0	3	193	0	197
4730	0	0	0	205	0	205
4731	202	0	0	5	0	207
4732	4	1	1	199	0	205
4733	1	194	1	3	0	199
4734	1	3	0	198	0	202
4735	0	1	0	202	0	203
4736	191	0	1	4	0	196
4737	3	195	0	1	0	199
4738	2	2	0	201	0	205
4739	0	0	0	206	0	206
4740	1	201	0	3	0	205
4741	1	3	0	203	0	207
4742	1	0	0	202	0	203
4743	0	198	0	3	0	201
4744	0	3	1	203	0	207
4745	1	0	0	205	0	206
4746	0	199	0	3	0	202
4747	2	3	0	201	0	206
4748	194	0	0	5	0	199
4749	200	1	0	1	0	202
4750	198	0	0	3	0	201
4751	199	0	0	3	0	202
4752	4	190	0	0	0	194
4753	182	4	0	0	0	186
4754	4	188	0	1	0	193
4755	0	180	0	0	0	180
4756	2	2	0	181	0	185
4757	0	0	184	3	0	187
4758	179	0	2	1	0	182
4759	181	0	0	0	0	181
4760	2	1	180	0	0	183
4761	178	0	2	3	0	183
4762	187	0	0	1	0	188
4763	2	186	0	0	0	188
4764	211	2	0	1	0	214
4765	4	0	0	212	0	216
4766	0	0	0	216	0	216
4767	0	0	0	215	0	215
4768	1	1	0	217	0	219
4769	216	0	0	4	0	220
4770	3	0	0	219	0	222
4771	0	1	0	218	0	219
4772	0	1	212	3	0	216
4773	200	0	2	1	0	203
4774	207	2	1	1	0	211
4775	210	0	0	1	0	211
4776	2	212	0	1	0	215
4777	0	214	0	0	0	214
4778	206	2	0	1	0	209
4779	3	0	0	206	0	209
4780	1	205	0	2	0	208
4781	2	2	0	210	0	214
4782	1	212	0	2	0	215
4783	209	3	0	1	0	213
4784	3	210	0	0	0	213
4785	1	3	0	209	0	213
4786	0	2	0	210	0	212
4787	0	0	207	3	0	210
4788	0	221	3	0	0	224
4789	1	3	0	223	0	227
4790	1	0	247	3	0	251
4791	0	1	247	0	0	248
4792	0	0	3	253	0	256
4793	2	0	2	245	0	249
4794	0	244	1	5	0	250
4795	1	253	0	1	0	255
4796	1	5	0	257	0	263
4797	251	3	0	6	0	260
4798	5	2	0	270	0	277
4799	285	0	0	8	0	293
4800	291	0	0	2	0	293
4801	294	0	0	4	0	298
4802	7	0	291	1	0	299
4803	288	0	4	0	0	292
4804	7	0	1	292	0	300
4805	3	0	2	292	0	297
4806	3	0	288	4	0	295
4807	0	1	279	3	0	283
4808	1	1	4	277	0	283
4809	1	272	2	3	0	278
4810	0	276	2	2	0	280
4811	6	5	0	271	0	282
4812	264	3	0	3	0	270
4813	3	2	0	265	0	270
4814	3	1	0	266	0	270
4815	2	267	0	2	0	271
4816	0	2	0	275	0	277
4817	0	1	269	5	0	275
4818	1	1	264	1	0	267
4819	254	1	3	3	0	261
4820	3	268	3	0	0	274
4821	264	2	2	1	0	269
4822	274	1	1	0	0	276
4823	0	3	0	267	0	270
4824	2	275	0	2	0	279
4825	3	3	0	289	0	295
4826	286	2	0	5	0	293
4827	2	269	0	1	0	272
4828	263	2	0	2	0	267
4829	4	269	0	1	0	274
4830	264	4	0	0	0	268
4831	265	1	0	1	0	267
4832	4	257	0	1	0	262
4833	3	3	1	260	0	267
4834	263	1	0	3	0	267
4835	2	2	255	2	0	261
4836	1	0	247	3	0	251
4837	2	0	3	254	0	259
4838	252	0	3	2	0	257
4839	3	0	3	250	0	256
4840	253	0	1	5	0	259
4841	4	0	266	2	0	272
4842	263	0	2	5	0	270
4843	296	1	1	1	0	299
4844	4	1	2	292	0	299
4845	3	0	0	291	0	294
4846	4	0	0	295	0	299
4847	0	294	0	5	0	299
4848	1	3	0	293	0	297
4849	2	1	0	298	0	301
4850	300	2	0	3	0	305
4851	295	0	1	4	0	300
4852	4	0	293	2	0	299
4853	292	1	2	1	0	296
4854	4	0	290	2	0	296
4855	268	0	6	4	0	278
4856	4	0	280	0	0	284
4857	1	0	278	2	0	281
4858	2	1	3	279	0	285
4859	0	2	277	2	0	281
4860	280	2	5	3	0	290
4861	4	0	1	296	0	301
4862	298	0	2	4	0	304
4863	296	0	0	4	0	300
4864	278	2	0	3	0	283
4865	282	0	1	2	0	285
4866	8	0	273	0	0	281
4867	3	0	4	271	0	278
4868	5	0	271	3	0	279
4869	1	1	4	274	0	280
4870	268	0	1	6	0	275
4871	4	1	4	275	0	284
4872	274	0	0	7	0	281
4873	3	1	0	280	0	284
4874	2	1	0	281	0	284
4875	283	1	1	4	0	289
4876	2	282	1	5	0	290
4877	286	2	0	3	0	291
4878	4	281	1	2	0	288
4879	4	5	0	284	0	293
4880	292	2	2	4	0	300
4881	3	3	286	1	0	293
4882	2	0	2	290	0	294
4883	287	0	2	4	0	293
4884	290	1	3	2	0	296
4885	4	0	1	289	0	294
4886	4	290	0	4	0	298
4887	4	290	1	2	0	297
4888	4	5	0	276	0	285
4889	271	3	2	3	0	279
4890	3	243	1	1	0	248
4891	0	228	1	2	0	231
4892	224	2	1	0	0	227
4893	1	223	1	1	0	226
4894	231	1	0	2	0	234
4895	1	0	1	238	0	240
4896	1	0	1	230	0	232
4897	0	230	0	3	0	233
4898	0	230	1	1	0	232
4899	210	1	0	1	0	212
4900	1	205	0	1	0	207
4901	3	235	0	0	0	238
4902	1	4	0	235	0	240
4903	243	1	0	8	0	252
4904	6	1	253	3	0	263
4905	243	0	7	1	0	251
4906	7	1	5	287	0	300
4907	6	1	286	6	0	299
4908	3	0	287	6	0	296
4909	2	1	11	299	0	313
4910	1	1	315	7	0	324
4911	300	1	8	10	0	319
4912	317	0	6	7	0	330
4913	15	2	316	1	0	334
4914	10	2	8	308	0	328
4915	3	2	5	314	0	324
4916	318	1	1	15	0	335
4917	8	3	0	319	0	330
4918	8	305	2	10	0	325
4919	310	8	0	5	0	323
4920	9	306	4	1	0	320
4921	7	307	1	1	0	316
4922	3	13	1	307	0	324
4923	5	6	2	306	0	319
4924	4	2	2	303	0	311
4925	0	2	283	18	0	303
4926	258	2	9	12	0	281
4927	11	272	7	2	0	292
4928	284	9	2	1	0	296
4929	284	7	1	0	0	292
4930	16	2	1	267	0	286
4931	9	274	2	11	0	296
4932	3	11	2	293	0	309
4933	4	4	0	303	0	311
4934	294	2	2	18	0	316
4935	296	1	1	11	0	309
4936	18	1	291	2	0	312
4937	298	2	8	2	0	310
4938	10	300	5	0	0	315
4939	306	10	2	3	0	321
4940	10	323	0	3	0	336
4941	5	11	3	300	0	319
4942	6	5	1	302	0	314
4943	2	284	0	19	0	305
4944	1	11	2	298	0	312
4945	4	6	0	306	0	316
4946	2	0	0	308	0	310
4947	2	284	1	18	0	305
4948	2	10	1	305	0	318
4949	0	7	0	312	0	319
4950	3	1	1	315	0	320
4951	3	1	289	14	0	307
4952	278	1	10	8	0	297
4953	11	0	297	1	0	309
4954	292	1	11	3	0	307
4955	13	1	293	3	0	310
4956	292	1	13	2	0	308
4957	300	2	4	5	0	311
4958	17	3	290	2	0	312
4959	11	1	11	286	0	309
4960	2	2	277	12	0	293
4961	267	2	11	10	0	290
4962	11	2	280	4	0	297
4963	8	1	281	3	0	293
4964	279	2	18	3	0	302
4965	13	275	8	3	0	299
4966	7	11	1	282	0	301
4967	283	7	3	13	0	306
4968	14	1	2	287	0	304
4969	9	1	1	292	0	303
4970	283	0	2	19	0	304
4971	292	2	1	8	0	303
4972	19	0	285	3	0	307
4973	9	0	294	2	0	305
4974	3	0	18	290	0	311
4975	1	0	298	14	0	313
4976	2	0	14	293	0	309
4977	4	3	6	293	0	306
4978	3	3	2	303	0	311
4979	288	0	1	21	0	310
4980	12	306	0	9	0	327
4981	308	12	0	4	0	324
4982	310	6	1	4	0	321
4983	16	302	0	2	0	320
4984	297	11	1	3	0	312
4985	12	3	293	2	0	310
4986	8	1	11	293	0	313
4987	302	1	5	11	0	319
4988	13	0	298	7	0	318
4989	293	0	11	4	0	308
4990	10	313	4	2	0	329
4991	350	11	1	1	0	363
4992	349	7	1	2	0	359
4993	18	353	1	2	0	374
4994	357	11	1	2	0	371
4995	16	6	0	352	0	374
4996	8	2	0	364	0	374
4997	355	1	0	21	0	377
4998	356	0	0	9	0	365
4999	16	350	0	2	0	368
5000	8	363	0	1	0	372
5001	0	13	0	320	0	333
5002	1	325	1	12	0	339
5003	0	336	0	5	0	341
5004	321	15	0	1	0	337
5005	13	315	2	1	0	331
5006	287	13	1	1	0	302
5007	13	303	0	0	0	316
5008	0	11	292	0	0	303
5009	0	285	13	0	0	298
5010	277	11	0	2	0	290
5011	288	0	0	0	0	288
5012	11	1	276	0	0	288
5013	0	0	11	265	0	276
5014	0	0	0	286	0	286
5015	0	1	275	11	0	287
5016	1	0	11	265	0	277
5017	0	1	273	13	0	287
5018	2	1	272	0	0	275
5019	266	1	15	1	0	283
5020	13	276	1	0	0	290
5021	279	14	1	0	0	294
5022	15	1	0	276	0	292
5023	1	2	292	12	0	307
5024	3	1	12	286	0	302
5025	1	294	0	13	0	308
5026	296	10	2	2	0	310
5027	308	1	2	2	0	313
5028	13	1	0	305	0	319
5029	2	0	298	12	0	312
5030	274	0	14	1	0	289
5031	12	285	0	4	0	301
5032	286	10	2	2	0	300
5033	15	0	2	289	0	306
5034	289	1	0	12	0	302
5035	13	2	2	285	0	302
5036	2	0	281	13	0	296
5037	2	2	283	2	0	289
5038	272	2	10	3	0	287
5039	14	289	1	1	0	305
5040	277	11	3	3	0	294
5041	293	1	2	0	0	296
5042	11	285	0	2	0	298
5043	284	11	0	3	0	298
5044	12	0	296	0	0	308
5045	2	2	9	304	0	317
5046	4	1	0	313	0	318
5047	3	2	1	315	0	321
5048	3	0	296	12	0	311
5049	1	2	307	2	0	312
5050	2	0	11	294	0	307
5051	1	293	2	12	0	308
5052	4	318	3	0	0	325
5053	314	12	0	2	0	328
5054	316	5	2	2	0	325
5055	13	327	1	2	0	343
5056	3	12	2	329	0	346
5057	2	3	1	341	0	347
5058	339	2	0	14	0	355
5059	11	1	2	347	0	361
5060	3	1	1	350	0	355
5061	4	1	1	352	0	358
5062	0	1	334	15	0	350
5063	2	3	336	3	0	344
5064	328	1	11	4	0	344
5065	14	0	3	355	0	372
5066	1	1	354	12	0	368
5067	2	3	353	1	0	359
5068	356	0	10	5	0	371
5069	14	1	418	1	0	434
5070	1	413	13	3	0	430
5071	4	13	2	442	0	461
5072	2	0	440	14	0	456
5073	430	5	12	3	0	450
5074	17	1	2	457	0	477
5075	4	1	451	16	0	472
5076	6	0	15	455	0	476
5077	2	0	4	474	0	480
5078	456	1	5	23	0	485
5079	16	458	3	6	0	483
5080	6	17	1	447	0	471
5081	449	3	3	19	0	474
5082	458	3	1	4	0	466
5083	466	1	0	5	0	472
5084	477	1	3	1	0	482
5085	26	2	1	456	0	485
5086	464	0	1	18	0	483
5087	469	0	3	7	0	479
5088	463	1	0	4	0	468
5089	461	0	0	9	0	470
5090	19	423	4	0	0	446
5091	7	408	0	1	0	416
5092	3	13	0	394	0	410
5093	3	393	1	13	0	410
5094	393	15	0	2	0	410
5095	15	3	0	394	0	412
5096	394	2	0	17	0	413
5097	400	2	0	5	0	407
5098	21	0	0	409	0	430
5099	8	0	0	401	0	409
5100	6	388	1	13	0	408
5101	394	11	0	6	0	411
5102	14	394	0	4	0	412
5103	391	10	0	2	0	403
5104	12	4	1	397	0	414
5105	4	3	397	10	0	414
5106	391	2	9	6	0	408
5107	396	0	3	5	0	404
5108	13	1	388	1	0	403
5109	5	1	397	0	0	403
5110	4	0	13	382	0	399
5111	403	0	5	12	0	420
5112	442	2	3	8	0	455
5113	458	0	1	5	0	464
5114	468	1	0	2	0	471
5115	17	447	0	0	0	464
5116	465	10	0	2	0	477
5117	16	3	1	456	0	476
5118	6	1	1	476	0	484
5119	4	1	0	475	0	480
5120	3	0	0	486	0	489
5121	466	1	1	18	0	486
5122	14	0	0	471	0	485
5123	2	1	457	15	0	475
5124	4	0	12	464	0	480
5125	5	1	3	469	0	478
5126	5	0	1	473	0	479
5127	4	0	1	469	0	474
5128	454	0	0	17	0	471
5129	15	440	0	6	0	461
5130	6	455	0	2	0	463
5131	5	15	0	445	0	465
5132	444	5	0	16	0	465
5133	459	2	0	6	0	467
5134	16	2	0	453	0	471
5135	6	1	445	13	0	465
5136	445	1	11	6	0	463
5137	14	2	2	456	0	474
5138	6	0	443	13	0	462
5139	430	3	13	5	0	451
5140	15	453	3	5	0	476
5141	507	13	2	5	0	527
5142	20	514	1	1	0	536
5143	10	16	0	515	0	541
5144	3	524	2	15	0	544
5145	7	21	0	522	0	550
5146	499	6	1	25	0	531
5147	20	509	0	12	0	541
5148	8	23	511	4	0	546
5149	6	4	17	519	0	546
5150	7	4	514	17	0	542
5151	4	3	21	506	0	534
5152	3	0	9	518	0	530
5153	3	1	498	24	0	526
5154	455	0	20	13	0	488
5155	19	0	487	6	0	512
5156	11	0	479	4	0	494
5157	7	480	25	0	0	512
5158	7	19	6	475	0	507
5159	3	9	4	488	0	504
5160	2	4	3	492	0	501
5161	8	4	0	497	0	509
5162	2	5	468	30	0	505
5163	443	1	19	17	0	480
5164	19	2	476	10	0	507
5165	10	2	19	464	0	495
5166	463	2	7	23	0	495
5167	23	452	5	9	0	489
5168	11	18	5	439	0	473
5169	413	8	3	20	0	444
5170	18	400	3	10	0	431
5171	6	415	2	5	0	428
5172	402	20	2	3	0	427
5173	16	386	1	3	0	406
5174	370	14	1	4	0	389
5175	13	379	2	2	0	396
5176	378	14	1	2	0	395
5177	384	7	4	2	0	397
5178	19	378	1	4	0	402
5179	4	13	2	384	0	403
5180	4	3	375	17	0	399
5181	367	3	12	7	0	389
5182	14	4	4	374	0	396
5183	7	361	4	16	0	388
5184	5	373	6	6	0	390
5185	7	15	2	375	0	399
5186	363	9	1	17	0	390
5187	14	3	363	7	0	387
5188	7	4	13	376	0	400
5189	6	3	4	384	0	397
5190	4	4	3	385	0	396
5191	4	2	5	378	0	389
5192	4	370	2	16	0	392
5193	3	15	2	383	0	403
5194	3	5	367	19	0	394
5195	4	3	379	7	0	393
5196	3	5	377	8	0	393
5197	1	2	19	372	0	394
5198	369	3	5	15	0	392
5199	12	4	369	7	0	392
5200	5	3	373	6	0	387
5201	9	1	15	361	0	386
5202	363	3	9	12	0	387
5203	12	355	5	9	0	381
5204	350	13	3	6	0	372
5205	15	5	1	354	0	375
5206	5	5	364	14	0	388
5207	5	4	11	339	0	359
5208	7	349	4	14	0	374
5209	370	14	6	6	0	396
5210	15	5	379	3	0	402
5211	4	365	14	3	0	386
5212	348	10	3	6	0	367
5213	18	5	2	341	0	366
5214	5	2	5	349	0	361
5215	344	2	4	15	0	365
5216	352	1	2	10	0	365
5217	372	2	2	6	0	382
5218	18	4	3	347	0	372
5219	12	357	1	9	0	379
5220	367	9	0	10	0	386
5221	15	363	1	4	0	383
5222	357	15	1	6	0	379
5223	12	357	1	2	0	372
5224	9	11	1	352	0	373
5225	353	8	3	8	0	372
5226	358	4	0	8	0	370
5227	359	5	0	5	0	369
5228	366	3	0	5	0	374
5229	368	1	1	4	0	374
5230	20	5	349	1	0	375
5231	13	1	9	346	0	369
5232	8	2	350	10	0	370
5233	4	1	346	7	0	358
5234	347	2	13	5	0	367
5235	342	0	7	7	0	356
5236	344	5	4	2	0	355
5237	19	1	3	333	0	356
5238	339	1	2	9	0	351
5239	15	324	1	9	0	349
5240	8	323	1	5	0	337
5241	3	284	0	5	0	292
5242	260	6	1	1	0	268
5243	5	260	2	1	0	268
5244	261	5	2	2	0	270
5245	264	3	0	3	0	270
5246	7	3	256	0	0	266
5247	5	2	3	253	0	263
5248	5	0	2	267	0	274
5249	266	1	3	5	0	275
5250	271	0	4	5	0	280
5251	5	0	1	270	0	276
5252	3	0	268	7	0	278
5253	5	0	276	3	0	284
5254	6	1	5	277	0	289
5255	3	2	2	270	0	277
5256	1	0	3	280	0	284
5257	271	2	3	7	0	283
5258	276	1	2	4	0	283
5259	6	272	0	4	0	282
5260	6	4	0	279	0	289
5261	5	3	1	282	0	291
5262	4	281	2	5	0	292
5263	3	5	1	280	0	289
5264	283	2	1	7	0	293
5265	5	3	1	282	0	291
5266	6	2	0	282	0	290
5267	280	2	0	6	0	288
5268	276	0	1	6	0	283
5269	281	0	1	5	0	287
5270	8	1	3	274	0	286
5271	4	1	262	5	0	272
5272	7	0	250	2	0	259
5273	2	2	261	3	0	268
5274	6	250	5	0	0	261
5275	243	4	2	1	0	250
5276	5	4	245	1	0	255
5277	236	1	4	2	0	243
5278	6	1	2	244	0	253
5279	250	3	1	8	0	262
5280	272	1	0	3	0	276
5281	7	271	1	1	0	280
5282	279	3	1	4	0	287
5283	284	2	0	4	0	290
5284	8	286	2	1	0	297
5285	6	3	2	289	0	300
5286	3	3	281	5	0	292
5287	3	1	4	276	0	284
5288	3	0	4	282	0	289
5289	282	0	3	5	0	290
5290	7	0	1	289	0	297
5291	3	283	1	6	0	293
5292	5	4	1	292	0	302
5293	6	3	2	284	0	295
5294	3	3	281	6	0	293
5295	0	280	4	5	0	289
5296	4	286	2	2	0	294
5297	280	4	2	6	0	292
5298	3	291	1	3	0	298
5299	7	5	0	291	0	303
5300	6	2	295	4	0	307
5301	4	292	4	2	0	302
5302	298	4	1	8	0	311
5303	4	2	4	301	0	311
5304	6	1	3	297	0	307
5305	3	3	295	6	0	307
5306	3	3	3	278	0	287
5307	7	1	3	295	0	306
5308	284	3	5	8	0	300
5309	257	0	1	9	0	267
5310	4	254	2	6	0	266
5311	231	3	1	3	0	238
5312	7	220	2	3	0	232
5313	4	7	1	215	0	227
5314	3	220	1	7	0	231
5315	4	232	1	0	0	237
5316	216	4	1	5	0	226
5317	203	4	1	3	0	211
5318	5	202	3	1	0	211
5319	204	5	0	2	0	211
5320	197	4	0	4	0	205
5321	215	3	0	3	0	221
5322	5	2	1	215	0	223
5323	211	3	0	3	0	217
5324	5	2	206	2	0	215
5325	206	2	3	5	0	216
5326	8	0	216	1	0	225
5327	1	4	3	220	0	228
5328	4	3	0	224	0	231
5329	4	0	221	2	0	227
5330	213	3	2	3	0	221
5331	216	1	1	7	0	225
5332	5	1	244	1	0	251
5333	4	2	3	246	0	255
5334	5	1	1	247	0	254
5335	2	0	3	251	0	256
5336	241	1	1	11	0	254
5337	239	1	2	5	0	247
5338	2	1	1	237	0	241
5339	3	236	0	5	0	244
5340	6	236	0	2	0	244
5341	245	2	2	2	0	251
5342	3	237	0	2	0	242
5343	3	227	0	3	0	233
5344	4	1	0	208	0	213
5345	4	2	214	2	0	222
5346	1	217	0	2	0	220
5347	1	1	0	219	0	221
5348	1	213	3	0	0	217
5349	2	3	0	214	0	219
5350	215	1	1	2	0	219
5351	1	219	0	1	0	221
5352	218	0	0	3	0	221
5353	215	0	1	1	0	217
5354	1	2	215	1	0	219
5355	214	1	0	1	0	216
5356	2	0	1	216	0	219
5357	0	1	222	1	0	224
5358	2	219	0	2	0	223
5359	2	1	0	224	0	227
5360	1	1	2	226	0	230
5361	223	2	0	1	0	226
5362	1	0	0	227	0	228
5363	0	0	0	226	0	226
5364	229	0	0	0	0	229
5365	1	224	0	3	0	228
5366	228	1	1	3	0	233
5367	3	1	221	0	0	225
5368	200	1	1	3	0	205
5369	3	0	224	1	0	228
5370	1	219	3	0	0	223
5371	224	1	0	2	0	227
5372	220	0	2	1	0	223
5373	2	2	217	0	0	221
5374	3	1	215	0	0	219
5375	3	1	216	0	0	220
5376	0	227	4	1	0	232
5377	1	1	2	233	0	237
5378	0	0	244	1	0	245
5379	0	2	217	0	0	219
5380	2	0	2	215	0	219
5381	2	0	219	1	0	222
5382	211	0	6	2	0	219
5383	251	0	2	4	0	257
5384	4	1	258	0	0	263
5385	5	265	4	0	0	274
5386	6	4	4	261	0	275
5387	1	3	276	4	0	284
5388	0	256	7	2	0	265
5389	3	5	3	266	0	277
5390	266	3	5	8	0	282
5391	259	4	2	6	0	271
5392	8	269	0	4	0	281
5393	8	4	0	264	0	276
5394	5	3	2	271	0	281
5395	4	2	0	265	0	271
5396	3	1	2	270	0	276
5397	1	3	260	10	0	274
5398	3	0	4	261	0	268
5399	0	2	255	9	0	266
5400	1	253	9	5	0	268
5401	249	3	4	7	0	263
5402	4	270	5	2	0	281
5403	5	8	1	268	0	282
5404	5	3	2	271	0	281
5405	268	3	1	9	0	281
5406	5	1	1	268	0	275
5407	3	264	0	10	0	277
5408	6	5	0	272	0	283
5409	1	5	0	277	0	283
5410	268	4	0	11	0	283
5411	6	3	263	8	0	280
5412	5	255	0	6	0	266
5413	4	268	4	3	0	279
5414	1	8	2	262	0	273
5415	250	5	0	10	0	265
5416	5	265	0	5	0	275
5417	5	4	2	271	0	282
5418	4	4	266	5	0	279
5419	5	3	5	268	0	281
5420	270	3	5	8	0	286
5421	255	2	1	6	0	264
5422	9	0	1	261	0	271
5423	265	2	1	8	0	276
5424	266	1	1	6	0	274
5425	8	0	265	5	0	278
5426	253	0	4	3	0	260
5427	9	266	3	2	0	280
5428	272	6	3	2	0	283
5429	8	3	263	3	0	277
5430	5	2	5	270	0	282
5431	273	1	4	6	0	284
5432	5	1	242	3	0	251
5433	6	2	247	2	0	257
5434	3	3	8	252	0	266
5435	4	1	258	4	0	267
5436	248	1	10	5	0	264
5437	6	1	265	2	0	274
5438	5	2	8	262	0	277
5439	2	2	5	270	0	279
5440	275	0	3	13	0	291
5441	8	0	281	7	0	296
5442	3	1	310	4	0	318
5443	4	1	9	327	0	341
5444	2	0	332	11	0	345
5445	325	0	13	5	0	343
5446	10	0	5	321	0	336
5447	6	1	327	12	0	346
5448	4	3	11	326	0	344
5449	3	1	6	335	0	345
5450	326	1	4	17	0	348
5451	11	1	321	8	0	341
5452	312	7	9	4	0	332
5453	12	0	326	3	0	341
5454	318	0	15	0	0	333
5455	328	1	4	2	0	335
5456	334	0	3	3	0	340
5457	19	322	1	0	0	342
5458	330	9	3	2	0	344
5459	330	4	1	3	0	338
5460	15	2	1	330	0	348
5461	7	1	323	10	0	341
5462	320	0	10	7	0	337
5463	10	1	343	4	0	358
5464	4	1	11	327	0	343
5465	3	0	7	346	0	356
5466	339	0	4	15	0	358
5467	10	343	3	8	0	364
5468	6	8	4	343	0	361
5469	5	3	0	349	0	357
5470	4	3	340	14	0	361
5471	3	1	8	335	0	347
5472	6	0	5	346	0	357
5473	6	0	4	338	0	348
5474	1	344	2	12	0	359
5475	334	7	0	11	0	352
5476	342	3	0	8	0	353
5477	14	333	2	2	0	351
5478	330	9	3	0	0	342
5479	14	3	0	336	0	353
5480	4	3	360	12	0	379
5481	5	364	8	4	0	381
5482	3	374	5	5	0	387
5483	346	7	10	1	0	364
5484	353	3	3	4	0	363
5485	11	1	0	355	0	367
5486	8	0	2	368	0	378
5487	4	2	1	371	0	378
5488	363	1	1	13	0	378
5489	11	0	359	4	0	374
5490	354	0	9	4	0	367
5491	11	2	2	358	0	373
5492	3	1	2	355	0	361
5493	5	346	4	9	0	364
5494	5	7	2	355	0	369
5495	4	1	2	366	0	373
5496	3	3	377	12	0	395
5497	2	380	10	6	0	398
5498	386	9	2	4	0	401
5499	379	3	5	5	0	392
5500	394	2	4	1	0	401
5501	373	0	2	6	0	381
5502	11	1	373	6	0	391
5503	362	2	8	3	0	375
5504	13	0	376	3	0	392
5505	6	2	11	366	0	385
5506	3	378	5	12	0	398
5507	5	8	5	375	0	393
5508	9	2	1	384	0	396
5509	3	3	382	12	0	400
5510	363	2	9	10	0	384
5511	376	1	3	6	0	386
5512	12	360	5	9	0	386
5513	5	7	367	3	0	382
5514	5	2	10	371	0	388
5515	5	2	374	11	0	392
5516	2	5	362	2	0	371
5517	5	2	7	368	0	382
5518	6	0	366	11	0	383
5519	6	1	12	364	0	383
5520	6	3	374	10	0	393
5521	6	1	11	371	0	389
5522	382	1	3	11	0	397
5523	372	4	5	4	0	385
5524	374	2	1	7	0	384
5525	368	0	2	8	0	378
5526	10	363	4	2	0	379
5527	7	10	2	365	0	384
5528	4	3	1	377	0	385
5529	4	3	366	12	0	385
5530	7	3	9	357	0	376
5531	3	1	356	13	0	373
5532	2	2	348	7	0	359
5533	338	0	10	8	0	356
5534	10	373	4	3	0	390
5535	377	7	4	4	0	392
5536	376	2	1	7	0	386
5537	8	386	1	4	0	399
5538	371	8	2	3	0	384
5539	9	2	371	3	0	385
5540	3	371	7	2	0	383
5541	366	5	2	2	0	375
5542	10	1	342	0	0	353
5543	313	3	3	1	0	320
5544	7	323	2	1	0	333
5545	314	2	3	3	0	322
5546	316	0	0	2	0	318
5547	2	308	0	0	0	310
5548	2	311	0	1	0	314
5549	2	317	1	1	0	321
5550	2	4	1	323	0	330
5551	1	1	0	322	0	324
5552	320	1	0	7	0	328
5553	319	0	0	2	0	321
5554	3	0	323	1	0	327
5555	3	0	306	1	0	310
5556	1	0	328	0	0	329
5557	0	0	5	319	0	324
5558	0	0	319	4	0	323
5559	0	0	5	316	0	321
5560	306	0	0	9	0	315
5561	3	0	313	0	0	316
5562	308	0	3	5	0	316
5563	304	0	0	0	0	304
5564	4	0	306	0	0	310
5565	3	305	3	0	0	311
5566	3	3	0	306	0	312
5567	0	1	311	3	0	315
5568	0	1	4	313	0	318
5569	2	0	1	344	0	347
5570	346	0	2	6	0	354
5571	5	1	0	340	0	346
5572	0	3	337	5	0	345
5573	2	1	5	337	0	345
5574	337	0	0	10	0	347
5575	4	346	0	2	0	352
5576	350	3	0	5	0	358
5577	10	10	0	334	0	354
5578	5	2	341	4	0	352
5579	4	0	322	2	0	328
5580	1	8	313	2	0	324
5581	0	297	6	2	0	305
5582	288	4	7	2	0	301
5583	3	281	3	1	0	288
5584	276	2	0	3	0	281
5585	3	275	2	1	0	281
5586	4	2	2	264	0	272
5587	4	1	1	259	0	265
5588	4	0	3	254	0	261
5589	1	256	3	3	0	263
5590	3	2	2	261	0	268
5591	0	4	3	305	0	312
5592	321	0	1	8	0	330
5593	7	2	1	346	0	356
5594	5	0	364	10	0	379
5595	359	1	8	6	0	374
5596	354	0	5	7	0	366
5597	13	356	3	2	0	374
5598	360	8	0	5	0	373
5599	363	4	1	2	0	370
5600	14	2	0	356	0	372
5601	7	0	0	360	0	367
5602	3	1	2	376	0	382
5603	371	1	2	14	0	388
5604	370	0	3	8	0	381
5605	15	2	355	0	0	372
5606	358	2	9	2	0	371
5607	363	3	6	2	0	374
5608	367	3	0	2	0	372
5609	16	1	346	3	0	366
5610	4	3	354	4	0	365
5611	6	0	11	356	0	373
5612	4	1	356	11	0	372
5613	3	0	10	339	0	352
5614	2	1	5	318	0	326
5615	1	356	3	13	0	373
5616	358	10	0	3	0	371
5617	11	3	361	2	0	377
5618	361	1	13	4	0	379
5619	17	0	4	362	0	383
5620	358	1	3	10	0	372
5621	12	356	1	5	0	374
5622	6	372	3	1	0	382
5623	5	14	3	357	0	379
5624	5	6	0	378	0	389
5625	2	0	365	18	0	385
5626	3	1	10	373	0	387
5627	354	0	3	17	0	374
5628	14	363	0	7	0	384
5629	5	10	363	4	0	382
5630	5	4	12	365	0	386
5631	7	1	365	12	0	385
5632	6	2	12	369	0	389
5633	6	0	366	11	0	383
5634	3	2	352	4	0	361
5635	6	1	14	347	0	368
5636	351	1	8	15	0	375
5637	349	0	5	7	0	361
5638	355	1	3	6	0	365
5639	13	343	6	1	0	363
5640	351	12	2	4	0	369
5641	356	4	5	3	0	368
5642	17	4	348	2	0	371
5643	9	340	10	5	0	364
5644	3	10	7	335	0	355
5645	338	3	1	12	0	354
5646	12	343	2	7	0	364
5647	351	12	3	3	0	369
5648	357	4	0	5	0	366
5649	359	3	1	4	0	367
5650	352	2	2	4	0	360
5651	17	2	0	345	0	364
5652	344	2	3	13	0	362
5653	15	2	1	337	0	355
5654	5	326	3	11	0	345
5655	4	11	3	332	0	350
5656	335	5	1	13	0	354
5657	13	2	330	5	0	350
5658	6	0	14	328	0	348
5659	326	0	3	13	0	342
5660	13	328	3	4	0	348
5661	324	9	3	3	0	339
5662	327	3	3	2	0	335
5663	16	330	2	1	0	349
5664	335	11	2	5	0	353
5665	16	1	317	1	0	335
5666	5	2	318	1	0	326
5667	303	4	13	2	0	322
5668	13	3	299	5	0	320
5669	11	0	10	272	0	293
5670	1	288	5	7	0	301
5671	290	10	0	5	0	305
5672	15	276	1	3	0	295
5673	6	291	0	2	0	299
5674	9	8	3	290	0	310
5675	2	2	2	302	0	308
5676	7	0	2	292	0	301
5677	3	1	0	297	0	301
5678	2	2	289	11	0	304
5679	3	0	10	282	0	295
5680	4	0	3	287	0	294
5681	280	2	1	12	0	295
5682	12	0	3	278	0	293
5683	5	2	272	12	0	291
5684	271	3	12	4	0	290
5685	14	1	0	282	0	297
5686	5	1	288	8	0	302
5687	2	2	12	280	0	296
5688	5	284	2	8	0	299
5689	285	8	3	4	0	300
5690	15	1	292	2	0	310
5691	6	259	9	0	0	274
5692	238	8	2	1	0	249
5693	8	210	1	2	0	221
5694	4	197	0	0	0	201
5695	195	5	5	0	0	205
5696	6	176	0	0	0	182
5697	1	184	2	0	0	187
5698	1	3	1	180	0	185
5699	2	0	182	3	0	187
5700	1	188	4	1	0	194
5701	1	3	0	182	0	186
5702	0	174	0	1	0	175
5703	172	1	0	0	0	173
5704	3	1	173	0	0	177
5705	1	0	2	171	0	174
5706	176	0	0	3	0	179
5707	3	0	0	178	0	181
5708	0	0	175	3	0	178
5709	157	1	2	1	0	161
5710	175	0	0	1	0	176
5711	3	182	0	0	0	185
5712	1	1	1	180	0	183
5713	0	0	0	185	0	185
5714	180	0	0	3	0	183
5715	176	1	0	0	0	177
5716	3	0	177	0	0	180
5717	1	171	2	0	0	174
5718	173	2	0	0	0	175
5719	2	0	0	177	0	179
5720	0	0	180	1	0	181
5721	0	0	156	0	0	156
5722	1	0	1	164	0	166
5723	167	0	7	1	0	175
5724	1	160	0	1	0	162
5725	173	1	0	1	0	175
5726	1	1	0	175	0	177
5727	1	0	0	176	0	177
5728	0	0	0	180	0	180
5729	178	0	0	2	0	180
5730	1	174	0	1	0	176
5731	1	1	0	179	0	181
5732	0	1	0	182	0	183
5733	0	0	185	2	0	187
5734	1	0	0	179	0	180
5735	0	0	190	1	0	191
5736	0	182	1	1	0	184
5737	0	0	1	184	0	185
5738	179	1	0	0	0	180
5739	0	0	184	1	0	185
5740	2	0	0	182	0	184
5741	0	0	176	0	0	176
5742	165	0	0	1	0	166
5743	0	0	180	0	0	180
5744	2	0	0	172	0	174
5745	179	0	1	1	0	181
5746	0	155	0	0	0	155
5747	172	0	0	1	0	173
5748	0	146	0	0	0	146
5749	1	0	0	178	0	179
5750	0	1	167	0	0	168
5751	1	0	168	1	0	170
5752	1	1	1	166	0	169
5753	180	1	0	0	0	181
5754	177	0	0	3	0	180
5755	2	0	0	184	0	186
5756	2	0	0	183	0	185
5757	190	0	0	1	0	191
5758	0	190	0	1	0	191
5759	1	198	0	0	0	199
5760	194	1	0	0	0	195
5761	0	3	196	1	0	200
5762	1	0	0	205	0	206
5763	0	0	200	0	0	200
5764	0	0	0	199	0	199
5765	1	0	201	0	0	202
5766	0	1	181	1	0	183
5767	1	0	0	202	0	203
5768	0	180	1	1	0	182
5769	202	0	0	2	0	204
5770	0	196	0	1	0	197
5771	1	0	0	202	0	203
5772	202	1	0	0	0	203
5773	0	0	0	203	0	203
5774	206	0	0	2	0	208
5775	198	0	1	0	0	199
5776	207	0	0	2	0	209
5777	0	202	1	0	0	203
5778	211	1	0	1	0	213
5779	0	0	0	229	0	229
5780	227	0	1	2	0	230
5781	1	0	1	230	0	232
5782	228	0	0	3	0	231
5783	229	0	1	2	0	232
5784	3	229	0	0	0	232
5785	1	0	1	254	0	256
5786	0	1	0	246	0	247
5787	0	252	0	2	0	254
5788	3	3	0	268	0	274
5789	269	2	0	5	0	276
5790	269	1	0	3	0	273
5791	263	0	0	2	0	265
5792	8	0	284	0	0	292
5793	293	0	4	3	0	300
5794	320	1	2	1	0	324
5795	329	0	0	1	0	330
5796	7	327	1	1	0	336
5797	2	4	0	334	0	340
5798	1	3	0	337	0	341
5799	1	0	0	337	0	338
5800	1	1	329	6	0	337
5801	1	2	4	320	0	327
5802	325	0	3	5	0	333
5803	7	0	1	326	0	334
5804	3	0	0	336	0	339
5805	2	0	331	6	0	339
5806	0	329	5	3	0	337
5807	340	4	2	2	0	348
5808	5	2	0	347	0	354
5809	341	2	0	8	0	351
5810	3	1	349	2	0	355
5811	334	0	4	4	0	342
5812	6	368	3	1	0	378
5813	2	5	374	2	0	383
5814	2	2	371	1	0	376
5815	3	0	6	356	0	365
5816	1	1	394	4	0	400
5817	1	391	5	4	0	401
5818	2	4	2	397	0	405
5819	2	3	1	409	0	415
5820	1	1	3	410	0	415
5821	409	0	1	8	0	418
5822	4	412	0	5	0	421
5823	3	4	2	409	0	418
5824	3	3	2	418	0	426
5825	399	0	1	13	0	413
5826	4	404	1	3	0	412
5827	422	5	1	3	0	431
5828	423	1	1	2	0	427
5829	408	1	0	5	0	414
5830	8	1	412	2	0	423
5831	5	1	5	400	0	411
5832	3	410	2	5	0	420
5833	1	416	2	5	0	424
5834	4	5	1	425	0	435
5835	4	420	0	5	0	429
5836	445	5	1	7	0	458
5837	7	4	443	2	0	456
5838	426	0	4	9	0	439
5839	456	1	2	4	0	463
5840	7	2	2	456	0	467
5841	464	1	1	6	0	472
5842	6	537	0	5	0	548
5843	561	5	0	6	0	572
5844	554	3	2	6	0	565
5845	601	2	0	6	0	609
5846	14	2	603	1	0	620
5847	4	1	607	3	0	615
5848	7	0	11	606	0	624
5849	3	585	4	24	0	616
5850	7	627	2	5	0	641
5851	5	11	3	607	0	626
5852	619	5	1	12	0	637
5853	11	5	1	611	0	628
5854	6	2	2	641	0	651
5855	641	1	2	17	0	661
5856	12	631	1	8	0	652
5857	6	10	639	2	0	657
5858	2	4	621	4	0	631
5859	651	1	10	4	0	666
5860	12	2	2	650	0	666
5861	2	1	667	14	0	684
5862	4	1	12	633	0	650
5863	3	4	3	630	0	640
5864	7	1	3	659	0	670
5865	3	0	2	653	0	658
5866	5	648	1	14	0	668
5867	1	11	3	656	0	671
5868	649	3	1	18	0	671
5869	13	647	1	3	0	664
5870	664	13	0	4	0	681
5871	676	3	3	10	0	692
5872	681	1	2	5	0	689
5873	12	3	670	2	0	687
5874	659	3	10	4	0	676
5875	692	0	3	5	0	700
5876	685	2	1	5	0	693
5877	692	0	2	6	0	700
5878	15	684	7	1	0	707
5879	673	9	0	4	0	686
5880	10	3	666	4	0	683
5881	4	2	9	652	0	667
5882	5	2	1	672	0	680
5883	686	2	0	12	0	700
5884	14	668	2	4	0	688
5885	656	10	0	9	0	675
5886	12	675	1	3	0	691
5887	680	8	2	6	0	696
5888	668	3	0	6	0	677
5889	9	713	1	1	0	724
5890	719	12	2	3	0	736
5891	764	1	1	2	0	768
5892	20	718	4	2	0	744
5893	3	725	3	1	0	732
5894	746	16	1	8	0	771
5895	24	5	0	748	0	777
5896	745	4	0	21	0	770
5897	772	1	2	7	0	782
5898	762	1	0	11	0	774
5899	756	0	0	10	0	766
5900	28	723	0	7	0	758
5901	8	764	0	1	0	773
5902	759	24	0	4	0	787
5903	24	5	751	0	0	780
5904	12	2	21	726	0	761
5905	6	2	4	770	0	782
5906	749	1	3	26	0	779
5907	23	744	5	6	0	778
5908	11	21	1	740	0	773
5909	6	5	0	770	0	781
5910	745	2	0	34	0	781
5911	29	1	1	752	0	783
5912	747	3	3	30	0	783
5913	766	1	0	14	0	781
5914	766	2	0	6	0	774
5915	31	5	1	734	0	771
5916	15	3	0	747	0	765
5917	10	2	791	27	0	830
5918	6	3	791	6	0	806
5919	788	0	30	9	0	827
5920	32	1	7	805	0	845
5921	11	4	876	27	0	918
5922	5	3	885	7	0	900
5923	9	3	39	867	0	918
5924	6	6	879	33	0	924
5925	6	1	34	869	0	910
5926	9	1	17	900	0	927
5927	5	7	879	45	0	936
5928	13	0	27	888	0	928
5929	8	4	10	876	0	898
5930	10	4	3	935	0	952
5931	8	2	907	43	0	960
5932	6	4	35	915	0	960
5933	914	1	13	42	0	970
5934	35	898	4	18	0	955
5935	925	29	7	12	0	973
5936	39	10	905	6	0	960
5937	903	5	32	13	0	953
5938	940	5	12	8	0	965
5939	955	9	10	1	0	975
5940	48	2	6	916	0	972
5941	26	0	5	950	0	981
5942	17	1	844	47	0	909
5943	804	3	33	21	0	861
5944	40	796	11	10	0	857
5945	15	771	6	11	0	803
5946	5	807	8	10	0	830
5947	8	38	5	763	0	814
5948	765	13	7	29	0	814
5949	782	8	5	15	0	810
5950	37	5	742	13	0	797
5951	24	2	27	741	0	794
5952	14	3	11	775	0	803
5953	11	1	745	40	0	797
5954	8	3	716	20	0	747
5955	697	3	35	19	0	754
5956	27	714	15	11	0	767
5957	718	25	8	11	0	762
5958	722	11	7	14	0	754
5959	43	5	7	692	0	747
5960	28	3	5	715	0	751
5961	697	8	3	42	0	750
5962	34	3	6	706	0	749
5963	22	3	8	718	0	751
5964	705	2	10	41	0	758
5965	34	0	9	726	0	769
5966	717	6	7	38	0	768
5967	733	3	6	23	0	765
5968	43	4	696	11	0	754
5969	700	2	31	14	0	747
5970	716	4	11	13	0	744
5971	718	6	11	9	0	744
5972	43	3	555	18	0	619
5973	653	3	28	15	0	699
5974	31	654	11	19	0	715
5975	674	25	8	15	0	722
5976	695	9	7	9	0	720
5977	42	3	5	674	0	724
5978	23	4	7	669	0	703
5979	17	659	6	40	0	722
5980	18	25	5	685	0	733
5981	20	12	4	701	0	737
5982	679	5	9	43	0	736
5983	43	4	6	680	0	733
5984	25	6	4	691	0	726
5985	19	4	3	685	0	711
5986	16	640	5	45	0	706
5987	633	21	8	26	0	688
5988	37	644	5	13	0	699
5989	603	24	4	16	0	647
5990	28	10	569	13	0	620
5991	521	9	16	11	0	557
5992	25	4	539	11	0	579
5993	16	517	19	5	0	557
5994	499	11	11	9	0	530
5995	469	8	6	9	0	492
5996	22	462	3	6	0	493
5997	14	468	5	5	0	492
5998	460	19	2	8	0	489
5999	480	7	4	6	0	497
6000	23	6	4	466	0	499
6001	16	5	3	472	0	496
6002	3	6	464	20	0	493
6003	455	3	10	12	0	480
6004	22	2	9	443	0	476
6005	13	459	1	17	0	490
6006	8	9	1	468	0	486
6007	8	9	2	471	0	490
6008	6	3	447	19	0	475
6009	15	3	9	450	0	477
6010	434	5	7	16	0	462
6011	14	427	1	14	0	456
6012	13	426	2	6	0	447
6013	423	11	5	6	0	445
6014	420	9	5	7	0	441
6015	425	3	2	6	0	436
6016	20	394	3	3	0	420
6017	13	342	0	2	0	357
6018	347	7	4	3	0	361
6019	353	5	3	3	0	364
6020	15	340	1	2	0	358
6021	0	272	0	2	0	274
6022	267	6	0	2	0	275
6023	5	2	0	266	0	273
6024	270	1	1	4	0	276
6025	5	0	1	261	0	267
6026	2	251	1	5	0	259
6027	2	253	1	1	0	257
6028	252	4	5	2	0	263
6029	242	1	4	0	0	247
6030	253	1	0	2	0	256
6031	7	252	0	0	0	259
6032	2	5	243	0	0	250
6033	1	245	4	0	0	250
6034	237	4	5	0	0	246
6035	225	2	2	3	0	232
6036	4	0	228	0	0	232
6037	2	211	4	0	0	217
6038	0	5	1	220	0	226
6039	3	2	0	200	0	205
6040	3	165	0	13	0	181
6041	3	4	197	1	0	205
6042	198	2	4	1	0	205
6043	4	2	0	202	0	208
6044	203	1	2	4	0	210
6045	215	2	0	1	0	218
6046	8	3	0	218	0	229
6047	3	0	2	228	0	233
6048	2	2	2	234	0	240
6049	2	2	1	237	0	242
6050	232	1	0	9	0	242
6051	234	0	2	3	0	239
6052	8	3	228	0	0	239
6053	2	0	8	230	0	240
6054	1	0	2	236	0	239
6055	0	1	0	245	0	246
6056	2	0	235	8	0	245
6057	4	1	5	231	0	241
6058	234	0	3	8	0	245
6059	8	0	0	239	0	247
6060	4	0	234	8	0	246
6061	2	0	5	240	0	247
6062	3	0	237	7	0	247
6063	243	0	4	6	0	253
6064	9	0	4	246	0	259
6065	242	0	0	9	0	251
6066	243	1	0	4	0	248
6067	9	1	2	238	0	250
6068	260	0	2	8	0	270
6069	6	0	1	255	0	262
6070	6	260	0	6	0	272
6071	274	6	2	5	0	287
6072	274	3	2	3	0	282
6073	270	2	1	2	0	275
6074	11	0	2	271	0	284
6075	8	0	2	273	0	283
6076	1	1	1	282	0	285
6077	2	1	262	8	0	273
6078	5	263	6	4	0	278
6079	0	6	2	263	0	271
6080	6	3	246	5	0	260
6081	244	0	7	5	0	256
6082	9	3	2	253	0	267
6083	7	1	244	6	0	258
6084	258	0	5	5	0	268
6085	9	2	2	274	0	287
6086	6	0	0	278	0	284
6087	2	2	0	285	0	289
6088	283	0	0	10	0	293
6089	285	1	2	6	0	294
6090	286	2	0	3	0	291
6091	9	260	0	5	0	274
6092	2	258	6	1	0	267
6093	264	7	0	2	0	273
6094	8	2	252	5	0	267
6095	3	0	10	265	0	278
6096	5	2	3	268	0	278
6097	279	0	0	13	0	292
6098	277	0	2	6	0	285
6099	7	265	0	6	0	278
6100	3	6	2	278	0	289
6101	2	1	270	12	0	285
6102	1	0	278	7	0	286
6103	4	2	8	290	0	304
6104	4	2	2	299	0	307
6105	291	0	1	10	0	302
6106	9	0	5	286	0	300
6107	298	1	0	12	0	311
6108	287	0	1	10	0	298
6109	10	0	305	3	0	318
6110	303	1	6	3	0	313
6111	306	1	2	4	0	313
6112	311	0	1	5	0	317
6113	8	301	3	4	0	316
6114	2	299	3	3	0	307
6115	3	7	1	307	0	318
6116	2	1	303	9	0	315
6117	2	288	9	1	0	300
6118	1	7	1	277	0	286
6119	5	1	0	271	0	277
6120	2	271	1	7	0	281
6121	276	4	3	4	0	287
6122	283	2	0	3	0	288
6123	7	1	281	2	0	291
6124	283	1	6	2	0	292
6125	8	2	282	2	0	294
6126	262	1	3	3	0	269
6127	7	1	273	1	0	282
6128	3	274	3	3	0	283
6129	6	2	1	269	0	278
6130	2	1	1	269	0	273
6131	267	2	1	6	0	276
6132	267	1	0	5	0	273
6133	267	0	2	2	0	271
6134	8	1	269	0	0	278
6135	3	1	3	266	0	273
6136	1	2	4	273	0	280
6137	271	0	1	6	0	278
6138	4	263	4	3	0	274
6139	282	3	1	4	0	290
6140	4	3	0	287	0	294
6141	4	0	1	292	0	297
6142	5	1	1	295	0	302
6143	3	2	0	292	0	297
6144	3	1	1	291	0	296
6145	2	276	2	5	0	285
6146	4	258	0	0	0	262
6147	1	252	1	0	0	254
6148	2	3	0	251	0	256
6149	1	1	250	1	0	253
6150	226	1	2	1	0	230
6151	1	257	2	2	0	262
6152	3	1	0	261	0	265
6153	2	3	1	258	0	264
6154	262	1	0	4	0	267
6155	254	2	0	1	0	257
6156	272	1	1	1	0	275
6157	4	0	1	280	0	285
6158	1	0	282	2	0	285
6159	1	0	296	2	0	299
6160	0	1	3	308	0	312
6161	2	0	304	2	0	308
6162	291	0	1	4	0	296
6163	3	0	1	295	0	299
6164	2	1	300	2	0	305
6165	3	0	2	285	0	290
6166	1	0	311	2	0	314
6167	1	0	333	2	0	336
6168	0	0	2	338	0	340
6169	1	1	364	2	0	368
6170	2	0	339	3	0	344
6171	0	328	7	0	0	335
6172	1	12	4	354	0	371
6173	365	4	1	14	0	384
6174	13	1	0	363	0	377
6175	4	0	0	381	0	385
6176	3	0	372	12	0	387
6177	336	0	13	5	0	354
6178	14	0	3	376	0	393
6179	4	0	1	394	0	399
6180	379	0	1	14	0	394
6181	13	0	1	379	0	393
6182	373	0	0	14	0	387
6183	377	0	1	4	0	382
6184	386	0	0	3	0	389
6185	15	358	2	3	0	378
6186	368	13	1	1	0	383
6187	12	369	0	2	0	383
6188	3	13	1	374	0	391
6189	369	4	1	12	0	386
6190	13	376	0	3	0	392
6191	379	12	1	4	0	396
6192	12	374	2	1	0	389
6193	372	14	0	2	0	388
6194	13	376	1	2	0	392
6195	5	384	0	0	0	389
6196	2	411	1	1	0	415
6197	0	16	1	378	0	395
6198	0	390	2	12	0	404
6199	1	14	1	390	0	406
6200	1	2	0	395	0	398
6201	3	1	1	390	0	395
6202	5	0	0	385	0	390
6203	366	0	1	21	0	388
6204	379	0	1	7	0	387
6205	16	0	363	3	0	382
6206	380	0	13	2	0	395
6207	412	2	4	1	0	419
6208	419	0	1	5	0	425
6209	16	1	395	2	0	414
6210	4	0	406	0	0	410
6211	398	2	15	2	0	417
6212	13	0	418	1	0	432
6213	4	435	14	0	0	453
6214	2	14	3	445	0	464
6215	450	4	1	20	0	475
6216	457	2	2	5	0	466
6217	462	2	0	2	0	466
6218	21	0	0	443	0	464
6219	5	1	0	465	0	471
6220	3	0	451	18	0	472
6221	3	0	14	454	0	471
6222	2	0	3	470	0	475
6223	452	0	1	22	0	475
6224	16	461	1	4	0	482
6225	475	16	0	3	0	494
6226	19	3	1	471	0	494
6227	472	1	1	16	0	490
6228	476	2	0	5	0	483
6229	467	1	0	4	0	472
6230	18	441	1	1	0	461
6231	7	479	1	1	0	488
6232	6	17	0	466	0	489
6233	468	3	2	17	0	490
6234	16	4	1	467	0	488
6235	5	2	1	477	0	485
6236	3	1	466	19	0	489
6237	2	2	16	459	0	479
6238	6	1	3	467	0	477
6239	3	1	4	469	0	477
6240	3	2	453	18	0	476
6241	4	1	452	7	0	464
6242	4	447	17	4	0	472
6243	445	15	4	5	0	469
6244	19	3	4	442	0	468
6245	3	3	452	17	0	475
6246	4	2	15	454	0	475
6247	4	0	2	492	0	498
6248	475	1	1	21	0	498
6249	477	1	2	6	0	486
6250	18	461	2	7	0	488
6251	468	14	2	5	0	489
6252	471	3	2	4	0	480
6253	22	2	2	459	0	485
6254	6	4	473	19	0	502
6255	6	467	18	5	0	496
6256	462	16	4	4	0	486
6257	464	5	3	7	0	479
6258	18	470	4	5	0	497
6259	7	17	1	488	0	513
6260	516	4	2	22	0	544
6261	517	3	3	6	0	529
6262	24	4	1	517	0	546
6263	520	5	0	23	0	548
6264	553	1	1	5	0	560
6265	551	3	2	6	0	562
6266	25	4	525	5	0	559
6267	10	500	21	6	0	537
6268	5	530	3	5	0	543
6269	498	19	1	6	0	524
6270	20	505	1	3	0	529
6271	4	11	487	5	0	507
6272	7	5	10	476	0	498
6273	490	2	1	12	0	505
6274	14	3	0	492	0	509
6275	488	1	2	15	0	506
6276	492	2	1	9	0	504
6277	505	1	3	6	0	515
6278	16	485	2	4	0	507
6279	3	540	3	3	0	549
6280	527	11	2	6	0	546
6281	521	3	4	4	0	532
6282	534	3	1	6	0	544
6283	13	4	0	528	0	545
6284	518	0	2	14	0	534
6285	12	500	2	6	0	520
6286	6	531	4	5	0	546
6287	3	13	2	525	0	543
6288	8	1	514	12	0	535
6289	5	3	506	5	0	519
6290	8	3	16	500	0	527
6291	4	4	504	14	0	526
6292	7	3	11	515	0	536
6293	515	1	3	15	0	534
6294	16	4	1	512	0	533
6295	508	2	2	17	0	529
6296	18	498	2	6	0	524
6297	15	13	494	3	0	525
6298	7	4	13	483	0	507
6299	11	4	2	502	0	519
6300	8	6	487	13	0	514
6301	10	1	13	473	0	497
6302	7	488	3	10	0	508
6303	5	13	3	499	0	520
6304	9	5	4	520	0	538
6305	12	6	1	544	0	563
6306	7	6	551	14	0	578
6307	4	1	506	9	0	520
6308	485	1	13	8	0	507
6309	15	2	489	5	0	511
6310	4	485	14	4	0	507
6311	477	12	1	7	0	497
6312	16	482	1	4	0	503
6313	466	12	4	6	0	488
6314	470	3	2	6	0	481
6315	469	1	3	5	0	478
6316	473	2	3	4	0	482
6317	13	454	0	3	0	470
6318	3	460	2	4	0	469
6319	459	9	0	6	0	474
6320	15	3	453	2	0	473
6321	5	5	7	440	0	457
6322	3	1	2	463	0	469
6323	2	3	446	11	0	462
6324	407	3	11	8	0	429
6325	438	0	4	5	0	447
6326	429	1	5	5	0	440
6327	12	424	3	5	0	444
6328	440	9	2	6	0	457
6329	10	4	4	427	0	445
6330	7	463	1	12	0	483
6331	470	16	1	3	0	490
6332	474	4	7	5	0	490
6333	505	4	2	3	0	514
6334	21	2	1	493	0	517
6335	7	0	4	497	0	508
6336	5	482	0	18	0	505
6337	5	10	496	6	0	517
6338	3	4	12	502	0	521
6339	7	4	4	497	0	512
6340	5	4	1	518	0	528
6341	2	0	497	16	0	515
6342	480	3	12	7	0	502
6343	17	1	3	504	0	525
6344	4	1	522	15	0	542
6345	5	3	14	505	0	527
6346	520	3	2	17	0	542
6347	14	522	3	9	0	548
6348	10	13	2	540	0	565
6349	7	5	534	13	0	559
6350	515	4	16	4	0	539
6351	543	1	4	5	0	553
6352	17	3	538	3	0	561
6353	12	3	14	495	0	524
6354	6	506	3	11	0	526
6355	522	14	5	7	0	548
6356	16	7	509	4	0	536
6357	503	1	8	8	0	520
6358	13	0	503	2	0	518
6359	6	2	459	5	0	472
6360	427	1	12	3	0	443
6361	13	451	5	1	0	470
6362	12	11	446	2	0	471
6363	7	435	9	2	0	453
6364	3	10	424	3	0	440
6365	3	432	9	2	0	446
6366	427	10	2	3	0	442
6367	8	1	419	4	0	432
6368	5	1	413	2	0	421
6369	2	2	414	2	0	420
6370	420	0	10	1	0	431
6371	422	1	2	2	0	427
6372	8	2	2	418	0	430
6373	3	1	443	6	0	453
6374	4	0	434	2	0	440
6375	439	1	8	6	0	454
6376	9	1	2	448	0	460
6377	436	0	1	9	0	446
6378	432	1	2	5	0	440
6379	10	0	2	397	0	409
6380	5	403	1	9	0	418
6381	4	7	2	418	0	431
6382	5	2	1	431	0	439
6383	3	3	419	9	0	434
6384	3	409	6	5	0	423
6385	2	409	3	5	0	419
6386	1	6	7	408	0	422
6387	2	2	411	8	0	423
6388	3	410	4	5	0	422
6389	1	5	421	3	0	430
6390	406	2	6	4	0	418
6391	422	3	3	2	0	430
6392	7	2	407	3	0	419
6393	401	1	7	3	0	412
6394	7	0	2	411	0	420
6395	4	421	3	6	0	434
6396	3	6	3	427	0	439
6397	424	1	1	6	0	432
6398	416	2	3	5	0	426
6399	424	2	0	3	0	429
6400	433	1	1	3	0	438
6401	6	419	4	2	0	431
6402	4	431	1	2	0	438
6403	422	7	8	0	0	437
6404	6	1	419	1	0	427
6405	4	9	6	380	0	399
6406	3	400	2	5	0	410
6407	3	5	3	397	0	408
6408	1	409	3	3	0	416
6409	4	6	1	411	0	422
6410	1	4	406	8	0	419
6411	390	2	8	4	0	404
6412	412	1	2	4	0	419
6413	7	3	415	1	0	426
6414	407	2	6	2	0	417
6415	423	2	2	2	0	429
6416	8	1	407	1	0	417
6417	5	3	7	398	0	413
6418	412	0	6	8	0	426
6419	10	0	415	3	0	428
6420	7	0	8	392	0	407
6421	3	1	415	7	0	426
6422	4	2	408	3	0	417
6423	414	1	10	3	0	428
6424	420	2	5	3	0	430
6425	416	1	4	3	0	424
6426	436	0	4	2	0	442
6427	13	0	2	420	0	435
6428	6	398	4	8	0	416
6429	6	423	2	2	0	433
6430	5	6	0	389	0	400
6431	381	3	2	9	0	395
6432	6	370	2	1	0	379
6433	2	362	2	1	0	367
6434	363	7	0	2	0	372
6435	8	2	0	359	0	369
6436	359	2	1	7	0	369
6437	7	360	1	3	0	371
6438	365	7	1	2	0	375
6439	8	3	383	1	0	395
6440	429	3	7	3	0	442
6441	461	1	4	4	0	470
6442	477	0	5	3	0	485
6443	18	3	425	0	0	446
6444	449	1	7	2	0	459
6445	15	459	4	0	0	478
6446	9	11	451	0	0	471
6447	7	2	12	429	0	450
6448	3	3	5	417	0	428
6449	2	428	3	14	0	447
6450	5	11	1	432	0	449
6451	2	3	3	443	0	451
6452	0	4	429	17	0	450
6453	411	2	12	5	0	430
6454	13	0	436	6	0	455
6455	8	1	14	416	0	439
6456	3	2	432	12	0	449
6457	4	0	14	434	0	452
6458	440	0	5	18	0	463
6459	458	1	3	6	0	468
6460	18	1	2	446	0	467
6461	8	2	445	13	0	468
6462	4	0	11	450	0	465
6463	2	2	445	13	0	462
6464	434	2	13	8	0	457
6465	455	2	5	4	0	466
6466	450	0	2	4	0	456
6467	441	2	3	5	0	451
6468	23	409	1	2	0	435
6469	9	14	2	416	0	441
6470	413	6	1	13	0	433
6471	17	408	5	5	0	435
6472	10	419	2	3	0	434
6473	9	17	383	2	0	411
6474	402	6	15	3	0	426
6475	406	7	5	3	0	421
6476	22	1	388	4	0	415
6477	9	3	14	388	0	414
6478	9	1	9	402	0	421
6479	6	2	388	18	0	414
6480	6	1	17	393	0	417
6481	387	1	6	20	0	414
6482	17	0	375	9	0	401
6483	8	1	382	7	0	398
6484	376	2	18	5	0	401
6485	19	1	378	4	0	402
6486	379	1	20	5	0	405
6487	20	372	8	6	0	406
6488	379	14	6	6	0	405
6489	19	6	8	371	0	404
6490	11	7	0	381	0	399
6491	385	2	3	19	0	409
6492	20	1	2	381	0	404
6493	387	2	3	17	0	409
6494	17	377	2	11	0	407
6495	9	12	3	370	0	394
6496	10	7	3	384	0	404
6497	380	4	2	23	0	409
6498	390	3	3	12	0	408
6499	389	3	2	8	0	402
6500	23	357	2	4	0	386
6501	14	366	5	3	0	388
6502	369	13	3	6	0	391
6503	20	6	362	5	0	393
6504	9	358	14	3	0	384
6505	335	12	5	5	0	357
6506	325	2	4	4	0	335
6507	331	2	3	1	0	337
6508	19	2	2	305	0	328
6509	315	2	5	12	0	334
6510	318	1	3	7	0	329
6511	16	2	3	306	0	327
6512	308	3	0	13	0	324
6513	18	2	290	3	0	313
6514	10	1	11	293	0	315
6515	7	3	5	296	0	311
6516	7	0	5	304	0	316
6517	284	0	3	23	0	310
6518	302	1	1	11	0	315
6519	302	1	6	3	0	312
6520	299	1	3	7	0	310
6521	296	0	1	4	0	301
6522	21	1	3	270	0	295
6523	9	0	1	283	0	293
6524	269	1	2	14	0	286
6525	17	266	1	7	0	291
6526	260	11	5	4	0	280
6527	14	4	248	5	0	271
6528	262	2	11	2	0	277
6529	274	2	4	2	0	282
6530	16	3	286	1	0	306
6531	315	3	14	1	0	333
6532	18	0	320	2	0	340
6533	10	0	339	2	0	351
6534	9	3	18	330	0	360
6535	5	2	11	354	0	372
6536	3	1	349	18	0	371
6537	2	2	340	13	0	357
6538	3	334	18	8	0	363
6539	2	327	12	4	0	345
6540	263	12	11	2	0	288
6541	6	281	4	2	0	293
6542	263	10	4	2	0	279
6543	9	265	3	0	0	277
6544	264	10	1	1	0	276
6545	10	7	244	0	0	261
6546	251	5	6	0	0	262
6547	11	2	5	241	0	259
6548	7	247	4	6	0	264
6549	7	7	1	261	0	276
6550	262	4	0	12	0	278
6551	267	6	1	5	0	279
6552	14	2	0	264	0	280
6553	7	2	255	9	0	273
6554	6	2	256	5	0	269
6555	2	259	9	5	0	275
6556	5	16	6	253	0	280
6557	1	3	251	10	0	265
6558	1	239	9	3	0	252
6559	3	8	4	243	0	258
6560	1	4	3	251	0	259
6561	230	5	2	12	0	249
6562	9	1	2	237	0	249
6563	3	2	232	12	0	249
6564	4	1	7	232	0	244
6565	228	1	4	14	0	247
6566	8	1	234	6	0	249
6567	231	0	9	6	0	246
6568	11	235	3	3	0	252
6569	244	6	3	2	0	255
6570	251	2	2	3	0	258
6571	15	3	6	237	0	261
6572	9	1	3	244	0	257
6573	6	235	3	11	0	255
6574	2	8	4	253	0	267
6575	247	3	2	12	0	264
6576	8	4	239	6	0	257
6577	6	3	9	244	0	262
6578	5	249	5	8	0	267
6579	4	11	3	253	0	271
6580	3	7	1	266	0	277
6581	252	4	1	12	0	269
6582	7	253	1	9	0	270
6583	8	7	1	256	0	272
6584	254	6	3	9	0	272
6585	14	3	0	259	0	276
6586	5	3	3	266	0	277
6587	265	3	1	13	0	282
6588	264	2	0	13	0	279
6589	15	3	263	6	0	287
6590	260	0	9	7	0	276
6591	270	0	3	7	0	280
6592	270	1	6	3	0	280
6593	14	243	6	4	0	267
6594	9	245	5	1	0	260
6595	5	10	3	249	0	267
6596	250	11	2	10	0	273
6597	260	5	1	6	0	272
6598	13	3	2	251	0	269
6599	10	3	260	9	0	282
6600	265	2	7	8	0	282
6601	272	1	4	8	0	285
6602	16	1	6	261	0	284
6603	9	1	1	270	0	281
6604	263	0	4	13	0	280
6605	12	2	3	263	0	280
6606	9	252	1	13	0	275
6607	8	8	3	264	0	283
6608	274	3	0	12	0	289
6609	11	5	266	8	0	290
6610	260	0	8	9	0	277
6611	12	2	271	4	0	289
6612	5	4	10	265	0	284
6613	282	0	3	18	0	303
6614	12	3	6	281	0	302
6615	3	2	3	291	0	299
6616	284	2	1	14	0	301
6617	8	2	281	11	0	302
6618	8	0	289	10	0	307
6619	7	2	12	296	0	317
6620	4	1	7	310	0	322
6621	4	2	4	313	0	323
6622	5	1	303	15	0	324
6623	294	2	9	11	0	316
6624	322	0	4	11	0	337
6625	321	2	4	6	0	333
6626	320	0	1	5	0	326
6627	16	295	2	5	0	318
6628	10	303	4	3	0	320
6629	10	297	0	3	0	310
6630	4	11	2	246	0	263
6631	2	1	0	251	0	254
6632	2	1	236	4	0	243
6633	1	208	4	1	0	214
6634	1	3	0	201	0	205
6635	198	0	0	3	0	201
6636	3	196	0	0	0	199
6637	0	3	0	194	0	197
6638	0	188	0	3	0	191
6639	190	3	0	3	0	196
6640	3	0	0	186	0	189
6641	0	0	178	3	0	181
6642	0	1	178	0	0	179
6643	2	0	3	179	0	184
6644	0	0	0	183	0	183
6645	1	0	0	190	0	191
6646	186	0	0	4	0	190
6647	3	0	181	0	0	184
6648	0	183	3	0	0	186
6649	0	1	0	178	0	179
6650	0	0	186	1	0	187
6651	0	189	1	0	0	190
6652	1	1	0	194	0	196
6653	0	0	199	0	0	199
6654	1	0	0	193	0	194
6655	2	0	0	191	0	193
6656	197	0	0	3	0	200
6657	194	0	0	2	0	196
6658	0	0	0	199	0	199
6659	199	0	0	2	0	201
6660	1	0	199	0	0	200
6661	0	0	1	201	0	202
6662	0	0	208	1	0	209
6663	1	0	1	206	0	208
6664	0	199	0	1	0	200
6665	0	209	0	0	0	209
6666	0	205	0	0	0	205
6667	1	1	0	199	0	201
6668	0	0	0	241	0	241
6669	1	0	235	6	0	242
6670	0	0	225	1	0	226
6671	0	1	245	1	0	247
6672	276	0	3	1	0	280
6673	3	0	0	300	0	303
6674	293	0	0	7	0	300
6675	4	307	0	2	0	313
6676	3	7	0	315	0	325
6677	315	3	0	7	0	325
6678	8	0	0	315	0	323
6679	315	0	1	9	0	325
6680	7	1	314	5	0	327
6681	5	312	8	0	0	325
6682	3	8	4	311	0	326
6683	315	4	0	9	0	328
6684	325	0	1	5	0	331
6685	11	2	0	319	0	332
6686	4	0	0	325	0	329
6687	313	0	0	13	0	326
6688	9	0	0	309	0	318
6689	5	0	306	8	0	319
6690	0	309	8	5	0	322
6691	1	9	3	308	0	321
6692	311	3	0	10	0	324
6693	321	0	1	6	0	328
6694	13	1	315	0	0	329
6695	4	307	7	2	0	320
6696	1	328	4	2	0	335
6697	3	11	0	329	0	343
6698	3	4	1	341	0	349
6699	1	0	2	337	0	340
6700	3	3	0	330	0	336
6701	2	324	0	15	0	341
6702	3	9	1	334	0	347
6703	2	5	0	341	0	348
6704	328	0	2	16	0	346
6705	331	2	2	4	0	339
6706	11	330	0	3	0	344
6707	327	9	0	3	0	339
6708	332	4	0	1	0	337
6709	333	0	0	2	0	335
6710	12	2	310	3	0	327
6711	7	0	9	318	0	334
6712	2	0	5	331	0	338
6713	2	1	318	15	0	336
6714	1	1	12	319	0	333
6715	5	2	5	308	0	320
6716	323	3	0	14	0	340
6717	11	1	305	7	0	324
6718	7	1	8	301	0	317
6719	293	1	3	13	0	310
6720	10	297	0	6	0	313
6721	302	10	2	5	0	319
6722	302	5	1	6	0	314
6723	14	295	3	2	0	314
6724	6	9	2	293	0	310
6725	292	5	0	12	0	309
6726	11	297	0	8	0	316
6727	8	11	2	295	0	316
6728	296	6	0	12	0	314
6729	302	0	0	7	0	309
6730	14	290	2	3	0	309
6731	297	10	0	4	0	311
6732	13	3	2	290	0	308
6733	297	1	4	9	0	311
6734	9	4	292	7	0	312
6735	8	0	9	288	0	305
6736	4	2	4	299	0	309
6737	289	1	2	13	0	305
6738	8	287	3	8	0	306
6739	280	10	0	6	0	296
6740	11	279	0	3	0	293
6741	7	9	275	6	0	297
6742	3	6	281	5	0	295
6743	4	3	18	272	0	297
6744	0	4	276	15	0	295
6745	4	3	10	273	0	290
6746	2	1	4	276	0	283
6747	2	2	1	289	0	294
6748	265	2	1	16	0	284
6749	271	1	1	7	0	280
6750	276	4	0	2	0	282
6751	14	249	3	5	0	271
6752	8	277	2	5	0	292
6753	5	15	288	3	0	311
6754	1	6	19	292	0	318
6755	3	1	298	20	0	322
6756	4	1	13	296	0	314
6757	5	0	7	301	0	313
6758	2	1	3	310	0	316
6759	2	2	285	20	0	309
6760	3	1	13	288	0	305
6761	279	1	7	15	0	302
6762	16	274	2	9	0	301
6763	10	14	2	278	0	304
6764	279	7	1	17	0	304
6765	293	1	1	8	0	303
6766	22	1	2	276	0	301
6767	9	3	1	279	0	292
6768	244	0	1	18	0	263
6769	18	1	0	244	0	263
6770	237	0	1	19	0	257
6771	16	2	1	221	0	240
6772	8	1	192	15	0	216
6773	3	162	11	4	0	180
6774	2	182	2	2	0	188
6775	1	10	9	149	0	169
6776	1	2	1	160	0	164
6777	157	1	0	9	0	167
6778	8	0	0	160	0	168
6779	3	0	1	163	0	167
6780	3	0	0	158	0	161
6781	2	146	0	9	0	157
6782	2	11	1	149	0	163
6783	1	0	1	162	0	164
6784	1	2	3	156	0	162
6785	140	1	1	10	0	152
6786	7	146	2	2	0	157
6787	1	7	0	155	0	163
6788	4	0	1	158	0	163
6789	1	1	0	162	0	164
6790	151	0	0	11	0	162
6791	8	1	1	154	0	164
6792	3	0	0	156	0	159
6793	0	2	139	8	0	149
6794	1	132	8	3	0	144
6795	2	7	1	135	0	145
6796	129	0	1	11	0	141
6797	9	133	2	0	0	144
6798	121	7	1	5	0	134
6799	134	0	0	2	0	136
6800	7	2	0	127	0	136
6801	1	0	2	129	0	132
6802	3	0	124	8	0	135
6803	3	0	7	127	0	137
6804	0	2	131	11	0	144
6805	0	0	9	134	0	143
6806	131	1	0	10	0	142
6807	8	136	2	4	0	150
6808	2	7	0	149	0	158
6809	3	1	0	156	0	160
6810	5	2	1	150	0	158
6811	3	1	1	153	0	158
6812	146	1	0	11	0	158
6813	7	147	0	5	0	159
6814	2	7	1	155	0	165
6815	157	2	0	8	0	167
6816	8	2	149	2	0	161
6817	145	0	7	5	0	157
6818	157	0	0	4	0	161
6819	9	2	153	1	0	165
6820	2	0	7	152	0	161
6821	159	0	0	11	0	170
6822	8	156	1	3	0	168
6823	155	8	0	5	0	168
6824	167	1	1	3	0	172
6825	160	3	0	2	0	165
6826	8	2	0	160	0	170
6827	5	0	0	169	0	174
6828	4	182	1	5	0	192
6829	2	7	0	189	0	198
6830	188	0	0	10	0	198
6831	7	1	189	1	0	198
6832	181	1	7	5	0	194
6833	196	1	1	1	0	199
6834	9	1	1	187	0	198
6835	4	1	0	194	0	199
6836	193	1	1	9	0	204
6837	202	0	0	3	0	205
6838	188	1	0	4	0	193
6839	8	0	187	5	0	200
6840	1	192	7	3	0	203
6841	197	6	0	3	0	206
6842	9	1	2	192	0	204
6843	1	187	1	9	0	198
6844	3	6	1	195	0	205
6845	195	2	2	9	0	208
6846	6	2	0	206	0	214
6847	1	1	206	10	0	218
6848	3	204	5	3	0	215
6849	2	212	0	4	0	218
6850	3	6	201	0	0	210
6851	169	5	12	1	0	187
6852	5	180	1	1	0	187
6853	2	2	1	153	0	158
6854	151	1	0	2	0	154
6855	2	149	0	1	0	152
6856	1	1	0	152	0	154
6857	152	1	0	1	0	154
6858	1	0	1	148	0	150
6859	152	1	0	1	0	154
6860	2	1	160	0	0	163
6861	0	159	1	2	0	162
6862	164	2	0	1	0	167
6863	162	0	0	2	0	164
6864	159	0	0	0	0	159
6865	1	1	157	1	0	160
6866	148	1	2	0	0	151
6867	159	1	0	0	0	160
6868	2	1	0	157	0	160
6869	161	0	1	1	0	163
6870	2	148	1	0	0	151
6871	1	2	0	154	0	157
6872	1	0	158	2	0	161
6873	2	1	1	157	0	161
6874	2	1	0	161	0	164
6875	157	1	1	2	0	161
6876	160	0	0	1	0	161
6877	1	1	149	0	0	151
6878	145	0	1	2	0	148
6879	2	0	147	1	0	150
6880	2	2	1	147	0	152
6881	2	0	149	2	0	153
6882	3	0	1	147	0	151
6883	2	146	0	2	0	150
6884	1	1	152	0	0	154
6885	1	0	155	1	0	157
6886	2	2	2	128	0	134
6887	155	0	0	2	0	157
6888	149	1	1	0	0	151
6889	148	1	1	2	0	152
6890	1	0	2	147	0	150
6891	1	0	1	150	0	152
6892	3	0	0	146	0	149
6893	1	1	0	148	0	150
6894	4	0	145	1	0	150
6895	3	1	1	143	0	148
6896	0	145	1	4	0	150
6897	2	1	1	147	0	151
6898	142	0	2	3	0	147
6899	0	1	146	2	0	149
6900	126	0	3	1	0	130
6901	4	2	152	1	0	159
6902	1	0	155	1	0	157
6903	2	154	4	1	0	161
6904	0	2	2	144	0	148
6905	3	0	0	165	0	168
6906	1	153	2	2	0	158
6907	181	1	0	2	0	184
6908	3	2	0	196	0	201
6909	0	0	1	208	0	209
6910	1	0	2	211	0	214
6911	252	1	0	10	0	263
6912	260	0	0	5	0	265
6913	8	0	1	250	0	259
6914	4	0	0	247	0	251
6915	237	0	1	9	0	247
6916	7	0	0	239	0	246
6917	4	0	1	242	0	247
6918	2	0	0	246	0	248
6919	1	0	238	8	0	247
6920	232	1	5	5	0	243
6921	235	2	2	2	0	241
6922	6	1	224	4	0	235
6923	5	0	6	209	0	220
6924	3	226	3	5	0	237
6925	223	5	2	3	0	233
6926	6	218	1	3	0	228
6927	4	222	2	2	0	230
6928	1	7	2	206	0	216
6929	204	1	1	8	0	214
6930	213	2	0	4	0	219
6931	8	1	1	210	0	220
6932	3	1	2	215	0	221
6933	2	2	0	216	0	220
6934	1	2	0	221	0	224
6935	2	1	0	209	0	212
6936	3	205	0	7	0	215
6937	2	5	2	207	0	216
6938	206	1	1	8	0	216
6939	211	2	0	3	0	216
6940	211	0	0	3	0	214
6941	6	200	1	5	0	212
6942	4	5	0	206	0	215
6943	4	2	198	10	0	214
6944	200	2	9	5	0	216
6945	8	5	1	203	0	217
6946	205	1	2	5	0	213
6947	199	1	0	6	0	206
6948	205	0	0	5	0	210
6949	10	0	1	200	0	211
6950	201	1	2	6	0	210
6951	9	1	0	201	0	211
6952	3	0	2	204	0	209
6953	204	0	3	6	0	213
6954	7	0	0	206	0	213
6955	201	3	1	9	0	214
6956	205	0	0	5	0	210
6957	11	2	0	197	0	210
6958	7	2	0	204	0	213
6959	5	2	0	204	0	211
6960	5	0	182	11	0	198
6961	5	0	187	8	0	200
6962	5	0	5	191	0	201
6963	4	0	2	192	0	198
6964	5	0	3	196	0	204
6965	4	0	2	193	0	199
6966	3	0	1	199	0	203
6967	184	2	2	11	0	199
6968	6	178	2	10	0	196
6969	5	6	1	190	0	202
6970	190	1	3	6	0	200
6971	10	3	1	187	0	201
6972	4	4	1	182	0	191
6973	180	2	1	10	0	193
6974	180	2	2	7	0	191
6975	8	1	171	5	0	185
6976	7	0	5	177	0	189
6977	6	2	175	8	0	191
6978	3	2	6	183	0	194
6979	5	1	2	182	0	190
6980	5	1	1	181	0	188
6981	5	1	176	12	0	194
6982	2	165	4	10	0	181
6983	5	173	1	8	0	187
6984	6	5	3	175	0	189
6985	167	3	1	10	0	181
6986	8	3	169	4	0	184
6987	4	4	180	6	0	194
6988	3	1	6	185	0	195
6989	4	2	5	181	0	192
6990	2	178	3	13	0	196
6991	4	5	2	184	0	195
6992	4	4	3	187	0	198
6993	4	3	2	195	0	204
6994	188	0	3	12	0	203
6995	191	0	1	10	0	202
6996	6	1	3	191	0	201
6997	7	184	0	10	0	201
6998	6	4	0	194	0	204
6999	181	4	0	11	0	196
7000	6	188	2	7	0	203
7001	8	4	0	167	0	179
7002	3	161	0	11	0	175
7003	162	5	0	9	0	176
7004	151	1	1	5	0	158
7005	7	146	2	5	0	160
7006	4	140	6	1	0	151
7007	3	4	124	2	0	133
7008	1	105	5	3	0	114
7009	1	4	0	101	0	106
7010	0	2	91	7	0	100
7011	0	43	0	0	0	43
7012	0	0	0	39	0	39
7013	0	0	1	39	0	40
7014	0	0	1	39	0	40
7015	39	0	0	1	0	40
7016	0	1	37	1	0	39
7017	0	0	37	1	0	38
7018	2	0	0	36	0	38
7019	0	0	43	0	0	43
7020	1	0	1	42	0	44
7021	0	0	0	43	0	43
7022	0	0	1	45	0	46
7023	1	0	0	45	0	46
7024	45	0	0	1	0	46
7025	44	0	0	1	0	45
7026	0	0	0	46	0	46
7027	1	0	54	0	0	55
7028	1	0	0	56	0	57
7029	0	53	0	1	0	54
7030	1	0	1	52	0	54
7031	53	0	0	2	0	55
7032	52	1	0	1	0	54
7033	0	0	0	54	0	54
7034	1	0	0	54	0	55
7035	1	0	0	53	0	54
7036	54	0	0	1	0	55
7037	0	0	54	1	0	55
7038	0	0	50	1	0	51
7039	1	54	0	0	0	55
7040	53	0	0	1	0	54
7041	1	0	0	59	0	60
7042	0	0	60	0	0	60
7043	0	60	0	0	0	60
7044	0	62	0	0	0	62
7045	0	0	0	62	0	62
7046	0	0	0	69	0	69
7047	0	68	0	0	0	68
7048	0	0	0	68	0	68
7049	0	0	0	68	0	68
7050	69	0	0	1	0	70
7051	0	72	0	0	0	72
7052	0	0	0	70	0	70
7053	0	0	71	0	0	71
7054	0	0	0	67	0	67
7055	67	0	0	0	0	67
7056	0	76	0	0	0	76
7057	0	0	0	77	0	77
7058	0	0	77	0	0	77
7059	0	0	91	0	0	91
7060	1	0	1	91	0	93
7061	0	0	0	91	0	91
7062	95	0	0	0	0	95
7063	1	100	0	0	0	101
7064	101	1	0	1	0	103
7065	1	0	105	0	0	106
7066	98	0	1	0	0	99
7067	1	0	107	0	0	108
7068	103	0	1	0	0	104
7069	110	0	0	0	0	110
7070	1	0	119	0	0	120
7071	0	0	114	0	0	114
7072	0	118	1	0	0	119
7073	0	1	0	120	0	121
7074	122	0	0	2	0	124
7075	2	0	0	121	0	123
7076	0	0	0	120	0	120
7077	0	0	0	124	0	124
7078	0	0	122	1	0	123
7079	112	0	1	0	0	113
7080	118	0	0	0	0	118
7081	1	123	0	0	0	124
7082	1	1	0	125	0	127
7083	0	132	0	0	0	132
7084	0	3	0	136	0	139
7085	141	0	0	3	0	144
7086	2	141	0	0	0	143
7087	0	2	0	137	0	139
7088	134	0	0	2	0	136
7089	136	1	0	1	0	138
7090	2	0	0	134	0	136
7091	3	0	133	2	0	138
7092	1	0	2	128	0	131
7093	0	129	0	3	0	132
7094	127	2	1	2	0	132
7095	2	131	0	1	0	134
7096	0	3	0	132	0	135
7097	132	0	0	2	0	134
7098	2	1	0	134	0	137
7099	1	1	0	140	0	142
7100	1	0	146	2	0	149
7101	0	144	2	1	0	147
7102	143	2	0	1	0	146
7103	133	0	1	1	0	135
7104	2	145	0	0	0	147
7105	1	144	0	0	0	145
7106	1	2	0	146	0	149
7107	145	1	0	2	0	148
7108	2	146	0	0	0	148
7109	0	2	0	149	0	151
7110	1	0	148	2	0	151
7111	0	1	2	146	0	149
7112	145	0	0	4	0	149
7113	2	146	1	0	0	149
7114	0	2	0	155	0	157
7115	1	0	155	2	0	158
7116	0	1	148	0	0	149
7117	0	0	2	155	0	157
7118	0	0	1	158	0	159
7119	0	155	0	2	0	157
7120	0	2	0	157	0	159
7121	153	1	0	3	0	157
7122	2	1	0	156	0	159
7123	154	0	0	4	0	158
7124	3	157	0	0	0	160
7125	0	168	0	1	0	169
7126	1	2	0	171	0	174
7127	0	1	0	163	0	164
7128	0	1	167	2	0	170
7129	1	0	2	165	0	168
7130	164	0	0	3	0	167
7131	2	0	164	0	0	166
7132	0	0	2	164	0	166
7133	0	0	170	2	0	172
7134	0	0	3	172	0	175
7135	0	0	0	169	0	169
7136	0	0	1	178	0	179
7137	0	0	177	3	0	180
7138	0	0	2	174	0	176
7139	0	176	1	3	0	180
7140	0	2	1	181	0	184
7141	0	0	0	173	0	173
7142	172	1	0	4	0	177
7143	2	0	176	1	0	179
7144	1	0	2	173	0	176
7145	1	0	174	3	0	178
7146	1	0	154	1	0	156
7147	0	0	3	169	0	172
7148	0	0	1	165	0	166
7149	0	1	1	181	0	183
7150	178	0	0	3	0	181
7151	2	0	168	2	0	172
7152	180	0	2	1	0	183
7153	3	0	0	193	0	196
7154	0	0	1	202	0	203
7155	0	206	1	3	0	210
7156	0	2	1	209	0	212
7157	1	1	0	210	0	212
7158	0	1	0	212	0	213
7159	185	0	0	3	0	188
7160	2	0	180	1	0	183
7161	171	0	2	1	0	174
7162	3	186	1	0	0	190
7163	177	1	1	1	0	180
7164	2	176	0	0	0	178
7165	0	174	0	0	0	174
7166	1	1	0	175	0	177
7167	177	1	0	3	0	181
7168	1	1	0	181	0	183
7169	0	172	0	3	0	175
7170	1	172	1	0	0	174
7171	0	1	0	176	0	177
7172	0	2	0	172	0	174
7173	0	179	0	1	0	180
7174	0	2	0	179	0	181
7175	0	1	0	182	0	183
7176	0	1	0	184	0	185
7177	184	0	0	1	0	185
7178	1	1	182	2	0	186
7179	189	1	1	1	0	192
7180	205	1	0	0	0	206
7181	203	0	0	1	0	204
7182	1	195	0	1	0	197
7183	0	1	0	191	0	192
7184	191	0	0	2	0	193
7185	0	0	0	193	0	193
7186	188	0	0	1	0	189
7187	1	217	0	0	0	218
7188	238	0	1	0	0	239
7189	238	0	0	0	0	238
7190	242	0	0	0	0	242
7191	2	0	0	241	0	243
7192	0	0	0	244	0	244
7193	251	0	0	2	0	253
7194	0	254	0	1	0	255
7195	0	248	0	1	0	249
7196	272	0	0	0	0	272
7197	0	1	0	271	0	272
7198	1	0	0	268	0	269
7199	1	0	0	274	0	275
7200	1	268	0	0	0	269
7201	272	0	0	2	0	274
7202	1	0	0	271	0	272
7203	1	285	1	0	0	287
7204	0	1	0	303	0	304
7205	1	1	0	299	0	301
7206	2	0	0	301	0	303
7207	1	0	0	306	0	307
7208	304	0	0	1	0	305
7209	294	0	0	2	0	296
7210	297	1	0	5	0	303
7211	1	0	0	316	0	317
7212	0	1	309	1	0	311
7213	1	1	288	0	0	290
7214	0	0	300	1	0	301
7215	319	0	0	0	0	319
7216	1	0	0	322	0	323
7217	3	0	0	315	0	318
7218	1	1	0	319	0	321
7219	320	0	0	0	0	320
7220	313	0	0	2	0	315
7221	0	339	0	1	0	340
7222	1	0	1	341	0	343
7223	0	0	340	0	0	340
7224	0	337	1	0	0	338
7225	4	0	0	339	0	343
7226	0	0	0	345	0	345
7227	1	0	0	337	0	338
7228	1	0	0	323	0	324
7229	1	0	328	0	0	329
7230	1	1	308	0	0	310
7231	0	339	0	0	0	339
7232	0	0	0	344	0	344
7233	0	0	0	340	0	340
7234	339	0	0	0	0	339
7235	0	0	346	0	0	346
7236	0	0	0	347	0	347
7237	0	0	0	357	0	357
7238	0	1	369	0	0	370
7239	0	370	0	0	0	370
7240	369	0	0	2	0	371
7241	0	0	375	0	0	375
7242	358	0	0	2	0	360
7243	0	1	381	0	0	382
7244	0	0	0	388	0	388
7245	0	1	402	0	0	403
7246	0	0	399	1	0	400
7247	1	0	0	409	0	410
7248	2	0	2	356	0	360
7249	2	0	0	427	0	429
7250	1	1	0	416	0	418
7251	1	0	0	415	0	416
7252	1	0	430	0	0	431
7253	0	0	401	1	0	402
7254	0	424	2	0	0	426
7255	418	0	0	1	0	419
7256	0	0	0	422	0	422
7257	421	0	0	2	0	423
7258	1	1	0	415	0	417
7259	428	0	0	5	0	433
7260	1	0	0	437	0	438
7261	0	0	0	441	0	441
7262	0	448	1	1	0	450
7263	0	1	0	460	0	461
7264	1	0	0	461	0	462
7265	1	1	0	459	0	461
7266	1	0	0	458	0	459
7267	0	451	1	1	0	453
7268	446	1	0	0	0	447
7269	1	445	1	0	0	447
7270	0	1	0	446	0	447
7271	441	0	0	5	0	446
7272	1	0	436	0	0	437
7273	0	0	422	1	0	423
7274	0	0	1	427	0	428
7275	1	0	0	435	0	436
7276	0	0	0	435	0	435
7277	2	0	0	401	0	403
7278	0	0	0	428	0	428
7279	0	415	0	1	0	416
7280	0	1	0	420	0	421
7281	413	0	0	3	0	416
7282	1	0	0	417	0	418
7283	0	0	418	1	0	419
7284	0	0	1	411	0	412
7285	408	0	0	2	0	410
7286	1	416	0	0	0	417
7287	0	1	0	419	0	420
7288	0	0	0	428	0	428
7289	0	0	423	3	0	426
7290	1	1	590	0	0	592
7291	747	0	12	5	0	764
7292	17	0	1	758	0	776
7293	5	0	4	778	0	787
7294	12	0	786	18	0	816
7295	2	1	789	19	0	811
7296	2	786	21	13	0	822
7297	8	14	17	775	0	814
7298	1	7	795	21	0	824
7299	1	785	20	12	0	818
7300	789	14	13	16	0	832
7301	816	8	18	7	0	849
7302	23	17	2	788	0	830
7303	21	792	5	21	0	839
7304	799	21	7	8	0	835
7305	22	13	2	771	0	808
7306	16	14	776	18	0	824
7307	19	786	20	8	0	833
7308	775	20	9	13	0	817
7309	799	11	13	10	0	833
7310	25	14	4	775	0	818
7311	20	4	4	789	0	817
7312	16	6	758	25	0	805
7313	13	7	16	768	0	804
7314	12	2	10	732	0	756
7315	7	3	12	763	0	785
7316	8	1	3	788	0	800
7317	3	2	5	752	0	762
7318	2	739	9	38	0	788
7319	729	19	1	37	0	786
7320	21	6	745	22	0	794
7321	8	734	19	16	0	777
7322	15	18	8	753	0	794
7323	749	10	14	29	0	802
7324	22	16	7	756	0	801
7325	15	5	4	770	0	794
7326	17	3	8	764	0	792
7327	6	7	3	785	0	801
7328	5	2	735	49	0	791
7329	6	741	22	30	0	799
7330	745	19	10	30	0	804
7331	21	10	741	18	0	790
7332	9	15	22	744	0	790
7333	736	8	13	29	0	786
7334	22	731	22	15	0	790
7335	737	27	8	18	0	790
7336	38	12	6	699	0	755
7337	16	13	10	747	0	786
7338	19	8	5	747	0	779
7339	18	7	4	751	0	780
7340	707	11	9	46	0	773
7341	29	8	2	722	0	761
7342	15	4	5	739	0	763
7343	695	7	7	39	0	748
7344	29	9	669	36	0	743
7345	21	5	20	702	0	748
7346	685	7	9	33	0	734
7347	679	3	15	23	0	720
7348	31	5	8	683	0	727
7349	35	5	8	663	0	711
7350	18	634	9	46	0	707
7351	18	17	4	667	0	706
7352	15	7	3	669	0	694
7353	10	16	612	48	0	686
7354	9	2	625	47	0	683
7355	4	612	28	34	0	678
7356	8	24	21	608	0	661
7357	8	11	18	646	0	683
7358	624	16	7	37	0	684
7359	23	6	12	628	0	669
7360	13	10	602	43	0	668
7361	32	7	19	609	0	667
7362	8	7	586	52	0	653
7363	10	5	599	28	0	642
7364	14	5	30	575	0	624
7365	11	3	27	610	0	651
7366	580	10	20	37	0	647
7367	594	4	9	40	0	647
7368	33	2	16	599	0	650
7369	603	7	10	34	0	654
7370	611	1	5	26	0	643
7371	36	6	4	600	0	646
7372	42	4	6	599	0	651
7373	596	5	5	42	0	648
7374	582	5	7	34	0	628
7375	39	1	3	578	0	621
7376	28	549	6	37	0	620
7377	23	18	3	582	0	626
7378	17	10	0	606	0	633
7379	17	15	548	45	0	625
7380	19	1	20	593	0	633
7381	546	4	11	52	0	613
7382	25	548	22	25	0	620
7383	558	20	4	32	0	614
7384	577	6	4	27	0	614
7385	583	13	5	21	0	622
7386	46	5	3	553	0	607
7387	31	8	496	39	0	574
7388	28	10	496	15	0	549
7389	19	486	25	23	0	553
7390	8	287	13	9	0	317
7391	3	140	5	6	0	154
7392	2	136	4	2	0	144
7393	14	3	114	4	0	135
7394	88	4	8	2	0	102
7395	6	0	0	84	0	90
7396	1	0	0	91	0	92
7397	2	0	0	91	0	93
7398	2	86	0	2	0	90
7399	81	3	0	2	0	86
7400	4	0	78	2	0	84
7401	1	76	2	1	0	80
7402	0	2	0	77	0	79
7403	82	0	0	3	0	85
7404	2	0	1	80	0	83
7405	0	0	79	3	0	82
7406	1	0	77	0	0	78
7407	0	1	1	77	0	79
7408	1	0	0	81	0	82
7409	82	0	0	3	0	85
7410	3	0	81	0	0	84
7411	76	0	2	1	0	79
7412	78	0	1	0	0	79
7413	2	0	2	79	0	83
7414	0	1	78	2	0	81
7415	0	1	2	79	0	82
7416	80	0	0	4	0	84
7417	2	78	0	0	0	80
7418	77	2	1	0	0	80
7419	3	0	0	78	0	81
7420	0	94	0	2	0	96
7421	0	2	0	92	0	94
7422	2	0	0	92	0	94
7423	0	92	0	3	0	95
7424	1	3	0	95	0	99
7425	0	0	1	99	0	100
7426	0	1	0	103	0	104
7427	0	0	103	2	0	105
7428	1	107	2	1	0	111
7429	114	2	0	2	0	118
7430	2	2	0	109	0	113
7431	1	116	0	0	0	117
7432	117	2	0	1	0	120
7433	3	0	0	120	0	123
7434	1	0	0	120	0	121
7435	0	0	2	120	0	122
7436	2	0	1	117	0	120
7437	117	1	0	4	0	122
7438	2	1	0	117	0	120
7439	0	1	1	118	0	120
7440	117	0	0	4	0	121
7441	3	0	1	118	0	122
7442	1	1	115	2	0	119
7443	1	0	2	119	0	122
7444	113	0	0	4	0	117
7445	2	1	0	116	0	119
7446	0	1	116	2	0	119
7447	0	0	115	1	0	116
7448	115	1	2	1	0	119
7449	118	1	0	1	0	120
7450	116	0	0	4	0	120
7451	119	0	0	2	0	121
7452	2	0	118	1	0	121
7453	0	1	3	119	0	123
7454	1	0	1	121	0	123
7455	119	0	0	5	0	124
7456	2	1	0	122	0	125
7457	2	0	119	2	0	123
7458	0	0	2	125	0	127
7459	2	0	123	3	0	128
7460	1	128	2	1	0	132
7461	128	1	0	2	0	131
7462	3	0	1	128	0	132
7463	0	0	128	4	0	132
7464	2	0	2	128	0	132
7465	1	1	0	131	0	133
7466	1	0	127	4	0	132
7467	1	0	4	124	0	129
7468	123	1	0	5	0	129
7469	4	0	119	1	0	124
7470	115	0	3	3	0	121
7471	2	124	0	1	0	127
7472	0	2	123	1	0	126
7473	0	5	121	1	0	127
7474	2	0	2	98	0	102
7475	1	0	1	115	0	117
7476	0	0	113	1	0	114
7477	1	0	1	113	0	115
7478	120	0	0	2	0	122
7479	121	0	0	0	0	121
7480	2	0	0	118	0	120
7481	0	0	0	119	0	119
7482	0	124	0	1	0	125
7483	137	1	0	1	0	139
7484	1	0	0	136	0	137
7485	0	141	0	1	0	142
7486	140	1	0	0	0	141
7487	136	0	0	1	0	137
7488	1	143	0	0	0	144
7489	0	0	0	145	0	145
7490	0	0	0	144	0	144
7491	0	1	127	1	0	129
7492	0	0	1	128	0	129
7493	127	0	0	1	0	128
7494	1	0	0	128	0	129
7495	0	0	126	1	0	127
7496	123	0	1	0	0	124
7497	1	0	0	126	0	127
7498	0	0	126	1	0	127
7499	0	0	1	125	0	126
7500	0	0	131	1	0	132
7501	1	0	1	127	0	129
7502	1	0	0	132	0	133
7503	124	0	0	2	0	126
7504	1	128	0	0	0	129
7505	133	1	0	0	0	134
7506	127	0	0	1	0	128
7507	130	0	0	0	0	130
7508	1	129	0	0	0	130
7509	0	1	134	0	0	135
7510	0	0	1	135	0	136
7511	134	0	0	1	0	135
7512	133	0	0	1	0	134
7513	1	0	0	127	0	128
7514	129	0	0	2	0	131
7515	1	0	130	0	0	131
7516	123	0	1	1	0	125
7517	1	0	129	0	0	130
7518	0	126	1	0	0	127
7519	128	1	0	0	0	129
7520	112	0	0	1	0	113
7521	1	117	0	0	0	118
7522	117	1	0	1	0	119
7523	116	0	0	0	0	116
7524	1	1	113	0	0	115
7525	107	0	2	1	0	110
7526	1	1	109	0	0	111
7527	1	0	1	94	0	96
7528	0	100	1	2	0	103
7529	0	1	97	0	0	98
7530	92	0	2	1	0	95
7531	95	0	0	1	0	96
7532	1	0	1	91	0	93
7533	0	0	91	2	0	93
7534	2	0	1	90	0	93
7535	91	0	1	1	0	93
7536	2	97	0	0	0	99
7537	94	2	0	1	0	97
7538	94	0	1	1	0	96
7539	1	92	1	3	0	97
7540	0	1	0	97	0	98
7541	94	0	0	2	0	96
7542	1	0	1	99	0	101
7543	1	0	0	105	0	106
7544	0	0	105	1	0	106
7545	1	0	1	102	0	104
7546	0	0	0	106	0	106
7547	100	0	0	2	0	102
7548	105	2	0	0	0	107
7549	3	0	0	105	0	108
7550	2	0	104	2	0	108
7551	0	2	102	0	0	104
7552	2	1	1	101	0	105
7553	3	1	115	1	0	120
7554	1	1	1	116	0	119
7555	0	1	0	119	0	120
7556	117	0	1	2	0	120
7557	1	0	115	2	0	118
7558	112	0	2	2	0	116
7559	115	0	0	2	0	117
7560	3	0	109	0	0	112
7561	0	1	119	1	0	121
7562	0	0	3	119	0	122
7563	1	119	1	1	0	122
7564	0	116	0	2	0	118
7565	0	0	2	113	0	115
7566	0	0	0	121	0	121
7567	0	0	1	123	0	124
7568	1	0	0	121	0	122
7569	121	0	1	1	0	123
7570	3	0	0	119	0	122
7571	1	1	120	0	0	122
7572	3	0	0	117	0	120
7573	1	121	1	1	0	124
7574	2	0	0	120	0	122
7575	121	0	0	0	0	121
7576	1	1	1	121	0	124
7577	0	0	116	2	0	118
7578	1	116	1	0	0	118
7579	1	0	0	120	0	121
7580	119	0	0	1	0	120
7581	125	0	0	0	0	125
7582	1	0	1	117	0	119
7583	0	0	105	1	0	106
7584	0	0	106	1	0	107
7585	108	1	0	0	0	109
7586	0	0	110	1	0	111
7587	1	0	101	0	0	102
7588	0	1	0	103	0	104
7589	101	0	2	0	0	103
7590	95	1	0	0	0	96
7591	92	0	0	3	0	95
7592	1	0	96	0	0	97
7593	1	1	93	0	0	95
7594	0	102	0	1	0	103
7595	0	0	1	98	0	99
7596	0	0	0	98	0	98
7597	1	0	0	97	0	98
7598	0	0	1	99	0	100
7599	0	0	100	0	0	100
7600	0	91	0	1	0	92
7601	101	0	0	1	0	102
7602	119	0	0	0	0	119
7603	117	0	0	1	0	118
7604	0	118	1	0	0	119
7605	1	1	1	116	0	119
7606	120	1	0	1	0	122
7607	1	125	1	1	0	128
7608	123	1	0	1	0	125
7609	1	119	0	1	0	121
7610	119	1	0	1	0	121
7611	118	0	0	0	0	118
7612	1	1	0	120	0	122
7613	1	0	0	123	0	124
7614	1	0	122	1	0	124
7615	1	0	118	0	0	119
7616	119	0	1	1	0	121
7617	122	0	0	2	0	124
7618	2	0	0	119	0	121
7619	1	1	0	121	0	123
7620	1	1	131	1	0	134
7621	1	1	1	127	0	130
7622	1	0	131	1	0	133
7623	1	1	1	135	0	138
7624	0	0	0	138	0	138
7625	136	0	0	2	0	138
7626	132	1	0	0	0	133
7627	3	0	1	132	0	136
7628	1	1	0	134	0	136
7629	2	0	129	6	0	137
7630	2	0	1	133	0	136
7631	0	0	132	3	0	135
7632	131	0	1	1	0	133
7633	1	0	1	134	0	136
7634	132	0	1	1	0	134
7635	2	130	0	0	0	132
7636	126	1	0	1	0	128
7637	1	0	0	124	0	125
7638	0	0	0	123	0	123
7639	0	124	1	1	0	126
7640	1	1	0	128	0	130
7641	1	0	127	1	0	129
7642	0	1	1	123	0	125
7643	0	1	117	3	0	121
7644	2	118	2	0	0	122
7645	1	2	0	125	0	128
7646	1	0	121	2	0	124
7647	0	1	123	1	0	125
7648	0	0	2	121	0	123
7649	123	0	0	2	0	125
7650	1	1	122	1	0	125
7651	1	0	1	122	0	124
7652	122	0	1	2	0	125
7653	2	112	1	0	0	115
7654	122	2	0	0	0	124
7655	3	0	0	120	0	123
7656	0	0	0	123	0	123
7657	1	0	0	125	0	126
7658	124	1	1	1	0	127
7659	1	0	0	125	0	126
7660	0	0	1	123	0	124
7661	113	0	0	4	0	117
7662	1	1	110	1	0	113
7663	1	1	1	114	0	117
7664	0	0	113	2	0	115
7665	113	0	2	1	0	116
7666	1	0	1	108	0	110
7667	0	0	110	2	0	112
7668	108	0	1	2	0	111
7669	111	0	2	0	0	113
7670	2	0	122	1	0	125
7671	1	1	1	119	0	122
7672	1	1	0	124	0	126
7673	2	2	124	1	0	129
7674	1	121	1	1	0	124
7675	1	0	123	2	0	126
7676	115	1	1	3	0	120
7677	3	1	124	0	0	128
7678	121	0	1	2	0	124
7679	2	0	126	1	0	129
7680	122	0	1	3	0	126
7681	1	121	3	0	0	125
7682	0	2	1	124	0	127
7683	1	0	0	122	0	123
7684	2	0	120	1	0	123
7685	0	0	2	108	0	110
7686	0	109	1	3	0	113
7687	115	1	1	0	0	117
7688	2	118	1	1	0	122
7689	0	2	2	121	0	125
7690	122	1	0	3	0	126
7691	1	124	0	2	0	127
7692	122	0	0	0	0	122
7693	2	1	122	1	0	126
7694	0	0	1	123	0	124
7695	2	0	0	125	0	127
7696	1	0	2	127	0	130
7697	125	0	0	3	0	128
7698	130	0	2	1	0	133
7699	136	0	0	0	0	136
7700	126	1	0	2	0	129
7701	2	0	115	1	0	118
7702	95	1	0	1	0	97
7703	0	97	1	0	0	98
7704	0	93	0	0	0	93
7705	98	0	0	0	0	98
7706	99	0	0	1	0	100
7707	0	0	0	94	0	94
7708	95	0	0	0	0	95
7709	96	0	0	0	0	96
7710	97	0	0	0	0	97
7711	1	0	0	99	0	100
7712	0	105	0	1	0	106
7713	0	108	0	0	0	108
7714	0	2	0	108	0	110
7715	108	0	0	2	0	110
7716	2	107	0	0	0	109
7717	0	2	0	107	0	109
7718	0	0	108	2	0	110
7719	99	1	2	0	0	102
7720	2	95	0	0	0	97
7721	0	108	0	0	0	108
7722	103	2	0	1	0	106
7723	2	0	103	0	0	105
7724	0	0	2	101	0	103
7725	0	105	0	2	0	107
7726	0	2	0	106	0	108
7727	0	1	0	103	0	104
7728	0	96	0	2	0	98
7729	1	2	0	106	0	109
7730	0	0	0	111	0	111
7731	107	0	0	3	0	110
7732	2	107	0	0	0	109
7733	113	2	0	1	0	116
7734	2	0	0	116	0	118
7735	0	120	0	2	0	122
7736	0	2	124	0	0	126
7737	0	0	2	119	0	121
7738	0	0	0	120	0	120
7739	0	0	121	2	0	123
7740	119	0	2	0	0	121
7741	2	0	0	125	0	127
7742	129	1	0	2	0	132
7743	3	0	125	1	0	129
7744	1	0	3	125	0	129
7745	0	1	143	4	0	148
7746	1	0	4	143	0	148
7747	1	1	4	143	0	149
7748	140	0	0	8	0	148
7749	3	144	0	2	0	149
7750	152	4	0	2	0	158
7751	6	5	146	0	0	157
7752	5	1	4	147	0	157
7753	2	0	170	4	0	176
7754	149	0	4	4	0	157
7755	155	0	4	2	0	161
7756	8	0	157	1	0	166
7757	153	1	4	3	0	161
7758	157	1	3	2	0	163
7759	8	0	0	160	0	168
7760	4	0	160	4	0	168
7761	1	1	167	4	0	173
7762	1	0	7	165	0	173
7763	3	0	3	167	0	173
7764	1	164	0	6	0	171
7765	0	171	0	2	0	173
7766	168	8	0	1	0	177
7767	6	4	0	171	0	181
7768	3	170	1	6	0	180
7769	2	176	0	4	0	182
7770	163	8	1	2	0	174
7771	5	3	0	164	0	172
7772	3	156	1	8	0	168
7773	3	5	0	162	0	170
7774	0	5	0	165	0	170
7775	1	1	0	170	0	172
7776	163	0	0	8	0	171
7777	4	163	2	4	0	173
7778	4	4	1	164	0	173
7779	0	4	1	168	0	173
7780	2	0	0	176	0	178
7781	0	1	164	8	0	173
7782	158	2	4	5	0	169
7783	6	0	3	167	0	176
7784	167	0	1	7	0	175
7785	169	0	1	5	0	175
7786	173	1	1	1	0	176
7787	8	0	167	2	0	177
7788	3	159	4	1	0	167
7789	0	4	3	159	0	166
7790	0	4	161	3	0	168
7791	1	1	157	3	0	162
7792	1	0	6	154	0	161
7793	0	152	3	2	0	157
7794	149	5	1	5	0	160
7795	168	3	0	3	0	174
7796	175	0	0	3	0	178
7797	176	1	0	0	0	177
7798	6	0	163	1	0	170
7799	157	0	4	1	0	162
7800	4	163	4	1	0	172
7801	4	4	0	169	0	177
7802	2	4	0	167	0	173
7803	163	0	0	11	0	174
7804	4	1	0	169	0	174
7805	4	0	164	5	0	173
7806	159	0	5	4	0	168
7807	170	0	3	1	0	174
7808	169	0	1	3	0	173
7809	9	0	165	0	0	174
7810	160	0	3	1	0	164
7811	5	162	4	0	0	171
7812	162	2	1	0	0	165
7813	3	3	0	154	0	160
7814	3	0	0	157	0	160
7815	0	155	2	4	0	161
7816	0	2	2	157	0	161
7817	0	156	0	3	0	159
7818	0	3	0	157	0	160
7819	1	158	0	2	0	161
7820	1	3	0	152	0	156
7821	2	150	0	2	0	154
7822	1	2	0	150	0	153
7823	0	156	1	1	0	158
7824	158	3	0	4	0	165
7825	5	4	0	159	0	168
7826	3	0	0	159	0	162
7827	0	1	0	176	0	177
7828	1	0	0	179	0	180
7829	0	0	180	10	0	190
7830	0	0	5	188	0	193
7831	1	0	3	183	0	187
7832	183	1	0	8	0	192
7833	180	0	1	3	0	184
7834	6	180	1	1	0	188
7835	5	5	0	174	0	184
7836	1	6	1	182	0	190
7837	191	1	1	9	0	202
7838	6	0	188	5	0	199
7839	185	0	4	1	0	190
7840	7	193	3	0	0	203
7841	194	6	0	1	0	201
7842	187	3	1	0	0	191
7843	8	187	0	0	0	195
7844	3	191	0	1	0	195
7845	0	4	0	168	0	172
7846	0	0	167	4	0	171
7847	159	0	3	1	0	163
7848	4	0	166	0	0	170
7849	155	0	4	0	0	159
7850	4	0	158	0	0	162
7851	0	159	4	0	0	163
7852	0	4	0	158	0	162
7853	143	0	0	4	0	147
7854	143	0	0	0	0	143
7855	4	0	0	145	0	149
7856	155	0	0	4	0	159
7857	155	0	0	1	0	156
7858	6	153	0	1	0	160
7859	153	5	0	2	0	160
7860	4	153	0	1	0	158
7861	0	6	0	148	0	154
7862	148	0	1	6	0	155
7863	153	0	0	1	0	154
7864	155	0	0	1	0	156
7865	7	0	147	1	0	155
7866	1	0	150	0	0	151
7867	0	1	5	139	0	145
7868	2	0	0	155	0	157
7869	0	162	0	7	0	169
7870	162	7	0	1	0	170
7871	10	1	2	157	0	170
7872	3	1	0	168	0	172
7873	2	2	156	9	0	169
7874	1	152	6	3	0	162
7875	2	157	3	1	0	163
7876	1	10	1	158	0	170
7877	154	4	0	7	0	165
7878	8	1	0	156	0	165
7879	4	0	1	161	0	166
7880	156	0	1	10	0	167
7881	161	0	2	4	0	167
7882	10	0	2	152	0	164
7883	4	0	151	9	0	164
7884	4	0	7	154	0	165
7885	2	3	1	157	0	163
7886	155	1	1	9	0	166
7887	10	1	0	153	0	164
7888	149	1	1	10	0	161
7889	10	1	151	3	0	165
7890	3	1	8	167	0	179
7891	3	2	4	169	0	178
7892	3	0	2	176	0	181
7893	3	2	1	172	0	178
7894	3	0	0	174	0	177
7895	3	0	150	12	0	165
7896	149	1	7	3	0	160
7897	11	1	2	150	0	164
7898	5	0	146	10	0	161
7899	4	0	150	2	0	156
7900	1	1	10	151	0	163
7901	153	0	4	9	0	166
7902	157	2	2	3	0	164
7903	171	1	2	4	0	178
7904	15	1	0	159	0	175
7905	5	169	1	9	0	184
7906	172	9	1	5	0	187
7907	172	3	1	2	0	178
7908	174	2	1	3	0	180
7909	177	1	0	3	0	181
7910	16	0	2	163	0	181
7911	3	3	164	9	0	179
7912	4	1	8	165	0	178
7913	3	1	164	11	0	179
7914	164	1	10	4	0	179
7915	175	0	4	2	0	181
7916	11	1	166	3	0	181
7917	168	1	8	3	0	180
7918	181	0	4	5	0	190
7919	13	1	2	177	0	193
7920	3	181	1	11	0	196
7921	180	8	0	6	0	194
7922	12	3	1	177	0	193
7923	6	174	0	11	0	191
7924	3	7	1	167	0	178
7925	3	3	172	8	0	186
7926	1	174	7	3	0	185
7927	161	6	3	5	0	175
7928	163	5	2	2	0	172
7929	154	1	2	6	0	163
7930	161	0	0	3	0	164
7931	11	0	0	150	0	161
7932	4	147	3	7	0	161
7933	144	6	0	5	0	155
7934	7	1	144	3	0	155
7935	4	139	5	4	0	152
7936	2	4	138	2	0	146
7937	3	2	4	122	0	131
7938	1	114	2	8	0	125
7939	2	5	1	126	0	134
7940	2	3	129	5	0	139
7941	1	1	7	130	0	139
7942	1	2	2	137	0	142
7943	2	0	3	137	0	142
7944	128	0	1	9	0	138
7945	6	131	0	6	0	143
7946	5	4	1	133	0	143
7947	131	1	1	6	0	139
7948	5	132	1	5	0	143
7949	130	4	1	7	0	142
7950	5	3	132	2	0	142
7951	6	1	4	131	0	142
7952	4	131	4	5	0	144
7953	128	4	2	3	0	137
7954	8	3	127	1	0	139
7955	3	119	5	3	0	130
7956	4	2	3	119	0	128
7957	1	3	2	119	0	125
7958	118	1	2	4	0	125
7959	5	1	1	118	0	125
7960	4	2	114	4	0	124
7961	3	0	3	117	0	123
7962	3	1	110	4	0	118
7963	2	0	3	112	0	117
7964	1	112	2	6	0	121
7965	113	4	1	3	0	121
7966	114	2	1	2	0	119
7967	5	107	1	2	0	115
7968	4	99	1	1	0	105
7969	3	1	1	90	0	95
7970	91	0	1	4	0	96
7971	1	2	2	90	0	95
7972	89	0	0	2	0	91
7973	4	91	1	0	0	96
7974	3	2	0	93	0	98
7975	2	2	93	1	0	98
7976	3	0	2	91	0	96
7977	2	1	0	95	0	98
7978	95	1	0	3	0	99
7979	2	102	1	2	0	107
7980	0	3	1	104	0	108
7981	103	1	1	2	0	107
7982	2	0	99	2	0	103
7983	95	2	1	2	0	100
7984	2	1	0	105	0	108
7985	2	103	2	1	0	108
7986	106	3	0	1	0	110
7987	2	1	106	1	0	110
7988	3	0	101	1	0	105
7989	2	104	3	0	0	109
7990	89	0	0	2	0	91
7991	0	0	0	91	0	91
7992	0	2	0	86	0	88
7993	93	0	0	0	0	93
7994	1	0	92	0	0	93
7995	1	0	0	92	0	93
7996	1	1	111	0	0	113
7997	3	0	0	109	0	112
7998	0	112	0	1	0	113
7999	1	0	0	116	0	117
8000	1	0	113	0	0	114
8001	104	1	1	1	0	107
8002	0	0	1	110	0	111
8003	1	0	102	0	0	103
8004	0	1	0	98	0	99
8005	0	1	0	100	0	101
8006	0	0	98	1	0	99
8007	0	0	93	1	0	94
8008	1	0	0	93	0	94
8009	0	0	98	2	0	100
8010	99	0	0	2	0	101
8011	0	0	0	106	0	106
8012	106	0	0	1	0	107
8013	1	0	114	0	0	115
8014	1	1	0	108	0	110
8015	0	0	123	1	0	124
8016	1	120	2	0	0	123
8017	1	0	120	1	0	122
8018	0	0	109	1	0	110
8019	114	0	0	0	0	114
8020	113	0	2	1	0	116
8021	0	0	121	1	0	122
8022	0	0	0	124	0	124
8023	1	0	0	129	0	130
8024	1	0	133	0	0	134
8025	0	130	0	1	0	131
8026	129	0	0	0	0	129
8027	0	0	128	0	0	128
8028	0	0	0	136	0	136
8029	1	0	0	135	0	136
8030	140	0	0	0	0	140
8031	144	0	0	0	0	144
8032	144	0	0	0	0	144
8033	145	0	0	1	0	146
8034	1	0	0	147	0	148
8035	0	0	148	0	0	148
8036	1	0	0	151	0	152
8037	0	0	1	150	0	151
8038	1	1	0	155	0	157
8039	0	0	155	0	0	155
8040	158	0	1	0	0	159
8041	1	0	0	165	0	166
8042	2	0	182	0	0	184
8043	0	188	1	1	0	190
8044	1	1	1	190	0	193
8045	2	1	0	188	0	191
8046	183	0	1	2	0	186
8047	1	189	0	1	0	191
8048	2	1	188	0	0	191
8049	0	1	2	187	0	190
8050	2	0	1	184	0	187
8051	189	0	0	3	0	192
8052	189	0	0	2	0	191
8053	3	0	0	194	0	197
8054	196	0	0	3	0	199
8055	2	188	0	1	0	191
8056	1	1	216	1	0	219
8057	0	0	2	212	0	214
8058	0	0	0	224	0	224
8059	1	0	0	222	0	223
8060	0	0	0	217	0	217
8061	1	217	0	2	0	220
8062	225	1	0	1	0	227
8063	2	3	0	223	0	228
8064	3	225	0	1	0	229
8065	233	2	0	3	0	238
8066	225	3	0	1	0	229
8067	4	246	0	1	0	251
8068	5	1	0	245	0	251
8069	1	4	0	249	0	254
8070	1	0	1	243	0	245
8071	0	0	1	250	0	251
8072	246	0	0	7	0	253
8073	244	0	1	3	0	248
8074	5	248	0	0	0	253
8075	3	1	248	1	0	253
8076	1	3	2	246	0	252
8077	247	1	4	4	0	256
8078	3	247	1	4	0	255
8079	4	244	1	1	0	250
8080	245	6	0	3	0	254
8081	248	4	0	4	0	256
8082	6	0	1	258	0	265
8083	4	2	261	2	0	269
8084	4	0	262	4	0	270
8085	276	0	7	0	0	283
8086	283	1	4	2	0	290
8087	297	0	0	1	0	298
8088	291	0	0	1	0	292
8089	288	1	0	1	0	290
8090	7	286	1	1	0	295
8091	6	2	1	284	0	293
8092	1	318	0	4	0	323
8093	310	2	1	3	0	316
8094	302	4	0	4	0	310
8095	308	0	0	3	0	311
8096	301	1	0	1	0	303
8097	5	296	2	0	0	303
8098	298	2	1	1	0	302
8099	3	294	0	2	0	299
8100	6	2	1	297	0	306
8101	298	7	0	3	0	308
8102	5	0	319	4	0	328
8103	7	0	2	315	0	324
8104	3	1	4	319	0	327
8105	2	2	316	6	0	326
8106	0	320	4	4	0	328
8107	322	2	4	2	0	330
8108	313	3	0	2	0	318
8109	9	318	1	0	0	328
8110	4	2	0	311	0	317
8111	1	4	327	3	0	335
8112	1	337	3	2	0	343
8113	330	4	5	1	0	340
8114	3	4	332	1	0	340
8115	308	0	3	0	0	311
8116	324	1	4	0	0	329
8117	8	0	329	1	0	338
8118	5	333	3	0	0	341
8119	1	3	4	325	0	333
8120	1	4	335	2	0	342
8121	318	0	3	4	0	325
8122	319	1	5	0	0	325
8123	6	316	0	1	0	323
8124	5	2	1	316	0	324
8125	1	5	1	319	0	326
8126	0	0	316	8	0	324
8127	1	323	2	5	0	331
8128	327	2	5	1	0	335
8129	326	5	0	1	0	332
8130	340	1	0	1	0	342
8131	6	0	340	1	0	347
8132	329	1	2	5	0	337
8133	342	0	5	4	0	351
8134	7	1	1	341	0	350
8135	5	1	338	2	0	346
8136	2	0	2	328	0	332
8137	1	0	344	2	0	347
8138	1	7	2	320	0	330
8139	3	324	4	3	0	334
8140	1	345	1	3	0	350
8141	0	4	0	351	0	355
8142	0	2	1	333	0	336
8143	332	0	1	7	0	340
8144	2	0	320	3	0	325
8145	319	0	0	3	0	322
8146	2	326	3	0	0	331
8147	326	2	0	5	0	333
8148	325	3	0	4	0	332
8149	4	0	1	325	0	330
8150	3	1	353	1	0	358
8151	0	0	2	343	0	345
8152	2	352	3	1	0	358
8153	1	2	0	362	0	365
8154	4	3	1	360	0	368
8155	354	0	0	5	0	359
8156	2	1	0	334	0	337
8157	4	331	1	3	0	339
8158	1	1	1	336	0	339
8159	335	4	0	3	0	342
8160	1	329	1	6	0	337
8161	1	2	0	342	0	345
8162	1	2	0	339	0	342
8163	2	1	0	343	0	346
8164	0	1	0	341	0	342
8165	344	0	0	7	0	351
8166	2	0	0	351	0	353
8167	1	1	1	338	0	341
8168	1	0	0	354	0	355
8169	1	357	1	3	0	362
8170	357	2	0	1	0	360
8171	3	0	352	3	0	358
8172	1	354	2	1	0	358
8173	351	3	1	3	0	358
8174	3	1	345	1	0	350
8175	1	362	2	1	0	366
8176	2	4	6	351	0	363
8177	3	367	2	1	0	373
8178	1	3	357	1	0	362
8179	0	4	346	2	0	352
8180	1	352	2	0	0	355
8181	341	2	11	3	0	357
8182	336	2	3	0	0	341
8183	2	2	323	0	0	327
8184	2	2	305	0	0	309
8185	3	0	326	0	0	329
8186	3	0	5	314	0	322
8187	0	1	4	310	0	315
8188	0	0	2	331	0	333
8189	1	0	340	5	0	346
8190	4	1	3	324	0	332
8191	1	0	2	334	0	337
8192	0	0	329	4	0	333
8193	318	0	3	8	0	329
8194	3	0	2	347	0	352
8195	5	0	2	339	0	346
8196	3	347	3	5	0	358
8197	348	3	0	10	0	361
8198	3	4	337	5	0	349
8199	332	2	4	3	0	341
8200	6	2	4	332	0	344
8201	5	0	344	4	0	353
8202	3	0	6	321	0	330
8203	321	2	5	5	0	333
8204	4	0	321	5	0	330
8205	314	0	6	3	0	323
8206	308	1	4	4	0	317
8207	309	0	2	8	0	319
8208	9	306	3	0	0	318
8209	5	4	1	327	0	337
8210	341	4	1	4	0	350
8211	318	2	2	5	0	327
8212	331	1	0	4	0	336
8213	12	1	317	2	0	332
8214	332	0	4	3	0	339
8215	8	2	5	339	0	354
8216	5	0	335	7	0	347
8217	4	0	7	356	0	367
8218	4	0	3	369	0	376
8219	1	0	371	14	0	386
8220	4	0	11	370	0	385
8221	2	0	6	407	0	415
8222	1	0	460	14	0	475
8223	486	0	16	11	0	513
8224	536	0	6	7	0	549
8225	18	0	7	564	0	589
8226	16	1	562	14	0	593
8227	11	2	11	546	0	570
8228	5	554	6	17	0	582
8229	12	12	8	549	0	581
8230	8	6	3	566	0	583
8231	549	6	1	32	0	588
8232	542	3	6	19	0	570
8233	563	1	3	13	0	580
8234	26	5	0	557	0	588
8235	16	3	5	568	0	592
8236	10	0	544	29	0	583
8237	16	1	12	522	0	551
8238	10	533	8	22	0	573
8239	542	15	7	11	0	575
8240	14	526	4	19	0	563
8241	524	20	4	13	0	561
8242	25	9	5	505	0	544
8243	12	521	4	23	0	560
8244	523	21	5	16	0	565
8245	538	12	5	10	0	565
8246	28	10	1	515	0	554
8247	17	521	2	20	0	560
8248	15	13	4	531	0	563
8249	7	12	518	30	0	567
8250	504	10	14	19	0	547
8251	21	503	8	14	0	546
8252	505	14	7	15	0	541
8253	27	14	6	493	0	540
8254	503	8	2	25	0	538
8255	22	5	517	16	0	560
8256	531	4	21	10	0	566
8257	543	10	7	10	0	570
8258	33	6	518	5	0	562
8259	27	3	17	519	0	566
8260	21	7	11	531	0	570
8261	525	1	12	29	0	567
8262	27	509	8	17	0	561
8263	26	18	1	516	0	561
8264	15	11	507	24	0	557
8265	10	8	492	24	0	534
8266	8	497	24	17	0	546
8267	21	16	501	12	0	550
8268	468	16	31	12	0	527
8269	28	10	12	464	0	514
8270	473	5	14	28	0	520
8271	28	4	471	9	0	512
8272	15	8	22	461	0	506
8273	19	7	13	477	0	516
8274	18	4	470	25	0	517
8275	18	4	17	467	0	506
8276	451	6	10	29	0	496
8277	466	6	15	16	0	503
8278	36	4	7	455	0	502
8279	458	5	6	30	0	499
8280	461	3	10	18	0	492
8281	26	441	8	16	0	491
8282	27	15	4	457	0	503
8283	464	10	7	18	0	499
8284	23	6	9	462	0	500
8285	454	8	4	28	0	494
8286	35	1	7	447	0	490
8287	16	8	436	24	0	484
8288	12	442	17	23	0	494
8289	16	15	15	398	0	444
8290	19	433	8	23	0	483
8291	434	17	8	19	0	478
8292	28	415	6	16	0	465
8293	9	411	13	15	0	448
8294	19	22	5	403	0	449
8295	404	13	6	26	0	449
8296	23	15	7	402	0	447
8297	402	7	4	28	0	441
8298	412	9	6	14	0	441
8299	24	397	5	14	0	440
8300	409	18	5	14	0	446
8301	412	7	4	16	0	439
8302	409	12	5	14	0	440
8303	31	7	389	14	0	441
8304	26	3	17	390	0	436
8305	18	9	10	402	0	439
8306	18	8	378	23	0	427
8307	395	8	16	18	0	437
8308	408	5	9	15	0	437
8309	394	5	17	15	0	431
8310	387	8	5	15	0	415
8311	27	356	5	20	0	408
8312	367	15	6	13	0	401
8313	34	7	3	354	0	398
8314	24	10	328	18	0	380
8315	333	7	11	11	0	362
8316	28	326	9	11	0	374
8317	314	13	5	9	0	341
8318	26	290	4	9	0	329
8319	19	283	2	10	0	314
8320	16	280	5	13	0	314
8321	14	258	6	11	0	289
8322	18	9	189	10	0	226
8323	10	18	8	142	0	178
8324	6	3	123	8	0	140
8325	95	1	4	3	0	103
8326	3	95	2	3	0	103
8327	3	91	2	5	0	101
8328	5	5	1	90	0	101
8329	4	2	1	92	0	99
8330	5	3	87	5	0	100
8331	5	2	89	2	0	98
8332	2	4	4	90	0	100
8333	3	3	88	3	0	97
8334	1	87	2	4	0	94
8335	4	3	2	86	0	95
8336	2	2	0	91	0	95
8337	3	4	87	3	0	97
8338	4	1	2	86	0	93
8339	82	3	3	1	0	89
8340	5	2	1	84	0	92
8341	4	1	0	87	0	92
8342	2	3	86	3	0	94
8343	87	2	3	4	0	96
8344	2	93	0	3	0	98
8345	2	3	2	93	0	100
8346	3	2	89	2	0	96
8347	4	1	1	93	0	99
8348	90	1	4	3	0	98
8349	4	2	92	2	0	100
8350	4	1	1	92	0	98
8351	1	2	96	3	0	102
8352	4	95	5	1	0	105
8353	3	1	96	4	0	104
8354	2	100	3	1	0	106
8355	0	0	78	0	0	78
8356	0	1	0	66	0	67
8357	1	63	1	0	0	65
8358	63	0	0	1	0	64
8359	0	1	0	63	0	64
8360	64	0	1	0	0	65
8361	1	0	0	65	0	66
8362	1	1	0	62	0	64
8363	62	0	0	2	0	64
8364	60	0	1	1	0	62
8365	1	0	0	64	0	65
8366	2	0	64	0	0	66
8367	0	66	1	1	0	68
8368	0	0	70	1	0	71
8369	0	67	1	0	0	68
8370	67	1	1	1	0	70
8371	0	1	69	0	0	70
8372	2	0	69	0	0	71
8373	0	0	1	69	0	70
8374	70	0	0	0	0	70
8375	0	0	75	1	0	76
8376	1	74	1	0	0	76
8377	76	0	1	0	0	77
8378	77	1	0	1	0	79
8379	79	0	0	0	0	79
8380	74	0	0	1	0	75
8381	75	0	0	0	0	75
8382	1	0	73	0	0	74
8383	1	0	0	71	0	72
8384	0	70	1	0	0	71
8385	73	0	0	1	0	74
8386	0	77	0	0	0	77
8387	71	0	0	0	0	71
8388	69	0	0	1	0	70
8389	0	70	0	0	0	70
8390	73	0	0	0	0	73
8391	0	0	0	73	0	73
8392	0	0	0	73	0	73
8393	0	0	72	0	0	72
8394	0	80	0	0	0	80
8395	0	0	0	79	0	79
8396	0	0	0	76	0	76
8397	1	0	0	78	0	79
8398	0	0	79	0	0	79
8399	77	0	0	0	0	77
8400	0	0	0	81	0	81
8401	81	0	0	0	0	81
8402	0	1	0	80	0	81
8403	0	0	83	0	0	83
8404	0	1	80	0	0	81
8405	84	0	0	0	0	84
8406	83	0	0	0	0	83
8407	0	81	0	0	0	81
8408	0	0	81	0	0	81
8409	1	0	0	78	0	79
8410	0	1	1	58	0	60
8411	83	0	0	0	0	83
8412	83	0	0	0	0	83
8413	82	0	0	0	0	82
8414	0	0	83	0	0	83
8415	81	0	0	0	0	81
8416	0	0	0	85	0	85
8417	0	0	0	84	0	84
8418	0	0	0	84	0	84
8419	0	84	0	0	0	84
8420	78	0	0	0	0	78
8421	1	0	0	73	0	74
8422	0	0	72	0	0	72
8423	0	0	0	72	0	72
8424	0	74	0	0	0	74
8425	72	0	0	0	0	72
8426	0	0	0	70	0	70
8427	0	0	0	70	0	70
8428	0	0	70	0	0	70
8429	0	0	0	69	0	69
8430	0	74	0	0	0	74
8431	0	0	0	74	0	74
8432	0	0	74	0	0	74
8433	74	0	0	0	0	74
8434	77	0	0	1	0	78
8435	0	78	0	0	0	78
8436	79	0	0	0	0	79
8437	80	0	0	0	0	80
8438	0	79	0	0	0	79
8439	0	0	0	80	0	80
8440	85	0	0	0	0	85
8441	0	87	0	0	0	87
8442	0	0	86	0	0	86
8443	80	0	0	0	0	80
8444	82	0	0	1	0	83
8445	86	0	0	0	0	86
8446	86	0	0	0	0	86
8447	1	84	0	0	0	85
8448	84	1	0	1	0	86
8449	89	0	0	0	0	89
8450	91	0	0	0	0	91
8451	2	0	0	87	0	89
8452	85	0	0	1	0	86
8453	0	95	0	0	0	95
8454	0	1	99	0	0	100
8455	0	0	1	101	0	102
8456	99	0	0	3	0	102
8457	2	0	102	0	0	104
8458	1	0	2	102	0	105
8459	0	0	101	2	0	103
8460	0	103	2	0	0	105
8461	0	2	0	104	0	106
8462	0	1	99	2	0	102
8463	0	102	2	0	0	104
8464	1	2	0	98	0	101
8465	102	0	0	2	0	104
8466	105	0	0	0	0	105
8467	108	0	0	2	0	110
8468	109	0	0	0	0	109
8469	107	0	0	0	0	107
8470	2	0	100	0	0	102
8471	102	0	1	1	0	104
8472	106	0	0	0	0	106
8473	2	0	0	103	0	105
8474	100	0	0	3	0	103
8475	96	0	0	0	0	96
8476	2	98	0	0	0	100
8477	1	2	0	94	0	97
8478	0	0	0	100	0	100
8479	100	0	0	2	0	102
8480	2	97	0	1	0	100
8481	1	103	0	4	0	108
8482	1	5	0	104	0	110
8483	1	0	1	107	0	109
8484	0	0	0	116	0	116
8485	1	0	0	116	0	117
8486	108	0	1	5	0	114
8487	111	0	0	1	0	112
8488	5	0	108	0	0	113
8489	1	1	4	109	0	115
8490	0	0	1	112	0	113
8491	0	0	110	5	0	115
8492	101	0	4	2	0	107
8493	3	115	1	1	0	120
8494	110	4	0	1	0	115
8495	5	2	0	106	0	113
8496	2	0	105	5	0	112
8497	3	0	4	106	0	113
8498	1	1	118	4	0	124
8499	0	119	5	1	0	125
8500	118	4	1	0	0	123
8501	124	1	0	0	0	125
8502	5	119	0	1	0	125
8503	4	4	0	113	0	121
8504	112	1	0	4	0	117
8505	5	113	0	1	0	119
8506	3	4	0	114	0	121
8507	115	1	0	6	0	122
8508	5	0	113	2	0	120
8509	114	1	4	1	0	120
8510	3	117	1	0	0	121
8511	118	4	1	1	0	124
8512	121	1	0	2	0	124
8513	6	0	117	0	0	123
8514	1	0	6	109	0	116
8515	1	0	1	120	0	122
8516	1	0	115	5	0	121
8517	1	1	5	114	0	121
8518	0	0	1	111	0	112
8519	116	0	1	6	0	123
8520	123	1	1	2	0	127
8521	8	0	0	120	0	128
8522	2	1	123	5	0	131
8523	2	0	4	124	0	130
8524	1	0	1	131	0	133
8525	1	0	126	6	0	133
8526	2	0	5	124	0	131
8527	124	0	3	5	0	132
8528	131	1	0	0	0	132
8529	7	129	0	0	0	136
8530	142	5	0	1	0	148
8531	141	2	0	1	0	144
8532	7	141	0	0	0	148
8533	142	6	0	0	0	148
8534	142	1	0	2	0	145
8535	144	0	0	1	0	145
8536	9	0	134	0	0	143
8537	135	0	6	0	0	141
8538	6	1	2	136	0	145
8539	135	1	0	7	0	143
8540	6	0	142	2	0	150
8541	2	137	7	0	0	146
8542	142	5	4	0	0	151
8543	5	156	0	1	0	162
8544	4	5	0	155	0	164
8545	0	2	1	169	0	172
8546	162	0	1	8	0	171
8547	163	0	0	5	0	168
8548	8	0	160	0	0	168
8549	3	2	152	0	0	157
8550	1	0	156	0	0	157
8551	2	1	6	158	0	167
8552	0	1	160	5	0	166
8553	0	0	146	3	0	149
8554	2	0	7	145	0	154
8555	155	2	2	5	0	164
8556	162	0	0	5	0	167
8557	162	0	0	1	0	163
8558	162	0	1	0	0	163
8559	7	0	0	155	0	162
8560	2	1	0	164	0	167
8561	1	0	173	6	0	180
8562	1	0	4	175	0	180
8563	2	0	3	160	0	165
8564	171	0	0	9	0	180
8565	171	0	0	4	0	175
8566	6	0	1	170	0	177
8567	169	0	0	7	0	176
8568	168	0	0	7	0	175
8569	7	0	0	170	0	177
8570	3	0	0	173	0	176
8571	0	0	164	8	0	172
8572	0	0	168	2	0	170
8573	1	0	7	167	0	175
8574	0	0	2	178	0	180
8575	0	0	176	7	0	183
8576	164	0	5	2	0	171
8577	178	0	2	1	0	181
8578	8	0	169	1	0	178
8579	3	170	4	0	0	177
8580	175	3	3	1	0	182
8581	4	2	187	0	0	193
8582	2	1	3	184	0	190
8583	1	1	1	193	0	196
8584	196	0	0	5	0	201
8585	198	0	0	4	0	202
8586	5	0	0	201	0	206
8587	2	0	0	201	0	203
8588	196	0	1	4	0	201
8589	195	0	1	2	0	198
8590	200	0	1	1	0	202
8591	4	0	196	1	0	201
8592	1	0	4	202	0	207
8593	0	0	2	203	0	205
8594	199	0	0	7	0	206
8595	4	202	0	1	0	207
8596	217	3	0	1	0	221
8597	4	214	0	0	0	218
8598	3	5	0	213	0	221
8599	1	1	0	230	0	232
8600	0	2	229	6	0	237
8601	2	0	5	228	0	235
8602	0	0	232	6	0	238
8603	0	0	5	235	0	240
8604	1	0	1	236	0	238
8605	2	220	1	5	0	228
8606	0	238	1	3	0	242
8607	2	5	0	233	0	240
8608	2	2	0	245	0	249
8609	1	1	0	243	0	245
8610	0	0	0	237	0	237
8611	0	0	1	249	0	250
8612	0	0	245	6	0	251
8613	1	0	4	242	0	247
8614	1	0	1	246	0	248
8615	1	0	240	5	0	246
8616	1	236	4	3	0	244
8617	4	4	1	239	0	248
8618	1	1	246	5	0	253
8619	0	257	4	3	0	264
8620	1	3	1	257	0	262
8621	258	1	3	5	0	267
8622	3	1	2	255	0	261
8623	4	0	0	258	0	262
8624	3	0	0	262	0	265
8625	3	0	1	255	0	259
8626	1	253	0	6	0	260
8627	1	3	0	259	0	263
8628	263	1	1	5	0	270
8629	4	3	0	261	0	268
8630	3	0	0	253	0	256
8631	2	0	2	256	0	260
8632	247	0	0	7	0	254
8633	246	0	0	5	0	251
8634	7	0	0	252	0	259
8635	255	1	0	5	0	261
8636	249	1	1	3	0	254
8637	4	252	2	3	0	261
8638	259	3	0	4	0	266
8639	5	252	1	2	0	260
8640	1	245	1	1	0	248
8641	2	2	1	252	0	257
8642	2	0	255	3	0	260
8643	1	4	3	230	0	238
8644	1	1	0	238	0	240
8645	2	229	3	2	0	236
8646	228	2	1	2	0	233
8647	3	1	0	229	0	233
8648	1	0	249	5	0	255
8649	2	0	3	250	0	255
8650	1	249	1	3	0	254
8651	254	2	2	5	0	263
8652	2	0	2	259	0	263
8653	1	0	256	5	0	262
8654	3	1	2	254	0	260
8655	1	244	0	2	0	247
8656	2	2	2	248	0	254
8657	253	0	0	10	0	263
8658	263	1	1	3	0	268
8659	266	0	0	5	0	271
8660	4	268	1	1	0	274
8661	255	2	1	4	0	262
8662	5	0	0	260	0	265
8663	257	2	1	6	0	266
8664	4	255	1	2	0	262
8665	0	4	1	265	0	270
8666	1	0	266	7	0	274
8667	258	1	5	1	0	265
8668	5	264	2	2	0	273
8669	3	1	1	268	0	273
8670	2	1	1	270	0	274
8671	2	1	0	270	0	273
8672	0	0	0	267	0	267
8673	1	261	2	4	0	268
8674	266	4	0	3	0	273
8675	258	1	0	4	0	263
8676	2	2	277	1	0	282
8677	4	1	2	270	0	277
8678	1	1	277	4	0	283
8679	266	0	5	2	0	273
8680	270	0	0	5	0	275
8681	260	0	1	2	0	263
8682	5	0	0	255	0	260
8683	0	248	0	4	0	252
8684	249	3	0	2	0	254
8685	4	1	0	258	0	263
8686	251	2	1	3	0	257
8687	3	0	242	3	0	248
8688	1	1	235	2	0	239
8689	245	1	3	1	0	250
8690	4	0	2	252	0	258
8691	248	0	2	2	0	252
8692	3	245	0	4	0	252
8693	242	3	0	2	0	247
8694	243	2	0	1	0	246
8695	4	2	236	1	0	243
8696	2	1	213	1	0	217
8697	0	225	5	0	0	230
8698	3	1	6	208	0	218
8699	205	1	0	2	0	208
8700	1	0	0	200	0	201
8701	2	0	0	202	0	204
8702	0	2	197	2	0	201
8703	194	0	1	1	0	196
8704	2	0	1	203	0	206
8705	2	0	205	1	0	208
8706	0	1	198	1	0	200
8707	1	0	2	203	0	206
8708	0	1	204	2	0	207
8709	1	0	202	1	0	204
8710	1	1	2	191	0	195
8711	0	0	212	2	0	214
8712	0	0	2	208	0	210
8713	0	194	1	1	0	196
8714	215	2	0	1	0	218
8715	1	215	0	1	0	217
8716	2	1	0	208	0	211
8717	0	229	0	2	0	231
8718	0	2	220	2	0	224
8719	2	2	5	258	0	267
8720	3	1	308	7	0	319
8721	306	0	6	2	0	314
8722	8	332	4	1	0	345
8723	336	8	2	2	0	348
8724	10	3	1	331	0	345
8725	333	2	1	10	0	346
8726	10	0	330	2	0	342
8727	3	331	8	3	0	345
8728	326	8	3	3	0	340
8729	11	3	2	321	0	337
8730	4	333	2	6	0	345
8731	6	8	1	338	0	353
8732	337	4	0	11	0	352
8733	10	358	2	2	0	372
8734	360	10	1	6	0	377
8735	13	6	354	0	0	373
8736	358	2	12	2	0	374
8737	15	1	3	350	0	369
8738	349	2	2	11	0	364
8739	14	347	2	4	0	367
8740	6	13	1	354	0	374
8741	4	4	1	364	0	373
8742	1	2	348	15	0	366
8743	2	3	11	339	0	355
8744	2	1	3	363	0	369
8745	5	0	4	362	0	371
8746	4	0	0	364	0	368
8747	2	2	352	18	0	374
8748	1	332	12	6	0	351
8749	6	11	3	341	0	361
8750	335	5	4	17	0	361
8751	346	2	1	8	0	357
8752	13	340	5	2	0	360
8753	346	11	1	5	0	363
8754	345	5	1	7	0	358
8755	344	2	4	4	0	354
8756	18	339	0	4	0	361
8757	336	12	3	5	0	356
8758	17	3	0	322	0	342
8759	5	4	312	15	0	336
8760	4	313	9	6	0	332
8761	3	13	4	312	0	332
8762	3	8	305	11	0	327
8763	309	3	11	6	0	329
8764	14	1	5	308	0	328
8765	8	5	2	310	0	325
8766	8	2	1	317	0	328
8767	6	1	2	320	0	329
8768	5	2	298	16	0	321
8769	282	3	12	7	0	304
8770	15	296	6	3	0	320
8771	301	12	2	3	0	318
8772	14	301	1	3	0	319
8773	297	15	1	4	0	317
8774	15	5	0	296	0	316
8775	4	4	300	15	0	323
8776	6	0	294	6	0	306
8777	4	4	18	291	0	317
8778	4	1	5	315	0	325
8779	3	1	4	314	0	322
8780	300	3	1	18	0	322
8781	13	1	299	11	0	324
8782	5	57	11	225	0	298
8783	3	297	5	10	0	315
8784	291	11	3	7	0	312
8785	14	4	294	3	0	315
8786	8	284	12	2	0	306
8787	2	15	289	5	0	311
8788	6	2	13	284	0	305
8789	3	5	286	13	0	307
8790	4	2	289	5	0	300
8791	3	1	15	285	0	304
8792	3	0	284	15	0	302
8793	2	1	298	5	0	306
8794	1	1	16	281	0	299
8795	280	3	7	14	0	304
8796	12	2	264	15	0	293
8797	5	0	16	276	0	297
8798	3	4	7	279	0	293
8799	271	1	3	18	0	293
8800	14	2	4	276	0	296
8801	268	2	1	15	0	286
8802	14	269	5	5	0	293
8803	4	13	5	272	0	294
8804	276	2	4	13	0	295
8805	280	2	2	8	0	292
8806	19	1	4	261	0	285
8807	5	3	261	12	0	281
8808	253	0	11	10	0	274
8809	11	261	6	6	0	284
8810	243	13	7	3	0	266
8811	262	2	2	8	0	274
8812	262	2	2	4	0	270
8813	18	2	245	4	0	269
8814	7	253	11	7	0	278
8815	6	14	5	254	0	279
8816	7	7	3	259	0	276
8817	2	3	237	16	0	258
8818	5	230	10	6	0	251
8819	4	173	2	2	0	181
8820	1	126	4	2	0	133
8821	115	6	3	2	0	126
8822	7	1	1	100	0	109
8823	2	0	0	108	0	110
8824	0	1	99	5	0	105
8825	95	0	4	2	0	101
8826	5	1	1	99	0	106
8827	4	0	0	105	0	109
8828	2	0	97	6	0	105
8829	2	94	5	1	0	102
8830	1	3	3	88	0	95
8831	5	2	82	5	0	94
8832	0	78	5	3	0	86
8833	64	3	1	0	0	68
8834	2	1	67	0	0	70
8835	1	0	1	66	0	68
8836	0	67	2	1	0	70
8837	67	2	0	0	0	69
8838	2	0	0	68	0	70
8839	76	0	1	4	0	81
8840	81	0	0	0	0	81
8841	1	79	0	0	0	80
8842	75	1	0	1	0	77
8843	84	0	0	2	0	86
8844	2	0	93	0	0	95
8845	90	0	1	1	0	92
8846	1	2	91	0	0	94
8847	94	0	1	1	0	96
8848	97	0	0	0	0	97
8849	1	0	103	0	0	104
8850	1	0	1	99	0	101
8851	0	1	104	1	0	106
8852	2	1	93	0	0	96
8853	1	0	104	0	0	105
8854	1	0	2	108	0	111
8855	0	0	0	114	0	114
8856	1	0	1	114	0	116
8857	2	0	1	122	0	125
8858	0	0	136	1	0	137
8859	1	0	1	130	0	132
8860	0	132	1	2	0	135
8861	0	1	134	2	0	137
8862	0	2	1	134	0	137
8863	0	0	137	1	0	138
8864	0	138	1	3	0	142
8865	0	149	2	0	0	151
8866	0	2	1	149	0	152
8867	2	2	149	0	0	153
8868	0	0	147	2	0	149
8869	0	0	4	148	0	152
8870	0	1	1	150	0	152
8871	0	0	0	152	0	152
8872	0	0	149	1	0	150
8873	0	145	2	2	0	149
8874	0	147	2	0	0	149
8875	1	1	0	143	0	145
8876	0	1	139	1	0	141
8877	1	1	121	2	0	125
8878	0	138	1	0	0	139
8879	144	1	2	1	0	148
8880	0	145	0	0	0	145
8881	2	0	163	0	0	165
8882	159	1	1	1	0	162
8883	1	1	2	171	0	175
8884	174	0	0	1	0	175
8885	2	1	0	171	0	174
8886	2	0	1	171	0	174
8887	172	0	0	4	0	176
8888	1	175	0	2	0	178
8889	3	2	176	0	0	181
8890	0	177	1	0	0	178
8891	180	1	2	1	0	184
8892	2	180	0	0	0	182
8893	182	1	0	1	0	184
8894	178	2	1	1	0	182
8895	3	187	0	1	0	191
8896	2	1	0	185	0	188
8897	180	2	1	1	0	184
8898	185	0	0	3	0	188
8899	4	0	1	183	0	188
8900	3	2	177	1	0	183
8901	0	2	173	3	0	178
8902	2	0	3	182	0	187
8903	1	0	183	1	0	185
8904	173	0	1	4	0	178
8905	2	180	2	0	0	184
8906	2	1	1	189	0	193
8907	0	2	1	187	0	190
8908	0	1	1	186	0	188
8909	4	0	0	182	0	186
8910	2	2	0	186	0	190
8911	1	0	185	2	0	188
8912	0	180	1	4	0	185
8913	181	2	2	3	0	188
8914	1	1	0	180	0	182
8915	3	0	0	176	0	179
8916	1	0	1	180	0	182
8917	0	175	0	4	0	179
8918	1	1	1	176	0	179
8919	0	2	1	179	0	182
8920	174	0	0	6	0	180
8921	1	161	1	2	0	165
8922	3	169	1	0	0	173
8923	0	3	0	170	0	173
8924	168	0	0	2	0	170
8925	1	0	173	2	0	176
8926	170	0	1	0	0	171
8927	2	0	185	0	0	187
8928	3	0	1	190	0	194
8929	0	0	3	200	0	203
8930	0	1	0	197	0	198
8931	1	0	0	200	0	201
8932	1	0	0	206	0	207
8933	201	0	0	9	0	210
8934	1	0	202	3	0	206
8935	2	1	0	200	0	203
8936	0	1	215	2	0	218
8937	0	216	2	3	0	221
8938	221	2	2	1	0	226
8939	3	2	225	0	0	230
8940	3	0	2	221	0	226
8941	0	0	2	228	0	230
8942	0	0	236	5	0	241
8943	0	0	236	1	0	237
8944	1	0	4	210	0	215
8945	226	0	2	3	0	231
8946	228	0	0	2	0	230
8947	5	226	0	0	0	231
8948	232	3	0	1	0	236
8949	3	2	0	228	0	233
8950	2	240	0	4	0	246
8951	0	3	0	243	0	246
8952	0	2	242	3	0	247
8953	0	0	3	233	0	236
8954	0	1	2	247	0	250
8955	241	0	0	4	0	245
8956	3	245	0	2	0	250
8957	237	3	0	0	0	240
8958	4	244	0	0	0	248
8959	230	4	0	0	0	234
8960	4	233	0	0	0	237
8961	0	234	0	0	0	234
8962	237	4	0	0	0	241
8963	11	0	1	225	0	237
8964	1	238	0	4	0	243
8965	238	4	0	1	0	243
8966	238	0	0	0	0	238
8967	241	0	0	1	0	242
8968	241	0	0	1	0	242
8969	5	237	0	0	0	242
8970	0	5	0	247	0	252
8971	0	0	0	252	0	252
8972	251	0	0	8	0	259
8973	5	1	0	250	0	256
8974	254	0	0	6	0	260
8975	5	0	254	0	0	259
8976	250	0	5	0	0	255
8977	5	0	260	0	0	265
8978	1	0	5	263	0	269
8979	262	0	0	5	0	267
8980	5	259	0	0	0	264
8981	244	4	0	1	0	249
8982	4	238	0	0	0	242
8983	0	4	0	249	0	253
8984	0	1	252	4	0	257
8985	232	0	4	2	0	238
8986	4	248	1	0	0	253
8987	0	5	0	253	0	258
8988	0	0	0	254	0	254
8989	0	1	0	251	0	252
8990	0	1	252	4	0	257
8991	0	247	5	1	0	253
8992	251	4	0	0	0	255
8993	248	1	0	0	0	249
8994	4	248	0	1	0	253
8995	251	4	0	3	0	258
8996	6	0	0	248	0	254
8997	0	244	1	3	0	248
8998	251	5	0	2	0	258
8999	5	1	246	0	0	252
9000	1	250	4	1	0	256
9001	0	5	0	256	0	261
9002	2	0	0	256	0	258
9003	0	1	248	5	0	254
9004	2	0	4	235	0	241
9005	1	1	248	4	0	254
9006	3	1	5	237	0	246
9007	1	2	0	242	0	245
9008	0	1	0	244	0	245
9009	2	1	0	238	0	241
9010	1	0	232	5	0	238
9011	1	3	232	1	0	237
9012	1	251	6	0	0	258
9013	1	5	2	281	0	289
9014	1	3	277	7	0	288
9015	1	277	6	3	0	287
9016	1	6	2	291	0	300
9017	0	2	300	5	0	307
9018	281	0	6	6	0	293
9019	319	1	2	2	0	324
9020	8	0	0	317	0	325
9021	3	0	315	6	0	324
9022	2	1	7	312	0	322
9023	313	0	4	8	0	325
9024	5	310	3	3	0	321
9025	319	5	0	3	0	327
9026	326	2	0	1	0	329
9027	7	2	0	312	0	321
9028	3	0	1	305	0	309
9029	0	2	1	303	0	306
9030	4	0	0	299	0	303
9031	2	1	1	301	0	305
9032	288	0	0	8	0	296
9033	292	1	0	2	0	295
9034	293	0	0	4	0	297
9035	8	1	271	2	0	282
9036	269	1	3	2	0	275
9037	6	0	3	260	0	269
9038	3	2	263	5	0	273
9039	1	251	4	3	0	259
9040	1	4	2	256	0	263
9041	1	2	0	257	0	260
9042	0	259	0	4	0	263
9043	1	3	0	270	0	274
9044	1	3	263	5	0	272
9045	1	1	265	2	0	269
9046	1	1	6	265	0	273
9047	265	0	3	8	0	276
9048	270	0	0	4	0	274
9049	6	3	263	1	0	273
9050	2	230	5	8	0	245
9051	0	257	2	0	0	259
9052	246	6	1	1	0	254
9053	4	3	255	3	0	265
9054	3	1	4	246	0	254
9055	249	0	2	7	0	258
9056	4	241	2	3	0	250
9057	3	251	1	0	0	255
9058	235	6	0	3	0	244
9059	5	3	2	234	0	244
9060	251	0	1	5	0	257
9061	5	0	1	290	0	296
9062	7	2	0	304	0	313
9063	1	3	299	10	0	313
9064	2	1	6	311	0	320
9065	2	0	5	320	0	327
9066	312	1	1	14	0	328
9067	12	0	0	318	0	330
9068	6	1	313	11	0	331
9069	301	1	7	8	0	317
9070	9	0	6	302	0	317
9071	311	0	2	10	0	323
9072	12	292	0	7	0	311
9073	7	305	1	4	0	317
9074	304	9	0	3	0	316
9075	298	7	2	3	0	310
9076	16	2	1	290	0	309
9077	7	1	291	10	0	309
9078	6	0	8	285	0	299
9079	282	0	5	11	0	298
9080	7	277	5	4	0	293
9081	5	8	0	286	0	299
9082	282	5	1	9	0	297
9083	9	1	273	6	0	289
9084	270	1	8	3	0	282
9085	259	1	5	3	0	268
9086	15	0	278	2	0	295
9087	8	0	279	1	0	288
9088	3	1	13	271	0	288
9089	4	1	5	277	0	287
9090	3	278	2	11	0	294
9091	3	7	1	278	0	289
9092	0	7	284	9	0	300
9093	6	3	8	284	0	301
9094	4	1	4	299	0	308
9095	1	1	285	15	0	302
9096	1	284	9	8	0	302
9097	3	11	5	277	0	296
9098	5	4	3	292	0	304
9099	287	3	1	15	0	306
9100	12	1	1	303	0	317
9101	7	0	296	11	0	314
9102	292	0	9	7	0	308
9103	306	0	6	5	0	317
9104	314	3	1	1	0	319
9105	16	2	294	2	0	314
9106	11	0	9	294	0	314
9107	8	0	7	304	0	319
9108	4	0	2	311	0	317
9109	300	0	1	18	0	319
9110	9	293	3	9	0	314
9111	4	10	282	3	0	299
9112	3	271	8	3	0	285
9113	3	251	4	3	0	261
9114	2	261	2	1	0	266
9115	10	12	2	237	0	261
9116	2	3	234	10	0	249
9117	202	1	12	5	0	220
9118	9	220	5	3	0	237
9119	213	8	3	3	0	227
9120	11	218	0	2	0	231
9121	220	10	0	3	0	233
9122	9	224	1	1	0	235
9123	5	11	219	1	0	236
9124	4	2	9	221	0	236
9125	4	2	5	226	0	237
9126	219	1	3	16	0	239
9127	11	1	2	251	0	265
9128	7	1	247	11	0	266
9129	5	1	9	251	0	266
9130	0	1	248	14	0	263
9131	3	244	12	5	0	264
9132	1	7	3	241	0	252
9133	4	244	4	8	0	260
9134	247	14	1	3	0	265
9135	11	5	2	245	0	263
9136	6	2	242	9	0	259
9137	2	1	249	5	0	257
9138	242	2	10	5	0	259
9139	11	1	5	233	0	250
9140	3	1	239	12	0	255
9141	5	0	234	4	0	243
9142	1	231	13	3	0	248
9143	3	7	6	204	0	220
9144	1	221	3	7	0	232
9145	1	11	2	221	0	235
9146	213	6	0	12	0	231
9147	9	2	0	219	0	230
9148	5	0	2	229	0	236
9149	224	1	1	12	0	238
9150	10	1	2	230	0	243
9151	5	1	1	222	0	229
9152	4	240	1	10	0	255
9153	244	9	0	10	0	263
9154	251	3	3	5	0	262
9155	12	3	3	244	0	262
9156	6	1	0	255	0	262
9157	3	1	1	254	0	259
9158	4	238	0	13	0	255
9159	2	246	0	8	0	256
9160	1	9	3	235	0	248
9161	180	4	0	5	0	189
9162	182	3	1	1	0	187
9163	7	177	0	2	0	186
9164	164	5	0	5	0	174
9165	7	157	1	0	0	165
9166	3	156	0	1	0	160
9167	0	5	2	157	0	164
9168	156	0	1	6	0	163
9169	4	144	1	0	0	149
9170	0	159	1	0	0	160
9171	1	3	0	149	0	153
9172	3	1	0	148	0	152
9173	1	2	149	3	0	155
9174	150	1	3	1	0	155
9175	146	1	1	2	0	150
9176	3	0	148	1	0	152
9177	1	1	147	1	0	150
9178	2	0	3	160	0	165
9179	2	0	1	164	0	167
9180	0	161	2	4	0	167
9181	1	4	2	159	0	166
9182	0	0	160	6	0	166
9183	0	1	4	163	0	168
9184	2	2	0	166	0	170
9185	161	0	0	5	0	166
9186	3	1	152	1	0	157
9187	152	0	3	2	0	157
9188	5	0	150	1	0	156
9189	1	0	4	149	0	154
9190	0	0	150	3	0	153
9191	2	1	146	2	0	151
9192	1	0	6	143	0	150
9193	130	8	1	4	0	143
9194	132	0	2	4	0	138
9195	2	141	1	2	0	146
9196	142	2	0	3	0	147
9197	141	2	0	2	0	145
9198	5	141	2	1	0	149
9199	2	3	2	142	0	149
9200	3	0	0	132	0	135
9201	2	1	0	129	0	132
9202	2	2	2	129	0	135
9203	0	0	130	4	0	134
9204	124	3	2	2	0	131
9205	3	0	0	134	0	137
9206	2	2	0	129	0	133
9207	2	138	1	4	0	145
9208	4	3	0	142	0	149
9209	0	1	133	6	0	140
9210	129	2	2	3	0	136
9211	4	1	139	1	0	145
9212	1	1	2	141	0	145
9213	148	1	1	3	0	153
9214	3	147	1	0	0	151
9215	6	4	1	146	0	157
9216	3	1	152	4	0	160
9217	2	0	3	155	0	160
9218	151	2	0	5	0	158
9219	4	1	152	3	0	160
9220	1	2	140	0	0	143
9221	0	147	4	1	0	152
9222	147	2	1	3	0	153
9223	4	138	1	3	0	146
9224	2	2	141	1	0	146
9225	1	5	135	1	0	142
9226	3	135	2	1	0	141
9227	109	2	2	0	0	113
9228	1	110	2	2	0	115
9229	2	1	1	108	0	112
9230	2	1	1	111	0	115
9231	2	1	108	0	0	111
9232	1	1	2	110	0	114
9233	0	0	110	1	0	111
9234	101	1	1	3	0	106
9235	109	0	3	1	0	113
9236	109	1	1	3	0	114
9237	1	0	112	2	0	115
9238	109	0	0	1	0	110
9239	2	1	2	107	0	112
9240	2	107	1	1	0	111
9241	111	0	2	2	0	115
9242	2	3	108	0	0	113
9243	106	1	0	2	0	109
9244	111	0	0	1	0	112
9245	0	0	104	2	0	106
9246	1	108	0	1	0	110
9247	0	0	1	109	0	110
9248	1	1	106	0	0	108
9249	2	0	101	1	0	104
9250	0	0	1	96	0	97
9251	1	0	108	0	0	109
9252	1	0	0	90	0	91
9253	0	0	1	84	0	85
9254	0	1	0	87	0	88
9255	0	0	88	1	0	89
9256	0	0	1	85	0	86
9257	0	0	88	0	0	88
9258	0	0	0	86	0	86
9259	94	0	2	0	0	96
9260	0	0	0	93	0	93
9261	1	93	0	1	0	95
9262	0	0	0	97	0	97
9263	97	1	1	1	0	100
9264	0	97	1	2	0	100
9265	1	0	1	100	0	102
9266	101	1	0	1	0	103
9267	1	0	100	1	0	102
9268	2	0	1	99	0	102
9269	0	2	102	0	0	104
9270	1	0	93	1	0	95
9271	2	1	1	91	0	95
9272	95	1	2	0	0	98
9273	0	0	93	2	0	95
9274	94	1	0	0	0	95
9275	1	0	2	94	0	97
9276	1	1	98	2	0	102
9277	0	0	97	2	0	99
9278	0	1	86	1	0	88
9279	0	0	3	88	0	91
9280	89	0	1	2	0	92
9281	1	83	2	1	0	87
9282	2	1	0	85	0	88
9283	2	1	0	84	0	87
9284	86	0	1	2	0	89
9285	86	0	2	1	0	89
9286	2	84	1	0	0	87
9287	86	1	0	2	0	89
9288	86	2	0	0	0	88
9289	3	1	0	84	0	88
9290	1	0	87	2	0	90
9291	85	0	1	2	0	88
9292	3	0	1	88	0	92
9293	2	0	1	86	0	89
9294	87	2	0	2	0	91
9295	3	0	0	76	0	79
9296	2	0	1	80	0	83
9297	78	0	1	3	0	82
9298	1	81	1	2	0	85
9299	85	1	1	0	0	87
9300	1	1	82	2	0	86
9301	82	0	1	2	0	85
9302	2	0	1	79	0	82
9303	1	81	1	2	0	85
9304	0	1	0	86	0	87
9305	1	1	1	83	0	86
9306	1	1	0	85	0	87
9307	77	0	0	2	0	79
9308	1	68	1	2	0	72
9309	2	71	0	0	0	73
9310	67	2	0	1	0	70
9311	2	1	69	0	0	72
9312	1	1	64	1	0	67
9313	62	0	3	3	0	68
9314	1	0	67	1	0	69
9315	1	0	1	58	0	60
9316	2	0	1	52	0	55
9317	1	0	0	63	0	64
9318	1	0	0	59	0	60
9319	0	57	0	2	0	59
9320	0	1	0	61	0	62
9321	0	1	61	1	0	63
9322	0	0	1	59	0	60
9323	0	0	59	1	0	60
9324	0	0	57	1	0	58
9325	0	0	2	58	0	60
9326	0	0	66	0	0	66
9327	0	0	1	62	0	63
9328	64	0	1	1	0	66
9329	1	0	62	1	0	64
9330	60	0	1	1	0	62
9331	1	0	1	61	0	63
9332	1	0	65	1	0	67
9333	0	64	1	1	0	66
9334	0	1	1	65	0	67
9335	2	1	69	1	0	73
9336	0	0	1	74	0	75
9337	75	0	1	1	0	77
9338	74	0	0	2	0	76
9339	75	0	0	1	0	76
9340	2	0	0	80	0	82
9341	2	0	0	80	0	82
9342	0	0	0	79	0	79
9343	88	0	0	4	0	92
9344	1	88	1	2	0	92
9345	1	3	0	91	0	95
9346	0	1	0	96	0	97
9347	92	0	0	3	0	95
9348	3	96	0	1	0	100
9349	1	4	0	96	0	101
9350	94	1	0	4	0	99
9351	86	0	0	2	0	88
9352	6	0	0	85	0	91
9353	87	1	0	3	0	91
9354	3	0	0	87	0	90
9355	3	0	83	3	0	89
9356	1	0	3	86	0	90
9357	0	0	1	91	0	92
9358	1	0	0	88	0	89
9359	81	0	0	5	0	86
9360	3	77	1	1	0	82
9361	77	3	0	1	0	81
9362	3	76	0	2	0	81
9363	1	81	0	2	0	84
9364	78	4	0	0	0	82
9365	3	83	0	0	0	86
9366	2	3	0	82	0	87
9367	80	2	0	4	0	86
9368	81	1	0	2	0	84
9369	4	0	0	79	0	83
9370	1	1	0	86	0	88
9371	1	83	1	5	0	90
9372	85	2	0	1	0	88
9373	83	1	0	2	0	86
9374	3	83	0	2	0	88
9375	1	87	0	2	0	90
9376	0	5	1	89	0	95
9377	89	1	0	3	0	93
9378	3	1	0	89	0	93
9379	2	2	0	88	0	92
9380	2	1	89	3	0	95
9381	0	3	91	1	0	95
9382	1	0	3	91	0	95
9383	1	0	90	3	0	94
9384	1	93	2	2	0	98
9385	1	2	1	92	0	96
9386	2	2	1	96	0	101
9387	2	1	0	95	0	98
9388	2	0	95	3	0	100
9389	2	1	93	1	0	97
9390	87	1	2	2	0	92
9391	2	96	1	2	0	101
9392	94	2	0	2	0	98
9393	5	1	1	92	0	99
9394	92	0	1	4	0	97
9395	3	1	0	92	0	96
9396	1	94	1	1	0	97
9397	96	2	1	2	0	101
9398	3	1	90	2	0	96
9399	2	91	2	1	0	96
9400	89	2	1	3	0	95
9401	2	2	1	87	0	92
9402	2	85	1	3	0	91
9403	1	1	1	92	0	95
9404	88	2	2	2	0	94
9405	3	1	1	88	0	93
9406	90	0	0	3	0	93
9407	2	3	88	2	0	95
9408	2	0	2	91	0	95
9409	86	0	2	4	0	92
9410	3	0	86	2	0	91
9411	3	86	1	1	0	91
9412	0	3	2	85	0	90
9413	2	1	83	3	0	89
9414	2	1	85	2	0	90
9415	1	1	4	82	0	88
9416	2	1	87	3	0	93
9417	0	1	87	4	0	92
9418	2	1	5	86	0	94
9419	88	0	2	3	0	93
9420	4	1	0	90	0	95
9421	2	0	1	93	0	96
9422	2	0	88	4	0	94
9423	0	1	3	100	0	104
9424	100	0	1	4	0	105
9425	3	1	98	2	0	104
9426	1	94	2	2	0	99
9427	2	3	2	96	0	103
9428	96	2	0	5	0	103
9429	4	0	1	96	0	101
9430	2	96	0	2	0	100
9431	1	3	99	2	0	105
9432	0	1	3	103	0	107
9433	103	0	2	3	0	108
9434	2	1	102	2	0	107
9435	3	1	4	109	0	117
9436	110	0	2	4	0	116
9437	113	1	1	3	0	118
9438	5	114	2	0	0	121
9439	114	2	1	3	0	120
9440	5	2	0	109	0	116
9441	3	1	105	2	0	111
9442	2	103	3	3	0	111
9443	0	91	2	2	0	95
9444	1	3	1	90	0	95
9445	1	4	0	86	0	91
9446	0	2	84	3	0	89
9447	0	82	1	3	0	86
9448	0	78	2	1	0	81
9449	0	3	1	79	0	83
9450	76	2	0	1	0	79
9451	0	80	0	1	0	81
9452	1	1	0	81	0	83
9453	87	1	0	1	0	89
9454	1	1	0	87	0	89
9455	1	0	0	88	0	89
9456	2	0	0	85	0	87
9457	0	0	0	89	0	89
9458	86	0	0	3	0	89
9459	1	0	0	88	0	89
9460	1	0	86	2	0	89
9461	87	0	1	1	0	89
9462	1	0	84	1	0	86
9463	1	0	93	0	0	94
9464	1	0	2	89	0	92
9465	0	0	2	90	0	92
9466	1	0	1	92	0	94
9467	90	0	1	3	0	94
9468	1	0	89	3	0	93
9469	92	0	1	1	0	94
9470	93	0	1	0	0	94
9471	2	1	96	0	0	99
9472	96	0	1	0	0	97
9473	2	0	102	1	0	105
9474	1	96	3	0	0	100
9475	2	3	1	96	0	102
9476	0	3	1	95	0	99
9477	0	1	0	100	0	101
9478	0	0	0	98	0	98
9479	0	0	97	3	0	100
9480	0	0	92	2	0	94
9481	0	1	2	99	0	102
9482	0	0	99	2	0	101
9483	92	0	2	1	0	95
9484	97	1	1	1	0	100
9485	2	0	1	95	0	98
9486	97	0	0	1	0	98
9487	1	95	0	3	0	99
9488	98	1	0	2	0	101
9489	2	1	99	1	0	103
9490	1	1	1	101	0	104
9491	2	97	1	1	0	101
9492	98	1	1	4	0	104
9493	1	1	1	104	0	107
9494	2	1	105	1	0	109
9495	1	0	2	106	0	109
9496	104	0	2	2	0	108
9497	1	0	113	2	0	116
9498	2	0	1	114	0	117
9499	1	0	2	116	0	119
9500	1	0	114	3	0	118
9501	2	113	2	3	0	120
9502	6	96	3	1	0	106
9503	1	4	1	119	0	125
9504	1	3	1	116	0	121
9505	2	1	0	124	0	127
9506	119	0	2	4	0	125
9507	118	2	0	2	0	122
9508	2	3	0	123	0	128
9509	120	1	0	5	0	126
9510	1	125	0	5	0	131
9511	1	1	1	138	0	141
9512	1	3	2	135	0	141
9513	0	4	1	136	0	141
9514	128	1	0	6	0	135
9515	1	129	1	3	0	134
9516	3	3	0	129	0	135
9517	129	2	0	4	0	135
9518	3	1	0	127	0	131
9519	3	0	0	128	0	131
9520	1	120	1	5	0	127
9521	1	126	0	5	0	132
9522	0	1	1	129	0	131
9523	2	2	0	121	0	125
9524	116	2	0	4	0	122
9525	1	0	2	118	0	121
9526	3	1	113	3	0	120
9527	2	0	4	110	0	116
9528	0	107	4	4	0	115
9529	110	1	2	3	0	116
9530	1	1	1	112	0	115
9531	1	1	0	111	0	113
9532	3	98	0	4	0	105
9533	101	0	1	3	0	105
9534	0	103	1	0	0	104
9535	0	1	0	101	0	102
9536	1	1	100	1	0	103
9537	0	0	0	98	0	98
9538	98	0	0	2	0	100
9539	1	95	0	0	0	96
9540	0	0	0	98	0	98
9541	0	100	0	1	0	101
9542	1	0	1	102	0	104
9543	0	2	104	1	0	107
9544	1	0	0	99	0	100
9545	0	0	1	106	0	107
9546	0	0	0	106	0	106
9547	104	1	0	1	0	106
9548	104	1	1	1	0	107
9549	0	104	2	2	0	108
9550	107	1	1	1	0	110
9551	1	103	0	2	0	106
9552	1	97	2	1	0	101
9553	98	1	1	2	0	102
9554	1	2	93	2	0	98
9555	1	0	1	99	0	101
9556	1	1	1	96	0	99
9557	2	2	0	97	0	101
9558	94	1	0	2	0	97
9559	0	87	1	3	0	91
9560	0	1	0	97	0	98
9561	1	93	0	3	0	97
9562	101	1	0	0	0	102
9563	2	1	0	100	0	103
9564	1	0	0	113	0	114
9565	2	123	0	2	0	127
9566	1	4	0	129	0	134
9567	0	1	0	137	0	138
9568	128	1	0	7	0	136
9569	4	126	1	1	0	132
9570	1	132	0	3	0	136
9571	1	4	0	127	0	132
9572	2	1	120	5	0	128
9573	1	1	111	4	0	117
9574	1	1	3	117	0	122
9575	0	2	114	6	0	122
9576	1	4	3	112	0	120
9577	1	1	0	114	0	116
9578	0	0	2	119	0	121
9579	113	0	2	7	0	122
9580	4	1	1	119	0	125
9581	2	0	2	118	0	122
9582	1	115	1	5	0	122
9583	1	4	0	120	0	125
9584	2	1	121	5	0	129
9585	3	1	3	124	0	131
9586	2	0	0	131	0	133
9587	119	2	1	6	0	128
9588	4	3	0	120	0	127
9589	2	1	0	116	0	119
9590	0	1	2	124	0	127
9591	115	0	1	5	0	121
9592	3	117	1	4	0	125
9593	2	2	0	121	0	125
9594	0	1	0	125	0	126
9595	1	1	118	5	0	125
9596	0	1	3	122	0	126
9597	112	0	0	5	0	117
9598	3	114	2	0	0	119
9599	0	3	1	114	0	118
9600	1	1	0	117	0	119
9601	1	0	113	4	0	118
9602	98	0	3	4	0	105
9603	6	105	0	1	0	112
9604	104	6	0	1	0	111
9605	4	1	0	111	0	116
9606	0	1	0	113	0	114
9607	0	0	2	113	0	115
9608	3	1	1	111	0	116
9609	107	2	0	5	0	114
9610	5	1	2	99	0	107
9611	0	94	0	8	0	102
9612	1	3	0	102	0	106
9613	2	1	1	101	0	105
9614	94	1	1	6	0	102
9615	5	91	0	3	0	99
9616	0	3	2	98	0	103
9617	95	3	1	3	0	102
9618	96	1	0	5	0	102
9619	4	0	2	96	0	102
9620	4	0	96	4	0	104
9621	94	2	4	3	0	103
9622	4	0	0	103	0	107
9623	3	1	102	4	0	110
9624	2	1	2	104	0	109
9625	0	0	1	117	0	118
9626	2	1	1	109	0	113
9627	2	112	1	4	0	119
9628	2	4	1	113	0	120
9629	0	1	2	119	0	122
9630	2	0	1	118	0	121
9631	2	0	0	114	0	116
9632	3	0	0	116	0	119
9633	0	3	0	116	0	119
9634	111	0	0	9	0	120
9635	4	0	103	3	0	110
9636	0	102	6	2	0	110
9637	96	4	0	5	0	105
9638	4	99	1	4	0	108
9639	100	4	1	4	0	109
9640	6	0	0	102	0	108
9641	99	1	2	7	0	109
9642	4	3	1	100	0	108
9643	3	0	0	101	0	104
9644	2	101	0	5	0	108
9645	103	4	0	2	0	109
9646	4	1	111	4	0	120
9647	3	0	4	110	0	117
9648	1	0	109	9	0	119
9649	1	1	105	4	0	111
9650	109	3	3	2	0	117
9651	5	0	0	114	0	119
9652	0	1	109	5	0	115
9653	1	1	120	4	0	126
9654	3	0	4	117	0	124
9655	1	1	3	121	0	126
9656	118	1	0	5	0	124
9657	3	0	0	128	0	131
9658	2	0	128	4	0	134
9659	2	1	3	128	0	134
9660	2	0	0	140	0	142
9661	1	143	2	5	0	151
9662	138	3	0	3	0	144
9663	4	137	0	6	0	147
9664	121	2	3	1	0	127
9665	2	114	0	1	0	117
9666	0	104	0	0	0	104
9667	0	1	0	106	0	107
9668	1	0	0	105	0	106
9669	0	3	0	102	0	105
9670	101	0	0	0	0	101
9671	0	0	98	0	0	98
9672	0	0	0	98	0	98
9673	96	0	0	2	0	98
9674	0	96	0	0	0	96
9675	0	97	0	0	0	97
9676	0	0	0	97	0	97
9677	1	0	0	99	0	100
9678	1	0	0	113	0	114
9679	0	118	0	0	0	118
9680	0	0	0	118	0	118
9681	0	0	117	0	0	117
9682	0	0	112	0	0	112
9683	107	0	0	3	0	110
9684	0	0	0	119	0	119
9685	121	0	0	0	0	121
9686	122	0	0	0	0	122
9687	0	121	0	0	0	121
9688	122	0	0	0	0	122
9689	129	0	0	1	0	130
9690	0	0	0	130	0	130
9691	1	0	0	127	0	128
9692	0	0	133	0	0	133
9693	0	147	0	0	0	147
9694	0	0	0	137	0	137
9695	0	0	0	141	0	141
9696	144	0	0	0	0	144
9697	0	0	0	144	0	144
9698	148	0	0	0	0	148
9699	0	0	0	150	0	150
9700	0	152	0	0	0	152
9701	153	0	0	0	0	153
9702	0	0	0	177	0	177
9703	0	0	0	186	0	186
9704	0	0	0	196	0	196
9705	0	0	191	0	0	191
9706	0	0	0	188	0	188
9707	192	0	0	0	0	192
9708	0	0	0	203	0	203
9709	0	0	0	205	0	205
9710	0	0	0	205	0	205
9711	0	206	0	1	0	207
9712	0	216	0	0	0	216
9713	208	2	0	5	0	215
9714	1	211	0	1	0	213
9715	215	2	0	3	0	220
9716	208	0	1	1	0	210
9717	216	0	0	2	0	218
9718	3	0	213	0	0	216
9719	0	222	2	1	0	225
9720	225	2	0	1	0	228
9721	4	0	0	230	0	234
9722	0	1	0	226	0	227
9723	1	2	0	228	0	231
9724	1	224	0	3	0	228
9725	1	4	0	224	0	229
9726	222	1	0	3	0	226
9727	2	0	0	222	0	224
9728	0	1	1	227	0	229
9729	1	0	223	3	0	227
9730	2	1	225	0	0	228
9731	2	0	2	230	0	234
9732	1	0	1	230	0	232
9733	1	239	1	3	0	244
9734	1	3	0	239	0	243
9735	2	2	0	241	0	245
9736	4	0	0	244	0	248
9737	239	1	0	6	0	246
9738	3	1	251	3	0	258
9739	2	0	2	251	0	255
9740	249	0	2	4	0	255
9741	251	0	2	2	0	255
9742	3	2	0	252	0	257
9743	2	0	1	253	0	256
9744	245	1	1	7	0	254
9745	3	241	0	4	0	248
9746	0	245	1	3	0	249
9747	1	3	0	246	0	250
9748	246	0	0	6	0	252
9749	249	1	1	4	0	255
9750	242	0	0	5	0	247
9751	5	1	243	2	0	251
9752	228	0	4	1	0	233
9753	2	1	238	4	0	245
9754	236	2	2	3	0	243
9755	6	250	0	2	0	258
9756	2	4	249	4	0	259
9757	1	1	4	248	0	254
9758	1	2	251	4	0	258
9759	1	4	2	248	0	255
9760	246	1	0	5	0	252
9761	4	2	240	3	0	249
9762	3	0	3	247	0	253
9763	3	251	1	6	0	261
9764	3	3	2	262	0	270
9765	2	0	4	260	0	266
9766	3	2	1	249	0	255
9767	259	0	2	5	0	266
9768	253	2	1	4	0	260
9769	2	2	3	255	0	262
9770	0	0	245	9	0	254
9771	2	1	245	5	0	253
9772	3	2	4	260	0	269
9773	3	1	271	6	0	281
9774	1	3	3	277	0	284
9775	3	0	1	267	0	271
9776	4	0	2	276	0	282
9777	5	267	2	4	0	278
9778	3	253	1	4	0	261
9779	4	3	2	275	0	284
9780	4	2	0	273	0	279
9781	3	2	3	270	0	278
9782	269	1	1	9	0	280
9783	6	0	274	6	0	286
9784	4	3	6	269	0	282
9785	274	2	1	8	0	285
9786	4	267	2	4	0	277
9787	5	2	1	284	0	292
9788	5	1	2	285	0	293
9789	3	2	2	278	0	285
9790	2	1	2	273	0	278
9791	2	1	269	4	0	276
9792	247	1	3	8	0	259
9793	261	2	2	5	0	270
9794	3	1	267	6	0	277
9795	266	1	3	6	0	276
9796	274	0	3	4	0	281
9797	4	1	278	5	0	288
9798	0	289	5	6	0	300
9799	3	2	2	297	0	304
9800	2	0	305	7	0	314
9801	2	295	4	3	0	304
9802	1	3	289	1	0	294
9803	0	276	2	2	0	280
9804	2	1	1	269	0	273
9805	0	0	267	4	0	271
9806	2	0	1	259	0	262
9807	2	0	277	2	0	281
9808	1	278	2	1	0	282
9809	259	1	0	2	0	262
9810	1	258	1	0	0	260
9811	0	277	1	0	0	278
9812	0	0	0	269	0	269
9813	1	0	1	278	0	280
9814	1	0	0	277	0	278
9815	0	0	0	263	0	263
9816	1	0	0	270	0	271
9817	0	0	319	0	0	319
9818	1	0	0	310	0	311
9819	2	0	0	326	0	328
9820	325	0	0	4	0	329
9821	326	0	0	3	0	329
9822	337	0	0	5	0	342
9823	1	0	0	343	0	344
9824	359	0	0	4	0	363
9825	405	0	0	3	0	408
9826	409	0	0	0	0	409
9827	1	0	408	0	0	409
9828	401	0	0	3	0	404
9829	408	0	3	6	0	417
9830	417	0	0	1	0	418
9831	5	0	1	413	0	419
9832	4	1	410	2	0	417
9833	5	0	2	397	0	404
9834	426	0	2	5	0	433
9835	3	0	0	446	0	449
9836	3	469	1	2	0	475
9837	1	2	0	490	0	493
9838	486	3	0	3	0	492
9839	489	0	1	5	0	495
9840	485	1	0	3	0	489
9841	5	0	492	1	0	498
9842	4	0	2	483	0	489
9843	3	0	4	500	0	507
9844	2	0	508	5	0	515
9845	0	490	3	5	0	498
9846	1	2	506	1	0	510
9847	3	4	1	500	0	508
9848	503	0	4	3	0	510
9849	1	1	511	10	0	523
9850	6	0	2	519	0	527
9851	1	1	531	4	0	537
9852	514	0	5	4	0	523
9853	5	0	5	519	0	529
9854	4	0	542	4	0	550
9855	2	0	4	532	0	538
9856	3	0	549	3	0	555
9857	1	546	3	6	0	556
9858	4	3	4	561	0	572
9859	569	2	1	6	0	578
9860	7	0	1	567	0	575
9861	6	1	0	555	0	562
9862	550	1	0	8	0	559
9863	3	542	0	6	0	551
9864	4	558	1	1	0	564
9865	4	6	0	561	0	571
9866	4	554	0	3	0	561
9867	2	3	2	556	0	563
9868	2	5	0	556	0	563
9869	558	0	1	10	0	569
9870	5	564	1	2	0	572
9871	5	4	555	2	0	566
9872	2	566	7	0	0	575
9873	563	4	3	5	0	575
9874	575	4	0	2	0	581
9875	8	1	2	563	0	574
9876	575	2	1	8	0	586
9877	6	1	1	579	0	587
9878	568	0	1	8	0	577
9879	564	0	0	10	0	574
9880	12	0	1	599	0	612
9881	587	1	2	8	0	598
9882	6	1	591	5	0	603
9883	575	1	6	1	0	583
9884	9	1	4	583	0	597
9885	593	1	1	8	0	603
9886	6	605	3	5	0	619
9887	7	5	0	597	0	609
9888	6	4	1	600	0	611
9889	594	2	3	10	0	609
9890	7	2	596	4	0	609
9891	8	591	6	3	0	608
9892	6	5	4	590	0	605
9893	4	599	1	11	0	615
9894	4	5	2	617	0	628
9895	4	5	0	597	0	606
9896	4	2	2	609	0	617
9897	597	1	1	11	0	610
9898	6	3	0	585	0	594
9899	591	0	2	10	0	603
9900	576	1	0	9	0	586
9901	12	1	0	581	0	594
9902	571	1	1	11	0	584
9903	570	2	2	6	0	580
9904	12	3	560	2	0	577
9905	7	0	6	551	0	564
9906	569	1	5	9	0	584
9907	8	580	1	7	0	596
9908	578	5	5	5	0	593
9909	576	4	3	6	0	589
9910	13	2	571	2	0	588
9911	7	3	8	533	0	551
9912	605	2	4	11	0	622
9913	8	0	2	616	0	626
9914	7	0	5	611	0	623
9915	6	2	1	625	0	634
9916	6	0	3	661	0	670
9917	631	0	0	22	0	653
9918	18	1	649	8	0	676
9919	9	2	20	651	0	682
9920	3	1	724	26	0	754
9921	7	2	758	8	0	775
9922	736	2	40	7	0	785
9923	31	1	793	7	0	832
9924	14	760	30	3	0	807
9925	746	29	16	8	0	799
9926	782	11	5	2	0	800
9927	42	3	1	750	0	796
9928	15	2	756	26	0	799
9929	4	3	767	11	0	785
9930	768	1	38	7	0	814
9931	31	0	16	773	0	820
9932	778	3	5	32	0	818
9933	32	792	4	12	0	840
9934	782	29	5	7	0	823
9935	779	12	3	10	0	804
9936	43	759	2	2	0	806
9937	20	27	4	757	0	808
9938	749	12	4	34	0	799
9939	30	5	750	13	0	798
9940	21	746	34	3	0	804
9941	14	31	15	746	0	806
9942	743	12	6	34	0	795
9943	29	761	4	14	0	808
9944	780	33	3	5	0	821
9945	43	14	757	3	0	817
9946	757	7	35	7	0	806
9947	37	4	778	5	0	824
9948	779	3	38	7	0	827
9949	792	1	15	6	0	814
9950	49	3	770	5	0	827
9951	18	753	36	6	0	813
9952	16	33	16	746	0	811
9953	9	14	757	32	0	812
9954	12	757	32	13	0	814
9955	11	33	16	754	0	814
9956	14	17	11	773	0	815
9957	8	8	746	46	0	808
9958	19	1	36	728	0	784
9959	6	7	19	769	0	801
9960	4	5	753	49	0	811
9961	12	3	37	721	0	773
9962	6	754	23	33	0	816
9963	762	35	9	26	0	832
9964	41	14	9	751	0	815
9965	20	758	11	33	0	822
9966	15	37	5	715	0	772
9967	11	781	12	31	0	835
9968	8	39	775	14	0	836
9969	10	778	32	16	0	836
9970	767	43	23	6	0	839
9971	783	17	10	10	0	820
9972	794	13	4	12	0	823
9973	52	6	780	8	0	846
9974	26	9	781	9	0	825
9975	15	797	45	9	0	866
9976	14	32	28	751	0	825
9977	13	809	8	33	0	863
9978	16	41	10	726	0	793
9979	10	813	9	35	0	867
9980	789	41	8	18	0	856
9981	857	20	10	19	0	906
9982	68	15	6	858	0	947
9983	27	12	867	44	0	950
9984	847	5	41	29	0	922
9985	45	885	21	11	0	962
9986	25	44	15	864	0	948
9987	21	19	4	858	0	902
9988	13	885	10	47	0	955
9989	872	43	11	31	0	957
9990	52	27	866	11	0	956
9991	32	13	49	865	0	959
9992	880	8	23	49	0	960
9993	883	12	20	20	0	935
9994	61	863	7	21	0	952
9995	41	42	9	835	0	927
9996	19	887	11	41	0	958
9997	886	46	13	31	0	976
9998	47	24	890	14	0	975
9999	30	19	882	12	0	943
10000	32	6	57	868	0	963
10001	16	11	26	887	0	940
10002	10	883	22	52	0	967
10003	19	39	10	898	0	966
10004	14	29	879	51	0	973
10005	858	17	36	34	0	945
10006	41	9	19	895	0	964
10007	23	13	877	41	0	954
10008	21	11	36	884	0	952
10009	12	7	24	875	0	918
10010	5	858	22	55	0	940
10011	14	45	3	888	0	950
10012	23	19	8	869	0	919
10013	17	21	14	875	0	927
10014	814	10	3	73	0	900
10015	41	790	16	24	0	871
10016	25	806	7	17	0	855
10017	755	40	5	10	0	810
10018	724	17	13	13	0	767
10019	35	707	3	10	0	755
10020	20	645	3	6	0	674
10021	574	19	7	6	0	606
10022	15	574	2	6	0	597
10023	5	582	6	7	0	600
10024	558	16	8	8	0	590
10025	13	563	2	5	0	583
10026	559	18	3	6	0	586
10027	563	4	5	6	0	578
10028	562	8	0	5	0	575
10029	22	550	1	7	0	580
10030	8	550	3	5	0	566
10031	10	17	1	537	0	565
10032	2	536	2	15	0	555
10033	5	23	1	550	0	579
10034	568	3	0	24	0	595
10035	20	9	3	541	0	573
10036	3	552	4	22	0	581
10037	550	14	2	6	0	572
10038	16	550	0	9	0	575
10039	3	560	0	4	0	567
10040	7	17	0	525	0	549
10041	1	554	1	12	0	568
10042	544	20	2	3	0	569
10043	18	4	523	5	0	550
10044	2	539	13	5	0	559
10045	12	14	1	526	0	553
10046	6	1	529	11	0	547
10047	7	11	12	499	0	529
10048	4	5	2	524	0	535
10049	6	4	5	517	0	532
10050	5	6	0	519	0	530
10051	5	4	496	18	0	523
10052	4	497	14	11	0	526
10053	490	17	3	8	0	518
10054	16	2	490	6	0	514
10055	473	10	14	3	0	500
10056	18	3	486	5	0	512
10057	7	4	18	495	0	524
10058	9	2	490	15	0	516
10059	3	6	510	7	0	526
10060	5	2	15	502	0	524
10061	7	3	9	470	0	489
10062	8	5	7	505	0	525
10063	7	6	2	504	0	519
10064	497	5	2	18	0	522
10065	13	5	507	9	0	534
10066	504	4	11	11	0	530
10067	523	4	4	5	0	536
10068	512	3	5	7	0	527
10069	518	3	3	5	0	529
10070	518	2	4	7	0	531
10071	22	3	1	501	0	527
10072	7	4	471	16	0	498
10073	6	6	448	4	0	464
10074	4	459	12	11	0	486
10075	432	11	8	4	0	455
10076	11	3	3	423	0	440
10077	9	10	0	414	0	433
10078	5	417	0	12	0	434
10079	5	418	0	5	0	428
10080	5	412	1	4	0	422
10081	363	9	3	5	0	380
10082	8	5	1	323	0	337
10083	1	331	1	6	0	339
10084	3	8	0	338	0	349
10085	1	0	330	9	0	340
10086	0	2	340	2	0	344
10087	0	2	6	352	0	360
10088	356	1	2	7	0	366
10089	377	2	0	4	0	383
10090	382	1	0	3	0	386
10091	10	0	380	2	0	392
10092	4	3	7	376	0	390
10093	4	1	2	395	0	402
10094	3	1	373	8	0	385
10095	340	2	7	5	0	354
10096	9	0	367	5	0	381
10097	4	1	368	2	0	375
10098	5	2	381	3	0	391
10099	1	0	11	378	0	390
10100	1	3	7	382	0	393
10101	4	1	386	11	0	402
10102	2	2	10	399	0	413
10103	395	1	5	13	0	414
10104	8	1	5	413	0	427
10105	3	3	421	13	0	440
10106	4	2	434	3	0	443
10107	4	1	13	423	0	441
10108	431	2	6	12	0	451
10109	9	464	5	10	0	488
10110	478	8	5	11	0	502
10111	485	4	1	8	0	498
10112	15	4	495	5	0	519
10113	10	0	14	498	0	522
10114	506	2	7	17	0	532
10115	500	2	9	5	0	516
10116	20	499	3	8	0	530
10117	13	12	5	487	0	517
10118	8	4	5	512	0	529
10119	6	10	489	17	0	522
10120	9	0	15	497	0	521
10121	4	2	495	20	0	521
10122	6	1	488	5	0	500
10123	6	0	18	470	0	494
10124	464	0	12	15	0	491
10125	14	459	7	11	0	491
10126	457	12	5	12	0	486
10127	463	3	5	5	0	476
10128	14	464	5	6	0	489
10129	12	10	3	439	0	464
10130	449	9	2	15	0	475
10131	20	448	2	5	0	475
10132	453	11	1	11	0	476
10133	21	437	1	1	0	460
10134	3	17	2	419	0	441
10135	10	3	2	438	0	453
10136	438	7	2	13	0	460
10137	432	4	2	9	0	447
10138	13	440	3	7	0	463
10139	10	6	432	7	0	455
10140	6	4	440	7	0	457
10141	6	7	13	404	0	430
10142	7	429	10	10	0	456
10143	8	12	8	438	0	466
10144	4	6	4	444	0	458
10145	4	6	7	435	0	452
10146	5	3	436	16	0	460
10147	4	6	445	10	0	465
10148	6	462	11	9	0	488
10149	5	10	10	466	0	491
10150	5	6	5	492	0	508
10151	4	6	475	16	0	501
10152	428	3	15	10	0	456
10153	10	4	5	487	0	506
10154	7	5	483	12	0	507
10155	448	2	9	15	0	474
10156	11	463	9	11	0	494
10157	8	8	482	3	0	501
10158	12	3	9	468	0	492
10159	470	7	9	13	0	499
10160	10	5	479	8	0	502
10161	9	5	11	487	0	512
10162	8	1	9	497	0	515
10163	6	2	9	530	0	547
10164	526	2	3	24	0	555
10165	9	505	8	15	0	537
10166	6	10	6	524	0	546
10167	5	6	524	18	0	553
10168	3	7	15	516	0	541
10169	5	492	7	20	0	524
10170	3	527	9	10	0	549
10171	515	12	2	13	0	542
10172	525	7	9	7	0	548
10173	16	6	515	5	0	542
10174	503	4	12	8	0	527
10175	16	501	6	8	0	531
10176	521	13	6	5	0	545
10177	22	11	2	511	0	546
10178	9	7	527	16	0	559
10179	11	3	15	521	0	550
10180	5	4	519	22	0	550
10181	509	5	15	11	0	540
10182	19	4	5	533	0	561
10183	9	523	11	13	0	556
10184	9	15	2	536	0	562
10185	4	4	530	24	0	562
10186	7	518	10	10	0	545
10187	511	16	4	12	0	543
10188	18	487	9	1	0	515
10189	3	492	4	4	0	503
10190	4	14	7	479	0	504
10191	2	483	0	12	0	497
10192	8	16	2	485	0	511
10193	7	5	480	15	0	507
10194	457	6	11	7	0	481
10195	479	2	4	7	0	492
10196	12	4	482	5	0	503
10197	458	3	15	4	0	480
10198	17	444	6	4	0	471
10199	450	12	1	3	0	466
10200	14	7	2	437	0	460
10201	2	4	458	14	0	478
10202	4	457	13	5	0	479
10203	5	21	1	450	0	477
10204	3	3	3	467	0	476
10205	444	3	1	19	0	467
10206	438	0	2	7	0	447
10207	11	425	2	4	0	442
10208	4	412	3	4	0	423
10209	1	404	0	1	0	406
10210	2	6	0	390	0	398
10211	389	0	0	8	0	397
10212	373	0	1	2	0	376
10213	6	1	2	368	0	377
10214	3	0	0	374	0	377
10215	365	2	0	7	0	374
10216	8	0	0	368	0	376
10217	0	0	368	8	0	376
10218	364	1	7	1	0	373
10219	377	2	0	3	0	382
10220	5	2	374	1	0	382
10221	382	0	5	5	0	392
10222	9	1	0	407	0	417
10223	2	4	0	408	0	414
10224	1	1	1	411	0	414
10225	404	1	3	9	0	417
10226	5	415	1	3	0	424
10227	1	7	0	417	0	425
10228	2	406	3	7	0	418
10229	415	5	0	5	0	425
10230	8	2	2	413	0	425
10231	3	3	0	412	0	418
10232	7	410	0	4	0	421
10233	3	7	398	2	0	410
10234	5	0	8	404	0	417
10235	411	0	1	11	0	423
10236	423	2	3	4	0	432
10237	12	2	439	2	0	455
10238	4	1	8	454	0	467
10239	5	476	4	12	0	497
10240	2	10	1	481	0	494
10241	477	3	4	17	0	501
10242	486	1	1	7	0	495
10243	15	3	3	483	0	504
10244	4	468	1	15	0	488
10245	524	11	0	6	0	541
10246	16	5	2	511	0	534
10247	495	6	0	16	0	517
10248	527	3	2	4	0	536
10249	16	5	0	518	0	539
10250	5	2	2	535	0	544
10251	8	1	2	525	0	536
10252	7	524	2	17	0	550
10253	7	14	0	533	0	554
10254	4	6	5	537	0	552
10255	7	4	516	19	0	546
10256	7	4	517	6	0	534
10257	7	1	18	508	0	534
10258	503	0	5	21	0	529
10259	17	505	5	5	0	532
10260	504	17	2	6	0	529
10261	18	4	504	11	0	537
10262	7	4	482	7	0	500
10263	6	483	16	2	0	507
10264	7	13	9	486	0	515
10265	4	4	495	17	0	520
10266	3	3	519	7	0	532
10267	1	3	15	500	0	519
10268	496	1	5	20	0	522
10269	498	2	5	7	0	512
10270	17	4	4	494	0	519
10271	10	2	543	14	0	569
10272	9	0	14	555	0	578
10273	8	1	7	549	0	565
10274	4	560	5	9	0	578
10275	559	12	3	10	0	584
10276	563	5	5	5	0	578
10277	15	575	5	2	0	597
10278	8	13	2	554	0	577
10279	6	568	2	14	0	590
10280	575	13	3	7	0	598
10281	11	5	558	10	0	584
10282	6	7	534	3	0	550
10283	8	2	535	5	0	550
10284	6	1	16	538	0	561
10285	4	4	11	533	0	552
10286	536	0	1	19	0	556
10287	11	3	3	536	0	553
10288	3	3	2	559	0	567
10289	4	3	584	18	0	609
10290	6	4	564	8	0	582
10291	553	2	19	7	0	581
10292	12	575	8	6	0	601
10293	586	13	5	4	0	608
10294	18	7	3	592	0	620
10295	11	4	2	592	0	609
10296	5	594	5	17	0	621
10297	4	12	6	604	0	626
10298	596	6	2	16	0	620
10299	15	2	3	606	0	626
10300	4	4	613	14	0	635
10301	7	581	14	7	0	609
10302	582	10	3	12	0	607
10303	597	5	5	9	0	616
10304	597	4	4	2	0	607
10305	598	1	2	8	0	609
10306	20	2	4	583	0	609
10307	10	3	1	607	0	621
10308	4	1	608	20	0	633
10309	5	4	14	596	0	619
10310	6	2	598	19	0	625
10311	4	1	15	602	0	622
10312	596	4	5	15	0	620
10313	14	609	6	12	0	641
10314	10	13	2	627	0	652
10315	8	3	3	636	0	650
10316	632	3	5	17	0	657
10317	613	5	3	14	0	635
10318	18	2	614	9	0	643
10319	11	606	15	6	0	638
10320	7	13	5	597	0	622
10321	7	4	4	599	0	614
10322	590	4	3	23	0	620
10323	587	2	5	12	0	606
10324	17	4	588	8	0	617
10325	8	0	582	10	0	600
10326	7	2	17	568	0	594
10327	5	6	9	576	0	596
10328	7	3	567	17	0	594
10329	538	1	15	14	0	568
10330	19	1	6	564	0	590
10331	554	5	3	22	0	584
10332	15	547	4	13	0	579
10333	570	13	5	10	0	598
10334	18	4	619	7	0	648
10335	6	591	15	6	0	618
10336	6	582	9	1	0	598
10337	542	7	13	6	0	568
10338	514	3	2	5	0	524
10339	9	2	3	516	0	530
10340	5	514	2	7	0	528
10341	5	509	2	4	0	520
10342	5	9	2	508	0	524
10343	513	4	2	8	0	527
10344	508	3	3	6	0	520
10345	11	2	488	2	0	503
10346	463	0	8	4	0	475
10347	12	503	1	0	0	516
10348	509	8	0	2	0	519
10349	10	631	0	1	0	642
10350	1	688	0	1	0	690
10351	4	28	1	756	0	789
10352	800	2	2	34	0	838
10353	822	6	0	5	0	833
10354	35	3	786	4	0	828
10355	15	1	30	791	0	837
10356	811	0	4	27	0	842
10357	32	0	5	798	0	835
10358	810	1	7	39	0	857
10359	842	2	2	8	0	854
10360	38	1	800	7	0	846
10361	13	1	31	788	0	833
10362	10	1	4	836	0	851
10363	14	0	5	828	0	847
10364	6	1	780	42	0	829
10365	11	0	34	761	0	806
10366	11	0	7	762	0	780
10367	1	753	7	39	0	800
10368	4	29	747	14	0	794
10369	4	766	30	9	0	809
10370	757	34	6	7	0	804
10371	37	5	7	714	0	763
10372	8	6	3	701	0	718
10373	6	711	3	41	0	761
10374	709	32	3	11	0	755
10375	731	6	4	10	0	751
10376	100	643	2	9	0	754
10377	17	735	2	5	0	759
10378	722	36	2	9	0	769
10379	35	11	703	6	0	755
10380	8	13	697	2	0	720
10381	701	8	31	4	0	744
10382	36	717	9	4	0	766
10383	719	34	7	4	0	764
10384	36	10	710	4	0	760
10385	723	7	30	5	0	765
10386	37	734	10	3	0	784
10387	15	32	7	742	0	796
10388	16	9	4	759	0	788
10389	13	11	3	702	0	729
10390	9	3	1	732	0	745
10391	6	2	5	735	0	748
10392	7	704	4	38	0	753
10393	710	33	2	15	0	760
10394	35	10	693	10	0	748
10395	13	6	30	707	0	756
10396	10	7	708	36	0	761
10397	11	2	35	705	0	753
10398	7	3	7	743	0	760
10399	711	5	7	41	0	764
10400	35	2	707	16	0	760
10401	5	697	35	15	0	752
10402	9	34	7	710	0	760
10403	13	7	8	743	0	771
10404	5	8	727	39	0	779
10405	9	4	33	715	0	761
10406	10	4	7	759	0	780
10407	694	3	10	45	0	752
10408	30	709	7	17	0	763
10409	714	30	2	17	0	763
10410	732	6	3	12	0	753
10411	39	9	5	702	0	755
10412	13	5	704	34	0	756
10413	10	2	709	15	0	736
10414	10	3	39	684	0	736
10415	7	6	11	681	0	705
10416	7	692	10	34	0	743
10417	687	32	4	22	0	745
10418	33	667	7	17	0	724
10419	12	717	6	10	0	745
10420	707	36	6	7	0	756
10421	39	11	2	680	0	732
10422	10	712	7	38	0	767
10423	8	35	3	721	0	767
10424	9	8	707	45	0	769
10425	7	10	725	14	0	756
10426	8	8	38	707	0	761
10427	10	6	714	36	0	766
10428	14	1	38	711	0	764
10429	5	10	7	730	0	752
10430	12	3	10	745	0	770
10431	688	4	12	45	0	749
10432	31	690	10	19	0	750
10433	10	715	3	17	0	745
10434	658	33	7	13	0	711
10435	677	13	4	9	0	703
10436	40	9	2	663	0	714
10437	12	5	669	37	0	723
10438	15	6	28	669	0	718
10439	3	9	659	37	0	708
10440	8	662	30	13	0	713
10441	12	28	9	666	0	715
10442	667	9	7	33	0	716
10443	43	8	3	665	0	719
10444	9	8	646	30	0	693
10445	617	5	26	13	0	661
10446	30	4	642	8	0	684
10447	17	3	638	7	0	665
10448	9	603	28	6	0	646
10449	4	462	9	7	0	482
10450	2	452	4	6	0	464
10451	309	5	22	12	0	348
10452	291	1	0	1	0	293
10453	0	0	0	301	0	301
10454	0	1	0	305	0	306
10455	2	0	0	310	0	312
10456	0	308	2	0	0	310
10457	305	0	0	3	0	308
10458	0	301	0	0	0	301
10459	0	0	0	312	0	312
10460	297	0	0	3	0	300
10461	1	0	0	296	0	297
10462	0	0	1	296	0	297
10463	296	1	0	2	0	299
10464	288	0	0	2	0	290
10465	0	0	292	1	0	293
10466	0	1	290	0	0	291
10467	0	0	300	1	0	301
10468	1	0	0	306	0	307
10469	1	0	0	303	0	304
10470	0	305	1	0	0	306
10471	315	0	0	3	0	318
10472	2	0	0	316	0	318
10473	1	0	0	316	0	317
10474	0	321	2	1	0	324
10475	0	345	1	0	0	346
10476	2	2	0	363	0	367
10477	0	1	0	406	0	407
10478	397	0	0	7	0	404
10479	393	0	0	8	0	401
10480	7	0	0	401	0	408
10481	4	0	411	2	0	417
10482	0	0	392	5	0	397
10483	2	0	7	396	0	405
10484	1	0	3	391	0	395
10485	0	397	1	7	0	405
10486	386	3	1	7	0	397
10487	5	4	2	387	0	398
10488	4	1	397	4	0	406
10489	0	0	3	396	0	399
10490	1	2	394	3	0	400
10491	1	2	391	5	0	399
10492	1	1	8	393	0	403
10493	403	0	5	7	0	415
10494	3	0	403	5	0	411
10495	5	0	5	394	0	404
10496	0	1	432	3	0	436
10497	1	1	4	432	0	438
10498	1	1	4	427	0	433
10499	2	0	432	6	0	440
10500	3	2	408	6	0	419
10501	3	0	9	385	0	397
10502	0	0	5	410	0	415
10503	0	0	2	421	0	423
10504	1	2	0	407	0	410
10505	398	0	2	10	0	410
10506	399	2	1	6	0	408
10507	8	400	0	4	0	412
10508	398	2	1	8	0	409
10509	4	4	2	403	0	413
10510	404	0	0	13	0	417
10511	6	1	400	3	0	410
10512	396	1	3	3	0	403
10513	4	1	6	406	0	417
10514	6	1	3	420	0	430
10515	409	0	2	7	0	418
10516	6	0	0	454	0	460
10517	4	1	454	8	0	467
10518	460	0	4	10	0	474
10519	7	481	4	4	0	496
10520	6	7	2	518	0	533
10521	3	4	561	10	0	578
10522	3	3	9	557	0	572
10523	1	1	560	9	0	571
10524	4	1	8	550	0	563
10525	2	554	7	9	0	572
10526	3	7	4	587	0	601
10527	4	605	1	10	0	620
10528	6	6	3	594	0	609
10529	5	6	0	613	0	624
10530	5	1	1	623	0	630
10531	3	2	3	624	0	632
10532	3	2	3	613	0	621
10533	3	1	599	19	0	622
10534	9	1	6	601	0	617
10535	3	0	9	606	0	618
10536	586	0	3	19	0	608
10537	8	585	3	12	0	608
10538	590	8	5	8	0	611
10539	14	8	2	591	0	615
10540	8	4	590	14	0	616
10541	2	600	10	10	0	622
10542	589	10	8	7	0	614
10543	10	588	4	5	0	607
10544	6	601	4	7	0	618
10545	585	15	2	8	0	610
10546	10	9	1	623	0	643
10547	625	3	2	16	0	646
10548	13	2	4	615	0	634
10549	8	2	632	17	0	659
10550	8	3	612	10	0	633
10551	606	2	16	7	0	631
10552	618	2	9	9	0	638
10553	14	0	6	607	0	627
10554	12	0	5	614	0	631
10555	591	3	4	21	0	619
10556	14	597	1	12	0	624
10557	8	615	2	10	0	635
10558	607	16	3	12	0	638
10559	615	12	0	6	0	633
10560	16	620	3	10	0	649
10561	13	12	3	629	0	657
10562	7	14	620	9	0	650
10563	5	3	616	15	0	639
10564	600	2	19	10	0	631
10565	14	2	625	5	0	646
10566	16	2	15	612	0	645
10567	7	0	14	608	0	629
10568	5	620	7	17	0	649
10569	619	11	3	12	0	645
10570	18	9	2	615	0	644
10571	8	6	609	17	0	640
10572	10	597	8	15	0	630
10573	9	11	5	598	0	623
10574	4	12	597	15	0	628
10575	2	6	575	14	0	597
10576	6	575	17	6	0	604
10577	516	7	6	6	0	535
10578	7	540	4	6	0	557
10579	535	8	5	5	0	553
10580	10	4	532	5	0	551
10581	517	4	9	7	0	537
10582	12	526	5	8	0	551
10583	8	7	5	531	0	551
10584	6	3	4	554	0	567
10585	546	6	3	12	0	567
10586	8	7	544	7	0	566
10587	538	4	7	8	0	557
10588	541	1	7	5	0	554
10589	10	3	525	3	0	541
10590	5	6	520	5	0	536
10591	11	2	9	525	0	547
10592	525	2	10	15	0	552
10593	517	3	8	5	0	533
10594	10	537	8	5	0	560
10595	13	8	1	545	0	567
10596	9	6	3	514	0	532
10597	6	7	3	523	0	539
10598	6	1	2	533	0	542
10599	523	2	2	13	0	540
10600	9	3	3	539	0	554
10601	6	6	530	13	0	555
10602	10	1	524	8	0	543
10603	505	2	13	5	0	525
10604	11	510	11	3	0	535
10605	8	532	7	2	0	549
10606	14	10	7	517	0	548
10607	7	9	5	525	0	546
10608	8	7	3	510	0	528
10609	6	2	4	527	0	539
10610	8	1	506	18	0	533
10611	10	3	7	504	0	524
10612	3	3	2	521	0	529
10613	5	1	508	17	0	531
10614	459	1	10	17	0	487
10615	10	489	7	11	0	517
10616	449	3	5	10	0	467
10617	12	3	449	4	0	468
10618	6	4	414	2	0	426
10619	4	409	8	3	0	424
10620	332	16	30	7	0	385
10621	308	5	4	1	0	318
10622	309	4	0	5	0	318
10623	5	312	0	4	0	321
10624	299	3	2	5	0	309
10625	7	1	311	6	0	325
10626	2	270	4	4	0	280
10627	273	3	4	6	0	286
10628	5	284	4	5	0	298
10629	283	4	2	2	0	291
10630	271	2	2	3	0	278
10631	6	3	285	2	0	296
10632	3	289	5	1	0	298
10633	288	4	2	1	0	295
10634	4	3	287	1	0	295
10635	4	287	6	0	0	297
10636	5	4	3	282	0	294
10637	4	7	282	1	0	294
10638	4	4	270	1	0	279
10639	3	3	3	283	0	292
10640	274	3	4	5	0	286
10641	4	270	5	1	0	280
10642	1	5	281	2	0	289
10643	5	4	278	1	0	288
10644	266	2	3	4	0	275
10645	2	299	4	0	0	305
10646	260	1	3	2	0	266
10647	3	264	3	0	0	270
10648	262	3	0	3	0	268
10649	248	1	0	0	0	249
10650	2	247	3	0	0	252
10651	2	3	1	249	0	255
10652	265	0	0	2	0	267
10653	2	3	1	278	0	284
10654	0	1	1	287	0	289
10655	286	0	1	4	0	291
10656	3	282	0	2	0	287
10657	282	3	0	7	0	292
10658	3	0	284	2	0	289
10659	2	1	4	283	0	290
10660	3	1	0	278	0	282
10661	276	1	1	5	0	283
10662	280	0	3	2	0	285
10663	3	1	0	279	0	283
10664	2	2	281	4	0	289
10665	5	0	3	275	0	283
10666	2	0	1	282	0	285
10667	1	0	2	278	0	281
10668	1	2	1	281	0	285
10669	277	0	0	8	0	285
10670	5	1	275	2	0	283
10671	2	278	3	3	0	286
10672	3	2	0	277	0	282
10673	2	1	1	286	0	290
10674	2	1	282	4	0	289
10675	1	2	280	2	0	285
10676	1	1	4	299	0	305
10677	2	2	1	300	0	305
10678	3	0	297	4	0	304
10679	2	0	9	290	0	301
10680	290	1	2	12	0	305
10681	8	290	2	3	0	303
10682	0	8	289	3	0	300
10683	1	282	10	4	0	297
10684	3	10	1	278	0	292
10685	2	3	282	9	0	296
10686	1	283	9	1	0	294
10687	2	7	3	281	0	293
10688	0	0	288	10	0	298
10689	2	2	7	277	0	288
10690	4	2	2	278	0	286
10691	280	2	4	8	0	294
10692	8	1	1	284	0	294
10693	277	1	1	10	0	289
10694	277	2	1	1	0	281
10695	278	1	2	5	0	286
10696	9	1	1	266	0	277
10697	4	1	262	11	0	278
10698	6	0	248	3	0	257
10699	254	1	9	5	0	269
10700	9	1	253	3	0	266
10701	249	3	14	1	0	267
10702	12	252	0	3	0	267
10703	252	9	4	6	0	271
10704	9	2	261	4	0	276
10705	1	2	269	3	0	275
10706	4	1	9	261	0	275
10707	2	1	271	11	0	285
10708	0	1	293	4	0	298
10709	3	0	11	306	0	320
10710	2	2	2	316	0	322
10711	4	0	3	316	0	323
10712	1	312	3	13	0	329
10713	2	11	2	306	0	321
10714	2	314	1	16	0	333
10715	313	12	1	3	0	329
10716	323	1	2	9	0	335
10717	12	4	2	306	0	324
10718	3	307	1	12	0	323
10719	3	12	318	2	0	335
10720	318	2	13	4	0	337
10721	15	1	0	316	0	332
10722	2	2	4	328	0	336
10723	7	2	1	332	0	342
10724	319	0	2	20	0	341
10725	14	299	2	5	0	320
10726	1	325	2	5	0	333
10727	295	13	4	7	0	319
10728	16	289	2	4	0	311
10729	291	15	2	4	0	312
10730	302	1	2	6	0	311
10731	13	293	2	5	0	313
10732	8	14	0	284	0	306
10733	2	293	4	17	0	316
10734	2	18	2	286	0	308
10735	5	2	1	313	0	321
10736	317	2	5	15	0	339
10737	326	1	2	7	0	336
10738	22	3	1	318	0	344
10739	2	2	301	18	0	323
10740	301	0	16	8	0	325
10741	19	307	2	6	0	334
10742	3	15	3	306	0	327
10743	2	3	1	319	0	325
10744	7	2	2	309	0	320
10745	283	3	2	18	0	306
10746	296	4	1	4	0	305
10747	19	263	1	6	0	289
10748	6	284	3	2	0	295
10749	6	18	2	272	0	298
10750	7	2	4	287	0	300
10751	6	2	277	19	0	304
10752	5	6	17	271	0	299
10753	4	4	251	18	0	277
10754	3	3	250	6	0	262
10755	2	237	15	6	0	260
10756	3	17	4	242	0	266
10757	247	2	1	18	0	268
10758	20	4	2	232	0	258
10759	0	4	230	16	0	250
10760	228	2	13	4	0	247
10761	240	1	1	6	0	248
10762	14	2	230	3	0	249
10763	2	2	13	244	0	261
10764	231	3	2	18	0	254
10765	14	237	2	5	0	258
10766	241	15	1	5	0	262
10767	256	2	2	2	0	262
10768	20	3	0	240	0	263
10769	7	2	1	256	0	266
10770	245	1	5	15	0	266
10771	20	2	2	246	0	270
10772	4	2	245	19	0	270
10773	235	2	15	6	0	258
10774	257	0	2	10	0	269
10775	18	238	2	5	0	263
10776	4	238	1	3	0	246
10777	4	12	4	219	0	239
10778	4	218	0	12	0	234
10779	2	12	3	220	0	237
10780	222	0	1	15	0	238
10781	232	2	1	2	0	237
10782	14	229	2	3	0	248
10783	216	12	3	4	0	235
10784	13	219	3	2	0	237
10785	218	12	1	3	0	234
10786	232	2	0	2	0	236
10787	15	4	218	1	0	238
10788	217	1	11	3	0	232
10789	11	213	1	5	0	230
10790	3	234	1	4	0	242
10791	234	12	1	3	0	250
10792	18	1	3	230	0	252
10793	3	2	235	14	0	254
10794	3	2	13	233	0	251
10795	5	5	0	248	0	258
10796	4	6	232	14	0	256
10797	223	1	11	2	0	237
10798	17	228	2	4	0	251
10799	224	15	3	4	0	246
10800	20	1	0	222	0	243
10801	208	4	1	12	0	225
10802	14	215	2	5	0	236
10803	4	13	1	221	0	239
10804	219	2	2	13	0	236
10805	16	2	212	2	0	232
10806	5	3	209	3	0	220
10807	203	4	13	3	0	223
10808	14	193	1	5	0	213
10809	2	159	0	4	0	165
10810	3	9	2	146	0	160
10811	3	147	2	11	0	163
10812	4	9	1	145	0	159
10813	5	3	1	163	0	172
10814	2	3	1	161	0	167
10815	2	156	2	8	0	168
10816	3	8	0	155	0	166
10817	1	1	150	9	0	161
10818	2	148	8	2	0	160
10819	5	6	2	131	0	144
10820	2	139	1	5	0	147
10821	139	8	0	0	0	147
10822	141	0	1	1	0	143
10823	140	3	1	2	0	146
10824	7	138	0	2	0	147
10825	1	7	0	140	0	148
10826	1	1	138	6	0	146
10827	4	1	132	1	0	138
10828	129	2	6	2	0	139
10829	135	2	1	3	0	141
10830	8	3	0	130	0	141
10831	3	0	0	146	0	149
10832	0	4	142	6	0	152
10833	3	128	6	8	0	145
10834	4	141	0	3	0	148
10835	1	5	126	0	0	132
10836	3	1	4	114	0	122
10837	1	2	1	107	0	111
10838	2	2	1	118	0	123
10839	2	0	0	119	0	121
10840	112	2	0	7	0	121
10841	4	2	109	0	0	115
10842	104	2	4	3	0	113
10843	5	3	0	107	0	115
10844	104	1	3	6	0	114
10845	7	0	1	107	0	115
10846	3	1	104	6	0	114
10847	1	1	5	105	0	112
10848	2	1	113	7	0	123
10849	2	1	4	127	0	134
10850	2	1	128	4	0	135
10851	3	121	4	3	0	131
10852	2	4	2	123	0	131
10853	4	0	1	130	0	135
10854	0	125	2	4	0	131
10855	133	4	1	3	0	141
10856	4	2	2	135	0	143
10857	1	3	1	135	0	140
10858	132	0	0	7	0	139
10859	138	2	2	3	0	145
10860	151	2	1	2	0	156
10861	151	0	1	2	0	154
10862	4	1	141	3	0	149
10863	136	3	3	1	0	143
10864	143	0	0	2	0	145
10865	4	1	0	138	0	143
10866	2	0	0	141	0	143
10867	139	0	0	3	0	142
10868	3	136	1	2	0	142
10869	3	3	0	133	0	139
10870	2	0	139	3	0	144
10871	0	138	3	1	0	142
10872	140	2	1	1	0	144
10873	144	0	0	0	0	144
10874	137	1	0	2	0	140
10875	139	0	0	2	0	141
10876	3	0	1	138	0	142
10877	0	2	137	2	0	141
10878	1	0	140	1	0	142
10879	2	0	3	146	0	151
10880	152	1	0	2	0	155
10881	7	0	0	151	0	158
10882	1	0	155	4	0	160
10883	151	0	4	0	0	155
10884	159	0	1	0	0	160
10885	7	0	0	154	0	161
10886	1	0	170	4	0	175
10887	1	0	174	0	0	175
10888	170	0	3	1	0	174
10889	6	165	0	0	0	171
10890	1	1	168	1	0	171
10891	1	0	3	162	0	166
10892	163	0	1	4	0	168
10893	3	154	2	0	0	159
10894	0	153	1	1	0	155
10895	158	3	1	0	0	162
10896	3	0	2	155	0	160
10897	166	0	0	5	0	171
10898	3	1	0	165	0	169
10899	1	1	1	165	0	168
10900	0	1	161	3	0	165
10901	2	0	154	1	0	157
10902	0	1	165	1	0	167
10903	1	1	2	167	0	171
10904	178	0	0	5	0	183
10905	3	0	180	1	0	184
10906	1	0	3	177	0	181
10907	0	0	183	3	0	186
10908	0	188	3	1	0	192
10909	0	2	1	188	0	191
10910	1	0	1	188	0	190
10911	0	1	2	188	0	191
10912	186	0	0	7	0	193
10913	3	0	1	183	0	187
10914	1	1	1	188	0	191
10915	184	0	0	6	0	190
10916	2	0	184	2	0	188
10917	177	1	2	4	0	184
10918	183	0	0	1	0	184
10919	2	0	188	2	0	192
10920	182	0	1	1	0	184
10921	5	0	0	193	0	198
10922	1	1	209	3	0	214
10923	208	0	2	1	0	211
10924	218	0	0	1	0	219
10925	2	0	2	221	0	225
10926	2	0	0	221	0	223
10927	3	0	0	222	0	225
10928	220	0	1	5	0	226
10929	3	222	1	0	0	226
10930	221	1	0	1	0	223
10931	3	213	0	0	0	216
10932	0	208	0	1	0	209
10933	1	2	0	211	0	214
10934	1	1	1	213	0	216
10935	0	1	0	210	0	211
10936	0	0	0	208	0	208
10937	0	0	208	3	0	211
10938	204	0	2	1	0	207
10939	2	0	0	210	0	212
10940	3	0	206	2	0	211
10941	1	0	1	209	0	211
10942	0	0	0	214	0	214
10943	1	0	216	2	0	219
10944	1	0	2	215	0	218
10945	0	0	0	221	0	221
10946	223	0	1	2	0	226
10947	2	0	226	1	0	229
10948	208	0	2	1	0	211
10949	3	216	0	0	0	219
10950	215	2	1	1	0	219
10951	220	2	0	0	0	222
10952	5	1	0	215	0	221
10953	3	0	214	2	0	219
10954	2	221	2	2	0	227
10955	1	2	2	208	0	213
10956	0	235	1	3	0	239
10957	230	3	0	3	0	236
10958	1	2	231	1	0	235
10959	2	1	225	1	0	229
10960	1	0	4	221	0	226
10961	1	0	229	2	0	232
10962	0	1	3	231	0	235
10963	1	1	2	224	0	228
10964	237	0	1	4	0	242
10965	2	241	0	3	0	246
10966	3	2	0	247	0	252
10967	1	2	0	250	0	253
10968	0	1	0	247	0	248
10969	0	228	1	6	0	235
10970	0	240	1	4	0	245
10971	229	4	1	2	0	236
10972	233	2	0	3	0	238
10973	231	1	0	0	0	232
10974	6	0	235	0	0	241
10975	5	0	2	227	0	234
10976	1	0	236	2	0	239
10977	0	237	3	3	0	243
10978	230	2	5	3	0	240
10979	2	3	227	2	0	234
10980	3	1	0	224	0	228
10981	1	0	233	2	0	236
10982	219	0	1	8	0	228
10983	228	1	3	2	0	234
10984	233	1	1	0	0	235
10985	231	0	1	0	0	232
10986	5	0	239	0	0	244
10987	240	0	0	1	0	241
10988	236	1	5	1	0	243
10989	4	241	1	1	0	247
10990	240	1	2	0	0	243
10991	246	4	0	1	0	251
10992	5	1	1	241	0	248
10993	5	238	1	1	0	245
10994	249	1	1	5	0	256
10995	265	2	2	0	0	269
10996	5	2	299	1	0	307
10997	8	0	299	1	0	308
10998	2	0	311	2	0	315
10999	1	5	10	298	0	314
11000	307	0	7	7	0	321
11001	5	311	1	7	0	324
11002	302	4	0	3	0	309
11003	5	309	0	0	0	314
11004	304	6	0	1	0	311
11005	6	296	0	0	0	302
11006	6	300	0	1	0	307
11007	295	9	2	1	0	307
11008	5	304	1	0	0	310
11009	4	4	0	298	0	306
11010	0	6	306	4	0	316
11011	0	1	309	6	0	316
11012	1	0	10	302	0	313
11013	0	2	7	309	0	318
11014	2	0	307	13	0	322
11015	1	1	7	311	0	320
11016	2	1	7	311	0	321
11017	311	4	0	10	0	325
11018	7	303	1	6	0	317
11019	9	4	0	277	0	290
11020	1	306	4	3	0	314
11021	293	4	3	6	0	306
11022	5	290	3	0	0	298
11023	298	5	1	7	0	311
11024	292	6	2	2	0	302
11025	11	4	4	278	0	297
11026	10	2	2	282	0	296
11027	2	4	2	287	0	295
11028	6	1	1	290	0	298
11029	6	3	273	10	0	292
11030	254	4	6	8	0	272
11031	9	277	7	3	0	296
11032	10	11	1	282	0	304
11033	5	7	1	291	0	304
11034	2	295	4	10	0	311
11035	293	6	4	7	0	310
11036	7	295	2	3	0	307
11037	9	9	1	299	0	318
11038	4	7	5	303	0	319
11039	4	0	2	308	0	314
11040	2	3	2	307	0	314
11041	296	2	0	15	0	313
11042	7	4	284	8	0	303
11043	8	0	9	286	0	303
11044	2	4	8	281	0	295
11045	4	2	4	286	0	296
11046	6	4	3	281	0	294
11047	275	3	0	14	0	292
11048	8	1	268	10	0	287
11049	9	4	5	254	0	272
11050	3	240	4	7	0	254
11051	4	265	0	10	0	279
11052	261	8	0	5	0	274
11053	6	6	256	3	0	271
11054	243	3	5	4	0	255
11055	8	3	247	2	0	260
11056	6	3	5	230	0	244
11057	233	0	3	13	0	249
11058	4	235	5	5	0	249
11059	9	4	2	223	0	238
11060	0	227	0	9	0	236
11061	240	4	0	11	0	255
11062	243	4	3	6	0	256
11063	8	3	0	246	0	257
11064	5	0	235	9	0	249
11065	4	2	233	5	0	244
11066	0	7	11	222	0	240
11067	1	225	5	10	0	241
11068	0	6	0	245	0	251
11069	2	2	0	234	0	238
11070	4	2	0	219	0	225
11071	3	1	230	8	0	242
11072	1	0	7	229	0	237
11073	2	1	2	227	0	232
11074	0	225	2	8	0	235
11075	0	5	0	239	0	244
11076	4	3	0	235	0	242
11077	0	1	5	236	0	242
11078	3	0	1	238	0	242
11079	2	2	3	234	0	241
11080	1	2	0	236	0	239
11081	3	0	0	226	0	229
11082	0	3	2	220	0	225
11083	3	1	208	10	0	222
11084	2	2	5	212	0	221
11085	213	0	4	7	0	224
11086	8	1	1	191	0	201
11087	4	3	194	7	0	208
11088	191	0	5	8	0	204
11089	204	1	5	2	0	212
11090	206	1	2	2	0	211
11091	206	2	0	2	0	210
11092	8	1	0	203	0	212
11093	5	0	204	6	0	215
11094	2	201	3	6	0	212
11095	1	177	1	2	0	181
11096	1	3	5	136	0	145
11097	1	1	2	138	0	142
11098	0	1	0	136	0	137
11099	1	1	0	134	0	136
11100	1	1	0	177	0	179
11101	188	0	0	4	0	192
11102	3	192	0	2	0	197
11103	0	201	0	2	0	203
11104	2	5	0	200	0	207
11105	0	1	0	207	0	208
11106	1	1	0	208	0	210
11107	2	1	0	206	0	209
11108	0	1	193	5	0	199
11109	0	195	4	2	0	201
11110	0	4	0	201	0	205
11111	196	0	1	6	0	203
11112	5	1	0	197	0	203
11113	0	0	200	4	0	204
11114	2	1	195	1	0	199
11115	0	0	195	2	0	197
11116	2	0	5	191	0	198
11117	203	0	1	6	0	210
11118	4	0	2	205	0	211
11119	0	0	1	214	0	215
11120	212	0	1	5	0	218
11121	4	0	0	217	0	221
11122	2	0	0	215	0	217
11123	1	0	221	6	0	228
11124	1	217	4	3	0	225
11125	2	4	0	222	0	228
11126	224	0	1	7	0	232
11127	4	1	0	227	0	232
11128	0	0	221	5	0	226
11129	1	1	4	220	0	226
11130	0	223	1	7	0	231
11131	2	4	1	224	0	231
11132	0	0	210	6	0	216
11133	0	227	6	0	0	233
11134	0	5	0	232	0	237
11135	3	1	1	261	0	266
11136	1	1	0	267	0	269
11137	2	1	1	263	0	267
11138	0	1	257	7	0	265
11139	1	256	7	3	0	267
11140	257	6	1	3	0	267
11141	267	1	1	3	0	272
11142	7	1	1	265	0	274
11143	1	0	269	7	0	277
11144	265	1	5	3	0	274
11145	8	0	0	268	0	276
11146	0	0	269	7	0	276
11147	2	1	5	267	0	275
11148	0	0	3	269	0	272
11149	2	1	2	270	0	275
11150	0	0	271	11	0	282
11151	2	0	7	264	0	273
11152	0	273	1	10	0	284
11153	269	5	4	2	0	280
11154	276	1	0	4	0	281
11155	269	2	1	2	0	274
11156	7	274	0	3	0	284
11157	270	5	2	3	0	280
11158	11	2	1	266	0	280
11159	271	1	0	8	0	280
11160	270	0	0	4	0	274
11161	6	0	262	2	0	270
11162	2	262	6	1	0	271
11163	255	5	1	5	0	266
11164	5	1	1	255	0	262
11165	2	1	257	7	0	267
11166	3	265	9	1	0	278
11167	259	9	1	3	0	272
11168	7	1	1	267	0	276
11169	3	0	0	271	0	274
11170	0	0	2	273	0	275
11171	0	267	1	7	0	275
11172	2	5	1	269	0	277
11173	0	262	1	9	0	272
11174	3	5	0	263	0	271
11175	3	0	264	8	0	275
11176	2	1	6	261	0	270
11177	1	3	2	271	0	277
11178	4	1	1	271	0	277
11179	1	1	266	9	0	277
11180	4	0	10	256	0	270
11181	1	2	1	274	0	278
11182	3	0	1	280	0	284
11183	0	0	1	281	0	282
11184	2	0	3	271	0	276
11185	1	0	267	11	0	279
11186	0	3	8	269	0	280
11187	2	2	0	271	0	275
11188	260	1	0	7	0	268
11189	7	249	2	5	0	263
11190	1	263	4	1	0	269
11191	5	6	0	262	0	273
11192	1	2	1	264	0	268
11193	6	257	0	7	0	270
11194	4	6	0	248	0	258
11195	4	250	2	6	0	262
11196	2	8	0	249	0	259
11197	6	1	2	248	0	257
11198	2	1	240	10	0	253
11199	2	237	9	4	0	252
11200	1	211	3	3	0	218
11201	179	2	2	4	0	187
11202	1	182	2	4	0	189
11203	4	5	0	176	0	185
11204	2	0	171	6	0	179
11205	2	1	2	175	0	180
11206	171	2	1	5	0	179
11207	3	2	186	1	0	192
11208	4	190	1	4	0	199
11209	3	2	1	166	0	172
11210	0	2	2	189	0	193
11211	194	1	2	5	0	202
11212	1	0	0	200	0	201
11213	2	1	2	200	0	205
11214	1	1	2	194	0	198
11215	1	1	2	194	0	198
11216	188	2	0	6	0	196
11217	183	1	0	4	0	188
11218	2	0	1	186	0	189
11219	182	0	3	2	0	187
11220	3	3	0	179	0	185
11221	5	0	176	3	0	184
11222	2	0	171	3	0	176
11223	4	2	1	162	0	169
11224	3	163	0	4	0	170
11225	4	3	3	167	0	177
11226	159	2	0	8	0	169
11227	4	1	0	164	0	169
11228	163	0	0	7	0	170
11229	1	3	3	162	0	169
11230	0	4	162	5	0	171
11231	4	156	1	3	0	164
11232	1	160	1	6	0	168
11233	1	6	0	142	0	149
11234	1	1	146	2	0	150
11235	1	117	0	0	0	118
11236	0	0	0	114	0	114
11237	110	0	0	2	0	112
11238	0	0	121	1	0	122
11239	0	0	0	119	0	119
11240	0	0	0	123	0	123
11241	0	0	120	0	0	120
11242	0	0	120	0	0	120
11243	0	0	124	0	0	124
11244	0	0	0	125	0	125
11245	0	0	128	0	0	128
11246	122	0	0	2	0	124
11247	0	3	0	137	0	140
11248	0	0	173	0	0	173
11249	2	178	0	0	0	180
11250	0	0	179	1	0	180
11251	1	0	1	178	0	180
11252	187	1	0	2	0	190
11253	1	0	1	187	0	189
11254	0	0	0	193	0	193
11255	204	0	0	2	0	206
11256	1	0	0	208	0	209
11257	0	0	206	2	0	208
11258	203	0	1	3	0	207
11259	1	214	0	2	0	217
11260	215	1	2	2	0	220
11261	5	0	0	216	0	221
11262	0	3	215	1	0	219
11263	3	0	214	0	0	217
11264	0	1	1	230	0	232
11265	1	0	3	223	0	227
11266	0	0	221	1	0	222
11267	0	0	211	1	0	212
11268	223	0	2	4	0	229
11269	2	0	3	221	0	226
11270	222	0	3	5	0	230
11271	5	0	0	223	0	228
11272	1	0	240	5	0	246
11273	3	0	254	0	0	257
11274	1	0	4	268	0	273
11275	0	0	3	263	0	266
11276	1	0	259	3	0	263
11277	245	0	4	2	0	251
11278	4	0	0	258	0	262
11279	265	0	3	6	0	274
11280	7	308	0	0	0	315
11281	2	5	0	323	0	330
11282	316	3	0	7	0	326
11283	5	2	320	1	0	328
11284	4	0	5	324	0	333
11285	5	0	2	315	0	322
11286	1	0	4	333	0	338
11287	0	0	325	9	0	334
11288	1	0	6	324	0	331
11289	0	334	2	10	0	346
11290	0	5	4	336	0	345
11291	1	2	339	10	0	352
11292	0	3	332	3	0	338
11293	4	0	8	336	0	348
11294	3	1	5	336	0	345
11295	2	0	3	343	0	348
11296	2	1	0	352	0	355
11297	338	0	1	13	0	352
11298	338	0	0	9	0	347
11299	8	0	334	5	0	347
11300	6	346	6	3	0	361
11301	4	8	4	356	0	372
11302	359	2	3	8	0	372
11303	331	5	2	4	0	342
11304	366	0	1	4	0	371
11305	361	1	1	5	0	368
11306	11	0	352	3	0	366
11307	334	0	9	3	0	346
11308	8	333	4	4	0	349
11309	2	6	3	341	0	352
11310	3	3	350	8	0	364
11311	2	3	6	337	0	348
11312	3	1	346	10	0	360
11313	4	1	11	345	0	361
11314	3	1	3	358	0	365
11315	352	0	6	12	0	370
11316	8	1	1	356	0	366
11317	3	2	364	13	0	382
11318	6	0	7	365	0	378
11319	366	0	3	11	0	380
11320	10	0	5	374	0	389
11321	5	3	372	11	0	391
11322	4	369	5	6	0	384
11323	386	6	3	7	0	402
11324	6	3	7	366	0	382
11325	3	389	1	11	0	404
11326	389	6	2	5	0	402
11327	6	2	390	7	0	405
11328	3	392	8	3	0	406
11329	7	7	3	410	0	427
11330	1	3	414	12	0	430
11331	2	2	9	390	0	403
11332	404	3	1	15	0	423
11333	7	1	409	5	0	422
11334	7	0	5	410	0	422
11335	6	0	417	6	0	429
11336	4	1	10	410	0	425
11337	4	1	3	417	0	425
11338	402	1	4	12	0	419
11339	9	398	0	6	0	413
11340	4	6	0	407	0	417
11341	408	4	1	7	0	420
11342	404	3	3	4	0	414
11343	9	1	4	393	0	407
11344	6	389	3	5	0	403
11345	3	400	0	6	0	409
11346	2	8	1	396	0	407
11347	5	4	3	388	0	400
11348	356	2	1	13	0	372
11349	8	1	3	353	0	365
11350	2	0	349	11	0	362
11351	321	1	6	4	0	332
11352	7	335	2	5	0	349
11353	333	5	3	2	0	343
11354	7	4	341	2	0	354
11355	4	355	4	2	0	365
11356	356	6	2	1	0	365
11357	351	3	2	3	0	359
11358	8	1	350	1	0	360
11359	342	1	6	1	0	350
11360	346	2	2	0	0	350
11361	5	359	1	3	0	368
11362	4	6	1	360	0	371
11363	3	1	353	9	0	366
11364	5	1	8	352	0	366
11365	0	2	355	8	0	365
11366	0	1	8	356	0	365
11367	362	0	4	8	0	374
11368	10	1	2	373	0	386
11369	6	0	408	8	0	422
11370	403	0	10	7	0	420
11371	8	1	3	418	0	430
11372	5	0	405	8	0	418
11373	383	1	6	5	0	395
11374	9	0	4	387	0	400
11375	4	1	381	8	0	394
11376	8	4	371	3	0	386
11377	2	2	8	385	0	397
11378	3	2	392	9	0	406
11379	1	390	8	4	0	403
11380	3	8	1	345	0	357
11381	348	0	4	4	0	356
11382	5	1	342	1	0	349
11383	1	0	339	2	0	342
11384	321	1	5	4	0	331
11385	6	1	341	0	0	348
11386	322	0	8	1	0	331
11387	7	0	343	1	0	351
11388	0	0	9	332	0	341
11389	4	0	330	5	0	339
11390	1	0	7	326	0	334
11391	1	0	337	7	0	345
11392	0	0	329	0	0	329
11393	305	0	5	5	0	315
11394	5	335	4	0	0	344
11395	338	5	1	1	0	345
11396	6	337	2	2	0	347
11397	2	6	1	341	0	350
11398	5	0	1	343	0	349
11399	339	3	1	6	0	349
11400	8	0	0	328	0	336
11401	1	2	329	6	0	338
11402	318	0	4	1	0	323
11403	329	0	1	4	0	334
11404	6	0	2	320	0	328
11405	2	1	324	5	0	332
11406	3	0	6	321	0	330
11407	1	323	1	6	0	331
11408	2	5	3	324	0	334
11409	2	0	0	339	0	341
11410	0	3	326	5	0	334
11411	292	1	5	6	0	304
11412	3	315	0	3	0	321
11413	301	4	3	6	0	314
11414	7	306	0	4	0	317
11415	1	7	4	302	0	314
11416	5	318	0	7	0	330
11417	1	9	304	1	0	315
11418	7	1	6	279	0	293
11419	1	4	2	293	0	300
11420	2	1	2	301	0	306
11421	288	2	2	10	0	302
11422	7	1	3	288	0	299
11423	285	2	0	11	0	298
11424	293	0	0	3	0	296
11425	280	0	3	6	0	289
11426	9	0	288	1	0	298
11427	5	0	6	277	0	288
11428	4	1	1	302	0	308
11429	6	1	3	294	0	304
11430	314	1	0	10	0	325
11431	7	2	1	307	0	317
11432	1	1	2	322	0	326
11433	327	0	3	8	0	338
11434	8	0	1	338	0	347
11435	2	1	342	8	0	353
11436	4	0	342	3	0	349
11437	2	1	8	348	0	359
11438	343	0	2	11	0	356
11439	337	1	4	2	0	344
11440	10	0	2	340	0	352
11441	2	0	335	9	0	346
11442	3	326	9	3	0	341
11443	4	5	0	340	0	349
11444	4	1	2	340	0	347
11445	2	2	1	347	0	352
11446	338	2	2	10	0	352
11447	7	1	332	6	0	346
11448	327	0	8	9	0	344
11449	12	0	1	331	0	344
11450	2	330	4	8	0	344
11451	326	7	2	5	0	340
11452	322	0	5	6	0	333
11453	11	3	332	1	0	347
11454	5	311	7	2	0	325
11455	2	313	1	3	0	319
11456	301	6	3	3	0	313
11457	10	3	2	303	0	318
11458	1	2	3	310	0	316
11459	2	1	1	302	0	306
11460	1	282	2	10	0	295
11461	3	292	0	3	0	298
11462	289	5	1	5	0	300
11463	8	2	2	294	0	306
11464	1	2	348	8	0	359
11465	2	3	9	370	0	384
11466	3	2	406	12	0	423
11467	3	1	398	2	0	404
11468	4	1	393	2	0	400
11469	1	354	17	4	0	376
11470	3	8	6	335	0	352
11471	2	354	7	8	0	371
11472	2	10	8	330	0	350
11473	4	5	5	352	0	366
11474	346	4	2	17	0	369
11475	8	5	4	356	0	373
11476	342	5	2	16	0	365
11477	358	3	1	11	0	373
11478	13	0	2	352	0	367
11479	7	342	2	12	0	363
11480	4	8	0	340	0	352
11481	7	334	3	12	0	356
11482	8	9	1	346	0	364
11483	1	8	335	17	0	361
11484	6	5	7	346	0	364
11485	4	4	4	354	0	366
11486	330	5	3	18	0	356
11487	9	333	6	11	0	359
11488	7	9	5	338	0	359
11489	6	3	2	347	0	358
11490	6	340	1	22	0	369
11491	10	12	2	347	0	371
11492	331	8	2	15	0	356
11493	334	6	2	16	0	358
11494	14	330	1	10	0	355
11495	6	12	1	342	0	361
11496	326	3	1	19	0	349
11497	16	327	3	9	0	355
11498	12	14	3	303	0	332
11499	6	338	0	16	0	360
11500	337	9	0	11	0	357
11501	14	10	327	8	0	359
11502	7	8	336	10	0	361
11503	5	6	16	334	0	361
11504	8	3	338	14	0	363
11505	5	7	21	331	0	364
11506	333	6	12	14	0	365
11507	14	4	334	11	0	363
11508	11	6	12	333	0	362
11509	4	5	7	341	0	357
11510	331	5	3	24	0	363
11511	15	351	3	11	0	380
11512	357	13	4	11	0	385
11513	355	4	4	14	0	377
11514	18	347	3	12	0	380
11515	11	10	2	362	0	385
11516	9	10	346	12	0	377
11517	6	5	11	347	0	369
11518	8	352	7	11	0	378
11519	350	15	6	17	0	388
11520	10	8	7	364	0	389
11521	7	4	361	21	0	393
11522	7	7	14	376	0	404
11523	9	5	7	376	0	397
11524	7	4	5	382	0	398
11525	3	5	4	385	0	397
11526	6	5	4	374	0	389
11527	3	5	355	25	0	388
11528	4	1	331	22	0	358
11529	6	310	12	11	0	339
11530	6	322	4	13	0	345
11531	317	13	5	9	0	344
11532	13	4	325	8	0	350
11533	299	8	13	1	0	321
11534	9	6	290	7	0	312
11535	6	6	286	4	0	302
11536	8	6	14	281	0	309
11537	319	4	9	13	0	345
11538	11	3	9	322	0	345
11539	7	2	8	327	0	344
11540	2	0	349	18	0	369
11541	5	2	10	348	0	365
11542	8	3	4	359	0	374
11543	6	1	4	361	0	372
11544	2	3	7	359	0	371
11545	7	0	1	362	0	370
11546	350	3	4	17	0	374
11547	9	1	1	357	0	368
11548	7	4	335	17	0	363
11549	12	3	6	349	0	370
11550	6	4	337	14	0	361
11551	6	5	7	345	0	363
11552	5	0	344	15	0	364
11553	1	3	12	341	0	357
11554	2	1	8	351	0	362
11555	2	4	341	17	0	364
11556	327	0	13	12	0	352
11557	6	3	339	13	0	361
11558	9	2	12	343	0	366
11559	341	1	8	20	0	370
11560	10	1	8	347	0	366
11561	9	3	4	354	0	370
11562	5	1	336	18	0	360
11563	3	324	10	14	0	351
11564	5	265	5	5	0	280
11565	2	252	3	7	0	264
11566	0	0	3	204	0	207
11567	209	1	0	3	0	213
11568	1	0	0	200	0	201
11569	0	0	0	200	0	200
11570	0	0	0	203	0	203
11571	0	0	0	206	0	206
11572	0	202	0	0	0	202
11573	0	0	0	214	0	214
11574	2	0	0	213	0	215
11575	0	210	0	0	0	210
11576	211	0	0	2	0	213
11577	0	0	0	208	0	208
11578	204	0	0	1	0	205
11579	195	0	0	2	0	197
11580	0	208	0	0	0	208
11581	1	0	0	223	0	224
11582	0	0	224	0	0	224
11583	0	2	218	0	0	220
11584	0	0	0	223	0	223
11585	231	0	0	0	0	231
11586	229	0	0	0	0	229
11587	1	0	0	232	0	233
11588	227	0	0	0	0	227
11589	0	230	0	0	0	230
11590	221	0	0	1	0	222
11591	0	262	0	0	0	262
11592	0	0	0	271	0	271
11593	0	0	0	271	0	271
11594	0	270	1	0	0	271
11595	265	0	0	3	0	268
11596	0	0	261	0	0	261
11597	1	0	0	270	0	271
11598	0	1	269	0	0	270
11599	0	0	0	269	0	269
11600	270	0	0	2	0	272
11601	0	1	0	269	0	270
11602	266	0	0	3	0	269
11603	262	0	0	2	0	264
11604	0	0	0	270	0	270
11605	1	0	270	0	0	271
11606	0	277	0	0	0	277
11607	0	0	0	279	0	279
11608	275	0	0	1	0	276
11609	0	1	282	0	0	283
11610	1	0	0	273	0	274
11611	1	0	0	261	0	262
11612	1	0	0	267	0	268
11613	266	0	0	3	0	269
11614	1	0	0	266	0	267
11615	1	0	0	266	0	267
11616	1	0	261	0	0	262
11617	2	0	0	254	0	256
11618	0	1	0	268	0	269
11619	0	0	0	270	0	270
11620	0	265	1	0	0	266
11621	0	0	0	259	0	259
11622	0	0	0	262	0	262
11623	270	0	0	0	0	270
11624	0	0	266	0	0	266
11625	0	0	246	0	0	246
11626	0	279	0	0	0	279
11627	0	0	1	281	0	282
11628	289	0	0	5	0	294
11629	3	0	0	283	0	286
11630	0	0	0	278	0	278
11631	0	0	0	283	0	283
11632	0	0	0	278	0	278
11633	0	0	0	279	0	279
11634	0	0	270	1	0	271
11635	2	0	0	271	0	273
11636	269	0	0	3	0	272
11637	0	246	1	0	0	247
11638	4	0	0	244	0	248
11639	0	1	0	245	0	246
11640	0	0	239	1	0	240
11641	1	0	0	224	0	225
11642	0	0	0	241	0	241
11643	237	0	0	5	0	242
11644	0	258	0	1	0	259
11645	0	0	0	256	0	256
11646	0	0	0	256	0	256
11647	1	0	1	253	0	255
11648	0	0	250	2	0	252
11649	1	1	244	0	0	246
11650	0	254	0	0	0	254
11651	1	258	0	1	0	260
11652	0	1	0	258	0	259
11653	0	239	1	1	0	241
11654	1	1	1	268	0	271
11655	1	0	0	298	0	299
11656	1	0	0	309	0	310
11657	2	1	0	376	0	379
11658	0	0	380	9	0	389
11659	1	0	4	380	0	385
11660	0	0	4	390	0	394
11661	1	0	2	402	0	405
11662	387	0	1	13	0	401
11663	4	381	5	5	0	395
11664	4	6	0	359	0	369
11665	2	395	2	8	0	407
11666	374	8	1	15	0	398
11667	333	6	0	10	0	349
11668	5	373	0	4	0	382
11669	6	397	0	5	0	408
11670	3	13	375	2	0	393
11671	4	401	4	1	0	410
11672	5	7	2	394	0	408
11673	386	7	2	9	0	404
11674	5	400	1	6	0	412
11675	8	6	4	395	0	413
11676	1	11	0	403	0	415
11677	3	2	2	413	0	420
11678	402	4	1	12	0	419
11679	5	6	397	8	0	416
11680	378	0	4	9	0	391
11681	7	380	3	6	0	396
11682	6	6	2	381	0	395
11683	8	4	377	6	0	395
11684	358	4	9	9	0	380
11685	10	382	4	5	0	401
11686	8	9	4	374	0	395
11687	4	391	2	10	0	407
11688	3	7	3	387	0	400
11689	4	5	0	398	0	407
11690	1	6	386	12	0	405
11691	4	1	359	10	0	374
11692	4	5	9	356	0	374
11693	2	2	364	10	0	378
11694	0	3	7	366	0	376
11695	1	1	9	353	0	364
11696	1	0	8	372	0	381
11697	366	1	3	17	0	387
11698	4	2	7	370	0	383
11699	5	1	370	16	0	392
11700	367	2	8	14	0	391
11701	8	0	6	379	0	393
11702	9	2	2	381	0	394
11703	366	0	3	20	0	389
11704	7	375	9	9	0	400
11705	13	4	1	388	0	406
11706	7	6	3	384	0	400
11707	369	3	4	19	0	395
11708	12	5	372	11	0	400
11709	7	5	6	374	0	392
11710	8	2	3	379	0	392
11711	3	5	4	375	0	387
11712	8	366	3	13	0	390
11713	4	8	6	377	0	395
11714	365	7	1	18	0	391
11715	5	370	3	15	0	393
11716	364	6	2	13	0	385
11717	8	373	1	9	0	391
11718	369	7	4	13	0	393
11719	11	10	376	9	0	406
11720	6	9	364	10	0	389
11721	378	2	9	7	0	396
11722	10	7	383	5	0	405
11723	13	1	6	373	0	393
11724	7	5	10	355	0	377
11725	6	3	7	388	0	404
11726	374	3	4	15	0	396
11727	7	2	369	10	0	388
11728	371	3	6	9	0	389
11729	10	2	11	382	0	405
11730	389	4	3	15	0	411
11731	14	4	1	396	0	415
11732	397	3	5	13	0	418
11733	15	4	3	433	0	455
11734	7	1	436	17	0	461
11735	443	1	9	11	0	464
11736	456	2	9	9	0	476
11737	18	1	4	464	0	487
11738	9	1	4	463	0	477
11739	10	465	5	14	0	494
11740	449	8	3	12	0	472
11741	10	461	5	12	0	488
11742	441	8	4	12	0	465
11743	14	10	430	6	0	460
11744	9	5	425	8	0	447
11745	7	3	420	9	0	439
11746	419	6	11	7	0	443
11747	10	428	10	5	0	453
11748	8	6	9	429	0	452
11749	418	5	6	11	0	440
11750	10	427	8	5	0	450
11751	11	8	3	417	0	439
11752	2	414	4	15	0	435
11753	6	400	1	14	0	421
11754	8	414	2	5	0	429
11755	374	13	3	9	0	399
11756	11	374	0	6	0	391
11757	3	288	1	4	0	296
11758	4	300	3	0	0	307
11759	291	3	8	6	0	308
11760	288	5	0	0	0	293
11761	3	5	285	3	0	296
11762	279	2	4	4	0	289
11763	299	2	0	0	0	301
11764	8	0	1	302	0	311
11765	302	0	4	6	0	312
11766	3	0	297	3	0	303
11767	5	312	3	0	0	320
11768	320	5	2	3	0	330
11769	6	3	0	351	0	360
11770	350	0	2	6	0	358
11771	4	3	331	1	0	339
11772	330	2	3	3	0	338
11773	7	2	3	341	0	353
11774	6	1	332	3	0	342
11775	0	310	5	2	0	317
11776	3	333	1	3	0	340
11777	5	4	2	322	0	333
11778	3	2	1	324	0	330
11779	2	336	0	3	0	341
11780	334	4	1	6	0	345
11781	338	1	0	3	0	342
11782	327	1	1	3	0	332
11783	4	328	1	2	0	335
11784	5	4	0	322	0	331
11785	2	335	3	1	0	341
11786	341	4	0	4	0	349
11787	339	1	0	3	0	343
11788	3	335	2	2	0	342
11789	338	6	0	1	0	345
11790	6	3	0	334	0	343
11791	3	1	2	337	0	343
11792	341	1	2	6	0	350
11793	331	0	4	2	0	337
11794	334	0	2	6	0	342
11795	6	1	1	332	0	340
11796	4	2	2	334	0	342
11797	6	2	334	5	0	347
11798	2	6	3	333	0	344
11799	3	3	1	330	0	337
11800	3	3	315	8	0	329
11801	3	4	307	4	0	318
11802	2	3	317	1	0	323
11803	7	1	7	317	0	332
11804	5	4	319	3	0	331
11805	3	4	6	309	0	322
11806	4	3	2	326	0	335
11807	3	5	322	7	0	337
11808	3	4	318	4	0	329
11809	3	4	4	318	0	329
11810	9	3	341	5	0	358
11811	4	7	332	1	0	344
11812	5	334	6	4	0	349
11813	346	7	2	3	0	358
11814	345	6	3	3	0	357
11815	342	8	0	4	0	354
11816	12	343	1	1	0	357
11817	8	366	1	2	0	377
11818	7	4	2	368	0	381
11819	9	4	4	355	0	372
11820	5	4	352	5	0	366
11821	7	1	3	350	0	361
11822	353	0	4	8	0	365
11823	6	2	5	333	0	346
11824	5	346	3	4	0	358
11825	348	4	2	5	0	359
11826	346	2	1	6	0	355
11827	348	3	2	4	0	357
11828	6	3	341	5	0	355
11829	8	1	4	340	0	353
11830	354	1	4	9	0	368
11831	6	0	374	5	0	385
11832	6	360	6	3	0	375
11833	4	331	5	1	0	341
11834	318	3	1	3	0	325
11835	2	317	1	4	0	324
11836	2	4	0	297	0	303
11837	3	1	309	2	0	315
11838	3	2	1	299	0	305
11839	303	2	1	5	0	311
11840	2	301	0	3	0	306
11841	303	2	0	4	0	309
11842	3	2	300	2	0	307
11843	3	1	2	303	0	309
11844	2	342	1	4	0	349
11845	2	2	2	338	0	344
11846	337	1	1	6	0	345
11847	346	2	1	2	0	351
11848	348	0	1	4	0	353
11849	352	0	1	1	0	354
11850	5	0	0	348	0	353
11851	2	0	354	5	0	361
11852	2	0	3	343	0	348
11853	1	355	3	3	0	362
11854	358	2	2	5	0	367
11855	2	3	354	1	0	360
11856	347	2	2	2	0	353
11857	6	1	1	360	0	368
11858	2	1	370	2	0	375
11859	4	0	3	366	0	373
11860	378	0	2	6	0	386
11861	379	1	2	5	0	387
11862	381	1	0	3	0	385
11863	5	2	384	1	0	392
11864	7	0	2	376	0	385
11865	2	0	395	3	0	400
11866	1	396	3	1	0	401
11867	378	3	1	3	0	385
11868	2	372	2	2	0	378
11869	336	2	0	2	0	340
11870	3	2	0	333	0	338
11871	2	339	1	1	0	343
11872	336	2	0	4	0	342
11873	2	2	333	1	0	338
11874	1	0	2	342	0	345
11875	340	0	1	5	0	346
11876	3	0	337	1	0	341
11877	1	1	1	327	0	330
11878	2	322	1	1	0	326
11879	0	1	2	342	0	345
11880	0	1	0	338	0	339
11881	337	1	0	2	0	340
11882	1	336	0	2	0	339
11883	2	1	0	330	0	333
11884	1	341	0	0	0	342
11885	2	1	0	331	0	334
11886	1	327	1	2	0	331
11887	330	1	0	2	0	333
11888	1	0	335	0	0	336
11889	1	0	1	333	0	335
11890	0	1	0	339	0	340
11891	1	0	0	341	0	342
11892	2	0	1	338	0	341
11893	1	0	334	2	0	337
11894	0	341	0	1	0	342
11895	338	0	1	1	0	340
11896	341	0	0	2	0	343
11897	2	343	0	0	0	345
11898	341	1	0	1	0	343
11899	339	1	0	0	0	340
11900	1	355	2	0	0	358
11901	1	1	0	351	0	353
11902	1	350	1	2	0	354
11903	354	2	0	3	0	359
11904	2	0	345	0	0	347
11905	321	1	1	1	0	324
11906	3	0	354	0	0	357
11907	1	0	1	348	0	350
11908	348	0	0	1	0	349
11909	2	1	331	0	0	334
11910	313	0	2	2	0	317
11911	326	1	0	2	0	329
11912	3	0	0	327	0	330
11913	1	323	1	0	0	325
11914	327	1	0	2	0	330
11915	2	1	0	321	0	324
11916	1	323	0	2	0	326
11917	311	1	0	5	0	317
11918	4	0	1	314	0	319
11919	0	322	0	2	0	324
11920	0	2	0	330	0	332
11921	326	1	1	2	0	330
11922	318	0	1	3	0	322
11923	326	1	0	1	0	328
11924	2	0	0	320	0	322
11925	1	0	2	319	0	322
11926	0	0	320	3	0	323
11927	2	0	2	314	0	318
11928	1	0	335	2	0	338
11929	2	0	314	2	0	318
11930	0	0	309	0	0	309
11931	0	329	1	0	0	330
11932	2	0	1	310	0	313
11933	0	340	1	1	0	342
11934	340	0	2	3	0	345
11935	347	1	0	6	0	354
11936	1	1	1	362	0	365
11937	1	0	371	1	0	373
11938	1	1	3	367	0	372
11939	1	0	378	3	0	382
11940	3	0	3	369	0	375
11941	0	377	1	2	0	380
11942	1	394	1	0	0	396
11943	384	3	0	3	0	390
11944	3	1	368	1	0	373
11945	1	0	4	373	0	378
11946	0	0	2	377	0	379
11947	372	2	1	4	0	379
11948	6	374	3	2	0	385
11949	378	4	1	3	0	386
11950	3	406	0	4	0	413
11951	401	3	3	3	0	410
11952	395	1	1	6	0	403
11953	4	1	3	403	0	411
11954	2	0	394	6	0	402
11955	371	3	1	4	0	379
11956	4	409	1	0	0	414
11957	411	3	0	1	0	415
11958	5	2	3	390	0	400
11959	5	0	1	390	0	396
11960	1	394	1	6	0	402
11961	6	4	0	383	0	393
11962	1	393	3	3	0	400
11963	5	3	0	387	0	395
11964	4	6	0	377	0	387
11965	374	1	0	4	0	379
11966	6	0	370	3	0	379
11967	1	365	3	3	0	372
11968	2	5	4	371	0	382
11969	384	0	0	8	0	392
11970	389	3	0	5	0	397
11971	394	0	1	3	0	398
11972	4	1	383	3	0	391
11973	383	0	3	5	0	391
11974	5	2	2	398	0	407
11975	403	1	0	8	0	412
11976	4	395	0	2	0	401
11977	6	3	1	400	0	410
11978	389	0	0	8	0	397
11979	8	412	0	3	0	423
11980	4	6	4	416	0	430
11981	1	5	407	6	0	419
11982	414	1	5	7	0	427
11983	436	1	1	4	0	442
11984	11	2	436	1	0	450
11985	5	418	9	2	0	434
11986	1	447	5	1	0	454
11987	7	10	2	442	0	461
11988	3	2	1	422	0	428
11989	4	2	3	439	0	448
11990	3	5	438	8	0	454
11991	419	3	7	8	0	437
11992	452	2	1	3	0	458
11993	452	4	1	2	0	459
11994	472	1	0	9	0	482
11995	474	0	5	4	0	483
11996	481	1	1	2	0	485
11997	17	1	0	521	0	539
11998	8	0	516	14	0	538
11999	3	4	528	5	0	540
12000	4	6	17	498	0	525
12001	5	2	5	506	0	518
12002	4	0	2	503	0	509
12003	4	505	2	23	0	534
12004	508	14	6	10	0	538
12005	21	526	0	5	0	552
12006	16	15	3	511	0	545
12007	507	6	4	18	0	535
12008	16	514	2	13	0	545
12009	12	15	3	516	0	546
12010	12	8	5	533	0	558
12011	5	4	2	534	0	545
12012	6	517	3	28	0	554
12013	9	16	4	525	0	554
12014	5	10	519	22	0	556
12015	11	4	13	539	0	567
12016	9	5	7	544	0	565
12017	6	10	2	574	0	592
12018	11	2	1	582	0	596
12019	5	10	573	25	0	613
12020	4	565	17	20	0	606
12021	6	17	7	580	0	610
12022	1	12	6	596	0	615
12023	2	6	5	589	0	602
12024	5	548	2	34	0	589
12025	0	592	7	21	0	620
12026	572	27	2	16	0	617
12027	19	11	1	584	0	615
12028	8	4	583	26	0	621
12029	3	572	18	17	0	610
12030	561	18	8	18	0	605
12031	19	10	541	13	0	583
12032	10	10	549	8	0	577
12033	7	3	540	13	0	563
12034	12	15	22	515	0	564
12035	2	4	525	28	0	559
12036	4	507	21	11	0	543
12037	8	17	9	490	0	524
12038	4	10	491	20	0	525
12039	3	4	20	487	0	514
12040	478	5	10	22	0	515
12041	18	7	476	12	0	513
12042	451	2	20	15	0	488
12043	17	477	14	8	0	516
12044	489	18	8	8	0	523
12045	18	11	5	492	0	526
12046	494	4	7	25	0	530
12047	497	4	8	14	0	523
12048	489	5	4	14	0	512
12049	22	500	7	6	0	535
12050	479	16	3	9	0	507
12051	488	6	3	14	0	511
12052	26	3	489	4	0	522
12053	12	482	17	5	0	516
12054	14	19	11	475	0	519
12055	7	11	6	493	0	517
12056	10	2	5	506	0	523
12057	6	8	480	25	0	519
12058	7	8	16	483	0	514
12059	11	5	486	21	0	523
12060	473	6	18	17	0	514
12061	492	2	13	10	0	517
12062	26	5	500	5	0	536
12063	500	3	20	12	0	535
12064	510	5	13	6	0	534
12065	519	3	12	11	0	545
12066	25	1	7	503	0	536
12067	11	4	505	27	0	547
12068	9	508	22	18	0	557
12069	7	16	9	516	0	548
12070	10	11	517	25	0	563
12071	10	7	502	11	0	530
12072	494	5	21	11	0	531
12073	25	535	12	7	0	579
12074	549	18	7	11	0	585
12075	560	8	7	8	0	583
12076	30	554	7	5	0	596
12077	552	20	4	8	0	584
12078	21	6	559	13	0	599
12079	13	8	541	11	0	573
12080	15	4	543	10	0	572
12081	9	528	24	8	0	569
12082	513	16	21	6	0	556
12083	520	12	11	5	0	548
12084	28	494	6	8	0	536
12085	16	516	11	3	0	546
12086	9	19	8	500	0	536
12087	11	11	4	516	0	542
12088	511	7	5	22	0	545
12089	20	502	5	15	0	542
12090	505	15	8	12	0	540
12091	496	8	15	6	0	525
12092	23	8	500	5	0	536
12093	19	499	12	4	0	534
12094	16	10	8	481	0	515
12095	486	8	8	11	0	513
12096	22	3	8	467	0	500
12097	433	5	2	8	0	448
12098	12	1	419	6	0	438
12099	7	407	4	6	0	424
12100	7	430	4	5	0	446
12101	5	5	6	411	0	427
12102	2	430	5	6	0	443
12103	426	4	4	4	0	438
12104	5	1	418	2	0	426
12105	399	4	5	9	0	417
12106	6	2	430	3	0	441
12107	6	2	5	420	0	433
12108	5	0	2	429	0	436
12109	6	2	3	421	0	432
12110	424	3	2	5	0	434
12111	8	0	422	2	0	432
12112	5	1	6	416	0	428
12113	3	1	3	414	0	421
12114	4	401	4	3	0	412
12115	1	401	3	2	0	407
12116	3	414	0	4	0	421
12117	3	9	1	395	0	408
12118	2	2	0	381	0	385
12119	0	370	0	2	0	372
12120	0	370	0	1	0	371
12121	376	2	0	3	0	381
12122	4	3	0	369	0	376
12123	0	370	0	1	0	371
12124	373	1	0	1	0	375
12125	3	0	0	371	0	374
12126	428	0	1	3	0	432
12127	3	2	0	436	0	441
12128	0	0	431	4	0	435
12129	1	445	2	0	0	448
12130	436	3	1	4	0	444
12131	3	0	448	2	0	453
12132	0	438	3	0	0	441
12133	0	2	1	457	0	460
12134	1	0	0	456	0	457
12135	1	0	0	452	0	453
12136	3	0	0	435	0	438
12137	0	1	456	2	0	459
12138	0	449	2	0	0	451
12139	1	3	0	452	0	456
12140	438	0	0	2	0	440
12141	2	440	2	0	0	444
12142	0	2	0	471	0	473
12143	0	0	467	2	0	469
12144	0	469	1	1	0	471
12145	1	4	0	417	0	422
12146	0	486	1	2	0	489
12147	498	4	1	2	0	505
12148	507	2	0	0	0	509
12149	4	1	475	1	0	481
12150	482	1	3	0	0	486
12151	495	0	1	2	0	498
12152	6	1	477	0	0	484
12153	2	470	5	0	0	477
12154	2	3	1	480	0	486
12155	2	2	1	499	0	504
12156	489	1	1	7	0	498
12157	4	1	0	494	0	499
12158	2	0	497	6	0	505
12159	470	0	4	4	0	478
12160	6	0	487	1	0	494
12161	2	486	7	2	0	497
12162	470	4	3	2	0	479
12163	5	3	478	1	0	487
12164	2	1	448	1	0	452
12165	2	462	8	1	0	473
12166	2	4	2	478	0	486
12167	0	2	471	4	0	477
12168	3	2	4	415	0	424
12169	1	1	3	455	0	460
12170	0	0	448	8	0	456
12171	1	433	8	3	0	445
12172	1	4	3	442	0	450
12173	428	2	2	6	0	438
12174	416	2	1	3	0	422
12175	8	2	0	417	0	427
12176	3	0	416	5	0	424
12177	2	0	419	3	0	424
12178	1	1	6	414	0	422
12179	0	1	408	5	0	414
12180	400	2	6	2	0	410
12181	7	0	4	409	0	420
12182	4	1	1	413	0	419
12183	1	415	3	7	0	426
12184	5	4	0	420	0	429
12185	1	3	414	8	0	426
12186	402	1	7	5	0	415
12187	419	2	2	3	0	426
12188	9	0	431	1	0	441
12189	5	0	6	451	0	462
12190	3	1	4	455	0	463
12191	0	1	460	12	0	473
12192	3	1	9	460	0	473
12193	2	0	4	469	0	475
12194	0	469	7	13	0	489
12195	2	10	1	495	0	508
12196	3	3	0	515	0	521
12197	497	2	4	19	0	522
12198	509	1	2	10	0	522
12199	520	1	3	6	0	530
12200	515	3	1	4	0	523
12201	515	0	2	5	0	522
12202	23	3	484	3	0	513
12203	13	1	17	478	0	509
12204	6	1	5	498	0	510
12205	5	1	484	22	0	512
12206	463	1	18	9	0	491
12207	483	1	5	5	0	494
12208	25	1	440	4	0	470
12209	476	0	17	7	0	500
12210	496	3	6	3	0	508
12211	24	2	483	1	0	510
12212	12	0	18	472	0	502
12213	6	497	7	16	0	526
12214	8	21	5	512	0	546
12215	10	4	3	531	0	548
12216	9	2	5	522	0	538
12217	3	3	498	28	0	532
12218	487	0	19	16	0	522
12219	519	2	9	5	0	535
12220	28	1	4	495	0	528
12221	9	2	487	25	0	523
12222	8	2	19	485	0	514
12223	5	1	497	25	0	528
12224	6	0	530	10	0	546
12225	5	525	24	3	0	557
12226	13	16	11	456	0	496
12227	451	6	8	18	0	483
12228	461	1	4	11	0	477
12229	467	2	5	7	0	481
12230	21	1	8	443	0	473
12231	9	468	2	18	0	497
12232	6	16	2	477	0	501
12233	3	6	483	22	0	514
12234	514	3	19	10	0	546
12235	565	2	7	5	0	579
12236	29	0	5	544	0	578
12237	17	3	3	552	0	575
12238	10	1	2	572	0	585
12239	4	1	539	31	0	575
12240	496	1	17	15	0	529
12241	19	527	13	7	0	566
12242	8	519	5	9	0	541
12243	4	20	501	6	0	531
12244	7	7	17	496	0	527
12245	5	3	504	23	0	535
12246	491	2	20	11	0	524
12247	20	3	10	481	0	514
12248	10	2	476	21	0	509
12249	6	493	20	6	0	525
12250	491	16	7	12	0	526
12251	20	6	507	4	0	537
12252	12	493	21	3	0	529
12253	7	508	7	6	0	528
12254	502	22	5	5	0	534
12255	18	9	3	509	0	539
12256	14	3	526	21	0	564
12257	8	522	22	8	0	560
12258	521	17	9	9	0	556
12259	527	10	2	7	0	546
12260	22	520	4	9	0	555
12261	8	18	533	8	0	567
12262	10	8	17	532	0	567
12263	535	7	8	18	0	568
12264	544	2	5	10	0	561
12265	27	2	533	5	0	567
12266	16	5	17	523	0	561
12267	9	1	13	540	0	563
12268	4	3	535	29	0	571
12269	6	3	536	11	0	556
12270	532	4	23	8	0	567
12271	560	2	12	3	0	577
12272	565	2	3	14	0	584
12273	560	1	12	6	0	579
12274	28	2	536	5	0	571
12275	544	3	21	5	0	573
12276	29	0	8	536	0	573
12277	13	3	593	20	0	629
12278	10	5	601	10	0	626
12279	7	595	28	8	0	638
12280	7	13	11	591	0	622
12281	11	8	597	20	0	636
12282	574	6	21	13	0	614
12283	21	7	13	535	0	576
12284	12	584	5	21	0	622
12285	589	17	7	7	0	620
12286	594	6	9	10	0	619
12287	28	4	593	5	0	630
12288	12	566	18	10	0	606
12289	5	11	10	553	0	579
12290	551	10	3	18	0	582
12291	18	0	10	540	0	568
12292	11	3	525	14	0	553
12293	475	6	14	8	0	503
12294	15	509	5	6	0	535
12295	8	482	3	5	0	498
12296	5	501	4	5	0	515
12297	498	9	5	4	0	516
12298	489	6	5	3	0	503
12299	490	1	2	3	0	496
12300	13	6	1	484	0	504
12301	6	7	494	4	0	511
12302	6	3	7	486	0	502
12303	503	1	6	6	0	516
12304	13	0	3	493	0	509
12305	512	2	2	8	0	524
12306	511	2	4	10	0	527
12307	515	1	3	5	0	524
12308	11	510	4	6	0	531
12309	513	4	7	2	0	526
12310	7	5	497	5	0	514
12311	9	1	491	1	0	502
12312	8	501	12	2	0	523
12313	7	3	3	486	0	499
12314	483	4	7	4	0	498
12315	6	3	471	4	0	484
12316	463	4	3	2	0	472
12317	3	1	6	467	0	477
12318	5	467	6	2	0	480
12319	5	4	2	485	0	496
12320	5	5	474	4	0	488
12321	446	1	5	9	0	461
12322	4	2	494	1	0	501
12323	8	1	467	3	0	479
12324	444	2	8	4	0	458
12325	8	462	4	1	0	475
12326	476	2	2	3	0	483
12327	471	4	4	1	0	480
12328	9	1	458	2	0	470
12329	448	3	2	5	0	458
12330	6	0	451	1	0	458
12331	6	0	413	3	0	422
12332	0	1	444	4	0	449
12333	2	427	5	2	0	436
12334	377	3	11	5	0	396
12335	374	1	1	6	0	382
12336	382	0	1	0	0	383
12337	369	0	0	1	0	370
12338	3	0	377	0	0	380
12339	3	0	1	370	0	374
12340	3	0	2	372	0	377
12341	378	0	0	2	0	380
12342	0	374	0	4	0	378
12343	3	1	0	375	0	379
12344	370	1	0	0	0	371
12345	0	0	372	1	0	373
12346	3	1	0	359	0	363
12347	0	0	372	1	0	373
12348	0	371	2	1	0	374
12349	0	1	1	363	0	365
12350	361	1	0	2	0	364
12351	1	0	0	369	0	370
12352	1	0	364	2	0	367
12353	0	365	1	1	0	367
12354	352	2	4	3	0	361
12355	2	1	353	0	0	356
12356	333	0	2	2	0	337
12357	2	355	1	0	0	358
12358	365	2	1	0	0	368
12359	371	1	0	0	0	372
12360	4	0	0	380	0	384
12361	2	0	382	2	0	386
12362	0	382	2	2	0	386
12363	4	1	2	388	0	395
12364	0	2	0	394	0	396
12365	0	0	0	425	0	425
12366	2	0	0	434	0	436
12367	0	476	0	8	0	484
12368	504	5	1	6	0	516
12369	6	507	1	1	0	515
12370	8	7	1	526	0	542
12371	528	5	1	11	0	545
12372	11	1	0	533	0	545
12373	4	5	519	11	0	539
12374	1	522	12	6	0	541
12375	8	8	4	521	0	541
12376	2	8	2	537	0	549
12377	486	1	2	19	0	508
12378	12	5	469	6	0	492
12379	464	1	11	9	0	485
12380	470	1	5	6	0	482
12381	486	2	0	6	0	494
12382	19	2	472	3	0	496
12383	14	5	12	460	0	491
12384	6	1	5	475	0	487
12385	3	3	482	16	0	504
12386	4	3	479	10	0	496
12387	472	0	20	5	0	497
12388	17	2	7	484	0	510
12389	487	0	5	14	0	506
12390	500	3	1	8	0	512
12391	23	3	3	489	0	518
12392	10	1	506	16	0	533
12393	494	3	12	10	0	519
12394	23	0	11	503	0	537
12395	10	1	513	15	0	539
12396	7	511	15	9	0	542
12397	499	12	7	8	0	526
12398	18	513	3	5	0	539
12399	11	14	5	462	0	492
12400	3	510	3	17	0	533
12401	501	13	4	6	0	524
12402	503	4	8	7	0	522
12403	22	493	2	5	0	522
12404	506	13	5	7	0	531
12405	506	7	1	7	0	521
12406	22	485	7	3	0	517
12407	493	17	1	6	0	517
12408	18	8	3	484	0	513
12409	13	7	6	491	0	517
12410	493	6	2	21	0	522
12411	25	1	2	465	0	493
12412	7	467	4	15	0	493
12413	462	17	1	4	0	484
12414	463	9	2	2	0	476
12415	22	461	1	14	0	498
12416	476	16	3	7	0	502
12417	480	7	3	7	0	497
12418	28	5	1	455	0	489
12419	13	4	453	17	0	487
12420	5	459	14	9	0	487
12421	459	16	5	7	0	487
12422	467	10	1	6	0	484
12423	23	3	450	8	0	484
12424	445	6	15	5	0	471
12425	21	4	427	7	0	459
12426	440	4	13	6	0	463
12427	24	4	5	433	0	466
12428	13	5	434	16	0	468
12429	10	6	446	7	0	469
12430	13	10	18	425	0	466
12431	14	4	4	443	0	465
12432	11	2	428	19	0	460
12433	10	2	20	420	0	452
12434	7	5	419	22	0	453
12435	12	2	18	415	0	447
12436	10	6	10	405	0	431
12437	7	393	10	17	0	427
12438	13	400	5	10	0	428
12439	6	416	8	9	0	439
12440	12	15	5	412	0	444
12441	9	9	10	410	0	438
12442	5	4	405	26	0	440
12443	397	2	23	14	0	436
12444	416	4	7	9	0	436
12445	21	399	8	8	0	436
12446	407	16	8	7	0	438
12447	20	9	4	410	0	443
12448	419	5	4	19	0	447
12449	415	7	6	15	0	443
12450	21	5	6	412	0	444
12451	392	5	4	22	0	423
12452	18	387	4	11	0	420
12453	10	399	4	6	0	419
12454	10	17	3	379	0	409
12455	12	409	1	17	0	439
12456	10	16	6	396	0	428
12457	10	7	2	412	0	431
12458	397	3	3	18	0	421
12459	16	370	5	16	0	407
12460	373	14	2	7	0	396
12461	362	8	1	10	0	381
12462	16	354	2	5	0	377
12463	344	15	3	5	0	367
12464	17	4	348	6	0	375
12465	9	314	9	6	0	338
12466	296	14	5	5	0	320
12467	12	2	267	3	0	284
12468	3	229	8	4	0	244
12469	0	244	2	4	0	250
12470	215	4	2	0	0	221
12471	215	0	1	3	0	219
12472	225	2	1	3	0	231
12473	3	213	2	2	0	220
12474	3	6	0	221	0	230
12475	217	3	1	5	0	226
12476	223	2	0	2	0	227
12477	3	3	1	220	0	227
12478	1	3	217	5	0	226
12479	3	1	211	3	0	218
12480	4	1	3	230	0	238
12481	3	2	0	231	0	236
12482	3	1	225	3	0	232
12483	3	1	5	216	0	225
12484	3	225	0	4	0	232
12485	226	2	1	4	0	233
12486	5	1	3	219	0	228
12487	217	0	1	3	0	221
12488	3	227	1	3	0	234
12489	3	231	1	1	0	236
12490	232	3	1	2	0	238
12491	3	3	219	1	0	226
12492	186	2	3	1	0	192
12493	2	198	0	1	0	201
12494	2	2	1	191	0	196
12495	189	0	2	3	0	194
12496	2	1	0	187	0	190
12497	185	1	0	6	0	192
12498	182	0	1	3	0	186
12499	3	197	1	1	0	202
12500	201	1	1	2	0	205
12501	1	196	1	1	0	199
12502	200	1	1	2	0	204
12503	1	2	0	198	0	201
12504	198	1	0	3	0	202
12505	1	1	1	208	0	211
12506	220	0	0	1	0	221
12507	224	1	0	1	0	226
12508	225	0	0	0	0	225
12509	218	0	0	2	0	220
12510	223	0	0	0	0	223
12511	2	1	0	221	0	224
12512	222	1	0	1	0	224
12513	3	218	1	0	0	222
12514	1	1	220	0	0	222
12515	2	0	1	218	0	221
12516	1	1	226	1	0	229
12517	0	0	1	226	0	227
12518	1	0	232	1	0	234
12519	233	0	1	2	0	236
12520	2	0	1	236	0	239
12521	1	0	234	1	0	236
12522	1	1	238	1	0	241
12523	1	1	1	260	0	263
12524	290	1	0	1	0	292
12525	4	299	0	0	0	303
12526	299	3	0	1	0	303
12527	300	0	0	0	0	300
12528	3	294	2	1	0	300
12529	301	3	0	1	0	305
12530	4	1	0	298	0	303
12531	1	0	0	299	0	300
12532	2	0	0	303	0	305
12533	295	0	0	4	0	299
12534	3	291	1	1	0	296
12535	2	3	0	294	0	299
12536	0	1	0	306	0	307
12537	300	0	1	5	0	306
12538	4	0	0	302	0	306
12539	1	1	299	3	0	304
12540	1	315	3	2	0	321
12541	309	3	1	2	0	315
12542	4	0	0	305	0	309
12543	0	307	0	4	0	311
12544	311	2	1	2	0	316
12545	2	0	311	1	0	314
12546	1	301	2	0	0	304
12547	303	2	0	2	0	307
12548	2	0	0	302	0	304
12549	1	0	0	303	0	304
12550	1	1	299	3	0	304
12551	3	0	3	286	0	292
12552	1	0	341	2	0	344
12553	1	2	316	1	0	320
12554	1	2	345	0	0	348
12555	347	0	3	2	0	352
12556	350	0	0	1	0	351
12557	354	0	0	0	0	354
12558	3	1	1	352	0	357
12559	1	354	0	3	0	358
12560	3	359	3	0	0	365
12561	359	4	0	1	0	364
12562	367	1	0	1	0	369
12563	2	368	1	1	0	372
12564	356	3	0	6	0	365
12565	2	0	357	2	0	361
12566	2	1	341	1	0	345
12567	1	1	4	327	0	333
12568	2	0	0	356	0	358
12569	2	0	363	3	0	368
12570	2	1	2	350	0	355
12571	356	0	0	5	0	361
12572	2	4	351	1	0	358
12573	346	2	2	2	0	352
12574	6	0	0	362	0	368
12575	1	2	392	3	0	398
12576	1	406	3	0	0	410
12577	406	2	0	2	0	410
12578	3	0	397	1	0	401
12579	397	2	3	1	0	403
12580	5	0	0	390	0	395
12581	393	0	1	5	0	399
12582	2	0	424	3	0	429
12583	1	0	3	433	0	437
12584	443	0	0	6	0	449
12585	453	0	2	3	0	458
12586	472	0	1	6	0	479
12587	476	1	1	2	0	480
12588	7	0	2	455	0	464
12589	4	1	1	461	0	467
12590	2	1	466	2	0	471
12591	3	0	3	454	0	460
12592	3	2	1	439	0	445
12593	1	460	0	3	0	464
12594	467	1	0	3	0	471
12595	473	0	1	2	0	476
12596	2	501	1	4	0	508
12597	4	4	1	510	0	519
12598	4	2	1	519	0	526
12599	497	1	2	8	0	508
12600	6	1	516	4	0	527
12601	4	0	6	525	0	535
12602	1	0	545	5	0	551
12603	512	0	5	8	0	525
12604	540	0	3	2	0	545
12605	533	0	2	3	0	538
12606	9	1	1	516	0	527
12607	4	1	0	514	0	519
12608	517	1	3	7	0	528
12609	5	2	517	4	0	528
12610	7	1	4	514	0	526
12611	518	0	5	6	0	529
12612	6	1	2	518	0	527
12613	5	0	551	6	0	562
12614	1	2	520	5	0	528
12615	508	0	11	6	0	525
12616	6	539	4	2	0	551
12617	560	4	0	2	0	566
12618	563	3	1	3	0	570
12619	7	0	0	561	0	568
12620	6	0	0	549	0	555
12621	2	549	2	6	0	559
12622	539	4	1	2	0	546
12623	6	547	0	1	0	554
12624	3	537	0	6	0	546
12625	1	5	1	542	0	549
12626	537	4	1	4	0	546
12627	546	0	0	5	0	551
12628	5	1	1	543	0	550
12629	3	0	0	541	0	544
12630	1	0	0	547	0	548
12631	527	0	0	7	0	534
12632	2	0	535	4	0	541
12633	3	530	2	0	0	535
12634	537	2	3	3	0	545
12635	3	7	0	536	0	546
12636	3	1	530	2	0	536
12637	0	1	520	6	0	527
12638	2	530	5	0	0	537
12639	1	572	5	0	0	578
12640	1	7	1	546	0	555
12641	0	503	0	2	0	505
12642	3	2	0	542	0	547
12643	3	4	0	552	0	559
12644	553	0	2	10	0	565
12645	3	1	0	555	0	559
12646	5	0	1	553	0	559
12647	2	0	550	7	0	559
12648	2	0	4	548	0	554
12649	548	1	5	10	0	564
12650	551	1	1	9	0	562
12651	5	580	2	2	0	589
12652	546	3	1	4	0	554
12653	2	6	526	0	0	534
12654	5	524	4	0	0	533
12655	2	4	4	529	0	539
12656	3	4	0	534	0	541
12657	4	2	0	536	0	542
12658	527	0	2	11	0	540
12659	510	0	1	13	0	524
12660	7	1	525	3	0	536
12661	7	0	516	0	0	523
12662	3	1	516	2	0	522
12663	3	514	9	0	0	526
12664	2	531	4	3	0	540
12665	523	6	2	4	0	535
12666	525	4	0	1	0	530
12667	8	1	2	528	0	539
12668	6	1	0	518	0	525
12669	2	520	0	8	0	530
12670	5	2	1	528	0	536
12671	1	5	526	3	0	535
12672	2	525	4	3	0	534
12673	7	2	5	535	0	549
12674	0	5	562	3	0	570
12675	8	1	6	504	0	519
12676	3	528	4	3	0	538
12677	544	6	0	7	0	557
12678	536	6	0	4	0	546
12679	545	2	0	4	0	551
12680	13	1	0	548	0	562
12681	7	3	0	548	0	558
12682	529	3	0	12	0	544
12683	7	521	0	6	0	534
12684	540	6	0	5	0	551
12685	7	5	579	2	0	593
12686	569	1	9	7	0	586
12687	591	0	3	6	0	600
12688	15	0	2	588	0	605
12689	595	0	1	12	0	608
12690	608	3	2	8	0	621
12691	15	2	0	602	0	619
12692	9	1	594	7	0	611
12693	573	1	9	8	0	591
12694	10	2	603	1	0	616
12695	6	610	11	2	0	629
12696	2	7	9	589	0	607
12697	1	2	2	602	0	607
12698	638	0	2	10	0	650
12699	11	2	635	1	0	649
12700	5	2	10	610	0	627
12701	2	620	3	8	0	633
12702	4	622	1	4	0	631
12703	6	11	1	625	0	643
12704	1	2	623	12	0	638
12705	4	2	11	622	0	639
12706	6	4	4	614	0	628
12707	1	3	603	13	0	620
12708	0	633	10	4	0	647
12709	601	9	3	3	0	616
12710	8	635	1	3	0	647
12711	6	11	1	627	0	645
12712	604	4	2	14	0	624
12713	10	601	4	2	0	617
12714	3	12	605	1	0	621
12715	579	4	10	4	0	597
12716	10	613	4	3	0	630
12717	603	12	0	11	0	626
12718	14	4	593	1	0	612
12719	587	1	11	1	0	600
12720	13	2	3	595	0	613
12721	6	3	605	11	0	625
12722	4	3	12	599	0	618
12723	3	585	4	11	0	603
12724	3	9	3	591	0	606
12725	2	1	2	602	0	607
12726	2	1	577	16	0	596
12727	3	3	10	573	0	589
12728	4	4	511	14	0	533
12729	5	590	4	3	0	602
12730	2	12	2	589	0	605
12731	2	3	596	14	0	615
12732	2	590	14	4	0	610
12733	1	625	4	3	0	633
12734	5	13	602	3	0	623
12735	4	3	600	0	0	607
12736	3	5	12	594	0	614
12737	581	4	3	17	0	605
12738	12	591	5	1	0	609
12739	3	15	3	561	0	582
12740	559	1	3	19	0	582
12741	17	575	2	4	0	598
12742	575	16	0	5	0	596
12743	11	592	2	4	0	609
12744	596	15	1	7	0	619
12745	595	4	1	4	0	604
12746	603	4	2	4	0	613
12747	21	644	0	5	0	670
12748	10	15	2	632	0	659
12749	8	6	631	17	0	662
12750	7	617	17	8	0	649
12751	7	17	6	607	0	637
12752	5	8	2	636	0	651
12753	8	2	613	19	0	642
12754	6	604	18	4	0	632
12755	597	17	6	9	0	629
12756	20	596	3	7	0	626
12757	12	16	4	594	0	626
12758	2	8	596	20	0	626
12759	582	3	18	8	0	611
12760	20	3	4	594	0	621
12761	5	4	587	23	0	619
12762	567	2	20	5	0	594
12763	18	583	9	4	0	614
12764	582	17	1	9	0	609
12765	582	7	0	4	0	593
12766	24	4	3	570	0	601
12767	4	5	575	23	0	607
12768	6	571	23	6	0	606
12769	4	21	573	6	0	604
12770	5	9	17	559	0	590
12771	2	7	9	586	0	604
12772	561	7	2	27	0	597
12773	22	3	574	6	0	605
12774	6	552	18	5	0	581
12775	4	19	4	562	0	589
12776	11	7	2	573	0	593
12777	533	5	7	21	0	566
12778	20	541	4	5	0	570
12779	8	18	0	529	0	555
12780	496	7	2	26	0	531
12781	20	510	2	8	0	540
12782	496	18	2	4	0	520
12783	507	8	2	6	0	523
12784	21	482	2	5	0	510
12785	411	13	2	5	0	431
12786	13	423	2	3	0	441
12787	416	13	2	4	0	435
12788	405	6	3	4	0	418
12789	17	408	2	4	0	431
12790	380	14	1	6	0	401
12791	390	3	1	3	0	397
12792	394	3	1	4	0	402
12793	16	4	370	3	0	393
12794	6	2	376	4	0	388
12795	4	1	376	4	0	385
12796	365	2	16	5	0	388
12797	13	1	364	2	0	380
12798	4	2	310	2	0	318
12799	7	3	9	293	0	312
12800	302	1	3	8	0	314
12801	9	2	306	2	0	319
12802	2	1	313	1	0	317
12803	3	1	9	304	0	317
12804	3	1	3	309	0	316
12805	4	2	2	318	0	326
12806	3	1	317	10	0	331
12807	3	1	10	311	0	325
12808	306	2	3	9	0	320
12809	9	311	1	6	0	327
12810	6	7	2	304	0	319
12811	4	3	3	312	0	322
12812	1	4	312	11	0	328
12813	4	304	11	3	0	322
12814	307	11	3	4	0	325
12815	11	312	1	4	0	328
12816	3	8	6	311	0	328
12817	2	2	309	10	0	323
12818	4	1	10	320	0	335
12819	4	3	5	331	0	343
12820	330	2	3	13	0	348
12821	9	1	5	309	0	324
12822	4	313	1	12	0	330
12823	5	332	2	4	0	343
12824	3	13	326	2	0	344
12825	328	2	11	4	0	345
12826	8	2	4	331	0	345
12827	3	3	3	340	0	349
12828	2	1	3	350	0	356
12829	331	0	1	15	0	347
12830	10	347	1	9	0	367
12831	342	9	3	3	0	357
12832	6	8	326	3	0	343
12833	3	2	330	4	0	339
12834	324	2	9	4	0	339
12835	10	3	9	325	0	347
12836	6	3	1	337	0	347
12837	4	2	1	340	0	347
12838	4	1	330	10	0	345
12839	327	3	7	5	0	342
12840	337	0	5	3	0	345
12841	326	1	3	3	0	333
12842	10	3	2	313	0	328
12843	7	1	303	6	0	317
12844	4	2	299	2	0	307
12845	4	1	306	3	0	314
12846	2	296	10	6	0	314
12847	4	2	5	257	0	268
12848	256	0	2	6	0	264
12849	3	0	267	3	0	273
12850	253	0	4	5	0	262
12851	6	0	2	262	0	270
12852	4	2	2	253	0	261
12853	3	252	1	6	0	262
12854	4	244	4	3	0	255
12855	1	262	5	0	0	268
12856	2	4	4	266	0	276
12857	265	0	1	5	0	271
12858	268	1	4	5	0	278
12859	4	2	264	2	0	272
12860	260	0	3	6	0	269
12861	7	1	268	2	0	278
12862	5	2	3	272	0	282
12863	5	0	271	6	0	282
12864	274	0	3	5	0	282
12865	3	1	2	281	0	287
12866	2	4	288	3	0	297
12867	2	1	272	1	0	276
12868	270	3	4	2	0	279
12869	275	2	1	4	0	282
12870	4	288	5	2	0	299
12871	5	1	2	294	0	302
12872	3	1	301	2	0	307
12873	4	2	286	3	0	295
12874	4	0	3	292	0	299
12875	283	1	7	4	0	295
12876	3	280	2	3	0	288
12877	2	4	1	289	0	296
12878	290	1	0	5	0	296
12879	5	1	2	288	0	296
12880	4	280	2	2	0	288
12881	3	3	2	290	0	298
12882	291	1	1	4	0	297
12883	5	2	2	289	0	298
12884	287	0	3	6	0	296
12885	2	296	2	3	0	303
12886	311	1	3	1	0	316
12887	3	1	304	3	0	311
12888	298	0	3	4	0	305
12889	304	2	2	2	0	310
12890	2	306	1	2	0	311
12891	5	1	1	298	0	305
12892	1	2	306	3	0	312
12893	2	2	302	1	0	307
12894	271	6	3	2	0	282
12895	267	0	0	2	0	269
12896	3	269	1	2	0	275
12897	2	270	1	2	0	275
12898	273	2	2	3	0	280
12899	3	269	1	1	0	274
12900	1	280	1	1	0	283
12901	5	3	0	271	0	279
12902	1	1	0	277	0	279
12903	0	1	276	3	0	280
12904	2	0	2	275	0	279
12905	277	0	2	1	0	280
12906	1	2	272	0	0	275
12907	2	0	273	2	0	277
12908	3	0	3	268	0	274
12909	2	1	1	283	0	287
12910	2	1	1	276	0	280
12911	1	1	278	1	0	281
12912	2	1	0	254	0	257
12913	1	1	2	269	0	273
12914	266	0	0	1	0	267
12915	1	261	1	1	0	264
12916	261	1	1	1	0	264
12917	0	1	262	2	0	265
12918	226	1	1	1	0	229
12919	0	263	1	0	0	264
12920	241	0	1	2	0	244
12921	1	242	0	1	0	244
12922	227	1	0	3	0	231
12923	0	226	0	1	0	227
12924	0	230	0	0	0	230
12925	0	1	0	231	0	232
12926	230	0	0	1	0	231
12927	229	0	0	0	0	229
12928	222	0	0	0	0	222
12929	0	1	224	0	0	225
12930	0	0	217	0	0	217
12931	0	0	0	223	0	223
12932	0	217	1	0	0	218
12933	0	232	0	1	0	233
12934	0	5	0	227	0	232
12935	231	0	0	1	0	232
12936	231	0	0	1	0	232
12937	231	0	0	0	0	231
12938	1	0	233	0	0	234
12939	2	0	0	237	0	239
12940	1	0	240	0	0	241
12941	240	0	0	2	0	242
12942	243	0	1	2	0	246
12943	0	0	247	0	0	247
12944	2	0	0	240	0	242
12945	242	0	1	2	0	245
12946	0	0	0	250	0	250
12947	1	0	0	253	0	254
12948	0	0	0	270	0	270
12949	282	0	0	3	0	285
12950	4	0	0	297	0	301
12951	307	0	0	3	0	310
12952	6	333	0	1	0	340
12953	1	6	0	338	0	345
12954	1	1	0	336	0	338
12955	0	0	0	333	0	333
12956	316	0	0	8	0	324
12957	9	0	0	314	0	323
12958	1	2	0	320	0	323
12959	312	0	0	12	0	324
12960	317	0	0	1	0	318
12961	321	0	0	2	0	323
12962	7	0	303	0	0	310
12963	1	0	291	1	0	293
12964	305	0	7	1	0	313
12965	7	0	1	299	0	307
12966	3	0	0	307	0	310
12967	310	0	0	6	0	316
12968	302	0	1	3	0	306
12969	306	0	0	0	0	306
12970	8	292	0	0	0	300
12971	293	6	0	2	0	301
12972	293	1	0	3	0	297
12973	7	282	0	0	0	289
12974	3	294	0	0	0	297
12975	2	7	0	290	0	299
12976	293	2	1	6	0	302
12977	292	0	0	4	0	296
12978	288	0	0	1	0	289
12979	7	1	0	286	0	294
12980	287	0	0	8	0	295
12981	7	1	289	2	0	299
12982	285	0	5	1	0	291
12983	7	0	297	0	0	304
12984	3	0	292	0	0	295
12985	0	0	7	288	0	295
12986	283	0	1	8	0	292
12987	7	0	1	287	0	295
12988	2	0	289	6	0	297
12989	0	0	296	2	0	298
12990	1	0	6	299	0	306
12991	305	0	1	9	0	315
12992	6	307	0	1	0	314
12993	2	6	0	318	0	326
12994	0	1	1	327	0	329
12995	0	1	328	6	0	335
12996	0	0	319	2	0	321
12997	1	0	7	333	0	341
12998	333	1	1	7	0	342
12999	6	1	332	2	0	341
13000	1	0	6	325	0	332
13001	1	0	2	332	0	335
13002	1	0	0	334	0	335
13003	332	0	0	7	0	339
13004	5	0	318	2	0	325
13005	1	332	6	0	0	339
13006	0	6	1	332	0	339
13007	0	1	328	7	0	336
13008	0	320	6	4	0	330
13009	3	331	1	1	0	336
13010	326	6	0	4	0	336
13011	7	331	2	2	0	342
13012	333	7	0	3	0	343
13013	7	1	334	1	0	343
13014	1	1	6	339	0	347
13015	342	0	1	10	0	353
13016	9	340	1	3	0	353
13017	4	7	340	2	0	353
13018	1	1	7	312	0	321
13019	2	333	3	7	0	345
13020	4	6	0	341	0	351
13021	334	1	0	8	0	343
13022	6	337	2	4	0	349
13023	350	6	3	1	0	360
13024	351	2	1	2	0	356
13025	11	1	349	1	0	362
13026	2	379	8	4	0	393
13027	4	6	2	396	0	408
13028	5	3	407	8	0	423
13029	2	2	454	3	0	461
13030	3	2	18	469	0	492
13031	487	1	4	16	0	508
13032	494	1	0	1	0	496
13033	24	1	0	473	0	498
13034	4	2	476	14	0	496
13035	2	473	17	5	0	497
13036	505	15	2	5	0	527
13037	516	2	1	1	0	520
13038	22	506	0	1	0	529
13039	502	16	1	8	0	527
13040	18	3	498	1	0	520
13041	496	1	17	1	0	515
13042	493	0	3	2	0	498
13043	17	1	487	2	0	507
13044	7	4	17	473	0	501
13045	1	1	484	16	0	502
13046	3	474	16	5	0	498
13047	5	482	2	1	0	490
13048	3	19	2	442	0	466
13049	1	2	455	14	0	472
13050	1	411	15	4	0	431
13051	0	432	5	0	0	437
13052	383	13	0	4	0	400
13053	403	1	2	3	0	409
13054	13	1	2	398	0	414
13055	4	0	0	389	0	393
13056	2	405	2	11	0	420
13057	400	10	2	7	0	419
13058	413	5	1	3	0	422
13059	12	405	2	4	0	423
13060	6	12	2	411	0	431
13061	2	3	419	11	0	435
13062	6	3	10	415	0	434
13063	428	4	3	16	0	451
13064	17	3	0	433	0	453
13065	8	1	2	448	0	459
13066	442	2	4	12	0	460
13067	14	5	1	421	0	441
13068	7	419	3	12	0	441
13069	7	10	2	437	0	456
13070	3	2	5	443	0	453
13071	4	3	1	435	0	443
13072	2	434	4	13	0	453
13073	6	11	0	440	0	457
13074	3	5	434	12	0	454
13075	6	2	13	433	0	454
13076	2	3	433	13	0	451
13077	3	427	10	2	0	442
13078	6	12	3	436	0	457
13079	3	5	2	439	0	449
13080	5	2	1	444	0	452
13081	4	3	4	438	0	449
13082	4	2	427	14	0	447
13083	3	419	13	5	0	440
13084	4	12	5	424	0	445
13085	3	2	428	17	0	450
13086	3	1	12	426	0	442
13087	423	3	3	21	0	450
13088	12	6	402	4	0	424
13089	394	0	12	9	0	415
13090	14	3	8	408	0	433
13091	7	5	407	13	0	432
13092	5	395	13	7	0	420
13093	8	13	6	389	0	416
13094	3	3	401	16	0	423
13095	6	394	14	6	0	420
13096	5	10	5	405	0	425
13097	393	4	4	16	0	417
13098	408	3	5	8	0	424
13099	408	4	4	7	0	423
13100	15	5	399	6	0	425
13101	5	402	16	5	0	428
13102	3	15	4	392	0	414
13103	4	4	4	419	0	431
13104	419	4	3	21	0	447
13105	17	421	3	8	0	449
13106	420	14	4	7	0	445
13107	424	5	2	10	0	441
13108	440	3	4	13	0	460
13109	16	5	426	4	0	451
13110	425	5	13	6	0	449
13111	16	6	2	437	0	461
13112	11	1	4	444	0	460
13113	437	4	3	18	0	462
13114	19	2	3	419	0	443
13115	7	415	3	16	0	441
13116	5	14	3	424	0	446
13117	410	5	4	22	0	441
13118	17	0	411	11	0	439
13119	5	403	13	6	0	427
13120	4	17	1	410	0	432
13121	406	2	3	19	0	430
13122	19	3	393	6	0	421
13123	8	9	15	389	0	421
13124	13	4	390	15	0	422
13125	4	0	368	8	0	380
13126	6	0	363	3	0	372
13127	2	1	357	4	0	364
13128	1	3	337	4	0	345
13129	258	3	18	6	0	285
13130	3	264	4	1	0	272
13131	244	2	1	4	0	251
13132	246	0	1	4	0	251
13133	1	243	2	0	0	246
13134	0	249	2	1	0	252
13135	249	2	1	1	0	253
13136	237	1	1	2	0	241
13137	3	2	0	222	0	227
13138	0	235	2	3	0	240
13139	245	2	0	2	0	249
13140	2	242	2	0	0	246
13141	0	2	0	248	0	250
13142	252	0	1	3	0	256
13143	252	0	1	0	0	253
13144	3	0	1	250	0	254
13145	1	0	1	258	0	260
13146	0	0	251	2	0	253
13147	3	0	2	250	0	255
13148	0	1	258	2	0	261
13149	1	0	2	243	0	246
13150	1	0	0	253	0	254
13151	245	1	0	4	0	250
13152	248	1	0	0	0	249
13153	3	0	237	0	0	240
13154	237	0	2	0	0	239
13155	2	0	0	240	0	242
13156	0	1	248	2	0	251
13157	2	1	2	248	0	253
13158	0	1	0	261	0	262
13159	0	0	256	3	0	259
13160	3	0	2	258	0	263
13161	1	0	270	2	0	273
13162	0	0	2	284	0	286
13163	316	0	0	6	0	322
13164	3	326	1	1	0	331
13165	317	4	1	3	0	325
13166	4	325	0	0	0	329
13167	327	4	1	5	0	337
13168	4	333	0	2	0	339
13169	328	4	0	2	0	334
13170	4	336	0	0	0	340
13171	3	4	1	329	0	337
13172	1	1	343	3	0	348
13173	1	0	334	1	0	336
13174	0	1	4	329	0	334
13175	333	0	0	6	0	339
13176	4	342	2	1	0	349
13177	2	4	1	346	0	353
13178	1	1	343	4	0	349
13179	1	1	353	0	0	355
13180	2	6	4	334	0	346
13181	2	358	1	3	0	364
13182	356	7	0	0	0	363
13183	4	1	377	2	0	384
13184	1	1	373	0	0	375
13185	1	383	7	0	0	391
13186	379	4	0	5	0	388
13187	390	1	1	2	0	394
13188	7	1	1	386	0	395
13189	386	0	1	8	0	395
13190	393	0	2	2	0	397
13191	4	387	1	0	0	392
13192	385	4	0	3	0	392
13193	5	0	389	0	0	394
13194	4	0	7	383	0	394
13195	2	0	1	384	0	387
13196	376	1	1	9	0	387
13197	6	375	2	0	0	383
13198	372	6	1	2	0	381
13199	6	377	2	0	0	385
13200	0	384	0	4	0	388
13201	3	5	374	2	0	384
13202	4	2	355	6	0	367
13203	349	2	5	8	0	364
13204	359	0	1	1	0	361
13205	6	2	353	0	0	361
13206	0	344	5	3	0	352
13207	1	355	3	0	0	359
13208	353	5	2	0	0	360
13209	349	2	1	2	0	354
13210	8	0	1	361	0	370
13211	364	3	0	7	0	374
13212	6	3	0	364	0	373
13213	2	0	371	6	0	379
13214	2	3	357	1	0	363
13215	363	1	5	1	0	370
13216	8	0	2	363	0	373
13217	2	398	2	3	0	405
13218	397	6	0	5	0	408
13219	401	1	4	0	0	406
13220	6	0	397	2	0	405
13221	385	0	4	3	0	392
13222	408	1	1	1	0	411
13223	7	3	1	400	0	411
13224	3	391	4	6	0	404
13225	1	392	3	4	0	400
13226	5	8	2	410	0	425
13227	7	3	1	395	0	406
13228	3	1	2	402	0	408
13229	1	3	397	9	0	410
13230	6	2	384	0	0	392
13231	4	3	9	378	0	394
13232	2	6	389	8	0	405
13233	4	4	392	1	0	401
13234	6	0	8	383	0	397
13235	1	1	428	8	0	438
13236	1	420	9	2	0	432
13237	443	7	0	5	0	455
13238	12	1	3	439	0	455
13239	1	445	3	7	0	456
13240	1	6	454	5	0	466
13241	7	1	7	443	0	458
13242	1	2	460	7	0	470
13243	4	3	5	457	0	469
13244	5	1	4	471	0	481
13245	4	1	478	8	0	491
13246	2	0	10	456	0	468
13247	2	459	4	6	0	471
13248	3	10	2	478	0	493
13249	5	2	477	8	0	492
13250	4	1	5	465	0	475
13251	465	6	2	10	0	483
13252	8	479	2	4	0	493
13253	4	4	2	488	0	498
13254	1	3	494	8	0	506
13255	4	473	8	3	0	488
13256	2	471	5	6	0	484
13257	2	7	482	3	0	494
13258	2	5	6	450	0	463
13259	6	4	2	451	0	463
13260	3	2	455	7	0	467
13261	3	434	8	3	0	448
13262	1	434	2	3	0	440
13263	390	5	1	5	0	401
13264	4	384	2	3	0	393
13265	385	4	3	1	0	393
13266	5	2	1	378	0	386
13267	384	1	0	9	0	394
13268	4	2	392	2	0	400
13269	366	1	6	1	0	374
13270	8	0	1	394	0	403
13271	4	390	2	6	0	402
13272	389	6	2	2	0	399
13273	6	2	0	391	0	399
13274	2	409	2	4	0	417
13275	0	429	1	3	0	433
13276	427	6	0	5	0	438
13277	426	0	2	1	0	429
13278	422	0	1	5	0	428
13279	6	1	0	400	0	407
13280	2	397	2	4	0	405
13281	1	396	3	2	0	402
13282	1	5	0	396	0	402
13283	378	1	1	6	0	386
13284	366	3	1	3	0	373
13285	367	1	1	3	0	372
13286	4	0	370	4	0	378
13287	3	1	354	0	0	358
13288	387	0	7	0	0	394
13289	6	1	1	388	0	396
13290	2	0	3	386	0	391
13291	2	2	1	378	0	383
13292	5	0	0	382	0	387
13293	0	1	389	6	0	396
13294	0	1	2	378	0	381
13295	0	2	382	3	0	387
13296	346	0	2	7	0	355
13297	3	398	4	2	0	407
13298	2	2	0	405	0	409
13299	1	1	1	399	0	402
13300	390	1	1	6	0	398
13301	390	2	0	3	0	395
13302	389	0	1	4	0	394
13303	392	1	0	3	0	396
13304	4	1	389	1	0	395
13305	3	2	366	1	0	372
13306	2	0	4	375	0	381
13307	381	1	2	5	0	389
13308	377	0	2	2	0	381
13309	3	2	371	2	0	378
13310	3	2	2	359	0	366
13311	359	1	2	5	0	367
13312	5	1	1	354	0	361
13313	3	3	351	1	0	358
13314	1	1	1	356	0	359
13315	359	0	3	2	0	364
13316	2	409	2	3	0	416
13317	405	2	1	3	0	411
13318	408	3	0	6	0	417
13319	407	1	1	5	0	414
13320	5	1	1	408	0	415
13321	402	1	0	3	0	406
13322	3	408	1	1	0	413
13323	3	427	1	0	0	431
13324	1	5	1	427	0	434
13325	443	2	0	4	0	449
13326	2	454	1	3	0	460
13327	521	4	1	2	0	528
13328	546	3	0	4	0	553
13329	13	564	2	1	0	580
13330	2	10	0	571	0	583
13331	4	3	0	580	0	587
13332	1	2	585	13	0	601
13333	6	1	8	565	0	580
13334	2	1	582	10	0	595
13335	4	555	9	4	0	572
13336	3	15	4	554	0	576
13337	532	6	0	14	0	552
13338	549	0	1	5	0	555
13339	15	1	0	548	0	564
13340	4	1	535	11	0	551
13341	501	2	8	6	0	517
13342	8	521	5	2	0	536
13343	3	521	0	3	0	527
13344	2	538	4	3	0	547
13345	4	12	0	523	0	539
13346	3	2	551	12	0	568
13347	3	2	10	552	0	567
13348	2	2	549	10	0	563
13349	3	1	539	5	0	548
13350	1	3	554	1	0	559
13351	5	3	12	521	0	541
13352	0	2	4	551	0	557
13353	2	2	2	553	0	559
13354	4	3	2	537	0	546
13355	542	0	2	18	0	562
13356	11	540	5	2	0	558
13357	536	10	2	4	0	552
13358	10	540	5	2	0	557
13359	7	10	2	547	0	566
13360	1	4	2	569	0	576
13361	558	1	1	17	0	577
13362	567	1	2	8	0	578
13363	589	2	1	6	0	598
13364	587	2	0	8	0	597
13365	598	1	3	4	0	606
13366	11	590	1	5	0	607
13367	579	10	1	5	0	595
13368	11	585	1	3	0	600
13369	577	9	1	4	0	591
13370	12	4	584	4	0	604
13371	8	1	10	568	0	587
13372	4	581	2	10	0	597
13373	7	12	0	588	0	607
13374	4	7	572	10	0	593
13375	8	4	9	550	0	571
13376	538	2	4	16	0	560
13377	9	547	1	6	0	563
13378	3	565	2	3	0	573
13379	4	13	566	4	0	587
13380	5	4	14	550	0	573
13381	4	588	5	12	0	609
13382	6	10	1	594	0	611
13383	4	4	596	14	0	618
13384	3	584	12	5	0	604
13385	4	12	593	4	0	613
13386	4	4	575	0	0	583
13387	3	4	12	573	0	592
13388	587	5	3	17	0	612
13389	12	4	3	587	0	606
13390	2	3	591	11	0	607
13391	2	5	11	615	0	633
13392	3	2	659	12	0	676
13393	1	4	655	6	0	666
13394	648	2	17	5	0	672
13395	698	0	7	5	0	710
13396	704	2	4	4	0	714
13397	13	2	688	7	0	710
13398	4	1	702	4	0	711
13399	3	1	16	679	0	699
13400	5	5	6	682	0	698
13401	706	1	3	18	0	728
13402	15	3	6	688	0	712
13403	8	2	692	14	0	716
13404	4	3	678	7	0	692
13405	4	682	19	5	0	710
13406	7	12	5	701	0	725
13407	6	5	717	13	0	741
13408	6	2	14	697	0	719
13409	711	3	9	12	0	735
13410	12	2	722	9	0	745
13411	10	7	14	707	0	738
13412	4	4	8	720	0	736
13413	8	1	705	15	0	729
13414	4	3	14	685	0	706
13415	4	2	705	14	0	725
13416	612	3	13	14	0	642
13417	15	0	8	637	0	660
13418	5	640	3	18	0	666
13419	638	10	3	15	0	666
13420	648	5	3	8	0	664
13421	16	640	4	7	0	667
13422	10	39	4	588	0	641
13423	4	600	3	8	0	615
13424	7	606	1	7	0	621
13425	15	14	567	4	0	600
13426	2	556	12	3	0	573
13427	1	3	487	4	0	495
13428	411	5	3	6	0	425
13429	434	2	3	3	0	442
13430	4	434	2	1	0	441
13431	2	433	2	1	0	438
13432	3	426	2	2	0	433
13433	433	5	1	2	0	441
13434	7	4	0	441	0	452
13435	2	5	459	2	0	468
13436	0	462	3	4	0	469
13437	2	4	3	477	0	486
13438	2	3	1	459	0	465
13439	3	533	2	5	0	543
13440	559	9	1	7	0	576
13441	9	5	591	3	0	608
13442	6	1	9	734	0	750
13443	1	789	3	13	0	806
13444	770	20	1	8	0	799
13445	21	6	765	2	0	794
13446	7	740	20	6	0	773
13447	9	24	7	737	0	777
13448	9	10	736	20	0	775
13449	721	3	24	7	0	755
13450	21	6	10	732	0	769
13451	4	8	740	26	0	778
13452	6	731	28	8	0	773
13453	716	19	13	8	0	756
13454	21	730	2	9	0	762
13455	714	22	8	12	0	756
13456	731	14	5	3	0	753
13457	30	7	4	703	0	744
13458	12	706	1	21	0	740
13459	10	24	696	7	0	737
13460	15	8	22	695	0	740
13461	17	3	8	633	0	661
13462	5	7	4	716	0	732
13463	10	5	13	687	0	715
13464	8	4	5	698	0	715
13465	676	1	5	36	0	718
13466	656	3	1	26	0	686
13467	674	2	1	14	0	691
13468	24	658	3	16	0	701
13469	17	19	667	10	0	713
13470	15	7	663	6	0	691
13471	16	3	689	2	0	710
13472	8	11	26	657	0	702
13473	4	7	15	679	0	705
13474	8	2	17	689	0	716
13475	1	4	689	28	0	722
13476	2	653	27	21	0	703
13477	3	22	673	17	0	715
13478	8	7	678	16	0	709
13479	11	4	34	669	0	718
13480	4	12	696	22	0	734
13481	5	9	32	667	0	713
13482	668	6	21	26	0	721
13483	684	2	15	19	0	720
13484	27	2	671	12	0	712
13485	14	6	27	668	0	715
13486	16	2	665	32	0	715
13487	15	676	27	11	0	729
13488	682	30	13	4	0	729
13489	26	7	684	15	0	732
13490	12	642	37	9	0	700
13491	8	651	18	7	0	684
13492	10	640	5	10	0	665
13493	7	34	601	8	0	650
13494	13	19	26	559	0	617
13495	8	593	9	22	0	632
13496	7	43	5	582	0	637
13497	4	16	12	604	0	636
13498	574	4	14	39	0	631
13499	26	582	8	15	0	631
13500	578	31	6	15	0	630
13501	24	561	10	18	0	613
13502	16	597	5	16	0	634
13503	15	39	571	8	0	633
13504	20	20	30	560	0	630
13505	13	18	567	28	0	626
13506	7	567	29	13	0	616
13507	9	36	565	8	0	618
13508	5	12	577	15	0	609
13509	7	573	39	15	0	634
13510	544	36	18	14	0	612
13511	29	571	16	14	0	630
13512	564	29	17	15	0	625
13513	28	21	569	13	0	631
13514	20	10	574	12	0	616
13515	14	563	36	9	0	622
13516	561	34	9	14	0	618
13517	31	552	18	9	0	610
13518	16	33	18	556	0	623
13519	561	18	14	32	0	625
13520	36	11	571	13	0	631
13521	24	16	26	561	0	627
13522	573	6	13	38	0	630
13523	33	564	7	20	0	624
13524	20	26	11	561	0	618
13525	10	12	569	37	0	628
13526	556	9	31	22	0	618
13527	32	13	17	564	0	626
13528	7	7	566	38	0	618
13529	6	7	36	555	0	604
13530	11	550	14	36	0	611
13531	11	25	557	24	0	617
13532	9	11	28	546	0	594
13533	534	6	12	35	0	587
13534	29	11	11	528	0	579
13535	494	11	10	29	0	544
13536	22	494	14	15	0	545
13537	483	28	16	8	0	535
13538	28	5	478	13	0	524
13539	9	5	408	9	0	431
13540	11	8	371	5	0	395
13541	8	341	20	7	0	376
13542	8	3	11	121	0	143
13543	3	1	1	120	0	125
13544	0	1	2	117	0	120
13545	0	0	0	115	0	115
13546	2	0	109	4	0	115
13547	106	2	1	2	0	111
13548	3	113	1	2	0	119
13549	118	3	2	0	0	123
13550	5	1	0	114	0	120
13551	2	110	0	5	0	117
13552	1	3	2	116	0	122
13553	116	1	0	5	0	122
13554	1	119	0	1	0	121
13555	119	3	2	1	0	125
13556	122	1	0	3	0	126
13557	6	0	0	127	0	133
13558	1	0	132	5	0	138
13559	124	0	3	2	0	129
13560	3	2	1	132	0	138
13561	132	1	0	3	0	136
13562	138	1	1	2	0	142
13563	139	1	1	0	0	141
13564	3	0	136	0	0	139
13565	1	2	3	136	0	142
13566	133	0	1	4	0	138
13567	2	0	129	3	0	134
13568	1	128	3	2	0	134
13569	0	2	0	126	0	128
13570	0	1	142	2	0	145
13571	3	1	135	1	0	140
13572	0	1	2	137	0	140
13573	0	0	0	140	0	140
13574	1	0	0	139	0	140
13575	1	0	0	139	0	140
13576	0	0	138	2	0	140
13577	0	136	1	1	0	138
13578	0	1	1	139	0	141
13579	141	0	0	0	0	141
13580	138	0	0	2	0	140
13581	138	0	0	0	0	138
13582	2	0	0	141	0	143
13583	2	0	0	142	0	144
13584	0	136	0	2	0	138
13585	0	143	0	2	0	145
13586	0	3	1	150	0	154
13587	145	0	0	0	0	145
13588	142	0	0	2	0	144
13589	137	0	1	0	0	138
13590	139	0	0	1	0	140
13591	143	1	0	3	0	147
13592	0	149	1	1	0	151
13593	0	0	0	145	0	145
13594	148	0	0	0	0	148
13595	147	0	0	1	0	148
13596	2	0	0	146	0	148
13597	1	1	0	147	0	149
13598	1	0	152	0	0	153
13599	0	0	1	147	0	148
13600	1	0	1	145	0	147
13601	0	0	173	0	0	173
13602	2	5	0	163	0	170
13603	0	178	0	1	0	179
13604	0	0	176	1	0	177
13605	0	178	0	1	0	179
13606	0	0	0	177	0	177
13607	0	0	1	178	0	179
13608	1	172	1	0	0	174
13609	0	177	0	0	0	177
13610	175	0	0	2	0	177
13611	171	0	0	3	0	174
13612	0	1	179	0	0	180
13613	174	0	0	2	0	176
13614	195	0	0	0	0	195
13615	193	1	0	0	0	194
13616	195	0	0	1	0	196
13617	2	1	184	0	0	187
13618	2	0	173	1	0	176
13619	194	0	1	0	0	195
13620	2	188	0	1	0	191
13621	2	0	190	1	0	193
13622	182	0	0	4	0	186
13623	187	0	0	1	0	188
13624	0	0	184	0	0	184
13625	179	2	0	1	0	182
13626	1	0	0	214	0	215
13627	1	0	229	0	0	230
13628	204	0	2	1	0	207
13629	2	227	0	1	0	230
13630	235	0	1	3	0	239
13631	260	0	1	6	0	267
13632	2	0	0	269	0	271
13633	1	0	2	267	0	270
13634	0	2	0	271	0	273
13635	267	0	0	5	0	272
13636	284	0	1	0	0	285
13637	2	1	0	284	0	287
13638	2	0	0	281	0	283
13639	1	1	273	2	0	277
13640	258	0	1	1	0	260
13641	1	2	0	280	0	283
13642	0	1	0	283	0	284
13643	0	279	0	3	0	282
13644	2	1	0	284	0	287
13645	2	2	0	280	0	284
13646	278	0	0	6	0	284
13647	2	278	0	1	0	281
13648	3	0	0	289	0	292
13649	3	3	0	277	0	283
13650	2	0	0	279	0	281
13651	3	0	282	1	0	286
13652	1	2	0	280	0	283
13653	273	0	1	8	0	282
13654	2	0	283	3	0	288
13655	2	0	1	286	0	289
13656	2	1	1	303	0	307
13657	303	0	0	4	0	307
13658	292	0	1	2	0	295
13659	2	0	294	2	0	298
13660	275	1	1	3	0	280
13661	2	0	311	0	0	313
13662	306	2	0	2	0	310
13663	1	340	3	0	0	344
13664	356	1	0	3	0	360
13665	2	357	0	0	0	359
13666	372	1	0	2	0	375
13667	2	393	0	0	0	395
13668	2	1	0	402	0	405
13669	0	1	1	391	0	393
13670	2	1	0	395	0	398
13671	0	382	0	2	0	384
13672	1	1	0	388	0	390
13673	1	385	0	2	0	388
13674	0	2	0	382	0	384
13675	376	1	1	7	0	385
13676	379	1	0	4	0	384
13677	2	379	0	2	0	383
13678	5	1	0	388	0	394
13679	383	1	0	4	0	388
13680	1	391	0	2	0	394
13681	1	398	1	1	0	401
13682	402	2	0	5	0	409
13683	403	2	1	3	0	409
13684	3	400	0	2	0	405
13685	401	3	0	3	0	407
13686	3	1	1	389	0	394
13687	2	1	408	3	0	414
13688	407	1	2	2	0	412
13689	394	1	1	2	0	398
13690	4	0	403	2	0	409
13691	406	0	5	2	0	413
13692	432	0	1	3	0	436
13693	437	0	2	3	0	442
13694	5	433	1	1	0	440
13695	442	3	0	3	0	448
13696	440	1	1	4	0	446
13697	4	2	0	442	0	448
13698	5	2	0	430	0	437
13699	3	1	0	441	0	445
13700	446	0	0	4	0	450
13701	2	0	1	426	0	429
13702	421	0	0	8	0	429
13703	442	1	1	4	0	448
13704	6	0	0	439	0	445
13705	2	2	0	447	0	451
13706	4	0	0	456	0	460
13707	450	1	0	6	0	457
13708	5	447	1	3	0	456
13709	3	7	0	446	0	456
13710	2	1	0	466	0	469
13711	450	2	1	8	0	461
13712	449	1	0	6	0	456
13713	7	3	435	2	0	447
13714	4	0	449	2	0	455
13715	488	1	7	2	0	498
13716	10	1	2	488	0	501
13717	5	0	2	549	0	556
13718	1	2	560	15	0	578
13719	5	0	13	558	0	576
13720	2	567	3	14	0	586
13721	1	591	3	6	0	601
13722	569	15	2	7	0	593
13723	13	5	577	2	0	597
13724	6	594	11	1	0	612
13725	6	13	3	588	0	610
13726	2	5	575	13	0	595
13727	4	2	14	554	0	574
13728	6	2	4	568	0	580
13729	1	1	567	20	0	589
13730	1	558	13	7	0	579
13731	3	13	4	555	0	575
13732	549	4	2	17	0	572
13733	557	2	1	10	0	570
13734	568	1	1	3	0	573
13735	19	546	0	2	0	567
13736	548	13	0	2	0	563
13737	21	3	1	537	0	562
13738	5	2	522	15	0	544
13739	522	0	10	4	0	536
13740	11	536	3	4	0	554
13741	5	11	1	525	0	542
13742	3	2	1	526	0	532
13743	1	524	2	17	0	544
13744	4	16	1	534	0	555
13745	5	4	1	539	0	549
13746	4	3	1	549	0	557
13747	538	1	2	24	0	565
13748	536	4	2	9	0	551
13749	17	1	539	8	0	565
13750	5	1	14	545	0	565
13751	6	4	3	564	0	577
13752	5	3	4	563	0	575
13753	556	2	2	19	0	579
13754	15	5	537	4	0	561
13755	520	3	10	6	0	539
13756	543	2	5	5	0	555
13757	18	2	6	541	0	567
13758	542	2	1	17	0	562
13759	17	2	528	9	0	556
13760	513	1	15	7	0	536
13761	16	570	3	10	0	599
13762	4	15	571	4	0	594
13763	7	5	555	2	0	569
13764	8	4	16	525	0	553
13765	7	1	532	14	0	554
13766	508	4	13	7	0	532
13767	16	510	4	5	0	535
13768	522	13	4	6	0	545
13769	18	5	3	520	0	546
13770	6	3	510	16	0	535
13771	4	3	525	7	0	539
13772	2	2	16	535	0	555
13773	528	2	6	17	0	553
13774	16	521	1	7	0	545
13775	6	550	2	5	0	563
13776	534	17	3	8	0	562
13777	15	548	1	6	0	570
13778	541	13	1	9	0	564
13779	22	5	1	538	0	566
13780	535	2	6	19	0	562
13781	20	0	4	538	0	562
13782	535	3	1	22	0	561
13783	19	0	3	535	0	557
13784	7	527	2	19	0	555
13785	529	15	2	8	0	554
13786	15	530	4	6	0	555
13787	11	16	495	3	0	525
13788	8	4	13	479	0	504
13789	7	507	7	11	0	532
13790	503	13	5	9	0	530
13791	493	5	2	5	0	505
13792	17	485	5	2	0	509
13793	6	11	489	3	0	509
13794	5	7	14	474	0	500
13795	5	477	7	12	0	501
13796	3	12	6	496	0	517
13797	4	6	3	500	0	513
13798	492	4	2	17	0	515
13799	15	485	1	8	0	509
13800	9	13	2	494	0	518
13801	491	5	4	15	0	515
13802	496	4	3	6	0	509
13803	481	1	4	8	0	494
13804	21	3	4	470	0	498
13805	465	4	3	14	0	486
13806	14	460	0	7	0	481
13807	468	12	2	5	0	487
13808	13	481	0	4	0	498
13809	483	14	1	4	0	502
13810	483	4	1	4	0	492
13811	18	4	0	467	0	489
13812	9	0	472	15	0	496
13813	7	2	461	6	0	476
13814	3	463	11	6	0	483
13815	433	7	5	2	0	447
13816	9	10	425	0	0	444
13817	341	2	4	0	0	347
13818	4	343	2	0	0	349
13819	2	356	1	1	0	360
13820	3	3	0	381	0	387
13821	0	399	1	7	0	407
13822	2	4	401	1	0	408
13823	0	3	4	384	0	391
13824	1	402	2	3	0	408
13825	2	6	1	414	0	423
13826	406	2	2	9	0	419
13827	8	1	1	404	0	414
13828	2	1	402	11	0	416
13829	4	417	7	2	0	430
13830	1	8	2	418	0	429
13831	2	5	3	410	0	420
13832	3	4	2	421	0	430
13833	403	2	1	15	0	421
13834	404	3	3	6	0	416
13835	9	2	400	8	0	419
13836	8	3	393	2	0	406
13837	3	404	10	10	0	427
13838	426	6	5	3	0	440
13839	8	4	2	427	0	441
13840	4	5	3	427	0	439
13841	6	1	0	436	0	443
13842	7	2	0	431	0	440
13843	4	1	413	16	0	434
13844	403	0	6	12	0	421
13845	13	1	4	458	0	476
13846	7	1	451	11	0	470
13847	448	2	14	6	0	470
13848	492	3	7	7	0	509
13849	18	3	546	2	0	569
13850	16	0	561	5	0	582
13851	9	1	17	551	0	578
13852	544	0	14	22	0	580
13853	549	0	9	13	0	571
13854	26	1	2	545	0	574
13855	15	0	6	566	0	587
13856	11	0	556	20	0	587
13857	7	2	12	537	0	558
13858	7	1	539	18	0	565
13859	517	1	20	9	0	547
13860	16	524	8	11	0	559
13861	482	14	12	5	0	513
13862	21	479	5	3	0	508
13863	490	19	1	7	0	517
13864	33	3	2	471	0	509
13865	14	8	0	488	0	510
13866	487	1	3	25	0	516
13867	483	1	2	16	0	502
13868	483	1	5	10	0	499
13869	491	0	2	5	0	498
13870	26	1	471	3	0	501
13871	468	2	13	3	0	486
13872	480	5	5	3	0	493
13873	482	1	8	1	0	492
13874	28	5	0	456	0	489
13875	456	0	4	18	0	478
13876	23	444	4	10	0	481
13877	15	15	0	445	0	475
13878	19	4	3	461	0	487
13879	8	10	441	20	0	479
13880	13	1	13	433	0	460
13881	10	443	8	22	0	483
13882	438	16	10	8	0	472
13883	24	444	2	12	0	482
13884	452	21	1	7	0	481
13885	31	4	5	446	0	486
13886	443	7	5	24	0	479
13887	28	443	5	10	0	486
13888	461	19	2	12	0	494
13889	475	7	2	9	0	493
13890	31	8	3	444	0	486
13891	21	4	5	464	0	494
13892	15	7	437	27	0	486
13893	9	8	17	443	0	477
13894	14	3	4	458	0	479
13895	7	5	439	25	0	476
13896	18	2	17	447	0	484
13897	8	3	436	30	0	477
13898	438	4	19	9	0	470
13899	24	6	7	438	0	475
13900	16	2	432	18	0	468
13901	440	1	14	12	0	467
13902	21	2	8	448	0	479
13903	14	1	449	22	0	486
13904	451	3	19	9	0	482
13905	24	2	6	455	0	487
13906	12	2	10	466	0	490
13907	455	2	6	28	0	491
13908	25	4	5	447	0	481
13909	17	1	7	453	0	478
13910	13	3	2	431	0	449
13911	5	418	3	37	0	463
13912	422	15	8	16	0	461
13913	436	9	4	12	0	461
13914	25	6	3	418	0	452
13915	420	2	5	21	0	448
13916	424	3	4	11	0	442
13917	424	1	4	16	0	445
13918	367	4	3	11	0	385
13919	414	2	1	10	0	427
13920	22	4	343	9	0	378
13921	19	0	328	5	0	352
13922	329	1	16	8	0	354
13923	20	329	8	10	0	367
13924	12	14	9	306	0	341
13925	9	2	309	18	0	338
13926	5	6	312	11	0	334
13927	7	7	15	307	0	336
13928	299	3	9	20	0	331
13929	15	1	10	294	0	320
13930	10	2	294	18	0	324
13931	318	1	8	14	0	341
13932	16	2	7	311	0	336
13933	16	0	5	319	0	340
13934	13	1	2	324	0	340
13935	8	0	3	330	0	341
13936	10	0	309	19	0	338
13937	12	0	12	303	0	327
13938	298	1	3	17	0	319
13939	15	0	284	11	0	310
13940	290	5	10	5	0	310
13941	299	1	7	7	0	314
13942	298	0	5	10	0	313
13943	289	3	4	6	0	302
13944	19	287	0	6	0	312
13945	7	236	1	4	0	248
13946	6	243	3	6	0	258
13947	223	10	9	8	0	250
13948	11	3	214	2	0	230
13949	132	0	5	6	0	143
13950	3	0	1	138	0	142
13951	138	0	3	4	0	145
13952	6	0	0	136	0	142
13953	139	0	0	7	0	146
13954	4	0	2	146	0	152
13955	5	0	0	148	0	153
13956	140	0	2	5	0	147
13957	4	163	1	2	0	170
13958	3	1	165	1	0	170
13959	2	165	3	0	0	170
13960	1	2	163	1	0	167
13961	2	1	2	160	0	165
13962	155	0	9	2	0	166
13963	2	0	1	152	0	155
13964	150	1	0	1	0	152
13965	3	160	0	1	0	164
13966	1	2	166	0	0	169
13967	1	165	1	1	0	168
13968	2	170	1	0	0	173
13969	168	1	0	0	0	169
13970	162	0	0	1	0	163
13971	2	158	0	0	0	160
13972	0	1	0	161	0	162
13973	2	0	0	161	0	163
13974	158	0	0	2	0	160
13975	1	0	160	1	0	162
13976	1	0	153	0	0	154
13977	0	1	1	157	0	159
13978	0	1	156	2	0	159
13979	152	1	2	0	0	155
13980	155	0	2	0	0	157
13981	1	157	0	1	0	159
13982	2	1	160	0	0	163
13983	0	0	1	158	0	159
13984	1	1	171	1	0	174
13985	1	0	2	168	0	171
13986	171	0	1	5	0	177
13987	1	177	0	1	0	179
13988	0	2	175	2	0	179
13989	1	179	2	1	0	183
13990	1	189	2	0	0	192
13991	189	2	0	4	0	195
13992	187	0	0	2	0	189
13993	1	0	193	2	0	196
13994	2	205	2	0	0	209
13995	2	1	1	203	0	207
13996	0	0	1	209	0	210
13997	3	0	0	202	0	205
13998	0	1	210	2	0	213
13999	2	1	1	206	0	210
14000	1	1	1	214	0	217
14001	216	1	0	2	0	219
14002	218	0	2	0	0	220
14003	216	0	1	1	0	218
14004	209	0	0	3	0	212
14005	204	0	0	5	0	209
14006	3	208	0	1	0	212
14007	207	2	0	2	0	211
14008	1	1	205	1	0	208
14009	1	2	1	202	0	206
14010	205	1	0	2	0	208
14011	3	204	0	0	0	207
14012	214	1	2	0	0	217
14013	215	0	1	0	0	216
14014	2	1	1	215	0	219
14015	1	0	0	215	0	216
14016	1	237	0	3	0	241
14017	1	1	0	248	0	250
14018	1	1	256	2	0	260
14019	0	1	1	256	0	258
14020	1	0	266	2	0	269
14021	242	0	1	1	0	244
14022	1	0	1	257	0	259
14023	1	0	270	1	0	272
14024	0	263	1	1	0	265
14025	0	266	1	0	0	267
14026	264	2	0	1	0	267
14027	1	1	0	270	0	272
14028	1	0	290	1	0	292
14029	0	294	1	1	0	296
14030	0	2	304	0	0	306
14031	281	2	1	4	0	288
14032	290	0	1	4	0	295
14033	290	0	1	0	0	291
14034	1	0	0	300	0	301
14035	3	0	296	1	0	300
14036	1	297	1	1	0	300
14037	0	1	1	301	0	303
14038	0	1	297	1	0	299
14039	1	1	288	2	0	292
14040	0	1	2	296	0	299
14041	303	0	1	2	0	306
14042	2	0	0	299	0	301
14043	1	0	1	307	0	309
14044	0	1	314	2	0	317
14045	0	0	2	314	0	316
14046	1	0	1	311	0	313
14047	1	1	318	2	0	322
14048	2	0	310	1	0	313
14049	2	6	2	307	0	317
14050	0	0	325	1	0	326
14051	2	2	1	317	0	322
14052	319	0	1	4	0	324
14053	0	334	2	1	0	337
14054	1	1	1	333	0	336
14055	0	1	330	1	0	332
14056	299	0	1	2	0	302
14057	0	320	2	1	0	323
14058	313	1	0	2	0	316
14059	1	1	1	311	0	314
14060	1	1	0	314	0	316
14061	311	0	0	4	0	315
14062	1	0	316	1	0	318
14063	305	0	2	0	0	307
14064	1	0	1	316	0	318
14065	308	0	1	3	0	312
14066	310	0	1	2	0	313
14067	5	0	0	311	0	316
14068	1	321	0	4	0	326
14069	329	4	0	3	0	336
14070	327	1	1	0	0	329
14071	8	2	333	0	0	343
14072	325	1	5	0	0	331
14073	5	0	2	328	0	335
14074	2	333	0	6	0	341
14075	0	4	0	326	0	330
14076	1	329	1	2	0	333
14077	327	4	1	3	0	335
14078	334	2	0	0	0	336
14079	9	0	0	352	0	361
14080	4	0	349	7	0	360
14081	1	0	340	2	0	343
14082	1	1	8	355	0	365
14083	352	2	2	9	0	365
14084	359	0	0	4	0	363
14085	12	360	1	0	0	373
14086	4	8	2	363	0	377
14087	4	4	361	7	0	376
14088	0	1	373	5	0	379
14089	0	5	10	397	0	412
14090	425	0	4	11	0	440
14091	13	2	0	428	0	443
14092	7	1	419	11	0	438
14093	415	0	11	6	0	432
14094	12	0	5	407	0	424
14095	9	0	2	420	0	431
14096	2	1	3	428	0	434
14097	0	411	2	18	0	431
14098	4	8	413	7	0	432
14099	2	5	418	3	0	428
14100	6	2	14	410	0	432
14101	3	1	417	12	0	433
14102	404	0	14	7	0	425
14103	12	2	7	415	0	436
14104	5	0	2	420	0	427
14105	5	0	0	419	0	424
14106	1	410	1	18	0	430
14107	419	10	2	13	0	444
14108	13	5	1	424	0	443
14109	421	2	1	15	0	439
14110	13	424	2	9	0	448
14111	425	13	0	9	0	447
14112	417	5	1	4	0	427
14113	424	4	1	4	0	433
14114	19	419	4	3	0	445
14115	7	423	4	4	0	438
14116	393	14	2	7	0	416
14117	14	405	2	1	0	422
14118	9	12	395	1	0	417
14119	2	391	12	4	0	409
14120	2	399	4	3	0	408
14121	394	16	3	5	0	418
14122	12	6	389	1	0	408
14123	5	2	380	2	0	389
14124	7	2	12	379	0	400
14125	375	2	17	16	0	410
14126	12	2	384	4	0	402
14127	9	1	13	380	0	403
14128	6	1	371	12	0	390
14129	3	1	363	6	0	373
14130	349	2	15	9	0	375
14131	13	2	368	4	0	387
14132	7	2	14	364	0	387
14133	3	2	8	364	0	377
14134	0	359	8	14	0	381
14135	5	383	3	4	0	395
14136	3	14	3	383	0	403
14137	4	5	388	15	0	412
14138	3	2	13	385	0	403
14139	1	2	6	403	0	412
14140	0	3	409	19	0	431
14141	7	1	14	406	0	428
14142	403	1	5	21	0	430
14143	14	0	399	8	0	421
14144	393	1	12	10	0	416
14145	18	2	8	401	0	429
14146	8	1	7	399	0	415
14147	5	398	3	20	0	426
14148	8	13	1	408	0	430
14149	6	5	2	426	0	439
14150	401	9	2	20	0	432
14151	14	4	2	406	0	426
14152	7	2	6	412	0	427
14153	396	2	4	19	0	421
14154	14	2	4	403	0	423
14155	11	5	1	388	0	405
14156	3	396	4	18	0	421
14157	397	13	6	10	0	426
14158	17	5	3	402	0	427
14159	6	4	3	413	0	426
14160	9	1	402	17	0	429
14161	4	2	10	403	0	419
14162	4	6	5	412	0	427
14163	403	3	5	18	0	429
14164	411	2	3	9	0	425
14165	19	4	2	403	0	428
14166	10	0	397	14	0	421
14167	8	374	9	7	0	398
14168	3	384	6	5	0	398
14169	6	10	3	378	0	397
14170	365	7	3	15	0	390
14171	9	5	8	375	0	397
14172	387	2	0	11	0	400
14173	10	3	4	392	0	409
14174	8	1	4	395	0	408
14175	378	4	1	16	0	399
14176	381	3	5	7	0	396
14177	12	379	6	3	0	400
14178	10	400	1	5	0	416
14179	5	11	3	359	0	378
14180	3	6	2	367	0	378
14181	3	2	354	11	0	370
14182	320	0	10	9	0	339
14183	9	342	5	5	0	361
14184	4	335	4	0	0	343
14185	324	6	2	4	0	336
14186	4	5	330	2	0	341
14187	2	2	311	0	0	315
14188	5	0	299	0	0	304
14189	1	266	8	3	0	278
14190	1	1	2	230	0	234
14191	1	1	1	233	0	236
14192	0	1	0	236	0	237
14193	228	0	0	4	0	232
14194	222	0	0	5	0	227
14195	2	225	0	1	0	228
14196	2	1	2	219	0	224
14197	1	1	222	1	0	225
14198	0	222	2	1	0	225
14199	209	1	1	4	0	215
14200	1	1	216	0	0	218
14201	197	1	0	3	0	201
14202	1	1	218	0	0	220
14203	3	4	1	208	0	216
14204	1	215	2	0	0	218
14205	216	0	1	3	0	220
14206	0	219	0	0	0	219
14207	211	0	0	2	0	213
14208	1	2	0	216	0	219
14209	1	0	223	0	0	224
14210	0	0	0	217	0	217
14211	1	0	1	223	0	225
14212	0	0	230	2	0	232
14213	226	0	2	3	0	231
14214	1	250	1	0	0	252
14215	249	1	0	1	0	251
14216	2	250	0	0	0	252
14217	2	1	0	251	0	254
14218	2	1	246	1	0	250
14219	295	0	1	3	0	299
14220	5	304	1	0	0	310
14221	4	5	0	296	0	305
14222	0	4	0	307	0	311
14223	313	0	0	11	0	324
14224	324	0	0	8	0	332
14225	12	334	1	0	0	347
14226	363	6	0	5	0	374
14227	372	5	0	0	0	377
14228	379	0	0	5	0	384
14229	12	0	367	0	0	379
14230	5	354	9	0	0	368
14231	0	371	7	0	0	378
14232	0	13	0	355	0	368
14233	1	5	0	361	0	367
14234	357	0	0	13	0	370
14235	8	348	0	6	0	362
14236	354	7	1	1	0	363
14237	9	5	0	344	0	358
14238	7	1	0	356	0	364
14239	342	0	0	16	0	358
14240	319	0	0	6	0	325
14241	13	0	316	1	0	330
14242	7	1	8	314	0	330
14243	2	0	320	7	0	329
14244	0	1	316	5	0	322
14245	0	0	318	2	0	320
14246	305	0	16	2	0	323
14247	10	0	6	302	0	318
14248	5	2	1	304	0	312
14249	2	0	0	314	0	316
14250	1	1	304	15	0	321
14251	2	0	8	305	0	315
14252	1	0	6	313	0	320
14253	294	1	1	15	0	311
14254	305	1	0	7	0	313
14255	308	1	0	2	0	311
14256	311	0	0	2	0	313
14257	16	0	1	293	0	310
14258	294	2	0	9	0	305
14259	11	1	1	296	0	309
14260	7	1	280	9	0	297
14261	284	1	8	7	0	300
14262	9	284	6	2	0	301
14263	7	7	1	278	0	293
14264	5	5	0	283	0	293
14265	0	285	0	14	0	299
14266	285	8	1	7	0	301
14267	8	284	1	3	0	296
14268	6	9	281	1	0	297
14269	3	4	284	0	0	291
14270	278	2	12	2	0	294
14271	284	0	7	0	0	291
14272	13	0	272	2	0	287
14273	279	1	10	0	0	290
14274	12	0	280	0	0	292
14275	271	1	10	1	0	283
14276	12	1	274	1	0	288
14277	5	0	278	2	0	285
14278	4	0	14	255	0	273
14279	1	1	5	262	0	269
14280	258	1	2	15	0	276
14281	264	0	0	8	0	272
14282	267	0	0	2	0	269
14283	273	0	0	1	0	274
14284	18	258	0	0	0	276
14285	7	8	1	250	0	266
14286	3	260	1	9	0	273
14287	2	9	0	266	0	277
14288	1	5	4	263	0	273
14289	3	2	1	265	0	271
14290	0	3	255	14	0	272
14291	245	0	11	7	0	263
14292	9	241	5	4	0	259
14293	5	252	2	7	0	266
14294	4	13	258	2	0	277
14295	3	7	11	253	0	274
14296	6	1	5	260	0	272
14297	253	0	1	15	0	269
14298	12	1	1	257	0	271
14299	7	0	2	261	0	270
14300	3	1	3	270	0	277
14301	4	0	0	271	0	275
14302	255	0	3	18	0	276
14303	270	0	1	8	0	279
14304	272	0	4	2	0	278
14305	18	0	1	260	0	279
14306	261	0	1	10	0	272
14307	9	2	0	264	0	275
14308	6	0	1	271	0	278
14309	0	1	251	15	0	267
14310	2	0	254	8	0	264
14311	3	0	252	3	0	258
14312	230	1	17	3	0	251
14313	11	0	12	206	0	229
14314	6	214	1	7	0	228
14315	217	9	0	6	0	232
14316	9	5	211	2	0	227
14317	206	1	9	1	0	217
14318	10	209	4	3	0	226
14319	159	4	1	2	0	166
14320	8	1	0	158	0	167
14321	155	1	0	7	0	163
14322	4	151	0	3	0	158
14323	1	142	1	2	0	146
14324	128	2	1	0	0	131
14325	2	118	1	0	0	121
14326	1	85	0	0	0	86
14327	1	83	0	1	0	85
14328	80	3	0	0	0	83
14329	83	0	0	0	0	83
14330	82	0	0	0	0	82
14331	2	0	0	79	0	81
14332	0	1	0	79	0	80
14333	1	0	85	1	0	87
14334	0	0	1	85	0	86
14335	1	0	87	1	0	89
14336	0	0	1	86	0	87
14337	1	1	0	89	0	91
14338	86	0	0	1	0	87
14339	87	0	0	0	0	87
14340	1	85	0	0	0	86
14341	0	2	0	89	0	91
14342	1	0	90	1	0	92
14343	2	0	1	88	0	91
14344	1	0	0	88	0	89
14345	0	0	0	90	0	90
14346	0	0	89	2	0	91
14347	0	0	85	0	0	85
14348	89	0	1	1	0	91
14349	1	0	0	88	0	89
14350	0	0	91	2	0	93
14351	84	0	1	1	0	86
14352	2	95	0	1	0	98
14353	95	1	1	1	0	98
14354	1	1	105	0	0	107
14355	100	0	2	1	0	103
14356	1	0	2	106	0	109
14357	1	1	107	2	0	111
14358	0	104	1	2	0	107
14359	112	1	0	0	0	113
14360	3	0	1	109	0	113
14361	0	0	1	113	0	114
14362	2	117	0	1	0	120
14363	0	2	0	120	0	122
14364	1	0	116	1	0	118
14365	1	118	1	1	0	121
14366	115	2	0	0	0	117
14367	2	1	0	118	0	121
14368	1	0	1	118	0	120
14369	2	0	117	1	0	120
14370	1	1	1	121	0	124
14371	0	0	137	1	0	138
14372	0	137	2	0	0	139
14373	137	0	0	0	0	137
14374	133	0	0	0	0	133
14375	135	0	0	0	0	135
14376	0	134	0	1	0	135
14377	1	0	0	140	0	141
14378	0	0	1	141	0	142
14379	0	1	0	123	0	124
14380	140	0	1	0	0	141
14381	137	0	0	1	0	138
14382	0	0	0	140	0	140
14383	1	1	157	0	0	159
14384	1	0	0	155	0	156
14385	0	1	0	166	0	167
14386	0	0	0	166	0	166
14387	0	0	1	163	0	164
14388	162	0	0	2	0	164
14389	0	0	0	163	0	163
14390	1	0	0	160	0	161
14391	0	160	1	0	0	161
14392	0	0	1	166	0	167
14393	1	171	0	1	0	173
14394	2	1	0	166	0	169
14395	170	0	1	2	0	173
14396	2	171	0	0	0	173
14397	167	2	0	1	0	170
14398	2	0	170	0	0	172
14399	0	1	2	172	0	175
14400	2	0	165	1	0	168
14401	0	1	2	170	0	173
14402	0	0	1	167	0	168
14403	0	171	1	1	0	173
14404	2	170	0	1	0	173
14405	0	199	0	2	0	201
14406	201	2	0	1	0	204
14407	1	194	0	0	0	195
14408	0	192	0	0	0	192
14409	1	2	0	197	0	200
14410	198	0	0	4	0	202
14411	2	229	0	0	0	231
14412	228	2	0	1	0	231
14413	224	0	0	3	0	227
14414	1	1	246	0	0	248
14415	0	0	1	237	0	238
14416	1	0	1	242	0	244
14417	0	0	1	246	0	247
14418	0	0	0	236	0	236
14419	0	1	230	2	0	233
14420	1	2	199	1	0	203
14421	214	1	2	2	0	219
14422	3	225	1	0	0	229
14423	1	231	1	0	0	233
14424	229	3	0	0	0	232
14425	2	227	0	1	0	230
14426	1	2	1	228	0	232
14427	232	1	0	3	0	236
14428	3	1	225	0	0	229
14429	2	0	1	242	0	245
14430	2	0	241	2	0	245
14431	236	1	2	2	0	241
14432	1	1	264	2	0	268
14433	261	1	2	4	0	268
14434	274	0	0	1	0	275
14435	266	1	2	1	0	270
14436	268	1	1	0	0	270
14437	269	0	0	1	0	270
14438	3	1	0	273	0	277
14439	293	2	0	1	0	296
14440	4	0	0	290	0	294
14441	1	1	0	288	0	290
14442	1	0	1	290	0	292
14443	1	0	289	3	0	293
14444	2	0	2	287	0	291
14445	0	0	0	293	0	293
14446	0	0	292	2	0	294
14447	270	0	2	2	0	274
14448	1	0	1	290	0	292
14449	2	0	290	1	0	293
14450	1	1	286	0	0	288
14451	2	1	1	286	0	290
14452	2	0	308	1	0	311
14453	1	1	2	309	0	313
14454	1	0	1	310	0	312
14455	2	309	1	2	0	314
14456	0	311	0	3	0	314
14457	318	1	0	6	0	325
14458	2	2	1	320	0	325
14459	2	0	2	312	0	316
14460	0	0	1	320	0	321
14461	1	0	317	4	0	322
14462	2	0	2	316	0	320
14463	311	0	1	2	0	314
14464	2	0	322	2	0	326
14465	3	0	2	332	0	337
14466	1	0	2	324	0	327
14467	2	0	1	336	0	339
14468	0	346	1	5	0	352
14469	348	1	0	8	0	357
14470	355	2	0	5	0	362
14471	3	358	1	1	0	363
14472	3	2	0	390	0	395
14473	2	2	395	2	0	401
14474	0	2	372	3	0	377
14475	398	1	5	3	0	407
14476	4	0	2	421	0	427
14477	425	1	3	3	0	432
14478	6	425	1	5	0	437
14479	4	427	1	2	0	434
14480	431	11	3	1	0	446
14481	8	450	0	4	0	462
14482	7	7	0	460	0	474
14483	4	7	0	447	0	458
14484	0	462	0	11	0	473
14485	460	8	0	5	0	473
14486	9	5	458	2	0	474
14487	437	3	7	4	0	451
14488	8	0	462	3	0	473
14489	428	0	10	5	0	443
14490	9	2	473	1	0	485
14491	8	478	8	0	0	494
14492	2	7	11	475	0	495
14493	479	5	0	6	0	490
14494	5	0	470	7	0	482
14495	6	1	472	0	0	479
14496	1	1	11	461	0	474
14497	1	1	482	6	0	490
14498	4	0	7	469	0	480
14499	2	1	7	437	0	447
14500	2	0	471	12	0	485
14501	4	0	9	465	0	478
14502	486	1	5	9	0	501
14503	5	485	2	6	0	498
14504	503	7	0	4	0	514
14505	8	5	2	472	0	487
14506	475	2	1	7	0	485
14507	492	2	0	9	0	503
14508	15	0	2	485	0	502
14509	4	496	1	9	0	510
14510	502	6	1	11	0	520
14511	8	5	477	4	0	494
14512	7	1	484	1	0	493
14513	478	1	11	2	0	492
14514	8	1	6	481	0	496
14515	7	0	492	5	0	504
14516	2	1	7	481	0	491
14517	497	0	6	8	0	511
14518	506	1	1	8	0	516
14519	510	1	1	4	0	516
14520	11	522	2	4	0	539
14521	9	8	1	525	0	543
14522	4	6	3	533	0	546
14523	531	1	1	16	0	549
14524	8	536	0	9	0	553
14525	542	7	3	6	0	558
14526	7	8	3	544	0	562
14527	536	3	1	14	0	554
14528	10	4	510	6	0	530
14529	11	510	7	4	0	532
14530	6	8	7	502	0	523
14531	5	539	1	8	0	553
14532	8	8	1	522	0	539
14533	520	7	1	16	0	544
14534	11	3	515	7	0	536
14535	492	2	10	9	0	513
14536	11	541	10	4	0	566
14537	7	10	5	547	0	569
14538	6	7	1	546	0	560
14539	524	3	4	20	0	551
14540	10	3	523	7	0	543
14541	11	2	8	529	0	550
14542	4	2	9	531	0	546
14543	3	2	4	525	0	534
14544	5	3	3	528	0	539
14545	520	2	2	20	0	544
14546	521	3	4	11	0	539
14547	16	1	524	6	0	547
14548	10	1	490	7	0	508
14549	511	3	11	9	0	534
14550	529	1	8	7	0	545
14551	18	3	3	522	0	546
14552	8	2	2	519	0	531
14553	508	1	4	15	0	528
14554	8	509	4	12	0	533
14555	9	6	3	510	0	528
14556	5	4	2	521	0	532
14557	3	1	497	17	0	518
14558	7	3	9	490	0	509
14559	6	2	499	9	0	516
14560	6	2	9	501	0	518
14561	497	1	6	14	0	518
14562	11	2	4	496	0	513
14563	7	3	491	12	0	513
14564	5	477	8	10	0	500
14565	6	8	4	487	0	505
14566	8	5	490	11	0	514
14567	6	492	7	7	0	512
14568	4	10	7	478	0	499
14569	2	6	475	12	0	495
14570	385	1	7	9	0	402
14571	8	462	5	4	0	479
14572	4	430	2	4	0	440
14573	4	433	0	4	0	441
14574	8	9	3	418	0	438
14575	3	2	427	7	0	439
14576	2	413	6	2	0	423
14577	1	4	3	414	0	422
14578	429	1	1	6	0	437
14579	7	1	0	574	0	582
14580	0	1	670	9	0	680
14581	1	664	14	1	0	680
14582	650	12	1	3	0	666
14583	13	658	0	1	0	672
14584	1	13	637	0	0	651
14585	1	650	13	1	0	665
14586	7	11	2	638	0	658
14587	0	2	644	11	0	657
14588	0	636	15	0	0	651
14589	6	16	1	623	0	646
14590	6	5	1	626	0	638
14591	0	640	4	15	0	659
14592	0	16	2	630	0	648
14593	0	4	625	15	0	644
14594	1	3	635	3	0	642
14595	2	5	16	620	0	643
14596	622	3	1	19	0	645
14597	635	2	1	7	0	645
14598	17	4	0	620	0	641
14599	1	626	1	17	0	645
14600	6	13	6	608	0	633
14601	612	1	6	16	0	635
14602	16	2	3	602	0	623
14603	10	2	0	611	0	623
14604	599	3	0	17	0	619
14605	15	587	3	8	0	613
14606	3	18	3	592	0	616
14607	582	5	1	21	0	609
14608	19	1	563	6	0	589
14609	565	3	14	9	0	591
14610	17	1	1	579	0	598
14611	573	2	0	20	0	595
14612	581	7	0	6	0	594
14613	558	3	1	8	0	570
14614	17	567	3	4	0	591
14615	4	13	568	3	0	588
14616	5	568	17	5	0	595
14617	564	14	1	6	0	585
14618	19	559	2	4	0	584
14619	16	13	1	556	0	586
14620	538	5	2	16	0	561
14621	15	544	2	2	0	563
14622	4	18	544	2	0	568
14623	10	6	15	526	0	557
14624	7	3	536	16	0	562
14625	6	545	13	7	0	571
14626	5	19	1	531	0	556
14627	6	5	1	547	0	559
14628	5	5	4	546	0	560
14629	5	4	7	516	0	532
14630	3	530	4	18	0	555
14631	514	16	6	9	0	545
14632	18	8	512	4	0	542
14633	10	3	13	519	0	545
14634	516	2	4	21	0	543
14635	14	7	511	10	0	542
14636	4	500	17	9	0	530
14637	3	23	4	499	0	529
14638	8	4	500	16	0	528
14639	5	502	19	6	0	532
14640	491	18	4	10	0	523
14641	21	496	4	7	0	528
14642	7	21	4	495	0	527
14643	3	10	7	510	0	530
14644	489	5	6	23	0	523
14645	15	492	10	12	0	529
14646	8	19	4	489	0	520
14647	485	11	4	20	0	520
14648	482	6	6	7	0	501
14649	16	481	1	14	0	512
14650	472	13	8	14	0	507
14651	491	13	2	4	0	510
14652	24	7	2	480	0	513
14653	6	8	474	21	0	509
14654	3	3	15	480	0	501
14655	16	4	2	483	0	505
14656	8	7	466	19	0	500
14657	11	458	18	5	0	492
14658	10	15	4	465	0	494
14659	10	4	9	476	0	499
14660	16	5	7	475	0	503
14661	14	4	5	461	0	484
14662	5	465	4	23	0	497
14663	471	15	5	12	0	503
14664	475	4	5	11	0	495
14665	466	10	1	10	0	487
14666	20	440	2	15	0	477
14667	11	18	2	441	0	472
14668	7	5	434	27	0	473
14669	9	8	12	421	0	450
14670	10	440	2	20	0	472
14671	429	17	3	8	0	457
14672	433	6	1	9	0	449
14673	422	6	2	10	0	440
14674	16	404	6	8	0	434
14675	7	378	6	9	0	400
14676	8	404	6	10	0	428
14677	9	19	396	5	0	429
14678	8	14	363	12	0	397
14679	10	60	9	129	0	208
14680	93	0	3	3	0	99
14681	87	3	0	2	0	92
14682	1	0	1	91	0	93
14683	0	1	1	88	0	90
14684	3	1	0	87	0	91
14685	3	0	0	90	0	93
14686	81	3	0	2	0	86
14687	82	1	0	3	0	86
14688	1	82	2	2	0	87
14689	80	1	1	4	0	86
14690	87	1	0	1	0	89
14691	82	1	2	1	0	86
14692	3	3	65	0	0	71
14693	77	1	0	3	0	81
14694	1	77	4	0	0	82
14695	1	5	0	80	0	86
14696	3	0	1	81	0	85
14697	1	85	1	2	0	89
14698	0	1	2	89	0	92
14699	86	0	1	4	0	91
14700	4	1	0	86	0	91
14701	1	2	86	2	0	91
14702	81	2	1	3	0	87
14703	2	95	2	3	0	102
14704	1	2	1	99	0	103
14705	1	2	0	101	0	104
14706	4	0	1	98	0	103
14707	3	3	97	1	0	104
14708	4	97	1	3	0	105
14709	1	3	2	98	0	104
14710	2	0	97	5	0	104
14711	0	1	1	91	0	93
14712	2	0	90	2	0	94
14713	0	3	1	82	0	86
14714	0	84	0	5	0	89
14715	1	2	0	86	0	89
14716	83	0	0	3	0	86
14717	85	1	0	3	0	89
14718	3	1	94	0	0	98
14719	1	1	87	1	0	90
14720	0	1	107	2	0	110
14721	1	1	3	105	0	110
14722	0	1	1	109	0	111
14723	0	1	1	110	0	112
14724	1	106	2	3	0	112
14725	2	1	0	105	0	108
14726	3	0	1	106	0	110
14727	0	2	0	109	0	111
14728	110	1	0	5	0	116
14729	111	1	1	2	0	115
14730	1	1	111	2	0	115
14731	2	0	112	0	0	114
14732	110	0	1	2	0	113
14733	113	1	0	1	0	115
14734	3	1	116	1	0	121
14735	1	0	113	1	0	115
14736	123	0	0	1	0	124
14737	125	0	1	2	0	128
14738	1	1	134	1	0	137
14739	1	0	1	133	0	135
14740	2	0	0	133	0	135
14741	0	144	0	3	0	147
14742	1	1	1	145	0	148
14743	2	2	156	1	0	161
14744	2	1	0	153	0	156
14745	1	0	1	160	0	162
14746	1	0	156	4	0	161
14747	155	1	2	2	0	160
14748	161	0	1	2	0	164
14749	1	2	1	156	0	160
14750	0	1	1	161	0	163
14751	160	0	1	3	0	164
14752	159	0	0	3	0	162
14753	152	0	3	1	0	156
14754	158	1	2	1	0	162
14755	3	158	0	1	0	162
14756	155	2	1	2	0	160
14757	2	155	1	2	0	160
14758	0	1	1	155	0	157
14759	0	0	1	156	0	157
14760	0	154	2	1	0	157
14761	1	2	1	153	0	157
14762	2	0	1	155	0	158
14763	1	147	1	3	0	152
14764	0	1	1	155	0	157
14765	0	1	3	152	0	156
14766	2	0	0	150	0	152
14767	1	0	149	3	0	153
14768	0	144	0	3	0	147
14769	2	0	0	138	0	140
14770	1	146	0	0	0	147
14771	147	0	1	2	0	150
14772	1	0	148	1	0	150
14773	1	0	141	1	0	143
14774	151	0	0	0	0	151
14775	3	0	1	148	0	152
14776	0	0	143	0	0	143
14777	1	0	133	0	0	134
14778	2	2	0	132	0	136
14779	135	0	1	1	0	137
14780	135	0	1	1	0	137
14781	0	0	1	136	0	137
14782	1	2	140	0	0	143
14783	1	142	0	2	0	145
14784	1	0	2	151	0	154
14785	0	0	149	2	0	151
14786	0	153	0	2	0	155
14787	0	1	1	155	0	157
14788	155	0	0	1	0	156
14789	2	0	1	151	0	154
14790	0	152	0	2	0	154
14791	149	0	0	2	0	151
14792	1	0	157	0	0	158
14793	2	154	0	0	0	156
14794	2	0	157	1	0	160
14795	151	0	5	2	0	158
14796	0	0	0	150	0	150
14797	0	0	0	150	0	150
14798	150	0	0	0	0	150
14799	1	0	0	148	0	149
14800	1	0	147	0	0	148
14801	143	0	0	2	0	145
14802	0	143	0	1	0	144
14803	1	0	0	138	0	139
14804	138	0	0	0	0	138
14805	0	135	0	0	0	135
14806	1	0	0	143	0	144
14807	146	1	0	0	0	147
14808	0	0	0	141	0	141
14809	0	141	0	0	0	141
14810	0	0	146	1	0	147
14811	0	0	0	146	0	146
14812	1	1	0	140	0	142
14813	147	0	0	0	0	147
14814	0	0	0	150	0	150
14815	146	1	0	1	0	148
14816	147	0	0	2	0	149
14817	0	0	0	150	0	150
14818	0	145	0	1	0	146
14819	0	0	1	146	0	147
14820	136	1	0	0	0	137
14821	0	138	0	0	0	138
14822	0	146	0	0	0	146
14823	157	0	0	0	0	157
14824	154	0	0	1	0	155
14825	0	156	1	0	0	157
14826	163	0	0	0	0	163
14827	157	0	0	4	0	161
14828	1	0	1	161	0	163
14829	0	0	170	0	0	170
14830	0	0	0	166	0	166
14831	0	0	170	0	0	170
14832	1	0	0	170	0	171
14833	0	0	167	1	0	168
14834	163	0	0	0	0	163
14835	2	1	0	157	0	160
14836	157	0	0	2	0	159
14837	1	0	0	157	0	158
14838	0	161	0	1	0	162
14839	164	1	0	1	0	166
14840	2	1	157	0	0	160
14841	144	0	1	0	0	145
14842	0	149	0	0	0	149
14843	144	1	0	1	0	146
14844	143	0	0	0	0	143
14845	1	142	0	0	0	143
14846	0	1	0	156	0	157
14847	151	0	0	1	0	152
14848	1	151	0	2	0	154
14849	0	1	0	151	0	152
14850	150	0	0	1	0	151
14851	1	0	1	150	0	152
14852	1	0	0	147	0	148
14853	0	0	0	154	0	154
14854	0	2	149	1	0	152
14855	1	0	1	152	0	154
14856	155	0	0	1	0	156
14857	2	0	152	0	0	154
14858	1	1	1	154	0	157
14859	1	0	0	152	0	153
14860	1	0	150	2	0	153
14861	149	1	2	0	0	152
14862	153	0	0	2	0	155
14863	1	0	154	0	0	155
14864	0	1	1	150	0	152
14865	0	0	1	154	0	155
14866	2	0	156	1	0	159
14867	1	0	1	161	0	163
14868	3	0	0	155	0	158
14869	0	0	164	4	0	168
14870	151	1	3	0	0	155
14871	3	0	0	159	0	162
14872	153	0	0	3	0	156
14873	156	0	1	0	0	157
14874	2	2	168	1	0	173
14875	2	0	2	163	0	167
14876	168	0	0	2	0	170
14877	3	170	0	0	0	173
14878	2	3	0	183	0	188
14879	1	0	1	180	0	182
14880	2	1	0	180	0	183
14881	0	1	175	4	0	180
14882	156	0	3	0	0	159
14883	2	0	0	171	0	173
14884	0	0	0	164	0	164
14885	0	0	161	3	0	164
14886	1	0	3	149	0	153
14887	1	0	0	160	0	161
14888	154	0	0	4	0	158
14889	3	159	1	0	0	163
14890	0	2	158	1	0	161
14891	158	0	2	2	0	162
14892	3	0	1	161	0	165
14893	1	1	165	3	0	170
14894	2	0	164	2	0	168
14895	1	0	3	166	0	170
14896	0	0	169	4	0	173
14897	1	0	165	1	0	167
14898	3	181	4	0	0	188
14899	0	2	1	191	0	194
14900	0	0	189	5	0	194
14901	3	0	3	176	0	182
14902	213	1	0	4	0	218
14903	2	0	0	199	0	201
14904	2	0	1	200	0	203
14905	203	1	0	5	0	209
14906	203	0	2	2	0	207
14907	4	0	0	211	0	215
14908	2	0	217	5	0	224
14909	0	217	5	1	0	223
14910	0	3	2	219	0	224
14911	218	0	1	7	0	226
14912	220	0	1	3	0	224
14913	5	213	2	1	0	221
14914	1	224	1	0	0	226
14915	224	3	1	2	0	230
14916	224	0	1	4	0	229
14917	5	0	235	2	0	242
14918	4	0	5	238	0	247
14919	0	249	3	5	0	257
14920	253	4	0	3	0	260
14921	8	0	1	248	0	257
14922	1	265	2	3	0	271
14923	2	5	269	2	0	278
14924	0	0	5	260	0	265
14925	0	283	2	4	0	289
14926	282	4	1	2	0	289
14927	289	0	0	1	0	290
14928	5	277	0	2	0	284
14929	274	4	0	2	0	280
14930	278	0	1	2	0	281
14931	6	276	0	1	0	283
14932	1	282	0	2	0	285
14933	3	4	2	285	0	294
14934	283	2	0	5	0	290
14935	5	0	304	1	0	310
14936	275	0	3	2	0	280
14937	4	299	0	1	0	304
14938	304	4	1	1	0	310
14939	307	1	1	0	0	309
14940	301	0	0	1	0	302
14941	4	0	1	295	0	300
14942	0	298	3	3	0	304
14943	301	4	0	2	0	307
14944	3	1	315	1	0	320
14945	1	319	4	0	0	324
14946	0	3	0	320	0	323
14947	1	1	311	3	0	316
14948	0	0	296	1	0	297
14949	0	0	3	307	0	310
14950	1	0	1	315	0	317
14951	2	0	0	316	0	318
14952	3	0	0	314	0	317
14953	1	302	0	3	0	306
14954	2	322	0	0	0	324
14955	324	3	0	1	0	328
14956	4	1	0	324	0	329
14957	4	1	0	324	0	329
14958	3	0	0	331	0	334
14959	328	0	0	5	0	333
14960	320	0	1	2	0	323
14961	5	1	0	323	0	329
14962	337	2	1	4	0	344
14963	335	0	0	3	0	338
14964	338	2	2	1	0	343
14965	5	1	1	336	0	343
14966	0	0	313	6	0	319
14967	0	2	294	0	0	296
14968	2	1	302	0	0	305
14969	1	0	331	1	0	333
14970	1	1	2	331	0	335
14971	336	0	2	5	0	343
14972	338	1	0	1	0	340
14973	2	3	333	1	0	339
14974	1	3	306	0	0	310
14975	3	343	2	1	0	349
14976	2	3	0	355	0	360
14977	347	2	1	6	0	356
14978	5	0	347	1	0	353
14979	326	1	3	0	0	330
14980	5	360	1	0	0	366
14981	1	2	0	373	0	376
14982	3	1	1	400	0	405
14983	3	0	2	394	0	399
14984	401	1	0	5	0	407
14985	7	1	0	402	0	410
14986	1	0	4	400	0	405
14987	391	1	1	8	0	401
14988	5	2	0	394	0	401
14989	1	1	410	4	0	416
14990	396	0	4	6	0	406
14991	6	1	0	409	0	416
14992	3	0	0	404	0	407
14993	1	410	2	4	0	417
14994	409	5	2	2	0	418
14995	413	3	1	3	0	420
14996	6	1	0	414	0	421
14997	5	0	409	4	0	418
14998	356	0	7	3	0	366
14999	7	0	397	1	0	405
15000	0	2	4	390	0	396
15001	2	0	1	402	0	405
15002	399	0	1	7	0	407
15003	6	0	1	409	0	416
15004	2	1	403	4	0	410
15005	382	2	4	2	0	390
15006	7	0	410	3	0	420
15007	3	1	404	0	0	408
15008	412	0	3	1	0	416
15009	2	0	3	435	0	440
15010	2	458	1	2	0	463
15011	457	1	0	5	0	463
15012	447	0	0	3	0	450
15013	2	2	452	0	0	456
15014	441	0	2	1	0	444
15015	4	0	0	470	0	474
15016	0	1	469	5	0	475
15017	0	452	4	0	0	456
15018	448	2	0	2	0	452
15019	3	446	2	0	0	451
15020	0	2	0	454	0	456
15021	0	0	0	456	0	456
15022	3	0	0	433	0	436
15023	0	0	0	420	0	420
15024	0	424	3	3	0	430
15025	3	3	414	0	0	420
15026	0	425	3	1	0	429
15027	416	2	3	9	0	430
15028	4	1	0	429	0	434
15029	429	0	0	2	0	431
15030	3	1	0	433	0	437
15031	450	0	0	6	0	456
15032	4	451	3	1	0	459
15033	444	2	2	2	0	450
15034	449	0	1	2	0	452
15035	420	0	0	4	0	424
15036	420	0	2	2	0	424
15037	3	423	0	0	0	426
15038	1	2	425	1	0	429
15039	2	0	3	421	0	426
15040	431	0	0	4	0	435
15041	434	0	1	2	0	437
15042	3	0	0	438	0	441
15043	0	0	474	3	0	477
15044	1	1	2	441	0	445
15045	1	467	1	2	0	471
15046	465	2	1	2	0	470
15047	4	0	0	467	0	471
15048	1	488	1	3	0	493
15049	2	509	0	1	0	512
15050	0	519	1	1	0	521
15051	2	3	0	544	0	549
15052	547	1	1	7	0	556
15053	5	546	1	12	0	564
15054	2	4	0	553	0	559
15055	556	0	0	7	0	563
15056	7	1	1	558	0	567
15057	560	2	0	7	0	569
15058	563	0	2	5	0	570
15059	9	602	0	3	0	614
15060	1	7	1	583	0	592
15061	2	608	0	5	0	615
15062	594	6	1	5	0	606
15063	601	1	1	2	0	605
15064	624	0	0	3	0	627
15065	9	1	2	623	0	635
15066	3	1	618	6	0	628
15067	594	0	6	4	0	604
15068	630	3	1	2	0	636
15069	11	1	0	600	0	612
15070	4	619	1	8	0	632
15071	5	8	1	616	0	630
15072	4	2	0	630	0	636
15073	618	1	2	10	0	631
15074	624	1	3	6	0	634
15075	9	1	613	1	0	624
15076	3	2	5	599	0	609
15077	607	4	1	8	0	620
15078	12	2	0	609	0	623
15079	3	1	612	7	0	623
15080	3	573	7	4	0	587
15081	4	601	1	2	0	608
15082	623	7	1	4	0	635
15083	7	0	2	672	0	681
15084	5	2	0	766	0	773
15085	759	1	0	15	0	775
15086	9	3	758	5	0	775
15087	8	1	8	758	0	775
15088	2	2	764	14	0	782
15089	7	750	10	4	0	771
15090	760	9	6	5	0	780
15091	780	3	2	6	0	791
15092	784	2	4	7	0	797
15093	16	6	762	1	0	785
15094	793	2	9	5	0	809
15095	804	1	4	5	0	814
15096	22	1	4	794	0	821
15097	678	0	9	25	0	712
15098	18	0	782	5	0	805
15099	766	4	10	9	0	789
15100	16	0	777	5	0	798
15101	10	812	13	3	0	838
15102	10	15	8	736	0	769
15103	12	796	5	10	0	823
15104	6	15	792	3	0	816
15105	4	804	16	2	0	826
15106	755	22	3	9	0	789
15107	13	750	4	1	0	768
15108	6	751	6	2	0	765
15109	6	19	735	1	0	761
15110	10	6	15	714	0	745
15111	724	8	5	16	0	753
15112	11	7	730	4	0	752
15113	6	719	13	4	0	742
15114	8	13	6	726	0	753
15115	6	7	751	13	0	777
15116	3	4	747	3	0	757
15117	3	8	15	742	0	768
15118	3	3	747	17	0	770
15119	2	4	18	687	0	711
15120	4	719	7	11	0	741
15121	5	12	7	715	0	739
15122	1	741	6	15	0	763
15123	6	14	4	736	0	760
15124	730	8	3	21	0	762
15125	12	5	3	738	0	758
15126	6	742	2	15	0	765
15127	2	15	4	757	0	778
15128	5	5	740	15	0	765
15129	6	3	11	747	0	767
15130	747	6	7	17	0	777
15131	14	2	719	10	0	745
15132	6	2	20	723	0	751
15133	712	2	4	23	0	741
15134	17	717	3	7	0	744
15135	8	14	5	723	0	750
15136	724	6	0	17	0	747
15137	19	3	1	724	0	747
15138	9	6	720	14	0	749
15139	690	2	15	15	0	722
15140	20	704	8	7	0	739
15141	5	730	7	9	0	751
15142	721	16	8	7	0	752
15143	698	6	8	2	0	714
15144	20	8	2	682	0	712
15145	687	5	2	15	0	709
15146	19	6	665	5	0	695
15147	663	4	12	10	0	689
15148	19	642	6	8	0	675
15149	646	14	4	9	0	673
15150	16	6	641	3	0	666
15151	10	7	13	615	0	645
15152	9	6	9	627	0	651
15153	9	6	7	588	0	610
15154	7	618	6	13	0	644
15155	613	13	6	11	0	643
15156	14	8	2	593	0	617
15157	9	608	3	15	0	635
15158	633	12	8	9	0	662
15159	617	9	3	6	0	635
15160	629	5	4	9	0	647
15161	628	6	4	6	0	644
15162	617	3	6	11	0	637
15163	19	5	3	620	0	647
15164	16	1	4	606	0	627
15165	602	4	3	16	0	625
15166	14	6	3	598	0	621
15167	9	4	2	602	0	617
15168	4	3	575	21	0	603
15169	577	5	11	13	0	606
15170	591	3	5	10	0	609
15171	578	3	5	12	0	598
15172	18	3	4	551	0	576
15173	15	577	1	10	0	603
15174	621	8	6	8	0	643
15175	597	3	1	13	0	614
15176	21	3	2	676	0	702
15177	684	6	6	16	0	712
15178	25	14	547	18	0	604
15179	15	672	10	12	0	709
15180	13	697	8	10	0	728
15181	21	19	677	9	0	726
15182	17	606	20	4	0	647
15183	3	575	9	8	0	595
15184	482	18	11	1	0	512
15185	11	493	4	3	0	511
15186	11	14	4	487	0	516
15187	504	11	1	14	0	530
15188	15	11	476	6	0	508
15189	484	2	10	10	0	506
15190	15	5	479	7	0	506
15191	9	3	480	6	0	498
15192	455	4	14	4	0	477
15193	9	1	470	2	0	482
15194	11	442	12	3	0	468
15195	14	5	8	443	0	470
15196	444	7	6	9	0	466
15197	9	438	3	9	0	459
15198	9	7	4	440	0	460
15199	5	7	436	11	0	459
15200	4	7	6	429	0	446
15201	413	2	7	11	0	433
15202	9	2	408	10	0	429
15203	9	1	8	412	0	430
15204	409	4	8	10	0	431
15205	423	0	4	12	0	439
15206	21	1	2	433	0	457
15207	11	2	3	432	0	448
15208	8	0	439	12	0	459
15209	7	2	413	8	0	430
15210	426	0	9	6	0	441
15211	450	0	9	7	0	466
15212	9	457	7	3	0	476
15213	456	4	3	3	0	466
15214	460	7	3	3	0	473
15215	15	6	466	1	0	488
15216	13	484	5	1	0	503
15217	485	6	4	5	0	500
15218	498	6	5	1	0	510
15219	515	4	3	4	0	526
15220	14	2	2	504	0	522
15221	12	1	0	503	0	516
15222	9	503	0	9	0	521
15223	7	2	0	518	0	527
15224	505	5	0	10	0	520
15225	4	4	1	518	0	527
15226	7	3	496	10	0	516
15227	5	3	494	8	0	510
15228	3	0	9	504	0	516
15229	4	0	521	6	0	531
15230	3	2	494	8	0	507
15231	0	0	13	506	0	519
15232	1	1	10	515	0	527
15233	0	0	528	12	0	540
15234	2	2	527	10	0	541
15235	2	524	11	6	0	543
15236	528	5	9	5	0	547
15237	3	553	8	3	0	567
15238	551	9	3	1	0	564
15239	564	7	3	2	0	576
15240	14	575	1	0	0	590
15241	576	7	0	2	0	585
15242	14	8	0	570	0	592
15243	12	5	557	6	0	580
15244	7	3	7	555	0	572
15245	4	3	6	569	0	582
15246	543	1	5	14	0	563
15247	541	2	4	15	0	562
15248	555	1	5	6	0	567
15249	548	1	2	6	0	557
15250	533	2	2	5	0	542
15251	18	513	5	2	0	538
15252	15	6	1	522	0	544
15253	9	8	519	7	0	543
15254	7	2	7	525	0	541
15255	4	1	10	523	0	538
15256	3	3	5	549	0	560
15257	561	1	4	22	0	588
15258	11	2	5	550	0	568
15259	541	2	1	18	0	562
15260	21	0	536	11	0	568
15261	12	3	12	635	0	662
15262	9	2	636	17	0	664
15263	633	0	22	14	0	669
15264	23	2	12	651	0	688
15265	10	1	659	21	0	691
15266	7	0	19	664	0	690
15267	669	2	12	26	0	709
15268	21	1	678	16	0	716
15269	665	0	20	12	0	697
15270	715	2	11	8	0	736
15271	705	1	5	10	0	721
15272	715	2	7	5	0	729
15273	34	673	5	6	0	718
15274	23	623	2	4	0	652
15275	12	629	4	3	0	648
15276	4	18	3	540	0	565
15277	6	555	1	17	0	579
15278	554	15	6	6	0	581
15279	17	528	5	3	0	553
15280	7	557	2	5	0	571
15281	10	16	3	546	0	575
15282	4	8	2	566	0	580
15283	546	2	3	21	0	572
15284	16	5	4	540	0	565
15285	9	4	529	17	0	559
15286	6	1	503	8	0	518
15287	5	4	533	6	0	548
15288	8	2	20	512	0	542
15289	9	3	7	548	0	567
15290	6	5	531	19	0	561
15291	6	7	523	9	0	545
15292	13	1	550	5	0	569
15293	546	5	19	4	0	574
15294	24	4	8	553	0	589
15295	12	5	4	565	0	586
15296	556	7	5	24	0	592
15297	15	4	6	558	0	583
15298	7	557	5	21	0	590
15299	8	586	5	11	0	610
15300	8	17	1	593	0	619
15301	585	7	3	24	0	619
15302	595	4	5	10	0	614
15303	608	3	4	5	0	620
15304	20	2	3	590	0	615
15305	8	4	590	23	0	625
15306	8	2	17	580	0	607
15307	4	1	576	20	0	601
15308	537	1	19	8	0	565
15309	16	4	9	555	0	584
15310	551	2	7	21	0	581
15311	14	1	557	16	0	588
15312	505	1	19	15	0	540
15313	21	0	565	5	0	591
15314	11	537	20	10	0	578
15315	11	539	9	5	0	564
15316	531	15	13	7	0	566
15317	26	5	2	539	0	572
15318	14	4	538	16	0	572
15319	13	508	13	7	0	541
15320	5	534	8	8	0	555
15321	11	22	5	525	0	563
15322	536	8	3	21	0	568
15323	541	3	3	8	0	555
15324	22	527	3	9	0	561
15325	540	18	1	7	0	566
15326	23	11	0	537	0	571
15327	9	7	531	18	0	565
15328	9	533	18	9	0	569
15329	7	15	8	525	0	555
15330	7	11	8	531	0	557
15331	518	10	2	24	0	554
15332	20	2	513	13	0	548
15333	511	2	14	11	0	538
15334	524	1	11	7	0	543
15335	20	5	7	509	0	541
15336	14	2	3	526	0	545
15337	492	2	7	27	0	528
15338	28	3	8	497	0	536
15339	11	4	476	19	0	510
15340	7	2	461	12	0	482
15341	8	461	17	7	0	493
15342	5	510	9	4	0	528
15343	4	19	8	487	0	518
15344	10	493	5	10	0	518
15345	493	19	2	12	0	526
15346	17	507	3	9	0	536
15347	8	20	3	509	0	540
15348	10	6	3	520	0	539
15349	4	8	500	22	0	534
15350	9	4	16	498	0	527
15351	6	6	4	512	0	528
15352	5	516	4	21	0	546
15353	10	17	1	522	0	550
15354	10	4	2	536	0	552
15355	4	3	512	25	0	544
15356	5	501	25	8	0	539
15357	2	27	5	454	0	488
15358	2	484	6	17	0	509
15359	4	15	462	6	0	487
15360	2	454	14	7	0	477
15361	350	12	5	3	0	370
15362	357	3	2	3	0	365
15363	342	1	0	12	0	355
15364	8	328	3	2	0	341
15365	333	9	1	1	0	344
15366	6	2	0	330	0	338
15367	313	1	0	10	0	324
15368	7	292	2	3	0	304
15369	297	6	1	3	0	307
15370	298	1	0	6	0	305
15371	5	297	0	1	0	303
15372	2	5	300	3	0	310
15373	2	2	6	339	0	349
15374	4	2	364	5	0	375
15375	0	3	8	368	0	379
15376	5	0	3	395	0	403
15377	1	3	396	13	0	413
15378	3	1	9	394	0	407
15379	402	3	3	11	0	419
15380	10	0	402	7	0	419
15381	5	404	9	3	0	421
15382	7	9	5	391	0	412
15383	1	6	2	411	0	420
15384	2	1	396	14	0	413
15385	2	2	10	385	0	399
15386	1	396	4	13	0	414
15387	382	10	1	7	0	400
15388	11	393	2	2	0	408
15389	375	12	1	5	0	393
15390	10	374	1	1	0	386
15391	4	393	2	2	0	401
15392	2	11	374	2	0	389
15393	1	6	11	375	0	393
15394	3	2	3	377	0	385
15395	3	0	2	386	0	391
15396	2	399	2	15	0	418
15397	2	14	2	409	0	427
15398	408	5	1	17	0	431
15399	14	5	1	404	0	424
15400	401	1	1	18	0	421
15401	13	3	391	7	0	414
15402	404	1	10	8	0	423
15403	18	1	11	397	0	427
15404	7	3	4	425	0	439
15405	421	3	2	20	0	446
15406	14	0	412	16	0	442
15407	7	416	15	5	0	443
15408	7	12	8	426	0	453
15409	411	9	4	17	0	441
15410	422	8	3	10	0	443
15411	23	2	1	420	0	446
15412	13	3	413	14	0	443
15413	400	5	12	9	0	426
15414	13	3	413	7	0	436
15415	10	2	16	407	0	435
15416	5	3	408	19	0	435
15417	6	1	16	399	0	422
15418	4	2	396	18	0	420
15419	2	397	15	13	0	427
15420	6	14	5	349	0	374
15421	4	404	6	12	0	426
15422	405	15	0	10	0	430
15423	412	6	6	4	0	428
15424	23	3	396	4	0	426
15425	10	1	16	396	0	423
15426	406	0	6	16	0	428
15427	15	2	8	404	0	429
15428	10	0	1	410	0	421
15429	5	3	398	19	0	425
15430	379	4	10	13	0	406
15431	14	2	396	7	0	419
15432	10	4	15	391	0	420
15433	7	1	399	14	0	421
15434	397	1	15	12	0	425
15435	406	1	10	5	0	422
15436	414	1	6	4	0	425
15437	23	0	2	404	0	429
15438	9	1	399	15	0	424
15439	10	2	392	10	0	414
15440	2	0	22	336	0	360
15441	3	390	11	15	0	419
15442	361	10	10	7	0	388
15443	12	9	0	373	0	394
15444	9	4	366	11	0	390
15445	9	2	9	369	0	389
15446	5	1	370	13	0	389
15447	6	3	13	376	0	398
15448	5	0	375	15	0	395
15449	3	0	376	10	0	389
15450	3	356	25	7	0	391
15451	2	8	375	6	0	391
15452	6	7	363	4	0	380
15453	5	5	17	302	0	329
15454	4	1	11	311	0	327
15455	1	345	10	13	0	369
15456	345	6	3	9	0	363
15457	9	346	6	5	0	366
15458	10	9	2	338	0	359
15459	339	7	6	9	0	361
15460	13	2	3	343	0	361
15461	343	3	7	11	0	364
15462	15	2	3	343	0	363
15463	6	1	338	14	0	359
15464	5	1	9	350	0	365
15465	5	1	7	343	0	356
15466	340	4	5	15	0	364
15467	339	3	2	15	0	359
15468	348	2	7	4	0	361
15469	17	313	4	8	0	342
15470	12	334	4	4	0	354
15471	324	13	5	8	0	350
15472	11	8	323	2	0	344
15473	9	4	283	6	0	302
15474	5	18	11	231	0	265
15475	1	2	250	10	0	263
15476	3	2	228	5	0	238
15477	202	2	11	4	0	219
15478	219	0	9	2	0	230
15479	9	209	4	3	0	225
15480	6	219	4	4	0	233
15481	5	9	1	201	0	216
15482	4	223	1	8	0	236
15483	226	9	2	2	0	239
15484	6	2	2	219	0	229
15485	6	226	3	6	0	241
15486	228	5	2	5	0	240
15487	7	4	225	4	0	240
15488	6	4	216	1	0	227
15489	222	1	9	3	0	235
15490	6	2	223	2	0	233
15491	207	0	8	2	0	217
15492	8	0	8	212	0	228
15493	6	0	212	4	0	222
15494	7	203	5	5	0	220
15495	0	216	7	3	0	226
15496	171	8	1	2	0	182
15497	6	179	0	1	0	186
15498	165	3	1	2	0	171
15499	161	3	1	0	0	165
15500	4	161	0	1	0	166
15501	4	8	1	158	0	171
15502	0	3	168	4	0	175
15503	1	181	5	2	0	189
15504	2	3	4	185	0	194
15505	1	4	1	211	0	217
15506	200	1	0	8	0	209
15507	6	0	1	206	0	213
15508	3	1	202	4	0	210
15509	1	201	4	4	0	210
15510	2	4	3	203	0	212
15511	205	3	1	5	0	214
15512	208	1	0	5	0	214
15513	6	0	2	207	0	215
15514	210	1	2	5	0	218
15515	6	1	205	3	0	215
15516	5	0	4	209	0	218
15517	3	1	209	4	0	217
15518	2	1	6	236	0	245
15519	1	1	3	228	0	233
15520	1	0	2	227	0	230
15521	3	0	1	222	0	226
15522	1	0	1	224	0	226
15523	213	1	1	14	0	229
15524	220	0	0	7	0	227
15525	9	220	1	2	0	232
15526	222	6	1	4	0	233
15527	12	2	0	218	0	232
15528	5	1	1	227	0	234
15529	2	0	0	229	0	231
15530	2	1	222	11	0	236
15531	2	0	8	209	0	219
15532	1	221	3	8	0	233
15533	221	7	2	2	0	232
15534	229	3	0	4	0	236
15535	9	2	226	2	0	239
15536	5	216	7	2	0	230
15537	2	6	3	214	0	225
15538	1	6	218	7	0	232
15539	3	1	7	212	0	223
15540	2	218	6	5	0	231
15541	221	9	2	2	0	234
15542	7	224	0	2	0	233
15543	3	7	222	3	0	235
15544	2	3	225	2	0	232
15545	0	217	8	3	0	228
15546	1	224	6	0	0	231
15547	208	8	3	4	0	223
15548	211	5	0	3	0	219
15549	11	1	2	213	0	227
15550	5	0	213	7	0	225
15551	1	1	7	210	0	219
15552	0	2	3	217	0	222
15553	215	0	1	12	0	228
15554	219	0	1	7	0	227
15555	12	0	1	219	0	232
15556	4	1	225	7	0	237
15557	2	223	6	4	0	235
15558	218	8	3	4	0	233
15559	8	243	2	2	0	255
15560	4	6	0	247	0	257
15561	4	4	0	253	0	261
15562	1	2	2	252	0	257
15563	2	2	0	254	0	258
15564	239	1	0	13	0	253
15565	10	2	0	244	0	256
15566	7	231	1	10	0	249
15567	1	6	1	242	0	250
15568	232	3	2	11	0	248
15569	7	233	1	8	0	249
15570	6	6	0	234	0	246
15571	3	3	232	9	0	247
15572	232	5	6	4	0	247
15573	8	1	4	227	0	240
15574	8	1	225	7	0	241
15575	2	2	224	3	0	231
15576	0	1	8	232	0	241
15577	228	1	7	10	0	246
15578	221	1	3	5	0	230
15579	8	226	0	6	0	240
15580	223	7	2	2	0	234
15581	223	3	1	5	0	232
15582	222	2	1	4	0	229
15583	222	0	1	4	0	227
15584	10	0	2	216	0	228
15585	5	2	0	221	0	228
15586	5	2	208	10	0	225
15587	5	197	6	6	0	214
15588	4	210	4	2	0	220
15589	2	7	210	3	0	222
15590	210	3	9	1	0	223
15591	6	2	2	220	0	230
15592	215	1	3	8	0	227
15593	224	1	1	4	0	230
15594	8	2	211	3	0	224
15595	6	2	7	212	0	227
15596	224	1	2	6	0	233
15597	7	1	2	217	0	227
15598	3	2	223	7	0	235
15599	3	7	6	216	0	232
15600	1	230	2	7	0	240
15601	1	238	2	3	0	244
15602	2	4	217	3	0	226
15603	0	204	6	4	0	214
15604	184	4	1	0	0	189
15605	164	0	0	3	0	167
15606	4	1	1	161	0	167
15607	4	0	1	159	0	164
15608	3	0	0	164	0	167
15609	158	1	0	5	0	164
15610	5	160	1	2	0	168
15611	159	5	1	0	0	165
15612	162	0	0	0	0	162
15613	5	156	0	3	0	164
15614	148	4	3	0	0	155
15615	3	151	1	0	0	155
15616	150	3	0	1	0	154
15617	5	2	150	0	0	157
15618	118	0	3	2	0	123
15619	2	121	0	2	0	125
15620	0	3	0	122	0	125
15621	0	0	0	122	0	122
15622	2	0	0	120	0	122
15623	123	0	0	5	0	128
15624	3	2	0	128	0	133
15625	0	0	125	4	0	129
15626	133	0	3	0	0	136
15627	3	2	129	0	0	134
15628	0	0	3	141	0	144
15629	0	0	141	3	0	144
15630	2	0	3	131	0	136
15631	0	138	0	4	0	142
15632	0	3	2	134	0	139
15633	0	138	2	3	0	143
15634	0	3	0	138	0	141
15635	137	0	0	3	0	140
15636	5	0	0	136	0	141
15637	141	2	0	4	0	147
15638	6	1	142	0	0	149
15639	145	0	2	0	0	147
15640	149	0	0	1	0	150
15641	150	0	0	0	0	150
15642	3	0	0	147	0	150
15643	142	0	0	5	0	147
15644	3	0	145	0	0	148
15645	138	2	3	0	0	143
15646	3	2	142	0	0	147
15647	139	0	5	0	0	144
15648	6	1	0	136	0	143
15649	0	0	143	4	0	147
15650	3	0	2	145	0	150
15651	2	0	0	151	0	153
15652	0	0	147	3	0	150
15653	134	0	3	3	0	140
15654	6	153	0	0	0	159
15655	141	3	8	2	0	154
15656	3	163	0	1	0	167
15657	167	2	1	0	0	170
15658	2	0	165	1	0	168
15659	138	1	6	0	0	145
15660	2	147	0	1	0	150
15661	0	2	0	150	0	152
15662	0	0	0	150	0	150
15663	2	0	0	148	0	150
15664	0	0	148	3	0	151
15665	2	0	2	144	0	148
15666	0	0	153	2	0	155
15667	159	0	2	0	0	161
15668	166	0	0	1	0	167
15669	4	0	0	166	0	170
15670	0	0	175	3	0	178
15671	172	0	2	0	0	174
15672	2	0	211	0	0	213
15673	2	0	2	202	0	206
15674	1	0	0	209	0	210
15675	1	0	0	212	0	213
15676	0	0	0	211	0	211
15677	203	0	1	2	0	206
15678	3	210	0	1	0	214
15679	0	3	200	1	0	204
15680	0	201	4	0	0	205
15681	206	3	0	0	0	209
15682	3	1	0	203	0	207
15683	206	0	0	4	0	210
15684	3	0	0	207	0	210
15685	1	0	0	203	0	204
15686	0	0	1	208	0	209
15687	1	1	204	3	0	209
15688	0	196	3	2	0	201
15689	0	2	214	0	0	216
15690	0	0	3	212	0	215
15691	223	0	0	4	0	227
15692	223	0	1	0	0	224
15693	215	0	0	2	0	217
15694	3	212	1	0	0	216
15695	221	3	0	2	0	226
15696	4	0	0	224	0	228
15697	0	0	0	228	0	228
15698	0	0	1	219	0	220
15699	3	213	0	3	0	219
15700	2	3	0	209	0	214
15701	0	210	0	4	0	214
15702	214	3	1	1	0	219
15703	220	0	0	1	0	221
15704	3	0	2	221	0	226
15705	1	0	222	5	0	228
15706	215	1	3	3	0	222
15707	3	0	0	228	0	231
15708	1	1	224	3	0	229
15709	225	0	3	0	0	228
15710	3	1	0	232	0	236
15711	231	0	0	4	0	235
15712	3	230	0	1	0	234
15713	2	2	0	232	0	236
15714	0	246	0	5	0	251
15715	2	4	1	257	0	264
15716	0	261	0	5	0	266
15717	0	1	1	275	0	277
15718	0	0	268	4	0	272
15719	217	0	3	2	0	222
15720	3	269	0	0	0	272
15721	2	2	271	0	0	275
15722	255	0	2	2	0	259
15723	5	1	0	270	0	276
15724	2	0	261	3	0	266
15725	3	269	3	1	0	276
15726	0	4	1	265	0	270
15727	1	0	267	3	0	271
15728	0	0	3	256	0	259
15729	1	0	0	272	0	273
15730	0	0	276	7	0	283
15731	2	2	3	272	0	279
15732	0	1	282	6	0	289
15733	0	1	3	282	0	286
15734	2	2	317	4	0	325
15735	5	0	4	312	0	321
15736	0	2	0	327	0	329
15737	1	0	3	325	0	329
15738	2	318	0	5	0	325
15739	321	3	0	4	0	328
15740	316	0	1	4	0	321
15741	6	0	1	326	0	333
15742	335	1	0	8	0	344
15743	5	0	338	1	0	344
15744	0	345	3	1	0	349
15745	343	2	2	5	0	352
15746	4	348	0	1	0	353
15747	3	3	1	348	0	355
15748	1	3	0	353	0	357
15749	340	0	0	7	0	347
15750	3	1	2	342	0	348
15751	4	0	341	4	0	349
15752	0	342	2	1	0	345
15753	337	4	3	1	0	345
15754	4	0	0	337	0	341
15755	0	333	0	6	0	339
15756	1	3	1	321	0	326
15757	1	323	0	2	0	326
15758	321	3	0	7	0	331
15759	319	1	2	2	0	324
15760	5	0	319	3	0	327
15761	0	0	307	3	0	310
15762	1	1	5	321	0	328
15763	1	325	1	5	0	332
15764	0	2	2	329	0	333
15765	324	0	1	8	0	333
15766	0	1	317	0	0	318
15767	1	0	3	300	0	304
15768	0	0	304	4	0	308
15769	2	0	299	1	0	302
15770	0	297	2	1	0	300
15771	4	3	0	288	0	295
15772	270	1	2	4	0	277
15773	2	1	275	1	0	279
15774	1	273	3	0	0	277
15775	273	1	0	1	0	275
15776	1	0	0	279	0	280
15777	282	0	0	3	0	285
15778	277	1	1	4	0	283
15779	278	2	0	0	0	280
15780	3	0	293	0	0	296
15781	280	1	0	1	0	282
15782	296	0	0	2	0	298
15783	1	310	1	1	0	313
15784	1	2	0	310	0	313
15785	1	0	0	316	0	317
15786	1	1	1	318	0	321
15787	316	1	0	3	0	320
15788	300	0	0	3	0	303
15789	3	0	304	1	0	308
15790	2	1	1	300	0	304
15791	0	287	3	1	0	291
15792	293	3	0	2	0	298
15793	4	1	290	0	0	295
15794	2	0	2	286	0	290
15795	2	0	2	290	0	294
15796	0	290	2	3	0	295
15797	0	2	1	292	0	295
15798	1	3	0	277	0	281
15799	1	0	0	297	0	298
15800	289	0	0	5	0	294
15801	1	0	3	288	0	292
15802	1	1	0	289	0	291
15803	288	1	1	4	0	294
15804	2	1	1	286	0	290
15805	3	331	0	2	0	336
15806	348	4	1	4	0	357
15807	353	4	0	2	0	359
15808	369	0	3	1	0	373
15809	405	2	1	1	0	409
15810	12	441	0	0	0	453
15811	474	10	0	6	0	490
15812	489	3	0	2	0	494
15813	17	1	0	479	0	497
15814	7	3	466	12	0	488
15815	5	1	11	456	0	473
15816	7	0	4	462	0	473
15817	5	1	2	455	0	463
15818	4	1	1	453	0	459
15819	3	1	0	455	0	459
15820	438	1	1	19	0	459
15821	14	0	2	443	0	459
15822	9	0	443	15	0	467
15823	3	1	10	429	0	443
15824	2	437	5	13	0	457
15825	3	16	1	435	0	455
15826	1	6	434	15	0	456
15827	397	1	11	11	0	420
15828	424	2	4	4	0	434
15829	17	1	449	5	0	472
15830	6	446	14	2	0	468
15831	451	12	6	5	0	474
15832	456	3	2	7	0	468
15833	462	2	2	3	0	469
15834	431	2	0	3	0	436
15835	22	0	0	415	0	437
15836	8	0	411	13	0	432
15837	4	1	11	414	0	430
15838	4	1	5	427	0	437
15839	1	1	411	16	0	429
15840	2	3	414	8	0	427
15841	399	0	16	6	0	421
15842	13	397	10	3	0	423
15843	12	11	4	394	0	421
15844	4	4	393	14	0	415
15845	385	3	15	6	0	409
15846	13	2	401	3	0	419
15847	393	0	15	5	0	413
15848	16	397	6	3	0	422
15849	8	10	2	401	0	421
15850	4	4	399	15	0	422
15851	378	3	10	6	0	397
15852	13	390	5	5	0	413
15853	5	405	3	4	0	417
15854	4	16	3	392	0	415
15855	3	8	3	418	0	432
15856	434	5	3	19	0	461
15857	16	432	3	8	0	459
15858	13	13	0	439	0	465
15859	433	5	1	21	0	460
15860	447	4	5	8	0	464
15861	458	2	1	4	0	465
15862	21	2	454	4	0	481
15863	12	2	463	2	0	479
15864	484	3	17	6	0	510
15865	19	483	7	7	0	516
15866	9	502	5	2	0	518
15867	14	20	1	477	0	512
15868	5	506	1	17	0	529
15869	506	19	2	10	0	537
15870	18	7	2	505	0	532
15871	8	3	500	23	0	534
15872	507	4	17	7	0	535
15873	513	3	6	12	0	534
15874	25	0	5	511	0	541
15875	13	3	3	516	0	535
15876	14	4	3	523	0	544
15877	9	1	2	521	0	533
15878	6	1	498	26	0	531
15879	8	484	19	12	0	523
15880	10	17	5	442	0	474
15881	2	495	8	22	0	527
15882	4	22	6	445	0	477
15883	5	467	2	24	0	498
15884	459	26	2	10	0	497
15885	460	8	3	9	0	480
15886	21	459	3	7	0	490
15887	463	17	4	4	0	488
15888	29	8	3	455	0	495
15889	457	7	1	24	0	489
15890	22	452	3	12	0	489
15891	458	17	5	8	0	488
15892	475	4	5	7	0	491
15893	30	5	4	455	0	494
15894	12	4	446	21	0	483
15895	8	448	16	13	0	485
15896	5	20	8	460	0	493
15897	453	8	7	25	0	493
15898	20	9	449	5	0	483
15899	12	8	16	446	0	482
15900	10	6	4	463	0	483
15901	450	3	11	24	0	488
15902	464	7	5	10	0	486
15903	468	3	2	7	0	480
15904	26	448	3	6	0	483
15905	397	16	1	8	0	422
15906	22	7	365	7	0	401
15907	11	5	375	6	0	397
15908	11	0	370	7	0	388
15909	10	28	19	288	0	345
15910	5	2	280	10	0	297
15911	249	4	8	1	0	262
15912	9	1	1	252	0	263
15913	1	4	258	11	0	274
15914	267	2	9	4	0	282
15915	11	4	0	265	0	280
15916	5	3	3	270	0	281
15917	276	1	5	7	0	289
15918	7	4	3	279	0	293
15919	6	1	274	14	0	295
15920	7	4	5	274	0	290
15921	8	2	278	8	0	296
15922	9	2	9	271	0	291
15923	276	3	1	12	0	292
15924	11	266	4	1	0	282
15925	4	277	2	6	0	289
15926	5	4	7	269	0	285
15927	5	3	4	275	0	287
15928	3	266	6	7	0	282
15929	2	253	2	7	0	264
15930	5	4	4	254	0	267
15931	7	2	1	257	0	267
15932	249	2	3	12	0	266
15933	9	250	5	2	0	266
15934	5	250	0	6	0	261
15935	6	256	1	5	0	268
15936	258	6	4	3	0	271
15937	9	1	250	3	0	263
15938	248	4	7	6	0	265
15939	9	0	2	255	0	266
15940	3	248	4	6	0	261
15941	6	261	2	3	0	272
15942	264	4	1	6	0	275
15943	9	2	1	254	0	266
15944	3	280	3	5	0	291
15945	284	8	2	6	0	300
15946	288	0	2	9	0	299
15947	9	2	284	5	0	300
15948	288	2	6	5	0	301
15949	297	2	2	2	0	303
15950	5	2	1	292	0	300
15951	4	285	5	7	0	301
15952	6	289	1	4	0	300
15953	6	5	3	289	0	303
15954	286	5	1	9	0	301
15955	8	4	264	4	0	280
15956	4	2	242	3	0	251
15957	2	2	252	3	0	259
15958	10	3	253	2	0	268
15959	0	264	6	4	0	274
15960	0	267	1	3	0	271
15961	2	6	251	3	0	262
15962	2	1	241	1	0	245
15963	3	213	3	2	0	221
15964	2	0	2	201	0	205
15965	1	1	213	0	0	215
15966	1	5	0	198	0	204
15967	0	0	1	208	0	209
15968	0	0	0	212	0	212
15969	0	1	0	217	0	218
15970	0	0	218	1	0	219
15971	0	0	0	205	0	205
15972	208	0	1	0	0	209
15973	1	0	205	1	0	207
15974	203	0	0	1	0	204
15975	0	0	1	211	0	212
15976	1	1	207	0	0	209
15977	199	0	0	1	0	200
15978	1	0	1	208	0	210
15979	207	0	1	0	0	208
15980	1	0	0	207	0	208
15981	2	203	0	0	0	205
15982	0	0	212	1	0	213
15983	0	0	0	210	0	210
15984	213	1	1	0	0	215
15985	204	0	0	3	0	207
15986	208	0	0	0	0	208
15987	210	0	0	3	0	213
15988	201	0	1	2	0	204
15989	1	206	1	0	0	208
15990	208	0	1	0	0	209
15991	0	2	205	0	0	207
15992	200	1	0	1	0	202
15993	0	0	2	198	0	200
15994	1	0	206	1	0	208
15995	0	1	207	2	0	210
15996	1	0	0	217	0	218
15997	222	0	3	0	0	225
15998	0	209	1	2	0	212
15999	217	0	0	3	0	220
16000	0	215	1	2	0	218
16001	3	0	0	225	0	228
16002	0	1	1	229	0	231
16003	226	0	1	3	0	230
16004	3	0	0	224	0	227
16005	1	0	232	1	0	234
16006	233	1	0	3	0	237
16007	0	0	1	242	0	243
16008	1	1	0	245	0	247
16009	3	0	239	2	0	244
16010	219	0	1	3	0	223
16011	235	0	1	0	0	236
16012	2	238	0	1	0	241
16013	2	2	224	0	0	228
16014	0	1	219	1	0	221
16015	2	0	1	229	0	232
16016	1	3	1	225	0	230
16017	2	230	0	2	0	234
16018	1	1	225	1	0	228
16019	2	1	1	221	0	225
16020	2	0	229	1	0	232
16021	0	1	2	229	0	232
16022	1	230	2	1	0	234
16023	1	0	1	243	0	245
16024	2	1	0	241	0	244
16025	1	1	0	234	0	236
16026	233	0	1	5	0	239
16027	1	1	229	1	0	232
16028	1	238	0	2	0	241
16029	3	1	1	260	0	265
16030	272	2	0	2	0	276
16031	4	0	0	273	0	277
16032	276	1	1	4	0	282
16033	5	1	262	2	0	270
16034	260	0	4	2	0	266
16035	5	0	0	267	0	272
16036	1	0	271	5	0	277
16037	1	270	4	2	0	277
16038	2	4	1	264	0	271
16039	0	2	0	272	0	274
16040	270	0	1	7	0	278
16041	4	264	3	1	0	272
16042	3	253	1	1	0	258
16043	1	269	0	2	0	272
16044	248	4	0	3	0	255
16045	4	248	1	1	0	254
16046	1	4	0	253	0	258
16047	2	0	0	249	0	251
16048	244	1	0	8	0	253
16049	5	244	0	1	0	250
16050	4	5	0	249	0	258
16051	257	0	0	7	0	264
16052	262	0	0	1	0	263
16053	260	0	0	0	0	260
16054	7	256	0	0	0	263
16055	253	7	0	1	0	261
16056	9	1	1	251	0	262
16057	1	226	1	6	0	234
16058	1	240	0	1	0	242
16059	2	6	0	241	0	249
16060	236	0	1	8	0	245
16061	239	1	0	1	0	241
16062	6	0	0	226	0	232
16063	0	231	1	6	0	238
16064	230	6	0	0	0	236
16065	6	1	221	1	0	229
16066	0	0	221	1	0	222
16067	215	0	6	1	0	222
16068	7	1	217	0	0	225
16069	1	1	6	200	0	208
16070	204	0	0	7	0	211
16071	7	0	0	213	0	220
16072	1	0	208	7	0	216
16073	0	212	5	0	0	217
16074	1	6	0	214	0	221
16075	1	0	213	6	0	220
16076	203	0	5	1	0	209
16077	7	1	0	214	0	222
16078	1	1	223	6	0	231
16079	1	0	6	217	0	224
16080	1	216	1	6	0	224
16081	2	6	0	222	0	230
16082	0	1	0	227	0	228
16083	0	0	0	229	0	229
16084	1	219	0	7	0	227
16085	220	6	1	1	0	228
16086	5	1	1	227	0	234
16087	2	0	0	229	0	231
16088	0	0	1	240	0	241
16089	0	1	224	10	0	235
16090	1	0	7	224	0	232
16091	224	0	1	11	0	236
16092	6	224	1	1	0	232
16093	1	7	0	245	0	253
16094	0	1	0	247	0	248
16095	238	0	1	9	0	248
16096	8	241	0	1	0	250
16097	243	8	0	1	0	252
16098	250	1	1	0	0	252
16099	10	0	0	241	0	251
16100	241	1	0	9	0	251
16101	9	233	1	3	0	246
16102	234	8	0	2	0	244
16103	8	2	0	240	0	250
16104	267	1	0	9	0	277
16105	271	1	0	5	0	277
16106	15	0	235	1	0	251
16107	258	1	7	1	0	267
16108	266	1	2	4	0	273
16109	282	1	2	1	0	286
16110	11	0	283	3	0	297
16111	4	280	14	1	0	299
16112	1	16	3	278	0	298
16113	280	3	0	15	0	298
16114	15	272	1	4	0	292
16115	277	13	1	1	0	292
16116	18	5	0	270	0	293
16117	5	2	272	15	0	294
16118	288	0	12	3	0	303
16119	19	0	3	288	0	310
16120	8	1	286	15	0	310
16121	286	1	15	4	0	306
16122	18	0	302	1	0	321
16123	5	2	15	308	0	330
16124	5	2	4	327	0	338
16125	316	2	1	16	0	335
16126	330	3	1	6	0	340
16127	23	314	1	2	0	340
16128	317	17	0	6	0	340
16129	19	4	289	1	0	313
16130	8	1	290	1	0	300
16131	271	0	16	2	0	289
16132	14	279	5	2	0	300
16133	275	14	4	1	0	294
16134	15	274	6	0	0	295
16135	273	14	2	4	0	293
16136	17	3	2	265	0	287
16137	9	0	266	15	0	290
16138	6	1	16	272	0	295
16139	3	5	4	284	0	296
16140	277	1	1	20	0	299
16141	17	2	271	6	0	296
16142	262	1	17	2	0	282
16143	18	269	3	3	0	293
16144	271	14	4	5	0	294
16145	21	4	3	264	0	292
16146	7	3	269	17	0	296
16147	8	1	16	269	0	294
16148	263	4	4	19	0	290
16149	21	1	2	280	0	304
16150	7	3	2	280	0	292
16151	2	260	2	18	0	282
16152	7	12	2	266	0	287
16153	5	4	268	15	0	292
16154	8	2	14	262	0	286
16155	7	3	5	278	0	293
16156	268	3	3	14	0	288
16157	15	4	2	271	0	292
16158	11	1	269	15	0	296
16159	7	265	14	8	0	294
16160	7	14	8	267	0	296
16161	8	4	2	282	0	296
16162	277	2	0	22	0	301
16163	17	269	5	8	0	299
16164	11	14	4	276	0	305
16165	269	7	5	16	0	297
16166	288	2	2	13	0	305
16167	23	2	2	283	0	310
16168	10	5	284	15	0	314
16169	286	1	16	12	0	315
16170	21	2	4	303	0	330
16171	298	4	6	19	0	327
16172	311	1	2	13	0	327
16173	16	291	3	12	0	322
16174	303	12	4	6	0	325
16175	15	293	4	9	0	321
16176	11	14	5	293	0	323
16177	8	6	2	298	0	314
16178	10	284	4	19	0	317
16179	292	12	2	11	0	317
16180	298	5	9	5	0	317
16181	22	5	272	5	0	304
16182	8	3	278	11	0	300
16183	8	1	19	273	0	301
16184	278	3	6	20	0	307
16185	20	5	3	271	0	299
16186	10	5	2	286	0	303
16187	10	4	284	17	0	315
16188	5	5	276	10	0	296
16189	8	4	281	7	0	300
16190	280	4	13	7	0	304
16191	284	4	5	9	0	302
16192	17	263	5	6	0	291
16193	5	267	6	7	0	285
16194	15	11	3	255	0	284
16195	4	5	268	20	0	297
16196	277	0	13	5	0	295
16197	13	9	272	9	0	303
16198	7	3	12	277	0	299
16199	4	1	4	288	0	297
16200	2	3	8	281	0	294
16201	4	1	5	287	0	297
16202	281	1	4	16	0	302
16203	15	3	3	283	0	304
16204	3	0	252	13	0	268
16205	234	2	8	9	0	253
16206	8	1	250	6	0	265
16207	3	1	239	7	0	250
16208	4	239	8	4	0	255
16209	3	8	3	206	0	220
16210	201	0	2	8	0	211
16211	8	1	1	200	0	210
16212	2	1	207	5	0	215
16213	2	1	4	208	0	215
16214	208	1	1	5	0	215
16215	7	212	0	2	0	221
16216	212	4	1	3	0	220
16217	5	206	2	2	0	215
16218	214	5	1	2	0	222
16219	3	214	0	4	0	221
16220	2	210	1	0	0	213
16221	3	4	207	0	0	214
16222	1	206	5	1	0	213
16223	191	1	0	2	0	194
16224	4	0	0	188	0	192
16225	187	0	0	4	0	191
16226	1	188	0	1	0	190
16227	190	0	0	0	0	190
16228	1	0	198	1	0	200
16229	0	0	2	195	0	197
16230	1	201	0	0	0	202
16231	0	1	1	215	0	217
16232	2	0	0	209	0	211
16233	238	1	0	2	0	241
16234	4	241	0	1	0	246
16235	244	4	0	3	0	251
16236	4	1	247	1	0	253
16237	1	1	231	0	0	233
16238	0	237	5	1	0	243
16239	1	4	1	237	0	243
16240	0	2	249	2	0	253
16241	7	0	4	240	0	251
16242	2	1	1	263	0	267
16243	0	1	256	5	0	262
16244	0	3	252	1	0	256
16245	0	2	273	0	0	275
16246	0	0	268	1	0	269
16247	0	270	6	0	0	276
16248	4	4	1	265	0	274
16249	0	2	0	270	0	272
16250	2	0	264	5	0	271
16251	1	1	6	262	0	270
16252	0	0	273	4	0	277
16253	1	1	6	265	0	273
16254	1	1	1	264	0	267
16255	0	278	1	6	0	285
16256	2	4	0	278	0	284
16257	3	2	1	269	0	275
16258	2	0	1	269	0	272
16259	0	2	261	5	0	268
16260	1	266	5	2	0	274
16261	263	4	3	1	0	271
16262	268	3	1	1	0	273
16263	7	1	0	258	0	266
16264	2	0	0	256	0	258
16265	0	277	2	6	0	285
16266	273	4	1	3	0	281
16267	4	266	2	1	0	273
16268	261	3	0	3	0	267
16269	5	2	259	1	0	267
16270	240	1	4	3	0	248
16271	4	261	1	3	0	269
16272	2	4	0	261	0	267
16273	2	2	0	262	0	266
16274	1	256	1	5	0	263
16275	263	5	1	2	0	271
16276	5	1	2	270	0	278
16277	3	1	0	271	0	275
16278	283	1	0	8	0	292
16279	283	0	1	6	0	290
16280	6	2	276	2	0	286
16281	292	0	5	1	0	298
16282	6	0	2	291	0	299
16283	2	0	294	6	0	302
16284	0	0	7	290	0	297
16285	2	0	288	4	0	294
16286	1	2	285	1	0	289
16287	2	0	7	287	0	296
16288	1	1	294	7	0	303
16289	0	314	6	2	0	322
16290	2	5	2	317	0	326
16291	1	1	1	324	0	327
16292	1	0	324	5	0	330
16293	1	315	6	1	0	323
16294	318	6	1	2	0	327
16295	8	1	2	312	0	323
16296	306	1	0	10	0	317
16297	5	303	1	4	0	313
16298	2	6	313	1	0	322
16299	2	3	7	314	0	326
16300	312	2	3	5	0	322
16301	7	1	311	2	0	321
16302	294	0	8	5	0	307
16303	4	302	3	4	0	313
16304	1	307	0	2	0	310
16305	307	6	4	4	0	321
16306	5	2	2	310	0	319
16307	4	0	3	307	0	314
16308	0	316	4	5	0	325
16309	2	6	1	319	0	328
16310	0	4	0	324	0	328
16311	323	1	0	9	0	333
16312	6	1	1	322	0	330
16313	1	2	326	6	0	335
16314	1	0	5	322	0	328
16315	3	1	2	326	0	332
16316	0	0	324	9	0	333
16317	1	1	4	318	0	324
16318	319	2	1	10	0	332
16319	312	1	1	8	0	322
16320	319	0	1	5	0	325
16321	6	1	1	321	0	329
16322	1	2	319	6	0	328
16323	1	315	6	1	0	323
16324	3	4	2	318	0	327
16325	1	2	320	8	0	331
16326	4	0	4	315	0	323
16327	4	2	2	315	0	323
16328	315	1	1	7	0	324
16329	6	326	1	3	0	336
16330	2	8	321	1	0	332
16331	289	2	6	4	0	301
16332	5	304	4	2	0	315
16333	0	287	1	3	0	291
16334	299	3	2	5	0	309
16335	2	2	0	304	0	308
16336	0	1	358	4	0	363
16337	2	0	2	352	0	356
16338	0	358	0	2	0	360
16339	361	3	2	2	0	368
16340	2	0	0	356	0	358
16341	354	0	0	7	0	361
16342	4	0	1	345	0	350
16343	0	374	0	3	0	377
16344	378	1	0	3	0	382
16345	364	0	0	3	0	367
16346	4	360	4	0	0	368
16347	354	2	1	5	0	362
16348	2	0	1	357	0	360
16349	1	359	0	2	0	362
16350	356	4	0	2	0	362
16351	4	353	1	0	0	358
16352	362	2	0	3	0	367
16353	4	1	0	359	0	364
16354	366	1	0	2	0	369
16355	361	2	0	4	0	367
16356	366	0	2	4	0	372
16357	3	0	0	365	0	368
16358	1	1	0	362	0	364
16359	358	1	1	6	0	366
16360	3	0	374	2	0	379
16361	0	0	2	373	0	375
16362	0	374	3	4	0	381
16363	1	2	0	386	0	389
16364	1	2	1	383	0	387
16365	1	0	367	4	0	372
16366	2	1	2	382	0	387
16367	2	404	1	9	0	416
16368	1	8	1	422	0	432
16369	0	5	452	11	0	468
16370	3	2	10	435	0	450
16371	2	1	4	459	0	466
16372	446	1	1	16	0	464
16373	436	1	1	11	0	449
16374	15	1	0	434	0	450
16375	6	421	0	9	0	436
16376	3	439	3	6	0	451
16377	4	12	422	4	0	442
16378	1	6	8	418	0	433
16379	418	5	4	12	0	439
16380	14	2	2	425	0	443
16381	6	0	411	14	0	431
16382	6	0	10	413	0	429
16383	4	1	4	422	0	431
16384	1	1	3	427	0	432
16385	4	0	419	17	0	440
16386	3	426	9	7	0	445
16387	423	8	4	10	0	445
16388	426	6	4	4	0	440
16389	12	4	2	403	0	421
16390	6	1	397	12	0	416
16391	4	407	10	7	0	428
16392	1	9	6	401	0	417
16393	0	409	2	6	0	417
16394	1	426	2	7	0	436
16395	406	14	1	6	0	427
16396	9	5	409	5	0	428
16397	4	3	418	5	0	430
16398	5	3	17	404	0	429
16399	4	1	7	420	0	432
16400	3	0	427	12	0	442
16401	3	2	8	417	0	430
16402	2	1	429	13	0	445
16403	391	2	11	8	0	412
16404	10	1	7	417	0	435
16405	4	1	445	14	0	464
16406	3	3	9	423	0	438
16407	3	487	5	10	0	505
16408	479	7	5	6	0	497
16409	8	483	5	4	0	500
16410	485	8	0	7	0	500
16411	10	5	468	4	0	487
16412	482	2	12	1	0	497
16413	12	2	5	485	0	504
16414	6	2	488	10	0	506
16415	7	0	9	482	0	498
16416	3	1	486	14	0	504
16417	450	1	12	9	0	472
16418	10	480	7	5	0	502
16419	5	9	2	473	0	489
16420	2	485	2	12	0	501
16421	490	12	4	7	0	513
16422	496	7	1	8	0	512
16423	15	489	4	3	0	511
16424	9	9	2	495	0	515
16425	7	7	1	498	0	513
16426	3	3	2	502	0	510
16427	484	3	4	20	0	511
16428	9	484	2	11	0	506
16429	8	7	3	488	0	506
16430	3	7	1	494	0	505
16431	473	4	2	15	0	494
16432	11	3	468	10	0	492
16433	8	1	456	8	0	473
16434	441	1	13	8	0	463
16435	11	3	453	3	0	470
16436	3	4	389	3	0	399
16437	6	2	14	392	0	414
16438	401	3	7	11	0	422
16439	12	1	4	404	0	421
16440	5	3	396	11	0	415
16441	368	2	11	11	0	392
16442	9	0	394	7	0	410
16443	6	398	12	4	0	420
16444	3	9	10	418	0	440
16445	426	5	5	14	0	450
16446	10	3	3	431	0	447
16447	9	0	5	432	0	446
16448	441	0	3	18	0	462
16449	8	1	4	456	0	469
16450	4	1	2	459	0	466
16451	3	2	453	16	0	474
16452	4	1	11	444	0	460
16453	450	1	4	14	0	469
16454	455	2	4	8	0	469
16455	449	0	4	7	0	460
16456	15	1	2	446	0	464
16457	7	437	2	10	0	456
16458	439	7	3	12	0	461
16459	8	447	2	4	0	461
16460	442	10	1	3	0	456
16461	15	3	2	437	0	457
16462	434	3	0	12	0	449
16463	431	1	2	8	0	442
16464	435	2	2	5	0	444
16465	15	422	1	3	0	441
16466	3	392	2	1	0	398
16467	373	2	0	6	0	381
16468	2	387	0	2	0	391
16469	0	341	0	1	0	342
16470	0	347	1	0	0	348
16471	346	1	0	2	0	349
16472	1	0	0	342	0	343
16473	1	0	0	331	0	332
16474	338	0	1	4	0	343
16475	1	1	348	2	0	352
16476	1	0	1	384	0	386
16477	1	0	0	386	0	387
16478	3	0	0	431	0	434
16479	0	0	0	445	0	445
16480	0	446	1	5	0	452
16481	2	508	0	2	0	512
16482	518	10	0	6	0	534
16483	12	2	0	512	0	526
16484	2	3	0	542	0	547
16485	4	2	514	11	0	531
16486	4	1	11	507	0	523
16487	1	0	511	15	0	527
16488	2	2	14	507	0	525
16489	0	2	519	15	0	536
16490	2	513	15	3	0	533
16491	0	12	2	519	0	533
16492	522	2	3	13	0	540
16493	522	4	1	3	0	530
16494	12	2	2	521	0	537
16495	4	1	516	16	0	537
16496	6	1	510	5	0	522
16497	492	2	11	4	0	509
16498	11	507	5	3	0	526
16499	514	12	6	5	0	537
16500	508	4	3	4	0	519
16501	15	3	506	3	0	527
16502	6	5	12	492	0	515
16503	8	1	3	503	0	515
16504	6	3	6	511	0	526
16505	3	0	3	496	0	502
16506	4	1	4	481	0	490
16507	2	2	435	21	0	460
16508	1	1	444	12	0	458
16509	4	1	13	445	0	463
16510	3	1	6	460	0	470
16511	6	1	7	462	0	476
16512	449	1	6	21	0	477
16513	14	1	2	449	0	466
16514	449	2	2	23	0	476
16515	18	2	3	463	0	486
16516	482	0	1	19	0	502
16517	502	2	3	9	0	516
16518	489	0	5	11	0	505
16519	492	1	3	10	0	506
16520	500	1	2	9	0	512
16521	26	1	2	483	0	512
16522	483	2	3	22	0	510
16523	22	487	2	7	0	518
16524	495	15	5	7	0	522
16525	22	3	4	500	0	529
16526	7	2	484	21	0	514
16527	8	4	17	492	0	521
16528	6	4	511	22	0	543
16529	7	0	18	509	0	534
16530	8	2	5	533	0	548
16531	7	1	512	22	0	542
16532	5	1	510	10	0	526
16533	6	0	18	525	0	549
16534	515	1	5	26	0	547
16535	20	2	503	11	0	536
16536	7	504	17	9	0	537
16537	8	15	525	7	0	555
16538	527	0	20	14	0	561
16539	22	4	6	534	0	566
16540	532	6	7	20	0	565
16541	554	3	4	8	0	569
16542	22	2	5	541	0	570
16543	11	2	514	26	0	553
16544	11	0	14	517	0	542
16545	10	2	7	519	0	538
16546	496	2	3	27	0	528
16547	22	496	8	13	0	539
16548	6	12	6	509	0	533
16549	8	1	485	25	0	519
16550	473	6	17	11	0	507
16551	23	473	6	8	0	510
16552	10	18	6	487	0	521
16553	10	5	4	501	0	520
16554	13	3	7	505	0	528
16555	486	5	5	27	0	523
16556	503	3	4	17	0	527
16557	24	0	3	515	0	542
16558	10	2	501	26	0	539
16559	11	495	19	15	0	540
16560	496	17	7	12	0	532
16561	514	3	10	10	0	537
16562	22	2	5	502	0	531
16563	12	6	4	517	0	539
16564	13	4	504	21	0	542
16565	8	498	19	15	0	540
16566	522	17	5	15	0	559
16567	513	3	6	14	0	536
16568	22	498	4	13	0	537
16569	499	20	3	11	0	533
16570	25	5	7	490	0	527
16571	8	0	485	29	0	522
16572	12	3	21	490	0	526
16573	11	2	489	24	0	526
16574	475	3	18	14	0	510
16575	23	478	5	11	0	517
16576	10	21	6	424	0	461
16577	7	1	423	24	0	455
16578	8	2	413	4	0	427
16579	372	7	18	3	0	400
16580	18	380	3	11	0	412
16581	310	12	8	3	0	333
16582	309	3	5	3	0	320
16583	311	0	2	4	0	317
16584	11	2	1	297	0	311
16585	5	2	294	8	0	309
16586	4	290	7	5	0	306
16587	7	9	2	293	0	311
16588	5	2	298	10	0	315
16589	3	1	286	3	0	293
16590	5	1	8	282	0	296
16591	2	2	281	9	0	294
16592	256	0	5	5	0	266
16593	8	0	4	279	0	291
16594	3	1	3	289	0	296
16595	282	2	0	10	0	294
16596	7	280	3	3	0	293
16597	295	8	1	5	0	309
16598	9	1	1	294	0	305
16599	4	0	1	299	0	304
16600	3	3	2	293	0	301
16601	4	1	1	301	0	307
16602	293	1	2	7	0	303
16603	9	4	296	1	0	310
16604	3	299	8	3	0	313
16605	3	6	1	305	0	315
16606	290	2	1	11	0	304
16607	311	0	0	4	0	315
16608	8	308	4	2	0	322
16609	305	7	2	0	0	314
16610	6	298	0	4	0	308
16611	1	312	2	1	0	316
16612	6	7	1	302	0	316
16613	1	1	310	8	0	320
16614	2	0	5	306	0	313
16615	300	1	7	7	0	315
16616	4	297	1	1	0	303
16617	3	3	0	286	0	292
16618	0	3	320	4	0	327
16619	318	0	4	3	0	325
16620	325	0	0	3	0	328
16621	328	2	0	1	0	331
16622	6	0	315	0	0	321
16623	302	0	4	5	0	311
16624	2	319	1	1	0	323
16625	0	4	0	317	0	321
16626	1	317	1	5	0	324
16627	322	4	0	3	0	329
16628	304	2	0	2	0	308
16629	4	0	321	2	0	327
16630	0	321	4	0	0	325
16631	1	5	1	315	0	322
16632	2	0	1	318	0	321
16633	0	1	1	314	0	316
16634	2	0	0	327	0	329
16635	2	0	0	337	0	339
16636	0	1	332	5	0	338
16637	0	332	6	3	0	341
16638	316	6	2	1	0	325
16639	7	3	322	0	0	332
16640	2	319	6	1	0	328
16641	322	6	3	1	0	332
16642	6	1	334	0	0	341
16643	322	0	4	0	0	326
16644	326	0	2	0	0	328
16645	322	1	0	3	0	326
16646	6	330	0	1	0	337
16647	2	6	326	0	0	334
16648	1	319	6	1	0	327
16649	5	7	2	275	0	289
16650	0	319	2	6	0	327
16651	327	6	0	4	0	337
16652	342	1	1	2	0	346
16653	329	1	0	5	0	335
16654	9	1	331	1	0	342
16655	3	339	6	1	0	349
16656	4	8	3	364	0	379
16657	394	2	1	10	0	407
16658	14	391	1	1	0	407
16659	6	13	2	391	0	412
16660	2	4	408	14	0	428
16661	411	1	15	2	0	429
16662	18	0	414	1	0	433
16663	3	1	451	0	0	455
16664	419	1	18	1	0	439
16665	14	1	432	1	0	448
16666	405	1	15	2	0	423
16667	15	395	3	2	0	415
16668	414	12	2	3	0	431
16669	16	4	1	412	0	433
16670	4	1	2	425	0	432
16671	3	2	1	420	0	426
16672	416	2	0	18	0	436
16673	420	0	3	4	0	427
16674	424	1	1	1	0	427
16675	18	404	0	1	0	423
16676	4	14	4	416	0	438
16677	4	1	403	14	0	422
16678	4	1	14	378	0	397
16679	4	380	5	14	0	403
16680	2	16	3	380	0	401
16681	2	4	2	396	0	404
16682	381	3	2	16	0	402
16683	15	0	1	381	0	397
16684	4	3	375	16	0	398
16685	6	0	367	3	0	376
16686	4	1	13	372	0	390
16687	375	1	3	16	0	395
16688	16	0	5	372	0	393
16689	3	4	0	393	0	400
16690	2	1	374	19	0	396
16691	3	367	15	4	0	389
16692	3	17	1	378	0	399
16693	375	4	2	19	0	400
16694	15	379	4	4	0	402
16695	8	14	1	379	0	402
16696	2	5	377	15	0	399
16697	2	1	16	377	0	396
16698	370	1	3	18	0	392
16699	18	364	5	3	0	390
16700	5	15	374	5	0	399
16701	5	6	16	365	0	392
16702	4	4	368	18	0	394
16703	363	0	18	10	0	391
16704	382	1	5	5	0	393
16705	19	3	364	5	0	391
16706	11	2	14	360	0	387
16707	9	0	368	17	0	394
16708	4	366	18	4	0	392
16709	7	17	2	370	0	396
16710	3	4	380	18	0	405
16711	1	2	16	348	0	367
16712	3	351	4	26	0	384
16713	4	16	4	361	0	385
16714	8	4	358	17	0	387
16715	349	2	18	8	0	377
16716	21	371	5	2	0	399
16717	372	14	4	13	0	403
16718	18	4	348	3	0	373
16719	338	4	19	6	0	367
16720	19	2	343	9	0	373
16721	347	2	18	4	0	371
16722	367	4	4	4	0	379
16723	20	3	4	351	0	378
16724	8	0	5	367	0	380
16725	348	4	3	21	0	376
16726	16	352	3	12	0	383
16727	364	16	6	4	0	390
16728	20	6	1	361	0	388
16729	9	353	3	16	0	381
16730	6	16	2	369	0	393
16731	1	5	3	384	0	393
16732	6	2	5	381	0	394
16733	4	367	3	21	0	395
16734	356	12	5	8	0	381
16735	15	5	3	356	0	379
16736	5	0	345	15	0	365
16737	5	3	332	6	0	346
16738	6	1	332	7	0	346
16739	336	2	15	4	0	357
16740	349	2	6	7	0	364
16741	16	2	343	4	0	365
16742	7	2	10	318	0	337
16743	3	2	3	333	0	341
16744	1	2	340	15	0	358
16745	2	0	341	9	0	352
16746	5	2	13	346	0	366
16747	346	3	6	15	0	370
16748	361	0	3	6	0	370
16749	358	3	3	2	0	366
16750	14	328	3	2	0	347
16751	6	342	3	3	0	354
16752	3	10	5	329	0	347
16753	338	4	1	12	0	355
16754	13	4	325	5	0	347
16755	291	1	11	5	0	308
16756	11	290	6	3	0	310
16757	2	244	1	2	0	249
16758	237	4	1	1	0	243
16759	3	239	0	1	0	243
16760	3	222	1	1	0	227
16761	216	1	2	1	0	220
16762	0	231	0	2	0	233
16763	1	1	1	213	0	216
16764	0	2	1	212	0	215
16765	211	1	1	2	0	215
16766	203	0	0	3	0	206
16767	3	214	0	0	0	217
16768	3	220	1	0	0	224
16769	0	2	207	1	0	210
16770	208	1	0	2	0	211
16771	220	0	3	0	0	223
16772	219	0	1	1	0	221
16773	3	0	0	214	0	217
16774	3	0	0	219	0	222
16775	228	0	0	4	0	232
16776	3	0	0	228	0	231
16777	2	1	236	1	0	240
16778	1	0	1	237	0	239
16779	0	245	2	2	0	249
16780	0	3	0	249	0	252
16781	0	2	0	264	0	266
16782	0	0	0	266	0	266
16783	252	0	0	7	0	259
16784	4	256	0	3	0	263
16785	2	4	0	258	0	264
16786	0	1	257	5	0	263
16787	0	1	254	2	0	257
16788	1	0	6	258	0	265
16789	0	0	3	264	0	267
16790	262	0	1	5	0	268
16791	6	0	0	255	0	261
16792	2	257	1	5	0	265
16793	1	3	254	3	0	261
16794	1	2	3	260	0	266
16795	0	0	264	4	0	268
16796	0	0	5	272	0	277
16797	266	0	2	7	0	275
16798	266	0	0	2	0	268
16799	5	271	0	2	0	278
16800	5	3	0	271	0	279
16801	273	1	0	5	0	279
16802	281	2	0	3	0	286
16803	288	0	0	5	0	293
16804	292	0	0	1	0	293
16805	289	0	1	1	0	291
16806	7	282	1	0	0	290
16807	279	4	0	0	0	283
16808	6	1	270	0	0	277
16809	5	1	4	274	0	284
16810	278	0	2	4	0	284
16811	273	0	1	4	0	278
16812	283	0	0	2	0	285
16813	5	0	274	0	0	279
16814	3	0	4	283	0	290
16815	287	0	2	4	0	293
16816	3	282	2	2	0	289
16817	309	4	0	2	0	315
16818	322	2	0	2	0	326
16819	322	0	0	3	0	325
16820	7	0	0	319	0	326
16821	324	0	0	7	0	331
16822	5	0	314	2	0	321
16823	2	0	319	1	0	322
16824	314	0	5	0	0	319
16825	4	0	318	1	0	323
16826	296	0	4	0	0	300
16827	5	1	312	0	0	318
16828	4	0	5	291	0	300
16829	299	0	1	4	0	304
16830	4	306	1	1	0	312
16831	308	4	0	3	0	315
16832	6	296	0	0	0	302
16833	0	311	1	0	0	312
16834	1	3	1	314	0	319
16835	2	1	0	318	0	321
16836	0	1	0	311	0	312
16837	1	0	315	5	0	321
16838	301	0	5	3	0	309
16839	330	0	0	4	0	334
16840	329	0	1	2	0	332
16841	331	2	0	1	0	334
16842	328	0	0	1	0	329
16843	6	2	301	1	0	310
16844	1	3	306	0	0	310
16845	2	0	4	316	0	322
16846	0	0	315	7	0	322
16847	314	0	4	4	0	322
16848	7	333	2	2	0	344
16849	1	7	1	343	0	352
16850	354	0	0	11	0	365
16851	9	1	1	370	0	381
16852	2	0	368	9	0	379
16853	4	1	372	1	0	378
16854	2	0	9	374	0	385
16855	1	0	380	8	0	389
16856	368	0	9	4	0	381
16857	9	1	1	379	0	390
16858	2	1	379	9	0	391
16859	1	372	9	1	0	383
16860	1	6	2	386	0	395
16861	2	0	400	10	0	412
16862	1	1	9	376	0	387
16863	1	0	2	402	0	405
16864	1	1	400	9	0	411
16865	5	0	8	389	0	402
16866	3	0	2	386	0	391
16867	5	0	2	404	0	411
16868	392	0	1	14	0	407
16869	10	381	2	3	0	396
16870	2	398	2	1	0	403
16871	3	10	384	2	0	399
16872	374	1	11	2	0	388
16873	9	2	389	2	0	402
16874	1	2	384	4	0	391
16875	4	0	11	378	0	393
16876	388	0	2	12	0	402
16877	9	385	1	3	0	398
16878	371	7	1	4	0	383
16879	370	0	2	3	0	375
16880	7	378	1	2	0	388
16881	358	7	0	4	0	369
16882	357	0	2	2	0	361
16883	7	368	0	0	0	375
16884	2	9	2	362	0	375
16885	0	3	2	373	0	378
16886	378	0	2	11	0	391
16887	14	396	0	0	0	410
16888	401	11	2	1	0	415
16889	409	1	3	1	0	414
16890	409	0	1	3	0	413
16891	12	2	0	408	0	422
16892	5	4	1	417	0	427
16893	416	0	0	11	0	427
16894	423	3	0	3	0	429
16895	430	2	1	3	0	436
16896	14	0	0	438	0	452
16897	4	0	435	12	0	451
16898	0	4	10	436	0	450
16899	4	1	1	469	0	475
16900	4	0	459	13	0	476
16901	4	2	494	2	0	502
16902	2	1	18	519	0	540
16903	2	0	504	21	0	527
16904	520	0	19	6	0	545
16905	24	0	1	520	0	545
16906	6	0	2	542	0	550
16907	555	2	0	26	0	583
16908	21	0	3	557	0	581
16909	4	0	2	575	0	581
16910	6	0	0	572	0	578
16911	2	0	6	569	0	577
16912	3	0	550	21	0	574
16913	3	0	18	553	0	574
16914	0	0	535	23	0	558
16915	5	542	19	2	0	568
16916	2	18	8	531	0	559
16917	1	2	508	25	0	536
16918	472	3	17	4	0	496
16919	21	487	1	6	0	515
16920	496	16	5	6	0	523
16921	21	3	0	483	0	507
16922	5	517	0	15	0	537
16923	504	20	2	9	0	535
16924	18	506	2	6	0	532
16925	518	18	3	4	0	543
16926	26	3	1	512	0	542
16927	526	4	2	19	0	551
16928	23	523	2	5	0	553
16929	520	23	3	6	0	552
16930	24	6	500	0	0	530
16931	11	3	22	511	0	547
16932	511	2	5	21	0	539
16933	537	0	2	4	0	543
16934	26	3	1	516	0	546
16935	7	1	517	22	0	547
16936	3	498	22	5	0	528
16937	3	536	2	5	0	546
16938	535	22	6	3	0	566
16939	27	6	0	517	0	550
16940	7	4	1	539	0	551
16941	530	0	0	22	0	552
16942	531	1	2	10	0	544
16943	25	3	524	5	0	557
16944	10	1	21	527	0	559
16945	4	2	541	24	0	571
16946	6	534	24	4	0	568
16947	512	18	2	12	0	544
16948	21	511	2	8	0	542
16949	4	533	1	3	0	541
16950	8	20	3	507	0	538
16951	486	3	4	24	0	517
16952	20	495	2	9	0	526
16953	483	19	2	8	0	512
16954	21	488	3	4	0	516
16955	3	20	3	497	0	523
16956	494	3	5	18	0	520
16957	24	6	488	4	0	522
16958	4	4	20	489	0	517
16959	13	1	491	22	0	527
16960	5	491	19	6	0	521
16961	1	503	5	7	0	516
16962	485	18	2	10	0	515
16963	18	490	1	12	0	521
16964	486	21	6	8	0	521
16965	503	2	6	7	0	518
16966	20	4	492	7	0	523
16967	486	2	23	3	0	514
16968	21	7	499	7	0	534
16969	5	503	22	5	0	535
16970	509	20	3	4	0	536
16971	20	497	4	8	0	529
16972	8	22	4	501	0	535
16973	513	6	1	21	0	541
16974	24	5	2	504	0	535
16975	7	4	513	22	0	546
16976	7	2	19	513	0	541
16977	5	7	3	538	0	553
16978	525	3	3	22	0	553
16979	23	4	518	8	0	553
16980	505	3	20	10	0	538
16981	548	3	2	4	0	557
16982	23	3	6	512	0	544
16983	5	1	4	523	0	533
16984	514	3	2	24	0	543
16985	19	526	2	5	0	552
16986	8	19	0	514	0	541
16987	5	3	499	15	0	522
16988	7	5	474	2	0	488
16989	3	501	15	6	0	525
16990	6	16	5	488	0	515
16991	7	3	3	493	0	506
16992	477	4	2	18	0	501
16993	18	4	1	469	0	492
16994	453	2	2	19	0	476
16995	13	454	4	4	0	475
16996	5	438	2	5	0	450
16997	5	455	0	4	0	464
16998	434	15	4	8	0	461
16999	405	0	2	10	0	417
17000	14	394	1	5	0	414
17001	345	6	1	3	0	355
17002	7	324	2	0	0	333
17003	1	5	1	324	0	331
17004	1	324	0	4	0	329
17005	323	5	2	2	0	332
17006	320	1	0	4	0	325
17007	8	1	0	294	0	303
17008	295	1	1	6	0	303
17009	5	1	0	298	0	304
17010	0	306	1	6	0	313
17011	0	5	2	301	0	308
17012	0	303	0	7	0	310
17013	300	7	0	3	0	310
17014	6	0	294	2	0	302
17015	275	0	6	2	0	283
17016	8	0	0	293	0	301
17017	1	0	291	7	0	299
17018	282	1	6	0	0	289
17019	7	1	295	0	0	303
17020	0	2	5	292	0	299
17021	2	1	0	297	0	300
17022	3	0	0	272	0	275
17023	2	2	0	276	0	280
17024	1	267	0	7	0	275
17025	2	4	1	286	0	293
17026	279	0	1	5	0	285
17027	2	2	275	2	0	281
17028	2	296	1	2	0	301
17029	297	6	0	2	0	305
17030	316	4	0	2	0	322
17031	12	0	1	347	0	360
17032	4	0	352	8	0	364
17033	0	2	8	353	0	363
17034	3	1	6	390	0	400
17035	0	2	382	18	0	402
17036	3	394	10	7	0	414
17037	414	13	7	2	0	436
17038	412	9	0	4	0	425
17039	431	0	1	1	0	433
17040	25	5	1	411	0	442
17041	16	1	0	439	0	456
17042	436	2	1	23	0	462
17043	22	0	0	409	0	431
17044	12	409	1	17	0	439
17045	410	14	2	17	0	443
17046	435	8	0	5	0	448
17047	464	2	0	5	0	471
17048	471	4	1	2	0	478
17049	31	1	423	2	0	457
17050	15	2	442	1	0	460
17051	9	1	26	426	0	462
17052	8	0	12	450	0	470
17053	3	1	433	28	0	465
17054	2	2	445	15	0	464
17055	5	1	26	429	0	461
17056	442	0	11	22	0	475
17057	19	3	3	442	0	467
17058	15	1	447	18	0	481
17059	2	460	20	16	0	498
17060	458	16	13	7	0	494
17061	485	12	1	10	0	508
17062	500	2	6	1	0	509
17063	493	3	3	2	0	501
17064	36	1	455	4	0	496
17065	20	1	17	455	0	493
17066	458	1	11	20	0	490
17067	28	1	3	458	0	490
17068	20	2	3	442	0	467
17069	9	440	0	32	0	481
17070	13	17	2	458	0	490
17071	447	11	5	22	0	485
17072	23	451	3	16	0	493
17073	446	21	4	7	0	478
17074	23	446	5	5	0	479
17075	22	17	6	402	0	447
17076	5	406	3	25	0	439
17077	9	434	7	17	0	467
17078	429	29	3	14	0	475
17079	19	11	417	12	0	459
17080	17	7	411	5	0	440
17081	6	5	420	9	0	440
17082	395	2	27	5	0	429
17083	23	396	14	5	0	438
17084	22	420	4	5	0	451
17085	409	29	7	4	0	449
17086	28	410	1	7	0	446
17087	20	444	3	5	0	472
17088	7	30	4	441	0	482
17089	10	12	433	23	0	478
17090	8	6	439	18	0	471
17091	10	9	27	436	0	482
17092	432	1	14	25	0	472
17093	20	433	5	18	0	476
17094	22	17	7	437	0	483
17095	12	15	422	24	0	473
17096	8	9	426	19	0	462
17097	13	9	30	416	0	468
17098	428	7	13	23	0	471
17099	440	7	7	18	0	472
17100	33	4	428	6	0	471
17101	420	4	22	13	0	459
17102	26	3	433	7	0	469
17103	24	4	22	393	0	443
17104	5	423	24	22	0	474
17105	431	19	12	13	0	475
17106	31	12	11	433	0	487
17107	26	2	4	439	0	471
17108	12	9	8	452	0	481
17109	13	5	8	459	0	485
17110	9	4	429	35	0	477
17111	7	424	21	17	0	469
17112	10	17	14	437	0	478
17113	429	16	7	24	0	476
17114	29	7	8	434	0	478
17115	20	4	5	450	0	479
17116	11	5	426	34	0	476
17117	10	5	412	22	0	449
17118	11	400	29	15	0	455
17119	5	431	17	11	0	464
17120	10	28	8	431	0	477
17121	434	14	7	20	0	475
17122	24	7	420	18	0	469
17123	21	436	18	4	0	479
17124	7	21	16	430	0	474
17125	8	432	7	22	0	469
17126	14	18	11	422	0	465
17127	2	435	5	23	0	465
17128	3	12	2	413	0	430
17129	392	18	2	17	0	429
17130	15	372	1	22	0	410
17131	13	11	3	328	0	355
17132	317	11	2	15	0	345
17133	13	310	1	12	0	336
17134	7	282	4	3	0	296
17135	3	281	2	9	0	295
17136	4	5	1	272	0	282
17137	4	2	3	266	0	275
17138	4	254	3	6	0	267
17139	4	4	2	259	0	269
17140	8	5	254	4	0	271
17141	0	253	5	2	0	260
17142	3	14	1	244	0	262
17143	1	256	1	2	0	260
17144	1	6	241	3	0	251
17145	1	250	2	2	0	255
17146	223	5	3	2	0	233
17147	1	1	0	224	0	226
17148	223	0	0	3	0	226
17149	1	0	218	1	0	220
17150	1	0	1	224	0	226
17151	0	0	222	1	0	223
17152	0	0	1	224	0	225
17153	231	0	2	2	0	235
17154	1	0	0	234	0	235
17155	232	0	0	2	0	234
17156	1	226	0	1	0	228
17157	226	1	0	1	0	228
17158	1	1	230	0	0	232
17159	2	232	1	0	0	235
17160	0	1	0	237	0	238
17161	3	1	0	231	0	235
17162	0	0	236	2	0	238
17163	0	230	1	1	0	232
17164	0	1	0	239	0	240
17165	0	236	0	2	0	238
17166	0	1	0	239	0	240
17167	0	236	0	1	0	237
17168	229	1	0	2	0	232
17169	2	1	0	239	0	242
17170	1	0	245	1	0	247
17171	0	243	1	1	0	245
17172	0	255	1	0	0	256
17173	0	3	248	0	0	251
17174	1	251	1	0	0	253
17175	0	1	1	250	0	252
17176	0	1	249	1	0	251
17177	2	0	1	239	0	242
17178	0	0	0	255	0	255
17179	0	1	252	2	0	255
17180	239	0	1	4	0	244
17181	3	0	1	260	0	264
17182	1	0	294	1	0	296
17183	0	284	1	1	0	286
17184	296	1	1	4	0	302
17185	1	292	0	1	0	294
17186	1	1	0	292	0	294
17187	282	1	0	4	0	287
17188	1	0	0	284	0	285
17189	1	0	290	1	0	292
17190	0	0	1	293	0	294
17191	0	0	297	1	0	298
17192	285	0	1	3	0	289
17193	1	1	293	0	0	295
17194	298	0	2	1	0	301
17195	312	0	1	3	0	316
17196	2	1	324	0	0	327
17197	1	0	302	0	0	303
17198	0	321	2	0	0	323
17199	325	1	0	1	0	327
17200	2	1	1	329	0	333
17201	1	0	0	331	0	332
17202	376	0	0	7	0	383
17203	385	0	0	4	0	389
17204	389	0	0	2	0	391
17205	393	0	0	2	0	395
17206	2	0	0	383	0	385
17207	388	0	0	2	0	390
17208	1	0	0	402	0	403
17209	1	1	0	398	0	400
17210	0	2	0	401	0	403
17211	1	0	391	3	0	395
17212	0	384	1	1	0	386
17213	0	396	1	1	0	398
17214	0	2	0	407	0	409
17215	409	1	0	3	0	413
17216	1	0	0	401	0	402
17217	409	0	1	3	0	413
17218	1	0	422	1	0	424
17219	399	0	1	1	0	401
17220	1	1	1	421	0	424
17221	438	0	0	4	0	442
17222	425	1	0	4	0	430
17223	439	0	0	3	0	442
17224	2	0	0	434	0	436
17225	1	1	430	1	0	433
17226	1	0	2	436	0	439
17227	444	0	1	3	0	448
17228	3	0	504	1	0	508
17229	4	0	3	528	0	535
17230	546	0	1	7	0	554
17231	3	0	559	1	0	563
17232	584	0	3	3	0	590
17233	615	0	1	1	0	617
17234	4	0	0	609	0	613
17235	2	0	0	633	0	635
17236	623	0	0	9	0	632
17237	4	0	0	632	0	636
17238	627	0	0	7	0	634
17239	3	651	0	1	0	655
17240	0	643	0	1	0	644
17241	4	2	0	658	0	664
17242	1	1	667	3	0	672
17243	0	667	2	0	0	669
17244	664	2	0	1	0	667
17245	2	667	0	1	0	670
17246	1	3	656	1	0	661
17247	6	0	1	634	0	641
17248	0	3	677	4	0	684
17249	1	688	4	0	0	693
17250	2	4	0	682	0	688
17251	2	678	1	2	0	683
17252	0	4	686	1	0	691
17253	1	0	4	672	0	677
17254	2	2	681	2	0	687
17255	3	0	2	681	0	686
17256	685	1	1	5	0	692
17257	2	0	664	1	0	667
17258	631	0	2	4	0	637
17259	5	1	643	5	0	654
17260	2	1	3	652	0	658
17261	4	1	661	3	0	669
17262	3	0	2	659	0	664
17263	3	0	2	665	0	670
17264	2	0	1	656	0	659
17265	1	0	2	661	0	664
17266	1	2	707	4	0	714
17267	671	1	3	4	0	679
17268	3	2	1	749	0	755
17269	752	0	1	7	0	760
17270	745	0	2	9	0	756
17271	760	1	0	3	0	764
17272	9	0	1	760	0	770
17273	2	2	0	769	0	773
17274	2	825	5	5	0	837
17275	887	9	0	11	0	907
17276	932	2	1	7	0	942
17277	939	2	1	9	0	951
17278	20	2	941	1	0	964
17279	7	3	14	929	0	953
17280	6	0	948	14	0	968
17281	911	1	16	9	0	937
17282	917	0	3	6	0	926
17283	20	1	4	915	0	940
17284	7	1	1	886	0	895
17285	3	921	4	17	0	945
17286	941	14	9	3	0	967
17287	951	6	2	7	0	966
17288	20	918	1	5	0	944
17289	906	13	1	12	0	932
17290	15	6	5	912	0	938
17291	10	2	2	910	0	924
17292	913	0	2	27	0	942
17293	17	2	887	8	0	914
17294	885	1	16	6	0	908
17295	890	1	4	16	0	911
17296	16	872	4	3	0	895
17297	887	16	2	6	0	911
17298	21	5	857	3	0	886
17299	17	4	15	865	0	901
17300	881	3	4	24	0	912
17301	23	4	3	869	0	899
17302	8	2	851	21	0	882
17303	8	0	17	829	0	854
17304	7	942	7	21	0	977
17305	10	16	6	961	0	993
17306	11	4	2	990	0	1007
17307	14	3	2	969	0	988
17308	9	3	3	993	0	1008
17309	4	4	975	23	0	1006
17310	7	0	18	985	0	1010
17311	975	1	4	26	0	1006
17312	19	966	6	8	0	999
17313	9	17	1	998	0	1025
17314	5	5	996	18	0	1024
17315	6	3	17	995	0	1021
17316	1004	4	5	25	0	1038
17317	997	3	4	13	0	1017
17318	978	1	2	11	0	992
17319	28	1	3	988	0	1020
17320	10	2	981	22	0	1015
17321	7	959	20	9	0	995
17322	976	16	7	17	0	1016
17323	28	5	4	973	0	1010
17324	9	5	2	988	0	1004
17325	10	1	976	22	0	1009
17326	4	937	20	12	0	973
17327	10	975	5	8	0	998
17328	13	19	4	923	0	959
17329	5	7	885	24	0	921
17330	837	4	18	11	0	870
17331	21	3	864	8	0	896
17332	792	4	18	6	0	820
17333	20	863	7	8	0	898
17334	8	19	857	6	0	890
17335	818	6	15	10	0	849
17336	16	838	4	7	0	865
17337	869	17	7	9	0	902
17338	19	8	850	4	0	881
17339	8	863	21	2	0	894
17340	870	17	4	10	0	901
17341	19	9	849	4	0	881
17342	850	4	18	9	0	881
17343	24	2	7	853	0	886
17344	854	3	9	18	0	884
17345	27	3	1	852	0	883
17346	849	5	5	28	0	887
17347	26	2	857	8	0	893
17348	16	4	19	851	0	890
17349	12	5	5	865	0	887
17350	5	3	860	25	0	893
17351	12	4	20	850	0	886
17352	7	708	10	21	0	746
17353	10	17	5	898	0	930
17354	10	6	3	936	0	955
17355	5	4	4	1033	0	1046
17356	8	4	991	34	0	1037
17357	1010	4	21	23	0	1058
17358	37	1	9	1093	0	1140
17359	16	3	1103	31	0	1153
17360	1068	1	29	20	0	1118
17361	1102	0	18	23	0	1143
17362	1149	3	8	11	0	1171
17363	45	5	6	1118	0	1174
17364	27	2	6	1258	0	1293
17365	17	4	4	1236	0	1261
17366	8	1213	4	52	0	1277
17367	1198	32	1	38	0	1269
17368	1210	19	4	19	0	1252
17369	60	7	7	1178	0	1252
17370	26	2	1152	43	0	1223
17371	10	5	1161	22	0	1198
17372	14	1097	48	14	0	1173
17373	10	1169	27	10	0	1216
17374	1033	44	13	17	0	1107
17375	32	1015	7	3	0	1057
17376	1006	26	1	9	0	1042
17377	996	12	3	13	0	1024
17378	1009	6	1	9	0	1025
17379	50	4	1	984	0	1039
17380	27	6	2	1025	0	1060
17381	1031	4	0	44	0	1079
17382	41	7	2	1043	0	1093
17383	21	1	1020	39	0	1081
17384	1032	4	32	24	0	1092
17385	36	5	20	1034	0	1095
17386	25	5	9	1061	0	1100
17387	15	8	4	1073	0	1100
17388	9	8	1033	46	0	1096
17389	985	6	29	22	0	1042
17390	42	5	1055	9	0	1111
17391	29	5	31	1031	0	1096
17392	17	4	1056	38	0	1115
17393	14	1	37	1045	0	1097
17394	17	1	15	1067	0	1100
17395	8	0	1090	55	0	1153
17396	13	1	32	1007	0	1053
17397	10	1067	22	38	0	1137
17398	1080	30	7	29	0	1146
17399	1100	13	8	20	0	1141
17400	54	3	6	1091	0	1154
17401	20	3	1095	50	0	1168
17402	13	1019	42	26	0	1100
17403	12	1098	21	18	0	1149
17404	1009	43	15	11	0	1078
17405	41	16	991	14	0	1062
17406	996	5	42	13	0	1056
17407	43	6	21	992	0	1062
17408	26	3	11	1019	0	1059
17409	970	5	5	60	0	1040
17410	33	971	11	34	0	1049
17411	24	37	977	12	0	1050
17412	18	21	34	971	0	1044
17413	14	11	991	40	0	1056
17414	15	984	40	26	0	1065
17415	8	37	28	992	0	1065
17416	981	21	12	46	0	1060
17417	1005	9	10	28	0	1052
17418	56	12	988	14	0	1070
17419	29	989	38	13	0	1069
17420	982	36	27	18	0	1063
17421	47	1009	12	13	0	1081
17422	33	37	6	1007	0	1083
17423	1007	16	12	44	0	1079
17424	47	7	7	1016	0	1077
17425	25	6	983	49	0	1063
17426	16	12	35	999	0	1062
17427	12	6	996	53	0	1067
17428	18	11	42	995	0	1066
17429	983	9	23	47	0	1062
17430	47	982	12	25	0	1066
17431	1000	36	9	25	0	1070
17432	53	20	13	967	0	1053
17433	24	15	12	992	0	1043
17434	21	15	871	52	0	959
17435	16	13	964	26	0	1019
17436	17	942	47	27	0	1033
17437	8	44	959	14	0	1025
17438	893	18	38	28	0	977
17439	45	919	22	21	0	1007
17440	23	972	15	22	0	1032
17441	16	987	14	15	0	1032
17442	14	52	12	951	0	1029
17443	14	24	965	43	0	1046
17444	15	957	40	26	0	1038
17445	17	39	22	896	0	974
17446	8	989	8	43	0	1048
17447	958	38	13	29	0	1038
17448	988	23	9	18	0	1038
17449	54	10	11	965	0	1040
17450	28	11	15	981	0	1035
17451	929	10	13	54	0	1006
17452	41	909	8	33	0	991
17453	20	939	11	14	0	984
17454	24	41	4	850	0	919
17455	7	20	767	33	0	827
17456	5	766	32	20	0	823
17457	686	27	22	13	0	748
17458	21	677	6	10	0	714
17459	12	691	8	7	0	718
17460	653	32	7	7	0	699
17461	30	666	6	7	0	709
17462	15	28	655	3	0	701
17463	8	658	22	8	0	696
17464	496	14	4	8	0	522
17465	11	488	4	3	0	506
17466	474	13	3	3	0	493
17467	13	4	4	472	0	493
17468	4	5	1	482	0	492
17469	4	4	472	11	0	491
17470	4	473	12	4	0	493
17471	5	14	3	471	0	493
17472	456	3	3	17	0	479
17473	463	4	4	4	0	475
17474	11	477	2	4	0	494
17475	7	18	1	474	0	500
17476	476	8	0	15	0	499
17477	475	2	1	6	0	484
17478	14	1	447	5	0	467
17479	4	3	416	3	0	426
17480	2	2	401	3	0	408
17481	2	397	8	1	0	408
17482	374	4	5	0	0	383
17483	8	361	1	0	0	370
17484	355	4	0	4	0	363
17485	5	383	1	1	0	390
17486	2	7	0	402	0	411
17487	409	0	1	5	0	415
17488	5	3	413	0	0	421
17489	403	1	4	5	0	413
17490	421	1	0	2	0	424
17491	5	414	2	0	0	421
17492	2	435	0	0	0	437
17493	446	5	0	3	0	454
17494	5	2	465	1	0	473
17495	437	1	5	1	0	444
17496	446	1	1	0	0	448
17497	3	0	2	437	0	442
17498	440	1	2	3	0	446
17499	5	2	0	451	0	458
17500	3	0	0	477	0	480
17501	2	2	0	454	0	458
17502	1	459	2	6	0	468
17503	462	5	0	5	0	472
17504	461	2	0	2	0	465
17505	7	2	3	457	0	469
17506	3	2	2	461	0	468
17507	5	453	2	4	0	464
17508	452	6	1	2	0	461
17509	6	3	441	1	0	451
17510	5	5	3	445	0	458
17511	2	0	436	5	0	443
17512	6	1	5	442	0	454
17513	3	2	450	6	0	461
17514	3	1	4	428	0	436
17515	444	2	2	7	0	455
17516	6	2	461	4	0	473
17517	446	1	3	8	0	458
17518	7	507	1	6	0	521
17519	4	5	1	527	0	537
17520	3	2	1	528	0	534
17521	552	3	3	8	0	566
17522	9	2	0	592	0	603
17523	3	2	584	8	0	597
17524	579	3	2	4	0	588
17525	606	2	2	5	0	615
17526	607	2	2	4	0	615
17527	606	1	2	7	0	616
17528	8	593	1	3	0	605
17529	4	4	2	613	0	623
17530	609	1	3	8	0	621
17531	7	1	3	611	0	622
17532	601	2	2	11	0	616
17533	5	3	588	5	0	601
17534	5	2	606	2	0	615
17535	7	4	7	569	0	587
17536	2	603	3	5	0	613
17537	1	631	2	5	0	639
17538	619	3	1	10	0	633
17539	7	2	617	2	0	628
17540	554	0	5	3	0	562
17541	6	596	1	3	0	606
17542	593	3	2	6	0	604
17543	5	2	1	583	0	591
17544	5	1	603	3	0	612
17545	3	0	2	591	0	596
17546	3	0	0	588	0	591
17547	2	585	3	5	0	595
17548	3	606	2	3	0	614
17549	5	3	0	612	0	620
17550	1	622	4	4	0	631
17551	2	5	610	4	0	621
17552	3	3	592	2	0	600
17553	585	1	4	3	0	593
17554	621	1	4	5	0	631
17555	7	617	1	2	0	627
17556	7	2	1	613	0	623
17557	2	2	1	615	0	620
17558	2	2	620	5	0	629
17559	4	1	2	587	0	594
17560	2	616	3	6	0	627
17561	1	4	607	4	0	616
17562	3	5	588	3	0	599
17563	3	568	5	3	0	579
17564	1	4	602	1	0	608
17565	4	2	2	584	0	592
17566	5	1	4	519	0	529
17567	3	4	607	5	0	619
17568	8	2	3	595	0	608
17569	4	605	4	3	0	616
17570	1	643	1	6	0	651
17571	3	3	2	641	0	649
17572	1	4	631	6	0	642
17573	2	664	4	2	0	672
17574	0	1	2	680	0	683
17575	2	4	661	0	0	667
17576	619	0	2	13	0	634
17577	663	2	3	7	0	675
17578	667	3	1	5	0	676
17579	4	1	2	652	0	659
17580	3	1	1	662	0	667
17581	2	2	669	2	0	675
17582	1	1	2	657	0	661
17583	2	1	3	669	0	675
17584	2	0	665	4	0	671
17585	560	1	1	7	0	569
17586	1	604	4	1	0	610
17587	612	1	0	8	0	621
17588	1	595	3	2	0	601
17589	2	1	2	604	0	609
17590	1	1	594	3	0	599
17591	1	3	1	577	0	582
17592	1	1	587	1	0	590
17593	479	1	4	6	0	490
17594	1	1	558	1	0	561
17595	3	0	3	533	0	539
17596	0	0	570	4	0	574
17597	0	567	3	3	0	573
17598	4	1	3	585	0	593
17599	6	1	2	586	0	595
17600	1	0	0	583	0	584
17601	0	0	595	3	0	598
17602	1	2	572	0	0	575
17603	1	1	4	565	0	571
17604	4	0	0	649	0	653
17605	1	1	1	741	0	744
17606	731	0	3	25	0	759
17607	21	0	4	769	0	794
17608	4	2	798	24	0	828
17609	836	0	24	13	0	873
17610	27	1	4	861	0	893
17611	908	0	5	28	0	941
17612	925	0	2	11	0	938
17613	35	0	5	911	0	951
17614	927	2	2	30	0	961
17615	935	1	1	22	0	959
17616	37	2	907	5	0	951
17617	16	921	24	5	0	966
17618	13	27	8	893	0	941
17619	12	6	4	922	0	944
17620	913	3	5	33	0	954
17621	892	3	4	16	0	915
17622	891	3	2	14	0	910
17623	39	1	842	9	0	891
17624	14	847	30	5	0	896
17625	847	26	7	12	0	892
17626	33	851	6	4	0	894
17627	873	29	3	8	0	913
17628	33	11	3	856	0	903
17629	869	7	1	27	0	904
17630	873	4	0	15	0	892
17631	883	6	4	6	0	899
17632	41	5	856	4	0	906
17633	865	1	25	9	0	900
17634	34	885	8	7	0	934
17635	926	25	5	10	0	966
17636	946	6	3	8	0	963
17637	963	4	7	7	0	981
17638	49	4	4	909	0	966
17639	19	923	6	24	0	972
17640	937	27	4	12	0	980
17641	38	9	938	7	0	992
17642	19	955	27	7	0	1008
17643	15	28	8	907	0	958
17644	13	979	6	25	0	1023
17645	970	29	3	9	0	1011
17646	1015	11	6	6	0	1038
17647	43	11	5	987	0	1046
17648	17	8	962	36	0	1023
17649	14	974	27	13	0	1028
17650	24	32	10	842	0	908
17651	15	10	9	991	0	1025
17652	15	8	4	1024	0	1051
17653	994	2	7	48	0	1051
17654	1010	9	4	17	0	1040
17655	1020	2	3	18	0	1043
17656	1026	4	4	12	0	1046
17657	54	4	5	1000	0	1063
17658	27	4	1010	38	0	1079
17659	24	5	30	1029	0	1088
17660	19	3	11	1041	0	1074
17661	19	4	3	1042	0	1068
17662	19	1	6	1040	0	1066
17663	1014	0	9	46	0	1069
17664	47	6	3	1026	0	1082
17665	1011	2	2	48	0	1063
17666	1031	4	4	21	0	1060
17667	52	2	981	15	0	1050
17668	25	4	967	13	0	1009
17669	19	6	1011	13	0	1049
17670	23	3	41	965	0	1032
17671	23	4	992	35	0	1054
17672	18	4	42	983	0	1047
17673	10	7	17	992	0	1026
17674	972	4	8	49	0	1033
17675	43	3	9	953	0	1008
17676	19	985	12	37	0	1053
17677	1016	35	6	23	0	1080
17678	38	1027	4	17	0	1086
17679	17	36	1048	14	0	1115
17680	18	1063	31	8	0	1120
17681	1047	38	7	11	0	1103
17682	46	13	7	1037	0	1103
17683	21	11	1024	34	0	1090
17684	1028	12	34	13	0	1087
17685	53	3	10	1035	0	1101
17686	24	13	1038	35	0	1110
17687	21	1	31	1054	0	1107
17688	16	7	13	1069	0	1105
17689	26	3	6	1042	0	1077
17690	15	1043	7	42	0	1107
17691	1064	33	7	23	0	1127
17692	36	7	7	1045	0	1095
17693	20	1063	6	41	0	1130
17694	14	38	1	1072	0	1125
17695	15	12	1050	39	0	1116
17696	15	1056	34	19	0	1124
17697	1052	31	9	18	0	1110
17698	1036	15	8	16	0	1075
17699	46	10	7	1003	0	1066
17700	25	4	6	1033	0	1068
17701	1003	4	9	42	0	1058
17702	1003	6	5	20	0	1034
17703	40	992	9	14	0	1055
17704	902	20	2	14	0	938
17705	26	8	820	6	0	860
17706	20	4	804	7	0	835
17707	9	786	19	6	0	820
17708	8	781	4	1	0	794
17709	712	9	5	8	0	734
17710	11	722	3	4	0	740
17711	682	7	3	10	0	702
17712	671	2	0	9	0	682
17713	681	1	1	6	0	689
17714	10	0	1	669	0	680
17715	670	2	1	9	0	682
17716	8	1	646	7	0	662
17717	4	0	658	2	0	664
17718	3	655	10	3	0	671
17719	1	7	663	3	0	674
17720	3	5	7	625	0	640
17721	4	0	647	7	0	658
17722	2	2	610	3	0	617
17723	6	1	10	625	0	642
17724	627	0	2	13	0	642
17725	630	0	1	5	0	636
17726	9	0	666	4	0	679
17727	650	0	8	3	0	661
17728	6	2	669	3	0	680
17729	663	0	7	2	0	672
17730	686	4	1	5	0	696
17731	9	1	4	675	0	689
17732	4	2	0	650	0	656
17733	3	645	2	6	0	656
17734	1	652	4	3	0	660
17735	2	6	1	632	0	641
17736	8	0	2	629	0	639
17737	602	0	1	13	0	616
17738	6	604	7	0	0	617
17739	599	5	0	6	0	610
17740	4	607	3	4	0	618
17741	3	5	598	3	0	609
17742	12	0	6	579	0	597
17743	574	0	2	9	0	585
17744	605	0	0	5	0	610
17745	8	634	1	1	0	644
17746	2	647	2	2	0	653
17747	2	654	1	1	0	658
17748	3	16	0	684	0	703
17749	2	3	693	5	0	703
17750	2	692	6	0	0	700
17751	2	5	0	728	0	735
17752	3	1	2	726	0	732
17753	1	4	720	5	0	730
17754	2	0	700	4	0	706
17755	668	1	5	6	0	680
17756	7	1	733	0	0	741
17757	704	0	8	4	0	716
17758	688	1	4	4	0	697
17759	692	5	4	5	0	706
17760	692	2	1	4	0	699
17761	8	0	684	5	0	697
17762	3	686	9	3	0	701
17763	6	6	7	677	0	696
17764	3	1	691	9	0	704
17765	9	3	9	670	0	691
17766	5	626	8	9	0	648
17767	7	6	7	697	0	717
17768	15	3	2	706	0	726
17769	10	6	4	679	0	699
17770	692	0	5	8	0	705
17771	13	5	4	687	0	709
17772	7	5	1	689	0	702
17773	9	2	4	679	0	694
17774	1	675	6	13	0	695
17775	656	12	4	10	0	682
17776	7	633	3	9	0	652
17777	4	629	4	8	0	645
17778	8	3	3	630	0	644
17779	9	7	0	612	0	628
17780	608	5	1	14	0	628
17781	15	1	1	619	0	636
17782	612	0	3	22	0	637
17783	782	3	4	5	0	794
17784	25	6	0	769	0	800
17785	19	3	2	760	0	784
17786	7	786	2	25	0	820
17787	798	26	1	19	0	844
17788	23	827	1	9	0	860
17789	825	30	0	14	0	869
17790	30	15	796	8	0	849
17791	803	9	22	11	0	845
17792	859	3	10	11	0	883
17793	44	1	6	818	0	869
17794	19	3	826	30	0	878
17795	13	818	25	14	0	870
17796	15	28	11	838	0	892
17797	10	13	847	27	0	897
17798	12	12	23	849	0	896
17799	832	7	16	33	0	888
17800	35	4	819	17	0	875
17801	20	819	25	13	0	877
17802	14	841	15	13	0	883
17803	8	37	16	721	0	782
17804	6	843	7	17	0	873
17805	831	33	6	19	0	889
17806	832	13	9	20	0	874
17807	835	11	9	16	0	871
17808	53	9	795	6	0	863
17809	823	5	28	10	0	866
17810	39	10	20	791	0	860
17811	26	10	10	814	0	860
17812	21	7	6	814	0	848
17813	15	10	7	829	0	861
17814	12	9	794	43	0	858
17815	14	8	796	24	0	842
17816	12	3	802	14	0	831
17817	759	9	47	10	0	825
17818	31	770	22	8	0	831
17819	25	25	14	765	0	829
17820	771	14	8	40	0	833
17821	32	779	7	24	0	842
17822	18	807	8	22	0	855
17823	782	38	8	19	0	847
17824	793	23	12	9	0	837
17825	40	805	10	11	0	866
17826	34	32	4	721	0	791
17827	19	785	6	22	0	832
17828	759	34	6	21	0	820
17829	767	16	6	17	0	806
17830	788	12	5	10	0	815
17831	46	748	4	7	0	805
17832	30	28	2	756	0	816
17833	28	13	728	32	0	801
17834	17	14	25	738	0	794
17835	16	9	16	760	0	801
17836	10	10	736	44	0	800
17837	721	7	28	26	0	782
17838	41	7	16	730	0	794
17839	25	7	8	726	0	766
17840	18	727	3	38	0	786
17841	719	31	9	22	0	781
17842	34	18	9	708	0	769
17843	22	718	4	32	0	776
17844	664	29	3	28	0	724
17845	29	658	6	13	0	706
17846	627	28	5	8	0	668
17847	32	19	612	11	0	674
17848	18	9	558	11	0	596
17849	11	5	568	7	0	591
17850	13	554	37	4	0	608
17851	7	26	18	494	0	545
17852	5	536	9	20	0	570
17853	553	28	9	7	0	597
17854	26	19	545	7	0	597
17855	553	4	24	9	0	590
17856	552	6	18	5	0	581
17857	42	4	7	549	0	602
17858	569	2	8	27	0	606
17859	30	3	5	568	0	606
17860	16	7	552	26	0	601
17861	555	4	23	18	0	600
17862	31	554	13	6	0	604
17863	17	26	5	558	0	606
17864	563	11	5	27	0	606
17865	30	5	3	564	0	602
17866	19	7	544	25	0	595
17867	15	2	25	550	0	592
17868	6	545	15	27	0	593
17869	551	22	6	16	0	595
17870	29	16	5	545	0	595
17871	573	6	2	24	0	605
17872	30	5	4	572	0	611
17873	19	4	3	568	0	594
17874	5	561	7	33	0	606
17875	572	22	2	19	0	615
17876	24	572	2	18	0	616
17877	17	24	3	544	0	588
17878	11	562	0	23	0	596
17879	561	20	0	19	0	600
17880	560	15	3	8	0	586
17881	574	6	1	7	0	588
17882	36	529	1	9	0	575
17883	4	393	0	3	0	400
17884	382	14	0	2	0	398
17885	15	375	2	1	0	393
17886	4	16	2	348	0	370
17887	2	4	337	7	0	350
17888	301	4	6	5	0	316
17889	324	1	3	0	0	328
17890	318	1	1	4	0	324
17891	8	323	1	2	0	334
17892	300	6	0	3	0	309
17893	5	3	316	3	0	327
17894	5	318	3	0	0	326
17895	1	2	3	305	0	311
17896	0	293	2	1	0	296
17897	273	1	0	4	0	278
17898	1	291	0	0	0	292
17899	0	1	0	285	0	286
17900	0	284	2	1	0	287
17901	0	1	0	287	0	288
17902	0	0	0	281	0	281
17903	0	0	294	1	0	295
17904	1	0	1	286	0	288
17905	289	0	0	2	0	291
17906	281	0	0	3	0	284
17907	1	0	0	294	0	295
17908	2	0	290	1	0	293
17909	1	0	1	290	0	292
17910	298	0	0	1	0	299
17911	321	0	0	2	0	323
17912	321	0	0	2	0	323
17913	1	342	0	0	0	343
17914	347	1	0	0	0	348
17915	1	0	335	0	0	336
17916	385	0	1	2	0	388
17917	3	0	0	399	0	402
17918	0	0	0	397	0	397
17919	0	0	1	403	0	404
17920	398	0	0	4	0	402
17921	391	0	0	2	0	393
17922	1	0	0	399	0	400
17923	0	0	403	2	0	405
17924	2	0	1	401	0	404
17925	2	1	0	399	0	402
17926	1	0	404	2	0	407
17927	0	395	2	1	0	398
17928	1	1	0	408	0	410
17929	409	0	0	3	0	412
17930	2	0	1	416	0	419
17931	1	1	1	415	0	418
17932	410	0	0	5	0	415
17933	3	401	1	0	0	405
17934	0	417	0	1	0	418
17935	409	1	0	5	0	415
17936	2	0	411	0	0	413
17937	399	1	1	1	0	402
17938	1	2	454	0	0	457
17939	1	457	2	1	0	461
17940	461	1	1	1	0	464
17941	465	0	1	3	0	469
17942	455	4	1	3	0	463
17943	460	1	0	6	0	467
17944	2	0	458	0	0	460
17945	2	0	1	448	0	451
17946	462	0	0	2	0	464
17947	2	0	477	0	0	479
17948	1	0	472	0	0	473
17949	0	473	1	2	0	476
17950	465	1	0	3	0	469
17951	0	0	0	459	0	459
17952	459	0	1	3	0	463
17953	1	464	0	0	0	465
17954	3	1	0	482	0	486
17955	1	0	1	480	0	482
17956	1	0	0	503	0	504
17957	0	0	493	2	0	495
17958	0	486	2	1	0	489
17959	525	2	0	1	0	528
17960	2	0	0	526	0	528
17961	522	0	1	4	0	527
17962	519	1	0	2	0	522
17963	4	0	0	517	0	521
17964	2	3	530	2	0	537
17965	1	1	1	523	0	526
17966	1	530	1	1	0	533
17967	1	2	0	536	0	539
17968	0	1	529	1	0	531
17969	528	0	1	5	0	534
17970	4	1	3	535	0	543
17971	502	0	0	7	0	509
17972	1	1	497	2	0	501
17973	483	1	1	2	0	487
17974	3	0	508	1	0	512
17975	470	0	1	4	0	475
17976	1	491	4	1	0	497
17977	2	496	0	3	0	501
17978	2	1	1	502	0	506
17979	2	0	3	465	0	470
17980	2	1	1	485	0	489
17981	501	2	0	3	0	506
17982	3	0	1	498	0	502
17983	2	0	496	4	0	502
17984	458	0	1	8	0	467
17985	3	501	1	0	0	505
17986	501	2	0	6	0	509
17987	491	2	1	5	0	499
17988	4	0	507	1	0	512
17989	3	1	2	503	0	509
17990	4	1	2	531	0	538
17991	2	1	540	6	0	549
17992	0	542	6	4	0	552
17993	531	4	2	6	0	543
17994	531	3	0	2	0	536
17995	6	1	1	530	0	538
17996	3	1	1	533	0	538
17997	2	0	2	565	0	569
17998	546	0	0	11	0	557
17999	7	566	1	4	0	578
18000	573	6	2	4	0	585
18001	561	3	2	4	0	570
18002	9	3	590	1	0	603
18003	8	1	5	554	0	568
18004	4	597	4	6	0	611
18005	7	6	2	609	0	624
18006	2	3	2	618	0	625
18007	4	3	630	12	0	649
18008	638	2	8	6	0	654
18009	679	1	5	4	0	689
18010	693	1	2	4	0	700
18011	14	1	2	677	0	694
18012	8	0	2	667	0	677
18013	4	647	0	16	0	667
18014	3	690	1	7	0	701
18015	671	15	1	5	0	692
18016	12	642	3	2	0	659
18017	7	14	631	2	0	654
18018	2	5	13	643	0	663
18019	649	2	3	15	0	669
18020	12	4	642	4	0	662
18021	6	2	636	3	0	647
18022	647	1	16	7	0	671
18023	665	0	5	5	0	675
18024	18	3	4	641	0	666
18025	8	1	652	15	0	676
18026	5	2	11	657	0	675
18027	3	4	645	16	0	668
18028	2	4	677	9	0	692
18029	4	691	17	2	0	714
18030	682	12	6	7	0	707
18031	681	6	5	5	0	697
18032	18	683	5	3	0	709
18033	10	14	2	678	0	704
18034	5	4	5	679	0	693
18035	10	3	5	688	0	706
18036	684	5	2	18	0	709
18037	17	681	0	7	0	705
18038	652	11	2	14	0	679
18039	654	4	3	13	0	674
18040	18	5	642	5	0	670
18041	8	642	16	2	0	668
18042	8	14	8	647	0	677
18043	6	7	663	13	0	689
18044	640	3	15	9	0	667
18045	661	5	5	8	0	679
18046	675	3	4	6	0	688
18047	680	3	4	7	0	694
18048	25	2	4	653	0	684
18049	13	3	652	17	0	685
18050	6	3	13	655	0	677
18051	650	3	9	16	0	678
18052	652	4	6	14	0	676
18053	20	651	8	7	0	686
18054	646	13	3	8	0	670
18055	17	7	631	6	0	661
18056	12	3	608	7	0	630
18057	603	3	20	5	0	631
18058	21	606	6	5	0	638
18059	13	13	2	562	0	590
18060	8	557	5	14	0	584
18061	7	15	2	581	0	605
18062	8	7	1	571	0	587
18063	5	5	6	590	0	606
18064	567	7	3	21	0	598
18065	578	3	1	12	0	594
18066	564	4	3	9	0	580
18067	21	5	550	6	0	582
18068	558	3	15	8	0	584
18069	21	2	8	574	0	605
18070	11	0	8	595	0	614
18071	10	1	587	19	0	617
18072	17	2	12	657	0	688
18073	699	3	5	23	0	730
18074	17	4	689	14	0	724
18075	12	2	22	695	0	731
18076	697	1	10	26	0	734
18077	688	1	5	15	0	709
18078	28	2	694	5	0	729
18079	19	3	696	6	0	724
18080	14	2	21	714	0	751
18081	711	3	15	20	0	749
18082	726	1	9	14	0	750
18083	27	1	6	695	0	729
18084	17	725	6	20	0	768
18085	727	15	2	17	0	761
18086	20	740	4	6	0	770
18087	19	18	2	748	0	787
18088	5	11	741	21	0	778
18089	7	3	705	15	0	730
18090	9	7	711	6	0	733
18091	11	1	20	683	0	715
18092	12	1	16	690	0	719
18093	686	1	12	23	0	722
18094	19	688	5	12	0	724
18095	691	11	4	12	0	718
18096	20	6	3	651	0	680
18097	14	660	3	18	0	695
18098	8	694	3	11	0	716
18099	13	20	7	665	0	705
18100	674	10	2	21	0	707
18101	13	672	3	11	0	699
18102	642	16	9	8	0	675
18103	20	673	3	4	0	700
18104	658	10	6	7	0	681
18105	16	8	635	3	0	662
18106	11	4	624	7	0	646
18107	9	614	13	3	0	639
18108	565	14	14	8	0	601
18109	9	546	6	5	0	566
18110	14	506	4	5	0	529
18111	8	11	2	529	0	550
18112	526	6	3	7	0	542
18113	7	538	2	8	0	555
18114	519	9	4	5	0	537
18115	9	519	3	4	0	535
18116	509	6	2	3	0	520
18117	11	509	1	2	0	523
18118	6	507	2	3	0	518
18119	6	9	1	488	0	504
18120	4	512	0	3	0	519
18121	502	7	1	10	0	520
18122	5	7	498	3	0	513
18123	7	4	6	485	0	502
18124	3	3	504	6	0	516
18125	4	2	6	489	0	501
18126	5	2	7	496	0	510
18127	2	2	464	11	0	479
18128	434	3	7	9	0	453
18129	8	442	5	5	0	460
18130	448	6	2	10	0	466
18131	9	460	1	4	0	474
18132	6	9	3	464	0	482
18133	469	7	1	9	0	486
18134	465	3	1	11	0	480
18135	475	4	2	4	0	485
18136	11	2	2	464	0	479
18137	8	2	5	451	0	466
18138	7	478	1	9	0	495
18139	483	5	3	8	0	499
18140	489	4	3	8	0	504
18141	492	5	3	4	0	504
18142	489	3	2	3	0	497
18143	15	466	2	3	0	486
18144	12	8	3	479	0	502
18145	5	10	474	8	0	497
18146	455	2	6	11	0	474
18147	468	3	9	5	0	485
18148	10	6	469	4	0	489
18149	9	2	456	6	0	473
18150	7	1	9	467	0	484
18151	7	5	6	472	0	490
18152	8	2	3	478	0	491
18153	467	4	2	11	0	484
18154	7	2	2	476	0	487
18155	7	5	473	9	0	494
18156	6	4	5	475	0	490
18157	3	2	481	8	0	494
18158	5	2	8	476	0	491
18159	4	1	9	477	0	491
18160	4	4	473	14	0	495
18161	443	1	8	13	0	465
18162	9	473	11	2	0	495
18163	486	7	3	5	0	501
18164	11	9	3	497	0	520
18165	501	4	3	11	0	519
18166	12	515	2	7	0	536
18167	9	538	1	6	0	554
18168	4	24	1	536	0	565
18169	7	8	558	15	0	588
18170	5	5	555	6	0	571
18171	5	546	22	4	0	577
18172	422	15	5	13	0	455
18173	17	3	1	422	0	443
18174	416	3	4	13	0	436
18175	15	402	3	4	0	424
18176	3	430	3	2	0	438
18177	9	17	2	417	0	445
18178	429	6	2	16	0	453
18179	437	5	3	6	0	451
18180	16	5	416	8	0	445
18181	5	6	410	5	0	426
18182	403	1	17	7	0	428
18183	16	407	5	4	0	432
18184	403	16	2	5	0	426
18185	17	6	6	394	0	423
18186	9	1	380	14	0	404
18187	356	3	13	8	0	380
18188	15	378	6	1	0	400
18189	6	395	1	5	0	407
18190	6	16	1	386	0	409
18191	398	5	4	15	0	422
18192	19	4	3	403	0	429
18193	414	3	3	17	0	437
18194	17	4	399	5	0	425
18195	396	7	11	6	0	420
18196	415	3	4	3	0	425
18197	17	4	385	6	0	412
18198	379	2	11	8	0	400
18199	12	382	8	4	0	406
18200	9	13	5	364	0	391
18201	8	387	1	15	0	411
18202	387	15	7	6	0	415
18203	20	4	2	372	0	398
18204	8	378	2	14	0	402
18205	6	16	3	372	0	397
18206	5	382	2	13	0	402
18207	10	14	1	389	0	414
18208	386	4	2	20	0	412
18209	21	3	1	389	0	414
18210	9	3	385	15	0	412
18211	382	6	15	5	0	408
18212	19	5	4	385	0	413
18213	9	7	386	11	0	413
18214	11	2	369	10	0	392
18215	5	5	404	4	0	418
18216	6	0	20	393	0	419
18217	6	4	4	401	0	415
18218	6	5	4	414	0	429
18219	5	2	4	419	0	430
18220	415	6	3	16	0	440
18221	423	1	3	11	0	438
18222	426	4	0	6	0	436
18223	453	5	1	8	0	467
18224	22	1	4	435	0	462
18225	11	3	442	16	0	472
18226	442	2	15	7	0	466
18227	464	2	8	6	0	480
18228	26	3	2	444	0	475
18229	8	1	6	470	0	485
18230	459	1	5	18	0	483
18231	18	2	3	444	0	467
18232	11	428	5	16	0	460
18233	441	13	2	12	0	468
18234	449	7	3	12	0	471
18235	25	2	457	4	0	488
18236	8	3	13	465	0	489
18237	6	5	9	481	0	501
18238	458	2	3	21	0	484
18239	467	2	4	8	0	481
18240	20	2	3	458	0	483
18241	11	2	459	18	0	490
18242	11	2	453	10	0	476
18243	10	2	16	453	0	481
18244	15	2	4	472	0	493
18245	453	2	4	22	0	481
18246	22	433	2	5	0	462
18247	9	448	7	5	0	469
18248	5	468	4	9	0	486
18249	12	14	6	460	0	492
18250	457	6	4	17	0	484
18251	446	3	3	11	0	463
18252	14	458	1	7	0	480
18253	464	14	3	6	0	487
18254	18	5	5	454	0	482
18255	8	3	440	17	0	468
18256	5	4	14	441	0	464
18257	12	3	3	444	0	462
18258	10	2	3	451	0	466
18259	440	2	3	21	0	466
18260	12	5	5	428	0	450
18261	8	418	5	15	0	446
18262	416	6	5	9	0	436
18263	9	410	1	8	0	428
18264	5	401	2	7	0	415
18265	4	407	2	4	0	417
18266	1	10	367	4	0	382
18267	5	368	4	2	0	379
18268	1	6	318	13	0	338
18269	292	1	1	2	0	296
18270	303	0	0	2	0	305
18271	2	1	313	0	0	316
18272	310	1	1	4	0	316
18273	322	1	0	3	0	326
18274	3	0	324	1	0	328
18275	1	341	2	1	0	345
18276	0	2	0	341	0	343
18277	358	1	1	7	0	367
18278	3	0	2	348	0	353
18279	379	1	0	5	0	385
18280	372	1	1	4	0	378
18281	4	1	369	0	0	374
18282	368	2	2	5	0	377
18283	1	382	1	1	0	385
18284	391	4	0	1	0	396
18285	3	2	1	388	0	394
18286	3	1	393	1	0	398
18287	2	1	4	378	0	385
18288	382	1	2	4	0	389
18289	5	369	1	13	0	388
18290	2	1	379	1	0	383
18291	2	1	3	348	0	354
18292	4	0	371	3	0	378
18293	1	382	4	1	0	388
18294	385	3	2	1	0	391
18295	2	3	0	386	0	391
18296	2	0	393	5	0	400
18297	2	2	366	1	0	371
18298	397	1	2	3	0	403
18299	3	4	1	403	0	411
18300	4	2	1	398	0	405
18301	1	3	402	4	0	410
18302	2	1	401	0	0	404
18303	2	430	1	3	0	436
18304	4	2	3	431	0	440
18305	2	2	1	429	0	434
18306	4	425	2	3	0	434
18307	2	1	420	4	0	427
18308	392	2	4	1	0	399
18309	3	2	2	427	0	434
18310	2	1	442	4	0	449
18311	2	2	3	431	0	438
18312	1	451	4	5	0	461
18313	1	4	442	1	0	448
18314	420	1	2	4	0	427
18315	2	3	433	2	0	440
18316	2	2	416	3	0	423
18317	3	2	408	1	0	414
18318	3	2	448	2	0	455
18319	5	4	4	453	0	466
18320	4	1	482	4	0	491
18321	5	1	4	464	0	474
18322	3	482	4	4	0	493
18323	492	4	1	7	0	504
18324	11	0	2	498	0	511
18325	1	3	495	11	0	510
18326	3	493	8	3	0	507
18327	5	7	0	508	0	520
18328	508	1	3	9	0	521
18329	7	507	3	2	0	519
18330	2	11	0	509	0	522
18331	520	1	1	10	0	532
18332	8	3	518	1	0	530
18333	509	2	10	4	0	525
18334	8	2	510	3	0	523
18335	471	0	9	3	0	483
18336	485	0	3	2	0	490
18337	9	0	479	1	0	489
18338	2	473	8	0	0	483
18339	8	7	0	458	0	473
18340	3	2	494	7	0	506
18341	1	3	9	471	0	484
18342	2	2	1	474	0	479
18343	1	1	490	9	0	501
18344	1	0	483	3	0	487
18345	3	1	6	496	0	506
18346	498	0	2	12	0	512
18347	7	484	5	0	0	496
18348	4	485	3	4	0	496
18349	499	6	0	5	0	510
18350	506	2	3	2	0	513
18351	10	4	1	514	0	529
18352	5	2	1	510	0	518
18353	7	0	2	526	0	535
18354	516	1	1	11	0	529
18355	6	501	1	6	0	514
18356	2	539	2	3	0	546
18357	3	8	0	535	0	546
18358	4	2	1	542	0	549
18359	7	3	1	532	0	543
18360	537	3	1	12	0	553
18361	7	549	1	8	0	565
18362	544	8	2	8	0	562
18363	17	2	539	6	0	564
18364	5	554	9	0	0	568
18365	3	14	1	558	0	576
18366	558	3	1	17	0	579
18367	14	3	545	3	0	565
18368	1	3	548	6	0	558
18369	4	1	12	556	0	573
18370	9	1	4	566	0	580
18371	3	3	5	566	0	577
18372	5	2	2	553	0	562
18373	3	4	2	556	0	565
18374	0	545	0	19	0	564
18375	5	8	1	549	0	563
18376	531	2	1	19	0	553
18377	11	542	3	4	0	560
18378	538	15	3	8	0	564
18379	16	3	525	7	0	551
18380	8	3	537	2	0	550
18381	5	5	16	552	0	578
18382	4	3	652	18	0	677
18383	5	0	20	646	0	671
18384	8	2	10	657	0	677
18385	674	2	2	30	0	708
18386	688	1	4	11	0	704
18387	26	707	5	7	0	745
18388	13	749	4	5	0	771
18389	10	25	4	734	0	773
18390	739	12	2	28	0	781
18391	22	7	746	13	0	788
18392	11	5	25	738	0	779
18393	11	2	9	759	0	781
18394	6	1	741	33	0	781
18395	5	728	26	13	0	772
18396	9	22	9	712	0	752
18397	6	7	730	28	0	771
18398	4	9	28	707	0	748
18399	680	4	9	36	0	729
18400	24	685	7	13	0	729
18401	8	704	6	13	0	731
18402	12	28	2	690	0	732
18403	666	15	2	32	0	715
18404	26	682	3	12	0	723
18405	687	29	5	10	0	731
18406	30	7	677	7	0	721
18407	13	9	728	6	0	756
18408	11	9	29	693	0	742
18409	14	3	11	746	0	774
18410	716	4	11	34	0	765
18411	31	7	5	721	0	764
18412	10	4	708	36	0	758
18413	10	5	26	711	0	752
18414	4	9	8	735	0	756
18415	5	1	711	36	0	753
18416	677	4	28	18	0	727
18417	32	3	12	707	0	754
18418	670	3	10	32	0	715
18419	23	633	3	14	0	673
18420	627	23	4	13	0	667
18421	26	620	2	8	0	656
18422	7	639	5	8	0	659
18423	10	25	9	595	0	639
18424	592	10	5	25	0	632
18425	599	4	6	10	0	619
18426	30	6	1	587	0	624
18427	577	7	4	28	0	616
18428	595	3	3	13	0	614
18429	30	4	4	599	0	637
18430	587	6	4	22	0	619
18431	26	596	5	12	0	639
18432	595	20	8	9	0	632
18433	23	13	578	9	0	623
18434	623	5	19	11	0	658
18435	29	2	6	622	0	659
18436	17	2	9	632	0	660
18437	13	3	3	644	0	663
18438	6	5	2	649	0	662
18439	5	4	6	635	0	650
18440	6	586	4	31	0	627
18441	3	636	5	19	0	663
18442	628	24	5	12	0	669
18443	24	12	625	8	0	669
18444	623	4	19	8	0	654
18445	25	6	630	6	0	667
18446	13	7	21	610	0	651
18447	8	6	7	656	0	677
18448	627	3	4	37	0	671
18449	24	6	615	13	0	658
18450	16	6	19	609	0	650
18451	15	4	653	24	0	696
18452	8	660	27	14	0	709
18453	14	19	9	660	0	702
18454	659	10	7	31	0	707
18455	661	8	2	16	0	687
18456	659	4	2	16	0	681
18457	36	632	7	9	0	684
18458	16	662	6	9	0	693
18459	584	28	14	16	0	642
18460	19	657	6	8	0	690
18461	14	646	4	12	0	676
18462	12	26	622	10	0	670
18463	9	612	16	12	0	649
18464	5	626	9	9	0	649
18465	11	26	4	623	0	664
18466	6	16	634	21	0	677
18467	5	15	630	12	0	662
18468	613	6	25	11	0	655
18469	23	5	620	8	0	656
18470	628	4	21	6	0	659
18471	24	7	11	615	0	657
18472	14	624	9	21	0	668
18473	653	18	3	16	0	690
18474	675	13	3	20	0	711
18475	32	5	6	684	0	727
18476	18	7	5	686	0	716
18477	14	3	8	695	0	720
18478	677	3	7	29	0	716
18479	631	5	6	20	0	662
18480	686	5	2	12	0	705
18481	26	619	2	9	0	656
18482	526	11	4	10	0	551
18483	18	520	1	4	0	543
18484	7	517	3	2	0	529
18485	13	18	1	468	0	500
18486	3	476	3	10	0	492
18487	448	5	1	6	0	460
18488	7	5	0	434	0	446
18489	427	3	1	9	0	440
18490	9	409	1	3	0	422
18491	2	443	2	2	0	449
18492	449	8	0	9	0	466
18493	6	478	3	2	0	489
18494	7	7	1	493	0	508
18495	3	2	1	501	0	507
18496	497	1	1	12	0	511
18497	11	0	3	504	0	518
18498	5	1	504	11	0	521
18499	4	0	8	503	0	515
18500	516	5	2	12	0	535
18501	9	527	0	5	0	541
18502	547	7	1	8	0	563
18503	543	4	3	7	0	557
18504	541	1	2	8	0	552
18505	11	3	530	4	0	548
18506	7	4	514	4	0	529
18507	482	0	7	4	0	493
18508	7	503	4	2	0	516
18509	6	8	0	502	0	516
18510	4	4	0	502	0	510
18511	3	494	1	8	0	506
18512	3	512	2	3	0	520
18513	5	12	2	503	0	522
18514	5	3	2	511	0	521
18515	0	3	501	12	0	516
18516	4	1	476	5	0	486
18517	476	1	12	5	0	494
18518	512	4	5	6	0	527
18519	11	4	0	512	0	527
18520	5	2	513	11	0	531
18521	5	3	7	507	0	522
18522	506	1	6	8	0	521
18523	12	0	503	5	0	520
18524	8	2	7	505	0	522
18525	4	1	511	7	0	523
18526	3	494	11	12	0	520
18527	4	8	515	0	0	527
18528	5	10	8	494	0	517
18529	503	0	3	11	0	517
18530	10	0	3	507	0	520
18531	509	4	0	10	0	523
18532	512	1	2	7	0	522
18533	499	2	2	4	0	507
18534	9	3	471	2	0	485
18535	482	0	9	4	0	495
18536	12	2	4	487	0	505
18537	9	0	1	495	0	505
18538	2	2	491	11	0	506
18539	3	2	9	486	0	500
18540	492	0	2	9	0	503
18541	10	475	3	3	0	491
18542	494	6	0	8	0	508
18543	494	1	2	5	0	502
18544	498	1	1	7	0	507
18545	15	2	2	476	0	495
18546	3	2	486	12	0	503
18547	6	0	8	480	0	494
18548	4	3	4	494	0	505
18549	493	1	1	13	0	508
18550	483	1	1	5	0	490
18551	13	3	441	1	0	458
18552	7	0	6	456	0	469
18553	2	0	464	10	0	476
18554	454	0	13	8	0	475
18555	13	514	2	5	0	534
18556	511	13	1	1	0	526
18557	15	523	1	1	0	540
18558	519	16	4	2	0	541
18559	15	530	0	3	0	548
18560	5	17	3	533	0	558
18561	4	4	1	551	0	560
18562	550	2	0	19	0	571
18563	555	1	0	6	0	562
18564	561	3	0	2	0	566
18565	527	1	1	6	0	535
18566	536	2	2	1	0	541
18567	23	1	1	511	0	536
18568	3	513	0	21	0	537
18569	9	16	0	502	0	527
18570	5	510	1	17	0	533
18571	4	17	3	503	0	527
18572	5	509	0	16	0	530
18573	8	17	1	501	0	527
18574	2	3	471	20	0	496
18575	449	3	16	9	0	477
18576	18	479	3	2	0	502
18577	485	19	1	3	0	508
18578	19	3	474	4	0	500
18579	466	3	18	3	0	490
18580	18	2	485	4	0	509
18581	3	0	21	482	0	506
18582	5	533	2	17	0	557
18583	3	20	531	3	0	557
18584	2	3	19	538	0	562
18585	508	2	6	19	0	535
18586	22	2	3	538	0	565
18587	6	2	4	564	0	576
18588	7	2	2	569	0	580
18589	5	2	538	25	0	570
18590	6	3	19	521	0	549
18591	2	530	4	26	0	562
18592	2	19	4	528	0	553
18593	8	1	2	517	0	528
18594	494	3	2	23	0	522
18595	17	1	0	513	0	531
18596	5	1	508	20	0	534
18597	5	1	503	7	0	516
18598	4	0	504	6	0	514
18599	3	507	22	3	0	535
18600	482	17	10	5	0	514
18601	14	473	8	1	0	496
18602	471	20	3	3	0	497
18603	19	5	1	460	0	485
18604	5	4	462	19	0	490
18605	6	2	467	4	0	479
18606	3	472	21	3	0	499
18607	6	18	6	473	0	503
18608	6	3	3	488	0	500
18609	3	5	4	494	0	506
18610	3	2	481	25	0	511
18611	451	4	20	11	0	486
18612	22	1	486	5	0	514
18613	3	0	23	475	0	501
18614	5	4	3	508	0	520
18615	2	1	490	28	0	521
18616	464	4	21	8	0	497
18617	22	475	7	7	0	511
18618	478	23	6	6	0	513
18619	27	4	2	468	0	501
18620	5	471	6	22	0	504
18621	9	21	0	480	0	510
18622	473	7	4	26	0	510
18623	28	4	2	468	0	502
18624	9	2	469	26	0	506
18625	454	5	21	7	0	487
18626	476	1	4	11	0	492
18627	27	1	454	7	0	489
18628	13	2	19	456	0	490
18629	468	2	7	22	0	499
18630	27	2	2	453	0	484
18631	12	1	2	469	0	484
18632	7	2	3	468	0	480
18633	2	3	1	472	0	478
18634	5	2	446	31	0	484
18635	3	1	19	452	0	475
18636	3	4	445	31	0	483
18637	441	2	22	10	0	475
18638	464	2	5	12	0	483
18639	461	0	9	8	0	478
18640	467	0	6	8	0	481
18641	28	1	5	443	0	477
18642	441	2	4	21	0	468
18643	28	2	432	7	0	469
18644	8	1	426	7	0	442
18645	416	0	19	6	0	441
18646	19	409	10	7	0	445
18647	3	424	7	2	0	436
18648	5	20	5	412	0	442
18649	3	5	409	19	0	436
18650	403	5	15	8	0	431
18651	20	4	417	6	0	447
18652	4	388	16	2	0	410
18653	8	14	382	5	0	409
18654	3	345	21	3	0	372
18655	311	15	9	3	0	338
18656	11	305	9	0	0	325
18657	1	300	2	2	0	305
18658	6	10	3	290	0	309
18659	1	9	288	9	0	307
18660	5	4	8	272	0	289
18661	1	4	6	285	0	296
18662	2	4	275	12	0	293
18663	1	0	10	271	0	282
18664	1	273	7	12	0	293
18665	2	9	5	279	0	295
18666	276	5	4	10	0	295
18667	9	5	3	276	0	293
18668	2	2	275	16	0	295
18669	4	5	8	278	0	295
18670	1	2	267	16	0	286
18671	266	1	11	5	0	283
18672	9	0	6	273	0	288
18673	266	1	5	12	0	284
18674	10	2	271	9	0	292
18675	250	0	14	6	0	270
18676	15	266	4	2	0	287
18677	6	9	266	5	0	286
18678	9	5	11	264	0	289
18679	3	3	276	10	0	292
18680	4	249	11	4	0	268
18681	1	277	4	5	0	287
18682	226	7	4	5	0	242
18683	7	233	0	5	0	245
18684	236	8	3	5	0	252
18685	8	4	1	244	0	257
18686	6	2	245	7	0	260
18687	3	244	8	4	0	259
18688	1	10	4	245	0	260
18689	6	3	2	258	0	269
18690	5	0	0	271	0	276
18691	3	1	4	259	0	267
18692	0	248	1	14	0	263
18693	4	263	0	6	0	273
18694	242	10	4	8	0	264
18695	10	252	2	3	0	267
18696	3	8	1	251	0	263
18697	3	3	247	8	0	261
18698	3	246	8	4	0	261
18699	4	4	3	232	0	243
18700	4	4	2	229	0	239
18701	2	232	1	13	0	248
18702	221	3	1	9	0	234
18703	6	7	221	1	0	235
18704	209	4	5	1	0	219
18705	7	223	1	5	0	236
18706	209	5	1	2	0	217
18707	3	209	2	2	0	216
18708	2	4	3	216	0	225
18709	2	3	1	222	0	228
18710	217	2	0	8	0	227
18711	6	2	0	220	0	228
18712	3	2	204	6	0	215
18713	4	199	5	2	0	210
18714	0	200	5	1	0	206
18715	5	8	1	195	0	209
18716	1	8	197	4	0	210
18717	5	1	5	194	0	205
18718	1	3	4	201	0	209
18719	3	0	192	10	0	205
18720	1	2	189	9	0	201
18721	2	192	8	6	0	208
18722	200	5	6	4	0	215
18723	5	7	3	196	0	211
18724	3	194	0	10	0	207
18725	198	6	2	7	0	213
18726	4	6	1	199	0	210
18727	5	4	3	203	0	215
18728	2	202	4	10	0	218
18729	5	5	2	207	0	219
18730	198	8	2	5	0	213
18731	8	2	3	205	0	218
18732	3	5	3	209	0	220
18733	4	8	195	11	0	218
18734	2	3	184	13	0	202
18735	203	2	8	5	0	218
18736	6	6	4	199	0	215
18737	8	4	3	199	0	214
18738	3	4	3	205	0	215
18739	4	8	192	13	0	217
18740	190	4	7	14	0	215
18741	11	2	7	196	0	216
18742	4	3	3	219	0	229
18743	207	4	2	16	0	229
18744	9	203	5	9	0	226
18745	6	9	205	6	0	226
18746	8	4	5	200	0	217
18747	4	208	8	9	0	229
18748	4	11	3	211	0	229
18749	208	8	0	14	0	230
18750	6	6	3	211	0	226
18751	198	2	3	15	0	218
18752	205	2	3	14	0	224
18753	10	5	3	204	0	222
18754	11	192	4	11	0	218
18755	5	209	3	6	0	223
18756	3	11	204	7	0	225
18757	4	7	6	198	0	215
18758	2	4	7	208	0	221
18759	2	4	4	219	0	229
18760	210	4	2	15	0	231
18761	7	1	2	222	0	232
18762	6	4	211	10	0	231
18763	207	5	6	10	0	228
18764	6	5	5	222	0	238
18765	13	1	4	228	0	246
18766	5	4	217	17	0	243
18767	215	3	8	16	0	242
18768	10	2	6	227	0	245
18769	5	5	232	11	0	253
18770	6	1	8	237	0	252
18771	7	3	6	208	0	224
18772	4	224	4	18	0	250
18773	229	4	2	16	0	251
18774	227	6	4	8	0	245
18775	10	223	6	7	0	246
18776	231	5	3	8	0	247
18777	229	3	4	11	0	247
18778	17	5	0	218	0	240
18779	6	5	215	16	0	242
18780	9	2	217	8	0	236
18781	0	1	214	12	0	227
18782	5	1	212	5	0	223
18783	6	5	13	203	0	227
18784	1	1	5	236	0	243
18785	7	3	4	234	0	248
18786	6	1	1	235	0	243
18787	218	1	4	14	0	237
18788	7	222	6	9	0	244
18789	224	6	3	3	0	236
18790	10	4	218	4	0	236
18791	4	2	252	2	0	260
18792	7	0	9	247	0	263
18793	242	0	4	10	0	256
18794	238	2	4	3	0	247
18795	10	225	1	4	0	240
18796	5	236	0	2	0	243
18797	2	6	0	233	0	241
18798	236	3	1	5	0	245
18799	3	235	3	3	0	244
18800	237	4	4	1	0	246
18801	233	3	0	3	0	239
18802	239	2	0	1	0	242
18803	10	0	237	2	0	249
18804	4	242	5	1	0	252
18805	231	4	3	3	0	241
18806	231	2	1	2	0	236
18807	7	221	0	0	0	228
18808	3	219	0	1	0	223
18809	222	2	1	0	0	225
18810	3	1	1	219	0	224
18811	2	1	218	3	0	224
18812	217	0	3	1	0	221
18813	2	0	0	233	0	235
18814	2	249	1	2	0	254
18815	3	2	1	253	0	259
18816	0	1	262	3	0	266
18817	0	2	2	262	0	266
18818	278	0	1	3	0	282
18819	2	0	1	277	0	280
18820	2	0	1	278	0	281
18821	2	1	298	2	0	303
18822	2	0	2	292	0	296
18823	1	300	0	2	0	303
18824	295	3	0	1	0	299
18825	289	0	1	1	0	291
18826	3	0	293	2	0	298
18827	3	0	3	283	0	289
18828	1	288	1	4	0	294
18829	1	289	1	3	0	294
18830	288	2	3	4	0	297
18831	4	0	2	295	0	301
18832	2	1	292	4	0	299
18833	2	0	282	3	0	287
18834	3	0	3	295	0	301
18835	291	1	2	3	0	297
18836	297	1	1	2	0	301
18837	3	1	1	313	0	318
18838	3	0	308	2	0	313
18839	3	311	4	1	0	319
18840	302	4	1	2	0	309
18841	3	311	1	2	0	317
18842	307	2	1	2	0	312
18843	4	1	1	304	0	310
18844	3	3	302	2	0	310
18845	4	2	2	292	0	300
18846	301	0	0	5	0	306
18847	4	1	302	0	0	307
18848	0	309	4	0	0	313
18849	5	3	1	299	0	308
18850	305	0	1	3	0	309
18851	6	0	307	1	0	314
18852	1	2	3	311	0	317
18853	0	2	1	312	0	315
18854	2	1	306	4	0	313
18855	5	0	3	295	0	303
18856	0	4	306	2	0	312
18857	290	2	2	4	0	298
18858	5	0	2	322	0	329
18859	2	0	335	4	0	341
18860	0	335	7	1	0	343
18861	346	5	2	3	0	356
18862	376	0	0	6	0	382
18863	12	3	1	404	0	420
18864	1	402	0	8	0	411
18865	401	8	2	4	0	415
18866	10	0	1	402	0	413
18867	1	2	396	11	0	410
18868	379	0	10	2	0	391
18869	7	398	0	1	0	406
18870	3	7	1	402	0	413
18871	407	1	1	9	0	418
18872	7	2	397	2	0	408
18873	0	1	411	1	0	413
18874	4	1	7	391	0	403
18875	3	0	403	7	0	413
18876	3	0	9	391	0	403
18877	1	394	0	10	0	405
18878	0	8	4	412	0	424
18879	402	0	0	12	0	414
18880	9	2	398	0	0	409
18881	2	392	9	1	0	404
18882	4	6	0	397	0	407
18883	0	0	417	8	0	425
18884	1	1	7	383	0	392
18885	0	391	0	6	0	397
18886	0	420	1	0	0	421
18887	404	5	0	4	0	413
18888	6	419	0	0	0	425
18889	0	6	407	0	0	413
18890	376	1	5	2	0	384
18891	5	1	375	0	0	381
18892	1	0	6	366	0	373
18893	1	0	388	5	0	394
18894	0	394	6	0	0	400
18895	1	5	0	392	0	398
18896	1	0	1	394	0	396
18897	1	1	0	380	0	382
18898	0	0	396	6	0	402
18899	1	0	5	387	0	393
18900	0	0	0	415	0	415
18901	417	0	1	6	0	424
18902	416	0	0	3	0	419
18903	5	1	433	1	0	440
18904	1	426	5	0	0	432
18905	0	5	442	0	0	447
18906	1	0	5	444	0	450
18907	1	1	459	5	0	466
18908	2	0	5	447	0	454
18909	1	0	0	464	0	465
18910	0	0	459	5	0	464
18911	412	0	5	3	0	420
18912	5	485	0	3	0	493
18913	2	4	2	473	0	481
18914	2	0	473	5	0	480
18915	1	3	443	0	0	447
18916	439	0	5	5	0	449
18917	6	456	2	0	0	464
18918	1	5	2	458	0	466
18919	458	0	0	7	0	465
18920	8	2	0	451	0	461
18921	2	2	0	473	0	477
18922	4	1	471	6	0	482
18923	441	0	7	5	0	453
18924	483	0	1	5	0	489
18925	11	0	3	476	0	490
18926	485	0	0	9	0	494
18927	11	0	0	473	0	484
18928	1	470	0	11	0	482
18929	3	487	0	1	0	491
18930	2	8	0	487	0	497
18931	472	1	0	11	0	484
18932	9	3	0	471	0	483
18933	479	0	0	16	0	495
18934	491	0	0	6	0	497
18935	10	0	0	484	0	494
18936	7	0	0	483	0	490
18937	4	0	472	9	0	485
18938	0	0	472	4	0	476
18939	4	0	10	471	0	485
18940	1	0	509	9	0	519
18941	490	0	13	4	0	507
18942	12	0	2	533	0	547
18943	1	1	567	10	0	579
18944	547	0	15	2	0	564
18945	603	0	2	5	0	610
18946	16	634	4	2	0	656
18947	7	15	1	659	0	682
18948	6	2	714	13	0	735
18949	690	4	14	10	0	718
18950	736	1	3	6	0	746
18951	20	0	729	0	0	749
18952	739	0	16	5	0	760
18953	21	0	4	737	0	762
18954	7	0	6	749	0	762
18955	743	0	1	16	0	760
18956	753	2	0	7	0	762
18957	21	1	2	737	0	761
18958	9	0	746	15	0	770
18959	7	735	13	3	0	758
18960	3	10	752	5	0	770
18961	2	4	742	1	0	749
18962	3	719	14	2	0	738
18963	5	11	6	675	0	697
18964	2	2	5	692	0	701
18965	4	4	677	12	0	697
18966	5	1	14	654	0	674
18967	677	0	3	19	0	699
18968	11	3	683	4	0	701
18969	668	3	13	6	0	690
18970	689	0	4	9	0	702
18971	686	0	8	3	0	697
18972	17	4	664	1	0	686
18973	10	0	671	4	0	685
18974	5	1	15	661	0	682
18975	6	0	8	649	0	663
18976	3	670	5	15	0	693
18977	683	11	3	8	0	705
18978	675	4	3	10	0	692
18979	16	674	3	5	0	698
18980	682	10	1	15	0	708
18981	20	682	2	2	0	706
18982	676	15	2	5	0	698
18983	20	3	5	659	0	687
18984	7	2	667	14	0	690
18985	6	4	661	6	0	677
18986	2	4	16	667	0	689
18987	1	2	7	677	0	687
18988	5	2	663	13	0	683
18989	8	2	13	652	0	675
18990	7	1	3	643	0	654
18991	655	3	11	15	0	684
18992	659	2	2	13	0	676
18993	657	0	4	8	0	669
18994	16	3	633	3	0	655
18995	10	628	15	3	0	656
18996	6	11	6	641	0	664
18997	7	3	647	14	0	671
18998	4	647	17	2	0	670
18999	647	13	4	10	0	674
19000	17	2	7	640	0	666
19001	7	5	5	646	0	663
19002	642	3	1	21	0	667
19003	24	0	1	626	0	651
19004	13	4	2	629	0	648
19005	622	4	4	19	0	649
19006	14	1	607	11	0	633
19007	4	593	15	7	0	619
19008	601	14	6	8	0	629
19009	17	6	609	3	0	635
19010	592	4	15	9	0	620
19011	18	614	5	4	0	641
19012	595	13	5	8	0	621
19013	604	4	5	7	0	620
19014	588	5	3	11	0	607
19015	24	1	0	588	0	613
19016	8	1	5	586	0	600
19017	7	577	6	13	0	603
19018	9	577	3	7	0	596
19019	6	589	4	7	0	606
19020	584	13	5	5	0	607
19021	11	8	567	2	0	588
19022	6	3	10	557	0	576
19023	5	1	3	557	0	566
19024	4	563	4	12	0	583
19025	9	10	3	564	0	586
19026	7	2	1	553	0	563
19027	2	571	4	13	0	590
19028	568	13	1	10	0	592
19029	8	587	1	8	0	604
19030	6	10	586	3	0	605
19031	568	3	9	8	0	588
19032	12	584	6	4	0	606
19033	583	9	4	11	0	607
19034	14	5	1	590	0	610
19035	6	6	1	593	0	606
19036	7	0	591	11	0	609
19037	3	4	572	7	0	586
19038	6	2	7	580	0	595
19039	577	3	5	12	0	597
19040	552	4	3	6	0	565
19041	14	559	0	5	0	578
19042	5	548	2	1	0	556
19043	2	527	1	0	0	530
19044	6	10	8	505	0	529
19045	484	2	4	13	0	503
19046	477	2	0	2	0	481
19047	467	0	0	5	0	472
19048	10	0	434	1	0	445
19049	2	539	9	1	0	551
19050	3	7	0	609	0	619
19051	600	1	2	19	0	622
19052	19	1	0	603	0	623
19053	4	0	1	638	0	643
19054	626	0	0	23	0	649
19055	691	0	0	6	0	697
19056	18	1	683	2	0	704
19057	5	0	18	678	0	701
19058	2	1	653	20	0	676
19059	4	2	22	657	0	685
19060	1	0	645	21	0	667
19061	3	1	20	631	0	655
19062	622	0	3	21	0	646
19063	19	610	2	4	0	635
19064	1	646	3	3	0	653
19065	6	19	1	565	0	591
19066	2	641	2	16	0	661
19067	637	22	0	8	0	667
19068	629	1	1	5	0	636
19069	21	3	613	1	0	638
19070	4	585	19	3	0	611
19071	4	18	3	615	0	640
19072	3	3	608	21	0	635
19073	597	3	21	2	0	623
19074	23	3	2	617	0	645
19075	3	1	611	20	0	635
19076	3	2	20	603	0	628
19077	608	1	2	27	0	638
19078	23	1	595	4	0	623
19079	591	2	20	3	0	616
19080	616	0	3	7	0	626
19081	26	1	5	594	0	626
19082	4	3	598	21	0	626
19083	9	4	596	6	0	615
19084	582	1	21	8	0	612
19085	608	2	3	7	0	620
19086	24	0	581	3	0	608
19087	8	1	22	585	0	616
19088	11	2	4	579	0	596
19089	4	580	7	24	0	615
19090	6	19	6	599	0	630
19091	601	1	4	27	0	633
19092	24	2	5	602	0	633
19093	5	2	601	28	0	636
19094	583	1	22	13	0	619
19095	28	4	2	591	0	625
19096	6	4	594	22	0	626
19097	8	592	24	3	0	627
19098	578	22	3	13	0	616
19099	23	602	8	6	0	639
19100	603	21	4	4	0	632
19101	27	4	590	7	0	628
19102	10	561	24	6	0	601
19103	9	612	4	5	0	630
19104	9	23	6	583	0	621
19105	7	5	4	619	0	635
19106	8	4	595	25	0	632
19107	8	4	23	593	0	628
19108	579	2	7	30	0	618
19109	25	3	576	13	0	617
19110	10	5	25	577	0	617
19111	7	3	571	29	0	610
19112	553	4	29	7	0	593
19113	26	574	6	7	0	613
19114	572	24	4	13	0	613
19115	592	4	11	7	0	614
19116	593	4	7	11	0	615
19117	28	5	557	9	0	599
19118	21	560	21	5	0	607
19119	16	21	8	544	0	589
19120	10	1	12	590	0	613
19121	597	6	6	29	0	638
19122	26	7	6	602	0	641
19123	605	4	9	35	0	653
19124	625	2	10	11	0	648
19125	624	2	5	14	0	645
19126	632	3	8	12	0	655
19127	39	7	8	593	0	647
19128	600	7	3	32	0	642
19129	34	3	570	12	0	619
19130	580	3	30	7	0	620
19131	614	5	7	7	0	633
19132	41	4	567	5	0	617
19133	574	5	34	8	0	621
19134	605	3	10	9	0	627
19135	34	2	7	578	0	621
19136	17	4	11	593	0	625
19137	584	7	6	26	0	623
19138	33	1	5	580	0	619
19139	16	1	7	579	0	603
19140	12	542	5	31	0	590
19141	15	18	7	535	0	575
19142	528	3	10	25	0	566
19143	34	4	4	528	0	570
19144	14	3	4	528	0	549
19145	4	511	6	31	0	552
19146	11	19	7	488	0	525
19147	9	3	7	493	0	512
19148	475	0	4	22	0	501
19149	27	11	1	314	0	353
19150	3	0	261	12	0	276
19151	2	230	8	4	0	244
19152	5	231	1	3	0	240
19153	234	7	1	6	0	248
19154	9	233	2	2	0	246
19155	161	7	2	2	0	172
19156	7	170	1	0	0	178
19157	172	9	0	2	0	183
19158	8	2	0	185	0	195
19159	3	0	0	187	0	190
19160	1	184	0	9	0	194
19161	2	7	1	193	0	203
19162	0	2	196	8	0	206
19163	197	0	9	2	0	208
19164	8	200	0	3	0	211
19165	203	10	0	1	0	214
19166	212	0	1	0	0	213
19167	218	0	0	0	0	218
19168	13	1	0	208	0	222
19169	2	0	0	214	0	216
19170	3	212	0	12	0	227
19171	212	10	2	0	0	224
19172	12	212	0	3	0	227
19173	218	11	0	2	0	231
19174	14	1	214	1	0	230
19175	221	1	10	0	0	232
19176	13	1	0	223	0	237
19177	2	0	225	12	0	239
19178	2	0	233	2	0	237
19179	2	1	12	227	0	242
19180	3	1	225	11	0	240
19181	3	0	12	223	0	238
19182	220	0	3	11	0	234
19183	14	0	0	213	0	227
19184	3	1	215	11	0	230
19185	1	207	8	3	0	219
19186	3	221	0	3	0	227
19187	3	14	0	210	0	227
19188	211	0	1	13	0	225
19189	9	1	1	211	0	222
19190	2	3	0	215	0	220
19191	3	0	0	223	0	226
19192	2	1	2	217	0	222
19193	1	2	215	14	0	232
19194	3	2	220	1	0	226
19195	210	2	11	4	0	227
19196	227	1	1	5	0	234
19197	15	2	2	210	0	229
19198	2	2	2	223	0	229
19199	4	0	216	14	0	234
19200	3	212	13	2	0	230
19201	212	16	0	2	0	230
19202	223	1	0	4	0	228
19203	14	0	2	217	0	233
19204	3	3	212	13	0	231
19205	4	3	12	201	0	220
19206	3	213	0	11	0	227
19207	3	14	211	3	0	231
19208	217	0	14	1	0	232
19209	11	1	1	218	0	231
19210	218	2	0	16	0	236
19211	13	2	213	2	0	230
19212	213	0	14	3	0	230
19213	14	1	1	211	0	227
19214	208	1	4	13	0	226
19215	14	2	2	205	0	223
19216	8	203	0	11	0	222
19217	3	226	1	4	0	234
19218	3	14	2	211	0	230
19219	1	2	217	13	0	233
19220	0	216	12	3	0	231
19221	2	10	3	183	0	198
19222	179	1	1	9	0	190
19223	183	2	0	3	0	188
19224	10	0	1	183	0	194
19225	2	0	1	182	0	185
19226	1	163	1	10	0	175
19227	1	179	2	3	0	185
19228	169	8	3	3	0	183
19229	11	0	2	166	0	179
19230	4	0	1	174	0	179
19231	0	1	161	10	0	172
19232	2	1	8	160	0	171
19233	5	0	1	161	0	167
19234	2	1	2	168	0	173
19235	1	1	161	10	0	173
19236	3	2	8	157	0	170
19237	158	4	0	8	0	170
19238	9	0	153	4	0	166
19239	168	0	8	3	0	179
19240	7	2	1	172	0	182
19241	0	1	2	185	0	188
19242	4	1	0	189	0	194
19243	3	1	176	9	0	189
19244	175	0	9	4	0	188
19245	8	180	4	2	0	194
19246	174	7	2	1	0	184
19247	10	202	0	2	0	214
19248	3	7	2	203	0	215
19249	202	0	0	10	0	212
19250	7	1	198	3	0	209
19251	199	3	6	2	0	210
19252	10	1	200	3	0	214
19253	1	6	7	187	0	201
19254	0	2	183	7	0	192
19255	1	183	7	1	0	192
19256	1	5	3	175	0	184
19257	166	1	0	12	0	179
19258	4	0	1	155	0	160
19259	1	163	0	4	0	168
19260	0	4	0	167	0	171
19261	159	0	0	4	0	163
19262	152	0	1	0	0	153
19263	4	143	0	0	0	147
19264	0	148	0	1	0	149
19265	2	2	0	141	0	145
19266	0	0	0	143	0	143
19267	140	1	0	2	0	143
19268	137	1	0	0	0	138
19269	3	134	0	1	0	138
19270	1	2	1	130	0	134
19271	0	2	1	133	0	136
19272	0	0	130	5	0	135
19273	1	130	2	1	0	134
19274	2	127	0	0	0	129
19275	0	4	0	118	0	122
19276	0	1	111	3	0	115
19277	0	0	110	2	0	112
19278	1	0	5	108	0	114
19279	0	1	0	112	0	113
19280	0	0	122	4	0	126
19281	0	0	3	124	0	127
19282	1	1	125	3	0	130
19283	132	1	4	1	0	138
19284	4	0	1	127	0	132
19285	1	0	128	4	0	133
19286	0	0	129	0	0	129
19287	2	0	3	134	0	139
19288	1	0	159	4	0	164
19289	2	0	159	1	0	162
19290	0	157	4	2	0	163
19291	166	3	2	1	0	172
19292	2	1	178	1	0	182
19293	1	0	2	181	0	184
19294	0	0	4	184	0	188
19295	3	1	2	191	0	197
19296	0	2	190	4	0	196
19297	1	1	11	177	0	190
19298	178	9	4	4	0	195
19299	11	0	2	182	0	195
19300	2	0	189	5	0	196
19301	0	0	2	192	0	194
19302	178	0	4	13	0	195
19303	183	0	1	15	0	199
19304	186	0	11	2	0	199
19305	7	0	0	194	0	201
19306	196	1	1	6	0	204
19307	184	0	2	14	0	200
19308	189	0	11	4	0	204
19309	6	184	2	11	0	203
19310	194	2	1	2	0	199
19311	14	3	1	187	0	205
19312	13	2	183	5	0	203
19313	2	184	6	11	0	203
19314	197	3	3	2	0	205
19315	14	2	0	189	0	205
19316	11	1	3	180	0	195
19317	1	182	2	7	0	192
19318	10	180	2	5	0	197
19319	167	3	1	11	0	182
19320	5	166	11	1	0	183
19321	168	11	1	5	0	185
19322	12	169	1	4	0	186
19323	162	2	0	15	0	179
19324	4	168	2	10	0	184
19325	4	180	1	2	0	187
19326	173	13	0	2	0	188
19327	14	2	164	3	0	183
19328	3	180	4	1	0	188
19329	12	4	1	169	0	186
19330	4	12	0	174	0	190
19331	12	4	0	169	0	185
19332	5	10	0	174	0	189
19333	1	12	178	4	0	195
19334	189	2	4	4	0	199
19335	5	3	11	190	0	209
19336	205	10	2	5	0	222
19337	202	3	0	14	0	219
19338	204	2	1	11	0	218
19339	191	1	1	14	0	207
19340	5	2	187	10	0	204
19341	4	5	11	182	0	202
19342	13	2	181	5	0	201
19343	3	183	5	13	0	204
19344	13	5	2	170	0	190
19345	13	3	1	187	0	204
19346	10	5	3	186	0	204
19347	12	1	3	172	0	188
19348	3	5	177	6	0	191
19349	3	2	5	177	0	187
19350	4	3	12	170	0	189
19351	167	9	3	12	0	191
19352	170	4	0	17	0	191
19353	6	1	2	185	0	194
19354	5	0	3	188	0	196
19355	4	0	3	187	0	194
19356	174	2	10	10	0	196
19357	178	0	1	19	0	198
19358	172	0	3	14	0	189
19359	182	2	0	8	0	192
19360	19	169	0	7	0	195
19361	175	2	3	14	0	194
19362	177	1	3	14	0	195
19363	9	0	0	185	0	194
19364	22	1	3	172	0	198
19365	181	2	0	7	0	190
19366	15	161	1	5	0	182
19367	14	178	0	4	0	196
19368	186	13	1	7	0	207
19369	16	2	1	187	0	206
19370	14	2	1	186	0	203
19371	6	4	0	199	0	209
19372	9	2	1	187	0	199
19373	17	2	0	185	0	204
19374	4	191	1	10	0	206
19375	5	14	0	184	0	203
19376	192	5	0	8	0	205
19377	7	1	1	197	0	206
19378	7	2	0	196	0	205
19379	182	3	0	16	0	201
19380	5	173	0	15	0	193
19381	10	3	0	170	0	183
19382	3	174	0	7	0	184
19383	4	6	1	173	0	184
19384	13	2	159	5	0	179
19385	144	4	1	10	0	159
19386	4	154	1	15	0	174
19387	150	3	1	2	0	156
19388	2	1	148	5	0	156
19389	3	9	2	137	0	151
19390	3	144	1	2	0	150
19391	1	139	1	4	0	145
19392	135	0	0	5	0	140
19393	1	1	2	131	0	135
19394	1	0	140	4	0	145
19395	3	3	0	144	0	150
19396	0	3	137	3	0	143
19397	135	0	2	1	0	138
19398	2	1	144	4	0	151
19399	1	0	2	148	0	151
19400	3	161	1	3	0	168
19401	1	3	2	163	0	169
19402	4	160	0	1	0	165
19403	170	2	3	1	0	176
19404	1	0	1	182	0	184
19405	0	2	174	3	0	179
19406	2	1	163	2	0	168
19407	169	4	1	2	0	176
19408	181	1	1	1	0	184
19409	173	0	2	6	0	181
19410	174	0	3	2	0	179
19411	2	173	3	2	0	180
19412	179	1	1	2	0	183
19413	181	0	1	2	0	184
19414	3	1	172	2	0	178
19415	5	2	1	169	0	177
19416	175	3	0	4	0	182
19417	4	1	171	1	0	177
19418	4	1	1	175	0	181
19419	2	0	183	3	0	188
19420	1	0	3	183	0	187
19421	2	187	2	1	0	192
19422	184	1	4	3	0	192
19423	3	1	175	3	0	182
19424	167	1	3	2	0	173
19425	4	0	1	176	0	181
19426	181	2	1	2	0	186
19427	6	2	0	178	0	186
19428	206	0	2	3	0	211
19429	5	0	197	0	0	202
19430	203	0	2	8	0	213
19431	6	1	0	220	0	227
19432	2	0	2	217	0	221
19433	208	0	1	2	0	211
19434	4	0	3	203	0	210
19435	2	0	204	2	0	208
19436	1	1	1	191	0	194
19437	183	1	1	5	0	190
19438	5	183	1	0	0	189
19439	1	185	2	2	0	190
19440	184	1	1	3	0	189
19441	2	207	1	3	0	213
19442	2	1	0	203	0	206
19443	201	1	0	2	0	204
19444	204	0	1	0	0	205
19445	202	0	1	1	0	204
19446	2	0	205	1	0	208
19447	0	0	2	202	0	204
19448	2	209	1	1	0	213
19449	2	1	0	206	0	209
19450	1	0	208	2	0	211
19451	1	211	2	2	0	216
19452	0	1	0	208	0	209
19453	209	0	0	2	0	211
19454	1	212	0	0	0	213
19455	0	1	220	0	0	221
19456	0	0	1	221	0	222
19457	0	0	226	1	0	227
19458	0	0	1	222	0	223
19459	233	0	1	3	0	237
19460	1	0	0	231	0	232
19461	240	0	0	3	0	243
19462	245	0	0	0	0	245
19463	1	247	0	0	0	248
19464	248	1	0	1	0	250
19465	1	244	0	1	0	246
19466	1	1	245	0	0	247
19467	2	1	1	231	0	235
19468	3	1	0	272	0	276
19469	2	1	267	1	0	271
19470	0	270	2	2	0	274
19471	269	1	0	3	0	273
19472	274	0	0	4	0	278
19473	2	0	0	285	0	287
19474	2	0	1	269	0	272
19475	0	0	1	282	0	283
19476	281	0	0	2	0	283
19477	1	1	272	0	0	274
19478	0	0	286	1	0	287
19479	1	0	2	294	0	297
19480	0	1	296	1	0	298
19481	0	0	287	1	0	288
19482	2	0	2	285	0	289
19483	0	1	297	1	0	299
19484	0	296	2	0	0	298
19485	0	1	0	309	0	310
19486	0	0	320	1	0	321
19487	0	0	1	316	0	317
19488	1	301	1	1	0	304
19489	1	1	0	315	0	317
19490	1	1	310	1	0	313
19491	2	0	1	292	0	295
19492	309	1	0	3	0	313
19493	2	0	301	0	0	303
19494	282	1	1	0	0	284
19495	1	293	1	0	0	295
19496	293	1	0	1	0	295
19497	0	0	0	300	0	300
19498	0	296	1	0	0	297
19499	304	1	0	2	0	307
19500	1	1	0	307	0	309
19501	2	0	305	0	0	307
19502	0	309	0	2	0	311
19503	1	0	1	302	0	304
19504	296	1	0	2	0	299
19505	294	0	0	2	0	296
19506	3	0	0	297	0	300
19507	1	1	292	0	0	294
19508	272	0	0	4	0	276
19509	0	1	298	0	0	299
19510	1	1	1	294	0	297
19511	297	0	1	3	0	301
19512	0	290	2	1	0	293
19513	297	1	1	2	0	301
19514	0	1	295	1	0	297
19515	293	0	1	2	0	296
19516	2	0	1	307	0	310
19517	2	1	0	309	0	312
19518	0	0	309	3	0	312
19519	0	0	2	302	0	304
19520	308	0	1	2	0	311
19521	2	0	1	312	0	315
19522	1	309	1	1	0	312
19523	2	0	0	308	0	310
19524	1	315	0	1	0	317
19525	1	1	311	1	0	314
19526	285	2	1	4	0	292
19527	1	1	1	313	0	316
19528	2	0	301	2	0	305
19529	0	306	1	5	0	312
19530	1	1	3	303	0	308
19531	1	3	1	304	0	309
19532	305	1	1	4	0	311
19533	5	0	1	311	0	317
19534	308	1	1	5	0	315
19535	300	0	1	7	0	308
19536	5	309	0	0	0	314
19537	305	1	2	3	0	311
19538	4	2	1	328	0	335
19539	3	0	323	4	0	330
19540	318	2	3	4	0	327
19541	3	2	2	305	0	312
19542	3	0	305	3	0	311
19543	279	0	5	4	0	288
19544	4	0	2	298	0	304
19545	3	313	1	5	0	322
19546	2	2	2	309	0	315
19547	0	315	1	3	0	319
19548	299	2	1	5	0	307
19549	3	4	308	2	0	317
19550	2	308	2	3	0	315
19551	1	3	3	305	0	312
19552	2	2	301	3	0	308
19553	1	2	283	3	0	289
19554	2	285	7	0	0	294
19555	5	2	3	284	0	294
19556	3	2	2	281	0	288
19557	2	3	3	356	0	364
19558	367	2	0	14	0	383
19559	10	1	401	6	0	418
19560	5	408	10	3	0	426
19561	4	12	3	392	0	411
19562	3	3	1	424	0	431
19563	2	2	405	19	0	428
19564	1	2	17	402	0	422
19565	2	4	407	19	0	432
19566	2	1	412	4	0	419
19567	0	0	420	4	0	424
19568	4	0	17	359	0	380
19569	3	0	4	394	0	401
19570	6	2	3	402	0	413
19571	389	1	2	21	0	413
19572	18	385	2	5	0	410
19573	396	16	1	5	0	418
19574	387	3	1	6	0	397
19575	404	3	2	5	0	414
19576	20	403	1	3	0	427
19577	401	15	4	1	0	421
19578	412	3	2	1	0	418
19579	18	3	2	391	0	414
19580	6	2	2	404	0	414
19581	2	1	2	410	0	415
19582	2	1	392	23	0	418
19583	381	2	15	6	0	404
19584	19	1	4	390	0	414
19585	386	2	2	20	0	410
19586	19	375	1	6	0	401
19587	8	17	3	374	0	402
19588	6	5	1	400	0	412
19589	377	2	0	22	0	401
19590	21	2	3	383	0	409
19591	353	2	2	22	0	379
19592	387	0	1	9	0	397
19593	19	369	0	6	0	394
19594	4	389	4	5	0	402
19595	5	20	4	360	0	389
19596	5	374	2	15	0	396
19597	2	19	2	384	0	407
19598	2	5	377	20	0	404
19599	3	1	376	7	0	387
19600	350	0	14	6	0	370
19601	368	0	4	3	0	375
19602	19	360	3	1	0	383
19603	351	18	1	3	0	373
19604	20	376	0	2	0	398
19605	3	18	0	380	0	401
19606	3	4	1	391	0	399
19607	2	3	1	394	0	400
19608	2	1	2	395	0	400
19609	380	2	0	19	0	401
19610	15	383	1	6	0	405
19611	377	16	3	6	0	402
19612	396	1	1	5	0	403
19613	19	0	381	1	0	401
19614	362	1	16	1	0	380
19615	19	371	2	1	0	393
19616	5	14	2	374	0	395
19617	4	4	2	368	0	378
19618	2	368	0	20	0	390
19619	372	17	1	6	0	396
19620	17	2	369	4	0	392
19621	356	0	16	3	0	375
19622	19	2	360	2	0	383
19623	4	1	18	366	0	389
19624	3	3	4	384	0	394
19625	5	1	4	393	0	403
19626	380	1	3	24	0	408
19627	18	2	395	7	0	422
19628	395	1	14	8	0	418
19629	420	3	2	6	0	431
19630	400	2	5	3	0	410
19631	403	1	1	2	0	407
19632	24	0	1	381	0	406
19633	3	2	378	19	0	402
19634	7	3	17	368	0	395
19635	5	1	367	19	0	392
19636	1	1	369	5	0	376
19637	4	366	11	6	0	387
19638	2	14	1	336	0	353
19639	4	1	2	360	0	367
19640	3	3	2	325	0	333
19641	7	1	0	353	0	361
19642	347	0	0	18	0	365
19643	362	2	0	3	0	367
19644	16	0	2	342	0	360
19645	3	0	325	19	0	347
19646	4	1	17	325	0	347
19647	3	1	1	344	0	349
19648	1	2	331	18	0	352
19649	3	1	14	321	0	339
19650	327	4	0	17	0	348
19651	338	2	2	4	0	346
19652	339	1	1	5	0	346
19653	20	2	2	319	0	343
19654	327	1	0	19	0	347
19655	332	0	2	2	0	336
19656	18	1	321	2	0	342
19657	2	1	243	1	0	247
19658	1	1	236	0	0	238
19659	182	0	5	0	0	187
19660	5	189	0	0	0	194
19661	189	1	0	1	0	191
19662	2	206	0	1	0	209
19663	0	3	0	209	0	212
19664	1	0	0	210	0	211
19665	1	0	0	210	0	211
19666	0	0	208	3	0	211
19667	189	0	2	0	0	191
19668	3	0	0	203	0	206
19669	0	0	194	3	0	197
19670	0	1	192	0	0	193
19671	183	0	4	0	0	187
19672	4	189	0	5	0	198
19673	192	4	0	1	0	197
19674	202	0	0	0	0	202
19675	4	198	0	0	0	202
19676	192	4	0	0	0	196
19677	4	0	196	0	0	200
19678	0	0	191	0	0	191
19679	0	0	202	0	0	202
19680	1	0	3	194	0	198
19681	0	0	201	3	0	204
19682	180	0	3	1	0	184
19683	193	0	0	0	0	193
19684	3	0	195	0	0	198
19685	0	0	3	187	0	190
19686	195	0	0	5	0	200
19687	3	209	0	0	0	212
19688	0	204	0	0	0	204
19689	205	3	0	0	0	208
19690	3	0	208	0	0	211
19691	1	0	3	201	0	205
19692	2	0	0	204	0	206
19693	0	0	0	202	0	202
19694	0	201	0	3	0	204
19695	2	3	0	182	0	187
19696	212	0	0	4	0	216
19697	3	0	0	216	0	219
19698	1	215	0	4	0	220
19699	223	3	0	1	0	227
19700	4	1	0	223	0	228
19701	1	0	0	234	0	235
19702	239	0	0	5	0	244
19703	242	0	0	3	0	245
19704	6	0	1	254	0	261
19705	257	0	0	6	0	263
19706	260	0	0	1	0	261
19707	5	258	0	0	0	263
19708	254	6	0	0	0	260
19709	6	250	1	0	0	257
19710	3	6	0	256	0	265
19711	0	1	264	5	0	270
19712	1	0	6	260	0	267
19713	2	0	1	263	0	266
19714	0	0	0	289	0	289
19715	278	0	0	7	0	285
19716	6	277	0	2	0	285
19717	282	6	0	0	0	288
19718	6	299	0	2	0	307
19719	304	6	0	2	0	312
19720	301	2	0	3	0	306
19721	309	0	0	1	0	310
19722	303	0	0	0	0	303
19723	8	1	300	0	0	309
19724	2	0	6	297	0	305
19725	2	0	3	304	0	309
19726	0	0	296	8	0	304
19727	275	0	6	3	0	284
19728	6	0	2	271	0	279
19729	3	0	268	7	0	278
19730	0	2	263	2	0	267
19731	1	0	9	269	0	279
19732	0	1	283	7	0	291
19733	1	0	7	281	0	289
19734	2	0	2	287	0	291
19735	1	0	284	9	0	294
19736	268	0	7	2	0	277
19737	8	0	3	281	0	292
19738	2	0	283	8	0	293
19739	4	0	7	283	0	294
19740	285	0	3	10	0	298
19741	9	1	283	3	0	296
19742	281	1	7	3	0	292
19743	291	1	3	4	0	299
19744	11	0	1	287	0	299
19745	4	1	0	291	0	296
19746	2	0	293	9	0	304
19747	2	0	8	281	0	291
19748	6	1	2	282	0	291
19749	2	0	1	306	0	309
19750	1	0	295	9	0	305
19751	282	0	7	7	0	296
19752	308	0	3	4	0	315
19753	323	0	2	1	0	326
19754	326	1	1	0	0	328
19755	9	1	1	318	0	329
19756	320	0	2	7	0	329
19757	317	1	1	4	0	323
19758	270	1	0	6	0	277
19759	321	0	3	3	0	327
19760	11	320	2	3	0	336
19761	319	10	0	5	0	334
19762	309	3	3	4	0	319
19763	12	307	0	4	0	323
19764	310	10	1	4	0	325
19765	12	2	2	305	0	321
19766	6	2	1	311	0	320
19767	302	2	0	14	0	318
19768	13	289	1	4	0	307
19769	4	308	0	3	0	315
19770	6	11	1	313	0	331
19771	2	3	318	9	0	332
19772	2	2	8	312	0	324
19773	5	0	3	323	0	331
19774	310	1	5	11	0	327
19775	320	0	0	9	0	329
19776	11	0	0	314	0	325
19777	4	2	316	8	0	330
19778	5	0	9	312	0	326
19779	325	0	2	15	0	342
19780	10	0	345	3	0	358
19781	5	346	11	2	0	364
19782	352	10	2	4	0	368
19783	13	3	4	347	0	367
19784	5	2	1	347	0	355
19785	3	1	1	360	0	365
19786	3	1	342	14	0	360
19787	311	2	8	7	0	328
19788	12	1	329	5	0	347
19789	5	327	11	3	0	346
19790	2	9	4	332	0	347
19791	8	1	2	334	0	345
19792	3	2	3	347	0	355
19793	3	1	338	15	0	357
19794	2	0	342	5	0	349
19795	0	2	342	6	0	350
19796	1	336	10	6	0	353
19797	1	8	3	333	0	345
19798	338	1	5	11	0	355
19799	355	2	1	6	0	364
19800	12	1	360	6	0	379
19801	7	369	13	2	0	391
19802	6	8	360	2	0	376
19803	3	364	11	1	0	379
19804	336	9	9	0	0	354
19805	339	5	1	1	0	346
19806	11	339	2	2	0	354
19807	345	10	1	3	0	359
19808	11	4	1	348	0	364
19809	7	1	0	350	0	358
19810	344	1	1	13	0	359
19811	344	1	1	5	0	351
19812	342	1	2	4	0	349
19813	12	336	2	1	0	351
19814	6	358	0	3	0	367
19815	360	10	0	4	0	374
19816	9	4	358	1	0	372
19817	6	7	9	347	0	369
19818	345	2	4	9	0	360
19819	9	332	2	4	0	347
19820	4	356	2	1	0	363
19821	351	11	0	2	0	364
19822	12	3	341	0	0	356
19823	318	5	8	1	0	332
19824	12	3	334	0	0	349
19825	5	1	326	1	0	333
19826	2	4	12	320	0	338
19827	3	0	352	10	0	365
19828	332	4	9	5	0	350
19829	363	2	3	1	0	369
19830	368	2	3	3	0	376
19831	363	4	2	1	0	370
19832	15	0	2	345	0	362
19833	354	0	2	10	0	366
19834	10	336	2	5	0	353
19835	8	7	1	337	0	353
19836	4	355	1	10	0	370
19837	369	8	2	2	0	381
19838	374	4	0	1	0	379
19839	12	4	1	364	0	381
19840	374	2	0	11	0	387
19841	378	0	4	4	0	386
19842	11	0	1	368	0	380
19843	11	0	0	364	0	375
19844	3	5	1	369	0	378
19845	2	3	353	13	0	371
19846	4	3	333	4	0	344
19847	5	0	352	2	0	359
19848	6	1	10	342	0	359
19849	1	1	347	10	0	359
19850	7	0	12	342	0	361
19851	2	3	363	11	0	379
19852	2	1	341	5	0	349
19853	329	1	11	6	0	347
19854	11	345	4	6	0	366
19855	359	7	5	1	0	372
19856	14	2	4	341	0	361
19857	7	2	2	354	0	365
19858	4	3	347	8	0	362
19859	2	345	5	4	0	356
19860	3	5	3	352	0	363
19861	1	5	350	6	0	362
19862	4	333	7	5	0	349
19863	9	4	4	339	0	356
19864	336	8	2	8	0	354
19865	341	4	0	4	0	349
19866	14	1	2	339	0	356
19867	337	2	2	12	0	353
19868	9	336	4	5	0	354
19869	6	5	3	347	0	361
19870	3	3	343	6	0	355
19871	4	5	8	333	0	350
19872	2	4	348	5	0	359
19873	339	0	3	9	0	351
19874	9	4	6	342	0	361
19875	9	349	0	9	0	367
19876	5	10	4	360	0	379
19877	2	4	359	9	0	374
19878	6	2	337	4	0	349
19879	5	4	331	1	0	341
19880	296	1	15	3	0	315
19881	5	315	2	5	0	327
19882	7	3	2	310	0	322
19883	309	3	5	6	0	323
19884	4	310	2	5	0	321
19885	341	5	2	5	0	353
19886	352	2	4	2	0	360
19887	360	4	2	5	0	371
19888	366	1	3	6	0	376
19889	12	0	357	3	0	372
19890	354	1	6	4	0	365
19891	7	1	359	3	0	370
19892	331	1	5	2	0	339
19893	6	2	3	359	0	370
19894	5	1	355	6	0	367
19895	2	345	6	4	0	357
19896	3	12	5	341	0	361
19897	2	342	3	2	0	349
19898	7	346	0	3	0	356
19899	326	3	1	3	0	333
19900	4	1	316	1	0	322
19901	0	312	2	1	0	315
19902	305	1	0	2	0	308
19903	1	321	0	0	0	322
19904	310	1	0	1	0	312
19905	1	0	0	316	0	317
19906	318	0	0	2	0	320
19907	3	0	0	312	0	315
19908	307	0	1	5	0	313
19909	1	0	0	308	0	309
19910	0	331	0	1	0	332
19911	0	1	0	343	0	344
19912	336	0	0	2	0	338
19913	1	328	0	0	0	329
19914	1	1	0	314	0	316
19915	312	0	0	4	0	316
19916	1	0	0	325	0	326
19917	0	0	0	317	0	317
19918	1	0	333	1	0	335
19919	0	0	318	1	0	319
19920	1	0	1	323	0	325
19921	0	0	339	1	0	340
19922	0	0	1	339	0	340
19923	1	0	0	299	0	300
19924	1	0	0	339	0	340
19925	0	0	341	1	0	342
19926	0	0	1	325	0	326
19927	1	1	0	318	0	320
19928	0	332	1	1	0	334
19929	0	1	0	338	0	339
19930	339	0	0	2	0	341
19931	1	0	0	355	0	356
19932	1	0	387	1	0	389
19933	364	0	2	3	0	369
19934	2	414	3	0	0	419
19935	4	2	0	419	0	425
19936	0	3	414	3	0	420
19937	392	0	4	6	0	402
19938	5	418	3	1	0	427
19939	420	5	0	1	0	426
19940	5	3	0	414	0	422
19941	408	0	1	4	0	413
19942	5	0	416	3	0	424
19943	4	410	4	1	0	419
19944	1	462	2	0	0	465
19945	465	7	0	3	0	475
19946	463	3	0	7	0	473
19947	7	0	462	0	0	469
19948	450	1	4	1	0	456
19949	457	1	3	2	0	463
19950	466	0	0	2	0	468
19951	8	439	0	1	0	448
19952	4	454	1	0	0	459
19953	454	5	0	4	0	463
19954	463	3	0	0	0	466
19955	8	470	0	2	0	480
19956	2	5	0	478	0	485
19957	0	4	476	6	0	486
19958	480	0	4	3	0	487
19959	476	2	3	3	0	484
19960	503	1	0	3	0	507
19961	7	503	1	1	0	512
19962	4	4	517	1	0	526
19963	520	3	5	1	0	529
19964	6	0	4	527	0	537
19965	5	1	0	524	0	530
19966	1	1	1	538	0	541
19967	1	1	535	7	0	544
19968	4	0	5	527	0	536
19969	0	1	529	8	0	538
19970	0	532	5	6	0	543
19971	517	4	5	4	0	530
19972	5	519	1	1	0	526
19973	4	530	1	2	0	537
19974	520	9	2	3	0	534
19975	6	535	0	1	0	542
19976	7	6	0	517	0	530
19977	0	522	0	7	0	529
19978	518	6	2	5	0	531
19979	8	519	1	2	0	530
19980	4	7	0	527	0	538
19981	1	4	525	8	0	538
19982	3	1	9	534	0	547
19983	4	523	3	7	0	537
19984	1	8	1	553	0	563
19985	2	4	2	532	0	540
19986	2	2	1	509	0	514
19987	3	2	1	521	0	527
19988	5	1	0	528	0	534
19989	3	0	2	528	0	533
19990	1	3	531	13	0	548
19991	519	0	6	6	0	531
19992	8	1	5	577	0	591
19993	6	3	571	10	0	590
19994	5	1	572	7	0	585
19995	4	2	15	579	0	600
19996	583	0	9	12	0	604
19997	9	2	574	10	0	595
19998	569	1	13	5	0	588
19999	11	1	611	5	0	628
20000	12	0	12	597	0	621
20001	6	2	11	626	0	645
20002	5	0	619	17	0	641
20003	588	1	11	13	0	613
20004	11	1	13	609	0	634
20005	10	1	598	16	0	625
20006	2	0	624	14	0	640
20007	8	0	18	604	0	630
20008	4	613	12	13	0	642
20009	618	8	6	14	0	646
20010	609	9	6	9	0	633
20011	20	2	616	4	0	642
20012	13	5	13	591	0	622
20013	612	2	10	15	0	639
20014	15	4	612	10	0	641
20015	607	2	12	7	0	628
20016	14	601	13	4	0	632
20017	15	10	6	614	0	645
20018	9	9	5	614	0	637
20019	620	3	5	25	0	653
20020	15	4	2	623	0	644
20021	12	6	1	616	0	635
20022	8	2	1	629	0	640
20023	609	1	4	26	0	640
20024	14	1	598	19	0	632
20025	594	2	12	11	0	619
20026	596	0	11	13	0	620
20027	626	0	5	14	0	645
20028	27	4	3	600	0	634
20029	12	2	614	15	0	643
20030	8	582	11	14	0	615
20031	10	576	12	6	0	604
20032	5	584	7	4	0	600
20033	8	15	593	5	0	621
20034	2	11	12	668	0	693
20035	683	4	14	18	0	719
20036	729	4	6	15	0	754
20037	26	4	4	743	0	777
20038	18	2	734	20	0	774
20039	8	3	737	16	0	764
20040	11	0	27	739	0	777
20041	5	0	760	22	0	787
20042	5	0	21	768	0	794
20043	4	3	13	745	0	765
20044	5	731	12	24	0	772
20045	8	16	8	728	0	760
20046	3	10	5	759	0	777
20047	738	2	8	31	0	779
20048	19	2	4	754	0	779
20049	16	3	2	761	0	782
20050	736	4	5	35	0	780
20051	21	742	5	19	0	787
20052	750	20	1	15	0	786
20053	23	12	738	7	0	780
20054	735	2	20	13	0	770
20055	742	1	10	17	0	770
20056	32	2	721	6	0	761
20057	21	3	717	4	0	745
20058	11	3	31	705	0	750
20059	708	2	22	23	0	755
20060	25	2	692	23	0	742
20061	24	1	23	689	0	737
20062	7	2	689	19	0	717
20063	8	1	24	683	0	716
20064	14	2	12	697	0	725
20065	672	1	13	32	0	718
20066	670	1	8	24	0	703
20067	697	4	4	14	0	719
20068	34	4	676	10	0	724
20069	21	2	689	11	0	723
20070	16	2	29	682	0	729
20071	12	3	19	695	0	729
20072	16	3	7	710	0	736
20073	684	5	6	29	0	724
20074	21	684	16	16	0	737
20075	672	14	12	14	0	712
20076	674	10	4	15	0	703
20077	32	651	10	9	0	702
20078	24	677	10	8	0	719
20079	677	30	5	11	0	723
20080	22	16	9	651	0	698
20081	24	657	5	29	0	715
20082	23	15	6	660	0	704
20083	13	16	652	30	0	711
20084	13	6	25	669	0	713
20085	648	0	25	36	0	709
20086	24	3	655	25	0	707
20087	14	7	668	21	0	710
20088	17	13	34	612	0	676
20089	8	611	23	37	0	679
20090	9	629	9	28	0	675
20091	14	637	6	22	0	679
20092	605	21	10	21	0	657
20093	620	8	1	23	0	652
20094	596	4	5	18	0	623
20095	31	588	4	16	0	639
20096	605	16	5	20	0	646
20097	608	14	7	14	0	643
20098	36	7	590	8	0	641
20099	20	556	21	16	0	613
20100	17	17	20	565	0	619
20101	565	9	12	20	0	606
20102	31	1	559	21	0	612
20103	17	6	28	537	0	588
20104	10	553	21	28	0	612
20105	20	12	12	559	0	603
20106	18	11	11	547	0	587
20107	547	7	11	39	0	604
20108	545	4	16	27	0	592
20109	31	2	11	556	0	600
20110	19	7	537	29	0	592
20111	22	2	540	20	0	584
20112	543	3	28	15	0	589
20113	32	9	561	9	0	611
20114	31	6	21	526	0	584
20115	12	544	23	22	0	601
20116	544	17	17	20	0	598
20117	27	546	8	18	0	599
20118	552	18	6	21	0	597
20119	28	7	14	548	0	597
20120	19	8	6	563	0	596
20121	556	10	4	28	0	598
20122	579	9	5	15	0	608
20123	28	9	3	563	0	603
20124	24	14	9	563	0	610
20125	21	8	545	28	0	602
20126	18	4	541	21	0	584
20127	518	11	27	18	0	574
20128	20	8	520	18	0	566
20129	510	7	20	18	0	555
20130	517	5	13	17	0	552
20131	31	4	500	12	0	547
20132	18	457	25	13	0	513
20133	11	477	19	8	0	515
20134	8	13	349	3	0	373
20135	12	28	19	288	0	347
20136	284	4	6	9	0	303
20137	286	1	1	8	0	296
20138	312	2	1	3	0	318
20139	353	0	2	6	0	361
20140	351	2	2	5	0	360
20141	12	369	2	5	0	388
20142	347	9	3	2	0	361
20143	11	348	5	1	0	365
20144	354	10	0	0	0	364
20145	14	2	354	0	0	370
20146	8	1	7	345	0	361
20147	2	1	4	333	0	340
20148	2	339	1	10	0	352
20149	343	10	0	1	0	354
20150	341	4	2	2	0	349
20151	13	0	1	328	0	342
20152	3	2	1	332	0	338
20153	324	1	0	15	0	340
20154	11	2	1	332	0	346
20155	6	1	0	333	0	340
20156	333	0	0	13	0	346
20157	10	1	0	335	0	346
20158	334	0	0	10	0	344
20159	342	0	0	5	0	347
20160	12	0	329	4	0	345
20161	330	1	7	6	0	344
20162	342	0	3	4	0	349
20163	338	2	1	4	0	345
20164	14	0	315	2	0	331
20165	8	0	12	315	0	335
20166	7	0	3	334	0	344
20167	5	0	323	13	0	341
20168	320	1	10	2	0	333
20169	15	1	3	318	0	337
20170	7	1	313	11	0	332
20171	3	2	323	5	0	333
20172	3	0	10	322	0	335
20173	3	0	329	12	0	344
20174	4	0	9	331	0	344
20175	4	0	6	329	0	339
20176	4	0	324	13	0	341
20177	3	0	9	314	0	326
20178	3	308	4	11	0	326
20179	3	334	4	4	0	345
20180	327	11	2	7	0	347
20181	329	4	1	5	0	339
20182	12	327	3	3	0	345
20183	327	10	2	3	0	342
20184	332	4	1	7	0	344
20185	14	3	1	326	0	344
20186	11	1	1	327	0	340
20187	310	1	1	13	0	325
20188	15	314	2	3	0	334
20189	7	308	2	3	0	320
20190	6	11	2	307	0	326
20191	3	3	306	9	0	321
20192	282	1	9	9	0	301
20193	301	2	4	2	0	309
20194	295	4	2	5	0	306
20195	13	281	2	5	0	301
20196	10	10	2	288	0	310
20197	3	5	3	298	0	309
20198	289	2	2	13	0	306
20199	16	291	0	4	0	311
20200	8	11	2	284	0	305
20201	6	3	2	300	0	311
20202	5	3	0	305	0	313
20203	291	2	0	16	0	309
20204	15	283	2	9	0	309
20205	11	11	0	278	0	300
20206	2	293	2	14	0	311
20207	289	11	0	7	0	307
20208	17	4	284	2	0	307
20209	271	3	9	4	0	287
20210	13	2	273	7	0	295
20211	5	9	6	262	0	282
20212	271	4	2	10	0	287
20213	14	5	255	3	0	277
20214	254	0	7	3	0	264
20215	254	2	5	8	0	269
20216	253	0	3	8	0	264
20217	13	0	3	249	0	265
20218	11	2	1	254	0	268
20219	6	2	6	255	0	269
20220	250	0	1	16	0	267
20221	12	249	1	8	0	270
20222	248	6	3	4	0	261
20223	259	3	3	3	0	268
20224	13	2	244	6	0	265
20225	249	2	10	3	0	264
20226	258	1	5	4	0	268
20227	14	1	2	258	0	275
20228	7	2	4	262	0	275
20229	10	2	2	263	0	277
20230	262	1	4	11	0	278
20231	266	0	2	7	0	275
20232	254	0	2	7	0	263
20233	9	234	2	5	0	250
20234	3	225	1	4	0	233
20235	5	236	2	2	0	245
20236	229	7	1	6	0	243
20237	9	3	212	4	0	228
20238	5	0	189	3	0	197
20239	122	0	2	1	0	125
20240	4	0	136	1	0	141
20241	1	0	1	101	0	103
20242	1	99	1	1	0	102
20243	98	0	6	1	0	105
20244	96	0	0	1	0	97
20245	97	0	0	1	0	98
20246	1	0	0	121	0	122
20247	1	0	130	0	0	131
20248	0	0	123	0	0	123
20249	128	0	0	1	0	129
20250	134	1	0	0	0	135
20251	130	1	0	0	0	131
20252	0	1	0	133	0	134
20253	1	0	0	132	0	133
20254	0	0	134	0	0	134
20255	133	0	1	0	0	134
20256	3	0	0	136	0	139
20257	1	0	1	139	0	141
20258	1	0	0	140	0	141
20259	0	143	0	0	0	143
20260	1	0	0	143	0	144
20261	1	0	0	140	0	141
20262	143	0	0	1	0	144
20263	0	0	139	1	0	140
20264	139	0	1	1	0	141
20265	142	0	1	1	0	144
20266	1	0	0	142	0	143
20267	2	0	0	141	0	143
20268	141	0	0	1	0	142
20269	0	0	136	1	0	137
20270	0	141	0	1	0	142
20271	0	0	1	138	0	139
20272	139	0	0	1	0	140
20273	0	0	0	133	0	133
20274	0	0	130	1	0	131
20275	0	0	141	0	0	141
20276	144	1	0	0	0	145
20277	0	0	0	151	0	151
20278	0	0	153	1	0	154
20279	147	0	0	1	0	148
20280	164	0	1	0	0	165
20281	1	0	0	162	0	163
20282	1	0	0	165	0	166
20283	0	158	0	1	0	159
20284	168	0	0	2	0	170
20285	1	0	0	167	0	168
20286	0	0	1	168	0	169
20287	0	1	171	0	0	172
20288	159	0	0	1	0	160
20289	169	0	0	0	0	169
20290	0	170	0	1	0	171
20291	0	0	166	0	0	166
20292	0	0	172	0	0	172
20293	1	0	0	165	0	166
20294	174	0	0	0	0	174
20295	0	0	1	172	0	173
20296	181	0	0	0	0	181
20297	181	0	0	0	0	181
20298	184	0	0	1	0	185
20299	0	0	0	184	0	184
20300	0	1	0	180	0	181
20301	187	0	0	1	0	188
20302	0	0	188	1	0	189
20303	173	0	1	2	0	176
20304	176	0	1	0	0	177
20305	1	0	184	0	0	185
20306	0	0	177	0	0	177
20307	0	177	1	0	0	178
20308	1	1	0	182	0	184
20309	176	0	0	2	0	178
20310	1	0	0	184	0	185
20311	0	0	178	1	0	179
20312	0	173	2	2	0	177
20313	0	175	0	0	0	175
20314	0	1	0	180	0	181
20315	0	0	0	179	0	179
20316	0	178	1	1	0	180
20317	0	1	176	0	0	177
20318	165	0	1	0	0	166
20319	180	0	0	1	0	181
20320	1	181	0	0	0	182
20321	179	1	0	3	0	183
20322	1	0	0	181	0	182
20323	176	0	0	1	0	177
20324	1	0	0	177	0	178
20325	0	196	0	1	0	197
20326	0	1	192	0	0	193
20327	3	0	1	200	0	204
20328	1	0	1	187	0	189
20329	0	0	0	219	0	219
20330	221	0	0	4	0	225
20331	2	0	0	221	0	223
20332	1	0	233	2	0	236
20333	1	0	239	1	0	241
20334	246	0	3	1	0	250
20335	3	1	263	1	0	268
20336	263	0	4	1	0	268
20337	3	0	2	284	0	289
20338	2	0	0	288	0	290
20339	1	0	2	321	0	324
20340	2	0	1	319	0	322
20341	315	0	0	9	0	324
20342	5	0	314	4	0	323
20343	4	0	4	311	0	319
20344	0	316	3	7	0	326
20345	309	4	0	8	0	321
20346	4	1	1	294	0	300
20347	292	0	0	6	0	298
20348	6	1	289	3	0	299
20349	3	0	6	280	0	289
20350	0	288	3	7	0	298
20351	288	5	0	4	0	297
20352	5	3	289	1	0	298
20353	6	0	5	284	0	295
20354	2	1	3	280	0	286
20355	283	0	1	10	0	294
20356	6	1	278	4	0	289
20357	4	1	276	3	0	284
20358	2	2	8	282	0	294
20359	2	0	284	5	0	291
20360	1	1	276	6	0	284
20361	1	0	10	275	0	286
20362	2	1	4	283	0	290
20363	4	0	2	291	0	297
20364	282	1	3	11	0	297
20365	7	279	0	7	0	293
20366	286	6	3	5	0	300
20367	9	4	2	287	0	302
20368	6	287	3	9	0	305
20369	4	6	2	298	0	310
20370	314	4	1	9	0	328
20371	6	325	3	6	0	340
20372	4	9	2	330	0	345
20373	4	5	326	10	0	345
20374	320	0	10	8	0	338
20375	10	3	6	321	0	340
20376	7	1	1	330	0	339
20377	3	2	323	14	0	342
20378	5	2	324	6	0	337
20379	315	1	12	7	0	335
20380	11	304	6	5	0	326
20381	8	7	4	307	0	326
20382	309	7	4	11	0	331
20383	10	4	308	7	0	329
20384	8	304	9	2	0	323
20385	3	9	8	302	0	322
20386	305	5	1	9	0	320
20387	301	1	3	10	0	315
20388	313	2	0	8	0	323
20389	13	297	2	7	0	319
20390	9	9	301	4	0	323
20391	5	5	10	304	0	324
20392	7	1	7	287	0	302
20393	3	1	4	308	0	316
20394	4	4	4	311	0	323
20395	301	1	2	21	0	325
20396	307	2	1	13	0	323
20397	16	2	298	7	0	323
20398	10	2	292	4	0	308
20399	284	2	15	5	0	306
20400	286	1	5	6	0	298
20401	14	4	4	274	0	296
20402	10	237	3	56	0	306
20403	277	9	4	10	0	300
20404	13	277	3	6	0	299
20405	10	281	3	7	0	301
20406	4	12	2	290	0	308
20407	7	5	4	292	0	308
20408	6	1	2	302	0	311
20409	4	3	4	300	0	311
20410	3	2	281	15	0	301
20411	272	1	12	12	0	297
20412	284	4	8	7	0	303
20413	17	1	2	282	0	302
20414	9	3	3	284	0	299
20415	279	3	1	19	0	302
20416	11	4	266	10	0	291
20417	279	1	6	7	0	293
20418	277	5	5	9	0	296
20419	18	4	267	5	0	294
20420	269	0	8	7	0	284
20421	14	3	4	275	0	296
20422	10	2	1	277	0	290
20423	6	2	5	280	0	293
20424	6	1	7	277	0	291
20425	250	2	1	19	0	272
20426	9	0	3	257	0	269
20427	10	0	2	233	0	245
20428	1	212	2	14	0	229
20429	6	214	3	4	0	227
20430	8	11	2	209	0	230
20431	206	7	6	9	0	228
20432	11	1	2	195	0	209
20433	7	1	167	8	0	183
20434	2	3	162	8	0	175
20435	153	2	9	5	0	169
20436	8	155	4	6	0	173
20437	132	5	7	2	0	146
20438	6	4	141	2	0	153
20439	7	5	3	111	0	126
20440	113	1	2	5	0	121
20441	7	111	0	3	0	121
20442	111	4	1	1	0	117
20443	3	4	127	2	0	136
20444	8	2	5	121	0	136
20445	1	2	2	132	0	137
20446	146	2	0	7	0	155
20447	148	0	1	5	0	154
20448	151	0	1	2	0	154
20449	148	0	0	4	0	152
20450	151	0	1	2	0	154
20451	6	152	1	1	0	160
20452	5	3	1	154	0	163
20453	159	2	1	3	0	165
20454	5	0	0	166	0	171
20455	3	2	0	165	0	170
20456	2	1	0	163	0	166
20457	2	152	1	4	0	159
20458	158	4	1	3	0	166
20459	4	3	0	160	0	167
20460	161	0	0	5	0	166
20461	157	2	0	6	0	165
20462	5	156	0	2	0	163
20463	159	2	0	3	0	164
20464	3	2	152	1	0	158
20465	150	1	2	2	0	155
20466	3	9	5	145	0	162
20467	3	1	158	3	0	165
20468	1	157	3	3	0	164
20469	2	2	160	2	0	166
20470	1	135	2	1	0	139
20471	125	1	0	1	0	127
20472	134	1	0	1	0	136
20473	128	0	0	0	0	128
20474	1	131	1	0	0	133
20475	130	0	0	1	0	131
20476	0	0	136	1	0	137
20477	0	0	129	0	0	129
20478	1	1	0	130	0	132
20479	1	0	1	133	0	135
20480	0	133	0	0	0	133
20481	134	0	0	0	0	134
20482	1	0	0	136	0	137
20483	0	141	0	1	0	142
20484	0	1	0	149	0	150
20485	150	0	0	2	0	152
20486	150	0	0	0	0	150
20487	1	0	145	0	0	146
20488	0	0	1	144	0	145
20489	0	0	145	1	0	146
20490	0	1	1	144	0	146
20491	0	0	145	1	0	146
20492	0	0	1	145	0	146
20493	0	0	151	1	0	152
20494	0	0	1	151	0	152
20495	0	0	156	1	0	157
20496	0	0	1	156	0	157
20497	0	0	0	157	0	157
20498	0	163	0	1	0	164
20499	0	1	0	166	0	167
20500	0	0	158	1	0	159
20501	1	0	1	159	0	161
20502	1	0	0	161	0	162
20503	162	0	0	3	0	165
20504	1	0	0	162	0	163
20505	0	0	0	161	0	161
20506	0	0	158	1	0	159
20507	152	0	1	0	0	153
20508	1	0	0	157	0	158
20509	0	0	0	153	0	153
20510	0	0	0	159	0	159
20511	165	0	0	2	0	167
20512	1	0	0	165	0	166
20513	2	0	0	164	0	166
20514	164	0	0	3	0	167
20515	1	162	0	0	0	163
20516	0	1	0	164	0	165
20517	0	0	0	163	0	163
20518	0	0	161	1	0	162
20519	142	0	1	2	0	145
20520	1	0	0	162	0	163
20521	0	0	156	1	0	157
20522	162	0	1	2	0	165
20523	1	0	0	169	0	170
20524	1	0	0	167	0	168
20525	1	0	0	165	0	166
20526	1	0	0	170	0	171
20527	0	0	168	2	0	170
20528	2	1	1	164	0	168
20529	2	0	0	203	0	205
20530	0	1	244	3	0	248
20531	252	0	4	2	0	258
20532	263	0	3	3	0	269
20533	269	0	3	2	0	274
20534	10	0	0	263	0	273
20535	269	0	0	5	0	274
20536	272	0	1	1	0	274
20537	11	0	0	262	0	273
20538	265	0	0	6	0	271
20539	264	0	0	4	0	268
20540	259	0	0	3	0	262
20541	267	0	0	3	0	270
20542	9	0	1	256	0	266
20543	4	239	0	5	0	248
20544	2	245	0	3	0	250
20545	2	247	3	1	0	253
20546	229	6	0	1	0	236
20547	238	1	0	3	0	242
20548	7	2	230	0	0	239
20549	238	1	4	2	0	245
20550	7	2	1	240	0	250
20551	4	0	1	241	0	246
20552	4	1	0	243	0	248
20553	235	0	1	6	0	242
20554	8	0	1	229	0	238
20555	2	228	1	6	0	237
20556	4	4	0	231	0	239
20557	1	1	231	8	0	241
20558	3	1	4	232	0	240
20559	233	0	3	7	0	243
20560	7	2	224	1	0	234
20561	4	0	4	233	0	241
20562	3	1	2	220	0	226
20563	0	0	2	238	0	240
20564	3	238	0	7	0	248
20565	2	4	2	245	0	253
20566	243	1	0	8	0	252
20567	243	1	1	5	0	250
20568	7	0	243	2	0	252
20569	4	1	244	3	0	252
20570	6	1	5	238	0	250
20571	5	1	2	246	0	254
20572	3	1	233	6	0	243
20573	2	1	4	222	0	229
20574	3	232	2	5	0	242
20575	242	5	2	5	0	254
20576	242	1	1	3	0	247
20577	245	1	2	3	0	251
20578	8	0	238	2	0	248
20579	4	2	5	241	0	252
20580	3	0	244	9	0	256
20581	236	2	5	2	0	245
20582	8	239	2	2	0	251
20583	5	7	3	231	0	246
20584	228	3	1	6	0	238
20585	8	2	2	230	0	242
20586	3	1	2	245	0	251
20587	4	1	241	6	0	252
20588	232	0	3	6	0	241
20589	7	239	3	3	0	252
20590	4	4	2	244	0	254
20591	243	1	2	8	0	254
20592	6	1	2	244	0	253
20593	239	3	1	6	0	249
20594	7	238	2	5	0	252
20595	241	6	2	4	0	253
20596	11	2	240	2	0	255
20597	240	1	7	2	0	250
20598	236	0	3	5	0	244
20599	243	1	3	3	0	250
20600	11	0	2	235	0	248
20601	5	2	2	225	0	234
20602	5	1	1	235	0	242
20603	4	232	1	7	0	244
20604	239	6	0	5	0	250
20605	9	1	1	238	0	249
20606	4	3	2	235	0	244
20607	5	0	2	240	0	247
20608	234	3	1	9	0	247
20609	8	1	3	237	0	249
20610	8	1	230	7	0	246
20611	3	228	3	5	0	239
20612	2	4	3	232	0	241
20613	3	3	1	237	0	244
20614	4	1	1	239	0	245
20615	4	2	229	8	0	243
20616	4	2	227	3	0	236
20617	4	0	6	232	0	242
20618	2	2	250	6	0	260
20619	1	0	5	257	0	263
20620	254	0	2	10	0	266
20621	258	0	4	7	0	269
20622	252	1	2	6	0	261
20623	8	3	245	2	0	258
20624	247	0	5	5	0	257
20625	13	2	3	245	0	263
20626	3	0	249	11	0	263
20627	6	1	261	1	0	269
20628	4	249	6	3	0	262
20629	4	220	3	1	0	228
20630	149	8	12	3	0	172
20631	4	0	0	148	0	152
20632	2	0	153	3	0	158
20633	4	0	2	151	0	157
20634	159	0	1	3	0	163
20635	2	0	171	1	0	174
20636	167	0	2	3	0	172
20637	174	1	1	1	0	177
20638	172	0	1	3	0	176
20639	4	173	1	1	0	179
20640	181	3	0	2	0	186
20641	4	1	0	182	0	187
20642	2	0	0	179	0	181
20643	2	0	0	182	0	184
20644	1	0	2	184	0	187
20645	173	1	1	6	0	181
20646	4	176	1	1	0	182
20647	0	164	1	1	0	166
20648	1	182	0	1	0	184
20649	173	2	1	3	0	179
20650	173	0	1	3	0	177
20651	173	1	1	3	0	178
20652	172	0	1	2	0	175
20653	4	0	0	173	0	177
20654	2	0	1	170	0	173
20655	171	0	0	5	0	176
20656	5	168	0	1	0	174
20657	169	3	1	4	0	177
20658	174	2	0	3	0	179
20659	5	1	0	173	0	179
20660	0	174	1	4	0	179
20661	1	3	0	178	0	182
20662	176	1	0	6	0	183
20663	4	2	183	1	0	190
20664	5	0	3	174	0	182
20665	0	180	0	5	0	185
20666	177	3	1	2	0	183
20667	176	0	0	1	0	177
20668	4	1	181	0	0	186
20669	1	177	4	1	0	183
20670	7	2	174	0	0	183
20671	5	0	2	173	0	180
20672	2	0	174	3	0	179
20673	1	1	176	0	0	178
20674	2	167	2	0	0	171
20675	167	2	0	2	0	171
20676	168	0	1	2	0	171
20677	2	179	0	0	0	181
20678	0	184	0	0	0	184
20679	0	3	169	0	0	172
20680	1	0	166	1	0	168
20681	0	0	175	1	0	176
20682	0	0	3	175	0	178
20683	0	0	179	3	0	182
20684	1	0	2	173	0	176
20685	3	0	1	165	0	169
20686	1	0	172	2	0	175
20687	1	168	2	0	0	171
20688	0	2	0	171	0	173
20689	166	1	0	4	0	171
20690	3	0	0	165	0	168
20691	0	0	171	3	0	174
20692	0	164	2	1	0	167
20693	0	174	0	1	0	175
20694	0	2	0	171	0	173
20695	162	0	0	3	0	165
20696	164	1	0	2	0	167
20697	2	1	0	163	0	166
20698	0	166	0	3	0	169
20699	2	2	0	164	0	168
20700	2	0	0	168	0	170
20701	2	0	0	168	0	170
20702	179	0	0	3	0	182
20703	2	178	0	2	0	182
20704	181	2	0	2	0	185
20705	180	2	0	1	0	183
20706	181	1	0	0	0	182
20707	183	0	0	1	0	184
20708	5	0	0	179	0	184
20709	3	0	179	3	0	185
20710	1	172	2	4	0	179
20711	181	2	1	1	0	185
20712	184	2	0	0	0	186
20713	189	0	2	1	0	192
20714	4	1	184	1	0	190
20715	185	1	2	0	0	188
20716	188	0	2	0	0	190
20717	7	0	0	188	0	195
20718	2	0	175	1	0	178
20719	1	169	1	2	0	173
20720	2	0	2	168	0	172
20721	167	1	1	4	0	173
20722	1	0	2	166	0	169
20723	3	2	0	167	0	172
20724	181	0	0	6	0	187
20725	3	0	177	2	0	182
20726	181	0	1	4	0	186
20727	170	0	2	3	0	175
20728	174	0	0	1	0	175
20729	174	0	2	0	0	176
20730	5	0	169	0	0	174
20731	3	0	1	172	0	176
20732	2	0	178	1	0	181
20733	2	0	1	170	0	173
20734	0	0	172	1	0	173
20735	145	0	1	6	0	152
20736	1	153	4	0	0	158
20737	2	163	0	2	0	167
20738	0	1	4	171	0	176
20739	3	2	0	178	0	183
20740	0	182	0	4	0	186
20741	185	6	0	5	0	196
20742	204	4	0	3	0	211
20743	217	0	0	1	0	218
20744	226	1	0	1	0	228
20745	12	0	0	214	0	226
20746	7	0	1	231	0	239
20747	231	0	0	11	0	242
20748	10	0	0	231	0	241
20749	5	1	224	9	0	239
20750	0	0	231	5	0	236
20751	4	0	12	223	0	239
20752	2	1	233	8	0	244
20753	223	0	9	10	0	242
20754	9	0	6	227	0	242
20755	240	0	1	9	0	250
20756	7	0	236	7	0	250
20757	7	1	8	232	0	248
20758	1	0	241	9	0	251
20759	2	232	7	5	0	246
20760	231	7	7	4	0	249
20761	237	5	3	3	0	248
20762	13	231	3	1	0	248
20763	235	9	1	4	0	249
20764	10	6	1	227	0	244
20765	12	0	0	236	0	248
20766	229	2	0	16	0	247
20767	11	223	2	6	0	242
20768	5	231	4	1	0	241
20769	0	13	1	230	0	244
20770	223	5	2	10	0	240
20771	233	3	0	6	0	242
20772	236	4	1	2	0	243
20773	13	1	226	2	0	242
20774	7	2	231	2	0	242
20775	4	224	12	2	0	242
20776	227	7	6	2	0	242
20777	10	6	3	221	0	240
20778	225	1	4	10	0	240
20779	227	4	2	8	0	241
20780	16	3	1	222	0	242
20781	8	1	219	10	0	238
20782	217	1	7	9	0	234
20783	14	0	5	216	0	235
20784	8	1	215	10	0	234
20785	214	1	10	8	0	233
20786	216	1	6	3	0	226
20787	16	2	1	210	0	229
20788	9	1	212	9	0	231
20789	5	1	9	210	0	225
20790	8	211	6	7	0	232
20791	5	7	216	7	0	235
20792	2	218	10	4	0	234
20793	214	8	7	3	0	232
20794	220	6	2	3	0	231
20795	225	2	3	4	0	234
20796	222	3	3	2	0	230
20797	18	1	2	210	0	231
20798	211	0	0	9	0	220
20799	13	0	3	207	0	223
20800	208	0	0	10	0	218
20801	8	198	3	7	0	216
20802	9	9	1	182	0	201
20803	3	192	2	10	0	207
20804	190	6	1	4	0	201
20805	193	4	1	2	0	200
20806	12	188	2	0	0	202
20807	5	8	0	187	0	200
20808	2	4	181	9	0	196
20809	2	2	6	188	0	198
20810	4	3	183	5	0	195
20811	1	2	8	176	0	187
20812	1	177	3	9	0	190
20813	172	7	2	5	0	186
20814	183	3	1	2	0	189
20815	14	1	2	167	0	184
20816	180	1	2	10	0	193
20817	11	1	1	179	0	192
20818	7	2	0	180	0	189
20819	4	1	0	189	0	194
20820	177	0	2	14	0	193
20821	185	2	1	4	0	192
20822	182	2	1	3	0	188
20823	11	170	0	4	0	185
20824	163	8	1	3	0	175
20825	13	162	0	1	0	176
20826	156	8	1	1	0	166
20827	8	3	2	157	0	170
20828	5	1	4	162	0	172
20829	155	1	0	11	0	167
20830	162	2	1	5	0	170
20831	12	156	2	3	0	173
20832	152	7	0	2	0	161
20833	10	4	0	149	0	163
20834	6	0	1	155	0	162
20835	144	2	2	14	0	162
20836	11	1	137	4	0	153
20837	5	137	8	3	0	153
20838	4	6	4	122	0	136
20839	2	1	105	5	0	113
20840	4	6	2	96	0	108
20841	99	1	2	2	0	104
20842	2	80	1	1	0	84
20843	0	72	0	1	0	73
20844	1	71	1	0	0	73
20845	6	5	3	55	0	69
20846	53	2	2	1	0	58
20847	2	0	0	51	0	53
20848	51	0	0	0	0	51
20849	48	0	0	0	0	48
20850	0	0	0	48	0	48
20851	48	0	0	1	0	49
20852	1	0	0	49	0	50
20853	0	0	52	1	0	53
20854	49	0	0	0	0	49
20855	0	1	46	0	0	47
20856	47	0	0	0	0	47
20857	0	0	54	0	0	54
20858	1	0	0	53	0	54
20859	0	0	0	54	0	54
20860	58	0	0	0	0	58
20861	1	0	0	56	0	57
20862	57	0	0	0	0	57
20863	0	50	0	0	0	50
20864	51	0	0	0	0	51
20865	0	0	0	52	0	52
20866	0	0	0	51	0	51
20867	1	0	0	50	0	51
20868	1	0	0	51	0	52
20869	0	0	48	0	0	48
20870	0	0	45	0	0	45
20871	0	0	0	51	0	51
20872	0	1	48	0	0	49
20873	0	50	0	0	0	50
20874	0	0	0	50	0	50
20875	0	0	48	0	0	48
20876	0	0	54	0	0	54
20877	0	0	0	51	0	51
20878	0	0	0	50	0	50
20879	0	56	0	0	0	56
20880	1	0	0	61	0	62
20881	0	0	64	0	0	64
20882	68	0	0	0	0	68
20883	0	0	0	70	0	70
20884	72	0	0	0	0	72
20885	69	0	0	0	0	69
20886	67	0	0	0	0	67
20887	0	0	69	0	0	69
20888	0	0	60	0	0	60
20889	58	0	0	0	0	58
20890	0	0	63	0	0	63
20891	0	0	0	56	0	56
20892	0	0	0	58	0	58
20893	0	0	71	0	0	71
20894	0	69	0	0	0	69
20895	67	0	0	0	0	67
20896	0	68	0	0	0	68
20897	0	73	0	0	0	73
20898	73	0	0	1	0	74
20899	0	0	73	0	0	73
20900	0	0	66	0	0	66
20901	0	0	0	70	0	70
20902	72	0	0	0	0	72
20903	0	79	0	0	0	79
20904	78	0	0	1	0	79
20905	0	0	84	0	0	84
20906	0	95	0	0	0	95
20907	0	0	0	107	0	107
20908	0	0	109	0	0	109
20909	0	0	0	106	0	106
20910	1	0	0	97	0	98
20911	0	1	0	110	0	111
20912	1	0	0	109	0	110
20913	112	0	0	0	0	112
20914	111	0	0	0	0	111
20915	0	0	117	0	0	117
20916	107	0	0	0	0	107
20917	0	108	0	1	0	109
20918	106	0	0	0	0	106
20919	0	0	106	0	0	106
20920	1	0	0	107	0	108
20921	0	0	111	0	0	111
20922	0	0	108	0	0	108
20923	0	0	1	110	0	111
20924	2	0	1	107	0	110
20925	1	0	110	1	0	112
20926	1	108	0	0	0	109
20927	1	114	0	0	0	115
20928	1	0	0	119	0	120
20929	116	0	1	2	0	119
20930	0	120	1	0	0	121
20931	2	0	117	0	0	119
20932	0	0	120	1	0	121
20933	0	0	117	1	0	118
20934	2	0	0	113	0	115
20935	123	0	1	1	0	125
20936	0	121	1	0	0	122
20937	3	0	118	0	0	121
20938	2	118	0	0	0	120
20939	0	1	2	120	0	123
20940	1	0	122	1	0	124
20941	1	124	1	1	0	127
20942	0	0	4	125	0	129
20943	1	1	1	123	0	126
20944	2	0	132	1	0	135
20945	0	1	1	128	0	130
20946	1	134	1	0	0	136
20947	1	1	132	1	0	135
20948	130	3	1	1	0	135
20949	0	1	1	141	0	143
20950	2	0	1	135	0	138
20951	1	139	1	2	0	143
20952	137	2	2	2	0	143
20953	2	0	132	2	0	136
20954	128	0	3	2	0	133
20955	2	2	0	129	0	133
20956	3	127	0	2	0	132
20957	2	2	3	120	0	127
20958	1	1	1	132	0	135
20959	127	2	0	5	0	134
20960	133	0	1	2	0	136
20961	2	0	2	136	0	140
20962	1	1	131	4	0	137
20963	119	0	3	5	0	127
20964	3	131	2	2	0	138
20965	3	1	1	132	0	137
20966	3	0	0	135	0	138
20967	1	1	2	134	0	138
20968	1	1	135	3	0	140
20969	2	2	2	126	0	132
20970	2	128	0	4	0	134
20971	2	2	2	130	0	136
20972	0	134	1	5	0	140
20973	2	2	2	133	0	139
20974	0	0	132	4	0	136
20975	126	3	3	3	0	135
20976	2	1	0	127	0	130
20977	1	1	131	4	0	137
20978	2	130	2	3	0	137
20979	122	5	1	1	0	129
20980	4	1	119	3	0	127
20981	117	1	4	2	0	124
20982	3	0	1	120	0	124
20983	0	2	2	121	0	125
20984	3	123	0	3	0	129
20985	124	2	1	2	0	129
20986	124	0	0	2	0	126
20987	2	135	1	1	0	139
20988	1	2	0	146	0	149
20989	0	0	2	146	0	148
20990	2	0	0	146	0	148
20991	1	2	143	3	0	149
20992	142	1	2	3	0	148
20993	2	2	1	132	0	137
20994	2	0	0	137	0	139
20995	1	0	133	4	0	138
20996	1	1	134	0	0	136
20997	1	0	2	138	0	141
20998	1	0	139	4	0	144
20999	136	1	3	3	0	143
21000	4	0	2	137	0	143
21001	1	0	1	140	0	142
21002	1	0	140	4	0	145
21003	0	2	3	134	0	139
21004	2	0	141	2	0	145
21005	1	133	3	1	0	138
21006	117	5	0	2	0	124
21007	111	0	2	1	0	114
21008	3	113	0	2	0	118
21009	0	2	1	111	0	114
21010	0	1	114	3	0	118
21011	2	0	3	110	0	115
21012	113	0	1	4	0	118
21013	2	112	0	1	0	115
21014	110	3	1	1	0	115
21015	3	0	2	107	0	112
21016	107	0	1	4	0	112
21017	3	115	2	0	0	120
21018	112	3	0	4	0	119
21019	3	0	112	1	0	116
21020	1	115	2	3	0	121
21021	2	2	0	116	0	120
21022	124	2	0	5	0	131
21023	128	0	1	0	0	129
21024	2	0	1	123	0	126
21025	125	1	0	3	0	129
21026	124	1	1	2	0	128
21027	120	0	0	1	0	121
21028	5	1	1	120	0	127
21029	0	1	122	4	0	127
21030	2	0	113	3	0	118
21031	4	0	120	1	0	125
21032	119	1	3	0	0	123
21033	3	0	0	123	0	126
21034	1	125	0	3	0	129
21035	2	2	0	121	0	125
21036	1	121	0	2	0	124
21037	127	2	0	4	0	133
21038	2	0	2	134	0	138
21039	2	1	1	134	0	138
21040	135	0	1	6	0	142
21041	5	0	1	128	0	134
21042	3	1	0	134	0	138
21043	134	1	0	3	0	138
21044	4	0	132	2	0	138
21045	3	1	2	126	0	132
21046	2	0	130	4	0	136
21047	130	0	1	5	0	136
21048	4	1	2	131	0	138
21049	130	0	0	1	0	131
21050	2	0	0	132	0	134
21051	1	1	138	3	0	143
21052	3	0	1	141	0	145
21053	138	0	2	3	0	143
21054	2	143	0	3	0	148
21055	1	1	140	1	0	143
21056	135	1	1	1	0	138
21057	2	137	1	4	0	144
21058	3	135	0	0	0	138
21059	0	167	0	1	0	168
21060	1	3	1	178	0	183
21061	189	2	0	2	0	193
21062	199	0	0	3	0	202
21063	3	1	194	0	0	198
21064	191	0	2	2	0	195
21065	1	198	2	0	0	201
21066	2	1	0	194	0	197
21067	205	2	0	2	0	209
21068	206	0	0	2	0	208
21069	209	0	0	0	0	209
21070	203	0	0	3	0	206
21071	208	0	0	1	0	209
21072	6	0	0	205	0	211
21073	2	0	217	1	0	220
21074	0	0	1	218	0	219
21075	1	0	2	217	0	220
21076	223	0	0	3	0	226
21077	1	215	0	2	0	218
21078	221	1	0	2	0	224
21079	216	2	0	1	0	219
21080	216	1	0	3	0	220
21081	231	0	1	1	0	233
21082	5	0	224	0	0	229
21083	221	1	2	0	0	224
21084	220	0	2	4	0	226
21085	199	1	0	2	0	202
21086	223	0	0	4	0	227
21087	6	0	0	216	0	222
21088	4	0	198	1	0	203
21089	200	0	0	4	0	204
21090	2	205	3	1	0	211
21091	3	1	1	208	0	213
21092	0	212	0	3	0	215
21093	1	1	1	216	0	219
21094	213	2	0	4	0	219
21095	212	1	0	3	0	216
21096	220	0	0	0	0	220
21097	4	1	203	0	0	208
21098	200	0	1	2	0	203
21099	3	0	203	1	0	207
21100	4	0	198	0	0	202
21101	3	0	198	0	0	201
21102	2	0	4	185	0	191
21103	3	0	2	203	0	208
21104	2	0	1	196	0	199
21105	1	0	0	201	0	202
21106	5	0	0	189	0	194
21107	2	0	0	195	0	197
21108	1	201	2	3	0	207
21109	199	2	0	2	0	203
21110	3	206	0	0	0	209
21111	3	1	0	208	0	212
21112	1	3	1	209	0	214
21113	206	0	0	6	0	212
21114	4	204	0	3	0	211
21115	209	1	1	1	0	212
21116	3	3	1	205	0	212
21117	4	0	2	200	0	206
21118	2	1	1	201	0	205
21119	1	0	202	4	0	207
21120	3	0	2	198	0	203
21121	1	0	198	2	0	201
21122	2	0	190	4	0	196
21123	2	0	201	1	0	204
21124	2	0	3	200	0	205
21125	1	0	2	207	0	210
21126	0	1	0	215	0	216
21127	211	0	1	4	0	216
21128	2	2	0	233	0	237
21129	231	1	0	3	0	235
21130	1	237	0	3	0	241
21131	250	2	0	3	0	255
21132	253	3	0	3	0	259
21133	9	261	1	0	0	271
21134	257	3	1	3	0	264
21135	258	2	1	3	0	264
21136	260	0	1	4	0	265
21137	261	1	1	2	0	265
21138	10	0	249	2	0	261
21139	4	247	7	1	0	259
21140	2	6	4	241	0	253
21141	247	3	2	7	0	259
21142	6	0	248	4	0	258
21143	3	242	6	1	0	252
21144	0	5	1	239	0	245
21145	3	243	1	7	0	254
21146	2	5	1	247	0	255
21147	4	3	0	240	0	247
21148	3	1	241	8	0	253
21149	3	2	234	1	0	240
21150	213	1	6	3	0	223
21151	7	1	224	3	0	235
21152	5	0	222	0	0	227
21153	1	2	9	223	0	235
21154	4	0	2	223	0	229
21155	2	222	2	10	0	236
21156	1	234	2	2	0	239
21157	1	9	234	1	0	245
21158	3	4	8	227	0	242
21159	1	2	221	6	0	230
21160	2	2	198	0	0	202
21161	1	189	7	0	0	197
21162	0	6	2	186	0	194
21163	190	1	2	6	0	199
21164	6	1	1	194	0	202
21165	192	1	0	8	0	201
21166	198	0	0	3	0	201
21167	203	1	0	1	0	205
21168	7	0	195	1	0	203
21169	203	0	6	2	0	211
21170	7	0	1	203	0	211
21171	206	1	2	5	0	214
21172	212	1	1	2	0	216
21173	8	199	0	2	0	209
21174	203	6	0	2	0	211
21175	8	1	201	1	0	211
21176	191	0	6	3	0	200
21177	202	1	1	0	0	204
21178	8	208	1	0	0	217
21179	210	6	2	1	0	219
21180	9	1	0	207	0	217
21181	4	1	0	204	0	209
21182	2	203	1	6	0	212
21183	4	5	0	204	0	213
21184	2	2	0	212	0	216
21185	2	0	201	8	0	211
21186	0	1	198	1	0	200
21187	191	1	8	2	0	202
21188	204	0	1	3	0	208
21189	8	0	1	201	0	210
21190	2	0	208	7	0	217
21191	2	202	5	2	0	211
21192	1	6	0	203	0	210
21193	2	4	199	7	0	212
21194	185	2	8	3	0	198
21195	8	3	1	203	0	215
21196	2	199	3	8	0	212
21197	0	7	3	206	0	216
21198	5	1	1	199	0	206
21199	3	0	2	207	0	212
21200	200	2	1	10	0	213
21201	8	0	1	202	0	211
21202	196	1	0	13	0	210
21203	207	2	0	3	0	212
21204	10	1	195	1	0	207
21205	4	199	7	1	0	211
21206	3	7	2	189	0	201
21207	1	201	2	4	0	208
21208	203	7	3	3	0	216
21209	7	4	0	205	0	216
21210	3	0	197	11	0	211
21211	3	1	193	3	0	200
21212	1	1	201	2	0	205
21213	193	1	7	4	0	205
21214	10	197	2	1	0	210
21215	192	6	4	3	0	205
21216	9	197	3	1	0	210
21217	4	7	1	196	0	208
21218	4	5	0	194	0	203
21219	3	197	1	10	0	211
21220	1	9	194	4	0	208
21221	0	196	9	2	0	207
21222	175	7	1	2	0	185
21223	9	2	0	169	0	180
21224	3	0	176	9	0	188
21225	3	0	181	0	0	184
21226	4	0	9	172	0	185
21227	2	2	173	8	0	185
21228	1	0	167	4	0	172
21229	157	1	9	2	0	169
21230	8	163	2	2	0	175
21231	152	6	0	3	0	161
21232	7	1	161	1	0	170
21233	4	157	8	0	0	169
21234	1	172	3	1	0	177
21235	6	10	0	161	0	177
21236	2	2	0	177	0	181
21237	3	0	1	176	0	180
21238	2	1	175	5	0	183
21239	3	0	4	175	0	182
21240	3	1	1	177	0	182
21241	175	1	1	5	0	182
21242	5	174	2	3	0	184
21243	3	4	1	171	0	179
21244	171	3	0	6	0	180
21245	175	0	0	5	0	180
21246	6	1	1	173	0	181
21247	2	0	172	5	0	179
21248	1	1	5	177	0	184
21249	1	0	179	5	0	185
21250	175	0	5	2	0	182
21251	184	0	3	3	0	190
21252	4	1	2	195	0	202
21253	2	1	196	2	0	201
21254	1	205	2	1	0	209
21255	0	2	211	2	0	215
21256	3	2	2	183	0	190
21257	0	202	0	2	0	204
21258	184	2	0	2	0	188
21259	4	0	0	174	0	178
21260	0	182	1	0	0	183
21261	185	1	0	1	0	187
21262	2	0	0	177	0	179
21263	1	173	0	2	0	176
21264	3	3	0	168	0	174
21265	0	0	174	3	0	177
21266	165	0	2	0	0	167
21267	167	0	0	0	0	167
21268	1	0	160	1	0	162
21269	0	155	2	0	0	157
21270	160	1	0	1	0	162
21271	5	0	1	153	0	159
21272	7	0	0	153	0	160
21273	2	0	0	153	0	155
21274	1	0	0	157	0	158
21275	2	0	1	151	0	154
21276	151	1	0	3	0	155
21277	152	0	0	1	0	153
21278	2	0	0	146	0	148
21279	1	0	0	148	0	149
21280	1	0	148	1	0	150
21281	0	0	143	1	0	144
21282	145	1	1	0	0	147
21283	4	0	1	141	0	146
21284	0	0	143	1	0	144
21285	2	0	1	140	0	143
21286	141	1	0	2	0	144
21287	150	0	0	2	0	152
21288	2	0	0	153	0	155
21289	0	1	0	156	0	157
21290	146	0	1	2	0	149
21291	1	0	0	145	0	146
21292	0	151	0	1	0	152
21293	1	2	0	148	0	151
21294	2	0	0	156	0	158
21295	0	2	147	2	0	151
21296	1	0	153	1	0	155
21297	0	147	2	2	0	151
21298	151	2	0	1	0	154
21299	147	0	0	3	0	150
21300	149	0	1	0	0	150
21301	1	148	0	0	0	149
21302	1	146	0	1	0	148
21303	146	1	1	0	0	148
21304	2	157	0	0	0	159
21305	1	1	152	1	0	155
21306	0	165	2	1	0	168
21307	0	2	160	1	0	163
21308	156	1	3	2	0	162
21309	160	0	1	1	0	162
21310	2	159	0	3	0	164
21311	166	2	1	1	0	170
21312	171	0	1	2	0	174
21313	170	2	0	1	0	173
21314	2	1	0	169	0	172
21315	168	0	1	5	0	174
21316	1	2	168	1	0	172
21317	174	1	0	0	0	175
21318	2	0	0	170	0	172
21319	0	2	168	1	0	171
21320	2	0	160	2	0	164
21321	3	0	2	170	0	175
21322	2	1	1	173	0	177
21323	174	1	0	3	0	178
21324	2	0	2	166	0	170
21325	2	0	159	2	0	163
21326	7	0	1	154	0	162
21327	0	170	0	3	0	173
21328	170	2	0	3	0	175
21329	2	0	0	171	0	173
21330	1	0	165	2	0	168
21331	1	164	2	2	0	169
21332	144	1	0	2	0	147
21333	6	0	0	146	0	152
21334	2	0	146	1	0	149
21335	1	144	1	1	0	147
21336	140	2	1	0	0	143
21337	139	1	1	1	0	142
21338	139	1	0	0	0	140
21339	1	1	1	139	0	142
21340	4	1	1	135	0	141
21341	139	1	1	1	0	142
21342	2	137	1	1	0	141
21343	144	0	0	1	0	145
21344	3	1	0	138	0	142
21345	140	1	0	3	0	144
21346	3	1	0	140	0	144
21347	3	0	0	135	0	138
21348	1	0	0	135	0	136
21349	3	0	1	129	0	133
21350	1	0	128	1	0	130
21351	1	1	118	0	0	120
21352	102	0	0	1	0	103
21353	0	1	120	1	0	122
21354	0	0	97	0	0	97
21355	101	0	0	1	0	102
21356	103	0	1	1	0	105
21357	1	0	0	130	0	131
21358	131	0	0	1	0	132
21359	0	137	1	0	0	138
21360	143	0	0	3	0	146
21361	144	1	0	0	0	145
21362	150	0	0	1	0	151
21363	0	0	0	153	0	153
21364	0	149	0	0	0	149
21365	0	147	0	0	0	147
21366	154	0	0	0	0	154
21367	151	0	1	0	0	152
21368	0	0	1	155	0	156
21369	0	1	0	155	0	156
21370	1	154	0	0	0	155
21371	154	0	0	1	0	155
21372	1	0	151	0	0	152
21373	1	0	0	151	0	152
21374	1	0	0	152	0	153
21375	1	0	164	0	0	165
21376	0	1	0	160	0	161
21377	1	125	1	0	0	127
21378	0	0	0	166	0	166
21379	1	0	0	157	0	158
21380	0	152	1	2	0	155
21381	0	164	0	2	0	166
21382	0	1	0	165	0	166
21383	162	0	0	4	0	166
21384	3	0	1	163	0	167
21385	2	0	1	158	0	161
21386	1	187	0	1	0	189
21387	0	1	1	181	0	183
21388	0	0	1	183	0	184
21389	1	0	0	184	0	185
21390	183	0	0	2	0	185
21391	1	0	0	187	0	188
21392	3	0	0	179	0	182
21393	0	1	0	184	0	185
21394	1	0	186	1	0	188
21395	154	0	1	0	0	155
21396	2	177	0	0	0	179
21397	181	1	0	1	0	183
21398	2	0	0	181	0	183
21399	0	0	169	1	0	170
21400	165	0	1	0	0	166
21401	1	0	245	0	0	246
21402	1	0	1	259	0	261
21403	273	0	0	3	0	276
21404	267	0	0	2	0	269
21405	285	0	0	1	0	286
21406	2	0	0	283	0	285
21407	0	0	0	286	0	286
21408	2	0	0	288	0	290
21409	0	274	0	1	0	275
21410	0	280	1	1	0	282
21411	0	274	0	0	0	274
21412	0	283	0	0	0	283
21413	1	1	0	292	0	294
21414	0	0	0	293	0	293
21415	292	0	0	2	0	294
21416	290	0	0	0	0	290
21417	288	0	0	2	0	290
21418	2	1	0	293	0	296
21419	1	0	0	297	0	298
21420	292	0	0	2	0	294
21421	281	0	0	1	0	282
21422	1	0	279	0	0	280
21423	0	0	269	0	0	269
21424	0	0	279	0	0	279
21425	0	0	291	0	0	291
21426	0	0	0	298	0	298
21427	297	0	0	5	0	302
21428	1	302	0	0	0	303
21429	0	1	0	316	0	317
21430	0	0	316	1	0	317
21431	0	325	2	0	0	327
21432	0	1	0	338	0	339
21433	0	0	338	1	0	339
21434	1	0	1	325	0	327
21435	0	1	0	337	0	338
21436	337	0	0	4	0	341
21437	1	0	0	339	0	340
21438	0	0	341	1	0	342
21439	0	0	1	336	0	337
21440	0	360	0	6	0	366
21441	0	1	0	378	0	379
21442	1	0	1	371	0	373
21443	0	0	0	368	0	368
21444	372	0	0	4	0	376
21445	371	0	0	2	0	373
21446	386	0	0	1	0	387
21447	388	0	0	0	0	388
21448	1	0	383	0	0	384
21449	369	0	1	0	0	370
21450	383	0	0	2	0	385
21451	2	0	378	1	0	381
21452	0	0	413	0	0	413
21453	1	0	1	399	0	401
21454	0	407	0	1	0	408
21455	423	1	0	4	0	428
21456	444	0	0	3	0	447
21457	436	0	0	5	0	441
21458	1	0	0	438	0	439
21459	0	449	0	1	0	450
21460	477	1	0	1	0	479
21461	481	0	0	2	0	483
21462	1	0	1	477	0	479
21463	0	1	466	1	0	468
21464	457	0	1	1	0	459
21465	1	1	0	489	0	491
21466	489	0	0	4	0	493
21467	3	1	0	492	0	496
21468	1	0	497	1	0	499
21469	521	0	1	3	0	525
21470	3	1	0	548	0	552
21471	1	0	0	550	0	551
21472	2	0	0	562	0	564
21473	1	0	0	560	0	561
21474	562	0	0	3	0	565
21475	3	0	0	552	0	555
21476	3	539	2	6	0	550
21477	1	1	0	555	0	557
21478	0	558	0	3	0	561
21479	1	0	1	585	0	587
21480	5	0	0	580	0	585
21481	0	578	0	1	0	579
21482	1	0	0	589	0	590
21483	0	0	0	578	0	578
21484	580	0	0	6	0	586
21485	1	1	579	0	0	581
21486	0	0	0	572	0	572
21487	579	1	0	2	0	582
21488	574	0	0	2	0	576
21489	577	1	0	0	0	578
21490	1	1	584	1	0	587
21491	1	1	584	1	0	587
21492	0	1	2	618	0	621
21493	626	0	2	3	0	631
21494	1	0	620	2	0	623
21495	598	0	1	3	0	602
21496	2	637	2	0	0	641
21497	1	1	0	677	0	679
21498	3	1	0	689	0	693
21499	693	0	0	4	0	697
21500	2	1	2	706	0	711
21501	646	0	1	5	0	652
21502	655	1	1	3	0	660
21503	2	0	0	652	0	654
21504	3	0	1	650	0	654
21505	647	1	1	6	0	655
21506	3	0	691	2	0	696
21507	674	1	1	7	0	683
21508	1	2	732	2	0	737
21509	708	0	2	2	0	712
21510	775	0	1	4	0	780
21511	765	0	1	5	0	771
21512	770	0	0	1	0	771
21513	3	777	1	2	0	783
21514	807	1	1	8	0	817
21515	809	1	0	6	0	816
21516	4	873	0	0	0	877
21517	883	1	2	2	0	888
21518	4	1	869	0	0	874
21519	871	2	2	1	0	876
21520	4	7	884	1	0	896
21521	2	0	3	891	0	896
21522	4	0	1	896	0	901
21523	1	1	886	4	0	892
21524	2	1	2	888	0	893
21525	24	6	11	573	0	614
21526	928	0	0	9	0	937
21527	5	1	0	934	0	940
21528	4	0	0	918	0	922
21529	1	0	2	912	0	915
21530	2	889	0	14	0	905
21531	1	6	2	902	0	911
21532	920	1	0	10	0	931
21533	5	2	918	2	0	927
21534	2	0	6	926	0	934
21535	2	1	918	9	0	930
21536	904	1	8	8	0	921
21537	10	0	1	959	0	970
21538	4	1	1205	13	0	1223
21539	6	1	27	1199	0	1233
21540	6	0	23	1189	0	1218
21541	0	1188	8	48	0	1244
21542	7	28	3	1248	0	1286
21543	9	21	0	1320	0	1350
21544	0	9	1288	60	0	1357
21545	5	5	32	1310	0	1352
21546	3	3	23	1329	0	1358
21547	1276	3	8	65	0	1352
21548	1293	0	6	43	0	1342
21549	55	1278	2	17	0	1352
21550	1314	32	5	12	0	1363
21551	1306	23	2	19	0	1350
21552	58	1296	5	9	0	1368
21553	37	38	2	1294	0	1371
21554	1295	26	0	45	0	1366
21555	1307	12	1	30	0	1350
21556	1301	6	3	17	0	1327
21557	60	1234	6	9	0	1309
21558	36	33	1240	12	0	1321
21559	1260	22	32	18	0	1332
21560	1285	14	23	13	0	1335
21561	64	1265	10	9	0	1348
21562	1299	40	2	14	0	1355
21563	1313	30	5	9	0	1357
21564	72	14	5	1259	0	1350
21565	42	14	1265	45	0	1366
21566	31	2	39	1287	0	1359
21567	29	6	28	1294	0	1357
21568	18	5	9	1344	0	1376
21569	17	8	1240	73	0	1338
21570	17	3	41	1224	0	1285
21571	13	5	32	1259	0	1309
21572	11	5	10	1292	0	1318
21573	15	3	11	1277	0	1306
21574	15	2	2	1282	0	1301
21575	12	1222	5	87	0	1326
21576	10	44	2	1272	0	1328
21577	12	28	9	1321	0	1370
21578	14	11	1255	86	0	1366
21579	11	4	45	1340	0	1400
21580	8	8	29	1378	0	1423
21581	13	5	13	1453	0	1484
21582	10	5	9	1484	0	1508
21583	1373	8	4	117	0	1502
21584	54	1	12	1432	0	1499
21585	45	0	6	1452	0	1503
21586	16	0	1365	101	0	1482
21587	10	1299	48	69	0	1426
21588	4	1407	39	35	0	1485
21589	1335	75	15	40	0	1465
21590	49	1401	7	20	0	1477
21591	40	57	8	1367	0	1472
21592	1344	37	6	74	0	1461
21593	55	20	1346	53	0	1474
21594	42	12	51	1342	0	1447
21595	22	1336	37	65	0	1460
21596	17	50	11	1358	0	1436
21597	11	1378	10	74	0	1473
21598	17	64	6	1386	0	1473
21599	1348	41	10	86	0	1485
21600	60	19	1371	54	0	1504
21601	49	16	52	1342	0	1459
21602	26	1378	32	64	0	1500
21603	1381	61	12	54	0	1508
21604	64	37	1373	34	0	1508
21605	51	21	61	1377	0	1510
21606	24	14	1355	71	0	1464
21607	32	9	62	1347	0	1450
21608	12	13	1341	78	0	1444
21609	15	14	71	1317	0	1417
21610	17	12	39	1334	0	1402
21611	1278	7	14	109	0	1408
21612	1305	8	20	58	0	1391
21613	97	6	5	1250	0	1358
21614	54	1224	12	69	0	1359
21615	34	55	5	1271	0	1365
21616	14	38	17	1248	0	1317
21617	1164	14	6	114	0	1298
21618	67	1178	7	59	0	1311
21619	1187	54	12	43	0	1296
21620	1199	35	7	25	0	1266
21621	84	1115	7	29	0	1235
21622	49	1200	5	28	0	1282
21623	1157	81	12	29	0	1279
21624	67	41	1135	34	0	1277
21625	1135	18	58	25	0	1236
21626	1154	14	31	25	0	1224
21627	93	1071	16	22	0	1202
21628	53	59	8	990	0	1110
21629	24	1102	13	71	0	1210
21630	1083	69	7	44	0	1203
21631	1119	47	8	34	0	1208
21632	97	20	4	1064	0	1185
21633	59	22	6	1100	0	1187
21634	1020	11	4	103	0	1138
21635	65	1011	7	60	0	1143
21636	44	992	8	38	0	1082
21637	23	1020	9	26	0	1078
21638	14	678	8	12	0	712
21639	10	712	5	15	0	742
21640	13	44	3	684	0	744
21641	11	20	661	39	0	731
21642	15	656	31	15	0	717
21643	584	26	14	19	0	643
21644	34	15	10	566	0	625
21645	572	13	5	35	0	625
21646	36	569	4	19	0	628
21647	576	27	11	14	0	628
21648	34	562	6	10	0	612
21649	16	31	11	564	0	622
21650	565	12	5	36	0	618
21651	583	9	6	19	0	617
21652	37	7	5	571	0	620
21653	19	4	3	589	0	615
21654	13	549	4	41	0	607
21655	21	25	5	565	0	616
21656	13	15	3	589	0	620
21657	12	13	2	582	0	609
21658	6	549	2	44	0	601
21659	492	23	2	30	0	547
21660	34	504	6	11	0	555
21661	506	25	3	10	0	544
21662	27	500	4	15	0	546
21663	19	27	489	11	0	546
21664	18	15	24	478	0	535
21665	5	15	468	30	0	518
21666	12	11	477	13	0	513
21667	12	7	28	463	0	510
21668	13	7	470	22	0	512
21669	24	4	20	455	0	503
21670	8	13	8	466	0	495
21671	10	8	5	481	0	504
21672	461	9	3	31	0	504
21673	28	9	6	460	0	503
21674	19	8	2	472	0	501
21675	449	2	4	27	0	482
21676	21	426	4	20	0	471
21677	10	372	1	17	0	400
21678	9	391	4	8	0	412
21679	5	17	2	305	0	329
21680	6	7	300	19	0	332
21681	217	10	16	7	0	250
21682	13	226	0	7	0	246
21683	221	12	2	8	0	243
21684	235	3	3	5	0	246
21685	234	7	1	4	0	246
21686	16	8	229	0	0	253
21687	6	6	8	234	0	254
21688	3	4	4	243	0	254
21689	8	2	2	240	0	252
21690	9	4	4	232	0	249
21691	7	232	1	13	0	253
21692	226	12	0	7	0	245
21693	13	3	205	4	0	225
21694	197	2	9	2	0	210
21695	15	4	1	182	0	202
21696	0	180	4	14	0	198
21697	2	189	0	9	0	200
21698	3	6	1	176	0	186
21699	1	171	0	11	0	183
21700	134	3	0	4	0	141
21701	4	4	133	0	0	141
21702	5	0	2	106	0	113
21703	2	0	3	109	0	114
21704	3	1	1	112	0	117
21705	0	2	0	114	0	116
21706	112	4	0	3	0	119
21707	3	102	0	23	0	128
21708	131	2	0	3	0	136
21709	4	4	1	129	0	138
21710	6	0	1	133	0	140
21711	1	134	4	8	0	147
21712	144	4	1	8	0	157
21713	150	2	0	6	0	158
21714	7	149	0	4	0	160
21715	5	5	0	136	0	146
21716	5	140	0	4	0	149
21717	137	8	2	4	0	151
21718	7	3	135	3	0	148
21719	3	2	132	4	0	141
21720	127	1	7	4	0	139
21721	6	126	3	0	0	135
21722	8	5	0	122	0	135
21723	4	4	0	125	0	133
21724	0	5	124	8	0	137
21725	2	1	3	129	0	135
21726	1	3	4	129	0	137
21727	3	125	2	7	0	137
21728	1	3	4	128	0	136
21729	1	4	3	130	0	138
21730	127	2	0	8	0	137
21731	4	124	0	6	0	134
21732	3	128	1	5	0	137
21733	0	7	1	130	0	138
21734	1	4	2	129	0	136
21735	1	2	0	135	0	138
21736	0	125	0	12	0	137
21737	1	7	0	130	0	138
21738	4	3	0	130	0	137
21739	1	2	0	133	0	136
21740	3	2	0	133	0	138
21741	0	122	0	9	0	131
21742	1	130	0	6	0	137
21743	120	3	1	6	0	130
21744	129	4	1	3	0	137
21745	7	1	0	124	0	132
21746	4	1	124	3	0	132
21747	2	0	4	133	0	139
21748	2	0	3	134	0	139
21749	126	0	2	6	0	134
21750	3	128	0	5	0	136
21751	3	3	0	132	0	138
21752	1	4	0	133	0	138
21753	0	1	129	7	0	137
21754	0	0	134	5	0	139
21755	2	0	6	129	0	137
21756	1	1	4	133	0	139
21757	0	130	1	6	0	137
21758	0	131	0	2	0	133
21759	127	5	0	2	0	134
21760	3	4	0	132	0	139
21761	3	2	124	3	0	132
21762	1	125	3	4	0	133
21763	1	3	3	124	0	131
21764	124	4	0	4	0	132
21765	4	1	0	125	0	130
21766	125	0	0	5	0	130
21767	4	122	0	4	0	130
21768	120	3	0	2	0	125
21769	8	3	0	117	0	128
21770	4	3	122	4	0	133
21771	1	1	4	128	0	134
21772	0	124	3	6	0	133
21773	2	5	2	130	0	139
21774	2	140	2	5	0	149
21775	0	6	1	151	0	158
21776	1	2	147	7	0	157
21777	1	1	142	4	0	148
21778	0	2	150	1	0	153
21779	141	0	9	2	0	152
21780	4	140	5	3	0	152
21781	3	149	3	2	0	157
21782	146	6	0	3	0	155
21783	142	5	0	2	0	149
21784	8	2	0	137	0	147
21785	4	0	137	8	0	149
21786	3	0	133	4	0	140
21787	1	2	7	131	0	141
21788	132	1	3	5	0	141
21789	5	132	1	5	0	143
21790	5	4	1	134	0	144
21791	134	2	0	6	0	142
21792	131	3	0	5	0	139
21793	8	1	127	3	0	139
21794	127	1	5	3	0	136
21795	5	0	132	3	0	140
21796	4	0	133	3	0	140
21797	1	2	8	126	0	137
21798	0	2	4	132	0	138
21799	6	3	0	134	0	143
21800	3	1	127	10	0	141
21801	125	1	5	6	0	137
21802	6	0	6	132	0	144
21803	134	0	5	5	0	144
21804	129	0	0	9	0	138
21805	9	129	2	2	0	142
21806	6	136	1	1	0	144
21807	2	133	0	3	0	138
21808	2	7	0	118	0	127
21809	2	3	119	6	0	130
21810	1	4	6	111	0	122
21811	2	108	0	4	0	114
21812	1	105	3	1	0	110
21813	0	1	4	106	0	111
21814	106	0	2	3	0	111
21815	3	100	1	2	0	106
21816	0	106	1	1	0	108
21817	113	3	1	2	0	119
21818	5	0	0	113	0	118
21819	3	0	0	114	0	117
21820	1	1	1	115	0	118
21821	110	1	1	1	0	113
21822	109	1	2	2	0	114
21823	2	1	1	115	0	119
21824	2	1	109	3	0	115
21825	106	2	1	4	0	113
21826	3	1	1	111	0	116
21827	1	1	114	1	0	117
21828	2	1	111	2	0	116
21829	0	1	4	116	0	121
21830	3	0	121	3	0	127
21831	3	0	2	130	0	135
21832	0	3	2	127	0	132
21833	1	2	1	137	0	141
21834	137	1	0	4	0	142
21835	1	1	1	136	0	139
21836	1	1	2	134	0	138
21837	3	0	0	138	0	141
21838	1	2	0	137	0	140
21839	3	1	131	4	0	139
21840	1	132	1	5	0	139
21841	2	2	2	134	0	140
21842	4	3	1	127	0	135
21843	0	125	1	5	0	131
21844	1	125	4	1	0	131
21845	124	3	2	1	0	130
21846	1	112	0	14	0	127
21847	1	2	1	118	0	122
21848	2	2	123	2	0	129
21849	119	1	1	3	0	124
21850	3	0	119	2	0	124
21851	116	2	3	0	0	121
21852	120	1	2	2	0	125
21853	3	0	122	3	0	128
21854	3	0	2	116	0	121
21855	0	116	3	3	0	122
21856	2	1	2	125	0	130
21857	124	2	1	3	0	130
21858	123	1	1	3	0	128
21859	2	121	1	3	0	127
21860	130	3	1	2	0	136
21861	4	2	1	130	0	137
21862	126	1	1	3	0	131
21863	126	1	1	3	0	131
21864	2	1	1	125	0	129
21865	123	0	1	4	0	128
21866	120	0	2	5	0	127
21867	4	1	122	2	0	129
21868	132	0	1	5	0	138
21869	3	0	136	3	0	142
21870	3	0	128	0	0	131
21871	2	129	2	2	0	135
21872	1	2	4	126	0	133
21873	0	1	123	2	0	126
21874	1	1	107	5	0	114
21875	124	0	2	0	0	126
21876	0	1	1	120	0	122
21877	1	0	1	129	0	131
21878	1	0	1	138	0	140
21879	2	0	1	133	0	136
21880	2	0	0	138	0	140
21881	0	0	133	4	0	137
21882	0	0	131	3	0	134
21883	3	0	1	137	0	141
21884	134	0	2	1	0	137
21885	0	131	3	2	0	136
21886	1	0	1	127	0	129
21887	129	1	1	0	0	131
21888	0	128	0	2	0	130
21889	3	0	0	127	0	130
21890	2	2	0	128	0	132
21891	0	2	0	129	0	131
21892	129	0	0	4	0	133
21893	0	1	124	4	0	129
21894	122	0	0	4	0	126
21895	3	0	1	128	0	132
21896	1	0	2	126	0	129
21897	3	129	1	2	0	135
21898	0	0	128	4	0	132
21899	119	1	0	3	0	123
21900	129	2	1	1	0	133
21901	1	1	128	2	0	132
21902	124	1	0	1	0	126
21903	2	133	1	2	0	138
21904	2	137	2	1	0	142
21905	3	137	0	0	0	140
21906	128	3	0	1	0	132
21907	0	3	131	1	0	135
21908	1	3	0	132	0	136
21909	2	132	2	1	0	137
21910	1	135	2	2	0	140
21911	0	133	2	2	0	137
21912	4	5	0	116	0	125
21913	132	3	0	0	0	135
21914	0	138	1	1	0	140
21915	1	1	0	132	0	134
21916	2	1	1	135	0	139
21917	129	2	0	3	0	134
21918	1	0	1	129	0	131
21919	3	0	0	129	0	132
21920	2	1	128	1	0	132
21921	1	0	1	129	0	131
21922	0	0	1	135	0	136
21923	128	1	2	1	0	132
21924	122	0	0	5	0	127
21925	2	0	0	125	0	127
21926	121	0	0	0	0	121
21927	120	1	0	1	0	122
21928	2	123	1	2	0	128
21929	3	0	117	1	0	121
21930	3	112	0	0	0	115
21931	0	2	0	115	0	117
21932	112	0	2	0	0	114
21933	0	112	0	0	0	112
21934	1	0	0	114	0	115
21935	113	0	0	0	0	113
21936	111	2	0	1	0	114
21937	0	0	0	113	0	113
21938	1	0	115	0	0	116
21939	2	0	0	117	0	119
21940	0	0	0	120	0	120
21941	0	0	116	0	0	116
21942	0	0	0	117	0	117
21943	1	0	0	117	0	118
21944	121	0	2	0	0	123
21945	1	0	0	130	0	131
21946	0	0	0	128	0	128
21947	130	0	0	0	0	130
21948	124	0	0	2	0	126
21949	122	0	0	3	0	125
21950	2	0	120	0	0	122
21951	2	0	0	122	0	124
21952	2	123	0	0	0	125
21953	0	1	1	120	0	122
21954	0	0	127	1	0	128
21955	0	1	0	121	0	122
21956	0	0	124	1	0	125
21957	122	0	1	0	0	123
21958	126	0	0	1	0	127
21959	0	0	0	127	0	127
21960	1	0	0	119	0	120
21961	0	0	0	121	0	121
21962	0	132	0	1	0	133
21963	133	0	0	1	0	134
21964	135	0	0	2	0	137
21965	0	1	0	137	0	138
21966	1	0	0	131	0	132
21967	1	0	0	137	0	138
21968	0	0	0	126	0	126
21969	0	0	120	0	0	120
21970	0	0	0	120	0	120
21971	116	0	0	1	0	117
21972	115	0	0	0	0	115
21973	0	0	0	118	0	118
21974	1	0	117	0	0	118
21975	107	0	0	0	0	107
21976	0	0	0	109	0	109
21977	0	103	1	0	0	104
21978	0	102	0	0	0	102
21979	101	0	0	2	0	103
21980	0	0	0	107	0	107
21981	0	0	0	104	0	104
21982	0	0	0	121	0	121
21983	0	0	0	120	0	120
21984	0	0	0	123	0	123
21985	0	1	121	1	0	123
21986	0	0	122	0	0	122
21987	0	0	117	0	0	117
21988	0	0	1	120	0	121
21989	0	0	132	1	0	133
21990	0	0	0	137	0	137
21991	0	0	0	141	0	141
21992	0	0	0	143	0	143
21993	145	0	0	2	0	147
21994	1	0	0	145	0	146
21995	0	0	1	152	0	153
21996	149	0	0	3	0	152
21997	1	153	0	0	0	154
21998	0	161	0	0	0	161
21999	158	1	0	0	0	159
22000	1	161	0	0	0	162
22001	161	1	0	1	0	163
22002	164	0	1	0	0	165
22003	165	0	0	2	0	167
22004	163	0	0	3	0	166
22005	162	0	0	1	0	163
22006	3	162	0	0	0	165
22007	160	1	0	3	0	164
22008	160	1	1	3	0	165
22009	4	159	0	1	0	164
22010	178	4	0	0	0	182
22011	181	1	0	2	0	184
22012	194	0	1	1	0	196
22013	203	1	0	2	0	206
22014	2	0	216	0	0	218
22015	4	1	1	221	0	227
22016	3	0	0	223	0	226
22017	1	0	226	3	0	230
22018	2	0	219	1	0	222
22019	222	2	1	3	0	228
22020	4	1	0	229	0	234
22021	2	0	235	2	0	239
22022	2	0	225	0	0	227
22023	223	0	3	4	0	230
22024	233	1	1	2	0	237
22025	226	1	0	3	0	230
22026	4	0	232	2	0	238
22027	3	1	5	230	0	239
22028	1	0	233	4	0	238
22029	232	0	2	3	0	237
22030	4	0	233	1	0	238
22031	1	0	4	217	0	222
22032	3	0	2	218	0	223
22033	3	226	0	3	0	232
22034	229	2	1	1	0	233
22035	5	1	226	0	0	232
22036	218	3	3	2	0	226
22037	6	0	226	1	0	233
22038	6	0	4	215	0	225
22039	5	0	2	221	0	228
22040	3	0	1	225	0	229
22041	221	0	3	4	0	228
22042	4	0	1	221	0	226
22043	2	1	3	220	0	226
22044	3	219	2	3	0	227
22045	5	2	3	218	0	228
22046	224	1	0	3	0	228
22047	5	2	214	2	0	223
22048	3	0	5	213	0	221
22049	1	1	220	4	0	226
22050	3	211	4	4	0	222
22051	3	1	219	2	0	225
22052	212	0	6	3	0	221
22053	221	0	3	5	0	229
22054	6	2	1	218	0	227
22055	214	0	5	9	0	228
22056	220	0	4	4	0	228
22057	8	1	4	210	0	223
22058	5	0	2	216	0	223
22059	4	0	211	4	0	219
22060	2	215	5	2	0	224
22061	209	2	3	5	0	219
22062	5	201	6	1	0	213
22063	6	2	3	202	0	213
22064	4	0	5	208	0	217
22065	5	1	1	208	0	215
22066	6	1	0	209	0	216
22067	3	2	204	7	0	216
22068	206	2	4	2	0	214
22069	209	0	3	3	0	215
22070	7	1	3	205	0	216
22071	207	3	3	4	0	217
22072	4	1	1	207	0	213
22073	4	1	201	7	0	213
22074	7	1	4	197	0	209
22075	2	195	1	8	0	206
22076	6	2	4	200	0	212
22077	2	211	1	7	0	221
22078	2	4	3	209	0	218
22079	4	207	1	5	0	217
22080	200	2	4	1	0	207
22081	6	1	204	4	0	215
22082	6	179	3	3	0	191
22083	2	179	3	3	0	187
22084	1	3	3	188	0	195
22085	2	2	2	188	0	194
22086	4	0	4	185	0	193
22087	7	3	0	181	0	191
22088	4	180	1	3	0	188
22089	5	4	0	166	0	175
22090	5	0	2	168	0	175
22091	163	1	1	6	0	171
22092	2	1	2	170	0	175
22093	0	2	162	5	0	169
22094	2	0	159	1	0	162
22095	156	2	1	3	0	162
22096	5	155	0	2	0	162
22097	1	150	0	4	0	155
22098	1	2	0	147	0	150
22099	2	0	0	149	0	151
22100	1	1	146	3	0	151
22101	140	1	2	2	0	145
22102	145	1	2	0	0	148
22103	4	2	149	2	0	157
22104	3	2	146	2	0	153
22105	149	0	1	6	0	156
22106	155	1	1	3	0	160
22107	156	0	2	5	0	163
22108	147	1	2	1	0	151
22109	1	149	0	2	0	152
22110	130	2	0	2	0	134
22111	1	1	125	3	0	130
22112	1	1	112	1	0	115
22113	1	2	120	1	0	124
22114	1	4	3	98	0	106
22115	93	0	0	0	0	93
22116	93	0	0	0	0	93
22117	0	0	0	92	0	92
22118	1	0	0	88	0	89
22119	0	0	0	95	0	95
22120	0	105	0	0	0	105
22121	103	0	0	0	0	103
22122	100	0	0	0	0	100
22123	103	0	0	0	0	103
22124	98	0	0	1	0	99
22125	100	0	0	0	0	100
22126	0	0	0	102	0	102
22127	0	91	0	0	0	91
22128	0	0	0	96	0	96
22129	0	0	0	97	0	97
22130	97	0	0	0	0	97
22131	0	0	96	0	0	96
22132	0	1	88	1	0	90
22133	2	0	95	0	0	97
22134	101	0	0	1	0	102
22135	107	0	0	0	0	107
22136	2	0	0	107	0	109
22137	2	0	0	107	0	109
22138	0	0	0	110	0	110
22139	0	2	110	1	0	113
22140	1	0	1	107	0	109
22141	0	0	120	3	0	123
22142	2	0	1	124	0	127
22143	0	0	2	125	0	127
22144	0	0	2	128	0	130
22145	127	0	2	2	0	131
22146	132	0	0	1	0	133
22147	3	0	132	0	0	135
22148	129	0	1	3	0	133
22149	132	0	0	2	0	134
22150	1	0	0	134	0	135
22151	138	0	2	1	0	141
22152	1	0	0	140	0	141
22153	0	0	2	136	0	138
22154	0	0	128	2	0	130
22155	123	0	2	2	0	127
22156	1	0	0	138	0	139
22157	2	0	136	1	0	139
22158	1	0	149	0	0	150
22159	0	0	3	150	0	153
22160	2	0	0	157	0	159
22161	160	0	0	2	0	162
22162	1	0	0	159	0	160
22163	2	0	0	157	0	159
22164	0	0	0	159	0	159
22165	0	0	0	165	0	165
22166	182	0	2	2	0	186
22167	185	0	0	1	0	186
22168	183	0	0	3	0	186
22169	184	0	2	0	0	186
22170	1	0	1	196	0	198
22171	197	0	0	2	0	199
22172	1	0	0	200	0	201
22173	201	0	0	2	0	203
22174	2	0	0	201	0	203
22175	2	0	0	198	0	200
22176	0	196	0	2	0	198
22177	0	1	0	195	0	196
22178	194	1	0	2	0	197
22179	186	0	0	3	0	189
22180	3	0	186	0	0	189
22181	3	194	1	0	0	198
22182	197	1	1	1	0	200
22183	3	204	0	0	0	207
22184	200	1	0	2	0	203
22185	3	206	0	0	0	209
22186	1	1	225	2	0	229
22187	0	218	2	2	0	222
22188	0	222	1	0	0	223
22189	1	3	0	227	0	231
22190	228	1	0	3	0	232
22191	5	0	0	226	0	231
22192	2	0	2	230	0	234
22193	227	2	0	5	0	234
22194	238	0	0	2	0	240
22195	4	2	0	238	0	244
22196	3	0	0	239	0	242
22197	1	1	0	241	0	243
22198	237	0	2	4	0	243
22199	2	2	239	1	0	244
22200	2	2	2	243	0	249
22201	0	0	245	4	0	249
22202	2	237	2	1	0	242
22203	0	2	233	2	0	237
22204	0	1	2	223	0	226
22205	2	0	235	2	0	239
22206	223	0	3	1	0	227
22207	2	0	1	233	0	236
22208	1	238	0	5	0	244
22209	2	2	0	240	0	244
22210	2	237	0	3	0	242
22211	0	234	2	1	0	237
22212	0	238	0	2	0	240
22213	0	3	2	213	0	218
22214	1	224	0	2	0	227
22215	220	2	2	2	0	226
22216	3	1	210	2	0	216
22217	2	0	208	0	0	210
22218	3	0	220	1	0	224
22219	1	4	3	224	0	232
22220	0	0	1	206	0	207
22221	1	0	0	210	0	211
22222	0	0	0	210	0	210
22223	1	0	0	201	0	202
22224	1	217	0	3	0	221
22225	1	3	210	2	0	216
22226	2	1	212	1	0	216
22227	2	220	3	0	0	225
22228	0	2	2	223	0	227
22229	1	2	0	223	0	226
22230	3	0	0	223	0	226
22231	225	1	0	3	0	229
22232	3	0	212	3	0	218
22233	208	1	2	1	0	212
22234	216	1	2	0	0	219
22235	4	207	0	1	0	212
22236	2	205	1	1	0	209
22237	210	2	0	1	0	213
22238	3	2	1	208	0	214
22239	1	1	0	209	0	211
22240	1	1	213	3	0	218
22241	2	1	199	3	0	205
22242	1	0	3	211	0	215
22243	214	2	1	4	0	221
22244	3	1	224	1	0	229
22245	230	2	3	1	0	236
22246	6	1	1	231	0	239
22247	3	1	0	235	0	239
22248	4	0	1	244	0	249
22249	0	1	239	4	0	244
22250	1	237	3	2	0	243
22251	1	245	2	2	0	250
22252	251	4	0	3	0	258
22253	250	1	1	4	0	256
22254	6	0	1	248	0	255
22255	252	1	0	5	0	258
22256	6	2	241	1	0	250
22257	2	0	238	0	0	240
22258	1	0	5	227	0	233
22259	229	0	1	6	0	236
22260	6	0	0	235	0	241
22261	2	0	2	238	0	242
22262	229	0	1	6	0	236
22263	245	0	1	3	0	249
22264	7	256	1	0	0	264
22265	268	4	1	3	0	276
22266	6	1	0	247	0	254
22267	3	256	3	3	0	265
22268	259	3	0	3	0	265
22269	4	262	1	1	0	268
22270	2	3	0	251	0	256
22271	246	0	0	7	0	253
22272	4	1	247	1	0	253
22273	2	1	250	0	0	253
22274	0	2	5	251	0	258
22275	1	1	1	258	0	261
22276	3	0	0	244	0	247
22277	1	268	1	5	0	275
22278	276	5	2	2	0	285
22279	273	1	1	1	0	276
22280	286	0	2	2	0	290
22281	5	287	1	9	0	302
22282	3	5	0	310	0	318
22283	3	1	0	312	0	316
22284	3	0	0	312	0	315
22285	300	0	0	8	0	308
22286	6	289	0	1	0	296
22287	2	5	0	291	0	298
22288	2	2	0	293	0	297
22289	1	0	286	6	0	293
22290	2	287	4	2	0	295
22291	2	7	1	284	0	294
22292	1	2	0	288	0	291
22293	2	1	0	296	0	299
22294	275	2	1	7	0	285
22295	6	279	2	1	0	288
22296	278	6	2	2	0	288
22297	5	1	1	279	0	286
22298	280	0	0	9	0	289
22299	5	0	278	3	0	286
22300	273	3	5	1	0	282
22301	293	1	1	3	0	298
22302	8	0	287	3	0	298
22303	5	0	5	294	0	304
22304	3	2	2	288	0	295
22305	296	1	0	9	0	306
22306	8	1	0	297	0	306
22307	4	0	1	291	0	296
22308	2	2	0	292	0	296
22309	1	1	280	9	0	291
22310	260	0	5	6	0	271
22311	6	296	2	4	0	308
22312	4	5	3	292	0	304
22313	0	296	1	8	0	305
22314	0	300	1	7	0	308
22315	3	5	0	307	0	315
22316	0	3	298	8	0	309
22317	2	1	296	3	0	302
22318	1	2	6	300	0	309
22319	2	3	295	7	0	307
22320	295	1	5	5	0	306
22321	7	2	2	314	0	325
22322	4	1	2	308	0	315
22323	3	309	1	7	0	320
22324	4	6	1	306	0	317
22325	3	2	1	299	0	305
22326	0	302	2	10	0	314
22327	0	4	0	316	0	320
22328	2	2	0	315	0	319
22329	2	305	2	8	0	317
22330	316	5	0	6	0	327
22331	4	2	315	5	0	326
22332	3	0	322	5	0	330
22333	2	1	8	323	0	334
22334	2	4	1	337	0	344
22335	3	1	328	9	0	341
22336	1	2	321	4	0	328
22337	306	0	6	1	0	313
22338	6	325	2	4	0	337
22339	323	7	1	5	0	336
22340	9	2	313	0	0	324
22341	1	315	10	2	0	328
22342	7	4	3	318	0	332
22343	0	1	317	7	0	325
22344	3	0	304	2	0	309
22345	3	2	4	312	0	321
22346	0	0	318	8	0	326
22347	2	313	6	4	0	325
22348	0	5	1	311	0	317
22349	3	0	317	7	0	327
22350	0	315	6	2	0	323
22351	306	5	1	5	0	317
22352	4	1	302	4	0	311
22353	2	304	6	0	0	312
22354	2	4	3	301	0	310
22355	1	2	2	319	0	324
22356	310	2	2	7	0	321
22357	7	2	1	303	0	313
22358	1	2	2	313	0	318
22359	305	0	2	7	0	314
22360	4	1	1	302	0	308
22361	2	0	298	7	0	307
22362	2	1	7	296	0	306
22363	1	0	285	7	0	293
22364	2	0	263	4	0	269
22365	1	1	272	3	0	277
22366	3	6	5	242	0	256
22367	0	0	1	263	0	264
22368	257	1	1	8	0	267
22369	8	0	0	250	0	258
22370	0	266	0	6	0	272
22371	2	4	2	280	0	288
22372	0	0	1	276	0	277
22373	0	274	1	4	0	279
22374	265	4	2	1	0	272
22375	267	0	1	1	0	269
22376	3	264	0	2	0	269
22377	1	257	0	2	0	260
22378	3	5	0	248	0	256
22379	248	1	0	4	0	253
22380	4	3	236	1	0	244
22381	1	0	215	2	0	218
22382	197	0	6	4	0	207
22383	3	211	1	1	0	216
22384	1	2	1	216	0	220
22385	2	0	0	213	0	215
22386	0	1	1	216	0	218
22387	1	0	0	218	0	219
22388	0	215	1	3	0	219
22389	1	3	1	213	0	218
22390	211	0	1	3	0	215
22391	4	1	0	212	0	217
22392	0	0	0	219	0	219
22393	212	0	0	3	0	215
22394	204	0	0	2	0	206
22395	216	1	0	1	0	218
22396	217	0	0	2	0	219
22397	4	0	0	217	0	221
22398	217	1	0	6	0	224
22399	6	0	0	217	0	223
22400	214	0	0	5	0	219
22401	210	1	0	1	0	212
22402	2	1	0	220	0	223
22403	1	0	215	4	0	220
22404	215	0	2	0	0	217
22405	217	0	1	1	0	219
22406	218	0	3	1	0	222
22407	227	0	2	1	0	230
22408	3	2	1	234	0	240
22409	1	0	234	4	0	239
22410	1	0	220	2	0	223
22411	210	1	2	3	0	216
22412	218	0	1	3	0	222
22413	1	231	2	0	0	234
22414	1	232	0	2	0	235
22415	247	2	0	1	0	250
22416	2	2	0	249	0	253
22417	2	1	0	257	0	260
22418	254	0	0	6	0	260
22419	3	265	1	2	0	271
22420	276	3	0	4	0	283
22421	4	0	262	2	0	268
22422	262	1	3	2	0	268
22423	4	0	0	270	0	274
22424	0	0	279	3	0	282
22425	3	271	4	0	0	278
22426	1	4	1	284	0	290
22427	0	0	290	5	0	295
22428	0	1	4	280	0	285
22429	301	0	0	6	0	307
22430	4	0	292	2	0	298
22431	281	1	2	1	0	285
22432	5	290	0	2	0	297
22433	1	3	0	297	0	301
22434	2	1	302	2	0	307
22435	1	1	5	295	0	302
22436	3	1	311	5	0	320
22437	3	295	4	0	0	302
22438	297	3	1	2	0	303
22439	3	308	1	1	0	313
22440	2	3	0	314	0	319
22441	3	0	1	318	0	322
22442	0	1	307	5	0	313
22443	254	0	3	5	0	262
22444	4	292	1	1	0	298
22445	1	277	0	1	0	279
22446	1	281	2	0	0	284
22447	2	2	0	274	0	278
22448	1	277	0	4	0	282
22449	1	1	1	278	0	281
22450	1	277	2	1	0	281
22451	1	1	0	280	0	282
22452	0	286	3	1	0	290
22453	286	2	1	3	0	292
22454	2	1	282	1	0	286
22455	264	0	0	4	0	268
22456	269	1	0	4	0	274
22457	277	0	0	3	0	280
22458	1	278	0	0	0	279
22459	280	1	0	2	0	283
22460	282	1	0	1	0	284
22461	287	0	0	3	0	290
22462	1	1	280	0	0	282
22463	1	0	1	284	0	286
22464	1	0	289	1	0	291
22465	1	0	1	276	0	278
22466	268	1	0	3	0	272
22467	2	277	1	0	0	280
22468	1	1	302	0	0	304
22469	1	1	2	311	0	315
22470	0	0	2	336	0	338
22471	0	0	377	5	0	382
22472	372	0	4	1	0	377
22473	390	0	1	1	0	392
22474	399	1	0	2	0	402
22475	5	1	1	405	0	412
22476	1	386	1	5	0	393
22477	0	414	0	2	0	416
22478	1	6	1	419	0	427
22479	3	1	2	413	0	419
22480	2	410	1	6	0	419
22481	413	4	0	4	0	421
22482	5	415	1	2	0	423
22483	3	2	1	407	0	413
22484	2	2	401	3	0	408
22485	2	1	4	407	0	414
22486	402	0	1	5	0	408
22487	4	2	399	3	0	408
22488	406	2	5	2	0	415
22489	413	2	1	4	0	420
22490	418	0	0	4	0	422
22491	422	1	3	3	0	429
22492	436	2	1	3	0	442
22493	7	2	425	3	0	437
22494	5	1	418	1	0	425
22495	453	1	9	3	0	466
22496	462	0	3	5	0	470
22497	14	0	3	491	0	508
22498	8	492	1	7	0	508
22499	7	7	1	499	0	514
22500	507	7	2	10	0	526
22501	12	2	1	487	0	502
22502	8	507	2	7	0	524
22503	505	6	1	8	0	520
22504	501	6	2	5	0	514
22505	509	4	2	5	0	520
22506	16	503	2	1	0	522
22507	10	9	0	500	0	519
22508	5	6	0	500	0	511
22509	0	482	1	15	0	498
22510	4	8	0	506	0	518
22511	496	6	0	13	0	515
22512	500	1	1	8	0	510
22513	14	480	0	2	0	496
22514	11	9	0	476	0	496
22515	2	8	1	480	0	491
22516	6	4	0	483	0	493
22517	465	2	0	18	0	485
22518	9	1	458	9	0	477
22519	431	1	7	5	0	444
22520	11	2	448	1	0	462
22521	8	1	7	431	0	447
22522	2	429	6	12	0	449
22523	3	452	2	9	0	466
22524	443	14	0	6	0	463
22525	436	9	3	3	0	451
22526	15	421	1	4	0	441
22527	8	424	2	3	0	437
22528	432	11	0	3	0	446
22529	442	11	1	3	0	457
22530	14	446	1	0	0	461
22531	456	6	1	0	0	463
22532	11	6	441	1	0	459
22533	441	3	6	2	0	452
22534	442	5	6	2	0	455
22535	16	1	1	437	0	455
22536	10	433	2	7	0	452
22537	4	6	0	441	0	451
22538	446	8	1	9	0	464
22539	11	2	2	431	0	446
22540	12	3	0	443	0	458
22541	5	5	438	15	0	463
22542	8	2	6	455	0	471
22543	5	2	7	456	0	470
22544	449	1	1	16	0	467
22545	11	2	447	10	0	470
22546	449	1	6	8	0	464
22547	8	6	6	450	0	470
22548	7	2	4	457	0	470
22549	6	2	1	458	0	467
22550	4	436	0	18	0	458
22551	8	448	0	9	0	465
22552	3	16	3	444	0	466
22553	444	8	1	11	0	464
22554	453	4	2	12	0	471
22555	18	2	0	444	0	464
22556	455	0	2	10	0	467
22557	12	4	5	446	0	467
22558	16	2	2	447	0	467
22559	426	0	4	20	0	450
22560	15	437	2	11	0	465
22561	437	11	0	4	0	452
22562	434	9	1	6	0	450
22563	424	5	3	6	0	438
22564	13	417	2	7	0	439
22565	13	9	0	421	0	443
22566	5	15	1	418	0	439
22567	2	4	406	18	0	430
22568	3	5	7	382	0	397
22569	6	1	365	10	0	382
22570	5	329	7	10	0	351
22571	11	268	6	2	0	287
22572	4	284	2	2	0	292
22573	5	8	1	289	0	303
22574	5	6	1	275	0	287
22575	0	5	0	288	0	293
22576	2	1	1	289	0	293
22577	2	3	263	14	0	282
22578	2	3	326	8	0	339
22579	1	2	12	330	0	345
22580	2	0	335	11	0	348
22581	329	0	7	9	0	345
22582	331	1	5	8	0	345
22583	14	0	324	3	0	341
22584	10	0	8	324	0	342
22585	3	1	5	334	0	343
22586	4	0	2	341	0	347
22587	2	2	2	323	0	329
22588	6	3	0	332	0	341
22589	248	7	1	14	0	270
22590	325	0	1	11	0	337
22591	12	314	0	6	0	332
22592	8	7	303	2	0	320
22593	3	293	7	5	0	308
22594	1	294	7	3	0	305
22595	260	7	2	4	0	273
22596	5	261	1	3	0	270
22597	0	221	1	0	0	222
22598	219	4	0	0	0	223
22599	4	1	215	0	0	220
22600	203	1	5	1	0	210
22601	6	0	0	204	0	210
22602	0	0	1	202	0	203
22603	1	0	0	202	0	203
22604	0	0	199	6	0	205
22605	0	199	5	1	0	205
22606	203	4	0	2	0	209
22607	5	7	1	198	0	211
22608	0	206	0	3	0	209
22609	1	4	1	212	0	218
22610	0	0	220	3	0	223
22611	0	2	4	216	0	222
22612	1	0	1	221	0	223
22613	2	0	1	227	0	230
22614	225	0	0	5	0	230
22615	5	1	1	227	0	234
22616	0	0	228	6	0	234
22617	2	228	4	2	0	236
22618	0	3	2	234	0	239
22619	1	0	0	235	0	236
22620	0	1	221	7	0	229
22621	1	0	223	2	0	226
22622	215	1	6	3	0	225
22623	215	1	5	1	0	222
22624	5	216	4	2	0	227
22625	220	5	1	1	0	227
22626	7	1	215	2	0	225
22627	3	1	213	2	0	219
22628	210	0	5	4	0	219
22629	187	1	2	6	0	196
22630	7	0	188	5	0	200
22631	190	1	5	3	0	199
22632	7	0	189	3	0	199
22633	190	0	6	5	0	201
22634	199	2	2	1	0	204
22635	7	1	1	185	0	194
22636	3	214	2	5	0	224
22637	160	8	2	5	0	175
22638	5	1	218	2	0	226
22639	3	224	5	2	0	234
22640	218	7	1	0	0	226
22641	216	4	1	3	0	224
22642	7	219	2	2	0	230
22643	6	4	2	217	0	229
22644	3	1	220	6	0	230
22645	2	3	4	219	0	228
22646	3	0	218	8	0	229
22647	0	1	7	222	0	230
22648	0	2	2	220	0	224
22649	2	1	212	7	0	222
22650	2	211	5	3	0	221
22651	4	6	1	208	0	219
22652	2	3	171	9	0	185
22653	210	3	2	2	0	217
22654	7	1	2	216	0	226
22655	4	1	2	221	0	228
22656	217	2	1	8	0	228
22657	7	2	0	216	0	225
22658	4	1	2	212	0	219
22659	3	213	3	6	0	225
22660	4	4	2	215	0	225
22661	2	3	214	5	0	224
22662	0	3	4	203	0	210
22663	2	208	2	7	0	219
22664	0	212	6	4	0	222
22665	3	4	3	212	0	222
22666	214	2	2	3	0	221
22667	7	3	0	214	0	224
22668	216	3	0	7	0	226
22669	8	2	2	210	0	222
22670	214	0	5	7	0	226
22671	223	2	3	4	0	232
22672	8	0	2	218	0	228
22673	10	16	1	198	0	225
22674	4	210	3	8	0	225
22675	3	206	4	5	0	218
22676	3	7	204	1	0	215
22677	4	207	5	4	0	220
22678	131	1	1	2	0	135
22679	0	2	4	126	0	132
22680	1	132	3	0	0	136
22681	134	0	0	1	0	135
22682	2	1	1	136	0	140
22683	1	3	0	131	0	135
22684	4	0	0	135	0	139
22685	1	0	2	138	0	141
22686	0	149	2	2	0	153
22687	1	157	1	3	0	162
22688	161	1	1	0	0	163
22689	1	164	2	1	0	168
22690	3	1	1	165	0	170
22691	1	1	2	161	0	165
22692	4	0	0	161	0	165
22693	2	1	0	164	0	167
22694	163	2	0	4	0	169
22695	158	2	1	3	0	164
22696	2	1	160	0	0	163
22697	3	0	3	161	0	167
22698	0	2	167	3	0	172
22699	1	1	2	168	0	172
22700	4	0	1	169	0	174
22701	171	2	0	4	0	177
22702	2	0	0	174	0	176
22703	1	1	174	3	0	179
22704	0	0	165	4	0	169
22705	159	1	5	0	0	165
22706	2	1	171	3	0	177
22707	2	0	2	166	0	170
22708	0	2	169	2	0	173
22709	1	0	2	160	0	163
22710	1	163	1	2	0	167
22711	0	3	0	160	0	163
22712	2	162	0	3	0	167
22713	1	159	0	2	0	162
22714	2	6	0	159	0	167
22715	159	0	1	3	0	163
22716	2	157	1	2	0	162
22717	1	2	1	159	0	163
22718	157	0	0	6	0	163
22719	161	0	0	3	0	164
22720	162	1	0	0	0	163
22721	2	1	0	163	0	166
22722	0	0	0	163	0	163
22723	162	1	1	3	0	167
22724	164	0	0	2	0	166
22725	169	0	1	1	0	171
22726	2	0	0	172	0	174
22727	0	0	171	3	0	174
22728	171	0	2	1	0	174
22729	3	1	0	172	0	176
22730	0	174	1	3	0	178
22731	2	3	0	173	0	178
22732	0	181	2	2	0	185
22733	1	1	0	179	0	181
22734	2	1	174	3	0	180
22735	1	176	3	0	0	180
22736	0	3	0	158	0	161
22737	0	1	2	150	0	153
22738	2	0	1	156	0	159
22739	153	1	0	3	0	157
22740	3	148	1	2	0	154
22741	0	2	0	157	0	159
22742	160	0	2	3	0	165
22743	158	0	1	2	0	161
22744	5	0	0	161	0	166
22745	1	0	158	4	0	163
22746	0	0	3	154	0	157
22747	1	156	2	3	0	162
22748	0	2	1	160	0	163
22749	158	2	0	4	0	164
22750	3	1	0	175	0	179
22751	1	2	177	3	0	183
22752	0	188	2	2	0	192
22753	192	2	2	1	0	197
22754	4	1	192	0	0	197
22755	186	1	2	4	0	193
22756	2	0	1	194	0	197
22757	2	0	0	193	0	195
22758	2	193	1	2	0	198
22759	200	3	0	2	0	205
22760	3	1	0	205	0	209
22761	3	0	1	208	0	212
22762	3	1	0	218	0	222
22763	1	1	219	4	0	225
22764	3	1	3	218	0	225
22765	223	0	0	5	0	228
22766	224	2	1	1	0	228
22767	5	0	0	229	0	234
22768	4	0	0	221	0	225
22769	226	2	0	4	0	232
22770	2	0	223	2	0	227
22771	221	2	2	3	0	228
22772	3	0	214	2	0	219
22773	1	0	220	1	0	222
22774	1	1	2	217	0	221
22775	1	0	229	3	0	233
22776	230	0	2	1	0	233
22777	4	0	1	245	0	250
22778	2	0	239	4	0	245
22779	231	0	3	1	0	235
22780	237	1	0	2	0	240
22781	2	0	279	2	0	283
22782	1	0	2	268	0	271
22783	0	279	1	3	0	283
22784	286	2	1	2	0	291
22785	3	2	287	0	0	292
22786	257	0	2	0	0	259
22787	2	283	0	1	0	286
22788	270	1	1	2	0	274
22789	271	0	1	3	0	275
22790	272	0	1	1	0	274
22791	4	0	0	282	0	286
22792	1	279	1	2	0	283
22793	1	1	277	0	0	279
22794	0	284	1	3	0	288
22795	2	1	2	269	0	274
22796	1	285	0	1	0	287
22797	0	288	0	0	0	288
22798	278	0	1	4	0	283
22799	2	1	280	0	0	283
22800	2	0	287	1	0	290
22801	0	0	281	1	0	282
22802	0	297	0	2	0	299
22803	291	1	0	4	0	296
22804	289	0	1	2	0	292
22805	285	0	1	3	0	289
22806	2	285	0	1	0	288
22807	1	1	0	304	0	306
22808	1	1	298	1	0	301
22809	2	0	286	1	0	289
22810	297	0	0	3	0	300
22811	305	0	1	5	0	311
22812	307	1	0	2	0	310
22813	0	0	300	0	0	300
22814	298	1	0	1	0	300
22815	1	0	0	307	0	308
22816	1	1	1	307	0	310
22817	1	1	322	1	0	325
22818	1	316	1	2	0	320
22819	1	0	2	332	0	335
22820	1	0	331	0	0	332
22821	312	0	1	2	0	315
22822	0	1	2	336	0	339
22823	1	0	1	332	0	334
22824	336	1	0	2	0	339
22825	2	0	1	335	0	338
22826	332	1	1	1	0	335
22827	327	0	0	3	0	330
22828	0	1	2	327	0	330
22829	3	0	1	316	0	320
22830	335	0	0	0	0	335
22831	2	1	1	326	0	330
22832	339	0	0	4	0	343
22833	328	2	1	2	0	333
22834	332	0	1	0	0	333
22835	0	1	0	334	0	335
22836	2	0	0	322	0	324
22837	331	1	1	1	0	334
22838	1	325	0	0	0	326
22839	2	319	0	1	0	322
22840	322	0	2	1	0	325
22841	1	0	309	0	0	310
22842	304	0	1	2	0	307
22843	1	1	2	329	0	333
22844	2	0	328	0	0	330
22845	329	1	0	1	0	331
22846	2	0	0	342	0	344
22847	1	1	0	337	0	339
22848	0	0	0	366	0	366
22849	1	0	1	357	0	359
22850	340	0	1	5	0	346
22851	1	341	0	1	0	343
22852	325	0	0	0	0	325
22853	2	0	316	0	0	318
22854	2	0	308	0	0	310
22855	1	335	0	1	0	337
22856	0	1	0	342	0	343
22857	1	0	328	1	0	330
22858	0	306	0	1	0	307
22859	0	0	322	0	0	322
22860	0	0	0	311	0	311
22861	2	0	0	317	0	319
22862	318	0	0	1	0	319
22863	1	0	0	312	0	313
22864	314	0	0	1	0	315
22865	0	0	300	0	0	300
22866	0	316	0	0	0	316
22867	1	0	0	334	0	335
22868	1	0	0	353	0	354
22869	0	0	367	0	0	367
22870	0	0	334	0	0	334
22871	334	0	1	2	0	337
22872	363	0	0	3	0	366
22873	0	1	0	363	0	364
22874	3	1	0	354	0	358
22875	1	355	0	0	0	356
22876	0	0	1	372	0	373
22877	361	0	0	2	0	363
22878	359	0	0	1	0	360
22879	0	362	1	0	0	363
22880	366	1	0	2	0	369
22881	338	0	0	0	0	338
22882	3	0	0	355	0	358
22883	0	374	0	6	0	380
22884	0	5	0	381	0	386
22885	1	0	0	375	0	376
22886	0	1	369	5	0	375
22887	355	0	5	1	0	361
22888	4	0	1	381	0	386
22889	0	0	1	407	0	408
22890	2	444	0	4	0	450
22891	1	5	0	469	0	475
22892	473	0	1	11	0	485
22893	500	1	0	3	0	504
22894	14	1	484	0	0	499
22895	2	0	487	1	0	490
22896	3	1	15	506	0	525
22897	2	0	1	537	0	540
22898	1	0	527	18	0	546
22899	2	0	529	3	0	534
22900	2	0	20	489	0	511
22901	2	1	546	16	0	565
22902	1	6	528	4	0	539
22903	2	0	18	533	0	553
22904	550	0	4	19	0	573
22905	557	1	2	5	0	565
22906	22	0	3	542	0	567
22907	8	0	2	545	0	555
22908	535	0	2	22	0	559
22909	20	1	3	533	0	557
22910	529	2	2	22	0	555
22911	546	0	1	10	0	557
22912	26	2	0	528	0	556
22913	6	0	0	549	0	555
22914	527	2	2	22	0	553
22915	20	518	1	6	0	545
22916	5	546	3	5	0	559
22917	6	15	4	544	0	569
22918	4	6	533	23	0	566
22919	4	2	18	534	0	558
22920	537	1	3	25	0	566
22921	20	3	1	540	0	564
22922	538	1	1	24	0	564
22923	21	3	540	7	0	571
22924	538	1	18	7	0	564
22925	21	2	5	535	0	563
22926	11	1	2	554	0	568
22927	4	0	549	27	0	580
22928	9	1	19	554	0	583
22929	8	1	6	580	0	595
22930	6	1	2	588	0	597
22931	561	2	5	32	0	600
22932	18	2	559	14	0	593
22933	5	2	565	8	0	580
22934	560	0	24	16	0	600
22935	589	0	8	4	0	601
22936	27	1	585	7	0	620
22937	13	1	24	565	0	603
22938	4	595	10	23	0	632
22939	5	17	2	615	0	639
22940	603	4	8	25	0	640
22941	612	0	7	13	0	632
22942	28	1	6	604	0	639
22943	6	591	5	29	0	631
22944	10	19	7	576	0	612
22945	3	590	5	24	0	622
22946	593	20	1	14	0	628
22947	592	6	3	3	0	604
22948	579	1	4	12	0	596
22949	25	544	2	11	0	582
22950	12	572	3	10	0	597
22951	7	26	4	579	0	616
22952	6	5	1	600	0	612
22953	17	5	0	573	0	595
22954	8	1	5	592	0	606
22955	5	3	558	37	0	603
22956	531	2	20	13	0	566
22957	26	4	567	11	0	608
22958	560	9	20	8	0	597
22959	22	4	569	11	0	606
22960	572	3	22	9	0	606
22961	22	0	591	14	0	627
22962	578	1	20	10	0	609
22963	27	2	11	584	0	624
22964	586	3	3	30	0	622
22965	26	6	8	586	0	626
22966	14	0	3	599	0	616
22967	12	1	5	582	0	600
22968	4	558	6	34	0	602
22969	553	19	9	15	0	596
22970	565	4	8	11	0	588
22971	33	550	1	8	0	592
22972	9	18	6	554	0	587
22973	16	4	551	31	0	602
22974	545	3	21	11	0	580
22975	576	2	9	12	0	599
22976	570	5	7	10	0	592
22977	36	3	2	539	0	580
22978	13	532	5	29	0	579
22979	8	19	6	536	0	569
22980	531	7	1	27	0	566
22981	22	6	3	520	0	551
22982	11	510	4	18	0	543
22983	496	17	3	5	0	521
22984	23	5	490	3	0	521
22985	10	4	482	7	0	503
22986	4	472	19	7	0	502
22987	3	478	5	8	0	494
22988	3	21	463	7	0	494
22989	12	5	427	4	0	448
22990	8	15	15	358	0	396
22991	359	2	15	12	0	388
22992	9	2	363	7	0	381
22993	4	341	7	2	0	354
22994	330	7	5	5	0	347
22995	9	326	1	0	0	336
22996	304	4	0	2	0	310
22997	2	305	1	0	0	308
22998	2	304	1	6	0	313
22999	0	2	2	309	0	313
23000	1	1	2	307	0	311
23001	0	1	288	3	0	292
23002	0	2	2	281	0	285
23003	280	0	2	5	0	287
23004	280	1	1	1	0	283
23005	5	0	0	281	0	286
23006	2	1	278	2	0	283
23007	0	1	276	1	0	278
23008	1	1	2	276	0	280
23009	1	0	281	3	0	285
23010	0	1	3	278	0	282
23011	1	0	0	274	0	275
23012	1	0	295	3	0	299
23013	290	1	2	1	0	294
23014	294	0	1	4	0	299
23015	3	0	297	1	0	301
23016	0	0	293	0	0	293
23017	1	0	4	313	0	318
23018	1	0	2	347	0	350
23019	3	0	0	361	0	364
23020	2	0	0	371	0	373
23021	363	0	3	8	0	374
23022	389	0	3	2	0	394
23023	14	0	0	408	0	422
23024	2	0	2	434	0	438
23025	0	0	480	13	0	493
23026	6	0	12	488	0	506
23027	3	0	6	524	0	533
23028	541	0	3	20	0	564
23029	19	582	2	13	0	616
23030	9	21	3	594	0	627
23031	9	6	2	614	0	631
23032	5	2	1	616	0	624
23033	3	552	1	33	0	589
23034	4	595	1	12	0	612
23035	4	25	1	586	0	616
23036	4	6	0	594	0	604
23037	3	5	0	594	0	602
23038	535	4	0	37	0	576
23039	21	547	1	18	0	587
23040	550	23	1	12	0	586
23041	571	7	1	11	0	590
23042	32	10	0	539	0	581
23043	14	523	0	22	0	559
23044	528	24	1	9	0	562
23045	28	8	1	533	0	570
23046	536	3	1	29	0	569
23047	28	2	3	541	0	574
23048	12	5	523	27	0	567
23049	6	3	543	12	0	564
23050	7	1	25	533	0	566
23051	4	1	9	535	0	549
23052	5	2	6	533	0	546
23053	4	486	4	31	0	525
23054	3	538	4	11	0	556
23055	513	27	3	11	0	554
23056	527	10	1	8	0	546
23057	25	502	1	9	0	537
23058	10	502	1	8	0	521
23059	5	537	1	5	0	548
23060	494	30	0	4	0	528
23061	24	496	0	2	0	522
23062	12	25	1	499	0	537
23063	499	10	3	24	0	536
23064	521	8	0	13	0	542
23065	32	4	0	491	0	527
23066	12	2	488	25	0	527
23067	7	4	510	11	0	532
23068	7	2	23	486	0	518
23069	4	2	504	27	0	537
23070	7	1	26	507	0	541
23071	5	2	11	524	0	542
23072	2	2	504	35	0	543
23073	2	1	523	15	0	541
23074	6	2	29	498	0	535
23075	4	4	10	534	0	552
23076	498	1	8	35	0	542
23077	21	496	7	13	0	537
23078	10	534	3	9	0	556
23079	511	31	3	12	0	557
23080	532	11	2	10	0	555
23081	27	505	1	9	0	542
23082	15	529	2	7	0	553
23083	517	30	2	3	0	552
23084	32	13	0	510	0	555
23085	506	6	0	32	0	544
23086	30	509	4	10	0	553
23087	522	26	4	7	0	559
23088	27	9	505	12	0	553
23089	507	6	21	9	0	543
23090	35	4	504	7	0	550
23091	14	6	24	505	0	549
23092	503	3	8	33	0	547
23093	25	2	497	18	0	542
23094	11	3	29	513	0	556
23095	508	5	10	30	0	553
23096	25	6	497	16	0	544
23097	15	2	24	505	0	546
23098	487	5	8	34	0	534
23099	25	493	5	16	0	539
23100	12	24	5	502	0	543
23101	13	9	2	505	0	529
23102	8	8	2	515	0	533
23103	8	486	2	35	0	531
23104	11	24	0	504	0	539
23105	10	9	0	527	0	546
23106	11	7	1	523	0	542
23107	13	4	2	531	0	550
23108	6	8	489	37	0	540
23109	481	4	23	20	0	528
23110	501	2	10	19	0	532
23111	32	488	6	14	0	540
23112	16	23	5	477	0	521
23113	9	8	5	485	0	507
23114	5	469	3	33	0	510
23115	9	22	5	473	0	509
23116	448	8	1	29	0	486
23117	24	437	5	12	0	478
23118	412	20	4	10	0	446
23119	23	8	1	394	0	426
23120	10	4	385	24	0	423
23121	5	389	17	12	0	423
23122	340	24	10	11	0	385
23123	20	337	4	2	0	363
23124	6	351	0	4	0	361
23125	259	17	2	6	0	284
23126	16	5	258	2	0	281
23127	3	227	14	1	0	245
23128	174	13	3	6	0	196
23129	133	1	8	3	0	145
23130	4	130	0	0	0	134
23131	1	4	0	129	0	134
23132	1	1	140	3	0	145
23133	0	0	4	144	0	148
23134	1	1	1	137	0	140
23135	1	1	0	147	0	149
23136	2	1	157	4	0	164
23137	0	1	3	153	0	157
23138	1	2	154	4	0	161
23139	1	2	154	1	0	158
23140	142	0	5	3	0	150
23141	5	151	1	0	0	157
23142	1	156	1	1	0	159
23143	2	4	0	155	0	161
23144	175	1	1	5	0	182
23145	183	0	2	1	0	186
23146	171	1	1	3	0	176
23147	174	0	0	1	0	175
23148	170	1	0	0	0	171
23149	4	1	163	1	0	169
23150	2	0	3	161	0	166
23151	1	160	2	4	0	167
23152	0	4	1	165	0	170
23153	169	1	0	7	0	177
23154	5	166	0	1	0	172
23155	1	5	0	172	0	178
23156	180	1	0	6	0	187
23157	201	0	1	3	0	205
23158	4	0	0	207	0	211
23159	3	1	0	209	0	213
23160	0	1	0	212	0	213
23161	0	0	205	6	0	211
23162	0	0	201	3	0	204
23163	0	2	5	211	0	218
23164	0	1	3	218	0	222
23165	218	0	0	4	0	222
23166	219	2	2	3	0	226
23167	225	3	0	1	0	229
23168	229	0	0	5	0	234
23169	211	0	1	2	0	214
23170	5	209	0	0	0	214
23171	213	3	0	3	0	219
23172	219	2	1	3	0	225
23173	225	2	0	1	0	228
23174	8	0	1	225	0	234
23175	1	1	217	6	0	225
23176	0	1	6	217	0	224
23177	0	1	240	6	0	247
23178	1	1	5	229	0	236
23179	0	230	2	4	0	236
23180	236	4	0	4	0	244
23181	244	1	1	0	0	246
23182	6	2	0	244	0	252
23183	1	0	0	264	0	265
23184	1	0	0	268	0	269
23185	2	266	0	5	0	273
23186	277	4	1	2	0	284
23187	272	1	1	4	0	278
23188	6	282	0	2	0	290
23189	2	4	2	284	0	292
23190	1	1	1	294	0	297
23191	0	281	0	6	0	287
23192	285	3	1	4	0	293
23193	289	1	0	0	0	290
23194	7	1	0	274	0	282
23195	2	1	270	5	0	278
23196	3	1	254	1	0	259
23197	2	0	4	283	0	289
23198	1	1	1	285	0	288
23199	1	0	0	304	0	305
23200	294	0	1	8	0	303
23201	297	0	1	4	0	302
23202	7	300	2	1	0	310
23203	299	5	1	3	0	308
23204	6	3	308	2	0	319
23205	4	0	313	0	0	317
23206	2	328	9	1	0	340
23207	331	8	3	2	0	344
23208	7	322	2	0	0	331
23209	329	6	1	4	0	340
23210	6	2	316	1	0	325
23211	2	1	322	1	0	326
23212	3	0	8	310	0	321
23213	1	2	346	7	0	356
23214	3	1	6	342	0	352
23215	5	0	3	315	0	323
23216	1	354	1	8	0	364
23217	0	5	1	363	0	369
23218	1	1	1	371	0	374
23219	371	2	0	12	0	385
23220	10	368	0	2	0	380
23221	6	8	0	381	0	395
23222	1	1	377	11	0	390
23223	318	1	9	5	0	333
23224	8	2	364	1	0	375
23225	3	1	9	352	0	365
23226	0	370	1	10	0	381
23227	2	10	1	366	0	379
23228	384	0	0	9	0	393
23229	382	0	2	6	0	390
23230	11	387	1	3	0	402
23231	411	11	3	1	0	426
23232	430	1	2	6	0	439
23233	439	1	2	1	0	443
23234	435	1	0	6	0	442
23235	419	1	1	4	0	425
23236	12	2	417	3	0	434
23237	5	1	11	415	0	432
23238	1	3	2	415	0	421
23239	1	2	2	431	0	436
23240	2	420	2	11	0	435
23241	5	11	2	425	0	443
23242	1	2	429	12	0	444
23243	0	428	11	4	0	443
23244	1	416	3	2	0	422
23245	1	11	0	420	0	432
23246	2	1	2	429	0	434
23247	3	0	2	423	0	428
23248	2	409	1	9	0	421
23249	1	424	0	4	0	429
23250	410	12	1	6	0	429
23251	421	3	0	3	0	427
23252	11	418	2	3	0	434
23253	430	11	1	3	0	445
23254	437	4	1	3	0	445
23255	13	1	1	445	0	460
23256	3	2	1	445	0	451
23257	2	1	2	443	0	448
23258	3	1	418	12	0	434
23259	1	0	416	5	0	422
23260	1	445	12	4	0	462
23261	452	12	3	3	0	470
23262	10	3	450	3	0	466
23263	453	1	11	4	0	469
23264	12	2	481	1	0	496
23265	467	3	12	3	0	485
23266	11	493	4	1	0	509
23267	497	12	1	4	0	514
23268	16	4	1	487	0	508
23269	9	1	1	506	0	517
23270	3	3	508	12	0	526
23271	3	509	13	2	0	527
23272	6	9	4	506	0	525
23273	4	2	504	14	0	524
23274	478	2	10	4	0	494
23275	10	494	2	4	0	510
23276	489	9	2	3	0	503
23277	6	469	2	3	0	480
23278	5	9	2	477	0	493
23279	470	2	2	15	0	489
23280	9	476	2	3	0	490
23281	4	10	0	482	0	496
23282	2	5	476	10	0	493
23283	440	2	7	5	0	454
23284	14	3	2	459	0	478
23285	7	2	453	8	0	470
23286	3	463	8	6	0	480
23287	7	7	4	445	0	463
23288	4	4	445	8	0	461
23289	5	3	9	435	0	452
23290	2	464	3	12	0	481
23291	1	478	2	5	0	486
23292	2	10	461	4	0	477
23293	3	5	10	461	0	479
23294	2	1	472	12	0	487
23295	460	5	10	3	0	478
23296	15	2	3	456	0	476
23297	3	443	3	10	0	459
23298	1	462	1	7	0	471
23299	449	10	1	3	0	463
23300	8	471	2	3	0	484
23301	463	8	1	5	0	477
23302	8	4	467	2	0	481
23303	435	2	16	4	0	457
23304	8	446	7	0	0	461
23305	456	7	0	3	0	466
23306	8	443	0	2	0	453
23307	6	8	0	430	0	444
23308	10	3	0	440	0	453
23309	2	1	441	10	0	454
23310	415	0	6	8	0	429
23311	5	1	455	0	0	461
23312	451	0	6	2	0	459
23313	7	2	3	440	0	452
23314	5	0	0	448	0	453
23315	0	458	2	7	0	467
23316	5	6	0	453	0	464
23317	1	4	1	450	0	456
23318	2	1	445	7	0	455
23319	404	1	4	4	0	413
23320	5	428	5	1	0	439
23321	424	5	0	2	0	431
23322	4	3	1	421	0	429
23323	3	0	0	420	0	423
23324	415	1	1	9	0	426
23325	5	416	1	4	0	426
23326	409	6	1	1	0	417
23327	6	406	3	1	0	416
23328	1	393	0	0	0	394
23329	399	6	0	3	0	408
23330	4	2	3	390	0	399
23331	2	0	384	4	0	390
23332	2	0	4	350	0	356
23333	2	0	2	352	0	356
23334	0	347	0	5	0	352
23335	4	5	0	346	0	355
23336	1	3	0	351	0	355
23337	1	1	0	353	0	355
23338	3	0	0	355	0	358
23339	0	0	354	8	0	362
23340	0	2	362	2	0	366
23341	3	0	7	348	0	358
23342	0	0	364	6	0	370
23343	0	1	360	2	0	363
23344	1	0	7	367	0	375
23345	0	1	396	5	0	402
23346	0	0	5	385	0	390
23347	0	383	3	6	0	392
23348	398	5	2	7	0	412
23349	5	4	412	0	0	421
23350	5	0	5	402	0	412
23351	0	0	438	5	0	443
23352	3	0	7	462	0	472
23353	4	1	3	459	0	467
23354	460	1	1	14	0	476
23355	11	1	1	473	0	486
23356	467	1	0	17	0	485
23357	484	0	1	8	0	493
23358	18	487	1	0	0	506
23359	478	13	0	3	0	494
23360	12	482	1	2	0	497
23361	3	505	0	1	0	509
23362	468	17	0	3	0	488
23363	14	6	458	1	0	479
23364	4	0	440	1	0	445
23365	418	0	26	3	0	447
23366	447	0	4	2	0	453
23367	16	440	0	1	0	457
23368	459	13	0	1	0	473
23369	467	7	0	2	0	476
23370	468	1	0	4	0	473
23371	18	0	0	463	0	481
23372	458	3	1	15	0	477
23373	16	467	0	5	0	488
23374	8	13	3	486	0	510
23375	4	3	4	493	0	504
23376	2	489	1	18	0	510
23377	7	13	1	497	0	518
23378	491	7	0	15	0	513
23379	501	1	1	7	0	510
23380	19	484	0	2	0	505
23381	6	492	2	1	0	501
23382	488	15	0	4	0	507
23383	14	5	474	2	0	495
23384	5	3	469	1	0	478
23385	3	1	17	462	0	483
23386	2	1	4	482	0	489
23387	2	1	460	19	0	482
23388	0	445	14	7	0	466
23389	9	14	4	422	0	449
23390	6	4	455	13	0	478
23391	4	2	15	453	0	474
23392	4	3	5	459	0	471
23393	2	471	0	17	0	490
23394	7	13	2	475	0	497
23395	5	5	4	480	0	494
23396	1	0	2	498	0	501
23397	480	0	2	24	0	506
23398	16	0	2	471	0	489
23399	5	489	1	13	0	508
23400	483	13	0	7	0	503
23401	13	5	472	2	0	492
23402	5	1	472	2	0	480
23403	463	0	16	4	0	483
23404	13	4	3	475	0	495
23405	6	1	474	14	0	495
23406	2	2	12	474	0	490
23407	2	1	4	495	0	502
23408	479	1	0	22	0	502
23409	482	2	1	6	0	491
23410	17	479	1	4	0	501
23411	9	12	1	464	0	486
23412	4	4	470	9	0	487
23413	0	484	12	8	0	504
23414	490	10	3	3	0	506
23415	16	509	1	3	0	529
23416	504	12	3	7	0	526
23417	12	3	507	5	0	527
23418	492	1	13	5	0	511
23419	535	3	3	3	0	544
23420	17	1	551	3	0	572
23421	7	6	13	544	0	570
23422	1	545	4	18	0	568
23423	3	589	3	7	0	602
23424	4	603	3	3	0	613
23425	7	19	2	581	0	609
23426	3	8	606	15	0	632
23427	9	3	14	592	0	618
23428	6	3	5	625	0	639
23429	4	3	603	20	0	630
23430	7	600	17	4	0	628
23431	6	15	5	596	0	622
23432	597	4	2	21	0	624
23433	17	2	3	608	0	630
23434	6	4	1	606	0	617
23435	2	614	2	19	0	637
23436	611	14	0	6	0	631
23437	18	4	2	636	0	660
23438	4	3	633	17	0	657
23439	2	617	13	9	0	641
23440	618	12	6	6	0	642
23441	16	8	619	1	0	644
23442	602	4	17	6	0	629
23443	15	6	1	610	0	632
23444	6	605	2	17	0	630
23445	592	16	6	9	0	623
23446	600	5	1	4	0	610
23447	20	633	2	3	0	658
23448	7	15	3	627	0	652
23449	3	4	3	637	0	647
23450	612	6	1	19	0	638
23451	18	614	3	3	0	638
23452	7	8	2	575	0	592
23453	2	568	2	8	0	580
23454	1	574	0	4	0	579
23455	8	9	0	533	0	550
23456	530	1	1	9	0	541
23457	8	534	2	1	0	545
23458	3	5	0	529	0	537
23459	2	2	1	529	0	534
23460	2	1	526	6	0	535
23461	2	2	491	2	0	497
23462	1	505	6	2	0	514
23463	1	7	498	4	0	510
23464	2	2	6	493	0	503
23465	1	3	511	8	0	523
23466	1	4	7	506	0	518
23467	2	1	1	521	0	525
23468	3	3	1	511	0	518
23469	503	2	4	10	0	519
23470	7	3	1	498	0	509
23471	4	1	2	496	0	503
23472	2	488	2	6	0	498
23473	3	5	0	489	0	497
23474	476	0	0	13	0	489
23475	6	480	2	3	0	491
23476	484	8	0	2	0	494
23477	6	2	475	4	0	487
23478	3	3	504	0	0	510
23479	2	3	5	512	0	522
23480	4	0	0	523	0	527
23481	1	522	2	7	0	532
23482	9	6	1	483	0	499
23483	519	1	1	13	0	534
23484	516	1	2	7	0	526
23485	8	4	0	523	0	535
23486	2	2	579	9	0	592
23487	2	3	5	573	0	583
23488	4	1	0	574	0	579
23489	2	2	0	599	0	603
23490	3	2	2	586	0	593
23491	2	1	2	589	0	594
23492	2	580	4	11	0	597
23493	576	11	3	5	0	595
23494	582	2	1	7	0	592
23495	580	1	3	9	0	593
23496	9	581	1	3	0	594
23497	576	7	1	8	0	592
23498	9	571	2	5	0	587
23499	4	9	564	3	0	580
23500	3	2	7	542	0	554
23501	4	2	569	10	0	585
23502	2	565	6	5	0	578
23503	558	8	5	6	0	577
23504	7	4	576	5	0	592
23505	2	3	619	3	0	627
23506	2	645	11	3	0	661
23507	2	10	8	659	0	679
23508	6	7	698	10	0	721
23509	6	2	15	686	0	709
23510	1	2	10	756	0	769
23511	4	3	4	791	0	802
23512	831	1	3	27	0	862
23513	844	3	3	17	0	867
23514	22	2	2	836	0	862
23515	816	2	0	23	0	841
23516	19	2	812	10	0	843
23517	10	1	808	10	0	829
23518	8	1	821	6	0	836
23519	7	1	826	5	0	839
23520	4	808	19	9	0	840
23521	5	8	15	797	0	825
23522	3	5	828	9	0	845
23523	749	4	16	10	0	779
23524	803	2	11	9	0	825
23525	16	803	5	7	0	831
23526	788	14	4	8	0	814
23527	18	5	8	784	0	815
23528	12	4	816	10	0	842
23529	17	2	17	759	0	795
23530	6	836	10	12	0	864
23531	812	14	5	12	0	843
23532	834	6	7	8	0	855
23533	16	829	10	5	0	860
23534	832	14	5	6	0	857
23535	825	10	4	6	0	845
23536	21	826	5	2	0	854
23537	20	12	1	795	0	828
23538	9	808	3	16	0	836
23539	812	16	7	13	0	848
23540	20	9	2	805	0	836
23541	808	8	2	17	0	835
23542	21	6	4	803	0	834
23543	14	6	770	15	0	805
23544	773	8	8	15	0	804
23545	23	2	787	6	0	818
23546	17	3	14	771	0	805
23547	9	8	765	13	0	795
23548	11	2	16	761	0	790
23549	11	6	775	9	0	801
23550	745	5	14	15	0	779
23551	12	753	11	13	0	789
23552	753	11	6	8	0	778
23553	15	10	7	763	0	795
23554	751	3	8	18	0	780
23555	21	755	5	7	0	788
23556	13	738	7	10	0	768
23557	7	806	5	11	0	829
23558	815	17	5	12	0	849
23559	14	10	7	837	0	868
23560	14	7	8	826	0	855
23561	9	8	802	19	0	838
23562	7	13	789	9	0	818
23563	16	2	17	820	0	855
23564	11	1	838	18	0	868
23565	5	835	15	13	0	868
23566	823	15	11	10	0	859
23567	14	14	842	5	0	875
23568	14	9	817	3	0	843
23569	13	5	20	825	0	863
23570	844	7	11	24	0	886
23571	21	5	4	854	0	884
23572	859	2	11	20	0	892
23573	20	2	13	854	0	889
23574	9	3	881	24	0	917
23575	10	879	20	10	0	919
23576	9	15	896	9	0	929
23577	8	902	17	12	0	939
23578	6	18	21	868	0	913
23579	865	10	14	17	0	906
23580	16	6	862	13	0	897
23581	12	8	17	846	0	883
23582	11	6	13	875	0	905
23583	873	3	2	29	0	907
23584	15	0	9	843	0	867
23585	11	851	11	20	0	893
23586	818	14	5	16	0	853
23587	16	11	808	11	0	846
23588	795	11	10	9	0	825
23589	22	813	7	6	0	848
23590	25	14	7	768	0	814
23591	8	818	10	12	0	848
23592	815	16	1	21	0	853
23593	15	13	827	10	0	865
23594	775	10	13	15	0	813
23595	19	813	6	11	0	849
23596	17	16	4	839	0	876
23597	842	7	6	21	0	876
23598	847	5	7	12	0	871
23599	25	4	7	836	0	872
23600	19	6	4	835	0	864
23601	9	833	5	21	0	868
23602	12	18	3	856	0	889
23603	12	965	6	18	0	1001
23604	6	1021	8	16	0	1051
23605	6	23	4	963	0	996
23606	5	998	4	17	0	1024
23607	9	22	989	12	0	1032
23608	13	12	1041	5	0	1071
23609	8	1049	24	9	0	1090
23610	5	15	1057	9	0	1086
23611	8	14	1058	5	0	1085
23612	5	6	995	2	0	1008
23613	1	957	33	3	0	994
23614	926	17	23	8	0	974
23615	15	964	10	0	0	989
23616	11	19	943	0	0	973
23617	8	17	18	904	0	947
23618	919	4	14	20	0	957
23619	16	7	904	12	0	939
23620	18	2	21	894	0	935
23621	5	1	916	16	0	938
23622	12	4	18	886	0	920
23623	860	2	19	23	0	904
23624	15	2	885	17	0	919
23625	14	889	23	3	0	929
23626	7	17	15	864	0	903
23627	906	11	6	20	0	943
23628	14	6	893	12	0	925
23629	16	9	16	828	0	869
23630	5	859	15	17	0	896
23631	869	18	4	12	0	903
23632	869	15	7	5	0	896
23633	27	2	4	862	0	895
23634	14	871	4	15	0	904
23635	8	918	5	14	0	945
23636	917	28	3	6	0	954
23637	21	15	6	912	0	954
23638	14	926	3	21	0	964
23639	942	24	2	13	0	981
23640	21	13	5	944	0	983
23641	17	9	4	964	0	994
23642	5	12	928	33	0	978
23643	9	958	20	15	0	1002
23644	5	994	14	11	0	1024
23645	9	26	3	1005	0	1043
23646	994	16	8	24	0	1042
23647	20	1012	6	15	0	1053
23648	1002	30	1	11	0	1044
23649	24	995	5	10	0	1034
23650	22	27	2	998	0	1049
23651	1004	21	3	22	0	1050
23652	33	8	2	1005	0	1048
23653	18	11	997	25	0	1051
23654	5	7	20	958	0	990
23655	12	989	14	20	0	1035
23656	965	22	7	28	0	1022
23657	21	971	5	10	0	1007
23658	18	25	4	941	0	988
23659	9	18	4	967	0	998
23660	10	11	948	28	0	997
23661	6	10	945	20	0	981
23662	12	14	33	924	0	983
23663	6	7	935	27	0	975
23664	9	924	28	14	0	975
23665	916	23	18	11	0	968
23666	20	19	938	16	0	993
23667	924	10	24	6	0	964
23668	948	10	21	11	0	990
23669	956	8	7	6	0	977
23670	942	4	12	10	0	968
23671	43	5	5	916	0	969
23672	27	8	5	894	0	934
23673	11	906	10	27	0	954
23674	886	26	5	19	0	936
23675	24	16	865	17	0	922
23676	27	7	24	856	0	914
23677	14	11	19	870	0	914
23678	11	7	858	34	0	910
23679	5	863	25	21	0	914
23680	12	25	18	841	0	896
23681	14	13	6	890	0	923
23682	858	5	13	38	0	914
23683	24	862	7	22	0	915
23684	22	25	6	850	0	903
23685	10	859	6	32	0	907
23686	13	20	7	875	0	915
23687	845	18	4	37	0	904
23688	873	7	3	27	0	910
23689	31	13	5	850	0	899
23690	854	6	4	33	0	897
23691	863	3	7	23	0	896
23692	38	833	8	10	0	889
23693	22	23	3	814	0	862
23694	13	842	5	21	0	881
23695	24	24	3	825	0	876
23696	824	24	4	28	0	880
23697	33	7	0	833	0	873
23698	21	10	5	834	0	870
23699	9	6	787	40	0	842
23700	11	748	20	23	0	802
23701	7	811	12	16	0	846
23702	772	27	3	16	0	818
23703	27	15	5	589	0	636
23704	545	6	3	21	0	575
23705	18	527	2	13	0	560
23706	11	487	2	8	0	508
23707	7	536	2	11	0	556
23708	405	14	7	7	0	433
23709	5	427	4	4	0	440
23710	394	4	3	4	0	405
23711	372	1	0	2	0	375
23712	384	2	0	1	0	387
23713	6	3	0	397	0	406
23714	1	3	0	408	0	412
23715	2	1	0	412	0	415
23716	4	0	0	409	0	413
23717	408	1	0	8	0	417
23718	5	401	0	3	0	409
23719	2	6	0	411	0	419
23720	416	1	0	10	0	427
23721	8	2	0	401	0	411
23722	1	2	0	410	0	413
23723	399	1	1	12	0	413
23724	7	1	386	0	0	394
23725	5	2	5	383	0	395
23726	2	1	382	7	0	392
23727	2	2	5	383	0	392
23728	2	0	2	389	0	393
23729	383	2	0	9	0	394
23730	6	370	1	1	0	378
23731	2	371	1	1	0	375
23732	367	6	0	4	0	377
23733	6	384	1	1	0	392
23734	380	3	0	1	0	384
23735	6	0	374	2	0	382
23736	366	0	4	2	0	372
23737	367	0	0	2	0	369
23738	360	0	1	3	0	364
23739	5	0	1	360	0	366
23740	1	1	1	360	0	363
23741	1	357	0	5	0	363
23742	1	4	0	346	0	351
23743	342	0	0	7	0	349
23744	4	364	0	1	0	369
23745	1	361	0	0	0	362
23746	358	3	1	1	0	363
23747	2	1	358	1	0	362
23748	1	0	4	354	0	359
23749	0	0	358	4	0	362
23750	1	0	3	352	0	356
23751	2	359	0	3	0	364
23752	0	4	0	360	0	364
23753	348	1	0	6	0	355
23754	5	0	0	348	0	353
23755	0	2	359	3	0	364
23756	332	0	3	2	0	337
23757	4	366	1	1	0	372
23758	1	391	0	0	0	392
23759	392	4	0	1	0	397
23760	420	0	0	1	0	421
23761	6	0	415	1	0	422
23762	406	0	6	3	0	415
23763	6	424	3	0	0	433
23764	432	5	1	4	0	442
23765	9	3	0	418	0	430
23766	2	396	1	6	0	405
23767	406	7	0	3	0	416
23768	8	5	401	2	0	416
23769	3	0	7	413	0	423
23770	416	0	2	9	0	427
23771	7	1	419	2	0	429
23772	417	2	7	5	0	431
23773	7	2	2	417	0	428
23774	5	0	0	435	0	440
23775	2	0	435	10	0	447
23776	3	0	6	432	0	441
23777	435	1	3	10	0	449
23778	8	421	1	2	0	432
23779	431	7	0	3	0	441
23780	427	4	1	4	0	436
23781	10	0	1	430	0	441
23782	4	2	445	6	0	457
23783	2	1	7	441	0	451
23784	444	1	2	8	0	455
23785	5	442	2	2	0	451
23786	463	5	1	3	0	472
23787	8	2	0	461	0	471
23788	4	3	1	462	0	470
23789	2	0	2	466	0	470
23790	2	0	454	9	0	465
23791	2	0	6	455	0	463
23792	1	2	451	5	0	459
23793	2	0	451	4	0	457
23794	5	0	8	497	0	510
23795	1	2	505	12	0	520
23796	545	0	13	4	0	562
23797	18	0	3	569	0	590
23798	6	1	3	578	0	588
23799	3	582	0	20	0	605
23800	584	20	1	9	0	614
23801	608	3	2	5	0	618
23802	23	595	2	3	0	623
23803	10	17	3	601	0	631
23804	3	5	599	21	0	628
23805	578	4	19	8	0	609
23806	613	0	6	5	0	624
23807	28	1	3	579	0	611
23808	9	2	565	19	0	595
23809	5	556	19	7	0	587
23810	553	17	7	5	0	582
23811	21	7	542	5	0	575
23812	7	539	19	2	0	567
23813	520	16	6	5	0	547
23814	544	6	4	2	0	556
23815	22	4	1	514	0	541
23816	12	514	1	15	0	542
23817	6	18	1	534	0	559
23818	2	8	0	554	0	564
23819	4	4	3	544	0	555
23820	5	2	2	547	0	556
23821	6	2	524	24	0	556
23822	3	4	18	527	0	552
23823	5	0	7	545	0	557
23824	1	2	532	25	0	560
23825	3	537	15	12	0	567
23826	531	19	6	7	0	563
23827	542	7	3	6	0	558
23828	26	3	1	538	0	568
23829	541	1	3	25	0	570
23830	23	1	4	539	0	567
23831	7	5	538	26	0	576
23832	8	2	549	9	0	568
23833	5	533	23	6	0	567
23834	518	19	8	10	0	555
23835	22	6	554	8	0	590
23836	11	5	21	523	0	560
23837	10	0	13	581	0	604
23838	8	1	6	599	0	614
23839	3	4	4	600	0	611
23840	9	3	5	596	0	613
23841	4	4	564	33	0	605
23842	11	2	20	589	0	622
23843	568	3	13	30	0	614
23844	25	568	6	17	0	616
23845	552	24	2	10	0	588
23846	27	569	2	10	0	608
23847	569	26	5	10	0	610
23848	587	10	5	11	0	613
23849	40	4	1	570	0	615
23850	18	4	3	600	0	625
23851	576	2	6	40	0	624
23852	580	4	5	19	0	608
23853	594	6	4	11	0	615
23854	40	544	3	7	0	594
23855	15	563	4	10	0	592
23856	9	30	549	7	0	595
23857	14	17	22	531	0	584
23858	11	4	528	27	0	570
23859	7	504	25	18	0	554
23860	10	21	10	478	0	519
23861	7	12	4	498	0	521
23862	9	4	3	511	0	527
23863	473	4	5	34	0	516
23864	473	6	4	19	0	502
23865	29	476	2	10	0	517
23866	16	21	4	478	0	519
23867	9	10	471	26	0	516
23868	6	5	474	15	0	500
23869	469	4	23	10	0	506
23870	484	3	10	9	0	506
23871	34	2	3	461	0	500
23872	479	0	3	31	0	513
23873	23	3	453	16	0	495
23874	12	451	25	11	0	499
23875	9	20	12	453	0	494
23876	7	8	484	25	0	524
23877	10	7	21	479	0	517
23878	11	4	9	490	0	514
23879	8	4	465	32	0	509
23880	460	5	19	18	0	502
23881	485	1	11	12	0	509
23882	29	469	7	13	0	518
23883	490	21	5	14	0	530
23884	515	9	4	15	0	543
23885	33	6	496	11	0	546
23886	503	3	21	10	0	537
23887	29	514	15	7	0	565
23888	533	27	6	7	0	573
23889	549	11	5	8	0	573
23890	555	10	1	8	0	574
23891	534	6	5	10	0	555
23892	552	3	5	10	0	570
23893	36	519	6	11	0	572
23894	471	20	5	12	0	508
23895	28	461	6	9	0	504
23896	9	396	0	12	0	417
23897	9	404	0	8	0	421
23898	403	19	2	3	0	427
23899	402	9	0	5	0	416
23900	26	5	377	5	0	413
23901	396	7	16	2	0	421
23902	397	5	9	4	0	415
23903	25	2	396	4	0	427
23904	10	5	16	396	0	427
23905	10	3	9	400	0	422
23906	5	6	2	424	0	437
23907	7	2	1	423	0	433
23908	9	2	2	426	0	439
23909	7	5	404	22	0	438
23910	8	409	16	12	0	445
23911	409	16	6	8	0	439
23912	13	423	4	5	0	445
23913	420	16	3	4	0	443
23914	423	9	6	2	0	440
23915	24	5	417	3	0	449
23916	17	2	12	391	0	422
23917	10	409	7	15	0	441
23918	413	14	6	8	0	441
23919	422	9	4	3	0	438
23920	422	5	5	3	0	435
23921	21	437	1	7	0	466
23922	433	13	2	7	0	455
23923	436	5	4	6	0	451
23924	435	3	2	6	0	446
23925	21	2	2	419	0	444
23926	13	4	4	431	0	452
23927	13	2	2	428	0	445
23928	424	3	1	18	0	446
23929	17	426	3	6	0	452
23930	438	15	2	0	0	455
23931	427	8	2	3	0	440
23932	422	4	6	1	0	433
23933	425	3	2	4	0	434
23934	23	409	2	3	0	437
23935	370	11	1	3	0	385
23936	17	370	2	2	0	391
23937	6	348	1	1	0	356
23938	346	10	1	5	0	362
23939	15	344	0	1	0	360
23940	5	365	1	1	0	372
23941	358	9	1	2	0	370
23942	351	3	0	3	0	357
23943	11	4	0	337	0	352
23944	3	4	1	344	0	352
23945	355	0	0	12	0	367
23946	354	3	1	4	0	362
23947	359	1	2	2	0	364
23948	14	2	345	0	0	361
23949	355	4	7	2	0	368
23950	13	0	3	369	0	385
23951	6	3	1	369	0	379
23952	6	1	1	374	0	382
23953	4	2	2	373	0	381
23954	5	3	360	11	0	379
23955	5	5	355	5	0	370
23956	7	3	11	365	0	386
23957	7	4	366	7	0	384
23958	7	4	359	1	0	371
23959	6	2	8	368	0	384
23960	9	1	2	377	0	389
23961	6	2	1	385	0	394
23962	6	2	2	370	0	380
23963	378	3	2	13	0	396
23964	385	5	1	5	0	396
23965	11	3	2	373	0	389
23966	9	4	1	385	0	399
23967	10	0	1	386	0	397
23968	2	4	3	383	0	392
23969	5	1	2	386	0	394
23970	8	371	1	14	0	394
23971	377	9	4	6	0	396
23972	11	373	4	8	0	396
23973	376	10	1	11	0	398
23974	387	2	2	7	0	398
23975	387	2	1	6	0	396
23976	15	3	0	363	0	381
23977	367	3	3	13	0	386
23978	15	2	0	363	0	380
23979	9	1	1	365	0	376
23980	370	2	1	14	0	387
23981	10	370	0	7	0	387
23982	7	361	0	6	0	374
23983	344	8	1	4	0	357
23984	8	4	331	0	0	343
23985	313	3	5	3	0	324
23986	10	1	2	327	0	340
23987	2	303	2	6	0	313
23988	4	300	0	3	0	307
23989	305	4	1	4	0	314
23990	5	3	1	308	0	317
23991	2	319	0	5	0	326
23992	315	4	0	2	0	321
23993	308	0	1	3	0	312
23994	313	1	0	2	0	316
23995	314	1	0	2	0	317
23996	4	302	0	1	0	307
23997	1	308	0	0	0	309
23998	307	1	0	1	0	309
23999	297	1	0	4	0	302
24000	2	1	303	0	0	306
24001	1	308	3	0	0	312
24002	312	2	0	0	0	314
24003	319	0	1	1	0	321
24004	4	1	324	0	0	329
24005	325	0	5	2	0	332
24006	4	2	353	0	0	359
24007	0	0	375	1	0	376
24008	3	0	7	354	0	364
24009	0	361	3	7	0	371
24010	383	8	1	5	0	397
24011	9	1	0	375	0	385
24012	3	1	0	379	0	383
24013	2	0	0	384	0	386
24014	380	1	0	12	0	393
24015	9	0	0	377	0	386
24016	3	0	0	392	0	395
24017	1	0	375	9	0	385
24018	364	0	8	3	0	375
24019	389	0	1	1	0	391
24020	10	0	380	0	0	390
24021	363	0	10	0	0	373
24022	11	0	1	355	0	367
24023	1	356	4	7	0	368
24024	4	9	0	367	0	380
24025	366	1	1	11	0	379
24026	9	384	0	1	0	394
24027	4	8	1	388	0	401
24028	1	1	1	397	0	400
24029	0	1	0	401	0	402
24030	0	1	0	390	0	391
24031	1	392	0	9	0	402
24032	389	7	0	3	0	399
24033	398	2	0	3	0	403
24034	10	399	1	1	0	411
24035	458	8	0	2	0	468
24036	485	3	0	3	0	491
24037	480	1	0	3	0	484
24038	13	1	473	0	0	487
24039	11	0	9	461	0	481
24040	4	0	457	9	0	470
24041	451	1	7	6	0	465
24042	12	464	4	1	0	481
24043	461	8	3	5	0	477
24044	9	479	2	1	0	491
24045	4	10	3	462	0	479
24046	8	5	0	481	0	494
24047	1	3	474	12	0	490
24048	2	475	13	5	0	495
24049	470	14	4	4	0	492
24050	14	6	467	3	0	490
24051	455	3	12	3	0	473
24052	17	2	6	458	0	483
24053	9	1	465	14	0	489
24054	4	457	15	6	0	482
24055	3	13	6	453	0	475
24056	4	7	461	13	0	485
24057	3	1	464	7	0	475
24058	2	454	19	1	0	476
24059	6	14	6	453	0	479
24060	6	5	2	443	0	456
24061	3	449	3	16	0	471
24062	454	13	1	9	0	477
24063	13	7	2	443	0	465
24064	8	439	3	15	0	465
24065	447	15	1	7	0	470
24066	450	7	1	4	0	462
24067	458	3	3	3	0	467
24068	21	435	2	2	0	460
24069	446	17	3	5	0	471
24070	462	6	1	3	0	472
24071	23	3	2	443	0	471
24072	452	2	2	17	0	473
24073	17	5	2	445	0	469
24074	10	1	443	17	0	471
24075	3	3	461	9	0	476
24076	9	0	19	456	0	484
24077	2	5	466	18	0	491
24078	432	1	16	11	0	460
24079	20	5	9	452	0	486
24080	14	1	4	457	0	476
24081	4	5	442	23	0	474
24082	6	429	18	10	0	463
24083	3	466	9	5	0	483
24084	6	18	4	454	0	482
24085	5	9	4	466	0	484
24086	3	1	452	25	0	481
24087	2	7	465	9	0	483
24088	7	2	22	458	0	489
24089	3	5	458	18	0	484
24090	434	3	16	12	0	465
24091	21	4	9	440	0	474
24092	442	1	4	24	0	471
24093	23	5	3	438	0	469
24094	14	2	4	461	0	481
24095	9	3	442	23	0	477
24096	6	445	18	11	0	480
24097	8	15	6	458	0	487
24098	4	6	456	22	0	488
24099	7	453	13	10	0	483
24100	6	13	10	465	0	494
24101	446	10	2	19	0	477
24102	16	1	467	10	0	494
24103	450	4	14	5	0	473
24104	17	2	449	6	0	474
24105	403	0	16	5	0	424
24106	15	399	12	2	0	428
24107	10	385	4	4	0	403
24108	6	17	6	371	0	400
24109	6	366	3	14	0	389
24110	369	12	3	13	0	397
24111	13	11	2	368	0	394
24112	8	5	4	376	0	393
24113	2	5	2	390	0	399
24114	2	4	367	20	0	393
24115	5	2	10	362	0	379
24116	2	2	369	15	0	388
24117	5	349	13	11	0	378
24118	346	10	11	9	0	376
24119	12	373	3	7	0	395
24120	380	9	4	5	0	398
24121	376	7	3	5	0	391
24122	392	3	2	4	0	401
24123	382	3	2	5	0	392
24124	17	3	356	5	0	381
24125	12	3	12	347	0	374
24126	5	3	8	344	0	360
24127	5	2	4	362	0	373
24128	316	2	5	15	0	338
24129	331	1	2	14	0	348
24130	19	346	1	8	0	374
24131	8	8	341	4	0	361
24132	6	5	338	5	0	354
24133	5	333	18	3	0	359
24134	4	345	7	5	0	361
24135	17	13	5	254	0	289
24136	0	6	2	253	0	261
24137	247	3	2	11	0	263
24138	8	238	1	5	0	252
24139	6	7	1	252	0	266
24140	3	4	260	9	0	276
24141	5	1	6	267	0	279
24142	3	1	4	273	0	281
24143	0	0	2	278	0	280
24144	0	0	2	276	0	278
24145	0	3	260	12	0	275
24146	1	251	7	5	0	264
24147	1	261	3	4	0	269
24148	249	6	2	1	0	258
24149	6	251	2	0	0	259
24150	4	277	1	1	0	283
24151	7	6	0	274	0	287
24152	2	3	2	278	0	285
24153	2	1	1	281	0	285
24154	0	2	276	13	0	291
24155	2	270	7	6	0	285
24156	3	5	2	272	0	282
24157	0	284	1	6	0	291
24158	276	8	1	6	0	291
24159	6	282	1	1	0	290
24160	276	7	2	1	0	286
24161	7	3	275	0	0	285
24162	279	2	6	1	0	288
24163	7	1	2	277	0	287
24164	3	0	282	6	0	291
24165	270	0	7	7	0	284
24166	291	1	2	1	0	295
24167	287	0	1	5	0	293
24168	8	0	2	283	0	293
24169	3	0	291	6	0	300
24170	286	0	5	0	0	291
24171	5	0	1	292	0	298
24172	2	0	1	299	0	302
24173	1	0	316	6	0	323
24174	2	314	4	4	0	324
24175	2	6	1	301	0	310
24176	1	312	1	4	0	318
24177	314	5	0	3	0	322
24178	316	3	0	2	0	321
24179	5	1	0	315	0	321
24180	323	1	0	7	0	331
24181	6	321	0	2	0	329
24182	323	5	0	3	0	331
24183	4	308	1	2	0	315
24184	2	8	0	310	0	320
24185	1	3	1	308	0	313
24186	2	307	0	5	0	314
24187	2	5	0	305	0	312
24188	1	1	307	7	0	316
24189	1	309	4	2	0	316
24190	303	5	0	1	0	309
24191	4	304	1	2	0	311
24192	3	5	2	305	0	315
24193	2	4	303	4	0	313
24194	5	2	4	302	0	313
24195	4	1	0	306	0	311
24196	303	0	1	12	0	316
24197	7	0	308	3	0	318
24198	5	298	6	2	0	311
24199	1	6	318	1	0	326
24200	2	2	302	1	0	307
24201	1	0	308	0	0	309
24202	2	10	5	264	0	281
24203	268	0	1	6	0	275
24204	5	268	0	1	0	274
24205	275	5	0	0	0	280
24206	289	1	0	1	0	291
24207	6	0	0	283	0	289
24208	1	286	0	5	0	292
24209	285	5	0	2	0	292
24210	5	289	0	1	0	295
24211	1	5	0	285	0	291
24212	0	1	0	297	0	298
24213	0	300	0	6	0	306
24214	1	5	0	304	0	310
24215	0	1	292	5	0	298
24216	0	0	283	1	0	284
24217	3	0	6	282	0	291
24218	0	0	1	298	0	299
24219	0	0	280	6	0	286
24220	0	0	281	1	0	282
24221	262	0	5	1	0	268
24222	6	272	1	0	0	279
24223	1	288	0	0	0	289
24224	1	6	0	280	0	287
24225	0	1	0	286	0	287
24226	2	0	0	286	0	288
24227	2	0	284	4	0	290
24228	0	0	272	1	0	273
24229	1	0	6	289	0	296
24230	0	0	290	5	0	295
24231	0	278	5	2	0	285
24232	276	5	1	0	0	282
24233	5	2	277	0	0	284
24234	1	0	279	0	0	280
24235	0	0	6	278	0	284
24236	0	1	295	5	0	301
24237	0	302	6	1	0	309
24238	2	5	1	307	0	315
24239	0	1	309	6	0	316
24240	0	293	5	1	0	299
24241	288	6	2	5	0	301
24242	9	2	0	287	0	298
24243	1	0	0	296	0	297
24244	296	0	1	9	0	306
24245	6	296	0	1	0	303
24246	299	6	0	2	0	307
24247	297	1	0	1	0	299
24248	293	0	0	3	0	296
24249	9	2	0	285	0	296
24250	262	3	0	9	0	274
24251	6	255	0	1	0	262
24252	3	258	0	0	0	261
24253	259	4	0	4	0	267
24254	3	1	0	268	0	272
24255	3	0	0	267	0	270
24256	0	1	0	265	0	266
24257	0	1	253	5	0	259
24258	1	251	4	1	0	257
24259	1	4	1	254	0	260
24260	251	1	0	8	0	260
24261	7	0	1	244	0	252
24262	1	1	253	4	0	259
24263	1	261	4	1	0	267
24264	262	4	1	4	0	271
24265	262	1	1	4	0	268
24266	266	1	0	1	0	268
24267	9	1	1	268	0	279
24268	2	1	269	4	0	276
24269	2	1	291	1	0	295
24270	3	296	7	0	0	306
24271	2	5	2	296	0	305
24272	4	1	0	303	0	308
24273	285	0	1	7	0	293
24274	6	3	1	289	0	299
24275	301	1	0	7	0	309
24276	10	0	295	4	0	309
24277	3	1	292	5	0	301
24278	4	1	7	284	0	296
24279	2	0	4	286	0	292
24280	4	3	1	294	0	302
24281	287	1	1	13	0	302
24282	313	0	1	4	0	318
24283	13	1	0	313	0	327
24284	3	1	306	13	0	323
24285	2	1	319	5	0	327
24286	5	0	13	318	0	336
24287	325	1	5	14	0	345
24288	15	0	2	328	0	345
24289	5	0	2	334	0	341
24290	1	0	328	13	0	342
24291	3	0	326	5	0	334
24292	319	2	14	3	0	338
24293	12	1	328	4	0	345
24294	3	0	12	309	0	324
24295	7	0	2	319	0	328
24296	306	0	3	17	0	326
24297	12	308	2	4	0	326
24298	304	9	3	3	0	319
24299	11	290	1	3	0	305
24300	284	11	4	6	0	305
24301	13	1	298	3	0	315
24302	283	3	8	3	0	297
24303	298	0	3	3	0	304
24304	13	4	4	288	0	309
24305	5	0	288	12	0	305
24306	6	3	12	265	0	286
24307	5	1	2	279	0	287
24308	3	271	3	14	0	291
24309	7	11	0	260	0	278
24310	3	270	2	15	0	290
24311	5	11	2	271	0	289
24312	272	2	2	13	0	289
24313	15	4	4	265	0	288
24314	4	0	266	15	0	285
24315	278	1	12	2	0	293
24316	13	1	269	8	0	291
24317	276	0	10	5	0	291
24318	282	2	3	6	0	293
24319	10	270	4	4	0	288
24320	5	294	3	5	0	307
24321	285	13	3	4	0	305
24322	301	4	1	6	0	312
24323	295	4	2	6	0	307
24324	300	2	2	4	0	308
24325	307	1	4	3	0	315
24326	18	1	4	287	0	310
24327	7	0	4	297	0	308
24328	8	2	282	12	0	304
24329	267	1	14	8	0	290
24330	17	2	3	270	0	292
24331	10	1	1	286	0	298
24332	8	2	279	15	0	304
24333	2	269	12	8	0	291
24334	6	283	6	4	0	299
24335	285	11	6	4	0	306
24336	276	3	0	3	0	282
24337	15	252	2	3	0	272
24338	8	244	3	4	0	259
24339	248	7	3	3	0	261
24340	252	2	5	5	0	264
24341	14	3	2	247	0	266
24342	10	1	4	249	0	264
24343	4	0	3	263	0	270
24344	234	3	2	18	0	257
24345	250	0	1	10	0	261
24346	15	5	0	246	0	266
24347	252	4	0	14	0	270
24348	19	4	255	2	0	280
24349	8	2	12	256	0	278
24350	6	1	255	13	0	275
24351	6	255	16	1	0	278
24352	7	11	4	255	0	277
24353	249	2	5	14	0	270
24354	19	4	2	250	0	275
24355	5	4	2	261	0	272
24356	7	3	244	15	0	269
24357	7	2	253	5	0	267
24358	8	253	13	5	0	279
24359	266	14	5	2	0	287
24360	273	3	5	4	0	285
24361	276	3	1	3	0	283
24362	273	1	1	8	0	283
24363	19	0	4	253	0	276
24364	9	1	5	246	0	261
24365	7	246	2	15	0	270
24366	245	14	3	9	0	271
24367	254	1	0	7	0	262
24368	15	6	243	2	0	266
24369	194	1	10	1	0	206
24370	14	200	1	1	0	216
24371	3	13	1	189	0	206
24372	6	195	2	9	0	212
24373	198	14	0	2	0	214
24374	10	188	1	3	0	202
24375	5	11	0	183	0	199
24376	4	1	1	187	0	193
24377	0	2	0	194	0	196
24378	1	180	1	11	0	193
24379	3	7	0	184	0	194
24380	5	1	0	185	0	191
24381	2	167	1	10	0	180
24382	0	166	1	6	0	173
24383	156	6	1	4	0	167
24384	7	156	2	0	0	165
24385	151	5	1	1	0	158
24386	6	0	141	1	0	148
24387	3	136	3	0	0	142
24388	136	4	1	1	0	142
24389	135	1	2	1	0	139
24390	6	0	132	0	0	138
24391	1	1	4	132	0	138
24392	1	0	136	6	0	143
24393	1	134	5	1	0	141
24394	132	7	1	3	0	143
24395	8	133	1	1	0	143
24396	4	5	2	134	0	145
24397	4	1	1	140	0	146
24398	2	3	141	4	0	150
24399	3	0	137	3	0	143
24400	133	1	3	3	0	140
24401	132	1	1	2	0	136
24402	133	2	1	1	0	137
24403	127	0	0	5	0	132
24404	5	125	1	2	0	133
24405	4	4	0	130	0	138
24406	4	1	0	129	0	134
24407	3	133	1	6	0	143
24408	135	6	4	2	0	147
24409	140	2	0	3	0	145
24410	6	3	136	0	0	145
24411	134	1	4	2	0	141
24412	6	2	0	135	0	143
24413	5	0	136	5	0	146
24414	2	8	11	126	0	147
24415	1	1	131	7	0	140
24416	2	1	141	1	0	145
24417	3	0	6	128	0	137
24418	1	134	1	4	0	140
24419	131	4	3	1	0	139
24420	119	1	1	3	0	124
24421	6	127	0	1	0	134
24422	4	123	0	6	0	133
24423	130	6	0	3	0	139
24424	132	0	0	5	0	137
24425	132	4	1	1	0	138
24426	135	0	2	2	0	139
24427	7	1	1	135	0	144
24428	2	0	135	5	0	142
24429	5	132	3	0	0	140
24430	131	6	0	1	0	138
24431	4	127	0	0	0	131
24432	120	4	0	1	0	125
24433	126	0	0	4	0	130
24434	5	1	122	0	0	128
24435	1	130	3	0	0	134
24436	1	3	0	133	0	137
24437	0	0	1	135	0	136
24438	1	0	0	133	0	134
24439	132	1	0	4	0	137
24440	135	0	0	0	0	135
24441	135	1	0	1	0	137
24442	6	134	0	0	0	140
24443	126	5	0	0	0	131
24444	4	130	0	1	0	135
24445	0	4	129	1	0	134
24446	0	131	4	1	0	136
24447	7	2	0	116	0	125
24448	0	0	0	120	0	120
24449	0	1	118	2	0	121
24450	0	0	2	111	0	113
24451	0	0	0	122	0	122
24452	121	0	0	2	0	123
24453	120	0	0	1	0	121
24454	122	0	0	0	0	122
24455	1	124	0	0	0	125
24456	125	2	0	1	0	128
24457	120	1	0	0	0	121
24458	3	127	0	0	0	130
24459	0	1	0	126	0	127
24460	1	0	1	124	0	126
24461	127	0	0	1	0	128
24462	1	0	126	1	0	128
24463	0	122	2	0	0	124
24464	0	1	0	123	0	124
24465	0	125	2	1	0	128
24466	0	128	1	0	0	129
24467	127	1	0	1	0	129
24468	130	1	0	1	0	132
24469	1	0	0	135	0	136
24470	0	1	0	133	0	134
24471	1	1	0	133	0	135
24472	1	1	0	130	0	132
24473	1	0	130	1	0	132
24474	1	0	123	0	0	124
24475	1	0	1	129	0	131
24476	1	0	136	1	0	138
24477	0	130	0	2	0	132
24478	134	0	1	1	0	136
24479	137	1	1	0	0	139
24480	2	0	0	140	0	142
24481	0	2	0	144	0	146
24482	2	1	0	149	0	152
24483	1	151	0	2	0	154
24484	144	2	1	1	0	148
24485	148	2	0	0	0	150
24486	3	1	142	1	0	147
24487	0	0	2	155	0	157
24488	1	0	158	3	0	162
24489	2	0	2	163	0	167
24490	2	0	0	163	0	165
24491	1	0	1	169	0	171
24492	1	2	0	168	0	171
24493	164	0	0	6	0	170
24494	169	2	0	1	0	172
24495	174	0	0	1	0	175
24496	6	1	0	169	0	176
24497	4	0	169	3	0	176
24498	167	1	2	3	0	173
24499	5	0	3	170	0	178
24500	188	0	0	6	0	194
24501	5	0	1	187	0	193
24502	4	185	0	3	0	192
24503	1	197	0	3	0	201
24504	3	4	0	196	0	203
24505	0	4	0	193	0	197
24506	1	0	0	188	0	189
24507	0	194	0	5	0	199
24508	189	3	0	4	0	196
24509	3	191	0	1	0	195
24510	2	3	192	1	0	198
24511	0	3	5	187	0	195
24512	1	193	1	4	0	199
24513	0	6	0	192	0	198
24514	0	2	1	190	0	193
24515	0	0	186	9	0	195
24516	159	1	5	3	0	168
24517	5	197	2	2	0	206
24518	199	5	0	1	0	205
24519	208	2	1	1	0	212
24520	211	0	0	1	0	212
24521	7	1	206	0	0	214
24522	4	0	5	202	0	211
24523	1	0	3	214	0	218
24524	1	0	202	8	0	211
24525	192	0	6	3	0	201
24526	6	0	211	1	0	218
24527	2	0	205	2	0	209
24528	1	192	8	0	0	201
24529	2	5	2	197	0	206
24530	1	2	197	5	0	205
24531	190	0	6	3	0	199
24532	199	1	3	1	0	204
24533	7	0	202	1	0	210
24534	3	0	6	202	0	211
24535	2	0	220	5	0	227
24536	1	217	5	3	0	226
24537	234	5	3	0	0	242
24538	247	3	0	1	0	251
24539	252	0	1	2	0	255
24540	8	1	0	244	0	253
24541	4	0	0	252	0	256
24542	1	1	246	7	0	255
24543	242	0	5	4	0	251
24544	7	1	2	246	0	256
24545	246	1	2	7	0	256
24546	5	0	244	5	0	254
24547	4	2	249	0	0	255
24548	1	1	8	236	0	246
24549	3	0	2	249	0	254
24550	0	4	246	8	0	258
24551	235	0	7	2	0	244
24552	6	3	3	247	0	259
24553	3	267	2	8	0	280
24554	274	5	1	5	0	285
24555	7	273	0	2	0	282
24556	269	6	2	7	0	284
24557	8	4	278	4	0	294
24558	6	1	267	4	0	278
24559	4	283	7	1	0	295
24560	281	6	3	6	0	296
24561	6	3	285	1	0	295
24562	276	0	8	2	0	286
24563	7	286	2	2	0	297
24564	5	4	3	288	0	300
24565	2	2	3	293	0	300
24566	4	273	1	7	0	285
24567	296	7	1	4	0	308
24568	296	3	3	5	0	307
24569	293	0	2	5	0	300
24570	10	1	290	2	0	303
24571	4	5	6	288	0	303
24572	6	0	3	293	0	302
24573	5	2	1	294	0	302
24574	4	1	294	8	0	307
24575	2	287	8	7	0	304
24576	279	7	3	6	0	295
24577	7	2	282	4	0	295
24578	272	0	9	5	0	286
24579	5	287	4	2	0	298
24580	294	5	2	1	0	302
24581	7	4	4	277	0	292
24582	285	0	0	6	0	291
24583	8	1	1	291	0	301
24584	6	1	292	6	0	305
24585	4	0	10	284	0	298
24586	4	1	294	7	0	306
24587	260	1	4	7	0	272
24588	6	283	4	1	0	294
24589	5	4	3	261	0	273
24590	2	274	3	3	0	282
24591	262	4	0	3	0	269
24592	260	0	2	4	0	266
24593	3	263	3	1	0	270
24594	264	4	1	1	0	270
24595	272	1	1	2	0	276
24596	6	0	2	268	0	276
24597	2	1	1	270	0	274
24598	272	2	1	4	0	279
24599	270	0	1	4	0	275
24600	4	0	1	258	0	263
24601	1	2	2	280	0	285
24602	281	1	0	8	0	290
24603	7	0	278	3	0	288
24604	275	2	6	0	0	283
24605	6	0	273	0	0	279
24606	0	270	5	1	0	276
24607	1	3	0	268	0	272
24608	0	0	283	5	0	288
24609	0	294	5	0	0	299
24610	288	2	0	2	0	292
24611	2	0	287	0	0	289
24612	273	1	2	2	0	278
24613	288	0	0	1	0	289
24614	285	1	0	4	0	290
24615	4	0	0	287	0	291
24616	0	293	1	1	0	295
24617	280	2	1	3	0	286
24618	2	1	297	0	0	300
24619	268	0	2	3	0	273
24620	1	0	293	0	0	294
24621	1	280	2	0	0	283
24622	1	2	1	280	0	284
24623	0	0	0	284	0	284
24624	0	282	0	3	0	285
24625	0	2	0	288	0	290
24626	0	0	287	1	0	288
24627	0	290	3	0	0	293
24628	2	2	0	289	0	293
24629	297	0	1	2	0	300
24630	309	0	0	3	0	312
24631	2	1	0	317	0	320
24632	1	333	1	4	0	339
24633	1	3	0	337	0	341
24634	3	0	0	329	0	332
24635	0	0	318	5	0	323
24636	0	318	4	0	0	322
24637	1	4	0	300	0	305
24638	0	0	299	4	0	303
24639	1	287	4	0	0	292
24640	0	5	0	293	0	298
24641	300	0	0	6	0	306
24642	4	312	2	1	0	319
24643	4	5	0	324	0	333
24644	318	0	0	10	0	328
24645	325	1	0	3	0	329
24646	323	0	1	4	0	328
24647	318	1	0	3	0	322
24648	5	1	1	313	0	320
24649	0	0	322	6	0	328
24650	0	1	4	317	0	322
24651	1	322	1	4	0	328
24652	313	5	0	3	0	321
24653	4	1	295	3	0	303
24654	287	0	5	2	0	294
24655	5	2	286	0	0	293
24656	3	0	4	291	0	298
24657	2	1	298	4	0	305
24658	2	2	4	285	0	293
24659	1	0	287	7	0	295
24660	3	0	6	279	0	288
24661	281	2	0	9	0	292
24662	5	297	1	1	0	304
24663	3	4	1	297	0	305
24664	3	2	1	297	0	303
24665	4	0	299	4	0	307
24666	3	0	294	0	0	297
24667	287	0	3	3	0	293
24668	4	299	3	1	0	307
24669	301	4	1	4	0	310
24670	296	1	2	4	0	303
24671	6	0	1	296	0	303
24672	2	298	3	4	0	307
24673	305	4	0	8	0	317
24674	315	0	2	3	0	320
24675	315	3	0	2	0	320
24676	315	0	1	4	0	320
24677	309	0	2	3	0	314
24678	6	1	303	0	0	310
24679	298	1	5	3	0	307
24680	9	0	304	0	0	313
24681	1	1	5	299	0	306
24682	3	1	0	311	0	315
24683	2	1	305	5	0	313
24684	296	1	4	4	0	305
24685	7	1	1	313	0	322
24686	2	0	2	316	0	320
24687	4	2	1	320	0	327
24688	3	1	0	316	0	320
24689	2	0	1	318	0	321
24690	2	0	320	6	0	328
24691	0	2	6	319	0	327
24692	2	1	322	7	0	332
24693	2	1	311	2	0	316
24694	309	1	5	5	0	320
24695	331	0	2	3	0	336
24696	355	1	2	3	0	361
24697	12	0	353	3	0	368
24698	4	1	371	2	0	378
24699	3	1	385	3	0	392
24700	0	387	14	6	0	407
24701	8	10	5	364	0	387
24702	380	2	4	12	0	398
24703	9	3	3	410	0	425
24704	3	413	2	14	0	432
24705	427	9	1	5	0	442
24706	14	2	1	426	0	443
24707	5	437	0	13	0	455
24708	4	11	2	432	0	449
24709	4	2	3	429	0	438
24710	410	2	2	19	0	433
24711	10	3	2	418	0	433
24712	3	0	415	16	0	434
24713	7	1	10	402	0	420
24714	2	396	3	14	0	415
24715	2	420	4	4	0	430
24716	2	12	2	408	0	424
24717	3	6	4	412	0	425
24718	2	384	2	20	0	408
24719	1	394	2	7	0	404
24720	2	406	0	8	0	416
24721	9	13	0	377	0	399
24722	1	396	1	10	0	408
24723	389	15	3	7	0	414
24724	12	6	402	6	0	426
24725	4	5	12	391	0	412
24726	3	399	3	13	0	418
24727	397	12	2	9	0	420
24728	12	6	397	6	0	421
24729	6	405	11	4	0	426
24730	381	11	4	7	0	403
24731	9	372	5	4	0	390
24732	2	376	4	2	0	384
24733	7	12	1	358	0	378
24734	2	374	1	8	0	385
24735	365	11	2	5	0	383
24736	9	5	0	370	0	384
24737	4	6	364	11	0	385
24738	4	5	367	4	0	380
24739	3	5	10	373	0	391
24740	1	4	376	12	0	393
24741	1	3	11	371	0	386
24742	351	5	3	14	0	373
24743	11	4	342	6	0	363
24744	4	2	11	339	0	356
24745	3	336	3	13	0	355
24746	7	10	2	343	0	362
24747	1	5	3	342	0	351
24748	2	366	4	13	0	385
24749	3	12	2	367	0	384
24750	5	3	2	374	0	384
24751	1	5	367	15	0	388
24752	2	369	9	8	0	388
24753	363	13	2	7	0	385
24754	12	7	2	366	0	387
24755	4	5	364	15	0	388
24756	3	6	12	357	0	378
24757	2	4	356	15	0	377
24758	341	3	12	8	0	364
24759	11	357	3	6	0	377
24760	4	10	4	363	0	381
24761	5	3	5	375	0	388
24762	350	4	5	15	0	374
24763	12	2	4	352	0	370
24764	4	4	363	19	0	390
24765	4	4	12	354	0	374
24766	3	351	4	16	0	374
24767	2	368	4	12	0	386
24768	1	378	2	4	0	385
24769	3	15	1	368	0	387
24770	0	9	361	13	0	383
24771	2	360	14	7	0	383
24772	352	15	4	10	0	381
24773	12	356	3	8	0	379
24774	343	11	5	12	0	371
24775	354	7	5	6	0	372
24776	16	3	351	4	0	374
24777	338	5	14	5	0	362
24778	370	5	4	5	0	384
24779	358	4	1	11	0	374
24780	376	3	5	7	0	391
24781	16	10	355	5	0	386
24782	360	3	12	7	0	382
24783	384	3	4	5	0	396
24784	17	392	5	3	0	417
24785	10	13	2	377	0	402
24786	4	6	2	395	0	407
24787	3	386	4	13	0	406
24788	379	14	1	13	0	407
24789	13	388	5	6	0	412
24790	388	16	4	5	0	413
24791	390	9	2	1	0	402
24792	19	383	2	2	0	406
24793	13	18	1	375	0	407
24794	9	5	373	13	0	400
24795	6	359	13	7	0	385
24796	5	11	3	316	0	335
24797	7	342	2	10	0	361
24798	5	349	2	3	0	359
24799	7	18	3	322	0	350
24800	6	2	337	11	0	356
24801	3	315	11	4	0	333
24802	4	318	3	2	0	327
24803	264	10	1	3	0	278
24804	5	4	0	267	0	276
24805	3	1	4	270	0	278
24806	3	6	0	267	0	276
24807	2	4	268	9	0	283
24808	6	2	6	271	0	285
24809	0	282	3	7	0	292
24810	284	7	0	9	0	300
24811	8	3	3	290	0	304
24812	2	4	286	7	0	299
24813	280	2	6	7	0	295
24814	11	3	3	295	0	312
24815	4	2	291	10	0	307
24816	1	1	300	7	0	309
24817	297	0	11	4	0	312
24818	317	2	5	2	0	326
24819	313	1	1	5	0	320
24820	315	3	4	2	0	324
24821	12	1	309	0	0	322
24822	6	301	8	9	0	324
24823	313	8	4	3	0	328
24824	10	309	2	4	0	325
24825	311	6	4	4	0	325
24826	9	308	3	1	0	321
24827	4	11	3	310	0	328
24828	8	3	0	316	0	327
24829	5	3	1	314	0	323
24830	6	303	2	9	0	320
24831	4	311	1	5	0	321
24832	5	10	3	308	0	326
24833	1	310	2	11	0	324
24834	4	9	298	4	0	315
24835	4	7	6	299	0	316
24836	5	1	307	11	0	324
24837	302	4	8	8	0	322
24838	300	2	5	4	0	311
24839	11	3	298	3	0	315
24840	4	4	301	4	0	313
24841	5	3	13	293	0	314
24842	4	4	299	7	0	314
24843	6	1	8	283	0	298
24844	3	285	6	7	0	301
24845	3	7	5	316	0	331
24846	2	6	3	322	0	333
24847	2	1	6	323	0	332
24848	4	2	295	11	0	312
24849	4	6	6	291	0	307
24850	4	3	4	293	0	304
24851	4	2	4	279	0	289
24852	0	284	3	12	0	299
24853	283	7	3	9	0	302
24854	277	2	1	10	0	290
24855	286	4	2	3	0	295
24856	9	5	0	288	0	302
24857	3	8	286	8	0	305
24858	8	3	278	6	0	295
24859	4	279	8	6	0	297
24860	279	6	6	7	0	298
24861	8	279	2	5	0	294
24862	287	8	4	8	0	307
24863	9	287	4	7	0	307
24864	275	7	8	3	0	293
24865	11	285	2	4	0	302
24866	8	10	3	276	0	297
24867	9	2	272	9	0	292
24868	4	4	274	8	0	290
24869	4	1	13	275	0	293
24870	2	10	5	279	0	296
24871	8	1	2	288	0	299
24872	1	8	271	11	0	291
24873	9	2	11	268	0	290
24874	273	6	4	9	0	292
24875	278	1	1	10	0	290
24876	10	274	4	7	0	295
24877	277	7	3	7	0	294
24878	8	277	2	7	0	294
24879	273	11	4	3	0	291
24880	272	2	2	8	0	284
24881	267	7	1	5	0	280
24882	14	3	267	4	0	288
24883	8	5	225	2	0	240
24884	248	3	9	4	0	264
24885	253	1	5	4	0	263
24886	14	3	2	254	0	273
24887	7	2	2	264	0	275
24888	3	6	4	260	0	273
24889	6	4	0	269	0	279
24890	3	4	3	274	0	284
24891	269	3	0	12	0	284
24892	7	4	3	276	0	290
24893	5	2	285	10	0	302
24894	272	3	7	7	0	289
24895	277	0	2	6	0	285
24896	9	283	3	1	0	296
24897	2	289	3	5	0	299
24898	261	1	1	3	0	266
24899	1	266	1	3	0	271
24900	248	2	1	0	0	251
24901	252	0	0	1	0	253
24902	252	2	0	1	0	255
24903	3	0	0	253	0	256
24904	0	261	1	3	0	265
24905	266	1	1	1	0	269
24906	3	0	2	262	0	267
24907	0	1	0	255	0	256
24908	245	0	0	2	0	247
24909	1	249	0	1	0	251
24910	1	4	0	239	0	244
24911	257	0	0	2	0	259
24912	4	269	0	0	0	273
24913	282	1	0	2	0	285
24914	1	2	254	2	0	259
24915	269	1	1	2	0	273
24916	1	292	1	1	0	295
24917	290	2	0	1	0	293
24918	283	1	0	1	0	285
24919	2	297	0	1	0	300
24920	300	2	0	2	0	304
24921	3	309	0	0	0	312
24922	314	2	0	1	0	317
24923	6	2	0	327	0	335
24924	1	0	0	325	0	326
24925	2	1	0	326	0	329
24926	1	0	322	3	0	326
24927	1	0	2	325	0	328
24928	1	0	319	2	0	322
24929	3	0	2	309	0	314
24930	1	323	3	1	0	328
24931	1	3	1	328	0	333
24932	2	1	326	2	0	331
24933	1	0	327	3	0	331
24934	1	1	3	330	0	335
24935	325	1	1	4	0	331
24936	334	0	0	2	0	336
24937	3	331	0	2	0	336
24938	3	2	0	338	0	343
24939	2	1	334	2	0	339
24940	3	0	2	333	0	338
24941	0	1	333	4	0	338
24942	323	2	2	2	0	329
24943	5	1	1	327	0	334
24944	2	1	320	4	0	327
24945	4	0	2	318	0	324
24946	4	2	1	325	0	332
24947	2	1	324	4	0	331
24948	1	1	3	324	0	329
24949	328	1	1	3	0	333
24950	322	2	1	4	0	329
24951	7	0	0	323	0	330
24952	328	0	1	6	0	335
24953	4	2	328	1	0	335
24954	2	4	307	1	0	314
24955	317	1	4	1	0	323
24956	333	1	1	2	0	337
24957	4	3	0	319	0	326
24958	5	0	1	327	0	333
24959	1	1	332	4	0	338
24960	4	1	3	306	0	314
24961	0	329	1	5	0	335
24962	335	2	1	2	0	340
24963	365	2	0	4	0	371
24964	7	373	1	1	0	382
24965	354	6	0	4	0	364
24966	348	3	3	1	0	355
24967	8	353	1	3	0	365
24968	364	7	1	2	0	374
24969	7	361	0	1	0	369
24970	369	6	0	3	0	378
24971	6	2	365	0	0	373
24972	5	0	5	357	0	367
24973	3	1	3	363	0	370
24974	7	0	0	374	0	381
24975	375	3	2	8	0	388
24976	9	1	0	388	0	398
24977	4	0	385	8	0	397
24978	386	2	9	6	0	403
24979	7	1	3	383	0	394
24980	3	384	1	11	0	399
24981	2	398	2	2	0	404
24982	1	7	3	387	0	398
24983	4	1	1	391	0	397
24984	3	0	1	387	0	391
24985	1	0	380	10	0	391
24986	2	367	9	2	0	380
24987	362	8	2	3	0	375
24988	352	1	4	2	0	359
24989	9	362	3	1	0	375
24990	2	362	2	2	0	368
24991	1	8	6	354	0	369
24992	0	2	354	8	0	364
24993	336	0	8	4	0	348
24994	354	0	1	3	0	358
24995	8	1	0	344	0	353
24996	2	0	2	345	0	349
24997	325	1	0	9	0	335
24998	9	1	319	1	0	330
24999	308	0	8	2	0	318
25000	8	326	1	1	0	336
25001	2	8	0	301	0	311
25002	0	314	1	8	0	323
25003	316	7	2	2	0	327
25004	11	1	0	301	0	313
25005	3	0	0	304	0	307
25006	0	304	1	7	0	312
25007	302	7	1	3	0	313
25008	309	0	0	1	0	310
25009	7	0	309	1	0	317
25010	1	2	296	0	0	299
25011	281	1	6	2	0	290
25012	6	0	276	1	0	283
25013	0	1	276	0	0	277
25014	278	0	6	1	0	285
25015	6	0	318	1	0	325
25016	0	1	7	308	0	316
25017	1	1	0	310	0	312
25018	317	0	1	8	0	326
25019	10	0	326	1	0	337
25020	324	0	10	1	0	335
25021	12	0	2	330	0	344
25022	332	0	0	11	0	343
25023	330	0	2	2	0	334
25024	328	0	2	2	0	332
25025	13	1	0	321	0	335
25026	318	0	3	11	0	332
25027	17	0	0	314	0	331
25028	5	1	0	327	0	333
25029	5	0	0	324	0	329
25030	7	1	1	320	0	329
25031	318	0	0	12	0	330
25032	319	0	1	7	0	327
25033	14	0	313	5	0	332
25034	317	0	9	4	0	330
25035	324	0	1	7	0	332
25036	17	0	1	314	0	332
25037	5	315	0	12	0	332
25038	320	10	2	1	0	333
25039	17	1	0	313	0	331
25040	312	1	2	12	0	327
25041	13	312	2	2	0	329
25042	329	12	0	1	0	342
25043	16	1	0	318	0	335
25044	2	316	1	11	0	330
25045	325	11	0	2	0	338
25046	12	309	0	4	0	325
25047	4	346	0	3	0	353
25048	339	14	0	1	0	354
25049	14	4	330	2	0	350
25050	340	3	10	2	0	355
25051	18	5	0	336	0	359
25052	3	3	345	12	0	363
25053	6	1	11	338	0	356
25054	8	3	1	357	0	369
25055	4	3	355	13	0	375
25056	339	0	14	6	0	359
25057	14	1	3	345	0	363
25058	5	1	1	356	0	363
25059	4	0	4	347	0	355
25060	339	1	3	17	0	360
25061	15	1	336	6	0	358
25062	2	1	331	6	0	340
25063	6	1	10	304	0	321
25064	4	0	298	12	0	314
25065	299	0	9	6	0	314
25066	9	298	3	6	0	316
25067	290	8	3	5	0	306
25068	13	1	3	285	0	302
25069	3	287	5	9	0	304
25070	5	9	3	287	0	304
25071	4	300	3	10	0	317
25072	8	8	2	292	0	310
25073	2	4	291	12	0	309
25074	4	3	278	2	0	287
25075	3	283	7	7	0	300
25076	260	9	2	6	0	277
25077	9	2	3	259	0	273
25078	2	4	3	266	0	275
25079	262	2	1	13	0	278
25080	264	2	4	6	0	276
25081	10	1	3	256	0	270
25082	5	3	248	7	0	263
25083	6	257	7	4	0	274
25084	5	7	4	254	0	270
25085	7	4	0	252	0	263
25086	3	263	3	9	0	278
25087	270	8	2	4	0	284
25088	7	6	259	8	0	280
25089	5	1	11	251	0	268
25090	2	3	4	260	0	269
25091	2	5	254	10	0	271
25092	3	1	7	252	0	263
25093	255	3	3	12	0	273
25094	257	1	1	7	0	266
25095	258	2	4	5	0	269
25096	11	254	4	5	0	274
25097	262	7	0	10	0	279
25098	11	3	6	261	0	281
25099	6	2	2	263	0	273
25100	3	269	2	12	0	286
25101	295	9	2	4	0	310
25102	307	2	1	4	0	314
25103	304	5	3	3	0	315
25104	314	3	2	1	0	320
25105	312	3	0	6	0	321
25106	16	1	288	8	0	313
25107	292	3	11	6	0	312
25108	304	4	2	3	0	313
25109	304	0	0	3	0	307
25110	19	1	3	285	0	308
25111	14	1	3	291	0	309
25112	9	3	279	12	0	303
25113	235	5	14	4	0	258
25114	15	259	4	8	0	286
25115	10	221	3	4	0	238
25116	10	9	228	1	0	248
25117	6	229	9	5	0	249
25118	4	218	9	7	0	238
25119	6	11	4	187	0	208
25120	4	194	1	7	0	206
25121	193	6	0	1	0	200
25122	194	3	1	1	0	199
25123	9	0	1	191	0	201
25124	5	2	188	6	0	201
25125	179	3	6	1	0	189
25126	9	1	184	3	0	197
25127	4	3	189	2	0	198
25128	5	0	10	175	0	190
25129	8	2	1	183	0	194
25130	4	3	190	8	0	205
25131	3	181	7	2	0	193
25132	4	199	1	3	0	207
25133	194	6	1	3	0	204
25134	207	2	3	1	0	213
25135	9	0	192	4	0	205
25136	195	1	7	3	0	206
25137	208	1	4	3	0	216
25138	11	2	1	198	0	212
25139	3	3	1	207	0	214
25140	4	1	1	205	0	211
25141	207	0	1	8	0	216
25142	214	1	2	1	0	218
25143	231	3	0	0	0	234
25144	10	2	0	224	0	236
25145	2	1	213	10	0	226
25146	211	1	8	3	0	223
25147	208	1	2	4	0	215
25148	11	1	0	207	0	219
25149	3	209	2	6	0	220
25150	4	6	1	207	0	218
25151	2	211	0	8	0	221
25152	2	6	4	202	0	214
25153	3	212	2	7	0	224
25154	204	7	0	2	0	213
25155	9	1	1	203	0	214
25156	3	208	0	7	0	218
25157	1	5	206	4	0	216
25158	195	3	11	0	0	209
25159	11	0	1	199	0	211
25160	1	206	1	8	0	216
25161	4	5	1	193	0	203
25162	0	192	0	10	0	202
25163	1	206	0	3	0	210
25164	196	7	3	0	0	206
25165	206	3	0	0	0	209
25166	9	1	194	3	0	207
25167	197	1	5	1	0	204
25168	200	1	1	3	0	205
25169	7	200	2	0	0	209
25170	4	6	1	197	0	208
25171	5	2	0	194	0	201
25172	2	1	187	8	0	198
25173	1	1	184	3	0	189
25174	184	1	5	3	0	193
25175	195	2	1	2	0	200
25176	193	2	0	1	0	196
25177	9	0	182	2	0	193
25178	2	0	5	182	0	189
25179	183	1	4	5	0	193
25180	6	0	2	183	0	191
25181	4	2	179	6	0	191
25182	170	2	5	3	0	180
25183	7	1	187	3	0	198
25184	1	182	7	1	0	191
25185	183	7	2	2	0	194
25186	8	1	186	1	0	196
25187	3	1	5	181	0	190
25188	186	0	2	5	0	193
25189	7	0	0	189	0	196
25190	196	1	1	7	0	205
25191	7	2	1	191	0	201
25192	198	0	0	8	0	206
25193	196	0	1	6	0	203
25194	194	1	1	2	0	198
25195	192	0	2	0	0	194
25196	8	0	1	185	0	194
25197	4	0	176	5	0	185
25198	1	1	181	2	0	185
25199	2	179	5	1	0	187
25200	3	173	1	1	0	178
25201	153	1	2	1	0	157
25202	2	0	0	148	0	150
25203	1	0	146	1	0	148
25204	0	0	141	1	0	142
25205	0	0	2	142	0	144
25206	148	0	0	4	0	152
25207	2	149	0	0	0	151
25208	152	1	0	2	0	155
25209	2	0	0	152	0	154
25210	0	0	0	153	0	153
25211	0	0	1	156	0	157
25212	1	0	157	1	0	159
25213	1	1	145	0	0	147
25214	0	155	1	1	0	157
25215	0	2	0	161	0	163
25216	156	0	0	3	0	159
25217	1	2	159	0	0	162
25218	0	0	164	1	0	165
25219	1	1	2	169	0	173
25220	2	0	0	172	0	174
25221	0	0	0	183	0	183
25222	3	1	0	193	0	197
25223	202	0	0	5	0	207
25224	5	0	0	202	0	207
25225	201	0	0	6	0	207
25226	4	1	205	0	0	210
25227	1	203	4	0	0	208
25228	0	5	0	201	0	206
25229	0	0	200	6	0	206
25230	1	1	188	0	0	190
25231	0	191	4	2	0	197
25232	2	3	0	188	0	193
25233	0	0	1	192	0	193
25234	1	1	181	3	0	186
25235	176	1	5	1	0	183
25236	4	1	1	182	0	188
25237	1	0	1	182	0	184
25238	1	1	180	4	0	186
25239	1	173	4	0	0	178
25240	0	187	1	1	0	189
25241	181	5	1	1	0	188
25242	6	1	0	184	0	191
25243	183	0	2	7	0	192
25244	6	0	185	2	0	193
25245	2	1	5	183	0	191
25246	179	1	1	10	0	191
25247	183	1	0	2	0	186
25248	7	0	1	178	0	186
25249	2	1	176	7	0	186
25250	2	0	173	2	0	177
25251	1	0	7	169	0	177
25252	1	0	165	5	0	171
25253	157	0	7	3	0	167
25254	6	159	1	1	0	167
25255	174	5	0	2	0	181
25256	173	1	1	3	0	178
25257	7	0	1	169	0	177
25258	1	0	2	176	0	179
25259	170	0	1	8	0	179
25260	7	0	0	172	0	179
25261	2	1	173	6	0	182
25262	2	164	6	2	0	174
25263	2	6	1	167	0	176
25264	1	1	0	173	0	175
25265	1	0	0	184	0	185
25266	1	0	175	7	0	183
25267	1	177	5	3	0	186
25268	1	6	2	181	0	190
25269	1	2	182	6	0	191
25270	2	0	6	181	0	189
25271	181	1	1	9	0	192
25272	5	0	0	183	0	188
25273	2	1	181	7	0	191
25274	180	1	5	3	0	189
25275	5	180	3	1	0	189
25276	1	190	1	0	0	192
25277	183	6	0	3	0	192
25278	6	1	187	0	0	194
25279	1	0	6	186	0	193
25280	3	1	3	186	0	193
25281	1	1	184	7	0	193
25282	0	186	5	3	0	194
25283	1	6	3	164	0	174
25284	2	3	181	6	0	192
25285	2	0	6	178	0	186
25286	185	0	1	9	0	195
25287	6	0	190	2	0	198
25288	2	0	7	189	0	198
25289	0	3	1	190	0	194
25290	2	1	183	7	0	193
25291	3	1	6	172	0	182
25292	2	169	3	7	0	181
25293	3	5	3	172	0	183
25294	0	186	2	5	0	193
25295	186	5	1	3	0	195
25296	188	2	2	2	0	194
25297	7	0	179	2	0	188
25298	2	1	176	2	0	181
25299	1	1	184	1	0	187
25300	2	173	6	4	0	185
25301	0	5	4	182	0	191
25302	2	1	187	8	0	198
25303	2	1	5	179	0	187
25304	2	0	4	182	0	188
25305	3	0	188	5	0	196
25306	1	2	7	184	0	194
25307	0	1	3	187	0	191
25308	2	187	1	6	0	196
25309	1	7	1	180	0	189
25310	2	1	1	194	0	198
25311	1	1	191	7	0	200
25312	0	0	6	195	0	201
25313	0	0	192	8	0	200
25314	1	1	183	4	0	189
25315	181	0	7	4	0	192
25316	5	6	3	172	0	186
25317	1	174	2	7	0	184
25318	2	170	2	4	0	178
25319	1	6	1	175	0	183
25320	1	2	177	4	0	184
25321	1	168	5	4	0	178
25322	3	2	1	144	0	150
25323	0	2	147	3	0	152
25324	0	147	2	1	0	150
25325	156	1	2	1	0	160
25326	155	2	0	3	0	160
25327	164	0	0	3	0	167
25328	3	0	1	171	0	175
25329	4	0	0	170	0	174
25330	2	1	0	167	0	170
25331	0	1	169	2	0	172
25332	182	0	1	2	0	185
25333	1	0	2	186	0	189
25334	1	0	185	2	0	188
25335	180	0	1	3	0	184
25336	187	1	2	1	0	191
25337	2	3	164	1	0	170
25338	193	1	1	4	0	199
25339	2	207	2	1	0	212
25340	0	1	212	2	0	215
25341	200	0	1	6	0	207
25342	2	202	1	0	0	205
25343	0	0	0	192	0	192
25344	0	193	0	0	0	193
25345	1	0	0	198	0	199
25346	0	0	196	1	0	197
25347	174	1	1	2	0	178
25348	1	0	196	0	0	197
25349	0	192	0	1	0	193
25350	0	197	1	1	0	199
25351	198	0	0	0	0	198
25352	0	1	197	0	0	198
25353	0	0	0	190	0	190
25354	0	1	198	0	0	199
25355	0	196	0	1	0	197
25356	0	0	1	184	0	185
25357	1	193	1	0	0	195
25358	204	0	1	2	0	207
25359	209	1	0	0	0	210
25360	209	1	0	0	0	210
25361	1	0	204	0	0	205
25362	0	1	200	0	0	201
25363	194	0	0	2	0	196
25364	0	0	207	0	0	207
25365	2	1	0	188	0	191
25366	1	196	0	1	0	198
25367	200	0	0	0	0	200
25368	195	0	0	0	0	195
25369	194	0	0	0	0	194
25370	1	0	0	197	0	198
25371	1	0	1	197	0	199
25372	199	0	1	1	0	201
25373	1	204	1	0	0	206
25374	201	0	1	0	0	202
25375	1	0	0	201	0	202
25376	0	1	1	194	0	196
25377	199	0	0	0	0	199
25378	1	194	0	0	0	195
25379	193	0	0	0	0	193
25380	0	195	0	0	0	195
25381	195	1	0	1	0	197
25382	1	0	1	203	0	205
25383	198	1	0	0	0	199
25384	204	0	0	1	0	205
25385	239	0	0	2	0	241
25386	3	236	1	1	0	241
25387	1	2	232	1	0	236
25388	228	1	3	0	0	232
25389	238	0	0	0	0	238
25390	2	237	1	0	0	240
25391	2	3	0	243	0	248
25392	1	1	1	242	0	245
25393	242	0	0	2	0	244
25394	6	1	1	244	0	252
25395	3	1	247	2	0	253
25396	2	1	237	2	0	242
25397	251	1	4	1	0	257
25398	5	0	2	245	0	252
25399	1	1	1	260	0	263
25400	2	1	1	257	0	261
25401	0	0	266	4	0	270
25402	5	0	2	258	0	265
25403	3	1	2	264	0	270
25404	1	0	1	271	0	273
25405	271	0	0	4	0	275
25406	3	0	3	268	0	274
25407	2	1	278	5	0	286
25408	290	1	3	6	0	300
25409	5	0	308	2	0	315
25410	303	1	2	4	0	310
25411	294	0	3	1	0	298
25412	6	1	0	307	0	314
25413	4	304	1	7	0	316
25414	3	2	1	317	0	323
25415	4	4	0	312	0	320
25416	3	329	2	6	0	340
25417	331	4	2	4	0	341
25418	4	335	0	1	0	340
25419	327	2	1	4	0	334
25420	329	3	0	3	0	335
25421	7	1	0	321	0	329
25422	5	1	1	318	0	325
25423	1	3	318	6	0	328
25424	1	1	312	5	0	319
25425	311	0	5	4	0	320
25426	316	1	2	2	0	321
25427	7	295	0	2	0	304
25428	5	3	1	292	0	301
25429	3	2	308	4	0	317
25430	4	5	4	304	0	317
25431	304	0	4	3	0	311
25432	294	1	0	3	0	298
25433	6	285	1	2	0	294
25434	3	6	0	282	0	291
25435	1	2	0	295	0	298
25436	2	0	0	290	0	292
25437	2	1	281	4	0	288
25438	262	1	4	4	0	271
25439	283	1	3	3	0	290
25440	5	1	289	1	0	296
25441	5	285	4	1	0	295
25442	286	3	4	1	0	294
25443	291	2	0	3	0	296
25444	7	0	280	2	0	289
25445	2	1	285	1	0	289
25446	2	2	5	288	0	297
25447	3	1	288	6	0	298
25448	281	2	4	6	0	293
25449	292	0	3	3	0	298
25450	295	1	1	4	0	301
25451	10	2	1	288	0	301
25452	6	323	1	5	0	335
25453	331	3	4	7	0	345
25454	323	3	0	6	0	332
25455	10	0	323	2	0	335
25456	3	0	313	3	0	319
25457	306	5	5	2	0	318
25458	6	1	2	325	0	334
25459	5	0	320	7	0	332
25460	2	322	4	4	0	332
25461	5	3	5	322	0	335
25462	320	6	0	4	0	330
25463	8	330	0	5	0	343
25464	8	3	2	330	0	343
25465	0	334	2	7	0	343
25466	2	336	1	7	0	346
25467	3	5	3	347	0	358
25468	2	3	5	340	0	350
25469	7	344	2	6	0	359
25470	342	4	0	7	0	353
25471	5	6	345	2	0	358
25472	334	0	5	5	0	344
25473	4	2	6	349	0	361
25474	8	1	1	356	0	366
25475	8	0	0	353	0	361
25476	5	2	3	355	0	365
25477	3	5	351	6	0	365
25478	3	0	4	356	0	363
25479	2	0	5	351	0	358
25480	2	375	3	11	0	391
25481	4	6	375	2	0	387
25482	6	385	5	2	0	398
25483	5	6	390	2	0	403
25484	1	407	7	3	0	418
25485	3	5	2	371	0	381
25486	361	2	2	8	0	373
25487	5	367	4	3	0	379
25488	6	4	1	376	0	387
25489	4	4	376	5	0	389
25490	3	381	6	4	0	394
25491	376	9	5	6	0	396
25492	389	5	0	7	0	401
25493	10	391	5	2	0	408
25494	5	7	390	1	0	403
25495	374	3	7	4	0	388
25496	12	2	3	389	0	406
25497	397	4	2	10	0	413
25498	7	398	2	4	0	411
25499	7	397	2	3	0	409
25500	2	10	390	6	0	408
25501	379	4	15	3	0	401
25502	9	5	3	382	0	399
25503	381	2	3	12	0	398
25504	9	390	3	4	0	406
25505	383	8	1	4	0	396
25506	379	4	2	10	0	395
25507	11	2	384	2	0	399
25508	3	349	7	3	0	362
25509	4	361	5	0	0	370
25510	8	12	1	334	0	355
25511	2	336	3	7	0	348
25512	337	8	3	4	0	352
25513	8	346	2	1	0	357
25514	6	11	0	333	0	350
25515	2	330	1	9	0	342
25516	3	326	1	2	0	332
25517	1	350	1	0	0	352
25518	4	8	3	341	0	356
25519	5	3	2	348	0	358
25520	4	3	2	351	0	360
25521	3	346	2	8	0	359
25522	5	7	337	4	0	353
25523	5	3	315	3	0	326
25524	332	2	8	7	0	349
25525	7	6	2	338	0	353
25526	2	7	340	5	0	354
25527	2	4	342	3	0	351
25528	3	365	7	2	0	377
25529	4	6	1	367	0	378
25530	4	5	4	371	0	384
25531	371	3	2	10	0	386
25532	7	6	0	367	0	380
25533	6	4	1	377	0	388
25534	1	6	384	10	0	401
25535	3	6	7	371	0	387
25536	2	2	3	394	0	401
25537	5	2	391	14	0	412
25538	2	3	388	6	0	399
25539	2	380	8	4	0	394
25540	2	8	379	2	0	391
25541	5	4	10	367	0	386
25542	8	1	5	303	0	317
25543	2	5	381	7	0	395
25544	2	372	11	3	0	388
25545	368	9	3	5	0	385
25546	5	374	2	9	0	390
25547	2	9	3	387	0	401
25548	4	4	2	388	0	398
25549	3	387	2	10	0	402
25550	2	6	4	393	0	405
25551	3	3	4	389	0	399
25552	2	2	353	14	0	371
25553	1	349	9	6	0	365
25554	1	8	6	362	0	377
25555	0	3	364	12	0	379
25556	4	2	13	361	0	380
25557	1	6	5	359	0	371
25558	7	1	4	353	0	365
25559	2	1	6	356	0	365
25560	3	2	3	356	0	364
25561	1	352	4	12	0	369
25562	350	8	4	5	0	367
25563	8	8	340	6	0	362
25564	318	3	7	9	0	337
25565	5	5	366	5	0	381
25566	3	378	8	4	0	393
25567	2	9	367	6	0	384
25568	3	368	9	8	0	388
25569	2	6	6	359	0	373
25570	1	7	5	353	0	366
25571	1	359	4	8	0	372
25572	3	391	3	4	0	401
25573	375	8	1	8	0	392
25574	388	3	3	8	0	402
25575	382	5	1	11	0	399
25576	388	6	1	9	0	404
25577	14	1	1	385	0	401
25578	3	387	1	11	0	402
25579	398	8	1	7	0	414
25580	9	3	4	375	0	391
25581	374	3	1	10	0	388
25582	367	2	4	7	0	380
25583	7	352	2	2	0	363
25584	1	325	4	4	0	334
25585	2	355	0	3	0	360
25586	4	4	1	342	0	351
25587	2	342	1	6	0	351
25588	346	3	0	7	0	356
25589	352	2	1	5	0	360
25590	355	1	0	5	0	361
25591	360	1	1	6	0	368
25592	363	1	1	4	0	369
25593	7	2	361	1	0	371
25594	356	2	3	8	0	369
25595	5	0	367	0	0	372
25596	344	1	4	3	0	352
25597	5	1	2	347	0	355
25598	1	1	355	1	0	358
25599	3	1	353	1	0	358
25600	0	384	3	2	0	389
25601	386	2	1	2	0	391
25602	396	1	1	5	0	403
25603	4	446	1	0	0	451
25604	3	4	1	485	0	493
25605	526	1	0	8	0	535
25606	6	4	544	1	0	555
25607	3	538	6	2	0	549
25608	538	10	2	3	0	553
25609	6	557	3	6	0	572
25610	10	8	1	531	0	550
25611	2	564	4	3	0	573
25612	2	14	0	542	0	558
25613	7	544	1	8	0	560
25614	1	576	2	2	0	581
25615	550	9	0	13	0	572
25616	562	11	0	7	0	580
25617	8	6	572	7	0	593
25618	6	8	556	1	0	571
25619	6	8	556	0	0	570
25620	8	0	11	571	0	590
25621	7	2	580	6	0	595
25622	7	2	17	564	0	590
25623	3	3	9	560	0	575
25624	2	571	8	13	0	594
25625	572	8	3	15	0	598
25626	6	575	10	5	0	596
25627	4	12	1	590	0	607
25628	6	4	0	584	0	594
25629	3	9	1	578	0	591
25630	8	3	571	13	0	595
25631	3	8	8	573	0	592
25632	3	5	3	574	0	585
25633	2	2	6	584	0	594
25634	7	7	563	15	0	592
25635	2	559	14	9	0	584
25636	551	10	4	17	0	582
25637	530	4	6	14	0	554
25638	7	561	4	7	0	579
25639	8	11	9	558	0	586
25640	8	12	1	568	0	589
25641	12	4	556	12	0	584
25642	8	554	9	7	0	578
25643	4	14	5	567	0	590
25644	3	4	571	15	0	593
25645	5	4	10	563	0	582
25646	3	2	13	554	0	572
25647	0	8	554	16	0	578
25648	5	0	9	560	0	574
25649	5	3	11	539	0	558
25650	3	4	555	18	0	580
25651	2	5	7	564	0	578
25652	4	1	11	535	0	551
25653	2	5	5	570	0	582
25654	1	4	532	36	0	573
25655	7	1	17	551	0	576
25656	533	0	6	26	0	565
25657	546	2	6	17	0	571
25658	7	550	4	16	0	577
25659	553	7	12	9	0	581
25660	9	5	606	11	0	631
25661	11	7	9	604	0	631
25662	13	2	6	608	0	629
25663	5	8	4	617	0	634
25664	591	4	1	18	0	614
25665	9	585	8	12	0	614
25666	3	8	4	577	0	592
25667	5	588	4	17	0	614
25668	583	10	5	17	0	615
25669	13	588	4	10	0	615
25670	579	16	4	7	0	606
25671	11	572	2	14	0	599
25672	5	580	4	9	0	598
25673	12	9	1	584	0	606
25674	3	10	4	585	0	602
25675	11	7	2	579	0	599
25676	7	8	2	577	0	594
25677	3	8	569	15	0	595
25678	4	566	6	16	0	592
25679	1	10	5	555	0	571
25680	2	555	7	16	0	580
25681	3	10	553	15	0	581
25682	10	4	9	544	0	567
25683	5	9	2	568	0	584
25684	5	5	561	14	0	585
25685	2	539	11	8	0	560
25686	3	9	10	548	0	570
25687	1	4	539	16	0	560
25688	1	537	8	14	0	560
25689	4	7	9	525	0	545
25690	4	11	532	11	0	558
25691	6	7	494	12	0	519
25692	1	514	11	10	0	536
25693	2	552	5	6	0	565
25694	5	7	3	568	0	583
25695	4	4	7	582	0	597
25696	4	8	584	8	0	604
25697	540	10	6	7	0	563
25698	564	7	3	9	0	583
25699	7	1	560	12	0	580
25700	5	528	9	9	0	551
25701	5	523	7	6	0	541
25702	5	508	6	9	0	528
25703	3	413	6	7	0	429
25704	9	12	21	441	0	483
25705	2	8	0	512	0	522
25706	1	1	0	504	0	506
25707	2	0	1	507	0	510
25708	1	518	0	14	0	533
25709	4	8	1	510	0	523
25710	0	508	1	10	0	519
25711	2	10	0	520	0	532
25712	513	3	0	11	0	527
25713	9	4	1	522	0	536
25714	4	500	1	11	0	516
25715	7	6	0	520	0	533
25716	1	5	0	529	0	535
25717	0	4	0	513	0	517
25718	493	1	0	24	0	518
25719	9	4	1	501	0	515
25720	5	0	487	16	0	508
25721	3	499	6	8	0	516
25722	3	9	4	511	0	527
25723	8	5	4	503	0	520
25724	3	4	0	523	0	530
25725	504	6	0	16	0	526
25726	8	1	497	14	0	520
25727	5	1	7	488	0	501
25728	3	493	4	15	0	515
25729	5	11	2	496	0	514
25730	477	7	1	20	0	505
25731	8	478	4	9	0	499
25732	6	14	0	488	0	508
25733	6	4	0	499	0	509
25734	2	477	2	19	0	500
25735	4	8	1	496	0	509
25736	6	6	0	498	0	510
25737	0	5	477	15	0	497
25738	0	469	7	16	0	492
25739	476	13	4	9	0	502
25740	9	4	480	9	0	502
25741	477	5	9	1	0	492
25742	10	8	488	4	0	510
25743	7	4	10	494	0	515
25744	484	0	5	20	0	509
25745	11	6	3	480	0	500
25746	498	2	1	23	0	524
25747	507	1	1	15	0	524
25748	507	2	7	7	0	523
25749	14	501	2	5	0	522
25750	16	10	0	487	0	513
25751	6	4	6	505	0	521
25752	8	5	1	497	0	511
25753	1	5	491	16	0	513
25754	7	0	7	498	0	512
25755	486	1	7	15	0	509
25756	488	1	4	15	0	508
25757	18	4	481	5	0	508
25758	484	1	6	10	0	501
25759	501	1	4	4	0	510
25760	17	10	3	441	0	471
25761	451	1	1	16	0	469
25762	456	0	1	14	0	471
25763	16	5	0	447	0	468
25764	449	1	7	13	0	470
25765	446	1	1	16	0	464
25766	21	2	2	446	0	471
25767	12	4	352	14	0	382
25768	420	1	11	10	0	442
25769	15	2	433	5	0	455
25770	14	5	419	3	0	441
25771	6	423	12	8	0	449
25772	8	6	8	415	0	437
25773	12	5	3	430	0	450
25774	6	3	1	430	0	440
25775	9	1	410	19	0	439
25776	10	3	412	10	0	435
25777	3	418	11	14	0	446
25778	6	9	7	407	0	429
25779	12	4	5	415	0	436
25780	8	3	7	427	0	445
25781	2	2	412	18	0	434
25782	2	408	10	11	0	431
25783	7	10	5	415	0	437
25784	3	5	415	18	0	441
25785	5	4	414	13	0	436
25786	410	3	19	6	0	438
25787	415	2	14	5	0	436
25788	418	5	4	5	0	432
25789	14	3	4	402	0	423
25790	12	1	403	15	0	431
25791	10	394	10	11	0	425
25792	2	414	12	10	0	438
25793	3	16	356	6	0	381
25794	9	12	15	317	0	353
25795	4	4	9	300	0	317
25796	2	286	15	12	0	315
25797	10	304	2	8	0	324
25798	297	7	6	5	0	315
25799	307	8	5	3	0	323
25800	311	3	1	7	0	322
25801	309	2	8	4	0	323
25802	295	5	1	5	0	306
25803	18	286	2	2	0	308
25804	4	193	3	2	0	202
25805	3	135	1	1	0	140
25806	129	2	4	2	0	137
25807	3	14	6	109	0	132
25808	1	1	2	107	0	111
25809	107	1	1	3	0	112
25810	3	107	0	3	0	113
25811	2	1	0	108	0	111
25812	1	0	2	110	0	113
25813	3	0	1	104	0	108
25814	100	0	0	1	0	101
25815	4	0	0	103	0	107
25816	1	1	99	2	0	103
25817	102	0	1	2	0	105
25818	5	0	0	104	0	109
25819	2	0	104	4	0	110
25820	2	96	3	0	0	101
25821	3	91	0	1	0	95
25822	88	2	0	3	0	93
25823	87	0	4	0	0	91
25824	3	94	1	0	0	98
25825	1	3	0	100	0	104
25826	101	0	0	3	0	104
25827	5	0	0	119	0	124
25828	2	1	1	121	0	125
25829	2	0	0	121	0	123
25830	1	1	1	123	0	126
25831	2	117	0	7	0	126
25832	1	3	0	125	0	129
25833	0	1	1	123	0	125
25834	1	1	1	125	0	128
25835	0	2	118	5	0	125
25836	1	119	4	2	0	126
25837	2	3	1	124	0	130
25838	0	2	122	5	0	129
25839	0	0	121	2	0	123
25840	1	124	4	0	0	129
25841	121	4	1	2	0	128
25842	4	1	1	123	0	129
25843	125	0	1	6	0	132
25844	3	135	0	2	0	140
25845	3	3	0	136	0	142
25846	123	1	0	7	0	131
25847	127	0	1	3	0	131
25848	7	1	0	124	0	132
25849	2	0	1	122	0	125
25850	1	1	124	5	0	131
25851	2	1	3	116	0	122
25852	0	1	1	128	0	130
25853	120	0	1	6	0	127
25854	3	120	1	2	0	126
25855	2	4	121	1	0	128
25856	113	1	3	3	0	120
25857	6	119	1	1	0	127
25858	3	5	1	121	0	130
25859	120	1	2	6	0	129
25860	5	1	0	121	0	127
25861	3	1	0	125	0	129
25862	0	1	121	8	0	130
25863	2	0	3	125	0	130
25864	121	0	2	6	0	129
25865	4	1	0	124	0	129
25866	119	0	2	5	0	126
25867	5	109	0	3	0	117
25868	2	117	0	3	0	122
25869	0	4	3	116	0	123
25870	4	2	2	113	0	121
25871	110	3	0	5	0	118
25872	4	114	1	3	0	122
25873	118	3	1	2	0	124
25874	117	3	0	2	0	122
25875	3	1	1	113	0	118
25876	113	1	0	4	0	118
25877	6	0	107	2	0	115
25878	4	1	3	106	0	114
25879	1	0	108	7	0	116
25880	2	0	3	110	0	115
25881	102	0	3	4	0	109
25882	108	0	1	4	0	113
25883	4	107	1	3	0	115
25884	4	3	1	104	0	112
25885	3	2	0	110	0	115
25886	2	106	1	5	0	114
25887	3	5	0	108	0	116
25888	2	4	0	105	0	111
25889	0	107	1	8	0	116
25890	102	4	0	2	0	108
25891	101	2	1	2	0	106
25892	4	1	0	102	0	107
25893	2	1	2	98	0	103
25894	2	0	90	7	0	99
25895	4	0	3	92	0	99
25896	2	91	2	5	0	100
25897	96	4	1	3	0	104
25898	4	2	0	97	0	103
25899	2	1	1	98	0	102
25900	92	0	0	6	0	98
25901	5	93	0	3	0	101
25902	3	4	0	96	0	103
25903	0	4	0	104	0	108
25904	2	96	0	6	0	104
25905	100	4	0	3	0	107
25906	3	3	97	3	0	106
25907	3	0	100	2	0	105
25908	0	1	6	100	0	107
25909	1	0	100	5	0	106
25910	95	1	5	1	0	102
25911	5	0	3	100	0	108
25912	2	0	98	5	0	105
25913	1	0	114	2	0	117
25914	2	115	4	1	0	122
25915	111	2	1	1	0	115
25916	3	111	1	1	0	116
25917	108	2	0	0	0	110
25918	108	1	0	1	0	110
25919	2	109	0	1	0	112
25920	109	1	0	0	0	110
25921	111	1	0	1	0	113
25922	2	0	111	1	0	114
25923	1	13	1	94	0	109
25924	0	97	1	2	0	100
25925	1	94	0	1	0	96
25926	0	4	1	96	0	101
25927	75	0	0	0	0	75
25928	0	0	0	79	0	79
25929	1	0	0	78	0	79
25930	0	0	0	78	0	78
25931	0	81	0	0	0	81
25932	1	0	0	90	0	91
25933	0	0	99	0	0	99
25934	92	0	0	1	0	93
25935	102	0	0	1	0	103
25936	0	102	0	0	0	102
25937	101	0	0	0	0	101
25938	0	0	0	102	0	102
25939	0	0	103	0	0	103
25940	94	0	0	0	0	94
25941	0	102	0	0	0	102
25942	2	0	0	101	0	103
25943	96	0	0	1	0	97
25944	1	93	0	0	0	94
25945	0	93	0	0	0	93
25946	96	0	0	0	0	96
25947	1	0	92	0	0	93
25948	93	0	0	1	0	94
25949	1	0	0	91	0	92
25950	0	1	0	90	0	91
25951	0	0	89	2	0	91
25952	1	0	83	0	0	84
25953	2	0	0	90	0	92
25954	1	0	93	1	0	95
25955	0	1	96	0	0	97
25956	2	0	1	95	0	98
25957	1	0	1	101	0	103
25958	102	0	0	1	0	103
25959	1	0	0	101	0	102
25960	100	1	1	2	0	104
25961	1	100	0	1	0	102
25962	1	2	0	100	0	103
25963	1	1	111	0	0	113
25964	113	2	1	0	0	116
25965	119	0	0	0	0	119
25966	116	0	1	0	0	117
25967	114	1	0	2	0	117
25968	116	0	0	1	0	117
25969	2	0	0	117	0	119
25970	0	0	115	1	0	116
25971	0	1	108	1	0	110
25972	0	1	104	1	0	106
25973	108	1	1	0	0	110
25974	109	0	0	2	0	111
25975	1	0	0	112	0	113
25976	0	117	0	3	0	120
25977	2	1	0	117	0	120
25978	0	0	117	3	0	120
25979	1	2	113	0	0	116
25980	107	1	1	3	0	112
25981	1	0	122	1	0	124
25982	1	0	2	126	0	129
25983	154	0	0	3	0	157
25984	142	1	0	1	0	144
25985	152	0	0	2	0	154
25986	154	0	0	2	0	156
25987	2	0	150	0	0	152
25988	141	0	1	2	0	144
25989	1	153	1	0	0	155
25990	1	1	1	151	0	154
25991	1	0	149	0	0	150
25992	2	1	1	150	0	154
25993	1	1	156	1	0	159
25994	3	0	0	150	0	153
25995	0	0	1	158	0	159
25996	1	0	154	1	0	156
25997	2	0	2	148	0	152
25998	151	0	1	2	0	154
25999	3	0	2	153	0	158
26000	0	0	1	156	0	157
26001	154	0	0	3	0	157
26002	2	160	0	0	0	162
26003	156	1	0	1	0	158
26004	1	158	0	1	0	160
26005	164	1	0	0	0	165
26006	1	0	162	0	0	163
26007	1	0	1	160	0	162
26008	0	1	0	164	0	165
26009	160	0	0	3	0	163
26010	1	160	1	0	0	162
26011	1	1	0	154	0	156
26012	0	0	0	160	0	160
26013	0	151	0	3	0	154
26014	148	1	0	1	0	150
26015	1	148	0	0	0	149
26016	1	1	0	149	0	151
26017	1	1	0	147	0	149
26018	1	149	0	2	0	152
26019	147	1	0	1	0	149
26020	2	0	139	0	0	141
26021	134	1	1	1	0	137
26022	2	141	0	0	0	143
26023	1	0	0	144	0	145
26024	142	0	0	2	0	144
26025	1	0	1	139	0	141
26026	0	0	0	143	0	143
26027	148	0	0	2	0	150
26028	2	149	0	0	0	151
26029	0	152	0	0	0	152
26030	152	1	0	1	0	154
26031	1	0	152	0	0	153
26032	0	145	2	0	0	147
26033	0	1	0	148	0	149
26034	0	0	180	1	0	181
26035	0	0	2	171	0	173
26036	174	0	1	2	0	177
26037	2	181	0	1	0	184
26038	2	2	0	177	0	181
26039	0	181	0	1	0	182
26040	178	2	0	2	0	182
26041	180	1	0	1	0	182
26042	3	186	0	0	0	189
26043	0	2	0	189	0	191
26044	0	190	1	0	0	191
26045	192	1	0	3	0	196
26046	191	2	0	0	0	193
26047	2	0	0	192	0	194
26048	1	0	0	196	0	197
26049	0	0	191	2	0	193
26050	177	0	1	2	0	180
26051	1	0	187	0	0	188
26052	1	0	1	187	0	189
26053	180	0	1	2	0	183
26054	1	188	0	1	0	190
26055	179	1	0	1	0	181
26056	1	1	174	0	0	176
26057	170	0	1	0	0	171
26058	1	181	2	0	0	184
26059	181	1	1	2	0	185
26060	2	185	1	5	0	193
26061	2	2	0	190	0	194
26062	0	3	186	2	0	191
26063	0	2	171	2	0	175
26064	1	1	2	175	0	179
26065	2	0	175	1	0	178
26066	1	1	2	172	0	176
26067	1	1	1	171	0	174
26068	1	1	177	3	0	182
26069	158	2	1	1	0	162
26070	172	0	1	2	0	175
26071	2	175	0	1	0	178
26072	177	0	0	4	0	181
26073	2	1	0	177	0	180
26074	3	1	190	1	0	195
26075	1	1	1	186	0	189
26076	1	1	2	185	0	189
26077	183	1	0	3	0	187
26078	4	183	0	1	0	188
26079	3	181	0	1	0	185
26080	2	0	1	187	0	190
26081	1	1	1	183	0	186
26082	2	176	1	1	0	180
26083	3	2	1	157	0	163
26084	1	1	2	153	0	157
26085	1	157	0	4	0	162
26086	157	2	0	3	0	162
26087	2	2	2	154	0	160
26088	2	155	2	2	0	161
26089	2	1	2	155	0	160
26090	153	2	1	5	0	161
26091	2	162	1	3	0	168
26092	164	2	1	2	0	169
26093	168	2	1	1	0	172
26094	4	0	1	167	0	172
26095	167	1	2	3	0	173
26096	170	1	1	2	0	174
26097	167	0	1	4	0	172
26098	166	1	0	3	0	170
26099	3	0	1	166	0	170
26100	1	0	1	171	0	173
26101	2	0	169	3	0	174
26102	4	1	1	168	0	174
26103	1	2	2	167	0	172
26104	1	2	169	4	0	176
26105	166	0	2	7	0	175
26106	2	1	3	170	0	176
26107	2	2	182	3	0	189
26108	167	0	1	8	0	176
26109	2	3	202	2	0	209
26110	6	202	1	1	0	210
26111	3	209	4	1	0	217
26112	0	6	0	216	0	222
26113	0	3	243	7	0	253
26114	239	1	4	5	0	249
26115	268	2	3	1	0	274
26116	11	0	259	2	0	272
26117	266	0	4	3	0	273
26118	273	0	2	2	0	277
26119	10	273	1	2	0	286
26120	278	6	0	1	0	285
26121	7	3	1	272	0	283
26122	5	1	269	7	0	282
26123	4	2	4	263	0	273
26124	3	270	3	5	0	281
26125	3	284	2	3	0	292
26126	284	8	2	2	0	296
26127	281	3	1	4	0	289
26128	284	2	3	1	0	290
26129	13	1	1	275	0	290
26130	6	7	1	276	0	290
26131	1	273	2	10	0	286
26132	267	4	2	7	0	280
26133	6	271	4	1	0	282
26134	234	5	1	2	0	242
26135	5	237	2	2	0	246
26136	237	4	0	2	0	243
26137	237	1	1	1	0	240
26138	7	1	1	225	0	234
26139	3	238	1	7	0	249
26140	2	4	238	3	0	247
26141	230	3	5	1	0	239
26142	6	231	4	0	0	241
26143	3	5	230	1	0	239
26144	1	4	236	0	0	241
26145	5	1	7	226	0	239
26146	7	0	2	222	0	231
26147	2	243	0	5	0	250
26148	251	6	1	3	0	261
26149	6	3	1	249	0	259
26150	3	265	1	5	0	274
26151	1	291	1	3	0	296
26152	3	5	273	2	0	283
26153	2	4	281	0	0	287
26154	268	2	5	3	0	278
26155	6	1	283	3	0	293
26156	8	2	5	274	0	289
26157	4	3	2	284	0	293
26158	2	1	280	10	0	293
26159	2	2	7	280	0	291
26160	5	1	1	259	0	266
26161	277	2	1	7	0	287
26162	281	1	4	4	0	290
26163	13	0	1	269	0	283
26164	3	274	1	5	0	283
26165	0	293	1	4	0	298
26166	286	8	2	3	0	299
26167	5	1	279	4	0	289
26168	2	2	6	281	0	291
26169	283	2	4	7	0	296
26170	287	2	1	4	0	294
26171	7	2	2	281	0	292
26172	4	1	275	6	0	286
26173	3	2	260	2	0	267
26174	247	2	7	1	0	257
26175	265	0	3	5	0	273
26176	7	262	2	6	0	277
26177	3	274	3	1	0	281
26178	280	5	1	3	0	289
26179	302	5	2	3	0	312
26180	9	4	1	296	0	310
26181	3	2	3	304	0	312
26182	2	0	3	310	0	315
26183	304	1	1	8	0	314
26184	8	1	2	304	0	315
26185	4	3	299	7	0	313
26186	294	3	7	4	0	308
26187	11	1	3	303	0	318
26188	6	3	318	5	0	332
26189	301	1	6	7	0	315
26190	300	1	3	6	0	310
26191	6	326	2	3	0	337
26192	4	343	3	3	0	353
26193	1	9	320	3	0	333
26194	314	5	6	3	0	328
26195	8	337	4	0	0	349
26196	4	6	322	2	0	334
26197	320	4	3	4	0	331
26198	8	346	3	3	0	360
26199	3	5	345	1	0	354
26200	330	1	4	4	0	339
26201	5	338	3	1	0	347
26202	3	6	2	339	0	350
26203	335	3	0	8	0	346
26204	7	341	2	2	0	352
26205	6	6	0	347	0	359
26206	338	1	3	10	0	352
26207	6	0	339	1	0	346
26208	3	339	4	2	0	348
26209	3	5	328	1	0	337
26210	3	0	5	324	0	332
26211	1	1	328	2	0	332
26212	2	316	4	0	0	322
26213	0	293	1	2	0	296
26214	2	2	7	280	0	291
26215	0	0	0	262	0	262
26216	2	0	0	259	0	261
26217	0	0	271	0	0	271
26218	0	0	1	268	0	269
26219	272	0	0	2	0	274
26220	265	0	0	0	0	265
26221	1	0	270	0	0	271
26222	0	268	1	0	0	269
26223	261	1	0	2	0	264
26224	1	268	1	0	0	270
26225	271	1	0	0	0	272
26226	265	0	0	2	0	267
26227	1	0	262	0	0	263
26228	0	265	0	0	0	265
26229	0	2	0	268	0	270
26230	0	0	271	1	0	272
26231	258	0	1	0	0	259
26232	5	0	0	272	0	277
26233	0	1	272	1	0	274
26234	257	1	1	1	0	260
26235	1	1	278	0	0	280
26236	1	0	1	279	0	281
26237	290	0	0	2	0	292
26238	1	299	0	1	0	301
26239	1	0	303	0	0	304
26240	297	0	1	2	0	300
26241	337	0	0	5	0	342
26242	6	353	0	0	0	359
26243	1	5	0	349	0	355
26244	0	0	1	355	0	356
26245	348	0	0	6	0	354
26246	6	0	0	345	0	351
26247	0	1	357	6	0	364
26248	2	1	5	343	0	351
26249	340	1	0	6	0	347
26250	6	327	1	0	0	334
26251	2	5	0	316	0	323
26252	2	319	1	4	0	326
26253	314	5	0	3	0	322
26254	5	0	0	340	0	345
26255	0	1	0	355	0	356
26256	2	345	0	6	0	353
26257	0	7	340	1	0	348
26258	4	0	6	330	0	340
26259	1	0	0	351	0	352
26260	1	1	0	344	0	346
26261	0	350	1	5	0	356
26262	0	6	345	2	0	353
26263	1	1	345	3	0	350
26264	353	1	6	2	0	362
26265	354	1	1	4	0	360
26266	6	1	352	1	0	360
26267	341	1	7	2	0	351
26268	7	0	353	1	0	361
26269	344	1	7	4	0	356
26270	7	370	1	1	0	379
26271	363	5	3	0	0	371
26272	9	0	369	1	0	379
26273	2	1	373	1	0	377
26274	3	1	7	392	0	403
26275	409	2	0	12	0	423
26276	14	444	3	6	0	467
26277	1	10	511	3	0	525
26278	3	3	17	531	0	554
26279	4	1	3	537	0	545
26280	518	1	2	24	0	545
26281	534	3	2	8	0	547
26282	22	0	2	532	0	556
26283	537	2	1	21	0	561
26284	21	3	533	4	0	561
26285	8	0	18	527	0	553
26286	8	1	4	557	0	570
26287	534	3	3	26	0	566
26288	530	0	4	10	0	544
26289	22	0	1	536	0	559
26290	532	2	1	26	0	561
26291	23	1	529	5	0	558
26292	7	500	16	6	0	529
26293	5	16	511	5	0	537
26294	5	4	18	519	0	546
26295	503	2	6	22	0	533
26296	21	505	4	7	0	537
26297	10	20	3	503	0	536
26298	13	4	3	502	0	522
26299	7	489	3	21	0	520
26300	3	19	4	507	0	533
26301	10	5	2	516	0	533
26302	6	3	4	524	0	537
26303	9	2	1	518	0	530
26304	7	6	2	505	0	520
26305	3	479	3	30	0	515
26306	7	17	1	494	0	519
26307	3	6	2	500	0	511
26308	5	2	475	28	0	510
26309	4	462	20	8	0	494
26310	2	21	3	470	0	496
26311	6	4	4	481	0	495
26312	1	3	3	484	0	491
26313	3	455	2	27	0	487
26314	3	17	455	15	0	490
26315	6	3	20	481	0	510
26316	5	7	470	24	0	506
26317	4	3	480	12	0	499
26318	6	2	18	477	0	503
26319	481	1	9	24	0	515
26320	19	4	4	483	0	510
26321	9	1	5	486	0	501
26322	3	489	8	25	0	525
26323	9	18	2	510	0	539
26324	6	6	5	522	0	539
26325	5	4	519	28	0	556
26326	4	527	19	13	0	563
26327	7	21	8	527	0	563
26328	519	5	9	28	0	561
26329	20	8	518	13	0	559
26330	6	4	22	532	0	564
26331	6	4	4	549	0	563
26332	514	2	7	32	0	555
26333	20	518	6	8	0	552
26334	518	18	3	20	0	559
26335	24	507	1	13	0	545
26336	11	20	6	506	0	543
26337	495	7	3	26	0	531
26338	20	1	490	17	0	528
26339	8	474	18	12	0	512
26340	7	487	4	9	0	507
26341	439	19	3	12	0	473
26342	16	8	6	426	0	456
26343	8	416	6	19	0	449
26344	5	449	4	12	0	470
26345	9	17	6	442	0	474
26346	9	8	3	451	0	471
26347	423	4	3	24	0	454
26348	19	424	1	11	0	455
26349	5	19	3	438	0	465
26350	6	8	427	21	0	462
26351	4	441	16	9	0	470
26352	3	18	425	11	0	457
26353	3	429	19	10	0	461
26354	4	19	15	401	0	439
26355	1	6	3	407	0	417
26356	5	396	1	19	0	421
26357	1	10	390	11	0	412
26358	398	8	11	10	0	427
26359	13	5	5	404	0	427
26360	6	3	3	419	0	431
26361	1	4	400	18	0	423
26362	3	5	13	405	0	426
26363	3	3	399	20	0	425
26364	3	3	15	401	0	422
26365	4	3	398	20	0	425
26366	0	395	16	8	0	419
26367	1	15	400	9	0	425
26368	4	8	18	394	0	424
26369	395	6	7	12	0	420
26370	12	394	4	9	0	419
26371	8	14	1	399	0	422
26372	3	6	399	15	0	423
26373	2	399	12	10	0	423
26374	3	10	4	365	0	382
26375	6	3	364	8	0	381
26376	0	316	5	2	0	323
26377	239	10	3	7	0	259
26378	222	1	0	0	0	223
26379	0	0	0	224	0	224
26380	229	0	0	0	0	229
26381	0	0	0	222	0	222
26382	0	0	0	218	0	218
26383	0	0	225	0	0	225
26384	0	0	0	225	0	225
26385	0	0	1	225	0	226
26386	226	0	0	1	0	227
26387	218	0	0	1	0	219
26388	1	225	0	0	0	226
26389	1	0	227	0	0	228
26390	2	1	0	217	0	220
26391	0	0	213	0	0	213
26392	198	0	0	1	0	199
26393	0	1	208	0	0	209
26394	1	0	0	206	0	207
26395	0	204	1	0	0	205
26396	1	0	0	207	0	208
26397	0	1	0	203	0	204
26398	0	0	210	1	0	211
26399	1	0	0	205	0	206
26400	205	0	1	0	0	206
26401	207	0	0	2	0	209
26402	207	0	0	1	0	208
26403	208	0	0	1	0	209
26404	1	202	0	1	0	204
26405	1	205	0	0	0	206
26406	0	1	0	198	0	199
26407	0	1	0	206	0	207
26408	1	198	0	1	0	200
26409	0	0	0	209	0	209
26410	0	1	0	207	0	208
26411	0	0	0	204	0	204
26412	0	0	0	206	0	206
26413	0	1	0	207	0	208
26414	205	0	0	1	0	206
26415	0	193	0	1	0	194
26416	1	0	188	0	0	189
26417	0	1	0	197	0	198
26418	0	0	0	191	0	191
26419	0	0	0	191	0	191
26420	187	0	0	3	0	190
26421	0	206	1	1	0	208
26422	0	0	0	202	0	202
26423	0	197	0	0	0	197
26424	0	1	0	194	0	195
26425	0	172	0	1	0	173
26426	0	1	199	1	0	201
26427	0	1	3	220	0	224
26428	0	0	269	2	0	271
26429	1	0	3	262	0	266
26430	0	0	2	295	0	297
26431	301	0	0	5	0	306
26432	299	0	0	2	0	301
26433	307	0	0	1	0	308
26434	302	1	0	2	0	305
26435	303	0	0	0	0	303
26436	6	0	1	292	0	299
26437	3	293	0	5	0	301
26438	3	4	0	292	0	299
26439	2	2	292	4	0	300
26440	289	0	4	6	0	299
26441	300	0	2	0	0	302
26442	8	0	0	293	0	301
26443	4	0	1	288	0	293
26444	0	278	0	7	0	285
26445	2	5	0	288	0	295
26446	0	2	0	285	0	287
26447	0	280	1	5	0	286
26448	2	5	0	285	0	292
26449	262	2	0	5	0	269
26450	4	1	274	4	0	283
26451	274	0	3	1	0	278
26452	4	1	271	1	0	277
26453	2	0	4	272	0	278
26454	0	0	1	270	0	271
26455	1	269	0	5	0	275
26456	0	277	1	2	0	280
26457	5	6	0	268	0	279
26458	0	4	266	4	0	274
26459	264	1	4	3	0	272
26460	5	1	4	262	0	272
26461	2	266	0	6	0	274
26462	0	4	1	265	0	270
26463	3	3	0	257	0	263
26464	1	267	0	7	0	275
26465	4	10	0	263	0	277
26466	2	2	256	5	0	265
26467	4	1	250	2	0	257
26468	3	1	6	242	0	252
26469	1	270	0	6	0	277
26470	1	4	2	272	0	279
26471	273	2	2	5	0	282
26472	270	1	0	3	0	274
26473	260	1	1	1	0	263
26474	6	264	1	2	0	273
26475	3	3	259	1	0	266
26476	257	2	4	2	0	265
26477	268	0	1	2	0	271
26478	5	266	0	5	0	276
26479	7	7	1	257	0	272
26480	267	1	0	7	0	275
26481	264	2	0	1	0	267
26482	271	1	3	1	0	276
26483	9	0	1	256	0	266
26484	262	0	3	7	0	272
26485	9	0	0	260	0	269
26486	5	2	1	263	0	271
26487	264	0	0	8	0	272
26488	9	1	0	263	0	273
26489	265	2	2	7	0	276
26490	7	1	3	275	0	286
26491	6	2	0	280	0	288
26492	273	0	2	11	0	286
26493	8	2	265	3	0	278
26494	6	1	5	274	0	286
26495	6	1	3	265	0	275
26496	5	1	1	275	0	282
26497	4	2	1	274	0	281
26498	2	4	1	263	0	270
26499	1	260	2	13	0	276
26500	3	5	2	266	0	276
26501	3	5	264	6	0	278
26502	4	0	4	273	0	281
26503	3	4	0	277	0	284
26504	2	3	1	277	0	283
26505	5	1	265	12	0	283
26506	3	4	264	4	0	275
26507	266	2	6	7	0	281
26508	266	1	3	6	0	276
26509	7	282	5	3	0	297
26510	3	7	1	302	0	313
26511	5	4	1	307	0	317
26512	5	2	5	306	0	318
26513	306	2	2	9	0	319
26514	301	1	4	7	0	313
26515	10	3	1	302	0	316
26516	6	3	0	306	0	315
26517	2	5	2	296	0	305
26518	4	4	1	299	0	308
26519	292	0	3	14	0	309
26520	5	2	288	7	0	302
26521	6	249	6	6	0	267
26522	1	251	1	9	0	262
26523	244	7	1	5	0	257
26524	7	4	2	244	0	257
26525	2	3	236	8	0	249
26526	4	6	199	5	0	214
26527	2	200	5	3	0	210
26528	150	2	1	6	0	159
26529	2	1	149	1	0	153
26530	103	0	9	1	0	113
26531	0	0	0	112	0	112
26532	0	0	0	117	0	117
26533	0	116	0	0	0	116
26534	0	108	0	0	0	108
26535	111	0	0	1	0	112
26536	108	0	0	0	0	108
26537	0	123	0	0	0	123
26538	0	0	120	0	0	120
26539	0	1	125	0	0	126
26540	0	0	0	129	0	129
26541	135	0	0	0	0	135
26542	0	127	0	0	0	127
26543	0	0	0	133	0	133
26544	139	0	0	0	0	139
26545	0	0	0	135	0	135
26546	0	0	0	139	0	139
26547	142	0	0	1	0	143
26548	0	139	0	1	0	140
26549	0	143	0	0	0	143
26550	1	0	150	0	0	151
26551	0	0	0	150	0	150
26552	0	0	0	147	0	147
26553	0	0	154	0	0	154
26554	127	0	0	1	0	128
26555	139	0	0	1	0	140
26556	0	0	152	0	0	152
26557	131	0	0	0	0	131
26558	0	0	159	0	0	159
26559	0	167	0	0	0	167
26560	0	0	0	180	0	180
26561	0	0	0	183	0	183
26562	188	0	0	0	0	188
26563	187	0	0	0	0	187
26564	179	0	0	0	0	179
26565	187	0	0	0	0	187
26566	180	0	0	1	0	181
26567	0	0	187	0	0	187
26568	0	181	0	0	0	181
26569	0	0	0	189	0	189
26570	0	189	0	0	0	189
26571	0	193	0	0	0	193
26572	0	0	0	191	0	191
26573	0	0	0	192	0	192
26574	0	0	192	0	0	192
26575	177	0	0	3	0	180
26576	191	0	0	0	0	191
26577	0	191	0	0	0	191
26578	193	1	0	0	0	194
26579	200	0	1	0	0	201
26580	0	1	1	200	0	202
26581	0	0	210	1	0	211
26582	1	0	201	0	0	202
26583	204	1	0	2	0	207
26584	209	0	0	2	0	211
26585	1	206	0	0	0	207
26586	0	205	0	1	0	206
26587	0	0	0	212	0	212
26588	207	0	0	4	0	211
26589	0	2	207	0	0	209
26590	0	0	0	208	0	208
26591	211	0	1	0	0	212
26592	213	0	0	2	0	215
26593	0	0	0	228	0	228
26594	227	0	1	1	0	229
26595	1	0	219	1	0	221
26596	2	0	238	0	0	240
26597	0	0	1	232	0	233
26598	1	0	0	249	0	250
26599	0	1	1	246	0	248
26600	0	239	0	0	0	239
26601	0	250	0	1	0	251
26602	0	0	0	251	0	251
26603	256	0	0	0	0	256
26604	1	0	0	252	0	253
26605	1	0	0	249	0	250
26606	1	241	0	0	0	242
26607	1	253	0	0	0	254
26608	0	0	1	249	0	250
26609	0	1	0	242	0	243
26610	227	0	0	1	0	228
26611	0	224	0	0	0	224
26612	220	1	0	2	0	223
26613	0	0	0	230	0	230
26614	0	0	225	1	0	226
26615	0	0	223	0	0	223
26616	227	0	0	3	0	230
26617	3	0	1	236	0	240
26618	0	1	1	233	0	235
26619	2	0	0	233	0	235
26620	1	0	238	1	0	240
26621	0	0	0	233	0	233
26622	0	230	1	1	0	232
26623	0	0	2	238	0	240
26624	0	0	0	235	0	235
26625	1	234	0	0	0	235
26626	0	0	0	233	0	233
26627	212	1	0	2	0	215
26628	0	215	0	1	0	216
26629	220	0	0	1	0	221
26630	221	0	1	2	0	224
26631	1	1	0	232	0	234
26632	3	0	0	226	0	229
26633	2	0	1	232	0	235
26634	0	0	228	2	0	230
26635	1	225	0	1	0	227
26636	0	230	1	1	0	232
26637	0	0	1	220	0	221
26638	220	1	0	2	0	223
26639	0	1	0	214	0	215
26640	0	2	217	1	0	220
26641	1	214	0	0	0	215
26642	0	212	0	2	0	214
26643	210	0	1	3	0	214
26644	211	1	0	3	0	215
26645	0	227	1	0	0	228
26646	228	1	0	2	0	231
26647	1	1	227	0	0	229
26648	0	1	216	1	0	218
26649	221	0	0	0	0	221
26650	223	0	1	3	0	227
26651	0	0	2	225	0	227
26652	222	0	0	2	0	224
26653	2	1	232	0	0	235
26654	2	0	239	1	0	242
26655	3	0	0	290	0	293
26656	1	1	1	314	0	317
26657	1	0	1	320	0	322
26658	1	0	1	331	0	333
26659	0	0	1	370	0	371
26660	1	0	356	6	0	363
26661	1	0	4	362	0	367
26662	365	1	2	9	0	377
26663	5	0	1	372	0	378
26664	363	0	1	9	0	373
26665	6	1	2	365	0	374
26666	364	1	1	10	0	376
26667	380	1	1	8	0	390
26668	7	1	1	385	0	394
26669	7	0	0	402	0	409
26670	392	0	3	11	0	406
26671	388	2	1	8	0	399
26672	10	1	381	5	0	397
26673	9	0	5	397	0	411
26674	8	0	1	409	0	418
26675	405	1	1	11	0	418
26676	416	0	0	7	0	423
26677	13	0	2	417	0	432
26678	9	0	2	420	0	431
26679	7	0	1	410	0	418
26680	3	0	2	404	0	409
26681	7	385	0	13	0	405
26682	7	396	3	6	0	412
26683	3	2	4	395	0	404
26684	1	402	3	11	0	417
26685	3	6	0	428	0	437
26686	5	1	416	10	0	432
26687	6	3	400	8	0	417
26688	3	420	4	8	0	435
26689	2	7	6	419	0	434
26690	3	3	407	12	0	425
26691	5	4	4	407	0	420
26692	3	4	3	412	0	422
26693	404	4	3	12	0	423
26694	8	4	4	407	0	423
26695	3	5	448	14	0	470
26696	5	2	446	6	0	459
26697	2	441	9	10	0	462
26698	3	488	7	6	0	504
26699	489	7	2	10	0	508
26700	10	3	516	5	0	534
26701	7	1	6	513	0	527
26702	517	0	4	15	0	536
26703	514	1	2	12	0	529
26704	10	518	2	7	0	537
26705	8	8	3	506	0	525
26706	4	4	7	534	0	549
26707	7	3	6	536	0	552
26708	519	8	3	10	0	540
26709	9	5	524	10	0	548
26710	8	534	7	4	0	553
26711	7	5	6	532	0	550
26712	7	5	3	550	0	565
26713	6	1	544	15	0	566
26714	7	3	7	525	0	542
26715	3	5	3	545	0	556
26716	3	3	2	545	0	553
26717	3	2	2	547	0	554
26718	2	5	526	16	0	549
26719	6	0	10	522	0	538
26720	1	2	553	11	0	567
26721	0	545	8	11	0	564
26722	5	8	3	547	0	563
26723	2	1	5	560	0	568
26724	1	4	550	13	0	568
26725	2	545	9	13	0	569
26726	4	7	5	543	0	559
26727	5	3	551	12	0	571
26728	2	548	6	10	0	566
26729	4	4	7	552	0	567
26730	3	2	556	11	0	572
26731	4	3	8	546	0	561
26732	5	2	6	527	0	540
26733	6	4	3	552	0	565
26734	540	4	4	16	0	564
26735	6	536	6	7	0	555
26736	544	8	2	8	0	562
26737	7	3	548	6	0	564
26738	555	4	7	7	0	573
26739	581	2	2	10	0	595
26740	8	3	2	581	0	594
26741	582	2	1	15	0	600
26742	592	0	5	9	0	606
26743	603	1	2	12	0	618
26744	10	4	3	616	0	633
26745	5	5	2	618	0	630
26746	7	3	588	10	0	608
26747	5	3	563	5	0	576
26748	577	0	8	7	0	592
26749	13	2	3	590	0	608
26750	6	609	1	9	0	625
26751	605	5	3	11	0	624
26752	7	596	3	6	0	612
26753	8	594	4	5	0	611
26754	7	5	575	3	0	590
26755	3	2	566	4	0	575
26756	2	10	10	575	0	597
26757	0	1	620	5	0	626
26758	1	0	557	2	0	560
26759	512	0	0	5	0	517
26760	548	0	0	3	0	551
26761	0	0	0	550	0	550
26762	1	1	0	554	0	556
26763	1	0	562	0	0	563
26764	0	556	2	0	0	558
26765	1	0	0	570	0	571
26766	581	0	1	2	0	584
26767	1	0	0	590	0	591
26768	0	586	0	0	0	586
26769	0	0	568	2	0	570
26770	1	583	0	0	0	584
26771	586	0	0	1	0	587
26772	572	0	0	2	0	574
26773	0	0	0	573	0	573
26774	0	0	574	1	0	575
26775	0	0	518	0	0	518
26776	0	572	1	0	0	573
26777	1	0	0	550	0	551
26778	0	0	1	576	0	577
26779	0	0	577	0	0	577
26780	0	1	0	557	0	558
26781	0	574	0	1	0	575
26782	0	0	0	588	0	588
26783	0	1	0	586	0	587
26784	0	1	578	0	0	579
26785	0	1	0	556	0	557
26786	550	0	1	3	0	554
26787	1	1	567	1	0	570
26788	2	0	546	0	0	548
26789	1	578	3	1	0	583
26790	1	1	1	598	0	601
26791	1	3	1	603	0	608
26792	0	1	596	2	0	599
26793	544	1	1	2	0	548
26794	3	0	1	600	0	604
26795	2	0	568	2	0	572
26796	4	2	2	534	0	542
26797	2	3	564	1	0	570
26798	1	0	534	2	0	537
26799	0	532	3	2	0	537
26800	2	1	3	511	0	517
26801	0	524	3	5	0	532
26802	504	4	3	5	0	516
26803	2	3	519	2	0	526
26804	1	519	1	3	0	524
26805	2	2	3	524	0	531
26806	523	1	1	6	0	531
26807	1	529	3	1	0	534
26808	1	2	2	536	0	541
26809	2	2	0	518	0	522
26810	2	530	2	2	0	536
26811	519	3	1	5	0	528
26812	7	1	0	589	0	597
26813	3	1	2	629	0	635
26814	1	2	614	15	0	632
26815	2	643	11	9	0	665
26816	4	11	7	638	0	660
26817	3	7	2	695	0	707
26818	0	703	4	19	0	726
26819	5	13	2	717	0	737
26820	5	9	2	742	0	758
26821	3	3	2	752	0	760
26822	1	745	1	27	0	774
26823	732	16	2	13	0	763
26824	18	10	738	3	0	769
26825	690	5	18	5	0	718
26826	18	741	10	4	0	773
26827	11	19	1	742	0	773
26828	6	12	733	14	0	765
26829	6	3	20	728	0	757
26830	3	3	9	725	0	740
26831	7	2	3	743	0	755
26832	1	4	722	28	0	755
26833	4	705	17	14	0	740
26834	4	17	724	8	0	753
26835	3	723	21	10	0	757
26836	3	20	737	6	0	766
26837	3	11	21	721	0	756
26838	714	5	14	25	0	758
26839	16	737	6	15	0	774
26840	8	18	723	10	0	759
26841	3	733	18	9	0	763
26842	4	21	753	7	0	785
26843	3	11	19	717	0	750
26844	5	8	10	714	0	737
26845	3	708	7	24	0	742
26846	1	740	10	14	0	765
26847	727	26	3	12	0	768
26848	22	15	5	737	0	779
26849	13	12	734	22	0	781
26850	11	6	21	732	0	770
26851	6	6	739	28	0	779
26852	5	7	745	15	0	772
26853	4	7	26	724	0	761
26854	3	724	16	27	0	770
26855	686	20	12	11	0	729
26856	23	11	9	680	0	723
26857	14	9	5	657	0	685
26858	4	671	10	34	0	719
26859	648	23	10	24	0	705
26860	683	13	8	14	0	718
26861	31	7	3	663	0	704
26862	10	648	10	27	0	695
26863	7	701	8	15	0	731
26864	689	28	5	16	0	738
26865	22	18	679	8	0	727
26866	658	11	22	8	0	699
26867	683	10	15	11	0	719
26868	690	9	10	10	0	719
26869	33	684	5	6	0	728
26870	20	17	3	694	0	734
26871	687	12	7	23	0	729
26872	695	10	3	19	0	727
26873	29	683	10	7	0	729
26874	709	20	5	17	0	751
26875	21	12	5	716	0	754
26876	13	11	5	706	0	735
26877	11	704	6	23	0	744
26878	11	22	4	717	0	754
26879	8	16	2	732	0	758
26880	3	716	5	35	0	759
26881	8	18	4	693	0	723
26882	4	716	6	31	0	757
26883	726	23	9	18	0	776
26884	714	17	2	18	0	751
26885	26	718	7	12	0	763
26886	15	20	708	11	0	754
26887	11	12	20	706	0	749
26888	5	13	711	22	0	751
26889	7	676	25	16	0	724
26890	8	703	11	9	0	731
26891	672	24	3	10	0	709
26892	19	692	8	7	0	726
26893	12	22	5	666	0	705
26894	9	683	4	17	0	713
26895	7	704	4	10	0	725
26896	683	27	3	12	0	725
26897	20	11	5	670	0	706
26898	14	7	659	24	0	704
26899	5	9	629	14	0	657
26900	8	669	24	6	0	707
26901	634	23	11	15	0	683
26902	22	652	6	6	0	686
26903	12	20	7	662	0	701
26904	666	15	5	23	0	709
26905	29	6	6	663	0	704
26906	13	9	2	675	0	699
26907	11	648	1	29	0	689
26908	17	25	2	655	0	699
26909	5	10	654	28	0	697
26910	633	4	21	13	0	671
26911	17	651	7	13	0	688
26912	10	625	4	3	0	642
26913	584	14	3	6	0	607
26914	14	6	569	7	0	596
26915	530	4	22	1	0	557
26916	13	612	2	2	0	629
26917	6	642	4	2	0	654
26918	4	14	645	3	0	666
26919	5	641	11	2	0	659
26920	6	9	6	584	0	605
26921	7	6	1	581	0	595
26922	2	609	0	11	0	622
26923	4	8	2	620	0	634
26924	615	7	1	13	0	636
26925	9	3	606	7	0	625
26926	598	1	8	5	0	612
26927	610	5	5	3	0	623
26928	604	4	2	9	0	619
26929	16	3	589	4	0	612
26930	11	3	11	585	0	610
26931	6	3	603	13	0	625
26932	584	2	11	11	0	608
26933	573	4	5	9	0	591
26934	17	590	6	2	0	615
26935	10	10	2	577	0	599
26936	7	595	6	11	0	619
26937	5	11	614	6	0	636
26938	12	9	10	601	0	632
26939	596	4	8	14	0	622
26940	611	4	2	7	0	624
26941	19	5	4	564	0	592
26942	10	573	3	16	0	602
26943	4	16	575	8	0	603
26944	7	8	569	4	0	588
26945	550	6	18	7	0	581
26946	12	7	584	7	0	610
26947	7	589	19	5	0	620
26948	8	20	10	571	0	609
26949	5	6	582	17	0	610
26950	10	4	15	568	0	597
26951	4	5	583	17	0	609
26952	537	6	13	12	0	568
26953	20	5	8	554	0	587
26954	6	553	10	17	0	586
26955	6	589	8	7	0	610
26956	10	18	5	568	0	601
26957	13	9	2	571	0	595
26958	4	574	7	17	0	602
26959	7	16	579	11	0	613
26960	7	11	15	574	0	607
26961	5	5	581	20	0	611
26962	4	4	583	12	0	603
26963	538	6	23	8	0	575
26964	19	548	13	7	0	587
26965	554	18	6	7	0	585
26966	18	12	7	526	0	563
26967	11	544	9	16	0	580
26968	8	20	6	544	0	578
26969	6	7	7	533	0	553
26970	7	534	10	20	0	571
26971	7	18	538	15	0	578
26972	5	11	18	542	0	576
26973	539	9	11	15	0	574
26974	15	4	11	542	0	572
26975	13	9	6	540	0	568
26976	12	5	523	23	0	563
26977	9	512	23	16	0	560
26978	13	19	10	513	0	555
26979	7	12	521	24	0	564
26980	4	11	522	13	0	550
26981	506	9	23	14	0	552
26982	14	503	20	10	0	547
26983	479	18	11	12	0	520
26984	18	476	9	14	0	517
26985	11	494	7	10	0	522
26986	487	23	6	16	0	532
26987	17	16	8	462	0	503
26988	14	488	15	15	0	532
26989	12	23	7	503	0	545
26990	504	11	9	22	0	546
26991	29	10	495	14	0	548
26992	12	9	499	12	0	532
26993	481	10	23	15	0	529
26994	23	482	14	12	0	531
26995	13	19	492	7	0	531
26996	19	477	19	7	0	522
26997	13	16	14	480	0	523
26998	11	14	469	20	0	514
26999	4	10	23	478	0	515
27000	3	11	479	24	0	517
27001	441	8	24	18	0	491
27002	24	462	17	9	0	512
27003	457	17	10	10	0	494
27004	25	14	7	448	0	494
27005	10	474	6	25	0	515
27006	478	25	9	13	0	525
27007	450	14	10	12	0	486
27008	21	9	475	13	0	518
27009	15	9	466	11	0	501
27010	414	11	25	4	0	454
27011	14	421	16	6	0	457
27012	13	406	10	10	0	439
27013	7	34	20	376	0	437
27014	14	13	397	14	0	438
27015	7	363	13	13	0	396
27016	6	323	11	4	0	344
27017	10	19	5	193	0	227
27018	202	1	1	8	0	212
27019	208	0	1	2	0	211
27020	214	2	0	0	0	216
27021	6	1	223	0	0	230
27022	218	0	5	2	0	225
27023	219	1	1	2	0	223
27024	232	1	1	0	0	234
27025	9	0	0	213	0	222
27026	1	216	3	4	0	224
27027	222	6	1	1	0	230
27028	6	219	1	1	0	227
27029	2	6	0	217	0	225
27030	1	1	237	5	0	244
27031	0	0	5	229	0	234
27032	1	1	1	229	0	232
27033	0	0	227	5	0	232
27034	1	229	5	2	0	237
27035	2	5	0	215	0	222
27036	210	0	1	8	0	219
27037	6	204	1	1	0	212
27038	197	3	1	0	0	201
27039	3	1	2	185	0	191
27040	2	211	0	4	0	217
27041	214	3	1	1	0	219
27042	5	217	1	1	0	224
27043	1	3	209	2	0	215
27044	209	3	4	0	0	216
27045	219	1	0	0	0	220
27046	3	209	0	1	0	213
27047	1	3	209	2	0	215
27048	0	212	5	0	0	217
27049	2	3	1	166	0	172
27050	1	1	0	230	0	232
27051	1	0	2	230	0	233
27052	2	224	0	4	0	230
27053	0	4	0	229	0	233
27054	3	1	1	225	0	230
27055	227	1	0	4	0	232
27056	6	0	0	223	0	229
27057	1	2	0	230	0	233
27058	225	0	1	4	0	230
27059	5	225	0	1	0	231
27060	230	5	0	2	0	237
27061	233	1	1	1	0	236
27062	235	0	0	1	0	236
27063	6	1	0	227	0	234
27064	1	1	0	235	0	237
27065	0	0	223	5	0	228
27066	1	1	218	1	0	221
27067	0	0	225	2	0	227
27068	217	0	7	1	0	225
27069	6	0	224	2	0	232
27070	2	230	4	0	0	236
27071	2	5	3	225	0	235
27072	4	3	0	219	0	226
27073	2	227	3	5	0	237
27074	1	6	236	3	0	246
27075	1	242	4	3	0	250
27076	240	5	3	2	0	250
27077	5	5	239	0	0	249
27078	4	243	5	1	0	253
27079	3	4	247	1	0	255
27080	1	3	6	240	0	250
27081	2	2	244	5	0	253
27082	3	0	4	236	0	243
27083	244	0	4	5	0	253
27084	6	1	241	2	0	250
27085	4	240	5	0	0	249
27086	241	5	1	1	0	248
27087	6	3	251	1	0	261
27088	2	2	243	1	0	248
27089	3	0	13	228	0	244
27090	1	1	240	5	0	247
27091	226	2	4	5	0	237
27092	5	239	6	0	0	250
27093	3	7	0	242	0	252
27094	2	259	0	6	0	267
27095	261	4	4	3	0	272
27096	4	6	254	1	0	265
27097	4	0	266	2	0	272
27098	0	0	9	264	0	273
27099	0	3	4	266	0	273
27100	3	1	0	289	0	293
27101	3	1	0	288	0	292
27102	1	2	300	8	0	311
27103	3	298	5	2	0	308
27104	3	5	2	269	0	279
27105	0	4	266	4	0	274
27106	3	258	6	2	0	269
27107	261	3	3	2	0	269
27108	4	2	2	265	0	273
27109	268	0	0	6	0	274
27110	4	267	0	3	0	274
27111	262	4	0	2	0	268
27112	5	3	277	0	0	285
27113	5	2	4	260	0	271
27114	1	277	3	3	0	284
27115	0	3	275	4	0	282
27116	0	279	4	3	0	286
27117	4	6	4	210	0	224
27118	261	2	1	4	0	268
27119	5	264	1	2	0	272
27120	266	3	0	1	0	270
27121	3	2	261	0	0	266
27122	2	3	259	1	0	265
27123	263	1	4	0	0	268
27124	4	1	1	257	0	263
27125	1	1	0	262	0	264
27126	1	0	266	3	0	270
27127	1	2	256	0	0	259
27128	1	263	3	0	0	267
27129	269	2	1	2	0	274
27130	248	1	0	1	0	250
27131	2	246	2	0	0	250
27132	1	2	1	260	0	264
27133	262	0	2	2	0	266
27134	3	0	1	258	0	262
27135	260	1	0	3	0	264
27136	258	0	1	1	0	260
27137	270	1	0	2	0	273
27138	6	1	0	267	0	274
27139	0	0	2	277	0	279
27140	250	1	1	5	0	257
27141	254	0	0	3	0	257
27142	251	0	2	2	0	255
27143	5	249	0	0	0	254
27144	239	5	1	1	0	246
27145	4	241	0	1	0	246
27146	238	5	1	0	0	244
27147	5	0	235	2	0	242
27148	215	0	10	1	0	226
27149	2	212	0	0	0	214
27150	0	214	0	0	0	214
27151	222	3	0	0	0	225
27152	3	0	0	220	0	223
27153	0	0	0	217	0	217
27154	0	220	0	3	0	223
27155	0	248	0	0	0	248
27156	245	5	0	0	0	250
27157	5	2	247	0	0	254
27158	2	0	4	268	0	274
27159	278	0	0	8	0	286
27160	9	0	274	0	0	283
27161	0	300	8	0	0	308
27162	303	8	0	2	0	313
27163	8	0	316	1	0	325
27164	1	0	9	332	0	342
27165	0	0	334	9	0	343
27166	325	1	9	2	0	337
27167	10	338	2	0	0	350
27168	347	8	0	0	0	355
27169	343	2	0	4	0	349
27170	11	0	0	334	0	345
27171	345	0	0	10	0	355
27172	8	0	0	346	0	354
27173	4	0	0	347	0	351
27174	0	0	330	12	0	342
27175	1	328	8	1	0	338
27176	2	8	2	334	0	346
27177	1	2	0	340	0	343
27178	2	1	0	345	0	348
27179	2	0	332	11	0	345
27180	0	332	10	2	0	344
27181	1	8	2	340	0	351
27182	5	1	1	343	0	350
27183	1	0	341	11	0	353
27184	0	1	9	334	0	344
27185	337	2	3	13	0	355
27186	11	343	1	2	0	357
27187	330	9	0	1	0	340
27188	9	3	328	1	0	341
27189	3	1	7	327	0	338
27190	329	1	2	11	0	343
27191	334	1	0	2	0	337
27192	12	0	338	1	0	351
27193	2	0	8	322	0	332
27194	1	0	329	10	0	340
27195	307	1	9	3	0	320
27196	8	333	3	1	0	345
27197	344	8	0	1	0	353
27198	343	1	1	1	0	346
27199	9	351	2	0	0	362
27200	342	9	1	5	0	357
27201	10	3	356	1	0	370
27202	343	2	7	2	0	354
27203	11	1	4	349	0	365
27204	6	0	372	10	0	388
27205	3	1	9	372	0	385
27206	4	1	2	373	0	380
27207	3	2	2	387	0	394
27208	1	377	3	8	0	389
27209	375	9	3	7	0	394
27210	12	2	3	376	0	393
27211	3	370	2	10	0	385
27212	4	7	2	369	0	382
27213	0	367	2	10	0	379
27214	2	12	366	3	0	383
27215	4	4	9	361	0	378
27216	5	1	3	375	0	384
27217	3	0	365	14	0	382
27218	343	0	9	5	0	357
27219	8	366	3	2	0	379
27220	7	10	1	367	0	385
27221	2	3	2	358	0	365
27222	4	2	1	363	0	370
27223	1	352	2	8	0	363
27224	345	8	2	8	0	363
27225	9	3	357	5	0	374
27226	5	0	355	3	0	363
27227	3	1	14	339	0	357
27228	0	3	3	363	0	369
27229	353	0	1	14	0	368
27230	9	344	4	6	0	363
27231	7	11	1	348	0	367
27232	345	4	2	12	0	363
27233	12	2	1	343	0	358
27234	346	1	2	11	0	360
27235	11	1	335	4	0	351
27236	5	340	12	3	0	360
27237	340	7	4	4	0	355
27238	12	2	335	0	0	349
27239	333	2	7	3	0	345
27240	8	0	332	3	0	343
27241	343	0	8	4	0	355
27242	10	1	2	340	0	353
27243	345	3	0	10	0	358
27244	13	2	0	342	0	357
27245	5	2	3	343	0	353
27246	341	1	1	13	0	356
27247	8	334	1	4	0	347
27248	6	6	1	348	0	361
27249	364	4	2	11	0	381
27250	378	2	2	5	0	387
27251	12	0	1	375	0	388
27252	4	2	1	383	0	390
27253	382	0	2	13	0	397
27254	10	1	1	384	0	396
27255	2	1	0	371	0	374
27256	364	1	0	9	0	374
27257	9	0	1	360	0	370
27258	3	1	315	5	0	324
27259	303	0	3	2	0	308
27260	3	0	319	1	0	323
27261	2	0	268	1	0	271
27262	261	0	6	0	0	267
27263	2	266	2	0	0	270
27264	2	2	0	255	0	259
27265	0	0	1	252	0	253
27266	1	0	0	260	0	261
27267	0	0	0	261	0	261
27268	264	0	1	4	0	269
27269	276	0	0	1	0	277
27270	295	1	0	1	0	297
27271	3	2	321	0	0	326
27272	1	1	3	332	0	337
27273	0	0	1	340	0	341
27274	1	0	0	338	0	339
27275	1	334	0	10	0	345
27276	0	336	0	3	0	339
27277	347	7	0	4	0	358
27278	11	2	0	353	0	366
27279	1	1	1	374	0	377
27280	1	2	0	376	0	379
27281	1	3	357	10	0	371
27282	2	0	342	3	0	347
27283	352	2	7	2	0	363
27284	369	1	2	2	0	374
27285	8	0	1	366	0	375
27286	3	361	3	5	0	372
27287	4	5	2	366	0	377
27288	2	2	0	373	0	377
27289	2	1	361	7	0	371
27290	359	0	7	10	0	376
27291	12	2	2	378	0	394
27292	5	1	2	374	0	382
27293	373	2	1	9	0	385
27294	9	376	2	4	0	391
27295	393	7	0	6	0	406
27296	8	2	2	377	0	389
27297	3	366	1	16	0	386
27298	380	8	0	6	0	394
27299	10	3	2	375	0	390
27300	363	3	1	9	0	376
27301	340	4	0	7	0	351
27302	350	5	0	5	0	360
27303	17	339	1	4	0	361
27304	2	325	0	9	0	336
27305	7	10	1	317	0	335
27306	7	321	3	10	0	341
27307	335	10	4	5	0	354
27308	13	4	3	334	0	354
27309	337	3	0	11	0	351
27310	339	1	1	7	0	348
27311	12	7	2	334	0	355
27312	9	5	0	357	0	371
27313	345	3	0	17	0	365
27314	342	3	1	8	0	354
27315	362	1	1	6	0	370
27316	375	4	0	7	0	386
27317	379	1	0	9	0	389
27318	19	0	1	368	0	388
27319	9	3	0	376	0	388
27320	10	2	0	378	0	390
27321	369	1	1	19	0	390
27322	14	4	1	374	0	393
27323	9	363	1	16	0	389
27324	14	10	0	374	0	398
27325	367	4	0	15	0	386
27326	373	5	0	10	0	388
27327	16	1	366	11	0	394
27328	9	3	8	356	0	376
27329	7	368	4	16	0	395
27330	372	9	4	10	0	395
27331	15	383	3	5	0	406
27332	8	10	2	386	0	406
27333	388	3	1	9	0	401
27334	387	6	1	7	0	401
27335	15	391	2	7	0	415
27336	9	9	1	389	0	408
27337	7	4	377	15	0	403
27338	377	4	7	11	0	399
27339	16	3	382	5	0	406
27340	387	2	9	10	0	408
27341	393	3	2	7	0	405
27342	14	1	4	394	0	413
27343	408	3	0	14	0	425
27344	411	6	3	10	0	430
27345	417	4	3	8	0	432
27346	16	1	0	418	0	435
27347	413	4	3	12	0	432
27348	23	1	1	403	0	428
27349	7	3	4	401	0	415
27350	12	409	3	14	0	438
27351	15	9	1	400	0	425
27352	10	399	2	9	0	420
27353	402	12	2	10	0	426
27354	402	4	0	13	0	419
27355	15	6	1	395	0	417
27356	11	2	1	403	0	417
27357	399	7	3	10	0	419
27358	15	2	387	10	0	414
27359	399	0	7	10	0	416
27360	15	4	1	402	0	422
27361	7	5	389	11	0	412
27362	392	4	7	8	0	411
27363	400	0	5	8	0	413
27364	13	3	401	7	0	424
27365	414	2	9	6	0	431
27366	18	0	396	5	0	419
27367	12	398	9	7	0	426
27368	418	7	4	8	0	437
27369	411	2	4	7	0	424
27370	13	399	0	4	0	416
27371	7	371	2	3	0	383
27372	361	5	2	4	0	372
27373	361	1	0	3	0	365
27374	6	1	1	374	0	382
27375	3	1	348	3	0	355
27376	3	2	335	2	0	342
27377	345	0	3	2	0	350
27378	3	3	348	1	0	355
27379	333	1	3	2	0	339
27380	6	0	2	337	0	345
27381	5	0	1	338	0	344
27382	2	2	345	4	0	353
27383	339	0	4	2	0	345
27384	4	0	3	355	0	362
27385	4	0	1	371	0	376
27386	365	0	2	5	0	372
27387	364	0	0	3	0	367
27388	356	0	0	5	0	361
27389	5	363	2	2	0	372
27390	5	1	357	0	0	363
27391	356	6	1	0	0	363
27392	364	1	1	3	0	369
27393	2	361	0	2	0	365
27394	361	1	0	1	0	363
27395	2	1	0	343	0	346
27396	1	2	353	1	0	357
27397	337	1	6	3	0	347
27398	352	0	1	4	0	357
27399	352	1	1	1	0	355
27400	350	0	0	0	0	350
27401	4	0	0	348	0	352
27402	2	0	1	348	0	351
27403	347	0	0	4	0	351
27404	2	0	0	349	0	351
27405	1	0	1	344	0	346
27406	3	333	1	2	0	339
27407	0	1	0	345	0	346
27408	0	2	1	339	0	342
27409	1	1	0	338	0	340
27410	1	0	0	344	0	345
27411	1	334	2	1	0	338
27412	1	0	0	333	0	334
27413	0	1	1	322	0	324
27414	0	1	326	1	0	328
27415	0	0	305	2	0	307
27416	0	307	2	1	0	310
27417	358	0	2	2	0	362
27418	3	360	0	6	0	369
27419	2	2	0	387	0	391
27420	0	1	409	3	0	413
27421	435	0	4	4	0	443
27422	5	0	1	445	0	451
27423	445	0	0	9	0	454
27424	453	0	0	4	0	457
27425	4	450	0	2	0	456
27426	454	4	0	3	0	461
27427	5	461	0	0	0	466
27428	4	4	0	460	0	468
27429	0	461	0	3	0	464
27430	1	4	450	2	0	457
27431	0	465	4	0	0	469
27432	2	4	1	451	0	458
27433	469	3	0	5	0	477
27434	2	463	2	8	0	475
27435	2	4	0	470	0	476
27436	4	0	1	476	0	481
27437	1	1	483	6	0	491
27438	5	1	5	480	0	491
27439	1	0	485	6	0	492
27440	448	2	5	8	0	463
27441	5	1	498	1	0	505
27442	7	488	5	1	0	501
27443	4	6	6	470	0	486
27444	3	5	0	474	0	482
27445	2	1	3	482	0	488
27446	483	1	1	12	0	497
27447	7	6	0	478	0	491
27448	5	480	1	12	0	498
27449	467	6	1	7	0	481
27450	9	466	1	1	0	477
27451	6	7	0	464	0	477
27452	467	6	2	7	0	482
27453	8	459	0	5	0	472
27454	4	478	3	2	0	487
27455	475	9	1	2	0	487
27456	474	4	0	6	0	484
27457	12	3	471	3	0	489
27458	471	2	6	1	0	480
27459	9	5	477	1	0	492
27460	9	2	8	481	0	500
27461	3	3	484	10	0	500
27462	8	1	9	481	0	499
27463	2	8	487	9	0	506
27464	2	1	11	476	0	490
27465	4	3	4	466	0	477
27466	454	2	5	19	0	480
27467	9	5	452	9	0	475
27468	427	3	10	8	0	448
27469	13	2	439	6	0	460
27470	7	1	437	5	0	450
27471	6	14	15	423	0	458
27472	421	1	6	14	0	442
27473	9	429	4	10	0	452
27474	430	8	3	10	0	451
27475	429	6	4	6	0	445
27476	11	424	4	4	0	443
27477	423	10	4	9	0	446
27478	12	9	438	2	0	461
27479	10	6	8	437	0	461
27480	440	4	6	13	0	463
27481	13	439	2	12	0	466
27482	6	12	5	436	0	459
27483	8	7	1	446	0	462
27484	9	3	4	447	0	463
27485	10	3	0	449	0	462
27486	438	4	6	14	0	462
27487	441	6	1	16	0	464
27488	446	2	7	6	0	461
27489	439	3	0	9	0	451
27490	17	2	433	4	0	456
27491	442	3	9	3	0	457
27492	445	3	9	6	0	463
27493	17	432	4	4	0	457
27494	9	441	4	6	0	460
27495	8	12	7	441	0	468
27496	5	5	4	451	0	465
27497	8	3	429	13	0	453
27498	2	429	11	12	0	454
27499	3	10	8	427	0	448
27500	9	433	2	14	0	458
27501	5	10	6	454	0	475
27502	10	8	2	446	0	466
27503	7	450	8	15	0	480
27504	10	10	4	464	0	488
27505	6	7	469	13	0	495
27506	6	5	468	7	0	486
27507	469	4	21	6	0	500
27508	482	1	10	11	0	504
27509	21	471	4	8	0	504
27510	481	15	4	6	0	506
27511	20	8	1	475	0	504
27512	475	4	5	13	0	497
27513	19	469	2	14	0	504
27514	16	11	472	5	0	504
27515	458	7	16	10	0	491
27516	19	2	488	7	0	516
27517	10	5	420	5	0	440
27518	6	2	422	7	0	437
27519	4	402	16	4	0	426
27520	374	10	22	4	0	410
27521	354	6	8	6	0	374
27522	15	3	3	350	0	371
27523	10	2	2	349	0	363
27524	7	346	1	14	0	368
27525	357	7	0	9	0	373
27526	9	357	2	3	0	371
27527	9	343	0	3	0	355
27528	340	10	5	5	0	360
27529	8	6	1	340	0	355
27530	9	4	1	336	0	350
27531	4	0	2	350	0	356
27532	5	328	0	14	0	347
27533	326	9	2	5	0	342
27534	10	6	2	321	0	339
27535	7	302	2	7	0	318
27536	0	305	1	3	0	309
27537	4	7	0	290	0	301
27538	3	298	0	7	0	308
27539	0	8	0	298	0	306
27540	290	2	0	12	0	304
27541	6	0	275	4	0	285
27542	3	288	7	2	0	300
27543	1	6	3	291	0	301
27544	2	3	304	5	0	314
27545	277	2	14	4	0	297
27546	7	1	6	290	0	304
27547	291	0	1	13	0	305
27548	297	0	0	4	0	301
27549	7	316	0	0	0	323
27550	320	5	1	1	0	327
27551	317	2	1	1	0	321
27552	317	0	2	0	0	319
27553	8	0	1	300	0	309
27554	3	1	0	307	0	311
27555	1	2	0	311	0	314
27556	2	1	300	7	0	310
27557	1	300	5	3	0	309
27558	293	5	2	2	0	302
27559	5	290	0	2	0	297
27560	4	5	0	288	0	297
27561	1	2	289	6	0	298
27562	266	2	5	2	0	275
27563	7	291	2	0	0	300
27564	1	4	0	289	0	294
27565	0	2	0	291	0	293
27566	0	1	287	5	0	293
27567	0	281	2	2	0	285
27568	1	3	1	284	0	289
27569	1	1	0	290	0	292
27570	1	0	0	288	0	289
27571	283	0	1	5	0	289
27572	5	1	277	1	0	284
27573	1	273	4	1	0	279
27574	272	4	2	1	0	279
27575	5	285	0	0	0	290
27576	1	4	0	280	0	285
27577	2	284	0	1	0	287
27578	265	4	0	1	0	270
27579	266	2	1	0	0	269
27580	7	0	0	270	0	277
27581	2	0	0	270	0	272
27582	3	0	0	275	0	278
27583	0	0	279	6	0	285
27584	0	280	4	2	0	286
27585	0	3	2	340	0	345
27586	1	0	1	354	0	356
27587	1	0	0	353	0	354
27588	2	0	0	356	0	358
27589	0	1	341	12	0	354
27590	2	356	10	3	0	371
27591	0	9	2	376	0	387
27592	2	2	0	415	0	419
27593	1	2	410	12	0	425
27594	2	1	11	392	0	406
27595	1	392	2	13	0	408
27596	0	409	2	5	0	416
27597	2	12	1	404	0	419
27598	0	2	394	14	0	410
27599	365	2	13	9	0	389
27600	8	403	2	5	0	418
27601	2	13	384	2	0	401
27602	1	4	386	4	0	395
27603	1	387	14	1	0	403
27604	2	12	410	2	0	426
27605	8	6	16	382	0	412
27606	373	4	6	8	0	391
27607	377	1	4	5	0	387
27608	373	4	4	2	0	383
27609	380	3	3	4	0	390
27610	11	383	3	4	0	401
27611	383	9	2	4	0	398
27612	15	380	3	0	0	398
27613	5	12	378	1	0	396
27614	6	2	10	359	0	377
27615	4	381	3	9	0	397
27616	5	13	1	375	0	394
27617	369	3	2	12	0	386
27618	11	4	3	362	0	380
27619	6	374	2	11	0	393
27620	371	12	1	7	0	391
27621	12	4	372	4	0	392
27622	7	4	9	373	0	393
27623	5	4	3	383	0	395
27624	365	2	1	15	0	383
27625	11	374	3	5	0	393
27626	5	8	365	5	0	383
27627	4	5	11	362	0	382
27628	3	3	363	14	0	383
27629	2	350	9	8	0	369
27630	4	375	5	4	0	388
27631	365	9	6	6	0	386
27632	8	6	367	7	0	388
27633	377	4	11	4	0	396
27634	11	3	7	359	0	380
27635	6	385	2	10	0	403
27636	375	11	5	4	0	395
27637	15	5	386	4	0	410
27638	9	6	11	381	0	407
27639	8	4	6	387	0	405
27640	2	4	4	371	0	381
27641	6	377	3	11	0	397
27642	362	12	6	9	0	389
27643	11	368	2	10	0	391
27644	5	374	5	5	0	389
27645	7	12	3	366	0	388
27646	377	8	1	14	0	400
27647	366	5	3	7	0	381
27648	367	6	3	7	0	383
27649	14	343	3	6	0	366
27650	7	12	3	349	0	371
27651	7	10	351	11	0	379
27652	11	6	8	346	0	371
27653	7	3	8	341	0	359
27654	3	364	2	14	0	383
27655	360	11	6	7	0	384
27656	10	6	3	360	0	379
27657	7	373	3	13	0	396
27658	366	11	2	10	0	389
27659	13	5	365	5	0	388
27660	367	4	9	6	0	386
27661	13	375	3	6	0	397
27662	377	12	1	5	0	395
27663	375	7	4	5	0	391
27664	13	3	383	6	0	405
27665	365	6	10	9	0	390
27666	15	5	421	5	0	446
27667	4	9	411	7	0	431
27668	413	2	12	5	0	432
27669	422	3	6	6	0	437
27670	13	10	420	1	0	444
27671	14	2	11	405	0	432
27672	5	3	8	409	0	425
27673	11	441	3	8	0	463
27674	430	8	6	7	0	451
27675	448	4	5	3	0	460
27676	11	6	430	7	0	454
27677	431	4	12	12	0	459
27678	448	3	2	8	0	461
27679	14	448	5	5	0	472
27680	9	10	1	442	0	462
27681	7	10	3	436	0	456
27682	16	4	2	426	0	448
27683	425	5	7	10	0	447
27684	13	417	1	5	0	436
27685	3	4	1	360	0	368
27686	5	346	1	5	0	357
27687	9	11	1	337	0	358
27688	4	345	0	5	0	354
27689	3	346	2	5	0	356
27690	309	4	1	11	0	325
27691	302	0	2	2	0	306
27692	0	0	1	273	0	274
27693	1	4	1	274	0	280
27694	1	0	1	281	0	283
27695	2	0	0	279	0	281
27696	1	0	1	277	0	279
27697	0	277	0	0	0	277
27698	0	0	0	285	0	285
27699	0	1	0	274	0	275
27700	267	0	0	0	0	267
27701	1	0	0	268	0	269
27702	0	0	1	260	0	261
27703	1	0	264	0	0	265
27704	1	0	0	243	0	244
27705	0	1	0	264	0	265
27706	0	0	274	1	0	275
27707	0	272	1	1	0	274
27708	0	0	273	1	0	274
27709	0	0	265	0	0	265
27710	0	254	0	7	0	261
27711	283	0	0	3	0	286
27712	285	0	0	1	0	286
27713	0	0	0	281	0	281
27714	292	0	0	1	0	293
27715	1	0	306	0	0	307
27716	0	0	1	304	0	305
27717	1	0	351	1	0	353
27718	0	0	2	355	0	357
27719	1	0	0	349	0	350
27720	1	0	1	356	0	358
27721	357	0	0	3	0	360
27722	1	0	0	355	0	356
27723	352	0	0	5	0	357
27724	352	0	0	1	0	353
27725	1	354	0	1	0	356
27726	355	1	0	0	0	356
27727	2	367	0	0	0	369
27728	0	2	0	376	0	378
27729	1	0	0	378	0	379
27730	0	1	0	382	0	383
27731	0	0	374	4	0	378
27732	0	369	3	0	0	372
27733	0	3	0	362	0	365
27734	2	1	1	356	0	360
27735	1	362	0	4	0	367
27736	363	3	0	3	0	369
27737	3	356	0	0	0	359
27738	359	3	0	2	0	364
27739	5	359	0	0	0	364
27740	0	4	0	355	0	359
27741	1	360	0	4	0	365
27742	366	4	1	2	0	373
27743	367	0	0	3	0	370
27744	370	1	1	2	0	374
27745	363	0	0	2	0	365
27746	5	0	366	0	0	371
27747	366	0	3	3	0	372
27748	381	0	0	4	0	385
27749	371	0	1	2	0	374
27750	5	1	371	0	0	377
27751	370	1	4	2	0	377
27752	5	378	1	0	0	384
27753	379	4	1	5	0	389
27754	4	0	388	3	0	395
27755	375	1	3	4	0	383
27756	396	0	1	3	0	400
27757	4	1	2	384	0	391
27758	1	2	381	4	0	388
27759	378	0	2	3	0	383
27760	3	2	0	394	0	399
27761	2	1	1	407	0	411
27762	2	2	403	3	0	410
27763	378	1	3	2	0	384
27764	405	1	0	6	0	412
27765	3	404	1	2	0	410
27766	1	4	1	382	0	388
27767	4	2	0	376	0	382
27768	2	1	0	374	0	377
27769	2	376	0	5	0	383
27770	381	4	0	2	0	387
27771	6	0	1	375	0	382
27772	1	2	1	374	0	378
27773	367	0	0	5	0	372
27774	357	1	0	4	0	362
27775	4	0	0	367	0	371
27776	2	1	0	362	0	365
27777	4	3	353	3	0	363
27778	313	1	4	6	0	324
27779	4	337	2	1	0	344
27780	3	3	2	348	0	356
27781	4	0	1	361	0	366
27782	1	387	1	6	0	395
27783	2	4	1	400	0	407
27784	433	3	1	7	0	444
27785	9	1	1	513	0	524
27786	6	0	0	529	0	535
27787	2	2	1	552	0	557
27788	2	0	527	23	0	552
27789	3	1	14	526	0	544
27790	2	1	525	19	0	547
27791	1	512	15	10	0	538
27792	1	13	8	526	0	548
27793	0	6	4	539	0	549
27794	2	3	2	547	0	554
27795	3	3	1	545	0	552
27796	6	1	1	558	0	566
27797	519	1	2	30	0	552
27798	15	1	537	13	0	566
27799	9	514	14	7	0	544
27800	3	555	10	5	0	573
27801	2	19	2	543	0	566
27802	1	11	3	555	0	570
27803	4	3	2	551	0	560
27804	2	542	0	23	0	567
27805	3	16	1	536	0	556
27806	0	10	524	23	0	557
27807	2	515	15	14	0	546
27808	2	18	9	538	0	567
27809	533	7	2	21	0	563
27810	19	3	2	544	0	568
27811	10	4	2	531	0	547
27812	2	497	2	29	0	530
27813	3	550	1	16	0	570
27814	3	22	3	531	0	559
27815	7	8	1	539	0	555
27816	1	6	533	26	0	566
27817	4	9	14	491	0	518
27818	2	1	8	530	0	541
27819	2	1	4	523	0	530
27820	1	2	3	538	0	544
27821	502	1	2	31	0	536
27822	510	2	3	19	0	534
27823	23	2	1	517	0	543
27824	9	3	3	546	0	561
27825	524	2	2	31	0	559
27826	17	2	2	557	0	578
27827	9	2	547	25	0	583
27828	3	542	15	19	0	579
27829	4	15	9	555	0	583
27830	3	9	3	573	0	588
27831	572	4	4	31	0	611
27832	14	2	3	591	0	610
27833	9	4	3	601	0	617
27834	587	3	1	32	0	623
27835	17	3	2	601	0	623
27836	9	602	3	25	0	639
27837	3	17	2	634	0	656
27838	5	14	1	646	0	666
27839	6	4	1	656	0	667
27840	6	3	3	658	0	670
27841	3	6	622	35	0	666
27842	2	5	609	19	0	635
27843	3	3	25	622	0	653
27844	1	2	11	630	0	644
27845	2	614	5	35	0	656
27846	3	16	3	616	0	638
27847	2	610	5	23	0	640
27848	593	19	1	28	0	641
27849	17	644	3	14	0	678
27850	10	21	2	677	0	710
27851	6	11	3	692	0	712
27852	4	3	661	35	0	703
27853	632	3	17	20	0	672
27854	653	3	10	15	0	681
27855	22	664	2	16	0	704
27856	12	19	2	652	0	685
27857	6	10	702	22	0	740
27858	6	706	17	18	0	747
27859	700	21	9	14	0	744
27860	701	12	2	16	0	731
27861	23	3	666	16	0	708
27862	677	6	18	9	0	710
27863	23	3	9	693	0	728
27864	13	684	4	26	0	727
27865	685	21	4	12	0	722
27866	21	12	2	691	0	726
27867	692	4	2	33	0	731
27868	733	5	4	19	0	761
27869	29	7	1	714	0	751
27870	12	1	717	31	0	761
27871	713	5	18	18	0	754
27872	728	2	11	13	0	754
27873	729	3	3	14	0	749
27874	23	731	5	8	0	767
27875	15	18	3	728	0	764
27876	9	10	3	753	0	775
27877	8	3	724	27	0	762
27878	5	4	16	724	0	749
27879	2	721	11	22	0	756
27880	706	15	3	23	0	747
27881	14	714	5	8	0	741
27882	8	16	695	9	0	728
27883	3	678	17	6	0	704
27884	4	671	5	2	0	682
27885	8	7	3	559	0	577
27886	549	1	6	9	0	565
27887	531	0	0	5	0	536
27888	517	0	0	3	0	520
27889	6	526	0	0	0	532
27890	1	4	524	0	0	529
27891	508	1	5	8	0	522
27892	525	0	0	4	0	529
27893	6	516	0	1	0	523
27894	520	5	0	6	0	531
27895	6	2	0	525	0	533
27896	1	0	566	6	0	573
27897	568	0	8	4	0	580
27898	585	0	2	4	0	591
27899	612	0	0	7	0	619
27900	10	2	0	608	0	620
27901	1	1	0	624	0	626
27902	2	2	0	648	0	652
27903	1	668	0	11	0	680
27904	5	10	1	689	0	705
27905	1	4	0	763	0	768
27906	0	1	753	16	0	770
27907	2	0	8	754	0	764
27908	4	1	2	762	0	769
27909	3	0	0	761	0	764
27910	2	2	1	744	0	749
27911	1	740	3	15	0	759
27912	3	11	0	746	0	760
27913	2	4	2	742	0	750
27914	711	1	1	20	0	733
27915	14	0	714	8	0	736
27916	6	2	693	4	0	705
27917	651	2	14	8	0	675
27918	693	2	6	7	0	708
27919	22	3	0	640	0	665
27920	8	684	1	10	0	703
27921	694	12	1	11	0	718
27922	16	5	2	672	0	695
27923	6	683	5	13	0	707
27924	686	11	2	13	0	712
27925	14	698	2	1	0	715
27926	677	11	1	8	0	697
27927	673	8	1	5	0	687
27928	18	663	2	5	0	688
27929	7	12	0	674	0	693
27930	0	8	667	13	0	688
27931	5	2	9	650	0	666
27932	639	5	4	18	0	666
27933	13	2	640	7	0	662
27934	7	635	12	5	0	659
27935	12	14	6	620	0	652
27936	1	6	614	14	0	635
27937	2	611	11	8	0	632
27938	594	9	4	9	0	616
27939	15	3	1	602	0	621
27940	7	2	3	604	0	616
27941	4	5	3	600	0	612
27942	6	597	0	18	0	621
27943	597	7	5	8	0	617
27944	10	592	5	2	0	609
27945	11	606	2	2	0	621
27946	602	12	1	10	0	625
27947	601	6	1	6	0	614
27948	15	1	584	7	0	607
27949	577	6	8	4	0	595
27950	573	4	3	3	0	583
27951	18	1	1	565	0	585
27952	6	6	559	11	0	582
27953	9	3	8	561	0	581
27954	579	3	6	15	0	603
27955	12	4	580	9	0	605
27956	10	2	11	594	0	617
27957	10	1	9	654	0	674
27958	3	3	2	733	0	741
27959	705	1	5	31	0	742
27960	19	709	6	10	0	744
27961	714	21	2	10	0	747
27962	23	5	710	7	0	745
27963	5	4	21	706	0	736
27964	3	719	8	25	0	755
27965	730	20	3	15	0	768
27966	26	9	3	725	0	763
27967	13	4	709	25	0	751
27968	7	5	20	698	0	730
27969	673	5	7	29	0	714
27970	22	689	3	13	0	727
27971	15	28	2	632	0	677
27972	4	688	2	23	0	717
27973	686	23	3	15	0	727
27974	684	6	4	7	0	701
27975	28	673	6	3	0	710
27976	667	20	5	10	0	702
27977	27	9	2	648	0	686
27978	8	661	1	25	0	695
27979	660	21	3	17	0	701
27980	674	10	3	3	0	690
27981	28	628	6	11	0	673
27982	9	655	5	10	0	679
27983	652	28	1	7	0	688
27984	26	4	4	659	0	693
27985	657	7	5	24	0	693
27986	26	7	2	655	0	690
27987	15	4	650	20	0	689
27988	9	8	18	649	0	684
27989	653	8	4	28	0	693
27990	27	6	642	7	0	682
27991	14	2	21	647	0	684
27992	8	3	5	672	0	688
27993	7	5	655	26	0	693
27994	638	6	21	10	0	675
27995	28	1	7	661	0	697
27996	9	4	609	25	0	647
27997	567	3	21	15	0	606
27998	26	591	8	7	0	632
27999	9	575	6	8	0	598
28000	6	592	2	11	0	611
28001	7	19	559	6	0	591
28002	11	11	19	535	0	576
28003	12	1	529	17	0	559
28004	2	16	15	440	0	473
28005	3	441	4	16	0	464
28006	3	450	3	6	0	462
28007	8	14	2	443	0	467
28008	450	5	4	18	0	477
28009	17	1	3	466	0	487
28010	8	2	1	467	0	478
28011	3	454	4	14	0	475
28012	447	14	1	6	0	468
28013	14	459	3	5	0	481
28014	2	17	1	471	0	491
28015	8	3	1	472	0	484
28016	3	468	3	15	0	489
28017	7	16	0	473	0	496
28018	468	4	1	20	0	493
28019	14	7	1	466	0	488
28020	6	4	2	483	0	495
28021	7	458	1	18	0	484
28022	5	18	2	470	0	495
28023	449	4	1	19	0	473
28024	466	7	1	8	0	482
28025	471	3	3	8	0	485
28026	19	6	1	465	0	491
28027	10	1	450	19	0	480
28028	3	4	450	10	0	467
28029	5	5	15	455	0	480
28030	453	4	1	24	0	482
28031	25	4	6	449	0	484
28032	452	3	1	23	0	479
28033	20	4	1	453	0	478
28034	6	4	4	473	0	487
28035	460	0	2	23	0	485
28036	20	4	452	5	0	481
28037	452	3	15	8	0	478
28038	27	2	450	4	0	483
28039	3	5	15	456	0	479
28040	456	4	3	18	0	481
28041	20	4	467	3	0	494
28042	3	3	475	7	0	488
28043	462	4	14	6	0	486
28044	16	3	474	6	0	499
28045	6	472	20	4	0	502
28046	5	16	3	477	0	501
28047	498	2	5	18	0	523
28048	18	1	510	7	0	536
28049	497	3	17	7	0	524
28050	521	0	3	8	0	532
28051	511	3	7	4	0	525
28052	513	1	4	8	0	526
28053	24	2	2	495	0	523
28054	3	484	8	13	0	508
28055	460	12	8	6	0	486
28056	16	1	436	3	0	456
28057	1	321	10	3	0	335
28058	282	6	6	1	0	295
28059	4	264	2	1	0	271
28060	1	313	1	1	0	316
28061	7	3	8	290	0	308
28062	3	1	1	295	0	300
28063	2	1	0	298	0	301
28064	315	0	0	4	0	319
28065	320	0	0	3	0	323
28066	3	0	0	347	0	350
28067	5	1	0	358	0	364
28068	2	1	376	5	0	384
28069	365	0	7	5	0	377
28070	371	1	0	3	0	375
28071	7	0	1	367	0	375
28072	2	1	2	371	0	376
28073	4	1	372	7	0	384
28074	8	0	7	362	0	377
28075	1	0	379	12	0	392
28076	0	395	8	4	0	407
28077	2	7	393	2	0	404
28078	4	0	9	383	0	396
28079	1	1	409	8	0	419
28080	0	3	400	2	0	405
28081	422	1	11	3	0	437
28082	11	0	2	455	0	468
28083	1	0	457	10	0	468
28084	423	0	13	6	0	442
28085	14	0	455	2	0	471
28086	3	0	492	3	0	498
28087	1	500	11	3	0	515
28088	4	8	4	497	0	513
28089	1	2	504	8	0	515
28090	2	1	497	2	0	502
28091	4	3	10	488	0	505
28092	1	1	3	512	0	517
28093	1	522	4	9	0	536
28094	4	8	4	524	0	540
28095	524	1	1	13	0	539
28096	522	1	3	5	0	531
28097	543	4	0	4	0	551
28098	11	1	3	530	0	545
28099	6	552	2	8	0	568
28100	563	8	2	4	0	577
28101	13	549	1	3	0	566
28102	3	538	1	5	0	547
28103	0	557	1	4	0	562
28104	560	10	2	0	0	572
28105	11	3	0	555	0	569
28106	1	1	4	562	0	568
28107	1	557	2	11	0	571
28108	547	10	4	5	0	566
28109	9	1	545	5	0	560
28110	2	1	10	542	0	555
28111	534	2	4	11	0	551
28112	11	550	2	2	0	565
28113	580	8	3	9	0	600
28114	7	2	3	604	0	616
28115	5	610	1	10	0	626
28116	4	11	604	1	0	620
28117	598	2	10	6	0	616
28118	11	2	2	616	0	631
28119	616	2	0	12	0	630
28120	11	2	6	613	0	632
28121	5	617	5	8	0	635
28122	2	10	621	5	0	638
28123	5	2	631	5	0	643
28124	2	5	8	628	0	643
28125	638	3	9	11	0	661
28126	634	2	1	6	0	643
28127	13	0	4	636	0	653
28128	4	3	1	652	0	660
28129	649	0	1	18	0	668
28130	11	4	2	643	0	660
28131	649	0	2	14	0	665
28132	9	646	3	5	0	663
28133	646	9	0	7	0	662
28134	9	4	670	5	0	688
28135	6	1	8	665	0	680
28136	4	4	4	674	0	686
28137	3	1	3	679	0	686
28138	6	655	6	6	0	673
28139	10	626	2	7	0	645
28140	4	9	4	678	0	695
28141	1	1	660	19	0	681
28142	5	3	12	643	0	663
28143	1	5	8	661	0	675
28144	3	518	4	146	0	671
28145	634	9	5	13	0	661
28146	8	644	5	4	0	661
28147	5	641	4	7	0	657
28148	7	9	4	639	0	659
28149	5	3	5	639	0	652
28150	8	4	2	636	0	650
28151	5	6	2	634	0	647
28152	634	3	2	15	0	654
28153	8	630	6	7	0	651
28154	637	8	4	9	0	658
28155	642	3	6	9	0	660
28156	16	4	0	647	0	667
28157	6	4	3	661	0	674
28158	651	1	3	19	0	674
28159	650	2	4	9	0	665
28160	13	2	2	608	0	625
28161	5	2	1	619	0	627
28162	4	5	614	15	0	638
28163	6	602	6	8	0	622
28164	6	619	3	3	0	631
28165	599	9	3	10	0	621
28166	10	3	589	3	0	605
28167	5	2	547	3	0	557
28168	516	2	13	4	0	535
28169	539	0	2	3	0	544
28170	4	570	0	0	0	574
28171	1	598	3	0	0	602
28172	0	5	0	605	0	610
28173	618	2	0	7	0	627
28174	616	0	0	8	0	624
28175	605	0	0	2	0	607
28176	6	0	0	589	0	595
28177	2	0	1	593	0	596
28178	1	1	597	5	0	604
28179	2	0	535	2	0	539
28180	1	0	568	0	0	569
28181	1	12	6	545	0	564
28182	531	0	1	5	0	537
28183	2	1	554	1	0	558
28184	3	0	2	541	0	546
28185	1	558	2	3	0	564
28186	0	2	0	540	0	542
28187	0	1	0	541	0	542
28188	0	0	589	5	0	594
28189	1	0	4	575	0	580
28190	626	0	2	12	0	640
28191	10	1	627	2	0	640
28192	8	0	10	616	0	634
28193	2	1	643	9	0	655
28194	0	641	11	4	0	656
28195	0	13	643	2	0	658
28196	3	4	14	610	0	631
28197	1	1	6	657	0	665
28198	2	1	677	17	0	697
28199	3	0	13	638	0	654
28200	2	1	4	633	0	640
28201	0	635	3	16	0	654
28202	1	13	643	7	0	664
28203	2	5	13	631	0	651
28204	3	1	6	651	0	661
28205	0	653	4	17	0	674
28206	0	14	2	659	0	675
28207	645	5	0	19	0	669
28208	13	2	2	657	0	674
28209	5	1	662	15	0	683
28210	635	0	11	11	0	657
28211	680	2	4	7	0	693
28212	18	2	690	2	0	712
28213	652	0	15	5	0	672
28214	18	654	7	4	0	683
28215	7	18	3	677	0	705
28216	7	6	5	766	0	784
28217	8	2	1	764	0	775
28218	5	1	1	780	0	787
28219	3	3	2	781	0	789
28220	755	2	1	28	0	786
28221	18	5	749	15	0	787
28222	725	2	19	11	0	757
28223	21	0	738	7	0	766
28224	14	3	20	734	0	771
28225	739	0	9	25	0	773
28226	24	5	3	724	0	756
28227	6	733	5	24	0	768
28228	762	16	2	12	0	792
28229	24	8	4	798	0	834
28230	10	4	740	22	0	776
28231	721	2	15	22	0	760
28232	21	786	5	7	0	819
28233	7	17	800	5	0	829
28234	13	6	18	781	0	818
28235	9	4	6	774	0	793
28236	3	782	6	25	0	816
28237	7	23	781	11	0	822
28238	7	6	20	774	0	807
28239	2	6	809	26	0	843
28240	8	2	21	808	0	839
28241	8	4	12	819	0	843
28242	1	5	816	26	0	848
28243	12	1	24	808	0	845
28244	3	2	13	732	0	750
28245	9	2	7	882	0	900
28246	11	3	4	883	0	901
28247	852	1	5	49	0	907
28248	23	5	838	16	0	882
28249	859	0	28	14	0	901
28250	35	1	10	906	0	952
28251	16	1	12	930	0	959
28252	12	3	9	920	0	944
28253	6	894	10	44	0	954
28254	906	26	7	22	0	961
28255	26	8	7	933	0	974
28256	10	917	9	42	0	978
28257	13	25	6	945	0	989
28258	956	6	7	46	0	1015
28259	976	9	6	20	0	1011
28260	957	5	9	14	0	985
28261	32	953	5	19	0	1009
28262	13	27	951	19	0	1010
28263	930	14	28	12	0	984
28264	973	9	7	19	0	1008
28265	34	965	8	14	0	1021
28266	968	27	7	21	0	1023
28267	963	9	7	14	0	993
28268	989	6	7	14	0	1016
28269	44	1003	9	11	0	1067
28270	23	22	9	1002	0	1056
28271	997	14	4	33	0	1048
28272	1030	6	8	22	0	1066
28273	1010	5	5	22	0	1042
28274	1040	8	6	10	0	1064
28275	50	7	3	998	0	1058
28276	20	5	992	36	0	1053
28277	20	5	26	998	0	1049
28278	19	1012	6	41	0	1078
28279	16	30	8	1046	0	1100
28280	19	9	1065	36	0	1129
28281	1052	7	27	21	0	1107
28282	40	7	12	1091	0	1150
28283	1090	5	8	39	0	1142
28284	1106	7	5	25	0	1143
28285	41	9	6	1096	0	1152
28286	25	4	1113	37	0	1179
28287	19	7	1053	22	0	1101
28288	1002	6	32	12	0	1052
28289	31	1033	11	13	0	1088
28290	12	997	5	15	0	1029
28291	9	1017	11	9	0	1046
28292	14	1049	6	8	0	1077
28293	1019	19	7	14	0	1059
28294	1022	10	8	6	0	1046
28295	1030	5	3	15	0	1053
28296	1026	6	2	12	0	1046
28297	30	9	4	986	0	1029
28298	12	982	3	24	0	1021
28299	997	19	1	7	0	1024
28300	24	6	994	6	0	1030
28301	15	981	19	11	0	1026
28302	14	18	976	6	0	1014
28303	954	6	20	11	0	991
28304	986	4	7	9	0	1006
28305	986	6	4	10	0	1006
28306	27	6	6	981	0	1020
28307	11	8	978	23	0	1020
28308	8	984	22	8	0	1022
28309	972	19	4	9	0	1004
28310	29	968	3	6	0	1006
28311	13	935	5	9	0	962
28312	16	935	3	4	0	958
28313	14	949	3	7	0	973
28314	11	17	900	5	0	933
28315	12	904	23	4	0	943
28316	833	16	3	8	0	860
28317	23	5	2	834	0	864
28318	9	0	7	839	0	855
28319	844	6	0	16	0	866
28320	16	834	5	6	0	861
28321	8	14	857	5	0	884
28322	11	4	13	831	0	859
28323	14	2	3	865	0	884
28324	9	6	2	863	0	880
28325	5	3	860	18	0	886
28326	4	6	852	3	0	865
28327	8	2	15	846	0	871
28328	6	6	862	16	0	890
28329	2	8	809	5	0	824
28330	707	4	18	9	0	738
28331	15	815	3	3	0	836
28332	7	796	4	2	0	809
28333	7	824	1	13	0	845
28334	7	13	2	811	0	833
28335	5	853	1	15	0	874
28336	856	16	3	7	0	882
28337	18	4	874	2	0	898
28338	869	6	17	2	0	894
28339	19	6	3	875	0	903
28340	9	3	4	871	0	887
28341	5	912	3	15	0	935
28342	899	20	3	7	0	929
28343	908	4	5	2	0	919
28344	27	943	3	1	0	974
28345	7	18	2	903	0	930
28346	2	4	919	19	0	944
28347	5	3	905	4	0	917
28348	4	923	23	1	0	951
28349	903	22	3	7	0	935
28350	17	3	912	3	0	935
28351	10	3	18	874	0	905
28352	915	2	5	19	0	941
28353	911	2	2	6	0	921
28354	19	1090	7	2	0	1118
28355	2	1168	3	3	0	1176
28356	1154	32	2	9	0	1197
28357	36	9	1158	2	0	1205
28358	1127	7	33	6	0	1173
28359	1154	7	4	4	0	1169
28360	41	13	4	1112	0	1170
28361	7	3	1150	33	0	1193
28362	6	3	1156	4	0	1169
28363	1104	4	40	8	0	1156
28364	38	2	1154	4	0	1198
28365	1093	0	38	7	0	1138
28366	1171	1	9	3	0	1184
28367	41	1155	4	5	0	1205
28368	11	35	1149	1	0	1196
28369	6	1133	33	3	0	1175
28370	1103	34	7	6	0	1150
28371	39	7	1097	2	0	1145
28372	14	5	34	1049	0	1102
28373	7	4	1096	32	0	1139
28374	5	4	1102	8	0	1119
28375	18	3	1089	2	0	1112
28376	5	5	1092	3	0	1105
28377	6	1029	41	4	0	1080
28378	5	29	1045	4	0	1083
28379	6	985	42	5	0	1038
28380	3	37	987	3	0	1030
28381	956	7	37	4	0	1004
28382	41	6	8	899	0	954
28383	8	996	8	28	0	1040
28384	969	34	6	8	0	1017
28385	975	8	7	9	0	999
28386	917	10	5	6	0	938
28387	968	7	8	9	0	992
28388	40	956	11	2	0	1009
28389	921	27	10	5	0	963
28390	976	9	7	14	0	1006
28391	37	939	9	8	0	993
28392	13	36	916	3	0	968
28393	14	8	38	860	0	920
28394	13	924	11	23	0	971
28395	13	36	936	7	0	992
28396	9	9	942	6	0	966
28397	10	893	43	5	0	951
28398	15	926	12	6	0	959
28399	12	977	8	5	0	1002
28400	15	955	10	0	0	980
28401	960	42	10	7	0	1019
28402	986	16	6	9	0	1017
28403	46	11	965	2	0	1024
28404	24	5	1007	2	0	1038
28405	20	14	45	958	0	1037
28406	22	11	17	981	0	1031
28407	22	10	17	1003	0	1052
28408	986	13	16	45	0	1060
28409	44	972	18	10	0	1044
28410	21	1025	15	10	0	1071
28411	14	1073	14	9	0	1110
28412	1022	50	16	8	0	1096
28413	1067	20	14	5	0	1106
28414	60	17	16	1018	0	1111
28415	1034	15	20	42	0	1111
28416	1051	15	13	9	0	1088
28417	69	10	12	1001	0	1092
28418	1037	12	18	42	0	1109
28419	50	1012	25	13	0	1100
28420	31	43	24	992	0	1090
28421	27	12	1003	45	0	1087
28422	21	992	59	12	0	1084
28423	23	48	1005	14	0	1090
28424	29	23	52	940	0	1044
28425	19	1014	29	32	0	1094
28426	25	49	29	999	0	1102
28427	31	23	23	1008	0	1085
28428	26	20	982	50	0	1078
28429	27	14	1060	12	0	1113
28430	19	20	62	1021	0	1122
28431	24	15	34	977	0	1050
28432	25	1028	29	41	0	1123
28433	979	49	22	25	0	1075
28434	54	1016	29	15	0	1114
28435	25	1048	21	9	0	1103
28436	19	56	986	16	0	1077
28437	11	972	49	13	0	1045
28438	15	46	33	896	0	990
28439	17	956	23	33	0	1029
28440	15	56	18	904	0	993
28441	10	937	15	39	0	1001
28442	914	45	14	14	0	987
28443	48	929	11	12	0	1000
28444	27	40	15	803	0	885
28445	16	852	11	29	0	908
28446	845	42	13	12	0	912
28447	852	24	8	9	0	893
28448	47	819	14	10	0	890
28449	811	43	6	6	0	866
28450	43	24	9	770	0	846
28451	15	19	760	33	0	827
28452	16	17	778	13	0	824
28453	13	781	38	7	0	839
28454	519	16	7	4	0	546
28455	504	6	6	8	0	524
28456	19	6	501	2	0	528
28457	7	3	499	3	0	512
28458	492	3	15	5	0	515
28459	512	4	6	1	0	523
28460	16	7	480	3	0	506
28461	452	1	10	7	0	470
28462	9	452	8	1	0	470
28463	7	472	5	2	0	486
28464	9	15	9	441	0	474
28465	5	10	0	456	0	471
28466	451	5	3	16	0	475
28467	450	2	2	7	0	461
28468	447	6	3	3	0	459
28469	16	3	4	436	0	459
28470	8	4	1	436	0	449
28471	6	409	2	16	0	433
28472	5	433	3	5	0	446
28473	4	456	2	4	0	466
28474	4	16	3	436	0	459
28475	3	459	0	13	0	475
28476	6	13	442	6	0	467
28477	415	8	13	3	0	439
28478	16	6	451	3	0	476
28479	7	5	443	1	0	456
28480	426	6	15	3	0	450
28481	12	452	5	8	0	477
28482	459	16	8	4	0	487
28483	463	7	3	3	0	476
28484	17	9	485	2	0	513
28485	8	6	501	1	0	516
28486	7	513	16	4	0	540
28487	4	15	521	3	0	543
28488	5	8	16	523	0	552
28489	11	2	5	447	0	465
28490	8	513	3	16	0	540
28491	6	550	6	6	0	568
28492	549	19	2	3	0	573
28493	565	10	3	3	0	581
28494	17	8	6	568	0	599
28495	6	5	3	581	0	595
28496	552	10	3	20	0	585
28497	572	8	4	5	0	589
28498	20	583	2	6	0	611
28499	559	16	3	5	0	583
28500	18	548	4	4	0	574
28501	7	580	5	3	0	595
28502	573	19	10	4	0	606
28503	585	11	5	4	0	605
28504	24	4	2	572	0	602
28505	577	7	1	16	0	601
28506	18	9	552	5	0	584
28507	11	567	14	5	0	597
28508	557	14	5	6	0	582
28509	20	5	556	2	0	583
28510	16	3	14	510	0	543
28511	6	517	5	8	0	536
28512	7	548	2	5	0	562
28513	542	10	2	4	0	558
28514	11	6	529	5	0	551
28515	519	1	12	2	0	534
28516	9	3	7	533	0	552
28517	9	2	525	9	0	545
28518	482	1	10	7	0	500
28519	12	531	5	3	0	551
28520	5	569	2	3	0	579
28521	558	12	4	6	0	580
28522	575	7	2	8	0	592
28523	579	3	1	5	0	588
28524	15	4	2	573	0	594
28525	12	3	0	580	0	595
28526	7	3	567	12	0	589
28527	6	0	550	7	0	563
28528	5	565	10	3	0	583
28529	2	12	1	520	0	535
28530	524	2	0	5	0	531
28531	4	518	2	2	0	526
28532	2	5	1	522	0	530
28533	524	4	0	5	0	533
28534	4	503	1	3	0	511
28535	1	537	0	1	0	539
28536	0	7	524	0	0	531
28537	506	3	4	1	0	514
28538	525	0	1	3	0	529
28539	6	1	509	0	0	516
28540	489	0	3	1	0	493
28541	4	0	515	1	0	520
28542	3	513	5	0	0	521
28543	4	4	1	504	0	513
28544	508	3	2	7	0	520
28545	4	509	1	2	0	516
28546	4	517	2	0	0	523
28547	502	6	0	4	0	512
28548	5	3	564	2	0	574
28549	554	0	4	2	0	560
28550	5	591	2	1	0	599
28551	2	6	590	0	0	598
28552	575	1	5	4	0	585
28553	598	0	3	2	0	603
28554	7	2	1	592	0	602
28555	4	1	3	600	0	608
28556	1	598	1	7	0	607
28557	1	6	596	3	0	606
28558	4	3	4	592	0	603
28559	0	4	626	5	0	635
28560	2	1	613	1	0	617
28561	5	1	6	630	0	642
28562	1	1	649	11	0	662
28563	1	2	634	6	0	643
28564	4	0	11	632	0	647
28565	3	0	678	8	0	689
28566	612	2	8	8	0	630
28567	11	643	5	0	0	659
28568	2	7	697	0	0	706
28569	1	3	731	2	0	737
28570	3	2	13	709	0	727
28571	746	1	2	11	0	760
28572	744	1	1	7	0	753
28573	739	1	2	4	0	746
28574	742	2	2	5	0	751
28575	12	2	1	726	0	741
28576	7	0	752	8	0	767
28577	736	1	8	7	0	752
28578	768	1	3	2	0	774
28579	775	2	2	4	0	783
28580	12	2	743	3	0	760
28581	696	0	9	1	0	706
28582	12	0	3	755	0	770
28583	6	778	0	9	0	793
28584	3	11	0	763	0	777
28585	0	749	2	10	0	761
28586	754	12	1	6	0	773
28587	14	3	764	2	0	783
28588	3	3	15	732	0	753
28589	2	743	6	15	0	766
28590	1	760	5	2	0	768
28591	768	12	2	7	0	789
28592	768	4	3	4	0	779
28593	13	2	739	0	0	754
28594	735	3	14	3	0	755
28595	15	3	3	743	0	764
28596	8	1	775	12	0	796
28597	6	0	750	3	0	759
28598	7	0	14	772	0	793
28599	808	2	3	25	0	838
28600	22	1	3	795	0	821
28601	10	0	4	812	0	826
28602	8	0	3	819	0	830
28603	4	795	2	24	0	825
28604	11	16	2	795	0	824
28605	786	2	3	24	0	815
28606	21	787	2	3	0	813
28607	5	17	2	803	0	827
28608	793	5	2	22	0	822
28609	22	804	0	6	0	832
28610	4	834	0	4	0	842
28611	4	19	2	811	0	836
28612	793	3	3	24	0	823
28613	20	5	794	5	0	824
28614	3	3	774	4	0	784
28615	768	2	21	4	0	795
28616	821	3	5	3	0	832
28617	24	830	5	2	0	861
28618	14	22	3	815	0	854
28619	7	4	819	19	0	849
28620	4	4	780	5	0	793
28621	2	2	852	5	0	861
28622	2	816	26	5	0	849
28623	3	844	9	3	0	859
28624	839	23	5	2	0	869
28625	27	5	836	5	0	873
28626	795	3	22	6	0	826
28627	844	2	3	10	0	859
28628	25	4	823	6	0	858
28629	8	857	23	7	0	895
28630	12	21	7	816	0	856
28631	8	5	864	27	0	904
28632	6	7	842	4	0	859
28633	799	3	20	8	0	830
28634	24	847	8	7	0	886
28635	9	27	3	821	0	860
28636	11	5	3	841	0	860
28637	6	833	4	23	0	866
28638	9	854	7	6	0	876
28639	5	874	8	4	0	891
28640	9	28	4	862	0	903
28641	911	8	3	29	0	951
28642	31	11	2	920	0	964
28643	12	5	909	33	0	959
28644	11	5	923	8	0	947
28645	5	3	38	913	0	959
28646	6	6	917	31	0	960
28647	1	909	38	11	0	959
28648	10	32	8	911	0	961
28649	986	10	10	35	0	1041
28650	991	8	7	20	0	1026
28651	46	1004	4	8	0	1062
28652	994	36	3	14	0	1047
28653	1034	9	7	6	0	1056
28654	1039	8	9	11	0	1067
28655	46	6	906	8	0	966
28656	962	5	34	11	0	1012
28657	42	983	12	9	0	1046
28658	12	37	987	7	0	1043
28659	17	10	985	8	0	1020
28660	8	981	38	7	0	1034
28661	962	36	16	10	0	1024
28662	44	8	9	925	0	986
28663	11	936	5	33	0	985
28664	949	38	1	14	0	1002
28665	44	10	3	933	0	990
28666	955	6	8	39	0	1008
28667	48	9	4	946	0	1007
28668	11	8	920	47	0	986
28669	11	5	903	10	0	929
28670	11	8	913	15	0	947
28671	14	5	50	888	0	957
28672	13	10	18	936	0	977
28673	12	10	920	46	0	988
28674	14	909	37	20	0	980
28675	922	36	14	15	0	987
28676	915	18	11	9	0	953
28677	48	924	9	6	0	987
28678	32	39	7	916	0	994
28679	24	15	935	33	0	1007
28680	904	11	46	10	0	971
28681	48	9	938	9	0	1004
28682	18	8	914	6	0	946
28683	20	9	935	5	0	969
28684	868	8	56	11	0	943
28685	38	11	900	8	0	957
28686	21	844	44	6	0	915
28687	26	887	11	7	0	931
28688	19	42	15	845	0	921
28689	20	20	11	869	0	920
28690	14	8	861	41	0	924
28691	833	8	42	16	0	899
28692	880	6	19	14	0	919
28693	42	10	21	876	0	949
28694	862	9	16	40	0	927
28695	41	863	18	16	0	938
28696	844	31	12	24	0	911
28697	41	823	18	12	0	894
28698	18	825	15	9	0	867
28699	792	32	9	10	0	843
28700	788	17	8	15	0	828
28701	808	10	11	17	0	846
28702	838	11	13	7	0	869
28703	46	7	791	10	0	854
28704	801	9	40	4	0	854
28705	43	11	16	774	0	844
28706	28	789	20	26	0	863
28707	799	25	19	12	0	855
28708	35	804	22	8	0	869
28709	805	32	15	9	0	861
28710	42	19	12	787	0	860
28711	28	14	15	794	0	851
28712	19	14	760	36	0	829
28713	14	15	793	19	0	841
28714	23	782	28	18	0	851
28715	775	27	19	12	0	833
28716	35	757	19	13	0	824
28717	26	741	17	11	0	795
28718	29	778	9	15	0	831
28719	22	33	757	7	0	819
28720	20	780	27	12	0	839
28721	722	39	17	8	0	786
28722	738	19	14	7	0	778
28723	37	15	12	694	0	758
28724	27	681	10	26	0	744
28725	35	715	7	17	0	774
28726	24	31	18	706	0	779
28727	20	19	717	31	0	787
28728	24	701	30	11	0	766
28729	30	24	12	669	0	735
28730	652	11	18	30	0	711
28731	649	18	11	16	0	694
28732	32	662	16	14	0	724
28733	682	23	7	13	0	725
28734	688	13	17	9	0	727
28735	34	19	15	644	0	712
28736	23	13	637	27	0	700
28737	17	670	29	12	0	728
28738	22	26	15	662	0	725
28739	9	24	655	19	0	707
28740	18	651	24	9	0	702
28741	592	22	8	12	0	634
28742	581	17	10	9	0	617
28743	35	8	11	568	0	622
28744	16	584	4	21	0	625
28745	15	24	578	9	0	626
28746	14	15	20	572	0	621
28747	8	18	589	21	0	636
28748	9	529	20	6	0	564
28749	19	9	3	430	0	461
28750	416	6	13	8	0	443
28751	12	419	1	4	0	436
28752	419	6	1	7	0	433
28753	404	5	0	7	0	416
28754	10	413	3	5	0	431
28755	9	13	2	412	0	436
28756	11	7	0	409	0	427
28757	4	393	3	10	0	410
28758	5	405	3	8	0	421
28759	4	6	1	381	0	392
28760	5	383	3	6	0	397
28761	398	7	3	4	0	412
28762	394	6	1	3	0	404
28763	6	5	388	0	0	399
28764	7	5	384	4	0	400
28765	368	3	5	4	0	380
28766	397	4	6	3	0	410
28767	4	398	4	4	0	410
28768	399	5	3	3	0	410
28769	391	5	5	1	0	402
28770	9	387	1	4	0	401
28771	370	5	1	2	0	378
28772	6	12	1	412	0	431
28773	8	1	0	430	0	439
28774	4	3	441	12	0	460
28775	1	420	8	4	0	433
28776	2	435	4	2	0	443
28777	401	11	1	4	0	417
28778	403	4	0	4	0	411
28779	397	1	3	6	0	407
28780	416	2	0	2	0	420
28781	10	2	402	1	0	415
28782	3	2	402	1	0	408
28783	1	408	8	1	0	418
28784	4	11	3	398	0	416
28785	4	5	1	395	0	405
28786	4	401	0	10	0	415
28787	6	15	1	400	0	422
28788	403	2	1	10	0	416
28789	12	411	2	4	0	429
28790	4	8	424	2	0	438
28791	1	432	9	2	0	444
28792	434	7	3	5	0	449
28793	9	5	415	2	0	431
28794	396	4	7	3	0	410
28795	421	2	3	4	0	430
28796	10	2	415	2	0	429
28797	5	2	416	2	0	425
28798	2	4	413	0	0	419
28799	385	2	10	3	0	400
28800	11	1	427	1	0	440
28801	4	415	10	1	0	430
28802	415	8	4	0	0	427
28803	9	2	413	0	0	424
28804	385	0	9	2	0	396
28805	8	1	401	0	0	410
28806	4	1	425	0	0	430
28807	4	427	12	0	0	443
28808	1	9	436	0	0	446
28809	4	4	417	1	0	426
28810	3	382	11	1	0	397
28811	409	8	4	3	0	424
28812	11	2	420	1	0	434
28813	5	3	11	387	0	406
28814	3	446	6	7	0	462
28815	446	9	6	2	0	463
28816	431	4	3	5	0	443
28817	10	2	448	0	0	460
28818	1	434	9	1	0	445
28819	2	449	3	2	0	456
28820	4	10	3	433	0	450
28821	4	419	2	9	0	434
28822	5	9	3	402	0	419
28823	6	4	2	442	0	454
28824	3	447	4	9	0	463
28825	5	9	3	442	0	459
28826	4	446	2	9	0	461
28827	4	11	430	5	0	450
28828	4	7	10	422	0	443
28829	9	4	3	423	0	439
28830	1	433	3	11	0	448
28831	5	446	3	2	0	456
28832	6	9	4	431	0	450
28833	2	439	4	9	0	454
28834	434	10	1	8	0	453
28835	10	3	6	436	0	455
28836	4	430	5	8	0	447
28837	426	11	2	10	0	449
28838	9	443	1	4	0	457
28839	6	10	446	4	0	466
28840	5	8	9	432	0	454
28841	446	3	4	10	0	463
28842	13	3	451	4	0	471
28843	5	8	8	434	0	455
28844	4	438	9	9	0	460
28845	3	13	423	4	0	443
28846	6	438	10	4	0	458
28847	409	9	6	8	0	432
28848	431	4	2	2	0	439
28849	14	427	3	4	0	448
28850	423	8	6	5	0	442
28851	8	8	421	2	0	439
28852	7	3	11	412	0	433
28853	10	4	4	398	0	416
28854	4	423	8	7	0	442
28855	449	10	3	7	0	469
28856	466	7	2	3	0	478
28857	11	2	467	2	0	482
28858	457	5	11	2	0	475
28859	474	2	8	5	0	489
28860	479	1	7	6	0	493
28861	13	5	1	460	0	479
28862	6	3	3	456	0	468
28863	3	469	5	7	0	484
28864	447	9	4	5	0	465
28865	450	2	4	6	0	462
28866	12	438	6	0	0	456
28867	9	8	3	427	0	447
28868	5	430	2	8	0	445
28869	7	443	1	3	0	454
28870	439	10	4	6	0	459
28871	11	4	440	2	0	457
28872	2	2	386	1	0	391
28873	2	392	3	3	0	400
28874	362	2	0	6	0	370
28875	2	2	364	0	0	368
28876	3	340	2	0	0	345
28877	337	0	0	3	0	340
28878	0	1	327	0	0	328
28879	2	0	0	323	0	325
28880	345	0	0	1	0	346
28881	0	0	350	0	0	350
28882	2	0	363	0	0	365
28883	0	0	373	0	0	373
28884	2	2	369	0	0	373
28885	347	0	3	1	0	351
28886	398	0	2	2	0	402
28887	3	408	0	0	0	411
28888	5	1	0	414	0	420
28889	0	2	0	425	0	427
28890	0	398	0	3	0	401
28891	1	1	0	406	0	408
28892	0	430	0	3	0	433
28893	0	434	0	3	0	437
28894	2	5	0	425	0	432
28895	0	5	433	1	0	439
28896	0	425	1	4	0	430
28897	2	1	4	429	0	436
28898	434	4	1	2	0	441
28899	1	3	427	4	0	435
28900	414	0	1	5	0	420
28901	421	0	5	1	0	427
28902	6	1	1	430	0	438
28903	5	1	471	3	0	480
28904	2	1	450	6	0	459
28905	0	501	10	1	0	512
28906	2	6	8	480	0	496
28907	2	7	496	5	0	510
28908	0	1	493	8	0	502
28909	0	501	12	1	0	514
28910	494	4	9	4	0	511
28911	500	7	3	3	0	513
28912	11	1	2	565	0	579
28913	7	1	599	11	0	618
28914	11	0	574	10	0	595
28915	2	612	21	5	0	640
28916	2	10	622	2	0	636
28917	0	13	608	1	0	622
28918	2	6	23	575	0	606
28919	0	4	621	13	0	638
28920	568	0	19	13	0	600
28921	11	1	14	608	0	634
28922	12	2	637	13	0	664
28923	5	673	14	10	0	702
28924	8	11	12	677	0	708
28925	0	12	690	15	0	717
28926	0	678	16	9	0	703
28927	2	13	15	664	0	694
28928	3	705	5	13	0	726
28929	1	14	5	696	0	716
28930	5	12	3	686	0	706
28931	0	4	679	26	0	709
28932	0	677	17	15	0	709
28933	5	15	9	696	0	725
28934	2	14	8	687	0	711
28935	1	4	7	703	0	715
28936	0	6	681	30	0	717
28937	2	660	18	20	0	700
28938	3	15	18	670	0	706
28939	3	14	654	19	0	690
28940	1	653	22	16	0	692
28941	4	22	13	654	0	693
28942	4	12	658	20	0	694
28943	3	653	23	17	0	696
28944	2	21	16	644	0	683
28945	6	14	8	677	0	705
28946	2	10	708	26	0	746
28947	626	7	15	28	0	676
28948	13	697	20	13	0	743
28949	706	18	14	4	0	742
28950	14	24	698	10	0	746
28951	704	5	20	14	0	743
28952	18	3	26	713	0	760
28953	16	11	3	739	0	769
28954	5	4	723	30	0	762
28955	678	6	17	20	0	721
28956	682	3	15	26	0	726
28957	23	684	20	6	0	733
28958	15	728	6	7	0	756
28959	712	24	4	18	0	758
28960	15	15	720	4	0	754
28961	17	750	16	3	0	786
28962	9	17	12	774	0	812
28963	6	17	13	793	0	829
28964	4	8	787	24	0	823
28965	729	5	17	28	0	779
28966	13	8	811	14	0	846
28967	789	11	17	12	0	829
28968	21	1	846	10	0	878
28969	23	836	26	6	0	891
28970	842	21	17	17	0	897
28971	849	20	12	15	0	896
28972	853	9	11	6	0	879
28973	858	5	8	15	0	886
28974	38	6	8	832	0	884
28975	20	12	833	22	0	887
28976	14	10	19	823	0	866
28977	13	850	21	22	0	906
28978	7	22	9	874	0	912
28979	5	17	859	25	0	906
28980	8	8	871	21	0	908
28981	7	7	33	845	0	892
28982	841	6	22	30	0	899
28983	846	5	13	20	0	884
28984	860	9	10	11	0	890
28985	35	1	858	11	0	905
28986	24	1	848	7	0	880
28987	6	822	33	11	0	872
28988	15	841	18	9	0	883
28989	822	25	17	6	0	870
28990	840	12	5	11	0	868
28991	35	865	5	6	0	911
28992	856	22	5	10	0	893
28993	848	12	9	6	0	875
28994	31	847	4	7	0	889
28995	875	24	5	8	0	912
28996	873	13	4	10	0	900
28997	31	855	6	9	0	901
28998	882	21	12	6	0	921
28999	875	10	6	14	0	905
29000	35	7	867	3	0	912
29001	14	11	854	3	0	882
29002	17	858	22	3	0	900
29003	10	857	17	2	0	886
29004	841	22	8	5	0	876
29005	807	6	4	3	0	820
29006	812	5	3	8	0	828
29007	24	811	3	2	0	840
29008	21	8	2	830	0	861
29009	8	11	849	14	0	882
29010	10	9	16	828	0	863
29011	9	850	10	15	0	884
29012	802	7	1	6	0	816
29013	10	764	0	1	0	775
29014	8	5	0	770	0	783
29015	796	3	0	8	0	807
29016	783	1	1	5	0	790
29017	9	0	785	0	0	794
29018	765	1	6	5	0	777
29019	836	2	4	2	0	844
29020	845	1	1	4	0	851
29021	12	3	1	822	0	838
29022	5	804	2	5	0	816
29023	4	6	0	779	0	789
29024	5	2	803	6	0	816
29025	4	794	9	3	0	810
29026	4	8	3	806	0	821
29027	1	6	809	10	0	826
29028	5	804	10	4	0	823
29029	12	10	4	769	0	795
29030	4	7	798	7	0	816
29031	693	2	9	10	0	714
29032	11	2	820	3	0	836
29033	6	1	810	0	0	817
29034	5	828	12	1	0	846
29035	5	8	4	814	0	831
29036	3	5	3	807	0	818
29037	6	790	2	11	0	809
29038	4	9	2	839	0	854
29039	828	4	1	14	0	847
29040	824	2	1	7	0	834
29041	15	3	804	2	0	824
29042	800	1	10	5	0	816
29043	824	3	5	3	0	835
29044	14	1	834	3	0	852
29045	5	835	11	1	0	852
29046	3	822	5	0	0	830
29047	5	13	1	767	0	786
29048	3	812	4	6	0	825
29049	4	12	770	3	0	789
29050	4	5	766	2	0	777
29051	4	787	13	0	0	804
29052	804	15	4	2	0	825
29053	808	6	1	4	0	819
29054	812	3	1	3	0	819
29055	801	4	1	4	0	810
29056	766	2	0	9	0	777
29057	17	772	5	5	0	799
29058	7	12	767	1	0	787
29059	8	3	13	765	0	789
29060	758	2	5	13	0	778
29061	15	753	2	4	0	774
29062	11	14	3	719	0	747
29063	7	6	740	10	0	763
29064	2	706	13	3	0	724
29065	2	740	5	9	0	756
29066	691	21	10	5	0	727
29067	9	697	8	2	0	716
29068	4	8	1	677	0	690
29069	658	3	3	12	0	676
29070	647	4	3	4	0	658
29071	664	1	4	3	0	672
29072	14	1	645	0	0	660
29073	6	653	7	2	0	668
29074	665	6	4	6	0	681
29075	13	4	0	645	0	662
29076	649	2	1	10	0	662
29077	8	638	2	2	0	650
29078	675	8	2	4	0	689
29079	736	5	1	5	0	747
29080	25	2	5	713	0	745
29081	6	6	741	15	0	768
29082	10	2	16	758	0	786
29083	761	3	7	20	0	791
29084	772	5	3	8	0	788
29085	23	767	2	3	0	795
29086	738	19	2	6	0	765
29087	20	745	2	2	0	769
29088	766	18	3	4	0	791
29089	733	7	1	8	0	749
29090	25	5	737	2	0	769
29091	11	709	13	1	0	734
29092	6	18	8	743	0	775
29093	5	12	3	742	0	762
29094	4	6	4	723	0	737
29095	6	730	2	23	0	761
29096	6	17	735	6	0	764
29097	0	13	749	4	0	766
29098	4	978	24	4	0	1010
29099	968	28	9	7	0	1012
29100	30	12	968	6	0	1016
29101	941	10	31	7	0	989
29102	37	953	12	4	0	1006
29103	14	33	957	1	0	1005
29104	14	11	30	939	0	994
29105	6	11	970	29	0	1016
29106	9	4	1001	10	0	1024
29107	10	4	36	875	0	925
29108	10	930	21	25	0	986
29109	4	972	7	11	0	994
29110	958	36	4	8	0	1006
29111	33	16	927	6	0	982
29112	932	8	29	4	0	973
29113	956	5	13	7	0	981
29114	38	970	10	5	0	1023
29115	951	31	2	4	0	988
29116	964	12	2	7	0	985
29117	947	12	4	2	0	965
29118	48	894	4	5	0	951
29119	27	834	2	10	0	873
29120	13	909	3	2	0	927
29121	887	42	2	5	0	936
29122	910	15	3	6	0	934
29123	38	13	845	5	0	901
29124	23	2	849	2	0	876
29125	850	3	36	3	0	892
29126	880	3	21	3	0	907
29127	879	2	10	8	0	899
29128	47	5	3	833	0	888
29129	26	5	4	846	0	881
29130	21	2	2	866	0	891
29131	15	4	4	880	0	903
29132	6	5	803	37	0	851
29133	7	2	851	21	0	881
29134	8	2	858	10	0	878
29135	8	2	855	3	0	868
29136	832	6	42	6	0	886
29137	29	859	17	4	0	909
29138	13	903	10	5	0	931
29139	889	37	3	10	0	939
29140	32	20	881	3	0	936
29141	11	15	879	3	0	908
29142	880	7	37	4	0	928
29143	895	3	19	7	0	924
29144	37	880	15	3	0	935
29145	22	27	3	890	0	942
29146	909	12	4	29	0	954
29147	913	9	6	11	0	939
29148	39	4	8	859	0	910
29149	17	909	4	25	0	955
29150	917	27	2	11	0	957
29151	30	12	883	11	0	936
29152	884	8	24	8	0	924
29153	35	894	14	2	0	945
29154	906	27	12	3	0	948
29155	890	12	4	9	0	915
29156	37	8	909	2	0	956
29157	20	3	892	4	0	919
29158	893	4	34	7	0	938
29159	939	5	17	7	0	968
29160	35	929	11	1	0	976
29161	25	28	2	941	0	996
29162	13	10	935	23	0	981
29163	920	8	29	14	0	971
29164	33	3	13	938	0	987
29165	19	7	9	962	0	997
29166	944	3	6	36	0	989
29167	32	970	4	17	0	1023
29168	975	25	6	16	0	1022
29169	974	14	6	6	0	1000
29170	994	9	0	6	0	1009
29171	40	951	3	8	0	1002
29172	993	27	3	6	0	1029
29173	46	10	2	970	0	1028
29174	20	8	6	981	0	1015
29175	14	3	968	36	0	1021
29176	9	5	944	18	0	976
29177	8	932	34	7	0	981
29178	8	965	17	2	0	992
29179	10	20	879	2	0	911
29180	4	919	19	1	0	943
29181	910	34	6	10	0	960
29182	901	10	5	6	0	922
29183	920	8	4	4	0	936
29184	35	4	3	867	0	909
29185	21	0	2	899	0	922
29186	14	3	908	22	0	947
29187	3	912	18	14	0	947
29188	871	18	7	15	0	911
29189	23	889	8	2	0	922
29190	911	25	2	1	0	939
29191	933	7	1	1	0	942
29192	29	10	2	890	0	931
29193	23	1	1	900	0	925
29194	14	1	2	932	0	949
29195	6	1	898	34	0	939
29196	3	864	17	17	0	901
29197	4	878	9	11	0	902
29198	0	623	3	0	0	626
29199	1	619	0	0	0	620
29200	2	637	0	0	0	639
29201	595	7	2	7	0	611
29202	4	1	609	1	0	615
29203	0	621	5	2	0	628
29204	3	6	584	0	0	593
29205	0	614	6	0	0	620
29206	6	5	2	475	0	488
29207	3	2	2	585	0	592
29208	0	603	1	6	0	610
29209	592	4	0	6	0	602
29210	6	0	587	2	0	595
29211	0	615	4	0	0	619
29212	2	5	591	0	0	598
29213	4	0	5	575	0	584
29214	4	2	0	562	0	568
29215	0	595	2	5	0	602
29216	2	4	1	601	0	608
29217	3	1	1	603	0	608
29218	0	612	0	4	0	616
29219	0	4	601	3	0	608
29220	1	3	576	2	0	582
29221	560	3	4	4	0	571
29222	601	0	4	6	0	611
29223	6	1	2	587	0	596
29224	3	0	606	4	0	613
29225	2	0	4	581	0	587
29226	2	633	0	6	0	641
29227	0	5	663	1	0	669
29228	0	632	4	8	0	644
29229	1	6	637	1	0	645
29230	1	648	6	0	0	655
29231	643	6	1	3	0	653
29232	9	0	2	634	0	645
29233	6	3	0	629	0	638
29234	3	0	629	6	0	638
29235	2	2	590	5	0	599
29236	1	616	6	2	0	625
29237	613	5	1	3	0	622
29238	3	3	1	606	0	613
29239	1	4	624	4	0	633
29240	2	3	605	1	0	611
29241	569	2	5	6	0	582
29242	600	2	2	5	0	609
29243	4	1	629	1	0	635
29244	3	2	4	612	0	621
29245	2	626	1	4	0	633
29246	630	5	3	3	0	641
29247	3	632	1	3	0	639
29248	623	7	0	2	0	632
29249	5	607	1	1	0	614
29250	2	630	1	2	0	635
29251	2	4	2	629	0	637
29252	2	5	1	625	0	633
29253	1	629	3	4	0	637
29254	1	6	611	4	0	622
29255	1	2	598	3	0	604
29256	2	2	589	1	0	594
29257	557	6	6	1	0	570
29258	585	1	2	4	0	592
29259	3	588	5	1	0	597
29260	4	7	587	1	0	599
29261	5	3	6	574	0	588
29262	0	3	606	6	0	615
29263	0	2	619	4	0	625
29264	6	2	9	670	0	687
29265	1	3	4	747	0	755
29266	1	1	811	20	0	833
29267	767	2	21	13	0	803
29268	24	853	7	6	0	890
29269	8	907	8	3	0	926
29270	13	34	0	869	0	916
29271	880	17	0	29	0	926
29272	25	904	3	11	0	943
29273	914	25	1	11	0	951
29274	32	924	3	2	0	961
29275	958	39	3	3	0	1003
29276	34	14	942	6	0	996
29277	18	11	961	4	0	994
29278	13	13	39	907	0	972
29279	7	6	929	25	0	967
29280	5	856	31	12	0	904
29281	5	842	13	8	0	868
29282	854	37	11	2	0	904
29283	29	19	7	813	0	868
29284	13	861	5	27	0	906
29285	865	24	7	15	0	911
29286	844	16	4	11	0	875
29287	871	11	1	5	0	888
29288	53	4	4	832	0	893
29289	22	4	3	865	0	894
29290	8	8	843	36	0	895
29291	8	2	833	17	0	860
29292	814	2	38	9	0	863
29293	36	5	20	819	0	880
29294	16	4	803	30	0	853
29295	783	4	28	21	0	836
29296	30	840	15	9	0	894
29297	862	27	12	7	0	908
29298	894	15	3	5	0	917
29299	902	6	3	9	0	920
29300	46	2	853	4	0	905
29301	862	3	28	3	0	896
29302	36	10	13	827	0	886
29303	18	800	13	25	0	856
29304	16	878	5	17	0	916
29305	870	37	8	9	0	924
29306	890	16	7	4	0	917
29307	914	8	2	4	0	928
29308	51	4	3	862	0	920
29309	24	5	3	905	0	937
29310	15	11	3	883	0	912
29311	12	875	3	44	0	934
29312	878	28	3	16	0	925
29313	904	16	2	10	0	932
29314	917	7	2	12	0	938
29315	50	2	888	9	0	949
29316	908	5	29	11	0	953
29317	37	7	14	866	0	924
29318	20	896	7	28	0	951
29319	902	29	3	14	0	948
29320	902	16	7	8	0	933
29321	55	8	883	2	0	948
29322	28	5	29	848	0	910
29323	17	869	14	35	0	935
29324	896	31	9	21	0	957
29325	41	22	3	893	0	959
29326	30	10	3	892	0	935
29327	24	4	9	887	0	924
29328	18	7	7	918	0	950
29329	15	8	886	50	0	959
29330	12	881	37	22	0	952
29331	16	31	16	885	0	948
29332	9	24	889	39	0	961
29333	873	17	33	25	0	948
29334	914	7	16	23	0	960
29335	56	9	15	886	0	966
29336	911	10	5	42	0	968
29337	933	9	7	27	0	976
29338	51	10	924	11	0	996
29339	35	893	32	12	0	972
29340	904	36	16	14	0	970
29341	44	16	16	894	0	970
29342	904	12	7	47	0	970
29343	56	6	10	883	0	955
29344	27	10	10	918	0	965
29345	22	11	881	47	0	961
29346	834	6	34	29	0	903
29347	41	879	19	21	0	960
29348	27	37	880	12	0	956
29349	23	879	30	15	0	947
29350	861	40	16	16	0	933
29351	51	16	14	855	0	936
29352	858	11	11	43	0	923
29353	53	846	8	20	0	927
29354	878	33	12	14	0	937
29355	892	22	11	19	0	944
29356	915	14	6	10	0	945
29357	915	8	7	14	0	944
29358	63	864	7	11	0	945
29359	888	34	3	6	0	931
29360	54	16	5	848	0	923
29361	36	10	6	864	0	916
29362	25	789	4	40	0	858
29363	21	798	4	22	0	845
29364	19	791	3	12	0	825
29365	696	32	5	7	0	740
29366	24	628	3	8	0	663
29367	8	545	2	6	0	561
29368	537	11	14	7	0	569
29369	529	9	3	3	0	544
29370	15	540	2	4	0	561
29371	539	8	2	4	0	553
29372	15	5	521	2	0	543
29373	503	6	6	3	0	518
29374	14	5	504	4	0	527
29375	6	455	6	3	0	470
29376	9	474	3	3	0	489
29377	9	10	2	469	0	490
29378	472	8	1	10	0	491
29379	481	3	1	9	0	494
29380	488	4	3	5	0	500
29381	483	3	2	5	0	493
29382	480	5	3	4	0	492
29383	9	4	460	5	0	478
29384	6	5	440	1	0	452
29385	454	4	7	4	0	469
29386	11	487	4	1	0	503
29387	497	7	2	2	0	508
29388	494	3	2	3	0	502
29389	516	2	1	3	0	522
29390	518	2	1	2	0	523
29391	516	2	2	5	0	525
29392	8	2	508	2	0	520
29393	511	2	3	4	0	520
29394	517	1	4	5	0	527
29395	8	4	500	3	0	515
29396	464	3	11	4	0	482
29397	491	4	4	6	0	505
29398	12	1	520	0	0	533
29399	9	5	509	2	0	525
29400	5	522	8	2	0	537
29401	4	6	4	524	0	538
29402	10	8	522	1	0	541
29403	533	3	5	6	0	547
29404	8	1	5	550	0	564
29405	8	2	578	2	0	590
29406	566	4	3	7	0	580
29407	579	1	4	4	0	588
29408	580	3	0	4	0	587
29409	11	591	1	2	0	605
29410	3	6	1	577	0	587
29411	7	589	2	3	0	601
29412	590	3	3	3	0	599
29413	584	3	1	6	0	594
29414	5	2	584	0	0	591
29415	3	548	2	0	0	553
29416	2	559	2	1	0	564
29417	2	4	0	562	0	568
29418	3	2	1	554	0	560
29419	559	3	0	4	0	566
29420	4	558	0	2	0	564
29421	5	559	0	2	0	566
29422	1	3	558	1	0	563
29423	4	567	1	0	0	572
29424	558	3	2	2	0	565
29425	5	0	555	1	0	561
29426	506	0	1	4	0	511
29427	2	1	543	1	0	547
29428	478	0	0	5	0	483
29429	2	554	1	0	0	557
29430	562	0	1	4	0	567
29431	0	1	564	0	0	565
29432	562	1	0	6	0	569
29433	568	1	1	1	0	571
29434	3	0	587	0	0	590
29435	587	0	1	2	0	590
29436	584	0	2	4	0	590
29437	571	1	1	4	0	577
29438	1	558	0	1	0	560
29439	557	0	0	4	0	561
29440	2	1	563	1	0	567
29441	2	600	1	1	0	604
29442	616	2	1	5	0	624
29443	594	3	1	7	0	605
29444	611	0	0	3	0	614
29445	3	603	1	0	0	607
29446	3	1	1	709	0	714
29447	1	3	722	5	0	731
29448	3	1	7	712	0	723
29449	1	0	728	8	0	737
29450	696	0	7	4	0	707
29451	8	717	2	7	0	734
29452	5	8	2	702	0	717
29453	1	719	1	7	0	728
29454	4	6	1	715	0	726
29455	6	3	1	696	0	706
29456	2	729	3	9	0	743
29457	3	8	2	736	0	749
29458	5	4	1	769	0	779
29459	3	766	3	12	0	784
29460	4	779	0	4	0	787
29461	5	15	1	769	0	790
29462	3	4	766	13	0	786
29463	1	775	12	4	0	792
29464	5	11	1	760	0	777
29465	2	4	770	13	0	789
29466	2	776	13	5	0	796
29467	757	14	5	8	0	784
29468	15	7	755	3	0	780
29469	754	2	13	6	0	775
29470	18	3	5	754	0	780
29471	9	7	2	761	0	779
29472	10	3	1	761	0	775
29473	2	6	759	15	0	782
29474	9	3	744	6	0	762
29475	720	3	16	5	0	744
29476	16	2	5	741	0	764
29477	7	3	736	15	0	761
29478	714	2	15	8	0	739
29479	20	1	5	743	0	769
29480	7	2	4	752	0	765
29481	8	4	1	735	0	748
29482	1	741	4	16	0	762
29483	4	14	1	723	0	742
29484	1	724	5	19	0	749
29485	4	756	3	7	0	770
29486	728	17	2	9	0	756
29487	683	9	2	7	0	701
29488	739	4	1	8	0	752
29489	15	731	2	3	0	751
29490	714	17	1	7	0	739
29491	743	4	3	7	0	757
29492	19	7	3	729	0	758
29493	13	5	1	741	0	760
29494	4	4	733	21	0	762
29495	6	745	16	6	0	773
29496	736	18	5	8	0	767
29497	729	6	3	11	0	749
29498	17	739	3	9	0	768
29499	731	16	5	7	0	759
29500	734	7	3	8	0	752
29501	23	6	3	727	0	759
29502	6	708	3	19	0	736
29503	5	724	3	5	0	737
29504	699	17	5	6	0	727
29505	17	7	0	690	0	714
29506	7	3	686	20	0	716
29507	659	5	13	11	0	688
29508	15	9	696	5	0	725
29509	8	675	18	5	0	706
29510	679	15	8	8	0	710
29511	16	6	683	5	0	710
29512	14	6	18	674	0	712
29513	6	2	707	17	0	732
29514	5	714	14	10	0	743
29515	6	17	5	715	0	743
29516	5	7	719	18	0	749
29517	654	2	13	12	0	681
29518	14	720	8	8	0	750
29519	6	22	4	691	0	723
29520	6	718	5	21	0	750
29521	721	17	5	6	0	749
29522	726	7	3	8	0	744
29523	18	712	4	6	0	740
29524	8	14	4	692	0	718
29525	6	717	3	14	0	740
29526	712	18	1	7	0	738
29527	19	6	709	9	0	743
29528	4	8	704	5	0	721
29529	6	674	15	6	0	701
29530	5	699	5	3	0	712
29531	9	15	4	685	0	713
29532	668	9	4	17	0	698
29533	680	4	5	3	0	692
29534	673	4	4	4	0	685
29535	19	730	2	4	0	755
29536	10	17	5	710	0	742
29537	11	720	4	14	0	749
29538	727	14	3	8	0	752
29539	23	4	3	725	0	755
29540	4	8	704	18	0	734
29541	4	696	13	8	0	721
29542	674	17	3	6	0	700
29543	19	5	678	4	0	706
29544	667	6	12	4	0	689
29545	18	675	5	1	0	699
29546	2	575	2	4	0	583
29547	560	10	2	4	0	576
29548	10	577	2	0	0	589
29549	555	10	0	3	0	568
29550	11	548	2	1	0	562
29551	553	11	2	2	0	568
29552	552	4	0	2	0	558
29553	9	4	586	2	0	601
29554	4	1	574	2	0	581
29555	2	605	7	0	0	614
29556	575	7	12	3	0	597
29557	6	4	567	0	0	577
29558	517	9	6	1	0	533
29559	6	6	0	530	0	542
29560	2	3	542	2	0	549
29561	2	0	510	1	0	513
29562	2	1	541	0	0	544
29563	0	545	4	0	0	549
29564	8	9	4	523	0	544
29565	530	2	0	2	0	534
29566	2	0	0	529	0	531
29567	530	1	1	2	0	534
29568	3	0	0	537	0	540
29569	549	0	4	3	0	556
29570	567	1	1	3	0	572
29571	628	0	1	2	0	631
29572	1	651	1	0	0	653
29573	2	2	645	0	0	649
29574	1	0	2	651	0	654
29575	12	6	5	362	0	385
29576	0	1	1	655	0	657
29577	3	1	0	638	0	642
29578	1	642	1	4	0	648
29579	2	2	612	1	0	617
29580	0	650	1	1	0	652
29581	2	2	0	627	0	631
29582	1	2	1	659	0	663
29583	2	0	1	669	0	672
29584	1	1	0	656	0	658
29585	1	649	0	1	0	651
29586	0	651	0	3	0	654
29587	0	2	656	2	0	660
29588	2	5	1	645	0	653
29589	1	2	0	649	0	652
29590	1	1	2	669	0	673
29591	677	0	0	5	0	682
29592	3	680	0	2	0	685
29593	1	3	690	2	0	696
29594	680	1	1	1	0	683
29595	4	5	0	687	0	696
29596	702	2	1	4	0	709
29597	4	1	1	700	0	706
29598	719	0	1	8	0	728
29599	3	1	1	720	0	725
29600	713	1	1	6	0	721
29601	3	0	760	0	0	763
29602	4	2	2	744	0	752
29603	4	784	1	1	0	790
29604	2	3	2	797	0	804
29605	795	2	0	4	0	801
29606	3	778	0	2	0	783
29607	4	1	1	806	0	812
29608	3	789	1	4	0	797
29609	2	5	1	812	0	820
29610	5	2	1	816	0	824
29611	2	1	808	4	0	815
29612	3	1	6	789	0	799
29613	0	3	775	5	0	783
29614	2	765	5	1	0	773
29615	757	3	3	5	0	768
29616	6	1	760	1	0	768
29617	731	2	3	5	0	741
29618	768	3	1	5	0	777
29619	4	2	5	799	0	810
29620	4	1	831	7	0	843
29621	777	1	5	6	0	789
29622	852	1	1	12	0	866
29623	10	0	4	833	0	847
29624	5	2	0	845	0	852
29625	4	865	4	5	0	878
29626	5	5	3	865	0	878
29627	3	852	1	11	0	867
29628	4	6	843	4	0	857
29629	7	0	5	843	0	855
29630	832	2	2	8	0	844
29631	829	1	3	5	0	838
29632	5	839	1	4	0	849
29633	8	6	2	848	0	864
29634	836	2	5	6	0	849
29635	7	793	4	5	0	809
29636	807	4	1	9	0	821
29637	15	3	0	830	0	848
29638	874	6	0	14	0	894
29639	6	5	979	3	0	993
29640	4	986	11	9	0	1010
29641	978	13	2	5	0	998
29642	10	995	9	6	0	1020
29643	1002	16	2	10	0	1030
29644	1005	6	1	10	0	1022
29645	15	4	1001	6	0	1026
29646	7	6	12	963	0	988
29647	1013	2	4	16	0	1035
29648	15	2	997	7	0	1021
29649	984	5	15	9	0	1013
29650	24	1	2	1005	0	1032
29651	5	3	1015	16	0	1039
29652	9	3	14	990	0	1016
29653	977	1	4	23	0	1005
29654	14	7	1025	3	0	1049
29655	7	4	13	1012	0	1036
29656	10	4	2	1027	0	1043
29657	1021	1	6	19	0	1047
29658	1003	2	4	10	0	1019
29659	14	1054	7	7	0	1082
29660	12	16	2	1059	0	1089
29661	13	6	3	1054	0	1076
29662	9	4	4	1048	0	1065
29663	1041	0	4	19	0	1064
29664	1028	2	3	13	0	1046
29665	19	2	6	1022	0	1049
29666	10	1003	2	21	0	1036
29667	15	14	8	995	0	1032
29668	8	1031	7	15	0	1061
29669	1008	18	0	15	0	1041
29670	17	982	5	13	0	1017
29671	919	16	5	7	0	947
29672	28	2	3	908	0	941
29673	908	7	6	17	0	938
29674	21	2	900	11	0	934
29675	7	917	13	14	0	951
29676	926	11	5	13	0	955
29677	936	2	5	6	0	949
29678	23	9	4	910	0	946
29679	8	923	4	22	0	957
29680	11	15	4	937	0	967
29681	9	2	2	946	0	959
29682	14	7	5	945	0	971
29683	952	3	3	27	0	985
29684	945	4	3	17	0	969
29685	21	9	2	935	0	967
29686	12	933	2	20	0	967
29687	951	19	1	12	0	983
29688	21	5	927	10	0	963
29689	13	10	12	936	0	971
29690	16	4	942	19	0	981
29691	14	3	16	933	0	966
29692	14	4	940	22	0	980
29693	10	6	18	937	0	971
29694	943	10	7	25	0	985
29695	945	7	3	14	0	969
29696	27	922	2	9	0	960
29697	945	18	3	5	0	971
29698	27	10	0	912	0	949
29699	14	8	1	934	0	957
29700	930	4	5	29	0	968
29701	22	4	890	15	0	931
29702	16	4	887	8	0	915
29703	14	4	877	9	0	904
29704	874	2	19	15	0	910
29705	22	7	913	12	0	954
29706	16	5	889	7	0	917
29707	853	3	18	15	0	889
29708	20	882	6	15	0	923
29709	13	14	9	879	0	915
29710	15	8	2	895	0	920
29711	10	5	928	24	0	967
29712	907	4	17	13	0	941
29713	915	4	4	17	0	940
29714	890	6	6	12	0	914
29715	24	4	917	10	0	955
29716	872	3	18	9	0	902
29717	20	2	912	11	0	945
29718	13	878	19	9	0	919
29719	13	877	7	9	0	906
29720	838	16	5	11	0	870
29721	16	822	6	11	0	855
29722	10	817	3	9	0	839
29723	825	14	6	7	0	852
29724	20	834	5	7	0	866
29725	813	15	6	12	0	846
29726	26	1	2	836	0	865
29727	9	4	5	843	0	861
29728	11	3	5	840	0	859
29729	7	4	9	843	0	863
29730	9	832	5	20	0	866
29731	844	17	9	6	0	876
29732	22	926	6	8	0	962
29733	8	965	4	8	0	985
29734	16	24	1035	5	0	1080
29735	957	17	20	7	0	1001
29736	29	9	1076	8	0	1122
29737	19	4	1147	6	0	1176
29738	6	1087	36	11	0	1140
29739	4	1103	11	9	0	1127
29740	1125	36	7	6	0	1174
29741	31	1167	6	3	0	1207
29742	20	32	1152	1	0	1205
29743	9	1142	29	3	0	1183
29744	5	36	1182	1	0	1224
29745	1	24	1164	3	0	1192
29746	1111	8	47	6	0	1172
29747	32	7	1178	1	0	1218
29748	26	3	44	1123	0	1196
29749	1116	4	25	28	0	1173
29750	29	1112	15	20	0	1176
29751	20	34	1125	10	0	1189
29752	1107	18	30	9	0	1164
29753	37	12	23	1052	0	1124
29754	21	1030	14	25	0	1090
29755	13	29	1060	18	0	1120
29756	1041	20	27	16	0	1104
29757	27	14	1086	6	0	1133
29758	31	7	41	1048	0	1127
29759	14	0	1039	32	0	1085
29760	12	3	41	1026	0	1082
29761	985	3	26	42	0	1056
29762	30	1012	15	24	0	1081
29763	1032	28	11	11	0	1082
29764	42	20	1017	8	0	1087
29765	31	14	31	1019	0	1095
29766	14	6	1047	30	0	1097
29767	1020	1	41	25	0	1087
29768	1030	4	27	19	0	1080
29769	49	1037	16	7	0	1109
29770	1070	27	15	6	0	1118
29771	1074	19	6	7	0	1106
29772	57	13	10	1028	0	1108
29773	32	8	1041	29	0	1110
29774	25	1004	32	19	0	1080
29775	13	32	20	1034	0	1099
29776	1043	18	17	32	0	1110
29777	34	18	1036	21	0	1109
29778	24	7	1045	17	0	1093
29779	18	3	1032	8	0	1061
29780	999	5	59	4	0	1067
29781	34	6	1043	4	0	1087
29782	996	5	41	7	0	1049
29783	46	5	949	2	0	1002
29784	30	972	46	4	0	1052
29785	21	24	34	958	0	1037
29786	13	23	986	27	0	1049
29787	4	948	42	22	0	1016
29788	12	980	24	14	0	1030
29789	11	48	19	967	0	1045
29790	958	31	11	32	0	1032
29791	32	19	15	966	0	1032
29792	954	11	9	43	0	1017
29793	47	9	13	957	0	1026
29794	26	12	938	42	0	1018
29795	20	7	955	26	0	1008
29796	913	7	54	23	0	997
29797	949	6	36	20	0	1011
29798	53	5	941	8	0	1007
29799	922	16	34	12	0	984
29800	48	11	933	7	0	999
29801	34	859	40	10	0	943
29802	29	888	33	6	0	956
29803	21	893	23	5	0	942
29804	14	54	25	855	0	948
29805	864	37	17	32	0	950
29806	882	20	18	27	0	947
29807	63	15	17	867	0	962
29808	40	11	847	37	0	935
29809	30	13	38	863	0	944
29810	21	15	853	44	0	933
29811	18	9	48	827	0	902
29812	814	8	39	40	0	901
29813	835	7	31	29	0	902
29814	841	9	20	20	0	890
29815	839	8	20	18	0	885
29816	76	5	13	783	0	877
29817	54	5	16	814	0	889
29818	808	8	15	56	0	887
29819	832	3	14	37	0	886
29820	65	7	12	805	0	889
29821	47	5	10	822	0	884
29822	29	10	15	824	0	878
29823	25	9	8	841	0	883
29824	791	9	9	68	0	877
29825	44	3	769	47	0	863
29826	35	1	38	762	0	836
29827	758	5	32	42	0	837
29828	44	4	749	34	0	831
29829	34	5	34	749	0	822
29830	27	7	751	36	0	821
29831	25	691	44	26	0	786
29832	21	18	25	618	0	682
29833	567	14	23	43	0	647
29834	29	13	23	476	0	541
29835	20	444	11	31	0	506
29836	18	419	9	14	0	460
29837	7	302	7	12	0	328
29838	16	292	4	8	0	320
29839	128	35	20	15	0	198
29840	3	10	4	76	0	93
29841	2	1	64	1	0	68
29842	1	0	1	63	0	65
29843	0	1	63	1	0	65
29844	59	0	1	3	0	63
29845	2	0	1	57	0	60
29846	1	0	1	59	0	61
29847	3	1	0	59	0	63
29848	2	1	0	60	0	63
29849	57	1	0	2	0	60
29850	59	1	0	2	0	62
29851	2	0	0	61	0	63
29852	60	0	0	2	0	62
29853	2	0	59	1	0	62
29854	1	56	0	3	0	60
29855	1	0	1	58	0	60
29856	1	0	1	58	0	60
29857	1	53	0	2	0	56
29858	0	0	1	56	0	57
29859	2	0	0	55	0	57
29860	54	0	1	1	0	56
29861	1	0	51	2	0	54
29862	2	0	43	1	0	46
29863	42	0	2	1	0	45
29864	1	0	42	1	0	44
29865	21	0	2	1	0	24
29866	23	1	0	0	0	24
29867	1	0	0	22	0	23
29868	1	0	24	0	0	25
29869	15	0	0	0	0	15
29870	0	16	0	0	0	16
29871	16	0	1	0	0	17
29872	22	2	0	1	0	25
29873	77	2	2	0	0	81
29874	195	0	0	0	0	195
29875	177	0	0	0	0	177
29876	203	0	0	0	0	203
29877	193	0	0	0	0	193
29878	188	0	0	0	0	188
29879	213	0	0	0	0	213
29880	214	0	0	0	0	214
29881	187	0	0	0	0	187
29882	188	0	0	0	0	188
29883	208	0	0	0	0	208
29884	179	0	0	0	0	179
29885	183	0	0	0	0	183
29886	208	0	0	0	0	208
29887	204	0	0	0	0	204
29888	172	0	0	0	0	172
29889	175	0	0	0	0	175
29890	194	0	0	0	0	194
29891	172	0	0	0	0	172
29892	196	0	0	0	0	196
29893	200	0	0	0	0	200
29894	211	0	0	0	0	211
29895	214	0	0	0	0	214
29896	206	0	0	0	0	206
29897	199	0	0	0	0	199
29898	193	0	0	0	0	193
29899	209	0	0	0	0	209
29900	207	0	0	0	0	207
29901	199	0	0	0	0	199
29902	188	0	1	0	0	189
29903	142	0	41	0	0	183
