Pos	A	C	G	T	Other	Total
1	0	0	0	0	0	0
2	0	0	0	9	0	9
3	0	0	0	9	0	9
4	16	0	0	0	0	16
5	34	0	0	0	0	34
6	37	0	0	0	0	37
7	0	0	42	0	0	42
8	0	0	40	0	0	40
9	0	0	0	44	0	44
10	0	0	0	50	0	50
11	0	0	0	78	0	78
12	141	0	0	2	0	143
13	0	0	0	275	0	275
14	554	0	0	14	0	568
15	0	748	0	1	0	749
16	1	1336	0	1	0	1338
17	22	6	1	4511	0	4540
18	13	1	0	5070	0	5084
19	8	8304	3	23	0	8338
20	8	9615	2	5	0	9630
21	4	11941	5	90	0	12040
22	13724	4	5	159	0	13892
23	14	9	14361	3	0	14387
24	8	13	14622	3	0	14646
25	26	1	2	16359	0	16388
26	17668	0	5	117	0	17790
27	17852	1	1	84	0	17938
28	1	18004	5	18	0	18028
29	20672	2	1	141	0	20816
30	22263	3	15	154	0	22435
31	22847	1	2	120	0	22970
32	13	23165	8	19	0	23205
33	3	24018	9	10	0	24040
34	25217	3	1	106	0	25327
35	25745	3	2	100	0	25850
36	8	26343	9	24	0	26384
37	15	28915	9	28	0	28967
38	29235	13	5	139	0	29392
39	29280	5	9	84	0	29378
40	8	29559	10	34	0	29611
41	29	11	3	30869	0	30912
42	36	2	8	31066	0	31112
43	26	3	5	30968	0	31002
44	9	30718	10	21	0	30758
45	23	37	30443	5	0	30508
46	28336	14	16	60	0	28426
47	25	2	1	31601	0	31629
48	5	31597	13	21	0	31636
49	21	16	0	32126	0	32163
50	8	32103	12	22	0	32145
51	27	22	7	32207	0	32263
52	33	6	2	32758	0	32799
53	10	33	32988	16	0	33047
54	39	22	18	32312	0	32391
55	32858	6	6	86	0	32956
56	30	21	32621	2	0	32674
57	31472	8	22	84	0	31586
58	37	7	4	33445	0	33493
59	1	33413	16	33	0	33463
60	27	21	3	33768	0	33819
61	14	26	33793	33	0	33866
62	48	16	23	32908	0	32995
63	33	8	8	33892	0	33941
64	6	34293	19	51	0	34369
65	20	27	5	34836	0	34888
66	28	34298	11	61	0	34398
67	18	28	10	34934	0	34990
68	34713	7	9	148	0	34877
69	33752	13	8	139	0	33912
70	34118	9	12	133	0	34272
71	74	34987	25	35	0	35121
72	30	53	34269	27	0	34379
73	32982	18	41	139	0	33180
74	35746	16	16	107	0	35885
75	87	36639	33	45	0	36804
76	109	110	9	33648	0	33876
77	72	48	5	34025	0	34150
78	94	30	25	32051	0	32200
79	32819	12	14	406	0	33251
80	32826	18	4	247	0	33095
81	32813	21	8	199	0	33041
82	33341	18	18	154	0	33531
83	300	15	3	33302	0	33620
84	127	33237	16	186	0	33566
85	124	189	7	34168	0	34488
86	83	95	34153	233	0	34564
87	166	36	199	34539	0	34940
88	87	47	35553	338	0	36025
89	151	52	288	35156	0	35647
90	67	62	36133	387	0	36649
91	75	45	34973	193	0	35286
92	66	36651	402	143	0	37262
93	208	310	128	37850	0	38496
94	106	132	39266	369	0	39873
95	203	57	374	38311	0	38945
96	103	39058	171	401	0	39733
97	39248	355	87	381	0	40071
98	384	41020	84	117	0	41605
99	209	415	75	40475	0	41174
100	76	41274	125	395	0	41870
101	68	415	40025	273	0	40781
102	76	196	39323	180	0	39775
103	76	40219	510	231	0	41036
104	172	403	251	41105	0	41931
105	119	175	41331	436	0	42061
106	73	40862	454	237	0	41626
107	40759	412	208	350	0	41729
108	456	227	187	41269	0	42139
109	151	158	42344	497	0	43150
110	74	42365	474	257	0	43170
111	187	486	193	42705	0	43571
112	159	244	141	42853	0	43397
113	41634	179	128	780	0	42721
114	409	180	42291	268	0	43148
115	251	158	512	41992	0	42913
116	103	170	42148	459	0	42880
117	74	39723	512	244	0	40553
118	38426	464	219	391	0	39500
119	373	37586	234	180	0	38373
120	216	537	150	36148	0	37051
121	166	35359	151	424	0	36100
122	33706	521	134	381	0	34742
123	422	34092	156	224	0	34894
124	180	561	32945	145	0	33831
125	92	33057	464	212	0	33825
126	31624	507	234	300	0	32665
127	501	284	32716	178	0	33679
128	285	169	553	32541	0	33548
129	31322	186	244	640	0	32392
130	547	157	204	30097	0	31005
131	30107	216	147	664	0	31134
132	30417	145	130	350	0	31042
133	689	218	156	29757	0	30820
134	325	182	125	29647	0	30279
135	28748	222	115	768	0	29853
136	28339	184	98	394	0	29015
137	774	184	97	26981	0	28036
138	26946	175	166	642	0	27929
139	27124	176	134	377	0	27811
140	702	26898	113	266	0	27979
141	406	519	168	26855	0	27948
142	26991	239	122	727	0	28079
143	27506	174	108	375	0	28163
144	786	138	106	27233	0	28263
145	465	133	86	27748	0	28432
146	27335	109	113	800	0	28357
147	659	27554	106	438	0	28757
148	422	511	96	27493	0	28522
149	355	229	27339	669	0	28592
150	402	164	479	26568	0	27613
151	293	26924	202	690	0	28109
152	317	497	26797	394	0	28005
153	378	208	481	26398	0	27465
154	378	192	197	25484	0	26251
155	297	166	26600	769	0	27832
156	24915	132	501	520	0	26068
157	646	26873	227	331	0	28077
158	26908	524	149	419	0	28000
159	687	274	26576	324	0	27861
160	386	161	26694	307	0	27548
161	25233	180	607	354	0	26374
162	657	26847	250	300	0	28054
163	26678	545	197	335	0	27755
164	618	26842	181	298	0	27939
165	328	639	26631	266	0	27864
166	25970	272	571	302	0	27115
167	657	219	27338	257	0	28471
168	363	161	560	26993	0	28077
169	27201	135	283	727	0	28346
170	27059	166	206	415	0	27846
171	704	26680	194	247	0	27825
172	453	904	180	25628	0	27165
173	297	26126	206	537	0	27166
174	247	509	25635	273	0	26664
175	350	392	506	23799	0	25047
176	231	23553	231	429	0	24444
177	266	426	151	23503	0	24346
178	22463	166	130	462	0	23221
179	444	143	117	22816	0	23520
180	273	22902	118	399	0	23692
181	229	354	117	23109	0	23809
182	213	175	118	22995	0	23501
183	210	22874	107	416	0	23607
184	225	348	125	22990	0	23688
185	202	127	22472	400	0	23201
186	189	22104	296	171	0	22760
187	20493	246	94	210	0	21043
188	302	134	20987	122	0	21545
189	169	90	20374	106	0	20739
190	131	20279	233	107	0	20750
191	256	283	205	19566	0	20310
192	115	86	19350	220	0	19771
193	135	15294	206	144	0	15779
194	152	158	72	17322	0	17704
195	115	94	56	17787	0	18052
196	17558	70	49	262	0	17939
197	183	17737	46	121	0	18087
198	93	175	16617	117	0	17002
199	82	99	17122	107	0	17410
200	99	78	199	17124	0	17500
201	130	72	76	22176	0	22454
202	109	77	58	22577	0	22821
203	81	25935	70	613	0	26699
204	70	658	26468	281	0	27477
205	172	282	645	26304	0	27403
206	57	27150	280	721	0	28208
207	52	29263	159	358	0	29832
208	56	1003	29684	214	0	30957
209	151	420	852	28555	0	29978
210	80	238	31689	865	0	32872
211	163	144	999	31165	0	32471
212	156	108	461	32596	0	33321
213	91	122	32095	1256	0	33564
214	58	31854	1005	599	0	33516
215	31284	904	471	450	0	33109
216	870	465	32457	263	0	34055
217	363	32195	1006	232	0	33796
218	214	33858	491	246	0	34809
219	123	1329	32688	192	0	34332
220	31605	639	1070	269	0	33583
221	1069	421	543	29654	0	31687
222	408	32722	368	860	0	34358
223	32601	1091	295	488	0	34475
224	1124	576	268	31064	0	33032
225	461	32165	255	1049	0	33930
226	32385	1095	256	660	0	34396
227	995	587	31620	357	0	33559
228	481	31884	1041	308	0	33714
229	31035	1102	564	301	0	33002
230	966	31607	361	221	0	33155
231	31048	1235	287	250	0	32820
232	1162	679	260	29808	0	31909
233	542	30417	303	922	0	32184
234	405	1076	258	30794	0	32533
235	30359	604	244	1262	0	32469
236	1008	444	29949	629	0	32030
237	554	394	30721	416	0	32085
238	489	357	1353	29450	0	31649
239	411	361	663	30185	0	31620
240	376	350	433	29564	0	30723
241	259	29410	376	1376	0	31421
242	275	1111	28997	711	0	31094
243	362	660	1070	27616	0	29708
244	287	27589	597	1054	0	29527
245	322	29504	384	581	0	30791
246	339	1354	28919	396	0	31008
247	292	799	28840	364	0	30295
248	334	598	29972	306	0	31210
249	357	434	1536	28966	0	31293
250	294	429	29883	1075	0	31681
251	357	369	1339	29773	0	31838
252	288	371	30470	1232	0	32361
253	28436	367	1318	792	0	30913
254	1074	31308	703	560	0	33645
255	573	34042	510	462	0	35587
256	416	1598	34852	429	0	37295
257	34059	837	1382	495	0	36773
258	35742	603	709	442	0	37496
259	35941	436	592	444	0	37413
260	1738	424	34526	389	0	37077
261	861	372	35599	393	0	37225
262	543	382	1805	34760	0	37490
263	35185	391	1002	1475	0	38053
264	35651	434	677	915	0	37677
265	1659	442	34743	611	0	37455
266	34671	451	1602	600	0	37324
267	1611	464	1018	34213	0	37306
268	810	475	35092	1502	0	37879
269	535	467	35530	816	0	37348
270	33141	416	2058	729	0	36344
271	1368	401	35708	564	0	38041
272	34540	356	1970	591	0	37457
273	1619	384	35744	533	0	38280
274	921	33877	1961	499	0	37258
275	670	36138	1225	473	0	38506
276	723	1721	982	33680	0	37106
277	663	956	813	36244	0	38676
278	610	666	35622	1723	0	38621
279	667	549	1819	34062	0	37097
280	683	33674	1170	1574	0	37101
281	770	34890	869	888	0	37417
282	727	36496	850	601	0	38674
283	892	1897	744	35098	0	38631
284	663	1004	35551	1439	0	38657
285	688	749	35958	812	0	38207
286	781	638	2070	34811	0	38300
287	800	560	1137	35616	0	38113
288	826	560	934	33467	0	35787
289	760	35065	711	1753	0	38289
290	35184	1467	685	1112	0	38448
291	35314	859	721	794	0	37688
292	1909	35200	675	695	0	38479
293	1054	1536	35676	651	0	38917
294	35916	875	1665	655	0	39111
295	1702	673	36875	559	0	39809
296	36103	575	1838	608	0	39124
297	36846	553	1082	663	0	39144
298	36358	566	813	660	0	38397
299	35513	485	744	802	0	37544
300	1943	35077	698	841	0	38559
301	29741	974	486	653	0	31854
302	1223	29724	500	569	0	32016
303	25727	888	456	394	0	27465
304	966	25442	394	332	0	27134
305	542	760	24356	249	0	25907
306	488	1491	736	21666	0	24381
307	383	22752	514	609	0	24258
308	384	23002	380	351	0	24117
309	21848	816	685	455	0	23804
310	20458	290	243	240	0	21231
311	706	21009	206	174	0	22095
312	422	471	239	19963	0	21095
313	366	21662	197	418	0	22643
314	21954	523	192	197	0	22866
315	674	248	21811	145	0	22878
316	426	265	572	20745	0	22008
317	366	147	298	20964	0	21775
318	327	189	248	21218	0	21982
319	280	173	20933	574	0	21960
320	308	20080	539	264	0	21191
321	300	21465	253	191	0	22209
322	310	623	227	21540	0	22700
323	287	303	21905	486	0	22981
324	266	292	523	21471	0	22552
325	253	279	258	22182	0	22972
326	255	252	212	22087	0	22806
327	265	245	176	22093	0	22779
328	21549	201	210	703	0	22663
329	504	21751	219	391	0	22865
330	21599	570	227	344	0	22740
331	583	304	21601	281	0	22769
332	292	267	21692	240	0	22491
333	304	244	569	21156	0	22273
334	240	243	295	21578	0	22356
335	199	22001	249	672	0	23121
336	171	526	22285	393	0	23375
337	180	22362	583	363	0	23488
338	166	566	22699	319	0	23750
339	20888	255	563	367	0	22073
340	521	22811	259	299	0	23890
341	289	551	22910	246	0	23996
342	319	283	535	22487	0	23624
343	211	299	22929	541	0	23980
344	213	22877	535	297	0	23922
345	230	556	286	22245	0	23317
346	223	22762	249	594	0	23828
347	237	563	22749	322	0	23871
348	288	245	488	22130	0	23151
349	22151	248	214	582	0	23195
350	595	21980	206	249	0	23030
351	287	564	21396	197	0	22444
352	264	575	458	20193	0	21490
353	205	234	21012	442	0	21893
354	141	180	18434	167	0	18922
355	112	17497	450	130	0	18189
356	172	193	139	15992	0	16496
357	53	108	69	16227	0	16457
358	62	89	70	15975	0	16196
359	48	65	16300	242	0	16655
360	46	53	16083	91	0	16273
361	14584	49	214	112	0	14959
362	174	63	15978	58	0	16273
363	14819	43	176	88	0	15126
364	168	15712	92	57	0	16029
365	67	174	68	15238	0	15547
366	41	15816	50	169	0	16076
367	19	16246	60	80	0	16405
368	36	179	15860	63	0	16138
369	53	80	167	15518	0	15818
370	36	72	15938	179	0	16225
371	31	43	14832	77	0	14983
372	14575	38	186	105	0	14904
373	151	39	15740	56	0	15986
374	43	40	15275	67	0	15425
375	14594	32	181	99	0	14906
376	132	48	15489	74	0	15743
377	50	44	16053	52	0	16199
378	69	57	175	15245	0	15546
379	43	16151	87	137	0	16418
380	35	147	83	16375	0	16640
381	36	52	85	15997	0	16170
382	16308	40	64	227	0	16639
383	153	44	63	16100	0	16360
384	59	16629	66	168	0	16922
385	16376	161	81	107	0	16725
386	159	81	16450	68	0	16758
387	15521	62	191	105	0	15879
388	189	44	17608	73	0	17914
389	75	49	17867	57	0	18048
390	33	18607	282	67	0	18989
391	18767	229	104	93	0	19193
392	215	18986	100	77	0	19378
393	69	254	18759	55	0	19137
394	113	78	246	17124	0	17561
395	35	19079	104	221	0	19439
396	19391	252	92	96	0	19831
397	19379	85	73	102	0	19639
398	290	19498	85	58	0	19931
399	20050	279	69	59	0	20457
400	282	96	93	19489	0	19960
401	80	20020	89	284	0	20473
402	82	276	92	20898	0	21348
403	80	94	94	22295	0	22563
404	22666	85	72	359	0	23182
405	22286	80	70	159	0	22595
406	22283	50	72	104	0	22509
407	387	80	22139	58	0	22664
408	21506	42	318	66	0	21932
409	365	143	137	22299	0	22944
410	128	57	22361	285	0	22831
411	102	55	21115	109	0	21381
412	68	21624	357	101	0	22150
413	20285	245	135	85	0	20750
414	237	20742	51	74	0	21104
415	139	235	28	20849	0	21251
416	103	78	38	21188	0	21407
417	88	45	21416	276	0	21825
418	107	41	249	20367	0	20764
419	67	22	21519	276	0	21884
420	52	26	20367	95	0	20540
421	45	21291	258	74	0	21668
422	97	193	98	20892	0	21280
423	79	72	48	20876	0	21075
424	20895	42	37	259	0	21233
425	232	41	20799	92	0	21164
426	110	27	206	21189	0	21532
427	21460	23	91	269	0	21843
428	223	21	21577	103	0	21924
429	21039	29	244	91	0	21403
430	21714	41	107	73	0	21935
431	294	51	22276	43	0	22664
432	152	48	246	21874	0	22320
433	97	51	93	22327	0	22568
434	75	39	22849	294	0	23257
435	22078	32	258	172	0	22540
436	23070	36	136	111	0	23353
437	22486	39	102	94	0	22721
438	22774	52	108	79	0	23013
439	22410	78	108	86	0	22682
440	378	107	17750	198	0	18433
441	162	82	22364	91	0	22699
442	126	22735	280	94	0	23235
443	111	250	23074	90	0	23525
444	128	116	283	22540	0	23067
445	341	137	216	15281	0	15975
446	160	73	95	23112	0	23440
447	169	69	76	23451	0	23765
448	190	63	23323	328	0	23904
449	167	22559	260	161	0	23147
450	144	23522	133	138	0	23937
451	168	318	94	22994	0	23574
452	116	24297	87	287	0	24787
453	24358	279	92	205	0	24934
454	24161	118	82	174	0	24535
455	455	25094	83	138	0	25770
456	273	268	84	25224	0	25849
457	215	107	110	25815	0	26247
458	166	72	25793	425	0	26456
459	23249	71	357	256	0	23933
460	25932	86	205	160	0	26383
461	443	26354	154	131	0	27082
462	26789	371	109	192	0	27461
463	459	173	27248	146	0	28026
464	237	26670	384	179	0	27470
465	178	27772	177	180	0	28307
466	146	28219	149	184	0	28698
467	189	494	132	28000	0	28815
468	27844	198	138	538	0	28718
469	541	120	146	28260	0	29067
470	302	109	28558	538	0	29507
471	268	121	534	28353	0	29276
472	217	133	29375	592	0	30317
473	227	134	573	28127	0	29061
474	240	152	269	27584	0	28245
475	171	28965	221	575	0	29932
476	29556	531	187	342	0	30616
477	598	225	183	28580	0	29586
478	292	29152	170	584	0	30198
479	29281	535	159	348	0	30323
480	24047	236	230	386	0	24899
481	29403	164	183	303	0	30053
482	618	29115	215	256	0	30204
483	288	519	29177	237	0	30221
484	221	254	581	29177	0	30233
485	264	276	250	28158	0	28948
486	243	29179	173	703	0	30298
487	228	477	28804	307	0	29816
488	215	190	28010	244	0	28659
489	26714	140	569	232	0	27655
490	573	242	248	27264	0	28327
491	263	121	27836	517	0	28737
492	203	28419	439	290	0	29351
493	267	450	207	27075	0	27999
494	217	28585	183	404	0	29389
495	195	435	28116	223	0	28969
496	26153	193	451	252	0	27049
497	27871	122	220	218	0	28431
498	553	27972	157	190	0	28872
499	280	433	118	27641	0	28472
500	228	185	27674	435	0	28522
501	192	27062	433	206	0	27893
502	26320	417	180	211	0	27128
503	413	25119	106	129	0	25767
504	160	25344	75	80	0	25659
505	152	430	110	24680	0	25372
506	86	25149	99	339	0	25673
507	24985	401	93	194	0	25673
508	400	191	76	24747	0	25414
509	138	135	23976	347	0	24596
510	101	143	22544	142	0	22930
511	125	161	353	22866	0	23505
512	78	23364	149	311	0	23902
513	23455	355	99	165	0	24074
514	366	156	77	22958	0	23557
515	146	125	22776	349	0	23396
516	123	120	330	22568	0	23141
517	96	106	141	22754	0	23097
518	22216	133	96	442	0	22887
519	347	103	82	22266	0	22798
520	154	122	21932	356	0	22564
521	137	104	21711	154	0	22106
522	126	100	352	22413	0	22991
523	104	88	167	23044	0	23403
524	84	106	23440	412	0	24042
525	20459	84	350	318	0	21211
526	350	94	23050	166	0	23660
527	144	22724	372	132	0	23372
528	122	324	161	23062	0	23669
529	85	127	23188	404	0	23804
530	90	108	22543	197	0	22938
531	120	82	398	21994	0	22594
532	22266	63	197	425	0	22951
533	318	82	22589	187	0	23176
534	110	22389	367	147	0	23013
535	22606	310	171	216	0	23303
536	337	121	23060	142	0	23660
537	21866	75	358	188	0	22487
538	22989	73	184	181	0	23427
539	401	23820	163	128	0	24512
540	172	309	138	22605	0	23224
541	112	23229	125	325	0	23791
542	123	354	23161	151	0	23789
543	22700	131	374	176	0	23381
544	23704	103	184	163	0	24154
545	421	96	23796	112	0	24425
546	186	92	23214	98	0	23590
547	123	24436	438	96	0	25093
548	24898	383	196	105	0	25582
549	464	156	133	24749	0	25502
550	212	89	144	23677	0	24122
551	127	24483	122	367	0	25099
552	24054	362	105	199	0	24720
553	381	167	24695	114	0	25357
554	186	105	367	26729	0	27387
555	26947	83	174	604	0	27808
556	598	27394	124	185	0	28301
557	207	578	29076	94	0	29955
558	163	194	29680	75	0	30112
559	198	350	806	28166	0	29520
560	81	29625	267	613	0	30586
561	107	703	29925	163	0	30898
562	154	202	702	29087	0	30145
563	29762	103	194	759	0	30818
564	696	88	30783	178	0	31745
565	217	152	786	30312	0	31467
566	131	67	31093	759	0	32050
567	113	63	31615	164	0	31955
568	192	233	897	30863	0	32185
569	114	48	31884	746	0	32792
570	26461	64	796	327	0	27648
571	655	63	31060	110	0	31888
572	28406	31	743	164	0	29344
573	677	30121	269	98	0	31165
574	30938	640	136	181	0	31895
575	665	31681	161	85	0	32592
576	269	671	124	31473	0	32537
577	183	193	128	32787	0	33291
578	134	94	32143	817	0	33188
579	83	96	32229	291	0	32699
580	146	50	880	32431	0	33507
581	92	72	33208	742	0	34114
582	141	65	871	31309	0	32386
583	94	31647	348	727	0	32816
584	136	33493	251	270	0	34150
585	187	822	239	32658	0	33906
586	154	257	156	33248	0	33815
587	106	202	32820	875	0	34003
588	175	147	761	31812	0	32895
589	127	31677	270	816	0	32890
590	81	32061	227	344	0	32713
591	95	32816	220	272	0	33403
592	111	841	214	30524	0	31690
593	77	31229	258	740	0	32304
594	30816	770	247	368	0	32201
595	735	269	231	30888	0	32123
596	227	182	30783	871	0	32063
597	160	207	840	30406	0	31613
598	150	178	31043	890	0	32261
599	101	199	30894	383	0	31577
600	146	158	31452	283	0	32039
601	113	31430	981	309	0	32833
602	119	750	31956	250	0	33075
603	31112	305	906	300	0	32623
604	32131	243	369	259	0	33002
605	32674	249	282	267	0	33472
606	923	187	279	32181	0	33570
607	32057	194	242	928	0	33421
608	816	31004	272	375	0	32467
609	333	33002	252	311	0	33898
610	32682	856	281	379	0	34198
611	830	330	33520	277	0	34957
612	307	259	889	33249	0	34704
613	216	208	34242	859	0	35525
614	181	231	34272	369	0	35053
615	158	34414	1033	281	0	35886
616	238	853	464	31918	0	33473
617	200	334	388	35174	0	36096
618	34499	241	306	1057	0	36103
619	831	34465	256	456	0	36008
620	370	35469	283	403	0	36525
621	351	996	35037	359	0	36743
622	270	35850	866	312	0	37298
623	34987	1000	476	398	0	36861
624	34925	425	477	361	0	36188
625	894	324	36026	336	0	37580
626	322	347	36298	350	0	37317
627	298	282	1233	34256	0	36069
628	281	263	662	34635	0	35841
629	256	35134	485	1017	0	36892
630	336	925	437	34824	0	36522
631	333	350	409	35249	0	36341
632	271	35166	422	1154	0	37013
633	325	886	421	35147	0	36779
634	265	409	434	34191	0	35299
635	250	33692	475	1119	0	35536
636	258	902	33790	501	0	35451
637	355	383	1035	34314	0	36087
638	34559	340	508	1031	0	36438
639	33951	357	460	432	0	35200
640	1109	343	33552	354	0	35358
641	32343	353	901	486	0	34083
642	33962	342	378	477	0	35159
643	980	33660	324	497	0	35461
644	390	882	32680	470	0	34422
645	243	427	32977	458	0	34105
646	248	469	1034	35161	0	36912
647	35583	275	538	1132	0	37528
648	37423	264	410	518	0	38615
649	1125	318	327	39400	0	41170
650	42048	314	297	1212	0	43871
651	43284	293	339	565	0	44481
652	40917	294	320	572	0	42103
653	1335	301	39906	400	0	41942
654	529	177	39545	278	0	40529
655	38577	128	887	368	0	39960
656	898	148	39813	215	0	41074
657	299	37927	660	127	0	39013
658	322	587	449	37402	0	38760
659	157	208	39471	534	0	40370
660	167	133	38497	222	0	39019
661	264	216	674	37235	0	38389
662	158	64	38660	547	0	39429
663	152	77	37254	225	0	37708
664	154	33544	609	191	0	34498
665	146	37013	233	85	0	37477
666	37275	537	199	115	0	38126
667	571	206	120	36537	0	37434
668	36783	88	110	506	0	37487
669	539	68	36121	138	0	36866
670	260	80	488	35552	0	36380
671	147	68	190	36792	0	37197
672	36022	51	137	651	0	36861
673	474	36397	126	265	0	37262
674	227	478	32853	171	0	33729
675	218	174	34757	95	0	35244
676	107	35690	580	104	0	36481
677	111	478	35421	77	0	36087
678	95	35296	512	70	0	35973
679	120	33255	207	80	0	33662
680	168	548	33933	70	0	34719
681	32217	188	503	101	0	33009
682	530	102	186	34324	0	35142
683	178	34975	136	484	0	35773
684	166	417	127	34900	0	35610
685	34939	147	103	562	0	35751
686	34404	104	85	255	0	34848
687	34221	70	138	171	0	34600
688	592	66	33715	85	0	34458
689	270	96	483	32644	0	33493
690	110	33968	222	401	0	34701
691	35565	452	149	256	0	36422
692	519	191	99	35844	0	36653
693	316	135	107	34789	0	35347
694	184	79	121	36754	0	37138
695	146	89	36434	664	0	37333
696	32872	90	471	399	0	33832
697	565	36461	197	171	0	37394
698	308	462	145	36527	0	37442
699	263	151	129	36772	0	37315
700	35754	119	129	683	0	36685
701	597	124	33049	270	0	34040
702	257	83	35933	155	0	36428
703	173	35830	641	165	0	36809
704	131	554	36933	118	0	37736
705	34012	203	654	226	0	35095
706	542	36274	273	185	0	37274
707	218	568	36076	155	0	37017
708	33947	221	595	215	0	34978
709	603	160	38213	141	0	39117
710	273	38507	641	142	0	39563
711	281	566	269	38398	0	39514
712	252	231	178	39264	0	39925
713	217	176	38416	706	0	39515
714	217	137	36889	307	0	37550
715	201	37650	746	202	0	38799
716	37081	563	352	249	0	38245
717	599	38598	295	166	0	39658
718	330	632	208	38514	0	39684
719	214	280	38455	623	0	39572
720	34599	188	736	334	0	35857
721	706	187	328	37155	0	38376
722	289	36551	306	587	0	37733
723	161	38548	282	284	0	39275
724	187	749	229	38411	0	39576
725	196	331	222	39010	0	39759
726	38344	220	251	813	0	39628
727	671	197	222	39383	0	40473
728	282	228	39355	755	0	40620
729	38213	155	725	444	0	39537
730	40053	180	300	316	0	40849
731	814	199	40342	265	0	41620
732	39666	151	756	267	0	40840
733	877	158	310	42095	0	43440
734	422	196	238	42710	0	43566
735	318	208	201	43210	0	43937
736	312	173	184	41823	0	42492
737	179	42643	209	1026	0	44057
738	43514	790	220	499	0	45023
739	44558	320	205	376	0	45459
740	1067	246	44040	323	0	45676
741	45447	188	800	361	0	46796
742	48097	190	321	308	0	48916
743	48431	195	244	326	0	49196
744	49416	160	267	264	0	50107
745	1356	48448	215	226	0	50245
746	573	1053	118	45798	0	47542
747	334	280	46122	927	0	47663
748	283	198	42520	360	0	43361
749	38582	554	1200	377	0	40713
750	39821	176	537	194	0	40728
751	838	38537	138	151	0	39664
752	39157	601	117	177	0	40052
753	791	39110	97	95	0	40093
754	400	687	77	39148	0	40312
755	40042	213	111	766	0	41132
756	39312	137	124	307	0	39880
757	39312	97	70	249	0	39728
758	952	38709	80	145	0	39886
759	38505	659	82	156	0	39402
760	926	228	72	38613	0	39839
761	39463	127	84	729	0	40403
762	883	125	38230	215	0	39453
763	406	38561	682	151	0	39800
764	38710	651	200	167	0	39728
765	876	224	38926	99	0	40125
766	475	185	654	38282	0	39596
767	308	142	39243	656	0	40349
768	298	120	38263	246	0	38927
769	371	158	779	38512	0	39820
770	269	122	39818	681	0	40890
771	346	118	732	39183	0	40379
772	309	138	253	39879	0	40579
773	40613	97	193	909	0	41812
774	856	40219	162	343	0	41580
775	366	40651	180	238	0	41435
776	296	41892	195	172	0	42555
777	295	877	41903	178	0	43253
778	389	307	794	41015	0	42505
779	255	191	42586	815	0	43847
780	39624	146	850	400	0	41020
781	41933	141	305	301	0	42680
782	971	42292	253	197	0	43713
783	475	796	205	41469	0	42945
784	295	42813	219	737	0	44064
785	42873	836	202	354	0	44265
786	956	293	187	42845	0	44281
787	382	227	42754	907	0	44270
788	282	41936	867	362	0	43447
789	314	838	42946	237	0	44335
790	332	349	896	42348	0	43925
791	249	242	42206	912	0	43609
792	39240	216	934	468	0	40858
793	950	243	42018	277	0	43488
794	424	42330	915	266	0	43935
795	381	880	381	42222	0	43864
796	354	369	280	43428	0	44431
797	42526	285	254	1093	0	44158
798	42812	222	261	508	0	43803
799	1045	42106	272	351	0	43774
800	495	853	41740	256	0	43344
801	419	342	40960	255	0	41976
802	40334	274	1045	305	0	41958
803	993	262	41632	263	0	43150
804	460	244	40092	264	0	41060
805	379	225	40138	260	0	41002
806	368	236	40235	232	0	41071
807	342	40645	1149	253	0	42389
808	40968	893	550	317	0	42728
809	1009	404	425	39912	0	41750
810	39815	266	378	939	0	41398
811	1033	39278	399	379	0	41089
812	39306	908	373	360	0	40947
813	1017	40464	385	255	0	42121
814	559	946	408	39871	0	41784
815	371	42815	366	855	0	44407
816	419	1053	42190	341	0	44003
817	348	43461	1086	319	0	45214
818	429	1061	494	47373	0	49357
819	47738	465	418	1126	0	49747
820	1269	370	342	47699	0	49680
821	594	362	47589	1140	0	49685
822	546	314	1154	45650	0	47664
823	351	47394	512	1173	0	49430
824	375	1144	47346	452	0	49317
825	46577	517	1205	439	0	48738
826	1257	369	577	48491	0	50694
827	46852	321	433	1232	0	48838
828	47365	317	398	664	0	48744
829	1297	47367	446	551	0	49661
830	45409	1091	374	539	0	47413
831	48226	525	389	459	0	49599
832	1365	47768	396	349	0	49878
833	745	1054	338	47402	0	49539
834	525	478	377	47229	0	48609
835	398	47183	310	1293	0	49184
836	496	1063	292	48057	0	49908
837	351	528	47325	1156	0	49360
838	514	556	996	46442	0	48508
839	424	306	46170	1139	0	48039
840	342	276	42483	495	0	43596
841	314	42464	1044	465	0	44287
842	277	42584	490	363	0	43714
843	295	44437	402	315	0	45449
844	505	1064	295	42400	0	44264
845	206	483	43066	819	0	44574
846	41410	302	879	520	0	43111
847	923	212	427	43214	0	44776
848	333	264	43293	878	0	44768
849	295	276	42589	379	0	43539
850	220	43883	947	320	0	45370
851	272	976	431	43068	0	44747
852	43059	371	316	932	0	44678
853	748	42500	310	415	0	43973
854	334	42691	248	341	0	43614
855	245	42892	231	340	0	43708
856	238	1099	284	42851	0	44472
857	152	44653	282	862	0	45949
858	239	997	268	47279	0	48783
859	291	447	250	48316	0	49304
860	210	367	47103	1240	0	48920
861	41545	284	1003	701	0	43533
862	955	337	47251	311	0	48854
863	437	375	1038	46773	0	48623
864	256	292	47280	1060	0	48888
865	215	46798	1080	520	0	48613
866	46714	1057	512	541	0	48824
867	1052	494	350	45815	0	47711
868	488	334	275	47312	0	48409
869	46546	262	262	1366	0	48436
870	45985	233	292	671	0	47181
871	47286	219	251	546	0	48302
872	1280	278	46490	357	0	48405
873	43166	238	883	389	0	44676
874	1092	44370	368	296	0	46126
875	454	45647	260	381	0	46742
876	447	1129	238	44089	0	45903
877	408	476	207	43162	0	44253
878	303	43569	225	1147	0	45244
879	360	992	240	43755	0	45347
880	43104	407	218	1220	0	44949
881	957	338	43169	536	0	45000
882	422	42949	905	435	0	44711
883	41241	978	378	445	0	43042
884	868	42505	296	455	0	44124
885	446	1019	42349	331	0	44145
886	385	520	919	41967	0	43791
887	332	397	42365	1014	0	44108
888	330	41855	1008	444	0	43637
889	331	1023	433	41817	0	43604
890	285	503	41614	993	0	43395
891	291	391	41561	507	0	42750
892	344	351	1057	41910	0	43662
893	41510	311	525	1106	0	43452
894	41916	272	355	579	0	43122
895	41927	283	321	480	0	43011
896	1161	340	41941	384	0	43826
897	544	41900	921	336	0	43701
898	405	953	474	41746	0	43578
899	355	478	376	41089	0	42298
900	263	41993	299	1156	0	43711
901	41713	995	266	629	0	43603
902	1053	461	262	42129	0	43905
903	481	363	41957	1063	0	43864
904	309	41801	1032	549	0	43691
905	40666	969	479	587	0	42701
906	916	41538	436	467	0	43357
907	530	1050	375	40919	0	42874
908	477	499	340	41455	0	42771
909	434	344	375	41804	0	42957
910	357	321	41044	1296	0	43018
911	404	404	948	39484	0	41240
912	370	39207	507	1133	0	41217
913	378	39434	370	648	0	40830
914	342	1057	37564	493	0	39456
915	33556	479	817	597	0	35449
916	36738	353	348	539	0	37978
917	1031	35793	336	438	0	37598
918	31689	706	286	368	0	33049
919	31848	319	188	360	0	32715
920	847	32874	202	272	0	34195
921	410	849	213	33165	0	34637
922	333	367	34010	832	0	35542
923	314	311	32490	437	0	33552
924	32912	328	872	417	0	34529
925	768	33881	356	406	0	35411
926	446	757	263	33831	0	35297
927	322	377	262	34153	0	35114
928	337	330	196	34172	0	35035
929	33329	253	238	1027	0	34847
930	932	259	215	33294	0	34700
931	448	238	237	32926	0	33849
932	328	267	31473	880	0	32948
933	28551	191	699	511	0	29952
934	706	30926	313	341	0	32286
935	30560	680	218	401	0	31859
936	743	30215	252	252	0	31462
937	416	703	242	30072	0	31433
938	30242	269	213	826	0	31550
939	30766	241	204	429	0	31640
940	863	211	30065	287	0	31426
941	31064	205	614	353	0	32236
942	849	191	31403	308	0	32751
943	416	199	30357	240	0	31212
944	257	200	30340	309	0	31106
945	272	177	32917	291	0	33657
946	285	255	957	33418	0	34915
947	249	186	34053	884	0	35372
948	288	199	926	33437	0	34850
949	33486	172	405	1056	0	35119
950	947	217	302	33388	0	34854
951	32779	176	238	1107	0	34300
952	946	32606	211	483	0	34246
953	518	908	205	32848	0	34479
954	333	306	32265	998	0	33902
955	288	33896	841	475	0	35500
956	417	1048	352	32781	0	34598
957	246	254	33212	933	0	34645
958	128	31077	791	308	0	32304
959	91	32210	300	227	0	32828
960	232	848	31994	156	0	33230
961	192	454	839	30935	0	32420
962	84	185	31448	748	0	32465
963	29536	104	802	321	0	30763
964	31102	67	291	249	0	31709
965	859	30681	215	178	0	31933
966	30866	699	168	162	0	31895
967	910	254	124	30644	0	31932
968	333	180	30399	729	0	31641
969	28594	128	778	354	0	29854
970	816	101	29838	224	0	30979
971	264	29709	836	173	0	30982
972	30417	731	371	192	0	31711
973	894	278	212	30355	0	31739
974	283	207	30797	742	0	32029
975	30124	133	788	360	0	31405
976	30439	99	308	271	0	31117
977	30881	119	244	214	0	31458
978	1118	101	163	30113	0	31495
979	526	104	162	30901	0	31693
980	321	118	30411	943	0	31793
981	236	30152	792	401	0	31581
982	274	722	309	29779	0	31084
983	255	254	249	31147	0	31905
984	178	202	30576	949	0	31905
985	193	146	30500	411	0	31250
986	257	119	979	30499	0	31854
987	30013	91	481	932	0	31517
988	820	30307	324	413	0	31864
989	30334	743	308	344	0	31729
990	970	30479	228	261	0	31938
991	452	873	30376	208	0	31909
992	316	342	30890	264	0	31812
993	30188	233	1073	300	0	31794
994	34154	186	498	289	0	35127
995	1130	33924	388	329	0	35771
996	637	925	33371	277	0	35210
997	537	426	1037	33010	0	35010
998	464	327	497	32299	0	33587
999	325	33633	467	1203	0	35628
1000	337	1026	312	34122	0	35797
1001	324	461	34111	1257	0	36153
1002	33042	428	1023	694	0	35187
1003	34524	291	541	537	0	35893
1004	33865	270	455	429	0	35019
1005	35617	221	396	347	0	36581
1006	1680	191	34311	263	0	36445
1007	33987	192	1136	296	0	35611
1008	1581	177	34461	196	0	36415
1009	796	34079	1301	224	0	36400
1010	685	974	694	34759	0	37112
1011	35431	452	567	1130	0	37580
1012	1309	364	425	37013	0	39111
1013	658	294	37149	1360	0	39461
1014	36803	287	1192	719	0	39001
1015	38339	228	654	607	0	39828
1016	1749	224	498	37599	0	40070
1017	1034	193	398	38710	0	40335
1018	785	219	37508	1584	0	40096
1019	600	37913	1165	887	0	40565
1020	36604	1071	637	630	0	38942
1021	1338	528	34735	453	0	37054
1022	34130	374	1150	449	0	36103
1023	1434	35299	645	317	0	37695
1024	35383	1051	472	360	0	37266
1025	1498	34230	429	289	0	36446
1026	907	34555	340	291	0	36093
1027	839	1303	380	34761	0	37283
1028	627	719	320	35911	0	37577
1029	608	477	279	36295	0	37659
1030	523	364	314	36608	0	37809
1031	452	291	35290	1753	0	37786
1032	34159	263	1121	1059	0	36602
1033	36063	260	568	765	0	37656
1034	36964	238	479	585	0	38266
1035	1817	228	457	35602	0	38104
1036	1187	192	338	36498	0	38215
1037	36288	216	343	1520	0	38367
1038	36439	266	309	882	0	37896
1039	36628	270	260	743	0	37901
1040	1792	316	297	34695	0	37100
1041	1063	297	242	34343	0	35945
1042	809	236	33030	1410	0	35485
1043	640	218	32027	809	0	33694
1044	600	32508	1167	619	0	34894
1045	29551	961	935	610	0	32057
1046	29354	361	469	453	0	30637
1047	29583	317	257	443	0	30600
1048	1204	249	30160	351	0	31964
1049	29891	210	704	421	0	31226
1050	31003	152	385	427	0	31967
1051	31432	128	300	413	0	32273
1052	1386	88	270	30480	0	32224
1053	944	110	263	30391	0	31708
1054	807	107	218	30530	0	31662
1055	594	138	26215	1108	0	28055
1056	25074	114	441	718	0	26347
1057	868	26829	279	534	0	28510
1058	25150	464	192	379	0	26185
1059	830	24442	159	335	0	25766
1060	556	24926	163	283	0	25928
1061	585	656	176	24543	0	25960
1062	465	423	221	24289	0	25398
1063	368	24409	136	709	0	25622
1064	24328	543	140	501	0	25512
1065	24437	320	133	407	0	25297
1066	796	271	133	24145	0	25345
1067	584	177	24137	623	0	25521
1068	520	133	23022	438	0	24113
1069	474	125	24337	353	0	25289
1070	449	110	24458	249	0	25266
1071	23604	152	836	295	0	24887
1072	24214	83	432	230	0	24959
1073	814	98	316	23624	0	24852
1074	549	107	23308	586	0	24550
1075	461	103	503	23138	0	24205
1076	374	22835	295	666	0	24170
1077	354	25470	229	401	0	26454
1078	26200	579	166	402	0	27347
1079	26414	382	153	311	0	27260
1080	26684	279	144	314	0	27421
1081	828	233	164	26289	0	27514
1082	570	202	145	26831	0	27748
1083	501	183	135	26887	0	27706
1084	459	137	109	26676	0	27381
1085	407	110	26373	858	0	27748
1086	372	84	459	26581	0	27496
1087	27443	101	294	785	0	28623
1088	631	83	274	27739	0	28727
1089	469	84	234	27906	0	28693
1090	428	151	209	27569	0	28357
1091	312	26266	187	880	0	27645
1092	304	25895	176	585	0	26960
1093	255	26365	119	445	0	27184
1094	256	345	107	24099	0	24807
1095	204	137	65	24353	0	24759
1096	24303	84	55	476	0	24918
1097	24150	79	70	286	0	24585
1098	24340	86	50	256	0	24732
1099	425	99	77	24088	0	24689
1100	267	83	67	24016	0	24433
1101	215	23658	76	399	0	24348
1102	230	24569	51	211	0	25061
1103	24312	297	49	217	0	24875
1104	393	138	37	24092	0	24660
1105	23839	68	50	420	0	24377
1106	24090	52	63	283	0	24488
1107	406	76	74	23762	0	24318
1108	199	24605	71	330	0	25205
1109	24915	237	45	263	0	25460
1110	25173	114	32	227	0	25546
1111	399	87	25416	148	0	26050
1112	23349	52	153	123	0	23677
1113	228	24153	70	94	0	24545
1114	134	159	21	24798	0	25112
1115	27381	65	16	329	0	27791
1116	308	41	17	27329	0	27695
1117	173	31	32	27560	0	27796
1118	105	27533	27	307	0	27972
1119	27409	198	22	221	0	27850
1120	27515	99	15	163	0	27792
1121	321	27271	26	101	0	27719
1122	154	28359	28	78	0	28619
1123	28372	232	22	139	0	28765
1124	28072	128	14	110	0	28324
1125	326	90	27338	64	0	27818
1126	185	64	25244	93	0	25586
1127	137	69	27428	66	0	27700
1128	128	43	274	27912	0	28357
1129	128	41	124	28416	0	28709
1130	89	56	28368	279	0	28792
1131	27284	42	204	238	0	27768
1132	29091	52	97	168	0	29408
1133	29186	51	70	143	0	29450
1134	28680	45	40	115	0	28880
1135	363	61	30777	71	0	31272
1136	30679	45	209	182	0	31115
1137	31386	45	116	198	0	31745
1138	31314	49	73	201	0	31637
1139	31965	44	53	172	0	32234
1140	31771	58	43	186	0	32058
1141	372	66	32172	108	0	32718
1142	224	32099	200	109	0	32632
1143	237	239	107	31413	0	31996
1144	165	125	91	32969	0	33350
1145	145	116	32759	306	0	33326
1146	29880	75	222	267	0	30444
1147	345	53	107	31955	0	32460
1148	241	79	31474	248	0	32042
1149	217	60	29181	174	0	29632
1150	194	31710	277	162	0	32343
1151	201	198	150	32287	0	32836
1152	182	114	94	32597	0	32987
1153	164	105	66	32221	0	32556
1154	32573	76	65	419	0	33133
1155	335	69	67	32499	0	32970
1156	233	71	32247	310	0	32861
1157	235	70	28649	204	0	29158
1158	205	71	32829	147	0	33252
1159	229	62	323	33671	0	34285
1160	34334	76	182	347	0	34939
1161	337	76	34470	174	0	35057
1162	33432	52	269	234	0	33987
1163	37651	55	173	279	0	38158
1164	428	64	118	38412	0	39022
1165	313	50	108	38474	0	38945
1166	202	37985	97	378	0	38662
1167	167	226	38274	238	0	38905
1168	37106	123	248	275	0	37752
1169	345	103	148	39102	0	39698
1170	218	38861	128	270	0	39477
1171	229	211	95	39489	0	40024
1172	176	162	39368	297	0	40003
1173	217	120	249	38429	0	39015
1174	180	38977	150	300	0	39607
1175	187	199	139	38986	0	39511
1176	38691	120	114	382	0	39307
1177	329	88	113	37390	0	37920
1178	206	36234	137	303	0	36880
1179	174	37080	126	214	0	37594
1180	35498	268	113	292	0	36171
1181	291	158	36960	138	0	37547
1182	287	82	259	36370	0	36998
1183	217	73	147	37606	0	38043
1184	166	71	38016	349	0	38602
1185	144	37826	283	237	0	38490
1186	242	211	37864	156	0	38473
1187	178	192	260	36978	0	37608
1188	98	37732	149	209	0	38188
1189	38470	181	102	282	0	39035
1190	220	38305	104	125	0	38754
1191	118	38757	64	146	0	39085
1192	39240	244	108	218	0	39810
1193	39440	128	73	247	0	39888
1194	40050	80	56	214	0	40400
1195	311	47	60	40325	0	40743
1196	157	66	40456	196	0	40875
1197	39463	47	210	298	0	40018
1198	42459	38	122	228	0	42847
1199	414	45	80	43655	0	44194
1200	185	73	43596	310	0	44164
1201	106	42869	305	164	0	43444
1202	42829	299	117	213	0	43458
1203	43916	107	74	290	0	44387
1204	381	44293	66	84	0	44824
1205	137	45382	49	85	0	45653
1206	45344	361	54	199	0	45958
1207	45134	118	51	213	0	45516
1208	44655	89	49	140	0	44933
1209	475	60	37	44391	0	44963
1210	186	63	44542	315	0	45106
1211	204	63	287	43272	0	43826
1212	108	55	43889	333	0	44385
1213	92	42449	296	151	0	42988
1214	81	43283	120	88	0	43572
1215	155	272	83	39802	0	40312
1216	131	75	54	40524	0	40784
1217	169	58	34	39668	0	39929
1218	91	40505	49	290	0	40935
1219	40130	267	50	235	0	40682
1220	39632	109	61	222	0	40024
1221	330	40679	49	90	0	41148
1222	200	258	35	39612	0	40105
1223	124	39836	35	235	0	40230
1224	135	316	32	39718	0	40201
1225	107	39976	36	255	0	40374
1226	40001	259	42	240	0	40542
1227	354	87	33	39232	0	39706
1228	130	100	38746	270	0	39246
1229	37286	76	243	261	0	37866
1230	38205	66	92	274	0	38637
1231	309	102	38308	107	0	38826
1232	212	90	257	38203	0	38762
1233	97	131	38820	307	0	39355
1234	134	95	254	38930	0	39413
1235	91	118	36926	351	0	37486
1236	34746	97	269	269	0	35381
1237	331	122	77	36252	0	36782
1238	156	36780	76	301	0	37313
1239	37778	351	40	270	0	38439
1240	429	166	36	38383	0	39014
1241	213	117	35	38418	0	38783
1242	141	125	37999	461	0	38726
1243	199	89	350	40170	0	40808
1244	138	102	41855	547	0	42642
1245	159	114	42673	181	0	43127
1246	210	75	616	44407	0	45308
1247	122	104	47946	596	0	48768
1248	46982	88	712	385	0	48167
1249	55377	75	213	301	0	55966
1250	57119	69	148	372	0	57708
1251	1262	59813	139	186	0	61400
1252	718	1010	141	59649	0	61518
1253	561	400	117	57117	0	58195
1254	263	61218	136	1251	0	62868
1255	60977	1115	129	712	0	62933
1256	1276	454	91	60724	0	62545
1257	484	312	61905	1225	0	63926
1258	370	214	58303	555	0	59442
1259	236	59340	1405	444	0	61425
1260	59790	1121	585	426	0	61922
1261	1268	430	59570	293	0	61561
1262	55866	295	1282	456	0	57899
1263	1345	55035	593	296	0	57269
1264	576	1117	56100	272	0	58065
1265	446	461	51620	272	0	52799
1266	361	290	56196	205	0	57052
1267	300	54686	1606	301	0	56893
1268	337	1208	55536	197	0	57278
1269	53732	449	1473	299	0	55953
1270	1485	416	631	51583	0	54115
1271	729	257	421	55919	0	57326
1272	566	225	327	56423	0	57541
1273	547	243	259	56914	0	57963
1274	397	230	55835	1755	0	58217
1275	472	207	1337	55471	0	57487
1276	431	209	643	56649	0	57932
1277	55186	166	519	1814	0	57685
1278	56773	297	415	887	0	58372
1279	51631	213	422	758	0	53024
1280	1659	249	53986	435	0	56329
1281	808	55533	1308	402	0	58051
1282	497	58945	687	376	0	60505
1283	54744	1650	504	593	0	57491
1284	1379	57457	402	380	0	59618
1285	762	1559	466	56418	0	59205
1286	657	665	353	58137	0	59812
1287	355	484	56930	1823	0	59592
1288	379	56094	1568	871	0	58912
1289	361	1465	54794	635	0	57255
1290	54412	568	1619	677	0	57276
1291	57226	392	756	541	0	58915
1292	1871	306	608	56344	0	59129
1293	992	330	467	56082	0	57871
1294	708	258	438	56342	0	57746
1295	660	266	436	57281	0	58643
1296	439	284	55944	2210	0	58877
1297	541	397	1479	54921	0	57338
1298	382	243	55610	1802	0	58037
1299	339	252	53681	958	0	55230
1300	304	54145	1826	846	0	57121
1301	54187	1389	910	733	0	57219
1302	1511	55883	566	623	0	58583
1303	766	1640	477	54245	0	57128
1304	534	615	56483	1719	0	59351
1305	54596	447	1680	999	0	57722
1306	1675	372	55931	744	0	58722
1307	55927	306	1909	640	0	58782
1308	57309	295	913	609	0	59126
1309	2360	268	669	57919	0	61216
1310	1225	287	578	58073	0	60163
1311	883	369	551	58783	0	60586
1312	716	410	56570	2493	0	60189
1313	55319	409	1888	1281	0	58897
1314	1975	56035	790	964	0	59764
1315	1101	1754	688	56196	0	59739
1316	56726	706	542	2223	0	60197
1317	58037	613	630	1158	0	60438
1318	58517	467	558	956	0	60498
1319	2868	545	55223	788	0	59424
1320	57560	501	1908	857	0	60826
1321	58678	614	950	951	0	61193
1322	2687	461	47879	1127	0	52154
1323	1339	492	59305	837	0	61973
1324	1254	532	2421	58468	0	62675
1325	1019	381	60191	2209	0	63800
1326	692	56644	2705	1242	0	61283
1327	685	60436	1676	763	0	63560
1328	58314	2342	1259	737	0	62652
1329	2301	60576	908	583	0	64368
1330	1445	2187	973	60101	0	64706
1331	58198	1016	946	2234	0	62394
1332	2425	60534	729	1144	0	64832
1333	1162	2273	799	60184	0	64418
1334	941	839	1040	61720	0	64540
1335	839	638	59884	2905	0	64266
1336	869	555	2408	59826	0	63658
1337	811	579	59571	2766	0	63727
1338	828	406	59498	1547	0	62279
1339	1074	315	2411	57537	0	61337
1340	847	398	1152	59181	0	61578
1341	57079	335	796	3305	0	61515
1342	2248	61656	752	1772	0	66428
1343	1278	2035	646	59219	0	63178
1344	1042	1411	639	59609	0	62701
1345	56083	609	380	3188	0	60260
1346	2296	54089	486	1616	0	58487
1347	1278	50984	404	1102	0	53768
1348	891	48626	417	799	0	50733
1349	459	43938	397	519	0	45313
1350	37814	1794	1078	504	0	41190
1351	37581	708	369	486	0	39144
1352	37292	478	239	397	0	38406
1353	37589	387	194	411	0	38581
1354	1878	332	225	36114	0	38549
1355	841	328	35494	1395	0	38058
1356	612	35223	1234	584	0	37653
1357	562	1266	493	34949	0	37270
1358	459	511	35076	1431	0	37477
1359	558	387	1293	34835	0	37073
1360	519	306	534	35641	0	37000
1361	350	332	34894	1758	0	37334
1362	406	306	1323	34858	0	36893
1363	526	366	581	33613	0	35086
1364	35126	332	390	1801	0	37649
1365	35502	304	341	958	0	37105
1366	35536	259	267	763	0	36825
1367	35620	296	276	623	0	36815
1368	1978	243	283	34093	0	36597
1369	1047	231	311	35009	0	36598
1370	825	296	256	35290	0	36667
1371	34149	308	230	1983	0	36670
1372	1657	291	303	34385	0	36636
1373	937	254	310	35063	0	36564
1374	749	256	33219	1991	0	36215
1375	722	310	1336	32443	0	34811
1376	628	31199	584	1729	0	34140
1377	588	33972	372	981	0	35913
1378	32680	1451	336	769	0	35236
1379	1569	623	32212	732	0	35136
1380	786	31367	1248	642	0	34043
1381	31127	1208	654	565	0	33554
1382	1534	545	377	31119	0	33575
1383	719	438	30896	1530	0	33583
1384	662	450	1222	30066	0	32400
1385	542	31679	564	1538	0	34323
1386	31308	1193	466	945	0	33912
1387	1366	32198	366	758	0	34688
1388	32007	1370	328	643	0	34348
1389	32868	581	262	684	0	34395
1390	1790	462	292	31990	0	34534
1391	898	448	243	31318	0	32907
1392	668	31667	220	1746	0	34301
1393	32001	1253	264	951	0	34469
1394	1467	641	31361	723	0	34192
1395	30553	460	1064	593	0	32670
1396	30624	374	469	591	0	32058
1397	1611	277	29088	593	0	31569
1398	795	371	1062	27753	0	29981
1399	28049	275	463	1386	0	30173
1400	1382	234	27725	728	0	30069
1401	692	292	27021	558	0	28563
1402	25294	239	1237	530	0	27300
1403	1200	24795	613	441	0	27049
1404	626	24473	384	408	0	25891
1405	709	1165	265	23747	0	25886
1406	496	588	23753	962	0	25799
1407	22600	335	943	655	0	24533
1408	1077	256	23266	468	0	25067
1409	569	21548	874	361	0	23352
1410	21717	893	472	328	0	23410
1411	1018	466	322	21568	0	23374
1412	21747	307	265	1001	0	23320
1413	1150	203	21306	525	0	23184
1414	710	242	822	20553	0	22327
1415	457	21484	480	789	0	23210
1416	463	896	289	21359	0	23007
1417	431	535	260	22079	0	23305
1418	478	342	21579	1068	0	23467
1419	487	20427	820	635	0	22369
1420	392	20969	479	447	0	22287
1421	419	871	20047	343	0	21680
1422	18574	429	786	371	0	20160
1423	19407	242	444	363	0	20456
1424	1035	245	387	18667	0	20334
1425	18009	167	269	723	0	19168
1426	797	16719	273	449	0	18238
1427	455	17984	234	362	0	19035
1428	17890	741	218	395	0	19244
1429	888	437	270	17677	0	19272
1430	18015	221	229	765	0	19230
1431	18488	184	164	528	0	19364
1432	990	242	161	17614	0	19007
1433	587	269	17423	697	0	18976
1434	17427	207	580	448	0	18662
1435	18000	129	350	332	0	18811
1436	1003	170	264	17203	0	18640
1437	609	17150	213	686	0	18658
1438	431	673	176	17371	0	18651
1439	402	331	16975	770	0	18478
1440	375	201	16671	496	0	17743
1441	315	16541	729	443	0	18028
1442	440	290	244	11225	0	12199
1443	121	154	138	11502	0	11915
1444	130	118	11384	316	0	11948
1445	10909	84	251	223	0	11467
1446	11639	60	149	162	0	12010
1447	11662	63	111	131	0	11967
1448	11767	81	77	119	0	12044
1449	411	11196	67	122	0	11796
1450	232	11710	86	109	0	12137
1451	11937	298	83	117	0	12435
1452	360	173	80	12105	0	12718
1453	256	116	73	12275	0	12720
1454	171	12302	60	383	0	12916
1455	156	303	66	12466	0	12991
1456	162	162	73	12315	0	12712
1457	154	12216	81	404	0	12855
1458	153	292	12228	226	0	12899
1459	158	172	263	12303	0	12896
1460	12242	145	144	354	0	12885
1461	12190	112	112	228	0	12642
1462	448	83	11850	159	0	12540
1463	272	82	11499	131	0	11984
1464	193	78	11707	126	0	12104
1465	179	104	372	11430	0	12085
1466	146	89	11553	319	0	12107
1467	132	95	11521	206	0	11954
1468	164	168	368	11180	0	11880
1469	148	11605	222	311	0	12286
1470	140	240	11769	221	0	12370
1471	115	11942	285	168	0	12510
1472	11654	305	191	161	0	12311
1473	272	11865	160	143	0	12440
1474	196	293	119	11633	0	12241
1475	11738	145	117	312	0	12312
1476	309	124	110	11735	0	12278
1477	200	88	126	11957	0	12371
1478	149	78	11952	371	0	12550
1479	124	11176	305	236	0	11841
1480	107	11734	184	171	0	12196
1481	131	316	136	11073	0	11656
1482	93	123	106	11070	0	11392
1483	116	74	99	10895	0	11184
1484	71	86	10456	324	0	10937
1485	79	78	9543	176	0	9876
1486	8914	67	238	154	0	9373
1487	180	63	9573	113	0	9929
1488	83	67	9546	94	0	9790
1489	70	9373	235	93	0	9771
1490	103	218	127	9412	0	9860
1491	56	88	9468	221	0	9833
1492	81	59	213	9063	0	9416
1493	50	62	9516	254	0	9882
1494	55	50	229	9520	0	9854
1495	46	55	10082	256	0	10439
1496	62	53	229	9921	0	10265
1497	60	64	121	9966	0	10211
1498	45	10324	109	274	0	10752
1499	54	184	97	10374	0	10709
1500	38	10486	91	261	0	10876
1501	61	196	106	10719	0	11082
1502	50	91	109	10847	0	11097
1503	10533	81	95	315	0	11024
1504	190	76	92	10582	0	10940
1505	74	59	10432	290	0	10855
1506	60	50	228	10400	0	10738
1507	49	50	120	10606	0	10825
1508	42	51	10331	329	0	10753
1509	46	46	10111	199	0	10402
1510	65	50	259	10021	0	10395
1511	67	68	141	10407	0	10683
1512	41	70	10307	316	0	10734
1513	29	9702	242	216	0	10189
1514	40	10297	130	183	0	10650
1515	10069	224	97	201	0	10591
1516	208	106	100	10314	0	10728
1517	10420	68	109	322	0	10919
1518	10132	51	102	218	0	10503
1519	214	10345	123	164	0	10846
1520	10482	200	94	185	0	10961
1521	10589	96	104	174	0	10963
1522	246	85	10471	139	0	10941
1523	131	86	238	10484	0	10939
1524	74	84	10877	288	0	11323
1525	95	62	256	10951	0	11364
1526	80	66	11013	280	0	11439
1527	78	10284	240	163	0	10765
1528	68	10656	149	126	0	10999
1529	130	213	110	10413	0	10866
1530	10310	105	72	278	0	10765
1531	215	63	76	10358	0	10712
1532	128	63	92	10335	0	10618
1533	72	51	10304	294	0	10721
1534	75	59	10123	165	0	10422
1535	70	58	10297	132	0	10557
1536	71	61	269	10148	0	10549
1537	64	68	135	9909	0	10176
1538	45	10063	117	279	0	10504
1539	40	10523	108	169	0	10840
1540	10210	228	103	182	0	10723
1541	195	10451	103	131	0	10880
1542	82	208	10275	154	0	10719
1543	73	97	226	10111	0	10507
1544	64	68	10612	265	0	11009
1545	45	10652	233	172	0	11102
1546	67	243	143	10812	0	11265
1547	10383	79	110	307	0	10879
1548	167	61	10741	151	0	11120
1549	70	10762	226	144	0	11202
1550	57	178	10822	134	0	11191
1551	37	10744	213	111	0	11105
1552	101	258	128	10011	0	10498
1553	10268	90	65	212	0	10635
1554	10123	57	60	139	0	10379
1555	156	10130	64	101	0	10451
1556	10252	147	68	123	0	10590
1557	174	58	79	10266	0	10577
1558	10262	57	82	218	0	10619
1559	165	68	10350	115	0	10698
1560	89	52	10332	113	0	10586
1561	93	45	221	10050	0	10409
1562	69	71	85	10837	0	11062
1563	68	67	10758	244	0	11137
1564	67	54	203	10755	0	11079
1565	10833	56	99	269	0	11257
1566	10774	49	67	166	0	11056
1567	223	10420	87	90	0	10820
1568	92	10623	64	100	0	10879
1569	10367	198	60	111	0	10736
1570	232	76	54	10293	0	10655
1571	10249	51	70	235	0	10605
1572	195	10142	66	116	0	10519
1573	10150	171	75	112	0	10508
1574	193	64	10017	79	0	10353
1575	87	57	9946	85	0	10175
1576	79	92	204	10004	0	10379
1577	74	57	10269	196	0	10596
1578	69	56	176	9900	0	10201
1579	99	57	80	9398	0	9634
1580	88	61	10579	199	0	10927
1581	80	69	192	10519	0	10860
1582	95	44	80	11186	0	11405
1583	70	52	11593	245	0	11960
1584	58	45	11380	113	0	11596
1585	11139	38	238	124	0	11539
1586	213	43	11893	75	0	12224
1587	12056	39	255	93	0	12443
1588	13057	25	101	94	0	13277
1589	306	30	13195	59	0	13590
1590	112	35	13663	48	0	13858
1591	92	55	335	13171	0	13653
1592	82	32	125	12997	0	13236
1593	38	13393	88	289	0	13808
1594	53	13958	75	134	0	14220
1595	46	271	13627	96	0	14040
1596	12869	88	291	82	0	13330
1597	13464	54	110	85	0	13713
1598	312	28	13296	54	0	13690
1599	126	37	13182	45	0	13390
1600	118	32	289	12856	0	13295
1601	63	13355	137	230	0	13785
1602	86	238	81	13873	0	14278
1603	80	70	60	14164	0	14374
1604	14120	46	57	317	0	14540
1605	14159	35	65	154	0	14413
1606	339	38	54	14626	0	15057
1607	124	37	14660	270	0	15091
1608	13777	32	298	147	0	14254
1609	276	15093	118	99	0	15586
1610	15318	241	85	96	0	15740
1611	15062	67	65	105	0	15299
1612	292	15116	63	63	0	15534
1613	121	15645	85	73	0	15924
1614	105	289	83	15442	0	15919
1615	85	115	69	15683	0	15952
1616	73	15497	49	335	0	15954
1617	97	266	58	15773	0	16194
1618	104	102	70	15988	0	16264
1619	84	79	15720	324	0	16207
1620	15106	44	295	178	0	15623
1621	15942	28	130	116	0	16216
1622	16113	23	112	110	0	16358
1623	407	35	92	15760	0	16294
1624	15522	31	69	332	0	15954
1625	316	15278	63	141	0	15798
1626	159	282	67	14631	0	15139
1627	105	14853	73	269	0	15300
1628	95	15817	70	110	0	16092
1629	15991	270	59	140	0	16460
1630	16113	103	61	120	0	16397
1631	15993	62	97	93	0	16245
1632	16007	56	70	92	0	16225
1633	16001	54	61	103	0	16219
1634	386	55	16243	69	0	16753
1635	15874	57	241	105	0	16277
1636	353	67	16876	71	0	17367
1637	16125	56	282	106	0	16569
1638	16663	32	126	133	0	16954
1639	16504	38	107	124	0	16773
1640	367	68	17357	97	0	17889
1641	206	78	257	17085	0	17626
1642	148	18214	105	238	0	18705
1643	18551	254	109	126	0	19040
1644	18466	113	81	99	0	18759
1645	391	18614	84	64	0	19153
1646	18996	245	72	99	0	19412
1647	367	95	79	18697	0	19238
1648	156	18940	89	268	0	19453
1649	18980	277	61	147	0	19465
1650	19015	106	60	145	0	19326
1651	387	109	71	18910	0	19477
1652	19193	71	97	321	0	19682
1653	411	45	83	19247	0	19786
1654	242	47	73	19475	0	19837
1655	198	62	19334	338	0	19932
1656	200	71	250	18967	0	19488
1657	175	77	113	19386	0	19751
1658	167	68	19432	313	0	19980
1659	141	73	19171	137	0	19522
1660	152	54	288	19345	0	19839
1661	119	78	19762	259	0	20218
1662	18190	69	275	166	0	18700
1663	311	20156	90	126	0	20683
1664	161	244	65	20797	0	21267
1665	134	95	58	21063	0	21350
1666	153	84	37	20791	0	21065
1667	21155	59	40	365	0	21619
1668	20846	36	54	183	0	21119
1669	21210	56	63	148	0	21477
1670	377	21241	53	103	0	21774
1671	233	223	38	21550	0	22044
1672	180	96	35	21805	0	22116
1673	21673	75	33	351	0	22132
1674	21644	73	27	160	0	21904
1675	360	86	34	21565	0	22045
1676	180	87	21462	285	0	22014
1677	20855	71	221	198	0	21345
1678	21699	58	63	170	0	21990
1679	359	56	21916	103	0	22434
1680	20126	47	204	148	0	20525
1681	339	36	21567	84	0	22026
1682	21068	25	221	125	0	21439
1683	323	162	97	21681	0	22263
1684	165	22560	67	235	0	23027
1685	135	179	23293	124	0	23731
1686	131	22891	218	97	0	23337
1687	100	20813	70	60	0	21043
1688	23233	176	90	122	0	23621
1689	177	56	34	23091	0	23358
1690	74	24	21	22583	0	22702
1691	23573	17	19	218	0	23827
1692	157	15	18	23844	0	24034
1693	77	18	24	23751	0	23870
1694	69	16	26	23652	0	23763
1695	72	42	21	23543	0	23678
1696	38	28	23668	162	0	23896
1697	45	33	22623	75	0	22776
1698	34	23275	117	51	0	23477
1699	23572	115	44	130	0	23861
1700	159	38	26	23925	0	24148
1701	72	23070	31	150	0	23323
1702	94	123	26	24872	0	25115
1703	64	39	17	25108	0	25228
1704	71	30	25	24977	0	25103
1705	83	28	26	25346	0	25483
1706	68	33	25	25081	0	25207
1707	49	24586	35	182	0	24852
1708	61	131	23	25065	0	25280
1709	46	57	24482	179	0	24764
1710	41	24467	127	96	0	24731
1711	76	142	36	24796	0	25050
1712	77	53	30	24690	0	24850
1713	60	24156	28	178	0	24422
1714	25	24603	32	124	0	24784
1715	24227	128	24	152	0	24531
1716	125	24103	35	90	0	24353
1717	23787	123	29	123	0	24062
1718	23527	41	35	129	0	23732
1719	129	48	24653	57	0	24887
1720	106	31	121	23545	0	23803
1721	41	49	24862	160	0	25112
1722	35	25363	132	78	0	25608
1723	150	171	51	22292	0	22664
1724	72	67	31	25273	0	25443
1725	59	39	24	25817	0	25939
1726	59	32	15	26023	0	26129
1727	41	47	26387	201	0	26676
1728	65	34	144	25816	0	26059
1729	61	33	26050	203	0	26347
1730	37	51	25321	71	0	25480
1731	23962	37	166	190	0	24355
1732	26236	30	51	146	0	26463
1733	26420	32	44	149	0	26645
1734	185	25699	28	88	0	26000
1735	81	149	36	26131	0	26397
1736	55	64	26587	180	0	26886
1737	93	55	165	26070	0	26383
1738	66	39	27560	206	0	27871
1739	26780	23	176	194	0	27173
1740	27003	23	63	137	0	27226
1741	26916	23	58	117	0	27114
1742	197	35	26052	53	0	26337
1743	85	45	25729	39	0	25898
1744	93	38	180	26665	0	26976
1745	110	27	81	24938	0	25156
1746	57	20	42	27358	0	27477
1747	50	32	27371	190	0	27643
1748	77	36	25043	76	0	25232
1749	26249	14	158	141	0	26562
1750	189	17	69	27766	0	28041
1751	68	17	73	27920	0	28078
1752	28269	15	62	245	0	28591
1753	193	26	49	28179	0	28447
1754	29700	15	25	344	0	30084
1755	30509	22	34	244	0	30809
1756	30338	20	50	192	0	30600
1757	218	22	31133	58	0	31431
1758	87	30652	173	121	0	31033
1759	31832	128	67	173	0	32200
1760	210	36	54	32061	0	32361
1761	125	26	45	31839	0	32035
1762	60	32095	48	225	0	32428
1763	31849	144	32	176	0	32201
1764	31184	39	37	174	0	31434
1765	31435	25	34	150	0	31644
1766	218	31686	60	65	0	32029
1767	33241	170	28	196	0	33635
1768	33313	42	28	171	0	33554
1769	33399	38	33	138	0	33608
1770	272	18	17	32897	0	33204
1771	106	39	38	33162	0	33345
1772	90	50	33821	214	0	34175
1773	141	28	150	32931	0	33250
1774	134	16	46	32759	0	32955
1775	62	48	33652	198	0	33960
1776	31741	36	136	196	0	32109
1777	33699	21	37	163	0	33920
1778	256	39	31	33447	0	33773
1779	100	32825	31	163	0	33119
1780	75	33156	32	91	0	33354
1781	92	221	45	33003	0	33361
1782	75	68	32307	166	0	32616
1783	124	84	116	31109	0	31433
1784	56	27	31171	149	0	31403
1785	57	39	30535	54	0	30685
1786	94	17	104	31807	0	32022
1787	31999	11	47	207	0	32264
1788	31050	15	27	123	0	31215
1789	143	24	21	32060	0	32248
1790	104	12	22	31588	0	31726
1791	69	16	24	31814	0	31923
1792	55	13	17	31518	0	31603
1793	31628	11	29	231	0	31899
1794	31088	16	27	162	0	31293
1795	31076	17	14	163	0	31270
1796	154	27	31322	35	0	31538
1797	112	19	98	31059	0	31288
1798	81	14	28	31841	0	31964
1799	31659	8	30	212	0	31909
1800	125	31238	30	87	0	31480
1801	31052	96	22	154	0	31324
1802	30689	29	23	126	0	30867
1803	30417	23	18	127	0	30585
1804	30324	14	22	125	0	30485
1805	198	32	30810	47	0	31087
1806	116	31	28390	64	0	28601
1807	31675	12	123	153	0	31963
1808	32520	13	45	126	0	32704
1809	32399	21	33	105	0	32558
1810	33231	19	24	126	0	33400
1811	261	25	35799	53	0	36138
1812	133	37141	327	65	0	37666
1813	152	352	119	39097	0	39720
1814	41458	129	88	610	0	42285
1815	42171	72	51	355	0	42649
1816	44433	32	33	238	0	44736
1817	45041	28	26	174	0	45269
1818	45591	21	34	171	0	45817
1819	43837	28	47	166	0	44078
1820	1028	67	38325	170	0	39590
1821	508	43	41889	46	0	42486
1822	369	57	661	41385	0	42472
1823	230	43	42566	548	0	43387
1824	208	41142	654	259	0	42263
1825	194	41131	324	152	0	41801
1826	282	713	169	43086	0	44250
1827	186	330	44629	565	0	45710
1828	178	168	42163	292	0	42801
1829	42511	98	873	277	0	43759
1830	47471	77	425	215	0	48188
1831	1200	74	225	47604	0	49103
1832	48366	82	144	979	0	49571
1833	1148	74	138	48004	0	49364
1834	629	44	137	48374	0	49184
1835	324	60	48503	1255	0	50142
1836	248	84	46619	577	0	47528
1837	331	69	1211	46741	0	48352
1838	222	84	46855	1011	0	48172
1839	43685	65	1088	643	0	45481
1840	47238	48	505	395	0	48186
1841	1338	47645	321	284	0	49588
1842	48228	904	242	342	0	49716
1843	1285	359	47107	157	0	48908
1844	46370	141	1066	257	0	47834
1845	47840	82	496	285	0	48703
1846	48360	85	306	254	0	49005
1847	1772	75	223	45797	0	47867
1848	815	46351	231	1007	0	48404
1849	47236	974	221	571	0	49002
1850	47932	387	216	423	0	48958
1851	1695	193	261	47716	0	49865
1852	47733	113	237	1363	0	49446
1853	1535	47978	253	614	0	50380
1854	960	1101	199	47108	0	49368
1855	628	465	45955	1278	0	48326
1856	42255	244	1181	813	0	44493
1857	1528	177	45943	359	0	48007
1858	968	190	1318	45716	0	48192
1859	626	44966	576	1298	0	47466
1860	555	49689	394	563	0	51201
1861	678	1721	299	49216	0	51914
1862	555	47834	355	1492	0	50236
1863	749	1754	296	66156	0	68955
1864	762	727	264	69942	0	71695
1865	704	484	260	71566	0	73014
1866	68063	410	205	3479	0	72157
1867	2822	370	177	68367	0	71736
1868	1266	310	66629	3102	0	71307
1869	920	66911	2315	1502	0	71648
1870	67662	2338	826	1128	0	71954
1871	3093	899	449	67335	0	71776
1872	1591	526	403	69158	0	71678
1873	1110	481	402	70491	0	72484
1874	850	522	67073	3621	0	72066
1875	753	67348	2499	1761	0	72361
1876	67426	2536	980	1438	0	72380
1877	2883	1088	598	64788	0	69357
1878	1181	68696	559	2990	0	73426
1879	68195	2801	522	1715	0	73233
1880	2856	1194	67773	1132	0	72955
1881	67733	805	2704	1135	0	72377
1882	3190	695	68925	930	0	73740
1883	1553	727	69007	879	0	72166
1884	1110	68502	3203	1053	0	73868
1885	1143	2687	1405	66299	0	71534
1886	873	1088	67088	3144	0	72193
1887	771	64229	3128	1617	0	69745
1888	959	2771	1465	63186	0	68381
1889	666	65362	1015	3052	0	70095
1890	683	2982	65418	1593	0	70676
1891	902	1360	2966	65254	0	70482
1892	657	975	66117	3344	0	71093
1893	955	857	3142	65492	0	70446
1894	976	784	1518	67919	0	71197
1895	744	680	65584	4079	0	71087
1896	892	674	3182	66009	0	70757
1897	63509	610	1586	3972	0	69677
1898	2948	64515	1147	2195	0	70805
1899	1410	2834	64902	1687	0	70833
1900	64027	1239	3114	1641	0	70021
1901	3384	970	1465	61499	0	67318
1902	1625	64554	1180	3194	0	70553
1903	65722	2976	948	1905	0	71551
1904	67909	1437	1136	1435	0	71917
1905	3996	1029	946	64110	0	70081
1906	1983	940	814	66401	0	70138
1907	1394	859	870	66719	0	69842
1908	1252	869	814	65447	0	68382
1909	1093	62611	838	4581	0	69123
1910	1270	3716	827	59630	0	65443
1911	883	57958	756	3654	0	63251
1912	849	57975	736	2377	0	61937
1913	696	58183	755	1985	0	61619
1914	829	3381	53220	1712	0	59142
1915	788	54915	2609	1844	0	60156
1916	51039	3001	1500	1774	0	57314
1917	2549	51983	921	1809	0	57262
1918	1419	2896	887	47691	0	52893
1919	1032	52335	951	3391	0	57709
1920	1114	3096	848	52241	0	57299
1921	1259	1711	883	54074	0	57927
1922	1046	1440	51585	3911	0	57982
1923	49698	1435	2728	2358	0	56219
1924	51899	1364	1202	2176	0	56641
1925	51850	1118	952	2165	0	56085
1926	3134	50269	1031	2197	0	56631
1927	1544	2728	1062	49724	0	55058
1928	1371	1449	48359	3494	0	54673
1929	1256	48056	2718	2082	0	54112
1930	1431	2955	1176	40142	0	45704
1931	1130	45492	1023	2505	0	50150
1932	45109	2647	987	1720	0	50463
1933	45759	1604	1030	1336	0	49729
1934	46965	1253	1176	1160	0	50554
1935	47000	1125	1307	1072	0	50504
1936	3180	1127	1144	44808	0	50259
1937	1639	1128	1092	44665	0	48524
1938	1209	45200	1046	2888	0	50343
1939	1250	2690	866	45941	0	50747
1940	1007	1411	44383	3184	0	49985
1941	827	1255	2335	44490	0	48907
1942	646	1229	43430	3358	0	48663
1943	567	43064	2427	2188	0	48246
1944	635	2524	43481	1769	0	48409
1945	747	1319	2760	43740	0	48566
1946	669	952	44185	3225	0	49031
1947	775	966	2794	43798	0	48333
1948	845	1051	1431	44920	0	48247
1949	938	961	1132	44934	0	47965
1950	923	1050	1171	44723	0	47867
1951	41960	1020	917	3353	0	47250
1952	2371	42428	803	1989	0	47591
1953	41615	2428	705	1724	0	46472
1954	2369	1317	39625	1599	0	44910
1955	40240	1058	1826	1646	0	44770
1956	41847	902	840	1615	0	45204
1957	3197	978	39342	1465	0	44982
1958	2039	742	38002	1422	0	42205
1959	1425	36853	2059	1587	0	41924
1960	1059	35505	827	1568	0	38959
1961	1176	2038	32602	1618	0	37434
1962	766	29623	1582	1561	0	33532
1963	898	1117	653	16052	0	18720
1964	15260	196	267	527	0	16250
1965	406	148	90	15240	0	15884
1966	15196	133	83	495	0	15907
1967	15182	121	80	274	0	15657
1968	478	15217	84	210	0	15989
1969	15007	327	81	231	0	15646
1970	15143	169	54	180	0	15546
1971	499	161	47	14726	0	15433
1972	14721	117	44	410	0	15292
1973	385	14858	63	223	0	15529
1974	246	328	41	14896	0	15511
1975	14938	133	42	436	0	15549
1976	364	118	14604	192	0	15278
1977	14437	83	251	152	0	14923
1978	409	139	121	14669	0	15338
1979	172	80	14681	286	0	15219
1980	140	66	14274	123	0	14603
1981	14073	122	377	150	0	14722
1982	14160	42	170	100	0	14472
1983	324	46	77	13918	0	14365
1984	171	33	85	13975	0	14264
1985	145	47	45	13875	0	14112
1986	108	13912	41	330	0	14391
1987	13950	225	29	210	0	14414
1988	266	13956	32	154	0	14408
1989	13916	258	32	154	0	14360
1990	312	115	13757	87	0	14271
1991	204	87	222	13852	0	14365
1992	14255	70	96	295	0	14716
1993	345	33	80	14265	0	14723
1994	163	38	90	14148	0	14439
1995	118	13696	61	351	0	14226
1996	14074	234	62	206	0	14576
1997	281	14922	48	134	0	15385
1998	167	288	46	15137	0	15638
1999	107	150	14757	312	0	15326
2000	13415	105	264	195	0	13979
2001	331	70	14497	132	0	15030
2002	13650	56	298	137	0	14141
2003	328	14478	139	95	0	15040
2004	223	273	95	13692	0	14283
2005	146	14309	77	267	0	14799
2006	14405	313	66	181	0	14965
2007	344	147	39	14494	0	15024
2008	196	103	39	14835	0	15173
2009	130	95	14310	422	0	14957
2010	13387	67	271	275	0	14000
2011	384	67	121	14593	0	15165
2012	181	69	14292	341	0	14883
2013	130	14138	309	200	0	14777
2014	138	246	148	14366	0	14898
2015	14380	136	116	368	0	15000
2016	341	82	71	14547	0	15041
2017	192	89	14691	348	0	15320
2018	15619	71	285	240	0	16215
2019	437	72	128	15778	0	16415
2020	221	60	16783	426	0	17490
2021	184	62	411	17055	0	17712
2022	157	67	179	16779	0	17182
2023	123	17123	136	562	0	17944
2024	16999	413	92	305	0	17809
2025	452	17222	72	219	0	17965
2026	17293	464	77	158	0	17992
2027	539	214	51	16634	0	17438
2028	239	17249	73	443	0	18004
2029	226	458	57	17266	0	18007
2030	151	200	16882	530	0	17763
2031	16255	125	401	284	0	17065
2032	511	91	183	16567	0	17352
2033	273	86	125	16572	0	17056
2034	214	87	103	16817	0	17221
2035	145	79	16047	698	0	16969
2036	146	97	15946	360	0	16549
2037	120	16179	527	280	0	17106
2038	162	394	215	15594	0	16365
2039	15466	207	163	497	0	16333
2040	453	15728	108	297	0	16586
2041	249	455	117	16368	0	17189
2042	16495	216	74	527	0	17312
2043	16471	153	68	339	0	17031
2044	569	16446	103	244	0	17362
2045	17643	435	73	238	0	18389
2046	19312	202	66	244	0	19824
2047	799	158	76	19524	0	20557
2048	374	19411	80	669	0	20534
2049	280	565	98	20098	0	21041
2050	19911	233	95	759	0	20998
2051	705	178	19916	380	0	21179
2052	396	160	561	19839	0	20956
2053	321	153	219	20352	0	21045
2054	224	147	19911	911	0	21193
2055	281	140	593	20180	0	21194
2056	19955	135	286	890	0	21266
2057	18348	110	204	569	0	19231
2058	843	98	154	19811	0	20906
2059	423	109	19324	854	0	20710
2060	289	105	18703	506	0	19603
2061	283	18576	724	488	0	20071
2062	310	19555	359	354	0	20578
2063	343	694	199	18618	0	19854
2064	18434	300	154	781	0	19669
2065	623	18590	199	423	0	19835
2066	18533	603	204	353	0	19693
2067	690	301	180	18483	0	19654
2068	368	267	171	18688	0	19494
2069	17908	164	122	900	0	19094
2070	709	18052	142	452	0	19355
2071	18275	613	112	366	0	19366
2072	772	280	17663	333	0	19048
2073	379	211	17301	302	0	18193
2074	321	207	665	17116	0	18309
2075	244	176	17253	683	0	18356
2076	269	205	17167	364	0	18005
2077	325	203	695	16247	0	17470
2078	245	170	16967	685	0	18067
2079	262	132	706	16599	0	17699
2080	254	134	364	16832	0	17584
2081	208	117	17097	853	0	18275
2082	253	133	661	16920	0	17967
2083	257	133	369	16631	0	17390
2084	209	16692	317	837	0	18055
2085	16723	534	248	544	0	18049
2086	614	243	16830	438	0	18125
2087	304	181	664	16761	0	17910
2088	258	155	371	17279	0	18063
2089	173	134	16700	910	0	17917
2090	15530	140	654	551	0	16875
2091	598	16451	364	447	0	17860
2092	330	549	292	16638	0	17809
2093	238	255	237	16828	0	17558
2094	175	16551	253	921	0	17900
2095	192	546	16475	568	0	17781
2096	220	16764	610	428	0	18022
2097	15771	625	322	376	0	17094
2098	545	284	15613	343	0	16785
2099	321	236	547	15625	0	16729
2100	224	185	15820	692	0	16921
2101	191	191	15677	404	0	16463
2102	199	15652	705	335	0	16891
2103	287	523	373	14858	0	16041
2104	15214	249	275	630	0	16368
2105	15276	190	243	411	0	16120
2106	593	15265	263	342	0	16463
2107	278	510	247	15495	0	16530
2108	15365	289	223	641	0	16518
2109	15683	212	200	370	0	16465
2110	656	15539	190	315	0	16700
2111	15874	504	184	284	0	16846
2112	635	246	200	15370	0	16451
2113	320	16130	188	599	0	17237
2114	283	479	212	16597	0	17571
2115	288	265	170	16748	0	17471
2116	353	300	148	16707	0	17508
2117	268	185	16035	710	0	17198
2118	223	171	14084	368	0	14846
2119	182	14723	454	282	0	15641
2120	13506	345	242	257	0	14350
2121	357	13291	141	261	0	14050
2122	200	358	127	13339	0	14024
2123	171	168	14032	401	0	14772
2124	146	173	364	13655	0	14338
2125	144	147	183	14057	0	14531
2126	134	147	150	14459	0	14890
2127	14156	154	114	522	0	14946
2128	312	133	125	14375	0	14945
2129	132	93	15537	501	0	16263
2130	14703	86	362	355	0	15506
2131	15230	87	185	303	0	15805
2132	15857	90	155	249	0	16351
2133	15903	89	109	258	0	16359
2134	15880	70	120	225	0	16295
2135	452	15636	143	204	0	16435
2136	284	272	104	15116	0	15776
2137	226	15447	91	344	0	16108
2138	15537	298	78	213	0	16126
2139	15438	128	72	197	0	15835
2140	14999	107	79	184	0	15369
2141	418	14387	68	146	0	15019
2142	227	14293	65	138	0	14723
2143	204	14449	71	121	0	14845
2144	235	337	14022	80	0	14674
2145	380	726	218	11681	0	13005
2146	82	10721	53	84	0	10940
2147	16	11040	14	13	0	11083
2148	22	38	29	11041	0	11130
2149	15	29	6	10869	0	10919
2150	19	16	10975	40	0	11050
2151	10499	12	35	47	0	10593
2152	49	10	14	11441	0	11514
2153	35	11	11	11396	0	11453
2154	24	13	11265	49	0	11351
2155	24	17	10568	28	0	10637
2156	12	11785	52	20	0	11869
2157	31	43	33	12027	0	12134
2158	20	20	18	12139	0	12197
2159	16	32	11917	53	0	12018
2160	10684	22	43	55	0	10804
2161	11640	16	25	48	0	11729
2162	60	19	11907	28	0	12014
2163	11484	18	43	53	0	11598
2164	72	22	12156	23	0	12273
2165	11888	18	55	49	0	12010
2166	12276	14	28	51	0	12369
2167	92	6	12768	21	0	12887
2168	62	22	44	12653	0	12781
2169	64	19	25	11845	0	11953
2170	42	15	21	13361	0	13439
2171	13299	11	17	109	0	13436
2172	13059	17	17	73	0	13166
2173	81	19	13531	40	0	13671
2174	55	15	12600	51	0	12721
2175	13519	15	76	77	0	13687
2176	13932	9	54	47	0	14042
2177	98	19	13784	32	0	13933
2178	56	24	13425	24	0	13529
2179	61	16	101	13922	0	14100
2180	41	19	14379	81	0	14520
2181	45	10	88	13718	0	13861
2182	14653	5	50	125	0	14833
2183	121	7	15398	62	0	15588
2184	14400	12	152	79	0	14643
2185	187	11	16935	46	0	17179
2186	95	9	197	16696	0	16997
2187	90	2	59	17337	0	17488
2188	84	10	52	17367	0	17513
2189	60	17755	45	246	0	18106
2190	152	198	26	15545	0	15921
2191	85	45	33	17993	0	18156
2192	17750	28	30	263	0	18071
2193	231	17	17518	97	0	17863
2194	15945	12	204	118	0	16279
2195	247	21	17302	43	0	17613
2196	15377	22	219	98	0	15716
2197	236	17133	77	40	0	17486
2198	98	168	17044	42	0	17352
2199	72	47	16738	33	0	16890
2200	133	57	256	14357	0	14803
2201	65	18	92	16948	0	17123
2202	37	11	17145	244	0	17437
2203	59	21	16792	107	0	16979
2204	47	19	18389	74	0	18529
2205	19100	16	258	133	0	19507
2206	19750	15	115	92	0	19972
2207	19730	12	82	84	0	19908
2208	288	21	49	19356	0	19714
2209	126	9	63	19487	0	19685
2210	71	10	20584	251	0	20916
2211	107	27	216	19867	0	20217
2212	118	26	105	18550	0	18799
2213	20197	19	83	313	0	20612
2214	20021	23	70	151	0	20265
2215	20451	15	58	153	0	20677
2216	303	22	56	20385	0	20766
2217	148	16	70	20386	0	20620
2218	101	21	71	20516	0	20709
2219	20314	11	62	331	0	20718
2220	255	10	69	19929	0	20263
2221	123	20252	84	230	0	20689
2222	124	189	70	19991	0	20374
2223	77	19680	76	229	0	20062
2224	19724	204	81	132	0	20141
2225	19221	56	77	157	0	19511
2226	253	19377	75	109	0	19814
2227	110	19814	89	96	0	20109
2228	101	232	76	19677	0	20086
2229	79	90	18661	251	0	19081
2230	112	42	232	18039	0	18425
2231	103	32	18609	305	0	19049
2232	91	18651	255	148	0	19145
2233	112	193	92	18884	0	19281
2234	99	57	98	19112	0	19366
2235	90	53	19881	318	0	20342
2236	115	29	234	19691	0	20069
2237	86	43	20219	314	0	20662
2238	19575	43	269	198	0	20085
2239	20369	39	107	168	0	20683
2240	20598	42	97	160	0	20897
2241	336	40	57	20359	0	20792
2242	164	34	75	20523	0	20796
2243	123	53	20726	326	0	21228
2244	121	72	244	19929	0	20366
2245	98	19852	117	337	0	20404
2246	100	214	20351	160	0	20825
2247	103	74	19772	155	0	20104
2248	140	117	287	18311	0	18855
2249	105	53	20353	300	0	20811
2250	104	54	20077	159	0	20394
2251	18415	52	268	216	0	18951
2252	243	21368	121	152	0	21884
2253	22172	218	105	234	0	22729
2254	22204	74	104	191	0	22573
2255	22500	62	96	190	0	22848
2256	337	56	83	22141	0	22617
2257	173	50	98	22436	0	22757
2258	121	48	22285	317	0	22771
2259	133	46	246	21765	0	22190
2260	83	22164	131	331	0	22709
2261	22509	194	151	185	0	23039
2262	239	22369	128	134	0	22870
2263	107	22607	88	131	0	22933
2264	147	250	93	22608	0	23098
2265	114	85	22819	260	0	23278
2266	152	69	248	22352	0	22821
2267	96	67	22316	295	0	22774
2268	97	22067	255	181	0	22600
2269	22221	185	113	173	0	22692
2270	22306	55	111	178	0	22650
2271	22406	62	69	213	0	22750
2272	296	59	23180	116	0	23651
2273	157	56	21153	118	0	21484
2274	22610	54	224	183	0	23071
2275	23417	37	96	174	0	23724
2276	23691	35	77	163	0	23966
2277	282	50	65	23483	0	23880
2278	172	35	45	23822	0	24074
2279	23657	40	62	306	0	24065
2280	23226	44	41	206	0	23517
2281	255	48	23518	128	0	23949
2282	135	35	22002	83	0	22255
2283	21296	26	117	145	0	21584
2284	136	37	22388	66	0	22627
2285	20303	15	78	88	0	20484
2286	101	30	20978	25	0	21134
2287	60	23	45	20291	0	20419
2288	38	15	21397	33	0	21483
2289	71	6	29	21035	0	21141
2290	41	8	20	21434	0	21503
2291	31	21608	26	33	0	21698
2292	21970	26	13	129	0	22138
2293	42	23	22553	17	0	22635
2294	21208	12	52	88	0	21360
2295	60	22846	23	20	0	22949
2296	23798	39	34	103	0	23974
2297	98	8	16	23801	0	23923
2298	55	10	15	24019	0	24099
2299	20	24861	13	106	0	25000
2300	47	67	17	25753	0	25884
2301	49	33	13	25911	0	26006
2302	46	16	15	26118	0	26195
2303	25212	17	18	236	0	25483
2304	23561	9	8	124	0	23702
2305	180	23	23397	29	0	23629
2306	72	23341	131	43	0	23587
2307	64	123	45	24190	0	24422
2308	67	42	22	25229	0	25360
2309	39	35	25401	222	0	25697
2310	61	28	169	24107	0	24365
2311	24439	19	59	295	0	24812
2312	24382	10	37	163	0	24592
2313	24548	12	21	139	0	24720
2314	311	13	16	24716	0	25056
2315	25650	13	19	312	0	25994
2316	25491	10	17	223	0	25741
2317	26159	14	35	151	0	26359
2318	325	23	16	26159	0	26523
2319	175	8	23	26389	0	26595
2320	112	15	22	26515	0	26664
2321	108	27	34	25856	0	26025
2322	96	18	24	25932	0	26070
2323	85	22	25747	328	0	26182
2324	84	21	25049	159	0	25313
2325	72	24889	247	111	0	25319
2326	97	188	111	25853	0	26249
2327	114	64	43	26211	0	26432
2328	124	29	29	26372	0	26554
2329	96	26	25987	340	0	26449
2330	111	24	210	25557	0	25902
2331	68	21	25860	328	0	26277
2332	115	12	223	25511	0	25861
2333	66	34	26495	319	0	26914
2334	49	26374	231	217	0	26871
2335	88	203	93	26048	0	26432
2336	67	81	25581	314	0	26043
2337	22208	44	239	310	0	22801
2338	225	25822	110	146	0	26303
2339	139	229	73	26162	0	26603
2340	50	26341	65	306	0	26762
2341	79	249	58	26117	0	26503
2342	26671	99	48	426	0	27244
2343	310	39	57	26329	0	26735
2344	102	26598	63	341	0	27104
2345	26607	252	52	259	0	27170
2346	311	106	48	27977	0	28442
2347	136	59	64	28693	0	28952
2348	29029	40	76	613	0	29758
2349	475	44	39	31832	0	32390
2350	268	44	59	39345	0	39716
2351	127	55	39644	1263	0	41089
2352	86	64	39117	478	0	39745
2353	213	41	1353	38453	0	40060
2354	120	49	39257	1159	0	40585
2355	82	63	38470	508	0	39123
2356	36322	47	1466	502	0	38337
2357	1165	60	39171	197	0	40593
2358	404	38840	1384	264	0	40892
2359	434	1055	497	38922	0	40908
2360	40211	341	405	1338	0	42295
2361	41231	225	255	600	0	42311
2362	40937	79	233	560	0	41809
2363	1643	40253	281	341	0	42518
2364	890	1190	242	39960	0	42282
2365	572	398	230	41382	0	42582
2366	38149	266	281	1809	0	40505
2367	40961	122	259	925	0	42267
2368	41243	145	275	649	0	42312
2369	1804	147	41196	402	0	43549
2370	852	40033	1391	506	0	42782
2371	552	46960	739	392	0	48643
2372	625	1835	554	44684	0	47698
2373	660	885	314	46933	0	48792
2374	444	504	46361	2347	0	49656
2375	45146	343	1852	1331	0	48672
2376	47512	287	894	914	0	49607
2377	2564	304	617	46268	0	49753
2378	1628	252	292	47383	0	49555
2379	1141	151	294	48247	0	49833
2380	46743	232	223	2880	0	50078
2381	2231	231	45192	1475	0	49129
2382	1189	326	46324	1021	0	48860
2383	937	332	2267	45476	0	49012
2384	595	269	46362	2249	0	49475
2385	44974	200	2126	1416	0	48716
2386	46461	127	1142	1030	0	48760
2387	47362	195	850	729	0	49136
2388	2994	44556	566	657	0	48773
2389	45553	1683	465	778	0	48479
2390	2639	915	376	44388	0	48318
2391	1456	589	427	45404	0	47876
2392	1225	247	403	46362	0	48237
2393	753	247	43878	3102	0	47980
2394	835	257	2067	42441	0	45600
2395	730	43305	1128	2528	0	47691
2396	42222	1608	879	1691	0	46400
2397	1989	43453	594	1414	0	47450
2398	1311	1992	42628	927	0	46858
2399	1208	42801	2024	742	0	46775
2400	41299	2122	1171	784	0	45376
2401	2093	41827	1003	727	0	45650
2402	1503	2152	639	36697	0	40991
2403	991	41728	620	1914	0	45253
2404	41529	2091	629	1269	0	45518
2405	42534	1129	567	1041	0	45271
2406	38957	819	611	881	0	41268
2407	2891	722	40629	739	0	44981
2408	1728	637	40348	721	0	43434
2409	1280	586	40394	777	0	43037
2410	39857	540	2733	787	0	43917
2411	2383	533	1484	39221	0	43621
2412	1546	555	1036	40421	0	43558
2413	1218	591	39187	2538	0	43534
2414	897	638	1914	39861	0	43310
2415	37778	631	1109	2552	0	42070
2416	2198	38344	800	1507	0	42849
2417	39322	1837	702	1153	0	43014
2418	2654	1130	38332	734	0	42850
2419	39201	898	1955	716	0	42770
2420	40439	673	1169	671	0	42952
2421	40666	654	991	695	0	43006
2422	3256	549	38212	716	0	42733
2423	2142	471	1961	38188	0	42762
2424	1634	337	38896	2065	0	42932
2425	1339	379	2287	38862	0	42867
2426	1042	407	39442	2391	0	43282
2427	1096	404	2469	38750	0	42719
2428	1016	413	1419	40485	0	43333
2429	39250	338	1030	2784	0	43402
2430	39851	301	823	1756	0	42731
2431	40772	244	823	1348	0	43187
2432	3301	251	852	37841	0	42245
2433	1936	34866	729	2178	0	39709
2434	1559	38338	608	1423	0	41928
2435	38182	2088	602	1198	0	42070
2436	2462	1159	37484	917	0	42022
2437	37832	698	2036	917	0	41483
2438	2641	473	37312	865	0	41291
2439	38790	482	2207	819	0	42298
2440	35694	473	1267	933	0	38367
2441	2844	373	38351	766	0	42334
2442	38979	327	2017	959	0	42282
2443	39707	326	1325	787	0	42145
2444	39912	381	993	792	0	42078
2445	3322	38021	686	808	0	42837
2446	2005	2001	769	36731	0	41506
2447	1433	945	36811	1968	0	41157
2448	1331	673	36853	1159	0	40016
2449	1150	33213	2004	831	0	37198
2450	701	26674	996	389	0	28760
2451	862	960	874	24937	0	27633
2452	24733	612	408	851	0	26604
2453	1068	24936	329	628	0	26961
2454	1015	771	289	24297	0	26372
2455	782	25053	292	822	0	26949
2456	25069	850	242	658	0	26819
2457	1037	634	280	24638	0	26589
2458	767	459	24186	853	0	26265
2459	607	23217	751	691	0	25266
2460	464	23767	651	456	0	25338
2461	528	936	464	22015	0	23943
2462	501	23645	305	590	0	25041
2463	460	942	267	23299	0	24968
2464	23363	671	207	899	0	25140
2465	23466	489	220	644	0	24819
2466	24331	375	235	460	0	25401
2467	24533	305	255	332	0	25425
2468	1394	340	23822	259	0	25815
2469	956	22096	606	237	0	23895
2470	614	22129	463	293	0	23499
2471	208	18180	125	120	0	18633
2472	171	18004	145	88	0	18408
2473	18229	326	276	98	0	18929
2474	17847	133	90	79	0	18149
2475	18201	68	30	116	0	18415
2476	18233	58	34	93	0	18418
2477	333	70	18001	45	0	18449
2478	19095	49	190	107	0	19441
2479	19661	44	98	84	0	19887
2480	19971	41	70	72	0	20154
2481	386	46	47	19661	0	20140
2482	237	44	53	19713	0	20047
2483	19950	49	52	303	0	20354
2484	318	53	33	19542	0	19946
2485	166	19308	36	252	0	19762
2486	129	216	34	19654	0	20033
2487	135	106	31	19603	0	19875
2488	111	19825	37	292	0	20265
2489	122	217	35	19951	0	20325
2490	118	117	28	20094	0	20357
2491	19701	88	42	356	0	20187
2492	262	80	19127	174	0	19643
2493	18462	58	197	165	0	18882
2494	292	66	19194	86	0	19638
2495	178	67	18160	81	0	18486
2496	149	54	18789	76	0	19068
2497	18486	46	299	101	0	18932
2498	282	44	19807	57	0	20190
2499	19230	41	273	104	0	19648
2500	19635	39	139	96	0	19909
2501	19884	40	91	87	0	20102
2502	326	19767	58	44	0	20195
2503	19923	187	53	92	0	20255
2504	278	20159	51	59	0	20547
2505	219	232	30	20293	0	20774
2506	171	110	38	20320	0	20639
2507	118	20173	40	247	0	20578
2508	113	20193	44	133	0	20483
2509	95	20861	54	94	0	21104
2510	20660	287	43	113	0	21103
2511	237	21120	36	62	0	21455
2512	21126	268	33	117	0	21544
2513	320	154	20748	52	0	21274
2514	20569	99	198	86	0	20952
2515	21319	62	87	94	0	21562
2516	362	74	20624	42	0	21102
2517	236	55	218	20446	0	20955
2518	155	55	20848	214	0	21272
2519	160	42	241	20563	0	21006
2520	128	42	124	20819	0	21113
2521	20930	55	87	362	0	21434
2522	20875	46	67	236	0	21224
2523	311	20820	64	126	0	21321
2524	21161	226	34	138	0	21559
2525	328	117	21199	71	0	21715
2526	20732	68	218	127	0	21145
2527	348	74	21771	57	0	22250
2528	229	59	21391	61	0	21740
2529	21922	42	372	116	0	22452
2530	22640	49	182	95	0	22966
2531	403	64	23082	46	0	23595
2532	274	54	323	21870	0	22521
2533	165	77	156	23288	0	23686
2534	152	56	22888	369	0	23465
2535	171	59	294	22177	0	22701
2536	166	21192	159	330	0	21847
2537	157	285	101	23390	0	23933
2538	184	137	72	23150	0	23543
2539	162	92	22219	366	0	22839
2540	20558	73	283	250	0	21164
2541	22159	61	128	176	0	22524
2542	22135	54	94	163	0	22446
2543	21946	47	91	144	0	22228
2544	493	21458	103	104	0	22158
2545	323	253	69	20806	0	21451
2546	242	117	20600	315	0	21274
2547	170	99	20252	184	0	20705
2548	211	81	321	19776	0	20389
2549	145	62	20403	330	0	20940
2550	19716	55	308	241	0	20320
2551	325	67	165	20370	0	20927
2552	200	57	120	20497	0	20874
2553	148	51	93	20587	0	20879
2554	20074	57	90	486	0	20707
2555	298	20058	99	251	0	20706
2556	19952	237	84	246	0	20519
2557	19968	94	93	192	0	20347
2558	406	19455	119	105	0	20085
2559	245	19683	105	98	0	20131
2560	20242	292	107	109	0	20750
2561	389	120	142	20063	0	20714
2562	241	83	107	19937	0	20368
2563	20648	67	119	373	0	21207
2564	403	65	20435	148	0	21051
2565	19967	51	330	153	0	20501
2566	20513	45	148	161	0	20867
2567	451	20693	105	112	0	21361
2568	21418	268	64	123	0	21873
2569	21151	132	58	147	0	21488
2570	452	23231	51	101	0	23835
2571	166	23694	44	81	0	23985
2572	192	415	69	22939	0	23615
2573	23646	156	37	395	0	24234
2574	386	24314	27	149	0	24876
2575	232	418	27	24544	0	25221
2576	24790	132	26	494	0	25442
2577	467	96	24505	170	0	25238
2578	252	61	396	23746	0	24455
2579	149	50	24187	475	0	24861
2580	23036	55	472	243	0	23806
2581	24460	44	167	174	0	24845
2582	608	57	24258	84	0	25007
2583	250	24010	466	75	0	24801
2584	252	412	180	24261	0	25105
2585	159	184	24606	424	0	25373
2586	174	134	471	24322	0	25101
2587	206	93	178	25245	0	25722
2588	156	85	24974	635	0	25850
2589	23709	78	502	345	0	24634
2590	25093	86	183	253	0	25615
2591	650	63	25119	162	0	25994
2592	302	25058	537	140	0	26037
2593	267	488	230	24192	0	25177
2594	176	24543	185	490	0	25394
2595	160	25069	154	229	0	25612
2596	25375	607	118	204	0	26304
2597	595	255	127	25379	0	26356
2598	336	152	122	25106	0	25716
2599	197	151	25356	661	0	26365
2600	169	94	24961	331	0	25555
2601	210	113	651	24706	0	25680
2602	189	106	290	25505	0	26090
2603	164	99	25129	710	0	26102
2604	155	112	25125	323	0	25715
2605	204	86	700	24901	0	25891
2606	25150	115	321	681	0	26267
2607	555	25432	250	327	0	26564
2608	25278	581	156	312	0	26327
2609	669	25249	141	217	0	26276
2610	330	25923	164	176	0	26593
2611	25247	721	145	249	0	26362
2612	640	315	25821	226	0	27002
2613	369	196	618	25842	0	27025
2614	279	177	313	26429	0	27198
2615	269	128	228	28562	0	29187
2616	195	151	28473	931	0	29750
2617	232	147	732	28397	0	29508
2618	29029	131	371	902	0	30433
2619	767	145	277	29981	0	31170
2620	429	108	210	31129	0	31876
2621	30675	131	181	1138	0	32125
2622	30602	131	174	594	0	31501
2623	976	30133	205	388	0	31702
2624	494	729	30368	293	0	31884
2625	359	310	29835	246	0	30750
2626	269	208	30291	282	0	31050
2627	263	29175	979	292	0	30709
2628	323	685	509	28329	0	29846
2629	244	300	292	29410	0	30246
2630	28912	213	241	1056	0	30422
2631	857	138	252	28623	0	29870
2632	365	148	28536	992	0	30041
2633	343	131	818	28574	0	29866
2634	288	119	382	29069	0	29858
2635	219	143	28449	1150	0	29961
2636	274	28133	829	577	0	29813
2637	371	737	378	25494	0	26980
2638	210	28258	352	805	0	29625
2639	209	804	28255	427	0	29695
2640	27639	349	883	406	0	29277
2641	28453	257	480	339	0	29529
2642	28757	241	341	369	0	29708
2643	1070	218	264	27849	0	29401
2644	500	28442	277	882	0	30101
2645	28282	791	261	546	0	29880
2646	28927	319	267	477	0	29990
2647	28709	244	251	436	0	29640
2648	1063	177	28065	406	0	29711
2649	27176	125	827	453	0	28581
2650	921	27869	382	376	0	29548
2651	27688	750	307	363	0	29108
2652	905	28219	268	333	0	29725
2653	28467	873	233	364	0	29937
2654	993	364	28683	264	0	30304
2655	28573	253	834	268	0	29928
2656	29585	239	353	280	0	30457
2657	23177	256	342	465	0	24240
2658	29738	234	216	307	0	30495
2659	1208	229	28797	233	0	30467
2660	690	215	753	28450	0	30108
2661	28521	186	368	840	0	29915
2662	1018	28356	281	418	0	30073
2663	578	707	221	27931	0	29437
2664	459	311	27698	821	0	29289
2665	491	321	752	27704	0	29268
2666	422	193	27973	893	0	29481
2667	384	26826	782	476	0	28468
2668	330	25926	416	325	0	26997
2669	344	26396	243	307	0	27290
2670	406	776	215	23658	0	25055
2671	363	248	165	23696	0	24472
2672	277	178	23208	678	0	24341
2673	255	22156	531	284	0	23226
2674	21170	492	208	212	0	22082
2675	549	20657	136	180	0	21522
2676	254	21179	143	148	0	21724
2677	358	545	171	20437	0	21511
2678	20361	196	170	529	0	21256
2679	20583	170	147	266	0	21166
2680	587	120	120	20276	0	21103
2681	20025	140	137	507	0	20809
2682	516	156	89	19944	0	20705
2683	227	150	19699	536	0	20612
2684	19531	143	439	265	0	20378
2685	521	136	170	19714	0	20541
2686	219	128	19176	481	0	20004
2687	184	129	18809	224	0	19346
2688	186	148	463	19000	0	19797
2689	19296	129	225	487	0	20137
2690	19288	143	124	239	0	19794
2691	528	19405	106	175	0	20214
2692	19826	426	115	231	0	20598
2693	19905	172	130	163	0	20370
2694	20052	116	82	231	0	20481
2695	581	20078	96	162	0	20917
2696	20038	372	93	187	0	20690
2697	20333	151	83	169	0	20736
2698	598	122	85	20005	0	20810
2699	19324	90	84	416	0	19914
2700	479	19037	97	168	0	19781
2701	249	19628	101	120	0	20098
2702	244	381	98	19462	0	20185
2703	251	151	95	19590	0	20087
2704	189	19947	89	427	0	20652
2705	19821	345	80	183	0	20429
2706	452	19462	72	118	0	20104
2707	19200	365	49	116	0	19730
2708	471	19439	58	86	0	20054
2709	268	353	47	18731	0	19399
2710	219	19841	56	301	0	20417
2711	19812	374	183	153	0	20522
2712	19293	174	97	148	0	19712
2713	19058	110	110	116	0	19394
2714	503	115	18178	86	0	18882
2715	173	96	16708	78	0	17055
2716	114	16689	234	73	0	17110
2717	133	233	16455	75	0	16896
2718	99	123	15701	70	0	15993
2719	107	178	191	13667	0	14143
2720	49	30	14536	128	0	14743
2721	31	14641	107	62	0	14841
2722	14531	122	47	64	0	14764
2723	119	14364	23	32	0	14538
2724	55	14546	26	28	0	14655
2725	14551	145	14	52	0	14762
2726	14546	53	18	63	0	14680
2727	143	14885	24	28	0	15080
2728	15009	118	22	58	0	15207
2729	14959	46	18	60	0	15083
2730	14888	41	18	54	0	15001
2731	163	36	14386	19	0	14604
2732	79	51	13965	20	0	14115
2733	67	36	123	14465	0	14691
2734	78	36	60	14340	0	14514
2735	15015	34	35	153	0	15237
2736	129	14592	34	56	0	14811
2737	86	121	37	14990	0	15234
2738	57	56	29	15078	0	15220
2739	60	35	26	15308	0	15429
2740	68	40	28	15321	0	15457
2741	46	41	15286	204	0	15577
2742	61	35	15129	77	0	15302
2743	67	40	178	15422	0	15707
2744	56	36	15749	160	0	16001
2745	15013	34	188	99	0	15334
2746	217	23	70	15824	0	16134
2747	93	31	15851	185	0	16160
2748	14317	30	185	136	0	14668
2749	205	15625	76	49	0	15955
2750	15651	166	42	78	0	15937
2751	209	16025	48	36	0	16318
2752	125	178	28	15693	0	16024
2753	58	75	15841	171	0	16145
2754	85	42	173	15013	0	15313
2755	54	40	15127	198	0	15419
2756	14630	31	197	116	0	14974
2757	223	32	75	15336	0	15666
2758	15411	30	49	249	0	15739
2759	213	30	15301	79	0	15623
2760	15407	35	178	104	0	15724
2761	16579	23	72	101	0	16775
2762	295	30	16663	39	0	17027
2763	156	34	214	16275	0	16679
2764	82	26	16719	217	0	17044
2765	68	16617	236	82	0	17003
2766	16476	230	151	130	0	16987
2767	16398	70	67	101	0	16636
2768	284	35	16581	39	0	16939
2769	123	37	16237	37	0	16434
2770	117	22	266	15928	0	16333
2771	82	26	118	16402	0	16628
2772	16470	18	58	300	0	16846
2773	225	16497	66	102	0	16890
2774	16733	189	47	109	0	17078
2775	16756	69	48	99	0	16972
2776	301	41	16373	47	0	16762
2777	15678	37	214	101	0	16030
2778	283	32	16479	52	0	16846
2779	173	28	229	16344	0	16774
2780	106	32	17249	213	0	17600
2781	125	14	250	17029	0	17418
2782	75	35	17299	219	0	17628
2783	16460	18	272	145	0	16895
2784	17040	17	120	99	0	17276
2785	296	29	91	16969	0	17385
2786	17152	14	71	270	0	17507
2787	278	24	72	17120	0	17494
2788	134	17277	64	229	0	17704
2789	17262	180	64	140	0	17646
2790	265	17260	61	75	0	17661
2791	158	195	52	17404	0	17809
2792	120	74	59	17130	0	17383
2793	116	40	58	16954	0	17168
2794	96	36	66	16802	0	17000
2795	79	54	16194	305	0	16632
2796	14379	23	205	215	0	14822
2797	15752	41	82	135	0	16010
2798	286	15795	76	92	0	16249
2799	157	184	60	15888	0	16289
2800	108	65	68	15979	0	16220
2801	106	50	15507	296	0	15959
2802	14721	40	219	169	0	15149
2803	242	36	93	15409	0	15780
2804	139	40	15085	238	0	15502
2805	14710	27	226	182	0	15145
2806	15294	23	96	154	0	15567
2807	15312	30	76	135	0	15553
2808	306	26	14860	78	0	15270
2809	147	14	13776	102	0	14039
2810	13832	28	217	90	0	14167
2811	227	18	129	14273	0	14647
2812	143	44	73	14669	0	14929
2813	118	30	14532	224	0	14904
2814	14146	21	185	144	0	14496
2815	244	20	86	14963	0	15313
2816	15354	16	82	281	0	15733
2817	15355	18	58	182	0	15613
2818	15443	12	56	155	0	15666
2819	334	24	15737	70	0	16165
2820	177	27	227	15742	0	16173
2821	15756	17	102	303	0	16178
2822	278	16274	77	138	0	16767
2823	172	215	55	16523	0	16965
2824	151	73	43	16746	0	17013
2825	16523	42	62	380	0	17007
2826	16526	23	65	190	0	16804
2827	396	16	39	16269	0	16720
2828	190	42	16271	277	0	16780
2829	15890	27	243	195	0	16355
2830	339	22	17422	111	0	17894
2831	17485	30	292	121	0	17928
2832	18413	11	132	114	0	18670
2833	441	26	18073	92	0	18632
2834	238	30	324	18588	0	19180
2835	165	27	19466	349	0	20007
2836	129	20699	368	175	0	21371
2837	161	403	156	19602	0	20322
2838	113	20904	96	389	0	21502
2839	140	421	74	21270	0	21905
2840	100	141	21699	458	0	22398
2841	102	21402	464	180	0	22148
2842	77	22555	159	105	0	22896
2843	191	634	101	22430	0	23356
2844	22611	203	56	545	0	23415
2845	548	90	51	24559	0	25248
2846	24719	45	58	685	0	25507
2847	643	25076	57	215	0	25991
2848	27214	592	44	202	0	28052
2849	745	201	28001	112	0	29059
2850	363	105	662	27488	0	28618
2851	247	80	212	27880	0	28419
2852	118	66	27662	864	0	28710
2853	26466	90	676	371	0	27603
2854	27687	65	236	275	0	28263
2855	870	27340	148	139	0	28497
2856	467	704	87	25212	0	26470
2857	213	27093	107	605	0	28018
2858	165	704	26936	244	0	28049
2859	174	264	27250	180	0	27868
2860	221	440	855	26069	0	27585
2861	26098	101	308	711	0	27218
2862	680	25695	158	315	0	26848
2863	25931	652	117	203	0	26903
2864	750	256	25452	136	0	26594
2865	25509	151	650	165	0	26475
2866	26273	151	257	171	0	26852
2867	881	110	25841	141	0	26973
2868	438	133	701	25396	0	26668
2869	25969	106	305	732	0	27112
2870	26281	105	192	340	0	26918
2871	26463	119	150	242	0	26974
2872	1022	109	119	25671	0	26921
2873	453	111	25552	698	0	26814
2874	25398	118	704	338	0	26558
2875	840	107	25988	242	0	27177
2876	484	108	774	25175	0	26541
2877	414	105	304	25285	0	26108
2878	327	25832	218	803	0	27180
2879	262	679	25744	369	0	27054
2880	279	24588	732	268	0	25867
2881	271	25518	335	223	0	26347
2882	332	856	251	25069	0	26508
2883	260	319	25163	788	0	26530
2884	305	194	774	25127	0	26400
2885	285	153	25293	865	0	26596
2886	328	151	825	25021	0	26325
2887	307	180	356	25458	0	26301
2888	236	143	24414	1002	0	25795
2889	233	186	826	24281	0	25526
2890	240	149	24558	944	0	25891
2891	239	176	24406	444	0	25265
2892	199	24135	1013	377	0	25724
2893	24290	732	433	380	0	25835
2894	837	336	24354	266	0	25793
2895	23773	245	834	316	0	25168
2896	911	189	452	24470	0	26022
2897	416	196	24357	892	0	25861
2898	319	24250	879	502	0	25950
2899	349	760	475	24297	0	25881
2900	272	340	24603	884	0	26099
2901	340	228	883	23043	0	24494
2902	278	24308	477	863	0	25926
2903	24584	790	356	457	0	26187
2904	910	375	321	24658	0	26264
2905	24199	250	313	982	0	25744
2906	24869	201	302	551	0	25923
2907	24736	212	282	443	0	25673
2908	25183	199	309	396	0	26087
2909	24920	204	339	360	0	25823
2910	1135	24015	278	359	0	25787
2911	613	783	272	24178	0	25846
2912	463	312	291	24547	0	25613
2913	411	222	288	24572	0	25493
2914	403	203	23237	1106	0	24949
2915	374	23092	835	590	0	24891
2916	23887	740	433	428	0	25488
2917	24019	356	321	389	0	25085
2918	1109	23132	302	383	0	24926
2919	522	23886	303	366	0	25077
2920	23491	915	314	364	0	25084
2921	968	399	22915	341	0	24623
2922	550	320	885	22160	0	23915
2923	22361	247	421	883	0	23912
2924	1000	205	310	21574	0	23089
2925	482	21806	292	896	0	23476
2926	435	755	256	22073	0	23519
2927	338	381	22011	894	0	23624
2928	21330	220	871	511	0	22932
2929	22289	203	409	419	0	23320
2930	1075	180	301	20672	0	22228
2931	630	168	223	20952	0	21973
2932	19703	161	222	928	0	21014
2933	850	19458	225	478	0	21011
2934	512	647	205	19007	0	20371
2935	494	251	195	19125	0	20065
2936	17089	140	160	806	0	18195
2937	665	17261	167	436	0	18529
2938	17005	505	129	362	0	18001
2939	762	16460	143	249	0	17614
2940	374	16692	121	213	0	17400
2941	15864	594	114	247	0	16819
2942	583	15874	117	232	0	16806
2943	341	789	217	14973	0	16320
2944	237	236	14982	526	0	15981
2945	160	120	12647	230	0	13157
2946	114	96	12348	164	0	12722
2947	109	12185	423	124	0	12841
2948	10007	272	343	67	0	10689
2949	257	100	82	9387	0	9826
2950	112	63	44	9580	0	9799
2951	81	45	9355	299	0	9780
2952	9241	33	244	161	0	9679
2953	258	28	107	9619	0	10012
2954	124	36	59	9757	0	9976
2955	85	51	42	9792	0	9970
2956	9430	34	39	362	0	9865
2957	251	43	9228	176	0	9698
2958	9197	25	231	110	0	9563
2959	293	39	98	9296	0	9726
2960	146	42	9211	250	0	9649
2961	8988	38	247	145	0	9418
2962	286	50	9328	78	0	9742
2963	148	61	268	9094	0	9571
2964	107	54	9304	263	0	9728
2965	77	35	9017	130	0	9259
2966	8568	32	328	101	0	9029
2967	255	21	8826	87	0	9189
2968	119	24	302	8611	0	9056
2969	8627	31	133	254	0	9045
2970	273	32	85	8708	0	9098
2971	122	38	8548	289	0	8997
2972	87	25	8603	149	0	8864
2973	74	8609	295	100	0	9078
2974	92	212	118	8473	0	8895
2975	8225	72	107	259	0	8663
2976	243	8101	52	135	0	8531
2977	8220	217	52	104	0	8593
2978	261	82	38	8158	0	8539
2979	8127	48	59	263	0	8497
2980	287	8039	56	117	0	8499
2981	146	213	50	8074	0	8483
2982	8120	78	62	258	0	8518
2983	275	8192	44	119	0	8630
2984	136	236	56	8199	0	8627
2985	103	87	48	8341	0	8579
2986	8372	47	71	305	0	8795
2987	258	52	69	8385	0	8764
2988	122	40	70	8543	0	8775
2989	91	35	74	8767	0	8967
2990	106	27	8376	349	0	8858
2991	8251	46	266	175	0	8738
2992	299	37	88	9971	0	10395
2993	141	32	10276	386	0	10835
2994	10050	35	367	168	0	10620
2995	375	42	10524	119	0	11060
2996	149	30	399	10159	0	10737
2997	125	10382	139	356	0	11002
2998	109	335	97	10647	0	11188
2999	91	105	10670	414	0	11280
3000	78	74	11009	188	0	11349
3001	122	57	448	10985	0	11612
3002	78	53	10982	431	0	11544
3003	10549	40	423	201	0	11213
3004	394	52	10960	149	0	11555
3005	174	52	431	10677	0	11334
3006	163	41	169	10996	0	11369
3007	108	50	134	11062	0	11354
3008	10734	39	96	553	0	11422
3009	10924	37	95	274	0	11330
3010	11167	26	95	208	0	11496
3011	510	42	77	10843	0	11472
3012	205	41	97	11050	0	11393
3013	139	22	10524	528	0	11213
3014	116	19	10630	224	0	10989
3015	99	10392	448	188	0	11127
3016	146	324	199	9178	0	9847
3017	100	68	112	9011	0	9291
3018	74	9129	82	331	0	9616
3019	9209	250	77	186	0	9722
3020	305	9274	68	136	0	9783
3021	9291	286	77	119	0	9773
3022	353	98	67	9266	0	9784
3023	9338	54	71	346	0	9809
3024	343	26	67	9364	0	9800
3025	121	45	9179	359	0	9704
3026	94	37	313	9331	0	9775
3027	9170	39	118	362	0	9689
3028	324	34	95	9280	0	9733
3029	140	36	61	9376	0	9613
3030	91	53	9342	426	0	9912
3031	103	32	284	9514	0	9933
3032	101	46	109	9388	0	9644
3033	120	9206	71	385	0	9782
3034	115	259	37	9347	0	9758
3035	122	77	53	9471	0	9723
3036	95	35	50	9309	0	9489
3037	59	8644	57	371	0	9131
3038	61	220	42	8493	0	8816
3039	8108	59	45	315	0	8527
3040	227	7937	56	157	0	8377
3041	91	7714	34	121	0	7960
3042	51	7918	44	112	0	8125
3043	67	273	57	7399	0	7796
3044	63	7277	95	266	0	7701
3045	68	7687	98	139	0	7992
3046	7636	230	111	146	0	8123
3047	241	105	7457	135	0	7938
3048	7380	78	240	161	0	7859
3049	229	85	111	7571	0	7996
3050	69	59	7500	319	0	7947
3051	7239	58	298	175	0	7770
3052	235	55	7425	151	0	7866
3053	97	58	7437	129	0	7721
3054	7584	62	336	142	0	8124
3055	282	50	193	7790	0	8315
3056	123	58	7865	333	0	8379
3057	7747	48	307	232	0	8334
3058	8080	42	122	224	0	8468
3059	350	41	8031	191	0	8613
3060	8269	33	256	167	0	8725
3061	8580	32	117	156	0	8885
3062	389	27	8111	169	0	8696
3063	8161	21	267	219	0	8668
3064	8394	30	163	180	0	8767
3065	334	50	7830	158	0	8372
3066	164	69	8821	120	0	9174
3067	143	70	327	8888	0	9428
3068	109	73	8934	362	0	9478
3069	8898	97	284	228	0	9507
3070	364	89	112	8944	0	9509
3071	218	103	104	9097	0	9522
3072	192	92	8859	341	0	9484
3073	189	88	252	8767	0	9296
3074	173	53	8885	391	0	9502
3075	8913	49	300	227	0	9489
3076	9229	60	149	188	0	9626
3077	388	51	8998	189	0	9626
3078	8993	50	307	189	0	9539
3079	9394	28	116	244	0	9782
3080	371	39	9204	225	0	9839
3081	9393	38	298	257	0	9986
3082	9428	51	166	233	0	9878
3083	325	41	9373	238	0	9977
3084	9278	68	277	247	0	9870
3085	315	69	9586	254	0	10224
3086	133	57	278	9610	0	10078
3087	125	61	114	9720	0	10020
3088	137	82	98	9936	0	10253
3089	115	77	9469	427	0	10088
3090	8650	66	215	249	0	9180
3091	311	93	9097	160	0	9661
3092	109	7342	137	81	0	7669
3093	60	7427	75	53	0	7615
3094	7437	114	69	49	0	7669
3095	147	67	40	7181	0	7435
3096	72	7296	36	125	0	7529
3097	7155	72	49	55	0	7331
3098	7096	26	21	52	0	7195
3099	115	7456	49	31	0	7651
3100	84	74	35	7052	0	7245
3101	40	7281	29	81	0	7431
3102	7404	84	29	62	0	7579
3103	7485	33	37	46	0	7601
3104	144	14	20	7271	0	7449
3105	7313	16	36	103	0	7468
3106	132	15	27	7327	0	7501
3107	67	20	7281	96	0	7464
3108	7019	22	94	52	0	7187
3109	118	29	7331	25	0	7503
3110	67	25	95	7211	0	7398
3111	7384	17	42	116	0	7559
3112	127	27	22	7416	0	7592
3113	68	14	7375	107	0	7564
3114	47	11	7142	53	0	7253
3115	49	33	123	7394	0	7599
3116	7452	13	65	123	0	7653
3117	125	7613	37	46	0	7821
3118	74	85	23	7716	0	7898
3119	59	33	7806	98	0	7996
3120	7587	11	93	71	0	7762
3121	8103	18	50	47	0	8218
3122	148	10	7939	28	0	8125
3123	7966	10	103	28	0	8107
3124	135	17	35	8402	0	8589
3125	58	12	8387	86	0	8543
3126	8264	10	84	52	0	8410
3127	124	8	43	8376	0	8551
3128	66	6	32	8252	0	8356
3129	8461	6	36	126	0	8629
3130	102	8070	33	44	0	8249
3131	48	8238	28	38	0	8352
3132	8318	75	29	46	0	8468
3133	8038	20	29	48	0	8135
3134	110	12	8388	35	0	8545
3135	57	9	8147	31	0	8244
3136	55	20	101	8421	0	8597
3137	8693	8	47	108	0	8856
3138	8508	6	30	55	0	8599
3139	8694	12	28	41	0	8775
3140	114	8584	22	36	0	8756
3141	63	8774	30	20	0	8887
3142	57	88	22	9101	0	9268
3143	65	27	20	8681	0	8793
3144	46	16	27	9171	0	9260
3145	51	20	9260	104	0	9435
3146	51	21	8118	46	0	8236
3147	8996	11	114	37	0	9158
3148	9578	9	37	50	0	9674
3149	137	10	35	9587	0	9769
3150	60	10	30	9571	0	9671
3151	61	16	23	9849	0	9949
3152	37	9	9558	143	0	9747
3153	32	17	9236	63	0	9348
3154	37	37	94	9493	0	9661
3155	30	18	9755	100	0	9903
3156	35	9338	95	51	0	9519
3157	30	9721	40	31	0	9822
3158	9690	98	36	49	0	9873
3159	101	9587	29	33	0	9750
3160	46	96	35	9707	0	9884
3161	52	34	21	9724	0	9831
3162	26	10134	31	115	0	10306
3163	42	121	22	10316	0	10501
3164	40	28	10117	152	0	10337
3165	22	10081	124	57	0	10284
3166	28	109	32	9680	0	9849
3167	29	25	9723	114	0	9891
3168	27	9538	100	48	0	9713
3169	31	99	37	9386	0	9553
3170	21	9615	30	100	0	9766
3171	33	112	18	9687	0	9850
3172	42	31	25	9355	0	9453
3173	29	9521	18	124	0	9692
3174	9264	103	25	56	0	9448
3175	9074	42	28	62	0	9206
3176	126	9152	25	38	0	9341
3177	46	9419	22	49	0	9536
3178	38	117	31	9392	0	9578
3179	32	44	9219	121	0	9416
3180	8770	44	110	81	0	9005
3181	9069	34	34	59	0	9196
3182	131	39	9012	33	0	9215
3183	8789	31	110	67	0	8997
3184	9137	41	29	51	0	9258
3185	150	30	8898	41	0	9119
3186	8392	27	108	61	0	8588
3187	143	38	9072	35	0	9288
3188	60	9252	124	34	0	9470
3189	9377	111	44	55	0	9587
3190	9389	37	29	55	0	9510
3191	150	37	9323	31	0	9541
3192	9260	25	119	51	0	9455
3193	9692	29	40	58	0	9819
3194	159	23	9401	42	0	9625
3195	9565	34	107	46	0	9752
3196	9884	22	38	55	0	9999
3197	160	25	9703	29	0	9917
3198	9807	32	120	43	0	10002
3199	147	24	48	9575	0	9794
3200	79	25	35	9619	0	9758
3201	53	24	9527	135	0	9739
3202	71	24	9217	45	0	9357
3203	73	23	133	9564	0	9793
3204	62	23	51	9757	0	9893
3205	10144	16	37	151	0	10348
3206	171	21	10037	49	0	10278
3207	9938	19	142	48	0	10147
3208	180	16	46	10289	0	10531
3209	58	34	10294	141	0	10527
3210	10558	18	132	69	0	10777
3211	173	16	48	11210	0	11447
3212	60	16	11349	145	0	11570
3213	11080	17	153	66	0	11316
3214	169	10	49	11477	0	11705
3215	11628	9	42	194	0	11873
3216	174	11	12228	45	0	12458
3217	103	19	152	11488	0	11762
3218	48	12465	68	143	0	12724
3219	12592	153	49	76	0	12870
3220	12436	37	37	71	0	12581
3221	201	12829	39	39	0	13108
3222	12987	170	41	52	0	13250
3223	12834	39	35	68	0	12976
3224	12722	21	44	57	0	12844
3225	242	12523	38	28	0	12831
3226	112	156	29	12580	0	12877
3227	72	40	12758	184	0	13054
3228	90	37	186	12343	0	12656
3229	67	16	66	12588	0	12737
3230	47	22	12626	234	0	12929
3231	59	25	12200	74	0	12358
3232	93	27	204	11799	0	12123
3233	60	12583	75	146	0	12864
3234	12555	180	47	69	0	12851
3235	12302	56	27	65	0	12450
3236	258	12623	28	44	0	12953
3237	12738	185	35	54	0	13012
3238	12653	61	36	59	0	12809
3239	240	44	12661	45	0	12990
3240	12207	30	182	69	0	12488
3241	224	13030	55	59	0	13368
3242	110	171	12787	36	0	13104
3243	83	58	12229	38	0	12408
3244	51	12668	216	54	0	12989
3245	12666	168	76	64	0	12974
3246	207	53	12806	42	0	13108
3247	112	34	178	12678	0	13002
3248	71	50	12718	166	0	13005
3249	11844	27	185	88	0	12144
3250	217	36	14375	54	0	14682
3251	113	41	13956	32	0	14142
3252	13917	16	193	74	0	14200
3253	207	14707	90	31	0	15035
3254	15030	174	60	79	0	15343
3255	15137	50	62	68	0	15317
3256	242	55	45	14942	0	15284
3257	107	16265	47	141	0	16560
3258	16469	169	56	125	0	16819
3259	202	58	16545	53	0	16858
3260	15998	34	153	96	0	16281
3261	198	16865	65	41	0	17169
3262	16511	124	48	54	0	16737
3263	16482	37	62	75	0	16656
3264	178	16822	50	40	0	17090
3265	97	134	39	16964	0	17234
3266	17132	51	48	172	0	17403
3267	187	17029	35	45	0	17296
3268	92	146	38	17223	0	17499
3269	17535	53	28	168	0	17784
3270	207	54	32	18076	0	18369
3271	121	30	40	17956	0	18147
3272	72	18114	39	204	0	18429
3273	18269	174	30	116	0	18589
3274	18295	87	36	75	0	18493
3275	18790	27	28	67	0	18912
3276	244	19151	44	23	0	19462
3277	19388	179	37	92	0	19696
3278	19439	62	35	86	0	19622
3279	272	50	30	19207	0	19559
3280	125	49	28	19300	0	19502
3281	89	35	19345	217	0	19686
3282	106	37	175	18851	0	19169
3283	113	45	71	18077	0	18306
3284	91	54	19265	218	0	19628
3285	16733	51	193	167	0	17144
3286	258	34	19123	50	0	19465
3287	137	52	19133	53	0	19375
3288	107	51	210	19203	0	19571
3289	119	45	77	19242	0	19483
3290	100	19669	41	193	0	20003
3291	19549	187	30	127	0	19893
3292	19439	62	37	113	0	19651
3293	243	19429	45	67	0	19784
3294	107	20661	61	57	0	20886
3295	134	255	35	20385	0	20809
3296	68	21208	51	207	0	21534
3297	21173	240	62	152	0	21627
3298	21132	87	54	95	0	21368
3299	338	52	55	20963	0	21408
3300	160	45	47	21246	0	21498
3301	21185	35	38	352	0	21610
3302	277	65	20757	115	0	21214
3303	20062	49	231	124	0	20466
3304	334	48	20816	43	0	21241
3305	20014	26	199	81	0	20320
3306	281	58	78	20560	0	20977
3307	125	47	21021	216	0	21409
3308	87	37	20426	85	0	20635
3309	20127	87	337	111	0	20662
3310	20626	26	84	94	0	20830
3311	263	21195	56	37	0	21551
3312	130	193	27	21945	0	22295
3313	102	66	28	22363	0	22559
3314	22162	29	35	382	0	22608
3315	286	21946	39	119	0	22390
3316	21453	224	31	103	0	21811
3317	274	21137	32	41	0	21484
3318	99	21176	33	36	0	21344
3319	21047	255	23	90	0	21415
3320	267	90	20795	35	0	21187
3321	154	49	216	20518	0	20937
3322	101	24	77	20782	0	20984
3323	49	37	20899	284	0	21269
3324	88	29	208	20558	0	20883
3325	175	47	93	17589	0	17904
3326	53	21001	34	271	0	21359
3327	20866	235	30	182	0	21313
3328	271	81	21110	62	0	21524
3329	19752	57	225	105	0	20139
3330	270	21153	74	55	0	21552
3331	135	237	47	21396	0	21815
3332	21975	91	32	322	0	22420
3333	302	53	28	22025	0	22408
3334	153	22	33	22224	0	22432
3335	81	41	22040	324	0	22486
3336	20267	34	255	230	0	20786
3337	21706	35	91	164	0	21996
3338	344	53	21739	62	0	22198
3339	190	35	245	21492	0	21962
3340	104	42	21651	278	0	22075
3341	20794	31	275	195	0	21295
3342	22030	39	101	133	0	22303
3343	365	33	69	21887	0	22354
3344	21918	30	41	343	0	22332
3345	323	35	23358	152	0	23868
3346	187	28	264	23150	0	23629
3347	155	26	119	23038	0	23338
3348	106	25	84	24085	0	24300
3349	118	20	38	23991	0	24167
3350	21905	22	52	443	0	22422
3351	315	33	21593	177	0	22118
3352	167	16	273	21830	0	22286
3353	107	29	21575	310	0	22021
3354	99	33	20937	159	0	21228
3355	111	20	325	21091	0	21547
3356	115	19	131	21422	0	21687
3357	20443	19	82	418	0	20962
3358	325	24	48	20416	0	20813
3359	177	22	62	20396	0	20657
3360	120	13	57	20853	0	21043
3361	20533	12	46	514	0	21105
3362	20513	17	46	257	0	20833
3363	20777	19	57	194	0	21047
3364	20365	11	39	177	0	20592
3365	401	21944	72	95	0	22512
3366	206	331	42	22010	0	22589
3367	153	116	42	22487	0	22798
3368	23023	60	60	567	0	23710
3369	479	24391	57	268	0	25195
3370	249	465	39	25551	0	26304
3371	124	186	27119	587	0	28016
3372	27653	77	577	379	0	28686
3373	735	29460	232	193	0	30620
3374	30816	688	114	184	0	31802
3375	31768	261	64	172	0	32265
3376	1215	125	48	30904	0	32292
3377	459	93	30899	860	0	32311
3378	352	49	806	31492	0	32699
3379	31813	58	282	1024	0	33177
3380	998	62	140	31838	0	33038
3381	31830	52	85	1023	0	32990
3382	1006	31342	71	445	0	32864
3383	32708	811	77	320	0	33916
3384	1132	306	67	32575	0	34080
3385	587	148	75	35155	0	35965
3386	35646	109	65	1293	0	37113
3387	35903	94	48	586	0	36631
3388	36210	89	56	383	0	36738
3389	36233	72	72	307	0	36684
3390	36178	71	56	270	0	36575
3391	1572	66	84	34850	0	36572
3392	689	82	33733	1019	0	35523
3393	465	34196	735	484	0	35880
3394	33385	829	280	374	0	34868
3395	1121	308	32728	254	0	34411
3396	32368	169	824	282	0	33643
3397	1169	32671	310	218	0	34368
3398	33504	838	169	263	0	34774
3399	1300	332	119	32906	0	34657
3400	761	201	86	33582	0	34630
3401	518	150	32988	1214	0	34870
3402	560	92	850	32700	0	34202
3403	428	93	33576	1131	0	35228
3404	409	109	33360	566	0	34444
3405	33681	114	1104	442	0	35341
3406	35374	136	436	410	0	36356
3407	1400	155	34082	325	0	35962
3408	33588	115	923	369	0	34995
3409	34843	130	397	394	0	35764
3410	1516	131	33573	306	0	35526
3411	808	33089	888	319	0	35104
3412	851	831	423	33991	0	36096
3413	35616	325	282	1058	0	37281
3414	36570	214	235	602	0	37621
3415	36671	171	202	447	0	37491
3416	36801	151	220	418	0	37590
3417	36738	131	258	392	0	37519
3418	1611	163	35222	290	0	37286
3419	988	175	36112	270	0	37545
3420	924	223	1089	36090	0	38326
3421	36936	206	540	1050	0	38732
3422	37617	186	356	612	0	38771
3423	37408	179	275	527	0	38389
3424	35256	180	272	598	0	36306
3425	1547	35087	308	474	0	37416
3426	997	37081	314	536	0	38928
3427	37240	948	287	613	0	39088
3428	37698	405	305	529	0	38937
3429	1685	37048	262	430	0	39425
3430	37797	902	210	465	0	39374
3431	1648	429	36888	395	0	39360
3432	1161	273	905	36520	0	38859
3433	932	245	36836	1044	0	39057
3434	969	214	36385	582	0	38150
3435	987	180	1128	36485	0	38780
3436	1023	180	521	37616	0	39340
3437	994	198	38178	1185	0	40555
3438	1003	190	975	36809	0	38977
3439	956	182	491	38643	0	40272
3440	38608	205	407	1343	0	40563
3441	38749	210	400	687	0	40046
3442	1705	225	380	37935	0	40245
3443	1067	245	37644	1095	0	40051
3444	851	37616	994	604	0	40065
3445	36921	863	568	527	0	38879
3446	1466	407	37638	461	0	39972
3447	1005	35965	1033	451	0	38454
3448	812	38373	603	447	0	40235
3449	38774	977	507	565	0	40823
3450	39460	439	475	525	0	40899
3451	1579	301	482	38525	0	40887
3452	996	269	40031	1060	0	42356
3453	942	194	1111	39760	0	42007
3454	939	184	657	40385	0	42165
3455	908	173	522	41095	0	42698
3456	40537	198	477	1393	0	42605
3457	1492	39088	461	716	0	41757
3458	974	40892	467	495	0	42828
3459	906	1053	431	39782	0	42172
3460	815	490	418	41292	0	43015
3461	40715	345	379	1446	0	42885
3462	40217	283	315	827	0	41642
3463	40687	213	279	663	0	41842
3464	1830	39658	337	454	0	42279
3465	38788	726	286	425	0	40225
3466	1456	514	315	37821	0	40106
3467	988	212	37235	962	0	39397
3468	791	191	34281	527	0	35790
3469	33127	158	845	514	0	34644
3470	906	121	32821	321	0	34169
3471	517	111	30287	210	0	31125
3472	27409	74	398	227	0	28108
3473	472	63	28181	135	0	28851
3474	230	59	27190	100	0	27579
3475	241	188	312	25770	0	26511
3476	143	40	27281	208	0	27672
3477	155	38	222	26201	0	26616
3478	155	44	111	25565	0	25875
3479	111	47	27314	219	0	27691
3480	92	27487	204	145	0	27928
3481	27393	149	122	191	0	27855
3482	217	80	28336	58	0	28691
3483	119	76	27469	50	0	27714
3484	23705	43	211	168	0	24127
3485	174	31	26028	42	0	26275
3486	99	24788	181	43	0	25111
3487	128	20927	154	58	0	21267
3488	85	150	74	25342	0	25651
3489	87	66	62	24815	0	25030
3490	25769	44	46	270	0	26129
3491	25324	23	42	183	0	25572
3492	25506	19	48	146	0	25719
3493	248	26	43	25474	0	25791
3494	25667	28	40	241	0	25976
3495	25298	27	41	165	0	25531
3496	218	22	25596	69	0	25905
3497	138	39	24350	50	0	24577
3498	86	25690	190	67	0	26033
3499	78	133	88	26056	0	26355
3500	26123	59	64	226	0	26472
3501	159	25854	52	84	0	26149
3502	103	141	47	26378	0	26669
3503	25872	59	42	255	0	26228
3504	24982	49	41	171	0	25243
3505	209	25171	47	77	0	25504
3506	24943	138	37	153	0	25271
3507	24978	45	45	138	0	25206
3508	242	59	42	24926	0	25269
3509	131	56	25182	137	0	25506
3510	81	24386	159	90	0	24716
3511	67	24861	67	76	0	25071
3512	23471	143	72	121	0	23807
3513	190	88	44	22818	0	23140
3514	91	67	22748	139	0	23045
3515	83	22814	126	65	0	23088
3516	22894	134	51	132	0	23211
3517	23041	43	50	127	0	23261
3518	197	58	23294	34	0	23583
3519	158	30	154	22531	0	22873
3520	112	37	56	24354	0	24559
3521	68	29	28208	208	0	28513
3522	28418	30	325	224	0	28997
3523	35407	31	129	167	0	35734
3524	932	37	100	39540	0	40609
3525	349	40251	84	944	0	41628
3526	392	920	43	42363	0	43718
3527	172	379	42081	1175	0	43807
3528	41309	221	995	620	0	43145
3529	1214	146	404	43205	0	44969
3530	494	160	42849	1239	0	44742
3531	41315	111	1119	696	0	43241
3532	1335	109	528	42371	0	44343
3533	711	73	351	43115	0	44250
3534	42279	52	268	1678	0	44277
3535	1310	42434	283	786	0	44813
3536	42363	1037	196	651	0	44247
3537	1619	444	148	41788	0	43999
3538	41943	295	134	1487	0	43859
3539	1581	229	41626	736	0	44172
3540	799	41866	1124	571	0	44360
3541	748	1163	498	42480	0	44889
3542	42861	523	378	1501	0	45263
3543	1482	42947	289	777	0	45495
3544	921	1254	307	43382	0	45864
3545	43796	585	264	1617	0	46262
3546	43503	406	244	939	0	45092
3547	2067	339	199	42080	0	44685
3548	1132	330	41464	1659	0	44585
3549	801	309	41503	963	0	43576
3550	41169	263	1528	838	0	43798
3551	1716	40469	768	656	0	43609
3552	931	40832	545	565	0	42873
3553	40156	1507	450	583	0	42696
3554	1619	41035	415	503	0	43572
3555	1136	1538	368	40559	0	43601
3556	959	772	277	42091	0	44099
3557	41455	644	232	1920	0	44251
3558	41369	519	225	1092	0	43205
3559	41744	486	187	843	0	43260
3560	2255	437	39718	680	0	43090
3561	1480	305	1295	39995	0	43075
3562	1123	332	40061	1644	0	43160
3563	950	310	39792	950	0	42002
3564	884	318	41117	741	0	43060
3565	888	357	2004	39784	0	43033
3566	671	359	40921	1716	0	43667
3567	649	379	41807	912	0	43747
3568	673	363	2125	40702	0	43863
3569	40995	313	1174	1864	0	44346
3570	1824	310	41315	976	0	44425
3571	1101	306	1799	40534	0	43740
3572	954	260	1016	42038	0	44268
3573	792	306	41483	2162	0	44743
3574	883	309	1758	41267	0	44217
3575	775	290	41780	2086	0	44931
3576	853	328	1843	41016	0	44040
3577	790	301	1042	41970	0	44103
3578	757	242	920	42380	0	44299
3579	597	260	840	42410	0	44107
3580	39974	215	795	2745	0	43729
3581	40442	203	751	1668	0	43064
3582	2077	257	39283	1194	0	42811
3583	1158	38495	1715	1166	0	42534
3584	951	1248	39962	1042	0	43203
3585	799	534	40156	933	0	42422
3586	38493	345	2195	981	0	42014
3587	1772	39393	1437	846	0	43448
3588	39756	1372	1172	842	0	43142
3589	1854	39975	1071	806	0	43706
3590	40172	1604	981	850	0	43607
3591	41249	747	862	865	0	43723
3592	2375	590	782	39386	0	43133
3593	1344	39888	643	1927	0	43802
3594	1099	1601	604	40561	0	43865
3595	947	787	574	41694	0	44002
3596	834	543	40424	2547	0	44348
3597	793	40724	1753	1530	0	44800
3598	860	1516	977	41364	0	44717
3599	40363	725	847	2342	0	44277
3600	42403	556	777	1389	0	45125
3601	42668	480	740	1215	0	45103
3602	2299	41507	747	1008	0	45561
3603	42789	1639	675	937	0	46040
3604	2337	43700	670	812	0	47519
3605	1560	1920	580	44532	0	48592
3606	1191	918	44303	1999	0	48411
3607	1063	710	1878	43539	0	47190
3608	919	43969	995	2110	0	47993
3609	878	1858	820	44144	0	47700
3610	835	985	621	44823	0	47264
3611	683	44323	586	2653	0	48245
3612	44524	1987	548	1587	0	48646
3613	2074	971	537	44973	0	48555
3614	1075	784	43822	2418	0	48099
3615	1079	608	1787	44358	0	47832
3616	988	609	852	46074	0	48523
3617	757	583	44470	2915	0	48725
3618	945	570	1903	41974	0	45392
3619	753	43698	938	2460	0	47849
3620	865	1801	43225	1452	0	47343
3621	905	812	39971	1051	0	42739
3622	473	36762	1992	929	0	40156
3623	328	31810	806	685	0	33629
3624	242	28173	471	388	0	29274
3625	25958	964	819	410	0	28151
3626	24939	353	253	322	0	25867
3627	24974	242	153	294	0	25663
3628	957	181	164	24442	0	25744
3629	346	167	23992	857	0	25362
3630	292	183	722	23887	0	25084
3631	240	178	303	24416	0	25137
3632	23777	153	213	1022	0	25165
3633	23979	164	182	496	0	24821
3634	878	23901	165	330	0	25274
3635	23908	711	138	348	0	25105
3636	24328	280	166	300	0	25074
3637	24978	213	155	306	0	25652
3638	965	182	23985	259	0	25391
3639	402	152	23873	217	0	24644
3640	350	214	805	23313	0	24682
3641	224	160	23442	748	0	24574
3642	22402	174	692	342	0	23610
3643	23118	144	255	279	0	23796
3644	869	122	22106	149	0	23246
3645	21543	98	594	196	0	22431
3646	751	21858	278	148	0	23035
3647	22184	599	205	204	0	23192
3648	790	237	130	21807	0	22964
3649	415	167	153	21252	0	21987
3650	323	21754	96	744	0	22917
3651	21725	605	132	337	0	22799
3652	22021	258	144	229	0	22652
3653	821	21768	128	161	0	22878
3654	441	651	119	21088	0	22299
3655	359	252	109	21188	0	21908
3656	227	21141	120	774	0	22262
3657	301	617	121	21164	0	22203
3658	279	291	123	21670	0	22363
3659	21023	185	119	857	0	22184
3660	21240	140	107	442	0	21929
3661	858	146	20684	270	0	21958
3662	20529	110	570	307	0	21516
3663	745	137	20689	223	0	21794
3664	381	198	632	20207	0	21418
3665	272	132	20249	713	0	21366
3666	231	19986	624	353	0	21194
3667	344	610	269	19492	0	20715
3668	266	224	148	19950	0	20588
3669	19535	183	124	753	0	20595
3670	697	115	113	19410	0	20335
3671	335	138	18716	656	0	19845
3672	19055	125	496	383	0	20059
3673	19708	120	260	286	0	20374
3674	20056	136	149	243	0	20584
3675	20013	125	112	244	0	20494
3676	891	92	129	20674	0	21786
3677	478	87	89	21426	0	22080
3678	318	114	104	22410	0	22946
3679	290	79	144	22705	0	23218
3680	21939	74	100	1019	0	23132
3681	22162	96	127	444	0	22829
3682	969	66	113	20591	0	21739
3683	440	21106	109	751	0	22406
3684	21313	623	129	401	0	22466
3685	786	233	21000	315	0	22334
3686	372	21173	623	268	0	22436
3687	20387	598	216	267	0	21468
3688	734	20705	144	201	0	21784
3689	360	642	20537	201	0	21740
3690	20634	233	578	233	0	21678
3691	21156	181	243	160	0	21740
3692	959	117	20584	175	0	21835
3693	524	88	626	20882	0	22120
3694	396	135	241	20872	0	21644
3695	296	20848	181	812	0	22137
3696	302	632	147	20772	0	21853
3697	20019	218	122	804	0	21163
3698	721	20132	111	354	0	21318
3699	414	542	81	19206	0	20243
3700	304	186	101	19527	0	20118
3701	197	181	18779	750	0	19907
3702	223	18741	487	392	0	19843
3703	17485	547	212	268	0	18512
3704	493	15706	115	185	0	16499
3705	241	15752	75	137	0	16205
3706	15513	511	127	138	0	16289
3707	478	209	83	15227	0	15997
3708	257	145	55	15604	0	16061
3709	15478	77	73	553	0	16181
3710	500	110	40	15746	0	16396
3711	269	79	35	16080	0	16463
3712	16229	81	43	606	0	16959
3713	537	102	42	15676	0	16357
3714	248	15691	43	535	0	16517
3715	15758	426	23	286	0	16493
3716	509	161	15148	197	0	16015
3717	244	14550	383	175	0	15352
3718	199	415	144	14214	0	14972
3719	112	143	13997	474	0	14726
3720	126	125	14032	205	0	14488
3721	196	332	447	13283	0	14258
3722	13391	68	206	407	0	14072
3723	401	50	84	13275	0	13810
3724	179	48	70	13576	0	13873
3725	130	62	64	13673	0	13929
3726	130	53	73	13693	0	13949
3727	115	56	67	13809	0	14047
3728	105	57	13122	493	0	13777
3729	67	62	12907	286	0	13322
3730	133	38	408	13107	0	13686
3731	85	46	13161	433	0	13725
3732	83	13166	352	235	0	13836
3733	115	304	161	13346	0	13926
3734	74	121	12984	437	0	13616
3735	11620	84	348	285	0	12337
3736	318	12472	153	193	0	13136
3737	127	11886	98	158	0	12269
3738	93	12349	77	134	0	12653
3739	122	402	83	11899	0	12506
3740	11927	149	73	381	0	12530
3741	333	108	64	12045	0	12550
3742	11744	101	72	405	0	12322
3743	349	11570	61	202	0	12182
3744	11917	327	69	153	0	12466
3745	358	143	53	11929	0	12483
3746	219	120	37	11884	0	12260
3747	112	11801	31	433	0	12377
3748	117	324	49	11958	0	12448
3749	98	158	43	12238	0	12537
3750	136	88	36	12196	0	12456
3751	11710	99	35	516	0	12360
3752	10897	79	41	312	0	11329
3753	360	83	11552	194	0	12189
3754	11493	77	281	197	0	12048
3755	395	72	11767	155	0	12389
3756	191	65	299	11699	0	12254
3757	144	68	121	11962	0	12295
3758	112	73	89	12143	0	12417
3759	103	50	11684	476	0	12313
3760	113	66	302	11797	0	12278
3761	76	70	11865	430	0	12441
3762	117	50	310	11935	0	12412
3763	11835	47	158	445	0	12485
3764	324	51	11845	257	0	12477
3765	11802	44	319	220	0	12385
3766	362	46	125	12076	0	12609
3767	11944	58	122	414	0	12538
3768	348	11873	86	245	0	12552
3769	189	270	82	12109	0	12650
3770	104	100	12518	434	0	13156
3771	148	126	312	12439	0	13025
3772	88	213	149	12176	0	12626
3773	93	12221	97	446	0	12857
3774	106	273	12026	242	0	12647
3775	79	12023	291	204	0	12597
3776	10617	248	125	133	0	11123
3777	225	11041	72	118	0	11456
3778	10217	200	103	80	0	10600
3779	10263	66	42	81	0	10452
3780	10309	43	38	75	0	10465
3781	266	25	37	10291	0	10619
3782	106	31	10149	217	0	10503
3783	82	33	186	9882	0	10183
3784	48	10137	83	212	0	10480
3785	50	204	47	10307	0	10608
3786	10072	63	31	270	0	10436
3787	179	10140	34	104	0	10457
3788	92	175	36	9787	0	10090
3789	74	73	28	9921	0	10096
3790	9818	47	43	255	0	10163
3791	207	34	9701	117	0	10059
3792	85	9474	192	80	0	9831
3793	65	167	59	9109	0	9400
3794	46	57	9063	177	0	9343
3795	54	57	153	8733	0	8997
3796	41	8688	65	175	0	8969
3797	58	179	38	9311	0	9586
3798	44	65	36	9270	0	9415
3799	46	44	27	9227	0	9344
3800	38	29	9053	234	0	9354
3801	8693	36	161	124	0	9014
3802	177	36	50	9594	0	9857
3803	10404	26	36	245	0	10711
3804	10595	24	32	123	0	10774
3805	10756	21	28	104	0	10909
3806	10575	30	29	87	0	10721
3807	10772	19	24	81	0	10896
3808	293	31	21	10552	0	10897
3809	111	10276	20	212	0	10619
3810	99	163	30	9940	0	10232
3811	52	9842	19	200	0	10113
3812	60	163	15	9429	0	9667
3813	9480	46	14	183	0	9723
3814	171	29	9	9406	0	9615
3815	88	20	9260	170	0	9538
3816	8714	18	126	98	0	8956
3817	159	9327	40	63	0	9589
3818	9467	122	44	64	0	9697
3819	9429	51	17	63	0	9560
3820	9163	33	23	62	0	9281
3821	194	9622	10	36	0	9862
3822	96	110	13	9592	0	9811
3823	80	58	11	9651	0	9800
3824	42	34	9613	184	0	9873
3825	66	38	121	9204	0	9429
3826	78	33	40	9023	0	9174
3827	72	19	30	9567	0	9688
3828	68	9602	20	180	0	9870
3829	9747	129	22	96	0	9994
3830	9346	48	20	80	0	9494
3831	164	48	9737	58	0	10007
3832	106	9753	114	40	0	10013
3833	88	132	50	9987	0	10257
3834	85	47	32	10126	0	10290
3835	68	54	20	10138	0	10280
3836	66	43	14	10291	0	10414
3837	50	23	15	10492	0	10580
3838	50	34	10139	226	0	10449
3839	40	27	9506	135	0	9708
3840	10166	33	176	113	0	10488
3841	10818	23	71	98	0	11010
3842	10903	43	41	77	0	11064
3843	248	34	33	10879	0	11194
3844	135	28	10695	198	0	11056
3845	10568	18	162	114	0	10862
3846	10943	29	76	90	0	11138
3847	223	35	10534	78	0	10870
3848	10372	26	172	107	0	10677
3849	244	24	11578	81	0	11927
3850	128	14	194	11736	0	12072
3851	91	30	11775	227	0	12123
3852	11371	14	215	119	0	11719
3853	11898	21	96	105	0	12120
3854	11978	26	77	88	0	12169
3855	11891	16	57	80	0	12044
3856	312	24	12382	57	0	12775
3857	145	12400	184	76	0	12805
3858	12715	161	84	94	0	13054
3859	12777	57	72	98	0	13004
3860	284	56	12744	67	0	13151
3861	185	24	208	12466	0	12883
3862	152	24	77	12990	0	13243
3863	100	18	12803	247	0	13168
3864	11860	28	231	128	0	12247
3865	12897	19	92	125	0	13133
3866	290	12892	83	67	0	13332
3867	13441	181	48	92	0	13762
3868	13421	57	50	79	0	13607
3869	13625	50	47	93	0	13815
3870	13201	28	83	71	0	13383
3871	337	29	12747	60	0	13173
3872	12513	27	197	78	0	12815
3873	335	104	90	12604	0	13133
3874	178	12984	68	197	0	13427
3875	127	167	12746	96	0	13136
3876	106	12859	204	89	0	13258
3877	133	223	96	12198	0	12650
3878	92	58	12549	162	0	12861
3879	11694	32	170	86	0	11982
3880	219	34	12440	57	0	12750
3881	12285	32	174	64	0	12555
3882	244	17	76	12401	0	12738
3883	148	30	61	12344	0	12583
3884	119	12149	40	197	0	12505
3885	94	12609	63	86	0	12852
3886	104	168	55	12986	0	13313
3887	12799	61	53	197	0	13110
3888	12729	56	49	88	0	12922
3889	12701	32	54	79	0	12866
3890	250	27	12848	50	0	13175
3891	12438	28	157	82	0	12705
3892	216	26	13517	66	0	13825
3893	141	27	12695	53	0	12916
3894	13090	42	209	57	0	13398
3895	13622	26	97	45	0	13790
3896	250	26	13516	50	0	13842
3897	134	21	169	13165	0	13489
3898	142	30	62	13816	0	14050
3899	13796	35	63	191	0	14085
3900	13453	32	60	102	0	13647
3901	238	21	14403	88	0	14750
3902	122	13881	142	51	0	14196
3903	103	13563	59	34	0	13759
3904	13692	111	65	51	0	13919
3905	179	48	51	13567	0	13845
3906	104	32	40	13758	0	13934
3907	92	26	40	14066	0	14224
3908	13875	12	41	162	0	14090
3909	173	27	40	14136	0	14376
3910	14222	20	27	159	0	14428
3911	14644	17	43	71	0	14775
3912	200	15555	43	61	0	15859
3913	136	130	35	16933	0	17234
3914	115	56	17031	171	0	17373
3915	16390	51	181	110	0	16732
3916	17027	39	92	91	0	17249
3917	17129	28	59	84	0	17300
3918	298	31	17560	44	0	17933
3919	175	18	190	17636	0	18019
3920	18024	15	85	225	0	18349
3921	17118	23	77	125	0	17343
3922	17294	28	58	88	0	17468
3923	322	17064	42	66	0	17494
3924	174	17785	51	53	0	18063
3925	133	213	36	18227	0	18609
3926	108	95	30	18109	0	18342
3927	111	18102	26	241	0	18480
3928	18115	178	39	161	0	18493
3929	261	80	18503	77	0	18921
3930	173	58	180	18474	0	18885
3931	135	61	77	18524	0	18797
3932	97	45	18391	242	0	18775
3933	17114	37	201	175	0	17527
3934	18640	38	99	113	0	18890
3935	310	18374	57	67	0	18808
3936	18433	174	60	84	0	18751
3937	267	91	19314	59	0	19731
3938	19385	48	195	150	0	19778
3939	284	44	20213	48	0	20589
3940	19928	37	213	83	0	20261
3941	20682	31	110	70	0	20893
3942	20768	37	71	62	0	20938
3943	20625	15	59	67	0	20766
3944	305	20314	48	53	0	20720
3945	20906	164	35	65	0	21170
3946	21249	70	52	73	0	21444
3947	324	57	21141	35	0	21557
3948	21083	41	155	52	0	21331
3949	282	41	76	20837	0	21236
3950	163	31	20645	180	0	21019
3951	20528	31	189	100	0	20848
3952	289	21	82	21065	0	21457
3953	21470	21	67	230	0	21788
3954	23061	26	43	196	0	23326
3955	325	37	24308	66	0	24736
3956	23978	26	176	138	0	24318
3957	24803	15	102	85	0	25005
3958	24755	37	50	93	0	24935
3959	25095	23	42	96	0	25256
3960	376	21	54	24513	0	24964
3961	227	24520	56	195	0	24998
3962	23790	172	69	176	0	24207
3963	24993	81	40	107	0	25221
3964	25103	50	47	112	0	25312
3965	375	43	24916	39	0	25373
3966	227	24802	202	53	0	25284
3967	211	183	104	24934	0	25432
3968	191	82	81	25139	0	25493
3969	183	59	25686	238	0	26166
3970	211	31	241	25402	0	25885
3971	178	31	25840	289	0	26338
3972	177	42	288	25634	0	26141
3973	169	41	114	26016	0	26340
3974	142	45	26035	375	0	26597
3975	24695	63	278	240	0	25276
3976	26395	31	126	226	0	26778
3977	418	50	26755	119	0	27342
3978	25999	53	288	154	0	26494
3979	26928	38	128	139	0	27233
3980	433	39	27883	101	0	28456
3981	270	44	309	27439	0	28062
3982	254	29	135	27948	0	28366
3983	28345	20	137	408	0	28910
3984	358	28851	100	210	0	29519
3985	26659	268	89	285	0	27301
3986	28761	108	87	150	0	29106
3987	435	29356	81	98	0	29970
3988	29710	262	80	158	0	30210
3989	29827	124	80	120	0	30151
3990	507	29290	77	76	0	29950
3991	300	281	71	29546	0	30198
3992	246	29578	70	274	0	30168
3993	241	306	80	29848	0	30475
3994	211	161	29700	341	0	30413
3995	211	91	29053	181	0	29536
3996	28836	74	361	217	0	29488
3997	29875	77	167	153	0	30272
3998	469	76	30010	92	0	30647
3999	29487	54	333	141	0	30015
4000	30504	31	161	157	0	30853
4001	29667	40	143	153	0	30003
4002	542	30153	116	71	0	30882
4003	345	274	66	30854	0	31539
4004	30850	132	72	395	0	31449
4005	30484	76	88	245	0	30893
4006	537	78	31138	124	0	31877
4007	382	49	303	30550	0	31284
4008	293	81	160	31111	0	31645
4009	210	31047	119	384	0	31760
4010	226	33106	85	225	0	33642
4011	258	600	76	31698	0	32632
4012	156	32336	85	417	0	32994
4013	31238	360	63	191	0	31852
4014	430	32433	55	105	0	33023
4015	32809	450	51	184	0	33494
4016	551	156	32799	60	0	33566
4017	33168	82	436	162	0	33848
4018	34830	55	129	135	0	35149
4019	34826	56	90	123	0	35095
4020	34488	56	56	146	0	34746
4021	757	33950	46	97	0	34850
4022	394	486	56	34489	0	35425
4023	291	182	47	34105	0	34625
4024	194	128	34154	664	0	35140
4025	231	91	500	33276	0	34098
4026	220	84	175	34140	0	34619
4027	34532	95	100	787	0	35514
4028	624	35012	90	334	0	36060
4029	361	510	77	35294	0	36242
4030	316	224	81	35897	0	36518
4031	296	150	53	36363	0	36862
4032	35857	129	51	932	0	36969
4033	723	108	80	36128	0	37039
4034	36281	97	83	860	0	37321
4035	788	58	97	36440	0	37383
4036	420	45	96	36942	0	37503
4037	310	76	34598	886	0	35870
4038	31436	86	536	574	0	32632
4039	750	34085	199	321	0	35355
4040	35054	592	115	337	0	36098
4041	809	213	101	34671	0	35794
4042	398	134	77	35302	0	35911
4043	35906	91	72	979	0	37048
4044	36650	75	64	511	0	37300
4045	1027	127	34	38033	0	39221
4046	452	99	38165	904	0	39620
4047	296	81	37296	470	0	38143
4048	225	39348	814	366	0	40753
4049	39768	768	347	377	0	41260
4050	40093	272	165	312	0	40842
4051	1172	197	90	39835	0	41294
4052	500	40626	88	928	0	42142
4053	428	838	89	40716	0	42071
4054	338	298	102	39121	0	39859
4055	305	36733	110	1142	0	38290
4056	37258	835	135	539	0	38767
4057	1080	350	99	37158	0	38687
4058	466	37244	136	966	0	38812
4059	383	39404	121	463	0	40371
4060	39115	1027	122	435	0	40699
4061	1113	446	38751	270	0	40580
4062	38979	307	828	314	0	40428
4063	1231	211	290	39394	0	41126
4064	586	233	198	39460	0	40477
4065	396	39430	156	1201	0	41183
4066	468	998	131	39607	0	41204
4067	425	404	39455	1166	0	41450
4068	359	38300	857	599	0	40115
4069	313	39698	294	471	0	40776
4070	38754	1076	217	496	0	40543
4071	985	39353	167	368	0	40873
4072	545	1056	113	39097	0	40811
4073	423	39498	142	1046	0	41109
4074	426	1006	115	39624	0	41171
4075	372	486	100	40255	0	41213
4076	301	367	38584	1426	0	40678
4077	346	332	859	38288	0	39825
4078	332	314	344	39385	0	40375
4079	38240	314	283	1429	0	40266
4080	1112	287	37583	745	0	39727
4081	605	308	867	38560	0	40340
4082	467	310	38292	1303	0	40372
4083	37216	300	978	841	0	39335
4084	1121	38620	416	695	0	40852
4085	40540	1069	312	675	0	42596
4086	1320	471	242	41484	0	43517
4087	682	354	196	41900	0	43132
4088	490	353	40804	1665	0	43312
4089	37457	311	1027	1058	0	39853
4090	1237	41209	409	719	0	43574
4091	40746	1163	301	691	0	42901
4092	1414	538	264	40649	0	42865
4093	718	40946	262	1369	0	43295
4094	40817	1170	264	859	0	43110
4095	1328	41553	206	713	0	43800
4096	721	1287	189	41575	0	43772
4097	624	585	205	42369	0	43783
4098	541	446	248	42068	0	43303
4099	441	40814	254	1782	0	43291
4100	512	1167	270	41478	0	43427
4101	540	619	189	42429	0	43777
4102	40470	555	171	1804	0	43000
4103	40881	435	175	1018	0	42509
4104	40956	456	185	827	0	42424
4105	1655	455	39912	702	0	42724
4106	39944	440	1038	758	0	42180
4107	41037	414	424	713	0	42588
4108	39089	414	292	798	0	40593
4109	1624	429	36353	679	0	39085
4110	37631	351	757	697	0	39436
4111	1418	346	388	38385	0	40537
4112	784	328	37452	1322	0	39886
4113	637	37129	997	749	0	39512
4114	650	1262	392	35170	0	37474
4115	486	34716	323	1116	0	36641
4116	486	35788	233	658	0	37165
4117	33983	993	283	581	0	35840
4118	1032	418	242	33911	0	35603
4119	34118	307	213	1092	0	35730
4120	1110	264	169	34130	0	35673
4121	33981	269	170	1101	0	35521
4122	1152	275	172	33894	0	35493
4123	33858	286	148	1144	0	35436
4124	1070	281	32572	552	0	34475
4125	635	293	740	32760	0	34428
4126	476	307	32940	990	0	34713
4127	495	241	31358	549	0	32643
4128	401	286	32635	502	0	33824
4129	424	266	915	31733	0	33338
4130	321	230	32073	1038	0	33662
4131	31292	194	788	605	0	32879
4132	890	208	311	31918	0	33327
4133	460	198	32248	1000	0	33906
4134	463	162	751	32116	0	33492
4135	426	171	321	32605	0	33523
4136	382	165	33783	1048	0	35378
4137	454	157	769	33598	0	34978
4138	427	120	366	33153	0	34066
4139	404	34074	298	988	0	35764
4140	34011	609	239	635	0	35494
4141	34231	251	261	506	0	35249
4142	991	190	33322	422	0	34925
4143	31604	124	667	460	0	32855
4144	834	121	31005	367	0	32327
4145	392	117	28885	251	0	29645
4146	353	90	29039	269	0	29751
4147	409	511	719	27472	0	29111
4148	214	88	28287	544	0	29133
4149	229	108	485	27391	0	28213
4150	199	72	251	27749	0	28271
4151	222	74	208	27893	0	28397
4152	234	72	141	27716	0	28163
4153	26964	73	131	758	0	27926
4154	27280	68	156	426	0	27930
4155	588	27879	150	302	0	28919
4156	290	374	145	28134	0	28943
4157	230	173	28520	497	0	29420
4158	217	28366	490	299	0	29372
4159	254	499	223	29084	0	30060
4160	166	196	29447	582	0	30391
4161	197	126	520	28595	0	29438
4162	126	92	29077	625	0	29920
4163	125	73	28573	297	0	29068
4164	164	70	633	29007	0	29874
4165	160	65	272	29212	0	29709
4166	28859	44	213	796	0	29912
4167	541	54	136	28854	0	29585
4168	28274	49	118	753	0	29194
4169	530	28019	122	353	0	29024
4170	241	29113	117	262	0	29733
4171	246	501	92	29630	0	30469
4172	29543	206	141	609	0	30499
4173	543	29698	120	287	0	30648
4174	271	500	127	30498	0	31396
4175	31755	161	128	713	0	32757
4176	32031	119	100	396	0	32646
4177	31222	89	115	340	0	31766
4178	30954	53	141	302	0	31450
4179	32861	60	113	274	0	33308
4180	783	86	31579	176	0	32624
4181	324	77	30818	160	0	31379
4182	223	31144	549	135	0	32051
4183	270	528	267	30917	0	31982
4184	138	141	32397	484	0	33160
4185	120	100	31041	163	0	31424
4186	156	188	503	29994	0	30841
4187	87	57	32902	454	0	33500
4188	87	67	32448	160	0	32762
4189	71	41086	601	158	0	41916
4190	40771	799	232	238	0	42040
4191	788	43931	182	99	0	45000
4192	329	935	123	44705	0	46092
4193	45597	197	118	1030	0	46942
4194	964	46512	129	243	0	47848
4195	390	960	107	46044	0	47501
4196	184	222	46777	991	0	48174
4197	46801	158	967	327	0	48253
4198	48329	144	217	326	0	49016
4199	49315	98	169	269	0	49851
4200	1368	125	140	48889	0	50522
4201	389	162	48954	1080	0	50585
4202	246	48732	1050	335	0	50363
4203	354	1018	267	49210	0	50849
4204	48648	270	168	1225	0	50311
4205	1212	206	48952	295	0	50665
4206	372	47468	1065	277	0	49182
4207	290	1028	48337	222	0	49877
4208	48264	263	1113	300	0	49940
4209	50536	218	326	277	0	51357
4210	50439	142	234	317	0	51132
4211	1441	129	48863	181	0	50614
4212	506	48197	1142	211	0	50056
4213	480	1066	354	48530	0	50430
4214	429	273	296	49793	0	50791
4215	413	191	241	50061	0	50906
4216	316	202	48636	1392	0	50546
4217	47232	147	1171	621	0	49171
4218	1248	215	49104	338	0	50905
4219	49476	169	1221	403	0	51269
4220	51132	170	416	365	0	52083
4221	51314	182	276	344	0	52116
4222	50201	202	252	359	0	51014
4223	1620	179	49898	216	0	51913
4224	824	198	1175	49901	0	52098
4225	537	243	49364	1240	0	51384
4226	511	47718	1224	454	0	49907
4227	439	50830	446	376	0	52091
4228	50627	1335	310	430	0	52702
4229	49360	450	376	407	0	50593
4230	1502	51007	334	371	0	53214
4231	51480	1270	333	397	0	53480
4232	1723	499	41818	349	0	44389
4233	49890	346	939	378	0	51553
4234	1667	51895	453	279	0	54294
4235	53185	1300	367	327	0	55179
4236	52501	483	333	351	0	53668
4237	1953	367	299	50813	0	53432
4238	914	313	363	51915	0	53505
4239	51068	324	335	1667	0	53394
4240	1774	327	344	50888	0	53333
4241	51112	329	338	1547	0	53326
4242	1912	345	303	51038	0	53598
4243	50660	272	356	1572	0	52860
4244	50714	267	342	710	0	52033
4245	1934	49027	352	459	0	51772
4246	986	51258	368	430	0	53042
4247	49444	1472	379	479	0	51774
4248	1694	50468	347	445	0	52954
4249	902	1534	384	49724	0	52544
4250	900	554	337	50827	0	52618
4251	49137	454	327	1777	0	51695
4252	1710	49153	328	791	0	51982
4253	980	47953	341	621	0	49895
4254	864	49363	393	519	0	51139
4255	870	1612	47653	510	0	50645
4256	864	626	47140	501	0	49131
4257	915	574	47787	465	0	49741
4258	968	911	1520	41637	0	45036
4259	831	45943	552	1205	0	48531
4260	46089	1470	359	640	0	48558
4261	1660	630	45426	530	0	48246
4262	867	459	45198	512	0	47036
4263	789	443	46579	416	0	48227
4264	844	395	1584	45427	0	48250
4265	851	379	628	46564	0	48422
4266	890	422	457	47037	0	48806
4267	46509	387	458	1552	0	48906
4268	46421	426	491	640	0	47978
4269	46905	396	506	517	0	48324
4270	1888	370	525	45140	0	47923
4271	842	363	44018	1299	0	46522
4272	726	420	45041	560	0	46747
4273	821	276	1428	44560	0	47085
4274	834	288	590	44627	0	46339
4275	43218	311	433	1523	0	45485
4276	1603	42704	427	694	0	45428
4277	42800	1115	406	614	0	44935
4278	1591	42374	458	512	0	44935
4279	901	1160	388	42339	0	44788
4280	731	400	42093	1458	0	44682
4281	853	395	1149	41798	0	44195
4282	42112	297	430	1508	0	44347
4283	1596	281	41510	666	0	44053
4284	39509	250	1121	548	0	41428
4285	1601	258	39403	428	0	41690
4286	949	241	38485	407	0	40082
4287	35753	217	1172	474	0	37616
4288	1431	209	36489	411	0	38540
4289	470	122	27599	167	0	28358
4290	476	27444	1009	207	0	29136
4291	25010	510	923	291	0	26734
4292	24092	157	256	166	0	24671
4293	23947	88	113	166	0	24314
4294	492	93	22885	104	0	23574
4295	21754	73	380	151	0	22358
4296	406	22546	165	93	0	23210
4297	21790	318	104	126	0	22338
4298	420	117	21838	69	0	22444
4299	285	343	336	20546	0	21510
4300	132	61	20514	252	0	20959
4301	112	20491	306	109	0	21018
4302	152	243	198	19980	0	20573
4303	112	83	92	20452	0	20739
4304	20844	40	74	359	0	21317
4305	20715	39	76	150	0	20980
4306	20747	23	74	147	0	20991
4307	20624	39	71	101	0	20835
4308	20342	55	55	103	0	20555
4309	374	34	20263	78	0	20749
4310	211	36	256	19944	0	20447
4311	138	41	20945	258	0	21382
4312	151	40	295	20790	0	21276
4313	21082	43	112	332	0	21569
4314	21414	46	64	154	0	21678
4315	21476	39	76	127	0	21718
4316	21632	38	68	124	0	21862
4317	418	35	21975	81	0	22509
4318	196	44	320	21766	0	22326
4319	139	53	21733	325	0	22250
4320	137	21836	330	132	0	22435
4321	141	21591	139	87	0	21958
4322	211	343	109	20783	0	21446
4323	143	103	78	23354	0	23678
4324	184	43	99	22835	0	23161
4325	145	33	69	24575	0	24822
4326	24110	24	90	547	0	24771
4327	421	24024	77	212	0	24734
4328	23323	343	57	139	0	23862
4329	470	112	50	23103	0	23735
4330	245	62	53	22732	0	23092
4331	121	23094	67	428	0	23710
4332	170	343	50	23205	0	23768
4333	23082	115	52	452	0	23701
4334	395	21856	45	175	0	22471
4335	126	21579	41	114	0	21860
4336	21334	385	37	146	0	21902
4337	415	120	37	21393	0	21965
4338	148	21346	40	386	0	21920
4339	181	347	37	21611	0	22176
4340	21603	122	36	488	0	22249
4341	420	95	31	21555	0	22101
4342	194	57	31	21816	0	22098
4343	21519	46	28	557	0	22150
4344	453	66	28	21453	0	22000
4345	168	21513	35	457	0	22173
4346	191	369	20	21367	0	21947
4347	126	21370	23	446	0	21965
4348	132	409	20	21537	0	22098
4349	21313	142	32	529	0	22016
4350	21650	112	27	237	0	22026
4351	512	97	28	21720	0	22357
4352	216	98	21297	436	0	22047
4353	20559	70	328	265	0	21222
4354	437	84	21284	172	0	21977
4355	21013	70	379	225	0	21687
4356	21501	43	113	217	0	21874
4357	518	65	20882	136	0	21601
4358	196	20697	358	154	0	21405
4359	20647	393	130	147	0	21317
4360	20530	122	62	212	0	20926
4361	466	123	21077	118	0	21784
4362	20680	84	352	215	0	21331
4363	20805	63	109	183	0	21160
4364	20896	75	61	168	0	21200
4365	569	52	49	20564	0	21234
4366	304	52	50	20634	0	21040
4367	196	20664	63	471	0	21394
4368	208	341	70	21242	0	21861
4369	197	130	48	21306	0	21681
4370	158	96	20949	500	0	21703
4371	133	86	20036	247	0	20502
4372	19119	78	428	201	0	19826
4373	20317	71	172	162	0	20722
4374	541	20129	103	127	0	20900
4375	296	365	71	20303	0	21035
4376	209	140	20523	440	0	21312
4377	217	111	385	20632	0	21345
4378	235	86	141	20764	0	21226
4379	223	70	78	21552	0	21923
4380	138	21483	79	600	0	22300
4381	170	425	63	21859	0	22517
4382	178	171	58	22501	0	22908
4383	143	119	22041	647	0	22950
4384	121	99	22036	337	0	22593
4385	21143	87	531	318	0	22079
4386	22217	84	214	219	0	22734
4387	644	76	136	23611	0	24467
4388	353	95	86	23243	0	23777
4389	268	84	87	23772	0	24211
4390	160	99	22517	792	0	23568
4391	142	22043	525	405	0	23115
4392	165	548	22138	299	0	23150
4393	21577	203	604	307	0	22691
4394	616	143	22317	238	0	23314
4395	22068	98	627	250	0	23043
4396	21605	97	216	279	0	22197
4397	22627	104	154	245	0	23130
4398	836	99	124	22313	0	23372
4399	341	92	22225	709	0	23367
4400	237	22671	622	325	0	23855
4401	267	566	217	22418	0	23468
4402	248	184	153	23402	0	23987
4403	178	121	23977	843	0	25119
4404	160	23448	682	417	0	24707
4405	24134	656	272	336	0	25398
4406	725	24954	213	239	0	26131
4407	26834	819	160	201	0	28014
4408	1055	272	154	26791	0	28272
4409	421	182	27373	856	0	28832
4410	330	27595	838	340	0	29103
4411	27717	802	323	334	0	29176
4412	974	264	27771	256	0	29265
4413	27728	183	938	237	0	29086
4414	28396	146	360	225	0	29127
4415	1192	146	28041	190	0	29569
4416	27490	100	941	233	0	28764
4417	27974	104	359	217	0	28654
4418	27469	114	281	205	0	28069
4419	1267	26653	224	139	0	28283
4420	25976	823	146	182	0	27127
4421	1103	26306	168	148	0	27725
4422	459	877	26206	172	0	27714
4423	354	26337	804	143	0	27638
4424	25474	897	432	165	0	26968
4425	25893	309	224	153	0	26579
4426	26227	206	186	152	0	26771
4427	1213	138	168	25034	0	26553
4428	623	138	141	25903	0	26805
4429	24639	113	173	952	0	25877
4430	25949	127	117	362	0	26555
4431	1207	96	133	25015	0	26451
4432	533	120	24797	818	0	26268
4433	383	23597	746	282	0	25008
4434	293	24990	267	212	0	25762
4435	390	870	202	24395	0	25857
4436	246	361	24641	752	0	26000
4437	368	288	740	23288	0	24684
4438	275	24129	266	757	0	25427
4439	353	731	218	24207	0	25509
4440	288	288	24198	836	0	25610
4441	336	198	738	24313	0	25585
4442	274	171	25297	922	0	26664
4443	313	163	825	25241	0	26542
4444	276	139	26169	907	0	27491
4445	231	189	26138	374	0	26932
4446	25280	155	986	318	0	26739
4447	26318	190	408	270	0	27186
4448	26512	156	312	224	0	27204
4449	1099	25842	246	203	0	27390
4450	620	732	225	26314	0	27891
4451	25264	307	209	888	0	26668
4452	26754	231	190	397	0	27572
4453	26614	195	179	358	0	27346
4454	1118	143	26151	285	0	27697
4455	560	24555	777	276	0	26168
4456	439	26571	342	225	0	27577
4457	26292	859	333	257	0	27741
4458	992	387	261	26143	0	27783
4459	26355	282	242	826	0	27705
4460	1069	254	26017	305	0	27645
4461	630	198	772	25504	0	27104
4462	554	198	342	25986	0	27080
4463	495	195	275	25272	0	26237
4464	399	25973	252	944	0	27568
4465	26021	745	195	497	0	27458
4466	26321	316	223	368	0	27228
4467	1135	25759	219	274	0	27387
4468	603	830	216	25401	0	27050
4469	25725	345	205	843	0	27118
4470	1113	297	186	25526	0	27122
4471	25528	241	174	945	0	26888
4472	1051	25349	204	417	0	27021
4473	25334	817	178	344	0	26673
4474	1077	377	24869	279	0	26602
4475	594	25018	729	269	0	26610
4476	450	824	25111	283	0	26668
4477	559	603	873	24566	0	26601
4478	24627	282	395	850	0	26154
4479	25028	218	277	353	0	25876
4480	24877	195	197	334	0	25603
4481	1216	153	167	23885	0	25421
4482	24054	129	185	859	0	25227
4483	1094	146	154	23684	0	25078
4484	23727	149	163	928	0	24967
4485	24201	140	161	469	0	24971
4486	1075	176	23670	346	0	25267
4487	490	136	21913	220	0	22759
4488	392	169	21892	180	0	22633
4489	306	175	698	21212	0	22391
4490	21548	101	433	638	0	22720
4491	668	146	261	21776	0	22851
4492	416	89	177	22358	0	23040
4493	22981	97	167	818	0	24063
4494	23089	85	131	424	0	23729
4495	23266	76	148	366	0	23856
4496	23487	75	136	296	0	23994
4497	976	80	130	22887	0	24073
4498	22531	77	130	655	0	23393
4499	778	22201	146	273	0	23398
4500	21904	432	131	301	0	22768
4501	21858	153	139	266	0	22416
4502	710	148	20676	148	0	21682
4503	19237	98	389	166	0	19890
4504	589	71	19177	129	0	19966
4505	257	51	17763	115	0	18186
4506	243	71	17766	99	0	18179
4507	193	333	330	15273	0	16129
4508	90	20	15763	196	0	16069
4509	114	64	208	14757	0	15143
4510	63	21	15047	183	0	15314
4511	58	21	15436	75	0	15590
4512	86	40	162	14907	0	15195
4513	89	17	75	15769	0	15950
4514	52	13	16328	157	0	16550
4515	15511	13	134	108	0	15766
4516	187	10	55	16109	0	16361
4517	115	8	41	16320	0	16484
4518	16299	16	28	207	0	16550
4519	173	11	23	16555	0	16762
4520	86	12	16448	159	0	16705
4521	67	17	15376	59	0	15519
4522	51	40	132	15136	0	15359
4523	36	14	15484	125	0	15659
4524	21	15896	149	75	0	16141
4525	70	88	69	15611	0	15838
4526	15927	34	50	168	0	16179
4527	108	30	16068	63	0	16269
4528	15652	8	123	87	0	15870
4529	152	8	59	16605	0	16824
4530	88	10	49	16737	0	16884
4531	66	9	27	16857	0	16959
4532	47	7	23	16764	0	16841
4533	16684	5	45	228	0	16962
4534	132	17574	31	96	0	17833
4535	86	128	25	17965	0	18204
4536	59	56	32	17965	0	18112
4537	56	34	35	17999	0	18124
4538	47	11	30	18028	0	18116
4539	17836	9	38	298	0	18181
4540	163	17765	43	122	0	18093
4541	17552	139	27	121	0	17839
4542	176	16555	36	64	0	16831
4543	74	16788	38	64	0	16964
4544	16207	164	37	85	0	16493
4545	189	70	16496	57	0	16812
4546	110	49	157	16519	0	16835
4547	16850	21	62	242	0	17175
4548	16953	16	50	167	0	17186
4549	14368	71	54	248	0	14741
4550	17021	22	27	104	0	17174
4551	231	17759	26	86	0	18102
4552	17913	204	26	117	0	18260
4553	18345	80	18	114	0	18557
4554	295	19203	35	103	0	19636
4555	169	264	20	19647	0	20100
4556	91	107	19773	320	0	20291
4557	110	61	273	19723	0	20167
4558	19389	43	100	393	0	19925
4559	313	51	20278	139	0	20781
4560	120	19837	296	115	0	20368
4561	99	307	20408	64	0	20878
4562	120	126	323	19065	0	19634
4563	82	19529	126	263	0	20000
4564	20098	297	59	172	0	20626
4565	329	20381	52	105	0	20867
4566	208	321	30	20285	0	20844
4567	138	117	56	20859	0	21170
4568	20532	80	44	424	0	21080
4569	388	51	39	20124	0	20602
4570	156	20355	60	327	0	20898
4571	20415	323	36	218	0	20992
4572	20493	124	44	176	0	20837
4573	381	20710	55	95	0	21241
4574	20672	335	37	128	0	21172
4575	352	20387	60	98	0	20897
4576	20114	358	46	130	0	20648
4577	347	20265	40	113	0	20765
4578	216	350	71	19303	0	19940
4579	172	147	39	20584	0	20942
4580	20329	111	35	436	0	20911
4581	20798	91	41	218	0	21148
4582	441	20615	22	117	0	21195
4583	221	355	20352	91	0	21019
4584	20484	165	294	137	0	21080
4585	431	126	106	20795	0	21458
4586	185	20822	71	352	0	21430
4587	217	357	27	21055	0	21656
4588	21035	171	30	430	0	21666
4589	21140	129	22	232	0	21523
4590	21375	106	29	176	0	21686
4591	551	87	39	20984	0	21661
4592	265	130	20925	364	0	21684
4593	19626	95	311	248	0	20280
4594	20063	104	123	190	0	20480
4595	20736	112	72	143	0	21063
4596	551	20344	58	121	0	21074
4597	283	385	47	20541	0	21256
4598	203	20959	55	392	0	21609
4599	237	431	50	20940	0	21658
4600	200	181	44	21586	0	22011
4601	167	124	22811	505	0	23607
4602	198	96	418	24091	0	24803
4603	227	83	145	24981	0	25436
4604	24782	99	93	737	0	25711
4605	591	24990	66	296	0	25943
4606	25036	548	49	221	0	25854
4607	25986	227	55	219	0	26487
4608	811	191	46	25534	0	26582
4609	365	129	25860	591	0	26945
4610	249	24861	509	299	0	25918
4611	179	25275	173	203	0	25830
4612	24580	640	117	240	0	25577
4613	640	24918	92	152	0	25802
4614	360	609	58	24299	0	25326
4615	302	247	58	25035	0	25642
4616	195	189	24496	716	0	25596
4617	206	149	24040	333	0	24728
4618	196	24373	641	217	0	25427
4619	250	590	233	24372	0	25445
4620	24375	287	120	656	0	25438
4621	693	194	89	24692	0	25668
4622	312	193	24935	685	0	26125
4623	279	183	548	24772	0	25782
4624	24038	146	226	741	0	25151
4625	24205	159	128	392	0	24884
4626	752	24014	135	247	0	25148
4627	23969	615	110	284	0	24978
4628	697	24020	118	185	0	25020
4629	23864	649	75	256	0	24844
4630	779	295	84	23425	0	24583
4631	365	199	23213	661	0	24438
4632	257	194	22543	319	0	23313
4633	241	23692	657	245	0	24835
4634	270	564	279	22848	0	23961
4635	299	239	163	23658	0	24359
4636	23468	184	114	790	0	24556
4637	23737	168	109	375	0	24389
4638	24246	146	75	349	0	24816
4639	873	166	99	23793	0	24931
4640	481	165	109	24223	0	24978
4641	326	191	98	24563	0	25178
4642	282	135	24048	783	0	25248
4643	217	186	23477	362	0	24242
4644	23131	160	641	334	0	24266
4645	23416	147	244	329	0	24136
4646	732	163	23565	211	0	24671
4647	22958	135	577	276	0	23946
4648	22603	150	214	330	0	23297
4649	761	109	22814	276	0	23960
4650	360	22814	607	269	0	24050
4651	372	548	245	22310	0	23475
4652	287	193	23024	611	0	24115
4653	268	23731	545	341	0	24885
4654	315	565	193	21685	0	22758
4655	212	22603	169	559	0	23543
4656	227	505	22118	264	0	23114
4657	207	206	22415	207	0	23035
4658	260	223	655	22377	0	23515
4659	22581	129	252	595	0	23557
4660	632	135	185	22562	0	23514
4661	22462	134	153	597	0	23346
4662	676	141	127	22539	0	23483
4663	323	146	22204	590	0	23263
4664	21436	116	567	368	0	22487
4665	579	136	22102	237	0	23054
4666	22171	112	606	266	0	23155
4667	625	130	309	21884	0	22948
4668	275	22224	204	587	0	23290
4669	294	523	180	22235	0	23232
4670	216	22942	190	643	0	23991
4671	308	529	203	21696	0	22736
4672	237	23048	190	578	0	24053
4673	22847	533	190	397	0	23967
4674	23060	225	154	331	0	23770
4675	22917	155	178	336	0	23586
4676	765	157	22664	238	0	23824
4677	416	131	561	22710	0	23818
4678	322	156	23078	579	0	24135
4679	299	21902	613	319	0	23133
4680	269	23007	299	228	0	23803
4681	22181	585	228	262	0	23256
4682	623	268	22314	210	0	23415
4683	326	22060	533	203	0	23122
4684	272	564	273	22459	0	23568
4685	22367	261	188	662	0	23478
4686	546	22632	184	328	0	23690
4687	22938	571	148	269	0	23926
4688	678	260	22986	209	0	24133
4689	418	192	548	23262	0	24420
4690	315	139	287	23830	0	24571
4691	280	158	210	24285	0	24933
4692	233	23976	198	772	0	25179
4693	369	625	183	22311	0	23488
4694	260	273	24259	694	0	25486
4695	328	160	604	23681	0	24773
4696	262	155	273	24261	0	24951
4697	274	130	192	23891	0	24487
4698	185	23344	199	776	0	24504
4699	293	531	163	23162	0	24149
4700	346	269	133	23118	0	23866
4701	134	21208	154	660	0	22156
4702	19660	403	97	276	0	20436
4703	389	19638	80	215	0	20322
4704	148	19786	90	163	0	20187
4705	193	484	96	19495	0	20268
4706	109	174	19405	417	0	20105
4707	17858	110	366	239	0	18573
4708	372	91	148	18996	0	19607
4709	120	79	18576	440	0	19215
4710	83	18558	360	227	0	19228
4711	124	383	116	18705	0	19328
4712	83	158	18894	433	0	19568
4713	113	97	381	18342	0	18933
4714	113	94	130	18658	0	18995
4715	18179	92	79	513	0	18863
4716	359	18123	87	230	0	18799
4717	17920	387	63	171	0	18541
4718	378	158	18105	153	0	18794
4719	140	18170	357	150	0	18817
4720	92	366	18379	109	0	18946
4721	146	164	358	18630	0	19298
4722	18521	95	164	442	0	19222
4723	355	97	117	18578	0	19147
4724	18610	68	66	466	0	19210
4725	18949	65	76	238	0	19328
4726	474	78	65	19185	0	19802
4727	184	78	19700	453	0	20415
4728	142	98	19985	194	0	20419
4729	134	90	425	20382	0	21031
4730	107	94	180	20934	0	21315
4731	20756	40	142	554	0	21492
4732	419	78	95	20634	0	21226
4733	198	20044	78	489	0	20809
4734	178	361	88	20472	0	21099
4735	132	188	64	20698	0	21082
4736	20133	104	73	605	0	20915
4737	376	20267	91	315	0	21049
4738	213	399	64	20349	0	21025
4739	183	155	59	20358	0	20755
4740	121	20003	74	558	0	20756
4741	159	393	70	20330	0	20952
4742	123	170	74	20214	0	20581
4743	82	19753	86	605	0	20526
4744	111	394	77	20021	0	20603
4745	116	165	73	19875	0	20229
4746	68	19555	90	598	0	20311
4747	106	414	58	19929	0	20507
4748	19450	180	41	636	0	20307
4749	19523	119	54	375	0	20071
4750	19020	120	44	305	0	19489
4751	19094	100	46	284	0	19524
4752	481	18181	73	235	0	18970
4753	16985	331	37	209	0	17562
4754	362	16540	34	215	0	17151
4755	158	16693	44	163	0	17058
4756	191	404	73	16555	0	17223
4757	100	163	16576	384	0	17223
4758	15737	111	271	236	0	16355
4759	16492	100	98	221	0	16911
4760	389	74	16723	164	0	17350
4761	16572	77	274	190	0	17113
4762	17389	85	99	174	0	17747
4763	418	16839	70	166	0	17493
4764	18677	323	56	247	0	19303
4765	417	155	47	18526	0	19145
4766	201	107	48	18762	0	19118
4767	169	103	47	18868	0	19187
4768	158	99	44	18838	0	19139
4769	18584	74	37	535	0	19230
4770	382	88	52	18269	0	18791
4771	204	78	39	18549	0	18870
4772	167	90	17954	468	0	18679
4773	16229	79	277	293	0	16878
4774	18043	77	96	221	0	18437
4775	18077	73	83	221	0	18454
4776	435	17590	72	180	0	18277
4777	220	18103	52	164	0	18539
4778	17905	357	43	204	0	18509
4779	414	152	47	18044	0	18657
4780	192	18359	50	413	0	19014
4781	159	346	48	18204	0	18757
4782	153	18517	54	444	0	19168
4783	18489	347	35	254	0	19125
4784	387	18798	46	204	0	19435
4785	211	365	42	18736	0	19354
4786	177	157	48	19188	0	19570
4787	151	127	19576	458	0	20312
4788	157	20457	317	225	0	21156
4789	196	465	107	21019	0	21787
4790	134	197	21227	532	0	22090
4791	110	127	21183	261	0	21681
4792	162	83	523	21377	0	22145
4793	153	82	225	21414	0	21874
4794	97	20435	104	643	0	21279
4795	88	21632	71	342	0	22133
4796	113	571	70	21592	0	22346
4797	21489	283	39	562	0	22373
4798	520	150	50	22430	0	23150
4799	22604	122	42	675	0	23443
4800	23422	117	33	404	0	23976
4801	23753	108	47	266	0	24174
4802	785	134	23343	157	0	24419
4803	23301	91	456	220	0	24068
4804	696	92	244	23362	0	24394
4805	394	78	132	23718	0	24322
4806	224	90	23207	731	0	24252
4807	176	105	23179	392	0	23852
4808	200	186	608	22514	0	23508
4809	135	22051	321	543	0	23050
4810	151	23088	154	352	0	23745
4811	191	605	116	23043	0	23955
4812	22823	306	95	619	0	23843
4813	561	171	73	23085	0	23890
4814	387	117	90	22923	0	23517
4815	223	22758	94	753	0	23828
4816	203	471	87	23283	0	24044
4817	166	270	23308	640	0	24384
4818	151	166	22206	439	0	22962
4819	21948	115	607	309	0	22979
4820	487	22816	322	246	0	23871
4821	22589	443	166	237	0	23435
4822	22681	264	110	219	0	23274
4823	693	166	84	21610	0	22553
4824	367	22190	109	455	0	23121
4825	249	452	97	22323	0	23121
4826	21956	227	79	591	0	22853
4827	473	21433	71	354	0	22331
4828	20969	429	37	283	0	21718
4829	509	21062	61	175	0	21807
4830	21222	460	75	189	0	21946
4831	21300	260	78	177	0	21815
4832	614	20918	73	154	0	21759
4833	382	481	57	20951	0	21871
4834	20985	273	79	489	0	21826
4835	520	127	20296	278	0	21221
4836	305	131	20323	185	0	20944
4837	220	237	504	20198	0	21159
4838	20585	102	243	495	0	21425
4839	469	109	127	20643	0	21348
4840	20619	91	81	570	0	21361
4841	532	103	20620	305	0	21560
4842	20834	83	397	233	0	21547
4843	21994	95	209	178	0	22476
4844	686	86	108	21553	0	22433
4845	432	90	87	21792	0	22401
4846	284	89	69	21894	0	22336
4847	189	21690	70	667	0	22616
4848	206	363	96	21726	0	22391
4849	159	196	105	22383	0	22843
4850	21897	114	107	691	0	22809
4851	22020	87	90	455	0	22652
4852	628	94	21528	242	0	22492
4853	21268	74	390	264	0	21996
4854	559	104	21632	171	0	22466
4855	20410	66	441	251	0	21168
4856	546	82	21276	194	0	22098
4857	350	69	20961	169	0	21549
4858	279	74	542	20695	0	21590
4859	184	75	20933	464	0	21656
4860	20121	82	450	339	0	20992
4861	424	70	267	21257	0	22018
4862	21559	68	137	515	0	22279
4863	21702	67	126	365	0	22260
4864	20482	66	113	222	0	20883
4865	20319	68	94	198	0	20679
4866	713	52	19961	135	0	20861
4867	468	44	373	19927	0	20812
4868	275	51	20314	426	0	21066
4869	254	51	430	20035	0	20770
4870	20082	50	270	499	0	20901
4871	490	56	170	20375	0	21091
4872	20488	52	110	516	0	21166
4873	528	49	123	20566	0	21266
4874	358	56	94	20873	0	21381
4875	20626	44	103	617	0	21390
4876	481	20400	89	371	0	21341
4877	20492	339	71	237	0	21139
4878	495	20392	61	191	0	21139
4879	376	369	60	20556	0	21361
4880	20425	205	82	473	0	21185
4881	460	109	20604	309	0	21482
4882	334	73	323	20701	0	21431
4883	20801	75	200	466	0	21542
4884	21601	42	122	311	0	22076
4885	654	69	79	21175	0	21977
4886	409	21200	83	436	0	22128
4887	230	20770	45	279	0	21324
4888	252	724	54	19046	0	20076
4889	19165	174	47	357	0	19743
4890	306	18513	35	178	0	19032
4891	140	18015	31	93	0	18279
4892	17633	286	25	100	0	18044
4893	219	17642	19	47	0	17927
4894	17988	223	32	67	0	18310
4895	300	125	20	17885	0	18330
4896	194	48	12	17895	0	18149
4897	56	17626	23	303	0	18008
4898	64	17484	8	150	0	17706
4899	16465	249	14	96	0	16824
4900	200	16989	16	57	0	17262
4901	113	18739	11	22	0	18885
4902	113	356	18	18682	0	19169
4903	19028	194	7	325	0	19554
4904	303	99	19783	166	0	20351
4905	19746	66	298	101	0	20211
4906	436	32	194	21095	0	21757
4907	251	53	21317	382	0	22003
4908	114	46	21739	250	0	22149
4909	125	36	570	22082	0	22813
4910	55	43	22895	426	0	23419
4911	22288	50	457	351	0	23146
4912	23123	59	275	176	0	23633
4913	661	48	23096	83	0	23888
4914	396	44	449	22867	0	23756
4915	201	72	299	22831	0	23403
4916	23395	47	137	713	0	24292
4917	519	40	98	22385	0	23042
4918	337	22486	105	487	0	23415
4919	22851	381	101	333	0	23666
4920	482	22583	78	195	0	23338
4921	326	23525	80	157	0	24088
4922	190	632	99	23318	0	24239
4923	186	322	75	23561	0	24144
4924	166	149	78	23848	0	24241
4925	134	117	23035	747	0	24033
4926	21342	88	408	493	0	22331
4927	476	22596	276	226	0	23574
4928	23123	440	130	217	0	23910
4929	23331	300	73	228	0	23932
4930	780	166	61	23262	0	24269
4931	422	23176	66	576	0	24240
4932	286	466	76	24080	0	24908
4933	223	326	60	24388	0	24997
4934	24403	171	57	831	0	25462
4935	24088	150	53	509	0	24800
4936	778	138	22874	254	0	24044
4937	24126	119	376	268	0	24889
4938	619	24612	199	243	0	25673
4939	24827	518	123	232	0	25700
4940	679	25789	82	196	0	26746
4941	488	637	55	25399	0	26579
4942	302	386	72	25455	0	26215
4943	263	25285	57	832	0	26437
4944	277	574	64	26181	0	27096
4945	239	385	58	26233	0	26915
4946	225	230	53	25964	0	26472
4947	187	25365	49	1002	0	26603
4948	230	608	68	25895	0	26801
4949	252	388	57	26134	0	26831
4950	207	246	73	26455	0	26981
4951	196	180	25234	1041	0	26651
4952	24018	214	529	657	0	25418
4953	645	173	25347	399	0	26564
4954	24989	169	606	377	0	26141
4955	703	177	25518	329	0	26727
4956	25162	155	617	349	0	26283
4957	25836	159	384	344	0	26723
4958	964	154	25432	307	0	26857
4959	604	161	618	25319	0	26702
4960	358	165	23876	722	0	25121
4961	24002	149	565	569	0	25285
4962	712	159	25827	394	0	27092
4963	531	138	25359	339	0	26367
4964	24983	121	856	386	0	26346
4965	715	25569	534	320	0	27138
4966	568	552	282	25917	0	27319
4967	26346	382	259	755	0	27742
4968	838	190	251	26497	0	27776
4969	597	152	250	27013	0	28012
4970	26540	122	269	1027	0	27958
4971	26673	125	211	649	0	27658
4972	1028	159	26117	379	0	27683
4973	621	109	26161	374	0	27265
4974	416	121	896	26420	0	27853
4975	347	117	27060	821	0	28345
4976	366	112	745	26865	0	28088
4977	378	110	502	26615	0	27605
4978	374	103	290	27766	0	28533
4979	26601	145	222	1138	0	28106
4980	713	26684	229	706	0	28332
4981	26669	582	169	534	0	27954
4982	26577	365	180	479	0	27601
4983	977	26181	169	461	0	27788
4984	25365	570	133	430	0	26498
4985	804	358	24943	332	0	26437
4986	568	262	471	24741	0	26042
4987	25167	185	332	728	0	26412
4988	704	176	23955	490	0	25325
4989	24554	119	471	396	0	25540
4990	671	25827	307	332	0	27137
4991	28942	498	207	318	0	29965
4992	29154	281	189	315	0	29939
4993	1099	29190	163	286	0	30738
4994	30349	680	173	276	0	31478
4995	1147	368	154	30391	0	32060
4996	740	268	122	31099	0	32229
4997	30564	200	131	1062	0	31957
4998	29866	169	99	686	0	30820
4999	1126	29974	125	463	0	31688
5000	692	30092	108	350	0	31242
5001	471	785	94	27536	0	28886
5002	308	27819	117	631	0	28875
5003	281	28809	114	342	0	29546
5004	27070	719	150	303	0	28242
5005	639	27396	92	180	0	28307
5006	26292	609	77	175	0	27153
5007	618	27050	66	121	0	27855
5008	337	597	26464	128	0	27526
5009	261	26897	412	121	0	27691
5010	26354	694	237	219	0	27504
5011	26256	240	127	156	0	26779
5012	650	224	25909	93	0	26876
5013	436	141	434	24958	0	25969
5014	332	122	173	26351	0	26978
5015	207	95	26153	562	0	27017
5016	192	91	490	25516	0	26289
5017	131	93	25983	604	0	26811
5018	136	89	25177	288	0	25690
5019	24744	78	574	306	0	25702
5020	475	25620	301	176	0	26572
5021	25547	442	219	176	0	26384
5022	649	187	137	25602	0	26575
5023	310	189	25768	442	0	26709
5024	345	155	429	24773	0	25702
5025	213	25715	183	491	0	26602
5026	26176	418	179	269	0	27042
5027	26457	177	122	274	0	27030
5028	645	177	91	26365	0	27278
5029	350	131	25739	466	0	26686
5030	24377	93	396	270	0	25136
5031	548	25273	171	188	0	26180
5032	25233	419	163	161	0	25976
5033	667	192	98	25008	0	25965
5034	25009	212	71	466	0	25758
5035	723	170	46	24727	0	25666
5036	345	170	24502	535	0	25552
5037	336	113	23132	298	0	23879
5038	23127	81	456	411	0	24075
5039	501	24472	245	243	0	25461
5040	23991	359	224	174	0	24748
5041	24048	202	100	160	0	24510
5042	496	24236	78	81	0	24891
5043	23694	470	65	149	0	24378
5044	564	242	24580	119	0	25505
5045	316	267	335	24700	0	25618
5046	313	221	148	24967	0	25649
5047	294	149	145	25355	0	25943
5048	198	174	24948	567	0	25887
5049	230	129	24771	323	0	25453
5050	167	154	489	24800	0	25610
5051	164	24364	312	412	0	25252
5052	147	25699	205	195	0	26246
5053	25585	517	141	236	0	26479
5054	25694	250	128	239	0	26311
5055	524	26262	147	151	0	27084
5056	329	496	77	26644	0	27546
5057	300	219	102	26967	0	27588
5058	27125	197	167	623	0	28112
5059	519	132	110	27778	0	28539
5060	283	129	148	27685	0	28245
5061	274	113	157	27901	0	28445
5062	253	136	26294	659	0	27342
5063	222	173	25282	376	0	26053
5064	26011	93	508	399	0	27011
5065	531	101	308	27987	0	28927
5066	240	100	27918	600	0	28858
5067	250	113	26852	290	0	27505
5068	26952	127	637	336	0	28052
5069	682	96	30080	196	0	31054
5070	303	30471	686	219	0	31679
5071	301	539	311	32269	0	33420
5072	240	216	32131	625	0	33212
5073	31711	221	664	331	0	32927
5074	781	191	263	33512	0	34747
5075	363	113	33075	777	0	34328
5076	347	67	752	33326	0	34492
5077	310	65	332	33844	0	34551
5078	33576	64	257	1034	0	34931
5079	726	33861	270	485	0	35342
5080	396	626	220	33894	0	35136
5081	34160	246	140	862	0	35408
5082	34521	237	121	405	0	35284
5083	34737	132	133	351	0	35353
5084	35207	151	104	296	0	35758
5085	1181	133	110	34416	0	35840
5086	33913	81	150	840	0	34984
5087	34099	50	152	445	0	34746
5088	32180	63	117	526	0	32886
5089	32973	70	141	410	0	33594
5090	1014	30730	135	309	0	32188
5091	253	28398	64	100	0	28815
5092	259	479	50	28092	0	28880
5093	167	27682	50	438	0	28337
5094	27694	447	55	216	0	28412
5095	551	167	35	27252	0	28005
5096	27133	74	42	497	0	27746
5097	27407	50	30	254	0	27741
5098	644	47	30	27655	0	28376
5099	301	46	33	27540	0	27920
5100	183	27299	48	517	0	28047
5101	27544	367	39	272	0	28222
5102	488	27316	55	152	0	28011
5103	27527	417	42	175	0	28161
5104	564	169	35	27659	0	28427
5105	262	107	27245	437	0	28051
5106	26832	83	388	261	0	27564
5107	26119	86	123	205	0	26533
5108	620	66	25690	129	0	26505
5109	255	84	25642	127	0	26108
5110	280	69	446	25116	0	25911
5111	27768	61	151	523	0	28503
5112	28659	80	93	297	0	29129
5113	28930	71	67	239	0	29307
5114	29281	87	65	226	0	29659
5115	764	28879	71	143	0	29857
5116	29876	511	62	197	0	30646
5117	742	181	61	29497	0	30481
5118	438	95	59	29727	0	30319
5119	316	84	89	30908	0	31397
5120	305	59	81	31545	0	31990
5121	30937	77	82	864	0	31960
5122	754	74	86	32595	0	33509
5123	356	74	31937	790	0	33157
5124	324	71	631	32600	0	33626
5125	349	62	233	32913	0	33557
5126	304	65	121	32989	0	33479
5127	301	49	109	32853	0	33312
5128	31794	57	94	1054	0	32999
5129	781	31298	97	473	0	32649
5130	365	32086	103	325	0	32879
5131	307	800	73	31849	0	33029
5132	31211	290	83	889	0	32473
5133	32559	153	91	440	0	33243
5134	985	109	88	32494	0	33676
5135	449	91	31530	897	0	32967
5136	31900	69	610	517	0	33096
5137	964	89	224	33264	0	34541
5138	434	101	33129	937	0	34601
5139	31714	94	728	560	0	33096
5140	941	32974	243	361	0	34519
5141	36964	739	120	375	0	38198
5142	1225	37905	105	305	0	39540
5143	855	1040	60	37671	0	39626
5144	501	38036	74	1141	0	39752
5145	472	1304	67	38939	0	40782
5146	37574	623	69	1541	0	39807
5147	1206	38168	97	818	0	40289
5148	741	1084	37750	518	0	40093
5149	555	612	1020	38082	0	40269
5150	395	337	38396	1276	0	40404
5151	413	253	1224	37799	0	39689
5152	402	170	616	39118	0	40306
5153	289	198	37698	1723	0	39908
5154	34524	168	1127	1183	0	37002
5155	1244	185	37251	592	0	39272
5156	765	199	36919	422	0	38305
5157	492	37042	1494	401	0	39429
5158	438	1110	737	36850	0	39135
5159	349	650	437	37575	0	39011
5160	411	384	278	36456	0	37529
5161	332	290	183	38288	0	39093
5162	255	211	36036	2009	0	38511
5163	33741	160	1074	1280	0	36255
5164	1157	163	36122	721	0	38163
5165	777	105	1261	34868	0	37011
5166	34474	116	714	1420	0	36724
5167	1123	34537	510	897	0	37067
5168	792	1188	297	33648	0	35925
5169	32120	554	255	1306	0	34235
5170	1115	30727	266	809	0	32917
5171	615	31375	187	519	0	32696
5172	30677	1285	194	472	0	32628
5173	1004	31032	193	352	0	32581
5174	30028	1137	166	396	0	31727
5175	1156	30292	163	395	0	32006
5176	30774	1104	188	364	0	32430
5177	31206	592	159	340	0	32297
5178	1450	31032	181	261	0	32924
5179	873	1003	171	30586	0	32633
5180	543	598	30075	1048	0	32264
5181	29761	414	920	670	0	31765
5182	1124	307	498	29914	0	31843
5183	714	28448	319	1110	0	30591
5184	444	30166	200	669	0	31479
5185	355	1257	165	30147	0	31924
5186	29777	713	145	1151	0	31786
5187	1053	458	29648	683	0	31842
5188	748	296	890	30084	0	32018
5189	499	261	521	30842	0	32123
5190	366	245	341	31433	0	32385
5191	365	198	218	30836	0	31617
5192	253	29652	213	1687	0	31805
5193	307	978	167	30698	0	32150
5194	243	625	29649	1429	0	31946
5195	274	443	29452	815	0	30984
5196	242	322	30207	638	0	31409
5197	299	277	1465	29562	0	31603
5198	29134	269	793	1160	0	31356
5199	1033	255	29266	774	0	31328
5200	710	218	29666	581	0	31175
5201	513	228	1397	28972	0	31110
5202	29103	232	801	1277	0	31413
5203	1027	29132	493	844	0	31496
5204	29353	1020	354	710	0	31437
5205	1342	615	300	29203	0	31460
5206	760	486	29633	1190	0	32069
5207	587	457	1052	28467	0	30563
5208	359	29908	672	1299	0	32238
5209	31415	1075	482	818	0	33790
5210	1162	613	31353	624	0	33752
5211	625	30116	1070	463	0	32274
5212	29901	1024	671	477	0	32073
5213	1264	618	494	29770	0	32146
5214	766	395	353	30553	0	32067
5215	30224	248	310	1549	0	32331
5216	30605	228	295	1025	0	32153
5217	31904	260	274	637	0	33075
5218	1848	237	235	30138	0	32458
5219	973	29566	257	1183	0	31979
5220	29852	956	242	838	0	31888
5221	1192	29881	212	635	0	31920
5222	28523	1098	179	415	0	30215
5223	1228	28052	219	320	0	29819
5224	836	1084	194	27631	0	29745
5225	28026	675	166	1024	0	29891
5226	28488	452	132	768	0	29840
5227	28895	303	127	577	0	29902
5228	29167	290	127	427	0	30011
5229	29166	224	131	395	0	29916
5230	1764	251	27514	327	0	29856
5231	1200	234	805	27453	0	29692
5232	758	233	27760	939	0	29690
5233	570	254	27631	643	0	29098
5234	27291	238	1271	459	0	29259
5235	27923	251	773	332	0	29279
5236	28150	242	408	278	0	29078
5237	1772	256	237	26523	0	28788
5238	26795	198	213	967	0	28173
5239	1389	25981	204	663	0	28237
5240	998	26330	158	484	0	27970
5241	501	23790	112	224	0	24627
5242	22104	639	171	201	0	23115
5243	656	22391	99	186	0	23332
5244	22094	492	121	171	0	22878
5245	21950	252	64	166	0	22432
5246	743	163	21515	136	0	22557
5247	493	160	422	21052	0	22127
5248	412	110	192	22121	0	22835
5249	22243	122	169	606	0	23140
5250	22456	113	117	323	0	23009
5251	782	97	116	22066	0	23061
5252	470	113	21703	551	0	22837
5253	393	121	21833	313	0	22660
5254	383	111	555	22289	0	23338
5255	399	107	242	22337	0	23085
5256	338	123	137	22991	0	23589
5257	22067	132	111	743	0	23053
5258	22315	151	107	359	0	22932
5259	791	22086	123	264	0	23264
5260	492	525	129	22106	0	23252
5261	441	243	103	22206	0	22993
5262	343	22339	117	659	0	23458
5263	392	503	116	22563	0	23574
5264	22622	249	104	674	0	23649
5265	725	178	141	22420	0	23464
5266	537	122	112	22705	0	23476
5267	22381	147	98	780	0	23406
5268	22425	130	111	470	0	23136
5269	22592	114	128	391	0	23225
5270	904	194	165	22013	0	23276
5271	525	102	21073	580	0	22280
5272	420	123	20688	353	0	21584
5273	401	122	20682	280	0	21485
5274	382	20346	541	257	0	21526
5275	20118	436	346	298	0	21198
5276	630	233	19664	216	0	20743
5277	19228	131	412	235	0	20006
5278	596	147	240	19234	0	20217
5279	17703	146	201	565	0	18615
5280	19677	141	129	389	0	20336
5281	710	19735	117	234	0	20796
5282	20253	368	114	277	0	21012
5283	20189	205	108	317	0	20819
5284	735	20109	136	246	0	21226
5285	557	361	127	20646	0	21691
5286	411	218	20693	493	0	21815
5287	376	147	380	20351	0	21254
5288	349	130	214	20774	0	21467
5289	20798	141	164	632	0	21735
5290	640	135	149	20553	0	21477
5291	417	20831	151	548	0	21947
5292	334	405	145	20962	0	21846
5293	285	235	137	21413	0	22070
5294	327	154	20870	694	0	22045
5295	343	20198	392	458	0	21391
5296	375	21071	214	303	0	21963
5297	20602	505	142	352	0	21601
5298	564	21348	128	307	0	22347
5299	456	481	142	21349	0	22428
5300	322	302	21270	534	0	22428
5301	273	21396	422	405	0	22496
5302	21388	465	267	332	0	22452
5303	575	276	196	21405	0	22452
5304	412	178	148	21793	0	22531
5305	308	152	21387	662	0	22509
5306	313	143	392	20709	0	21557
5307	331	125	216	21342	0	22014
5308	20662	155	166	719	0	21702
5309	19104	106	110	429	0	19749
5310	582	18747	101	284	0	19714
5311	17856	306	78	260	0	18500
5312	412	17486	80	217	0	18195
5313	291	420	72	16500	0	17283
5314	225	16616	77	341	0	17259
5315	179	17236	79	233	0	17727
5316	16504	384	149	261	0	17298
5317	16142	163	65	180	0	16550
5318	349	15917	61	135	0	16462
5319	16061	252	67	173	0	16553
5320	16041	133	42	179	0	16395
5321	16514	92	67	176	0	16849
5322	364	86	57	16631	0	17138
5323	16679	98	46	323	0	17146
5324	319	112	15964	184	0	16579
5325	15749	74	191	170	0	16184
5326	357	83	16631	112	0	17183
5327	234	96	226	16908	0	17464
5328	181	98	95	17376	0	17750
5329	151	94	17176	329	0	17750
5330	16267	90	211	237	0	16805
5331	16925	87	121	168	0	17301
5332	353	82	17913	119	0	18467
5333	247	73	224	17532	0	18076
5334	203	64	112	17603	0	17982
5335	172	52	73	18203	0	18500
5336	17929	55	61	388	0	18433
5337	17866	54	66	207	0	18193
5338	380	58	53	17148	0	17639
5339	178	16433	55	226	0	16892
5340	111	16142	47	145	0	16445
5341	15368	191	51	123	0	15733
5342	232	15353	52	74	0	15711
5343	116	15163	31	94	0	15404
5344	97	178	35	14384	0	14694
5345	69	73	14437	140	0	14719
5346	66	14147	119	76	0	14408
5347	93	161	61	14126	0	14441
5348	59	14276	51	130	0	14516
5349	63	124	29	14117	0	14333
5350	14050	37	29	173	0	14289
5351	125	14179	20	83	0	14407
5352	14187	119	12	111	0	14429
5353	13756	49	21	83	0	13909
5354	157	39	13414	41	0	13651
5355	13102	31	101	65	0	13299
5356	138	41	53	13648	0	13880
5357	64	40	13816	107	0	14027
5358	46	13821	82	61	0	14010
5359	66	106	45	13657	0	13874
5360	57	51	18	13837	0	13963
5361	13849	33	12	151	0	14045
5362	110	28	21	13819	0	13978
5363	67	31	27	13831	0	13956
5364	13819	46	11	142	0	14018
5365	101	13724	16	78	0	13919
5366	13484	87	20	77	0	13668
5367	103	52	13433	41	0	13629
5368	12203	29	85	104	0	12421
5369	117	31	13742	43	0	13933
5370	72	13884	83	28	0	14067
5371	13896	84	36	94	0	14110
5372	13270	47	28	89	0	13434
5373	130	32	13670	36	0	13868
5374	71	38	13640	30	0	13779
5375	62	33	14067	28	0	14190
5376	48	14668	134	35	0	14885
5377	63	113	43	14875	0	15094
5378	51	59	16371	119	0	16600
5379	52	32	15833	58	0	15975
5380	80	30	214	15887	0	16211
5381	50	30	16285	161	0	16526
5382	15709	29	180	173	0	16091
5383	18134	27	114	117	0	18392
5384	367	22	17928	51	0	18368
5385	186	17762	273	54	0	18275
5386	149	233	169	17613	0	18164
5387	79	142	18061	259	0	18541
5388	58	17710	301	158	0	18227
5389	129	288	180	17517	0	18114
5390	17827	151	85	332	0	18395
5391	17742	59	80	225	0	18106
5392	363	18196	66	90	0	18715
5393	229	258	56	18238	0	18781
5394	120	151	64	18349	0	18684
5395	112	89	51	18119	0	18371
5396	98	56	53	18456	0	18663
5397	72	58	18016	449	0	18595
5398	99	52	237	17704	0	18092
5399	54	67	17506	339	0	17966
5400	44	17111	274	224	0	17653
5401	16930	245	184	189	0	17548
5402	228	17580	91	125	0	18024
5403	172	264	68	17687	0	18191
5404	116	162	62	17759	0	18099
5405	17447	84	35	454	0	18020
5406	267	51	70	17632	0	18020
5407	162	17125	48	333	0	17668
5408	125	234	38	17661	0	18058
5409	70	177	31	17709	0	17987
5410	17363	87	30	457	0	17937
5411	242	80	16909	280	0	17511
5412	176	16805	191	145	0	17317
5413	92	17409	97	124	0	17722
5414	94	313	54	17255	0	17716
5415	16937	196	28	306	0	17467
5416	200	17012	44	211	0	17467
5417	172	242	20	17225	0	17659
5418	101	161	16952	273	0	17487
5419	95	108	203	17005	0	17411
5420	17013	76	132	350	0	17571
5421	16698	69	74	264	0	17105
5422	353	51	45	16682	0	17131
5423	16873	50	34	345	0	17302
5424	16613	46	37	247	0	16943
5425	369	56	16469	129	0	17023
5426	15626	46	211	157	0	16040
5427	303	16174	149	96	0	16722
5428	16333	227	74	118	0	16752
5429	334	165	15941	74	0	16514
5430	247	89	240	16191	0	16767
5431	16607	51	153	313	0	17124
5432	322	50	15537	184	0	16093
5433	243	30	15708	114	0	16095
5434	179	52	389	15601	0	16221
5435	116	52	16210	281	0	16659
5436	15774	36	360	230	0	16400
5437	312	39	16527	127	0	17005
5438	245	38	355	16904	0	17542
5439	160	51	216	17432	0	17859
5440	17971	38	144	511	0	18664
5441	379	43	18162	280	0	18864
5442	227	27	19042	165	0	19461
5443	221	30	548	19947	0	20746
5444	116	30	20421	489	0	21056
5445	19799	20	581	298	0	20698
5446	505	32	307	20238	0	21082
5447	269	20	20355	545	0	21189
5448	220	14	559	20256	0	21049
5449	174	32	301	20767	0	21274
5450	20537	31	192	739	0	21499
5451	541	27	20576	363	0	21507
5452	19783	33	553	247	0	20616
5453	604	57	21326	179	0	22166
5454	20920	30	622	205	0	21777
5455	21414	39	331	191	0	21975
5456	21487	36	219	203	0	21945
5457	767	20585	154	175	0	21681
5458	20968	441	139	168	0	21716
5459	21150	186	117	161	0	21614
5460	772	108	154	20710	0	21744
5461	429	57	20512	587	0	21585
5462	19754	38	520	396	0	20708
5463	631	38	20910	251	0	21830
5464	384	54	618	20469	0	21525
5465	289	48	316	21303	0	21956
5466	21110	44	242	763	0	22159
5467	602	21523	162	406	0	22693
5468	396	468	147	21356	0	22367
5469	336	212	135	21761	0	22444
5470	207	136	21553	746	0	22642
5471	255	66	514	21527	0	22362
5472	219	48	295	22101	0	22663
5473	275	34	163	21496	0	21968
5474	177	21192	149	777	0	22295
5475	20859	451	117	430	0	21857
5476	21181	221	104	348	0	21854
5477	741	21136	117	243	0	22237
5478	19957	444	99	190	0	20690
5479	665	220	85	20427	0	21397
5480	308	120	21006	547	0	21981
5481	208	20886	482	307	0	21883
5482	167	21612	247	215	0	22241
5483	20655	462	223	167	0	21507
5484	21755	160	91	173	0	22179
5485	652	102	82	21637	0	22473
5486	344	68	80	22156	0	22648
5487	233	41	87	22161	0	22522
5488	21402	40	90	775	0	22307
5489	579	55	21080	321	0	22035
5490	21219	47	464	270	0	22000
5491	646	83	188	21420	0	22337
5492	326	47	142	21121	0	21636
5493	212	21001	109	654	0	21976
5494	238	452	118	21601	0	22409
5495	220	160	92	22119	0	22591
5496	173	127	21900	725	0	22925
5497	213	21921	483	359	0	22976
5498	22503	498	207	317	0	23525
5499	21947	191	140	283	0	22561
5500	22962	121	106	259	0	23448
5501	22703	119	103	243	0	23168
5502	771	86	22069	168	0	23094
5503	21753	65	514	224	0	22556
5504	690	84	22335	204	0	23313
5505	383	78	565	21576	0	22602
5506	277	22379	228	588	0	23472
5507	319	503	154	22568	0	23544
5508	276	190	161	23074	0	23701
5509	245	146	22623	777	0	23791
5510	21663	113	551	456	0	22783
5511	22423	111	240	360	0	23134
5512	733	22130	175	301	0	23339
5513	409	483	22344	260	0	23496
5514	373	218	533	22407	0	23531
5515	293	162	22584	682	0	23721
5516	281	152	22357	362	0	23152
5517	327	130	651	22367	0	23475
5518	282	142	22586	666	0	23676
5519	344	109	601	22512	0	23566
5520	292	103	23111	722	0	24228
5521	263	147	611	23177	0	24198
5522	23241	106	291	815	0	24453
5523	23410	102	215	476	0	24203
5524	23400	126	168	418	0	24112
5525	23170	113	171	395	0	23849
5526	798	23053	184	338	0	24373
5527	478	510	187	23056	0	24231
5528	399	206	165	23505	0	24275
5529	295	165	22853	836	0	24149
5530	328	134	579	22675	0	23716
5531	254	169	22616	776	0	23815
5532	243	129	21820	432	0	22624
5533	21117	114	658	432	0	22321
5534	616	22458	344	316	0	23734
5535	22552	492	264	331	0	23639
5536	22574	236	196	375	0	23381
5537	757	22583	215	269	0	23824
5538	22393	461	180	325	0	23359
5539	703	195	22298	218	0	23414
5540	360	22065	461	201	0	23087
5541	22034	438	252	283	0	23007
5542	566	203	20816	197	0	21782
5543	19781	138	341	221	0	20481
5544	408	20648	190	177	0	21423
5545	20723	302	165	233	0	21423
5546	20633	153	147	220	0	21153
5547	491	20257	141	161	0	21050
5548	280	19885	164	149	0	20478
5549	215	20577	158	137	0	21087
5550	207	399	138	20647	0	21391
5551	183	180	151	20881	0	21395
5552	21077	101	139	491	0	21808
5553	20322	117	138	297	0	20874
5554	468	90	20395	209	0	21162
5555	264	82	19834	210	0	20390
5556	216	91	20387	167	0	20861
5557	242	77	465	20464	0	21248
5558	210	78	20970	414	0	21672
5559	243	82	434	20775	0	21534
5560	20940	70	218	499	0	21727
5561	468	97	21078	228	0	21871
5562	20797	96	427	211	0	21531
5563	21115	94	241	219	0	21669
5564	542	101	21655	162	0	22460
5565	289	22116	448	158	0	23011
5566	296	370	231	21809	0	22706
5567	216	179	22325	438	0	23158
5568	249	127	498	21641	0	22515
5569	235	91	246	23694	0	24266
5570	23093	90	201	595	0	23979
5571	582	106	162	23093	0	23943
5572	296	112	22938	500	0	23846
5573	275	104	477	22877	0	23733
5574	23043	98	214	585	0	23940
5575	521	23134	176	265	0	24096
5576	22948	425	225	222	0	23820
5577	620	252	169	22738	0	23779
5578	338	122	22821	442	0	23723
5579	283	118	21914	199	0	22514
5580	254	94	21805	128	0	22281
5581	166	20946	464	113	0	21689
5582	20415	414	351	175	0	21355
5583	348	19918	107	85	0	20458
5584	19031	272	97	98	0	19498
5585	305	19153	59	58	0	19575
5586	164	295	56	19419	0	19934
5587	111	114	45	19741	0	20011
5588	115	54	50	19683	0	19902
5589	49	19663	48	400	0	20160
5590	110	293	57	21016	0	21476
5591	124	124	50	24448	0	24746
5592	25211	57	43	664	0	25975
5593	641	65	40	26009	0	26755
5594	183	71	26869	640	0	27763
5595	26146	61	605	308	0	27120
5596	27292	42	183	207	0	27724
5597	797	27159	92	140	0	28188
5598	27267	654	78	171	0	28170
5599	28107	189	62	155	0	28513
5600	1000	114	47	27533	0	28694
5601	441	103	54	28132	0	28730
5602	293	68	66	28935	0	29362
5603	28463	66	62	1043	0	29634
5604	28914	76	47	419	0	29456
5605	982	91	28060	245	0	29378
5606	27921	70	684	264	0	28939
5607	28770	50	177	251	0	29248
5608	28815	64	129	223	0	29231
5609	1082	55	27459	197	0	28793
5610	485	48	27876	186	0	28595
5611	415	62	879	27867	0	29223
5612	326	47	28659	870	0	29902
5613	354	53	889	27977	0	29273
5614	490	58	325	25921	0	26794
5615	328	28639	192	856	0	30015
5616	28827	735	197	444	0	30203
5617	1030	218	29136	255	0	30639
5618	29629	124	837	283	0	30873
5619	1165	115	341	30113	0	31734
5620	29578	76	218	1045	0	30917
5621	1116	28518	202	459	0	30295
5622	523	30541	156	347	0	31567
5623	493	995	167	29945	0	31600
5624	498	298	183	30838	0	31817
5625	380	159	30087	1217	0	31843
5626	424	134	947	30010	0	31515
5627	29262	115	331	1200	0	30908
5628	1053	29363	265	505	0	31186
5629	528	921	29452	296	0	31197
5630	473	309	936	29297	0	31015
5631	339	169	29926	1079	0	31513
5632	409	151	1040	29700	0	31300
5633	273	146	30236	1208	0	31863
5634	296	143	29690	521	0	30650
5635	335	162	1134	29627	0	31258
5636	29985	161	472	1120	0	31738
5637	30165	153	346	527	0	31191
5638	29576	130	270	470	0	30446
5639	1236	29143	270	377	0	31026
5640	29534	917	251	368	0	31070
5641	29386	320	234	405	0	30345
5642	1247	219	28547	327	0	30340
5643	531	28375	944	372	0	30222
5644	507	905	374	28322	0	30108
5645	28375	304	285	1082	0	30046
5646	1121	28387	235	496	0	30239
5647	29402	984	249	420	0	31055
5648	29939	366	252	379	0	30936
5649	29802	207	255	395	0	30659
5650	29780	235	254	356	0	30625
5651	1366	190	261	28734	0	30551
5652	29012	159	201	1127	0	30499
5653	1224	194	253	28337	0	30008
5654	576	28032	239	1067	0	29914
5655	550	766	224	28715	0	30255
5656	28694	253	251	1096	0	30294
5657	1212	182	28480	487	0	30361
5658	681	149	865	28635	0	30330
5659	28472	143	360	1046	0	30021
5660	1158	28222	253	484	0	30117
5661	28697	853	242	380	0	30172
5662	29360	327	213	385	0	30285
5663	1328	29168	217	329	0	31042
5664	28947	857	217	327	0	30348
5665	1191	344	27401	272	0	29208
5666	654	211	27294	307	0	28466
5667	26779	209	893	323	0	28204
5668	1187	244	27238	223	0	28892
5669	698	182	774	25332	0	26986
5670	589	25759	284	741	0	27373
5671	26594	807	203	327	0	27931
5672	1054	26045	198	297	0	27594
5673	618	24442	219	283	0	25562
5674	500	873	218	27445	0	29036
5675	488	309	179	27902	0	28878
5676	431	218	199	27707	0	28555
5677	397	209	181	27960	0	28747
5678	388	209	26972	1047	0	28616
5679	378	210	734	26419	0	27741
5680	394	203	260	27222	0	28079
5681	26571	212	199	985	0	27967
5682	923	204	196	26542	0	27865
5683	451	154	25930	965	0	27500
5684	25230	155	708	443	0	26536
5685	921	181	319	25893	0	27314
5686	451	179	26275	819	0	27724
5687	438	184	727	25471	0	26820
5688	366	26276	303	738	0	27683
5689	26237	671	246	413	0	27567
5690	808	235	25157	273	0	26473
5691	283	21643	467	176	0	22569
5692	20691	380	206	150	0	21427
5693	374	19734	121	114	0	20343
5694	137	18980	87	95	0	19299
5695	18750	296	137	104	0	19287
5696	286	18320	59	85	0	18750
5697	132	18546	61	79	0	18818
5698	231	299	95	18192	0	18817
5699	102	91	17960	226	0	18379
5700	86	18339	219	103	0	18747
5701	109	233	66	18112	0	18520
5702	65	18081	29	180	0	18355
5703	17857	174	34	116	0	18181
5704	188	66	17701	78	0	18033
5705	97	64	160	17700	0	18021
5706	18274	43	52	228	0	18597
5707	197	41	42	18658	0	18938
5708	83	41	18589	202	0	18915
5709	17448	34	168	127	0	17777
5710	18671	35	62	97	0	18865
5711	227	19486	42	50	0	19805
5712	109	165	35	19373	0	19682
5713	89	67	35	19873	0	20064
5714	19976	43	29	248	0	20296
5715	19416	35	47	105	0	19603
5716	225	45	19758	46	0	20074
5717	84	19237	143	29	0	19493
5718	19220	99	46	57	0	19422
5719	119	75	25	19202	0	19421
5720	66	39	19694	116	0	19915
5721	43	25	18795	45	0	18908
5722	54	135	123	18960	0	19272
5723	19389	8	43	103	0	19543
5724	91	19146	18	36	0	19291
5725	20517	75	19	62	0	20673
5726	106	32	12	20623	0	20773
5727	54	19	12	20854	0	20939
5728	33	8	18	21085	0	21144
5729	21110	11	16	149	0	21286
5730	77	21396	20	54	0	21547
5731	51	86	5	21706	0	21848
5732	42	35	8	21603	0	21688
5733	26	19	21525	93	0	21663
5734	47	15	69	21134	0	21265
5735	25	27	21652	85	0	21789
5736	23	21163	70	58	0	21314
5737	17	60	25	21487	0	21589
5738	21180	24	17	109	0	21330
5739	71	9	21052	39	0	21171
5740	50	9	63	21066	0	21188
5741	19	13	21043	75	0	21150
5742	19390	10	67	101	0	19568
5743	87	16	21126	23	0	21252
5744	60	12	70	20171	0	20313
5745	20773	12	24	109	0	20918
5746	97	17452	45	55	0	17649
5747	19556	60	16	63	0	19695
5748	104	17131	33	36	0	17304
5749	55	63	13	19999	0	20130
5750	28	30	19630	71	0	19759
5751	33	37	18723	43	0	18836
5752	54	11	84	19588	0	19737
5753	20235	12	35	124	0	20406
5754	19763	14	19	88	0	19884
5755	120	16	14	19967	0	20117
5756	60	11	18	20247	0	20336
5757	19850	16	10	141	0	20017
5758	85	18804	24	65	0	18978
5759	43	20238	17	34	0	20332
5760	20359	91	17	63	0	20530
5761	103	53	19854	25	0	20035
5762	84	23	73	19592	0	19772
5763	40	28	19367	102	0	19537
5764	43	17	76	19398	0	19534
5765	44	16	19749	93	0	19902
5766	33	23	19260	64	0	19380
5767	52	19	105	19941	0	20117
5768	29	18816	65	88	0	18998
5769	20257	76	28	87	0	20448
5770	94	19987	28	53	0	20162
5771	70	82	27	20259	0	20438
5772	20475	38	19	145	0	20677
5773	114	20	27	20678	0	20839
5774	20867	26	16	177	0	21086
5775	20762	16	23	107	0	20908
5776	20978	27	20	78	0	21103
5777	145	20239	29	51	0	20464
5778	21489	90	25	85	0	21689
5779	145	59	36	22495	0	22735
5780	23444	42	22	190	0	23698
5781	193	25	32	24228	0	24478
5782	24353	19	24	270	0	24666
5783	24596	20	33	146	0	24795
5784	266	24269	21	86	0	24642
5785	155	197	26	26620	0	26998
5786	101	81	20	26455	0	26657
5787	54	27304	32	329	0	27719
5788	86	285	18	28086	0	28475
5789	27942	93	42	418	0	28495
5790	28894	56	21	222	0	29193
5791	28164	34	39	179	0	28416
5792	470	52	29127	75	0	29724
5793	29879	24	305	163	0	30371
5794	31482	26	112	119	0	31739
5795	31812	23	63	145	0	32043
5796	509	31219	44	66	0	31838
5797	285	348	30	31793	0	32456
5798	179	142	24	32369	0	32714
5799	136	87	22	32021	0	32266
5800	84	60	31149	561	0	31854
5801	124	55	347	31565	0	32091
5802	31757	35	133	568	0	32493
5803	477	32	75	32039	0	32623
5804	271	35	45	32940	0	33291
5805	178	52	32353	570	0	33153
5806	125	31484	417	290	0	32316
5807	32576	398	155	197	0	33326
5808	533	157	81	32592	0	33363
5809	32562	74	56	540	0	33232
5810	539	94	31807	201	0	32641
5811	29805	49	412	250	0	30516
5812	515	32286	149	184	0	33134
5813	245	417	31885	150	0	32697
5814	159	132	31989	112	0	32392
5815	210	128	538	30531	0	31407
5816	142	60	32728	478	0	33408
5817	124	32567	464	234	0	33389
5818	179	402	153	32013	0	32747
5819	144	154	118	33128	0	33544
5820	123	122	89	33172	0	33506
5821	32453	88	59	696	0	33296
5822	479	32446	55	333	0	33313
5823	289	401	51	33016	0	33757
5824	203	172	88	33362	0	33825
5825	32150	94	76	665	0	32985
5826	497	32124	71	358	0	33050
5827	32543	433	85	308	0	33369
5828	32358	170	113	237	0	32878
5829	32219	134	88	259	0	32700
5830	699	97	31357	338	0	32491
5831	426	108	425	30726	0	31685
5832	274	31186	181	522	0	32163
5833	212	31783	128	284	0	32407
5834	243	586	69	31198	0	32096
5835	222	30924	89	530	0	31765
5836	32815	529	72	411	0	33827
5837	552	249	32663	261	0	33725
5838	31793	145	448	353	0	32739
5839	33470	111	164	275	0	34020
5840	761	136	126	33566	0	34589
5841	33716	108	104	676	0	34604
5842	693	35308	116	329	0	36446
5843	35781	493	98	417	0	36789
5844	36109	223	127	313	0	36772
5845	38931	178	114	352	0	39575
5846	885	171	39105	243	0	40404
5847	458	219	39262	258	0	40197
5848	428	130	750	39443	0	40751
5849	306	38855	371	738	0	40270
5850	325	40422	240	389	0	41376
5851	351	768	200	39880	0	41199
5852	40143	383	128	889	0	41543
5853	849	232	148	40129	0	41358
5854	437	191	167	40648	0	41443
5855	39964	170	140	1092	0	41366
5856	817	39856	154	596	0	41423
5857	484	696	39725	425	0	41330
5858	456	291	39088	333	0	40168
5859	39770	226	794	354	0	41144
5860	853	214	416	39578	0	41061
5861	453	182	40647	741	0	42023
5862	434	161	698	39838	0	41131
5863	371	185	326	39733	0	40615
5864	298	205	257	41083	0	41843
5865	326	183	161	40252	0	40922
5866	285	39293	176	1043	0	40797
5867	301	669	173	40034	0	41177
5868	39507	309	193	1046	0	41055
5869	791	39374	184	569	0	40918
5870	39905	722	387	457	0	41471
5871	40589	366	205	423	0	41583
5872	40651	272	201	407	0	41531
5873	1041	267	39214	314	0	40836
5874	39025	205	671	454	0	40355
5875	40389	188	343	382	0	41302
5876	39437	199	211	398	0	40245
5877	40181	148	153	422	0	40904
5878	1030	39584	165	347	0	41126
5879	38524	628	109	335	0	39596
5880	868	337	37857	254	0	39316
5881	495	244	532	36679	0	37950
5882	480	142	217	37601	0	38440
5883	37972	150	169	813	0	39104
5884	762	37391	125	401	0	38679
5885	36070	498	87	327	0	36982
5886	726	36065	90	173	0	37054
5887	35284	497	76	225	0	36082
5888	35232	203	86	189	0	35710
5889	687	38511	78	121	0	39397
5890	38446	577	49	170	0	39242
5891	39677	233	99	184	0	40193
5892	925	36637	89	111	0	37762
5893	367	37917	80	83	0	38447
5894	39492	728	142	188	0	40550
5895	943	281	63	39822	0	41109
5896	40035	212	47	848	0	41142
5897	41055	122	37	371	0	41585
5898	41450	116	43	291	0	41900
5899	41356	90	43	240	0	41729
5900	1224	39562	75	143	0	41004
5901	543	40920	61	114	0	41638
5902	41042	875	72	194	0	42183
5903	978	369	40714	83	0	42144
5904	512	295	718	39675	0	41200
5905	405	142	254	41123	0	41924
5906	40810	128	147	1040	0	42125
5907	912	40467	87	477	0	41943
5908	544	799	64	40270	0	41677
5909	436	333	51	42049	0	42869
5910	41701	234	51	1229	0	43215
5911	1148	173	48	41985	0	43354
5912	41838	169	70	1178	0	43255
5913	42127	187	58	547	0	42919
5914	42367	164	36	416	0	42983
5915	1526	148	68	41521	0	43263
5916	806	184	53	41919	0	42962
5917	582	118	45411	1200	0	47311
5918	502	120	44952	519	0	46093
5919	45146	152	1378	435	0	47111
5920	1481	137	569	46704	0	48891
5921	741	151	49665	1323	0	51880
5922	570	158	50007	627	0	51362
5923	510	123	1736	49926	0	52295
5924	450	158	50182	1548	0	52338
5925	505	187	1545	49885	0	52122
5926	556	131	645	50441	0	51773
5927	401	142	50078	2041	0	52662
5928	548	112	1453	50579	0	52692
5929	616	149	705	48913	0	50383
5930	579	99	405	52395	0	53478
5931	464	184	50592	2303	0	53543
5932	554	128	1485	52293	0	54460
5933	51791	115	690	2121	0	54717
5934	1721	51734	464	1111	0	55030
5935	52575	1400	352	890	0	55217
5936	1960	612	51597	544	0	54713
5937	51943	315	1592	685	0	54535
5938	53210	228	764	618	0	54820
5939	52947	243	557	546	0	54293
5940	2513	232	393	51404	0	54542
5941	1353	191	421	52582	0	54547
5942	854	162	48608	2342	0	51966
5943	46395	129	1591	1342	0	49457
5944	1953	46753	783	885	0	50374
5945	932	44373	483	701	0	46489
5946	644	45934	390	654	0	47622
5947	804	1817	405	43958	0	46984
5948	43641	751	358	1809	0	46559
5949	44309	413	349	1035	0	46106
5950	2128	279	42730	685	0	45822
5951	1217	297	1451	42878	0	45843
5952	894	256	652	43921	0	45723
5953	691	273	42552	2150	0	45666
5954	652	230	41446	1173	0	43501
5955	41664	163	1827	936	0	44590
5956	1765	42095	892	728	0	45480
5957	43134	1326	544	737	0	45741
5958	43679	622	423	715	0	45439
5959	2242	375	407	42358	0	45382
5960	1285	291	408	43548	0	45532
5961	42054	287	397	2200	0	44938
5962	2026	271	366	42250	0	44913
5963	1177	294	358	42983	0	44812
5964	42084	251	412	2331	0	45078
5965	1927	228	404	42617	0	45176
5966	42825	186	384	2173	0	45568
5967	43586	151	443	1304	0	45484
5968	2232	213	41932	937	0	45314
5969	42237	200	1583	916	0	44936
5970	43185	220	838	894	0	45137
5971	43079	198	632	870	0	44779
5972	2502	273	30654	898	0	34327
5973	41023	194	1193	776	0	43186
5974	2101	40198	679	777	0	43755
5975	41676	1282	505	829	0	44292
5976	42407	524	422	879	0	44232
5977	2446	265	384	41202	0	44297
5978	1449	187	432	41599	0	43667
5979	1030	41002	405	2321	0	44758
5980	1054	1308	339	42214	0	44915
5981	1058	630	344	43216	0	45248
5982	42106	350	447	2428	0	45331
5983	2186	257	356	41919	0	44718
5984	1474	243	320	42459	0	44496
5985	1184	266	332	41954	0	43736
5986	1002	39875	413	2357	0	43647
5987	39712	1306	402	1391	0	42811
5988	2051	39554	396	1013	0	43014
5989	36190	1273	286	844	0	38593
5990	1839	587	34610	739	0	37775
5991	33472	355	1172	759	0	35758
5992	1707	298	33745	746	0	36496
5993	1012	32891	1278	667	0	35848
5994	31657	1092	917	632	0	34298
5995	31191	559	419	586	0	32755
5996	1668	29720	291	530	0	32209
5997	980	30402	248	541	0	32171
5998	30042	1296	313	528	0	32179
5999	30736	592	184	549	0	32061
6000	1772	361	214	29764	0	32111
6001	1149	294	193	30671	0	32307
6002	714	317	29431	1520	0	31982
6003	29121	293	902	891	0	31207
6004	1459	263	485	29084	0	31291
6005	902	29090	348	1142	0	31482
6006	784	863	215	29306	0	31168
6007	656	502	178	29702	0	31038
6008	560	342	28415	1460	0	30777
6009	603	302	869	28720	0	30494
6010	28104	289	403	1317	0	30113
6011	1120	27267	251	780	0	29418
6012	721	27594	155	518	0	28988
6013	27480	1098	158	467	0	29203
6014	28058	545	196	460	0	29259
6015	27793	324	187	454	0	28758
6016	1517	26160	201	382	0	28260
6017	562	23543	98	208	0	24411
6018	24720	695	154	247	0	25816
6019	24960	351	148	244	0	25703
6020	1007	23456	122	198	0	24783
6021	284	20748	49	152	0	21233
6022	20463	502	100	135	0	21200
6023	541	233	27	20222	0	21023
6024	20855	139	41	490	0	21525
6025	585	128	28	20716	0	21457
6026	264	20907	34	457	0	21662
6027	228	21621	36	221	0	22106
6028	22159	533	70	187	0	22949
6029	21720	265	47	204	0	22236
6030	22628	170	60	107	0	22965
6031	711	22260	33	92	0	23096
6032	267	458	20733	50	0	21508
6033	164	21062	352	79	0	21657
6034	20434	480	164	104	0	21182
6035	19619	187	51	147	0	20004
6036	550	142	19687	46	0	20425
6037	221	19464	346	72	0	20103
6038	237	390	149	19410	0	20186
6039	181	194	51	18904	0	19330
6040	170	16695	63	451	0	17379
6041	146	459	18773	143	0	19521
6042	19302	175	371	118	0	19966
6043	542	149	113	19575	0	20379
6044	19790	103	84	451	0	20428
6045	20162	116	67	199	0	20544
6046	615	144	53	20867	0	21679
6047	349	104	73	21773	0	22299
6048	278	119	42	22231	0	22670
6049	231	119	39	22512	0	22901
6050	21895	127	66	772	0	22860
6051	22168	130	55	357	0	22710
6052	743	120	21951	223	0	23037
6053	430	84	467	22046	0	23027
6054	311	96	176	22518	0	23101
6055	222	105	122	22823	0	23272
6056	218	113	22034	764	0	23129
6057	260	97	484	21908	0	22749
6058	21785	91	214	713	0	22803
6059	689	92	112	21959	0	22852
6060	332	100	21711	730	0	22873
6061	258	99	507	21857	0	22721
6062	201	97	21828	713	0	22839
6063	22026	78	561	467	0	23132
6064	698	66	229	22451	0	23444
6065	22466	95	141	733	0	23435
6066	22359	80	128	409	0	22976
6067	836	76	104	22191	0	23207
6068	22639	63	123	778	0	23603
6069	805	68	103	21992	0	22968
6070	403	23356	95	715	0	24569
6071	24219	540	120	420	0	25299
6072	24282	225	94	332	0	24933
6073	24555	133	88	313	0	25089
6074	1020	108	89	23991	0	25208
6075	534	74	93	24329	0	25030
6076	341	97	79	24703	0	25220
6077	281	98	23468	952	0	24799
6078	274	23012	549	529	0	24364
6079	320	535	213	22744	0	23812
6080	250	215	22491	737	0	23693
6081	22075	138	577	430	0	23220
6082	734	81	232	22494	0	23541
6083	389	68	22087	773	0	23317
6084	22725	75	543	457	0	23800
6085	750	83	227	23293	0	24353
6086	408	63	181	23658	0	24310
6087	336	79	107	24017	0	24539
6088	23599	44	101	1035	0	24779
6089	23883	69	126	559	0	24637
6090	23676	55	114	408	0	24253
6091	859	22303	121	338	0	23621
6092	428	23070	135	266	0	23899
6093	23113	594	89	330	0	24126
6094	708	224	22767	321	0	24020
6095	425	128	505	22711	0	23769
6096	366	74	223	23350	0	24013
6097	22898	92	134	859	0	23983
6098	22353	92	129	482	0	23056
6099	801	22143	99	344	0	23387
6100	451	480	116	22536	0	23583
6101	323	191	21992	725	0	23231
6102	284	114	22057	434	0	22889
6103	300	94	633	22332	0	23359
6104	285	81	257	23139	0	23762
6105	22525	85	164	919	0	23693
6106	714	83	125	23045	0	23967
6107	23529	82	150	837	0	24598
6108	23204	79	144	488	0	23915
6109	823	74	22505	384	0	23786
6110	23235	75	434	405	0	24149
6111	23770	73	208	365	0	24416
6112	23887	56	146	378	0	24467
6113	871	23051	171	299	0	24392
6114	463	23153	123	301	0	24040
6115	385	646	103	22965	0	24099
6116	284	229	22774	688	0	23975
6117	243	21716	468	390	0	22817
6118	296	451	259	20358	0	21364
6119	278	159	126	20051	0	20614
6120	222	19977	101	526	0	20826
6121	20146	348	84	359	0	20937
6122	20352	151	83	282	0	20868
6123	623	83	20316	200	0	21222
6124	19379	64	333	242	0	20018
6125	452	76	19278	210	0	20016
6126	17827	71	322	232	0	18452
6127	480	75	18482	155	0	19192
6128	299	18022	299	122	0	18742
6129	320	241	230	17448	0	18239
6130	196	111	96	17574	0	17977
6131	17777	62	80	424	0	18343
6132	17719	56	82	282	0	18139
6133	17563	50	64	215	0	17892
6134	403	48	17722	164	0	18337
6135	279	65	252	17594	0	18190
6136	201	52	131	18060	0	18444
6137	18001	48	85	432	0	18566
6138	344	17901	78	222	0	18545
6139	18694	239	68	200	0	19201
6140	370	117	83	18961	0	19531
6141	261	80	65	19281	0	19687
6142	167	62	67	19343	0	19639
6143	160	62	42	19461	0	19725
6144	167	63	47	19349	0	19626
6145	160	18411	49	435	0	19055
6146	119	17295	51	182	0	17647
6147	79	16962	26	69	0	17136
6148	79	178	28	17159	0	17444
6149	79	63	16864	147	0	17153
6150	15238	39	137	113	0	15527
6151	169	17308	69	46	0	17592
6152	103	129	46	17287	0	17565
6153	64	48	42	17486	0	17640
6154	17595	40	22	246	0	17903
6155	17277	33	25	139	0	17474
6156	17523	21	17	103	0	17664
6157	234	27	20	18157	0	18438
6158	125	28	18237	174	0	18564
6159	77	23	18412	101	0	18613
6160	82	13	184	18869	0	19148
6161	74	27	19011	207	0	19319
6162	18082	34	167	121	0	18404
6163	206	33	61	18601	0	18901
6164	106	41	18667	181	0	18995
6165	112	21	153	18257	0	18543
6166	65	30	19144	220	0	19459
6167	71	27	19756	107	0	19961
6168	123	51	214	20461	0	20849
6169	57	24	21629	244	0	21954
6170	36	35	20223	95	0	20389
6171	43	18776	350	66	0	19235
6172	127	248	163	20050	0	20588
6173	21304	99	88	309	0	21800
6174	274	53	43	20997	0	21367
6175	175	22	32	21841	0	22070
6176	76	22	21610	360	0	22068
6177	19989	6	257	248	0	20500
6178	274	7	124	22082	0	22487
6179	139	5	82	22596	0	22822
6180	22390	5	57	414	0	22866
6181	284	5	46	22767	0	23102
6182	22766	11	40	425	0	23242
6183	22768	16	54	247	0	23085
6184	22509	14	37	177	0	22737
6185	394	21968	50	82	0	22494
6186	22391	226	45	118	0	22780
6187	324	22248	44	96	0	22712
6188	194	285	46	22406	0	22931
6189	22481	127	43	328	0	22979
6190	293	22460	42	183	0	22978
6191	22645	260	33	170	0	23108
6192	343	22449	42	87	0	22921
6193	22287	311	36	113	0	22747
6194	352	21847	25	97	0	22321
6195	194	22206	38	81	0	22519
6196	148	23378	31	65	0	23622
6197	138	426	20	22502	0	23086
6198	93	23509	34	262	0	23898
6199	132	371	33	23404	0	23940
6200	120	187	24	23796	0	24127
6201	129	125	17	23836	0	24107
6202	133	86	21	23985	0	24225
6203	23600	83	19	553	0	24255
6204	23817	67	17	333	0	24234
6205	466	80	23645	150	0	24341
6206	24249	77	294	151	0	24771
6207	25706	76	135	147	0	26064
6208	26486	80	92	144	0	26802
6209	617	81	25425	92	0	26215
6210	299	79	25401	99	0	25878
6211	24790	88	492	136	0	25506
6212	512	87	26234	110	0	26943
6213	268	27239	474	118	0	28099
6214	249	447	187	27625	0	28508
6215	28496	194	131	577	0	29398
6216	28735	119	103	296	0	29253
6217	28920	79	101	208	0	29308
6218	761	56	111	28595	0	29523
6219	445	68	87	29150	0	29750
6220	279	71	29338	658	0	30346
6221	302	68	487	29272	0	30129
6222	257	63	229	30180	0	30729
6223	29742	45	173	742	0	30702
6224	633	30030	121	334	0	31118
6225	30593	476	120	299	0	31488
6226	674	244	131	30657	0	31706
6227	30426	149	105	701	0	31381
6228	30039	96	103	400	0	30638
6229	29228	80	116	319	0	29743
6230	806	28931	86	209	0	30032
6231	424	29828	106	211	0	30569
6232	347	613	88	30086	0	31134
6233	30315	270	89	656	0	31330
6234	681	154	100	29868	0	30803
6235	423	110	79	30277	0	30889
6236	318	113	30034	781	0	31246
6237	318	123	462	29893	0	30796
6238	299	123	222	30096	0	30740
6239	305	111	131	30271	0	30818
6240	243	104	29789	888	0	31024
6241	283	94	28845	457	0	29679
6242	289	29287	607	324	0	30507
6243	29512	517	255	322	0	30606
6244	681	265	149	29719	0	30814
6245	390	188	29562	646	0	30786
6246	404	115	496	29280	0	30295
6247	346	105	223	31320	0	31994
6248	30853	104	163	904	0	32024
6249	30825	123	155	517	0	31620
6250	762	30734	179	335	0	32010
6251	30680	511	155	348	0	31694
6252	30577	247	157	317	0	31298
6253	825	193	163	30436	0	31617
6254	429	176	30310	649	0	31564
6255	321	30408	505	377	0	31611
6256	30403	555	221	365	0	31544
6257	31182	267	143	328	0	31920
6258	802	31899	124	286	0	33111
6259	521	546	94	32980	0	34141
6260	33915	209	107	857	0	35088
6261	34390	158	109	480	0	35137
6262	950	96	123	34395	0	35564
6263	33926	133	116	912	0	35087
6264	36377	137	79	463	0	37056
6265	36787	111	94	400	0	37392
6266	1138	138	36733	262	0	38271
6267	549	35280	621	309	0	36759
6268	434	36472	232	232	0	37370
6269	35119	658	165	281	0	36223
6270	841	35040	106	184	0	36171
6271	439	679	35001	154	0	36273
6272	430	269	595	34918	0	36212
6273	35071	177	180	754	0	36182
6274	910	150	125	34903	0	36088
6275	35151	159	90	837	0	36237
6276	35310	163	101	404	0	35978
6277	35073	108	103	354	0	35638
6278	955	33820	122	263	0	35160
6279	430	36141	158	255	0	36984
6280	35944	717	134	352	0	37147
6281	35332	303	103	345	0	36083
6282	36161	204	112	265	0	36742
6283	1067	179	111	35484	0	36841
6284	35323	187	120	785	0	36415
6285	890	34328	125	339	0	35682
6286	458	35912	109	302	0	36781
6287	490	770	90	35488	0	36838
6288	401	271	35005	782	0	36459
6289	401	194	34503	347	0	35445
6290	482	153	680	34936	0	36251
6291	405	203	35243	719	0	36570
6292	432	230	632	35213	0	36507
6293	35697	227	190	802	0	36916
6294	962	192	148	35532	0	36834
6295	35408	154	157	839	0	36558
6296	880	34432	172	342	0	35826
6297	441	685	34800	259	0	36185
6298	465	275	616	33627	0	34983
6299	411	238	216	35029	0	35894
6300	311	220	35069	884	0	36484
6301	408	182	646	33961	0	35197
6302	308	35356	276	799	0	36739
6303	382	684	206	36343	0	37615
6304	385	240	146	36990	0	37761
6305	429	152	176	37828	0	38585
6306	348	123	37366	1089	0	38926
6307	304	101	34480	450	0	35335
6308	31972	109	831	390	0	33302
6309	802	141	34100	239	0	35282
6310	297	34366	767	205	0	35635
6311	34529	652	257	307	0	35745
6312	783	34792	209	225	0	36009
6313	33943	709	258	272	0	35182
6314	34169	219	178	271	0	34837
6315	33611	157	160	235	0	34163
6316	33752	155	120	281	0	34308
6317	910	32478	137	223	0	33748
6318	391	33551	125	211	0	34278
6319	33591	741	126	213	0	34671
6320	849	318	32857	172	0	34196
6321	460	223	663	32244	0	33590
6322	394	156	248	33422	0	34220
6323	296	148	33143	810	0	34397
6324	30560	148	703	399	0	31810
6325	33034	170	243	282	0	33729
6326	32837	178	199	242	0	33456
6327	1014	32257	160	186	0	33617
6328	33680	701	168	234	0	34783
6329	998	297	151	32621	0	34067
6330	474	34949	161	692	0	36276
6331	35778	820	170	301	0	37069
6332	36134	337	131	266	0	36868
6333	38072	258	128	245	0	38703
6334	1415	246	107	37160	0	38928
6335	762	215	114	37307	0	38398
6336	499	36251	127	1052	0	37929
6337	401	854	36680	500	0	38435
6338	496	364	824	36476	0	38160
6339	505	232	371	35745	0	36853
6340	437	183	251	38215	0	39086
6341	334	186	37323	1274	0	39117
6342	36485	197	861	685	0	38228
6343	1139	165	344	38118	0	39766
6344	539	231	38383	1065	0	40218
6345	534	144	936	38338	0	39952
6346	38814	155	382	1252	0	40603
6347	1131	38345	312	597	0	40385
6348	644	939	210	39130	0	40923
6349	440	406	39083	1158	0	41087
6350	37117	283	986	655	0	39041
6351	38955	225	451	567	0	40198
6352	1352	189	38871	428	0	40840
6353	781	234	983	36239	0	38237
6354	486	38186	466	1057	0	40195
6355	38751	927	377	610	0	40665
6356	1218	389	37907	440	0	39954
6357	36697	260	1008	513	0	38478
6358	1273	184	36535	314	0	38306
6359	676	190	34575	317	0	35758
6360	33106	133	1146	370	0	34755
6361	974	34402	603	267	0	36246
6362	646	821	33979	303	0	35749
6363	459	33353	924	262	0	34998
6364	436	835	32704	267	0	34242
6365	361	32542	871	247	0	34021
6366	30665	804	536	282	0	32287
6367	841	349	30300	240	0	31730
6368	461	267	29895	198	0	30821
6369	417	191	29533	186	0	30327
6370	28958	184	1038	228	0	30408
6371	29810	146	540	220	0	30716
6372	974	136	337	29170	0	30617
6373	511	145	30237	665	0	31558
6374	438	117	30121	365	0	31041
6375	29891	144	957	271	0	31263
6376	822	134	584	30572	0	32112
6377	30735	160	393	724	0	32012
6378	31093	135	318	397	0	31943
6379	1045	169	271	29148	0	30633
6380	623	29208	260	648	0	30739
6381	438	620	323	29579	0	30960
6382	403	347	274	30056	0	31080
6383	336	243	29671	904	0	31154
6384	315	28619	777	531	0	30242
6385	331	29772	482	327	0	30912
6386	318	837	374	28821	0	30350
6387	281	416	29269	690	0	30656
6388	230	29195	846	418	0	30689
6389	334	662	29427	334	0	30757
6390	28308	352	890	347	0	29897
6391	29640	224	526	278	0	30668
6392	996	188	29277	228	0	30689
6393	28916	161	866	256	0	30199
6394	983	187	485	29092	0	30747
6395	573	30649	386	691	0	32299
6396	479	657	319	31359	0	32814
6397	30715	375	316	853	0	32259
6398	31142	276	317	504	0	32239
6399	31066	236	303	347	0	31952
6400	30609	179	282	328	0	31398
6401	1134	29798	314	245	0	31491
6402	585	29799	266	207	0	30857
6403	29567	750	331	252	0	30900
6404	839	424	29857	184	0	31304
6405	572	663	677	28775	0	30687
6406	315	30738	435	625	0	32113
6407	369	662	277	30042	0	31350
6408	229	31460	262	716	0	32667
6409	300	824	222	31524	0	32870
6410	235	408	31465	812	0	32920
6411	30519	254	772	491	0	32036
6412	31588	206	423	311	0	32528
6413	1049	212	31127	197	0	32585
6414	30803	217	784	223	0	32027
6415	31628	185	461	225	0	32499
6416	1081	226	30895	167	0	32369
6417	685	156	826	29917	0	31584
6418	30717	140	503	766	0	32126
6419	931	142	30609	411	0	32093
6420	631	200	784	29566	0	31181
6421	373	134	31333	795	0	32635
6422	342	185	30822	425	0	31774
6423	30377	157	1004	346	0	31884
6424	32027	157	573	234	0	32991
6425	32362	120	334	245	0	33061
6426	33600	133	243	218	0	34194
6427	1380	168	294	31923	0	33765
6428	693	30324	239	748	0	32004
6429	484	31303	204	411	0	32402
6430	345	834	194	29909	0	31282
6431	30059	312	180	758	0	31309
6432	857	28995	156	325	0	30333
6433	333	29212	141	155	0	29841
6434	29066	756	133	163	0	30118
6435	807	314	112	28934	0	30167
6436	29256	169	133	731	0	30289
6437	819	29117	117	270	0	30323
6438	29796	679	105	231	0	30811
6439	912	256	31007	129	0	32304
6440	33583	200	746	177	0	34706
6441	34989	130	252	202	0	35573
6442	35571	136	173	211	0	36091
6443	1390	213	28892	192	0	30687
6444	33899	145	622	236	0	34902
6445	1164	34071	254	151	0	35640
6446	556	827	34171	120	0	35674
6447	528	421	912	32735	0	34596
6448	423	212	367	32161	0	33163
6449	328	33273	188	1007	0	34796
6450	323	829	175	33710	0	35037
6451	311	305	190	34512	0	35318
6452	312	183	33203	1149	0	34847
6453	30926	144	923	562	0	32555
6454	1038	140	33477	292	0	34947
6455	598	91	950	33097	0	34736
6456	398	119	33928	967	0	35412
6457	303	118	1082	34020	0	35523
6458	34630	92	450	1154	0	36326
6459	35793	148	320	528	0	36789
6460	1372	114	271	35389	0	37146
6461	611	119	35934	1141	0	37805
6462	507	96	1035	36052	0	37690
6463	407	155	35426	1189	0	37177
6464	34305	119	1090	641	0	36155
6465	36331	117	421	522	0	37391
6466	35482	143	352	371	0	36348
6467	35841	139	254	417	0	36651
6468	1523	34113	290	295	0	36221
6469	800	964	209	34837	0	36810
6470	34177	419	264	1160	0	36020
6471	1243	33389	241	592	0	35465
6472	686	34813	203	458	0	36160
6473	601	1163	32819	299	0	34882
6474	32844	433	1027	371	0	34675
6475	34372	268	505	292	0	35437
6476	1544	216	32864	265	0	34889
6477	911	157	1138	32472	0	34678
6478	739	137	547	33760	0	35183
6479	596	155	33228	1344	0	35323
6480	572	151	1169	32797	0	34689
6481	33133	115	570	1297	0	35115
6482	1363	188	31825	618	0	33994
6483	716	149	33075	488	0	34428
6484	32436	138	1372	444	0	34390
6485	1329	200	33191	380	0	35100
6486	32671	216	1256	379	0	34522
6487	1393	32437	652	349	0	34831
6488	33433	984	429	357	0	35203
6489	1546	419	327	32633	0	34925
6490	799	287	346	33604	0	35036
6491	33267	249	279	1440	0	35235
6492	1377	273	238	33265	0	35153
6493	33340	228	303	1375	0	35246
6494	1417	33419	277	701	0	35814
6495	869	1075	240	31811	0	33995
6496	706	480	286	33101	0	34573
6497	32450	299	314	1442	0	34505
6498	32782	208	273	713	0	33976
6499	32736	215	269	565	0	33785
6500	1781	30445	288	420	0	32934
6501	904	31594	240	408	0	33146
6502	31384	1131	217	405	0	33137
6503	1467	438	30350	361	0	32616
6504	763	29858	1002	385	0	32008
6505	27848	853	669	356	0	29726
6506	27047	338	366	279	0	28030
6507	27160	223	241	235	0	27859
6508	1291	230	221	25940	0	27682
6509	26605	156	187	848	0	27796
6510	26789	135	178	445	0	27547
6511	1304	178	140	25550	0	27172
6512	26145	155	161	893	0	27354
6513	1139	156	24966	490	0	26751
6514	695	171	702	25508	0	27076
6515	534	196	325	26077	0	27132
6516	508	125	238	27188	0	28059
6517	26525	105	213	1244	0	28087
6518	27356	170	180	672	0	28378
6519	27565	137	144	485	0	28331
6520	27463	72	149	485	0	28169
6521	26646	76	167	361	0	27250
6522	1402	91	154	25158	0	26805
6523	862	93	147	25740	0	26842
6524	25178	98	177	1020	0	26473
6525	1027	24394	154	567	0	26142
6526	24753	578	131	396	0	25858
6527	989	228	23262	319	0	24798
6528	25315	188	576	331	0	26410
6529	26948	148	235	325	0	27656
6530	1248	107	27757	272	0	29384
6531	29190	76	820	240	0	30326
6532	1338	103	29081	240	0	30762
6533	927	69	30182	165	0	31343
6534	798	105	1334	28912	0	31149
6535	631	117	749	30979	0	32476
6536	536	75	30750	1308	0	32669
6537	405	101	30745	775	0	32026
6538	323	28932	1282	586	0	31123
6539	261	28579	684	428	0	29952
6540	25031	867	587	242	0	26727
6541	712	26585	300	170	0	27767
6542	25956	844	235	222	0	27257
6543	871	25725	176	153	0	26925
6544	25719	797	181	143	0	26840
6545	916	487	24387	103	0	25893
6546	24888	345	648	130	0	26011
6547	979	245	378	24385	0	25987
6548	588	24843	255	608	0	26294
6549	477	641	213	25104	0	26435
6550	25033	409	162	779	0	26383
6551	25516	272	105	491	0	26384
6552	1089	252	118	24807	0	26266
6553	694	157	24321	721	0	25893
6554	483	134	23612	460	0	24689
6555	380	24562	839	290	0	26071
6556	363	763	501	24504	0	26131
6557	263	387	24620	655	0	25925
6558	207	22880	696	388	0	24171
6559	312	638	421	23288	0	24659
6560	196	367	246	23952	0	24761
6561	22455	224	233	903	0	23815
6562	603	197	163	22645	0	23608
6563	404	162	22086	857	0	23509
6564	318	105	567	22268	0	23258
6565	21487	91	366	863	0	22807
6566	621	108	21453	559	0	22741
6567	21111	78	640	440	0	22269
6568	756	21879	415	289	0	23339
6569	22761	534	245	276	0	23816
6570	23037	328	249	215	0	23829
6571	980	231	183	22207	0	23601
6572	692	178	134	22465	0	23469
6573	429	21915	130	916	0	23390
6574	382	519	121	22923	0	23945
6575	22205	357	121	898	0	23581
6576	691	240	22026	556	0	23513
6577	513	217	536	21898	0	23164
6578	378	21809	358	695	0	23240
6579	339	549	253	22676	0	23817
6580	269	383	188	23081	0	23921
6581	22371	279	123	1050	0	23823
6582	656	22147	95	672	0	23570
6583	517	586	112	22558	0	23773
6584	22249	358	120	850	0	23577
6585	742	264	122	22361	0	23489
6586	530	217	107	22802	0	23656
6587	22612	164	97	1140	0	24013
6588	22585	93	103	794	0	23575
6589	973	139	22269	507	0	23888
6590	22274	113	537	434	0	23358
6591	23026	127	345	325	0	23823
6592	23283	131	234	281	0	23929
6593	1130	21413	183	283	0	23009
6594	749	21627	143	252	0	22771
6595	603	775	110	21666	0	23154
6596	21924	499	139	659	0	23221
6597	22223	336	92	491	0	23142
6598	996	227	113	21751	0	23087
6599	731	139	21664	749	0	23283
6600	21888	121	525	531	0	23065
6601	23284	163	348	387	0	24182
6602	1024	128	226	22573	0	23951
6603	741	129	183	22859	0	23912
6604	22913	96	123	953	0	24085
6605	899	129	84	22696	0	23808
6606	603	22473	117	872	0	24065
6607	481	544	104	23541	0	24670
6608	23318	343	106	881	0	24648
6609	783	240	22889	616	0	24528
6610	22028	189	502	523	0	23242
6611	867	140	22893	370	0	24270
6612	654	96	641	23137	0	24528
6613	23427	107	440	735	0	24709
6614	812	89	282	23252	0	24435
6615	621	103	182	23477	0	24383
6616	22566	91	184	1128	0	23969
6617	785	89	22177	734	0	23785
6618	573	75	22767	507	0	23922
6619	461	123	785	23193	0	24562
6620	365	82	518	24034	0	24999
6621	311	79	325	24376	0	25091
6622	260	74	23437	1088	0	24859
6623	22741	52	525	825	0	24143
6624	24324	56	383	566	0	25329
6625	24414	49	268	464	0	25195
6626	24236	61	198	368	0	24863
6627	1150	22652	160	297	0	24259
6628	741	21969	109	313	0	23132
6629	431	21286	99	242	0	22058
6630	284	402	94	17490	0	18270
6631	215	86	121	18453	0	18875
6632	180	38	17913	234	0	18365
6633	95	16598	136	105	0	16934
6634	155	89	47	16150	0	16441
6635	15717	30	42	161	0	15950
6636	97	15661	33	79	0	15870
6637	66	68	16	15509	0	15659
6638	57	15745	22	103	0	15927
6639	16089	84	19	109	0	16301
6640	128	35	33	15927	0	16123
6641	45	23	15389	100	0	15557
6642	55	14	15147	58	0	15274
6643	61	45	121	15697	0	15924
6644	54	14	48	15686	0	15802
6645	53	9	31	16266	0	16359
6646	15998	9	19	187	0	16213
6647	120	20	15804	72	0	16016
6648	55	15470	97	46	0	15668
6649	55	98	42	15491	0	15686
6650	35	30	15574	124	0	15763
6651	30	15545	103	57	0	15735
6652	44	113	55	15991	0	16203
6653	18	34	16044	106	0	16202
6654	35	27	98	15676	0	15836
6655	50	12	45	16003	0	16110
6656	16148	6	28	179	0	16361
6657	16074	9	22	94	0	16199
6658	137	13	17	16083	0	16250
6659	16116	11	22	168	0	16317
6660	127	12	16448	54	0	16641
6661	65	14	123	16597	0	16799
6662	38	20	17104	148	0	17310
6663	48	50	142	17905	0	18145
6664	19	17661	53	200	0	17933
6665	28	18015	32	98	0	18173
6666	20	18762	38	43	0	18863
6667	96	218	25	18717	0	19056
6668	44	60	21	21811	0	21936
6669	16	36	21618	382	0	22052
6670	36	32	21681	118	0	21867
6671	26	28	22863	57	0	22974
6672	23717	28	451	70	0	24266
6673	465	21	104	24635	0	25225
6674	25001	17	40	506	0	25564
6675	470	25467	39	119	0	26095
6676	163	499	42	25868	0	26572
6677	26238	126	41	586	0	26991
6678	555	67	36	26255	0	26913
6679	26160	52	29	645	0	26886
6680	606	49	26419	190	0	27264
6681	150	26875	497	109	0	27631
6682	120	514	140	27379	0	28153
6683	27308	126	104	603	0	28141
6684	27849	73	77	260	0	28259
6685	706	35	67	27855	0	28663
6686	265	23	115	28357	0	28760
6687	27604	61	105	741	0	28511
6688	628	43	106	27487	0	28264
6689	238	53	27210	639	0	28140
6690	192	27175	540	251	0	28158
6691	203	528	155	27734	0	28620
6692	27855	154	110	733	0	28852
6693	28145	128	78	322	0	28673
6694	788	81	28264	248	0	29381
6695	302	27176	635	217	0	28330
6696	247	29146	176	205	0	29774
6697	224	756	116	28958	0	30054
6698	277	225	102	29311	0	29915
6699	227	172	92	29470	0	29961
6700	209	97	98	29566	0	29970
6701	229	28664	104	953	0	29950
6702	260	690	88	29068	0	30106
6703	240	200	86	29808	0	30334
6704	28888	131	81	1052	0	30152
6705	28930	119	71	525	0	29645
6706	889	28689	97	384	0	30059
6707	29061	727	82	350	0	30220
6708	29363	246	91	323	0	30023
6709	29270	186	77	381	0	29914
6710	1007	143	28288	282	0	29720
6711	485	125	681	28387	0	29678
6712	303	156	209	29440	0	30108
6713	250	157	28450	975	0	29832
6714	269	162	677	28333	0	29441
6715	323	157	248	26807	0	27535
6716	28258	104	161	1146	0	29669
6717	828	133	28038	567	0	29566
6718	365	127	688	27654	0	28834
6719	27149	142	232	1009	0	28532
6720	803	27147	157	522	0	28629
6721	27225	693	95	494	0	28507
6722	27283	249	107	382	0	28021
6723	984	26477	118	336	0	27915
6724	473	719	100	26793	0	28085
6725	26809	253	105	914	0	28081
6726	924	26665	91	455	0	28135
6727	473	730	133	27041	0	28377
6728	26732	266	114	937	0	28049
6729	26569	200	123	501	0	27393
6730	996	26060	122	428	0	27606
6731	26506	695	149	402	0	27752
6732	937	285	131	26440	0	27793
6733	26472	173	87	1039	0	27771
6734	980	161	25854	439	0	27434
6735	509	148	716	25981	0	27354
6736	410	146	226	26526	0	27308
6737	25761	146	173	1058	0	27138
6738	911	25299	166	509	0	26885
6739	25036	760	157	406	0	26359
6740	999	24997	145	352	0	26493
6741	492	773	24241	317	0	25823
6742	406	306	24326	364	0	25402
6743	494	277	801	24000	0	25572
6744	314	281	24264	865	0	25724
6745	361	224	698	24500	0	25783
6746	401	162	215	24237	0	25015
6747	405	179	168	25344	0	26096
6748	25126	175	137	1123	0	26561
6749	25214	166	95	584	0	26059
6750	25908	174	127	412	0	26621
6751	1191	25099	99	359	0	26748
6752	589	27307	100	342	0	28338
6753	473	902	28575	341	0	30291
6754	438	402	852	29082	0	30774
6755	357	279	29040	1145	0	30821
6756	379	199	1032	28963	0	30573
6757	402	220	339	29801	0	30762
6758	330	164	333	30035	0	30862
6759	311	164	28571	1478	0	30524
6760	333	174	957	28558	0	30022
6761	28039	133	425	1400	0	29997
6762	1061	27247	296	716	0	29320
6763	501	841	234	27015	0	28591
6764	26661	325	200	1206	0	28392
6765	26778	265	220	624	0	27887
6766	1262	198	186	25735	0	27381
6767	677	128	167	25084	0	26056
6768	22662	130	136	1136	0	24064
6769	956	101	143	22715	0	23915
6770	21096	87	97	1042	0	22322
6771	951	71	84	20514	0	21620
6772	422	70	19072	946	0	20510
6773	360	17780	506	494	0	19140
6774	247	18733	220	403	0	19603
6775	352	531	293	18056	0	19232
6776	319	244	213	18283	0	19059
6777	17763	159	114	769	0	18805
6778	567	135	75	18081	0	18858
6779	284	106	66	18355	0	18811
6780	277	79	72	17202	0	17630
6781	179	16601	69	852	0	17701
6782	219	433	40	17205	0	17897
6783	191	175	54	17299	0	17719
6784	192	147	63	17236	0	17638
6785	15956	95	83	957	0	17091
6786	519	16054	75	517	0	17165
6787	249	454	67	16546	0	17316
6788	196	200	64	16780	0	17240
6789	181	194	35	16900	0	17310
6790	16041	103	45	937	0	17126
6791	593	77	32	16273	0	16975
6792	303	76	25	16115	0	16519
6793	213	87	14675	808	0	15783
6794	124	14285	322	525	0	15256
6795	130	401	126	14923	0	15580
6796	14273	163	107	672	0	15215
6797	404	14537	60	397	0	15398
6798	14259	384	55	382	0	15080
6799	14422	158	67	281	0	14928
6800	521	155	40	14286	0	15002
6801	320	106	45	14688	0	15159
6802	219	112	14389	625	0	15345
6803	166	83	324	14934	0	15507
6804	181	50	14769	653	0	15653
6805	157	76	389	15180	0	15802
6806	14370	53	156	697	0	15276
6807	416	14694	152	413	0	15675
6808	206	383	109	15887	0	16585
6809	198	185	116	16135	0	16634
6810	158	157	102	16089	0	16506
6811	146	95	64	16275	0	16580
6812	15599	85	75	751	0	16510
6813	421	15474	54	477	0	16426
6814	256	358	52	16267	0	16933
6815	16107	142	56	711	0	17016
6816	463	124	15719	450	0	16756
6817	15664	83	374	407	0	16528
6818	16206	94	170	306	0	16776
6819	567	94	15842	288	0	16791
6820	358	72	413	16085	0	16928
6821	16309	91	188	573	0	17161
6822	550	16554	153	357	0	17614
6823	17080	406	87	347	0	17920
6824	17346	153	99	312	0	17910
6825	17498	122	71	325	0	18016
6826	727	92	65	17081	0	17965
6827	424	92	53	17715	0	18284
6828	309	18738	61	662	0	19770
6829	324	469	44	19365	0	20202
6830	19310	212	53	703	0	20278
6831	633	149	18914	369	0	20065
6832	18485	102	431	394	0	19412
6833	19881	86	176	305	0	20448
6834	733	102	139	19436	0	20410
6835	395	76	95	19985	0	20551
6836	19830	73	69	768	0	20740
6837	19930	61	88	436	0	20515
6838	18148	88	84	403	0	18723
6839	754	67	19300	255	0	20376
6840	412	19070	387	268	0	20137
6841	19393	421	164	296	0	20274
6842	668	182	102	19281	0	20233
6843	365	19274	82	557	0	20278
6844	346	479	64	19295	0	20184
6845	19127	190	87	656	0	20060
6846	617	177	74	19222	0	20090
6847	397	116	18639	619	0	19771
6848	251	18348	321	371	0	19291
6849	199	19103	150	327	0	19779
6850	184	419	17891	277	0	18771
6851	15580	325	478	270	0	16653
6852	347	15875	155	174	0	16551
6853	204	172	69	13830	0	14275
6854	13747	68	28	184	0	14027
6855	170	13525	25	88	0	13808
6856	94	148	26	13678	0	13946
6857	13690	58	40	193	0	13981
6858	205	41	16	13650	0	13912
6859	13627	28	17	231	0	13903
6860	198	27	13656	108	0	13989
6861	105	13852	139	64	0	14160
6862	14520	153	44	101	0	14818
6863	14442	64	26	105	0	14637
6864	14383	32	27	110	0	14552
6865	260	36	13614	53	0	13963
6866	13757	30	140	79	0	14006
6867	14448	42	51	64	0	14605
6868	241	38	25	14329	0	14633
6869	14382	39	28	199	0	14648
6870	218	14130	21	112	0	14481
6871	137	145	33	14325	0	14640
6872	95	66	14180	171	0	14512
6873	121	39	135	14064	0	14359
6874	84	38	60	14303	0	14485
6875	14187	35	26	264	0	14512
6876	14085	57	27	134	0	14303
6877	230	43	13866	91	0	14230
6878	13453	37	168	101	0	13759
6879	221	26	13868	67	0	14182
6880	155	27	156	13869	0	14207
6881	104	46	13946	190	0	14286
6882	102	35	161	13745	0	14043
6883	98	13824	78	177	0	14177
6884	117	160	13952	92	0	14321
6885	105	70	14302	44	0	14521
6886	176	40	269	11695	0	12180
6887	14452	46	111	220	0	14829
6888	14461	27	55	145	0	14688
6889	14589	46	38	113	0	14786
6890	296	43	38	14324	0	14701
6891	173	34	43	14532	0	14782
6892	129	24	30	14639	0	14822
6893	118	19	32	14633	0	14802
6894	90	34	14329	289	0	14742
6895	116	33	191	14223	0	14563
6896	65	14023	76	258	0	14422
6897	93	177	49	14405	0	14724
6898	14628	67	46	305	0	15046
6899	282	56	14503	131	0	14972
6900	13557	21	247	154	0	13979
6901	308	24	15147	82	0	15561
6902	138	41	15183	66	0	15428
6903	77	15137	349	75	0	15638
6904	171	288	146	13264	0	13869
6905	89	111	109	14869	0	15178
6906	122	12598	95	390	0	13205
6907	16187	319	68	176	0	16750
6908	416	138	54	16706	0	17314
6909	270	74	61	18147	0	18552
6910	168	47	63	19035	0	19313
6911	20557	40	41	817	0	21455
6912	21804	51	50	439	0	22344
6913	856	31	39	21450	0	22376
6914	425	30	44	21731	0	22230
6915	21068	35	49	927	0	22079
6916	756	34	44	21196	0	22030
6917	389	39	52	21620	0	22100
6918	318	42	43	21898	0	22301
6919	264	30	20556	1040	0	21890
6920	19836	36	535	621	0	21028
6921	20756	26	227	524	0	21533
6922	946	32	19623	395	0	20996
6923	549	169	572	18406	0	19696
6924	344	19345	274	790	0	20753
6925	19162	537	166	583	0	20448
6926	701	19180	203	432	0	20516
6927	409	18579	144	352	0	19484
6928	469	712	125	17775	0	19081
6929	17481	318	134	735	0	18668
6930	18173	182	125	490	0	18970
6931	855	179	97	17801	0	18932
6932	552	143	74	18116	0	18885
6933	429	181	71	18050	0	18731
6934	399	194	72	18017	0	18682
6935	330	187	49	17640	0	18206
6936	289	16814	75	1107	0	18285
6937	354	525	50	17544	0	18473
6938	17078	264	54	1037	0	18433
6939	17405	183	40	733	0	18361
6940	17394	140	42	662	0	18238
6941	924	16647	71	585	0	18227
6942	604	538	57	16991	0	18190
6943	415	312	16575	932	0	18234
6944	16483	224	506	661	0	17874
6945	849	214	232	16862	0	18157
6946	16871	152	179	922	0	18124
6947	16695	132	101	589	0	17517
6948	16804	186	86	445	0	17521
6949	1084	182	76	16060	0	17402
6950	16253	191	117	854	0	17415
6951	1012	147	108	16199	0	17466
6952	692	99	115	16634	0	17540
6953	16318	101	74	1049	0	17542
6954	980	94	59	16491	0	17624
6955	16344	128	52	975	0	17499
6956	16697	108	49	715	0	17569
6957	1117	108	49	16425	0	17699
6958	708	95	49	16881	0	17733
6959	585	83	37	17177	0	17882
6960	522	88	15483	1228	0	17321
6961	519	58	15728	858	0	17163
6962	532	58	645	15710	0	16945
6963	526	80	311	15911	0	16828
6964	440	73	179	16287	0	16979
6965	424	67	144	16268	0	16903
6966	347	66	121	16547	0	17081
6967	15335	76	152	1327	0	16890
6968	773	14983	195	860	0	16811
6969	553	501	190	15766	0	17010
6970	15617	234	170	1044	0	17065
6971	863	160	100	15882	0	17005
6972	539	122	90	16182	0	16933
6973	15361	104	90	1333	0	16888
6974	15658	89	96	897	0	16740
6975	1032	132	14910	682	0	16756
6976	670	120	514	15528	0	16832
6977	582	112	15178	1026	0	16898
6978	493	75	580	15720	0	16868
6979	461	48	274	15940	0	16723
6980	444	49	195	16156	0	16844
6981	445	50	14898	1309	0	16702
6982	396	14240	618	859	0	16113
6983	335	15211	352	750	0	16648
6984	306	612	294	15304	0	16516
6985	14730	283	232	1089	0	16334
6986	696	152	14568	837	0	16253
6987	456	145	15120	702	0	16423
6988	363	105	780	15311	0	16559
6989	305	134	460	15103	0	16002
6990	262	15307	337	1060	0	16966
6991	257	612	254	15465	0	16588
6992	294	316	209	16311	0	17130
6993	287	196	197	16652	0	17332
6994	15541	134	252	1184	0	17111
6995	15680	120	223	828	0	16851
6996	880	120	195	15804	0	16999
6997	503	15230	131	998	0	16862
6998	370	522	120	15429	0	16441
6999	14723	277	99	1041	0	16140
7000	632	14911	137	787	0	16467
7001	462	479	123	13756	0	14820
7002	356	13792	99	816	0	15063
7003	13659	480	80	626	0	14845
7004	13014	314	101	524	0	13953
7005	650	13310	99	508	0	14567
7006	414	13155	92	414	0	14075
7007	319	514	11895	324	0	13052
7008	191	11151	302	305	0	11949
7009	252	469	164	9504	0	10389
7010	174	178	9289	373	0	10014
7011	52	6883	123	110	0	7168
7012	44	101	64	6119	0	6328
7013	31	48	14	6327	0	6420
7014	24	24	11	6378	0	6437
7015	6186	21	14	158	0	6379
7016	99	23	6019	71	0	6212
7017	55	19	5987	44	0	6105
7018	25	26	116	6083	0	6250
7019	17	31	6519	112	0	6679
7020	33	19	107	6599	0	6758
7021	23	27	56	6129	0	6235
7022	19	23	31	6802	0	6875
7023	22	19	25	6890	0	6956
7024	6686	22	29	161	0	6898
7025	6681	17	15	100	0	6813
7026	126	16	14	6822	0	6978
7027	55	12	7093	136	0	7296
7028	51	13	90	7089	0	7243
7029	29	7052	50	123	0	7254
7030	29	90	32	7135	0	7286
7031	7083	39	23	149	0	7294
7032	7248	23	30	92	0	7393
7033	124	16	15	7332	0	7487
7034	71	19	19	7350	0	7459
7035	42	16	8	7462	0	7528
7036	7249	17	13	177	0	7456
7037	111	18	7189	79	0	7397
7038	65	19	7045	61	0	7190
7039	27	7048	99	48	0	7222
7040	7152	79	39	55	0	7325
7041	104	36	25	7270	0	7435
7042	42	31	7374	116	0	7563
7043	16	7176	80	64	0	7336
7044	28	7483	33	39	0	7583
7045	41	93	11	7518	0	7663
7046	30	35	13	7741	0	7819
7047	21	7547	21	127	0	7716
7048	22	83	17	7853	0	7975
7049	30	38	18	7879	0	7965
7050	7738	14	23	138	0	7913
7051	83	7697	28	68	0	7876
7052	33	91	18	7706	0	7848
7053	27	48	7605	100	0	7780
7054	31	28	79	7561	0	7699
7055	7604	16	40	116	0	7776
7056	82	7582	20	60	0	7744
7057	39	89	15	7672	0	7815
7058	22	44	7590	115	0	7771
7059	22	29	7862	71	0	7984
7060	31	35	119	8229	0	8414
7061	28	31	37	8541	0	8637
7062	8546	17	20	166	0	8749
7063	108	8679	21	63	0	8871
7064	8791	106	23	53	0	8973
7065	108	45	8824	49	0	9026
7066	8397	19	117	65	0	8598
7067	125	23	8940	45	0	9133
7068	8693	20	118	53	0	8884
7069	9063	24	45	55	0	9187
7070	157	24	9594	38	0	9813
7071	57	22	9366	42	0	9487
7072	34	9203	163	41	0	9441
7073	39	122	52	9983	0	10196
7074	10105	40	37	170	0	10352
7075	142	22	27	10356	0	10547
7076	69	30	24	10481	0	10604
7077	49	21	22	10570	0	10662
7078	33	15	10385	183	0	10616
7079	9435	12	137	103	0	9687
7080	10509	18	58	66	0	10651
7081	173	10797	32	53	0	11055
7082	88	120	36	10623	0	10867
7083	49	10940	30	131	0	11150
7084	45	129	33	11146	0	11353
7085	11098	54	29	194	0	11375
7086	146	11023	20	81	0	11270
7087	70	136	12	10786	0	11004
7088	10679	43	12	182	0	10916
7089	10741	15	25	90	0	10871
7090	190	20	23	10413	0	10646
7091	67	18	10414	152	0	10651
7092	52	60	116	9911	0	10139
7093	46	10328	46	119	0	10539
7094	10318	120	27	71	0	10536
7095	127	10279	27	40	0	10473
7096	76	121	11	10164	0	10372
7097	10312	50	6	142	0	10510
7098	133	36	10	10556	0	10735
7099	66	18	11	10598	0	10693
7100	47	21	10447	161	0	10676
7101	36	10301	110	75	0	10522
7102	10142	108	39	59	0	10348
7103	9288	45	25	82	0	9440
7104	126	9938	14	33	0	10111
7105	50	10095	14	37	0	10196
7106	49	110	20	10004	0	10183
7107	9878	43	12	126	0	10059
7108	97	9769	7	49	0	9922
7109	49	96	5	9967	0	10117
7110	36	42	9854	101	0	10033
7111	38	28	83	9860	0	10009
7112	9955	18	27	139	0	10139
7113	106	10011	16	54	0	10187
7114	41	90	11	10419	0	10561
7115	27	36	10273	109	0	10445
7116	28	34	10068	40	0	10170
7117	44	32	103	10371	0	10550
7118	46	22	36	10570	0	10674
7119	35	10310	20	118	0	10483
7120	30	124	14	10346	0	10514
7121	10413	39	11	140	0	10603
7122	122	35	17	10573	0	10747
7123	10560	27	12	150	0	10749
7124	116	10398	24	59	0	10597
7125	47	10687	31	54	0	10819
7126	47	114	28	10990	0	11179
7127	43	44	26	10755	0	10868
7128	32	43	10659	142	0	10876
7129	44	38	103	10466	0	10651
7130	10564	31	45	172	0	10812
7131	111	35	10495	70	0	10711
7132	64	27	110	10749	0	10950
7133	48	20	11065	164	0	11297
7134	54	27	119	11188	0	11388
7135	55	30	53	11114	0	11252
7136	53	28	34	11422	0	11537
7137	50	23	11285	180	0	11538
7138	43	30	131	11028	0	11232
7139	34	11262	51	171	0	11518
7140	32	144	39	11553	0	11768
7141	26	52	25	11553	0	11656
7142	11372	32	22	223	0	11649
7143	133	32	11181	107	0	11453
7144	69	25	122	11281	0	11497
7145	56	19	11111	193	0	11379
7146	55	26	10551	97	0	10729
7147	41	25	170	11209	0	11445
7148	71	30	72	10761	0	10934
7149	37	33	55	11640	0	11765
7150	11461	30	35	261	0	11787
7151	143	29	11283	132	0	11587
7152	11434	36	145	126	0	11741
7153	178	25	58	12149	0	12410
7154	82	32	48	12435	0	12597
7155	53	12992	45	224	0	13314
7156	67	119	39	13448	0	13673
7157	63	31	50	13423	0	13567
7158	68	31	43	13385	0	13527
7159	12358	23	37	225	0	12643
7160	115	22	11920	126	0	12183
7161	11089	27	122	113	0	11351
7162	135	12089	54	83	0	12361
7163	11893	100	29	117	0	12139
7164	122	11800	33	77	0	12032
7165	67	11812	23	89	0	11991
7166	105	141	47	11951	0	12244
7167	12021	51	39	155	0	12266
7168	124	29	21	12153	0	12327
7169	57	11772	23	179	0	12031
7170	43	12127	23	94	0	12287
7171	46	156	16	12217	0	12435
7172	38	79	12	12197	0	12326
7173	43	12164	17	203	0	12427
7174	60	145	20	12719	0	12944
7175	52	61	23	12720	0	12856
7176	49	40	22	12852	0	12963
7177	12639	37	11	246	0	12933
7178	150	34	12473	119	0	12776
7179	12208	49	130	118	0	12505
7180	12991	34	50	90	0	13165
7181	12748	16	34	89	0	12887
7182	184	12558	14	61	0	12817
7183	100	123	10	12468	0	12701
7184	12507	50	18	162	0	12737
7185	140	34	11	12696	0	12881
7186	12672	18	14	183	0	12887
7187	144	13199	17	87	0	13447
7188	13804	124	11	93	0	14032
7189	14028	45	12	87	0	14172
7190	14184	34	6	72	0	14296
7191	191	25	17	14015	0	14248
7192	112	25	12	14403	0	14552
7193	14444	22	11	201	0	14678
7194	153	14179	15	101	0	14448
7195	78	14223	10	68	0	14379
7196	14832	147	11	77	0	15067
7197	158	70	12	14877	0	15117
7198	78	42	13	15032	0	15165
7199	88	28	4	15251	0	15371
7200	53	14921	16	227	0	15217
7201	15056	155	9	130	0	15350
7202	199	55	8	15209	0	15471
7203	86	15258	21	174	0	15539
7204	84	179	8	16062	0	16333
7205	67	61	6	16232	0	16366
7206	58	45	4	16188	0	16295
7207	50	40	5	16345	0	16440
7208	16177	23	7	286	0	16493
7209	16080	40	10	145	0	16275
7210	16354	26	7	104	0	16491
7211	242	28	10	16321	0	16601
7212	120	32	16023	196	0	16371
7213	89	42	14723	109	0	14963
7214	74	32	15361	99	0	15566
7215	15991	43	199	107	0	16340
7216	182	39	74	16411	0	16706
7217	102	26	35	16397	0	16560
7218	87	28	22	16576	0	16713
7219	16334	29	14	279	0	16656
7220	16205	23	18	173	0	16419
7221	218	16806	27	118	0	17169
7222	113	150	16	16997	0	17276
7223	89	58	16671	206	0	17024
7224	65	16832	139	115	0	17151
7225	80	156	48	17181	0	17465
7226	82	62	36	17294	0	17474
7227	52	49	29	17176	0	17306
7228	84	33	17	16846	0	16980
7229	58	33	16647	250	0	16988
7230	61	33	15677	147	0	15918
7231	52	16700	167	122	0	17041
7232	68	132	58	16885	0	17143
7233	65	49	37	16619	0	16770
7234	16264	47	29	232	0	16572
7235	185	32	16298	100	0	16615
7236	76	29	136	16323	0	16564
7237	72	26	51	16892	0	17041
7238	58	25	17264	211	0	17558
7239	45	17175	137	109	0	17466
7240	17265	130	46	129	0	17570
7241	175	59	17111	83	0	17428
7242	16459	26	121	129	0	16735
7243	172	38	17809	61	0	18080
7244	99	21	134	18043	0	18297
7245	71	29	18075	145	0	18320
7246	45	36	18142	94	0	18317
7247	56	23	164	18622	0	18865
7248	203	70	135	14156	0	14564
7249	52	25	41	19385	0	19503
7250	58	20	29	18926	0	19033
7251	48	29	29	18888	0	18994
7252	36	23	18762	224	0	19045
7253	40	33	17506	128	0	17707
7254	33	18806	151	84	0	19074
7255	18605	138	75	112	0	18930
7256	176	57	43	18812	0	19088
7257	18772	22	40	224	0	19058
7258	200	20	21	18756	0	18997
7259	19233	14	32	275	0	19554
7260	195	12	41	19406	0	19654
7261	89	16	33	19535	0	19673
7262	61	19751	44	231	0	20087
7263	45	148	36	20552	0	20781
7264	79	65	21	20555	0	20720
7265	52	27	42	20501	0	20622
7266	58	20	27	20357	0	20462
7267	38	19777	35	247	0	20097
7268	19803	125	22	155	0	20105
7269	143	19697	24	87	0	19951
7270	52	121	25	19415	0	19613
7271	19079	55	16	210	0	19360
7272	147	35	18510	80	0	18772
7273	55	29	18263	62	0	18409
7274	96	54	141	17944	0	18235
7275	34	15	68	18782	0	18899
7276	26	13	36	18787	0	18862
7277	46	16	56	17437	0	17555
7278	42	11	23	18347	0	18423
7279	13	17931	19	203	0	18166
7280	29	114	14	18434	0	18591
7281	18343	36	10	222	0	18611
7282	136	20	20	18690	0	18866
7283	46	35	19211	176	0	19468
7284	41	16	169	18991	0	19217
7285	18874	8	64	295	0	19241
7286	177	19815	39	106	0	20137
7287	78	171	21	21570	0	21840
7288	73	59	15	22726	0	22873
7289	40	31	22236	483	0	22790
7290	36	42	27054	148	0	27280
7291	30750	23	712	144	0	31629
7292	852	23	203	31148	0	32226
7293	377	22	213	32300	0	32912
7294	292	26	33414	1111	0	34843
7295	204	32	33461	616	0	34313
7296	111	33725	1151	519	0	35506
7297	184	833	561	33588	0	35166
7298	70	306	33937	934	0	35247
7299	47	33817	1121	419	0	35404
7300	33837	990	490	423	0	35740
7301	35296	428	450	320	0	36494
7302	1294	354	292	33921	0	35861
7303	626	34645	231	1000	0	36502
7304	34622	1043	251	531	0	36447
7305	1397	451	199	32580	0	34627
7306	641	405	33828	1066	0	35940
7307	491	34334	960	602	0	36387
7308	34209	1075	463	598	0	36345
7309	35270	440	476	442	0	36628
7310	1398	497	321	34753	0	36969
7311	820	352	227	35730	0	37129
7312	645	258	34592	1456	0	36951
7313	591	248	1082	35169	0	37090
7314	560	226	473	33681	0	34940
7315	506	173	418	35628	0	36725
7316	405	158	292	35919	0	36774
7317	347	198	270	34524	0	35339
7318	279	34161	232	1964	0	36636
7319	33962	988	227	1350	0	36527
7320	1119	418	33929	1022	0	36488
7321	522	33571	1057	753	0	35903
7322	637	1129	453	34584	0	36803
7323	34505	504	452	1489	0	36950
7324	1305	437	348	34814	0	36904
7325	636	340	287	35553	0	36816
7326	613	265	290	35757	0	36925
7327	450	225	264	36128	0	37067
7328	382	216	33878	2257	0	36733
7329	300	33849	1094	1555	0	36798
7330	34027	1083	472	1349	0	36931
7331	1190	494	34028	1026	0	36738
7332	628	527	1295	34520	0	36970
7333	34252	439	591	1638	0	36920
7334	1353	34122	626	954	0	37055
7335	34695	1240	458	931	0	37324
7336	1669	633	399	31761	0	34462
7337	920	558	307	35628	0	37413
7338	865	395	260	35310	0	36830
7339	637	303	217	35734	0	36891
7340	33788	314	224	2414	0	36740
7341	1358	305	182	34819	0	36664
7342	818	239	281	35551	0	36889
7343	33052	310	266	2238	0	35866
7344	1499	278	32578	1407	0	35762
7345	891	247	1133	33569	0	35840
7346	32159	215	510	2008	0	34892
7347	32899	172	434	1246	0	34751
7348	1778	242	309	32128	0	34457
7349	1117	178	303	32164	0	33762
7350	872	30090	307	2126	0	33395
7351	684	1023	236	31733	0	33676
7352	610	421	216	32137	0	33384
7353	480	426	29730	2337	0	32973
7354	482	293	29168	1628	0	31571
7355	429	29213	1309	1407	0	32358
7356	436	1056	757	29700	0	31949
7357	517	476	623	30827	0	32443
7358	29630	469	571	1960	0	32630
7359	1248	402	465	29971	0	32086
7360	768	310	28735	2106	0	31919
7361	779	265	1130	29716	0	31890
7362	538	286	28016	2184	0	31024
7363	487	230	28483	1461	0	30661
7364	429	318	1522	28287	0	30556
7365	418	271	932	29540	0	31161
7366	28227	281	740	2123	0	31371
7367	29044	226	609	1410	0	31289
7368	1547	214	604	29178	0	31543
7369	29337	265	451	1884	0	31937
7370	30365	194	318	1300	0	32177
7371	1939	171	281	29966	0	32357
7372	1252	224	280	30813	0	32569
7373	29840	204	229	2164	0	32437
7374	30007	127	326	1516	0	31976
7375	1749	130	328	29800	0	32007
7376	1087	28650	342	2053	0	32132
7377	1014	964	337	29911	0	32226
7378	864	378	285	30889	0	32416
7379	617	347	28744	2317	0	32025
7380	639	276	970	30410	0	32295
7381	28362	198	467	2219	0	31246
7382	1268	28528	474	1464	0	31734
7383	28482	936	290	1292	0	31000
7384	28931	401	270	1039	0	30641
7385	29194	395	253	971	0	30813
7386	1976	531	231	27241	0	29979
7387	1375	274	23740	1442	0	26831
7388	1166	235	22829	840	0	25070
7389	735	22397	959	997	0	25088
7390	401	17136	336	552	0	18425
7391	238	13664	171	256	0	14329
7392	227	13239	225	234	0	13925
7393	350	334	12721	204	0	13609
7394	10810	216	416	151	0	11593
7395	216	62	67	10894	0	11239
7396	105	41	28	10817	0	10991
7397	96	31	30	10776	0	10933
7398	79	10749	33	192	0	11053
7399	10406	130	45	129	0	10710
7400	153	46	10483	76	0	10758
7401	51	9893	105	49	0	10098
7402	45	141	71	9942	0	10199
7403	9926	34	31	150	0	10141
7404	128	22	28	9938	0	10116
7405	62	20	9704	118	0	9904
7406	36	26	9722	73	0	9857
7407	57	23	114	10049	0	10243
7408	45	11	40	10155	0	10251
7409	10014	14	26	164	0	10218
7410	117	18	9927	72	0	10134
7411	9566	11	121	87	0	9785
7412	9807	16	40	64	0	9927
7413	155	19	17	9869	0	10060
7414	66	26	9978	129	0	10199
7415	55	22	106	9978	0	10161
7416	10071	20	38	154	0	10283
7417	122	10033	38	73	0	10266
7418	10243	107	29	72	0	10451
7419	146	29	22	10456	0	10653
7420	59	10888	28	172	0	11147
7421	54	155	32	10980	0	11221
7422	64	53	17	11277	0	11411
7423	53	11265	21	226	0	11565
7424	52	174	31	11502	0	11759
7425	51	48	35	11786	0	11920
7426	59	21	20	12159	0	12259
7427	55	27	12094	269	0	12445
7428	42	12064	204	123	0	12433
7429	12329	198	78	97	0	12702
7430	251	72	47	12574	0	12944
7431	80	13497	34	261	0	13872
7432	14394	237	21	157	0	14809
7433	309	91	22	14583	0	15005
7434	148	58	19	14715	0	14940
7435	106	47	19	14552	0	14724
7436	100	47	15	14392	0	14554
7437	14094	33	11	490	0	14628
7438	317	45	28	14335	0	14725
7439	156	34	17	14548	0	14755
7440	14245	29	21	497	0	14792
7441	354	30	11	14398	0	14793
7442	143	45	14143	431	0	14762
7443	124	45	263	14310	0	14742
7444	13891	41	99	445	0	14476
7445	341	36	56	14123	0	14556
7446	144	56	14076	442	0	14718
7447	118	48	13859	235	0	14260
7448	14103	35	368	247	0	14753
7449	14757	32	152	208	0	15149
7450	14848	23	94	219	0	15184
7451	14894	27	68	167	0	15156
7452	506	40	14565	149	0	15260
7453	293	24	306	14432	0	15055
7454	217	14	121	14937	0	15289
7455	14734	23	81	514	0	15352
7456	407	22	70	14976	0	15475
7457	181	21	14722	472	0	15396
7458	178	22	326	14911	0	15437
7459	120	19	14971	486	0	15596
7460	120	14975	370	251	0	15716
7461	15369	290	169	237	0	16065
7462	439	101	124	15404	0	16068
7463	184	66	15095	444	0	15789
7464	193	40	359	15199	0	15791
7465	167	32	145	15922	0	16266
7466	143	37	15713	524	0	16417
7467	143	42	387	15863	0	16435
7468	15692	21	201	554	0	16468
7469	404	44	14133	363	0	14944
7470	14486	37	334	271	0	15128
7471	455	14634	175	202	0	15466
7472	243	289	14727	194	0	15453
7473	191	160	14842	151	0	15344
7474	244	258	492	12223	0	13217
7475	163	41	247	14005	0	14456
7476	95	69	13973	515	0	14652
7477	130	46	392	14051	0	14619
7478	14049	42	201	540	0	14832
7479	14241	28	160	346	0	14775
7480	485	28	126	13972	0	14611
7481	273	34	124	13906	0	14337
7482	160	13967	117	536	0	14780
7483	14387	297	118	362	0	15164
7484	450	134	92	14472	0	15148
7485	236	14696	115	482	0	15529
7486	14870	353	101	343	0	15667
7487	15040	173	128	309	0	15650
7488	504	15265	118	260	0	16147
7489	305	358	106	15378	0	16147
7490	258	162	100	15465	0	15985
7491	206	98	14799	635	0	15738
7492	198	79	383	14847	0	15507
7493	14758	76	198	613	0	15645
7494	520	68	135	14790	0	15513
7495	268	62	14349	632	0	15311
7496	14283	65	418	403	0	15169
7497	494	55	212	14620	0	15381
7498	317	61	14381	550	0	15309
7499	241	59	397	14563	0	15260
7500	225	54	14451	572	0	15302
7501	242	72	441	14529	0	15284
7502	212	53	236	14928	0	15429
7503	14552	48	176	692	0	15468
7504	443	14503	150	449	0	15545
7505	14843	345	167	356	0	15711
7506	14705	149	145	335	0	15334
7507	14735	95	139	287	0	15256
7508	632	14348	124	306	0	15410
7509	400	374	14388	201	0	15363
7510	309	179	415	14443	0	15346
7511	14695	127	252	512	0	15586
7512	14937	74	182	343	0	15536
7513	633	85	166	14539	0	15423
7514	14521	74	164	573	0	15332
7515	539	65	14292	393	0	15289
7516	14171	46	445	334	0	14996
7517	582	62	14230	282	0	15156
7518	380	13945	450	241	0	15016
7519	14050	301	212	246	0	14809
7520	13546	162	214	224	0	14146
7521	588	13504	160	204	0	14456
7522	13491	355	178	209	0	14233
7523	13212	173	128	218	0	13731
7524	558	124	12760	178	0	13620
7525	12322	92	335	205	0	12954
7526	487	68	12142	180	0	12877
7527	300	140	323	11155	0	11918
7528	240	11586	184	325	0	12335
7529	219	233	11524	193	0	12169
7530	10478	347	406	247	0	11478
7531	10092	114	194	169	0	10569
7532	341	48	67	9432	0	9888
7533	175	51	9323	221	0	9770
7534	143	55	226	9310	0	9734
7535	9369	35	100	247	0	9751
7536	265	9400	75	127	0	9867
7537	9345	185	57	110	0	9697
7538	9470	72	70	95	0	9707
7539	303	9288	46	77	0	9714
7540	162	174	64	9442	0	9842
7541	9632	80	43	213	0	9968
7542	265	60	54	9711	0	10090
7543	161	58	56	10164	0	10439
7544	133	66	10182	250	0	10631
7545	148	29	188	10033	0	10398
7546	133	28	77	10141	0	10379
7547	9929	47	59	290	0	10325
7548	10004	32	54	160	0	10250
7549	318	24	61	9953	0	10356
7550	183	40	9755	236	0	10214
7551	145	42	9493	128	0	9808
7552	133	44	238	9682	0	10097
7553	116	50	10011	237	0	10414
7554	107	39	216	9827	0	10189
7555	115	33	117	9775	0	10040
7556	9931	15	80	298	0	10324
7557	232	27	9804	156	0	10219
7558	9601	19	200	121	0	9941
7559	9694	19	104	130	0	9947
7560	276	29	9328	88	0	9721
7561	177	40	9327	71	0	9615
7562	137	205	219	8960	0	9521
7563	107	8807	109	163	0	9186
7564	110	9176	78	84	0	9448
7565	116	158	54	8504	0	8832
7566	92	50	51	8259	0	8452
7567	61	27	50	8767	0	8905
7568	66	24	30	8844	0	8964
7569	8553	16	54	212	0	8835
7570	179	21	46	8608	0	8854
7571	81	21	8412	181	0	8695
7572	86	12	129	8222	0	8449
7573	72	8125	62	156	0	8415
7574	78	107	52	8169	0	8406
7575	8129	32	38	185	0	8384
7576	155	24	57	8240	0	8476
7577	70	32	8234	159	0	8495
7578	43	8037	131	100	0	8311
7579	51	108	53	8210	0	8422
7580	8147	48	37	180	0	8412
7581	8223	29	28	111	0	8391
7582	217	22	31	8261	0	8531
7583	82	27	7761	151	0	8021
7584	65	25	7203	80	0	7373
7585	7343	14	139	85	0	7581
7586	142	19	7630	63	0	7854
7587	57	18	7558	60	0	7693
7588	60	18	115	7162	0	7355
7589	7521	10	51	145	0	7727
7590	7347	12	33	87	0	7479
7591	7428	8	34	58	0	7528
7592	143	22	7711	60	0	7936
7593	87	8	8003	53	0	8151
7594	51	8622	112	52	0	8837
7595	51	91	67	8540	0	8749
7596	38	24	54	8813	0	8929
7597	53	22	54	8427	0	8556
7598	40	10	51	8886	0	8987
7599	54	14	8905	172	0	9145
7600	53	9144	108	94	0	9399
7601	9829	90	54	74	0	10047
7602	10769	30	58	86	0	10943
7603	10972	10	54	67	0	11103
7604	235	10935	57	33	0	11260
7605	90	178	47	10920	0	11235
7606	11293	40	49	251	0	11633
7607	224	11686	40	106	0	12056
7608	11727	195	35	102	0	12059
7609	240	11706	37	64	0	12047
7610	11826	207	46	74	0	12153
7611	11971	63	58	67	0	12159
7612	292	39	44	12047	0	12422
7613	132	24	46	12531	0	12733
7614	76	37	12343	297	0	12753
7615	82	37	11839	133	0	12091
7616	12182	28	290	103	0	12603
7617	12661	47	102	89	0	12899
7618	328	38	60	12410	0	12836
7619	176	30	48	12606	0	12860
7620	143	25	12337	333	0	12838
7621	110	57	228	12063	0	12458
7622	94	40	12049	337	0	12520
7623	115	43	257	12173	0	12588
7624	86	70	101	12493	0	12750
7625	12326	38	66	381	0	12811
7626	12316	68	40	172	0	12596
7627	376	44	41	12308	0	12769
7628	205	33	46	12469	0	12753
7629	124	33	12213	388	0	12758
7630	133	27	252	12376	0	12788
7631	114	49	12401	346	0	12910
7632	12228	39	303	182	0	12752
7633	369	36	117	12600	0	13122
7634	12500	37	93	333	0	12963
7635	346	12361	67	211	0	12985
7636	12656	241	70	196	0	13163
7637	359	95	106	12563	0	13123
7638	190	64	88	12553	0	12895
7639	144	12461	113	350	0	13068
7640	171	246	77	12667	0	13161
7641	130	87	12385	378	0	12980
7642	153	45	251	12377	0	12826
7643	108	44	11971	367	0	12490
7644	87	11579	300	194	0	12160
7645	104	195	161	11870	0	12330
7646	93	71	11792	302	0	12258
7647	105	53	11450	194	0	11802
7648	106	30	317	11550	0	12003
7649	11495	21	194	330	0	12040
7650	270	22	11405	185	0	11882
7651	158	23	258	11396	0	11835
7652	11552	39	121	360	0	12072
7653	290	11196	95	172	0	11753
7654	11836	221	69	200	0	12326
7655	312	69	53	11871	0	12305
7656	160	76	54	11966	0	12256
7657	125	48	42	12269	0	12484
7658	12049	41	69	428	0	12587
7659	293	38	77	12228	0	12636
7660	126	28	83	12526	0	12763
7661	11910	49	85	398	0	12442
7662	299	50	11926	226	0	12501
7663	163	46	285	12044	0	12538
7664	133	40	12007	337	0	12517
7665	11717	44	291	221	0	12273
7666	363	49	107	12101	0	12620
7667	150	59	12229	339	0	12777
7668	11679	58	264	238	0	12239
7669	12239	53	114	197	0	12603
7670	362	61	12626	163	0	13212
7671	199	50	291	12575	0	13115
7672	158	46	123	12952	0	13279
7673	117	46	12964	411	0	13538
7674	104	12723	289	259	0	13375
7675	124	233	12987	212	0	13556
7676	12320	75	310	210	0	12915
7677	286	66	13315	179	0	13846
7678	12631	31	335	189	0	13186
7679	346	18	13302	151	0	13817
7680	12783	15	320	222	0	13340
7681	322	13395	160	160	0	14037
7682	213	218	137	13254	0	13822
7683	176	82	92	13778	0	14128
7684	136	63	13683	382	0	14264
7685	172	39	262	13144	0	13617
7686	131	13309	136	349	0	13925
7687	13174	203	122	247	0	13746
7688	293	13345	106	194	0	13938
7689	161	238	78	13621	0	14098
7690	13569	75	103	389	0	14136
7691	306	13674	87	207	0	14274
7692	13219	251	130	190	0	13790
7693	391	84	13338	133	0	13946
7694	185	61	342	13136	0	13724
7695	178	44	148	13314	0	13684
7696	132	44	136	13657	0	13969
7697	13389	39	123	459	0	14010
7698	13434	74	102	235	0	13845
7699	13413	54	91	185	0	13743
7700	13056	39	89	154	0	13338
7701	389	41	12131	109	0	12670
7702	10561	19	173	82	0	10835
7703	220	10751	94	65	0	11130
7704	104	10908	69	62	0	11143
7705	10957	175	228	87	0	11447
7706	11095	63	80	93	0	11331
7707	197	29	30	10613	0	10869
7708	10784	21	26	162	0	10993
7709	10688	12	29	75	0	10804
7710	11618	15	40	71	0	11744
7711	258	30	16	11495	0	11799
7712	99	11225	27	177	0	11528
7713	61	11426	11	53	0	11551
7714	54	194	20	11372	0	11640
7715	11217	56	12	190	0	11475
7716	163	11405	16	73	0	11657
7717	91	145	15	11386	0	11637
7718	49	51	11446	152	0	11698
7719	10388	28	144	111	0	10671
7720	175	11338	45	49	0	11607
7721	62	11672	32	40	0	11806
7722	11427	170	19	53	0	11669
7723	186	67	11526	25	0	11804
7724	104	31	143	11216	0	11494
7725	53	11583	57	138	0	11831
7726	66	151	28	11710	0	11955
7727	57	57	18	11632	0	11764
7728	49	9787	35	204	0	10075
7729	68	157	14	11905	0	12144
7730	71	60	23	12001	0	12155
7731	11832	41	17	222	0	12112
7732	165	11809	25	79	0	12078
7733	11957	166	18	85	0	12226
7734	217	58	18	11808	0	12101
7735	84	12107	27	183	0	12401
7736	56	177	12111	72	0	12416
7737	56	98	180	12195	0	12529
7738	67	44	52	12785	0	12948
7739	33	48	12994	246	0	13321
7740	12309	44	178	114	0	12645
7741	229	36	62	14277	0	14604
7742	14222	34	30	293	0	14579
7743	276	36	13859	104	0	14275
7744	128	34	238	14094	0	14494
7745	73	44	14681	290	0	15088
7746	84	52	280	14752	0	15168
7747	86	46	97	15269	0	15498
7748	15022	24	59	408	0	15513
7749	278	15045	33	202	0	15558
7750	15250	271	31	137	0	15689
7751	332	110	15099	66	0	15607
7752	174	66	268	15038	0	15546
7753	81	43	15619	315	0	16058
7754	13494	47	334	199	0	14074
7755	15107	22	129	152	0	15410
7756	375	30	15139	84	0	15628
7757	14769	29	302	101	0	15201
7758	15423	26	120	95	0	15664
7759	426	24	82	15131	0	15663
7760	172	33	14914	331	0	15450
7761	121	33	15316	144	0	15614
7762	116	24	368	15320	0	15828
7763	112	29	163	15246	0	15550
7764	86	14906	119	371	0	15482
7765	90	15472	82	187	0	15831
7766	15436	335	64	157	0	15992
7767	360	129	67	15082	0	15638
7768	159	14955	76	323	0	15513
7769	136	15544	77	151	0	15908
7770	14764	356	86	152	0	15358
7771	357	136	69	14901	0	15463
7772	163	15083	85	337	0	15668
7773	169	310	50	15114	0	15643
7774	148	132	59	15161	0	15500
7775	140	79	73	15198	0	15490
7776	14791	70	69	479	0	15409
7777	353	14600	67	229	0	15249
7778	200	297	66	14710	0	15273
7779	144	134	75	14893	0	15246
7780	136	92	75	14969	0	15272
7781	110	81	14200	488	0	14879
7782	13618	59	326	288	0	14291
7783	361	68	141	14319	0	14889
7784	14058	77	91	437	0	14663
7785	14157	64	81	230	0	14532
7786	14135	75	78	210	0	14498
7787	468	83	13794	175	0	14520
7788	213	13723	308	152	0	14396
7789	164	318	129	13628	0	14239
7790	124	145	13604	390	0	14263
7791	116	123	13241	204	0	13684
7792	143	151	345	12724	0	13363
7793	103	12852	171	324	0	13450
7794	13088	270	105	244	0	13707
7795	13177	130	86	223	0	13616
7796	13311	101	75	183	0	13670
7797	13270	81	71	178	0	13600
7798	444	74	12851	161	0	13530
7799	12676	49	295	185	0	13205
7800	372	13163	149	156	0	13840
7801	226	279	91	13374	0	13970
7802	190	132	100	13680	0	14102
7803	13583	81	94	409	0	14167
7804	382	61	76	13630	0	14149
7805	217	70	13126	373	0	13786
7806	12533	48	293	245	0	13119
7807	13042	68	135	179	0	13424
7808	12936	61	120	171	0	13288
7809	447	54	12533	111	0	13145
7810	11547	59	247	154	0	12007
7811	337	11742	127	116	0	12322
7812	11970	226	123	142	0	12461
7813	316	114	108	11736	0	12274
7814	202	88	80	11856	0	12226
7815	167	11678	69	313	0	12227
7816	154	228	57	11722	0	12161
7817	134	11787	77	292	0	12290
7818	165	240	50	11627	0	12082
7819	136	11606	52	283	0	12077
7820	139	269	56	11718	0	12182
7821	129	11911	48	314	0	12402
7822	133	248	51	12465	0	12897
7823	114	12769	57	334	0	13274
7824	13652	283	64	200	0	14199
7825	374	136	42	13814	0	14366
7826	198	110	48	14003	0	14359
7827	186	75	36	14529	0	14826
7828	155	63	48	14595	0	14861
7829	130	85	14405	529	0	15149
7830	142	67	330	14503	0	15042
7831	144	65	131	14796	0	15136
7832	14291	55	74	533	0	14953
7833	14193	60	63	277	0	14593
7834	480	14484	47	187	0	15198
7835	264	321	48	14463	0	15096
7836	205	153	34	15308	0	15700
7837	15454	97	30	572	0	16153
7838	473	98	14240	256	0	15067
7839	14235	53	311	208	0	14807
7840	439	14731	137	156	0	15463
7841	13612	293	46	106	0	14057
7842	13598	122	31	92	0	13843
7843	429	13300	30	62	0	13821
7844	163	13957	29	69	0	14218
7845	236	408	53	13018	0	13715
7846	74	135	12950	312	0	13471
7847	12564	56	284	160	0	13064
7848	311	64	12939	78	0	13392
7849	12520	37	283	82	0	12922
7850	339	29	12800	61	0	13229
7851	141	12733	303	52	0	13229
7852	126	279	127	12777	0	13309
7853	12471	114	58	321	0	12964
7854	12841	68	33	145	0	13087
7855	426	40	31	12873	0	13370
7856	13378	35	36	337	0	13786
7857	13422	50	31	152	0	13655
7858	447	13116	34	93	0	13690
7859	13340	289	35	99	0	13763
7860	386	13444	34	63	0	13927
7861	236	322	36	13398	0	13992
7862	13238	128	30	354	0	13750
7863	13629	83	28	148	0	13888
7864	13640	64	26	108	0	13838
7865	475	57	13427	63	0	14022
7866	202	47	13639	72	0	13960
7867	182	40	399	14029	0	14650
7868	170	56	138	14828	0	15192
7869	107	15560	75	450	0	16192
7870	15726	377	64	188	0	16355
7871	472	163	56	15672	0	16363
7872	242	98	33	16009	0	16382
7873	144	80	15738	553	0	16515
7874	124	15147	381	222	0	15874
7875	116	16021	140	145	0	16422
7876	144	478	72	16008	0	16702
7877	15829	188	50	487	0	16554
7878	480	83	67	15852	0	16482
7879	234	91	64	16392	0	16781
7880	16045	88	53	625	0	16811
7881	16415	71	55	296	0	16837
7882	629	74	36	16232	0	16971
7883	274	87	16036	534	0	16931
7884	219	81	393	16295	0	16988
7885	202	51	152	16697	0	17102
7886	16410	65	87	677	0	17239
7887	542	55	72	16583	0	17252
7888	16563	66	81	622	0	17332
7889	557	77	16574	337	0	17545
7890	306	69	432	17011	0	17818
7891	251	73	171	17611	0	18106
7892	204	85	97	17859	0	18245
7893	200	75	78	17701	0	18054
7894	218	58	90	17306	0	17672
7895	162	66	16777	785	0	17790
7896	16618	60	464	424	0	17566
7897	568	70	214	16990	0	17842
7898	284	75	16686	647	0	17692
7899	209	66	16780	384	0	17439
7900	224	71	584	16744	0	17623
7901	16641	81	238	677	0	17637
7902	16791	92	126	419	0	17428
7903	17085	81	148	281	0	17595
7904	785	68	133	16087	0	17073
7905	360	16708	103	646	0	17817
7906	17199	458	135	381	0	18173
7907	17496	206	121	254	0	18077
7908	17512	132	98	298	0	18040
7909	17542	102	116	281	0	18041
7910	851	81	100	16997	0	18029
7911	447	62	16841	646	0	17996
7912	350	67	481	16962	0	17860
7913	285	79	16982	675	0	18021
7914	16875	53	507	412	0	17847
7915	17273	47	234	349	0	17903
7916	763	68	16685	274	0	17790
7917	16569	40	503	299	0	17411
7918	17413	44	220	308	0	17985
7919	836	56	163	16715	0	17770
7920	430	16702	135	629	0	17896
7921	16883	414	130	365	0	17792
7922	693	250	113	15848	0	16904
7923	354	15598	97	573	0	16622
7924	278	390	84	15291	0	16043
7925	220	147	15426	531	0	16324
7926	226	15566	385	318	0	16495
7927	15307	358	197	281	0	16143
7928	15368	151	172	246	0	15937
7929	15085	75	107	194	0	15461
7930	15199	46	117	225	0	15587
7931	583	149	116	14549	0	15397
7932	335	14527	103	418	0	15383
7933	13481	299	124	308	0	14212
7934	466	136	14222	193	0	15017
7935	301	13706	329	167	0	14503
7936	250	272	13189	155	0	13866
7937	228	115	240	12162	0	12745
7938	208	10491	147	275	0	11121
7939	210	226	93	12764	0	13293
7940	192	109	13262	298	0	13861
7941	204	65	235	12733	0	13237
7942	199	65	122	13460	0	13846
7943	179	74	85	13677	0	14015
7944	13119	57	104	400	0	13680
7945	339	12977	84	240	0	13640
7946	208	223	90	13205	0	13726
7947	12898	96	89	344	0	13427
7948	340	12971	76	215	0	13602
7949	13046	223	108	170	0	13547
7950	356	133	13242	154	0	13885
7951	278	75	216	12739	0	13308
7952	209	13154	111	282	0	13756
7953	13213	245	89	179	0	13726
7954	337	134	12934	115	0	13520
7955	219	11633	231	166	0	12249
7956	169	243	97	12279	0	12788
7957	166	111	61	12459	0	12797
7958	12273	65	82	287	0	12707
7959	279	88	62	12165	0	12594
7960	173	81	11841	261	0	12356
7961	181	55	165	11547	0	11948
7962	154	54	11954	237	0	12399
7963	167	105	179	11273	0	11724
7964	136	11773	98	222	0	12229
7965	11748	183	76	159	0	12166
7966	11420	95	52	101	0	11668
7967	237	10719	67	82	0	11105
7968	94	10047	29	49	0	10219
7969	129	101	52	9677	0	9959
7970	9594	26	29	122	0	9771
7971	116	30	26	9573	0	9745
7972	9502	30	16	107	0	9655
7973	106	9268	16	45	0	9435
7974	64	76	22	9641	0	9803
7975	44	41	9769	85	0	9939
7976	59	30	77	9640	0	9806
7977	46	29	34	9892	0	10001
7978	10073	27	27	127	0	10254
7979	85	10253	19	53	0	10410
7980	55	94	18	10388	0	10555
7981	10335	38	11	118	0	10502
7982	94	26	10409	45	0	10574
7983	10121	25	76	48	0	10270
7984	109	60	26	10559	0	10754
7985	49	10929	21	77	0	11076
7986	10883	81	7	62	0	11033
7987	106	32	11096	16	0	11250
7988	48	28	10650	18	0	10744
7989	24	10859	82	30	0	10995
7990	10792	55	69	34	0	10950
7991	69	18	13	10845	0	10945
7992	33	8	6	10776	0	10823
7993	10896	8	8	116	0	11028
7994	85	15	10904	41	0	11045
7995	51	4	77	11043	0	11175
7996	25	10	11643	89	0	11767
7997	42	6	85	11510	0	11643
7998	15	11750	37	95	0	11897
7999	31	79	17	12174	0	12301
8000	15	35	12022	110	0	12182
8001	11574	20	92	69	0	11755
8002	114	12	33	12356	0	12515
8003	35	14	12368	118	0	12535
8004	47	14	101	12018	0	12180
8005	49	12	44	12062	0	12167
8006	18	14	11832	141	0	12005
8007	19	22	11800	65	0	11906
8008	35	4	127	12225	0	12391
8009	20	13	12346	130	0	12509
8010	11976	9	133	79	0	12197
8011	121	8	57	12494	0	12680
8012	12398	8	45	159	0	12610
8013	127	14	12261	66	0	12468
8014	68	13	122	12395	0	12598
8015	39	7	13301	135	0	13482
8016	25	13053	144	69	0	13291
8017	29	99	13355	52	0	13535
8018	22	40	12798	51	0	12911
8019	12494	17	160	64	0	12735
8020	13135	14	74	68	0	13291
8021	150	14	13513	35	0	13712
8022	91	9	146	12723	0	12969
8023	68	14	72	13045	0	13199
8024	35	6	13680	173	0	13894
8025	24	12954	147	81	0	13206
8026	12693	118	77	85	0	12973
8027	135	55	13341	41	0	13572
8028	88	17	137	13386	0	13628
8029	61	17	72	13751	0	13901
8030	14070	11	43	222	0	14346
8031	14234	11	49	123	0	14417
8032	14366	13	44	79	0	14502
8033	14475	9	43	71	0	14598
8034	218	15	47	14318	0	14598
8035	103	20	14922	148	0	15193
8036	80	15	159	14837	0	15091
8037	81	10	82	15045	0	15218
8038	65	8	50	15601	0	15724
8039	43	16	15259	215	0	15533
8040	14241	11	153	122	0	14527
8041	197	12	72	15092	0	15373
8042	100	15	15359	204	0	15678
8043	57	15524	178	102	0	15861
8044	65	154	88	15993	0	16300
8045	65	66	51	16245	0	16427
8046	15975	22	36	289	0	16322
8047	188	16328	42	124	0	16682
8048	99	164	16453	78	0	16794
8049	99	61	176	16261	0	16597
8050	83	29	84	16348	0	16544
8051	16217	18	59	263	0	16557
8052	16094	17	41	159	0	16311
8053	248	15	45	16389	0	16697
8054	16365	19	41	252	0	16677
8055	217	16077	46	128	0	16468
8056	107	169	17020	85	0	17381
8057	109	67	187	16962	0	17325
8058	90	36	91	17553	0	17770
8059	80	32	69	17652	0	17833
8060	78	19	57	17411	0	17565
8061	55	17100	37	303	0	17495
8062	16947	168	63	170	0	17348
8063	216	76	49	17000	0	17341
8064	100	17606	55	238	0	17999
8065	17742	176	53	177	0	18148
8066	17658	76	48	143	0	17925
8067	240	18073	56	123	0	18492
8068	143	185	51	18584	0	18963
8069	100	102	35	18771	0	19008
8070	109	45	42	18409	0	18605
8071	95	50	41	18821	0	19007
8072	19050	35	47	341	0	19473
8073	19049	37	44	209	0	19339
8074	313	19120	42	142	0	19617
8075	141	245	19050	113	0	19549
8076	113	93	252	19138	0	19596
8077	19347	44	98	350	0	19839
8078	286	18705	46	188	0	19225
8079	120	18947	44	122	0	19233
8080	19245	309	44	118	0	19716
8081	19593	118	25	119	0	19855
8082	420	51	31	19372	0	19874
8083	172	52	19445	333	0	20002
8084	118	49	19351	183	0	19701
8085	20482	43	360	177	0	21062
8086	21479	36	118	159	0	21792
8087	21310	33	54	161	0	21558
8088	21103	42	54	121	0	21320
8089	21079	41	38	124	0	21282
8090	402	20857	39	104	0	21402
8091	250	278	29	20259	0	20816
8092	113	21631	28	230	0	22002
8093	22113	258	61	203	0	22635
8094	21758	112	39	181	0	22090
8095	21710	56	23	140	0	21929
8096	21700	48	28	111	0	21887
8097	371	21364	38	74	0	21847
8098	21282	238	25	97	0	21642
8099	303	21112	40	65	0	21520
8100	213	262	30	21236	0	21741
8101	21174	95	27	311	0	21607
8102	300	74	21387	116	0	21877
8103	216	53	212	20847	0	21328
8104	132	64	96	21381	0	21673
8105	129	51	21534	307	0	22021
8106	119	21262	207	141	0	21729
8107	21347	233	101	112	0	21793
8108	21196	102	43	117	0	21458
8109	335	21034	42	82	0	21493
8110	209	237	32	21074	0	21552
8111	144	143	21343	226	0	21856
8112	114	21840	209	131	0	22294
8113	21705	234	90	135	0	22164
8114	307	119	21710	57	0	22193
8115	19688	79	198	118	0	20083
8116	20901	71	83	101	0	21156
8117	354	60	21422	71	0	21907
8118	184	21346	222	49	0	21801
8119	172	227	100	20628	0	21127
8120	120	120	21866	222	0	22328
8121	20259	65	225	156	0	20705
8122	21320	58	90	107	0	21575
8123	325	21206	45	62	0	21638
8124	178	224	44	21211	0	21657
8125	123	126	30	21553	0	21832
8126	122	59	21513	257	0	21951
8127	97	21400	217	121	0	21835
8128	22084	215	86	167	0	22552
8129	22080	94	50	142	0	22366
8130	22257	63	58	114	0	22492
8131	333	70	21860	58	0	22321
8132	21237	45	199	111	0	21592
8133	22180	53	88	79	0	22400
8134	349	43	44	22159	0	22595
8135	153	59	21514	182	0	21908
8136	141	48	186	21264	0	21639
8137	102	50	21659	207	0	22018
8138	132	65	184	20934	0	21315
8139	90	21166	109	181	0	21546
8140	82	22244	49	90	0	22465
8141	106	216	49	22543	0	22914
8142	120	109	34	21657	0	21920
8143	21746	49	38	311	0	22144
8144	227	59	21596	94	0	21976
8145	20554	39	175	128	0	20896
8146	216	21839	86	60	0	22201
8147	21747	180	45	114	0	22086
8148	21721	81	49	99	0	21950
8149	297	51	49	21657	0	22054
8150	156	47	22114	181	0	22498
8151	136	52	185	21925	0	22298
8152	99	23022	86	188	0	23395
8153	97	221	46	23179	0	23543
8154	95	96	50	23470	0	23711
8155	23071	52	38	363	0	23524
8156	283	34	38	22540	0	22895
8157	147	22064	45	245	0	22501
8158	117	216	24	22546	0	22903
8159	22758	98	23	321	0	23200
8160	254	22957	44	137	0	23392
8161	155	243	35	23682	0	24115
8162	110	123	32	23864	0	24129
8163	108	60	41	25078	0	25287
8164	115	51	25	24823	0	25014
8165	24721	49	20	563	0	25353
8166	423	40	23	25168	0	25654
8167	212	51	27	25468	0	25758
8168	136	50	31	25713	0	25930
8169	68	25890	52	528	0	26538
8170	25426	395	34	315	0	26170
8171	456	159	25664	147	0	26426
8172	167	25089	359	116	0	25731
8173	24392	367	125	160	0	25044
8174	398	153	25001	66	0	25618
8175	166	24985	358	68	0	25577
8176	179	485	165	24191	0	25020
8177	67	25231	83	318	0	25699
8178	61	388	24885	146	0	25480
8179	88	171	24805	99	0	25163
8180	47	24976	430	92	0	25545
8181	24621	347	173	154	0	25295
8182	24699	141	74	137	0	25051
8183	427	85	24083	65	0	24660
8184	189	82	21894	54	0	22219
8185	101	78	22569	60	0	22808
8186	115	60	438	22207	0	22820
8187	130	44	180	22175	0	22529
8188	93	41	130	23169	0	23433
8189	58	56	23496	473	0	24083
8190	125	39	374	22523	0	23061
8191	87	56	149	23423	0	23715
8192	57	53	22730	525	0	23365
8193	21865	44	409	282	0	22600
8194	439	64	176	23258	0	23937
8195	233	46	131	23089	0	23499
8196	117	23562	103	518	0	24300
8197	23530	378	104	308	0	24320
8198	444	161	23579	152	0	24336
8199	23118	104	428	174	0	23824
8200	514	71	188	23495	0	24268
8201	225	92	23747	485	0	24549
8202	195	56	481	23433	0	24165
8203	23524	61	257	576	0	24418
8204	472	54	23493	282	0	24301
8205	22951	41	471	286	0	23749
8206	23517	59	243	231	0	24050
8207	23754	44	170	205	0	24173
8208	654	23270	167	140	0	24231
8209	349	421	133	23955	0	24858
8210	24569	180	95	596	0	25440
8211	24762	97	139	321	0	25319
8212	25427	81	111	268	0	25887
8213	808	96	24339	170	0	25413
8214	25815	68	513	225	0	26621
8215	812	76	265	27543	0	28696
8216	418	52	27376	754	0	28600
8217	392	58	750	28083	0	29283
8218	294	63	314	28660	0	29331
8219	218	61	28509	1119	0	29907
8220	263	71	856	28603	0	29793
8221	305	50	370	29686	0	30411
8222	194	78	33233	1191	0	34696
8223	34667	45	1071	702	0	36485
8224	38357	44	537	521	0	39459
8225	1713	59	425	39187	0	41384
8226	916	74	38923	1382	0	41295
8227	826	63	1382	37690	0	39961
8228	614	37700	621	1573	0	40508
8229	713	1127	465	38098	0	40403
8230	575	441	391	39490	0	40897
8231	38380	325	415	2168	0	41288
8232	38520	240	364	1489	0	40613
8233	39651	268	377	1095	0	41391
8234	2205	211	285	38649	0	41350
8235	1287	200	256	39718	0	41461
8236	990	181	37903	2218	0	41292
8237	1009	166	1321	36717	0	39213
8238	930	37356	658	1981	0	40925
8239	37856	1152	525	1349	0	40882
8240	1718	36947	458	1160	0	40283
8241	37597	1425	483	1022	0	40527
8242	1936	733	384	35377	0	38430
8243	1005	36797	426	1816	0	40044
8244	36893	1491	345	1298	0	40027
8245	37826	905	313	977	0	40021
8246	2383	668	292	36419	0	39762
8247	1434	36631	249	1866	0	40180
8248	1254	1583	268	37063	0	40168
8249	1045	741	36247	2124	0	40157
8250	35739	652	1352	1268	0	39011
8251	1873	36132	699	1160	0	39864
8252	35744	1555	500	977	0	38776
8253	2077	832	417	35686	0	39012
8254	36250	721	410	1940	0	39321
8255	2224	577	35900	1102	0	39803
8256	37156	480	1437	1098	0	40171
8257	37660	564	723	827	0	39774
8258	2699	433	36446	833	0	40411
8259	1938	366	1537	36018	0	39859
8260	1602	312	885	36932	0	39731
8261	35763	395	715	2373	0	39246
8262	2234	34998	641	1493	0	39366
8263	1475	1415	660	34242	0	37792
8264	1292	725	33360	2057	0	37434
8265	1014	650	33352	1481	0	36497
8266	1076	32758	1679	1301	0	36814
8267	1112	1406	33000	1174	0	36692
8268	31930	814	1787	1074	0	35605
8269	1914	699	1044	31112	0	34769
8270	32193	507	907	1900	0	35507
8271	1982	500	31717	1176	0	35375
8272	1273	463	1793	31703	0	35232
8273	1194	511	1000	32582	0	35287
8274	1047	478	31604	2150	0	35279
8275	1181	396	1609	31939	0	35125
8276	31116	515	927	2180	0	34738
8277	32205	412	857	1572	0	35046
8278	2251	353	712	31763	0	35079
8279	31528	363	751	2132	0	34774
8280	31916	413	622	1542	0	34493
8281	2458	30342	653	1292	0	34745
8282	1883	1186	594	31052	0	34715
8283	31573	662	478	2094	0	34807
8284	2413	571	536	31417	0	34937
8285	31534	437	537	2229	0	34737
8286	2430	475	497	31073	0	34475
8287	1666	478	30442	2337	0	34923
8288	1437	30356	1429	1620	0	34842
8289	1385	1424	818	26203	0	29830
8290	1438	30060	676	1920	0	34094
8291	30073	1541	632	1416	0	33662
8292	2097	28738	596	1299	0	32730
8293	1451	29303	602	1084	0	32440
8294	1358	1734	571	28933	0	32596
8295	28848	1267	525	1942	0	32582
8296	1925	987	462	29037	0	32411
8297	28832	880	410	2178	0	32300
8298	28906	925	409	1399	0	31639
8299	2291	28453	394	1286	0	32424
8300	29466	1623	498	1143	0	32730
8301	29951	882	496	1142	0	32471
8302	30152	846	458	978	0	32434
8303	2803	676	27726	890	0	32095
8304	2001	652	1273	27943	0	31869
8305	1912	586	688	29022	0	32208
8306	1593	608	26782	2045	0	31028
8307	28472	600	1357	1361	0	31790
8308	29572	397	825	1314	0	32108
8309	29315	424	722	1166	0	31627
8310	28283	404	597	1139	0	30423
8311	2570	26354	576	1173	0	30673
8312	27110	1091	398	951	0	29550
8313	2662	623	388	25891	0	29564
8314	1949	542	22209	1448	0	26148
8315	23491	390	763	902	0	25546
8316	2142	23030	513	751	0	26436
8317	22427	976	402	633	0	24438
8318	1789	21266	329	786	0	24170
8319	1301	20588	325	714	0	22928
8320	1129	20360	355	740	0	22584
8321	1031	20532	461	661	0	22685
8322	844	915	16035	506	0	18300
8323	758	1199	713	12657	0	15327
8324	358	243	11735	460	0	12796
8325	9611	131	280	206	0	10228
8326	339	9810	137	152	0	10438
8327	195	10006	83	182	0	10466
8328	170	330	81	9734	0	10315
8329	211	174	53	9865	0	10303
8330	164	163	9731	314	0	10372
8331	155	144	9648	178	0	10125
8332	170	123	268	9722	0	10283
8333	168	88	9838	286	0	10380
8334	177	9837	251	168	0	10433
8335	219	253	113	9332	0	9917
8336	192	133	86	10350	0	10761
8337	183	103	10158	332	0	10776
8338	194	65	222	10078	0	10559
8339	10201	48	137	316	0	10702
8340	342	65	103	10144	0	10654
8341	192	61	106	10191	0	10550
8342	151	77	9933	385	0	10546
8343	9259	65	236	259	0	9819
8344	333	10027	136	146	0	10642
8345	256	218	64	10010	0	10548
8346	201	105	9959	275	0	10540
8347	208	83	227	9847	0	10365
8348	9942	88	92	300	0	10422
8349	340	102	9944	162	0	10548
8350	211	81	224	9900	0	10416
8351	164	74	10156	304	0	10698
8352	149	10067	259	169	0	10644
8353	154	250	10054	121	0	10579
8354	136	9745	235	119	0	10235
8355	62	184	8994	68	0	9308
8356	76	130	202	8185	0	8593
8357	43	8605	87	138	0	8873
8358	8554	158	41	109	0	8862
8359	176	82	42	8621	0	8921
8360	8780	58	44	173	0	9055
8361	199	48	32	9048	0	9327
8362	117	54	27	9207	0	9405
8363	9128	41	28	240	0	9437
8364	9300	22	34	123	0	9479
8365	239	27	30	9577	0	9873
8366	128	27	9819	194	0	10168
8367	111	9654	159	94	0	10018
8368	75	168	9874	46	0	10163
8369	79	10006	174	57	0	10316
8370	9903	150	92	74	0	10219
8371	185	68	9822	47	0	10122
8372	86	44	9869	35	0	10034
8373	59	41	197	9556	0	9853
8374	9806	26	74	198	0	10104
8375	164	33	10105	82	0	10384
8376	101	10551	163	56	0	10871
8377	10884	148	71	77	0	11180
8378	11103	66	34	75	0	11278
8379	11226	29	34	60	0	11349
8380	11203	42	33	75	0	11353
8381	11118	38	29	58	0	11243
8382	240	27	10981	49	0	11297
8383	113	74	152	10420	0	10759
8384	71	10407	81	125	0	10684
8385	10907	141	35	85	0	11168
8386	155	10895	43	29	0	11122
8387	10382	112	34	47	0	10575
8388	10373	51	17	37	0	10478
8389	151	10257	40	36	0	10484
8390	10439	115	47	40	0	10641
8391	136	53	32	10433	0	10654
8392	90	29	22	10542	0	10683
8393	55	34	10391	128	0	10608
8394	49	10693	109	58	0	10909
8395	68	118	48	10710	0	10944
8396	76	44	31	10903	0	11054
8397	66	23	29	10919	0	11037
8398	46	41	10662	139	0	10888
8399	9675	20	119	96	0	9910
8400	136	27	52	10817	0	11032
8401	10846	25	29	146	0	11046
8402	167	22	23	10831	0	11043
8403	86	31	10986	133	0	11236
8404	69	26	10895	64	0	11054
8405	10511	26	154	76	0	10767
8406	11166	16	69	77	0	11328
8407	170	10977	44	54	0	11245
8408	80	131	11043	25	0	11279
8409	72	57	123	10742	0	10994
8410	182	72	116	7635	0	8005
8411	11465	33	35	210	0	11743
8412	11442	25	46	98	0	11611
8413	11358	27	31	80	0	11496
8414	180	26	11226	55	0	11487
8415	11308	11	136	85	0	11540
8416	160	28	62	11533	0	11783
8417	91	21	39	11550	0	11701
8418	63	20	30	11604	0	11717
8419	59	11388	36	179	0	11662
8420	11216	114	31	97	0	11458
8421	167	51	24	11150	0	11392
8422	85	36	11009	137	0	11267
8423	89	21	133	10765	0	11008
8424	52	10996	53	172	0	11273
8425	11087	118	47	98	0	11350
8426	158	64	47	11011	0	11280
8427	100	37	33	10900	0	11070
8428	72	24	10963	179	0	11238
8429	73	23	130	10795	0	11021
8430	58	10954	68	146	0	11226
8431	61	124	41	11184	0	11410
8432	65	50	11106	155	0	11376
8433	9868	30	120	124	0	10142
8434	10709	26	52	75	0	10862
8435	163	10990	34	57	0	11244
8436	10859	99	31	67	0	11056
8437	11214	37	20	65	0	11336
8438	155	11207	20	40	0	11422
8439	75	131	15	11288	0	11509
8440	11459	37	39	150	0	11685
8441	125	11890	20	73	0	12108
8442	61	119	11974	46	0	12200
8443	11782	62	119	76	0	12039
8444	12399	18	52	60	0	12529
8445	12373	20	28	79	0	12500
8446	12396	21	23	47	0	12487
8447	170	12766	25	29	0	12990
8448	12967	114	16	74	0	13171
8449	13302	56	13	65	0	13436
8450	13477	21	24	53	0	13575
8451	211	15	16	13394	0	13636
8452	13281	26	11	177	0	13495
8453	150	13646	21	75	0	13892
8454	77	147	14171	40	0	14435
8455	81	63	151	14460	0	14755
8456	14672	31	45	208	0	14956
8457	215	26	14726	63	0	15030
8458	131	18	173	14685	0	15007
8459	69	11	14753	200	0	15033
8460	55	14660	194	74	0	14983
8461	76	195	63	14434	0	14768
8462	53	61	14499	196	0	14809
8463	55	14447	171	85	0	14758
8464	106	182	60	14273	0	14621
8465	14413	52	76	220	0	14761
8466	14452	29	32	93	0	14606
8467	14576	33	26	63	0	14698
8468	14469	25	30	65	0	14589
8469	14395	22	29	92	0	14538
8470	283	28	14431	38	0	14780
8471	14371	32	180	58	0	14641
8472	14980	17	63	87	0	15147
8473	280	15	60	14857	0	15212
8474	14945	37	38	212	0	15232
8475	14446	30	28	119	0	14623
8476	242	13970	53	59	0	14324
8477	131	190	40	14125	0	14486
8478	114	58	40	14289	0	14501
8479	14241	33	29	242	0	14545
8480	260	13979	31	110	0	14380
8481	116	14492	35	74	0	14717
8482	138	203	20	14792	0	15153
8483	135	92	25	14927	0	15179
8484	111	46	48	14696	0	14901
8485	110	31	28	15069	0	15238
8486	14728	24	22	306	0	15080
8487	14596	30	23	170	0	14819
8488	323	33	14761	87	0	15204
8489	212	25	196	14540	0	14973
8490	155	45	45	14953	0	15198
8491	99	38	14641	302	0	15080
8492	13936	27	206	194	0	14363
8493	280	14554	72	100	0	15006
8494	14479	226	33	95	0	14833
8495	303	111	31	14369	0	14814
8496	129	61	14424	281	0	14895
8497	127	49	188	14596	0	14960
8498	99	46	15021	307	0	15473
8499	82	15192	227	160	0	15661
8500	14908	217	96	153	0	15374
8501	15081	69	49	111	0	15310
8502	284	15095	67	88	0	15534
8503	156	190	51	14896	0	15293
8504	14591	76	42	296	0	15005
8505	241	14464	67	130	0	14902
8506	160	205	54	14659	0	15078
8507	14714	99	37	283	0	15133
8508	284	63	14384	123	0	14854
8509	14083	42	187	171	0	14483
8510	258	14709	104	91	0	15162
8511	14672	194	81	130	0	15077
8512	14631	74	85	121	0	14911
8513	288	90	14481	78	0	14937
8514	202	69	191	14014	0	14476
8515	185	43	80	14575	0	14883
8516	126	82	14495	262	0	14965
8517	133	66	195	14114	0	14508
8518	173	57	100	12902	0	13232
8519	14674	62	62	306	0	15104
8520	14766	54	57	185	0	15062
8521	328	45	62	14616	0	15051
8522	169	44	14578	247	0	15038
8523	180	57	206	14528	0	14971
8524	145	67	85	14762	0	15059
8525	134	54	14858	301	0	15347
8526	167	37	213	15003	0	15420
8527	14931	41	105	303	0	15380
8528	14913	33	74	193	0	15213
8529	273	14794	63	149	0	15279
8530	15104	212	73	153	0	15542
8531	15107	60	58	158	0	15383
8532	313	15165	56	126	0	15660
8533	15530	221	44	143	0	15938
8534	15616	77	37	134	0	15864
8535	16145	44	30	134	0	16353
8536	370	40	15630	103	0	16143
8537	15382	26	232	144	0	15784
8538	326	19	86	15880	0	16311
8539	15860	31	77	333	0	16301
8540	320	37	15622	144	0	16123
8541	186	15004	230	101	0	15521
8542	15117	231	99	104	0	15551
8543	302	15442	65	71	0	15880
8544	180	248	48	15224	0	15700
8545	156	93	31	15761	0	16041
8546	15672	66	36	350	0	16124
8547	15299	39	48	147	0	15533
8548	372	48	15061	99	0	15580
8549	155	31	13699	66	0	13951
8550	125	22	14191	41	0	14379
8551	123	83	274	14100	0	14580
8552	78	45	14256	244	0	14623
8553	78	29	13681	84	0	13872
8554	196	290	250	12887	0	13623
8555	13787	20	92	251	0	14150
8556	13960	17	46	103	0	14126
8557	14046	17	38	81	0	14182
8558	14123	11	32	86	0	14252
8559	279	9	33	14047	0	14368
8560	111	9	45	14315	0	14480
8561	68	13	14875	233	0	15189
8562	97	8	233	14647	0	14985
8563	102	34	99	13803	0	14038
8564	15293	7	45	321	0	15666
8565	15280	15	50	116	0	15461
8566	336	12	35	15054	0	15437
8567	15159	8	23	317	0	15507
8568	15416	4	39	122	0	15581
8569	354	10	40	15343	0	15747
8570	155	10	31	15244	0	15440
8571	85	13	14884	339	0	15321
8572	85	18	14453	133	0	14689
8573	103	39	301	14868	0	15311
8574	100	16	112	15292	0	15520
8575	98	12	15220	318	0	15648
8576	14369	10	251	179	0	14809
8577	14842	8	89	124	0	15063
8578	366	12	14616	74	0	15068
8579	137	14442	260	93	0	14932
8580	14562	185	113	99	0	14959
8581	266	66	14935	72	0	15339
8582	131	30	244	14590	0	14995
8583	117	13	98	15232	0	15460
8584	15823	10	67	347	0	16247
8585	16845	6	69	196	0	17116
8586	366	13	60	16951	0	17390
8587	183	16	45	18146	0	18390
8588	17983	14	67	396	0	18460
8589	18085	17	59	196	0	18357
8590	17977	8	59	150	0	18194
8591	397	20	18138	99	0	18654
8592	206	14	275	18178	0	18673
8593	163	6	103	18862	0	19134
8594	18693	6	78	442	0	19219
8595	333	18696	61	207	0	19297
8596	20377	250	46	180	0	20853
8597	475	20504	57	108	0	21144
8598	256	373	60	20865	0	21554
8599	178	113	63	21195	0	21549
8600	119	63	20766	602	0	21550
8601	144	26	426	20819	0	21415
8602	140	26	20769	560	0	21495
8603	169	32	462	20972	0	21635
8604	152	29	184	21035	0	21400
8605	120	20090	116	601	0	20927
8606	119	21253	85	290	0	21747
8607	146	496	74	20443	0	21159
8608	141	167	76	21514	0	21898
8609	142	81	83	21630	0	21936
8610	159	64	90	21749	0	22062
8611	136	43	71	22093	0	22343
8612	117	58	21343	763	0	22281
8613	148	46	479	21266	0	21939
8614	149	52	178	21880	0	22259
8615	100	64	20945	756	0	21865
8616	101	20668	496	398	0	21663
8617	132	449	186	21105	0	21872
8618	117	159	20897	652	0	21825
8619	86	20897	500	366	0	21849
8620	134	478	206	21172	0	21990
8621	21583	162	122	726	0	22593
8622	565	83	112	21688	0	22448
8623	244	80	84	22087	0	22495
8624	160	84	110	22386	0	22740
8625	148	72	99	21882	0	22201
8626	117	20989	103	848	0	22057
8627	122	479	96	21810	0	22507
8628	22035	189	93	828	0	23145
8629	552	126	96	22466	0	23240
8630	255	90	99	22354	0	22798
8631	179	81	82	22748	0	23090
8632	21566	66	109	931	0	22672
8633	21691	58	80	580	0	22409
8634	698	77	101	21888	0	22764
8635	20023	82	76	769	0	20950
8636	20819	74	69	463	0	21425
8637	588	20684	88	331	0	21691
8638	20479	429	72	370	0	21350
8639	502	20475	71	315	0	21363
8640	240	20720	72	274	0	21306
8641	182	536	87	20856	0	21661
8642	174	190	21010	623	0	21997
8643	189	136	398	20473	0	21196
8644	173	89	168	20612	0	21042
8645	117	20368	108	665	0	21258
8646	20299	438	77	398	0	21212
8647	495	169	69	20520	0	21253
8648	211	155	20838	589	0	21793
8649	164	138	371	20730	0	21403
8650	133	21223	164	590	0	22110
8651	21407	432	93	400	0	22332
8652	491	177	75	21671	0	22414
8653	228	129	21508	633	0	22498
8654	202	114	396	21724	0	22436
8655	135	21162	141	650	0	22088
8656	145	436	94	21774	0	22449
8657	22229	195	97	709	0	23230
8658	22637	148	80	457	0	23322
8659	22681	129	83	400	0	23293
8660	660	22617	90	330	0	23697
8661	22323	461	77	318	0	23179
8662	583	191	68	22452	0	23294
8663	22090	149	79	687	0	23005
8664	541	22231	78	367	0	23217
8665	278	480	44	22595	0	23397
8666	162	209	22397	626	0	23394
8667	20848	144	400	439	0	21831
8668	476	22553	161	316	0	23506
8669	250	481	106	22683	0	23520
8670	209	199	68	23258	0	23734
8671	168	131	60	22749	0	23108
8672	166	116	72	22181	0	22535
8673	134	22198	69	720	0	23121
8674	22398	458	57	455	0	23368
8675	22468	191	61	344	0	23064
8676	606	144	22604	253	0	23607
8677	311	123	426	22720	0	23580
8678	213	93	22717	603	0	23626
8679	22071	128	443	383	0	23025
8680	22840	103	172	326	0	23441
8681	22378	80	113	296	0	22867
8682	673	102	68	21618	0	22461
8683	304	21371	49	575	0	22299
8684	21278	439	48	341	0	22106
8685	548	190	41	20614	0	21393
8686	20413	112	51	594	0	21170
8687	553	103	19102	258	0	20016
8688	263	81	18443	208	0	18995
8689	19333	74	415	225	0	20047
8690	566	55	188	19444	0	20253
8691	19157	64	115	514	0	19850
8692	515	19049	64	273	0	19901
8693	19154	365	52	211	0	19782
8694	19336	158	41	214	0	19749
8695	577	131	18950	135	0	19793
8696	210	67	16661	84	0	17022
8697	155	16857	282	87	0	17381
8698	205	241	177	16635	0	17258
8699	16734	75	149	287	0	17245
8700	278	53	44	16648	0	17023
8701	168	27	46	17140	0	17381
8702	115	51	16661	280	0	17107
8703	16141	34	209	177	0	16561
8704	296	38	91	17150	0	17575
8705	170	45	16824	237	0	17276
8706	133	46	16349	120	0	16648
8707	132	94	265	16766	0	17257
8708	80	54	16910	234	0	17278
8709	98	34	16660	120	0	16912
8710	116	44	247	15430	0	15837
8711	90	43	17057	210	0	17400
8712	85	49	216	16479	0	16829
8713	65	15989	96	237	0	16387
8714	17323	173	67	165	0	17728
8715	232	17699	48	97	0	18076
8716	149	256	37	17730	0	18172
8717	84	18471	45	262	0	18862
8718	89	295	19525	105	0	20014
8719	137	95	315	22800	0	23347
8720	74	81	25809	553	0	26517
8721	25024	50	676	288	0	26038
8722	669	27073	282	118	0	28142
8723	27350	658	157	140	0	28305
8724	862	268	90	26878	0	28098
8725	27368	156	90	765	0	28379
8726	885	96	27091	315	0	28387
8727	381	27239	702	194	0	28516
8728	27058	693	283	157	0	28191
8729	856	325	181	25973	0	27335
8730	408	27260	112	638	0	28418
8731	297	767	126	27759	0	28949
8732	28256	359	117	918	0	29650
8733	873	30019	149	400	0	31441
8734	30220	936	102	331	0	31589
8735	1112	437	29644	124	0	31317
8736	29780	255	862	246	0	31143
8737	1263	185	353	29831	0	31632
8738	29921	137	247	1026	0	31331
8739	1144	29692	158	431	0	31425
8740	642	928	139	29898	0	31607
8741	496	391	96	30753	0	31736
8742	277	295	29241	1279	0	31092
8743	368	162	891	29220	0	30641
8744	295	199	381	30189	0	31064
8745	344	193	234	30452	0	31223
8746	301	188	113	30784	0	31386
8747	267	156	29770	1460	0	31653
8748	253	28651	941	779	0	30624
8749	334	912	426	29150	0	30822
8750	28737	378	294	1206	0	30615
8751	29032	269	201	668	0	30170
8752	1284	28969	193	469	0	30915
8753	28911	939	137	488	0	30475
8754	29150	415	183	450	0	30198
8755	29183	303	133	410	0	30029
8756	1433	28106	153	442	0	30134
8757	27578	945	149	399	0	29071
8758	1281	497	141	26582	0	28501
8759	582	256	26468	1103	0	28409
8760	397	26586	846	630	0	28459
8761	411	933	377	26667	0	28388
8762	321	428	26410	1108	0	28267
8763	26051	304	854	614	0	27823
8764	1065	245	419	26523	0	28252
8765	631	229	216	27005	0	28081
8766	502	172	197	26945	0	27816
8767	484	205	126	27123	0	27938
8768	396	198	25525	1438	0	27557
8769	23987	178	843	803	0	25811
8770	1089	25362	344	499	0	27294
8771	25542	895	262	409	0	27108
8772	1155	25678	182	313	0	27328
8773	25973	1038	159	402	0	27572
8774	1237	443	165	25668	0	27513
8775	595	324	25460	1053	0	27432
8776	469	230	25850	607	0	27156
8777	367	267	1106	25709	0	27449
8778	426	150	528	26262	0	27366
8779	320	202	302	26802	0	27626
8780	25616	146	275	1553	0	27590
8781	1041	158	25558	870	0	27627
8782	628	192	893	24419	0	26132
8783	423	25619	450	1075	0	27567
8784	25579	947	289	688	0	27503
8785	1128	460	25500	459	0	27547
8786	623	25186	951	474	0	27234
8787	501	994	25571	334	0	27400
8788	471	501	1043	25544	0	27559
8789	378	333	25462	1179	0	27352
8790	352	250	25771	656	0	27029
8791	362	228	1239	25712	0	27541
8792	312	190	25835	1178	0	27515
8793	313	213	26091	696	0	27313
8794	320	186	1310	25401	0	27217
8795	25236	186	658	1257	0	27337
8796	1073	203	25466	722	0	27464
8797	616	173	1110	25087	0	26986
8798	416	200	595	26039	0	27250
8799	25295	193	487	1412	0	27387
8800	1073	217	383	25766	0	27439
8801	25192	145	371	1353	0	27061
8802	1120	24774	376	723	0	26993
8803	598	899	333	25706	0	27536
8804	25499	363	356	1252	0	27470
8805	25920	251	372	748	0	27291
8806	1326	172	339	25629	0	27466
8807	662	190	25341	1249	0	27442
8808	24549	141	1051	728	0	26469
8809	1050	25336	568	561	0	27515
8810	24285	858	384	609	0	26136
8811	25703	377	306	498	0	26884
8812	25885	228	312	491	0	26916
8813	1489	166	24776	474	0	26905
8814	750	24554	931	396	0	26631
8815	632	886	455	24332	0	26305
8816	578	517	305	24828	0	26228
8817	496	279	23794	1188	0	25757
8818	382	21863	775	713	0	23733
8819	273	18336	287	407	0	19303
8820	218	16444	163	224	0	17049
8821	15404	449	542	211	0	16606
8822	441	154	123	14959	0	15677
8823	243	91	93	15134	0	15561
8824	173	85	15105	425	0	15788
8825	14351	93	299	219	0	14962
8826	408	94	133	14995	0	15630
8827	284	129	104	15164	0	15681
8828	202	64	14890	404	0	15560
8829	140	14536	321	186	0	15183
8830	154	381	136	14499	0	15170
8831	97	116	14438	356	0	15007
8832	61	13111	213	155	0	13540
8833	11709	141	71	118	0	12039
8834	152	41	12301	59	0	12553
8835	82	45	127	11688	0	11942
8836	49	12148	40	109	0	12346
8837	12180	117	41	79	0	12417
8838	142	38	26	12211	0	12417
8839	12249	34	26	160	0	12469
8840	12187	25	19	97	0	12328
8841	140	12235	34	50	0	12459
8842	12272	115	21	78	0	12486
8843	12576	33	22	85	0	12716
8844	157	36	12690	39	0	12922
8845	12249	15	107	70	0	12441
8846	150	32	12554	36	0	12772
8847	12204	22	102	65	0	12393
8848	12515	25	38	51	0	12629
8849	137	23	12888	28	0	13076
8850	82	32	89	12762	0	12965
8851	58	26	13074	83	0	13241
8852	35	32	11957	29	0	12053
8853	38	27	13182	30	0	13277
8854	76	54	114	13014	0	13258
8855	43	9	55	14462	0	14569
8856	42	13	22	14633	0	14710
8857	54	10	23	14925	0	15012
8858	34	15	15075	176	0	15300
8859	62	9	145	14392	0	14608
8860	39	13326	52	185	0	13602
8861	21	148	15215	62	0	15446
8862	51	52	162	14806	0	15071
8863	30	31	15364	183	0	15608
8864	23	14877	187	59	0	15146
8865	23	15372	75	47	0	15517
8866	47	203	28	15278	0	15556
8867	21	68	15297	164	0	15550
8868	32	48	15194	72	0	15346
8869	55	20	210	15384	0	15669
8870	55	18	82	15694	0	15849
8871	41	21	48	16038	0	16148
8872	16	16	15948	247	0	16227
8873	23	15636	182	114	0	15955
8874	15	16495	74	56	0	16640
8875	34	227	48	16376	0	16685
8876	16	68	16026	216	0	16326
8877	18	53	15846	91	0	16008
8878	11	16657	246	60	0	16974
8879	16739	205	89	105	0	17138
8880	189	17118	47	58	0	17412
8881	68	215	17748	39	0	18070
8882	17519	75	247	75	0	17916
8883	253	53	87	18351	0	18744
8884	18776	40	57	290	0	19163
8885	298	25	44	18784	0	19151
8886	112	30	39	19129	0	19310
8887	18924	25	45	389	0	19383
8888	257	19600	49	122	0	20028
8889	81	271	19492	84	0	19928
8890	54	19902	261	67	0	20284
8891	19690	284	100	104	0	20178
8892	242	19820	70	57	0	20189
8893	19767	285	49	90	0	20191
8894	19795	107	35	94	0	20031
8895	330	20067	48	50	0	20495
8896	170	280	37	19906	0	20393
8897	19826	102	45	324	0	20297
8898	20010	69	35	140	0	20254
8899	372	53	30	19698	0	20153
8900	143	40	19203	289	0	19675
8901	93	45	19279	113	0	19530
8902	96	52	328	19649	0	20125
8903	89	48	19240	294	0	19671
8904	18199	60	305	177	0	18741
8905	294	19006	109	98	0	19507
8906	143	284	57	19555	0	20039
8907	131	98	46	19661	0	19936
8908	106	67	36	19457	0	19666
8909	122	50	55	19313	0	19540
8910	90	41	38	19752	0	19921
8911	57	72	19361	398	0	19888
8912	70	19311	273	183	0	19837
8913	19548	273	108	134	0	20063
8914	319	105	71	19323	0	19818
8915	135	73	49	19498	0	19755
8916	103	53	54	19506	0	19716
8917	69	19239	62	425	0	19795
8918	86	286	50	19623	0	20045
8919	99	112	45	19870	0	20126
8920	19232	71	50	457	0	19810
8921	278	18669	54	199	0	19200
8922	94	18944	71	163	0	19272
8923	99	350	44	19082	0	19575
8924	18697	118	42	406	0	19263
8925	305	92	18770	162	0	19329
8926	17485	62	292	210	0	18049
8927	327	64	19275	113	0	19779
8928	154	67	309	19210	0	19740
8929	131	41	111	19716	0	19999
8930	95	59	70	19401	0	19625
8931	66	70	58	19561	0	19755
8932	89	66	34	19270	0	19459
8933	19274	70	43	479	0	19866
8934	317	45	18860	231	0	19453
8935	152	59	289	19107	0	19607
8936	99	60	19540	361	0	20060
8937	70	19453	304	189	0	20016
8938	19373	317	116	197	0	20003
8939	336	121	20178	134	0	20769
8940	160	87	314	20327	0	20888
8941	141	59	130	20895	0	21225
8942	78	63	20849	479	0	21469
8943	79	56	20592	222	0	20949
8944	141	51	431	19206	0	19829
8945	20780	53	159	459	0	21451
8946	20852	47	121	242	0	21262
8947	436	20682	74	165	0	21357
8948	20974	337	70	180	0	21561
8949	434	126	54	20082	0	20696
8950	148	20843	72	391	0	21454
8951	151	335	61	21069	0	21616
8952	115	126	21313	433	0	21987
8953	145	93	337	20249	0	20824
8954	160	51	129	20881	0	21221
8955	19694	46	92	453	0	20285
8956	298	19702	62	249	0	20311
8957	19472	266	66	190	0	19994
8958	321	19334	70	110	0	19835
8959	18817	278	52	116	0	19263
8960	305	18576	63	111	0	19055
8961	127	18749	60	98	0	19034
8962	18953	300	56	101	0	19410
8963	311	140	38	18331	0	18820
8964	114	18663	61	269	0	19107
8965	18950	239	52	182	0	19423
8966	18932	97	58	152	0	19239
8967	19191	67	43	151	0	19452
8968	18842	46	49	157	0	19094
8969	342	18744	53	112	0	19251
8970	186	237	32	18908	0	19363
8971	150	95	34	19177	0	19456
8972	19167	92	36	357	0	19652
8973	278	53	32	18918	0	19281
8974	18632	54	23	342	0	19051
8975	271	58	18169	144	0	18642
8976	17588	57	183	171	0	17999
8977	279	59	18063	88	0	18489
8978	181	117	220	17693	0	18211
8979	17780	52	77	297	0	18206
8980	258	17452	52	117	0	17879
8981	16673	180	29	121	0	17003
8982	227	15858	44	95	0	16224
8983	125	241	24	17434	0	17824
8984	88	77	16894	177	0	17236
8985	15418	97	184	144	0	15843
8986	194	16711	46	57	0	17008
8987	121	187	41	16673	0	17022
8988	88	61	22	16250	0	16421
8989	76	46	21	16063	0	16206
8990	51	42	15977	208	0	16278
8991	48	15806	142	97	0	16093
8992	15799	139	42	121	0	16101
8993	15784	53	38	88	0	15963
8994	186	15817	32	44	0	16079
8995	16069	146	24	83	0	16322
8996	214	72	22	15966	0	16274
8997	84	15873	22	162	0	16141
8998	15953	149	23	98	0	16223
8999	174	64	15514	60	0	15812
9000	70	15659	137	61	0	15927
9001	97	135	46	15805	0	16083
9002	69	49	37	16067	0	16222
9003	58	53	15703	171	0	15985
9004	77	46	127	15370	0	15620
9005	56	38	15612	179	0	15885
9006	60	40	150	15510	0	15760
9007	73	37	55	15793	0	15958
9008	61	35	45	15947	0	16088
9009	70	39	24	16322	0	16455
9010	50	43	16120	253	0	16466
9011	56	40	17311	105	0	17512
9012	37	19250	303	95	0	19685
9013	72	337	117	20264	0	20790
9014	53	127	20889	354	0	21423
9015	46	20757	387	137	0	21327
9016	96	398	134	21590	0	22218
9017	45	153	22458	412	0	23068
9018	21264	70	432	222	0	21988
9019	23360	53	139	139	0	23691
9020	611	35	62	23227	0	23935
9021	213	46	23093	458	0	23810
9022	177	49	448	22930	0	23604
9023	22961	35	164	578	0	23738
9024	462	23235	106	206	0	24009
9025	23828	457	62	181	0	24528
9026	24239	162	47	178	0	24626
9027	668	85	52	23199	0	24004
9028	300	56	57	23553	0	23966
9029	181	46	70	23723	0	24020
9030	187	39	53	23602	0	23881
9031	142	58	49	23439	0	23688
9032	23132	40	57	770	0	23999
9033	23366	33	73	346	0	23818
9034	23327	50	72	258	0	23707
9035	645	62	21844	196	0	22747
9036	22312	57	402	221	0	22992
9037	612	85	150	22406	0	23253
9038	266	70	22272	566	0	23174
9039	168	21657	502	251	0	22578
9040	253	469	220	21425	0	22367
9041	202	159	121	21553	0	22035
9042	130	21543	112	602	0	22387
9043	168	453	110	22178	0	22909
9044	114	172	21934	667	0	22887
9045	120	85	22160	309	0	22674
9046	176	93	634	22319	0	23222
9047	22214	65	220	675	0	23174
9048	22221	59	129	350	0	22759
9049	707	68	21957	236	0	22968
9050	313	20241	526	245	0	21325
9051	193	21567	221	238	0	22219
9052	20532	607	150	243	0	21532
9053	593	248	20753	221	0	21815
9054	357	131	489	20550	0	21527
9055	20644	96	193	658	0	21591
9056	633	19988	144	339	0	21104
9057	276	20805	144	249	0	21474
9058	20561	611	97	267	0	21536
9059	669	228	100	20995	0	21992
9060	22512	117	116	719	0	23464
9061	799	103	99	24932	0	25933
9062	491	76	114	25582	0	26263
9063	303	121	25004	1050	0	26478
9064	274	141	707	25468	0	26590
9065	250	98	349	26172	0	26869
9066	25688	94	257	1224	0	27263
9067	838	94	171	26416	0	27519
9068	435	114	25824	1086	0	27459
9069	25659	96	759	658	0	27172
9070	888	101	399	26301	0	27689
9071	26165	98	237	1035	0	27535
9072	990	24511	179	600	0	26280
9073	526	26156	182	420	0	27284
9074	25866	993	179	378	0	27416
9075	26210	491	187	336	0	27224
9076	1229	261	164	25736	0	27390
9077	706	167	25362	933	0	27168
9078	477	165	780	25947	0	27369
9079	25361	204	385	1056	0	27006
9080	923	25440	288	564	0	27215
9081	600	815	191	25668	0	27274
9082	25522	409	175	1038	0	27144
9083	991	253	24242	668	0	26154
9084	24714	171	791	549	0	26225
9085	23022	177	411	514	0	24124
9086	1182	190	24750	386	0	26508
9087	729	176	25193	326	0	26424
9088	582	121	1078	24191	0	25972
9089	456	100	559	24918	0	26033
9090	375	25416	395	1185	0	27371
9091	379	800	234	26086	0	27499
9092	334	437	25891	1160	0	27822
9093	388	299	881	26270	0	27838
9094	350	183	490	27615	0	28638
9095	365	153	26380	1418	0	28316
9096	329	26113	913	821	0	28176
9097	350	854	487	26529	0	28220
9098	372	406	321	27474	0	28573
9099	26757	254	312	1424	0	28747
9100	1027	183	230	27058	0	28498
9101	577	185	26257	1303	0	28322
9102	26024	186	908	792	0	27910
9103	27021	204	464	551	0	28240
9104	27350	186	325	463	0	28324
9105	1461	127	25940	440	0	27968
9106	882	112	937	25634	0	27565
9107	554	108	534	26422	0	27618
9108	467	131	423	26445	0	27466
9109	24872	169	270	1451	0	26762
9110	985	24779	217	930	0	26911
9111	557	654	22341	579	0	24131
9112	357	21509	676	484	0	23026
9113	255	20769	402	414	0	21840
9114	227	20853	298	367	0	21745
9115	486	983	323	19932	0	21724
9116	291	464	19531	754	0	21040
9117	17494	336	613	572	0	19015
9118	590	18669	388	446	0	20093
9119	18080	517	261	381	0	19239
9120	713	18661	161	308	0	19843
9121	18852	658	152	307	0	19969
9122	757	19132	137	252	0	20278
9123	516	696	19262	200	0	20674
9124	423	375	548	19095	0	20441
9125	303	268	355	20051	0	20977
9126	19686	183	240	928	0	21037
9127	687	160	185	20992	0	22024
9128	443	153	20683	928	0	22207
9129	400	167	636	21097	0	22300
9130	265	191	20905	918	0	22279
9131	217	20788	743	559	0	22307
9132	253	660	392	19785	0	21090
9133	277	21141	306	678	0	22402
9134	21098	814	186	446	0	22544
9135	753	372	235	21052	0	22412
9136	428	316	20969	757	0	22470
9137	323	218	20759	464	0	21764
9138	20361	230	817	442	0	21850
9139	731	189	448	20612	0	21980
9140	421	211	20388	725	0	21745
9141	340	195	19785	465	0	20785
9142	204	19922	895	371	0	21392
9143	270	648	554	18115	0	19587
9144	159	19652	359	664	0	20834
9145	226	681	236	19325	0	20468
9146	19571	368	209	837	0	20985
9147	606	293	238	19901	0	21038
9148	371	188	182	20452	0	21193
9149	20094	168	191	1034	0	21487
9150	701	180	199	21122	0	22202
9151	433	178	168	20693	0	21472
9152	347	21023	206	927	0	22503
9153	21190	615	166	657	0	22628
9154	21733	322	217	443	0	22715
9155	918	265	193	21475	0	22851
9156	556	157	193	21702	0	22608
9157	406	160	178	21507	0	22251
9158	280	19910	183	1117	0	21490
9159	246	20871	180	681	0	21978
9160	306	650	155	19230	0	20341
9161	15920	188	101	537	0	16746
9162	16127	123	109	288	0	16647
9163	445	15799	86	234	0	16564
9164	15119	367	103	220	0	15809
9165	409	14902	82	188	0	15581
9166	176	15109	75	186	0	15546
9167	310	440	125	14664	0	15539
9168	14464	178	105	448	0	15195
9169	357	13978	73	230	0	14638
9170	171	14492	66	190	0	14919
9171	156	361	62	14503	0	15082
9172	128	166	55	14895	0	15244
9173	122	135	14412	454	0	15123
9174	14065	109	288	269	0	14731
9175	13839	111	99	233	0	14282
9176	383	131	14700	180	0	15394
9177	182	125	14725	183	0	15215
9178	182	111	354	14889	0	15536
9179	154	115	123	15371	0	15763
9180	122	15160	81	505	0	15868
9181	144	383	73	15355	0	15955
9182	137	163	15186	500	0	15986
9183	141	146	330	15099	0	15716
9184	140	129	116	15400	0	15785
9185	14968	117	98	535	0	15718
9186	412	127	14775	268	0	15582
9187	14237	128	364	247	0	14976
9188	430	108	14506	221	0	15265
9189	191	107	354	13914	0	14566
9190	140	104	13844	426	0	14514
9191	119	108	13831	221	0	14279
9192	155	149	378	13545	0	14227
9193	12802	104	249	526	0	13681
9194	12743	93	146	247	0	13229
9195	354	13012	120	219	0	13705
9196	12898	310	121	195	0	13524
9197	12921	144	106	187	0	13358
9198	381	12915	123	167	0	13586
9199	198	312	110	13191	0	13811
9200	153	134	118	13535	0	13940
9201	146	107	100	13561	0	13914
9202	150	116	98	13631	0	13995
9203	124	111	13242	518	0	13995
9204	12847	79	342	286	0	13554
9205	393	73	164	13363	0	13993
9206	210	72	119	13285	0	13686
9207	159	13358	118	474	0	14109
9208	177	341	89	13640	0	14247
9209	136	165	12996	495	0	13792
9210	12865	128	314	312	0	13619
9211	396	104	13569	273	0	14342
9212	220	112	306	13349	0	13987
9213	13322	82	114	506	0	14024
9214	358	13582	93	277	0	14310
9215	223	327	59	14115	0	14724
9216	138	165	14040	480	0	14823
9217	149	129	334	14121	0	14733
9218	14021	95	129	487	0	14732
9219	405	105	14056	233	0	14799
9220	173	112	13646	197	0	14128
9221	156	13664	389	177	0	14386
9222	13221	343	153	203	0	13920
9223	333	13136	115	179	0	13763
9224	165	330	12740	170	0	13405
9225	112	123	12259	124	0	12618
9226	88	12093	352	131	0	12664
9227	10918	228	149	104	0	11399
9228	229	10840	106	87	0	11262
9229	119	230	63	10678	0	11090
9230	70	84	82	10905	0	11141
9231	71	56	10817	294	0	11238
9232	69	56	259	10733	0	11117
9233	56	46	11142	266	0	11510
9234	10713	45	274	144	0	11176
9235	11149	46	119	104	0	11418
9236	11173	50	87	99	0	11409
9237	283	63	10894	77	0	11317
9238	10903	44	239	92	0	11278
9239	274	64	108	10584	0	11030
9240	101	10923	73	259	0	11356
9241	10801	202	89	145	0	11237
9242	235	81	10346	94	0	10756
9243	10514	41	218	116	0	10889
9244	10667	30	104	92	0	10893
9245	293	35	10499	82	0	10909
9246	128	10452	230	84	0	10894
9247	131	218	127	10334	0	10810
9248	86	66	10509	236	0	10897
9249	97	50	10174	103	0	10424
9250	100	161	231	9173	0	9665
9251	61	30	9468	171	0	9730
9252	81	35	163	9102	0	9381
9253	89	29	70	8515	0	8703
9254	50	29	69	9294	0	9442
9255	58	31	9191	196	0	9476
9256	67	25	197	9176	0	9465
9257	53	30	9319	197	0	9599
9258	67	32	191	9335	0	9625
9259	9666	30	85	215	0	9996
9260	205	22	65	9619	0	9911
9261	75	9864	63	201	0	10203
9262	52	174	67	10153	0	10446
9263	10106	65	55	248	0	10474
9264	204	10165	56	107	0	10532
9265	94	200	58	10243	0	10595
9266	10143	45	64	263	0	10515
9267	224	33	10126	103	0	10486
9268	85	40	225	10056	0	10406
9269	55	27	10198	261	0	10541
9270	43	37	10110	116	0	10306
9271	61	37	267	10020	0	10385
9272	10074	22	84	262	0	10442
9273	224	19	9918	89	0	10250
9274	9754	36	216	79	0	10085
9275	252	39	81	10158	0	10530
9276	95	32	10032	203	0	10362
9277	65	36	9701	86	0	9888
9278	61	41	9881	65	0	10048
9279	55	100	258	9448	0	9861
9280	9657	14	158	214	0	10043
9281	190	9728	53	97	0	10068
9282	104	158	58	9627	0	9947
9283	65	52	54	9868	0	10039
9284	9843	30	59	234	0	10166
9285	9917	24	50	107	0	10098
9286	217	9856	70	62	0	10205
9287	9969	168	45	68	0	10250
9288	9965	51	53	66	0	10135
9289	244	28	48	9877	0	10197
9290	81	26	9858	200	0	10165
9291	9719	23	200	89	0	10031
9292	205	41	81	10006	0	10333
9293	91	24	52	10033	0	10200
9294	9916	18	47	236	0	10217
9295	196	20	51	9467	0	9734
9296	102	20	33	9567	0	9722
9297	9408	12	37	245	0	9702
9298	201	9586	41	100	0	9928
9299	9559	156	32	98	0	9845
9300	218	53	9477	56	0	9804
9301	9447	26	174	61	0	9708
9302	232	18	57	9540	0	9847
9303	95	9745	44	186	0	10070
9304	80	160	31	9897	0	10168
9305	78	43	19	9984	0	10124
9306	73	23	34	9979	0	10109
9307	9754	19	32	248	0	10053
9308	187	9492	28	102	0	9809
9309	70	9597	28	64	0	9759
9310	9385	170	23	75	0	9653
9311	174	60	9617	51	0	9902
9312	76	33	9353	50	0	9512
9313	9195	68	208	72	0	9543
9314	176	19	9581	51	0	9827
9315	70	13	142	9157	0	9382
9316	96	24	54	8166	0	8340
9317	39	15	28	9422	0	9504
9318	48	12	19	9270	0	9349
9319	34	8678	21	180	0	8913
9320	39	126	23	9390	0	9578
9321	39	45	9178	187	0	9449
9322	45	29	135	9098	0	9307
9323	26	29	8930	176	0	9161
9324	42	24	8822	68	0	8956
9325	36	20	170	8965	0	9191
9326	37	17	9133	172	0	9359
9327	42	20	153	9049	0	9264
9328	9076	27	60	186	0	9349
9329	151	16	9192	80	0	9439
9330	8781	17	155	67	0	9020
9331	172	13	55	9093	0	9333
9332	69	19	9053	166	0	9307
9333	34	8853	150	86	0	9123
9334	45	132	52	9001	0	9230
9335	37	47	9505	181	0	9770
9336	48	26	165	9485	0	9724
9337	9848	12	64	220	0	10144
9338	9966	16	54	94	0	10130
9339	10177	21	33	83	0	10314
9340	214	16	37	10290	0	10557
9341	82	17	49	10514	0	10662
9342	60	18	36	10731	0	10845
9343	10756	8	42	266	0	11072
9344	193	10911	36	110	0	11250
9345	102	168	33	11007	0	11310
9346	63	57	30	11303	0	11453
9347	11005	34	33	303	0	11375
9348	204	11208	40	146	0	11598
9349	112	181	28	11773	0	12094
9350	11789	74	35	288	0	12186
9351	11733	41	33	161	0	11968
9352	329	29	33	11626	0	12017
9353	11653	16	34	290	0	11993
9354	290	22	33	11601	0	11946
9355	132	28	11638	283	0	12081
9356	118	18	204	11648	0	11988
9357	109	18	90	11896	0	12113
9358	88	19	54	12099	0	12260
9359	11455	16	34	327	0	11832
9360	210	11543	28	184	0	11965
9361	11282	191	37	133	0	11643
9362	226	11098	28	98	0	11450
9363	92	11412	21	100	0	11625
9364	11440	247	24	95	0	11806
9365	232	11618	27	73	0	11950
9366	117	237	19	11644	0	12017
9367	11551	74	16	265	0	11906
9368	11699	68	26	122	0	11915
9369	292	50	23	11575	0	11940
9370	162	32	22	11391	0	11607
9371	100	11452	23	264	0	11839
9372	11637	193	20	175	0	12025
9373	11371	78	21	141	0	11611
9374	259	11811	18	117	0	12205
9375	132	11926	22	84	0	12164
9376	105	257	17	11995	0	12374
9377	11951	114	12	298	0	12375
9378	282	86	15	11903	0	12286
9379	145	64	15	12202	0	12426
9380	95	67	11782	332	0	12276
9381	89	59	11717	158	0	12023
9382	98	48	258	11864	0	12268
9383	80	44	11912	294	0	12330
9384	65	11868	255	151	0	12339
9385	75	240	96	11875	0	12286
9386	85	85	58	12201	0	12429
9387	79	64	49	12311	0	12503
9388	70	53	12010	372	0	12505
9389	60	58	11652	190	0	11960
9390	11543	46	265	183	0	12037
9391	263	11977	120	107	0	12467
9392	11967	242	67	117	0	12393
9393	295	103	49	12011	0	12458
9394	12129	80	44	307	0	12560
9395	307	75	44	12009	0	12435
9396	137	12255	35	304	0	12731
9397	12318	234	29	186	0	12767
9398	283	103	12005	124	0	12515
9399	120	11903	224	105	0	12352
9400	11918	244	108	128	0	12398
9401	287	102	60	11693	0	12142
9402	116	11558	48	234	0	11956
9403	120	237	41	11992	0	12390
9404	11961	98	35	307	0	12401
9405	283	85	33	11997	0	12398
9406	11973	75	25	336	0	12409
9407	285	66	11737	171	0	12259
9408	169	55	206	11821	0	12251
9409	11794	48	73	345	0	12260
9410	306	66	11627	158	0	12157
9411	137	11249	235	157	0	11778
9412	169	237	107	10946	0	11459
9413	97	100	11129	276	0	11602
9414	83	89	10983	148	0	11303
9415	116	111	269	10954	0	11450
9416	82	63	10923	290	0	11358
9417	84	59	10936	157	0	11236
9418	91	62	271	10798	0	11222
9419	10857	47	140	305	0	11349
9420	255	47	110	10895	0	11307
9421	134	44	83	11095	0	11356
9422	104	59	11026	333	0	11522
9423	107	55	242	11271	0	11675
9424	11471	42	110	363	0	11986
9425	263	43	11537	165	0	12008
9426	120	11604	242	156	0	12122
9427	112	240	128	11959	0	12439
9428	12023	93	104	312	0	12532
9429	281	66	82	11956	0	12385
9430	124	12040	64	300	0	12528
9431	103	235	12627	144	0	13109
9432	85	117	281	12895	0	13378
9433	13489	71	115	368	0	14043
9434	324	73	13355	154	0	13906
9435	149	52	298	13487	0	13986
9436	13701	42	128	400	0	14271
9437	13999	39	90	212	0	14340
9438	427	13907	80	135	0	14549
9439	13875	303	77	140	0	14395
9440	447	122	70	13670	0	14309
9441	167	91	13813	374	0	14445
9442	133	13234	335	167	0	13869
9443	90	13950	122	143	0	14305
9444	121	413	121	13501	0	14156
9445	102	135	91	13836	0	14164
9446	65	79	13330	386	0	13860
9447	74	13022	313	178	0	13587
9448	54	13186	134	120	0	13494
9449	116	376	98	12593	0	13183
9450	12439	121	76	312	0	12948
9451	277	12443	48	157	0	12925
9452	124	261	45	12672	0	13102
9453	13054	89	63	336	0	13542
9454	310	84	50	13145	0	13589
9455	151	71	51	13047	0	13320
9456	115	63	44	13217	0	13439
9457	108	60	43	13218	0	13429
9458	12911	53	47	412	0	13423
9459	286	65	43	13045	0	13439
9460	113	48	12527	334	0	13022
9461	12150	69	246	177	0	12642
9462	279	68	12342	138	0	12827
9463	111	59	12701	134	0	13005
9464	125	37	302	12661	0	13125
9465	96	43	137	12853	0	13129
9466	91	61	75	13084	0	13311
9467	12831	54	56	376	0	13317
9468	286	40	12682	209	0	13217
9469	12489	34	257	164	0	12944
9470	12899	45	114	141	0	13199
9471	330	45	12724	133	0	13232
9472	12464	47	235	143	0	12889
9473	301	31	12872	127	0	13331
9474	124	12982	245	109	0	13460
9475	173	208	214	12779	0	13374
9476	80	80	86	13297	0	13543
9477	85	34	48	13228	0	13395
9478	62	25	58	13187	0	13332
9479	61	31	13134	323	0	13549
9480	64	40	12963	163	0	13230
9481	73	39	277	12988	0	13377
9482	60	23	13142	286	0	13511
9483	12580	21	240	175	0	13016
9484	13252	27	117	119	0	13515
9485	295	31	70	13099	0	13495
9486	12987	28	70	277	0	13362
9487	245	13419	98	136	0	13898
9488	13416	198	48	145	0	13807
9489	258	81	13553	112	0	14004
9490	136	43	224	13362	0	13765
9491	109	13723	94	252	0	14178
9492	13934	199	94	151	0	14378
9493	255	84	64	14119	0	14522
9494	125	55	14014	270	0	14464
9495	116	44	238	13932	0	14330
9496	13886	37	109	316	0	14348
9497	255	43	13933	169	0	14400
9498	150	54	253	13956	0	14413
9499	135	49	104	14200	0	14488
9500	93	46	14081	352	0	14572
9501	85	13640	259	177	0	14161
9502	184	9587	152	201	0	10124
9503	109	271	70	14120	0	14570
9504	95	100	79	14433	0	14707
9505	85	85	65	14699	0	14934
9506	14330	72	58	380	0	14840
9507	14468	52	50	203	0	14773
9508	324	47	70	14513	0	14954
9509	14400	59	60	357	0	14876
9510	279	14313	51	172	0	14815
9511	149	258	52	14906	0	15365
9512	94	104	57	15203	0	15458
9513	85	59	71	15283	0	15498
9514	14402	60	48	422	0	14932
9515	269	14155	46	219	0	14689
9516	146	223	58	14631	0	15058
9517	14384	92	44	370	0	14890
9518	276	50	49	14639	0	15014
9519	151	41	50	14645	0	14887
9520	108	13638	51	398	0	14195
9521	108	14488	50	203	0	14849
9522	92	251	45	14424	0	14812
9523	92	86	45	14478	0	14701
9524	13726	48	55	382	0	14211
9525	311	50	37	13809	0	14207
9526	132	36	13348	311	0	13827
9527	94	38	222	13145	0	13499
9528	85	12889	83	312	0	13369
9529	13134	217	72	193	0	13616
9530	287	71	54	13162	0	13574
9531	143	40	41	12771	0	12995
9532	67	12686	47	321	0	13121
9533	12171	160	25	136	0	12492
9534	197	12812	25	94	0	13128
9535	87	196	19	12814	0	13116
9536	65	52	12463	198	0	12778
9537	79	77	151	11794	0	12101
9538	11871	27	38	202	0	12138
9539	152	11961	23	76	0	12212
9540	71	163	11	12034	0	12279
9541	41	11579	22	172	0	11814
9542	32	158	9	12117	0	12316
9543	35	55	11814	194	0	12098
9544	41	85	145	11607	0	11878
9545	47	21	48	11963	0	12079
9546	23	37	22	12170	0	12252
9547	11594	23	17	252	0	11886
9548	11806	35	22	102	0	11965
9549	186	11820	18	89	0	12113
9550	11901	151	19	96	0	12167
9551	171	11655	21	59	0	11906
9552	65	12071	18	76	0	12230
9553	11611	194	13	91	0	11909
9554	187	70	11409	80	0	11746
9555	84	34	154	11544	0	11816
9556	63	45	45	11916	0	12069
9557	57	34	21	12324	0	12436
9558	11882	42	22	261	0	12207
9559	190	11749	15	101	0	12055
9560	106	183	19	12121	0	12429
9561	48	12013	27	215	0	12303
9562	12876	202	18	128	0	13224
9563	225	90	18	12998	0	13331
9564	105	59	10	15087	0	15261
9565	81	15785	12	393	0	16271
9566	80	331	25	16570	0	17006
9567	60	136	16	16833	0	17045
9568	16081	82	15	562	0	16740
9569	341	15686	23	277	0	16327
9570	151	16436	19	202	0	16808
9571	107	437	6	16277	0	16827
9572	83	199	15660	428	0	16370
9573	69	126	15475	241	0	15911
9574	113	119	394	15461	0	16087
9575	69	87	15408	454	0	16018
9576	85	96	376	15460	0	16017
9577	109	103	174	14540	0	14926
9578	60	74	93	16033	0	16260
9579	15409	61	106	633	0	16209
9580	380	57	79	15618	0	16134
9581	194	60	66	15562	0	15882
9582	93	15229	73	612	0	16007
9583	104	371	53	16050	0	16578
9584	68	174	15571	573	0	16386
9585	95	107	378	15872	0	16452
9586	90	68	169	16307	0	16634
9587	15282	67	114	702	0	16165
9588	381	67	84	15647	0	16179
9589	185	84	67	15499	0	15835
9590	126	58	68	15783	0	16035
9591	14467	51	59	745	0	15322
9592	367	14696	51	419	0	15533
9593	201	366	46	14992	0	15605
9594	134	188	34	15253	0	15609
9595	97	115	14534	696	0	15442
9596	100	91	368	14786	0	15345
9597	14057	70	168	651	0	14946
9598	373	14207	94	398	0	15072
9599	211	396	79	14182	0	14868
9600	129	177	68	14588	0	14962
9601	98	100	13914	692	0	14804
9602	13086	90	378	450	0	14004
9603	386	13501	159	346	0	14392
9604	13630	379	90	282	0	14381
9605	420	194	70	13833	0	14517
9606	216	131	71	14025	0	14443
9607	108	112	70	14282	0	14572
9608	153	82	86	14340	0	14661
9609	13742	94	77	709	0	14622
9610	423	96	58	13578	0	14155
9611	214	13068	67	636	0	13985
9612	154	343	71	13587	0	14155
9613	131	152	93	13964	0	14340
9614	13376	94	75	723	0	14268
9615	407	13303	73	427	0	14210
9616	245	375	54	13782	0	14456
9617	13462	192	47	650	0	14351
9618	13748	108	45	447	0	14348
9619	495	97	53	13814	0	14459
9620	270	95	13210	646	0	14221
9621	13317	100	309	441	0	14167
9622	460	103	136	13739	0	14438
9623	239	88	13577	638	0	14542
9624	194	80	367	13991	0	14632
9625	201	81	177	13830	0	14289
9626	183	87	104	14196	0	14570
9627	144	14305	89	696	0	15234
9628	166	342	78	14801	0	15387
9629	170	154	63	15272	0	15659
9630	152	94	79	15160	0	15485
9631	154	106	51	15050	0	15361
9632	133	92	51	14847	0	15123
9633	155	88	52	14758	0	15053
9634	13177	79	83	706	0	14045
9635	344	64	12822	462	0	13692
9636	179	12835	291	395	0	13700
9637	12946	282	149	386	0	13763
9638	350	12952	82	312	0	13696
9639	12868	336	77	305	0	13586
9640	448	187	69	12862	0	13566
9641	12919	104	67	506	0	13596
9642	411	101	68	12921	0	13501
9643	264	83	51	12573	0	12971
9644	144	12499	51	588	0	13282
9645	12661	297	39	402	0	13399
9646	384	147	12666	355	0	13552
9647	240	81	256	13083	0	13660
9648	179	90	13004	511	0	13784
9649	146	86	12391	355	0	12978
9650	12844	94	355	295	0	13588
9651	362	91	164	13247	0	13864
9652	236	87	12976	456	0	13755
9653	159	75	13169	337	0	13740
9654	162	61	357	13147	0	13727
9655	154	66	167	13714	0	14101
9656	13490	59	126	522	0	14197
9657	364	57	98	13524	0	14043
9658	237	68	13835	485	0	14625
9659	205	41	292	13970	0	14508
9660	155	119	172	13880	0	14326
9661	115	14088	109	496	0	14808
9662	13803	224	93	378	0	14498
9663	304	13520	90	255	0	14169
9664	11541	106	37	141	0	11825
9665	99	10334	27	67	0	10527
9666	44	10200	27	53	0	10324
9667	55	90	36	10276	0	10457
9668	38	38	30	10231	0	10337
9669	48	41	17	10153	0	10259
9670	9871	15	26	108	0	10020
9671	63	16	9882	50	0	10011
9672	33	13	41	9757	0	9844
9673	9669	13	20	105	0	9807
9674	55	9583	13	60	0	9711
9675	36	9643	17	39	0	9735
9676	54	73	17	9671	0	9815
9677	25	24	13	9943	0	10005
9678	18	24	13	9979	0	10034
9679	24	10230	10	82	0	10346
9680	27	53	6	10379	0	10465
9681	24	23	10332	68	0	10447
9682	16	14	9320	33	0	9383
9683	9643	15	38	39	0	9735
9684	46	10	28	10290	0	10374
9685	10361	9	19	70	0	10459
9686	10247	9	9	50	0	10315
9687	43	10346	13	25	0	10427
9688	10451	28	13	52	0	10544
9689	10843	18	13	43	0	10917
9690	46	13	6	10927	0	10992
9691	33	15	9	11133	0	11190
9692	27	12	11497	52	0	11588
9693	14	11820	30	30	0	11894
9694	101	35	28	9909	0	10073
9695	19	12	9	12235	0	12275
9696	12256	17	16	63	0	12352
9697	44	8	4	12339	0	12395
9698	12590	7	9	56	0	12662
9699	49	10	8	12883	0	12950
9700	33	12874	9	59	0	12975
9701	13375	48	11	67	0	13501
9702	67	34	1	14690	0	14792
9703	58	11	4	15537	0	15610
9704	38	14	9	16362	0	16423
9705	25	27	16217	232	0	16501
9706	41	6	170	16305	0	16522
9707	16749	5	67	283	0	17104
9708	197	6	26	17486	0	17715
9709	99	8	25	18885	0	19017
9710	74	8	25	18897	0	19004
9711	31	18358	17	403	0	18809
9712	34	19148	20	164	0	19366
9713	19095	314	1	132	0	19542
9714	265	19211	23	89	0	19588
9715	19181	302	10	113	0	19606
9716	19147	122	14	91	0	19374
9717	19069	67	12	120	0	19268
9718	416	53	18881	70	0	19420
9719	153	19302	264	78	0	19797
9720	19871	303	91	119	0	20384
9721	356	130	34	19985	0	20505
9722	215	60	33	20046	0	20354
9723	116	78	21	20364	0	20579
9724	103	19795	19	558	0	20475
9725	117	283	17	20187	0	20604
9726	20163	131	8	415	0	20717
9727	349	76	34	19645	0	20104
9728	183	83	13	19903	0	20182
9729	119	70	19557	430	0	20176
9730	108	55	19729	230	0	20122
9731	149	55	342	20174	0	20720
9732	127	26	149	20464	0	20766
9733	72	20520	87	477	0	21156
9734	118	294	58	20563	0	21033
9735	126	143	61	20986	0	21316
9736	82	105	34	21188	0	21409
9737	20652	66	45	595	0	21358
9738	324	105	20743	297	0	21469
9739	203	76	296	21118	0	21693
9740	21203	59	123	498	0	21883
9741	21264	67	83	285	0	21699
9742	466	83	68	21187	0	21804
9743	251	66	64	21502	0	21883
9744	21065	78	56	566	0	21765
9745	379	20760	70	306	0	21515
9746	209	21155	54	242	0	21660
9747	166	404	57	21387	0	22014
9748	21377	182	38	504	0	22101
9749	21482	104	33	332	0	21951
9750	21064	87	29	257	0	21437
9751	463	83	21407	232	0	22185
9752	20224	78	301	284	0	20887
9753	455	57	20992	196	0	21700
9754	20283	66	329	264	0	20942
9755	418	20806	142	223	0	21589
9756	228	309	20942	246	0	21725
9757	200	165	330	21020	0	21715
9758	161	92	20644	511	0	21408
9759	210	89	348	20629	0	21276
9760	20464	100	171	562	0	21297
9761	454	92	20408	324	0	21278
9762	226	86	387	20333	0	21032
9763	223	21271	196	464	0	22154
9764	225	339	120	22686	0	23370
9765	234	151	139	22638	0	23162
9766	198	118	104	21506	0	21926
9767	22351	80	119	629	0	23179
9768	22461	97	102	395	0	23055
9769	555	119	74	22448	0	23196
9770	278	116	22009	521	0	22924
9771	236	99	21259	378	0	21972
9772	228	112	415	22357	0	23112
9773	220	118	23006	520	0	23864
9774	234	100	374	23125	0	23833
9775	261	80	228	21704	0	22273
9776	241	84	146	23344	0	23815
9777	226	22262	133	616	0	23237
9778	215	20292	132	375	0	21014
9779	183	424	120	23287	0	24014
9780	175	192	142	23252	0	23761
9781	190	127	115	23206	0	23638
9782	22736	100	130	675	0	23641
9783	429	103	23042	413	0	23987
9784	270	76	384	23151	0	23881
9785	23011	75	234	595	0	23915
9786	382	23040	179	405	0	24006
9787	262	362	128	23687	0	24439
9788	169	158	161	23940	0	24428
9789	153	98	106	23705	0	24062
9790	166	85	112	23635	0	23998
9791	181	92	22651	694	0	23618
9792	20774	84	353	496	0	21707
9793	21855	94	170	431	0	22550
9794	500	68	21933	314	0	22815
9795	21180	94	350	349	0	21973
9796	21965	64	195	356	0	22580
9797	531	62	22118	281	0	22992
9798	281	22566	378	282	0	23507
9799	238	343	192	22716	0	23489
9800	183	125	23494	451	0	24253
9801	180	22562	344	286	0	23372
9802	178	266	21577	200	0	22221
9803	91	20627	270	446	0	21434
9804	129	215	157	20371	0	20872
9805	89	62	20253	228	0	20632
9806	134	71	231	19674	0	20110
9807	92	54	20366	211	0	20723
9808	67	19753	163	127	0	20110
9809	18511	51	75	72	0	18709
9810	51	18300	32	28	0	18411
9811	12	19365	23	44	0	19444
9812	144	62	29	19358	0	19593
9813	24	18	14	19804	0	19860
9814	21	9	5	19736	0	19771
9815	31	5	7	19385	0	19428
9816	27	4	4	20040	0	20075
9817	15	11	21103	51	0	21180
9818	36	7	43	20700	0	20786
9819	20	1	9	21355	0	21385
9820	21431	2	15	140	0	21588
9821	21352	6	6	68	0	21432
9822	21568	2	8	67	0	21645
9823	112	9	4	21685	0	21810
9824	23659	8	6	168	0	23841
9825	25302	8	6	137	0	25453
9826	25665	8	7	105	0	25785
9827	232	16	25502	20	0	25770
9828	24681	8	181	88	0	24958
9829	26129	5	39	82	0	26255
9830	25852	7	24	71	0	25954
9831	302	5	16	25829	0	26152
9832	92	18	26175	216	0	26501
9833	103	7	203	25811	0	26124
9834	26529	2	55	313	0	26899
9835	273	10	24	26769	0	27076
9836	83	27822	22	215	0	28142
9837	94	187	15	28646	0	28942
9838	28609	41	15	333	0	28998
9839	28802	20	20	189	0	29031
9840	28543	12	19	130	0	28704
9841	344	15	29211	38	0	29608
9842	225	10	239	28607	0	29081
9843	136	15	69	29884	0	30104
9844	89	16	30036	317	0	30458
9845	83	29074	251	127	0	29535
9846	92	242	29151	70	0	29555
9847	121	67	264	29771	0	30223
9848	29793	37	98	363	0	30291
9849	301	34	30494	119	0	30948
9850	186	35	257	30489	0	30967
9851	111	30	30708	307	0	31156
9852	29893	24	312	181	0	30410
9853	377	21	103	31136	0	31637
9854	173	25	32374	344	0	32916
9855	190	19	315	31964	0	32488
9856	111	38	32746	369	0	33264
9857	105	32832	329	183	0	33449
9858	149	263	141	33083	0	33636
9859	33483	85	82	413	0	34063
9860	407	35	103	33666	0	34211
9861	204	47	92	33296	0	33639
9862	33252	26	89	479	0	33846
9863	371	30972	103	205	0	31651
9864	182	31688	83	168	0	32121
9865	159	312	105	31913	0	32489
9866	114	31940	84	401	0	32539
9867	127	284	69	32291	0	32771
9868	149	102	96	32464	0	32811
9869	32289	69	50	545	0	32953
9870	350	32138	104	201	0	32793
9871	171	346	31771	167	0	32455
9872	135	32758	318	183	0	33394
9873	32451	334	132	213	0	33130
9874	33255	108	91	227	0	33681
9875	476	72	90	32884	0	33522
9876	33327	71	76	494	0	33968
9877	478	96	76	33262	0	33912
9878	32963	87	83	536	0	33669
9879	33397	78	71	331	0	33877
9880	544	94	84	34476	0	35198
9881	34707	57	71	602	0	35437
9882	524	76	34854	238	0	35692
9883	33999	61	401	263	0	34724
9884	563	80	141	35090	0	35874
9885	35401	48	122	556	0	36127
9886	572	35974	105	210	0	36861
9887	342	361	106	36149	0	36958
9888	314	125	121	36474	0	37034
9889	36188	90	111	670	0	37059
9890	605	117	35986	266	0	36974
9891	293	35780	401	288	0	36762
9892	332	383	136	36194	0	37045
9893	277	36233	123	512	0	37145
9894	271	405	95	37031	0	37802
9895	337	146	102	36302	0	36887
9896	264	131	106	37420	0	37921
9897	36832	118	97	720	0	37767
9898	525	121	77	36166	0	36889
9899	36259	132	79	702	0	37172
9900	35708	142	92	446	0	36388
9901	634	100	89	35930	0	36753
9902	35752	105	117	687	0	36661
9903	35293	109	98	442	0	35942
9904	618	109	35550	307	0	36584
9905	363	146	430	34769	0	35708
9906	35653	114	170	693	0	36630
9907	544	35299	178	317	0	36338
9908	35851	423	111	422	0	36807
9909	35887	143	98	426	0	36554
9910	668	130	35179	292	0	36269
9911	414	89	450	34045	0	34998
9912	37183	72	174	795	0	38224
9913	759	77	140	38339	0	39315
9914	448	87	120	39979	0	40634
9915	382	94	125	40408	0	41009
9916	387	74	129	42722	0	43312
9917	42380	74	105	1132	0	43691
9918	904	110	43297	457	0	44768
9919	532	129	747	44196	0	45604
9920	366	111	46511	996	0	47984
9921	269	117	46226	548	0	47160
9922	45599	73	1327	556	0	47555
9923	1267	98	48984	330	0	50679
9924	598	46856	1215	259	0	48928
9925	46743	948	659	345	0	48695
9926	47497	409	299	315	0	48520
9927	1573	206	175	46395	0	48349
9928	723	110	47108	1081	0	49022
9929	406	108	46132	566	0	47212
9930	47614	68	1422	487	0	49591
9931	1319	119	702	49184	0	51324
9932	49799	86	384	1238	0	51507
9933	1371	50956	268	642	0	53237
9934	51378	1026	293	472	0	53169
9935	51442	503	261	411	0	52617
9936	1720	50641	269	244	0	52874
9937	1014	1130	252	50558	0	52954
9938	50657	535	184	1374	0	52750
9939	1464	286	50514	627	0	52891
9940	819	50814	1256	394	0	53283
9941	750	1150	639	50647	0	53186
9942	50970	550	448	1328	0	53296
9943	1427	51509	291	701	0	53928
9944	52316	1267	231	579	0	54393
9945	1695	672	51656	327	0	54350
9946	50332	380	1300	413	0	52425
9947	1734	312	52190	259	0	54495
9948	50988	264	1496	346	0	53094
9949	51080	247	713	431	0	52471
9950	2035	244	50749	311	0	53339
9951	1139	50813	1384	279	0	53615
9952	951	1267	736	48226	0	51180
9953	631	629	51275	1327	0	53862
9954	626	50259	1394	752	0	53031
9955	738	1364	764	48536	0	51402
9956	685	699	521	51136	0	53041
9957	618	476	50131	1838	0	53063
9958	715	332	1525	48479	0	51051
9959	663	331	941	50495	0	52430
9960	596	289	49938	1979	0	52802
9961	653	284	1714	47718	0	50369
9962	544	49243	1033	1550	0	52370
9963	49943	1312	724	1010	0	52989
9964	1689	751	703	49008	0	52151
9965	1102	50019	642	1509	0	53272
9966	977	1447	661	46900	0	49985
9967	782	51263	624	1489	0	54158
9968	827	1581	50536	923	0	53867
9969	642	51566	1702	773	0	54683
9970	51091	1664	977	762	0	54494
9971	51467	857	782	752	0	53858
9972	52825	607	671	775	0	54878
9973	2395	602	53033	613	0	56643
9974	1383	540	52113	655	0	54691
9975	991	54304	2162	637	0	58094
9976	1059	1762	1164	51333	0	55318
9977	871	55954	742	1689	0	59256
9978	1150	2036	587	49086	0	52859
9979	869	56063	656	1605	0	59193
9980	55924	2064	598	1113	0	59699
9981	60010	1258	557	796	0	62621
9982	2843	807	557	60675	0	64882
9983	1653	737	60033	2115	0	64538
9984	58555	754	1992	1388	0	62689
9985	2502	61153	1203	912	0	65770
9986	1720	2110	883	59806	0	64519
9987	1423	1247	798	58865	0	62333
9988	1096	61185	753	2520	0	65554
9989	61488	2243	688	1528	0	65947
9990	2572	1360	60845	906	0	65683
9991	1717	1057	2167	60934	0	65875
9992	61436	838	1253	2329	0	65856
9993	61580	786	949	1466	0	64781
9994	3114	61126	805	1050	0	66095
9995	1987	2205	789	58868	0	63849
9996	1292	62155	764	2204	0	66415
9997	63091	2442	690	1589	0	67812
9998	2558	1473	62640	1132	0	67803
9999	1666	1165	62335	1002	0	66168
10000	1342	982	2717	61929	0	66970
10001	1096	841	1573	61527	0	65037
10002	966	62718	1062	2842	0	67588
10003	1102	2322	855	62736	0	67015
10004	927	1385	62428	2734	0	67474
10005	61174	1029	2293	1856	0	66352
10006	2425	907	1302	63514	0	68148
10007	1406	959	62932	2671	0	67968
10008	1262	900	2265	63071	0	67498
10009	1009	835	1418	62048	0	65310
10010	819	63078	1039	3077	0	68013
10011	1126	2194	817	63392	0	67529
10012	996	1338	796	62242	0	65372
10013	1020	1041	791	62011	0	64863
10014	57190	683	715	3349	0	61937
10015	2058	55718	693	2022	0	60491
10016	1236	55865	608	1316	0	59025
10017	53610	2105	553	1155	0	57423
10018	51717	1149	542	999	0	54407
10019	2164	49763	505	846	0	53278
10020	1049	48516	362	644	0	50571
10021	45510	1609	325	637	0	48081
10022	1354	45265	289	589	0	47497
10023	782	46395	287	535	0	47999
10024	45615	1641	399	663	0	48318
10025	1317	46201	230	590	0	48338
10026	45998	1578	292	611	0	48479
10027	45486	866	248	598	0	47198
10028	46047	755	260	499	0	47561
10029	1861	45736	247	466	0	48310
10030	1033	46145	211	472	0	47861
10031	842	1662	162	44031	0	46697
10032	754	43872	189	1207	0	46022
10033	776	1612	196	45801	0	48385
10034	46534	957	205	1586	0	49282
10035	1556	759	212	45753	0	48280
10036	895	45467	186	1578	0	48126
10037	44972	1491	233	1009	0	47705
10038	1576	44409	196	694	0	46875
10039	931	46222	146	632	0	47931
10040	884	2013	145	43347	0	46389
10041	622	45232	201	1312	0	47367
10042	44644	1647	272	794	0	47357
10043	1453	1007	43570	601	0	46631
10044	825	43395	1124	579	0	45923
10045	693	1482	546	43875	0	46596
10046	593	964	43615	1462	0	46634
10047	635	808	1158	43040	0	45641
10048	641	647	627	43947	0	45862
10049	598	568	493	44622	0	46281
10050	541	640	370	44167	0	45718
10051	542	488	42891	2146	0	46067
10052	491	42356	1290	1341	0	45478
10053	42163	1423	679	1133	0	45398
10054	1303	942	41525	917	0	44687
10055	41167	710	1214	953	0	44044
10056	1507	678	42160	753	0	45098
10057	1031	534	1450	42171	0	45186
10058	770	559	42075	1535	0	44939
10059	694	558	42586	1016	0	44854
10060	594	514	1764	42551	0	45423
10061	706	477	1045	39813	0	42041
10062	544	577	669	44162	0	45952
10063	518	530	489	44092	0	45629
10064	42679	550	513	2315	0	46057
10065	1393	493	42719	1446	0	46051
10066	42991	480	1205	1264	0	45940
10067	43774	493	736	988	0	45991
10068	43725	517	504	905	0	45651
10069	43537	528	435	802	0	45302
10070	43951	581	399	683	0	45614
10071	2466	424	301	42165	0	45356
10072	1373	468	38767	1467	0	42075
10073	1038	447	37593	929	0	40007
10074	804	38859	1187	812	0	41662
10075	37435	1137	850	666	0	40088
10076	1263	808	423	36682	0	39176
10077	893	913	342	35721	0	37869
10078	750	35488	312	1357	0	37907
10079	692	35220	297	869	0	37078
10080	694	35458	232	599	0	36983
10081	31434	1132	184	466	0	33216
10082	776	646	200	29268	0	30890
10083	426	29107	133	743	0	30409
10084	361	696	106	29344	0	30507
10085	276	419	28835	778	0	30308
10086	305	313	30046	476	0	31140
10087	385	232	768	32929	0	34314
10088	34065	266	363	994	0	35688
10089	35741	278	218	542	0	36779
10090	35984	251	177	427	0	36839
10091	1352	323	35288	292	0	37255
10092	757	292	894	34914	0	36857
10093	491	296	420	36601	0	37808
10094	455	309	34730	1278	0	36772
10095	32740	251	912	802	0	34705
10096	1128	263	35656	494	0	37541
10097	520	258	35047	347	0	36172
10098	358	217	35620	370	0	36565
10099	390	191	1309	34255	0	36145
10100	331	156	646	35715	0	36848
10101	260	157	36091	1362	0	37870
10102	310	182	1093	36290	0	37875
10103	36764	116	611	1297	0	38788
10104	1101	123	458	37647	0	39329
10105	577	143	37699	1318	0	39737
10106	371	128	39103	782	0	40384
10107	366	125	1437	38883	0	40811
10108	40500	99	707	1445	0	42751
10109	1323	42156	541	718	0	44738
10110	43279	1148	468	606	0	45501
10111	43800	528	499	535	0	45362
10112	1916	256	44181	492	0	46845
10113	1137	144	1456	44109	0	46846
10114	44828	130	944	1662	0	47564
10115	44450	131	637	1123	0	46341
10116	1975	44243	513	687	0	47418
10117	1164	1134	522	44393	0	47213
10118	759	562	490	46404	0	48215
10119	574	274	45152	2066	0	48066
10120	680	151	1502	44857	0	47190
10121	529	158	45270	1838	0	47795
10122	605	159	44543	1054	0	46361
10123	651	132	1864	43877	0	46524
10124	43562	133	1007	1679	0	46381
10125	1534	42487	677	1019	0	45717
10126	42677	1132	533	790	0	45132
10127	42846	609	492	660	0	44607
10128	2005	42113	465	571	0	45154
10129	1222	1128	390	40157	0	42897
10130	40143	659	368	1325	0	42495
10131	1578	40014	338	817	0	42747
10132	39480	1139	299	673	0	41591
10133	1501	38213	311	457	0	40482
10134	940	1111	268	37045	0	39364
10135	726	563	318	38293	0	39900
10136	37321	388	284	1635	0	39628
10137	36518	297	296	1073	0	38184
10138	1658	37080	330	697	0	39765
10139	928	1048	36407	594	0	38977
10140	624	524	35937	605	0	37690
10141	662	361	1490	34794	0	37307
10142	467	36491	929	1185	0	39072
10143	553	994	616	37528	0	39691
10144	573	577	510	37400	0	39060
10145	622	376	463	37451	0	38912
10146	539	340	36665	1715	0	39259
10147	532	362	35534	986	0	37414
10148	484	36863	1461	782	0	39590
10149	588	1072	795	36948	0	39403
10150	598	676	462	38781	0	40517
10151	624	462	37366	1695	0	40147
10152	34222	460	1214	1202	0	37098
10153	1418	321	757	38137	0	40633
10154	900	346	37749	1481	0	40476
10155	35536	331	1327	1147	0	38341
10156	1379	37487	778	848	0	40492
10157	1039	1141	38522	686	0	41388
10158	828	705	1270	38535	0	41338
10159	38226	502	848	1588	0	41164
10160	1435	335	38945	1044	0	41759
10161	928	376	1408	39068	0	41780
10162	704	322	989	39030	0	41045
10163	619	332	711	42842	0	44504
10164	42179	358	585	2270	0	45392
10165	1405	40998	588	1376	0	44367
10166	932	1216	516	41961	0	44625
10167	659	735	42194	1816	0	45404
10168	647	485	1507	41048	0	43687
10169	565	39822	921	1824	0	43132
10170	520	43139	722	1225	0	45606
10171	42390	1606	573	1083	0	45652
10172	43140	839	524	960	0	45463
10173	2048	584	42177	696	0	45505
10174	41333	492	1455	838	0	44118
10175	1788	42265	862	722	0	45637
10176	43162	1418	601	788	0	45969
10177	1877	866	438	42841	0	46022
10178	1270	655	43726	1629	0	47280
10179	1045	589	1393	43735	0	46762
10180	879	478	43928	1844	0	47129
10181	42782	446	1672	1262	0	46162
10182	1654	419	941	44255	0	47269
10183	1003	45144	636	1821	0	48604
10184	854	1564	482	46216	0	49116
10185	709	841	45448	2020	0	49018
10186	550	44074	1430	1324	0	47378
10187	41007	1263	762	1018	0	44050
10188	1256	39642	555	684	0	42137
10189	664	39606	463	512	0	41245
10190	644	1414	395	37767	0	40220
10191	415	39161	352	1138	0	41066
10192	476	1270	329	39595	0	41670
10193	441	710	38709	1403	0	41263
10194	35827	523	1026	840	0	38216
10195	38489	409	536	626	0	40060
10196	1461	368	37763	477	0	40069
10197	36005	373	985	489	0	37852
10198	1248	36887	555	476	0	39166
10199	37444	1011	379	474	0	39308
10200	1314	642	291	36728	0	38975
10201	692	445	36707	1074	0	38918
10202	494	37413	918	643	0	39468
10203	510	961	546	37043	0	39060
10204	352	501	335	37525	0	38713
10205	35833	387	227	1359	0	37806
10206	34161	271	203	826	0	35461
10207	1172	33570	221	471	0	35434
10208	519	31347	150	269	0	32285
10209	225	30640	139	199	0	31203
10210	330	592	176	29855	0	30953
10211	29589	229	134	596	0	30548
10212	29038	138	77	270	0	29523
10213	625	108	63	28751	0	29547
10214	272	102	54	28853	0	29281
10215	28415	102	57	648	0	29222
10216	544	103	50	28847	0	29544
10217	199	108	28400	562	0	29269
10218	27697	108	372	366	0	28543
10219	28668	99	126	282	0	29175
10220	624	107	28825	156	0	29712
10221	29134	110	407	230	0	29881
10222	631	111	124	29945	0	30811
10223	327	116	89	30145	0	30677
10224	212	117	84	30527	0	30940
10225	29721	95	88	768	0	30672
10226	512	30447	95	317	0	31371
10227	289	457	68	30550	0	31364
10228	228	29855	81	528	0	30692
10229	30140	491	88	310	0	31029
10230	621	175	86	30412	0	31294
10231	328	142	84	30876	0	31430
10232	235	30581	97	674	0	31587
10233	219	519	30180	304	0	31222
10234	232	213	497	30583	0	31525
10235	30787	130	150	734	0	31801
10236	33733	129	142	386	0	34390
10237	933	140	34810	218	0	36101
10238	441	113	749	35155	0	36458
10239	238	36176	265	835	0	37514
10240	262	836	158	37146	0	38402
10241	36766	311	137	1117	0	38331
10242	37000	245	116	516	0	37877
10243	1182	205	87	36146	0	37620
10244	500	35777	111	955	0	37343
10245	38180	903	86	455	0	39624
10246	1093	322	81	39084	0	40580
10247	38701	282	86	1182	0	40251
10248	40735	228	73	597	0	41633
10249	1379	154	77	40564	0	42174
10250	660	190	102	40820	0	41772
10251	532	120	82	41507	0	42241
10252	358	40972	99	1416	0	42845
10253	426	942	84	41669	0	43121
10254	426	337	80	42146	0	42989
10255	330	272	40142	1403	0	42147
10256	324	234	38971	669	0	40198
10257	320	156	1076	39637	0	41189
10258	39191	135	401	1346	0	41073
10259	1040	39262	259	631	0	41192
10260	38300	904	184	611	0	39999
10261	1192	370	38222	431	0	40215
10262	541	241	36367	448	0	37597
10263	345	36473	999	425	0	38242
10264	476	859	487	36192	0	38014
10265	251	316	36073	977	0	37617
10266	237	248	36589	471	0	37545
10267	273	210	965	36093	0	37541
10268	36086	168	422	1102	0	37778
10269	36384	110	327	520	0	37341
10270	1089	106	237	35806	0	37238
10271	536	157	37687	962	0	39342
10272	502	128	825	38004	0	39459
10273	365	142	381	37410	0	38298
10274	238	38132	310	1025	0	39705
10275	37956	727	253	684	0	39620
10276	38097	315	208	545	0	39165
10277	1009	38374	205	355	0	39943
10278	584	768	202	35900	0	37454
10279	329	37152	242	867	0	38590
10280	37017	851	215	513	0	38596
10281	923	344	36369	414	0	38050
10282	484	248	34266	319	0	35317
10283	335	229	34292	247	0	35103
10284	340	154	957	34163	0	35614
10285	271	127	518	34596	0	35512
10286	34154	131	336	1012	0	35633
10287	788	150	221	34286	0	35445
10288	443	156	172	34770	0	35541
10289	361	106	35952	1019	0	37438
10290	255	145	34571	579	0	35550
10291	34374	133	869	576	0	35952
10292	771	35382	420	360	0	36933
10293	36241	676	281	388	0	37586
10294	921	285	252	36145	0	37603
10295	506	205	265	35911	0	36887
10296	364	35772	221	964	0	37321
10297	333	679	238	36217	0	37467
10298	35655	312	201	1100	0	37268
10299	853	264	173	35935	0	37225
10300	488	225	35944	1014	0	37671
10301	337	35262	704	651	0	36954
10302	34711	670	369	636	0	36386
10303	35344	345	322	526	0	36537
10304	35448	277	229	470	0	36424
10305	35909	204	207	459	0	36779
10306	1201	190	227	35150	0	36768
10307	713	192	226	35836	0	36967
10308	513	184	35090	1167	0	36954
10309	473	168	658	35599	0	36898
10310	432	190	35261	1108	0	36991
10311	409	123	760	35646	0	36938
10312	35160	180	374	1216	0	36930
10313	820	35976	354	699	0	37849
10314	514	685	287	36683	0	38169
10315	499	332	224	37748	0	38803
10316	36734	268	231	1228	0	38461
10317	35988	188	255	800	0	37231
10318	1086	172	35796	594	0	37648
10319	564	35979	765	545	0	37853
10320	511	725	371	35773	0	37380
10321	422	360	316	36337	0	37435
10322	35529	233	329	1218	0	37309
10323	35281	193	400	798	0	36672
10324	1062	190	35675	513	0	37440
10325	580	242	35145	407	0	36374
10326	526	203	957	34448	0	36134
10327	447	160	512	35657	0	36776
10328	390	150	35035	1078	0	36653
10329	33634	136	839	726	0	35335
10330	1006	133	444	35275	0	36858
10331	34446	120	390	1052	0	36008
10332	885	34032	302	658	0	35877
10333	34875	628	268	644	0	36415
10334	1006	333	37197	475	0	39011
10335	571	36208	725	450	0	37954
10336	335	34370	282	283	0	35270
10337	32228	506	491	355	0	33580
10338	31470	180	139	247	0	32036
10339	583	110	91	31333	0	32117
10340	283	30943	106	427	0	31759
10341	170	32407	117	240	0	32934
10342	228	447	84	33020	0	33779
10343	33055	241	72	611	0	33979
10344	33781	149	72	404	0	34406
10345	625	94	31353	156	0	32228
10346	30143	45	320	221	0	30729
10347	471	33982	134	94	0	34681
10348	34962	516	81	176	0	35735
10349	726	41445	75	105	0	42351
10350	290	45217	63	88	0	45658
10351	463	1454	75	48272	0	50264
10352	51532	579	104	1469	0	53684
10353	52984	372	38	686	0	54080
10354	2039	241	51683	400	0	54363
10355	1178	114	1418	51826	0	54536
10356	52791	114	530	1818	0	55253
10357	2167	116	372	53073	0	55728
10358	53534	88	285	2039	0	55946
10359	54215	92	271	1007	0	55585
10360	2412	152	53190	692	0	56446
10361	1492	133	1521	52338	0	55484
10362	1027	141	584	54251	0	56003
10363	902	112	403	54962	0	56379
10364	603	158	52554	2471	0	55786
10365	618	135	1700	52684	0	55137
10366	569	136	692	51200	0	52597
10367	329	51514	514	2452	0	54809
10368	352	1555	50786	1350	0	54043
10369	271	52111	1708	991	0	55081
10370	51853	1853	647	906	0	55259
10371	1956	842	504	49430	0	52732
10372	1099	660	407	47946	0	50112
10373	710	49631	404	2088	0	52833
10374	49373	1840	253	1263	0	52729
10375	50601	702	221	1104	0	52628
10376	2370	48651	247	855	0	52123
10377	1302	50840	200	690	0	53032
10378	50185	2148	261	654	0	53248
10379	2191	1052	49177	560	0	52980
10380	1217	763	48931	500	0	51411
10381	47623	706	2047	578	0	50954
10382	2024	49682	1008	417	0	53131
10383	50073	1772	735	562	0	53142
10384	2180	898	49011	491	0	52580
10385	49264	688	1748	693	0	52393
10386	2352	51795	793	507	0	55447
10387	1417	1913	579	52071	0	55980
10388	1322	879	472	53113	0	55786
10389	1148	692	429	48852	0	51121
10390	1006	536	308	51923	0	53773
10391	832	599	327	50241	0	51999
10392	708	50091	363	2953	0	54115
10393	50107	1787	292	1869	0	54055
10394	2077	879	49714	1356	0	54026
10395	1196	675	1676	50788	0	54335
10396	928	585	50593	2320	0	54426
10397	894	549	2092	50486	0	54021
10398	867	420	1116	51953	0	54356
10399	50389	405	891	2875	0	54560
10400	1991	439	49495	1722	0	53647
10401	970	49370	2025	1343	0	53708
10402	996	1757	938	50092	0	53783
10403	844	887	744	51887	0	54362
10404	756	799	50460	2645	0	54660
10405	776	689	1895	50497	0	53857
10406	674	663	863	52563	0	54763
10407	49419	469	667	3214	0	53769
10408	1883	50215	627	1883	0	54608
10409	50321	1882	511	1534	0	54248
10410	51677	968	344	1338	0	54327
10411	2836	816	369	50501	0	54522
10412	1674	658	49518	2272	0	54122
10413	1278	665	49794	1249	0	52986
10414	1168	494	2321	49013	0	52996
10415	1047	475	1267	47931	0	50720
10416	747	48928	1033	2612	0	53320
10417	48986	1736	872	1600	0	53194
10418	2069	48019	848	1258	0	52194
10419	1172	50195	593	1223	0	53183
10420	49283	2501	500	1147	0	53431
10421	2384	1348	427	48588	0	52747
10422	1366	50526	433	2375	0	54700
10423	1127	2216	405	50985	0	54733
10424	822	1143	49628	2771	0	54364
10425	770	865	49938	1744	0	53317
10426	704	738	2258	50672	0	54372
10427	614	652	50719	2740	0	54725
10428	704	494	2423	50671	0	54292
10429	638	461	1373	51182	0	53654
10430	540	473	1128	52697	0	54838
10431	49500	420	818	3470	0	54208
10432	1837	47731	807	2057	0	52432
10433	937	50269	544	1762	0	53512
10434	47020	2184	491	1431	0	51126
10435	48312	1157	391	1260	0	51120
10436	2593	1011	439	47079	0	51122
10437	1258	934	47091	2192	0	51475
10438	1161	743	1765	47561	0	51230
10439	977	578	47219	2515	0	51289
10440	717	47072	2032	1566	0	51387
10441	792	1741	984	47564	0	51081
10442	46513	869	859	2423	0	50664
10443	2043	751	620	47069	0	50483
10444	1066	581	44797	2220	0	48664
10445	43312	592	1745	1504	0	47153
10446	2220	510	44748	1188	0	48666
10447	1370	420	42791	900	0	45481
10448	801	39964	1895	1007	0	43667
10449	440	32684	862	435	0	34421
10450	431	31045	697	417	0	32590
10451	25105	712	1008	557	0	27382
10452	23331	87	132	208	0	23758
10453	226	65	47	23723	0	24061
10454	123	41	31	23756	0	23951
10455	97	38	32	24237	0	24404
10456	56	24119	40	265	0	24480
10457	23951	180	41	200	0	24372
10458	195	24091	49	80	0	24415
10459	83	194	45	24291	0	24613
10460	23572	70	38	295	0	23975
10461	210	76	36	23596	0	23918
10462	123	56	33	24051	0	24263
10463	23948	47	44	368	0	24407
10464	23512	38	35	219	0	23804
10465	274	36	23681	99	0	24090
10466	107	46	23095	82	0	23330
10467	75	63	23919	74	0	24131
10468	91	44	261	23847	0	24243
10469	113	51	90	24199	0	24453
10470	60	24321	67	252	0	24700
10471	25078	225	50	191	0	25544
10472	261	90	48	25492	0	25891
10473	143	50	37	25911	0	26141
10474	75	25586	49	341	0	26051
10475	57	27059	51	166	0	27333
10476	122	307	37	27676	0	28142
10477	110	126	32	30675	0	30943
10478	30594	85	52	622	0	31353
10479	30664	51	42	292	0	31049
10480	580	53	41	30739	0	31413
10481	206	55	30645	519	0	31425
10482	165	77	29409	193	0	29844
10483	159	55	509	30189	0	30912
10484	159	45	182	29702	0	30088
10485	90	29633	124	583	0	30430
10486	28089	404	64	330	0	28887
10487	487	121	63	28247	0	28918
10488	155	112	28065	514	0	28846
10489	184	75	427	28235	0	28921
10490	118	46	28111	576	0	28851
10491	117	62	28140	230	0	28549
10492	150	164	534	28518	0	29366
10493	28328	69	249	656	0	29302
10494	427	53	28250	227	0	28957
10495	219	42	451	27915	0	28627
10496	156	58	30092	524	0	30830
10497	164	43	475	30021	0	30703
10498	158	46	201	30211	0	30616
10499	105	49	29997	617	0	30768
10500	94	39	28966	329	0	29428
10501	239	50	590	27009	0	27888
10502	135	42	248	29995	0	30420
10503	127	47	204	30203	0	30581
10504	115	42	158	29890	0	30205
10505	29410	36	135	794	0	30375
10506	29430	26	127	468	0	30051
10507	504	29416	150	281	0	30351
10508	29439	405	142	330	0	30316
10509	561	135	138	29740	0	30574
10510	29913	86	163	657	0	30819
10511	542	54	30212	316	0	31124
10512	30619	34	558	328	0	31539
10513	623	42	252	31603	0	32520
10514	277	43	194	33023	0	33537
10515	32520	35	142	925	0	33622
10516	691	32	142	35079	0	35944
10517	262	59	35931	946	0	37198
10518	35153	48	766	552	0	36519
10519	782	36680	292	355	0	38109
10520	377	673	179	37991	0	39220
10521	266	241	40452	953	0	41912
10522	283	148	825	40017	0	41273
10523	189	119	40420	1132	0	41860
10524	301	86	973	40350	0	41710
10525	187	40590	355	1127	0	42259
10526	294	836	231	40850	0	42211
10527	206	42524	184	1159	0	44073
10528	454	1047	166	39549	0	41216
10529	339	330	190	44763	0	45622
10530	325	218	213	45065	0	45821
10531	335	133	217	45128	0	45813
10532	342	111	208	45579	0	46240
10533	221	122	43964	1743	0	46050
10534	310	137	1096	44048	0	45591
10535	242	125	509	45124	0	46000
10536	44138	136	401	1760	0	46435
10537	1002	44018	279	1000	0	46299
10538	44202	1095	231	826	0	46354
10539	1302	436	234	44605	0	46577
10540	466	351	44263	1533	0	46613
10541	308	44179	1186	982	0	46655
10542	43613	1114	515	913	0	46155
10543	1071	43482	394	766	0	45713
10544	419	45424	267	724	0	46834
10545	44540	1375	291	780	0	46986
10546	1286	601	245	47223	0	49355
10547	46891	326	239	1856	0	49312
10548	1510	219	251	46355	0	48335
10549	612	267	46246	1877	0	49002
10550	443	237	45871	1056	0	47607
10551	44511	234	1568	956	0	47269
10552	46880	243	756	776	0	48655
10553	1803	239	433	45595	0	48070
10554	927	284	292	46459	0	47962
10555	44036	275	250	2040	0	46601
10556	1409	43643	259	1127	0	46438
10557	737	45478	308	779	0	47302
10558	44690	1575	241	748	0	47254
10559	45205	676	270	711	0	46862
10560	1867	45045	285	529	0	47726
10561	1106	1410	254	45038	0	47808
10562	760	643	44451	1575	0	47429
10563	588	476	44467	915	0	46446
10564	43611	319	1633	779	0	46342
10565	1621	322	44798	660	0	47401
10566	1039	266	1494	43369	0	46168
10567	837	285	625	43086	0	44833
10568	620	43673	497	1805	0	46595
10569	43872	1384	355	1025	0	46636
10570	1765	629	319	43705	0	46418
10571	907	512	42581	1626	0	45626
10572	726	42618	1270	954	0	45568
10573	640	1528	613	42362	0	45143
10574	529	655	42169	1556	0	44909
10575	599	511	40783	857	0	42750
10576	475	40325	1545	744	0	43089
10577	37025	1150	747	614	0	39536
10578	1153	37826	485	586	0	40050
10579	37717	1214	435	576	0	39942
10580	1304	596	37178	515	0	39593
10581	36018	451	1173	612	0	38254
10582	1257	37278	626	571	0	39732
10583	736	1152	466	37447	0	39801
10584	518	628	395	38878	0	40419
10585	37984	499	357	1680	0	40520
10586	1224	395	37788	929	0	40336
10587	37363	416	1206	743	0	39728
10588	38450	396	630	608	0	40084
10589	1535	393	36853	576	0	39357
10590	802	373	37625	560	0	39360
10591	690	411	1468	36890	0	39459
10592	37461	382	766	1414	0	40023
10593	37844	399	532	787	0	39562
10594	1596	38042	435	630	0	40703
10595	916	1251	399	38439	0	41005
10596	814	629	347	37504	0	39294
10597	700	466	339	37980	0	39485
10598	715	341	394	38767	0	40217
10599	37741	363	428	1760	0	40292
10600	1551	362	354	38362	0	40629
10601	900	334	37803	1501	0	40538
10602	754	354	37164	762	0	39034
10603	36139	303	1500	703	0	38645
10604	1533	36561	779	540	0	39413
10605	891	38281	572	530	0	40274
10606	774	1385	459	38140	0	40758
10607	701	658	425	39001	0	40785
10608	699	404	376	38724	0	40203
10609	705	309	334	39570	0	40918
10610	530	349	38083	1865	0	40827
10611	672	303	1137	37598	0	39710
10612	651	254	550	37784	0	39239
10613	492	275	35395	1669	0	37831
10614	32657	219	1188	1084	0	35148
10615	1173	34429	614	808	0	37024
10616	32182	819	411	622	0	34034
10617	1084	367	31537	503	0	33491
10618	558	277	30630	401	0	31866
10619	397	30634	1053	433	0	32517
10620	28732	1078	1490	552	0	31852
10621	27113	406	385	407	0	28311
10622	27292	234	209	380	0	28115
10623	880	26521	207	349	0	27957
10624	25817	595	170	369	0	26951
10625	751	286	25887	292	0	27216
10626	377	25626	632	291	0	26926
10627	24475	586	337	327	0	25725
10628	668	24892	218	276	0	26054
10629	24081	580	165	250	0	25076
10630	23139	230	179	233	0	23781
10631	723	158	23951	135	0	24967
10632	390	24061	540	141	0	25132
10633	23847	534	254	190	0	24825
10634	614	253	23849	104	0	24820
10635	336	23778	552	136	0	24802
10636	294	539	232	23187	0	24252
10637	212	233	23282	437	0	24164
10638	207	173	22501	210	0	23091
10639	232	148	497	22724	0	23601
10640	22443	112	227	500	0	23282
10641	467	22475	163	223	0	23328
10642	263	399	22164	140	0	22966
10643	280	191	21516	84	0	22071
10644	20437	167	469	126	0	21199
10645	442	21931	226	73	0	22672
10646	19761	239	128	83	0	20211
10647	287	19836	56	34	0	20213
10648	20052	273	128	84	0	20537
10649	19508	117	53	72	0	19750
10650	362	19185	49	31	0	19627
10651	191	263	50	19407	0	19911
10652	20517	123	68	321	0	21029
10653	357	94	56	20889	0	21396
10654	188	55	50	21983	0	22276
10655	21779	38	77	531	0	22425
10656	383	21718	81	167	0	22349
10657	21973	363	46	165	0	22547
10658	458	157	21838	53	0	22506
10659	226	96	380	21909	0	22611
10660	160	61	165	21971	0	22357
10661	21700	65	87	531	0	22383
10662	21756	73	50	245	0	22124
10663	541	80	45	21629	0	22295
10664	236	80	21803	412	0	22531
10665	182	72	351	21736	0	22341
10666	165	60	144	22205	0	22574
10667	179	57	91	22371	0	22698
10668	155	60	58	22485	0	22758
10669	21949	55	53	657	0	22714
10670	470	68	21865	251	0	22654
10671	216	21992	386	185	0	22779
10672	170	379	156	21838	0	22543
10673	181	143	89	23084	0	23497
10674	139	115	22838	598	0	23690
10675	136	83	22336	276	0	22831
10676	138	53	553	22976	0	23720
10677	164	48	215	23337	0	23764
10678	120	53	22779	669	0	23621
10679	181	51	478	22654	0	23364
10680	22889	62	209	646	0	23806
10681	536	23389	116	316	0	24357
10682	244	463	23023	209	0	23939
10683	154	23074	493	197	0	23918
10684	169	517	197	23190	0	24073
10685	136	208	23274	593	0	24211
10686	125	23156	526	294	0	24101
10687	181	476	218	23485	0	24360
10688	105	194	23953	580	0	24832
10689	147	139	563	23681	0	24530
10690	164	94	220	23939	0	24417
10691	23687	83	163	798	0	24731
10692	587	93	158	23915	0	24753
10693	23741	81	143	762	0	24727
10694	22881	71	127	397	0	23476
10695	22908	85	122	326	0	23441
10696	770	87	138	22481	0	23476
10697	287	85	21830	640	0	22842
10698	194	75	21012	337	0	21618
10699	21510	75	601	297	0	22483
10700	544	77	22069	183	0	22873
10701	21226	79	542	266	0	22113
10702	547	21870	243	184	0	22844
10703	22234	447	183	250	0	23114
10704	595	188	22558	204	0	23545
10705	292	115	23230	195	0	23832
10706	233	68	668	23668	0	24637
10707	174	63	24589	689	0	25515
10708	175	67	25075	314	0	25631
10709	262	50	797	25842	0	26951
10710	235	60	312	27227	0	27834
10711	210	75	199	27990	0	28474
10712	118	27684	195	1019	0	29016
10713	246	689	175	26824	0	27934
10714	109	28591	179	856	0	29735
10715	28484	776	152	468	0	29880
10716	29333	310	182	332	0	30157
10717	1054	186	132	28265	0	29637
10718	422	28211	171	920	0	29724
10719	273	787	28737	415	0	30212
10720	28854	276	896	378	0	30404
10721	988	188	387	28833	0	30396
10722	491	139	269	29428	0	30327
10723	365	127	211	30105	0	30808
10724	28917	109	181	1367	0	30574
10725	943	27715	184	667	0	29509
10726	381	29072	231	426	0	30110
10727	28030	995	174	408	0	29607
10728	917	28555	186	325	0	29983
10729	28837	973	184	334	0	30328
10730	29195	394	189	372	0	30150
10731	1200	28590	193	313	0	30296
10732	615	940	155	27839	0	29549
10733	345	28462	194	967	0	29968
10734	376	970	175	28541	0	30062
10735	335	411	148	30476	0	31370
10736	29898	303	137	1450	0	31788
10737	31274	247	157	744	0	32422
10738	1472	252	175	30820	0	32719
10739	706	238	29968	1256	0	32168
10740	29248	237	976	745	0	31206
10741	1204	29985	434	572	0	32195
10742	698	1026	288	30258	0	32270
10743	548	496	219	31135	0	32398
10744	472	395	157	31580	0	32604
10745	29779	292	140	1717	0	31928
10746	30059	257	161	955	0	31432
10747	1427	28386	156	672	0	30641
10748	747	29401	153	517	0	30818
10749	649	1239	165	29185	0	31238
10750	552	658	150	30051	0	31411
10751	424	425	29307	1476	0	31632
10752	457	357	904	28681	0	30399
10753	331	260	28071	1382	0	30044
10754	339	211	26628	748	0	27926
10755	344	26761	1140	563	0	28808
10756	456	939	567	26923	0	28885
10757	26977	479	307	1252	0	29015
10758	1091	360	242	27033	0	28726
10759	628	288	26477	1265	0	28658
10760	26072	300	888	748	0	28008
10761	26947	254	432	621	0	28254
10762	1356	272	26296	486	0	28410
10763	798	243	944	27058	0	29043
10764	26753	211	455	1247	0	28666
10765	1178	27001	374	738	0	29291
10766	27670	971	275	654	0	29570
10767	28638	510	254	589	0	29991
10768	1547	365	237	27979	0	30128
10769	857	296	237	29172	0	30562
10770	28578	281	243	1558	0	30660
10771	1403	206	219	28790	0	30618
10772	729	267	28041	1507	0	30544
10773	27017	205	941	892	0	29055
10774	27877	222	447	680	0	29226
10775	1439	26549	320	570	0	28878
10776	787	27686	250	502	0	29225
10777	623	1234	199	26505	0	28561
10778	491	27546	210	1124	0	29371
10779	515	1141	204	27851	0	29711
10780	27310	494	219	1328	0	29351
10781	27054	372	211	774	0	28411
10782	1314	26573	217	613	0	28717
10783	26638	957	228	516	0	28339
10784	1289	26637	210	439	0	28575
10785	26747	1063	178	478	0	28466
10786	27137	515	197	482	0	28331
10787	1455	401	25955	427	0	28238
10788	25702	291	869	465	0	27327
10789	1353	25247	439	386	0	27425
10790	811	26477	307	418	0	28013
10791	26482	1152	241	405	0	28280
10792	1333	609	193	26396	0	28531
10793	825	429	26308	1086	0	28648
10794	703	391	870	26696	0	28660
10795	617	357	416	27571	0	28961
10796	597	314	26443	1369	0	28723
10797	25267	297	893	864	0	27321
10798	1205	26092	449	667	0	28413
10799	26131	915	304	514	0	27864
10800	1400	463	220	25281	0	27364
10801	25366	408	228	1050	0	27052
10802	1301	25004	185	623	0	27113
10803	862	965	188	25077	0	27092
10804	24776	479	166	1137	0	26558
10805	1182	355	23322	649	0	25508
10806	643	283	21705	509	0	23140
10807	20708	301	893	445	0	22347
10808	992	20611	460	348	0	22411
10809	507	19148	241	259	0	20155
10810	713	805	288	17739	0	19545
10811	367	17941	168	635	0	19111
10812	391	688	178	17965	0	19222
10813	334	328	162	18761	0	19585
10814	331	251	170	18396	0	19148
10815	312	17837	181	807	0	19137
10816	348	522	167	17597	0	18634
10817	320	328	17073	661	0	18382
10818	291	16668	442	534	0	17935
10819	279	482	213	15622	0	16596
10820	251	16272	178	480	0	17181
10821	16225	491	155	310	0	17181
10822	16192	257	138	299	0	16886
10823	16296	192	149	260	0	16897
10824	697	16359	146	194	0	17396
10825	437	462	109	16323	0	17331
10826	397	275	16068	444	0	17184
10827	310	252	15681	284	0	16527
10828	15398	265	497	323	0	16483
10829	15831	185	297	271	0	16584
10830	634	163	142	16308	0	17247
10831	402	162	122	16747	0	17433
10832	305	153	16525	674	0	17657
10833	267	15481	424	1012	0	17184
10834	257	15686	243	304	0	16490
10835	202	407	15114	177	0	15900
10836	191	285	357	14192	0	15025
10837	200	164	125	11797	0	12286
10838	131	124	64	14451	0	14770
10839	150	119	64	14455	0	14788
10840	14310	93	61	393	0	14857
10841	366	99	13730	158	0	14353
10842	13635	97	265	153	0	14150
10843	372	103	106	13783	0	14364
10844	13824	117	72	343	0	14356
10845	363	86	81	13837	0	14367
10846	187	102	13835	324	0	14448
10847	169	118	283	13882	0	14452
10848	140	119	14102	326	0	14687
10849	123	105	258	13688	0	14174
10850	99	86	14200	339	0	14724
10851	89	14190	260	188	0	14727
10852	103	229	130	14356	0	14818
10853	107	106	73	14310	0	14596
10854	82	14467	84	319	0	14952
10855	14782	251	89	197	0	15319
10856	291	87	82	14798	0	15258
10857	154	98	66	14832	0	15150
10858	14921	93	42	378	0	15434
10859	15101	50	63	222	0	15436
10860	15386	61	70	205	0	15722
10861	15464	58	65	177	0	15764
10862	338	65	14825	142	0	15370
10863	14396	48	232	161	0	14837
10864	15073	57	108	126	0	15364
10865	354	54	100	14325	0	14833
10866	154	55	62	14182	0	14453
10867	13605	39	38	306	0	13988
10868	226	13485	41	136	0	13888
10869	111	165	34	13091	0	13401
10870	82	58	13458	220	0	13818
10871	63	13386	145	113	0	13707
10872	13466	161	85	98	0	13810
10873	13554	43	60	101	0	13758
10874	13561	38	34	81	0	13714
10875	13771	41	27	81	0	13920
10876	256	15	44	13354	0	13669
10877	116	35	13232	185	0	13568
10878	91	37	13770	84	0	13982
10879	86	22	230	14654	0	14992
10880	15313	19	79	279	0	15690
10881	311	20	53	15399	0	15783
10882	110	29	15392	302	0	15833
10883	15299	11	254	156	0	15720
10884	15512	19	81	119	0	15731
10885	373	25	60	15675	0	16133
10886	160	16	16127	270	0	16573
10887	123	13	16292	105	0	16533
10888	15623	12	298	136	0	16069
10889	284	16105	117	107	0	16613
10890	117	214	16518	95	0	16944
10891	136	56	287	16337	0	16816
10892	16427	36	124	328	0	16915
10893	304	15800	72	158	0	16334
10894	133	16151	100	117	0	16501
10895	16103	283	87	129	0	16602
10896	356	99	82	16053	0	16590
10897	17169	62	53	349	0	17633
10898	398	58	74	17397	0	17927
10899	179	47	77	17680	0	17983
10900	145	47	17456	385	0	18033
10901	130	62	16284	180	0	16656
10902	115	59	17453	120	0	17747
10903	114	73	410	17521	0	18118
10904	17788	36	180	392	0	18396
10905	396	60	17679	172	0	18307
10906	208	54	345	17656	0	18263
10907	147	62	17824	393	0	18426
10908	139	18057	367	189	0	18752
10909	177	301	157	18266	0	18901
10910	141	91	126	18390	0	18748
10911	158	53	132	18518	0	18861
10912	18214	46	128	523	0	18911
10913	406	40	122	18225	0	18793
10914	182	59	157	18468	0	18866
10915	18205	34	135	531	0	18905
10916	404	46	18021	243	0	18714
10917	17803	46	370	215	0	18434
10918	18032	59	159	195	0	18445
10919	448	60	17843	151	0	18502
10920	17339	59	338	195	0	17931
10921	444	52	146	18406	0	19048
10922	216	61	18596	403	0	19276
10923	18293	18	351	321	0	18983
10924	18737	25	149	239	0	19150
10925	470	29	123	18581	0	19203
10926	261	24	130	18685	0	19100
10927	216	27	112	18692	0	19047
10928	18275	15	122	547	0	18959
10929	452	18265	115	256	0	19088
10930	17689	230	121	211	0	18251
10931	351	16813	118	180	0	17462
10932	193	16959	140	131	0	17423
10933	171	280	126	17263	0	17840
10934	188	92	100	17475	0	17855
10935	164	60	83	17255	0	17562
10936	177	51	104	17328	0	17660
10937	154	53	16894	456	0	17557
10938	16435	53	294	278	0	17060
10939	343	74	117	17269	0	17803
10940	203	70	17211	396	0	17880
10941	171	75	284	17147	0	17677
10942	210	62	112	17526	0	17910
10943	149	92	18158	425	0	18824
10944	184	66	301	18100	0	18651
10945	156	67	111	18207	0	18541
10946	18301	47	108	549	0	19005
10947	337	42	18504	295	0	19178
10948	17656	38	307	298	0	18299
10949	374	18671	185	207	0	19437
10950	18485	247	134	245	0	19111
10951	18180	75	134	239	0	18628
10952	421	52	114	18109	0	18696
10953	182	45	17972	443	0	18642
10954	138	19048	342	255	0	19783
10955	198	300	149	18379	0	19026
10956	127	19642	111	401	0	20281
10957	19634	369	115	278	0	20396
10958	429	121	19296	222	0	20068
10959	176	92	19064	191	0	19523
10960	192	83	389	19015	0	19679
10961	161	70	19884	480	0	20595
10962	196	88	386	20006	0	20676
10963	207	86	160	19688	0	20141
10964	20362	53	113	600	0	21128
10965	434	20384	149	275	0	21242
10966	200	369	115	20836	0	21520
10967	181	98	132	21335	0	21746
10968	164	95	129	21048	0	21436
10969	146	20543	130	579	0	21398
10970	132	20977	152	279	0	21540
10971	20513	390	149	273	0	21325
10972	20591	112	130	303	0	21136
10973	20470	91	133	251	0	20945
10974	510	96	20183	220	0	21009
10975	228	136	401	20025	0	20790
10976	181	96	20017	499	0	20793
10977	152	20008	385	276	0	20821
10978	19153	351	164	225	0	19893
10979	359	130	18844	169	0	19502
10980	184	87	289	18261	0	18821
10981	112	81	18631	345	0	19169
10982	18086	49	299	219	0	18653
10983	18947	54	122	196	0	19319
10984	18997	65	96	179	0	19337
10985	18656	58	88	181	0	18983
10986	384	57	19249	122	0	19812
10987	18549	53	269	153	0	19024
10988	19170	54	119	148	0	19491
10989	342	19036	95	120	0	19593
10990	18918	240	99	136	0	19393
10991	19245	85	78	146	0	19554
10992	400	38	101	18821	0	19360
10993	160	19774	91	289	0	20314
10994	20787	265	63	200	0	21315
10995	22317	102	78	144	0	22641
10996	516	84	24482	122	0	25204
10997	225	58	24145	55	0	24483
10998	150	49	25015	68	0	25282
10999	170	74	650	24575	0	25469
11000	24667	40	290	539	0	25536
11001	525	24750	162	227	0	25664
11002	24571	465	121	161	0	25318
11003	585	24691	84	88	0	25448
11004	24448	496	82	115	0	25141
11005	560	24077	103	87	0	24827
11006	274	24742	84	92	0	25192
11007	23966	611	65	114	0	24756
11008	540	24540	60	63	0	25203
11009	312	541	60	24395	0	25308
11010	199	236	24917	455	0	25807
11011	161	155	25036	181	0	25533
11012	183	120	605	24689	0	25597
11013	182	95	236	25423	0	25936
11014	139	108	25368	620	0	26235
11015	156	103	523	24891	0	25673
11016	173	79	227	25351	0	25830
11017	25233	88	154	708	0	26183
11018	531	25262	129	329	0	26251
11019	326	510	128	23999	0	24963
11020	163	25452	138	519	0	26272
11021	25099	557	116	302	0	26074
11022	539	25298	119	182	0	26138
11023	25302	588	110	191	0	26191
11024	25648	265	88	193	0	26194
11025	773	194	73	25126	0	26166
11026	436	150	90	25363	0	26039
11027	301	159	100	25606	0	26166
11028	244	132	104	25654	0	26134
11029	190	154	24564	781	0	25689
11030	22707	151	506	465	0	23829
11031	617	24561	216	263	0	25657
11032	332	569	151	25071	0	26123
11033	282	249	135	25125	0	25791
11034	178	25130	142	720	0	26170
11035	25144	577	130	411	0	26262
11036	618	25446	127	274	0	26465
11037	342	641	113	25698	0	26794
11038	283	290	121	26312	0	27006
11039	241	211	99	26431	0	26982
11040	233	174	84	26422	0	26913
11041	25698	172	96	911	0	26877
11042	700	165	25660	428	0	26953
11043	395	168	567	25004	0	26134
11044	264	160	272	25329	0	26025
11045	244	159	204	25624	0	26231
11046	230	152	178	25485	0	26045
11047	24334	145	109	1017	0	25605
11048	718	169	24309	475	0	25671
11049	401	223	530	23229	0	24383
11050	274	22950	220	704	0	24148
11051	196	24289	153	417	0	25055
11052	23781	693	115	437	0	25026
11053	658	388	23510	278	0	24834
11054	21691	244	459	286	0	22680
11055	662	211	22455	228	0	23556
11056	316	153	471	21753	0	22693
11057	22086	112	244	675	0	23117
11058	482	22311	215	391	0	23399
11059	302	466	168	21319	0	22255
11060	200	20436	173	596	0	21405
11061	21900	507	139	423	0	22969
11062	22091	251	141	371	0	22854
11063	637	164	92	22126	0	23019
11064	369	141	21448	653	0	22611
11065	270	167	21181	393	0	22011
11066	274	181	545	21007	0	22007
11067	181	20933	268	569	0	21951
11068	198	536	130	22382	0	23246
11069	265	301	101	21350	0	22017
11070	234	266	75	21255	0	21830
11071	239	151	21610	796	0	22796
11072	222	134	474	21644	0	22474
11073	166	113	253	21806	0	22338
11074	132	21406	181	930	0	22649
11075	134	512	141	21375	0	22162
11076	163	234	123	22579	0	23099
11077	149	162	140	22924	0	23375
11078	199	104	144	22940	0	23387
11079	170	138	113	22673	0	23094
11080	149	122	91	22754	0	23116
11081	165	151	90	22389	0	22795
11082	162	179	85	22009	0	22435
11083	151	167	20479	1158	0	21955
11084	185	176	404	21175	0	21940
11085	20701	140	199	813	0	21853
11086	542	108	129	20493	0	21272
11087	284	97	20491	788	0	21660
11088	19823	78	464	608	0	20973
11089	20971	87	247	425	0	21730
11090	20871	107	192	396	0	21566
11091	21041	87	116	411	0	21655
11092	798	102	98	20975	0	21973
11093	361	80	20346	716	0	21503
11094	208	19239	410	481	0	20338
11095	161	17348	214	322	0	18045
11096	301	332	496	15164	0	16293
11097	74	72	129	16151	0	16426
11098	83	33	26	16009	0	16151
11099	52	28	29	16857	0	16966
11100	56	19	25	18834	0	18934
11101	19653	32	18	528	0	20231
11102	395	19674	28	202	0	20299
11103	150	20448	35	141	0	20774
11104	130	516	25	20699	0	21370
11105	114	188	31	21299	0	21632
11106	110	81	27	21287	0	21505
11107	102	42	16	21412	0	21572
11108	72	44	20170	769	0	21055
11109	71	19842	441	348	0	20702
11110	98	463	136	19809	0	20506
11111	19344	201	62	598	0	20205
11112	458	122	44	19647	0	20271
11113	169	93	19416	643	0	20321
11114	90	77	18574	385	0	19126
11115	59	61	19769	288	0	20177
11116	85	89	611	19541	0	20326
11117	19978	87	292	643	0	21000
11118	472	74	128	20358	0	21032
11119	221	67	83	21383	0	21754
11120	20922	56	68	821	0	21867
11121	531	45	91	21519	0	22186
11122	249	43	140	21920	0	22352
11123	127	55	22758	755	0	23695
11124	94	22788	555	458	0	23895
11125	158	479	220	23827	0	24684
11126	23549	171	139	781	0	24640
11127	581	119	103	23957	0	24760
11128	270	75	24005	767	0	25117
11129	223	82	521	23971	0	24797
11130	123	24261	220	827	0	25431
11131	171	531	149	24911	0	25762
11132	100	225	24465	811	0	25601
11133	103	26118	575	440	0	27236
11134	165	690	215	26694	0	27764
11135	174	261	161	29048	0	29644
11136	145	140	131	29437	0	29853
11137	126	106	154	29594	0	29980
11138	74	131	28466	1220	0	29891
11139	80	28484	731	647	0	29942
11140	28497	698	332	523	0	30050
11141	29238	325	225	407	0	30195
11142	937	189	171	28918	0	30215
11143	371	143	28544	996	0	30054
11144	27944	123	710	623	0	29400
11145	797	79	357	29108	0	30341
11146	322	112	29574	1044	0	31052
11147	257	108	801	29807	0	30973
11148	272	122	346	30057	0	30797
11149	262	102	202	30586	0	31152
11150	205	119	30935	1290	0	32549
11151	317	85	781	29435	0	30618
11152	199	30972	387	1011	0	32569
11153	31182	695	266	688	0	32831
11154	31534	316	248	510	0	32608
11155	31664	206	172	513	0	32555
11156	1048	31206	193	477	0	32924
11157	31415	729	184	497	0	32825
11158	957	300	189	31091	0	32537
11159	30904	198	198	1140	0	32440
11160	31037	187	197	698	0	32119
11161	1068	184	30231	538	0	32021
11162	560	30018	760	473	0	31811
11163	30214	752	375	412	0	31753
11164	989	363	230	30320	0	31902
11165	535	269	30074	955	0	31833
11166	407	30137	727	603	0	31874
11167	30006	773	352	523	0	31654
11168	1029	328	241	30232	0	31830
11169	598	267	201	30707	0	31773
11170	474	248	201	30599	0	31522
11171	402	30047	172	1235	0	31856
11172	389	728	173	30414	0	31704
11173	310	29799	221	1157	0	31487
11174	327	849	254	30478	0	31908
11175	284	431	30122	1101	0	31938
11176	334	314	782	30360	0	31790
11177	349	229	378	30880	0	31836
11178	309	181	277	31445	0	32212
11179	268	220	30285	1433	0	32206
11180	297	237	790	30401	0	31725
11181	318	215	388	31210	0	32131
11182	280	221	290	31620	0	32411
11183	295	192	274	31557	0	32318
11184	314	210	204	31877	0	32605
11185	262	192	30650	1532	0	32636
11186	286	203	777	30850	0	32116
11187	309	171	404	31021	0	31905
11188	29399	168	290	1508	0	31365
11189	823	28775	279	963	0	30840
11190	459	29805	231	797	0	31292
11191	393	871	205	30013	0	31482
11192	313	414	226	29723	0	30676
11193	231	28365	251	1345	0	30192
11194	306	745	196	28621	0	29868
11195	235	28259	175	1316	0	29985
11196	338	757	189	28252	0	29536
11197	296	414	150	27709	0	28569
11198	209	291	26306	1180	0	27986
11199	212	25376	621	778	0	26987
11200	175	24531	267	532	0	25505
11201	21989	552	201	465	0	23207
11202	416	22393	128	321	0	23258
11203	287	505	92	22180	0	23064
11204	194	297	21544	594	0	22629
11205	187	227	369	21567	0	22350
11206	21150	209	197	687	0	22243
11207	422	197	21405	439	0	22463
11208	240	21806	402	336	0	22784
11209	337	464	245	18291	0	19337
11210	178	249	141	22684	0	23252
11211	22576	167	157	776	0	23676
11212	397	172	122	22980	0	23671
11213	238	143	117	23092	0	23590
11214	178	148	107	23188	0	23621
11215	162	151	105	22991	0	23409
11216	22215	135	108	828	0	23286
11217	22085	136	98	588	0	22907
11218	503	112	103	22401	0	23119
11219	21476	104	106	667	0	22353
11220	470	87	106	21282	0	21945
11221	267	112	20555	645	0	21579
11222	171	105	19492	491	0	20259
11223	207	214	383	18239	0	19043
11224	125	18354	186	565	0	19230
11225	146	285	110	18389	0	18930
11226	18018	166	91	565	0	18840
11227	301	122	66	18376	0	18865
11228	17734	108	72	579	0	18493
11229	360	91	60	17943	0	18454
11230	256	94	17646	477	0	18473
11231	139	17041	254	373	0	17807
11232	140	17706	150	290	0	18286
11233	175	349	68	15609	0	16201
11234	72	110	15737	297	0	16216
11235	40	13705	75	92	0	13912
11236	66	82	67	13653	0	13868
11237	13475	23	27	135	0	13660
11238	66	30	13804	70	0	13970
11239	48	20	60	13917	0	14045
11240	33	15	30	14524	0	14602
11241	20	31	14469	128	0	14648
11242	22	18	13471	92	0	13603
11243	22	27	14640	50	0	14739
11244	35	34	124	14811	0	15004
11245	19	12	15209	122	0	15362
11246	14263	10	107	92	0	14472
11247	145	5	44	15613	0	15807
11248	53	21	18036	145	0	18255
11249	32	18350	159	84	0	18625
11250	26	153	18086	49	0	18314
11251	37	51	204	18082	0	18374
11252	18538	30	67	264	0	18899
11253	196	16	40	18970	0	19222
11254	76	11	27	19194	0	19308
11255	20328	11	25	321	0	20685
11256	290	9	16	20712	0	21027
11257	75	22	20883	320	0	21300
11258	20307	10	280	161	0	20758
11259	275	21128	105	69	0	21577
11260	21422	268	63	111	0	21864
11261	334	68	40	21463	0	21905
11262	107	31	21361	301	0	21800
11263	76	28	21504	126	0	21734
11264	88	38	355	21525	0	22006
11265	83	32	114	21638	0	21867
11266	46	24	21766	350	0	22186
11267	56	17	20726	141	0	20940
11268	21358	23	369	125	0	21875
11269	355	20	132	21810	0	22317
11270	22041	16	80	390	0	22527
11271	386	29	77	21829	0	22321
11272	138	29	22528	377	0	23072
11273	76	31	23564	140	0	23811
11274	107	23	444	24184	0	24758
11275	93	21	150	25009	0	25273
11276	51	20	25601	473	0	26145
11277	24995	3	476	218	0	25692
11278	518	11	148	26405	0	27082
11279	27140	7	119	597	0	27863
11280	560	29938	109	208	0	30815
11281	218	595	92	30662	0	31567
11282	30809	126	95	788	0	31818
11283	717	75	31073	234	0	32099
11284	263	49	700	31172	0	32184
11285	169	35	225	31430	0	31859
11286	168	18	152	32283	0	32621
11287	92	37	31499	938	0	32566
11288	180	29	738	30741	0	31688
11289	93	31373	251	797	0	32514
11290	138	629	179	31955	0	32901
11291	133	156	31713	834	0	32836
11292	107	88	31753	325	0	32273
11293	174	59	870	31856	0	32959
11294	196	66	281	32270	0	32813
11295	157	46	185	32820	0	33208
11296	158	44	181	33050	0	33433
11297	32201	38	172	1122	0	33533
11298	32090	60	143	508	0	32801
11299	878	45	31685	355	0	32963
11300	284	31804	767	318	0	33173
11301	243	666	279	32791	0	33979
11302	33918	174	179	1059	0	35330
11303	29305	153	210	685	0	30353
11304	34417	89	150	416	0	35072
11305	34651	68	171	399	0	35289
11306	992	75	34026	271	0	35364
11307	32651	66	794	375	0	33886
11308	862	33024	310	308	0	34504
11309	392	699	224	33679	0	34994
11310	228	201	33792	972	0	35193
11311	296	114	817	33413	0	34640
11312	235	97	33504	1013	0	34849
11313	271	96	895	33396	0	34658
11314	279	83	338	34507	0	35207
11315	33915	85	242	1182	0	35424
11316	966	65	195	34149	0	35375
11317	361	103	34136	1052	0	35652
11318	317	91	840	34765	0	36013
11319	34604	73	332	1153	0	36162
11320	981	75	260	34951	0	36267
11321	409	69	34689	1059	0	36226
11322	293	34188	899	517	0	35897
11323	35330	753	338	556	0	36977
11324	965	217	299	34021	0	35502
11325	351	36057	268	975	0	37651
11326	35902	794	247	568	0	37511
11327	962	249	35854	439	0	37504
11328	400	35647	864	432	0	37343
11329	336	770	383	36622	0	38111
11330	287	262	36309	1014	0	37872
11331	293	165	915	35605	0	36978
11332	35696	126	372	1206	0	37400
11333	950	111	35366	598	0	37025
11334	414	121	919	35451	0	36905
11335	368	113	35490	1101	0	37072
11336	364	132	938	35276	0	36710
11337	329	134	398	36341	0	37202
11338	35080	131	262	1287	0	36760
11339	908	35101	285	583	0	36877
11340	419	756	238	35507	0	36920
11341	34980	221	241	1133	0	36575
11342	34949	169	251	592	0	35961
11343	1042	172	241	34418	0	35873
11344	400	33640	268	1030	0	35338
11345	299	34874	237	517	0	35927
11346	303	868	239	33938	0	35348
11347	300	275	230	34110	0	34915
11348	31029	156	198	1102	0	32485
11349	806	146	198	30747	0	31897
11350	307	104	29531	933	0	30875
11351	27676	78	662	587	0	29003
11352	718	28581	246	412	0	29957
11353	28455	600	168	393	0	29616
11354	787	205	28670	337	0	29999
11355	303	29097	629	279	0	30308
11356	28654	645	283	344	0	29926
11357	29072	201	201	279	0	29753
11358	813	145	28687	221	0	29866
11359	28111	173	640	227	0	29151
11360	28915	116	210	263	0	29504
11361	796	28689	152	222	0	29859
11362	380	610	111	29447	0	30548
11363	279	229	29072	708	0	30288
11364	265	137	668	30069	0	31139
11365	218	111	30466	820	0	31615
11366	249	109	732	30077	0	31167
11367	30431	106	273	922	0	31732
11368	812	93	200	31267	0	32372
11369	296	102	33540	881	0	34819
11370	33449	94	822	405	0	34770
11371	1025	53	301	34375	0	35754
11372	355	76	33451	910	0	34792
11373	31442	70	858	450	0	32820
11374	1002	77	314	32051	0	33444
11375	379	91	31159	916	0	32545
11376	283	104	30192	343	0	30922
11377	313	374	853	29556	0	31096
11378	200	78	30381	806	0	31465
11379	189	29234	762	361	0	30546
11380	200	497	250	26233	0	27180
11381	26235	114	196	621	0	27166
11382	530	81	26449	244	0	27304
11383	223	47	26061	190	0	26521
11384	24703	39	659	236	0	25637
11385	528	43	26308	135	0	27014
11386	24722	15	618	230	0	25585
11387	582	30	26026	125	0	26763
11388	273	35	622	25600	0	26530
11389	174	42	26360	520	0	27096
11390	207	38	646	26030	0	26921
11391	143	47	26771	598	0	27559
11392	138	46	25995	265	0	26444
11393	24326	51	701	269	0	25347
11394	486	26191	374	168	0	27219
11395	26498	426	287	189	0	27400
11396	573	26634	247	125	0	27579
11397	298	486	256	26840	0	27880
11398	294	153	231	27530	0	28208
11399	27293	98	248	677	0	28316
11400	618	65	255	27143	0	28081
11401	284	57	27169	599	0	28109
11402	25299	47	643	363	0	26352
11403	26183	58	345	272	0	26858
11404	717	56	293	26066	0	27132
11405	327	75	26338	604	0	27344
11406	277	87	644	25804	0	26812
11407	196	26161	333	629	0	27319
11408	238	483	260	26434	0	27415
11409	270	179	205	27096	0	27750
11410	225	158	26264	726	0	27373
11411	23337	117	600	502	0	24556
11412	587	25885	287	324	0	27083
11413	25781	478	254	317	0	26830
11414	629	26167	215	298	0	27309
11415	380	515	216	25519	0	26630
11416	283	26315	206	620	0	27424
11417	241	532	25789	358	0	26920
11418	269	309	588	24642	0	25808
11419	281	151	323	25107	0	25862
11420	240	112	260	26253	0	26865
11421	25484	100	247	886	0	26717
11422	623	119	257	25626	0	26625
11423	24699	126	234	835	0	25894
11424	24979	170	213	491	0	25853
11425	24374	143	231	460	0	25208
11426	791	161	24285	364	0	25601
11427	492	136	636	24459	0	25723
11428	357	148	368	26041	0	26914
11429	315	147	339	26583	0	27384
11430	27185	145	296	1024	0	28650
11431	843	140	283	27251	0	28517
11432	424	122	308	28271	0	29125
11433	28807	128	319	1125	0	30379
11434	948	101	322	29600	0	30971
11435	491	107	29942	1092	0	31632
11436	410	134	30201	592	0	31337
11437	415	97	1080	30534	0	32126
11438	30181	74	519	1141	0	31915
11439	29638	83	443	638	0	30802
11440	1203	76	393	29675	0	31347
11441	629	99	29501	1055	0	31284
11442	461	29013	951	581	0	31006
11443	428	744	441	29901	0	31514
11444	428	274	347	30539	0	31588
11445	392	183	328	30747	0	31650
11446	30081	132	343	1429	0	31985
11447	1033	128	30255	725	0	32141
11448	30216	114	939	700	0	31969
11449	1200	117	429	29989	0	31735
11450	627	30393	380	1092	0	32492
11451	30879	778	294	729	0	32680
11452	30630	266	311	656	0	31863
11453	1259	240	31894	483	0	33876
11454	629	29696	915	569	0	31809
11455	442	30390	416	518	0	31766
11456	30260	863	325	559	0	32007
11457	1078	315	224	30276	0	31893
11458	611	247	246	30458	0	31562
11459	513	235	256	30353	0	31357
11460	410	28552	218	1269	0	30449
11461	321	30294	214	691	0	31520
11462	29565	891	155	623	0	31234
11463	1080	329	161	29446	0	31016
11464	418	253	31250	930	0	32851
11465	470	205	954	32059	0	33688
11466	332	227	34655	1255	0	36469
11467	352	219	34744	562	0	35877
11468	361	213	34758	459	0	35791
11469	160	31012	1365	239	0	32776
11470	370	900	903	29139	0	31312
11471	139	30840	492	887	0	32358
11472	306	1072	340	27800	0	29518
11473	225	502	229	31525	0	32481
11474	30966	355	185	1424	0	32930
11475	942	257	143	31511	0	32853
11476	30914	165	136	1394	0	32609
11477	31429	159	113	787	0	32488
11478	1390	138	121	30186	0	31835
11479	692	30070	124	1184	0	32070
11480	536	877	148	29634	0	31195
11481	355	30184	156	1169	0	31864
11482	320	1044	132	30109	0	31605
11483	238	533	29933	1279	0	31983
11484	223	345	877	30245	0	31690
11485	237	281	417	31103	0	32038
11486	29353	207	314	1581	0	31455
11487	918	29728	239	899	0	31784
11488	581	905	192	29998	0	31676
11489	432	430	174	29810	0	30846
11490	319	29220	179	1483	0	31201
11491	353	998	160	29677	0	31188
11492	27013	511	160	1551	0	29235
11493	29140	417	126	898	0	30581
11494	1247	28671	113	722	0	30753
11495	689	1036	137	28882	0	30744
11496	28005	516	122	1331	0	29974
11497	1093	28547	149	826	0	30615
11498	720	1034	154	27084	0	28992
11499	495	28415	152	1174	0	30236
11500	28138	1145	158	760	0	30201
11501	1157	614	27543	540	0	29854
11502	593	475	27647	484	0	29199
11503	482	372	1212	27584	0	29650
11504	353	303	27965	1209	0	29830
11505	318	292	1253	27468	0	29331
11506	27220	250	707	1373	0	29550
11507	1054	232	27959	808	0	30053
11508	633	262	1097	28056	0	30048
11509	473	261	534	28999	0	30267
11510	28228	230	384	1651	0	30493
11511	1117	28791	285	977	0	31170
11512	29059	981	216	810	0	31066
11513	29243	519	200	679	0	30641
11514	1506	28308	193	527	0	30534
11515	951	1044	206	28596	0	30797
11516	654	620	28270	1124	0	30668
11517	571	449	919	27866	0	29805
11518	389	28005	506	1298	0	30198
11519	28716	1117	381	814	0	31028
11520	1076	599	276	29170	0	31121
11521	592	473	29364	1306	0	31735
11522	486	375	1004	29828	0	31693
11523	398	321	498	30757	0	31974
11524	415	294	383	31108	0	32200
11525	431	244	293	31124	0	32092
11526	352	259	289	30452	0	31352
11527	299	224	28728	1949	0	31200
11528	364	251	27193	1206	0	29014
11529	236	25570	1153	891	0	27850
11530	203	26638	621	658	0	28120
11531	25930	971	443	532	0	27876
11532	882	565	25845	458	0	27750
11533	23898	421	933	383	0	25635
11534	955	300	23668	342	0	25265
11535	548	256	22945	269	0	24018
11536	417	223	1019	22385	0	24044
11537	23086	200	635	806	0	24727
11538	763	184	413	23441	0	24801
11539	493	158	299	23589	0	24539
11540	303	119	25111	1200	0	26733
11541	295	113	722	25681	0	26811
11542	250	103	446	25412	0	26211
11543	253	93	312	26118	0	26776
11544	252	127	216	26010	0	26605
11545	257	100	193	26136	0	26686
11546	24738	83	175	1452	0	26448
11547	713	101	115	25166	0	26095
11548	417	111	23898	1213	0	25639
11549	350	175	590	24435	0	25550
11550	285	121	23935	1063	0	25404
11551	280	175	769	24155	0	25379
11552	206	106	24529	1016	0	25857
11553	142	161	832	22932	0	24067
11554	119	118	534	23930	0	24701
11555	125	115	23176	1153	0	24569
11556	20985	100	744	820	0	22649
11557	625	104	23309	555	0	24593
11558	429	97	790	23338	0	24654
11559	23415	50	510	884	0	24859
11560	731	62	354	23794	0	24941
11561	525	73	228	24096	0	24922
11562	343	70	23525	1105	0	25043
11563	224	22327	586	845	0	23982
11564	122	19654	278	521	0	20575
11565	83	19270	203	346	0	19902
11566	368	106	233	16123	0	16830
11567	16287	33	30	162	0	16512
11568	88	26	12	16460	0	16586
11569	43	19	15	16489	0	16566
11570	32	9	22	16649	0	16712
11571	32	11	16	16464	0	16523
11572	10	16193	23	149	0	16375
11573	24	77	16	16572	0	16689
11574	23	34	13	16503	0	16573
11575	18	16243	19	129	0	16409
11576	16507	80	13	117	0	16717
11577	79	34	12	16620	0	16745
11578	16522	26	13	141	0	16702
11579	16250	13	14	104	0	16381
11580	103	16599	19	52	0	16773
11581	60	78	14	17595	0	17747
11582	42	32	17479	109	0	17662
11583	37	34	16884	62	0	17017
11584	36	41	105	17198	0	17380
11585	17569	6	48	173	0	17796
11586	17968	15	38	106	0	18127
11587	120	16	22	18183	0	18341
11588	18247	15	19	160	0	18441
11589	103	18054	16	92	0	18265
11590	18117	78	22	96	0	18313
11591	106	19165	32	44	0	19347
11592	76	93	15	19710	0	19894
11593	73	47	15	19733	0	19868
11594	44	19762	18	116	0	19940
11595	19630	89	21	145	0	19885
11596	108	56	19403	79	0	19646
11597	79	43	91	19339	0	19552
11598	53	35	19642	110	0	19840
11599	71	20	116	19502	0	19709
11600	19894	17	56	195	0	20162
11601	132	17	34	19932	0	20115
11602	19789	21	23	203	0	20036
11603	19571	17	22	150	0	19760
11604	161	17	21	19742	0	19941
11605	84	24	19446	134	0	19688
11606	56	20132	92	92	0	20372
11607	52	85	45	19932	0	20114
11608	19540	42	29	202	0	19813
11609	112	41	19635	91	0	19879
11610	115	27	90	19574	0	19806
11611	83	26	45	19362	0	19516
11612	50	20	38	19827	0	19935
11613	19805	20	46	235	0	20106
11614	130	25	26	19450	0	19631
11615	73	17	30	19950	0	20070
11616	64	29	19465	179	0	19737
11617	90	22	109	19543	0	19764
11618	60	14	59	19869	0	20002
11619	61	16	37	20289	0	20403
11620	43	19990	38	211	0	20282
11621	62	90	24	19329	0	19505
11622	63	42	18	19434	0	19557
11623	18736	29	21	238	0	19024
11624	136	32	18769	113	0	19050
11625	77	33	17485	90	0	17685
11626	48	18661	128	103	0	18940
11627	54	108	86	19311	0	19559
11628	19257	53	60	210	0	19580
11629	142	38	28	19073	0	19281
11630	86	20	26	19408	0	19540
11631	68	15	27	19611	0	19721
11632	60	21	23	19382	0	19486
11633	50	16	22	19473	0	19561
11634	37	26	19298	201	0	19562
11635	51	20	100	19328	0	19499
11636	19292	11	45	253	0	19601
11637	106	18923	36	124	0	19189
11638	75	95	26	19172	0	19368
11639	55	47	26	19227	0	19355
11640	39	44	18034	191	0	18308
11641	56	23	115	17614	0	17808
11642	46	21	61	18908	0	19036
11643	19042	19	49	301	0	19411
11644	159	19647	30	153	0	19989
11645	88	159	21	20043	0	20311
11646	82	65	21	20307	0	20475
11647	63	41	24	20327	0	20455
11648	47	39	20552	311	0	20949
11649	42	42	19276	179	0	19539
11650	41	19826	241	148	0	20256
11651	38	20644	105	102	0	20889
11652	49	221	57	20575	0	20902
11653	48	18280	79	249	0	18656
11654	58	283	33	22491	0	22865
11655	52	124	27	25091	0	25294
11656	64	61	28	26336	0	26489
11657	58	39	18	28886	0	29001
11658	28	47	28513	916	0	29504
11659	89	34	483	28737	0	29343
11660	51	35	281	29276	0	29643
11661	47	23	196	30036	0	30302
11662	28706	32	118	1268	0	30124
11663	508	29386	161	759	0	30814
11664	376	544	101	27945	0	28966
11665	215	29611	101	822	0	30749
11666	28590	739	65	690	0	30084
11667	25507	438	57	626	0	26628
11668	745	29342	45	409	0	30541
11669	455	30588	66	343	0	31452
11670	281	1065	29476	295	0	31117
11671	243	30960	566	277	0	32046
11672	289	965	328	29983	0	31565
11673	30491	607	226	856	0	32180
11674	694	31455	116	545	0	32810
11675	425	919	163	31904	0	33411
11676	337	649	127	32369	0	33482
11677	273	441	127	33165	0	34006
11678	32084	310	75	1451	0	33920
11679	800	344	31763	881	0	33788
11680	30563	282	662	688	0	32195
11681	936	31294	381	509	0	33120
11682	521	871	253	31768	0	33413
11683	463	505	31307	993	0	33268
11684	29724	387	779	715	0	31605
11685	934	31340	418	459	0	33151
11686	584	940	310	30557	0	32391
11687	398	31570	218	907	0	33093
11688	337	1045	221	31811	0	33414
11689	358	565	183	32713	0	33819
11690	272	496	31633	1270	0	33671
11691	253	373	30204	874	0	31704
11692	268	369	996	30945	0	32578
11693	161	300	31425	1200	0	33086
11694	196	224	984	31424	0	32828
11695	316	200	622	30450	0	31588
11696	193	205	515	32466	0	33379
11697	31307	147	380	1656	0	33490
11698	809	207	387	32126	0	33529
11699	462	200	31461	1456	0	33579
11700	31278	172	857	1076	0	33383
11701	866	170	548	32453	0	34037
11702	619	184	395	32920	0	34118
11703	31948	170	270	1597	0	33985
11704	861	32888	353	1037	0	35139
11705	641	733	291	33958	0	35623
11706	456	460	244	33936	0	35096
11707	32937	332	263	1696	0	35228
11708	948	245	33073	1133	0	35399
11709	603	266	796	33143	0	34808
11710	482	225	560	33490	0	34757
11711	406	232	344	32929	0	33911
11712	335	32444	293	1680	0	34752
11713	318	736	322	33478	0	34854
11714	32355	481	228	1575	0	34639
11715	857	32400	265	1163	0	34685
11716	32145	827	252	1005	0	34229
11717	1027	32795	176	791	0	34789
11718	32819	1027	200	824	0	34870
11719	1179	635	32074	681	0	34569
11720	748	539	31540	688	0	33515
11721	31937	397	1019	649	0	34002
11722	1077	414	33297	566	0	35354
11723	797	353	994	33096	0	35240
11724	772	316	731	28504	0	30323
11725	511	235	589	34305	0	35640
11726	33507	258	462	1601	0	35828
11727	967	249	32945	1115	0	35276
11728	32944	224	918	965	0	35051
11729	1177	275	581	35954	0	37987
11730	35821	237	461	1529	0	38048
11731	1402	235	316	36339	0	38292
11732	37288	237	351	1553	0	39429
11733	1590	233	320	39970	0	42113
11734	860	297	40455	1626	0	43238
11735	40838	204	1086	1111	0	43239
11736	42734	179	658	946	0	44517
11737	1880	213	492	42437	0	45022
11738	1222	188	389	41794	0	43593
11739	785	42298	459	1731	0	45273
11740	41673	984	352	1240	0	44249
11741	1434	42101	345	918	0	44798
11742	40891	1144	285	872	0	43192
11743	1641	544	41063	747	0	43995
11744	898	479	40698	691	0	42766
11745	814	269	39418	629	0	41130
11746	39412	314	1527	649	0	41902
11747	1507	40552	824	513	0	43396
11748	1001	993	579	40114	0	42687
11749	40073	546	503	1282	0	42404
11750	1360	40662	448	874	0	43344
11751	992	1376	416	38901	0	41685
11752	705	39358	365	1247	0	41675
11753	607	38276	322	814	0	40019
11754	591	38690	227	615	0	40123
11755	34946	1187	343	526	0	37002
11756	910	34761	191	372	0	36234
11757	454	31553	153	240	0	32400
11758	291	32429	170	230	0	33120
11759	31884	793	265	243	0	33185
11760	32075	345	196	226	0	32842
11761	884	263	31084	168	0	32399
11762	30291	160	594	211	0	31256
11763	31544	145	245	219	0	32153
11764	853	206	151	31032	0	32242
11765	31576	175	77	691	0	32519
11766	749	191	30879	305	0	32124
11767	366	32651	521	223	0	33761
11768	32856	644	250	206	0	33956
11769	767	360	163	33306	0	34596
11770	33385	200	85	680	0	34350
11771	769	226	31744	277	0	33016
11772	32436	183	483	217	0	33319
11773	810	193	216	33172	0	34391
11774	412	159	33059	579	0	34209
11775	263	31462	579	273	0	32577
11776	213	33346	270	177	0	34006
11777	378	734	166	32575	0	33853
11778	290	292	118	32105	0	32805
11779	191	33067	81	667	0	34006
11780	33262	577	95	320	0	34254
11781	33181	261	76	215	0	33733
11782	32995	180	62	166	0	33403
11783	841	33318	86	142	0	34387
11784	468	599	59	31452	0	32578
11785	246	33425	82	524	0	34277
11786	33390	643	91	278	0	34402
11787	33230	246	39	252	0	33767
11788	804	32727	104	140	0	33775
11789	33287	590	96	146	0	34119
11790	797	291	58	33053	0	34199
11791	391	216	80	33475	0	34162
11792	33673	144	92	870	0	34779
11793	32973	157	79	390	0	33599
11794	33549	164	61	238	0	34012
11795	988	124	53	33028	0	34193
11796	492	128	73	33673	0	34366
11797	323	165	33083	805	0	34376
11798	338	176	553	32709	0	33776
11799	312	162	222	33080	0	33776
11800	282	219	32341	789	0	33631
11801	290	147	30662	390	0	31489
11802	205	187	32673	238	0	33303
11803	259	164	810	32353	0	33586
11804	300	163	31889	652	0	33004
11805	277	179	632	31512	0	32600
11806	269	168	249	32348	0	33034
11807	269	174	31834	849	0	33126
11808	235	183	31482	421	0	32321
11809	302	167	762	31100	0	32331
11810	225	175	33466	750	0	34616
11811	276	184	32997	354	0	33811
11812	218	33199	800	264	0	34481
11813	34145	651	359	321	0	35476
11814	34422	277	237	284	0	35220
11815	34563	227	209	278	0	35277
11816	908	33688	211	231	0	35038
11817	466	34800	198	219	0	35683
11818	357	785	187	34882	0	36211
11819	322	315	237	34929	0	35803
11820	257	209	34417	923	0	35806
11821	313	153	688	34231	0	35385
11822	34443	132	323	879	0	35777
11823	792	144	211	32804	0	33951
11824	382	34160	205	740	0	35487
11825	35054	653	234	379	0	36320
11826	35419	283	194	333	0	36229
11827	35821	223	168	286	0	36498
11828	1060	145	34834	236	0	36275
11829	488	238	546	34390	0	35662
11830	35469	119	285	891	0	36764
11831	870	109	36790	352	0	38121
11832	366	34950	751	292	0	36359
11833	253	33740	234	192	0	34419
11834	31786	705	257	203	0	32951
11835	641	31752	137	151	0	32681
11836	333	633	113	31047	0	32126
11837	220	188	31372	642	0	32422
11838	216	130	579	31126	0	32051
11839	31287	99	187	702	0	32275
11840	603	30980	136	253	0	31972
11841	30781	582	109	220	0	31692
11842	663	188	30531	195	0	31577
11843	308	176	605	29395	0	30484
11844	142	31537	229	560	0	32468
11845	197	567	148	32130	0	33042
11846	32314	176	141	731	0	33362
11847	32610	138	102	314	0	33164
11848	32672	102	118	219	0	33111
11849	32880	102	104	208	0	33294
11850	810	95	99	31676	0	32680
11851	296	122	32219	649	0	33286
11852	299	120	590	31007	0	32016
11853	176	32038	196	636	0	33046
11854	32420	533	160	302	0	33415
11855	653	171	32235	166	0	33225
11856	31205	124	567	201	0	32097
11857	692	119	190	32033	0	33034
11858	265	95	32734	624	0	33718
11859	257	89	575	32546	0	33467
11860	33010	72	184	772	0	34038
11861	33205	64	153	317	0	33739
11862	33076	75	125	277	0	33553
11863	788	108	32625	158	0	33679
11864	403	135	552	32496	0	33586
11865	253	88	33529	601	0	34471
11866	217	33162	606	217	0	34202
11867	31827	538	236	249	0	32850
11868	581	31159	159	163	0	32062
11869	30720	463	133	189	0	31505
11870	616	149	102	29995	0	30862
11871	211	30405	100	430	0	31146
11872	30584	456	93	223	0	31356
11873	587	149	30705	103	0	31544
11874	252	110	438	30250	0	31050
11875	30544	95	142	560	0	31341
11876	548	85	30455	195	0	31283
11877	280	84	463	29391	0	30218
11878	206	27816	186	439	0	28647
11879	191	479	118	30624	0	31412
11880	201	177	91	30938	0	31407
11881	30327	125	75	635	0	31162
11882	521	30387	104	228	0	31240
11883	222	459	85	29737	0	30503
11884	178	30247	119	468	0	31012
11885	220	487	83	30225	0	31015
11886	178	30797	110	498	0	31583
11887	30582	513	78	268	0	31441
11888	596	194	31243	174	0	32207
11889	271	131	488	30829	0	31719
11890	202	120	162	31182	0	31666
11891	196	130	120	31366	0	31812
11892	230	107	81	30946	0	31364
11893	207	127	30397	648	0	31379
11894	215	30578	477	264	0	31534
11895	30549	484	161	295	0	31489
11896	31035	140	114	268	0	31557
11897	534	30645	101	222	0	31502
11898	30821	475	101	276	0	31673
11899	30854	187	94	250	0	31385
11900	618	31299	102	147	0	32166
11901	333	515	91	30810	0	31749
11902	241	31743	97	426	0	32507
11903	31405	538	81	271	0	32295
11904	573	182	31295	193	0	32243
11905	28866	109	494	306	0	29775
11906	589	127	31663	167	0	32546
11907	314	120	483	31397	0	32314
11908	31641	104	148	603	0	32496
11909	615	112	31244	202	0	32173
11910	28613	92	496	269	0	29470
11911	29992	96	168	223	0	30479
11912	670	97	145	29458	0	30370
11913	260	29639	140	474	0	30513
11914	30099	482	72	266	0	30919
11915	622	208	78	29845	0	30753
11916	274	28870	102	535	0	29781
11917	29329	470	96	265	0	30160
11918	598	190	94	29417	0	30299
11919	237	30541	106	513	0	31397
11920	219	499	110	31455	0	32283
11921	31903	160	87	649	0	32799
11922	31662	128	91	332	0	32213
11923	32066	107	113	270	0	32556
11924	696	98	96	31213	0	32103
11925	307	129	79	31372	0	31887
11926	182	128	31621	622	0	32553
11927	322	192	444	31647	0	32605
11928	205	110	32886	601	0	33802
11929	175	68	29742	240	0	30225
11930	85	63	29054	111	0	29313
11931	67	30311	422	97	0	30897
11932	181	320	279	28833	0	29613
11933	56	32608	124	299	0	33087
11934	33091	452	75	223	0	33841
11935	33407	176	71	186	0	33840
11936	634	87	73	34548	0	35342
11937	241	69	35389	532	0	36231
11938	181	75	580	35166	0	36002
11939	85	75	36292	684	0	37136
11940	199	76	628	34997	0	35900
11941	119	35282	220	626	0	36247
11942	103	37055	132	241	0	37531
11943	36339	714	96	247	0	37396
11944	674	262	35886	113	0	36935
11945	325	134	644	35205	0	36308
11946	200	92	238	36127	0	36657
11947	35983	76	154	903	0	37116
11948	663	36139	113	356	0	37271
11949	36176	662	112	297	0	37247
11950	693	36825	104	200	0	37822
11951	36136	700	134	257	0	37227
11952	36899	269	122	242	0	37532
11953	956	143	122	36902	0	38123
11954	378	136	36782	745	0	38041
11955	35104	149	674	423	0	36350
11956	782	37141	255	197	0	38375
11957	37694	750	136	234	0	38814
11958	923	284	130	36307	0	37644
11959	460	179	102	36480	0	37221
11960	269	36130	112	932	0	37443
11961	298	715	128	35710	0	36851
11962	242	36625	127	779	0	37773
11963	286	768	119	36319	0	37492
11964	298	333	95	36207	0	36933
11965	34915	214	91	1010	0	36230
11966	879	183	34699	417	0	36178
11967	388	34460	647	311	0	35806
11968	332	692	284	35089	0	36397
11969	35448	293	188	902	0	36831
11970	36150	205	141	504	0	37000
11971	35693	171	142	393	0	36399
11972	1068	184	34986	305	0	36543
11973	35147	187	757	310	0	36401
11974	1022	221	286	35656	0	37185
11975	35383	180	159	1012	0	36734
11976	976	34844	149	455	0	36424
11977	494	787	124	35414	0	36819
11978	34858	313	136	1047	0	36354
11979	986	35594	148	460	0	37188
11980	528	899	162	35966	0	37555
11981	366	417	33958	1018	0	35759
11982	35189	251	725	557	0	36722
11983	37482	190	245	459	0	38376
11984	1399	222	36624	290	0	38535
11985	636	35213	908	319	0	37076
11986	453	37176	396	293	0	38318
11987	481	1126	265	37179	0	39051
11988	512	454	210	35177	0	36353
11989	408	313	166	37568	0	38455
11990	330	302	37424	1401	0	39457
11991	36990	258	1003	775	0	39026
11992	40088	246	390	523	0	41247
11993	41043	284	250	493	0	42070
11994	41449	239	225	475	0	42388
11995	41814	254	216	478	0	42762
11996	42499	218	243	416	0	43376
11997	1890	235	241	43269	0	45635
11998	885	242	42201	1423	0	44751
11999	625	312	43554	649	0	45140
12000	645	285	1410	43230	0	45570
12001	610	276	549	42987	0	44422
12002	639	211	318	43165	0	44333
12003	515	43068	303	1794	0	45680
12004	43818	1302	248	929	0	46297
12005	1646	44994	262	624	0	47526
12006	959	1424	235	44642	0	47260
12007	44270	554	240	1697	0	46761
12008	1747	44247	240	759	0	46993
12009	952	1518	206	44814	0	47490
12010	777	612	174	46242	0	47805
12011	658	444	199	46767	0	48068
12012	512	46001	236	2181	0	48930
12013	618	1544	248	47536	0	49946
12014	560	597	46864	2133	0	50154
12015	584	482	1511	47861	0	50438
12016	606	417	504	49251	0	50778
12017	626	411	303	52386	0	53726
12018	661	419	220	53469	0	54769
12019	566	400	50075	2907	0	53948
12020	497	49973	1734	1625	0	53829
12021	642	1832	711	50896	0	54081
12022	587	800	519	53182	0	55088
12023	593	581	445	52067	0	53686
12024	510	48232	375	3240	0	52357
12025	418	52243	317	1966	0	54944
12026	50311	2340	293	1545	0	54489
12027	2097	1084	218	49734	0	53133
12028	823	758	48027	2683	0	52291
12029	641	48337	1730	1547	0	52255
12030	47230	1963	720	1406	0	51319
12031	1983	850	46258	1194	0	50285
12032	887	702	45684	1035	0	48308
12033	641	571	45535	890	0	47637
12034	672	895	2408	43916	0	47891
12035	468	468	44610	2220	0	47766
12036	356	42112	2165	1396	0	46029
12037	415	1613	1129	41552	0	44709
12038	311	811	42175	2141	0	45438
12039	381	775	1971	41510	0	44637
12040	40583	567	962	2490	0	44602
12041	1595	484	40806	1524	0	44409
12042	39329	457	1914	1337	0	43037
12043	1879	41488	996	1026	0	45389
12044	42098	1799	841	875	0	45613
12045	2237	807	793	41886	0	45723
12046	42287	631	766	2151	0	45835
12047	42795	547	828	1236	0	45406
12048	41720	586	709	1135	0	44150
12049	2532	41755	634	937	0	45858
12050	42339	1608	779	878	0	45604
12051	42975	740	728	899	0	45342
12052	2535	623	41224	850	0	45232
12053	1469	41048	1798	880	0	45195
12054	1339	1765	1031	40995	0	45130
12055	1167	979	845	42386	0	45377
12056	1011	775	689	42953	0	45428
12057	857	639	41149	2700	0	45345
12058	887	567	1811	41972	0	45237
12059	940	544	41411	2656	0	45551
12060	40877	477	2057	1635	0	45046
12061	42861	474	1099	1410	0	45844
12062	2568	582	41713	1160	0	46023
12063	41875	573	1921	1086	0	45455
12064	43572	473	1027	1093	0	46165
12065	44201	433	905	944	0	46483
12066	3193	438	857	41941	0	46429
12067	1995	503	41852	2058	0	46408
12068	1525	42062	1808	1299	0	46694
12069	1465	1643	1037	42376	0	46521
12070	1242	869	42637	2227	0	46975
12071	987	694	40559	1409	0	43649
12072	39883	706	2183	1328	0	44100
12073	1857	42044	1338	1374	0	46613
12074	42821	1542	1162	1251	0	46776
12075	43346	833	988	1181	0	46348
12076	2480	42435	1068	979	0	46962
12077	43000	1701	886	937	0	46524
12078	2594	894	42954	878	0	47320
12079	1847	710	41600	791	0	44948
12080	1649	611	42111	771	0	45142
12081	1403	41354	2308	673	0	45738
12082	41510	1474	1491	671	0	45146
12083	41760	790	1149	722	0	44421
12084	2412	39375	1035	708	0	43530
12085	1549	41099	857	755	0	44260
12086	1417	1799	906	40215	0	44337
12087	1179	1250	733	41148	0	44310
12088	40773	993	651	1991	0	44408
12089	2000	40722	754	1157	0	44633
12090	40533	1595	736	983	0	43847
12091	39988	955	665	814	0	42422
12092	2292	932	38035	643	0	41902
12093	1683	37448	1401	602	0	41134
12094	1720	1487	920	36797	0	40924
12095	36750	917	733	1281	0	39681
12096	2073	673	752	35531	0	39029
12097	34739	566	741	1288	0	37334
12098	1748	555	33380	786	0	36469
12099	1267	31830	1268	739	0	35104
12100	1112	33641	740	682	0	36175
12101	1191	1460	731	31185	0	34567
12102	1123	33485	590	973	0	36171
12103	33544	1464	530	717	0	36255
12104	1399	1037	32443	627	0	35506
12105	31132	757	996	771	0	33656
12106	1485	663	32547	667	0	35362
12107	1256	581	1063	32259	0	35159
12108	1133	589	691	32629	0	35042
12109	1216	482	635	32942	0	35275
12110	32631	377	590	1393	0	34991
12111	1404	392	31928	902	0	34626
12112	949	401	841	30994	0	33185
12113	880	351	565	30710	0	32506
12114	882	29222	458	1221	0	31783
12115	747	28926	377	919	0	30969
12116	758	29440	388	701	0	31287
12117	452	772	256	26820	0	28300
12118	297	341	153	25658	0	26449
12119	158	24539	91	382	0	25170
12120	156	24917	88	238	0	25399
12121	24701	235	136	227	0	25299
12122	265	158	101	24590	0	25114
12123	126	24172	51	165	0	24514
12124	24598	146	67	125	0	24936
12125	215	71	54	24972	0	25312
12126	27014	31	53	252	0	27350
12127	321	51	50	27429	0	27851
12128	131	49	27870	283	0	28333
12129	101	27903	223	142	0	28369
12130	27349	242	95	174	0	27860
12131	273	107	28224	64	0	28668
12132	103	28014	227	56	0	28400
12133	77	167	67	28401	0	28712
12134	50	64	30	28704	0	28848
12135	73	35	22	27897	0	28027
12136	87	25	21	27236	0	27369
12137	29	24	28148	269	0	28470
12138	30	27621	184	122	0	27957
12139	49	184	62	27888	0	28183
12140	27524	58	40	272	0	27894
12141	200	27660	23	98	0	27981
12142	102	197	19	29540	0	29858
12143	87	76	28616	311	0	29090
12144	28	28532	302	135	0	28997
12145	158	323	106	26417	0	27004
12146	40	29603	91	210	0	29944
12147	29627	409	27	183	0	30246
12148	29680	139	25	168	0	30012
12149	505	92	28486	80	0	29163
12150	28234	62	351	140	0	28787
12151	29258	52	109	150	0	29569
12152	557	55	28151	47	0	28810
12153	208	28432	367	55	0	29062
12154	209	382	122	28029	0	28742
12155	132	134	96	29623	0	29985
12156	29336	90	58	596	0	30080
12157	488	54	43	29320	0	29905
12158	191	70	29195	502	0	29958
12159	27546	65	416	291	0	28318
12160	489	66	28540	152	0	29247
12161	199	28636	468	101	0	29404
12162	27950	425	161	149	0	28685
12163	519	173	28272	82	0	29046
12164	243	128	26791	77	0	27239
12165	174	27937	497	61	0	28669
12166	148	443	216	28366	0	29173
12167	104	195	27726	453	0	28478
12168	228	146	475	23942	0	24791
12169	147	56	198	27214	0	27615
12170	98	81	26330	606	0	27115
12171	102	25967	488	272	0	26829
12172	123	417	203	26409	0	27152
12173	26014	161	154	553	0	26882
12174	25971	124	120	280	0	26495
12175	620	84	113	26126	0	26943
12176	262	83	25612	531	0	26488
12177	174	101	26388	219	0	26882
12178	136	89	600	26225	0	27050
12179	114	93	25919	550	0	26676
12180	25129	73	583	277	0	26062
12181	582	54	253	25979	0	26868
12182	266	83	196	26118	0	26663
12183	175	26109	146	648	0	27078
12184	162	489	155	26694	0	27500
12185	114	202	25993	654	0	26963
12186	24414	139	560	341	0	25454
12187	25901	82	236	290	0	26509
12188	699	86	26027	195	0	27007
12189	328	78	582	28179	0	29167
12190	235	69	239	29298	0	29841
12191	161	64	29007	1037	0	30269
12192	177	64	827	29490	0	30558
12193	255	60	368	28506	0	29189
12194	156	29945	245	1071	0	31417
12195	186	830	158	30775	0	31949
12196	173	263	146	31805	0	32387
12197	31481	168	157	1328	0	33134
12198	32595	107	169	635	0	33506
12199	33307	76	166	460	0	34009
12200	33160	92	183	370	0	33805
12201	32981	93	145	387	0	33606
12202	1428	97	31250	326	0	33101
12203	654	103	1004	31124	0	32885
12204	477	79	353	32304	0	33213
12205	316	98	31538	1387	0	33339
12206	29953	99	995	720	0	31767
12207	31437	101	398	524	0	32460
12208	1420	130	27803	367	0	29720
12209	30667	83	826	414	0	31990
12210	31907	71	368	398	0	32744
12211	1531	108	30622	326	0	32587
12212	873	98	1067	29448	0	31486
12213	606	30408	482	1044	0	32540
12214	539	943	347	33024	0	34853
12215	542	325	229	33810	0	34906
12216	490	198	247	33635	0	34570
12217	393	113	32565	1564	0	34635
12218	31682	104	1124	792	0	33702
12219	33386	74	522	527	0	34509
12220	1598	83	353	32554	0	34588
12221	790	85	31833	1287	0	33995
12222	593	107	1196	31729	0	33625
12223	445	55	32626	1409	0	34535
12224	405	87	32620	640	0	33752
12225	335	32620	1424	523	0	34902
12226	478	864	571	31011	0	32924
12227	30797	300	358	1275	0	32730
12228	30154	178	336	670	0	31338
12229	31328	109	259	546	0	32242
12230	1574	115	253	30093	0	32035
12231	687	31904	274	1218	0	34083
12232	575	1048	236	33002	0	34861
12233	401	340	33865	1493	0	36099
12234	35650	216	1292	763	0	37921
12235	38939	118	524	585	0	40166
12236	1922	115	364	38267	0	40668
12237	920	149	301	39347	0	40717
12238	758	112	280	40012	0	41162
12239	515	128	38051	2172	0	40866
12240	34839	98	1471	1102	0	37510
12241	1724	36417	625	735	0	39501
12242	671	36683	386	534	0	38274
12243	546	1308	36605	505	0	38964
12244	567	500	1310	35975	0	38352
12245	388	328	36623	1529	0	38868
12246	35000	222	1388	747	0	37357
12247	1567	188	571	35409	0	37735
12248	750	195	35108	1451	0	37504
12249	624	36375	1286	766	0	39051
12250	36564	1128	543	699	0	38934
12251	1552	374	37490	540	0	39956
12252	725	35813	1423	501	0	38462
12253	517	38163	596	534	0	39810
12254	38019	1471	535	475	0	40500
12255	1519	635	409	37942	0	40505
12256	671	459	38991	1469	0	41590
12257	568	38865	1500	718	0	41651
12258	39066	1386	605	623	0	41680
12259	39947	523	516	537	0	41523
12260	1785	39033	497	402	0	41717
12261	817	1433	39611	512	0	42373
12262	682	582	1538	39733	0	42535
12263	40027	485	628	1579	0	42719
12264	40859	375	554	736	0	42524
12265	1966	352	40076	512	0	42906
12266	1105	421	1451	39321	0	42298
12267	812	327	662	41160	0	42961
12268	629	370	40877	1807	0	43683
12269	606	391	40424	873	0	42294
12270	40805	320	1830	687	0	43642
12271	42415	364	814	623	0	44216
12272	42756	341	669	563	0	44329
12273	43027	305	565	572	0	44469
12274	2220	353	40672	518	0	43763
12275	41390	232	1512	607	0	43741
12276	2230	254	712	40802	0	43998
12277	1195	268	41320	1609	0	44392
12278	953	254	41174	897	0	43278
12279	742	41023	1813	821	0	44399
12280	718	1329	943	40643	0	43633
12281	691	553	41440	1563	0	44247
12282	40036	387	1772	811	0	43006
12283	1822	381	926	36833	0	39962
12284	1002	41002	781	1265	0	44050
12285	41750	1274	701	845	0	44570
12286	42422	478	683	749	0	44332
12287	2159	361	41507	572	0	44599
12288	1152	40771	1638	525	0	44086
12289	961	1039	675	38893	0	41568
12290	39037	492	566	1264	0	41359
12291	1586	483	540	38421	0	41030
12292	841	341	37591	1252	0	40025
12293	34286	355	1189	750	0	36580
12294	1337	36127	659	539	0	38662
12295	747	34408	559	506	0	36220
12296	665	37793	488	473	0	39419
12297	37114	1147	676	561	0	39498
12298	36957	587	492	410	0	38446
12299	37315	436	409	314	0	38474
12300	1577	364	349	36239	0	38529
12301	893	343	36368	1007	0	38611
12302	803	310	1030	36617	0	38760
12303	37105	276	502	1236	0	39119
12304	1358	223	474	37264	0	39319
12305	37923	245	437	1266	0	39871
12306	37835	211	444	710	0	39200
12307	37083	253	454	583	0	38373
12308	1348	37186	396	508	0	39438
12309	37478	922	389	398	0	39187
12310	1485	435	36539	313	0	38772
12311	957	342	36806	275	0	38380
12312	853	36359	1049	284	0	38545
12313	896	871	555	35117	0	37439
12314	35144	346	397	968	0	36855
12315	1223	306	34495	439	0	36463
12316	34009	212	991	490	0	35702
12317	1297	202	498	33697	0	35694
12318	689	34239	480	977	0	36385
12319	675	786	404	35157	0	37022
12320	644	390	34863	967	0	36864
12321	33254	312	885	640	0	35091
12322	1206	321	35403	424	0	37354
12323	766	241	33999	317	0	35323
12324	33139	229	1002	358	0	34728
12325	1105	33634	557	287	0	35583
12326	34661	825	402	333	0	36221
12327	35028	359	398	366	0	36151
12328	1366	265	33758	285	0	35674
12329	32404	233	896	341	0	33874
12330	1159	232	32485	331	0	34207
12331	634	153	30103	314	0	31204
12332	557	156	30511	290	0	31514
12333	406	29036	778	249	0	30469
12334	26287	506	895	250	0	27938
12335	25694	149	236	187	0	26266
12336	25543	73	125	148	0	25889
12337	25374	62	131	146	0	25713
12338	513	65	25129	71	0	25778
12339	316	83	356	24749	0	25504
12340	248	74	170	24925	0	25417
12341	25359	56	127	453	0	25995
12342	420	25108	148	151	0	25827
12343	248	280	98	24857	0	25483
12344	24796	129	118	375	0	25418
12345	408	87	25081	127	0	25703
12346	302	81	332	24931	0	25646
12347	160	87	25752	333	0	26332
12348	189	25389	361	153	0	26092
12349	199	323	178	24004	0	24704
12350	23920	103	110	354	0	24487
12351	416	63	83	24258	0	24820
12352	187	90	24191	328	0	24796
12353	125	24188	317	159	0	24789
12354	23636	289	129	161	0	24215
12355	386	98	23790	84	0	24358
12356	22339	50	294	150	0	22833
12357	336	23521	143	116	0	24116
12358	23988	310	135	128	0	24561
12359	24294	127	68	118	0	24607
12360	513	63	69	24751	0	25396
12361	208	63	24700	371	0	25342
12362	123	24965	404	145	0	25637
12363	173	371	141	26339	0	27024
12364	184	139	101	26953	0	27377
12365	214	67	85	28709	0	29075
12366	212	60	85	29634	0	29991
12367	111	31939	87	795	0	32932
12368	32293	692	88	343	0	33416
12369	789	32560	92	171	0	33612
12370	395	763	84	33363	0	34605
12371	33890	261	86	926	0	35163
12372	968	157	60	33980	0	35165
12373	379	144	33691	983	0	35197
12374	231	33850	783	416	0	35280
12375	306	795	276	33831	0	35208
12376	243	348	138	35103	0	35832
12377	33339	192	103	1201	0	34835
12378	926	171	33043	484	0	34624
12379	32640	130	815	476	0	34061
12380	33424	130	306	377	0	34237
12381	33532	178	160	340	0	34210
12382	1258	171	32888	282	0	34599
12383	677	205	850	32358	0	34090
12384	474	191	333	33385	0	34383
12385	309	165	33678	1229	0	35381
12386	324	160	33835	614	0	34933
12387	34238	140	1171	464	0	36013
12388	1200	178	473	35007	0	36858
12389	35623	144	312	1236	0	37315
12390	36791	135	217	697	0	37840
12391	1537	140	189	36305	0	38171
12392	723	146	37772	1246	0	39887
12393	37115	132	1143	721	0	39111
12394	1490	132	445	38308	0	40375
12395	742	134	38354	1371	0	40601
12396	600	37763	1177	662	0	40202
12397	37984	1096	501	626	0	40207
12398	1380	38702	358	480	0	40920
12399	952	1237	335	34839	0	37363
12400	607	39299	339	1198	0	41443
12401	38359	1208	356	792	0	40715
12402	39193	460	386	684	0	40723
12403	1649	38546	385	609	0	41189
12404	38891	1192	349	579	0	41011
12405	38805	512	310	661	0	40288
12406	1746	37696	372	624	0	40438
12407	38465	1206	330	571	0	40572
12408	1899	451	339	37693	0	40382
12409	1096	351	398	38654	0	40499
12410	38259	347	376	1612	0	40594
12411	1925	271	320	35538	0	38054
12412	1018	37277	370	1359	0	40024
12413	37471	1241	363	810	0	39885
12414	37684	582	299	683	0	39248
12415	1730	37486	356	646	0	40218
12416	37979	1272	391	587	0	40229
12417	38724	596	341	538	0	40199
12418	2066	451	270	37363	0	40150
12419	1243	399	36984	1439	0	40065
12420	1107	37015	1135	807	0	40064
12421	37962	1343	442	691	0	40438
12422	38377	620	333	670	0	40000
12423	2042	492	36676	621	0	39831
12424	37028	429	1150	642	0	39249
12425	1923	414	35689	593	0	38619
12426	36451	471	1244	580	0	38746
12427	1940	576	482	36279	0	39277
12428	1207	525	36039	1380	0	39151
12429	999	572	36831	706	0	39108
12430	1003	650	1383	35989	0	39025
12431	1075	516	557	36794	0	38942
12432	1042	472	35406	1576	0	38496
12433	1076	471	1243	35446	0	38236
12434	1042	476	36002	1501	0	39021
12435	1108	441	1367	35849	0	38765
12436	1084	488	629	35626	0	37827
12437	1039	34465	489	1600	0	37593
12438	1010	34978	458	948	0	37394
12439	862	36981	484	875	0	39202
12440	1018	1455	462	36333	0	39268
12441	970	642	454	37406	0	39472
12442	843	473	36152	1882	0	39350
12443	34525	451	1396	1056	0	37428
12444	36928	430	665	841	0	38864
12445	1958	35717	540	741	0	38956
12446	36219	1306	517	673	0	38715
12447	1935	581	500	35589	0	38605
12448	36170	461	525	1618	0	38774
12449	36849	387	569	969	0	38774
12450	2016	433	508	35718	0	38675
12451	34578	453	458	1585	0	37074
12452	1722	33623	507	829	0	36681
12453	1061	34865	483	650	0	37059
12454	1023	1433	474	33213	0	36143
12455	912	34945	470	1323	0	37650
12456	933	1304	471	34320	0	37028
12457	945	597	416	35289	0	37247
12458	34091	418	437	1654	0	36600
12459	1518	33489	486	951	0	36444
12460	32799	1088	426	781	0	35094
12461	32253	533	387	800	0	33973
12462	1558	31858	421	717	0	34554
12463	31154	1045	340	720	0	33259
12464	1455	492	29882	711	0	32540
12465	720	28332	813	591	0	30456
12466	27089	756	386	569	0	28800
12467	899	362	25805	361	0	27427
12468	459	24098	555	348	0	25460
12469	431	25089	335	297	0	26152
12470	24021	620	388	259	0	25288
12471	23843	306	150	239	0	24538
12472	23872	249	107	194	0	24422
12473	754	23532	131	202	0	24619
12474	452	480	121	23777	0	24830
12475	23859	232	147	582	0	24820
12476	23946	217	153	299	0	24615
12477	773	195	116	23482	0	24566
12478	424	173	23815	507	0	24919
12479	346	216	23488	235	0	24285
12480	327	175	548	23816	0	24866
12481	338	134	267	24216	0	24955
12482	310	119	24238	594	0	25261
12483	326	114	473	23242	0	24155
12484	261	23557	273	520	0	24611
12485	22988	397	210	289	0	23884
12486	540	223	158	22649	0	23570
12487	21784	102	128	476	0	22490
12488	418	21609	142	300	0	22469
12489	215	21996	167	225	0	22603
12490	21529	304	121	257	0	22211
12491	348	120	21136	178	0	21782
12492	18432	120	280	155	0	18987
12493	233	19219	144	104	0	19700
12494	114	140	56	18731	0	19041
12495	18522	65	47	213	0	18847
12496	193	36	33	18392	0	18654
12497	18529	26	34	239	0	18828
12498	18143	30	48	108	0	18329
12499	188	18770	28	76	0	19062
12500	18408	110	17	97	0	18632
12501	132	18230	34	35	0	18431
12502	18417	117	17	69	0	18620
12503	158	56	17	18457	0	18688
12504	18814	30	17	145	0	19006
12505	137	27	14	19193	0	19371
12506	19994	32	18	179	0	20223
12507	20440	36	11	111	0	20598
12508	20688	35	5	99	0	20827
12509	20771	18	3	71	0	20863
12510	20820	24	11	69	0	20924
12511	193	19	9	21092	0	21313
12512	20510	22	4	166	0	20702
12513	142	20112	19	51	0	20324
12514	78	115	20057	29	0	20279
12515	106	59	95	20056	0	20316
12516	45	30	20769	125	0	20969
12517	88	16	114	21211	0	21429
12518	46	23	21583	174	0	21826
12519	20903	18	137	111	0	21169
12520	200	8	52	21664	0	21924
12521	74	23	21393	152	0	21642
12522	58	22	21545	61	0	21686
12523	75	39	186	22000	0	22300
12524	24210	20	93	215	0	24538
12525	225	25301	36	106	0	25668
12526	25659	226	23	122	0	26030
12527	25756	87	22	80	0	25945
12528	329	25687	23	46	0	26085
12529	26730	241	19	135	0	27125
12530	331	95	14	26851	0	27291
12531	165	37	10	27012	0	27224
12532	106	39	16	27304	0	27465
12533	27165	17	14	393	0	27589
12534	262	27425	17	157	0	27861
12535	161	282	14	27818	0	28275
12536	99	111	22	28263	0	28495
12537	28023	46	17	480	0	28566
12538	354	49	21	27944	0	28368
12539	155	42	28114	371	0	28682
12540	99	28722	335	168	0	29324
12541	29137	388	98	127	0	29750
12542	478	145	53	28520	0	29196
12543	161	29447	48	385	0	30041
12544	29360	396	27	214	0	29997
12545	478	177	29107	120	0	29882
12546	197	29209	384	98	0	29888
12547	29595	462	125	130	0	30312
12548	509	181	69	29270	0	30029
12549	253	96	50	29480	0	29879
12550	137	98	29206	536	0	29977
12551	185	66	383	28769	0	29403
12552	102	55	31086	523	0	31766
12553	99	67	29054	268	0	29488
12554	94	44	30575	162	0	30875
12555	30303	55	582	220	0	31160
12556	30658	59	252	160	0	31129
12557	31594	57	166	138	0	31955
12558	644	49	113	30931	0	31737
12559	292	30891	91	381	0	31655
12560	217	31648	70	198	0	32133
12561	32025	478	76	218	0	32797
12562	31919	214	53	244	0	32430
12563	519	32283	67	121	0	32990
12564	32036	433	70	163	0	32702
12565	505	195	31615	100	0	32415
12566	279	143	31237	82	0	31741
12567	221	104	538	29540	0	30403
12568	220	65	246	31525	0	32056
12569	166	46	31533	509	0	32254
12570	166	56	464	30756	0	31442
12571	31256	46	215	593	0	32110
12572	437	61	31242	266	0	32006
12573	30386	64	458	222	0	31130
12574	547	65	204	31433	0	32249
12575	295	81	32187	442	0	33005
12576	203	32590	473	190	0	33456
12577	32951	398	213	225	0	33787
12578	532	186	32156	100	0	32974
12579	31557	103	489	151	0	32300
12580	548	99	212	32063	0	32922
12581	32262	75	152	550	0	33039
12582	560	71	33370	230	0	34231
12583	315	74	475	33537	0	34401
12584	35036	49	216	608	0	35909
12585	35647	63	168	348	0	36226
12586	36922	54	131	257	0	37364
12587	37222	48	126	237	0	37633
12588	849	60	101	35975	0	36985
12589	452	61	122	36114	0	36749
12590	292	79	35904	696	0	36971
12591	311	67	527	35845	0	36750
12592	346	74	232	34800	0	35452
12593	205	36817	149	754	0	37925
12594	37186	536	146	409	0	38277
12595	37804	213	117	330	0	38464
12596	828	38388	128	235	0	39579
12597	426	644	105	38239	0	39414
12598	352	241	98	38997	0	39688
12599	37503	117	99	979	0	38698
12600	837	115	38793	398	0	40143
12601	457	82	655	39207	0	40401
12602	291	85	39840	829	0	41045
12603	38482	65	772	462	0	39781
12604	39833	59	328	364	0	40584
12605	40125	88	180	330	0	40723
12606	1118	72	145	38581	0	39916
12607	560	68	137	38644	0	39409
12608	38368	93	104	1019	0	39584
12609	920	103	37789	412	0	39224
12610	484	83	680	37926	0	39173
12611	38086	76	260	938	0	39360
12612	922	71	178	38154	0	39325
12613	432	77	39499	877	0	40885
12614	303	81	37735	439	0	38558
12615	37515	90	857	448	0	38910
12616	837	39011	367	291	0	40506
12617	39136	603	237	313	0	40289
12618	39777	211	150	309	0	40447
12619	1051	106	143	39403	0	40703
12620	518	111	133	39257	0	40019
12621	328	39016	147	878	0	40369
12622	38664	604	133	494	0	39895
12623	824	38865	138	303	0	40130
12624	365	38072	111	230	0	38778
12625	332	637	97	36912	0	37978
12626	36697	217	108	741	0	37763
12627	37365	118	109	378	0	37970
12628	832	117	107	36741	0	37797
12629	461	79	80	35708	0	36328
12630	371	91	81	35848	0	36391
12631	35179	84	95	881	0	36239
12632	739	79	35051	383	0	36252
12633	358	34937	552	308	0	36155
12634	34490	458	182	302	0	35432
12635	709	220	110	34323	0	35362
12636	333	109	34150	598	0	35190
12637	292	103	33218	347	0	33960
12638	205	33619	617	266	0	34707
12639	218	34443	218	228	0	35107
12640	277	504	242	33089	0	34112
12641	213	29354	141	443	0	30151
12642	264	420	76	32644	0	33404
12643	222	156	69	33674	0	34121
12644	33642	88	72	695	0	34497
12645	520	95	89	33657	0	34361
12646	284	98	78	34030	0	34490
12647	205	124	33652	584	0	34565
12648	225	110	392	34357	0	35084
12649	34498	90	166	661	0	35415
12650	34794	80	109	388	0	35371
12651	623	36055	115	215	0	37008
12652	34451	470	84	317	0	35322
12653	630	210	34107	211	0	35158
12654	293	34190	486	244	0	35213
12655	284	489	196	34673	0	35642
12656	263	181	126	35404	0	35974
12657	233	145	108	35785	0	36271
12658	35267	98	91	854	0	36310
12659	32505	113	152	469	0	33239
12660	651	121	34409	262	0	35443
12661	322	106	33502	229	0	34159
12662	270	130	33669	222	0	34291
12663	233	33545	622	257	0	34657
12664	239	34733	226	256	0	35454
12665	34342	609	142	352	0	35445
12666	34363	227	125	326	0	35041
12667	779	116	119	34696	0	35710
12668	379	123	145	34005	0	34652
12669	234	34425	136	753	0	35548
12670	235	569	146	35154	0	36104
12671	200	242	34968	712	0	36122
12672	241	35169	575	316	0	36301
12673	272	606	194	35566	0	36638
12674	226	258	37054	666	0	38204
12675	325	177	591	34009	0	35102
12676	229	36319	229	698	0	37475
12677	37300	687	157	406	0	38550
12678	37393	291	126	356	0	38166
12679	38915	198	124	365	0	39602
12680	992	151	117	38952	0	40212
12681	448	165	99	40053	0	40765
12682	39193	157	87	1067	0	40504
12683	876	39180	138	383	0	40577
12684	39068	764	105	380	0	40317
12685	910	254	39995	237	0	41396
12686	39819	140	815	308	0	41082
12687	41210	132	278	303	0	41923
12688	1260	134	154	40679	0	42227
12689	41473	115	123	1010	0	42721
12690	42556	146	84	489	0	43275
12691	1274	141	103	42047	0	43565
12692	466	105	41522	927	0	43020
12693	39505	117	811	487	0	40920
12694	961	106	42399	262	0	43728
12695	387	43291	900	243	0	44821
12696	438	777	362	43768	0	45345
12697	318	252	146	45727	0	46443
12698	47908	120	116	1242	0	49386
12699	1077	129	48256	393	0	49855
12700	519	140	968	44951	0	46578
12701	301	46813	364	918	0	48396
12702	206	47062	200	385	0	47853
12703	311	1100	136	47587	0	49134
12704	222	389	46919	1101	0	48631
12705	362	197	964	47182	0	48705
12706	296	133	364	46962	0	47755
12707	196	164	45791	1281	0	47432
12708	195	47009	968	475	0	48647
12709	45486	1052	340	456	0	47334
12710	1021	47268	231	325	0	48845
12711	507	1081	182	46719	0	48489
12712	45122	378	134	1292	0	46926
12713	992	45047	225	518	0	46782
12714	397	1049	45045	323	0	46814
12715	43939	414	981	416	0	45750
12716	1069	46318	390	262	0	48039
12717	46528	1105	217	354	0	48204
12718	1194	411	45144	269	0	47018
12719	45032	275	1017	359	0	46683
12720	1231	224	364	45548	0	47367
12721	507	207	45326	1150	0	47190
12722	455	237	1046	43446	0	45184
12723	301	44126	398	1120	0	45945
12724	383	1046	238	45076	0	46743
12725	385	429	208	45586	0	46608
12726	355	285	44127	1379	0	46146
12727	379	264	1053	44652	0	46348
12728	349	288	36746	1359	0	38742
12729	339	44755	835	571	0	46500
12730	434	1161	341	44741	0	46677
12731	373	440	45101	1262	0	47176
12732	359	44251	1184	550	0	46344
12733	372	46636	474	438	0	47920
12734	392	1375	45917	375	0	48059
12735	392	510	45910	362	0	47174
12736	494	326	1399	45292	0	47511
12737	45144	269	538	1418	0	47369
12738	1318	45318	365	639	0	47640
12739	635	1244	246	44710	0	46835
12740	44529	516	335	1362	0	46742
12741	1397	44984	306	636	0	47323
12742	44437	1241	341	564	0	46583
12743	1453	45766	306	492	0	48017
12744	45971	1311	281	532	0	48095
12745	45937	506	352	552	0	47347
12746	46635	404	274	590	0	47903
12747	1822	48135	326	442	0	50725
12748	911	1432	319	48075	0	50737
12749	677	553	47199	1507	0	49936
12750	565	47149	1434	704	0	49852
12751	751	1492	534	45439	0	48216
12752	709	630	441	46411	0	48191
12753	602	437	44924	1645	0	47608
12754	529	44169	1350	808	0	46856
12755	43658	1297	571	678	0	46204
12756	1534	43808	384	497	0	46223
12757	759	1418	305	43495	0	45977
12758	550	570	43579	1508	0	46207
12759	42085	448	1363	746	0	44642
12760	1530	424	547	44081	0	46582
12761	629	423	43599	1528	0	46179
12762	41116	431	1402	834	0	43783
12763	1372	42765	598	640	0	45375
12764	42865	1440	471	662	0	45438
12765	43521	657	346	684	0	45208
12766	1687	472	347	43030	0	45536
12767	680	476	42838	1568	0	45562
12768	539	42609	1388	731	0	45267
12769	422	1472	42757	576	0	45227
12770	457	816	1350	41684	0	44307
12771	436	608	607	43512	0	45163
12772	41882	444	479	1787	0	44592
12773	1350	416	41604	874	0	44244
12774	591	40196	1369	609	0	42765
12775	576	1343	557	39845	0	42321
12776	532	576	414	40525	0	42047
12777	38933	486	341	1538	0	41298
12778	1342	39419	281	686	0	41728
12779	723	1207	254	37607	0	39791
12780	36332	550	255	1383	0	38520
12781	1120	36268	280	573	0	38241
12782	35136	1068	249	418	0	36871
12783	35420	451	244	398	0	36513
12784	1243	34597	282	369	0	36491
12785	31775	883	157	328	0	33143
12786	997	31896	196	277	0	33366
12787	31667	898	204	250	0	33019
12788	31699	330	198	306	0	32533
12789	1010	31172	144	304	0	32630
12790	29702	784	120	293	0	30899
12791	30693	273	143	261	0	31370
12792	30606	244	95	277	0	31222
12793	1041	234	29580	215	0	31070
12794	398	185	26975	204	0	27762
12795	618	175	26787	162	0	27742
12796	26745	264	927	188	0	28124
12797	819	132	26253	134	0	27338
12798	310	152	23587	73	0	24122
12799	296	191	630	21980	0	23097
12800	22406	108	211	520	0	23245
12801	617	131	22448	173	0	23369
12802	310	111	23525	136	0	24082
12803	309	129	616	23230	0	24284
12804	252	121	248	23905	0	24526
12805	292	78	161	24339	0	24870
12806	233	116	23875	639	0	24863
12807	229	105	586	23831	0	24751
12808	23774	84	280	662	0	24800
12809	590	23964	199	255	0	25008
12810	337	513	190	24121	0	25161
12811	296	177	191	24716	0	25380
12812	221	157	25022	653	0	26053
12813	198	24572	601	298	0	25669
12814	24514	571	237	273	0	25595
12815	621	24877	224	205	0	25927
12816	305	594	197	24997	0	26093
12817	250	207	25041	649	0	26147
12818	261	185	664	26260	0	27370
12819	224	162	257	27109	0	27752
12820	27012	100	236	896	0	28244
12821	765	120	234	26197	0	27316
12822	290	26165	202	807	0	27464
12823	241	27833	204	337	0	28615
12824	222	770	27651	303	0	28946
12825	27508	258	708	319	0	28793
12826	825	193	304	28061	0	29383
12827	348	158	239	28331	0	29076
12828	307	192	199	28572	0	29270
12829	28139	157	168	960	0	29424
12830	722	28576	185	497	0	29980
12831	28457	636	173	420	0	29686
12832	763	246	27402	325	0	28736
12833	359	190	26867	312	0	27728
12834	27831	165	793	296	0	29085
12835	830	165	377	28123	0	29495
12836	369	157	260	28790	0	29576
12837	327	152	230	29012	0	29721
12838	224	140	28750	957	0	30071
12839	28361	139	716	504	0	29720
12840	29288	122	268	449	0	30127
12841	28668	132	239	438	0	29477
12842	941	184	229	28113	0	29467
12843	442	135	27372	845	0	28794
12844	401	130	26268	413	0	27212
12845	390	149	27542	351	0	28432
12846	275	26769	791	339	0	28174
12847	359	485	485	24814	0	26143
12848	24611	169	267	687	0	25734
12849	570	145	24572	328	0	25615
12850	24675	113	540	345	0	25673
12851	648	94	250	25229	0	26221
12852	334	116	222	25150	0	25822
12853	272	24345	225	715	0	25557
12854	268	24684	202	348	0	25502
12855	238	25931	206	301	0	26676
12856	289	581	190	25974	0	27034
12857	25671	229	214	683	0	26797
12858	25922	134	225	405	0	26686
12859	656	150	25525	295	0	26626
12860	24863	129	523	309	0	25824
12861	649	118	25513	293	0	26573
12862	355	105	553	25328	0	26341
12863	285	115	25649	572	0	26621
12864	24959	117	624	323	0	26023
12865	615	123	338	25957	0	27033
12866	317	128	26873	614	0	27932
12867	251	119	25160	386	0	25916
12868	25380	105	633	392	0	26510
12869	26469	119	334	301	0	27223
12870	649	26809	247	261	0	27966
12871	368	449	196	27310	0	28323
12872	293	192	27236	589	0	28310
12873	254	190	26780	299	0	27523
12874	328	215	593	26947	0	28083
12875	27249	135	343	623	0	28350
12876	524	27038	242	380	0	28184
12877	300	434	214	27504	0	28452
12878	27405	176	231	628	0	28440
12879	606	165	206	27270	0	28247
12880	351	27367	208	613	0	28539
12881	319	411	204	27857	0	28791
12882	27705	190	205	632	0	28732
12883	607	117	210	27831	0	28765
12884	27831	95	200	619	0	28745
12885	587	28350	216	391	0	29544
12886	28251	443	224	374	0	29292
12887	600	186	27824	283	0	28893
12888	26846	118	541	320	0	27825
12889	28102	147	255	288	0	28792
12890	678	28227	217	218	0	29340
12891	366	500	194	27556	0	28616
12892	310	163	27537	468	0	28478
12893	268	123	26413	277	0	27081
12894	25355	236	509	318	0	26418
12895	25256	114	212	284	0	25866
12896	443	25471	154	235	0	26303
12897	250	25761	148	216	0	26375
12898	25336	362	172	202	0	26072
12899	464	25125	158	157	0	25904
12900	274	25825	141	157	0	26397
12901	273	350	110	25518	0	26251
12902	219	153	99	24802	0	25273
12903	191	119	24790	450	0	25550
12904	220	104	331	24624	0	25279
12905	24507	112	158	485	0	25262
12906	427	100	24482	206	0	25215
12907	251	99	24380	175	0	24905
12908	305	71	381	24139	0	24896
12909	255	80	211	25134	0	25680
12910	231	98	148	25110	0	25587
12911	161	102	24714	420	0	25397
12912	169	76	341	23441	0	24027
12913	168	84	183	24286	0	24721
12914	23870	79	124	376	0	24449
12915	296	23574	96	191	0	24157
12916	23245	212	81	175	0	23713
12917	313	100	23436	109	0	23958
12918	20226	41	155	135	0	20557
12919	198	22338	71	75	0	22682
12920	21374	94	39	82	0	21589
12921	109	21395	31	34	0	21569
12922	20478	108	48	93	0	20727
12923	99	20256	14	41	0	20410
12924	57	20219	44	44	0	20364
12925	138	109	82	20292	0	20621
12926	20289	28	54	128	0	20499
12927	20181	19	5	72	0	20277
12928	20143	20	7	72	0	20242
12929	117	22	19893	15	0	20047
12930	58	17	19532	9	0	19616
12931	52	12	99	19973	0	20136
12932	21	19929	36	103	0	20089
12933	23	20703	17	38	0	20781
12934	42	107	13	20072	0	20234
12935	19961	37	7	135	0	20140
12936	19847	26	9	62	0	19944
12937	20033	25	8	71	0	20137
12938	139	26	19848	22	0	20035
12939	84	17	94	20044	0	20239
12940	41	18	20504	116	0	20679
12941	20151	15	116	91	0	20373
12942	20734	18	46	85	0	20883
12943	169	24	20965	25	0	21183
12944	77	19	139	20949	0	21184
12945	21146	17	40	196	0	21399
12946	175	21	17	21649	0	21862
12947	81	24	19	21914	0	22038
12948	113	22	22	22568	0	22725
12949	25020	8	16	342	0	25386
12950	332	10	20	26283	0	26645
12951	26967	9	17	444	0	27437
12952	400	28538	25	139	0	29102
12953	193	386	24	29649	0	30252
12954	144	119	29	29946	0	30238
12955	109	51	16	29721	0	29897
12956	29313	37	16	659	0	30025
12957	510	37	18	29187	0	29752
12958	228	9	20	29453	0	29710
12959	29508	21	19	699	0	30247
12960	29845	12	15	344	0	30216
12961	29788	20	20	227	0	30055
12962	653	22	28975	133	0	29783
12963	301	28	27376	110	0	27815
12964	29073	19	512	157	0	29761
12965	582	27	178	28814	0	29601
12966	285	43	83	28084	0	28495
12967	28523	29	53	720	0	29325
12968	27670	24	43	372	0	28109
12969	27879	28	41	271	0	28219
12970	635	27336	45	184	0	28200
12971	27486	401	41	191	0	28119
12972	27061	130	30	199	0	27420
12973	678	26665	35	115	0	27493
12974	361	27274	35	114	0	27784
12975	340	485	53	27504	0	28382
12976	28217	158	73	509	0	28957
12977	28335	87	71	254	0	28747
12978	28309	51	47	202	0	28609
12979	758	50	47	27842	0	28697
12980	27834	42	37	607	0	28520
12981	690	42	27162	253	0	28147
12982	26872	53	403	255	0	27583
12983	670	59	27328	148	0	28205
12984	365	79	26649	131	0	27224
12985	321	65	528	26140	0	27054
12986	26449	52	221	552	0	27274
12987	601	81	104	26286	0	27072
12988	290	78	26390	580	0	27338
12989	250	59	26322	296	0	26927
12990	274	52	535	25591	0	26452
12991	25887	44	204	564	0	26699
12992	609	26174	129	286	0	27198
12993	386	391	117	26580	0	27474
12994	314	142	92	27282	0	27830
12995	262	88	27144	654	0	28148
12996	249	74	26554	347	0	27224
12997	253	53	605	27332	0	28243
12998	27450	40	289	668	0	28447
12999	611	61	27335	378	0	28385
13000	423	55	480	27199	0	28157
13001	341	69	209	27478	0	28097
13002	287	49	170	27966	0	28472
13003	27065	60	141	829	0	28095
13004	648	95	24468	471	0	25682
13005	414	26806	389	356	0	27965
13006	329	472	191	27228	0	28220
13007	317	202	26891	687	0	28097
13008	328	26199	512	451	0	27490
13009	284	27321	264	390	0	28259
13010	27094	546	202	351	0	28193
13011	676	27311	186	312	0	28485
13012	27721	524	156	344	0	28745
13013	778	241	27308	289	0	28616
13014	478	159	561	27647	0	28845
13015	27661	105	241	798	0	28805
13016	750	28031	190	483	0	29454
13017	485	536	27869	405	0	29295
13018	514	256	566	25423	0	26759
13019	396	28151	283	599	0	29429
13020	411	603	198	29393	0	30605
13021	29094	267	219	885	0	30465
13022	804	30253	194	450	0	31701
13023	30757	694	138	402	0	31991
13024	31298	296	152	363	0	32109
13025	1103	223	30926	289	0	32541
13026	630	32241	737	257	0	33865
13027	556	745	364	33790	0	35455
13028	450	281	35076	850	0	36657
13029	435	219	37200	388	0	38242
13030	432	227	1136	37749	0	39544
13031	38626	132	489	1091	0	40338
13032	38976	149	334	510	0	39969
13033	1448	155	238	38420	0	40261
13034	632	156	38634	1185	0	40607
13035	488	38599	1012	542	0	40641
13036	39474	982	391	419	0	41266
13037	39954	372	261	449	0	41036
13038	1427	39953	261	285	0	41926
13039	40440	1041	259	319	0	42059
13040	1297	420	39417	262	0	41396
13041	39285	284	1003	305	0	40877
13042	37840	230	493	337	0	38900
13043	1295	195	39419	255	0	41164
13044	776	131	1102	38605	0	40614
13045	555	130	38818	1031	0	40534
13046	465	37085	1078	476	0	39104
13047	377	37767	559	415	0	39118
13048	459	1312	333	35134	0	37238
13049	271	345	35570	809	0	36995
13050	206	33119	760	327	0	34412
13051	186	33555	305	208	0	34254
13052	30608	817	336	248	0	32009
13053	31075	266	186	135	0	31662
13054	822	182	133	31061	0	32198
13055	427	151	122	30400	0	31100
13056	265	31128	115	667	0	32175
13057	30959	605	135	349	0	32048
13058	31256	215	121	312	0	31904
13059	760	31084	124	188	0	32156
13060	387	652	77	31511	0	32627
13061	264	268	31431	655	0	32618
13062	276	176	608	31514	0	32574
13063	31875	181	221	757	0	33034
13064	756	171	144	32044	0	33115
13065	369	154	115	32908	0	33546
13066	32927	134	105	923	0	34089
13067	818	102	123	32050	0	33093
13068	312	32458	129	798	0	33697
13069	285	641	103	33235	0	34264
13070	308	261	75	33716	0	34360
13071	310	182	100	32881	0	33473
13072	197	33011	107	912	0	34227
13073	233	668	100	32842	0	33843
13074	164	306	32313	869	0	33652
13075	231	210	652	32142	0	33235
13076	213	191	31888	849	0	33141
13077	213	31585	680	479	0	32957
13078	238	660	293	32478	0	33669
13079	236	259	174	32967	0	33636
13080	266	189	174	32959	0	33588
13081	262	176	164	32866	0	33468
13082	184	208	31879	1072	0	33343
13083	167	31767	682	577	0	33193
13084	199	685	271	32617	0	33772
13085	183	317	32644	943	0	34087
13086	244	206	751	32919	0	34120
13087	32900	228	334	1009	0	34471
13088	788	171	31645	559	0	33163
13089	31924	159	755	441	0	33279
13090	882	185	327	32876	0	34270
13091	447	217	32755	927	0	34346
13092	285	32409	814	521	0	34029
13093	323	760	340	32514	0	33937
13094	292	314	33442	1016	0	35064
13095	249	33126	879	529	0	34783
13096	274	858	368	33552	0	35052
13097	33452	364	261	1048	0	35125
13098	34126	267	280	565	0	35238
13099	34486	211	255	462	0	35414
13100	1094	223	33885	404	0	35606
13101	524	34337	840	355	0	36056
13102	471	865	348	34382	0	36066
13103	394	348	246	36420	0	37408
13104	36265	227	250	1226	0	37968
13105	971	36973	226	542	0	38712
13106	37249	1000	216	485	0	38950
13107	37068	428	204	490	0	38190
13108	37676	320	217	473	0	38686
13109	1246	291	36937	411	0	38885
13110	37216	233	957	426	0	38832
13111	1306	226	324	37553	0	39409
13112	687	226	227	37988	0	39128
13113	37414	191	248	1295	0	39148
13114	1205	208	204	36915	0	38532
13115	528	36754	203	1197	0	38682
13116	442	935	184	36546	0	38107
13117	35696	345	146	1335	0	37522
13118	1065	260	35048	701	0	37074
13119	491	34842	853	510	0	36696
13120	485	834	263	34194	0	35776
13121	34047	312	182	1057	0	35598
13122	942	247	33158	537	0	34884
13123	592	607	855	32286	0	34340
13124	505	180	32082	935	0	33702
13125	447	157	30436	540	0	31580
13126	330	144	29765	404	0	30643
13127	351	88	28947	385	0	29771
13128	306	105	27953	310	0	28674
13129	24303	298	1022	271	0	25894
13130	470	24891	296	197	0	25854
13131	24294	352	209	215	0	25070
13132	24293	120	184	182	0	24779
13133	501	24000	182	123	0	24806
13134	245	24576	158	128	0	25107
13135	24518	416	159	181	0	25274
13136	24635	167	120	153	0	25075
13137	522	150	102	23720	0	24494
13138	276	24241	117	405	0	25039
13139	24812	362	129	217	0	25520
13140	419	24534	134	151	0	25238
13141	249	428	125	24739	0	25541
13142	24976	147	131	442	0	25696
13143	25124	125	98	222	0	25569
13144	534	135	98	24896	0	25663
13145	301	144	80	25063	0	25588
13146	263	90	24738	469	0	25560
13147	233	142	357	24397	0	25129
13148	173	116	24773	476	0	25538
13149	272	100	408	23871	0	24651
13150	238	80	181	24643	0	25142
13151	24458	75	150	595	0	25278
13152	24257	96	125	349	0	24827
13153	534	73	24163	186	0	24956
13154	23725	93	383	227	0	24428
13155	534	90	184	24201	0	25009
13156	271	85	24439	488	0	25283
13157	302	79	430	24251	0	25062
13158	297	72	155	26263	0	26787
13159	208	73	26168	607	0	27056
13160	237	74	482	26548	0	27341
13161	193	65	27808	610	0	28676
13162	203	87	542	28881	0	29713
13163	30322	61	257	741	0	31381
13164	595	30932	161	411	0	32099
13165	31236	543	141	342	0	32262
13166	726	31682	153	220	0	32781
13167	31429	630	128	281	0	32468
13168	742	31540	164	197	0	32643
13169	31234	650	113	291	0	32288
13170	729	31824	169	200	0	32922
13171	457	710	108	31891	0	33166
13172	314	335	31937	695	0	33281
13173	282	256	31497	351	0	32386
13174	308	208	765	31712	0	32993
13175	31901	185	369	752	0	33207
13176	765	32480	235	368	0	33848
13177	493	704	165	32548	0	33910
13178	320	388	32557	756	0	34021
13179	286	248	32832	393	0	33759
13180	371	288	894	30984	0	32537
13181	235	33050	466	716	0	34467
13182	32910	713	289	446	0	34358
13183	793	403	33738	266	0	35200
13184	405	304	32533	263	0	33505
13185	280	33686	895	263	0	35124
13186	33593	708	546	305	0	35152
13187	34112	360	363	268	0	35103
13188	936	267	247	33765	0	35215
13189	34181	197	251	756	0	35385
13190	33856	208	253	458	0	34775
13191	935	33686	231	308	0	35160
13192	33710	701	257	280	0	34948
13193	918	377	34220	189	0	35704
13194	588	251	699	33206	0	34744
13195	473	243	384	33389	0	34489
13196	33167	185	282	910	0	34544
13197	800	33041	260	459	0	34560
13198	32762	667	213	351	0	33993
13199	862	33497	187	244	0	34790
13200	548	33650	171	192	0	34561
13201	447	830	32810	220	0	34307
13202	378	478	31668	260	0	32784
13203	30336	336	764	246	0	31682
13204	31460	223	398	226	0	32307
13205	774	234	30660	158	0	31826
13206	521	29173	471	117	0	30282
13207	305	30154	307	133	0	30899
13208	30200	658	229	185	0	31272
13209	30182	403	171	165	0	30921
13210	758	269	162	30093	0	31282
13211	30678	195	170	534	0	31577
13212	702	172	163	30328	0	31365
13213	417	193	30354	527	0	31491
13214	345	186	28108	318	0	28957
13215	29484	175	687	276	0	30622
13216	641	200	388	29526	0	30755
13217	435	32067	251	411	0	33164
13218	32800	509	221	381	0	33911
13219	32856	297	224	291	0	33668
13220	796	234	32691	192	0	33913
13221	32655	177	524	211	0	33567
13222	33811	192	340	210	0	34553
13223	948	168	248	33277	0	34641
13224	536	32335	242	527	0	33640
13225	438	32272	182	343	0	33235
13226	411	686	173	34595	0	35865
13227	443	402	177	33473	0	34495
13228	411	272	161	34704	0	35548
13229	409	208	34016	870	0	35503
13230	364	259	32934	452	0	34009
13231	403	234	771	33205	0	34613
13232	342	223	33884	664	0	35113
13233	350	218	33303	409	0	34280
13234	325	209	820	33021	0	34375
13235	327	196	35151	702	0	36376
13236	277	34647	818	460	0	36202
13237	36022	681	460	443	0	37606
13238	761	407	374	35107	0	36649
13239	456	35163	293	703	0	36615
13240	349	691	36154	442	0	37636
13241	326	372	840	36124	0	37662
13242	255	283	37464	799	0	38801
13243	343	206	902	37018	0	38469
13244	337	195	474	38307	0	39313
13245	304	219	39121	1009	0	40653
13246	341	191	925	37798	0	39255
13247	256	37560	535	925	0	39276
13248	338	760	387	40090	0	41575
13249	288	443	39907	976	0	41614
13250	358	303	869	39481	0	41011
13251	39108	197	487	1112	0	40904
13252	854	39451	347	632	0	41284
13253	550	784	297	39707	0	41338
13254	344	424	40299	922	0	41989
13255	275	38740	890	586	0	40491
13256	262	40161	509	483	0	41415
13257	292	936	39628	371	0	41227
13258	334	509	751	37548	0	39142
13259	410	350	488	37166	0	38414
13260	236	218	37407	992	0	38853
13261	174	34639	667	571	0	36051
13262	161	35374	382	363	0	36280
13263	32843	577	250	252	0	33922
13264	441	33024	132	225	0	33822
13265	32886	503	104	251	0	33744
13266	536	252	115	32058	0	32961
13267	33748	177	118	645	0	34688
13268	545	111	33729	284	0	34669
13269	33069	133	528	271	0	34001
13270	619	143	262	33829	0	34853
13271	239	34503	216	524	0	35482
13272	34848	502	136	349	0	35835
13273	591	349	145	34665	0	35750
13274	226	34643	181	542	0	35592
13275	173	37019	136	273	0	37601
13276	36497	613	146	307	0	37563
13277	37046	264	98	240	0	37648
13278	37420	187	104	211	0	37922
13279	690	149	107	36043	0	36989
13280	276	34884	115	542	0	35817
13281	202	36387	101	254	0	36944
13282	205	558	125	36328	0	37216
13283	35781	265	96	635	0	36777
13284	33165	201	99	492	0	33957
13285	35189	154	96	355	0	35794
13286	717	168	32946	192	0	34023
13287	362	166	33790	177	0	34495
13288	36100	172	542	257	0	37071
13289	678	177	221	36104	0	37180
13290	390	149	155	36760	0	37454
13291	344	154	128	36239	0	36865
13292	261	153	149	36758	0	37321
13293	155	173	35673	844	0	36845
13294	217	189	547	35366	0	36319
13295	175	183	35382	769	0	36509
13296	32671	140	609	511	0	33931
13297	604	35241	281	355	0	36481
13298	356	541	210	36277	0	37384
13299	270	303	185	35732	0	36490
13300	35172	241	185	863	0	36461
13301	34965	185	206	498	0	35854
13302	35096	163	143	414	0	35816
13303	34973	190	115	359	0	35637
13304	816	184	34685	324	0	36009
13305	450	152	33890	302	0	34794
13306	359	164	701	34453	0	35677
13307	34893	160	374	735	0	36162
13308	34455	171	267	520	0	35413
13309	738	167	34291	392	0	35588
13310	454	120	596	33821	0	34991
13311	34050	173	310	869	0	35402
13312	641	179	270	34179	0	35269
13313	358	202	34191	794	0	35545
13314	443	203	569	33654	0	34869
13315	33986	218	279	834	0	35317
13316	703	36233	217	468	0	37621
13317	35699	554	181	517	0	36951
13318	35797	259	185	465	0	36706
13319	36365	192	232	360	0	37149
13320	917	182	164	35941	0	37204
13321	35305	150	137	706	0	36298
13322	735	36279	167	360	0	37541
13323	467	37523	183	308	0	38481
13324	390	797	180	36830	0	38197
13325	37062	362	123	765	0	38312
13326	774	38295	122	381	0	39572
13327	43656	722	152	390	0	44920
13328	45987	341	126	372	0	46826
13329	1504	47116	120	265	0	49005
13330	863	1087	122	47392	0	49464
13331	651	511	99	48717	0	49978
13332	516	362	48266	1415	0	50559
13333	666	279	990	47539	0	49474
13334	529	287	47863	1403	0	50082
13335	471	46279	1085	762	0	48597
13336	539	1142	498	47136	0	49315
13337	45104	529	331	1510	0	47474
13338	46131	340	283	963	0	47717
13339	1565	264	328	45910	0	48067
13340	708	269	44417	1380	0	46774
13341	41231	266	1098	922	0	43517
13342	1221	42426	505	615	0	44767
13343	687	41904	338	536	0	43465
13344	601	43603	214	454	0	44872
13345	674	1315	278	41411	0	43678
13346	461	618	42375	1089	0	44543
13347	497	415	997	41635	0	43544
13348	383	388	42140	1131	0	44042
13349	288	430	41160	544	0	42422
13350	320	409	42434	414	0	43577
13351	376	399	1367	40127	0	42269
13352	327	292	665	43135	0	44419
13353	261	298	548	43635	0	44742
13354	256	196	464	42678	0	43594
13355	42265	149	545	1644	0	44603
13356	885	42083	494	914	0	44376
13357	42038	879	457	765	0	44139
13358	981	42798	366	680	0	44825
13359	581	1008	289	43180	0	45058
13360	470	469	198	44951	0	46088
13361	43953	343	174	1741	0	46211
13362	44572	292	144	958	0	45966
13363	45052	342	149	740	0	46283
13364	44953	312	155	628	0	46048
13365	44669	340	114	620	0	45743
13366	1626	43728	107	502	0	45963
13367	41977	1013	75	559	0	43624
13368	1404	41972	90	403	0	43869
13369	41582	951	83	449	0	43065
13370	1565	477	40940	240	0	43222
13371	1046	396	760	39853	0	42055
13372	815	41494	377	804	0	43490
13373	697	1042	236	41280	0	43255
13374	651	589	40594	975	0	42809
13375	585	486	880	38757	0	40708
13376	37903	336	462	1272	0	39973
13377	976	38404	370	715	0	40465
13378	626	39313	285	671	0	40895
13379	467	1257	39387	500	0	41611
13380	418	734	949	38372	0	40473
13381	349	39949	570	1182	0	42050
13382	362	1037	403	41076	0	42878
13383	360	663	40871	1209	0	43103
13384	271	39759	1045	873	0	41948
13385	371	1162	40354	533	0	42420
13386	365	765	40141	500	0	41771
13387	436	538	1175	39778	0	41927
13388	40304	444	724	1214	0	42686
13389	1089	425	473	40998	0	42985
13390	522	508	41066	1233	0	43329
13391	444	423	1255	41632	0	43754
13392	330	434	42999	1304	0	45067
13393	379	426	42101	787	0	43693
13394	42033	355	1600	847	0	44835
13395	45123	280	890	835	0	47128
13396	45423	272	721	863	0	47279
13397	1502	180	44841	695	0	47218
13398	713	191	44972	691	0	46567
13399	663	146	1802	43661	0	46272
13400	653	168	1021	44964	0	46806
13401	44876	217	717	1614	0	47424
13402	1499	213	577	45075	0	47364
13403	856	234	45074	1518	0	47682
13404	626	207	43586	1002	0	45421
13405	575	44418	1556	801	0	47350
13406	595	1051	782	45768	0	48196
13407	591	541	46387	1457	0	48976
13408	650	393	1348	45725	0	48116
13409	45716	298	855	1740	0	48609
13410	1310	310	46807	928	0	49355
13411	833	258	1421	46558	0	49070
13412	719	294	811	47628	0	49452
13413	613	253	46702	1798	0	49366
13414	697	271	1414	46139	0	48521
13415	596	220	46414	1619	0	48849
13416	42760	260	1495	1046	0	45561
13417	1391	254	849	43076	0	45570
13418	762	42933	635	1474	0	45804
13419	42813	1051	547	1103	0	45514
13420	42859	477	595	865	0	44796
13421	1537	42562	581	794	0	45474
13422	1212	2816	618	37535	0	42181
13423	606	39495	338	1235	0	41674
13424	524	40384	397	746	0	42051
13425	909	1321	38302	565	0	41097
13426	582	37649	957	517	0	39705
13427	367	753	31767	270	0	33157
13428	26725	290	518	273	0	27806
13429	27669	110	179	243	0	28201
13430	434	28257	152	125	0	28968
13431	163	28380	129	128	0	28800
13432	113	29857	117	114	0	30201
13433	30824	491	103	185	0	31603
13434	576	180	102	32049	0	32907
13435	192	153	34995	546	0	35886
13436	140	35367	643	195	0	36345
13437	181	655	188	36388	0	37412
13438	208	219	125	35671	0	36223
13439	82	40771	134	743	0	41730
13440	43547	882	106	397	0	44932
13441	1038	265	44511	184	0	45998
13442	508	164	1084	50594	0	52350
13443	157	57370	286	1283	0	59096
13444	57220	1539	173	487	0	59419
13445	1622	457	57065	254	0	59398
13446	451	55822	1541	230	0	58044
13447	550	1670	406	55989	0	58615
13448	248	492	56244	1548	0	58532
13449	54565	294	1701	621	0	57181
13450	1787	335	469	55249	0	57840
13451	569	225	55588	1731	0	58113
13452	339	55458	1761	544	0	58102
13453	54449	1699	498	477	0	57123
13454	1598	55756	386	383	0	58123
13455	55556	1827	317	372	0	58072
13456	56651	619	263	442	0	57975
13457	2231	529	245	54664	0	57669
13458	819	53603	310	1697	0	56429
13459	528	1701	54386	527	0	57142
13460	640	659	1722	53835	0	56856
13461	798	585	686	46728	0	48797
13462	538	324	555	55147	0	56564
13463	648	308	363	55178	0	56497
13464	508	259	308	55743	0	56818
13465	53962	343	409	2472	0	57186
13466	52660	374	332	1154	0	54520
13467	52651	307	279	918	0	54155
13468	2120	52366	299	651	0	55436
13469	947	1679	53340	566	0	56532
13470	750	598	53445	485	0	55278
13471	508	496	54590	610	0	56204
13472	620	503	2203	52161	0	55487
13473	582	360	974	54037	0	55953
13474	567	315	581	54637	0	56100
13475	357	393	52926	2601	0	56277
13476	354	51851	1956	1269	0	55430
13477	428	1731	52452	946	0	55557
13478	432	601	53665	826	0	55524
13479	656	464	2209	52258	0	55587
13480	501	474	53482	2130	0	56587
13481	643	391	2184	52546	0	55764
13482	52032	527	993	2264	0	55816
13483	52800	426	809	1037	0	55072
13484	2315	373	51949	814	0	55451
13485	1057	423	2147	51441	0	55068
13486	806	388	52283	2313	0	55790
13487	581	52240	2233	1061	0	56115
13488	51869	1951	996	984	0	55800
13489	2137	796	52454	697	0	56084
13490	951	50243	2190	725	0	54109
13491	660	50354	1121	717	0	52852
13492	606	51218	892	770	0	53486
13493	606	2309	48708	810	0	52433
13494	785	1250	2199	45238	0	49472
13495	705	47823	939	2002	0	51469
13496	819	2072	792	47499	0	51182
13497	835	941	773	48952	0	51501
13498	46691	764	744	2613	0	50812
13499	2024	47024	767	1351	0	51166
13500	46335	1979	830	1129	0	50273
13501	2114	45460	730	1024	0	49328
13502	1105	47604	683	878	0	50270
13503	825	2348	46303	891	0	50367
13504	896	1320	2023	45734	0	49973
13505	763	1033	46048	2161	0	50005
13506	728	45328	2103	1180	0	49339
13507	826	2005	45531	1009	0	49371
13508	738	979	45933	1072	0	48722
13509	728	45846	2292	988	0	49854
13510	44175	2100	1221	1068	0	48564
13511	1937	45363	947	1179	0	49426
13512	45473	2207	916	1084	0	49680
13513	2081	1125	45479	1055	0	49740
13514	1023	747	45892	1082	0	48744
13515	745	45204	2434	1144	0	49527
13516	44781	2091	1122	1061	0	49055
13517	2130	45200	1121	904	0	49355
13518	1144	2121	956	45124	0	49345
13519	45770	1090	988	2074	0	49922
13520	2147	953	45741	934	0	49775
13521	1001	759	2542	45676	0	49978
13522	45160	723	1337	2291	0	49511
13523	2072	45453	1065	1149	0	49739
13524	1124	2014	975	45480	0	49593
13525	754	944	45290	2466	0	49454
13526	44513	737	2283	1267	0	48800
13527	2008	691	1304	45430	0	49433
13528	753	693	45202	2367	0	49015
13529	755	717	2331	43460	0	47263
13530	711	44438	1165	2324	0	48638
13531	667	1936	44545	1298	0	48446
13532	852	769	2144	42665	0	46430
13533	41038	610	971	2049	0	44668
13534	2136	538	834	39857	0	43365
13535	36342	487	742	1829	0	39400
13536	1766	36004	704	909	0	39383
13537	35146	1557	762	688	0	38153
13538	1661	753	34482	714	0	37610
13539	818	564	30584	548	0	32514
13540	591	429	27291	369	0	28680
13541	526	26053	1739	481	0	28799
13542	623	342	1363	13421	0	15749
13543	112	101	169	13085	0	13467
13544	88	58	98	12696	0	12940
13545	56	61	72	13198	0	13387
13546	79	45	13090	303	0	13517
13547	11999	66	220	164	0	12449
13548	218	13131	116	101	0	13566
13549	12862	198	61	92	0	13213
13550	254	81	58	12835	0	13228
13551	101	12875	55	208	0	13239
13552	89	193	56	13017	0	13355
13553	12862	99	71	220	0	13252
13554	188	13475	52	108	0	13823
13555	13449	198	60	96	0	13803
13556	13508	81	60	79	0	13728
13557	223	63	51	13709	0	14046
13558	100	66	13690	197	0	14053
13559	13317	47	188	129	0	13681
13560	214	49	69	14247	0	14579
13561	14404	44	56	242	0	14746
13562	14738	40	43	130	0	14951
13563	14658	47	52	100	0	14857
13564	260	55	14609	70	0	14994
13565	138	50	166	14243	0	14597
13566	14433	36	69	214	0	14752
13567	216	56	14883	101	0	15256
13568	106	14850	159	70	0	15185
13569	138	188	83	13237	0	13646
13570	80	71	14954	163	0	15268
13571	60	52	14724	79	0	14915
13572	110	52	174	14456	0	14792
13573	80	30	82	15356	0	15548
13574	73	22	48	15468	0	15611
13575	68	22	52	15207	0	15349
13576	60	29	15166	205	0	15460
13577	59	15177	148	109	0	15493
13578	66	127	70	15428	0	15691
13579	15646	48	47	178	0	15919
13580	15296	33	38	123	0	15490
13581	15372	38	28	74	0	15512
13582	203	31	33	15356	0	15623
13583	113	52	36	15095	0	15296
13584	54	14324	35	192	0	14605
13585	51	14844	32	93	0	15020
13586	83	188	41	14449	0	14761
13587	14322	59	57	165	0	14603
13588	14115	18	28	98	0	14259
13589	13977	14	21	77	0	14089
13590	13936	16	23	67	0	14042
13591	13945	16	23	60	0	14044
13592	114	14043	22	37	0	14216
13593	77	73	16	14327	0	14493
13594	14720	27	18	134	0	14899
13595	14774	21	17	98	0	14910
13596	132	20	14	14644	0	14810
13597	78	18	14	14765	0	14875
13598	47	16	15064	122	0	15249
13599	75	13	74	14455	0	14617
13600	77	19	32	14768	0	14896
13601	40	25	15750	124	0	15939
13602	70	34	62	15588	0	15754
13603	47	15897	29	113	0	16086
13604	55	96	15824	51	0	16026
13605	47	15989	76	43	0	16155
13606	71	73	26	15588	0	15758
13607	63	35	12	16056	0	16166
13608	40	15871	25	107	0	16043
13609	36	16135	17	52	0	16240
13610	16368	71	24	81	0	16544
13611	16062	32	13	74	0	16181
13612	111	23	15889	47	0	16070
13613	15705	17	63	96	0	15881
13614	16803	7	32	87	0	16929
13615	16822	12	24	88	0	16946
13616	16616	15	55	105	0	16791
13617	116	15	16224	52	0	16407
13618	62	34	15145	40	0	15281
13619	16455	17	59	94	0	16625
13620	93	17379	41	51	0	17564
13621	51	55	17510	16	0	17632
13622	17375	20	69	64	0	17528
13623	17630	13	25	74	0	17742
13624	105	16	17471	25	0	17617
13625	17346	14	73	49	0	17482
13626	99	13	36	18918	0	19066
13627	42	16	19332	95	0	19485
13628	17643	19	94	117	0	17873
13629	87	19125	46	46	0	19304
13630	19718	78	23	113	0	19932
13631	21993	23	26	156	0	22198
13632	148	25	23	22180	0	22376
13633	76	12	25	22070	0	22183
13634	49	17	19	22665	0	22750
13635	22744	10	19	210	0	22983
13636	23861	8	19	131	0	24019
13637	188	24	17	24002	0	24231
13638	123	15	15	23780	0	23933
13639	72	31	23383	193	0	23679
13640	22150	14	127	166	0	22457
13641	183	22	62	23900	0	24167
13642	124	20	19	23881	0	24044
13643	65	23581	16	232	0	23894
13644	79	132	17	23939	0	24167
13645	82	68	11	23873	0	24034
13646	23648	29	20	288	0	23985
13647	191	23866	23	116	0	24196
13648	152	143	13	24265	0	24573
13649	112	68	10	24205	0	24395
13650	96	27	15	24484	0	24622
13651	78	42	24299	264	0	24683
13652	98	25	149	23942	0	24214
13653	23706	20	78	302	0	24106
13654	219	41	23740	144	0	24144
13655	163	22	161	23899	0	24245
13656	87	14	84	24503	0	24688
13657	24282	15	33	385	0	24715
13658	23620	19	54	243	0	23936
13659	284	33	23827	113	0	24257
13660	21822	32	170	208	0	22232
13661	237	38	23387	95	0	23757
13662	22827	34	182	162	0	23205
13663	241	25020	79	113	0	25453
13664	25540	214	36	170	0	25960
13665	292	25753	43	88	0	26176
13666	26374	255	35	155	0	26819
13667	283	26615	40	102	0	27040
13668	154	274	49	27208	0	27685
13669	139	93	37	27293	0	27562
13670	118	44	43	27251	0	27456
13671	77	26596	43	407	0	27123
13672	103	257	34	26699	0	27093
13673	60	26952	57	352	0	27421
13674	98	287	27	27370	0	27782
13675	27495	121	36	397	0	28049
13676	27120	66	39	241	0	27466
13677	422	27001	46	117	0	27586
13678	221	301	41	27370	0	27933
13679	27048	131	42	411	0	27632
13680	354	27076	48	182	0	27660
13681	181	27492	36	121	0	27830
13682	27532	422	20	169	0	28143
13683	27691	172	37	146	0	28046
13684	462	27616	27	92	0	28197
13685	27512	369	30	143	0	28054
13686	451	179	19	27493	0	28142
13687	217	121	28045	402	0	28785
13688	27702	92	308	305	0	28407
13689	28269	99	111	224	0	28703
13690	522	81	28480	130	0	29213
13691	28687	91	345	234	0	29357
13692	29420	84	131	213	0	29848
13693	30603	77	52	257	0	30989
13694	567	30250	61	143	0	31021
13695	30822	416	48	204	0	31490
13696	31190	204	40	190	0	31624
13697	674	125	42	31007	0	31848
13698	387	119	41	31455	0	32002
13699	272	106	35	32045	0	32458
13700	32162	103	35	691	0	32991
13701	591	94	41	31488	0	32214
13702	31835	106	30	655	0	32626
13703	32294	106	40	384	0	32824
13704	752	92	44	32119	0	33007
13705	408	97	53	33214	0	33772
13706	331	88	49	33580	0	34048
13707	33305	85	37	801	0	34228
13708	602	33172	57	355	0	34186
13709	394	492	61	33949	0	34896
13710	330	201	36	34722	0	35289
13711	34207	133	48	874	0	35262
13712	34261	104	84	481	0	34930
13713	840	118	33516	289	0	34763
13714	440	122	33147	253	0	33962
13715	35453	100	651	285	0	36489
13716	862	99	224	36253	0	37438
13717	557	101	112	40871	0	41641
13718	332	128	40580	1224	0	42264
13719	437	137	867	39468	0	40909
13720	296	39353	297	1080	0	41026
13721	292	41388	163	459	0	42302
13722	40086	1082	121	437	0	41726
13723	1089	382	39573	373	0	41417
13724	495	40798	780	279	0	42352
13725	483	973	250	41423	0	43129
13726	344	363	41115	1064	0	42886
13727	404	212	951	39951	0	41518
13728	412	187	293	40914	0	41806
13729	302	177	40960	1337	0	42776
13730	294	41075	968	561	0	42898
13731	414	925	333	39311	0	40983
13732	39441	365	256	1170	0	41232
13733	39619	244	186	581	0	40630
13734	39807	193	122	454	0	40576
13735	1298	38801	218	369	0	40686
13736	38190	929	154	367	0	39640
13737	1245	347	161	38062	0	39815
13738	517	236	37455	1069	0	39277
13739	36801	207	846	583	0	38437
13740	1112	38161	324	396	0	39993
13741	506	898	205	38063	0	39672
13742	454	345	184	38200	0	39183
13743	330	37624	183	1226	0	39363
13744	401	969	162	38793	0	40325
13745	427	328	171	39359	0	40285
13746	405	248	157	40245	0	41055
13747	38869	264	206	1514	0	40853
13748	38877	188	215	811	0	40091
13749	1230	303	38801	541	0	40875
13750	649	278	932	38631	0	40490
13751	569	227	324	40055	0	41175
13752	494	266	273	40382	0	41415
13753	39346	270	253	1487	0	41356
13754	1122	257	38368	793	0	40540
13755	37428	205	961	664	0	39258
13756	39526	184	366	644	0	40720
13757	1377	168	249	39358	0	41152
13758	39178	146	278	1388	0	40990
13759	1261	240	37529	673	0	39703
13760	37150	193	834	691	0	38868
13761	1305	41443	346	563	0	43657
13762	722	974	40807	426	0	42929
13763	529	395	41469	467	0	42860
13764	658	384	1153	40716	0	42911
13765	491	248	41495	1210	0	43444
13766	39464	201	1140	756	0	41561
13767	1161	40111	455	551	0	42278
13768	40170	931	307	565	0	41973
13769	1231	415	261	40453	0	42360
13770	596	267	40065	1306	0	42234
13771	401	233	40109	711	0	41454
13772	487	311	1173	40166	0	42137
13773	40508	226	457	1419	0	42610
13774	1131	39686	318	761	0	41896
13775	544	41587	291	673	0	43095
13776	41030	1049	349	708	0	43136
13777	1241	41461	343	520	0	43565
13778	41572	1059	294	529	0	43454
13779	1351	480	307	41333	0	43471
13780	41416	251	295	1241	0	43203
13781	1250	242	323	41473	0	43288
13782	41782	233	291	1335	0	43641
13783	1284	229	320	41432	0	43265
13784	668	41166	372	1184	0	43390
13785	41287	886	263	737	0	43173
13786	1209	41303	250	608	0	43370
13787	713	1017	39819	397	0	41946
13788	632	542	971	37864	0	40009
13789	499	40687	427	994	0	42607
13790	38838	994	307	565	0	40704
13791	39263	474	304	478	0	40519
13792	1330	38949	312	405	0	40996
13793	563	1052	38321	390	0	40326
13794	620	417	957	36814	0	38808
13795	469	36624	445	1086	0	38624
13796	474	996	364	38294	0	40128
13797	610	431	279	38717	0	40037
13798	37560	416	183	1332	0	39491
13799	1143	37361	268	661	0	39433
13800	613	923	268	37590	0	39394
13801	37498	509	236	1201	0	39444
13802	37526	334	217	733	0	38810
13803	37098	329	215	598	0	38240
13804	1436	341	203	36404	0	38384
13805	35474	289	205	1056	0	37024
13806	1217	35216	202	473	0	37108
13807	34931	906	228	460	0	36525
13808	1101	35101	151	511	0	36864
13809	35059	884	163	548	0	36654
13810	34855	360	132	562	0	35909
13811	1327	422	165	34101	0	36015
13812	668	253	34547	928	0	36396
13813	572	301	33380	473	0	34726
13814	541	34056	710	311	0	35618
13815	32761	747	346	424	0	34278
13816	950	356	32201	232	0	33739
13817	25324	168	286	208	0	25986
13818	418	26490	106	104	0	27118
13819	260	27557	84	91	0	27992
13820	233	418	69	28660	0	29380
13821	170	29593	65	354	0	30182
13822	186	466	30276	193	0	31121
13823	261	258	406	29231	0	30156
13824	181	30852	166	427	0	31626
13825	168	500	99	31217	0	31984
13826	30993	233	86	633	0	31945
13827	565	195	84	31354	0	32198
13828	274	177	31605	588	0	32644
13829	198	31592	507	287	0	32584
13830	227	582	211	31281	0	32301
13831	238	276	148	31496	0	32158
13832	174	216	119	32241	0	32750
13833	31384	179	102	872	0	32537
13834	30973	152	88	529	0	31742
13835	780	170	31258	261	0	32469
13836	388	184	30591	236	0	31399
13837	248	31441	649	258	0	32596
13838	31908	591	300	253	0	33052
13839	684	294	185	31960	0	33123
13840	395	201	147	32189	0	32932
13841	337	164	113	32425	0	33039
13842	350	150	95	32599	0	33194
13843	263	175	31282	923	0	32643
13844	30235	137	535	605	0	31512
13845	821	143	242	35606	0	36812
13846	388	165	35528	933	0	37014
13847	36036	149	837	560	0	37582
13848	40182	126	363	414	0	41085
13849	1354	168	44880	258	0	46660
13850	742	128	47002	229	0	48101
13851	596	141	1467	46288	0	48492
13852	46994	127	655	1403	0	49179
13853	47982	112	417	705	0	49216
13854	1789	150	300	46231	0	48470
13855	907	88	332	47820	0	49147
13856	488	139	47340	1627	0	49594
13857	602	241	1274	46454	0	48571
13858	460	133	47046	1604	0	49243
13859	44614	126	1348	913	0	47001
13860	1360	46978	726	585	0	49649
13861	44752	1020	376	525	0	46673
13862	1359	44636	388	356	0	46739
13863	44295	1180	368	403	0	46246
13864	1576	494	249	43038	0	45357
13865	936	279	240	43938	0	45393
13866	43898	239	173	1645	0	45955
13867	44482	182	167	863	0	45694
13868	44896	155	212	607	0	45870
13869	45408	158	179	525	0	46270
13870	2008	138	43910	403	0	46459
13871	43666	121	1175	459	0	45421
13872	45463	137	540	399	0	46539
13873	45680	129	348	372	0	46529
13874	2233	150	300	43817	0	46500
13875	42930	109	269	1400	0	44708
13876	1835	42480	303	716	0	45334
13877	1330	1052	252	42940	0	45574
13878	1093	447	224	44023	0	45787
13879	865	281	42895	1801	0	45842
13880	902	207	1320	41620	0	44049
13881	701	42685	689	1700	0	45775
13882	42563	1169	489	1060	0	45281
13883	1719	42782	446	808	0	45755
13884	43382	1317	327	815	0	45841
13885	2013	647	319	42908	0	45887
13886	42518	397	325	1786	0	45026
13887	1797	41929	335	1010	0	45071
13888	42700	1322	338	846	0	45206
13889	43316	680	329	771	0	45096
13890	2300	538	299	42132	0	45269
13891	1501	439	258	43159	0	45357
13892	1163	417	41874	1926	0	45380
13893	1168	431	1168	42362	0	45129
13894	1048	369	550	43104	0	45071
13895	964	310	42120	2124	0	45518
13896	1032	255	1286	42785	0	45358
13897	934	242	42091	2014	0	45281
13898	41932	217	1456	1197	0	44802
13899	2043	212	771	42195	0	45221
13900	1325	247	41219	1773	0	44564
13901	41426	221	1470	1054	0	44171
13902	2124	219	769	41838	0	44950
13903	1345	222	41976	1839	0	45382
13904	42327	192	1467	1235	0	45221
13905	2053	225	697	42868	0	45843
13906	1246	255	566	43778	0	45845
13907	43646	244	471	2292	0	46653
13908	1986	241	396	43807	0	46430
13909	1187	226	508	44467	0	46388
13910	1051	246	432	42694	0	44423
13911	953	42439	407	2268	0	46067
13912	41927	1303	355	1463	0	45048
13913	42816	659	327	1087	0	44889
13914	2275	450	325	41901	0	44951
13915	42255	384	277	2016	0	44932
13916	42438	288	307	1386	0	44419
13917	42830	336	327	1099	0	44592
13918	29727	424	524	1392	0	32067
13919	41623	243	403	992	0	43261
13920	2401	234	37537	949	0	41121
13921	1408	230	36266	920	0	38824
13922	36347	176	1461	862	0	38846
13923	1830	35776	746	894	0	39246
13924	1133	987	569	35583	0	38272
13925	883	447	35260	1602	0	38192
13926	889	266	35280	996	0	37431
13927	854	516	1555	34464	0	37389
13928	34601	279	1041	1607	0	37528
13929	1631	234	556	34710	0	37131
13930	950	241	34440	1628	0	37259
13931	35666	127	1232	1123	0	38148
13932	1614	167	745	36085	0	38611
13933	1065	119	523	36905	0	38612
13934	938	115	480	37287	0	38820
13935	901	129	372	36919	0	38321
13936	773	152	35235	2079	0	38239
13937	891	117	1109	35790	0	37907
13938	35518	128	549	1883	0	38078
13939	1457	126	33916	1319	0	36818
13940	34377	130	1050	1088	0	36645
13941	35838	161	473	1005	0	37477
13942	35724	172	418	858	0	37172
13943	35361	144	393	789	0	36687
13944	2025	33555	338	739	0	36657
13945	962	29122	242	513	0	30839
13946	844	29882	232	522	0	31480
13947	27842	1125	834	633	0	30434
13948	1090	301	25425	447	0	27263
13949	18991	243	545	200	0	19979
13950	548	85	172	18077	0	18882
13951	18066	44	84	365	0	18559
13952	354	38	74	18003	0	18469
13953	18010	34	76	381	0	18501
13954	366	36	68	17879	0	18349
13955	293	35	41	18172	0	18541
13956	16749	27	59	420	0	17255
13957	367	19215	56	209	0	19847
13958	232	197	19052	140	0	19621
13959	188	18624	215	133	0	19160
13960	149	161	17921	105	0	18336
13961	132	159	200	16996	0	17487
13962	17620	36	138	180	0	17974
13963	202	36	40	17366	0	17644
13964	17232	20	43	212	0	17507
13965	195	18112	36	113	0	18456
13966	162	130	18278	68	0	18638
13967	83	17990	138	70	0	18281
13968	78	18212	76	59	0	18425
13969	17444	140	76	88	0	17748
13970	16898	37	35	78	0	17048
13971	145	17137	34	36	0	17352
13972	72	105	30	17325	0	17532
13973	61	33	24	17415	0	17533
13974	17325	24	17	190	0	17556
13975	141	30	17456	62	0	17689
13976	73	25	16898	43	0	17039
13977	78	21	139	17230	0	17468
13978	42	32	17577	144	0	17795
13979	16151	22	143	133	0	16449
13980	17377	21	47	91	0	17536
13981	171	17371	42	31	0	17615
13982	85	134	17742	32	0	17993
13983	89	59	135	17636	0	17919
13984	62	34	18428	151	0	18675
13985	80	26	145	18261	0	18512
13986	18612	22	50	203	0	18887
13987	165	19015	38	75	0	19293
13988	90	146	19636	54	0	19926
13989	56	19693	160	55	0	19964
13990	46	20553	69	65	0	20733
13991	20724	176	40	112	0	21052
13992	19792	52	33	102	0	19979
13993	210	44	20530	59	0	20843
13994	82	20879	173	65	0	21199
13995	96	148	62	21157	0	21463
13996	73	56	34	21167	0	21330
13997	84	39	38	20886	0	21047
13998	64	35	21303	226	0	21628
13999	113	35	173	20888	0	21209
14000	78	47	65	21871	0	22061
14001	21993	34	49	279	0	22355
14002	21844	37	30	148	0	22059
14003	21751	45	43	133	0	21972
14004	21355	39	34	127	0	21555
14005	21336	38	35	99	0	21508
14006	236	21135	33	59	0	21463
14007	20530	144	33	82	0	20789
14008	196	74	20348	36	0	20654
14009	115	77	130	20206	0	20528
14010	20666	32	69	204	0	20971
14011	169	20539	40	84	0	20832
14012	20938	139	24	102	0	21203
14013	21243	61	24	119	0	21447
14014	226	28	30	21312	0	21596
14015	128	26	30	21546	0	21730
14016	74	22368	37	204	0	22683
14017	87	149	41	22892	0	23169
14018	78	74	23508	197	0	23857
14019	113	41	164	23514	0	23832
14020	59	45	23666	190	0	23960
14021	22149	31	196	175	0	22551
14022	228	40	72	23991	0	24331
14023	104	43	24189	204	0	24540
14024	78	23268	188	105	0	23639
14025	56	23957	81	70	0	24164
14026	23850	204	67	118	0	24239
14027	224	99	39	23926	0	24288
14028	88	54	24984	170	0	25296
14029	43	24272	168	94	0	24577
14030	51	176	24591	55	0	24873
14031	23097	76	177	129	0	23479
14032	23715	39	73	121	0	23948
14033	23869	31	56	117	0	24073
14034	237	40	48	23886	0	24211
14035	120	42	23868	162	0	24192
14036	77	23632	173	104	0	23986
14037	95	153	89	24033	0	24370
14038	70	98	23569	171	0	23908
14039	66	84	22697	79	0	22926
14040	95	39	214	23753	0	24101
14041	24216	30	113	256	0	24615
14042	203	34	81	24123	0	24441
14043	119	45	53	24383	0	24600
14044	81	41	24595	221	0	24938
14045	118	27	198	24250	0	24593
14046	110	32	90	24278	0	24510
14047	77	54	24574	240	0	24945
14048	77	38	23668	146	0	23929
14049	74	25	236	24399	0	24734
14050	58	47	24870	219	0	25194
14051	88	41	223	24692	0	25044
14052	24856	19	116	321	0	25312
14053	187	25543	109	137	0	25976
14054	122	147	77	26099	0	26445
14055	96	71	25651	236	0	26054
14056	22220	39	216	314	0	22789
14057	186	23798	105	129	0	24218
14058	24092	179	87	166	0	24524
14059	228	76	84	24129	0	24517
14060	121	60	74	24039	0	24294
14061	24572	22	103	396	0	25093
14062	225	53	24757	148	0	25183
14063	24050	28	209	214	0	24501
14064	250	40	113	25252	0	25655
14065	24563	28	79	340	0	25010
14066	24484	44	69	206	0	24803
14067	338	49	65	24605	0	25057
14068	153	25403	77	278	0	25911
14069	26091	238	82	217	0	26628
14070	26303	78	61	204	0	26646
14071	395	76	26315	96	0	26882
14072	25841	51	277	147	0	26316
14073	418	31	113	26265	0	26827
14074	182	26572	103	310	0	27167
14075	246	262	61	25908	0	26477
14076	122	26617	100	302	0	27141
14077	26503	296	70	195	0	27064
14078	27105	106	55	231	0	27497
14079	482	104	48	28746	0	29380
14080	232	73	28436	404	0	29145
14081	174	99	27885	218	0	28376
14082	181	53	465	29533	0	30232
14083	29660	52	238	481	0	30431
14084	31878	27	141	362	0	32408
14085	634	32132	126	158	0	33050
14086	401	456	97	32255	0	33209
14087	206	222	32886	573	0	33887
14088	147	155	33430	288	0	34020
14089	286	177	841	35502	0	36806
14090	37698	87	431	974	0	39190
14091	1019	56	190	38181	0	39446
14092	389	47	37828	1077	0	39341
14093	37507	49	967	545	0	39068
14094	1061	45	406	37695	0	39207
14095	524	57	258	38300	0	39139
14096	386	46	163	37692	0	38287
14097	214	37489	171	1309	0	39183
14098	227	844	37405	606	0	39082
14099	182	342	38268	432	0	39224
14100	240	191	1238	38088	0	39757
14101	182	117	38554	1090	0	39943
14102	37557	115	1145	622	0	39439
14103	1127	79	469	37913	0	39588
14104	534	74	349	38244	0	39201
14105	412	81	276	37972	0	38741
14106	205	37887	285	1451	0	39828
14107	38600	898	208	760	0	40466
14108	1127	331	166	38676	0	40300
14109	38095	228	212	1319	0	39854
14110	1187	38252	175	650	0	40264
14111	38191	1017	190	565	0	39963
14112	37191	366	220	523	0	38300
14113	38164	237	180	556	0	39137
14114	1486	36944	180	367	0	38977
14115	687	37214	222	308	0	38431
14116	36063	1133	182	375	0	37753
14117	1165	36572	142	369	0	38248
14118	571	1129	35405	313	0	37418
14119	428	34002	904	332	0	35666
14120	344	35983	387	293	0	37007
14121	35355	1195	281	352	0	37183
14122	1115	595	34965	235	0	36910
14123	552	419	34697	203	0	35871
14124	546	268	1203	34217	0	36234
14125	34877	238	555	1122	0	36792
14126	1240	200	34888	455	0	36783
14127	636	270	1035	34854	0	36795
14128	440	285	33356	1099	0	35180
14129	375	249	33250	551	0	34425
14130	32429	244	1265	441	0	34379
14131	1149	255	33743	234	0	35381
14132	604	236	1200	32893	0	34933
14133	539	236	562	32599	0	33936
14134	368	32434	434	1220	0	34456
14135	398	33884	385	621	0	35288
14136	420	1239	354	32654	0	34667
14137	317	571	33194	1162	0	35244
14138	423	378	1045	33105	0	34951
14139	311	312	602	33981	0	35206
14140	274	230	33794	1461	0	35759
14141	300	210	1172	34056	0	35738
14142	34135	191	691	1442	0	36459
14143	1121	233	34340	700	0	36394
14144	33988	227	1218	620	0	36053
14145	1344	187	686	34016	0	36233
14146	694	119	515	35042	0	36370
14147	507	34990	418	1603	0	37518
14148	404	1103	456	35256	0	37219
14149	408	455	337	36994	0	38194
14150	35878	313	392	1850	0	38433
14151	1282	270	373	36431	0	38356
14152	650	266	361	37199	0	38476
14153	35274	239	401	1915	0	37829
14154	1347	227	432	35703	0	37709
14155	761	219	382	34131	0	35493
14156	454	34892	424	1817	0	37587
14157	35074	1095	413	1111	0	37693
14158	1374	505	267	35550	0	37696
14159	745	394	262	36464	0	37865
14160	567	301	34999	1854	0	37721
14161	520	243	1168	34934	0	36865
14162	409	208	573	36071	0	37261
14163	34137	202	353	2022	0	36714
14164	34855	294	271	1148	0	36568
14165	1609	270	277	34444	0	36600
14166	858	254	33104	1550	0	35766
14167	620	31602	1124	851	0	34197
14168	452	33003	589	726	0	34770
14169	632	1373	468	32473	0	34946
14170	32497	567	270	1526	0	34860
14171	1280	401	215	32958	0	34854
14172	32881	296	149	1647	0	34973
14173	1381	303	205	33346	0	35235
14174	775	242	225	33802	0	35044
14175	32480	242	188	1820	0	34730
14176	32319	285	192	987	0	33783
14177	1578	32050	223	643	0	34494
14178	767	33179	186	597	0	34729
14179	520	1179	197	30157	0	32053
14180	481	555	179	31100	0	32315
14181	435	349	29745	1339	0	31868
14182	26908	193	945	876	0	28922
14183	1074	28375	411	579	0	30439
14184	326	26811	243	372	0	27752
14185	25630	890	248	391	0	27159
14186	927	317	25502	328	0	27074
14187	415	210	24589	276	0	25490
14188	314	215	22405	242	0	23176
14189	176	20549	522	185	0	21432
14190	121	295	312	18517	0	19245
14191	108	93	68	18578	0	18847
14192	98	95	38	18750	0	18981
14193	18098	70	42	491	0	18701
14194	18027	56	38	228	0	18349
14195	363	18006	44	161	0	18574
14196	158	295	43	18213	0	18709
14197	134	99	18194	336	0	18763
14198	77	18121	285	172	0	18655
14199	17690	297	97	201	0	18285
14200	346	122	17709	100	0	18277
14201	16129	88	262	163	0	16642
14202	334	82	17490	105	0	18011
14203	137	101	288	16879	0	17405
14204	93	17499	107	310	0	18009
14205	17647	269	77	206	0	18199
14206	298	18135	62	116	0	18611
14207	17801	328	32	160	0	18321
14208	377	92	28	17723	0	18220
14209	148	85	18290	359	0	18882
14210	158	52	309	19118	0	19637
14211	129	60	99	20767	0	21055
14212	74	70	20612	544	0	21300
14213	19463	59	433	283	0	20238
14214	462	21102	110	154	0	21828
14215	21027	442	82	181	0	21732
14216	511	21681	45	122	0	22359
14217	215	494	48	23073	0	23830
14218	119	139	22947	588	0	23793
14219	27161	93	535	265	0	28054
14220	785	28535	142	162	0	29624
14221	313	781	91	28142	0	29327
14222	255	250	69	29749	0	30323
14223	30968	187	46	1045	0	32246
14224	32542	93	65	465	0	33165
14225	1137	33023	60	246	0	34466
14226	34159	978	64	236	0	35437
14227	34650	313	67	232	0	35262
14228	35055	239	51	250	0	35595
14229	1486	162	34401	145	0	36194
14230	660	33252	946	180	0	35038
14231	382	35626	350	156	0	36514
14232	461	1266	210	33010	0	34947
14233	427	524	119	34883	0	35953
14234	34579	325	97	1332	0	36333
14235	1134	34520	126	556	0	36336
14236	34871	1126	85	380	0	36462
14237	1370	481	82	34105	0	36038
14238	649	304	67	35297	0	36317
14239	34256	228	85	1463	0	36032
14240	34499	177	72	661	0	35409
14241	1466	241	33176	399	0	35282
14242	841	213	944	32759	0	34757
14243	479	158	32409	1097	0	34143
14244	367	185	32209	517	0	33278
14245	362	187	32799	337	0	33685
14246	31315	181	1379	321	0	33196
14247	1142	177	616	30796	0	32731
14248	640	142	309	30623	0	31714
14249	492	165	232	32031	0	32920
14250	335	159	31254	1391	0	33139
14251	408	106	999	31267	0	32780
14252	440	150	407	32386	0	33383
14253	31470	100	297	1480	0	33347
14254	31978	148	211	781	0	33118
14255	32545	160	179	562	0	33446
14256	32712	123	224	451	0	33510
14257	1700	163	172	31451	0	33486
14258	31868	146	210	1215	0	33439
14259	1527	183	190	31496	0	33396
14260	834	210	29220	1324	0	31588
14261	30585	174	831	768	0	32358
14262	1404	30515	380	556	0	32855
14263	879	961	275	30333	0	32448
14264	775	486	204	30385	0	31850
14265	543	30720	203	1432	0	32898
14266	30608	1058	226	807	0	32699
14267	1354	30469	183	647	0	32653
14268	770	1122	30038	461	0	32391
14269	663	522	30322	463	0	31970
14270	29665	348	1251	486	0	31750
14271	30652	313	574	512	0	32051
14272	1595	229	29714	466	0	32004
14273	29777	260	1098	510	0	31645
14274	1509	207	29796	441	0	31953
14275	29772	233	1262	454	0	31721
14276	1563	247	29656	511	0	31977
14277	943	221	30215	487	0	31866
14278	813	241	1402	28257	0	30713
14279	748	266	771	28759	0	30544
14280	29593	212	594	1521	0	31920
14281	29046	222	438	950	0	30656
14282	29697	196	466	701	0	31060
14283	30548	195	394	592	0	31729
14284	1856	28876	398	560	0	31690
14285	1274	940	355	28318	0	30887
14286	953	29203	407	1202	0	31765
14287	881	1060	360	29635	0	31936
14288	810	511	392	29891	0	31604
14289	788	408	335	30014	0	31545
14290	725	365	28535	1694	0	31319
14291	27842	243	1112	1123	0	30320
14292	1402	27222	561	838	0	30023
14293	941	28836	446	767	0	30990
14294	808	1256	28826	666	0	31556
14295	792	572	1083	28900	0	31347
14296	768	375	680	29335	0	31158
14297	29160	315	442	1656	0	31573
14298	1495	301	467	29036	0	31299
14299	982	304	422	29836	0	31544
14300	797	246	474	30129	0	31646
14301	705	232	459	30554	0	31950
14302	29170	204	472	1884	0	31730
14303	29830	201	511	1035	0	31577
14304	30147	163	482	885	0	31677
14305	1895	188	396	29686	0	32165
14306	29758	184	449	1512	0	31903
14307	1629	184	418	30004	0	32235
14308	1084	199	430	30895	0	32608
14309	848	153	29079	1742	0	31822
14310	776	173	27739	1011	0	29699
14311	725	153	27112	729	0	28719
14312	26675	157	1366	600	0	28798
14313	1363	212	764	24826	0	27165
14314	859	25770	472	1177	0	28278
14315	26585	716	457	776	0	28534
14316	1311	377	25386	637	0	27711
14317	23705	243	884	555	0	25387
14318	1221	22605	539	467	0	24832
14319	18072	365	218	261	0	18916
14320	749	243	151	17849	0	18992
14321	17678	121	167	544	0	18510
14322	613	16708	150	389	0	17860
14323	390	16459	156	273	0	17278
14324	14680	357	203	205	0	15445
14325	375	14745	127	204	0	15451
14326	180	13076	90	90	0	13436
14327	194	13472	121	100	0	13887
14328	13002	307	271	103	0	13683
14329	12710	112	59	68	0	12949
14330	12694	84	38	60	0	12876
14331	291	78	31	12407	0	12807
14332	160	81	38	12566	0	12845
14333	119	72	12370	193	0	12754
14334	132	49	148	12379	0	12708
14335	122	78	12661	188	0	13049
14336	143	53	153	12698	0	13047
14337	112	56	60	13014	0	13242
14338	12902	41	64	243	0	13250
14339	12760	64	41	178	0	13043
14340	235	12776	56	98	0	13165
14341	153	187	41	12872	0	13253
14342	98	132	13291	197	0	13718
14343	120	86	153	13329	0	13688
14344	138	71	68	13513	0	13790
14345	128	58	53	13702	0	13941
14346	125	53	13432	270	0	13880
14347	104	57	12495	150	0	12806
14348	13017	37	181	170	0	13405
14349	186	45	118	13557	0	13906
14350	102	30	13349	245	0	13726
14351	12488	28	166	212	0	12894
14352	169	13381	122	133	0	13805
14353	13565	124	84	155	0	13928
14354	202	70	13871	110	0	14253
14355	13533	47	155	112	0	13847
14356	218	43	91	13932	0	14284
14357	123	65	14292	179	0	14659
14358	121	14127	150	146	0	14544
14359	14392	136	140	135	0	14803
14360	195	96	79	14427	0	14797
14361	135	45	76	14479	0	14735
14362	93	14692	90	212	0	15087
14363	98	117	73	14879	0	15167
14364	107	79	14745	190	0	15121
14365	94	14569	153	131	0	14947
14366	14752	139	108	138	0	15137
14367	191	104	71	14668	0	15034
14368	139	70	51	14589	0	14849
14369	93	81	14490	198	0	14862
14370	121	106	128	14487	0	14842
14371	113	73	15195	189	0	15570
14372	103	15178	160	119	0	15560
14373	15072	146	101	145	0	15464
14374	14987	92	81	122	0	15282
14375	15023	73	46	136	0	15278
14376	214	15728	79	87	0	16108
14377	138	161	52	15894	0	16245
14378	107	82	48	15936	0	16173
14379	151	101	88	12963	0	13303
14380	15755	57	43	274	0	16129
14381	15652	63	50	149	0	15914
14382	211	59	34	15715	0	16019
14383	138	59	16773	202	0	17172
14384	111	58	131	16719	0	17019
14385	104	34	75	16850	0	17063
14386	81	40	72	16932	0	17125
14387	70	38	51	17015	0	17174
14388	17056	28	73	274	0	17431
14389	174	51	44	17438	0	17707
14390	141	33	48	17383	0	17605
14391	91	17309	44	258	0	17702
14392	94	133	38	17922	0	18187
14393	82	18075	54	234	0	18445
14394	85	175	32	18208	0	18500
14395	18036	87	32	295	0	18450
14396	189	18168	32	176	0	18565
14397	17902	171	37	198	0	18308
14398	250	102	18105	106	0	18563
14399	141	53	174	17898	0	18266
14400	107	58	18380	252	0	18797
14401	83	48	200	18310	0	18641
14402	104	53	101	18304	0	18562
14403	69	17811	69	300	0	18249
14404	68	18158	52	213	0	18491
14405	68	18316	56	96	0	18536
14406	17972	173	28	182	0	18355
14407	147	17484	38	86	0	17755
14408	48	17503	21	75	0	17647
14409	148	144	24	17739	0	18055
14410	17784	53	22	172	0	18031
14411	119	18555	25	82	0	18781
14412	18770	138	19	104	0	19031
14413	18674	55	30	106	0	18865
14414	156	45	19429	67	0	19697
14415	92	46	108	19028	0	19274
14416	59	36	34	19798	0	19927
14417	54	40	29	19883	0	20006
14418	48	42	27	19575	0	19692
14419	48	37	18914	172	0	19171
14420	53	56	16726	78	0	16913
14421	17314	31	116	101	0	17562
14422	105	18416	38	46	0	18605
14423	43	18521	22	52	0	18638
14424	18582	139	21	67	0	18809
14425	115	18181	19	45	0	18360
14426	69	140	13	18266	0	18488
14427	18221	62	18	158	0	18459
14428	137	49	17987	64	0	18237
14429	70	47	110	18134	0	18361
14430	43	38	18226	154	0	18461
14431	17499	26	121	105	0	17751
14432	140	55	19881	40	0	20116
14433	20029	28	132	140	0	20329
14434	21152	24	66	129	0	21371
14435	21078	38	28	102	0	21246
14436	21109	27	31	90	0	21257
14437	21213	33	24	76	0	21346
14438	193	28	33	21276	0	21530
14439	21806	28	25	221	0	22080
14440	183	27	35	21889	0	22134
14441	98	34	23	21853	0	22008
14442	77	34	26	21852	0	21989
14443	68	42	21807	183	0	22100
14444	93	29	141	21226	0	21489
14445	88	30	53	22099	0	22270
14446	71	43	21662	188	0	21964
14447	19658	35	153	144	0	19990
14448	209	14	49	22059	0	22331
14449	98	31	22094	164	0	22387
14450	80	24	21327	82	0	21513
14451	105	19	162	21583	0	21869
14452	74	19	21960	170	0	22223
14453	83	24	162	21852	0	22121
14454	94	11	70	21599	0	21774
14455	61	21516	44	211	0	21832
14456	45	21981	49	95	0	22170
14457	21946	151	36	141	0	22274
14458	175	50	29	22229	0	22483
14459	116	36	36	21808	0	21996
14460	80	32	35	22544	0	22691
14461	76	35	22592	226	0	22929
14462	65	18	166	22081	0	22330
14463	22257	26	74	263	0	22620
14464	185	25	22704	120	0	23034
14465	102	19	171	23318	0	23610
14466	81	12	88	23482	0	23663
14467	71	18	54	23822	0	23965
14468	40	24743	62	242	0	25087
14469	24784	197	48	178	0	25207
14470	25493	63	49	164	0	25769
14471	333	26129	52	79	0	26593
14472	146	246	34	27303	0	27729
14473	79	93	27313	319	0	27804
14474	85	46	26271	152	0	26554
14475	27356	30	392	170	0	27948
14476	410	23	151	27995	0	28579
14477	28925	25	76	471	0	29497
14478	439	29027	80	216	0	29762
14479	198	29836	60	127	0	30221
14480	29660	526	44	190	0	30420
14481	468	30697	74	106	0	31345
14482	279	484	65	31028	0	31856
14483	217	203	62	29823	0	30305
14484	121	31995	59	584	0	32759
14485	32279	520	74	315	0	33188
14486	540	270	32510	161	0	33481
14487	31129	144	468	222	0	31963
14488	628	119	32981	109	0	33837
14489	30206	105	540	227	0	31078
14490	643	128	33083	135	0	33989
14491	309	32498	562	151	0	33520
14492	354	598	274	32525	0	33751
14493	32440	254	161	574	0	33429
14494	635	116	32020	230	0	33001
14495	297	132	31996	134	0	32559
14496	266	122	667	31316	0	32371
14497	189	85	32148	536	0	32958
14498	221	96	602	31508	0	32427
14499	296	93	307	30589	0	31285
14500	156	112	31735	725	0	32728
14501	263	65	587	31296	0	32211
14502	31997	70	362	695	0	33124
14503	542	31769	228	325	0	32864
14504	32221	469	186	322	0	33198
14505	641	246	209	31837	0	32933
14506	31942	122	164	706	0	32934
14507	32472	84	165	461	0	33182
14508	813	109	176	32077	0	33175
14509	402	32532	206	584	0	33724
14510	32938	473	173	448	0	34032
14511	660	260	31929	223	0	33072
14512	363	143	31399	221	0	32126
14513	31214	112	706	312	0	32344
14514	687	106	358	31212	0	32363
14515	398	109	31429	630	0	32566
14516	282	96	607	31321	0	32306
14517	31426	119	317	756	0	32618
14518	31845	101	204	440	0	32590
14519	31668	97	241	334	0	32340
14520	848	32373	182	278	0	33681
14521	557	517	143	32779	0	33996
14522	384	261	126	33197	0	33968
14523	32836	165	160	885	0	34046
14524	672	32803	173	426	0	34074
14525	32973	544	128	343	0	33988
14526	815	276	146	32747	0	33984
14527	32759	171	153	682	0	33765
14528	774	180	31574	343	0	32871
14529	464	31744	550	295	0	33053
14530	441	519	324	30497	0	31781
14531	346	32468	197	522	0	33533
14532	349	605	155	31090	0	32199
14533	30706	314	154	724	0	31898
14534	724	221	29533	381	0	30859
14535	28697	155	558	348	0	29758
14536	706	30168	346	250	0	31470
14537	504	544	207	30756	0	32011
14538	337	314	170	31280	0	32101
14539	30297	227	184	850	0	31558
14540	710	191	30123	482	0	31506
14541	505	168	538	30481	0	31692
14542	394	140	341	30547	0	31422
14543	331	170	207	30621	0	31329
14544	307	186	196	30850	0	31539
14545	30041	159	186	999	0	31385
14546	29858	142	145	676	0	30821
14547	876	175	29638	355	0	31044
14548	505	163	28269	333	0	29270
14549	29645	108	714	447	0	30914
14550	30927	119	337	398	0	31781
14551	889	127	219	30652	0	31887
14552	510	111	200	30825	0	31646
14553	30331	137	190	918	0	31576
14554	757	30016	191	509	0	31473
14555	483	466	219	30425	0	31593
14556	351	202	209	30966	0	31728
14557	371	132	30072	895	0	31470
14558	402	109	558	30083	0	31152
14559	293	127	30303	826	0	31549
14560	376	96	594	30242	0	31308
14561	29633	98	324	823	0	30878
14562	749	102	248	29947	0	31046
14563	463	99	29580	800	0	30942
14564	319	27828	576	543	0	29266
14565	355	474	312	29454	0	30595
14566	282	240	29297	752	0	30571
14567	292	29361	557	514	0	30724
14568	340	557	272	28863	0	30032
14569	293	278	28459	679	0	29709
14570	23468	116	516	654	0	24754
14571	515	27085	330	458	0	28388
14572	301	26189	185	265	0	26940
14573	206	26955	161	274	0	27596
14574	309	723	160	25826	0	27018
14575	177	237	27007	521	0	27942
14576	162	26810	484	323	0	27779
14577	267	630	233	26541	0	27671
14578	28245	211	138	577	0	29171
14579	606	140	77	36776	0	37599
14580	325	92	41545	989	0	42951
14581	186	41523	1043	391	0	43143
14582	40279	1069	326	429	0	42103
14583	1085	41319	231	350	0	42985
14584	417	1192	39058	262	0	40929
14585	219	39539	1157	287	0	41202
14586	466	1482	553	37932	0	40433
14587	260	736	38313	988	0	40297
14588	282	38141	1244	370	0	40037
14589	482	1482	503	36974	0	39441
14590	317	817	454	37169	0	38757
14591	86	37759	491	1409	0	39745
14592	228	1473	411	37837	0	39949
14593	99	737	37698	1604	0	40138
14594	130	583	38535	830	0	40078
14595	219	694	1393	38222	0	40528
14596	37635	513	580	1849	0	40577
14597	38298	488	526	1016	0	40328
14598	1335	554	544	37259	0	39692
14599	499	37770	673	1549	0	40491
14600	534	1287	656	38150	0	40627
14601	37819	466	627	1703	0	40615
14602	1584	481	333	37696	0	40094
14603	954	453	242	38600	0	40249
14604	37412	453	267	2016	0	40148
14605	1334	37295	292	1194	0	40115
14606	749	1450	256	37525	0	39980
14607	37028	588	234	2048	0	39898
14608	1586	430	35992	1144	0	39152
14609	36175	400	1146	1174	0	38895
14610	1716	434	420	36923	0	39493
14611	36982	419	356	1810	0	39567
14612	37370	482	362	1102	0	39316
14613	35458	364	352	1058	0	37232
14614	2004	35672	420	836	0	38932
14615	1227	1158	35854	714	0	38953
14616	1144	36245	1200	723	0	39312
14617	36293	1301	424	848	0	38866
14618	2019	36193	347	551	0	39110
14619	1353	1512	323	36293	0	39481
14620	35502	859	333	1531	0	38225
14621	1717	35605	382	679	0	38383
14622	898	1732	35511	602	0	38743
14623	974	962	1213	35432	0	38581
14624	923	820	35505	1582	0	38830
14625	773	35897	1359	1027	0	39056
14626	855	1632	603	35306	0	38396
14627	764	804	572	36347	0	38487
14628	714	792	594	36434	0	38534
14629	629	630	686	35140	0	37085
14630	470	35405	555	2045	0	38475
14631	34812	1649	458	1333	0	38252
14632	1484	895	34794	1156	0	38329
14633	724	738	1294	35638	0	38394
14634	34819	588	557	2241	0	38205
14635	1576	720	34933	1264	0	38493
14636	855	34659	1482	986	0	37982
14637	871	1734	771	34078	0	37454
14638	786	846	34533	1724	0	37889
14639	635	34620	1749	1071	0	38075
14640	33256	1630	865	1110	0	36861
14641	1579	34579	749	916	0	37823
14642	758	1847	719	34152	0	37476
14643	586	1109	604	35600	0	37899
14644	33940	921	607	2212	0	37680
14645	1582	34377	643	1243	0	37845
14646	908	1913	592	34614	0	38027
14647	33807	1085	574	2049	0	37515
14648	33931	951	447	1434	0	36763
14649	1883	33536	470	1274	0	37163
14650	33685	1780	371	1238	0	37074
14651	34487	1103	361	1043	0	36994
14652	2218	980	400	33411	0	37009
14653	1369	882	32637	1969	0	36857
14654	1418	752	1348	32570	0	36088
14655	1325	781	588	33590	0	36284
14656	1115	759	32282	2176	0	36332
14657	1080	31925	1463	1362	0	35830
14658	965	1567	684	32341	0	35557
14659	808	762	689	33633	0	35892
14660	696	647	762	33910	0	36015
14661	765	588	637	32820	0	34810
14662	731	32116	550	2510	0	35907
14663	32425	1547	515	1634	0	36121
14664	32844	870	326	1536	0	35576
14665	32511	631	262	1567	0	34971
14666	1985	30896	264	1555	0	34700
14667	1214	1540	288	31293	0	34335
14668	1081	858	30691	2082	0	34712
14669	1258	936	1142	30120	0	33456
14670	1271	31194	538	1820	0	34823
14671	30828	1520	363	1136	0	33847
14672	30929	886	351	1092	0	33258
14673	30693	769	421	1109	0	32992
14674	1777	29672	497	1070	0	33016
14675	1085	28186	583	891	0	30745
14676	1063	29494	422	891	0	31870
14677	1231	1579	28161	669	0	31640
14678	1323	1195	25731	664	0	28913
14679	1077	2511	838	14418	0	18844
14680	12353	80	363	315	0	13111
14681	12314	76	69	164	0	12623
14682	311	75	51	12512	0	12949
14683	147	69	49	12221	0	12486
14684	115	77	39	12685	0	12916
14685	120	75	42	12774	0	13011
14686	12609	83	30	381	0	13103
14687	12806	77	35	200	0	13118
14688	341	13022	42	135	0	13540
14689	13146	300	39	124	0	13609
14690	13363	130	37	115	0	13645
14691	13483	108	39	115	0	13745
14692	402	114	10643	133	0	11292
14693	12725	72	144	126	0	13067
14694	340	13148	75	100	0	13663
14695	185	286	54	13466	0	13991
14696	154	110	48	13558	0	13870
14697	119	12915	54	386	0	13474
14698	126	289	49	13803	0	14267
14699	13646	128	55	427	0	14256
14700	373	92	34	13841	0	14340
14701	173	75	13564	397	0	14209
14702	13084	69	270	230	0	13653
14703	368	13878	100	159	0	14505
14704	216	311	47	14021	0	14595
14705	182	152	23	14204	0	14561
14706	173	98	36	14330	0	14637
14707	137	96	13894	453	0	14580
14708	166	13757	272	216	0	14411
14709	145	313	86	13847	0	14391
14710	150	136	13583	363	0	14232
14711	148	103	276	13372	0	13899
14712	124	82	13359	396	0	13961
14713	137	102	304	13003	0	13546
14714	111	13106	121	361	0	13699
14715	113	290	73	13063	0	13539
14716	12939	113	65	400	0	13517
14717	12931	91	58	222	0	13302
14718	382	82	12775	160	0	13399
14719	161	69	11945	137	0	12312
14720	109	67	13528	145	0	13849
14721	103	66	336	13650	0	14155
14722	91	67	154	14339	0	14651
14723	91	44	88	14455	0	14678
14724	69	14513	80	480	0	15142
14725	83	317	77	14377	0	14854
14726	92	133	90	15045	0	15360
14727	104	94	70	15516	0	15784
14728	15234	73	59	561	0	15927
14729	15326	53	96	321	0	15796
14730	437	72	15394	206	0	16109
14731	186	67	15118	166	0	15537
14732	15253	47	438	189	0	15927
14733	16013	61	180	172	0	16426
14734	485	57	16294	148	0	16984
14735	258	49	15985	116	0	16408
14736	15942	60	457	148	0	16607
14737	16408	38	213	169	0	16828
14738	482	55	16566	138	0	17241
14739	258	46	387	16256	0	16947
14740	166	38	184	16695	0	17083
14741	125	17101	142	494	0	17862
14742	153	380	95	17604	0	18232
14743	126	122	18441	525	0	19214
14744	148	75	471	18493	0	19187
14745	133	60	214	18937	0	19344
14746	115	37	18429	625	0	19206
14747	17744	44	485	331	0	18604
14748	18831	48	217	235	0	19331
14749	617	36	186	18413	0	19252
14750	321	36	132	18869	0	19358
14751	18655	34	118	641	0	19448
14752	18497	47	136	338	0	19018
14753	16619	65	120	328	0	17132
14754	18819	32	107	223	0	19181
14755	625	18136	114	188	0	19063
14756	18013	379	102	237	0	18731
14757	535	17961	125	190	0	18811
14758	290	450	80	18064	0	18884
14759	224	147	96	18122	0	18589
14760	167	17655	123	603	0	18548
14761	185	422	95	18061	0	18763
14762	182	162	115	17850	0	18309
14763	173	17609	109	640	0	18531
14764	195	415	98	17836	0	18544
14765	206	136	99	18096	0	18537
14766	209	115	77	18175	0	18576
14767	181	100	17444	696	0	18421
14768	167	16931	451	352	0	17901
14769	200	519	165	16063	0	16947
14770	171	16856	120	485	0	17632
14771	16520	442	113	281	0	17356
14772	493	182	16484	255	0	17414
14773	226	127	15996	212	0	16561
14774	15338	112	452	181	0	16083
14775	466	131	214	15681	0	16492
14776	194	76	15255	438	0	15963
14777	165	88	14955	233	0	15441
14778	184	193	422	14661	0	15460
14779	14533	70	197	453	0	15253
14780	14673	74	134	268	0	15149
14781	452	60	94	14454	0	15060
14782	219	83	14038	450	0	14790
14783	160	14650	336	258	0	15404
14784	159	319	142	14806	0	15426
14785	140	134	14722	400	0	15396
14786	124	14579	334	224	0	15261
14787	139	310	145	14481	0	15075
14788	14475	108	134	430	0	15147
14789	346	99	113	14079	0	14637
14790	168	14306	111	378	0	14963
14791	14091	285	99	258	0	14733
14792	348	131	14877	194	0	15550
14793	175	14680	316	173	0	15344
14794	158	301	14673	164	0	15296
14795	14138	115	339	174	0	14766
14796	366	93	160	13754	0	14373
14797	161	76	139	14653	0	15029
14798	14565	52	128	396	0	15141
14799	342	56	118	14611	0	15127
14800	139	79	14247	388	0	14853
14801	13514	58	288	235	0	14095
14802	347	14229	129	202	0	14907
14803	202	250	111	14152	0	14715
14804	14043	92	122	356	0	14613
14805	331	13892	89	204	0	14516
14806	187	285	96	14330	0	14898
14807	14357	134	80	368	0	14939
14808	330	109	82	14349	0	14870
14809	156	14203	89	382	0	14830
14810	147	291	14511	213	0	15162
14811	172	118	245	14966	0	15501
14812	169	110	113	13881	0	14273
14813	15124	82	94	415	0	15715
14814	335	73	76	15209	0	15693
14815	15168	93	72	392	0	15725
14816	15302	68	78	231	0	15679
14817	400	78	71	15039	0	15588
14818	194	15192	45	376	0	15807
14819	166	293	41	15272	0	15772
14820	13916	108	41	424	0	14489
14821	297	14053	57	194	0	14601
14822	88	14530	40	131	0	14789
14823	14650	268	38	150	0	15106
14824	14729	105	43	143	0	15020
14825	291	14771	40	121	0	15223
14826	14846	280	62	125	0	15313
14827	14814	100	49	88	0	15051
14828	346	92	23	14818	0	15279
14829	154	72	15237	270	0	15733
14830	154	81	273	15191	0	15699
14831	97	45	15742	337	0	16221
14832	116	79	278	15686	0	16159
14833	76	41	15768	335	0	16220
14834	14940	26	275	155	0	15396
14835	290	36	124	15223	0	15673
14836	15746	30	66	308	0	16150
14837	341	59	55	15351	0	15806
14838	161	15858	35	289	0	16343
14839	16196	253	45	189	0	16683
14840	329	110	15240	92	0	15771
14841	14875	76	180	114	0	15245
14842	263	15320	97	55	0	15735
14843	14607	181	42	93	0	14923
14844	14783	77	34	59	0	14953
14845	277	14770	32	44	0	15123
14846	143	200	38	15274	0	15655
14847	15269	80	30	267	0	15646
14848	254	15239	43	101	0	15637
14849	154	233	21	15443	0	15851
14850	15546	87	31	285	0	15949
14851	302	58	17	15455	0	15832
14852	154	49	14	15585	0	15802
14853	125	37	24	15787	0	15973
14854	88	48	15363	344	0	15843
14855	102	54	226	15307	0	15689
14856	15508	44	80	336	0	15968
14857	303	43	15560	135	0	16041
14858	182	36	229	15708	0	16155
14859	108	52	86	15996	0	16242
14860	104	38	15649	342	0	16133
14861	14989	41	237	208	0	15475
14862	16108	49	94	157	0	16408
14863	359	35	16037	121	0	16552
14864	180	36	280	15867	0	16363
14865	126	33	99	16481	0	16739
14866	96	30	17375	391	0	17892
14867	130	24	295	17480	0	17929
14868	122	20	116	17294	0	17552
14869	79	51	18005	437	0	18572
14870	17380	24	320	268	0	17992
14871	346	29	135	18461	0	18971
14872	18344	32	84	425	0	18885
14873	18451	25	77	225	0	18778
14874	449	30	18459	170	0	19108
14875	235	31	310	18301	0	18877
14876	18664	26	133	432	0	19255
14877	375	19208	99	233	0	19915
14878	225	317	74	20136	0	20752
14879	177	91	88	20269	0	20625
14880	134	51	92	20959	0	21236
14881	93	41	20601	568	0	21303
14882	18813	29	374	329	0	19545
14883	414	26	159	20068	0	20667
14884	209	23	109	20197	0	20538
14885	147	31	19968	542	0	20688
14886	180	22	374	19818	0	20394
14887	163	24	154	20443	0	20784
14888	19856	28	119	597	0	20600
14889	405	19731	78	299	0	20513
14890	187	315	19639	216	0	20357
14891	19447	107	392	210	0	20156
14892	420	60	150	19392	0	20022
14893	210	46	19528	461	0	20245
14894	145	57	19577	233	0	20012
14895	145	41	444	19945	0	20575
14896	129	31	20456	472	0	21088
14897	125	22	20165	276	0	20588
14898	97	19716	476	215	0	20504
14899	126	310	197	21651	0	22284
14900	110	111	21860	454	0	22535
14901	130	72	394	21280	0	21876
14902	22821	50	192	544	0	23607
14903	414	43	129	23064	0	23650
14904	199	35	123	23635	0	23992
14905	23112	33	104	606	0	23855
14906	23261	47	120	311	0	23739
14907	514	34	134	24481	0	25163
14908	221	44	24774	495	0	25534
14909	124	24457	434	281	0	25296
14910	138	337	192	24883	0	25550
14911	24610	124	146	531	0	25411
14912	24692	70	118	310	0	25190
14913	492	24255	141	214	0	25102
14914	201	25051	115	199	0	25566
14915	25070	450	96	203	0	25819
14916	24911	156	98	208	0	25373
14917	537	92	25787	185	0	26601
14918	282	59	380	25048	0	25769
14919	180	25927	173	439	0	26719
14920	26642	344	146	297	0	27429
14921	483	189	118	26343	0	27133
14922	236	25619	101	449	0	26405
14923	162	375	26177	223	0	26937
14924	193	279	376	25055	0	25903
14925	125	26777	178	383	0	27463
14926	27211	381	106	265	0	27963
14927	27245	140	111	234	0	27730
14928	460	27126	86	143	0	27815
14929	26500	315	70	155	0	27040
14930	26437	110	71	154	0	26772
14931	412	25905	69	145	0	26531
14932	193	26495	80	112	0	26880
14933	189	366	78	26243	0	26876
14934	26067	147	64	405	0	26683
14935	359	105	26866	177	0	27507
14936	25161	80	278	179	0	25698
14937	334	27190	100	124	0	27748
14938	27308	291	79	176	0	27854
14939	27506	124	64	126	0	27820
14940	27516	78	62	127	0	27783
14941	460	87	52	26942	0	27541
14942	187	26970	68	305	0	27530
14943	27021	303	57	184	0	27565
14944	354	150	27255	110	0	27869
14945	166	26953	288	116	0	27523
14946	161	276	106	28327	0	28870
14947	117	129	27650	277	0	28173
14948	108	104	27580	115	0	27907
14949	169	77	313	27083	0	27642
14950	142	61	122	28904	0	29229
14951	133	57	85	29272	0	29547
14952	143	53	85	28703	0	28984
14953	113	27614	69	379	0	28175
14954	98	28977	63	161	0	29299
14955	29232	317	53	167	0	29769
14956	316	140	58	29341	0	29855
14957	199	89	46	29263	0	29597
14958	129	70	62	29702	0	29963
14959	29378	72	55	434	0	29939
14960	29538	62	58	234	0	29892
14961	369	58	54	29620	0	30101
14962	29738	63	40	392	0	30233
14963	29682	57	52	231	0	30022
14964	30055	68	34	187	0	30344
14965	415	85	48	29526	0	30074
14966	181	72	27821	266	0	28340
14967	154	77	25597	170	0	25998
14968	135	62	27106	113	0	27416
14969	137	49	28492	98	0	28776
14970	148	79	285	28608	0	29120
14971	28803	57	132	306	0	29298
14972	28561	43	72	188	0	28864
14973	328	45	28527	102	0	29002
14974	190	72	28018	84	0	28364
14975	125	30601	237	86	0	31049
14976	156	184	110	30918	0	31368
14977	30816	94	127	284	0	31321
14978	236	65	30449	94	0	30844
14979	28870	45	178	159	0	29252
14980	211	31523	100	72	0	31906
14981	137	170	63	32453	0	32823
14982	109	74	60	33314	0	33557
14983	130	51	61	32398	0	32640
14984	33556	50	52	388	0	34046
14985	286	42	45	33739	0	34112
14986	179	47	43	33986	0	34255
14987	33883	46	51	388	0	34368
14988	315	27	49	33789	0	34180
14989	172	51	34148	281	0	34652
14990	33149	43	209	257	0	33658
14991	309	40	119	34450	0	34918
14992	214	35	84	34015	0	34348
14993	113	34095	66	306	0	34580
14994	34480	220	45	251	0	34996
14995	34628	111	43	221	0	35003
14996	409	63	49	34152	0	34673
14997	201	64	33922	286	0	34473
14998	31129	34	252	282	0	31697
14999	323	39	33737	146	0	34245
15000	217	31	295	33078	0	33621
15001	168	25	154	34184	0	34531
15002	33446	41	84	495	0	34066
15003	378	31	86	34466	0	34961
15004	216	41	34267	376	0	34900
15005	32887	29	303	309	0	33528
15006	368	35	35865	154	0	36422
15007	208	68	34900	104	0	35280
15008	35280	25	475	143	0	35923
15009	513	112	198	36501	0	37324
15010	197	37894	137	351	0	38579
15011	38139	318	122	282	0	38861
15012	38095	142	75	195	0	38507
15013	527	79	37884	105	0	38595
15014	37348	33	370	170	0	37921
15015	532	45	181	38017	0	38775
15016	264	54	39093	361	0	39772
15017	166	38110	390	239	0	38905
15018	38023	312	249	231	0	38815
15019	437	38657	116	110	0	39320
15020	284	337	116	38450	0	39187
15021	207	168	104	38679	0	39158
15022	218	80	78	38608	0	38984
15023	201	62	69	37641	0	37973
15024	99	37708	95	552	0	38454
15025	162	346	36388	266	0	37162
15026	122	36832	342	202	0	37498
15027	36840	346	195	175	0	37556
15028	408	192	90	36966	0	37656
15029	37140	104	86	458	0	37788
15030	469	93	93	37211	0	37866
15031	37936	86	79	512	0	38613
15032	462	38498	91	252	0	39303
15033	39371	376	63	289	0	40099
15034	39648	164	80	270	0	40162
15035	38560	129	64	224	0	38977
15036	38922	76	63	238	0	39299
15037	575	38614	55	166	0	39410
15038	353	368	38761	108	0	39590
15039	252	188	359	38717	0	39516
15040	39061	117	176	468	0	39822
15041	39969	92	106	297	0	40464
15042	645	70	71	41011	0	41797
15043	349	106	41797	496	0	42748
15044	300	70	427	40413	0	41210
15045	228	41265	207	538	0	42238
15046	41459	486	107	331	0	42383
15047	641	242	99	41526	0	42508
15048	367	40642	100	567	0	41676
15049	265	42574	79	318	0	43236
15050	192	43631	88	236	0	44147
15051	218	731	92	44161	0	45202
15052	44375	315	84	682	0	45456
15053	656	44908	79	317	0	45960
15054	419	625	72	45476	0	46592
15055	45308	251	61	767	0	46387
15056	725	194	90	45471	0	46480
15057	45370	135	90	805	0	46400
15058	45469	134	55	480	0	46138
15059	891	46958	72	231	0	48152
15060	614	654	71	44706	0	46045
15061	287	47497	89	555	0	48428
15062	47060	703	97	367	0	48227
15063	47127	356	58	311	0	47852
15064	48096	231	84	280	0	48691
15065	1012	138	103	47987	0	49240
15066	533	169	47378	695	0	48775
15067	45709	200	578	451	0	46938
15068	47543	183	235	312	0	48273
15069	1017	161	125	46482	0	47785
15070	544	47673	101	704	0	49022
15071	468	669	80	48049	0	49266
15072	376	374	87	48950	0	49787
15073	48572	230	85	979	0	49866
15074	47809	206	87	562	0	48664
15075	987	206	45700	308	0	47201
15076	619	156	578	45648	0	47001
15077	46587	170	234	817	0	47808
15078	934	184	134	46721	0	47973
15079	452	193	46869	925	0	48439
15080	366	43734	664	508	0	45272
15081	363	46442	239	316	0	47360
15082	50456	781	127	359	0	51723
15083	1053	354	96	52685	0	54188
15084	584	228	84	57607	0	58503
15085	56919	180	99	1548	0	58746
15086	1409	180	56636	741	0	58966
15087	831	151	1053	57135	0	59170
15088	550	188	57521	1405	0	59664
15089	434	57753	1242	789	0	60218
15090	59482	1130	603	688	0	61903
15091	61002	516	375	583	0	62476
15092	62008	354	300	435	0	63097
15093	1953	307	59942	401	0	62603
15094	60445	279	1172	459	0	62355
15095	62456	255	620	361	0	63692
15096	2155	252	319	61261	0	63987
15097	48361	299	616	1755	0	51031
15098	1432	259	59953	723	0	62367
15099	58900	194	1135	619	0	60848
15100	1787	186	60177	398	0	62548
15101	1077	60677	1276	456	0	63486
15102	898	1513	759	56842	0	60012
15103	733	60928	460	1129	0	63250
15104	776	1251	60014	527	0	62568
15105	590	60917	1262	497	0	63266
15106	57960	1270	549	430	0	60209
15107	1235	57159	465	314	0	59173
15108	757	57607	310	319	0	58993
15109	694	1459	56010	257	0	58420
15110	576	825	1160	55353	0	57914
15111	56074	534	585	1186	0	58379
15112	1301	492	55829	564	0	58186
15113	805	55870	1191	456	0	58322
15114	700	1200	638	55446	0	57984
15115	548	687	56591	1188	0	59014
15116	563	454	55212	669	0	56898
15117	511	477	1573	55879	0	58440
15118	484	397	56459	1264	0	58604
15119	507	363	1478	52169	0	54517
15120	453	53063	817	1240	0	55573
15121	524	1138	663	54274	0	56599
15122	375	54986	576	1243	0	57180
15123	558	1264	486	55478	0	57786
15124	54585	687	459	1499	0	57230
15125	1356	529	403	54665	0	56953
15126	696	53876	404	1478	0	56454
15127	554	1298	375	55914	0	58141
15128	545	633	54760	1523	0	57461
15129	501	530	1225	55473	0	57729
15130	55137	407	716	1575	0	57835
15131	1256	415	53429	919	0	56019
15132	725	425	1296	53556	0	56002
15133	52398	322	744	1549	0	55013
15134	1283	51910	560	950	0	54703
15135	867	1201	526	52379	0	54973
15136	52940	672	409	1532	0	55553
15137	1481	491	470	52941	0	55383
15138	864	438	51767	1533	0	54602
15139	49980	450	1163	1070	0	52663
15140	1401	51212	790	720	0	54123
15141	745	51762	544	765	0	53816
15142	51429	1295	536	653	0	53913
15143	50479	729	462	580	0	52250
15144	1600	602	375	50120	0	52697
15145	50676	446	462	1190	0	52774
15146	1440	532	48301	826	0	51099
15147	48751	402	1073	763	0	50989
15148	1429	48954	679	630	0	51692
15149	49113	990	525	710	0	51338
15150	1464	620	48181	539	0	50804
15151	1063	585	1101	48650	0	51399
15152	855	442	790	49076	0	51163
15153	711	503	613	44996	0	46823
15154	711	48075	482	1359	0	50627
15155	48616	1020	499	926	0	51061
15156	1446	622	449	44038	0	46555
15157	939	45642	478	1220	0	48279
15158	49808	1041	374	1017	0	52240
15159	48280	636	483	800	0	50199
15160	49300	543	439	793	0	51075
15161	49219	511	369	778	0	50877
15162	48179	461	399	709	0	49748
15163	1785	488	447	47938	0	50658
15164	1371	444	421	47660	0	49896
15165	47232	456	376	1582	0	49646
15166	1473	538	374	47509	0	49894
15167	1146	520	403	47311	0	49380
15168	851	539	43564	1736	0	46690
15169	45616	513	1034	1190	0	48353
15170	46606	491	714	1123	0	48934
15171	47217	591	523	863	0	49194
15172	1792	534	510	42691	0	45527
15173	1091	45327	458	1376	0	48252
15174	49722	1006	496	949	0	52173
15175	47078	642	463	1027	0	49210
15176	1934	526	426	50988	0	53874
15177	50786	474	480	1619	0	53359
15178	2035	771	37088	1345	0	41239
15179	1242	50148	962	949	0	53301
15180	1197	51744	685	1034	0	54660
15181	1332	1388	50448	860	0	54028
15182	625	44749	1106	757	0	47237
15183	661	42835	665	775	0	44936
15184	38702	698	584	547	0	40531
15185	640	38443	318	553	0	39954
15186	592	712	245	38475	0	40024
15187	38819	423	204	902	0	40348
15188	813	349	37700	612	0	39474
15189	36442	354	445	667	0	37908
15190	857	353	35969	502	0	37681
15191	601	236	35386	462	0	36685
15192	34179	229	636	573	0	35617
15193	746	211	35895	438	0	37290
15194	541	35022	565	337	0	36465
15195	536	469	396	34731	0	36132
15196	35112	337	265	623	0	36337
15197	754	34107	160	450	0	35471
15198	598	489	200	34408	0	35695
15199	516	331	34109	616	0	35572
15200	605	253	418	34207	0	35483
15201	33505	218	325	736	0	34784
15202	765	204	32862	448	0	34279
15203	777	213	436	32456	0	33882
15204	32839	279	305	650	0	34073
15205	33635	206	255	501	0	34597
15206	1044	196	169	33132	0	34541
15207	806	206	138	33039	0	34189
15208	558	212	33585	718	0	35073
15209	513	142	32197	474	0	33326
15210	32839	109	606	429	0	33983
15211	34090	149	335	356	0	34930
15212	862	33713	232	240	0	35047
15213	33670	372	232	210	0	34484
15214	34187	240	181	321	0	34929
15215	783	206	36104	265	0	37358
15216	553	36983	496	227	0	38259
15217	37086	474	344	294	0	38198
15218	37199	253	173	203	0	37828
15219	37893	177	114	188	0	38372
15220	887	138	73	36996	0	38094
15221	613	119	54	37068	0	37854
15222	397	36832	78	643	0	37950
15223	301	467	75	37606	0	38449
15224	37356	235	55	721	0	38367
15225	695	162	64	37560	0	38481
15226	413	118	36973	667	0	38171
15227	339	93	35850	414	0	36696
15228	358	61	612	36647	0	37678
15229	232	72	37237	613	0	38154
15230	219	71	36303	417	0	37010
15231	292	62	730	36066	0	37150
15232	233	74	427	37397	0	38131
15233	214	65	37608	721	0	38608
15234	231	77	37025	445	0	37778
15235	204	37567	707	330	0	38808
15236	37495	515	424	274	0	38708
15237	571	38467	311	178	0	39527
15238	38202	573	192	236	0	39203
15239	38728	315	147	216	0	39406
15240	728	38677	151	162	0	39718
15241	38935	577	144	155	0	39811
15242	790	294	111	38419	0	39614
15243	412	217	39178	569	0	40376
15244	371	133	573	38449	0	39526
15245	236	128	300	39788	0	40452
15246	37805	109	219	902	0	39035
15247	38086	89	160	547	0	38882
15248	38366	70	124	372	0	38932
15249	38300	91	113	268	0	38772
15250	36679	58	143	212	0	37092
15251	977	35424	134	154	0	36689
15252	584	521	106	36252	0	37463
15253	420	255	36879	590	0	38144
15254	324	204	587	36758	0	37873
15255	319	112	299	37038	0	37768
15256	286	77	222	39630	0	40215
15257	42062	85	179	1104	0	43430
15258	995	75	154	42366	0	43590
15259	43029	93	115	1197	0	44434
15260	1196	110	43258	543	0	45107
15261	710	81	886	49079	0	50756
15262	476	87	50476	1351	0	52390
15263	50139	76	1370	714	0	52299
15264	1493	87	541	51034	0	53155
15265	645	118	51684	1475	0	53922
15266	599	89	1340	51938	0	53966
15267	52237	63	660	1732	0	54692
15268	1452	96	51725	819	0	54092
15269	52607	52	1329	774	0	54762
15270	54588	47	646	604	0	55885
15271	54375	53	457	560	0	55445
15272	53190	53	378	549	0	54170
15273	2077	51121	352	450	0	54000
15274	1032	48313	302	375	0	50022
15275	780	46335	316	421	0	47852
15276	758	1950	467	43819	0	46994
15277	487	45555	301	1084	0	47427
15278	44919	1171	281	559	0	46930
15279	1289	43416	309	418	0	45432
15280	681	44909	259	328	0	46177
15281	653	1319	245	44513	0	46730
15282	559	615	247	45736	0	47157
15283	44907	420	287	1574	0	47188
15284	1481	372	252	45120	0	47225
15285	800	321	44014	1432	0	46567
15286	685	317	41880	707	0	43589
15287	630	276	44447	575	0	45928
15288	746	304	1399	43838	0	46287
15289	766	261	602	46895	0	48524
15290	632	304	45560	1579	0	48075
15291	597	358	44139	784	0	45878
15292	588	377	45815	519	0	47299
15293	45781	363	1631	561	0	48336
15294	1483	425	762	46146	0	48816
15295	722	420	509	47215	0	48866
15296	46443	402	415	1831	0	49091
15297	1479	371	380	46316	0	48546
15298	680	45411	382	1706	0	48179
15299	543	48016	379	993	0	49931
15300	582	1472	374	48016	0	50444
15301	47924	627	384	1750	0	50685
15302	48360	398	399	1104	0	50261
15303	49134	274	463	917	0	50788
15304	1924	220	458	48352	0	50954
15305	899	215	47581	1725	0	50420
15306	702	183	1521	47681	0	50087
15307	581	194	47799	1751	0	50325
15308	45608	159	1723	1037	0	48527
15309	1625	204	911	46745	0	49485
15310	44824	164	686	1827	0	47501
15311	1607	120	45947	1052	0	48726
15312	42846	147	1525	981	0	45499
15313	1818	180	46773	713	0	49484
15314	1109	43648	1476	679	0	46912
15315	817	44303	682	695	0	46497
15316	43180	1431	558	658	0	45827
15317	1762	644	335	42904	0	45645
15318	966	462	43088	1496	0	46012
15319	799	41890	1204	781	0	44674
15320	657	44083	582	634	0	45956
15321	724	1541	446	43624	0	46335
15322	43756	674	449	1602	0	46481
15323	44152	444	382	911	0	45889
15324	1771	43564	423	730	0	46488
15325	44050	1284	435	699	0	46468
15326	1706	582	467	43810	0	46565
15327	957	398	43310	1561	0	46226
15328	669	43576	1444	887	0	46576
15329	792	1304	763	43946	0	46805
15330	720	586	567	44920	0	46793
15331	44203	436	515	1803	0	46957
15332	1579	431	43608	873	0	46491
15333	43275	413	1394	693	0	45775
15334	44483	363	748	684	0	46278
15335	1840	416	572	43458	0	46286
15336	1010	433	502	44581	0	46526
15337	42867	466	462	1841	0	45636
15338	1664	430	416	43364	0	45874
15339	912	436	42256	1681	0	45285
15340	715	358	41974	940	0	43987
15341	692	41154	1467	744	0	44057
15342	713	44624	626	689	0	46652
15343	780	1491	459	41166	0	43896
15344	668	41425	374	1453	0	43920
15345	42576	1437	369	911	0	45293
15346	1502	43202	339	760	0	45803
15347	848	1408	354	43348	0	45958
15348	696	662	407	44442	0	46207
15349	577	546	43257	1820	0	46200
15350	684	416	1309	43143	0	45552
15351	654	341	626	44260	0	45881
15352	674	44213	459	1887	0	47233
15353	709	1219	457	43976	0	46361
15354	704	487	417	45263	0	46871
15355	748	379	43443	1967	0	46537
15356	511	42020	1349	1124	0	45004
15357	465	2517	503	36400	0	39885
15358	356	38472	381	1226	0	40435
15359	343	983	36996	711	0	39033
15360	256	36204	1032	486	0	37978
15361	29764	782	598	371	0	31515
15362	29047	269	173	234	0	29723
15363	29038	186	119	200	0	29543
15364	619	28806	109	161	0	29695
15365	28417	519	73	208	0	29217
15366	593	239	79	28065	0	28976
15367	27313	178	83	588	0	28162
15368	545	26644	95	279	0	27563
15369	26438	527	71	263	0	27299
15370	27237	227	77	275	0	27816
15371	670	27778	77	180	0	28705
15372	322	599	27828	144	0	28893
15373	295	282	539	29853	0	30969
15374	189	193	31483	710	0	32575
15375	222	166	762	32012	0	33162
15376	205	155	253	33661	0	34274
15377	144	167	33834	1042	0	35187
15378	227	135	785	33930	0	35077
15379	34150	121	288	1062	0	35621
15380	874	105	34473	420	0	35872
15381	357	34431	830	304	0	35922
15382	364	809	302	33482	0	34957
15383	264	296	181	35274	0	36015
15384	183	221	34619	1075	0	36098
15385	247	178	802	32980	0	34207
15386	167	34101	292	960	0	35520
15387	33119	786	216	517	0	34638
15388	735	33303	184	300	0	34522
15389	31432	792	110	288	0	32622
15390	745	31666	118	187	0	32716
15391	267	33371	128	171	0	33937
15392	213	929	32197	189	0	33528
15393	237	395	784	32116	0	33532
15394	236	246	255	31682	0	32419
15395	205	171	182	33213	0	33771
15396	124	34996	186	1053	0	36359
15397	183	929	115	35432	0	36659
15398	35640	376	120	1246	0	37382
15399	1030	267	155	35760	0	37212
15400	35667	202	139	1351	0	37359
15401	1164	146	35442	627	0	37379
15402	35422	152	1007	501	0	37082
15403	1245	168	410	35427	0	37250
15404	543	186	274	37382	0	38385
15405	37015	204	215	1520	0	38954
15406	1153	197	37126	749	0	39225
15407	435	36772	1062	580	0	38849
15408	413	1036	417	37495	0	39361
15409	37289	469	316	1280	0	39354
15410	38157	347	208	656	0	39368
15411	1536	276	144	37808	0	39764
15412	682	229	37306	1325	0	39542
15413	35955	250	1099	667	0	37971
15414	1238	232	36801	536	0	38807
15415	656	263	1231	36462	0	38612
15416	440	199	36926	1345	0	38910
15417	399	237	1205	36587	0	38428
15418	299	182	35812	1511	0	37804
15419	339	35450	1194	786	0	37769
15420	519	1075	530	31791	0	33915
15421	339	36272	370	1075	0	38056
15422	36405	1157	244	624	0	38430
15423	37036	478	273	514	0	38301
15424	1532	351	35924	405	0	38212
15425	854	233	1138	35819	0	38044
15426	36445	202	505	1353	0	38505
15427	1350	173	399	36324	0	38246
15428	728	172	302	36705	0	37907
15429	526	195	35258	1631	0	37610
15430	33691	192	1152	957	0	35992
15431	1276	183	35550	642	0	37651
15432	768	179	1305	35172	0	37424
15433	521	156	35631	1396	0	37704
15434	34991	172	1309	882	0	37354
15435	35764	134	749	699	0	37346
15436	35842	195	521	587	0	37145
15437	1688	178	439	35012	0	37317
15438	843	236	34423	1354	0	36856
15439	603	202	34676	799	0	36280
15440	606	324	1453	30819	0	33202
15441	420	34027	840	1179	0	36466
15442	33285	993	543	770	0	35591
15443	1338	497	413	33470	0	35718
15444	786	359	33267	1384	0	35796
15445	726	242	1186	33760	0	35914
15446	544	203	34353	1558	0	36658
15447	615	164	1361	34774	0	36914
15448	526	181	34888	1523	0	37118
15449	547	178	34734	892	0	36351
15450	431	33781	1541	818	0	36571
15451	502	929	33946	633	0	36010
15452	510	424	34214	563	0	35711
15453	781	351	1562	27258	0	29952
15454	550	207	862	30781	0	32400
15455	520	32512	626	1332	0	34990
15456	32585	900	587	862	0	34934
15457	1287	32594	492	661	0	35034
15458	788	1060	509	32456	0	34813
15459	32692	472	483	1324	0	34971
15460	1277	314	515	32705	0	34811
15461	32581	227	568	1459	0	34835
15462	1316	183	512	33009	0	35020
15463	672	249	32994	1476	0	35391
15464	588	243	1200	33327	0	35358
15465	568	204	727	34378	0	35877
15466	33635	229	641	1643	0	36148
15467	33978	190	577	1059	0	35804
15468	33504	187	559	776	0	35026
15469	1528	31760	620	624	0	34532
15470	788	32354	474	631	0	34247
15471	32039	1008	581	593	0	34221
15472	1151	522	32126	595	0	34394
15473	644	322	30662	463	0	32091
15474	641	837	1246	27858	0	30582
15475	351	161	28404	973	0	29889
15476	358	137	27336	598	0	28429
15477	25839	144	1066	539	0	27588
15478	26691	112	614	404	0	27821
15479	1024	26296	397	390	0	28107
15480	590	26889	316	394	0	28189
15481	573	815	328	22823	0	24539
15482	356	26353	319	696	0	27724
15483	26760	733	315	515	0	28323
15484	895	370	287	25498	0	27050
15485	507	26678	260	813	0	28258
15486	27307	653	325	483	0	28768
15487	806	337	27225	440	0	28808
15488	503	254	26977	314	0	28048
15489	26444	147	970	397	0	27958
15490	825	129	26170	303	0	27427
15491	25625	93	791	315	0	26824
15492	811	175	467	25894	0	27347
15493	410	141	25958	663	0	27172
15494	336	24964	756	389	0	26445
15495	252	25699	446	350	0	26747
15496	22751	470	231	214	0	23666
15497	434	23172	178	154	0	23938
15498	21816	360	147	158	0	22481
15499	21830	143	133	138	0	22244
15500	431	21723	145	90	0	22389
15501	206	332	127	21617	0	22282
15502	133	125	22168	327	0	22753
15503	91	23195	371	140	0	23797
15504	144	641	183	22266	0	23234
15505	136	151	139	24078	0	24504
15506	23464	84	65	493	0	24106
15507	411	61	64	23484	0	24020
15508	150	79	23229	473	0	23931
15509	97	23275	368	193	0	23933
15510	127	408	125	23594	0	24254
15511	24078	139	109	480	0	24806
15512	24896	90	73	225	0	25284
15513	565	72	73	24963	0	25673
15514	25610	65	67	553	0	26295
15515	590	57	25767	210	0	26624
15516	287	48	516	25610	0	26461
15517	177	61	26273	567	0	27078
15518	204	51	576	27728	0	28559
15519	159	57	234	27758	0	28208
15520	176	74	134	27930	0	28314
15521	147	46	93	27829	0	28115
15522	165	58	75	27655	0	27953
15523	27185	52	76	1050	0	28363
15524	27669	40	67	512	0	28288
15525	831	27487	82	322	0	28722
15526	27979	625	83	301	0	28988
15527	836	228	75	27986	0	29125
15528	426	120	74	28556	0	29176
15529	361	71	77	28567	0	29076
15530	245	72	28411	1009	0	29737
15531	293	76	686	26669	0	27724
15532	169	27984	266	869	0	29288
15533	27934	639	179	493	0	29245
15534	28032	218	128	432	0	28810
15535	923	121	27561	338	0	28943
15536	394	27489	686	334	0	28903
15537	325	648	239	27690	0	28902
15538	229	246	28096	898	0	29469
15539	317	163	687	26199	0	27366
15540	225	27601	272	918	0	29016
15541	26842	681	191	529	0	28243
15542	781	27505	151	356	0	28793
15543	376	763	27480	341	0	28960
15544	297	315	27513	316	0	28441
15545	223	26548	814	339	0	27924
15546	190	27233	311	343	0	28077
15547	26221	814	248	376	0	27659
15548	26589	346	166	299	0	27400
15549	913	225	161	26411	0	27710
15550	414	203	26345	825	0	27787
15551	368	199	675	26228	0	27470
15552	317	172	278	26744	0	27511
15553	26272	138	207	1074	0	27691
15554	25994	179	203	535	0	26911
15555	939	177	175	27671	0	28962
15556	437	185	27760	931	0	29313
15557	277	28105	801	463	0	29646
15558	28107	810	309	401	0	29627
15559	888	29162	233	303	0	30586
15560	471	888	208	29637	0	31204
15561	345	394	199	30924	0	31862
15562	293	297	249	30875	0	31714
15563	282	238	213	30418	0	31151
15564	29359	277	152	1324	0	31112
15565	1026	221	142	29180	0	30569
15566	516	28541	169	1126	0	30352
15567	384	786	162	28998	0	30330
15568	27919	326	211	1237	0	29693
15569	888	28201	194	668	0	29951
15570	505	844	165	28329	0	29843
15571	389	382	27641	1097	0	29509
15572	27262	276	757	632	0	28927
15573	1056	240	316	27861	0	29473
15574	514	207	27411	1077	0	29209
15575	363	215	27168	623	0	28369
15576	394	278	1015	27236	0	28923
15577	27017	193	522	1172	0	28904
15578	27374	200	257	701	0	28532
15579	1035	28095	190	618	0	29938
15580	28119	758	185	653	0	29715
15581	28612	342	164	623	0	29741
15582	28573	237	170	608	0	29588
15583	28478	239	182	558	0	29457
15584	1268	231	161	27814	0	29474
15585	652	244	179	28138	0	29213
15586	513	215	26501	1239	0	28468
15587	423	25222	716	757	0	27118
15588	338	26426	353	602	0	27719
15589	332	868	26257	540	0	27997
15590	25787	376	772	556	0	27491
15591	951	242	379	26338	0	27910
15592	26407	203	259	1081	0	27950
15593	26445	237	234	592	0	27508
15594	1196	234	25550	447	0	27427
15595	714	214	737	25514	0	27179
15596	25916	176	353	978	0	27423
15597	1054	181	236	25740	0	27211
15598	562	219	25460	1009	0	27250
15599	517	742	772	23903	0	25934
15600	430	25694	376	881	0	27381
15601	415	26715	261	508	0	27899
15602	420	822	25577	363	0	27182
15603	329	24557	688	326	0	25900
15604	23315	763	412	390	0	24880
15605	23174	249	169	278	0	23870
15606	817	152	150	22690	0	23809
15607	447	102	134	22918	0	23601
15608	329	126	143	23346	0	23944
15609	22608	120	90	828	0	23646
15610	656	22622	116	366	0	23760
15611	21945	480	93	269	0	22787
15612	21549	197	107	210	0	22063
15613	688	21439	112	196	0	22435
15614	20385	384	83	205	0	21057
15615	493	20672	83	185	0	21433
15616	20746	406	96	238	0	21486
15617	502	172	20306	184	0	21164
15618	18041	174	387	155	0	18757
15619	374	19005	136	120	0	19635
15620	288	293	141	19178	0	19900
15621	203	101	45	20101	0	20450
15622	172	83	42	20240	0	20537
15623	20583	50	48	574	0	21255
15624	420	93	61	20762	0	21336
15625	239	95	20255	458	0	21047
15626	19506	89	311	273	0	20179
15627	395	132	20065	157	0	20749
15628	293	131	337	20035	0	20796
15629	185	125	20467	422	0	21199
15630	180	110	350	19530	0	20170
15631	145	19998	188	425	0	20756
15632	177	322	133	19713	0	20345
15633	142	20068	99	426	0	20735
15634	161	345	104	20318	0	20928
15635	20385	167	71	493	0	21116
15636	418	135	72	21025	0	21650
15637	20995	79	66	503	0	21643
15638	465	102	20086	240	0	20893
15639	20274	86	323	238	0	20921
15640	20829	84	138	191	0	21242
15641	20937	78	131	159	0	21305
15642	583	73	99	20834	0	21589
15643	20520	57	109	438	0	21124
15644	469	97	19710	224	0	20500
15645	19589	90	322	240	0	20241
15646	484	84	19628	172	0	20368
15647	19865	91	344	197	0	20497
15648	537	76	151	20280	0	21044
15649	300	95	20664	368	0	21427
15650	310	72	335	20576	0	21293
15651	258	53	196	21043	0	21550
15652	231	39	20817	480	0	21567
15653	18973	44	323	377	0	19717
15654	408	20772	188	238	0	21606
15655	19888	215	110	200	0	20413
15656	297	19755	93	139	0	20284
15657	19331	219	82	181	0	19813
15658	298	98	19090	113	0	19599
15659	17246	110	344	180	0	17880
15660	247	17911	117	90	0	18365
15661	165	150	80	17890	0	18285
15662	129	62	51	18525	0	18767
15663	112	59	57	18621	0	18849
15664	109	40	18764	255	0	19168
15665	102	42	183	18593	0	18920
15666	88	49	19793	257	0	20187
15667	20114	30	240	179	0	20563
15668	21538	29	107	157	0	21831
15669	373	31	92	21805	0	22301
15670	171	37	21978	333	0	22519
15671	20738	20	310	229	0	21297
15672	355	33	25604	119	0	26111
15673	222	29	405	25174	0	25830
15674	190	31	151	25976	0	26348
15675	132	20	125	26593	0	26870
15676	150	20	87	27003	0	27260
15677	26034	32	83	630	0	26779
15678	424	26307	89	268	0	27088
15679	200	357	25234	164	0	25955
15680	151	25451	392	152	0	26146
15681	25653	404	161	189	0	26407
15682	467	132	114	25742	0	26455
15683	25920	87	106	514	0	26627
15684	540	64	90	25964	0	26658
15685	290	47	92	26016	0	26445
15686	214	49	85	26199	0	26547
15687	143	58	25591	659	0	26451
15688	144	24951	430	348	0	25873
15689	144	373	25606	262	0	26385
15690	194	130	462	25816	0	26602
15691	26178	102	203	619	0	27102
15692	25845	83	140	402	0	26470
15693	26253	73	111	355	0	26792
15694	604	26128	108	218	0	27058
15695	26868	428	96	275	0	27667
15696	601	164	145	26858	0	27768
15697	300	149	104	27039	0	27592
15698	272	96	114	27132	0	27614
15699	199	27307	92	711	0	28309
15700	292	404	76	25532	0	26304
15701	193	26461	109	583	0	27346
15702	26280	468	89	379	0	27216
15703	26450	179	115	343	0	27087
15704	643	142	109	26515	0	27409
15705	320	158	26110	573	0	27161
15706	25477	105	454	389	0	26425
15707	579	122	148	26675	0	27524
15708	325	106	26385	581	0	27397
15709	25193	87	421	412	0	26113
15710	613	93	160	26641	0	27507
15711	26502	111	148	621	0	27382
15712	586	26246	107	311	0	27250
15713	316	456	108	25802	0	26682
15714	251	26495	100	596	0	27442
15715	288	485	84	26720	0	27577
15716	242	26911	106	577	0	27836
15717	238	517	79	27275	0	28109
15718	172	234	26594	546	0	27546
15719	21600	147	381	487	0	22615
15720	506	26125	160	266	0	27057
15721	273	367	25509	231	0	26380
15722	24769	123	365	292	0	25549
15723	513	129	128	25897	0	26667
15724	244	103	25646	486	0	26479
15725	188	25760	408	255	0	26611
15726	216	364	145	26337	0	27062
15727	168	166	26496	472	0	27302
15728	235	159	364	26344	0	27102
15729	169	135	140	26975	0	27419
15730	170	125	27220	578	0	28093
15731	190	159	385	27265	0	27999
15732	155	141	27837	587	0	28720
15733	206	177	410	27928	0	28721
15734	133	145	29096	603	0	29977
15735	225	111	467	29080	0	29883
15736	248	120	205	29272	0	29845
15737	214	122	180	28874	0	29390
15738	177	28837	205	617	0	29836
15739	28804	402	157	455	0	29818
15740	28908	148	199	411	0	29666
15741	554	138	170	29289	0	30151
15742	29060	127	173	719	0	30079
15743	487	114	29001	359	0	29961
15744	215	29261	424	367	0	30267
15745	29364	391	209	474	0	30438
15746	474	29867	209	312	0	30862
15747	263	448	168	30171	0	31050
15748	211	185	154	30544	0	31094
15749	29353	166	188	655	0	30362
15750	503	134	112	29456	0	30205
15751	279	118	29101	602	0	30100
15752	223	28910	405	378	0	29916
15753	29212	399	161	416	0	30188
15754	477	198	140	28901	0	29716
15755	238	29225	127	600	0	30190
15756	268	438	139	28468	0	29313
15757	210	29334	131	521	0	30196
15758	29163	460	124	400	0	30147
15759	29009	189	141	360	0	29699
15760	567	173	28590	300	0	29630
15761	337	168	27930	242	0	28677
15762	307	126	427	27811	0	28671
15763	203	28476	196	476	0	29351
15764	263	373	144	28885	0	29665
15765	28612	165	138	653	0	29568
15766	410	129	27480	308	0	28327
15767	224	132	280	26206	0	26842
15768	118	83	26002	375	0	26578
15769	159	92	24508	195	0	24954
15770	100	25977	329	159	0	26565
15771	440	609	214	24723	0	25986
15772	22425	88	89	269	0	22871
15773	153	51	22514	76	0	22794
15774	58	22105	140	67	0	22370
15775	21848	111	44	107	0	22110
15776	143	48	27	22033	0	22251
15777	22383	34	38	243	0	22698
15778	22112	33	17	168	0	22330
15779	22318	23	27	173	0	22541
15780	155	31	23356	53	0	23595
15781	21973	20	127	152	0	22272
15782	23314	24	61	126	0	23525
15783	169	24052	54	48	0	24323
15784	91	143	34	24385	0	24653
15785	91	45	38	23948	0	24122
15786	62	37	29	24679	0	24807
15787	24603	32	28	271	0	24934
15788	23683	29	29	192	0	23933
15789	207	31	24042	87	0	24367
15790	134	22	148	23793	0	24097
15791	77	23802	65	150	0	24094
15792	23975	145	51	159	0	24330
15793	175	61	24021	68	0	24325
15794	128	44	154	23120	0	23446
15795	95	44	61	23650	0	23850
15796	72	23575	52	200	0	23899
15797	82	160	50	23818	0	24110
15798	143	62	38	22245	0	22488
15799	64	51	31	23826	0	23972
15800	23558	30	31	329	0	23948
15801	219	24	38	23404	0	23685
15802	108	32	39	23506	0	23685
15803	23746	26	19	385	0	24176
15804	248	35	31	23798	0	24112
15805	105	27985	32	278	0	28400
15806	29046	431	29	203	0	29709
15807	30075	193	28	205	0	30501
15808	30945	94	27	207	0	31273
15809	33539	47	31	186	0	33803
15810	1016	35299	29	90	0	36434
15811	39159	758	27	181	0	40125
15812	39974	288	35	166	0	40463
15813	1412	197	33	39261	0	40903
15814	583	113	38693	1002	0	40391
15815	486	72	927	38483	0	39968
15816	333	68	288	39005	0	39694
15817	292	49	167	38683	0	39191
15818	279	66	119	38811	0	39275
15819	246	81	67	39232	0	39626
15820	37547	61	63	1657	0	39328
15821	1182	57	50	38050	0	39339
15822	476	57	37586	1394	0	39513
15823	456	58	946	36545	0	38005
15824	250	37169	337	1239	0	38995
15825	324	998	182	37433	0	38937
15826	243	315	37300	1309	0	39167
15827	33657	198	981	820	0	35656
15828	36168	128	403	499	0	37198
15829	1368	87	36748	381	0	38584
15830	590	36719	1016	340	0	38665
15831	37464	989	363	428	0	39244
15832	37827	372	206	392	0	38797
15833	38176	238	129	366	0	38909
15834	37319	128	113	290	0	37850
15835	1893	120	106	35616	0	37735
15836	920	135	35712	1166	0	37933
15837	763	136	1055	35860	0	37814
15838	570	174	410	37101	0	38255
15839	459	131	36207	1658	0	38455
15840	399	150	35918	839	0	37306
15841	35213	89	1424	727	0	37453
15842	1421	35995	639	551	0	38606
15843	781	1054	419	36278	0	38532
15844	516	430	35640	1527	0	38113
15845	34138	271	1256	974	0	36639
15846	1436	204	35311	762	0	37713
15847	34459	136	1338	771	0	36704
15848	1623	35113	620	615	0	37971
15849	932	1137	405	35634	0	38108
15850	682	507	35212	1544	0	37945
15851	33750	339	1260	967	0	36316
15852	1530	34752	680	692	0	37654
15853	891	37377	549	564	0	39381
15854	786	1535	504	36565	0	39390
15855	720	769	377	38670	0	40536
15856	38837	540	375	1968	0	41720
15857	1767	38592	336	1142	0	41837
15858	1155	1417	364	39441	0	42377
15859	39115	633	320	1931	0	41999
15860	40539	456	354	1106	0	42455
15861	41033	362	296	992	0	42683
15862	2488	321	40491	847	0	44147
15863	1425	264	41446	897	0	44032
15864	43196	242	1965	949	0	46352
15865	2103	43014	1011	881	0	47009
15866	1162	44584	728	883	0	47357
15867	1018	2034	591	41370	0	45013
15868	744	44086	521	2048	0	47399
15869	44252	1922	554	1266	0	47994
15870	2201	954	569	44017	0	47741
15871	1336	720	43487	2060	0	47603
15872	43856	584	1831	1247	0	47518
15873	45503	539	933	953	0	47928
15874	2836	562	699	44050	0	48147
15875	1815	522	614	45096	0	48047
15876	1390	501	658	45602	0	48151
15877	1260	493	656	45444	0	47853
15878	1203	556	42221	2863	0	46843
15879	1028	42178	1754	1686	0	46646
15880	1038	1950	952	38148	0	42088
15881	984	42242	692	2217	0	46135
15882	1095	2086	608	38358	0	42147
15883	987	41390	522	2298	0	45197
15884	41085	2016	538	1600	0	45239
15885	41447	1075	600	1362	0	44484
15886	2664	40841	608	1200	0	45313
15887	41768	1900	607	1033	0	45308
15888	2609	1082	576	41188	0	45455
15889	40953	864	573	2378	0	44768
15890	2552	40608	649	1367	0	45176
15891	41357	2052	554	1108	0	45071
15892	42399	1243	626	885	0	45153
15893	2970	1060	590	40473	0	45093
15894	1742	917	40140	2176	0	44975
15895	1359	40180	1762	1317	0	44618
15896	1334	2048	878	40753	0	45013
15897	40947	1303	661	2318	0	45229
15898	2456	1062	40080	1387	0	44985
15899	1724	833	1659	39861	0	44077
15900	1437	775	846	41517	0	44575
15901	40994	650	685	2745	0	45074
15902	41590	662	578	1816	0	44646
15903	41026	644	547	1415	0	43632
15904	2898	39304	516	1259	0	43977
15905	35660	1495	383	1106	0	38644
15906	2126	774	33172	1004	0	37076
15907	1249	656	32000	994	0	34899
15908	1027	511	32206	831	0	34575
15909	1114	1807	1757	27250	0	31928
15910	736	394	26912	1183	0	29225
15911	23392	301	794	661	0	25148
15912	1083	261	448	23806	0	25598
15913	739	291	24252	916	0	26198
15914	24933	258	761	693	0	26645
15915	1148	255	485	25081	0	26969
15916	822	286	343	25750	0	27201
15917	25669	220	373	1112	0	27374
15918	1098	266	358	26405	0	28127
15919	723	245	26585	1042	0	28595
15920	617	230	885	26967	0	28699
15921	543	219	27380	1073	0	29215
15922	535	214	959	27170	0	28878
15923	26755	177	531	1202	0	28665
15924	1019	25844	439	802	0	28104
15925	707	26957	378	620	0	28662
15926	649	864	282	26791	0	28586
15927	548	470	303	26846	0	28167
15928	554	25842	355	1203	0	27954
15929	525	26079	310	811	0	27725
15930	485	864	361	25823	0	27533
15931	450	442	340	26130	0	27362
15932	25042	303	336	1301	0	26982
15933	861	24701	355	863	0	26780
15934	599	24555	326	627	0	26107
15935	434	25730	292	593	0	27049
15936	24577	946	302	575	0	26400
15937	863	542	24524	537	0	26466
15938	24232	364	741	532	0	25869
15939	880	338	420	24416	0	26054
15940	579	23244	312	959	0	25094
15941	446	24925	228	722	0	26321
15942	24592	884	223	575	0	26274
15943	879	559	246	23555	0	25239
15944	563	26310	265	913	0	28051
15945	26675	803	281	681	0	28440
15946	27037	518	225	576	0	28356
15947	1117	434	26242	400	0	28193
15948	26423	420	649	474	0	27966
15949	27063	337	421	427	0	28248
15950	1164	350	250	26067	0	27831
15951	687	25305	267	880	0	27139
15952	504	25965	189	627	0	27285
15953	493	890	141	25038	0	26562
15954	23967	446	161	869	0	25443
15955	807	371	21556	479	0	23213
15956	542	244	21917	297	0	23000
15957	543	214	21343	334	0	22434
15958	452	217	22192	232	0	23093
15959	307	22026	604	236	0	23173
15960	341	21984	394	220	0	22939
15961	438	637	20898	221	0	22194
15962	278	342	20348	252	0	21220
15963	134	17558	449	162	0	18303
15964	95	237	193	17196	0	17721
15965	22	113	18325	203	0	18663
15966	67	51	216	17490	0	17824
15967	61	28	98	18916	0	19103
15968	52	30	73	19253	0	19408
15969	59	26	45	19989	0	20119
15970	37	32	19679	387	0	20135
15971	70	26	313	19014	0	19423
15972	19390	38	140	381	0	19949
15973	317	38	19162	174	0	19691
15974	19195	28	323	140	0	19686
15975	361	30	141	19834	0	20366
15976	161	46	20000	341	0	20548
15977	19701	24	348	228	0	20301
15978	381	24	167	20291	0	20863
15979	20429	37	114	412	0	20992
15980	383	32	81	20097	0	20593
15981	170	20001	68	429	0	20668
15982	110	302	20860	235	0	21507
15983	110	142	358	21087	0	21697
15984	21289	88	152	470	0	21999
15985	21434	62	98	293	0	21887
15986	21542	58	95	204	0	21899
15987	21452	73	84	174	0	21783
15988	21102	73	68	201	0	21444
15989	450	21112	83	158	0	21803
15990	21376	345	77	165	0	21963
15991	440	171	20939	129	0	21679
15992	20998	116	337	147	0	21598
15993	467	114	137	20268	0	20986
15994	221	114	21064	337	0	21736
15995	166	113	20709	172	0	21160
15996	174	60	460	20970	0	21664
15997	21374	83	194	451	0	22102
15998	437	20994	129	189	0	21749
15999	21072	364	80	203	0	21719
16000	473	21121	92	131	0	21817
16001	302	402	93	21643	0	22440
16002	232	186	68	22114	0	22600
16003	21990	125	63	543	0	22721
16004	491	96	86	22052	0	22725
16005	278	94	21938	449	0	22759
16006	21767	73	373	257	0	22470
16007	504	57	176	22330	0	23067
16008	280	72	144	22458	0	22954
16009	224	72	22203	499	0	22998
16010	20033	75	387	365	0	20860
16011	22012	91	192	232	0	22527
16012	549	22041	121	155	0	22866
16013	248	352	21338	106	0	22044
16014	194	156	20808	97	0	21255
16015	203	200	420	20432	0	21255
16016	184	123	194	20312	0	20813
16017	130	20809	132	434	0	21505
16018	98	282	20217	200	0	20797
16019	135	127	350	19420	0	20032
16020	113	61	20072	366	0	20612
16021	118	53	366	19070	0	19607
16022	103	19684	165	376	0	20328
16023	109	299	141	20424	0	20973
16024	128	111	106	20521	0	20866
16025	140	84	90	20300	0	20614
16026	20098	69	97	513	0	20777
16027	370	57	20094	216	0	20737
16028	154	21091	367	211	0	21823
16029	139	353	161	22301	0	22954
16030	22624	142	121	500	0	23387
16031	444	86	101	23047	0	23678
16032	22995	62	98	558	0	23713
16033	474	55	22879	273	0	23681
16034	22745	62	426	217	0	23450
16035	545	54	175	23730	0	24504
16036	259	82	23667	506	0	24514
16037	168	23540	461	277	0	24446
16038	214	390	183	23338	0	24125
16039	175	149	152	23991	0	24467
16040	23456	87	102	643	0	24288
16041	481	23074	100	300	0	23955
16042	201	22530	113	202	0	23046
16043	178	23337	110	181	0	23806
16044	21478	495	86	199	0	22258
16045	435	21510	94	172	0	22211
16046	280	434	84	21317	0	22115
16047	218	189	78	21651	0	22136
16048	21301	119	75	573	0	22068
16049	448	21190	72	271	0	21981
16050	240	403	87	21524	0	22254
16051	21798	178	68	555	0	22599
16052	21817	121	76	309	0	22323
16053	21720	74	72	266	0	22132
16054	600	21519	64	166	0	22349
16055	21221	382	82	170	0	21855
16056	477	187	63	20945	0	21672
16057	212	20483	70	427	0	21192
16058	187	21139	75	193	0	21594
16059	206	465	54	20966	0	21691
16060	20762	187	60	477	0	21486
16061	21035	120	49	275	0	21479
16062	529	99	55	20386	0	21069
16063	199	20328	59	422	0	21008
16064	20364	390	44	255	0	21053
16065	406	184	19669	161	0	20420
16066	223	123	18867	132	0	19345
16067	18508	104	309	150	0	19071
16068	353	89	18837	133	0	19412
16069	162	70	250	17918	0	18400
16070	18186	48	86	324	0	18644
16071	310	64	55	18577	0	19006
16072	135	82	18388	309	0	18914
16073	126	18331	257	160	0	18874
16074	136	248	88	18885	0	19357
16075	123	101	18776	258	0	19258
16076	17723	101	230	205	0	18259
16077	305	73	81	18667	0	19126
16078	134	77	18644	274	0	19129
16079	146	75	234	18211	0	18666
16080	73	17984	95	298	0	18450
16081	113	251	61	18995	0	19420
16082	121	103	59	18713	0	18996
16083	131	67	34	18163	0	18395
16084	84	18199	55	362	0	18700
16085	18600	240	54	232	0	19126
16086	278	112	45	18889	0	19324
16087	166	90	79	18901	0	19236
16088	138	52	66	19218	0	19474
16089	106	51	18968	386	0	19511
16090	124	64	243	19047	0	19478
16091	19138	47	97	415	0	19697
16092	274	19264	98	201	0	19837
16093	154	266	45	19772	0	20237
16094	102	133	65	19814	0	20114
16095	19511	92	60	454	0	20117
16096	286	19598	54	255	0	20193
16097	19773	275	63	211	0	20322
16098	20303	151	41	168	0	20663
16099	447	86	48	20225	0	20806
16100	20233	72	58	402	0	20765
16101	340	19489	58	253	0	20140
16102	19799	326	45	183	0	20353
16103	395	161	47	20332	0	20935
16104	22710	107	31	458	0	23306
16105	23320	71	31	298	0	23720
16106	612	111	21520	190	0	22433
16107	23069	89	332	205	0	23695
16108	23935	71	90	202	0	24298
16109	23636	76	75	280	0	24067
16110	702	95	25167	159	0	26123
16111	301	25463	546	145	0	26455
16112	256	566	181	25626	0	26629
16113	25650	207	108	700	0	26665
16114	681	25298	73	255	0	26307
16115	25456	608	43	232	0	26339
16116	815	221	60	25750	0	26846
16117	375	150	25563	655	0	26743
16118	26146	104	576	323	0	27149
16119	876	96	190	26913	0	28075
16120	403	97	26986	690	0	28176
16121	26959	81	636	347	0	28023
16122	861	77	27766	200	0	28904
16123	492	88	713	27976	0	29269
16124	380	67	290	29696	0	30433
16125	29362	77	176	1011	0	30626
16126	29587	68	106	495	0	30256
16127	1080	28970	146	291	0	30487
16128	28668	667	102	254	0	29691
16129	935	221	27144	158	0	28458
16130	450	145	27074	163	0	27832
16131	26656	128	797	209	0	27790
16132	862	27053	380	123	0	28418
16133	26784	624	234	160	0	27802
16134	828	26793	203	119	0	27943
16135	26803	689	132	168	0	27792
16136	911	269	147	26128	0	27455
16137	462	177	26365	639	0	27643
16138	403	138	638	26324	0	27503
16139	365	96	291	27317	0	28069
16140	26953	103	179	961	0	28196
16141	791	99	26674	408	0	27972
16142	26094	100	658	370	0	27222
16143	861	26566	302	233	0	27962
16144	27027	661	232	191	0	28111
16145	971	249	174	26530	0	27924
16146	452	202	26396	711	0	27761
16147	428	143	672	26457	0	27700
16148	26783	121	328	842	0	28074
16149	900	145	236	26800	0	28081
16150	570	120	165	26469	0	27324
16151	351	25684	201	920	0	27156
16152	438	602	160	26416	0	27616
16153	277	268	26098	918	0	27561
16154	378	156	720	26152	0	27406
16155	350	146	316	26772	0	27584
16156	26155	142	235	1032	0	27564
16157	915	130	186	26224	0	27455
16158	479	153	25725	932	0	27289
16159	417	25623	710	586	0	27336
16160	413	647	352	25898	0	27310
16161	397	294	264	26527	0	27482
16162	26131	204	189	1069	0	27593
16163	859	25492	225	546	0	27122
16164	517	672	181	26085	0	27455
16165	25302	318	210	960	0	26790
16166	26203	210	160	566	0	27139
16167	1068	190	163	25960	0	27381
16168	574	166	25871	954	0	27565
16169	25883	168	684	593	0	27328
16170	1009	179	379	26984	0	28551
16171	26906	126	229	1109	0	28370
16172	27245	117	250	661	0	28273
16173	1133	26198	209	476	0	28016
16174	26284	686	166	509	0	27645
16175	1041	26385	215	362	0	28003
16176	640	775	182	26419	0	28016
16177	529	375	207	26204	0	27315
16178	413	26281	205	1062	0	27961
16179	26766	725	147	657	0	28295
16180	26586	387	193	531	0	27697
16181	1109	290	25552	461	0	27412
16182	604	243	25478	409	0	26734
16183	565	188	871	25928	0	27552
16184	26159	154	412	1027	0	27752
16185	976	177	312	25959	0	27424
16186	636	155	209	26603	0	27603
16187	468	169	26131	1162	0	27930
16188	453	169	25767	663	0	27052
16189	411	165	26487	522	0	27585
16190	25514	192	966	486	0	27158
16191	26368	150	487	457	0	27462
16192	1042	25231	340	391	0	27004
16193	602	25841	256	409	0	27108
16194	514	863	236	25699	0	27312
16195	453	399	25512	878	0	27242
16196	25073	267	706	569	0	26615
16197	919	248	26560	419	0	28146
16198	605	186	755	26183	0	27729
16199	428	164	404	27104	0	28100
16200	409	168	286	27386	0	28249
16201	436	129	266	27891	0	28722
16202	27088	160	229	1211	0	28688
16203	1009	142	210	26779	0	28140
16204	414	110	24601	844	0	25969
16205	22508	75	558	617	0	23758
16206	714	112	23760	370	0	24956
16207	406	113	23104	329	0	23952
16208	317	23290	719	314	0	24640
16209	481	351	405	21571	0	22808
16210	21350	166	294	503	0	22313
16211	460	113	166	21402	0	22141
16212	254	119	21407	483	0	22263
16213	233	53	349	21558	0	22193
16214	21340	65	212	529	0	22146
16215	397	21393	141	330	0	22261
16216	20959	277	134	286	0	21656
16217	420	20765	113	221	0	21519
16218	20507	327	107	247	0	21188
16219	363	20191	93	187	0	20834
16220	249	20432	100	120	0	20901
16221	196	331	19852	103	0	20482
16222	153	19542	268	114	0	20077
16223	18244	199	157	102	0	18702
16224	212	88	60	18080	0	18440
16225	18186	60	37	245	0	18528
16226	222	18469	50	119	0	18860
16227	18284	199	31	135	0	18649
16228	260	89	18517	67	0	18933
16229	147	76	214	18248	0	18685
16230	97	19102	98	199	0	19496
16231	114	244	74	19777	0	20209
16232	123	101	43	19974	0	20241
16233	21837	82	46	397	0	22362
16234	357	22146	53	178	0	22734
16235	22303	377	45	152	0	22877
16236	461	164	22399	79	0	23103
16237	212	106	21498	60	0	21876
16238	126	22118	474	88	0	22806
16239	145	376	207	22184	0	22912
16240	95	176	22492	403	0	23166
16241	189	119	431	20757	0	21496
16242	133	77	172	22922	0	23304
16243	100	71	21876	554	0	22601
16244	80	90	21634	244	0	22048
16245	78	96	22414	157	0	22745
16246	108	53	22764	145	0	23070
16247	98	23629	592	154	0	24473
16248	157	433	268	23362	0	24220
16249	108	202	164	24420	0	24894
16250	94	134	23970	584	0	24782
16251	128	84	511	23630	0	24353
16252	75	99	24789	564	0	25527
16253	124	76	558	24444	0	25202
16254	110	75	256	24537	0	24978
16255	75	24657	200	608	0	25540
16256	110	454	148	24997	0	25709
16257	127	185	155	24875	0	25342
16258	120	133	145	25233	0	25631
16259	86	111	24653	676	0	25526
16260	77	24517	479	342	0	25415
16261	24479	457	232	322	0	25490
16262	24691	220	171	256	0	25338
16263	587	137	135	24417	0	25276
16264	300	104	143	24080	0	24627
16265	154	24659	121	652	0	25586
16266	24520	457	125	398	0	25500
16267	456	24982	130	238	0	25806
16268	24477	484	111	261	0	25333
16269	502	205	24086	185	0	24978
16270	22743	157	456	234	0	23590
16271	470	24016	201	196	0	24883
16272	240	456	144	24381	0	25221
16273	218	182	105	24359	0	24864
16274	117	24335	128	579	0	25159
16275	24685	466	111	334	0	25596
16276	525	216	115	25253	0	26109
16277	253	152	116	25969	0	26490
16278	25886	152	98	748	0	26884
16279	26384	143	76	419	0	27022
16280	698	129	26228	244	0	27299
16281	26426	119	548	266	0	27359
16282	685	113	225	26793	0	27816
16283	309	114	26757	635	0	27815
16284	293	104	575	26489	0	27461
16285	181	132	26114	684	0	27111
16286	184	105	26573	333	0	27195
16287	179	130	700	26366	0	27375
16288	143	129	26763	709	0	27744
16289	117	27002	637	422	0	28178
16290	211	532	307	26801	0	27851
16291	174	226	242	28270	0	28912
16292	168	148	27962	807	0	29085
16293	167	27823	664	439	0	29093
16294	28059	574	320	369	0	29322
16295	651	240	237	28640	0	29768
16296	28594	187	180	800	0	29761
16297	656	27987	208	402	0	29253
16298	308	647	28234	334	0	29523
16299	263	269	676	27843	0	29051
16300	27588	184	357	816	0	28945
16301	663	146	27496	390	0	28695
16302	26053	129	687	406	0	27275
16303	707	26718	374	264	0	28063
16304	269	27230	216	267	0	27982
16305	26974	676	253	297	0	28200
16306	665	279	248	26781	0	27973
16307	336	179	204	26713	0	27432
16308	207	26984	158	764	0	28113
16309	219	609	153	27491	0	28472
16310	221	261	176	27853	0	28511
16311	27225	202	115	951	0	28493
16312	652	163	141	27147	0	28103
16313	284	153	26910	787	0	28134
16314	257	96	641	26883	0	27877
16315	202	143	293	27802	0	28440
16316	177	145	27474	859	0	28655
16317	201	160	582	27589	0	28532
16318	26964	114	272	920	0	28270
16319	26439	126	180	581	0	27326
16320	26642	127	197	408	0	27374
16321	807	115	158	26593	0	27673
16322	383	126	26379	791	0	27679
16323	297	26332	568	465	0	27662
16324	302	550	233	26585	0	27670
16325	261	240	26725	697	0	27923
16326	277	178	522	26264	0	27241
16327	237	121	267	26852	0	27477
16328	25960	118	190	873	0	27141
16329	536	26563	202	464	0	27765
16330	306	534	25717	317	0	26874
16331	23537	214	519	391	0	24661
16332	600	24777	278	307	0	25962
16333	221	23293	131	199	0	23844
16334	23712	439	230	228	0	24609
16335	485	185	135	23869	0	24674
16336	243	124	25322	471	0	26160
16337	200	117	418	24740	0	25475
16338	130	25194	204	472	0	26000
16339	25604	407	127	326	0	26464
16340	487	193	96	25925	0	26701
16341	26398	126	94	604	0	27222
16342	530	125	84	26000	0	26739
16343	262	27082	89	505	0	27938
16344	27557	446	97	384	0	28484
16345	27465	210	92	266	0	28033
16346	637	27444	69	214	0	28364
16347	26852	458	81	220	0	27611
16348	584	210	70	26171	0	27035
16349	273	26220	74	519	0	27086
16350	26463	471	71	317	0	27322
16351	546	26730	73	172	0	27521
16352	26483	494	52	234	0	27263
16353	622	217	75	26516	0	27430
16354	26850	146	60	571	0	27627
16355	27001	157	50	338	0	27546
16356	27227	144	56	258	0	27685
16357	744	126	43	27053	0	27966
16358	382	128	55	27581	0	28146
16359	27174	115	46	704	0	28039
16360	633	145	27680	298	0	28756
16361	372	109	428	27542	0	28451
16362	250	28232	169	591	0	29242
16363	301	510	76	28885	0	29772
16364	279	217	69	29220	0	29785
16365	224	182	28385	731	0	29522
16366	277	150	447	30068	0	30942
16367	214	31106	198	713	0	32231
16368	267	703	102	32271	0	33343
16369	198	352	33649	870	0	35069
16370	285	213	732	33396	0	34626
16371	256	162	316	34486	0	35220
16372	33237	120	163	1245	0	34765
16373	33312	104	117	695	0	34228
16374	1136	145	106	32741	0	34128
16375	538	31790	83	957	0	33368
16376	314	32556	75	534	0	33479
16377	280	922	31834	335	0	33371
16378	328	640	733	31317	0	33018
16379	31302	251	369	970	0	32892
16380	817	188	162	31616	0	32783
16381	423	149	31535	904	0	33011
16382	337	111	693	31547	0	32688
16383	299	103	329	32106	0	32837
16384	225	128	168	32780	0	33301
16385	196	135	31814	1140	0	33285
16386	169	31686	705	637	0	33197
16387	31382	712	322	463	0	32879
16388	31429	313	169	372	0	32283
16389	1037	214	133	30563	0	31947
16390	490	171	30277	830	0	31768
16391	305	30077	666	481	0	31529
16392	310	817	308	28765	0	30200
16393	200	29660	196	744	0	30800
16394	149	30717	151	451	0	31468
16395	29636	894	172	362	0	31064
16396	738	389	29777	255	0	31159
16397	402	207	29414	220	0	30243
16398	334	157	828	29278	0	30597
16399	243	144	388	30501	0	31276
16400	194	158	30543	889	0	31784
16401	255	102	679	29687	0	30723
16402	157	124	30158	891	0	31330
16403	28142	127	707	543	0	29519
16404	729	113	350	30052	0	31244
16405	372	143	30564	756	0	31835
16406	294	130	680	29056	0	30160
16407	184	31469	329	792	0	32774
16408	31212	634	201	584	0	32631
16409	659	31631	207	318	0	32815
16410	31611	727	154	392	0	32884
16411	778	385	31188	242	0	32593
16412	31167	216	634	316	0	32333
16413	815	165	345	31991	0	33316
16414	427	147	32158	775	0	33507
16415	328	144	694	31793	0	32959
16416	227	149	31406	878	0	32660
16417	28903	127	721	628	0	30379
16418	680	31429	394	394	0	32897
16419	464	637	256	30076	0	31433
16420	257	31955	235	668	0	33115
16421	31700	728	191	483	0	33102
16422	31789	350	173	424	0	32736
16423	896	31770	184	339	0	33189
16424	497	699	170	31883	0	33249
16425	340	357	174	32018	0	32889
16426	323	207	174	32106	0	32810
16427	31227	175	157	1207	0	32766
16428	680	31130	163	672	0	32645
16429	397	661	190	30756	0	32004
16430	266	363	205	31185	0	32019
16431	30256	217	166	1101	0	31740
16432	729	211	29767	590	0	31297
16433	424	157	28863	478	0	29922
16434	27623	113	799	448	0	28983
16435	690	121	28748	287	0	29846
16436	391	147	26677	240	0	27455
16437	282	152	749	26366	0	27549
16438	26946	119	453	704	0	28222
16439	613	119	252	26876	0	27860
16440	359	126	26333	700	0	27518
16441	24417	101	591	461	0	25570
16442	658	115	25583	300	0	26656
16443	337	24813	596	232	0	25978
16444	274	519	406	25073	0	26272
16445	25334	242	249	614	0	26439
16446	508	163	173	25449	0	26293
16447	299	102	176	25724	0	26301
16448	26193	78	117	833	0	27221
16449	542	59	135	26666	0	27402
16450	345	54	174	27150	0	27723
16451	204	80	26768	762	0	27814
16452	189	67	460	26590	0	27306
16453	26817	70	295	745	0	27927
16454	26661	75	186	503	0	27425
16455	26860	71	152	324	0	27407
16456	751	96	133	26144	0	27124
16457	416	25992	114	500	0	27022
16458	26115	398	109	382	0	27004
16459	481	26412	132	221	0	27246
16460	25620	427	116	217	0	26380
16461	534	240	89	25575	0	26438
16462	25129	127	68	503	0	25827
16463	24892	74	75	376	0	25417
16464	24958	49	112	304	0	25423
16465	660	24556	108	158	0	25482
16466	232	22912	51	109	0	23304
16467	21709	188	41	126	0	22064
16468	200	21746	41	83	0	22070
16469	62	20058	15	37	0	20172
16470	88	20250	33	26	0	20397
16471	20472	118	64	80	0	20734
16472	134	45	6	20362	0	20547
16473	65	26	8	20523	0	20622
16474	20812	13	6	208	0	21039
16475	135	19	21299	47	0	21500
16476	107	14	118	24663	0	24902
16477	91	17	46	25016	0	25170
16478	77	27	28	27627	0	27759
16479	96	18	15	28421	0	28550
16480	26	27542	22	722	0	28312
16481	26	33473	18	313	0	33830
16482	34084	821	9	263	0	35177
16483	828	332	16	34154	0	35330
16484	381	185	9	35134	0	35709
16485	202	108	34291	1069	0	35670
16486	196	68	759	34627	0	35650
16487	86	72	34917	1090	0	36165
16488	181	55	929	35120	0	36285
16489	72	66	36236	1151	0	37525
16490	59	35986	1047	532	0	37624
16491	139	861	390	36807	0	38197
16492	36535	306	261	1220	0	38322
16493	36801	197	151	609	0	37758
16494	1277	129	117	36425	0	37948
16495	525	122	36205	1138	0	37990
16496	341	114	35908	547	0	36910
16497	34325	121	1224	522	0	36192
16498	1004	35815	552	362	0	37733
16499	36514	925	370	422	0	38231
16500	36499	382	232	455	0	37568
16501	1350	259	36088	324	0	38021
16502	781	151	1054	35674	0	37660
16503	558	133	522	36046	0	37259
16504	418	167	361	38241	0	39187
16505	379	148	283	37093	0	37903
16506	423	146	261	36146	0	36976
16507	280	128	34764	1838	0	37010
16508	269	115	34858	1004	0	36246
16509	403	106	1410	35002	0	36921
16510	366	105	651	35960	0	37082
16511	340	114	503	36587	0	37544
16512	35028	148	366	1870	0	37412
16513	1300	123	307	35411	0	37141
16514	35181	173	250	1657	0	37261
16515	1475	116	251	36149	0	37991
16516	36639	64	229	1791	0	38723
16517	37725	64	253	1082	0	39124
16518	36980	62	270	937	0	38249
16519	37318	68	279	817	0	38482
16520	37418	104	285	699	0	38506
16521	1906	105	227	36499	0	38737
16522	36553	123	209	1623	0	38508
16523	1609	35968	241	910	0	38728
16524	36921	1006	233	784	0	38944
16525	1648	375	235	37083	0	39341
16526	854	250	36526	1622	0	39252
16527	761	150	1150	37244	0	39305
16528	620	174	36808	1789	0	39391
16529	648	144	1328	36997	0	39117
16530	690	106	572	38265	0	39633
16531	581	122	36956	1930	0	39589
16532	592	103	37015	1102	0	38812
16533	608	98	1537	37516	0	39759
16534	37175	82	754	1806	0	39817
16535	1500	111	36976	1096	0	39683
16536	909	37241	1302	858	0	40310
16537	697	1062	38798	766	0	41323
16538	38552	416	1477	723	0	41168
16539	1649	287	693	39160	0	41789
16540	39539	201	574	1690	0	42004
16541	40328	154	446	1062	0	41990
16542	1993	135	478	39778	0	42384
16543	1084	121	39069	1782	0	42056
16544	883	121	1379	39196	0	41579
16545	668	110	707	39944	0	41429
16546	38050	118	583	2163	0	40914
16547	1483	38815	519	1247	0	42064
16548	949	1101	456	39464	0	41970
16549	710	425	38414	1849	0	41398
16550	36796	314	1456	1152	0	39718
16551	1585	38097	766	915	0	41363
16552	982	1162	595	38833	0	41572
16553	767	503	474	39425	0	41169
16554	702	333	443	40048	0	41526
16555	38315	219	445	2278	0	41257
16556	39367	157	414	1383	0	41321
16557	2025	175	372	39116	0	41688
16558	1149	172	38211	1959	0	41491
16559	804	38393	1440	1208	0	41845
16560	38949	1219	678	1053	0	41899
16561	40242	525	518	950	0	42235
16562	2127	346	405	39270	0	42148
16563	1199	252	372	40694	0	42517
16564	913	226	39734	2160	0	43033
16565	756	39855	1440	1174	0	43225
16566	40731	1249	693	1029	0	43702
16567	40592	561	515	954	0	42622
16568	1945	40019	414	818	0	43196
16569	40390	1332	312	835	0	42869
16570	2007	573	288	39840	0	42708
16571	1114	418	39064	1788	0	42384
16572	993	240	1352	39616	0	42201
16573	698	263	38860	1980	0	41801
16574	37660	223	1564	1153	0	40600
16575	1614	38067	737	903	0	41321
16576	808	1228	393	34586	0	37015
16577	603	409	34191	1405	0	36608
16578	523	258	32305	733	0	33819
16579	30658	324	1128	668	0	32778
16580	1091	31047	615	522	0	33275
16581	26566	531	605	359	0	28061
16582	25978	246	278	314	0	26816
16583	26135	158	187	254	0	26734
16584	884	189	115	25548	0	26736
16585	454	128	25451	607	0	26640
16586	315	25312	500	347	0	26474
16587	325	573	311	25450	0	26659
16588	266	197	25558	593	0	26614
16589	209	155	23894	268	0	24526
16590	218	134	495	23996	0	24843
16591	189	98	23944	480	0	24711
16592	22495	90	472	343	0	23400
16593	521	89	245	23651	0	24506
16594	285	97	162	24353	0	24897
16595	24206	82	176	606	0	25070
16596	466	23767	166	290	0	24689
16597	25021	385	147	253	0	25806
16598	558	191	128	24744	0	25621
16599	361	129	133	25144	0	25767
16600	277	94	141	25318	0	25830
16601	241	84	134	24761	0	25220
16602	24147	86	156	670	0	25059
16603	498	102	23918	335	0	24853
16604	274	23424	373	250	0	24321
16605	231	328	218	23750	0	24527
16606	22482	174	172	499	0	23327
16607	23590	103	133	347	0	24173
16608	470	23502	151	233	0	24356
16609	23152	326	121	252	0	23851
16610	436	23023	114	220	0	23793
16611	264	24011	116	207	0	24598
16612	228	450	106	24161	0	24945
16613	178	205	24202	470	0	25055
16614	223	211	375	23728	0	24537
16615	23428	129	192	537	0	24286
16616	437	22808	116	270	0	23631
16617	279	342	98	22921	0	23640
16618	183	189	24114	462	0	24948
16619	23981	113	366	371	0	24831
16620	25196	101	176	281	0	25754
16621	25325	114	123	230	0	25792
16622	512	95	24220	159	0	24986
16623	23296	91	331	189	0	23907
16624	447	24120	151	135	0	24853
16625	272	337	101	23326	0	24036
16626	171	24146	121	310	0	24748
16627	24365	355	104	234	0	25058
16628	23284	165	88	263	0	23800
16629	447	130	24675	124	0	25376
16630	239	24723	314	143	0	25419
16631	191	331	179	24978	0	25679
16632	169	146	138	25269	0	25722
16633	189	120	101	25019	0	25429
16634	196	103	87	25345	0	25731
16635	190	101	75	26128	0	26494
16636	145	98	24653	585	0	25481
16637	162	24194	391	275	0	25022
16638	23849	380	167	250	0	24646
16639	479	166	24486	151	0	25282
16640	233	25003	419	160	0	25815
16641	25072	420	184	193	0	25869
16642	520	183	26054	132	0	26889
16643	25117	127	482	221	0	25947
16644	24956	122	174	206	0	25458
16645	25926	89	131	186	0	26332
16646	621	25975	91	144	0	26831
16647	315	482	25328	117	0	26242
16648	178	26029	471	126	0	26804
16649	392	565	203	20762	0	21922
16650	151	26316	126	398	0	26991
16651	26242	508	111	216	0	27077
16652	27482	194	67	214	0	27957
16653	26678	116	93	203	0	27090
16654	736	122	27327	127	0	28312
16655	359	28547	536	130	0	29572
16656	284	607	228	31111	0	32230
16657	32928	255	149	742	0	34074
16658	855	32765	118	323	0	34061
16659	465	782	87	32368	0	33702
16660	295	308	32710	786	0	34099
16661	31900	230	805	377	0	33312
16662	937	162	33912	217	0	35228
16663	419	124	34696	136	0	35375
16664	32270	119	1072	197	0	33658
16665	994	121	33531	115	0	34761
16666	31901	113	969	148	0	33131
16667	1014	32367	434	134	0	33949
16668	33894	797	352	192	0	35235
16669	1127	356	225	34019	0	35727
16670	627	231	233	33906	0	34997
16671	481	137	211	35318	0	36147
16672	34820	133	194	1261	0	36408
16673	34784	122	180	626	0	35712
16674	35148	129	168	394	0	35839
16675	1364	33968	161	224	0	35717
16676	781	802	160	34391	0	36134
16677	496	350	34131	943	0	35920
16678	479	230	861	32923	0	34493
16679	329	32889	425	1090	0	34733
16680	465	850	269	33278	0	34862
16681	440	418	176	34117	0	35151
16682	33604	308	161	1264	0	35337
16683	1105	240	155	33788	0	35288
16684	548	188	33137	1269	0	35142
16685	449	177	32676	662	0	33964
16686	441	147	1153	33268	0	35009
16687	33010	161	618	1154	0	34943
16688	1171	168	371	32727	0	34437
16689	665	170	269	33774	0	34878
16690	477	149	33084	1407	0	35117
16691	391	32680	999	791	0	34861
16692	376	859	527	33619	0	35381
16693	32938	389	412	1238	0	34977
16694	1036	33000	294	722	0	35052
16695	631	875	234	33634	0	35374
16696	494	419	33310	1244	0	35467
16697	448	308	954	32741	0	34451
16698	32050	226	534	1375	0	34185
16699	1013	31617	420	745	0	33795
16700	580	929	32262	639	0	34410
16701	570	466	945	32009	0	33990
16702	386	357	32624	1254	0	34621
16703	31490	256	1115	844	0	33705
16704	32625	231	595	671	0	34122
16705	1318	239	32414	556	0	34527
16706	836	225	1015	32221	0	34297
16707	587	237	33044	1158	0	35026
16708	437	32751	1201	692	0	35081
16709	425	948	703	33244	0	35320
16710	384	424	33511	1239	0	35558
16711	463	382	1140	31468	0	33453
16712	438	32422	650	1174	0	34684
16713	418	948	507	33069	0	34942
16714	364	456	32731	1317	0	34868
16715	31062	360	1141	864	0	33427
16716	1049	32598	632	665	0	34944
16717	33182	955	491	591	0	35219
16718	1251	510	31815	489	0	34065
16719	31044	368	1088	550	0	33050
16720	1281	294	31498	514	0	33587
16721	31158	280	1238	524	0	33200
16722	32971	258	661	536	0	34426
16723	1487	282	494	32246	0	34509
16724	861	296	439	33487	0	35083
16725	33117	268	389	1467	0	35241
16726	1220	33039	429	923	0	35611
16727	33700	960	425	662	0	35747
16728	1454	449	413	33026	0	35342
16729	817	32766	439	1225	0	35247
16730	764	975	364	33745	0	35848
16731	616	456	345	34711	0	36128
16732	577	358	383	34152	0	35470
16733	509	33476	326	1699	0	36010
16734	33257	948	336	895	0	35436
16735	1224	478	269	33559	0	35530
16736	672	370	32802	1362	0	35206
16737	556	304	31845	885	0	33590
16738	440	273	32688	774	0	34175
16739	32394	233	1257	667	0	34551
16740	32879	255	683	636	0	34453
16741	1350	298	31979	464	0	34091
16742	792	277	923	30041	0	32033
16743	570	230	563	31018	0	32381
16744	413	192	31840	1312	0	33757
16745	355	186	31471	855	0	32867
16746	446	195	1149	32066	0	33856
16747	31973	164	669	1174	0	33980
16748	31310	167	453	736	0	32666
16749	31340	126	387	665	0	32518
16750	1232	30124	390	549	0	32295
16751	739	30908	369	435	0	32451
16752	504	836	367	30310	0	32017
16753	30154	370	314	951	0	31789
16754	910	239	29145	557	0	30851
16755	26529	204	620	523	0	27876
16756	696	25106	286	288	0	26376
16757	245	23807	141	172	0	24365
16758	23703	453	146	196	0	24498
16759	429	23353	173	145	0	24100
16760	242	23091	131	111	0	23575
16761	22686	563	372	227	0	23848
16762	302	22806	77	90	0	23275
16763	138	245	56	22251	0	22690
16764	109	91	35	22468	0	22703
16765	22357	63	47	341	0	22808
16766	22109	55	42	186	0	22392
16767	295	22356	61	103	0	22815
16768	119	22380	47	89	0	22635
16769	93	256	21883	45	0	22277
16770	22268	148	233	83	0	22732
16771	23732	64	93	74	0	23963
16772	24510	51	48	77	0	24686
16773	397	41	46	24717	0	25201
16774	171	48	33	25557	0	25809
16775	25859	37	29	423	0	26348
16776	403	27	29	26047	0	26506
16777	147	42	26142	398	0	26729
16778	130	49	325	25905	0	26409
16779	69	26927	107	375	0	27478
16780	108	365	46	27491	0	28010
16781	116	130	44	28176	0	28466
16782	101	81	29	28346	0	28557
16783	27768	52	37	591	0	28448
16784	417	27729	37	222	0	28405
16785	208	376	32	28400	0	29016
16786	106	148	28305	462	0	29021
16787	115	104	26994	217	0	27430
16788	129	72	447	27771	0	28419
16789	144	59	162	28016	0	28381
16790	27485	56	95	598	0	28234
16791	448	64	60	26843	0	27415
16792	157	26759	63	524	0	27503
16793	130	389	27188	237	0	27944
16794	165	169	393	27435	0	28162
16795	104	98	27544	533	0	28279
16796	135	77	433	27564	0	28209
16797	27627	55	167	561	0	28410
16798	27743	68	106	320	0	28237
16799	516	27478	122	189	0	28305
16800	274	376	85	27542	0	28277
16801	28325	147	77	550	0	29099
16802	28661	83	83	309	0	29136
16803	29038	71	74	259	0	29442
16804	28911	52	72	250	0	29285
16805	28647	62	101	208	0	29018
16806	592	28070	102	154	0	28918
16807	28045	366	85	205	0	28701
16808	534	150	27559	138	0	28381
16809	308	92	378	27681	0	28459
16810	28044	91	146	528	0	28809
16811	28059	70	96	298	0	28523
16812	27823	143	67	261	0	28294
16813	626	78	27324	183	0	28211
16814	389	66	378	27461	0	28294
16815	28073	84	151	511	0	28819
16816	525	27877	85	264	0	28751
16817	28791	393	101	214	0	29499
16818	28201	171	86	234	0	28692
16819	28429	110	71	222	0	28832
16820	655	118	79	28466	0	29318
16821	28703	95	59	565	0	29422
16822	605	70	27993	299	0	28967
16823	304	102	27728	220	0	28354
16824	27671	61	465	247	0	28444
16825	554	83	28083	151	0	28871
16826	26484	71	381	221	0	27157
16827	498	46	27553	176	0	28273
16828	323	97	363	27060	0	27843
16829	26764	62	166	449	0	27441
16830	466	25644	125	242	0	26477
16831	26519	305	85	248	0	27157
16832	482	25540	108	167	0	26297
16833	290	27103	91	158	0	27642
16834	279	375	103	27554	0	28311
16835	230	130	123	27752	0	28235
16836	257	85	111	27771	0	28224
16837	174	106	27165	504	0	27949
16838	26255	69	356	360	0	27040
16839	28226	74	182	231	0	28713
16840	28293	79	118	252	0	28742
16841	28464	76	93	222	0	28855
16842	28389	84	84	213	0	28770
16843	707	100	25587	177	0	26571
16844	372	80	27388	135	0	27975
16845	300	81	463	28164	0	29008
16846	256	92	27885	516	0	28749
16847	28275	92	451	297	0	29115
16848	708	29800	172	181	0	30861
16849	422	511	122	31373	0	32428
16850	31725	168	121	678	0	32692
16851	844	84	111	31957	0	32996
16852	429	102	31915	685	0	33131
16853	313	57	32081	312	0	32763
16854	344	61	802	32861	0	34068
16855	277	67	33092	698	0	34134
16856	32162	60	727	367	0	33316
16857	855	85	311	32993	0	34244
16858	430	88	33087	735	0	34340
16859	308	32755	696	370	0	34129
16860	381	571	304	33513	0	34769
16861	277	238	33900	713	0	35128
16862	336	140	700	32647	0	33823
16863	325	113	343	33296	0	34077
16864	276	98	33599	923	0	34896
16865	323	78	749	33342	0	34492
16866	348	93	377	32419	0	33237
16867	315	75	267	33797	0	34454
16868	32386	57	246	1036	0	33725
16869	778	31858	225	489	0	33350
16870	397	32305	202	328	0	33232
16871	293	696	30950	275	0	32214
16872	29029	244	606	287	0	30166
16873	644	137	29831	220	0	30832
16874	291	116	29390	207	0	30004
16875	211	143	675	28588	0	29617
16876	28749	62	304	648	0	29763
16877	516	28959	191	340	0	30006
16878	28620	458	174	309	0	29561
16879	28237	187	138	283	0	28845
16880	629	28486	123	195	0	29433
16881	28268	456	137	223	0	29084
16882	28186	183	148	208	0	28725
16883	612	28690	130	136	0	29568
16884	352	510	105	28703	0	29670
16885	264	191	117	29659	0	30231
16886	30483	121	109	650	0	31363
16887	567	31239	110	285	0	32201
16888	32080	555	131	213	0	32979
16889	32403	235	99	230	0	32967
16890	34178	131	89	221	0	34619
16891	956	130	100	33568	0	34754
16892	499	110	60	34579	0	35248
16893	34391	98	72	914	0	35475
16894	35227	131	65	428	0	35851
16895	35720	110	67	302	0	36199
16896	1118	79	73	36219	0	37489
16897	503	120	36363	813	0	37799
16898	394	85	729	36960	0	38168
16899	327	77	282	39584	0	40270
16900	283	100	38489	1123	0	39995
16901	257	107	41147	550	0	42061
16902	365	82	1177	41433	0	43057
16903	286	89	41901	1177	0	43453
16904	42074	80	1157	673	0	43984
16905	1244	82	555	42676	0	44557
16906	690	55	312	43833	0	44890
16907	44027	77	239	1665	0	46008
16908	1320	50	232	44177	0	45779
16909	727	58	193	44800	0	45778
16910	483	56	213	45413	0	46165
16911	410	88	187	45617	0	46302
16912	332	80	43852	1834	0	46098
16913	361	58	1101	44556	0	46076
16914	284	83	43542	1601	0	45510
16915	241	44047	1229	982	0	46499
16916	316	1006	559	44454	0	46335
16917	284	427	43660	1506	0	45877
16918	40781	205	1222	1033	0	43241
16919	1224	43047	654	644	0	45569
16920	43519	1046	381	617	0	45563
16921	1430	455	301	42051	0	44237
16922	644	41980	308	1411	0	44343
16923	42129	1093	231	956	0	44409
16924	1258	42524	253	636	0	44671
16925	42914	1220	252	594	0	44980
16926	1452	579	238	42726	0	44995
16927	43084	344	234	1493	0	45155
16928	1431	43443	249	832	0	45955
16929	43786	1283	231	646	0	45946
16930	1566	587	43084	542	0	45779
16931	925	351	1248	43518	0	46042
16932	43237	268	581	1544	0	45630
16933	43915	257	309	975	0	45456
16934	1972	233	270	42907	0	45382
16935	994	266	42568	1536	0	45364
16936	663	39715	1201	1054	0	42633
16937	596	43200	589	613	0	44998
16938	43485	1493	416	638	0	46032
16939	1584	678	271	42962	0	45495
16940	939	340	261	44018	0	45558
16941	43117	288	316	1877	0	45598
16942	43116	273	313	1033	0	44735
16943	1850	273	42373	700	0	45196
16944	1069	258	1185	41999	0	44511
16945	681	230	41159	1521	0	43591
16946	613	40622	1172	949	0	43356
16947	38810	1024	623	813	0	41270
16948	1239	38942	386	660	0	41227
16949	702	39218	343	585	0	40848
16950	737	1260	302	38809	0	41108
16951	37958	580	260	1435	0	40233
16952	1144	37908	327	842	0	40221
16953	37470	1121	272	718	0	39581
16954	1261	37246	329	549	0	39385
16955	852	1146	273	37424	0	39695
16956	37200	579	272	1378	0	39429
16957	1297	401	37101	868	0	39667
16958	903	402	1017	37081	0	39403
16959	629	364	36675	1311	0	38979
16960	585	34645	1085	835	0	37150
16961	483	36950	539	699	0	38671
16962	35741	1274	420	681	0	38116
16963	1206	36441	306	599	0	38552
16964	36109	1158	340	664	0	38271
16965	36729	685	291	609	0	38314
16966	1508	553	35091	491	0	37643
16967	35369	432	976	574	0	37351
16968	1392	483	36310	490	0	38675
16969	915	36128	1083	538	0	38664
16970	36650	1115	583	505	0	38853
16971	1364	36406	426	491	0	38687
16972	931	1161	325	36766	0	39183
16973	36988	649	346	1221	0	39204
16974	1437	495	292	36848	0	39072
16975	885	451	36825	1378	0	39539
16976	715	472	1046	36665	0	38898
16977	610	505	512	37468	0	39095
16978	36704	485	336	1589	0	39114
16979	1390	429	36221	882	0	38922
16980	36284	438	1084	656	0	38462
16981	38065	332	570	586	0	39553
16982	1788	369	404	36910	0	39471
16983	1112	345	333	37220	0	39010
16984	36427	343	317	1574	0	38661
16985	1477	36166	336	807	0	38786
16986	1016	1054	234	35194	0	37498
16987	722	529	33921	1110	0	36282
16988	562	401	31990	725	0	33678
16989	539	33572	1108	546	0	35765
16990	637	973	514	31914	0	34038
16991	481	579	304	32656	0	34020
16992	31696	375	257	1304	0	33632
16993	1143	345	259	31401	0	33148
16994	29941	274	219	1111	0	31545
16995	1138	29091	204	644	0	31077
16996	560	28347	209	480	0	29596
16997	478	29462	176	418	0	30534
16998	28542	856	277	440	0	30115
16999	26399	401	222	380	0	27402
17000	945	25714	140	309	0	27108
17001	22701	381	84	146	0	23312
17002	440	22349	52	106	0	22947
17003	243	427	53	21604	0	22327
17004	134	21702	67	359	0	22262
17005	21711	386	120	192	0	22409
17006	21743	181	52	137	0	22113
17007	442	124	36	20787	0	21389
17008	20755	92	30	385	0	21262
17009	412	99	45	20506	0	21062
17010	189	20969	52	375	0	21585
17011	196	465	44	20890	0	21595
17012	161	21002	44	367	0	21574
17013	20726	319	57	238	0	21340
17014	372	153	20033	128	0	20686
17015	18879	88	227	126	0	19320
17016	341	78	74	19699	0	20192
17017	142	66	19479	290	0	19977
17018	18769	78	237	183	0	19267
17019	330	71	20591	84	0	21076
17020	164	64	285	20408	0	20921
17021	148	51	109	21065	0	21373
17022	147	71	47	21154	0	21419
17023	125	42	52	21607	0	21826
17024	108	21103	54	473	0	21738
17025	142	344	54	23001	0	23541
17026	22791	144	35	518	0	23488
17027	418	87	22398	219	0	23122
17028	171	23783	370	155	0	24479
17029	24638	450	135	169	0	25392
17030	26615	197	70	143	0	27025
17031	768	125	42	29096	0	30031
17032	319	104	29081	715	0	30219
17033	267	91	638	28618	0	29614
17034	216	85	285	29940	0	30526
17035	151	76	29522	1016	0	30765
17036	153	30582	746	455	0	31936
17037	31259	788	341	302	0	32690
17038	31330	399	150	317	0	32196
17039	32298	204	150	272	0	32924
17040	1441	163	110	31382	0	33096
17041	769	118	110	32942	0	33939
17042	33260	110	124	1341	0	34835
17043	1267	130	104	31874	0	33375
17044	679	32667	116	1149	0	34611
17045	34371	892	105	724	0	36092
17046	34174	437	127	606	0	35344
17047	36590	230	116	489	0	37425
17048	37196	184	108	435	0	37923
17049	1906	155	34673	289	0	37023
17050	1070	164	34877	299	0	36410
17051	827	179	1372	34783	0	37161
17052	761	128	618	36056	0	37563
17053	580	107	35158	1561	0	37406
17054	520	144	35378	816	0	36858
17055	566	102	1489	35619	0	37776
17056	35743	109	773	1401	0	38026
17057	1411	92	481	35509	0	37493
17058	842	126	35495	1463	0	37926
17059	582	36180	1212	891	0	38865
17060	36999	1008	703	629	0	39339
17061	38239	485	466	586	0	39776
17062	38514	252	430	563	0	39759
17063	38999	204	430	482	0	40115
17064	1954	177	36749	505	0	39385
17065	1172	145	1247	37158	0	39722
17066	38018	174	721	1444	0	40357
17067	1683	136	560	37973	0	40352
17068	1142	175	482	36665	0	38464
17069	860	35981	359	1746	0	38946
17070	880	1019	301	37574	0	39774
17071	36903	528	355	1635	0	39421
17072	1532	36635	358	1034	0	39559
17073	36993	1179	348	766	0	39286
17074	1727	36699	316	624	0	39366
17075	1267	1252	263	34684	0	37466
17076	998	34920	298	1346	0	37562
17077	873	36949	346	931	0	39099
17078	36209	1530	377	751	0	38867
17079	1619	857	35511	733	0	38720
17080	1141	503	34583	718	0	36945
17081	839	475	34553	761	0	36628
17082	32654	460	1605	882	0	35601
17083	1480	33871	920	709	0	36980
17084	1076	35264	570	683	0	37593
17085	33999	1553	461	697	0	36710
17086	1732	33426	449	561	0	36168
17087	1244	35421	419	532	0	37616
17088	1047	1716	459	35070	0	38292
17089	925	1051	34888	1465	0	38329
17090	934	796	35022	954	0	37706
17091	868	691	1567	35639	0	38765
17092	35472	581	967	1580	0	38600
17093	1713	35786	750	965	0	39214
17094	1268	1377	673	36466	0	39784
17095	1085	874	36029	1545	0	39533
17096	1059	701	35466	1005	0	38231
17097	1009	629	1676	36094	0	39408
17098	36048	622	1004	1712	0	39386
17099	36616	585	761	1163	0	39125
17100	2075	604	35436	856	0	38971
17101	35308	583	1466	898	0	38255
17102	1946	534	36094	795	0	39369
17103	1446	382	1686	34533	0	38047
17104	1079	35503	1209	1462	0	39253
17105	37059	1220	940	1041	0	40260
17106	1923	797	738	37241	0	40699
17107	1473	589	744	36041	0	38847
17108	1156	527	698	38418	0	40799
17109	1057	403	778	38505	0	40743
17110	970	419	36342	2206	0	39937
17111	979	35737	1530	1406	0	39652
17112	1103	1179	982	37002	0	40266
17113	36893	732	788	1886	0	40299
17114	1838	598	748	37090	0	40274
17115	1250	484	717	37561	0	40012
17116	1084	539	35869	2213	0	39705
17117	1008	602	33719	1456	0	36785
17118	910	34325	1652	1295	0	38182
17119	817	35794	1053	1153	0	38817
17120	827	1577	774	35699	0	38877
17121	35120	918	635	1951	0	38624
17122	1551	701	34510	1391	0	38153
17123	1171	34759	1267	1032	0	38229
17124	932	1289	841	33594	0	36656
17125	652	34340	618	1458	0	37068
17126	746	1331	520	33202	0	35799
17127	584	33632	503	1530	0	36249
17128	758	1181	368	32332	0	34639
17129	31067	812	348	1310	0	33537
17130	991	29207	350	837	0	31385
17131	515	785	253	26443	0	27996
17132	25659	515	252	858	0	27284
17133	711	25527	197	588	0	27023
17134	368	24094	180	455	0	25097
17135	412	24441	173	371	0	25397
17136	415	638	270	23482	0	24805
17137	184	338	133	23235	0	23890
17138	166	22879	85	582	0	23712
17139	187	505	111	23169	0	23972
17140	207	332	22958	496	0	23993
17141	120	22971	324	294	0	23709
17142	147	958	129	21643	0	22877
17143	143	22373	109	344	0	22969
17144	143	332	21176	193	0	21844
17145	88	21195	259	155	0	21697
17146	19561	298	125	145	0	20129
17147	165	80	45	19621	0	19911
17148	19631	36	23	194	0	19884
17149	140	31	19236	67	0	19474
17150	74	24	134	19470	0	19702
17151	29	50	19600	155	0	19834
17152	57	27	128	19509	0	19721
17153	20143	20	54	220	0	20437
17154	157	24	29	20064	0	20274
17155	20144	22	29	206	0	20401
17156	130	20318	24	79	0	20551
17157	20156	126	25	110	0	20417
17158	145	53	20724	50	0	20972
17159	60	20776	136	38	0	21010
17160	53	128	52	21002	0	21235
17161	73	45	23	20823	0	20964
17162	29	36	20389	160	0	20614
17163	26	20213	116	90	0	20445
17164	47	140	44	20612	0	20843
17165	19	20634	20	125	0	20798
17166	43	132	18	20367	0	20560
17167	13	20360	19	145	0	20537
17168	19992	132	13	96	0	20233
17169	134	60	18	20301	0	20513
17170	60	47	20242	123	0	20472
17171	15	20150	114	67	0	20346
17172	18	20976	35	51	0	21080
17173	46	150	20746	28	0	20970
17174	12	20916	108	49	0	21085
17175	55	119	41	20760	0	20975
17176	23	52	21157	99	0	21331
17177	62	19	92	20693	0	20866
17178	50	32	32	21185	0	21299
17179	25	32	21131	122	0	21310
17180	19450	27	102	105	0	19684
17181	110	15	43	21474	0	21642
17182	39	23	22552	108	0	22722
17183	15	22602	104	59	0	22780
17184	22808	96	47	102	0	23053
17185	99	22805	27	33	0	22964
17186	56	110	13	23155	0	23334
17187	22623	40	17	172	0	22852
17188	120	25	19	22559	0	22723
17189	44	39	23076	115	0	23274
17190	61	16	120	22734	0	22931
17191	22	27	22817	124	0	22990
17192	21725	14	132	151	0	22022
17193	123	33	22828	39	0	23023
17194	22377	18	124	105	0	22624
17195	22623	27	45	122	0	22817
17196	188	39	22526	29	0	22782
17197	66	27	21135	37	0	21265
17198	37	22502	170	25	0	22734
17199	23212	135	67	100	0	23514
17200	164	54	26	23506	0	23750
17201	99	27	33	23107	0	23266
17202	25222	26	24	336	0	25608
17203	25554	22	31	197	0	25804
17204	25710	30	23	124	0	25887
17205	25595	16	30	106	0	25747
17206	195	25	36	25225	0	25481
17207	25498	24	25	217	0	25764
17208	174	17	21	25699	0	25911
17209	105	22	39	25523	0	25689
17210	68	25	35	25905	0	26033
17211	49	43	25407	198	0	25697
17212	48	24640	143	100	0	24931
17213	43	25233	82	54	0	25412
17214	52	174	30	25727	0	25983
17215	25653	79	28	216	0	25976
17216	177	29	22	25601	0	25829
17217	25448	24	23	261	0	25756
17218	180	30	25832	91	0	26133
17219	24869	20	156	146	0	25191
17220	191	21	75	26126	0	26413
17221	26558	18	42	262	0	26880
17222	26191	25	27	184	0	26427
17223	26176	18	25	119	0	26338
17224	250	25	30	26157	0	26462
17225	123	43	25600	184	0	25950
17226	88	43	171	25496	0	25798
17227	25906	25	86	264	0	26281
17228	226	51	28418	98	0	28793
17229	163	35	195	30065	0	30458
17230	30859	23	82	413	0	31377
17231	284	29	31241	140	0	31694
17232	32151	22	279	212	0	32664
17233	33916	30	110	150	0	34206
17234	501	19	57	34171	0	34748
17235	226	25	32	34636	0	34919
17236	34437	13	44	579	0	35073
17237	455	25	35	35529	0	36044
17238	35116	14	31	612	0	35773
17239	461	35221	37	224	0	35943
17240	185	35764	34	118	0	36101
17241	163	495	24	35508	0	36190
17242	102	183	36251	451	0	36987
17243	65	36142	438	199	0	36844
17244	35558	422	139	220	0	36339
17245	432	35660	90	91	0	36273
17246	177	470	35507	63	0	36217
17247	193	163	401	34801	0	35558
17248	99	120	36043	433	0	36695
17249	61	36957	472	211	0	37701
17250	136	399	162	36687	0	37384
17251	89	36884	99	432	0	37504
17252	99	467	36586	174	0	37326
17253	159	204	418	36034	0	36815
17254	83	152	36775	440	0	37450
17255	129	83	482	36364	0	37058
17256	36365	57	207	630	0	37259
17257	447	138	35885	202	0	36672
17258	33189	79	458	268	0	33994
17259	516	77	34675	121	0	35389
17260	241	63	536	34319	0	35159
17261	132	73	36589	519	0	37313
17262	207	53	512	36295	0	37067
17263	145	76	235	36980	0	37436
17264	187	65	125	36126	0	36503
17265	127	62	111	37197	0	37497
17266	83	81	38547	677	0	39388
17267	37223	54	493	501	0	38271
17268	504	173	202	41556	0	42435
17269	42137	65	153	667	0	43022
17270	43211	53	114	390	0	43768
17271	43880	41	99	330	0	44350
17272	851	51	126	44311	0	45339
17273	460	47	96	44543	0	45146
17274	196	48953	116	781	0	50046
17275	53158	725	102	474	0	54459
17276	55362	335	92	390	0	56179
17277	55945	192	83	343	0	56563
17278	1581	173	55655	209	0	57618
17279	988	97	935	55736	0	57756
17280	582	100	55777	1021	0	57480
17281	54844	70	1106	663	0	56683
17282	56215	50	617	456	0	57338
17283	1622	75	351	55100	0	57148
17284	985	85	289	53366	0	54725
17285	610	55482	224	1312	0	57628
17286	56509	930	156	801	0	58396
17287	56705	432	163	629	0	57929
17288	1576	55949	179	437	0	58141
17289	56387	1079	148	449	0	58063
17290	1610	529	142	55978	0	58259
17291	1112	294	130	56721	0	58257
17292	56642	256	167	1636	0	58701
17293	1416	221	55851	832	0	58320
17294	55320	153	969	728	0	57170
17295	56791	147	481	627	0	58046
17296	1762	55574	307	371	0	58014
17297	56893	1008	238	467	0	58606
17298	1618	529	55484	284	0	57915
17299	1152	336	986	55817	0	58291
17300	56399	269	473	1242	0	58383
17301	1698	194	312	56257	0	58461
17302	936	208	52990	1307	0	55441
17303	780	168	1131	51419	0	53498
17304	628	55989	611	1393	0	58621
17305	653	996	358	58098	0	60105
17306	668	517	295	59382	0	60862
17307	644	288	289	58345	0	59566
17308	531	270	221	59576	0	60598
17309	466	268	57633	2010	0	60377
17310	581	257	1013	58434	0	60285
17311	57844	200	543	1860	0	60447
17312	1309	57288	397	1074	0	60068
17313	861	1069	282	59121	0	61333
17314	591	572	58871	1603	0	61637
17315	644	305	1082	59813	0	61844
17316	59757	269	642	1786	0	62454
17317	60171	224	424	1256	0	62075
17318	59868	224	383	906	0	61381
17319	2115	199	308	59440	0	62062
17320	1299	197	58804	1535	0	61835
17321	1041	58042	1170	937	0	61190
17322	59326	1069	666	883	0	61944
17323	1608	528	516	59116	0	61768
17324	1088	303	450	59793	0	61634
17325	878	321	58346	1860	0	61405
17326	839	56504	1197	1093	0	59633
17327	739	59256	637	972	0	61604
17328	747	1597	474	56270	0	59088
17329	590	717	54458	1625	0	57390
17330	50680	514	1134	1226	0	53554
17331	1527	490	49262	783	0	52062
17332	49020	325	974	919	0	51238
17333	1426	52434	641	786	0	55287
17334	1033	944	51708	652	0	54337
17335	50109	606	1119	665	0	52499
17336	1504	51206	649	491	0	53850
17337	52743	1054	426	653	0	54876
17338	1439	653	52348	471	0	54911
17339	1092	52458	1030	461	0	55041
17340	53304	1056	607	540	0	55507
17341	1526	631	52099	421	0	54677
17342	51937	413	1025	543	0	53918
17343	1435	388	729	52040	0	54592
17344	52818	339	561	1125	0	54843
17345	1513	324	500	52466	0	54803
17346	52841	320	395	1347	0	54903
17347	1432	314	52782	977	0	55505
17348	993	288	1053	53312	0	55646
17349	784	282	631	53365	0	55062
17350	642	366	53039	1638	0	55685
17351	666	324	1093	53588	0	55671
17352	644	41015	1021	1730	0	44410
17353	534	992	523	58871	0	60920
17354	665	521	492	62082	0	63760
17355	685	345	410	66986	0	68426
17356	611	386	65335	2430	0	68762
17357	61801	331	1562	1703	0	65397
17358	1861	251	856	68383	0	71351
17359	1086	231	69002	2237	0	72556
17360	66718	222	1853	1481	0	70274
17361	69566	231	1004	1034	0	71835
17362	71559	262	587	988	0	73396
17363	2886	287	530	70195	0	73898
17364	1721	266	511	76804	0	79302
17365	1259	258	469	74441	0	76427
17366	889	74397	443	3005	0	78734
17367	73593	1807	390	1946	0	77736
17368	72823	804	389	1473	0	75489
17369	2949	479	374	72043	0	75845
17370	1609	395	69746	2352	0	74102
17371	1208	352	69758	1377	0	72695
17372	864	65762	2557	1166	0	70349
17373	738	70167	1290	1010	0	73205
17374	63312	2353	1078	1105	0	67848
17375	1750	61809	331	548	0	64438
17376	61938	1534	290	524	0	64286
17377	62067	628	210	560	0	63465
17378	62297	311	244	531	0	63383
17379	2476	252	251	61710	0	64689
17380	1293	253	236	66372	0	68154
17381	67417	236	223	2412	0	70288
17382	2312	237	201	68379	0	71129
17383	1089	328	67482	2132	0	71031
17384	68154	235	1722	1062	0	71173
17385	2389	259	700	68384	0	71732
17386	1269	316	353	69917	0	71855
17387	949	266	259	71141	0	72615
17388	661	321	68296	2770	0	72048
17389	63763	305	1795	1504	0	67367
17390	2257	314	68349	800	0	71720
17391	1418	248	2028	67762	0	71456
17392	865	285	69098	2173	0	72421
17393	841	244	2163	67532	0	70780
17394	862	244	910	69878	0	71894
17395	714	293	70496	2862	0	74365
17396	934	302	2067	64235	0	67538
17397	733	70455	927	2275	0	74390
17398	70960	1847	568	1373	0	74748
17399	72455	715	419	1160	0	74749
17400	2986	336	491	71444	0	75257
17401	1468	225	71510	2582	0	75785
17402	889	68306	2182	1567	0	72944
17403	710	72943	1084	1188	0	75925
17404	68644	2316	758	1149	0	72867
17405	2339	968	67627	900	0	71834
17406	67224	491	2162	970	0	70847
17407	2648	331	1054	67584	0	71617
17408	1426	295	712	69525	0	71958
17409	66502	270	656	3245	0	70673
17410	2264	66569	590	1816	0	71239
17411	1264	1988	67519	1255	0	72026
17412	1158	858	2246	66475	0	70737
17413	876	521	68289	2605	0	72291
17414	787	67288	2455	1523	0	72053
17415	963	1922	1241	68476	0	72602
17416	67744	905	821	2864	0	72334
17417	68901	609	655	1740	0	71905
17418	3010	517	67455	1193	0	72175
17419	1619	67453	2245	1002	0	72319
17420	67276	2112	1158	1039	0	71585
17421	2643	68025	848	957	0	72473
17422	1549	2296	714	67747	0	72306
17423	67881	1065	639	2692	0	72277
17424	2657	744	624	68579	0	72604
17425	1436	598	66972	2906	0	71912
17426	1259	541	2305	68031	0	72136
17427	974	680	67820	2751	0	72225
17428	1133	608	2445	67573	0	71759
17429	67645	551	1228	3056	0	72480
17430	2645	68069	893	1669	0	73276
17431	69250	2226	696	1358	0	73530
17432	2845	1155	737	68709	0	73446
17433	1650	813	732	69753	0	72948
17434	1265	817	57611	3361	0	63054
17435	1039	690	67927	1763	0	71419
17436	1055	68138	2727	1383	0	73303
17437	1130	2245	67981	1186	0	72542
17438	62646	1134	2620	1334	0	67734
17439	2667	66270	1348	1228	0	71513
17440	1585	68563	965	1178	0	72291
17441	1186	70017	817	1191	0	73211
17442	1111	3105	838	68134	0	73188
17443	964	1458	68928	2893	0	74243
17444	899	69560	2554	1749	0	74762
17445	1134	2510	1282	64302	0	69228
17446	982	70303	924	2684	0	74893
17447	68870	2599	835	1774	0	74078
17448	70582	1237	899	1357	0	74075
17449	3244	914	854	68954	0	73966
17450	1653	801	881	69671	0	73006
17451	65569	747	858	3269	0	70443
17452	2446	63425	758	1845	0	68474
17453	1344	64250	686	1302	0	67582
17454	1210	2632	557	58871	0	63270
17455	693	994	55192	1996	0	58875
17456	608	54871	1638	1184	0	58301
17457	52829	1637	969	947	0	56382
17458	1533	51750	641	826	0	54750
17459	827	52437	516	731	0	54511
17460	50036	1863	556	640	0	53095
17461	1518	51612	370	609	0	54109
17462	886	1654	50026	594	0	53160
17463	640	50437	1291	650	0	53018
17464	44236	1204	694	453	0	46587
17465	1056	44316	333	331	0	46036
17466	44285	1195	283	366	0	46129
17467	1228	666	230	44000	0	46124
17468	667	515	210	45208	0	46600
17469	448	471	44586	1262	0	46767
17470	384	45074	878	648	0	46984
17471	447	1119	414	45724	0	47704
17472	45242	594	342	1125	0	47303
17473	45234	439	248	645	0	46566
17474	1203	45805	256	456	0	47720
17475	674	1096	222	45407	0	47399
17476	45618	553	212	1113	0	47496
17477	45867	461	254	592	0	47174
17478	1343	438	43556	385	0	45722
17479	670	367	40403	316	0	41756
17480	411	316	39926	250	0	40903
17481	294	38862	756	198	0	40110
17482	37639	679	550	272	0	39140
17483	701	37505	206	211	0	38623
17484	37245	678	253	251	0	38427
17485	729	38199	201	156	0	39285
17486	399	733	173	38854	0	40159
17487	39274	326	161	757	0	40518
17488	760	262	39247	265	0	40534
17489	38441	249	604	258	0	39552
17490	39912	231	247	237	0	40627
17491	864	39163	176	183	0	40386
17492	409	39967	153	148	0	40677
17493	41089	737	228	196	0	42250
17494	776	346	41769	126	0	43017
17495	39413	358	684	217	0	40672
17496	40653	190	272	173	0	41288
17497	920	192	151	39787	0	41050
17498	40863	181	110	621	0	41775
17499	852	234	91	41270	0	42447
17500	471	202	90	42266	0	43029
17501	445	166	100	40891	0	41602
17502	324	41007	148	726	0	42205
17503	41514	580	106	428	0	42628
17504	41902	258	131	295	0	42586
17505	903	223	114	41643	0	42883
17506	543	191	124	40890	0	41748
17507	365	41214	141	717	0	42437
17508	41350	638	126	413	0	42527
17509	825	311	40791	250	0	42177
17510	481	276	570	41241	0	42568
17511	401	218	40523	679	0	41821
17512	465	198	601	40494	0	41758
17513	326	209	40427	780	0	41742
17514	399	179	617	39526	0	40721
17515	39883	191	250	870	0	41194
17516	814	185	39772	373	0	41144
17517	38173	148	659	397	0	39377
17518	830	40332	320	311	0	41793
17519	472	632	266	40963	0	42333
17520	450	289	198	41588	0	42525
17521	42109	257	220	894	0	43480
17522	887	205	171	43628	0	44891
17523	532	229	43388	797	0	44946
17524	43215	193	549	623	0	44580
17525	45842	179	244	498	0	46763
17526	45734	174	193	468	0	46569
17527	45600	137	180	494	0	46411
17528	1030	44674	199	386	0	46289
17529	596	529	149	44701	0	45975
17530	44390	210	181	792	0	45573
17531	901	196	168	43829	0	45094
17532	43324	198	143	749	0	44414
17533	895	147	42245	372	0	43659
17534	540	184	41722	288	0	42734
17535	539	573	584	39534	0	41230
17536	369	40705	292	662	0	42028
17537	356	42375	226	461	0	43418
17538	41498	577	248	552	0	42875
17539	690	221	41120	360	0	42391
17540	37072	135	496	434	0	38137
17541	655	40020	288	255	0	41218
17542	40257	414	187	331	0	41189
17543	741	195	146	39574	0	40656
17544	419	203	39932	599	0	41153
17545	411	178	440	39770	0	40799
17546	397	138	203	39487	0	40225
17547	324	38906	223	640	0	40093
17548	321	40749	189	412	0	41671
17549	343	554	170	40432	0	41499
17550	348	41175	165	578	0	42266
17551	355	489	40543	335	0	41722
17552	331	233	38836	311	0	39711
17553	37152	178	557	420	0	38307
17554	40219	179	260	377	0	41035
17555	708	39505	211	244	0	40668
17556	470	474	183	39466	0	40593
17557	406	205	153	40030	0	40794
17558	341	221	39899	646	0	41107
17559	349	145	504	37897	0	38895
17560	285	39289	264	604	0	40442
17561	284	504	38281	356	0	39425
17562	321	252	37658	290	0	38521
17563	303	35747	586	315	0	36951
17564	331	531	38081	241	0	39184
17565	348	239	542	37662	0	38791
17566	473	232	283	32948	0	33936
17567	288	212	38323	671	0	39494
17568	372	218	485	37509	0	38584
17569	224	36672	294	643	0	37833
17570	248	38540	251	374	0	39413
17571	262	535	180	37642	0	38619
17572	238	243	38334	549	0	39364
17573	174	38514	496	303	0	39487
17574	319	506	216	38255	0	39296
17575	165	174	37813	481	0	38633
17576	35005	126	380	303	0	35814
17577	37596	101	141	247	0	38085
17578	37732	92	142	227	0	38193
17579	520	99	113	37220	0	37952
17580	227	97	118	37331	0	37773
17581	164	93	38472	493	0	39222
17582	195	102	372	37858	0	38527
17583	183	92	166	38517	0	38958
17584	120	112	38573	473	0	39278
17585	32334	90	366	415	0	33205
17586	348	36174	169	163	0	36854
17587	36069	317	130	210	0	36726
17588	340	35833	115	156	0	36444
17589	173	362	82	35938	0	36555
17590	122	127	36110	371	0	36730
17591	181	174	342	34984	0	35681
17592	88	95	35452	433	0	36068
17593	29982	70	330	321	0	30703
17594	306	57	33660	129	0	34152
17595	152	66	332	32573	0	33123
17596	96	69	33527	356	0	34048
17597	82	34356	376	153	0	34967
17598	164	345	175	35158	0	35842
17599	187	106	118	34699	0	35110
17600	155	82	93	37124	0	37454
17601	121	75	36982	621	0	37799
17602	117	79	37731	263	0	38190
17603	157	52	610	37631	0	38450
17604	183	53	233	44882	0	45351
17605	155	56	161	48042	0	48414
17606	48524	64	139	1501	0	50228
17607	1101	40	131	50446	0	51718
17608	418	77	51815	1288	0	53598
17609	52944	58	1122	702	0	54826
17610	1343	79	503	55205	0	57130
17611	56686	73	282	1543	0	58584
17612	58209	62	183	852	0	59306
17613	1911	51	177	58019	0	60158
17614	58304	33	234	1722	0	60293
17615	58902	49	204	939	0	60094
17616	1966	47	58324	568	0	60905
17617	926	58836	1322	471	0	61555
17618	823	1191	596	57131	0	59741
17619	576	498	322	60345	0	61741
17620	59527	249	277	2076	0	62129
17621	59005	174	221	1152	0	60552
17622	58479	120	220	870	0	59689
17623	2248	130	54699	568	0	57645
17624	1136	55105	1398	543	0	58182
17625	55565	1243	703	580	0	58091
17626	1795	55867	415	424	0	58501
17627	56619	1460	275	585	0	58939
17628	2085	642	235	56145	0	59107
17629	56596	363	214	1718	0	58891
17630	57323	285	236	989	0	58833
17631	57879	236	211	725	0	59051
17632	2450	218	56089	562	0	59319
17633	57304	204	1333	655	0	59496
17634	2176	57841	595	508	0	61120
17635	60016	1380	376	609	0	62381
17636	61110	624	269	572	0	62575
17637	62237	344	260	534	0	63375
17638	2916	294	274	58458	0	61942
17639	1675	59890	295	1501	0	63361
17640	60747	1604	275	942	0	63568
17641	2309	794	60003	610	0	63716
17642	1451	60491	1487	526	0	63955
17643	1439	1706	608	55459	0	59212
17644	1073	60283	412	1451	0	63219
17645	60507	1782	326	867	0	63482
17646	62967	896	322	597	0	64782
17647	2899	535	325	61476	0	65235
17648	1602	563	60016	1828	0	64009
17649	1253	60054	1631	1049	0	63987
17650	1585	1792	856	48764	0	52997
17651	1194	918	507	61484	0	64103
17652	1135	544	399	64493	0	66571
17653	63332	477	359	2767	0	66935
17654	64461	428	362	1467	0	66718
17655	64999	398	311	1116	0	66824
17656	65728	482	308	924	0	67442
17657	3407	413	313	63561	0	67694
17658	1919	502	63857	2187	0	68465
17659	1639	394	1741	64777	0	68551
17660	1485	322	815	65872	0	68494
17661	1422	379	489	66341	0	68631
17662	1497	350	440	66886	0	69173
17663	64985	350	389	3331	0	69055
17664	2716	344	516	65682	0	69258
17665	65276	292	517	2957	0	69042
17666	66146	380	377	1898	0	68801
17667	3511	363	62957	1439	0	68270
17668	2400	328	61982	1212	0	65922
17669	1922	291	64239	1228	0	67680
17670	1932	356	2458	62760	0	67506
17671	1753	345	64236	2414	0	68748
17672	1659	323	2307	63186	0	67475
17673	1425	466	1215	64305	0	67411
17674	64024	417	765	3327	0	68533
17675	2809	405	649	63253	0	67116
17676	1956	64403	559	2870	0	69788
17677	66586	1755	614	1850	0	70805
17678	3109	66564	534	1310	0	71517
17679	2036	2107	66708	1145	0	71996
17680	1559	68074	2067	1005	0	72705
17681	67127	2288	1100	1083	0	71598
17682	3084	1249	717	66564	0	71614
17683	2123	854	65751	2325	0	71053
17684	65970	622	2108	1576	0	70276
17685	3164	611	1145	66366	0	71286
17686	2157	533	66384	2442	0	71516
17687	1866	528	2126	66735	0	71255
17688	1648	527	1179	67746	0	71100
17689	1607	491	793	67704	0	70595
17690	1473	66839	627	3040	0	71979
17691	68031	2057	558	1793	0	72439
17692	3113	1118	524	66324	0	71079
17693	2029	67038	533	2423	0	72023
17694	1734	2181	435	67467	0	71817
17695	1323	1359	66558	2594	0	71834
17696	1344	67163	1972	1537	0	72016
17697	66237	2116	1093	1399	0	70845
17698	66753	1264	755	1037	0	69809
17699	3073	788	563	64874	0	69298
17700	1772	719	521	65843	0	68855
17701	64603	564	472	2956	0	68595
17702	62971	506	452	1865	0	65794
17703	2850	62778	503	1307	0	67438
17704	55957	1312	329	882	0	58480
17705	1875	640	53285	656	0	56456
17706	1114	399	51965	616	0	54094
17707	689	50433	1352	596	0	53070
17708	556	51331	712	478	0	53077
17709	47802	1214	991	551	0	50558
17710	1091	48118	315	299	0	49823
17711	47538	996	223	398	0	49155
17712	46876	434	204	411	0	47925
17713	46413	267	217	403	0	47300
17714	1353	221	173	45705	0	47452
17715	46162	193	183	1075	0	47613
17716	1229	190	44443	523	0	46385
17717	651	213	44415	403	0	45682
17718	479	44559	1044	364	0	46446
17719	402	808	45605	335	0	47150
17720	448	422	983	43839	0	45692
17721	349	307	45414	968	0	47038
17722	370	297	44818	486	0	45971
17723	412	237	1103	44970	0	46722
17724	45326	238	542	1076	0	47182
17725	45624	269	322	592	0	46807
17726	1275	240	45826	334	0	47675
17727	44678	239	887	462	0	46266
17728	1154	181	46421	285	0	48041
17729	45690	158	991	401	0	47240
17730	48347	154	514	397	0	49412
17731	1365	141	346	47604	0	49456
17732	739	196	251	46377	0	47563
17733	489	44705	296	1164	0	46654
17734	385	46866	319	545	0	48115
17735	448	1012	279	45310	0	47049
17736	436	423	298	45955	0	47112
17737	44262	253	218	1110	0	45843
17738	916	44106	223	496	0	45741
17739	43809	752	264	482	0	45307
17740	900	44246	260	294	0	45700
17741	488	899	43812	231	0	45430
17742	535	413	787	43689	0	45424
17743	44286	231	380	992	0	45889
17744	46655	171	221	579	0	47626
17745	1252	47261	217	357	0	49087
17746	565	47756	203	242	0	48766
17747	382	49139	179	251	0	49951
17748	504	1273	189	50405	0	52371
17749	327	465	50622	1144	0	52558
17750	275	50460	1067	461	0	52263
17751	419	1118	369	49918	0	51824
17752	352	413	201	51091	0	52057
17753	191	273	50194	1227	0	51885
17754	260	210	49289	470	0	50229
17755	47470	172	1224	480	0	49346
17756	1143	184	51327	224	0	52878
17757	50291	216	1057	396	0	51960
17758	49985	172	432	315	0	50904
17759	50109	203	253	321	0	50886
17760	49775	205	225	335	0	50540
17761	1463	203	47944	219	0	49829
17762	595	48377	976	244	0	50192
17763	499	1047	429	47645	0	49620
17764	367	497	48632	1049	0	50545
17765	424	308	1054	47040	0	48826
17766	375	41569	563	1128	0	43635
17767	426	1068	314	49624	0	51432
17768	425	430	297	50220	0	51372
17769	466	323	226	48981	0	49996
17770	49136	215	279	1560	0	51190
17771	1297	250	309	48876	0	50732
17772	740	198	228	49306	0	50472
17773	526	206	329	48643	0	49704
17774	387	46711	302	1379	0	48779
17775	46463	1019	239	734	0	48455
17776	1186	44162	255	441	0	46044
17777	489	46048	201	315	0	47053
17778	474	1080	268	46286	0	48108
17779	439	417	215	46890	0	47961
17780	46331	264	202	1486	0	48283
17781	1260	231	196	47149	0	48836
17782	47494	164	172	1457	0	49287
17783	58241	246	168	704	0	59359
17784	2149	211	182	57546	0	60088
17785	1046	221	170	57405	0	58842
17786	465	58602	200	2268	0	61535
17787	60227	1705	172	1266	0	63370
17788	1867	62224	187	748	0	65026
17789	62180	1999	185	619	0	64983
17790	2140	907	60518	529	0	64094
17791	60664	501	1701	620	0	63486
17792	64695	365	657	562	0	66279
17793	2825	324	310	62232	0	65691
17794	1269	329	62468	2128	0	66194
17795	771	62311	1883	1087	0	66052
17796	831	2051	764	63709	0	67355
17797	635	919	63631	2279	0	67464
17798	787	546	1978	62966	0	66277
17799	61994	342	865	2536	0	65737
17800	2362	340	61706	1146	0	65554
17801	1209	60331	1987	751	0	64278
17802	714	63420	920	634	0	65688
17803	1025	2657	551	53966	0	58199
17804	586	62737	407	1693	0	65423
17805	62093	2310	349	1053	0	65805
17806	63358	1031	353	751	0	65493
17807	63846	639	321	713	0	65519
17808	2973	520	60486	556	0	64535
17809	61797	492	2041	630	0	64960
17810	2566	528	872	61161	0	65127
17811	1451	416	545	62513	0	64925
17812	977	432	403	63283	0	65095
17813	898	418	386	63365	0	65067
17814	702	417	61117	3082	0	65318
17815	650	455	60925	1550	0	63580
17816	641	458	61263	951	0	63313
17817	57543	402	2819	941	0	61705
17818	2368	59375	1203	734	0	63680
17819	1357	2118	646	59022	0	63143
17820	58584	988	456	2569	0	62597
17821	2408	58992	465	1311	0	63176
17822	1268	61203	535	924	0	63930
17823	59654	2696	477	750	0	63577
17824	60657	1242	446	763	0	63108
17825	2921	60414	493	795	0	64623
17826	1784	2216	381	56330	0	60711
17827	960	60030	411	2241	0	63642
17828	59738	2293	401	1313	0	63745
17829	59782	1120	485	972	0	62359
17830	59819	814	417	779	0	61829
17831	3183	57535	425	726	0	61869
17832	1696	2200	409	58210	0	62515
17833	1055	1160	57685	2401	0	62301
17834	1110	792	1943	57311	0	61156
17835	978	667	909	59249	0	61803
17836	859	751	56914	2933	0	61457
17837	56014	626	2004	1483	0	60127
17838	2633	590	972	57348	0	61543
17839	1520	658	567	56697	0	59442
17840	1001	56508	436	2823	0	60768
17841	56243	2145	381	1557	0	60326
17842	2696	1175	399	54682	0	58952
17843	1467	55041	374	2388	0	59270
17844	52418	1995	381	1371	0	56165
17845	2183	52565	416	913	0	56077
17846	50572	2025	347	840	0	53784
17847	2297	1010	49546	797	0	53650
17848	1144	645	46018	750	0	48557
17849	829	505	46936	583	0	48853
17850	609	46921	2357	628	0	50515
17851	886	1762	1392	42347	0	46387
17852	686	45657	626	1498	0	48467
17853	46299	1886	438	993	0	49616
17854	1873	1113	46421	612	0	50019
17855	45726	692	1637	600	0	48655
17856	47179	603	882	511	0	49175
17857	2441	582	595	45630	0	49248
17858	46635	525	401	1748	0	49309
17859	2275	506	390	46402	0	49573
17860	1230	489	45944	1840	0	49503
17861	44942	447	1641	1076	0	48106
17862	1893	45689	999	646	0	49227
17863	1231	1604	663	45904	0	49402
17864	46269	968	437	1728	0	49402
17865	2077	600	394	46232	0	49303
17866	1178	537	45022	1933	0	48670
17867	951	449	1537	44425	0	47362
17868	680	45059	935	1883	0	48557
17869	45631	1606	532	1106	0	48875
17870	1963	859	404	45434	0	48660
17871	45942	537	406	1891	0	48776
17872	2169	411	340	45711	0	48631
17873	1248	326	335	44773	0	46682
17874	792	44872	372	2215	0	48251
17875	44660	1559	305	1286	0	47810
17876	1807	46467	279	864	0	49417
17877	1177	1663	266	42006	0	45112
17878	687	43327	244	1511	0	45769
17879	42713	1606	200	1023	0	45542
17880	42122	880	259	739	0	44000
17881	42119	553	223	721	0	43616
17882	2120	39992	263	560	0	42935
17883	499	30271	109	212	0	31091
17884	29747	773	104	284	0	30908
17885	782	30388	115	200	0	31485
17886	535	885	155	28508	0	30083
17887	281	273	27855	584	0	28993
17888	25590	192	400	303	0	26485
17889	26341	145	128	251	0	26865
17890	26066	137	81	183	0	26467
17891	569	26136	63	131	0	26899
17892	25097	384	34	156	0	25671
17893	476	173	25685	79	0	26413
17894	207	25168	273	76	0	25724
17895	225	496	103	23723	0	24547
17896	78	24162	51	154	0	24445
17897	23300	194	35	120	0	23649
17898	183	23767	25	58	0	24033
17899	99	186	22	23725	0	24032
17900	64	23948	31	163	0	24206
17901	94	189	23	24449	0	24755
17902	69	85	22	23996	0	24172
17903	72	62	24111	211	0	24456
17904	83	52	170	23187	0	23492
17905	23282	47	48	243	0	23620
17906	23142	47	41	131	0	23361
17907	255	53	32	23242	0	23582
17908	113	63	23033	202	0	23411
17909	119	54	161	22712	0	23046
17910	22772	44	60	268	0	23144
17911	23276	57	47	175	0	23555
17912	23436	42	38	147	0	23663
17913	252	24302	31	68	0	24653
17914	24470	187	36	129	0	24822
17915	234	85	24135	79	0	24533
17916	25965	54	199	179	0	26397
17917	322	48	83	27238	0	27691
17918	162	30	60	27316	0	27568
17919	129	53	33	27644	0	27859
17920	27130	57	23	397	0	27607
17921	26620	33	25	209	0	26887
17922	339	46	41	26843	0	27269
17923	180	36	27152	270	0	27638
17924	152	50	209	26894	0	27305
17925	145	40	60	26391	0	26636
17926	98	55	26131	324	0	26608
17927	118	25837	225	157	0	26337
17928	134	240	78	26174	0	26626
17929	26716	82	64	355	0	27217
17930	287	74	43	26839	0	27243
17931	161	56	21	27029	0	27267
17932	26997	36	35	461	0	27529
17933	301	26652	37	184	0	27174
17934	151	27195	30	133	0	27509
17935	26881	298	29	199	0	27407
17936	315	129	26948	97	0	27489
17937	25339	87	230	220	0	25876
17938	327	70	28609	97	0	29103
17939	154	29139	264	100	0	29657
17940	29358	261	112	178	0	29909
17941	29548	111	49	201	0	29909
17942	29713	89	33	159	0	29994
17943	29677	58	37	182	0	29954
17944	405	90	29328	64	0	29887
17945	228	57	231	28555	0	29071
17946	29057	74	88	335	0	29554
17947	329	69	30254	130	0	30782
17948	185	72	29363	90	0	29710
17949	139	29672	260	65	0	30136
17950	30079	202	116	112	0	30509
17951	309	86	72	29850	0	30317
17952	29960	39	54	329	0	30382
17953	274	30659	60	109	0	31102
17954	202	241	54	33014	0	33511
17955	159	76	45	33207	0	33487
17956	142	54	37	34111	0	34344
17957	121	47	34539	439	0	35146
17958	85	34944	333	213	0	35575
17959	37112	364	130	205	0	37811
17960	536	177	67	37194	0	37974
17961	37128	55	61	582	0	37826
17962	36769	47	58	283	0	37157
17963	731	45	37	36906	0	37719
17964	275	78	37413	499	0	38265
17965	221	66	431	36819	0	37537
17966	139	37211	183	511	0	38044
17967	186	428	83	38074	0	38771
17968	109	175	37759	570	0	38613
17969	36978	73	454	360	0	37865
17970	555	84	182	38320	0	39141
17971	37805	49	114	634	0	38602
17972	560	66	37231	247	0	38104
17973	35298	68	444	286	0	36096
17974	611	58	36862	142	0	37673
17975	34757	47	460	244	0	35508
17976	582	35485	220	111	0	36398
17977	279	36787	104	154	0	37324
17978	230	536	100	36761	0	37627
17979	305	270	138	32888	0	33601
17980	182	131	63	37133	0	37509
17981	36938	89	88	747	0	37862
17982	555	51	71	37431	0	38108
17983	282	96	37166	560	0	38104
17984	34990	76	416	479	0	35961
17985	493	37174	199	230	0	38096
17986	37494	431	133	289	0	38347
17987	37048	186	109	265	0	37608
17988	719	121	37304	124	0	38268
17989	460	90	518	36837	0	37905
17990	291	95	231	39337	0	39954
17991	202	104	39631	718	0	40655
17992	153	39481	555	374	0	40563
17993	38774	555	218	368	0	39915
17994	39026	213	137	334	0	39710
17995	838	137	126	39789	0	40890
17996	462	83	108	39797	0	40450
17997	298	79	91	41583	0	42051
17998	40365	74	133	1033	0	41605
17999	760	41603	115	439	0	42917
18000	42096	676	109	370	0	43251
18001	42172	259	101	300	0	42832
18002	1046	161	44283	208	0	45698
18003	578	133	822	42730	0	44263
18004	319	44949	345	892	0	46505
18005	341	795	197	45943	0	47276
18006	352	360	173	47707	0	48592
18007	287	232	48339	1235	0	50093
18008	49181	145	930	726	0	50982
18009	53800	111	411	551	0	54873
18010	55605	109	234	475	0	56423
18011	1801	149	178	54285	0	56413
18012	937	162	115	53089	0	54303
18013	518	52818	170	1601	0	55107
18014	399	55345	225	735	0	56704
18015	54049	1489	168	581	0	56287
18016	1478	52744	194	330	0	54746
18017	677	1394	52181	347	0	54599
18018	640	545	1239	52689	0	55113
18019	53159	353	497	1545	0	55554
18020	1445	304	52604	700	0	55053
18021	742	289	52177	517	0	53725
18022	52988	242	1604	487	0	55321
18023	53860	225	695	445	0	55225
18024	1975	199	428	52669	0	55271
18025	967	208	52556	1502	0	55233
18026	769	220	1336	52759	0	55084
18027	600	294	48369	1690	0	50953
18028	530	276	52653	765	0	54224
18029	541	53272	1599	571	0	55983
18030	53508	1334	745	607	0	56194
18031	53776	587	512	578	0	55453
18032	1856	53023	423	455	0	55757
18033	1053	1397	365	52782	0	55597
18034	834	577	389	53647	0	55447
18035	668	437	408	54613	0	56126
18036	53214	308	359	2052	0	55933
18037	1619	52856	353	996	0	55824
18038	51745	1312	347	742	0	54146
18039	51808	610	367	614	0	53399
18040	1963	430	49929	501	0	52823
18041	1020	50173	1372	528	0	53093
18042	836	1321	703	50751	0	53611
18043	624	671	51044	1462	0	53801
18044	49726	476	1461	852	0	52515
18045	51677	329	675	652	0	53333
18046	51716	352	498	601	0	53167
18047	51037	299	402	556	0	52294
18048	2254	282	298	49132	0	51966
18049	1101	300	48455	1559	0	51415
18050	980	245	1350	48565	0	51140
18051	48361	294	610	1752	0	51017
18052	48411	244	462	933	0	50050
18053	2003	46634	348	661	0	49646
18054	45421	1167	312	556	0	47456
18055	1778	546	44212	412	0	46948
18056	957	403	44025	391	0	45776
18057	42772	316	1552	485	0	45125
18058	1632	42747	745	369	0	45493
18059	948	1001	388	39102	0	41439
18060	724	40647	308	1016	0	42695
18061	718	1138	254	41182	0	43292
18062	665	488	269	41632	0	43054
18063	650	365	274	43120	0	44409
18064	41495	309	256	1664	0	43724
18065	42990	290	253	871	0	44404
18066	42688	294	243	607	0	43832
18067	1740	307	41333	448	0	43828
18068	41953	248	1171	459	0	43831
18069	1710	230	612	42881	0	45433
18070	1040	216	450	45286	0	46992
18071	831	197	44932	1629	0	47589
18072	757	247	1322	49645	0	51971
18073	51178	203	635	1856	0	53872
18074	1791	222	50938	882	0	53833
18075	1003	219	1551	51314	0	54087
18076	51534	183	688	1873	0	54278
18077	51684	235	516	1012	0	53447
18078	2189	237	50766	732	0	53924
18079	1236	248	51461	557	0	53502
18080	994	212	1891	51672	0	54769
18081	52542	192	925	1820	0	55479
18082	53486	224	569	968	0	55247
18083	2389	234	391	50295	0	53309
18084	1236	52216	427	1706	0	55585
18085	52626	1380	457	969	0	55432
18086	1893	53144	441	834	0	56312
18087	1276	1547	356	53041	0	56220
18088	978	599	52463	1732	0	55772
18089	776	405	50958	919	0	53058
18090	731	265	52099	643	0	53738
18091	771	229	2162	49734	0	52896
18092	791	208	967	51345	0	53311
18093	50398	197	680	2092	0	53367
18094	1744	49972	496	1150	0	53362
18095	49961	1351	449	768	0	52529
18096	2133	572	427	46459	0	49591
18097	1012	48042	401	1432	0	50887
18098	763	50143	361	816	0	52083
18099	808	1728	328	48696	0	51560
18100	48285	727	368	1635	0	51015
18101	1631	48794	373	834	0	51632
18102	45325	1219	308	683	0	47535
18103	1512	46516	342	494	0	48864
18104	45577	1362	344	471	0	47754
18105	1638	622	44359	408	0	47027
18106	903	447	43328	380	0	45058
18107	643	42664	1383	342	0	45032
18108	39170	1335	1065	371	0	41941
18109	1046	36875	310	227	0	38458
18110	501	34688	208	251	0	35648
18111	650	1081	233	35548	0	37512
18112	35511	473	234	837	0	37055
18113	867	36048	189	394	0	37498
18114	34971	790	180	332	0	36273
18115	919	34987	135	220	0	36261
18116	34391	845	158	253	0	35647
18117	873	34271	198	153	0	35495
18118	434	35069	148	178	0	35829
18119	442	987	135	33118	0	34682
18120	275	34767	129	657	0	35828
18121	34267	941	118	348	0	35674
18122	821	466	34078	248	0	35613
18123	520	320	651	34097	0	35588
18124	320	319	34673	743	0	36055
18125	312	272	750	34367	0	35701
18126	347	248	310	35164	0	36069
18127	273	289	33466	965	0	34993
18128	30282	217	712	639	0	31850
18129	850	32562	401	354	0	34167
18130	32955	788	292	348	0	34383
18131	943	33320	221	306	0	34790
18132	659	875	192	33455	0	35181
18133	33429	419	421	875	0	35144
18134	33832	332	280	478	0	34922
18135	34241	259	241	420	0	35161
18136	1230	282	203	33524	0	35239
18137	764	270	155	33277	0	34466
18138	523	34494	223	983	0	36223
18139	34923	891	207	586	0	36607
18140	35602	444	202	417	0	36665
18141	35609	403	218	325	0	36555
18142	35396	327	219	371	0	36313
18143	1226	34145	258	311	0	35940
18144	710	841	250	34593	0	36394
18145	561	480	34136	827	0	36004
18146	33203	353	794	526	0	34876
18147	35834	318	306	519	0	36977
18148	1285	323	35020	360	0	36988
18149	731	371	35169	340	0	36611
18150	612	394	931	35114	0	37051
18151	487	338	469	36463	0	37757
18152	461	338	292	37314	0	38405
18153	36530	405	207	1255	0	38397
18154	1096	342	221	36723	0	38382
18155	609	323	35793	1134	0	37859
18156	495	312	900	36508	0	38215
18157	479	270	37148	1084	0	38981
18158	500	304	933	36806	0	38543
18159	514	272	449	39471	0	40706
18160	408	262	39222	1283	0	41175
18161	36083	286	1039	806	0	38214
18162	1121	39511	441	451	0	41524
18163	39682	1060	284	410	0	41436
18164	1333	511	178	40347	0	42369
18165	40317	442	138	1201	0	42098
18166	1269	41219	169	671	0	43328
18167	683	43350	194	457	0	44684
18168	681	1867	188	43216	0	45952
18169	474	669	44681	1178	0	47002
18170	392	462	42134	544	0	43532
18171	402	43111	1304	427	0	45244
18172	37134	908	585	263	0	38890
18173	934	358	291	36904	0	38487
18174	36458	223	206	961	0	37848
18175	968	35847	203	412	0	37430
18176	426	37255	176	302	0	38159
18177	482	1135	156	36948	0	38721
18178	37021	514	117	992	0	38644
18179	37505	340	83	461	0	38389
18180	1207	265	36602	313	0	38387
18181	587	239	34985	210	0	36021
18182	34857	188	948	291	0	36284
18183	933	35680	460	194	0	37267
18184	35582	828	312	194	0	36916
18185	1109	380	207	35048	0	36744
18186	527	275	34244	787	0	35833
18187	32272	156	807	435	0	33670
18188	895	33321	405	276	0	34897
18189	452	34576	307	177	0	35512
18190	491	1008	210	33917	0	35626
18191	34354	489	192	867	0	35902
18192	967	299	161	34592	0	36019
18193	35692	224	175	1028	0	37119
18194	1032	253	33918	403	0	35606
18195	35006	261	654	415	0	36336
18196	36499	205	246	311	0	37261
18197	1198	205	34664	274	0	36341
18198	33638	154	745	306	0	34843
18199	1131	33518	389	229	0	35267
18200	686	711	341	33436	0	35174
18201	578	33912	217	658	0	35365
18202	34671	876	205	354	0	36106
18203	1040	393	205	33648	0	35286
18204	578	33395	204	797	0	34974
18205	501	831	197	33368	0	34897
18206	393	33862	144	908	0	35307
18207	396	978	90	34206	0	35670
18208	34167	473	130	1055	0	35825
18209	961	386	127	34199	0	35673
18210	546	292	33536	1050	0	35424
18211	33029	274	728	615	0	34646
18212	956	259	319	34149	0	35683
18213	577	253	33244	970	0	35044
18214	483	225	31266	621	0	32595
18215	437	188	33667	471	0	34763
18216	486	148	1153	32885	0	34672
18217	412	160	612	34576	0	35760
18218	369	179	458	34642	0	35648
18219	327	191	361	34897	0	35776
18220	34321	181	304	1353	0	36159
18221	34896	196	305	822	0	36219
18222	35191	173	245	653	0	36262
18223	35677	216	218	545	0	36656
18224	1348	194	189	34887	0	36618
18225	779	191	35636	1122	0	37728
18226	35455	187	767	711	0	37120
18227	37442	185	367	598	0	38592
18228	1356	207	331	36676	0	38570
18229	860	165	258	37630	0	38913
18230	37901	172	272	1270	0	39615
18231	1209	161	242	36243	0	37855
18232	695	35945	267	1217	0	38124
18233	37024	741	261	746	0	38772
18234	36451	339	263	670	0	37723
18235	1393	307	37166	469	0	39335
18236	882	231	853	37059	0	39025
18237	652	245	419	38695	0	40011
18238	38293	198	362	1351	0	40204
18239	38699	171	258	803	0	39931
18240	1507	198	229	38309	0	40243
18241	938	166	37777	1146	0	40027
18242	732	152	37857	706	0	39447
18243	685	137	1043	38628	0	40493
18244	657	170	519	39320	0	40666
18245	38442	125	370	1343	0	40280
18246	1201	37240	301	810	0	39552
18247	739	36805	307	585	0	38436
18248	622	38325	276	512	0	39735
18249	574	1069	324	37697	0	39664
18250	37487	466	282	1081	0	39316
18251	37233	356	165	705	0	38459
18252	1228	37175	137	561	0	39101
18253	37648	873	128	457	0	39106
18254	1198	469	121	37296	0	39084
18255	618	406	37497	961	0	39482
18256	664	278	726	36764	0	38432
18257	602	223	329	37341	0	38495
18258	606	183	275	37218	0	38282
18259	35298	139	174	1228	0	36839
18260	872	269	201	33909	0	35251
18261	499	33849	195	1028	0	35571
18262	33185	556	286	698	0	34725
18263	776	32601	182	553	0	34112
18264	421	31601	155	431	0	32608
18265	389	32517	144	403	0	33453
18266	249	549	29865	279	0	30942
18267	251	28936	400	225	0	29812
18268	213	337	26891	184	0	27625
18269	24643	96	254	201	0	25194
18270	25513	40	74	162	0	25789
18271	271	58	25900	90	0	26319
18272	25145	44	191	208	0	25588
18273	26695	33	49	190	0	26967
18274	294	36	26630	77	0	27037
18275	121	27657	202	68	0	28048
18276	141	254	62	27804	0	28261
18277	28361	76	31	294	0	28762
18278	270	64	39	27862	0	28235
18279	29074	57	33	343	0	29507
18280	28708	54	38	201	0	29001
18281	273	60	28862	82	0	29277
18282	28136	50	205	180	0	28571
18283	277	29481	73	69	0	29900
18284	29883	217	37	144	0	30281
18285	294	85	37	30107	0	30523
18286	139	64	30108	263	0	30574
18287	161	54	209	29777	0	30201
18288	29794	42	89	330	0	30255
18289	250	29853	70	124	0	30297
18290	103	267	29827	129	0	30326
18291	173	97	216	28662	0	29148
18292	114	69	29862	275	0	30320
18293	80	29698	238	143	0	30159
18294	29434	236	89	157	0	29916
18295	309	91	70	29582	0	30052
18296	146	81	29659	260	0	30146
18297	149	92	27766	115	0	28122
18298	29831	67	276	133	0	30307
18299	328	90	100	30345	0	30863
18300	162	77	75	30479	0	30793
18301	116	95	30668	318	0	31197
18302	129	74	30100	152	0	30455
18303	141	31416	294	106	0	31957
18304	139	272	132	31742	0	32285
18305	168	96	106	31426	0	31796
18306	132	31643	83	318	0	32176
18307	113	304	31336	147	0	31900
18308	30072	99	296	180	0	30647
18309	362	86	112	32238	0	32798
18310	127	90	32719	342	0	33278
18311	156	73	320	31256	0	31805
18312	125	32468	119	334	0	33046
18313	129	339	32351	147	0	32966
18314	30474	115	357	201	0	31147
18315	384	101	32900	95	0	33480
18316	165	113	32152	79	0	32509
18317	138	85	31326	88	0	31637
18318	118	71	33841	84	0	34114
18319	159	74	493	34273	0	34999
18320	110	74	35938	439	0	36561
18321	146	66	471	34639	0	35322
18322	91	35599	146	460	0	36296
18323	37620	429	108	230	0	38387
18324	614	104	94	37834	0	38646
18325	190	101	36890	605	0	37786
18326	133	36726	592	208	0	37659
18327	155	520	194	37132	0	38001
18328	36805	146	133	681	0	37765
18329	510	37163	120	211	0	38004
18330	237	575	124	37599	0	38535
18331	38020	158	106	673	0	38957
18332	586	119	37872	177	0	38754
18333	37134	59	581	300	0	38074
18334	642	68	38910	101	0	39721
18335	36720	66	616	168	0	37570
18336	37199	62	227	160	0	37648
18337	677	71	36638	101	0	37487
18338	226	35957	538	114	0	36835
18339	263	542	223	34466	0	35494
18340	89	193	36898	538	0	37718
18341	201	124	548	35028	0	35901
18342	210	75	191	35689	0	36165
18343	80	76	36320	671	0	37147
18344	104	73	35717	264	0	36158
18345	157	45	671	36062	0	36935
18346	36640	45	272	639	0	37596
18347	577	35835	179	248	0	36839
18348	220	36561	144	163	0	37088
18349	36683	612	101	219	0	37615
18350	37532	216	124	192	0	38064
18351	742	137	135	37671	0	38685
18352	333	94	99	37924	0	38450
18353	247	59	104	38424	0	38834
18354	37357	56	122	869	0	38404
18355	566	35806	130	355	0	36857
18356	219	36899	134	220	0	37472
18357	204	644	152	36971	0	37971
18358	171	222	130	37714	0	38237
18359	185	134	104	37885	0	38308
18360	37312	93	80	907	0	38392
18361	585	37960	115	335	0	38995
18362	38302	612	115	305	0	39334
18363	757	239	38328	183	0	39507
18364	319	38413	638	207	0	39577
18365	225	642	264	38295	0	39426
18366	38107	263	163	818	0	39351
18367	725	176	38034	352	0	39287
18368	369	145	37981	227	0	38722
18369	309	151	807	38273	0	39540
18370	197	140	341	39269	0	39947
18371	213	110	192	39159	0	39674
18372	236	120	158	37667	0	38181
18373	231	121	142	37950	0	38444
18374	200	37009	145	1011	0	38365
18375	216	637	120	37228	0	38201
18376	36314	248	148	966	0	37676
18377	640	37048	181	489	0	38358
18378	36886	713	129	433	0	38161
18379	842	323	35972	279	0	37416
18380	389	228	36378	260	0	37255
18381	321	201	891	39160	0	40573
18382	209	141	47189	950	0	48489
18383	266	149	1211	46537	0	48163
18384	349	134	536	45777	0	46796
18385	47573	134	349	1744	0	49800
18386	47072	159	261	928	0	48420
18387	1546	47920	209	599	0	50274
18388	717	50636	215	404	0	51972
18389	567	1603	186	49839	0	52195
18390	50162	721	199	1574	0	52656
18391	1376	457	50631	733	0	53197
18392	746	249	1345	50678	0	53018
18393	514	210	621	51467	0	52812
18394	322	203	50450	1908	0	52883
18395	258	50249	1410	1028	0	52945
18396	435	1340	650	49293	0	51718
18397	297	568	50922	1689	0	53476
18398	371	395	1422	50323	0	52511
18399	48309	257	662	1852	0	51080
18400	1352	48265	490	913	0	51020
18401	620	49875	374	676	0	51545
18402	560	1701	304	49127	0	51692
18403	47854	755	323	1737	0	50669
18404	1393	48566	346	981	0	51286
18405	49161	1448	325	876	0	51810
18406	1660	705	48732	727	0	51824
18407	848	532	50214	666	0	52260
18408	745	420	1873	48188	0	51226
18409	618	419	906	51569	0	53512
18410	50140	368	595	2298	0	53401
18411	1909	392	423	50681	0	53405
18412	942	535	49727	2009	0	53213
18413	847	544	1471	49570	0	52432
18414	713	471	736	51485	0	53405
18415	525	426	48832	2334	0	52117
18416	46273	413	1645	1490	0	49821
18417	1697	409	818	49310	0	52234
18418	47170	362	669	2057	0	50258
18419	1559	45345	663	1190	0	48757
18420	44880	1401	518	1080	0	47879
18421	1508	44151	491	963	0	47113
18422	817	45398	542	869	0	47626
18423	820	1696	524	43068	0	46108
18424	42964	854	484	1631	0	45933
18425	43546	717	358	1024	0	45645
18426	1737	608	365	43086	0	45796
18427	43089	463	378	1726	0	45656
18428	43404	492	309	1117	0	45322
18429	1981	526	329	42887	0	45723
18430	40891	415	367	1718	0	43391
18431	1670	41783	505	1024	0	44982
18432	41792	1280	519	938	0	44529
18433	1646	705	38990	922	0	42263
18434	42130	422	1252	1031	0	44835
18435	1811	305	707	42824	0	45647
18436	1134	268	591	43732	0	45725
18437	918	273	545	43899	0	45635
18438	861	430	434	43775	0	45500
18439	684	434	430	43468	0	45016
18440	668	39553	507	2262	0	42990
18441	730	42387	416	1503	0	45036
18442	42271	1472	381	1200	0	45324
18443	1687	891	41609	918	0	45105
18444	41185	727	1194	941	0	44047
18445	1870	636	41521	852	0	44879
18446	1288	661	1345	41251	0	44545
18447	1033	689	600	43252	0	45574
18448	42187	545	424	2132	0	45288
18449	1970	541	41635	1165	0	45311
18450	1418	485	1196	42066	0	45165
18451	1133	441	42836	1864	0	46274
18452	1073	43949	1382	1176	0	47580
18453	1086	1347	660	45433	0	48526
18454	45494	635	455	2106	0	48690
18455	44053	524	392	1325	0	46294
18456	45658	526	358	1135	0	47677
18457	2268	44143	479	974	0	47864
18458	1292	46137	527	966	0	48922
18459	40795	1656	478	1183	0	44112
18460	1721	45141	399	1125	0	48386
18461	1029	45626	366	1141	0	48162
18462	946	1660	44093	1088	0	47787
18463	672	43094	1302	1110	0	46178
18464	620	44593	684	1029	0	46926
18465	706	1759	508	44512	0	47485
18466	644	1049	44237	1751	0	47681
18467	799	685	42881	1010	0	45375
18468	42144	535	1651	958	0	45288
18469	1892	466	43686	719	0	46763
18470	44463	454	1659	709	0	47285
18471	1937	488	859	43827	0	47111
18472	1210	44763	611	1662	0	48246
18473	46294	1397	545	1064	0	49300
18474	48059	761	524	1021	0	50365
18475	2130	520	475	47626	0	50751
18476	1401	476	527	48095	0	50499
18477	1154	487	453	48527	0	50621
18478	47069	424	380	2260	0	50133
18479	42313	480	370	1403	0	44566
18480	46879	504	259	1031	0	48673
18481	2035	42743	263	713	0	45754
18482	35127	680	166	329	0	36302
18483	889	34452	134	282	0	35757
18484	486	34863	152	241	0	35742
18485	505	1079	248	32814	0	34646
18486	289	33553	158	589	0	34589
18487	32330	557	124	307	0	33318
18488	620	225	56	32109	0	33010
18489	31642	177	57	599	0	32475
18490	559	30430	61	254	0	31304
18491	260	31535	69	160	0	32024
18492	32539	567	67	226	0	33399
18493	591	33191	100	158	0	34040
18494	347	559	109	33450	0	34465
18495	296	215	87	34035	0	34633
18496	33855	148	87	699	0	34789
18497	675	119	63	33996	0	34853
18498	311	140	34271	662	0	35384
18499	261	134	562	34525	0	35482
18500	34974	138	191	765	0	36068
18501	683	35492	122	303	0	36600
18502	36773	681	101	303	0	37858
18503	35160	284	82	334	0	35860
18504	37207	183	71	249	0	37710
18505	969	166	35992	151	0	37278
18506	407	141	34605	159	0	35312
18507	34303	154	691	216	0	35364
18508	730	35130	241	149	0	36250
18509	372	694	139	35645	0	36850
18510	254	289	113	35600	0	36256
18511	184	34045	124	779	0	35132
18512	198	35518	108	319	0	36143
18513	239	819	98	35555	0	36711
18514	232	321	95	36069	0	36717
18515	194	200	35032	835	0	36261
18516	223	198	33060	363	0	33844
18517	34269	152	812	300	0	35533
18518	36350	150	328	256	0	37084
18519	966	149	185	35929	0	37229
18520	418	163	35879	760	0	37220
18521	363	152	684	35707	0	36906
18522	35507	141	269	912	0	36829
18523	804	171	35314	368	0	36657
18524	450	158	691	35563	0	36862
18525	298	196	35611	787	0	36892
18526	251	34980	741	451	0	36423
18527	247	677	35434	276	0	36634
18528	289	387	778	34778	0	36232
18529	35513	194	346	825	0	36878
18530	828	161	221	36092	0	37302
18531	35631	140	177	933	0	36881
18532	36412	150	168	476	0	37206
18533	35568	153	169	384	0	36274
18534	1055	150	34142	247	0	35594
18535	34563	143	691	272	0	35669
18536	955	128	298	34746	0	36127
18537	520	114	234	35157	0	36025
18538	323	159	34471	952	0	35905
18539	353	200	696	34729	0	35978
18540	34991	138	308	938	0	36375
18541	802	35535	212	442	0	36991
18542	36598	620	159	424	0	37801
18543	37089	266	145	378	0	37878
18544	37365	175	148	356	0	38044
18545	1073	139	148	36810	0	38170
18546	510	130	37006	828	0	38474
18547	441	112	689	37354	0	38596
18548	377	103	300	38015	0	38795
18549	37665	100	216	1058	0	39039
18550	36802	103	197	545	0	37647
18551	1007	113	35706	363	0	37189
18552	559	122	708	35550	0	36939
18553	335	130	35753	904	0	37122
18554	35775	84	829	521	0	37209
18555	972	38812	367	361	0	40512
18556	38859	770	281	322	0	40232
18557	1055	39495	209	268	0	41027
18558	39495	922	190	290	0	40897
18559	1093	39533	185	237	0	41048
18560	611	947	181	39346	0	41085
18561	477	351	136	40802	0	41766
18562	40636	205	154	1266	0	42261
18563	40450	177	172	614	0	41413
18564	40924	135	133	471	0	41663
18565	39176	166	154	388	0	39884
18566	40570	152	123	353	0	41198
18567	1546	170	137	39048	0	40901
18568	786	38963	159	959	0	40867
18569	655	919	95	38361	0	40030
18570	485	38385	141	1048	0	40059
18571	470	997	95	37154	0	38716
18572	423	37757	115	1023	0	39318
18573	461	963	106	37762	0	39292
18574	428	388	36200	1106	0	38122
18575	34420	242	825	619	0	36106
18576	1153	36053	296	405	0	37907
18577	36308	875	190	420	0	37793
18578	1250	377	35721	310	0	37658
18579	35084	282	888	388	0	36642
18580	1245	277	37185	280	0	38987
18581	675	271	1025	36809	0	38780
18582	447	39414	385	1067	0	41313
18583	395	1082	39605	481	0	41563
18584	396	489	1105	39912	0	41902
18585	36824	362	500	1363	0	39049
18586	1330	242	379	40345	0	42296
18587	766	219	240	41089	0	42314
18588	640	217	216	41678	0	42751
18589	477	193	40002	1637	0	42309
18590	512	180	1083	39330	0	41105
18591	399	38783	486	1416	0	41084
18592	406	992	355	38908	0	40661
18593	381	423	254	39549	0	40607
18594	38818	312	210	1620	0	40960
18595	1309	253	190	39994	0	41746
18596	595	197	39986	1515	0	42293
18597	493	167	39878	827	0	41365
18598	364	142	39987	646	0	41139
18599	318	39584	1488	541	0	41931
18600	38870	1075	956	512	0	41413
18601	1093	38987	482	450	0	41012
18602	38654	1193	368	424	0	40639
18603	1369	579	265	38235	0	40448
18604	689	388	39280	1215	0	41572
18605	511	327	38147	673	0	39658
18606	369	39917	1425	554	0	42265
18607	398	1159	744	39946	0	42247
18608	404	529	499	40922	0	42354
18609	388	393	376	41601	0	42758
18610	307	302	40411	1856	0	42876
18611	37369	267	1291	1133	0	40060
18612	1303	273	40643	726	0	42945
18613	819	278	1474	39547	0	42118
18614	667	268	741	41481	0	43157
18615	447	317	40076	1813	0	42653
18616	37608	284	1340	1156	0	40388
18617	1307	40039	701	915	0	42962
18618	40153	1226	573	709	0	42661
18619	1593	592	451	39138	0	41774
18620	755	39957	440	1477	0	42629
18621	638	1303	413	40826	0	43180
18622	40400	634	403	1817	0	43254
18623	1475	474	381	40637	0	42967
18624	838	357	39615	1754	0	42564
18625	38961	318	1280	1115	0	41674
18626	40391	293	760	883	0	42327
18627	1826	264	39387	727	0	42204
18628	1038	293	1414	39386	0	42131
18629	40368	293	811	1655	0	43127
18630	1618	327	588	39828	0	42361
18631	962	349	409	40050	0	41770
18632	799	295	384	40242	0	41720
18633	678	267	361	40765	0	42071
18634	535	277	38788	2291	0	41891
18635	612	245	1353	39436	0	41646
18636	512	237	38957	1997	0	41703
18637	37871	210	1563	1300	0	40944
18638	39439	195	850	1091	0	41575
18639	39345	222	707	902	0	41176
18640	39538	162	530	824	0	41054
18641	2183	225	493	37480	0	40381
18642	36994	207	434	1721	0	39356
18643	1767	155	36125	1195	0	39242
18644	1003	188	35937	979	0	38107
18645	34781	169	1582	949	0	37481
18646	1483	34373	947	854	0	37657
18647	885	35366	667	777	0	37695
18648	812	1344	620	34835	0	37611
18649	624	694	34611	1522	0	37451
18650	32763	442	1294	1049	0	35548
18651	1551	301	34525	769	0	37146
18652	901	32430	1311	719	0	35361
18653	856	922	32618	620	0	35016
18654	671	30898	1203	580	0	33352
18655	28310	1036	876	570	0	30792
18656	1114	28073	522	523	0	30232
18657	647	27742	412	478	0	29279
18658	586	1016	452	27440	0	29494
18659	471	581	27246	1009	0	29307
18660	442	432	934	26544	0	28352
18661	466	330	588	27224	0	28608
18662	412	289	26440	1334	0	28475
18663	435	252	1008	25479	0	27174
18664	468	25136	617	1120	0	27341
18665	411	817	547	26723	0	28498
18666	26507	499	432	1190	0	28628
18667	1027	356	446	26909	0	28738
18668	650	348	26587	1134	0	28719
18669	620	290	914	26898	0	28722
18670	439	320	26507	1211	0	28477
18671	25989	350	1016	794	0	28149
18672	1002	283	578	26814	0	28677
18673	26520	244	528	1209	0	28501
18674	1075	208	26353	799	0	28435
18675	24803	196	955	717	0	26671
18676	1056	26789	622	517	0	28984
18677	645	774	27138	513	0	29070
18678	548	614	960	26520	0	28642
18679	467	354	27432	1006	0	29259
18680	426	25290	965	692	0	27373
18681	367	26796	582	570	0	28315
18682	23864	794	395	458	0	25511
18683	739	25239	292	444	0	26714
18684	25302	782	319	409	0	26812
18685	960	370	298	25470	0	27098
18686	501	231	25123	883	0	26738
18687	407	25613	774	507	0	27301
18688	393	818	471	25770	0	27452
18689	389	394	295	27254	0	28332
18690	374	301	229	27791	0	28695
18691	356	238	276	26958	0	27828
18692	265	25157	266	1214	0	26902
18693	262	26840	271	636	0	28009
18694	24950	800	233	390	0	26373
18695	695	24935	196	260	0	26086
18696	394	686	136	23764	0	24980
18697	220	316	23541	715	0	24792
18698	224	23390	600	363	0	24577
18699	206	617	260	23120	0	24203
18700	214	378	202	22858	0	23652
18701	128	23101	136	729	0	24094
18702	22337	599	131	415	0	23482
18703	560	304	22212	301	0	23377
18704	20034	181	477	258	0	20950
18705	520	21324	217	173	0	22234
18706	19743	522	96	129	0	20490
18707	476	20431	57	110	0	21074
18708	257	541	68	21139	0	22005
18709	173	246	73	21680	0	22172
18710	21109	157	59	675	0	22000
18711	527	131	73	21361	0	22092
18712	237	137	21118	580	0	22072
18713	133	20247	441	279	0	21100
18714	144	21061	169	192	0	21566
18715	131	603	117	20769	0	21620
18716	131	255	21028	506	0	21920
18717	140	190	440	20756	0	21526
18718	147	144	168	21377	0	21836
18719	84	149	20741	667	0	21641
18720	92	117	20134	341	0	20684
18721	84	20679	531	228	0	21522
18722	20769	490	218	234	0	21711
18723	490	229	128	20492	0	21339
18724	201	19875	119	496	0	20691
18725	20723	514	89	339	0	21665
18726	479	260	95	20857	0	21691
18727	224	188	102	20886	0	21400
18728	126	20508	107	686	0	21427
18729	108	533	94	20437	0	21172
18730	20426	250	80	666	0	21422
18731	488	204	98	20750	0	21540
18732	252	163	94	21073	0	21582
18733	176	166	20378	691	0	21411
18734	144	164	19038	389	0	19735
18735	20124	138	554	351	0	21167
18736	513	159	239	20520	0	21431
18737	256	161	126	20702	0	21245
18738	205	167	100	21088	0	21560
18739	142	154	20305	790	0	21391
18740	20056	138	478	446	0	21118
18741	525	144	234	20410	0	21313
18742	283	132	179	20786	0	21380
18743	20196	132	119	789	0	21236
18744	495	19985	138	468	0	21086
18745	279	482	20039	338	0	21138
18746	201	246	494	19257	0	20198
18747	153	19843	256	641	0	20893
18748	205	473	177	20491	0	21346
18749	20189	237	137	719	0	21282
18750	539	192	110	20342	0	21183
18751	19964	153	129	750	0	20996
18752	20011	155	112	451	0	20729
18753	656	150	139	19515	0	20460
18754	338	19022	112	685	0	20157
18755	218	19927	121	438	0	20704
18756	158	593	19611	387	0	20749
18757	225	304	527	18262	0	19318
18758	182	204	275	19929	0	20590
18759	188	165	164	20448	0	20965
18760	19852	154	87	869	0	20962
18761	560	153	88	20180	0	20981
18762	297	147	19903	768	0	21115
18763	19821	124	480	505	0	20930
18764	608	120	253	20923	0	21904
18765	333	120	154	21534	0	22141
18766	202	137	20895	852	0	22086
18767	20151	154	490	525	0	21320
18768	584	130	244	21196	0	22154
18769	299	127	21589	748	0	22763
18770	230	109	541	21573	0	22453
18771	250	99	282	20019	0	20650
18772	209	21811	174	752	0	22946
18773	21654	475	136	542	0	22807
18774	21501	217	152	422	0	22292
18775	687	21321	143	348	0	22499
18776	20623	442	126	358	0	21549
18777	20359	195	119	368	0	21041
18778	693	141	124	20144	0	21102
18779	355	99	19138	649	0	20241
18780	228	105	18141	376	0	18850
18781	186	71	18391	292	0	18940
18782	166	87	19010	268	0	19531
18783	170	180	498	17748	0	18596
18784	156	74	219	18711	0	19160
18785	162	70	144	18618	0	18994
18786	181	54	107	18783	0	19125
18787	18320	55	99	598	0	19072
18788	404	18415	103	335	0	19257
18789	18169	273	79	223	0	18744
18790	390	128	18075	175	0	18768
18791	217	73	18836	136	0	19262
18792	189	110	415	19178	0	19892
18793	19441	36	322	457	0	20256
18794	18615	28	135	305	0	19083
18795	433	18959	111	176	0	19679
18796	208	19497	75	159	0	19939
18797	180	373	60	19610	0	20223
18798	19552	174	76	382	0	20184
18799	333	19775	59	232	0	20399
18800	19957	321	38	193	0	20509
18801	19861	164	45	166	0	20236
18802	20102	79	53	183	0	20417
18803	492	76	20152	94	0	20814
18804	242	20293	306	98	0	20939
18805	20167	249	152	142	0	20710
18806	20030	148	103	136	0	20417
18807	393	19254	70	95	0	19812
18808	153	18705	36	42	0	18936
18809	18785	285	35	70	0	19175
18810	292	109	27	18754	0	19182
18811	144	80	18708	211	0	19143
18812	17882	71	203	126	0	18282
18813	300	47	82	19032	0	19461
18814	143	19480	42	212	0	19877
18815	119	236	42	19960	0	20357
18816	103	120	19951	260	0	20434
18817	124	79	223	19643	0	20069
18818	20734	64	98	323	0	21219
18819	316	59	49	20860	0	21284
18820	179	47	35	21107	0	21368
18821	108	56	22096	333	0	22593
18822	154	43	232	21268	0	21697
18823	73	22244	100	285	0	22702
18824	22361	238	62	205	0	22866
18825	21721	91	50	170	0	22032
18826	352	74	22364	78	0	22868
18827	196	66	236	21604	0	22102
18828	117	21635	105	259	0	22116
18829	94	22507	63	142	0	22806
18830	22211	298	70	130	0	22709
18831	296	144	54	22627	0	23121
18832	152	86	22537	305	0	23080
18833	113	87	22124	134	0	22458
18834	121	40	341	22701	0	23203
18835	22564	48	157	362	0	23131
18836	22457	45	112	203	0	22817
18837	408	41	79	23423	0	23951
18838	188	61	23845	319	0	24413
18839	133	23783	270	165	0	24351
18840	23855	271	119	168	0	24413
18841	298	24180	83	136	0	24697
18842	24366	316	80	141	0	24903
18843	365	136	64	24407	0	24972
18844	180	115	24344	322	0	24961
18845	183	75	290	23923	0	24471
18846	24191	62	137	413	0	24803
18847	325	78	24284	191	0	24878
18848	169	24272	324	144	0	24909
18849	172	287	152	24413	0	25024
18850	24705	118	84	405	0	25312
18851	353	104	24705	156	0	25318
18852	218	78	298	24886	0	25480
18853	159	78	137	25623	0	25997
18854	161	70	25701	397	0	26329
18855	172	73	321	25094	0	25660
18856	117	86	25485	385	0	26073
18857	24340	62	352	289	0	25043
18858	395	63	167	26430	0	27055
18859	186	87	27586	389	0	28248
18860	146	27799	370	216	0	28531
18861	28378	347	166	241	0	29132
18862	30062	169	93	225	0	30549
18863	657	102	98	31961	0	32818
18864	275	32380	103	542	0	33300
18865	32619	570	84	307	0	33580
18866	740	219	102	32641	0	33702
18867	300	150	32626	645	0	33721
18868	31266	116	571	393	0	32346
18869	700	31967	247	182	0	33096
18870	365	562	145	32470	0	33542
18871	32428	229	134	721	0	33512
18872	703	157	31741	277	0	32878
18873	347	143	32186	212	0	32888
18874	291	122	734	31582	0	32729
18875	219	99	33046	651	0	34015
18876	247	95	698	31908	0	32948
18877	138	31562	355	672	0	32727
18878	209	597	205	33821	0	34832
18879	33206	241	174	832	0	34453
18880	667	132	33240	405	0	34444
18881	298	33164	655	292	0	34409
18882	282	606	281	32886	0	34055
18883	193	278	33773	723	0	34967
18884	247	228	650	31879	0	33004
18885	150	32316	295	648	0	33409
18886	132	33775	203	326	0	34436
18887	32483	663	198	379	0	33723
18888	547	33233	152	201	0	34133
18889	211	582	32178	166	0	33137
18890	29511	272	611	291	0	30685
18891	551	172	32100	147	0	32970
18892	331	151	563	29778	0	30823
18893	175	124	32200	525	0	33024
18894	140	32108	579	225	0	33052
18895	191	488	263	32074	0	33016
18896	163	199	181	32142	0	32685
18897	163	121	186	31880	0	32350
18898	97	141	31891	708	0	32837
18899	140	113	537	31226	0	32016
18900	99	134	233	32262	0	32728
18901	31341	116	138	794	0	32389
18902	30947	119	124	468	0	31658
18903	629	103	31287	247	0	32266
18904	296	30587	552	204	0	31639
18905	209	520	31133	140	0	32002
18906	197	168	576	31298	0	32239
18907	147	143	32019	554	0	32863
18908	158	129	640	31482	0	32409
18909	147	105	264	32536	0	33052
18910	82	107	32147	770	0	33106
18911	28623	80	619	498	0	29820
18912	487	32404	291	300	0	33482
18913	238	520	192	32570	0	33520
18914	156	182	33270	667	0	34275
18915	198	134	31647	302	0	32281
18916	30791	109	666	353	0	31919
18917	513	32666	329	192	0	33700
18918	259	509	214	32560	0	33542
18919	32979	185	175	653	0	33992
18920	598	119	174	33033	0	33924
18921	279	128	155	33189	0	33751
18922	168	104	32928	783	0	33983
18923	30690	86	566	527	0	31869
18924	33126	86	290	368	0	33870
18925	738	91	202	33250	0	34281
18926	33108	103	159	717	0	34087
18927	698	68	186	33108	0	34060
18928	357	31988	171	763	0	33279
18929	240	33627	207	341	0	34415
18930	284	687	144	34154	0	35269
18931	33416	288	155	739	0	34598
18932	583	170	138	33708	0	34599
18933	34144	125	102	792	0	35163
18934	34399	134	122	466	0	35121
18935	809	102	117	34362	0	35390
18936	454	105	124	35064	0	35747
18937	293	92	33993	847	0	35225
18938	288	78	34091	438	0	34895
18939	279	72	766	34508	0	35625
18940	204	91	36280	788	0	37363
18941	35279	76	745	512	0	36612
18942	723	93	341	37863	0	39020
18943	313	104	39469	791	0	40677
18944	38166	77	782	555	0	39580
18945	41493	81	390	403	0	42367
18946	1128	42348	267	283	0	44026
18947	728	773	168	42975	0	44644
18948	448	376	44180	860	0	45864
18949	43546	199	820	703	0	45268
18950	45480	134	438	478	0	46530
18951	1261	143	45669	272	0	47345
18952	45757	85	924	387	0	47153
18953	1208	89	482	45386	0	47165
18954	691	76	360	46337	0	47464
18955	45834	60	309	1319	0	47522
18956	45969	61	260	777	0	47067
18957	1393	189	271	45230	0	47083
18958	819	87	45060	1007	0	46973
18959	533	43979	821	614	0	45947
18960	477	734	44162	400	0	45773
18961	432	370	43659	365	0	44826
18962	371	42653	1129	303	0	44456
18963	478	635	632	39377	0	41122
18964	379	314	327	40194	0	41214
18965	247	211	39965	878	0	41301
18966	369	104	711	39216	0	40400
18967	39774	94	417	927	0	41212
18968	809	113	40404	509	0	41835
18969	40017	62	709	527	0	41315
18970	41271	57	476	428	0	42232
18971	41659	95	295	409	0	42458
18972	1197	105	40580	304	0	42186
18973	728	120	40776	244	0	41868
18974	600	151	920	40312	0	41983
18975	544	129	543	38429	0	39645
18976	289	40824	402	860	0	42375
18977	40612	612	359	611	0	42194
18978	40430	323	307	486	0	41546
18979	993	40511	316	362	0	42182
18980	40484	618	286	413	0	41801
18981	922	40031	239	346	0	41538
18982	40420	692	261	424	0	41797
18983	1022	329	240	39231	0	40822
18984	628	265	39569	758	0	41220
18985	513	183	38967	475	0	40138
18986	509	135	959	38766	0	40369
18987	415	114	629	39450	0	40608
18988	380	161	39176	963	0	40680
18989	450	142	809	38345	0	39746
18990	455	158	573	37622	0	38808
18991	38690	143	421	1132	0	40386
18992	39086	124	339	749	0	40298
18993	38135	173	271	577	0	39156
18994	1200	172	37226	366	0	38964
18995	786	37366	722	331	0	39205
18996	670	625	473	37732	0	39500
18997	529	356	38498	724	0	40107
18998	427	38581	822	502	0	40332
18999	39120	666	504	488	0	40778
19000	943	389	406	39126	0	40864
19001	677	248	331	39748	0	41004
19002	39380	165	368	1147	0	41060
19003	926	179	345	39343	0	40793
19004	688	166	274	39652	0	40780
19005	39257	141	259	1271	0	40928
19006	969	173	38432	703	0	40277
19007	643	38097	786	513	0	40039
19008	38168	649	447	589	0	39853
19009	927	389	38515	430	0	40261
19010	37613	286	801	456	0	39156
19011	1018	39490	533	356	0	41397
19012	38990	703	409	471	0	40573
19013	38954	389	351	520	0	40214
19014	38179	280	315	464	0	39238
19015	1254	217	276	37387	0	39134
19016	807	265	303	37304	0	38679
19017	631	36858	264	1058	0	38811
19018	539	37015	323	727	0	38604
19019	484	37596	267	538	0	38885
19020	37366	824	236	559	0	38985
19021	910	435	36896	362	0	38603
19022	696	277	659	36613	0	38245
19023	524	261	421	36743	0	37949
19024	464	36900	342	920	0	38626
19025	502	716	270	37088	0	38576
19026	516	456	245	36358	0	37575
19027	454	37074	257	928	0	38713
19028	36522	696	275	670	0	38163
19029	809	37134	191	467	0	38601
19030	553	770	36111	376	0	37810
19031	35317	446	623	483	0	36869
19032	859	36854	337	380	0	38430
19033	35874	632	265	368	0	37139
19034	868	372	240	36029	0	37509
19035	653	267	219	35950	0	37089
19036	470	266	35555	823	0	37114
19037	403	255	35066	483	0	36207
19038	393	314	696	35155	0	36558
19039	35012	184	384	771	0	36351
19040	33973	165	243	493	0	34874
19041	855	35179	173	317	0	36524
19042	468	34398	150	230	0	35246
19043	294	34354	118	169	0	34935
19044	680	965	364	33249	0	35258
19045	33310	221	402	715	0	34648
19046	34258	118	41	338	0	34755
19047	33871	64	35	294	0	34264
19048	942	85	32865	91	0	33983
19049	329	39298	676	95	0	40398
19050	275	773	213	42892	0	44153
19051	42947	257	117	1028	0	44349
19052	1172	141	65	43227	0	44605
19053	431	90	51	45209	0	45781
19054	44662	92	54	1387	0	46195
19055	47010	97	52	531	0	47690
19056	1508	137	46834	234	0	48713
19057	697	83	1166	46702	0	48648
19058	307	107	46313	1269	0	47996
19059	356	69	1256	46289	0	47970
19060	258	86	46106	1413	0	47863
19061	353	130	1278	45845	0	47606
19062	44724	66	413	1605	0	46808
19063	1311	44435	259	569	0	46574
19064	509	46969	146	403	0	48027
19065	619	1489	180	41199	0	43487
19066	254	47389	144	1142	0	48929
19067	47004	1349	211	551	0	49115
19068	46369	416	159	482	0	47426
19069	1720	253	45269	250	0	47492
19070	600	44984	1338	312	0	47234
19071	512	1240	472	45457	0	47681
19072	220	461	45737	1378	0	47796
19073	45082	309	1329	623	0	47343
19074	1583	195	456	45559	0	47793
19075	597	242	46086	1366	0	48291
19076	513	223	1311	46150	0	48197
19077	46131	238	490	1624	0	48483
19078	1436	252	45822	581	0	48091
19079	45625	202	1366	453	0	47646
19080	47272	178	518	356	0	48324
19081	1893	203	360	45948	0	48404
19082	761	235	46053	1417	0	48466
19083	438	201	45686	708	0	47033
19084	45132	147	1761	521	0	47561
19085	47011	155	643	470	0	48279
19086	1947	144	46060	333	0	48484
19087	975	144	1461	45523	0	48103
19088	701	155	646	44462	0	45964
19089	449	45614	464	1686	0	48213
19090	554	1310	366	46261	0	48491
19091	46424	414	364	1681	0	48883
19092	1789	219	334	46526	0	48868
19093	740	127	46011	1777	0	48655
19094	45234	155	1542	808	0	47739
19095	1700	147	683	45512	0	48042
19096	800	211	45397	1613	0	48021
19097	584	44454	1570	771	0	47379
19098	43386	1364	641	731	0	46122
19099	1608	44784	479	591	0	47462
19100	44891	1456	386	670	0	47403
19101	1836	549	44160	552	0	47097
19102	845	42575	1540	540	0	45500
19103	698	45467	659	485	0	47309
19104	630	1734	478	43702	0	46544
19105	663	638	449	45394	0	47144
19106	551	416	44088	2012	0	47067
19107	628	267	1604	44651	0	47150
19108	43989	349	797	1886	0	47021
19109	1734	351	43462	908	0	46455
19110	939	360	1672	43376	0	46347
19111	614	432	42804	1804	0	45654
19112	41357	384	1730	965	0	44436
19113	1668	42850	797	767	0	46082
19114	42825	1591	574	814	0	45804
19115	44692	641	525	684	0	46542
19116	45125	464	444	697	0	46730
19117	2289	394	42634	556	0	45873
19118	1032	42793	1734	557	0	46116
19119	865	1512	776	42998	0	46151
19120	716	672	677	45492	0	47557
19121	45905	453	529	2212	0	49099
19122	2146	327	497	46336	0	49306
19123	46725	299	615	2154	0	49793
19124	47314	338	641	1134	0	49427
19125	47691	353	563	820	0	49427
19126	47955	325	559	716	0	49555
19127	2799	374	432	45855	0	49460
19128	46371	305	464	2052	0	49192
19129	2310	317	44344	1104	0	48075
19130	44934	310	1804	796	0	47844
19131	46703	316	811	685	0	48515
19132	2750	339	43689	1153	0	47931
19133	44982	269	1758	606	0	47615
19134	46802	255	831	689	0	48577
19135	2779	262	604	44675	0	48320
19136	1563	254	557	45843	0	48217
19137	44190	878	462	2314	0	47844
19138	2475	214	441	44310	0	47440
19139	1514	190	457	43561	0	45722
19140	1136	41497	456	2213	0	45302
19141	1013	1197	427	41208	0	43845
19142	40572	443	374	1864	0	43253
19143	2113	258	385	39976	0	42732
19144	1227	157	405	39065	0	40854
19145	889	36377	382	1915	0	39563
19146	970	1123	316	35453	0	37862
19147	1125	439	320	35212	0	37096
19148	33734	223	304	1763	0	36024
19149	1489	454	186	25870	0	27999
19150	591	122	23046	1019	0	24778
19151	389	21235	690	557	0	22871
19152	345	21684	283	365	0	22677
19153	20845	700	263	389	0	22197
19154	821	21029	158	316	0	22324
19155	19101	527	271	278	0	20177
19156	655	18997	87	225	0	19964
19157	19296	544	72	262	0	20174
19158	720	244	46	19425	0	20435
19159	424	178	31	19762	0	20395
19160	266	19451	50	801	0	20568
19161	339	544	34	19896	0	20813
19162	208	247	19811	729	0	20995
19163	19066	141	462	476	0	20145
19164	617	21419	190	271	0	22497
19165	21116	579	94	280	0	22069
19166	21317	280	74	227	0	21898
19167	21647	165	62	187	0	22061
19168	988	127	55	20782	0	21952
19169	527	144	60	20782	0	21513
19170	337	20744	41	815	0	21937
19171	20651	632	41	450	0	21774
19172	752	20867	44	263	0	21926
19173	20949	673	37	245	0	21904
19174	810	313	20910	231	0	22264
19175	21932	190	586	241	0	22949
19176	936	158	254	22018	0	23366
19177	514	171	21790	781	0	23256
19178	381	132	22031	413	0	22957
19179	338	150	899	21933	0	23320
19180	296	104	22304	792	0	23496
19181	335	126	831	21924	0	23216
19182	21263	96	355	902	0	22616
19183	866	104	222	21483	0	22675
19184	495	123	20921	885	0	22424
19185	346	20081	680	513	0	21620
19186	273	21236	346	358	0	22213
19187	329	915	238	20566	0	22048
19188	20743	421	165	857	0	22186
19189	863	261	114	20921	0	22159
19190	548	150	120	21384	0	22202
19191	387	140	177	21714	0	22418
19192	326	125	133	21868	0	22452
19193	246	139	20986	1213	0	22584
19194	234	123	20769	664	0	21790
19195	20649	110	922	470	0	22151
19196	21464	106	455	406	0	22431
19197	1034	105	296	20957	0	22392
19198	607	119	209	21524	0	22459
19199	403	124	20626	1082	0	22235
19200	257	20757	737	637	0	22388
19201	20675	701	392	482	0	22250
19202	21317	374	228	368	0	22287
19203	1073	244	157	20893	0	22367
19204	560	170	20791	938	0	22459
19205	425	164	684	20295	0	21568
19206	298	20686	363	956	0	22303
19207	274	704	20889	531	0	22398
19208	20650	334	768	447	0	22199
19209	871	240	382	21260	0	22753
19210	21546	166	286	936	0	22934
19211	915	142	20709	568	0	22334
19212	20943	128	739	487	0	22297
19213	1011	164	430	20897	0	22502
19214	20759	156	294	905	0	22114
19215	1054	135	183	20055	0	21427
19216	561	19165	195	970	0	20891
19217	422	20219	186	552	0	21379
19218	370	956	205	19435	0	20966
19219	316	369	19094	737	0	20516
19220	224	18752	612	490	0	20078
19221	383	567	315	17509	0	18774
19222	16992	238	228	715	0	18173
19223	17160	191	143	405	0	17899
19224	763	115	143	17057	0	18078
19225	468	108	145	16987	0	17708
19226	300	16094	168	772	0	17334
19227	222	17161	111	486	0	17980
19228	16908	605	150	363	0	18026
19229	612	312	108	16887	0	17919
19230	375	201	127	17199	0	17902
19231	265	160	16658	848	0	17931
19232	230	139	517	16749	0	17635
19233	207	140	295	16806	0	17448
19234	234	150	225	17026	0	17635
19235	202	126	16572	936	0	17836
19236	243	110	546	16932	0	17831
19237	16659	110	284	863	0	17916
19238	588	94	16397	532	0	17611
19239	17005	104	568	495	0	18172
19240	656	133	324	17424	0	18537
19241	382	113	223	18255	0	18973
19242	332	90	163	18899	0	19484
19243	214	89	18035	1014	0	19352
19244	17023	92	596	604	0	18315
19245	609	18571	336	413	0	19929
19246	18665	546	192	361	0	19764
19247	670	18848	147	333	0	19998
19248	397	611	121	19112	0	20241
19249	19109	271	118	807	0	20305
19250	655	187	18700	509	0	20051
19251	18197	118	550	426	0	19291
19252	727	105	19092	247	0	20171
19253	418	130	629	18729	0	19906
19254	272	94	18845	671	0	19882
19255	219	18384	635	444	0	19682
19256	325	505	316	17953	0	19099
19257	17599	244	259	694	0	18796
19258	589	147	136	17211	0	18083
19259	310	16957	130	626	0	18023
19260	303	465	108	17312	0	18188
19261	16965	259	112	634	0	17970
19262	16525	161	72	423	0	17181
19263	714	16101	99	287	0	17201
19264	278	14806	81	127	0	15292
19265	182	443	70	14552	0	15247
19266	128	219	105	14817	0	15269
19267	14534	111	78	514	0	15237
19268	14329	66	72	308	0	14775
19269	449	14439	55	183	0	15126
19270	250	332	55	14134	0	14771
19271	196	182	54	14407	0	14839
19272	111	125	14125	485	0	14846
19273	124	13766	275	311	0	14476
19274	110	13623	132	181	0	14046
19275	95	290	39	12900	0	13324
19276	59	122	12965	239	0	13385
19277	46	77	12881	127	0	13131
19278	78	41	292	13003	0	13414
19279	69	56	128	13314	0	13567
19280	51	44	13220	324	0	13639
19281	88	27	245	13306	0	13666
19282	51	34	13595	288	0	13968
19283	13805	37	287	184	0	14313
19284	314	38	108	14191	0	14651
19285	142	28	14371	351	0	14892
19286	107	44	14318	167	0	14636
19287	89	46	402	14993	0	15530
19288	59	44	16034	371	0	16508
19289	76	35	16039	203	0	16353
19290	41	15761	482	147	0	16431
19291	16233	322	223	127	0	16905
19292	343	154	16838	91	0	17426
19293	203	87	358	16489	0	17137
19294	124	47	210	16837	0	17218
19295	94	41	130	17373	0	17638
19296	58	66	17000	549	0	17673
19297	111	35	380	16720	0	17246
19298	16806	38	199	492	0	17535
19299	371	32	120	16806	0	17329
19300	176	44	16699	473	0	17392
19301	127	33	387	16668	0	17215
19302	16763	28	231	527	0	17549
19303	17096	44	141	303	0	17584
19304	17045	46	109	196	0	17396
19305	557	46	100	17038	0	17741
19306	17118	24	118	460	0	17720
19307	17127	27	100	290	0	17544
19308	17168	27	81	230	0	17506
19309	573	16441	99	151	0	17264
19310	16806	329	111	161	0	17407
19311	490	147	94	16723	0	17454
19312	275	85	16548	438	0	17346
19313	188	16554	391	248	0	17381
19314	16802	343	198	227	0	17570
19315	435	181	139	16856	0	17611
19316	300	83	101	16619	0	17103
19317	167	16359	105	532	0	17163
19318	148	17261	119	278	0	17806
19319	16422	457	96	209	0	17184
19320	459	16549	87	171	0	17266
19321	16126	391	93	169	0	16779
19322	432	16162	99	150	0	16843
19323	15987	416	69	155	0	16627
19324	453	15967	66	154	0	16640
19325	271	16644	85	142	0	17142
19326	16399	493	76	184	0	17152
19327	456	231	16429	107	0	17223
19328	232	16744	334	133	0	17443
19329	229	364	172	16666	0	17431
19330	138	208	107	17733	0	18186
19331	162	152	81	17559	0	17954
19332	191	112	65	17877	0	18245
19333	153	96	17887	594	0	18730
19334	17570	98	395	332	0	18395
19335	501	97	180	18617	0	19395
19336	18867	77	121	571	0	19636
19337	19468	95	103	284	0	19950
19338	19731	103	73	235	0	20142
19339	19161	104	91	184	0	19540
19340	723	109	18561	162	0	19555
19341	398	89	455	18280	0	19222
19342	218	95	18266	533	0	19112
19343	197	18044	533	275	0	19049
19344	275	460	280	15792	0	16807
19345	215	189	138	17358	0	17900
19346	150	78	126	17853	0	18207
19347	147	88	115	17600	0	17950
19348	148	66	17281	692	0	18187
19349	163	70	467	17305	0	18005
19350	175	83	231	17702	0	18191
19351	17574	76	133	704	0	18487
19352	18193	70	125	362	0	18750
19353	724	69	109	18146	0	19048
19354	351	57	124	18430	0	18962
19355	244	72	124	18734	0	19174
19356	18310	58	112	845	0	19325
19357	18724	62	116	456	0	19358
19358	17730	77	116	338	0	18261
19359	18645	85	94	289	0	19113
19360	773	18326	97	269	0	19465
19361	18719	449	86	277	0	19531
19362	18937	181	86	282	0	19486
19363	802	95	69	18422	0	19388
19364	454	69	68	18590	0	19181
19365	18048	60	64	798	0	18970
19366	674	17421	69	413	0	18577
19367	404	18103	74	272	0	18853
19368	18811	573	49	290	0	19723
19369	734	237	55	19048	0	20074
19370	443	142	47	19335	0	19967
19371	366	95	42	19679	0	20182
19372	307	106	51	19600	0	20064
19373	319	95	51	19323	0	19788
19374	247	18682	51	806	0	19786
19375	268	477	38	18596	0	19379
19376	18412	208	31	651	0	19302
19377	567	135	38	18224	0	18964
19378	323	122	39	18327	0	18811
19379	17874	111	33	749	0	18767
19380	525	17952	44	417	0	18938
19381	324	511	43	17617	0	18495
19382	186	17937	40	539	0	18702
19383	218	468	35	17433	0	18154
19384	190	177	16936	470	0	17773
19385	15543	124	300	339	0	16306
19386	416	16575	109	194	0	17294
19387	15898	293	58	190	0	16439
19388	374	123	15342	166	0	16005
19389	211	120	268	14345	0	14944
19390	118	14447	104	338	0	15007
19391	120	15026	53	207	0	15406
19392	14662	333	60	163	0	15218
19393	350	129	26	14682	0	15187
19394	157	77	15202	370	0	15806
19395	135	53	264	15430	0	15882
19396	93	61	15420	400	0	15974
19397	14494	47	296	261	0	15098
19398	349	66	15619	156	0	16190
19399	194	48	295	15416	0	15953
19400	131	15898	134	369	0	16532
19401	141	302	57	15751	0	16251
19402	96	15983	59	379	0	16517
19403	16249	312	38	224	0	16823
19404	398	146	35	16773	0	17352
19405	193	88	16859	419	0	17559
19406	171	81	16153	219	0	16624
19407	16484	64	369	223	0	17140
19408	17499	64	136	187	0	17886
19409	17469	66	70	166	0	17771
19410	17291	65	61	163	0	17580
19411	483	17090	46	158	0	17777
19412	17334	306	56	169	0	17865
19413	17382	132	34	186	0	17734
19414	459	107	16785	143	0	17494
19415	279	90	283	16676	0	17328
19416	17021	79	119	419	0	17638
19417	423	61	16574	242	0	17300
19418	230	72	301	16503	0	17106
19419	175	70	17230	420	0	17895
19420	173	66	305	16903	0	17447
19421	158	17480	132	362	0	18132
19422	17784	305	77	241	0	18407
19423	399	141	17306	162	0	18008
19424	17156	106	293	175	0	17730
19425	427	86	122	17472	0	18107
19426	17548	64	64	401	0	18077
19427	431	71	68	17337	0	17907
19428	18027	64	62	482	0	18635
19429	403	89	17426	212	0	18130
19430	17959	78	285	208	0	18530
19431	407	60	112	18180	0	18759
19432	210	51	75	18309	0	18645
19433	17884	43	67	443	0	18437
19434	352	56	48	17981	0	18437
19435	165	64	17645	310	0	18184
19436	142	83	208	17396	0	17829
19437	16744	49	103	306	0	17202
19438	238	16448	65	171	0	16922
19439	108	16628	54	95	0	16885
19440	16378	168	37	133	0	16716
19441	200	17090	47	77	0	17414
19442	137	147	52	16910	0	17246
19443	16856	63	50	228	0	17197
19444	16902	48	32	129	0	17111
19445	16831	57	29	118	0	17035
19446	228	41	16907	56	0	17232
19447	133	71	135	16703	0	17042
19448	73	16940	71	158	0	17242
19449	91	130	63	17173	0	17457
19450	70	57	17590	165	0	17882
19451	73	16493	151	87	0	16804
19452	104	162	60	16906	0	17232
19453	16586	22	32	120	0	16760
19454	94	16657	26	49	0	16826
19455	63	93	16970	37	0	17163
19456	86	36	98	16663	0	16883
19457	52	34	16842	108	0	17036
19458	69	18	106	16339	0	16532
19459	17109	16	41	177	0	17343
19460	120	19	36	17066	0	17241
19461	17135	16	21	174	0	17346
19462	17180	13	30	106	0	17329
19463	147	17532	32	46	0	17757
19464	17772	99	34	106	0	18011
19465	143	17648	25	57	0	17873
19466	84	127	17994	36	0	18241
19467	135	49	107	17559	0	17850
19468	89	24	50	18876	0	19039
19469	68	32	18307	166	0	18573
19470	44	18176	140	81	0	18441
19471	18455	117	53	126	0	18751
19472	18831	56	42	111	0	19040
19473	203	26	40	19218	0	19487
19474	114	32	38	19089	0	19273
19475	94	19	32	19585	0	19730
19476	19314	30	25	257	0	19626
19477	176	39	19019	88	0	19322
19478	96	42	18912	66	0	19116
19479	107	26	165	19438	0	19736
19480	67	30	19251	173	0	19521
19481	53	35	19021	109	0	19218
19482	102	21	184	18679	0	18986
19483	64	40	19751	186	0	20041
19484	52	19637	183	115	0	19987
19485	82	150	83	19876	0	20191
19486	64	59	20348	203	0	20674
19487	92	50	174	19926	0	20242
19488	74	19239	77	216	0	19606
19489	79	144	60	20004	0	20287
19490	65	54	20367	216	0	20702
19491	85	48	178	19723	0	20034
19492	20127	34	80	279	0	20520
19493	190	39	20244	103	0	20576
19494	18428	21	187	147	0	18783
19495	181	19959	93	88	0	20321
19496	20052	157	51	128	0	20388
19497	216	64	55	20282	0	20617
19498	75	20156	58	198	0	20487
19499	20932	183	38	161	0	21314
19500	237	59	57	21249	0	21602
19501	95	62	21439	250	0	21846
19502	54	21655	221	119	0	22049
19503	98	224	114	21776	0	22212
19504	21276	71	52	313	0	21712
19505	20691	58	48	160	0	20957
19506	296	46	40	20705	0	21087
19507	127	43	20507	243	0	20920
19508	18899	21	228	218	0	19366
19509	247	50	20546	78	0	20921
19510	146	44	255	20291	0	20736
19511	20671	33	100	334	0	21138
19512	246	20719	67	131	0	21163
19513	20809	213	43	144	0	21209
19514	287	91	20455	98	0	20931
19515	20463	56	248	119	0	20886
19516	306	42	111	20905	0	21364
19517	161	41	72	21341	0	21615
19518	102	41	21225	310	0	21678
19519	115	43	235	20310	0	20703
19520	20576	54	97	344	0	21071
19521	291	43	82	20621	0	21037
19522	160	21026	76	276	0	21538
19523	135	217	74	21070	0	21496
19524	101	21215	67	311	0	21694
19525	84	245	20830	175	0	21334
19526	19651	106	274	186	0	20217
19527	293	62	107	21393	0	21855
19528	155	45	20422	311	0	20933
19529	112	20348	244	154	0	20858
19530	130	237	115	20089	0	20571
19531	102	126	84	20361	0	20673
19532	20227	67	81	405	0	20780
19533	298	61	80	20671	0	21110
19534	20774	57	86	383	0	21300
19535	20570	40	74	248	0	20932
19536	364	20574	77	154	0	21169
19537	20960	280	71	177	0	21488
19538	391	118	55	22420	0	22984
19539	189	81	22506	404	0	23180
19540	22167	59	343	255	0	22824
19541	435	66	130	22173	0	22804
19542	212	59	22066	422	0	22759
19543	20985	72	410	245	0	21712
19544	445	65	142	22186	0	22838
19545	227	22958	107	398	0	23690
19546	215	356	77	22225	0	22873
19547	118	22857	115	430	0	23520
19548	22587	378	87	276	0	23328
19549	446	164	23450	159	0	24219
19550	196	23338	367	200	0	24101
19551	217	363	157	23586	0	24323
19552	153	162	24025	433	0	24773
19553	150	138	22871	223	0	23382
19554	139	24009	456	183	0	24787
19555	241	429	192	24113	0	24975
19556	183	160	138	24940	0	25421
19557	201	106	97	30038	0	30442
19558	31029	90	114	1000	0	32233
19559	844	108	32340	323	0	33615
19560	299	32592	828	249	0	33968
19561	273	850	281	31960	0	33364
19562	229	294	188	33685	0	34396
19563	132	198	32960	1160	0	34450
19564	217	181	903	33022	0	34323
19565	141	107	32961	1130	0	34339
19566	130	113	31938	419	0	32600
19567	160	92	32826	304	0	33382
19568	234	90	1122	31188	0	32634
19569	147	120	416	32467	0	33150
19570	184	94	269	33560	0	34107
19571	32585	88	217	1313	0	34203
19572	909	32433	207	510	0	34059
19573	32983	893	185	420	0	34481
19574	31992	282	145	429	0	32848
19575	33822	174	159	362	0	34517
19576	1191	34139	178	289	0	35797
19577	34519	923	180	272	0	35894
19578	35617	312	173	269	0	36371
19579	1283	209	151	34727	0	36370
19580	535	158	155	35435	0	36283
19581	402	123	137	36137	0	36799
19582	286	118	34761	1371	0	36536
19583	33431	114	969	618	0	35132
19584	1091	152	338	34722	0	36303
19585	34218	121	253	1209	0	35801
19586	1084	34235	219	526	0	36064
19587	503	895	211	34584	0	36193
19588	406	275	159	35768	0	36608
19589	34933	200	195	1329	0	36657
19590	1123	180	163	35173	0	36639
19591	33009	156	160	1379	0	34704
19592	35037	135	103	639	0	35914
19593	1262	33523	143	504	0	35432
19594	477	34836	146	387	0	35846
19595	487	1173	115	33444	0	35219
19596	316	34769	157	1000	0	36242
19597	431	1025	127	34626	0	36209
19598	289	345	34315	1210	0	36159
19599	278	256	32743	512	0	33789
19600	31812	249	979	444	0	33484
19601	33318	144	383	388	0	34233
19602	1130	32785	251	340	0	34506
19603	32845	868	169	395	0	34277
19604	1107	34376	169	355	0	36007
19605	470	975	167	34939	0	36551
19606	369	339	199	35596	0	36503
19607	367	268	155	35611	0	36401
19608	272	224	184	35984	0	36664
19609	34983	139	170	1455	0	36747
19610	951	35150	196	692	0	36989
19611	35355	871	169	590	0	36985
19612	35833	311	188	482	0	36814
19613	1319	271	34790	319	0	36699
19614	34115	236	863	417	0	35631
19615	1245	34768	264	323	0	36600
19616	576	996	233	34911	0	36716
19617	490	385	185	34493	0	35553
19618	366	34007	192	1166	0	35731
19619	35016	972	183	691	0	36862
19620	1138	371	34364	507	0	36380
19621	33642	306	917	620	0	35485
19622	1285	245	34238	481	0	36249
19623	659	213	1134	34225	0	36231
19624	630	270	479	35242	0	36621
19625	528	217	427	35831	0	37003
19626	35392	309	334	1660	0	37695
19627	1146	248	35905	911	0	38210
19628	35714	289	1011	872	0	37886
19629	37015	256	512	792	0	38575
19630	37001	184	444	778	0	38407
19631	37049	179	490	606	0	38324
19632	1559	195	462	36178	0	38394
19633	789	185	35486	1243	0	37703
19634	709	239	1003	35369	0	37320
19635	586	185	35483	1402	0	37656
19636	563	272	34684	778	0	36297
19637	595	35087	981	638	0	37301
19638	736	981	350	32451	0	34518
19639	718	389	279	34273	0	35659
19640	811	387	253	28733	0	30184
19641	730	253	209	33810	0	35002
19642	33777	271	175	1307	0	35530
19643	34150	202	142	705	0	35199
19644	1430	193	145	33426	0	35194
19645	726	181	32273	1362	0	34542
19646	574	146	873	32908	0	34501
19647	509	142	330	33874	0	34855
19648	450	128	32750	1492	0	34820
19649	579	134	840	32047	0	33600
19650	32086	194	303	1358	0	33941
19651	32382	203	222	743	0	33550
19652	32237	236	142	645	0	33260
19653	1348	214	108	31473	0	33143
19654	30992	152	135	1217	0	32496
19655	30515	159	168	651	0	31493
19656	1281	147	29435	599	0	31462
19657	346	56	22322	245	0	22969
19658	280	64	22501	214	0	23059
19659	20907	28	220	164	0	21319
19660	231	21486	112	114	0	21943
19661	21673	145	121	126	0	22065
19662	237	22904	50	96	0	23287
19663	154	179	73	22882	0	23288
19664	155	55	44	23020	0	23274
19665	131	52	50	23001	0	23234
19666	102	41	22781	260	0	23184
19667	21010	31	195	186	0	21422
19668	256	16	76	22585	0	22933
19669	111	23	22357	187	0	22678
19670	94	31	21000	103	0	21228
19671	20861	20	197	160	0	21238
19672	200	22313	89	92	0	22694
19673	21960	144	55	101	0	22260
19674	21566	58	42	115	0	21781
19675	223	21528	44	76	0	21871
19676	20856	134	39	109	0	21138
19677	229	52	21403	73	0	21757
19678	118	36	20245	51	0	20450
19679	96	34	21216	44	0	21390
19680	104	86	205	21033	0	21428
19681	61	26	21533	167	0	21787
19682	20242	16	190	127	0	20575
19683	21101	15	80	92	0	21288
19684	218	25	21498	38	0	21779
19685	128	26	158	21067	0	21379
19686	21226	21	64	194	0	21505
19687	188	21702	47	72	0	22009
19688	100	22068	46	51	0	22265
19689	22072	161	36	93	0	22362
19690	182	57	22262	33	0	22534
19691	93	106	160	21316	0	21675
19692	73	13	73	21575	0	21734
19693	48	11	43	22010	0	22112
19694	33	22023	35	168	0	22259
19695	133	154	37	19905	0	20229
19696	23379	31	20	245	0	23675
19697	247	22	26	23845	0	24140
19698	77	24023	28	234	0	24362
19699	24422	229	11	121	0	24783
19700	282	71	16	24612	0	24981
19701	115	44	14	25682	0	25855
19702	26218	42	16	353	0	26629
19703	26398	23	20	150	0	26591
19704	380	21	19	25619	0	26039
19705	26198	11	12	402	0	26623
19706	26454	29	14	168	0	26665
19707	427	26531	21	81	0	27060
19708	26757	321	13	128	0	27219
19709	395	26428	21	83	0	26927
19710	223	342	7	26501	0	27073
19711	137	115	26844	366	0	27462
19712	158	68	315	26630	0	27171
19713	157	61	82	27058	0	27358
19714	137	33	33	28195	0	28398
19715	27796	57	39	555	0	28447
19716	441	27622	32	218	0	28313
19717	28554	383	24	192	0	29153
19718	508	29406	22	161	0	30097
19719	30123	436	40	174	0	30773
19720	30366	174	31	183	0	30754
19721	30668	110	21	157	0	30956
19722	30488	104	30	179	0	30801
19723	684	90	30141	96	0	31011
19724	314	94	441	30104	0	30953
19725	285	62	135	31043	0	31525
19726	169	90	30510	658	0	31427
19727	29115	65	506	321	0	30007
19728	642	76	140	29898	0	30756
19729	306	75	29519	607	0	30507
19730	265	102	29081	232	0	29680
19731	264	108	623	29952	0	30947
19732	233	105	30722	612	0	31672
19733	292	81	579	30159	0	31111
19734	275	66	210	30477	0	31028
19735	267	58	29732	708	0	30765
19736	28298	52	596	345	0	29291
19737	697	55	231	29761	0	30744
19738	288	65	29976	691	0	31020
19739	287	45	593	29960	0	30885
19740	30000	49	275	780	0	31104
19741	665	48	29965	350	0	31028
19742	28978	42	613	355	0	29988
19743	30837	50	289	306	0	31482
19744	832	47	229	30544	0	31652
19745	403	52	203	30680	0	31338
19746	282	74	30457	809	0	31622
19747	243	64	649	30497	0	31453
19748	367	61	300	27004	0	27732
19749	228	49	218	31178	0	31673
19750	240	49	30143	889	0	31321
19751	29091	40	637	503	0	30271
19752	30442	38	258	435	0	31173
19753	30977	52	206	418	0	31653
19754	31943	44	229	319	0	32535
19755	942	61	175	31824	0	33002
19756	31694	63	187	811	0	32755
19757	31972	49	150	468	0	32639
19758	24304	167	269	647	0	25387
19759	31956	30	187	393	0	32566
19760	871	31771	213	317	0	33172
19761	32273	495	151	402	0	33321
19762	31986	146	165	363	0	32660
19763	940	31637	178	377	0	33132
19764	32131	627	146	340	0	33244
19765	1034	188	181	32032	0	33435
19766	615	107	156	32448	0	33326
19767	32013	80	120	984	0	33197
19768	964	31002	150	445	0	32561
19769	489	31545	143	368	0	32545
19770	455	714	148	31983	0	33300
19771	405	235	32207	815	0	33662
19772	440	150	663	31594	0	32847
19773	424	124	225	32887	0	33660
19774	32296	118	178	1014	0	33606
19775	32749	119	171	446	0	33485
19776	1104	111	113	32439	0	33767
19777	509	141	32005	873	0	33528
19778	471	120	677	32549	0	33817
19779	33287	80	278	1018	0	34663
19780	983	91	34344	492	0	35910
19781	490	34552	832	389	0	36263
19782	35497	786	300	388	0	36971
19783	1098	288	213	35543	0	37142
19784	545	197	172	35947	0	36861
19785	427	142	187	36860	0	37616
19786	380	93	35351	1299	0	37123
19787	32301	103	811	765	0	33980
19788	1082	83	34357	451	0	35973
19789	560	33920	888	405	0	35773
19790	492	711	371	34845	0	36419
19791	484	246	243	35655	0	36628
19792	430	166	243	37750	0	38589
19793	364	146	36656	1478	0	38644
19794	309	107	35342	689	0	36447
19795	298	120	36035	478	0	36931
19796	284	35806	1195	379	0	37664
19797	376	940	516	35788	0	37620
19798	36517	280	288	1183	0	38268
19799	38339	166	233	547	0	39285
19800	1406	143	39485	413	0	41447
19801	643	39796	1140	370	0	41949
19802	440	1057	39489	287	0	41273
19803	331	41035	1125	334	0	42825
19804	39643	1305	690	387	0	42025
19805	39875	484	342	382	0	41083
19806	1418	39464	250	334	0	41466
19807	39891	1153	262	298	0	41604
19808	1445	465	277	39325	0	41512
19809	728	324	263	40466	0	41781
19810	39973	275	221	1499	0	41968
19811	39236	230	191	700	0	40357
19812	39527	216	174	513	0	40430
19813	1731	37821	183	417	0	40152
19814	792	39734	199	366	0	41091
19815	39447	1362	179	366	0	41354
19816	1450	543	39032	276	0	41301
19817	801	599	1059	37939	0	40398
19818	37380	318	466	1160	0	39324
19819	1403	36086	271	472	0	38232
19820	704	38124	200	326	0	39354
19821	37881	1342	212	318	0	39753
19822	1382	605	36867	291	0	39145
19823	35940	393	1061	292	0	37686
19824	1422	347	35974	231	0	37974
19825	735	291	36031	193	0	37250
19826	652	275	1277	35756	0	37960
19827	491	278	37377	980	0	39126
19828	36638	264	1214	505	0	38621
19829	37936	220	588	376	0	39120
19830	38628	207	437	308	0	39580
19831	38640	228	340	308	0	39516
19832	1775	204	300	36998	0	39277
19833	37453	202	275	1113	0	39043
19834	1513	36643	259	498	0	38913
19835	961	1002	234	35285	0	37482
19836	678	37340	259	956	0	39233
19837	38858	1107	202	512	0	40679
19838	39268	508	248	419	0	40443
19839	1675	365	216	38535	0	40791
19840	39288	276	239	1199	0	41002
19841	39890	295	248	602	0	41035
19842	1744	273	210	39015	0	41242
19843	1035	238	233	39367	0	40873
19844	839	251	208	40093	0	41391
19845	716	208	38392	1522	0	40838
19846	659	215	36494	774	0	38142
19847	606	211	38304	566	0	39687
19848	617	218	1394	38232	0	40461
19849	530	223	39060	1309	0	41122
19850	583	190	1310	38537	0	40620
19851	560	198	40784	1375	0	42917
19852	544	188	39366	721	0	40819
19853	37915	204	1464	648	0	40231
19854	1278	38995	756	480	0	41509
19855	39877	994	529	453	0	41853
19856	1418	456	472	39265	0	41611
19857	813	318	430	39898	0	41459
19858	639	281	39374	1449	0	41743
19859	550	39128	1151	758	0	41587
19860	553	1055	577	39716	0	41901
19861	544	450	40175	1217	0	42386
19862	484	39275	1034	653	0	41446
19863	547	933	601	39621	0	41702
19864	39424	423	455	1202	0	41504
19865	39592	306	383	694	0	40975
19866	1331	268	400	39625	0	41624
19867	39721	262	358	1196	0	41537
19868	1240	39487	356	635	0	41718
19869	817	935	335	40073	0	42160
19870	622	463	40702	1107	0	42894
19871	645	333	977	40748	0	42703
19872	578	291	40754	1259	0	42882
19873	39656	277	1079	748	0	41760
19874	1307	255	514	40727	0	42803
19875	707	40816	405	1192	0	43120
19876	655	1092	334	42187	0	44268
19877	515	463	41494	1304	0	43776
19878	525	303	40138	717	0	41683
19879	452	263	39402	529	0	40646
19880	37033	302	1277	493	0	39105
19881	948	38266	627	378	0	40219
19882	529	786	431	38151	0	39897
19883	38143	343	418	1006	0	39910
19884	925	37940	401	544	0	39810
19885	39170	812	346	521	0	40849
19886	39600	411	331	407	0	40749
19887	40140	275	272	441	0	41128
19888	40773	233	275	383	0	41664
19889	1325	224	39411	304	0	41264
19890	37957	168	859	361	0	39345
19891	1155	165	38382	303	0	40005
19892	36526	146	688	280	0	37640
19893	982	171	397	37318	0	38868
19894	661	114	37028	562	0	38365
19895	500	36226	645	370	0	37741
19896	622	1328	404	34363	0	36717
19897	402	35163	252	510	0	36327
19898	359	35750	211	348	0	36668
19899	32778	428	233	296	0	33735
19900	434	118	31970	157	0	32679
19901	175	30438	250	81	0	30944
19902	29801	207	222	116	0	30346
19903	255	30178	77	42	0	30552
19904	30375	188	57	124	0	30744
19905	265	91	54	30233	0	30643
19906	30432	48	60	233	0	30773
19907	252	47	48	29951	0	30298
19908	30197	54	49	244	0	30544
19909	250	49	33	30022	0	30354
19910	115	30599	54	205	0	30973
19911	98	181	60	31113	0	31452
19912	31052	70	53	253	0	31428
19913	224	30771	50	84	0	31129
19914	122	223	35	30711	0	31091
19915	30976	86	29	261	0	31352
19916	263	54	29	31061	0	31407
19917	157	59	30	30944	0	31190
19918	92	58	31301	272	0	31723
19919	119	57	30071	98	0	30345
19920	116	56	216	30244	0	30632
19921	87	74	31836	217	0	32214
19922	98	42	190	31587	0	31917
19923	199	61	110	27562	0	27932
19924	85	64	40	32080	0	32269
19925	85	60	31721	266	0	32132
19926	131	47	172	29936	0	30286
19927	101	52	54	30543	0	30750
19928	76	30669	42	279	0	31066
19929	88	171	59	31153	0	31471
19930	31143	74	67	293	0	31577
19931	233	40	48	31644	0	31965
19932	117	57	35087	261	0	35522
19933	32506	42	398	279	0	33225
19934	435	36520	263	146	0	37364
19935	338	410	182	37010	0	37940
19936	247	263	36417	500	0	37427
19937	33293	191	444	447	0	34375
19938	477	35711	317	285	0	36790
19939	36021	474	218	227	0	36940
19940	654	288	132	35670	0	36744
19941	35330	213	109	575	0	36227
19942	731	124	34790	332	0	35977
19943	414	34061	452	265	0	35192
19944	297	36937	286	218	0	37738
19945	37266	621	242	250	0	38379
19946	37240	416	122	232	0	38010
19947	765	298	36970	114	0	38147
19948	35912	153	485	178	0	36728
19949	37009	115	306	177	0	37607
19950	36833	95	221	157	0	37306
19951	952	34724	142	109	0	35927
19952	607	35383	95	118	0	36203
19953	35591	635	102	193	0	36521
19954	35802	416	85	157	0	36460
19955	807	35973	64	99	0	36943
19956	556	580	77	35966	0	37179
19957	403	390	35858	455	0	37106
19958	34727	262	469	422	0	35880
19959	31974	219	372	504	0	33069
19960	36824	125	269	255	0	37473
19961	852	36032	130	134	0	37148
19962	564	492	35942	97	0	37095
19963	36531	312	478	156	0	37477
19964	706	282	277	36812	0	38077
19965	519	177	222	36900	0	37818
19966	453	127	136	38020	0	38736
19967	280	140	37346	863	0	38629
19968	269	108	466	36746	0	37589
19969	221	105	37167	755	0	38248
19970	152	35572	546	494	0	36764
19971	34957	394	373	353	0	36077
19972	468	35167	239	153	0	36027
19973	330	35501	142	115	0	36088
19974	35187	678	162	179	0	36206
19975	513	36279	88	77	0	36957
19976	401	674	73	35279	0	36427
19977	317	35458	51	404	0	36230
19978	35350	631	65	348	0	36394
19979	528	35958	53	226	0	36765
19980	424	655	59	36302	0	37440
19981	284	419	35925	514	0	37142
19982	226	317	467	36207	0	37217
19983	169	36220	345	733	0	37467
19984	200	564	232	37338	0	38334
19985	156	439	132	36969	0	37696
19986	207	298	126	35389	0	36020
19987	190	162	112	37619	0	38083
19988	190	172	88	37858	0	38308
19989	191	135	74	38274	0	38674
19990	147	144	37238	1243	0	38772
19991	35972	159	635	824	0	37590
19992	724	128	386	39695	0	40933
19993	468	140	39598	932	0	41138
19994	352	155	39189	669	0	40365
19995	302	146	1102	40182	0	41732
19996	40433	154	734	1055	0	42376
19997	863	171	39832	692	0	41558
19998	38923	144	966	662	0	40695
19999	1101	159	40938	358	0	42556
20000	797	136	1078	40518	0	42529
20001	657	182	595	41913	0	43347
20002	421	165	41486	1247	0	43319
20003	39057	170	988	914	0	41129
20004	1021	147	634	40798	0	42600
20005	683	127	40747	1117	0	42674
20006	543	122	40600	780	0	42045
20007	517	132	1326	38156	0	40131
20008	379	40606	895	909	0	42789
20009	41279	752	619	777	0	43427
20010	41352	468	439	669	0	42928
20011	1331	377	41392	387	0	43487
20012	1017	277	1018	40253	0	42565
20013	41422	230	596	1181	0	43429
20014	1247	165	41130	708	0	43250
20015	39834	114	1101	671	0	41720
20016	1310	39395	760	511	0	41976
20017	861	791	626	41300	0	43578
20018	746	446	468	41895	0	43555
20019	42431	349	411	1493	0	44684
20020	1201	271	383	42762	0	44617
20021	827	266	307	42267	0	43667
20022	693	216	265	43023	0	44197
20023	41537	146	346	1978	0	44007
20024	1213	170	41062	1235	0	43680
20025	40922	183	1025	1033	0	43163
20026	41489	168	669	870	0	43196
20027	42904	153	542	648	0	44247
20028	1965	199	422	41550	0	44136
20029	1196	185	42343	1268	0	44992
20030	818	40057	1164	918	0	42957
20031	678	40908	665	819	0	43070
20032	461	39971	345	547	0	41324
20033	484	1050	40395	501	0	42430
20034	485	605	1098	44560	0	46748
20035	45481	291	484	1584	0	47840
20036	48831	234	318	1058	0	50441
20037	2072	194	322	50400	0	52988
20038	1212	141	49939	1741	0	53033
20039	852	174	50114	1088	0	52228
20040	675	121	1924	50729	0	53449
20041	534	128	51541	1827	0	54030
20042	581	129	1930	51919	0	54559
20043	563	124	1129	50535	0	52351
20044	414	50697	861	2296	0	54268
20045	542	1350	632	51754	0	54278
20046	545	719	500	53962	0	55726
20047	52155	495	570	2753	0	55973
20048	1859	301	528	53077	0	55765
20049	1195	233	475	53879	0	55782
20050	51668	205	618	2859	0	55350
20051	1826	51338	565	1937	0	55666
20052	52343	1381	617	1520	0	55861
20053	2188	833	51357	1048	0	55426
20054	51241	546	1702	1197	0	54686
20055	51906	402	1160	1083	0	54551
20056	2945	362	50243	866	0	54416
20057	1645	283	50426	978	0	53332
20058	1362	324	2481	48497	0	52664
20059	48951	197	1564	2169	0	52881
20060	2158	249	48297	1552	0	52256
20061	1604	211	2179	48228	0	52222
20062	1168	233	48135	2278	0	51814
20063	1102	241	2313	47436	0	51092
20064	1029	228	1482	48847	0	51586
20065	47315	225	1229	3006	0	51775
20066	46785	247	897	2181	0	50110
20067	49025	271	804	1654	0	51754
20068	3026	258	47701	1330	0	52315
20069	1914	254	48155	1230	0	51553
20070	1605	276	2524	47502	0	51907
20071	1315	312	1728	48128	0	51483
20072	1212	306	1241	49783	0	52542
20073	47468	267	1005	3207	0	51947
20074	2244	46971	958	2129	0	52302
20075	46398	1459	812	1787	0	50456
20076	45566	816	760	1481	0	48623
20077	2909	44314	800	1241	0	49264
20078	2054	45913	739	1145	0	49851
20079	45451	1965	815	1224	0	49455
20080	2354	1115	802	43737	0	48008
20081	1748	43763	714	2679	0	48904
20082	1914	1606	587	44904	0	49011
20083	1596	1038	43294	2749	0	48677
20084	1409	692	1821	44416	0	48338
20085	43283	505	1580	2961	0	48329
20086	2204	490	42764	2114	0	47572
20087	1654	395	42448	1900	0	46397
20088	1520	1133	2749	38708	0	44110
20089	1233	38248	1800	2494	0	43775
20090	1119	39215	1152	2049	0	43535
20091	993	41330	928	1893	0	45144
20092	39105	2058	817	1724	0	43704
20093	39329	1187	611	1695	0	42822
20094	38034	741	614	1603	0	40992
20095	2607	37667	703	1628	0	42605
20096	38983	1278	664	1542	0	42467
20097	38781	976	644	1324	0	41725
20098	2697	961	37379	1077	0	42114
20099	2147	36403	1707	981	0	41238
20100	1713	1506	1441	36742	0	41402
20101	37065	1076	1091	1867	0	41099
20102	2413	737	36373	1473	0	40996
20103	1761	478	1992	35109	0	39340
20104	1405	35705	1539	2229	0	40878
20105	1425	1312	1129	36439	0	40305
20106	1395	885	1016	37422	0	40718
20107	36868	644	1102	2759	0	41373
20108	37185	612	966	2187	0	40950
20109	2600	536	1007	36934	0	41077
20110	1832	595	35576	2425	0	40428
20111	1616	537	35542	1955	0	39650
20112	36264	502	2045	1667	0	40478
20113	2765	513	36533	1137	0	40948
20114	2257	502	1990	32604	0	37353
20115	1664	34571	1637	1770	0	39642
20116	35019	1334	1435	1453	0	39241
20117	2107	34804	1161	1511	0	39583
20118	35711	1526	916	1636	0	39789
20119	2365	989	876	35107	0	39337
20120	1930	835	732	35794	0	39291
20121	35372	856	745	2438	0	39411
20122	36267	690	742	1722	0	39421
20123	2961	750	684	35194	0	39589
20124	2301	869	614	35623	0	39407
20125	1717	834	34038	2245	0	38834
20126	1443	760	33655	1723	0	37581
20127	33525	699	1890	1597	0	37711
20128	1958	812	31611	1364	0	35745
20129	32362	614	1601	1528	0	36105
20130	33365	431	1331	1385	0	36512
20131	2478	462	31557	1313	0	35810
20132	1988	29161	1521	1019	0	33689
20133	1544	30313	1310	763	0	33930
20134	763	811	25464	420	0	27458
20135	1196	1600	1273	22189	0	26258
20136	21356	421	807	925	0	23509
20137	20979	153	173	369	0	21674
20138	23320	123	162	276	0	23881
20139	26699	118	139	319	0	27275
20140	27057	126	122	285	0	27590
20141	1215	26801	164	204	0	28384
20142	26121	773	112	177	0	27183
20143	1005	25763	135	144	0	27047
20144	25300	791	77	102	0	26270
20145	1002	254	24515	40	0	25811
20146	506	127	705	23667	0	25005
20147	432	119	194	23046	0	23791
20148	267	23870	126	759	0	25022
20149	23999	797	82	301	0	25179
20150	24650	312	64	182	0	25208
20151	1132	200	80	23676	0	25088
20152	505	128	111	24396	0	25140
20153	24066	79	106	1038	0	25289
20154	1000	91	61	24043	0	25195
20155	466	151	45	24620	0	25282
20156	24137	138	45	1052	0	25372
20157	1087	115	47	24124	0	25373
20158	24269	78	45	1060	0	25452
20159	24561	47	81	570	0	25259
20160	1099	75	23853	367	0	25394
20161	24178	45	684	401	0	25308
20162	24661	79	210	334	0	25284
20163	24897	54	98	313	0	25362
20164	1273	59	23335	236	0	24903
20165	647	45	720	23011	0	24423
20166	526	48	243	24033	0	24850
20167	423	70	23250	973	0	24716
20168	22934	35	832	421	0	24222
20169	1095	38	277	22842	0	24252
20170	590	42	22446	909	0	23987
20171	398	41	23159	385	0	23983
20172	360	48	986	22994	0	24388
20173	336	56	23352	1004	0	24748
20174	328	52	962	23176	0	24518
20175	366	32	393	23854	0	24645
20176	341	48	23410	1134	0	24933
20177	356	47	923	22350	0	23676
20178	239	22093	449	963	0	23744
20179	238	24125	340	466	0	25169
20180	23576	877	251	436	0	25140
20181	23877	282	247	412	0	24818
20182	1083	23469	209	365	0	25126
20183	23679	826	200	373	0	25078
20184	24271	291	219	323	0	25104
20185	1223	224	200	23396	0	25043
20186	580	236	132	24240	0	25188
20187	23448	227	145	1134	0	24954
20188	1147	22782	147	506	0	24582
20189	574	23816	120	394	0	24904
20190	545	1026	159	23393	0	25123
20191	518	348	23491	999	0	25356
20192	22892	247	826	556	0	24521
20193	24000	214	287	472	0	24973
20194	23341	219	175	427	0	24162
20195	1384	23375	163	285	0	25207
20196	762	964	146	22930	0	24802
20197	586	395	145	24152	0	25278
20198	23491	219	185	1250	0	25145
20199	1219	23243	190	599	0	25251
20200	814	868	132	23279	0	25093
20201	733	387	125	24004	0	25249
20202	724	330	101	24017	0	25172
20203	23291	309	128	1372	0	25100
20204	1285	23009	147	769	0	25210
20205	762	1040	157	21986	0	23945
20206	678	22892	157	1063	0	24790
20207	22770	1012	177	626	0	24585
20208	1231	413	22202	636	0	24482
20209	21902	270	831	715	0	23718
20210	1177	277	21593	628	0	23675
20211	754	400	834	20764	0	22752
20212	20886	277	305	1082	0	22550
20213	1185	239	20668	603	0	22695
20214	20927	189	808	564	0	22488
20215	21789	118	377	605	0	22889
20216	22093	97	299	556	0	23045
20217	1382	102	299	20992	0	22775
20218	794	141	255	21168	0	22358
20219	676	116	204	21722	0	22718
20220	20846	100	245	1295	0	22486
20221	1238	20756	254	679	0	22927
20222	21289	638	290	479	0	22696
20223	21784	218	264	441	0	22707
20224	1319	151	20689	419	0	22578
20225	20822	149	759	514	0	22244
20226	21940	101	368	511	0	22920
20227	1326	113	340	21284	0	23063
20228	748	167	291	21512	0	22718
20229	646	165	274	21577	0	22662
20230	20772	133	248	1131	0	22284
20231	20718	104	296	634	0	21752
20232	19947	103	261	518	0	20829
20233	1077	18377	262	449	0	20165
20234	507	17199	230	406	0	18342
20235	339	17644	203	411	0	18597
20236	17237	666	306	491	0	18700
20237	806	219	16710	437	0	18172
20238	416	160	14021	286	0	14883
20239	10328	61	210	111	0	10710
20240	212	32	11104	64	0	11412
20241	56	19	65	9741	0	9881
20242	52	9254	39	80	0	9425
20243	10258	83	35	64	0	10440
20244	10286	24	26	48	0	10384
20245	10257	21	11	49	0	10338
20246	117	29	13	11021	0	11180
20247	56	32	11332	75	0	11495
20248	56	34	10709	27	0	10826
20249	11024	23	73	47	0	11167
20250	11427	14	35	52	0	11528
20251	11368	16	35	46	0	11465
20252	115	14	26	11502	0	11657
20253	75	4	32	11537	0	11648
20254	65	16	11451	83	0	11615
20255	11205	24	54	68	0	11351
20256	111	18	25	11874	0	12028
20257	60	14	23	11760	0	11857
20258	57	22	21	11667	0	11767
20259	50	11632	16	96	0	11794
20260	56	54	30	11617	0	11757
20261	48	12	32	11597	0	11689
20262	11523	18	13	127	0	11681
20263	99	17	11271	50	0	11437
20264	10872	12	63	85	0	11032
20265	11516	16	14	88	0	11634
20266	108	9	19	11424	0	11560
20267	67	11	24	11373	0	11475
20268	11372	10	20	103	0	11505
20269	101	14	11193	58	0	11366
20270	43	11075	64	57	0	11239
20271	42	42	18	10997	0	11099
20272	10924	14	23	90	0	11051
20273	75	18	21	10698	0	10812
20274	48	13	10587	78	0	10726
20275	43	19	10265	38	0	10365
20276	10254	8	51	65	0	10378
20277	82	15	29	10885	0	11011
20278	56	6	10733	48	0	10843
20279	10221	6	54	69	0	10350
20280	11052	5	18	76	0	11151
20281	68	5	18	11120	0	11211
20282	44	10	20	11084	0	11158
20283	36	11157	12	44	0	11249
20284	11506	31	18	70	0	11625
20285	68	8	13	11604	0	11693
20286	46	12	10	11653	0	11721
20287	33	16	11945	49	0	12043
20288	10784	9	42	71	0	10906
20289	11475	8	15	54	0	11552
20290	49	11335	21	33	0	11438
20291	29	28	11083	25	0	11165
20292	42	12	11002	15	0	11071
20293	56	45	31	10794	0	10926
20294	11315	21	56	69	0	11461
20295	42	8	15	11227	0	11292
20296	11617	12	9	73	0	11711
20297	11690	6	8	50	0	11754
20298	11738	5	16	63	0	11822
20299	53	4	6	11866	0	11929
20300	45	3	10	11890	0	11948
20301	12158	4	8	62	0	12232
20302	41	10	12438	10	0	12499
20303	11522	7	10	52	0	11591
20304	11790	1	9	54	0	11854
20305	20	3	12187	3	0	12213
20306	12	6	11816	9	0	11843
20307	21	12134	12	4	0	12171
20308	25	9	14	12380	0	12428
20309	12021	3	15	32	0	12071
20310	15	1	2	12412	0	12430
20311	8	11	12504	11	0	12534
20312	6	12147	9	7	0	12169
20313	5	12123	5	7	0	12140
20314	6	14	5	12507	0	12532
20315	14	3	3	12272	0	12292
20316	2	12217	6	17	0	12242
20317	11	11	12257	7	0	12286
20318	11331	5	21	46	0	11403
20319	12568	4	3	42	0	12617
20320	20	12806	6	6	0	12838
20321	12281	25	2	30	0	12338
20322	35	19	3	12101	0	12158
20323	12059	6	5	60	0	12130
20324	44	4	4	12234	0	12286
20325	12	13101	3	60	0	13176
20326	9	79	13301	16	0	13405
20327	35	21	91	14784	0	14931
20328	72	15	26	14167	0	14280
20329	29	2	12	15955	0	15998
20330	16353	2	8	253	0	16616
20331	243	11	4	16519	0	16777
20332	73	12	17480	247	0	17812
20333	43	20	18165	76	0	18304
20334	18622	8	367	94	0	19091
20335	358	18	19105	41	0	19522
20336	19163	14	378	56	0	19611
20337	429	11	80	20349	0	20869
20338	148	9	69	20962	0	21188
20339	112	16	48	21976	0	22152
20340	96	13	49	21889	0	22047
20341	21568	7	34	629	0	22238
20342	491	15	21700	216	0	22422
20343	237	18	455	20852	0	21562
20344	98	21971	144	474	0	22687
20345	22144	435	84	219	0	22882
20346	542	92	79	21403	0	22116
20347	21229	47	62	574	0	21912
20348	585	33	21062	192	0	21872
20349	248	29	520	19818	0	20615
20350	132	20996	139	511	0	21778
20351	21207	456	97	252	0	22012
20352	572	112	20990	213	0	21887
20353	249	66	515	20680	0	21510
20354	205	30	159	21525	0	21919
20355	21050	47	139	707	0	21943
20356	569	54	20911	306	0	21840
20357	213	63	21128	212	0	21616
20358	241	45	633	21168	0	22087
20359	170	38	21153	595	0	21956
20360	133	37	21513	283	0	21966
20361	228	47	643	21232	0	22150
20362	196	57	272	21699	0	22224
20363	173	46	213	22766	0	23198
20364	22252	49	184	814	0	23299
20365	597	22420	159	392	0	23568
20366	22646	502	182	292	0	23622
20367	688	152	162	22457	0	23459
20368	266	22772	153	737	0	23928
20369	241	547	142	23396	0	24326
20370	23572	141	156	852	0	24721
20371	664	24507	177	399	0	25747
20372	360	624	159	25074	0	26217
20373	215	204	25323	812	0	26554
20374	25205	148	715	469	0	26537
20375	773	141	267	25582	0	26763
20376	413	99	200	26066	0	26778
20377	291	110	25299	996	0	26696
20378	256	110	25059	580	0	26005
20379	24481	105	855	468	0	25909
20380	797	24721	393	353	0	26264
20381	394	673	271	25027	0	26365
20382	25070	255	241	895	0	26461
20383	814	167	25003	509	0	26493
20384	335	24748	808	393	0	26284
20385	358	691	359	24838	0	26246
20386	25264	255	263	986	0	26768
20387	24213	178	223	606	0	25220
20388	25261	139	214	495	0	26109
20389	989	24632	249	407	0	26277
20390	440	706	24832	362	0	26340
20391	433	274	786	25044	0	26537
20392	489	248	386	21328	0	22451
20393	378	168	254	25680	0	26480
20394	311	154	259	25920	0	26644
20395	25191	157	236	1185	0	26769
20396	25050	195	225	665	0	26135
20397	1021	153	24389	524	0	26087
20398	510	150	24220	476	0	25356
20399	23689	122	928	481	0	25220
20400	24507	149	414	435	0	25505
20401	1078	158	325	23176	0	24737
20402	545	23672	314	920	0	25451
20403	23692	712	302	559	0	25265
20404	960	23194	292	461	0	24907
20405	485	23347	246	462	0	24540
20406	487	846	229	24119	0	25681
20407	420	344	221	24889	0	25874
20408	380	250	249	24849	0	25728
20409	351	232	250	25030	0	25863
20410	378	208	23845	1204	0	25635
20411	23373	214	810	635	0	25032
20412	24546	156	378	543	0	25623
20413	1112	194	253	23892	0	25451
20414	563	225	247	24246	0	25281
20415	23826	200	261	1147	0	25434
20416	985	205	21708	662	0	23560
20417	23419	172	719	516	0	24826
20418	23619	210	314	524	0	24667
20419	1062	168	22962	482	0	24674
20420	23674	178	772	455	0	25079
20421	1057	142	377	23881	0	25457
20422	558	129	337	24454	0	25478
20423	493	128	278	24536	0	25435
20424	513	127	239	24366	0	25245
20425	22684	121	185	1143	0	24133
20426	938	142	218	22310	0	23608
20427	445	110	181	20503	0	21239
20428	329	18748	166	901	0	20144
20429	287	19462	162	511	0	20422
20430	322	489	125	19091	0	20027
20431	18804	201	127	720	0	19852
20432	637	164	99	17573	0	18473
20433	281	99	16109	517	0	17006
20434	230	92	14967	290	0	15579
20435	14958	75	380	296	0	15709
20436	448	15369	188	229	0	16234
20437	14275	264	230	196	0	14965
20438	415	125	14141	133	0	14814
20439	371	365	293	12980	0	14009
20440	13006	66	141	303	0	13516
20441	276	12861	98	173	0	13408
20442	12635	192	91	172	0	13090
20443	325	81	13571	127	0	14104
20444	191	90	187	13345	0	13813
20445	132	57	103	13811	0	14103
20446	13981	59	89	332	0	14461
20447	13937	41	88	230	0	14296
20448	14389	37	49	174	0	14649
20449	14335	41	42	183	0	14601
20450	14495	43	50	154	0	14742
20451	353	14304	51	104	0	14812
20452	222	170	41	14610	0	15043
20453	14894	97	35	273	0	15299
20454	298	60	36	14838	0	15232
20455	196	38	38	14844	0	15116
20456	158	35	30	14902	0	15125
20457	126	14372	30	297	0	14825
20458	14516	172	37	210	0	14935
20459	215	102	47	14518	0	14882
20460	14028	44	41	296	0	14409
20461	13712	24	25	210	0	13971
20462	265	13472	34	144	0	13915
20463	13469	138	25	144	0	13776
20464	270	67	13085	84	0	13506
20465	12810	52	165	90	0	13117
20466	257	101	129	12969	0	13456
20467	146	42	13315	163	0	13666
20468	130	13194	132	111	0	13567
20469	114	123	13225	80	0	13542
20470	55	12491	97	64	0	12707
20471	11927	72	101	83	0	12183
20472	11881	13	26	65	0	11985
20473	11696	6	5	46	0	11753
20474	38	11638	11	26	0	11713
20475	11478	24	6	32	0	11540
20476	38	10	11360	10	0	11418
20477	21	21	11275	8	0	11325
20478	43	28	21	11347	0	11439
20479	25	6	6	12177	0	12214
20480	9	12184	6	55	0	12254
20481	12413	42	1	44	0	12500
20482	67	4	1	12618	0	12690
20483	9	12378	8	68	0	12463
20484	14	54	4	12748	0	12820
20485	12689	5	4	99	0	12797
20486	12196	6	4	43	0	12249
20487	66	11	11877	8	0	11962
20488	34	4	51	12076	0	12165
20489	15	18	12091	59	0	12183
20490	17	16	53	12101	0	12187
20491	14	11	12127	74	0	12226
20492	23	7	64	12058	0	12152
20493	13	12	12152	73	0	12250
20494	27	10	67	12105	0	12209
20495	23	13	12330	80	0	12446
20496	37	13	75	12072	0	12197
20497	24	9	22	12548	0	12603
20498	13	12629	23	86	0	12751
20499	37	68	13	13183	0	13301
20500	18	24	12998	87	0	13127
20501	35	9	77	12879	0	13000
20502	18	12	31	12977	0	13038
20503	12969	7	23	155	0	13154
20504	90	7	21	13181	0	13299
20505	36	11	16	13103	0	13166
20506	22	13	12710	107	0	12852
20507	12305	7	93	93	0	12498
20508	78	10	29	13103	0	13220
20509	43	8	26	13131	0	13208
20510	41	9	16	13305	0	13371
20511	13281	8	18	176	0	13483
20512	96	11	17	13428	0	13552
20513	38	2	29	13479	0	13548
20514	13297	9	21	186	0	13513
20515	87	13302	23	70	0	13482
20516	40	81	14	13291	0	13426
20517	37	22	19	13411	0	13489
20518	22	22	13038	148	0	13230
20519	11084	10	112	133	0	11339
20520	110	18	31	12785	0	12944
20521	43	16	12335	143	0	12537
20522	12398	14	89	119	0	12620
20523	120	10	24	13163	0	13317
20524	49	14	20	13817	0	13900
20525	39	12	26	13959	0	14036
20526	45	11	15	14321	0	14392
20527	37	10	15529	223	0	15799
20528	57	15	211	15700	0	15983
20529	70	6	54	19505	0	19635
20530	35	13	22001	463	0	22512
20531	22662	9	504	235	0	23410
20532	23914	9	202	250	0	24375
20533	24253	6	178	173	0	24610
20534	975	13	131	23620	0	24739
20535	24095	7	90	658	0	24850
20536	24611	5	45	349	0	25010
20537	1051	12	52	24314	0	25429
20538	24472	5	47	818	0	25342
20539	24809	12	34	436	0	25291
20540	24955	7	40	376	0	25378
20541	25296	11	47	282	0	25636
20542	1215	20	30	24076	0	25341
20543	698	22919	51	690	0	24358
20544	533	23230	76	327	0	24166
20545	425	23874	65	272	0	24636
20546	23161	889	33	281	0	24364
20547	24016	451	48	227	0	24742
20548	1001	365	22948	185	0	24499
20549	23665	229	594	201	0	24689
20550	1170	163	222	23866	0	25421
20551	655	109	205	24166	0	25135
20552	607	82	145	24545	0	25379
20553	23903	42	98	1143	0	25186
20554	974	48	82	23846	0	24950
20555	538	23187	71	1052	0	24848
20556	490	612	38	24021	0	25161
20557	356	274	24129	1039	0	25798
20558	346	276	620	24446	0	25688
20559	24440	228	239	1093	0	26000
20560	969	185	24376	490	0	26020
20561	546	109	723	24489	0	25867
20562	504	115	350	24602	0	25571
20563	464	72	276	24884	0	25696
20564	333	24783	194	1159	0	26469
20565	317	655	141	25361	0	26474
20566	25102	258	93	1240	0	26693
20567	25030	230	94	734	0	26088
20568	1075	177	24211	567	0	26030
20569	581	189	24531	454	0	25755
20570	562	122	846	24467	0	25997
20571	449	87	463	25413	0	26412
20572	324	105	25258	1130	0	26817
20573	364	78	876	23888	0	25206
20574	262	24376	465	1013	0	26116
20575	25602	698	338	704	0	27342
20576	25854	286	246	606	0	26992
20577	25633	234	194	510	0	26571
20578	1268	195	25242	406	0	27111
20579	771	183	766	25517	0	27237
20580	635	104	25288	949	0	26976
20581	24576	104	870	515	0	26065
20582	1012	24847	470	482	0	26811
20583	577	658	382	25054	0	26671
20584	25278	276	273	976	0	26803
20585	980	255	226	25268	0	26729
20586	548	187	204	26049	0	26988
20587	466	159	25002	1210	0	26837
20588	23859	151	734	821	0	25565
20589	1006	24901	363	588	0	26858
20590	642	632	279	25417	0	26970
20591	25487	288	234	1005	0	27014
20592	1106	245	221	25485	0	27057
20593	25310	195	192	1157	0	26854
20594	1123	25080	163	685	0	27051
20595	25782	733	135	595	0	27245
20596	1281	377	25600	399	0	27657
20597	25848	288	769	450	0	27355
20598	26343	224	342	387	0	27296
20599	26604	202	320	360	0	27486
20600	1512	146	244	25491	0	27393
20601	1051	187	224	23813	0	25275
20602	832	149	178	25614	0	26773
20603	594	24715	149	1262	0	26720
20604	25439	737	150	846	0	27172
20605	1139	311	119	25509	0	27078
20606	664	319	129	25791	0	26903
20607	608	206	128	25956	0	26898
20608	25039	222	137	1439	0	26837
20609	1098	159	120	25417	0	26794
20610	656	150	24314	1329	0	26449
20611	525	24575	727	836	0	26663
20612	520	720	309	25256	0	26805
20613	484	401	261	25734	0	26880
20614	390	304	216	26189	0	27099
20615	359	229	24799	1454	0	26841
20616	340	181	24798	955	0	26274
20617	347	155	999	25433	0	26934
20618	325	167	25782	1225	0	27499
20619	356	97	975	26303	0	27731
20620	25951	114	494	1422	0	27981
20621	26891	114	390	908	0	28303
20622	26768	111	245	799	0	27923
20623	1345	120	25557	551	0	27573
20624	25009	114	756	527	0	26406
20625	1349	177	422	25295	0	27243
20626	714	99	24971	992	0	26776
20627	625	90	23677	566	0	24958
20628	434	22939	937	615	0	24925
20629	266	20140	367	333	0	21106
20630	17022	382	647	198	0	18249
20631	383	106	87	16510	0	17086
20632	125	64	16660	311	0	17160
20633	105	32	256	16879	0	17272
20634	16972	34	105	371	0	17482
20635	305	47	18021	135	0	18508
20636	17804	26	291	185	0	18306
20637	18969	26	101	136	0	19232
20638	18725	19	76	157	0	18977
20639	421	18380	62	95	0	18958
20640	18908	288	52	130	0	19378
20641	440	81	49	18966	0	19536
20642	220	70	67	18774	0	19131
20643	161	44	48	19151	0	19404
20644	141	29	45	19028	0	19243
20645	18434	24	38	466	0	18962
20646	344	18049	37	207	0	18637
20647	128	17490	42	119	0	17779
20648	99	18010	36	116	0	18261
20649	17983	321	66	150	0	18520
20650	17973	102	58	131	0	18264
20651	17909	77	28	120	0	18134
20652	17895	51	37	106	0	18089
20653	456	38	36	17728	0	18258
20654	208	38	25	17885	0	18156
20655	17758	33	38	404	0	18233
20656	313	17680	42	174	0	18209
20657	17154	260	25	177	0	17616
20658	17405	75	34	151	0	17665
20659	398	63	36	17118	0	17615
20660	181	17157	33	320	0	17691
20661	166	281	28	17586	0	18061
20662	17308	91	31	390	0	17820
20663	340	93	17494	131	0	18058
20664	198	50	250	16741	0	17239
20665	126	17260	70	285	0	17741
20666	17286	254	68	160	0	17768
20667	17023	78	29	163	0	17293
20668	369	82	17145	95	0	17691
20669	187	16825	253	65	0	17330
20670	141	271	17066	55	0	17533
20671	133	103	261	16477	0	16974
20672	102	71	16328	261	0	16762
20673	89	48	16128	109	0	16374
20674	82	16068	248	88	0	16486
20675	15977	221	104	100	0	16402
20676	16053	68	71	119	0	16311
20677	280	16393	52	69	0	16794
20678	116	16382	45	73	0	16616
20679	107	275	15432	57	0	15871
20680	116	118	15076	45	0	15355
20681	101	83	15693	45	0	15922
20682	102	67	290	15641	0	16100
20683	80	60	15934	239	0	16313
20684	109	45	256	15372	0	15782
20685	114	34	123	15114	0	15385
20686	73	43	15655	302	0	16073
20687	63	15505	262	122	0	15952
20688	95	224	101	15565	0	15985
20689	15570	90	66	280	0	16006
20690	291	67	51	15571	0	15980
20691	133	73	15608	272	0	16086
20692	94	15447	229	125	0	15895
20693	88	16469	100	96	0	16753
20694	88	306	91	16150	0	16635
20695	16093	116	80	311	0	16600
20696	15988	96	68	159	0	16311
20697	386	66	61	15847	0	16360
20698	180	16908	66	303	0	17457
20699	157	321	49	17080	0	17607
20700	138	134	52	17684	0	18008
20701	133	100	59	17771	0	18063
20702	18263	72	47	555	0	18937
20703	431	18377	64	232	0	19104
20704	18522	383	56	222	0	19183
20705	18917	143	53	168	0	19281
20706	18900	112	53	165	0	19230
20707	19426	85	41	162	0	19714
20708	636	88	43	18930	0	19697
20709	284	88	19034	457	0	19863
20710	199	19126	379	207	0	19911
20711	19356	390	150	192	0	20088
20712	19772	176	90	173	0	20211
20713	19966	117	57	155	0	20295
20714	643	77	19297	113	0	20130
20715	19071	86	413	160	0	19730
20716	19776	69	157	122	0	20124
20717	685	97	80	19369	0	20231
20718	315	72	18744	435	0	19566
20719	247	18439	394	185	0	19265
20720	245	418	160	18497	0	19320
20721	18415	157	134	464	0	19170
20722	520	103	86	18301	0	19010
20723	262	68	84	19093	0	19507
20724	19333	70	82	594	0	20079
20725	552	84	18968	248	0	19852
20726	19041	68	444	208	0	19761
20727	19243	67	190	151	0	19651
20728	19274	85	112	166	0	19637
20729	19319	52	77	156	0	19604
20730	736	59	18563	116	0	19474
20731	385	62	461	18241	0	19149
20732	218	65	18591	493	0	19367
20733	240	102	470	18131	0	18943
20734	173	47	18387	497	0	19104
20735	16494	51	461	283	0	17289
20736	526	16290	186	134	0	17136
20737	253	17127	101	86	0	17567
20738	253	484	77	18395	0	19209
20739	239	185	94	18924	0	19442
20740	150	19778	80	645	0	20653
20741	20018	542	70	311	0	20941
20742	21108	213	68	188	0	21577
20743	21916	108	71	131	0	22226
20744	22801	72	65	134	0	23072
20745	1025	55	58	22090	0	23228
20746	496	54	67	23025	0	23642
20747	22953	54	66	966	0	24039
20748	834	44	71	22906	0	23855
20749	427	63	22127	800	0	23417
20750	286	81	22490	365	0	23222
20751	283	62	856	22569	0	23770
20752	203	74	22708	758	0	23743
20753	22331	46	761	443	0	23581
20754	851	54	327	22556	0	23788
20755	22805	62	198	805	0	23870
20756	909	52	22846	419	0	24226
20757	536	65	720	22805	0	24126
20758	337	60	23335	811	0	24543
20759	249	23121	812	423	0	24605
20760	22966	695	362	348	0	24371
20761	23444	289	198	287	0	24218
20762	1057	22861	139	251	0	24308
20763	22945	699	135	270	0	24049
20764	1022	294	135	22476	0	23927
20765	556	162	133	23124	0	23975
20766	22599	85	139	1051	0	23874
20767	924	21822	156	494	0	23396
20768	530	22585	117	328	0	23560
20769	438	902	122	22262	0	23724
20770	22150	380	121	848	0	23499
20771	22720	200	147	457	0	23524
20772	22843	137	131	343	0	23454
20773	1267	135	21861	205	0	23468
20774	670	140	21713	222	0	22745
20775	459	21688	950	222	0	23319
20776	21984	761	420	248	0	23413
20777	1090	344	232	21455	0	23121
20778	21836	210	166	892	0	23104
20779	22234	142	156	469	0	23001
20780	1296	129	184	21410	0	23019
20781	696	138	21233	921	0	22988
20782	21461	137	784	525	0	22907
20783	1096	137	346	21407	0	22986
20784	625	115	21500	936	0	23176
20785	21411	135	775	526	0	22847
20786	22148	125	387	394	0	23054
20787	1270	95	294	21463	0	23122
20788	709	97	21480	944	0	23230
20789	553	137	820	20809	0	22319
20790	436	21522	429	909	0	23296
20791	479	731	21499	442	0	23151
20792	453	21849	804	378	0	23484
20793	21541	780	378	301	0	23000
20794	21947	312	302	319	0	22880
20795	21855	197	215	329	0	22596
20796	21815	131	216	303	0	22465
20797	1339	146	174	20575	0	22234
20798	19943	111	212	792	0	21058
20799	1072	122	173	19523	0	20890
20800	19062	85	165	878	0	20190
20801	930	18482	197	493	0	20102
20802	549	553	155	17417	0	18674
20803	417	17949	130	672	0	19168
20804	18067	603	126	448	0	19244
20805	18205	294	167	275	0	18941
20806	945	17558	149	251	0	18903
20807	549	603	147	17350	0	18649
20808	378	285	17165	634	0	18462
20809	389	250	583	16953	0	18175
20810	385	155	16964	687	0	18191
20811	396	173	621	15395	0	16585
20812	325	16226	304	611	0	17466
20813	16451	540	177	324	0	17492
20814	16784	242	115	319	0	17460
20815	897	164	121	16394	0	17576
20816	17089	128	109	694	0	18020
20817	856	147	99	17010	0	18112
20818	468	168	83	17407	0	18126
20819	385	123	112	17653	0	18273
20820	17265	140	83	872	0	18360
20821	17483	100	95	471	0	18149
20822	17557	98	109	321	0	18085
20823	907	16421	155	232	0	17715
20824	16308	474	128	242	0	17152
20825	726	15911	149	191	0	16977
20826	16181	550	104	228	0	17063
20827	768	255	120	15767	0	16910
20828	503	180	74	16233	0	16990
20829	15922	165	72	698	0	16857
20830	16087	126	72	417	0	16702
20831	837	15586	104	232	0	16759
20832	15760	466	64	255	0	16545
20833	804	193	62	15179	0	16238
20834	447	132	86	15436	0	16101
20835	15122	78	50	743	0	15993
20836	693	83	14676	389	0	15841
20837	418	13988	385	293	0	15084
20838	297	340	146	12263	0	13046
20839	177	123	11467	305	0	12072
20840	195	283	249	10656	0	11383
20841	10727	49	132	326	0	11234
20842	280	9867	82	161	0	10390
20843	126	9128	53	122	0	9429
20844	92	8667	38	76	0	8873
20845	222	210	115	8324	0	8871
20846	8242	45	183	169	0	8639
20847	165	44	9	8201	0	8419
20848	8204	28	12	163	0	8407
20849	8270	24	11	74	0	8379
20850	167	25	12	8259	0	8463
20851	8348	17	19	148	0	8532
20852	168	18	15	8409	0	8610
20853	78	23	8483	140	0	8724
20854	8395	23	111	91	0	8620
20855	153	19	9110	56	0	9338
20856	8450	10	109	49	0	8618
20857	136	10	8691	44	0	8881
20858	70	11	79	8164	0	8324
20859	39	21	23	8369	0	8452
20860	8507	17	11	126	0	8661
20861	114	11	14	8804	0	8943
20862	8826	15	7	131	0	8979
20863	110	8851	12	36	0	9009
20864	9207	86	5	63	0	9361
20865	129	20	8	9552	0	9709
20866	65	15	7	9627	0	9714
20867	47	12	10	9725	0	9794
20868	61	14	10	9721	0	9806
20869	33	14	9476	123	0	9646
20870	27	16	9201	47	0	9291
20871	39	9	98	9499	0	9645
20872	28	12	9651	108	0	9799
20873	28	9560	100	49	0	9737
20874	36	95	29	9615	0	9775
20875	30	23	9934	114	0	10101
20876	29	17	9605	37	0	9688
20877	46	20	114	9938	0	10118
20878	40	10	38	10040	0	10128
20879	24	10206	22	132	0	10384
20880	37	110	12	10372	0	10531
20881	29	21	10518	132	0	10700
20882	10198	9	131	77	0	10415
20883	152	14	38	10693	0	10897
20884	10695	8	28	180	0	10911
20885	10733	15	26	74	0	10848
20886	10895	10	19	83	0	11007
20887	153	14	11071	52	0	11290
20888	54	11	10938	39	0	11042
20889	10015	9	159	93	0	10276
20890	158	17	11254	38	0	11467
20891	69	13	145	10709	0	10936
20892	48	10	42	11008	0	11108
20893	47	11	11098	159	0	11315
20894	37	11013	156	53	0	11259
20895	10958	123	60	82	0	11223
20896	137	11027	53	49	0	11266
20897	50	11462	42	46	0	11600
20898	11456	142	38	88	0	11724
20899	161	35	11833	59	0	12088
20900	40	31	11890	45	0	12006
20901	84	18	183	11597	0	11882
20902	11851	25	66	188	0	12130
20903	171	11944	51	61	0	12227
20904	11997	155	39	79	0	12270
20905	176	44	12284	49	0	12553
20906	70	13103	177	34	0	13384
20907	66	179	71	13411	0	13727
20908	50	52	13835	196	0	14133
20909	57	41	200	13802	0	14100
20910	146	54	76	11536	0	11812
20911	82	36	48	14117	0	14283
20912	61	26	61	14141	0	14289
20913	13915	24	51	272	0	14262
20914	13786	31	47	101	0	13965
20915	236	30	13967	60	0	14293
20916	13173	31	203	90	0	13497
20917	205	13545	87	57	0	13894
20918	13596	179	56	70	0	13901
20919	214	55	13691	57	0	14017
20920	100	49	206	13464	0	13819
20921	58	32	13693	214	0	13997
20922	69	35	13719	84	0	13907
20923	67	45	249	13542	0	13903
20924	74	31	73	13816	0	13994
20925	49	40	13697	249	0	14035
20926	67	13242	203	105	0	13617
20927	56	13594	95	81	0	13826
20928	74	215	55	13718	0	14062
20929	13493	60	65	264	0	13882
20930	217	14188	60	110	0	14575
20931	96	194	14181	82	0	14553
20932	65	55	13819	82	0	14021
20933	70	46	14208	75	0	14399
20934	81	48	258	13894	0	14281
20935	14230	33	98	243	0	14604
20936	218	14081	88	109	0	14496
20937	96	191	13977	95	0	14359
20938	58	13883	252	70	0	14263
20939	49	208	133	14077	0	14467
20940	43	81	14187	244	0	14555
20941	51	14214	236	120	0	14621
20942	67	224	89	14099	0	14479
20943	77	87	66	14581	0	14811
20944	63	72	14833	242	0	15210
20945	73	55	254	14252	0	14634
20946	64	14599	115	223	0	15001
20947	59	222	14540	103	0	14924
20948	14154	78	234	97	0	14563
20949	235	58	104	14500	0	14897
20950	106	63	102	14303	0	14574
20951	50	14374	83	236	0	14743
20952	14185	192	78	113	0	14568
20953	199	85	13943	83	0	14310
20954	13396	58	212	91	0	13757
20955	199	67	85	13475	0	13826
20956	68	13623	70	202	0	13963
20957	56	165	69	13668	0	13958
20958	54	69	50	14052	0	14225
20959	13812	56	49	269	0	14186
20960	13920	49	46	118	0	14133
20961	234	24	66	13924	0	14248
20962	81	38	13800	223	0	14142
20963	12631	52	204	150	0	13037
20964	181	13849	82	85	0	14197
20965	105	200	57	13818	0	14180
20966	85	63	56	14125	0	14329
20967	77	34	45	14136	0	14292
20968	54	60	13951	254	0	14319
20969	70	55	218	13575	0	13918
20970	38	13833	97	237	0	14205
20971	85	195	56	13608	0	13944
20972	50	13719	51	223	0	14043
20973	63	220	45	13650	0	13978
20974	50	79	13552	244	0	13925
20975	12284	39	195	139	0	12657
20976	212	46	79	13377	0	13714
20977	72	36	13301	220	0	13629
20978	39	13246	183	111	0	13579
20979	13106	169	103	101	0	13479
20980	175	62	13031	85	0	13353
20981	12487	45	225	86	0	12843
20982	183	42	63	13036	0	13324
20983	87	36	52	13005	0	13180
20984	41	13089	39	190	0	13359
20985	13049	152	48	104	0	13353
20986	12737	53	43	93	0	12926
20987	189	13223	35	59	0	13506
20988	89	155	32	13373	0	13649
20989	54	70	40	13466	0	13630
20990	59	48	37	13190	0	13334
20991	45	33	12929	214	0	13221
20992	12373	31	167	130	0	12701
20993	187	35	65	12934	0	13221
20994	83	36	42	13052	0	13213
20995	38	45	12714	210	0	13007
20996	46	44	12393	102	0	12585
20997	60	37	193	12823	0	13113
20998	56	46	13065	183	0	13350
20999	12348	28	170	117	0	12663
21000	170	26	69	12775	0	13040
21001	85	31	41	12980	0	13137
21002	42	21	13347	234	0	13644
21003	72	39	165	13640	0	13916
21004	36	29	13860	196	0	14121
21005	47	13417	170	99	0	13733
21006	12467	137	121	105	0	12830
21007	12468	34	50	62	0	12614
21008	148	12217	30	54	0	12449
21009	65	127	23	12340	0	12555
21010	32	36	12488	143	0	12699
21011	44	23	129	12326	0	12522
21012	12333	15	44	183	0	12575
21013	129	12513	35	72	0	12749
21014	12568	125	28	57	0	12778
21015	146	42	21	12590	0	12799
21016	12572	24	25	174	0	12795
21017	139	12532	24	62	0	12757
21018	12536	119	17	75	0	12747
21019	147	48	12263	39	0	12497
21020	59	12449	122	46	0	12676
21021	58	123	52	12456	0	12689
21022	13048	37	36	168	0	13289
21023	13200	25	27	86	0	13338
21024	191	31	14	13218	0	13454
21025	13500	20	27	184	0	13731
21026	13431	27	21	92	0	13571
21027	13856	20	14	82	0	13972
21028	210	25	17	13922	0	14174
21029	86	22	13995	148	0	14251
21030	71	20	13063	70	0	13224
21031	51	19	13454	45	0	13569
21032	13693	21	171	55	0	13940
21033	188	18	55	13823	0	14084
21034	67	14128	44	158	0	14397
21035	73	150	28	14055	0	14306
21036	43	14441	28	152	0	14664
21037	14708	144	29	93	0	14974
21038	202	53	20	14901	0	15176
21039	87	28	17	15543	0	15675
21040	15651	23	34	258	0	15966
21041	216	20	27	15754	0	16017
21042	107	20	24	16119	0	16270
21043	16274	13	23	288	0	16598
21044	237	28	16616	107	0	16988
21045	119	17	210	16644	0	16990
21046	62	17	16773	249	0	17101
21047	16489	26	240	125	0	16880
21048	276	14	71	17015	0	17376
21049	17114	13	51	280	0	17458
21050	288	19	30	17332	0	17669
21051	101	24	17592	296	0	18013
21052	109	13	246	17657	0	18025
21053	18085	14	83	339	0	18521
21054	270	18430	56	128	0	18884
21055	119	237	18387	75	0	18818
21056	17297	69	255	97	0	17718
21057	283	18542	76	78	0	18979
21058	114	18885	54	76	0	19129
21059	87	20622	48	63	0	20820
21060	111	353	45	21603	0	22112
21061	21898	112	61	424	0	22495
21062	22294	60	49	165	0	22568
21063	499	59	21816	101	0	22475
21064	21299	44	355	119	0	21817
21065	460	21417	111	75	0	22063
21066	212	368	74	21677	0	22331
21067	22699	116	50	479	0	23344
21068	23069	71	46	182	0	23368
21069	23191	62	39	144	0	23436
21070	22952	68	60	119	0	23199
21071	23270	56	54	91	0	23471
21072	614	77	42	22952	0	23685
21073	251	78	22899	439	0	23667
21074	252	64	387	22954	0	23657
21075	241	68	119	23397	0	23825
21076	23168	58	73	560	0	23859
21077	566	22712	60	207	0	23545
21078	23121	388	55	188	0	23752
21079	23423	119	64	189	0	23795
21080	23914	84	83	187	0	24268
21081	24364	76	64	210	0	24714
21082	720	68	23447	150	0	24385
21083	23664	65	363	171	0	24263
21084	24333	76	123	178	0	24710
21085	20256	102	141	316	0	20815
21086	24352	47	65	156	0	24620
21087	762	50	71	23333	0	24216
21088	399	63	22810	484	0	23756
21089	22604	43	437	245	0	23329
21090	656	22950	143	183	0	23932
21091	447	371	110	22351	0	23279
21092	348	23135	89	450	0	24022
21093	335	432	85	23618	0	24470
21094	23799	147	80	569	0	24595
21095	23972	97	102	231	0	24402
21096	23991	78	92	183	0	24344
21097	759	100	22239	138	0	23236
21098	22415	73	393	178	0	23059
21099	685	107	21960	130	0	22882
21100	409	93	21780	144	0	22426
21101	390	83	22473	128	0	23074
21102	428	168	507	20556	0	21659
21103	345	78	212	21861	0	22496
21104	307	89	161	21767	0	22324
21105	331	73	115	21667	0	22186
21106	338	100	135	20634	0	21207
21107	302	72	134	21437	0	21945
21108	271	21525	134	546	0	22476
21109	21300	385	101	342	0	22128
21110	548	21584	118	242	0	22492
21111	341	415	117	21707	0	22580
21112	328	157	111	22088	0	22684
21113	21612	114	128	635	0	22489
21114	572	21492	119	315	0	22498
21115	21687	404	126	292	0	22509
21116	641	160	122	21621	0	22544
21117	370	130	133	21716	0	22349
21118	308	108	117	21868	0	22401
21119	264	124	21348	670	0	22406
21120	289	146	400	21302	0	22137
21121	268	134	20955	633	0	21990
21122	283	114	20436	350	0	21183
21123	319	79	21689	316	0	22403
21124	331	101	522	21803	0	22757
21125	309	99	219	22479	0	23106
21126	301	125	164	22831	0	23421
21127	22565	112	132	781	0	23590
21128	629	140	138	23098	0	24005
21129	23233	95	154	753	0	24235
21130	701	23001	132	398	0	24232
21131	23910	465	106	374	0	24855
21132	24783	177	122	387	0	25469
21133	804	25239	155	297	0	26495
21134	25321	488	132	376	0	26317
21135	25183	188	169	367	0	25907
21136	25808	105	154	390	0	26457
21137	25741	119	196	308	0	26364
21138	926	118	24900	239	0	26183
21139	500	24377	539	218	0	25634
21140	450	558	199	23931	0	25138
21141	24072	169	187	653	0	25081
21142	751	100	23946	318	0	25115
21143	431	23352	501	252	0	24536
21144	378	454	193	22078	0	23103
21145	351	23072	130	522	0	24075
21146	364	554	88	23046	0	24052
21147	374	242	92	23364	0	24072
21148	369	152	23085	628	0	24234
21149	343	151	22734	274	0	23502
21150	21441	157	547	267	0	22412
21151	669	143	22913	191	0	23916
21152	370	169	22717	164	0	23420
21153	376	147	562	22134	0	23219
21154	338	126	252	22055	0	22771
21155	272	22049	222	580	0	23123
21156	261	23615	188	327	0	24391
21157	242	536	23303	230	0	24311
21158	340	351	578	23109	0	24378
21159	159	118	22505	538	0	23320
21160	102	68	20619	186	0	20975
21161	93	20499	493	114	0	21199
21162	173	386	251	20144	0	20954
21163	20276	121	148	415	0	20960
21164	412	89	109	20407	0	21017
21165	20437	61	90	470	0	21058
21166	20433	54	91	228	0	20806
21167	20114	66	92	177	0	20449
21168	496	73	19746	103	0	20418
21169	19737	54	371	137	0	20299
21170	469	53	166	20125	0	20813
21171	20192	49	122	446	0	20809
21172	20204	50	111	213	0	20578
21173	484	19872	109	135	0	20600
21174	20001	336	93	138	0	20568
21175	454	142	19982	94	0	20672
21176	19443	76	388	146	0	20053
21177	19722	66	147	162	0	20097
21178	512	19885	108	80	0	20585
21179	19885	359	91	127	0	20462
21180	505	155	88	18856	0	19604
21181	276	73	84	18746	0	19179
21182	190	18743	81	435	0	19449
21183	210	338	82	19023	0	19653
21184	251	126	84	19199	0	19660
21185	165	107	18882	468	0	19622
21186	173	81	18456	234	0	18944
21187	18076	66	446	185	0	18773
21188	19014	57	164	176	0	19411
21189	585	50	120	19067	0	19822
21190	299	79	19065	394	0	19837
21191	241	18994	416	164	0	19815
21192	225	390	183	18943	0	19741
21193	191	150	19143	433	0	19917
21194	18358	93	433	278	0	19162
21195	531	101	149	19525	0	20306
21196	250	19821	142	482	0	20695
21197	229	443	127	20031	0	20830
21198	224	161	125	20386	0	20896
21199	221	97	126	20592	0	21036
21200	20070	99	118	677	0	20964
21201	587	94	89	19963	0	20733
21202	20202	91	123	633	0	21049
21203	20503	105	90	309	0	21007
21204	692	77	20069	232	0	21070
21205	326	20129	503	195	0	21153
21206	350	481	185	18039	0	19055
21207	193	21044	154	445	0	21836
21208	21289	554	127	294	0	22264
21209	638	205	134	21333	0	22310
21210	285	167	21234	622	0	22308
21211	282	98	20969	307	0	21656
21212	219	114	21191	225	0	21749
21213	20859	106	666	262	0	21893
21214	626	21301	281	235	0	22443
21215	21241	561	200	218	0	22220
21216	659	21471	152	209	0	22491
21217	347	581	170	21235	0	22333
21218	308	230	149	21077	0	21764
21219	267	21439	131	658	0	22495
21220	234	590	21369	366	0	22559
21221	192	21783	584	257	0	22816
21222	20846	586	232	246	0	21910
21223	612	227	174	20043	0	21056
21224	254	174	19602	556	0	20586
21225	244	141	19597	247	0	20229
21226	247	171	595	19278	0	20291
21227	238	129	19080	493	0	19940
21228	162	124	18273	242	0	18801
21229	17070	106	567	223	0	17966
21230	461	17678	263	168	0	18570
21231	16990	429	161	185	0	17765
21232	519	187	16929	125	0	17760
21233	228	15731	468	116	0	16543
21234	182	16379	231	125	0	16917
21235	217	574	229	16002	0	17022
21236	156	222	146	16357	0	16881
21237	164	140	126	16633	0	17063
21238	133	147	16405	591	0	17276
21239	168	103	454	16514	0	17239
21240	155	106	187	17028	0	17476
21241	16689	110	166	620	0	17585
21242	464	16506	141	332	0	17443
21243	224	446	129	16922	0	17721
21244	16859	198	136	542	0	17735
21245	16791	160	139	280	0	17370
21246	650	134	107	16535	0	17426
21247	262	139	16612	541	0	17554
21248	239	107	450	16681	0	17477
21249	144	119	16656	579	0	17498
21250	17447	82	543	332	0	18404
21251	19464	88	249	266	0	20067
21252	759	124	205	20008	0	21096
21253	294	104	20227	693	0	21318
21254	213	20738	649	297	0	21897
21255	165	648	21099	238	0	22150
21256	243	375	675	18265	0	19558
21257	158	19754	230	557	0	20699
21258	19018	547	137	218	0	19920
21259	623	177	85	18305	0	19190
21260	194	18805	137	597	0	19733
21261	19133	585	103	240	0	20061
21262	627	186	130	18756	0	19699
21263	221	18975	110	618	0	19924
21264	225	592	88	19139	0	20044
21265	147	212	18960	677	0	19996
21266	18268	126	589	315	0	19298
21267	18939	121	205	220	0	19485
21268	725	109	18462	147	0	19443
21269	277	18496	553	176	0	19502
21270	18696	569	229	168	0	19662
21271	629	216	152	18575	0	19572
21272	300	140	151	18581	0	19172
21273	249	102	89	19026	0	19466
21274	216	135	112	19045	0	19508
21275	199	84	105	19142	0	19530
21276	18502	135	98	827	0	19562
21277	19029	114	88	353	0	19584
21278	759	81	96	18593	0	19529
21279	316	68	121	19072	0	19577
21280	203	107	18412	790	0	19512
21281	154	92	18467	371	0	19084
21282	18089	92	688	270	0	19139
21283	737	105	247	18249	0	19338
21284	300	94	18061	684	0	19139
21285	221	72	593	18257	0	19143
21286	18191	88	218	809	0	19306
21287	18932	65	207	354	0	19558
21288	760	72	139	18528	0	19499
21289	382	58	125	18743	0	19308
21290	18667	57	101	861	0	19686
21291	673	64	136	18514	0	19387
21292	295	18648	110	726	0	19779
21293	306	516	94	18754	0	19670
21294	255	174	97	19100	0	19626
21295	160	101	18478	796	0	19535
21296	156	70	18067	403	0	18696
21297	171	18449	597	280	0	19497
21298	18246	475	269	284	0	19274
21299	18169	186	131	248	0	18734
21300	18407	95	108	266	0	18876
21301	718	17565	134	236	0	18653
21302	301	18168	147	212	0	18828
21303	17750	594	121	234	0	18699
21304	562	18351	130	193	0	19236
21305	287	528	17842	216	0	18873
21306	209	18128	488	231	0	19056
21307	190	524	17635	193	0	18542
21308	16936	231	474	227	0	17868
21309	17763	174	183	204	0	18324
21310	626	17589	121	178	0	18514
21311	18062	504	99	201	0	18866
21312	19140	229	123	177	0	19669
21313	19404	164	102	196	0	19866
21314	784	129	126	18925	0	19964
21315	19248	138	91	571	0	20048
21316	707	137	18464	276	0	19584
21317	18976	136	460	241	0	19813
21318	733	124	227	19277	0	20361
21319	414	109	19175	546	0	20244
21320	326	117	19339	295	0	20077
21321	299	132	589	19408	0	20428
21322	293	85	280	20042	0	20700
21323	19900	106	197	740	0	20943
21324	646	103	135	19935	0	20819
21325	363	98	19635	716	0	20812
21326	324	70	495	19275	0	20164
21327	249	20053	242	664	0	21208
21328	20461	434	163	422	0	21480
21329	637	189	163	20515	0	21504
21330	366	129	20184	618	0	21297
21331	277	20018	494	361	0	21150
21332	19642	418	244	301	0	20605
21333	606	175	206	20067	0	21054
21334	317	137	20203	572	0	21229
21335	272	19907	474	350	0	21003
21336	20009	466	258	326	0	21059
21337	19950	160	178	256	0	20544
21338	20098	124	153	250	0	20625
21339	737	91	111	19606	0	20545
21340	412	86	96	19944	0	20538
21341	19592	73	118	640	0	20423
21342	539	19282	109	375	0	20305
21343	19651	395	98	311	0	20455
21344	542	198	116	19575	0	20431
21345	20060	136	93	545	0	20834
21346	572	114	93	20015	0	20794
21347	369	89	101	20063	0	20622
21348	312	91	105	20252	0	20760
21349	392	127	103	20250	0	20872
21350	223	82	18340	566	0	19211
21351	162	88	16514	282	0	17046
21352	14621	33	257	216	0	15127
21353	263	54	15827	135	0	16279
21354	157	37	14317	94	0	14605
21355	14064	40	278	107	0	14489
21356	14631	35	181	94	0	14941
21357	261	44	115	15644	0	16064
21358	15820	26	91	217	0	16154
21359	237	16056	56	131	0	16480
21360	16535	125	36	124	0	16820
21361	16311	82	48	111	0	16552
21362	17140	50	53	138	0	17381
21363	288	65	42	17155	0	17550
21364	216	16687	41	160	0	17104
21365	165	17120	52	126	0	17463
21366	17333	160	61	141	0	17695
21367	17356	120	48	112	0	17636
21368	245	93	43	17301	0	17682
21369	184	55	45	17163	0	17447
21370	141	17104	57	235	0	17537
21371	17106	126	37	194	0	17463
21372	198	94	17099	118	0	17509
21373	166	78	109	16752	0	17105
21374	162	46	84	17074	0	17366
21375	109	36	17195	217	0	17557
21376	117	25	143	16952	0	17237
21377	137	11736	152	243	0	12268
21378	105	131	56	17406	0	17698
21379	101	86	55	17218	0	17460
21380	97	15493	54	217	0	15861
21381	94	17258	32	159	0	17543
21382	81	157	25	17377	0	17640
21383	17330	113	41	201	0	17685
21384	142	93	35	17351	0	17621
21385	139	60	29	17460	0	17688
21386	85	17691	54	218	0	18048
21387	109	112	38	18314	0	18573
21388	102	89	39	18233	0	18463
21389	85	73	46	18320	0	18524
21390	17936	57	44	287	0	18324
21391	153	48	46	18031	0	18278
21392	149	43	23	17738	0	17953
21393	118	41	27	17828	0	18014
21394	92	52	17108	254	0	17506
21395	15061	52	107	253	0	15473
21396	169	16760	73	165	0	17167
21397	17006	103	50	139	0	17298
21398	194	84	50	17003	0	17331
21399	144	75	16627	155	0	17001
21400	15212	66	100	184	0	15562
21401	183	46	18976	119	0	19324
21402	152	48	122	19088	0	19410
21403	19869	34	102	198	0	20203
21404	19382	32	64	155	0	19633
21405	19794	35	42	144	0	20015
21406	235	35	24	19878	0	20172
21407	183	21	31	20039	0	20274
21408	142	43	30	20107	0	20322
21409	90	18905	21	241	0	19257
21410	44	18909	25	184	0	19162
21411	63	18659	22	132	0	18876
21412	24	18406	18	18	0	18466
21413	37	39	15	19072	0	19163
21414	18	16	6	19251	0	19291
21415	19105	8	5	101	0	19219
21416	18738	2	12	75	0	18827
21417	19027	6	7	59	0	19099
21418	61	12	3	18830	0	18906
21419	38	7	6	18986	0	19037
21420	18449	11	6	97	0	18563
21421	18026	17	18	70	0	18131
21422	55	12	18140	31	0	18238
21423	51	16	17281	30	0	17378
21424	39	15	17695	27	0	17776
21425	32	17	18677	21	0	18747
21426	36	9	42	18635	0	18722
21427	18535	13	13	74	0	18635
21428	49	18275	10	57	0	18391
21429	31	49	0	18876	0	18956
21430	23	25	18882	60	0	18990
21431	19	19562	42	30	0	19653
21432	21	34	11	20067	0	20133
21433	27	20	19757	53	0	19857
21434	41	18	39	19210	0	19308
21435	44	9	18	19586	0	19657
21436	19880	9	15	89	0	19993
21437	49	12	4	20096	0	20161
21438	27	13	20331	53	0	20424
21439	43	10	38	20036	0	20127
21440	21	21498	22	62	0	21603
21441	34	39	21	22750	0	22844
21442	19	12	17	23073	0	23121
21443	29	18	12	22931	0	22990
21444	23283	8	11	118	0	23420
21445	23025	1	10	90	0	23126
21446	23256	11	12	88	0	23367
21447	23195	8	3	99	0	23305
21448	65	17	22866	29	0	22977
21449	22207	9	42	72	0	22330
21450	23056	8	11	70	0	23145
21451	68	19	22580	20	0	22687
21452	42	9	23587	19	0	23657
21453	39	5	48	23775	0	23867
21454	13	23978	28	49	0	24068
21455	24549	40	24	95	0	24708
21456	24842	25	7	80	0	24954
21457	24260	6	7	70	0	24343
21458	84	5	6	24103	0	24198
21459	31	24518	18	52	0	24619
21460	25530	40	9	105	0	25684
21461	25755	17	9	111	0	25892
21462	73	24	6	25230	0	25333
21463	56	21	24862	50	0	24989
21464	24701	6	48	84	0	24839
21465	70	8	23	25875	0	25976
21466	26252	3	10	125	0	26390
21467	71	12	6	26626	0	26715
21468	49	17	26469	57	0	26592
21469	27768	2	48	119	0	27937
21470	78	6	24	28645	0	28753
21471	75	4	16	28675	0	28770
21472	47	11	6	28963	0	29027
21473	37	3	5	28946	0	28991
21474	29231	3	9	146	0	29389
21475	72	5	6	29111	0	29194
21476	34	28906	25	84	0	29049
21477	36	73	8	29587	0	29704
21478	11	29473	14	96	0	29594
21479	38	89	7	30102	0	30236
21480	43	23	5	30302	0	30373
21481	15	30082	19	114	0	30230
21482	35	70	8	30768	0	30881
21483	21	29	6	30809	0	30865
21484	30659	24	3	205	0	30891
21485	126	17	31186	78	0	31407
21486	71	7	119	31227	0	31424
21487	31491	5	33	244	0	31773
21488	31363	4	16	128	0	31511
21489	31517	15	5	117	0	31654
21490	216	19	31444	30	0	31709
21491	86	25	31322	35	0	31468
21492	103	21	211	32244	0	32579
21493	32925	5	74	292	0	33296
21494	207	23	32474	73	0	32777
21495	31400	4	188	131	0	31723
21496	220	32736	82	48	0	33086
21497	130	168	21	34150	0	34469
21498	108	51	31	34697	0	34887
21499	34931	16	48	312	0	35307
21500	247	13	25	35168	0	35453
21501	33160	14	20	308	0	33502
21502	33375	15	37	168	0	33595
21503	285	10	35	33074	0	33404
21504	140	21	31	33231	0	33423
21505	33051	18	26	366	0	33461
21506	246	15	34325	120	0	34706
21507	33656	12	196	207	0	34071
21508	265	26	35563	59	0	35913
21509	35703	15	197	204	0	36119
21510	37907	19	64	197	0	38187
21511	37238	12	36	195	0	37481
21512	36854	9	29	158	0	37050
21513	322	36518	54	65	0	36959
21514	37386	181	37	144	0	37748
21515	37430	57	39	141	0	37667
21516	336	38539	48	67	0	38990
21517	39008	197	37	232	0	39474
21518	341	74	38486	47	0	38948
21519	38270	27	226	141	0	38664
21520	363	53	39035	45	0	39496
21521	218	32	261	39188	0	39699
21522	155	29	97	39640	0	39921
21523	156	34	39217	322	0	39729
21524	187	33	279	39341	0	39840
21525	782	292	451	22491	0	24016
21526	41434	24	57	504	0	42019
21527	421	39	49	41748	0	42257
21528	246	21	56	41672	0	41995
21529	189	26	51	42045	0	42311
21530	115	41157	65	487	0	41824
21531	152	316	69	41347	0	41884
21532	41500	99	63	532	0	42194
21533	482	68	42187	209	0	42946
21534	252	32	443	42787	0	43514
21535	159	51	42884	571	0	43665
21536	41899	31	498	309	0	42737
21537	608	27	176	44979	0	45790
21538	235	65	53342	671	0	54313
21539	272	31	1011	53590	0	54904
21540	255	41	746	52914	0	53956
21541	135	52180	550	1768	0	54633
21542	246	951	328	54319	0	55844
21543	262	702	149	57097	0	58210
21544	161	503	55732	2249	0	58645
21545	283	273	1159	56104	0	57819
21546	245	141	814	57335	0	58535
21547	55056	90	584	2485	0	58215
21548	55184	84	395	1738	0	57401
21549	1884	55083	282	1143	0	58392
21550	56515	1156	229	910	0	58810
21551	56666	769	239	845	0	58519
21552	2289	55163	318	632	0	58402
21553	1599	1454	200	55404	0	58657
21554	56070	932	166	1843	0	59011
21555	56561	642	202	1338	0	58743
21556	55285	433	166	1158	0	57042
21557	2719	54302	259	760	0	58040
21558	1951	1389	56104	613	0	60057
21559	57538	922	1290	750	0	60500
21560	58476	800	818	659	0	60753
21561	2698	57591	652	622	0	61563
21562	58748	1639	423	697	0	61507
21563	60114	1027	339	611	0	62091
21564	3279	741	200	57883	0	62103
21565	2087	655	57732	1847	0	62321
21566	1683	479	1597	58764	0	62523
21567	1450	283	967	59377	0	62077
21568	1171	372	693	60213	0	62449
21569	900	445	56786	3132	0	61263
21570	1123	314	1658	55645	0	58740
21571	1024	331	1006	58371	0	60732
21572	983	243	755	59197	0	61178
21573	947	291	554	59606	0	61398
21574	926	312	373	59895	0	61506
21575	751	57891	389	3958	0	62989
21576	788	1776	337	60046	0	62947
21577	678	971	465	62379	0	64493
21578	639	687	59400	3641	0	64367
21579	827	449	1800	64903	0	67979
21580	686	378	1061	66205	0	68330
21581	703	313	796	68461	0	70273
21582	745	284	698	69489	0	71216
21583	65715	359	468	5083	0	71625
21584	2536	329	388	68533	0	71786
21585	1654	423	302	68951	0	71330
21586	1229	391	63857	4552	0	70029
21587	940	60604	2024	3422	0	66990
21588	592	65275	1387	2739	0	69993
21589	63258	2690	1186	2387	0	69521
21590	2064	64644	735	2157	0	69600
21591	1632	2668	474	64431	0	69205
21592	63734	1660	403	3753	0	69550
21593	2497	1108	63865	2854	0	70324
21594	1756	854	2230	64542	0	69382
21595	1239	64110	1444	3702	0	70495
21596	1079	2299	958	64416	0	68752
21597	782	65224	691	3975	0	70672
21598	853	2930	440	66372	0	70595
21599	64436	1924	354	4311	0	71025
21600	2719	1351	65138	2875	0	72083
21601	1983	965	2327	63158	0	68433
21602	1438	65429	1631	3517	0	72015
21603	65357	2585	1206	2772	0	71920
21604	2675	1829	64850	2473	0	71827
21605	1978	1413	2408	65390	0	71189
21606	1655	1038	63433	3635	0	69761
21607	1543	824	2929	63941	0	69237
21608	1096	674	62603	4167	0	68540
21609	959	790	3188	61799	0	66736
21610	825	746	2190	63094	0	66855
21611	59955	814	1446	4678	0	66893
21612	61625	898	1115	3278	0	66916
21613	3882	771	757	60149	0	65559
21614	2527	59769	783	3777	0	66856
21615	1880	2538	658	61864	0	66940
21616	1475	1653	754	62285	0	66167
21617	58150	1086	949	5191	0	65376
21618	2660	58521	838	3919	0	65938
21619	58839	2716	723	3025	0	65303
21620	59368	1820	648	2586	0	64422
21621	3762	56084	677	2372	0	62895
21622	2544	59475	618	2455	0	65092
21623	58487	3183	743	2612	0	65025
21624	3268	1954	56668	2716	0	64606
21625	57066	1459	2580	2398	0	63503
21626	57534	1327	1562	2309	0	62732
21627	4455	55344	1267	2099	0	63165
21628	3294	2641	1026	50292	0	57253
21629	2123	55853	885	3527	0	62388
21630	55184	3344	990	2694	0	62212
21631	56923	2284	913	2298	0	62418
21632	4066	1758	936	54853	0	61613
21633	3088	1443	738	55656	0	60925
21634	52699	1200	519	4600	0	59018
21635	3378	51764	565	3523	0	59230
21636	2789	50515	540	2770	0	56614
21637	2121	50413	655	2152	0	55341
21638	1118	40132	445	1576	0	43271
21639	1072	41824	441	1554	0	44891
21640	1082	2708	515	40526	0	44831
21641	1002	1610	38632	2550	0	43794
21642	1203	39255	1450	1597	0	43505
21643	37066	1980	801	1135	0	40982
21644	2161	1302	658	36610	0	40731
21645	36837	1109	514	2053	0	40513
21646	2039	36660	586	1370	0	40655
21647	36792	1780	688	1236	0	40496
21648	2167	36531	804	1080	0	40582
21649	1555	1903	739	36672	0	40869
21650	36820	1077	708	2093	0	40698
21651	37638	974	626	1610	0	40848
21652	2276	885	516	37287	0	40964
21653	1594	919	498	37147	0	40158
21654	1326	36227	372	2588	0	40513
21655	1367	1761	334	36919	0	40381
21656	1344	1177	239	37600	0	40360
21657	1277	1106	269	36648	0	39300
21658	1091	33802	306	2731	0	37930
21659	31337	1511	205	1664	0	34717
21660	1586	31981	246	1271	0	35084
21661	31412	1771	234	1004	0	34421
21662	1896	31350	316	850	0	34412
21663	1409	1691	30065	853	0	34018
21664	1326	1124	1152	30072	0	33674
21665	1073	970	29651	1444	0	33138
21666	987	882	29506	954	0	32329
21667	1120	761	1484	29179	0	32544
21668	1040	736	29363	1447	0	32586
21669	1188	628	1358	28876	0	32050
21670	1223	601	772	29145	0	31741
21671	961	719	600	30010	0	32290
21672	28844	683	394	2215	0	32136
21673	1676	639	320	29078	0	31713
21674	1294	582	282	28644	0	30802
21675	26462	441	174	2017	0	29094
21676	1573	25491	152	1483	0	28699
21677	1130	23764	139	1186	0	26219
21678	1065	24652	106	839	0	26662
21679	659	1636	141	19288	0	21724
21680	474	556	19219	872	0	21121
21681	16632	427	595	556	0	18210
21682	696	17231	302	355	0	18584
21683	16923	553	209	288	0	17973
21684	16947	417	128	197	0	17689
21685	16987	342	92	226	0	17647
21686	759	321	16612	217	0	17909
21687	537	294	404	16768	0	18003
21688	491	252	226	17143	0	18112
21689	488	210	152	17303	0	18153
21690	441	191	133	16761	0	17526
21691	366	15719	100	789	0	16974
21692	15741	429	93	456	0	16719
21693	479	261	14642	266	0	15648
21694	13977	200	266	247	0	14690
21695	491	201	143	13600	0	14435
21696	318	13075	63	433	0	13889
21697	264	13694	55	306	0	14319
21698	308	800	74	12315	0	13497
21699	163	12618	61	323	0	13165
21700	11457	214	52	183	0	11906
21701	207	126	11125	120	0	11578
21702	131	73	130	10579	0	10913
21703	81	57	65	11050	0	11253
21704	68	59	39	11209	0	11375
21705	72	69	40	11123	0	11304
21706	11138	50	23	252	0	11463
21707	188	11524	36	148	0	11896
21708	12693	165	34	134	0	13026
21709	249	88	20	12869	0	13226
21710	141	62	38	13098	0	13339
21711	92	13544	36	351	0	14023
21712	13873	240	42	235	0	14390
21713	14088	126	33	150	0	14397
21714	339	13871	34	100	0	14344
21715	193	251	21	12962	0	13427
21716	97	13405	31	243	0	13776
21717	13250	275	54	158	0	13737
21718	264	138	13207	122	0	13731
21719	140	101	12662	92	0	12995
21720	12431	60	277	99	0	12867
21721	253	12883	137	101	0	13374
21722	156	235	75	12968	0	13434
21723	129	136	46	13047	0	13358
21724	82	110	12968	347	0	13507
21725	103	75	227	12955	0	13360
21726	101	68	96	13125	0	13390
21727	58	12874	84	363	0	13379
21728	92	242	44	13029	0	13407
21729	81	131	52	13027	0	13291
21730	12664	96	45	397	0	13202
21731	253	12228	64	210	0	12755
21732	134	12448	55	178	0	12815
21733	126	285	54	12496	0	12961
21734	94	152	32	12757	0	13035
21735	81	114	46	12684	0	12925
21736	56	12444	40	413	0	12953
21737	73	243	30	12784	0	13130
21738	81	126	30	12801	0	13038
21739	93	100	31	12847	0	13071
21740	89	65	28	12738	0	12920
21741	77	12020	30	427	0	12554
21742	68	12880	37	243	0	13228
21743	12486	296	23	204	0	13009
21744	12623	159	22	146	0	12950
21745	355	115	28	12560	0	13058
21746	151	84	12436	338	0	13009
21747	135	93	242	12563	0	13033
21748	89	70	86	12730	0	12975
21749	12337	65	72	420	0	12894
21750	275	12752	37	229	0	13293
21751	138	268	33	12743	0	13182
21752	113	143	25	12937	0	13218
21753	93	112	12475	404	0	13084
21754	72	80	12438	229	0	12819
21755	81	56	308	12472	0	12917
21756	75	86	142	12310	0	12613
21757	75	12135	98	362	0	12670
21758	60	12522	56	230	0	12868
21759	12300	301	45	196	0	12842
21760	285	137	46	12614	0	13082
21761	100	108	12412	324	0	12944
21762	81	12409	219	236	0	12945
21763	66	257	89	12735	0	13147
21764	12666	120	73	358	0	13217
21765	240	106	35	12935	0	13316
21766	12622	76	41	403	0	13142
21767	284	12843	39	203	0	13369
21768	12682	273	35	214	0	13204
21769	328	138	37	13064	0	13567
21770	154	116	13581	359	0	14210
21771	117	107	269	13408	0	13901
21772	114	13862	111	389	0	14476
21773	107	344	77	13854	0	14382
21774	83	14551	55	423	0	15112
21775	99	379	57	15091	0	15626
21776	69	165	14645	484	0	15363
21777	83	127	14060	281	0	14551
21778	70	124	14496	229	0	14919
21779	14290	107	450	200	0	15047
21780	382	14400	184	177	0	15143
21781	181	14956	123	146	0	15406
21782	14612	432	101	182	0	15327
21783	14750	213	72	193	0	15228
21784	459	154	82	14536	0	15231
21785	216	117	14475	452	0	15260
21786	157	109	13967	246	0	14479
21787	138	115	441	14025	0	14719
21788	13927	108	202	483	0	14720
21789	355	13938	143	277	0	14713
21790	179	371	105	14154	0	14809
21791	13980	172	113	488	0	14753
21792	13986	133	100	303	0	14522
21793	433	109	13757	243	0	14542
21794	13276	104	338	241	0	13959
21795	434	135	14102	180	0	14851
21796	213	110	14530	188	0	15041
21797	216	106	433	14046	0	14801
21798	155	101	198	14384	0	14838
21799	164	95	151	14682	0	15092
21800	114	98	14122	558	0	14892
21801	14093	94	377	333	0	14897
21802	422	93	157	14861	0	15533
21803	14330	101	114	490	0	15035
21804	14340	116	84	291	0	14831
21805	464	14373	96	254	0	15187
21806	252	14584	114	195	0	15145
21807	158	14531	123	180	0	14992
21808	132	385	87	13212	0	13816
21809	87	133	13195	325	0	13740
21810	98	392	312	12230	0	13032
21811	90	12441	129	296	0	12956
21812	84	12543	75	147	0	12849
21813	109	298	66	12401	0	12874
21814	12151	120	61	301	0	12633
21815	280	11919	59	133	0	12391
21816	129	12134	60	111	0	12434
21817	12395	283	67	135	0	12880
21818	309	107	57	12470	0	12943
21819	157	106	73	12562	0	12898
21820	100	85	63	12910	0	13158
21821	12385	66	49	396	0	12896
21822	12574	67	50	209	0	12900
21823	334	66	61	12577	0	13038
21824	158	66	12295	311	0	12830
21825	12294	54	243	180	0	12771
21826	322	72	110	12666	0	13170
21827	147	74	12478	323	0	13022
21828	125	68	12293	165	0	12651
21829	123	64	329	12766	0	13282
21830	80	73	13497	357	0	14007
21831	111	63	316	14397	0	14887
21832	153	72	157	13525	0	13907
21833	107	57	102	15270	0	15536
21834	14969	57	87	545	0	15658
21835	409	69	69	15111	0	15658
21836	224	97	61	15257	0	15639
21837	147	81	60	15389	0	15677
21838	148	87	86	15322	0	15643
21839	99	95	14639	537	0	15370
21840	87	14603	332	302	0	15324
21841	92	312	138	14482	0	15024
21842	84	143	122	14150	0	14499
21843	74	13673	78	456	0	14281
21844	80	14487	78	254	0	14899
21845	14292	357	91	209	0	14949
21846	340	14131	87	190	0	14748
21847	174	331	67	14074	0	14646
21848	135	165	14116	393	0	14809
21849	13427	110	300	253	0	14090
21850	345	96	13616	207	0	14264
21851	13502	68	334	203	0	14107
21852	13763	68	158	192	0	14181
21853	420	50	13793	199	0	14462
21854	232	50	340	13138	0	13760
21855	174	13094	164	386	0	13818
21856	159	296	118	14326	0	14899
21857	14528	121	121	448	0	15218
21858	14727	94	91	278	0	15190
21859	424	14509	107	260	0	15300
21860	14638	318	95	219	0	15270
21861	450	140	108	14410	0	15108
21862	14429	80	83	490	0	15082
21863	14892	81	92	272	0	15337
21864	475	69	85	14772	0	15401
21865	14772	68	68	499	0	15407
21866	14280	58	53	336	0	14727
21867	439	84	14233	241	0	14997
21868	13838	86	289	256	0	14469
21869	431	79	13852	199	0	14561
21870	210	66	13002	150	0	13428
21871	151	13610	332	164	0	14257
21872	162	282	185	13103	0	13732
21873	109	104	13382	306	0	13901
21874	111	86	12883	143	0	13223
21875	13189	71	283	132	0	13675
21876	282	70	134	13344	0	13830
21877	146	85	101	13874	0	14206
21878	113	51	88	14043	0	14295
21879	127	72	67	14067	0	14333
21880	111	69	63	14193	0	14436
21881	104	57	13887	410	0	14458
21882	132	52	13753	223	0	14160
21883	139	50	292	14057	0	14538
21884	13966	48	154	368	0	14536
21885	293	13809	107	222	0	14431
21886	177	237	97	13976	0	14487
21887	13886	79	97	371	0	14433
21888	303	13889	92	210	0	14494
21889	166	257	76	14089	0	14588
21890	167	106	85	14272	0	14630
21891	152	85	71	14322	0	14630
21892	14046	59	74	467	0	14646
21893	323	52	13888	247	0	14510
21894	13855	52	263	231	0	14401
21895	345	46	131	14160	0	14682
21896	205	49	108	13591	0	13953
21897	133	13727	94	443	0	14397
21898	132	226	13440	275	0	14073
21899	13236	96	250	254	0	13836
21900	13867	66	148	225	0	14306
21901	357	66	13617	203	0	14243
21902	12976	62	270	203	0	13511
21903	325	13513	132	195	0	14165
21904	178	13772	116	166	0	14232
21905	152	13928	98	136	0	14314
21906	13429	336	112	141	0	14018
21907	320	156	13495	120	0	14091
21908	201	179	244	12799	0	13423
21909	116	12760	122	265	0	13263
21910	110	12987	93	159	0	13349
21911	108	13099	67	124	0	13398
21912	282	370	80	9601	0	10333
21913	12568	113	81	293	0	13055
21914	260	12722	56	176	0	13214
21915	149	254	59	12853	0	13315
21916	114	130	57	13047	0	13348
21917	12618	92	60	326	0	13096
21918	306	84	49	12634	0	13073
21919	168	66	50	12855	0	13139
21920	127	83	12594	327	0	13131
21921	133	70	202	12493	0	12898
21922	109	53	93	12977	0	13232
21923	12752	39	69	356	0	13216
21924	12758	53	56	202	0	13069
21925	355	35	46	12714	0	13150
21926	11766	36	64	352	0	12218
21927	12360	44	51	195	0	12650
21928	287	12284	68	128	0	12767
21929	161	203	12071	103	0	12538
21930	143	11505	204	89	0	11941
21931	145	292	117	10597	0	11151
21932	10424	60	75	169	0	10728
21933	140	10313	30	86	0	10569
21934	85	135	29	10339	0	10588
21935	10245	67	40	164	0	10516
21936	10184	50	25	106	0	10365
21937	165	38	26	10205	0	10434
21938	81	42	10269	160	0	10552
21939	64	37	113	10403	0	10617
21940	39	30	44	10648	0	10761
21941	48	30	10539	193	0	10810
21942	66	19	119	10418	0	10622
21943	53	23	61	10586	0	10723
21944	10934	25	43	208	0	11210
21945	135	22	22	11109	0	11288
21946	76	22	20	11173	0	11291
21947	10937	34	32	208	0	11211
21948	10750	20	30	144	0	10944
21949	10702	42	17	123	0	10884
21950	195	26	10663	58	0	10942
21951	93	37	110	10494	0	10734
21952	63	10635	43	150	0	10891
21953	62	125	28	10950	0	11165
21954	71	58	11097	142	0	11368
21955	88	61	110	10259	0	10518
21956	60	31	10669	121	0	10881
21957	9824	24	106	99	0	10053
21958	10224	26	31	69	0	10350
21959	132	10	22	10406	0	10570
21960	59	12	25	10341	0	10437
21961	40	17	11	10310	0	10378
21962	25	10667	35	125	0	10852
21963	10537	81	14	101	0	10733
21964	10631	26	20	87	0	10764
21965	139	16	12	10482	0	10649
21966	62	24	13	10441	0	10540
21967	48	11	15	10502	0	10576
21968	47	28	13	10488	0	10576
21969	48	11	10286	144	0	10489
21970	60	9	92	10253	0	10414
21971	9822	11	38	142	0	10013
21972	9760	11	23	103	0	9897
21973	121	16	19	9543	0	9699
21974	50	15	9157	117	0	9339
21975	8643	4	98	99	0	8844
21976	105	18	39	9287	0	9449
21977	56	8781	17	122	0	8976
21978	26	9189	19	49	0	9283
21979	9458	95	25	75	0	9653
21980	114	34	12	9615	0	9775
21981	61	18	7	9840	0	9926
21982	38	8	9	10321	0	10376
21983	35	9	8	10385	0	10437
21984	37	19	11	10700	0	10767
21985	27	13	10579	182	0	10801
21986	28	16	10280	97	0	10421
21987	24	14	10505	65	0	10608
21988	34	9	172	10532	0	10747
21989	33	9	11023	164	0	11229
21990	37	5	163	10985	0	11190
21991	45	9	68	11120	0	11242
21992	35	8	44	11642	0	11729
21993	11641	5	36	267	0	11949
21994	182	11	37	11689	0	11919
21995	86	15	44	11915	0	12060
21996	11700	7	38	280	0	12025
21997	171	11603	31	139	0	11944
21998	67	11939	26	108	0	12140
21999	11961	211	17	105	0	12294
22000	188	12314	23	94	0	12619
22001	12330	185	21	116	0	12652
22002	12444	68	23	122	0	12657
22003	12511	35	17	105	0	12668
22004	12216	20	12	101	0	12349
22005	12412	31	21	84	0	12548
22006	288	12244	23	67	0	12622
22007	12188	204	19	88	0	12499
22008	12548	84	22	86	0	12740
22009	303	12917	20	57	0	13297
22010	14838	214	17	97	0	15166
22011	15310	89	18	90	0	15507
22012	16444	64	9	89	0	16606
22013	17107	53	9	83	0	17252
22014	613	71	17658	64	0	18406
22015	367	58	416	18238	0	19079
22016	281	61	125	18877	0	19344
22017	184	57	18707	573	0	19521
22018	179	62	18492	227	0	18960
22019	18360	52	580	156	0	19148
22020	665	49	211	18733	0	19658
22021	304	42	19000	483	0	19829
22022	230	56	18780	184	0	19250
22023	18626	70	631	167	0	19494
22024	19310	35	244	155	0	19744
22025	19431	37	170	130	0	19768
22026	797	44	19153	70	0	20064
22027	455	28	526	19095	0	20104
22028	311	35	19542	519	0	20407
22029	19227	29	598	266	0	20120
22030	625	35	20000	168	0	20828
22031	351	31	663	19415	0	20460
22032	296	20	288	19410	0	20014
22033	219	19785	233	603	0	20840
22034	20160	463	182	332	0	21137
22035	621	155	20140	204	0	21120
22036	19913	99	618	205	0	20835
22037	742	61	20808	108	0	21719
22038	441	44	708	20088	0	21281
22039	368	34	324	20628	0	21354
22040	328	24	248	20900	0	21500
22041	20525	39	185	813	0	21562
22042	766	58	199	20046	0	21069
22043	478	40	160	20559	0	21237
22044	312	19797	234	788	0	21131
22045	314	474	202	20254	0	21244
22046	19873	161	229	824	0	21087
22047	700	150	19874	410	0	21134
22048	458	76	624	19902	0	21060
22049	337	86	20038	742	0	21203
22050	305	19378	726	409	0	20818
22051	256	486	20140	351	0	21233
22052	19609	222	772	373	0	20976
22053	20427	131	386	344	0	21288
22054	849	81	371	19907	0	21208
22055	20216	58	273	790	0	21337
22056	20418	46	271	521	0	21256
22057	919	62	260	20296	0	21537
22058	548	94	274	20591	0	21507
22059	383	88	20418	914	0	21803
22060	386	20229	685	474	0	21774
22061	20419	530	413	410	0	21772
22062	786	19962	304	350	0	21402
22063	496	627	314	20059	0	21496
22064	471	265	220	20523	0	21479
22065	423	169	292	20602	0	21486
22066	379	128	266	20665	0	21438
22067	300	100	19966	1024	0	21390
22068	19224	116	712	612	0	20664
22069	20496	117	324	436	0	21373
22070	963	107	295	20046	0	21411
22071	20204	103	214	884	0	21405
22072	906	105	175	20347	0	21533
22073	475	123	19972	947	0	21517
22074	426	152	616	19696	0	20890
22075	368	19646	360	916	0	21290
22076	345	547	284	19378	0	20554
22077	310	19866	247	887	0	21310
22078	304	620	206	19161	0	20291
22079	262	19518	207	884	0	20871
22080	18995	601	188	592	0	20376
22081	710	250	18919	491	0	20370
22082	409	17885	603	460	0	19357
22083	342	18652	358	405	0	19757
22084	375	605	385	18261	0	19626
22085	410	254	206	18150	0	19020
22086	325	214	222	18307	0	19068
22087	307	146	223	18621	0	19297
22088	281	17831	192	937	0	19241
22089	298	545	194	17862	0	18899
22090	282	242	171	18044	0	18739
22091	17252	250	185	817	0	18504
22092	650	183	138	17548	0	18519
22093	325	194	17039	804	0	18362
22094	299	154	16505	531	0	17489
22095	15907	153	569	456	0	17085
22096	558	16538	287	407	0	17790
22097	280	16964	226	359	0	17829
22098	292	552	212	16654	0	17710
22099	236	309	134	16985	0	17664
22100	184	191	16193	799	0	17367
22101	15490	160	428	576	0	16654
22102	16152	160	222	479	0	17013
22103	576	116	16526	452	0	17670
22104	359	122	15975	389	0	16845
22105	16208	133	531	375	0	17247
22106	17069	121	252	388	0	17830
22107	17035	125	221	350	0	17731
22108	16813	120	171	342	0	17446
22109	676	15828	147	299	0	16950
22110	13935	340	88	219	0	14582
22111	436	154	13243	203	0	14036
22112	173	96	11963	172	0	12404
22113	129	83	12420	156	0	12788
22114	198	524	355	10329	0	11406
22115	10473	19	125	139	0	10756
22116	10478	17	47	68	0	10610
22117	147	13	51	10414	0	10625
22118	107	26	47	9545	0	9725
22119	79	24	30	10352	0	10485
22120	59	10834	38	127	0	11058
22121	11041	86	24	109	0	11260
22122	11089	41	36	82	0	11248
22123	11141	48	31	78	0	11298
22124	11131	24	23	73	0	11251
22125	11159	16	44	75	0	11294
22126	164	19	46	10785	0	11014
22127	86	10475	31	117	0	10709
22128	93	79	32	9775	0	9979
22129	49	27	21	10268	0	10365
22130	10005	19	15	115	0	10154
22131	88	22	9750	56	0	9916
22132	55	13	9136	36	0	9240
22133	49	12	9247	24	0	9332
22134	9895	8	71	40	0	10014
22135	10325	7	61	44	0	10437
22136	99	5	24	10542	0	10670
22137	50	10	15	10219	0	10294
22138	45	8	17	10400	0	10470
22139	24	11	10497	96	0	10628
22140	38	10	68	10249	0	10365
22141	33	9	10939	84	0	11065
22142	43	8	71	10848	0	10970
22143	39	17	30	10905	0	10991
22144	30	8	28	11278	0	11344
22145	11275	10	16	126	0	11427
22146	11318	5	20	104	0	11447
22147	88	15	11339	51	0	11493
22148	11083	8	72	74	0	11237
22149	11320	9	33	72	0	11434
22150	105	7	40	11339	0	11491
22151	11493	2	25	107	0	11627
22152	110	4	27	11548	0	11689
22153	64	6	19	11658	0	11747
22154	44	15	11418	114	0	11591
22155	10630	5	76	105	0	10816
22156	107	18	36	11486	0	11647
22157	64	5	11471	112	0	11652
22158	42	8	11919	65	0	12034
22159	61	3	101	11606	0	11771
22160	41	2	56	11792	0	11891
22161	12053	0	44	158	0	12255
22162	98	2	28	12229	0	12357
22163	65	4	20	12240	0	12329
22164	60	0	23	12430	0	12513
22165	46	2	30	13342	0	13420
22166	13717	0	22	238	0	13977
22167	13675	0	22	161	0	13858
22168	13983	2	27	127	0	14139
22169	14288	0	27	91	0	14406
22170	263	1	15	14615	0	14894
22171	14784	1	23	249	0	15057
22172	254	1	31	14748	0	15034
22173	14901	0	17	256	0	15174
22174	267	2	19	14865	0	15153
22175	141	2	25	14767	0	14935
22176	90	14734	28	265	0	15117
22177	74	164	18	14801	0	15057
22178	14548	58	14	306	0	14926
22179	14235	35	23	188	0	14481
22180	275	18	14466	106	0	14865
22181	133	14509	183	105	0	14930
22182	14630	163	76	128	0	14997
22183	243	14849	58	79	0	15229
22184	14837	200	25	133	0	15195
22185	291	15461	25	69	0	15846
22186	162	220	15499	76	0	15957
22187	125	15401	195	94	0	15815
22188	75	15632	78	105	0	15890
22189	117	242	49	16216	0	16624
22190	16408	127	23	309	0	16867
22191	280	65	17	16576	0	16938
22192	162	53	15	16679	0	16909
22193	16385	31	22	385	0	16823
22194	16710	51	27	237	0	17025
22195	351	49	22	16783	0	17205
22196	228	30	24	16816	0	17098
22197	163	46	23	16917	0	17149
22198	16448	36	42	414	0	16940
22199	278	74	16462	186	0	17000
22200	198	49	204	16516	0	16967
22201	133	75	16972	263	0	17443
22202	101	16656	245	152	0	17154
22203	77	240	16399	142	0	16858
22204	98	107	257	16243	0	16705
22205	95	105	16276	274	0	16750
22206	15563	59	256	203	0	16081
22207	283	41	92	16254	0	16670
22208	167	16522	82	290	0	17061
22209	155	240	39	16633	0	17067
22210	106	16488	50	333	0	16977
22211	115	16476	37	182	0	16810
22212	122	16717	48	145	0	17032
22213	127	285	45	15702	0	16159
22214	99	16107	39	298	0	16543
22215	15884	260	45	214	0	16403
22216	295	114	15490	207	0	16106
22217	171	91	14813	129	0	15204
22218	139	69	15681	123	0	16012
22219	102	65	320	16097	0	16584
22220	103	63	136	15477	0	15779
22221	121	66	105	15316	0	15608
22222	147	56	53	15384	0	15640
22223	159	68	75	14736	0	15038
22224	128	15451	69	367	0	16015
22225	96	255	15107	215	0	15673
22226	130	169	14692	143	0	15134
22227	92	15548	286	160	0	16086
22228	110	261	135	15921	0	16427
22229	114	150	88	16149	0	16501
22230	113	110	68	16136	0	16427
22231	15865	80	65	424	0	16434
22232	268	107	15679	222	0	16276
22233	15220	64	248	191	0	15723
22234	15481	82	119	190	0	15872
22235	328	15059	95	157	0	15639
22236	176	15339	58	139	0	15712
22237	15401	271	62	198	0	15932
22238	323	173	60	15501	0	16057
22239	188	92	66	16097	0	16443
22240	133	98	16585	388	0	17204
22241	116	94	16304	202	0	16716
22242	123	98	348	17000	0	17569
22243	17221	98	191	389	0	17899
22244	303	86	18119	225	0	18733
22245	18488	88	307	241	0	19124
22246	387	88	159	19263	0	19897
22247	217	80	112	20084	0	20493
22248	182	84	102	20698	0	21066
22249	121	92	20480	544	0	21237
22250	138	19635	403	242	0	20418
22251	127	21081	170	204	0	21582
22252	21003	441	95	237	0	21776
22253	21603	179	77	208	0	22067
22254	553	102	80	21741	0	22476
22255	21873	61	71	582	0	22587
22256	475	59	21402	254	0	22190
22257	211	74	21238	186	0	21709
22258	181	73	532	21294	0	22080
22259	22034	85	205	571	0	22895
22260	534	61	132	22350	0	23077
22261	252	45	114	23082	0	23493
22262	22511	54	110	726	0	23401
22263	22908	70	135	328	0	23441
22264	601	23426	124	250	0	24401
22265	23015	465	99	190	0	23769
22266	614	163	73	22454	0	23304
22267	203	22751	70	561	0	23585
22268	22804	451	94	245	0	23594
22269	532	23099	86	167	0	23884
22270	250	486	63	23046	0	23845
22271	23053	130	64	553	0	23800
22272	526	91	22703	195	0	23515
22273	189	82	22638	169	0	23078
22274	231	80	504	22271	0	23086
22275	157	69	164	23245	0	23635
22276	204	81	99	22570	0	22954
22277	164	23376	78	554	0	24172
22278	24287	511	66	282	0	25146
22279	24492	173	75	248	0	24988
22280	24567	90	69	228	0	24954
22281	703	25421	83	185	0	26392
22282	359	550	74	27000	0	27983
22283	266	193	63	27502	0	28024
22284	236	161	77	27661	0	28135
22285	26073	102	79	910	0	27164
22286	685	26268	81	336	0	27370
22287	413	569	88	26407	0	27477
22288	266	220	69	26912	0	27467
22289	185	156	25909	882	0	27132
22290	207	25712	578	386	0	26883
22291	235	624	192	25805	0	26856
22292	254	245	112	26297	0	26908
22293	298	164	55	26394	0	26911
22294	25307	144	69	1000	0	26520
22295	701	25277	74	501	0	26553
22296	25508	643	75	413	0	26639
22297	808	252	92	25430	0	26582
22298	25455	193	84	859	0	26591
22299	774	201	24851	439	0	26265
22300	24785	156	598	424	0	25963
22301	25231	152	176	415	0	25974
22302	862	178	24948	325	0	26313
22303	459	176	611	25039	0	26285
22304	381	153	235	24638	0	25407
22305	26058	150	145	1068	0	27421
22306	823	110	142	26599	0	27674
22307	467	144	135	26578	0	27324
22308	346	156	132	27048	0	27682
22309	342	149	25880	1025	0	27396
22310	24491	137	614	620	0	25862
22311	868	26422	244	425	0	27959
22312	472	687	142	26149	0	27450
22313	409	26037	149	865	0	27460
22314	302	27540	157	468	0	28467
22315	352	811	133	27561	0	28857
22316	276	332	27234	1010	0	28852
22317	282	219	27448	565	0	28514
22318	344	177	801	27978	0	29300
22319	309	177	27766	1014	0	29266
22320	27380	209	760	580	0	28929
22321	855	187	291	28685	0	30018
22322	443	176	220	29100	0	29939
22323	320	28753	204	1128	0	30405
22324	301	765	207	29009	0	30282
22325	294	329	160	28932	0	29715
22326	267	28296	185	1146	0	29894
22327	297	771	169	28993	0	30230
22328	285	336	164	28833	0	29618
22329	296	28359	162	1128	0	29945
22330	28303	757	201	672	0	29933
22331	871	304	28123	523	0	29821
22332	395	245	27952	479	0	29071
22333	393	233	848	28062	0	29536
22334	287	213	336	28985	0	29821
22335	283	206	28145	1182	0	29816
22336	235	233	27501	672	0	28641
22337	25716	228	821	629	0	27394
22338	772	27810	323	505	0	29410
22339	27358	733	220	525	0	28836
22340	793	269	26834	490	0	28386
22341	324	26778	755	477	0	28334
22342	330	813	321	27538	0	29002
22343	264	298	28146	959	0	29667
22344	235	229	27476	469	0	28409
22345	298	340	898	27478	0	29014
22346	232	207	27574	964	0	28977
22347	187	26961	819	462	0	28429
22348	259	738	345	26851	0	28193
22349	195	276	27056	881	0	28408
22350	182	27124	776	454	0	28536
22351	26732	695	339	399	0	28165
22352	761	272	26608	314	0	27955
22353	300	26768	753	310	0	28131
22354	282	719	354	26288	0	27643
22355	211	295	257	27632	0	28395
22356	27027	206	225	995	0	28453
22357	729	149	224	27012	0	28114
22358	312	139	210	26799	0	27460
22359	25827	140	215	982	0	27164
22360	673	163	184	25751	0	26771
22361	274	142	24953	833	0	26202
22362	259	191	630	24777	0	25857
22363	177	130	24686	838	0	25831
22364	193	139	23083	403	0	23818
22365	184	110	24044	316	0	24654
22366	254	156	733	22941	0	24084
22367	157	107	350	24135	0	24749
22368	23689	74	221	835	0	24819
22369	565	74	190	23061	0	23890
22370	238	23856	199	733	0	25026
22371	203	465	188	24880	0	25736
22372	176	197	200	24445	0	25018
22373	110	24477	211	775	0	25573
22374	24382	480	215	462	0	25539
22375	24037	211	182	386	0	24816
22376	582	23755	217	317	0	24871
22377	190	23383	185	242	0	24000
22378	194	820	229	22803	0	24046
22379	23032	227	177	596	0	24032
22380	472	157	22965	342	0	23936
22381	224	124	20739	237	0	21324
22382	19490	102	374	200	0	20166
22383	367	20588	189	186	0	21330
22384	189	374	128	20746	0	21437
22385	180	168	109	20036	0	20493
22386	131	111	100	20566	0	20908
22387	151	89	92	20801	0	21133
22388	107	20448	109	508	0	21172
22389	113	323	106	20971	0	21513
22390	20883	156	88	505	0	21632
22391	370	128	84	21233	0	21815
22392	177	91	78	21518	0	21864
22393	21392	81	115	582	0	22170
22394	21470	96	102	335	0	22003
22395	21830	67	90	291	0	22278
22396	22066	88	77	249	0	22480
22397	562	87	72	21832	0	22553
22398	21956	74	60	504	0	22594
22399	452	64	81	21951	0	22548
22400	21777	73	62	557	0	22469
22401	21919	73	67	329	0	22388
22402	532	77	85	21819	0	22513
22403	289	72	22116	467	0	22944
22404	21945	63	332	311	0	22651
22405	22159	78	167	287	0	22691
22406	21914	67	110	243	0	22334
22407	22016	59	80	238	0	22393
22408	601	74	93	21905	0	22673
22409	357	53	21782	415	0	22607
22410	232	69	20874	259	0	21434
22411	20907	80	426	247	0	21660
22412	21905	53	187	232	0	22377
22413	511	21491	106	206	0	22314
22414	264	21463	87	146	0	21960
22415	21777	324	96	200	0	22397
22416	430	146	88	21285	0	21949
22417	271	106	82	21608	0	22067
22418	21390	79	92	449	0	22010
22419	398	21577	72	245	0	22292
22420	22018	277	50	249	0	22594
22421	416	143	21774	177	0	22510
22422	21595	91	281	217	0	22184
22423	443	73	127	21790	0	22433
22424	260	64	22099	360	0	22783
22425	217	22224	287	238	0	22966
22426	225	274	133	22911	0	23543
22427	177	145	23768	376	0	24466
22428	222	86	305	23518	0	24131
22429	24383	49	166	477	0	25075
22430	404	64	24280	253	0	25001
22431	23368	56	325	239	0	23988
22432	418	24542	205	179	0	25344
22433	274	313	130	24989	0	25706
22434	223	163	26242	390	0	27018
22435	253	98	351	25971	0	26673
22436	213	70	26691	433	0	27407
22437	186	26231	359	235	0	27011
22438	25970	299	217	208	0	26694
22439	364	27055	130	148	0	27697
22440	230	323	88	26811	0	27452
22441	188	165	95	26923	0	27371
22442	156	103	25804	407	0	26470
22443	20832	87	284	375	0	21578
22444	307	24049	185	152	0	24693
22445	147	23069	102	95	0	23413
22446	118	23451	66	115	0	23750
22447	195	322	119	22764	0	23400
22448	78	22883	102	242	0	23305
22449	141	263	64	22396	0	22864
22450	76	22559	74	214	0	22923
22451	85	221	63	22121	0	22490
22452	64	22691	36	200	0	22991
22453	22632	210	40	164	0	23046
22454	177	130	22568	112	0	22987
22455	21392	94	176	127	0	21789
22456	22475	76	94	127	0	22772
22457	22922	87	52	123	0	23184
22458	235	23079	56	78	0	23448
22459	23386	204	52	113	0	23755
22460	23301	108	37	122	0	23568
22461	23811	84	49	107	0	24051
22462	322	75	23571	48	0	24016
22463	212	69	181	23974	0	24436
22464	140	79	24653	210	0	25082
22465	154	65	207	24099	0	24525
22466	24317	51	115	303	0	24786
22467	275	24259	59	128	0	24721
22468	181	252	27365	79	0	27877
22469	210	132	370	26966	0	27678
22470	149	87	112	28758	0	29106
22471	96	59	30640	513	0	31308
22472	29551	79	505	245	0	30380
22473	31022	61	188	158	0	31429
22474	31717	66	89	141	0	32013
22475	774	56	69	30951	0	31850
22476	265	29872	84	551	0	30772
22477	151	31997	86	213	0	32447
22478	170	605	76	31535	0	32386
22479	203	217	74	31121	0	31615
22480	137	31222	93	612	0	32064
22481	31252	495	50	277	0	32074
22482	563	31225	67	150	0	32005
22483	300	561	69	30833	0	31763
22484	160	227	30592	571	0	31550
22485	180	140	513	30341	0	31174
22486	30551	112	192	672	0	31527
22487	570	111	30583	279	0	31543
22488	30479	114	525	221	0	31339
22489	31712	133	190	230	0	32265
22490	32239	91	126	224	0	32680
22491	32066	135	101	217	0	32519
22492	33167	89	104	254	0	33614
22493	873	84	31831	128	0	32916
22494	366	119	31654	162	0	32301
22495	34403	81	700	160	0	35344
22496	35965	96	280	135	0	36476
22497	1042	85	108	36218	0	37453
22498	473	36594	114	717	0	37898
22499	351	708	110	37434	0	38603
22500	38076	275	102	862	0	39315
22501	1000	167	121	36560	0	37848
22502	470	38369	108	763	0	39710
22503	38169	741	96	430	0	39436
22504	37904	303	86	328	0	38621
22505	38151	184	101	291	0	38727
22506	1112	37410	123	239	0	38884
22507	611	754	106	37534	0	39005
22508	439	306	107	37343	0	38195
22509	351	35747	93	984	0	37175
22510	442	786	68	37037	0	38333
22511	36721	309	71	1003	0	38104
22512	37012	207	85	453	0	37757
22513	1139	36317	112	305	0	37873
22514	640	801	104	36536	0	38081
22515	494	331	99	37139	0	38063
22516	405	246	114	37490	0	38255
22517	36306	195	106	1252	0	37859
22518	1058	187	35522	568	0	37335
22519	34629	151	748	483	0	36011
22520	1136	254	35343	381	0	37114
22521	642	258	785	34086	0	35771
22522	451	34177	304	1012	0	35944
22523	452	36092	149	570	0	37263
22524	34999	1063	123	495	0	36680
22525	34740	508	141	485	0	35874
22526	1245	33735	133	385	0	35498
22527	578	33942	136	374	0	35030
22528	34113	1080	136	423	0	35752
22529	34700	520	125	406	0	35751
22530	1255	34783	140	347	0	36525
22531	35696	938	109	332	0	37075
22532	1223	475	34904	266	0	36868
22533	35139	352	770	366	0	36627
22534	34919	324	341	326	0	35910
22535	1397	302	209	33931	0	35839
22536	804	33715	145	974	0	35638
22537	710	929	139	33763	0	35541
22538	34552	434	163	1045	0	36194
22539	1334	313	147	33420	0	35214
22540	841	244	151	34311	0	35547
22541	565	250	34023	1274	0	36112
22542	571	266	830	34306	0	35973
22543	585	237	348	35375	0	36545
22544	34766	272	247	1326	0	36611
22545	1195	265	34405	654	0	36519
22546	34784	259	870	512	0	36425
22547	1281	233	366	35026	0	36906
22548	743	274	198	35546	0	36761
22549	521	304	165	35293	0	36283
22550	547	33598	144	1311	0	35600
22551	534	34797	158	683	0	36172
22552	611	1105	144	34098	0	35958
22553	34038	501	154	1099	0	35792
22554	34466	311	147	670	0	35594
22555	1459	252	155	33914	0	35780
22556	33961	270	122	1185	0	35538
22557	1312	289	141	33688	0	35430
22558	808	260	110	34258	0	35436
22559	32039	238	148	1453	0	33878
22560	1200	33659	159	758	0	35776
22561	33500	875	108	649	0	35132
22562	33341	418	108	652	0	34519
22563	32790	286	107	565	0	33748
22564	1278	31946	141	543	0	33908
22565	817	929	126	32141	0	34013
22566	639	396	135	32857	0	34027
22567	524	244	31366	1322	0	33456
22568	529	370	638	28627	0	30164
22569	410	163	27561	1003	0	29137
22570	392	25799	607	562	0	27360
22571	275	23223	261	405	0	24164
22572	286	23970	153	359	0	24768
22573	391	661	250	24384	0	25686
22574	288	330	114	24678	0	25410
22575	266	214	98	25047	0	25625
22576	238	196	77	25464	0	25975
22577	223	205	25336	898	0	26662
22578	220	222	30302	515	0	31259
22579	250	181	734	31442	0	32607
22580	238	131	31840	909	0	33118
22581	31889	108	713	579	0	33289
22582	32623	118	317	456	0	33514
22583	933	155	32148	389	0	33625
22584	506	140	699	32753	0	34098
22585	412	124	313	33252	0	34101
22586	369	154	188	33836	0	34547
22587	374	134	159	33366	0	34033
22588	384	121	149	34096	0	34750
22589	22403	399	243	1339	0	24384
22590	32556	129	126	720	0	33531
22591	849	32476	149	523	0	33997
22592	401	608	30631	425	0	32065
22593	287	30321	606	379	0	31593
22594	245	30895	269	337	0	31746
22595	28514	612	176	290	0	29592
22596	568	28262	119	247	0	29196
22597	229	27334	94	177	0	27834
22598	26940	559	150	227	0	27876
22599	502	232	26519	149	0	27402
22600	25672	146	402	186	0	26406
22601	542	106	170	26700	0	27518
22602	263	105	84	25939	0	26391
22603	170	89	70	26375	0	26704
22604	139	73	25546	650	0	26408
22605	115	25703	453	335	0	26606
22606	25858	404	168	282	0	26712
22607	469	172	160	26015	0	26816
22608	192	26285	122	618	0	27217
22609	169	477	141	27445	0	28232
22610	185	215	27058	582	0	28040
22611	245	156	479	27440	0	28320
22612	195	131	254	28216	0	28796
22613	182	105	124	28563	0	28974
22614	28049	99	90	903	0	29141
22615	552	86	104	28412	0	29154
22616	244	64	27826	844	0	28978
22617	154	27703	516	527	0	28900
22618	215	503	226	28179	0	29123
22619	274	229	167	28191	0	28861
22620	171	181	27978	818	0	29148
22621	157	159	27105	400	0	27821
22622	26914	173	881	401	0	28369
22623	26582	208	367	440	0	27597
22624	822	26963	363	296	0	28444
22625	27297	559	206	321	0	28383
22626	809	283	27031	297	0	28420
22627	441	159	26525	392	0	27517
22628	26395	203	812	628	0	28038
22629	26150	110	332	662	0	27254
22630	686	105	25345	684	0	26820
22631	24824	90	543	692	0	26149
22632	658	110	25228	525	0	26521
22633	25159	174	595	301	0	26229
22634	25522	286	294	228	0	26330
22635	784	384	222	23841	0	25231
22636	364	26260	297	548	0	27469
22637	17307	969	362	493	0	19131
22638	544	517	26194	238	0	27493
22639	427	26417	588	245	0	27677
22640	26464	867	307	318	0	27956
22641	25527	456	197	386	0	26566
22642	932	25408	282	335	0	26957
22643	591	567	356	25621	0	27135
22644	497	261	25160	820	0	26738
22645	311	206	649	25622	0	26788
22646	267	243	25112	1005	0	26627
22647	235	245	682	25373	0	26535
22648	255	265	462	25475	0	26457
22649	308	371	24751	881	0	26311
22650	373	24962	655	527	0	26517
22651	366	657	296	24752	0	26071
22652	408	450	16043	922	0	17823
22653	24580	274	440	647	0	25941
22654	687	194	351	25284	0	26516
22655	353	156	302	25903	0	26714
22656	25210	202	270	1130	0	26812
22657	794	145	195	25373	0	26507
22658	622	184	241	24634	0	25681
22659	349	24751	336	884	0	26320
22660	430	602	356	24535	0	25923
22661	276	406	24243	847	0	25772
22662	354	199	648	23702	0	24903
22663	316	23665	418	890	0	25289
22664	262	24205	521	565	0	25553
22665	339	652	414	24310	0	25715
22666	24393	316	295	713	0	25717
22667	873	304	291	24252	0	25720
22668	24364	428	274	681	0	25747
22669	941	231	309	24213	0	25694
22670	24281	202	478	706	0	25667
22671	24771	228	406	527	0	25932
22672	1103	245	307	24163	0	25818
22673	794	857	445	23135	0	25231
22674	520	23039	469	824	0	24852
22675	585	23576	344	521	0	25026
22676	567	525	23088	441	0	24621
22677	550	21905	524	468	0	23447
22678	16069	425	455	298	0	17247
22679	460	139	206	15842	0	16647
22680	188	15287	154	384	0	16013
22681	15787	295	103	244	0	16429
22682	389	132	100	15805	0	16426
22683	263	85	147	15395	0	15890
22684	197	87	155	15686	0	16125
22685	200	95	138	15740	0	16173
22686	172	15888	128	454	0	16642
22687	222	17012	71	226	0	17531
22688	16978	346	121	168	0	17613
22689	422	17151	103	158	0	17834
22690	220	347	103	17113	0	17783
22691	215	145	62	17395	0	17817
22692	207	112	55	17408	0	17782
22693	155	94	73	17607	0	17929
22694	17221	95	87	536	0	17939
22695	17629	85	86	258	0	18058
22696	512	63	17324	183	0	18082
22697	249	84	362	17447	0	18142
22698	209	64	17614	445	0	18332
22699	179	61	401	17662	0	18303
22700	156	89	165	17984	0	18394
22701	17612	72	97	583	0	18364
22702	489	66	114	17583	0	18252
22703	200	63	17221	502	0	17986
22704	141	74	16441	240	0	16896
22705	16787	43	404	277	0	17511
22706	369	68	17242	212	0	17891
22707	192	84	358	16408	0	17042
22708	130	35	16839	437	0	17441
22709	140	151	356	16039	0	16686
22710	64	16293	176	421	0	16954
22711	127	338	144	16162	0	16771
22712	54	15872	102	398	0	16426
22713	55	16079	78	221	0	16433
22714	73	356	72	15812	0	16313
22715	15595	121	58	419	0	16193
22716	266	15802	63	174	0	16305
22717	130	283	59	15913	0	16385
22718	15872	119	49	391	0	16431
22719	16083	82	64	219	0	16448
22720	16476	81	37	211	0	16805
22721	413	58	55	16231	0	16757
22722	207	52	36	16539	0	16834
22723	16623	61	44	434	0	17162
22724	16699	70	35	270	0	17074
22725	16821	66	50	210	0	17147
22726	416	73	42	16711	0	17242
22727	200	64	15851	327	0	16442
22728	15928	59	211	206	0	16404
22729	335	53	88	16081	0	16557
22730	183	16353	70	342	0	16948
22731	186	328	46	16125	0	16685
22732	152	16155	29	338	0	16674
22733	139	259	44	16533	0	16975
22734	104	126	16190	366	0	16786
22735	96	16091	231	213	0	16631
22736	125	225	93	15520	0	15963
22737	92	93	63	15592	0	15840
22738	105	82	39	15545	0	15771
22739	15649	55	31	399	0	16134
22740	260	15818	48	207	0	16333
22741	158	243	42	16239	0	16682
22742	16502	109	45	369	0	17025
22743	16589	97	40	208	0	16934
22744	375	65	23	16731	0	17194
22745	189	68	16678	372	0	17307
22746	181	55	260	16450	0	16946
22747	104	16683	118	381	0	17286
22748	108	309	79	17115	0	17611
22749	16888	121	62	451	0	17522
22750	358	116	38	17777	0	18289
22751	163	72	18026	469	0	18730
22752	131	18781	270	279	0	19461
22753	18950	342	125	232	0	19649
22754	365	170	18931	198	0	19664
22755	18930	120	336	169	0	19555
22756	446	76	141	19490	0	20153
22757	271	48	111	19591	0	20021
22758	154	19633	92	497	0	20376
22759	20432	315	77	323	0	21147
22760	441	150	79	20743	0	21413
22761	264	93	80	21017	0	21454
22762	207	83	70	21644	0	22004
22763	143	75	21301	631	0	22150
22764	152	45	374	21496	0	22067
22765	21672	74	172	583	0	22501
22766	22168	68	126	338	0	22700
22767	541	65	95	22066	0	22767
22768	291	72	66	22382	0	22811
22769	22067	70	93	620	0	22850
22770	458	75	21634	348	0	22515
22771	21260	74	358	325	0	22017
22772	491	73	21283	235	0	22082
22773	287	82	21221	176	0	21766
22774	231	71	462	21307	0	22071
22775	157	58	21674	519	0	22408
22776	21478	48	448	337	0	22311
22777	479	59	198	22228	0	22964
22778	250	50	22150	492	0	22942
22779	21493	40	381	342	0	22256
22780	22222	51	177	304	0	22754
22781	583	45	22597	224	0	23449
22782	382	134	369	21466	0	22351
22783	253	22663	202	435	0	23553
22784	23134	316	149	320	0	23919
22785	475	146	23274	207	0	24102
22786	21168	134	359	233	0	21894
22787	447	22280	195	170	0	23092
22788	21617	247	172	190	0	22226
22789	21530	111	89	213	0	21943
22790	21691	75	93	198	0	22057
22791	458	110	85	21716	0	22369
22792	256	21716	108	339	0	22419
22793	207	252	21456	212	0	22127
22794	182	22042	282	169	0	22675
22795	264	310	159	19961	0	20694
22796	157	21331	123	271	0	21882
22797	140	21837	100	203	0	22280
22798	21365	305	115	206	0	21991
22799	314	176	21210	145	0	21845
22800	216	108	21297	144	0	21765
22801	181	97	21220	141	0	21639
22802	153	21826	312	128	0	22419
22803	21878	233	200	188	0	22499
22804	21854	127	100	203	0	22284
22805	21842	81	91	195	0	22209
22806	369	21644	105	180	0	22298
22807	231	248	97	22282	0	22858
22808	182	131	21992	323	0	22628
22809	189	114	21626	234	0	22163
22810	22354	74	295	284	0	23007
22811	23235	91	167	245	0	23738
22812	23254	89	121	228	0	23692
22813	432	70	22774	172	0	23448
22814	22773	44	307	207	0	23331
22815	383	43	207	23213	0	23846
22816	283	73	160	23010	0	23526
22817	241	82	23746	396	0	24465
22818	244	23722	281	275	0	24522
22819	238	215	193	24241	0	24887
22820	228	104	23871	352	0	24555
22821	22678	81	314	318	0	23391
22822	349	56	244	24136	0	24785
22823	280	34	207	24056	0	24577
22824	23952	49	192	440	0	24633
22825	444	44	147	23997	0	24632
22826	23936	42	138	465	0	24581
22827	24010	53	151	327	0	24541
22828	486	59	141	23980	0	24666
22829	361	41	174	24021	0	24597
22830	23775	58	166	453	0	24452
22831	424	58	161	24059	0	24702
22832	24195	66	196	402	0	24859
22833	23995	71	158	302	0	24526
22834	23953	70	160	241	0	24424
22835	537	62	153	23577	0	24329
22836	363	72	143	23608	0	24186
22837	23626	57	134	402	0	24219
22838	410	23098	119	228	0	23855
22839	244	22652	115	125	0	23136
22840	22544	179	140	159	0	23022
22841	278	108	22360	101	0	22847
22842	21709	66	194	133	0	22102
22843	289	52	110	22763	0	23214
22844	177	55	22847	176	0	23255
22845	22672	53	175	174	0	23074
22846	279	68	74	23309	0	23730
22847	254	49	80	23732	0	24115
22848	231	51	59	24248	0	24589
22849	206	45	42	24267	0	24560
22850	23562	55	48	289	0	23954
22851	195	22997	53	119	0	23364
22852	21670	101	31	119	0	21921
22853	153	75	21770	39	0	22037
22854	101	57	20742	30	0	20930
22855	100	22141	95	35	0	22371
22856	151	147	107	22068	0	22473
22857	65	50	21961	97	0	22173
22858	50	19645	80	84	0	19859
22859	21	44	20769	23	0	20857
22860	45	17	46	20480	0	20588
22861	30	11	13	20195	0	20249
22862	20488	4	10	92	0	20594
22863	51	4	7	20175	0	20237
22864	20123	2	12	115	0	20252
22865	54	15	19939	20	0	20028
22866	21	20014	37	22	0	20094
22867	48	34	12	21020	0	21114
22868	27	19	21	22434	0	22501
22869	21	24	22676	45	0	22766
22870	34	34	20696	34	0	20798
22871	21010	4	60	107	0	21181
22872	22815	6	29	100	0	22950
22873	64	8	18	22933	0	23023
22874	53	3	14	22756	0	22826
22875	20	22400	9	63	0	22492
22876	22	44	12	23257	0	23335
22877	23346	11	10	162	0	23529
22878	23481	12	7	114	0	23614
22879	90	23814	10	42	0	23956
22880	23998	75	7	98	0	24178
22881	23500	23	11	61	0	23595
22882	144	16	6	24878	0	25044
22883	43	25390	12	174	0	25619
22884	61	164	15	25851	0	26091
22885	58	41	8	25786	0	25893
22886	21	28	25166	236	0	25451
22887	25064	10	191	132	0	25397
22888	277	11	48	27849	0	28185
22889	135	12	27	29371	0	29545
22890	59	32483	23	413	0	32978
22891	125	490	6	34153	0	34774
22892	34327	141	18	708	0	35194
22893	35949	97	12	339	0	36397
22894	822	103	35450	171	0	36546
22895	332	89	35456	141	0	36018
22896	305	57	793	36370	0	37525
22897	285	41	285	37881	0	38492
22898	181	46	37483	934	0	38644
22899	154	43	37647	382	0	38226
22900	256	29	1016	35883	0	37184
22901	106	33	37923	919	0	38981
22902	113	41	37900	401	0	38455
22903	172	22	1137	37138	0	38469
22904	38001	31	506	1026	0	39564
22905	39076	23	384	531	0	40014
22906	1047	27	311	38895	0	40280
22907	495	31	256	39233	0	40015
22908	38684	33	223	1244	0	40184
22909	1017	45	211	38120	0	39393
22910	37652	23	180	1199	0	39054
22911	38271	34	175	634	0	39114
22912	1246	24	161	37955	0	39386
22913	599	61	154	38588	0	39402
22914	37706	38	137	1377	0	39258
22915	1073	36917	148	690	0	38828
22916	552	37940	171	470	0	39133
22917	465	884	156	36991	0	38496
22918	380	313	36562	1090	0	38345
22919	375	200	838	36497	0	37910
22920	36525	197	372	1260	0	38354
22921	1003	155	240	36804	0	38202
22922	36728	115	228	1252	0	38323
22923	1043	140	36367	664	0	38214
22924	35975	104	890	609	0	37578
22925	1159	82	398	36574	0	38213
22926	648	90	262	37517	0	38517
22927	516	95	37374	1332	0	39317
22928	557	90	885	37339	0	38871
22929	454	75	385	38500	0	39414
22930	422	106	289	39200	0	40017
22931	37866	90	244	1661	0	39861
22932	1056	117	37615	904	0	39692
22933	577	131	37023	734	0	38465
22934	36644	88	1098	792	0	38622
22935	37878	70	576	716	0	39240
22936	1340	84	37900	601	0	39925
22937	779	92	1123	36397	0	38391
22938	555	37483	647	1135	0	39820
22939	573	773	528	38810	0	40684
22940	38491	276	502	1455	0	40724
22941	39199	152	517	849	0	40717
22942	1319	148	514	38393	0	40374
22943	677	38005	452	1391	0	40525
22944	641	762	475	37255	0	39133
22945	606	37869	415	1278	0	40168
22946	38170	873	402	950	0	40395
22947	36075	378	384	904	0	37741
22948	37219	241	387	747	0	38594
22949	1375	35270	363	838	0	37846
22950	872	36886	342	747	0	38847
22951	787	1059	323	37207	0	39376
22952	782	438	254	37721	0	39195
22953	761	319	248	37270	0	38598
22954	762	245	234	38218	0	39459
22955	625	273	36308	1710	0	38916
22956	35037	263	920	1180	0	37400
22957	1316	285	36987	898	0	39486
22958	37256	247	1041	916	0	39460
22959	1369	276	37969	845	0	40459
22960	37569	228	1121	866	0	39784
22961	1420	230	38552	794	0	40996
22962	37723	225	1192	748	0	39888
22963	1527	177	697	38893	0	41294
22964	39678	196	504	1443	0	41821
22965	1590	160	487	40007	0	42244
22966	1047	188	423	40389	0	42047
22967	835	170	437	39061	0	40503
22968	719	36982	401	1745	0	39847
22969	37008	881	365	1193	0	39447
22970	37276	385	344	1071	0	39076
22971	1595	36879	353	931	0	39758
22972	1006	922	330	37517	0	39775
22973	722	471	36597	1563	0	39353
22974	36200	286	1025	1052	0	38563
22975	37592	266	546	927	0	39331
22976	37240	256	482	787	0	38765
22977	1805	185	387	35275	0	37652
22978	1036	34800	416	1290	0	37542
22979	913	885	371	35249	0	37418
22980	35174	400	372	1406	0	37352
22981	1582	314	349	33852	0	36097
22982	869	32968	309	1261	0	35407
22983	31926	844	279	841	0	33890
22984	1324	434	31648	651	0	34057
22985	947	362	30863	584	0	32756
22986	701	30940	1024	537	0	33202
22987	607	30356	489	474	0	31926
22988	796	977	28149	401	0	30323
22989	589	518	26037	390	0	27534
22990	554	1179	673	21055	0	23461
22991	21890	121	314	490	0	22815
22992	411	114	21770	241	0	22536
22993	211	20525	275	142	0	21153
22994	20473	255	223	181	0	21132
22995	315	20392	95	79	0	20881
22996	19432	188	63	124	0	19807
22997	207	19227	64	65	0	19563
22998	139	19614	59	54	0	19866
22999	133	224	93	19803	0	20253
23000	148	122	80	19839	0	20189
23001	103	76	18841	196	0	19216
23002	113	65	140	18506	0	18824
23003	18560	68	77	248	0	18953
23004	18714	57	45	181	0	18997
23005	229	48	40	18349	0	18666
23006	145	56	17906	188	0	18295
23007	92	63	17461	135	0	17751
23008	101	45	205	18185	0	18536
23009	81	46	18496	174	0	18797
23010	97	49	211	18234	0	18591
23011	109	56	130	17721	0	18016
23012	57	58	20057	244	0	20416
23013	19078	53	279	208	0	19618
23014	20069	39	171	157	0	20436
23015	343	38	20434	91	0	20906
23016	192	32	20857	95	0	21176
23017	171	32	464	21397	0	22064
23018	141	44	223	24704	0	25112
23019	128	37	115	25712	0	25992
23020	148	68	94	25591	0	25901
23021	25720	46	71	740	0	26577
23022	27725	55	75	393	0	28248
23023	740	45	91	29904	0	30780
23024	375	45	64	31937	0	32421
23025	145	42	33867	1009	0	35063
23026	167	24	810	35006	0	36007
23027	168	20	422	36970	0	37580
23028	37379	22	175	1560	0	39136
23029	1046	39759	138	697	0	41640
23030	611	993	113	40104	0	41821
23031	340	429	105	40991	0	41865
23032	247	159	131	40409	0	40946
23033	167	35497	139	1835	0	37638
23034	108	39825	120	902	0	40955
23035	243	1375	92	39595	0	41305
23036	232	564	84	40024	0	40904
23037	219	286	82	40865	0	41452
23038	38069	195	81	2039	0	40384
23039	1108	38795	101	1012	0	41016
23040	39190	1171	93	696	0	41150
23041	40006	582	84	570	0	41242
23042	1699	303	77	38543	0	40622
23043	719	38248	75	1460	0	40502
23044	38471	1233	49	921	0	40674
23045	1416	577	44	38711	0	40748
23046	39045	330	47	1648	0	41070
23047	1528	272	57	39643	0	41500
23048	763	286	38946	1609	0	41604
23049	467	208	39954	986	0	41615
23050	427	206	1486	40000	0	42119
23051	427	221	611	40989	0	42248
23052	410	224	274	40275	0	41183
23053	366	37906	211	1942	0	40425
23054	325	41122	164	1092	0	42703
23055	39850	1486	151	850	0	42337
23056	39657	684	164	736	0	41241
23057	1617	38689	159	595	0	41060
23058	755	37785	140	485	0	39165
23059	415	40189	118	565	0	41287
23060	37835	1603	110	634	0	40182
23061	1228	38631	116	552	0	40527
23062	735	1397	131	38828	0	41091
23063	38638	717	127	1422	0	40904
23064	39082	431	119	847	0	40479
23065	1805	338	119	37738	0	40000
23066	805	366	36822	1475	0	39468
23067	494	346	37372	866	0	39078
23068	530	358	1413	37448	0	39749
23069	439	319	38319	1516	0	40593
23070	464	292	1248	38331	0	40335
23071	492	293	617	38757	0	40159
23072	375	292	38027	1885	0	40579
23073	355	308	38323	976	0	39962
23074	417	257	1628	38035	0	40337
23075	357	285	709	40035	0	41386
23076	38026	283	430	2072	0	40811
23077	1277	37542	336	1133	0	40288
23078	686	39988	288	866	0	41828
23079	38420	1571	262	888	0	41141
23080	39806	735	300	781	0	41622
23081	1743	38467	311	757	0	41278
23082	841	39954	279	770	0	41844
23083	39497	1670	266	781	0	42214
23084	1518	813	238	39522	0	42091
23085	38920	517	264	1771	0	41472
23086	1501	38864	279	1304	0	41948
23087	39406	1335	259	968	0	41968
23088	1663	720	38556	843	0	41782
23089	38512	462	1220	881	0	41075
23090	1701	442	39003	747	0	41893
23091	988	472	1347	38806	0	41613
23092	38557	410	695	1853	0	41515
23093	1573	417	37691	1221	0	40902
23094	983	450	1287	38326	0	41046
23095	37766	446	681	1892	0	40785
23096	1639	503	37651	1229	0	41022
23097	1084	472	1310	38391	0	41257
23098	37648	463	674	1854	0	40639
23099	1584	37399	351	1302	0	40636
23100	1041	1403	313	38555	0	41312
23101	843	859	300	37899	0	39901
23102	749	629	246	39002	0	40626
23103	740	38350	274	2046	0	41410
23104	743	1483	245	39871	0	42342
23105	778	765	251	40707	0	42501
23106	782	555	269	40576	0	42182
23107	825	498	271	41391	0	42985
23108	732	484	39268	2201	0	42685
23109	37343	416	1250	1399	0	40408
23110	39653	359	676	1029	0	41717
23111	1880	39034	445	892	0	42251
23112	1047	1240	359	37852	0	40498
23113	720	646	378	38177	0	39921
23114	615	37361	346	1989	0	40311
23115	578	1077	349	37852	0	39856
23116	35926	567	354	1750	0	38597
23117	1179	35121	376	1091	0	37767
23118	32885	993	345	732	0	34955
23119	1170	523	258	32627	0	34578
23120	603	304	32011	1404	0	34322
23121	373	32119	926	874	0	34292
23122	29501	977	543	668	0	31689
23123	872	27538	221	434	0	29065
23124	431	27199	183	352	0	28165
23125	23666	596	254	344	0	24860
23126	572	256	23486	243	0	24557
23127	237	21684	339	176	0	22436
23128	18799	554	826	243	0	20422
23129	17228	107	110	103	0	17548
23130	186	17205	28	51	0	17470
23131	104	161	23	17831	0	18119
23132	60	82	18364	177	0	18683
23133	86	73	134	18181	0	18474
23134	108	51	47	17584	0	17790
23135	69	56	32	18988	0	19145
23136	60	45	18976	215	0	19296
23137	103	44	126	18287	0	18560
23138	50	37	18787	182	0	19056
23139	61	61	17278	89	0	17489
23140	16026	60	155	122	0	16363
23141	149	18185	73	52	0	18459
23142	66	18637	47	56	0	18806
23143	110	185	52	19147	0	19494
23144	20479	70	37	266	0	20852
23145	20607	50	33	137	0	20827
23146	20012	54	32	126	0	20224
23147	20307	34	22	109	0	20472
23148	19539	37	37	80	0	19693
23149	229	49	18954	57	0	19289
23150	129	33	166	18905	0	19233
23151	73	18188	78	188	0	18527
23152	73	163	50	18944	0	19230
23153	19222	76	27	259	0	19584
23154	174	18772	47	114	0	19107
23155	107	178	38	19533	0	19856
23156	19512	95	36	243	0	19886
23157	20041	49	38	162	0	20290
23158	280	42	45	20008	0	20375
23159	161	58	25	19608	0	19852
23160	117	47	31	20036	0	20231
23161	86	51	19636	275	0	20048
23162	93	58	19450	135	0	19736
23163	110	50	212	20141	0	20513
23164	117	45	88	20531	0	20781
23165	20445	55	64	305	0	20869
23166	20213	52	29	214	0	20508
23167	20404	51	42	166	0	20663
23168	20650	48	35	179	0	20912
23169	20376	46	30	143	0	20595
23170	290	20721	35	105	0	21151
23171	21403	193	34	181	0	21811
23172	21588	95	36	170	0	21889
23173	21546	61	52	144	0	21803
23174	326	39	52	22150	0	22567
23175	178	56	21888	273	0	22395
23176	162	46	213	22270	0	22691
23177	146	51	23550	317	0	24064
23178	160	57	245	22607	0	23069
23179	105	23412	114	281	0	23912
23180	23722	244	73	190	0	24229
23181	24360	104	61	168	0	24693
23182	411	68	28	24626	0	25133
23183	228	57	38	25758	0	26081
23184	189	45	26	25877	0	26137
23185	152	26267	50	356	0	26825
23186	26304	271	52	202	0	26829
23187	26286	100	46	178	0	26610
23188	404	26360	45	111	0	26920
23189	221	308	43	26654	0	27226
23190	185	95	39	26335	0	26654
23191	131	26636	61	345	0	27173
23192	27096	292	42	226	0	27656
23193	27208	98	60	165	0	27531
23194	437	71	47	27247	0	27802
23195	176	84	27298	370	0	27928
23196	150	76	25761	168	0	26155
23197	181	56	357	27922	0	28516
23198	177	59	118	28011	0	28365
23199	170	50	74	28857	0	29151
23200	28136	47	64	588	0	28835
23201	28270	56	39	314	0	28679
23202	459	29008	69	183	0	29719
23203	28934	351	67	209	0	29561
23204	481	148	28674	99	0	29402
23205	213	96	28005	121	0	28435
23206	173	29750	431	116	0	30470
23207	29132	375	221	187	0	29915
23208	364	28985	89	170	0	29608
23209	29024	360	81	151	0	29616
23210	435	133	28788	99	0	29455
23211	192	101	28299	91	0	28683
23212	216	74	388	28215	0	28893
23213	135	73	29442	388	0	30038
23214	160	59	387	29691	0	30297
23215	309	95	178	25150	0	25732
23216	104	29725	109	485	0	30423
23217	134	339	104	30570	0	31147
23218	153	126	87	31142	0	31508
23219	32258	103	97	571	0	33029
23220	461	32125	98	230	0	32914
23221	245	426	90	33202	0	33963
23222	190	153	33000	521	0	33864
23223	29014	112	469	377	0	29972
23224	527	90	32828	219	0	33664
23225	262	118	470	32137	0	32987
23226	199	34026	178	506	0	34909
23227	201	536	110	34182	0	35029
23228	34567	191	113	646	0	35517
23229	34596	124	110	339	0	35169
23230	704	35174	116	205	0	36199
23231	36018	562	93	312	0	36985
23232	36013	237	87	308	0	36645
23233	35731	160	82	317	0	36290
23234	37113	112	77	291	0	37593
23235	34380	133	106	316	0	34935
23236	725	106	36017	198	0	37046
23237	432	99	570	35698	0	36799
23238	384	122	242	34395	0	35143
23239	256	105	155	36097	0	36613
23240	215	35923	117	807	0	37062
23241	264	567	97	35902	0	36830
23242	258	238	35815	651	0	36962
23243	213	34625	550	321	0	35709
23244	205	34670	205	272	0	35352
23245	281	641	185	34657	0	35764
23246	248	241	139	34823	0	35451
23247	235	163	148	34360	0	34906
23248	197	33102	112	765	0	34176
23249	184	34273	141	349	0	34947
23250	33977	631	117	312	0	35037
23251	34174	284	114	269	0	34841
23252	670	34252	137	239	0	35298
23253	34623	563	122	305	0	35613
23254	35630	218	128	327	0	36303
23255	738	194	144	35804	0	36880
23256	388	164	133	36993	0	37678
23257	314	138	134	37122	0	37708
23258	235	174	36787	804	0	38000
23259	223	190	35805	396	0	36614
23260	232	38494	699	320	0	39745
23261	39056	666	271	338	0	40331
23262	746	317	39224	266	0	40553
23263	37994	194	694	367	0	39249
23264	842	190	41131	257	0	42420
23265	40405	169	833	343	0	41750
23266	926	42619	360	231	0	44136
23267	42913	864	230	319	0	44326
23268	1051	349	181	42426	0	44007
23269	544	243	168	43201	0	44156
23270	368	239	42275	1069	0	43951
23271	301	43677	760	501	0	45239
23272	394	894	305	44192	0	45785
23273	291	376	43920	896	0	45483
23274	39015	240	809	594	0	40658
23275	848	42982	369	344	0	44543
23276	42634	756	252	366	0	44008
23277	857	41508	201	283	0	42849
23278	445	868	149	41618	0	43080
23279	41141	339	154	967	0	42601
23280	845	41396	162	423	0	42826
23281	467	812	147	41582	0	43008
23282	312	386	40832	874	0	42404
23283	38185	242	728	486	0	39641
23284	920	244	292	40361	0	41817
23285	424	195	39779	859	0	41257
23286	304	39575	711	445	0	41035
23287	290	744	316	39930	0	41280
23288	291	363	39958	807	0	41419
23289	344	257	757	38102	0	39460
23290	286	39577	320	809	0	40992
23291	274	40783	210	411	0	41678
23292	276	915	40279	261	0	41731
23293	323	438	705	39600	0	41066
23294	204	267	40494	835	0	41800
23295	38912	205	781	492	0	40390
23296	827	202	316	39052	0	40397
23297	341	38098	212	731	0	39382
23298	232	39960	177	350	0	40719
23299	39080	847	183	352	0	40462
23300	689	40318	151	222	0	41380
23301	40207	728	177	304	0	41416
23302	765	325	39531	208	0	40829
23303	37361	180	642	301	0	38484
23304	715	39117	261	171	0	40264
23305	39170	721	178	223	0	40292
23306	710	38600	139	191	0	39640
23307	386	739	136	38077	0	39338
23308	286	317	126	39572	0	40301
23309	184	229	38917	847	0	40177
23310	36466	182	656	464	0	37768
23311	677	244	39207	213	0	40341
23312	39555	172	700	237	0	40664
23313	823	198	294	39375	0	40690
23314	416	187	159	39576	0	40338
23315	211	40079	145	932	0	41367
23316	266	767	198	40861	0	42092
23317	306	343	151	41860	0	42660
23318	207	221	40832	1040	0	42300
23319	36338	139	741	539	0	37757
23320	743	39041	335	289	0	40408
23321	38877	697	147	300	0	40021
23322	787	324	136	38778	0	40025
23323	398	215	116	39236	0	39965
23324	38456	145	144	1004	0	39749
23325	755	38978	167	406	0	40306
23326	37673	653	120	292	0	38738
23327	749	37069	133	198	0	38149
23328	356	37592	106	160	0	38214
23329	37316	830	150	213	0	38509
23330	785	340	116	36663	0	37904
23331	339	247	36628	706	0	37920
23332	288	195	630	35954	0	37067
23333	238	167	262	36100	0	36767
23334	194	36159	149	862	0	37364
23335	251	684	124	37042	0	38101
23336	242	318	115	37076	0	37751
23337	221	196	87	37810	0	38314
23338	187	165	108	38441	0	38901
23339	147	189	37431	1075	0	38842
23340	130	200	37848	504	0	38682
23341	196	172	851	38751	0	39970
23342	138	192	38924	899	0	40153
23343	208	150	38131	460	0	38949
23344	222	148	962	38761	0	40093
23345	159	175	40135	910	0	41379
23346	279	143	849	38142	0	39413
23347	121	39622	405	920	0	41068
23348	42419	807	259	572	0	44057
23349	912	353	46463	344	0	48072
23350	484	209	1069	46453	0	48215
23351	246	193	48075	1151	0	49665
23352	285	180	1146	50223	0	51834
23353	291	158	524	51744	0	52717
23354	50687	143	358	1796	0	52984
23355	1354	135	263	51700	0	53452
23356	48968	151	283	1625	0	51027
23357	50246	91	272	886	0	51495
23358	1528	49326	237	559	0	51650
23359	48778	1112	220	518	0	50628
23360	1351	47233	213	396	0	49193
23361	576	48933	203	394	0	50106
23362	47379	1430	297	429	0	49535
23363	1284	583	47420	321	0	49608
23364	564	313	46117	255	0	47249
23365	44397	248	1566	317	0	46528
23366	45424	218	559	361	0	46562
23367	1391	45259	322	265	0	47237
23368	46129	997	247	359	0	47732
23369	46627	435	241	356	0	47659
23370	45990	247	192	306	0	46735
23371	1728	193	198	44441	0	46560
23372	44340	216	158	1227	0	45941
23373	1383	45291	198	529	0	47401
23374	844	1075	149	46458	0	48526
23375	637	489	186	46761	0	48073
23376	504	46529	234	1394	0	48661
23377	493	1070	246	47357	0	49166
23378	46563	517	254	1427	0	48761
23379	47132	328	223	815	0	48498
23380	1581	45074	212	566	0	47433
23381	828	46944	194	430	0	48396
23382	46730	1336	160	467	0	48693
23383	1479	602	45696	395	0	48172
23384	909	416	45611	360	0	47296
23385	754	365	1304	45002	0	47425
23386	661	377	555	46503	0	48096
23387	579	360	45531	1438	0	47908
23388	535	42927	1154	784	0	45400
23389	698	1183	575	41499	0	43955
23390	517	637	45130	1259	0	47543
23391	599	375	1168	44760	0	46902
23392	604	326	625	44523	0	46078
23393	494	46084	376	1506	0	48460
23394	589	1221	269	46213	0	48292
23395	556	640	291	46839	0	48326
23396	598	406	302	47462	0	48768
23397	46393	325	287	1767	0	48772
23398	1420	329	277	45221	0	47247
23399	737	45755	220	1506	0	48218
23400	45495	1154	267	917	0	47833
23401	1361	627	44510	622	0	47120
23402	801	388	43839	582	0	45610
23403	43848	321	1434	680	0	46283
23404	1373	352	689	44867	0	47281
23405	789	400	44922	1389	0	47500
23406	668	302	1185	44803	0	46958
23407	518	334	660	46387	0	47899
23408	45226	293	414	1822	0	47755
23409	45282	301	352	1144	0	47079
23410	1617	45179	353	746	0	47895
23411	954	1071	339	44870	0	47234
23412	593	592	44752	1382	0	47319
23413	496	46217	1121	911	0	48745
23414	46110	1084	601	786	0	48581
23415	1245	47765	460	628	0	50098
23416	47913	1247	378	577	0	50115
23417	1412	626	47119	532	0	49689
23418	47002	439	1157	605	0	49203
23419	49464	349	598	569	0	50980
23420	1702	359	49572	549	0	52182
23421	963	394	1245	47999	0	50601
23422	719	46808	639	1338	0	49504
23423	574	50479	421	825	0	52299
23424	565	51375	322	672	0	52934
23425	727	1644	315	49465	0	52151
23426	530	747	50461	1374	0	53112
23427	652	549	1147	49975	0	52323
23428	615	455	518	51724	0	53312
23429	525	423	50676	1597	0	53221
23430	472	50424	1259	858	0	53013
23431	575	1198	628	49670	0	52071
23432	50171	592	413	1476	0	52652
23433	1400	400	391	50282	0	52473
23434	775	352	379	49838	0	51344
23435	605	49253	262	1717	0	51837
23436	49635	1218	276	949	0	52078
23437	1473	676	254	50706	0	53109
23438	753	494	49750	1404	0	52401
23439	462	49634	1099	865	0	52060
23440	48809	1176	562	653	0	51200
23441	1223	645	49186	450	0	51504
23442	47789	482	1129	573	0	49973
23443	1371	392	551	47866	0	50180
23444	632	49058	466	1166	0	51322
23445	48279	1125	354	727	0	50485
23446	47825	585	317	637	0	49364
23447	1422	48740	297	459	0	50918
23448	821	960	264	46386	0	48431
23449	410	393	178	43935	0	44916
23450	42433	268	170	1131	0	44002
23451	803	42247	192	555	0	43797
23452	372	696	125	39456	0	40649
23453	234	38754	152	633	0	39773
23454	194	38891	108	301	0	39494
23455	240	626	132	38099	0	39097
23456	37650	258	122	667	0	38697
23457	493	38006	117	274	0	38890
23458	281	518	83	37907	0	38789
23459	225	233	78	38200	0	38736
23460	189	209	37482	579	0	38459
23461	195	195	35111	336	0	35837
23462	135	36895	491	308	0	37829
23463	158	504	36170	202	0	37034
23464	218	262	478	35908	0	36866
23465	147	210	35937	503	0	36797
23466	198	139	465	37004	0	37806
23467	155	156	184	37746	0	38241
23468	158	156	144	38002	0	38460
23469	37062	157	124	736	0	38079
23470	484	152	93	37070	0	37799
23471	264	157	80	36876	0	37377
23472	180	36661	93	613	0	37547
23473	165	453	76	35862	0	36556
23474	35129	196	84	736	0	36145
23475	409	36138	109	347	0	37003
23476	35984	490	95	411	0	36980
23477	521	251	35989	269	0	37030
23478	263	237	36306	215	0	37021
23479	269	204	540	37492	0	38505
23480	239	155	273	38321	0	38988
23481	148	38329	241	674	0	39392
23482	283	547	167	35205	0	36202
23483	38190	238	139	796	0	39363
23484	37273	202	158	493	0	38126
23485	659	195	151	38738	0	39743
23486	318	199	40773	728	0	42018
23487	322	175	500	41220	0	42217
23488	256	171	254	42714	0	43395
23489	184	151	223	43236	0	43794
23490	209	169	164	42782	0	43324
23491	188	188	126	41775	0	42277
23492	142	42103	140	960	0	43345
23493	41100	583	161	654	0	42498
23494	41403	267	147	559	0	42376
23495	41766	201	142	534	0	42643
23496	762	42530	141	417	0	43850
23497	41939	618	126	512	0	43195
23498	735	42273	118	397	0	43523
23499	356	735	41773	319	0	43183
23500	422	314	563	40794	0	42093
23501	278	236	42205	804	0	43523
23502	227	42644	691	482	0	44044
23503	42010	693	269	529	0	43501
23504	721	306	43148	364	0	44539
23505	338	298	44770	343	0	45749
23506	282	46740	928	354	0	48304
23507	343	817	505	47248	0	48913
23508	292	445	50156	962	0	51855
23509	479	328	951	47747	0	49505
23510	357	261	477	54433	0	55528
23511	386	178	297	57416	0	58277
23512	57650	194	216	1818	0	59878
23513	57397	166	197	1060	0	58820
23514	1721	191	155	56696	0	58763
23515	56093	132	152	1602	0	57979
23516	1413	145	54548	781	0	56887
23517	735	131	53552	578	0	54996
23518	556	115	53796	470	0	54937
23519	439	106	54225	455	0	55225
23520	360	53194	1480	411	0	55445
23521	727	954	944	51833	0	54458
23522	414	404	53666	1058	0	55542
23523	48841	236	1276	781	0	51134
23524	52903	165	744	600	0	54412
23525	1436	52550	632	417	0	55035
23526	52293	965	596	468	0	54322
23527	1463	439	567	51975	0	54444
23528	717	323	53310	1132	0	55482
23529	758	279	1343	49718	0	52098
23530	434	54137	818	1100	0	56489
23531	51479	1056	603	897	0	54035
23532	54052	559	492	638	0	55741
23533	1516	54196	451	454	0	56617
23534	54854	1150	409	491	0	56904
23535	54774	596	370	542	0	56282
23536	1740	54712	404	358	0	57214
23537	1118	1228	292	52552	0	55190
23538	719	53701	336	1161	0	55917
23539	54187	1323	307	744	0	56561
23540	1602	765	320	53809	0	56496
23541	54059	519	285	1360	0	56223
23542	1702	530	249	53590	0	56071
23543	1086	485	52813	1307	0	55691
23544	51367	472	1030	912	0	53781
23545	1609	448	52882	558	0	55497
23546	1144	428	1191	52386	0	55149
23547	817	428	52059	1329	0	54633
23548	851	410	1272	51835	0	54368
23549	722	362	52002	1506	0	54592
23550	49764	356	1315	1052	0	52487
23551	1491	51421	792	757	0	54461
23552	51764	1121	623	739	0	54247
23553	1671	569	582	51269	0	54091
23554	50777	365	557	1569	0	53268
23555	1516	50326	619	790	0	53251
23556	931	49885	538	699	0	52053
23557	688	52486	589	597	0	54360
23558	52469	1492	441	781	0	55183
23559	1512	786	535	52282	0	55115
23560	1041	603	374	53134	0	55152
23561	767	557	51807	1692	0	54823
23562	812	509	51192	934	0	53447
23563	860	504	1445	52257	0	55066
23564	777	485	53169	1460	0	55891
23565	579	52294	1371	958	0	55202
23566	51556	1310	843	818	0	54527
23567	1444	781	52510	631	0	55366
23568	941	567	52201	575	0	54284
23569	713	489	1738	51509	0	54449
23570	52528	427	1031	1627	0	55613
23571	1514	373	818	52958	0	55663
23572	52736	360	730	1740	0	55566
23573	1591	397	778	52787	0	55553
23574	969	432	53068	1536	0	56005
23575	796	51536	1558	927	0	54817
23576	736	1196	52920	727	0	55579
23577	586	52671	1630	800	0	55687
23578	731	1386	1061	51633	0	54811
23579	51095	672	763	1637	0	54167
23580	1470	483	51312	934	0	54199
23581	1005	385	1390	50790	0	53570
23582	885	420	827	52270	0	54402
23583	52546	379	611	1929	0	55465
23584	1556	426	626	51381	0	53989
23585	815	52108	702	1466	0	55091
23586	49904	1226	636	1106	0	52872
23587	1389	783	49472	778	0	52422
23588	47247	530	1298	786	0	49861
23589	1540	49008	713	616	0	51877
23590	1054	1247	535	46792	0	49628
23591	796	49568	487	1316	0	52167
23592	49004	1252	474	995	0	51725
23593	1528	764	48976	690	0	51958
23594	47286	628	1189	785	0	49888
23595	1555	49515	685	596	0	52351
23596	1105	1180	476	49653	0	52414
23597	50195	715	505	1417	0	52832
23598	50899	514	483	894	0	52790
23599	1726	538	492	50392	0	53148
23600	1152	507	373	50697	0	52729
23601	785	50384	445	1547	0	53161
23602	923	1308	362	50323	0	52916
23603	719	57399	401	1397	0	59916
23604	683	60086	388	961	0	62118
23605	790	2076	321	53651	0	56838
23606	616	56004	268	1378	0	58266
23607	675	1386	56258	679	0	58998
23608	776	705	55447	664	0	57592
23609	457	56537	1441	694	0	59129
23610	397	1223	54766	361	0	56747
23611	321	585	53944	282	0	55132
23612	212	324	51752	159	0	52447
23613	104	51219	1504	172	0	52999
23614	49737	1070	986	321	0	52114
23615	873	50190	429	166	0	51658
23616	456	1165	50278	98	0	51997
23617	471	573	1067	48990	0	51101
23618	49452	394	552	1027	0	51425
23619	971	314	49371	447	0	51103
23620	607	199	1172	48985	0	50963
23621	319	195	50135	1005	0	51654
23622	349	182	1279	49128	0	50938
23623	48768	192	693	1271	0	50924
23624	1025	187	50077	582	0	51871
23625	497	50510	1233	388	0	52628
23626	504	1070	656	49112	0	51342
23627	51850	576	437	1153	0	54016
23628	1139	433	51084	498	0	53154
23629	799	318	1229	47268	0	49614
23630	377	50462	704	1023	0	52566
23631	51420	1100	505	653	0	53678
23632	52869	526	410	507	0	54312
23633	1719	409	361	51546	0	54035
23634	794	51623	384	1233	0	54034
23635	507	54900	356	655	0	56418
23636	55915	1605	311	551	0	58382
23637	1611	850	282	54200	0	56943
23638	723	56318	318	1323	0	58682
23639	56158	1563	240	809	0	58770
23640	1607	755	287	56530	0	59179
23641	899	475	289	57627	0	59290
23642	588	383	53782	1890	0	56643
23643	380	55329	1288	1009	0	58006
23644	317	59049	593	689	0	60648
23645	490	1833	438	58437	0	61198
23646	58270	879	340	1706	0	61195
23647	1449	58896	283	849	0	61477
23648	58695	1665	273	690	0	61323
23649	1696	58794	274	454	0	61218
23650	998	1715	252	59051	0	62016
23651	59294	896	214	1657	0	62061
23652	1745	657	272	59401	0	62075
23653	872	553	59127	1762	0	62314
23654	707	506	1393	56607	0	59213
23655	521	58819	699	1714	0	61753
23656	58342	1598	439	1026	0	61405
23657	1581	58785	373	653	0	61392
23658	941	1825	269	57114	0	60149
23659	693	1033	258	58967	0	60951
23660	557	701	57075	2025	0	60358
23661	487	576	57047	1129	0	59239
23662	488	592	1827	56818	0	59725
23663	438	525	56616	1792	0	59371
23664	370	56278	1725	1063	0	59436
23665	56149	1596	852	898	0	59495
23666	1532	927	57277	593	0	60329
23667	56169	738	1596	649	0	59152
23668	58623	600	792	633	0	60648
23669	58609	479	601	644	0	60333
23670	59107	492	514	536	0	60649
23671	2412	514	436	57184	0	60546
23672	1370	462	448	55847	0	58127
23673	864	55713	440	1939	0	58956
23674	55975	1569	462	1194	0	59200
23675	1784	896	55150	751	0	58581
23676	1039	680	1531	54508	0	57758
23677	790	559	901	55453	0	57703
23678	678	443	53739	2100	0	56960
23679	558	54116	1652	1183	0	57509
23680	822	1566	923	50452	0	53763
23681	670	885	588	55854	0	57997
23682	53909	670	493	2238	0	57310
23683	1615	53544	409	1380	0	56948
23684	1069	1519	448	52799	0	55835
23685	699	53301	512	1804	0	56316
23686	725	1712	381	54403	0	57221
23687	53037	868	440	2096	0	56441
23688	54133	694	449	1232	0	56508
23689	2187	561	367	53480	0	56595
23690	53167	434	388	2032	0	56021
23691	53279	436	360	1231	0	55306
23692	2277	52139	361	862	0	55639
23693	1471	1536	299	50669	0	53975
23694	1028	52128	296	1644	0	55096
23695	902	1707	267	52242	0	55118
23696	51757	935	250	2051	0	54993
23697	1814	754	259	51491	0	54318
23698	1223	637	236	52218	0	54314
23699	862	527	49780	2291	0	53460
23700	780	46832	1260	1403	0	50275
23701	660	50102	621	1063	0	52446
23702	48352	1769	465	981	0	51567
23703	1433	896	248	40462	0	43039
23704	38587	461	171	1384	0	40603
23705	1276	37281	203	840	0	39600
23706	730	35331	170	632	0	36863
23707	500	37100	159	527	0	38286
23708	33090	1038	464	516	0	35108
23709	821	33672	134	358	0	34985
23710	33230	757	396	466	0	34849
23711	32777	366	104	333	0	33580
23712	33686	247	88	349	0	34370
23713	947	215	95	34931	0	36188
23714	484	216	83	35620	0	36403
23715	385	214	89	35911	0	36599
23716	324	202	83	35547	0	36156
23717	35138	169	106	1157	0	36570
23718	834	34532	113	528	0	36007
23719	463	719	82	34760	0	36024
23720	34755	303	101	905	0	36064
23721	866	226	72	34333	0	35497
23722	458	168	76	34589	0	35291
23723	33896	158	89	1114	0	35257
23724	835	169	32857	515	0	34376
23725	449	163	598	32638	0	33848
23726	305	126	32976	834	0	34241
23727	278	150	636	31944	0	33008
23728	275	216	229	32189	0	32909
23729	31128	122	122	999	0	32371
23730	691	30211	101	469	0	31472
23731	310	29722	56	301	0	30389
23732	28525	551	47	263	0	29386
23733	550	28858	62	175	0	29645
23734	28825	438	111	334	0	29708
23735	558	161	28332	184	0	29235
23736	25842	72	299	184	0	26397
23737	26801	50	87	169	0	27107
23738	26952	24	49	166	0	27191
23739	431	39	45	26281	0	26796
23740	199	40	33	26216	0	26488
23741	84	26132	45	400	0	26661
23742	127	395	35	25930	0	26487
23743	25523	106	24	432	0	26085
23744	321	24902	32	156	0	25411
23745	110	24955	20	77	0	25162
23746	24723	289	16	129	0	25157
23747	297	124	24619	46	0	25086
23748	179	58	229	24127	0	24593
23749	68	60	24735	261	0	25124
23750	113	22	244	24087	0	24466
23751	67	24409	94	235	0	24805
23752	106	248	26	25114	0	25494
23753	24584	87	27	356	0	25054
23754	311	45	15	24718	0	25089
23755	106	63	25310	297	0	25776
23756	23093	33	267	249	0	23642
23757	328	25061	113	92	0	25594
23758	138	26777	52	93	0	27060
23759	27817	384	31	177	0	28409
23760	29164	156	44	160	0	29524
23761	555	100	29097	60	0	29812
23762	27845	47	393	165	0	28450
23763	488	29165	141	83	0	29877
23764	29589	425	65	137	0	30216
23765	562	156	39	28093	0	28850
23766	217	26732	34	395	0	27378
23767	27227	443	42	238	0	27950
23768	532	174	26974	108	0	27788
23769	285	103	409	27327	0	28124
23770	28022	86	144	541	0	28793
23771	550	86	27886	184	0	28706
23772	27906	78	445	212	0	28641
23773	613	88	161	27693	0	28555
23774	323	60	103	28470	0	28956
23775	168	70	28675	606	0	29519
23776	204	66	455	28490	0	29215
23777	28879	49	180	660	0	29768
23778	541	28424	140	259	0	29364
23779	28779	476	74	253	0	29582
23780	29014	200	63	225	0	29502
23781	726	116	51	28807	0	29700
23782	319	109	29208	548	0	30184
23783	250	65	482	29255	0	30052
23784	29493	63	195	665	0	30416
23785	567	29239	153	286	0	30245
23786	30248	480	82	254	0	31064
23787	721	190	61	30034	0	31006
23788	353	116	87	30668	0	31224
23789	268	63	99	31007	0	31437
23790	178	97	30236	801	0	31312
23791	256	85	494	30499	0	31334
23792	197	101	30368	654	0	31320
23793	190	107	30667	313	0	31277
23794	272	90	663	34863	0	35888
23795	185	90	35385	832	0	36492
23796	37285	69	824	488	0	38666
23797	1037	75	338	38788	0	40238
23798	550	63	256	38389	0	39258
23799	317	39335	195	1193	0	41040
23800	39670	877	158	741	0	41446
23801	40962	384	130	507	0	41983
23802	1330	41194	139	274	0	42937
23803	771	951	97	41187	0	43006
23804	440	419	41440	1035	0	43334
23805	39995	259	962	696	0	41912
23806	42338	152	460	508	0	43458
23807	1452	148	313	40649	0	42562
23808	749	146	39701	1076	0	41672
23809	494	39459	967	521	0	41441
23810	38825	977	434	515	0	40751
23811	1206	443	39304	380	0	41333
23812	586	38723	1071	310	0	40690
23813	37264	965	498	351	0	39078
23814	37516	396	352	335	0	38599
23815	1433	329	216	36499	0	38477
23816	769	36695	188	952	0	38604
23817	650	965	180	38756	0	40551
23818	443	466	223	39663	0	40795
23819	479	375	199	38293	0	39346
23820	474	219	167	40015	0	40875
23821	345	207	38872	1597	0	41021
23822	464	189	978	39519	0	41150
23823	432	236	429	40426	0	41523
23824	386	195	39247	1498	0	41326
23825	300	39292	1059	873	0	41524
23826	39080	1071	473	685	0	41309
23827	39952	472	357	572	0	41353
23828	1479	337	277	39796	0	41889
23829	40191	237	218	1374	0	42020
23830	1481	221	191	41151	0	43044
23831	719	201	41002	1577	0	43499
23832	558	210	40599	921	0	42288
23833	360	40959	1339	764	0	43422
23834	40206	1042	697	701	0	42646
23835	1276	531	42561	520	0	44888
23836	862	389	1247	40791	0	43289
23837	760	226	689	43156	0	44831
23838	586	225	523	44667	0	46001
23839	536	220	302	44740	0	45798
23840	540	231	318	44425	0	45514
23841	402	278	42821	2350	0	45851
23842	506	248	1298	43417	0	45469
23843	42575	196	713	1985	0	45469
23844	1433	42397	517	1176	0	45523
23845	42386	1219	441	975	0	45021
23846	1571	42755	440	762	0	45528
23847	42946	1491	357	747	0	45541
23848	44438	714	375	684	0	46211
23849	2056	507	343	43246	0	46152
23850	1222	309	294	44544	0	46369
23851	43362	276	358	2140	0	46136
23852	42442	299	291	1491	0	44523
23853	43397	250	280	1093	0	45020
23854	2055	40766	342	852	0	44015
23855	1088	42083	295	738	0	44204
23856	855	1478	41347	697	0	44377
23857	741	988	1211	40693	0	43633
23858	621	518	40078	1675	0	42892
23859	562	38788	1349	1101	0	41800
23860	504	1163	664	37744	0	40075
23861	580	626	396	38226	0	39828
23862	641	450	282	39099	0	40472
23863	37650	330	289	2031	0	40300
23864	37923	311	267	1276	0	39777
23865	1712	37856	271	886	0	40725
23866	1117	1103	302	38302	0	40824
23867	818	667	38029	1403	0	40917
23868	633	579	36821	919	0	38952
23869	37311	422	1516	750	0	39999
23870	38339	358	843	720	0	40260
23871	1713	326	551	37919	0	40509
23872	38212	263	450	1626	0	40551
23873	1569	273	37384	1105	0	40331
23874	936	36951	1221	961	0	40069
23875	825	1160	706	37209	0	39900
23876	577	705	38242	1572	0	41096
23877	612	469	1277	38733	0	41091
23878	590	339	789	39782	0	41500
23879	546	353	39255	2023	0	42177
23880	37745	271	1205	1496	0	40717
23881	40030	284	723	1164	0	42201
23882	1642	41191	565	946	0	44344
23883	42420	1211	445	842	0	44918
23884	43601	690	432	795	0	45518
23885	2172	474	41990	795	0	45431
23886	42229	374	1282	785	0	44670
23887	1890	44259	751	671	0	47571
23888	44779	1354	491	755	0	47379
23889	46111	750	440	680	0	47981
23890	46955	548	401	611	0	48515
23891	44198	414	343	758	0	45713
23892	46539	359	358	725	0	47981
23893	2422	44628	356	668	0	48074
23894	41161	1027	230	512	0	42930
23895	1627	40176	288	408	0	42499
23896	870	35962	234	304	0	37370
23897	620	38470	237	295	0	39622
23898	37697	1281	515	328	0	39821
23899	37680	633	206	365	0	38884
23900	1512	346	35918	276	0	38052
23901	38089	290	832	305	0	39516
23902	38206	226	444	355	0	39231
23903	1566	236	38501	316	0	40619
23904	981	202	990	38011	0	40184
23905	808	228	548	36216	0	37800
23906	550	229	282	40276	0	41337
23907	574	211	203	40136	0	41124
23908	588	200	183	40419	0	41390
23909	440	224	38950	1575	0	41189
23910	435	38677	982	800	0	40894
23911	37833	992	540	522	0	39887
23912	1217	38262	313	362	0	40154
23913	38438	1085	248	361	0	40132
23914	38499	586	215	324	0	39624
23915	1670	354	37132	279	0	39435
23916	1065	359	958	33930	0	36312
23917	623	35716	599	932	0	37870
23918	36260	980	316	584	0	38140
23919	36302	589	235	478	0	37604
23920	37055	348	215	386	0	38004
23921	1671	36815	218	309	0	39013
23922	37440	915	217	344	0	38916
23923	37942	544	186	345	0	39017
23924	38197	368	156	285	0	39006
23925	1830	297	167	36567	0	38861
23926	1170	246	163	37173	0	38752
23927	827	268	151	37809	0	39055
23928	36814	276	154	1387	0	38631
23929	1323	36715	123	681	0	38842
23930	36460	889	118	405	0	37872
23931	35812	529	146	283	0	36770
23932	34563	349	124	280	0	35316
23933	35121	297	112	232	0	35762
23934	1620	33764	112	175	0	35671
23935	31778	754	66	209	0	32807
23936	1210	30618	82	152	0	32062
23937	727	31066	127	156	0	32076
23938	31395	873	83	246	0	32597
23939	1022	30485	97	160	0	31764
23940	682	31527	90	191	0	32490
23941	31561	908	128	237	0	32834
23942	31887	485	60	229	0	32661
23943	1195	325	67	30859	0	32446
23944	762	267	53	31401	0	32483
23945	31391	274	61	986	0	32712
23946	32438	240	107	500	0	33285
23947	31177	284	92	363	0	31916
23948	1196	266	30693	184	0	32339
23949	32258	316	572	270	0	33416
23950	1162	231	264	32233	0	33890
23951	795	234	142	32623	0	33794
23952	626	184	143	32896	0	33849
23953	547	229	109	32984	0	33869
23954	520	234	31452	1037	0	33243
23955	519	206	31678	551	0	32954
23956	523	186	813	32013	0	33535
23957	492	216	31918	934	0	33560
23958	482	267	31633	599	0	32981
23959	612	171	873	31679	0	33335
23960	548	184	438	32658	0	33828
23961	532	202	299	33846	0	34879
23962	541	244	218	32467	0	33470
23963	33356	195	207	1292	0	35050
23964	34411	226	183	780	0	35600
23965	1369	178	172	33557	0	35276
23966	864	212	172	33827	0	35075
23967	610	203	207	34041	0	35061
23968	578	191	153	33927	0	34849
23969	610	204	175	33541	0	34530
23970	583	32851	179	1231	0	34844
23971	32911	775	158	802	0	34646
23972	1059	33111	152	575	0	34897
23973	33114	853	121	576	0	34664
23974	33465	465	96	552	0	34578
23975	33690	283	112	515	0	34600
23976	1421	250	119	31659	0	33449
23977	31683	261	83	1068	0	33095
23978	1196	244	82	31167	0	32689
23979	900	228	103	30854	0	32085
23980	30624	239	60	1215	0	32138
23981	1101	29447	70	686	0	31304
23982	636	28295	63	406	0	29400
23983	27783	651	49	383	0	28866
23984	885	335	26969	309	0	28498
23985	25569	249	449	311	0	26578
23986	908	302	183	25862	0	27255
23987	565	23892	79	592	0	25128
23988	460	24647	61	364	0	25532
23989	24595	594	64	356	0	25609
23990	703	346	34	24566	0	25649
23991	433	25544	35	482	0	26494
23992	25335	465	78	334	0	26212
23993	25407	221	15	310	0	25953
23994	25574	167	27	281	0	26049
23995	25721	175	27	291	0	26214
23996	673	24318	29	317	0	25337
23997	329	24394	16	127	0	24866
23998	24917	389	53	166	0	25525
23999	26089	178	34	184	0	26485
24000	592	107	25502	109	0	26310
24001	206	24932	268	72	0	25478
24002	25288	326	136	111	0	25861
24003	26287	111	37	125	0	26560
24004	514	91	25995	66	0	26666
24005	25217	55	368	143	0	25783
24006	518	53	26925	59	0	27555
24007	161	43	28011	38	0	28253
24008	223	91	536	25378	0	26228
24009	106	25793	187	398	0	26484
24010	28802	457	90	191	0	29540
24011	607	126	75	28619	0	29427
24012	269	82	50	28999	0	29400
24013	191	55	58	29562	0	29866
24014	29204	50	77	735	0	30066
24015	604	38	54	29165	0	29861
24016	269	57	43	30357	0	30726
24017	187	47	29992	675	0	30901
24018	28222	57	545	389	0	29213
24019	30119	46	170	268	0	30603
24020	768	55	29837	162	0	30822
24021	28535	53	597	197	0	29382
24022	784	57	167	28320	0	29328
24023	315	28740	109	612	0	29776
24024	288	557	94	29027	0	29966
24025	28706	147	83	799	0	29735
24026	671	28879	82	303	0	29935
24027	344	581	72	29282	0	30279
24028	318	190	75	30236	0	30819
24029	244	105	81	30406	0	30836
24030	275	86	79	29152	0	29592
24031	186	30694	123	808	0	31811
24032	30875	665	106	418	0	32064
24033	31447	224	72	346	0	32089
24034	932	32108	115	235	0	33390
24035	34547	794	73	290	0	35704
24036	35841	275	57	327	0	36500
24037	35526	191	65	301	0	36083
24038	1348	157	34083	241	0	35829
24039	763	112	838	34045	0	35758
24040	463	169	33040	1004	0	34676
24041	33401	114	882	551	0	34948
24042	1120	34323	344	368	0	36155
24043	34114	901	217	367	0	35599
24044	1220	34914	168	252	0	36554
24045	719	1041	180	33332	0	35272
24046	636	409	130	34790	0	35965
24047	466	303	34666	1200	0	36635
24048	393	35341	974	574	0	37282
24049	34847	1073	386	486	0	36792
24050	1283	468	34914	276	0	36941
24051	34831	376	1040	312	0	36559
24052	1400	232	458	34928	0	37018
24053	655	245	35277	1205	0	37382
24054	503	35148	1136	617	0	37404
24055	505	1091	471	35145	0	37212
24056	458	514	35537	1158	0	37667
24057	437	369	35483	545	0	36834
24058	448	35184	1277	466	0	37375
24059	493	1092	595	34499	0	36679
24060	526	463	428	34061	0	35478
24061	409	34026	342	1329	0	36106
24062	34680	1098	339	742	0	36859
24063	1291	517	339	33973	0	36120
24064	589	34095	342	1217	0	36243
24065	34776	1130	313	698	0	36917
24066	34673	511	332	609	0	36125
24067	35593	432	323	479	0	36827
24068	1597	34829	259	438	0	37123
24069	35680	1130	277	534	0	37621
24070	36171	588	269	511	0	37539
24071	1683	452	267	35092	0	37494
24072	35815	376	251	1351	0	37793
24073	1580	395	213	35921	0	38109
24074	868	362	34929	1440	0	37599
24075	738	364	35817	710	0	37629
24076	724	284	1300	36378	0	38686
24077	591	327	36845	1422	0	39185
24078	35721	353	1312	823	0	38209
24079	1601	282	566	37155	0	39604
24080	881	299	410	38056	0	39646
24081	728	302	36918	1637	0	39585
24082	661	35299	1256	878	0	38094
24083	581	37718	573	650	0	39522
24084	621	1432	461	36713	0	39227
24085	558	639	327	38261	0	39785
24086	551	460	36816	1682	0	39509
24087	521	362	37432	900	0	39215
24088	559	345	1509	37759	0	40172
24089	463	348	37514	1586	0	39911
24090	36373	326	1496	859	0	39054
24091	1561	341	672	37052	0	39626
24092	37356	359	480	1634	0	39829
24093	1642	324	423	37104	0	39493
24094	884	285	404	38026	0	39599
24095	642	273	36497	1944	0	39356
24096	517	36927	1430	1018	0	39892
24097	659	1229	655	36980	0	39523
24098	491	546	36869	1581	0	39487
24099	465	35589	1337	788	0	38179
24100	507	1145	639	36342	0	38633
24101	35869	492	508	1542	0	38411
24102	1295	335	35851	825	0	38306
24103	32818	255	1218	749	0	35040
24104	1317	241	33572	566	0	35696
24105	30825	212	1277	528	0	32842
24106	1212	31609	665	471	0	33957
24107	544	31794	479	420	0	33237
24108	509	1264	397	30033	0	32203
24109	325	29798	305	1038	0	31466
24110	30442	951	279	792	0	32464
24111	996	432	337	30777	0	32542
24112	539	372	283	31342	0	32536
24113	423	286	287	31880	0	32876
24114	306	263	30663	1365	0	32597
24115	357	294	915	30519	0	32085
24116	301	268	30072	1242	0	31883
24117	305	29352	1048	736	0	31441
24118	28629	793	536	567	0	30525
24119	912	29883	396	462	0	31653
24120	30554	876	325	508	0	32263
24121	31003	407	282	486	0	32178
24122	31229	335	252	460	0	32276
24123	30868	293	276	441	0	31878
24124	1253	270	29574	376	0	31473
24125	710	265	853	29420	0	31248
24126	598	306	467	28214	0	29585
24127	494	220	333	30560	0	31607
24128	26613	235	299	1324	0	28471
24129	27159	204	281	787	0	28431
24130	1044	28710	278	584	0	30616
24131	567	681	27596	413	0	29257
24132	460	318	27071	384	0	28233
24133	367	26977	922	364	0	28630
24134	312	27563	488	392	0	28755
24135	553	645	608	24431	0	26237
24136	290	282	182	23161	0	23915
24137	24467	166	151	723	0	25507
24138	569	24221	161	359	0	25310
24139	346	497	151	24820	0	25814
24140	260	195	25127	641	0	26223
24141	258	165	518	25683	0	26624
24142	245	127	251	26320	0	26943
24143	237	106	211	26741	0	27295
24144	243	125	184	26416	0	26968
24145	208	127	25460	793	0	26588
24146	198	24074	548	400	0	25220
24147	175	24535	219	277	0	25206
24148	23506	505	195	251	0	24457
24149	476	23630	139	209	0	24454
24150	228	24645	124	200	0	25197
24151	235	536	161	24378	0	25310
24152	229	237	115	24668	0	25249
24153	228	173	159	24615	0	25175
24154	187	127	24085	688	0	25087
24155	147	23920	443	395	0	24905
24156	179	436	194	23370	0	24179
24157	128	24021	160	532	0	24841
24158	23741	460	136	386	0	24723
24159	418	23937	146	272	0	24773
24160	23802	473	132	291	0	24698
24161	474	222	23513	230	0	24439
24162	23343	190	422	254	0	24209
24163	495	207	182	23979	0	24863
24164	244	173	24060	486	0	24963
24165	23155	175	432	292	0	24054
24166	23964	185	172	266	0	24587
24167	24100	150	136	245	0	24631
24168	594	153	113	23746	0	24606
24169	283	174	23474	512	0	24443
24170	23110	131	397	362	0	24000
24171	523	146	172	24170	0	25011
24172	282	122	162	24190	0	24756
24173	209	140	24505	547	0	25401
24174	167	24177	367	303	0	25014
24175	190	410	154	23429	0	24183
24176	137	24055	130	419	0	24741
24177	23415	380	125	244	0	24164
24178	23438	167	113	221	0	23939
24179	482	145	92	23159	0	23878
24180	23185	95	92	450	0	23822
24181	450	22926	88	227	0	23691
24182	22932	326	66	241	0	23565
24183	431	23145	101	176	0	23853
24184	279	347	91	23148	0	23865
24185	229	148	76	22847	0	23300
24186	188	23046	98	365	0	23697
24187	173	327	89	22792	0	23381
24188	142	153	22495	416	0	23206
24189	132	21884	272	191	0	22479
24190	21044	257	69	182	0	21552
24191	287	21285	70	112	0	21754
24192	168	240	70	21261	0	21739
24193	121	115	21262	278	0	21776
24194	134	81	222	21402	0	21839
24195	105	73	67	21779	0	22024
24196	20958	54	62	429	0	21503
24197	285	55	21239	180	0	21759
24198	112	21315	238	169	0	21834
24199	105	280	22390	108	0	22883
24200	60	108	21626	65	0	21859
24201	66	80	21863	66	0	22075
24202	104	211	322	21374	0	22011
24203	22601	34	138	339	0	23112
24204	284	22567	73	120	0	23044
24205	22940	301	45	137	0	23423
24206	23457	98	45	123	0	23723
24207	388	66	51	22834	0	23339
24208	131	23086	39	315	0	23571
24209	22857	303	31	179	0	23370
24210	312	22988	47	94	0	23441
24211	161	325	37	22219	0	22742
24212	106	115	49	23583	0	23853
24213	61	23570	57	398	0	24086
24214	79	314	44	23752	0	24189
24215	62	132	23217	349	0	23760
24216	69	91	23033	151	0	23344
24217	103	78	372	23464	0	24017
24218	90	57	128	23942	0	24217
24219	64	57	22858	409	0	23388
24220	71	70	22127	169	0	22437
24221	20456	58	392	207	0	21113
24222	333	21878	155	90	0	22456
24223	142	23430	109	109	0	23790
24224	122	409	69	22383	0	22983
24225	115	155	56	22837	0	23163
24226	100	100	60	23220	0	23480
24227	79	101	22764	431	0	23375
24228	80	68	22450	203	0	22801
24229	107	68	405	23111	0	23691
24230	71	78	23011	394	0	23554
24231	63	22781	409	191	0	23444
24232	22465	373	188	163	0	23189
24233	386	139	22567	108	0	23200
24234	136	101	22415	103	0	22755
24235	148	109	422	22742	0	23421
24236	78	83	24512	418	0	25091
24237	71	24869	465	207	0	25612
24238	160	415	172	24826	0	25573
24239	78	160	25331	470	0	26039
24240	52	24616	482	205	0	25355
24241	24195	432	189	203	0	25019
24242	433	175	145	24139	0	24892
24243	170	108	113	24510	0	24901
24244	24289	95	111	561	0	25056
24245	417	24435	100	236	0	25188
24246	24564	434	90	239	0	25327
24247	24802	173	91	184	0	25250
24248	24860	116	85	185	0	25246
24249	600	79	78	24298	0	25055
24250	23767	68	116	511	0	24462
24251	492	22372	111	208	0	23183
24252	216	23334	103	178	0	23831
24253	24169	502	106	167	0	24944
24254	546	219	69	24485	0	25319
24255	273	159	59	24767	0	25258
24256	222	112	77	25048	0	25459
24257	139	117	24057	655	0	24968
24258	152	24056	449	318	0	24975
24259	159	473	178	24583	0	25393
24260	24575	178	140	606	0	25499
24261	516	153	92	24579	0	25340
24262	199	127	24299	608	0	25233
24263	171	24326	493	283	0	25273
24264	24389	483	198	251	0	25321
24265	24376	205	166	228	0	24975
24266	24727	172	116	222	0	25237
24267	727	123	113	24775	0	25738
24268	312	157	24735	580	0	25784
24269	252	156	25596	274	0	26278
24270	221	26765	626	226	0	27838
24271	281	622	250	26525	0	27678
24272	244	241	157	27548	0	28190
24273	26100	170	119	907	0	27296
24274	730	170	96	26634	0	27630
24275	27157	146	86	843	0	28232
24276	800	142	26614	372	0	27928
24277	386	123	27134	315	0	27958
24278	347	82	773	26906	0	28108
24279	274	93	355	27653	0	28375
24280	256	109	226	28732	0	29323
24281	29397	119	188	1049	0	30753
24282	31392	119	166	509	0	32186
24283	1179	102	143	31270	0	32694
24284	491	104	30784	1071	0	32450
24285	321	77	31471	549	0	32418
24286	302	91	1134	31532	0	33059
24287	31927	107	500	1078	0	33612
24288	1019	95	283	31701	0	33098
24289	529	87	202	32650	0	33468
24290	324	84	31924	1321	0	33653
24291	248	89	32101	668	0	33106
24292	30892	91	1171	512	0	32666
24293	1000	96	32003	393	0	33492
24294	533	80	1065	30890	0	32568
24295	436	68	480	31858	0	32842
24296	31309	55	331	1312	0	33007
24297	996	30764	294	662	0	32716
24298	30294	762	290	505	0	31851
24299	1015	29354	235	375	0	30979
24300	28848	825	224	392	0	30289
24301	1026	322	28446	328	0	30122
24302	26660	236	923	378	0	28197
24303	27407	122	389	338	0	28256
24304	1140	188	294	26982	0	28604
24305	605	106	26955	896	0	28562
24306	505	100	865	25871	0	27341
24307	419	121	415	26401	0	27356
24308	320	26005	339	1156	0	27820
24309	381	722	261	25391	0	26755
24310	338	26235	248	1009	0	27830
24311	400	798	228	26536	0	27962
24312	26191	330	209	1115	0	27845
24313	1020	229	202	26439	0	27890
24314	511	182	26009	1092	0	27794
24315	25730	170	878	645	0	27423
24316	1036	141	26659	499	0	28335
24317	26353	138	927	500	0	27918
24318	27094	139	435	486	0	28154
24319	1205	26261	382	407	0	28255
24320	665	27753	304	393	0	29115
24321	27423	976	290	448	0	29137
24322	28448	419	265	443	0	29575
24323	27973	274	252	461	0	28960
24324	28030	207	269	468	0	28974
24325	28171	203	257	420	0	29051
24326	1499	163	205	27162	0	29029
24327	859	192	232	27991	0	29274
24328	611	198	27348	1251	0	29408
24329	27004	189	947	641	0	28781
24330	1225	168	439	27087	0	28919
24331	770	161	339	27766	0	29036
24332	628	179	27087	1253	0	29147
24333	560	25528	960	736	0	27784
24334	563	27376	459	564	0	28962
24335	26792	945	385	527	0	28649
24336	25478	401	274	423	0	26576
24337	1220	23684	268	386	0	25558
24338	698	24295	246	310	0	25549
24339	24310	854	235	388	0	25787
24340	25519	368	234	448	0	26569
24341	1215	250	235	24815	0	26515
24342	714	219	212	25289	0	26434
24343	578	210	200	26010	0	26998
24344	25126	204	203	1233	0	26766
24345	25629	182	207	681	0	26699
24346	1258	211	187	25583	0	27239
24347	26229	230	207	1027	0	27693
24348	1218	214	25954	580	0	27966
24349	814	175	801	26197	0	27987
24350	614	194	26017	1025	0	27850
24351	494	25636	888	622	0	27640
24352	602	883	498	25645	0	27628
24353	25595	354	317	989	0	27255
24354	1137	232	232	25384	0	26985
24355	711	208	213	25690	0	26822
24356	542	195	24949	1211	0	26897
24357	487	186	24853	681	0	26207
24358	487	25589	909	525	0	27510
24359	25980	784	428	453	0	27645
24360	26462	394	266	395	0	27517
24361	26472	246	224	429	0	27371
24362	26818	218	203	388	0	27627
24363	1385	177	220	25990	0	27772
24364	818	163	220	25799	0	27000
24365	575	25933	214	1075	0	27797
24366	26256	733	215	626	0	27830
24367	26235	362	213	480	0	27290
24368	1264	244	24985	359	0	26852
24369	22355	162	615	311	0	23443
24370	961	22940	300	278	0	24479
24371	631	859	189	21933	0	23612
24372	458	22996	159	690	0	24303
24373	22970	694	140	443	0	24247
24374	885	22921	143	301	0	24250
24375	609	621	123	22405	0	23758
24376	441	256	103	22922	0	23722
24377	352	180	138	22469	0	23139
24378	327	21787	123	897	0	23134
24379	404	722	115	21752	0	22993
24380	432	403	93	21290	0	22218
24381	195	18800	84	698	0	19777
24382	192	18243	66	269	0	18770
24383	17370	426	70	204	0	18070
24384	424	17539	60	199	0	18222
24385	16987	368	61	178	0	17594
24386	452	181	16785	125	0	17543
24387	199	16718	278	115	0	17310
24388	16698	323	118	187	0	17326
24389	16649	164	67	175	0	17055
24390	446	123	16331	136	0	17036
24391	280	105	280	16058	0	16723
24392	188	96	16526	359	0	17169
24393	139	16327	310	211	0	16987
24394	16203	342	124	196	0	16865
24395	355	16096	109	123	0	16683
24396	213	358	52	16141	0	16764
24397	181	149	60	16569	0	16959
24398	142	114	16362	423	0	17041
24399	129	123	15533	207	0	15992
24400	15498	117	336	197	0	16148
24401	16439	96	152	148	0	16835
24402	16496	101	86	127	0	16810
24403	16489	82	88	129	0	16788
24404	468	16311	72	120	0	16971
24405	269	326	73	16236	0	16904
24406	207	170	57	16325	0	16759
24407	167	16562	83	394	0	17206
24408	16976	340	67	228	0	17611
24409	17135	159	60	198	0	17552
24410	486	107	16852	157	0	17602
24411	16827	94	329	158	0	17408
24412	464	94	137	16905	0	17600
24413	240	108	16718	358	0	17424
24414	230	90	335	16549	0	17204
24415	157	89	16834	405	0	17485
24416	146	87	16334	173	0	16740
24417	205	166	395	15531	0	16297
24418	133	16015	182	305	0	16635
24419	16108	283	121	183	0	16695
24420	15758	141	70	143	0	16112
24421	377	16394	77	114	0	16962
24422	181	16692	72	105	0	17050
24423	16988	346	86	165	0	17585
24424	17202	143	60	141	0	17546
24425	17238	102	68	125	0	17533
24426	17283	83	56	111	0	17533
24427	467	94	61	17285	0	17907
24428	219	70	17032	301	0	17622
24429	151	16840	271	149	0	17411
24430	16712	272	113	144	0	17241
24431	328	17013	72	96	0	17509
24432	17178	303	61	112	0	17654
24433	17271	126	63	103	0	17563
24434	409	98	17234	64	0	17805
24435	202	17853	273	51	0	18379
24436	178	293	88	17863	0	18422
24437	148	129	82	18290	0	18649
24438	158	109	54	17370	0	17691
24439	18047	74	58	416	0	18595
24440	17076	91	51	195	0	17413
24441	17251	59	58	175	0	17543
24442	412	17156	42	97	0	17707
24443	16820	251	38	119	0	17228
24444	324	16859	39	85	0	17307
24445	178	271	16528	83	0	17060
24446	112	16590	226	70	0	16998
24447	215	325	200	15632	0	16372
24448	98	80	31	15569	0	15778
24449	90	62	15439	204	0	15795
24450	109	33	182	14976	0	15300
24451	79	53	67	15454	0	15653
24452	15641	37	49	270	0	15997
24453	15277	53	41	140	0	15511
24454	15584	37	38	108	0	15767
24455	244	15575	37	71	0	15927
24456	15446	179	28	97	0	15750
24457	14960	69	28	84	0	15141
24458	254	15351	46	37	0	15688
24459	137	183	32	15343	0	15695
24460	111	98	24	15470	0	15703
24461	15361	48	22	262	0	15693
24462	216	49	15079	95	0	15439
24463	94	14509	157	63	0	14823
24464	90	236	47	14069	0	14442
24465	65	13865	29	160	0	14119
24466	70	14346	23	67	0	14506
24467	14509	167	55	78	0	14809
24468	14508	66	27	63	0	14664
24469	211	48	24	14668	0	14951
24470	108	50	27	14424	0	14609
24471	78	37	23	14511	0	14649
24472	69	41	20	14425	0	14555
24473	59	49	14029	204	0	14341
24474	69	49	12995	91	0	13204
24475	79	34	158	14117	0	14388
24476	75	33	14944	192	0	15244
24477	75	15317	176	82	0	15650
24478	15609	183	61	89	0	15942
24479	15788	78	44	75	0	15985
24480	267	51	34	15860	0	16212
24481	136	39	25	15949	0	16149
24482	98	49	29	16221	0	16397
24483	66	16343	35	241	0	16685
24484	16466	196	26	149	0	16837
24485	16623	63	28	113	0	16827
24486	283	51	16446	67	0	16847
24487	135	47	211	17467	0	17860
24488	71	56	18143	319	0	18589
24489	124	52	268	19394	0	19838
24490	131	47	61	19390	0	19629
24491	148	39	59	19117	0	19363
24492	102	41	38	20014	0	20195
24493	19798	37	41	553	0	20429
24494	20118	49	40	273	0	20480
24495	20712	39	42	174	0	20967
24496	582	39	23	20551	0	21195
24497	212	36	20098	418	0	20764
24498	19468	35	364	220	0	20087
24499	445	29	129	20372	0	20975
24500	20295	36	78	469	0	20878
24501	488	28	53	20268	0	20837
24502	182	19444	52	484	0	20162
24503	127	20878	53	248	0	21306
24504	177	422	62	20956	0	21617
24505	180	138	41	20888	0	21247
24506	157	71	20	21070	0	21318
24507	107	20584	29	560	0	21280
24508	20366	365	39	274	0	21044
24509	409	20475	30	167	0	21081
24510	173	385	20339	133	0	21030
24511	181	139	353	20184	0	20857
24512	84	20981	119	453	0	21637
24513	119	389	91	21018	0	21617
24514	133	161	49	21274	0	21617
24515	84	115	20867	591	0	21657
24516	19122	82	361	376	0	19941
24517	389	21654	142	244	0	22429
24518	21815	399	74	246	0	22534
24519	22506	155	47	212	0	22920
24520	22572	112	46	235	0	22965
24521	652	84	21356	151	0	22243
24522	369	70	446	20854	0	21739
24523	270	91	149	21396	0	21906
24524	165	90	20804	635	0	21694
24525	18793	77	436	397	0	19703
24526	539	89	20915	240	0	21783
24527	222	80	20312	179	0	20793
24528	139	20719	495	184	0	21537
24529	177	392	208	20825	0	21602
24530	130	182	20993	496	0	21801
24531	19523	121	432	273	0	20349
24532	20507	99	184	207	0	20997
24533	586	78	20495	135	0	21294
24534	301	95	445	20518	0	21359
24535	165	81	20911	491	0	21648
24536	126	21021	477	299	0	21923
24537	22321	421	236	244	0	23222
24538	22692	171	169	204	0	23236
24539	22900	111	134	198	0	23343
24540	698	85	166	22463	0	23412
24541	374	83	137	23052	0	23646
24542	211	122	22500	660	0	23493
24543	21993	77	478	357	0	22905
24544	659	63	234	22700	0	23656
24545	22610	61	156	600	0	23427
24546	655	74	22530	278	0	23537
24547	294	72	22985	264	0	23615
24548	276	62	644	22214	0	23196
24549	238	65	340	23599	0	24242
24550	222	88	23305	686	0	24301
24551	22111	75	553	407	0	23146
24552	662	79	275	22558	0	23574
24553	331	23647	242	555	0	24775
24554	24179	462	184	398	0	25223
24555	605	24453	184	299	0	25541
24556	24443	530	183	275	0	25431
24557	742	208	24907	235	0	26092
24558	415	139	24055	214	0	24823
24559	316	24739	676	213	0	25944
24560	24825	526	372	236	0	25959
24561	723	254	24587	208	0	25772
24562	23637	145	573	275	0	24630
24563	737	24493	342	221	0	25793
24564	434	477	306	24891	0	26108
24565	332	243	189	24611	0	25375
24566	253	23433	192	710	0	24588
24567	25478	538	209	395	0	26620
24568	26312	250	199	253	0	27014
24569	26767	196	171	263	0	27397
24570	893	166	26331	201	0	27591
24571	498	125	645	26259	0	27527
24572	351	127	351	26644	0	27473
24573	313	156	244	27334	0	28047
24574	308	140	26598	849	0	27895
24575	288	25918	616	413	0	27235
24576	25312	567	317	254	0	26450
24577	683	284	25253	205	0	26425
24578	24272	193	625	264	0	25354
24579	680	25078	331	225	0	26314
24580	25303	582	251	224	0	26360
24581	831	271	195	24825	0	26122
24582	25302	203	211	621	0	26337
24583	837	152	207	25129	0	26325
24584	438	167	25458	646	0	26709
24585	414	259	536	25196	0	26405
24586	284	178	25220	674	0	26356
24587	22631	133	510	407	0	23681
24588	582	23657	309	213	0	24761
24589	403	442	179	21364	0	22388
24590	285	22838	188	353	0	23664
24591	22741	400	242	258	0	23641
24592	22786	219	163	232	0	23400
24593	546	22567	166	195	0	23474
24594	22604	363	172	221	0	23360
24595	23013	203	126	231	0	23573
24596	557	165	127	22666	0	23515
24597	328	138	117	23014	0	23597
24598	23543	123	127	530	0	24323
24599	23828	101	121	264	0	24314
24600	673	110	129	23231	0	24143
24601	408	127	91	24404	0	25030
24602	24353	102	101	640	0	25196
24603	574	88	23863	352	0	24877
24604	22453	95	431	346	0	23325
24605	594	108	23451	236	0	24389
24606	350	23157	483	186	0	24176
24607	330	423	248	23081	0	24082
24608	299	205	23663	442	0	24609
24609	259	24337	448	253	0	25297
24610	24107	477	225	283	0	25092
24611	569	224	24251	186	0	25230
24612	23296	151	434	198	0	24079
24613	24520	130	181	197	0	25028
24614	24693	118	127	231	0	25169
24615	728	97	133	23634	0	24592
24616	415	23944	158	428	0	24945
24617	23535	372	110	357	0	24374
24618	524	187	24135	220	0	25066
24619	21296	120	377	277	0	22070
24620	522	123	23793	157	0	24595
24621	307	23670	384	171	0	24532
24622	273	338	215	23955	0	24781
24623	240	195	185	23783	0	24403
24624	263	23395	145	470	0	24273
24625	278	369	190	24032	0	24869
24626	262	220	24429	416	0	25327
24627	247	24438	395	232	0	25312
24628	250	431	193	24159	0	25033
24629	24096	210	151	496	0	24953
24630	24857	162	124	301	0	25444
24631	698	156	115	25096	0	26065
24632	387	25436	122	487	0	26432
24633	349	406	115	25664	0	26534
24634	349	200	113	25403	0	26065
24635	263	108	23915	636	0	24922
24636	261	24047	387	373	0	25068
24637	222	358	174	23414	0	24168
24638	162	183	23026	451	0	23822
24639	162	22981	367	245	0	23755
24640	227	378	183	23224	0	24012
24641	23240	213	156	442	0	24051
24642	460	23768	101	246	0	24575
24643	314	403	89	24048	0	24854
24644	24522	232	100	488	0	25342
24645	24617	186	79	366	0	25248
24646	24738	131	83	293	0	25245
24647	24420	131	117	251	0	24919
24648	639	158	93	24125	0	25015
24649	322	106	24311	509	0	25248
24650	312	199	362	23684	0	24557
24651	227	24134	177	464	0	25002
24652	24451	347	131	383	0	25312
24653	475	201	23690	243	0	24609
24654	22333	153	336	228	0	23050
24655	451	130	23086	172	0	23839
24656	324	139	357	22927	0	23747
24657	252	121	22952	378	0	23703
24658	266	117	374	22443	0	23200
24659	259	108	22566	410	0	23343
24660	232	116	371	22136	0	22855
24661	22668	95	191	498	0	23452
24662	427	23777	176	253	0	24633
24663	334	335	130	24167	0	24966
24664	289	158	138	24173	0	24758
24665	254	117	24869	468	0	25708
24666	233	116	23351	264	0	23964
24667	22874	97	438	298	0	23707
24668	405	23955	252	190	0	24802
24669	23761	287	177	215	0	24440
24670	24016	125	145	211	0	24497
24671	454	91	161	23461	0	24167
24672	240	24028	150	364	0	24782
24673	24644	302	160	290	0	25396
24674	24940	155	135	260	0	25490
24675	25331	113	125	256	0	25825
24676	25427	91	109	254	0	25881
24677	25165	104	133	225	0	25627
24678	487	92	24567	150	0	25296
24679	24287	90	336	204	0	24917
24680	462	114	24782	133	0	25491
24681	375	87	327	24061	0	24850
24682	311	73	171	25399	0	25954
24683	226	91	24814	439	0	25570
24684	24255	96	323	304	0	24978
24685	509	74	179	24964	0	25726
24686	330	94	136	25893	0	26453
24687	287	85	108	26291	0	26771
24688	279	88	109	25820	0	26296
24689	267	83	106	26188	0	26644
24690	222	98	26295	579	0	27194
24691	267	76	391	26021	0	26755
24692	203	87	26594	506	0	27390
24693	215	78	25621	334	0	26248
24694	26084	50	557	324	0	27015
24695	27629	52	290	299	0	28270
24696	29577	54	193	261	0	30085
24697	796	65	30210	234	0	31305
24698	365	59	29686	246	0	30356
24699	258	48	30267	234	0	30807
24700	212	31198	823	270	0	32503
24701	318	565	454	31454	0	32791
24702	32753	210	249	754	0	33966
24703	735	113	189	34137	0	35174
24704	352	34599	210	788	0	35949
24705	35133	639	177	485	0	36434
24706	852	263	175	34786	0	36076
24707	454	35562	212	794	0	37022
24708	393	652	240	36200	0	37485
24709	329	313	235	36010	0	36887
24710	35173	162	239	1109	0	36683
24711	909	166	195	35369	0	36639
24712	475	172	35024	983	0	36654
24713	475	169	824	34588	0	36056
24714	363	33350	511	965	0	35189
24715	267	35196	400	577	0	36440
24716	315	934	355	34136	0	35740
24717	327	474	331	34072	0	35204
24718	279	33168	255	1227	0	34929
24719	323	33494	223	797	0	34837
24720	353	34474	184	665	0	35676
24721	413	1133	174	32079	0	33799
24722	333	34132	168	1057	0	35690
24723	33561	1022	178	800	0	35561
24724	863	641	33822	700	0	36026
24725	612	506	683	32835	0	34636
24726	351	34015	360	1174	0	35900
24727	33421	959	248	936	0	35564
24728	903	607	33671	680	0	35861
24729	482	33636	796	689	0	35603
24730	32827	976	432	634	0	34869
24731	779	32689	290	535	0	34293
24732	411	33398	243	533	0	34585
24733	387	1226	201	32577	0	34391
24734	280	33693	149	955	0	35077
24735	33073	1115	175	726	0	35089
24736	790	772	176	33260	0	34998
24737	424	698	32787	929	0	34838
24738	365	633	32615	579	0	34192
24739	335	593	851	33023	0	34802
24740	279	608	33444	946	0	35277
24741	373	524	790	33574	0	35261
24742	32567	494	454	1116	0	34631
24743	805	541	32728	636	0	34710
24744	572	472	762	31820	0	33626
24745	401	31693	498	892	0	33484
24746	399	968	401	32842	0	34610
24747	365	653	355	32754	0	34127
24748	334	31415	401	1182	0	33332
24749	353	1043	326	33195	0	34917
24750	385	704	281	33485	0	34855
24751	300	575	32816	1190	0	34881
24752	254	32430	814	792	0	34290
24753	32506	970	475	714	0	34665
24754	805	644	415	33151	0	35015
24755	433	516	33155	1088	0	35192
24756	399	418	855	32963	0	34635
24757	271	408	32985	1214	0	34878
24758	30861	371	1004	928	0	33164
24759	787	32820	593	738	0	34938
24760	568	850	504	33415	0	35337
24761	423	555	444	34331	0	35753
24762	32325	447	385	1402	0	34559
24763	868	462	378	32957	0	34665
24764	508	414	32227	1345	0	34494
24765	395	463	816	30908	0	32582
24766	303	29995	581	1268	0	32147
24767	282	31174	431	985	0	32872
24768	295	32009	374	848	0	33526
24769	337	1210	354	31681	0	33582
24770	329	746	30911	1252	0	33238
24771	317	31028	841	939	0	33125
24772	30195	967	566	860	0	32588
24773	816	30829	451	727	0	32823
24774	30773	1022	412	800	0	33007
24775	30770	652	415	753	0	32590
24776	1051	555	30277	663	0	32546
24777	30963	521	849	736	0	33069
24778	32781	475	521	783	0	34560
24779	30700	484	403	797	0	32384
24780	32844	447	334	784	0	34409
24781	1172	467	31767	627	0	34033
24782	31693	500	834	605	0	33632
24783	33599	530	471	627	0	35227
24784	1123	34336	370	516	0	36345
24785	719	1119	305	33972	0	36115
24786	603	744	270	34105	0	35722
24787	480	34196	354	1140	0	36170
24788	34026	1072	347	718	0	36163
24789	1060	34531	326	452	0	36369
24790	33570	1065	299	432	0	35366
24791	34375	711	282	385	0	35753
24792	1359	34776	235	370	0	36740
24793	906	932	271	34590	0	36699
24794	656	519	34914	938	0	37027
24795	607	33675	833	504	0	35619
24796	547	1107	385	30641	0	32680
24797	432	31356	284	621	0	32693
24798	362	33657	163	300	0	34482
24799	447	1131	196	32019	0	33793
24800	286	370	32220	766	0	33642
24801	215	30817	675	387	0	32094
24802	195	31492	316	253	0	32256
24803	28702	711	186	170	0	29769
24804	550	330	71	29446	0	30397
24805	295	189	55	29890	0	30429
24806	195	130	48	30685	0	31058
24807	100	129	30150	842	0	31221
24808	151	114	592	30132	0	30989
24809	73	31136	255	748	0	32212
24810	31877	690	121	369	0	33057
24811	751	296	84	32013	0	33144
24812	283	192	31726	750	0	32951
24813	31340	158	674	405	0	32577
24814	818	125	250	32535	0	33728
24815	330	124	33826	806	0	35086
24816	188	150	33868	377	0	34583
24817	33605	137	990	312	0	35044
24818	35392	103	377	262	0	36134
24819	35172	133	219	221	0	35745
24820	35479	161	130	235	0	36005
24821	1183	130	34483	208	0	36004
24822	512	34971	789	197	0	36469
24823	34900	798	321	312	0	36331
24824	882	35021	215	209	0	36327
24825	34859	870	174	263	0	36166
24826	955	35021	166	176	0	36318
24827	520	912	138	34923	0	36493
24828	386	395	138	35354	0	36273
24829	348	219	139	35025	0	35731
24830	248	33696	171	1102	0	35217
24831	235	35091	151	472	0	35949
24832	345	999	131	33394	0	34869
24833	204	34246	153	857	0	35460
24834	253	973	33959	374	0	35559
24835	315	418	838	33795	0	35366
24836	260	319	34151	932	0	35662
24837	33090	277	882	490	0	34739
24838	34044	250	363	353	0	35010
24839	1137	253	33566	290	0	35246
24840	510	268	33448	264	0	34490
24841	396	275	1049	33160	0	34880
24842	314	263	33543	938	0	35058
24843	313	245	980	31866	0	33404
24844	299	28634	529	998	0	30460
24845	311	961	293	33263	0	34828
24846	278	458	243	33863	0	34842
24847	294	307	227	33791	0	34619
24848	236	304	32590	1306	0	34436
24849	296	269	941	32139	0	33645
24850	269	259	453	32349	0	33330
24851	285	258	362	31310	0	32215
24852	265	32220	280	1182	0	33947
24853	32307	917	264	683	0	34171
24854	32409	417	264	594	0	33684
24855	32663	290	269	489	0	33711
24856	1287	254	288	31823	0	33652
24857	579	254	31389	1103	0	33325
24858	502	247	30908	646	0	32303
24859	297	31461	1100	516	0	33374
24860	30405	934	513	600	0	32452
24861	881	31237	355	487	0	32960
24862	31274	1004	308	449	0	33035
24863	993	31333	268	485	0	33079
24864	31021	1016	308	507	0	32852
24865	1066	32225	287	481	0	34059
24866	591	1122	260	32402	0	34375
24867	484	508	32043	1142	0	34177
24868	402	408	32252	669	0	33731
24869	419	376	1155	31745	0	33695
24870	406	376	568	32151	0	33501
24871	442	326	410	32941	0	34119
24872	426	310	31983	1347	0	34066
24873	468	269	923	31859	0	33519
24874	31069	282	513	1307	0	33171
24875	31460	242	444	775	0	32921
24876	1141	30586	392	592	0	32711
24877	29908	958	361	469	0	31696
24878	1117	29444	294	449	0	31304
24879	29289	1042	282	471	0	31084
24880	29624	525	333	454	0	30936
24881	28877	370	288	425	0	29960
24882	1376	298	28531	425	0	30630
24883	685	276	28099	342	0	29402
24884	27455	234	1081	427	0	29197
24885	29035	212	608	386	0	30241
24886	1320	253	431	28451	0	30455
24887	844	249	267	29595	0	30955
24888	629	255	214	30427	0	31525
24889	499	242	295	30747	0	31783
24890	498	284	259	31439	0	32480
24891	29732	249	229	1446	0	31656
24892	1074	273	177	29460	0	30984
24893	649	241	28641	1090	0	30621
24894	27570	261	749	677	0	29257
24895	28754	206	434	537	0	29931
24896	1152	28077	283	459	0	29971
24897	546	28288	172	385	0	29391
24898	25899	727	164	303	0	27093
24899	668	26855	123	218	0	27864
24900	26434	647	219	263	0	27563
24901	28502	263	158	250	0	29173
24902	28874	134	104	251	0	29363
24903	1169	109	104	27167	0	28549
24904	508	27218	112	747	0	28585
24905	27563	651	100	400	0	28714
24906	898	280	96	27382	0	28656
24907	495	153	95	26886	0	27629
24908	25401	87	53	911	0	26452
24909	679	24974	54	438	0	26145
24910	386	588	32	25234	0	26240
24911	25454	274	32	711	0	26471
24912	661	25826	34	378	0	26899
24913	26315	581	27	280	0	27203
24914	800	323	23136	191	0	24450
24915	24313	163	354	201	0	25031
24916	753	24947	146	159	0	26005
24917	25018	568	99	185	0	25870
24918	25000	287	28	188	0	25503
24919	858	25152	41	128	0	26179
24920	25391	590	25	181	0	26187
24921	786	24943	33	134	0	25896
24922	25751	667	31	174	0	26623
24923	864	314	30	25530	0	26738
24924	518	201	41	25762	0	26522
24925	369	155	29	26214	0	26767
24926	285	153	25091	856	0	26385
24927	298	163	519	25300	0	26280
24928	272	150	25350	701	0	26473
24929	304	149	588	24906	0	25947
24930	251	25393	245	641	0	26530
24931	323	618	121	25754	0	26816
24932	227	350	25275	730	0	26582
24933	261	213	26024	373	0	26871
24934	254	162	725	25957	0	27098
24935	25808	142	311	755	0	27016
24936	26045	124	165	464	0	26798
24937	881	26039	112	310	0	27342
24938	502	630	104	26429	0	27665
24939	320	314	26907	740	0	28281
24940	287	196	604	27144	0	28231
24941	230	152	27205	826	0	28413
24942	26441	139	709	483	0	27772
24943	786	166	316	27329	0	28597
24944	486	143	26899	778	0	28306
24945	354	156	652	26995	0	28157
24946	325	157	320	27608	0	28410
24947	260	136	27078	1020	0	28494
24948	294	113	680	27161	0	28248
24949	27057	121	352	971	0	28501
24950	27640	134	230	544	0	28548
24951	1030	147	149	27621	0	28947
24952	27786	134	173	900	0	28993
24953	877	146	27641	520	0	29184
24954	474	144	27231	407	0	28256
24955	27620	110	907	359	0	28996
24956	28765	110	460	396	0	29731
24957	1059	87	285	28061	0	29492
24958	597	118	192	28743	0	29650
24959	387	106	27965	1063	0	29521
24960	390	132	715	26161	0	27398
24961	298	27823	408	791	0	29320
24962	28105	639	254	540	0	29538
24963	30229	342	211	408	0	31190
24964	1132	29937	193	329	0	31591
24965	29108	741	172	376	0	30397
24966	29196	313	191	388	0	30088
24967	1110	29022	226	317	0	30675
24968	29204	775	190	353	0	30522
24969	1019	29343	207	294	0	30863
24970	29599	846	202	320	0	30967
24971	1074	390	29268	308	0	31040
24972	626	249	818	29191	0	30884
24973	450	153	378	30362	0	31343
24974	393	141	260	31701	0	32495
24975	31080	150	208	1370	0	32808
24976	1117	133	170	32047	0	33467
24977	631	167	31601	1151	0	33550
24978	31724	163	897	629	0	33413
24979	1197	155	397	31660	0	33409
24980	634	30700	280	1070	0	32684
24981	462	32346	219	569	0	33596
24982	450	1059	193	31333	0	33035
24983	471	484	209	31392	0	32556
24984	479	254	184	31875	0	32792
24985	363	172	29774	1386	0	31695
24986	306	29288	850	699	0	31143
24987	28299	778	355	514	0	29946
24988	27945	354	246	433	0	28978
24989	1060	27040	160	388	0	28648
24990	518	27792	149	376	0	28835
24991	429	933	252	27111	0	28725
24992	306	330	26839	896	0	28371
24993	25384	299	741	581	0	27005
24994	26487	137	300	374	0	27298
24995	961	125	231	26040	0	27357
24996	495	116	160	26366	0	27137
24997	25387	143	115	999	0	26644
24998	780	138	24972	523	0	26413
24999	23872	133	646	455	0	25106
25000	789	24156	277	292	0	25514
25001	302	448	118	21406	0	22274
25002	219	21926	91	532	0	22768
25003	22185	497	131	319	0	23132
25004	616	195	101	21955	0	22867
25005	355	142	87	21595	0	22179
25006	246	21622	93	613	0	22574
25007	21872	475	95	339	0	22781
25008	22053	214	74	245	0	22586
25009	665	165	21578	203	0	22611
25010	324	103	20263	194	0	20884
25011	20241	114	490	191	0	21036
25012	552	102	20519	172	0	21345
25013	261	98	19667	168	0	20194
25014	19558	152	534	212	0	20456
25015	530	88	21589	161	0	22368
25016	339	76	628	21229	0	22272
25017	264	102	254	21711	0	22331
25018	22567	73	189	809	0	23638
25019	714	117	22611	376	0	23818
25020	23271	117	667	282	0	24337
25021	920	101	264	23281	0	24566
25022	23399	68	213	792	0	24472
25023	23743	67	154	425	0	24389
25024	24083	67	136	330	0	24616
25025	1217	68	114	23313	0	24712
25026	23809	56	136	818	0	24819
25027	1126	51	141	23558	0	24876
25028	657	67	146	23921	0	24791
25029	542	72	141	24110	0	24865
25030	450	74	119	24374	0	25017
25031	23574	80	125	1231	0	25010
25032	24001	74	136	679	0	24890
25033	1132	77	23723	491	0	25423
25034	24035	52	741	478	0	25306
25035	24938	51	282	471	0	25742
25036	1239	62	217	23898	0	25416
25037	723	23641	156	914	0	25434
25038	24251	631	151	501	0	25534
25039	1184	266	134	23319	0	24903
25040	23300	178	153	934	0	24565
25041	1140	22811	147	475	0	24573
25042	23411	686	117	446	0	24660
25043	1177	280	116	22725	0	24298
25044	590	22526	100	949	0	24165
25045	23135	755	102	559	0	24551
25046	1027	22533	116	467	0	24143
25047	576	23874	109	415	0	24974
25048	23948	898	149	404	0	25399
25049	1082	466	23354	329	0	25231
25050	23946	303	705	351	0	25305
25051	1259	254	270	23663	0	25446
25052	696	233	23857	852	0	25638
25053	730	215	744	23343	0	25032
25054	602	204	320	24292	0	25418
25055	525	204	23720	1172	0	25621
25056	23860	180	813	682	0	25535
25057	1242	125	372	24098	0	25837
25058	689	153	252	24682	0	25776
25059	658	138	197	24608	0	25601
25060	23924	160	181	1468	0	25733
25061	1052	171	23090	853	0	25166
25062	651	150	23208	637	0	24646
25063	520	114	854	21855	0	23343
25064	485	85	21830	895	0	23295
25065	21385	106	794	604	0	22889
25066	900	21444	435	484	0	23263
25067	21689	604	386	406	0	23085
25068	1091	284	271	20824	0	22470
25069	597	21052	259	828	0	22736
25070	547	744	243	20984	0	22518
25071	475	21439	203	921	0	23038
25072	484	787	157	21708	0	23136
25073	423	374	21054	993	0	22844
25074	372	324	19889	549	0	21134
25075	389	20110	735	500	0	21734
25076	19235	573	433	445	0	20686
25077	714	346	278	19046	0	20384
25078	456	261	221	19421	0	20359
25079	19156	244	189	874	0	20463
25080	19306	226	207	537	0	20276
25081	952	154	208	19062	0	20376
25082	564	156	18634	758	0	20112
25083	490	18540	609	456	0	20095
25084	431	549	293	18838	0	20111
25085	380	299	295	18606	0	19580
25086	350	19189	217	870	0	20626
25087	19313	622	200	624	0	20759
25088	755	344	19377	444	0	20920
25089	486	290	588	19262	0	20626
25090	380	270	298	19337	0	20285
25091	324	231	18991	996	0	20542
25092	331	192	617	19474	0	20614
25093	19609	170	360	991	0	21130
25094	19768	155	333	610	0	20866
25095	20060	157	302	522	0	21041
25096	921	19564	253	512	0	21250
25097	21127	579	254	455	0	22415
25098	1015	304	210	20885	0	22414
25099	632	276	204	20804	0	21916
25100	523	22748	201	928	0	24400
25101	24412	728	153	641	0	25934
25102	25446	398	173	525	0	26542
25103	25674	294	193	494	0	26655
25104	26364	309	170	475	0	27318
25105	26341	218	180	476	0	27215
25106	1339	183	25477	398	0	27397
25107	26095	213	797	380	0	27485
25108	26670	212	364	402	0	27648
25109	26491	159	295	326	0	27271
25110	1488	136	238	25442	0	27304
25111	939	137	209	25726	0	27011
25112	721	117	24655	1062	0	26555
25113	21004	170	724	791	0	22689
25114	979	24118	373	574	0	26044
25115	507	22514	215	383	0	23619
25116	450	578	22486	281	0	23795
25117	409	22074	485	254	0	23222
25118	308	22102	270	232	0	22912
25119	465	777	279	19378	0	20899
25120	198	20711	153	383	0	21445
25121	20650	487	78	223	0	21438
25122	20488	229	81	183	0	20981
25123	656	142	74	20072	0	20944
25124	363	149	19842	454	0	20808
25125	19469	106	400	245	0	20220
25126	611	103	19933	179	0	20826
25127	347	110	20158	186	0	20801
25128	313	100	538	19302	0	20253
25129	296	95	256	19897	0	20544
25130	220	87	20110	523	0	20940
25131	193	19280	474	289	0	20236
25132	180	20413	210	239	0	21042
25133	20383	481	179	263	0	21306
25134	20652	226	124	163	0	21165
25135	572	152	20203	121	0	21048
25136	19921	129	362	133	0	20545
25137	21319	102	155	134	0	21710
25138	622	91	143	20913	0	21769
25139	395	99	115	21121	0	21730
25140	321	94	95	21239	0	21749
25141	21397	80	85	561	0	22123
25142	21690	94	79	325	0	22188
25143	21993	67	84	248	0	22392
25144	712	74	96	21711	0	22593
25145	444	77	21278	404	0	22203
25146	20856	72	351	263	0	21542
25147	21183	59	183	202	0	21627
25148	646	65	164	20528	0	21403
25149	397	20811	144	366	0	21718
25150	379	339	68	20640	0	21426
25151	278	20878	88	465	0	21709
25152	256	392	101	20205	0	20954
25153	215	20886	94	436	0	21631
25154	20575	376	89	253	0	21293
25155	483	223	72	20542	0	21320
25156	273	20526	68	370	0	21237
25157	232	380	20275	185	0	21072
25158	19870	191	334	188	0	20583
25159	438	151	177	20268	0	21034
25160	254	20267	115	360	0	20996
25161	254	347	102	19873	0	20576
25162	197	19590	81	417	0	20285
25163	185	20743	89	225	0	21242
25164	20610	427	83	230	0	21350
25165	20949	244	82	202	0	21477
25166	460	208	20963	137	0	21768
25167	20741	158	332	154	0	21385
25168	21085	126	167	166	0	21544
25169	502	20873	135	139	0	21649
25170	315	359	114	21044	0	21832
25171	284	176	89	21005	0	21554
25172	250	151	20599	416	0	21416
25173	220	154	19898	231	0	20503
25174	20520	104	414	218	0	21256
25175	21120	98	191	191	0	21600
25176	21105	86	167	159	0	21517
25177	542	89	20606	151	0	21388
25178	375	72	330	20467	0	21244
25179	20845	82	178	405	0	21510
25180	464	80	125	20798	0	21467
25181	280	77	20482	413	0	21252
25182	19481	88	319	270	0	20158
25183	475	86	21049	196	0	21806
25184	265	20779	350	155	0	21549
25185	21011	319	201	185	0	21716
25186	451	163	20847	112	0	21573
25187	296	121	342	20526	0	21285
25188	20809	119	177	368	0	21473
25189	480	74	123	20947	0	21624
25190	21265	71	121	426	0	21883
25191	442	87	77	21015	0	21621
25192	21432	86	69	464	0	22051
25193	21302	90	77	284	0	21753
25194	21244	79	77	229	0	21629
25195	20871	76	68	207	0	21222
25196	586	109	96	20777	0	21568
25197	297	62	19862	282	0	20503
25198	266	57	19680	140	0	20143
25199	192	19432	324	145	0	20093
25200	120	17838	131	86	0	18175
25201	16359	163	286	57	0	16865
25202	160	42	41	15745	0	15988
25203	71	19	15795	116	0	16001
25204	52	19	15441	62	0	15574
25205	75	28	150	15762	0	16015
25206	15849	17	57	153	0	16076
25207	114	15956	28	55	0	16153
25208	17022	116	23	63	0	17224
25209	160	41	14	17242	0	17457
25210	84	21	24	17275	0	17404
25211	57	19	28	17372	0	17476
25212	44	18	17313	148	0	17523
25213	34	21	16528	82	0	16665
25214	52	16803	149	45	0	17049
25215	45	130	51	17569	0	17795
25216	17260	49	38	159	0	17506
25217	140	30	16657	71	0	16898
25218	66	29	16866	63	0	17024
25219	65	19	165	17383	0	17632
25220	52	18	76	17820	0	17966
25221	54	16	49	17998	0	18117
25222	68	31	28	19068	0	19195
25223	19441	19	28	301	0	19789
25224	254	14	26	19552	0	19846
25225	19496	11	47	285	0	19839
25226	246	23	19594	106	0	19969
25227	98	19581	219	74	0	19972
25228	71	207	82	19766	0	20126
25229	56	72	20015	243	0	20386
25230	51	27	19469	110	0	19657
25231	49	20153	256	88	0	20546
25232	63	193	96	19704	0	20056
25233	74	69	66	19856	0	20065
25234	39	38	19962	301	0	20340
25235	19162	33	254	138	0	19587
25236	267	16	101	20073	0	20457
25237	122	27	55	19605	0	19809
25238	63	31	19954	324	0	20372
25239	55	19482	280	147	0	19964
25240	55	21237	115	98	0	21505
25241	21341	346	60	124	0	21871
25242	350	115	74	21417	0	21956
25243	22016	69	69	402	0	22556
25244	387	52	21838	162	0	22439
25245	185	33	368	21827	0	22413
25246	21894	39	150	447	0	22530
25247	22193	42	89	211	0	22535
25248	497	42	68	22057	0	22664
25249	219	31	21790	423	0	22463
25250	131	32	22299	194	0	22656
25251	156	73	457	22233	0	22919
25252	96	40	22330	436	0	22902
25253	21227	37	416	251	0	21931
25254	376	22110	187	186	0	22859
25255	22543	356	143	138	0	23180
25256	22929	138	97	182	0	23346
25257	558	84	87	22937	0	23666
25258	260	56	143	23215	0	23674
25259	23230	69	94	545	0	23938
25260	470	49	99	23266	0	23884
25261	216	53	23115	477	0	23861
25262	151	23257	411	257	0	24076
25263	160	366	180	23150	0	23856
25264	160	134	134	23197	0	23625
25265	152	82	117	23373	0	23724
25266	119	64	22696	596	0	23475
25267	173	22403	406	300	0	23282
25268	147	362	186	22893	0	23588
25269	121	157	22687	523	0	23488
25270	176	116	432	22543	0	23267
25271	22654	107	183	557	0	23501
25272	462	87	126	22876	0	23551
25273	254	62	22442	550	0	23308
25274	22000	40	439	400	0	22879
25275	456	22774	222	253	0	23705
25276	216	23543	202	217	0	24178
25277	23822	432	142	308	0	24704
25278	460	184	24226	223	0	25093
25279	290	124	447	23980	0	24841
25280	208	94	200	24736	0	25238
25281	137	116	24640	603	0	25496
25282	141	24456	491	322	0	25410
25283	247	394	237	21690	0	22568
25284	149	179	24261	531	0	25120
25285	235	99	453	24118	0	24905
25286	24155	114	240	638	0	25147
25287	492	98	24773	321	0	25684
25288	303	110	449	24948	0	25810
25289	203	111	204	25252	0	25770
25290	187	127	24682	650	0	25646
25291	258	112	474	23754	0	24598
25292	185	20607	280	668	0	21740
25293	198	387	265	22780	0	23630
25294	151	24289	203	573	0	25216
25295	24275	431	178	412	0	25296
25296	23410	194	179	358	0	24141
25297	538	141	23539	321	0	24539
25298	256	120	22628	279	0	23283
25299	203	137	22446	248	0	23034
25300	186	22611	558	281	0	23636
25301	204	383	350	23481	0	24418
25302	182	176	23817	528	0	24703
25303	248	159	476	22840	0	23723
25304	180	129	258	23584	0	24151
25305	180	119	23835	627	0	24761
25306	200	136	448	23808	0	24592
25307	163	125	250	23187	0	23725
25308	164	22537	228	615	0	23544
25309	211	411	169	23235	0	24026
25310	181	174	216	23800	0	24371
25311	141	151	23464	653	0	24409
25312	183	115	481	23048	0	23827
25313	128	91	23448	677	0	24344
25314	115	153	22699	397	0	23364
25315	22330	112	567	383	0	23392
25316	459	142	338	22242	0	23181
25317	187	23445	247	611	0	24490
25318	182	23893	233	414	0	24722
25319	174	514	278	23916	0	24882
25320	145	201	23838	685	0	24869
25321	144	23700	525	432	0	24801
25322	141	374	221	22549	0	23285
25323	118	185	23282	454	0	24039
25324	130	24166	358	269	0	24923
25325	25897	346	222	294	0	26759
25326	25868	142	198	300	0	26508
25327	25190	128	154	319	0	25791
25328	435	105	180	27802	0	28522
25329	214	106	155	27832	0	28307
25330	167	112	153	27534	0	27966
25331	103	118	26968	632	0	27821
25332	26581	97	448	406	0	27532
25333	483	103	217	26543	0	27346
25334	206	103	25480	509	0	26298
25335	26807	107	399	346	0	27659
25336	27707	81	238	292	0	28318
25337	577	263	19731	378	0	20949
25338	26647	82	283	299	0	27311
25339	478	27887	198	212	0	28775
25340	175	299	27178	140	0	27792
25341	26026	114	389	200	0	26729
25342	313	26640	161	187	0	27301
25343	120	253	79	25757	0	26209
25344	72	26326	91	286	0	26775
25345	81	284	65	26635	0	27065
25346	68	89	26705	336	0	27198
25347	23889	49	345	223	0	24506
25348	315	39	26610	141	0	27105
25349	90	25696	308	119	0	26213
25350	66	26285	137	95	0	26583
25351	25783	333	59	141	0	26316
25352	288	114	25899	84	0	26385
25353	137	52	317	25476	0	25982
25354	89	80	25697	311	0	26177
25355	47	25874	327	142	0	26390
25356	126	299	126	23888	0	24439
25357	54	25640	91	262	0	26047
25358	26166	315	89	161	0	26731
25359	26332	90	90	156	0	26668
25360	26268	92	81	117	0	26558
25361	368	87	25776	97	0	26328
25362	129	106	24689	87	0	25011
25363	24926	66	361	136	0	25489
25364	327	70	26340	87	0	26824
25365	207	48	357	24462	0	25074
25366	87	25995	164	295	0	26541
25367	26616	315	114	171	0	27216
25368	26455	111	110	144	0	26820
25369	27188	77	83	169	0	27517
25370	438	45	86	27258	0	27827
25371	152	53	96	27488	0	27789
25372	27211	46	66	487	0	27810
25373	350	27069	104	159	0	27682
25374	26797	315	71	149	0	27332
25375	405	90	48	26396	0	26939
25376	185	70	57	26590	0	26902
25377	25877	46	57	445	0	26425
25378	342	25610	58	161	0	26171
25379	25706	296	69	136	0	26207
25380	372	25849	82	92	0	26395
25381	25582	328	60	87	0	26057
25382	411	108	43	26954	0	27516
25383	27272	62	58	393	0	27785
25384	28321	59	26	181	0	28587
25385	29853	80	19	157	0	30109
25386	543	30703	39	91	0	31376
25387	214	455	29797	66	0	30532
25388	29651	145	425	106	0	30327
25389	30579	78	124	135	0	30916
25390	594	30110	81	75	0	30860
25391	324	430	59	30269	0	31082
25392	218	180	34	30576	0	31008
25393	30424	113	63	594	0	31194
25394	583	87	61	30758	0	31489
25395	275	73	30749	524	0	31621
25396	230	87	30041	194	0	30552
25397	31203	70	531	191	0	31995
25398	608	89	164	31406	0	32267
25399	313	49	111	31818	0	32291
25400	256	50	64	32238	0	32608
25401	177	63	32405	678	0	33323
25402	200	65	540	31815	0	32620
25403	216	49	214	32542	0	33021
25404	206	68	125	33065	0	33464
25405	32354	79	85	810	0	33328
25406	649	58	78	32635	0	33420
25407	272	86	32711	701	0	33770
25408	32885	75	568	391	0	33919
25409	668	84	34008	262	0	35022
25410	33927	55	658	307	0	34947
25411	34424	54	224	251	0	34953
25412	887	78	156	34710	0	35831
25413	381	34814	136	759	0	36090
25414	318	566	136	34902	0	35922
25415	298	343	163	35181	0	35985
25416	253	35180	158	879	0	36470
25417	34939	563	152	527	0	36181
25418	697	34822	126	344	0	35989
25419	34782	643	123	322	0	35870
25420	35238	242	94	346	0	35920
25421	892	176	103	34747	0	35918
25422	503	115	112	34760	0	35490
25423	316	100	33374	921	0	34711
25424	268	113	30985	477	0	31843
25425	30462	95	711	407	0	31675
25426	31363	68	353	356	0	32140
25427	830	29745	211	283	0	31069
25428	476	480	170	28876	0	30002
25429	290	193	30242	680	0	31405
25430	333	452	573	29977	0	31335
25431	29797	135	326	741	0	30999
25432	29373	122	177	419	0	30091
25433	767	29481	113	307	0	30668
25434	489	498	98	29599	0	30684
25435	323	255	110	29993	0	30681
25436	284	183	96	30022	0	30585
25437	270	127	28593	856	0	29846
25438	25802	140	504	538	0	26984
25439	27674	145	259	361	0	28439
25440	901	123	27778	271	0	29073
25441	466	27729	500	315	0	29010
25442	27870	489	263	387	0	29009
25443	28049	224	227	383	0	28883
25444	804	167	27244	336	0	28551
25445	521	134	28100	281	0	29036
25446	457	158	665	28255	0	29535
25447	339	175	28590	569	0	29673
25448	27776	167	597	407	0	28947
25449	28493	138	294	349	0	29274
25450	28744	121	221	319	0	29405
25451	886	85	212	27530	0	28713
25452	485	29236	216	605	0	30542
25453	29811	460	188	469	0	30928
25454	29738	229	188	380	0	30535
25455	844	189	29262	302	0	30597
25456	580	163	28035	265	0	29043
25457	28064	116	591	326	0	29097
25458	790	125	354	29090	0	30359
25459	484	116	29148	622	0	30370
25460	406	28827	599	396	0	30228
25461	437	472	359	29192	0	30460
25462	29106	247	289	640	0	30282
25463	730	29542	256	351	0	30879
25464	522	486	220	28872	0	30100
25465	435	28677	210	619	0	29941
25466	325	29581	230	438	0	30574
25467	369	610	253	29631	0	30863
25468	414	321	212	29527	0	30474
25469	382	29780	222	739	0	31123
25470	29660	546	237	455	0	30898
25471	769	335	29831	284	0	31219
25472	29463	233	517	359	0	30572
25473	810	192	304	30680	0	31986
25474	504	208	268	30865	0	31845
25475	459	168	223	31089	0	31939
25476	433	125	261	31023	0	31842
25477	376	176	31032	794	0	32378
25478	432	150	598	31226	0	32406
25479	366	187	349	31629	0	32531
25480	324	33000	228	857	0	34409
25481	300	601	33451	559	0	34911
25482	256	34121	657	461	0	35495
25483	341	712	34432	376	0	35861
25484	305	34159	690	321	0	35475
25485	462	625	382	31655	0	33124
25486	31423	260	200	601	0	32484
25487	578	31453	168	374	0	32573
25488	395	511	139	31782	0	32827
25489	282	277	31884	605	0	33048
25490	209	32522	537	372	0	33640
25491	32143	549	329	367	0	33388
25492	32562	315	256	315	0	33448
25493	686	32669	215	235	0	33805
25494	382	580	32018	195	0	33175
25495	31007	326	568	220	0	32121
25496	655	265	297	32580	0	33797
25497	32216	204	219	695	0	33334
25498	644	32788	155	408	0	33995
25499	346	33713	157	288	0	34504
25500	291	719	32965	233	0	34208
25501	31700	368	559	258	0	32885
25502	702	318	299	32674	0	33993
25503	32814	186	214	612	0	33826
25504	605	33116	156	318	0	34195
25505	33180	534	185	344	0	34243
25506	32865	314	152	234	0	33565
25507	756	232	33173	180	0	34341
25508	375	31402	431	169	0	32377
25509	248	32418	226	165	0	33057
25510	263	604	158	30672	0	31697
25511	182	29831	121	392	0	30526
25512	30785	498	117	270	0	31670
25513	464	30941	108	140	0	31653
25514	285	534	80	30362	0	31261
25515	215	30003	71	377	0	30666
25516	190	29433	94	161	0	29878
25517	205	30456	65	133	0	30859
25518	227	587	103	30126	0	31043
25519	219	263	96	30429	0	31007
25520	172	240	68	30185	0	30665
25521	159	29615	71	524	0	30369
25522	173	479	29040	234	0	29926
25523	152	323	28338	138	0	28951
25524	28279	248	426	182	0	29135
25525	464	208	182	29427	0	30281
25526	220	188	29504	452	0	30364
25527	190	231	28903	224	0	29548
25528	146	30307	417	180	0	31050
25529	185	498	179	28417	0	29279
25530	156	260	114	29513	0	30043
25531	29223	243	103	582	0	30151
25532	376	211	112	29345	0	30044
25533	200	234	117	29344	0	29895
25534	144	178	29643	586	0	30551
25535	163	186	392	29365	0	30106
25536	173	195	200	30670	0	31238
25537	127	208	30571	545	0	31451
25538	108	188	30184	323	0	30803
25539	110	29970	538	270	0	30888
25540	132	502	30390	219	0	31243
25541	130	292	446	29991	0	30859
25542	391	240	338	22117	0	23086
25543	133	181	30698	609	0	31621
25544	112	30369	425	419	0	31325
25545	28876	431	270	371	0	29948
25546	375	29480	232	268	0	30355
25547	215	504	205	29583	0	30507
25548	175	279	220	29934	0	30608
25549	109	29872	246	660	0	30887
25550	131	496	256	30102	0	30985
25551	156	284	215	30253	0	30908
25552	121	259	28629	682	0	29691
25553	112	28386	481	435	0	29414
25554	152	516	267	28885	0	29820
25555	151	315	28658	604	0	29728
25556	206	219	489	28499	0	29413
25557	199	193	263	28530	0	29185
25558	178	231	212	29113	0	29734
25559	167	222	220	28988	0	29597
25560	192	239	183	28367	0	28981
25561	160	28775	184	674	0	29793
25562	28260	500	200	469	0	29429
25563	453	304	27956	443	0	29156
25564	24415	259	469	476	0	25619
25565	430	249	28787	310	0	29776
25566	174	30105	504	362	0	31145
25567	180	534	29740	315	0	30769
25568	132	30117	544	345	0	31138
25569	249	572	296	27271	0	28388
25570	192	399	187	28682	0	29460
25571	138	28903	155	674	0	29870
25572	124	30036	152	412	0	30724
25573	29856	619	144	385	0	31004
25574	30261	326	156	364	0	31107
25575	30275	228	166	342	0	31011
25576	30538	208	172	307	0	31225
25577	649	239	185	29868	0	30941
25578	274	29728	140	502	0	30644
25579	29141	453	130	356	0	30080
25580	410	220	90	27946	0	28666
25581	27136	125	70	468	0	27799
25582	26199	91	71	297	0	26658
25583	365	25242	68	179	0	25854
25584	140	24628	56	132	0	24956
25585	101	25836	57	103	0	26097
25586	122	439	92	24809	0	25462
25587	101	25819	58	261	0	26239
25588	25999	253	72	197	0	26521
25589	26735	128	51	160	0	27074
25590	26502	81	56	153	0	26792
25591	26872	91	37	149	0	27149
25592	26996	78	49	138	0	27261
25593	409	86	27585	78	0	28158
25594	27325	59	323	144	0	27851
25595	415	71	27866	62	0	28414
25596	27742	52	316	116	0	28226
25597	424	61	125	28158	0	28768
25598	212	87	25520	332	0	26151
25599	130	64	28150	139	0	28483
25600	116	30248	395	86	0	30845
25601	30520	405	192	154	0	31271
25602	31431	133	95	143	0	31802
25603	608	33716	78	70	0	34472
25604	310	547	51	38288	0	39196
25605	40759	202	48	788	0	41797
25606	880	136	41081	280	0	42377
25607	379	40871	778	190	0	42218
25608	40171	822	305	251	0	41549
25609	939	40833	180	157	0	42109
25610	604	955	162	38560	0	40281
25611	317	41206	170	723	0	42416
25612	413	1113	98	38898	0	40522
25613	306	39897	103	819	0	41125
25614	188	41710	110	423	0	42431
25615	40531	1272	65	379	0	42247
25616	41424	642	110	347	0	42523
25617	1177	492	40867	256	0	42792
25618	634	419	39659	197	0	40909
25619	483	411	40860	136	0	41890
25620	538	317	1226	40799	0	42880
25621	387	358	41703	869	0	43317
25622	403	343	1196	40941	0	42883
25623	365	325	636	40983	0	42309
25624	247	41233	434	1300	0	43214
25625	41247	1043	350	789	0	43429
25626	967	41634	316	515	0	43432
25627	587	1188	253	42595	0	44623
25628	470	693	230	43120	0	44513
25629	501	516	282	43393	0	44692
25630	456	433	42648	1449	0	44986
25631	430	408	1095	42549	0	44482
25632	431	367	619	43242	0	44659
25633	404	349	450	43910	0	45113
25634	257	411	41942	1704	0	44314
25635	260	41757	1091	1058	0	44166
25636	40958	1140	520	974	0	43592
25637	39809	638	379	936	0	41762
25638	1225	41293	372	689	0	43579
25639	769	1251	322	41016	0	43358
25640	610	748	300	42170	0	43828
25641	538	516	41007	1590	0	43651
25642	435	40798	1127	1000	0	43360
25643	405	1185	617	41272	0	43479
25644	321	581	41329	1588	0	43819
25645	343	474	1227	41148	0	43192
25646	328	455	718	41322	0	42823
25647	302	453	40983	1817	0	43555
25648	407	434	1181	40873	0	42895
25649	447	413	698	40496	0	42054
25650	378	457	40948	1816	0	43599
25651	386	388	1204	41348	0	43326
25652	397	367	747	40008	0	41519
25653	268	338	524	42386	0	43516
25654	191	345	41009	2066	0	43611
25655	267	303	1278	41385	0	43233
25656	39961	290	690	2021	0	42962
25657	39974	286	566	1433	0	42259
25658	1205	39888	556	1371	0	43020
25659	40480	1024	512	1111	0	43127
25660	1273	537	41697	957	0	44464
25661	816	408	1186	42062	0	44472
25662	617	378	691	42657	0	44343
25663	491	371	525	43503	0	44890
25664	41094	301	493	2087	0	43975
25665	1011	40858	504	1445	0	43818
25666	544	1041	426	38669	0	40680
25667	419	39483	420	1730	0	42052
25668	38958	1103	425	1235	0	41721
25669	1119	39600	388	967	0	42074
25670	38829	1203	357	945	0	41334
25671	1184	38436	367	889	0	40876
25672	736	38833	368	838	0	40775
25673	598	1370	369	38557	0	40894
25674	506	760	389	39118	0	40773
25675	499	613	343	39117	0	40572
25676	408	536	325	39230	0	40499
25677	353	571	37462	1953	0	40339
25678	388	37427	963	1363	0	40141
25679	363	1141	509	35952	0	37965
25680	372	37166	400	1613	0	39551
25681	390	1237	37001	1097	0	39725
25682	466	815	1026	36906	0	39213
25683	475	641	526	38370	0	40012
25684	396	585	37139	1655	0	39775
25685	329	36481	1087	1180	0	39077
25686	327	1057	647	36881	0	38912
25687	249	635	36166	1743	0	38793
25688	241	36038	1071	1292	0	38642
25689	300	1146	638	35666	0	37750
25690	248	762	35251	1566	0	37827
25691	265	612	33921	1051	0	35849
25692	251	33807	1218	848	0	36124
25693	260	37014	632	782	0	38688
25694	321	1350	616	37187	0	39474
25695	313	785	472	39311	0	40881
25696	227	633	38229	1655	0	40744
25697	36879	590	1064	1202	0	39735
25698	37430	539	591	1031	0	39591
25699	1153	449	36615	872	0	39089
25700	545	34469	1052	776	0	36842
25701	423	34542	657	677	0	36299
25702	385	34152	453	584	0	35574
25703	439	26731	532	649	0	28351
25704	746	1373	539	26982	0	29640
25705	116	308	98	31734	0	32256
25706	106	194	66	31743	0	32109
25707	115	147	60	32068	0	32390
25708	77	31755	52	1265	0	33149
25709	129	768	81	31767	0	32745
25710	61	31946	88	979	0	33074
25711	126	929	54	32462	0	33571
25712	31739	494	58	1077	0	33368
25713	785	302	60	32081	0	33228
25714	360	31806	57	1145	0	33368
25715	250	855	49	33034	0	34188
25716	210	473	46	33933	0	34662
25717	156	302	43	34331	0	34832
25718	32296	267	43	1799	0	34405
25719	813	326	31	33606	0	34776
25720	387	307	31990	1547	0	34231
25721	251	32903	741	1057	0	34952
25722	293	996	354	33813	0	35456
25723	327	541	209	34861	0	35938
25724	277	434	153	35549	0	36413
25725	33497	391	118	1843	0	35849
25726	1040	322	32671	1154	0	35187
25727	598	330	815	31771	0	33514
25728	345	32422	380	1492	0	34639
25729	354	1078	200	33270	0	34902
25730	31073	635	175	1725	0	33608
25731	885	31993	221	1163	0	34262
25732	524	1155	124	32610	0	34413
25733	340	589	92	33067	0	34088
25734	209	31938	152	2051	0	34350
25735	285	1098	126	33313	0	34822
25736	362	683	146	33895	0	35086
25737	189	518	32221	2048	0	34976
25738	201	32574	872	1453	0	35100
25739	32490	1240	422	1162	0	35314
25740	1095	683	32349	1073	0	35200
25741	31973	535	962	1142	0	34612
25742	1179	555	32291	1170	0	35195
25743	670	481	1038	33294	0	35483
25744	32196	427	512	2185	0	35320
25745	1199	595	315	33345	0	35454
25746	32767	520	262	2274	0	35823
25747	33238	536	281	1655	0	35710
25748	33031	614	345	1317	0	35307
25749	1698	32675	275	1118	0	35766
25750	1126	1214	303	32964	0	35607
25751	737	770	378	33936	0	35821
25752	686	621	344	34032	0	35683
25753	623	424	32478	2351	0	35876
25754	652	347	1147	33744	0	35890
25755	33010	364	685	2131	0	36190
25756	33735	341	483	1662	0	36221
25757	1871	365	32514	1266	0	36016
25758	33382	468	1181	1058	0	36089
25759	34119	498	619	1132	0	36368
25760	1925	515	378	32369	0	35187
25761	31945	406	346	2154	0	34851
25762	32511	410	301	1647	0	34869
25763	1923	436	393	32228	0	34980
25764	31981	334	523	2113	0	34951
25765	32353	434	419	1571	0	34777
25766	2041	509	405	31696	0	34651
25767	1483	474	22604	1877	0	26438
25768	30026	412	963	1311	0	32712
25769	1862	456	30789	1103	0	34210
25770	1398	357	30981	1139	0	33875
25771	1123	30690	1501	1172	0	34486
25772	1196	1121	803	30776	0	33896
25773	1142	635	487	32156	0	34420
25774	1132	343	433	31848	0	33756
25775	1174	413	30826	2187	0	34600
25776	1274	418	30807	1407	0	33906
25777	1068	30838	1574	1199	0	34679
25778	1088	1050	954	30558	0	33650
25779	1155	550	741	31864	0	34310
25780	923	345	767	32541	0	34576
25781	925	304	31048	2252	0	34529
25782	981	30390	1311	1606	0	34288
25783	1023	1007	813	31183	0	34026
25784	1033	549	31117	1902	0	34601
25785	1086	427	31277	1313	0	34103
25786	30883	425	1720	1125	0	34153
25787	31225	423	1013	1198	0	33859
25788	31799	391	648	1256	0	34094
25789	1992	305	599	30742	0	33638
25790	1215	294	30241	2000	0	33750
25791	964	29309	1343	1524	0	33140
25792	951	30726	903	1297	0	33877
25793	944	1182	27080	995	0	30201
25794	980	974	1286	24686	0	27926
25795	834	461	1000	23210	0	25505
25796	885	22534	712	1274	0	25405
25797	953	24038	501	921	0	26413
25798	23882	1000	524	781	0	26187
25799	24277	469	497	677	0	25920
25800	24397	287	430	754	0	25868
25801	23808	264	405	766	0	25243
25802	22456	313	323	689	0	23781
25803	1605	20647	371	685	0	23308
25804	533	15883	235	431	0	17082
25805	298	13400	208	254	0	14160
25806	13241	357	592	261	0	14451
25807	604	216	288	12605	0	13713
25808	234	60	133	12653	0	13080
25809	12498	63	144	402	0	13107
25810	391	12453	101	223	0	13168
25811	243	264	108	12577	0	13192
25812	226	134	106	12804	0	13270
25813	238	68	120	12808	0	13234
25814	12258	50	88	365	0	12761
25815	364	68	92	12345	0	12869
25816	217	62	11781	299	0	12359
25817	11616	72	226	167	0	12081
25818	361	63	86	11879	0	12389
25819	168	64	11945	258	0	12435
25820	180	11656	218	154	0	12208
25821	132	11529	79	96	0	11836
25822	11170	249	200	129	0	11748
25823	11282	64	78	96	0	11520
25824	228	11908	36	50	0	12222
25825	95	179	28	12565	0	12867
25826	12919	52	30	261	0	13262
25827	258	33	25	13566	0	13882
25828	139	29	16	14059	0	14243
25829	71	32	25	14190	0	14318
25830	77	23	43	14099	0	14242
25831	57	13827	35	389	0	14308
25832	44	231	34	14034	0	14343
25833	51	94	34	14127	0	14306
25834	56	56	26	14304	0	14442
25835	53	44	13682	401	0	14180
25836	50	13724	236	183	0	14193
25837	64	264	92	13798	0	14218
25838	38	90	13573	334	0	14035
25839	35	59	12899	170	0	13163
25840	36	13527	319	112	0	13994
25841	13466	281	131	119	0	13997
25842	246	107	68	13692	0	14113
25843	13614	67	64	319	0	14064
25844	283	13845	51	145	0	14324
25845	155	278	34	14013	0	14480
25846	13493	113	35	355	0	13996
25847	13827	69	42	192	0	14130
25848	370	61	36	13767	0	14234
25849	172	59	32	13741	0	14004
25850	95	56	13626	407	0	14184
25851	105	32	259	13583	0	13979
25852	87	77	115	13950	0	14229
25853	13559	50	74	428	0	14111
25854	271	13698	51	228	0	14248
25855	138	234	13324	148	0	13844
25856	12943	102	214	172	0	13431
25857	293	13485	92	130	0	14000
25858	162	270	61	13597	0	14090
25859	13601	127	49	334	0	14111
25860	309	75	44	13491	0	13919
25861	169	59	38	13623	0	13889
25862	85	65	13334	408	0	13892
25863	98	47	234	13467	0	13846
25864	13455	32	116	402	0	14005
25865	294	48	69	13591	0	14002
25866	13342	51	48	403	0	13844
25867	318	12994	59	230	0	13601
25868	163	13522	48	181	0	13914
25869	155	318	42	13582	0	14097
25870	118	147	39	13775	0	14079
25871	13238	99	28	443	0	13808
25872	289	13239	38	254	0	13820
25873	13435	267	38	234	0	13974
25874	13565	130	42	199	0	13936
25875	377	88	32	13470	0	13967
25876	13483	63	43	370	0	13959
25877	342	72	12889	221	0	13524
25878	229	49	245	13041	0	13564
25879	154	76	13215	360	0	13805
25880	133	58	279	13459	0	13929
25881	13229	66	139	404	0	13838
25882	13508	64	83	246	0	13901
25883	379	13370	54	219	0	14022
25884	237	279	63	13267	0	13846
25885	176	128	52	13414	0	13770
25886	167	13218	33	417	0	13835
25887	159	291	45	13694	0	14189
25888	127	140	37	13696	0	14000
25889	108	13424	52	458	0	14042
25890	13028	274	38	296	0	13636
25891	13095	141	52	230	0	13518
25892	384	89	40	13034	0	13547
25893	222	89	65	13115	0	13491
25894	158	89	12749	450	0	13446
25895	163	87	244	12639	0	13133
25896	155	12552	118	378	0	13203
25897	12947	273	68	280	0	13568
25898	302	155	59	12990	0	13506
25899	186	91	59	12941	0	13277
25900	12552	96	44	470	0	13162
25901	320	12546	46	276	0	13188
25902	209	274	41	12998	0	13522
25903	159	132	34	13006	0	13331
25904	137	12729	41	447	0	13354
25905	12799	277	54	247	0	13377
25906	307	160	12535	218	0	13220
25907	181	86	12525	206	0	12998
25908	145	84	312	12670	0	13211
25909	123	94	12546	337	0	13100
25910	12342	75	272	238	0	12927
25911	314	66	137	12677	0	13194
25912	177	69	12896	353	0	13495
25913	150	69	12734	233	0	13186
25914	133	13178	290	177	0	13778
25915	13162	246	137	192	0	13737
25916	294	13311	98	161	0	13864
25917	13538	260	101	161	0	14060
25918	13615	139	81	181	0	14016
25919	347	13353	66	125	0	13891
25920	13379	225	68	124	0	13796
25921	13135	119	48	143	0	13445
25922	357	75	13010	103	0	13545
25923	223	582	193	12089	0	13087
25924	122	11652	89	198	0	12061
25925	80	11459	43	113	0	11695
25926	221	328	90	10838	0	11477
25927	10540	68	48	198	0	10854
25928	126	36	26	10378	0	10566
25929	76	22	25	10729	0	10852
25930	64	32	15	11004	0	11115
25931	44	11377	18	181	0	11620
25932	58	158	11	11973	0	12200
25933	39	90	12354	205	0	12688
25934	11209	49	179	111	0	11548
25935	12629	21	69	83	0	12802
25936	266	12299	32	53	0	12650
25937	12567	189	24	44	0	12824
25938	261	72	16	12654	0	13003
25939	86	55	12524	206	0	12871
25940	12071	34	167	102	0	12374
25941	212	12554	78	62	0	12906
25942	112	174	32	12600	0	12918
25943	13009	63	28	224	0	13324
25944	216	13040	18	85	0	13359
25945	94	13423	17	59	0	13593
25946	13307	247	15	82	0	13651
25947	223	113	12936	41	0	13313
25948	13143	53	185	72	0	13453
25949	257	54	76	13125	0	13512
25950	126	42	34	13215	0	13417
25951	80	37	13016	263	0	13396
25952	77	50	12753	120	0	13000
25953	87	30	249	13067	0	13433
25954	62	42	12794	230	0	13128
25955	68	41	12876	102	0	13087
25956	98	23	268	12849	0	13238
25957	60	31	130	13244	0	13465
25958	13198	22	73	300	0	13593
25959	235	41	56	13236	0	13568
25960	13215	44	55	292	0	13606
25961	253	13191	40	143	0	13627
25962	135	211	45	13489	0	13880
25963	80	103	14045	242	0	14470
25964	13830	63	208	140	0	14241
25965	14384	48	101	123	0	14656
25966	14561	35	68	101	0	14765
25967	14386	21	53	102	0	14562
25968	14318	32	48	97	0	14495
25969	353	49	50	14008	0	14460
25970	180	30	13781	255	0	14246
25971	111	34	13461	140	0	13746
25972	100	27	14006	89	0	14222
25973	13585	31	304	98	0	14018
25974	14312	24	145	96	0	14577
25975	349	25	85	13870	0	14329
25976	187	14431	69	232	0	14919
25977	127	215	57	14788	0	15187
25978	119	91	14661	291	0	15162
25979	107	58	14144	139	0	14448
25980	13818	42	316	131	0	14307
25981	297	37	15041	75	0	15450
25982	186	38	275	14975	0	15474
25983	15815	23	137	311	0	16286
25984	14913	38	103	176	0	15230
25985	16171	28	72	118	0	16389
25986	16311	24	72	114	0	16521
25987	415	21	15853	81	0	16370
25988	15404	26	279	95	0	15804
25989	365	15773	142	64	0	16344
25990	203	230	94	16147	0	16674
25991	154	105	16153	266	0	16678
25992	167	63	285	16038	0	16553
25993	130	48	16513	321	0	17012
25994	127	48	306	16301	0	16782
25995	127	37	178	16639	0	16981
25996	113	38	16372	389	0	16912
25997	127	40	317	16192	0	16676
25998	16371	29	156	372	0	16928
25999	338	28	124	16507	0	16997
26000	178	40	109	16796	0	17123
26001	16538	37	95	419	0	17089
26002	330	16597	106	198	0	17231
26003	16841	242	87	171	0	17341
26004	392	16973	79	107	0	17551
26005	17593	283	85	164	0	18125
26006	384	133	17600	111	0	18228
26007	229	75	289	17550	0	18143
26008	150	57	155	17880	0	18242
26009	17638	41	118	436	0	18233
26010	325	17576	110	212	0	18223
26011	187	239	114	17412	0	17952
26012	146	94	94	17408	0	17742
26013	112	16788	72	411	0	17383
26014	16767	253	82	246	0	17348
26015	310	16782	95	169	0	17356
26016	180	270	77	16799	0	17326
26017	159	118	79	16463	0	16819
26018	116	16299	72	411	0	16898
26019	16097	284	76	236	0	16693
26020	347	136	15878	145	0	16506
26021	15411	84	276	158	0	15929
26022	360	15941	120	105	0	16526
26023	199	270	84	16070	0	16623
26024	16126	91	85	345	0	16647
26025	347	61	79	16071	0	16558
26026	204	54	58	16281	0	16597
26027	16093	49	52	427	0	16621
26028	321	15692	59	201	0	16273
26029	167	16071	42	137	0	16417
26030	15906	257	42	146	0	16351
26031	270	98	16254	93	0	16715
26032	136	15412	181	77	0	15806
26033	158	204	141	16043	0	16546
26034	53	80	18556	167	0	18856
26035	90	59	269	18114	0	18532
26036	18364	36	111	342	0	18853
26037	287	18715	64	138	0	19204
26038	198	280	43	17675	0	18196
26039	78	18755	48	241	0	19122
26040	18903	316	17	145	0	19381
26041	19319	133	21	125	0	19598
26042	420	19427	23	76	0	19946
26043	206	316	27	18982	0	19531
26044	100	19467	38	298	0	19903
26045	19624	360	32	153	0	20169
26046	19943	171	44	104	0	20262
26047	496	95	44	19562	0	20197
26048	260	76	27	19940	0	20303
26049	142	78	19345	492	0	20057
26050	18190	58	329	288	0	18865
26051	415	87	19403	136	0	20041
26052	236	73	368	19240	0	19917
26053	19304	59	168	417	0	19948
26054	417	19773	78	189	0	20457
26055	18724	377	71	189	0	19361
26056	423	203	17345	152	0	18123
26057	18408	114	254	151	0	18927
26058	476	19546	116	98	0	20236
26059	19728	362	67	157	0	20314
26060	474	20208	70	129	0	20881
26061	262	430	62	20189	0	20943
26062	170	218	19804	432	0	20624
26063	161	157	18830	182	0	19330
26064	173	101	461	19124	0	19859
26065	160	105	19443	420	0	20128
26066	155	101	408	19260	0	19924
26067	199	85	182	19317	0	19783
26068	127	114	19810	518	0	20569
26069	16848	80	408	331	0	17667
26070	19626	106	181	206	0	20119
26071	537	19377	112	142	0	20168
26072	19433	377	86	141	0	20037
26073	490	144	93	19413	0	20140
26074	251	111	20039	398	0	20799
26075	190	115	376	19898	0	20579
26076	158	84	186	20226	0	20654
26077	19710	67	140	524	0	20441
26078	383	19339	101	269	0	20092
26079	209	19570	73	191	0	20043
26080	169	392	92	19816	0	20469
26081	162	184	70	19402	0	19818
26082	132	19162	92	448	0	19834
26083	182	354	71	18857	0	19464
26084	155	186	76	18756	0	19173
26085	112	18504	58	503	0	19177
26086	18266	343	80	282	0	18971
26087	360	148	95	18345	0	18948
26088	162	18338	90	446	0	19036
26089	169	333	78	18466	0	19046
26090	18219	171	62	487	0	18939
26091	379	18260	55	252	0	18946
26092	18413	410	44	234	0	19101
26093	18487	210	41	205	0	18943
26094	531	159	42	18579	0	19311
26095	19214	144	44	475	0	19877
26096	19653	116	42	286	0	20097
26097	19775	120	43	230	0	20168
26098	19933	92	59	211	0	20295
26099	583	95	56	19955	0	20689
26100	300	108	45	20301	0	20754
26101	231	90	19907	556	0	20784
26102	216	110	328	20223	0	20877
26103	225	104	124	20517	0	20970
26104	186	114	20072	598	0	20970
26105	19339	87	381	335	0	20142
26106	505	93	151	20250	0	20999
26107	282	71	20502	518	0	21373
26108	19459	77	412	365	0	20313
26109	582	76	21671	217	0	22546
26110	325	21654	464	232	0	22675
26111	258	22793	197	211	0	23459
26112	233	541	134	23769	0	24677
26113	168	212	25352	595	0	26327
26114	24703	138	525	395	0	25761
26115	26425	116	222	342	0	27105
26116	722	110	26203	209	0	27244
26117	25807	77	553	246	0	26683
26118	26674	68	267	270	0	27279
26119	766	26547	247	179	0	27739
26120	26866	464	167	222	0	27719
26121	717	191	213	26565	0	27686
26122	361	193	26656	548	0	27758
26123	332	195	513	25097	0	26137
26124	200	26805	240	596	0	27841
26125	202	27932	240	296	0	28670
26126	27720	596	180	276	0	28772
26127	27652	281	181	226	0	28340
26128	27489	214	225	194	0	28122
26129	896	168	144	27079	0	28287
26130	520	301	173	26034	0	27028
26131	356	26122	168	648	0	27294
26132	25824	522	168	427	0	26941
26133	704	26105	224	333	0	27366
26134	23426	359	178	193	0	24156
26135	617	23461	154	161	0	24393
26136	23551	439	201	139	0	24330
26137	22780	227	114	173	0	23294
26138	729	223	114	22605	0	23671
26139	424	23557	146	364	0	24491
26140	455	385	22244	201	0	23285
26141	21476	193	304	303	0	22276
26142	476	21209	150	231	0	22066
26143	278	414	22270	184	0	23146
26144	272	230	22188	166	0	22856
26145	288	259	310	21323	0	22180
26146	341	178	90	21103	0	21712
26147	271	22408	67	345	0	23091
26148	23030	359	54	211	0	23654
26149	511	192	46	22366	0	23115
26150	318	22904	44	364	0	23630
26151	286	23905	48	164	0	24403
26152	279	397	23226	162	0	24064
26153	286	284	23028	143	0	23741
26154	22482	275	296	150	0	23203
26155	471	227	23337	115	0	24150
26156	346	210	325	22978	0	23859
26157	323	179	137	23745	0	24384
26158	250	193	23581	422	0	24446
26159	278	239	334	23053	0	23904
26160	315	160	202	21422	0	22099
26161	22808	176	190	480	0	23654
26162	23220	244	214	230	0	23908
26163	428	182	246	22904	0	23760
26164	235	22652	278	398	0	23563
26165	175	23871	220	264	0	24530
26166	23856	389	212	293	0	24750
26167	424	257	23798	256	0	24735
26168	297	202	377	23721	0	24597
26169	24337	222	240	543	0	25342
26170	24550	248	243	278	0	25319
26171	515	225	207	24572	0	25519
26172	275	204	24507	473	0	25459
26173	364	218	22556	231	0	23369
26174	22332	196	526	298	0	23352
26175	23348	193	376	314	0	24231
26176	512	23599	295	304	0	24710
26177	385	24083	255	355	0	25078
26178	24548	389	311	354	0	25602
26179	24649	220	221	426	0	25516
26180	664	198	180	24991	0	26033
26181	523	176	238	25287	0	26224
26182	507	192	163	25519	0	26381
26183	25327	229	173	634	0	26363
26184	748	268	200	25205	0	26421
26185	490	252	25451	475	0	26668
26186	24665	188	399	376	0	25628
26187	684	240	252	25524	0	26700
26188	417	306	25776	501	0	27000
26189	24975	267	382	377	0	26001
26190	22476	304	257	388	0	23425
26191	624	26499	221	341	0	27685
26192	493	27169	248	280	0	28190
26193	460	463	24590	307	0	25820
26194	25936	311	326	386	0	26959
26195	685	27029	205	244	0	28163
26196	489	525	24788	274	0	26076
26197	25300	279	328	295	0	26202
26198	702	27566	127	328	0	28723
26199	390	481	26940	382	0	28193
26200	25663	295	360	398	0	26716
26201	685	26890	133	335	0	28043
26202	398	350	140	26416	0	27304
26203	26337	173	167	534	0	27211
26204	501	26231	150	378	0	27260
26205	329	409	210	25948	0	26896
26206	25943	113	174	474	0	26704
26207	449	114	25756	276	0	26595
26208	224	24981	401	194	0	25800
26209	292	295	24536	141	0	25264
26210	216	262	324	23578	0	24380
26211	148	114	23556	267	0	24085
26212	145	22230	223	103	0	22701
26213	81	21174	132	52	0	21439
26214	124	216	66	20819	0	21225
26215	88	64	47	20007	0	20206
26216	55	45	44	20323	0	20467
26217	64	44	20681	195	0	20984
26218	68	30	177	20682	0	20957
26219	20566	42	55	249	0	20912
26220	20230	36	41	146	0	20453
26221	213	46	20903	65	0	21227
26222	79	20561	173	75	0	20888
26223	20377	157	59	119	0	20712
26224	172	20255	62	82	0	20571
26225	20146	167	61	129	0	20503
26226	20095	62	44	130	0	20331
26227	231	61	20067	57	0	20416
26228	83	20479	180	70	0	20812
26229	111	159	60	20603	0	20933
26230	82	62	20662	185	0	20991
26231	19627	54	196	122	0	19999
26232	240	64	67	20556	0	20927
26233	101	46	20179	183	0	20509
26234	19243	28	181	135	0	19587
26235	221	43	20766	41	0	21071
26236	124	52	204	20736	0	21116
26237	21384	35	76	260	0	21755
26238	226	21951	68	69	0	22314
26239	102	207	21972	56	0	22337
26240	21263	59	206	121	0	21649
26241	23044	42	95	94	0	23275
26242	290	23687	72	49	0	24098
26243	151	237	52	23776	0	24216
26244	118	62	52	23710	0	23942
26245	23500	52	47	351	0	23950
26246	296	54	44	23788	0	24182
26247	107	46	23835	295	0	24283
26248	124	26	258	23414	0	23822
26249	23529	33	81	367	0	24010
26250	265	23317	75	148	0	23805
26251	155	251	60	22365	0	22831
26252	106	22728	40	271	0	23145
26253	23177	287	55	158	0	23677
26254	336	101	51	24620	0	25108
26255	164	68	38	24815	0	25085
26256	103	24919	50	463	0	25535
26257	97	377	24502	201	0	25177
26258	152	140	365	24119	0	24776
26259	117	94	128	24749	0	25088
26260	141	83	62	24548	0	24834
26261	65	24389	74	493	0	25021
26262	80	353	24375	240	0	25048
26263	81	175	24184	163	0	24603
26264	23975	96	460	185	0	24716
26265	24588	78	178	170	0	25014
26266	487	65	24699	127	0	25378
26267	23738	64	408	189	0	24399
26268	466	61	25122	116	0	25765
26269	23849	66	442	178	0	24535
26270	440	25304	191	136	0	26071
26271	25862	406	142	161	0	26571
26272	509	177	26279	149	0	27114
26273	266	126	26681	129	0	27202
26274	230	95	592	29623	0	30540
26275	30351	79	266	753	0	31449
26276	702	32588	168	331	0	33789
26277	307	705	35824	197	0	37033
26278	354	275	924	36055	0	37608
26279	285	141	345	37931	0	38702
26280	37137	114	235	1258	0	38744
26281	37693	99	196	496	0	38484
26282	1363	94	138	37224	0	38819
26283	37485	96	153	1130	0	38864
26284	1218	104	36767	406	0	38495
26285	587	99	1000	36050	0	37736
26286	421	74	387	37592	0	38474
26287	36975	108	237	1325	0	38645
26288	37170	107	206	602	0	38085
26289	1427	83	191	36596	0	38297
26290	36660	112	188	1230	0	38190
26291	1231	98	35524	545	0	37398
26292	569	35081	997	384	0	37031
26293	362	921	35483	364	0	37130
26294	426	403	1093	35763	0	37685
26295	34965	168	450	1220	0	36803
26296	1153	34725	290	560	0	36728
26297	630	966	219	34441	0	36256
26298	452	333	241	33753	0	34779
26299	352	33980	233	1344	0	35909
26300	436	1028	185	34750	0	36399
26301	395	379	243	35017	0	36034
26302	464	210	213	35648	0	36535
26303	376	189	201	35413	0	36179
26304	448	159	205	34760	0	35572
26305	370	33707	259	1592	0	35928
26306	379	986	197	34422	0	35984
26307	487	349	187	34807	0	35830
26308	361	250	33206	1610	0	35427
26309	355	32954	1020	848	0	35177
26310	392	1014	420	33502	0	35328
26311	373	417	274	33972	0	35036
26312	451	244	253	33646	0	34594
26313	326	32545	242	1660	0	34773
26314	361	1015	32673	983	0	35032
26315	444	381	1062	33425	0	35312
26316	348	299	32875	1515	0	35037
26317	322	258	32665	858	0	34103
26318	321	224	1293	32820	0	34658
26319	32697	235	553	1594	0	35079
26320	1170	223	366	32951	0	34710
26321	558	242	287	32627	0	33714
26322	364	32389	291	1715	0	34759
26323	406	1064	259	33612	0	35341
26324	308	458	265	34460	0	35491
26325	262	332	33622	1817	0	36033
26326	238	33466	1083	1029	0	35816
26327	293	1097	464	34360	0	36214
26328	33038	464	373	1671	0	35546
26329	1039	331	33210	1021	0	35601
26330	521	316	1087	33512	0	35436
26331	378	276	504	34459	0	35617
26332	32886	272	332	1916	0	35406
26333	1061	32861	365	1110	0	35397
26334	32292	1060	290	1011	0	34653
26335	1067	32346	267	915	0	34595
26336	578	1119	271	32553	0	34521
26337	31642	504	257	1702	0	34105
26338	1133	342	31197	1036	0	33708
26339	511	30358	1039	877	0	32785
26340	368	31202	548	803	0	32921
26341	29688	1209	444	766	0	32107
26342	1077	495	363	29017	0	30952
26343	522	28321	342	1451	0	30636
26344	394	29911	299	961	0	31565
26345	453	1198	231	29741	0	31623
26346	442	541	262	30371	0	31616
26347	28888	410	257	1738	0	31293
26348	1068	28863	244	1030	0	31205
26349	594	1118	312	28903	0	30927
26350	391	511	28519	1463	0	30884
26351	401	28350	1032	900	0	30683
26352	331	1095	28152	727	0	30305
26353	341	28173	1045	756	0	30315
26354	453	1054	478	26870	0	28855
26355	337	490	226	26604	0	27657
26356	296	26460	247	1318	0	28321
26357	233	1021	26430	756	0	28440
26358	26197	500	852	686	0	28235
26359	927	401	354	27366	0	29048
26360	432	379	284	28110	0	29205
26361	317	392	27335	1377	0	29421
26362	293	422	873	27707	0	29295
26363	228	367	27459	1396	0	29450
26364	272	386	924	27642	0	29224
26365	222	391	28021	1272	0	29906
26366	185	28157	916	863	0	30121
26367	189	1071	28646	705	0	30611
26368	222	542	937	28640	0	30341
26369	28023	334	402	1376	0	30135
26370	886	27530	265	744	0	29425
26371	401	1061	267	27194	0	28923
26372	284	464	26427	1218	0	28393
26373	193	26484	933	693	0	28303
26374	264	1050	357	22885	0	24556
26375	138	394	23004	808	0	24344
26376	105	20167	566	349	0	21187
26377	16135	605	422	260	0	17422
26378	15253	135	147	165	0	15700
26379	309	49	64	15177	0	15599
26380	15141	70	74	312	0	15597
26381	282	44	61	15008	0	15395
26382	120	41	53	15314	0	15528
26383	58	59	15558	335	0	16010
26384	77	48	268	15278	0	15671
26385	72	52	90	15666	0	15880
26386	15254	47	61	410	0	15772
26387	15050	61	49	201	0	15361
26388	301	15150	44	113	0	15608
26389	129	251	15248	87	0	15715
26390	83	119	260	15008	0	15470
26391	80	55	14814	299	0	15248
26392	13391	54	240	183	0	13868
26393	263	44	14230	99	0	14636
26394	145	40	226	13585	0	13996
26395	47	13935	84	232	0	14298
26396	79	205	55	13901	0	14240
26397	58	79	66	13974	0	14177
26398	45	48	14115	327	0	14535
26399	81	37	220	14062	0	14400
26400	13939	33	98	326	0	14396
26401	14017	38	54	197	0	14306
26402	13970	36	65	115	0	14186
26403	14008	27	58	161	0	14254
26404	283	13597	55	114	0	14049
26405	113	13658	85	74	0	13930
26406	143	239	74	12174	0	12630
26407	78	74	79	13614	0	13845
26408	75	12650	68	301	0	13094
26409	85	205	52	13740	0	14082
26410	88	84	49	13864	0	14085
26411	86	62	63	13804	0	14015
26412	72	69	63	13760	0	13964
26413	70	54	50	13972	0	14146
26414	13529	39	63	385	0	14016
26415	248	13424	49	169	0	13890
26416	125	219	13324	127	0	13795
26417	107	91	230	13360	0	13788
26418	76	77	96	13612	0	13861
26419	98	62	49	13505	0	13714
26420	13759	50	54	434	0	14297
26421	259	15996	66	189	0	16510
26422	164	430	45	16073	0	16712
26423	87	16833	60	541	0	17521
26424	129	541	41	16355	0	17066
26425	85	16315	49	595	0	17044
26426	93	552	17371	276	0	18292
26427	120	200	606	18365	0	19291
26428	90	131	21716	768	0	22705
26429	122	91	815	21695	0	22723
26430	107	97	280	23793	0	24277
26431	23265	80	152	1235	0	24732
26432	23784	78	88	533	0	24483
26433	24278	87	95	321	0	24781
26434	24197	96	93	260	0	24646
26435	24346	74	118	245	0	24783
26436	1311	85	84	22793	0	24273
26437	467	23387	118	1001	0	24973
26438	356	904	81	23403	0	24744
26439	218	309	22480	1137	0	24144
26440	22626	201	817	496	0	24140
26441	23987	112	272	370	0	24741
26442	1325	80	180	23251	0	24836
26443	602	83	112	23203	0	24000
26444	382	22451	110	1226	0	24169
26445	314	852	84	23248	0	24498
26446	304	336	85	23259	0	23984
26447	279	22646	105	1288	0	24318
26448	319	895	104	23405	0	24723
26449	21058	332	92	1332	0	22814
26450	984	224	22228	549	0	23985
26451	22123	185	852	502	0	23662
26452	1101	139	22445	438	0	24123
26453	492	162	1001	22089	0	23744
26454	393	135	325	21935	0	22788
26455	287	21125	204	1337	0	22953
26456	273	22670	136	597	0	23676
26457	341	1099	121	21550	0	23111
26458	298	399	21529	1144	0	23370
26459	20842	219	903	527	0	22491
26460	1072	140	319	21004	0	22535
26461	397	20859	275	1090	0	22621
26462	355	900	122	21250	0	22627
26463	306	374	127	21209	0	22016
26464	269	20497	107	1237	0	22110
26465	353	951	106	19904	0	21314
26466	241	312	18531	1069	0	20153
26467	211	215	18624	499	0	19549
26468	285	191	889	17356	0	18721
26469	141	18496	323	898	0	19858
26470	169	867	188	18852	0	20076
26471	18711	355	121	1066	0	20253
26472	19342	235	126	558	0	20261
26473	18706	175	116	387	0	19384
26474	1038	18243	141	314	0	19736
26475	401	777	18178	307	0	19663
26476	18075	341	813	319	0	19548
26477	18877	270	299	353	0	19799
26478	985	18361	182	361	0	19889
26479	435	848	130	18486	0	19899
26480	18474	423	131	959	0	19987
26481	18969	264	165	522	0	19920
26482	19301	173	186	404	0	20064
26483	1188	181	221	18128	0	19718
26484	18600	153	189	1038	0	19980
26485	1099	176	180	18490	0	19945
26486	596	146	130	19106	0	19978
26487	18506	167	109	1254	0	20036
26488	1112	231	124	18429	0	19896
26489	18412	199	119	1171	0	19901
26490	1234	179	167	18342	0	19922
26491	654	143	178	19101	0	20076
26492	18173	206	121	1367	0	19867
26493	1113	211	17940	772	0	20036
26494	663	181	798	18645	0	20287
26495	678	133	318	19019	0	20148
26496	671	130	197	18927	0	19925
26497	576	169	134	19375	0	20254
26498	549	148	103	18740	0	19540
26499	472	17919	171	1439	0	20001
26500	503	800	150	18557	0	20010
26501	522	332	17880	1312	0	20046
26502	474	314	823	18491	0	20102
26503	487	179	293	19067	0	20026
26504	509	176	203	19432	0	20320
26505	406	171	18108	1560	0	20245
26506	433	206	18212	882	0	19733
26507	17853	227	1015	725	0	19820
26508	18645	188	459	662	0	19954
26509	1153	18623	266	681	0	20723
26510	593	877	198	19434	0	21102
26511	450	438	139	20456	0	21483
26512	290	287	191	20712	0	21480
26513	19714	213	227	1585	0	21739
26514	20529	177	247	828	0	21781
26515	1160	170	244	20273	0	21847
26516	613	226	181	20559	0	21579
26517	447	220	192	20776	0	21635
26518	337	233	187	20875	0	21632
26519	19465	230	199	1585	0	21479
26520	917	202	18619	926	0	20664
26521	357	15194	599	641	0	16791
26522	316	15324	229	454	0	16323
26523	14585	560	163	461	0	15769
26524	586	625	179	14258	0	15648
26525	270	188	14110	781	0	15349
26526	202	153	12530	426	0	13311
26527	164	12799	421	413	0	13797
26528	9559	141	196	139	0	10035
26529	137	55	9403	101	0	9696
26530	7928	40	94	43	0	8105
26531	46	10	18	8330	0	8404
26532	32	17	10	8411	0	8470
26533	20	8254	8	61	0	8343
26534	18	8227	9	43	0	8297
26535	8597	42	13	45	0	8697
26536	8662	25	6	39	0	8732
26537	56	8579	10	28	0	8673
26538	23	35	8443	13	0	8514
26539	15	18	8471	20	0	8524
26540	25	17	43	8605	0	8690
26541	8871	7	36	54	0	8968
26542	31	8868	13	27	0	8939
26543	24	28	10	9202	0	9264
26544	9252	19	9	62	0	9342
26545	49	8	10	9336	0	9403
26546	34	14	5	9527	0	9580
26547	9468	8	5	72	0	9553
26548	41	9352	14	47	0	9454
26549	31	9705	11	31	0	9778
26550	29	52	10051	25	0	10157
26551	27	30	35	10169	0	10261
26552	25	27	23	10251	0	10326
26553	16	15	10676	65	0	10772
26554	9194	12	40	94	0	9340
26555	9916	2	26	79	0	10023
26556	62	14	10591	24	0	10691
26557	8877	13	51	71	0	9012
26558	65	9	10724	20	0	10818
26559	32	11078	56	35	0	11201
26560	42	44	27	11787	0	11900
26561	29	34	18	12249	0	12330
26562	12296	25	14	106	0	12441
26563	12067	12	17	78	0	12174
26564	12114	12	19	62	0	12207
26565	12272	4	13	48	0	12337
26566	12155	8	20	54	0	12237
26567	86	15	11836	23	0	11960
26568	49	11980	47	23	0	12099
26569	43	44	28	12076	0	12191
26570	23	12043	23	50	0	12139
26571	32	12199	15	43	0	12289
26572	29	63	15	12145	0	12252
26573	33	40	11	12236	0	12320
26574	37	32	12146	62	0	12277
26575	11104	18	42	81	0	11245
26576	12148	11	29	52	0	12240
26577	65	11999	37	29	0	12130
26578	12093	40	19	41	0	12193
26579	12304	26	12	56	0	12398
26580	67	22	13	12326	0	12428
26581	49	24	12731	42	0	12846
26582	42	16	12446	36	0	12540
26583	12645	16	44	55	0	12760
26584	12786	13	31	56	0	12886
26585	61	12643	27	25	0	12756
26586	53	13086	17	29	0	13185
26587	47	62	9	13430	0	13548
26588	13491	48	6	71	0	13616
26589	54	36	13454	33	0	13577
26590	46	18	41	13660	0	13765
26591	13892	9	33	89	0	14023
26592	13849	7	32	73	0	13961
26593	85	11	25	14050	0	14171
26594	14030	10	17	99	0	14156
26595	92	17	13550	34	0	13693
26596	66	35	14273	28	0	14402
26597	52	14	70	14142	0	14278
26598	43	15	46	15046	0	15150
26599	25	15	36	14981	0	15057
26600	32	14346	25	93	0	14496
26601	38	14749	19	62	0	14868
26602	35	76	11	15162	0	15284
26603	15170	45	15	98	0	15328
26604	77	31	15	15300	0	15423
26605	64	20	8	15291	0	15383
26606	33	15017	32	96	0	15178
26607	26	15674	26	59	0	15785
26608	37	69	14	15833	0	15953
26609	34	49	12	15260	0	15355
26610	14909	43	12	119	0	15083
26611	62	14648	9	72	0	14791
26612	14869	59	12	89	0	15029
26613	83	39	15	14970	0	15107
26614	57	33	14589	68	0	14747
26615	38	30	13993	59	0	14120
26616	14682	15	92	62	0	14851
26617	87	26	52	15469	0	15634
26618	57	16	31	15530	0	15634
26619	36	18	20	15668	0	15742
26620	28	14	15830	107	0	15979
26621	30	11	65	16060	0	16166
26622	22	15635	36	119	0	15812
26623	35	73	20	16647	0	16775
26624	30	35	17	16641	0	16723
26625	36	16741	23	116	0	16916
26626	35	115	15	17347	0	17512
26627	16912	38	13	194	0	17157
26628	135	16836	18	80	0	17069
26629	17326	164	8	86	0	17584
26630	17476	55	7	79	0	17617
26631	240	36	13	17334	0	17623
26632	122	33	15	17164	0	17334
26633	79	13	14	17513	0	17619
26634	57	20	16872	268	0	17217
26635	31	16182	162	144	0	16519
26636	29	16980	60	80	0	17149
26637	43	207	25	16814	0	17089
26638	16629	68	27	229	0	16953
26639	200	46	13	16488	0	16747
26640	77	46	16559	230	0	16912
26641	59	16012	158	108	0	16337
26642	48	16663	48	71	0	16830
26643	16545	207	24	93	0	16869
26644	16726	77	33	93	0	16929
26645	220	18023	33	55	0	18331
26646	18463	195	21	108	0	18787
26647	251	78	18188	46	0	18563
26648	106	65	17633	40	0	17844
26649	18182	50	245	94	0	18571
26650	18826	34	95	72	0	19027
26651	315	21	51	18697	0	19084
26652	18446	33	42	306	0	18827
26653	285	49	18303	103	0	18740
26654	122	49	19560	80	0	19811
26655	157	41	325	21081	0	21604
26656	111	44	108	24378	0	24641
26657	103	25	62	25229	0	25419
26658	127	37	61	24614	0	24839
26659	114	44	46	26728	0	26932
26660	73	44	25636	919	0	26672
26661	114	29	536	25657	0	26336
26662	25472	21	197	939	0	26629
26663	625	32	151	25851	0	26659
26664	25526	36	114	944	0	26620
26665	713	33	95	25846	0	26687
26666	25939	41	112	927	0	27019
26667	26801	44	75	620	0	27540
26668	955	32	87	26488	0	27562
26669	467	27	127	27143	0	27764
26670	26595	31	86	1035	0	27747
26671	26771	34	78	658	0	27541
26672	974	54	26660	497	0	28185
26673	657	32	548	26884	0	28121
26674	510	23	212	27957	0	28702
26675	27570	34	168	1055	0	28827
26676	28133	33	134	602	0	28902
26677	1011	41	102	28066	0	29220
26678	599	34	122	28560	0	29315
26679	551	21	99	28559	0	29230
26680	460	25	94	28365	0	28944
26681	336	26131	165	1259	0	27891
26682	274	27075	112	804	0	28265
26683	281	666	79	27211	0	28237
26684	302	26846	99	1000	0	28247
26685	353	695	70	27572	0	28690
26686	229	286	26830	1173	0	28518
26687	198	268	25845	795	0	27106
26688	178	26999	711	712	0	28600
26689	229	681	333	27325	0	28568
26690	217	391	26986	974	0	28568
26691	251	297	697	26615	0	27860
26692	236	230	321	27847	0	28634
26693	26769	219	271	1283	0	28542
26694	793	188	248	27475	0	28704
26695	397	136	27362	1154	0	29049
26696	361	176	26589	665	0	27791
26697	350	26059	822	679	0	27910
26698	317	28064	441	643	0	29465
26699	28362	719	394	642	0	30117
26700	835	319	30748	619	0	32521
26701	527	231	794	30876	0	32428
26702	31193	184	402	1089	0	32868
26703	31294	162	322	768	0	32546
26704	973	31644	382	614	0	33613
26705	701	676	318	30549	0	32244
26706	528	360	256	33194	0	34338
26707	462	312	194	32864	0	33832
26708	32178	210	208	1346	0	33942
26709	869	187	31590	877	0	33523
26710	467	32094	693	811	0	34065
26711	581	717	283	32213	0	33794
26712	455	375	273	33401	0	34504
26713	349	349	32326	1299	0	34323
26714	394	235	754	32345	0	33728
26715	302	201	359	33521	0	34383
26716	337	244	289	33475	0	34345
26717	389	178	290	33392	0	34249
26718	270	242	32093	1542	0	34147
26719	259	234	796	32346	0	33635
26720	205	163	32178	1607	0	34153
26721	209	31526	920	1093	0	33748
26722	295	607	479	32494	0	33875
26723	333	244	384	33194	0	34155
26724	268	230	31942	1496	0	33936
26725	264	30987	757	1185	0	33193
26726	325	626	432	31582	0	32965
26727	361	299	31276	1189	0	33125
26728	329	30668	713	900	0	32610
26729	320	657	412	31477	0	32866
26730	341	368	31167	1085	0	32961
26731	420	313	697	31160	0	32590
26732	384	244	426	30764	0	31818
26733	292	259	474	32119	0	33144
26734	31153	302	290	1340	0	33085
26735	701	30881	269	976	0	32827
26736	31084	632	317	853	0	32886
26737	830	337	30991	792	0	32950
26738	30977	268	684	918	0	32847
26739	33112	225	393	849	0	34579
26740	873	226	314	33222	0	34635
26741	33535	250	244	1267	0	35296
26742	34009	242	227	897	0	35375
26743	34733	259	198	885	0	36075
26744	1008	284	203	34666	0	36161
26745	668	231	193	33597	0	34689
26746	463	171	32014	1052	0	33700
26747	454	169	29651	703	0	30977
26748	30638	158	698	682	0	32176
26749	675	297	405	31900	0	33277
26750	412	31742	372	863	0	33389
26751	32009	453	359	648	0	33469
26752	664	31482	250	611	0	33007
26753	379	31219	246	644	0	32488
26754	446	581	29225	585	0	30837
26755	200	182	28063	277	0	28722
26756	262	463	442	27468	0	28635
26757	162	87	29148	383	0	29780
26758	100	82	26593	120	0	26895
26759	25292	37	117	206	0	25652
26760	27011	35	62	155	0	27263
26761	126	37	52	27342	0	27557
26762	97	32	47	27437	0	27613
26763	51	50	27838	121	0	28060
26764	28	27943	106	99	0	28176
26765	72	100	65	27629	0	27866
26766	29232	32	58	273	0	29595
26767	138	27	41	29567	0	29773
26768	57	29790	44	152	0	30043
26769	64	121	29335	84	0	29604
26770	36	30141	121	80	0	30378
26771	30216	118	53	169	0	30556
26772	29515	42	39	143	0	29739
26773	162	34	22	29540	0	29758
26774	73	34	29694	146	0	29947
26775	57	57	26918	82	0	27114
26776	33	29380	168	81	0	29662
26777	114	139	79	27994	0	28326
26778	76	52	34	29943	0	30105
26779	46	39	29627	161	0	29873
26780	75	24	140	29249	0	29488
26781	27	31038	68	188	0	31321
26782	74	181	50	31518	0	31823
26783	82	56	30	31659	0	31827
26784	25	48	31474	267	0	31814
26785	71	32	201	30445	0	30749
26786	30522	18	90	358	0	30988
26787	218	31	31021	75	0	31345
26788	98	32	30069	54	0	30253
26789	48	31314	278	44	0	31684
26790	96	223	104	32206	0	32629
26791	88	78	51	33324	0	33541
26792	32	54	32978	320	0	33384
26793	30542	25	273	254	0	31094
26794	278	18	103	33033	0	33432
26795	126	46	32583	262	0	33017
26796	135	15	269	31450	0	31869
26797	29	32	32462	323	0	32846
26798	57	29	31127	135	0	31348
26799	31	31483	352	103	0	31969
26800	97	259	136	29105	0	29597
26801	19	30219	83	275	0	30596
26802	29271	276	68	253	0	29868
26803	261	128	29916	66	0	30371
26804	95	29237	289	84	0	29705
26805	89	270	123	29331	0	29813
26806	28961	111	102	408	0	29582
26807	261	29102	83	180	0	29626
26808	150	271	65	29680	0	30166
26809	99	115	70	29754	0	30038
26810	40	30760	62	403	0	31265
26811	30921	330	95	271	0	31617
26812	385	137	96	35011	0	35629
26813	194	103	53	36884	0	37234
26814	65	75	36293	817	0	37250
26815	47	37395	625	371	0	38438
26816	151	654	269	37644	0	38718
26817	168	270	143	40412	0	40993
26818	42	41143	106	931	0	42222
26819	141	790	69	41477	0	42477
26820	183	318	73	42806	0	43380
26821	133	175	74	43027	0	43409
26822	41	42815	87	1225	0	44168
26823	42076	851	71	707	0	43705
26824	839	403	42514	322	0	44078
26825	40406	208	852	457	0	41923
26826	930	42461	353	267	0	44011
26827	436	869	192	42569	0	44066
26828	203	424	42749	995	0	44371
26829	264	280	878	42638	0	44060
26830	253	166	389	42903	0	43711
26831	227	148	227	44012	0	44614
26832	108	211	43075	1394	0	44788
26833	121	42163	935	793	0	44012
26834	112	908	43037	520	0	44577
26835	105	43231	1057	438	0	44831
26836	129	1063	43801	405	0	45398
26837	214	494	1051	43490	0	45249
26838	42278	291	530	1326	0	44425
26839	870	43289	339	689	0	45187
26840	381	1029	43525	515	0	45450
26841	197	43359	989	474	0	45019
26842	225	1140	43401	394	0	45160
26843	281	536	1165	41494	0	43476
26844	306	382	528	41016	0	42232
26845	147	41702	389	1389	0	43627
26846	151	43615	347	751	0	44864
26847	43109	1387	324	637	0	45457
26848	1107	686	342	43510	0	45645
26849	461	489	43567	1351	0	45868
26850	406	371	1124	43438	0	45339
26851	215	364	43927	1500	0	46006
26852	230	403	43648	824	0	45105
26853	337	374	1449	41596	0	43756
26854	189	43064	768	1232	0	45253
26855	42055	1212	507	878	0	44652
26856	1088	649	420	41741	0	43898
26857	575	463	405	40593	0	42036
26858	298	41515	392	1529	0	43734
26859	40853	1248	386	940	0	43427
26860	41489	711	364	703	0	43267
26861	1447	462	391	40451	0	42751
26862	628	40163	403	1393	0	42587
26863	363	42651	414	840	0	44268
26864	41387	1496	388	760	0	44031
26865	1100	832	41477	539	0	43948
26866	39607	564	1239	590	0	42000
26867	40314	400	655	670	0	42039
26868	40122	420	453	608	0	41603
26869	1462	39539	354	541	0	41896
26870	775	1201	373	39764	0	42113
26871	39786	651	391	1336	0	42164
26872	39779	512	347	866	0	41504
26873	1388	39842	376	616	0	42222
26874	40204	1152	323	599	0	42278
26875	1297	665	325	40400	0	42687
26876	709	552	305	40343	0	41909
26877	506	39985	289	1498	0	42278
26878	589	1181	271	40599	0	42640
26879	552	662	297	40861	0	42372
26880	452	40258	308	1613	0	42631
26881	460	1102	259	37872	0	39693
26882	380	39469	287	1295	0	41431
26883	39175	1244	281	827	0	41527
26884	38324	659	302	740	0	40025
26885	1345	38511	273	565	0	40694
26886	762	1104	38061	530	0	40457
26887	580	751	862	37952	0	40145
26888	472	581	37569	1149	0	39771
26889	433	36125	994	806	0	38358
26890	452	37355	489	637	0	38933
26891	35744	1164	290	524	0	37722
26892	1048	36705	251	412	0	38416
26893	710	1118	227	35186	0	37241
26894	498	35671	279	943	0	37391
26895	480	36971	209	633	0	38293
26896	36319	1322	199	469	0	38309
26897	1131	669	201	36289	0	38290
26898	630	514	36123	1056	0	38323
26899	490	472	35095	661	0	36718
26900	370	36318	1011	563	0	38262
26901	35758	1088	495	536	0	37877
26902	1018	36482	362	354	0	38216
26903	611	1192	249	36922	0	38974
26904	36938	690	257	1133	0	39018
26905	1123	549	216	37408	0	39296
26906	632	464	237	37543	0	38876
26907	470	37494	190	1307	0	39461
26908	520	1128	176	37978	0	39802
26909	334	695	38214	1180	0	40423
26910	36762	470	878	789	0	38899
26911	1038	38462	419	576	0	40495
26912	378	36889	237	299	0	37803
26913	35096	906	153	298	0	36453
26914	901	460	35281	208	0	36850
26915	33203	364	739	318	0	34624
26916	832	37689	280	198	0	38999
26917	283	40455	151	159	0	41048
26918	194	1110	40262	104	0	41670
26919	145	40863	951	160	0	42119
26920	363	1071	433	36738	0	38605
26921	250	418	185	38160	0	39013
26922	95	39308	90	1042	0	40535
26923	181	973	92	39698	0	40944
26924	39598	488	83	1097	0	41266
26925	907	343	39400	443	0	41093
26926	39177	231	878	399	0	40685
26927	40994	223	378	287	0	41882
26928	40811	252	221	313	0	41597
26929	1456	278	40342	179	0	42255
26930	812	233	979	40249	0	42273
26931	413	270	40845	1006	0	42534
26932	39184	213	1160	616	0	41173
26933	39903	239	491	448	0	41081
26934	1403	40153	324	244	0	42124
26935	844	1052	209	39796	0	41901
26936	402	41711	229	1065	0	43407
26937	345	1187	41927	528	0	43987
26938	541	569	1094	41599	0	43803
26939	41164	393	549	1240	0	43346
26940	41864	207	295	656	0	43022
26941	1696	270	210	39494	0	41670
26942	796	39908	257	1082	0	42043
26943	490	1084	40714	486	0	42774
26944	404	524	41108	357	0	42393
26945	38826	324	1455	367	0	40972
26946	1325	236	40941	248	0	42750
26947	642	40394	1272	294	0	42602
26948	541	1182	614	39953	0	42290
26949	334	570	40980	1131	0	43015
26950	463	337	1248	39919	0	41967
26951	370	227	40687	1256	0	42540
26952	38479	245	1344	687	0	40755
26953	1332	244	653	39046	0	41275
26954	647	38492	507	1176	0	40822
26955	388	40142	402	698	0	41630
26956	395	1461	423	39339	0	41618
26957	489	632	350	39250	0	40721
26958	343	39329	420	1497	0	41589
26959	359	1249	39257	760	0	41625
26960	386	679	1242	39397	0	41704
26961	243	505	40155	1298	0	42201
26962	263	318	39018	798	0	40397
26963	36676	320	1672	618	0	39286
26964	1215	38006	863	436	0	40520
26965	38244	1253	530	502	0	40529
26966	1429	705	402	37006	0	39542
26967	638	38065	427	1321	0	40451
26968	549	1308	456	38509	0	40822
26969	460	759	420	38653	0	40292
26970	402	38359	428	1645	0	40834
26971	387	1356	38201	920	0	40864
26972	431	832	1249	38530	0	41042
26973	38368	576	783	1501	0	41228
26974	1341	410	527	38655	0	40933
26975	769	412	451	39012	0	40644
26976	495	437	37945	1768	0	40645
26977	455	37673	1359	1031	0	40518
26978	471	1338	760	37853	0	40422
26979	421	792	37704	1517	0	40434
26980	382	587	37344	970	0	39283
26981	35700	485	1705	851	0	38741
26982	1289	36984	902	693	0	39868
26983	36756	1402	620	721	0	39499
26984	1426	36602	514	691	0	39233
26985	769	37722	543	649	0	39683
26986	36782	1694	506	720	0	39702
26987	1481	902	524	35744	0	38651
26988	881	36857	565	1361	0	39664
26989	722	1422	462	37615	0	40221
26990	37269	751	492	1649	0	40161
26991	1541	633	37206	916	0	40296
26992	897	502	36298	706	0	38403
26993	35684	451	1688	675	0	38498
26994	1387	36881	959	617	0	39844
26995	883	1419	36879	473	0	39654
26996	671	37013	1424	534	0	39642
26997	615	1532	856	36344	0	39347
26998	584	859	37189	1355	0	39987
26999	538	647	1381	36733	0	39299
27000	440	573	36562	1566	0	39141
27001	33929	515	1574	1012	0	37030
27002	1321	35974	892	704	0	38891
27003	35881	1348	660	560	0	38449
27004	1491	768	562	35712	0	38533
27005	771	38288	621	1355	0	41035
27006	37802	1497	599	820	0	40718
27007	36058	795	620	694	0	38167
27008	1743	631	37759	519	0	40652
27009	853	492	37202	493	0	39040
27010	33124	430	1653	433	0	35640
27011	1203	33596	802	515	0	36116
27012	640	33259	618	369	0	34886
27013	804	1726	574	31313	0	34417
27014	400	703	31735	1087	0	33925
27015	449	29820	1070	586	0	31925
27016	294	27870	570	417	0	29151
27017	689	760	302	22294	0	24045
27018	22866	270	147	563	0	23846
27019	23203	176	131	266	0	23776
27020	23525	164	133	189	0	24011
27021	656	161	23183	146	0	24146
27022	22827	112	533	165	0	23637
27023	23559	157	237	160	0	24113
27024	24179	144	141	125	0	24589
27025	720	140	139	23034	0	24033
27026	332	23245	103	468	0	24148
27027	23160	491	105	221	0	23977
27028	550	23188	99	142	0	23979
27029	241	466	101	22795	0	23603
27030	165	216	23683	453	0	24517
27031	205	136	444	23384	0	24169
27032	231	112	184	23838	0	24365
27033	168	114	23871	527	0	24680
27034	179	23564	462	207	0	24412
27035	180	413	157	22220	0	22970
27036	22037	176	102	431	0	22746
27037	388	21708	105	206	0	22407
27038	21534	388	75	158	0	22155
27039	452	176	72	21228	0	21928
27040	186	22107	91	349	0	22733
27041	22076	388	75	197	0	22736
27042	407	22579	65	118	0	23169
27043	191	379	22160	114	0	22844
27044	21789	194	384	173	0	22540
27045	22813	142	125	143	0	23223
27046	498	22775	78	104	0	23455
27047	223	389	22195	61	0	22868
27048	139	22955	373	80	0	23547
27049	470	594	280	13929	0	15273
27050	139	190	93	23364	0	23786
27051	131	161	51	23463	0	23806
27052	118	23330	52	531	0	24031
27053	125	434	60	23588	0	24207
27054	120	218	78	23798	0	24214
27055	23379	157	48	592	0	24176
27056	495	133	35	23249	0	23912
27057	235	97	62	23702	0	24096
27058	23247	94	40	599	0	23980
27059	520	23571	44	259	0	24394
27060	23855	456	53	208	0	24572
27061	23879	219	64	166	0	24328
27062	24085	160	54	154	0	24453
27063	700	100	75	23660	0	24535
27064	329	124	57	24304	0	24814
27065	222	137	23345	642	0	24346
27066	206	167	22582	293	0	23248
27067	193	139	23087	252	0	23671
27068	22128	146	581	240	0	23095
27069	590	135	23064	181	0	23970
27070	269	23266	513	230	0	24278
27071	259	499	202	23331	0	24291
27072	218	272	157	22979	0	23626
27073	176	23520	123	605	0	24424
27074	226	531	23906	293	0	24956
27075	210	24345	454	210	0	25219
27076	24246	582	174	210	0	25212
27077	662	271	24229	197	0	25359
27078	358	24126	498	216	0	25198
27079	320	545	24495	162	0	25522
27080	295	241	548	24370	0	25454
27081	201	224	24704	569	0	25698
27082	267	158	596	24064	0	25085
27083	24722	131	301	659	0	25813
27084	636	192	24645	301	0	25774
27085	301	24705	543	293	0	25842
27086	24992	576	255	290	0	26113
27087	621	306	25473	231	0	26631
27088	264	204	25691	290	0	26449
27089	232	195	632	25498	0	26557
27090	221	169	25800	650	0	26840
27091	24140	188	648	403	0	25379
27092	600	24928	271	306	0	26105
27093	347	581	274	25385	0	26587
27094	256	26824	187	581	0	27848
27095	26977	627	179	391	0	28174
27096	629	271	26704	319	0	27923
27097	335	277	27664	235	0	28511
27098	310	223	718	27433	0	28684
27099	241	205	343	28024	0	28813
27100	322	199	250	28276	0	29047
27101	306	203	223	28463	0	29195
27102	217	208	28364	801	0	29590
27103	185	27754	621	426	0	28986
27104	154	453	230	25969	0	26806
27105	141	215	25005	483	0	25844
27106	97	24723	479	267	0	25566
27107	24681	428	220	242	0	25571
27108	587	227	182	24604	0	25600
27109	24301	175	119	511	0	25106
27110	465	24341	119	246	0	25171
27111	24327	411	127	214	0	25079
27112	477	193	25112	174	0	25956
27113	272	172	423	24072	0	24939
27114	188	25068	215	433	0	25904
27115	165	372	24928	247	0	25712
27116	83	24663	412	227	0	25385
27117	372	563	246	16102	0	17283
27118	23661	167	157	422	0	24407
27119	343	23523	141	207	0	24214
27120	23325	348	129	224	0	24026
27121	420	160	23001	135	0	23716
27122	192	154	22522	118	0	22986
27123	22388	98	419	144	0	23049
27124	390	120	234	22614	0	23358
27125	245	104	138	22845	0	23332
27126	170	106	22679	422	0	23377
27127	144	78	22374	218	0	22814
27128	100	23224	433	155	0	23912
27129	22840	341	258	191	0	23630
27130	22075	155	139	129	0	22498
27131	373	21706	117	101	0	22297
27132	229	329	82	22237	0	22877
27133	22425	130	88	371	0	23014
27134	330	115	88	22450	0	22983
27135	22716	87	76	408	0	23287
27136	22892	54	107	191	0	23244
27137	23566	82	99	174	0	23921
27138	466	62	76	23078	0	23682
27139	223	53	66	24196	0	24538
27140	23299	60	75	429	0	23863
27141	23062	55	66	252	0	23435
27142	22843	71	79	188	0	23181
27143	421	22413	95	96	0	23025
27144	21494	195	56	111	0	21856
27145	240	21314	63	73	0	21690
27146	20969	216	65	106	0	21356
27147	271	79	20644	68	0	21062
27148	18657	86	161	127	0	19031
27149	209	19823	77	55	0	20164
27150	107	20352	45	61	0	20565
27151	20684	179	48	83	0	20994
27152	198	90	43	20578	0	20909
27153	134	59	29	21540	0	21762
27154	84	21361	35	248	0	21728
27155	63	22849	45	115	0	23072
27156	23532	259	28	118	0	23937
27157	286	108	24224	58	0	24676
27158	175	58	252	24950	0	25435
27159	25270	63	71	348	0	25752
27160	386	59	25075	98	0	25618
27161	133	26517	318	68	0	27036
27162	27700	365	99	115	0	28279
27163	496	115	28386	60	0	29057
27164	239	71	469	29251	0	30030
27165	111	60	30293	508	0	30972
27166	28586	42	518	244	0	29390
27167	518	30581	160	129	0	31388
27168	31023	513	87	147	0	31770
27169	31185	165	77	108	0	31535
27170	723	85	54	30837	0	31699
27171	31080	88	60	584	0	31812
27172	650	61	58	31118	0	31887
27173	307	76	45	31357	0	31785
27174	145	82	30326	658	0	31211
27175	157	30519	506	205	0	31387
27176	182	509	144	30777	0	31612
27177	166	147	80	31158	0	31551
27178	147	82	73	31275	0	31577
27179	106	74	30628	650	0	31458
27180	109	30269	492	232	0	31102
27181	157	485	143	30913	0	31698
27182	159	147	71	31334	0	31711
27183	105	95	30652	641	0	31493
27184	169	87	464	29961	0	30681
27185	30366	70	140	671	0	31247
27186	530	30316	81	267	0	31194
27187	29656	475	73	210	0	30414
27188	561	159	29553	133	0	30406
27189	265	106	470	29645	0	30486
27190	30608	85	149	584	0	31426
27191	30626	77	92	276	0	31071
27192	671	67	30611	148	0	31497
27193	318	67	524	30359	0	31268
27194	166	65	30498	595	0	31324
27195	28933	61	538	310	0	29842
27196	552	30373	207	137	0	31269
27197	31165	522	122	197	0	32006
27198	31006	159	107	178	0	31450
27199	728	30957	109	106	0	31900
27200	31431	590	84	181	0	32286
27201	709	188	30834	82	0	31813
27202	30994	93	542	127	0	31756
27203	721	87	161	31322	0	32291
27204	312	78	32285	604	0	33279
27205	263	63	592	32128	0	33046
27206	246	53	213	31152	0	31664
27207	220	47	144	32276	0	32687
27208	167	32181	150	752	0	33250
27209	32484	577	115	365	0	33541
27210	718	195	125	32422	0	33460
27211	292	32217	119	670	0	33298
27212	256	608	99	31117	0	32080
27213	225	31428	136	709	0	32498
27214	218	650	31559	308	0	32735
27215	242	233	605	31522	0	32602
27216	231	145	227	31973	0	32576
27217	188	151	31603	862	0	32804
27218	29069	105	634	531	0	30339
27219	645	31606	246	316	0	32813
27220	325	643	172	31992	0	33132
27221	285	211	144	31630	0	32270
27222	269	150	152	31406	0	31977
27223	219	31615	158	836	0	32828
27224	31379	646	153	451	0	32629
27225	734	245	31425	354	0	32758
27226	322	162	30291	321	0	31096
27227	278	154	732	30643	0	31807
27228	244	154	287	31703	0	32388
27229	31205	128	208	959	0	32500
27230	711	30867	190	443	0	32211
27231	354	652	166	31546	0	32718
27232	31086	264	171	847	0	32368
27233	802	186	174	30866	0	32028
27234	30840	152	141	904	0	32037
27235	808	157	29731	417	0	31113
27236	385	30349	664	314	0	31712
27237	30382	636	258	370	0	31646
27238	786	268	30337	286	0	31677
27239	29054	141	706	346	0	30247
27240	783	155	29400	287	0	30625
27241	29577	153	716	320	0	30766
27242	828	142	276	29919	0	31165
27243	30224	145	200	788	0	31357
27244	802	162	162	30041	0	31167
27245	406	143	152	30401	0	31102
27246	29939	114	156	1003	0	31212
27247	787	30323	157	429	0	31696
27248	382	657	139	30938	0	32116
27249	31078	242	163	936	0	32419
27250	32013	169	145	454	0	32781
27251	924	150	141	31654	0	32869
27252	455	150	124	32459	0	33188
27253	32158	125	151	995	0	33429
27254	916	117	118	32299	0	33450
27255	413	131	116	32020	0	32680
27256	30913	103	114	947	0	32077
27257	843	93	107	30230	0	31273
27258	283	94	27985	760	0	29122
27259	27263	61	549	408	0	28281
27260	689	82	28538	246	0	29555
27261	281	67	26521	203	0	27072
27262	25212	86	754	189	0	26241
27263	489	25259	197	136	0	26081
27264	262	354	176	24569	0	25361
27265	205	94	68	24865	0	25232
27266	205	62	48	26347	0	26662
27267	166	38	54	27265	0	27523
27268	25780	50	49	744	0	26623
27269	28630	47	45	297	0	29019
27270	29987	32	34	251	0	30304
27271	791	39	31861	148	0	32839
27272	405	34	673	33106	0	34218
27273	292	30	251	33952	0	34525
27274	258	24	145	32739	0	33166
27275	152	31339	114	1179	0	32784
27276	159	32318	83	563	0	33123
27277	33556	1019	94	380	0	35049
27278	954	426	70	33684	0	35134
27279	515	173	73	35613	0	36374
27280	296	118	68	36459	0	36941
27281	205	100	34794	1492	0	36591
27282	199	91	34091	740	0	35121
27283	34219	67	1224	521	0	36031
27284	36137	70	509	383	0	37099
27285	1423	70	269	34942	0	36704
27286	624	35451	182	1081	0	37338
27287	498	900	129	35803	0	37330
27288	391	387	115	36481	0	37374
27289	229	194	34877	1531	0	36831
27290	34850	138	902	798	0	36688
27291	1150	91	396	36413	0	38050
27292	621	86	218	36283	0	37208
27293	34949	72	174	1601	0	36796
27294	1129	35696	162	827	0	37814
27295	36518	984	139	585	0	38226
27296	1362	500	126	35533	0	37521
27297	618	34412	88	1192	0	36310
27298	35096	1047	110	668	0	36921
27299	1319	476	107	34982	0	36884
27300	34958	258	91	1304	0	36611
27301	34653	172	76	802	0	35703
27302	34914	125	81	568	0	35688
27303	1606	33270	134	397	0	35407
27304	851	33315	104	337	0	34607
27305	639	1269	96	32089	0	34093
27306	434	32519	115	1166	0	34234
27307	33631	1176	76	676	0	35559
27308	1313	593	85	33585	0	35576
27309	33685	335	81	1353	0	35454
27310	34455	252	84	812	0	35603
27311	1721	252	95	33353	0	35421
27312	980	197	85	34890	0	36152
27313	34364	196	78	1799	0	36437
27314	34886	196	83	986	0	36151
27315	35887	197	79	696	0	36859
27316	36183	200	78	605	0	37066
27317	36755	218	67	523	0	37563
27318	2064	237	53	35253	0	37607
27319	1185	219	69	35927	0	37400
27320	820	245	72	36546	0	37683
27321	35486	229	75	1931	0	37721
27322	1574	157	68	35081	0	36880
27323	955	34542	82	1625	0	37204
27324	822	1098	75	35691	0	37686
27325	34982	547	83	1652	0	37264
27326	35495	336	98	988	0	36917
27327	1911	302	33955	659	0	36827
27328	1162	277	960	32975	0	35374
27329	765	34021	422	1404	0	36612
27330	34817	1073	198	928	0	37016
27331	1566	34749	152	687	0	37154
27332	1059	1205	121	35309	0	37694
27333	35603	617	114	1560	0	37894
27334	36195	349	101	966	0	37611
27335	1948	35055	89	764	0	37856
27336	1197	1167	80	35140	0	37584
27337	851	626	34491	1487	0	37455
27338	33857	398	1021	966	0	36242
27339	1693	300	34598	676	0	37267
27340	35078	285	1152	654	0	37169
27341	36133	267	562	630	0	37592
27342	2046	240	266	35431	0	37983
27343	36031	274	175	1627	0	38107
27344	36802	281	152	956	0	38191
27345	37179	316	138	684	0	38317
27346	2268	314	134	35669	0	38385
27347	35636	242	139	1493	0	37510
27348	1867	238	122	35087	0	37314
27349	1234	245	156	35020	0	36655
27350	861	34041	169	1868	0	36939
27351	910	1029	172	33095	0	35206
27352	788	33321	121	1459	0	35689
27353	33044	1131	82	925	0	35182
27354	33326	608	107	724	0	34765
27355	1905	382	71	32473	0	34831
27356	1190	278	82	33025	0	34575
27357	32347	228	98	1739	0	34412
27358	1642	212	30997	979	0	33830
27359	31819	226	865	730	0	33640
27360	1714	206	423	31205	0	33548
27361	1095	203	29438	1320	0	32056
27362	29704	193	875	924	0	31696
27363	30578	184	451	717	0	31930
27364	1808	205	29207	589	0	31809
27365	28974	180	838	586	0	30578
27366	1506	201	27679	475	0	29861
27367	1058	27465	892	436	0	29851
27368	27665	776	721	489	0	29651
27369	27096	455	343	468	0	28362
27370	1499	24833	206	385	0	26923
27371	750	23010	159	286	0	24205
27372	21714	567	200	273	0	22754
27373	21686	238	122	285	0	22331
27374	919	244	80	21691	0	22934
27375	520	141	20922	610	0	22193
27376	428	121	19983	301	0	20833
27377	20839	99	519	266	0	21723
27378	725	121	20885	223	0	21954
27379	19779	140	570	212	0	20701
27380	629	82	187	19473	0	20371
27381	389	54	129	19760	0	20332
27382	293	78	19824	522	0	20717
27383	19798	50	395	324	0	20567
27384	569	62	196	20186	0	21013
27385	353	60	134	21458	0	22005
27386	20948	57	105	595	0	21705
27387	20941	37	93	368	0	21439
27388	20871	50	88	315	0	21324
27389	643	21121	113	221	0	22098
27390	303	259	19775	118	0	20455
27391	19274	104	288	162	0	19828
27392	19902	53	125	181	0	20261
27393	485	19346	89	123	0	20043
27394	18514	203	83	91	0	18891
27395	384	78	37	18158	0	18657
27396	174	68	18813	226	0	19281
27397	18504	63	235	186	0	18988
27398	19144	37	93	150	0	19424
27399	19282	42	50	132	0	19506
27400	19324	37	42	98	0	19501
27401	388	38	38	19200	0	19664
27402	195	31	37	19330	0	19593
27403	19450	21	45	332	0	19848
27404	327	18	48	19490	0	19883
27405	212	16	37	19491	0	19756
27406	151	19180	47	293	0	19671
27407	158	186	34	19761	0	20139
27408	131	49	42	19897	0	20119
27409	125	42	32	20061	0	20260
27410	145	33	42	20207	0	20427
27411	120	19886	32	329	0	20367
27412	119	205	29	19552	0	19905
27413	114	88	37	19149	0	19388
27414	107	66	18849	308	0	19330
27415	86	46	17555	150	0	17837
27416	80	18291	216	149	0	18736
27417	20957	175	95	156	0	21383
27418	350	21309	67	82	0	21808
27419	175	341	36	22215	0	22767
27420	85	99	23270	409	0	23863
27421	24429	54	419	233	0	25135
27422	508	46	124	25624	0	26302
27423	25334	34	79	609	0	26056
27424	25984	37	66	252	0	26339
27425	558	26081	48	154	0	26841
27426	26096	429	34	247	0	26806
27427	545	27404	59	113	0	28121
27428	271	563	40	27911	0	28785
27429	155	28322	51	517	0	29045
27430	157	580	28205	163	0	29105
27431	127	28610	480	146	0	29363
27432	196	639	128	28031	0	28994
27433	28657	194	110	640	0	29601
27434	537	29328	94	196	0	30155
27435	311	602	48	29601	0	30562
27436	250	221	42	30558	0	31071
27437	157	176	30228	782	0	31343
27438	226	122	628	30131	0	31107
27439	157	113	30295	805	0	31370
27440	28706	86	684	449	0	29925
27441	766	117	30577	238	0	31698
27442	317	30755	713	214	0	31999
27443	340	735	240	30758	0	32073
27444	274	269	189	30992	0	31724
27445	263	260	121	31157	0	31801
27446	31029	168	105	1101	0	32403
27447	843	165	90	30614	0	31712
27448	310	30831	113	866	0	32120
27449	30269	793	107	516	0	31685
27450	775	30029	104	359	0	31267
27451	405	843	127	30058	0	31433
27452	30004	336	99	1007	0	31446
27453	820	29248	161	435	0	30664
27454	352	30741	137	365	0	31595
27455	30522	894	162	407	0	31985
27456	31093	402	135	373	0	32003
27457	1018	295	30581	278	0	32172
27458	30869	263	765	366	0	32263
27459	1019	253	31679	278	0	33229
27460	507	233	866	32066	0	33672
27461	321	223	32268	1009	0	33821
27462	357	220	895	32312	0	33784
27463	299	207	32629	1083	0	34218
27464	330	244	888	32037	0	33499
27465	355	189	329	33465	0	34338
27466	32508	224	242	1251	0	34225
27467	940	261	32222	603	0	34026
27468	30588	229	847	556	0	32220
27469	1044	235	31957	407	0	33643
27470	514	214	32051	326	0	33105
27471	469	213	1018	31849	0	33549
27472	32226	227	466	1028	0	33947
27473	938	32144	391	472	0	33945
27474	31911	805	273	480	0	33469
27475	32179	324	284	455	0	33242
27476	1111	31721	268	448	0	33548
27477	31827	835	293	394	0	33349
27478	1049	393	32175	359	0	33976
27479	572	274	906	32373	0	34125
27480	32583	205	411	1056	0	34255
27481	965	32578	398	548	0	34489
27482	621	798	274	32851	0	34544
27483	509	350	305	32982	0	34146
27484	445	299	279	33650	0	34673
27485	452	220	278	33857	0	34807
27486	33099	200	285	1284	0	34868
27487	33538	213	295	699	0	34745
27488	33506	191	285	543	0	34525
27489	32549	186	268	542	0	33545
27490	1304	246	31960	360	0	33870
27491	31559	199	861	382	0	33001
27492	33065	237	426	394	0	34122
27493	1272	32210	345	388	0	34215
27494	698	33067	307	358	0	34430
27495	580	997	269	32074	0	33920
27496	548	409	235	32831	0	34023
27497	450	343	32066	1153	0	34012
27498	441	32049	845	648	0	33983
27499	476	811	397	31624	0	33308
27500	416	32207	347	974	0	33944
27501	465	882	254	33298	0	34899
27502	529	362	225	33316	0	34432
27503	445	34138	256	1135	0	35974
27504	504	879	230	34731	0	36344
27505	511	417	34589	1103	0	36620
27506	447	318	33430	616	0	34811
27507	33016	264	1078	555	0	34913
27508	34908	233	524	475	0	36140
27509	1206	34269	349	484	0	36308
27510	34645	894	266	402	0	36207
27511	1245	455	243	34329	0	36272
27512	34258	346	218	1077	0	35899
27513	1128	33839	187	647	0	35801
27514	654	917	33280	477	0	35328
27515	32214	422	921	555	0	34112
27516	1152	361	34676	403	0	36592
27517	534	270	30804	280	0	31888
27518	390	213	30695	313	0	31611
27519	345	30686	884	276	0	32191
27520	29428	732	851	360	0	31371
27521	28628	316	266	290	0	29500
27522	869	268	195	28005	0	29337
27523	550	169	182	27740	0	28641
27524	354	28302	164	741	0	29561
27525	28430	523	174	465	0	29592
27526	652	28331	178	269	0	29430
27527	372	27370	170	217	0	28129
27528	27018	523	192	221	0	27954
27529	596	260	163	26599	0	27618
27530	358	165	153	26529	0	27205
27531	279	132	151	26760	0	27322
27532	214	26350	150	597	0	27311
27533	25876	362	104	312	0	26654
27534	507	232	93	25541	0	26373
27535	275	24590	82	390	0	25337
27536	197	24667	79	220	0	25163
27537	187	394	69	23900	0	24550
27538	138	24216	64	344	0	24762
27539	186	358	81	24037	0	24662
27540	23666	196	82	399	0	24343
27541	311	134	22937	208	0	23590
27542	203	23186	236	145	0	23770
27543	194	300	119	23580	0	24193
27544	128	186	23983	297	0	24594
27545	23032	145	259	267	0	23703
27546	408	124	142	24222	0	24896
27547	24254	74	80	387	0	24795
27548	24074	84	65	284	0	24507
27549	406	25303	42	153	0	25904
27550	25819	295	60	197	0	26371
27551	25673	196	53	196	0	26118
27552	25852	129	52	164	0	26197
27553	488	89	49	25333	0	25959
27554	297	90	59	25107	0	25553
27555	211	102	63	25407	0	25783
27556	142	102	24898	444	0	25586
27557	138	24308	237	238	0	24921
27558	23773	226	157	207	0	24363
27559	276	23709	73	103	0	24161
27560	207	219	42	23641	0	24109
27561	125	164	23272	240	0	23801
27562	20980	89	196	288	0	21553
27563	242	23185	121	124	0	23672
27564	235	216	52	23074	0	23577
27565	172	139	36	23032	0	23379
27566	111	107	22674	311	0	23203
27567	103	22576	193	216	0	23088
27568	137	207	124	22648	0	23116
27569	136	147	59	22838	0	23180
27570	112	97	68	22188	0	22465
27571	21590	93	46	435	0	22164
27572	232	80	21339	235	0	21886
27573	162	21243	222	135	0	21762
27574	21013	226	117	176	0	21532
27575	237	21414	82	99	0	21832
27576	175	258	54	21109	0	21596
27577	111	21927	41	270	0	22349
27578	21410	255	77	215	0	21957
27579	21819	173	51	186	0	22229
27580	382	133	53	22770	0	23338
27581	245	98	43	22936	0	23322
27582	156	88	42	24128	0	24414
27583	102	74	24187	597	0	24960
27584	97	25079	439	309	0	25924
27585	192	488	173	28944	0	29797
27586	174	204	99	30033	0	30510
27587	151	132	77	30368	0	30728
27588	168	81	53	30554	0	30856
27589	92	120	29623	1112	0	30947
27590	98	31295	704	513	0	32610
27591	211	855	261	32607	0	33934
27592	196	408	126	35867	0	36597
27593	124	230	34811	1373	0	36538
27594	194	177	893	33583	0	34847
27595	118	33266	393	1285	0	35062
27596	96	35250	239	704	0	36289
27597	165	1239	147	34678	0	36229
27598	87	540	33571	1368	0	35566
27599	30471	309	958	1022	0	32760
27600	874	33155	533	625	0	35187
27601	374	1021	32409	515	0	34319
27602	201	592	32318	444	0	33555
27603	108	31873	1260	438	0	33679
27604	133	1055	32761	415	0	34364
27605	282	695	1231	31841	0	34049
27606	31859	350	569	1193	0	33971
27607	32687	364	380	651	0	34082
27608	32806	288	358	527	0	33979
27609	33813	299	310	488	0	34910
27610	1333	34121	328	358	0	36140
27611	34302	1067	345	496	0	36210
27612	1194	34886	342	451	0	36873
27613	691	1233	34377	322	0	36623
27614	578	672	1111	32977	0	35338
27615	389	35284	606	1066	0	37345
27616	477	1240	430	33976	0	36123
27617	33237	742	324	1289	0	35592
27618	1298	428	343	32687	0	34756
27619	674	33857	343	1186	0	36060
27620	34042	1198	328	695	0	36263
27621	1262	675	33977	505	0	36419
27622	765	500	1143	33781	0	36189
27623	635	382	586	34974	0	36577
27624	33418	395	359	1607	0	35779
27625	1246	33247	319	895	0	35707
27626	786	1225	32900	602	0	35513
27627	706	680	1073	33156	0	35615
27628	472	465	33603	1348	0	35888
27629	436	32178	1143	849	0	34606
27630	388	34199	579	694	0	35860
27631	33434	1502	404	590	0	35930
27632	1198	813	33253	588	0	35852
27633	33644	553	1265	609	0	36071
27634	1313	444	662	32741	0	35160
27635	631	33786	535	1328	0	36280
27636	33673	1313	383	837	0	36206
27637	1282	770	34090	657	0	36799
27638	861	489	1242	33931	0	36523
27639	603	480	704	34695	0	36482
27640	599	489	505	33966	0	35559
27641	480	34037	418	1685	0	36620
27642	32880	1298	415	1012	0	35605
27643	1271	32976	427	714	0	35388
27644	676	33653	454	563	0	35346
27645	586	1512	383	33435	0	35916
27646	33405	790	461	1422	0	36078
27647	33415	591	427	864	0	35297
27648	33594	605	354	670	0	35223
27649	1584	31801	393	514	0	34292
27650	896	1335	289	31919	0	34439
27651	716	754	31678	1304	0	34452
27652	703	522	1122	31791	0	34138
27653	687	548	581	31270	0	33086
27654	649	31829	344	1529	0	34351
27655	32181	1316	316	919	0	34732
27656	1342	815	331	31506	0	33994
27657	797	32097	334	1460	0	34688
27658	32151	1275	383	943	0	34752
27659	1324	804	31303	798	0	34229
27660	30986	649	1026	715	0	33376
27661	1414	32120	551	576	0	34661
27662	32508	1329	358	573	0	34768
27663	32754	824	318	638	0	34534
27664	1636	724	31939	570	0	34869
27665	32262	529	1083	569	0	34443
27666	1645	483	33450	491	0	36069
27667	1080	497	33770	447	0	35794
27668	33152	556	1376	508	0	35592
27669	34316	489	719	489	0	36013
27670	1756	471	33866	479	0	36572
27671	1068	379	1326	33293	0	36066
27672	900	406	711	33195	0	35212
27673	701	34722	575	1349	0	37347
27674	32978	1202	492	871	0	35543
27675	35484	715	358	588	0	37145
27676	1824	504	34107	448	0	36883
27677	34634	444	1135	474	0	36687
27678	35709	413	634	472	0	37228
27679	1775	34737	523	382	0	37417
27680	1121	1114	394	33810	0	36439
27681	992	588	364	32435	0	34379
27682	833	402	363	32771	0	34369
27683	31299	290	374	1248	0	33211
27684	1128	29930	363	673	0	32094
27685	595	685	260	25817	0	27357
27686	415	25509	251	619	0	26794
27687	419	1076	211	24426	0	26132
27688	360	24635	193	596	0	25784
27689	361	25126	172	431	0	26090
27690	22648	576	357	421	0	24002
27691	22265	272	272	343	0	23152
27692	332	116	52	20545	0	21045
27693	204	60	58	20689	0	21011
27694	145	57	46	20975	0	21223
27695	120	60	52	20927	0	21159
27696	115	59	35	20439	0	20648
27697	77	20297	45	340	0	20759
27698	135	206	32	20684	0	21057
27699	116	103	43	21063	0	21325
27700	20756	84	42	341	0	21223
27701	288	72	37	20854	0	21251
27702	173	69	31	20690	0	20963
27703	133	72	20514	312	0	21031
27704	149	66	205	19742	0	20162
27705	114	119	94	20697	0	21024
27706	119	58	20840	362	0	21379
27707	93	20932	238	229	0	21492
27708	73	231	21198	155	0	21657
27709	62	95	20381	114	0	20652
27710	51	19826	260	90	0	20227
27711	20264	240	117	135	0	20756
27712	20071	79	60	129	0	20339
27713	278	50	33	19773	0	20134
27714	19941	32	10	299	0	20282
27715	270	28	20157	113	0	20568
27716	124	21	233	20310	0	20688
27717	73	46	21970	270	0	22359
27718	95	23	261	22055	0	22434
27719	82	24	109	22196	0	22411
27720	59	46	63	22556	0	22724
27721	22463	36	54	422	0	22975
27722	272	34	59	22888	0	23253
27723	22717	38	45	393	0	23193
27724	23124	41	47	217	0	23429
27725	348	23036	43	138	0	23565
27726	23239	249	33	164	0	23685
27727	326	23880	55	119	0	24380
27728	181	289	40	23632	0	24142
27729	148	107	39	24035	0	24329
27730	121	65	54	24384	0	24624
27731	82	84	23590	457	0	24213
27732	61	23447	302	237	0	24047
27733	109	292	103	22685	0	23189
27734	103	127	65	22847	0	23142
27735	71	23509	59	376	0	24015
27736	23585	309	31	244	0	24169
27737	328	22931	33	188	0	23480
27738	22884	340	52	150	0	23426
27739	363	23145	41	135	0	23684
27740	199	372	27	22285	0	22883
27741	115	23352	50	333	0	23850
27742	23593	384	18	254	0	24249
27743	23912	134	27	230	0	24303
27744	23574	109	44	208	0	23935
27745	23485	85	34	202	0	23806
27746	448	89	23011	148	0	23696
27747	23247	71	285	200	0	23803
27748	24084	78	111	204	0	24477
27749	23962	95	79	184	0	24320
27750	461	91	23375	105	0	24032
27751	23268	79	248	178	0	23773
27752	406	24091	90	130	0	24717
27753	24419	315	76	184	0	24994
27754	398	173	25735	107	0	26413
27755	25448	97	294	194	0	26033
27756	26199	90	96	131	0	26516
27757	475	76	75	25962	0	26588
27758	274	68	25787	321	0	26450
27759	25802	80	282	231	0	26395
27760	438	52	108	26693	0	27291
27761	275	50	103	27104	0	27532
27762	206	53	27062	396	0	27717
27763	24921	46	328	287	0	25582
27764	27155	42	125	219	0	27541
27765	418	27130	103	135	0	27786
27766	282	334	60	26567	0	27243
27767	187	115	86	26630	0	27018
27768	224	75	64	26383	0	26746
27769	151	26542	89	421	0	27203
27770	26665	305	57	286	0	27313
27771	442	114	65	26546	0	27167
27772	221	96	61	26751	0	27129
27773	25908	67	50	489	0	26514
27774	25620	50	61	310	0	26041
27775	437	48	78	26129	0	26692
27776	248	62	67	25955	0	26332
27777	191	69	24767	386	0	25413
27778	22905	66	269	317	0	23557
27779	352	25115	91	189	0	25747
27780	209	302	58	26735	0	27304
27781	201	92	42	27426	0	27761
27782	123	28320	47	535	0	29025
27783	172	479	34	29553	0	30238
27784	31110	188	58	738	0	32094
27785	695	125	43	34854	0	35717
27786	337	93	32	35741	0	36203
27787	292	84	25	36539	0	36940
27788	161	78	35550	1395	0	37184
27789	233	85	742	36059	0	37119
27790	139	76	35458	1247	0	36920
27791	136	34546	894	683	0	36259
27792	190	739	439	34976	0	36344
27793	167	350	265	35535	0	36317
27794	167	211	158	36479	0	37015
27795	145	133	177	36406	0	36861
27796	153	127	111	37086	0	37477
27797	34771	96	122	1656	0	36645
27798	775	121	35042	922	0	36860
27799	390	33876	742	714	0	35722
27800	249	36401	373	581	0	37604
27801	224	1017	241	36746	0	38228
27802	236	500	189	37661	0	38586
27803	186	305	168	37423	0	38082
27804	117	36817	165	1454	0	38553
27805	171	860	135	37235	0	38401
27806	146	472	35751	1259	0	37628
27807	72	35112	723	820	0	36727
27808	131	850	359	35803	0	37143
27809	34945	437	228	1240	0	36850
27810	753	270	146	35647	0	36816
27811	450	211	127	35475	0	36263
27812	258	33455	166	1307	0	35186
27813	182	36224	130	842	0	37378
27814	247	1035	99	36356	0	37737
27815	186	541	99	36878	0	37704
27816	121	362	36024	1441	0	37948
27817	166	255	689	35153	0	36263
27818	140	254	351	35725	0	36470
27819	137	215	243	35701	0	36296
27820	110	195	186	36372	0	36863
27821	34424	208	181	1743	0	36556
27822	34908	170	138	1178	0	36394
27823	1092	123	120	35653	0	36988
27824	634	127	108	36627	0	37496
27825	35358	110	127	1817	0	37412
27826	1023	149	105	36850	0	38127
27827	551	178	36124	1624	0	38477
27828	362	36080	831	1125	0	38398
27829	279	824	481	36966	0	38550
27830	267	440	328	37964	0	38999
27831	37145	294	253	1833	0	39525
27832	886	214	191	38324	0	39615
27833	519	198	183	39184	0	40084
27834	38326	188	135	1972	0	40621
27835	1039	178	133	39073	0	40423
27836	604	38587	140	1684	0	41015
27837	484	898	114	40973	0	42469
27838	414	489	118	42283	0	43304
27839	379	320	147	42114	0	42960
27840	327	277	137	42591	0	43332
27841	201	332	40309	2053	0	42895
27842	174	337	39398	1403	0	41312
27843	246	278	1160	40824	0	42508
27844	210	241	572	40696	0	41719
27845	165	40461	387	1945	0	42958
27846	236	975	281	39818	0	41310
27847	178	40068	302	1775	0	42323
27848	39474	1116	224	1350	0	42164
27849	948	41021	229	1065	0	43263
27850	583	1255	176	42123	0	44137
27851	411	684	141	43245	0	44481
27852	261	506	41443	2053	0	44263
27853	38893	365	885	1551	0	41694
27854	39844	337	492	1197	0	41870
27855	1276	39892	386	1000	0	42554
27856	770	1012	321	39342	0	41445
27857	450	561	41093	1573	0	43677
27858	378	41719	1010	1157	0	44264
27859	41167	1131	519	1074	0	43891
27860	41445	636	321	979	0	43381
27861	1468	484	39718	832	0	42502
27862	40085	357	939	873	0	42254
27863	1496	339	493	40576	0	42904
27864	838	40550	367	1502	0	43257
27865	40613	1041	297	1107	0	43058
27866	1349	576	304	40884	0	43113
27867	41101	432	253	1640	0	43426
27868	42768	313	207	1204	0	44492
27869	1701	360	193	41824	0	44078
27870	938	345	41917	1664	0	44864
27871	41826	324	1009	1235	0	44394
27872	43486	288	495	1007	0	45276
27873	43691	253	317	962	0	45223
27874	1811	43918	283	805	0	46817
27875	1128	1029	267	43812	0	46236
27876	815	560	237	45682	0	47294
27877	635	430	44424	1904	0	47393
27878	662	416	1003	43428	0	45509
27879	452	43297	567	1738	0	46054
27880	41929	992	337	1216	0	44474
27881	1122	41793	271	923	0	44109
27882	643	985	40493	656	0	42777
27883	417	40481	937	690	0	42525
27884	400	40484	539	526	0	41949
27885	530	675	343	35852	0	37400
27886	35786	264	172	711	0	36933
27887	35602	158	103	433	0	36296
27888	35030	157	75	354	0	35616
27889	687	36167	82	234	0	37170
27890	339	535	35755	180	0	36809
27891	35120	240	498	293	0	36151
27892	36485	161	210	294	0	37150
27893	715	36097	125	196	0	37133
27894	36620	531	104	319	0	37574
27895	705	251	120	36511	0	37587
27896	344	207	37842	568	0	38961
27897	37586	165	525	474	0	38750
27898	37831	165	202	367	0	38565
27899	39706	153	132	294	0	40285
27900	875	139	103	38918	0	40035
27901	482	141	109	40084	0	40816
27902	377	136	100	42051	0	42664
27903	287	41348	115	943	0	42693
27904	558	747	150	40865	0	42320
27905	376	344	90	47299	0	48109
27906	260	256	46777	1246	0	48539
27907	343	181	892	46617	0	48033
27908	349	195	316	47777	0	48637
27909	339	153	191	47749	0	48432
27910	368	143	161	47533	0	48205
27911	263	47048	184	1496	0	48991
27912	362	963	137	47764	0	49226
27913	354	367	169	47800	0	48690
27914	46369	253	198	1680	0	48500
27915	1111	203	45919	870	0	48103
27916	514	220	44628	639	0	46001
27917	43648	182	1192	694	0	45716
27918	45803	187	446	659	0	47095
27919	1495	205	270	41823	0	43793
27920	591	44933	277	1150	0	46951
27921	45175	947	212	740	0	47074
27922	1311	415	209	44032	0	45967
27923	574	44491	271	1173	0	46509
27924	44647	885	183	734	0	46449
27925	1134	45185	152	418	0	46889
27926	44448	972	147	600	0	46167
27927	43496	444	122	557	0	44619
27928	1361	42600	134	320	0	44415
27929	753	936	160	42485	0	44334
27930	456	461	42231	1087	0	44235
27931	596	391	837	41571	0	43395
27932	41643	270	318	1269	0	43500
27933	1085	322	40980	641	0	43028
27934	584	40784	846	471	0	42685
27935	613	1018	351	40261	0	42243
27936	335	468	39872	1164	0	41839
27937	316	39214	912	599	0	41041
27938	38925	913	465	583	0	40886
27939	1074	468	293	39137	0	40972
27940	643	278	261	39610	0	40792
27941	509	285	271	38887	0	39952
27942	277	38996	186	1326	0	40785
27943	38641	894	191	863	0	40589
27944	935	38238	252	560	0	39985
27945	538	39622	130	494	0	40784
27946	39291	1051	150	611	0	41103
27947	39531	512	219	523	0	40785
27948	1180	410	38460	464	0	40514
27949	37611	337	812	477	0	39237
27950	37692	338	383	371	0	38784
27951	1384	350	224	36726	0	38684
27952	727	332	36383	973	0	38415
27953	582	303	804	36497	0	38186
27954	37314	205	349	1225	0	39093
27955	1159	235	38489	594	0	40477
27956	733	273	979	41940	0	43925
27957	776	185	434	45318	0	46713
27958	573	274	256	49266	0	50369
27959	47946	256	265	2243	0	50710
27960	1721	48638	299	931	0	51589
27961	48827	1591	192	758	0	51368
27962	1924	515	48711	567	0	51717
27963	956	350	1608	46487	0	49401
27964	561	48845	502	1849	0	51757
27965	49266	1619	330	1003	0	52218
27966	1993	562	296	49305	0	52156
27967	785	457	48417	1916	0	51575
27968	698	350	1515	47833	0	50396
27969	46589	322	605	2049	0	49565
27970	1686	46411	389	1007	0	49493
27971	923	1725	274	42120	0	45042
27972	555	46229	293	1671	0	48748
27973	45944	1684	229	904	0	48761
27974	45777	631	250	771	0	47429
27975	1998	44866	272	593	0	47729
27976	44948	1537	298	581	0	47364
27977	1978	682	202	42766	0	45628
27978	818	44358	209	1582	0	46967
27979	44230	1662	200	724	0	46816
27980	45168	677	174	679	0	46698
27981	2152	42605	266	464	0	45487
27982	956	43885	158	547	0	45546
27983	43151	1824	158	390	0	45523
27984	1990	771	153	42604	0	45518
27985	43151	543	137	1698	0	45529
27986	2067	520	152	42814	0	45553
27987	968	413	42111	1759	0	45251
27988	903	429	1343	42918	0	45593
27989	42238	486	385	1895	0	45004
27990	1981	357	42286	718	0	45342
27991	941	326	1482	42307	0	45056
27992	824	354	451	44325	0	45954
27993	665	292	42899	2041	0	45897
27994	41977	299	1481	913	0	44670
27995	1864	311	544	42978	0	45697
27996	756	337	40997	1797	0	43887
27997	38409	251	1520	868	0	41048
27998	1665	40358	579	717	0	43319
27999	711	40226	397	660	0	41994
28000	535	41271	341	629	0	42776
28001	442	1578	38412	515	0	40947
28002	612	777	1341	36401	0	39131
28003	421	313	36891	1535	0	39160
28004	415	873	1241	32449	0	34978
28005	233	31709	384	1311	0	33637
28006	249	32643	272	486	0	33650
28007	348	1229	229	32027	0	33833
28008	32019	397	190	1291	0	33897
28009	1177	274	156	32536	0	34143
28010	452	265	181	32284	0	33182
28011	326	32046	195	1305	0	33872
28012	31659	1079	135	604	0	33477
28013	1142	32226	159	389	0	33916
28014	501	1197	153	32207	0	34058
28015	400	456	168	32516	0	33540
28016	261	32061	157	1488	0	33967
28017	383	1129	190	32634	0	34336
28018	32358	457	129	1530	0	34474
28019	1343	489	127	32506	0	34465
28020	681	403	189	32465	0	33738
28021	499	32105	229	1421	0	34254
28022	492	1201	213	32761	0	34667
28023	31437	557	149	1467	0	33610
28024	32667	465	115	777	0	34024
28025	33187	429	177	654	0	34447
28026	1616	339	190	32450	0	34595
28027	724	352	31664	1465	0	34205
28028	664	358	31656	654	0	33332
28029	578	398	1173	32349	0	34498
28030	32570	487	346	1457	0	34860
28031	1369	455	220	32842	0	34886
28032	33384	381	161	1491	0	35417
28033	1674	353	157	33384	0	35568
28034	894	311	166	34267	0	35638
28035	33675	371	148	1597	0	35791
28036	1489	352	32547	776	0	35164
28037	32753	353	1064	623	0	34793
28038	1582	330	32994	512	0	35418
28039	894	285	1117	32917	0	35213
28040	33562	280	397	1423	0	35662
28041	1474	347	33765	625	0	36211
28042	752	323	33812	501	0	35388
28043	33013	262	1358	611	0	35244
28044	1548	210	33882	580	0	36220
28045	644	33557	1316	624	0	36141
28046	612	1095	574	34878	0	37159
28047	36945	346	445	1697	0	39433
28048	1427	278	37632	745	0	40082
28049	37789	199	1296	727	0	40011
28050	39469	198	581	646	0	40894
28051	39441	195	487	684	0	40807
28052	39533	207	436	589	0	40765
28053	1782	415	417	37495	0	40109
28054	786	37389	373	1372	0	39920
28055	35751	1044	400	719	0	37914
28056	1175	292	31810	424	0	33701
28057	359	26299	534	171	0	27363
28058	24727	335	270	181	0	25513
28059	384	23573	147	111	0	24215
28060	214	24602	78	102	0	24996
28061	479	373	267	24317	0	25436
28062	179	126	80	25268	0	25653
28063	127	80	92	25309	0	25608
28064	25631	67	55	478	0	26231
28065	26461	56	53	250	0	26820
28066	521	49	68	27079	0	27717
28067	298	45	63	28542	0	28948
28068	189	61	29115	609	0	29974
28069	27937	38	518	320	0	28813
28070	29681	54	174	214	0	30123
28071	724	50	126	29252	0	30152
28072	358	39	86	29556	0	30039
28073	212	46	29134	688	0	30080
28074	240	51	520	28904	0	29715
28075	176	52	29832	646	0	30706
28076	153	29419	588	309	0	30469
28077	173	467	30112	213	0	30965
28078	173	201	590	29223	0	30187
28079	136	128	30745	575	0	31584
28080	134	88	29054	254	0	29530
28081	29999	72	698	244	0	31013
28082	631	74	305	32158	0	33168
28083	274	70	32243	616	0	33203
28084	29527	65	665	359	0	30616
28085	689	65	32236	225	0	33215
28086	329	53	34673	184	0	35239
28087	220	35609	799	242	0	36870
28088	236	506	315	35726	0	36783
28089	171	190	35798	627	0	36786
28090	165	137	34859	263	0	35424
28091	210	82	784	34964	0	36040
28092	220	96	388	35184	0	35888
28093	152	35854	277	690	0	36973
28094	209	550	214	36282	0	37255
28095	36714	198	179	799	0	37890
28096	36555	128	182	472	0	37337
28097	37160	74	182	377	0	37793
28098	868	81	204	36189	0	37342
28099	418	36538	189	684	0	37829
28100	36734	547	178	417	0	37876
28101	675	36743	194	276	0	37888
28102	324	35948	193	256	0	36721
28103	243	36908	198	241	0	37590
28104	37118	690	224	301	0	38333
28105	696	302	219	36954	0	38171
28106	394	221	174	36899	0	37688
28107	248	37176	208	757	0	38389
28108	36417	616	194	447	0	37674
28109	671	273	36386	269	0	37599
28110	357	192	664	36461	0	37674
28111	36585	158	316	716	0	37775
28112	647	37438	256	393	0	38734
28113	38910	584	198	451	0	40143
28114	777	279	200	39309	0	40565
28115	374	40266	215	652	0	41507
28116	323	625	39346	331	0	40625
28117	38952	308	593	405	0	40258
28118	729	234	286	40785	0	42034
28119	41320	176	213	784	0	42493
28120	812	185	183	41066	0	42246
28121	395	40622	175	752	0	41944
28122	324	618	41382	394	0	42718
28123	283	314	41076	353	0	42026
28124	307	403	707	41304	0	42721
28125	42354	164	391	753	0	43662
28126	42510	159	214	424	0	43307
28127	766	172	189	42143	0	43270
28128	409	139	187	42454	0	43189
28129	42790	137	162	847	0	43936
28130	728	129	173	43071	0	44101
28131	42789	142	179	828	0	43938
28132	722	42375	167	421	0	43685
28133	41924	555	151	489	0	43119
28134	761	288	43109	285	0	44443
28135	448	198	618	42973	0	44237
28136	389	151	298	44081	0	44919
28137	332	146	250	44148	0	44876
28138	290	42779	209	875	0	44153
28139	323	35572	226	615	0	36736
28140	274	647	178	43035	0	44134
28141	227	291	42118	696	0	43332
28142	254	208	604	41636	0	42702
28143	262	146	270	42802	0	43480
28144	191	41897	244	836	0	43168
28145	41348	564	206	479	0	42597
28146	592	40453	217	325	0	41587
28147	310	40599	205	284	0	41398
28148	296	654	207	39956	0	41113
28149	278	272	184	40578	0	41312
28150	278	206	147	40281	0	40912
28151	278	184	141	40716	0	41319
28152	39843	140	160	931	0	41074
28153	555	39900	184	461	0	41100
28154	40181	569	160	445	0	41355
28155	41189	248	177	418	0	42032
28156	735	220	149	40729	0	41833
28157	382	203	112	41463	0	42160
28158	40952	162	103	880	0	42097
28159	41430	154	114	557	0	42255
28160	736	167	91	40339	0	41333
28161	426	151	53	40532	0	41162
28162	323	178	39922	726	0	41149
28163	252	38604	433	446	0	39735
28164	266	41002	142	338	0	41748
28165	39274	434	113	350	0	40171
28166	501	202	39811	185	0	40699
28167	206	144	36748	165	0	37263
28168	33983	86	333	265	0	34667
28169	37048	65	151	207	0	37471
28170	332	39452	76	114	0	39974
28171	173	41275	39	119	0	41606
28172	147	258	31	42128	0	42564
28173	43513	111	43	448	0	44115
28174	43846	92	42	269	0	44249
28175	44306	74	32	260	0	44672
28176	384	65	34	43656	0	44139
28177	205	71	30	44240	0	44546
28178	156	79	43606	303	0	44144
28179	125	82	39580	185	0	39972
28180	131	67	43397	135	0	43730
28181	168	589	245	42787	0	43789
28182	42548	32	96	329	0	43005
28183	203	42	43900	65	0	44210
28184	114	24	172	43478	0	43788
28185	78	44148	49	202	0	44477
28186	99	171	55	43256	0	43581
28187	99	47	36	43752	0	43934
28188	50	63	44942	311	0	45366
28189	98	39	297	44232	0	44666
28190	45834	21	92	462	0	46409
28191	419	50	47901	110	0	48480
28192	204	42	402	47725	0	48373
28193	111	41	48797	433	0	49382
28194	76	48395	481	167	0	49119
28195	81	426	49118	112	0	49737
28196	194	154	505	45037	0	45890
28197	109	83	175	49873	0	50240
28198	60	67	51361	596	0	52084
28199	146	52	511	49493	0	50202
28200	142	47	185	49118	0	49492
28201	68	49600	150	659	0	50477
28202	69	475	50599	283	0	51426
28203	152	145	554	49739	0	50590
28204	145	93	220	51282	0	51740
28205	65	51436	202	725	0	52428
28206	93	545	134	52348	0	53120
28207	52463	179	144	821	0	53607
28208	596	135	131	52742	0	53604
28209	176	121	53023	798	0	54118
28210	51363	73	655	502	0	52593
28211	55390	70	239	468	0	56167
28212	879	82	55717	246	0	56924
28213	52508	90	786	434	0	53818
28214	829	55769	317	269	0	57184
28215	404	734	229	57043	0	58410
28216	312	266	179	61575	0	62332
28217	310	165	164	59469	0	60108
28218	251	112	144	62380	0	62887
28219	252	117	146	62560	0	63075
28220	61565	108	126	1691	0	63490
28221	1067	96	60800	744	0	62707
28222	57177	65	1002	692	0	58936
28223	1157	97	59901	491	0	61646
28224	642	91	1136	59576	0	61445
28225	60035	99	466	1394	0	61994
28226	1259	124	336	59434	0	61153
28227	573	60043	295	1333	0	62244
28228	62237	931	270	835	0	64273
28229	1276	376	265	64480	0	66397
28230	603	254	59095	1477	0	61429
28231	58843	149	855	991	0	60838
28232	1297	65175	388	626	0	67486
28233	647	1053	66931	531	0	69162
28234	639	418	1161	65555	0	67773
28235	644	240	575	62666	0	64125
28236	446	65483	382	1623	0	67934
28237	402	1088	65967	835	0	68292
28238	487	487	1176	65401	0	67551
28239	388	340	67583	1562	0	69873
28240	456	242	1306	66699	0	68703
28241	408	250	611	67971	0	69240
28242	369	251	67455	1890	0	69965
28243	493	201	1296	67171	0	69161
28244	966	361	1039	49497	0	51863
28245	520	164	556	71190	0	72430
28246	461	225	498	71577	0	72761
28247	68759	198	458	2415	0	71830
28248	1426	200	68092	1364	0	71082
28249	68363	197	1484	1203	0	71247
28250	1689	253	782	72005	0	74729
28251	908	250	623	73323	0	75104
28252	636	200	542	72764	0	74142
28253	468	71582	522	2608	0	75180
28254	72305	1379	458	1590	0	75732
28255	1618	644	457	74349	0	77068
28256	750	74253	520	2138	0	77661
28257	595	1353	435	75823	0	78206
28258	75184	634	449	2450	0	78717
28259	74648	436	429	1686	0	77199
28260	74453	332	443	1399	0	76627
28261	2062	74298	448	1177	0	77985
28262	1000	1426	74601	1094	0	78121
28263	72856	679	1525	1314	0	76374
28264	75505	438	728	1272	0	77943
28265	2087	75540	555	1139	0	79321
28266	75670	1448	411	1185	0	78714
28267	73739	743	432	1169	0	76083
28268	76210	507	356	1130	0	78203
28269	2366	76638	425	1106	0	80535
28270	1462	1550	377	76090	0	79479
28271	76103	764	348	2227	0	79442
28272	77940	584	317	1422	0	80263
28273	75678	432	334	1198	0	77642
28274	77245	396	278	1091	0	79010
28275	2786	499	274	75155	0	78714
28276	1586	506	74278	2080	0	78450
28277	1454	363	1554	73302	0	76673
28278	1221	74118	684	2116	0	78139
28279	1246	1654	469	76795	0	80164
28280	1095	841	76624	2242	0	80802
28281	75795	533	1686	1318	0	79332
28282	2582	440	770	77716	0	81508
28283	77026	475	509	2303	0	80313
28284	77190	471	410	1507	0	79578
28285	3059	412	361	77016	0	80848
28286	1771	398	76782	2223	0	81174
28287	1500	393	71312	1210	0	74415
28288	69728	397	1929	1040	0	73094
28289	2304	72286	906	951	0	76447
28290	1416	71213	551	739	0	73919
28291	1154	70303	472	788	0	72717
28292	1025	73340	407	796	0	75568
28293	71229	1968	729	864	0	74790
28294	71862	840	440	824	0	73966
28295	71527	567	351	746	0	73191
28296	71754	534	281	787	0	73356
28297	2535	569	326	69196	0	72626
28298	1473	68249	341	1631	0	71694
28299	68397	1457	376	1069	0	71299
28300	2180	719	68114	718	0	71731
28301	1392	67683	1338	674	0	71087
28302	1221	1433	68032	617	0	71303
28303	66409	769	1485	708	0	69371
28304	68786	607	715	765	0	70873
28305	69115	571	530	616	0	70832
28306	2469	564	404	67427	0	70864
28307	1526	495	67589	1410	0	71020
28308	1161	67460	1300	836	0	70757
28309	65877	1366	666	725	0	68634
28310	1934	65646	449	588	0	68617
28311	1266	63572	292	522	0	65652
28312	1091	63163	269	473	0	64996
28313	968	63415	305	507	0	65195
28314	848	1494	59631	416	0	62389
28315	811	60242	1129	416	0	62598
28316	55767	1059	508	411	0	57745
28317	1234	576	302	55656	0	57768
28318	805	467	214	56454	0	57940
28319	56058	369	250	1181	0	57858
28320	1191	55590	273	572	0	57626
28321	821	947	56680	318	0	58766
28322	800	582	815	55894	0	58091
28323	765	404	385	57410	0	58964
28324	724	358	298	57928	0	59308
28325	568	409	57053	1171	0	59201
28326	520	448	56066	528	0	57562
28327	652	433	1042	56230	0	58357
28328	521	357	55574	871	0	57323
28329	526	386	51017	440	0	52369
28330	46154	357	961	580	0	48052
28331	986	52126	512	371	0	53995
28332	569	50295	318	330	0	51512
28333	624	51232	258	273	0	52387
28334	624	1189	232	49406	0	51451
28335	440	53005	299	726	0	54470
28336	54237	898	256	633	0	56024
28337	1037	536	55467	381	0	57421
28338	56629	368	960	470	0	58427
28339	1212	389	518	57474	0	59593
28340	746	303	359	58330	0	59738
28341	438	61049	346	1271	0	63104
28342	60929	1138	338	717	0	63122
28343	61274	500	445	556	0	62775
28344	1659	64887	307	351	0	67204
28345	827	1431	258	62531	0	65047
28346	497	589	63650	1279	0	66015
28347	450	428	63043	583	0	64504
28348	370	65048	1596	410	0	67424
28349	64470	1492	702	526	0	67190
28350	1454	570	65210	175	0	67409
28351	844	376	1319	63834	0	66373
28352	65324	300	600	1468	0	67692
28353	66338	290	400	698	0	67726
28354	1775	75522	351	386	0	78034
28355	776	79931	321	325	0	81353
28356	79504	2399	276	400	0	82579
28357	2215	1023	79624	228	0	83090
28358	79271	548	1973	430	0	82222
28359	81649	422	778	349	0	83198
28360	2984	400	475	79681	0	83540
28361	1200	433	82027	1953	0	85613
28362	789	379	80852	680	0	82700
28363	78420	371	2709	560	0	82060
28364	2460	373	82108	303	0	85244
28365	77758	284	2391	373	0	80806
28366	80779	266	962	435	0	82442
28367	2855	79900	609	309	0	83673
28368	1367	2037	79809	231	0	83444
28369	839	79230	2238	303	0	82610
28370	78222	2259	1018	363	0	81862
28371	2477	945	77924	198	0	81544
28372	1424	655	2224	74269	0	78572
28373	927	429	77281	1935	0	80572
28374	854	386	77522	693	0	79455
28375	818	313	77795	407	0	79333
28376	760	359	77707	314	0	79140
28377	682	75279	3101	313	0	79375
28378	730	2012	75613	285	0	78640
28379	646	74118	2600	336	0	77700
28380	647	2187	73311	224	0	76369
28381	72122	842	2641	382	0	75987
28382	2662	555	1320	66441	0	70978
28383	1214	73838	1039	1483	0	77574
28384	73535	2094	861	771	0	77261
28385	74203	1034	890	605	0	76732
28386	68782	823	907	545	0	71057
28387	73830	605	967	494	0	75896
28388	3030	73012	916	418	0	77376
28389	69725	2140	908	633	0	73406
28390	73848	1077	907	529	0	76361
28391	2990	71172	922	462	0	75546
28392	1614	2407	67159	340	0	71520
28393	1475	1148	2339	66624	0	71586
28394	1163	71577	1383	1778	0	75901
28395	1095	2498	72189	771	0	76553
28396	1186	1318	72737	550	0	75791
28397	1189	70703	3168	445	0	75505
28398	1203	72098	1747	410	0	75458
28399	1181	75958	1277	588	0	79004
28400	1307	73855	1084	466	0	76712
28401	75979	3474	1121	492	0	81066
28402	77691	1835	965	568	0	81059
28403	3886	1258	77850	399	0	83393
28404	2265	1073	79760	364	0	83462
28405	1883	963	3490	77547	0	83883
28406	1744	1104	1806	79800	0	84454
28407	1708	1113	1327	81425	0	85573
28408	80141	1111	1272	3132	0	85656
28409	3334	79302	1287	1382	0	85305
28410	2079	82203	1341	799	0	86422
28411	1709	84988	1374	703	0	88774
28412	82681	3914	1422	677	0	88694
28413	85301	2063	1448	645	0	89457
28414	4466	1489	1319	82910	0	90184
28415	86259	1271	1594	2760	0	91884
28416	87459	1343	1407	1273	0	91482
28417	4802	1358	1356	85078	0	92594
28418	86393	1450	1316	3101	0	92260
28419	4289	84876	1705	1379	0	92249
28420	2728	3367	1760	83818	0	91673
28421	2356	1818	84039	2893	0	91106
28422	1911	83552	4058	1485	0	91006
28423	2061	3540	85241	1269	0	92111
28424	2237	2025	4065	79136	0	87463
28425	1983	85266	2512	2787	0	92548
28426	2217	3503	2265	84428	0	92413
28427	2107	2208	2028	86929	0	93272
28428	2227	1732	85441	3714	0	93114
28429	2081	1528	90425	1814	0	95848
28430	2026	1483	4707	88314	0	96530
28431	2127	1516	2887	83886	0	90416
28432	1942	89536	2346	3752	0	97576
28433	85752	3765	1909	2088	0	93514
28434	4055	87510	1923	1530	0	95018
28435	2494	90083	1656	1356	0	95589
28436	1767	4488	84798	1256	0	92309
28437	1380	85180	3729	1282	0	91571
28438	1651	3904	2495	77023	0	85073
28439	1407	83582	1913	2868	0	89770
28440	1566	3624	1539	78599	0	85328
28441	1219	81333	1388	3110	0	87050
28442	80018	3754	1246	1811	0	86829
28443	3478	81444	1386	1240	0	87548
28444	1937	3482	1020	71047	0	77486
28445	1525	76964	1058	2467	0	82014
28446	75909	3415	1033	1335	0	81692
28447	76557	2069	755	1174	0	80555
28448	3737	75516	823	910	0	80986
28449	74066	3311	599	874	0	78850
28450	3526	2566	718	70839	0	77649
28451	1863	1603	71444	2690	0	77600
28452	1593	1431	71611	1388	0	76023
28453	1317	72902	3058	1157	0	78434
28454	59803	1955	1252	832	0	63842
28455	59648	1086	602	781	0	62117
28456	2211	862	59012	648	0	62733
28457	1113	749	57840	653	0	60355
28458	56192	767	1803	709	0	59471
28459	59135	738	880	695	0	61448
28460	2062	848	57335	550	0	60795
28461	52737	721	1584	611	0	55653
28462	1843	54457	839	531	0	57670
28463	942	57479	612	514	0	59547
28464	835	2114	648	55434	0	59031
28465	721	1221	474	56957	0	59373
28466	57109	829	529	2043	0	60510
28467	56852	779	622	1056	0	59309
28468	57376	691	540	854	0	59461
28469	2180	795	476	56321	0	59772
28470	1273	773	417	56671	0	59134
28471	930	53494	469	1973	0	56866
28472	837	54616	501	1031	0	56985
28473	822	57529	457	704	0	59512
28474	929	2190	436	53695	0	57250
28475	855	56065	416	1515	0	58851
28476	820	1944	53764	855	0	57383
28477	50406	1192	1372	799	0	53769
28478	1808	1034	54080	655	0	57577
28479	1045	929	53551	621	0	56146
28480	52201	857	1759	704	0	55521
28481	1802	54801	840	641	0	58084
28482	55369	1842	554	674	0	58439
28483	55727	1113	479	705	0	58024
28484	2252	869	52274	642	0	56037
28485	1339	791	54905	603	0	57638
28486	1094	56151	1814	560	0	59619
28487	1019	1918	57185	505	0	60627
28488	1026	1079	1774	56932	0	60811
28489	1192	956	1036	45603	0	48787
28490	796	56612	810	1869	0	60087
28491	903	59505	722	933	0	62063
28492	58002	2354	588	754	0	61698
28493	59800	1391	577	715	0	62483
28494	2430	957	679	59030	0	63096
28495	1380	866	708	60094	0	63048
28496	58432	769	715	2022	0	61938
28497	58899	791	647	1087	0	61424
28498	2261	59317	605	829	0	63012
28499	56198	1606	506	538	0	58848
28500	2036	53898	449	429	0	56812
28501	1119	56170	436	460	0	58185
28502	55721	1865	433	591	0	58610
28503	55378	1007	427	585	0	57397
28504	2120	811	397	54152	0	57480
28505	54256	697	322	1402	0	56677
28506	2016	650	53349	625	0	56640
28507	1251	53966	1120	556	0	56893
28508	53466	1376	529	789	0	56160
28509	1702	645	54089	614	0	57050
28510	969	711	1157	50380	0	53217
28511	843	50889	539	960	0	53231
28512	867	52895	399	467	0	54628
28513	52655	1308	417	457	0	54837
28514	1494	631	51168	344	0	53637
28515	49121	460	972	281	0	50834
28516	1453	334	544	49860	0	52191
28517	888	318	49721	811	0	51738
28518	47419	327	971	555	0	49272
28519	1294	50414	510	306	0	52524
28520	690	53173	401	279	0	54543
28521	53555	1184	430	340	0	55509
28522	53545	635	227	421	0	54828
28523	54859	430	207	493	0	55989
28524	1537	347	228	53725	0	55837
28525	1035	284	237	54092	0	55648
28526	754	264	53466	946	0	55430
28527	608	266	50893	589	0	52356
28528	511	52791	847	497	0	54646
28529	402	692	361	49753	0	51208
28530	49518	282	178	642	0	50620
28531	624	49214	139	293	0	50270
28532	327	643	87	49622	0	50679
28533	49396	248	123	687	0	50454
28534	662	48648	121	319	0	49750
28535	359	51016	106	221	0	51702
28536	392	614	48930	193	0	50129
28537	47546	261	527	247	0	48581
28538	49749	250	237	264	0	50500
28539	691	183	48584	180	0	49638
28540	44840	128	451	213	0	45632
28541	550	173	48433	104	0	49260
28542	262	47594	440	80	0	48376
28543	286	483	262	47079	0	48110
28544	47015	191	128	458	0	47792
28545	474	46271	110	151	0	47006
28546	219	46582	97	127	0	47025
28547	45087	380	77	171	0	45715
28548	398	195	47226	76	0	47895
28549	45407	148	294	241	0	46090
28550	364	48658	129	85	0	49236
28551	230	318	46945	57	0	47550
28552	45577	137	285	147	0	46146
28553	47643	109	108	123	0	47983
28554	472	104	77	46900	0	47553
28555	255	80	83	47580	0	47998
28556	156	47155	70	339	0	47720
28557	161	362	46515	143	0	47181
28558	229	142	327	46210	0	46908
28559	146	130	48696	402	0	49374
28560	158	123	47792	141	0	48214
28561	184	92	523	50056	0	50855
28562	133	110	51005	521	0	51769
28563	166	94	48981	190	0	49431
28564	209	82	674	48047	0	49012
28565	122	82	49848	533	0	50585
28566	43810	86	641	361	0	44898
28567	539	48070	311	197	0	49117
28568	263	500	48972	137	0	49872
28569	221	212	51716	120	0	52269
28570	290	163	712	48748	0	49913
28571	53949	114	347	649	0	55059
28572	54248	84	265	334	0	54931
28573	53848	93	197	249	0	54387
28574	54264	83	186	234	0	54767
28575	821	69	174	53028	0	54092
28576	406	93	53664	553	0	54716
28577	52874	66	612	383	0	53935
28578	54306	72	275	352	0	55005
28579	54894	70	246	283	0	55493
28580	828	91	53275	129	0	54323
28581	50447	81	589	216	0	51333
28582	735	103	316	55268	0	56422
28583	355	55543	305	564	0	56767
28584	378	544	199	54232	0	55353
28585	261	54764	198	580	0	55803
28586	54383	559	192	363	0	55497
28587	725	211	54230	203	0	55369
28588	411	151	647	52291	0	53500
28589	239	52768	354	579	0	53940
28590	194	54715	279	283	0	55471
28591	54739	677	228	309	0	55953
28592	54414	275	210	242	0	55141
28593	875	200	52532	122	0	53729
28594	52755	131	710	233	0	53829
28595	933	110	328	53308	0	54679
28596	440	126	54233	700	0	55499
28597	430	150	52628	288	0	53496
28598	447	108	827	54937	0	56319
28599	58920	108	404	966	0	60398
28600	1068	83	321	58590	0	60062
28601	630	85	275	58704	0	59694
28602	481	85	263	58713	0	59542
28603	354	59263	252	1262	0	61131
28604	417	835	229	60464	0	61945
28605	58771	354	220	1286	0	60631
28606	1074	58886	251	581	0	60792
28607	583	952	251	59974	0	61760
28608	59415	412	192	1316	0	61335
28609	1131	57722	227	616	0	59696
28610	556	59077	251	437	0	60321
28611	495	1282	233	59201	0	61211
28612	57889	549	196	1388	0	60022
28613	1281	345	57883	656	0	60165
28614	665	266	55842	532	0	57305
28615	57698	238	1364	585	0	59885
28616	61257	238	624	538	0	62657
28617	1726	61881	423	352	0	64382
28618	1003	1215	294	60181	0	62693
28619	633	570	61087	1312	0	63602
28620	486	406	58655	689	0	60236
28621	450	281	63307	522	0	64560
28622	425	61897	1924	435	0	64681
28623	404	63988	868	413	0	65673
28624	63101	1745	504	532	0	65882
28625	1623	777	63350	449	0	66199
28626	61733	505	1538	495	0	64271
28627	63904	343	802	538	0	65587
28628	2080	352	64117	370	0	66919
28629	1126	65848	1567	388	0	68929
28630	1064	1612	776	62886	0	66338
28631	637	801	67484	1576	0	70498
28632	635	561	62614	803	0	64613
28633	62791	424	1992	682	0	65889
28634	1680	66906	1044	424	0	70054
28635	1041	1627	650	64144	0	67462
28636	788	866	526	64180	0	66360
28637	522	64093	553	1952	0	67120
28638	611	65508	516	943	0	67578
28639	540	67117	544	631	0	68832
28640	667	2194	474	68149	0	71484
28641	69531	1002	401	2001	0	72935
28642	2135	701	436	70419	0	73691
28643	944	587	69951	2182	0	73664
28644	707	532	69387	1096	0	71722
28645	647	521	2437	71011	0	74616
28646	595	558	71877	2045	0	75075
28647	558	71645	2170	1130	0	75503
28648	696	2040	1031	75401	0	79168
28649	78326	978	781	2542	0	82627
28650	78255	667	605	1338	0	80865
28651	2946	78894	574	875	0	83289
28652	79278	2590	569	853	0	83290
28653	81815	1224	477	872	0	84388
28654	82519	822	518	843	0	84702
28655	3549	797	68318	694	0	73358
28656	76686	610	1927	822	0	80045
28657	2998	77895	977	764	0	82634
28658	1495	2310	78134	563	0	82502
28659	1061	1065	77926	648	0	80700
28660	835	76877	2937	711	0	81360
28661	77254	2454	1470	666	0	81844
28662	2863	1122	787	74429	0	79201
28663	1386	75256	715	2309	0	79666
28664	77011	2431	642	1256	0	81340
28665	2919	1253	578	77236	0	81986
28666	78378	859	542	2670	0	82449
28667	3269	634	567	78581	0	83051
28668	1717	716	77374	2668	0	82475
28669	1201	785	75418	1288	0	78692
28670	1087	661	76956	940	0	79644
28671	1288	711	3285	73596	0	78880
28672	1126	733	1570	77661	0	81090
28673	1009	763	76429	3178	0	81379
28674	1068	75771	2746	1624	0	81209
28675	78179	2620	1400	1059	0	83258
28676	79005	1322	1090	962	0	82379
28677	3593	79343	1066	824	0	84826
28678	2205	2917	918	80480	0	86520
28679	1427	1384	82437	2987	0	88235
28680	80086	1003	3160	1628	0	85877
28681	3466	787	82976	1179	0	88408
28682	1916	837	75943	859	0	79555
28683	1421	776	81585	751	0	84533
28684	78288	696	4043	899	0	83926
28685	3538	779	80658	780	0	85755
28686	1972	76118	3518	821	0	82429
28687	1538	81482	2063	823	0	85906
28688	1481	3453	1619	77568	0	84121
28689	1486	1692	1269	80132	0	84579
28690	1267	1047	79030	3500	0	84844
28691	75802	976	3280	1801	0	81859
28692	81204	965	1819	1183	0	85171
28693	4204	801	1500	79332	0	85837
28694	79531	719	1362	2995	0	84607
28695	3587	78674	1347	1512	0	85120
28696	78723	2874	1137	1287	0	84021
28697	3585	75581	1138	1148	0	81452
28698	1830	77512	1064	1054	0	81460
28699	74841	3136	1054	955	0	79986
28700	74370	1492	1086	975	0	77923
28701	77262	991	1112	850	0	80215
28702	78140	802	1135	943	0	81020
28703	3943	896	71622	924	0	77385
28704	71719	777	2826	870	0	76192
28705	3559	777	1556	69647	0	75539
28706	2057	71667	1168	2455	0	77347
28707	72264	2501	1036	1322	0	77123
28708	3315	71924	940	1112	0	77291
28709	72874	2757	857	869	0	77357
28710	3593	1400	805	71518	0	77316
28711	2226	1122	835	73329	0	77512
28712	1787	1027	67673	3006	0	73493
28713	1769	881	70321	1500	0	74471
28714	1657	71562	2914	1151	0	77284
28715	69772	2454	1527	981	0	74734
28716	3242	68321	1120	717	0	73400
28717	2147	67010	907	733	0	70797
28718	1881	70942	853	685	0	74361
28719	1790	3052	67201	662	0	72705
28720	1561	68910	2326	661	0	73458
28721	64020	2683	1260	729	0	68692
28722	64676	1364	963	675	0	67678
28723	3348	1059	816	61736	0	66959
28724	1977	60907	760	2179	0	65823
28725	1603	63556	773	1158	0	67090
28726	1579	2808	693	62094	0	67174
28727	1507	1514	62079	2157	0	67257
28728	1382	60940	2152	1131	0	65605
28729	1528	2585	1020	58978	0	64111
28730	57786	1479	726	2321	0	62312
28731	58467	1174	767	1222	0	61630
28732	2831	58886	737	922	0	63376
28733	59685	2395	766	781	0	63627
28734	60315	1359	750	688	0	63112
28735	3186	1141	736	57497	0	62560
28736	1851	1046	56718	2056	0	61671
28737	1400	57924	2119	1087	0	62530
28738	1302	2640	1157	56909	0	62008
28739	1273	1491	57020	1880	0	61664
28740	1223	56018	1822	1067	0	60130
28741	54004	2222	1040	916	0	58182
28742	54959	1300	814	786	0	57859
28743	2674	1055	642	53261	0	57632
28744	1616	53950	727	1787	0	58080
28745	1310	2007	53398	984	0	57699
28746	1374	1415	1793	52309	0	56891
28747	1135	1088	53550	1817	0	57590
28748	837	48629	1482	954	0	51902
28749	1120	1494	831	44573	0	48018
28750	44463	873	544	1227	0	47107
28751	1342	44308	413	757	0	46820
28752	43769	1247	383	625	0	46024
28753	42994	869	331	539	0	44733
28754	1764	43593	288	521	0	46166
28755	1217	1257	345	43341	0	46160
28756	960	945	305	43225	0	45435
28757	777	41393	378	1378	0	43926
28758	669	43169	380	836	0	45054
28759	743	1390	301	40537	0	42971
28760	694	42358	313	1007	0	44372
28761	42608	1241	289	636	0	44774
28762	42435	788	254	515	0	43992
28763	1548	682	41398	414	0	44042
28764	945	526	39662	435	0	41568
28765	40034	521	1044	505	0	42104
28766	42462	536	597	413	0	44008
28767	1337	43357	407	408	0	45509
28768	43239	1181	337	512	0	45269
28769	43004	777	275	450	0	44506
28770	1469	41990	215	416	0	44090
28771	42696	1157	199	472	0	44524
28772	1437	797	243	47084	0	49561
28773	883	756	262	48740	0	50641
28774	704	514	49482	1769	0	52469
28775	536	46683	1273	759	0	49251
28776	443	49909	417	493	0	51262
28777	46306	2105	670	720	0	49801
28778	46418	523	232	470	0	47643
28779	44139	344	179	470	0	45132
28780	47011	262	216	353	0	47842
28781	1514	330	42779	228	0	44851
28782	580	355	45537	160	0	46632
28783	484	46315	1201	179	0	48179
28784	607	1208	365	45785	0	47965
28785	623	455	230	45921	0	47229
28786	534	47431	185	1080	0	49230
28787	549	1248	204	46783	0	48784
28788	46500	447	261	1321	0	48529
28789	1328	46552	224	458	0	48562
28790	579	1308	47156	367	0	49410
28791	419	48379	1079	432	0	50309
28792	48239	1402	391	407	0	50439
28793	1302	577	47946	358	0	50183
28794	46810	437	1157	380	0	48784
28795	49125	418	367	323	0	50233
28796	1586	358	48187	228	0	50359
28797	623	377	47613	201	0	48814
28798	564	340	47212	188	0	48304
28799	43717	306	1522	240	0	45785
28800	1450	302	47616	136	0	49504
28801	691	46806	1269	163	0	48929
28802	47104	1132	565	183	0	48984
28803	1340	408	47172	150	0	49070
28804	44160	259	1433	197	0	46049
28805	1461	307	46331	131	0	48230
28806	698	238	48166	139	0	49241
28807	484	49023	1506	161	0	51174
28808	518	1215	49623	128	0	51484
28809	525	428	48859	130	0	49942
28810	525	40538	1562	159	0	42784
28811	47634	1187	746	165	0	49732
28812	1319	477	48821	73	0	50690
28813	685	425	1387	44407	0	46904
28814	450	48636	725	868	0	50679
28815	49371	1191	632	413	0	51607
28816	49308	512	542	361	0	50723
28817	1520	424	49412	218	0	51574
28818	767	46962	1411	172	0	49312
28819	520	49547	750	196	0	51013
28820	578	1586	554	47337	0	50055
28821	655	42226	448	1000	0	44329
28822	897	1446	462	40707	0	43512
28823	698	592	479	49282	0	51051
28824	519	49436	535	1371	0	51861
28825	575	1493	479	48701	0	51248
28826	463	49228	463	1245	0	51399
28827	454	1570	48292	596	0	50912
28828	491	772	1377	48174	0	50814
28829	486	705	597	48664	0	50452
28830	462	48037	470	1498	0	50467
28831	485	50169	452	726	0	51832
28832	543	1746	404	47459	0	50152
28833	438	49056	552	1256	0	51302
28834	48022	1627	498	746	0	50893
28835	1491	799	456	48261	0	51007
28836	623	48918	517	1391	0	51449
28837	47535	1647	440	686	0	50308
28838	1490	47572	465	544	0	50071
28839	709	1636	46805	567	0	49717
28840	665	870	1445	46458	0	49438
28841	46892	713	757	1497	0	49859
28842	1536	692	47569	677	0	50474
28843	809	694	1524	45461	0	48488
28844	699	46765	694	1248	0	49406
28845	725	1584	46047	512	0	48868
28846	602	47361	1573	534	0	50070
28847	43069	1525	788	513	0	45895
28848	46821	756	831	382	0	48790
28849	1646	46063	762	411	0	48882
28850	45900	1583	715	419	0	48617
28851	1537	778	45233	375	0	47923
28852	772	716	1614	44085	0	47187
28853	709	686	836	43665	0	45896
28854	770	45030	639	1319	0	47758
28855	47614	1594	733	628	0	50569
28856	49085	793	627	553	0	51058
28857	1698	761	48571	331	0	51361
28858	48163	616	1536	449	0	50764
28859	50372	534	719	504	0	52129
28860	50672	630	666	383	0	52351
28861	2000	575	563	48501	0	51639
28862	984	603	576	48981	0	51144
28863	734	48982	557	1381	0	51654
28864	47720	1410	515	656	0	50301
28865	48245	664	461	571	0	49941
28866	1761	47233	396	470	0	49860
28867	859	1431	372	45677	0	48339
28868	615	45220	315	1242	0	47392
28869	568	47911	338	539	0	49356
28870	46373	1466	414	545	0	48798
28871	1501	666	44865	485	0	47517
28872	415	342	38312	212	0	39281
28873	290	39184	568	247	0	40289
28874	36455	497	327	196	0	37475
28875	484	254	36239	118	0	37095
28876	275	32647	389	139	0	33450
28877	33793	378	170	155	0	34496
28878	381	169	33271	83	0	33904
28879	223	137	322	32305	0	32987
28880	34846	94	122	416	0	35478
28881	482	101	34777	161	0	35521
28882	201	117	36145	105	0	36568
28883	161	115	37242	96	0	37614
28884	138	113	36519	60	0	36830
28885	34531	84	597	148	0	35360
28886	39051	93	212	135	0	39491
28887	566	38917	116	108	0	39707
28888	264	520	88	39555	0	40427
28889	179	159	82	40847	0	41267
28890	91	38851	82	656	0	39680
28891	155	627	69	39752	0	40603
28892	97	40599	96	641	0	41433
28893	87	41945	88	256	0	42376
28894	141	862	75	41216	0	42294
28895	99	359	41520	709	0	42687
28896	89	41839	712	255	0	42895
28897	118	793	252	42251	0	43414
28898	42558	307	187	853	0	43905
28899	789	245	42226	279	0	43539
28900	40824	197	789	288	0	42098
28901	43141	172	283	240	0	43836
28902	1137	163	208	43589	0	45097
28903	467	139	44528	995	0	46129
28904	340	146	43800	360	0	44646
28905	228	46563	1279	256	0	48326
28906	268	1141	538	44925	0	46872
28907	165	414	45530	1127	0	47236
28908	158	270	45477	433	0	46338
28909	144	47011	1483	323	0	48961
28910	47299	1218	622	284	0	49423
28911	48612	451	426	270	0	49759
28912	1656	294	331	50373	0	52654
28913	713	222	51849	1470	0	54254
28914	481	208	50984	607	0	52280
28915	330	53323	1971	454	0	56078
28916	293	1482	54297	299	0	56371
28917	231	629	54248	280	0	55388
28918	325	465	2271	50058	0	53119
28919	172	297	54766	1546	0	56781
28920	51839	254	2077	734	0	54904
28921	1643	216	1014	54627	0	57500
28922	691	221	56193	1691	0	58796
28923	438	55870	1899	810	0	59017
28924	416	1583	956	56528	0	59483
28925	316	716	57591	1750	0	60373
28926	255	58688	2109	826	0	61878
28927	337	1891	1101	56898	0	60227
28928	238	60308	876	1724	0	63146
28929	332	2009	782	60296	0	63419
28930	335	896	692	61157	0	63080
28931	260	638	59827	2540	0	63265
28932	310	60053	2098	1279	0	63740
28933	349	1903	1067	60382	0	63701
28934	308	817	874	61383	0	63382
28935	318	641	754	62575	0	64288
28936	246	514	60030	2812	0	63602
28937	187	59394	2175	1489	0	63245
28938	264	1982	1113	60291	0	63650
28939	220	956	59938	2370	0	63484
28940	171	59692	2252	1339	0	63454
28941	271	2129	1208	60023	0	63631
28942	233	1103	60159	2337	0	63832
28943	176	60068	2258	1397	0	63899
28944	267	2173	1220	59174	0	62834
28945	248	1115	887	61885	0	64135
28946	187	773	61620	2988	0	65568
28947	55671	628	2253	1899	0	60451
28948	1643	61469	1213	1278	0	65603
28949	61542	2175	929	1185	0	65831
28950	1993	1170	62105	1049	0	66317
28951	61125	833	2386	1085	0	65429
28952	2154	782	1265	62316	0	66517
28953	936	793	961	64792	0	67482
28954	619	693	62771	2988	0	67071
28955	56411	687	2338	1869	0	61305
28956	58950	614	1228	1535	0	62327
28957	2300	57169	1001	1259	0	61729
28958	1104	60776	897	1092	0	63869
28959	60037	2605	809	1011	0	64462
28960	2252	1398	59482	906	0	64038
28961	1136	61660	2265	930	0	65991
28962	918	2248	1294	62954	0	67414
28963	767	1182	1033	65441	0	68423
28964	627	913	63882	3002	0	68424
28965	60822	705	2469	1859	0	65855
28966	2247	716	65075	1274	0	69312
28967	64186	643	2592	1246	0	68667
28968	2659	590	67442	917	0	71608
28969	1327	67728	2763	858	0	72676
28970	68481	2374	1456	1012	0	73323
28971	69753	1192	1189	965	0	73099
28972	68805	932	1055	928	0	71720
28973	70066	808	922	910	0	72706
28974	3368	752	848	68011	0	72979
28975	1788	695	67298	2543	0	72324
28976	1403	632	2520	65404	0	69959
28977	1172	66534	1460	2514	0	71680
28978	1100	2089	1149	68053	0	72391
28979	901	1099	67449	2726	0	72175
28980	822	834	67066	1387	0	70109
28981	993	833	2803	65661	0	70290
28982	64488	620	1689	2526	0	69323
28983	62706	608	1196	1445	0	65955
28984	64191	590	984	1164	0	66929
28985	3274	610	62732	944	0	67560
28986	1854	521	62130	902	0	65407
28987	1342	60870	2684	863	0	65759
28988	1086	63986	1474	886	0	67432
28989	61517	2280	1152	927	0	65876
28990	62597	1170	892	948	0	65607
28991	2612	64089	897	806	0	68404
28992	62794	1790	827	841	0	66252
28993	63340	965	733	862	0	65900
28994	2721	63124	693	736	0	67274
28995	63932	1820	701	754	0	67207
28996	63312	1008	706	755	0	65781
28997	2734	63132	743	637	0	67246
28998	63636	1801	746	702	0	66885
28999	63909	1007	700	698	0	66314
29000	2813	767	62824	604	0	67008
29001	1722	596	62352	566	0	65236
29002	1226	60390	1921	555	0	64092
29003	1026	62945	1033	510	0	65514
29004	62184	1858	1057	600	0	65699
29005	60218	921	623	526	0	62288
29006	59281	631	577	415	0	60904
29007	2233	58815	554	312	0	61914
29008	1357	1287	381	57599	0	60624
29009	1102	763	57815	1089	0	60769
29010	1193	1069	1173	54597	0	58032
29011	1011	57838	747	1107	0	60703
29012	55769	888	390	441	0	57488
29013	1261	54893	308	253	0	56715
29014	848	968	254	54407	0	56477
29015	57177	510	250	922	0	58859
29016	56880	367	265	464	0	57976
29017	1542	357	55010	245	0	57154
29018	56337	383	928	315	0	57963
29019	60324	281	437	345	0	61387
29020	60840	294	378	290	0	61802
29021	1740	374	296	57566	0	59976
29022	961	58283	269	930	0	60443
29023	852	1143	233	59395	0	61623
29024	688	572	59785	1047	0	62092
29025	616	60081	1111	518	0	62326
29026	588	1107	470	58291	0	60456
29027	604	564	58523	894	0	60585
29028	550	58202	959	441	0	60152
29029	743	1067	461	55440	0	57711
29030	617	558	57528	906	0	59609
29031	52081	438	1011	703	0	54233
29032	1296	409	59215	318	0	61238
29033	850	400	58841	243	0	60334
29034	707	60081	1214	272	0	62274
29035	748	1120	584	59741	0	62193
29036	715	627	371	57573	0	59286
29037	633	58147	378	1149	0	60307
29038	724	1083	359	60916	0	63082
29039	62078	627	331	1313	0	64349
29040	62409	454	327	700	0	63890
29041	1602	444	55433	514	0	57993
29042	61148	420	963	484	0	63015
29043	62989	430	467	486	0	64372
29044	1729	395	62989	351	0	65464
29045	966	62693	1202	345	0	65206
29046	690	63502	658	315	0	65165
29047	825	1529	460	55440	0	58254
29048	548	62387	441	969	0	64345
29049	688	1418	53275	506	0	55887
29050	678	696	59148	437	0	60959
29051	665	61941	1418	288	0	64312
29052	60807	1371	636	439	0	63253
29053	62815	778	426	476	0	64495
29054	63535	576	355	471	0	64937
29055	63451	532	311	453	0	64747
29056	57878	520	364	517	0	59279
29057	1798	61693	357	282	0	64130
29058	1047	1292	60986	239	0	63564
29059	935	669	1115	60282	0	63001
29060	59399	466	508	1231	0	61604
29061	1538	58539	389	538	0	61004
29062	948	1252	329	56916	0	59445
29063	709	648	57129	1025	0	59511
29064	573	54730	1135	513	0	56951
29065	479	56978	560	336	0	58353
29066	54071	1593	632	575	0	56871
29067	1115	53849	262	285	0	55511
29068	711	1045	217	51987	0	53960
29069	52007	464	235	998	0	53704
29070	51981	354	241	467	0	53043
29071	52379	292	219	302	0	53192
29072	1350	349	51229	188	0	53116
29073	635	51793	912	210	0	53550
29074	52739	1047	348	307	0	54441
29075	1166	508	234	52457	0	54365
29076	52891	374	208	1081	0	54554
29077	1220	52725	241	476	0	54662
29078	55287	1092	214	382	0	56975
29079	58933	535	186	352	0	60006
29080	1768	357	213	57387	0	59725
29081	921	342	58687	1186	0	61136
29082	776	349	1173	59337	0	61635
29083	59626	274	515	1432	0	61847
29084	60236	310	350	683	0	61579
29085	1900	59285	347	370	0	61902
29086	56920	1153	276	457	0	58806
29087	1599	57546	240	335	0	59720
29088	57494	1299	198	437	0	59428
29089	55035	599	253	548	0	56435
29090	1610	522	56734	375	0	59241
29091	836	56594	1094	347	0	58871
29092	749	1298	553	57149	0	59749
29093	666	653	376	58203	0	59898
29094	608	506	312	56086	0	57512
29095	498	57214	344	1542	0	59598
29096	533	1278	56979	689	0	59479
29097	517	679	57746	474	0	59416
29098	460	67873	1568	416	0	70317
29099	67755	1702	683	488	0	70628
29100	1813	798	67473	337	0	70421
29101	65144	560	1710	475	0	67889
29102	1916	66522	792	307	0	69537
29103	979	1737	66729	334	0	69779
29104	903	816	1673	65624	0	69016
29105	597	692	67486	1618	0	70393
29106	595	480	68941	780	0	70796
29107	917	435	2088	62319	0	65759
29108	694	65795	996	1447	0	68932
29109	626	69404	703	595	0	71328
29110	68442	2020	596	477	0	71535
29111	1884	1021	68015	359	0	71279
29112	67144	688	1726	429	0	69987
29113	68357	519	951	433	0	70260
29114	2065	68733	637	316	0	71751
29115	65718	1547	420	316	0	68001
29116	66178	802	341	311	0	67632
29117	63851	543	328	347	0	65069
29118	2195	61657	381	249	0	64482
29119	1114	56161	346	232	0	57853
29120	798	60684	334	196	0	62012
29121	60195	1777	615	256	0	62843
29122	60167	892	348	263	0	61670
29123	1962	645	55796	179	0	58582
29124	1106	479	56200	134	0	57919
29125	58314	351	1404	249	0	60318
29126	59857	339	679	278	0	61153
29127	60734	321	504	300	0	61859
29128	1959	353	401	58619	0	61332
29129	1206	330	275	59651	0	61462
29130	982	351	254	60428	0	62015
29131	820	374	254	60786	0	62234
29132	672	402	55153	1684	0	57911
29133	598	326	56863	779	0	58566
29134	654	283	56864	469	0	58270
29135	698	260	56617	297	0	57872
29136	56039	280	1672	322	0	58313
29137	1463	56931	829	310	0	59533
29138	911	59121	590	349	0	60971
29139	58261	1449	420	381	0	60511
29140	1591	808	57780	327	0	60506
29141	861	584	55588	343	0	57376
29142	55412	438	1687	427	0	57964
29143	57565	354	958	450	0	59327
29144	1707	57258	710	332	0	60007
29145	1147	1105	511	57122	0	59885
29146	58499	603	444	1099	0	60645
29147	59526	542	440	604	0	61112
29148	1877	479	396	57897	0	60649
29149	1255	60303	364	1042	0	62964
29150	61096	1192	377	671	0	63336
29151	1552	694	59931	498	0	62675
29152	58132	552	1218	551	0	60453
29153	1566	60192	725	453	0	62936
29154	61028	1204	584	445	0	63261
29155	58715	636	520	562	0	60433
29156	1703	616	61005	311	0	63635
29157	1123	443	58698	268	0	60532
29158	59555	425	1663	338	0	61981
29159	61408	470	943	335	0	63156
29160	1740	62320	666	257	0	64983
29161	1252	1220	537	62874	0	65883
29162	998	668	62876	1012	0	65554
29163	61866	608	1379	554	0	64407
29164	1624	483	827	63370	0	66304
29165	1168	391	643	64562	0	66764
29166	64279	362	607	1471	0	66719
29167	1595	66645	528	823	0	69591
29168	67496	1247	408	716	0	69867
29169	67783	666	510	477	0	69436
29170	68668	621	425	470	0	70184
29171	2030	67666	458	411	0	70565
29172	68445	1233	468	376	0	70522
29173	2063	632	412	67647	0	70754
29174	1303	591	362	67593	0	69849
29175	1204	497	67299	1482	0	70482
29176	1080	411	65557	765	0	67813
29177	909	66214	1460	576	0	69159
29178	789	66386	760	376	0	68311
29179	773	1220	63225	202	0	65420
29180	668	63692	1034	252	0	65646
29181	64441	1283	641	412	0	66777
29182	64779	564	351	305	0	65999
29183	65463	385	254	345	0	66447
29184	1731	343	238	62324	0	64636
29185	1040	310	236	63926	0	65512
29186	634	332	64906	1251	0	67123
29187	529	64422	950	699	0	66600
29188	64469	1038	432	546	0	66485
29189	1185	65035	389	270	0	66879
29190	65094	1192	288	241	0	66815
29191	65247	488	216	288	0	66239
29192	1770	366	190	62830	0	65156
29193	1112	261	248	63119	0	64740
29194	815	240	209	65079	0	66343
29195	602	251	62448	1526	0	64827
29196	423	60336	928	920	0	62607
29197	374	60592	470	607	0	62043
29198	194	50713	135	156	0	51198
29199	158	50677	118	163	0	51116
29200	211	51531	107	164	0	52013
29201	47644	599	139	250	0	48632
29202	532	283	49143	116	0	50074
29203	265	49551	440	131	0	50387
29204	206	484	47850	114	0	48654
29205	183	49619	414	150	0	50366
29206	632	867	294	31891	0	33684
29207	215	284	113	46753	0	47365
29208	167	48176	104	486	0	48933
29209	46927	463	114	339	0	47843
29210	482	286	46494	138	0	47400
29211	244	46998	400	153	0	47795
29212	188	547	45985	110	0	46830
29213	252	281	390	45320	0	46243
29214	242	181	221	42271	0	42915
29215	187	45288	112	485	0	46072
29216	225	476	118	45890	0	46709
29217	217	272	101	45726	0	46316
29218	144	45908	102	549	0	46703
29219	149	513	45182	226	0	46070
29220	156	299	44128	145	0	44728
29221	42245	187	515	246	0	43193
29222	45794	222	222	201	0	46439
29223	595	216	122	44394	0	45327
29224	270	183	43920	449	0	44822
29225	213	166	437	42372	0	43188
29226	155	44756	228	513	0	45652
29227	152	513	44559	268	0	45492
29228	152	44115	472	197	0	44936
29229	139	540	43964	147	0	44790
29230	121	44426	424	169	0	45140
29231	43818	505	284	252	0	44859
29232	488	292	154	43609	0	44543
29233	311	199	148	43085	0	43743
29234	188	212	43429	553	0	44382
29235	200	198	41069	276	0	41743
29236	151	43221	545	208	0	44125
29237	42697	492	239	289	0	43717
29238	475	276	182	42112	0	43045
29239	227	201	43329	455	0	44212
29240	191	218	41150	236	0	41795
29241	37732	196	538	289	0	38755
29242	40300	185	261	277	0	41023
29243	510	184	41356	149	0	42199
29244	267	260	462	39231	0	40220
29245	178	40331	243	408	0	41160
29246	40781	460	176	338	0	41755
29247	400	40559	178	189	0	41326
29248	39241	405	142	208	0	39996
29249	394	38899	146	126	0	39565
29250	198	39627	111	140	0	40076
29251	210	443	136	39349	0	40138
29252	183	199	125	39368	0	39875
29253	127	39669	129	664	0	40589
29254	127	427	39049	180	0	39783
29255	140	226	37861	163	0	38390
29256	147	179	37981	148	0	38455
29257	35251	176	485	236	0	36148
29258	37931	139	247	240	0	38557
29259	427	41412	164	151	0	42154
29260	203	625	40733	124	0	41685
29261	227	327	563	40529	0	41646
29262	116	208	43089	634	0	44047
29263	76	207	44234	306	0	44823
29264	188	169	903	47395	0	48655
29265	183	181	373	50166	0	50903
29266	109	183	53065	1254	0	54611
29267	48964	136	985	858	0	50943
29268	962	53472	608	414	0	55456
29269	572	56494	420	227	0	57713
29270	481	1555	265	54562	0	56863
29271	56460	907	182	1131	0	58680
29272	1221	57837	203	634	0	59895
29273	57841	1428	151	523	0	59943
29274	1485	58635	163	310	0	60593
29275	60212	1638	140	382	0	62372
29276	1753	950	59552	271	0	62526
29277	988	679	60421	249	0	62337
29278	893	609	1797	58390	0	61689
29279	441	419	59526	1277	0	61663
29280	444	55793	1735	706	0	58678
29281	382	56013	986	455	0	57836
29282	57176	1842	729	357	0	60104
29283	1473	1140	502	55079	0	58194
29284	821	57903	426	1267	0	60417
29285	58487	1590	391	816	0	61284
29286	57215	1060	351	529	0	59155
29287	59272	757	293	399	0	60721
29288	2598	564	283	57135	0	60580
29289	1638	462	232	58455	0	60787
29290	1032	454	58147	1978	0	61611
29291	758	470	57847	1145	0	60220
29292	56913	315	1992	865	0	60085
29293	1866	331	1183	57039	0	60419
29294	1119	347	57554	1666	0	60686
29295	56046	364	1680	1150	0	59240
29296	1803	59185	1129	729	0	62846
29297	60018	1444	785	655	0	62902
29298	60967	951	567	632	0	63117
29299	61335	630	517	577	0	63059
29300	2843	422	58980	491	0	62736
29301	59044	380	1636	414	0	61474
29302	2679	361	957	56531	0	60528
29303	1646	54826	700	1509	0	58681
29304	1349	59793	535	932	0	62609
29305	59646	1875	599	703	0	62823
29306	60293	1089	483	542	0	62407
29307	61125	720	439	571	0	62855
29308	3089	522	398	58455	0	62464
29309	2100	459	407	59540	0	62506
29310	1591	512	340	58033	0	60476
29311	1216	59031	357	2424	0	63028
29312	59197	1572	333	1501	0	62603
29313	60036	1006	318	1101	0	62461
29314	61451	786	348	843	0	63428
29315	3143	564	59875	704	0	64286
29316	61416	541	1539	714	0	64210
29317	2940	546	918	57640	0	62044
29318	1934	59989	649	1585	0	64157
29319	60684	1736	448	1110	0	63978
29320	60534	1076	436	855	0	62901
29321	3205	795	60252	566	0	64818
29322	2297	543	1677	58619	0	63136
29323	1612	61165	969	1834	0	65580
29324	63441	1783	753	1290	0	67267
29325	2679	1197	499	63190	0	67565
29326	1977	895	510	62871	0	66253
29327	1695	626	432	64810	0	67563
29328	1360	644	445	66661	0	69110
29329	1295	581	64124	3271	0	69271
29330	1227	64373	1925	1911	0	69436
29331	1291	1955	1029	65140	0	69415
29332	1024	1198	65253	2672	0	70147
29333	64042	982	1970	1809	0	68803
29334	67070	687	1156	1454	0	70367
29335	3202	681	977	66296	0	71156
29336	67260	614	760	2618	0	71252
29337	68493	670	617	1776	0	71556
29338	3557	616	66478	1294	0	71945
29339	2409	66096	2085	1070	0	71660
29340	67735	1987	1175	1140	0	72037
29341	3111	1127	931	67214	0	72383
29342	69052	801	748	2606	0	73207
29343	3365	617	789	68136	0	72907
29344	2190	667	661	69818	0	73336
29345	1687	703	66873	3274	0	72537
29346	62565	556	2054	2338	0	67513
29347	2872	67823	1207	1613	0	73515
29348	2081	2031	67245	1348	0	72705
29349	1668	68018	2096	1260	0	73042
29350	67469	2376	1187	1219	0	72251
29351	3135	1276	966	66826	0	72203
29352	67192	902	742	2560	0	71396
29353	3120	66117	691	1660	0	71588
29354	67958	2223	651	1399	0	72231
29355	69092	1203	656	1200	0	72151
29356	69390	945	577	1139	0	72051
29357	68757	619	572	1112	0	71060
29358	3921	66563	532	1097	0	72113
29359	65696	1861	537	888	0	68982
29360	3448	1194	514	63738	0	68894
29361	2557	965	371	62611	0	66504
29362	1960	58027	483	2436	0	62906
29363	1709	57774	429	1546	0	61458
29364	1469	56750	335	954	0	59508
29365	53113	1935	457	895	0	56400
29366	2059	49787	305	651	0	52802
29367	1209	47478	253	507	0	49447
29368	46636	1406	558	591	0	49191
29369	45177	707	254	521	0	46659
29370	1805	45278	188	439	0	47710
29371	44290	1094	219	475	0	46078
29372	1582	613	42502	336	0	45033
29373	41375	550	822	393	0	43140
29374	1530	436	41841	408	0	44215
29375	819	38394	714	346	0	40273
29376	698	39708	333	378	0	41117
29377	1236	1206	452	37714	0	40608
29378	38895	423	284	866	0	40468
29379	39402	346	160	493	0	40401
29380	39903	364	165	461	0	40893
29381	39733	344	238	396	0	40711
29382	38954	409	168	371	0	39902
29383	1169	391	37375	310	0	39245
29384	683	404	35038	304	0	36429
29385	37237	359	648	358	0	38602
29386	1069	38267	287	285	0	39908
29387	37990	712	224	337	0	39263
29388	38865	368	177	321	0	39731
29389	39515	305	167	362	0	40349
29390	39330	284	201	343	0	40158
29391	39299	329	188	359	0	40175
29392	1201	288	38142	273	0	39904
29393	39228	334	602	372	0	40536
29394	40090	330	289	417	0	41126
29395	1134	402	34939	376	0	36851
29396	35545	373	422	401	0	36741
29397	39032	385	243	343	0	40003
29398	1232	333	39537	264	0	41366
29399	851	369	39188	213	0	40621
29400	837	39793	714	197	0	41541
29401	852	756	351	39654	0	41613
29402	821	373	40330	589	0	42113
29403	40182	369	648	389	0	41588
29404	1245	311	341	42416	0	44313
29405	778	299	43623	652	0	45352
29406	42797	313	716	418	0	44244
29407	44388	344	357	325	0	45414
29408	44660	319	263	323	0	45565
29409	1358	45095	198	241	0	46892
29410	921	811	191	43679	0	45602
29411	793	44899	267	686	0	46645
29412	45402	809	298	389	0	46898
29413	44942	376	266	354	0	45938
29414	1223	342	43888	163	0	45616
29415	702	41803	618	139	0	43262
29416	529	42752	321	137	0	43739
29417	622	749	252	42018	0	43641
29418	632	419	174	42530	0	43755
29419	42466	279	153	749	0	43647
29420	1037	41862	152	249	0	43300
29421	754	41583	116	162	0	42615
29422	743	744	40971	107	0	42565
29423	593	41946	542	139	0	43220
29424	41231	630	278	222	0	42361
29425	963	307	40606	128	0	42004
29426	36084	218	478	213	0	36993
29427	740	163	38729	116	0	39748
29428	33992	121	394	228	0	34735
29429	568	39301	204	86	0	40159
29430	40006	518	128	135	0	40787
29431	686	237	40825	48	0	41796
29432	40132	163	524	195	0	41014
29433	40787	143	199	189	0	41318
29434	756	150	42335	45	0	43286
29435	41689	122	467	183	0	42461
29436	43663	106	219	158	0	44146
29437	43106	103	133	135	0	43477
29438	819	42408	106	42	0	43375
29439	43426	539	121	131	0	44217
29440	736	287	43128	64	0	44215
29441	401	47188	490	52	0	48131
29442	47819	637	256	150	0	48862
29443	47498	238	143	149	0	48028
29444	48363	120	114	128	0	48725
29445	1010	47601	121	78	0	48810
29446	515	731	110	52766	0	54122
29447	327	280	52623	868	0	54098
29448	415	167	948	52202	0	53732
29449	303	125	53383	972	0	54783
29450	50476	132	1059	416	0	52083
29451	1176	53842	386	206	0	55610
29452	642	1006	196	52768	0	54612
29453	390	54690	171	887	0	56138
29454	438	1129	123	54425	0	56115
29455	404	427	151	54597	0	55579
29456	304	55673	166	1291	0	57434
29457	420	1206	142	56298	0	58066
29458	431	487	138	58361	0	59417
29459	311	57947	188	1580	0	60026
29460	292	60427	182	670	0	61571
29461	430	1638	188	59656	0	61912
29462	335	663	59388	1453	0	61839
29463	269	60252	1367	695	0	62583
29464	439	1530	544	59893	0	62406
29465	339	675	62131	1617	0	64762
29466	282	62874	1551	711	0	65418
29467	62284	1694	528	642	0	65148
29468	1578	795	62283	454	0	65110
29469	61268	513	1560	558	0	63899
29470	1800	570	538	61828	0	64736
29471	793	402	359	63060	0	64614
29472	572	449	276	63554	0	64851
29473	381	536	61870	2238	0	65025
29474	349	479	60983	1037	0	62848
29475	60123	486	1876	864	0	63349
29476	1714	452	818	62120	0	65104
29477	681	480	62755	1887	0	65803
29478	61744	457	1671	1029	0	64901
29479	1826	436	822	63158	0	66242
29480	948	475	520	63853	0	65796
29481	712	400	485	63635	0	65232
29482	523	63733	521	2239	0	67016
29483	627	1751	383	61683	0	64444
29484	525	61681	400	1971	0	64577
29485	421	65099	430	1056	0	67006
29486	63946	2021	376	932	0	67275
29487	57042	878	518	1061	0	59499
29488	64370	586	477	820	0	66253
29489	2173	63068	422	756	0	66419
29490	62924	1741	444	807	0	65916
29491	64231	741	456	781	0	66209
29492	2418	512	473	62449	0	65852
29493	1128	510	447	63540	0	65625
29494	782	423	61519	2431	0	65155
29495	612	63122	1640	1307	0	66681
29496	61298	1771	727	1078	0	64874
29497	62410	806	507	905	0	64628
29498	2028	62042	439	851	0	65360
29499	61942	1902	396	824	0	65064
29500	62296	855	302	902	0	64355
29501	2354	772	351	60514	0	63991
29502	1224	58559	377	1886	0	62046
29503	982	61474	349	1001	0	63806
29504	60204	2002	355	906	0	63467
29505	2159	943	295	59236	0	62633
29506	964	759	58699	2008	0	62430
29507	56087	586	1522	1254	0	59449
29508	1929	645	60047	930	0	63551
29509	964	59243	1630	850	0	62687
29510	59147	1685	756	930	0	62518
29511	1918	929	59179	800	0	62826
29512	1110	844	1563	59986	0	63503
29513	905	678	61531	1922	0	65036
29514	769	62333	1612	1117	0	65831
29515	833	1897	706	62697	0	66133
29516	778	1000	62100	1992	0	65870
29517	57407	834	1610	1250	0	61101
29518	1833	63697	690	998	0	67218
29519	1076	1771	603	61558	0	65008
29520	767	64618	563	1793	0	67741
29521	63821	1897	507	1078	0	67303
29522	63461	1032	508	1073	0	66074
29523	2053	63740	585	887	0	67265
29524	1283	1800	598	62169	0	65850
29525	805	64162	649	1748	0	67364
29526	63279	1846	570	1132	0	66827
29527	1930	1010	63022	832	0	66794
29528	976	896	61120	765	0	63757
29529	887	62045	1710	755	0	65397
29530	760	63772	1021	655	0	66208
29531	802	1862	647	62586	0	65897
29532	62081	926	527	1825	0	65359
29533	62182	728	547	1003	0	64460
29534	60500	591	465	897	0	62453
29535	2146	62286	528	747	0	65707
29536	1209	1508	429	60738	0	63884
29537	955	62356	407	1558	0	65276
29538	62652	1630	451	982	0	65715
29539	1971	858	351	61808	0	64988
29540	1069	601	59780	1536	0	62986
29541	748	58579	1274	804	0	61405
29542	57301	1363	557	674	0	59895
29543	1447	736	57219	528	0	59930
29544	54947	669	1143	694	0	57453
29545	1509	56515	481	589	0	59094
29546	588	52950	250	300	0	54088
29547	51911	999	238	316	0	53464
29548	1027	52966	204	254	0	54451
29549	52099	948	194	325	0	53566
29550	931	52558	153	237	0	53879
29551	52512	897	229	274	0	53912
29552	52466	491	190	246	0	53393
29553	1102	390	53501	194	0	55187
29554	522	311	51728	153	0	52714
29555	408	53284	685	181	0	54558
29556	52869	673	424	244	0	54210
29557	749	330	51779	130	0	52988
29558	49274	249	510	171	0	50204
29559	619	267	197	49587	0	50670
29560	294	152	50585	343	0	51374
29561	263	148	47260	158	0	47829
29562	247	174	50607	122	0	51150
29563	162	51300	411	68	0	51941
29564	475	793	482	49906	0	51656
29565	49472	89	73	250	0	49884
29566	252	54	63	50180	0	50549
29567	50690	54	73	295	0	51112
29568	291	43	70	50954	0	51358
29569	51188	55	63	382	0	51688
29570	49182	78	76	347	0	49683
29571	56117	45	68	236	0	56466
29572	593	56976	55	69	0	57693
29573	246	485	57515	62	0	58308
29574	237	204	497	57462	0	58400
29575	1351	627	644	26181	0	28803
29576	166	78	102	58968	0	59314
29577	212	72	53	57874	0	58211
29578	145	55788	63	804	0	56800
29579	144	589	55543	309	0	56585
29580	96	56592	584	230	0	57502
29581	294	706	241	51632	0	52873
29582	126	296	121	57184	0	57727
29583	143	144	74	57520	0	57881
29584	150	120	63	56992	0	57325
29585	114	55228	102	892	0	56336
29586	100	56024	103	403	0	56630
29587	109	816	54806	258	0	55989
29588	158	397	609	54933	0	56097
29589	187	232	263	55727	0	56409
29590	123	184	124	57404	0	57835
29591	57063	167	80	1171	0	58481
29592	749	57080	93	493	0	58415
29593	371	776	56342	270	0	57759
29594	56122	363	700	321	0	57506
29595	796	217	286	56505	0	57804
29596	57152	173	140	1041	0	58506
29597	933	176	85	57474	0	58668
29598	57546	191	87	1051	0	58875
29599	923	193	141	57543	0	58800
29600	57186	198	136	1004	0	58524
29601	963	175	58440	424	0	60002
29602	575	148	702	57856	0	59281
29603	387	60373	290	799	0	61849
29604	349	787	157	61659	0	62952
29605	61097	371	143	1103	0	62714
29606	938	60318	159	477	0	61892
29607	532	950	165	62792	0	64439
29608	341	62486	175	1019	0	64021
29609	326	1063	144	63506	0	65039
29610	355	473	102	64039	0	64969
29611	300	272	62622	1415	0	64609
29612	397	212	981	60914	0	62504
29613	244	218	59891	1220	0	61573
29614	185	59035	1036	698	0	60954
29615	58807	1047	449	539	0	60842
29616	1063	442	59099	441	0	61045
29617	56535	293	1052	501	0	58381
29618	60083	210	462	524	0	61279
29619	1465	185	320	60529	0	62499
29620	581	257	61526	1238	0	63602
29621	59658	172	1148	802	0	61780
29622	64951	218	523	548	0	66240
29623	1654	172	315	63289	0	65430
29624	860	187	240	63955	0	65242
29625	489	63990	255	1670	0	66404
29626	517	1238	233	63758	0	65746
29627	345	64296	254	1464	0	66359
29628	370	1270	63849	783	0	66272
29629	357	587	1037	62681	0	64662
29630	61391	270	494	1450	0	63605
29631	62340	240	222	814	0	63616
29632	1377	62315	180	518	0	64390
29633	716	1129	147	64269	0	66261
29634	64561	474	199	1473	0	66707
29635	1238	62622	209	753	0	64822
29636	63303	1193	144	606	0	65246
29637	1503	527	127	65729	0	67886
29638	67852	355	155	1624	0	69986
29639	1630	345	70469	737	0	73181
29640	750	70856	1441	564	0	73611
29641	70688	1600	537	652	0	73477
29642	1685	72557	340	448	0	75030
29643	73510	1731	253	588	0	76082
29644	75461	648	205	619	0	76933
29645	2326	459	74454	407	0	77646
29646	1237	400	1556	73061	0	76254
29647	75740	334	590	1924	0	78588
29648	1982	348	74669	793	0	77792
29649	74768	325	1678	634	0	77405
29650	2211	336	585	75134	0	78266
29651	992	319	74604	1880	0	77795
29652	854	253	1723	73953	0	76783
29653	72437	222	742	2161	0	75562
29654	2109	349	73038	913	0	76409
29655	1219	303	1691	73199	0	76412
29656	916	336	713	74174	0	76139
29657	74213	259	510	2460	0	77442
29658	74224	226	383	1309	0	76142
29659	2448	74421	474	795	0	78138
29660	1322	1710	413	74368	0	77813
29661	1181	674	363	74967	0	77185
29662	919	475	460	74315	0	76169
29663	72530	334	445	2647	0	75956
29664	73389	356	380	1334	0	75459
29665	2790	381	385	71527	0	75083
29666	1406	69754	396	2150	0	73706
29667	1200	1746	407	68698	0	72051
29668	1001	70307	437	2102	0	73847
29669	69815	1752	371	1342	0	73280
29670	2256	68502	450	1022	0	72230
29671	64254	1476	403	788	0	66921
29672	2197	581	384	63119	0	66281
29673	62391	434	408	1911	0	65144
29674	2012	389	60976	1061	0	64438
29675	1164	62101	1420	929	0	65614
29676	61998	1427	828	977	0	65230
29677	62907	580	469	946	0	64902
29678	2283	436	385	60665	0	63769
29679	1202	60936	426	1858	0	64422
29680	1109	1348	315	63832	0	66604
29681	1017	638	323	64292	0	66270
29682	988	497	364	64259	0	66108
29683	63353	456	277	2478	0	66564
29684	63864	424	242	1465	0	65995
29685	2356	420	273	62278	0	65327
29686	1278	62261	237	1997	0	65773
29687	63311	1434	229	1349	0	66323
29688	2072	715	61966	1023	0	65776
29689	1351	557	1229	63053	0	66190
29690	1042	597	62283	1949	0	65871
29691	1114	483	1322	62300	0	65219
29692	933	509	62241	2024	0	65707
29693	954	521	1394	62290	0	65159
29694	62324	535	608	2129	0	65596
29695	62639	503	389	1334	0	64865
29696	2203	60902	374	975	0	64454
29697	62230	1519	291	1011	0	65051
29698	2222	773	308	61213	0	64516
29699	1399	604	336	62508	0	64847
29700	61984	530	328	2324	0	65166
29701	2148	533	58817	1262	0	62760
29702	1349	499	57598	1048	0	60494
29703	1190	525	55864	993	0	58572
29704	55553	432	1533	1084	0	58602
29705	1940	433	57324	1033	0	60730
29706	1288	403	54417	973	0	57081
29707	52539	377	1557	1032	0	55505
29708	1746	53815	820	894	0	57275
29709	1226	1149	594	54641	0	57610
29710	994	632	514	56000	0	58140
29711	967	464	55239	1917	0	58587
29712	54139	378	1399	1379	0	57295
29713	55150	358	749	1182	0	57439
29714	51425	367	663	1139	0	53594
29715	1902	300	54980	981	0	58163
29716	52961	313	1390	1139	0	55803
29717	1896	322	52314	943	0	55475
29718	1180	51986	1315	920	0	55401
29719	1044	52957	755	818	0	55574
29720	50465	1171	648	879	0	53163
29721	1529	49231	551	776	0	52087
29722	930	49607	552	768	0	51857
29723	49299	1172	558	840	0	51869
29724	1517	49824	537	667	0	52545
29725	49397	1121	536	719	0	51773
29726	1700	549	514	51165	0	53928
29727	1060	467	523	52319	0	54369
29728	975	389	530	52433	0	54327
29729	852	435	567	51090	0	52944
29730	787	51134	564	1647	0	54132
29731	53137	1147	522	937	0	55743
29732	1733	58765	513	736	0	61747
29733	905	60990	514	770	0	63179
29734	847	1907	63247	548	0	66549
29735	61061	719	1941	775	0	64496
29736	2292	534	66295	486	0	69607
29737	1084	342	68145	420	0	69991
29738	633	65489	2157	410	0	68689
29739	299	68693	739	258	0	69989
29740	68592	2217	501	479	0	71789
29741	1864	71506	309	353	0	74032
29742	955	2133	71264	262	0	74614
29743	555	69188	1970	263	0	71976
29744	391	2123	71004	177	0	73695
29745	406	923	69839	145	0	71313
29746	66881	661	2683	293	0	70518
29747	1974	477	69287	136	0	71874
29748	1064	411	2448	66691	0	70614
29749	65810	307	1275	1959	0	69351
29750	1927	65863	904	884	0	69578
29751	1055	1836	67143	419	0	70453
29752	65986	847	2247	437	0	69517
29753	2276	507	1139	62439	0	66361
29754	1134	61716	721	1738	0	65309
29755	624	1947	64934	753	0	68258
29756	63748	889	2249	510	0	67396
29757	2239	575	65176	260	0	68250
29758	1298	386	2428	63970	0	68082
29759	653	355	63889	1920	0	66817
29760	705	309	2485	63497	0	66996
29761	62232	278	1264	2358	0	66132
29762	1960	64002	947	1095	0	68004
29763	65070	1968	646	772	0	68456
29764	2440	920	64547	447	0	68354
29765	1381	563	2226	64862	0	69032
29766	833	423	66484	2072	0	69812
29767	65109	444	2516	1086	0	69155
29768	66752	344	1293	677	0	69066
29769	2886	66452	1034	431	0	70803
29770	67370	2073	716	550	0	70709
29771	68488	966	726	443	0	70623
29772	3429	580	527	66080	0	70616
29773	1786	477	65876	2067	0	70206
29774	1118	63629	2228	1060	0	68035
29775	1162	2149	1067	64202	0	68580
29776	65175	1065	759	2272	0	69271
29777	2506	638	64807	1172	0	69123
29778	1343	505	65536	673	0	68057
29779	943	502	64077	515	0	66037
29780	62385	468	3290	552	0	66695
29781	2645	468	63542	359	0	67014
29782	62438	394	2975	439	0	66246
29783	2728	446	56448	366	0	59988
29784	1452	61339	2714	373	0	65878
29785	1281	2122	1474	60144	0	65021
29786	825	1100	61558	2080	0	65563
29787	862	58908	2698	995	0	63463
29788	729	61781	1551	608	0	64669
29789	810	2866	1088	60174	0	64938
29790	60141	1414	945	2339	0	64839
29791	2487	959	979	60676	0	65101
29792	60157	784	855	2568	0	64364
29793	2815	793	754	59888	0	64250
29794	1524	601	59391	2684	0	64200
29795	1218	596	60462	1303	0	63579
29796	58313	500	3248	1161	0	63222
29797	60053	425	1894	883	0	63255
29798	3226	540	58907	797	0	63470
29799	58275	520	2850	728	0	62373
29800	3053	531	58561	551	0	62696
29801	1888	55219	3023	480	0	60610
29802	1454	56273	1742	531	0	60000
29803	1181	57439	1389	525	0	60534
29804	1305	3041	1146	55149	0	60641
29805	55284	1527	1181	2301	0	60293
29806	56880	1103	1058	1137	0	60178
29807	3384	882	941	55092	0	60299
29808	1942	869	53803	2408	0	59022
29809	1471	690	2602	54137	0	58900
29810	1278	611	54131	2701	0	58721
29811	1220	557	2963	53590	0	58330
29812	52785	504	1758	2916	0	57963
29813	54524	461	1362	1577	0	57924
29814	54818	469	1186	1184	0	57657
29815	55161	470	1150	988	0	57769
29816	3893	433	937	52147	0	57410
29817	2417	405	908	53884	0	57614
29818	52970	380	829	3222	0	57401
29819	54407	425	871	1607	0	57310
29820	3895	465	734	52148	0	57242
29821	2260	404	709	53558	0	56931
29822	1646	385	724	53477	0	56232
29823	1537	384	666	53861	0	56448
29824	51289	397	675	3676	0	56037
29825	2899	425	49902	2132	0	55358
29826	1831	343	2244	48432	0	52850
29827	47702	303	1327	2897	0	52229
29828	2724	287	46605	1898	0	51514
29829	2054	308	2312	46891	0	51565
29830	1467	279	46788	2602	0	51136
29831	1225	43003	2537	1605	0	48370
29832	1323	1324	1356	36091	0	40094
29833	33117	657	983	1821	0	36578
29834	1701	677	810	29404	0	32592
29835	1184	27650	741	1726	0	31301
29836	952	25768	625	1019	0	28364
29837	679	19769	434	718	0	21600
29838	688	18319	445	550	0	20002
29839	10403	1358	1445	932	0	14138
29840	755	337	415	7335	0	8842
29841	193	84	6341	336	0	6954
29842	196	83	264	6047	0	6590
29843	193	71	5916	307	0	6487
29844	5966	66	242	186	0	6460
29845	347	59	110	5907	0	6423
29846	216	62	118	6045	0	6441
29847	195	68	100	6020	0	6383
29848	165	64	91	6052	0	6372
29849	5827	80	80	356	0	6343
29850	5938	59	71	234	0	6302
29851	331	52	78	5845	0	6306
29852	5666	63	85	356	0	6170
29853	287	49	5501	242	0	6079
29854	147	5415	223	236	0	6021
29855	181	185	107	5480	0	5953
29856	149	59	107	5419	0	5734
29857	167	5249	80	318	0	5814
29858	151	170	76	5151	0	5548
29859	121	143	101	5085	0	5450
29860	4910	49	101	315	0	5375
29861	257	40	4478	153	0	4928
29862	104	39	3923	125	0	4191
29863	3736	30	176	129	0	4071
29864	222	27	3532	92	0	3873
29865	1732	12	138	53	0	1935
29866	1494	6	72	45	0	1617
29867	95	49	51	1132	0	1327
29868	27	7	897	50	0	981
29869	778	5	35	16	0	834
29870	38	769	11	25	0	843
29871	488	58	106	25	0	677
29872	350	15	16	19	0	400
29873	179	0	10	9	0	198
29874	59	6	2	1	0	68
29875	63	0	1	1	0	65
29876	57	0	0	1	0	58
29877	55	0	1	0	0	56
29878	54	0	1	1	0	56
29879	55	0	1	1	0	57
29880	56	1	0	0	0	57
29881	55	1	0	1	0	57
29882	54	0	0	1	0	55
29883	45	0	0	1	0	46
29884	44	0	0	0	0	44
29885	43	0	0	0	0	43
29886	55	0	0	0	0	55
29887	55	0	0	0	0	55
29888	48	0	0	0	0	48
29889	50	0	0	0	0	50
29890	51	0	0	0	0	51
29891	42	0	0	1	0	43
29892	55	0	0	0	0	55
29893	56	0	0	0	0	56
29894	50	0	0	0	0	50
29895	50	0	0	0	0	50
29896	55	0	0	0	0	55
29897	53	0	0	0	0	53
29898	51	0	0	0	0	51
29899	49	0	0	0	0	49
29900	50	0	0	0	0	50
29901	50	0	0	0	0	50
29902	44	0	0	0	0	44
29903	32	0	2	0	0	34
