Pos	A	C	G	T	Other	Total
1	0	0	0	0	0	0
2	0	0	0	0	0	0
3	0	0	0	4	0	4
4	4	0	0	1	0	5
5	7	0	0	0	0	7
6	7	0	0	0	0	7
7	0	0	7	0	0	7
8	0	0	9	0	0	9
9	0	0	0	11	0	11
10	0	0	0	11	0	11
11	0	0	1	13	0	14
12	35	0	0	0	0	35
13	0	1	0	78	0	79
14	130	0	0	1	0	131
15	0	199	0	0	0	199
16	0	364	0	1	0	365
17	3	0	0	1021	0	1024
18	4	0	0	1167	0	1171
19	1	1676	0	2	0	1679
20	1	1895	0	5	0	1901
21	1	2253	0	1	0	2255
22	2585	0	1	12	0	2598
23	5	2	2642	2	0	2651
24	0	3	2667	0	0	2670
25	1	0	0	3015	0	3016
26	3254	0	1	8	0	3263
27	3303	0	0	3	0	3306
28	0	3321	0	9	0	3330
29	3949	2	0	25	0	3976
30	4335	0	0	15	0	4350
31	4447	0	0	5	0	4452
32	0	4462	0	1	0	4463
33	0	4633	0	4	0	4637
34	4932	2	0	10	0	4944
35	5059	0	0	8	0	5067
36	1	5226	0	4	0	5231
37	1	5689	1	9	0	5700
38	5798	0	1	12	0	5811
39	5810	0	0	7	0	5817
40	2	5883	0	0	0	5885
41	3	0	1	6218	0	6222
42	1	1	1	6306	0	6309
43	1	0	1	6306	0	6308
44	3	6279	2	3	0	6287
45	2	3	6278	2	0	6285
46	6047	3	0	11	0	6061
47	2	1	1	6446	0	6450
48	2	6467	0	2	0	6471
49	3	7	0	6541	0	6551
50	0	6571	2	4	0	6577
51	1	4	0	6612	0	6617
52	2	2	0	6737	0	6741
53	4	1	6826	1	0	6832
54	2	3	1	6785	0	6791
55	6848	1	1	10	0	6860
56	3	3	6843	2	0	6851
57	6743	0	2	12	0	6757
58	2	2	0	6994	0	6998
59	2	7022	3	4	0	7031
60	3	3	0	7096	0	7102
61	8	4	7109	3	0	7124
62	5	4	2	7010	0	7021
63	2	0	4	7143	0	7149
64	1	7267	1	11	0	7280
65	0	3	1	7374	0	7378
66	1	7306	2	11	0	7320
67	2	2	1	7391	0	7396
68	7406	4	1	10	0	7421
69	7335	0	2	16	0	7353
70	7435	0	1	16	0	7452
71	14	7523	1	15	0	7553
72	7	4	7494	5	0	7510
73	7438	3	6	11	0	7458
74	7807	0	5	11	0	7823
75	12	7997	2	19	0	8030
76	8	20	0	6996	0	7024
77	3	6	1	7194	0	7204
78	10	6	1	6909	0	6926
79	6845	2	250	38	0	7135
80	7099	6	3	30	0	7138
81	7146	0	0	17	0	7163
82	7228	2	0	11	0	7241
83	32	11	0	7215	0	7258
84	15	7226	3	20	0	7264
85	10	21	0	7432	0	7463
86	11	14	7498	20	0	7543
87	18	4	23	7648	0	7693
88	5	3	7888	34	0	7930
89	10	4	32	7859	0	7905
90	1	4	8158	39	0	8202
91	9	3	8030	17	0	8059
92	6	8438	49	17	0	8510
93	15	41	14	8850	0	8920
94	6	12	9177	45	0	9240
95	18	4	51	9039	0	9112
96	5	9244	9	52	0	9310
97	9314	42	3	37	0	9396
98	43	9690	9	15	0	9757
99	18	48	3	9733	0	9802
100	4	9879	1	48	0	9932
101	9	51	9665	15	0	9740
102	11	16	9540	15	0	9582
103	5	9714	60	11	0	9790
104	9	48	14	9943	0	10014
105	5	15	9944	55	0	10019
106	1	9848	56	32	0	9937
107	9921	50	18	21	0	10010
108	61	17	4	9997	0	10079
109	23	4	10242	50	0	10319
110	5	10254	52	24	0	10335
111	15	58	13	10382	0	10468
112	10	14	6	10386	0	10416
113	10224	7	14	74	0	10319
114	48	9	10349	19	0	10425
115	26	11	44	10287	0	10368
116	5	7	10246	59	0	10317
117	4	9823	59	17	0	9903
118	9652	53	20	28	0	9753
119	46	9519	11	11	0	9587
120	23	48	9	9367	0	9447
121	2	9246	12	44	0	9304
122	9039	50	2	36	0	9127
123	50	9059	10	14	0	9133
124	23	56	8919	12	0	9010
125	9	8893	50	2	0	8954
126	8673	53	17	18	0	8761
127	51	26	8902	10	0	8989
128	22	12	59	8851	0	8944
129	7279	12	1361	58	0	8710
130	54	7	16	8358	0	8435
131	8389	7	9	71	0	8476
132	8419	4	12	28	0	8463
133	73	12	6	8325	0	8416
134	26	5	6	8266	0	8303
135	8121	9	1	86	0	8217
136	8012	6	12	31	0	8061
137	75	12	4	7780	0	7871
138	7750	9	8	74	0	7841
139	7792	6	6	40	0	7844
140	73	7743	10	13	0	7839
141	29	58	7	7710	0	7804
142	7748	19	3	78	0	7848
143	7828	4	8	30	0	7870
144	74	13	8	7751	0	7846
145	28	7	7	7818	0	7860
146	7745	12	6	85	0	7848
147	69	7793	8	33	0	7903
148	23	60	3	7769	0	7855
149	20	14	7769	76	0	7879
150	22	12	53	7628	0	7715
151	14	7719	18	63	0	7814
152	8	67	7677	24	0	7776
153	24	14	56	7552	0	7646
154	32	14	17	7374	0	7437
155	9	6	7661	85	0	7761
156	7213	10	64	36	0	7323
157	64	7788	15	29	0	7896
158	7795	61	10	25	0	7891
159	70	17	7771	18	0	7876
160	27	12	7861	16	0	7916
161	7621	10	66	36	0	7733
162	68	8026	16	19	0	8129
163	8064	61	14	23	0	8162
164	63	8074	13	19	0	8169
165	23	60	8140	13	0	8236
166	7994	14	59	26	0	8093
167	72	20	8325	7	0	8424
168	26	12	54	8236	0	8328
169	8292	12	15	73	0	8392
170	8234	6	10	31	0	8281
171	69	8169	14	21	0	8273
172	29	150	12	7964	0	8155
173	27	8070	8	52	0	8157
174	21	53	8008	14	0	8096
175	30	77	59	7586	0	7752
176	17	7451	19	56	0	7543
177	23	49	16	7394	0	7482
178	7151	12	15	58	0	7236
179	40	8	5	7220	0	7273
180	15	7249	4	45	0	7313
181	25	40	6	7264	0	7335
182	9	19	8	7240	0	7276
183	10	7203	2	58	0	7273
184	16	46	11	7241	0	7314
185	17	13	7112	41	0	7183
186	10	7002	33	29	0	7074
187	6652	29	8	18	0	6707
188	34	7	6681	9	0	6731
189	10	12	6542	3	0	6567
190	7	6439	25	14	0	6485
191	46	58	23	6223	0	6350
192	11	6	6098	20	0	6135
193	18	5027	22	18	0	5085
194	14	18	8	5509	0	5549
195	12	8	2	5604	0	5626
196	5521	6	1	22	0	5550
197	16	5570	6	14	0	5606
198	7	20	5260	7	0	5294
199	7	7	5349	10	0	5373
200	8	10	15	5347	0	5380
201	15	6	7	6449	0	6477
202	11	7	3	6559	0	6580
203	8	7446	8	82	0	7544
204	6	91	7651	39	0	7787
205	21	43	92	7948	0	8104
206	6	8143	39	106	0	8294
207	7	8578	17	51	0	8653
208	5	149	8998	17	0	9169
209	18	58	132	8800	0	9008
210	3	25	9816	137	0	9981
211	20	16	167	9728	0	9931
212	24	8	71	10071	0	10174
213	7	15	9958	222	0	10202
214	9	9899	157	106	0	10171
215	9794	159	78	50	0	10081
216	171	73	9932	29	0	10205
217	65	9916	149	51	0	10181
218	21	10245	82	23	0	10371
219	16	229	9924	22	0	10191
220	9746	90	173	43	0	10052
221	178	49	91	9412	0	9730
222	71	9927	37	161	0	10196
223	9896	184	33	81	0	10194
224	185	87	37	9588	0	9897
225	86	9794	25	175	0	10080
226	9865	180	31	99	0	10175
227	173	90	9728	46	0	10037
228	84	9763	175	34	0	10056
229	9579	187	94	43	0	9903
230	167	9704	47	30	0	9948
231	9600	191	36	41	0	9868
232	198	107	38	9364	0	9707
233	87	9426	40	166	0	9719
234	51	189	26	9506	0	9772
235	9385	94	44	212	0	9735
236	178	51	9317	113	0	9659
237	94	47	9404	61	0	9606
238	64	52	247	9189	0	9552
239	48	51	115	9361	0	9575
240	61	61	51	9216	0	9389
241	33	9096	66	257	0	9452
242	32	196	9005	115	0	9348
243	49	113	170	8746	0	9078
244	29	8718	99	192	0	9038
245	43	9108	46	101	0	9298
246	52	218	9006	54	0	9330
247	36	120	8980	45	0	9181
248	48	72	9211	45	0	9376
249	52	60	266	9007	0	9385
250	36	69	9225	187	0	9517
251	59	51	210	9202	0	9522
252	36	50	9422	209	0	9717
253	8943	60	231	114	0	9348
254	207	9743	106	76	0	10132
255	94	10500	66	65	0	10725
256	63	314	10862	56	0	11295
257	10675	128	254	64	0	11121
258	10994	70	118	64	0	11246
259	10997	67	74	65	0	11203
260	334	61	10549	67	0	11011
261	129	52	10782	77	0	11040
262	90	42	344	10580	0	11056
263	10677	60	159	285	0	11181
264	10701	69	99	145	0	11014
265	306	63	10401	108	0	10878
266	10383	84	278	87	0	10832
267	294	89	156	10260	0	10799
268	140	76	10381	273	0	10870
269	92	75	10471	129	0	10767
270	10044	69	386	107	0	10606
271	255	61	10443	99	0	10858
272	10275	49	350	96	0	10770
273	293	47	10449	95	0	10884
274	147	10062	332	112	0	10653
275	97	10560	189	74	0	10920
276	89	338	137	10136	0	10700
277	94	173	116	10593	0	10976
278	87	112	10337	345	0	10881
279	107	113	321	10138	0	10679
280	99	9976	200	297	0	10572
281	109	10205	146	153	0	10613
282	115	10540	105	109	0	10869
283	119	367	131	10225	0	10842
284	118	170	10248	273	0	10809
285	110	104	10371	142	0	10727
286	119	111	378	10073	0	10681
287	128	87	178	10265	0	10658
288	120	69	134	9860	0	10183
289	105	10118	109	320	0	10652
290	10149	292	101	153	0	10695
291	10188	143	96	121	0	10548
292	374	10106	93	100	0	10673
293	178	282	10157	85	0	10702
294	10231	155	311	90	0	10787
295	333	101	10362	86	0	10882
296	10232	66	333	91	0	10722
297	10377	92	169	85	0	10723
298	10296	75	132	119	0	10622
299	10103	60	115	114	0	10392
300	364	9963	118	126	0	10571
301	8818	213	74	95	0	9200
302	242	8794	74	99	0	9209
303	7729	185	59	57	0	8030
304	199	7560	65	49	0	7873
305	99	171	7071	38	0	7379
306	77	543	182	6148	0	6950
307	53	6588	96	129	0	6866
308	48	6376	59	52	0	6535
309	5917	200	201	101	0	6419
310	5397	37	35	37	0	5506
311	123	5557	23	26	0	5729
312	60	96	28	5345	0	5529
313	47	5573	27	330	0	5977
314	5876	97	27	35	0	6035
315	125	23	5898	29	0	6075
316	55	34	119	5739	0	5947
317	48	17	39	5798	0	5902
318	52	22	37	5843	0	5954
319	37	21	5798	113	0	5969
320	40	5705	109	34	0	5888
321	40	5948	33	22	0	6043
322	50	118	27	6023	0	6218
323	41	42	6082	96	0	6261
324	45	46	102	6009	0	6202
325	39	32	37	6157	0	6265
326	36	28	29	6086	0	6179
327	21	30	28	6088	0	6167
328	5914	33	48	142	0	6137
329	104	5990	18	61	0	6173
330	5973	111	34	48	0	6166
331	115	45	5977	41	0	6178
332	32	53	6065	21	0	6171
333	46	30	105	5917	0	6098
334	34	31	47	6022	0	6134
335	24	6086	40	137	0	6287
336	19	107	6156	65	0	6347
337	30	6207	113	58	0	6408
338	21	114	6260	47	0	6442
339	6008	34	110	42	0	6194
340	108	6310	33	38	0	6489
341	43	126	6331	26	0	6526
342	47	37	106	6276	0	6466
343	35	38	6344	110	0	6527
344	31	6338	112	36	0	6517
345	31	112	40	6169	0	6352
346	42	6321	29	117	0	6509
347	42	109	6319	39	0	6509
348	60	31	94	6193	0	6378
349	6184	48	18	115	0	6365
350	125	6117	23	33	0	6298
351	47	109	5987	24	0	6167
352	42	149	95	5623	0	5909
353	35	33	5784	83	0	5935
354	17	32	5110	18	0	5177
355	21	4682	76	20	0	4799
356	45	39	32	4132	0	4248
357	8	11	11	4155	0	4185
358	9	16	6	4098	0	4129
359	7	3	4155	39	0	4204
360	7	3	4126	11	0	4147
361	3865	10	31	16	0	3922
362	29	5	4070	6	0	4110
363	3830	3	30	11	0	3874
364	31	3970	8	6	0	4015
365	8	29	5	3891	0	3933
366	5	4005	6	26	0	4042
367	3	4114	3	12	0	4132
368	1	30	4052	14	0	4097
369	7	14	29	4017	0	4067
370	5	4	4076	37	0	4122
371	6	4	3857	11	0	3878
372	3824	2	31	11	0	3868
373	27	5	3968	11	0	4011
374	4	3	3889	11	0	3907
375	3740	5	31	12	0	3788
376	25	10	3895	8	0	3938
377	11	6	3968	8	0	3993
378	6	6	22	3842	0	3876
379	5	3988	14	22	0	4029
380	2	26	10	4034	0	4072
381	9	5	5	3972	0	3991
382	4033	7	8	30	0	4078
383	27	6	8	3996	0	4037
384	12	4106	7	28	0	4153
385	4052	30	14	13	0	4109
386	30	8	4052	16	0	4106
387	3929	10	35	15	0	3989
388	30	13	4324	6	0	4373
389	8	8	4419	10	0	4445
390	6	4568	41	12	0	4627
391	4150	43	17	486	0	4696
392	34	4698	10	20	0	4762
393	9	45	4725	8	0	4787
394	11	12	47	4445	0	4515
395	9	4762	12	37	0	4820
396	4821	42	13	18	0	4894
397	4842	15	12	9	0	4878
398	48	4853	12	11	0	4924
399	4939	50	11	11	0	5011
400	54	11	13	4808	0	4886
401	8	4898	10	50	0	4966
402	13	46	12	5064	0	5135
403	10	14	6	5333	0	5363
404	5428	11	10	61	0	5510
405	5356	11	6	21	0	5394
406	5346	6	11	12	0	5375
407	58	13	5315	9	0	5395
408	5236	6	51	9	0	5302
409	66	18	18	5360	0	5462
410	16	14	5350	50	0	5430
411	19	6	5043	14	0	5082
412	7	5053	44	18	0	5122
413	4626	44	23	8	0	4701
414	41	4747	8	6	0	4802
415	18	35	8	4795	0	4856
416	8	14	8	4849	0	4879
417	10	7	4908	44	0	4969
418	13	11	41	4776	0	4841
419	6	4	4903	40	0	4953
420	10	1	4767	9	0	4787
421	3	4924	35	9	0	4971
422	8	32	10	4758	0	4808
423	9	7	5	4762	0	4783
424	4749	4	5	39	0	4797
425	32	5	4760	8	0	4805
426	10	3	31	4802	0	4846
427	4849	2	6	39	0	4896
428	47	1	4862	9	0	4919
429	4777	3	33	11	0	4824
430	4902	2	11	8	0	4923
431	38	4	5053	6	0	5101
432	16	6	36	4977	0	5035
433	19	5	8	5054	0	5086
434	7	4	5156	36	0	5203
435	5020	4	33	22	0	5079
436	5174	4	12	14	0	5204
437	5032	6	13	14	0	5065
438	5089	4	13	11	0	5117
439	5042	9	11	12	0	5074
440	59	18	4234	19	0	4330
441	17	13	5060	12	0	5102
442	13	5087	34	12	0	5146
443	18	31	5127	15	0	5191
444	18	25	38	5017	0	5098
445	48	10	41	3703	0	3802
446	18	14	9	5160	0	5201
447	23	17	6	5179	0	5225
448	27	4	5199	45	0	5275
449	23	5075	32	19	0	5149
450	18	5329	15	15	0	5377
451	23	41	8	5217	0	5289
452	15	5403	13	40	0	5471
453	5420	47	6	16	0	5489
454	5446	14	10	19	0	5489
455	51	5662	8	21	0	5742
456	30	39	11	5664	0	5744
457	25	12	9	5758	0	5804
458	21	9	5746	54	0	5830
459	5335	5	54	30	0	5424
460	5726	7	23	23	0	5779
461	54	5845	13	19	0	5931
462	5889	45	16	20	0	5970
463	61	17	6007	17	0	6102
464	25	5908	48	24	0	6005
465	27	6136	19	15	0	6197
466	18	6166	16	21	0	6221
467	16	61	18	6117	0	6212
468	6053	17	21	71	0	6162
469	63	15	20	6127	0	6225
470	28	16	6260	75	0	6379
471	30	7	67	6281	0	6385
472	18	14	6493	76	0	6601
473	19	15	82	6307	0	6423
474	20	14	30	6276	0	6340
475	11	6426	24	79	0	6540
476	6557	62	22	36	0	6677
477	75	21	27	6404	0	6527
478	33	6495	10	79	0	6617
479	6554	64	13	37	0	6668
480	5760	25	29	53	0	5867
481	6563	19	19	35	0	6636
482	88	6513	21	28	0	6650
483	34	57	6550	21	0	6662
484	28	23	63	6508	0	6622
485	33	35	28	6321	0	6417
486	22	6498	25	81	0	6626
487	40	59	6464	32	0	6595
488	24	17	6266	35	0	6342
489	6067	18	67	22	0	6174
490	74	44	28	6078	0	6224
491	20	10	6203	54	0	6287
492	23	6337	50	34	0	6444
493	28	53	19	6130	0	6230
494	13	6360	22	50	0	6445
495	26	54	6291	24	0	6395
496	6013	20	50	32	0	6115
497	6229	15	27	16	0	6287
498	65	6240	13	25	0	6343
499	33	45	17	6191	0	6286
500	20	24	6193	51	0	6288
501	23	6097	51	19	0	6190
502	5960	51	16	32	0	6059
503	50	5747	16	16	0	5829
504	13	5728	6	13	0	5760
505	31	59	14	5636	0	5740
506	10	5684	6	46	0	5746
507	5658	50	5	20	0	5733
508	48	24	5	5637	0	5714
509	16	18	5492	41	0	5567
510	17	9	5257	18	0	5301
511	14	13	48	5329	0	5404
512	8	5380	21	37	0	5446
513	5412	42	12	27	0	5493
514	47	14	8	5282	0	5351
515	17	16	5212	43	0	5288
516	18	3	51	5179	0	5251
517	10	9	19	5168	0	5206
518	5109	10	7	62	0	5188
519	47	7	4	5099	0	5157
520	14	8	5006	49	0	5077
521	16	6	4949	15	0	4986
522	12	5	46	5057	0	5120
523	11	11	23	5151	0	5196
524	6	3	5213	54	0	5276
525	4709	8	44	35	0	4796
526	46	14	5114	10	0	5184
527	20	5138	50	11	0	5219
528	17	42	13	5220	0	5292
529	10	16	5216	54	0	5296
530	13	11	5149	20	0	5193
531	7	12	51	5032	0	5102
532	5062	8	26	54	0	5150
533	48	9	5145	20	0	5222
534	16	5134	43	18	0	5211
535	5199	47	17	11	0	5274
536	51	14	5240	10	0	5315
537	5090	13	45	24	0	5172
538	5253	6	17	16	0	5292
539	59	5425	15	13	0	5512
540	27	46	12	5250	0	5335
541	20	5369	5	47	0	5441
542	6	50	5380	19	0	5455
543	5352	19	50	15	0	5436
544	5660	11	21	21	0	5713
545	57	10	5689	9	0	5765
546	30	6	5573	9	0	5618
547	16	5819	64	11	0	5910
548	5940	60	26	14	0	6040
549	65	17	15	5928	0	6025
550	23	12	13	5684	0	5732
551	19	5816	12	56	0	5903
552	5753	52	7	38	0	5850
553	56	18	5922	18	0	6014
554	26	18	54	6432	0	6530
555	6593	10	18	97	0	6718
556	103	6693	15	23	0	6834
557	32	111	7370	11	0	7524
558	26	21	7544	9	0	7600
559	18	52	160	7343	0	7573
560	11	7668	36	139	0	7854
561	5	151	7786	26	0	7968
562	18	33	156	7734	0	7941
563	7841	20	36	164	0	8061
564	160	15	8059	29	0	8263
565	35	24	166	8071	0	8296
566	25	8	8191	156	0	8380
567	11	7	8383	34	0	8435
568	39	31	199	8227	0	8496
569	15	7	8439	151	0	8612
570	7524	7	163	54	0	7748
571	151	10	8194	19	0	8374
572	7781	9	149	20	0	7959
573	157	8072	46	9	0	8284
574	8268	146	21	17	0	8452
575	157	8452	17	8	0	8634
576	51	156	19	8449	0	8675
577	27	34	12	8782	0	8855
578	21	20	8643	175	0	8859
579	16	11	8756	52	0	8835
580	17	7	194	8810	0	9028
581	20	10	8918	170	0	9118
582	21	7	184	8574	0	8786
583	8	8635	68	169	0	8880
584	25	8995	30	57	0	9107
585	17	202	26	8811	0	9056
586	28	45	20	8968	0	9061
587	8	42	8756	198	0	9004
588	26	18	160	8649	0	8853
589	9	8515	54	179	0	8757
590	10	8568	39	66	0	8683
591	12	8719	31	39	0	8801
592	22	187	28	8204	0	8441
593	8	8299	34	180	0	8521
594	8243	167	21	56	0	8487
595	169	51	29	8228	0	8477
596	40	34	8185	177	0	8436
597	32	23	169	8148	0	8372
598	17	20	8265	190	0	8492
599	20	21	8235	56	0	8332
600	15	15	8308	42	0	8380
601	14	8206	192	36	0	8448
602	11	171	8330	30	0	8542
603	8220	44	189	32	0	8485
604	8368	36	58	31	0	8493
605	8515	31	44	31	0	8621
606	204	19	33	8405	0	8661
607	8383	16	40	183	0	8622
608	180	8168	41	58	0	8447
609	51	8605	28	54	0	8738
610	8540	187	42	42	0	8811
611	175	48	8674	37	0	8934
612	52	39	188	8674	0	8953
613	37	35	8815	178	0	9065
614	86	22	8782	55	0	8945
615	27	8862	195	41	0	9125
616	38	171	73	8423	0	8705
617	28	51	47	9006	0	9132
618	8859	37	32	208	0	9136
619	170	8861	30	69	0	9130
620	56	9090	32	56	0	9234
621	41	194	8952	57	0	9244
622	40	9137	162	40	0	9379
623	9026	203	75	34	0	9338
624	9058	66	56	52	0	9232
625	202	45	9128	37	0	9412
626	60	35	9197	52	0	9344
627	51	34	237	8811	0	9133
628	38	36	99	8871	0	9044
629	35	8870	82	198	0	9185
630	39	183	50	8864	0	9136
631	40	56	66	8916	0	9078
632	42	8813	56	210	0	9121
633	46	168	56	8796	0	9066
634	27	65	65	8608	0	8765
635	37	8492	65	220	0	8814
636	35	174	8507	83	0	8799
637	40	56	211	8616	0	8923
638	8619	50	76	205	0	8950
639	8538	33	65	72	0	8708
640	219	50	8377	51	0	8697
641	8152	53	179	61	0	8445
642	8411	45	62	70	0	8588
643	204	8324	46	68	0	8642
644	65	177	8054	53	0	8349
645	32	54	8092	78	0	8256
646	32	67	209	8311	0	8619
647	8343	42	94	197	0	8676
648	8654	37	70	83	0	8844
649	200	37	46	8912	0	9195
650	9277	36	48	211	0	9572
651	9557	44	38	85	0	9724
652	9336	40	41	85	0	9502
653	233	48	9064	60	0	9405
654	76	30	8826	39	0	8971
655	8518	22	136	53	0	8729
656	126	34	8568	40	0	8768
657	42	7870	91	15	0	8018
658	62	80	103	7688	0	7933
659	22	25	7962	68	0	8077
660	18	20	7782	40	0	7860
661	22	54	97	7525	0	7698
662	15	6	7686	64	0	7771
663	13	11	7494	30	0	7548
664	9	6915	84	24	0	7032
665	7	7351	35	5	0	7398
666	7430	64	23	16	0	7533
667	81	27	9	7286	0	7403
668	7329	10	12	60	0	7411
669	68	5	7284	17	0	7374
670	30	7	56	7239	0	7332
671	21	11	16	7394	0	7442
672	7330	8	14	79	0	7431
673	59	7373	8	35	0	7475
674	32	55	6887	18	0	6992
675	19	41	7072	6	0	7138
676	7	7314	73	16	0	7410
677	10	53	7202	12	0	7277
678	13	7164	61	12	0	7250
679	14	6789	17	5	0	6825
680	15	61	6895	13	0	6984
681	6689	19	56	9	0	6773
682	56	17	21	7021	0	7115
683	19	7119	10	45	0	7193
684	16	55	11	7112	0	7194
685	7128	18	3	65	0	7214
686	7062	10	7	22	0	7101
687	7065	3	14	15	0	7097
688	71	9	7022	9	0	7111
689	31	8	47	6905	0	6991
690	19	7053	23	49	0	7144
691	7375	51	14	25	0	7465
692	68	18	7	7433	0	7526
693	32	13	11	7297	0	7353
694	32	2	7	7591	0	7632
695	15	7	7522	76	0	7620
696	7022	11	52	29	0	7114
697	57	7540	23	17	0	7637
698	28	51	15	7552	0	7646
699	23	22	8	7613	0	7666
700	7570	15	14	78	0	7677
701	62	13	7211	31	0	7317
702	19	4	7637	20	0	7680
703	21	7688	75	19	0	7803
704	14	61	7951	11	0	8037
705	7535	23	84	28	0	7670
706	63	7923	24	16	0	8026
707	28	72	7996	14	0	8110
708	7639	23	70	22	0	7754
709	79	18	8369	16	0	8482
710	25	8445	79	19	0	8568
711	29	69	33	8455	0	8586
712	20	27	18	8556	0	8621
713	19	22	8410	83	0	8534
714	28	8	8176	32	0	8244
715	16	8262	83	32	0	8393
716	8238	75	39	17	0	8369
717	71	8485	25	16	0	8597
718	27	86	19	8505	0	8637
719	23	28	8449	71	0	8571
720	7908	16	83	40	0	8047
721	71	29	27	8252	0	8379
722	26	8077	32	70	0	8205
723	26	8420	24	29	0	8499
724	18	85	11	8433	0	8547
725	15	37	16	8480	0	8548
726	8410	24	16	94	0	8544
727	79	16	10	8513	0	8618
728	34	20	8531	83	0	8668
729	8361	12	72	38	0	8483
730	8628	11	29	52	0	8720
731	96	18	8704	23	0	8841
732	8566	18	81	32	0	8697
733	91	10	28	8936	0	9065
734	37	19	20	9019	0	9095
735	37	15	16	9055	0	9123
736	35	13	17	8910	0	8975
737	12	9058	25	113	0	9208
738	9362	90	19	44	0	9515
739	9655	26	12	37	0	9730
740	111	16	9900	35	0	10062
741	10145	19	81	37	0	10282
742	10717	12	30	40	0	10799
743	10869	13	27	31	0	10940
744	11188	10	22	29	0	11249
745	194	11072	20	17	0	11303
746	53	126	11	10772	0	10962
747	39	25	10803	114	0	10981
748	42	26	10303	32	0	10403
749	9720	64	187	45	0	10016
750	9850	15	96	19	0	9980
751	141	9620	21	26	0	9808
752	9706	102	14	17	0	9839
753	142	9754	9	16	0	9921
754	68	114	10	9788	0	9980
755	9937	36	10	127	0	10110
756	9942	15	7	56	0	10020
757	9857	16	13	29	0	9915
758	145	9770	16	27	0	9958
759	9778	99	11	21	0	9909
760	141	38	8	9820	0	10007
761	10000	17	8	115	0	10140
762	141	25	9811	31	0	10008
763	55	9830	104	25	0	10014
764	9825	108	31	27	0	9991
765	137	36	9846	12	0	10031
766	73	26	101	9758	0	9958
767	53	22	9922	108	0	10105
768	35	19	9852	34	0	9940
769	36	14	137	9765	0	9952
770	32	15	9986	117	0	10150
771	42	7	123	9903	0	10075
772	42	16	39	10010	0	10107
773	10143	23	20	154	0	10340
774	131	10100	26	45	0	10302
775	48	10254	22	34	0	10358
776	34	10344	24	28	0	10430
777	33	138	10327	23	0	10521
778	45	47	131	10265	0	10488
779	29	22	10472	135	0	10658
780	10006	22	135	56	0	10219
781	10357	11	46	51	0	10465
782	144	10397	25	28	0	10594
783	69	119	18	10225	0	10431
784	40	10446	15	123	0	10624
785	10498	139	13	49	0	10699
786	141	55	20	10486	0	10702
787	49	27	10483	130	0	10689
788	32	10400	124	55	0	10611
789	30	131	10573	34	0	10768
790	36	37	130	10507	0	10710
791	34	26	10430	129	0	10619
792	10019	27	135	60	0	10241
793	149	21	10387	33	0	10590
794	46	10413	129	37	0	10625
795	46	128	46	10359	0	10579
796	43	41	27	10571	0	10682
797	10415	25	41	156	0	10637
798	10453	26	31	62	0	10572
799	148	10333	42	35	0	10558
800	55	114	10247	38	0	10454
801	40	51	10166	28	0	10285
802	10045	31	148	33	0	10257
803	147	28	10171	24	0	10370
804	51	32	9856	29	0	9968
805	46	25	9885	26	0	9982
806	41	21	9832	33	0	9927
807	41	9814	159	30	0	10044
808	9857	119	69	41	0	10086
809	141	56	41	9567	0	9805
810	9530	29	40	134	0	9733
811	137	9452	39	41	0	9669
812	9441	123	39	39	0	9642
813	144	9679	40	31	0	9894
814	76	139	46	9633	0	9894
815	45	10114	37	122	0	10318
816	36	142	10065	46	0	10289
817	36	10360	133	30	0	10559
818	49	136	54	10944	0	11183
819	11012	56	32	153	0	11253
820	168	32	32	10989	0	11221
821	74	47	10988	148	0	11257
822	62	31	138	10695	0	10926
823	36	10966	66	143	0	11211
824	36	147	10973	64	0	11220
825	10948	54	159	51	0	11212
826	158	44	60	11197	0	11459
827	10992	42	46	160	0	11240
828	11092	27	49	78	0	11246
829	185	11114	34	53	0	11386
830	10804	143	42	56	0	11045
831	11130	54	53	59	0	11296
832	179	11109	44	41	0	11373
833	81	142	49	11076	0	11348
834	55	59	46	11042	0	11202
835	52	11028	42	171	0	11293
836	53	162	35	11117	0	11367
837	51	60	10917	158	0	11186
838	61	74	141	10634	0	10910
839	47	34	10461	155	0	10697
840	41	31	9709	58	0	9839
841	32	9588	148	51	0	9819
842	34	9428	47	44	0	9553
843	32	9554	48	36	0	9670
844	75	120	55	9093	0	9343
845	23	41	9206	104	0	9374
846	8996	24	98	54	0	9172
847	100	16	37	9219	0	9372
848	29	26	9188	88	0	9331
849	21	26	9153	40	0	9240
850	20	9282	102	24	0	9428
851	24	98	41	9159	0	9322
852	9074	38	32	90	0	9234
853	87	8950	27	37	0	9101
854	29	8880	19	34	0	8962
855	31	8852	17	31	0	8931
856	25	117	30	8866	0	9038
857	20	9108	20	88	0	9236
858	28	102	23	9622	0	9775
859	34	33	25	9825	0	9917
860	27	33	9665	134	0	9859
861	8958	28	117	77	0	9180
862	112	37	9812	29	0	9990
863	36	50	114	9893	0	10093
864	15	34	9946	118	0	10113
865	20	9832	112	56	0	10020
866	9837	124	52	41	0	10054
867	127	50	32	9674	0	9883
868	51	35	25	9793	0	9904
869	9704	19	33	138	0	9894
870	9604	25	23	59	0	9711
871	9819	16	22	47	0	9904
872	135	18	9714	41	0	9908
873	9206	14	102	28	0	9350
874	112	9332	31	24	0	9499
875	48	9361	21	29	0	9459
876	38	110	21	9107	0	9276
877	37	43	18	8945	0	9043
878	26	8980	10	124	0	9140
879	37	106	17	8971	0	9131
880	8929	36	16	124	0	9105
881	106	29	8916	58	0	9109
882	39	8862	103	27	0	9031
883	8606	101	31	54	0	8792
884	100	8783	25	40	0	8948
885	31	105	8711	35	0	8882
886	44	57	95	8675	0	8871
887	24	33	8670	107	0	8834
888	21	8586	105	39	0	8751
889	23	104	46	8508	0	8681
890	26	41	8490	105	0	8662
891	25	39	8492	45	0	8601
892	25	33	113	8529	0	8700
893	8484	17	44	117	0	8662
894	8510	19	42	42	0	8613
895	8517	39	21	31	0	8608
896	125	22	8538	33	0	8718
897	49	8533	96	25	0	8703
898	35	101	45	8515	0	8696
899	23	44	27	8368	0	8462
900	27	8509	25	116	0	8677
901	8458	102	17	64	0	8641
902	102	45	21	8443	0	8611
903	44	24	8420	116	0	8604
904	28	8398	107	51	0	8584
905	8214	99	42	48	0	8403
906	101	8292	38	45	0	8476
907	45	108	33	8148	0	8334
908	43	54	25	8199	0	8321
909	31	33	33	8256	0	8353
910	26	41	8151	129	0	8347
911	38	31	100	7945	0	8114
912	28	7910	47	119	0	8104
913	29	7847	29	62	0	7967
914	39	99	7551	48	0	7737
915	7034	44	101	50	0	7229
916	7290	25	49	53	0	7417
917	124	7065	25	35	0	7249
918	6388	78	36	28	0	6530
919	6380	27	14	34	0	6455
920	98	6568	27	82	0	6775
921	48	95	13	6680	0	6836
922	33	31	6942	93	0	7099
923	34	29	6759	38	0	6860
924	6828	31	99	35	0	6993
925	96	6947	31	30	0	7104
926	34	102	26	6861	0	7023
927	28	37	23	6923	0	7011
928	41	27	15	6911	0	6994
929	6798	23	21	137	0	6979
930	115	31	22	6797	0	6965
931	60	19	24	6807	0	6910
932	27	28	6589	127	0	6771
933	6283	29	94	46	0	6452
934	93	6529	38	35	0	6695
935	6459	99	27	33	0	6618
936	101	6408	23	30	0	6562
937	41	105	26	6391	0	6563
938	6418	34	23	112	0	6587
939	6521	28	22	44	0	6615
940	113	26	6420	35	0	6594
941	6616	23	93	38	0	6770
942	117	21	6700	32	0	6870
943	52	16	6494	28	0	6590
944	33	23	6514	23	0	6593
945	37	17	6853	33	0	6940
946	31	40	134	7011	0	7216
947	22	24	7060	129	0	7235
948	28	26	126	6996	0	7176
949	6996	19	44	138	0	7197
950	130	26	26	6974	0	7156
951	6868	21	26	150	0	7065
952	122	6897	30	58	0	7107
953	52	134	29	6881	0	7096
954	28	37	6813	143	0	7021
955	31	7085	108	52	0	7276
956	48	187	30	6860	0	7125
957	29	28	6894	134	0	7085
958	12	6490	103	35	0	6640
959	13	6496	26	29	0	6564
960	42	112	6364	12	0	6530
961	30	84	121	6061	0	6296
962	13	16	6063	92	0	6184
963	5736	7	93	24	0	5860
964	5913	6	20	20	0	5959
965	103	5868	14	13	0	5998
966	5871	85	11	15	0	5982
967	101	17	10	5895	0	6023
968	19	9	5837	100	0	5965
969	5675	7	99	24	0	5805
970	96	7	5777	23	0	5903
971	19	5745	99	8	0	5871
972	5881	94	36	17	0	6028
973	105	21	14	5892	0	6032
974	18	11	5916	96	0	6041
975	5842	7	98	29	0	5976
976	5862	9	22	24	0	5917
977	5939	9	20	14	0	5982
978	124	7	12	5806	0	5949
979	35	8	14	5934	0	5991
980	26	13	5874	103	0	6016
981	18	5848	87	28	0	5981
982	12	94	25	5829	0	5960
983	14	21	20	5965	0	6020
984	13	15	5881	111	0	6020
985	11	13	5864	33	0	5921
986	19	8	117	5836	0	5980
987	5794	10	30	110	0	5944
988	94	5815	22	28	0	5959
989	5827	96	20	23	0	5966
990	99	5846	18	24	0	5987
991	28	102	5888	19	0	6037
992	28	22	5972	18	0	6040
993	5819	17	110	26	0	5972
994	6238	13	32	20	0	6303
995	118	6186	19	34	0	6357
996	38	98	6061	21	0	6218
997	36	29	105	6029	0	6199
998	29	23	38	5959	0	6049
999	22	6097	30	124	0	6273
1000	29	102	18	6159	0	6308
1001	22	32	6176	121	0	6351
1002	6033	24	109	48	0	6214
1003	6278	15	37	37	0	6367
1004	6235	16	32	28	0	6311
1005	6426	14	27	15	0	6482
1006	155	16	6258	20	0	6449
1007	6209	17	114	19	0	6359
1008	127	11	6280	22	0	6440
1009	41	6274	129	25	0	6469
1010	41	111	52	6369	0	6573
1011	6511	28	30	113	0	6682
1012	124	29	26	6840	0	7019
1013	50	17	6899	139	0	7105
1014	6837	16	125	57	0	7035
1015	7092	18	49	50	0	7209
1016	171	20	33	6986	0	7210
1017	71	24	27	7129	0	7251
1018	43	20	6991	163	0	7217
1019	40	7028	127	56	0	7251
1020	6734	119	45	44	0	6942
1021	130	37	6459	23	0	6649
1022	6302	20	115	21	0	6458
1023	142	6438	45	25	0	6650
1024	6450	108	36	21	0	6615
1025	140	6290	30	16	0	6476
1026	60	6299	16	28	0	6403
1027	41	123	25	6396	0	6585
1028	38	50	23	6558	0	6669
1029	35	26	16	6614	0	6691
1030	31	21	27	6618	0	6697
1031	40	13	6470	141	0	6664
1032	6297	17	110	70	0	6494
1033	6532	12	41	51	0	6636
1034	6661	13	22	38	0	6734
1035	152	16	27	6525	0	6720
1036	75	13	27	6603	0	6718
1037	6600	15	21	138	0	6774
1038	6627	13	28	51	0	6719
1039	6654	22	16	42	0	6734
1040	168	23	14	6437	0	6642
1041	74	23	22	6277	0	6396
1042	47	18	6080	122	0	6267
1043	35	17	5863	56	0	5971
1044	35	5966	102	43	0	6146
1045	5413	115	120	53	0	5701
1046	5402	33	41	27	0	5503
1047	5457	16	11	42	0	5526
1048	101	15	5619	15	0	5750
1049	5550	9	66	23	0	5648
1050	5714	7	29	18	0	5768
1051	5784	7	22	19	0	5832
1052	117	8	9	5689	0	5823
1053	59	5	11	5686	0	5761
1054	49	6	13	5683	0	5751
1055	26	14	5125	92	0	5257
1056	4953	12	38	49	0	5052
1057	71	5161	17	34	0	5283
1058	4886	40	12	24	0	4962
1059	62	4776	10	20	0	4868
1060	33	4910	9	22	0	4974
1061	45	60	18	4855	0	4978
1062	47	32	14	4806	0	4899
1063	20	4784	8	62	0	4874
1064	4760	49	7	40	0	4856
1065	4752	21	10	35	0	4818
1066	73	18	8	4705	0	4804
1067	48	12	4723	48	0	4831
1068	37	8	4503	30	0	4578
1069	33	7	4721	28	0	4789
1070	28	7	4673	21	0	4729
1071	4542	19	78	22	0	4661
1072	4548	7	36	23	0	4614
1073	70	5	18	4471	0	4564
1074	46	10	4447	41	0	4544
1075	39	8	41	4498	0	4586
1076	23	4530	19	55	0	4627
1077	18	4955	16	37	0	5026
1078	5098	53	15	35	0	5201
1079	5107	35	11	21	0	5174
1080	5168	21	12	20	0	5221
1081	79	9	7	5120	0	5215
1082	50	11	10	5200	0	5271
1083	34	11	8	5199	0	5252
1084	30	6	11	5154	0	5201
1085	21	10	5177	73	0	5281
1086	29	5	39	5158	0	5231
1087	5401	8	23	65	0	5497
1088	63	10	19	5468	0	5560
1089	32	5	13	5541	0	5591
1090	26	10	15	5461	0	5512
1091	23	5257	15	81	0	5376
1092	17	5246	15	42	0	5320
1093	21	5344	8	29	0	5402
1094	32	59	6	5199	0	5296
1095	20	18	4	5240	0	5282
1096	5241	13	12	68	0	5334
1097	5216	10	8	46	0	5280
1098	5287	11	4	26	0	5328
1099	73	12	5	5228	0	5318
1100	31	13	6	5215	0	5265
1101	28	5182	7	67	0	5284
1102	25	5333	5	39	0	5402
1103	5290	44	2	32	0	5368
1104	55	22	5	5251	0	5333
1105	5271	9	6	56	0	5342
1106	5388	5	5	38	0	5436
1107	59	3	7	5345	0	5414
1108	29	5566	10	44	0	5649
1109	5655	37	4	27	0	5723
1110	5783	15	4	32	0	5834
1111	57	11	5890	18	0	5976
1112	5466	2	20	15	0	5503
1113	33	5546	11	7	0	5597
1114	15	24	4	5730	0	5773
1115	6216	11	2	51	0	6280
1116	34	5	1	6279	0	6319
1117	21	1	3	6297	0	6322
1118	15	6295	4	38	0	6352
1119	6292	27	1	26	0	6346
1120	6324	14	3	17	0	6358
1121	40	6269	1	17	0	6327
1122	19	6518	3	9	0	6549
1123	6541	34	6	11	0	6592
1124	6483	18	2	9	0	6512
1125	39	11	6344	5	0	6399
1126	25	11	5978	13	0	6027
1127	547	6	5852	8	0	6413
1128	12	3	34	6509	0	6558
1129	12	8	17	6580	0	6617
1130	8	5	6611	33	0	6657
1131	6485	2	26	28	0	6541
1132	6827	4	13	21	0	6865
1133	6873	2	10	4	0	6889
1134	6779	7	4	9	0	6799
1135	42	7	7280	7	0	7336
1136	7331	2	28	23	0	7384
1137	7448	4	33	19	0	7504
1138	7448	2	13	19	0	7482
1139	7606	2	6	9	0	7623
1140	7533	5	2	20	0	7560
1141	46	2	7644	10	0	7702
1142	21	7632	31	13	0	7697
1143	26	34	13	7568	0	7641
1144	20	16	8	7830	0	7874
1145	15	14	7773	44	0	7846
1146	7322	7	31	32	0	7392
1147	50	4	12	7604	0	7670
1148	29	6	7541	33	0	7609
1149	23	12	7149	17	0	7201
1150	16	7693	31	21	0	7761
1151	20	30	17	7823	0	7890
1152	19	16	14	7873	0	7922
1153	17	18	7	7819	0	7861
1154	7895	9	7	57	0	7968
1155	37	6	7	7886	0	7936
1156	25	4	7846	44	0	7919
1157	24	5	7200	32	0	7261
1158	24	5	8023	25	0	8077
1159	13	11	48	8291	0	8363
1160	8318	10	19	47	0	8394
1161	53	8	8353	15	0	8429
1162	8262	3	35	27	0	8327
1163	8949	7	20	35	0	9011
1164	55	8	19	9087	0	9169
1165	41	2	6	9162	0	9211
1166	29	9104	8	54	0	9195
1167	25	24	9237	29	0	9315
1168	9097	11	41	32	0	9181
1169	42	16	20	9456	0	9534
1170	27	9408	17	45	0	9497
1171	29	32	9	9531	0	9601
1172	21	15	9544	49	0	9629
1173	23	25	37	9383	0	9468
1174	20	9394	22	53	0	9489
1175	31	24	14	9365	0	9434
1176	9314	13	16	55	0	9398
1177	36	17	14	9064	0	9131
1178	22	8841	19	46	0	8928
1179	18	9000	15	29	0	9062
1180	8774	37	10	43	0	8864
1181	44	21	9011	27	0	9103
1182	32	19	33	8954	0	9038
1183	27	12	23	9162	0	9224
1184	28	6	9294	53	0	9381
1185	19	9280	41	37	0	9377
1186	16	31	9374	29	0	9450
1187	22	42	34	9101	0	9199
1188	11	9257	21	32	0	9321
1189	9423	26	18	42	0	9509
1190	33	9385	12	26	0	9456
1191	20	9482	4	24	0	9530
1192	9640	32	10	25	0	9707
1193	9718	18	18	38	0	9792
1194	9859	10	6	24	0	9899
1195	47	11	7	9940	0	10005
1196	21	5	10055	27	0	10108
1197	10186	7	24	38	0	10255
1198	10756	6	10	27	0	10799
1199	56	9	12	11115	0	11192
1200	32	10	11110	40	0	11192
1201	17	11028	40	24	0	11109
1202	11043	37	12	38	0	11130
1203	11291	19	8	44	0	11362
1204	51	11416	7	13	0	11487
1205	22	11656	6	15	0	11699
1206	11651	43	7	25	0	11726
1207	11643	18	3	32	0	11696
1208	11477	13	3	22	0	11515
1209	67	6	6	11396	0	11475
1210	27	9	11389	52	0	11477
1211	28	13	42	11088	0	11171
1212	13	11	11165	65	0	11254
1213	12	10940	49	26	0	11027
1214	13	11029	17	13	0	11072
1215	29	42	14	10383	0	10468
1216	18	14	6	10488	0	10526
1217	23	16	10	10328	0	10377
1218	13	10496	4	48	0	10561
1219	10435	36	4	30	0	10505
1220	10353	13	8	36	0	10410
1221	44	10506	6	10	0	10566
1222	27	43	4	10206	0	10280
1223	17	10256	8	46	0	10327
1224	18	47	2	10228	0	10295
1225	17	10302	5	42	0	10366
1226	10332	40	5	39	0	10416
1227	50	12	6	10233	0	10301
1228	12	12	10178	54	0	10256
1229	9947	9	46	23	0	10025
1230	10056	10	8	34	0	10108
1231	53	12	10002	13	0	10080
1232	29	10	39	9960	0	10038
1233	11	20	10082	49	0	10162
1234	15	18	39	10112	0	10184
1235	10	19	9654	49	0	9732
1236	9347	17	40	32	0	9436
1237	57	15	9	9405	0	9486
1238	19	9519	7	57	0	9602
1239	9764	45	7	30	0	9846
1240	64	22	2	9891	0	9979
1241	30	13	9	9853	0	9905
1242	19	24	9838	58	0	9939
1243	32	10	43	10320	0	10405
1244	11	11	10699	84	0	10805
1245	14	11	11067	27	0	11119
1246	29	9	102	11482	0	11622
1247	26	8	12253	95	0	12382
1248	12498	11	130	55	0	12694
1249	14108	13	29	39	0	14189
1250	14723	11	25	36	0	14795
1251	205	15397	11	32	0	15645
1252	105	176	19	15557	0	15857
1253	72	59	14	15193	0	15338
1254	27	15875	15	212	0	16129
1255	15851	195	17	99	0	16162
1256	207	65	12	15771	0	16055
1257	64	51	16047	201	0	16363
1258	57	23	15514	81	0	15675
1259	26	15554	224	72	0	15876
1260	15667	176	90	59	0	15992
1261	196	61	15614	39	0	15910
1262	15085	53	214	52	0	15404
1263	218	14834	79	44	0	15175
1264	79	193	14979	29	0	15280
1265	73	57	14193	33	0	14356
1266	39	50	14977	28	0	15094
1267	50	14705	254	31	0	15040
1268	52	202	14806	23	0	15083
1269	14527	58	226	48	0	14859
1270	247	60	83	14059	0	14449
1271	89	33	56	14872	0	15050
1272	76	32	24	14928	0	15060
1273	41	31	27	15058	0	15157
1274	43	26	11061	4079	0	15209
1275	50	21	159	14891	0	15121
1276	45	23	66	15047	0	15181
1277	14689	16	65	272	0	15042
1278	15068	25	50	137	0	15280
1279	14236	27	48	107	0	14418
1280	275	31	14658	54	0	15018
1281	120	14824	196	53	0	15193
1282	75	15381	88	47	0	15591
1283	14640	241	69	68	0	15018
1284	206	15007	45	48	0	15306
1285	103	251	50	14839	0	15243
1286	89	91	39	15132	0	15351
1287	52	70	14874	288	0	15284
1288	41	14728	231	145	0	15145
1289	40	224	14474	95	0	14833
1290	14429	73	244	84	0	14830
1291	14880	57	102	61	0	15100
1292	294	26	81	14668	0	15069
1293	126	31	52	14543	0	14752
1294	96	36	62	14545	0	14739
1295	74	26	53	14718	0	14871
1296	62	31	14439	327	0	14859
1297	73	56	228	14109	0	14466
1298	42	26	14121	281	0	14470
1299	46	20	13637	104	0	13807
1300	39	13687	257	107	0	14090
1301	13766	223	137	82	0	14208
1302	238	14009	64	84	0	14395
1303	95	278	57	13710	0	14140
1304	81	69	14128	257	0	14535
1305	13768	66	270	97	0	14201
1306	276	29	13941	87	0	14333
1307	13946	40	301	55	0	14342
1308	14235	36	98	58	0	14427
1309	367	38	73	14404	0	14882
1310	167	28	58	14391	0	14644
1311	108	35	54	14475	0	14672
1312	67	47	14081	387	0	14582
1313	13927	39	286	167	0	14419
1314	301	14004	106	112	0	14523
1315	133	272	87	14023	0	14515
1316	14089	86	51	334	0	14560
1317	14314	73	66	148	0	14601
1318	14348	57	56	116	0	14577
1319	428	81	13818	91	0	14418
1320	14215	61	292	100	0	14668
1321	14418	86	96	103	0	14703
1322	395	59	12531	144	0	13129
1323	174	51	14475	105	0	14805
1324	136	73	375	14347	0	14931
1325	130	38	14547	343	0	15058
1326	79	14032	404	148	0	14663
1327	94	14625	190	96	0	15005
1328	14250	374	147	87	0	14858
1329	346	14574	116	70	0	15106
1330	161	359	105	14558	0	15183
1331	14227	126	133	338	0	14824
1332	350	14632	82	137	0	15201
1333	125	358	100	14498	0	15081
1334	115	115	116	14731	0	15077
1335	80	82	14405	432	0	14999
1336	92	58	367	14424	0	14941
1337	96	67	14327	421	0	14911
1338	111	37	14347	185	0	14680
1339	111	33	370	13954	0	14468
1340	81	30	134	14222	0	14467
1341	13822	30	98	500	0	14450
1342	331	14430	88	249	0	15098
1343	135	309	79	13991	0	14514
1344	126	217	69	13829	0	14241
1345	13096	79	41	439	0	13655
1346	356	12577	48	192	0	13173
1347	152	11832	42	113	0	12139
1348	127	11187	39	72	0	11425
1349	46	9889	37	48	0	10020
1350	8381	223	283	45	0	8932
1351	8206	62	62	42	0	8372
1352	7902	40	13	30	0	7985
1353	7890	24	9	29	0	7952
1354	224	34	14	7656	0	7928
1355	59	24	7585	189	0	7857
1356	49	7510	172	48	0	7779
1357	35	169	37	7393	0	7634
1358	35	32	7336	188	0	7591
1359	40	43	172	7269	0	7524
1360	26	18	43	7397	0	7484
1361	26	15	7282	218	0	7541
1362	29	25	183	7271	0	7508
1363	27	25	60	7117	0	7229
1364	7261	21	33	228	0	7543
1365	7291	15	29	81	0	7416
1366	7229	13	24	55	0	7321
1367	7246	22	21	43	0	7332
1368	236	11	20	7034	0	7301
1369	75	22	25	7126	0	7248
1370	65	15	15	7139	0	7234
1371	6955	16	19	230	0	7220
1372	215	25	18	6969	0	7227
1373	68	23	21	7060	0	7172
1374	51	18	6763	240	0	7072
1375	55	45	171	6646	0	6917
1376	45	6512	35	217	0	6809
1377	51	6901	30	57	0	7039
1378	6561	185	27	62	0	6835
1379	206	41	6487	55	0	6789
1380	57	6262	167	40	0	6526
1381	6162	153	54	42	0	6411
1382	181	34	37	6149	0	6401
1383	51	31	6171	173	0	6426
1384	55	51	156	6048	0	6310
1385	34	6306	49	174	0	6563
1386	6255	169	41	60	0	6525
1387	173	6417	22	58	0	6670
1388	6342	169	22	54	0	6587
1389	6512	37	23	50	0	6622
1390	191	37	13	6427	0	6668
1391	72	33	16	6356	0	6477
1392	53	6363	12	184	0	6612
1393	6386	167	11	68	0	6632
1394	178	41	6325	48	0	6592
1395	6070	39	141	37	0	6287
1396	6030	25	30	36	0	6121
1397	185	16	5762	46	0	6009
1398	58	35	129	5460	0	5682
1399	5512	13	29	154	0	5708
1400	149	12	5450	52	0	5663
1401	50	16	5261	38	0	5365
1402	4920	23	125	37	0	5105
1403	116	4883	43	31	0	5073
1404	32	4652	25	27	0	4736
1405	71	121	41	4464	0	4697
1406	23	39	4502	101	0	4665
1407	4313	34	98	29	0	4474
1408	109	19	4342	27	0	4497
1409	30	3968	84	18	0	4100
1410	3960	82	29	22	0	4093
1411	98	32	17	3938	0	4085
1412	3950	17	14	94	0	4075
1413	101	11	3914	36	0	4062
1414	42	4	86	3836	0	3968
1415	29	3954	20	82	0	4085
1416	31	80	16	3932	0	4059
1417	24	26	12	4023	0	4085
1418	26	23	3977	102	0	4128
1419	27	3857	77	38	0	3999
1420	21	3878	24	35	0	3958
1421	22	78	3728	25	0	3853
1422	3482	26	79	22	0	3609
1423	3574	19	19	20	0	3632
1424	84	20	30	3488	0	3622
1425	3350	13	17	68	0	3448
1426	85	3227	6	27	0	3345
1427	27	3375	23	23	0	3448
1428	3398	73	14	31	0	3516
1429	83	33	16	3419	0	3551
1430	3466	17	14	72	0	3569
1431	3573	12	5	30	0	3620
1432	80	8	10	3424	0	3522
1433	37	16	3416	72	0	3541
1434	3397	9	67	22	0	3495
1435	3437	9	20	31	0	3497
1436	88	16	19	3358	0	3481
1437	43	3392	14	67	0	3516
1438	31	67	7	3399	0	3504
1439	18	23	3381	74	0	3496
1440	24	19	3345	27	0	3415
1441	24	3325	65	31	0	3445
1442	58	35	37	2566	0	2696
1443	5	12	12	2595	0	2624
1444	10	6	2579	30	0	2625
1445	2524	4	29	14	0	2571
1446	2637	4	7	12	0	2660
1447	2643	4	7	9	0	2663
1448	2645	5	5	9	0	2664
1449	47	2597	4	9	0	2657
1450	15	2683	5	9	0	2712
1451	2762	41	4	7	0	2814
1452	41	12	3	2838	0	2894
1453	12	8	3	2869	0	2892
1454	9	2877	5	49	0	2940
1455	9	43	6	2901	0	2959
1456	10	11	4	2885	0	2910
1457	7	2846	6	54	0	2913
1458	10	42	2862	16	0	2930
1459	10	15	40	2858	0	2923
1460	2869	8	12	45	0	2934
1461	2854	6	9	13	0	2882
1462	57	5	2776	10	0	2848
1463	17	5	2738	12	0	2772
1464	11	6	2779	7	0	2803
1465	15	8	44	2737	0	2804
1466	10	2	2760	48	0	2820
1467	8	2	2798	18	0	2826
1468	14	19	49	2740	0	2822
1469	22	2874	15	41	0	2952
1470	10	38	2935	17	0	3000
1471	6	2963	37	12	0	3018
1472	2941	39	19	10	0	3009
1473	45	2981	10	5	0	3041
1474	17	38	6	2961	0	3022
1475	2981	17	9	41	0	3048
1476	41	9	6	2979	0	3035
1477	19	5	8	3028	0	3060
1478	6	8	3038	54	0	3106
1479	14	2937	36	17	0	3004
1480	9	3016	15	14	0	3054
1481	11	46	10	2932	0	2999
1482	12	10	10	2920	0	2952
1483	13	9	4	2875	0	2901
1484	12	5	2782	47	0	2846
1485	9	5	2638	17	0	2669
1486	2546	5	42	14	0	2607
1487	34	7	2600	11	0	2652
1488	10	6	2670	6	0	2692
1489	9	2640	47	8	0	2704
1490	10	51	20	2640	0	2721
1491	4	13	2663	47	0	2727
1492	5	7	45	2613	0	2670
1493	2	7	2752	53	0	2814
1494	8	7	49	2734	0	2798
1495	7	3	2890	52	0	2952
1496	6	1	52	2864	0	2923
1497	6	4	14	2915	0	2939
1498	2	2927	13	56	0	2998
1499	5	46	7	2963	0	3021
1500	4	2981	10	50	0	3045
1501	5	49	13	3034	0	3101
1502	3	11	7	3073	0	3094
1503	2974	7	4	62	0	3047
1504	50	4	9	2968	0	3031
1505	9	4	2953	58	0	3024
1506	10	4	50	2934	0	2998
1507	5	3	13	2997	0	3018
1508	5	3	2916	60	0	2984
1509	6	4	2892	20	0	2922
1510	6	3	55	2849	0	2913
1511	4	9	15	2956	0	2984
1512	5	8	2911	63	0	2987
1513	4	2808	48	24	0	2884
1514	3	2936	9	22	0	2970
1515	2876	56	11	15	0	2958
1516	52	18	8	2913	0	2991
1517	2972	5	4	65	0	3046
1518	2927	4	14	22	0	2967
1519	54	2948	13	12	0	3027
1520	2986	48	8	15	0	3057
1521	3021	13	9	15	0	3058
1522	52	11	2976	9	0	3048
1523	17	5	49	2973	0	3044
1524	5	6	3055	58	0	3124
1525	9	8	56	3049	0	3122
1526	7	3	3048	60	0	3118
1527	6	2896	53	14	0	2969
1528	8	2969	17	14	0	3008
1529	19	58	10	2832	0	2919
1530	2815	14	9	45	0	2883
1531	43	8	6	2817	0	2874
1532	9	7	10	2834	0	2860
1533	13	0	2823	54	0	2890
1534	4	3	2801	23	0	2831
1535	6	6	2855	13	0	2880
1536	2	5	53	2829	0	2889
1537	4	9	16	2800	0	2829
1538	3	2807	12	48	0	2870
1539	2	2913	7	26	0	2948
1540	2840	50	7	17	0	2914
1541	36	2874	6	16	0	2932
1542	6	46	2829	17	0	2898
1543	13	11	42	2817	0	2883
1544	6	10	2961	47	0	3024
1545	3	2966	50	19	0	3038
1546	5	42	17	3009	0	3073
1547	2936	8	7	48	0	2999
1548	35	9	2989	16	0	3049
1549	9	3045	40	19	0	3113
1550	9	28	3032	14	0	3083
1551	1	2979	38	6	0	3024
1552	8	39	19	2843	0	2909
1553	2873	7	10	41	0	2931
1554	2858	10	6	13	0	2887
1555	24	2830	6	15	0	2875
1556	2877	27	5	13	0	2922
1557	36	6	5	2886	0	2933
1558	2892	10	6	32	0	2940
1559	29	9	2975	13	0	3026
1560	10	6	2996	11	0	3023
1561	12	5	28	2948	0	2993
1562	9	7	14	3114	0	3144
1563	9	2	3098	41	0	3150
1564	6	2	31	3140	0	3179
1565	3167	4	11	40	0	3222
1566	3151	6	12	10	0	3179
1567	33	3041	8	14	0	3096
1568	12	3060	5	11	0	3088
1569	2953	29	8	13	0	3003
1570	33	11	4	2909	0	2957
1571	2912	8	4	35	0	2959
1572	35	2906	5	12	0	2958
1573	2904	29	10	12	0	2955
1574	43	2	2854	12	0	2911
1575	9	8	2841	9	0	2867
1576	12	6	39	2877	0	2934
1577	4	7	2931	37	0	2979
1578	6	4	36	2868	0	2914
1579	9	2	6	2786	0	2803
1580	4	5	3016	38	0	3063
1581	5	11	32	3010	0	3058
1582	10	6	5	3156	0	3177
1583	14	4	3243	42	0	3303
1584	6	7	3232	5	0	3250
1585	3180	7	38	16	0	3241
1586	39	3	3347	9	0	3398
1587	3411	6	47	9	0	3473
1588	3629	1	7	11	0	3648
1589	45	6	3658	6	0	3715
1590	15	2	3742	2	0	3761
1591	15	21	48	3613	0	3697
1592	9	5	14	3625	0	3653
1593	5	3636	15	40	0	3696
1594	2	3729	14	17	0	3762
1595	4	33	3648	16	0	3701
1596	3527	9	36	12	0	3584
1597	3626	8	13	7	0	3654
1598	42	6	3595	7	0	3650
1599	17	6	3590	3	0	3616
1600	15	5	44	3535	0	3599
1601	10	3613	16	29	0	3668
1602	8	34	15	3735	0	3792
1603	10	11	8	3804	0	3833
1604	3794	9	8	42	0	3853
1605	3792	4	6	16	0	3818
1606	42	5	5	3900	0	3952
1607	17	5	3903	39	0	3964
1608	3744	3	40	16	0	3803
1609	38	3979	12	21	0	4050
1610	4052	36	9	10	0	4107
1611	4006	11	8	12	0	4037
1612	43	4014	9	10	0	4076
1613	17	4112	3	8	0	4140
1614	13	43	3	4097	0	4156
1615	11	19	3	4116	0	4149
1616	7	4091	5	37	0	4140
1617	12	36	6	4148	0	4202
1618	10	13	5	4192	0	4220
1619	11	9	4146	41	0	4207
1620	4036	4	42	20	0	4102
1621	4216	7	11	17	0	4251
1622	4250	8	10	14	0	4282
1623	49	8	7	4197	0	4261
1624	4132	2	7	47	0	4188
1625	46	4073	6	15	0	4140
1626	18	42	7	3991	0	4058
1627	13	3978	8	38	0	4037
1628	10	4190	9	16	0	4225
1629	4256	35	11	14	0	4316
1630	4273	12	4	15	0	4304
1631	4237	9	3	12	0	4261
1632	4234	9	7	12	0	4262
1633	4205	5	9	7	0	4226
1634	48	7	4269	5	0	4329
1635	4217	4	31	16	0	4268
1636	54	7	4391	7	0	4459
1637	4284	6	37	8	0	4335
1638	4357	6	13	9	0	4385
1639	4305	6	13	10	0	4334
1640	55	3	4540	11	0	4609
1641	21	15	36	4492	0	4564
1642	21	4680	12	32	0	4745
1643	4778	35	15	11	0	4839
1644	4699	13	9	16	0	4737
1645	45	4755	13	10	0	4823
1646	4853	36	7	19	0	4915
1647	49	15	8	4826	0	4898
1648	25	4904	10	38	0	4977
1649	4896	35	13	20	0	4964
1650	4916	11	11	19	0	4957
1651	60	15	6	4898	0	4979
1652	4981	9	9	48	0	5047
1653	53	8	10	5033	0	5104
1654	21	9	5	5060	0	5095
1655	26	11	5049	48	0	5134
1656	18	10	33	5009	0	5070
1657	18	10	12	5062	0	5102
1658	21	7	5055	48	0	5131
1659	17	6	4904	20	0	4947
1660	21	10	38	5014	0	5083
1661	12	6	5051	42	0	5111
1662	4747	5	40	24	0	4816
1663	43	5086	11	18	0	5158
1664	21	36	13	5168	0	5238
1665	14	8	10	5256	0	5288
1666	10	8	8	5206	0	5232
1667	5265	9	4	56	0	5334
1668	5222	10	6	23	0	5261
1669	5295	2	3	25	0	5325
1670	44	5309	8	15	0	5376
1671	28	29	3	5397	0	5457
1672	27	12	4	5411	0	5454
1673	5398	8	4	46	0	5456
1674	5401	7	3	20	0	5431
1675	51	12	2	5386	0	5451
1676	24	10	5365	37	0	5436
1677	5321	7	24	24	0	5376
1678	5457	7	9	20	0	5493
1679	42	16	5513	9	0	5580
1680	5204	3	27	22	0	5256
1681	51	5	5483	12	0	5551
1682	5422	3	33	16	0	5474
1683	51	31	12	5557	0	5651
1684	17	5796	18	34	0	5865
1685	19	26	6059	11	0	6115
1686	13	5996	37	15	0	6061
1687	19	5570	11	7	0	5607
1688	6030	36	19	34	0	6119
1689	34	12	5	6011	0	6062
1690	4	4	2	5937	0	5947
1691	6133	0	1	31	0	6165
1692	21	2	1	6176	0	6200
1693	9	2	2	6163	0	6176
1694	12	2	2	6152	0	6168
1695	6	5	1	6131	0	6143
1696	56	6	6079	24	0	6165
1697	8	2	5932	7	0	5949
1698	5	6067	20	9	0	6101
1699	6175	21	7	14	0	6217
1700	28	3	3	6217	0	6251
1701	9	6079	2	32	0	6122
1702	9	20	4	6441	0	6474
1703	10	7	1	6463	0	6481
1704	7	6	3	6464	0	6480
1705	6	2	6	6547	0	6561
1706	8	4	2	6479	0	6493
1707	5	6377	3	28	0	6413
1708	7	21	6	6451	0	6485
1709	3	9	6330	31	0	6373
1710	6	6308	23	9	0	6346
1711	10	20	3	6352	0	6385
1712	4	9	1	6340	0	6354
1713	3	6206	3	31	0	6243
1714	4	6298	2	15	0	6319
1715	6235	22	7	17	0	6281
1716	23	6185	3	8	0	6219
1717	6158	21	5	18	0	6202
1718	6097	10	3	10	0	6120
1719	24	5	6298	6	0	6333
1720	14	5	20	6129	0	6168
1721	7	8	6339	21	0	6375
1722	4	6416	21	16	0	6457
1723	24	34	9	5986	0	6053
1724	6	12	2	6505	0	6525
1725	10	4	2	6570	0	6586
1726	7	2	2	6640	0	6651
1727	6	8	6723	36	0	6773
1728	9	2	24	6605	0	6640
1729	6	2	6627	35	0	6670
1730	1	8	6516	13	0	6538
1731	6392	0	27	30	0	6449
1732	6767	5	9	15	0	6796
1733	6817	9	4	16	0	6846
1734	33	6610	3	14	0	6660
1735	13	25	2	6690	0	6730
1736	6	13	6833	31	0	6883
1737	9	8	28	6763	0	6808
1738	9	5	7008	31	0	7053
1739	6907	6	32	31	0	6976
1740	6850	1	8	18	0	6877
1741	6817	3	9	11	0	6840
1742	39	6	6668	7	0	6720
1743	15	0	6618	12	0	6645
1744	13	9	36	6728	0	6786
1745	12	5	17	6473	0	6507
1746	2	4	6	6820	0	6832
1747	9	6	6805	35	0	6855
1748	14	6	6329	21	0	6370
1749	6610	2	30	16	0	6658
1750	30	3	16	6855	0	6904
1751	12	1	8	6894	0	6915
1752	7031	1	5	45	0	7082
1753	30	3	10	6995	0	7038
1754	7350	5	3	51	0	7409
1755	7490	0	7	35	0	7532
1756	7509	4	4	23	0	7540
1757	37	6	7659	13	0	7715
1758	14	7602	28	14	0	7658
1759	7873	26	13	17	0	7929
1760	31	9	4	7882	0	7926
1761	17	5	6	7846	0	7874
1762	9	7902	2	38	0	7951
1763	7841	26	5	26	0	7898
1764	7761	7	4	16	0	7788
1765	7811	4	7	15	0	7837
1766	46	7850	7	8	0	7911
1767	8215	27	6	27	0	8275
1768	8264	13	3	27	0	8307
1769	8277	4	1	13	0	8295
1770	48	4	5	8178	0	8235
1771	18	3	4	8217	0	8242
1772	13	7	8379	43	0	8442
1773	17	3	31	8222	0	8273
1774	22	3	8	8299	0	8332
1775	11	8	8345	43	0	8407
1776	8013	1	23	27	0	8064
1777	8352	6	9	13	0	8380
1778	48	5	3	8283	0	8339
1779	20	8133	5	32	0	8190
1780	9	8227	4	13	0	8253
1781	10	43	2	8109	0	8164
1782	7	18	7945	33	0	8003
1783	15	18	28	7659	0	7720
1784	5	3	7590	27	0	7625
1785	7	6	7443	14	0	7470
1786	8	1	20	7630	0	7659
1787	7645	1	9	32	0	7687
1788	7434	0	4	20	0	7458
1789	25	3	5	7594	0	7627
1790	16	2	1	7570	0	7589
1791	8	1	0	7538	0	7547
1792	6	4	2	7504	0	7516
1793	7513	2	2	42	0	7559
1794	7472	3	5	22	0	7502
1795	7463	1	4	15	0	7483
1796	25	3	7467	6	0	7501
1797	14	1	16	7410	0	7441
1798	11	2	7	7546	0	7566
1799	7512	1	2	27	0	7542
1800	20	7443	1	14	0	7478
1801	7391	15	2	16	0	7424
1802	7346	8	2	20	0	7376
1803	7304	4	3	13	0	7324
1804	7285	1	3	16	0	7305
1805	31	6	7404	4	0	7445
1806	19	7	7072	9	0	7107
1807	7656	1	32	22	0	7711
1808	7804	2	10	21	0	7837
1809	7858	2	1	20	0	7881
1810	8140	3	3	11	0	8157
1811	55	5	8840	5	0	8905
1812	14	9328	48	11	0	9401
1813	38	66	24	9981	0	10109
1814	10520	28	13	123	0	10684
1815	10741	10	8	82	0	10841
1816	11492	8	6	40	0	11546
1817	11733	3	1	28	0	11765
1818	11900	1	3	15	0	11919
1819	11570	3	2	20	0	11595
1820	235	17	10181	27	0	10460
1821	103	7	11197	7	0	11314
1822	70	15	136	11041	0	11262
1823	51	9	11240	123	0	11423
1824	36	10873	146	60	0	11115
1825	31	11059	72	24	0	11186
1826	38	182	31	11381	0	11632
1827	23	62	11829	131	0	12045
1828	21	33	11477	61	0	11592
1829	11511	22	194	49	0	11776
1830	12512	17	82	34	0	12645
1831	237	15	42	12640	0	12934
1832	12821	21	29	203	0	13074
1833	226	15	22	12806	0	13069
1834	112	7	24	12893	0	13036
1835	48	12	12956	247	0	13263
1836	50	14	12572	95	0	12731
1837	45	5	238	12601	0	12889
1838	34	10	12625	208	0	12877
1839	12125	9	212	109	0	12455
1840	12848	3	91	63	0	13005
1841	250	13031	50	55	0	13386
1842	13128	177	44	52	0	13401
1843	252	69	12981	28	0	13330
1844	12909	22	199	44	0	13174
1845	13156	19	86	40	0	13301
1846	13277	15	51	41	0	13384
1847	327	11	42	12882	0	13262
1848	149	13040	36	187	0	13412
1849	13191	195	30	97	0	13513
1850	13357	69	37	59	0	13522
1851	323	40	36	13456	0	13855
1852	13420	26	34	259	0	13739
1853	290	13689	32	113	0	14124
1854	155	230	32	13548	0	13965
1855	95	89	13402	264	0	13850
1856	12795	38	235	132	0	13200
1857	291	35	13373	59	0	13758
1858	144	50	256	13382	0	13832
1859	84	13208	109	256	0	13657
1860	89	14319	63	99	0	14570
1861	91	321	48	14316	0	14776
1862	155	14228	68	302	0	14753
1863	100	346	49	17971	0	18466
1864	105	128	47	18867	0	19147
1865	98	75	43	19230	0	19446
1866	18581	65	33	610	0	19289
1867	485	56	25	18620	0	19186
1868	197	43	18273	542	0	19055
1869	130	18283	410	244	0	19067
1870	18451	421	127	176	0	19175
1871	553	148	62	18359	0	19122
1872	240	75	50	18656	0	19021
1873	176	58	58	18845	0	19137
1874	132	66	18233	614	0	19045
1875	115	18233	432	279	0	19059
1876	18412	433	165	199	0	19209
1877	502	159	88	17915	0	18664
1878	184	18555	72	511	0	19322
1879	18556	477	85	253	0	19371
1880	486	186	18467	147	0	19286
1881	18491	115	457	153	0	19216
1882	537	95	18741	122	0	19495
1883	266	106	18725	119	0	19216
1884	147	18624	547	163	0	19481
1885	162	469	227	18140	0	18998
1886	139	187	18246	506	0	19078
1887	119	17820	514	217	0	18670
1888	135	453	235	17559	0	18382
1889	87	17890	142	495	0	18614
1890	80	501	17844	244	0	18669
1891	110	201	506	17762	0	18579
1892	89	145	17955	551	0	18740
1893	126	110	513	17862	0	18611
1894	99	113	211	18272	0	18695
1895	87	110	17835	665	0	18697
1896	102	85	516	17891	0	18594
1897	17476	75	245	639	0	18435
1898	487	17630	162	333	0	18612
1899	217	454	17707	249	0	18627
1900	17523	183	508	214	0	18428
1901	558	136	215	17144	0	18053
1902	265	17633	145	543	0	18586
1903	17856	500	125	272	0	18753
1904	18211	218	131	189	0	18749
1905	671	150	119	17439	0	18379
1906	302	131	99	17803	0	18335
1907	200	103	94	17876	0	18273
1908	177	120	84	17640	0	18021
1909	167	17084	100	726	0	18077
1910	205	814	107	16317	0	17443
1911	108	15777	104	590	0	16579
1912	128	15518	88	335	0	16069
1913	84	15289	85	306	0	15764
1914	106	519	14281	238	0	15144
1915	113	14492	408	251	0	15264
1916	13469	435	266	262	0	14432
1917	384	13525	124	241	0	14274
1918	195	434	128	12806	0	13563
1919	156	13580	110	470	0	14316
1920	165	442	110	13565	0	14282
1921	151	228	119	13868	0	14366
1922	142	177	13529	546	0	14394
1923	13190	172	399	295	0	14056
1924	13515	146	173	287	0	14121
1925	13413	141	127	286	0	13967
1926	469	13119	146	293	0	14027
1927	200	399	135	12838	0	13572
1928	183	220	12631	499	0	13533
1929	170	12515	404	290	0	13379
1930	175	428	167	11023	0	11793
1931	160	11741	139	314	0	12354
1932	11647	390	135	241	0	12413
1933	11773	177	158	164	0	12272
1934	11914	159	163	135	0	12371
1935	11836	119	177	154	0	12286
1936	450	148	141	11507	0	12246
1937	198	144	127	11473	0	11942
1938	142	11501	128	447	0	12218
1939	155	373	118	11578	0	12224
1940	135	188	11283	448	0	12054
1941	98	158	341	11137	0	11734
1942	80	138	10947	483	0	11648
1943	75	10826	367	293	0	11561
1944	76	363	10893	252	0	11584
1945	85	168	420	10865	0	11538
1946	93	127	10942	491	0	11653
1947	106	106	403	10790	0	11405
1948	93	135	197	11008	0	11433
1949	110	108	149	10968	0	11335
1950	127	134	129	10907	0	11297
1951	10180	139	112	457	0	10888
1952	358	10287	105	237	0	10987
1953	9870	326	81	221	0	10498
1954	324	157	9482	220	0	10183
1955	9444	124	249	204	0	10021
1956	9715	83	100	211	0	10109
1957	447	99	9310	185	0	10041
1958	299	88	8955	189	0	9531
1959	158	8759	283	196	0	9396
1960	123	8328	104	190	0	8745
1961	165	305	7636	186	0	8292
1962	91	6740	220	214	0	7265
1963	183	177	127	3823	0	4310
1964	3556	17	52	49	0	3674
1965	36	14	10	3520	0	3580
1966	3553	13	6	33	0	3605
1967	3537	13	6	15	0	3571
1968	42	3590	8	14	0	3654
1969	3577	32	6	13	0	3628
1970	3588	13	4	19	0	3624
1971	31	16	4	3549	0	3600
1972	3580	6	3	39	0	3628
1973	28	3704	3	23	0	3758
1974	12	30	4	3687	0	3733
1975	3685	14	3	37	0	3739
1976	37	8	3679	15	0	3739
1977	3633	6	29	14	0	3682
1978	41	13	10	3745	0	3809
1979	11	5	3738	30	0	3784
1980	11	4	3659	15	0	3689
1981	3646	15	49	9	0	3719
1982	3636	3	10	11	0	3660
1983	33	2	1	3632	0	3668
1984	12	2	1	3651	0	3666
1985	6	3	2	3648	0	3659
1986	4	3685	0	30	0	3719
1987	3732	27	3	9	0	3771
1988	27	3721	3	5	0	3756
1989	3728	24	3	9	0	3764
1990	31	6	3710	4	0	3751
1991	9	3	28	3738	0	3778
1992	3809	0	5	34	0	3848
1993	32	0	2	3843	0	3877
1994	10	3	2	3822	0	3837
1995	6	3697	2	30	0	3735
1996	3772	25	1	11	0	3809
1997	28	3943	2	9	0	3982
1998	11	33	2	4014	0	4060
1999	4	8	3959	33	0	4004
2000	3694	3	33	15	0	3745
2001	40	3	3917	4	0	3964
2002	3725	2	41	12	0	3780
2003	48	3925	7	6	0	3986
2004	6	39	2	3830	0	3877
2005	5	3717	2	189	0	3913
2006	3900	44	5	12	0	3961
2007	46	7	0	3966	0	4019
2008	15	4	3	4016	0	4038
2009	9	2	3924	51	0	3986
2010	3776	5	39	22	0	3842
2011	46	2	6	3976	0	4030
2012	11	7	3917	42	0	3977
2013	8	3895	45	9	0	3957
2014	8	34	8	3919	0	3969
2015	3943	7	7	43	0	4000
2016	44	7	6	3952	0	4009
2017	10	5	4033	47	0	4095
2018	4314	0	44	15	0	4373
2019	55	4	9	4338	0	4406
2020	13	3	4632	63	0	4711
2021	11	5	60	4694	0	4770
2022	9	1	13	4701	0	4724
2023	4	4729	10	74	0	4817
2024	4694	60	4	33	0	4791
2025	58	4725	8	13	0	4804
2026	4730	69	3	13	0	4815
2027	79	13	7	4661	0	4760
2028	18	4738	6	69	0	4831
2029	19	64	4	4708	0	4795
2030	3	18	4649	78	0	4748
2031	4491	12	60	20	0	4583
2032	71	8	9	4515	0	4603
2033	22	6	13	4497	0	4538
2034	21	7	2	4546	0	4576
2035	9	8	4422	87	0	4526
2036	11	10	4422	26	0	4469
2037	9	4487	69	21	0	4586
2038	15	63	21	4405	0	4504
2039	4441	15	15	70	0	4541
2040	60	4560	6	32	0	4658
2041	21	69	5	4739	0	4834
2042	4856	15	6	77	0	4954
2043	4898	11	9	23	0	4941
2044	77	4909	5	22	0	5013
2045	5325	69	5	21	0	5420
2046	5871	20	6	17	0	5914
2047	131	19	6	6030	0	6186
2048	35	6001	8	127	0	6171
2049	30	111	7	6107	0	6255
2050	6079	26	4	137	0	6246
2051	127	24	6117	41	0	6309
2052	54	11	115	6068	0	6248
2053	48	10	20	6195	0	6273
2054	17	18	6093	159	0	6287
2055	21	22	120	6126	0	6289
2056	6079	14	33	162	0	6288
2057	5786	10	27	62	0	5885
2058	142	6	26	6008	0	6182
2059	44	11	5936	162	0	6153
2060	28	9	5820	64	0	5921
2061	24	5801	149	54	0	6028
2062	21	6033	44	39	0	6137
2063	44	127	22	5857	0	6050
2064	5835	35	15	151	0	6036
2065	120	5851	24	58	0	6053
2066	5788	118	33	48	0	5987
2067	135	39	30	5759	0	5963
2068	42	44	14	5795	0	5895
2069	5614	28	10	175	0	5827
2070	129	5616	14	71	0	5830
2071	5659	129	9	44	0	5841
2072	148	49	5481	26	0	5704
2073	51	31	5391	30	0	5503
2074	52	33	130	5283	0	5498
2075	34	19	5327	140	0	5520
2076	35	26	5276	39	0	5376
2077	36	35	124	5022	0	5217
2078	36	15	5138	124	0	5313
2079	23	12	149	5027	0	5211
2080	26	13	55	5090	0	5184
2081	24	12	5183	157	0	5376
2082	29	10	139	5089	0	5267
2083	24	10	58	5057	0	5149
2084	16	5026	51	153	0	5246
2085	5018	109	35	75	0	5237
2086	117	26	4997	69	0	5209
2087	38	31	123	4953	0	5145
2088	34	16	51	5078	0	5179
2089	25	15	4933	163	0	5136
2090	4732	23	122	81	0	4958
2091	125	4892	39	52	0	5108
2092	49	116	38	4887	0	5090
2093	40	36	34	4913	0	5023
2094	22	4878	30	165	0	5095
2095	30	113	4849	82	0	5074
2096	29	4912	129	51	0	5121
2097	4746	130	49	46	0	4971
2098	110	42	4675	52	0	4879
2099	44	32	113	4646	0	4835
2100	32	28	4698	128	0	4886
2101	31	32	4707	55	0	4825
2102	17	4694	131	43	0	4885
2103	44	116	57	4532	0	4749
2104	4576	35	42	115	0	4768
2105	4615	26	41	45	0	4727
2106	112	4584	33	59	0	4788
2107	47	103	35	4599	0	4784
2108	4588	39	46	110	0	4783
2109	4650	37	21	55	0	4763
2110	130	4617	15	51	0	4813
2111	4688	97	19	40	0	4844
2112	137	37	20	4586	0	4780
2113	45	4692	23	118	0	4878
2114	43	109	25	4778	0	4955
2115	49	42	20	4816	0	4927
2116	49	58	23	4828	0	4958
2117	29	28	4647	148	0	4852
2118	31	24	4190	64	0	4309
2119	23	4283	93	50	0	4449
2120	3964	85	40	32	0	4121
2121	75	3877	23	48	0	4023
2122	28	77	19	3859	0	3983
2123	21	25	3984	98	0	4128
2124	16	26	95	3900	0	4037
2125	19	27	40	4013	0	4099
2126	20	26	18	4077	0	4141
2127	4024	24	15	98	0	4161
2128	75	20	18	4046	0	4159
2129	23	16	4243	101	0	4383
2130	4104	9	89	57	0	4259
2131	4253	8	28	50	0	4339
2132	4341	9	18	46	0	4414
2133	4350	15	10	42	0	4417
2134	4343	7	17	31	0	4398
2135	97	4265	23	30	0	4415
2136	48	65	19	4094	0	4226
2137	40	4195	14	75	0	4324
2138	4205	67	10	30	0	4312
2139	4163	20	10	25	0	4218
2140	4035	17	12	18	0	4082
2141	95	3821	10	19	0	3945
2142	31	3721	7	25	0	3784
2143	24	3747	12	18	0	3801
2144	41	83	3625	15	0	3764
2145	59	224	66	2936	0	3285
2146	18	2555	6	28	0	2607
2147	2	2471	5	4	0	2482
2148	6	7	3	2485	0	2501
2149	2	2	2	2464	0	2470
2150	3	1	2508	6	0	2518
2151	2440	1	4	2	0	2447
2152	8	1	0	2607	0	2616
2153	3	2	1	2613	0	2619
2154	4	1	2592	8	0	2605
2155	2	3	2464	2	0	2471
2156	2	2670	6	3	0	2681
2157	4	7	0	2725	0	2736
2158	1	0	4	2752	0	2757
2159	3	5	2690	7	0	2705
2160	2511	1	8	7	0	2527
2161	2670	3	3	7	0	2683
2162	8	3	2722	3	0	2736
2163	2677	1	6	7	0	2691
2164	7	4	2801	4	0	2816
2165	2764	0	9	11	0	2784
2166	2830	1	2	6	0	2839
2167	12	1	2932	3	0	2948
2168	5	1	6	2929	0	2941
2169	5	1	7	2814	0	2827
2170	3	1	4	3036	0	3044
2171	3023	3	0	9	0	3035
2172	2996	2	1	8	0	3007
2173	6	2	3104	6	0	3118
2174	6	2	3020	7	0	3035
2175	3142	0	10	8	0	3160
2176	3256	1	3	5	0	3265
2177	13	1	3247	1	0	3262
2178	5	0	3207	4	0	3216
2179	7	2	14	3297	0	3320
2180	6	3	3386	14	0	3409
2181	5	1	16	3222	0	3244
2182	3416	1	7	18	0	3442
2183	28	0	3624	9	0	3661
2184	3503	0	30	10	0	3543
2185	31	1	3992	6	0	4030
2186	17	0	33	3959	0	4009
2187	7	1	8	4164	0	4180
2188	7	0	7	4161	0	4175
2189	5	4225	3	40	0	4273
2190	16	32	5	3904	0	3957
2191	8	2	1	4279	0	4290
2192	4214	1	3	46	0	4264
2193	34	4	4192	10	0	4240
2194	3983	2	33	18	0	4036
2195	38	2	4168	7	0	4215
2196	3883	0	32	16	0	3931
2197	39	4141	8	4	0	4192
2198	10	28	4139	1	0	4178
2199	7	5	4110	3	0	4125
2200	17	12	45	3743	0	3817
2201	9	2	5	4121	0	4137
2202	7	1	4140	37	0	4185
2203	3	4	4122	9	0	4138
2204	4	2	4457	6	0	4469
2205	4618	1	39	18	0	4676
2206	4722	1	5	13	0	4741
2207	4706	1	7	10	0	4724
2208	45	1	10	4631	0	4687
2209	11	1	9	4665	0	4686
2210	7	1	4891	44	0	4943
2211	14	2	34	4754	0	4804
2212	13	5	13	4564	0	4595
2213	4844	3	5	44	0	4896
2214	4847	2	6	22	0	4877
2215	4915	3	3	15	0	4936
2216	46	2	4	4911	0	4963
2217	16	0	6	4901	0	4923
2218	11	0	11	4916	0	4938
2219	4868	2	7	40	0	4917
2220	40	2	5	4817	0	4864
2221	13	4829	6	38	0	4886
2222	11	32	10	4792	0	4845
2223	8	4712	10	32	0	4762
2224	4705	32	9	23	0	4769
2225	4643	4	12	17	0	4676
2226	35	4670	9	16	0	4730
2227	11	4712	7	14	0	4744
2228	11	37	12	4660	0	4720
2229	15	9	4509	36	0	4569
2230	14	7	37	4429	0	4487
2231	12	3	4497	56	0	4568
2232	10	4525	33	25	0	4593
2233	12	35	13	4579	0	4639
2234	12	6	11	4622	0	4651
2235	10	3	4791	49	0	4853
2236	16	4	38	4754	0	4812
2237	14	8	4884	43	0	4949
2238	4803	4	43	27	0	4877
2239	4939	3	14	18	0	4974
2240	4967	3	8	20	0	4998
2241	49	6	11	4907	0	4973
2242	14	6	13	4924	0	4957
2243	16	3	4995	51	0	5065
2244	16	11	47	4895	0	4969
2245	15	4863	15	47	0	4940
2246	14	38	4929	22	0	5003
2247	19	11	4827	11	0	4868
2248	14	18	41	4614	0	4687
2249	21	6	4897	51	0	4975
2250	10	5	4846	25	0	4886
2251	4647	8	47	26	0	4728
2252	43	5178	19	17	0	5257
2253	5381	33	12	36	0	5462
2254	5443	9	11	17	0	5480
2255	5507	7	9	26	0	5549
2256	49	10	10	5488	0	5557
2257	21	5	7	5554	0	5587
2258	15	4	5559	48	0	5626
2259	15	4	37	5483	0	5539
2260	6	5540	14	57	0	5617
2261	5601	38	17	23	0	5679
2262	43	5568	17	18	0	5646
2263	19	5614	13	11	0	5657
2264	22	42	8	5617	0	5689
2265	20	9	5704	44	0	5777
2266	18	10	40	5634	0	5702
2267	10	9	5618	55	0	5692
2268	7	5572	43	25	0	5647
2269	5594	35	20	22	0	5671
2270	5651	6	10	25	0	5692
2271	5742	7	10	26	0	5785
2272	52	12	5993	12	0	6069
2273	18	5	5646	21	0	5690
2274	5884	4	45	27	0	5960
2275	5451	6	638	28	0	6123
2276	6126	8	9	27	0	6170
2277	48	6	10	6083	0	6147
2278	22	5	4	6156	0	6187
2279	6142	5	6	44	0	6197
2280	6050	5	8	29	0	6092
2281	37	6	6151	14	0	6208
2282	15	5	5810	15	0	5845
2283	5649	2	28	14	0	5693
2284	20	5	5860	5	0	5890
2285	5447	0	17	10	0	5474
2286	13	1	5583	6	0	5603
2287	8	7	10	5368	0	5393
2288	7	2	5620	5	0	5634
2289	3	4	2	5609	0	5618
2290	4	0	3	5683	0	5690
2291	3	5742	3	12	0	5760
2292	5820	3	2	21	0	5846
2293	2	2	5969	4	0	5977
2294	5768	2	4	16	0	5790
2295	9	6069	2	2	0	6082
2296	6331	6	3	12	0	6352
2297	10	3	3	6324	0	6340
2298	8	2	1	6401	0	6412
2299	6	6592	1	19	0	6618
2300	5	14	2	6864	0	6885
2301	6	2	1	6917	0	6926
2302	4	5	2	6967	0	6978
2303	6812	1	1	36	0	6850
2304	6490	1	2	16	0	6509
2305	24	7	6419	7	0	6457
2306	12	6435	18	10	0	6475
2307	11	20	4	6632	0	6667
2308	4	4	6	6915	0	6929
2309	3	7	6982	38	0	7030
2310	8	2	35	6733	0	6778
2311	6826	2	6	53	0	6887
2312	6860	1	5	20	0	6886
2313	6949	2	1	19	0	6971
2314	52	2	0	6978	0	7032
2315	7205	1	2	57	0	7265
2316	7227	2	2	25	0	7256
2317	7344	0	4	21	0	7369
2318	58	1	3	7334	0	7396
2319	21	2	4	7396	0	7423
2320	18	1	1	7436	0	7456
2321	10	0	2	7331	0	7343
2322	8	3	1	7335	0	7347
2323	3	2	7303	54	0	7362
2324	15	0	7190	17	0	7222
2325	9	7173	44	13	0	7239
2326	12	34	12	7333	0	7391
2327	16	4	7	7440	0	7467
2328	11	7	2	7475	0	7495
2329	8	5	7389	64	0	7466
2330	9	2	39	7304	0	7354
2331	7	1	7373	56	0	7437
2332	7	1	47	7318	0	7373
2333	7	4	7649	52	0	7712
2334	3	7651	59	23	0	7736
2335	9	53	7	7599	0	7668
2336	5	7	7557	55	0	7624
2337	6916	11	55	39	0	7021
2338	55	7578	8	16	0	7657
2339	17	53	13	7673	0	7756
2340	13	7718	4	58	0	7793
2341	11	69	4	7704	0	7788
2342	7828	5	6	84	0	7923
2343	69	14	5	7705	0	7793
2344	8	7790	5	74	0	7877
2345	7801	62	4	42	0	7909
2346	68	6	8	8127	0	8209
2347	13	34	4	8278	0	8329
2348	8441	5	2	111	0	8559
2349	97	5	4	9011	0	9117
2350	44	5	7	10637	0	10693
2351	21	7	10807	209	0	11044
2352	14	11	10635	64	0	10724
2353	31	3	230	10512	0	10776
2354	9	7	10653	208	0	10877
2355	15	10	10479	64	0	10568
2356	10115	1	253	72	0	10441
2357	212	5	10660	31	0	10908
2358	54	10680	233	30	0	10997
2359	73	188	71	10818	0	11150
2360	11116	47	45	242	0	11450
2361	11400	40	30	87	0	11557
2362	11350	16	22	82	0	11470
2363	300	11247	29	34	0	11610
2364	143	210	28	11210	0	11591
2365	94	60	20	11414	0	11588
2366	10809	42	21	303	0	11175
2367	11297	19	22	140	0	11478
2368	11406	13	27	90	0	11536
2369	315	11	11392	41	0	11759
2370	120	11274	227	43	0	11664
2371	78	12733	81	47	0	12939
2372	77	324	62	12323	0	12786
2373	72	120	32	12830	0	13054
2374	45	79	12758	399	0	13281
2375	12532	39	306	197	0	13074
2376	12943	26	111	129	0	13209
2377	430	27	78	12714	0	13249
2378	234	16	30	12912	0	13192
2379	150	16	20	13030	0	13216
2380	12707	17	19	504	0	13247
2381	355	27	12418	194	0	12994
2382	141	21	12628	147	0	12937
2383	124	47	390	12422	0	12983
2384	53	33	12532	368	0	12986
2385	12296	18	381	187	0	12882
2386	12502	9	164	145	0	12820
2387	12672	12	119	79	0	12882
2388	501	12136	61	65	0	12763
2389	12235	310	47	86	0	12678
2390	453	113	36	12051	0	12653
2391	189	81	42	12197	0	12509
2392	172	31	45	12361	0	12609
2393	94	31	11837	506	0	12468
2394	95	40	358	11579	0	12072
2395	67	11741	147	462	0	12417
2396	11388	300	141	216	0	12045
2397	365	11639	79	164	0	12247
2398	182	363	11417	109	0	12071
2399	158	11399	352	92	0	12001
2400	11042	386	161	95	0	11684
2401	362	11071	139	96	0	11668
2402	212	382	73	10089	0	10756
2403	140	11018	76	334	0	11568
2404	10985	372	72	175	0	11604
2405	11171	144	75	150	0	11540
2406	10424	113	76	113	0	10726
2407	488	95	10727	93	0	11403
2408	250	58	10555	87	0	10950
2409	176	76	10551	102	0	10905
2410	10356	69	484	100	0	11009
2411	391	88	244	10181	0	10904
2412	227	64	133	10398	0	10822
2413	172	76	10097	419	0	10764
2414	130	70	319	10219	0	10738
2415	9768	84	156	432	0	10440
2416	369	9862	116	210	0	10557
2417	9992	322	72	155	0	10541
2418	454	152	9790	102	0	10498
2419	9966	120	335	95	0	10516
2420	10177	90	174	90	0	10531
2421	10209	80	131	96	0	10516
2422	533	60	9777	95	0	10465
2423	300	56	322	9805	0	10483
2424	205	44	9821	376	0	10446
2425	163	44	406	9858	0	10471
2426	123	51	9932	420	0	10526
2427	152	49	393	9840	0	10434
2428	128	71	191	10100	0	10490
2429	9846	55	134	458	0	10493
2430	10018	34	110	256	0	10418
2431	10126	36	102	170	0	10434
2432	553	39	84	9580	0	10256
2433	300	8823	70	353	0	9546
2434	201	9476	95	201	0	9973
2435	9391	356	69	178	0	9994
2436	370	163	9279	125	0	9937
2437	9325	102	330	123	0	9880
2438	422	72	9133	102	0	9729
2439	9394	52	375	109	0	9930
2440	8776	61	170	146	0	9153
2441	417	53	9335	111	0	9916
2442	9486	43	330	108	0	9967
2443	9631	45	156	100	0	9932
2444	9569	51	130	115	0	9865
2445	499	9320	80	104	0	10003
2446	287	384	83	8928	0	9682
2447	221	136	8962	295	0	9614
2448	171	101	8968	155	0	9395
2449	152	8180	335	130	0	8797
2450	109	6751	154	74	0	7088
2451	165	188	160	6229	0	6742
2452	6194	84	54	163	0	6495
2453	195	6230	55	95	0	6575
2454	140	138	47	6118	0	6443
2455	115	6220	37	153	0	6525
2456	6190	178	33	97	0	6498
2457	187	88	35	6061	0	6371
2458	111	64	5913	169	0	6257
2459	98	5632	145	93	0	5968
2460	65	5671	101	67	0	5904
2461	69	168	76	5168	0	5481
2462	68	5472	36	116	0	5692
2463	62	169	46	5383	0	5660
2464	5387	76	29	162	0	5654
2465	5420	69	36	73	0	5598
2466	5624	51	25	69	0	5769
2467	5641	47	32	54	0	5774
2468	236	57	5485	37	0	5815
2469	134	5108	128	47	0	5417
2470	75	4999	74	46	0	5194
2471	30	4064	17	19	0	4130
2472	22	3923	20	20	0	3985
2473	3812	57	82	15	0	3966
2474	3702	11	16	6	0	3735
2475	3718	6	9	8	0	3741
2476	3728	1	4	8	0	3741
2477	50	7	3695	3	0	3755
2478	3846	7	33	9	0	3895
2479	3945	5	6	16	0	3972
2480	4011	2	5	6	0	4024
2481	52	4	3	3986	0	4045
2482	17	4	4	4007	0	4032
2483	4022	4	3	45	0	4074
2484	44	8	5	3974	0	4031
2485	14	3950	5	44	0	4013
2486	10	34	2	4026	0	4072
2487	11	11	3	4025	0	4050
2488	6	4085	2	45	0	4138
2489	13	37	1	4090	0	4141
2490	10	10	4	4122	0	4146
2491	4074	6	2	49	0	4131
2492	40	9	3958	14	0	4021
2493	3912	7	33	5	0	3957
2494	41	3	3922	12	0	3978
2495	18	3	3768	7	0	3796
2496	12	6	3886	3	0	3907
2497	3860	4	41	11	0	3916
2498	40	5	4030	5	0	4080
2499	3963	8	43	5	0	4019
2500	4019	4	9	13	0	4045
2501	4062	8	7	6	0	4083
2502	42	4023	7	5	0	4077
2503	4074	35	4	8	0	4121
2504	44	4115	0	5	0	4164
2505	18	36	2	4172	0	4228
2506	11	7	3	4200	0	4221
2507	14	4124	2	41	0	4181
2508	9	4158	4	13	0	4184
2509	11	4262	4	6	0	4283
2510	4222	38	6	14	0	4280
2511	36	4300	9	10	0	4355
2512	4323	39	6	15	0	4383
2513	40	18	4307	3	0	4368
2514	4290	8	33	9	0	4340
2515	4368	7	7	8	0	4390
2516	53	10	4255	4	0	4322
2517	25	1	35	4276	0	4337
2518	17	5	4355	32	0	4409
2519	19	4	35	4326	0	4384
2520	13	5	12	4363	0	4393
2521	4391	4	8	50	0	4453
2522	4386	4	4	21	0	4415
2523	45	4350	4	10	0	4409
2524	4451	34	3	16	0	4504
2525	48	15	4521	7	0	4591
2526	4485	4	38	13	0	4540
2527	51	8	4754	9	0	4822
2528	21	10	4796	4	0	4831
2529	4911	1	49	13	0	4974
2530	5029	3	19	13	0	5064
2531	64	8	5120	3	0	5195
2532	26	5	48	4955	0	5034
2533	17	6	14	5163	0	5200
2534	20	6	5109	49	0	5184
2535	17	6	46	5004	0	5073
2536	13	4837	25	35	0	4910
2537	16	40	8	5229	0	5293
2538	11	18	8	5194	0	5231
2539	17	10	5037	52	0	5116
2540	4770	4	39	36	0	4849
2541	4988	5	18	16	0	5027
2542	4920	6	4	12	0	4942
2543	4881	2	10	14	0	4907
2544	59	4823	8	9	0	4899
2545	29	37	5	4669	0	4740
2546	21	16	4614	40	0	4691
2547	11	10	4545	17	0	4583
2548	19	8	37	4427	0	4491
2549	7	5	4511	42	0	4565
2550	4322	2	32	19	0	4375
2551	30	4	15	4447	0	4496
2552	20	2	6	4468	0	4496
2553	9	3	6	4457	0	4475
2554	4400	2	8	45	0	4455
2555	31	4375	9	20	0	4435
2556	4383	24	4	11	0	4422
2557	4364	12	7	15	0	4398
2558	41	4281	7	8	0	4337
2559	15	4314	10	9	0	4348
2560	4437	34	2	9	0	4482
2561	40	10	9	4435	0	4494
2562	17	3	6	4420	0	4446
2563	4605	4	5	47	0	4661
2564	44	7	4550	21	0	4622
2565	4545	3	33	10	0	4591
2566	4612	2	13	12	0	4639
2567	47	4729	6	11	0	4793
2568	4931	21	4	13	0	4969
2569	4969	16	3	14	0	5002
2570	55	5428	2	9	0	5494
2571	15	5605	1	6	0	5627
2572	25	75	7	5512	0	5619
2573	5625	30	4	53	0	5712
2574	64	5796	4	27	0	5891
2575	36	71	0	5870	0	5977
2576	5937	32	6	70	0	6045
2577	75	9	5885	31	0	6000
2578	42	6	65	5831	0	5944
2579	14	8	5894	72	0	5988
2580	5705	5	75	35	0	5820
2581	5914	3	31	23	0	5971
2582	98	3	5876	8	0	5985
2583	43	5837	73	11	0	5964
2584	28	70	33	5855	0	5986
2585	13	29	5946	73	0	6061
2586	31	13	73	5908	0	6025
2587	17	9	37	6083	0	6146
2588	6	10	5979	101	0	6096
2589	5819	5	75	52	0	5951
2590	6010	3	38	25	0	6076
2591	105	7	6018	15	0	6145
2592	48	6034	79	13	0	6174
2593	33	73	37	5878	0	6021
2594	20	5929	21	70	0	6040
2595	14	6036	13	35	0	6098
2596	6089	96	13	18	0	6216
2597	90	44	5	6080	0	6219
2598	38	22	10	6068	0	6138
2599	20	13	6113	100	0	6246
2600	17	11	6059	54	0	6141
2601	18	9	103	6060	0	6190
2602	21	9	41	6190	0	6261
2603	17	7	6147	114	0	6285
2604	16	9	6171	47	0	6243
2605	16	9	116	6144	0	6285
2606	6271	11	46	98	0	6426
2607	91	6337	23	51	0	6502
2608	6309	94	19	32	0	6454
2609	106	6339	17	22	0	6484
2610	44	6474	11	22	0	6551
2611	6341	122	9	22	0	6494
2612	109	48	6416	18	0	6591
2613	53	18	98	6412	0	6581
2614	32	17	38	6532	0	6619
2615	25	16	26	6895	0	6962
2616	28	8	6862	140	0	7038
2617	25	10	104	6847	0	6986
2618	6963	10	46	133	0	7152
2619	105	16	28	7121	0	7270
2620	49	9	22	7310	0	7390
2621	7245	12	20	169	0	7446
2622	7267	13	12	79	0	7371
2623	154	7163	14	45	0	7376
2624	63	106	7146	36	0	7351
2625	46	31	6978	28	0	7083
2626	24	24	7052	26	0	7126
2627	28	6740	148	24	0	6940
2628	53	109	79	6530	0	6771
2629	18	33	32	6676	0	6759
2630	6587	23	28	145	0	6783
2631	114	17	24	6507	0	6662
2632	45	16	6479	141	0	6681
2633	27	18	114	6493	0	6652
2634	26	20	40	6570	0	6656
2635	31	12	6465	155	0	6663
2636	21	6380	120	72	0	6593
2637	29	108	43	6007	0	6187
2638	29	6422	31	113	0	6595
2639	23	109	6415	44	0	6591
2640	6330	45	123	35	0	6533
2641	6473	29	53	38	0	6593
2642	6528	20	42	30	0	6620
2643	147	27	26	6418	0	6618
2644	58	6489	26	123	0	6696
2645	6469	108	20	64	0	6661
2646	6586	40	15	47	0	6688
2647	6518	20	17	51	0	6606
2648	150	21	6384	44	0	6599
2649	6256	15	114	35	0	6420
2650	142	6368	42	32	0	6584
2651	6329	109	37	29	0	6504
2652	132	6435	29	26	0	6622
2653	6467	122	27	33	0	6649
2654	140	49	6567	22	0	6778
2655	6560	34	112	29	0	6735
2656	6755	19	40	35	0	6849
2657	5799	40	33	57	0	5929
2658	6780	15	25	26	0	6846
2659	164	15	6633	27	0	6839
2660	82	24	106	6550	0	6762
2661	6562	16	37	119	0	6734
2662	136	6540	37	47	0	6760
2663	72	96	28	6383	0	6579
2664	42	37	6311	126	0	6516
2665	58	61	110	6274	0	6503
2666	37	27	6316	119	0	6499
2667	31	6019	117	63	0	6230
2668	36	5777	45	40	0	5898
2669	35	5840	35	34	0	5944
2670	53	118	32	5235	0	5438
2671	42	30	15	5169	0	5256
2672	33	16	5049	78	0	5176
2673	28	4861	59	28	0	4976
2674	4634	54	27	25	0	4740
2675	57	4485	20	24	0	4586
2676	22	4549	23	17	0	4611
2677	62	72	20	4424	0	4578
2678	4384	24	14	65	0	4487
2679	4428	21	12	29	0	4490
2680	69	12	12	4377	0	4470
2681	4346	7	12	68	0	4433
2682	64	12	17	4313	0	4406
2683	25	14	4258	64	0	4361
2684	4262	12	57	28	0	4359
2685	60	11	15	4282	0	4368
2686	19	18	4201	56	0	4294
2687	9	12	4150	27	0	4198
2688	18	12	56	4200	0	4286
2689	4234	9	82	61	0	4386
2690	4308	13	18	23	0	4362
2691	60	4339	13	14	0	4426
2692	4464	51	10	28	0	4553
2693	4514	22	6	17	0	4559
2694	4537	15	7	14	0	4573
2695	68	4592	6	24	0	4690
2696	4656	44	6	17	0	4723
2697	4750	10	11	14	0	4785
2698	75	8	12	4682	0	4777
2699	4561	7	5	50	0	4623
2700	58	4514	9	19	0	4600
2701	32	4606	10	7	0	4655
2702	20	53	6	4589	0	4668
2703	24	12	10	4606	0	4652
2704	20	4643	11	42	0	4716
2705	4617	41	3	19	0	4680
2706	47	4456	8	10	0	4521
2707	4393	33	3	12	0	4441
2708	47	4478	3	12	0	4540
2709	31	30	7	4386	0	4454
2710	18	4585	3	29	0	4635
2711	4613	37	23	12	0	4685
2712	4523	21	8	10	0	4562
2713	4484	11	9	21	0	4525
2714	46	12	4389	6	0	4453
2715	19	4	4115	11	0	4149
2716	8	4131	26	6	0	4171
2717	12	24	4072	5	0	4113
2718	5	6	3945	11	0	3967
2719	12	39	22	3652	0	3725
2720	5	6	3769	16	0	3796
2721	2	3795	9	4	0	3810
2722	3808	12	2	6	0	3828
2723	11	3754	0	8	0	3773
2724	4	3802	1	4	0	3811
2725	3881	13	2	7	0	3903
2726	3958	4	1	5	0	3968
2727	14	4037	1	3	0	4055
2728	4093	12	1	5	0	4111
2729	4092	4	2	8	0	4106
2730	4090	1	0	3	0	4094
2731	50	2	4008	1	0	4061
2732	6	1	3993	2	0	4002
2733	4	4	11	4118	0	4137
2734	9	5	4	4100	0	4118
2735	4210	2	2	19	0	4233
2736	13	4155	0	3	0	4171
2737	9	15	1	4249	0	4274
2738	4	4	2	4280	0	4290
2739	7	1	1	4331	0	4340
2740	6	0	3	4357	0	4366
2741	2	2	4372	25	0	4401
2742	6	4	4294	6	0	4310
2743	5	3	24	4424	0	4456
2744	3	1	4514	22	0	4540
2745	4410	0	25	11	0	4446
2746	26	1	7	4563	0	4597
2747	7	2	4578	27	0	4614
2748	4309	1	26	11	0	4347
2749	25	4531	8	5	0	4569
2750	4540	22	5	9	0	4576
2751	25	4601	4	6	0	4636
2752	16	24	3	4542	0	4585
2753	4	7	4563	25	0	4599
2754	4	3	26	4384	0	4417
2755	7	1	4395	29	0	4432
2756	4327	4	26	15	0	4372
2757	33	2	4	4473	0	4512
2758	4486	5	4	28	0	4523
2759	29	3	4463	8	0	4503
2760	4616	0	29	15	0	4660
2761	5003	0	8	16	0	5027
2762	44	3	5057	1	0	5105
2763	19	4	36	5030	0	5089
2764	8	2	5108	34	0	5152
2765	9	5085	37	14	0	5145
2766	5074	37	25	15	0	5151
2767	5079	6	6	12	0	5103
2768	46	5	5109	2	0	5162
2769	13	4	5032	5	0	5054
2770	19	5	43	4985	0	5052
2771	19	5	13	5071	0	5108
2772	5091	4	8	44	0	5147
2773	42	5102	9	11	0	5164
2774	5169	34	9	19	0	5231
2775	5195	8	9	15	0	5227
2776	50	4	5082	8	0	5144
2777	4955	4	36	18	0	5013
2778	48	2	5104	10	0	5164
2779	33	5	45	5115	0	5198
2780	16	8	5281	39	0	5344
2781	19	3	40	5260	0	5322
2782	16	2	5274	37	0	5329
2783	5199	5	43	15	0	5262
2784	5276	4	19	11	0	5310
2785	51	0	14	5227	0	5292
2786	5279	1	16	51	0	5347
2787	47	7	14	5269	0	5337
2788	18	5342	10	49	0	5419
2789	5349	29	10	27	0	5415
2790	45	5336	9	11	0	5401
2791	24	35	14	5342	0	5415
2792	20	10	9	5228	0	5267
2793	23	6	7	5202	0	5238
2794	18	7	6	5163	0	5194
2795	13	11	4998	49	0	5071
2796	4651	6	38	30	0	4725
2797	4859	6	11	25	0	4901
2798	45	4838	9	24	0	4916
2799	23	33	8	4874	0	4938
2800	21	10	8	4889	0	4928
2801	11	7	4768	55	0	4841
2802	4621	7	42	26	0	4696
2803	48	9	13	4728	0	4798
2804	19	8	4664	42	0	4733
2805	4655	8	40	23	0	4726
2806	4743	4	14	27	0	4788
2807	4767	3	13	23	0	4806
2808	53	1	4631	12	0	4697
2809	27	3	4452	19	0	4501
2810	4429	5	43	15	0	4492
2811	53	2	18	4497	0	4570
2812	27	7	13	4589	0	4636
2813	21	5	4559	48	0	4633
2814	4507	3	36	22	0	4568
2815	45	5	19	4638	0	4707
2816	4776	1	16	49	0	4842
2817	4803	2	14	35	0	4854
2818	4796	3	11	32	0	4842
2819	64	1	4887	18	0	4970
2820	31	8	47	4898	0	4984
2821	4922	5	11	60	0	4998
2822	61	5051	9	25	0	5146
2823	30	40	20	5138	0	5228
2824	31	10	9	5189	0	5239
2825	5081	4	10	70	0	5165
2826	5026	8	14	34	0	5082
2827	78	7	9	4939	0	5033
2828	33	8	4944	53	0	5038
2829	4900	6	50	31	0	4987
2830	63	2	5191	24	0	5280
2831	5227	4	56	22	0	5309
2832	5392	2	23	23	0	5440
2833	86	1	5296	20	0	5403
2834	34	5	62	5500	0	5601
2835	28	3	5713	62	0	5806
2836	31	6080	64	28	0	6203
2837	31	78	24	5860	0	5993
2838	29	6201	13	76	0	6319
2839	32	78	15	6282	0	6407
2840	23	19	6428	96	0	6566
2841	14	6467	93	39	0	6613
2842	15	6719	31	20	0	6785
2843	43	125	21	6747	0	6936
2844	6795	42	11	112	0	6960
2845	110	15	9	7382	0	7516
2846	7543	10	17	140	0	7710
2847	137	7682	12	51	0	7882
2848	8364	131	9	34	0	8538
2849	159	42	8619	32	0	8852
2850	88	14	150	8564	0	8816
2851	52	24	43	8637	0	8756
2852	23	9	8567	200	0	8799
2853	8334	15	140	78	0	8567
2854	8544	11	45	48	0	8648
2855	193	8452	32	23	0	8700
2856	83	193	22	7967	0	8265
2857	43	8368	24	144	0	8579
2858	32	166	8293	61	0	8552
2859	31	52	8376	45	0	8504
2860	42	127	189	7965	0	8323
2861	7784	25	61	149	0	8019
2862	145	7671	30	60	0	7906
2863	7739	143	17	36	0	7935
2864	163	56	7617	21	0	7857
2865	7688	25	147	22	0	7882
2866	7877	21	52	23	0	7973
2867	198	18	7740	18	0	7974
2868	82	14	154	7695	0	7945
2869	7753	20	50	160	0	7983
2870	7840	16	23	68	0	7947
2871	7885	11	34	36	0	7966
2872	210	15	22	7694	0	7941
2873	90	16	7622	153	0	7881
2874	7587	13	152	64	0	7816
2875	172	23	7711	38	0	7944
2876	77	18	158	7623	0	7876
2877	55	17	57	7645	0	7774
2878	42	7668	31	182	0	7923
2879	36	148	7631	73	0	7888
2880	40	7334	154	45	0	7573
2881	38	7593	59	37	0	7727
2882	52	178	38	7508	0	7776
2883	45	53	7509	172	0	7779
2884	45	39	153	7526	0	7763
2885	38	24	7559	183	0	7804
2886	49	17	177	7482	0	7725
2887	41	36	64	7559	0	7700
2888	43	28	7274	208	0	7553
2889	44	23	182	7274	0	7523
2890	39	21	7294	193	0	7547
2891	36	22	7263	88	0	7409
2892	34	7202	218	51	0	7505
2893	7241	156	77	64	0	7538
2894	178	56	7248	41	0	7523
2895	7158	40	176	59	0	7433
2896	195	31	72	7273	0	7571
2897	85	34	7227	174	0	7520
2898	46	7178	198	74	0	7496
2899	44	171	84	7194	0	7493
2900	46	65	7230	188	0	7529
2901	62	49	178	6916	0	7205
2902	59	7191	76	178	0	7504
2903	7242	166	49	87	0	7544
2904	189	65	54	7258	0	7566
2905	7122	52	37	199	0	7410
2906	7288	38	50	89	0	7465
2907	7274	31	55	76	0	7436
2908	7333	18	50	87	0	7488
2909	7259	33	42	70	0	7404
2910	241	7047	49	58	0	7395
2911	113	159	45	7048	0	7365
2912	75	63	42	7136	0	7316
2913	85	37	50	7115	0	7287
2914	64	41	6825	218	0	7148
2915	58	6777	162	106	0	7103
2916	6818	148	79	79	0	7124
2917	6842	68	61	66	0	7037
2918	216	6589	51	63	0	6919
2919	95	6729	57	64	0	6945
2920	6633	184	46	71	0	6934
2921	180	87	6466	49	0	6782
2922	88	74	177	6289	0	6628
2923	6263	36	88	178	0	6565
2924	200	28	59	6158	0	6445
2925	82	6162	60	177	0	6481
2926	79	148	37	6239	0	6503
2927	69	58	6235	177	0	6539
2928	6119	40	173	75	0	6407
2929	6310	36	68	61	0	6475
2930	228	23	56	5927	0	6234
2931	109	24	52	5980	0	6165
2932	5687	28	33	204	0	5952
2933	182	5611	40	96	0	5929
2934	78	126	47	5465	0	5716
2935	106	50	30	5412	0	5598
2936	4883	29	20	172	0	5104
2937	133	4900	32	90	0	5155
2938	4832	119	21	71	0	5043
2939	154	4699	25	52	0	4930
2940	75	4738	28	34	0	4875
2941	4470	111	23	38	0	4642
2942	112	4483	21	37	0	4653
2943	65	228	37	4165	0	4495
2944	39	40	4154	122	0	4355
2945	35	19	3508	38	0	3600
2946	19	16	3312	31	0	3378
2947	20	3161	100	23	0	3304
2948	2463	51	108	13	0	2635
2949	46	19	7	2293	0	2365
2950	18	8	6	2326	0	2358
2951	11	8	2284	49	0	2352
2952	2297	7	41	19	0	2364
2953	45	9	11	2331	0	2396
2954	21	3	6	2372	0	2402
2955	10	7	6	2364	0	2387
2956	2298	3	8	59	0	2368
2957	45	3	2255	19	0	2322
2958	2274	3	37	15	0	2329
2959	48	2	10	2272	0	2332
2960	18	6	2265	47	0	2336
2961	2230	3	42	19	0	2294
2962	43	3	2269	10	0	2325
2963	22	13	48	2224	0	2307
2964	10	2	2269	43	0	2324
2965	5	6	2191	18	0	2220
2966	2103	3	55	10	0	2171
2967	43	5	2118	7	0	2173
2968	19	3	44	2085	0	2151
2969	2078	2	23	48	0	2151
2970	45	6	18	2115	0	2184
2971	23	2	2087	49	0	2161
2972	13	2	2130	20	0	2165
2973	10	2125	53	15	0	2203
2974	16	35	20	2094	0	2165
2975	2034	15	14	46	0	2109
2976	41	2023	13	22	0	2099
2977	2043	36	13	13	0	2105
2978	46	14	6	2031	0	2097
2979	2010	5	7	51	0	2073
2980	47	1995	6	23	0	2071
2981	22	39	4	2007	0	2072
2982	2010	12	6	43	0	2071
2983	45	2019	7	20	0	2091
2984	23	38	4	2026	0	2091
2985	13	19	8	2027	0	2067
2986	2045	8	9	50	0	2112
2987	46	6	9	2035	0	2096
2988	15	8	9	2061	0	2093
2989	17	4	6	2095	0	2122
2990	5	5	1999	62	0	2071
2991	1998	6	42	26	0	2072
2992	47	3	19	2300	0	2369
2993	17	4	2417	61	0	2499
2994	2393	3	57	26	0	2479
2995	71	5	2465	10	0	2551
2996	22	1	64	2436	0	2523
2997	20	2480	24	64	0	2588
2998	13	60	14	2512	0	2599
2999	12	24	2512	66	0	2614
3000	10	4	2628	28	0	2670
3001	13	10	75	2629	0	2727
3002	14	12	2615	74	0	2715
3003	2564	6	71	30	0	2671
3004	69	8	2605	22	0	2704
3005	29	5	69	2575	0	2678
3006	13	8	26	2635	0	2682
3007	17	0	16	2636	0	2669
3008	2569	8	12	81	0	2670
3009	2603	8	14	33	0	2658
3010	2667	1	14	24	0	2706
3011	82	6	10	2608	0	2706
3012	33	5	11	2643	0	2692
3013	17	3	2552	87	0	2659
3014	19	2	2583	31	0	2635
3015	12	2556	76	27	0	2671
3016	15	64	25	2374	0	2478
3017	13	14	6	2355	0	2388
3018	10	2352	16	64	0	2442
3019	2367	52	15	24	0	2458
3020	63	2369	8	15	0	2455
3021	2374	56	13	17	0	2460
3022	65	13	7	2360	0	2445
3023	2384	12	11	65	0	2472
3024	60	5	12	2389	0	2466
3025	18	12	2325	68	0	2423
3026	16	6	63	2361	0	2446
3027	2316	3	21	72	0	2412
3028	67	5	16	2345	0	2433
3029	21	5	9	2365	0	2400
3030	13	8	2352	75	0	2448
3031	18	2	57	2384	0	2461
3032	14	4	21	2353	0	2392
3033	12	2295	10	75	0	2392
3034	11	53	3	2334	0	2401
3035	14	13	11	2359	0	2397
3036	20	5	6	2324	0	2355
3037	12	2133	7	72	0	2224
3038	11	44	2	2042	0	2099
3039	1946	10	5	57	0	2018
3040	37	1863	9	32	0	1941
3041	17	1770	3	15	0	1805
3042	7	1752	4	19	0	1782
3043	8	59	7	1676	0	1750
3044	10	1648	13	52	0	1723
3045	9	1734	19	21	0	1783
3046	1708	32	21	14	0	1775
3047	36	12	1662	13	0	1723
3048	1644	10	36	20	0	1710
3049	30	15	12	1676	0	1733
3050	5	3	1680	50	0	1738
3051	1630	8	51	18	0	1707
3052	36	7	1652	14	0	1709
3053	11	6	1626	19	0	1662
3054	1673	3	58	8	0	1742
3055	51	7	18	1724	0	1800
3056	11	6	1750	53	0	1820
3057	1734	2	41	34	0	1811
3058	1804	0	11	28	0	1843
3059	54	4	1820	22	0	1900
3060	1909	3	35	21	0	1968
3061	1964	0	10	23	0	1997
3062	61	2	1888	22	0	1973
3063	1873	1	48	28	0	1950
3064	1943	6	18	22	0	1989
3065	44	6	1869	18	0	1937
3066	10	9	2088	20	0	2127
3067	8	17	46	2103	0	2174
3068	8	8	2108	62	0	2186
3069	2136	11	44	20	0	2211
3070	52	20	6	2116	0	2194
3071	26	11	4	2171	0	2212
3072	20	16	2089	53	0	2178
3073	27	6	41	2075	0	2149
3074	13	6	2098	60	0	2177
3075	2118	3	45	21	0	2187
3076	2162	4	11	31	0	2208
3077	54	6	2125	17	0	2202
3078	2137	3	39	32	0	2211
3079	2197	4	10	23	0	2234
3080	44	3	2174	31	0	2252
3081	2213	3	47	29	0	2292
3082	2247	5	19	26	0	2297
3083	45	4	2231	32	0	2312
3084	2212	9	42	29	0	2292
3085	44	12	2257	27	0	2340
3086	11	5	45	2286	0	2347
3087	11	9	6	2311	0	2337
3088	14	9	3	2363	0	2389
3089	7	16	2268	62	0	2353
3090	2165	5	37	33	0	2240
3091	56	10	2204	14	0	2284
3092	9	1855	24	2	0	1890
3093	3	1846	2	5	0	1856
3094	1832	14	16	5	0	1867
3095	18	5	1	1796	0	1820
3096	1	1805	4	14	0	1824
3097	1772	14	0	1	0	1787
3098	1803	0	0	3	0	1806
3099	15	1882	2	2	0	1901
3100	4	15	0	1771	0	1790
3101	0	1811	2	13	0	1826
3102	1852	17	1	2	0	1872
3103	1880	0	0	3	0	1883
3104	17	1	0	1831	0	1849
3105	1833	0	1	18	0	1852
3106	16	1	1	1831	0	1849
3107	1	0	1825	19	0	1845
3108	1784	0	17	2	0	1803
3109	18	1	1815	1	0	1835
3110	4	0	18	1788	0	1810
3111	1817	0	2	20	0	1839
3112	17	1	2	1829	0	1849
3113	2	0	1810	18	0	1830
3114	4	0	1764	2	0	1770
3115	4	8	17	1786	0	1815
3116	1790	2	5	18	0	1815
3117	17	1821	2	1	0	1841
3118	3	14	2	1845	0	1864
3119	1	1	1881	18	0	1901
3120	1860	1	16	6	0	1883
3121	1943	1	1	6	0	1951
3122	18	4	1924	2	0	1948
3123	1927	1	17	3	0	1948
3124	23	0	4	2008	0	2035
3125	5	0	2010	15	0	2030
3126	1996	3	15	3	0	2017
3127	18	1	3	2012	0	2034
3128	5	0	4	2004	0	2013
3129	2024	1	2	23	0	2050
3130	20	1968	1	9	0	1998
3131	5	2025	5	2	0	2037
3132	2029	19	2	2	0	2052
3133	1998	4	1	5	0	2008
3134	19	2	2058	2	0	2081
3135	9	1	2048	0	0	2058
3136	7	1	17	2101	0	2126
3137	2160	0	7	20	0	2187
3138	2165	0	3	7	0	2175
3139	2186	2	3	5	0	2196
3140	19	2119	7	8	0	2153
3141	9	2211	3	2	0	2225
3142	5	21	2	2268	0	2296
3143	3	4	3	2247	0	2257
3144	4	2	2	2329	0	2337
3145	3	3	2341	30	0	2377
3146	6	2	2168	10	0	2186
3147	2313	2	31	4	0	2350
3148	2437	2	10	4	0	2453
3149	32	2	4	2407	0	2445
3150	14	5	1	2393	0	2413
3151	10	1	2	2435	0	2448
3152	4	1	2362	35	0	2402
3153	8	4	2358	14	0	2384
3154	11	3	25	2382	0	2421
3155	6	2	2417	21	0	2446
3156	7	2319	22	8	0	2356
3157	2	2396	10	8	0	2416
3158	2367	27	7	7	0	2408
3159	21	2314	1	5	0	2341
3160	9	1288	1	1056	0	2354
3161	6	22	4	2319	0	2351
3162	5	2392	3	21	0	2421
3163	4	21	4	2412	0	2441
3164	1	12	2383	26	0	2422
3165	6	2366	18	12	0	2402
3166	4	24	9	2261	0	2298
3167	5	9	2240	25	0	2279
3168	5	2203	20	12	0	2240
3169	5	19	10	2169	0	2203
3170	4	2203	6	17	0	2230
3171	2	24	3	2193	0	2222
3172	3	9	3	2164	0	2179
3173	2	2170	3	28	0	2203
3174	2128	21	3	13	0	2165
3175	2088	13	2	6	0	2109
3176	26	2093	3	8	0	2130
3177	12	2140	1	6	0	2159
3178	8	26	0	2142	0	2176
3179	2	15	2117	19	0	2153
3180	2052	8	18	10	0	2088
3181	2079	2	8	10	0	2099
3182	27	5	2056	0	0	2088
3183	2024	2	21	5	0	2052
3184	2092	1	10	4	0	2107
3185	27	4	2032	3	0	2066
3186	1972	3	19	2	0	1996
3187	23	5	2090	4	0	2122
3188	11	2092	22	3	0	2128
3189	2115	18	7	9	0	2149
3190	2118	10	4	5	0	2137
3191	27	4	2125	5	0	2161
3192	2144	2	20	4	0	2170
3193	2209	3	8	7	0	2227
3194	27	4	2195	3	0	2229
3195	2246	4	17	2	0	2269
3196	2285	0	8	6	0	2299
3197	30	0	2266	1	0	2297
3198	2280	2	18	6	0	2306
3199	20	0	12	2183	0	2215
3200	12	1	6	2198	0	2217
3201	7	1	2166	28	0	2202
3202	4	0	2088	13	0	2105
3203	4	5	27	2164	0	2200
3204	4	4	12	2192	0	2212
3205	2317	3	4	28	0	2352
3206	22	4	2290	12	0	2328
3207	2313	1	20	5	0	2339
3208	30	3	10	2419	0	2462
3209	11	2	2470	21	0	2504
3210	2590	1	23	15	0	2629
3211	29	1	10	2749	0	2789
3212	14	2	2782	27	0	2825
3213	2749	0	24	18	0	2791
3214	24	3	12	2835	0	2874
3215	2877	1	4	27	0	2909
3216	46	1	2981	13	0	3041
3217	17	2	25	2863	0	2907
3218	5	3054	15	23	0	3097
3219	3064	25	8	18	0	3115
3220	3061	14	2	6	0	3083
3221	41	3091	5	6	0	3143
3222	3156	31	4	4	0	3195
3223	3146	14	1	10	0	3171
3224	3107	3	7	6	0	3123
3225	48	3061	2	5	0	3116
3226	17	30	1	3110	0	3158
3227	9	12	3132	34	0	3187
3228	11	7	35	3076	0	3129
3229	3	1	17	3138	0	3159
3230	4	1	3113	48	0	3166
3231	7	3	3045	15	0	3070
3232	9	2	42	2998	0	3051
3233	5	3125	16	24	0	3170
3234	3132	35	9	9	0	3185
3235	3076	10	3	7	0	3096
3236	49	3168	1	9	0	3227
3237	3217	33	0	6	0	3256
3238	3196	14	4	8	0	3222
3239	47	7	3188	3	0	3245
3240	3146	3	38	11	0	3198
3241	37	3282	12	11	0	3342
3242	13	32	3234	4	0	3283
3243	6	14	3151	9	0	3180
3244	1	3194	40	5	0	3240
3245	3195	25	10	4	0	3234
3246	30	13	3237	5	0	3285
3247	16	4	23	3235	0	3278
3248	11	3	3225	24	0	3263
3249	3105	4	28	12	0	3149
3250	31	5	3680	5	0	3721
3251	20	3	3624	4	0	3651
3252	3643	1	32	2	0	3678
3253	28	3789	13	2	0	3832
3254	3906	27	3	9	0	3945
3255	3941	9	5	10	0	3965
3256	37	5	7	3903	0	3952
3257	14	4219	2	21	0	4256
3258	4297	24	4	25	0	4350
3259	29	10	4343	4	0	4386
3260	4247	3	25	7	0	4282
3261	27	4398	14	13	0	4452
3262	4399	22	7	1	0	4429
3263	4370	7	9	4	0	4390
3264	33	4453	5	6	0	4497
3265	15	23	6	4514	0	4558
3266	4580	10	3	24	0	4617
3267	37	4551	3	6	0	4597
3268	13	25	4	4585	0	4627
3269	4682	8	4	27	0	4721
3270	33	7	6	4838	0	4884
3271	21	5	5	4815	0	4846
3272	11	4850	4	35	0	4900
3273	4868	28	3	21	0	4920
3274	4920	14	8	8	0	4950
3275	5000	8	2	16	0	5026
3276	45	5103	6	6	0	5160
3277	5177	26	7	11	0	5221
3278	5187	12	7	11	0	5217
3279	48	9	2	5133	0	5192
3280	24	8	3	5152	0	5187
3281	18	4	5148	38	0	5208
3282	10	7	30	5066	0	5113
3283	12	8	11	4924	0	4955
3284	18	4	5118	42	0	5182
3285	4747	9	32	26	0	4814
3286	41	6	5126	10	0	5183
3287	22	5	5145	5	0	5177
3288	20	4	37	5146	0	5207
3289	12	9	15	5168	0	5204
3290	12	5206	9	37	0	5264
3291	5216	33	4	20	0	5273
3292	5182	10	7	17	0	5216
3293	37	5147	10	9	0	5203
3294	21	5398	5	14	0	5438
3295	15	43	9	5393	0	5460
3296	9	5566	7	35	0	5617
3297	5572	39	10	14	0	5635
3298	5571	16	8	11	0	5606
3299	66	8	7	5525	0	5606
3300	24	9	9	5581	0	5623
3301	5568	2	4	63	0	5637
3302	54	10	5431	19	0	5514
3303	5402	6	46	11	0	5465
3304	61	7	5433	5	0	5506
3305	5315	0	43	16	0	5374
3306	50	9	11	5372	0	5442
3307	20	6	5430	38	0	5494
3308	23	5	5245	12	0	5285
3309	5203	12	68	16	0	5299
3310	5264	5	16	12	0	5297
3311	45	5308	9	7	0	5369
3312	15	38	5	5417	0	5475
3313	15	12	5	5502	0	5534
3314	5443	6	8	57	0	5514
3315	46	5398	3	18	0	5465
3316	5272	35	2	19	0	5328
3317	43	5214	4	10	0	5271
3318	12	5191	3	5	0	5211
3319	5183	40	2	11	0	5236
3320	47	16	5132	4	0	5199
3321	14	15	36	5068	0	5133
3322	14	5	8	5113	0	5140
3323	6	13	5125	49	0	5193
3324	10	5	36	5082	0	5133
3325	15	9	17	4607	0	4648
3326	8	5102	9	50	0	5169
3327	5078	36	5	24	0	5143
3328	42	11	5115	12	0	5180
3329	4916	4	37	17	0	4974
3330	40	5116	14	13	0	5183
3331	18	33	7	5165	0	5223
3332	5288	13	4	54	0	5359
3333	50	5	4	5302	0	5361
3334	16	5	11	5309	0	5341
3335	16	2	5278	47	0	5343
3336	5014	6	35	23	0	5078
3337	5189	4	15	19	0	5227
3338	49	5	5224	10	0	5288
3339	26	2	36	5162	0	5226
3340	12	4	5178	39	0	5233
3341	5057	4	42	30	0	5133
3342	5227	3	15	20	0	5265
3343	51	7	8	5218	0	5284
3344	5228	1	5	49	0	5283
3345	48	2	5508	19	0	5577
3346	26	4	39	5456	0	5525
3347	20	4	13	5466	0	5503
3348	16	2	12	5623	0	5653
3349	13	4	4	5621	0	5642
3350	5118	1	6	70	0	5195
3351	45	6	5063	23	0	5137
3352	24	2	41	5122	0	5189
3353	10	4	5012	53	0	5079
3354	14	2	4893	21	0	4930
3355	4	2	49	4880	0	4935
3356	13	4	17	4944	0	4978
3357	4700	2	12	59	0	4773
3358	45	3	7	4691	0	4746
3359	17	0	6	4721	0	4744
3360	10	3	10	4760	0	4783
3361	4692	1	10	77	0	4780
3362	4731	0	2	35	0	4768
3363	4807	1	9	21	0	4838
3364	4707	5	5	21	0	4738
3365	59	5088	5	14	0	5166
3366	18	69	4	5104	0	5195
3367	31	18	1	5216	0	5266
3368	5402	13	6	101	0	5522
3369	97	5728	5	43	0	5873
3370	34	107	3	6078	0	6222
3371	23	19	6511	114	0	6667
3372	6991	13	124	33	0	7161
3373	165	7360	21	19	0	7565
3374	7732	162	16	18	0	7928
3375	8073	37	5	12	0	8127
3376	255	15	4	7939	0	8213
3377	55	13	7927	200	0	8195
3378	45	5	186	8119	0	8355
3379	8182	7	42	216	0	8447
3380	227	4	16	8172	0	8419
3381	8208	5	15	211	0	8439
3382	221	8159	7	64	0	8451
3383	8487	193	7	38	0	8725
3384	240	44	7	8564	0	8855
3385	82	17	5	9157	0	9261
3386	9157	13	6	265	0	9441
3387	9275	7	6	71	0	9359
3388	9328	7	3	50	0	9388
3389	9319	13	5	32	0	9369
3390	9310	7	7	35	0	9359
3391	309	7	5	9040	0	9361
3392	94	20	8699	232	0	9045
3393	56	8860	178	70	0	9164
3394	8670	197	52	42	0	8961
3395	239	57	8451	29	0	8776
3396	8454	18	194	38	0	8704
3397	241	8445	49	30	0	8765
3398	8586	201	22	33	0	8842
3399	255	55	15	8534	0	8859
3400	116	18	10	8707	0	8851
3401	58	30	8544	256	0	8888
3402	70	13	199	8520	0	8802
3403	45	15	8688	227	0	8975
3404	56	12	8754	89	0	8911
3405	8734	19	244	51	0	9048
3406	9063	12	62	70	0	9207
3407	280	23	8780	57	0	9140
3408	8777	22	214	58	0	9071
3409	9012	18	51	57	0	9138
3410	302	26	8668	47	0	9043
3411	117	8521	199	99	0	8936
3412	118	203	59	8806	0	9186
3413	9025	59	47	234	0	9365
3414	9272	39	31	78	0	9420
3415	9301	28	24	67	0	9420
3416	9317	25	28	63	0	9433
3417	9315	17	36	68	0	9436
3418	327	23	8973	51	0	9374
3419	150	25	9179	49	0	9403
3420	131	36	242	9185	0	9594
3421	9292	35	73	242	0	9642
3422	9499	30	43	95	0	9667
3423	9454	27	45	76	0	9602
3424	9004	34	44	83	0	9165
3425	305	8909	38	86	0	9338
3426	158	9446	42	87	0	9733
3427	9522	217	36	90	0	9865
3428	9652	60	35	90	0	9837
3429	332	9469	39	72	0	9912
3430	9641	204	35	77	0	9957
3431	332	59	9503	69	0	9963
3432	183	37	222	9452	0	9894
3433	136	32	9495	250	0	9913
3434	155	24	9446	144	0	9769
3435	143	31	251	9474	0	9899
3436	146	26	74	9763	0	10009
3437	157	27	9742	263	0	10189
3438	142	31	222	9579	0	9974
3439	137	34	75	9923	0	10169
3440	9810	31	67	290	0	10198
3441	9935	32	60	113	0	10140
3442	332	40	59	9756	0	10187
3443	165	31	9655	254	0	10105
3444	124	9687	241	102	0	10154
3445	9588	211	85	76	0	9960
3446	309	57	9652	69	0	10087
3447	159	9211	246	63	0	9679
3448	121	9873	98	83	0	10175
3449	9924	212	82	72	0	10290
3450	10152	66	84	63	0	10365
3451	331	41	63	9952	0	10387
3452	146	43	10312	250	0	10751
3453	155	33	250	10284	0	10722
3454	141	32	89	10509	0	10771
3455	142	27	74	10598	0	10841
3456	10427	26	63	283	0	10799
3457	332	10058	71	96	0	10557
3458	158	10551	57	79	0	10845
3459	120	235	64	10317	0	10736
3460	116	79	67	10682	0	10944
3461	10500	43	55	300	0	10898
3462	10576	33	58	118	0	10785
3463	10567	35	43	86	0	10731
3464	364	10289	43	66	0	10762
3465	9959	180	42	56	0	10237
3466	297	108	43	9759	0	10207
3467	145	25	9663	219	0	10052
3468	120	32	9066	81	0	9299
3469	8821	20	189	67	0	9097
3470	197	11	8454	47	0	8709
3471	96	17	7885	40	0	8038
3472	7086	17	104	28	0	7235
3473	103	9	7044	17	0	7173
3474	36	11	6713	10	0	6770
3475	38	72	58	6342	0	6510
3476	19	3	6585	38	0	6645
3477	9	8	40	6406	0	6463
3478	14	10	13	6382	0	6419
3479	15	1	6623	39	0	6678
3480	5	6665	35	16	0	6721
3481	6673	31	13	15	0	6732
3482	34	10	6805	7	0	6856
3483	17	7	6601	7	0	6632
3484	5965	5	35	18	0	6023
3485	30	4	6256	5	0	6295
3486	8	6001	26	6	0	6041
3487	10	5366	20	9	0	5405
3488	4	22	9	6163	0	6198
3489	8	3	2	6089	0	6102
3490	6271	2	5	32	0	6310
3491	6247	5	1	16	0	6269
3492	6277	3	2	13	0	6295
3493	35	8	4	6265	0	6312
3494	6295	4	2	44	0	6345
3495	6265	3	4	19	0	6291
3496	30	3	6298	5	0	6336
3497	15	4	6123	6	0	6148
3498	6	6371	26	6	0	6409
3499	9	22	7	6430	0	6468
3500	6465	4	3	35	0	6507
3501	26	6400	5	10	0	6441
3502	9	25	8	6525	0	6567
3503	6482	9	2	40	0	6533
3504	6334	2	4	16	0	6356
3505	34	6431	5	15	0	6485
3506	6414	25	3	13	0	6455
3507	6468	6	8	13	0	6495
3508	35	4	3	6486	0	6528
3509	15	4	6517	28	0	6564
3510	7	6357	31	14	0	6409
3511	7	6464	9	8	0	6488
3512	6235	36	7	12	0	6290
3513	33	7	6	6243	0	6289
3514	11	7	6316	29	0	6363
3515	10	6335	27	10	0	6382
3516	6374	30	11	24	0	6439
3517	6441	7	7	15	0	6470
3518	41	8	6531	11	0	6591
3519	15	3	37	6400	0	6455
3520	22	5	8	6744	0	6779
3521	12	11	7312	45	0	7380
3522	7476	7	51	28	0	7562
3523	8777	9	17	24	0	8827
3524	125	5	16	9584	0	9730
3525	47	9799	8	132	0	9986
3526	48	126	7	10301	0	10482
3527	23	51	10241	172	0	10487
3528	10243	33	139	96	0	10511
3529	176	23	59	10615	0	10873
3530	76	27	10515	171	0	10789
3531	10365	19	157	106	0	10647
3532	181	16	74	10533	0	10804
3533	112	6	59	10591	0	10768
3534	10524	4	37	228	0	10793
3535	169	10537	38	133	0	10877
3536	10547	140	37	94	0	10818
3537	236	64	24	10416	0	10740
3538	10445	40	18	201	0	10704
3539	219	27	10364	108	0	10718
3540	120	10414	153	79	0	10766
3541	101	169	77	10560	0	10907
3542	10625	77	49	214	0	10965
3543	181	10631	45	117	0	10974
3544	136	184	30	10733	0	11083
3545	10788	89	32	209	0	11118
3546	10702	62	35	120	0	10919
3547	276	40	16	10520	0	10852
3548	149	33	10333	215	0	10730
3549	97	41	10252	116	0	10506
3550	10182	34	216	106	0	10538
3551	218	10135	112	76	0	10541
3552	137	10002	73	54	0	10266
3553	9824	208	56	78	0	10166
3554	181	10044	52	58	0	10335
3555	121	190	54	10006	0	10371
3556	129	105	24	10164	0	10422
3557	10071	82	24	261	0	10438
3558	9942	67	29	136	0	10174
3559	10030	58	19	105	0	10212
3560	299	45	9712	73	0	10129
3561	175	34	147	9759	0	10115
3562	146	34	9745	194	0	10119
3563	158	31	9610	129	0	9928
3564	93	26	9983	85	0	10187
3565	93	36	273	9837	0	10239
3566	78	26	10035	211	0	10350
3567	70	43	10190	114	0	10417
3568	70	41	273	10119	0	10503
3569	10138	26	169	241	0	10574
3570	217	32	10280	114	0	10643
3571	121	26	216	10158	0	10521
3572	110	26	132	10389	0	10657
3573	90	17	10391	269	0	10767
3574	83	36	213	10313	0	10645
3575	90	27	10427	282	0	10826
3576	78	29	262	10204	0	10573
3577	73	31	129	10352	0	10585
3578	70	29	99	10366	0	10564
3579	66	31	84	10310	0	10491
3580	9941	24	73	353	0	10391
3581	9965	14	72	226	0	10277
3582	267	34	9750	146	0	10197
3583	157	9666	197	138	0	10158
3584	108	160	9901	125	0	10294
3585	109	74	9869	95	0	10147
3586	9681	54	284	101	0	10120
3587	246	9950	164	93	0	10453
3588	10020	185	139	92	0	10436
3589	255	10138	107	77	0	10577
3590	10104	226	100	83	0	10513
3591	10252	106	105	63	0	10526
3592	332	83	68	10031	0	10514
3593	185	10136	54	236	0	10611
3594	131	210	56	10260	0	10657
3595	106	105	55	10423	0	10689
3596	110	77	10178	339	0	10704
3597	97	10301	222	180	0	10800
3598	86	199	115	10408	0	10808
3599	10366	111	91	288	0	10856
3600	10703	71	80	173	0	11027
3601	10778	47	88	147	0	11060
3602	315	10587	72	114	0	11088
3603	10874	225	65	97	0	11261
3604	307	11261	68	99	0	11735
3605	169	265	58	11490	0	11982
3606	156	110	11449	265	0	11980
3607	124	97	255	11331	0	11807
3608	105	11399	123	300	0	11927
3609	90	260	102	11439	0	11891
3610	82	111	67	11529	0	11789
3611	53	11456	54	379	0	11942
3612	11472	259	65	192	0	11988
3613	268	128	56	11415	0	11867
3614	134	95	11118	329	0	11676
3615	117	72	241	11247	0	11677
3616	96	40	107	11618	0	11861
3617	74	65	11458	394	0	11991
3618	100	63	256	11084	0	11503
3619	83	11338	113	356	0	11890
3620	102	257	11267	192	0	11818
3621	116	109	10810	133	0	11168
3622	44	10312	303	106	0	10765
3623	42	9216	122	76	0	9456
3624	38	8586	70	39	0	8733
3625	8020	192	177	57	0	8446
3626	7731	49	41	40	0	7861
3627	7679	23	15	28	0	7745
3628	169	26	17	7564	0	7776
3629	44	20	7436	147	0	7647
3630	32	16	133	7392	0	7573
3631	33	19	36	7491	0	7579
3632	7366	13	21	159	0	7559
3633	7389	17	16	63	0	7485
3634	154	7333	14	31	0	7532
3635	7315	130	8	34	0	7487
3636	7390	35	10	30	0	7465
3637	7464	18	14	29	0	7525
3638	168	14	7258	23	0	7463
3639	51	17	7239	27	0	7334
3640	36	31	148	7128	0	7343
3641	20	18	7131	128	0	7297
3642	6984	19	122	47	0	7172
3643	7135	19	29	30	0	7213
3644	156	15	6868	19	0	7058
3645	6799	14	118	23	0	6954
3646	140	6841	38	17	0	7036
3647	6923	123	20	19	0	7085
3648	147	29	16	6819	0	7011
3649	51	23	18	6709	0	6801
3650	31	6812	16	144	0	7003
3651	6822	127	8	53	0	7010
3652	6901	38	15	21	0	6975
3653	152	6796	9	32	0	6989
3654	51	131	12	6684	0	6878
3655	35	42	16	6703	0	6796
3656	34	6653	15	152	0	6854
3657	34	133	11	6662	0	6840
3658	29	37	19	6806	0	6891
3659	6640	22	15	163	0	6840
3660	6701	18	13	65	0	6797
3661	150	19	6583	35	0	6787
3662	6535	13	118	35	0	6701
3663	142	21	6500	29	0	6692
3664	47	25	119	6392	0	6583
3665	43	14	6374	128	0	6559
3666	33	6321	116	46	0	6516
3667	40	123	49	6128	0	6340
3668	42	30	26	6203	0	6301
3669	6098	20	16	141	0	6275
3670	121	21	15	6031	0	6188
3671	45	17	5853	120	0	6035
3672	5963	15	94	53	0	6125
3673	6061	17	28	33	0	6139
3674	6156	18	19	30	0	6223
3675	6096	14	11	39	0	6160
3676	150	18	14	6274	0	6456
3677	59	13	14	6507	0	6593
3678	45	9	11	6714	0	6779
3679	36	9	16	6801	0	6862
3680	6614	9	18	176	0	6817
3681	6635	6	16	74	0	6731
3682	175	10	21	6326	0	6532
3683	58	6391	17	145	0	6611
3684	6400	122	21	60	0	6603
3685	151	42	6346	29	0	6568
3686	59	6349	129	26	0	6563
3687	6078	119	24	30	0	6251
3688	132	6133	18	27	0	6310
3689	47	112	6104	21	0	6284
3690	6120	29	123	28	0	6300
3691	6212	23	28	24	0	6287
3692	162	13	6061	15	0	6251
3693	57	16	113	6134	0	6320
3694	40	13	34	6114	0	6201
3695	38	6094	13	143	0	6288
3696	41	121	16	6070	0	6248
3697	5912	32	8	145	0	6097
3698	136	5894	12	49	0	6091
3699	39	120	6	5622	0	5787
3700	34	30	9	5669	0	5742
3701	29	17	5469	139	0	5654
3702	25	5440	110	44	0	5619
3703	5062	119	30	38	0	5249
3704	101	4533	13	20	0	4667
3705	23	4362	15	16	0	4416
3706	4301	88	34	10	0	4433
3707	90	26	12	4180	0	4308
3708	23	13	7	4252	0	4295
3709	4203	9	2	99	0	4313
3710	89	4	5	4241	0	4339
3711	23	8	2	4301	0	4334
3712	4362	5	1	106	0	4474
3713	97	7	1	4276	0	4381
3714	21	4224	5	98	0	4348
3715	4222	75	6	29	0	4332
3716	82	18	4028	21	0	4149
3717	23	3856	72	14	0	3965
3718	15	79	19	3666	0	3779
3719	11	16	3611	68	0	3706
3720	11	10	3595	21	0	3637
3721	21	139	70	3261	0	3491
3722	3272	5	34	65	0	3376
3723	62	4	7	3224	0	3297
3724	21	3	4	3278	0	3306
3725	14	5	5	3292	0	3316
3726	11	4	1	3294	0	3310
3727	8	4	5	3316	0	3333
3728	5	8	3176	77	0	3266
3729	11	3	3117	26	0	3157
3730	11	8	57	3144	0	3220
3731	8	5	3154	60	0	3227
3732	11	3143	57	21	0	3232
3733	9	53	17	3165	0	3244
3734	4	15	3119	56	0	3194
3735	2921	10	54	20	0	3005
3736	53	3017	15	21	0	3106
3737	13	2960	7	10	0	2990
3738	13	3022	5	8	0	3048
3739	15	60	5	2960	0	3040
3740	2961	25	5	58	0	3049
3741	54	9	2	2973	0	3038
3742	2902	11	4	66	0	2983
3743	55	2825	8	25	0	2913
3744	2881	56	2	16	0	2955
3745	65	11	3	2885	0	2964
3746	21	15	4	2894	0	2934
3747	13	2828	2	66	0	2909
3748	11	50	5	2856	0	2922
3749	6	18	5	2904	0	2933
3750	6	8	4	2883	0	2901
3751	2785	4	5	80	0	2874
3752	2665	7	8	33	0	2713
3753	53	8	2743	23	0	2827
3754	2756	6	50	14	0	2826
3755	66	2	2775	15	0	2858
3756	18	12	56	2744	0	2830
3757	18	3	14	2802	0	2837
3758	10	6	15	2823	0	2854
3759	5	7	2757	72	0	2841
3760	11	8	55	2760	0	2834
3761	8	6	2790	68	0	2872
3762	8	9	56	2801	0	2874
3763	2783	7	17	73	0	2880
3764	59	3	2796	26	0	2884
3765	2790	6	50	29	0	2875
3766	59	5	16	2839	0	2919
3767	2824	6	12	65	0	2907
3768	58	2817	7	29	0	2911
3769	19	51	7	2856	0	2933
3770	18	16	2899	61	0	2994
3771	8	18	53	2889	0	2968
3772	10	44	13	2806	0	2873
3773	9	2813	12	68	0	2902
3774	11	46	2758	32	0	2847
3775	9	2695	51	22	0	2777
3776	2349	39	19	22	0	2429
3777	29	2374	13	7	0	2423
3778	2189	25	26	11	0	2251
3779	2202	10	7	8	0	2227
3780	2175	7	2	13	0	2197
3781	34	3	2	2183	0	2222
3782	14	3	2180	30	0	2227
3783	13	3	22	2153	0	2191
3784	4	2195	7	34	0	2240
3785	3	26	8	2205	0	2242
3786	2168	9	9	31	0	2217
3787	26	2170	7	16	0	2219
3788	11	24	2	2090	0	2127
3789	10	6	5	2097	0	2118
3790	2071	8	3	34	0	2116
3791	26	6	2063	18	0	2113
3792	10	1995	27	12	0	2044
3793	2	17	7	1914	0	1940
3794	3	3	1894	20	0	1920
3795	2	12	19	1839	0	1872
3796	1	1853	8	24	0	1886
3797	7	17	4	1928	0	1956
3798	3	6	4	1908	0	1921
3799	5	5	1	1893	0	1904
3800	4	4	1875	23	0	1906
3801	1837	1	19	11	0	1868
3802	24	0	6	1997	0	2027
3803	2154	3	6	22	0	2185
3804	2213	3	3	7	0	2226
3805	2230	3	3	11	0	2247
3806	2200	2	2	9	0	2213
3807	2222	3	3	5	0	2233
3808	30	4	1	2193	0	2228
3809	7	2156	5	21	0	2189
3810	10	18	1	2106	0	2135
3811	7	2094	1	19	0	2121
3812	8	24	3	1967	0	2002
3813	1984	2	2	14	0	2002
3814	16	4	1	1958	0	1979
3815	7	1	1957	14	0	1979
3816	1883	3	13	8	0	1907
3817	14	1970	2	5	0	1991
3818	1977	12	10	6	0	2005
3819	1973	4	0	5	0	1982
3820	1923	1	0	6	0	1930
3821	16	2016	0	2	0	2034
3822	6	13	0	2015	0	2034
3823	5	2	2	2030	0	2039
3824	4	1	2021	16	0	2042
3825	4	3	14	1949	0	1970
3826	5	0	2	1918	0	1925
3827	3	3	1	2000	0	2007
3828	2	2021	0	19	0	2042
3829	2020	17	1	5	0	2043
3830	1995	2	0	11	0	2008
3831	16	3	2060	7	0	2086
3832	6	2081	15	3	0	2105
3833	5	15	2	2131	0	2153
3834	5	4	1	2146	0	2156
3835	4	2	2	2147	0	2155
3836	8	2	1	2157	0	2168
3837	7	2	0	2199	0	2208
3838	5	0	2177	19	0	2201
3839	7	1	2048	8	0	2064
3840	2200	3	19	4	0	2226
3841	2277	3	4	6	0	2290
3842	2289	2	4	5	0	2300
3843	22	2	2	2327	0	2353
3844	7	5	2298	19	0	2329
3845	2283	0	15	10	0	2308
3846	2336	1	5	6	0	2348
3847	19	1	2293	5	0	2318
3848	2283	2	15	1	0	2301
3849	21	2	2511	3	0	2537
3850	10	0	18	2544	0	2572
3851	5	1	2565	20	0	2591
3852	2513	2	18	5	0	2538
3853	2602	2	4	5	0	2613
3854	2604	1	2	6	0	2613
3855	2613	0	5	4	0	2622
3856	25	1	2716	2	0	2744
3857	7	2719	19	4	0	2749
3858	2751	18	10	6	0	2785
3859	2759	4	6	2	0	2771
3860	27	2	2759	0	0	2788
3861	13	1	19	2695	0	2728
3862	7	1	2	2785	0	2795
3863	2	2	2750	24	0	2778
3864	2609	1	20	10	0	2640
3865	2737	1	3	6	0	2747
3866	24	2726	3	9	0	2762
3867	2851	20	2	7	0	2880
3868	2853	3	3	4	0	2863
3869	2870	3	1	4	0	2878
3870	2793	2	2	1	0	2798
3871	30	0	2727	1	0	2758
3872	2678	0	20	2	0	2700
3873	27	9	4	2708	0	2748
3874	6	2741	4	25	0	2776
3875	7	17	2719	4	0	2747
3876	5	2752	20	3	0	2780
3877	10	43	6	2613	0	2672
3878	7	2	2668	16	0	2693
3879	2514	2	19	6	0	2541
3880	18	1	2678	3	0	2700
3881	2643	2	19	5	0	2669
3882	22	2	3	2670	0	2697
3883	6	3	5	2663	0	2677
3884	5	2626	4	15	0	2650
3885	4	2728	1	8	0	2741
3886	6	15	2	2822	0	2845
3887	2796	3	5	18	0	2822
3888	2775	2	6	7	0	2790
3889	2766	1	2	6	0	2775
3890	24	2	2799	3	0	2828
3891	2743	1	16	6	0	2766
3892	21	2	2911	3	0	2937
3893	24	5	2738	6	0	2773
3894	2806	3	19	3	0	2831
3895	2914	1	9	6	0	2930
3896	23	1	2924	3	0	2951
3897	8	0	25	2896	0	2929
3898	9	2	4	3000	0	3015
3899	3005	0	6	21	0	3032
3900	2960	3	3	7	0	2973
3901	28	2	3108	6	0	3144
3902	7	2996	16	4	0	3023
3903	8	2932	4	1	0	2945
3904	2953	20	7	2	0	2982
3905	21	4	4	2955	0	2984
3906	7	2	0	3015	0	3024
3907	6	0	0	3065	0	3071
3908	3030	2	3	20	0	3055
3909	19	1	2	3063	0	3085
3910	3087	1	1	23	0	3112
3911	3177	2	2	5	0	3186
3912	28	3394	4	7	0	3433
3913	15	22	2	3705	0	3744
3914	6	6	3737	30	0	3779
3915	3629	2	32	15	0	3678
3916	3770	1	13	9	0	3793
3917	3768	0	8	6	0	3782
3918	53	3	3875	3	0	3934
3919	24	3	35	3905	0	3967
3920	3951	0	17	42	0	4010
3921	3794	5	7	18	0	3824
3922	3832	3	4	9	0	3848
3923	54	3753	4	10	0	3821
3924	24	3931	7	5	0	3967
3925	13	39	5	4043	0	4100
3926	16	12	3	4027	0	4058
3927	10	4005	2	46	0	4063
3928	4017	35	1	19	0	4072
3929	39	12	4103	7	0	4161
3930	15	9	37	4104	0	4165
3931	11	6	9	4105	0	4131
3932	9	3	4039	45	0	4096
3933	3884	5	38	23	0	3950
3934	4099	2	10	17	0	4128
3935	48	4016	10	9	0	4083
3936	4029	34	6	12	0	4081
3937	48	11	4207	9	0	4275
3938	4264	7	41	8	0	4320
3939	51	5	4385	4	0	4445
3940	4356	5	47	5	0	4413
3941	4482	6	17	5	0	4510
3942	4484	2	7	6	0	4499
3943	4425	1	7	7	0	4440
3944	58	4382	6	2	0	4448
3945	4509	30	6	5	0	4550
3946	4606	10	3	5	0	4624
3947	54	9	4592	1	0	4656
3948	4617	7	37	7	0	4668
3949	53	2	9	4553	0	4617
3950	15	9	4521	39	0	4584
3951	4524	3	42	11	0	4580
3952	52	1	11	4613	0	4677
3953	4681	2	9	46	0	4738
3954	5005	0	6	17	0	5028
3955	53	1	5209	13	0	5276
3956	5147	2	42	11	0	5202
3957	5287	1	14	7	0	5309
3958	5299	2	9	10	0	5320
3959	5375	1	7	10	0	5393
3960	73	3	4	5249	0	5329
3961	26	5240	7	43	0	5316
3962	5154	44	5	18	0	5221
3963	5353	9	4	10	0	5376
3964	5388	6	1	15	0	5410
3965	64	6	5312	7	0	5389
3966	29	5312	44	9	0	5394
3967	26	43	15	5347	0	5431
3968	20	11	6	5418	0	5455
3969	19	5	5653	52	0	5729
3970	18	8	53	5620	0	5699
3971	17	3	5712	73	0	5805
3972	14	5	68	5703	0	5790
3973	14	3	25	5800	0	5842
3974	16	7	5835	84	0	5942
3975	5639	6	71	37	0	5753
3976	5980	4	24	32	0	6040
3977	87	6	6056	15	0	6164
3978	6027	8	62	25	0	6122
3979	6170	4	21	17	0	6212
3980	93	5	6409	4	0	6511
3981	44	5	63	6346	0	6458
3982	27	3	25	6418	0	6473
3983	6469	0	15	90	0	6574
3984	77	6568	9	31	0	6685
3985	6202	62	11	26	0	6301
3986	6530	24	12	13	0	6579
3987	91	6661	5	14	0	6771
3988	6786	66	9	16	0	6877
3989	6819	22	6	12	0	6859
3990	100	6735	6	3	0	6844
3991	44	73	11	6827	0	6955
3992	30	6918	8	59	0	7015
3993	21	71	3	6983	0	7078
3994	27	26	6961	69	0	7083
3995	19	14	6862	30	0	6925
3996	6846	11	80	22	0	6959
3997	7016	3	33	15	0	7067
3998	93	11	7015	9	0	7128
3999	6987	4	68	13	0	7072
4000	7191	1	34	10	0	7236
4001	7049	4	15	4	0	7072
4002	106	7127	12	8	0	7253
4003	51	67	7	7268	0	7393
4004	7253	21	10	72	0	7356
4005	7230	8	8	37	0	7283
4006	104	9	7308	11	0	7432
4007	50	6	65	7224	0	7345
4008	30	7	21	7373	0	7431
4009	24	7276	10	89	0	7399
4010	26	7737	8	31	0	7802
4011	28	133	5	7506	0	7672
4012	17	7591	8	86	0	7702
4013	7377	71	9	31	0	7488
4014	73	7715	3	11	0	7802
4015	7903	81	5	12	0	8001
4016	93	20	7996	6	0	8115
4017	8322	16	98	15	0	8451
4018	8610	3	19	10	0	8642
4019	8612	1	10	9	0	8632
4020	8515	5	7	14	0	8541
4021	128	8402	5	8	0	8543
4022	44	87	2	8544	0	8677
4023	30	22	6	8509	0	8567
4024	33	14	8425	119	0	8591
4025	21	12	99	8307	0	8439
4026	15	10	23	8518	0	8566
4027	8560	7	12	128	0	8707
4028	114	8615	4	45	0	8778
4029	43	99	11	8670	0	8823
4030	43	26	9	8840	0	8918
4031	25	23	2	8906	0	8956
4032	8792	8	6	152	0	8958
4033	115	7	8	8865	0	8995
4034	8904	6	7	136	0	9053
4035	131	6	12	8935	0	9084
4036	45	10	2	9072	0	9129
4037	39	5	8660	140	0	8844
4038	8080	11	110	55	0	8256
4039	116	8551	23	39	0	8729
4040	8777	106	13	46	0	8942
4041	135	26	12	8719	0	8892
4042	47	23	7	8862	0	8939
4043	8970	11	6	144	0	9131
4044	9109	10	7	68	0	9194
4045	146	11	3	9329	0	9489
4046	47	2	9326	150	0	9525
4047	38	7	9126	48	0	9219
4048	26	9568	134	30	0	9758
4049	9731	127	45	32	0	9935
4050	9797	34	20	33	0	9884
4051	175	23	14	9854	0	10066
4052	49	9953	7	154	0	10163
4053	57	138	6	9942	0	10143
4054	40	35	4	9667	0	9746
4055	25	9234	10	171	0	9440
4056	9301	137	14	67	0	9519
4057	160	39	11	9325	0	9535
4058	46	9368	12	143	0	9569
4059	46	9691	13	45	0	9795
4060	9705	154	11	44	0	9914
4061	160	50	9645	31	0	9886
4062	9675	31	132	28	0	9866
4063	179	23	33	9746	0	9981
4064	66	17	20	9794	0	9897
4065	50	9741	10	176	0	9977
4066	50	170	16	9772	0	10008
4067	34	42	9779	174	0	10029
4068	25	9545	131	66	0	9767
4069	33	9648	23	54	0	9758
4070	9551	125	30	45	0	9751
4071	137	9569	22	36	0	9764
4072	42	139	8	9610	0	9799
4073	46	9613	6	150	0	9815
4074	32	137	8	9633	0	9810
4075	32	44	11	9732	0	9819
4076	34	35	9409	181	0	9659
4077	32	18	126	9289	0	9465
4078	40	31	33	9390	0	9494
4079	9234	29	24	163	0	9450
4080	148	24	9074	73	0	9319
4081	68	28	123	9240	0	9459
4082	48	24	9216	175	0	9463
4083	9159	23	137	82	0	9401
4084	153	9364	36	71	0	9624
4085	9858	145	30	77	0	10110
4086	167	32	24	10126	0	10349
4087	60	47	15	10168	0	10290
4088	60	28	10039	207	0	10334
4089	9553	32	148	98	0	9831
4090	176	10129	37	66	0	10408
4091	10028	157	29	75	0	10289
4092	202	45	24	9975	0	10246
4093	69	10037	24	181	0	10311
4094	10045	167	19	71	0	10302
4095	189	10056	22	73	0	10340
4096	57	175	21	10097	0	10350
4097	64	45	21	10202	0	10332
4098	50	47	28	10150	0	10275
4099	47	9926	21	209	0	10203
4100	39	173	19	9990	0	10221
4101	50	49	11	10164	0	10274
4102	9815	48	17	220	0	10100
4103	9878	42	9	85	0	10014
4104	9877	45	17	74	0	10013
4105	224	43	9808	61	0	10136
4106	9758	38	149	67	0	10012
4107	9989	27	42	63	0	10121
4108	9588	33	38	70	0	9729
4109	207	47	9072	58	0	9384
4110	9343	22	107	67	0	9539
4111	192	44	24	9404	0	9664
4112	63	37	9215	176	0	9491
4113	66	9125	132	64	0	9387
4114	49	262	33	8582	0	8926
4115	40	8469	38	145	0	8692
4116	38	8527	15	56	0	8636
4117	7996	125	59	51	0	8231
4118	126	44	15	7970	0	8155
4119	8006	27	17	136	0	8186
4120	131	20	13	8006	0	8170
4121	7992	21	18	140	0	8171
4122	135	27	11	7960	0	8133
4123	7968	21	11	139	0	8139
4124	143	19	7754	39	0	7955
4125	47	28	102	7774	0	7951
4126	49	22	7788	119	0	7978
4127	40	25	7405	44	0	7514
4128	31	21	7684	42	0	7778
4129	28	37	117	7514	0	7696
4130	15	23	7551	136	0	7725
4131	7455	22	111	54	0	7642
4132	111	32	23	7535	0	7701
4133	45	17	7697	123	0	7882
4134	39	19	103	7666	0	7827
4135	37	14	27	7767	0	7845
4136	28	17	8086	128	0	8259
4137	55	13	107	8051	0	8226
4138	40	21	27	8020	0	8108
4139	67	8132	26	124	0	8349
4140	8094	92	23	65	0	8274
4141	8113	20	19	60	0	8212
4142	138	19	7951	38	0	8146
4143	7671	11	105	49	0	7836
4144	111	16	7524	44	0	7695
4145	42	14	7121	30	0	7207
4146	36	13	7190	43	0	7282
4147	41	124	126	6907	0	7198
4148	33	19	7028	86	0	7166
4149	30	29	82	6856	0	6997
4150	31	9	21	6933	0	6994
4151	25	14	29	6877	0	6945
4152	33	4	15	6837	0	6889
4153	6735	12	14	105	0	6866
4154	6829	8	15	61	0	6913
4155	83	6945	17	36	0	7081
4156	42	67	9	7090	0	7208
4157	30	20	7211	92	0	7353
4158	29	7316	86	38	0	7469
4159	32	92	25	7556	0	7705
4160	21	21	7642	108	0	7792
4161	26	17	108	7503	0	7654
4162	23	11	7556	113	0	7703
4163	19	6	7498	34	0	7557
4164	24	12	122	7641	0	7799
4165	21	10	36	7680	0	7747
4166	7619	4	21	142	0	7786
4167	104	11	13	7600	0	7728
4168	7532	2	12	144	0	7690
4169	114	7437	20	42	0	7613
4170	24	7818	12	47	0	7901
4171	19	105	17	8107	0	8248
4172	8133	29	14	128	0	8304
4173	116	8192	9	52	0	8369
4174	40	107	15	8449	0	8611
4175	8697	14	17	136	0	8864
4176	8849	19	20	37	0	8925
4177	8637	10	25	33	0	8705
4178	8594	9	18	33	0	8654
4179	9006	12	20	27	0	9065
4180	143	6	8710	29	0	8888
4181	50	16	8534	33	0	8633
4182	27	8556	117	23	0	8723
4183	25	152	39	8487	0	8703
4184	23	21	8720	101	0	8865
4185	19	38	8371	24	0	8452
4186	33	43	103	8331	0	8510
4187	12	12	8713	103	0	8840
4188	13	10	8733	25	0	8781
4189	12	10467	117	21	0	10617
4190	10465	163	24	25	0	10677
4191	153	11164	13	15	0	11345
4192	35	175	10	11554	0	11774
4193	11755	25	13	194	0	11987
4194	181	11966	24	42	0	12213
4195	51	170	15	11972	0	12208
4196	19	32	12086	182	0	12319
4197	12133	11	192	43	0	12379
4198	12421	8	43	27	0	12499
4199	12671	7	16	29	0	12723
4200	241	16	11	12633	0	12901
4201	44	17	12584	211	0	12856
4202	20	12634	197	45	0	12896
4203	51	198	33	12716	0	12998
4204	12710	39	17	217	0	12983
4205	212	19	12541	40	0	12812
4206	48	12258	202	37	0	12545
4207	34	187	12390	19	0	12630
4208	12430	34	185	39	0	12688
4209	12883	21	36	45	0	12985
4210	12883	17	21	39	0	12960
4211	243	25	12480	18	0	12766
4212	55	12371	190	42	0	12658
4213	53	197	43	12545	0	12838
4214	50	38	30	12738	0	12856
4215	44	20	28	12744	0	12836
4216	34	21	12392	244	0	12691
4217	12311	14	204	73	0	12602
4218	237	23	12491	35	0	12786
4219	12710	23	210	47	0	12990
4220	13009	23	51	49	0	13132
4221	13056	29	29	43	0	13157
4222	12835	19	37	50	0	12941
4223	269	30	12679	27	0	13005
4224	90	29	213	12764	0	13096
4225	62	37	12607	219	0	12925
4226	72	12232	214	53	0	12571
4227	63	12854	49	43	0	13009
4228	12829	237	43	55	0	13164
4229	12606	67	45	54	0	12772
4230	247	12880	45	47	0	13219
4231	12963	234	39	55	0	13291
4232	274	75	10977	55	0	11381
4233	12601	36	168	43	0	12848
4234	260	12918	56	58	0	13292
4235	13117	229	52	51	0	13449
4236	12892	73	49	44	0	13058
4237	312	36	40	12625	0	13013
4238	131	34	45	12818	0	13028
4239	12634	44	49	274	0	13001
4240	266	59	47	12617	0	12989
4241	12636	34	55	270	0	12995
4242	299	51	41	12686	0	13077
4243	12599	36	47	264	0	12946
4244	12664	35	35	74	0	12808
4245	316	12211	58	50	0	12635
4246	125	12637	53	44	0	12859
4247	12386	265	61	59	0	12771
4248	290	12412	42	58	0	12802
4249	127	250	52	12283	0	12712
4250	102	74	62	12430	0	12668
4251	12111	60	59	308	0	12538
4252	276	12076	65	88	0	12505
4253	129	11868	58	74	0	12129
4254	109	12170	58	72	0	12409
4255	147	271	11806	71	0	12295
4256	129	79	11707	62	0	11977
4257	133	80	11705	61	0	11979
4258	148	216	260	10534	0	11158
4259	119	11139	80	222	0	11560
4260	11144	216	47	105	0	11512
4261	278	70	11028	74	0	11450
4262	154	47	10949	69	0	11219
4263	122	49	11162	64	0	11397
4264	136	49	230	11024	0	11439
4265	141	45	77	11199	0	11462
4266	121	54	61	11281	0	11517
4267	11144	50	58	252	0	11504
4268	11141	63	57	92	0	11353
4269	11130	53	57	76	0	11316
4270	301	59	66	10672	0	11098
4271	123	44	10184	184	0	10535
4272	98	63	10378	66	0	10605
4273	128	37	205	10287	0	10657
4274	116	47	67	10177	0	10407
4275	9897	42	42	229	0	10210
4276	242	9737	47	98	0	10124
4277	9780	166	38	82	0	10066
4278	232	9698	42	88	0	10060
4279	124	170	40	9683	0	10017
4280	87	55	9611	234	0	9987
4281	131	51	180	9556	0	9918
4282	9628	37	63	225	0	9953
4283	265	31	9515	73	0	9884
4284	9158	34	170	65	0	9427
4285	260	27	9101	52	0	9440
4286	168	41	8752	47	0	9008
4287	8269	35	168	59	0	8531
4288	207	46	8279	45	0	8577
4289	58	17	6469	19	0	6563
4290	70	6375	145	26	0	6616
4291	5580	115	221	53	0	5969
4292	5309	20	44	19	0	5392
4293	5262	8	7	19	0	5296
4294	48	5	5058	8	0	5119
4295	4883	6	38	11	0	4938
4296	40	4964	10	7	0	5021
4297	4830	35	4	10	0	4879
4298	37	12	4853	6	0	4908
4299	19	48	34	4563	0	4664
4300	5	5	4496	28	0	4534
4301	6	4456	28	14	0	4504
4302	14	25	26	4355	0	4420
4303	12	8	4	4405	0	4429
4304	4470	1	3	36	0	4510
4305	4461	0	1	12	0	4474
4306	4461	1	3	8	0	4473
4307	4449	1	3	9	0	4462
4308	4409	1	4	5	0	4419
4309	33	3	4411	4	0	4451
4310	11	1	28	4388	0	4428
4311	5	6	4587	28	0	4626
4312	10	1	27	4589	0	4627
4313	4655	3	11	37	0	4706
4314	4740	2	0	17	0	4759
4315	4766	8	4	12	0	4790
4316	4828	1	3	9	0	4841
4317	40	3	4892	3	0	4938
4318	16	1	27	4869	0	4913
4319	8	5	4866	28	0	4907
4320	5	4917	28	23	0	4973
4321	9	4844	13	5	0	4871
4322	16	40	11	4836	0	4903
4323	13	9	6	5264	0	5292
4324	17	4	7	5257	0	5285
4325	10	3	6	5536	0	5555
4326	5475	1	7	65	0	5548
4327	49	5446	8	17	0	5520
4328	5365	44	4	12	0	5425
4329	53	11	4	5342	0	5410
4330	29	7	1	5251	0	5288
4331	11	5329	4	55	0	5399
4332	15	46	1	5350	0	5412
4333	5358	12	4	54	0	5428
4334	53	5078	3	21	0	5155
4335	13	5041	5	11	0	5070
4336	5014	51	4	9	0	5078
4337	49	11	6	5028	0	5094
4338	12	5028	5	50	0	5095
4339	10	44	6	5070	0	5130
4340	5094	9	3	62	0	5168
4341	61	10	4	5042	0	5117
4342	12	3	1	5090	0	5106
4343	5061	4	2	67	0	5134
4344	58	3	2	5028	0	5091
4345	18	5109	3	51	0	5181
4346	12	53	0	5044	0	5109
4347	12	5072	3	54	0	5141
4348	13	53	4	5075	0	5145
4349	5057	12	4	63	0	5136
4350	5128	9	3	18	0	5158
4351	62	3	1	5140	0	5206
4352	21	4	5078	57	0	5160
4353	4959	6	46	25	0	5036
4354	60	3	5090	12	0	5165
4355	5092	6	50	17	0	5165
4356	5122	4	9	18	0	5153
4357	58	6	4971	5	0	5040
4358	16	4953	46	11	0	5026
4359	4955	49	18	12	0	5034
4360	4969	12	4	22	0	5007
4361	58	12	5134	8	0	5212
4362	5087	5	48	16	0	5156
4363	5073	5	6	20	0	5104
4364	5097	6	7	7	0	5117
4365	64	3	2	5055	0	5124
4366	25	5	4	5079	0	5113
4367	15	5107	6	62	0	5190
4368	19	48	2	5212	0	5281
4369	15	8	4	5257	0	5284
4370	11	8	5129	66	0	5214
4371	14	7	4974	20	0	5015
4372	4795	8	53	28	0	4884
4373	5005	8	15	16	0	5044
4374	62	4973	8	17	0	5060
4375	29	52	6	5014	0	5101
4376	18	17	5163	64	0	5262
4377	22	9	54	5250	0	5335
4378	17	10	19	5327	0	5373
4379	19	14	4	5466	0	5503
4380	14	5483	13	95	0	5605
4381	16	60	4	5572	0	5652
4382	13	20	8	5705	0	5746
4383	16	16	5618	94	0	5744
4384	16	11	5623	41	0	5691
4385	5479	7	82	31	0	5599
4386	5700	11	25	23	0	5759
4387	102	15	15	5977	0	6109
4388	38	11	9	5914	0	5972
4389	30	8	6	6021	0	6065
4390	19	6	5783	132	0	5940
4391	15	5706	93	47	0	5861
4392	16	95	5687	29	0	5827
4393	5617	18	96	26	0	5757
4394	104	15	5713	24	0	5856
4395	5649	12	105	25	0	5791
4396	5645	8	22	28	0	5703
4397	5777	6	22	23	0	5828
4398	130	13	11	5696	0	5850
4399	39	5	5714	106	0	5864
4400	33	5846	90	28	0	5997
4401	27	95	25	5786	0	5933
4402	20	23	16	6016	0	6075
4403	21	17	6177	118	0	6333
4404	16	6122	114	45	0	6297
4405	6341	113	26	29	0	6509
4406	133	6474	22	27	0	6656
4407	6881	145	11	19	0	7056
4408	172	30	12	6961	0	7175
4409	53	13	7116	158	0	7340
4410	27	7159	158	42	0	7386
4411	7225	160	33	30	0	7448
4412	179	30	7248	17	0	7474
4413	7239	14	169	26	0	7448
4414	7356	15	36	20	0	7427
4415	206	8	7276	23	0	7513
4416	7176	12	173	22	0	7383
4417	7263	11	41	17	0	7332
4418	7138	13	24	16	0	7191
4419	206	6975	23	12	0	7216
4420	6822	158	15	17	0	7012
4421	182	6908	16	12	0	7118
4422	52	166	6896	11	0	7125
4423	25	6855	149	11	0	7040
4424	6645	159	62	13	0	6879
4425	6734	30	21	14	0	6799
4426	6787	13	22	8	0	6830
4427	179	19	13	6589	0	6800
4428	60	5	11	6766	0	6842
4429	6494	6	12	173	0	6685
4430	6738	4	11	36	0	6789
4431	181	9	6	6576	0	6772
4432	54	7	6508	153	0	6722
4433	35	6274	140	32	0	6481
4434	28	6574	26	27	0	6655
4435	18	158	18	6444	0	6638
4436	15	38	6460	139	0	6652
4437	26	40	133	6220	0	6419
4438	20	6343	32	129	0	6524
4439	22	137	21	6338	0	6518
4440	19	33	6303	150	0	6505
4441	30	14	139	6349	0	6532
4442	24	21	6526	151	0	6722
4443	37	6	149	6518	0	6710
4444	19	10	6684	169	0	6882
4445	26	8	6657	51	0	6742
4446	6510	19	169	24	0	6722
4447	6712	11	38	28	0	6789
4448	6720	20	28	20	0	6788
4449	189	6620	34	13	0	6856
4450	56	158	14	6701	0	6929
4451	6515	33	21	159	0	6728
4452	6793	27	11	45	0	6876
4453	6791	12	18	25	0	6846
4454	188	12	6628	33	0	6861
4455	61	6309	151	21	0	6542
4456	36	6696	38	23	0	6793
4457	6640	162	39	23	0	6864
4458	165	41	29	6595	0	6830
4459	6589	26	27	147	0	6789
4460	170	26	6545	45	0	6786
4461	74	24	160	6385	0	6643
4462	47	19	36	6529	0	6631
4463	51	21	25	6400	0	6497
4464	41	6404	29	178	0	6652
4465	6414	156	18	53	0	6641
4466	6505	40	15	33	0	6593
4467	190	6324	26	20	0	6560
4468	72	156	19	6266	0	6513
4469	6288	39	22	161	0	6510
4470	195	26	15	6285	0	6521
4471	6263	29	22	163	0	6477
4472	185	6219	23	45	0	6472
4473	6214	158	21	24	0	6417
4474	189	44	6138	28	0	6399
4475	66	6146	143	27	0	6382
4476	50	167	6036	26	0	6279
4477	83	105	163	5884	0	6235
4478	5817	25	57	162	0	6061
4479	5925	27	26	45	0	6023
4480	5860	25	20	30	0	5935
4481	191	14	21	5662	0	5888
4482	5664	17	24	143	0	5848
4483	174	14	17	5581	0	5786
4484	5574	15	20	152	0	5761
4485	5675	15	19	56	0	5765
4486	193	14	5572	21	0	5800
4487	44	14	5233	34	0	5325
4488	37	14	5226	15	0	5292
4489	33	31	117	5045	0	5226
4490	5068	13	57	114	0	5252
4491	114	24	23	5106	0	5267
4492	39	16	28	5220	0	5303
4493	5321	19	15	138	0	5493
4494	5398	10	11	39	0	5458
4495	5424	8	15	34	0	5481
4496	5442	8	16	28	0	5494
4497	143	8	17	5340	0	5508
4498	5236	11	11	123	0	5381
4499	129	5209	11	32	0	5381
4500	5119	97	14	29	0	5259
4501	5129	20	22	24	0	5195
4502	128	12	4801	18	0	4959
4503	4449	16	84	12	0	4561
4504	93	7	4427	22	0	4549
4505	37	3	4068	8	0	4116
4506	25	7	4031	11	0	4074
4507	41	95	56	3449	0	3641
4508	11	7	3523	37	0	3578
4509	14	24	31	3244	0	3313
4510	3	0	3317	30	0	3350
4511	8	1	3393	16	0	3418
4512	6	5	28	3338	0	3377
4513	7	3	10	3504	0	3524
4514	4	1	3640	25	0	3670
4515	3500	1	21	13	0	3535
4516	22	2	8	3597	0	3629
4517	17	0	3	3647	0	3667
4518	3662	1	5	26	0	3694
4519	20	3	3	3742	0	3768
4520	9	4	3732	26	0	3771
4521	4	5	3525	11	0	3545
4522	5	5	23	3481	0	3514
4523	1	2	3559	23	0	3585
4524	2	3645	26	10	0	3683
4525	7	16	10	3617	0	3650
4526	3657	5	1	26	0	3689
4527	19	1	3644	10	0	3674
4528	3622	1	19	7	0	3649
4529	21	1	6	3739	0	3767
4530	15	0	2	3780	0	3797
4531	8	2	3	3790	0	3803
4532	5	2	1	3778	0	3786
4533	3751	0	2	34	0	3787
4534	20	3883	3	11	0	3917
4535	7	27	1	3926	0	3961
4536	7	13	2	3925	0	3947
4537	4	4	2	3951	0	3961
4538	5	4	0	3936	0	3945
4539	3911	0	0	40	0	3951
4540	25	3903	2	19	0	3949
4541	3864	22	2	15	0	3903
4542	25	3634	3	6	0	3668
4543	10	3655	2	7	0	3674
4544	3573	30	2	8	0	3613
4545	26	10	3660	6	0	3702
4546	12	8	25	3659	0	3704
4547	3740	3	9	29	0	3781
4548	3776	1	5	19	0	3801
4549	3380	12	6	30	0	3428
4550	3786	2	2	10	0	3800
4551	35	4040	1	7	0	4083
4552	4071	33	4	3	0	4111
4553	4207	11	1	7	0	4226
4554	56	4515	1	9	0	4581
4555	21	50	3	4685	0	4759
4556	9	21	4702	57	0	4789
4557	15	11	50	4734	0	4810
4558	4732	6	16	66	0	4820
4559	51	2	4921	21	0	4995
4560	16	4837	55	13	0	4921
4561	6	52	4959	5	0	5022
4562	13	21	57	4779	0	4870
4563	2	4831	22	47	0	4902
4564	4961	55	12	19	0	5047
4565	51	4993	7	11	0	5062
4566	16	58	3	5009	0	5086
4567	11	19	5	5095	0	5130
4568	5054	8	4	78	0	5144
4569	67	5	3	4956	0	5031
4570	17	5006	10	59	0	5092
4571	5074	56	2	26	0	5158
4572	5106	16	4	20	0	5146
4573	65	5128	2	12	0	5207
4574	5122	60	1	13	0	5196
4575	62	5048	4	8	0	5122
4576	5043	64	2	13	0	5122
4577	61	5062	2	21	0	5146
4578	30	56	3	4979	0	5068
4579	20	22	4	5186	0	5232
4580	5162	10	2	68	0	5242
4581	5263	11	6	23	0	5303
4582	77	5207	5	18	0	5307
4583	34	64	5212	7	0	5317
4584	5263	26	56	13	0	5358
4585	77	12	19	5330	0	5438
4586	24	5302	11	53	0	5390
4587	25	56	6	5331	0	5418
4588	5337	24	3	74	0	5438
4589	5370	11	1	42	0	5424
4590	5429	9	1	20	0	5459
4591	97	5	1	5402	0	5505
4592	40	13	5398	59	0	5510
4593	5203	12	57	24	0	5296
4594	5292	3	23	21	0	5339
4595	5397	12	6	16	0	5431
4596	88	5331	6	9	0	5434
4597	41	61	7	5444	0	5553
4598	16	5550	5	63	0	5634
4599	23	64	5	5591	0	5683
4600	24	23	5	5708	0	5760
4601	15	18	5983	89	0	6105
4602	19	15	68	6275	0	6377
4603	9	7	31	6469	0	6516
4604	6479	8	13	121	0	6621
4605	86	6534	14	49	0	6683
4606	6538	86	2	30	0	6656
4607	6792	36	7	22	0	6857
4608	133	21	6	6764	0	6924
4609	52	21	6859	98	0	7030
4610	31	6680	85	43	0	6839
4611	14	6696	29	28	0	6767
4612	6561	123	17	21	0	6722
4613	108	6629	4	24	0	6765
4614	45	111	7	6492	0	6655
4615	35	38	3	6661	0	6737
4616	19	25	6539	121	0	6704
4617	17	12	6491	54	0	6574
4618	22	6524	117	23	0	6686
4619	20	99	43	6522	0	6684
4620	6512	35	18	104	0	6669
4621	101	25	15	6588	0	6729
4622	41	17	6649	114	0	6821
4623	30	21	92	6601	0	6744
4624	6483	19	30	113	0	6645
4625	6521	14	18	48	0	6601
4626	131	6453	6	36	0	6626
4627	6490	98	13	27	0	6628
4628	108	6497	10	18	0	6633
4629	6498	108	6	23	0	6635
4630	125	45	5	6425	0	6600
4631	52	28	6416	100	0	6596
4632	39	18	6332	42	0	6431
4633	20	6581	118	28	0	6747
4634	34	89	41	6522	0	6686
4635	24	35	15	6680	0	6754
4636	6655	19	15	120	0	6809
4637	6713	22	6	54	0	6795
4638	6849	24	8	31	0	6912
4639	144	15	6	6787	0	6952
4640	60	17	6	6899	0	6982
4641	32	7	15	6943	0	6997
4642	27	13	6860	138	0	7038
4643	25	9	6753	56	0	6843
4644	6748	14	113	36	0	6911
4645	6780	14	43	38	0	6875
4646	127	14	6791	34	0	6966
4647	6710	14	101	21	0	6846
4648	6668	9	36	25	0	6738
4649	137	10	6607	28	0	6782
4650	60	6648	100	26	0	6834
4651	39	111	42	6439	0	6631
4652	29	29	6622	102	0	6782
4653	23	6752	90	54	0	6919
4654	37	111	38	6239	0	6425
4655	20	6371	11	74	0	6476
4656	15	78	6282	32	0	6407
4657	21	34	6272	22	0	6349
4658	26	51	102	6262	0	6441
4659	6237	13	38	93	0	6381
4660	91	23	10	6240	0	6364
4661	6212	11	16	88	0	6327
4662	92	13	11	6235	0	6351
4663	41	14	6187	98	0	6340
4664	6033	9	79	56	0	6177
4665	77	21	6184	30	0	6312
4666	6223	14	88	18	0	6343
4667	96	20	37	6171	0	6324
4668	39	6175	21	98	0	6333
4669	31	69	14	6281	0	6395
4670	15	6371	16	101	0	6503
4671	32	81	20	6159	0	6292
4672	20	6379	19	92	0	6510
4673	6311	91	13	37	0	6452
4674	6372	34	9	35	0	6450
4675	6334	22	12	31	0	6399
4676	113	10	6265	23	0	6411
4677	50	17	79	6253	0	6399
4678	40	16	6318	84	0	6458
4679	27	6111	89	50	0	6277
4680	26	6304	37	20	0	6387
4681	6162	95	25	29	0	6311
4682	88	44	6159	16	0	6307
4683	41	6093	77	27	0	6238
4684	48	80	38	6170	0	6336
4685	6154	35	20	91	0	6300
4686	78	6174	24	43	0	6319
4687	6283	74	16	30	0	6403
4688	84	42	6294	27	0	6447
4689	47	22	78	6420	0	6567
4690	28	13	39	6532	0	6612
4691	30	16	23	6670	0	6739
4692	32	6617	17	119	0	6785
4693	41	90	15	6319	0	6465
4694	28	34	6667	109	0	6838
4695	32	20	85	6592	0	6729
4696	33	6	39	6689	0	6767
4697	27	12	29	6561	0	6629
4698	25	6409	14	121	0	6569
4699	28	80	24	6352	0	6484
4700	37	37	15	6322	0	6411
4701	16	5910	15	107	0	6048
4702	5537	61	6	47	0	5651
4703	54	5495	8	24	0	5581
4704	24	5452	5	17	0	5498
4705	19	91	17	5382	0	5509
4706	10	31	5390	62	0	5493
4707	5081	14	63	37	0	5195
4708	49	11	19	5247	0	5326
4709	22	14	5121	58	0	5215
4710	12	5155	49	30	0	5246
4711	8	53	26	5129	0	5216
4712	10	25	5188	57	0	5280
4713	15	14	52	5053	0	5134
4714	13	8	23	5071	0	5115
4715	4973	13	10	80	0	5076
4716	57	4947	4	38	0	5046
4717	4932	55	16	19	0	5022
4718	62	22	4996	13	0	5093
4719	21	5019	54	26	0	5120
4720	9	53	5061	16	0	5139
4721	17	36	57	5118	0	5228
4722	5099	11	21	65	0	5196
4723	66	8	13	5091	0	5178
4724	5086	10	11	65	0	5172
4725	5150	8	12	30	0	5200
4726	76	7	11	5224	0	5318
4727	28	13	5378	65	0	5484
4728	13	5	5478	32	0	5528
4729	13	9	74	5556	0	5652
4730	18	12	24	5664	0	5718
4731	5629	11	12	86	0	5738
4732	71	8	10	5535	0	5624
4733	27	5441	13	71	0	5552
4734	16	63	9	5516	0	5604
4735	16	24	10	5545	0	5595
4736	5436	7	6	97	0	5546
4737	70	5496	9	41	0	5616
4738	26	63	6	5544	0	5639
4739	19	25	11	5522	0	5577
4740	13	5455	6	96	0	5570
4741	13	70	12	5505	0	5600
4742	15	27	7	5459	0	5508
4743	8	5386	12	96	0	5502
4744	16	70	5	5415	0	5506
4745	10	24	7	5375	0	5416
4746	10	5297	5	102	0	5414
4747	16	67	5	5354	0	5442
4748	5300	31	5	89	0	5425
4749	5341	18	8	44	0	5411
4750	5222	9	2	33	0	5266
4751	5208	15	6	25	0	5254
4752	79	4978	2	32	0	5091
4753	4668	58	4	27	0	4757
4754	63	4581	2	20	0	4666
4755	15	4633	9	28	0	4685
4756	28	61	15	4616	0	4720
4757	7	16	4635	68	0	4726
4758	4474	15	52	28	0	4569
4759	4647	8	17	17	0	4689
4760	68	10	4763	19	0	4860
4761	4757	6	51	20	0	4834
4762	4899	10	9	17	0	4935
4763	67	4774	7	19	0	4867
4764	5190	56	1	29	0	5276
4765	71	17	8	5155	0	5251
4766	22	12	8	5211	0	5253
4767	13	12	5	5238	0	5268
4768	11	10	7	5215	0	5243
4769	5168	7	6	79	0	5260
4770	74	6	2	5110	0	5192
4771	20	8	5	5157	0	5190
4772	19	9	5032	74	0	5134
4773	4783	3	52	29	0	4867
4774	5092	7	10	25	0	5134
4775	5089	9	7	16	0	5121
4776	66	4884	9	107	0	5066
4777	16	5051	6	26	0	5099
4778	5014	61	7	23	0	5105
4779	68	19	2	5035	0	5124
4780	26	5095	4	68	0	5193
4781	16	58	5	5050	0	5129
4782	8	4920	5	255	0	5188
4783	5096	53	6	32	0	5187
4784	63	5160	6	23	0	5252
4785	22	59	4	5166	0	5251
4786	21	12	1	5282	0	5316
4787	15	9	5348	73	0	5445
4788	15	5586	57	20	0	5678
4789	25	78	8	5739	0	5850
4790	14	19	5827	84	0	5944
4791	13	13	5921	28	0	5975
4792	15	14	92	5980	0	6101
4793	17	12	25	6035	0	6089
4794	16	5795	12	114	0	5937
4795	11	6005	6	45	0	6067
4796	16	112	6	5982	0	6116
4797	6005	30	9	104	0	6148
4798	102	15	6	6213	0	6336
4799	6300	13	2	109	0	6424
4800	6454	13	0	50	0	6517
4801	6509	16	6	28	0	6559
4802	129	12	6443	21	0	6605
4803	6437	7	92	18	0	6554
4804	116	10	28	6459	0	6613
4805	48	9	13	6529	0	6599
4806	22	10	6406	125	0	6563
4807	19	11	6327	52	0	6409
4808	27	26	109	6213	0	6375
4809	18	6073	40	103	0	6234
4810	19	6276	11	51	0	6357
4811	31	116	13	6249	0	6409
4812	6210	35	10	101	0	6356
4813	102	20	13	6247	0	6382
4814	58	11	6	6249	0	6324
4815	26	6212	10	120	0	6368
4816	27	89	9	6312	0	6437
4817	16	32	6342	117	0	6507
4818	22	15	6049	51	0	6137
4819	6036	12	111	35	0	6194
4820	89	6172	40	31	0	6332
4821	6115	85	11	26	0	6237
4822	6123	37	9	30	0	6199
4823	116	18	10	5938	0	6082
4824	40	6041	16	85	0	6182
4825	29	85	6	6106	0	6226
4826	6028	38	8	100	0	6174
4827	88	5873	7	44	0	6012
4828	5741	76	8	36	0	5861
4829	86	5733	7	29	0	5855
4830	5784	84	7	25	0	5900
4831	5790	34	9	30	0	5863
4832	111	5715	10	14	0	5850
4833	46	90	7	5703	0	5846
4834	5707	30	10	86	0	5833
4835	86	22	5558	37	0	5703
4836	48	12	5536	23	0	5619
4837	34	60	94	5462	0	5650
4838	5520	12	37	86	0	5655
4839	87	7	20	5521	0	5635
4840	5537	13	10	92	0	5652
4841	87	19	5603	42	0	5751
4842	5688	12	70	33	0	5803
4843	5924	9	32	25	0	5990
4844	107	18	16	5834	0	5975
4845	58	12	8	5921	0	5999
4846	31	13	6	5931	0	5981
4847	27	5919	11	96	0	6053
4848	23	63	8	5917	0	6011
4849	30	24	11	6001	0	6066
4850	5932	9	13	118	0	6072
4851	5972	4	7	62	0	6045
4852	99	17	5865	25	0	6006
4853	5796	12	69	26	0	5903
4854	83	3	5878	30	0	5994
4855	5624	7	77	23	0	5731
4856	91	6	5760	19	0	5876
4857	49	12	5642	23	0	5726
4858	25	22	90	5622	0	5759
4859	33	7	5601	79	0	5720
4860	5440	12	74	43	0	5569
4861	71	4	30	5628	0	5733
4862	5678	11	13	94	0	5796
4863	5715	7	13	54	0	5789
4864	5383	13	6	24	0	5426
4865	5322	6	15	22	0	5365
4866	118	5	5239	16	0	5378
4867	52	10	71	5227	0	5360
4868	43	2	5293	71	0	5409
4869	32	7	80	5237	0	5356
4870	5254	7	35	82	0	5378
4871	86	4	25	5279	0	5394
4872	5321	10	17	86	0	5434
4873	87	5	7	5356	0	5455
4874	42	7	13	5413	0	5475
4875	5376	6	11	104	0	5497
4876	81	5325	9	53	0	5468
4877	5368	62	9	29	0	5468
4878	87	5312	10	17	0	5426
4879	45	70	11	5385	0	5511
4880	5350	26	5	85	0	5466
4881	87	15	5353	34	0	5489
4882	41	9	59	5411	0	5520
4883	5420	5	34	80	0	5539
4884	5612	8	16	50	0	5686
4885	108	5	11	5520	0	5644
4886	54	5510	7	93	0	5664
4887	32	5428	7	49	0	5516
4888	36	211	2	4963	0	5212
4889	5005	33	16	68	0	5122
4890	68	4793	4	35	0	4900
4891	23	4534	3	17	0	4577
4892	4467	39	9	12	0	4527
4893	29	4441	3	6	0	4479
4894	4580	30	12	15	0	4637
4895	57	17	4	4562	0	4640
4896	22	11	3	4573	0	4609
4897	12	4497	3	51	0	4563
4898	8	4441	0	25	0	4474
4899	4240	45	1	12	0	4298
4900	34	4365	0	4	0	4403
4901	16	4741	1	11	0	4769
4902	15	61	3	4818	0	4897
4903	4912	25	1	55	0	4993
4904	56	12	5191	28	0	5287
4905	5280	5	62	11	0	5358
4906	75	8	41	5666	0	5790
4907	48	2	5763	84	0	5897
4908	16	5	5898	44	0	5963
4909	13	8	113	5999	0	6133
4910	7	4	6210	90	0	6311
4911	6227	4	98	56	0	6385
4912	6355	5	51	24	0	6435
4913	131	7	6325	14	0	6477
4914	68	2	92	6272	0	6434
4915	31	5	50	6291	0	6377
4916	6398	6	26	138	0	6568
4917	95	9	15	6197	0	6316
4918	62	6188	6	98	0	6354
4919	6290	82	12	58	0	6442
4920	102	6185	8	23	0	6318
4921	54	6428	8	22	0	6512
4922	29	129	6	6411	0	6575
4923	28	56	8	6486	0	6578
4924	24	28	9	6536	0	6597
4925	11	17	6303	164	0	6495
4926	6000	14	87	82	0	6183
4927	101	6204	46	43	0	6394
4928	6345	94	23	32	0	6494
4929	6393	58	19	24	0	6494
4930	152	23	4	6406	0	6585
4931	73	6361	8	104	0	6546
4932	49	96	6	6580	0	6731
4933	29	54	15	6636	0	6734
4934	6681	19	7	160	0	6867
4935	6652	18	5	87	0	6762
4936	149	20	6309	44	0	6522
4937	6677	14	67	36	0	6794
4938	124	6749	39	34	0	6946
4939	6857	109	18	29	0	7013
4940	131	7137	13	22	0	7303
4941	82	112	7	6998	0	7199
4942	37	70	15	6973	0	7095
4943	31	6959	6	173	0	7169
4944	31	120	4	7145	0	7300
4945	43	53	7	7170	0	7273
4946	24	38	6	7098	0	7166
4947	22	6957	8	184	0	7171
4948	33	119	3	7073	0	7228
4949	27	70	6	7136	0	7239
4950	26	42	11	7166	0	7245
4951	19	29	6943	196	0	7187
4952	6751	22	97	123	0	6993
4953	118	26	6997	62	0	7203
4954	6952	18	122	52	0	7144
4955	148	25	7020	36	0	7229
4956	6984	25	119	41	0	7169
4957	7102	16	67	46	0	7231
4958	190	20	7054	37	0	7301
4959	105	26	119	7027	0	7277
4960	65	21	6682	133	0	6901
4961	6714	23	106	94	0	6937
4962	147	11	7095	62	0	7315
4963	84	28	6957	44	0	7113
4964	6973	27	161	34	0	7195
4965	140	7054	77	49	0	7320
4966	84	108	45	7165	0	7402
4967	7254	76	21	131	0	7482
4968	138	39	28	7300	0	7505
4969	94	30	28	7412	0	7564
4970	7301	20	38	203	0	7562
4971	7363	18	32	117	0	7530
4972	199	19	7218	63	0	7499
4973	109	23	7238	57	0	7427
4974	61	21	180	7289	0	7551
4975	59	13	7398	159	0	7629
4976	47	22	153	7362	0	7584
4977	58	16	87	7312	0	7473
4978	48	13	50	7574	0	7685
4979	7319	12	43	218	0	7592
4980	138	7362	31	125	0	7656
4981	7353	115	31	88	0	7587
4982	7361	56	24	76	0	7517
4983	188	7286	32	61	0	7567
4984	7113	121	19	58	0	7311
4985	157	60	7031	49	0	7297
4986	95	60	88	6917	0	7160
4987	7038	29	61	136	0	7264
4988	133	28	6763	84	0	7008
4989	6876	21	93	63	0	7053
4990	137	7142	47	48	0	7374
4991	7835	99	41	50	0	8025
4992	7912	45	29	55	0	8041
4993	219	7934	28	46	0	8227
4994	8133	144	33	51	0	8361
4995	215	66	18	8202	0	8501
4996	106	43	30	8354	0	8533
4997	8222	19	11	228	0	8480
4998	8089	25	26	118	0	8258
4999	224	8085	18	76	0	8403
5000	131	8058	18	42	0	8249
5001	67	204	16	7479	0	7766
5002	48	7536	22	133	0	7739
5003	54	7726	14	62	0	7856
5004	7251	135	23	49	0	7458
5005	111	7277	16	31	0	7435
5006	6962	100	11	21	0	7094
5007	104	7091	10	29	0	7234
5008	53	95	7021	11	0	7180
5009	33	7047	89	21	0	7190
5010	6884	127	59	38	0	7108
5011	6833	34	17	29	0	6913
5012	114	24	6818	12	0	6968
5013	60	16	79	6613	0	6768
5014	51	15	22	6891	0	6979
5015	25	11	6855	106	0	6997
5016	26	14	85	6747	0	6872
5017	18	10	6817	110	0	6955
5018	18	11	6660	40	0	6729
5019	6620	6	96	34	0	6756
5020	87	6752	40	15	0	6894
5021	6744	76	28	17	0	6865
5022	110	25	17	6722	0	6874
5023	40	29	6767	90	0	6926
5024	42	19	77	6590	0	6728
5025	32	6780	23	78	0	6913
5026	6871	81	18	37	0	7007
5027	6939	29	13	35	0	7016
5028	113	29	7	6922	0	7071
5029	43	20	6782	93	0	6938
5030	6546	17	69	37	0	6669
5031	97	6649	26	30	0	6802
5032	6658	80	23	21	0	6782
5033	103	36	12	6603	0	6754
5034	6574	25	10	88	0	6697
5035	122	20	5	6548	0	6695
5036	48	38	6505	88	0	6679
5037	51	15	6228	40	0	6334
5038	6207	17	93	52	0	6369
5039	88	6445	38	36	0	6607
5040	6258	78	34	28	0	6398
5041	6300	29	15	25	0	6369
5042	95	6319	7	8	0	6429
5043	6220	91	5	18	0	6334
5044	86	33	6414	26	0	6559
5045	39	40	67	6449	0	6595
5046	36	34	25	6509	0	6604
5047	44	26	14	6559	0	6643
5048	24	27	6532	93	0	6676
5049	37	15	6533	44	0	6629
5050	19	26	89	6503	0	6637
5051	19	6386	46	82	0	6533
5052	17	6662	26	30	0	6735
5053	6665	86	25	31	0	6807
5054	6725	35	12	31	0	6803
5055	93	6820	32	26	0	6971
5056	43	85	7	6963	0	7098
5057	34	30	13	7058	0	7135
5058	7073	22	27	111	0	7233
5059	99	16	13	7222	0	7350
5060	52	12	31	7163	0	7258
5061	29	14	23	7228	0	7294
5062	40	13	6872	116	0	7041
5063	39	36	6532	50	0	6657
5064	6970	10	93	40	0	7113
5065	94	11	41	7356	0	7502
5066	37	16	7346	98	0	7497
5067	27	15	7191	52	0	7285
5068	7352	27	113	41	0	7533
5069	123	21	8025	20	0	8189
5070	62	8207	115	20	0	8404
5071	32	103	49	8800	0	8984
5072	31	35	8795	126	0	8987
5073	8838	25	120	51	0	9034
5074	141	33	51	9341	0	9566
5075	69	12	9243	154	0	9478
5076	43	9	138	9416	0	9606
5077	39	10	54	9539	0	9642
5078	9461	2	37	218	0	9718
5079	152	9533	42	74	0	9801
5080	60	140	33	9520	0	9753
5081	9601	41	17	156	0	9815
5082	9672	41	14	67	0	9794
5083	9720	13	12	48	0	9793
5084	9783	16	14	35	0	9848
5085	223	28	13	9574	0	9838
5086	9501	12	9	164	0	9686
5087	9540	14	26	61	0	9641
5088	9132	7	9	72	0	9220
5089	9234	3	11	61	0	9309
5090	197	8693	17	46	0	8953
5091	38	8050	8	17	0	8113
5092	33	113	8	8011	0	8165
5093	25	7908	10	87	0	8030
5094	7901	97	12	37	0	8047
5095	108	42	3	7817	0	7970
5096	7778	12	8	104	0	7902
5097	7911	9	6	46	0	7972
5098	128	6	5	8013	0	8152
5099	54	5	8	7968	0	8035
5100	30	7918	8	112	0	8068
5101	7953	84	3	47	0	8087
5102	101	7885	8	28	0	8022
5103	7953	87	2	32	0	8074
5104	120	28	5	8026	0	8179
5105	49	15	7931	99	0	8094
5106	7885	12	85	39	0	8021
5107	7668	8	23	34	0	7733
5108	128	14	7525	19	0	7686
5109	55	9	7555	17	0	7636
5110	45	10	103	7459	0	7617
5111	8056	7	31	105	0	8199
5112	8312	7	14	46	0	8379
5113	8341	8	9	42	0	8400
5114	8491	6	6	32	0	8535
5115	149	8285	6	27	0	8467
5116	8576	110	8	30	0	8724
5117	148	36	4	8480	0	8668
5118	75	25	8	8562	0	8670
5119	42	15	7	8814	0	8878
5120	28	17	9	8972	0	9026
5121	8822	12	3	178	0	9015
5122	142	12	6	9163	0	9323
5123	55	11	8987	156	0	9209
5124	51	9	117	9180	0	9357
5125	43	9	41	9274	0	9367
5126	46	6	25	9254	0	9331
5127	40	13	14	9201	0	9268
5128	8957	6	13	218	0	9194
5129	153	8838	15	85	0	9091
5130	59	8975	13	47	0	9094
5131	66	173	14	8941	0	9194
5132	8886	57	15	158	0	9116
5133	9173	30	7	83	0	9293
5134	206	15	14	9121	0	9356
5135	89	15	8954	170	0	9228
5136	9028	14	124	77	0	9243
5137	191	9	44	9287	0	9531
5138	79	18	9281	174	0	9552
5139	9083	12	155	92	0	9342
5140	187	9294	44	58	0	9583
5141	10139	157	18	59	0	10373
5142	236	10521	19	38	0	10814
5143	137	224	8	10592	0	10961
5144	76	10706	8	240	0	11030
5145	58	275	8	11000	0	11341
5146	10716	111	14	304	0	11145
5147	242	10810	9	160	0	11221
5148	118	234	10752	92	0	11196
5149	81	119	212	10794	0	11206
5150	62	55	10839	262	0	11218
5151	76	47	254	10714	0	11091
5152	54	31	110	11001	0	11196
5153	40	20	10672	340	0	11072
5154	10094	16	239	206	0	10555
5155	257	19	10523	101	0	10900
5156	129	29	10423	73	0	10654
5157	90	10458	279	51	0	10878
5158	71	235	125	10418	0	10849
5159	58	110	67	10596	0	10831
5160	55	64	45	10443	0	10607
5161	41	42	28	10782	0	10893
5162	44	28	10273	393	0	10738
5163	9862	21	211	211	0	10305
5164	246	12	10284	108	0	10650
5165	130	15	241	9953	0	10339
5166	9895	11	115	264	0	10285
5167	240	9881	69	144	0	10334
5168	117	267	45	9549	0	9978
5169	9154	92	36	236	0	9518
5170	242	8772	18	123	0	9155
5171	103	8776	21	67	0	8967
5172	8586	252	22	68	0	8928
5173	206	8577	20	44	0	8847
5174	8290	222	22	48	0	8582
5175	203	8376	23	47	0	8649
5176	8457	209	23	35	0	8724
5177	8644	99	10	43	0	8796
5178	261	8587	24	30	0	8902
5179	128	189	11	8485	0	8813
5180	76	89	8381	190	0	8736
5181	8331	54	176	109	0	8670
5182	201	48	79	8322	0	8650
5183	102	7998	51	210	0	8361
5184	63	8362	28	114	0	8567
5185	54	223	27	8390	0	8694
5186	8340	105	20	227	0	8692
5187	188	73	8356	107	0	8724
5188	115	34	170	8458	0	8777
5189	65	29	87	8640	0	8821
5190	57	21	49	8745	0	8872
5191	51	15	36	8619	0	8721
5192	33	8348	30	317	0	8728
5193	36	181	17	8551	0	8785
5194	22	96	8342	252	0	8712
5195	31	54	8215	136	0	8436
5196	25	48	8388	76	0	8537
5197	34	34	264	8218	0	8550
5198	8076	36	131	206	0	8449
5199	196	30	8088	105	0	8419
5200	105	28	8193	75	0	8401
5201	58	24	264	8053	0	8399
5202	8113	25	120	224	0	8482
5203	197	8067	76	117	0	8457
5204	8060	190	42	84	0	8376
5205	235	99	34	8029	0	8397
5206	120	70	8159	212	0	8561
5207	77	83	180	7974	0	8314
5208	50	8212	98	219	0	8579
5209	8505	189	51	128	0	8873
5210	204	105	8474	80	0	8863
5211	103	8261	188	65	0	8617
5212	8217	194	116	64	0	8591
5213	242	109	73	8183	0	8607
5214	122	60	47	8348	0	8577
5215	8283	41	43	278	0	8645
5216	8367	28	34	163	0	8592
5217	8614	22	47	106	0	8789
5218	325	34	24	8294	0	8677
5219	171	8142	29	209	0	8551
5220	8208	175	25	145	0	8553
5221	212	8158	25	91	0	8486
5222	7872	206	27	58	0	8163
5223	228	7766	27	43	0	8064
5224	121	192	25	7693	0	8031
5225	7807	103	24	190	0	8124
5226	7932	58	20	110	0	8120
5227	7996	39	16	80	0	8131
5228	8013	32	20	69	0	8134
5229	8070	18	21	46	0	8155
5230	306	31	7795	38	0	8170
5231	172	21	156	7812	0	8161
5232	106	25	7883	166	0	8180
5233	74	31	7836	94	0	8035
5234	7766	35	237	63	0	8101
5235	7896	28	112	56	0	8092
5236	7982	24	64	28	0	8098
5237	298	30	40	7627	0	7995
5238	7650	26	30	175	0	7881
5239	230	7491	22	108	0	7851
5240	151	7573	18	70	0	7812
5241	70	7132	12	49	0	7263
5242	6604	122	34	29	0	6789
5243	113	6602	18	20	0	6753
5244	6472	84	33	21	0	6610
5245	6451	37	8	22	0	6518
5246	120	22	6371	16	0	6529
5247	73	18	79	6298	0	6468
5248	53	12	32	6559	0	6656
5249	6622	15	20	110	0	6767
5250	6641	13	19	56	0	6729
5251	133	11	8	6600	0	6752
5252	70	17	6486	97	0	6670
5253	61	18	6534	43	0	6656
5254	42	12	97	6697	0	6848
5255	50	12	46	6722	0	6830
5256	42	19	26	6810	0	6897
5257	6608	19	11	133	0	6771
5258	6635	17	9	68	0	6729
5259	131	6619	13	37	0	6800
5260	80	89	14	6627	0	6810
5261	56	44	7	6634	0	6741
5262	39	6646	12	113	0	6810
5263	44	84	19	6734	0	6881
5264	6722	38	10	109	0	6879
5265	113	22	16	6690	0	6841
5266	70	19	20	6740	0	6849
5267	6623	10	18	134	0	6785
5268	6617	7	16	74	0	6714
5269	6646	14	17	53	0	6730
5270	147	37	28	6511	0	6723
5271	80	10	6212	88	0	6390
5272	63	7	6053	49	0	6172
5273	49	16	6087	38	0	6190
5274	40	6022	96	32	0	6190
5275	5863	73	88	33	0	6057
5276	92	41	5760	20	0	5913
5277	5599	23	58	34	0	5714
5278	88	20	29	5673	0	5810
5279	5531	19	17	77	0	5644
5280	5866	12	15	53	0	5946
5281	101	5937	6	26	0	6070
5282	6042	61	10	33	0	6146
5283	6052	32	15	31	0	6130
5284	105	6055	13	35	0	6208
5285	62	58	12	6182	0	6314
5286	56	31	6185	72	0	6344
5287	48	17	59	6044	0	6168
5288	39	15	32	6156	0	6242
5289	6147	9	19	104	0	6279
5290	87	9	24	6111	0	6231
5291	53	6161	15	83	0	6312
5292	35	63	14	6211	0	6323
5293	32	37	16	6263	0	6348
5294	32	17	6174	109	0	6332
5295	38	6007	61	57	0	6163
5296	37	5837	33	417	0	6324
5297	6131	81	19	38	0	6269
5298	75	6277	11	39	0	6402
5299	47	72	9	6300	0	6428
5300	40	48	6285	69	0	6442
5301	29	6285	55	67	0	6436
5302	6331	71	30	34	0	6466
5303	78	36	20	6317	0	6451
5304	53	22	11	6417	0	6503
5305	38	21	6367	94	0	6520
5306	40	8	60	6146	0	6254
5307	27	13	31	6281	0	6352
5308	6129	12	17	105	0	6263
5309	5792	9	21	60	0	5882
5310	86	5745	9	43	0	5883
5311	5515	45	6	34	0	5600
5312	64	5401	10	26	0	5501
5313	43	70	9	5174	0	5296
5314	28	5199	11	51	0	5289
5315	17	5343	13	29	0	5402
5316	5206	62	21	42	0	5331
5317	5092	30	15	24	0	5161
5318	56	5049	7	14	0	5126
5319	5118	39	12	19	0	5188
5320	5143	18	7	20	0	5188
5321	5275	12	10	29	0	5326
5322	61	12	9	5359	0	5441
5323	5358	4	10	57	0	5429
5324	54	11	5181	25	0	5271
5325	5084	11	32	25	0	5152
5326	52	10	5328	21	0	5411
5327	35	11	35	5434	0	5515
5328	27	11	13	5533	0	5584
5329	17	15	5505	54	0	5591
5330	5274	4	34	43	0	5355
5331	5377	13	20	31	0	5441
5332	50	11	5615	25	0	5701
5333	41	6	35	5490	0	5572
5334	21	13	15	5519	0	5568
5335	24	6	10	5607	0	5647
5336	5531	4	14	59	0	5608
5337	5501	10	9	38	0	5558
5338	62	9	11	5392	0	5474
5339	29	5154	10	39	0	5232
5340	18	5014	4	20	0	5056
5341	4798	44	2	19	0	4863
5342	41	4739	6	12	0	4798
5343	11	4689	11	11	0	4722
5344	21	31	5	4416	0	4473
5345	6	12	4412	25	0	4455
5346	6	4315	20	11	0	4352
5347	14	30	5	4308	0	4357
5348	6	4287	6	24	0	4323
5349	10	20	3	4240	0	4273
5350	4259	2	3	20	0	4284
5351	18	4275	3	8	0	4304
5352	4333	17	2	8	0	4360
5353	4206	5	1	10	0	4222
5354	23	5	4151	5	0	4184
5355	4127	1	14	7	0	4149
5356	23	3	3	4254	0	4283
5357	4	2	4358	15	0	4379
5358	3	4333	15	5	0	4356
5359	7	19	5	4319	0	4350
5360	4	2	2	4343	0	4351
5361	4354	1	0	24	0	4379
5362	17	0	1	4333	0	4351
5363	4	0	1	4343	0	4348
5364	4325	1	0	20	0	4346
5365	15	4302	3	9	0	4329
5366	4255	12	0	11	0	4278
5367	17	5	4262	3	0	4287
5368	4073	0	14	11	0	4098
5369	16	1	4447	3	0	4467
5370	4	4478	14	3	0	4499
5371	4524	17	2	8	0	4551
5372	4413	3	2	9	0	4427
5373	15	6	4454	5	0	4480
5374	9	4	4506	4	0	4523
5375	1	1	4644	4	0	4650
5376	0	4911	24	5	0	4940
5377	6	23	6	4993	0	5028
5378	3	10	5430	23	0	5466
5379	2	6	5263	8	0	5279
5380	4	0	56	5364	0	5424
5381	4	7	5394	40	0	5445
5382	5398	3	46	33	0	5480
5383	6004	2	17	11	0	6034
5384	76	6	5927	1	0	6010
5385	35	5909	52	5	0	6001
5386	18	44	29	5891	0	5982
5387	3	29	6012	56	0	6100
5388	4	5925	55	38	0	6022
5389	15	54	31	5935	0	6035
5390	5997	26	10	58	0	6091
5391	5991	6	4	43	0	6044
5392	77	6043	7	11	0	6138
5393	43	51	3	6068	0	6165
5394	11	34	9	6092	0	6146
5395	14	9	5	6043	0	6071
5396	9	4	6	6091	0	6110
5397	7	6	5991	88	0	6092
5398	10	5	54	5936	0	6005
5399	8	8	5876	61	0	5953
5400	7	5798	56	35	0	5896
5401	5787	54	29	18	0	5888
5402	45	5942	9	11	0	6007
5403	35	59	6	5971	0	6071
5404	17	28	5	5991	0	6041
5405	5916	10	5	90	0	6021
5406	55	3	7	5958	0	6023
5407	37	5824	3	58	0	5922
5408	14	47	3	5967	0	6031
5409	7	35	7	5973	0	6022
5410	5881	9	6	95	0	5991
5411	53	9	5733	47	0	5842
5412	34	5653	40	20	0	5747
5413	9	5806	25	13	0	5853
5414	6	61	9	5788	0	5864
5415	5689	36	5	59	0	5789
5416	47	5664	4	40	0	5755
5417	36	46	6	5718	0	5806
5418	12	34	5670	50	0	5766
5419	8	14	41	5660	0	5723
5420	5659	7	31	67	0	5764
5421	5581	2	13	45	0	5641
5422	73	6	6	5499	0	5584
5423	5576	7	7	52	0	5642
5424	5545	7	7	40	0	5599
5425	78	8	5522	16	0	5624
5426	5316	8	42	14	0	5380
5427	58	5403	32	10	0	5503
5428	5448	48	9	13	0	5518
5429	54	35	5365	13	0	5467
5430	41	10	47	5469	0	5567
5431	5573	3	33	54	0	5663
5432	54	5	5316	42	0	5417
5433	41	7	5381	16	0	5445
5434	23	4	77	5378	0	5482
5435	11	3	5502	59	0	5575
5436	5449	7	64	38	0	5558
5437	63	6	5625	16	0	5710
5438	43	8	64	5769	0	5884
5439	17	8	39	5881	0	5945
5440	6133	5	13	102	0	6253
5441	72	4	6214	49	0	6339
5442	52	6	6496	16	0	6570
5443	20	11	106	6852	0	6989
5444	9	3	6954	101	0	7067
5445	6870	2	109	56	0	7037
5446	105	2	54	6974	0	7135
5447	56	5	6998	102	0	7161
5448	27	4	109	6985	0	7125
5449	26	5	53	7092	0	7176
5450	7085	4	23	147	0	7259
5451	112	7	7070	66	0	7255
5452	6904	10	104	31	0	7049
5453	110	13	7200	23	0	7346
5454	7118	3	117	33	0	7271
5455	7187	11	60	29	0	7287
5456	7176	7	23	29	0	7235
5457	152	6917	23	23	0	7115
5458	6989	89	16	28	0	7122
5459	7031	49	17	23	0	7120
5460	156	18	19	6968	0	7161
5461	75	3	6922	117	0	7117
5462	6778	5	107	71	0	6961
5463	116	9	7053	34	0	7212
5464	73	7	115	6972	0	7167
5465	41	5	62	7170	0	7278
5466	7161	8	34	157	0	7360
5467	127	7304	16	75	0	7522
5468	81	111	17	7227	0	7436
5469	47	46	22	7280	0	7395
5470	29	22	7209	165	0	7425
5471	37	5	116	7197	0	7355
5472	32	7	55	7363	0	7457
5473	37	13	20	7161	0	7231
5474	25	7037	21	173	0	7256
5475	6847	107	17	76	0	7047
5476	6915	47	16	46	0	7024
5477	153	6855	17	43	0	7068
5478	6431	94	9	28	0	6562
5479	115	42	11	6648	0	6816
5480	47	15	6837	113	0	7012
5481	25	6920	108	52	0	7105
5482	24	7179	40	27	0	7270
5483	7124	127	45	23	0	7319
5484	7540	32	13	25	0	7610
5485	174	15	11	7525	0	7725
5486	61	20	17	7673	0	7771
5487	52	13	8	7676	0	7749
5488	7481	10	9	189	0	7689
5489	149	13	7408	58	0	7628
5490	7471	9	133	47	0	7660
5491	164	9	40	7496	0	7709
5492	69	7	23	7445	0	7544
5493	35	7384	22	166	0	7607
5494	46	129	18	7551	0	7744
5495	43	35	21	7683	0	7782
5496	42	29	7591	177	0	7839
5497	31	7629	128	74	0	7862
5498	7765	138	39	61	0	8003
5499	7579	42	24	49	0	7694
5500	7883	20	19	46	0	7968
5501	7762	18	23	45	0	7848
5502	181	23	7563	39	0	7806
5503	7520	11	143	37	0	7711
5504	181	15	7610	30	0	7836
5505	73	11	153	7420	0	7657
5506	56	7573	41	146	0	7816
5507	49	141	28	7611	0	7829
5508	58	38	27	7723	0	7846
5509	43	31	7596	187	0	7857
5510	7465	18	150	89	0	7722
5511	7590	21	44	71	0	7726
5512	177	7468	34	60	0	7739
5513	83	138	7514	50	0	7785
5514	60	42	144	7580	0	7826
5515	51	33	7576	164	0	7824
5516	51	31	7556	74	0	7712
5517	64	22	169	7522	0	7777
5518	62	23	7545	164	0	7794
5519	52	21	156	7558	0	7787
5520	68	19	7665	176	0	7928
5521	51	26	167	7668	0	7912
5522	7716	16	66	189	0	7987
5523	7758	21	43	109	0	7931
5524	7782	26	38	99	0	7945
5525	7636	21	37	77	0	7771
5526	208	7618	39	67	0	7932
5527	92	144	38	7610	0	7884
5528	78	39	28	7737	0	7882
5529	70	27	7533	206	0	7836
5530	74	30	144	7495	0	7743
5531	51	40	7428	191	0	7710
5532	59	23	7194	92	0	7368
5533	7096	27	171	88	0	7382
5534	161	7374	79	67	0	7681
5535	7410	151	53	75	0	7689
5536	7446	45	42	75	0	7608
5537	198	7434	33	72	0	7737
5538	7388	136	46	67	0	7637
5539	191	48	7352	55	0	7646
5540	85	7181	150	47	0	7463
5541	7114	132	58	52	0	7356
5542	174	44	6683	41	0	6942
5543	6419	35	116	39	0	6609
5544	138	5852	36	837	0	6863
5545	6620	105	40	55	0	6820
5546	6624	32	41	51	0	6748
5547	141	6505	27	47	0	6720
5548	64	6458	42	34	0	6598
5549	51	6666	31	37	0	6785
5550	56	121	44	6709	0	6930
5551	45	36	46	6807	0	6934
5552	6876	21	35	147	0	7079
5553	6819	20	36	68	0	6943
5554	146	21	6811	51	0	7029
5555	73	17	6693	52	0	6835
5556	48	20	6889	40	0	6997
5557	52	16	146	6871	0	7085
5558	47	28	6967	136	0	7178
5559	44	17	137	6974	0	7172
5560	6993	21	41	155	0	7210
5561	145	16	7015	54	0	7230
5562	7006	14	142	54	0	7216
5563	7068	16	52	42	0	7178
5564	155	27	7123	34	0	7339
5565	67	7181	132	39	0	7419
5566	62	100	46	7181	0	7389
5567	49	42	7171	121	0	7383
5568	42	30	127	7118	0	7317
5569	45	17	54	7594	0	7710
5570	7408	20	51	149	0	7628
5571	153	20	34	7413	0	7620
5572	68	24	7370	134	0	7596
5573	62	23	125	7394	0	7604
5574	7452	27	40	132	0	7651
5575	148	7449	29	51	0	7677
5576	7399	116	35	45	0	7595
5577	151	78	42	7303	0	7574
5578	70	35	7340	116	0	7561
5579	57	21	7013	34	0	7125
5580	57	20	6934	32	0	7043
5581	24	6586	105	28	0	6743
5582	6287	128	100	35	0	6550
5583	87	5976	13	12	0	6088
5584	5583	51	9	12	0	5655
5585	57	5560	5	6	0	5628
5586	25	55	7	5611	0	5698
5587	10	10	6	5687	0	5713
5588	9	6	6	5680	0	5701
5589	6	5667	10	66	0	5749
5590	12	55	4	5984	0	6055
5591	15	10	8	6679	0	6712
5592	7005	7	9	104	0	7125
5593	119	5	5	7239	0	7368
5594	24	4	7592	107	0	7727
5595	7496	4	103	28	0	7631
5596	7715	4	23	16	0	7758
5597	125	7783	9	23	0	7940
5598	7781	108	12	22	0	7923
5599	7996	25	10	14	0	8045
5600	159	8	9	7924	0	8100
5601	49	10	9	8059	0	8127
5602	37	5	11	8213	0	8266
5603	8155	5	8	161	0	8329
5604	8230	5	7	61	0	8303
5605	152	10	8044	27	0	8233
5606	8048	11	111	31	0	8201
5607	8208	5	26	26	0	8265
5608	8195	6	10	34	0	8245
5609	158	11	7940	24	0	8133
5610	60	5	8039	28	0	8132
5611	54	5	136	8065	0	8260
5612	37	12	8196	140	0	8385
5613	39	9	146	8111	0	8305
5614	54	10	38	7711	0	7813
5615	42	8235	25	142	0	8444
5616	8271	128	34	41	0	8474
5617	163	25	8338	31	0	8557
5618	8488	23	125	46	0	8682
5619	180	23	38	8633	0	8874
5620	8503	14	25	175	0	8717
5621	161	8360	34	71	0	8626
5622	75	8664	16	49	0	8804
5623	62	162	20	8597	0	8841
5624	67	41	23	8741	0	8872
5625	57	26	8568	190	0	8841
5626	52	23	145	8567	0	8787
5627	8438	13	50	195	0	8696
5628	162	8440	25	79	0	8706
5629	72	150	8427	39	0	8688
5630	53	46	147	8468	0	8714
5631	58	16	8507	163	0	8744
5632	54	25	150	8477	0	8706
5633	36	16	8599	174	0	8825
5634	39	23	8365	72	0	8499
5635	49	13	173	8420	0	8655
5636	8456	27	64	179	0	8726
5637	8410	18	45	73	0	8546
5638	8214	17	43	57	0	8331
5639	194	8130	33	56	0	8413
5640	8219	140	30	53	0	8442
5641	8206	39	30	54	0	8329
5642	202	30	7963	46	0	8241
5643	81	7936	134	43	0	8194
5644	75	139	47	7851	0	8112
5645	7848	47	30	166	0	8091
5646	169	7823	36	80	0	8108
5647	7977	148	25	51	0	8201
5648	8019	47	32	56	0	8154
5649	7990	29	27	43	0	8089
5650	7871	42	35	46	0	7994
5651	201	26	28	7689	0	7944
5652	7636	19	33	163	0	7851
5653	183	19	29	7512	0	7743
5654	77	7380	33	158	0	7648
5655	67	118	29	7492	0	7706
5656	7467	31	35	160	0	7693
5657	173	19	7406	74	0	7672
5658	89	27	134	7438	0	7688
5659	7390	10	41	168	0	7609
5660	166	7323	33	64	0	7586
5661	7361	126	36	44	0	7567
5662	7467	40	25	59	0	7591
5663	193	7426	35	49	0	7703
5664	7387	136	29	28	0	7580
5665	178	51	7054	41	0	7324
5666	98	31	6961	31	0	7121
5667	6912	40	137	39	0	7128
5668	179	28	6967	35	0	7209
5669	92	32	110	6550	0	6784
5670	79	6569	44	106	0	6798
5671	6746	112	29	47	0	6934
5672	150	6571	31	39	0	6791
5673	96	6275	24	34	0	6429
5674	80	128	30	6819	0	7057
5675	74	45	23	6823	0	6965
5676	58	28	25	6804	0	6915
5677	58	30	14	6806	0	6908
5678	51	29	6571	155	0	6806
5679	42	30	110	6422	0	6604
5680	48	22	33	6536	0	6639
5681	6394	30	20	149	0	6593
5682	128	31	25	6386	0	6570
5683	67	18	6253	132	0	6470
5684	6175	22	104	65	0	6366
5685	127	25	43	6226	0	6421
5686	69	25	6274	125	0	6493
5687	50	37	117	6173	0	6377
5688	62	6246	45	105	0	6458
5689	6238	98	27	60	0	6423
5690	120	36	5939	41	0	6136
5691	54	5173	70	28	0	5325
5692	4807	55	48	23	0	4933
5693	57	4477	19	20	0	4573
5694	26	4144	12	13	0	4195
5695	4100	47	40	9	0	4196
5696	35	3932	15	12	0	3994
5697	18	3916	7	13	0	3954
5698	37	52	28	3835	0	3952
5699	15	11	3784	31	0	3841
5700	9	3846	27	18	0	3900
5701	15	39	10	3779	0	3843
5702	8	3708	1	26	0	3743
5703	3693	18	3	19	0	3733
5704	26	7	3619	8	0	3660
5705	16	6	20	3655	0	3697
5706	3765	2	8	29	0	3804
5707	24	4	1	3816	0	3845
5708	16	7	3805	24	0	3852
5709	3638	3	16	23	0	3680
5710	3828	2	13	13	0	3856
5711	31	3966	5	6	0	4008
5712	13	23	2	3988	0	4026
5713	9	9	4	4058	0	4080
5714	4110	8	2	31	0	4151
5715	4033	8	4	12	0	4057
5716	39	10	4084	4	0	4137
5717	15	3956	25	2	0	3998
5718	3937	16	6	7	0	3966
5719	22	5	6	3896	0	3929
5720	6	2	3989	22	0	4019
5721	4	2	3840	4	0	3850
5722	10	34	14	3875	0	3933
5723	3920	2	5	17	0	3944
5724	16	3888	2	2	0	3908
5725	4216	17	0	5	0	4238
5726	18	2	2	4234	0	4256
5727	1	0	1	4301	0	4303
5728	1	4	3	4327	0	4335
5729	4324	3	1	26	0	4354
5730	15	4354	1	10	0	4380
5731	10	15	1	4451	0	4477
5732	1	5	0	4442	0	4448
5733	4	0	4446	18	0	4468
5734	5	0	15	4373	0	4393
5735	2	1	4448	18	0	4469
5736	1	4367	15	4	0	4387
5737	4	14	1	4444	0	4463
5738	4371	1	0	24	0	4396
5739	19	0	4344	2	0	4365
5740	5	3	15	4355	0	4378
5741	4	0	4344	16	0	4364
5742	4135	0	15	9	0	4159
5743	16	4	4366	2	0	4388
5744	4	4	16	4252	0	4276
5745	4325	0	2	22	0	4349
5746	19	3726	4	5	0	3754
5747	4156	16	2	5	0	4179
5748	20	3785	4	7	0	3816
5749	11	17	2	4289	0	4319
5750	5	7	4240	17	0	4269
5751	3	4	4171	7	0	4185
5752	7	5	20	4304	0	4336
5753	4410	2	5	22	0	4439
5754	4367	1	4	14	0	4386
5755	24	3	4	4381	0	4412
5756	12	2	1	4439	0	4454
5757	4366	3	1	27	0	4397
5758	20	4216	3	13	0	4252
5759	6	4395	3	5	0	4409
5760	4496	17	3	10	0	4526
5761	25	8	4468	4	0	4505
5762	12	2	21	4438	0	4473
5763	4	7	4352	24	0	4387
5764	13	1	18	4382	0	4414
5765	9	0	4405	33	0	4447
5766	5	6	4345	6	0	4362
5767	7	5	24	4509	0	4545
5768	6	4253	7	24	0	4290
5769	4495	19	7	13	0	4534
5770	23	4453	9	4	0	4489
5771	13	20	4	4545	0	4582
5772	4596	5	4	35	0	4640
5773	32	5	0	4686	0	4723
5774	4716	4	3	37	0	4760
5775	4734	2	2	17	0	4755
5776	4756	5	3	14	0	4778
5777	29	4641	3	10	0	4683
5778	4860	22	5	14	0	4901
5779	33	19	4	5041	0	5097
5780	5278	5	2	34	0	5319
5781	31	5	2	5431	0	5469
5782	5467	2	3	44	0	5516
5783	5534	4	3	32	0	5573
5784	50	5540	4	17	0	5611
5785	20	38	7	6097	0	6162
5786	12	17	3	6093	0	6125
5787	4	6321	3	69	0	6397
5788	21	58	3	6528	0	6610
5789	6557	18	9	78	0	6662
5790	6841	5	5	36	0	6887
5791	6737	5	7	15	0	6764
5792	88	8	7040	15	0	7151
5793	7292	1	63	22	0	7378
5794	7553	4	16	13	0	7586
5795	7669	4	10	16	0	7699
5796	112	7577	9	15	0	7713
5797	56	68	6	7695	0	7825
5798	24	27	4	7784	0	7839
5799	23	11	2	7733	0	7769
5800	14	7	7546	119	0	7686
5801	22	3	76	7651	0	7752
5802	7724	4	31	106	0	7865
5803	105	7	10	7773	0	7895
5804	42	7	6	8007	0	8062
5805	19	14	7848	126	0	8007
5806	12	7774	84	63	0	7933
5807	8049	91	30	38	0	8208
5808	108	34	13	8058	0	8213
5809	8077	12	6	109	0	8204
5810	115	12	7916	48	0	8091
5811	7603	7	88	38	0	7736
5812	105	7981	37	35	0	8158
5813	46	86	7978	20	0	8130
5814	34	36	8009	20	0	8099
5815	36	24	109	7751	0	7920
5816	24	13	8110	98	0	8245
5817	24	8121	94	48	0	8287
5818	23	82	41	8052	0	8198
5819	26	34	17	8255	0	8332
5820	15	17	17	8194	0	8243
5821	8035	13	13	134	0	8195
5822	92	8010	10	73	0	8185
5823	57	78	6	8166	0	8307
5824	33	36	9	8280	0	8358
5825	7966	20	11	143	0	8140
5826	95	7959	10	73	0	8137
5827	8087	92	6	53	0	8238
5828	8007	40	12	37	0	8096
5829	7978	18	16	30	0	8042
5830	140	23	7810	24	0	7997
5831	80	9	83	7669	0	7841
5832	44	7766	42	100	0	7952
5833	38	7925	24	51	0	8038
5834	37	118	21	7790	0	7966
5835	25	7846	17	95	0	7983
5836	8270	99	9	75	0	8453
5837	108	52	8232	41	0	8433
5838	8168	26	87	49	0	8330
5839	8453	19	35	54	0	8561
5840	143	23	23	8526	0	8715
5841	8567	18	18	120	0	8723
5842	122	8955	16	65	0	9158
5843	9118	95	17	57	0	9287
5844	9157	41	16	61	0	9275
5845	9779	29	20	46	0	9874
5846	181	25	9782	38	0	10026
5847	85	29	9857	34	0	10005
5848	74	18	155	9889	0	10136
5849	57	9710	58	146	0	9971
5850	53	10035	39	66	0	10193
5851	48	165	27	9940	0	10180
5852	10015	71	20	169	0	10275
5853	152	37	28	10008	0	10225
5854	65	40	18	10162	0	10285
5855	10022	19	22	203	0	10266
5856	151	10066	26	101	0	10344
5857	86	131	10064	65	0	10346
5858	60	47	9954	61	0	10122
5859	10138	32	144	71	0	10385
5860	171	39	62	10091	0	10363
5861	85	24	10220	156	0	10485
5862	68	26	139	10099	0	10332
5863	48	29	57	10143	0	10277
5864	60	21	40	10347	0	10468
5865	42	33	31	10176	0	10282
5866	40	9981	24	195	0	10240
5867	52	127	27	10124	0	10330
5868	10026	59	29	186	0	10300
5869	156	9991	33	105	0	10285
5870	10210	136	36	74	0	10456
5871	10322	61	22	77	0	10482
5872	10359	40	28	58	0	10485
5873	196	46	10035	42	0	10319
5874	10049	38	134	68	0	10289
5875	10333	23	54	62	0	10472
5876	10137	31	37	53	0	10258
5877	10247	27	28	57	0	10359
5878	196	10115	29	55	0	10395
5879	9996	137	12	62	0	10207
5880	175	50	9881	48	0	10154
5881	88	38	118	9701	0	9945
5882	70	35	39	9887	0	10031
5883	10041	17	25	168	0	10251
5884	159	9908	22	95	0	10184
5885	9568	105	19	48	0	9740
5886	126	9584	23	42	0	9775
5887	9444	97	9	41	0	9591
5888	9369	39	10	40	0	9458
5889	141	10192	12	22	0	10367
5890	10241	113	16	28	0	10398
5891	10661	43	13	27	0	10744
5892	190	9940	7	19	0	10156
5893	54	10291	10	29	0	10384
5894	10849	152	39	27	0	11067
5895	224	48	11	11037	0	11320
5896	11189	20	9	168	0	11386
5897	11519	22	8	65	0	11614
5898	11764	12	0	40	0	11816
5899	11746	9	4	34	0	11793
5900	251	11336	13	17	0	11617
5901	95	11618	12	12	0	11737
5902	11641	197	12	28	0	11878
5903	429	64	11409	16	0	11918
5904	110	42	151	11428	0	11731
5905	60	19	61	11699	0	11839
5906	11574	14	22	239	0	11849
5907	185	11470	10	93	0	11758
5908	94	162	8	11497	0	11761
5909	51	66	4	11815	0	11936
5910	11718	27	4	254	0	12003
5911	217	16	8	11797	0	12038
5912	11782	18	4	212	0	12016
5913	11811	23	5	90	0	11929
5914	11893	9	6	44	0	11952
5915	288	17	2	11741	0	12048
5916	132	9	8	11790	0	11939
5917	65	11	12310	251	0	12637
5918	53	24	12143	102	0	12322
5919	12380	15	274	62	0	12731
5920	259	34	99	12677	0	13069
5921	124	16	13204	249	0	13593
5922	60	21	13313	111	0	13505
5923	66	11	357	13297	0	13731
5924	47	17	13301	298	0	13663
5925	65	18	285	13280	0	13648
5926	69	15	127	13424	0	13635
5927	59	26	13381	393	0	13859
5928	60	19	275	13529	0	13883
5929	89	25	141	13226	0	13481
5930	66	23	42	13889	0	14020
5931	53	17	13472	451	0	13993
5932	80	8	289	13785	0	14162
5933	13692	18	121	371	0	14202
5934	315	13716	45	183	0	14259
5935	13886	274	40	91	0	14291
5936	345	135	13559	65	0	14104
5937	13743	43	291	75	0	14152
5938	13941	25	147	68	0	14181
5939	13888	26	56	65	0	14035
5940	461	23	39	13514	0	14037
5941	226	25	49	13709	0	14009
5942	102	22	12851	443	0	13418
5943	12438	24	276	224	0	12962
5944	333	12446	155	106	0	13040
5945	164	11943	48	81	0	12236
5946	87	12248	40	84	0	12459
5947	121	352	68	11759	0	12300
5948	11672	133	35	301	0	12141
5949	11808	36	30	183	0	12057
5950	417	24	11467	80	0	11988
5951	196	32	256	11499	0	11983
5952	97	30	117	11713	0	11957
5953	81	27	11384	406	0	11898
5954	79	26	11171	183	0	11459
5955	11212	22	339	99	0	11672
5956	297	11303	137	105	0	11842
5957	11444	263	47	101	0	11855
5958	11532	118	53	90	0	11793
5959	412	33	49	11313	0	11807
5960	204	29	52	11530	0	11815
5961	11205	30	43	421	0	11699
5962	337	22	48	11273	0	11680
5963	191	31	40	11393	0	11655
5964	11221	27	49	432	0	11729
5965	321	19	60	11316	0	11716
5966	11378	14	40	356	0	11788
5967	11500	19	47	219	0	11785
5968	408	22	11169	108	0	11707
5969	11293	25	277	100	0	11695
5970	11363	23	152	116	0	11654
5971	11385	17	77	107	0	11586
5972	440	50	8709	116	0	9315
5973	10914	23	189	92	0	11218
5974	327	10728	100	94	0	11249
5975	10996	239	52	90	0	11377
5976	11117	107	38	114	0	11376
5977	423	24	56	10917	0	11420
5978	210	16	53	11001	0	11280
5979	107	10872	51	399	0	11429
5980	111	243	46	10999	0	11399
5981	114	128	30	11178	0	11450
5982	10910	47	39	425	0	11421
5983	321	33	43	10780	0	11177
5984	218	32	39	10825	0	11114
5985	134	32	33	10750	0	10949
5986	112	10252	47	410	0	10821
5987	10117	231	38	218	0	10604
5988	310	10121	49	135	0	10615
5989	9202	216	39	88	0	9545
5990	294	117	8783	78	0	9272
5991	8387	38	192	99	0	8716
5992	248	27	8414	73	0	8762
5993	161	8065	204	75	0	8505
5994	7539	170	205	65	0	7979
5995	7336	98	63	49	0	7546
5996	265	6921	30	58	0	7274
5997	126	6932	28	51	0	7137
5998	6749	190	39	49	0	7027
5999	6834	67	33	45	0	6979
6000	238	27	19	6776	0	7060
6001	134	20	18	6921	0	7093
6002	55	34	6698	218	0	7005
6003	6595	23	129	105	0	6852
6004	176	27	74	6589	0	6866
6005	120	6599	23	160	0	6902
6006	69	128	16	6631	0	6844
6007	64	77	11	6642	0	6794
6008	49	29	6416	226	0	6720
6009	54	19	128	6451	0	6652
6010	6345	24	70	169	0	6608
6011	159	6211	17	117	0	6504
6012	97	6245	15	48	0	6405
6013	6205	182	22	43	0	6452
6014	6311	83	25	42	0	6461
6015	6291	22	20	51	0	6384
6016	230	5995	20	34	0	6279
6017	76	5565	12	15	0	5668
6018	5810	108	36	18	0	5972
6019	5844	46	16	31	0	5937
6020	162	5525	11	28	0	5726
6021	35	4978	4	5	0	5022
6022	4908	66	17	9	0	5000
6023	63	32	3	4852	0	4950
6024	4981	4	2	61	0	5048
6025	71	7	1	5056	0	5135
6026	25	5145	3	61	0	5234
6027	14	5189	5	26	0	5234
6028	5357	75	13	10	0	5455
6029	5446	28	11	12	0	5497
6030	5580	14	1	8	0	5603
6031	101	5496	4	16	0	5617
6032	26	66	5244	7	0	5343
6033	10	5246	62	5	0	5323
6034	5117	72	21	6	0	5216
6035	5002	21	4	15	0	5042
6036	79	14	4942	2	0	5037
6037	27	4891	59	1	0	4978
6038	22	62	22	4884	0	4990
6039	15	18	5	4843	0	4881
6040	16	4145	6	288	0	4455
6041	14	58	4806	18	0	4896
6042	4943	21	60	7	0	5031
6043	77	12	17	4991	0	5097
6044	5007	9	5	69	0	5090
6045	5150	7	5	27	0	5189
6046	93	14	4	5317	0	5428
6047	33	11	7	5575	0	5626
6048	26	9	4	5679	0	5718
6049	16	8	0	5748	0	5772
6050	5620	14	6	118	0	5758
6051	5688	7	7	43	0	5745
6052	115	11	5663	28	0	5817
6053	58	5	80	5677	0	5820
6054	27	10	25	5789	0	5851
6055	18	11	13	5811	0	5853
6056	15	10	5688	125	0	5838
6057	25	6	81	5636	0	5748
6058	5581	6	33	106	0	5726
6059	106	5	12	5611	0	5734
6060	50	6	5591	108	0	5755
6061	27	8	87	5641	0	5763
6062	11	11	5671	109	0	5802
6063	5699	7	92	54	0	5852
6064	107	5	28	5765	0	5905
6065	5778	5	23	101	0	5907
6066	5778	6	9	50	0	5843
6067	128	3	10	5746	0	5887
6068	5892	8	7	109	0	6016
6069	111	9	15	5867	0	6002
6070	44	6140	8	121	0	6313
6071	6338	81	15	47	0	6481
6072	6394	28	7	40	0	6469
6073	6471	16	11	26	0	6524
6074	157	2	6	6375	0	6540
6075	65	8	10	6420	0	6503
6076	35	8	10	6458	0	6511
6077	28	6	6221	140	0	6395
6078	28	6090	84	70	0	6272
6079	32	92	31	6079	0	6234
6080	27	32	6042	113	0	6214
6081	6023	11	93	59	0	6186
6082	111	10	34	6063	0	6218
6083	52	7	6033	111	0	6203
6084	6137	9	89	71	0	6306
6085	114	9	31	6278	0	6432
6086	59	2	23	6356	0	6440
6087	38	14	9	6407	0	6468
6088	6338	6	9	168	0	6521
6089	6400	7	15	80	0	6502
6090	6350	2	18	42	0	6412
6091	137	6083	16	38	0	6274
6092	64	6226	18	34	0	6342
6093	6284	101	11	42	0	6438
6094	115	34	6210	33	0	6392
6095	57	25	90	6195	0	6367
6096	42	6	37	6343	0	6428
6097	6250	6	22	142	0	6420
6098	6166	14	14	70	0	6264
6099	135	6106	13	47	0	6301
6100	61	85	21	6132	0	6299
6101	38	30	6032	118	0	6218
6102	39	18	6036	72	0	6165
6103	46	5	117	6180	0	6348
6104	33	10	49	6341	0	6433
6105	6236	11	16	152	0	6415
6106	115	8	14	6347	0	6484
6107	6531	11	18	119	0	6679
6108	6505	13	19	61	0	6598
6109	117	13	6400	60	0	6590
6110	6542	9	72	47	0	6670
6111	6630	6	33	50	0	6719
6112	6655	12	27	35	0	6729
6113	139	6500	10	39	0	6688
6114	70	6555	13	52	0	6690
6115	49	113	18	6514	0	6694
6116	39	35	6465	117	0	6656
6117	33	6228	70	70	0	6401
6118	48	89	39	5917	0	6093
6119	42	24	19	5840	0	5925
6120	34	5827	11	87	0	5959
6121	5902	54	13	61	0	6030
6122	5927	25	19	37	0	6008
6123	99	13	6047	33	0	6192
6124	5881	4	54	37	0	5976
6125	77	10	5871	33	0	5991
6126	5471	15	55	38	0	5579
6127	85	10	5661	23	0	5779
6128	50	5607	57	13	0	5727
6129	50	35	39	5466	0	5590
6130	23	22	23	5477	0	5545
6131	5520	13	11	64	0	5608
6132	5504	4	11	47	0	5566
6133	5482	7	10	33	0	5532
6134	57	12	5527	28	0	5624
6135	43	3	31	5548	0	5625
6136	32	2	26	5661	0	5721
6137	5649	9	13	60	0	5731
6138	50	5630	7	39	0	5726
6139	5835	36	8	32	0	5911
6140	54	24	11	5886	0	5975
6141	42	13	12	5975	0	6042
6142	28	4	11	5978	0	6021
6143	19	8	5	6018	0	6050
6144	22	5	4	6016	0	6047
6145	27	5769	7	69	0	5872
6146	15	5520	3	30	0	5568
6147	7	5379	2	14	0	5402
6148	10	23	1	5432	0	5466
6149	7	10	5383	17	0	5417
6150	5032	5	17	16	0	5070
6151	17	5491	6	8	0	5522
6152	18	16	5	5536	0	5575
6153	13	7	4	5556	0	5580
6154	5659	8	5	27	0	5699
6155	5611	5	3	19	0	5638
6156	5719	0	4	14	0	5737
6157	33	3	4	5969	0	6009
6158	17	5	6031	20	0	6073
6159	10	4	6158	16	0	6188
6160	13	1	28	6267	0	6309
6161	5	3	6331	28	0	6367
6162	6081	2	26	32	0	6141
6163	30	1	16	6204	0	6251
6164	16	6	6240	32	0	6294
6165	14	1	27	6174	0	6216
6166	12	2	6480	30	0	6524
6167	15	3	6698	24	0	6740
6168	18	8	41	7126	0	7193
6169	8	2	7431	56	0	7497
6170	6	6	7074	24	0	7110
6171	3	6759	82	13	0	6857
6172	26	63	42	7127	0	7258
6173	7451	27	16	63	0	7557
6174	65	10	10	7390	0	7475
6175	30	3	6	7611	0	7650
6176	14	7	7558	90	0	7669
6177	7177	3	66	51	0	7297
6178	70	0	27	7677	0	7774
6179	33	1	12	7819	0	7865
6180	7734	1	7	103	0	7845
6181	69	1	8	7787	0	7865
6182	7834	2	7	81	0	7924
6183	7830	3	6	46	0	7885
6184	7798	0	4	32	0	7834
6185	102	7607	6	12	0	7727
6186	7730	58	5	16	0	7809
6187	79	7710	6	11	0	7806
6188	40	71	3	7816	0	7930
6189	7885	29	4	77	0	7995
6190	69	7885	3	39	0	7996
6191	7950	66	3	23	0	8042
6192	75	7899	5	13	0	7992
6193	7857	71	2	19	0	7949
6194	80	7773	8	9	0	7870
6195	37	7920	5	11	0	7973
6196	21	8319	3	18	0	8361
6197	15	102	6	8199	0	8322
6198	13	8494	6	64	0	8577
6199	13	86	2	8496	0	8597
6200	15	49	7	8598	0	8669
6201	15	23	4	8609	0	8651
6202	14	12	4	8637	0	8667
6203	8540	12	6	126	0	8684
6204	8597	9	5	65	0	8676
6205	110	4	8525	30	0	8669
6206	8716	9	78	32	0	8835
6207	8965	7	36	31	0	9039
6208	9153	8	16	24	0	9201
6209	136	7	8847	17	0	9007
6210	63	9	8910	13	0	8995
6211	8817	11	119	27	0	8974
6212	105	14	9154	20	0	9293
6213	60	9424	105	21	0	9610
6214	45	98	40	9545	0	9728
6215	9763	41	22	118	0	9944
6216	9853	18	19	62	0	9952
6217	9876	10	15	39	0	9940
6218	159	14	13	9879	0	10065
6219	77	12	9	10010	0	10108
6220	40	15	10090	142	0	10287
6221	40	7	101	10085	0	10233
6222	39	9	38	10305	0	10391
6223	10091	12	14	159	0	10276
6224	115	10173	14	67	0	10369
6225	10301	101	14	53	0	10469
6226	131	53	11	10346	0	10541
6227	10186	25	7	132	0	10350
6228	10029	15	8	68	0	10120
6229	9838	21	9	49	0	9917
6230	159	9720	11	34	0	9924
6231	70	9955	8	29	0	10062
6232	56	128	7	10001	0	10192
6233	10096	52	11	126	0	10285
6234	129	26	8	10004	0	10167
6235	71	22	12	10070	0	10175
6236	46	22	9980	149	0	10197
6237	42	18	95	9940	0	10095
6238	44	16	40	9998	0	10098
6239	46	11	20	10013	0	10090
6240	30	13	9918	161	0	10122
6241	33	19	9707	81	0	9840
6242	29	9790	131	51	0	10001
6243	9808	100	54	55	0	10017
6244	126	49	23	9886	0	10084
6245	65	18	9939	120	0	10142
6246	49	21	101	9854	0	10025
6247	49	14	42	10345	0	10450
6248	10271	14	19	161	0	10465
6249	10244	14	17	84	0	10359
6250	154	10233	17	51	0	10455
6251	10152	93	21	51	0	10317
6252	10130	44	24	39	0	10237
6253	166	23	17	10123	0	10329
6254	80	26	10061	110	0	10277
6255	45	10077	95	60	0	10277
6256	10074	112	41	49	0	10276
6257	10233	43	26	42	0	10344
6258	158	10490	10	34	0	10692
6259	73	93	8	10771	0	10945
6260	11094	39	13	149	0	11295
6261	11174	30	12	73	0	11289
6262	179	12	10	11252	0	11453
6263	11305	14	16	173	0	11508
6264	12111	16	10	85	0	12222
6265	12431	12	20	55	0	12518
6266	237	17	12433	34	0	12721
6267	106	12075	142	37	0	12360
6268	68	12248	45	40	0	12401
6269	11924	146	41	32	0	12143
6270	164	12027	14	22	0	12227
6271	72	157	11988	20	0	12237
6272	66	58	132	12000	0	12256
6273	11962	39	48	154	0	12203
6274	169	24	24	11928	0	12145
6275	11932	21	14	190	0	12157
6276	11987	16	8	68	0	12079
6277	11944	15	6	61	0	12026
6278	214	11589	19	32	0	11854
6279	83	12056	24	35	0	12198
6280	12028	161	10	52	0	12251
6281	11906	63	12	41	0	12022
6282	12115	30	9	33	0	12187
6283	220	24	12	11947	0	12203
6284	11893	20	17	154	0	12084
6285	187	11690	16	61	0	11954
6286	78	12036	15	56	0	12185
6287	73	164	13	11910	0	12160
6288	54	67	11789	157	0	12067
6289	44	36	11632	71	0	11783
6290	52	28	187	11706	0	11973
6291	48	29	11758	156	0	11991
6292	40	27	157	11763	0	11987
6293	11804	20	50	186	0	12060
6294	189	13	30	11766	0	11998
6295	11639	20	26	199	0	11884
6296	184	11319	25	70	0	11598
6297	86	162	11351	47	0	11646
6298	76	54	144	11139	0	11413
6299	55	36	48	11348	0	11487
6300	36	31	11349	194	0	11610
6301	35	24	155	11102	0	11316
6302	41	11435	55	175	0	11706
6303	56	167	30	11575	0	11828
6304	52	50	23	11785	0	11910
6305	58	33	12	12146	0	12249
6306	49	24	12014	259	0	12346
6307	33	23	11608	105	0	11769
6308	11028	17	221	69	0	11335
6309	202	25	11290	29	0	11546
6310	65	11196	198	40	0	11499
6311	11229	171	63	50	0	11513
6312	190	11257	42	34	0	11523
6313	10957	194	47	31	0	11229
6314	11014	59	44	36	0	11153
6315	10915	39	24	46	0	11024
6316	10917	23	17	43	0	11000
6317	256	10472	18	30	0	10776
6318	108	10717	18	34	0	10877
6319	10715	223	13	37	0	10988
6320	218	73	10441	25	0	10757
6321	98	43	172	10330	0	10643
6322	79	25	60	10557	0	10721
6323	46	27	10406	232	0	10711
6324	10054	24	186	96	0	10360
6325	10393	25	60	56	0	10534
6326	10356	30	35	43	0	10464
6327	273	10168	30	34	0	10505
6328	10508	187	27	41	0	10763
6329	252	68	29	10264	0	10613
6330	97	10824	23	176	0	11120
6331	10991	203	26	71	0	11291
6332	11199	76	19	63	0	11357
6333	11703	51	28	36	0	11818
6334	334	46	21	11439	0	11840
6335	166	39	17	11509	0	11731
6336	90	11208	27	276	0	11601
6337	75	217	11322	121	0	11735
6338	79	90	215	11372	0	11756
6339	79	53	78	11335	0	11545
6340	88	27	50	11686	0	11851
6341	59	33	11366	331	0	11789
6342	11331	28	216	156	0	11731
6343	276	28	76	11582	0	11962
6344	123	34	11620	254	0	12031
6345	106	31	235	11588	0	11960
6346	11723	30	89	301	0	12143
6347	273	11562	70	124	0	12029
6348	118	248	36	11748	0	12150
6349	89	89	11685	282	0	12145
6350	11437	60	249	140	0	11886
6351	11766	36	95	90	0	11987
6352	337	30	11555	70	0	11992
6353	170	60	246	10972	0	11448
6354	88	11388	103	258	0	11837
6355	11508	244	71	117	0	11940
6356	285	91	11234	80	0	11690
6357	11064	57	253	76	0	11450
6358	334	27	10679	59	0	11099
6359	181	36	10161	49	0	10427
6360	9776	29	304	44	0	10153
6361	254	9862	130	58	0	10304
6362	165	211	9695	56	0	10127
6363	96	9339	220	50	0	9705
6364	113	216	8889	53	0	9271
6365	41	8694	219	34	0	8988
6366	8100	215	113	55	0	8483
6367	205	61	7895	44	0	8205
6368	81	38	7802	27	0	7948
6369	69	30	7560	33	0	7692
6370	7225	44	241	31	0	7541
6371	7328	24	92	27	0	7471
6372	197	19	54	7164	0	7434
6373	83	20	7289	148	0	7540
6374	63	21	7346	58	0	7488
6375	7302	25	194	36	0	7557
6376	177	17	92	7324	0	7610
6377	7365	18	65	152	0	7600
6378	7455	14	45	60	0	7574
6379	226	21	31	7053	0	7331
6380	91	7057	46	160	0	7354
6381	66	135	39	7139	0	7379
6382	46	61	37	7258	0	7402
6383	49	38	7091	195	0	7373
6384	52	6877	157	86	0	7172
6385	46	7070	81	52	0	7249
6386	50	163	52	6873	0	7138
6387	38	68	6915	148	0	7169
6388	33	6913	164	76	0	7186
6389	46	142	6931	49	0	7168
6390	6819	56	168	44	0	7087
6391	7056	38	79	37	0	7210
6392	189	26	6918	40	0	7173
6393	6933	28	174	39	0	7174
6394	192	29	69	6904	0	7194
6395	83	7123	64	148	0	7418
6396	62	144	44	7234	0	7484
6397	7060	58	49	169	0	7336
6398	7192	46	39	76	0	7353
6399	7149	27	42	42	0	7260
6400	6950	23	40	48	0	7061
6401	219	6656	43	39	0	6957
6402	86	6527	47	34	0	6694
6403	6498	141	34	37	0	6710
6404	159	67	6402	37	0	6665
6405	77	213	122	5914	0	6326
6406	56	6065	58	104	0	6283
6407	42	92	40	6029	0	6203
6408	32	6189	34	104	0	6359
6409	50	111	23	6244	0	6428
6410	36	50	6237	117	0	6440
6411	6208	26	119	59	0	6412
6412	6309	34	60	34	0	6437
6413	145	27	6200	26	0	6398
6414	6253	25	118	33	0	6429
6415	6310	23	55	27	0	6415
6416	144	27	6142	22	0	6335
6417	79	17	134	6053	0	6283
6418	6162	14	51	108	0	6335
6419	141	19	6109	44	0	6313
6420	67	17	130	5990	0	6204
6421	59	18	6227	113	0	6417
6422	36	16	6183	57	0	6292
6423	6205	28	150	39	0	6422
6424	6397	20	65	30	0	6512
6425	6451	18	40	27	0	6536
6426	6698	15	33	26	0	6772
6427	191	19	25	6477	0	6712
6428	96	6136	26	102	0	6360
6429	46	6273	29	64	0	6412
6430	52	143	22	5829	0	6046
6431	5900	42	22	101	0	6065
6432	115	5672	22	39	0	5848
6433	36	5422	8	21	0	5487
6434	5409	93	14	19	0	5535
6435	98	35	14	5390	0	5537
6436	5418	18	11	90	0	5537
6437	100	5414	11	31	0	5556
6438	5514	79	11	17	0	5621
6439	113	22	5766	13	0	5914
6440	6281	13	94	14	0	6402
6441	6493	9	33	17	0	6552
6442	6636	16	13	17	0	6682
6443	177	17	5667	23	0	5884
6444	6359	15	71	11	0	6456
6445	133	6315	26	13	0	6487
6446	56	100	6250	11	0	6417
6447	49	58	115	6004	0	6226
6448	35	14	48	5893	0	5990
6449	16	5963	12	126	0	6117
6450	17	99	18	6032	0	6166
6451	23	36	11	6134	0	6204
6452	20	15	5933	153	0	6121
6453	5670	15	106	56	0	5847
6454	114	8	5980	28	0	6130
6455	57	7	119	5939	0	6122
6456	26	10	6060	109	0	6205
6457	29	6	125	6097	0	6257
6458	6204	6	56	130	0	6396
6459	6416	7	18	64	0	6505
6460	170	7	23	6389	0	6589
6461	57	6	6438	149	0	6650
6462	58	5	123	6487	0	6673
6463	42	10	6415	131	0	6598
6464	6313	4	137	70	0	6524
6465	6525	6	56	31	0	6618
6466	6376	6	27	35	0	6444
6467	6453	11	22	26	0	6512
6468	195	6147	12	22	0	6376
6469	87	119	9	6249	0	6464
6470	6165	45	17	135	0	6362
6471	147	6033	10	61	0	6251
6472	60	6205	20	30	0	6315
6473	37	142	5940	39	0	6158
6474	5966	48	128	18	0	6160
6475	6110	31	49	16	0	6206
6476	188	20	5897	12	0	6117
6477	83	9	144	5896	0	6132
6478	63	8	48	6060	0	6179
6479	50	13	5957	160	0	6180
6480	33	11	144	5954	0	6142
6481	5926	10	57	159	0	6152
6482	155	12	5751	62	0	5980
6483	71	11	5963	28	0	6073
6484	5887	8	163	33	0	6091
6485	164	8	5981	21	0	6174
6486	5904	13	151	23	0	6091
6487	159	5870	71	26	0	6126
6488	5984	128	30	23	0	6165
6489	162	49	30	5913	0	6154
6490	83	22	15	6033	0	6153
6491	5937	29	17	178	0	6161
6492	169	19	18	5944	0	6150
6493	5943	12	20	171	0	6146
6494	151	5921	25	76	0	6173
6495	85	135	18	5740	0	5978
6496	51	56	22	5882	0	6011
6497	5768	27	22	176	0	5993
6498	5829	27	12	77	0	5945
6499	5832	15	20	51	0	5918
6500	211	5504	14	48	0	5777
6501	95	5647	21	34	0	5797
6502	5632	151	18	22	0	5823
6503	168	56	5504	23	0	5751
6504	77	5455	122	28	0	5682
6505	5184	135	97	34	0	5450
6506	5125	38	34	20	0	5217
6507	5092	22	23	21	0	5158
6508	184	26	15	4890	0	5115
6509	4956	9	21	129	0	5115
6510	4954	13	11	58	0	5036
6511	197	10	12	4743	0	4962
6512	4805	16	15	136	0	4972
6513	160	14	4628	53	0	4855
6514	82	16	109	4677	0	4884
6515	41	12	50	4788	0	4891
6516	52	9	23	4919	0	5003
6517	4787	12	23	173	0	4995
6518	4911	18	12	88	0	5029
6519	4939	15	10	61	0	5025
6520	4918	6	9	57	0	4990
6521	4763	8	22	30	0	4823
6522	198	6	20	4518	0	4742
6523	99	5	17	4609	0	4730
6524	4472	4	18	160	0	4654
6525	141	4354	18	75	0	4588
6526	4276	100	18	55	0	4449
6527	149	33	4094	41	0	4317
6528	4314	14	90	26	0	4444
6529	4428	20	37	27	0	4512
6530	183	6	4482	23	0	4694
6531	4589	8	132	25	0	4754
6532	178	8	4591	25	0	4802
6533	81	10	4749	11	0	4851
6534	71	21	155	4667	0	4914
6535	66	15	66	4931	0	5078
6536	38	11	4870	160	0	5079
6537	49	10	4904	77	0	5040
6538	25	4617	153	68	0	4863
6539	27	4502	55	43	0	4627
6540	3799	102	68	16	0	3985
6541	91	4050	19	11	0	4171
6542	3932	101	16	16	0	4065
6543	109	3856	11	18	0	3994
6544	3871	99	19	8	0	3997
6545	107	26	3731	9	0	3873
6546	3753	27	84	15	0	3879
6547	109	21	24	3734	0	3888
6548	38	3778	26	79	0	3921
6549	37	86	15	3867	0	4005
6550	3874	23	8	100	0	4005
6551	3953	31	8	29	0	4021
6552	119	20	2	3879	0	4020
6553	55	10	3815	84	0	3964
6554	52	11	3719	26	0	3808
6555	18	3851	86	37	0	3992
6556	22	105	36	3840	0	4003
6557	17	22	3823	76	0	3938
6558	28	3557	74	23	0	3682
6559	28	78	24	3570	0	3700
6560	12	20	23	3613	0	3668
6561	3414	25	11	80	0	3530
6562	69	10	6	3401	0	3486
6563	20	7	3334	94	0	3455
6564	32	5	62	3322	0	3421
6565	3268	6	24	86	0	3384
6566	61	10	3291	26	0	3388
6567	3237	4	58	37	0	3336
6568	80	3328	21	18	0	3447
6569	3411	62	20	9	0	3502
6570	3468	19	9	19	0	3515
6571	81	20	14	3363	0	3478
6572	46	9	3	3437	0	3495
6573	35	3349	6	82	0	3472
6574	11	58	7	3468	0	3544
6575	3387	15	6	87	0	3495
6576	60	25	3352	34	0	3471
6577	30	6	61	3358	0	3455
6578	29	3314	24	67	0	3434
6579	21	62	21	3405	0	3509
6580	14	21	10	3470	0	3515
6581	3380	22	8	85	0	3495
6582	62	3339	5	51	0	3457
6583	32	60	5	3388	0	3485
6584	3348	23	8	76	0	3455
6585	73	26	5	3352	0	3456
6586	26	14	6	3444	0	3490
6587	3481	7	10	98	0	3596
6588	3461	6	7	64	0	3538
6589	83	9	3426	41	0	3559
6590	3416	9	60	25	0	3510
6591	3525	4	19	27	0	3575
6592	3536	11	25	17	0	3589
6593	106	3313	8	16	0	3443
6594	52	3342	6	16	0	3416
6595	44	67	5	3348	0	3464
6596	3369	39	7	61	0	3476
6597	3413	25	4	30	0	3472
6598	87	10	3	3366	0	3466
6599	57	6	3403	65	0	3531
6600	3456	6	55	31	0	3548
6601	3661	4	20	35	0	3720
6602	88	10	20	3583	0	3701
6603	49	9	10	3631	0	3699
6604	3640	9	9	76	0	3734
6605	77	8	5	3599	0	3689
6606	32	3611	2	91	0	3736
6607	32	59	11	3736	0	3838
6608	3760	24	3	87	0	3874
6609	67	27	3700	37	0	3831
6610	3565	8	56	40	0	3669
6611	81	8	3665	25	0	3779
6612	42	11	66	3705	0	3824
6613	3783	3	27	78	0	3891
6614	78	8	18	3781	0	3885
6615	36	0	11	3831	0	3878
6616	3747	5	6	91	0	3849
6617	64	10	3704	49	0	3827
6618	38	7	3806	42	0	3893
6619	38	7	71	3886	0	4002
6620	27	4	34	3993	0	4058
6621	22	2	34	4051	0	4109
6622	15	7	3998	95	0	4115
6623	3859	6	53	64	0	3982
6624	4124	5	17	45	0	4191
6625	4151	0	30	27	0	4208
6626	4166	2	10	31	0	4209
6627	100	3990	11	20	0	4121
6628	58	4006	9	27	0	4100
6629	42	4036	9	8	0	4095
6630	18	53	7	3629	0	3707
6631	12	15	4	3771	0	3802
6632	10	8	3658	40	0	3716
6633	7	3441	17	24	0	3489
6634	27	10	6	3377	0	3420
6635	3301	9	8	18	0	3336
6636	11	3309	3	13	0	3336
6637	11	10	3	3260	0	3284
6638	7	3326	2	14	0	3349
6639	3460	12	3	14	0	3489
6640	19	5	3	3491	0	3518
6641	10	6	3451	16	0	3483
6642	9	3	3455	12	0	3479
6643	4	12	25	3574	0	3615
6644	6	0	8	3628	0	3642
6645	3	1	5	3763	0	3772
6646	3733	1	3	34	0	3771
6647	22	1	3707	15	0	3745
6648	8	3629	20	9	0	3666
6649	9	22	6	3644	0	3681
6650	3	9	3658	21	0	3691
6651	3	3637	18	13	0	3671
6652	6	22	9	3748	0	3785
6653	4	8	3747	20	0	3779
6654	7	2	17	3709	0	3735
6655	4	0	9	3769	0	3782
6656	3804	3	1	32	0	3840
6657	3786	2	1	14	0	3803
6658	29	0	2	3779	0	3810
6659	3795	0	5	26	0	3826
6660	29	3	3825	9	0	3866
6661	12	0	22	3852	0	3886
6662	2	1	3939	23	0	3965
6663	2	2	23	3983	0	4010
6664	3	3929	10	26	0	3968
6665	1	3953	3	14	0	3971
6666	2	4062	4	5	0	4073
6667	7	30	3	4095	0	4135
6668	4	10	0	4409	0	4423
6669	3	4	4384	42	0	4433
6670	5	4	4328	10	0	4347
6671	4	6	4501	4	0	4515
6672	4707	1	44	12	0	4764
6673	48	5	11	4833	0	4897
6674	4892	1	6	52	0	4951
6675	46	4981	4	14	0	5045
6676	15	48	5	5039	0	5107
6677	5107	13	1	63	0	5184
6678	59	5	3	5119	0	5186
6679	5119	3	2	59	0	5183
6680	56	5	5215	18	0	5294
6681	19	5268	50	10	0	5347
6682	8	52	14	5353	0	5427
6683	5382	11	4	56	0	5453
6684	5450	3	6	21	0	5480
6685	70	2	7	5440	0	5519
6686	21	7	4	5504	0	5536
6687	5358	1	6	75	0	5440
6688	60	3	8	5329	0	5400
6689	22	2	5305	60	0	5389
6690	5	5306	59	27	0	5397
6691	16	54	16	5370	0	5456
6692	5375	13	7	74	0	5469
6693	5410	2	5	38	0	5455
6694	81	11	5473	6	0	5571
6695	18	5317	58	20	0	5413
6696	14	5549	19	18	0	5600
6697	15	78	11	5558	0	5662
6698	11	23	8	5609	0	5651
6699	12	9	10	5572	0	5603
6700	11	9	7	5604	0	5631
6701	11	5417	8	92	0	5528
6702	13	66	4	5484	0	5567
6703	18	22	4	5546	0	5590
6704	5458	7	1	106	0	5572
6705	5476	8	2	40	0	5526
6706	89	5480	6	24	0	5599
6707	5559	61	2	25	0	5647
6708	5554	18	13	23	0	5608
6709	5583	12	10	12	0	5617
6710	87	16	5478	14	0	5595
6711	38	6	63	5474	0	5581
6712	25	9	16	5612	0	5662
6713	20	11	5486	93	0	5610
6714	9	9	71	5426	0	5515
6715	21	13	25	5172	0	5231
6716	5434	7	10	107	0	5558
6717	70	5	5401	39	0	5515
6718	28	8	72	5251	0	5359
6719	5214	7	23	98	0	5342
6720	79	5202	11	41	0	5333
6721	5211	72	6	26	0	5315
6722	5183	19	7	32	0	5241
6723	93	5104	3	21	0	5221
6724	39	70	6	5147	0	5262
6725	5146	23	2	82	0	5253
6726	88	5114	7	36	0	5245
6727	41	76	10	5133	0	5260
6728	5035	26	2	96	0	5159
6729	5016	13	9	34	0	5072
6730	99	5014	8	28	0	5149
6731	5060	71	3	31	0	5165
6732	88	21	11	5069	0	5189
6733	5058	13	8	88	0	5167
6734	83	15	4976	43	0	5117
6735	47	8	70	4948	0	5073
6736	31	8	22	4986	0	5047
6737	4885	9	16	107	0	5017
6738	84	4792	12	39	0	4927
6739	4675	72	13	24	0	4784
6740	78	4673	7	29	0	4787
6741	40	58	4385	21	0	4504
6742	27	24	4307	17	0	4375
6743	33	70	86	4178	0	4367
6744	21	9	4213	75	0	4318
6745	26	17	68	4179	0	4290
6746	19	9	22	4172	0	4222
6747	24	6	9	4284	0	4323
6748	4298	8	10	88	0	4404
6749	4311	11	3	44	0	4369
6750	4413	13	4	25	0	4455
6751	106	4447	7	20	0	4580
6752	39	4814	4	22	0	4879
6753	34	104	5086	17	0	5241
6754	32	32	108	5190	0	5362
6755	18	26	5176	126	0	5346
6756	24	13	112	5138	0	5287
6757	21	11	47	5238	0	5317
6758	21	19	22	5260	0	5322
6759	24	17	5057	159	0	5257
6760	23	16	105	5066	0	5210
6761	5005	7	49	150	0	5211
6762	114	4858	26	86	0	5084
6763	53	103	21	4919	0	5096
6764	4897	37	18	150	0	5102
6765	4958	21	19	61	0	5059
6766	149	18	13	4827	0	5007
6767	74	15	14	4760	0	4863
6768	4485	13	12	149	0	4659
6769	123	11	12	4472	0	4618
6770	4290	4	9	141	0	4444
6771	127	2	8	4185	0	4322
6772	51	3	3955	135	0	4144
6773	29	3727	83	74	0	3913
6774	39	3886	26	37	0	3988
6775	37	93	33	3814	0	3977
6776	49	26	29	3837	0	3941
6777	3750	18	9	123	0	3900
6778	89	17	14	3779	0	3899
6779	34	17	4	3814	0	3869
6780	29	12	7	3585	0	3633
6781	27	3462	6	134	0	3629
6782	18	71	5	3572	0	3666
6783	25	18	3	3582	0	3628
6784	13	14	6	3575	0	3608
6785	3391	15	10	141	0	3557
6786	72	3382	10	76	0	3540
6787	22	84	8	3448	0	3562
6788	23	26	9	3511	0	3569
6789	15	17	2	3523	0	3557
6790	3376	15	3	146	0	3540
6791	96	9	3	3409	0	3517
6792	38	9	3	3413	0	3463
6793	23	5	3190	139	0	3357
6794	19	3111	63	76	0	3269
6795	19	69	16	3227	0	3331
6796	3140	22	8	104	0	3274
6797	74	3138	10	58	0	3280
6798	3111	71	10	50	0	3242
6799	3160	26	14	33	0	3233
6800	94	23	4	3087	0	3208
6801	40	18	7	3174	0	3239
6802	39	12	3112	111	0	3274
6803	24	12	60	3231	0	3327
6804	32	5	3173	108	0	3318
6805	23	4	71	3247	0	3345
6806	3069	5	27	115	0	3216
6807	68	3124	14	61	0	3267
6808	28	69	21	3256	0	3374
6809	25	27	11	3302	0	3365
6810	23	21	18	3306	0	3368
6811	24	16	6	3334	0	3380
6812	3185	13	8	122	0	3328
6813	71	3152	8	69	0	3300
6814	31	66	8	3269	0	3374
6815	3243	24	8	125	0	3400
6816	81	17	3195	69	0	3362
6817	3193	15	71	54	0	3333
6818	3294	10	27	44	0	3375
6819	100	20	18	3271	0	3409
6820	50	14	15	3348	0	3427
6821	3304	10	6	117	0	3437
6822	95	3357	14	65	0	3531
6823	3452	71	3	50	0	3576
6824	3471	21	7	49	0	3548
6825	3527	15	3	54	0	3599
6826	119	15	3	3434	0	3571
6827	65	17	5	3595	0	3682
6828	46	3707	5	108	0	3866
6829	52	79	7	3768	0	3906
6830	3688	29	6	114	0	3837
6831	107	11	3581	46	0	3745
6832	3551	19	69	51	0	3690
6833	3720	13	20	48	0	3801
6834	112	20	12	3667	0	3811
6835	52	7	14	3746	0	3819
6836	3714	8	9	113	0	3844
6837	3750	6	15	54	0	3825
6838	3514	8	5	48	0	3575
6839	119	6	3587	36	0	3748
6840	51	3564	65	49	0	3729
6841	3629	72	16	43	0	3760
6842	102	28	7	3591	0	3728
6843	52	3610	11	84	0	3757
6844	53	79	6	3623	0	3761
6845	3628	25	13	93	0	3759
6846	95	25	6	3640	0	3766
6847	59	15	3500	105	0	3679
6848	30	3435	52	62	0	3579
6849	31	3565	18	35	0	3649
6850	39	70	3338	43	0	3490
6851	2944	62	74	30	0	3110
6852	50	2828	23	30	0	2931
6853	37	37	19	2400	0	2493
6854	2382	6	5	24	0	2417
6855	18	2368	2	14	0	2402
6856	10	18	4	2395	0	2427
6857	2407	7	2	26	0	2442
6858	27	1	4	2406	0	2438
6859	2409	2	5	27	0	2443
6860	26	5	2412	13	0	2456
6861	13	2446	19	7	0	2485
6862	2522	17	6	15	0	2560
6863	2521	6	1	11	0	2539
6864	2502	1	2	11	0	2516
6865	30	7	2358	9	0	2404
6866	2415	4	15	14	0	2448
6867	2486	6	4	4	0	2500
6868	31	8	1	2457	0	2497
6869	2465	6	2	31	0	2504
6870	26	2443	7	11	0	2487
6871	15	19	3	2473	0	2510
6872	15	7	2450	24	0	2496
6873	13	4	22	2444	0	2483
6874	8	9	5	2502	0	2524
6875	2487	7	3	34	0	2531
6876	2480	6	4	24	0	2514
6877	37	5	2442	5	0	2489
6878	2409	5	24	10	0	2448
6879	36	3	2454	8	0	2501
6880	18	6	21	2458	0	2503
6881	6	6	2451	34	0	2497
6882	19	4	19	2428	0	2470
6883	16	2451	8	23	0	2498
6884	24	19	2475	14	0	2532
6885	16	5	2533	9	0	2563
6886	15	8	30	2245	0	2298
6887	2544	8	8	29	0	2589
6888	2553	5	6	16	0	2580
6889	2569	6	2	10	0	2587
6890	38	9	5	2530	0	2582
6891	24	4	4	2563	0	2595
6892	18	4	7	2567	0	2596
6893	15	5	5	2569	0	2594
6894	7	7	2513	36	0	2563
6895	12	10	21	2500	0	2543
6896	12	2472	6	28	0	2518
6897	7	21	10	2518	0	2556
6898	2575	9	7	30	0	2621
6899	32	7	2542	18	0	2599
6900	2460	2	26	15	0	2503
6901	35	6	2629	13	0	2683
6902	15	5	2608	9	0	2637
6903	12	2586	35	8	0	2641
6904	18	30	13	2411	0	2472
6905	11	5	8	2581	0	2605
6906	10	2301	14	37	0	2362
6907	2817	33	9	12	0	2871
6908	49	14	5	2919	0	2987
6909	30	6	5	3176	0	3217
6910	17	6	7	3324	0	3354
6911	3635	5	7	91	0	3738
6912	3869	2	6	47	0	3924
6913	103	3	7	3808	0	3921
6914	53	2	5	3829	0	3889
6915	3767	2	3	108	0	3880
6916	86	4	3	3765	0	3858
6917	41	6	3	3818	0	3868
6918	41	4	5	3830	0	3880
6919	23	4	3663	128	0	3818
6920	3554	2	67	69	0	3692
6921	3637	2	21	53	0	3713
6922	116	3	3441	33	0	3593
6923	51	18	69	3312	0	3450
6924	30	3383	27	95	0	3535
6925	3342	67	24	62	0	3495
6926	86	3350	20	35	0	3491
6927	42	3189	12	33	0	3276
6928	43	79	15	3040	0	3177
6929	3035	35	15	79	0	3164
6930	3139	20	8	45	0	3212
6931	98	22	5	3072	0	3197
6932	53	15	6	3111	0	3185
6933	31	21	5	3091	0	3148
6934	29	16	3	3088	0	3136
6935	36	16	3	3040	0	3095
6936	27	2922	4	120	0	3073
6937	30	59	4	3004	0	3097
6938	2945	26	4	109	0	3084
6939	2996	17	3	66	0	3082
6940	3011	11	1	59	0	3082
6941	102	2889	4	53	0	3048
6942	43	66	5	2914	0	3028
6943	36	32	2882	97	0	3047
6944	2863	21	58	58	0	3000
6945	101	22	24	2883	0	3030
6946	2880	13	18	94	0	3005
6947	2862	11	9	47	0	2929
6948	2864	13	7	41	0	2925
6949	121	13	6	2759	0	2899
6950	2774	14	14	88	0	2890
6951	104	10	10	2775	0	2899
6952	55	10	8	2819	0	2892
6953	2803	4	4	105	0	2916
6954	108	7	6	2797	0	2918
6955	2790	10	3	100	0	2903
6956	2829	7	3	64	0	2903
6957	127	6	5	2773	0	2911
6958	73	5	3	2835	0	2916
6959	44	11	0	2872	0	2927
6960	35	8	2667	139	0	2849
6961	41	8	2693	76	0	2818
6962	50	3	82	2649	0	2784
6963	53	2	33	2704	0	2792
6964	37	6	17	2750	0	2810
6965	27	2	12	2740	0	2781
6966	26	5	15	2752	0	2798
6967	2623	4	18	138	0	2783
6968	76	2585	21	83	0	2765
6969	42	61	16	2656	0	2775
6970	2641	24	10	110	0	2785
6971	87	15	11	2670	0	2783
6972	58	7	4	2702	0	2771
6973	2613	12	5	131	0	2761
6974	2627	10	8	78	0	2723
6975	106	16	2536	56	0	2714
6976	64	12	64	2595	0	2735
6977	47	10	2572	115	0	2744
6978	34	10	71	2619	0	2734
6979	38	7	27	2648	0	2720
6980	44	1	19	2684	0	2748
6981	49	2	2538	133	0	2722
6982	32	2425	73	78	0	2608
6983	27	2580	33	68	0	2708
6984	17	66	34	2588	0	2705
6985	2524	29	17	116	0	2686
6986	73	15	2496	75	0	2659
6987	42	21	2596	66	0	2725
6988	34	13	92	2600	0	2739
6989	27	13	44	2593	0	2677
6990	30	2629	31	107	0	2797
6991	22	73	15	2650	0	2760
6992	28	34	18	2750	0	2830
6993	28	22	26	2772	0	2848
6994	2664	11	29	130	0	2834
6995	2680	6	21	88	0	2795
6996	102	10	15	2714	0	2841
6997	50	2643	8	113	0	2814
6998	35	60	7	2641	0	2743
6999	2569	24	4	115	0	2712
7000	77	2581	12	68	0	2738
7001	52	55	10	2420	0	2537
7002	43	2440	6	85	0	2574
7003	2430	65	5	67	0	2567
7004	2320	31	7	50	0	2408
7005	85	2391	10	42	0	2528
7006	50	2364	10	34	0	2458
7007	29	66	2135	27	0	2257
7008	13	1995	35	28	0	2071
7009	26	63	22	1726	0	1837
7010	19	12	1680	44	0	1755
7011	3	1259	20	10	0	1292
7012	5	12	8	1091	0	1116
7013	5	1	2	1106	0	1114
7014	3	1	0	1110	0	1114
7015	1086	1	2	21	0	1110
7016	13	2	1057	8	0	1080
7017	5	2	1074	4	0	1085
7018	3	4	14	1096	0	1117
7019	5	1	1160	17	0	1183
7020	7	1	12	1168	0	1188
7021	2	2	6	1124	0	1134
7022	0	2	2	1222	0	1226
7023	4	3	1	1218	0	1226
7024	1210	0	0	18	0	1228
7025	1200	1	5	5	0	1211
7026	14	2	2	1217	0	1235
7027	1	1	1281	16	0	1299
7028	3	0	13	1280	0	1296
7029	2	1256	1	16	0	1275
7030	2	10	0	1271	0	1283
7031	1254	3	5	17	0	1279
7032	1272	5	2	6	0	1285
7033	16	3	1	1279	0	1299
7034	5	2	1	1295	0	1303
7035	4	1	1	1303	0	1309
7036	1270	2	2	20	0	1294
7037	14	3	1271	3	0	1291
7038	6	0	1240	6	0	1252
7039	3	1237	9	5	0	1254
7040	1265	10	3	3	0	1281
7041	11	4	0	1282	0	1297
7042	3	1	1317	13	0	1334
7043	2	1283	7	8	0	1300
7044	2	1339	3	3	0	1347
7045	4	11	1	1353	0	1369
7046	4	5	1	1377	0	1387
7047	1	1351	2	13	0	1367
7048	1	11	1	1388	0	1401
7049	2	2	0	1403	0	1407
7050	1384	3	2	12	0	1401
7051	11	1385	0	4	0	1400
7052	4	12	1	1378	0	1395
7053	2	2	1370	12	0	1386
7054	0	2	10	1359	0	1371
7055	1370	2	1	13	0	1386
7056	10	1367	3	5	0	1385
7057	2	9	2	1395	0	1408
7058	4	3	1389	10	0	1406
7059	2	2	1429	3	0	1436
7060	1	3	14	1484	0	1502
7061	2	0	1	1542	0	1545
7062	1531	1	2	18	0	1552
7063	15	1560	1	3	0	1579
7064	1577	17	1	2	0	1597
7065	16	2	1600	2	0	1620
7066	1558	1	17	5	0	1581
7067	16	2	1641	3	0	1662
7068	1611	1	20	3	0	1635
7069	1658	0	2	5	0	1665
7070	21	0	1774	2	0	1797
7071	4	2	1757	2	0	1765
7072	2	1709	17	1	0	1729
7073	1	18	4	1843	0	1866
7074	1911	2	4	21	0	1938
7075	19	1	0	1920	0	1940
7076	4	1	0	1965	0	1970
7077	3	1	0	1965	0	1969
7078	2	2	1947	22	0	1973
7079	1824	0	20	7	0	1851
7080	1974	1	4	4	0	1983
7081	21	2015	2	4	0	2042
7082	5	21	0	2045	0	2071
7083	4	2064	1	20	0	2089
7084	4	23	1	2105	0	2133
7085	2101	3	1	26	0	2131
7086	24	2077	2	2	0	2105
7087	8	24	1	2020	0	2053
7088	2027	4	0	25	0	2056
7089	2035	3	1	4	0	2043
7090	29	2	1	1965	0	1997
7091	6	2	1977	25	0	2010
7092	1	11	22	1925	0	1959
7093	2	1991	4	19	0	2016
7094	1988	22	4	4	0	2018
7095	23	1978	1	3	0	2005
7096	6	24	4	1967	0	2001
7097	2006	3	0	28	0	2037
7098	23	4	0	2064	0	2091
7099	6	0	1	2079	0	2086
7100	1	2	2039	26	0	2068
7101	2	2030	19	6	0	2057
7102	1997	21	3	3	0	2024
7103	1875	4	1	7	0	1887
7104	16	1939	2	3	0	1960
7105	7	1948	1	0	0	1956
7106	2	19	0	1935	0	1956
7107	1921	3	1	17	0	1942
7108	15	1899	2	2	0	1918
7109	3	18	0	1937	0	1958
7110	2	4	1933	18	0	1957
7111	2	1	17	1938	0	1958
7112	1955	0	2	21	0	1978
7113	18	1945	2	4	0	1969
7114	5	16	0	2012	0	2033
7115	3	3	1990	17	0	2013
7116	1	1	1953	3	0	1958
7117	3	0	16	1990	0	2009
7118	2	4	3	2023	0	2032
7119	1	1969	1	20	0	1991
7120	2	18	1	1956	0	1977
7121	1975	3	1	22	0	2001
7122	18	1	0	1998	0	2017
7123	2000	3	1	26	0	2030
7124	23	1983	0	5	0	2011
7125	6	2044	2	7	0	2059
7126	7	20	2	2080	0	2109
7127	3	6	2	2034	0	2045
7128	3	4	2028	22	0	2057
7129	4	1	19	1989	0	2013
7130	2009	3	5	21	0	2038
7131	22	0	2016	7	0	2045
7132	7	2	20	2030	0	2059
7133	5	2	2105	24	0	2136
7134	3	0	21	2127	0	2151
7135	6	2	4	2110	0	2122
7136	3	1	4	2161	0	2169
7137	3	1	2156	26	0	2186
7138	1	2	20	2125	0	2148
7139	3	2135	4	26	0	2168
7140	2	16	3	2185	0	2206
7141	4	6	1	2182	0	2193
7142	2141	4	3	25	0	2173
7143	22	3	2108	11	0	2144
7144	6	3	18	2116	0	2143
7145	7	1	2086	20	0	2114
7146	3	0	1998	7	0	2008
7147	4	3	22	2093	0	2122
7148	5	3	6	2031	0	2045
7149	3	3	3	2164	0	2173
7150	2141	3	0	29	0	2173
7151	22	3	2132	10	0	2167
7152	2194	1	19	11	0	2225
7153	23	4	4	2269	0	2300
7154	8	0	3	2320	0	2331
7155	7	2392	2	24	0	2425
7156	3	19	2	2444	0	2468
7157	4	6	2	2439	0	2451
7158	5	4	4	2419	0	2432
7159	2260	2	0	22	0	2284
7160	15	1	2171	8	0	2195
7161	2042	2	11	7	0	2062
7162	14	2189	2	6	0	2211
7163	2157	12	2	5	0	2176
7164	14	2120	1	3	0	2138
7165	8	2118	1	2	0	2129
7166	10	16	2	2114	0	2142
7167	2132	5	3	11	0	2151
7168	12	4	1	2159	0	2176
7169	3	2098	1	17	0	2119
7170	4	2143	2	6	0	2155
7171	3	17	0	2150	0	2170
7172	2	8	0	2134	0	2144
7173	0	2108	1	23	0	2132
7174	2	17	1	2188	0	2208
7175	0	7	2	2185	0	2194
7176	3	3	0	2193	0	2199
7177	2174	2	1	28	0	2205
7178	16	0	2133	13	0	2162
7179	2149	0	14	9	0	2172
7180	2235	0	6	7	0	2248
7181	2195	0	3	4	0	2202
7182	22	2133	1	2	0	2158
7183	10	12	0	2133	0	2155
7184	2131	5	1	17	0	2154
7185	16	4	0	2163	0	2183
7186	2170	2	1	16	0	2189
7187	16	2266	0	11	0	2293
7188	2378	12	0	7	0	2397
7189	2425	6	2	5	0	2438
7190	2457	3	1	5	0	2466
7191	28	1	1	2447	0	2477
7192	10	3	0	2504	0	2517
7193	2514	2	0	18	0	2534
7194	11	2470	0	11	0	2492
7195	3	2433	1	11	0	2448
7196	2540	13	0	4	0	2557
7197	12	6	1	2550	0	2569
7198	7	5	0	2569	0	2581
7199	5	4	2	2600	0	2611
7200	3	2558	0	27	0	2588
7201	2596	14	2	16	0	2628
7202	18	5	1	2621	0	2645
7203	7	2629	2	20	0	2658
7204	8	22	0	2758	0	2788
7205	6	7	0	2783	0	2796
7206	4	5	0	2779	0	2788
7207	2	1	4	2811	0	2818
7208	2774	0	0	34	0	2808
7209	2762	1	0	19	0	2782
7210	2788	0	0	12	0	2800
7211	27	4	0	2782	0	2813
7212	17	1	2743	15	0	2776
7213	12	2	2476	11	0	2501
7214	6	0	2622	10	0	2638
7215	2812	3	27	11	0	2853
7216	17	3	16	2852	0	2888
7217	12	1	7	2841	0	2861
7218	7	2	1	2866	0	2876
7219	2856	1	1	31	0	2889
7220	2834	2	1	22	0	2859
7221	23	2966	2	13	0	3004
7222	15	13	0	3010	0	3038
7223	7	11	2969	16	0	3003
7224	2	3011	17	16	0	3046
7225	11	19	6	3035	0	3071
7226	3	10	5	3078	0	3096
7227	6	7	1	3044	0	3058
7228	5	4	1	3008	0	3018
7229	3	4	2994	30	0	3031
7230	6	3	2851	18	0	2878
7231	7	3028	18	13	0	3066
7232	6	16	8	3062	0	3092
7233	3	10	2	2989	0	3004
7234	2959	4	3	29	0	2995
7235	14	2	2965	18	0	2999
7236	11	1	14	2966	0	2992
7237	9	2	8	3051	0	3070
7238	6	6	3100	25	0	3137
7239	9	3094	14	14	0	3131
7240	3120	15	5	19	0	3159
7241	19	8	3098	8	0	3133
7242	3012	5	15	16	0	3048
7243	20	4	3277	6	0	3307
7244	14	3	17	3349	0	3383
7245	11	2	3376	19	0	3408
7246	11	3	3453	18	0	3485
7247	6	2	20	3504	0	3532
7248	26	10	31	2810	0	2877
7249	6	3	7	3663	0	3679
7250	5	6	3	3590	0	3604
7251	6	6	2	3592	0	3606
7252	5	2	3600	29	0	3636
7253	5	3	3404	21	0	3433
7254	6	3606	19	12	0	3643
7255	3624	16	11	12	0	3663
7256	28	11	8	3638	0	3685
7257	3680	5	3	31	0	3719
7258	34	1	6	3680	0	3721
7259	3830	3	6	40	0	3879
7260	31	4	2	3866	0	3903
7261	13	2	2	3903	0	3920
7262	7	3996	2	47	0	4052
7263	8	25	3	4111	0	4147
7264	7	12	5	4125	0	4149
7265	9	6	4	4106	0	4125
7266	7	1	2	4093	0	4103
7267	2	4008	4	42	0	4056
7268	3991	24	3	22	0	4040
7269	22	3975	3	17	0	4017
7270	12	18	2	3913	0	3945
7271	3877	9	2	28	0	3916
7272	21	3	3803	16	0	3843
7273	9	4	3830	12	0	3855
7274	6	4	26	3773	0	3809
7275	3	3	9	3893	0	3908
7276	2	0	4	3909	0	3915
7277	8	4	5	3723	0	3740
7278	8	4	1	3842	0	3855
7279	3	3768	6	32	0	3809
7280	3	16	1	3853	0	3873
7281	3850	7	2	30	0	3889
7282	22	4	4	3893	0	3923
7283	10	6	3990	24	0	4030
7284	9	1	22	3964	0	3996
7285	3939	1	10	33	0	3983
7286	21	4149	5	17	0	4192
7287	15	21	3	4493	0	4532
7288	7	9	3	4717	0	4736
7289	7	6	4648	72	0	4733
7290	3	6	5704	23	0	5736
7291	6709	3	128	25	0	6865
7292	164	6	37	6825	0	7032
7293	79	1	40	7069	0	7189
7294	65	2	7380	231	0	7678
7295	50	12	7500	130	0	7692
7296	15	7597	234	112	0	7958
7297	22	161	121	7591	0	7895
7298	8	68	7623	181	0	7880
7299	5	7665	236	87	0	7993
7300	7631	203	105	81	0	8020
7301	7903	90	85	64	0	8142
7302	260	80	54	7693	0	8087
7303	138	7750	29	196	0	8113
7304	7766	199	32	102	0	8099
7305	256	90	27	7448	0	7821
7306	119	84	7593	212	0	8008
7307	108	7677	175	103	0	8063
7308	7670	208	84	96	0	8058
7309	7903	92	72	78	0	8145
7310	282	86	49	7755	0	8172
7311	178	52	40	7918	0	8188
7312	129	41	7678	267	0	8115
7313	90	30	190	7784	0	8094
7314	80	37	84	7618	0	7819
7315	60	16	77	7869	0	8022
7316	52	21	54	7880	0	8007
7317	40	24	33	7716	0	7813
7318	31	7525	27	397	0	7980
7319	7562	171	29	241	0	8003
7320	203	79	7480	179	0	7941
7321	92	7451	178	142	0	7863
7322	97	223	80	7569	0	7969
7323	7547	89	79	261	0	7976
7324	233	83	62	7568	0	7946
7325	113	60	44	7719	0	7936
7326	106	34	30	7785	0	7955
7327	67	29	38	7836	0	7970
7328	53	34	7413	421	0	7921
7329	50	7456	193	265	0	7964
7330	7534	192	73	211	0	8010
7331	200	86	7455	165	0	7906
7332	99	90	238	7525	0	7952
7333	7510	68	111	265	0	7954
7334	256	7446	97	146	0	7945
7335	7596	215	73	148	0	8032
7336	312	112	53	7138	0	7615
7337	166	90	45	7719	0	8020
7338	142	72	38	7684	0	7936
7339	107	43	21	7750	0	7921
7340	7408	42	24	435	0	7909
7341	236	41	28	7594	0	7899
7342	131	25	23	7735	0	7914
7343	7257	23	21	408	0	7709
7344	273	24	7148	243	0	7688
7345	133	27	198	7325	0	7683
7346	7034	26	85	321	0	7466
7347	7158	24	73	197	0	7452
7348	315	18	47	6988	0	7368
7349	187	25	52	6986	0	7250
7350	157	6694	35	343	0	7229
7351	123	180	34	6957	0	7294
7352	81	75	13	7034	0	7203
7353	74	68	6571	416	0	7129
7354	55	51	6514	266	0	6886
7355	33	6497	266	225	0	7021
7356	61	195	142	6539	0	6937
7357	49	88	115	6781	0	7033
7358	6534	80	86	342	0	7042
7359	208	65	71	6562	0	6906
7360	124	53	6342	347	0	6866
7361	114	46	209	6500	0	6869
7362	88	32	6177	366	0	6663
7363	58	40	6288	225	0	6611
7364	57	35	293	6206	0	6591
7365	57	33	167	6470	0	6727
7366	6234	28	125	368	0	6755
7367	6392	28	104	229	0	6753
7368	282	35	73	6403	0	6793
7369	6456	26	58	326	0	6866
7370	6682	12	54	192	0	6940
7371	351	37	37	6554	0	6979
7372	225	31	28	6734	0	7018
7373	6599	14	33	346	0	6992
7374	6749	5	40	243	0	7037
7375	315	12	25	6707	0	7059
7376	204	6493	31	347	0	7075
7377	190	178	23	6731	0	7122
7378	123	66	23	6905	0	7117
7379	90	68	6500	413	0	7071
7380	98	52	184	6761	0	7095
7381	6406	35	90	395	0	6926
7382	213	6492	86	248	0	7039
7383	6481	201	47	182	0	6911
7384	6585	84	30	157	0	6856
7385	6659	84	23	140	0	6906
7386	376	77	29	6199	0	6681
7387	275	48	5528	252	0	6103
7388	215	29	5332	150	0	5726
7389	124	5296	209	149	0	5778
7390	74	4147	73	84	0	4378
7391	43	3180	31	32	0	3286
7392	33	3071	46	27	0	3177
7393	86	61	2923	29	0	3099
7394	2403	56	93	12	0	2564
7395	28	13	6	2374	0	2421
7396	11	2	4	2338	0	2355
7397	12	5	1	2318	0	2336
7398	7	2310	3	29	0	2349
7399	2260	19	4	13	0	2296
7400	17	6	2280	10	0	2313
7401	6	2163	18	3	0	2190
7402	8	19	6	2196	0	2229
7403	2204	4	6	26	0	2240
7404	19	4	2	2201	0	2226
7405	7	2	2154	27	0	2190
7406	9	2	2165	7	0	2183
7407	8	3	23	2213	0	2247
7408	6	1	8	2221	0	2236
7409	2202	2	5	28	0	2237
7410	24	0	2183	13	0	2220
7411	2155	2	18	10	0	2185
7412	2178	1	7	7	0	2193
7413	26	1	10	2200	0	2237
7414	14	4	2246	19	0	2283
7415	8	1	20	2256	0	2285
7416	2264	3	6	29	0	2302
7417	22	2256	8	9	0	2295
7418	2310	19	7	11	0	2347
7419	31	5	2	2335	0	2373
7420	9	2428	3	26	0	2466
7421	8	21	4	2431	0	2464
7422	6	7	2	2481	0	2496
7423	6	2453	1	28	0	2488
7424	8	24	1	2512	0	2545
7425	5	7	3	2566	0	2581
7426	5	6	1	2636	0	2648
7427	4	0	2644	43	0	2691
7428	3	2607	30	14	0	2654
7429	2655	28	7	14	0	2704
7430	31	11	7	2721	0	2770
7431	11	2890	1	26	0	2928
7432	3040	30	4	19	0	3093
7433	35	12	2	3064	0	3113
7434	17	8	1	3076	0	3102
7435	11	1	5	3048	0	3065
7436	7	6	3	3012	0	3028
7437	2997	3	2	59	0	3061
7438	35	5	3	3043	0	3086
7439	18	3	2	3061	0	3084
7440	3053	4	5	54	0	3116
7441	46	4	0	3061	0	3111
7442	16	2	3033	48	0	3099
7443	18	4	33	3048	0	3103
7444	2967	1	13	55	0	3036
7445	44	3	9	2981	0	3037
7446	18	1	2983	53	0	3055
7447	15	6	2935	27	0	2983
7448	3039	3	43	22	0	3107
7449	3123	3	19	13	0	3158
7450	3151	4	9	13	0	3177
7451	3150	1	7	20	0	3178
7452	58	1	3155	14	0	3228
7453	30	3	35	3135	0	3203
7454	18	3	12	3203	0	3236
7455	3199	3	12	53	0	3267
7456	48	7	5	3207	0	3267
7457	22	3	3168	50	0	3243
7458	17	2	38	3215	0	3272
7459	11	1	3251	50	0	3313
7460	11	3271	39	23	0	3344
7461	3338	34	16	24	0	3412
7462	46	13	8	3351	0	3418
7463	18	6	3307	48	0	3379
7464	14	2	38	3333	0	3387
7465	12	4	18	3460	0	3494
7466	9	6	3461	56	0	3532
7467	11	4	38	3480	0	3533
7468	3451	2	18	63	0	3534
7469	42	4	3219	31	0	3296
7470	3244	1	41	23	0	3309
7471	45	3248	19	19	0	3331
7472	24	34	3198	13	0	3269
7473	15	19	3220	13	0	3267
7474	20	42	65	2764	0	2891
7475	13	4	20	3031	0	3068
7476	9	5	3014	52	0	3080
7477	13	3	39	3035	0	3090
7478	3050	5	17	48	0	3120
7479	3069	0	12	29	0	3110
7480	47	2	10	3045	0	3104
7481	27	2	6	3030	0	3065
7482	10	3033	6	54	0	3103
7483	3130	32	9	28	0	3199
7484	44	12	7	3153	0	3216
7485	19	3167	10	42	0	3238
7486	3205	33	4	27	0	3269
7487	3263	13	8	21	0	3305
7488	55	3322	8	24	0	3409
7489	26	39	7	3360	0	3432
7490	14	14	5	3328	0	3361
7491	13	8	3223	61	0	3305
7492	19	5	39	3190	0	3253
7493	3181	8	16	59	0	3264
7494	47	6	12	3163	0	3228
7495	23	6	3100	54	0	3183
7496	3095	6	41	34	0	3176
7497	52	5	16	3114	0	3187
7498	24	4	3082	51	0	3161
7499	19	3	41	3100	0	3163
7500	15	5	3089	53	0	3162
7501	19	4	42	3104	0	3169
7502	10	2	21	3139	0	3172
7503	3081	3	12	70	0	3166
7504	47	3094	9	30	0	3180
7505	3165	35	10	19	0	3229
7506	3126	15	10	24	0	3175
7507	3114	8	10	14	0	3146
7508	68	3076	5	20	0	3169
7509	30	38	3069	11	0	3148
7510	21	13	40	3088	0	3162
7511	3107	7	18	52	0	3184
7512	3147	4	15	28	0	3194
7513	52	6	15	3090	0	3163
7514	3063	6	11	57	0	3137
7515	56	6	3027	31	0	3120
7516	3023	4	49	26	0	3102
7517	53	7	2997	18	0	3075
7518	31	2958	38	21	0	3048
7519	2934	40	21	17	0	3012
7520	2849	14	21	16	0	2900
7521	59	2838	17	21	0	2935
7522	2825	39	12	20	0	2896
7523	2777	10	13	20	0	2820
7524	55	8	2716	22	0	2801
7525	2633	5	32	15	0	2685
7526	44	7	2574	17	0	2642
7527	36	20	34	2429	0	2519
7528	26	2486	16	35	0	2563
7529	23	27	2476	14	0	2540
7530	2296	51	43	41	0	2431
7531	2184	13	23	27	0	2247
7532	45	12	7	2074	0	2138
7533	22	8	2047	25	0	2102
7534	22	7	27	2046	0	2102
7535	2048	6	11	30	0	2095
7536	37	2075	6	14	0	2132
7537	2043	24	6	8	0	2081
7538	2041	8	7	10	0	2066
7539	34	2015	5	10	0	2064
7540	14	24	6	2012	0	2056
7541	2051	6	6	21	0	2084
7542	36	4	5	2059	0	2104
7543	17	3	8	2159	0	2187
7544	9	7	2161	31	0	2208
7545	13	2	26	2144	0	2185
7546	11	2	12	2146	0	2171
7547	2113	7	7	33	0	2160
7548	2110	3	7	14	0	2134
7549	43	3	7	2080	0	2133
7550	16	6	2048	32	0	2102
7551	11	3	2013	16	0	2043
7552	16	6	30	1990	0	2042
7553	12	4	2051	33	0	2100
7554	13	11	28	2021	0	2073
7555	11	7	14	2018	0	2050
7556	2039	2	8	32	0	2081
7557	35	3	2001	14	0	2053
7558	1979	3	24	14	0	2020
7559	1977	2	8	11	0	1998
7560	35	1	1903	10	0	1949
7561	14	2	1888	14	0	1918
7562	9	68	28	1771	0	1876
7563	11	1736	9	28	0	1784
7564	15	1799	6	11	0	1831
7565	16	23	8	1675	0	1722
7566	9	4	3	1617	0	1633
7567	12	1	5	1663	0	1681
7568	8	2	3	1675	0	1688
7569	1626	1	10	26	0	1663
7570	23	2	7	1627	0	1659
7571	5	1	1612	27	0	1645
7572	6	1	18	1585	0	1610
7573	8	1491	8	89	0	1596
7574	10	17	2	1574	0	1603
7575	1574	2	4	21	0	1601
7576	26	1	6	1569	0	1602
7577	9	2	1577	23	0	1611
7578	6	1548	25	11	0	1590
7579	5	16	13	1564	0	1598
7580	1563	4	7	27	0	1601
7581	1590	3	4	10	0	1607
7582	26	4	4	1586	0	1620
7583	6	5	1487	26	0	1524
7584	11	4	1404	9	0	1428
7585	1436	0	22	11	0	1469
7586	22	0	1477	9	0	1508
7587	6	4	1434	5	0	1449
7588	6	19	18	1332	0	1375
7589	1430	2	9	17	0	1458
7590	1414	0	2	11	0	1427
7591	1422	3	2	6	0	1433
7592	17	2	1477	12	0	1508
7593	9	1	1535	5	0	1550
7594	4	1639	19	7	0	1669
7595	8	16	7	1635	0	1666
7596	3	7	5	1677	0	1692
7597	3	2	7	1623	0	1635
7598	3	4	3	1695	0	1705
7599	6	0	1680	25	0	1711
7600	8	1717	16	12	0	1753
7601	1815	17	6	6	0	1844
7602	1982	4	9	9	0	2004
7603	2010	0	12	2	0	2024
7604	38	2001	9	7	0	2055
7605	11	31	8	1967	0	2017
7606	2037	5	7	38	0	2087
7607	41	2108	4	11	0	2164
7608	2109	33	2	7	0	2151
7609	36	2097	5	10	0	2148
7610	2124	33	10	3	0	2170
7611	2169	10	6	3	0	2188
7612	45	3	4	2194	0	2246
7613	12	5	5	2285	0	2307
7614	6	4	2256	53	0	2319
7615	6	4	2211	16	0	2237
7616	2260	3	48	9	0	2320
7617	2353	5	9	10	0	2377
7618	53	4	2	2296	0	2355
7619	17	2	4	2338	0	2361
7620	14	4	2287	54	0	2359
7621	10	2	45	2246	0	2303
7622	5	6	2264	52	0	2327
7623	7	5	43	2292	0	2347
7624	8	3	11	2344	0	2366
7625	2313	6	4	62	0	2385
7626	2340	6	6	19	0	2371
7627	58	4	5	2319	0	2386
7628	23	5	3	2351	0	2382
7629	18	5	2292	60	0	2375
7630	15	0	49	2306	0	2370
7631	7	5	2321	59	0	2392
7632	2308	7	49	20	0	2384
7633	51	5	16	2359	0	2431
7634	2359	3	5	58	0	2425
7635	61	2336	5	17	0	2419
7636	2355	47	9	16	0	2427
7637	53	8	9	2357	0	2427
7638	24	5	8	2365	0	2402
7639	15	2349	11	56	0	2431
7640	16	50	10	2374	0	2450
7641	14	12	2336	65	0	2427
7642	17	6	49	2325	0	2397
7643	10	5	2242	59	0	2316
7644	9	2174	54	23	0	2260
7645	9	44	14	2211	0	2278
7646	3	7	2201	59	0	2270
7647	11	5	2182	15	0	2213
7648	11	6	46	2170	0	2233
7649	2176	1	16	57	0	2250
7650	49	1	2159	21	0	2230
7651	17	1	47	2159	0	2224
7652	2177	5	11	59	0	2252
7653	50	2113	12	20	0	2195
7654	2212	44	14	15	0	2285
7655	47	8	4	2236	0	2295
7656	17	7	8	2275	0	2307
7657	15	10	3	2309	0	2337
7658	2283	3	7	67	0	2360
7659	50	3	7	2301	0	2361
7660	20	3	8	2345	0	2376
7661	2244	5	8	63	0	2320
7662	50	1	2248	28	0	2327
7663	14	5	49	2264	0	2332
7664	12	6	2230	58	0	2306
7665	2213	2	50	21	0	2286
7666	55	6	10	2263	0	2334
7667	23	6	2275	59	0	2363
7668	2205	8	50	24	0	2287
7669	2301	6	13	22	0	2342
7670	58	4	2343	25	0	2430
7671	18	10	52	2353	0	2433
7672	17	5	17	2421	0	2460
7673	16	3	2407	69	0	2495
7674	18	2405	53	24	0	2500
7675	14	48	2450	18	0	2530
7676	2359	11	48	26	0	2444
7677	49	6	2501	23	0	2579
7678	2430	8	57	14	0	2509
7679	50	4	2515	22	0	2591
7680	2443	1	55	22	0	2521
7681	58	2535	19	18	0	2630
7682	23	41	12	2542	0	2618
7683	19	7	12	2622	0	2660
7684	12	5	2595	69	0	2681
7685	13	12	44	2530	0	2599
7686	19	2510	23	52	0	2604
7687	2490	36	12	30	0	2568
7688	44	2502	12	27	0	2585
7689	19	40	12	2533	0	2604
7690	2553	6	11	58	0	2628
7691	53	2589	9	29	0	2680
7692	2527	49	17	20	0	2613
7693	68	7	2564	13	0	2652
7694	18	8	54	2532	0	2612
7695	16	3	18	2581	0	2618
7696	15	7	15	2618	0	2655
7697	2588	3	13	75	0	2679
7698	2635	6	10	26	0	2677
7699	2621	12	12	21	0	2666
7700	2603	5	6	19	0	2633
7701	64	5	2437	15	0	2521
7702	2196	2	35	10	0	2243
7703	42	2226	7	9	0	2284
7704	10	2258	6	6	0	2280
7705	2310	34	25	7	0	2376
7706	2328	6	12	11	0	2357
7707	34	3	2	2238	0	2277
7708	2266	1	5	38	0	2310
7709	2268	0	3	12	0	2283
7710	2430	2	1	5	0	2438
7711	46	3	1	2391	0	2441
7712	12	2331	3	35	0	2381
7713	7	2350	1	6	0	2364
7714	10	27	4	2360	0	2401
7715	2331	6	2	31	0	2370
7716	25	2367	5	4	0	2401
7717	4	21	3	2344	0	2372
7718	5	2	2362	28	0	2397
7719	2254	4	22	11	0	2291
7720	26	2365	4	7	0	2402
7721	9	2418	2	2	0	2431
7722	2373	23	4	7	0	2407
7723	28	3	2426	1	0	2458
7724	5	5	21	2380	0	2411
7725	6	2445	2	24	0	2477
7726	10	22	5	2467	0	2504
7727	3	7	3	2475	0	2488
7728	10	2192	8	28	0	2238
7729	6	22	3	2567	0	2598
7730	8	2	1	2590	0	2601
7731	2554	6	2	28	0	2590
7732	26	2552	1	6	0	2585
7733	2569	20	1	7	0	2597
7734	29	5	1	2559	0	2594
7735	6	2585	0	23	0	2614
7736	6	26	2594	3	0	2629
7737	8	9	24	2634	0	2675
7738	9	3	2	2725	0	2739
7739	3	6	2731	30	0	2770
7740	2645	5	27	9	0	2686
7741	33	4	2	2953	0	2992
7742	2959	1	2	38	0	3000
7743	36	3	2913	6	0	2958
7744	8	5	32	2947	0	2992
7745	9	3	3075	38	0	3125
7746	10	6	36	3102	0	3154
7747	6	5	7	3197	0	3215
7748	3180	5	8	42	0	3235
7749	30	3206	5	16	0	3257
7750	3216	32	1	12	0	3261
7751	37	9	3226	2	0	3274
7752	14	5	31	3260	0	3310
7753	8	9	3331	35	0	3383
7754	3086	5	41	14	0	3146
7755	3312	1	9	11	0	3333
7756	37	4	3310	5	0	3356
7757	3282	2	31	14	0	3329
7758	3384	5	8	7	0	3404
7759	46	2	6	3339	0	3393
7760	13	2	3302	37	0	3354
7761	17	6	3401	11	0	3435
7762	4	2	40	3436	0	3482
7763	8	2	11	3421	0	3442
7764	3	3384	10	37	0	3434
7765	6	3449	6	15	0	3476
7766	3449	33	7	9	0	3498
7767	41	9	4	3446	0	3500
7768	13	3388	6	33	0	3440
7769	12	3466	3	15	0	3496
7770	3386	36	3	13	0	3438
7771	40	12	7	3401	0	3460
7772	7	3421	6	39	0	3473
7773	14	34	4	3433	0	3485
7774	9	9	4	3445	0	3467
7775	7	10	5	3412	0	3434
7776	3360	4	5	50	0	3419
7777	37	3319	3	20	0	3379
7778	16	36	4	3342	0	3398
7779	8	9	10	3363	0	3390
7780	12	7	1	3359	0	3379
7781	11	4	3232	43	0	3290
7782	3142	7	33	20	0	3202
7783	39	5	11	3242	0	3297
7784	3196	3	14	40	0	3253
7785	3219	2	5	20	0	3246
7786	3208	1	6	21	0	3236
7787	46	6	3179	6	0	3237
7788	17	3155	32	8	0	3212
7789	13	30	8	3103	0	3154
7790	5	7	3094	35	0	3141
7791	8	10	2996	9	0	3023
7792	11	18	32	2929	0	2990
7793	4	2906	12	28	0	2950
7794	2972	22	8	18	0	3020
7795	3005	10	5	15	0	3035
7796	3018	7	2	11	0	3038
7797	2991	4	4	13	0	3012
7798	32	7	2961	7	0	3007
7799	2894	4	21	10	0	2929
7800	26	3018	10	5	0	3059
7801	12	20	4	3072	0	3108
7802	7	8	4	3095	0	3114
7803	3087	8	3	37	0	3135
7804	32	2	3	3087	0	3124
7805	13	3	3001	29	0	3046
7806	2913	1	22	20	0	2956
7807	2990	2	12	12	0	3016
7808	2999	2	6	12	0	3019
7809	38	0	2958	10	0	3006
7810	2767	3	24	6	0	2800
7811	23	2827	9	7	0	2866
7812	2863	17	9	13	0	2902
7813	26	11	6	2802	0	2845
7814	11	7	6	2803	0	2827
7815	10	2792	5	32	0	2839
7816	9	19	3	2809	0	2840
7817	6	2816	6	25	0	2853
7818	11	27	2	2789	0	2829
7819	10	2772	6	30	0	2818
7820	11	21	2	2783	0	2817
7821	6	2796	7	21	0	2830
7822	11	26	3	2938	0	2978
7823	8	3006	1	26	0	3041
7824	3251	24	5	17	0	3297
7825	35	8	5	3278	0	3326
7826	13	10	4	3319	0	3346
7827	5	6	4	3432	0	3447
7828	6	2	3	3456	0	3467
7829	6	5	3481	52	0	3544
7830	11	3	35	3507	0	3556
7831	12	4	7	3548	0	3571
7832	3513	2	7	50	0	3572
7833	3474	5	3	27	0	3509
7834	46	3605	2	14	0	3667
7835	24	38	3	3649	0	3714
7836	16	8	3	3917	0	3944
7837	4062	7	3	66	0	4138
7838	61	9	3829	23	0	3922
7839	3890	4	39	21	0	3954
7840	59	3980	11	14	0	4064
7841	3792	43	6	8	0	3849
7842	3777	8	3	13	0	3801
7843	53	3744	5	6	0	3808
7844	21	3857	2	5	0	3885
7845	27	54	8	3688	0	3777
7846	9	17	3651	44	0	3721
7847	3583	13	41	16	0	3653
7848	47	5	3634	15	0	3701
7849	3545	7	48	13	0	3613
7850	62	5	3633	7	0	3707
7851	15	3608	45	6	0	3674
7852	13	46	8	3614	0	3681
7853	3500	10	9	48	0	3567
7854	3559	9	4	13	0	3585
7855	54	6	4	3545	0	3609
7856	3616	6	2	50	0	3674
7857	3630	5	3	15	0	3653
7858	66	3572	1	10	0	3649
7859	3603	54	2	9	0	3668
7860	67	3657	6	6	0	3736
7861	23	59	4	3623	0	3709
7862	3595	10	6	62	0	3673
7863	3685	7	4	13	0	3709
7864	3655	5	7	15	0	3682
7865	75	5	3645	6	0	3731
7866	21	6	3729	4	0	3760
7867	19	6	60	3770	0	3855
7868	23	0	13	3952	0	3988
7869	12	4108	9	70	0	4199
7870	4142	70	4	22	0	4238
7871	78	16	2	4144	0	4240
7872	27	10	2	4202	0	4241
7873	15	8	4163	86	0	4272
7874	10	4027	71	25	0	4133
7875	12	4228	12	18	0	4270
7876	18	82	5	4228	0	4333
7877	4205	16	9	83	0	4313
7878	83	13	5	4201	0	4302
7879	29	9	7	4294	0	4339
7880	4248	4	7	103	0	4362
7881	4312	8	6	31	0	4357
7882	101	6	4	4283	0	4394
7883	30	7	4257	86	0	4380
7884	24	9	74	4291	0	4398
7885	20	5	17	4380	0	4422
7886	4328	8	8	115	0	4459
7887	84	4	11	4357	0	4456
7888	4362	6	4	102	0	4474
7889	92	5	4404	36	0	4537
7890	26	9	79	4538	0	4652
7891	24	8	18	4659	0	4709
7892	19	8	10	4695	0	4732
7893	21	6	9	4654	0	4690
7894	23	7	6	4569	0	4605
7895	18	6	4432	133	0	4589
7896	4400	8	88	52	0	4548
7897	106	5	20	4457	0	4588
7898	26	8	4420	115	0	4569
7899	26	10	4441	45	0	4522
7900	27	8	97	4395	0	4527
7901	4368	8	24	115	0	4515
7902	4412	6	20	40	0	4478
7903	4476	8	14	35	0	4533
7904	120	12	12	4311	0	4455
7905	47	4410	5	106	0	4568
7906	4480	86	12	45	0	4623
7907	4532	22	13	34	0	4601
7908	4520	15	15	35	0	4585
7909	4513	14	14	33	0	4574
7910	125	11	13	4403	0	4552
7911	48	10	4389	113	0	4560
7912	39	12	93	4381	0	4525
7913	41	9	4375	111	0	4536
7914	4363	7	99	44	0	4513
7915	4463	5	32	42	0	4542
7916	126	12	4340	42	0	4520
7917	4324	5	92	40	0	4461
7918	4527	12	23	35	0	4597
7919	134	10	18	4424	0	4586
7920	58	4424	23	103	0	4608
7921	4471	87	7	51	0	4616
7922	122	47	18	4233	0	4420
7923	47	4185	13	108	0	4353
7924	36	81	14	4073	0	4204
7925	30	17	4091	105	0	4243
7926	23	4106	76	54	0	4259
7927	4002	90	33	39	0	4164
7928	4026	19	24	45	0	4114
7929	3925	8	17	26	0	3976
7930	3959	8	15	33	0	4015
7931	110	18	13	3836	0	3977
7932	39	3815	22	78	0	3954
7933	3630	66	15	35	0	3746
7934	82	17	3674	28	0	3801
7935	40	3548	65	29	0	3682
7936	28	53	3332	20	0	3433
7937	32	18	51	3050	0	3151
7938	30	2644	29	56	0	2759
7939	32	50	5	3148	0	3235
7940	29	11	3276	64	0	3380
7941	26	4	57	3205	0	3292
7942	28	11	20	3323	0	3382
7943	22	7	9	3374	0	3412
7944	3256	7	11	72	0	3346
7945	70	3263	13	31	0	3377
7946	31	51	12	3286	0	3380
7947	3230	11	14	77	0	3332
7948	64	3246	13	32	0	3355
7949	3257	49	15	31	0	3352
7950	71	16	3292	23	0	3402
7951	41	5	56	3256	0	3358
7952	29	3305	17	47	0	3398
7953	3315	53	8	28	0	3404
7954	73	14	3238	16	0	3341
7955	40	3006	56	20	0	3122
7956	28	48	15	3160	0	3251
7957	26	14	9	3205	0	3254
7958	3156	10	12	52	0	3230
7959	55	16	11	3118	0	3200
7960	35	9	3048	44	0	3136
7961	25	12	35	3023	0	3095
7962	27	10	3120	47	0	3204
7963	30	15	41	3049	0	3135
7964	31	3130	15	38	0	3214
7965	3150	35	7	21	0	3213
7966	3053	15	12	20	0	3100
7967	47	2888	13	22	0	2970
7968	18	2782	9	13	0	2822
7969	35	25	9	2642	0	2711
7970	2635	2	7	22	0	2666
7971	29	4	3	2611	0	2647
7972	2600	5	8	25	0	2638
7973	27	2533	3	7	0	2570
7974	13	22	5	2616	0	2656
7975	9	4	2705	24	0	2742
7976	11	7	20	2670	0	2708
7977	9	5	6	2729	0	2749
7978	2799	3	3	29	0	2834
7979	19	2844	2	8	0	2873
7980	8	18	2	2868	0	2896
7981	2856	6	3	23	0	2888
7982	21	7	2866	7	0	2901
7983	2825	2	14	11	0	2852
7984	25	12	5	2885	0	2927
7985	10	2957	2	18	0	2987
7986	2989	12	7	9	0	3017
7987	21	6	3006	5	0	3038
7988	9	7	2931	3	0	2950
7989	8	2966	12	5	0	2991
7990	2873	6	23	6	0	2908
7991	10	3	0	2879	0	2892
7992	5	3	0	2852	0	2860
7993	2890	1	0	18	0	2909
7994	9	0	2881	4	0	2894
7995	6	0	8	2919	0	2933
7996	2	3	3029	10	0	3044
7997	5	1	10	3024	0	3040
7998	3	3057	4	10	0	3074
7999	4	12	1	3147	0	3164
8000	3	8	3121	13	0	3145
8001	3045	4	13	9	0	3071
8002	14	1	10	3186	0	3211
8003	11	5	3192	13	0	3221
8004	7	2	12	3132	0	3153
8005	2	0	9	3160	0	3171
8006	2	1	3115	23	0	3141
8007	3	0	3116	13	0	3132
8008	4	0	20	3213	0	3237
8009	2	4	3236	11	0	3253
8010	3168	0	15	16	0	3199
8011	14	1	11	3264	0	3290
8012	3249	3	4	15	0	3271
8013	15	4	3212	14	0	3245
8014	10	0	17	3282	0	3309
8015	6	3	3479	15	0	3503
8016	3	3420	16	16	0	3455
8017	4	13	3491	6	0	3514
8018	4	7	3349	7	0	3367
8019	3311	5	22	9	0	3347
8020	3416	0	13	5	0	3434
8021	21	1	3503	5	0	3530
8022	17	1	17	3353	0	3388
8023	7	5	12	3426	0	3450
8024	6	2	3528	23	0	3559
8025	4	3376	16	20	0	3416
8026	3323	15	8	8	0	3354
8027	19	8	3481	2	0	3510
8028	12	4	18	3494	0	3528
8029	9	2	11	3549	0	3571
8030	3641	4	8	26	0	3679
8031	3681	2	4	16	0	3703
8032	3712	1	8	7	0	3728
8033	3727	2	3	5	0	3737
8034	35	2	1	3696	0	3734
8035	16	3	3896	21	0	3936
8036	4	1	20	3885	0	3910
8037	6	0	11	3927	0	3944
8038	4	1	7	4035	0	4047
8039	5	4	3980	36	0	4025
8040	3776	1	18	19	0	3814
8041	25	0	14	3931	0	3970
8042	9	0	4027	26	0	4062
8043	10	4100	18	15	0	4143
8044	6	16	13	4189	0	4224
8045	5	8	7	4207	0	4227
8046	4193	4	1	33	0	4231
8047	22	4248	6	17	0	4293
8048	13	18	4307	9	0	4347
8049	8	10	19	4278	0	4315
8050	5	5	13	4223	0	4246
8051	4224	2	9	37	0	4272
8052	4194	2	3	21	0	4220
8053	35	2	4	4255	0	4296
8054	4247	3	8	24	0	4282
8055	25	4196	2	18	0	4241
8056	13	19	4443	12	0	4487
8057	10	11	22	4465	0	4508
8058	7	6	13	4549	0	4575
8059	7	2	7	4556	0	4572
8060	11	1	5	4505	0	4522
8061	6	4445	2	36	0	4489
8062	4387	20	9	19	0	4435
8063	28	10	1	4404	0	4443
8064	13	4568	6	30	0	4617
8065	4616	17	7	16	0	4656
8066	4618	9	4	12	0	4643
8067	32	4718	4	12	0	4766
8068	19	19	7	4851	0	4896
8069	11	15	5	4889	0	4920
8070	8	5	4	4824	0	4841
8071	7	0	3	4936	0	4946
8072	5132	4	4	45	0	5185
8073	5215	4	2	21	0	5242
8074	43	5231	4	13	0	5291
8075	15	37	5229	10	0	5291
8076	15	14	34	5255	0	5318
8077	5292	8	16	41	0	5357
8078	38	5193	9	22	0	5262
8079	20	5219	2	18	0	5259
8080	5377	44	2	13	0	5436
8081	5479	19	4	8	0	5510
8082	61	9	2	5441	0	5513
8083	30	5	5452	48	0	5535
8084	13	8	5430	21	0	5472
8085	5623	6	61	21	0	5711
8086	5814	4	29	13	0	5860
8087	5777	4	8	16	0	5805
8088	5763	2	4	10	0	5779
8089	5752	1	5	9	0	5767
8090	64	5735	2	10	0	5811
8091	29	46	4	5653	0	5732
8092	12	5948	5	43	0	6008
8093	6055	48	10	23	0	6136
8094	6027	19	2	14	0	6062
8095	6041	7	2	14	0	6064
8096	6004	3	2	15	0	6024
8097	58	5960	1	6	0	6025
8098	5914	38	4	14	0	5970
8099	43	5957	0	12	0	6012
8100	22	56	2	5993	0	6073
8101	5981	11	3	41	0	6036
8102	47	6	6072	18	0	6143
8103	22	4	37	6027	0	6090
8104	17	7	12	6169	0	6205
8105	5	4	6182	47	0	6238
8106	8	6162	39	26	0	6235
8107	6184	37	12	18	0	6251
8108	6173	16	4	10	0	6203
8109	48	6124	3	9	0	6184
8110	22	40	5	6160	0	6227
8111	15	16	6314	33	0	6378
8112	7	6516	37	19	0	6579
8113	6562	41	13	16	0	6632
8114	41	18	6531	2	0	6592
8115	6128	4	34	11	0	6177
8116	6365	5	10	18	0	6398
8117	56	9	6540	7	0	6612
8118	22	6530	36	3	0	6591
8119	23	39	15	6480	0	6557
8120	13	16	6710	35	0	6774
8121	6407	8	40	22	0	6477
8122	6596	5	13	14	0	6628
8123	56	6588	6	11	0	6661
8124	23	34	3	6615	0	6675
8125	17	17	4	6679	0	6717
8126	19	7	6710	44	0	6780
8127	10	6692	34	21	0	6757
8128	6902	38	12	22	0	6974
8129	6967	13	5	16	0	7001
8130	7017	4	5	15	0	7041
8131	55	8	6933	3	0	6999
8132	6862	3	32	14	0	6911
8133	7015	3	11	14	0	7043
8134	53	5	6	7004	0	7068
8135	27	5	6827	31	0	6890
8136	15	11	33	6778	0	6837
8137	11	6	6869	38	0	6924
8138	17	18	27	6712	0	6774
8139	8	6760	16	34	0	6818
8140	12	7045	7	17	0	7081
8141	17	43	6	7139	0	7205
8142	20	18	7	6962	0	7007
8143	6972	7	2	57	0	7038
8144	43	9	6913	15	0	6980
8145	6720	5	34	17	0	6776
8146	39	6949	15	12	0	7015
8147	6959	34	7	15	0	7015
8148	6968	15	8	11	0	7002
8149	55	11	3	6941	0	7010
8150	28	3	7107	38	0	7176
8151	19	6	42	7075	0	7142
8152	15	7445	16	39	0	7515
8153	17	57	5	7499	0	7578
8154	13	13	10	7578	0	7614
8155	7456	9	6	74	0	7545
8156	68	7	4	7295	0	7374
8157	26	7179	6	53	0	7264
8158	19	53	3	7323	0	7398
8159	7384	17	6	71	0	7478
8160	61	7454	7	25	0	7547
8161	23	61	9	7610	0	7703
8162	14	20	2	7675	0	7711
8163	19	3	6	8035	0	8063
8164	23	7	4	7998	0	8032
8165	8050	5	7	111	0	8173
8166	88	8	6	8112	0	8214
8167	39	4	2	8256	0	8301
8168	26	22	7	8341	0	8396
8169	12	8456	6	114	0	8588
8170	8428	102	9	53	0	8592
8171	114	23	8407	25	0	8569
8172	29	8210	91	12	0	8342
8173	8013	99	26	28	0	8166
8174	104	24	8123	8	0	8259
8175	31	8044	89	12	0	8176
8176	28	136	31	7855	0	8050
8177	8	8080	11	84	0	8183
8178	10	96	7976	19	0	8101
8179	19	24	7940	20	0	8003
8180	7	7906	89	13	0	8015
8181	7845	94	24	21	0	7984
8182	7868	23	16	15	0	7922
8183	92	12	7682	7	0	7793
8184	25	17	7296	8	0	7346
8185	21	7	7454	7	0	7489
8186	21	8	103	7389	0	7521
8187	24	7	28	7385	0	7444
8188	11	1	21	7591	0	7624
8189	2	9	7651	104	0	7766
8190	18	3	92	7411	0	7524
8191	16	3	20	7631	0	7670
8192	3	9	7507	116	0	7635
8193	7413	2	90	48	0	7553
8194	95	1	26	7729	0	7851
8195	25	6	13	7682	0	7726
8196	11	7781	13	126	0	7931
8197	7810	92	9	45	0	7956
8198	108	26	7748	22	0	7904
8199	7653	12	96	32	0	7793
8200	110	8	23	7738	0	7879
8201	32	17	7773	103	0	7925
8202	27	7	98	7661	0	7793
8203	7729	6	29	128	0	7892
8204	109	7	7687	38	0	7841
8205	7566	11	111	33	0	7721
8206	7677	5	27	30	0	7739
8207	7737	6	19	32	0	7794
8208	143	7643	23	14	0	7823
8209	54	101	18	7829	0	8002
8210	8070	29	11	115	0	8225
8211	8105	14	13	41	0	8173
8212	8209	9	10	34	0	8262
8213	163	14	7912	15	0	8104
8214	8297	5	128	28	0	8458
8215	174	7	36	8695	0	8912
8216	52	7	8634	171	0	8864
8217	51	9	160	8787	0	9007
8218	34	10	37	8928	0	9009
8219	36	8	8888	224	0	9156
8220	35	5	197	8913	0	9150
8221	31	5	51	9288	0	9375
8222	21	6	9914	245	0	10186
8223	10309	6	233	93	0	10641
8224	11189	6	89	72	0	11356
8225	349	10	55	11351	0	11765
8226	133	9	11261	305	0	11708
8227	106	8	294	11026	0	11434
8228	70	10973	100	321	0	11464
8229	97	257	59	11023	0	11436
8230	77	82	53	11307	0	11519
8231	11004	42	52	436	0	11534
8232	11126	36	49	211	0	11422
8233	11342	36	42	144	0	11564
8234	429	41	31	11053	0	11554
8235	212	28	16	11307	0	11563
8236	148	22	10911	431	0	11512
8237	138	20	289	10681	0	11128
8238	121	10919	95	380	0	11515
8239	10947	268	66	190	0	11471
8240	335	10715	59	165	0	11274
8241	10839	312	52	141	0	11344
8242	388	113	61	10403	0	10965
8243	162	10632	54	336	0	11184
8244	10662	336	40	166	0	11204
8245	10914	128	35	124	0	11201
8246	436	94	39	10548	0	11117
8247	199	10571	31	360	0	11161
8248	165	327	32	10594	0	11118
8249	123	130	10465	384	0	11102
8250	10299	87	288	173	0	10847
8251	364	10368	98	153	0	10983
8252	10096	308	73	114	0	10591
8253	379	122	46	10121	0	10668
8254	10271	82	53	375	0	10781
8255	391	63	10485	160	0	11099
8256	10799	60	299	126	0	11284
8257	10959	68	114	113	0	11254
8258	474	47	10772	113	0	11406
8259	271	34	309	10665	0	11279
8260	218	29	147	10879	0	11273
8261	10553	31	114	436	0	11134
8262	418	10442	87	209	0	11156
8263	219	330	77	10079	0	10705
8264	152	123	9870	387	0	10532
8265	138	78	9846	230	0	10292
8266	120	9670	327	204	0	10321
8267	152	291	9574	150	0	10167
8268	9173	159	367	134	0	9833
8269	329	92	152	9001	0	9574
8270	9152	61	132	329	0	9674
8271	330	69	9087	169	0	9655
8272	180	79	295	9088	0	9642
8273	156	56	155	9272	0	9639
8274	148	56	9009	388	0	9601
8275	135	58	302	9074	0	9569
8276	8889	67	138	378	0	9472
8277	9138	48	116	222	0	9524
8278	409	49	88	8984	0	9530
8279	8946	41	78	383	0	9448
8280	9055	42	69	219	0	9385
8281	435	8701	70	182	0	9388
8282	276	245	65	8795	0	9381
8283	8934	104	49	347	0	9434
8284	388	71	59	8922	0	9440
8285	8862	71	59	373	0	9365
8286	415	62	55	8793	0	9325
8287	214	74	8686	396	0	9370
8288	187	8639	269	232	0	9327
8289	213	281	119	7840	0	8453
8290	165	8557	79	331	0	9132
8291	8484	295	81	193	0	9053
8292	344	8218	83	181	0	8826
8293	190	8285	97	150	0	8722
8294	182	350	80	8056	0	8668
8295	8084	171	72	334	0	8661
8296	320	140	62	8080	0	8602
8297	8036	104	51	385	0	8576
8298	8112	117	55	216	0	8500
8299	391	7990	62	173	0	8616
8300	8137	291	60	151	0	8639
8301	8272	137	55	131	0	8595
8302	8248	99	70	150	0	8567
8303	506	80	7761	114	0	8461
8304	307	77	253	7773	0	8410
8305	244	92	119	7998	0	8453
8306	234	59	7522	373	0	8188
8307	7809	50	242	222	0	8323
8308	8011	49	132	179	0	8371
8309	7911	48	121	156	0	8236
8310	7509	42	80	169	0	7800
8311	422	7145	80	166	0	7813
8312	7062	211	73	117	0	7463
8313	435	94	48	6880	0	7457
8314	294	69	6037	261	0	6661
8315	6224	54	149	140	0	6567
8316	336	6149	74	121	0	6680
8317	5877	198	53	99	0	6227
8318	302	5710	40	93	0	6145
8319	193	5492	42	98	0	5825
8320	153	5400	58	98	0	5709
8321	155	5313	78	104	0	5650
8322	133	208	4375	100	0	4816
8323	126	288	135	3583	0	4132
8324	48	36	3257	93	0	3434
8325	2824	26	61	36	0	2947
8326	67	2785	21	36	0	2909
8327	27	2812	21	20	0	2880
8328	29	62	14	2736	0	2841
8329	40	33	7	2759	0	2839
8330	29	32	2692	63	0	2816
8331	23	24	2687	34	0	2768
8332	27	19	51	2687	0	2784
8333	31	12	2690	67	0	2800
8334	33	2674	53	30	0	2790
8335	49	44	21	2632	0	2746
8336	42	28	15	2853	0	2938
8337	38	23	2797	56	0	2914
8338	44	15	41	2718	0	2818
8339	2763	8	18	62	0	2851
8340	67	8	24	2727	0	2826
8341	33	10	21	2747	0	2811
8342	27	7	2681	76	0	2791
8343	2637	12	53	44	0	2746
8344	69	2718	24	25	0	2836
8345	50	45	12	2694	0	2801
8346	53	17	2683	48	0	2801
8347	43	14	46	2685	0	2788
8348	2711	18	15	55	0	2799
8349	67	18	2689	26	0	2800
8350	46	22	42	2679	0	2789
8351	26	14	2712	53	0	2805
8352	27	2706	48	38	0	2819
8353	37	47	2642	21	0	2747
8354	26	2550	44	22	0	2642
8355	20	39	2136	9	0	2204
8356	27	32	30	1859	0	1948
8357	8	1883	12	19	0	1922
8358	1801	18	2	12	0	1833
8359	22	10	5	1809	0	1846
8360	1845	3	3	18	0	1869
8361	22	7	1	1931	0	1961
8362	10	4	3	1967	0	1984
8363	1963	1	5	23	0	1992
8364	1998	5	3	12	0	2018
8365	34	2	3	2073	0	2112
8366	14	1	2111	25	0	2151
8367	6	2115	24	8	0	2153
8368	3	29	2155	4	0	2191
8369	5	2163	22	9	0	2199
8370	2139	22	9	3	0	2173
8371	25	7	2119	2	0	2153
8372	6	4	2120	2	0	2132
8373	4	1	24	2085	0	2114
8374	2118	4	7	26	0	2155
8375	24	2	2227	5	0	2258
8376	7	2381	21	8	0	2417
8377	2468	21	4	3	0	2496
8378	2541	6	4	8	0	2559
8379	2566	3	2	8	0	2579
8380	2577	3	3	7	0	2590
8381	2563	3	1	6	0	2573
8382	27	2	2564	5	0	2598
8383	6	12	22	2466	0	2506
8384	6	2459	7	22	0	2494
8385	2528	23	4	5	0	2560
8386	21	2540	4	2	0	2567
8387	2466	18	2	1	0	2487
8388	2460	4	1	6	0	2471
8389	22	2437	3	3	0	2465
8390	2488	18	3	4	0	2513
8391	21	6	0	2496	0	2523
8392	5	1	3	2525	0	2534
8393	3	3	2481	22	0	2509
8394	4	2502	20	5	0	2531
8395	4	23	2	2526	0	2555
8396	5	4	3	2568	0	2580
8397	2	2	4	2557	0	2565
8398	1	4	2503	21	0	2529
8399	2382	0	17	10	0	2409
8400	22	3	4	2497	0	2526
8401	2512	2	3	17	0	2534
8402	21	2	2	2509	0	2534
8403	7	3	2571	18	0	2599
8404	4	3	2573	7	0	2587
8405	2507	0	22	9	0	2538
8406	2635	2	7	4	0	2648
8407	19	2584	4	3	0	2610
8408	7	16	2612	3	0	2638
8409	7	6	17	2574	0	2604
8410	18	8	15	1998	0	2039
8411	2716	0	3	25	0	2744
8412	2739	2	3	7	0	2751
8413	2724	0	3	7	0	2734
8414	18	0	2712	5	0	2735
8415	2756	2	18	7	0	2783
8416	18	1	7	2794	0	2820
8417	8	2	2	2814	0	2826
8418	3	3	4	2808	0	2818
8419	5	2781	5	20	0	2811
8420	2746	15	2	9	0	2772
8421	19	5	2	2752	0	2778
8422	9	3	2739	17	0	2768
8423	6	0	13	2727	0	2746
8424	5	2739	5	16	0	2765
8425	2781	14	7	5	0	2807
8426	18	6	1	2759	0	2784
8427	10	4	2	2735	0	2751
8428	5	3	2789	22	0	2819
8429	7	2	16	2769	0	2794
8430	7	2788	6	13	0	2814
8431	6	14	2	2848	0	2870
8432	3	5	2864	23	0	2895
8433	2635	2	15	10	0	2662
8434	2796	3	6	11	0	2816
8435	19	2851	5	2	0	2877
8436	2754	15	3	5	0	2777
8437	2839	4	3	4	0	2850
8438	20	2832	2	10	0	2864
8439	9	16	6	2868	0	2899
8440	2925	0	2	23	0	2950
8441	18	3028	0	3	0	3049
8442	3	15	3084	6	0	3108
8443	3069	2	21	5	0	3097
8444	3214	3	4	7	0	3228
8445	3223	3	3	7	0	3236
8446	3221	3	1	7	0	3232
8447	24	3310	1	7	0	3342
8448	3361	19	4	9	0	3393
8449	3433	4	2	7	0	3446
8450	3467	5	1	6	0	3479
8451	36	1	1	3455	0	3493
8452	3444	2	1	33	0	3480
8453	24	3544	4	7	0	3579
8454	8	29	3705	4	0	3746
8455	10	7	29	3817	0	3863
8456	3871	4	6	32	0	3913
8457	33	3	3906	8	0	3950
8458	9	4	31	3911	0	3955
8459	9	2	3927	30	0	3968
8460	5	3896	31	7	0	3939
8461	7	29	5	3834	0	3875
8462	3	6	3885	33	0	3927
8463	7	3870	27	5	0	3909
8464	16	33	8	3825	0	3882
8465	3875	5	12	29	0	3921
8466	3886	2	2	10	0	3900
8467	3909	1	1	2	0	3913
8468	3882	1	2	7	0	3892
8469	3870	0	2	6	0	3878
8470	37	3	3899	3	0	3942
8471	3889	3	24	7	0	3923
8472	4043	0	9	5	0	4057
8473	35	3	5	4018	0	4061
8474	4030	3	3	28	0	4064
8475	3894	3	2	10	0	3909
8476	31	3761	1	7	0	3800
8477	12	27	5	3768	0	3812
8478	7	11	2	3762	0	3782
8479	3751	2	1	35	0	3789
8480	33	3722	1	9	0	3765
8481	11	3810	4	5	0	3830
8482	13	30	1	3899	0	3943
8483	8	11	5	3924	0	3948
8484	8	5	1	3884	0	3898
8485	7	0	4	3925	0	3936
8486	3856	1	2	43	0	3902
8487	3834	4	0	16	0	3854
8488	40	4	3879	10	0	3933
8489	18	3	27	3850	0	3898
8490	9	3	7	3905	0	3924
8491	6	7	3861	38	0	3912
8492	3729	1	28	17	0	3775
8493	34	3827	6	11	0	3878
8494	3833	32	4	6	0	3875
8495	36	8	1	3825	0	3870
8496	8	8	3879	36	0	3931
8497	10	1	28	3917	0	3956
8498	7	0	4048	41	0	4096
8499	7	4090	31	11	0	4139
8500	4060	31	12	15	0	4118
8501	4088	7	5	7	0	4107
8502	36	4070	3	7	0	4116
8503	17	26	4	4016	0	4063
8504	3934	9	3	36	0	3982
8505	32	3919	3	14	0	3968
8506	11	31	4	3967	0	4013
8507	3990	7	3	38	0	4038
8508	32	6	3934	12	0	3984
8509	3898	1	31	12	0	3942
8510	32	3966	7	12	0	4017
8511	3961	27	9	7	0	4004
8512	3943	8	5	5	0	3961
8513	35	8	3910	7	0	3960
8514	15	5	31	3835	0	3886
8515	10	5	8	3922	0	3945
8516	6	2	3901	40	0	3949
8517	6	5	31	3849	0	3891
8518	15	5	12	3637	0	3669
8519	3943	4	4	41	0	3992
8520	3946	3	3	13	0	3965
8521	41	2	3	3912	0	3958
8522	15	6	3923	31	0	3975
8523	11	3	30	3901	0	3945
8524	15	1	8	3945	0	3969
8525	6	6	3979	36	0	4027
8526	10	2	29	3998	0	4039
8527	3996	1	7	35	0	4039
8528	3967	2	9	14	0	3992
8529	36	3928	5	10	0	3979
8530	3997	29	2	13	0	4041
8531	3993	6	4	8	0	4011
8532	36	4031	6	8	0	4081
8533	4080	28	4	9	0	4121
8534	4094	8	2	8	0	4112
8535	4173	7	1	13	0	4194
8536	44	5	4113	9	0	4171
8537	4061	2	33	12	0	4108
8538	38	4	9	4185	0	4236
8539	4175	2	7	45	0	4229
8540	41	5	4137	13	0	4196
8541	16	4002	26	12	0	4056
8542	3975	28	12	8	0	4023
8543	34	4080	10	3	0	4127
8544	20	36	2	4047	0	4105
8545	18	9	2	4094	0	4123
8546	4101	8	3	38	0	4150
8547	3997	3	2	21	0	4023
8548	50	4	3935	7	0	3996
8549	16	2	3670	3	0	3691
8550	13	4	3790	5	0	3812
8551	10	31	40	3734	0	3815
8552	10	3	3781	32	0	3826
8553	12	2	3614	8	0	3636
8554	40	70	31	3411	0	3552
8555	3558	2	19	41	0	3620
8556	3585	0	5	17	0	3607
8557	3595	1	3	10	0	3609
8558	3593	1	1	7	0	3602
8559	33	0	3	3576	0	3612
8560	13	2	3	3611	0	3629
8561	12	1	3706	30	0	3749
8562	6	1	28	3657	0	3692
8563	10	0	10	3519	0	3539
8564	3758	0	6	43	0	3807
8565	3771	4	2	18	0	3795
8566	50	1	3	3713	0	3767
8567	3748	3	2	42	0	3795
8568	3820	0	2	14	0	3836
8569	47	0	7	3799	0	3853
8570	18	3	1	3758	0	3780
8571	9	0	3690	49	0	3748
8572	9	2	3594	10	0	3615
8573	6	3	43	3701	0	3753
8574	9	3	10	3764	0	3786
8575	10	1	3759	43	0	3813
8576	3619	3	35	17	0	3674
8577	3673	1	9	12	0	3695
8578	46	3	3647	5	0	3701
8579	11	3611	38	4	0	3664
8580	3691	34	6	14	0	3745
8581	46	4	3845	5	0	3900
8582	10	9	37	3816	0	3872
8583	10	2	10	3941	0	3963
8584	4105	0	6	48	0	4159
8585	4379	0	5	22	0	4406
8586	49	1	2	4431	0	4483
8587	14	2	4	4686	0	4706
8588	4692	2	5	48	0	4747
8589	4710	2	2	18	0	4732
8590	4675	1	2	12	0	4690
8591	57	0	4733	5	0	4795
8592	18	0	44	4743	0	4805
8593	11	1	5	4890	0	4907
8594	4861	0	6	63	0	4930
8595	47	4885	7	14	0	4953
8596	5261	42	7	8	0	5318
8597	71	5249	5	9	0	5334
8598	14	66	4	5356	0	5440
8599	17	10	3	5438	0	5468
8600	12	3	5400	87	0	5502
8601	14	2	73	5396	0	5485
8602	9	5	5389	87	0	5490
8603	13	3	77	5431	0	5524
8604	9	2	15	5450	0	5476
8605	8	5247	11	91	0	5357
8606	8	5473	10	29	0	5520
8607	17	79	7	5352	0	5455
8608	13	23	5	5540	0	5581
8609	11	9	3	5593	0	5616
8610	13	2	8	5662	0	5685
8611	15	1	4	5718	0	5738
8612	13	8	5600	109	0	5730
8613	18	2	81	5561	0	5662
8614	10	4	18	5696	0	5728
8615	46	2	5496	115	0	5659
8616	6	5482	81	34	0	5603
8617	14	75	22	5542	0	5653
8618	6	15	5505	92	0	5618
8619	11	5497	87	26	0	5621
8620	10	79	17	5567	0	5673
8621	5657	15	10	103	0	5785
8622	91	15	8	5642	0	5756
8623	26	6	9	5708	0	5749
8624	21	3	8	5761	0	5793
8625	16	4	9	5656	0	5685
8626	6	5517	9	117	0	5649
8627	11	77	7	5628	0	5723
8628	5734	12	4	120	0	5870
8629	91	11	10	5765	0	5877
8630	26	11	4	5755	0	5796
8631	17	4	7	5835	0	5863
8632	5625	2	4	127	0	5758
8633	5636	7	8	51	0	5702
8634	106	6	7	5627	0	5746
8635	5321	5	8	106	0	5440
8636	5464	7	5	34	0	5510
8637	91	5401	10	29	0	5531
8638	5337	77	5	38	0	5457
8639	85	5316	7	19	0	5427
8640	18	5351	5	24	0	5398
8641	25	91	8	5354	0	5478
8642	19	21	5398	90	0	5528
8643	16	23	74	5232	0	5345
8644	12	10	10	5293	0	5325
8645	5	5218	12	90	0	5325
8646	5242	71	10	35	0	5358
8647	80	14	5	5260	0	5359
8648	13	14	5427	101	0	5555
8649	18	14	74	5404	0	5510
8650	11	5553	13	90	0	5667
8651	5629	75	7	46	0	5757
8652	86	13	7	5645	0	5751
8653	16	13	5731	101	0	5861
8654	11	12	73	5746	0	5842
8655	16	5671	12	83	0	5782
8656	17	80	7	5816	0	5920
8657	6204	21	7	108	0	6340
8658	6340	12	13	51	0	6416
8659	6434	12	10	50	0	6506
8660	124	6550	11	46	0	6731
8661	6643	94	8	34	0	6779
8662	123	33	9	6681	0	6846
8663	6700	15	7	140	0	6862
8664	116	6739	7	51	0	6913
8665	37	108	10	6808	0	6963
8666	17	36	6790	129	0	6972
8667	6565	17	96	58	0	6736
8668	99	6818	20	52	0	6989
8669	37	117	13	6857	0	7024
8670	23	25	11	7011	0	7070
8671	24	19	8	6934	0	6985
8672	15	14	10	6847	0	6886
8673	11	6817	7	158	0	6993
8674	6877	111	8	64	0	7060
8675	6941	28	7	41	0	7017
8676	135	19	6931	37	0	7122
8677	48	17	103	6983	0	7151
8678	31	14	6990	124	0	7159
8679	6869	14	106	57	0	7046
8680	6982	13	34	43	0	7072
8681	6812	8	14	43	0	6877
8682	151	15	10	6591	0	6767
8683	51	6595	7	130	0	6783
8684	6652	111	3	46	0	6812
8685	130	31	9	6454	0	6624
8686	6449	17	5	130	0	6601
8687	126	21	6194	49	0	6390
8688	51	16	6104	36	0	6207
8689	6270	10	109	37	0	6426
8690	118	9	38	6302	0	6467
8691	6234	5	15	132	0	6386
8692	125	6250	15	46	0	6436
8693	6271	107	10	38	0	6426
8694	6368	30	11	36	0	6445
8695	159	18	6205	18	0	6400
8696	47	17	5715	19	0	5798
8697	30	5787	92	22	0	5931
8698	65	83	56	5667	0	5871
8699	5715	26	35	94	0	5870
8700	100	12	4	5696	0	5812
8701	51	11	6	5836	0	5904
8702	23	12	5706	103	0	5844
8703	5675	13	64	40	0	5792
8704	82	19	30	5837	0	5968
8705	54	4	5769	86	0	5913
8706	30	14	5691	39	0	5774
8707	41	26	90	5724	0	5881
8708	18	14	5768	80	0	5880
8709	24	10	5708	34	0	5776
8710	36	11	82	5443	0	5572
8711	24	12	5748	85	0	5869
8712	19	14	77	5618	0	5728
8713	20	5545	28	90	0	5683
8714	5852	65	13	52	0	5982
8715	77	5945	13	23	0	6058
8716	39	75	15	5898	0	6027
8717	27	6100	10	77	0	6214
8718	24	76	6319	41	0	6460
8719	37	33	86	6982	0	7138
8720	25	15	7636	116	0	7792
8721	7639	11	118	77	0	7845
8722	130	8013	59	28	0	8230
8723	8119	124	29	26	0	8298
8724	165	56	16	8039	0	8276
8725	8120	33	20	141	0	8314
8726	162	20	8038	72	0	8292
8727	68	8073	136	46	0	8323
8728	8078	124	64	39	0	8305
8729	151	59	40	7870	0	8120
8730	79	8104	22	132	0	8337
8731	57	139	26	8256	0	8478
8732	8356	52	27	172	0	8607
8733	151	8843	14	88	0	9096
8734	8910	163	22	53	0	9148
8735	212	75	8812	27	0	9126
8736	8884	48	151	39	0	9122
8737	222	23	65	8873	0	9183
8738	8820	18	51	173	0	9062
8739	189	8768	35	77	0	9069
8740	101	147	29	8841	0	9118
8741	72	75	23	8962	0	9132
8742	52	45	8666	214	0	8977
8743	61	29	144	8675	0	8909
8744	46	24	70	8842	0	8982
8745	62	25	31	8897	0	9015
8746	45	20	38	8913	0	9016
8747	42	22	8731	246	0	9041
8748	38	8440	165	124	0	8767
8749	38	145	72	8548	0	8803
8750	8389	56	49	192	0	8686
8751	8375	41	36	105	0	8557
8752	207	8421	29	92	0	8749
8753	8340	162	30	66	0	8598
8754	8326	69	23	65	0	8483
8755	8214	40	25	61	0	8340
8756	225	7962	32	45	0	8264
8757	7574	141	19	42	0	7776
8758	198	67	17	7355	0	7637
8759	73	46	7187	138	0	7444
8760	50	7114	115	67	0	7346
8761	62	140	67	6934	0	7203
8762	44	52	6865	123	0	7084
8763	6780	36	105	67	0	6988
8764	140	22	44	6834	0	7040
8765	85	19	33	6838	0	6975
8766	57	20	21	6814	0	6912
8767	49	17	16	6859	0	6941
8768	33	25	6582	183	0	6823
8769	6316	18	109	103	0	6546
8770	118	6513	55	70	0	6756
8771	6504	111	39	44	0	6698
8772	138	6542	21	37	0	6738
8773	6585	124	22	49	0	6780
8774	143	60	27	6536	0	6766
8775	78	30	6498	135	0	6741
8776	48	18	6499	83	0	6648
8777	55	29	146	6498	0	6728
8778	50	20	59	6553	0	6682
8779	35	25	38	6631	0	6729
8780	6492	16	26	186	0	6720
8781	130	25	6461	98	0	6714
8782	73	6348	105	63	0	6589
8783	55	6571	57	42	0	6725
8784	6353	144	28	40	0	6565
8785	130	67	6347	45	0	6589
8786	65	6306	112	49	0	6532
8787	55	112	6279	38	0	6484
8788	44	59	129	6232	0	6464
8789	40	37	6204	129	0	6410
8790	35	34	6168	79	0	6316
8791	36	31	143	6201	0	6411
8792	35	25	6201	133	0	6394
8793	37	25	6204	75	0	6341
8794	33	26	142	6112	0	6313
8795	6067	30	65	134	0	6296
8796	123	28	6089	72	0	6312
8797	61	21	125	6008	0	6215
8798	52	26	63	6110	0	6251
8799	6016	23	57	155	0	6251
8800	116	25	30	6061	0	6232
8801	5953	16	47	147	0	6163
8802	135	5899	39	82	0	6155
8803	64	97	27	6058	0	6246
8804	6022	41	34	142	0	6239
8805	6064	29	32	85	0	6210
8806	146	18	25	6009	0	6198
8807	84	16	5965	135	0	6200
8808	5842	14	112	76	0	6044
8809	123	5994	41	70	0	6228
8810	5794	109	37	57	0	5997
8811	5959	48	22	48	0	6077
8812	5993	29	17	50	0	6089
8813	176	21	5827	35	0	6059
8814	86	5809	105	35	0	6035
8815	62	141	49	5704	0	5956
8816	59	75	37	5756	0	5927
8817	44	28	5571	149	0	5792
8818	33	5221	89	95	0	5438
8819	32	4502	40	37	0	4611
8820	18	4003	24	21	0	4066
8821	3747	60	112	20	0	3939
8822	62	20	17	3636	0	3735
8823	26	12	5	3656	0	3699
8824	17	10	3696	51	0	3774
8825	3588	4	37	21	0	3650
8826	43	12	14	3692	0	3761
8827	20	27	8	3698	0	3753
8828	17	7	3652	45	0	3721
8829	12	3606	34	21	0	3673
8830	16	64	15	3569	0	3664
8831	14	13	3523	42	0	3592
8832	6	3265	30	19	0	3320
8833	2861	13	10	5	0	2889
8834	12	6	2948	4	0	2970
8835	10	1	10	2867	0	2888
8836	2	2904	5	13	0	2924
8837	2940	10	0	7	0	2957
8838	16	7	1	2957	0	2981
8839	2953	1	2	11	0	2967
8840	2932	2	1	5	0	2940
8841	7	2968	1	3	0	2979
8842	3008	9	1	5	0	3023
8843	3115	2	3	6	0	3126
8844	11	3	3145	4	0	3163
8845	3104	1	10	9	0	3124
8846	8	5	3164	2	0	3179
8847	3103	2	6	4	0	3115
8848	3147	2	2	5	0	3156
8849	10	1	3231	4	0	3246
8850	4	2	7	3227	0	3240
8851	4	1	3272	6	0	3283
8852	4	1	3011	3	0	3019
8853	2	4	3310	2	0	3318
8854	5	6	11	3329	0	3351
8855	2	2	3	3620	0	3627
8856	1	4	1	3642	0	3648
8857	0	1	2	3714	0	3717
8858	3	2	3770	18	0	3793
8859	3	2	16	3705	0	3726
8860	4	3458	8	15	0	3485
8861	2	16	3858	6	0	3882
8862	1	6	14	3796	0	3817
8863	5	0	3927	14	0	3946
8864	1	3846	13	8	0	3868
8865	1	3936	7	2	0	3946
8866	2	19	0	3959	0	3980
8867	15	4	3925	14	0	3958
8868	3	3	3944	5	0	3955
8869	4	3	19	4018	0	4044
8870	4	1	7	4087	0	4099
8871	3	2	0	4133	0	4138
8872	2	2	4101	22	0	4127
8873	1	4069	16	12	0	4098
8874	3	4235	8	4	0	4250
8875	8	19	3	4236	0	4266
8876	4	9	4193	16	0	4222
8877	3	3	4144	12	0	4162
8878	1	4350	25	2	0	4378
8879	4407	14	10	6	0	4437
8880	13	4455	1	4	0	4473
8881	10	14	4613	3	0	4640
8882	4553	7	20	10	0	4590
8883	23	1	12	4691	0	4727
8884	4828	1	5	23	0	4857
8885	24	5	0	4815	0	4844
8886	13	3	0	4881	0	4897
8887	4913	1	2	38	0	4954
8888	23	5039	7	13	0	5082
8889	11	29	5036	2	0	5078
8890	4	5109	30	3	0	5146
8891	5073	33	8	4	0	5118
8892	29	5050	4	6	0	5089
8893	5055	29	3	4	0	5091
8894	5057	9	4	10	0	5080
8895	40	5067	2	2	0	5111
8896	12	27	3	5043	0	5085
8897	5025	11	1	33	0	5070
8898	5039	2	2	16	0	5059
8899	40	2	4	4970	0	5016
8900	13	3	4878	32	0	4926
8901	3	3	4864	13	0	4883
8902	5	8	38	4958	0	5009
8903	3	3	4877	34	0	4917
8904	4742	6	29	19	0	4796
8905	32	4839	7	11	0	4889
8906	13	31	5	4969	0	5018
8907	7	6	3	4942	0	4958
8908	8	4	5	4910	0	4927
8909	5	3	2	4859	0	4869
8910	13	2	1	4874	0	4890
8911	7	1	4827	43	0	4878
8912	5	4821	35	12	0	4873
8913	4874	36	13	7	0	4930
8914	35	12	8	4806	0	4861
8915	14	3	4	4825	0	4846
8916	7	10	6	4809	0	4832
8917	7	4797	2	55	0	4861
8918	7	33	4	4875	0	4919
8919	7	10	2	4925	0	4944
8920	4799	3	7	59	0	4868
8921	35	4664	5	21	0	4725
8922	16	4686	6	12	0	4720
8923	7	35	4	4717	0	4763
8924	4644	11	6	45	0	4706
8925	36	6	4676	18	0	4736
8926	4459	6	38	13	0	4516
8927	38	6	4757	11	0	4812
8928	19	7	36	4721	0	4783
8929	5	9	12	4771	0	4797
8930	8	10	6	4724	0	4748
8931	10	7	1	4730	0	4748
8932	12	5	5	4661	0	4683
8933	4719	3	4	58	0	4784
8934	35	7	4643	23	0	4708
8935	17	2	35	4700	0	4754
8936	7	5	4842	47	0	4901
8937	8	4820	41	22	0	4891
8938	4846	33	11	18	0	4908
8939	42	15	5000	12	0	5069
8940	16	8	43	5124	0	5191
8941	9	7	12	5245	0	5273
8942	7	3	5205	62	0	5277
8943	9	7	5140	22	0	5178
8944	12	9	52	4875	0	4948
8945	5145	3	19	51	0	5218
8946	5137	9	7	22	0	5175
8947	58	5114	6	17	0	5195
8948	5168	45	6	19	0	5238
8949	55	16	5	4984	0	5060
8950	24	5131	6	55	0	5216
8951	11	51	7	5179	0	5248
8952	15	16	5262	58	0	5351
8953	16	4	51	5041	0	5112
8954	15	5	18	5159	0	5197
8955	4934	3	9	64	0	5010
8956	45	4936	6	22	0	5009
8957	4871	43	6	16	0	4936
8958	46	4827	3	16	0	4892
8959	4711	42	9	12	0	4774
8960	46	4652	5	10	0	4713
8961	17	4667	7	14	0	4705
8962	4706	46	11	17	0	4780
8963	52	22	11	4536	0	4621
8964	15	4620	7	54	0	4696
8965	4688	39	11	34	0	4772
8966	4716	15	8	24	0	4763
8967	4755	7	6	21	0	4789
8968	4682	5	7	21	0	4715
8969	52	4699	8	17	0	4776
8970	19	39	4	4737	0	4799
8971	16	18	3	4773	0	4810
8972	4797	7	4	66	0	4874
8973	47	13	6	4727	0	4793
8974	4679	8	8	52	0	4747
8975	52	8	4568	18	0	4646
8976	4526	5	38	22	0	4591
8977	45	8	4562	13	0	4628
8978	20	30	41	4467	0	4558
8979	4436	8	12	57	0	4513
8980	48	4383	4	21	0	4456
8981	4216	34	10	14	0	4274
8982	40	4074	1	14	0	4129
8983	21	45	4	4348	0	4418
8984	5	10	4233	35	0	4283
8985	3962	14	40	16	0	4032
8986	30	4151	9	11	0	4201
8987	26	41	1	4072	0	4140
8988	11	9	6	3991	0	4017
8989	11	4	0	3950	0	3965
8990	12	2	3927	30	0	3971
8991	5	3901	25	16	0	3947
8992	3895	29	8	14	0	3946
8993	3893	8	7	17	0	3925
8994	37	3888	4	6	0	3935
8995	3991	29	4	11	0	4035
8996	31	13	1	3966	0	4011
8997	16	3988	6	24	0	4034
8998	3996	24	3	15	0	4038
8999	28	14	3969	5	0	4016
9000	10	4012	25	10	0	4057
9001	11	22	11	4035	0	4079
9002	10	10	2	4069	0	4091
9003	6	7	4017	34	0	4064
9004	18	4	24	3948	0	3994
9005	5	7	3988	28	0	4028
9006	12	5	22	3942	0	3981
9007	8	6	11	4012	0	4037
9008	9	6	2	4049	0	4066
9009	8	6	3	4161	0	4178
9010	2	6	4153	41	0	4202
9011	10	4	4477	17	0	4508
9012	3	4955	44	12	0	5014
9013	14	51	13	5289	0	5367
9014	8	28	5471	58	0	5565
9015	6	5477	55	27	0	5565
9016	14	60	25	5750	0	5849
9017	4	29	6027	65	0	6125
9018	5866	9	70	49	0	5994
9019	6322	6	30	21	0	6379
9020	110	6	11	6336	0	6463
9021	39	6	6313	83	0	6441
9022	18	10	75	6295	0	6398
9023	6261	5	36	98	0	6400
9024	77	6381	12	43	0	6513
9025	6492	75	7	25	0	6599
9026	6537	37	10	21	0	6605
9027	117	10	9	6375	0	6511
9028	60	9	7	6458	0	6534
9029	25	6	5	6455	0	6491
9030	23	4	8	6452	0	6487
9031	22	10	9	6447	0	6488
9032	6338	10	8	136	0	6492
9033	6407	6	10	61	0	6484
9034	6380	7	8	27	0	6422
9035	126	4	5997	15	0	6142
9036	6090	4	60	26	0	6180
9037	96	20	27	6058	0	6201
9038	44	6	6028	99	0	6177
9039	20	5885	77	53	0	6035
9040	27	106	40	5750	0	5923
9041	28	38	15	5746	0	5827
9042	22	5740	13	112	0	5887
9043	29	71	14	5854	0	5968
9044	29	30	5789	98	0	5946
9045	17	16	5836	58	0	5927
9046	27	6	120	5864	0	6017
9047	5808	11	48	109	0	5976
9048	5811	9	18	59	0	5897
9049	118	15	5772	34	0	5939
9050	64	5445	82	32	0	5623
9051	37	5640	38	27	0	5742
9052	5409	97	18	45	0	5569
9053	84	40	5469	41	0	5634
9054	53	20	82	5406	0	5561
9055	5402	9	35	109	0	5555
9056	93	5267	19	63	0	5442
9057	59	5438	15	37	0	5549
9058	5414	96	13	33	0	5556
9059	95	45	13	5494	0	5647
9060	5842	18	19	104	0	5983
9061	118	12	16	6396	0	6542
9062	67	11	17	6516	0	6611
9063	43	13	6454	158	0	6668
9064	37	20	100	6616	0	6773
9065	40	16	54	6671	0	6781
9066	6642	18	33	179	0	6872
9067	127	22	14	6722	0	6885
9068	67	13	6655	153	0	6888
9069	6638	10	117	104	0	6869
9070	123	11	65	6707	0	6906
9071	6684	11	33	156	0	6884
9072	136	6371	21	99	0	6627
9073	83	6659	21	55	0	6818
9074	6603	136	27	50	0	6816
9075	6639	75	23	41	0	6778
9076	171	43	20	6563	0	6797
9077	104	17	6505	127	0	6753
9078	61	21	120	6576	0	6778
9079	6472	20	60	158	0	6710
9080	137	6484	40	84	0	6745
9081	94	115	18	6526	0	6753
9082	6487	77	27	133	0	6724
9083	135	37	6245	92	0	6509
9084	6353	16	99	75	0	6543
9085	5963	22	65	53	0	6103
9086	169	20	6309	55	0	6553
9087	97	23	6352	60	0	6532
9088	75	24	157	6232	0	6488
9089	60	17	79	6297	0	6453
9090	46	6396	44	175	0	6661
9091	63	102	25	6480	0	6670
9092	43	69	6455	155	0	6722
9093	54	31	122	6529	0	6736
9094	59	17	69	6713	0	6858
9095	43	22	6484	194	0	6743
9096	47	6448	119	117	0	6731
9097	52	108	70	6510	0	6740
9098	42	72	42	6614	0	6770
9099	6522	37	24	191	0	6774
9100	147	17	26	6522	0	6712
9101	89	18	6414	165	0	6686
9102	6338	24	126	115	0	6603
9103	6485	19	69	82	0	6655
9104	6550	18	36	62	0	6666
9105	200	33	6308	42	0	6583
9106	108	14	123	6287	0	6532
9107	71	6	80	6366	0	6523
9108	52	13	57	6382	0	6504
9109	6093	15	30	212	0	6350
9110	139	6041	26	122	0	6328
9111	88	91	5507	66	0	5752
9112	41	5208	90	60	0	5399
9113	21	4864	52	63	0	5000
9114	34	4821	40	47	0	4942
9115	91	165	69	4578	0	4903
9116	32	56	4470	99	0	4657
9117	4009	31	73	64	0	4177
9118	68	4153	42	45	0	4308
9119	3897	57	23	33	0	4010
9120	75	3995	15	29	0	4114
9121	4055	63	16	32	0	4166
9122	82	4176	14	15	0	4287
9123	54	74	4252	23	0	4403
9124	49	42	55	4253	0	4399
9125	38	32	30	4474	0	4574
9126	4467	13	27	108	0	4615
9127	75	15	17	4873	0	4980
9128	51	17	4887	108	0	5063
9129	47	18	70	4961	0	5096
9130	24	20	4949	110	0	5103
9131	17	4942	92	62	0	5113
9132	33	76	42	4776	0	4927
9133	30	4989	28	86	0	5133
9134	4981	94	19	59	0	5153
9135	91	47	25	4987	0	5150
9136	59	27	4975	88	0	5149
9137	36	22	4932	45	0	5035
9138	4906	23	102	38	0	5069
9139	89	31	44	4920	0	5084
9140	47	25	4858	88	0	5018
9141	43	20	4752	59	0	4874
9142	21	4803	103	45	0	4972
9143	20	74	77	4518	0	4689
9144	15	4751	35	87	0	4888
9145	28	78	19	4745	0	4870
9146	4770	41	25	98	0	4934
9147	70	31	16	4812	0	4929
9148	47	14	22	4870	0	4953
9149	4844	14	23	118	0	4999
9150	79	17	27	5013	0	5136
9151	55	15	16	4951	0	5037
9152	38	5050	17	121	0	5226
9153	5080	70	17	66	0	5233
9154	5138	39	14	54	0	5245
9155	108	19	24	5122	0	5273
9156	58	11	29	5129	0	5227
9157	36	14	19	5101	0	5170
9158	29	4842	15	138	0	5024
9159	23	4953	17	83	0	5076
9160	34	99	12	4615	0	4760
9161	3949	21	8	59	0	4037
9162	3897	18	6	43	0	3964
9163	63	3800	7	27	0	3897
9164	3604	42	4	22	0	3672
9165	49	3575	3	17	0	3644
9166	22	3556	2	18	0	3598
9167	64	56	11	3461	0	3592
9168	3411	22	14	53	0	3500
9169	45	3328	4	21	0	3398
9170	25	3374	8	16	0	3423
9171	18	47	3	3368	0	3436
9172	9	23	5	3416	0	3453
9173	7	17	3361	55	0	3440
9174	3324	6	39	32	0	3401
9175	3284	11	14	25	0	3334
9176	51	11	3390	16	0	3468
9177	14	12	3402	18	0	3446
9178	21	7	51	3428	0	3507
9179	7	20	22	3499	0	3548
9180	11	3449	12	60	0	3532
9181	12	49	5	3475	0	3541
9182	17	24	3438	61	0	3540
9183	15	14	45	3447	0	3521
9184	18	14	20	3469	0	3521
9185	3417	10	13	79	0	3519
9186	50	16	3380	32	0	3478
9187	3283	10	55	31	0	3379
9188	58	10	3292	28	0	3388
9189	26	10	57	3275	0	3368
9190	12	14	3270	57	0	3353
9191	11	6	3275	36	0	3328
9192	11	13	59	3236	0	3319
9193	3110	15	37	72	0	3234
9194	3122	8	18	31	0	3179
9195	55	3161	12	29	0	3257
9196	3149	44	17	18	0	3228
9197	3148	15	14	27	0	3204
9198	53	3143	12	29	0	3237
9199	32	50	8	3200	0	3290
9200	23	15	16	3237	0	3291
9201	20	18	7	3250	0	3295
9202	20	17	10	3261	0	3308
9203	19	9	3205	75	0	3308
9204	3140	10	47	35	0	3232
9205	57	13	16	3216	0	3302
9206	25	11	13	3204	0	3253
9207	19	3234	9	73	0	3335
9208	18	55	5	3303	0	3381
9209	16	19	3207	74	0	3316
9210	3218	9	47	42	0	3316
9211	64	11	3313	29	0	3417
9212	26	18	52	3266	0	3362
9213	3262	7	14	69	0	3352
9214	62	3327	7	37	0	3433
9215	24	53	7	3429	0	3513
9216	13	24	3420	74	0	3531
9217	26	21	51	3434	0	3532
9218	3438	10	16	72	0	3536
9219	58	9	3425	29	0	3521
9220	25	10	3337	21	0	3393
9221	15	3296	55	24	0	3390
9222	3140	54	19	27	0	3240
9223	52	3067	15	16	0	3150
9224	17	50	2970	20	0	3057
9225	12	12	2780	12	0	2816
9226	13	2693	49	13	0	2768
9227	2293	29	31	12	0	2365
9228	34	2223	15	4	0	2276
9229	8	31	7	2203	0	2249
9230	6	9	3	2231	0	2249
9231	3	6	2203	32	0	2244
9232	5	3	30	2185	0	2223
9233	3	3	2252	30	0	2288
9234	2212	3	34	9	0	2258
9235	2249	4	10	8	0	2271
9236	2253	5	6	6	0	2270
9237	32	8	2212	5	0	2257
9238	2198	5	27	11	0	2241
9239	36	5	7	2182	0	2230
9240	8	2209	6	30	0	2253
9241	2214	28	14	9	0	2265
9242	31	7	2140	10	0	2188
9243	2160	4	24	10	0	2198
9244	2154	5	3	6	0	2168
9245	40	2	2098	6	0	2146
9246	11	2129	32	3	0	2175
9247	12	29	9	2119	0	2169
9248	7	7	2135	36	0	2185
9249	8	7	2074	8	0	2097
9250	12	28	29	1902	0	1971
9251	3	1	1921	26	0	1951
9252	8	0	27	1849	0	1884
9253	8	2	8	1777	0	1795
9254	6	3	6	1868	0	1883
9255	5	5	1862	25	0	1897
9256	1	3	26	1861	0	1891
9257	4	3	1890	24	0	1921
9258	4	3	25	1894	0	1926
9259	1977	1	9	28	0	2015
9260	27	2	9	1974	0	2012
9261	3	2025	4	32	0	2064
9262	6	24	3	2100	0	2133
9263	2112	7	4	30	0	2153
9264	24	2126	3	10	0	2163
9265	4	24	6	2148	0	2182
9266	2129	4	8	31	0	2172
9267	29	3	2144	11	0	2187
9268	9	5	25	2140	0	2179
9269	4	1	2176	32	0	2213
9270	8	4	2153	9	0	2174
9271	8	1	28	2151	0	2188
9272	2138	3	10	31	0	2182
9273	25	5	2118	9	0	2157
9274	2105	1	30	12	0	2148
9275	32	4	9	2145	0	2190
9276	12	3	2151	28	0	2194
9277	5	2	2113	7	0	2127
9278	5	4	2120	4	0	2133
9279	3	10	31	2065	0	2109
9280	2107	1	18	24	0	2150
9281	23	2126	6	9	0	2164
9282	12	24	5	2104	0	2145
9283	6	4	3	2145	0	2158
9284	2130	4	7	27	0	2168
9285	2144	3	6	18	0	2171
9286	24	2133	4	7	0	2168
9287	2146	21	7	6	0	2180
9288	2145	4	2	7	0	2158
9289	29	4	5	2118	0	2156
9290	8	3	2120	21	0	2152
9291	2105	2	20	8	0	2135
9292	24	2	6	2140	0	2172
9293	8	2	6	2143	0	2159
9294	2136	2	3	23	0	2164
9295	24	0	5	2059	0	2088
9296	8	4	2	2077	0	2091
9297	2042	0	3	24	0	2069
9298	20	2094	3	11	0	2128
9299	2068	17	3	6	0	2094
9300	22	7	2072	10	0	2111
9301	2071	1	19	5	0	2096
9302	23	3	6	2085	0	2117
9303	8	2119	3	23	0	2153
9304	6	17	5	2134	0	2162
9305	6	5	4	2135	0	2150
9306	6	1	0	2144	0	2151
9307	2086	1	2	20	0	2109
9308	17	2038	2	15	0	2072
9309	7	2025	3	4	0	2039
9310	1998	15	2	4	0	2019
9311	12	6	2078	4	0	2100
9312	7	2	2028	3	0	2040
9313	1984	8	31	4	0	2027
9314	11	0	2072	2	0	2085
9315	6	0	9	2007	0	2022
9316	10	0	8	1863	0	1881
9317	1	2	1	2052	0	2056
9318	2	0	0	2036	0	2038
9319	1	1962	3	17	0	1983
9320	2	10	1	2062	0	2075
9321	3	4	2044	13	0	2064
9322	0	3	11	2032	0	2046
9323	2	1	1988	16	0	2007
9324	5	1	1957	7	0	1970
9325	1	3	16	2006	0	2026
9326	4	2	2015	14	0	2035
9327	3	1	12	2009	0	2025
9328	2020	2	9	16	0	2047
9329	12	1	2034	7	0	2054
9330	1976	1	12	5	0	1994
9331	14	2	8	2021	0	2045
9332	9	1	2008	13	0	2031
9333	5	1977	10	7	0	1999
9334	0	11	8	2055	0	2074
9335	4	4	2151	13	0	2172
9336	3	1	14	2158	0	2176
9337	2205	1	8	20	0	2234
9338	2220	2	5	8	0	2235
9339	2268	0	4	6	0	2278
9340	27	0	3	2280	0	2310
9341	10	1	1	2317	0	2329
9342	4	2	5	2345	0	2356
9343	2381	0	7	24	0	2412
9344	17	2428	2	15	0	2462
9345	11	15	2	2457	0	2485
9346	11	8	3	2496	0	2518
9347	2476	6	0	30	0	2512
9348	20	2539	3	15	0	2577
9349	13	21	0	2645	0	2679
9350	2671	9	0	29	0	2709
9351	2659	4	3	13	0	2679
9352	36	8	1	2625	0	2670
9353	2632	1	0	32	0	2665
9354	31	1	2	2621	0	2655
9355	14	3	2656	29	0	2702
9356	8	1	20	2676	0	2705
9357	11	0	11	2701	0	2723
9358	8	0	2	2716	0	2726
9359	2599	2	2	38	0	2641
9360	26	2600	0	22	0	2648
9361	2551	21	3	12	0	2587
9362	27	2515	3	6	0	2551
9363	10	2550	1	12	0	2573
9364	2563	28	3	14	0	2608
9365	24	2608	2	5	0	2639
9366	8	24	2	2620	0	2654
9367	2591	9	4	26	0	2630
9368	2628	3	1	16	0	2648
9369	30	5	1	2614	0	2650
9370	16	2	3	2619	0	2640
9371	8	2643	1	35	0	2687
9372	2684	21	2	19	0	2726
9373	2672	8	2	13	0	2695
9374	32	2787	2	6	0	2827
9375	15	2820	3	6	0	2844
9376	8	30	3	2830	0	2871
9377	2831	12	3	34	0	2880
9378	31	7	2	2836	0	2876
9379	14	5	1	2879	0	2899
9380	8	2	2826	38	0	2874
9381	6	4	2816	15	0	2841
9382	5	6	31	2816	0	2858
9383	8	3	2841	31	0	2883
9384	7	2827	29	9	0	2872
9385	7	29	9	2844	0	2889
9386	8	11	5	2889	0	2913
9387	4	5	4	2910	0	2923
9388	4	3	2890	38	0	2935
9389	6	2	2802	21	0	2831
9390	2800	3	32	12	0	2847
9391	31	2876	13	8	0	2928
9392	2870	28	7	9	0	2914
9393	36	11	3	2862	0	2912
9394	2896	7	4	32	0	2939
9395	35	7	2	2872	0	2916
9396	12	2900	6	36	0	2954
9397	2916	31	0	17	0	2964
9398	35	8	2861	13	0	2917
9399	13	2843	30	11	0	2897
9400	2827	27	14	13	0	2881
9401	35	9	10	2804	0	2858
9402	14	2798	6	27	0	2845
9403	15	31	3	2859	0	2908
9404	2851	10	3	39	0	2903
9405	35	7	2	2859	0	2903
9406	2845	6	2	42	0	2895
9407	39	4	2806	18	0	2867
9408	20	6	28	2823	0	2877
9409	2809	10	8	37	0	2864
9410	37	7	2772	18	0	2834
9411	19	2669	30	14	0	2732
9412	17	34	6	2632	0	2689
9413	12	11	2630	36	0	2689
9414	6	9	2536	17	0	2568
9415	18	25	35	2535	0	2613
9416	13	0	2508	37	0	2558
9417	8	10	2492	15	0	2525
9418	6	12	30	2465	0	2513
9419	2451	4	10	42	0	2507
9420	37	6	10	2448	0	2501
9421	12	4	5	2486	0	2507
9422	12	1	2484	41	0	2538
9423	10	7	32	2516	0	2565
9424	2548	5	14	43	0	2610
9425	33	9	2529	17	0	2588
9426	13	2557	29	17	0	2616
9427	13	30	10	2603	0	2656
9428	2606	8	9	38	0	2661
9429	36	6	9	2605	0	2656
9430	11	2603	6	43	0	2663
9431	10	25	2704	18	0	2757
9432	10	14	39	2758	0	2821
9433	2901	10	12	41	0	2964
9434	41	9	2829	19	0	2898
9435	19	4	45	2858	0	2926
9436	2919	6	15	58	0	2998
9437	3030	3	10	26	0	3069
9438	59	3037	7	17	0	3120
9439	3026	51	7	15	0	3099
9440	56	26	7	3007	0	3096
9441	27	6	3027	52	0	3112
9442	14	2934	45	28	0	3021
9443	14	3013	20	12	0	3059
9444	12	68	15	2908	0	3003
9445	13	29	10	2951	0	3003
9446	9	5	2851	62	0	2927
9447	8	2828	42	23	0	2901
9448	6	2810	20	10	0	2846
9449	18	60	9	2666	0	2753
9450	2627	18	7	50	0	2702
9451	45	2639	9	21	0	2714
9452	24	42	4	2673	0	2743
9453	2756	23	4	49	0	2832
9454	47	7	3	2787	0	2844
9455	26	3	2	2774	0	2805
9456	8	7	6	2799	0	2820
9457	11	5	5	2792	0	2813
9458	2729	2	7	70	0	2808
9459	51	4	9	2737	0	2801
9460	22	9	2658	48	0	2737
9461	2623	8	43	29	0	2703
9462	50	4	2654	17	0	2725
9463	276	1	2434	18	0	2729
9464	18	7	48	2648	0	2721
9465	11	4	19	2667	0	2701
9466	13	5	7	2698	0	2723
9467	2638	0	9	71	0	2718
9468	47	4	2605	24	0	2680
9469	2591	4	42	16	0	2653
9470	2643	1	19	12	0	2675
9471	62	2	2553	14	0	2631
9472	2557	4	42	17	0	2620
9473	52	3	2586	7	0	2648
9474	21	2521	47	12	0	2601
9475	24	45	41	2490	0	2600
9476	12	15	7	2555	0	2589
9477	7	3	8	2538	0	2556
9478	7	4	7	2533	0	2551
9479	14	4	2472	65	0	2555
9480	4	6	2485	26	0	2521
9481	7	3	57	2461	0	2528
9482	9	4	2459	53	0	2525
9483	2390	1	48	30	0	2469
9484	2508	3	17	8	0	2536
9485	64	3	11	2447	0	2525
9486	2423	4	6	54	0	2487
9487	52	2464	4	22	0	2542
9488	2455	40	8	11	0	2514
9489	47	20	2467	12	0	2546
9490	27	6	39	2436	0	2508
9491	6	2486	21	47	0	2560
9492	2527	42	7	23	0	2599
9493	53	17	5	2557	0	2632
9494	20	7	2528	48	0	2603
9495	10	4	43	2537	0	2594
9496	2503	7	18	53	0	2581
9497	51	6	2538	21	0	2616
9498	28	5	42	2528	0	2603
9499	8	3	22	2580	0	2613
9500	11	6	2522	66	0	2605
9501	15	2427	36	26	0	2504
9502	17	1999	22	16	0	2054
9503	10	49	8	2509	0	2576
9504	9	21	10	2566	0	2606
9505	10	11	7	2615	0	2643
9506	2533	8	10	71	0	2622
9507	2583	6	8	35	0	2632
9508	61	4	7	2562	0	2634
9509	2556	7	6	62	0	2631
9510	42	2540	7	38	0	2627
9511	25	45	5	2619	0	2694
9512	11	18	9	2674	0	2712
9513	8	5	3	2696	0	2712
9514	2564	8	4	72	0	2648
9515	50	2525	7	32	0	2614
9516	31	42	4	2579	0	2656
9517	2566	21	4	59	0	2650
9518	51	5	5	2602	0	2663
9519	34	5	5	2596	0	2640
9520	12	2449	6	84	0	2551
9521	12	2574	4	37	0	2627
9522	9	54	5	2544	0	2612
9523	14	15	6	2555	0	2590
9524	2446	2	6	67	0	2521
9525	49	5	6	2457	0	2517
9526	21	5	2376	50	0	2452
9527	12	5	39	2373	0	2429
9528	9	2323	17	51	0	2400
9529	2392	37	9	29	0	2467
9530	53	18	4	2399	0	2474
9531	23	4	5	2321	0	2353
9532	10	2251	4	55	0	2320
9533	2113	29	2	23	0	2167
9534	31	2189	3	9	0	2232
9535	19	27	2	2121	0	2169
9536	5	13	2056	24	0	2098
9537	12	26	17	1886	0	1941
9538	1884	2	14	23	0	1923
9539	25	1880	0	10	0	1915
9540	8	21	2	1898	0	1929
9541	2	1823	5	18	0	1848
9542	1	21	1	1905	0	1928
9543	2	11	1877	24	0	1914
9544	3	6	18	1856	0	1883
9545	0	2	6	1872	0	1880
9546	5	2	2	1890	0	1899
9547	1828	4	2	32	0	1866
9548	1857	0	1	13	0	1871
9549	25	1868	3	3	0	1899
9550	1859	17	0	14	0	1890
9551	21	1831	6	0	0	1858
9552	6	1887	0	7	0	1900
9553	1794	28	1	4	0	1827
9554	22	13	1769	3	0	1807
9555	8	0	16	1765	0	1789
9556	4	4	6	1799	0	1813
9557	5	1	2	1845	0	1853
9558	1802	1	6	26	0	1835
9559	17	1754	2	14	0	1787
9560	8	17	1	1833	0	1859
9561	2	1801	3	26	0	1832
9562	1926	21	0	10	0	1957
9563	25	6	1	1957	0	1989
9564	8	6	0	2280	0	2294
9565	6	2469	0	37	0	2512
9566	6	29	0	2586	0	2621
9567	0	15	1	2628	0	2644
9568	2551	3	2	57	0	2613
9569	40	2495	3	29	0	2567
9570	14	2555	0	14	0	2583
9571	10	45	0	2530	0	2585
9572	6	19	2457	38	0	2520
9573	4	10	2445	19	0	2478
9574	3	10	43	2431	0	2487
9575	14	4	2412	47	0	2477
9576	7	5	35	2422	0	2469
9577	9	9	16	2313	0	2347
9578	7	7	4	2480	0	2498
9579	2421	4	4	61	0	2490
9580	36	4	5	2430	0	2475
9581	20	3	3	2426	0	2452
9582	7	2387	4	63	0	2461
9583	9	39	7	2468	0	2523
9584	3	18	2421	51	0	2493
9585	4	8	36	2463	0	2511
9586	6	4	15	2501	0	2526
9587	2424	2	9	60	0	2495
9588	39	6	9	2436	0	2490
9589	19	5	5	2402	0	2431
9590	12	5	4	2426	0	2447
9591	2297	8	3	72	0	2380
9592	36	2299	4	35	0	2374
9593	18	36	2	2335	0	2391
9594	12	15	6	2344	0	2377
9595	9	8	2292	59	0	2368
9596	6	5	34	2314	0	2359
9597	2202	6	14	60	0	2282
9598	35	2221	9	37	0	2302
9599	18	37	6	2242	0	2303
9600	12	20	3	2263	0	2298
9601	7	11	2202	67	0	2287
9602	2102	6	34	35	0	2177
9603	34	2153	12	30	0	2229
9604	2158	33	7	26	0	2224
9605	41	19	3	2177	0	2240
9606	21	10	5	2207	0	2243
9607	13	13	5	2217	0	2248
9608	7	6	5	2235	0	2253
9609	2161	5	8	69	0	2243
9610	41	6	6	2137	0	2190
9611	13	2115	6	55	0	2189
9612	17	36	4	2149	0	2206
9613	12	18	6	2195	0	2231
9614	2138	6	9	70	0	2223
9615	38	2113	8	37	0	2196
9616	15	37	5	2177	0	2234
9617	2148	14	3	56	0	2221
9618	2186	10	6	39	0	2241
9619	49	7	2	2185	0	2243
9620	22	8	2149	57	0	2236
9621	2152	6	28	40	0	2226
9622	46	5	10	2211	0	2272
9623	15	8	2248	63	0	2334
9624	12	9	34	2313	0	2368
9625	18	6	11	2316	0	2351
9626	15	10	10	2384	0	2419
9627	18	2421	5	67	0	2511
9628	10	38	3	2499	0	2550
9629	14	18	6	2507	0	2545
9630	10	8	5	2514	0	2537
9631	17	6	8	2484	0	2515
9632	19	7	3	2474	0	2503
9633	11	8	11	2452	0	2482
9634	2302	11	4	65	0	2382
9635	33	6	2263	44	0	2346
9636	16	2249	34	30	0	2329
9637	2284	31	13	29	0	2357
9638	31	2279	10	30	0	2350
9639	2270	32	6	28	0	2336
9640	44	18	3	2262	0	2327
9641	2301	8	4	66	0	2379
9642	42	4	6	2342	0	2394
9643	23	3	6	2292	0	2324
9644	15	2308	3	58	0	2384
9645	2325	35	6	34	0	2400
9646	36	22	2395	26	0	2479
9647	21	9	27	2454	0	2511
9648	16	6	2477	48	0	2547
9649	15	7	2357	29	0	2408
9650	2449	6	35	26	0	2516
9651	39	3	14	2528	0	2584
9652	22	10	2497	49	0	2578
9653	11	5	2602	33	0	2651
9654	15	4	38	2634	0	2691
9655	15	8	13	2727	0	2763
9656	2726	7	8	53	0	2794
9657	31	6	12	2774	0	2823
9658	15	6	2924	52	0	2997
9659	16	3	32	2967	0	3018
9660	15	5	16	2976	0	3012
9661	10	3031	13	44	0	3098
9662	2983	25	8	38	0	3054
9663	28	2916	9	25	0	2978
9664	2634	15	4	14	0	2667
9665	16	2372	2	13	0	2403
9666	3	2349	2	5	0	2359
9667	13	10	8	2364	0	2395
9668	3	1	2	2359	0	2365
9669	2	5	5	2340	0	2352
9670	2309	1	1	8	0	2319
9671	2	1	2316	4	0	2323
9672	0	2	2	2300	0	2304
9673	2283	0	0	4	0	2287
9674	1	2259	1	1	0	2262
9675	2	2255	0	3	0	2260
9676	2	9	3	2317	0	2331
9677	1	3	3	2369	0	2376
9678	1	1	0	2409	0	2411
9679	1	2469	0	17	0	2487
9680	1	1	2	2511	0	2515
9681	4	0	2475	5	0	2484
9682	0	4	2318	5	0	2327
9683	2443	1	1	0	0	2445
9684	1	2	0	2553	0	2556
9685	2562	0	0	4	0	2566
9686	2548	0	0	5	0	2553
9687	2	2575	0	3	0	2580
9688	2620	0	0	6	0	2626
9689	2719	0	1	5	0	2725
9690	2	0	0	2735	0	2737
9691	4	0	0	2814	0	2818
9692	4	1	2943	1	0	2949
9693	2	3032	2	2	0	3038
9694	13	3	2	2678	0	2696
9695	1	1	1	3114	0	3117
9696	3126	0	0	14	0	3140
9697	6	0	0	3143	0	3149
9698	3203	0	0	8	0	3211
9699	3	4	0	3269	0	3276
9700	0	3275	0	8	0	3283
9701	3415	5	1	4	0	3425
9702	9	2	2	3685	0	3698
9703	6	1	2	3941	0	3950
9704	2	1	1	4149	0	4153
9705	3	2	4184	35	0	4224
9706	3	0	32	4211	0	4246
9707	4338	0	5	45	0	4388
9708	36	1	4	4506	0	4547
9709	14	0	6	4843	0	4863
9710	8	0	2	4856	0	4866
9711	7	4794	4	59	0	4864
9712	2	4954	0	22	0	4978
9713	4950	61	1	21	0	5033
9714	53	4990	1	13	0	5057
9715	5012	61	2	13	0	5088
9716	5080	15	0	11	0	5106
9717	5088	6	0	18	0	5112
9718	64	10	5072	3	0	5149
9719	19	5219	52	6	0	5296
9720	5388	53	9	10	0	5460
9721	63	13	3	5419	0	5498
9722	18	7	4	5422	0	5451
9723	14	10	1	5442	0	5467
9724	12	5327	4	70	0	5413
9725	8	55	2	5382	0	5447
9726	5400	12	0	67	0	5479
9727	64	3	0	5308	0	5375
9728	20	7	2	5386	0	5415
9729	9	5	5307	78	0	5399
9730	13	6	5346	21	0	5386
9731	11	4	63	5486	0	5564
9732	13	3	18	5532	0	5566
9733	7	5535	11	66	0	5619
9734	12	58	6	5546	0	5622
9735	14	11	1	5654	0	5680
9736	13	6	4	5661	0	5684
9737	5572	11	4	81	0	5668
9738	64	9	5592	29	0	5694
9739	17	6	55	5681	0	5759
9740	5721	5	12	76	0	5814
9741	5697	2	6	31	0	5736
9742	71	6	8	5641	0	5726
9743	29	6	4	5697	0	5736
9744	5608	8	3	78	0	5697
9745	67	5553	4	37	0	5661
9746	14	5615	5	27	0	5661
9747	18	73	3	5659	0	5753
9748	5653	18	8	77	0	5756
9749	5702	15	2	38	0	5757
9750	5663	12	3	30	0	5708
9751	82	11	5680	23	0	5796
9752	5415	9	58	24	0	5506
9753	78	7	5519	27	0	5631
9754	5407	7	65	30	0	5509
9755	77	5473	22	20	0	5592
9756	32	63	5482	15	0	5592
9757	14	29	64	5483	0	5590
9758	28	10	5405	75	0	5518
9759	24	15	61	5403	0	5503
9760	5412	10	18	92	0	5532
9761	65	14	5429	39	0	5547
9762	26	9	70	5436	0	5541
9763	19	5589	22	80	0	5710
9764	21	64	14	5869	0	5968
9765	20	14	15	5867	0	5916
9766	22	9	11	5639	0	5681
9767	5792	12	8	100	0	5912
9768	5835	7	9	45	0	5896
9769	89	9	4	5831	0	5933
9770	25	10	5733	96	0	5864
9771	22	10	5591	43	0	5666
9772	26	8	72	5818	0	5924
9773	24	19	5976	87	0	6106
9774	20	10	77	6010	0	6117
9775	27	6	20	5718	0	5771
9776	23	7	14	6036	0	6080
9777	19	5805	19	92	0	5935
9778	24	5405	14	50	0	5493
9779	19	70	13	5981	0	6083
9780	21	20	11	5981	0	6033
9781	18	24	10	5947	0	5999
9782	5871	15	3	102	0	5991
9783	79	10	5934	41	0	6064
9784	26	8	68	5961	0	6063
9785	5953	6	21	94	0	6074
9786	82	5963	19	34	0	6098
9787	31	66	15	6111	0	6223
9788	23	16	19	6159	0	6217
9789	21	16	13	6062	0	6112
9790	15	13	12	6075	0	6115
9791	14	9	5880	110	0	6013
9792	5511	11	66	54	0	5642
9793	5711	7	21	45	0	5784
9794	79	9	5716	37	0	5841
9795	5631	11	70	38	0	5750
9796	5823	10	23	27	0	5883
9797	86	6	5867	31	0	5990
9798	23	5994	74	39	0	6130
9799	37	76	25	6020	0	6158
9800	28	14	6214	81	0	6337
9801	15	6008	73	44	0	6140
9802	25	53	5863	28	0	5969
9803	19	5673	48	22	0	5762
9804	16	43	26	5527	0	5612
9805	7	11	5554	43	0	5615
9806	14	11	40	5438	0	5503
9807	11	6	5615	41	0	5673
9808	6	5481	34	17	0	5538
9809	5243	20	14	15	0	5292
9810	21	5168	7	6	0	5202
9811	4	5519	1	13	0	5537
9812	26	24	5	5549	0	5604
9813	6	5	2	5671	0	5684
9814	2	2	2	5642	0	5648
9815	7	1	2	5564	0	5574
9816	2	1	0	5699	0	5702
9817	4	3	6006	14	0	6027
9818	7	0	14	5885	0	5906
9819	5	1	4	6075	0	6085
9820	6111	1	3	26	0	6141
9821	6156	0	2	11	0	6169
9822	6220	2	1	14	0	6237
9823	29	0	0	6257	0	6286
9824	6748	1	2	45	0	6796
9825	7217	3	1	14	0	7235
9826	7346	2	2	12	0	7362
9827	56	2	7335	5	0	7398
9828	7208	1	49	20	0	7278
9829	7546	1	4	15	0	7566
9830	7511	1	3	14	0	7529
9831	64	2	3	7539	0	7608
9832	15	8	7622	60	0	7705
9833	14	1	52	7545	0	7612
9834	7767	1	6	77	0	7851
9835	60	1	4	7882	0	7947
9836	8	8163	3	61	0	8235
9837	9	50	1	8416	0	8476
9838	8406	5	2	71	0	8484
9839	8504	3	4	22	0	8533
9840	8452	0	0	20	0	8472
9841	76	4	8662	1	0	8743
9842	31	4	59	8571	0	8665
9843	21	4	9	8900	0	8934
9844	13	5	8876	68	0	8962
9845	9	8643	58	21	0	8731
9846	9	60	8745	15	0	8829
9847	15	7	65	8846	0	8933
9848	8849	8	12	80	0	8949
9849	71	7	9009	19	0	9106
9850	21	9	57	9040	0	9127
9851	16	4	9048	68	0	9136
9852	8967	3	72	31	0	9073
9853	84	2	14	9163	0	9263
9854	23	9	9448	72	0	9552
9855	28	7	71	9415	0	9521
9856	13	9	9571	85	0	9678
9857	10	9617	78	28	0	9733
9858	15	64	18	9656	0	9753
9859	9745	14	11	82	0	9852
9860	81	9	11	9720	0	9821
9861	35	2	10	9642	0	9689
9862	9602	2	7	106	0	9717
9863	78	9119	13	30	0	9240
9864	21	9300	3	26	0	9350
9865	27	80	7	9329	0	9443
9866	14	9361	12	70	0	9457
9867	12	69	5	9432	0	9518
9868	14	11	9	9481	0	9515
9869	9457	9	4	102	0	9572
9870	77	9372	10	31	0	9490
9871	25	69	9347	20	0	9461
9872	16	9586	62	23	0	9687
9873	9481	73	20	27	0	9601
9874	9738	14	10	31	0	9793
9875	93	11	13	9657	0	9774
9876	9791	4	13	95	0	9903
9877	95	12	8	9786	0	9901
9878	9762	9	11	96	0	9878
9879	9929	10	4	42	0	9985
9880	103	8	11	10197	0	10319
9881	10309	6	13	114	0	10442
9882	101	6	10319	41	0	10467
9883	10231	6	81	35	0	10353
9884	111	9	17	10380	0	10517
9885	10463	7	19	101	0	10590
9886	109	10458	9	105	0	10681
9887	48	72	8	10576	0	10704
9888	40	16	19	10617	0	10692
9889	10578	13	10	122	0	10723
9890	122	14	10569	46	0	10751
9891	42	10462	74	41	0	10619
9892	39	83	20	10613	0	10755
9893	29	10565	17	96	0	10707
9894	36	85	9	10727	0	10857
9895	37	18	11	10576	0	10642
9896	35	17	9	10737	0	10798
9897	10611	12	14	128	0	10765
9898	94	17	8	10414	0	10533
9899	10445	11	14	132	0	10602
9900	10400	14	14	49	0	10477
9901	119	12	10	10391	0	10532
9902	10315	8	17	120	0	10460
9903	10293	8	14	57	0	10372
9904	112	16	10265	36	0	10429
9905	53	12	86	10092	0	10243
9906	10225	11	20	117	0	10373
9907	97	10177	21	38	0	10333
9908	10255	78	13	51	0	10397
9909	10264	20	12	47	0	10343
9910	117	15	10116	32	0	10280
9911	56	7	84	9780	0	9927
9912	10424	10	29	128	0	10591
9913	115	15	16	10650	0	10796
9914	52	9	8	11098	0	11167
9915	51	2	10	11229	0	11292
9916	27	11	14	11704	0	11756
9917	11632	8	13	191	0	11844
9918	152	17	12023	67	0	12259
9919	79	23	128	12337	0	12567
9920	47	19	13112	157	0	13335
9921	20	9	13443	80	0	13552
9922	13507	7	300	79	0	13893
9923	255	14	14242	33	0	14544
9924	139	13729	262	24	0	14154
9925	13766	221	195	34	0	14216
9926	13964	125	59	35	0	14183
9927	367	41	29	13742	0	14179
9928	196	16	13858	217	0	14287
9929	74	12	13778	150	0	14014
9930	14175	11	346	71	0	14603
9931	260	18	165	14495	0	14938
9932	14601	8	50	263	0	14922
9933	283	14859	34	163	0	15339
9934	14999	226	29	88	0	15342
9935	14982	149	30	47	0	15208
9936	397	14772	31	35	0	15235
9937	230	258	14	14803	0	15305
9938	14806	152	19	274	0	15251
9939	282	59	14770	158	0	15269
9940	186	14856	251	74	0	15367
9941	113	252	156	14820	0	15341
9942	14906	155	60	278	0	15399
9943	278	14988	38	175	0	15479
9944	15325	268	37	94	0	15724
9945	340	170	15123	34	0	15667
9946	15104	69	279	55	0	15507
9947	342	35	15360	36	0	15773
9948	15279	25	303	58	0	15665
9949	15097	27	183	52	0	15359
9950	444	37	14917	40	0	15438
9951	248	15044	271	41	0	15604
9952	129	251	180	14700	0	15260
9953	79	173	15140	271	0	15663
9954	69	14952	277	188	0	15486
9955	107	262	180	14705	0	15254
9956	89	178	85	15135	0	15487
9957	68	77	14856	422	0	15423
9958	97	47	287	14701	0	15132
9959	86	42	213	14969	0	15310
9960	66	52	14814	449	0	15381
9961	106	53	305	14471	0	14935
9962	67	14709	228	343	0	15347
9963	14863	272	124	222	0	15481
9964	328	192	102	14693	0	15315
9965	244	15000	86	300	0	15630
9966	148	297	89	14370	0	14904
9967	117	15342	110	303	0	15872
9968	135	331	15142	185	0	15793
9969	117	15400	326	100	0	15943
9970	15232	343	215	102	0	15892
9971	15376	205	127	97	0	15805
9972	15673	124	94	95	0	15986
9973	550	67	15542	101	0	16260
9974	313	81	15291	85	0	15770
9975	178	15762	498	78	0	16516
9976	190	343	267	15172	0	15972
9977	154	16130	133	321	0	16738
9978	222	380	100	14669	0	15371
9979	129	16150	87	328	0	16694
9980	16131	393	79	228	0	16831
9981	17151	238	93	143	0	17625
9982	583	153	93	17536	0	18365
9983	332	114	17377	425	0	18248
9984	17234	99	398	295	0	18026
9985	488	17625	263	174	0	18550
9986	340	417	144	17399	0	18300
9987	261	253	111	17277	0	17902
9988	192	17755	121	534	0	18602
9989	17839	429	118	328	0	18714
9990	477	297	17656	152	0	18582
9991	361	168	426	17646	0	18601
9992	17763	139	255	433	0	18590
9993	17766	108	200	307	0	18381
9994	656	17697	119	176	0	18648
9995	412	430	121	17352	0	18315
9996	234	17950	145	423	0	18752
9997	18292	460	107	338	0	19197
9998	463	302	18220	212	0	19197
9999	336	194	18267	148	0	18945
10000	227	153	587	18051	0	19018
10001	175	143	318	17972	0	18608
10002	167	18158	171	605	0	19101
10003	177	441	153	18295	0	19066
10004	150	295	18069	545	0	19059
10005	17918	184	438	372	0	18912
10006	439	151	304	18232	0	19126
10007	292	147	18030	523	0	18992
10008	220	159	422	18116	0	18917
10009	181	135	283	17888	0	18487
10010	128	18078	169	648	0	19023
10011	161	439	129	18048	0	18777
10012	169	286	125	17711	0	18291
10013	165	202	127	17670	0	18164
10014	16580	111	124	680	0	17495
10015	410	16186	111	386	0	17093
10016	277	16128	109	230	0	16744
10017	15589	470	83	170	0	16312
10018	15018	257	75	160	0	15510
10019	485	14287	98	149	0	15019
10020	215	13691	80	103	0	14089
10021	12592	267	47	85	0	12991
10022	230	12406	40	78	0	12754
10023	109	12403	31	80	0	12623
10024	12140	252	117	86	0	12595
10025	208	12192	40	80	0	12520
10026	12091	255	42	76	0	12464
10027	11967	116	33	86	0	12202
10028	12047	91	28	82	0	12248
10029	284	11896	46	50	0	12276
10030	154	11860	23	61	0	12098
10031	118	228	19	11422	0	11787
10032	91	11547	31	185	0	11854
10033	88	245	32	11719	0	12084
10034	11785	111	34	217	0	12147
10035	219	102	25	11535	0	11881
10036	93	11399	37	227	0	11756
10037	11291	195	23	125	0	11634
10038	220	11108	27	130	0	11485
10039	107	11439	24	79	0	11649
10040	111	306	26	10930	0	11373
10041	70	11183	30	180	0	11463
10042	11103	221	31	96	0	11451
10043	199	107	10926	71	0	11303
10044	87	10748	167	81	0	11083
10045	99	192	66	10772	0	11129
10046	72	90	10771	208	0	11141
10047	66	105	159	10679	0	11009
10048	64	84	68	10801	0	11017
10049	62	69	64	10882	0	11077
10050	67	64	47	10791	0	10969
10051	65	74	10538	278	0	10955
10052	58	10504	166	157	0	10885
10053	10409	174	77	130	0	10790
10054	165	95	10283	115	0	10658
10055	10178	101	165	96	0	10540
10056	214	80	10363	87	0	10744
10057	97	65	199	10383	0	10744
10058	100	65	10345	201	0	10711
10059	83	50	10559	130	0	10822
10060	73	71	222	10473	0	10839
10061	76	63	126	10031	0	10296
10062	79	68	86	10715	0	10948
10063	86	65	57	10647	0	10855
10064	10530	74	43	294	0	10941
10065	182	59	10515	166	0	10922
10066	10517	64	152	149	0	10882
10067	10557	62	72	113	0	10804
10068	10522	72	54	95	0	10743
10069	10480	69	46	81	0	10676
10070	10520	68	48	80	0	10716
10071	311	61	26	10289	0	10687
10072	169	62	9772	207	0	10210
10073	122	68	9528	100	0	9818
10074	100	9736	160	106	0	10102
10075	9326	170	106	85	0	9687
10076	166	113	60	9206	0	9545
10077	119	132	40	8995	0	9286
10078	84	9008	28	185	0	9305
10079	88	8921	27	109	0	9145
10080	97	8725	32	79	0	8933
10081	7658	184	59	72	0	7973
10082	99	116	18	6878	0	7111
10083	32	6742	14	83	0	6871
10084	33	70	14	6754	0	6871
10085	20	23	6831	78	0	6952
10086	26	19	7101	37	0	7183
10087	33	25	75	7569	0	7702
10088	7850	11	29	99	0	7989
10089	8222	16	22	44	0	8304
10090	8230	20	10	40	0	8300
10091	132	18	8268	30	0	8448
10092	65	18	110	8189	0	8382
10093	52	21	27	8445	0	8545
10094	32	22	8264	135	0	8453
10095	7880	18	90	73	0	8061
10096	124	17	8317	41	0	8499
10097	42	17	8048	20	0	8127
10098	25	17	8110	21	0	8173
10099	38	24	116	7945	0	8123
10100	29	13	44	8107	0	8193
10101	20	10	8263	123	0	8416
10102	19	18	104	8265	0	8406
10103	8420	13	36	138	0	8607
10104	115	11	35	8580	0	8741
10105	38	9	8758	125	0	8930
10106	36	9	9123	56	0	9224
10107	33	17	117	9098	0	9265
10108	9437	11	46	128	0	9622
10109	116	9892	40	63	0	10111
10110	10218	127	29	53	0	10427
10111	10385	48	26	58	0	10517
10112	200	20	10499	38	0	10757
10113	105	12	147	10494	0	10758
10114	10630	11	75	160	0	10876
10115	10575	6	45	97	0	10723
10116	178	10646	40	49	0	10913
10117	100	131	36	10667	0	10934
10118	63	55	23	10917	0	11058
10119	39	24	10732	201	0	10996
10120	38	13	156	10669	0	10876
10121	43	16	10723	173	0	10955
10122	41	9	10610	88	0	10748
10123	34	12	187	10522	0	10755
10124	10473	4	80	184	0	10741
10125	149	10248	48	97	0	10542
10126	10230	130	34	73	0	10467
10127	10269	55	28	58	0	10410
10128	202	10222	46	39	0	10509
10129	110	133	32	9889	0	10164
10130	9833	59	22	143	0	10057
10131	160	9846	28	77	0	10111
10132	9723	133	24	51	0	9931
10133	169	9538	18	33	0	9758
10134	99	120	20	9342	0	9581
10135	50	66	22	9531	0	9669
10136	9401	26	20	179	0	9626
10137	9282	20	20	96	0	9418
10138	157	9436	23	53	0	9669
10139	85	107	9227	47	0	9466
10140	51	51	9098	36	0	9236
10141	42	35	162	8985	0	9224
10142	27	9290	68	133	0	9518
10143	41	112	45	9456	0	9654
10144	37	53	39	9427	0	9556
10145	37	31	30	9483	0	9581
10146	44	18	9362	178	0	9602
10147	32	35	9145	85	0	9297
10148	39	9484	158	59	0	9740
10149	47	122	73	9485	0	9727
10150	50	65	36	9818	0	9969
10151	39	40	9618	176	0	9873
10152	9173	23	120	94	0	9410
10153	139	28	67	9747	0	9981
10154	76	25	9735	147	0	9983
10155	9458	30	126	111	0	9725
10156	137	9779	73	69	0	10058
10157	77	128	10063	61	0	10329
10158	65	67	147	10071	0	10350
10159	9999	32	69	176	0	10276
10160	154	32	10198	95	0	10479
10161	82	20	159	10178	0	10439
10162	70	23	86	10279	0	10458
10163	50	30	45	11027	0	11152
10164	11097	30	36	241	0	11404
10165	168	10869	43	132	0	11212
10166	96	148	35	11015	0	11294
10167	51	71	11166	182	0	11470
10168	54	44	141	10978	0	11217
10169	35	10845	82	187	0	11149
10170	38	11394	48	107	0	11587
10171	11308	178	41	78	0	11605
10172	11378	89	36	70	0	11573
10173	199	46	11260	69	0	11574
10174	11053	30	157	64	0	11304
10175	181	11202	72	66	0	11521
10176	11362	151	53	53	0	11619
10177	203	84	39	11286	0	11612
10178	109	45	11529	175	0	11858
10179	82	35	153	11503	0	11773
10180	51	35	11582	191	0	11859
10181	11412	29	169	111	0	11721
10182	172	37	85	11671	0	11965
10183	91	11937	43	192	0	12263
10184	75	171	35	12080	0	12361
10185	51	85	11937	205	0	12278
10186	43	11563	164	132	0	11902
10187	11063	156	89	91	0	11399
10188	143	10768	42	65	0	11018
10189	73	10628	43	45	0	10789
10190	71	183	24	10344	0	10622
10191	34	10557	26	130	0	10747
10192	53	139	34	10656	0	10882
10193	39	77	10505	145	0	10766
10194	10014	40	113	95	0	10262
10195	10367	29	68	57	0	10521
10196	181	38	10321	33	0	10573
10197	9996	31	112	44	0	10183
10198	131	10121	73	41	0	10366
10199	10229	120	33	49	0	10431
10200	153	68	24	10130	0	10375
10201	72	38	10155	125	0	10390
10202	40	10301	123	83	0	10547
10203	56	130	72	10225	0	10483
10204	27	67	30	10250	0	10374
10205	9869	33	18	173	0	10093
10206	9442	20	17	98	0	9577
10207	149	9294	19	40	0	9502
10208	55	8848	18	21	0	8942
10209	24	8591	8	13	0	8636
10210	58	105	32	8322	0	8517
10211	8250	25	47	82	0	8404
10212	8141	14	6	33	0	8194
10213	77	13	4	8105	0	8199
10214	40	3	7	8097	0	8147
10215	8048	6	3	89	0	8146
10216	70	6	7	8165	0	8248
10217	22	12	8164	65	0	8263
10218	8087	10	55	39	0	8191
10219	8239	5	13	31	0	8288
10220	78	12	8415	14	0	8519
10221	8476	9	48	25	0	8558
10222	73	10	15	8754	0	8852
10223	33	11	15	8719	0	8778
10224	21	10	7	8804	0	8842
10225	8715	6	9	103	0	8833
10226	65	8914	11	53	0	9043
10227	32	64	5	8967	0	9068
10228	24	8770	11	69	0	8874
10229	8851	70	8	35	0	8964
10230	67	21	6	8928	0	9022
10231	31	18	10	9090	0	9149
10232	31	8982	6	98	0	9117
10233	23	62	8948	29	0	9062
10234	22	23	65	9025	0	9135
10235	9079	12	23	90	0	9204
10236	9713	18	15	39	0	9785
10237	132	12	10063	21	0	10228
10238	59	6	115	10242	0	10422
10239	29	10442	39	119	0	10629
10240	28	126	23	10677	0	10854
10241	10615	42	13	173	0	10843
10242	10588	29	12	74	0	10703
10243	180	16	8	10442	0	10646
10244	68	10314	9	131	0	10522
10245	10969	129	5	66	0	11169
10246	152	38	6	11208	0	11404
10247	11196	31	5	173	0	11405
10248	11631	20	7	84	0	11742
10249	191	19	14	11620	0	11844
10250	100	16	4	11603	0	11723
10251	50	14	12	11838	0	11914
10252	33	11745	9	201	0	11988
10253	45	144	4	11904	0	12097
10254	40	46	10	11907	0	12003
10255	33	30	11493	199	0	11755
10256	37	20	11122	87	0	11266
10257	41	21	155	11241	0	11458
10258	11166	16	68	178	0	11428
10259	145	11174	35	77	0	11431
10260	10900	134	17	79	0	11130
10261	167	47	10925	40	0	11179
10262	74	33	10437	43	0	10587
10263	43	10530	150	42	0	10765
10264	61	138	89	10438	0	10726
10265	23	40	10443	138	0	10644
10266	19	33	10544	68	0	10664
10267	26	31	151	10510	0	10718
10268	10508	10	53	154	0	10725
10269	10528	7	36	70	0	10641
10270	163	14	22	10427	0	10626
10271	74	13	10923	134	0	11144
10272	56	9	121	11057	0	11243
10273	37	18	54	10938	0	11047
10274	26	11075	30	150	0	11281
10275	11049	117	25	79	0	11270
10276	11051	38	33	56	0	11178
10277	150	11142	22	50	0	11364
10278	74	126	18	10715	0	10933
10279	40	10895	20	143	0	11098
10280	10887	128	16	75	0	11106
10281	149	53	10736	46	0	10984
10282	72	32	10180	33	0	10317
10283	50	18	10288	36	0	10392
10284	54	19	159	10296	0	10528
10285	26	20	60	10364	0	10470
10286	10310	13	32	166	0	10521
10287	125	14	22	10293	0	10454
10288	68	18	18	10491	0	10595
10289	43	25	10868	164	0	11100
10290	31	18	10459	83	0	10591
10291	10542	20	151	66	0	10779
10292	118	10747	69	50	0	10984
10293	10925	113	41	52	0	11131
10294	153	45	27	10899	0	11124
10295	61	29	34	10820	0	10944
10296	43	10771	23	161	0	10998
10297	41	115	35	10862	0	11053
10298	10745	40	24	183	0	10992
10299	137	30	16	10808	0	10991
10300	61	31	10802	158	0	11052
10301	46	10554	113	88	0	10801
10302	10431	118	55	75	0	10679
10303	10567	44	36	55	0	10702
10304	10622	36	20	57	0	10735
10305	10667	30	17	56	0	10770
10306	193	25	19	10569	0	10806
10307	96	19	21	10685	0	10821
10308	63	21	10579	183	0	10846
10309	54	24	103	10664	0	10845
10310	49	28	10569	174	0	10820
10311	43	17	126	10602	0	10788
10312	10565	24	56	194	0	10839
10313	129	10817	42	95	0	11083
10314	76	115	32	11015	0	11238
10315	61	54	23	11206	0	11344
10316	11001	27	38	202	0	11268
10317	10786	26	27	117	0	10956
10318	187	25	10698	67	0	10977
10319	84	10763	129	73	0	11049
10320	63	114	56	10703	0	10936
10321	49	63	49	10702	0	10863
10322	10501	34	42	208	0	10785
10323	10487	24	45	112	0	10668
10324	175	27	10548	63	0	10813
10325	86	30	10438	69	0	10623
10326	69	19	173	10279	0	10540
10327	54	22	75	10531	0	10682
10328	60	18	10441	184	0	10703
10329	10150	19	138	101	0	10408
10330	157	20	63	10459	0	10699
10331	10279	17	48	174	0	10518
10332	147	10262	39	98	0	10546
10333	10700	123	31	87	0	10941
10334	189	53	11498	53	0	11793
10335	90	11365	139	56	0	11650
10336	39	11130	59	63	0	11291
10337	10605	123	150	67	0	10945
10338	10456	42	22	37	0	10557
10339	134	19	10	10340	0	10503
10340	57	10233	18	90	0	10398
10341	26	10648	21	48	0	10743
10342	41	109	6	10796	0	10952
10343	10875	50	7	121	0	11053
10344	11101	20	11	74	0	11206
10345	143	22	10313	25	0	10503
10346	10227	6	76	32	0	10341
10347	109	10975	36	10	0	11130
10348	11274	121	13	26	0	11434
10349	163	13051	12	28	0	13254
10350	54	14187	6	13	0	14260
10351	84	327	26	15238	0	15675
10352	16397	133	26	329	0	16885
10353	16786	77	4	169	0	17036
10354	498	41	16423	82	0	17044
10355	261	34	293	16552	0	17140
10356	16713	15	133	382	0	17243
10357	444	13	82	16838	0	17377
10358	16907	10	53	425	0	17395
10359	17049	24	53	220	0	17346
10360	511	19	16772	146	0	17448
10361	325	17	314	16624	0	17280
10362	204	20	134	16976	0	17334
10363	157	23	87	17106	0	17373
10364	98	26	16468	541	0	17133
10365	92	18	336	16608	0	17054
10366	86	21	152	16166	0	16425
10367	49	16178	106	528	0	16861
10368	43	320	15981	277	0	16621
10369	41	16302	348	194	0	16885
10370	16280	385	137	163	0	16965
10371	385	175	92	15697	0	16349
10372	214	133	64	15359	0	15770
10373	128	15673	74	449	0	16324
10374	15653	368	38	256	0	16315
10375	15870	160	27	202	0	16259
10376	491	15336	30	152	0	16009
10377	279	15829	26	105	0	16239
10378	15735	474	38	87	0	16334
10379	446	251	15466	68	0	16231
10380	240	155	15406	76	0	15877
10381	15101	116	438	107	0	15762
10382	392	15491	230	76	0	16189
10383	15617	343	154	75	0	16189
10384	452	182	15273	79	0	15986
10385	15510	118	343	99	0	16070
10386	467	15943	162	85	0	16657
10387	291	390	112	15996	0	16789
10388	245	178	75	16139	0	16637
10389	199	129	91	15225	0	15644
10390	170	92	47	15788	0	16097
10391	131	85	56	15329	0	15601
10392	102	15337	47	664	0	16150
10393	15375	340	50	381	0	16146
10394	388	188	15261	272	0	16109
10395	243	137	323	15439	0	16142
10396	193	105	15445	435	0	16178
10397	143	102	431	15485	0	16161
10398	149	64	222	15784	0	16219
10399	15403	66	187	589	0	16245
10400	389	71	15207	366	0	16033
10401	219	15160	387	257	0	16023
10402	189	341	188	15311	0	16029
10403	164	192	145	15652	0	16153
10404	142	162	15349	529	0	16182
10405	130	118	381	15466	0	16095
10406	126	119	180	15804	0	16229
10407	15126	76	137	639	0	15978
10408	362	15249	103	403	0	16117
10409	15344	355	88	293	0	16080
10410	15547	212	58	233	0	16050
10411	589	163	58	15280	0	16090
10412	371	122	15013	406	0	15912
10413	244	125	15008	243	0	15620
10414	221	93	496	14831	0	15641
10415	177	89	256	14576	0	15098
10416	113	14769	193	574	0	15649
10417	14720	355	164	328	0	15567
10418	401	14520	142	257	0	15320
10419	223	14998	98	227	0	15546
10420	14834	509	70	204	0	15617
10421	460	314	75	14610	0	15459
10422	297	15072	74	445	0	15888
10423	201	446	70	15178	0	15895
10424	152	231	14816	547	0	15746
10425	145	163	14836	343	0	15487
10426	121	128	462	15026	0	15737
10427	99	119	15003	507	0	15728
10428	130	75	455	14991	0	15651
10429	118	94	280	14983	0	15475
10430	96	79	217	15310	0	15702
10431	14541	67	156	694	0	15458
10432	350	14112	137	430	0	15029
10433	197	14318	96	336	0	14947
10434	13282	427	82	260	0	14051
10435	13458	242	56	213	0	13969
10436	509	208	49	13059	0	13825
10437	267	159	12954	370	0	13750
10438	220	132	316	13061	0	13729
10439	182	97	12976	447	0	13702
10440	139	12924	372	297	0	13732
10441	111	305	200	12961	0	13577
10442	12713	161	162	434	0	13470
10443	350	146	110	12814	0	13420
10444	224	107	12252	411	0	12994
10445	12063	122	311	271	0	12767
10446	391	81	12252	219	0	12943
10447	306	66	11625	154	0	12151
10448	164	10967	352	175	0	11658
10449	94	8873	166	77	0	9210
10450	103	8195	151	68	0	8517
10451	6273	217	302	188	0	6980
10452	5629	13	35	37	0	5714
10453	21	6	5	5707	0	5739
10454	10	6	3	5725	0	5744
10455	10	5	1	5795	0	5811
10456	7	5782	2	24	0	5815
10457	5794	15	3	15	0	5827
10458	15	5800	2	12	0	5829
10459	9	13	3	5839	0	5864
10460	5731	6	6	23	0	5766
10461	18	8	5	5754	0	5785
10462	10	4	1	5846	0	5861
10463	5839	6	2	31	0	5878
10464	5762	2	3	19	0	5786
10465	22	4	5742	6	0	5774
10466	14	6	5669	6	0	5695
10467	9	4	5873	5	0	5891
10468	7	7	23	5895	0	5932
10469	4	8	8	5978	0	5998
10470	5	5971	6	34	0	6016
10471	6185	20	4	15	0	6224
10472	25	6	5	6276	0	6312
10473	10	5	3	6408	0	6426
10474	5	6421	5	40	0	6471
10475	4	6763	3	19	0	6789
10476	9	33	2	6949	0	6993
10477	9	13	3	7681	0	7706
10478	7707	10	1	82	0	7800
10479	7707	6	5	35	0	7753
10480	83	7	2	7710	0	7802
10481	32	3	7726	72	0	7833
10482	20	5	7508	26	0	7559
10483	20	6	72	7664	0	7762
10484	22	5	30	7490	0	7547
10485	9	7469	19	88	0	7585
10486	7191	64	15	37	0	7307
10487	65	19	9	7208	0	7301
10488	21	17	7176	76	0	7290
10489	25	9	60	7290	0	7384
10490	13	9	7213	83	0	7318
10491	23	4	7309	26	0	7362
10492	13	28	78	7374	0	7493
10493	7341	3	38	98	0	7480
10494	67	12	7321	28	0	7428
10495	21	10	71	7294	0	7396
10496	17	11	7621	85	0	7734
10497	13	9	76	7625	0	7723
10498	29	5	22	7674	0	7730
10499	15	3	7621	97	0	7736
10500	11	3	7426	48	0	7488
10501	27	4	101	7126	0	7258
10502	10	1	37	7597	0	7645
10503	11	5	37	7632	0	7685
10504	8	3	19	7552	0	7582
10505	7469	7	14	126	0	7616
10506	7496	8	16	60	0	7580
10507	83	7481	14	43	0	7621
10508	7528	65	14	50	0	7657
10509	93	15	18	7588	0	7714
10510	7635	13	19	101	0	7768
10511	89	6	7694	36	0	7825
10512	7777	6	81	48	0	7912
10513	95	9	22	7946	0	8072
10514	43	5	27	8194	0	8269
10515	8167	3	18	122	0	8310
10516	104	3	21	8673	0	8801
10517	34	10	8926	134	0	9104
10518	8901	3	111	79	0	9094
10519	117	9175	47	47	0	9386
10520	54	109	31	9397	0	9591
10521	32	27	10040	141	0	10240
10522	30	19	130	9981	0	10160
10523	20	14	10055	170	0	10259
10524	30	10	145	10082	0	10267
10525	20	10162	44	175	0	10401
10526	34	119	36	10258	0	10447
10527	24	10664	25	171	0	10884
10528	46	161	25	10261	0	10493
10529	31	50	18	11161	0	11260
10530	46	31	19	11250	0	11346
10531	49	13	19	11262	0	11343
10532	31	14	27	11323	0	11395
10533	28	6	11045	266	0	11345
10534	36	13	174	11154	0	11377
10535	30	13	60	11337	0	11440
10536	11292	8	55	259	0	11614
10537	174	11327	30	134	0	11665
10538	11441	186	29	92	0	11748
10539	219	57	22	11473	0	11771
10540	63	48	11418	240	0	11769
10541	45	11438	203	112	0	11798
10542	11379	194	68	105	0	11746
10543	198	11321	49	76	0	11644
10544	51	11696	34	68	0	11849
10545	11561	231	37	69	0	11898
10546	219	86	23	12162	0	12490
10547	12164	51	20	274	0	12509
10548	264	24	20	11983	0	12291
10549	77	27	12014	295	0	12413
10550	60	23	11932	138	0	12153
10551	11732	23	271	113	0	12139
10552	12095	17	97	90	0	12299
10553	289	23	64	11752	0	12128
10554	124	18	29	11908	0	12079
10555	11493	28	31	316	0	11868
10556	242	11369	26	148	0	11785
10557	92	11698	23	101	0	11914
10558	11571	257	29	84	0	11941
10559	11669	92	31	77	0	11869
10560	291	11576	25	64	0	11956
10561	142	250	25	11551	0	11968
10562	95	89	11439	249	0	11872
10563	68	70	11487	102	0	11727
10564	11307	41	272	93	0	11713
10565	268	28	11458	71	0	11825
10566	122	25	251	11163	0	11561
10567	90	32	87	11078	0	11287
10568	61	11134	67	281	0	11543
10569	11134	231	49	126	0	11540
10570	279	76	33	11077	0	11465
10571	113	59	10775	261	0	11208
10572	89	10774	206	128	0	11197
10573	74	256	74	10665	0	11069
10574	51	92	10553	238	0	10934
10575	62	67	10279	101	0	10509
10576	52	10046	252	88	0	10438
10577	9241	184	103	52	0	9580
10578	189	9329	51	58	0	9627
10579	9281	200	42	54	0	9577
10580	208	73	9198	45	0	9524
10581	9024	42	192	53	0	9311
10582	208	9197	76	46	0	9527
10583	102	183	57	9227	0	9569
10584	63	78	33	9504	0	9678
10585	9360	50	43	253	0	9706
10586	190	43	9305	109	0	9647
10587	9308	43	192	79	0	9622
10588	9441	35	66	66	0	9608
10589	243	35	9102	53	0	9433
10590	94	38	9270	64	0	9466
10591	82	39	230	9074	0	9425
10592	9157	37	100	213	0	9507
10593	9253	43	66	98	0	9460
10594	247	9272	52	70	0	9641
10595	103	180	51	9383	0	9717
10596	97	87	32	9224	0	9440
10597	75	49	35	9356	0	9515
10598	61	38	36	9513	0	9648
10599	9343	28	38	285	0	9694
10600	224	43	37	9450	0	9754
10601	89	47	9328	246	0	9710
10602	84	42	9238	100	0	9464
10603	9175	31	231	93	0	9530
10604	230	9160	106	64	0	9560
10605	111	9538	67	44	0	9760
10606	91	234	49	9468	0	9842
10607	78	91	56	9608	0	9833
10608	59	57	52	9603	0	9771
10609	73	38	35	9678	0	9824
10610	53	38	9385	289	0	9765
10611	72	36	184	9267	0	9559
10612	66	29	70	9301	0	9466
10613	47	34	8856	263	0	9200
10614	8410	23	187	139	0	8759
10615	190	8599	76	105	0	8970
10616	8093	155	67	68	0	8383
10617	191	49	7862	58	0	8160
10618	76	43	7693	51	0	7863
10619	54	7610	176	44	0	7884
10620	7114	234	303	78	0	7729
10621	6715	61	67	36	0	6879
10622	6701	33	27	37	0	6798
10623	169	6550	21	44	0	6784
10624	6398	125	25	37	0	6585
10625	158	38	6395	42	0	6633
10626	54	6363	124	38	0	6579
10627	6119	114	52	34	0	6319
10628	130	6141	36	34	0	6341
10629	5914	117	25	33	0	6089
10630	5809	34	21	31	0	5895
10631	135	24	5900	19	0	6078
10632	56	5911	111	15	0	6093
10633	5850	101	34	21	0	6006
10634	112	42	5739	15	0	5908
10635	48	5708	104	16	0	5876
10636	66	96	38	5477	0	5677
10637	28	33	5430	77	0	5568
10638	30	26	5269	36	0	5361
10639	31	42	72	5225	0	5370
10640	5123	17	36	87	0	5263
10641	74	5148	23	37	0	5282
10642	24	64	5071	27	0	5186
10643	31	28	4955	20	0	5034
10644	4733	16	73	18	0	4840
10645	70	4903	32	19	0	5024
10646	4308	34	18	9	0	4369
10647	36	4300	6	5	0	4347
10648	4410	37	14	10	0	4471
10649	4319	7	7	7	0	4340
10650	42	4260	7	3	0	4312
10651	12	39	4	4312	0	4367
10652	4601	10	6	45	0	4662
10653	43	12	8	4721	0	4784
10654	14	8	8	5009	0	5039
10655	4980	3	4	64	0	5051
10656	52	4983	6	13	0	5054
10657	5034	52	6	21	0	5113
10658	60	10	5041	10	0	5121
10659	23	8	52	5071	0	5154
10660	15	7	12	5084	0	5118
10661	5051	8	8	67	0	5134
10662	5093	6	10	16	0	5125
10663	65	8	5	5076	0	5154
10664	22	8	5140	55	0	5225
10665	18	9	50	5116	0	5193
10666	16	9	13	5186	0	5224
10667	17	5	9	5211	0	5242
10668	17	5	7	5224	0	5253
10669	5171	6	5	78	0	5260
10670	65	7	5156	24	0	5252
10671	26	5196	55	15	0	5292
10672	17	57	13	5139	0	5226
10673	23	13	8	5312	0	5356
10674	13	12	5283	74	0	5382
10675	10	13	5232	28	0	5283
10676	21	6	65	5340	0	5432
10677	21	5	22	5400	0	5448
10678	11	7	5277	84	0	5379
10679	21	6	60	5278	0	5365
10680	5313	11	23	68	0	5415
10681	70	5438	10	26	0	5544
10682	18	61	5394	26	0	5499
10683	12	5364	57	24	0	5457
10684	14	63	20	5409	0	5506
10685	13	18	5447	74	0	5552
10686	15	5432	61	30	0	5538
10687	14	61	21	5506	0	5602
10688	9	17	5599	76	0	5701
10689	12	10	73	5551	0	5646
10690	13	12	17	5564	0	5606
10691	5563	8	10	95	0	5676
10692	69	7	12	5549	0	5637
10693	5575	11	11	84	0	5681
10694	5409	6	14	38	0	5467
10695	5389	4	11	27	0	5431
10696	98	6	7	5353	0	5464
10697	23	9	5221	77	0	5330
10698	16	2	5130	30	0	5178
10699	5250	5	77	23	0	5355
10700	74	12	5271	16	0	5373
10701	5167	5	70	28	0	5270
10702	62	5270	28	16	0	5376
10703	5306	57	12	20	0	5395
10704	64	15	5408	16	0	5503
10705	46	8	5608	17	0	5679
10706	14	17	76	5802	0	5909
10707	12	2	5997	81	0	6092
10708	12	4	6184	25	0	6225
10709	17	11	94	6468	0	6590
10710	12	3	21	6717	0	6753
10711	27	5	9	6882	0	6923
10712	9	6840	11	130	0	6990
10713	24	108	11	6751	0	6894
10714	7	7016	15	118	0	7156
10715	7075	106	10	43	0	7234
10716	7226	25	16	35	0	7302
10717	136	7	13	6993	0	7149
10718	31	7015	12	132	0	7190
10719	25	113	7145	33	0	7316
10720	7146	19	124	34	0	7323
10721	128	18	27	7164	0	7337
10722	37	10	15	7258	0	7320
10723	32	11	17	7309	0	7369
10724	7151	12	13	154	0	7330
10725	135	6919	12	46	0	7112
10726	37	7073	26	32	0	7168
10727	6861	130	15	42	0	7048
10728	121	6928	19	28	0	7096
10729	6976	125	11	32	0	7144
10730	7031	31	16	37	0	7115
10731	158	6954	14	30	0	7156
10732	41	119	18	6881	0	7059
10733	32	6990	17	132	0	7171
10734	31	123	9	6988	0	7151
10735	30	39	12	7236	0	7317
10736	7165	21	12	175	0	7373
10737	7367	27	8	62	0	7464
10738	176	18	20	7289	0	7503
10739	60	26	7188	148	0	7422
10740	7074	25	125	60	0	7284
10741	144	7202	33	55	0	7434
10742	54	141	21	7187	0	7403
10743	39	40	21	7321	0	7421
10744	46	34	9	7377	0	7466
10745	7066	27	9	200	0	7302
10746	7116	22	21	71	0	7230
10747	165	6793	15	56	0	7029
10748	63	6908	18	47	0	7036
10749	60	144	14	6852	0	7070
10750	42	57	20	6937	0	7056
10751	37	27	6833	184	0	7081
10752	40	45	121	6567	0	6773
10753	28	14	6458	169	0	6669
10754	30	25	6104	59	0	6218
10755	35	6173	130	43	0	6381
10756	49	120	36	6162	0	6367
10757	6229	42	22	146	0	6439
10758	138	22	17	6210	0	6387
10759	45	32	6165	149	0	6391
10760	6029	23	117	64	0	6233
10761	6158	25	34	46	0	6263
10762	147	30	6106	40	0	6323
10763	51	16	116	6286	0	6469
10764	6179	23	36	146	0	6384
10765	146	6293	21	64	0	6524
10766	6404	126	20	40	0	6590
10767	6611	43	13	44	0	6711
10768	173	26	18	6519	0	6736
10769	55	35	15	6747	0	6852
10770	6677	18	20	172	0	6887
10771	172	18	13	6721	0	6924
10772	49	27	6679	157	0	6912
10773	6548	18	125	58	0	6749
10774	6651	27	30	52	0	6760
10775	156	6475	26	38	0	6695
10776	67	6630	11	45	0	6753
10777	60	163	12	6444	0	6679
10778	34	6614	15	144	0	6807
10779	48	142	16	6661	0	6867
10780	6608	38	18	164	0	6828
10781	6527	17	21	70	0	6635
10782	153	6415	16	59	0	6643
10783	6377	117	21	31	0	6546
10784	143	6392	7	44	0	6586
10785	6344	129	22	40	0	6535
10786	6461	43	11	45	0	6560
10787	161	31	6271	35	0	6498
10788	6169	23	116	44	0	6352
10789	160	6125	31	28	0	6344
10790	51	6334	24	47	0	6456
10791	6288	148	15	33	0	6484
10792	165	31	10	6344	0	6550
10793	59	37	6337	134	0	6567
10794	52	25	112	6377	0	6566
10795	54	24	34	6496	0	6608
10796	46	21	6339	155	0	6561
10797	6124	32	120	51	0	6327
10798	150	6217	35	41	0	6443
10799	6159	121	15	36	0	6331
10800	151	34	28	6005	0	6218
10801	5985	34	10	136	0	6165
10802	153	5947	13	44	0	6157
10803	60	141	16	5943	0	6160
10804	5833	32	17	140	0	6022
10805	135	22	5502	59	0	5718
10806	53	22	5089	28	0	5192
10807	4867	27	118	43	0	5055
10808	114	4773	42	25	0	4954
10809	38	4351	23	17	0	4429
10810	100	99	28	4089	0	4316
10811	24	4084	12	63	0	4183
10812	42	70	24	4090	0	4226
10813	32	30	7	4229	0	4298
10814	37	16	12	4151	0	4216
10815	23	4070	16	82	0	4191
10816	27	49	9	4031	0	4116
10817	28	29	3978	52	0	4087
10818	22	3852	48	29	0	3951
10819	25	57	17	3658	0	3757
10820	24	3733	14	37	0	3808
10821	3711	52	10	28	0	3801
10822	3726	19	4	22	0	3771
10823	3736	16	5	14	0	3771
10824	54	3787	15	19	0	3875
10825	32	42	10	3789	0	3873
10826	22	20	3732	50	0	3824
10827	21	16	3647	22	0	3706
10828	3603	15	54	25	0	3697
10829	3661	12	28	20	0	3721
10830	63	11	15	3831	0	3920
10831	30	19	3	3941	0	3993
10832	25	12	3990	66	0	4093
10833	15	3895	46	33	0	3989
10834	15	3825	20	30	0	3890
10835	16	41	3789	12	0	3858
10836	24	30	48	3673	0	3775
10837	27	15	11	3236	0	3289
10838	13	8	11	3691	0	3723
10839	13	7	7	3699	0	3726
10840	3666	13	7	42	0	3728
10841	45	9	3543	13	0	3610
10842	3550	7	33	16	0	3606
10843	50	7	13	3568	0	3638
10844	3572	11	6	41	0	3630
10845	40	8	7	3579	0	3634
10846	18	9	3597	43	0	3667
10847	11	12	34	3619	0	3676
10848	12	8	3696	40	0	3756
10849	11	10	36	3613	0	3670
10850	5	11	3793	45	0	3854
10851	8	3830	39	14	0	3891
10852	9	30	9	3855	0	3903
10853	12	12	9	3877	0	3910
10854	7	3894	9	40	0	3950
10855	3986	35	3	16	0	4040
10856	43	12	4	3975	0	4034
10857	21	13	4	3955	0	3993
10858	4008	8	4	57	0	4077
10859	4096	3	12	19	0	4130
10860	4203	8	3	19	0	4233
10861	4241	2	7	16	0	4266
10862	57	8	4081	9	0	4155
10863	3981	3	40	14	0	4038
10864	4119	6	11	7	0	4143
10865	55	8	6	3944	0	4013
10866	18	12	5	3912	0	3947
10867	3772	9	2	47	0	3830
10868	41	3724	7	18	0	3790
10869	9	37	5	3660	0	3711
10870	11	8	3749	34	0	3802
10871	12	3670	29	5	0	3716
10872	3646	31	19	16	0	3712
10873	3693	6	1	15	0	3715
10874	3699	2	2	9	0	3712
10875	3759	7	2	6	0	3774
10876	43	5	2	3663	0	3713
10877	11	7	3639	32	0	3689
10878	5	8	3813	8	0	3834
10879	11	5	39	4079	0	4134
10880	4300	3	9	51	0	4363
10881	61	3	6	4338	0	4408
10882	17	4	4356	61	0	4438
10883	4398	0	53	18	0	4469
10884	4442	4	12	11	0	4469
10885	65	2	9	4468	0	4544
10886	19	2	4566	59	0	4646
10887	16	2	4652	9	0	4679
10888	4553	1	59	20	0	4633
10889	59	4598	13	12	0	4682
10890	19	49	4651	6	0	4725
10891	18	5	56	4640	0	4719
10892	4610	4	13	69	0	4696
10893	55	4482	11	14	0	4562
10894	12	4547	10	10	0	4579
10895	4548	58	10	17	0	4633
10896	64	11	8	4544	0	4627
10897	4751	8	9	67	0	4835
10898	81	7	4	4834	0	4926
10899	21	8	7	4884	0	4920
10900	15	5	4820	78	0	4918
10901	10	7	4624	25	0	4666
10902	17	7	4847	13	0	4884
10903	18	4	75	4851	0	4948
10904	4910	2	17	79	0	5008
10905	74	7	4917	18	0	5016
10906	23	4	76	4933	0	5036
10907	19	7	4988	80	0	5094
10908	12	5016	79	20	0	5127
10909	20	77	26	5047	0	5170
10910	22	15	17	5087	0	5141
10911	21	7	7	5129	0	5164
10912	5040	2	14	105	0	5161
10913	83	2	14	5011	0	5110
10914	29	4	15	5050	0	5098
10915	5002	5	11	103	0	5121
10916	82	9	4949	29	0	5069
10917	4933	5	80	23	0	5041
10918	4981	3	21	26	0	5031
10919	96	6	4905	17	0	5024
10920	4858	6	75	24	0	4963
10921	92	6	23	4986	0	5107
10922	25	8	5012	91	0	5136
10923	5005	3	81	31	0	5120
10924	5073	5	24	27	0	5129
10925	103	1	17	5002	0	5123
10926	35	3	13	5060	0	5111
10927	27	4	17	5066	0	5114
10928	4957	1	10	113	0	5081
10929	92	4962	17	35	0	5106
10930	4802	57	9	25	0	4893
10931	79	4548	19	13	0	4659
10932	29	4557	9	22	0	4617
10933	28	65	15	4577	0	4685
10934	13	20	14	4654	0	4701
10935	23	7	16	4622	0	4668
10936	20	9	12	4626	0	4667
10937	20	8	4550	92	0	4670
10938	4493	8	66	40	0	4607
10939	78	7	25	4609	0	4719
10940	28	10	4602	89	0	4729
10941	32	8	63	4617	0	4720
10942	21	8	21	4707	0	4757
10943	19	11	4808	91	0	4929
10944	31	6	69	4814	0	4920
10945	18	10	23	4830	0	4881
10946	4854	8	18	93	0	4973
10947	74	4	4876	44	0	4998
10948	4697	4	67	46	0	4814
10949	77	4906	30	29	0	5042
10950	4806	62	21	35	0	4924
10951	4754	18	19	32	0	4823
10952	93	9	12	4698	0	4812
10953	37	3	4656	85	0	4781
10954	20	4908	70	36	0	5034
10955	26	81	18	4694	0	4819
10956	14	5035	22	74	0	5145
10957	5021	91	13	35	0	5160
10958	93	20	4932	31	0	5076
10959	24	21	4870	28	0	4943
10960	24	7	91	4771	0	4893
10961	18	10	4890	98	0	5016
10962	23	7	94	4938	0	5062
10963	21	10	21	4930	0	4982
10964	5008	7	19	107	0	5141
10965	88	5027	20	42	0	5177
10966	32	80	14	5092	0	5218
10967	28	15	16	5220	0	5279
10968	14	10	18	5157	0	5199
10969	21	4974	16	108	0	5119
10970	16	5122	15	43	0	5196
10971	5022	84	15	29	0	5150
10972	5068	21	15	30	0	5134
10973	5054	11	13	28	0	5106
10974	106	8	4927	32	0	5073
10975	37	23	84	4881	0	5025
10976	20	17	4858	97	0	4992
10977	28	4836	83	30	0	4977
10978	4561	87	27	36	0	4711
10979	79	16	4421	13	0	4529
10980	25	17	56	4194	0	4292
10981	13	5	4272	67	0	4357
10982	4174	1	61	25	0	4261
10983	4285	8	17	25	0	4335
10984	4307	1	11	17	0	4336
10985	4236	5	11	10	0	4262
10986	75	6	4243	14	0	4338
10987	4120	3	55	13	0	4191
10988	4193	6	17	14	0	4230
10989	62	4151	14	16	0	4243
10990	4100	49	8	7	0	4164
10991	4187	13	4	12	0	4216
10992	71	10	6	4054	0	4141
10993	25	4237	5	53	0	4320
10994	4421	51	3	22	0	4497
10995	4728	14	7	16	0	4765
10996	89	11	5111	8	0	5219
10997	25	4	5077	6	0	5112
10998	11	9	5183	8	0	5211
10999	14	15	98	5153	0	5280
11000	5113	8	37	83	0	5241
11001	80	5126	18	30	0	5254
11002	5095	78	9	24	0	5206
11003	87	5095	5	26	0	5213
11004	5052	83	6	10	0	5151
11005	84	4981	8	10	0	5083
11006	31	5063	6	12	0	5112
11007	4913	89	9	13	0	5024
11008	72	5012	6	9	0	5099
11009	33	86	5	4987	0	5111
11010	23	20	5043	71	0	5157
11011	12	13	5045	17	0	5087
11012	18	11	85	5004	0	5118
11013	19	4	32	5096	0	5151
11014	10	14	5055	80	0	5159
11015	16	5	73	4998	0	5092
11016	14	7	18	5100	0	5139
11017	5091	7	22	96	0	5216
11018	74	5091	13	38	0	5216
11019	27	74	10	4940	0	5051
11020	22	5113	9	74	0	5218
11021	5072	84	8	25	0	5189
11022	78	5083	8	20	0	5189
11023	5082	78	13	14	0	5187
11024	5126	19	8	14	0	5167
11025	95	17	6	5042	0	5160
11026	38	14	6	5090	0	5148
11027	28	9	6	5104	0	5147
11028	23	9	5	5129	0	5166
11029	14	14	4957	102	0	5087
11030	4746	15	74	45	0	4880
11031	81	4910	23	25	0	5039
11032	28	82	17	5001	0	5128
11033	29	24	8	5028	0	5089
11034	16	5029	10	91	0	5146
11035	5068	82	12	37	0	5199
11036	91	5097	7	31	0	5226
11037	36	99	9	5126	0	5270
11038	27	24	10	5242	0	5303
11039	23	18	12	5241	0	5294
11040	15	17	8	5232	0	5272
11041	5132	12	9	128	0	5281
11042	92	15	5135	38	0	5280
11043	36	13	91	4979	0	5119
11044	34	14	26	5030	0	5104
11045	22	14	21	5042	0	5099
11046	22	14	12	5005	0	5053
11047	4833	10	14	124	0	4981
11048	105	10	4829	45	0	4989
11049	34	18	72	4627	0	4751
11050	34	4507	24	87	0	4652
11051	15	4723	20	27	0	4785
11052	4676	97	5	30	0	4808
11053	90	37	4636	17	0	4780
11054	4264	24	65	21	0	4374
11055	88	20	4353	14	0	4475
11056	30	7	68	4162	0	4267
11057	4206	8	24	77	0	4315
11058	58	4267	19	33	0	4377
11059	28	60	9	4134	0	4231
11060	24	3979	15	69	0	4087
11061	4200	70	6	35	0	4311
11062	4190	19	8	25	0	4242
11063	81	21	8	4165	0	4275
11064	33	8	4090	74	0	4205
11065	23	10	4068	34	0	4135
11066	20	14	68	4039	0	4141
11067	14	4013	24	64	0	4115
11068	15	62	15	4206	0	4298
11069	16	27	4	4073	0	4120
11070	22	14	5	4078	0	4119
11071	9	11	4104	87	0	4211
11072	16	8	55	4073	0	4152
11073	13	9	16	4128	0	4166
11074	11	4067	18	98	0	4194
11075	8	77	6	4021	0	4112
11076	11	21	7	4227	0	4266
11077	11	13	8	4262	0	4294
11078	13	11	7	4246	0	4277
11079	6	9	7	4209	0	4231
11080	12	11	6	4210	0	4239
11081	11	8	1	4117	0	4137
11082	4	12	6	4032	0	4054
11083	26	9	3368	498	0	3901
11084	11	9	43	3899	0	3962
11085	3857	3	18	85	0	3963
11086	60	4	13	3761	0	3838
11087	22	6	3786	86	0	3900
11088	3720	6	59	40	0	3825
11089	3863	3	19	35	0	3920
11090	3832	5	16	24	0	3877
11091	3853	7	8	23	0	3891
11092	85	3	2	3872	0	3962
11093	31	2	3785	74	0	3892
11094	19	3626	48	34	0	3727
11095	17	3292	23	27	0	3359
11096	42	66	85	2822	0	3015
11097	12	9	16	2990	0	3027
11098	8	3	4	3057	0	3072
11099	1	2	0	3194	0	3197
11100	9	1	1	3629	0	3640
11101	3946	2	3	61	0	4012
11102	51	3973	2	28	0	4054
11103	17	4160	1	13	0	4191
11104	13	90	0	4227	0	4330
11105	10	25	0	4354	0	4389
11106	4	16	1	4375	0	4396
11107	9	6	2	4359	0	4376
11108	4	4	4177	101	0	4286
11109	2	4088	65	43	0	4198
11110	5	65	14	4108	0	4192
11111	4053	19	7	84	0	4163
11112	72	12	9	4086	0	4179
11113	23	9	4106	82	0	4220
11114	9	9	4040	38	0	4096
11115	8	7	4158	27	0	4200
11116	12	17	88	4105	0	4222
11117	4202	5	35	80	0	4322
11118	69	5	14	4238	0	4326
11119	25	4	12	4401	0	4442
11120	4397	3	9	104	0	4513
11121	72	4	7	4510	0	4593
11122	29	3	5	4582	0	4619
11123	13	4	4713	98	0	4828
11124	11	4747	70	35	0	4863
11125	10	64	25	4887	0	4986
11126	4866	21	16	90	0	4993
11127	79	11	14	4909	0	5013
11128	29	8	4937	95	0	5069
11129	18	10	73	4918	0	5019
11130	11	4982	21	96	0	5110
11131	15	69	12	5055	0	5151
11132	10	24	4998	94	0	5126
11133	8	5369	70	56	0	5503
11134	11	93	26	5458	0	5588
11135	11	32	16	5877	0	5936
11136	16	16	10	5966	0	6008
11137	7	14	7	6003	0	6031
11138	10	6	5820	147	0	5983
11139	4	5832	101	65	0	6002
11140	5849	92	35	47	0	6023
11141	5946	34	19	31	0	6030
11142	121	17	15	5889	0	6042
11143	39	13	5840	116	0	6008
11144	5790	9	97	48	0	5944
11145	105	13	32	5931	0	6081
11146	35	10	6079	123	0	6247
11147	24	3	102	6122	0	6251
11148	30	4	35	6158	0	6227
11149	14	7	18	6234	0	6273
11150	14	8	6315	152	0	6489
11151	23	10	97	6106	0	6236
11152	24	6331	35	117	0	6507
11153	6365	92	20	74	0	6551
11154	6399	33	24	45	0	6501
11155	6413	16	13	45	0	6487
11156	133	6343	15	34	0	6525
11157	6376	94	18	29	0	6517
11158	117	40	12	6295	0	6464
11159	6287	13	18	115	0	6433
11160	6336	22	10	72	0	6440
11161	135	11	6202	48	0	6396
11162	55	6166	96	47	0	6364
11163	6184	95	36	37	0	6352
11164	115	45	16	6167	0	6343
11165	52	20	6132	112	0	6316
11166	35	6105	97	49	0	6286
11167	6075	101	42	41	0	6259
11168	121	40	20	6080	0	6261
11169	67	19	21	6146	0	6253
11170	35	20	13	6160	0	6228
11171	42	6041	17	145	0	6245
11172	30	102	11	6072	0	6215
11173	26	6003	18	135	0	6182
11174	19	104	17	6090	0	6230
11175	25	53	6006	129	0	6213
11176	26	19	99	6049	0	6193
11177	22	24	40	6123	0	6209
11178	31	16	26	6175	0	6248
11179	23	20	6015	163	0	6221
11180	23	16	102	6030	0	6171
11181	25	21	43	6145	0	6234
11182	29	18	16	6209	0	6272
11183	25	13	30	6181	0	6249
11184	23	21	17	6237	0	6298
11185	24	17	6058	173	0	6272
11186	23	16	99	6077	0	6215
11187	33	19	42	6065	0	6159
11188	5880	10	26	183	0	6099
11189	97	5774	29	95	0	5995
11190	47	5924	24	78	0	6073
11191	34	117	18	5915	0	6084
11192	44	36	17	5870	0	5967
11193	17	5640	26	161	0	5844
11194	20	111	16	5636	0	5783
11195	25	5592	18	144	0	5779
11196	33	105	9	5550	0	5697
11197	31	49	16	5410	0	5506
11198	17	30	5089	142	0	5278
11199	23	4925	83	78	0	5109
11200	20	4629	24	53	0	4726
11201	4092	87	31	40	0	4250
11202	60	4062	13	33	0	4168
11203	20	58	10	3999	0	4087
11204	23	24	3873	63	0	3983
11205	15	27	43	3833	0	3918
11206	3795	15	14	68	0	3892
11207	49	14	3866	42	0	3971
11208	22	3936	52	30	0	4040
11209	35	56	21	3495	0	3607
11210	18	21	11	4023	0	4073
11211	4035	11	11	85	0	4142
11212	49	18	11	4088	0	4166
11213	22	16	10	4066	0	4114
11214	14	13	12	4068	0	4107
11215	15	14	3	4037	0	4069
11216	3937	10	8	94	0	4049
11217	3900	8	14	52	0	3974
11218	57	17	9	3908	0	3991
11219	3773	5	6	82	0	3866
11220	53	15	11	3677	0	3756
11221	20	10	3539	74	0	3643
11222	15	9	3431	50	0	3505
11223	17	24	56	3164	0	3261
11224	11	3205	15	62	0	3293
11225	13	36	10	3176	0	3235
11226	3113	15	11	64	0	3203
11227	37	11	8	3159	0	3215
11228	3103	15	7	64	0	3189
11229	48	8	5	3133	0	3194
11230	20	10	3142	59	0	3231
11231	8	3068	36	45	0	3157
11232	13	3159	16	25	0	3213
11233	10	64	9	2716	0	2799
11234	15	15	2729	34	0	2793
11235	3	2356	13	8	0	2380
11236	23	9	7	2266	0	2305
11237	2247	5	4	13	0	2269
11238	7	3	2296	7	0	2313
11239	7	1	9	2294	0	2311
11240	1	1	4	2369	0	2375
11241	2	1	2381	15	0	2399
11242	1	2	2277	10	0	2290
11243	3	2	2402	6	0	2413
11244	1	4	13	2439	0	2457
11245	1	1	2499	13	0	2514
11246	2377	0	15	12	0	2404
11247	23	3	5	2565	0	2596
11248	6	0	3055	27	0	3088
11249	1	3159	20	11	0	3191
11250	2	23	3149	0	0	3174
11251	2	4	30	3155	0	3191
11252	3250	1	9	43	0	3303
11253	34	0	2	3367	0	3403
11254	8	1	2	3417	0	3428
11255	3686	3	0	40	0	3729
11256	43	2	1	3799	0	3845
11257	6	2	3851	47	0	3906
11258	3812	2	42	13	0	3869
11259	43	3918	7	7	0	3975
11260	3939	48	3	6	0	3996
11261	54	9	0	3938	0	4001
11262	9	3	3936	53	0	4001
11263	6	3	3978	14	0	4001
11264	9	12	53	3995	0	4069
11265	11	2	9	3991	0	4013
11266	3	3	4034	50	0	4090
11267	5	1	3942	11	0	3959
11268	4008	1	57	12	0	4078
11269	56	4	12	4089	0	4161
11270	4130	0	9	53	0	4192
11271	58	2	5	4111	0	4176
11272	15	1	4296	53	0	4365
11273	7	2	4520	15	0	4544
11274	6	3	60	4593	0	4662
11275	8	2	12	4748	0	4770
11276	5	1	4864	68	0	4938
11277	4873	1	67	19	0	4960
11278	74	0	15	5017	0	5106
11279	5195	1	12	71	0	5279
11280	76	5706	8	18	0	5808
11281	19	81	5	5833	0	5938
11282	5872	14	7	92	0	5985
11283	91	6	5943	24	0	6064
11284	30	3	89	5957	0	6079
11285	16	3	16	6008	0	6043
11286	17	1	12	6121	0	6151
11287	6	5	6031	121	0	6163
11288	15	4	89	5981	0	6089
11289	8	6039	21	103	0	6171
11290	9	90	14	6141	0	6254
11291	10	13	6103	110	0	6236
11292	11	11	6188	26	0	6236
11293	18	4	103	6211	0	6336
11294	10	4	30	6305	0	6349
11295	14	7	16	6364	0	6401
11296	22	6	13	6370	0	6411
11297	6279	3	11	133	0	6426
11298	6279	1	11	49	0	6340
11299	112	5	6232	22	0	6371
11300	26	6325	90	25	0	6466
11301	15	87	25	6462	0	6589
11302	6628	16	16	111	0	6771
11303	6010	11	19	61	0	6101
11304	6712	4	8	34	0	6758
11305	6760	7	7	24	0	6798
11306	123	2	6663	21	0	6809
11307	6471	5	102	18	0	6596
11308	112	6484	30	13	0	6639
11309	36	93	17	6557	0	6703
11310	21	22	6601	106	0	6750
11311	30	8	97	6551	0	6686
11312	17	10	6586	109	0	6722
11313	24	7	107	6585	0	6723
11314	22	10	26	6753	0	6811
11315	6692	6	19	133	0	6850
11316	109	7	16	6722	0	6854
11317	28	4	6764	118	0	6914
11318	26	5	99	6886	0	7016
11319	6914	2	33	131	0	7080
11320	107	7	20	6985	0	7119
11321	30	6	6968	124	0	7128
11322	23	6925	101	41	0	7090
11323	7137	96	32	43	0	7308
11324	107	21	21	6979	0	7128
11325	32	7234	19	105	0	7390
11326	7212	94	21	53	0	7380
11327	112	23	7220	34	0	7389
11328	29	7190	99	44	0	7362
11329	25	99	31	7286	0	7441
11330	18	31	7209	112	0	7370
11331	25	15	99	7097	0	7236
11332	7128	11	29	122	0	7290
11333	123	8	7063	37	0	7231
11334	37	8	98	7059	0	7202
11335	25	14	7046	114	0	7199
11336	26	9	101	7031	0	7167
11337	18	5	44	7178	0	7245
11338	7035	9	20	140	0	7204
11339	107	7040	12	55	0	7214
11340	32	89	24	7077	0	7222
11341	7033	18	16	119	0	7186
11342	7072	18	23	45	0	7158
11343	121	17	15	6966	0	7119
11344	41	6804	14	120	0	6979
11345	30	6987	14	46	0	7077
11346	37	97	21	6799	0	6954
11347	25	32	14	6788	0	6859
11348	6283	14	17	109	0	6423
11349	96	13	11	6174	0	6294
11350	25	9	5951	100	0	6085
11351	5703	6	71	44	0	5824
11352	69	5756	24	33	0	5882
11353	5726	67	17	23	0	5833
11354	81	15	5791	29	0	5916
11355	28	5814	56	17	0	5915
11356	5746	67	35	29	0	5877
11357	5785	24	25	21	0	5855
11358	90	15	5795	9	0	5909
11359	5725	11	68	17	0	5821
11360	5827	7	27	14	0	5875
11361	88	5878	16	11	0	5993
11362	40	72	8	6010	0	6130
11363	25	24	5941	77	0	6067
11364	19	11	79	6069	0	6178
11365	11	11	6130	94	0	6246
11366	14	6	89	6057	0	6166
11367	6104	3	31	107	0	6245
11368	92	6	14	6233	0	6345
11369	33	4	6390	101	0	6528
11370	6413	3	106	46	0	6568
11371	121	3	35	6552	0	6711
11372	43	4	6355	113	0	6515
11373	6121	3	107	43	0	6274
11374	115	5	33	6190	0	6343
11375	41	6	6044	111	0	6202
11376	24	5	5879	38	0	5946
11377	24	64	114	5784	0	5986
11378	16	5	5904	99	0	6024
11379	10	5704	102	35	0	5851
11380	23	80	27	5199	0	5329
11381	5181	20	19	79	0	5299
11382	71	11	5186	30	0	5298
11383	30	5	5158	16	0	5209
11384	4974	2	92	15	0	5083
11385	71	3	5185	7	0	5266
11386	5004	2	81	15	0	5102
11387	75	1	5132	8	0	5216
11388	33	2	79	5081	0	5195
11389	16	4	5218	64	0	5302
11390	14	10	75	5182	0	5281
11391	9	3	5327	77	0	5416
11392	10	3	5205	30	0	5248
11393	4999	1	88	22	0	5110
11394	68	5229	34	8	0	5339
11395	5299	62	20	12	0	5393
11396	74	5346	12	9	0	5441
11397	32	69	14	5414	0	5529
11398	14	22	17	5539	0	5592
11399	5521	7	10	90	0	5628
11400	73	5	10	5466	0	5554
11401	26	4	5419	75	0	5524
11402	5233	2	74	34	0	5343
11403	5351	2	27	19	0	5399
11404	103	5	19	5319	0	5446
11405	36	6	5411	74	0	5527
11406	21	8	79	5366	0	5474
11407	12	5402	29	87	0	5530
11408	17	73	19	5486	0	5595
11409	14	20	11	5611	0	5656
11410	16	8	5454	106	0	5584
11411	5043	5	81	42	0	5171
11412	85	5379	31	20	0	5515
11413	5417	79	15	21	0	5532
11414	89	5481	17	19	0	5606
11415	38	89	7	5380	0	5514
11416	16	5442	15	121	0	5594
11417	13	90	5387	30	0	5520
11418	18	25	89	5209	0	5341
11419	17	13	26	5241	0	5297
11420	12	4	24	5386	0	5426
11421	5238	4	21	113	0	5376
11422	96	9	13	5246	0	5364
11423	5096	10	20	104	0	5230
11424	5177	12	6	44	0	5239
11425	5037	9	10	48	0	5104
11426	114	6	5062	17	0	5199
11427	51	6	90	5075	0	5222
11428	27	7	33	5422	0	5489
11429	23	5	23	5557	0	5608
11430	5768	5	25	139	0	5937
11431	126	7	11	5858	0	6002
11432	40	5	24	6021	0	6090
11433	6272	10	13	160	0	6455
11434	147	3	20	6473	0	6643
11435	53	4	6622	168	0	6847
11436	33	6	6745	48	0	6832
11437	29	3	174	6764	0	6970
11438	6730	3	51	178	0	6962
11439	6702	7	46	62	0	6817
11440	204	4	19	6658	0	6885
11441	59	13	6620	165	0	6857
11442	37	6535	152	66	0	6790
11443	35	150	45	6708	0	6938
11444	26	31	30	6826	0	6913
11445	32	24	27	6828	0	6911
11446	6686	7	29	216	0	6938
11447	168	6	6733	82	0	6989
11448	6790	12	158	59	0	7019
11449	195	8	35	6730	0	6968
11450	57	6829	31	168	0	7085
11451	6891	147	23	71	0	7132
11452	6895	36	14	58	0	7003
11453	194	22	7075	44	0	7335
11454	72	6676	152	49	0	6949
11455	39	6830	41	32	0	6942
11456	6748	151	29	40	0	6968
11457	175	39	16	6714	0	6944
11458	60	26	12	6746	0	6844
11459	47	18	22	6690	0	6777
11460	28	6373	17	191	0	6609
11461	23	6639	13	65	0	6740
11462	6451	151	5	57	0	6664
11463	158	40	8	6440	0	6646
11464	38	24	6824	148	0	7034
11465	46	16	154	7017	0	7233
11466	28	24	7498	199	0	7749
11467	26	17	7558	74	0	7675
11468	30	23	7601	56	0	7710
11469	15	7190	238	38	0	7481
11470	46	167	129	6937	0	7279
11471	16	7163	81	156	0	7416
11472	50	197	54	6734	0	7035
11473	26	67	37	7345	0	7475
11474	7224	60	31	232	0	7547
11475	180	31	11	7293	0	7515
11476	7186	24	15	258	0	7483
11477	7302	18	15	107	0	7442
11478	232	15	22	7049	0	7318
11479	117	6995	16	217	0	7345
11480	93	156	17	6923	0	7189
11481	60	6996	20	234	0	7310
11482	56	200	20	7002	0	7278
11483	35	69	6963	254	0	7321
11484	39	67	172	7002	0	7280
11485	32	40	55	7226	0	7353
11486	6880	31	57	279	0	7247
11487	182	6906	32	148	0	7268
11488	73	174	33	7000	0	7280
11489	80	67	20	6958	0	7125
11490	48	6782	27	273	0	7130
11491	56	191	21	6855	0	7123
11492	6461	78	20	282	0	6841
11493	6795	72	20	128	0	7015
11494	229	6631	21	116	0	6997
11495	126	191	20	6648	0	6985
11496	6502	73	16	247	0	6838
11497	205	6603	27	105	0	6940
11498	111	197	28	6325	0	6661
11499	89	6523	25	218	0	6855
11500	6484	224	24	110	0	6842
11501	221	81	6352	91	0	6745
11502	77	96	6367	82	0	6622
11503	96	58	221	6348	0	6723
11504	76	60	6373	213	0	6722
11505	53	39	238	6274	0	6604
11506	6232	27	104	258	0	6621
11507	193	37	6408	120	0	6758
11508	97	44	184	6428	0	6753
11509	91	32	97	6571	0	6791
11510	6431	41	69	270	0	6811
11511	191	6521	52	171	0	6935
11512	6552	190	36	132	0	6910
11513	6606	71	27	111	0	6815
11514	257	6375	26	92	0	6750
11515	145	181	37	6433	0	6796
11516	119	89	6338	202	0	6748
11517	86	88	168	6317	0	6659
11518	61	6309	72	225	0	6667
11519	6431	191	63	123	0	6808
11520	194	94	33	6497	0	6818
11521	78	83	6498	246	0	6905
11522	81	50	180	6621	0	6932
11523	48	57	65	6821	0	6991
11524	77	41	65	6839	0	7022
11525	55	48	40	6883	0	7026
11526	58	45	48	6742	0	6893
11527	43	36	6394	357	0	6830
11528	74	37	6066	187	0	6364
11529	31	5767	184	153	0	6135
11530	30	5854	94	106	0	6084
11531	5680	153	76	83	0	5992
11532	148	75	5671	71	0	5965
11533	5178	85	156	50	0	5469
11534	162	39	5037	48	0	5286
11535	70	40	4847	39	0	4996
11536	66	32	141	4718	0	4957
11537	4878	29	96	117	0	5120
11538	117	26	62	4942	0	5147
11539	65	15	43	5001	0	5124
11540	59	15	5246	159	0	5479
11541	38	14	105	5342	0	5499
11542	41	13	61	5314	0	5429
11543	31	15	50	5386	0	5482
11544	30	18	25	5379	0	5452
11545	38	21	26	5386	0	5471
11546	5185	14	21	210	0	5430
11547	103	17	17	5196	0	5333
11548	58	15	4963	181	0	5217
11549	55	25	91	5021	0	5192
11550	37	22	4943	163	0	5165
11551	42	17	116	5001	0	5176
11552	28	14	5068	159	0	5269
11553	17	40	139	4751	0	4947
11554	16	10	66	4970	0	5062
11555	19	13	4807	161	0	5000
11556	4518	15	103	131	0	4767
11557	92	16	4874	84	0	5066
11558	58	17	124	4884	0	5083
11559	4915	8	74	142	0	5139
11560	113	12	62	4970	0	5157
11561	71	12	28	5031	0	5142
11562	60	9	4956	159	0	5184
11563	34	4743	88	122	0	4987
11564	21	4202	42	91	0	4356
11565	11	4128	28	59	0	4226
11566	67	22	61	3465	0	3615
11567	3523	8	11	23	0	3565
11568	12	5	2	3514	0	3533
11569	8	4	3	3524	0	3539
11570	8	2	2	3551	0	3563
11571	8	1	2	3543	0	3554
11572	1	3493	1	29	0	3524
11573	5	14	1	3548	0	3568
11574	5	8	1	3547	0	3561
11575	0	3498	2	28	0	3528
11576	3535	15	3	17	0	3570
11577	14	10	1	3543	0	3568
11578	3549	5	0	24	0	3578
11579	3492	5	1	18	0	3516
11580	25	3583	2	6	0	3616
11581	14	14	3	3719	0	3750
11582	6	8	3718	16	0	3748
11583	5	3	3612	8	0	3628
11584	4	17	19	3663	0	3703
11585	3727	1	12	22	0	3762
11586	3807	3	6	14	0	3830
11587	20	2	4	3853	0	3879
11588	3852	0	1	29	0	3882
11589	19	3838	1	7	0	3865
11590	3837	13	2	13	0	3865
11591	19	3971	2	7	0	3999
11592	13	18	2	4078	0	4111
11593	8	9	1	4088	0	4106
11594	5	4083	2	23	0	4113
11595	4076	17	0	20	0	4113
11596	16	9	4047	6	0	4078
11597	11	4	18	4032	0	4065
11598	6	5	4098	19	0	4128
11599	7	2	19	4076	0	4104
11600	4135	2	9	29	0	4175
11601	17	4	4	4136	0	4161
11602	4129	1	3	25	0	4158
11603	4079	2	2	21	0	4104
11604	27	1	3	4081	0	4112
11605	11	4	4027	23	0	4065
11606	10	4126	15	11	0	4162
11607	6	15	6	4067	0	4094
11608	3999	7	4	27	0	4037
11609	24	4	3965	9	0	4002
11610	12	4	18	3980	0	4014
11611	10	2	6	3922	0	3940
11612	5	2	4	3979	0	3990
11613	3973	3	3	34	0	4013
11614	23	1	2	3908	0	3934
11615	13	4	3	3963	0	3983
11616	8	2	3962	29	0	4001
11617	8	1	21	3949	0	3979
11618	2	1	10	4029	0	4042
11619	7	0	5	4090	0	4102
11620	8	4058	9	31	0	4106
11621	10	18	1	3958	0	3987
11622	8	7	3	3969	0	3987
11623	3857	5	2	38	0	3902
11624	26	5	3831	15	0	3877
11625	9	6	3612	18	0	3645
11626	5	3793	23	13	0	3834
11627	11	22	11	3904	0	3948
11628	3885	9	8	35	0	3937
11629	25	3	5	3854	0	3887
11630	12	3	6	3902	0	3923
11631	3	2	6	3946	0	3957
11632	8	2	3	3884	0	3897
11633	6	1	2	3880	0	3889
11634	7	3	3838	38	0	3886
11635	8	0	18	3827	0	3853
11636	3830	1	7	39	0	3877
11637	24	3732	5	19	0	3780
11638	9	19	5	3783	0	3816
11639	8	6	3	3787	0	3804
11640	7	6	3576	32	0	3621
11641	6	4	24	3524	0	3558
11642	7	0	9	3820	0	3836
11643	3864	2	5	51	0	3922
11644	27	3979	5	29	0	4040
11645	18	30	3	4067	0	4118
11646	8	14	3	4143	0	4168
11647	11	9	1	4159	0	4180
11648	4	6	4193	57	0	4260
11649	3	2	4012	34	0	4051
11650	7	4114	50	15	0	4186
11651	0	4278	20	19	0	4317
11652	2	42	5	4243	0	4292
11653	4	3958	5	45	0	4012
11654	13	55	4	4608	0	4680
11655	5	28	2	5089	0	5124
11656	9	7	3	5425	0	5444
11657	15	2	3	5982	0	6002
11658	3	4	5977	138	0	6122
11659	6	3	79	6011	0	6099
11660	8	3	45	6119	0	6175
11661	3	2	26	6251	0	6282
11662	6051	1	13	201	0	6266
11663	87	6145	26	107	0	6365
11664	64	93	12	5918	0	6087
11665	26	6197	14	135	0	6372
11666	6092	116	9	111	0	6328
11667	5566	69	7	93	0	5735
11668	133	6147	5	53	0	6338
11669	70	6401	10	52	0	6533
11670	34	180	6252	34	0	6500
11671	44	6484	86	38	0	6652
11672	47	150	48	6374	0	6619
11673	6432	91	29	134	0	6686
11674	116	6589	15	81	0	6801
11675	71	141	25	6700	0	6937
11676	44	101	9	6756	0	6910
11677	29	59	18	6921	0	7027
11678	6774	40	11	208	0	7033
11679	122	59	6741	122	0	7044
11680	6565	37	109	101	0	6812
11681	138	6682	61	71	0	6952
11682	89	125	32	6713	0	6959
11683	70	76	6644	143	0	6933
11684	6482	48	128	108	0	6766
11685	151	6683	65	55	0	6954
11686	85	166	41	6546	0	6838
11687	47	6698	28	162	0	6935
11688	44	155	32	6768	0	6999
11689	49	80	19	6955	0	7103
11690	35	72	6764	196	0	7067
11691	25	38	6582	137	0	6782
11692	32	46	157	6666	0	6901
11693	19	35	6731	187	0	6972
11694	24	26	143	6729	0	6922
11695	33	28	102	6634	0	6797
11696	21	24	58	6915	0	7018
11697	6732	25	44	240	0	7041
11698	115	25	61	6853	0	7054
11699	74	17	6755	211	0	7057
11700	6809	21	128	153	0	7111
11701	130	23	74	6962	0	7189
11702	95	24	52	7033	0	7204
11703	6878	21	35	246	0	7180
11704	131	7071	39	150	0	7391
11705	102	109	34	7231	0	7476
11706	56	70	36	7224	0	7386
11707	7064	36	34	258	0	7392
11708	150	29	7060	155	0	7394
11709	86	37	118	7072	0	7313
11710	57	21	68	7182	0	7328
11711	52	32	38	7087	0	7209
11712	64	6991	32	241	0	7328
11713	42	118	42	7164	0	7366
11714	7005	67	31	222	0	7325
11715	131	6989	35	152	0	7307
11716	6932	126	25	120	0	7203
11717	149	7103	16	97	0	7365
11718	7095	150	26	117	0	7388
11719	184	99	7020	65	0	7368
11720	103	76	6998	75	0	7252
11721	7036	52	160	81	0	7329
11722	152	63	7245	72	0	7532
11723	133	40	146	7245	0	7564
11724	100	42	117	6621	0	6880
11725	57	30	78	7462	0	7627
11726	7325	28	52	236	0	7641
11727	142	32	7216	150	0	7540
11728	7244	19	139	120	0	7522
11729	166	34	91	7586	0	7877
11730	7589	27	53	214	0	7883
11731	199	33	47	7716	0	7995
11732	7974	30	49	192	0	8245
11733	223	30	35	8488	0	8776
11734	126	26	8635	231	0	9018
11735	8743	33	148	143	0	9067
11736	9071	25	89	119	0	9304
11737	275	24	53	9006	0	9358
11738	149	16	48	8934	0	9147
11739	89	8971	61	258	0	9379
11740	8841	129	41	172	0	9183
11741	207	8917	44	121	0	9289
11742	8702	158	30	113	0	9003
11743	212	73	8664	103	0	9052
11744	118	60	8578	80	0	8836
11745	101	31	8356	77	0	8565
11746	8476	49	208	75	0	8808
11747	203	8604	105	67	0	8979
11748	127	137	69	8539	0	8872
11749	8482	78	70	179	0	8809
11750	175	8643	64	112	0	8994
11751	137	243	48	8401	0	8829
11752	81	8465	38	171	0	8755
11753	68	8201	34	133	0	8436
11754	69	8258	28	72	0	8427
11755	7627	172	50	72	0	7921
11756	125	7501	17	48	0	7691
11757	42	6815	13	28	0	6898
11758	30	6850	21	25	0	6926
11759	6794	98	41	24	0	6957
11760	6779	27	15	26	0	6847
11761	95	24	6637	23	0	6779
11762	6442	10	76	18	0	6546
11763	6748	10	30	24	0	6812
11764	103	11	19	6721	0	6854
11765	6821	18	14	81	0	6934
11766	97	13	6760	35	0	6905
11767	36	7132	68	24	0	7260
11768	7235	85	25	23	0	7368
11769	100	35	12	7381	0	7528
11770	7377	19	9	89	0	7494
11771	96	23	7138	27	0	7284
11772	7270	20	64	20	0	7374
11773	103	11	24	7417	0	7555
11774	38	17	7404	82	0	7541
11775	33	7099	77	33	0	7242
11776	20	7447	23	21	0	7511
11777	41	103	18	7376	0	7538
11778	26	31	11	7364	0	7432
11779	22	7408	11	80	0	7521
11780	7460	71	8	29	0	7568
11781	7423	22	9	16	0	7470
11782	7362	13	3	21	0	7399
11783	96	7521	5	16	0	7638
11784	46	79	3	7323	0	7451
11785	20	7580	13	67	0	7680
11786	7638	81	6	23	0	7748
11787	7574	20	4	18	0	7616
11788	95	7466	10	23	0	7594
11789	7559	76	9	28	0	7672
11790	98	29	9	7567	0	7703
11791	38	10	14	7644	0	7706
11792	7707	19	10	97	0	7833
11793	7576	11	6	42	0	7635
11794	7640	16	14	27	0	7697
11795	112	17	5	7609	0	7743
11796	44	15	10	7695	0	7764
11797	38	20	7603	99	0	7760
11798	31	20	71	7549	0	7671
11799	30	23	19	7609	0	7681
11800	35	18	7439	96	0	7588
11801	19	20	7079	36	0	7154
11802	24	21	7475	20	0	7540
11803	36	27	98	7424	0	7585
11804	23	15	7378	88	0	7504
11805	29	22	88	7369	0	7508
11806	30	18	29	7506	0	7583
11807	34	26	7488	103	0	7651
11808	22	22	7428	47	0	7519
11809	33	19	95	7441	0	7588
11810	27	19	7845	99	0	7990
11811	29	25	7740	35	0	7829
11812	29	7782	103	31	0	7945
11813	8035	99	33	29	0	8196
11814	8075	38	18	23	0	8154
11815	8083	31	19	23	0	8156
11816	124	7938	12	23	0	8097
11817	48	8055	16	25	0	8144
11818	32	103	13	8064	0	8212
11819	47	29	20	8003	0	8099
11820	33	18	7907	109	0	8067
11821	45	16	86	7863	0	8010
11822	7907	13	37	113	0	8070
11823	105	13	15	7698	0	7831
11824	36	7860	20	103	0	8019
11825	8109	91	23	52	0	8275
11826	8231	23	16	33	0	8303
11827	8326	22	23	37	0	8408
11828	128	15	8231	29	0	8403
11829	54	44	76	8323	0	8497
11830	8739	9	28	133	0	8909
11831	125	12	8876	34	0	9047
11832	43	8526	113	30	0	8712
11833	24	8226	26	20	0	8296
11834	7843	104	54	26	0	8027
11835	89	7806	20	26	0	7941
11836	35	85	18	7707	0	7845
11837	9	24	7852	93	0	7978
11838	23	18	88	7801	0	7930
11839	7827	13	29	103	0	7972
11840	93	7773	18	26	0	7910
11841	7722	88	15	27	0	7852
11842	91	17	7725	18	0	7851
11843	33	18	90	7514	0	7655
11844	19	7915	23	89	0	8046
11845	23	97	16	8030	0	8166
11846	8075	23	13	103	0	8214
11847	8149	12	13	26	0	8200
11848	8139	8	18	23	0	8188
11849	8191	10	10	22	0	8233
11850	116	10	13	7920	0	8059
11851	31	21	8050	92	0	8194
11852	35	18	79	7860	0	7992
11853	26	7997	16	85	0	8124
11854	8085	81	13	31	0	8210
11855	101	23	8003	19	0	8146
11856	7813	13	84	25	0	7935
11857	94	8	26	7974	0	8102
11858	23	10	8133	98	0	8264
11859	25	7	86	8082	0	8200
11860	8211	8	24	106	0	8349
11861	8270	4	14	37	0	8325
11862	8286	7	10	22	0	8325
11863	103	9	8212	22	0	8346
11864	42	23	86	8203	0	8354
11865	22	12	8390	82	0	8506
11866	25	8353	77	22	0	8477
11867	8021	72	28	25	0	8146
11868	82	7876	11	19	0	7988
11869	7738	66	19	19	0	7842
11870	79	14	10	7628	0	7731
11871	16	7691	14	58	0	7779
11872	7766	64	6	21	0	7857
11873	74	21	7843	8	0	7946
11874	24	17	62	7726	0	7829
11875	7827	10	14	71	0	7922
11876	75	14	7818	20	0	7927
11877	31	14	57	7633	0	7735
11878	23	7408	22	73	0	7526
11879	18	64	12	7882	0	7976
11880	17	25	10	7926	0	7978
11881	7839	17	3	87	0	7946
11882	76	7799	10	25	0	7910
11883	24	67	6	7637	0	7734
11884	21	7765	9	65	0	7860
11885	18	63	21	7777	0	7879
11886	13	7903	11	68	0	7995
11887	7921	69	6	27	0	8023
11888	75	28	8056	13	0	8172
11889	38	7	64	7918	0	8027
11890	16	17	25	8001	0	8059
11891	17	11	12	8030	0	8070
11892	24	13	8	7926	0	7971
11893	19	11	7853	90	0	7973
11894	24	7940	71	32	0	8067
11895	8007	65	17	32	0	8121
11896	8084	21	13	22	0	8140
11897	91	8004	11	23	0	8129
11898	8085	63	13	23	0	8184
11899	8089	23	15	26	0	8153
11900	83	8213	8	21	0	8325
11901	42	75	8	8173	0	8298
11902	32	8340	8	59	0	8439
11903	8300	70	15	30	0	8415
11904	84	21	8244	18	0	8367
11905	7812	8	67	39	0	7926
11906	71	15	8399	16	0	8501
11907	37	11	62	8360	0	8470
11908	8391	11	23	79	0	8504
11909	90	12	8316	22	0	8440
11910	7913	8	61	37	0	8019
11911	8131	14	19	26	0	8190
11912	90	11	16	8118	0	8235
11913	29	8127	17	76	0	8249
11914	8233	80	7	35	0	8355
11915	90	22	9	8168	0	8289
11916	35	8017	14	73	0	8139
11917	8121	70	5	44	0	8240
11918	82	24	14	8194	0	8314
11919	28	8374	16	78	0	8496
11920	30	64	12	8671	0	8777
11921	8735	22	11	94	0	8862
11922	8716	16	8	47	0	8787
11923	8794	7	7	33	0	8841
11924	101	13	12	8599	0	8725
11925	42	18	8	8554	0	8622
11926	21	20	8589	85	0	8715
11927	32	45	72	8570	0	8719
11928	26	10	8841	86	0	8963
11929	22	10	8197	28	0	8257
11930	10	3	8086	11	0	8110
11931	7	8482	56	21	0	8566
11932	26	45	49	8281	0	8401
11933	7	9051	8	39	0	9105
11934	9265	63	4	31	0	9363
11935	9349	17	5	24	0	9395
11936	89	9	9	9624	0	9731
11937	30	6	9878	79	0	9993
11938	22	4	88	9870	0	9984
11939	11	7	10138	97	0	10253
11940	26	8	98	9938	0	10070
11941	18	10011	28	92	0	10149
11942	13	10349	13	34	0	10409
11943	10244	110	13	27	0	10394
11944	100	28	10176	22	0	10326
11945	43	15	91	10011	0	10160
11946	26	11	25	10219	0	10281
11947	10207	5	14	128	0	10354
11948	99	10243	18	40	0	10400
11949	10256	95	11	35	0	10397
11950	99	10430	10	20	0	10559
11951	10292	102	5	33	0	10432
11952	10502	32	10	31	0	10575
11953	139	15	9	10535	0	10698
11954	40	20	10549	102	0	10711
11955	10233	9	99	50	0	10391
11956	115	10554	32	34	0	10735
11957	10700	111	17	23	0	10851
11958	127	33	11	10413	0	10584
11959	50	20	13	10440	0	10523
11960	28	10384	8	122	0	10542
11961	39	107	8	10269	0	10423
11962	21	10479	5	122	0	10627
11963	27	109	8	10335	0	10479
11964	25	32	13	10261	0	10331
11965	9945	12	11	152	0	10120
11966	111	15	9949	41	0	10116
11967	39	9899	95	35	0	10068
11968	33	105	28	10007	0	10173
11969	10155	38	12	130	0	10335
11970	10318	20	14	58	0	10410
11971	10280	22	15	37	0	10354
11972	152	15	10149	27	0	10343
11973	10100	18	112	30	0	10260
11974	150	8	34	10252	0	10444
11975	10202	16	19	138	0	10375
11976	132	10053	20	57	0	10262
11977	61	121	13	10166	0	10361
11978	10039	38	16	146	0	10239
11979	145	10315	5	58	0	10523
11980	53	138	9	10453	0	10653
11981	37	34	10105	148	0	10324
11982	10528	25	127	50	0	10730
11983	10984	20	31	40	0	11075
11984	189	17	10825	32	0	11063
11985	70	10512	148	26	0	10756
11986	45	10918	43	43	0	11049
11987	47	176	25	10914	0	11162
11988	47	52	22	10518	0	10639
11989	43	23	13	10966	0	11045
11990	22	27	11024	200	0	11273
11991	10919	18	153	83	0	11173
11992	11561	21	55	53	0	11690
11993	11856	18	23	47	0	11944
11994	11900	26	17	49	0	11992
11995	12055	17	17	44	0	12133
11996	12236	27	22	34	0	12319
11997	238	24	16	12581	0	12859
11998	77	31	12455	215	0	12778
11999	53	23	12781	73	0	12930
12000	50	23	215	12805	0	13093
12001	62	26	52	12754	0	12894
12002	57	23	30	12830	0	12940
12003	53	12844	21	255	0	13173
12004	13074	204	24	83	0	13385
12005	245	13396	19	55	0	13715
12006	102	214	21	13195	0	13532
12007	13095	72	19	250	0	13436
12008	239	13170	22	85	0	13516
12009	101	225	15	13220	0	13561
12010	70	71	18	13475	0	13634
12011	60	37	21	13527	0	13645
12012	49	13453	17	312	0	13831
12013	62	235	21	13669	0	13987
12014	47	76	13646	293	0	14062
12015	46	56	243	13838	0	14183
12016	58	33	61	14169	0	14321
12017	51	48	31	14739	0	14869
12018	60	32	25	15028	0	15145
12019	51	41	14629	417	0	15138
12020	46	14560	270	194	0	15070
12021	58	275	93	14740	0	15166
12022	44	116	41	15253	0	15454
12023	63	56	33	15146	0	15298
12024	45	14533	42	431	0	15051
12025	46	15315	29	214	0	15604
12026	14952	367	27	140	0	15486
12027	306	144	20	14768	0	15238
12028	114	83	14517	355	0	15069
12029	67	14485	255	198	0	15005
12030	14216	296	108	141	0	14761
12031	307	116	14010	102	0	14535
12032	129	76	13851	107	0	14163
12033	73	46	13932	98	0	14149
12034	72	177	370	13464	0	14083
12035	55	51	13623	316	0	14045
12036	38	13133	310	168	0	13649
12037	50	237	152	12789	0	13228
12038	44	105	12965	270	0	13384
12039	38	88	256	12788	0	13170
12040	12605	40	142	325	0	13112
12041	226	68	12597	183	0	13074
12042	12394	51	255	129	0	12829
12043	259	12765	138	100	0	13262
12044	12801	242	87	109	0	13239
12045	303	118	83	12776	0	13280
12046	12836	75	78	311	0	13300
12047	12911	45	76	182	0	13214
12048	12690	75	69	119	0	12953
12049	374	12798	67	91	0	13330
12050	12775	256	73	100	0	13204
12051	12874	108	71	109	0	13162
12052	391	66	12603	91	0	13151
12053	190	12498	274	95	0	13057
12054	158	273	138	12445	0	13014
12055	107	152	97	12715	0	13071
12056	125	72	76	12804	0	13077
12057	81	71	12457	411	0	13020
12058	104	56	279	12574	0	13013
12059	86	70	12557	352	0	13065
12060	12456	50	283	218	0	13007
12061	12730	62	142	151	0	13085
12062	361	53	12619	132	0	13165
12063	12631	61	274	109	0	13075
12064	12881	52	165	121	0	13219
12065	13050	53	91	103	0	13297
12066	431	47	98	12663	0	13239
12067	249	65	12726	289	0	13329
12068	170	12732	261	197	0	13360
12069	157	253	153	12674	0	13237
12070	134	125	12728	295	0	13282
12071	128	83	12154	182	0	12547
12072	12129	80	323	158	0	12690
12073	266	12550	178	133	0	13127
12074	12662	242	104	150	0	13158
12075	12752	116	108	132	0	13108
12076	338	12621	123	107	0	13189
12077	12673	231	85	112	0	13101
12078	339	141	12783	97	0	13360
12079	249	75	12446	100	0	12870
12080	212	60	12508	88	0	12868
12081	146	12337	313	89	0	12885
12082	12138	209	224	70	0	12641
12083	12163	112	136	100	0	12511
12084	339	11742	116	73	0	12270
12085	198	12076	110	77	0	12461
12086	161	268	79	11949	0	12457
12087	133	158	82	12094	0	12467
12088	12004	105	84	266	0	12459
12089	276	12062	70	169	0	12577
12090	11962	240	86	100	0	12388
12091	11793	128	72	103	0	12096
12092	318	92	11483	96	0	11989
12093	204	11270	195	72	0	11741
12094	185	241	122	11101	0	11649
12095	10988	119	96	187	0	11390
12096	278	99	82	10797	0	11256
12097	10373	62	84	178	0	10697
12098	235	65	10047	113	0	10460
12099	160	9670	175	96	0	10101
12100	147	9900	112	71	0	10230
12101	132	275	94	9409	0	9910
12102	124	9941	76	134	0	10275
12103	9910	178	73	113	0	10274
12104	175	119	9727	85	0	10106
12105	9307	100	138	65	0	9610
12106	177	72	9637	84	0	9970
12107	154	78	136	9547	0	9915
12108	138	69	93	9599	0	9899
12109	123	50	81	9664	0	9918
12110	9570	56	59	207	0	9892
12111	201	37	9541	117	0	9896
12112	146	46	120	9334	0	9646
12113	107	51	85	9232	0	9475
12114	95	8987	52	188	0	9322
12115	111	8837	44	123	0	9115
12116	95	8948	59	83	0	9185
12117	75	141	43	8403	0	8662
12118	66	69	33	8031	0	8199
12119	21	7680	16	74	0	7791
12120	39	7746	15	43	0	7843
12121	7634	43	62	48	0	7787
12122	53	43	14	7512	0	7622
12123	29	7343	13	29	0	7414
12124	7442	26	31	21	0	7520
12125	46	15	9	7487	0	7557
12126	7876	7	10	41	0	7934
12127	52	8	10	8016	0	8086
12128	25	11	8138	43	0	8217
12129	20	8196	33	30	0	8279
12130	8069	34	17	32	0	8152
12131	42	14	8240	10	0	8306
12132	14	8186	35	7	0	8242
12133	22	32	12	8071	0	8137
12134	14	13	4	8116	0	8147
12135	10	5	2	7942	0	7959
12136	14	1	2	7826	0	7843
12137	6	3	8022	32	0	8063
12138	1	7899	23	12	0	7935
12139	3	25	7	7939	0	7974
12140	7836	5	4	39	0	7884
12141	31	7880	0	14	0	7925
12142	19	26	1	8316	0	8362
12143	12	10	8148	40	0	8210
12144	4	8178	50	19	0	8251
12145	15	51	16	7732	0	7814
12146	1	8418	7	24	0	8450
12147	8450	63	0	22	0	8535
12148	8532	15	3	24	0	8574
12149	75	13	8286	5	0	8379
12150	8258	4	46	20	0	8328
12151	8464	2	14	22	0	8502
12152	79	7	8272	4	0	8362
12153	28	8340	50	10	0	8428
12154	30	53	17	8310	0	8410
12155	14	15	11	8611	0	8651
12156	8582	10	5	90	0	8687
12157	77	1	2	8588	0	8668
12158	22	6	8576	73	0	8677
12159	8252	3	65	33	0	8353
12160	79	4	8434	14	0	8531
12161	17	8481	74	10	0	8582
12162	8298	63	17	21	0	8399
12163	78	20	8342	5	0	8445
12164	20	16	8082	10	0	8128
12165	14	8230	70	10	0	8324
12166	19	67	28	8301	0	8415
12167	7	20	8137	70	0	8234
12168	35	18	79	7264	0	7396
12169	12	8	21	7947	0	7988
12170	7	6	7780	86	0	7879
12171	7	7736	72	29	0	7844
12172	7	69	18	7807	0	7901
12173	7684	23	14	90	0	7811
12174	7612	9	11	29	0	7661
12175	84	7	8	7699	0	7798
12176	33	6	7618	87	0	7744
12177	21	8	7899	25	0	7953
12178	19	9	103	7748	0	7879
12179	8	5	7666	100	0	7779
12180	7715	3	106	28	0	7852
12181	108	8	29	7897	0	8042
12182	37	6	20	8090	0	8153
12183	18	8049	14	120	0	8201
12184	18	98	8	8187	0	8311
12185	7	29	8009	119	0	8164
12186	7640	15	102	45	0	7802
12187	7948	6	31	28	0	8013
12188	128	5	8005	20	0	8158
12189	49	11	115	8491	0	8666
12190	35	9	32	8763	0	8839
12191	19	12	8767	187	0	8985
12192	30	4	157	8977	0	9168
12193	31	5	44	8932	0	9012
12194	14	9251	29	204	0	9498
12195	23	157	22	9504	0	9706
12196	20	38	12	9710	0	9780
12197	9754	18	14	237	0	10023
12198	10148	17	13	86	0	10264
12199	10364	6	13	45	0	10428
12200	10280	5	12	37	0	10334
12201	10191	13	10	30	0	10244
12202	280	9	9798	27	0	10114
12203	98	7	196	9762	0	10063
12204	68	7	54	9964	0	10093
12205	43	7	9826	246	0	10122
12206	9500	11	204	92	0	9807
12207	9762	8	57	64	0	9891
12208	254	12	9063	52	0	9381
12209	9680	7	170	40	0	9897
12210	9974	9	59	27	0	10069
12211	279	12	9717	37	0	10045
12212	119	15	217	9555	0	9906
12213	77	9982	68	193	0	10320
12214	67	210	34	10536	0	10847
12215	50	54	32	10713	0	10849
12216	44	31	23	10692	0	10790
12217	46	17	10469	310	0	10842
12218	10335	12	230	122	0	10699
12219	10623	8	76	82	0	10789
12220	297	12	44	10440	0	10793
12221	114	13	10272	256	0	10655
12222	79	8	236	10275	0	10598
12223	48	11	10466	282	0	10807
12224	40	10	10527	107	0	10684
12225	37	10498	299	71	0	10905
12226	69	215	92	10164	0	10540
12227	10087	56	53	261	0	10457
12228	9858	36	42	94	0	10030
12229	10093	19	34	74	0	10220
12230	332	14	24	9783	0	10153
12231	123	10114	34	252	0	10523
12232	85	230	22	10292	0	10629
12233	58	62	10565	295	0	10980
12234	11098	38	275	118	0	11529
12235	11858	19	82	94	0	12053
12236	398	15	60	11690	0	12163
12237	148	17	45	11951	0	12161
12238	117	13	45	12048	0	12223
12239	78	17	11599	431	0	12125
12240	11113	13	304	196	0	11626
12241	340	11299	107	117	0	11863
12242	118	11251	65	93	0	11527
12243	89	297	11220	54	0	11660
12244	89	121	280	11032	0	11522
12245	63	57	11167	305	0	11592
12246	10798	42	301	133	0	11274
12247	325	32	94	10849	0	11300
12248	135	15	10668	302	0	11120
12249	102	10938	274	113	0	11427
12250	11026	246	84	97	0	11453
12251	302	75	11101	81	0	11559
12252	113	10704	296	74	0	11187
12253	97	11193	106	50	0	11446
12254	11189	304	68	76	0	11637
12255	314	105	64	11195	0	11678
12256	110	70	11404	319	0	11903
12257	80	11423	293	123	0	11919
12258	11483	264	100	97	0	11944
12259	11642	86	71	69	0	11868
12260	354	11451	61	59	0	11925
12261	135	295	11562	47	0	12039
12262	101	101	278	11623	0	12103
12263	11632	67	116	315	0	12130
12264	11865	48	77	131	0	12121
12265	378	45	11628	94	0	12145
12266	164	33	300	11563	0	12060
12267	126	44	103	11911	0	12184
12268	110	37	11804	368	0	12319
12269	75	37	11837	138	0	12087
12270	11818	40	352	113	0	12323
12271	12165	53	146	86	0	12450
12272	12288	45	93	63	0	12489
12273	12334	39	76	78	0	12527
12274	432	39	11814	79	0	12364
12275	11912	41	279	93	0	12325
12276	413	24	106	11803	0	12346
12277	186	32	11720	313	0	12251
12278	141	32	11738	120	0	12031
12279	98	11672	330	115	0	12215
12280	83	258	141	11358	0	11840
12281	65	95	11456	294	0	11910
12282	11153	67	294	129	0	11643
12283	315	58	128	10594	0	11095
12284	149	11241	96	244	0	11730
12285	11386	250	72	140	0	11848
12286	11526	78	87	111	0	11802
12287	358	59	11305	81	0	11803
12288	175	11133	283	74	0	11665
12289	143	205	98	10600	0	11046
12290	10559	75	94	229	0	10957
12291	268	82	71	10403	0	10824
12292	125	54	10040	233	0	10452
12293	9483	34	207	103	0	9827
12294	249	9633	95	104	0	10081
12295	107	9270	81	70	0	9528
12296	94	9840	70	70	0	10074
12297	9509	232	161	71	0	9973
12298	9380	94	78	57	0	9609
12299	9424	78	63	34	0	9599
12300	268	38	45	9231	0	9582
12301	126	35	9295	184	0	9640
12302	103	39	175	9367	0	9684
12303	9445	27	82	196	0	9750
12304	222	24	58	9530	0	9834
12305	9642	23	51	216	0	9932
12306	9706	30	52	93	0	9881
12307	9581	27	74	84	0	9766
12308	235	9526	48	69	0	9878
12309	9546	158	39	60	0	9803
12310	255	54	9327	35	0	9671
12311	139	39	9372	34	0	9584
12312	117	9116	174	25	0	9432
12313	112	150	99	8676	0	9037
12314	8597	54	59	142	0	8852
12315	185	35	8487	57	0	8764
12316	8405	26	161	44	0	8636
12317	184	28	66	8360	0	8638
12318	83	8477	50	153	0	8763
12319	71	117	60	8645	0	8893
12320	64	43	8625	149	0	8881
12321	8372	44	126	83	0	8625
12322	156	37	8770	56	0	9019
12323	95	27	8450	30	0	8602
12324	8303	17	144	39	0	8503
12325	154	8339	86	28	0	8607
12326	8533	128	50	28	0	8739
12327	8599	53	37	42	0	8731
12328	195	33	8390	37	0	8655
12329	8174	23	133	31	0	8361
12330	154	31	8117	48	0	8350
12331	81	13	7668	40	0	7802
12332	84	13	7671	35	0	7803
12333	48	7341	122	28	0	7539
12334	6553	76	200	33	0	6862
12335	6397	21	39	24	0	6481
12336	6391	8	15	10	0	6424
12337	6391	6	8	16	0	6421
12338	66	10	6389	8	0	6473
12339	35	8	43	6354	0	6440
12340	31	6	19	6397	0	6453
12341	6453	5	12	63	0	6533
12342	52	6419	9	34	0	6514
12343	26	38	12	6376	0	6452
12344	6361	14	10	51	0	6436
12345	44	12	6415	21	0	6492
12346	29	12	41	6485	0	6567
12347	16	12	6591	45	0	6664
12348	15	6534	52	27	0	6628
12349	26	64	24	6239	0	6353
12350	6240	15	14	58	0	6327
12351	64	8	8	6481	0	6561
12352	27	6	6509	63	0	6605
12353	15	6535	54	20	0	6624
12354	6468	60	22	25	0	6575
12355	79	20	6455	10	0	6564
12356	6267	10	71	22	0	6370
12357	74	6423	30	23	0	6550
12358	6609	75	16	16	0	6716
12359	6741	21	4	18	0	6784
12360	113	8	9	6784	0	6914
12361	44	4	6791	75	0	6914
12362	16	6873	78	32	0	6999
12363	22	78	25	7082	0	7207
12364	25	26	7	7236	0	7294
12365	20	6	8	7599	0	7633
12366	21	6	14	7827	0	7868
12367	8	8325	6	138	0	8477
12368	8475	127	6	55	0	8663
12369	139	8516	9	18	0	8682
12370	50	129	10	8718	0	8907
12371	8862	42	9	141	0	9054
12372	165	19	9	8866	0	9059
12373	55	21	8824	153	0	9053
12374	27	8849	132	76	0	9084
12375	28	134	42	8919	0	9123
12376	24	43	16	9141	0	9224
12377	8814	26	13	197	0	9050
12378	155	27	8750	65	0	8997
12379	8703	13	132	52	0	8900
12380	8815	17	40	54	0	8926
12381	8797	16	21	43	0	8877
12382	213	25	8673	25	0	8936
12383	73	28	149	8671	0	8921
12384	59	20	46	8787	0	8912
12385	45	28	8788	216	0	9077
12386	30	16	8877	94	0	9017
12387	9026	14	196	59	0	9295
12388	186	22	66	9227	0	9501
12389	9346	26	39	203	0	9614
12390	9623	17	21	97	0	9758
12391	250	15	20	9582	0	9867
12392	95	25	10034	206	0	10360
12393	9989	19	190	91	0	10289
12394	238	22	66	10244	0	10570
12395	108	11	10221	228	0	10568
12396	64	10114	205	99	0	10482
12397	10168	187	81	75	0	10511
12398	233	10270	51	61	0	10615
12399	119	220	31	9679	0	10049
12400	80	10384	44	198	0	10706
12401	10182	214	45	109	0	10550
12402	10378	61	40	106	0	10585
12403	277	10217	51	83	0	10628
12404	10253	212	38	79	0	10582
12405	10226	61	51	84	0	10422
12406	289	10015	52	83	0	10439
12407	10115	199	45	84	0	10443
12408	298	67	48	9983	0	10396
12409	151	44	50	10151	0	10396
12410	10017	36	53	275	0	10381
12411	303	38	44	9629	0	10014
12412	147	9794	54	227	0	10222
12413	9827	212	43	124	0	10206
12414	9903	86	51	91	0	10131
12415	293	9785	50	125	0	10253
12416	9892	216	53	68	0	10229
12417	10063	84	50	53	0	10250
12418	337	60	29	9767	0	10193
12419	164	42	9701	254	0	10161
12420	142	9684	200	114	0	10140
12421	9828	220	66	90	0	10204
12422	9883	80	50	91	0	10104
12423	341	65	9536	86	0	10028
12424	9594	46	205	88	0	9933
12425	295	58	9317	80	0	9750
12426	9431	67	212	72	0	9782
12427	303	69	64	9422	0	9858
12428	152	80	9356	229	0	9817
12429	130	69	9464	93	0	9756
12430	115	108	218	9312	0	9753
12431	133	72	73	9409	0	9687
12432	150	67	9077	259	0	9553
12433	133	57	209	9108	0	9507
12434	134	77	9171	242	0	9624
12435	148	64	217	9144	0	9573
12436	164	57	77	9144	0	9442
12437	142	8739	58	273	0	9212
12438	135	8769	57	142	0	9103
12439	121	9212	62	108	0	9503
12440	148	243	41	9187	0	9619
12441	128	83	42	9364	0	9617
12442	102	70	9057	294	0	9523
12443	8803	48	235	145	0	9231
12444	9227	53	86	101	0	9467
12445	302	8966	64	99	0	9431
12446	8980	205	55	85	0	9325
12447	295	79	61	8861	0	9296
12448	8968	45	69	258	0	9340
12449	9068	58	73	130	0	9329
12450	310	47	74	8845	0	9276
12451	8396	57	55	231	0	8739
12452	247	8204	59	105	0	8615
12453	126	8388	64	80	0	8658
12454	132	199	61	8058	0	8450
12455	94	8375	61	204	0	8734
12456	109	184	58	8155	0	8506
12457	116	63	49	8294	0	8522
12458	7997	36	64	223	0	8320
12459	206	7846	69	108	0	8229
12460	7713	145	55	103	0	8016
12461	7615	56	53	105	0	7829
12462	209	7524	49	87	0	7869
12463	7416	155	51	86	0	7708
12464	188	42	7227	102	0	7559
12465	76	6858	132	82	0	7148
12466	6576	117	43	63	0	6799
12467	123	48	6210	42	0	6423
12468	48	5788	92	37	0	5965
12469	50	5966	43	39	0	6098
12470	5720	92	68	29	0	5909
12471	5657	35	14	18	0	5724
12472	5651	21	12	29	0	5713
12473	102	5591	13	28	0	5734
12474	43	78	16	5721	0	5858
12475	5720	22	13	85	0	5840
12476	5744	26	16	33	0	5819
12477	108	22	11	5677	0	5818
12478	53	18	5729	77	0	5877
12479	40	22	5670	25	0	5757
12480	43	11	83	5788	0	5925
12481	37	14	24	5894	0	5969
12482	36	14	5847	88	0	5985
12483	36	11	79	5673	0	5799
12484	21	5751	26	85	0	5883
12485	5593	68	20	36	0	5717
12486	86	23	15	5508	0	5632
12487	5262	14	9	76	0	5361
12488	68	5248	18	39	0	5373
12489	26	5316	21	25	0	5388
12490	5225	45	18	30	0	5318
12491	56	8	5077	19	0	5160
12492	4404	17	38	8	0	4467
12493	25	4486	9	8	0	4528
12494	10	18	11	4312	0	4351
12495	4270	1	7	27	0	4305
12496	21	2	1	4244	0	4268
12497	4271	1	2	33	0	4307
12498	4218	0	3	6	0	4227
12499	17	4344	4	8	0	4373
12500	4267	9	1	6	0	4283
12501	11	4208	0	3	0	4222
12502	4256	12	4	7	0	4279
12503	14	2	1	4291	0	4308
12504	4380	1	4	16	0	4401
12505	14	1	1	4474	0	4490
12506	4630	2	1	20	0	4653
12507	4746	1	1	13	0	4761
12508	4785	2	3	10	0	4800
12509	4814	2	1	7	0	4824
12510	4844	1	0	4	0	4849
12511	15	2	0	4908	0	4925
12512	4812	2	1	20	0	4835
12513	17	4738	3	6	0	4764
12514	4	19	4779	2	0	4804
12515	5	3	18	4811	0	4837
12516	3	0	4934	17	0	4954
12517	6	0	14	5095	0	5115
12518	2	4	5173	22	0	5201
12519	5096	0	18	11	0	5125
12520	23	0	3	5227	0	5253
12521	4	1	5211	19	0	5235
12522	11	0	5355	6	0	5372
12523	6	6	25	5466	0	5503
12524	6048	0	5	36	0	6089
12525	28	6419	7	10	0	6464
12526	6532	34	3	15	0	6584
12527	6540	6	4	14	0	6564
12528	38	6552	2	8	0	6600
12529	6803	32	3	22	0	6860
12530	42	10	1	6846	0	6899
12531	17	4	1	6868	0	6890
12532	12	1	1	6915	0	6929
12533	6912	2	0	51	0	6965
12534	35	7028	4	16	0	7083
12535	13	47	2	7184	0	7246
12536	8	12	0	7293	0	7313
12537	7242	7	1	75	0	7325
12538	59	4	1	7282	0	7346
12539	19	5	7415	54	0	7493
12540	8	7631	56	17	0	7712
12541	7799	70	12	17	0	7898
12542	80	20	8	7697	0	7805
12543	22	7851	3	67	0	7943
12544	7876	73	4	30	0	7983
12545	83	20	7791	12	0	7906
12546	25	7784	63	14	0	7886
12547	7896	75	16	12	0	7999
12548	80	21	11	7815	0	7927
12549	30	11	8	7843	0	7892
12550	20	7	7794	86	0	7907
12551	17	6	67	7730	0	7820
12552	8	7	8147	90	0	8252
12553	10	6	7738	35	0	7789
12554	8	5	8073	24	0	8110
12555	8072	10	97	15	0	8194
12556	8193	6	35	13	0	8247
12557	8314	4	30	9	0	8357
12558	99	11	10	8184	0	8304
12559	44	8179	9	63	0	8295
12560	32	8319	2	21	0	8374
12561	8425	81	3	30	0	8539
12562	8393	30	11	24	0	8458
12563	75	8492	4	17	0	8588
12564	8419	71	12	16	0	8518
12565	86	24	8347	9	0	8466
12566	31	17	8313	3	0	8364
12567	41	7	77	7973	0	8098
12568	18	13	33	8333	0	8397
12569	19	5	8307	81	0	8412
12570	19	4	78	8185	0	8286
12571	8232	5	24	97	0	8358
12572	68	7	8202	33	0	8310
12573	8057	6	73	29	0	8165
12574	89	6	25	8213	0	8333
12575	28	11	8394	74	0	8507
12576	32	8436	71	23	0	8562
12577	8529	61	29	32	0	8651
12578	78	21	8367	15	0	8481
12579	8251	14	72	16	0	8353
12580	84	7	30	8330	0	8451
12581	8393	11	22	80	0	8506
12582	99	5	8665	29	0	8798
12583	48	5	75	8749	0	8877
12584	9034	4	26	91	0	9155
12585	9235	4	19	40	0	9298
12586	9459	7	13	37	0	9516
12587	9515	7	17	18	0	9557
12588	125	10	7	9198	0	9340
12589	59	5	7	9224	0	9295
12590	37	13	9146	112	0	9308
12591	40	6	82	9141	0	9269
12592	31	8	28	9065	0	9132
12593	16	9408	21	119	0	9564
12594	9523	87	19	46	0	9675
12595	9705	27	8	42	0	9782
12596	126	9904	7	33	0	10070
12597	53	104	11	9907	0	10075
12598	46	37	5	10030	0	10118
12599	9750	15	8	146	0	9919
12600	118	13	9984	53	0	10168
12601	41	11	104	10084	0	10240
12602	27	3	10169	128	0	10327
12603	9967	5	114	57	0	10143
12604	10143	7	40	30	0	10220
12605	10147	7	26	29	0	10209
12606	159	5	8	9910	0	10082
12607	68	7	15	9879	0	9969
12608	9810	8	5	140	0	9963
12609	130	5	9716	50	0	9901
12610	45	9	110	9739	0	9903
12611	9754	7	31	128	0	9920
12612	126	4	24	9759	0	9913
12613	46	4	10044	125	0	10219
12614	39	3	9649	47	0	9738
12615	9730	4	117	47	0	9898
12616	112	9906	51	25	0	10094
12617	9962	99	30	37	0	10128
12618	10118	25	17	25	0	10185
12619	141	12	10	10048	0	10211
12620	61	17	5	9990	0	10073
12621	34	9951	8	136	0	10129
12622	9789	94	13	56	0	9952
12623	110	9839	12	38	0	9999
12624	32	9544	12	31	0	9619
12625	29	108	13	9164	0	9314
12626	9149	30	6	99	0	9284
12627	9273	13	6	43	0	9335
12628	116	16	5	9123	0	9260
12629	46	9	8	8910	0	8973
12630	36	8	8	8884	0	8936
12631	8759	7	3	126	0	8895
12632	110	5	8729	51	0	8895
12633	40	8723	86	42	0	8891
12634	8561	71	22	30	0	8684
12635	99	30	16	8536	0	8681
12636	41	14	8498	86	0	8639
12637	35	12	8425	28	0	8500
12638	28	8427	85	32	0	8572
12639	18	8445	21	39	0	8523
12640	49	93	50	8098	0	8290
12641	15	7453	25	69	0	7562
12642	36	57	6	8051	0	8150
12643	24	19	11	8164	0	8218
12644	8188	15	4	86	0	8293
12645	72	7	7	8188	0	8274
12646	26	7	8	8273	0	8314
12647	22	11	8197	75	0	8305
12648	24	9	65	8284	0	8382
12649	8348	7	8	92	0	8455
12650	8409	7	16	35	0	8467
12651	84	8649	9	29	0	8771
12652	8402	68	10	35	0	8515
12653	93	17	8415	22	0	8547
12654	31	8431	75	21	0	8558
12655	24	90	18	8601	0	8733
12656	26	16	11	8738	0	8791
12657	20	11	18	8760	0	8809
12658	8710	10	6	117	0	8843
12659	8310	9	13	42	0	8374
12660	94	9	8563	26	0	8692
12661	40	10	8440	23	0	8513
12662	27	12	8531	22	0	8592
12663	19	8454	92	29	0	8594
12664	14	8654	26	22	0	8716
12665	8620	98	10	17	0	8745
12666	8642	24	8	19	0	8693
12667	98	17	11	8718	0	8844
12668	37	9	8	8626	0	8680
12669	116	8612	8	112	0	8848
12670	28	87	13	8879	0	9007
12671	8	28	8889	108	0	9033
12672	19	8988	92	26	0	9125
12673	26	95	16	9100	0	9237
12674	26	27	9426	105	0	9584
12675	29	17	99	8877	0	9022
12676	24	9318	19	116	0	9477
12677	9535	98	12	47	0	9692
12678	9605	22	13	35	0	9675
12679	9992	16	15	33	0	10056
12680	137	10	16	10042	0	10205
12681	53	14	10	10272	0	10349
12682	10194	15	7	147	0	10363
12683	130	10190	16	39	0	10375
12684	10236	130	10	37	0	10413
12685	146	24	10653	15	0	10838
12686	10676	14	138	29	0	10857
12687	11000	15	30	35	0	11080
12688	216	9	15	10882	0	11122
12689	11055	10	12	169	0	11246
12690	11350	13	13	52	0	11428
12691	199	15	11	11286	0	11511
12692	55	24	11102	156	0	11337
12693	10810	13	146	58	0	11027
12694	157	19	11205	26	0	11407
12695	48	11357	146	23	0	11574
12696	44	149	73	11441	0	11707
12697	34	33	15	11827	0	11909
12698	12399	14	13	207	0	12633
12699	185	19	12448	51	0	12703
12700	66	15	163	11925	0	12169
12701	33	12243	48	170	0	12494
12702	18	12240	26	41	0	12325
12703	40	201	17	12369	0	12627
12704	37	47	12195	180	0	12459
12705	39	28	165	12355	0	12587
12706	38	24	40	12377	0	12479
12707	29	21	12035	226	0	12311
12708	18	12266	157	72	0	12513
12709	12067	178	33	51	0	12329
12710	182	11736	25	630	0	12573
12711	60	172	25	12283	0	12540
12712	11899	47	25	200	0	12171
12713	164	11891	24	68	0	12147
12714	49	178	11837	40	0	12104
12715	11753	54	169	46	0	12022
12716	201	12147	40	21	0	12409
12717	12123	173	26	38	0	12360
12718	212	49	11794	38	0	12093
12719	11781	27	170	40	0	12018
12720	220	23	39	11868	0	12150
12721	60	22	11786	204	0	12072
12722	57	26	176	11515	0	11774
12723	48	11462	43	193	0	11746
12724	51	175	36	11688	0	11950
12725	49	46	31	11795	0	11921
12726	38	26	11482	239	0	11785
12727	51	30	165	11607	0	11853
12728	48	46	9829	234	0	10157
12729	56	11602	135	74	0	11867
12730	58	186	42	11606	0	11892
12731	44	67	11657	215	0	11983
12732	40	11545	190	92	0	11867
12733	51	11997	55	48	0	12151
12734	50	227	11823	39	0	12139
12735	50	67	11830	49	0	11996
12736	73	33	216	11680	0	12002
12737	11581	41	63	221	0	11906
12738	229	11577	41	90	0	11937
12739	84	193	41	11427	0	11745
12740	11383	59	31	218	0	11691
12741	229	11503	28	87	0	11847
12742	11412	195	31	83	0	11721
12743	228	11661	46	71	0	12006
12744	11683	204	38	61	0	11986
12745	11739	68	41	67	0	11915
12746	11917	57	42	68	0	12084
12747	284	12267	45	81	0	12677
12748	129	231	34	12358	0	12752
12749	107	72	12216	249	0	12644
12750	68	12180	228	115	0	12591
12751	108	239	65	11904	0	12316
12752	106	79	56	11984	0	12225
12753	66	59	11585	263	0	11973
12754	80	11426	211	114	0	11831
12755	11286	214	83	89	0	11672
12756	236	11229	45	100	0	11610
12757	97	216	56	11174	0	11543
12758	70	72	11197	230	0	11569
12759	11028	69	199	104	0	11400
12760	235	51	74	11279	0	11639
12761	74	55	11106	248	0	11483
12762	10730	57	216	103	0	11106
12763	229	10924	76	79	0	11308
12764	10922	222	56	92	0	11292
12765	11057	67	64	85	0	11273
12766	259	69	42	10939	0	11309
12767	93	54	10833	241	0	11221
12768	69	10835	206	105	0	11215
12769	62	221	10749	91	0	11123
12770	53	105	204	10552	0	10914
12771	49	86	78	10863	0	11076
12772	10505	57	66	274	0	10902
12773	216	55	10369	117	0	10757
12774	69	10004	194	88	0	10355
12775	66	200	73	9928	0	10267
12776	73	69	57	9951	0	10150
12777	9595	68	39	236	0	9938
12778	201	9653	32	103	0	9989
12779	93	177	33	9174	0	9477
12780	8931	72	33	204	0	9240
12781	168	8781	27	93	0	9069
12782	8410	162	32	38	0	8642
12783	8414	66	28	38	0	8546
12784	190	8193	30	43	0	8456
12785	7340	126	20	25	0	7511
12786	143	7314	19	45	0	7521
12787	7208	116	31	29	0	7384
12788	7182	40	24	31	0	7277
12789	137	7071	16	33	0	7257
12790	6710	111	19	36	0	6876
12791	6908	35	14	38	0	6995
12792	6898	27	20	30	0	6975
12793	144	34	6739	28	0	6945
12794	49	18	6259	28	0	6354
12795	38	17	6225	22	0	6302
12796	6093	39	144	25	0	6301
12797	103	16	5983	24	0	6126
12798	33	12	5265	11	0	5321
12799	39	22	86	4915	0	5062
12800	4956	6	35	65	0	5062
12801	66	10	5017	22	0	5115
12802	28	6	5196	17	0	5247
12803	27	9	77	5137	0	5250
12804	23	7	31	5210	0	5271
12805	22	14	15	5266	0	5317
12806	15	7	5190	89	0	5301
12807	23	10	67	5166	0	5266
12808	5137	8	26	82	0	5253
12809	71	5187	14	33	0	5305
12810	38	64	11	5205	0	5318
12811	24	26	10	5322	0	5382
12812	21	16	5393	89	0	5519
12813	15	5326	68	30	0	5439
12814	5342	65	29	22	0	5458
12815	75	5388	13	17	0	5493
12816	40	74	9	5381	0	5504
12817	24	28	5378	73	0	5503
12818	27	22	74	5613	0	5736
12819	28	13	31	5720	0	5792
12820	5811	13	15	112	0	5951
12821	99	5	14	5625	0	5743
12822	35	5652	21	95	0	5803
12823	27	5948	11	38	0	6024
12824	15	93	5974	29	0	6111
12825	5963	30	87	24	0	6104
12826	100	20	27	5994	0	6141
12827	51	18	19	5987	0	6075
12828	33	15	17	6018	0	6083
12829	5974	13	12	118	0	6117
12830	93	6045	11	60	0	6209
12831	6021	83	19	40	0	6163
12832	108	29	5825	23	0	5985
12833	45	23	5728	22	0	5818
12834	5938	14	106	29	0	6087
12835	115	16	59	5980	0	6170
12836	47	15	25	6100	0	6187
12837	32	9	26	6121	0	6188
12838	29	15	6085	125	0	6254
12839	6047	7	97	61	0	6212
12840	6164	15	35	44	0	6258
12841	6026	7	24	38	0	6095
12842	124	24	26	5906	0	6080
12843	50	8	5744	104	0	5906
12844	37	8	5615	49	0	5709
12845	29	8	5780	37	0	5854
12846	23	5547	120	30	0	5720
12847	68	89	92	5009	0	5258
12848	4981	21	24	72	0	5098
12849	62	14	5008	43	0	5127
12850	5071	8	68	36	0	5183
12851	77	8	36	5133	0	5254
12852	30	10	19	5126	0	5185
12853	27	5021	10	89	0	5147
12854	24	5109	10	40	0	5183
12855	18	5309	15	33	0	5375
12856	18	68	16	5350	0	5452
12857	5314	25	19	73	0	5431
12858	5323	14	15	47	0	5399
12859	85	6	5266	31	0	5388
12860	5188	12	65	26	0	5291
12861	78	13	5247	23	0	5361
12862	41	7	68	5260	0	5376
12863	27	10	5273	73	0	5383
12864	5285	9	75	38	0	5407
12865	81	3	25	5406	0	5515
12866	29	9	5615	75	0	5728
12867	24	10	5361	37	0	5432
12868	5430	13	73	29	0	5545
12869	5579	9	40	27	0	5655
12870	77	5711	17	27	0	5832
12871	48	58	14	5819	0	5939
12872	24	17	5820	67	0	5928
12873	25	13	5792	41	0	5871
12874	25	21	75	5844	0	5965
12875	5880	17	35	80	0	6012
12876	64	5862	20	37	0	5983
12877	34	57	11	6005	0	6107
12878	5999	18	18	68	0	6103
12879	79	10	12	6021	0	6122
12880	36	6029	18	76	0	6159
12881	32	50	13	6119	0	6214
12882	6118	21	15	78	0	6232
12883	67	15	16	6128	0	6226
12884	6100	10	15	79	0	6204
12885	63	6212	20	39	0	6334
12886	6268	51	20	32	0	6371
12887	70	19	6167	26	0	6282
12888	6035	13	66	22	0	6136
12889	6236	12	31	30	0	6309
12890	77	6280	31	30	0	6418
12891	35	62	14	6165	0	6276
12892	28	16	6149	65	0	6258
12893	23	21	5938	29	0	6011
12894	5808	26	68	32	0	5934
12895	5805	7	23	23	0	5858
12896	57	5798	16	21	0	5892
12897	27	5877	11	23	0	5938
12898	5849	38	14	19	0	5920
12899	47	5799	17	14	0	5877
12900	21	5948	15	20	0	6004
12901	25	37	12	5955	0	6029
12902	21	12	15	5824	0	5872
12903	15	12	5901	57	0	5985
12904	26	8	40	5874	0	5948
12905	5884	6	12	56	0	5958
12906	49	9	5877	19	0	5954
12907	26	7	5804	20	0	5857
12908	24	9	49	5855	0	5937
12909	23	10	15	5997	0	6045
12910	18	6	21	5992	0	6037
12911	25	12	5881	51	0	5969
12912	18	9	34	5655	0	5716
12913	15	9	15	5860	0	5899
12914	5787	6	16	43	0	5852
12915	38	5752	10	28	0	5828
12916	5711	33	8	16	0	5768
12917	42	11	5764	15	0	5832
12918	5167	4	16	11	0	5198
12919	18	5588	11	6	0	5623
12920	5376	8	7	9	0	5400
12921	7	5357	2	8	0	5374
12922	5224	12	11	6	0	5253
12923	9	5126	1	3	0	5139
12924	4	5161	1	2	0	5168
12925	17	12	10	5187	0	5226
12926	5240	3	1	11	0	5255
12927	5220	1	0	11	0	5232
12928	5266	0	2	8	0	5276
12929	6	3	5218	1	0	5228
12930	3	2	5125	3	0	5133
12931	4	2	7	5276	0	5289
12932	1	5260	2	5	0	5268
12933	0	5441	0	2	0	5443
12934	4	7	2	5328	0	5341
12935	5273	3	1	14	0	5291
12936	5256	1	0	10	0	5267
12937	5296	2	1	9	0	5308
12938	13	0	5277	2	0	5292
12939	8	0	9	5358	0	5375
12940	3	3	5460	11	0	5477
12941	5418	0	12	16	0	5446
12942	5565	0	6	5	0	5576
12943	19	3	5601	0	0	5623
12944	8	3	14	5589	0	5614
12945	5641	0	5	24	0	5670
12946	20	2	2	5798	0	5822
12947	7	3	2	5849	0	5861
12948	12	0	4	5979	0	5995
12949	6562	1	1	48	0	6612
12950	40	3	3	6869	0	6915
12951	7081	2	0	59	0	7142
12952	63	7475	0	20	0	7558
12953	25	62	3	7777	0	7867
12954	16	24	3	7827	0	7870
12955	14	12	0	7768	0	7794
12956	7696	3	2	113	0	7814
12957	80	1	2	7670	0	7753
12958	33	1	2	7744	0	7780
12959	7761	0	0	109	0	7870
12960	7827	1	1	47	0	7876
12961	7786	1	3	29	0	7819
12962	115	7	7595	10	0	7727
12963	50	3	7278	17	0	7348
12964	7697	0	91	23	0	7811
12965	90	2	31	7650	0	7773
12966	48	3	13	7444	0	7508
12967	7543	4	7	110	0	7664
12968	7427	2	4	49	0	7482
12969	7441	4	6	24	0	7475
12970	111	7271	4	17	0	7403
12971	7264	73	4	16	0	7357
12972	7195	20	4	22	0	7241
12973	109	7133	1	12	0	7255
12974	49	7253	1	18	0	7321
12975	37	83	3	7329	0	7452
12976	7431	30	4	88	0	7553
12977	7456	16	7	32	0	7511
12978	7434	4	3	25	0	7466
12979	140	5	1	7361	0	7507
12980	7353	8	5	94	0	7460
12981	104	3	7299	35	0	7441
12982	7221	6	74	27	0	7328
12983	105	6	7310	12	0	7433
12984	46	7	7163	13	0	7229
12985	32	4	93	7111	0	7240
12986	7183	2	43	96	0	7324
12987	93	4	15	7200	0	7312
12988	42	5	7243	99	0	7389
12989	30	10	7250	34	0	7324
12990	21	1	92	7227	0	7341
12991	7233	6	34	99	0	7372
12992	86	7381	15	41	0	7523
12993	48	71	5	7548	0	7672
12994	40	21	9	7693	0	7763
12995	24	15	7741	115	0	7895
12996	24	8	7655	51	0	7738
12997	35	7	102	7744	0	7888
12998	7797	11	39	118	0	7965
12999	99	8	7813	49	0	7969
13000	53	5	77	7764	0	7899
13001	56	10	30	7786	0	7882
13002	24	8	24	7868	0	7924
13003	7672	7	13	154	0	7846
13004	120	17	7182	60	0	7379
13005	54	7638	59	44	0	7795
13006	50	86	23	7825	0	7984
13007	28	29	7822	101	0	7980
13008	35	7657	92	56	0	7840
13009	36	7928	29	54	0	8047
13010	8016	96	24	39	0	8175
13011	109	8051	14	42	0	8216
13012	8183	98	11	36	0	8328
13013	130	33	8146	23	0	8332
13014	64	32	103	8246	0	8445
13015	8253	16	29	126	0	8424
13016	129	8445	25	55	0	8654
13017	61	106	8426	49	0	8642
13018	63	35	100	8025	0	8223
13019	43	8579	37	103	0	8762
13020	54	111	23	8859	0	9047
13021	8843	29	24	153	0	9049
13022	124	9100	17	59	0	9300
13023	9254	118	14	45	0	9431
13024	9449	40	18	45	0	9552
13025	172	26	9495	33	0	9726
13026	79	9867	133	32	0	10111
13027	71	150	46	10346	0	10613
13028	55	38	10693	160	0	10946
13029	42	38	11338	56	0	11474
13030	61	35	227	11677	0	12000
13031	11965	18	73	240	0	12296
13032	12055	17	50	76	0	12198
13033	309	19	36	11941	0	12305
13034	96	16	11967	250	0	12329
13035	57	12005	222	87	0	12371
13036	12306	219	61	65	0	12651
13037	12472	65	32	64	0	12633
13038	297	12411	24	47	0	12779
13039	12544	224	26	44	0	12838
13040	267	65	12279	37	0	12648
13041	12252	37	227	30	0	12546
13042	11923	28	69	49	0	12069
13043	287	16	12235	33	0	12571
13044	119	23	228	12116	0	12486
13045	66	23	12116	233	0	12438
13046	58	11676	236	105	0	12075
13047	45	11899	80	54	0	12078
13048	66	293	41	11364	0	11764
13049	38	64	11332	182	0	11616
13050	29	10768	174	63	0	11034
13051	23	10831	47	28	0	10929
13052	10125	203	65	40	0	10433
13053	10202	47	30	26	0	10305
13054	198	20	12	10196	0	10426
13055	64	18	23	10113	0	10218
13056	27	10237	17	168	0	10449
13057	10244	152	14	51	0	10461
13058	10340	41	12	42	0	10435
13059	182	10248	13	24	0	10467
13060	50	155	8	10329	0	10542
13061	32	45	10303	160	0	10540
13062	37	23	140	10303	0	10503
13063	10371	26	39	175	0	10611
13064	170	20	18	10464	0	10672
13065	72	14	11	10688	0	10785
13066	10633	17	18	208	0	10876
13067	177	16	14	10548	0	10755
13068	56	10604	13	170	0	10843
13069	37	155	15	10770	0	10977
13070	49	35	14	10917	0	11015
13071	38	24	13	10812	0	10887
13072	25	10729	15	198	0	10967
13073	32	160	20	10730	0	10942
13074	24	49	10603	193	0	10869
13075	38	26	149	10600	0	10813
13076	25	28	10551	183	0	10787
13077	21	10475	151	77	0	10724
13078	40	155	56	10651	0	10902
13079	42	51	28	10794	0	10915
13080	35	35	21	10826	0	10917
13081	39	20	19	10794	0	10872
13082	34	27	10561	222	0	10844
13083	30	10497	153	86	0	10766
13084	34	158	59	10752	0	11003
13085	29	60	10786	186	0	11061
13086	33	37	174	10873	0	11117
13087	10958	32	58	217	0	11265
13088	187	26	10611	89	0	10913
13089	10688	32	152	55	0	10927
13090	208	26	50	10938	0	11222
13091	96	23	10880	208	0	11207
13092	46	10792	182	82	0	11102
13093	64	174	55	10770	0	11063
13094	33	58	10988	211	0	11290
13095	34	10845	188	83	0	11150
13096	47	188	61	10956	0	11252
13097	10984	61	35	228	0	11308
13098	11236	36	38	90	0	11400
13099	11335	39	25	64	0	11463
13100	251	29	11166	57	0	11503
13101	100	11306	193	39	0	11638
13102	66	202	66	11398	0	11732
13103	58	66	41	12032	0	12197
13104	12066	39	37	278	0	12420
13105	223	12360	25	110	0	12718
13106	12480	225	31	71	0	12807
13107	12456	86	27	70	0	12639
13108	12647	52	27	66	0	12792
13109	307	38	12418	55	0	12818
13110	12404	36	228	55	0	12723
13111	285	31	64	12439	0	12819
13112	108	26	42	12531	0	12707
13113	12218	33	36	314	0	12601
13114	264	29	23	12097	0	12413
13115	89	12000	34	264	0	12387
13116	64	220	15	11925	0	12224
13117	11656	75	19	277	0	12027
13118	243	37	11569	108	0	11957
13119	79	11414	202	81	0	11776
13120	63	206	49	11237	0	11555
13121	11150	55	32	253	0	11490
13122	226	25	10976	87	0	11314
13123	92	202	203	10653	0	11150
13124	85	35	10603	250	0	10973
13125	77	26	10250	93	0	10446
13126	74	15	9942	61	0	10092
13127	43	23	9693	47	0	9806
13128	49	18	9305	40	0	9412
13129	8179	98	245	35	0	8557
13130	101	8211	58	24	0	8394
13131	7995	80	32	30	0	8137
13132	7969	27	19	22	0	8037
13133	104	7918	17	20	0	8059
13134	37	8059	16	16	0	8128
13135	8039	95	17	26	0	8177
13136	7999	27	15	28	0	8069
13137	116	20	9	7804	0	7949
13138	45	7893	9	85	0	8032
13139	7997	79	11	40	0	8127
13140	96	7969	11	13	0	8089
13141	43	82	12	8012	0	8149
13142	8077	33	10	88	0	8208
13143	8108	18	14	36	0	8176
13144	125	14	11	8070	0	8220
13145	42	12	11	8124	0	8189
13146	33	12	8024	109	0	8178
13147	37	8	78	7952	0	8075
13148	26	13	8021	98	0	8158
13149	28	15	87	7777	0	7907
13150	20	8	34	7928	0	7990
13151	7880	8	20	115	0	8023
13152	7870	8	18	56	0	7952
13153	108	15	7797	29	0	7949
13154	7708	9	82	31	0	7830
13155	109	11	29	7754	0	7903
13156	52	11	7804	89	0	7956
13157	40	9	91	7821	0	7961
13158	36	7	38	8247	0	8328
13159	26	12	8250	120	0	8408
13160	28	10	95	8403	0	8536
13161	25	15	8650	106	0	8796
13162	35	27	101	8923	0	9086
13163	9280	9	37	133	0	9459
13164	124	9390	27	52	0	9593
13165	9476	116	24	45	0	9661
13166	127	9573	25	29	0	9754
13167	9470	126	14	39	0	9649
13168	131	9479	17	29	0	9656
13169	9409	131	16	29	0	9585
13170	145	9507	18	23	0	9693
13171	67	135	13	9543	0	9758
13172	40	48	9502	131	0	9721
13173	40	35	9397	41	0	9513
13174	35	30	145	9471	0	9681
13175	9468	18	54	141	0	9681
13176	144	9603	42	54	0	9843
13177	65	122	21	9691	0	9899
13178	36	45	9625	136	0	9842
13179	31	32	9679	60	0	9802
13180	42	44	152	9311	0	9549
13181	15	9755	59	129	0	9958
13182	9707	127	36	61	0	9931
13183	129	49	9886	39	0	10103
13184	61	33	9585	37	0	9716
13185	34	9799	137	28	0	9998
13186	9694	126	86	39	0	9945
13187	9741	47	49	17	0	9854
13188	164	32	25	9648	0	9869
13189	9704	23	20	133	0	9880
13190	9594	16	27	53	0	9690
13191	154	9521	38	41	0	9754
13192	9521	110	24	33	0	9688
13193	143	42	9626	25	0	9836
13194	67	28	108	9380	0	9583
13195	46	21	53	9436	0	9556
13196	9281	16	34	149	0	9480
13197	121	9250	28	63	0	9462
13198	9139	109	25	46	0	9319
13199	126	9318	17	30	0	9491
13200	54	9257	19	17	0	9347
13201	65	119	9057	20	0	9261
13202	48	74	8775	21	0	8918
13203	8250	89	134	25	0	8498
13204	8315	26	69	16	0	8426
13205	103	18	8042	11	0	8174
13206	46	7658	57	11	0	7772
13207	35	7788	26	23	0	7872
13208	7765	77	37	18	0	7897
13209	7729	37	16	12	0	7794
13210	91	29	9	7754	0	7883
13211	7850	16	11	65	0	7942
13212	76	11	14	7794	0	7895
13213	38	13	7793	66	0	7910
13214	32	14	7430	45	0	7521
13215	7718	12	69	29	0	7828
13216	68	14	35	7720	0	7837
13217	36	8158	23	50	0	8267
13218	8335	57	14	39	0	8445
13219	8305	33	20	31	0	8389
13220	79	22	8349	17	0	8467
13221	8390	11	61	28	0	8490
13222	8563	14	40	17	0	8634
13223	95	13	24	8491	0	8623
13224	55	8388	18	64	0	8525
13225	37	8357	12	37	0	8443
13226	37	91	10	8782	0	8920
13227	41	42	14	8510	0	8607
13228	45	29	10	8717	0	8801
13229	31	19	8619	99	0	8768
13230	37	27	8314	50	0	8428
13231	37	16	89	8406	0	8548
13232	23	22	8512	74	0	8631
13233	22	12	8337	41	0	8412
13234	33	18	97	8326	0	8474
13235	21	18	8774	88	0	8901
13236	24	8670	86	51	0	8831
13237	9180	70	45	40	0	9335
13238	78	39	29	9046	0	9192
13239	42	9050	33	88	0	9213
13240	36	78	9293	36	0	9443
13241	31	41	86	9322	0	9480
13242	18	22	9618	98	0	9756
13243	35	23	99	9576	0	9733
13244	29	18	46	9874	0	9967
13245	20	27	10128	133	0	10308
13246	34	19	113	9947	0	10113
13247	25	9859	60	109	0	10053
13248	33	94	33	10355	0	10515
13249	28	49	10352	122	0	10551
13250	33	27	104	10272	0	10436
13251	10235	18	55	135	0	10443
13252	111	10274	32	68	0	10485
13253	69	113	28	10288	0	10498
13254	36	49	10454	116	0	10655
13255	24	10152	109	61	0	10346
13256	33	10373	43	42	0	10491
13257	33	130	10251	30	0	10444
13258	37	69	101	9764	0	9971
13259	35	57	54	9669	0	9815
13260	24	17	9663	142	0	9846
13261	14	9102	97	66	0	9279
13262	23	9154	50	37	0	9264
13263	8686	89	17	32	0	8824
13264	62	8668	9	29	0	8768
13265	8607	72	16	28	0	8723
13266	66	44	5	8431	0	8546
13267	8796	14	14	94	0	8918
13268	71	9	8778	45	0	8903
13269	8725	5	67	35	0	8832
13270	83	11	45	8942	0	9081
13271	34	8964	19	79	0	9096
13272	9046	68	11	50	0	9175
13273	75	72	21	9028	0	9196
13274	39	9020	17	79	0	9155
13275	15	9487	6	44	0	9552
13276	9383	84	27	30	0	9524
13277	9467	35	11	31	0	9544
13278	9563	13	5	35	0	9616
13279	95	13	17	9289	0	9414
13280	34	9107	15	72	0	9228
13281	14	9314	15	44	0	9387
13282	15	89	14	9348	0	9466
13283	9229	34	13	89	0	9365
13284	8783	12	11	64	0	8870
13285	9128	15	11	37	0	9191
13286	88	20	8819	20	0	8947
13287	47	24	8845	25	0	8941
13288	9405	18	85	33	0	9541
13289	79	17	34	9440	0	9570
13290	41	13	12	9558	0	9624
13291	25	15	17	9453	0	9510
13292	26	16	13	9558	0	9613
13293	17	16	9363	112	0	9508
13294	24	10	78	9261	0	9373
13295	14	13	9219	101	0	9347
13296	8805	18	82	74	0	8979
13297	75	9209	44	30	0	9358
13298	35	80	18	9415	0	9548
13299	24	40	14	9200	0	9278
13300	9129	12	21	131	0	9293
13301	9082	16	24	59	0	9181
13302	9104	22	7	48	0	9181
13303	9103	24	17	29	0	9173
13304	125	17	9030	30	0	9202
13305	50	21	8874	33	0	8978
13306	35	14	101	8992	0	9142
13307	9079	25	38	112	0	9254
13308	9038	22	25	68	0	9153
13309	120	17	8999	29	0	9165
13310	55	11	77	8878	0	9021
13311	8931	15	44	96	0	9086
13312	97	29	17	8916	0	9059
13313	56	25	8980	89	0	9150
13314	38	23	85	8913	0	9059
13315	8941	20	38	112	0	9111
13316	97	9444	19	60	0	9620
13317	9257	79	19	51	0	9406
13318	9404	39	16	61	0	9520
13319	9526	13	20	53	0	9612
13320	125	23	28	9433	0	9609
13321	9321	23	16	111	0	9471
13322	92	9691	16	55	0	9854
13323	68	10025	9	37	0	10139
13324	36	157	13	9937	0	10143
13325	10112	49	9	136	0	10306
13326	134	10619	6	64	0	10823
13327	12492	143	3	49	0	12687
13328	13461	59	15	49	0	13584
13329	322	13861	17	28	0	14228
13330	137	255	16	13955	0	14363
13331	88	104	9	14335	0	14536
13332	70	56	14218	344	0	14688
13333	104	40	254	14089	0	14487
13334	71	44	14120	315	0	14550
13335	48	13729	285	151	0	14213
13336	76	270	107	13863	0	14316
13337	13283	106	64	358	0	13811
13338	13557	48	55	175	0	13835
13339	357	42	48	13418	0	13865
13340	147	51	13056	327	0	13581
13341	12487	46	277	165	0	12975
13342	296	12521	112	113	0	13042
13343	145	12462	46	91	0	12744
13344	108	12760	42	77	0	12987
13345	114	315	49	12182	0	12660
13346	65	121	12379	274	0	12839
13347	62	80	257	12298	0	12697
13348	59	77	12325	280	0	12741
13349	50	70	12226	124	0	12470
13350	43	82	12481	75	0	12681
13351	66	56	342	12002	0	12466
13352	44	29	159	12530	0	12762
13353	39	28	123	12632	0	12822
13354	48	22	99	12454	0	12623
13355	12258	26	90	390	0	12764
13356	238	12238	84	182	0	12742
13357	12194	237	67	146	0	12644
13358	256	12403	47	138	0	12844
13359	116	259	37	12449	0	12861
13360	88	110	25	12801	0	13024
13361	12568	65	30	391	0	13054
13362	12820	68	28	178	0	13094
13363	12889	63	43	121	0	13116
13364	12829	59	24	107	0	13019
13365	12777	51	21	101	0	12950
13366	394	12480	19	91	0	12984
13367	12079	241	16	100	0	12436
13368	354	12063	17	71	0	12505
13369	11972	268	16	55	0	12311
13370	368	106	11838	50	0	12362
13371	197	95	236	11523	0	12051
13372	135	11907	78	228	0	12348
13373	123	271	51	11854	0	12299
13374	99	130	11735	265	0	12229
13375	118	99	236	11344	0	11797
13376	11087	71	100	317	0	11575
13377	267	11193	72	162	0	11694
13378	121	11459	59	131	0	11770
13379	83	328	11416	116	0	11943
13380	92	152	253	11134	0	11631
13381	70	11488	113	290	0	11961
13382	77	269	82	11690	0	12118
13383	66	136	11690	296	0	12188
13384	48	11511	250	170	0	11979
13385	52	285	11579	118	0	12034
13386	62	131	11582	104	0	11879
13387	86	98	314	11335	0	11833
13388	11377	90	142	300	0	11909
13389	270	67	109	11521	0	11967
13390	117	85	11560	298	0	12060
13391	98	84	290	11752	0	12224
13392	69	77	12080	309	0	12535
13393	56	68	12056	182	0	12362
13394	11988	57	385	163	0	12593
13395	12641	43	180	146	0	13010
13396	12734	43	154	146	0	13077
13397	359	45	12559	123	0	13086
13398	161	34	12689	107	0	12991
13399	137	26	401	12343	0	12907
13400	112	30	188	12655	0	12985
13401	12575	31	117	385	0	13108
13402	335	45	86	12616	0	13082
13403	162	42	12612	368	0	13184
13404	120	44	12435	188	0	12787
13405	92	12485	355	155	0	13087
13406	93	260	150	12738	0	13241
13407	94	115	12895	333	0	13437
13408	102	82	318	12855	0	13357
13409	12868	68	156	384	0	13476
13410	291	51	13101	191	0	13634
13411	167	39	341	13060	0	13607
13412	122	52	145	13356	0	13675
13413	118	35	13038	395	0	13586
13414	118	41	313	12938	0	13410
13415	104	33	12939	367	0	13443
13416	12255	44	339	193	0	12831
13417	307	42	165	12204	0	12718
13418	127	12112	110	334	0	12683
13419	12047	245	86	207	0	12585
13420	12089	102	97	146	0	12434
13421	353	11961	76	149	0	12539
13422	301	1074	103	10199	0	11677
13423	120	11081	65	242	0	11508
13424	104	11209	49	140	0	11502
13425	234	341	10482	106	0	11163
13426	105	10243	220	102	0	10670
13427	95	216	8184	87	0	8582
13428	6836	107	117	35	0	7095
13429	6922	14	33	32	0	7001
13430	64	6912	16	20	0	7012
13431	21	6917	18	15	0	6971
13432	12	7261	8	16	0	7297
13433	7516	71	11	20	0	7618
13434	89	28	14	7737	0	7868
13435	29	12	8351	83	0	8475
13436	9	8410	86	34	0	8539
13437	25	88	30	8685	0	8828
13438	20	31	10	8609	0	8670
13439	9	9623	12	115	0	9759
13440	10288	132	14	44	0	10478
13441	162	35	10531	15	0	10743
13442	84	22	165	11798	0	12069
13443	21	12994	45	212	0	13272
13444	13047	245	18	74	0	13384
13445	254	81	12961	28	0	13324
13446	79	12738	247	22	0	13086
13447	73	253	67	12783	0	13176
13448	34	78	12768	250	0	13130
13449	12570	34	266	79	0	12949
13450	274	29	77	12612	0	12992
13451	74	27	12656	260	0	13017
13452	33	12591	258	79	0	12961
13453	12392	256	74	66	0	12788
13454	236	12651	42	48	0	12977
13455	12620	275	32	41	0	12968
13456	12783	85	21	48	0	12937
13457	339	44	24	12476	0	12883
13458	105	12213	26	279	0	12623
13459	55	255	12413	81	0	12804
13460	57	71	240	12305	0	12673
13461	101	53	129	10954	0	11237
13462	62	33	37	12518	0	12650
13463	70	26	36	12474	0	12606
13464	53	24	32	12514	0	12623
13465	12257	21	28	381	0	12687
13466	12028	34	27	148	0	12237
13467	11999	28	25	115	0	12167
13468	305	11979	28	86	0	12398
13469	119	258	12150	54	0	12581
13470	78	81	12108	45	0	12312
13471	62	44	12349	38	0	12493
13472	54	56	339	11932	0	12381
13473	70	33	115	12273	0	12491
13474	62	33	70	12303	0	12468
13475	39	40	12029	352	0	12460
13476	29	11858	276	159	0	12322
13477	31	265	11936	95	0	12327
13478	53	93	12088	66	0	12300
13479	66	44	344	11876	0	12330
13480	40	68	12132	303	0	12543
13481	74	51	317	11889	0	12331
13482	11813	45	140	321	0	12319
13483	11937	46	76	143	0	12202
13484	345	45	11787	103	0	12280
13485	146	42	314	11722	0	12224
13486	99	47	11845	332	0	12323
13487	81	11880	315	135	0	12411
13488	11883	293	134	103	0	12413
13489	314	128	11878	76	0	12396
13490	151	11391	316	72	0	11930
13491	89	11429	140	91	0	11749
13492	81	11469	85	84	0	11719
13493	78	370	10917	85	0	11450
13494	105	188	316	10383	0	10992
13495	88	10649	132	268	0	11137
13496	86	321	96	10624	0	11127
13497	71	143	91	10814	0	11119
13498	10414	86	93	388	0	10981
13499	297	10435	86	202	0	11020
13500	10370	289	78	165	0	10902
13501	310	10161	75	151	0	10697
13502	159	10526	88	101	0	10874
13503	124	358	10300	91	0	10873
13504	113	176	294	10222	0	10805
13505	92	130	10275	306	0	10803
13506	101	10144	318	151	0	10714
13507	94	298	10065	131	0	10588
13508	87	134	10130	135	0	10486
13509	82	10119	375	128	0	10704
13510	9809	302	161	147	0	10419
13511	287	10019	115	167	0	10588
13512	10058	322	118	128	0	10626
13513	303	146	10101	128	0	10678
13514	135	84	10109	162	0	10490
13515	85	10027	390	143	0	10645
13516	9979	295	161	137	0	10572
13517	342	10021	121	128	0	10612
13518	159	293	127	10037	0	10616
13519	10146	144	114	315	0	10719
13520	347	93	10131	124	0	10695
13521	140	105	381	10114	0	10740
13522	10098	91	157	358	0	10704
13523	314	10086	147	168	0	10715
13524	133	292	122	10118	0	10665
13525	97	119	10018	358	0	10592
13526	9883	89	334	172	0	10478
13527	284	98	168	10013	0	10563
13528	106	78	9909	343	0	10436
13529	91	82	344	9647	0	10164
13530	64	9782	163	347	0	10356
13531	66	280	9761	194	0	10301
13532	116	105	297	9310	0	9828
13533	8985	85	120	311	0	9501
13534	319	65	117	8737	0	9238
13535	8039	65	88	276	0	8468
13536	258	7995	87	121	0	8461
13537	7685	249	103	77	0	8114
13538	250	118	7509	82	0	7959
13539	109	71	6676	78	0	6934
13540	57	56	5907	50	0	6070
13541	65	5638	264	79	0	6046
13542	151	43	295	3197	0	3686
13543	11	9	25	3128	0	3173
13544	9	4	9	3045	0	3067
13545	6	5	6	3133	0	3150
13546	2	5	3154	29	0	3190
13547	2965	7	22	14	0	3008
13548	21	3167	9	10	0	3207
13549	3165	22	9	6	0	3202
13550	28	3	2	3159	0	3192
13551	9	3159	4	27	0	3199
13552	9	24	2	3217	0	3252
13553	3210	5	5	27	0	3247
13554	22	3319	1	13	0	3355
13555	3340	23	5	8	0	3376
13556	3339	7	4	4	0	3354
13557	29	3	2	3412	0	3446
13558	7	5	3449	25	0	3486
13559	3395	7	24	6	0	3432
13560	24	7	4	3605	0	3640
13561	3642	7	3	28	0	3680
13562	3768	0	5	12	0	3785
13563	3757	1	2	12	0	3772
13564	32	5	3769	8	0	3814
13565	12	2	27	3722	0	3763
13566	3756	2	4	28	0	3790
13567	29	3	3916	6	0	3954
13568	6	3951	25	5	0	3987
13569	11	22	6	3695	0	3734
13570	5	3	4012	23	0	4043
13571	3	4	3991	6	0	4004
13572	5	8	28	3940	0	3981
13573	9	2	5	4116	0	4132
13574	3	1	5	4138	0	4147
13575	3	1	3	4080	0	4087
13576	4	4	4087	27	0	4122
13577	3	4108	23	11	0	4145
13578	6	24	4	4166	0	4200
13579	4179	3	5	22	0	4209
13580	4091	5	1	4	0	4101
13581	4119	1	2	13	0	4135
13582	22	6	4	4088	0	4120
13583	13	5	4	4043	0	4065
13584	6	3877	1	23	0	3907
13585	3	3996	5	12	0	4016
13586	10	27	0	3940	0	3977
13587	3942	8	6	24	0	3980
13588	3939	3	5	12	0	3959
13589	3901	2	2	7	0	3912
13590	3895	1	1	9	0	3906
13591	3908	2	4	4	0	3918
13592	19	3936	3	5	0	3963
13593	5	14	2	4007	0	4028
13594	4121	4	3	16	0	4144
13595	4129	5	2	10	0	4146
13596	20	2	0	4132	0	4154
13597	8	1	2	4152	0	4163
13598	8	2	4240	18	0	4268
13599	10	4	15	4125	0	4154
13600	5	1	4	4198	0	4208
13601	5	5	4369	17	0	4396
13602	8	5	13	4365	0	4391
13603	2	4426	4	20	0	4452
13604	7	12	4424	8	0	4451
13605	4	4449	11	4	0	4468
13606	3	15	2	4377	0	4397
13607	6	4	2	4462	0	4474
13608	4	4396	2	12	0	4414
13609	5	4437	2	6	0	4450
13610	4529	12	1	8	0	4550
13611	4473	3	2	5	0	4483
13612	17	2	4440	3	0	4462
13613	4530	3	11	16	0	4560
13614	4799	0	6	10	0	4815
13615	4817	2	2	7	0	4828
13616	4812	0	4	6	0	4822
13617	15	1	4693	4	0	4713
13618	7	3	4496	3	0	4509
13619	4832	2	11	7	0	4852
13620	15	4981	3	9	0	5008
13621	5	7	5025	4	0	5041
13622	5056	5	9	7	0	5077
13623	5112	0	5	3	0	5120
13624	16	3	5077	0	0	5096
13625	5164	3	12	5	0	5184
13626	17	4	3	5588	0	5612
13627	7	3	5750	15	0	5775
13628	5482	0	16	15	0	5513
13629	15	5826	5	9	0	5855
13630	5998	16	5	10	0	6029
13631	6641	7	2	23	0	6673
13632	27	3	3	6696	0	6729
13633	8	1	7	6692	0	6708
13634	11	3	4	6845	0	6863
13635	6903	2	3	32	0	6940
13636	7237	0	1	20	0	7258
13637	40	2	1	7252	0	7295
13638	14	1	2	7230	0	7247
13639	6	5	7153	38	0	7202
13640	6968	2	27	20	0	7017
13641	32	4	5	7314	0	7355
13642	12	5	6	7286	0	7309
13643	9	7193	2	38	0	7242
13644	12	26	2	7276	0	7316
13645	9	7	3	7278	0	7297
13646	7215	5	0	50	0	7270
13647	29	7269	1	30	0	7329
13648	15	33	1	7388	0	7437
13649	11	8	0	7412	0	7431
13650	10	6	0	7480	0	7496
13651	12	1	7416	48	0	7477
13652	11	2	33	7327	0	7373
13653	7343	1	8	48	0	7400
13654	43	4	7346	18	0	7411
13655	19	5	34	7459	0	7517
13656	8	3	11	7582	0	7604
13657	7545	2	7	54	0	7608
13658	7404	2	2	29	0	7437
13659	43	5	7392	16	0	7456
13660	6983	5	36	30	0	7054
13661	41	5	7297	9	0	7352
13662	7250	2	36	22	0	7310
13663	44	7678	8	24	0	7754
13664	7836	38	6	15	0	7895
13665	46	7895	4	16	0	7961
13666	8097	52	9	19	0	8177
13667	52	8079	4	16	0	8151
13668	19	55	1	8235	0	8310
13669	14	13	5	8230	0	8262
13670	10	11	0	8185	0	8206
13671	6	8018	1	71	0	8096
13672	12	58	2	8052	0	8124
13673	5	8100	4	66	0	8175
13674	9	54	5	8188	0	8256
13675	8244	15	2	73	0	8334
13676	8178	8	2	31	0	8219
13677	68	8116	5	12	0	8201
13678	27	59	2	8202	0	8290
13679	8162	15	5	70	0	8252
13680	61	8161	2	21	0	8245
13681	19	8240	2	25	0	8286
13682	8280	71	6	20	0	8377
13683	8370	19	3	20	0	8412
13684	75	8288	4	19	0	8386
13685	8314	62	5	18	0	8399
13686	76	20	3	8348	0	8447
13687	20	11	8661	76	0	8768
13688	8682	9	67	40	0	8798
13689	8835	6	14	28	0	8883
13690	99	9	8950	10	0	9068
13691	9045	7	73	28	0	9153
13692	9248	8	21	21	0	9298
13693	9671	6	15	28	0	9720
13694	114	9640	4	17	0	9775
13695	9739	89	3	28	0	9859
13696	9807	32	4	26	0	9869
13697	118	21	3	9801	0	9943
13698	62	12	4	9989	0	10067
13699	39	16	1	10099	0	10155
13700	10113	9	6	144	0	10272
13701	99	7	5	9966	0	10077
13702	10047	13	5	115	0	10180
13703	10141	8	7	56	0	10212
13704	142	8	5	10102	0	10257
13705	66	13	7	10406	0	10492
13706	52	7	6	10480	0	10545
13707	10502	14	4	156	0	10676
13708	121	10478	4	65	0	10668
13709	54	112	3	10719	0	10888
13710	50	27	8	10946	0	11031
13711	10834	23	5	178	0	11040
13712	10923	21	2	81	0	11027
13713	165	18	10651	42	0	10876
13714	111	9	10529	41	0	10690
13715	11230	13	144	44	0	11431
13716	167	18	50	11481	0	11716
13717	87	13	16	12757	0	12873
13718	50	27	12641	281	0	12999
13719	58	22	214	12528	0	12822
13720	46	12413	49	237	0	12745
13721	33	12877	29	97	0	13036
13722	12694	254	25	66	0	13039
13723	245	63	12551	51	0	12910
13724	82	12847	198	40	0	13167
13725	89	235	37	13012	0	13373
13726	1446	60	11451	242	0	13199
13727	90	30	196	12566	0	12882
13728	49	31	53	12803	0	12936
13729	49	17	12593	312	0	12971
13730	45	12542	226	114	0	12927
13731	65	218	56	12031	0	12370
13732	12063	54	25	279	0	12421
13733	12160	29	38	108	0	12335
13734	12138	31	26	64	0	12259
13735	321	11855	15	60	0	12251
13736	11691	214	33	54	0	11992
13737	272	71	29	11653	0	12025
13738	103	31	11431	253	0	11818
13739	11367	24	208	112	0	11711
13740	250	11568	46	73	0	11937
13741	87	216	40	11554	0	11897
13742	70	53	31	11611	0	11765
13743	59	11429	25	266	0	11779
13744	54	236	22	11727	0	12039
13745	57	60	34	11891	0	12042
13746	61	38	30	12057	0	12186
13747	11693	48	24	331	0	12096
13748	11747	35	30	153	0	11965
13749	283	44	11642	89	0	12058
13750	106	49	213	11664	0	12032
13751	84	37	63	11971	0	12155
13752	71	42	49	12035	0	12197
13753	11761	45	43	329	0	12178
13754	244	39	11507	146	0	11936
13755	11399	32	214	114	0	11759
13756	11724	26	65	110	0	11925
13757	306	23	47	11643	0	12019
13758	11632	33	53	285	0	12003
13759	294	36	11134	114	0	11578
13760	11331	29	186	123	0	11669
13761	285	12007	65	96	0	12453
13762	131	220	11705	74	0	12130
13763	105	86	11852	72	0	12115
13764	96	87	265	11723	0	12171
13765	79	39	11806	275	0	12199
13766	11392	45	252	124	0	11813
13767	253	11395	87	94	0	11829
13768	11429	218	36	104	0	11787
13769	257	64	58	11489	0	11868
13770	115	42	11413	258	0	11828
13771	80	44	11380	141	0	11645
13772	65	53	263	11500	0	11881
13773	11530	28	85	327	0	11970
13774	221	11292	53	164	0	11730
13775	93	11674	43	128	0	11938
13776	11567	286	45	110	0	12008
13777	264	11683	37	99	0	12083
13778	11714	225	57	70	0	12066
13779	284	99	32	11642	0	12057
13780	11645	35	34	277	0	11991
13781	273	37	57	11665	0	12032
13782	11696	32	53	278	0	12059
13783	277	25	53	11574	0	11929
13784	119	11494	68	248	0	11929
13785	11498	198	48	134	0	11878
13786	258	11412	48	107	0	11825
13787	111	207	10939	74	0	11331
13788	88	83	204	10469	0	10844
13789	89	10912	66	188	0	11255
13790	10540	209	46	84	0	10879
13791	10611	69	53	76	0	10809
13792	260	10363	46	69	0	10738
13793	85	217	10013	53	0	10368
13794	87	59	206	9678	0	10030
13795	71	9623	70	224	0	9988
13796	60	208	47	9935	0	10250
13797	83	64	38	10041	0	10226
13798	9665	51	29	270	0	10015
13799	232	9615	37	90	0	9974
13800	80	192	40	9662	0	9974
13801	9630	67	29	249	0	9975
13802	9677	33	30	101	0	9841
13803	9540	48	26	78	0	9692
13804	272	47	18	9330	0	9667
13805	9020	36	23	205	0	9284
13806	242	8959	21	72	0	9294
13807	8822	189	24	73	0	9108
13808	212	8870	25	75	0	9182
13809	8781	177	36	74	0	9068
13810	8692	62	24	65	0	8843
13811	272	83	23	8570	0	8948
13812	91	31	8773	199	0	9094
13813	87	34	8591	65	0	8777
13814	77	8681	146	33	0	8937
13815	8303	161	89	71	0	8624
13816	184	44	8168	27	0	8423
13817	6547	22	67	20	0	6656
13818	76	6593	17	13	0	6699
13819	27	6859	9	10	0	6905
13820	31	83	7	7182	0	7303
13821	14	7507	5	63	0	7589
13822	22	76	7751	23	0	7872
13823	23	49	80	7497	0	7649
13824	16	7883	35	81	0	8015
13825	22	95	13	7922	0	8052
13826	7927	37	11	104	0	8079
13827	99	21	8	8075	0	8203
13828	38	24	8191	109	0	8362
13829	27	8326	92	47	0	8492
13830	29	107	33	8248	0	8417
13831	26	40	20	8414	0	8500
13832	21	31	14	8476	0	8542
13833	8311	22	9	166	0	8508
13834	8287	10	11	75	0	8383
13835	135	22	8281	34	0	8472
13836	58	12	8187	29	0	8286
13837	34	8351	116	29	0	8530
13838	8478	104	46	27	0	8655
13839	117	40	24	8513	0	8694
13840	61	25	20	8557	0	8663
13841	41	23	10	8588	0	8662
13842	37	12	12	8607	0	8668
13843	31	14	8331	168	0	8544
13844	8199	13	98	80	0	8390
13845	128	9	39	9056	0	9232
13846	56	9	8991	141	0	9197
13847	9197	15	129	81	0	9422
13848	9934	13	54	50	0	10051
13849	202	17	10841	34	0	11094
13850	109	12	11278	22	0	11421
13851	51	12	236	11222	0	11521
13852	11292	13	91	217	0	11613
13853	11500	7	41	93	0	11641
13854	286	13	23	11284	0	11606
13855	119	8	36	11447	0	11610
13856	53	5	11405	258	0	11721
13857	51	24	205	11265	0	11545
13858	53	18	11356	235	0	11662
13859	10991	6	213	118	0	11328
13860	216	11408	96	81	0	11801
13861	11009	183	36	68	0	11296
13862	230	10999	38	39	0	11306
13863	10975	206	37	50	0	11268
13864	237	78	44	10747	0	11106
13865	119	27	24	10968	0	11138
13866	10924	30	22	281	0	11257
13867	11069	16	18	118	0	11221
13868	11142	27	20	64	0	11253
13869	11300	17	18	51	0	11386
13870	316	22	10997	41	0	11376
13871	10974	19	196	66	0	11255
13872	11304	19	81	51	0	11455
13873	11275	11	32	52	0	11370
13874	346	16	26	10997	0	11385
13875	10790	8	19	241	0	11058
13876	273	10713	46	103	0	11135
13877	168	189	31	10780	0	11168
13878	128	75	31	10966	0	11200
13879	103	30	10701	292	0	11126
13880	91	24	208	10549	0	10872
13881	89	10680	101	250	0	11120
13882	10663	210	42	132	0	11047
13883	261	10705	36	94	0	11096
13884	10782	217	38	96	0	11133
13885	275	93	48	10748	0	11164
13886	10665	47	33	272	0	11017
13887	270	10608	33	136	0	11047
13888	10735	211	31	96	0	11073
13889	10876	103	35	76	0	11090
13890	349	61	28	10666	0	11104
13891	172	51	22	10864	0	11109
13892	125	43	10627	317	0	11112
13893	115	49	203	10727	0	11094
13894	137	37	75	10847	0	11096
13895	108	26	10603	336	0	11073
13896	109	24	221	10724	0	11078
13897	97	34	10570	296	0	10997
13898	10576	25	235	142	0	10978
13899	285	22	111	10608	0	11026
13900	170	7	10400	284	0	10861
13901	10424	29	242	145	0	10840
13902	300	28	104	10540	0	10972
13903	155	31	10562	290	0	11038
13904	10629	22	231	156	0	11038
13905	287	17	108	10740	0	11152
13906	147	21	73	10891	0	11132
13907	10842	28	60	349	0	11279
13908	298	25	41	10816	0	11180
13909	167	28	57	10911	0	11163
13910	126	24	49	10626	0	10825
13911	104	10466	44	346	0	10960
13912	10129	194	36	181	0	10540
13913	10247	92	32	121	0	10492
13914	346	41	33	9937	0	10357
13915	9964	38	26	284	0	10312
13916	9969	21	21	200	0	10211
13917	10058	40	32	110	0	10240
13918	7888	57	50	157	0	8152
13919	9742	19	37	113	0	9911
13920	332	25	8868	99	0	9324
13921	169	26	8457	94	0	8746
13922	8294	27	212	86	0	8619
13923	254	8254	97	79	0	8684
13924	132	160	46	7988	0	8326
13925	88	65	7910	208	0	8271
13926	87	32	7857	98	0	8074
13927	118	111	217	7638	0	8084
13928	7613	34	173	218	0	8038
13929	208	26	51	7565	0	7850
13930	121	27	7524	198	0	7870
13931	7729	16	170	125	0	8040
13932	201	19	88	7821	0	8129
13933	141	14	43	7946	0	8144
13934	91	11	46	8011	0	8159
13935	79	7	30	7939	0	8055
13936	73	10	7678	263	0	8024
13937	88	20	148	7701	0	7957
13938	7639	13	67	221	0	7940
13939	192	11	7355	145	0	7703
13940	7448	13	148	110	0	7719
13941	7635	16	71	95	0	7817
13942	7669	20	39	75	0	7803
13943	7592	12	25	74	0	7703
13944	250	7326	34	82	0	7692
13945	111	6589	28	55	0	6783
13946	78	6737	36	46	0	6897
13947	6302	188	137	72	0	6699
13948	170	39	5858	50	0	6117
13949	4556	62	103	22	0	4743
13950	87	8	31	4320	0	4446
13951	4297	4	15	50	0	4366
13952	61	1	8	4268	0	4338
13953	4284	5	4	63	0	4356
13954	60	5	6	4262	0	4333
13955	33	9	4	4372	0	4418
13956	4153	5	10	71	0	4239
13957	54	4509	8	35	0	4606
13958	46	31	4438	18	0	4533
13959	21	4393	33	18	0	4465
13960	20	28	4189	13	0	4250
13961	20	56	40	3932	0	4048
13962	4014	8	41	26	0	4089
13963	22	3	3	3952	0	3980
13964	3925	3	5	27	0	3960
13965	23	4147	9	21	0	4200
13966	26	17	4224	8	0	4275
13967	15	4173	18	8	0	4214
13968	9	4190	12	6	0	4217
13969	3952	20	22	11	0	4005
13970	3824	8	7	7	0	3846
13971	20	3863	4	5	0	3892
13972	15	13	1	3908	0	3937
13973	8	8	1	3909	0	3926
13974	3901	3	3	29	0	3936
13975	13	2	3951	12	0	3978
13976	12	3	3833	7	0	3855
13977	9	2	20	3985	0	4016
13978	3	4	4041	17	0	4065
13979	3870	3	18	20	0	3911
13980	4037	1	10	11	0	4059
13981	23	4047	3	5	0	4078
13982	14	12	4149	5	0	4180
13983	13	10	15	4182	0	4220
13984	9	5	4380	14	0	4408
13985	6	3	17	4327	0	4353
13986	4415	3	8	29	0	4455
13987	21	4529	4	11	0	4565
13988	11	20	4707	5	0	4743
13989	7	4719	12	11	0	4749
13990	5	4904	8	8	0	4925
13991	4967	25	4	10	0	5006
13992	4809	12	5	10	0	4836
13993	27	5	4950	8	0	4990
13994	16	5048	17	8	0	5089
13995	11	19	11	5103	0	5144
13996	13	9	4	5092	0	5118
13997	7	4	4	5046	0	5061
13998	12	3	5155	30	0	5200
13999	5	8	18	5090	0	5121
14000	4	2	13	5260	0	5279
14001	5316	5	7	32	0	5360
14002	5293	8	1	22	0	5324
14003	5245	3	5	23	0	5276
14004	5153	2	4	15	0	5174
14005	5151	3	4	12	0	5170
14006	30	5112	4	6	0	5152
14007	5006	18	2	7	0	5033
14008	26	11	5001	4	0	5042
14009	18	13	16	4959	0	5006
14010	5033	3	13	19	0	5068
14011	20	5025	5	15	0	5065
14012	5121	19	1	11	0	5152
14013	5221	8	3	10	0	5242
14014	33	4	3	5253	0	5293
14015	16	4	2	5335	0	5357
14016	6	5570	7	29	0	5612
14017	7	24	4	5682	0	5717
14018	8	12	5904	31	0	5955
14019	8	4	33	5939	0	5984
14020	9	3	5981	40	0	6033
14021	5807	2	39	21	0	5869
14022	39	4	16	6072	0	6131
14023	23	2	6189	35	0	6249
14024	6	6000	35	25	0	6066
14025	4	6133	15	11	0	6163
14026	6123	46	12	8	0	6189
14027	47	14	1	6115	0	6177
14028	17	6	6356	34	0	6413
14029	5	6241	33	17	0	6296
14030	11	31	6311	5	0	6358
14031	6098	12	37	15	0	6162
14032	6179	5	13	8	0	6205
14033	6242	2	6	12	0	6262
14034	49	3	4	6226	0	6282
14035	19	7	6231	35	0	6292
14036	5	6234	34	16	0	6289
14037	11	33	17	6343	0	6404
14038	8	15	6281	32	0	6336
14039	6	11	6135	19	0	6171
14040	8	5	49	6292	0	6354
14041	6398	5	19	46	0	6468
14042	40	7	8	6396	0	6451
14043	19	5	8	6492	0	6524
14044	17	11	6528	47	0	6603
14045	10	6	37	6502	0	6555
14046	11	5	15	6538	0	6569
14047	8	8	6595	53	0	6664
14048	7	7	6470	20	0	6504
14049	11	4	51	6528	0	6594
14050	11	4	6647	42	0	6704
14051	14	6	40	6648	0	6708
14052	6672	5	18	60	0	6755
14053	38	6819	12	20	0	6889
14054	22	35	5	6960	0	7022
14055	16	9	6865	44	0	6934
14056	6275	7	44	40	0	6366
14057	37	6472	16	26	0	6551
14058	6565	37	13	23	0	6638
14059	43	15	10	6555	0	6623
14060	17	7	11	6584	0	6619
14061	6665	4	12	68	0	6749
14062	45	6	6698	19	0	6768
14063	6616	5	38	25	0	6684
14064	46	2	20	6781	0	6849
14065	6592	4	12	60	0	6668
14066	6579	9	7	29	0	6624
14067	59	6	7	6633	0	6705
14068	20	6771	11	54	0	6856
14069	6966	40	8	28	0	7042
14070	7048	15	9	26	0	7098
14071	72	11	7017	6	0	7106
14072	6964	4	53	14	0	7035
14073	64	3	20	7038	0	7125
14074	27	7101	13	51	0	7192
14075	32	47	8	6997	0	7084
14076	11	7061	10	59	0	7141
14077	7075	53	15	35	0	7178
14078	7284	22	9	23	0	7338
14079	83	12	5	7779	0	7879
14080	38	7	7703	74	0	7822
14081	20	7	7657	45	0	7729
14082	24	10	100	7974	0	8108
14083	8008	6	45	101	0	8160
14084	8449	3	20	69	0	8541
14085	129	8554	20	29	0	8732
14086	71	101	11	8550	0	8733
14087	32	46	8652	120	0	8850
14088	27	20	8819	61	0	8927
14089	37	32	179	9205	0	9453
14090	9739	8	72	166	0	9985
14091	190	9	24	9810	0	10033
14092	80	5	9679	202	0	9966
14093	9672	12	178	86	0	9948
14094	209	5	70	9653	0	9937
14095	85	10	47	9776	0	9918
14096	57	7	26	9714	0	9804
14097	32	9613	23	245	0	9913
14098	30	179	9591	98	0	9898
14099	25	68	9786	63	0	9942
14100	37	30	230	9729	0	10026
14101	22	14	9819	196	0	10051
14102	9659	9	208	98	0	9974
14103	215	10	77	9736	0	10038
14104	94	13	44	9826	0	9977
14105	45	14	35	9803	0	9897
14106	25	9742	34	283	0	10084
14107	9891	173	27	109	0	10200
14108	205	66	22	9869	0	10162
14109	9791	33	21	227	0	10072
14110	211	9784	28	101	0	10124
14111	9806	181	27	75	0	10089
14112	9617	70	34	74	0	9795
14113	9779	33	20	70	0	9902
14114	277	9466	17	51	0	9811
14115	118	9486	16	42	0	9662
14116	9154	226	51	48	0	9479
14117	207	9218	21	50	0	9496
14118	96	201	8859	40	0	9196
14119	54	8579	161	52	0	8846
14120	50	8881	62	51	0	9044
14121	8847	219	35	40	0	9141
14122	191	83	8728	36	0	9038
14123	85	63	8614	22	0	8784
14124	71	38	214	8533	0	8856
14125	8636	25	97	187	0	8945
14126	199	26	8624	81	0	8930
14127	99	29	176	8623	0	8927
14128	52	33	8247	191	0	8523
14129	40	33	8152	90	0	8315
14130	8028	31	229	54	0	8342
14131	194	31	8230	33	0	8488
14132	100	25	199	8055	0	8379
14133	71	31	80	8069	0	8251
14134	40	7933	54	219	0	8246
14135	47	8195	46	100	0	8388
14136	51	209	49	7991	0	8300
14137	55	91	8002	186	0	8334
14138	53	48	175	8003	0	8279
14139	47	35	86	8135	0	8303
14140	40	30	8106	246	0	8422
14141	25	30	186	8209	0	8450
14142	8235	23	102	231	0	8591
14143	189	29	8236	112	0	8566
14144	8187	32	201	87	0	8507
14145	218	23	109	8146	0	8496
14146	103	17	69	8371	0	8560
14147	62	8377	70	274	0	8783
14148	48	187	57	8468	0	8760
14149	65	82	42	8709	0	8898
14150	8523	43	51	316	0	8933
14151	212	29	43	8614	0	8898
14152	103	31	45	8715	0	8894
14153	8363	33	56	312	0	8764
14154	236	28	56	8411	0	8731
14155	109	25	40	8153	0	8327
14156	71	8242	49	299	0	8661
14157	8299	192	46	163	0	8700
14158	229	88	33	8339	0	8689
14159	108	56	31	8511	0	8706
14160	72	30	8228	319	0	8649
14161	65	38	204	8206	0	8513
14162	56	23	93	8386	0	8558
14163	8098	31	47	330	0	8506
14164	8231	36	35	176	0	8478
14165	271	34	41	8101	0	8447
14166	124	40	7839	259	0	8262
14167	71	7506	201	134	0	7912
14168	72	7721	91	100	0	7984
14169	78	235	71	7600	0	7984
14170	7601	86	50	239	0	7976
14171	218	52	29	7698	0	7997
14172	7711	35	15	264	0	8025
14173	243	28	27	7822	0	8120
14174	116	38	30	7867	0	8051
14175	7652	38	28	294	0	8012
14176	7682	47	15	148	0	7892
14177	288	7527	21	86	0	7922
14178	114	7722	25	66	0	7927
14179	59	211	22	6874	0	7166
14180	57	75	15	7049	0	7196
14181	58	39	6758	214	0	7069
14182	6325	33	150	103	0	6611
14183	160	6454	55	63	0	6732
14184	50	6096	27	40	0	6213
14185	5835	142	25	40	0	6042
14186	200	51	5756	32	0	6039
14187	66	29	5540	29	0	5664
14188	45	28	5092	33	0	5198
14189	22	4723	96	16	0	4857
14190	26	55	54	4243	0	4378
14191	16	10	5	4277	0	4308
14192	5	4	10	4319	0	4338
14193	4224	6	7	64	0	4301
14194	4226	5	10	23	0	4264
14195	60	4206	1	19	0	4286
14196	16	49	6	4279	0	4350
14197	9	15	4303	55	0	4382
14198	8	4319	46	24	0	4397
14199	4260	51	17	19	0	4347
14200	53	16	4258	11	0	4338
14201	3985	5	41	16	0	4047
14202	45	8	4209	12	0	4274
14203	23	23	39	4088	0	4173
14204	12	4225	10	43	0	4290
14205	4253	42	7	21	0	4323
14206	46	4330	7	9	0	4392
14207	4256	46	7	17	0	4326
14208	47	15	5	4242	0	4309
14209	16	7	4432	60	0	4515
14210	17	6	46	4633	0	4702
14211	14	4	14	4997	0	5029
14212	20	12	4945	84	0	5061
14213	4864	8	64	32	0	4968
14214	73	5069	19	22	0	5183
14215	5059	72	6	18	0	5155
14216	79	5167	4	20	0	5270
14217	23	77	8	5424	0	5532
14218	13	21	5400	88	0	5522
14219	6119	11	81	30	0	6241
14220	113	6312	17	28	0	6470
14221	45	117	14	6292	0	6468
14222	23	34	5	6588	0	6650
14223	6916	15	5	151	0	7087
14224	7338	15	10	54	0	7417
14225	161	7427	5	31	0	7624
14226	7846	139	11	26	0	8022
14227	7948	42	12	27	0	8029
14228	8083	18	11	28	0	8140
14229	246	22	8020	14	0	8302
14230	78	7805	146	23	0	8052
14231	38	8194	45	24	0	8301
14232	44	190	17	7842	0	8093
14233	32	52	20	8128	0	8232
14234	8013	32	9	202	0	8256
14235	167	8019	11	61	0	8258
14236	8094	163	6	43	0	8306
14237	187	54	9	7992	0	8242
14238	79	22	7	8168	0	8276
14239	7954	22	8	215	0	8199
14240	7921	20	13	77	0	8031
14241	220	19	7762	37	0	8038
14242	92	23	155	7678	0	7948
14243	45	13	7610	159	0	7827
14244	29	20	7528	62	0	7639
14245	32	21	7625	22	0	7700
14246	7323	39	219	37	0	7618
14247	161	14	69	7255	0	7499
14248	57	12	27	7299	0	7395
14249	45	11	23	7409	0	7488
14250	30	17	7299	191	0	7537
14251	40	9	145	7285	0	7479
14252	40	11	49	7445	0	7545
14253	7267	11	19	207	0	7504
14254	7356	13	21	72	0	7462
14255	7489	13	12	44	0	7558
14256	7480	17	20	39	0	7556
14257	237	15	12	7279	0	7543
14258	7339	16	20	174	0	7549
14259	209	18	17	7312	0	7556
14260	102	23	6925	180	0	7230
14261	7161	17	117	76	0	7371
14262	204	7163	39	52	0	7458
14263	94	150	24	7114	0	7382
14264	77	73	17	7138	0	7305
14265	50	7191	25	201	0	7467
14266	7179	168	20	86	0	7453
14267	198	7151	15	52	0	7416
14268	96	166	7076	47	0	7385
14269	61	67	7112	44	0	7284
14270	6990	29	192	48	0	7259
14271	7146	37	65	43	0	7291
14272	227	38	6951	40	0	7256
14273	6899	23	160	50	0	7132
14274	200	28	6906	50	0	7184
14275	6884	21	176	50	0	7131
14276	197	28	6910	54	0	7189
14277	119	27	6984	54	0	7184
14278	76	25	193	6695	0	6989
14279	69	29	77	6804	0	6979
14280	6911	23	57	220	0	7211
14281	6846	18	40	106	0	7010
14282	6957	27	45	75	0	7104
14283	7075	18	45	64	0	7202
14284	235	6819	40	61	0	7155
14285	133	143	35	6737	0	7048
14286	96	6854	43	174	0	7167
14287	93	146	40	6928	0	7207
14288	94	52	45	6924	0	7115
14289	87	35	38	6922	0	7082
14290	70	42	6663	231	0	7006
14291	6498	22	162	135	0	6817
14292	182	6391	78	102	0	6753
14293	106	6681	39	87	0	6913
14294	89	179	6665	69	0	7002
14295	96	72	157	6644	0	6969
14296	82	32	78	6704	0	6896
14297	6634	29	45	227	0	6935
14298	214	30	35	6584	0	6863
14299	118	30	42	6721	0	6911
14300	99	27	39	6780	0	6945
14301	72	28	45	6839	0	6984
14302	6576	17	50	255	0	6898
14303	6698	28	44	117	0	6887
14304	6722	21	68	83	0	6894
14305	252	15	51	6720	0	7038
14306	6726	22	41	218	0	7007
14307	235	18	39	6877	0	7169
14308	134	33	40	7101	0	7308
14309	95	23	6738	240	0	7096
14310	89	13	6449	108	0	6659
14311	68	13	6259	91	0	6431
14312	6214	19	208	71	0	6512
14313	198	33	97	5928	0	6256
14314	106	6088	61	168	0	6423
14315	6186	117	65	79	0	6447
14316	205	47	6017	67	0	6336
14317	5729	29	142	67	0	5967
14318	180	5531	74	59	0	5844
14319	4838	77	31	40	0	4986
14320	123	39	30	4855	0	5047
14321	4804	15	19	101	0	4939
14322	124	4600	20	53	0	4797
14323	61	4541	24	29	0	4655
14324	4050	78	22	26	0	4176
14325	77	4131	16	23	0	4247
14326	22	3612	14	12	0	3660
14327	27	3696	16	15	0	3754
14328	3527	56	66	6	0	3655
14329	3435	25	3	11	0	3474
14330	3450	17	2	7	0	3476
14331	57	14	0	3389	0	3460
14332	26	8	2	3443	0	3479
14333	20	7	3403	46	0	3476
14334	20	6	32	3407	0	3465
14335	16	9	3450	45	0	3520
14336	19	5	42	3455	0	3521
14337	14	2	10	3533	0	3559
14338	3503	1	12	53	0	3569
14339	3480	8	6	20	0	3514
14340	44	3472	7	22	0	3545
14341	28	35	8	3468	0	3539
14342	14	16	3556	41	0	3627
14343	11	17	37	3556	0	3621
14344	11	11	12	3609	0	3643
14345	22	4	10	3630	0	3666
14346	15	3	3545	56	0	3619
14347	13	8	3382	29	0	3432
14348	3469	2	39	25	0	3535
14349	41	3	21	3558	0	3623
14350	25	2	3536	42	0	3605
14351	3403	5	35	29	0	3472
14352	39	3567	22	17	0	3645
14353	3590	29	15	21	0	3655
14354	46	9	3702	14	0	3771
14355	3679	11	28	9	0	3727
14356	41	10	13	3754	0	3818
14357	19	8	3822	30	0	3879
14358	16	3774	26	16	0	3832
14359	3837	27	19	13	0	3896
14360	31	14	13	3825	0	3883
14361	22	12	7	3846	0	3887
14362	14	3880	3	37	0	3934
14363	10	22	13	3905	0	3950
14364	9	12	3897	36	0	3954
14365	12	3863	23	21	0	3919
14366	3873	25	14	23	0	3935
14367	25	12	17	3842	0	3896
14368	25	12	6	3831	0	3874
14369	12	13	3801	37	0	3863
14370	20	6	24	3808	0	3858
14371	9	12	3959	34	0	4014
14372	17	3992	27	16	0	4052
14373	4003	19	16	23	0	4061
14374	3990	9	17	18	0	4034
14375	3987	19	9	13	0	4028
14376	41	4178	6	14	0	4239
14377	23	21	8	4213	0	4265
14378	22	12	5	4204	0	4243
14379	19	20	11	3642	0	3692
14380	4166	6	6	51	0	4229
14381	4146	4	9	31	0	4190
14382	33	12	2	4142	0	4189
14383	27	4	4406	32	0	4469
14384	20	4	23	4391	0	4438
14385	13	8	9	4424	0	4454
14386	11	3	16	4404	0	4434
14387	14	0	8	4406	0	4428
14388	4425	3	8	49	0	4485
14389	24	10	5	4495	0	4534
14390	19	1	8	4500	0	4528
14391	19	4481	4	42	0	4546
14392	17	23	3	4593	0	4636
14393	5	4646	2	48	0	4701
14394	10	32	3	4674	0	4719
14395	4645	17	1	46	0	4709
14396	27	4688	5	29	0	4749
14397	4667	31	2	25	0	4725
14398	44	13	4723	18	0	4798
14399	19	13	25	4662	0	4719
14400	15	8	4802	34	0	4859
14401	11	6	32	4780	0	4829
14402	8	12	13	4787	0	4820
14403	7	4730	12	46	0	4795
14404	7	4760	9	31	0	4807
14405	11	4799	4	14	0	4828
14406	4760	21	4	21	0	4806
14407	16	4544	3	9	0	4572
14408	4	4498	3	10	0	4515
14409	42	14	7	4551	0	4614
14410	4586	10	1	19	0	4616
14411	12	4834	0	11	0	4857
14412	4944	11	2	17	0	4974
14413	4943	4	2	6	0	4955
14414	17	6	5099	6	0	5128
14415	14	2	10	5045	0	5071
14416	11	4	3	5140	0	5158
14417	2	6	9	5174	0	5191
14418	3	1	3	5113	0	5120
14419	3	5	4947	21	0	4976
14420	5	6	4531	12	0	4554
14421	4604	5	9	8	0	4626
14422	10	4780	7	4	0	4801
14423	2	4814	5	4	0	4825
14424	4852	11	1	6	0	4870
14425	10	4545	2	209	0	4766
14426	5	15	1	4799	0	4820
14427	4819	4	0	16	0	4839
14428	13	5	4802	4	0	4824
14429	5	5	9	4862	0	4881
14430	11	2	4880	14	0	4907
14431	4789	2	14	11	0	4816
14432	13	4	5307	9	0	5333
14433	5367	2	17	16	0	5402
14434	5612	0	7	15	0	5634
14435	5591	2	9	8	0	5610
14436	5629	5	1	6	0	5641
14437	5640	5	1	8	0	5654
14438	26	2	1	5654	0	5683
14439	5838	3	1	22	0	5864
14440	22	2	1	5880	0	5905
14441	14	1	1	5887	0	5903
14442	12	1	2	5890	0	5905
14443	5	2	5888	27	0	5922
14444	4	2	15	5790	0	5811
14445	8	0	5	5977	0	5990
14446	5	6	5909	18	0	5938
14447	5551	3	16	20	0	5590
14448	17	1	3	5993	0	6014
14449	10	3	6002	16	0	6031
14450	8	2	5842	8	0	5860
14451	9	8	16	5890	0	5923
14452	12	3	5992	14	0	6021
14453	7	11	20	6009	0	6047
14454	8	2	7	5936	0	5953
14455	3	5909	9	17	0	5938
14456	2	5958	5	16	0	5981
14457	6018	13	5	16	0	6052
14458	15	8	2	6054	0	6079
14459	9	6	0	5981	0	5996
14460	14	2	3	6102	0	6121
14461	7	3	6135	24	0	6169
14462	14	1	11	6026	0	6052
14463	6091	0	7	29	0	6127
14464	21	1	6201	7	0	6230
14465	10	0	13	6359	0	6382
14466	14	0	8	6372	0	6394
14467	9	1	7	6525	0	6542
14468	5	6825	5	29	0	6864
14469	6886	28	1	26	0	6941
14470	7183	12	3	18	0	7216
14471	54	7247	4	6	0	7311
14472	30	41	0	7547	0	7618
14473	12	17	7564	57	0	7650
14474	10	7	7423	21	0	7461
14475	7752	31	82	24	0	7889
14476	72	5	39	7865	0	7981
14477	8085	2	16	88	0	8191
14478	90	8234	11	29	0	8364
14479	28	8409	6	22	0	8465
14480	8396	104	5	22	0	8527
14481	86	8659	6	20	0	8771
14482	43	100	6	8745	0	8894
14483	39	38	5	8536	0	8618
14484	16	9089	5	98	0	9208
14485	9170	109	6	45	0	9330
14486	108	44	9300	30	0	9482
14487	9145	28	100	30	0	9303
14488	137	19	9498	16	0	9670
14489	9064	23	127	25	0	9239
14490	151	21	9604	19	0	9795
14491	66	9456	136	12	0	9670
14492	58	144	52	9495	0	9749
14493	9458	46	37	152	0	9693
14494	139	24	9379	37	0	9579
14495	59	17	9402	24	0	9502
14496	59	13	159	9197	0	9428
14497	24	17	9384	131	0	9556
14498	41	14	137	9210	0	9402
14499	50	13	64	9063	0	9190
14500	25	14	9237	159	0	9435
14501	37	4	145	9152	0	9338
14502	9272	11	70	153	0	9506
14503	133	9185	40	70	0	9428
14504	9288	116	38	59	0	9501
14505	149	49	25	9160	0	9383
14506	9184	26	32	161	0	9403
14507	9349	10	33	80	0	9472
14508	193	12	34	9160	0	9399
14509	81	9217	40	131	0	9469
14510	9290	116	26	84	0	9516
14511	155	45	8978	45	0	9223
14512	69	27	8873	43	0	9012
14513	8828	14	163	56	0	9061
14514	153	16	71	8764	0	9004
14515	75	17	8777	144	0	9013
14516	67	17	139	8767	0	8990
14517	8808	19	59	176	0	9062
14518	8949	14	46	82	0	9091
14519	8920	15	23	76	0	9034
14520	194	9005	29	46	0	9274
14521	102	121	24	9107	0	9354
14522	75	44	24	9165	0	9308
14523	9069	38	18	190	0	9315
14524	165	9010	18	85	0	9278
14525	9052	136	28	49	0	9265
14526	179	46	23	8952	0	9200
14527	8937	33	21	164	0	9155
14528	178	28	8670	77	0	8953
14529	80	8704	135	56	0	8975
14530	80	150	48	8368	0	8646
14531	61	8848	29	119	0	9057
14532	66	140	24	8497	0	8727
14533	8445	55	23	150	0	8673
14534	155	48	8195	66	0	8464
14535	8039	26	127	73	0	8265
14536	150	8329	55	57	0	8591
14537	86	136	24	8442	0	8688
14538	71	65	23	8574	0	8733
14539	8304	36	24	188	0	8552
14540	159	28	8226	90	0	8503
14541	88	30	129	8248	0	8495
14542	65	27	60	8258	0	8410
14543	53	34	42	8245	0	8374
14544	44	29	26	8321	0	8420
14545	8111	35	23	214	0	8383
14546	8136	24	26	129	0	8315
14547	191	25	8093	72	0	8381
14548	99	18	7959	61	0	8137
14549	8157	22	169	72	0	8420
14550	8436	26	66	68	0	8596
14551	194	23	42	8376	0	8635
14552	102	17	42	8378	0	8539
14553	8227	11	44	216	0	8498
14554	162	8169	44	96	0	8471
14555	85	119	34	8218	0	8456
14556	77	40	34	8349	0	8500
14557	52	34	8116	211	0	8413
14558	62	15	128	8193	0	8398
14559	67	18	8157	187	0	8429
14560	66	16	150	8175	0	8407
14561	8066	17	76	192	0	8351
14562	164	10	48	8126	0	8348
14563	91	11	8041	192	0	8335
14564	65	7783	137	100	0	8085
14565	52	130	63	8023	0	8268
14566	49	49	7972	174	0	8244
14567	59	7979	140	98	0	8276
14568	58	163	64	7764	0	8049
14569	44	52	7717	157	0	7970
14570	6745	32	112	103	0	6992
14571	118	7263	58	79	0	7518
14572	55	6948	43	49	0	7095
14573	38	7151	37	54	0	7280
14574	76	173	38	6816	0	7103
14575	40	48	7082	118	0	7288
14576	31	7062	95	72	0	7260
14577	67	255	61	6872	0	7255
14578	7370	38	36	135	0	7579
14579	137	32	26	9354	0	9549
14580	60	25	10901	218	0	11204
14581	32	11056	235	90	0	11413
14582	10834	241	69	85	0	11229
14583	245	10921	56	73	0	11295
14584	98	265	10338	42	0	10743
14585	53	10395	242	69	0	10759
14586	90	324	101	9991	0	10506
14587	42	127	10036	208	0	10413
14588	50	9939	242	62	0	10293
14589	80	285	83	9659	0	10107
14590	59	141	75	9715	0	9990
14591	11	9806	80	280	0	10177
14592	34	293	61	9840	0	10228
14593	22	129	9793	312	0	10256
14594	15	96	9932	140	0	10183
14595	35	107	277	9841	0	10260
14596	9728	73	107	341	0	10249
14597	9865	74	85	173	0	10197
14598	277	68	83	9641	0	10069
14599	92	9724	90	305	0	10211
14600	101	236	102	9742	0	10181
14601	9663	90	97	311	0	10161
14602	298	69	40	9673	0	10080
14603	173	61	29	9836	0	10099
14604	9588	62	31	374	0	10055
14605	266	9536	41	186	0	10029
14606	115	266	26	9599	0	10006
14607	9489	88	30	355	0	9962
14608	301	77	9278	176	0	9832
14609	9324	51	213	187	0	9775
14610	319	69	69	9415	0	9872
14611	9433	72	45	317	0	9867
14612	9525	64	56	166	0	9811
14613	9065	55	46	159	0	9325
14614	356	9167	68	152	0	9743
14615	213	219	9170	95	0	9697
14616	183	9262	225	103	0	9773
14617	9253	246	79	118	0	9696
14618	347	9219	51	81	0	9698
14619	212	283	55	9183	0	9733
14620	8997	141	54	256	0	9448
14621	296	9014	57	100	0	9467
14622	139	317	8969	89	0	9514
14623	149	154	220	9009	0	9532
14624	140	133	8971	267	0	9511
14625	107	8992	250	200	0	9549
14626	123	292	108	8877	0	9400
14627	105	137	93	9103	0	9438
14628	80	130	93	9119	0	9422
14629	71	94	105	8908	0	9178
14630	45	8876	82	384	0	9387
14631	8747	271	77	223	0	9318
14632	253	155	8705	191	0	9304
14633	107	99	238	8862	0	9306
14634	8733	78	93	382	0	9286
14635	266	94	8738	230	0	9328
14636	140	8610	268	154	0	9172
14637	148	307	117	8479	0	9051
14638	128	134	8623	301	0	9186
14639	94	8619	305	180	0	9198
14640	8364	268	138	180	0	8950
14641	280	8614	121	128	0	9143
14642	131	336	113	8516	0	9096
14643	96	196	92	8778	0	9162
14644	8475	153	91	388	0	9107
14645	274	8555	94	204	0	9127
14646	148	339	82	8610	0	9179
14647	8424	184	76	369	0	9053
14648	8412	158	64	224	0	8858
14649	324	8279	65	224	0	8892
14650	8303	311	45	191	0	8850
14651	8456	182	43	154	0	8835
14652	401	152	59	8203	0	8815
14653	233	143	8053	340	0	8769
14654	245	86	235	8053	0	8619
14655	204	119	98	8233	0	8654
14656	184	106	7936	405	0	8631
14657	166	7882	266	220	0	8534
14658	154	275	111	7987	0	8527
14659	115	130	120	8232	0	8597
14660	93	95	123	8296	0	8607
14661	111	93	100	8061	0	8365
14662	100	7884	92	464	0	8540
14663	7961	287	75	280	0	8603
14664	8013	140	52	249	0	8454
14665	7880	110	39	249	0	8278
14666	346	7523	30	269	0	8168
14667	222	280	38	7523	0	8063
14668	174	156	7388	363	0	8081
14669	201	155	227	7272	0	7855
14670	199	7496	72	331	0	8098
14671	7353	274	53	185	0	7865
14672	7381	140	53	181	0	7755
14673	7299	130	66	180	0	7675
14674	338	7042	79	151	0	7610
14675	200	6614	88	142	0	7044
14676	171	6854	81	115	0	7221
14677	214	295	6483	108	0	7100
14678	194	239	5902	126	0	6461
14679	256	757	222	2862	0	4097
14680	2050	16	110	35	0	2211
14681	1973	5	4	17	0	1999
14682	28	8	2	2035	0	2073
14683	13	1	4	2029	0	2047
14684	9	3	2	2081	0	2095
14685	13	4	1	2083	0	2101
14686	2085	7	1	41	0	2134
14687	2132	3	3	26	0	2164
14688	42	2195	4	9	0	2250
14689	2220	27	2	13	0	2262
14690	2250	16	1	7	0	2274
14691	2270	5	0	7	0	2282
14692	46	10	1921	6	0	1983
14693	2188	7	15	6	0	2216
14694	38	2256	9	6	0	2309
14695	18	34	3	2324	0	2379
14696	10	13	2	2350	0	2375
14697	8	2282	9	50	0	2349
14698	6	36	7	2387	0	2436
14699	2367	12	1	53	0	2433
14700	40	7	1	2408	0	2456
14701	22	5	2379	41	0	2447
14702	2328	3	31	28	0	2390
14703	38	2472	10	16	0	2536
14704	22	35	3	2493	0	2553
14705	13	14	5	2510	0	2542
14706	14	8	1	2520	0	2543
14707	10	8	2476	53	0	2547
14708	11	2436	35	27	0	2509
14709	10	37	11	2460	0	2518
14710	10	13	2419	43	0	2485
14711	9	9	37	2387	0	2442
14712	7	8	2397	45	0	2457
14713	6	6	35	2357	0	2404
14714	8	2371	16	38	0	2433
14715	6	34	7	2325	0	2372
14716	2332	14	5	45	0	2396
14717	2345	8	3	19	0	2375
14718	49	10	2327	10	0	2396
14719	18	3	2255	12	0	2288
14720	7	5	2520	8	0	2540
14721	7	3	44	2511	0	2565
14722	5	3	22	2621	0	2651
14723	8	5	7	2653	0	2673
14724	4	2679	9	54	0	2746
14725	7	39	6	2666	0	2718
14726	6	14	3	2759	0	2782
14727	6	4	7	2816	0	2833
14728	2784	4	4	65	0	2857
14729	2829	4	5	24	0	2862
14730	54	5	2810	17	0	2886
14731	20	9	2784	10	0	2823
14732	2817	5	51	9	0	2882
14733	2910	1	21	12	0	2944
14734	56	4	2941	14	0	3015
14735	16	3	2874	10	0	2903
14736	2872	3	48	12	0	2935
14737	2921	5	15	13	0	2954
14738	52	3	2982	13	0	3050
14739	18	6	40	2963	0	3027
14740	15	5	11	3053	0	3084
14741	10	3182	8	53	0	3253
14742	7	39	8	3255	0	3309
14743	11	15	3447	52	0	3525
14744	14	7	48	3455	0	3524
14745	12	2	19	3514	0	3547
14746	8	5	3452	61	0	3526
14747	3358	1	54	26	0	3439
14748	3502	2	20	14	0	3538
14749	66	3	8	3450	0	3527
14750	22	2	12	3502	0	3538
14751	3463	5	10	67	0	3545
14752	3489	5	6	30	0	3530
14753	3320	3	9	26	0	3358
14754	3494	5	6	22	0	3527
14755	64	3396	9	11	0	3480
14756	3351	46	10	12	0	3419
14757	55	3356	7	17	0	3435
14758	19	48	13	3354	0	3434
14759	17	13	9	3325	0	3364
14760	18	3290	3	57	0	3368
14761	15	45	7	3333	0	3400
14762	12	11	5	3325	0	3353
14763	11	3297	7	65	0	3380
14764	14	49	3	3331	0	3397
14765	15	16	5	3349	0	3385
14766	16	5	5	3369	0	3395
14767	14	7	3296	66	0	3383
14768	12	3198	46	24	0	3280
14769	14	59	14	3089	0	3176
14770	9	3179	8	49	0	3245
14771	3137	48	9	24	0	3218
14772	46	20	3121	20	0	3207
14773	20	11	3030	22	0	3083
14774	2953	4	43	24	0	3024
14775	52	17	17	3018	0	3104
14776	14	8	2943	44	0	3009
14777	11	5	2891	23	0	2930
14778	16	25	39	2835	0	2915
14779	2814	4	21	45	0	2884
14780	2828	5	15	18	0	2866
14781	44	7	11	2784	0	2846
14782	19	5	2755	47	0	2826
14783	11	2872	35	23	0	2941
14784	10	38	16	2890	0	2954
14785	8	11	2889	38	0	2946
14786	10	2862	35	20	0	2927
14787	11	31	9	2828	0	2879
14788	2819	5	10	39	0	2873
14789	36	4	9	2761	0	2810
14790	9	2789	11	38	0	2847
14791	2807	29	9	15	0	2860
14792	39	6	2928	12	0	2985
14793	11	2883	23	16	0	2933
14794	17	22	2868	10	0	2917
14795	2794	9	35	9	0	2847
14796	27	4	7	2735	0	2773
14797	13	5	6	2845	0	2869
14798	2848	8	8	26	0	2890
14799	25	9	5	2867	0	2906
14800	10	3	2813	29	0	2855
14801	2714	6	25	15	0	2760
14802	22	2855	8	12	0	2897
14803	12	19	4	2784	0	2819
14804	2784	8	1	26	0	2819
14805	19	2771	6	16	0	2812
14806	15	21	5	2847	0	2888
14807	2897	8	9	28	0	2942
14808	25	5	4	2904	0	2938
14809	11	2885	5	27	0	2928
14810	9	19	2980	16	0	3024
14811	10	10	19	3056	0	3095
14812	15	4	7	2886	0	2912
14813	3083	6	7	28	0	3124
14814	27	6	5	3102	0	3140
14815	3119	6	4	31	0	3160
14816	3119	6	3	16	0	3144
14817	34	7	6	3077	0	3124
14818	10	3099	5	26	0	3140
14819	10	21	8	3108	0	3147
14820	2903	8	4	31	0	2946
14821	23	2905	2	18	0	2948
14822	11	3065	3	10	0	3089
14823	3128	21	6	8	0	3163
14824	3152	6	2	10	0	3170
14825	29	3145	3	10	0	3187
14826	3176	25	8	13	0	3222
14827	3170	9	5	10	0	3194
14828	35	5	5	3204	0	3249
14829	12	4	3297	29	0	3342
14830	12	13	27	3306	0	3358
14831	10	6	3385	34	0	3435
14832	12	15	25	3378	0	3430
14833	9	5	3412	37	0	3463
14834	3345	5	31	10	0	3391
14835	39	3	10	3369	0	3421
14836	3456	2	5	38	0	3501
14837	43	15	6	3387	0	3451
14838	11	3430	3	47	0	3491
14839	3507	32	4	13	0	3556
14840	40	8	3346	10	0	3404
14841	3213	9	23	13	0	3258
14842	39	3268	8	6	0	3321
14843	3117	27	5	3	0	3152
14844	3145	4	1	5	0	3155
14845	33	3143	5	6	0	3187
14846	12	28	3	3263	0	3306
14847	3292	7	2	35	0	3336
14848	40	3272	3	11	0	3326
14849	12	34	0	3318	0	3364
14850	3366	7	1	43	0	3417
14851	42	6	0	3368	0	3416
14852	12	4	1	3403	0	3420
14853	8	3	1	3446	0	3458
14854	10	7	3373	42	0	3432
14855	10	2	35	3362	0	3409
14856	3397	4	9	44	0	3454
14857	40	4	3384	14	0	3442
14858	16	4	39	3429	0	3488
14859	12	2	8	3494	0	3516
14860	4	2	3435	49	0	3490
14861	3338	2	36	19	0	3395
14862	3511	4	9	11	0	3535
14863	45	5	3509	6	0	3565
14864	21	0	35	3509	0	3565
14865	9	4	11	3612	0	3636
14866	9	4	3795	49	0	3857
14867	6	2	41	3845	0	3894
14868	16	3	12	3829	0	3860
14869	9	4	3929	52	0	3994
14870	3864	5	38	20	0	3927
14871	46	2	10	4035	0	4093
14872	3997	2	8	51	0	4058
14873	3994	2	4	23	0	4023
14874	52	5	3999	11	0	4067
14875	23	3	43	3956	0	4025
14876	3976	0	10	51	0	4037
14877	43	4077	8	20	0	4148
14878	13	37	8	4226	0	4284
14879	11	8	7	4237	0	4263
14880	7	5	6	4317	0	4335
14881	9	2	4258	63	0	4332
14882	3942	1	48	25	0	4016
14883	53	5	14	4071	0	4143
14884	15	1	8	4092	0	4116
14885	29	2	4025	60	0	4116
14886	16	2	44	4002	0	4064
14887	11	2	16	4104	0	4133
14888	4024	0	9	72	0	4105
14889	46	4032	11	25	0	4114
14890	15	43	4027	17	0	4102
14891	3977	10	45	21	0	4053
14892	52	5	15	3931	0	4003
14893	15	3	4001	58	0	4077
14894	15	3	4023	18	0	4059
14895	19	8	54	4128	0	4209
14896	9	0	4229	62	0	4300
14897	12	5	4207	23	0	4247
14898	8	4167	59	25	0	4259
14899	11	41	23	4503	0	4578
14900	13	10	4534	58	0	4615
14901	14	6	51	4480	0	4551
14902	4768	7	19	64	0	4858
14903	57	3	12	4797	0	4869
14904	13	4	10	4889	0	4916
14905	4826	2	8	78	0	4914
14906	4902	3	14	30	0	4949
14907	59	3	11	5097	0	5170
14908	17	1	5163	71	0	5252
14909	16	5111	60	24	0	5211
14910	13	54	17	5160	0	5244
14911	5134	11	12	69	0	5226
14912	5146	8	12	28	0	5194
14913	67	5039	13	25	0	5144
14914	18	5177	16	22	0	5233
14915	5261	57	10	22	0	5350
14916	5283	15	8	24	0	5330
14917	70	8	5440	19	0	5537
14918	25	10	63	5421	0	5519
14919	18	5578	20	63	0	5679
14920	5780	53	16	30	0	5879
14921	67	17	13	5736	0	5833
14922	14	5603	9	65	0	5691
14923	16	62	5728	26	0	5832
14924	18	45	53	5540	0	5656
14925	16	5875	19	66	0	5976
14926	5998	54	14	23	0	6089
14927	6024	18	8	26	0	6076
14928	63	5930	10	23	0	6026
14929	5816	50	9	19	0	5894
14930	5838	9	13	22	0	5882
14931	62	5715	6	15	0	5798
14932	16	5891	5	17	0	5929
14933	23	48	17	5852	0	5940
14934	5856	10	7	58	0	5931
14935	59	9	6032	18	0	6118
14936	5824	8	42	25	0	5899
14937	41	6141	11	21	0	6214
14938	6179	42	9	20	0	6250
14939	6249	8	6	17	0	6280
14940	6250	4	9	19	0	6282
14941	59	12	8	6160	0	6239
14942	18	6166	8	44	0	6236
14943	6217	41	3	22	0	6283
14944	51	8	6279	12	0	6350
14945	19	6204	38	9	0	6270
14946	9	43	9	6477	0	6538
14947	15	11	6331	39	0	6396
14948	14	11	6295	12	0	6332
14949	22	11	46	6253	0	6332
14950	13	13	13	6583	0	6622
14951	16	5	8	6669	0	6698
14952	10	9	7	6544	0	6570
14953	12	6356	11	44	0	6423
14954	5	6602	3	25	0	6635
14955	6697	42	6	23	0	6768
14956	43	7	9	6728	0	6787
14957	13	10	7	6733	0	6763
14958	15	16	3	6822	0	6856
14959	6803	7	3	55	0	6868
14960	6814	7	8	24	0	6853
14961	44	7	8	6840	0	6899
14962	6891	6	3	60	0	6960
14963	6881	5	2	27	0	6915
14964	6989	3	2	25	0	7019
14965	49	6	5	6897	0	6957
14966	16	15	6563	36	0	6630
14967	22	8	6140	14	0	6184
14968	22	3	6342	9	0	6376
14969	9	4	6678	9	0	6700
14970	16	14	46	6687	0	6763
14971	6749	8	11	40	0	6808
14972	6709	7	7	15	0	6738
14973	45	3	6677	7	0	6732
14974	17	5	6650	13	0	6685
14975	17	7250	33	9	0	7309
14976	15	35	16	7398	0	7464
14977	7389	9	13	38	0	7449
14978	35	11	7313	13	0	7372
14979	7141	6	30	12	0	7189
14980	33	7538	15	10	0	7596
14981	9	34	9	7785	0	7837
14982	10	10	5	7988	0	8013
14983	19	5	4	7832	0	7860
14984	8035	7	0	59	0	8101
14985	43	10	5	8073	0	8131
14986	17	4	6	8118	0	8145
14987	8110	5	5	56	0	8176
14988	44	7	3	8088	0	8142
14989	22	7	8179	49	0	8257
14990	8076	7	37	29	0	8149
14991	50	5	12	8242	0	8309
14992	28	3	7	8180	0	8218
14993	14	8138	5	50	0	8207
14994	8187	39	5	31	0	8262
14995	8220	14	1	27	0	8262
14996	64	6	0	8122	0	8192
14997	27	6	8061	41	0	8135
14998	7518	4	42	32	0	7596
14999	54	6	8050	15	0	8125
15000	26	5	46	7929	0	8006
15001	18	3	17	8191	0	8229
15002	8111	3	13	61	0	8188
15003	60	2	8	8337	0	8407
15004	16	7	8352	59	0	8434
15005	8125	3	50	33	0	8211
15006	58	4	8860	15	0	8937
15007	22	3	8659	13	0	8697
15008	8985	2	74	19	0	9080
15009	76	13	23	9240	0	9352
15010	20	9461	21	69	0	9571
15011	9510	57	16	29	0	9612
15012	9470	14	6	20	0	9510
15013	78	8	9456	17	0	9559
15014	9328	8	62	17	0	9415
15015	82	12	24	9447	0	9565
15016	32	2	9616	63	0	9713
15017	21	9339	72	36	0	9468
15018	9293	61	24	24	0	9402
15019	63	9412	10	21	0	9506
15020	39	61	10	9330	0	9440
15021	28	29	9	9419	0	9485
15022	30	10	10	9301	0	9351
15023	29	9	8	9121	0	9167
15024	13	9052	9	94	0	9168
15025	4	57	8805	39	0	8905
15026	10	8844	56	30	0	8940
15027	8879	68	15	24	0	8986
15028	60	33	9	8896	0	8998
15029	8942	16	9	75	0	9042
15030	75	16	3	8993	0	9087
15031	9160	4	8	94	0	9266
15032	65	9326	8	45	0	9444
15033	9504	61	13	34	0	9612
15034	9575	24	10	31	0	9640
15035	9354	19	16	24	0	9413
15036	9412	17	5	23	0	9457
15037	96	9336	3	24	0	9459
15038	50	61	9351	18	0	9480
15039	53	19	55	9341	0	9468
15040	9369	14	25	77	0	9485
15041	9527	15	18	36	0	9596
15042	101	15	12	9707	0	9835
15043	51	12	9942	73	0	10078
15044	49	9	66	9666	0	9790
15045	33	9905	27	74	0	10039
15046	9967	74	17	53	0	10111
15047	81	44	19	10021	0	10165
15048	41	9852	15	83	0	9991
15049	30	10310	8	52	0	10400
15050	30	10503	7	29	0	10569
15051	30	100	15	10699	0	10844
15052	10699	41	12	106	0	10858
15053	85	10822	20	42	0	10969
15054	53	94	10	10984	0	11141
15055	10952	38	9	105	0	11104
15056	109	20	5	10982	0	11116
15057	10932	22	3	116	0	11073
15058	10943	23	4	54	0	11024
15059	125	11307	10	30	0	11472
15060	71	96	5	10894	0	11066
15061	44	11370	10	80	0	11504
15062	11315	97	5	43	0	11460
15063	11351	46	7	36	0	11440
15064	11511	22	11	44	0	11588
15065	141	20	12	11516	0	11689
15066	73	17	11413	101	0	11604
15067	11164	17	80	62	0	11323
15068	11477	25	27	46	0	11575
15069	130	20	17	11326	0	11493
15070	64	11514	13	103	0	11694
15071	61	101	15	11595	0	11772
15072	55	37	17	11800	0	11909
15073	11854	30	13	137	0	12034
15074	11716	18	13	73	0	11820
15075	134	21	11308	48	0	11511
15076	79	23	97	11222	0	11421
15077	11526	18	32	117	0	11693
15078	139	32	13	11584	0	11768
15079	53	27	11572	128	0	11780
15080	45	11116	92	77	0	11330
15081	34	11648	29	55	0	11766
15082	12915	115	16	55	0	13101
15083	171	51	13	13814	0	14049
15084	99	32	15	15272	0	15418
15085	15331	24	22	281	0	15658
15086	253	26	15273	127	0	15679
15087	138	26	188	15346	0	15698
15088	78	17	15345	276	0	15716
15089	75	15434	225	125	0	15859
15090	15792	205	115	86	0	16198
15091	16041	100	59	79	0	16279
15092	16178	57	54	61	0	16350
15093	349	54	15826	82	0	16311
15094	15924	35	209	65	0	16233
15095	16245	26	118	54	0	16443
15096	399	35	61	16036	0	16531
15097	12696	62	143	316	0	13217
15098	242	50	15614	116	0	16022
15099	15580	21	200	87	0	15888
15100	331	34	15647	80	0	16092
15101	210	15843	228	74	0	16355
15102	150	327	159	14946	0	15582
15103	137	15796	80	202	0	16215
15104	124	224	15589	92	0	16029
15105	87	15692	209	87	0	16075
15106	14887	233	103	74	0	15297
15107	208	14632	63	52	0	14955
15108	120	14572	68	35	0	14795
15109	76	267	14200	24	0	14567
15110	106	152	192	14067	0	14517
15111	14208	92	98	200	0	14598
15112	201	102	14122	89	0	14514
15113	117	14187	220	66	0	14590
15114	84	223	102	14196	0	14605
15115	101	91	14258	228	0	14678
15116	78	81	14047	104	0	14310
15117	67	89	281	14126	0	14563
15118	57	65	14278	234	0	14634
15119	63	54	260	13472	0	13849
15120	63	13516	160	224	0	13963
15121	84	185	113	13743	0	14125
15122	71	13898	87	225	0	14281
15123	84	212	67	13963	0	14326
15124	13830	127	84	238	0	14279
15125	220	83	61	13808	0	14172
15126	129	12758	48	1287	0	14222
15127	97	188	70	14053	0	14408
15128	95	106	13858	275	0	14334
15129	81	78	205	13987	0	14351
15130	13876	63	117	290	0	14346
15131	204	94	13535	158	0	13991
15132	121	59	231	13434	0	13845
15133	13181	55	117	275	0	13628
15134	238	13127	81	174	0	13620
15135	139	222	92	13159	0	13612
15136	13246	121	56	278	0	13701
15137	271	80	72	13200	0	13623
15138	136	90	12976	278	0	13480
15139	12703	74	204	163	0	13144
15140	243	12768	141	119	0	13271
15141	148	12966	70	145	0	13329
15142	12928	213	87	95	0	13323
15143	12672	136	80	78	0	12966
15144	288	106	59	12586	0	13039
15145	12537	91	62	219	0	12909
15146	269	67	12124	145	0	12605
15147	12154	58	205	120	0	12537
15148	272	12043	105	130	0	12550
15149	12018	198	94	104	0	12414
15150	269	117	11968	83	0	12437
15151	209	99	220	11810	0	12338
15152	160	90	117	11939	0	12306
15153	138	88	90	11342	0	11658
15154	126	11603	98	272	0	12099
15155	11724	177	92	179	0	12172
15156	272	110	64	11187	0	11633
15157	171	11265	61	252	0	11749
15158	11938	203	58	159	0	12358
15159	11565	131	96	109	0	11901
15160	11766	78	67	161	0	12072
15161	11759	78	58	129	0	12024
15162	11647	65	74	110	0	11896
15163	342	80	59	11441	0	11922
15164	261	61	62	11372	0	11756
15165	11280	72	50	294	0	11696
15166	278	87	52	11246	0	11663
15167	219	80	60	11296	0	11655
15168	137	81	10658	330	0	11206
15169	10942	76	183	188	0	11389
15170	11023	77	123	151	0	11374
15171	11139	91	78	141	0	11449
15172	320	83	82	10420	0	10905
15173	221	10698	80	236	0	11235
15174	11754	175	82	148	0	12159
15175	11217	108	58	182	0	11565
15176	354	75	59	12338	0	12826
15177	12248	82	89	274	0	12693
15178	431	189	9387	224	0	10231
15179	235	12155	193	138	0	12721
15180	219	12430	106	193	0	12948
15181	292	280	12001	133	0	12706
15182	80	10459	213	99	0	10851
15183	105	9651	115	101	0	9972
15184	8210	122	132	59	0	8523
15185	105	8092	42	58	0	8297
15186	64	107	30	8220	0	8421
15187	8351	45	21	146	0	8563
15188	111	49	8219	62	0	8441
15189	8089	30	78	68	0	8265
15190	121	40	8003	42	0	8206
15191	68	13	7940	59	0	8080
15192	7847	17	112	47	0	8023
15193	112	7	8084	55	0	8258
15194	56	8001	98	24	0	8179
15195	44	85	44	7969	0	8142
15196	7965	44	28	100	0	8137
15197	103	7805	19	57	0	7984
15198	63	87	13	7910	0	8073
15199	44	42	7889	98	0	8073
15200	56	27	80	7913	0	8076
15201	7689	17	39	117	0	7862
15202	154	15	7546	54	0	7769
15203	70	19	89	7508	0	7686
15204	7550	25	34	101	0	7710
15205	7766	13	26	54	0	7859
15206	144	15	15	7713	0	7887
15207	85	15	9	7758	0	7867
15208	50	10	7829	120	0	8009
15209	38	15	7669	62	0	7784
15210	7840	11	105	46	0	8002
15211	8045	7	44	27	0	8123
15212	122	7974	28	24	0	8148
15213	7981	81	12	17	0	8091
15214	8168	30	15	22	0	8235
15215	136	21	8499	14	0	8670
15216	60	8673	93	24	0	8850
15217	8746	94	47	19	0	8906
15218	8837	40	17	16	0	8910
15219	9030	19	11	19	0	9079
15220	162	11	8	8879	0	9060
15221	66	12	9	8916	0	9003
15222	33	8861	5	137	0	9036
15223	25	95	7	9022	0	9149
15224	8952	42	4	132	0	9130
15225	117	20	1	8998	0	9136
15226	53	11	8856	119	0	9039
15227	29	8	8766	57	0	8860
15228	25	9	133	8815	0	8982
15229	18	6	8933	112	0	9069
15230	18	9	8792	54	0	8873
15231	21	8	141	8772	0	8942
15232	27	4	56	9002	0	9089
15233	14	6	9041	137	0	9198
15234	18	13	8966	60	0	9057
15235	18	9049	135	33	0	9235
15236	9095	97	60	28	0	9280
15237	106	9317	34	19	0	9476
15238	9349	112	21	23	0	9505
15239	9491	48	15	20	0	9574
15240	147	9529	10	14	0	9700
15241	9598	119	6	17	0	9740
15242	137	50	13	9507	0	9707
15243	67	26	9636	117	0	9846
15244	44	23	110	9553	0	9730
15245	31	6	49	9761	0	9847
15246	9395	11	20	171	0	9597
15247	9513	5	17	81	0	9616
15248	9543	4	15	45	0	9607
15249	9539	10	15	36	0	9600
15250	9202	5	13	31	0	9251
15251	182	8928	17	21	0	9148
15252	78	113	14	9094	0	9299
15253	47	44	9245	121	0	9457
15254	48	21	119	9248	0	9436
15255	31	16	46	9342	0	9435
15256	30	12	31	9734	0	9807
15257	10078	8	29	195	0	10310
15258	176	13	9	10126	0	10324
15259	10342	12	12	199	0	10565
15260	200	8	10519	76	0	10803
15261	92	11	173	11542	0	11818
15262	40	13	11837	225	0	12115
15263	11858	11	216	95	0	12180
15264	233	17	79	11982	0	12311
15265	93	12	12119	235	0	12459
15266	66	9	224	12219	0	12518
15267	12291	8	90	263	0	12652
15268	240	4	12184	113	0	12541
15269	12376	10	220	77	0	12683
15270	12680	9	76	69	0	12834
15271	12649	11	47	54	0	12761
15272	12409	3	39	47	0	12498
15273	307	12029	33	60	0	12429
15274	108	11084	31	38	0	11261
15275	69	10793	37	39	0	10938
15276	87	332	56	9817	0	10292
15277	47	10005	27	157	0	10236
15278	9823	163	34	61	0	10081
15279	172	9518	27	103	0	9820
15280	76	9784	24	37	0	9921
15281	55	182	33	9769	0	10039
15282	48	70	19	9971	0	10108
15283	9808	25	33	231	0	10097
15284	180	40	32	9872	0	10124
15285	99	18	9739	184	0	10040
15286	64	27	9338	91	0	9520
15287	66	18	9663	51	0	9798
15288	89	19	189	9689	0	9986
15289	68	21	69	10318	0	10476
15290	67	23	10072	220	0	10382
15291	61	29	9870	84	0	10044
15292	58	37	10192	41	0	10328
15293	10224	35	215	60	0	10534
15294	215	29	87	10313	0	10644
15295	94	34	43	10483	0	10654
15296	10399	45	37	257	0	10738
15297	223	33	32	10362	0	10650
15298	84	10255	30	223	0	10592
15299	58	10608	27	110	0	10803
15300	62	209	26	10579	0	10876
15301	10560	72	29	227	0	10888
15302	10664	38	33	115	0	10850
15303	10794	23	38	88	0	10943
15304	249	22	47	10643	0	10961
15305	108	18	10444	219	0	10789
15306	66	17	202	10458	0	10743
15307	56	13	10453	225	0	10747
15308	10114	15	224	107	0	10460
15309	219	16	110	10222	0	10567
15310	10026	10	57	234	0	10327
15311	209	8	10116	104	0	10437
15312	9739	13	203	73	0	10028
15313	214	14	10255	86	0	10569
15314	113	9711	206	53	0	10083
15315	78	9734	69	60	0	9941
15316	9542	180	49	62	0	9833
15317	216	76	32	9438	0	9762
15318	107	37	9479	187	0	9810
15319	67	9248	146	84	0	9545
15320	61	9581	66	47	0	9755
15321	67	200	30	9529	0	9826
15322	9560	68	34	191	0	9853
15323	9613	36	37	94	0	9780
15324	217	9539	38	66	0	9860
15325	9646	165	34	63	0	9908
15326	200	65	41	9580	0	9886
15327	102	30	9548	188	0	9868
15328	54	9614	184	106	0	9958
15329	71	170	83	9637	0	9961
15330	62	53	42	9798	0	9955
15331	9655	33	41	228	0	9957
15332	192	32	9593	89	0	9906
15333	9503	40	169	76	0	9788
15334	9657	24	88	58	0	9827
15335	242	31	42	9505	0	9820
15336	106	28	48	9699	0	9881
15337	9430	43	28	233	0	9734
15338	212	38	33	9449	0	9732
15339	93	30	9263	206	0	9592
15340	61	30	9181	93	0	9365
15341	65	9077	190	52	0	9384
15342	56	9652	65	65	0	9838
15343	72	189	35	9093	0	9389
15344	59	9222	35	174	0	9490
15345	9354	178	38	91	0	9661
15346	173	9469	33	62	0	9737
15347	96	179	26	9464	0	9765
15348	51	70	31	9658	0	9810
15349	49	50	9522	212	0	9833
15350	73	42	161	9498	0	9774
15351	66	26	67	9737	0	9896
15352	66	9780	30	248	0	10124
15353	52	159	43	9805	0	10059
15354	69	54	46	9971	0	10140
15355	45	32	9694	252	0	10023
15356	52	9447	182	104	0	9785
15357	41	505	53	8423	0	9022
15358	42	8825	29	137	0	9033
15359	46	126	8458	68	0	8698
15360	30	8167	116	56	0	8369
15361	6998	136	109	53	0	7296
15362	6822	37	20	23	0	6902
15363	6790	28	13	16	0	6847
15364	90	6736	6	31	0	6863
15365	6662	72	4	20	0	6758
15366	98	25	15	6556	0	6694
15367	6432	18	10	77	0	6537
15368	83	6413	7	35	0	6538
15369	6404	72	7	36	0	6519
15370	6612	27	8	35	0	6682
15371	96	6741	14	23	0	6874
15372	52	86	6772	16	0	6926
15373	39	28	74	7285	0	7426
15374	26	19	7708	103	0	7856
15375	25	19	122	7898	0	8064
15376	28	12	36	8298	0	8374
15377	13	22	8370	165	0	8570
15378	20	18	138	8452	0	8628
15379	8492	16	30	163	0	8701
15380	140	15	8482	53	0	8690
15381	37	8516	134	36	0	8723
15382	35	123	41	8369	0	8568
15383	27	40	25	8618	0	8710
15384	18	22	8485	163	0	8688
15385	29	22	125	8187	0	8363
15386	16	8335	32	153	0	8536
15387	8185	130	25	54	0	8394
15388	124	8105	21	39	0	8289
15389	7566	118	7	34	0	7725
15390	113	7548	14	23	0	7698
15391	28	7848	11	18	0	7905
15392	21	125	7560	15	0	7721
15393	36	70	124	7457	0	7687
15394	22	22	34	7375	0	7453
15395	20	18	14	7561	0	7613
15396	10	7815	17	147	0	7989
15397	21	136	12	7865	0	8034
15398	7830	43	13	168	0	8054
15399	151	21	19	7821	0	8012
15400	7771	19	8	178	0	7976
15401	161	16	7749	53	0	7979
15402	7761	14	147	41	0	7963
15403	168	14	35	7741	0	7958
15404	51	9	21	8054	0	8135
15405	8054	15	22	193	0	8284
15406	161	24	8026	67	0	8278
15407	47	7995	154	48	0	8244
15408	42	153	46	8090	0	8331
15409	8065	33	31	167	0	8296
15410	8174	30	19	70	0	8293
15411	196	34	21	8067	0	8318
15412	61	25	7991	178	0	8255
15413	7749	23	150	66	0	7988
15414	169	27	7817	58	0	8071
15415	68	32	153	7780	0	8033
15416	40	26	7810	171	0	8047
15417	44	33	165	7699	0	7941
15418	32	22	7583	193	0	7830
15419	31	7527	165	81	0	7804
15420	74	156	45	6928	0	7203
15421	23	7522	43	157	0	7745
15422	7542	160	28	60	0	7790
15423	7624	48	31	49	0	7752
15424	195	26	7468	43	0	7732
15425	76	25	153	7441	0	7695
15426	7498	20	47	185	0	7750
15427	185	24	39	7435	0	7683
15428	59	27	34	7476	0	7596
15429	48	19	7239	208	0	7514
15430	7075	13	156	91	0	7335
15431	173	18	7253	51	0	7495
15432	70	19	173	7219	0	7481
15433	55	13	7247	177	0	7492
15434	7161	18	179	74	0	7432
15435	7275	13	58	75	0	7421
15436	7215	24	56	54	0	7349
15437	217	15	45	7087	0	7364
15438	78	21	6959	174	0	7232
15439	55	23	7035	82	0	7195
15440	59	45	183	6624	0	6911
15441	50	6847	77	168	0	7142
15442	6643	143	49	83	0	6918
15443	170	58	42	6657	0	6927
15444	70	34	6652	173	0	6929
15445	75	29	156	6658	0	6918
15446	60	22	6793	188	0	7063
15447	50	22	166	6888	0	7126
15448	44	23	6936	192	0	7195
15449	56	15	6880	81	0	7032
15450	45	6739	188	77	0	7049
15451	42	143	6661	57	0	6903
15452	62	40	6666	68	0	6836
15453	65	46	197	5732	0	6040
15454	47	26	77	6214	0	6364
15455	35	6369	61	181	0	6646
15456	6383	131	53	89	0	6656
15457	170	6365	37	62	0	6634
15458	74	138	48	6312	0	6572
15459	6341	42	57	167	0	6607
15460	158	23	51	6333	0	6565
15461	6337	19	58	176	0	6590
15462	170	17	44	6408	0	6639
15463	64	21	6432	183	0	6700
15464	52	17	157	6499	0	6725
15465	47	22	66	6621	0	6756
15466	6509	23	65	178	0	6775
15467	6556	20	43	98	0	6717
15468	6445	22	59	74	0	6600
15469	183	6127	50	62	0	6422
15470	68	6110	38	49	0	6265
15471	6020	135	47	52	0	6254
15472	145	46	5981	50	0	6222
15473	56	34	5583	47	0	5720
15474	62	203	138	4930	0	5333
15475	26	14	4925	111	0	5076
15476	30	4	4675	48	0	4757
15477	4417	24	113	43	0	4597
15478	4479	5	52	27	0	4563
15479	92	4385	32	35	0	4544
15480	33	4514	27	34	0	4608
15481	40	80	27	4060	0	4207
15482	35	4434	25	68	0	4562
15483	4593	72	21	31	0	4717
15484	89	32	14	4454	0	4589
15485	32	4615	26	78	0	4751
15486	4775	71	18	29	0	4893
15487	80	26	4820	33	0	4959
15488	38	24	4771	22	0	4855
15489	4805	23	96	31	0	4955
15490	82	17	4765	24	0	4888
15491	4649	16	71	22	0	4758
15492	82	16	38	4715	0	4851
15493	34	13	4724	72	0	4843
15494	24	4603	77	38	0	4742
15495	23	4686	38	30	0	4777
15496	4284	43	22	21	0	4370
15497	43	4344	16	11	0	4414
15498	4204	36	19	8	0	4267
15499	4212	13	12	15	0	4252
15500	37	4206	14	10	0	4267
15501	22	38	12	4217	0	4289
15502	12	16	4390	33	0	4451
15503	8	4583	40	22	0	4653
15504	16	115	15	4529	0	4675
15505	17	22	13	4801	0	4853
15506	4730	9	4	53	0	4796
15507	46	7	5	4741	0	4799
15508	15	5	4722	54	0	4796
15509	15	4699	41	21	0	4776
15510	5	40	14	4792	0	4851
15511	4877	13	14	49	0	4953
15512	4976	10	4	24	0	5014
15513	56	5	7	4994	0	5062
15514	5137	7	7	58	0	5209
15515	71	2	5178	24	0	5275
15516	25	6	61	5193	0	5285
15517	21	7	5282	58	0	5368
15518	16	5	67	5594	0	5682
15519	14	8	19	5608	0	5649
15520	17	9	17	5637	0	5680
15521	14	3	6	5621	0	5644
15522	12	3	11	5589	0	5615
15523	5567	6	10	106	0	5689
15524	5627	5	5	50	0	5687
15525	82	5614	10	32	0	5738
15526	5716	71	6	28	0	5821
15527	91	16	3	5734	0	5844
15528	36	16	6	5821	0	5879
15529	33	10	5	5811	0	5859
15530	18	9	5859	106	0	5992
15531	23	5	71	5605	0	5704
15532	13	5785	18	95	0	5911
15533	5793	75	16	33	0	5917
15534	5814	16	8	35	0	5873
15535	94	17	5731	24	0	5866
15536	40	5727	70	28	0	5865
15537	31	72	23	5727	0	5853
15538	14	20	5784	86	0	5904
15539	20	21	76	5507	0	5624
15540	16	5661	21	96	0	5794
15541	5572	76	19	35	0	5702
15542	81	5595	9	44	0	5729
15543	28	78	5598	21	0	5725
15544	27	29	5585	15	0	5656
15545	15	5484	81	23	0	5603
15546	19	5461	36	16	0	5532
15547	5336	80	28	28	0	5472
15548	5325	28	8	19	0	5380
15549	85	18	10	5335	0	5448
15550	39	13	5343	75	0	5470
15551	24	6	74	5316	0	5420
15552	16	17	19	5338	0	5390
15553	5290	14	11	91	0	5406
15554	5251	11	11	42	0	5315
15555	91	10	13	5490	0	5604
15556	36	11	5568	85	0	5700
15557	24	5613	76	39	0	5752
15558	5644	80	26	33	0	5783
15559	83	5799	21	30	0	5933
15560	37	103	14	5943	0	6097
15561	43	28	12	6131	0	6214
15562	23	29	15	6091	0	6158
15563	17	18	19	6001	0	6055
15564	5874	15	19	133	0	6041
15565	101	19	10	5843	0	5973
15566	31	5805	8	127	0	5971
15567	34	95	10	5829	0	5968
15568	5744	19	7	137	0	5907
15569	101	5749	12	52	0	5914
15570	33	97	15	5753	0	5898
15571	32	22	5650	119	0	5823
15572	5608	31	93	41	0	5773
15573	115	17	20	5679	0	5831
15574	36	16	5585	117	0	5754
15575	36	12	5524	49	0	5621
15576	39	27	113	5555	0	5734
15577	5556	20	49	120	0	5745
15578	5630	10	27	48	0	5715
15579	105	5680	22	50	0	5857
15580	5604	91	13	45	0	5753
15581	5671	22	8	53	0	5754
15582	5632	23	17	43	0	5715
15583	5577	13	13	49	0	5652
15584	137	15	14	5458	0	5624
15585	53	14	16	5468	0	5551
15586	39	25	5184	125	0	5373
15587	20	4923	93	61	0	5097
15588	30	5082	25	47	0	5184
15589	19	103	4987	46	0	5155
15590	4866	21	106	46	0	5039
15591	106	19	25	4932	0	5082
15592	4934	10	22	117	0	5083
15593	4954	19	10	43	0	5026
15594	120	15	4824	29	0	4988
15595	50	17	86	4823	0	4976
15596	4871	13	17	109	0	5010
15597	112	12	25	4822	0	4971
15598	39	19	4827	112	0	4997
15599	35	102	88	4617	0	4842
15600	35	4899	28	94	0	5056
15601	27	5049	22	31	0	5129
15602	32	85	4777	24	0	4918
15603	24	4567	77	25	0	4693
15604	4327	98	33	40	0	4498
15605	4208	7	16	27	0	4258
15606	79	10	11	4169	0	4269
15607	21	11	7	4223	0	4262
15608	26	12	7	4249	0	4294
15609	4166	6	8	85	0	4265
15610	80	4172	9	22	0	4283
15611	4068	62	7	26	0	4163
15612	4048	5	6	8	0	4067
15613	74	3999	5	19	0	4097
15614	3803	51	10	16	0	3880
15615	59	3841	6	18	0	3924
15616	3894	56	9	13	0	3972
15617	59	13	3853	18	0	3943
15618	3481	17	57	8	0	3563
15619	53	3595	5	15	0	3668
15620	27	49	16	3652	0	3744
15621	16	8	3	3817	0	3844
15622	10	6	3	3872	0	3891
15623	3931	5	4	71	0	4011
15624	66	4	4	3962	0	4036
15625	14	11	3869	63	0	3957
15626	3762	11	55	18	0	3846
15627	72	8	3820	14	0	3914
15628	14	13	59	3814	0	3900
15629	11	5	3870	75	0	3961
15630	17	11	62	3727	0	3817
15631	13	3807	8	68	0	3896
15632	12	62	11	3763	0	3848
15633	12	3805	8	58	0	3883
15634	14	57	5	3839	0	3915
15635	3860	14	5	71	0	3950
15636	68	4	4	3949	0	4025
15637	3960	5	4	72	0	4041
15638	67	13	3822	10	0	3912
15639	3865	5	53	16	0	3939
15640	3969	7	17	5	0	3998
15641	3982	8	8	1	0	3999
15642	78	4	2	3968	0	4052
15643	3900	4	4	65	0	3973
15644	64	3	3819	18	0	3904
15645	3786	5	57	20	0	3868
15646	70	10	3792	12	0	3884
15647	3835	7	56	11	0	3909
15648	72	7	11	3935	0	4025
15649	21	4	3985	62	0	4072
15650	20	1	51	3978	0	4050
15651	26	4	9	4044	0	4083
15652	13	1	3994	62	0	4070
15653	3756	5	57	22	0	3840
15654	54	4054	16	20	0	4144
15655	3900	48	11	10	0	3969
15656	52	3854	1	22	0	3929
15657	3779	45	11	8	0	3843
15658	46	10	3743	11	0	3810
15659	3443	11	56	16	0	3526
15660	36	3464	9	6	0	3515
15661	17	26	12	3434	0	3489
15662	9	6	7	3536	0	3558
15663	10	2	2	3546	0	3560
15664	5	2	3554	37	0	3598
15665	9	2	27	3539	0	3577
15666	6	4	3668	32	0	3710
15667	3758	1	31	11	0	3801
15668	4025	2	8	6	0	4041
15669	50	1	3	4062	0	4116
15670	13	2	4102	41	0	4158
15671	3979	0	41	13	0	4033
15672	46	2	4670	9	0	4727
15673	14	3	47	4630	0	4694
15674	10	1	10	4774	0	4795
15675	5	1	6	4895	0	4907
15676	5	2	4	4939	0	4950
15677	4816	1	6	67	0	4890
15678	49	4844	2	24	0	4919
15679	13	45	4734	7	0	4799
15680	11	4746	45	7	0	4809
15681	4805	52	11	8	0	4876
15682	55	10	10	4805	0	4880
15683	4831	5	6	56	0	4898
15684	63	2	5	4851	0	4921
15685	20	5	2	4872	0	4899
15686	11	2	5	4894	0	4912
15687	10	2	4798	70	0	4880
15688	2	4739	52	22	0	4815
15689	14	43	4864	16	0	4937
15690	8	10	55	4912	0	4985
15691	4976	7	11	60	0	5054
15692	4974	6	9	29	0	5018
15693	4998	3	6	16	0	5023
15694	60	4945	5	18	0	5028
15695	5066	46	5	24	0	5141
15696	59	15	7	5066	0	5147
15697	22	10	9	5117	0	5158
15698	21	11	8	5117	0	5157
15699	12	5147	4	75	0	5238
15700	14	46	5	4896	0	4961
15701	16	4985	9	55	0	5065
15702	4953	53	4	28	0	5038
15703	4996	15	10	16	0	5037
15704	66	11	5	5040	0	5122
15705	27	4	4988	57	0	5076
15706	4974	9	42	31	0	5056
15707	62	4	17	5076	0	5159
15708	21	10	5040	59	0	5130
15709	4902	6	49	30	0	4987
15710	58	5	10	5078	0	5151
15711	5043	6	6	67	0	5122
15712	55	5004	12	26	0	5097
15713	19	50	6	4945	0	5020
15714	14	5089	11	49	0	5163
15715	15	59	6	5130	0	5210
15716	13	5133	4	63	0	5213
15717	18	56	7	5177	0	5258
15718	21	11	5095	55	0	5182
15719	4305	16	35	51	0	4407
15720	49	5004	12	28	0	5093
15721	17	34	4902	19	0	4972
15722	4802	7	39	24	0	4872
15723	44	10	11	4929	0	4994
15724	21	6	4938	36	0	5001
15725	13	4987	31	17	0	5048
15726	13	27	16	5057	0	5113
15727	13	10	5176	36	0	5235
15728	15	10	27	5135	0	5187
15729	12	8	7	5240	0	5267
15730	5	10	5307	48	0	5370
15731	16	5	30	5333	0	5384
15732	6	13	5440	44	0	5503
15733	11	6	36	5460	0	5513
15734	15	17	5691	35	0	5758
15735	14	4	34	5698	0	5750
15736	15	11	12	5712	0	5750
15737	26	7	11	5679	0	5723
15738	11	5652	10	57	0	5730
15739	5676	28	13	29	0	5746
15740	5717	12	10	30	0	5769
15741	40	10	10	5786	0	5846
15742	5792	9	11	50	0	5862
15743	35	9	5790	23	0	5857
15744	15	5846	33	25	0	5919
15745	5932	34	13	24	0	6003
15746	33	5969	15	21	0	6038
15747	19	34	10	6050	0	6113
15748	20	12	9	6048	0	6089
15749	5896	9	11	62	0	5978
15750	39	13	9	5909	0	5970
15751	15	9	5864	54	0	5942
15752	16	5839	39	23	0	5917
15753	5939	35	7	24	0	6005
15754	39	7	10	5849	0	5905
15755	12	5928	7	44	0	5991
15756	20	37	6	5899	0	5962
15757	10	6021	8	47	0	6086
15758	6036	45	10	23	0	6114
15759	6013	12	7	28	0	6060
15760	58	12	5953	17	0	6040
15761	18	8	5895	20	0	5941
15762	28	8	35	5894	0	5965
15763	13	6049	16	55	0	6133
15764	10	40	14	6125	0	6189
15765	6103	7	12	50	0	6172
15766	36	18	5993	22	0	6069
15767	21	14	23	5776	0	5834
15768	12	3	5743	30	0	5788
15769	8	9	5547	17	0	5581
15770	6	5826	23	13	0	5868
15771	46	51	21	5698	0	5816
15772	5319	7	10	24	0	5360
15773	14	3	5311	4	0	5332
15774	4	5218	11	11	0	5244
15775	5198	9	8	12	0	5227
15776	15	5	8	5201	0	5229
15777	5372	8	3	32	0	5415
15778	5364	3	2	20	0	5389
15779	5394	2	1	20	0	5417
15780	19	4	5683	5	0	5711
15781	5501	1	13	17	0	5532
15782	5744	1	6	13	0	5764
15783	25	5836	4	9	0	5874
15784	10	20	4	5904	0	5938
15785	11	5	1	5891	0	5908
15786	8	5	1	6043	0	6057
15787	6165	4	2	31	0	6202
15788	6028	2	0	27	0	6057
15789	25	9	6081	8	0	6123
15790	13	3	14	6057	0	6087
15791	11	6007	7	17	0	6042
15792	6067	19	5	22	0	6113
15793	24	8	6090	12	0	6134
15794	14	7	20	5982	0	6023
15795	14	4	6	6038	0	6062
15796	7	6024	10	30	0	6071
15797	4	21	3	6068	0	6096
15798	14	10	2	5810	0	5836
15799	9	4	5	6011	0	6029
15800	5988	6	5	44	0	6043
15801	28	4	3	5953	0	5988
15802	18	5	3	5965	0	5991
15803	6077	6	3	46	0	6132
15804	28	7	5	6058	0	6098
15805	16	6645	2	46	0	6709
15806	6898	44	3	27	0	6972
15807	7150	16	4	20	0	7190
15808	7377	9	3	24	0	7413
15809	7853	5	3	23	0	7884
15810	122	8287	11	15	0	8435
15811	8943	100	4	22	0	9069
15812	9099	24	7	16	0	9146
15813	165	15	2	9010	0	9192
15814	48	9	8937	134	0	9128
15815	39	12	120	8878	0	9049
15816	27	5	23	8976	0	9031
15817	14	15	14	8873	0	8916
15818	23	5	13	8877	0	8918
15819	28	1	7	8921	0	8957
15820	8694	7	1	197	0	8899
15821	152	4	10	8713	0	8879
15822	37	6	8813	171	0	9027
15823	40	5	128	8672	0	8845
15824	23	8801	29	150	0	9003
15825	23	126	17	8806	0	8972
15826	12	25	8809	160	0	9006
15827	8136	19	137	54	0	8346
15828	8561	14	26	51	0	8652
15829	157	11	8805	32	0	9005
15830	56	8803	136	22	0	9017
15831	8940	134	27	22	0	9123
15832	9004	31	18	23	0	9076
15833	8992	20	18	27	0	9057
15834	8825	19	5	16	0	8865
15835	217	5	7	8623	0	8852
15836	72	11	8760	148	0	8991
15837	56	16	142	8868	0	9082
15838	53	7	30	9191	0	9281
15839	34	11	9058	201	0	9304
15840	26	10	9024	75	0	9135
15841	8921	12	179	57	0	9169
15842	171	9083	45	63	0	9362
15843	61	150	43	9143	0	9397
15844	43	32	8997	190	0	9262
15845	8766	26	160	76	0	9028
15846	176	19	8960	61	0	9216
15847	8813	11	172	75	0	9071
15848	198	8953	61	59	0	9271
15849	79	157	38	9022	0	9296
15850	63	39	8940	184	0	9226
15851	8723	33	158	64	0	8978
15852	201	8915	46	77	0	9239
15853	68	9407	50	50	0	9575
15854	84	190	39	9390	0	9703
15855	80	66	22	9811	0	9979
15856	10039	54	28	237	0	10358
15857	221	10053	35	104	0	10413
15858	109	201	26	10253	0	10589
15859	10202	62	23	271	0	10558
15860	10495	50	35	95	0	10675
15861	10697	31	26	102	0	10856
15862	315	24	10830	85	0	11254
15863	155	23	11102	64	0	11344
15864	11553	26	272	84	0	11935
15865	301	11592	101	88	0	12082
15866	112	11844	60	76	0	12092
15867	112	303	56	11247	0	11718
15868	92	11675	39	274	0	12080
15869	11747	300	50	115	0	12212
15870	314	91	57	11679	0	12141
15871	128	56	11656	303	0	12143
15872	11673	57	279	121	0	12130
15873	11926	57	100	85	0	12168
15874	390	43	65	11729	0	12227
15875	176	58	49	11924	0	12207
15876	151	58	37	11944	0	12190
15877	123	42	43	11846	0	12054
15878	94	57	11259	405	0	11815
15879	112	11179	259	170	0	11720
15880	112	285	85	10472	0	10954
15881	87	11081	87	320	0	11575
15882	109	290	68	10343	0	10810
15883	94	10920	54	312	0	11380
15884	10888	297	44	162	0	11391
15885	10955	112	63	140	0	11270
15886	341	10760	61	136	0	11298
15887	10739	287	59	96	0	11181
15888	372	103	51	10672	0	11198
15889	10578	99	53	323	0	11053
15890	350	10576	62	133	0	11121
15891	10684	310	37	100	0	11131
15892	10878	111	50	85	0	11124
15893	395	113	59	10531	0	11098
15894	180	85	10521	305	0	11091
15895	140	10507	267	128	0	11042
15896	140	290	97	10584	0	11111
15897	10614	123	67	331	0	11135
15898	317	113	10512	154	0	11096
15899	197	73	267	10444	0	10981
15900	138	89	78	10744	0	11049
15901	10646	58	72	375	0	11151
15902	10734	72	65	178	0	11049
15903	10629	54	49	156	0	10888
15904	397	10297	63	125	0	10882
15905	9733	251	49	112	0	10145
15906	319	87	9338	101	0	9845
15907	150	91	9003	94	0	9338
15908	124	49	9011	93	0	9277
15909	164	349	325	7978	0	8816
15910	85	45	7927	201	0	8258
15911	7287	52	150	94	0	7583
15912	194	37	56	7375	0	7662
15913	119	35	7501	166	0	7821
15914	7670	44	149	101	0	7964
15915	215	30	68	7690	0	8003
15916	107	44	53	7878	0	8082
15917	7870	19	53	204	0	8146
15918	196	26	56	8056	0	8334
15919	103	28	8065	193	0	8389
15920	75	34	162	8148	0	8419
15921	77	25	8233	202	0	8537
15922	72	28	176	8124	0	8400
15923	8044	25	69	210	0	8348
15924	183	7802	52	115	0	8152
15925	90	8097	52	83	0	8322
15926	97	165	34	8018	0	8314
15927	69	72	40	8032	0	8213
15928	57	7821	42	225	0	8145
15929	69	7786	48	117	0	8020
15930	61	158	35	7684	0	7938
15931	66	74	55	7721	0	7916
15932	7512	49	34	231	0	7826
15933	161	7417	44	123	0	7745
15934	78	7359	35	106	0	7578
15935	64	7626	33	67	0	7790
15936	7271	187	37	83	0	7578
15937	146	87	7220	66	0	7519
15938	7053	49	141	64	0	7307
15939	161	51	54	7007	0	7273
15940	77	6707	46	169	0	6999
15941	66	7065	25	97	0	7253
15942	6967	153	23	74	0	7217
15943	150	86	31	6760	0	7027
15944	97	7265	30	143	0	7535
15945	7376	148	37	90	0	7651
15946	7452	66	28	68	0	7614
15947	175	55	7298	51	0	7579
15948	7361	49	113	58	0	7581
15949	7461	33	55	62	0	7611
15950	190	44	33	7272	0	7539
15951	83	7149	27	163	0	7422
15952	71	7218	20	75	0	7384
15953	68	182	17	6939	0	7206
15954	6702	62	28	142	0	6934
15955	140	49	6108	71	0	6368
15956	85	31	6010	36	0	6162
15957	127	17	5789	42	0	5975
15958	112	21	5935	31	0	6099
15959	39	5961	102	28	0	6130
15960	45	5916	59	42	0	6062
15961	98	110	5531	30	0	5769
15962	48	66	5332	33	0	5479
15963	19	4730	70	23	0	4842
15964	29	33	33	4462	0	4557
15965	1	14	4726	24	0	4765
15966	10	14	27	4590	0	4641
15967	10	7	7	4832	0	4856
15968	6	0	12	4900	0	4918
15969	8	4	7	5089	0	5108
15970	5	2	5043	52	0	5102
15971	8	2	41	4898	0	4949
15972	4981	3	15	49	0	5048
15973	37	6	4921	16	0	4980
15974	4968	4	43	26	0	5041
15975	50	5	15	5104	0	5174
15976	16	4	5167	44	0	5231
15977	5131	7	46	20	0	5204
15978	47	7	16	5213	0	5283
15979	5232	5	17	47	0	5301
15980	52	3	10	5172	0	5237
15981	19	5168	9	58	0	5254
15982	17	43	5356	25	0	5441
15983	13	16	48	5394	0	5471
15984	5430	12	17	55	0	5514
15985	5446	9	11	37	0	5503
15986	5464	6	13	21	0	5504
15987	5437	6	8	24	0	5475
15988	5366	6	6	21	0	5399
15989	60	5356	10	17	0	5443
15990	5405	48	9	22	0	5484
15991	60	14	5345	24	0	5443
15992	5354	16	48	21	0	5439
15993	68	14	15	5208	0	5305
15994	24	14	5358	42	0	5438
15995	23	8	5290	21	0	5342
15996	17	7	58	5329	0	5411
15997	5407	6	27	60	0	5500
15998	53	5315	26	22	0	5416
15999	5348	46	8	28	0	5430
16000	64	5368	18	19	0	5469
16001	34	55	14	5517	0	5620
16002	26	23	12	5585	0	5646
16003	5584	15	14	65	0	5678
16004	64	10	10	5626	0	5710
16005	27	17	5638	67	0	5749
16006	5628	8	48	32	0	5716
16007	76	4	16	5815	0	5911
16008	26	9	18	5822	0	5875
16009	27	14	5750	68	0	5859
16010	5382	10	62	44	0	5498
16011	5736	9	16	34	0	5795
16012	72	5749	18	18	0	5857
16013	40	56	5599	12	0	5707
16014	30	19	5504	11	0	5564
16015	37	31	73	5461	0	5602
16016	16	26	27	5461	0	5530
16017	22	5460	15	75	0	5572
16018	18	52	5317	26	0	5413
16019	21	19	62	5159	0	5261
16020	19	8	5259	65	0	5351
16021	6	9	67	5083	0	5165
16022	11	5159	22	62	0	5254
16023	16	49	19	5314	0	5398
16024	19	15	12	5348	0	5394
16025	23	13	7	5309	0	5352
16026	5263	11	7	86	0	5367
16027	70	8	5240	20	0	5338
16028	16	5494	58	30	0	5598
16029	20	69	16	5835	0	5940
16030	5998	17	19	84	0	6118
16031	94	12	7	6103	0	6216
16032	6115	7	14	114	0	6250
16033	101	5	6205	26	0	6337
16034	6227	3	84	29	0	6343
16035	102	6	21	6383	0	6512
16036	31	9	6375	102	0	6517
16037	24	6348	96	40	0	6508
16038	26	89	25	6306	0	6446
16039	26	23	17	6441	0	6507
16040	6311	13	18	124	0	6466
16041	96	6251	19	37	0	6403
16042	25	6111	15	34	0	6185
16043	14	6321	10	32	0	6377
16044	5927	101	10	19	0	6057
16045	94	5906	9	24	0	6033
16046	43	86	19	5885	0	6033
16047	26	22	18	5961	0	6027
16048	5918	8	11	112	0	6049
16049	87	5874	8	36	0	6005
16050	34	91	5	5964	0	6094
16051	6035	22	8	107	0	6172
16052	6022	13	7	42	0	6084
16053	6018	7	6	34	0	6065
16054	117	5929	12	22	0	6080
16055	5803	80	17	16	0	5916
16056	96	35	5	5734	0	5870
16057	31	5621	7	88	0	5747
16058	23	5767	7	30	0	5827
16059	24	85	13	5705	0	5827
16060	5663	27	11	91	0	5792
16061	5761	11	6	40	0	5818
16062	97	12	4	5589	0	5702
16063	26	5518	10	83	0	5637
16064	5544	81	7	29	0	5661
16065	84	25	5385	18	0	5512
16066	31	15	5268	20	0	5334
16067	5200	8	75	23	0	5306
16068	78	11	5231	16	0	5336
16069	26	7	70	4951	0	5054
16070	5006	6	16	68	0	5096
16071	70	9	5	5092	0	5176
16072	19	11	5103	69	0	5202
16073	12	5148	62	28	0	5250
16074	16	62	16	5231	0	5325
16075	14	15	5241	66	0	5336
16076	5097	13	62	24	0	5196
16077	67	10	13	5234	0	5324
16078	20	5	5251	67	0	5343
16079	13	6	62	5167	0	5248
16080	30	5162	17	65	0	5274
16081	11	63	3	5401	0	5478
16082	15	14	5	5342	0	5376
16083	14	7	3	5237	0	5261
16084	8	5216	3	78	0	5305
16085	5331	66	4	30	0	5431
16086	66	14	7	5379	0	5466
16087	22	9	5	5412	0	5448
16088	17	4	6	5487	0	5514
16089	11	6	5418	84	0	5519
16090	8	5	60	5430	0	5503
16091	5441	7	13	81	0	5542
16092	65	5480	12	24	0	5581
16093	22	63	7	5586	0	5678
16094	12	16	5	5639	0	5672
16095	5551	11	7	86	0	5655
16096	65	5587	6	31	0	5689
16097	5646	70	5	20	0	5741
16098	5774	14	3	34	0	5825
16099	99	9	7	5721	0	5836
16100	5698	13	3	83	0	5797
16101	75	5545	5	33	0	5658
16102	5600	72	4	21	0	5697
16103	92	19	4	5750	0	5865
16104	6173	11	6	92	0	6282
16105	6316	11	5	30	0	6362
16106	115	21	5995	19	0	6150
16107	6257	8	62	23	0	6350
16108	6424	8	13	24	0	6469
16109	6493	11	4	33	0	6541
16110	124	12	6749	17	0	6902
16111	40	6807	100	10	0	6957
16112	33	106	24	6815	0	6978
16113	6814	27	14	122	0	6977
16114	112	6709	9	37	0	6867
16115	6663	110	5	30	0	6808
16116	128	25	9	6783	0	6945
16117	44	21	6799	113	0	6977
16118	7039	11	101	42	0	7193
16119	141	8	25	7260	0	7434
16120	49	10	7354	121	0	7534
16121	7454	6	118	40	0	7618
16122	146	9	7643	26	0	7824
16123	70	17	125	7896	0	8108
16124	42	10	36	8272	0	8360
16125	8188	8	17	175	0	8388
16126	8230	10	11	66	0	8317
16127	187	8143	18	35	0	8383
16128	8057	122	12	32	0	8223
16129	150	35	7670	17	0	7872
16130	59	15	7542	20	0	7636
16131	7430	21	137	20	0	7608
16132	131	7511	48	14	0	7704
16133	7328	102	29	21	0	7480
16134	124	7340	22	17	0	7503
16135	7185	112	150	12	0	7459
16136	129	40	14	7215	0	7398
16137	58	20	7260	104	0	7442
16138	39	15	105	7272	0	7431
16139	40	8	35	7456	0	7539
16140	7377	7	22	155	0	7561
16141	120	11	7308	51	0	7490
16142	7256	13	105	39	0	7413
16143	135	7269	38	27	0	7469
16144	7320	108	26	17	0	7471
16145	148	33	21	7226	0	7428
16146	61	23	7204	115	0	7403
16147	48	20	108	7215	0	7391
16148	7256	14	38	134	0	7442
16149	140	21	26	7269	0	7456
16150	77	14	19	7189	0	7299
16151	41	7003	23	151	0	7218
16152	46	106	21	7127	0	7300
16153	31	35	7065	143	0	7274
16154	45	15	112	7076	0	7248
16155	40	18	41	7190	0	7289
16156	7059	16	26	165	0	7266
16157	137	15	26	7061	0	7239
16158	59	12	6971	147	0	7189
16159	44	6999	117	77	0	7237
16160	56	103	42	7033	0	7234
16161	40	40	26	7115	0	7221
16162	7030	23	25	163	0	7241
16163	138	6873	29	73	0	7113
16164	66	107	24	6992	0	7189
16165	6825	39	25	145	0	7034
16166	6972	32	18	68	0	7090
16167	160	25	22	6908	0	7115
16168	77	20	6956	146	0	7199
16169	6976	23	123	78	0	7200
16170	157	14	46	7173	0	7390
16171	7159	19	29	175	0	7382
16172	7192	18	30	73	0	7313
16173	176	6948	16	58	0	7198
16174	6922	117	26	58	0	7123
16175	160	6904	21	42	0	7127
16176	76	123	28	6911	0	7138
16177	58	56	24	6876	0	7014
16178	53	6872	18	169	0	7112
16179	6973	127	22	76	0	7198
16180	6926	51	20	59	0	7056
16181	174	30	6680	49	0	6933
16182	78	30	6649	43	0	6800
16183	69	19	131	6732	0	6951
16184	6776	23	57	153	0	7009
16185	157	14	36	6783	0	6990
16186	72	21	32	6915	0	7040
16187	57	21	6816	179	0	7073
16188	56	23	6775	80	0	6934
16189	43	22	6907	72	0	7044
16190	6776	18	141	65	0	7000
16191	6893	24	63	56	0	7036
16192	167	6674	39	49	0	6929
16193	75	6812	30	52	0	6969
16194	61	139	25	6778	0	7003
16195	55	46	6798	142	0	7041
16196	6659	31	123	74	0	6887
16197	148	30	6979	55	0	7212
16198	58	31	123	6874	0	7086
16199	51	22	45	7052	0	7170
16200	51	14	33	7070	0	7168
16201	46	17	31	7171	0	7265
16202	7027	19	22	183	0	7251
16203	141	20	28	6936	0	7125
16204	57	9	6606	143	0	6815
16205	6249	5	112	80	0	6446
16206	130	13	6447	44	0	6634
16207	58	11	6340	42	0	6451
16208	43	6384	120	31	0	6578
16209	115	98	80	5931	0	6224
16210	5891	27	36	97	0	6051
16211	96	12	19	5908	0	6035
16212	38	15	5905	92	0	6050
16213	32	12	82	5935	0	6061
16214	5908	4	30	107	0	6049
16215	84	5902	14	52	0	6052
16216	5766	71	15	35	0	5887
16217	86	5719	13	30	0	5848
16218	5616	71	18	29	0	5734
16219	82	5481	11	27	0	5601
16220	25	5494	8	15	0	5542
16221	25	67	5248	9	0	5349
16222	22	5137	60	10	0	5229
16223	4701	43	37	21	0	4802
16224	52	9	5	4679	0	4745
16225	4704	5	5	48	0	4762
16226	40	4795	6	21	0	4862
16227	4794	44	4	14	0	4856
16228	56	11	4826	8	0	4901
16229	21	7	47	4799	0	4874
16230	8	4960	14	44	0	5026
16231	19	52	5	5134	0	5210
16232	9	18	6	5209	0	5242
16233	5689	6	7	74	0	5776
16234	84	5756	6	35	0	5881
16235	5895	88	5	14	0	6002
16236	101	27	5954	6	0	6088
16237	31	17	5739	9	0	5796
16238	15	5874	98	13	0	6000
16239	17	83	29	5879	0	6008
16240	18	24	5933	86	0	6061
16241	17	15	92	5685	0	5809
16242	16	9	28	6076	0	6129
16243	6	9	5881	112	0	6008
16244	12	10	5878	41	0	5941
16245	16	3	6038	24	0	6081
16246	6	8	6070	19	0	6103
16247	11	6299	111	16	0	6437
16248	21	91	35	6279	0	6426
16249	16	33	21	6464	0	6534
16250	11	14	6381	114	0	6520
16251	10	15	104	6376	0	6505
16252	12	15	6615	109	0	6751
16253	10	9	105	6556	0	6680
16254	15	5	39	6586	0	6645
16255	4	6595	22	127	0	6748
16256	13	99	14	6662	0	6788
16257	12	30	16	6685	0	6743
16258	18	12	13	6735	0	6778
16259	11	16	6561	128	0	6716
16260	8	6548	98	48	0	6702
16261	6555	98	32	30	0	6715
16262	6622	34	15	27	0	6698
16263	119	15	17	6560	0	6711
16264	40	23	17	6513	0	6593
16265	20	6575	17	122	0	6734
16266	6592	97	14	57	0	6760
16267	100	6679	9	30	0	6818
16268	6518	96	10	32	0	6656
16269	103	32	6445	14	0	6594
16270	6258	20	91	26	0	6395
16271	98	6466	36	21	0	6621
16272	41	92	21	6511	0	6665
16273	17	31	19	6528	0	6595
16274	12	6497	13	102	0	6624
16275	6569	92	18	48	0	6727
16276	94	30	8	6721	0	6853
16277	37	17	9	6846	0	6909
16278	6829	16	13	135	0	6993
16279	6897	9	9	56	0	6971
16280	120	10	6846	30	0	7006
16281	6889	10	90	31	0	7020
16282	116	12	29	6953	0	7110
16283	42	14	6962	102	0	7120
16284	34	10	107	6902	0	7053
16285	27	17	6828	113	0	6985
16286	13	11	6880	55	0	6959
16287	16	9	122	6882	0	7029
16288	13	16	6956	115	0	7100
16289	13	7045	113	50	0	7221
16290	16	94	49	7029	0	7188
16291	15	35	22	7319	0	7391
16292	15	15	7273	137	0	7440
16293	12	7258	108	61	0	7439
16294	7334	104	43	48	0	7529
16295	112	46	21	7429	0	7608
16296	7451	25	17	127	0	7620
16297	113	7341	25	57	0	7536
16298	49	103	7404	34	0	7590
16299	19	46	111	7344	0	7520
16300	7339	26	46	125	0	7536
16301	112	14	7303	61	0	7490
16302	7089	13	115	40	0	7257
16303	120	7169	50	26	0	7365
16304	47	7159	24	27	0	7257
16305	7117	103	38	29	0	7287
16306	100	49	25	7075	0	7249
16307	45	33	27	6959	0	7064
16308	21	7012	22	125	0	7180
16309	33	92	12	7127	0	7264
16310	15	37	13	7177	0	7242
16311	7044	22	13	146	0	7225
16312	93	19	18	7028	0	7158
16313	40	9	6979	122	0	7150
16314	32	9	92	6977	0	7110
16315	18	13	40	7159	0	7230
16316	13	19	7083	137	0	7252
16317	14	20	92	7093	0	7219
16318	6943	7	38	145	0	7133
16319	6834	5	28	82	0	6949
16320	6819	9	31	50	0	6909
16321	129	12	24	6802	0	6967
16322	62	17	6764	105	0	6948
16323	39	6759	78	66	0	6942
16324	29	82	34	6790	0	6935
16325	24	38	6763	99	0	6924
16326	24	23	85	6644	0	6776
16327	21	23	36	6695	0	6775
16328	6520	14	20	130	0	6684
16329	82	6656	16	63	0	6817
16330	50	75	6466	33	0	6624
16331	6105	38	78	43	0	6264
16332	87	6280	39	25	0	6431
16333	30	5811	11	25	0	5877
16334	6009	46	51	28	0	6134
16335	67	26	11	6051	0	6155
16336	23	25	6455	57	0	6560
16337	16	11	63	6396	0	6486
16338	18	6478	18	75	0	6589
16339	6589	68	9	40	0	6706
16340	70	24	7	6638	0	6739
16341	6748	13	5	86	0	6852
16342	80	14	4	6673	0	6771
16343	28	6879	11	80	0	6998
16344	6984	61	17	46	0	7108
16345	7004	19	6	30	0	7059
16346	92	6980	4	20	0	7096
16347	6811	69	5	22	0	6907
16348	91	25	7	6659	0	6782
16349	31	6674	7	79	0	6791
16350	6685	76	12	35	0	6808
16351	80	6772	8	17	0	6877
16352	6750	75	4	22	0	6851
16353	87	31	11	6747	0	6876
16354	6855	13	4	81	0	6953
16355	6894	11	7	40	0	6952
16356	6946	13	5	24	0	6988
16357	100	13	4	6939	0	7056
16358	46	7	5	7070	0	7128
16359	6989	4	6	107	0	7106
16360	86	15	7185	39	0	7325
16361	44	14	69	7190	0	7317
16362	20	7381	20	93	0	7514
16363	32	88	13	7485	0	7618
16364	26	27	9	7587	0	7649
16365	17	24	7499	122	0	7662
16366	30	15	86	7933	0	8064
16367	17	8349	27	130	0	8523
16368	30	133	11	8583	0	8757
16369	19	58	9143	146	0	9366
16370	33	23	137	9168	0	9361
16371	34	15	61	9396	0	9506
16372	9238	7	16	231	0	9492
16373	9331	16	10	95	0	9452
16374	237	16	9	9110	0	9372
16375	94	8871	13	171	0	9149
16376	32	9023	6	102	0	9163
16377	31	184	8913	44	0	9172
16378	54	102	145	8850	0	9151
16379	8857	29	74	183	0	9143
16380	161	16	20	8909	0	9106
16381	81	18	8846	174	0	9119
16382	42	16	149	8854	0	9061
16383	23	17	77	8992	0	9109
16384	29	17	24	9133	0	9203
16385	26	7	8866	236	0	9135
16386	21	8847	132	113	0	9113
16387	8791	141	62	53	0	9047
16388	8764	62	26	50	0	8902
16389	212	34	14	8532	0	8792
16390	84	21	8524	169	0	8798
16391	32	8503	149	87	0	8771
16392	35	173	62	8218	0	8488
16393	36	8344	27	142	0	8549
16394	25	8582	13	70	0	8690
16395	8366	184	23	48	0	8621
16396	158	65	8390	36	0	8649
16397	60	37	8312	32	0	8441
16398	41	28	188	8253	0	8510
16399	29	20	71	8477	0	8597
16400	22	18	8445	200	0	8685
16401	41	15	138	8340	0	8534
16402	27	14	8400	165	0	8606
16403	8072	11	153	90	0	8326
16404	156	11	71	8325	0	8563
16405	70	17	8440	169	0	8696
16406	40	14	147	8153	0	8354
16407	16	8576	69	168	0	8829
16408	8544	143	30	90	0	8807
16409	151	8608	22	41	0	8822
16410	8658	149	22	48	0	8877
16411	167	68	8542	31	0	8808
16412	8588	23	144	40	0	8795
16413	166	17	68	8654	0	8905
16414	78	18	8651	165	0	8912
16415	42	23	147	8595	0	8807
16416	29	26	8496	172	0	8723
16417	8196	21	156	98	0	8471
16418	154	8503	71	57	0	8785
16419	91	142	38	8232	0	8503
16420	34	8584	32	153	0	8803
16421	8575	158	23	97	0	8853
16422	8608	69	25	68	0	8770
16423	204	8562	23	48	0	8837
16424	96	162	19	8558	0	8835
16425	50	70	22	8654	0	8796
16426	34	42	14	8699	0	8789
16427	8502	23	28	238	0	8791
16428	158	8471	19	123	0	8771
16429	77	150	22	8359	0	8608
16430	37	65	36	8468	0	8606
16431	8252	32	21	249	0	8554
16432	157	29	8152	120	0	8458
16433	86	15	8088	70	0	8259
16434	7680	27	183	61	0	7951
16435	151	16	7768	40	0	7975
16436	74	22	7224	40	0	7360
16437	54	27	177	7100	0	7358
16438	7229	6	84	146	0	7465
16439	133	19	44	7198	0	7394
16440	73	18	7080	145	0	7316
16441	6782	18	131	88	0	7019
16442	128	21	6976	45	0	7170
16443	75	6927	124	32	0	7158
16444	57	124	93	6984	0	7258
16445	7067	57	38	138	0	7300
16446	116	26	38	7093	0	7273
16447	64	18	33	7178	0	7293
16448	7257	12	26	186	0	7481
16449	115	11	22	7401	0	7549
16450	63	13	29	7546	0	7651
16451	33	16	7423	167	0	7639
16452	31	4	103	7380	0	7518
16453	7434	10	60	151	0	7655
16454	7438	4	28	101	0	7571
16455	7465	11	28	52	0	7556
16456	172	21	19	7250	0	7462
16457	77	7228	16	118	0	7439
16458	7209	104	13	74	0	7400
16459	115	7311	16	40	0	7482
16460	7130	99	10	31	0	7270
16461	130	52	16	7078	0	7276
16462	6973	16	16	100	0	7105
16463	6918	12	9	83	0	7022
16464	6931	11	20	46	0	7008
16465	142	6809	25	29	0	7005
16466	56	6385	11	27	0	6479
16467	5910	46	15	22	0	5993
16468	50	6020	8	16	0	6094
16469	12	5506	3	4	0	5525
16470	12	5454	8	2	0	5476
16471	5462	20	34	11	0	5527
16472	25	11	0	5464	0	5500
16473	7	5	1	5531	0	5544
16474	5629	2	2	41	0	5674
16475	29	3	5787	7	0	5826
16476	14	4	24	6377	0	6419
16477	13	7	5	6482	0	6507
16478	14	1	3	7040	0	7058
16479	14	6	3	7268	0	7291
16480	5	7158	6	109	0	7278
16481	4	8265	3	46	0	8318
16482	8442	113	2	30	0	8587
16483	130	40	0	8455	0	8625
16484	45	33	2	8591	0	8671
16485	31	11	8512	153	0	8707
16486	29	9	113	8585	0	8736
16487	11	9	8702	163	0	8885
16488	25	2	143	8803	0	8973
16489	12	3	9206	167	0	9388
16490	4	9209	172	66	0	9451
16491	23	132	48	9275	0	9478
16492	9306	36	32	177	0	9551
16493	9337	29	23	53	0	9442
16494	198	20	8	9214	0	9440
16495	66	14	9218	179	0	9477
16496	52	7	9143	57	0	9259
16497	8891	8	186	54	0	9139
16498	157	9076	69	43	0	9345
16499	9202	159	55	29	0	9445
16500	9249	42	35	31	0	9357
16501	213	34	9080	23	0	9350
16502	93	27	158	8992	0	9270
16503	72	21	48	9078	0	9219
16504	52	12	35	9439	0	9538
16505	48	7	26	9244	0	9325
16506	41	6	26	9077	0	9150
16507	29	10	8844	264	0	9147
16508	17	10	8868	116	0	9011
16509	34	6	210	8847	0	9097
16510	25	10	75	9077	0	9187
16511	35	7	50	9136	0	9228
16512	8911	13	34	280	0	9238
16513	203	13	21	8970	0	9207
16514	8973	6	18	261	0	9258
16515	231	10	24	9199	0	9464
16516	9306	10	14	272	0	9602
16517	9523	10	20	124	0	9677
16518	9370	4	22	93	0	9489
16519	9424	10	17	74	0	9525
16520	9415	12	18	58	0	9503
16521	305	6	27	9199	0	9537
16522	9290	8	27	222	0	9547
16523	245	9228	13	98	0	9584
16524	9292	174	12	83	0	9561
16525	248	49	14	9374	0	9685
16526	106	36	9283	225	0	9650
16527	83	23	186	9361	0	9653
16528	63	14	9366	255	0	9698
16529	58	11	220	9397	0	9686
16530	56	12	75	9642	0	9785
16531	44	15	9438	287	0	9784
16532	44	8	9479	134	0	9665
16533	59	18	244	9477	0	9798
16534	9439	10	99	263	0	9811
16535	218	13	9464	117	0	9812
16536	76	9517	230	106	0	9929
16537	63	182	9845	77	0	10167
16538	9776	49	232	76	0	10133
16539	237	34	79	9859	0	10209
16540	9915	28	67	248	0	10258
16541	10070	14	51	106	0	10241
16542	294	18	42	9931	0	10285
16543	116	12	9766	270	0	10164
16544	105	13	217	9669	0	10004
16545	85	17	74	9761	0	9937
16546	9441	12	56	329	0	9838
16547	229	9603	54	142	0	10028
16548	96	187	51	9674	0	10008
16549	81	52	9468	270	0	9871
16550	9234	42	215	129	0	9620
16551	237	9297	79	118	0	9731
16552	106	190	55	9447	0	9798
16553	86	64	54	9483	0	9687
16554	78	34	46	9609	0	9767
16555	9271	31	33	344	0	9679
16556	9492	22	45	171	0	9730
16557	294	19	44	9436	0	9793
16558	122	19	9317	292	0	9750
16559	101	9338	224	132	0	9795
16560	9366	206	74	110	0	9756
16561	9614	57	55	102	0	9828
16562	305	42	57	9382	0	9786
16563	141	28	39	9644	0	9852
16564	109	18	9527	316	0	9970
16565	82	9543	222	150	0	9997
16566	9690	206	74	127	0	10097
16567	9621	49	56	92	0	9818
16568	282	9375	55	81	0	9793
16569	9234	232	35	63	0	9564
16570	295	62	25	9178	0	9560
16571	122	41	9069	265	0	9497
16572	100	38	218	9133	0	9489
16573	81	29	8994	285	0	9389
16574	8770	17	228	146	0	9161
16575	244	8748	87	111	0	9190
16576	106	212	37	8110	0	8465
16577	66	51	8011	222	0	8350
16578	63	30	7679	76	0	7848
16579	7278	30	182	77	0	7567
16580	174	7257	67	70	0	7568
16581	6372	117	104	32	0	6625
16582	6276	29	57	27	0	6389
16583	6294	12	18	36	0	6360
16584	147	30	20	6125	0	6322
16585	48	20	6051	125	0	6244
16586	39	6034	100	37	0	6210
16587	41	126	49	5958	0	6174
16588	34	21	5971	121	0	6147
16589	22	16	5500	33	0	5571
16590	28	19	88	5407	0	5542
16591	26	11	5404	81	0	5522
16592	5280	9	78	42	0	5409
16593	88	7	26	5411	0	5532
16594	34	8	14	5536	0	5592
16595	5467	8	21	95	0	5591
16596	84	5411	16	39	0	5550
16597	5610	74	19	31	0	5734
16598	80	24	14	5567	0	5685
16599	46	13	19	5634	0	5712
16600	31	7	17	5666	0	5721
16601	27	7	11	5615	0	5660
16602	5513	11	15	103	0	5642
16603	88	8	5475	38	0	5609
16604	36	5404	64	20	0	5524
16605	30	60	20	5410	0	5520
16606	5212	20	13	90	0	5335
16607	5431	10	19	33	0	5493
16608	74	5392	10	28	0	5504
16609	5290	56	14	28	0	5388
16610	64	5297	13	28	0	5402
16611	18	5499	18	26	0	5561
16612	23	65	17	5528	0	5633
16613	20	26	5542	58	0	5646
16614	33	40	54	5391	0	5518
16615	5293	17	24	69	0	5403
16616	61	5210	12	39	0	5322
16617	38	52	8	5242	0	5340
16618	25	28	5490	63	0	5606
16619	5539	12	52	48	0	5651
16620	5717	14	26	34	0	5791
16621	5751	9	11	30	0	5801
16622	73	14	5559	17	0	5663
16623	5376	10	54	25	0	5465
16624	65	5461	21	25	0	5572
16625	24	54	19	5302	0	5399
16626	18	5456	14	54	0	5542
16627	5527	49	12	35	0	5623
16628	5367	14	9	24	0	5414
16629	66	12	5629	17	0	5724
16630	24	5629	52	12	0	5717
16631	30	45	18	5621	0	5714
16632	17	16	8	5674	0	5715
16633	12	11	7	5652	0	5682
16634	12	9	12	5743	0	5776
16635	16	14	9	5813	0	5852
16636	15	9	5564	87	0	5675
16637	21	5442	60	32	0	5555
16638	5394	62	19	28	0	5503
16639	68	17	5497	20	0	5602
16640	21	5644	65	18	0	5748
16641	5639	57	15	28	0	5739
16642	72	20	5847	12	0	5951
16643	5684	6	71	25	0	5786
16644	5705	14	20	17	0	5756
16645	5908	7	6	17	0	5938
16646	86	5922	12	16	0	6036
16647	23	72	5827	16	0	5938
16648	17	6026	69	11	0	6123
16649	33	80	13	5411	0	5537
16650	17	6068	6	61	0	6152
16651	6137	71	9	23	0	6240
16652	6440	20	10	18	0	6488
16653	6351	13	6	25	0	6395
16654	114	8	6493	10	0	6625
16655	34	6784	79	12	0	6909
16656	32	96	26	7296	0	7450
16657	7807	28	11	119	0	7965
16658	135	7825	20	34	0	8014
16659	64	135	19	7752	0	7970
16660	35	42	7936	130	0	8143
16661	7962	20	133	46	0	8161
16662	165	23	8433	23	0	8644
16663	54	19	8633	16	0	8722
16664	8197	8	193	32	0	8430
16665	174	16	8348	13	0	8551
16666	8058	10	165	21	0	8254
16667	164	8087	58	15	0	8324
16668	8385	143	28	20	0	8576
16669	187	52	25	8364	0	8628
16670	86	25	29	8408	0	8548
16671	60	16	20	8578	0	8674
16672	8449	24	20	208	0	8701
16673	8491	7	17	91	0	8606
16674	8511	17	18	49	0	8595
16675	225	8321	8	35	0	8589
16676	108	146	12	8362	0	8628
16677	64	51	8337	154	0	8606
16678	57	33	151	8100	0	8341
16679	39	8091	63	167	0	8360
16680	40	151	35	8135	0	8361
16681	52	49	20	8259	0	8380
16682	8152	37	21	206	0	8416
16683	184	31	10	8184	0	8409
16684	69	26	8118	194	0	8407
16685	53	18	8070	85	0	8226
16686	60	15	196	8089	0	8360
16687	8064	16	75	192	0	8347
16688	192	14	38	8066	0	8310
16689	96	18	38	8261	0	8413
16690	56	13	8173	220	0	8462
16691	44	8135	152	105	0	8436
16692	54	147	70	8217	0	8488
16693	8098	48	46	207	0	8399
16694	168	8112	41	96	0	8417
16695	79	155	37	8185	0	8456
16696	60	77	8115	190	0	8442
16697	65	28	160	8022	0	8275
16698	7926	21	71	210	0	8228
16699	166	7827	45	98	0	8136
16700	79	151	7935	71	0	8236
16701	63	61	170	7899	0	8193
16702	49	35	8016	198	0	8298
16703	7862	30	182	107	0	8181
16704	8031	34	66	71	0	8202
16705	220	19	8011	80	0	8330
16706	115	24	175	7999	0	8313
16707	68	34	8210	183	0	8495
16708	52	8199	192	97	0	8540
16709	54	161	100	8280	0	8595
16710	36	63	8287	217	0	8603
16711	46	51	185	7959	0	8241
16712	43	8059	74	198	0	8374
16713	54	170	57	8139	0	8420
16714	41	55	8112	207	0	8415
16715	7881	39	189	98	0	8207
16716	175	8063	82	79	0	8399
16717	8208	160	68	58	0	8494
16718	198	63	7986	65	0	8312
16719	7889	38	186	51	0	8164
16720	211	38	7952	54	0	8255
16721	7929	35	191	67	0	8222
16722	8219	28	81	59	0	8387
16723	244	33	53	8077	0	8407
16724	112	23	53	8282	0	8470
16725	8207	33	49	239	0	8528
16726	201	8251	36	113	0	8601
16727	8324	166	46	75	0	8611
16728	231	67	33	8243	0	8574
16729	92	8153	53	200	0	8498
16730	85	165	38	8366	0	8654
16731	59	72	54	8568	0	8753
16732	68	37	41	8503	0	8649
16733	59	8358	34	270	0	8721
16734	8346	160	42	103	0	8651
16735	197	65	36	8370	0	8668
16736	96	40	8261	205	0	8602
16737	58	38	8083	119	0	8298
16738	60	27	8216	101	0	8404
16739	8157	25	228	68	0	8478
16740	8196	31	80	78	0	8385
16741	223	36	8032	62	0	8353
16742	107	29	163	7720	0	8019
16743	68	35	78	7875	0	8056
16744	66	26	7997	220	0	8309
16745	41	30	7925	108	0	8104
16746	50	29	192	7976	0	8247
16747	7911	20	98	197	0	8226
16748	7744	23	45	113	0	7925
16749	7719	16	47	76	0	7858
16750	208	7501	49	77	0	7835
16751	94	7577	49	58	0	7778
16752	69	150	43	7411	0	7673
16753	7380	58	40	147	0	7625
16754	153	35	7144	64	0	7396
16755	6618	20	127	69	0	6834
16756	135	6282	39	39	0	6495
16757	36	5826	21	25	0	5908
16758	5723	88	20	36	0	5867
16759	76	5638	26	22	0	5762
16760	35	5528	14	17	0	5594
16761	5225	124	125	76	0	5550
16762	45	5276	13	14	0	5348
16763	16	37	4	5113	0	5170
16764	10	12	6	5161	0	5189
16765	5134	9	8	52	0	5203
16766	5117	6	8	20	0	5151
16767	42	5169	6	14	0	5231
16768	16	5150	9	8	0	5183
16769	14	36	5116	7	0	5173
16770	5120	20	41	10	0	5191
16771	5321	8	11	4	0	5344
16772	5432	3	8	9	0	5452
16773	52	7	3	5461	0	5523
16774	22	6	8	5573	0	5609
16775	5656	3	3	56	0	5718
16776	53	4	4	5682	0	5743
16777	19	4	5684	49	0	5756
16778	20	6	38	5698	0	5762
16779	14	5906	14	47	0	5981
16780	15	44	10	5954	0	6023
16781	11	16	2	6107	0	6136
16782	15	12	4	6099	0	6130
16783	6049	10	5	63	0	6127
16784	41	5995	7	31	0	6074
16785	24	43	2	6094	0	6163
16786	18	19	6068	47	0	6152
16787	4	16	5838	24	0	5882
16788	13	5	51	5951	0	6020
16789	13	12	23	5968	0	6016
16790	5869	8	11	62	0	5950
16791	49	6	8	5774	0	5837
16792	19	5762	11	58	0	5850
16793	16	42	5885	25	0	5968
16794	19	19	42	5920	0	6000
16795	12	11	6014	50	0	6087
16796	18	4	45	5982	0	6049
16797	5995	5	20	62	0	6082
16798	6027	6	13	27	0	6073
16799	55	6030	11	25	0	6121
16800	35	42	10	6051	0	6138
16801	6197	15	10	57	0	6279
16802	6222	11	9	32	0	6274
16803	6265	6	7	30	0	6308
16804	6267	5	5	23	0	6300
16805	6156	6	9	17	0	6188
16806	68	6060	2	22	0	6152
16807	5955	39	8	11	0	6013
16808	46	9	5942	15	0	6012
16809	29	8	32	5959	0	6028
16810	5988	8	16	48	0	6060
16811	5988	3	5	28	0	6024
16812	5965	7	6	20	0	5998
16813	56	9	5981	12	0	6058
16814	28	5	33	6047	0	6113
16815	6133	7	16	48	0	6204
16816	38	6106	13	20	0	6177
16817	6297	35	4	23	0	6359
16818	6157	20	3	19	0	6199
16819	6221	4	6	26	0	6257
16820	59	11	6	6240	0	6316
16821	6281	5	6	61	0	6353
16822	55	9	6265	23	0	6352
16823	26	8	6165	18	0	6217
16824	6216	4	49	23	0	6292
16825	41	3	6295	14	0	6353
16826	5986	4	31	20	0	6041
16827	43	4	6199	16	0	6262
16828	26	16	28	6074	0	6144
16829	5978	7	15	40	0	6040
16830	37	5793	14	18	0	5862
16831	5906	22	11	24	0	5963
16832	36	5757	8	15	0	5816
16833	26	6032	10	9	0	6077
16834	19	32	8	6168	0	6227
16835	20	16	3	6203	0	6242
16836	20	10	9	6219	0	6258
16837	12	8	6211	42	0	6273
16838	6052	8	23	40	0	6123
16839	6439	6	19	23	0	6487
16840	6504	4	9	15	0	6532
16841	6525	2	8	21	0	6556
16842	6524	6	8	18	0	6556
16843	60	4	6183	11	0	6258
16844	34	10	6322	6	0	6372
16845	28	6	37	6534	0	6605
16846	19	7	6532	43	0	6601
16847	6649	4	42	21	0	6716
16848	65	6990	17	17	0	7089
16849	32	44	11	7390	0	7477
16850	7499	13	8	72	0	7592
16851	77	8	13	7664	0	7762
16852	39	5	7694	73	0	7811
16853	33	10	7733	35	0	7811
16854	33	9	87	8036	0	8165
16855	28	6	8075	74	0	8183
16856	7899	3	90	43	0	8035
16857	96	0	32	8081	0	8209
16858	39	4	8150	89	0	8282
16859	26	8170	83	39	0	8318
16860	24	76	38	8436	0	8574
16861	21	25	8532	89	0	8667
16862	36	14	93	8264	0	8407
16863	23	11	34	8454	0	8522
16864	22	8	8530	127	0	8687
16865	31	5	95	8461	0	8592
16866	19	7	45	8282	0	8353
16867	17	7	27	8534	0	8585
16868	8330	5	24	131	0	8490
16869	94	8196	21	64	0	8375
16870	34	8401	23	38	0	8496
16871	28	106	8257	26	0	8417
16872	7987	27	85	36	0	8135
16873	94	18	8223	23	0	8358
16874	28	17	8139	22	0	8206
16875	22	8	102	8053	0	8185
16876	8088	5	40	93	0	8226
16877	86	8177	21	43	0	8327
16878	8143	81	17	33	0	8274
16879	8036	32	15	34	0	8117
16880	105	8116	9	23	0	8253
16881	8113	84	10	24	0	8231
16882	8105	26	15	30	0	8176
16883	109	8257	14	23	0	8403
16884	43	94	17	8367	0	8521
16885	34	31	8	8552	0	8625
16886	8715	14	17	107	0	8853
16887	110	8882	13	35	0	9040
16888	9036	104	11	46	0	9197
16889	9138	24	19	21	0	9202
16890	9517	18	8	37	0	9580
16891	157	16	11	9448	0	9632
16892	56	15	14	9701	0	9786
16893	9589	10	2	165	0	9766
16894	9808	9	8	50	0	9875
16895	9863	17	5	34	0	9919
16896	178	11	3	10020	0	10212
16897	70	10	10058	151	0	10289
16898	40	18	136	10223	0	10417
16899	42	5	32	10894	0	10973
16900	27	13	10615	204	0	10859
16901	30	17	11159	67	0	11273
16902	40	8	216	11343	0	11607
16903	31	7	11467	209	0	11714
16904	11619	5	205	94	0	11923
16905	218	5	82	11740	0	12045
16906	84	8	30	11989	0	12111
16907	12068	5	25	277	0	12375
16908	221	13	24	12044	0	12302
16909	113	7	18	12185	0	12323
16910	51	6	27	12306	0	12390
16911	44	11	25	12344	0	12424
16912	35	5	12002	298	0	12340
16913	35	9	188	12085	0	12317
16914	31	13	11883	259	0	12186
16915	31	11992	196	127	0	12346
16916	35	193	83	11994	0	12305
16917	53	65	11726	253	0	12097
16918	11194	29	219	131	0	11573
16919	223	11607	85	71	0	11986
16920	11763	195	42	72	0	12072
16921	245	67	32	11532	0	11876
16922	101	11473	37	221	0	11832
16923	11519	206	20	128	0	11873
16924	208	11589	21	83	0	11901
16925	11749	206	29	74	0	12058
16926	244	88	22	11746	0	12100
16927	11800	39	26	243	0	12108
16928	243	11889	28	108	0	12268
16929	11970	224	33	70	0	12297
16930	254	79	11871	56	0	12260
16931	135	39	207	11958	0	12339
16932	11936	37	87	241	0	12301
16933	12085	27	33	130	0	12275
16934	307	24	32	11878	0	12241
16935	134	32	11822	258	0	12246
16936	78	11296	196	128	0	11698
16937	59	11887	77	75	0	12098
16938	11916	243	69	82	0	12310
16939	247	85	39	11797	0	12168
16940	122	29	34	11973	0	12158
16941	11758	28	30	320	0	12136
16942	11818	24	42	154	0	12038
16943	289	32	11683	88	0	12092
16944	134	29	192	11618	0	11973
16945	77	24	11463	229	0	11793
16946	69	11339	199	133	0	11740
16947	11049	178	86	100	0	11413
16948	199	10925	42	80	0	11246
16949	87	10897	31	73	0	11088
16950	97	219	44	10769	0	11129
16951	10533	78	31	201	0	10843
16952	178	10514	31	106	0	10829
16953	10386	175	28	79	0	10668
16954	184	10258	34	56	0	10532
16955	103	167	22	10293	0	10585
16956	10239	87	28	193	0	10547
16957	187	47	10254	99	0	10587
16958	106	48	162	10198	0	10514
16959	62	40	10104	190	0	10396
16960	77	9543	151	100	0	9871
16961	51	9928	79	72	0	10130
16962	9708	215	45	91	0	10059
16963	162	9788	36	68	0	10054
16964	9782	175	25	63	0	10045
16965	9832	82	132	56	0	10102
16966	215	62	9674	70	0	10021
16967	9698	31	148	74	0	9951
16968	187	51	9897	65	0	10200
16969	121	9890	152	56	0	10219
16970	9998	160	82	54	0	10294
16971	193	9957	42	58	0	10250
16972	91	170	48	10036	0	10345
16973	10008	70	34	195	0	10307
16974	206	46	34	9977	0	10263
16975	103	55	10078	189	0	10425
16976	80	48	157	10023	0	10308
16977	45	57	77	10146	0	10325
16978	10031	52	24	229	0	10336
16979	192	47	9976	107	0	10322
16980	10141	38	162	74	0	10415
16981	10541	44	71	67	0	10723
16982	279	29	37	10461	0	10806
16983	149	32	39	10447	0	10667
16984	10190	38	34	270	0	10532
16985	242	10243	39	107	0	10631
16986	125	190	41	10063	0	10419
16987	67	85	9800	185	0	10137
16988	67	47	9389	94	0	9597
16989	67	9803	176	62	0	10108
16990	61	170	73	9477	0	9781
16991	66	79	34	9559	0	9738
16992	9315	42	25	225	0	9607
16993	181	34	28	9251	0	9494
16994	8957	32	21	172	0	9182
16995	174	8781	31	103	0	9089
16996	85	8653	18	60	0	8816
16997	53	9004	20	53	0	9130
16998	8782	156	40	58	0	9036
16999	8212	58	28	46	0	8344
17000	169	8007	13	36	0	8225
17001	7347	61	17	25	0	7450
17002	75	7255	12	7	0	7349
17003	26	74	4	7081	0	7185
17004	14	7041	3	61	0	7119
17005	7072	71	10	31	0	7184
17006	7094	21	11	15	0	7141
17007	85	13	3	6868	0	6969
17008	6874	6	3	78	0	6961
17009	67	12	2	6840	0	6921
17010	30	6915	7	72	0	7024
17011	17	86	1	6945	0	7049
17012	14	6957	3	70	0	7044
17013	6903	58	5	37	0	7003
17014	65	28	6770	11	0	6874
17015	6584	13	44	20	0	6661
17016	61	7	14	6764	0	6846
17017	23	8	6752	55	0	6838
17018	6587	9	48	35	0	6679
17019	60	5	7003	11	0	7079
17020	25	8	54	6971	0	7058
17021	15	6	17	7099	0	7137
17022	10	11	7	7094	0	7122
17023	17	10	6	7214	0	7247
17024	13	7165	7	84	0	7269
17025	16	63	8	7601	0	7688
17026	7642	25	5	87	0	7759
17027	76	15	7592	35	0	7718
17028	33	8008	65	24	0	8130
17029	8236	90	28	18	0	8372
17030	8790	41	10	19	0	8860
17031	165	17	6	9573	0	9761
17032	60	11	9601	152	0	9824
17033	43	17	145	9504	0	9709
17034	37	9	57	10023	0	10126
17035	24	8	9918	241	0	10191
17036	17	10347	177	89	0	10630
17037	10582	193	77	48	0	10900
17038	10662	84	21	45	0	10812
17039	11009	33	21	34	0	11097
17040	332	21	15	10782	0	11150
17041	157	22	13	11355	0	11547
17042	11534	8	10	322	0	11874
17043	290	19	13	11227	0	11549
17044	127	11489	12	272	0	11900
17045	12122	234	21	129	0	12506
17046	12369	103	17	107	0	12596
17047	13146	44	16	70	0	13276
17048	13289	23	26	61	0	13399
17049	450	32	12599	46	0	13127
17050	217	25	12745	49	0	13036
17051	156	20	355	12647	0	13178
17052	133	24	142	12936	0	13235
17053	93	22	12642	386	0	13143
17054	80	24	12744	178	0	13026
17055	98	13	374	12703	0	13188
17056	12711	9	165	332	0	13217
17057	338	27	80	12664	0	13109
17058	198	18	12603	349	0	13168
17059	122	12796	291	168	0	13377
17060	12977	261	156	113	0	13507
17061	13261	112	85	98	0	13556
17062	13306	54	65	99	0	13524
17063	13390	22	79	78	0	13569
17064	462	32	12774	82	0	13350
17065	235	29	301	12855	0	13420
17066	12944	21	151	336	0	13452
17067	386	19	94	12947	0	13446
17068	231	19	73	12645	0	12968
17069	146	12457	65	400	0	13068
17070	144	261	57	12734	0	13196
17071	12509	107	62	374	0	13052
17072	365	12497	48	190	0	13100
17073	12508	282	43	144	0	12977
17074	391	12475	67	98	0	13031
17075	231	326	49	11954	0	12560
17076	181	11977	41	319	0	12518
17077	143	12497	42	196	0	12878
17078	12290	354	64	141	0	12849
17079	365	188	12039	114	0	12706
17080	205	100	11806	126	0	12237
17081	156	81	11615	135	0	11987
17082	11258	81	378	133	0	11850
17083	304	11353	197	133	0	11987
17084	202	11684	114	122	0	12122
17085	11326	365	66	124	0	11881
17086	357	11268	76	97	0	11798
17087	222	11670	72	91	0	12055
17088	190	401	63	11551	0	12205
17089	170	204	11480	326	0	12180
17090	145	150	11640	186	0	12121
17091	159	107	366	11662	0	12294
17092	11539	100	199	355	0	12193
17093	359	11667	141	189	0	12356
17094	239	317	97	11781	0	12434
17095	213	186	11617	326	0	12342
17096	194	144	11477	196	0	12011
17097	176	111	369	11464	0	12120
17098	11399	109	199	362	0	12069
17099	11614	107	143	216	0	12080
17100	444	97	11345	162	0	12048
17101	11324	84	351	149	0	11908
17102	423	98	11431	134	0	12086
17103	282	84	371	11014	0	11751
17104	207	11248	222	342	0	12019
17105	11514	270	185	194	0	12163
17106	391	159	136	11573	0	12259
17107	259	119	138	11485	0	12001
17108	206	80	127	11877	0	12290
17109	184	76	142	11831	0	12233
17110	174	79	11272	494	0	12019
17111	199	11178	352	262	0	11991
17112	207	268	220	11374	0	12069
17113	11344	152	158	400	0	12054
17114	412	98	123	11424	0	12057
17115	261	80	136	11546	0	12023
17116	182	81	11135	487	0	11885
17117	180	98	10823	306	0	11407
17118	174	10784	378	263	0	11599
17119	154	11089	213	228	0	11684
17120	135	370	160	10988	0	11653
17121	10931	194	114	407	0	11646
17122	359	132	10771	283	0	11545
17123	227	10749	288	220	0	11484
17124	201	311	155	10313	0	10980
17125	137	10391	110	364	0	11002
17126	139	326	105	9964	0	10534
17127	125	10098	91	366	0	10680
17128	133	310	77	9630	0	10150
17129	9255	168	82	335	0	9840
17130	237	8662	84	191	0	9174
17131	133	253	48	7696	0	8130
17132	7564	118	65	203	0	7950
17133	183	7421	41	145	0	7790
17134	93	6857	37	118	0	7105
17135	100	6972	45	78	0	7195
17136	107	175	91	6405	0	6778
17137	27	92	41	6363	0	6523
17138	32	6243	22	151	0	6448
17139	41	134	25	6203	0	6403
17140	46	79	6167	122	0	6414
17141	27	5918	75	64	0	6084
17142	36	409	37	5235	0	5717
17143	35	5610	25	71	0	5741
17144	30	81	5325	40	0	5476
17145	15	5046	48	37	0	5146
17146	4278	76	40	42	0	4436
17147	20	6	6	4198	0	4230
17148	4206	6	5	18	0	4235
17149	17	7	4170	8	0	4202
17150	12	5	14	4235	0	4266
17151	6	3	4288	18	0	4315
17152	8	6	15	4308	0	4337
17153	4411	3	7	25	0	4446
17154	18	6	3	4417	0	4444
17155	4440	4	4	23	0	4471
17156	15	4440	6	10	0	4471
17157	4433	16	3	12	0	4464
17158	17	7	4472	7	0	4503
17159	8	4390	15	5	0	4418
17160	7	17	4	4419	0	4447
17161	12	4	6	4378	0	4400
17162	4	7	4317	15	0	4343
17163	3	4297	14	11	0	4325
17164	5	18	6	4336	0	4365
17165	1	4353	6	20	0	4380
17166	5	14	4	4319	0	4342
17167	2	4297	1	19	0	4319
17168	4297	15	4	10	0	4326
17169	17	10	2	4308	0	4337
17170	5	5	4273	15	0	4298
17171	3	4240	13	4	0	4260
17172	2	4361	5	8	0	4376
17173	3	17	4329	3	0	4352
17174	1	4354	16	4	0	4375
17175	4	14	1	4346	0	4365
17176	1	2	4392	12	0	4407
17177	3	4	12	4322	0	4341
17178	3	3	2	4422	0	4430
17179	4	3	4400	17	0	4424
17180	4197	4	13	11	0	4225
17181	12	4	3	4473	0	4492
17182	3	5	4685	12	0	4705
17183	2	4678	14	6	0	4700
17184	4759	11	4	11	0	4785
17185	12	4712	3	3	0	4730
17186	2	15	1	4765	0	4783
17187	4698	3	2	17	0	4720
17188	14	1	1	4649	0	4665
17189	6	5	4808	16	0	4835
17190	7	2	14	4776	0	4799
17191	1	2	4821	14	0	4838
17192	4657	1	14	8	0	4680
17193	16	3	4833	3	0	4855
17194	4796	1	16	10	0	4823
17195	4896	2	4	5	0	4907
17196	16	1	4875	6	0	4898
17197	7	4	4683	2	0	4696
17198	4	4876	20	2	0	4902
17199	5043	15	8	7	0	5073
17200	18	8	3	5134	0	5163
17201	11	4	5	5087	0	5107
17202	5386	2	2	34	0	5424
17203	5447	4	3	9	0	5463
17204	5453	1	4	9	0	5467
17205	5434	2	2	8	0	5446
17206	26	2	3	5329	0	5360
17207	5387	1	3	24	0	5415
17208	23	2	3	5365	0	5393
17209	9	1	3	5360	0	5373
17210	12	2	2	5402	0	5418
17211	5	3	5322	25	0	5355
17212	6	5139	15	16	0	5176
17213	6	5265	6	4	0	5281
17214	5	18	3	5368	0	5394
17215	5354	8	3	26	0	5391
17216	18	7	1	5347	0	5373
17217	5310	2	1	25	0	5338
17218	23	4	5445	9	0	5481
17219	5317	4	14	12	0	5347
17220	21	5	8	5576	0	5610
17221	5720	3	2	33	0	5758
17222	5654	3	2	15	0	5674
17223	5738	4	2	12	0	5756
17224	28	1	2	5742	0	5773
17225	13	4	5713	20	0	5750
17226	10	3	18	5717	0	5748
17227	5810	5	8	28	0	5851
17228	24	2	6376	13	0	6415
17229	12	7	20	6845	0	6884
17230	7118	2	10	42	0	7172
17231	37	3	7229	18	0	7287
17232	7580	4	43	21	0	7648
17233	7909	3	14	17	0	7943
17234	69	5	10	8091	0	8175
17235	28	3	7	8207	0	8245
17236	8198	4	4	80	0	8286
17237	72	5	4	8526	0	8607
17238	8464	4	4	107	0	8579
17239	82	8506	6	27	0	8621
17240	21	8603	1	19	0	8644
17241	20	95	2	8656	0	8773
17242	11	31	8850	73	0	8965
17243	5	8783	80	30	0	8898
17244	8703	82	19	25	0	8829
17245	71	8600	15	12	0	8698
17246	19	83	8630	5	0	8737
17247	30	26	73	8601	0	8730
17248	9	29	8711	80	0	8829
17249	6	8868	88	28	0	8990
17250	20	76	27	8800	0	8923
17251	5	8796	20	83	0	8904
17252	9	88	8822	18	0	8937
17253	12	24	79	8755	0	8870
17254	6	23	8878	80	0	8987
17255	13	11	91	8802	0	8917
17256	8832	9	25	103	0	8969
17257	81	6	8727	30	0	8844
17258	8323	4	83	27	0	8437
17259	92	6	8609	16	0	8723
17260	39	5	87	8554	0	8685
17261	24	8	8918	82	0	9032
17262	26	4	89	8921	0	9040
17263	14	1	27	9047	0	9089
17264	14	5	23	8914	0	8956
17265	11	4	13	9081	0	9109
17266	9	7	9338	116	0	9470
17267	9175	5	84	64	0	9328
17268	87	8	24	9849	0	9968
17269	9876	2	18	101	0	9997
17270	9950	5	18	40	0	10013
17271	10039	5	8	42	0	10094
17272	120	1	7	10108	0	10236
17273	49	9	7	10058	0	10123
17274	28	10152	14	111	0	10305
17275	10371	84	4	49	0	10508
17276	10387	25	8	44	0	10464
17277	10430	19	6	33	0	10488
17278	130	12	10509	19	0	10670
17279	55	7	88	10521	0	10671
17280	36	9	10503	96	0	10644
17281	10312	5	91	40	0	10448
17282	10484	7	34	36	0	10561
17283	119	3	22	10373	0	10517
17284	52	5	14	10317	0	10388
17285	26	10558	15	112	0	10711
17286	10631	89	8	51	0	10779
17287	10597	22	10	51	0	10680
17288	109	10565	10	29	0	10713
17289	10570	93	13	32	0	10708
17290	115	22	7	10671	0	10815
17291	44	21	13	10757	0	10835
17292	10736	8	9	136	0	10889
17293	114	9	10723	42	0	10888
17294	10577	5	91	48	0	10721
17295	10807	7	24	37	0	10875
17296	115	10650	23	28	0	10816
17297	10764	86	14	34	0	10898
17298	111	25	10648	23	0	10807
17299	50	20	88	10692	0	10850
17300	10681	15	25	107	0	10828
17301	105	9	20	10681	0	10815
17302	39	10	10317	115	0	10481
17303	38	8	81	10133	0	10260
17304	26	11151	23	101	0	11301
17305	29	104	25	11391	0	11549
17306	31	34	11	11684	0	11760
17307	30	20	14	11514	0	11578
17308	28	14	7	11697	0	11746
17309	18	14	11557	136	0	11725
17310	17	13	89	11583	0	11702
17311	11615	9	24	141	0	11789
17312	95	11581	23	51	0	11750
17313	38	84	19	11857	0	11998
17314	28	22	11965	121	0	12136
17315	24	17	93	12025	0	12159
17316	12165	10	24	148	0	12347
17317	12200	5	27	56	0	12288
17318	11987	5	20	60	0	12072
17319	142	9	6	12065	0	12222
17320	56	14	11967	100	0	12137
17321	42	11793	84	55	0	11974
17322	11980	83	31	47	0	12141
17323	113	24	16	11862	0	12015
17324	43	34	14	11899	0	11990
17325	37	16	11838	117	0	12008
17326	32	11588	91	62	0	11773
17327	19	11969	30	48	0	12066
17328	41	166	41	11338	0	11586
17329	29	34	10990	95	0	11148
17330	10212	14	70	51	0	10347
17331	85	10	10529	24	0	10648
17332	9933	14	56	38	0	10041
17333	74	10796	23	22	0	10915
17334	29	52	10602	15	0	10698
17335	10297	16	52	36	0	10401
17336	62	10486	25	17	0	10590
17337	10730	25	10	35	0	10800
17338	43	19	11067	4	0	11133
17339	23	11091	28	7	0	11149
17340	11258	31	26	21	0	11336
17341	40	23	11184	10	0	11257
17342	11006	3	38	19	0	11066
17343	46	7	13	11110	0	11176
17344	11204	3	6	53	0	11266
17345	48	4	5	11264	0	11321
17346	11249	4	9	56	0	11318
17347	47	10	11570	15	0	11642
17348	33	7	40	11651	0	11731
17349	10	3	17	11598	0	11628
17350	15	5	11791	60	0	11871
17351	18	1	42	12033	0	12094
17352	39	9416	80	74	0	9609
17353	14	43	8	13175	0	13240
17354	21	16	10	13989	0	14036
17355	16	5	9	15355	0	15385
17356	9	10	15367	178	0	15564
17357	14991	2	144	86	0	15223
17358	202	5	53	16382	0	16642
17359	73	13	16922	195	0	17203
17360	16728	8	203	96	0	17035
17361	17335	4	73	57	0	17469
17362	17825	5	22	53	0	17905
17363	328	6	25	17809	0	18168
17364	143	7	23	19631	0	19804
17365	73	17	10	19415	0	19515
17366	35	19341	18	394	0	19788
17367	19269	285	17	166	0	19737
17368	19527	101	19	95	0	19742
17369	437	16	23	19204	0	19680
17370	152	30	18964	331	0	19477
17371	72	24	18818	158	0	19072
17372	51	18885	397	83	0	19416
17373	98	346	128	18829	0	19401
17374	18982	113	51	368	0	19514
17375	344	19096	38	150	0	19628
17376	19608	320	32	107	0	20067
17377	19771	114	40	92	0	20017
17378	19897	32	39	98	0	20066
17379	500	44	41	19943	0	20528
17380	229	35	32	21179	0	21475
17381	21567	22	30	517	0	22136
17382	476	28	35	21950	0	22489
17383	203	30	21878	460	0	22571
17384	22188	34	393	205	0	22820
17385	495	31	134	22280	0	22940
17386	234	36	49	22648	0	22967
17387	152	34	34	22901	0	23121
17388	111	43	22185	582	0	22921
17389	21180	21	409	280	0	21890
17390	465	28	22061	143	0	22697
17391	229	26	452	21992	0	22699
17392	130	31	22349	478	0	22988
17393	129	39	441	22057	0	22666
17394	134	31	175	22603	0	22943
17395	105	44	22845	628	0	23622
17396	186	34	448	21529	0	22197
17397	124	22841	161	468	0	23594
17398	22974	410	78	268	0	23730
17399	23409	130	68	184	0	23791
17400	629	46	60	23113	0	23848
17401	245	53	23118	528	0	23944
17402	161	22311	467	266	0	23205
17403	133	23422	200	187	0	23942
17404	22405	504	110	193	0	23212
17405	503	158	22040	161	0	22862
17406	22045	64	463	175	0	22747
17407	547	54	177	22058	0	22836
17408	269	40	110	22508	0	22927
17409	21801	39	93	698	0	22631
17410	514	21833	92	312	0	22751
17411	223	436	22015	227	0	22901
17412	190	155	456	21769	0	22570
17413	152	63	22120	548	0	22883
17414	114	21871	521	281	0	22787
17415	142	440	223	22140	0	22945
17416	21932	161	120	599	0	22812
17417	22246	92	111	317	0	22766
17418	614	110	21864	186	0	22774
17419	282	21827	492	181	0	22782
17420	21837	440	203	187	0	22667
17421	530	21935	130	174	0	22769
17422	296	481	101	21818	0	22696
17423	21802	201	97	555	0	22655
17424	578	101	104	21981	0	22764
17425	279	96	21570	587	0	22532
17426	199	77	493	21803	0	22572
17427	182	95	21653	588	0	22518
17428	181	95	483	21615	0	22374
17429	21592	64	230	608	0	22494
17430	550	21613	130	329	0	22622
17431	21723	462	128	227	0	22540
17432	595	195	120	21547	0	22457
17433	294	124	114	21740	0	22272
17434	197	144	19045	730	0	20116
17435	187	100	21161	366	0	21814
17436	178	21228	580	232	0	22218
17437	182	492	21057	209	0	21940
17438	19977	183	567	219	0	20946
17439	544	20325	247	230	0	21346
17440	273	20680	165	211	0	21329
17441	174	21040	137	198	0	21549
17442	191	621	114	20653	0	21579
17443	179	251	20821	570	0	21821
17444	156	20948	500	341	0	21945
17445	185	515	233	19903	0	20836
17446	159	21099	148	560	0	21966
17447	20706	517	147	270	0	21640
17448	21040	222	131	235	0	21628
17449	656	141	145	20602	0	21544
17450	301	142	133	20680	0	21256
17451	19754	113	121	698	0	20686
17452	530	19233	106	326	0	20195
17453	253	19288	120	238	0	19899
17454	233	610	94	17980	0	18917
17455	108	177	16817	430	0	17532
17456	97	16570	358	221	0	17246
17457	15869	349	188	156	0	16562
17458	326	15437	115	123	0	16001
17459	144	15273	98	105	0	15620
17460	14601	367	110	115	0	15193
17461	305	14884	67	98	0	15354
17462	141	308	14514	105	0	15068
17463	106	14397	276	106	0	14885
17464	12647	226	158	58	0	13089
17465	181	12616	47	54	0	12898
17466	12570	201	68	45	0	12884
17467	218	83	27	12468	0	12796
17468	87	68	31	12709	0	12895
17469	74	51	12650	215	0	12990
17470	42	12690	175	101	0	13008
17471	47	181	48	12829	0	13105
17472	12786	60	46	195	0	13087
17473	12733	54	36	71	0	12894
17474	196	12788	34	79	0	13097
17475	83	178	29	12755	0	13045
17476	12726	70	26	192	0	13014
17477	12741	62	28	77	0	12908
17478	215	45	12255	59	0	12574
17479	104	39	11341	35	0	11519
17480	58	31	11084	33	0	11206
17481	27	10682	121	18	0	10848
17482	10136	97	161	26	0	10420
17483	87	9977	35	23	0	10122
17484	9850	96	30	22	0	9998
17485	86	10138	10	13	0	10247
17486	38	100	4	10308	0	10450
17487	10385	28	3	91	0	10507
17488	96	26	10366	21	0	10509
17489	10223	11	84	25	0	10343
17490	10447	12	33	17	0	10509
17491	92	10366	17	16	0	10491
17492	34	10424	11	13	0	10482
17493	10603	85	29	23	0	10740
17494	89	43	10782	10	0	10924
17495	10063	48	89	24	0	10224
17496	10228	22	25	31	0	10306
17497	92	7	11	10101	0	10211
17498	10297	7	10	73	0	10387
17499	90	11	7	10423	0	10531
17500	41	10	6	10629	0	10686
17501	38	10	4	10360	0	10412
17502	18	10313	3	98	0	10432
17503	10459	70	5	41	0	10575
17504	10526	25	7	33	0	10591
17505	102	18	11	10525	0	10656
17506	45	14	11	10432	0	10502
17507	24	10425	15	82	0	10546
17508	10419	71	10	45	0	10545
17509	84	29	10323	20	0	10456
17510	49	17	66	10398	0	10530
17511	23	24	10239	74	0	10360
17512	32	10	75	10242	0	10359
17513	18	20	10238	84	0	10360
17514	32	9	77	10056	0	10174
17515	10091	12	28	94	0	10225
17516	83	13	10172	32	0	10300
17517	9863	8	71	41	0	9983
17518	87	10363	29	19	0	10498
17519	44	71	16	10584	0	10715
17520	29	29	16	10685	0	10759
17521	10973	17	11	112	0	11113
17522	89	18	11	11384	0	11502
17523	45	13	11504	83	0	11645
17524	11366	9	61	68	0	11504
17525	11816	4	21	51	0	11892
17526	11833	12	13	36	0	11894
17527	11753	10	12	35	0	11810
17528	121	11653	10	25	0	11809
17529	52	65	8	11649	0	11774
17530	11614	19	9	79	0	11721
17531	89	16	6	11473	0	11584
17532	11329	15	11	79	0	11434
17533	68	15	11116	39	0	11238
17534	43	11	10971	25	0	11050
17535	47	127	63	10625	0	10862
17536	29	10778	25	58	0	10890
17537	23	11149	23	33	0	11228
17538	10990	62	30	58	0	11140
17539	67	23	11028	21	0	11139
17540	10196	18	51	42	0	10307
17541	69	10855	17	23	0	10964
17542	10914	41	11	36	0	11002
17543	63	18	17	10744	0	10842
17544	31	21	10847	58	0	10957
17545	37	11	47	10785	0	10880
17546	32	11	19	10726	0	10788
17547	26	10684	9	66	0	10785
17548	22	11000	13	35	0	11070
17549	30	58	9	11044	0	11141
17550	25	11147	12	78	0	11262
17551	25	53	11047	27	0	11152
17552	30	19	10705	22	0	10776
17553	10311	11	58	39	0	10419
17554	10940	13	26	24	0	11003
17555	66	10757	16	32	0	10871
17556	41	48	10	10817	0	10916
17557	26	18	8	10884	0	10936
17558	24	12	10885	76	0	10997
17559	33	12	55	10456	0	10556
17560	23	10703	20	68	0	10814
17561	24	58	10439	25	0	10546
17562	30	15	10255	17	0	10317
17563	19	9796	69	39	0	9923
17564	21	63	10371	24	0	10479
17565	25	18	67	10302	0	10412
17566	59	16	32	9324	0	9431
17567	23	15	10491	73	0	10602
17568	33	24	64	10265	0	10386
17569	16	10083	21	76	0	10196
17570	20	10558	13	38	0	10629
17571	21	83	15	10381	0	10500
17572	16	18	10528	78	0	10640
17573	14	10584	66	30	0	10694
17574	29	99	28	10551	0	10707
17575	19	15	10391	69	0	10494
17576	9861	8	58	33	0	9960
17577	10337	10	12	32	0	10391
17578	10333	4	12	21	0	10370
17579	75	9	11	10252	0	10347
17580	31	8	6	10303	0	10348
17581	19	11	10634	65	0	10729
17582	19	7	58	10538	0	10622
17583	20	7	17	10712	0	10756
17584	7	8	10714	72	0	10801
17585	9380	7	57	55	0	9499
17586	53	10047	17	21	0	10138
17587	10078	47	17	24	0	10166
17588	56	10025	11	10	0	10102
17589	29	59	4	10057	0	10149
17590	13	24	10153	56	0	10246
17591	19	27	55	9901	0	10002
17592	10	12	9973	61	0	10056
17593	8936	8	61	58	0	9063
17594	50	7	9645	18	0	9720
17595	19	7	62	9502	0	9590
17596	12	6	9718	62	0	9798
17597	15	9979	68	19	0	10081
17598	21	75	23	10330	0	10449
17599	23	20	11	10462	0	10516
17600	20	12	13	11006	0	11051
17601	10	7	11034	118	0	11169
17602	8	6	11413	43	0	11470
17603	16	3	123	11493	0	11635
17604	33	9	41	13371	0	13454
17605	22	2	24	14285	0	14333
17606	14649	7	16	290	0	14962
17607	232	5	10	15152	0	15399
17608	83	10	15773	264	0	16130
17609	16318	12	243	123	0	16696
17610	312	5	94	16904	0	17315
17611	17449	3	70	334	0	17856
17612	18033	2	32	147	0	18214
17613	464	3	19	18011	0	18497
17614	18143	7	22	378	0	18550
17615	18344	4	21	159	0	18528
17616	455	10	18019	95	0	18579
17617	183	18194	308	62	0	18747
17618	153	302	105	17710	0	18270
17619	97	104	62	18404	0	18667
17620	18197	48	35	448	0	18728
17621	18017	34	33	198	0	18282
17622	17924	14	33	124	0	18095
17623	489	12	16966	93	0	17560
17624	223	17098	318	68	0	17707
17625	17166	310	121	76	0	17673
17626	378	17257	72	61	0	17768
17627	17355	360	55	71	0	17841
17628	420	144	30	17316	0	17910
17629	17351	68	33	382	0	17834
17630	17575	49	27	171	0	17822
17631	17716	23	23	119	0	17881
17632	524	23	17212	88	0	17847
17633	17605	28	303	90	0	18026
17634	462	17578	120	64	0	18224
17635	18012	323	67	74	0	18476
17636	18304	121	50	64	0	18539
17637	18579	75	38	62	0	18754
17638	581	54	29	17805	0	18469
17639	280	17975	37	358	0	18650
17640	18144	335	30	163	0	18672
17641	469	121	17908	100	0	18598
17642	223	18076	328	104	0	18731
17643	228	355	118	16920	0	17621
17644	160	17940	76	287	0	18463
17645	17971	399	65	148	0	18583
17646	18620	162	50	112	0	18944
17647	558	101	28	18296	0	18983
17648	265	78	17971	398	0	18712
17649	209	18011	324	195	0	18739
17650	312	365	148	15183	0	16008
17651	149	143	97	18606	0	18995
17652	152	91	75	19222	0	19540
17653	18944	85	52	587	0	19668
17654	19220	58	53	271	0	19602
17655	19317	64	45	177	0	19603
17656	19501	51	36	164	0	19752
17657	688	60	45	19025	0	19818
17658	387	61	19016	456	0	19920
17659	274	53	381	19212	0	19920
17660	240	48	141	19473	0	19902
17661	205	38	95	19606	0	19944
17662	212	65	78	19657	0	20012
17663	19177	51	63	676	0	19967
17664	525	61	79	19319	0	19984
17665	19253	40	49	577	0	19919
17666	19500	48	45	335	0	19928
17667	703	58	18869	212	0	19842
17668	407	48	18590	191	0	19236
17669	326	59	19146	175	0	19706
17670	290	79	508	18709	0	19586
17671	282	62	19011	460	0	19815
17672	253	68	466	18750	0	19537
17673	225	79	216	19003	0	19523
17674	18955	68	117	627	0	19767
17675	581	63	96	18697	0	19437
17676	360	19006	86	550	0	20002
17677	19471	387	96	310	0	20264
17678	597	19523	87	224	0	20431
17679	327	442	19551	208	0	20528
17680	244	19841	413	189	0	20687
17681	19506	458	197	175	0	20336
17682	579	231	116	19384	0	20310
17683	365	150	19170	467	0	20152
17684	19292	109	415	275	0	20091
17685	635	103	170	19373	0	20281
17686	389	93	19291	484	0	20257
17687	306	105	447	19452	0	20310
17688	285	76	201	19627	0	20189
17689	252	103	142	19597	0	20094
17690	241	19273	125	629	0	20268
17691	19586	413	88	357	0	20444
17692	616	178	83	19288	0	20165
17693	345	19375	88	518	0	20326
17694	287	447	71	19408	0	20213
17695	242	225	19173	540	0	20180
17696	239	19290	392	299	0	20220
17697	19023	426	195	230	0	19874
17698	19053	215	113	184	0	19565
17699	600	151	93	18529	0	19373
17700	322	134	81	18637	0	19174
17701	18448	98	83	560	0	19189
17702	17976	70	75	324	0	18445
17703	564	17919	68	242	0	18793
17704	16017	281	55	187	0	16540
17705	403	108	15191	116	0	15818
17706	236	84	14831	93	0	15244
17707	151	14264	254	116	0	14785
17708	97	14098	115	83	0	14393
17709	12971	200	238	79	0	13488
17710	184	12893	52	45	0	13174
17711	12584	158	58	51	0	12851
17712	12386	59	30	69	0	12544
17713	12230	39	31	53	0	12353
17714	202	35	25	12109	0	12371
17715	12176	30	27	177	0	12410
17716	201	29	11926	57	0	12213
17717	86	20	11901	70	0	12077
17718	64	11927	163	55	0	12209
17719	61	130	12061	49	0	12301
17720	66	56	161	11825	0	12108
17721	53	44	12019	161	0	12277
17722	51	36	11928	68	0	12083
17723	50	36	171	12002	0	12259
17724	12048	20	78	184	0	12330
17725	12150	35	55	80	0	12320
17726	176	29	12271	54	0	12530
17727	12154	33	148	63	0	12398
17728	183	31	12475	46	0	12735
17729	12395	24	162	57	0	12638
17730	12968	21	58	54	0	13101
17731	218	17	43	12824	0	13102
17732	105	25	40	12609	0	12779
17733	81	12278	40	179	0	12578
17734	65	12661	34	87	0	12847
17735	63	173	28	12354	0	12618
17736	62	69	35	12547	0	12713
17737	12109	51	22	189	0	12371
17738	155	12032	27	93	0	12307
17739	12029	135	26	90	0	12280
17740	168	12096	29	39	0	12332
17741	73	155	12026	42	0	12296
17742	68	73	129	12046	0	12316
17743	12209	45	57	165	0	12476
17744	12791	32	39	78	0	12940
17745	207	12987	39	61	0	13294
17746	86	13199	32	36	0	13353
17747	66	13496	33	43	0	13638
17748	65	247	36	14078	0	14426
17749	57	78	14227	206	0	14568
17750	35	14137	198	71	0	14441
17751	57	207	72	14024	0	14360
17752	46	58	26	14272	0	14402
17753	34	33	14012	219	0	14298
17754	33	19	13836	81	0	13969
17755	13755	18	221	59	0	14053
17756	213	25	14344	23	0	14605
17757	14203	18	209	55	0	14485
17758	14132	15	57	45	0	14249
17759	14175	15	38	41	0	14269
17760	14085	17	27	49	0	14178
17761	258	22	13689	27	0	13996
17762	80	13814	178	22	0	14094
17763	72	192	50	13737	0	14051
17764	45	53	13892	192	0	14182
17765	61	37	192	13581	0	13871
17766	42	12440	90	222	0	12794
17767	59	195	36	14100	0	14390
17768	60	66	28	14187	0	14341
17769	63	44	24	13984	0	14115
17770	13963	23	18	269	0	14273
17771	225	24	31	13889	0	14169
17772	87	33	24	13930	0	14074
17773	66	25	29	13797	0	13917
17774	40	13339	39	255	0	13673
17775	13288	184	31	108	0	13611
17776	201	12689	36	60	0	12986
17777	73	12971	31	52	0	13127
17778	71	200	40	13021	0	13332
17779	61	57	30	13116	0	13264
17780	13011	29	26	249	0	13315
17781	221	24	30	13167	0	13442
17782	13299	13	22	245	0	13579
17783	15112	20	33	86	0	15251
17784	348	28	25	15010	0	15411
17785	147	36	22	15030	0	15235
17786	56	15240	35	336	0	15667
17787	15603	283	25	151	0	16062
17788	304	16075	27	89	0	16495
17789	16060	326	32	80	0	16498
17790	338	123	15785	65	0	16311
17791	15861	66	276	79	0	16282
17792	16580	38	90	80	0	16788
17793	426	36	54	16099	0	16615
17794	278	40	16075	343	0	16736
17795	94	16204	318	175	0	16791
17796	81	342	107	16569	0	17099
17797	71	120	16473	376	0	17040
17798	72	79	326	16320	0	16797
17799	16052	54	106	397	0	16609
17800	362	37	15913	168	0	16480
17801	164	15480	325	96	0	16065
17802	97	16019	122	75	0	16313
17803	131	435	73	14282	0	14921
17804	79	15781	52	275	0	16187
17805	15776	365	51	145	0	16337
17806	15875	136	32	110	0	16153
17807	15942	62	32	92	0	16128
17808	451	48	15284	73	0	15856
17809	15593	47	311	82	0	16033
17810	397	67	118	15422	0	16004
17811	186	60	56	15694	0	15996
17812	112	52	48	15812	0	16024
17813	98	50	39	15770	0	15957
17814	85	52	15337	480	0	15954
17815	68	51	15278	209	0	15606
17816	75	58	15167	119	0	15419
17817	14619	39	412	117	0	15187
17818	338	14861	167	102	0	15468
17819	190	314	73	14832	0	15409
17820	14711	128	55	405	0	15299
17821	366	14826	42	192	0	15426
17822	158	15219	67	125	0	15569
17823	14993	420	43	119	0	15575
17824	15188	164	51	92	0	15495
17825	426	15118	59	100	0	15703
17826	223	344	44	14394	0	15005
17827	145	14901	41	325	0	15412
17828	14800	350	44	175	0	15369
17829	14816	155	55	127	0	15153
17830	14694	109	48	79	0	14930
17831	492	14295	32	103	0	14922
17832	216	343	42	14389	0	14990
17833	136	144	14288	373	0	14941
17834	136	76	304	14217	0	14733
17835	109	78	115	14547	0	14849
17836	104	74	14076	437	0	14691
17837	13850	67	324	212	0	14453
17838	383	53	137	14104	0	14677
17839	184	85	69	13991	0	14329
17840	112	13867	63	437	0	14479
17841	13799	330	57	201	0	14387
17842	397	151	45	13462	0	14055
17843	187	13453	54	349	0	14043
17844	12761	290	61	192	0	13304
17845	336	12559	44	103	0	13042
17846	11892	288	56	109	0	12345
17847	309	129	11747	93	0	12278
17848	153	76	10562	71	0	10862
17849	100	59	10551	73	0	10783
17850	77	10588	306	73	0	11044
17851	124	226	226	9740	0	10316
17852	83	10083	67	195	0	10428
17853	10319	238	37	117	0	10711
17854	230	122	10348	71	0	10771
17855	10206	71	212	68	0	10557
17856	10341	60	98	61	0	10560
17857	308	52	69	10146	0	10575
17858	10275	54	49	224	0	10602
17859	276	44	49	10297	0	10666
17860	142	50	10228	238	0	10658
17861	10025	51	217	133	0	10426
17862	235	10134	120	75	0	10564
17863	127	215	64	10209	0	10615
17864	10227	120	41	216	0	10604
17865	263	64	33	10211	0	10571
17866	145	60	9988	251	0	10444
17867	118	42	198	9859	0	10217
17868	77	9948	112	229	0	10366
17869	10013	215	56	121	0	10405
17870	254	99	45	9974	0	10372
17871	10062	60	29	256	0	10407
17872	266	44	34	10056	0	10400
17873	152	40	30	9885	0	10107
17874	82	9920	41	278	0	10321
17875	9944	198	38	152	0	10332
17876	235	10211	31	85	0	10562
17877	122	216	33	9582	0	9953
17878	63	9665	31	219	0	9978
17879	9612	212	27	121	0	9972
17880	9446	104	32	94	0	9676
17881	9375	58	23	79	0	9535
17882	302	8926	29	64	0	9321
17883	63	7324	10	29	0	7426
17884	7178	120	12	32	0	7342
17885	111	7283	12	31	0	7437
17886	57	161	23	6903	0	7144
17887	52	31	6721	92	0	6896
17888	6241	30	61	38	0	6370
17889	6356	15	16	24	0	6411
17890	6280	11	8	24	0	6323
17891	78	6235	4	13	0	6330
17892	6036	55	8	18	0	6117
17893	63	20	6246	7	0	6336
17894	30	6128	29	7	0	6194
17895	24	82	25	5781	0	5912
17896	6	5796	4	27	0	5833
17897	5581	25	9	11	0	5626
17898	21	5642	1	6	0	5670
17899	11	19	0	5689	0	5719
17900	6	5729	1	16	0	5752
17901	5	22	4	5900	0	5931
17902	6	9	2	5789	0	5806
17903	4	4	5816	27	0	5851
17904	8	6	17	5674	0	5705
17905	5666	3	7	33	0	5709
17906	5650	4	2	17	0	5673
17907	34	3	3	5691	0	5731
17908	12	6	5644	21	0	5683
17909	6	4	18	5595	0	5623
17910	5610	4	7	29	0	5650
17911	5762	3	2	26	0	5793
17912	5842	5	3	15	0	5865
17913	28	6055	6	20	0	6109
17914	6150	22	5	12	0	6189
17915	25	11	6135	4	0	6175
17916	6598	4	23	24	0	6649
17917	24	5	11	6829	0	6869
17918	20	2	4	6906	0	6932
17919	12	3	2	6954	0	6971
17920	6810	2	3	50	0	6865
17921	6694	1	2	25	0	6722
17922	42	3	7	6691	0	6743
17923	13	9	6817	31	0	6870
17924	11	1	26	6743	0	6781
17925	15	3	12	6648	0	6678
17926	7	5	6620	38	0	6670
17927	4	6634	26	17	0	6681
17928	6	28	11	6748	0	6793
17929	6867	13	3	38	0	6921
17930	35	4	3	6886	0	6928
17931	15	2	1	6914	0	6932
17932	6927	7	2	50	0	6986
17933	32	6867	2	21	0	6922
17934	15	6974	3	8	0	7000
17935	6947	37	1	18	0	7003
17936	33	13	6985	8	0	7039
17937	6780	4	31	18	0	6833
17938	33	5	7418	5	0	7461
17939	15	7525	30	8	0	7578
17940	7619	29	11	25	0	7684
17941	7673	15	3	18	0	7709
17942	7725	2	3	13	0	7743
17943	7756	2	1	15	0	7774
17944	47	4	7743	4	0	7798
17945	23	1	30	7670	0	7724
17946	7748	1	14	42	0	7805
17947	43	4	7981	14	0	8042
17948	15	4	7858	7	0	7884
17949	3	7970	42	5	0	8020
17950	8112	31	16	16	0	8175
17951	41	16	1	8093	0	8151
17952	8174	0	5	42	0	8221
17953	34	8334	4	18	0	8390
17954	18	35	3	8839	0	8895
17955	12	13	2	8875	0	8902
17956	9	1	2	9077	0	9089
17957	9	7	9220	63	0	9299
17958	5	9344	53	22	0	9424
17959	9879	55	18	21	0	9973
17960	81	18	3	9908	0	10010
17961	9910	1	4	88	0	10003
17962	9851	2	4	30	0	9887
17963	103	4	4	9854	0	9965
17964	33	3	9998	79	0	10113
17965	23	5	72	9927	0	10027
17966	12	10050	22	76	0	10160
17967	19	69	5	10211	0	10304
17968	10	18	10204	73	0	10305
17969	10127	4	68	38	0	10237
17970	84	6	21	10325	0	10436
17971	10199	3	8	89	0	10299
17972	82	7	10139	30	0	10258
17973	9820	4	68	28	0	9920
17974	76	4	10126	19	0	10225
17975	9767	3	70	21	0	9861
17976	73	9857	32	22	0	9984
17977	30	10118	8	9	0	10165
17978	18	95	10	10118	0	10241
17979	38	27	17	9464	0	9546
17980	16	10	7	10211	0	10244
17981	10208	6	6	110	0	10330
17982	78	10	6	10320	0	10414
17983	34	5	10361	86	0	10486
17984	10043	8	72	51	0	10174
17985	78	10414	21	29	0	10542
17986	10508	71	13	33	0	10625
17987	10432	25	11	31	0	10499
17988	104	9	10522	10	0	10645
17989	43	7	76	10603	0	10729
17990	30	6	30	11161	0	11227
17991	22	12	11361	115	0	11510
17992	18	11314	96	38	0	11466
17993	11200	92	35	35	0	11362
17994	11241	27	11	36	0	11315
17995	137	14	13	11488	0	11652
17996	54	13	11	11603	0	11681
17997	42	1	13	12106	0	12162
17998	11869	8	9	182	0	12068
17999	124	12238	22	58	0	12442
18000	12394	122	5	33	0	12554
18001	12361	48	12	40	0	12461
18002	180	13	12974	26	0	13193
18003	76	18	147	12730	0	12971
18004	39	13126	43	158	0	13366
18005	42	155	17	13406	0	13620
18006	34	47	15	13819	0	13915
18007	24	17	14034	232	0	14307
18008	14382	17	189	97	0	14685
18009	15521	16	57	51	0	15645
18010	16101	19	28	40	0	16188
18011	315	16	17	15836	0	16184
18012	127	20	16	15700	0	15863
18013	58	15477	16	291	0	15842
18014	39	16148	23	103	0	16313
18015	15891	298	20	70	0	16279
18016	268	15635	24	38	0	15965
18017	101	255	15624	35	0	16015
18018	77	82	246	15834	0	16239
18019	15931	42	71	285	0	16329
18020	286	33	15847	103	0	16269
18021	119	29	15787	62	0	15997
18022	15936	21	296	77	0	16330
18023	16108	27	97	63	0	16295
18024	355	27	47	15920	0	16349
18025	123	45	15866	292	0	16326
18026	116	33	258	15873	0	16280
18027	79	42	15061	303	0	15485
18028	71	39	15905	122	0	16137
18029	51	15951	310	149	0	16461
18030	16124	260	104	78	0	16566
18031	16209	80	71	62	0	16422
18032	339	16005	59	60	0	16463
18033	157	271	39	15960	0	16427
18034	109	94	45	16151	0	16399
18035	87	42	43	16333	0	16505
18036	15981	36	50	379	0	16446
18037	288	15878	52	170	0	16388
18038	15589	271	36	96	0	15992
18039	15614	94	44	73	0	15825
18040	376	60	15179	53	0	15668
18041	161	15218	269	54	0	15702
18042	123	267	99	15343	0	15832
18043	80	107	15371	272	0	15830
18044	15106	64	276	130	0	15576
18045	15510	41	102	102	0	15755
18046	15491	37	55	82	0	15665
18047	15361	34	52	67	0	15514
18048	415	42	32	14932	0	15421
18049	168	47	14723	290	0	15228
18050	131	27	264	14759	0	15181
18051	14717	33	96	329	0	15175
18052	14693	30	64	145	0	14932
18053	369	14317	53	81	0	14820
18054	14063	247	48	62	0	14420
18055	346	82	13884	45	0	14357
18056	163	50	13819	42	0	14074
18057	13524	56	306	68	0	13954
18058	313	13466	104	55	0	13938
18059	152	211	68	12664	0	13095
18060	79	12985	54	231	0	13349
18061	102	238	45	13122	0	13507
18062	99	99	26	13254	0	13478
18063	98	49	35	13625	0	13807
18064	13242	43	32	329	0	13646
18065	13564	46	43	144	0	13797
18066	13472	34	42	94	0	13642
18067	336	40	13222	62	0	13660
18068	13379	33	233	65	0	13710
18069	325	36	99	13601	0	14061
18070	163	43	53	14089	0	14348
18071	117	35	13977	329	0	14458
18072	120	38	261	14758	0	15177
18073	15084	31	93	358	0	15566
18074	325	36	15021	144	0	15526
18075	166	25	290	15112	0	15593
18076	15144	33	114	335	0	15626
18077	15202	32	68	142	0	15444
18078	422	29	15029	90	0	15570
18079	201	26	15166	81	0	15474
18080	154	26	346	15307	0	15833
18081	15461	29	140	354	0	15984
18082	15718	27	88	143	0	15976
18083	425	35	65	15120	0	15645
18084	195	15378	58	313	0	15944
18085	15400	272	63	140	0	15875
18086	343	15482	48	121	0	15994
18087	178	289	49	15460	0	15976
18088	116	98	15269	316	0	15799
18089	105	49	14777	133	0	15064
18090	110	31	14885	89	0	15115
18091	112	37	348	14448	0	14945
18092	110	34	141	14709	0	14994
18093	14437	35	79	349	0	14900
18094	298	14310	67	174	0	14849
18095	14250	240	60	122	0	14672
18096	360	99	45	13606	0	14110
18097	141	13491	48	244	0	13924
18098	102	14016	46	113	0	14277
18099	111	283	47	13697	0	14138
18100	13541	108	51	287	0	13987
18101	288	13568	36	123	0	14015
18102	12746	230	43	98	0	13117
18103	259	12921	40	94	0	13314
18104	12741	235	55	66	0	13097
18105	292	96	12440	49	0	12877
18106	134	66	12169	42	0	12411
18107	79	11897	225	57	0	12258
18108	10992	255	221	52	0	11520
18109	167	10289	64	32	0	10552
18110	77	9539	38	38	0	9692
18111	120	193	35	9753	0	10101
18112	9725	57	31	137	0	9950
18113	140	9773	23	52	0	9988
18114	9452	122	25	44	0	9643
18115	141	9347	15	37	0	9540
18116	9171	126	13	25	0	9335
18117	127	9034	14	34	0	9209
18118	44	9133	10	19	0	9206
18119	172	152	15	8690	0	9029
18120	31	8994	8	106	0	9139
18121	8921	136	10	36	0	9103
18122	124	40	8863	21	0	9048
18123	52	40	96	8868	0	9056
18124	36	33	8974	105	0	9148
18125	30	20	116	8910	0	9076
18126	18	20	43	9022	0	9103
18127	23	12	8591	137	0	8763
18128	7999	16	105	72	0	8192
18129	114	8335	32	51	0	8532
18130	8450	102	32	29	0	8613
18131	125	8493	13	41	0	8672
18132	58	121	15	8519	0	8713
18133	8508	41	21	118	0	8688
18134	8562	28	15	51	0	8656
18135	8598	29	14	44	0	8685
18136	157	20	14	8515	0	8706
18137	81	22	17	8495	0	8615
18138	48	8700	15	129	0	8892
18139	8790	104	14	71	0	8979
18140	8888	35	17	51	0	8991
18141	8873	31	26	28	0	8958
18142	8739	27	15	42	0	8823
18143	165	8524	20	26	0	8735
18144	78	106	20	8607	0	8811
18145	45	50	8500	109	0	8704
18146	8338	36	98	62	0	8534
18147	8711	29	32	50	0	8822
18148	151	22	8595	33	0	8801
18149	88	28	8580	18	0	8714
18150	64	27	118	8661	0	8870
18151	43	28	54	8829	0	8954
18152	41	28	32	8941	0	9042
18153	8846	35	24	162	0	9067
18154	125	16	17	8904	0	9062
18155	58	22	8726	136	0	8942
18156	55	20	116	8846	0	9037
18157	33	25	9034	134	0	9226
18158	36	24	106	9100	0	9266
18159	36	25	41	9760	0	9862
18160	40	22	9896	169	0	10127
18161	9398	28	128	75	0	9629
18162	148	10068	44	51	0	10311
18163	10187	135	31	40	0	10393
18164	162	59	19	10460	0	10700
18165	10476	43	13	163	0	10695
18166	162	10892	16	75	0	11145
18167	79	11447	14	43	0	11583
18168	64	350	19	11713	0	12146
18169	55	95	12179	176	0	12505
18170	31	59	11751	84	0	11925
18171	38	11896	228	54	0	12216
18172	10872	185	119	54	0	11230
18173	148	75	62	10787	0	11072
18174	10681	39	37	173	0	10930
18175	171	10563	39	69	0	10842
18176	88	10855	34	49	0	11026
18177	67	223	19	10865	0	11174
18178	10859	90	20	169	0	11138
18179	10888	67	9	94	0	11058
18180	244	51	10659	46	0	11000
18181	112	50	10301	49	0	10512
18182	10363	46	180	41	0	10630
18183	179	10428	92	48	0	10747
18184	10397	150	62	35	0	10644
18185	218	88	44	10286	0	10636
18186	116	56	10103	141	0	10416
18187	9729	43	159	85	0	10016
18188	194	9805	84	49	0	10132
18189	81	10113	57	43	0	10294
18190	93	200	51	9988	0	10332
18191	10117	99	28	192	0	10436
18192	189	60	41	10159	0	10449
18193	10412	45	37	197	0	10691
18194	197	66	9896	100	0	10259
18195	10193	50	130	69	0	10442
18196	10447	36	55	89	0	10627
18197	279	33	10054	40	0	10406
18198	9774	36	138	63	0	10011
18199	222	9812	82	41	0	10157
18200	130	125	67	9715	0	10037
18201	119	9831	48	128	0	10126
18202	9973	164	36	68	0	10241
18203	186	91	52	9711	0	10040
18204	126	9655	41	159	0	9981
18205	86	174	34	9663	0	9957
18206	77	9769	24	177	0	10047
18207	75	194	15	9854	0	10138
18208	9849	106	13	192	0	10160
18209	170	58	23	9865	0	10116
18210	122	62	9681	177	0	10042
18211	9581	40	135	134	0	9890
18212	192	62	60	9729	0	10043
18213	101	46	9521	203	0	9871
18214	112	34	9109	111	0	9366
18215	84	32	9657	102	0	9875
18216	90	20	240	9545	0	9895
18217	85	28	121	9873	0	10107
18218	77	32	83	9849	0	10041
18219	67	35	76	9903	0	10081
18220	9764	33	63	255	0	10115
18221	9914	33	54	163	0	10164
18222	9969	45	41	132	0	10187
18223	10059	46	37	121	0	10263
18224	263	43	28	9899	0	10233
18225	162	40	9982	211	0	10395
18226	10033	27	138	133	0	10331
18227	10338	43	73	95	0	10549
18228	268	37	57	10217	0	10579
18229	175	40	53	10390	0	10658
18230	10440	30	42	255	0	10767
18231	224	29	51	10106	0	10410
18232	136	10088	47	244	0	10515
18233	10274	138	56	148	0	10616
18234	10270	69	48	131	0	10518
18235	257	51	10443	114	0	10865
18236	179	44	161	10489	0	10873
18237	128	27	99	10776	0	11030
18238	10669	47	80	244	0	11040
18239	10770	32	47	148	0	10997
18240	288	37	35	10723	0	11083
18241	176	23	10585	232	0	11016
18242	142	24	10680	151	0	10997
18243	126	17	203	10816	0	11162
18244	121	33	109	10944	0	11207
18245	10777	29	70	250	0	11126
18246	235	10500	47	161	0	10943
18247	145	10432	53	123	0	10753
18248	107	10843	61	103	0	11114
18249	119	204	60	10707	0	11090
18250	10666	100	44	223	0	11033
18251	10661	70	32	136	0	10899
18252	266	10607	23	112	0	11008
18253	10676	177	25	104	0	10982
18254	248	93	30	10525	0	10896
18255	135	76	10522	216	0	10949
18256	129	63	141	10376	0	10709
18257	137	33	68	10457	0	10695
18258	129	40	51	10311	0	10531
18259	9671	17	40	250	0	9978
18260	154	43	42	9211	0	9450
18261	107	9142	46	201	0	9496
18262	8858	109	51	157	0	9175
18263	150	8614	29	112	0	8905
18264	70	8189	32	92	0	8383
18265	69	8364	30	66	0	8529
18266	54	82	7604	62	0	7802
18267	35	7245	79	47	0	7406
18268	61	53	6464	32	0	6610
18269	5784	31	46	28	0	5889
18270	5949	9	10	24	0	5992
18271	33	5	6100	12	0	6150
18272	6114	7	24	20	0	6165
18273	6323	3	3	20	0	6349
18274	36	2	6342	6	0	6386
18275	9	6578	21	10	0	6618
18276	9	30	9	6650	0	6698
18277	6724	3	2	37	0	6766
18278	29	5	3	6629	0	6666
18279	6944	4	1	44	0	6993
18280	6890	7	3	18	0	6918
18281	32	7	6931	8	0	6978
18282	6820	7	23	12	0	6862
18283	31	7122	5	12	0	7170
18284	7178	31	1	19	0	7229
18285	47	7	5	7234	0	7293
18286	12	9	7291	31	0	7343
18287	16	5	30	7256	0	7307
18288	7247	3	6	44	0	7300
18289	33	7219	9	15	0	7276
18290	12	32	7212	13	0	7269
18291	17	4	34	7031	0	7086
18292	16	6	7164	36	0	7222
18293	11	7083	31	17	0	7142
18294	7090	33	9	20	0	7152
18295	40	10	7	7110	0	7167
18296	21	8	7153	38	0	7220
18297	22	12	6805	15	0	6854
18298	7302	12	32	23	0	7369
18299	45	13	9	7321	0	7388
18300	26	5	8	7351	0	7390
18301	16	9	7355	48	0	7428
18302	16	8	7286	15	0	7325
18303	17	7540	37	15	0	7609
18304	21	35	11	7617	0	7684
18305	16	7	16	7617	0	7656
18306	13	7601	9	48	0	7671
18307	10	41	7573	22	0	7646
18308	7419	13	41	25	0	7498
18309	56	9	14	7688	0	7767
18310	13	14	7794	55	0	7876
18311	19	8	43	7588	0	7658
18312	20	7850	14	42	0	7926
18313	21	46	7831	14	0	7912
18314	7624	16	46	27	0	7713
18315	51	15	7946	9	0	8021
18316	14	13	7751	14	0	7792
18317	21	6	7683	15	0	7725
18318	14	13	8251	10	0	8288
18319	19	8	63	8450	0	8540
18320	20	6	8781	59	0	8866
18321	18	6	69	8546	0	8639
18322	11	8723	13	63	0	8810
18323	9241	61	12	18	0	9332
18324	88	11	8	9331	0	9438
18325	20	15	9256	92	0	9383
18326	15	9283	84	33	0	9415
18327	24	85	19	9344	0	9472
18328	9380	22	21	97	0	9520
18329	92	9431	9	27	0	9559
18330	31	81	11	9605	0	9728
18331	9691	21	8	98	0	9818
18332	93	17	9597	27	0	9734
18333	9516	6	92	25	0	9639
18334	104	7	9742	17	0	9870
18335	9213	14	100	14	0	9341
18336	9289	4	27	19	0	9339
18337	110	3	9124	11	0	9248
18338	32	9029	77	6	0	9144
18339	23	87	28	8797	0	8935
18340	6	22	9162	88	0	9278
18341	26	14	79	8857	0	8976
18342	19	8	20	9029	0	9076
18343	5	3	9141	110	0	9259
18344	13	12	9021	33	0	9079
18345	12	4	99	9120	0	9235
18346	9292	1	37	94	0	9424
18347	94	9151	17	31	0	9293
18348	29	9270	16	26	0	9341
18349	9309	108	9	26	0	9452
18350	9526	30	18	20	0	9594
18351	130	14	13	9524	0	9681
18352	40	15	12	9575	0	9642
18353	23	9	14	9650	0	9696
18354	9465	9	5	134	0	9613
18355	90	9122	12	55	0	9279
18356	33	9370	15	29	0	9447
18357	18	118	15	9408	0	9559
18358	28	35	5	9572	0	9640
18359	30	18	8	9606	0	9662
18360	9508	7	14	145	0	9674
18361	100	9695	9	48	0	9852
18362	9838	103	13	38	0	9992
18363	133	35	9906	15	0	10089
18364	40	10080	110	26	0	10256
18365	34	124	30	10072	0	10260
18366	10059	37	21	141	0	10258
18367	135	20	10048	41	0	10244
18368	48	11	10071	33	0	10163
18369	43	10	165	10132	0	10350
18370	20	13	48	10272	0	10353
18371	24	17	28	10178	0	10247
18372	25	11	23	9816	0	9875
18373	31	22	11	9832	0	9896
18374	23	9595	17	187	0	9822
18375	21	123	21	9598	0	9763
18376	9411	37	17	178	0	9643
18377	130	9525	19	72	0	9746
18378	9540	134	14	66	0	9754
18379	153	43	9265	38	0	9499
18380	51	27	9389	40	0	9507
18381	48	27	160	9859	0	10094
18382	26	18	11237	166	0	11447
18383	30	16	211	11120	0	11377
18384	48	14	68	11016	0	11146
18385	11364	16	41	278	0	11699
18386	11388	19	30	115	0	11552
18387	269	11551	25	66	0	11911
18388	101	12053	25	57	0	12236
18389	73	270	19	12035	0	12397
18390	12149	109	22	249	0	12529
18391	235	54	12226	98	0	12613
18392	114	33	224	12259	0	12630
18393	72	21	93	12397	0	12583
18394	44	22	12169	316	0	12551
18395	32	12181	223	161	0	12597
18396	40	225	90	12047	0	12402
18397	32	94	12245	268	0	12639
18398	37	53	235	12087	0	12412
18399	11758	38	99	299	0	12194
18400	229	11705	59	141	0	12134
18401	90	11990	37	93	0	12210
18402	66	282	36	11894	0	12278
18403	11676	116	34	275	0	12101
18404	230	11722	46	125	0	12123
18405	11842	238	34	115	0	12229
18406	265	104	11790	87	0	12246
18407	130	66	12102	77	0	12375
18408	104	37	312	11852	0	12305
18409	76	52	133	12383	0	12644
18410	12095	54	66	356	0	12571
18411	288	40	42	12235	0	12605
18412	148	70	11965	296	0	12479
18413	104	69	244	11955	0	12372
18414	90	58	99	12236	0	12483
18415	57	53	11715	373	0	12198
18416	11323	37	263	207	0	11830
18417	276	52	128	11678	0	12134
18418	11201	36	88	329	0	11654
18419	250	10746	84	174	0	11254
18420	10623	232	63	149	0	11067
18421	253	10502	65	102	0	10922
18422	107	10652	69	109	0	10937
18423	133	284	99	10025	0	10541
18424	9977	113	80	264	0	10434
18425	10039	91	43	126	0	10299
18426	276	81	34	9874	0	10265
18427	9855	57	35	253	0	10200
18428	9894	65	40	145	0	10144
18429	315	58	37	9791	0	10201
18430	9426	66	31	262	0	9785
18431	256	9576	59	144	0	10035
18432	9597	200	68	121	0	9986
18433	254	80	9148	133	0	9615
18434	9728	57	189	114	0	10088
18435	265	36	90	9795	0	10186
18436	147	27	72	9973	0	10219
18437	122	25	73	9969	0	10189
18438	105	43	53	9953	0	10154
18439	65	48	54	9900	0	10067
18440	81	9118	64	350	0	9613
18441	82	9652	59	213	0	10006
18442	9575	208	52	153	0	9988
18443	244	126	9495	106	0	9971
18444	9444	99	181	109	0	9833
18445	282	81	9483	109	0	9955
18446	177	93	185	9401	0	9856
18447	132	95	76	9698	0	10001
18448	9518	78	56	317	0	9969
18449	291	71	9422	154	0	9938
18450	194	61	181	9545	0	9981
18451	158	55	9738	263	0	10214
18452	136	10004	201	159	0	10500
18453	159	200	79	10268	0	10706
18454	10333	72	71	295	0	10771
18455	10108	68	49	176	0	10401
18456	10455	66	47	146	0	10714
18457	337	10107	49	149	0	10642
18458	183	10483	63	122	0	10851
18459	9641	245	73	146	0	10105
18460	235	10257	44	139	0	10675
18461	128	10306	37	170	0	10641
18462	120	241	9971	138	0	10470
18463	73	9727	164	155	0	10119
18464	88	9806	86	129	0	10109
18465	67	246	63	9857	0	10233
18466	81	154	9839	232	0	10306
18467	82	96	9591	130	0	9899
18468	9481	59	230	108	0	9878
18469	239	64	9784	87	0	10174
18470	9923	50	221	77	0	10271
18471	252	46	126	9893	0	10317
18472	152	10000	83	240	0	10475
18473	10321	183	69	145	0	10718
18474	10697	101	56	143	0	10997
18475	288	51	62	10708	0	11109
18476	193	44	61	10802	0	11100
18477	133	47	60	10831	0	11071
18478	10592	41	48	316	0	10997
18479	9826	67	39	180	0	10112
18480	10493	58	33	134	0	10718
18481	320	9802	21	94	0	10237
18482	8461	93	17	47	0	8618
18483	140	8322	11	29	0	8502
18484	81	8335	15	29	0	8460
18485	88	207	49	7815	0	8159
18486	36	7960	27	76	0	8099
18487	7607	88	23	38	0	7756
18488	93	39	8	7512	0	7652
18489	7373	18	6	81	0	7478
18490	82	7137	7	37	0	7263
18491	27	7365	10	25	0	7427
18492	7526	83	9	31	0	7649
18493	92	7738	12	10	0	7852
18494	42	85	18	7809	0	7954
18495	43	15	12	7897	0	7967
18496	7936	15	8	99	0	8058
18497	93	13	9	8024	0	8139
18498	36	5	8175	101	0	8317
18499	24	14	88	8222	0	8348
18500	8396	11	20	113	0	8540
18501	102	8637	14	38	0	8791
18502	8974	102	10	25	0	9111
18503	8696	33	9	38	0	8776
18504	9131	17	8	20	0	9176
18505	146	13	8927	13	0	9099
18506	51	11	8636	18	0	8716
18507	8567	12	108	27	0	8714
18508	116	8647	37	24	0	8824
18509	43	103	16	8789	0	8951
18510	27	28	11	8780	0	8846
18511	17	8492	10	127	0	8646
18512	15	8721	10	44	0	8790
18513	22	118	8	8772	0	8920
18514	17	33	8	8852	0	8910
18515	7	23	8650	135	0	8815
18516	20	19	8403	44	0	8486
18517	8543	11	123	31	0	8708
18518	8905	10	37	21	0	8973
18519	139	5	27	8816	0	8987
18520	48	11	8801	121	0	8981
18521	40	10	116	8730	0	8896
18522	8732	13	31	138	0	8914
18523	129	13	8707	49	0	8898
18524	52	11	118	8806	0	8987
18525	32	14	8839	132	0	9017
18526	26	8707	125	51	0	8909
18527	18	117	8821	21	0	8977
18528	34	54	130	8691	0	8909
18529	8778	20	41	127	0	8966
18530	124	14	24	8886	0	9048
18531	8818	5	25	140	0	8988
18532	8907	12	15	53	0	8987
18533	8799	9	12	40	0	8860
18534	152	16	8593	28	0	8789
18535	8655	9	111	30	0	8805
18536	149	11	31	8698	0	8889
18537	61	9	25	8812	0	8907
18538	40	11	8699	140	0	8890
18539	37	13	108	8771	0	8929
18540	8812	9	42	152	0	9015
18541	116	8908	23	60	0	9107
18542	9098	109	17	35	0	9259
18543	9218	30	8	39	0	9295
18544	9319	15	13	24	0	9371
18545	156	18	9	9227	0	9410
18546	70	11	9310	121	0	9512
18547	47	8	113	9417	0	9585
18548	41	13	33	9552	0	9639
18549	9429	6	28	178	0	9641
18550	9239	11	21	75	0	9346
18551	160	13	8961	38	0	9172
18552	65	20	116	8949	0	9150
18553	41	6	9041	149	0	9237
18554	9244	7	142	58	0	9451
18555	149	9924	48	45	0	10166
18556	9934	143	26	39	0	10142
18557	172	10198	24	22	0	10416
18558	10137	163	12	34	0	10346
18559	189	10167	18	30	0	10404
18560	85	172	22	10174	0	10453
18561	58	46	18	10482	0	10604
18562	10426	32	19	201	0	10678
18563	10422	26	12	76	0	10536
18564	10463	19	10	59	0	10551
18565	10138	19	10	53	0	10220
18566	10325	21	10	26	0	10382
18567	240	21	14	10015	0	10290
18568	94	10023	12	173	0	10302
18569	94	156	13	9833	0	10096
18570	60	9780	9	174	0	10023
18571	58	175	10	9549	0	9792
18572	40	9628	16	180	0	9864
18573	51	176	6	9534	0	9767
18574	41	52	9210	184	0	9487
18575	8957	52	151	58	0	9218
18576	176	9136	35	62	0	9409
18577	9163	163	23	51	0	9400
18578	202	43	9121	34	0	9400
18579	9045	38	158	47	0	9288
18580	195	28	9482	34	0	9739
18581	83	32	180	9481	0	9776
18582	63	10036	45	196	0	10340
18583	48	192	10147	47	0	10434
18584	63	58	187	10231	0	10539
18585	9794	43	66	219	0	10122
18586	214	25	51	10289	0	10579
18587	75	20	42	10473	0	10610
18588	81	21	19	10570	0	10691
18589	51	33	10291	264	0	10639
18590	64	16	200	10087	0	10367
18591	41	10040	62	239	0	10382
18592	54	177	40	10029	0	10300
18593	50	56	23	10033	0	10162
18594	9818	39	22	257	0	10136
18595	203	24	20	10039	0	10286
18596	82	14	10023	233	0	10352
18597	58	23	9945	102	0	10128
18598	45	18	9861	80	0	10004
18599	32	9887	219	61	0	10199
18600	9640	168	131	67	0	10006
18601	171	9508	67	52	0	9798
18602	9337	187	39	48	0	9611
18603	205	63	31	9275	0	9574
18604	69	51	9451	180	0	9751
18605	62	38	9244	70	0	9414
18606	44	9614	198	67	0	9923
18607	47	178	85	9608	0	9918
18608	39	59	57	9748	0	9903
18609	42	49	33	9822	0	9946
18610	24	35	9662	250	0	9971
18611	9206	24	179	122	0	9531
18612	185	38	9674	74	0	9971
18613	96	23	201	9564	0	9884
18614	74	25	68	9901	0	10068
18615	49	17	9703	234	0	10003
18616	9308	21	181	126	0	9636
18617	185	9668	85	88	0	10026
18618	9706	170	58	55	0	9989
18619	212	65	35	9517	0	9829
18620	79	9678	33	208	0	9998
18621	72	173	34	9817	0	10096
18622	9784	71	40	227	0	10122
18623	211	57	36	9746	0	10050
18624	86	41	9589	232	0	9948
18625	9473	31	172	114	0	9790
18626	9691	26	68	105	0	9890
18627	247	34	9507	73	0	9861
18628	119	29	188	9505	0	9841
18629	9706	24	69	221	0	10020
18630	206	30	62	9568	0	9866
18631	99	26	57	9569	0	9751
18632	88	32	39	9598	0	9757
18633	70	36	47	9631	0	9784
18634	58	31	9382	288	0	9759
18635	63	25	173	9438	0	9699
18636	56	29	9336	256	0	9677
18637	9231	19	209	119	0	9578
18638	9455	21	86	119	0	9681
18639	9399	24	79	90	0	9592
18640	9431	19	64	88	0	9602
18641	266	29	48	9114	0	9457
18642	8981	21	46	220	0	9268
18643	228	19	8846	123	0	9216
18644	118	23	8783	100	0	9024
18645	8541	14	208	86	0	8849
18646	199	8440	111	88	0	8838
18647	85	8571	76	76	0	8808
18648	86	183	61	8464	0	8794
18649	61	72	8473	198	0	8804
18650	8236	60	176	105	0	8577
18651	198	41	8463	84	0	8786
18652	82	8067	176	84	0	8409
18653	90	136	7961	58	0	8245
18654	59	7528	143	67	0	7797
18655	6806	156	130	65	0	7157
18656	128	6720	45	59	0	6952
18657	58	6508	38	48	0	6652
18658	71	112	40	6487	0	6710
18659	44	62	6444	102	0	6652
18660	42	51	103	6259	0	6455
18661	37	27	49	6382	0	6495
18662	30	22	6250	146	0	6448
18663	32	28	102	6080	0	6242
18664	36	6049	54	128	0	6267
18665	34	93	43	6302	0	6472
18666	6303	44	35	130	0	6512
18667	107	29	30	6338	0	6504
18668	50	26	6297	133	0	6506
18669	52	21	102	6386	0	6561
18670	38	20	6366	137	0	6561
18671	6319	19	113	77	0	6528
18672	112	15	52	6467	0	6646
18673	6484	21	50	127	0	6682
18674	127	13	6483	74	0	6697
18675	6256	14	103	67	0	6440
18676	115	6587	60	57	0	6819
18677	68	94	6657	40	0	6859
18678	56	74	115	6513	0	6758
18679	50	37	6710	117	0	6914
18680	33	6311	112	77	0	6533
18681	38	6446	65	58	0	6607
18682	5891	96	30	44	0	6061
18683	85	6084	32	28	0	6229
18684	6142	87	26	39	0	6294
18685	107	38	29	6206	0	6380
18686	54	24	6187	91	0	6356
18687	36	6265	91	47	0	6439
18688	48	93	43	6281	0	6465
18689	32	46	25	6490	0	6593
18690	31	30	25	6587	0	6673
18691	27	26	15	6484	0	6552
18692	21	6243	27	123	0	6414
18693	25	6477	19	65	0	6586
18694	6179	96	24	41	0	6340
18695	88	6118	18	26	0	6250
18696	21	88	12	5927	0	6048
18697	20	28	5905	69	0	6022
18698	13	5880	69	45	0	6007
18699	22	73	25	5791	0	5911
18700	19	41	11	5759	0	5830
18701	10	5811	11	101	0	5933
18702	5705	78	15	36	0	5834
18703	75	30	5738	16	0	5859
18704	5328	22	58	18	0	5426
18705	75	5579	15	19	0	5688
18706	5289	67	11	19	0	5386
18707	63	5496	7	13	0	5579
18708	27	81	11	5766	0	5885
18709	15	23	8	5849	0	5895
18710	5764	20	4	90	0	5878
18711	77	18	1	5807	0	5903
18712	23	12	5787	76	0	5898
18713	19	5583	69	26	0	5697
18714	10	5714	19	20	0	5763
18715	15	85	13	5695	0	5808
18716	8	35	5765	68	0	5876
18717	18	22	61	5664	0	5765
18718	13	15	17	5794	0	5839
18719	12	10	5706	89	0	5817
18720	12	6	5525	32	0	5575
18721	11	5665	73	22	0	5771
18722	5698	74	27	22	0	5821
18723	73	29	16	5635	0	5753
18724	17	5528	7	69	0	5621
18725	5692	70	7	41	0	5810
18726	67	16	12	5727	0	5822
18727	24	14	6	5715	0	5759
18728	13	5649	9	91	0	5762
18729	11	65	16	5625	0	5717
18730	5664	31	9	84	0	5788
18731	74	24	8	5699	0	5805
18732	26	14	5	5780	0	5825
18733	19	13	5650	91	0	5773
18734	12	17	5331	42	0	5402
18735	5556	14	78	31	0	5679
18736	79	10	25	5594	0	5708
18737	25	18	17	5629	0	5689
18738	16	20	6	5684	0	5726
18739	20	16	5570	98	0	5704
18740	5514	10	68	54	0	5646
18741	74	9	15	5585	0	5683
18742	28	11	21	5637	0	5697
18743	5518	15	18	112	0	5663
18744	70	5497	20	46	0	5633
18745	35	71	5503	29	0	5638
18746	26	30	67	5316	0	5439
18747	13	5425	22	99	0	5559
18748	20	61	26	5515	0	5622
18749	5425	26	19	95	0	5565
18750	83	22	12	5395	0	5512
18751	5325	15	9	108	0	5457
18752	5290	13	11	60	0	5374
18753	91	18	10	5208	0	5327
18754	34	5114	15	93	0	5256
18755	20	5270	16	49	0	5355
18756	12	97	5247	31	0	5387
18757	33	36	73	4968	0	5110
18758	27	28	23	5245	0	5323
18759	22	18	18	5317	0	5375
18760	5233	14	16	111	0	5374
18761	93	18	8	5255	0	5374
18762	39	12	5235	110	0	5396
18763	5254	14	65	59	0	5392
18764	81	28	21	5502	0	5632
18765	32	22	23	5591	0	5668
18766	27	15	5524	100	0	5666
18767	5420	14	71	62	0	5567
18768	82	16	20	5591	0	5709
18769	34	14	5660	109	0	5817
18770	28	20	73	5644	0	5765
18771	23	13	41	5419	0	5496
18772	24	5666	21	97	0	5808
18773	5605	66	17	61	0	5749
18774	5535	21	14	61	0	5631
18775	84	5484	17	42	0	5627
18776	5326	65	22	38	0	5451
18777	5248	21	17	36	0	5322
18778	89	16	13	5222	0	5340
18779	29	9	5026	89	0	5153
18780	17	10	4804	56	0	4887
18781	21	8	4837	37	0	4903
18782	14	12	4999	35	0	5060
18783	26	44	84	4748	0	4902
18784	22	9	30	5030	0	5091
18785	13	16	18	4952	0	4999
18786	26	8	6	5047	0	5087
18787	5049	11	6	95	0	5161
18788	68	5120	11	51	0	5250
18789	5321	50	9	35	0	5415
18790	75	18	5382	28	0	5503
18791	30	10	5572	29	0	5641
18792	27	35	72	5712	0	5846
18793	5799	6	38	90	0	5933
18794	5653	4	23	43	0	5723
18795	80	5685	20	29	0	5814
18796	29	5800	20	24	0	5873
18797	24	63	15	5821	0	5923
18798	5798	22	14	75	0	5909
18799	70	5817	10	35	0	5932
18800	5914	67	8	31	0	6020
18801	5919	22	5	24	0	5970
18802	5905	14	7	19	0	5945
18803	84	15	5868	17	0	5984
18804	35	5969	55	22	0	6081
18805	5864	51	15	19	0	5949
18806	5836	16	9	24	0	5885
18807	75	5606	9	14	0	5704
18808	23	5385	4	3	0	5415
18809	5401	54	8	16	0	5479
18810	64	16	7	5385	0	5472
18811	22	15	5406	50	0	5493
18812	5297	14	43	20	0	5374
18813	64	9	11	5452	0	5536
18814	21	5614	4	52	0	5691
18815	18	49	8	5696	0	5771
18816	13	21	5711	54	0	5799
18817	21	10	46	5684	0	5761
18818	5913	10	13	66	0	6002
18819	60	10	7	5947	0	6024
18820	24	8	9	6006	0	6047
18821	16	14	6134	68	0	6232
18822	18	11	50	5953	0	6032
18823	11	6123	18	57	0	6209
18824	6149	45	11	34	0	6239
18825	6050	16	15	18	0	6099
18826	68	10	6123	21	0	6222
18827	30	11	52	5999	0	6092
18828	18	5946	21	57	0	6042
18829	13	6141	10	28	0	6192
18830	6108	63	8	18	0	6197
18831	71	22	7	6185	0	6285
18832	26	12	6162	63	0	6263
18833	20	18	6108	19	0	6165
18834	15	11	65	6235	0	6326
18835	6215	12	24	65	0	6316
18836	6234	14	15	25	0	6288
18837	81	9	13	6383	0	6486
18838	32	7	6493	66	0	6598
18839	20	6484	57	36	0	6597
18840	6527	59	25	26	0	6637
18841	61	6598	14	29	0	6702
18842	6640	62	9	24	0	6735
18843	77	28	8	6632	0	6745
18844	35	21	6633	68	0	6757
18845	25	15	63	6570	0	6673
18846	6616	10	26	86	0	6738
18847	74	15	6588	30	0	6707
18848	35	6607	58	22	0	6722
18849	35	61	19	6643	0	6758
18850	6696	19	17	77	0	6809
18851	68	16	6706	33	0	6823
18852	31	15	67	6724	0	6837
18853	25	16	25	6825	0	6891
18854	29	16	6818	83	0	6946
18855	32	13	68	6743	0	6856
18856	20	14	6784	82	0	6900
18857	6716	8	68	52	0	6844
18858	81	12	28	7134	0	7255
18859	37	14	7484	86	0	7621
18860	18	7612	89	36	0	7755
18861	7812	81	26	33	0	7952
18862	8343	25	22	30	0	8420
18863	124	19	19	8870	0	9032
18864	45	8938	16	119	0	9118
18865	9022	123	10	55	0	9210
18866	149	41	17	9010	0	9217
18867	56	29	8997	142	0	9224
18868	8795	25	124	58	0	9002
18869	155	8827	44	32	0	9058
18870	63	121	23	8915	0	9122
18871	8914	40	26	143	0	9123
18872	147	29	8770	51	0	8997
18873	65	21	8890	31	0	9007
18874	46	20	148	8789	0	9003
18875	31	14	9019	142	0	9206
18876	36	20	147	8819	0	9022
18877	24	8724	56	146	0	8950
18878	27	124	44	9182	0	9377
18879	9068	41	32	164	0	9305
18880	136	24	9064	74	0	9298
18881	49	9061	141	44	0	9295
18882	42	125	38	8953	0	9158
18883	43	42	9091	129	0	9305
18884	33	51	129	8669	0	8882
18885	22	8803	53	129	0	9007
18886	21	9017	33	62	0	9133
18887	8710	135	29	42	0	8916
18888	104	8793	25	35	0	8957
18889	41	120	8434	20	0	8615
18890	7901	49	121	41	0	8112
18891	121	27	8258	12	0	8418
18892	47	22	105	7839	0	8013
18893	27	16	8184	98	0	8325
18894	24	8149	102	40	0	8315
18895	18	94	41	8188	0	8341
18896	18	31	23	8204	0	8276
18897	26	16	20	8131	0	8193
18898	18	23	8101	134	0	8276
18899	30	12	97	8028	0	8167
18900	14	14	31	8190	0	8249
18901	7986	15	23	142	0	8166
18902	8013	10	24	72	0	8119
18903	121	13	7977	46	0	8157
18904	43	7822	104	33	0	8002
18905	42	94	7949	20	0	8105
18906	28	43	108	7994	0	8173
18907	13	17	8141	105	0	8276
18908	23	18	105	8074	0	8220
18909	16	14	54	8249	0	8333
18910	11	15	8162	140	0	8328
18911	7555	8	113	69	0	7745
18912	89	8199	50	46	0	8384
18913	36	94	26	8243	0	8399
18914	26	32	8292	107	0	8457
18915	26	20	8023	50	0	8119
18916	7918	21	115	40	0	8094
18917	97	8151	45	30	0	8323
18918	41	95	30	8129	0	8295
18919	8293	31	24	118	0	8466
18920	106	21	21	8307	0	8455
18921	48	18	17	8455	0	8538
18922	27	13	8427	145	0	8612
18923	8120	15	98	78	0	8311
18924	8552	11	42	56	0	8661
18925	134	16	23	8541	0	8714
18926	8559	7	33	120	0	8719
18927	132	8	12	8557	0	8709
18928	60	8364	28	119	0	8571
18929	35	8707	19	74	0	8835
18930	41	134	16	8795	0	8986
18931	8661	50	19	136	0	8866
18932	121	24	14	8726	0	8885
18933	8789	19	16	148	0	8972
18934	8856	17	19	76	0	8968
18935	158	12	13	8844	0	9027
18936	61	12	15	9018	0	9106
18937	45	10	8782	169	0	9006
18938	40	9	8864	66	0	8979
18939	30	17	144	8964	0	9155
18940	17	12	9317	142	0	9488
18941	9225	13	145	68	0	9451
18942	144	11	54	9750	0	9959
18943	45	21	10049	155	0	10270
18944	10012	10	144	80	0	10246
18945	10675	13	59	57	0	10804
18946	182	11111	39	42	0	11374
18947	95	132	28	11380	0	11635
18948	53	50	11697	167	0	11967
18949	11699	33	148	82	0	11962
18950	12051	20	55	60	0	12186
18951	196	15	12050	45	0	12306
18952	12147	17	156	39	0	12359
18953	202	9	51	12156	0	12418
18954	94	14	45	12281	0	12434
18955	12202	11	27	213	0	12453
18956	12269	4	21	94	0	12388
18957	211	51	27	12099	0	12388
18958	106	11	11961	165	0	12243
18959	62	11619	117	81	0	11879
18960	47	114	11631	54	0	11846
18961	72	40	11460	41	0	11613
18962	46	11087	170	45	0	11348
18963	71	101	91	10256	0	10519
18964	36	30	44	10317	0	10427
18965	27	23	10256	107	0	10413
18966	29	10	91	10147	0	10277
18967	10254	7	39	119	0	10419
18968	92	18	10402	51	0	10563
18969	10338	6	91	52	0	10487
18970	10566	2	52	51	0	10671
18971	10649	6	33	35	0	10723
18972	147	9	10487	24	0	10667
18973	77	6	10476	22	0	10581
18974	60	8	121	10441	0	10630
18975	49	9	52	10262	0	10372
18976	32	10574	28	113	0	10747
18977	10537	86	34	75	0	10732
18978	10500	25	26	42	0	10593
18979	121	10510	24	23	0	10678
18980	10465	88	24	41	0	10618
18981	107	10384	27	42	0	10560
18982	10473	97	31	33	0	10634
18983	123	31	16	10282	0	10452
18984	65	26	10362	93	0	10546
18985	40	22	10195	48	0	10305
18986	47	16	113	10208	0	10384
18987	46	14	59	10309	0	10428
18988	33	17	10216	120	0	10386
18989	43	6	100	10050	0	10199
18990	37	20	57	9958	0	10072
18991	10110	11	35	140	0	10296
18992	10185	5	22	84	0	10296
18993	9985	15	22	51	0	10073
18994	136	14	9836	31	0	10017
18995	67	9859	93	37	0	10056
18996	58	90	38	9958	0	10144
18997	47	27	10088	93	0	10255
18998	36	10113	97	54	0	10300
18999	10239	94	49	40	0	10422
19000	121	31	33	10275	0	10460
19001	65	29	25	10370	0	10489
19002	10312	13	22	147	0	10494
19003	112	15	27	10302	0	10456
19004	71	15	16	10351	0	10453
19005	10330	15	22	162	0	10529
19006	124	14	10188	75	0	10401
19007	43	10121	114	52	0	10330
19008	10150	95	49	43	0	10337
19009	118	39	10273	44	0	10474
19010	10056	29	108	56	0	10249
19011	131	10448	50	35	0	10664
19012	10312	95	44	49	0	10500
19013	10329	35	30	54	0	10448
19014	10133	20	27	44	0	10224
19015	153	27	20	9963	0	10163
19016	70	36	26	9984	0	10116
19017	53	9834	30	150	0	10067
19018	44	9899	24	76	0	10043
19019	49	9895	20	51	0	10015
19020	9851	97	23	46	0	10017
19021	108	46	9733	39	0	9926
19022	56	28	84	9633	0	9801
19023	50	17	35	9666	0	9768
19024	32	9671	31	115	0	9849
19025	52	93	22	9691	0	9858
19026	40	36	26	9612	0	9714
19027	44	9731	16	110	0	9901
19028	9630	91	26	71	0	9818
19029	98	9739	24	42	0	9903
19030	47	99	9607	32	0	9785
19031	9509	31	83	45	0	9668
19032	98	9724	30	39	0	9891
19033	9628	87	29	41	0	9785
19034	115	32	10	9602	0	9759
19035	54	34	21	9592	0	9701
19036	52	25	9505	95	0	9677
19037	46	25	9440	51	0	9562
19038	43	57	87	9407	0	9594
19039	9420	21	36	97	0	9574
19040	9204	14	26	47	0	9291
19041	102	9455	22	46	0	9625
19042	41	9266	12	24	0	9343
19043	20	9213	12	19	0	9264
19044	148	243	78	8883	0	9352
19045	8922	28	107	121	0	9178
19046	9028	6	2	39	0	9075
19047	8962	1	8	34	0	9005
19048	131	6	8817	13	0	8967
19049	32	10088	105	13	0	10238
19050	34	122	24	11056	0	11236
19051	11193	29	9	173	0	11404
19052	209	12	2	11403	0	11626
19053	52	3	11	11867	0	11933
19054	11762	8	5	236	0	12011
19055	12454	3	6	56	0	12519
19056	254	9	12417	20	0	12700
19057	81	6	213	12425	0	12725
19058	36	8	12339	223	0	12606
19059	36	6	230	12312	0	12584
19060	16	21	12255	241	0	12533
19061	47	23	228	12159	0	12457
19062	11992	7	51	260	0	12310
19063	223	11970	26	58	0	12277
19064	51	12457	13	42	0	12563
19065	84	256	22	11461	0	11823
19066	32	12568	10	193	0	12803
19067	12509	246	21	63	0	12839
19068	12442	55	9	52	0	12558
19069	288	22	12189	26	0	12525
19070	69	12186	217	34	0	12506
19071	65	226	57	12233	0	12581
19072	38	51	12221	227	0	12537
19073	12163	20	225	60	0	12468
19074	268	24	55	12201	0	12548
19075	55	22	12239	242	0	12558
19076	57	12	237	12231	0	12537
19077	12222	22	51	257	0	12552
19078	241	13	12128	70	0	12452
19079	12062	12	236	49	0	12359
19080	12375	13	58	50	0	12496
19081	297	20	33	12123	0	12473
19082	83	20	12071	239	0	12413
19083	44	20	12026	67	0	12157
19084	11868	19	261	57	0	12205
19085	12201	14	67	43	0	12325
19086	293	19	12002	36	0	12350
19087	107	16	242	12010	0	12375
19088	65	20	55	11872	0	12012
19089	42	12024	40	272	0	12378
19090	57	223	33	12064	0	12377
19091	12099	50	21	274	0	12444
19092	273	22	25	12101	0	12421
19093	84	23	11939	265	0	12311
19094	11840	17	248	105	0	12210
19095	277	17	73	11865	0	12232
19096	98	20	11804	262	0	12184
19097	54	11605	255	96	0	12010
19098	11425	231	72	74	0	11802
19099	235	11651	39	93	0	12018
19100	11591	247	43	55	0	11936
19101	268	70	11435	75	0	11848
19102	105	11083	230	65	0	11483
19103	88	11590	70	65	0	11813
19104	90	272	65	11298	0	11725
19105	84	71	57	11512	0	11724
19106	47	47	11278	326	0	11698
19107	63	37	257	11351	0	11708
19108	11268	35	83	300	0	11686
19109	276	32	11107	106	0	11521
19110	107	33	270	11109	0	11519
19111	76	26	10978	277	0	11357
19112	10726	45	269	111	0	11151
19113	259	10991	96	91	0	11437
19114	10994	253	70	84	0	11401
19115	11335	92	57	81	0	11565
19116	11438	56	46	73	0	11613
19117	347	48	11000	65	0	11460
19118	125	11063	265	67	0	11520
19119	115	244	88	11148	0	11595
19120	84	90	62	11689	0	11925
19121	11807	47	75	319	0	12248
19122	329	44	59	11895	0	12327
19123	11950	23	61	355	0	12389
19124	12047	42	97	130	0	12316
19125	12120	33	48	114	0	12315
19126	12172	26	67	77	0	12342
19127	415	29	54	11760	0	12258
19128	11768	22	56	323	0	12169
19129	354	39	11408	110	0	11911
19130	11431	31	269	111	0	11842
19131	11739	28	98	91	0	11956
19132	387	31	11276	105	0	11799
19133	11440	18	278	83	0	11819
19134	11747	27	107	56	0	11937
19135	406	29	72	11361	0	11868
19136	160	39	70	11544	0	11813
19137	11254	64	58	357	0	11733
19138	338	47	50	11196	0	11631
19139	173	29	53	11033	0	11288
19140	118	10601	53	348	0	11120
19141	109	212	40	10415	0	10776
19142	10192	48	49	303	0	10592
19143	306	48	43	10054	0	10451
19144	135	28	39	9772	0	9974
19145	94	9346	44	302	0	9786
19146	112	199	33	8985	0	9329
19147	99	55	47	8940	0	9141
19148	8518	43	33	261	0	8855
19149	240	84	25	6865	0	7214
19150	67	15	6002	164	0	6248
19151	46	5547	102	78	0	5773
19152	42	5482	39	46	0	5609
19153	5247	101	26	38	0	5412
19154	109	5253	22	29	0	5413
19155	4622	78	50	22	0	4772
19156	80	4610	15	17	0	4722
19157	4652	72	12	20	0	4756
19158	84	30	2	4670	0	4786
19159	42	12	3	4703	0	4760
19160	21	4698	4	86	0	4809
19161	36	73	5	4761	0	4875
19162	18	22	4829	88	0	4957
19163	4686	13	67	43	0	4809
19164	79	5000	22	22	0	5123
19165	4876	68	11	20	0	4975
19166	4901	24	7	16	0	4948
19167	4946	12	6	13	0	4977
19168	104	16	6	4822	0	4948
19169	51	4	5	4800	0	4860
19170	27	4868	5	85	0	4985
19171	4877	65	2	35	0	4979
19172	74	4886	2	35	0	4997
19173	4906	72	3	18	0	4999
19174	79	34	5035	20	0	5168
19175	5265	13	67	14	0	5359
19176	107	15	22	5279	0	5423
19177	48	9	5318	94	0	5469
19178	33	7	5341	32	0	5413
19179	29	6	112	5350	0	5497
19180	24	5	5380	103	0	5512
19181	22	5	101	5330	0	5458
19182	5187	9	42	110	0	5348
19183	105	9	16	5232	0	5362
19184	41	7	5196	107	0	5351
19185	34	5011	85	56	0	5186
19186	29	5199	30	25	0	5283
19187	22	101	21	5113	0	5257
19188	5155	37	25	94	0	5311
19189	105	20	5	5225	0	5355
19190	42	15	10	5292	0	5359
19191	33	5	6	5357	0	5401
19192	25	15	10	5373	0	5423
19193	24	4	5278	138	0	5444
19194	19	11	5196	66	0	5292
19195	5241	7	110	42	0	5400
19196	5326	11	40	32	0	5409
19197	127	5	28	5307	0	5467
19198	63	8	18	5383	0	5472
19199	34	6	5276	131	0	5447
19200	22	5294	90	64	0	5470
19201	5276	87	27	44	0	5434
19202	5366	39	20	31	0	5456
19203	128	17	10	5311	0	5466
19204	51	20	5344	103	0	5518
19205	44	8	86	5259	0	5397
19206	19	5340	38	109	0	5506
19207	27	85	5346	47	0	5505
19208	5334	40	93	39	0	5506
19209	102	17	34	5441	0	5594
19210	5461	21	23	104	0	5609
19211	112	8	5304	58	0	5482
19212	5343	12	93	37	0	5485
19213	117	13	31	5337	0	5498
19214	5288	10	25	101	0	5424
19215	115	10	19	5162	0	5306
19216	54	5015	10	110	0	5189
19217	26	5135	9	60	0	5230
19218	39	121	13	4982	0	5155
19219	15	37	4882	97	0	5031
19220	19	4782	75	30	0	4906
19221	62	73	33	4450	0	4618
19222	4362	23	27	71	0	4483
19223	4365	12	10	37	0	4424
19224	77	7	12	4337	0	4433
19225	44	4	14	4312	0	4374
19226	22	4172	10	76	0	4280
19227	18	4331	10	39	0	4398
19228	4309	71	5	34	0	4419
19229	65	30	10	4287	0	4392
19230	33	20	8	4318	0	4379
19231	21	12	4277	90	0	4400
19232	18	7	61	4247	0	4333
19233	17	10	30	4238	0	4295
19234	8	8	20	4317	0	4353
19235	17	7	4273	98	0	4395
19236	17	8	60	4300	0	4385
19237	4261	7	30	86	0	4384
19238	59	6	4216	44	0	4325
19239	4389	5	74	38	0	4506
19240	71	10	29	4457	0	4567
19241	40	8	17	4635	0	4700
19242	28	6	13	4733	0	4780
19243	17	5	4617	109	0	4748
19244	4512	4	69	51	0	4636
19245	67	4740	25	41	0	4873
19246	4770	65	16	26	0	4877
19247	67	4814	12	28	0	4921
19248	35	66	12	4851	0	4964
19249	4861	27	11	85	0	4984
19250	76	13	4782	50	0	4921
19251	4695	13	68	30	0	4806
19252	76	6	4826	31	0	4939
19253	42	16	66	4735	0	4859
19254	22	6	4739	69	0	4836
19255	21	4643	64	71	0	4799
19256	33	47	42	4543	0	4665
19257	4481	23	22	75	0	4601
19258	54	15	15	4393	0	4477
19259	32	4338	11	58	0	4439
19260	22	53	8	4381	0	4464
19261	4331	22	5	76	0	4434
19262	4208	12	9	38	0	4267
19263	65	4139	12	27	0	4243
19264	28	3955	11	13	0	4007
19265	24	65	13	3941	0	4043
19266	15	24	9	3978	0	4026
19267	3913	16	13	66	0	4008
19268	3906	8	4	37	0	3955
19269	58	3923	5	25	0	4011
19270	36	58	8	3768	0	3870
19271	19	26	6	3823	0	3874
19272	14	15	3769	58	0	3856
19273	11	3701	41	38	0	3791
19274	11	3598	15	26	0	3650
19275	15	42	6	3477	0	3540
19276	3	8	3463	37	0	3511
19277	3	3	3444	13	0	3463
19278	11	4	35	3508	0	3558
19279	3	11	13	3547	0	3574
19280	5	3	3548	41	0	3597
19281	12	3	29	3609	0	3653
19282	5	0	3690	38	0	3733
19283	3774	3	29	25	0	3831
19284	40	3	13	3835	0	3891
19285	14	4	3897	45	0	3960
19286	9	2	3911	19	0	3941
19287	11	6	56	4189	0	4262
19288	5	5	4493	58	0	4561
19289	5	7	4592	19	0	4623
19290	5	4538	72	19	0	4634
19291	4654	51	23	18	0	4746
19292	57	19	4772	7	0	4855
19293	25	9	63	4781	0	4878
19294	15	7	21	4834	0	4877
19295	8	5	11	4933	0	4957
19296	4	3	4841	85	0	4933
19297	8	7	61	4763	0	4839
19298	4779	3	21	77	0	4880
19299	60	2	13	4767	0	4842
19300	20	2	4765	74	0	4861
19301	10	2	62	4763	0	4837
19302	4803	1	25	74	0	4903
19303	4836	1	13	41	0	4891
19304	4784	1	17	21	0	4823
19305	84	1	11	4767	0	4863
19306	4780	4	8	74	0	4866
19307	4794	2	9	31	0	4836
19308	4791	0	12	20	0	4823
19309	85	4626	12	14	0	4737
19310	4704	58	8	15	0	4785
19311	78	15	15	4678	0	4786
19312	30	8	4654	72	0	4764
19313	16	4632	64	33	0	4745
19314	4686	60	27	20	0	4793
19315	65	24	12	4681	0	4782
19316	29	12	13	4612	0	4666
19317	22	4568	11	87	0	4688
19318	15	4736	10	41	0	4802
19319	4549	71	13	25	0	4658
19320	66	4562	5	25	0	4658
19321	4443	64	7	19	0	4533
19322	68	4450	11	14	0	4543
19323	4439	62	6	17	0	4524
19324	67	4463	8	17	0	4555
19325	35	4596	14	11	0	4656
19326	4609	73	8	12	0	4702
19327	77	26	4610	14	0	4727
19328	26	4639	54	14	0	4733
19329	26	73	21	4670	0	4790
19330	21	22	7	4843	0	4893
19331	21	10	11	4794	0	4836
19332	16	16	7	4864	0	4903
19333	17	6	4875	88	0	4986
19334	4828	13	65	49	0	4955
19335	74	7	23	5020	0	5124
19336	5054	8	18	87	0	5167
19337	5239	9	14	37	0	5299
19338	5275	9	10	22	0	5316
19339	5120	11	10	28	0	5169
19340	113	7	5017	19	0	5156
19341	36	18	74	4964	0	5092
19342	31	5	4928	89	0	5053
19343	21	4926	83	39	0	5069
19344	38	85	32	4582	0	4737
19345	24	27	25	4836	0	4912
19346	18	12	20	4881	0	4931
19347	26	21	7	4840	0	4894
19348	22	9	4760	112	0	4903
19349	19	9	83	4766	0	4877
19350	26	7	27	4885	0	4945
19351	4869	7	13	118	0	5007
19352	5014	5	19	52	0	5090
19353	118	8	17	5052	0	5195
19354	49	7	19	5119	0	5194
19355	42	10	14	5159	0	5225
19356	5122	6	18	137	0	5283
19357	5223	13	18	60	0	5314
19358	5045	16	13	49	0	5123
19359	5191	11	17	35	0	5254
19360	122	5128	14	37	0	5301
19361	5197	80	18	29	0	5324
19362	5259	29	4	38	0	5330
19363	136	12	7	5112	0	5267
19364	53	16	9	5123	0	5201
19365	5016	11	11	120	0	5158
19366	110	4902	4	57	0	5073
19367	49	5025	13	40	0	5127
19368	5170	100	11	44	0	5325
19369	113	30	6	5297	0	5446
19370	55	23	7	5346	0	5431
19371	53	16	7	5425	0	5501
19372	49	12	2	5407	0	5470
19373	42	16	8	5353	0	5419
19374	37	5206	7	122	0	5372
19375	34	72	6	5123	0	5235
19376	5102	24	4	101	0	5231
19377	92	23	7	5022	0	5144
19378	36	18	2	5034	0	5090
19379	4943	18	6	111	0	5078
19380	93	4975	9	47	0	5124
19381	35	91	7	4873	0	5006
19382	29	4905	9	88	0	5031
19383	30	122	11	4706	0	4869
19384	29	21	4683	69	0	4802
19385	4413	21	60	37	0	4531
19386	69	4494	11	24	0	4598
19387	4211	54	8	28	0	4301
19388	62	11	4068	12	0	4153
19389	20	34	42	3746	0	3842
19390	11	3730	8	80	0	3829
19391	12	3859	6	18	0	3895
19392	3735	48	20	19	0	3822
19393	54	10	4	3756	0	3824
19394	14	9	3906	45	0	3974
19395	15	8	39	3962	0	4024
19396	12	3	3964	55	0	4034
19397	3852	6	45	22	0	3925
19398	45	6	4031	20	0	4102
19399	17	3	43	4001	0	4064
19400	12	4093	10	49	0	4164
19401	16	41	5	4116	0	4178
19402	15	4140	5	47	0	4207
19403	4267	46	3	18	0	4334
19404	54	11	2	4399	0	4466
19405	17	7	4435	56	0	4515
19406	15	8	4288	20	0	4331
19407	4392	4	43	20	0	4459
19408	4562	5	11	18	0	4596
19409	4557	5	8	15	0	4585
19410	4522	3	7	16	0	4548
19411	55	4472	6	12	0	4545
19412	4514	45	3	11	0	4573
19413	4533	7	4	16	0	4560
19414	59	7	4457	14	0	4537
19415	23	11	41	4426	0	4501
19416	4491	7	8	54	0	4560
19417	53	9	4425	18	0	4505
19418	21	7	43	4392	0	4463
19419	12	6	4475	60	0	4553
19420	15	4	50	4428	0	4497
19421	18	4571	13	51	0	4653
19422	4604	46	5	28	0	4683
19423	54	17	4537	11	0	4619
19424	4479	9	43	11	0	4542
19425	56	6	10	4511	0	4583
19426	4521	6	5	57	0	4589
19427	51	7	6	4497	0	4561
19428	4693	4	3	64	0	4764
19429	52	9	4625	18	0	4704
19430	4830	8	39	24	0	4901
19431	50	8	11	4877	0	4946
19432	21	5	10	4893	0	4929
19433	4797	4	7	62	0	4870
19434	48	5	7	4804	0	4864
19435	12	11	4731	46	0	4800
19436	11	14	35	4674	0	4734
19437	4540	1	12	44	0	4597
19438	35	4473	6	16	0	4530
19439	12	4478	4	9	0	4503
19440	4369	29	5	11	0	4414
19441	32	4496	5	12	0	4545
19442	21	20	5	4473	0	4519
19443	4477	8	11	29	0	4525
19444	4490	3	5	17	0	4515
19445	4485	6	1	10	0	4502
19446	30	5	4476	10	0	4521
19447	15	16	21	4423	0	4475
19448	7	4465	8	27	0	4507
19449	7	24	4	4511	0	4546
19450	6	11	4608	22	0	4647
19451	10	4439	21	12	0	4482
19452	17	42	11	4429	0	4499
19453	4349	5	6	27	0	4387
19454	17	4369	2	6	0	4394
19455	9	16	4495	1	0	4521
19456	14	3	15	4421	0	4453
19457	6	4	4424	22	0	4456
19458	7	2	22	4329	0	4360
19459	4485	1	8	33	0	4527
19460	28	1	4	4480	0	4513
19461	4517	3	1	30	0	4551
19462	4545	0	6	14	0	4565
19463	26	4613	3	8	0	4650
19464	4697	20	4	10	0	4731
19465	29	4680	4	8	0	4721
19466	13	27	4808	3	0	4851
19467	13	7	27	4827	0	4874
19468	10	3	8	5067	0	5088
19469	6	3	4862	35	0	4906
19470	5	4835	28	11	0	4879
19471	4899	27	10	12	0	4948
19472	5024	8	7	11	0	5050
19473	41	4	6	5092	0	5143
19474	18	0	1	5104	0	5123
19475	13	0	4	5194	0	5211
19476	5141	1	8	47	0	5197
19477	37	4	5066	15	0	5122
19478	16	3	5099	4	0	5122
19479	11	2	39	5185	0	5237
19480	5	2	5105	42	0	5154
19481	9	3	5097	15	0	5124
19482	9	0	40	5016	0	5065
19483	12	5	5173	32	0	5222
19484	5	5147	36	20	0	5208
19485	13	33	13	5228	0	5287
19486	5	12	5310	39	0	5366
19487	8	7	34	5259	0	5308
19488	7	5074	14	40	0	5135
19489	10	27	8	5208	0	5253
19490	8	9	5285	41	0	5343
19491	11	7	35	5222	0	5275
19492	5277	1	10	47	0	5335
19493	37	3	5264	14	0	5318
19494	4986	1	35	24	0	5046
19495	41	5187	10	9	0	5247
19496	5240	36	6	15	0	5297
19497	40	14	5	5284	0	5343
19498	12	5337	5	45	0	5399
19499	5570	41	9	18	0	5638
19500	52	17	3	5671	0	5743
19501	18	12	5708	55	0	5793
19502	11	5732	53	19	0	5815
19503	14	55	19	5706	0	5794
19504	5601	14	6	66	0	5687
19505	5561	6	4	24	0	5595
19506	70	5	5	5525	0	5605
19507	22	6	5470	58	0	5556
19508	5252	5	59	27	0	5343
19509	58	4	5475	15	0	5552
19510	24	4	63	5441	0	5532
19511	5488	8	17	69	0	5582
19512	65	5491	9	28	0	5593
19513	5545	57	14	22	0	5638
19514	67	15	5479	13	0	5574
19515	5527	9	65	17	0	5618
19516	72	7	17	5555	0	5651
19517	30	5	14	5671	0	5720
19518	18	13	5634	77	0	5742
19519	22	5	57	5531	0	5615
19520	5579	12	25	67	0	5683
19521	74	3	8	5585	0	5670
19522	23	5648	19	66	0	5756
19523	18	58	11	5619	0	5706
19524	15	5663	13	79	0	5770
19525	12	59	5598	28	0	5697
19526	5532	14	59	15	0	5620
19527	60	14	18	5708	0	5800
19528	23	9	5489	64	0	5585
19529	16	5441	57	30	0	5544
19530	23	68	19	5326	0	5436
19531	21	15	12	5438	0	5486
19532	5371	12	9	96	0	5488
19533	67	12	14	5455	0	5548
19534	5494	10	13	79	0	5596
19535	5499	8	13	36	0	5556
19536	86	5497	16	25	0	5624
19537	5592	73	8	23	0	5696
19538	91	18	11	5918	0	6038
19539	29	12	5951	85	0	6077
19540	5998	12	65	32	0	6107
19541	91	8	24	5901	0	6024
19542	34	11	5864	87	0	5996
19543	5768	7	77	37	0	5889
19544	92	15	23	5895	0	6025
19545	42	6062	18	88	0	6210
19546	31	75	15	5934	0	6055
19547	31	6066	13	76	0	6186
19548	6026	78	13	56	0	6173
19549	84	27	6215	31	0	6357
19550	40	6138	77	48	0	6303
19551	26	83	23	6213	0	6345
19552	18	26	6267	92	0	6403
19553	34	15	6079	34	0	6162
19554	20	6232	90	33	0	6375
19555	36	93	35	6215	0	6379
19556	22	31	23	6433	0	6509
19557	23	14	20	7316	0	7373
19558	7506	16	18	179	0	7719
19559	168	15	7830	58	0	8071
19560	40	7909	180	39	0	8168
19561	39	194	39	7845	0	8117
19562	38	45	25	8186	0	8294
19563	17	24	7972	239	0	8252
19564	40	36	187	7953	0	8216
19565	22	19	7910	221	0	8172
19566	22	16	7660	74	0	7772
19567	26	9	7771	44	0	7850
19568	38	13	214	7460	0	7725
19569	27	13	68	7712	0	7820
19570	27	14	30	7927	0	7998
19571	7709	16	25	241	0	7991
19572	187	7642	16	85	0	7930
19573	7794	183	20	54	0	8051
19574	7660	43	23	47	0	7773
19575	7952	24	20	38	0	8034
19576	223	7924	24	40	0	8211
19577	7995	190	22	29	0	8236
19578	8182	43	24	37	0	8286
19579	255	19	20	7985	0	8279
19580	75	23	18	8214	0	8330
19581	55	15	22	8274	0	8366
19582	43	19	8007	251	0	8320
19583	7880	16	192	88	0	8176
19584	220	20	52	8021	0	8313
19585	7886	14	33	231	0	8164
19586	212	7867	24	83	0	8186
19587	76	190	20	7944	0	8230
19588	45	42	25	8166	0	8278
19589	7993	29	25	248	0	8295
19590	212	22	27	7996	0	8257
19591	7503	23	27	240	0	7793
19592	7927	23	17	96	0	8063
19593	240	7573	19	63	0	7895
19594	72	7812	21	50	0	7955
19595	57	257	24	7524	0	7862
19596	30	7742	24	206	0	8002
19597	45	211	22	7681	0	7959
19598	28	50	7566	227	0	7871
19599	36	23	7288	77	0	7424
19600	7029	24	197	57	0	7307
19601	7203	17	65	54	0	7339
19602	210	7040	30	47	0	7327
19603	7067	162	26	45	0	7300
19604	190	7352	22	38	0	7602
19605	59	189	18	7451	0	7717
19606	43	50	18	7584	0	7695
19607	47	28	18	7612	0	7705
19608	32	26	20	7653	0	7731
19609	7460	16	20	246	0	7742
19610	181	7451	23	84	0	7739
19611	7525	174	21	64	0	7784
19612	7650	42	21	58	0	7771
19613	232	27	7441	43	0	7743
19614	7328	25	171	45	0	7569
19615	221	7332	43	31	0	7627
19616	78	181	22	7393	0	7674
19617	50	44	20	7355	0	7469
19618	43	7235	20	219	0	7517
19619	7418	190	20	72	0	7700
19620	200	54	7298	56	0	7608
19621	7167	37	170	70	0	7444
19622	221	26	7303	47	0	7597
19623	76	22	196	7331	0	7625
19624	75	30	56	7521	0	7682
19625	58	20	39	7636	0	7753
19626	7519	33	42	265	0	7859
19627	197	29	7611	100	0	7937
19628	7583	30	181	108	0	7902
19629	7795	25	75	84	0	7979
19630	7792	29	48	82	0	7951
19631	7733	23	51	80	0	7887
19632	263	17	44	7564	0	7888
19633	87	26	7460	216	0	7789
19634	85	26	183	7440	0	7734
19635	67	22	7421	225	0	7735
19636	60	30	7312	102	0	7504
19637	75	7319	191	70	0	7655
19638	72	179	44	6805	0	7100
19639	70	54	22	7133	0	7279
19640	83	47	29	6268	0	6427
19641	89	27	17	7046	0	7179
19642	6951	30	20	237	0	7238
19643	7069	20	19	84	0	7192
19644	252	23	16	6850	0	7141
19645	100	21	6656	215	0	6992
19646	78	11	158	6725	0	6972
19647	58	23	37	6912	0	7030
19648	42	16	6712	247	0	7017
19649	54	15	155	6561	0	6785
19650	6538	19	46	223	0	6826
19651	6603	11	26	101	0	6741
19652	6605	28	19	66	0	6718
19653	232	22	13	6461	0	6728
19654	6342	21	12	205	0	6580
19655	6299	19	12	67	0	6397
19656	213	16	6064	69	0	6362
19657	56	6	4935	35	0	5032
19658	38	7	4905	25	0	4975
19659	4465	9	33	21	0	4528
19660	36	4450	12	16	0	4514
19661	4457	24	20	18	0	4519
19662	25	4691	5	15	0	4736
19663	21	29	8	4687	0	4745
19664	13	12	2	4729	0	4756
19665	15	4	4	4740	0	4763
19666	13	7	4706	33	0	4759
19667	4496	1	32	19	0	4548
19668	37	0	9	4653	0	4699
19669	14	5	4596	32	0	4647
19670	6	2	4394	12	0	4414
19671	4427	1	26	14	0	4468
19672	31	4597	10	9	0	4647
19673	4529	22	9	4	0	4564
19674	4465	5	6	8	0	4484
19675	33	4433	0	8	0	4474
19676	4324	22	4	8	0	4358
19677	33	5	4447	6	0	4491
19678	10	4	4276	7	0	4297
19679	7	1	4481	5	0	4494
19680	9	13	27	4472	0	4521
19681	2	5	4521	19	0	4547
19682	4427	3	21	9	0	4460
19683	4507	3	5	5	0	4520
19684	30	2	4556	6	0	4594
19685	12	5	21	4513	0	4551
19686	4533	1	7	31	0	4572
19687	20	4686	7	12	0	4725
19688	13	4776	4	5	0	4798
19689	4779	20	4	13	0	4816
19690	26	8	4821	4	0	4859
19691	9	17	18	4664	0	4708
19692	6	5	8	4720	0	4739
19693	5	4	1	4780	0	4790
19694	2	4784	3	24	0	4813
19695	16	17	8	4503	0	4544
19696	5087	6	1	26	0	5120
19697	29	2	2	5210	0	5243
19698	12	5219	5	31	0	5267
19699	5310	23	3	24	0	5360
19700	35	9	1	5322	0	5367
19701	14	5	4	5534	0	5557
19702	5608	6	4	44	0	5662
19703	5659	3	3	18	0	5683
19704	49	1	3	5489	0	5542
19705	5601	2	1	48	0	5652
19706	5654	4	1	24	0	5683
19707	53	5778	0	7	0	5838
19708	5806	42	3	13	0	5864
19709	50	5745	3	7	0	5805
19710	38	40	4	5744	0	5826
19711	15	17	5848	49	0	5929
19712	16	11	42	5832	0	5901
19713	15	9	12	5897	0	5933
19714	25	6	4	6058	0	6093
19715	6018	6	5	72	0	6101
19716	50	6008	5	30	0	6093
19717	6218	45	3	23	0	6289
19718	62	6427	2	24	0	6515
19719	6571	54	4	25	0	6654
19720	6629	22	6	21	0	6678
19721	6662	13	2	23	0	6700
19722	6577	8	4	23	0	6612
19723	87	15	6565	11	0	6678
19724	47	7	53	6598	0	6705
19725	34	11	18	6805	0	6868
19726	28	7	6696	91	0	6822
19727	6453	11	67	40	0	6571
19728	84	4	23	6595	0	6706
19729	43	12	6544	83	0	6682
19730	29	9	6488	36	0	6562
19731	35	6	91	6637	0	6769
19732	22	9	6817	88	0	6936
19733	24	7	75	6693	0	6799
19734	36	9	34	6728	0	6807
19735	22	9	6591	102	0	6724
19736	6417	8	76	44	0	6545
19737	98	1	28	6571	0	6698
19738	37	9	6628	85	0	6759
19739	26	7	80	6635	0	6748
19740	6666	6	36	90	0	6798
19741	85	2	6651	53	0	6791
19742	6526	9	82	44	0	6661
19743	6802	4	36	30	0	6872
19744	117	6	20	6756	0	6899
19745	45	4	19	6751	0	6819
19746	26	5	6740	106	0	6877
19747	30	7	82	6724	0	6843
19748	52	5	40	6235	0	6332
19749	26	3	21	6826	0	6876
19750	24	4	6663	110	0	6801
19751	6497	3	83	53	0	6636
19752	6691	5	39	40	0	6775
19753	6797	7	21	46	0	6871
19754	6949	4	28	39	0	7020
19755	113	6	21	6945	0	7085
19756	6891	3	16	111	0	7021
19757	6926	6	17	56	0	7005
19758	5590	42	28	70	0	5730
19759	6892	8	24	44	0	6968
19760	113	6891	16	39	0	7059
19761	6962	77	15	44	0	7098
19762	6917	21	17	32	0	6987
19763	128	6929	17	37	0	7111
19764	6977	90	14	38	0	7119
19765	140	31	14	6948	0	7133
19766	74	11	11	7010	0	7106
19767	6928	12	18	123	0	7081
19768	118	6774	14	58	0	6964
19769	68	6835	8	40	0	6951
19770	58	107	11	6948	0	7124
19771	50	37	7020	101	0	7208
19772	51	28	84	6927	0	7090
19773	52	11	33	7088	0	7184
19774	7011	12	21	140	0	7184
19775	7071	8	19	66	0	7164
19776	134	13	14	7038	0	7199
19777	60	19	6991	119	0	7189
19778	56	9	86	7101	0	7252
19779	7216	9	39	127	0	7391
19780	126	18	7470	58	0	7672
19781	62	7494	121	43	0	7720
19782	7666	111	45	42	0	7864
19783	154	37	28	7701	0	7920
19784	73	22	20	7754	0	7869
19785	51	22	14	7881	0	7968
19786	39	13	7632	177	0	7861
19787	7053	6	117	95	0	7271
19788	145	2	7360	56	0	7563
19789	49	7349	142	48	0	7588
19790	52	116	51	7438	0	7657
19791	51	37	33	7561	0	7682
19792	46	23	26	7919	0	8014
19793	32	19	7779	216	0	8046
19794	25	8	7651	94	0	7778
19795	27	6	7810	67	0	7910
19796	33	7775	170	46	0	8024
19797	56	150	69	7816	0	8091
19798	7946	41	35	174	0	8196
19799	8345	20	20	65	0	8450
19800	216	12	8619	54	0	8901
19801	85	8736	170	39	0	9030
19802	56	164	8743	33	0	8996
19803	38	9073	176	29	0	9316
19804	8872	216	88	43	0	9219
19805	8876	59	47	35	0	9017
19806	230	8790	25	27	0	9072
19807	8743	184	30	28	0	8985
19808	224	74	17	8685	0	9000
19809	104	46	15	8867	0	9032
19810	8788	29	27	231	0	9075
19811	8663	29	17	88	0	8797
19812	8731	21	14	57	0	8823
19813	260	8441	17	46	0	8764
19814	99	8743	15	52	0	8909
19815	8679	216	10	48	0	8953
19816	235	71	8604	37	0	8947
19817	104	110	167	8354	0	8735
19818	8217	28	54	193	0	8492
19819	204	7977	38	73	0	8292
19820	83	8331	23	46	0	8483
19821	8264	226	27	36	0	8553
19822	213	73	8105	36	0	8427
19823	7896	66	180	29	0	8171
19824	232	31	7848	26	0	8137
19825	89	38	7886	18	0	8031
19826	73	43	200	7885	0	8201
19827	46	34	8096	163	0	8339
19828	8000	22	192	61	0	8275
19829	8198	22	80	54	0	8354
19830	8319	26	60	34	0	8439
19831	8297	20	36	39	0	8392
19832	257	19	37	8009	0	8322
19833	8067	20	31	173	0	8291
19834	227	7927	38	63	0	8255
19835	121	156	28	7785	0	8090
19836	90	8095	27	146	0	8358
19837	8350	175	17	65	0	8607
19838	8410	60	18	50	0	8538
19839	243	51	18	8292	0	8604
19840	8394	35	20	182	0	8631
19841	8517	35	27	74	0	8653
19842	254	34	29	8361	0	8678
19843	132	41	21	8395	0	8589
19844	106	32	16	8538	0	8692
19845	96	23	8251	240	0	8610
19846	84	27	7926	110	0	8147
19847	77	26	8213	74	0	8390
19848	62	29	218	8242	0	8551
19849	59	26	8396	199	0	8680
19850	69	27	215	8338	0	8649
19851	60	31	8804	216	0	9111
19852	66	24	8592	94	0	8776
19853	8413	26	221	86	0	8746
19854	192	8521	114	57	0	8884
19855	8709	157	69	61	0	8996
19856	221	61	59	8620	0	8961
19857	116	46	62	8758	0	8982
19858	93	38	8750	217	0	9098
19859	60	8704	183	109	0	9056
19860	80	186	67	8827	0	9160
19861	66	74	8921	185	0	9246
19862	72	8743	168	85	0	9068
19863	84	146	75	8739	0	9044
19864	8703	59	61	177	0	9000
19865	8744	49	37	89	0	8919
19866	217	34	40	8717	0	9008
19867	8739	31	37	185	0	8992
19868	201	8744	38	93	0	9076
19869	108	154	37	8818	0	9117
19870	84	70	8911	176	0	9241
19871	86	47	167	8900	0	9200
19872	81	35	8904	195	0	9215
19873	8762	40	177	92	0	9071
19874	212	32	62	8963	0	9269
19875	101	9017	57	174	0	9349
19876	99	181	35	9256	0	9571
19877	75	52	9128	204	0	9459
19878	69	43	8947	101	0	9160
19879	67	24	8778	77	0	8946
19880	8318	44	193	55	0	8610
19881	145	8534	78	52	0	8809
19882	66	128	53	8473	0	8720
19883	8471	47	48	151	0	8717
19884	130	8460	57	70	0	8717
19885	8762	115	48	72	0	8997
19886	8847	53	42	45	0	8987
19887	8999	35	36	52	0	9122
19888	9094	27	26	48	0	9195
19889	190	29	8817	44	0	9080
19890	8653	20	120	44	0	8837
19891	172	34	8656	35	0	8897
19892	8305	13	120	40	0	8478
19893	151	22	62	8469	0	8704
19894	85	19	8351	93	0	8548
19895	60	8151	88	59	0	8358
19896	64	333	68	7724	0	8189
19897	55	7939	37	79	0	8110
19898	39	7967	39	50	0	8095
19899	7415	69	52	34	0	7570
19900	65	19	7151	29	0	7264
19901	25	6863	35	19	0	6942
19902	6644	26	46	11	0	6727
19903	27	6741	12	8	0	6788
19904	6751	19	10	10	0	6790
19905	26	19	9	6755	0	6809
19906	6797	5	6	21	0	6829
19907	27	5	3	6709	0	6744
19908	6732	3	15	25	0	6775
19909	27	5	5	6703	0	6740
19910	11	6875	3	29	0	6918
19911	12	20	5	7008	0	7045
19912	7001	12	0	28	0	7041
19913	25	6964	2	11	0	7002
19914	14	23	5	6950	0	6992
19915	7073	9	4	29	0	7115
19916	22	10	2	7112	0	7146
19917	16	8	2	7113	0	7139
19918	10	3	7195	27	0	7235
19919	10	4	6940	14	0	6968
19920	12	7	24	6999	0	7042
19921	13	9	7295	25	0	7342
19922	16	6	21	7247	0	7290
19923	22	7	19	6551	0	6599
19924	9	9	4	7358	0	7380
19925	10	7	7305	35	0	7357
19926	18	4	23	6994	0	7039
19927	13	4	8	7138	0	7163
19928	5	7169	7	33	0	7214
19929	10	23	3	7261	0	7297
19930	7260	7	5	42	0	7314
19931	33	6	4	7372	0	7415
19932	10	11	8109	37	0	8167
19933	7788	2	59	37	0	7886
19934	62	8560	44	18	0	8684
19935	60	68	23	8687	0	8838
19936	31	45	8549	76	0	8701
19937	8036	27	79	59	0	8201
19938	73	8404	51	42	0	8570
19939	8485	74	33	25	0	8617
19940	108	48	13	8443	0	8612
19941	8389	33	7	91	0	8520
19942	109	19	8340	56	0	8524
19943	68	8211	77	39	0	8395
19944	43	8712	44	23	0	8822
19945	8809	111	35	32	0	8987
19946	8819	60	21	30	0	8930
19947	125	36	8782	12	0	8955
19948	8597	18	77	26	0	8718
19949	8789	18	49	26	0	8882
19950	8854	12	32	20	0	8918
19951	151	8364	16	10	0	8541
19952	96	8505	13	6	0	8620
19953	8542	112	7	18	0	8679
19954	8603	61	11	16	0	8691
19955	130	8622	7	12	0	8771
19956	84	93	8	8633	0	8818
19957	52	56	8699	70	0	8877
19958	8464	40	75	50	0	8629
19959	8027	30	44	71	0	8172
19960	8899	11	36	38	0	8984
19961	138	8710	20	21	0	8889
19962	77	88	8734	12	0	8911
19963	8872	50	81	19	0	9022
19964	114	31	42	8989	0	9176
19965	82	20	29	9007	0	9138
19966	49	19	19	9171	0	9258
19967	34	16	9090	141	0	9281
19968	38	14	76	8959	0	9087
19969	23	14	9056	126	0	9219
19970	14	8742	99	72	0	8927
19971	8637	69	57	53	0	8816
19972	77	8624	34	35	0	8770
19973	51	8711	19	16	0	8797
19974	8671	108	17	23	0	8819
19975	77	8855	15	7	0	8954
19976	60	100	7	8723	0	8890
19977	41	8729	4	67	0	8841
19978	8741	104	2	46	0	8893
19979	83	8843	2	29	0	8957
19980	63	104	6	9028	0	9201
19981	39	65	8960	86	0	9150
19982	29	42	83	9049	0	9203
19983	18	9025	45	128	0	9216
19984	20	95	30	9208	0	9353
19985	21	91	20	9042	0	9174
19986	25	51	17	8818	0	8911
19987	21	17	16	9142	0	9196
19988	20	21	7	9210	0	9258
19989	17	19	6	9270	0	9312
19990	11	18	9091	205	0	9325
19991	8925	10	101	127	0	9163
19992	113	13	58	9581	0	9765
19993	68	11	9565	155	0	9799
19994	44	15	9521	103	0	9683
19995	35	11	171	9718	0	9935
19996	9771	12	110	157	0	10050
19997	117	24	9635	104	0	9880
19998	9566	13	146	78	0	9803
19999	158	13	9921	49	0	10141
20000	114	19	164	9934	0	10231
20001	87	23	103	10124	0	10337
20002	61	26	10061	192	0	10340
20003	9627	13	152	129	0	9921
20004	153	15	103	9936	0	10207
20005	92	23	9901	173	0	10189
20006	67	27	9875	108	0	10077
20007	65	12	195	9566	0	9838
20008	49	9922	116	148	0	10235
20009	10086	118	90	108	0	10402
20010	10109	66	71	78	0	10324
20011	209	57	10136	49	0	10451
20012	131	34	148	9996	0	10309
20013	10150	26	82	166	0	10424
20014	185	24	10122	102	0	10433
20015	9911	18	161	90	0	10180
20016	207	9763	108	61	0	10139
20017	131	121	71	10185	0	10508
20018	90	68	64	10259	0	10481
20019	10517	45	52	239	0	10853
20020	185	42	39	10612	0	10878
20021	112	36	42	10480	0	10670
20022	88	25	30	10634	0	10777
20023	10383	22	35	297	0	10737
20024	180	21	10355	187	0	10743
20025	10399	16	158	139	0	10712
20026	10528	15	93	94	0	10730
20027	10721	19	68	88	0	10896
20028	306	33	46	10508	0	10893
20029	166	32	10708	193	0	11099
20030	126	10281	186	132	0	10725
20031	88	10409	108	105	0	10710
20032	65	10215	53	71	0	10404
20033	55	166	10387	70	0	10678
20034	81	117	182	11287	0	11667
20035	11578	44	81	274	0	11977
20036	12573	40	35	173	0	12821
20037	334	23	35	13083	0	13475
20038	191	17	12982	308	0	13498
20039	117	20	13025	172	0	13334
20040	96	16	338	13144	0	13594
20041	69	15	13299	323	0	13706
20042	81	9	325	13413	0	13828
20043	70	13	182	13273	0	13538
20044	44	13208	121	416	0	13789
20045	69	247	82	13438	0	13836
20046	86	112	69	13843	0	14110
20047	13514	77	73	460	0	14124
20048	326	49	64	13657	0	14096
20049	169	36	66	13818	0	14089
20050	13382	26	73	482	0	13963
20051	312	13322	69	276	0	13979
20052	13496	248	74	196	0	14014
20053	363	126	13262	148	0	13899
20054	13303	69	293	138	0	13803
20055	13350	55	166	131	0	13702
20056	446	41	12999	113	0	13599
20057	240	42	12924	133	0	13339
20058	205	43	409	12552	0	13209
20059	12610	25	224	357	0	13216
20060	354	35	12423	207	0	13019
20061	229	26	363	12366	0	12984
20062	143	25	12349	374	0	12891
20063	138	36	374	12263	0	12811
20064	134	29	213	12519	0	12895
20065	12246	31	144	491	0	12912
20066	12201	32	105	312	0	12650
20067	12504	35	103	231	0	12873
20068	476	34	12229	179	0	12918
20069	274	27	12278	170	0	12749
20070	222	42	401	12161	0	12826
20071	186	31	223	12355	0	12795
20072	155	29	167	12579	0	12930
20073	12089	31	137	507	0	12764
20074	367	12012	112	318	0	12809
20075	11887	255	118	215	0	12475
20076	11700	122	107	184	0	12113
20077	477	11243	107	181	0	12008
20078	285	11629	92	137	0	12143
20079	11524	329	101	178	0	12132
20080	370	149	87	11192	0	11798
20081	257	11103	90	388	0	11838
20082	251	281	63	11288	0	11883
20083	195	155	10995	447	0	11792
20084	188	84	316	11171	0	11759
20085	11013	74	232	449	0	11768
20086	366	54	10882	315	0	11617
20087	222	46	10852	250	0	11370
20088	202	147	440	10195	0	10984
20089	178	10158	249	399	0	10984
20090	142	10310	167	279	0	10898
20091	117	10663	130	277	0	11187
20092	10261	361	123	247	0	10992
20093	10347	178	78	238	0	10841
20094	10053	103	76	236	0	10468
20095	441	9913	87	240	0	10681
20096	10166	245	90	206	0	10707
20097	10138	161	82	190	0	10571
20098	473	120	9838	150	0	10581
20099	288	9584	329	133	0	10334
20100	244	286	215	9666	0	10411
20101	9702	152	141	347	0	10342
20102	397	92	9536	229	0	10254
20103	254	64	338	9316	0	9972
20104	192	9422	205	391	0	10210
20105	209	245	143	9485	0	10082
20106	198	118	160	9658	0	10134
20107	9552	78	154	498	0	10282
20108	9664	90	145	306	0	10205
20109	443	70	138	9561	0	10212
20110	278	72	9250	416	0	10016
20111	232	82	9243	279	0	9836
20112	9329	81	340	228	0	9978
20113	460	81	9369	153	0	10063
20114	308	85	339	8530	0	9262
20115	260	8822	228	293	0	9603
20116	8916	224	182	226	0	9548
20117	354	8850	166	212	0	9582
20118	8980	257	132	247	0	9616
20119	394	134	120	8871	0	9519
20120	262	123	112	9014	0	9511
20121	8887	121	112	410	0	9530
20122	9182	82	98	266	0	9628
20123	476	95	94	8956	0	9621
20124	338	118	76	8973	0	9505
20125	259	119	8589	369	0	9336
20126	217	96	8526	258	0	9097
20127	8495	111	328	198	0	9132
20128	321	104	8036	217	0	8678
20129	8158	76	301	195	0	8730
20130	8322	54	192	214	0	8782
20131	429	69	7932	186	0	8616
20132	272	7452	259	162	0	8145
20133	228	7568	201	112	0	8109
20134	123	107	6428	64	0	6722
20135	239	406	268	5477	0	6390
20136	5014	97	188	185	0	5484
20137	4843	16	15	32	0	4906
20138	5335	17	8	28	0	5388
20139	5972	4	6	30	0	6012
20140	6069	9	11	28	0	6117
20141	133	6206	20	24	0	6383
20142	6043	97	13	18	0	6171
20143	117	5973	17	10	0	6117
20144	5856	101	10	11	0	5978
20145	116	23	5722	7	0	5868
20146	38	12	87	5541	0	5678
20147	34	7	17	5421	0	5479
20148	16	5531	10	104	0	5661
20149	5581	97	5	22	0	5705
20150	5676	20	3	18	0	5717
20151	116	19	3	5562	0	5700
20152	47	7	5	5647	0	5706
20153	5593	5	11	113	0	5722
20154	107	7	5	5617	0	5736
20155	38	7	5	5696	0	5746
20156	5611	12	7	117	0	5747
20157	118	4	3	5624	0	5749
20158	5650	6	3	109	0	5768
20159	5705	6	4	43	0	5758
20160	120	7	5651	25	0	5803
20161	5704	2	82	21	0	5809
20162	5723	5	20	30	0	5778
20163	5743	5	11	25	0	5784
20164	133	7	5532	12	0	5684
20165	48	1	86	5522	0	5657
20166	37	3	19	5649	0	5708
20167	37	4	5519	109	0	5669
20168	5466	2	93	40	0	5601
20169	122	5	21	5465	0	5613
20170	49	5	5405	96	0	5555
20171	34	10	5503	26	0	5573
20172	34	4	110	5496	0	5644
20173	24	6	5610	113	0	5753
20174	22	6	99	5575	0	5702
20175	27	8	32	5663	0	5730
20176	32	2	5626	113	0	5773
20177	25	7	94	5479	0	5605
20178	23	5398	36	109	0	5566
20179	17	5693	26	35	0	5771
20180	5628	109	12	40	0	5789
20181	5662	22	18	16	0	5718
20182	111	5602	14	31	0	5758
20183	5588	90	11	41	0	5730
20184	5668	22	20	25	0	5735
20185	126	12	12	5598	0	5748
20186	46	19	7	5679	0	5751
20187	5588	18	13	119	0	5738
20188	122	5473	16	41	0	5652
20189	61	5629	5	28	0	5723
20190	49	108	11	5601	0	5769
20191	43	33	5640	104	0	5820
20192	5532	19	91	40	0	5682
20193	5679	16	21	37	0	5753
20194	5567	15	19	37	0	5638
20195	152	5601	13	19	0	5785
20196	49	107	11	5562	0	5729
20197	49	34	7	5695	0	5785
20198	5595	17	14	131	0	5757
20199	111	5560	23	45	0	5739
20200	69	97	7	5493	0	5666
20201	60	31	13	5590	0	5694
20202	52	25	11	5585	0	5673
20203	5531	24	11	146	0	5712
20204	130	5504	12	71	0	5717
20205	59	127	14	5374	0	5574
20206	53	5504	9	123	0	5689
20207	5430	120	9	55	0	5614
20208	132	29	5382	55	0	5598
20209	5286	27	108	51	0	5472
20210	133	24	5252	48	0	5457
20211	82	57	110	5010	0	5259
20212	5033	20	31	113	0	5197
20213	127	14	5016	64	0	5221
20214	5024	17	94	48	0	5183
20215	5167	8	36	48	0	5259
20216	5186	15	24	44	0	5269
20217	157	12	18	5044	0	5231
20218	64	14	26	5035	0	5139
20219	52	3	16	5100	0	5171
20220	4974	8	17	136	0	5135
20221	119	5012	25	58	0	5214
20222	4955	79	22	40	0	5096
20223	5042	25	21	33	0	5121
20224	139	12	4912	33	0	5096
20225	4897	9	86	42	0	5034
20226	5074	9	32	33	0	5148
20227	135	14	27	5006	0	5182
20228	53	10	17	5035	0	5115
20229	46	16	18	5034	0	5114
20230	4881	13	17	132	0	5043
20231	4826	15	18	48	0	4907
20232	4617	10	17	40	0	4684
20233	114	4315	18	72	0	4519
20234	44	4040	19	22	0	4125
20235	25	4090	17	35	0	4167
20236	4021	76	32	44	0	4173
20237	86	24	3929	38	0	4077
20238	36	17	3344	32	0	3429
20239	2626	8	37	9	0	2680
20240	30	1	2767	6	0	2804
20241	7	3	7	2390	0	2407
20242	4	2321	5	8	0	2338
20243	2510	9	0	7	0	2526
20244	2516	3	2	5	0	2526
20245	2513	3	5	4	0	2525
20246	16	0	1	2675	0	2692
20247	6	0	2749	10	0	2765
20248	3	4	2703	5	0	2715
20249	2712	3	12	2	0	2729
20250	2783	0	5	7	0	2795
20251	2781	1	1	0	0	2783
20252	13	2	3	2825	0	2843
20253	10	1	1	2821	0	2833
20254	4	0	2788	12	0	2804
20255	2783	0	11	8	0	2802
20256	10	1	5	2883	0	2899
20257	4	0	2	2875	0	2881
20258	3	0	2	2869	0	2874
20259	3	2865	1	10	0	2879
20260	3	8	1	2848	0	2860
20261	2	3	1	2837	0	2843
20262	2834	0	1	14	0	2849
20263	9	2	2783	5	0	2799
20264	2683	0	9	9	0	2701
20265	2805	1	3	3	0	2812
20266	15	2	0	2772	0	2789
20267	7	1	2	2773	0	2783
20268	2752	2	1	15	0	2770
20269	12	1	2734	5	0	2752
20270	6	2728	9	3	0	2746
20271	3	8	2	2715	0	2728
20272	2707	2	0	12	0	2721
20273	12	2	2	2621	0	2637
20274	4	2	2604	12	0	2622
20275	3	0	2585	4	0	2592
20276	2606	1	11	5	0	2623
20277	13	2	4	2694	0	2713
20278	5	2	2676	10	0	2693
20279	2629	0	9	6	0	2644
20280	2786	3	4	1	0	2794
20281	11	1	2	2782	0	2796
20282	6	1	2	2768	0	2777
20283	7	2766	1	9	0	2783
20284	2848	6	1	15	0	2870
20285	10	2	3	2862	0	2877
20286	7	3	0	2881	0	2891
20287	4	1	2932	9	0	2946
20288	2770	2	8	10	0	2790
20289	2867	1	2	6	0	2876
20290	10	2823	1	4	0	2838
20291	4	5	2722	1	0	2732
20292	8	2	2690	4	0	2704
20293	7	13	4	2672	0	2696
20294	2757	5	6	10	0	2778
20295	5	0	0	2729	0	2734
20296	2826	0	0	15	0	2841
20297	2822	0	1	9	0	2832
20298	2859	0	2	7	0	2868
20299	6	1	0	2868	0	2875
20300	2	1	1	2872	0	2876
20301	2913	0	2	8	0	2923
20302	6	0	2952	1	0	2959
20303	2768	0	1	4	0	2773
20304	2791	0	2	5	0	2798
20305	3	0	2853	2	0	2858
20306	2	1	2806	0	0	2809
20307	2	2823	1	1	0	2827
20308	2	2	6	2865	0	2875
20309	2785	1	3	4	0	2793
20310	1	0	1	2886	0	2888
20311	2	2	2911	1	0	2916
20312	1	2859	0	1	0	2861
20313	0	2907	1	3	0	2911
20314	0	3	0	3036	0	3039
20315	1	2	0	2991	0	2994
20316	1	3034	1	1	0	3037
20317	0	2	3018	3	0	3023
20318	2899	1	2	12	0	2914
20319	3085	0	2	6	0	3093
20320	2	3093	2	3	0	3100
20321	3020	1	1	4	0	3026
20322	1	3	1	2986	0	2991
20323	2988	0	0	2	0	2990
20324	2	0	0	3020	0	3022
20325	0	3283	1	3	0	3287
20326	1	8	3353	1	0	3363
20327	7	1	9	3703	0	3720
20328	8	1	2	3636	0	3647
20329	3	0	0	3933	0	3936
20330	4027	2	0	31	0	4060
20331	32	0	1	4086	0	4119
20332	10	1	4358	29	0	4398
20333	2	0	4523	11	0	4536
20334	4677	0	45	10	0	4732
20335	38	1	4766	1	0	4806
20336	4801	0	39	7	0	4847
20337	48	0	13	5069	0	5130
20338	19	0	5	5160	0	5184
20339	13	0	4	5416	0	5433
20340	8	0	5	5408	0	5421
20341	5377	0	0	79	0	5456
20342	62	2	5367	22	0	5453
20343	38	0	57	5250	0	5345
20344	6	5428	16	62	0	5512
20345	5457	63	5	25	0	5550
20346	68	21	3	5306	0	5398
20347	5244	3	2	76	0	5325
20348	77	3	5207	19	0	5306
20349	29	0	76	5055	0	5160
20350	8	5181	22	66	0	5277
20351	5199	70	6	30	0	5305
20352	74	19	5167	10	0	5270
20353	29	5	65	5099	0	5198
20354	27	1	20	5231	0	5279
20355	5148	1	14	97	0	5260
20356	75	2	5117	34	0	5228
20357	27	9	5179	14	0	5229
20358	23	3	79	5190	0	5295
20359	11	2	5186	78	0	5277
20360	10	2	5260	38	0	5310
20361	13	1	93	5240	0	5347
20362	19	3	25	5339	0	5386
20363	26	4	20	5517	0	5567
20364	5436	5	19	106	0	5566
20365	87	5525	7	46	0	5665
20366	5571	76	16	25	0	5688
20367	98	21	10	5575	0	5704
20368	35	5586	9	102	0	5732
20369	19	83	7	5781	0	5890
20370	5987	25	15	119	0	6146
20371	99	6261	11	44	0	6415
20372	45	104	11	6464	0	6624
20373	35	32	6530	112	0	6709
20374	6533	12	114	60	0	6719
20375	116	11	38	6562	0	6727
20376	45	10	18	6648	0	6721
20377	35	4	6495	166	0	6700
20378	19	11	6492	67	0	6589
20379	6387	6	144	37	0	6574
20380	118	6359	66	29	0	6572
20381	57	113	26	6415	0	6611
20382	6403	42	22	136	0	6603
20383	125	14	6422	63	0	6624
20384	57	6376	123	40	0	6596
20385	27	115	48	6395	0	6585
20386	6419	42	23	144	0	6628
20387	6317	29	24	67	0	6437
20388	6480	6	29	44	0	6559
20389	156	6322	19	46	0	6543
20390	64	106	6325	37	0	6532
20391	39	50	120	6392	0	6601
20392	57	30	59	5733	0	5879
20393	44	11	26	6525	0	6606
20394	36	20	18	6519	0	6593
20395	6355	14	27	188	0	6584
20396	6332	21	22	88	0	6463
20397	166	13	6214	56	0	6449
20398	69	11	6160	53	0	6293
20399	6059	14	162	65	0	6300
20400	6209	16	59	51	0	6335
20401	181	13	29	6011	0	6234
20402	91	6041	35	116	0	6283
20403	6054	115	34	71	0	6274
20404	131	5943	36	57	0	6167
20405	66	5995	30	42	0	6133
20406	53	151	17	6069	0	6290
20407	41	55	24	6218	0	6338
20408	40	28	17	6237	0	6322
20409	37	25	25	6241	0	6328
20410	46	23	6017	178	0	6264
20411	5971	25	123	79	0	6198
20412	6110	20	54	68	0	6252
20413	169	17	28	5960	0	6174
20414	75	11	26	5968	0	6080
20415	5876	21	30	180	0	6107
20416	148	28	5426	77	0	5679
20417	5772	11	110	61	0	5954
20418	5814	18	38	55	0	5925
20419	182	17	5703	45	0	5947
20420	5866	23	117	50	0	6056
20421	151	17	55	5894	0	6117
20422	76	14	32	5976	0	6098
20423	58	13	29	5978	0	6078
20424	62	10	29	5934	0	6035
20425	5521	16	18	171	0	5726
20426	147	22	28	5396	0	5593
20427	77	12	15	5019	0	5123
20428	33	4665	22	168	0	4888
20429	29	4795	24	80	0	4928
20430	39	103	15	4690	0	4847
20431	4640	36	9	126	0	4811
20432	110	22	9	4320	0	4461
20433	36	13	3990	105	0	4144
20434	28	9	3770	40	0	3847
20435	3756	16	91	36	0	3899
20436	88	3772	36	39	0	3935
20437	3528	65	37	41	0	3671
20438	96	21	3574	22	0	3713
20439	61	100	87	3271	0	3519
20440	3282	12	20	67	0	3381
20441	61	3278	17	33	0	3389
20442	3218	51	22	28	0	3319
20443	83	20	3469	16	0	3588
20444	36	17	48	3468	0	3569
20445	19	14	23	3549	0	3605
20446	3572	11	20	88	0	3691
20447	3632	5	21	44	0	3702
20448	3702	7	14	25	0	3748
20449	3701	10	5	30	0	3746
20450	3715	12	6	37	0	3770
20451	87	3663	8	21	0	3779
20452	41	43	16	3706	0	3806
20453	3761	22	15	69	0	3867
20454	67	12	9	3738	0	3826
20455	47	4	7	3769	0	3827
20456	50	11	5	3746	0	3812
20457	29	3627	8	81	0	3745
20458	3674	47	7	38	0	3766
20459	53	20	17	3654	0	3744
20460	3545	15	8	71	0	3639
20461	3488	8	4	52	0	3552
20462	64	3398	6	40	0	3508
20463	3389	37	5	27	0	3458
20464	62	12	3306	22	0	3402
20465	3247	7	37	14	0	3305
20466	59	21	33	3233	0	3346
20467	33	9	3298	36	0	3376
20468	32	3243	31	25	0	3331
20469	27	27	3195	16	0	3265
20470	17	2870	21	10	0	2918
20471	2583	43	49	17	0	2692
20472	2524	4	6	11	0	2545
20473	2465	0	2	4	0	2471
20474	6	2423	2	2	0	2433
20475	2383	4	0	8	0	2395
20476	4	2	2387	2	0	2395
20477	2	1	2393	1	0	2397
20478	3	2	5	2393	0	2403
20479	1	1	3	2538	0	2543
20480	0	2527	1	8	0	2536
20481	2563	10	0	5	0	2578
20482	14	2	0	2586	0	2602
20483	1	2564	0	16	0	2581
20484	1	12	0	2640	0	2653
20485	2626	1	0	17	0	2644
20486	2556	1	0	9	0	2566
20487	17	2	2469	2	0	2490
20488	9	1	11	2504	0	2525
20489	1	5	2514	15	0	2535
20490	1	1	13	2552	0	2567
20491	1	2	2570	14	0	2587
20492	3	0	14	2557	0	2574
20493	3	4	2566	13	0	2586
20494	3	0	14	2567	0	2584
20495	2	1	2625	16	0	2644
20496	2	0	15	2638	0	2655
20497	2	0	2	2682	0	2686
20498	1	2733	3	13	0	2750
20499	2	14	0	2834	0	2850
20500	0	3	2808	15	0	2826
20501	3	2	13	2797	0	2815
20502	3	0	3	2824	0	2830
20503	2846	1	3	23	0	2873
20504	16	1	0	2906	0	2923
20505	3	1	2	2896	0	2902
20506	3	1	2839	20	0	2863
20507	2779	0	17	9	0	2805
20508	15	3	3	2887	0	2908
20509	2	1	2	2916	0	2921
20510	3	2	1	2928	0	2934
20511	2934	0	2	29	0	2965
20512	18	0	3	2978	0	2999
20513	4	0	2	3004	0	3010
20514	2971	0	3	27	0	3001
20515	17	2964	3	10	0	2994
20516	7	16	1	2954	0	2978
20517	3	7	3	2980	0	2993
20518	2	1	2905	24	0	2932
20519	2625	0	18	13	0	2656
20520	18	1	3	2881	0	2903
20521	6	0	2810	24	0	2840
20522	2863	2	16	13	0	2894
20523	19	1	2	3030	0	3052
20524	7	0	2	3157	0	3166
20525	4	1	3	3180	0	3188
20526	7	0	1	3269	0	3277
20527	3	5	3507	34	0	3549
20528	4	0	31	3575	0	3610
20529	11	0	5	4327	0	4343
20530	5	2	4817	78	0	4902
20531	5000	0	84	30	0	5114
20532	5219	0	27	33	0	5279
20533	5238	1	19	15	0	5273
20534	160	2	17	5125	0	5304
20535	5198	1	8	107	0	5314
20536	5323	1	3	53	0	5380
20537	166	1	7	5296	0	5470
20538	5298	0	1	132	0	5431
20539	5333	1	4	53	0	5391
20540	5353	4	6	36	0	5399
20541	5382	0	2	41	0	5425
20542	179	2	0	5194	0	5375
20543	92	4863	6	112	0	5073
20544	60	4942	15	51	0	5068
20545	50	5010	8	35	0	5103
20546	4867	142	7	29	0	5045
20547	5014	68	0	27	0	5109
20548	146	49	4870	23	0	5088
20549	5014	27	95	18	0	5154
20550	173	16	37	5040	0	5266
20551	88	8	21	5102	0	5219
20552	64	5	23	5152	0	5244
20553	5035	2	11	170	0	5218
20554	140	2	6	5031	0	5179
20555	61	4920	9	155	0	5145
20556	58	101	2	5044	0	5205
20557	40	47	5110	146	0	5343
20558	40	40	99	5168	0	5347
20559	5185	33	33	141	0	5392
20560	140	15	5202	61	0	5418
20561	69	3	115	5234	0	5421
20562	45	10	49	5244	0	5348
20563	59	6	29	5308	0	5402
20564	28	5280	25	175	0	5508
20565	24	108	12	5387	0	5531
20566	5341	31	6	178	0	5556
20567	5303	18	9	88	0	5418
20568	163	27	5169	62	0	5421
20569	70	23	5246	51	0	5390
20570	59	12	134	5270	0	5475
20571	47	11	62	5418	0	5538
20572	33	5	5401	175	0	5614
20573	47	6	131	5198	0	5382
20574	27	5284	56	151	0	5518
20575	5512	117	35	95	0	5759
20576	5558	34	29	64	0	5685
20577	5525	21	10	66	0	5622
20578	219	26	5458	45	0	5748
20579	100	20	107	5515	0	5742
20580	83	8	5499	129	0	5719
20581	5406	11	123	63	0	5603
20582	135	5453	69	49	0	5706
20583	61	103	43	5466	0	5673
20584	5476	37	34	144	0	5691
20585	145	28	19	5497	0	5689
20586	69	23	13	5679	0	5784
20587	48	16	5509	176	0	5749
20588	5352	17	105	92	0	5566
20589	142	5481	44	64	0	5731
20590	75	99	27	5565	0	5766
20591	5559	36	28	141	0	5764
20592	159	27	24	5567	0	5777
20593	5540	25	17	170	0	5752
20594	158	5555	25	81	0	5819
20595	5677	113	9	62	0	5861
20596	158	55	5628	51	0	5892
20597	5680	37	125	52	0	5894
20598	5716	30	43	35	0	5824
20599	5741	16	28	51	0	5836
20600	210	11	33	5563	0	5817
20601	134	17	28	5310	0	5489
20602	101	17	13	5605	0	5736
20603	65	5427	15	191	0	5698
20604	5490	112	16	118	0	5736
20605	159	42	19	5501	0	5721
20606	77	36	12	5563	0	5688
20607	57	33	15	5574	0	5679
20608	5443	28	8	190	0	5669
20609	154	16	15	5495	0	5680
20610	66	13	5371	186	0	5636
20611	70	5388	102	103	0	5663
20612	71	106	39	5469	0	5685
20613	46	45	32	5577	0	5700
20614	34	42	34	5647	0	5757
20615	33	27	5433	210	0	5703
20616	28	22	5431	117	0	5598
20617	36	19	143	5526	0	5724
20618	47	17	5676	161	0	5901
20619	43	7	137	5784	0	5971
20620	5811	6	64	188	0	6069
20621	6028	13	43	102	0	6186
20622	5956	12	38	86	0	6092
20623	183	15	5751	65	0	6014
20624	5649	10	109	56	0	5824
20625	180	24	52	5724	0	5980
20626	80	12	5649	139	0	5880
20627	60	11	5405	72	0	5548
20628	47	5347	133	62	0	5589
20629	30	4736	36	38	0	4840
20630	4100	55	112	21	0	4288
20631	51	13	17	3981	0	4062
20632	14	4	4058	30	0	4106
20633	10	5	29	4148	0	4192
20634	4191	2	7	42	0	4242
20635	35	6	4445	11	0	4497
20636	4385	3	38	17	0	4443
20637	4629	3	5	7	0	4644
20638	4555	2	4	12	0	4573
20639	50	4512	7	7	0	4576
20640	4621	39	7	16	0	4683
20641	53	7	0	4675	0	4735
20642	15	7	5	4659	0	4686
20643	14	4	3	4710	0	4731
20644	9	5	3	4688	0	4705
20645	4607	1	4	58	0	4670
20646	45	4503	5	23	0	4576
20647	12	4385	6	14	0	4417
20648	17	4510	9	10	0	4546
20649	4561	42	6	10	0	4619
20650	4533	10	3	12	0	4558
20651	4515	11	6	12	0	4544
20652	4528	8	2	9	0	4547
20653	58	6	2	4534	0	4600
20654	20	3	3	4541	0	4567
20655	4526	2	3	56	0	4587
20656	45	4492	3	24	0	4564
20657	4386	38	0	21	0	4445
20658	4462	7	3	13	0	4485
20659	51	13	4	4429	0	4497
20660	13	4470	6	43	0	4532
20661	19	45	2	4537	0	4603
20662	4525	5	4	56	0	4590
20663	52	7	4583	15	0	4657
20664	20	6	38	4456	0	4520
20665	15	4562	7	43	0	4627
20666	4588	35	10	21	0	4654
20667	4591	6	8	18	0	4623
20668	55	6	4591	9	0	4661
20669	17	4523	34	10	0	4584
20670	19	39	4600	9	0	4667
20671	21	15	36	4493	0	4565
20672	9	10	4483	38	0	4540
20673	7	10	4430	14	0	4461
20674	10	4426	33	17	0	4486
20675	4418	34	14	17	0	4483
20676	4466	8	14	13	0	4501
20677	38	4580	9	6	0	4633
20678	18	4545	6	10	0	4579
20679	19	43	4405	6	0	4473
20680	17	9	4308	9	0	4343
20681	9	14	4459	6	0	4488
20682	9	12	41	4482	0	4544
20683	8	4	4542	38	0	4592
20684	9	7	42	4454	0	4512
20685	14	3	15	4403	0	4435
20686	11	8	4467	44	0	4530
20687	12	4459	35	12	0	4518
20688	19	37	7	4474	0	4537
20689	4477	13	6	43	0	4539
20690	36	13	6	4483	0	4538
20691	12	10	4523	37	0	4582
20692	11	4513	36	14	0	4574
20693	10	4734	14	8	0	4766
20694	13	41	10	4657	0	4721
20695	4638	9	9	50	0	4706
20696	4637	7	11	20	0	4675
20697	55	7	4	4621	0	4687
20698	18	4821	7	47	0	4893
20699	19	46	8	4869	0	4942
20700	12	12	7	5025	0	5056
20701	15	9	3	5057	0	5084
20702	5234	10	2	70	0	5316
20703	58	5286	7	21	0	5372
20704	5322	58	7	25	0	5412
20705	5421	15	8	17	0	5461
20706	5397	15	3	20	0	5435
20707	5520	12	6	8	0	5546
20708	80	13	3	5467	0	5563
20709	32	7	5475	61	0	5575
20710	20	5493	58	23	0	5594
20711	5570	62	17	33	0	5682
20712	5646	15	13	22	0	5696
20713	5716	13	3	26	0	5758
20714	93	8	5597	13	0	5711
20715	5570	14	62	13	0	5659
20716	5700	12	16	12	0	5740
20717	98	12	16	5659	0	5785
20718	50	4	5456	63	0	5573
20719	37	5379	60	22	0	5498
20720	29	68	16	5356	0	5469
20721	5332	16	22	80	0	5450
20722	75	16	10	5359	0	5460
20723	31	9	14	5546	0	5600
20724	5712	15	5	87	0	5819
20725	94	8	5624	32	0	5758
20726	5668	3	71	28	0	5770
20727	5638	7	19	20	0	5684
20728	5650	5	27	16	0	5698
20729	5644	11	7	19	0	5681
20730	115	8	5491	8	0	5622
20731	51	6	72	5446	0	5575
20732	30	7	5505	78	0	5620
20733	34	20	79	5412	0	5545
20734	18	9	5433	95	0	5555
20735	5072	6	79	32	0	5189
20736	75	5009	21	27	0	5132
20737	28	5227	23	12	0	5290
20738	38	70	13	5564	0	5685
20739	26	30	10	5769	0	5835
20740	22	5959	4	91	0	6076
20741	5995	81	4	40	0	6120
20742	6256	28	6	20	0	6310
20743	6498	20	5	12	0	6535
20744	6784	3	10	20	0	6817
20745	154	5	9	6749	0	6917
20746	80	6	11	6983	0	7080
20747	7056	4	9	165	0	7234
20748	136	3	12	7006	0	7157
20749	68	5	6851	136	0	7060
20750	41	17	6884	52	0	6994
20751	31	9	153	6931	0	7124
20752	24	4	6939	128	0	7095
20753	6858	5	136	75	0	7074
20754	126	11	49	6912	0	7098
20755	6954	4	33	126	0	7117
20756	151	6	6948	65	0	7170
20757	78	8	123	6949	0	7158
20758	54	7	6989	121	0	7171
20759	31	6926	132	74	0	7163
20760	6854	121	66	46	0	7087
20761	6907	53	39	31	0	7030
20762	170	6793	8	31	0	7002
20763	6764	114	15	22	0	6915
20764	161	53	14	6678	0	6906
20765	83	33	15	6767	0	6898
20766	6663	10	13	178	0	6864
20767	135	6521	16	86	0	6758
20768	77	6631	13	50	0	6771
20769	61	159	10	6552	0	6782
20770	6477	79	17	133	0	6706
20771	6581	35	12	73	0	6701
20772	6586	10	14	57	0	6667
20773	206	13	6384	19	0	6622
20774	104	12	6340	22	0	6478
20775	56	6346	159	34	0	6595
20776	6329	119	77	30	0	6555
20777	161	61	31	6216	0	6469
20778	6255	30	14	135	0	6434
20779	6313	12	15	75	0	6415
20780	202	12	17	6183	0	6414
20781	108	15	6149	138	0	6410
20782	6168	16	123	77	0	6384
20783	151	14	59	6165	0	6389
20784	101	6	6131	135	0	6373
20785	6105	17	129	77	0	6328
20786	6209	14	60	53	0	6336
20787	196	7	45	6071	0	6319
20788	108	13	6027	151	0	6299
20789	71	15	132	5934	0	6152
20790	49	6026	54	154	0	6283
20791	46	117	6007	78	0	6248
20792	52	6062	126	51	0	6291
20793	5916	136	57	31	0	6140
20794	6004	51	41	36	0	6132
20795	5977	32	27	35	0	6071
20796	5956	17	28	23	0	6024
20797	224	14	26	5708	0	5972
20798	5594	18	31	142	0	5785
20799	164	17	27	5502	0	5710
20800	5345	11	19	150	0	5525
20801	158	5233	11	89	0	5491
20802	92	99	24	4961	0	5176
20803	63	4996	16	104	0	5179
20804	4982	112	17	73	0	5184
20805	4989	55	16	47	0	5107
20806	166	4879	22	33	0	5100
20807	111	98	14	4798	0	5021
20808	57	57	4759	107	0	4980
20809	48	42	101	4722	0	4913
20810	36	10	4698	128	0	4872
20811	49	27	106	4398	0	4580
20812	39	4502	57	104	0	4702
20813	4484	93	27	64	0	4668
20814	4541	54	21	32	0	4648
20815	155	32	13	4464	0	4664
20816	4635	22	14	106	0	4777
20817	136	15	19	4607	0	4777
20818	86	18	11	4669	0	4784
20819	71	14	14	4691	0	4790
20820	4611	8	14	164	0	4797
20821	4620	17	15	83	0	4735
20822	4615	14	9	46	0	4684
20823	165	4299	15	36	0	4515
20824	4160	79	10	25	0	4274
20825	117	4074	17	25	0	4233
20826	4094	88	15	27	0	4224
20827	115	48	15	4023	0	4201
20828	82	18	15	4095	0	4210
20829	4039	18	8	127	0	4192
20830	4052	12	10	73	0	4147
20831	147	3952	13	35	0	4147
20832	3953	82	4	20	0	4059
20833	113	40	6	3821	0	3980
20834	69	17	10	3862	0	3958
20835	3787	9	8	129	0	3933
20836	101	10	3705	66	0	3882
20837	64	3532	79	31	0	3706
20838	43	73	34	3099	0	3249
20839	25	27	2818	62	0	2932
20840	29	101	51	2608	0	2789
20841	2612	7	38	67	0	2724
20842	60	2382	16	32	0	2490
20843	27	2130	6	29	0	2192
20844	12	1924	6	10	0	1952
20845	63	67	41	1683	0	1854
20846	1669	7	45	24	0	1745
20847	20	2	0	1613	0	1635
20848	1590	2	0	20	0	1612
20849	1605	1	1	4	0	1611
20850	24	0	0	1595	0	1619
20851	1621	1	2	18	0	1642
20852	19	1	1	1634	0	1655
20853	6	0	1630	19	0	1655
20854	1629	2	14	6	0	1651
20855	18	0	1730	4	0	1752
20856	1612	0	12	5	0	1629
20857	13	5	1640	3	0	1661
20858	9	6	11	1539	0	1565
20859	2	3	3	1599	0	1607
20860	1623	2	0	16	0	1641
20861	13	1	1	1655	0	1670
20862	1667	0	0	14	0	1681
20863	13	1662	1	6	0	1682
20864	1735	10	1	6	0	1752
20865	15	4	3	1779	0	1801
20866	5	0	1	1810	0	1816
20867	3	3	0	1815	0	1821
20868	4	1	3	1818	0	1826
20869	1	1	1774	19	0	1795
20870	1	1	1734	5	0	1741
20871	4	2	14	1763	0	1783
20872	2	0	1800	12	0	1814
20873	2	1787	12	4	0	1805
20874	2	12	5	1800	0	1819
20875	4	3	1853	14	0	1874
20876	3	1	1822	7	0	1833
20877	8	2	13	1869	0	1892
20878	5	0	5	1899	0	1909
20879	3	1902	3	16	0	1924
20880	3	13	3	1936	0	1955
20881	2	2	1931	18	0	1953
20882	1877	1	16	11	0	1905
20883	18	2	6	1937	0	1963
20884	1950	1	1	23	0	1975
20885	1962	0	3	10	0	1975
20886	2030	2	4	3	0	2039
20887	19	0	2044	5	0	2068
20888	8	1	2019	4	0	2032
20889	1929	2	19	3	0	1953
20890	18	2	2079	5	0	2104
20891	5	0	16	1991	0	2012
20892	3	1	8	2022	0	2034
20893	4	0	2056	18	0	2078
20894	1	2042	17	6	0	2066
20895	2057	16	3	5	0	2081
20896	17	2045	2	4	0	2068
20897	3	2121	5	5	0	2134
20898	2133	18	4	6	0	2161
20899	19	4	2190	3	0	2216
20900	4	2	2218	5	0	2229
20901	2	4	22	2195	0	2223
20902	2230	1	3	20	0	2254
20903	18	2244	5	8	0	2275
20904	2245	20	9	5	0	2279
20905	24	4	2348	4	0	2380
20906	7	2468	20	7	0	2502
20907	4	24	8	2524	0	2560
20908	6	5	2599	25	0	2635
20909	5	0	25	2612	0	2642
20910	14	6	18	2299	0	2337
20911	5	2	4	2662	0	2673
20912	5	1	5	2650	0	2661
20913	2635	5	3	27	0	2670
20914	2630	3	3	10	0	2646
20915	30	1	2639	8	0	2678
20916	2502	1	27	7	0	2537
20917	30	2531	4	3	0	2568
20918	2513	22	4	7	0	2546
20919	42	5	2549	4	0	2600
20920	12	6	20	2509	0	2547
20921	7	2	2552	20	0	2581
20922	3	4	2566	5	0	2578
20923	6	2	28	2516	0	2552
20924	5	3	8	2567	0	2583
20925	5	2	2537	24	0	2568
20926	2	2485	23	8	0	2518
20927	3	2532	7	9	0	2551
20928	3	24	5	2533	0	2565
20929	2521	8	7	21	0	2557
20930	24	2650	2	6	0	2682
20931	6	20	2672	6	0	2704
20932	6	4	2604	7	0	2621
20933	7	4	2687	6	0	2704
20934	6	6	27	2625	0	2664
20935	2675	1	9	28	0	2713
20936	26	2642	8	10	0	2686
20937	11	20	2644	3	0	2678
20938	4	2626	23	5	0	2658
20939	5	20	9	2694	0	2728
20940	3	7	2704	24	0	2738
20941	6	2738	24	7	0	2775
20942	7	24	5	2727	0	2763
20943	1	6	7	2787	0	2801
20944	5	2	2819	26	0	2852
20945	5	14	22	2743	0	2784
20946	6	2773	6	27	0	2812
20947	5	20	2774	11	0	2810
20948	2761	7	25	8	0	2801
20949	24	8	8	2812	0	2852
20950	5	9	7	2806	0	2827
20951	7	2771	6	26	0	2810
20952	2759	25	6	15	0	2805
20953	24	7	2748	5	0	2784
20954	2717	6	27	5	0	2755
20955	26	10	3	2724	0	2763
20956	3	2757	9	23	0	2792
20957	3	22	8	2789	0	2822
20958	4	8	1	2842	0	2855
20959	2833	5	5	31	0	2874
20960	2861	4	7	9	0	2881
20961	28	3	5	2868	0	2904
20962	7	3	2844	31	0	2885
20963	2690	5	26	13	0	2734
20964	27	2874	7	6	0	2914
20965	5	29	6	2880	0	2920
20966	7	6	4	2926	0	2943
20967	10	3	3	2931	0	2947
20968	1	3	2902	33	0	2939
20969	2	8	27	2851	0	2888
20970	3	2905	8	31	0	2947
20971	5	25	7	2876	0	2913
20972	2	2881	7	30	0	2920
20973	4	29	2	2873	0	2908
20974	1	10	2845	33	0	2889
20975	2666	4	25	12	0	2707
20976	26	4	7	2835	0	2872
20977	6	2	2843	24	0	2875
20978	5	2837	20	11	0	2873
20979	2825	21	6	10	0	2862
20980	21	7	2796	8	0	2832
20981	2778	4	25	7	0	2814
20982	23	1	7	2888	0	2919
20983	6	2	2	2908	0	2918
20984	5	2899	2	23	0	2929
20985	2892	16	3	15	0	2926
20986	2844	5	2	6	0	2857
20987	21	2970	5	7	0	3003
20988	8	15	3	3030	0	3056
20989	4	7	1	3038	0	3050
20990	1	3	2	3017	0	3023
20991	2	2	3014	26	0	3044
20992	2919	3	16	10	0	2948
20993	20	1	5	2980	0	3006
20994	6	5	4	3007	0	3022
20995	7	2	2951	26	0	2986
20996	1	4	2918	11	0	2934
20997	7	4	22	3001	0	3034
20998	7	2	3026	17	0	3052
20999	2911	5	19	14	0	2949
21000	16	2	11	3010	0	3039
21001	9	4	3	3026	0	3042
21002	4	4	3165	23	0	3196
21003	9	3	20	3230	0	3262
21004	7	3	3285	21	0	3316
21005	2	3212	21	12	0	3247
21006	3057	20	14	12	0	3103
21007	3048	5	3	7	0	3063
21008	16	2995	4	2	0	3017
21009	6	13	3	3037	0	3059
21010	1	6	3060	14	0	3081
21011	4	2	12	3067	0	3085
21012	3060	3	4	17	0	3084
21013	14	3073	2	6	0	3095
21014	3092	13	2	4	0	3111
21015	14	5	5	3085	0	3109
21016	3088	2	0	17	0	3107
21017	14	3054	1	5	0	3074
21018	3078	14	1	4	0	3097
21019	15	6	3004	1	0	3026
21020	6	3033	14	5	0	3058
21021	7	13	8	3065	0	3093
21022	3161	4	3	24	0	3192
21023	3190	1	3	8	0	3202
21024	15	1	2	3206	0	3224
21025	3236	2	0	16	0	3254
21026	3218	0	2	9	0	3229
21027	3295	1	1	7	0	3304
21028	17	1	0	3312	0	3330
21029	5	1	3335	13	0	3354
21030	5	1	3111	10	0	3127
21031	2	0	3176	5	0	3183
21032	3197	1	22	4	0	3224
21033	18	3	6	3251	0	3278
21034	4	3318	2	15	0	3339
21035	4	13	2	3323	0	3342
21036	3	3370	3	17	0	3393
21037	3398	14	1	13	0	3426
21038	18	4	3	3431	0	3456
21039	6	3	3	3514	0	3526
21040	3578	0	2	23	0	3603
21041	19	1	0	3593	0	3613
21042	5	2	1	3662	0	3670
21043	3743	1	1	24	0	3769
21044	21	0	3826	7	0	3854
21045	8	3	21	3814	0	3846
21046	4	4	3833	23	0	3864
21047	3787	1	25	9	0	3822
21048	25	1	9	3868	0	3903
21049	3894	1	5	25	0	3925
21050	27	3	1	3972	0	4003
21051	10	1	4088	27	0	4126
21052	11	1	23	4166	0	4201
21053	4259	2	6	29	0	4296
21054	26	4311	3	9	0	4349
21055	10	26	4278	5	0	4319
21056	4130	6	22	12	0	4170
21057	24	4392	8	4	0	4428
21058	6	4526	2	3	0	4537
21059	6	4983	3	4	0	4996
21060	12	45	4	5402	0	5463
21061	5522	11	3	56	0	5592
21062	5718	7	1	16	0	5742
21063	74	6	5648	7	0	5735
21064	5562	4	52	12	0	5630
21065	68	5567	13	6	0	5654
21066	30	53	2	5633	0	5718
21067	5800	14	5	69	0	5888
21068	5857	8	5	24	0	5894
21069	5893	4	5	18	0	5920
21070	5824	4	10	18	0	5856
21071	5900	4	11	10	0	5925
21072	94	9	8	5849	0	5960
21073	32	7	5827	68	0	5934
21074	40	6	55	5892	0	5993
21075	30	7	13	5977	0	6027
21076	5918	4	9	82	0	6013
21077	85	5787	4	24	0	5900
21078	5877	62	7	24	0	5970
21079	5954	15	4	24	0	5997
21080	6128	10	7	24	0	6169
21081	6167	4	11	25	0	6207
21082	103	4	5997	24	0	6128
21083	6053	9	61	23	0	6146
21084	6141	12	21	23	0	6197
21085	5340	22	13	44	0	5419
21086	6140	8	7	16	0	6171
21087	120	9	6	5917	0	6052
21088	66	3	5826	68	0	5963
21089	5813	1	69	26	0	5909
21090	94	5858	20	24	0	5996
21091	57	62	18	5790	0	5927
21092	31	5945	12	75	0	6063
21093	37	62	10	6052	0	6161
21094	6116	19	3	79	0	6217
21095	6135	19	16	40	0	6210
21096	6149	13	10	25	0	6197
21097	110	14	5853	15	0	5992
21098	5916	11	58	21	0	6006
21099	100	17	5844	11	0	5972
21100	43	12	5835	22	0	5912
21101	43	9	6052	21	0	6125
21102	51	14	78	5749	0	5892
21103	41	8	29	5903	0	5981
21104	46	7	19	5897	0	5969
21105	39	7	18	5881	0	5945
21106	42	7	25	5659	0	5733
21107	36	9	21	5843	0	5909
21108	27	5875	24	86	0	6012
21109	5818	65	17	52	0	5952
21110	77	5904	12	32	0	6025
21111	37	68	10	5962	0	6077
21112	32	21	8	6047	0	6108
21113	5946	11	7	108	0	6072
21114	78	5926	15	51	0	6070
21115	5968	65	13	40	0	6086
21116	96	33	7	5961	0	6097
21117	49	19	10	6005	0	6083
21118	36	25	15	6012	0	6088
21119	33	19	5919	108	0	6079
21120	42	11	61	5943	0	6057
21121	40	13	5834	90	0	5977
21122	40	12	5752	49	0	5853
21123	38	12	6079	43	0	6172
21124	32	10	85	6151	0	6278
21125	37	14	39	6261	0	6351
21126	30	10	26	6333	0	6399
21127	6313	13	25	118	0	6469
21128	100	17	20	6439	0	6576
21129	6486	13	22	120	0	6641
21130	114	6500	22	56	0	6692
21131	6768	76	18	46	0	6908
21132	6986	27	16	53	0	7082
21133	135	7120	13	41	0	7309
21134	7133	85	13	56	0	7287
21135	7175	28	10	53	0	7266
21136	7287	17	15	47	0	7366
21137	7290	14	18	40	0	7362
21138	146	18	7120	39	0	7323
21139	77	7023	86	29	0	7215
21140	66	97	33	6940	0	7136
21141	6989	27	23	102	0	7141
21142	131	23	6939	40	0	7133
21143	62	6784	90	41	0	6977
21144	62	76	28	6550	0	6716
21145	56	6769	21	88	0	6934
21146	58	93	15	6786	0	6952
21147	59	35	19	6859	0	6972
21148	47	25	6815	113	0	7000
21149	51	30	6708	43	0	6832
21150	6499	18	97	45	0	6659
21151	103	26	6654	31	0	6814
21152	54	23	6616	29	0	6722
21153	43	28	101	6541	0	6713
21154	46	18	37	6511	0	6612
21155	41	6475	22	113	0	6651
21156	33	6859	34	55	0	6981
21157	36	87	6799	32	0	6954
21158	47	92	113	6681	0	6933
21159	30	20	6418	81	0	6549
21160	16	10	5839	28	0	5893
21161	9	5787	76	17	0	5889
21162	33	58	38	5589	0	5718
21163	5612	17	20	63	0	5712
21164	57	9	10	5636	0	5712
21165	5656	6	14	62	0	5738
21166	5671	7	6	30	0	5714
21167	5657	4	13	15	0	5689
21168	75	5	5571	11	0	5662
21169	5580	5	52	13	0	5650
21170	67	3	21	5653	0	5744
21171	5680	5	13	57	0	5755
21172	5679	7	11	29	0	5726
21173	73	5615	9	13	0	5710
21174	5607	53	5	20	0	5685
21175	64	20	5627	6	0	5717
21176	5526	9	46	15	0	5596
21177	5575	8	16	16	0	5615
21178	61	5570	15	9	0	5655
21179	5580	48	13	7	0	5648
21180	64	17	11	5387	0	5479
21181	32	10	6	5335	0	5383
21182	24	5294	9	57	0	5384
21183	21	48	6	5347	0	5422
21184	21	18	4	5410	0	5453
21185	17	9	5333	64	0	5423
21186	18	10	5248	30	0	5306
21187	5196	8	59	19	0	5282
21188	5360	8	23	21	0	5412
21189	69	6	18	5385	0	5478
21190	27	8	5358	55	0	5448
21191	21	5345	56	21	0	5443
21192	28	52	18	5329	0	5427
21193	19	14	5411	63	0	5507
21194	5297	13	56	34	0	5400
21195	61	10	20	5545	0	5636
21196	25	5666	12	63	0	5766
21197	27	63	7	5705	0	5802
21198	26	18	11	5802	0	5857
21199	25	13	10	5840	0	5888
21200	5675	10	8	85	0	5778
21201	75	8	8	5612	0	5703
21202	5673	6	9	83	0	5771
21203	5739	8	10	42	0	5799
21204	93	10	5657	20	0	5780
21205	43	5707	65	20	0	5835
21206	44	67	24	5416	0	5551
21207	28	5973	16	58	0	6075
21208	6117	76	18	26	0	6237
21209	86	35	16	6098	0	6235
21210	39	23	6082	79	0	6223
21211	25	14	5989	41	0	6069
21212	23	13	6023	31	0	6090
21213	6014	8	98	32	0	6152
21214	85	6072	42	26	0	6225
21215	6092	82	18	24	0	6216
21216	88	6136	21	25	0	6270
21217	53	81	18	6124	0	6276
21218	37	31	17	6103	0	6188
21219	32	6155	12	100	0	6299
21220	25	80	6149	45	0	6299
21221	23	6220	77	27	0	6347
21222	6050	81	30	27	0	6188
21223	92	34	17	5812	0	5955
21224	32	20	5695	77	0	5824
21225	26	23	5682	37	0	5768
21226	26	24	90	5658	0	5798
21227	16	15	5570	77	0	5678
21228	17	10	5345	37	0	5409
21229	5132	10	89	29	0	5260
21230	58	5175	32	23	0	5288
21231	4976	51	23	26	0	5076
21232	59	25	4909	23	0	5016
21233	34	4645	58	13	0	4750
21234	21	4692	33	18	0	4764
21235	49	84	40	4619	0	4792
21236	23	30	12	4686	0	4751
21237	18	19	10	4737	0	4784
21238	9	23	4677	84	0	4793
21239	18	13	58	4713	0	4802
21240	10	10	25	4795	0	4840
21241	4770	6	17	88	0	4881
21242	62	4721	15	44	0	4842
21243	31	56	14	4840	0	4941
21244	4831	28	9	79	0	4947
21245	4793	16	10	41	0	4860
21246	85	8	13	4774	0	4880
21247	39	11	4785	66	0	4901
21248	31	10	58	4803	0	4902
21249	16	12	4813	78	0	4919
21250	4962	10	62	45	0	5079
21251	5342	6	29	31	0	5408
21252	98	26	22	5415	0	5561
21253	38	14	5464	82	0	5598
21254	23	5633	79	46	0	5781
21255	20	81	5712	24	0	5837
21256	27	70	95	5165	0	5357
21257	12	5359	31	82	0	5484
21258	5229	77	16	24	0	5346
21259	82	23	9	5128	0	5242
21260	23	5182	13	78	0	5296
21261	5264	80	8	31	0	5383
21262	87	28	6	5214	0	5335
21263	27	5268	12	79	0	5386
21264	28	76	12	5280	0	5396
21265	13	29	5232	86	0	5360
21266	5096	15	81	34	0	5226
21267	5182	11	26	28	0	5247
21268	95	14	5112	15	0	5236
21269	34	5078	82	14	0	5208
21270	5134	75	25	23	0	5257
21271	83	26	16	5100	0	5225
21272	45	16	12	5061	0	5134
21273	23	13	12	5173	0	5221
21274	24	14	12	5192	0	5242
21275	18	7	8	5175	0	5208
21276	5091	10	12	108	0	5221
21277	5164	8	11	40	0	5223
21278	99	10	9	5118	0	5236
21279	38	8	5	5162	0	5213
21280	21	8	5057	113	0	5199
21281	17	7	5059	39	0	5122
21282	4998	11	91	35	0	5135
21283	97	4	30	5048	0	5179
21284	32	3	4993	94	0	5122
21285	24	10	88	5023	0	5145
21286	5072	11	32	95	0	5210
21287	5172	11	19	35	0	5237
21288	107	6	13	5124	0	5250
21289	40	6	14	5165	0	5225
21290	5205	9	13	108	0	5335
21291	94	7	13	5163	0	5277
21292	31	5179	14	108	0	5332
21293	31	76	11	5142	0	5260
21294	31	23	8	5137	0	5199
21295	25	13	4990	104	0	5132
21296	18	12	4796	55	0	4881
21297	16	4938	77	34	0	5065
21298	4852	75	38	27	0	4992
21299	4809	25	16	25	0	4875
21300	4826	9	14	27	0	4876
21301	98	4686	16	23	0	4823
21302	29	4783	20	21	0	4853
21303	4696	78	15	17	0	4806
21304	80	4785	12	16	0	4893
21305	35	77	4657	16	0	4785
21306	24	4665	79	18	0	4786
21307	19	75	4485	18	0	4597
21308	4312	18	72	14	0	4416
21309	4440	18	15	15	0	4488
21310	75	4439	11	24	0	4549
21311	4614	72	7	20	0	4713
21312	4964	15	14	23	0	5016
21313	5037	13	9	19	0	5078
21314	115	12	9	4996	0	5132
21315	5053	13	6	89	0	5161
21316	102	11	4886	39	0	5038
21317	4957	8	75	25	0	5065
21318	112	6	27	5029	0	5174
21319	40	14	4948	89	0	5091
21320	46	8	4970	34	0	5058
21321	31	10	100	5027	0	5168
21322	33	9	35	5126	0	5203
21323	5119	10	22	119	0	5270
21324	91	10	18	5128	0	5247
21325	47	6	5084	100	0	5237
21326	45	6	76	5013	0	5140
21327	16	5191	33	105	0	5345
21328	5306	78	24	46	0	5454
21329	88	28	14	5338	0	5468
21330	50	18	5282	91	0	5441
21331	30	5235	75	56	0	5396
21332	5182	78	36	33	0	5329
21333	95	29	23	5302	0	5449
21334	44	16	5315	91	0	5466
21335	28	5245	79	53	0	5405
21336	5277	85	34	32	0	5428
21337	5269	29	26	20	0	5344
21338	5315	15	15	25	0	5370
21339	122	7	15	5178	0	5322
21340	48	16	9	5236	0	5309
21341	5143	5	11	109	0	5268
21342	83	5069	12	57	0	5221
21343	5101	66	14	31	0	5212
21344	91	28	2	5081	0	5202
21345	5200	16	4	89	0	5309
21346	101	7	4	5191	0	5303
21347	42	8	11	5188	0	5249
21348	37	11	7	5218	0	5273
21349	38	10	4	5209	0	5261
21350	31	5	4827	107	0	4970
21351	18	9	4385	55	0	4467
21352	4082	5	62	41	0	4190
21353	52	7	4299	23	0	4381
21354	35	3	3924	11	0	3973
21355	3875	3	63	16	0	3957
21356	3954	3	45	22	0	4024
21357	62	6	17	4242	0	4327
21358	4289	0	8	48	0	4345
21359	48	4337	15	26	0	4426
21360	4447	34	7	26	0	4514
21361	4414	21	4	21	0	4460
21362	4609	13	7	15	0	4644
21363	73	3	6	4570	0	4652
21364	38	4463	7	39	0	4547
21365	28	4557	7	27	0	4619
21366	4601	44	8	21	0	4674
21367	4634	25	8	14	0	4681
21368	55	17	6	4595	0	4673
21369	39	10	8	4573	0	4630
21370	24	4532	6	51	0	4613
21371	4548	32	4	36	0	4620
21372	45	21	4563	22	0	4651
21373	33	16	28	4515	0	4592
21374	23	8	17	4611	0	4659
21375	17	5	4636	51	0	4709
21376	12	9	33	4589	0	4643
21377	23	3381	31	58	0	3493
21378	11	35	13	4687	0	4746
21379	11	23	8	4658	0	4700
21380	18	4226	9	53	0	4306
21381	8	4625	3	43	0	4679
21382	9	47	2	4668	0	4726
21383	4671	28	3	47	0	4749
21384	36	18	9	4693	0	4756
21385	26	9	10	4710	0	4755
21386	23	4722	4	53	0	4802
21387	10	30	7	4907	0	4954
21388	14	18	9	4856	0	4897
21389	8	16	4	4865	0	4893
21390	4747	8	4	65	0	4824
21391	37	5	2	4760	0	4804
21392	29	5	4	4719	0	4757
21393	18	8	3	4719	0	4748
21394	8	9	4556	65	0	4638
21395	4156	5	25	48	0	4234
21396	35	4494	18	29	0	4576
21397	4541	22	10	21	0	4594
21398	39	20	3	4530	0	4592
21399	23	18	4443	33	0	4517
21400	4160	6	27	38	0	4231
21401	33	7	5068	23	0	5131
21402	33	8	32	5083	0	5156
21403	5295	2	24	40	0	5361
21404	5215	5	14	31	0	5265
21405	5343	6	4	33	0	5386
21406	55	4	7	5362	0	5428
21407	36	5	4	5427	0	5472
21408	26	13	3	5425	0	5467
21409	12	5094	5	57	0	5168
21410	10	5043	4	37	0	5094
21411	3	4939	2	26	0	4970
21412	2	4693	2	5	0	4702
21413	9	8	3	4871	0	4891
21414	4	3	0	4884	0	4891
21415	4844	2	1	9	0	4856
21416	4793	2	0	11	0	4806
21417	4860	0	0	10	0	4870
21418	7	0	1	4828	0	4836
21419	7	0	2	4885	0	4894
21420	4778	0	2	14	0	4794
21421	4697	2	3	12	0	4714
21422	13	1	4588	2	0	4604
21423	13	5	4332	9	0	4359
21424	4	2	4493	7	0	4506
21425	3	3	4813	2	0	4821
21426	4	1	9	4802	0	4816
21427	4778	0	3	14	0	4795
21428	7	4703	2	4	0	4716
21429	6	6	0	4842	0	4854
21430	3	6	4863	7	0	4879
21431	1	5036	8	8	0	5053
21432	1	7	2	5167	0	5177
21433	2	5	5094	7	0	5108
21434	4	4	5	5006	0	5019
21435	3	0	1	5095	0	5099
21436	5162	0	1	16	0	5179
21437	8	0	0	5198	0	5206
21438	3	2	5222	8	0	5235
21439	3	0	6	5198	0	5207
21440	0	5484	6	14	0	5504
21441	4	8	2	5760	0	5774
21442	5	2	0	5794	0	5801
21443	4	3	1	5746	0	5754
21444	5833	1	0	26	0	5860
21445	5783	0	2	12	0	5797
21446	5815	0	2	10	0	5827
21447	5825	1	1	10	0	5837
21448	14	4	5744	2	0	5764
21449	5623	0	8	11	0	5642
21450	5811	0	2	9	0	5822
21451	13	3	5692	2	0	5710
21452	6	2	5852	3	0	5863
21453	7	6	7	5913	0	5933
21454	0	5936	5	10	0	5951
21455	6073	6	2	16	0	6097
21456	6176	4	0	8	0	6188
21457	6005	2	2	9	0	6018
21458	13	5	0	5960	0	5978
21459	4	6015	1	8	0	6028
21460	6216	5	1	15	0	6237
21461	6293	3	0	9	0	6305
21462	12	2	0	6140	0	6154
21463	10	3	6046	7	0	6066
21464	6060	0	6	10	0	6076
21465	11	1	3	6290	0	6305
21466	6394	0	2	13	0	6409
21467	9	0	2	6451	0	6462
21468	10	1	6400	6	0	6417
21469	6657	1	7	23	0	6688
21470	8	1	4	6802	0	6815
21471	6	0	2	6824	0	6832
21472	5	2	0	6835	0	6842
21473	4	0	0	6783	0	6787
21474	6871	1	0	14	0	6886
21475	6	2	1	6832	0	6841
21476	7	6750	4	8	0	6769
21477	4	7	0	6909	0	6920
21478	1	6889	1	14	0	6905
21479	1	12	2	6990	0	7005
21480	4	6	0	7009	0	7019
21481	0	6953	1	17	0	6971
21482	5	8	0	7058	0	7071
21483	2	5	0	7024	0	7031
21484	7022	1	3	18	0	7044
21485	12	1	7113	7	0	7133
21486	7	1	10	7120	0	7138
21487	7196	0	7	29	0	7232
21488	7169	1	1	22	0	7193
21489	7237	0	1	16	0	7254
21490	34	5	7240	4	0	7283
21491	16	3	7300	4	0	7323
21492	15	3	34	7544	0	7596
21493	7685	0	9	37	0	7731
21494	27	1	7575	9	0	7612
21495	7405	3	27	16	0	7451
21496	29	7650	14	6	0	7699
21497	14	23	5	8029	0	8071
21498	12	8	4	8185	0	8209
21499	8274	5	2	51	0	8332
21500	32	1	1	8340	0	8374
21501	7858	2	2	31	0	7893
21502	7901	1	1	24	0	7927
21503	38	5	3	7827	0	7873
21504	20	0	2	7862	0	7884
21505	7822	2	2	49	0	7875
21506	33	2	8068	15	0	8118
21507	7994	1	29	25	0	8049
21508	43	4	8316	5	0	8368
21509	8420	1	27	21	0	8469
21510	8815	1	10	21	0	8847
21511	8694	1	6	23	0	8724
21512	8621	1	2	19	0	8643
21513	39	8601	7	13	0	8660
21514	8802	23	4	21	0	8850
21515	8839	9	6	15	0	8869
21516	41	9209	3	9	0	9262
21517	9300	27	4	16	0	9347
21518	40	7	9169	7	0	9223
21519	9306	4	27	18	0	9355
21520	48	11	9461	0	0	9520
21521	26	2	38	9545	0	9611
21522	18	4	12	9697	0	9731
21523	20	4	9708	50	0	9782
21524	15	1	45	9772	0	9833
21525	118	22	105	6693	0	6938
21526	10415	2	6	91	0	10514
21527	70	4	8	10500	0	10582
21528	34	3	8	10525	0	10570
21529	18	5	4	10544	0	10571
21530	6	10325	11	94	0	10436
21531	19	55	3	10327	0	10404
21532	10346	16	7	97	0	10466
21533	85	10	10591	27	0	10713
21534	39	4	78	10866	0	10987
21535	23	6	10867	89	0	10985
21536	10901	3	86	53	0	11043
21537	95	10	24	11597	0	11726
21538	43	11	14434	123	0	14611
21539	43	3	235	14622	0	14903
21540	33	9	201	14473	0	14716
21541	21	14514	135	435	0	15105
21542	42	239	70	15108	0	15459
21543	43	179	21	16037	0	16280
21544	33	156	15664	549	0	16402
21545	52	59	287	15935	0	16333
21546	33	30	209	16151	0	16423
21547	15624	15	147	613	0	16399
21548	15610	12	81	437	0	16140
21549	457	15627	51	269	0	16404
21550	15990	283	31	179	0	16483
21551	16033	206	47	133	0	16419
21552	569	16098	51	131	0	16849
21553	409	357	43	16101	0	16910
21554	16306	240	31	405	0	16982
21555	16397	167	35	317	0	16916
21556	16088	99	28	257	0	16472
21557	698	15865	49	155	0	16767
21558	485	333	16166	122	0	17106
21559	16635	236	300	138	0	17309
21560	16736	185	195	139	0	17255
21561	640	16610	163	112	0	17525
21562	16894	379	73	136	0	17482
21563	17205	260	57	117	0	17639
21564	762	202	46	16744	0	17754
21565	502	130	16688	427	0	17747
21566	371	96	356	17058	0	17881
21567	271	51	241	17232	0	17795
21568	224	69	172	17446	0	17911
21569	182	85	16623	772	0	17662
21570	221	53	391	16610	0	17275
21571	178	67	248	17097	0	17590
21572	162	44	198	17271	0	17675
21573	182	36	104	17399	0	17721
21574	143	66	78	17406	0	17693
21575	119	16851	67	959	0	17996
21576	145	376	61	17460	0	18042
21577	133	236	76	17910	0	18355
21578	94	180	17236	812	0	18322
21579	138	94	388	18524	0	19144
21580	119	85	242	18842	0	19288
21581	128	54	186	19249	0	19617
21582	130	54	138	19558	0	19880
21583	18714	73	84	1109	0	19980
21584	479	73	70	19418	0	20040
21585	364	64	57	19450	0	19935
21586	280	61	18322	974	0	19637
21587	177	17529	420	741	0	18867
21588	112	18579	320	537	0	19548
21589	18193	564	231	453	0	19441
21590	453	18411	142	384	0	19390
21591	356	567	93	18230	0	19246
21592	18118	379	65	709	0	19271
21593	521	253	18028	573	0	19375
21594	387	158	418	18216	0	19179
21595	271	18094	314	717	0	19396
21596	209	464	221	18188	0	19082
21597	140	18264	132	788	0	19324
21598	162	603	82	18527	0	19374
21599	18098	384	65	839	0	19386
21600	538	300	18195	547	0	19580
21601	417	184	451	17853	0	18905
21602	319	18189	326	668	0	19502
21603	18222	480	245	532	0	19479
21604	546	378	18018	439	0	19381
21605	406	308	471	18039	0	19224
21606	368	174	17636	669	0	18847
21607	271	170	611	17703	0	18755
21608	196	113	17421	821	0	18551
21609	182	135	666	17296	0	18279
21610	157	135	405	17556	0	18253
21611	16866	108	283	965	0	18222
21612	17259	150	196	652	0	18257
21613	792	116	169	16825	0	17902
21614	560	16623	126	728	0	18037
21615	402	489	121	17051	0	18063
21616	259	327	124	17028	0	17738
21617	16103	239	134	1014	0	17490
21618	523	16157	130	791	0	17601
21619	16102	509	110	570	0	17291
21620	16153	330	101	452	0	17036
21621	785	15320	120	390	0	16615
21622	553	16049	87	414	0	17103
21623	15747	623	123	441	0	16934
21624	615	427	15284	465	0	16791
21625	15249	305	463	415	0	16432
21626	15272	187	313	389	0	16161
21627	852	14728	249	378	0	16207
21628	636	491	175	13707	0	15009
21629	440	14852	146	647	0	16085
21630	14745	639	155	495	0	16034
21631	15050	465	146	393	0	16054
21632	781	355	111	14618	0	15865
21633	629	277	113	14622	0	15641
21634	13952	228	78	854	0	15112
21635	640	13625	85	731	0	15081
21636	522	13211	103	548	0	14384
21637	393	13099	112	407	0	14011
21638	154	9643	61	248	0	10106
21639	153	9822	65	217	0	10257
21640	214	459	111	9373	0	10157
21641	135	213	9068	374	0	9790
21642	135	9024	190	250	0	9599
21643	8228	250	107	173	0	8758
21644	271	154	110	8081	0	8616
21645	8079	126	58	267	0	8530
21646	255	8030	81	165	0	8531
21647	8061	216	75	156	0	8508
21648	264	8057	114	121	0	8556
21649	186	233	86	8092	0	8597
21650	8144	116	102	261	0	8623
21651	8244	109	87	216	0	8656
21652	273	87	80	8204	0	8644
21653	181	94	64	8226	0	8565
21654	155	8030	46	337	0	8568
21655	180	211	33	8124	0	8548
21656	163	126	36	8198	0	8523
21657	160	156	26	8044	0	8386
21658	109	7614	38	355	0	8116
21659	6987	173	21	233	0	7414
21660	192	7058	27	170	0	7447
21661	6925	202	31	107	0	7265
21662	224	6878	35	114	0	7251
21663	211	209	6632	84	0	7136
21664	177	153	137	6599	0	7066
21665	135	126	6470	159	0	6890
21666	128	115	6345	109	0	6697
21667	139	115	182	6274	0	6710
21668	128	68	6340	167	0	6703
21669	169	70	161	6226	0	6626
21670	142	72	97	6288	0	6599
21671	113	85	74	6383	0	6655
21672	6265	90	36	255	0	6646
21673	184	92	37	6258	0	6571
21674	163	76	21	6166	0	6426
21675	5812	62	13	230	0	6117
21676	189	5664	14	209	0	6076
21677	139	5250	11	171	0	5571
21678	150	5345	9	104	0	5608
21679	62	300	16	4218	0	4596
21680	48	60	4192	97	0	4397
21681	3752	58	66	55	0	3931
21682	62	3827	23	47	0	3959
21683	3679	71	26	27	0	3803
21684	3664	33	12	30	0	3739
21685	3662	37	16	23	0	3738
21686	82	34	3651	22	0	3789
21687	57	38	37	3662	0	3794
21688	46	30	19	3724	0	3819
21689	45	12	25	3783	0	3865
21690	41	21	13	3673	0	3748
21691	48	3545	12	72	0	3677
21692	3568	58	8	50	0	3684
21693	51	28	3327	42	0	3448
21694	3166	24	33	27	0	3250
21695	71	34	11	2997	0	3113
21696	29	2923	15	48	0	3015
21697	28	3020	2	35	0	3085
21698	41	148	6	2742	0	2937
21699	19	2754	9	36	0	2818
21700	2451	17	10	15	0	2493
21701	15	7	2406	16	0	2444
21702	12	9	9	2300	0	2330
21703	9	5	3	2357	0	2374
21704	6	9	3	2400	0	2418
21705	9	6	1	2394	0	2410
21706	2412	7	3	17	0	2439
21707	13	2509	7	7	0	2536
21708	2860	15	4	10	0	2889
21709	26	5	5	2939	0	2975
21710	11	5	3	3116	0	3135
21711	10	1334	4	1897	0	3245
21712	3324	14	4	34	0	3376
21713	3416	8	2	22	0	3448
21714	39	3397	7	9	0	3452
21715	18	29	4	3282	0	3333
21716	11	3359	3	40	0	3413
21717	3354	39	1	16	0	3410
21718	40	7	3368	13	0	3428
21719	8	11	3301	10	0	3330
21720	3269	8	30	5	0	3312
21721	36	3348	12	5	0	3401
21722	9	31	11	3365	0	3416
21723	15	6	3	3380	0	3404
21724	6	12	3375	39	0	3432
21725	9	9	31	3369	0	3418
21726	9	5	5	3421	0	3440
21727	8	3344	9	39	0	3400
21728	6	36	4	3361	0	3407
21729	6	6	7	3361	0	3380
21730	3291	11	4	44	0	3350
21731	37	3205	4	20	0	3266
21732	6	3255	9	14	0	3284
21733	14	30	5	3267	0	3316
21734	13	15	6	3295	0	3329
21735	4	17	6	3284	0	3311
21736	5	3245	3	55	0	3308
21737	9	36	3	3287	0	3335
21738	8	12	4	3283	0	3307
21739	9	10	2	3291	0	3312
21740	4	9	5	3271	0	3289
21741	9	3138	4	62	0	3213
21742	8	3282	3	27	0	3320
21743	3219	43	1	24	0	3287
21744	3236	14	3	24	0	3277
21745	45	17	2	3224	0	3288
21746	15	7	3227	47	0	3296
21747	17	11	34	3242	0	3304
21748	12	9	6	3235	0	3262
21749	3160	11	8	53	0	3232
21750	40	3213	7	28	0	3288
21751	18	32	4	3216	0	3270
21752	14	12	6	3248	0	3280
21753	11	15	3166	57	0	3249
21754	10	10	3177	32	0	3229
21755	6	11	41	3170	0	3228
21756	9	9	17	3159	0	3194
21757	9	3131	14	50	0	3204
21758	8	3197	6	33	0	3244
21759	3160	37	11	32	0	3240
21760	43	17	11	3226	0	3297
21761	11	14	3230	59	0	3314
21762	16	3208	33	27	0	3284
21763	14	46	13	3253	0	3326
21764	3259	20	13	58	0	3350
21765	45	14	6	3287	0	3352
21766	3230	6	6	72	0	3314
21767	46	3273	11	24	0	3354
21768	3210	45	6	30	0	3291
21769	51	15	5	3298	0	3369
21770	14	18	3445	61	0	3538
21771	22	14	43	3422	0	3501
21772	11	3542	9	62	0	3624
21773	11	46	13	3559	0	3629
21774	5	3687	10	70	0	3772
21775	10	62	13	3788	0	3873
21776	13	20	3692	81	0	3806
21777	10	19	3631	41	0	3701
21778	10	17	3689	36	0	3752
21779	3648	14	61	31	0	3754
21780	60	3653	23	26	0	3762
21781	21	3730	17	27	0	3795
21782	3651	62	14	19	0	3746
21783	3658	30	12	26	0	3726
21784	60	28	8	3653	0	3749
21785	35	10	3633	64	0	3742
21786	25	17	3565	25	0	3632
21787	15	12	61	3555	0	3643
21788	3535	11	25	72	0	3643
21789	52	3516	22	30	0	3620
21790	22	54	15	3555	0	3646
21791	3519	25	13	70	0	3627
21792	3526	18	15	31	0	3590
21793	61	20	3444	39	0	3564
21794	3429	15	56	30	0	3530
21795	73	18	3501	24	0	3616
21796	28	11	3590	31	0	3660
21797	27	8	68	3434	0	3537
21798	20	16	30	3506	0	3572
21799	17	14	25	3536	0	3592
21800	18	15	3433	81	0	3547
21801	3468	14	54	45	0	3581
21802	56	10	25	3575	0	3666
21803	3473	18	19	77	0	3587
21804	3477	10	12	41	0	3540
21805	78	3498	12	31	0	3619
21806	30	3545	14	32	0	3621
21807	31	3463	17	18	0	3529
21808	20	70	12	3055	0	3157
21809	17	22	3041	42	0	3122
21810	13	118	32	2743	0	2906
21811	7	2766	20	46	0	2839
21812	11	2686	14	19	0	2730
21813	15	38	16	2613	0	2682
21814	2571	14	6	38	0	2629
21815	32	2534	7	13	0	2586
21816	17	2549	3	12	0	2581
21817	2595	41	4	14	0	2654
21818	43	19	3	2594	0	2659
21819	15	11	7	2614	0	2647
21820	14	8	8	2633	0	2663
21821	2560	6	7	50	0	2623
21822	2579	5	9	26	0	2619
21823	45	7	3	2576	0	2631
21824	20	5	2506	40	0	2571
21825	2516	4	29	22	0	2571
21826	37	12	12	2545	0	2606
21827	19	5	2522	40	0	2586
21828	13	7	2506	18	0	2544
21829	14	6	36	2592	0	2648
21830	8	3	2717	41	0	2769
21831	14	6	38	2904	0	2962
21832	11	8	21	2854	0	2894
21833	11	10	10	3045	0	3076
21834	3027	8	7	62	0	3104
21835	46	10	7	3031	0	3094
21836	27	5	7	3078	0	3117
21837	21	9	6	3081	0	3117
21838	13	10	7	3082	0	3112
21839	7	8	2978	75	0	3068
21840	11	2981	43	36	0	3071
21841	9	47	17	2971	0	3044
21842	9	22	8	2953	0	2992
21843	9	2807	11	57	0	2884
21844	9	2971	10	33	0	3023
21845	2940	49	6	37	0	3032
21846	45	2890	9	29	0	2973
21847	24	47	10	2888	0	2969
21848	17	24	2909	52	0	3002
21849	2831	11	43	27	0	2912
21850	44	10	2819	23	0	2896
21851	2806	6	44	27	0	2883
21852	2826	5	21	23	0	2875
21853	62	6	2831	19	0	2918
21854	28	8	49	2719	0	2804
21855	20	2742	21	56	0	2839
21856	19	45	13	2920	0	2997
21857	2967	16	10	73	0	3066
21858	2994	8	14	35	0	3051
21859	63	2963	8	31	0	3065
21860	2939	48	6	37	0	3030
21861	59	14	7	2887	0	2967
21862	2879	7	7	66	0	2959
21863	2971	8	14	34	0	3027
21864	70	11	10	2943	0	3034
21865	2915	11	9	68	0	3003
21866	2879	11	5	46	0	2941
21867	64	12	2851	27	0	2954
21868	2805	10	43	25	0	2883
21869	59	8	2791	25	0	2883
21870	24	8	2567	12	0	2611
21871	20	2678	52	13	0	2763
21872	20	47	39	2518	0	2624
21873	14	12	2582	43	0	2651
21874	10	16	2519	19	0	2564
21875	2544	8	47	20	0	2619
21876	52	3	15	2571	0	2641
21877	17	7	13	2654	0	2691
21878	6	6	8	2680	0	2700
21879	15	9	6	2658	0	2688
21880	10	9	5	2669	0	2693
21881	11	8	2609	61	0	2689
21882	17	6	2588	24	0	2635
21883	12	11	43	2631	0	2697
21884	2619	4	18	47	0	2688
21885	48	2599	10	21	0	2678
21886	23	42	9	2588	0	2662
21887	2589	11	6	50	0	2656
21888	49	2609	6	25	0	2689
21889	27	42	7	2623	0	2699
21890	15	12	5	2661	0	2693
21891	12	3	15	2653	0	2683
21892	2611	6	11	56	0	2684
21893	42	5	2589	28	0	2664
21894	2598	0	45	20	0	2663
21895	45	10	16	2623	0	2694
21896	18	6	9	2550	0	2583
21897	12	2554	13	56	0	2635
21898	10	35	2520	25	0	2590
21899	2491	12	33	23	0	2559
21900	2572	4	11	28	0	2615
21901	46	7	2498	16	0	2567
21902	2404	6	37	22	0	2469
21903	48	2470	12	21	0	2551
21904	12	2536	9	23	0	2580
21905	10	2525	11	18	0	2564
21906	2444	37	17	11	0	2509
21907	41	17	2453	11	0	2522
21908	15	20	31	2364	0	2430
21909	9	2321	12	29	0	2371
21910	7	2342	6	19	0	2374
21911	12	2354	6	7	0	2379
21912	31	45	7	1838	0	1921
21913	2265	11	1	42	0	2319
21914	31	2288	3	12	0	2334
21915	8	27	4	2307	0	2346
21916	11	8	4	2330	0	2353
21917	2268	3	5	36	0	2312
21918	37	3	4	2273	0	2317
21919	15	3	4	2329	0	2351
21920	5	4	2300	39	0	2348
21921	10	6	24	2283	0	2323
21922	4	5	12	2361	0	2382
21923	2332	1	6	36	0	2375
21924	2331	2	2	13	0	2348
21925	34	4	8	2342	0	2388
21926	2262	2	4	34	0	2302
21927	2310	5	1	14	0	2330
21928	32	2285	2	12	0	2331
21929	12	28	2247	6	0	2293
21930	12	2156	26	2	0	2196
21931	15	57	19	1940	0	2031
21932	1895	6	7	14	0	1922
21933	14	1876	1	3	0	1894
21934	2	12	3	1873	0	1890
21935	1867	1	4	16	0	1888
21936	1863	1	1	4	0	1869
21937	13	4	0	1862	0	1879
21938	2	2	1915	16	0	1935
21939	2	0	10	1942	0	1954
21940	1	2	3	1986	0	1992
21941	29	1	1939	19	0	1988
21942	1	0	14	1958	0	1973
21943	2	0	3	1969	0	1974
21944	2060	0	2	19	0	2081
21945	12	0	2	2096	0	2110
21946	5	3	0	2109	0	2117
21947	2073	1	3	22	0	2099
21948	2040	1	0	7	0	2048
21949	2043	1	1	4	0	2049
21950	18	2	2024	2	0	2046
21951	5	2	13	1981	0	2001
21952	2	2042	2	15	0	2061
21953	3	16	1	2120	0	2140
21954	6	6	2177	14	0	2203
21955	6	7	13	2051	0	2077
21956	3	2	2093	13	0	2111
21957	1959	0	9	5	0	1973
21958	1997	1	3	0	0	2001
21959	9	0	1	2085	0	2095
21960	5	0	0	2063	0	2068
21961	3	1	2	2065	0	2071
21962	1	2136	1	11	0	2149
21963	2105	7	2	7	0	2121
21964	2138	3	0	2	0	2143
21965	13	1	0	2118	0	2132
21966	4	0	0	2110	0	2114
21967	3	2	0	2125	0	2130
21968	1	1	2	2132	0	2136
21969	3	2	2110	9	0	2124
21970	2	0	8	2104	0	2114
21971	2039	0	1	10	0	2050
21972	2026	2	0	6	0	2034
21973	10	1	0	1985	0	1996
21974	3	1	1931	8	0	1943
21975	1874	1	5	7	0	1887
21976	8	8	4	1933	0	1953
21977	3	1887	1	10	0	1901
21978	2	1961	1	2	0	1966
21979	2044	9	1	9	0	2063
21980	9	3	0	2091	0	2103
21981	5	0	1	2132	0	2138
21982	5	1	1	2219	0	2226
21983	6	0	0	2246	0	2252
21984	3	1	0	2332	0	2336
21985	0	2	2329	22	0	2353
21986	1	2	2280	5	0	2288
21987	0	0	2335	2	0	2337
21988	2	1	18	2322	0	2343
21989	1	0	2411	17	0	2429
21990	2	1	19	2406	0	2428
21991	3	1	8	2443	0	2455
21992	2	0	2	2550	0	2554
21993	2626	0	4	31	0	2661
21994	23	1	3	2650	0	2677
21995	8	0	3	2698	0	2709
21996	2682	0	3	36	0	2721
21997	22	2703	2	10	0	2737
21998	7	2791	1	13	0	2812
21999	2817	29	3	10	0	2859
22000	26	2915	3	6	0	2950
22001	2941	27	2	10	0	2980
22002	2988	7	0	10	0	3005
22003	3010	1	2	8	0	3021
22004	2926	3	0	9	0	2938
22005	2965	2	1	6	0	2974
22006	40	2950	2	4	0	2996
22007	2945	27	1	3	0	2976
22008	2988	8	3	7	0	3006
22009	38	3133	2	4	0	3177
22010	3399	27	0	4	0	3430
22011	3495	9	2	5	0	3511
22012	3726	6	4	8	0	3744
22013	3881	3	2	10	0	3896
22014	82	7	4057	2	0	4148
22015	32	7	65	4258	0	4362
22016	18	6	18	4367	0	4409
22017	17	7	4296	99	0	4419
22018	7	7	4236	31	0	4281
22019	4266	4	90	16	0	4376
22020	95	5	27	4359	0	4486
22021	30	6	4408	79	0	4523
22022	21	4	4365	27	0	4417
22023	4387	5	91	17	0	4500
22024	4496	6	29	8	0	4539
22025	4523	3	11	6	0	4543
22026	125	3	4511	4	0	4643
22027	47	6	78	4544	0	4675
22028	26	2	4608	80	0	4716
22029	4575	3	85	29	0	4692
22030	96	9	4705	14	0	4824
22031	45	3	89	4683	0	4820
22032	26	3	33	4721	0	4783
22033	20	4741	19	88	0	4868
22034	4815	76	14	40	0	4945
22035	100	20	4787	19	0	4926
22036	4798	15	93	18	0	4924
22037	107	4	4968	11	0	5090
22038	41	4	101	4865	0	5011
22039	32	4	32	4968	0	5036
22040	25	5	20	4977	0	5027
22041	4923	2	16	115	0	5056
22042	109	4	21	4833	0	4967
22043	47	5	13	4912	0	4977
22044	29	4756	17	118	0	4920
22045	23	85	16	4801	0	4925
22046	4745	22	20	109	0	4896
22047	110	9	4730	36	0	4885
22048	53	4	92	4715	0	4864
22049	27	8	4743	105	0	4883
22050	26	4643	104	48	0	4821
22051	26	80	4765	27	0	4898
22052	4679	29	112	30	0	4850
22053	4789	9	50	28	0	4876
22054	121	9	32	4648	0	4810
22055	4689	2	36	107	0	4834
22056	4750	8	33	46	0	4837
22057	138	5	24	4732	0	4899
22058	67	4	27	4792	0	4890
22059	38	6	4723	124	0	4891
22060	33	4656	92	60	0	4841
22061	4696	83	44	42	0	4865
22062	116	4597	27	29	0	4769
22063	55	87	38	4620	0	4800
22064	50	28	21	4672	0	4771
22065	31	13	36	4671	0	4751
22066	27	15	25	4682	0	4749
22067	31	12	4534	133	0	4710
22068	4420	15	107	61	0	4603
22069	4635	4	50	42	0	4731
22070	138	6	31	4545	0	4720
22071	4561	10	20	122	0	4713
22072	115	18	22	4583	0	4738
22073	56	6	4557	127	0	4746
22074	54	13	89	4500	0	4656
22075	38	4508	47	119	0	4712
22076	36	76	24	4510	0	4646
22077	25	4550	22	120	0	4717
22078	24	101	19	4425	0	4569
22079	31	4464	25	113	0	4633
22080	4366	89	23	61	0	4539
22081	100	35	4387	56	0	4578
22082	43	4205	92	49	0	4389
22083	36	4306	40	43	0	4425
22084	43	96	45	4208	0	4392
22085	41	36	28	4201	0	4306
22086	35	15	26	4210	0	4286
22087	43	9	21	4266	0	4339
22088	27	4153	28	128	0	4336
22089	34	74	26	4121	0	4255
22090	38	26	20	4141	0	4225
22091	4017	24	17	118	0	4176
22092	99	10	21	4019	0	4149
22093	39	15	3902	112	0	4068
22094	38	13	3819	56	0	3926
22095	3681	24	80	52	0	3837
22096	85	3774	38	48	0	3945
22097	43	3880	20	38	0	3981
22098	27	87	29	3829	0	3972
22099	27	33	13	3869	0	3942
22100	21	20	3699	105	0	3845
22101	3569	20	74	57	0	3720
22102	3723	10	28	42	0	3803
22103	103	13	3792	41	0	3949
22104	42	9	3700	43	0	3794
22105	3751	12	90	44	0	3897
22106	3991	8	32	34	0	4065
22107	3985	10	13	36	0	4044
22108	3936	11	16	46	0	4009
22109	97	3699	12	34	0	3842
22110	3414	59	10	23	0	3506
22111	65	16	3278	29	0	3388
22112	24	13	3013	18	0	3068
22113	20	14	3123	14	0	3171
22114	36	149	76	2621	0	2882
22115	2625	4	28	20	0	2677
22116	2635	4	2	9	0	2650
22117	14	3	3	2640	0	2660
22118	9	1	4	2533	0	2547
22119	4	3	2	2652	0	2661
22120	3	2761	2	20	0	2786
22121	2793	12	1	17	0	2823
22122	2818	5	3	9	0	2835
22123	2815	0	2	8	0	2825
22124	2811	2	1	5	0	2819
22125	2806	0	4	7	0	2817
22126	18	1	2	2706	0	2727
22127	5	2639	5	15	0	2664
22128	7	11	4	2534	0	2556
22129	7	5	0	2564	0	2576
22130	2521	1	0	9	0	2531
22131	7	4	2506	3	0	2520
22132	6	1	2424	6	0	2437
22133	1	2	2499	5	0	2507
22134	2629	0	7	5	0	2641
22135	2726	1	10	8	0	2745
22136	9	2	4	2821	0	2836
22137	5	0	3	2740	0	2748
22138	4	1	1	2813	0	2819
22139	1	1	2822	8	0	2832
22140	7	0	4	2792	0	2803
22141	4	0	2947	8	0	2959
22142	4	0	4	2946	0	2954
22143	2	1	4	2965	0	2972
22144	2	0	1	3025	0	3028
22145	3039	0	4	12	0	3055
22146	3057	1	1	10	0	3069
22147	5	1	3090	5	0	3101
22148	3053	0	2	10	0	3065
22149	3084	0	3	3	0	3090
22150	9	0	3	3085	0	3097
22151	3126	0	3	14	0	3143
22152	7	1	1	3215	0	3224
22153	7	1	2	3221	0	3231
22154	4	2	3189	14	0	3209
22155	3090	0	13	8	0	3111
22156	10	0	5	3209	0	3224
22157	8	1	3237	13	0	3259
22158	9	0	3341	10	0	3360
22159	12	0	8	3279	0	3299
22160	3	0	6	3317	0	3326
22161	3383	1	10	10	0	3404
22162	8	0	5	3404	0	3417
22163	7	2	0	3418	0	3427
22164	5	0	0	3475	0	3480
22165	7	0	3	3673	0	3683
22166	3805	0	2	23	0	3830
22167	3802	1	2	22	0	3827
22168	3936	0	2	18	0	3956
22169	4022	0	1	6	0	4029
22170	38	1	0	4104	0	4143
22171	4162	0	2	25	0	4189
22172	28	0	1	4168	0	4197
22173	4202	0	2	33	0	4237
22174	27	0	0	4206	0	4233
22175	22	0	3	4175	0	4200
22176	6	4160	3	60	0	4229
22177	8	22	1	4182	0	4213
22178	4164	11	0	41	0	4216
22179	4110	5	2	23	0	4140
22180	39	4	4139	8	0	4190
22181	21	4149	24	6	0	4200
22182	4164	23	12	13	0	4212
22183	32	4237	5	4	0	4278
22184	4237	28	5	13	0	4283
22185	31	4397	1	12	0	4441
22186	19	29	4442	10	0	4500
22187	10	4449	22	9	0	4490
22188	8	4490	18	8	0	4524
22189	7	38	8	4643	0	4696
22190	4733	20	8	33	0	4794
22191	32	10	3	4785	0	4830
22192	23	4	8	4811	0	4846
22193	4751	2	3	57	0	4813
22194	4855	2	3	34	0	4894
22195	50	6	3	4883	0	4942
22196	25	2	2	4887	0	4916
22197	18	3	2	4868	0	4891
22198	4779	3	1	61	0	4844
22199	32	4	4797	36	0	4869
22200	27	2	28	4792	0	4849
22201	17	2	4879	40	0	4938
22202	12	4816	35	25	0	4888
22203	12	30	4746	14	0	4802
22204	21	17	36	4689	0	4763
22205	9	10	4691	43	0	4753
22206	4544	6	38	25	0	4613
22207	38	7	19	4670	0	4734
22208	27	4748	11	49	0	4835
22209	13	30	4	4787	0	4834
22210	13	4748	4	46	0	4811
22211	10	4728	2	33	0	4773
22212	17	4765	2	19	0	4803
22213	12	43	5	4537	0	4597
22214	5	4617	6	47	0	4675
22215	4600	38	3	33	0	4674
22216	45	20	4507	13	0	4585
22217	29	12	4409	10	0	4460
22218	17	9	4582	13	0	4621
22219	10	5	52	4630	0	4697
22220	20	10	22	4457	0	4509
22221	8	9	12	4422	0	4451
22222	12	11	5	4449	0	4477
22223	15	8	3	4361	0	4387
22224	13	4502	7	63	0	4585
22225	17	42	4499	24	0	4582
22226	9	19	4423	22	0	4473
22227	15	4599	46	13	0	4673
22228	17	37	21	4666	0	4741
22229	12	21	9	4708	0	4750
22230	13	18	5	4697	0	4733
22231	4618	5	2	81	0	4706
22232	47	10	4525	32	0	4614
22233	4462	6	33	26	0	4527
22234	4510	7	17	23	0	4557
22235	51	4397	11	12	0	4471
22236	29	4403	8	17	0	4457
22237	4424	52	17	19	0	4512
22238	46	22	5	4468	0	4541
22239	27	14	12	4616	0	4669
22240	19	11	4747	59	0	4836
22241	21	12	4686	31	0	4750
22242	12	14	57	4836	0	4919
22243	4906	9	32	62	0	5009
22244	51	15	5178	26	0	5270
22245	5299	12	61	23	0	5395
22246	68	13	21	5476	0	5578
22247	34	12	10	5737	0	5793
22248	22	10	10	5893	0	5935
22249	12	13	5869	94	0	5988
22250	12	5698	64	41	0	5815
22251	10	6031	29	31	0	6101
22252	6000	84	10	26	0	6120
22253	6144	29	10	22	0	6205
22254	91	15	9	6155	0	6270
22255	6188	9	13	85	0	6295
22256	83	13	6102	33	0	6231
22257	38	9	6065	18	0	6130
22258	16	6	93	6103	0	6218
22259	6221	6	35	100	0	6362
22260	88	6	17	6353	0	6464
22261	42	8	11	6543	0	6604
22262	6476	5	21	108	0	6610
22263	6584	6	16	59	0	6665
22264	97	6822	18	28	0	6965
22265	6713	80	9	24	0	6826
22266	97	40	10	6599	0	6746
22267	29	6637	12	102	0	6780
22268	6586	80	14	35	0	6715
22269	96	6627	10	23	0	6756
22270	34	88	9	6562	0	6693
22271	6558	19	7	91	0	6675
22272	90	12	6453	30	0	6585
22273	40	11	6412	14	0	6477
22274	29	24	90	6372	0	6515
22275	22	13	22	6503	0	6560
22276	23	5	9	6393	0	6430
22277	18	6541	13	90	0	6662
22278	6711	89	4	39	0	6843
22279	6763	22	10	30	0	6825
22280	6782	16	7	23	0	6828
22281	116	7061	7	18	0	7202
22282	45	96	7	7473	0	7621
22283	31	31	6	7564	0	7632
22284	28	15	10	7596	0	7649
22285	7235	12	9	165	0	7421
22286	113	7214	12	49	0	7388
22287	55	112	5	7226	0	7398
22288	31	33	4	7334	0	7402
22289	20	17	7088	155	0	7280
22290	28	7025	102	50	0	7205
22291	27	125	36	6976	0	7164
22292	36	36	15	7076	0	7163
22293	28	17	7	7094	0	7146
22294	6848	17	9	166	0	7040
22295	121	6815	10	74	0	7020
22296	6874	118	10	58	0	7060
22297	142	33	7	6873	0	7055
22298	6903	18	3	148	0	7072
22299	138	27	6781	55	0	7001
22300	6804	23	113	57	0	6997
22301	6908	13	30	49	0	7000
22302	152	21	6855	37	0	7065
22303	53	24	114	6906	0	7097
22304	51	22	29	6860	0	6962
22305	7049	23	16	172	0	7260
22306	142	11	12	7136	0	7301
22307	57	13	15	7149	0	7234
22308	44	20	22	7157	0	7243
22309	33	18	6963	177	0	7191
22310	6790	14	111	88	0	7003
22311	140	7034	40	55	0	7269
22312	59	122	26	6933	0	7140
22313	54	6915	15	134	0	7118
22314	46	7180	15	51	0	7292
22315	36	140	19	7186	0	7381
22316	27	45	7141	160	0	7373
22317	43	28	7187	68	0	7326
22318	40	25	135	7189	0	7389
22319	37	22	7184	170	0	7413
22320	7186	15	135	81	0	7417
22321	136	21	46	7348	0	7551
22322	65	10	26	7401	0	7502
22323	38	7366	18	178	0	7600
22324	42	127	23	7341	0	7533
22325	28	48	16	7355	0	7447
22326	23	7205	17	186	0	7431
22327	26	135	18	7297	0	7476
22328	39	45	19	7303	0	7406
22329	37	7181	23	174	0	7415
22330	7192	130	19	84	0	7425
22331	141	39	7147	61	0	7388
22332	47	31	7111	54	0	7243
22333	49	44	137	7081	0	7311
22334	34	30	44	7229	0	7337
22335	28	26	7075	176	0	7305
22336	27	29	6969	84	0	7109
22337	6677	25	143	74	0	6919
22338	136	6954	45	56	0	7191
22339	6857	130	26	60	0	7073
22340	143	39	6752	58	0	6992
22341	45	6746	132	54	0	6977
22342	37	163	48	6813	0	7061
22343	32	35	6902	169	0	7138
22344	29	27	6654	53	0	6763
22345	52	70	142	6686	0	6950
22346	27	21	6650	166	0	6864
22347	17	6432	136	63	0	6648
22348	32	123	58	6366	0	6579
22349	23	40	6393	143	0	6599
22350	23	6427	136	60	0	6646
22351	6339	134	44	46	0	6563
22352	132	38	6260	52	0	6482
22353	44	6230	124	40	0	6438
22354	45	141	50	6147	0	6383
22355	30	42	31	6373	0	6476
22356	6248	25	32	167	0	6472
22357	129	29	26	6233	0	6417
22358	49	10	24	6168	0	6251
22359	5940	15	34	169	0	6158
22360	134	23	24	5852	0	6033
22361	45	9	5613	159	0	5826
22362	32	19	120	5597	0	5768
22363	31	15	5463	135	0	5644
22364	25	12	5105	64	0	5206
22365	16	21	5206	40	0	5283
22366	32	25	135	4973	0	5165
22367	14	12	61	5122	0	5209
22368	5036	6	30	134	0	5206
22369	96	20	25	4924	0	5065
22370	44	5042	18	112	0	5216
22371	30	86	18	5219	0	5353
22372	19	34	21	5166	0	5240
22373	15	5184	16	133	0	5348
22374	5162	88	22	75	0	5347
22375	5101	38	27	35	0	5201
22376	115	5032	24	39	0	5210
22377	33	4936	20	26	0	5015
22378	25	240	27	4720	0	5012
22379	4834	34	33	94	0	4995
22380	90	21	4790	41	0	4942
22381	30	20	4293	27	0	4370
22382	3943	9	67	13	0	4032
22383	54	4071	29	16	0	4170
22384	24	52	16	4101	0	4193
22385	19	23	14	4052	0	4108
22386	16	10	6	4141	0	4173
22387	15	10	11	4145	0	4181
22388	4	4080	7	79	0	4170
22389	9	48	4	4170	0	4231
22390	4147	24	4	74	0	4249
22391	55	8	5	4215	0	4283
22392	24	7	7	4246	0	4284
22393	4234	4	5	89	0	4332
22394	4263	6	6	36	0	4311
22395	4299	7	5	22	0	4333
22396	4323	5	6	25	0	4359
22397	80	4	8	4276	0	4368
22398	4267	2	8	67	0	4344
22399	69	4	8	4233	0	4314
22400	4204	7	7	66	0	4284
22401	4194	7	5	42	0	4248
22402	81	3	6	4178	0	4268
22403	37	6	4190	66	0	4299
22404	4208	6	50	38	0	4302
22405	4247	5	22	26	0	4300
22406	4225	9	9	26	0	4269
22407	4217	4	9	23	0	4253
22408	90	3	8	4231	0	4332
22409	39	9	4222	60	0	4330
22410	21	10	4201	23	0	4255
22411	4221	9	60	29	0	4319
22412	4335	7	23	16	0	4381
22413	69	4249	15	14	0	4347
22414	29	4255	14	17	0	4315
22415	4326	56	7	15	0	4404
22416	57	25	9	4215	0	4306
22417	28	15	8	4328	0	4379
22418	4320	8	5	70	0	4403
22419	56	4366	6	32	0	4460
22420	4470	46	4	31	0	4551
22421	53	27	4413	23	0	4516
22422	4442	7	45	24	0	4518
22423	59	10	17	4462	0	4548
22424	28	6	4566	53	0	4653
22425	19	4588	49	31	0	4687
22426	19	42	22	4730	0	4813
22427	24	16	4926	57	0	5023
22428	11	8	56	4924	0	4999
22429	5024	10	23	74	0	5131
22430	64	7	4998	43	0	5112
22431	4893	5	58	31	0	4987
22432	63	5048	29	23	0	5163
22433	43	54	11	5115	0	5223
22434	24	24	5380	59	0	5487
22435	19	12	58	5390	0	5479
22436	18	12	5483	65	0	5578
22437	12	5390	64	39	0	5505
22438	5375	46	24	22	0	5467
22439	52	5497	17	22	0	5588
22440	31	54	10	5450	0	5545
22441	18	26	11	5434	0	5489
22442	14	11	5230	66	0	5321
22443	4547	12	48	41	0	4648
22444	52	4881	20	20	0	4973
22445	13	4607	8	13	0	4641
22446	6	4662	6	9	0	4683
22447	23	60	17	4524	0	4624
22448	7	4559	6	30	0	4602
22449	11	41	4	4473	0	4529
22450	4	4493	6	31	0	4534
22451	7	36	2	4419	0	4464
22452	2	4552	3	28	0	4585
22453	4574	24	3	16	0	4617
22454	23	11	4550	8	0	4592
22455	4417	8	21	17	0	4463
22456	4584	6	8	16	0	4614
22457	4671	4	8	13	0	4696
22458	28	4717	4	11	0	4760
22459	4774	22	1	6	0	4803
22460	4772	10	3	10	0	4795
22461	4869	7	2	8	0	4886
22462	33	5	4834	5	0	4877
22463	17	4	19	4950	0	4990
22464	10	4	5037	23	0	5074
22465	10	3	24	4989	0	5026
22466	5030	2	9	37	0	5078
22467	29	5021	7	13	0	5070
22468	15	33	5736	6	0	5790
22469	14	15	42	5823	0	5894
22470	10	6	15	6228	0	6259
22471	11	3	6765	72	0	6851
22472	6728	3	85	24	0	6840
22473	6957	4	20	16	0	6997
22474	7094	7	7	12	0	7120
22475	121	2	5	7049	0	7177
22476	35	6820	1	94	0	6950
22477	18	7198	5	33	0	7254
22478	13	114	7	7160	0	7294
22479	16	30	6	7141	0	7193
22480	12	7059	7	120	0	7198
22481	7091	91	7	37	0	7226
22482	95	7098	8	15	0	7216
22483	41	98	2	7010	0	7151
22484	12	32	6967	96	0	7107
22485	25	11	90	6915	0	7041
22486	6987	16	27	103	0	7133
22487	99	9	6978	32	0	7118
22488	6955	7	96	30	0	7088
22489	7156	5	32	31	0	7224
22490	7280	5	16	22	0	7323
22491	7291	8	10	19	0	7328
22492	7506	10	5	15	0	7536
22493	137	11	7264	16	0	7428
22494	49	8	7258	15	0	7330
22495	7751	8	119	22	0	7900
22496	8045	6	40	7	0	8098
22497	160	13	19	8178	0	8370
22498	69	8236	12	126	0	8443
22499	39	126	10	8373	0	8548
22500	8498	48	9	140	0	8695
22501	151	17	7	8316	0	8491
22502	60	8595	6	132	0	8793
22503	8576	128	9	67	0	8780
22504	8510	50	12	31	0	8603
22505	8535	16	4	28	0	8583
22506	191	8378	9	15	0	8593
22507	82	126	6	8403	0	8617
22508	34	50	8	8356	0	8448
22509	24	8017	5	167	0	8213
22510	34	130	5	8230	0	8399
22511	8143	40	5	161	0	8349
22512	8181	25	7	61	0	8274
22513	183	8045	11	29	0	8268
22514	84	130	7	8074	0	8295
22515	54	48	4	8179	0	8285
22516	37	23	10	8221	0	8291
22517	7942	19	10	205	0	8176
22518	155	14	7871	86	0	8126
22519	7652	18	130	49	0	7849
22520	171	42	7796	38	0	8047
22521	96	22	136	7580	0	7834
22522	60	7521	50	141	0	7772
22523	49	7866	14	83	0	8012
22524	7647	186	18	63	0	7914
22525	7675	71	7	53	0	7806
22526	191	7411	12	46	0	7660
22527	78	7408	13	44	0	7543
22528	7493	178	13	37	0	7721
22529	7661	69	15	35	0	7780
22530	205	7650	12	32	0	7899
22531	7851	152	11	43	0	8057
22532	186	71	7733	28	0	8018
22533	7828	40	136	42	0	8046
22534	7765	30	38	49	0	7882
22535	232	27	26	7553	0	7838
22536	96	7529	20	155	0	7800
22537	82	145	16	7536	0	7779
22538	7666	59	16	158	0	7899
22539	192	31	16	7490	0	7729
22540	104	22	15	7652	0	7793
22541	62	29	7573	209	0	7873
22542	64	27	144	7653	0	7888
22543	64	22	58	7817	0	7961
22544	7731	17	31	215	0	7994
22545	177	20	7701	93	0	7991
22546	7744	34	145	57	0	7980
22547	176	32	55	7770	0	8033
22548	101	32	22	7859	0	8014
22549	67	33	18	7799	0	7917
22550	54	7471	17	210	0	7752
22551	53	7672	18	94	0	7837
22552	67	180	17	7513	0	7777
22553	7514	68	13	176	0	7771
22554	7654	40	6	75	0	7775
22555	230	38	19	7494	0	7781
22556	7502	39	12	187	0	7740
22557	208	25	7	7448	0	7688
22558	99	26	13	7561	0	7699
22559	7184	25	13	240	0	7462
22560	175	7453	19	92	0	7739
22561	7432	159	12	65	0	7668
22562	7441	62	9	63	0	7575
22563	7329	29	10	72	0	7440
22564	227	7161	15	65	0	7468
22565	108	154	15	7184	0	7461
22566	75	61	16	7295	0	7447
22567	49	30	7028	224	0	7331
22568	49	73	126	6371	0	6619
22569	45	21	6053	179	0	6298
22570	44	5652	116	68	0	5880
22571	28	4932	52	42	0	5054
22572	30	5036	23	31	0	5120
22573	75	107	39	5085	0	5306
22574	34	35	17	5125	0	5211
22575	18	26	8	5117	0	5169
22576	19	26	6	5151	0	5202
22577	16	27	5073	126	0	5242
22578	39	15	5705	77	0	5836
22579	34	21	115	5964	0	6134
22580	31	18	6098	118	0	6265
22581	6118	18	101	79	0	6316
22582	6252	12	44	41	0	6349
22583	146	12	6187	40	0	6385
22584	66	10	97	6298	0	6471
22585	55	12	45	6404	0	6516
22586	43	16	19	6471	0	6549
22587	49	12	13	6427	0	6501
22588	52	8	13	6475	0	6548
22589	4749	59	20	201	0	5029
22590	6244	18	11	86	0	6359
22591	130	6179	13	60	0	6382
22592	60	90	5903	49	0	6102
22593	38	5830	92	42	0	6002
22594	25	5921	35	46	0	6027
22595	5528	95	20	34	0	5677
22596	78	5385	15	37	0	5515
22597	29	5136	8	26	0	5199
22598	5085	83	13	23	0	5204
22599	73	32	5032	16	0	5153
22600	4889	22	62	16	0	4989
22601	69	17	21	5047	0	5154
22602	40	7	11	4906	0	4964
22603	20	14	9	4971	0	5014
22604	18	10	4844	91	0	4963
22605	13	4858	59	44	0	4974
22606	4904	62	27	35	0	5028
22607	80	20	20	4999	0	5119
22608	22	4991	14	97	0	5124
22609	20	65	18	5163	0	5266
22610	33	24	5157	85	0	5299
22611	31	12	73	5199	0	5315
22612	21	14	30	5338	0	5403
22613	20	13	13	5403	0	5449
22614	5332	16	5	126	0	5479
22615	81	15	4	5399	0	5499
22616	29	6	5324	117	0	5476
22617	14	5285	80	59	0	5438
22618	24	71	30	5354	0	5479
22619	30	28	23	5403	0	5484
22620	24	27	5238	108	0	5397
22621	21	14	5083	41	0	5159
22622	5114	22	103	40	0	5279
22623	5104	18	43	46	0	5211
22624	103	5132	39	36	0	5310
22625	5108	74	23	50	0	5255
22626	97	36	5094	39	0	5266
22627	61	13	4970	40	0	5084
22628	5005	19	113	58	0	5195
22629	5000	16	35	59	0	5110
22630	100	10	4867	53	0	5030
22631	4727	16	75	57	0	4875
22632	90	14	4835	47	0	4986
22633	4786	12	92	25	0	4915
22634	4878	33	31	17	0	4959
22635	110	33	23	4750	0	4916
22636	49	5110	26	79	0	5264
22637	4117	106	33	52	0	4308
22638	59	47	5177	27	0	5310
22639	43	5209	82	19	0	5353
22640	5287	84	33	38	0	5442
22641	5123	34	21	45	0	5223
22642	98	5095	25	42	0	5260
22643	63	75	19	5146	0	5303
22644	45	23	5039	97	0	5204
22645	21	27	91	5090	0	5229
22646	28	44	5058	101	0	5231
22647	29	15	85	5063	0	5192
22648	30	23	43	5145	0	5241
22649	26	31	4992	107	0	5156
22650	26	4993	90	58	0	5167
22651	41	71	30	5001	0	5143
22652	41	44	3894	113	0	4092
22653	4990	29	47	62	0	5128
22654	80	21	23	5122	0	5246
22655	36	11	30	5182	0	5259
22656	5114	19	32	109	0	5274
22657	83	22	18	5117	0	5240
22658	54	24	24	5006	0	5108
22659	37	4999	30	103	0	5169
22660	48	62	28	4966	0	5104
22661	22	37	4885	110	0	5054
22662	40	22	72	4842	0	4976
22663	44	4799	29	97	0	4969
22664	18	4888	43	57	0	5006
22665	26	92	29	4921	0	5068
22666	4921	30	23	89	0	5063
22667	85	16	43	4922	0	5066
22668	4931	36	34	74	0	5075
22669	106	17	21	4959	0	5103
22670	4959	19	35	82	0	5095
22671	5066	30	31	44	0	5171
22672	111	19	24	5005	0	5159
22673	63	94	42	4860	0	5059
22674	49	4806	37	100	0	4992
22675	58	4904	37	44	0	5043
22676	47	65	4823	63	0	4998
22677	43	4761	57	45	0	4906
22678	3945	54	61	23	0	4083
22679	53	13	13	3991	0	4070
22680	20	3841	15	45	0	3921
22681	3937	35	15	22	0	4009
22682	43	16	12	3943	0	4014
22683	26	9	12	3876	0	3923
22684	21	12	13	3962	0	4008
22685	21	15	10	4036	0	4082
22686	16	4112	19	46	0	4193
22687	20	4338	14	21	0	4393
22688	4470	35	13	17	0	4535
22689	55	4537	8	17	0	4617
22690	22	51	8	4569	0	4650
22691	20	13	8	4594	0	4635
22692	19	10	11	4602	0	4642
22693	13	17	11	4621	0	4662
22694	4583	8	6	55	0	4652
22695	4665	8	6	19	0	4698
22696	60	9	4629	11	0	4709
22697	23	6	45	4686	0	4760
22698	21	5	4784	55	0	4865
22699	14	10	50	4796	0	4870
22700	14	11	15	4854	0	4894
22701	4868	10	11	79	0	4968
22702	64	10	7	4918	0	4999
22703	18	6	4951	65	0	5040
22704	11	7	4683	30	0	4731
22705	4894	11	54	25	0	4984
22706	58	10	4995	17	0	5080
22707	19	12	46	4859	0	4936
22708	11	4	5059	60	0	5134
22709	10	24	45	4959	0	5038
22710	5	5007	15	52	0	5079
22711	10	43	7	5036	0	5096
22712	6	4969	5	47	0	5027
22713	6	5050	5	21	0	5082
22714	10	52	6	5041	0	5109
22715	5019	19	7	50	0	5095
22716	43	5112	3	21	0	5179
22717	17	38	5	5163	0	5223
22718	5175	9	2	59	0	5245
22719	5252	7	7	19	0	5285
22720	5342	5	2	23	0	5372
22721	49	4	8	5315	0	5376
22722	17	6	3	5359	0	5385
22723	5398	10	3	61	0	5472
22724	5377	7	5	36	0	5425
22725	5488	6	6	25	0	5525
22726	69	9	4	5446	0	5528
22727	19	6	5293	48	0	5366
22728	5266	7	31	32	0	5336
22729	47	12	16	5257	0	5332
22730	24	5365	8	53	0	5450
22731	19	56	5	5349	0	5429
22732	10	5343	4	52	0	5409
22733	13	45	3	5436	0	5497
22734	12	13	5364	50	0	5439
22735	10	5319	31	30	0	5390
22736	21	32	9	5145	0	5207
22737	15	12	9	5177	0	5213
22738	11	7	6	5170	0	5194
22739	5231	5	3	64	0	5303
22740	50	5303	7	23	0	5383
22741	22	48	2	5414	0	5486
22742	5454	9	4	67	0	5534
22743	5471	10	6	27	0	5514
22744	71	9	2	5505	0	5587
22745	23	9	5560	57	0	5649
22746	14	8	49	5511	0	5582
22747	12	5567	15	61	0	5655
22748	14	52	9	5669	0	5744
22749	5689	14	1	75	0	5779
22750	63	9	7	5932	0	6011
22751	20	10	6055	72	0	6157
22752	12	6404	56	28	0	6500
22753	6502	72	11	26	0	6611
22754	73	21	6554	23	0	6671
22755	6668	13	72	29	0	6782
22756	85	6	17	6876	0	6984
22757	27	10	8	6974	0	7019
22758	16	6995	9	88	0	7108
22759	7372	69	6	51	0	7498
22760	90	19	7	7477	0	7593
22761	29	12	10	7633	0	7684
22762	29	4	3	7792	0	7828
22763	13	9	7790	110	0	7922
22764	27	5	74	7785	0	7891
22765	7922	5	26	96	0	8049
22766	8082	4	9	45	0	8140
22767	106	8	7	8037	0	8158
22768	38	7	9	8130	0	8184
22769	8029	8	6	114	0	8157
22770	89	9	7950	41	0	8089
22771	7856	9	70	38	0	7973
22772	90	12	7801	16	0	7919
22773	33	6	7815	24	0	7878
22774	26	13	86	7901	0	8026
22775	14	9	7997	93	0	8113
22776	7963	4	89	44	0	8100
22777	85	9	23	8204	0	8321
22778	35	6	8162	92	0	8295
22779	7964	10	78	43	0	8095
22780	8116	3	25	33	0	8177
22781	106	3	8237	24	0	8370
22782	52	21	75	7995	0	8143
22783	16	8321	26	87	0	8450
22784	8432	69	14	47	0	8562
22785	94	25	8454	20	0	8593
22786	7969	18	73	23	0	8083
22787	87	8277	23	27	0	8414
22788	8140	58	33	26	0	8257
22789	8170	19	11	25	0	8225
22790	8187	6	11	27	0	8231
22791	86	12	11	8212	0	8321
22792	35	8222	9	68	0	8334
22793	31	63	8142	23	0	8259
22794	17	8308	64	23	0	8412
22795	29	70	16	7798	0	7913
22796	13	8141	12	67	0	8233
22797	17	8285	12	26	0	8340
22798	8148	68	16	25	0	8257
22799	68	23	8091	16	0	8198
22800	39	10	8086	12	0	8147
22801	21	14	8022	25	0	8082
22802	17	8233	62	19	0	8331
22803	8216	55	25	24	0	8320
22804	8239	16	8	21	0	8284
22805	8197	7	18	30	0	8252
22806	76	8108	6	21	0	8211
22807	22	53	12	8333	0	8420
22808	18	23	8252	60	0	8353
22809	25	13	8163	37	0	8238
22810	8284	8	59	32	0	8383
22811	8502	14	26	36	0	8578
22812	8513	13	12	28	0	8566
22813	84	2	8381	30	0	8497
22814	8410	5	59	23	0	8497
22815	73	14	22	8456	0	8565
22816	46	9	13	8414	0	8482
22817	28	15	8607	77	0	8727
22818	33	8631	50	39	0	8753
22819	30	52	25	8740	0	8847
22820	24	14	8625	76	0	8739
22821	8340	14	69	56	0	8479
22822	87	11	31	8692	0	8821
22823	40	7	26	8736	0	8809
22824	8703	6	17	102	0	8828
22825	88	6	8	8672	0	8774
22826	8656	5	23	83	0	8767
22827	8662	6	25	60	0	8753
22828	97	7	13	8662	0	8779
22829	54	6	30	8673	0	8763
22830	8568	5	22	98	0	8693
22831	80	5	18	8639	0	8742
22832	8664	10	30	72	0	8776
22833	8621	7	20	50	0	8698
22834	8569	10	26	33	0	8638
22835	104	7	27	8478	0	8616
22836	42	8	28	8489	0	8567
22837	8459	3	24	91	0	8577
22838	77	8319	31	25	0	8452
22839	50	8148	24	17	0	8239
22840	8098	54	19	25	0	8196
22841	62	18	7982	20	0	8082
22842	7960	10	49	27	0	8046
22843	80	11	15	8259	0	8365
22844	32	11	8310	44	0	8397
22845	8244	5	48	33	0	8330
22846	67	16	15	8352	0	8450
22847	53	14	10	8467	0	8544
22848	37	9	11	8625	0	8682
22849	32	10	8	8568	0	8618
22850	8366	16	12	63	0	8457
22851	46	8188	9	25	0	8268
22852	7706	24	6	22	0	7758
22853	40	13	7667	5	0	7725
22854	27	5	7339	7	0	7378
22855	17	7658	19	11	0	7705
22856	60	80	33	7509	0	7682
22857	12	10	7520	17	0	7559
22858	5	6872	16	17	0	6910
22859	5	15	7009	1	0	7030
22860	8	6	12	6891	0	6917
22861	6	3	3	6755	0	6767
22862	6829	2	4	27	0	6862
22863	14	3	3	6684	0	6704
22864	6683	0	1	21	0	6705
22865	12	0	6654	7	0	6673
22866	3	6678	8	7	0	6696
22867	9	8	1	6935	0	6953
22868	11	3	0	7235	0	7249
22869	5	6	7269	13	0	7293
22870	8	4	6815	5	0	6832
22871	6888	2	18	15	0	6923
22872	7354	0	1	18	0	7373
22873	11	0	0	7366	0	7377
22874	10	3	3	7313	0	7329
22875	4	7191	2	15	0	7212
22876	7	12	1	7407	0	7427
22877	7612	2	0	26	0	7640
22878	7784	0	0	22	0	7806
22879	20	7936	2	7	0	7965
22880	8077	26	0	20	0	8123
22881	8121	11	2	14	0	8148
22882	44	10	0	8823	0	8877
22883	17	8896	6	62	0	8981
22884	16	62	1	9040	0	9119
22885	14	16	2	9089	0	9121
22886	5	3	8925	87	0	9020
22887	9072	2	70	28	0	9172
22888	96	4	14	9759	0	9873
22889	42	5	4	10283	0	10334
22890	11	11366	1	159	0	11537
22891	25	189	2	12220	0	12436
22892	12472	47	1	244	0	12764
22893	13407	27	2	93	0	13529
22894	305	24	13221	51	0	13601
22895	96	32	13394	33	0	13555
22896	88	23	278	13622	0	14011
22897	91	8	75	14086	0	14260
22898	63	7	13861	332	0	14263
22899	49	9	13962	107	0	14127
22900	60	8	350	13473	0	13891
22901	27	5	13833	324	0	14189
22902	36	12	13860	125	0	14033
22903	36	4	370	13678	0	14088
22904	13851	5	145	341	0	14342
22905	14213	8	98	127	0	14446
22906	345	7	87	14092	0	14531
22907	129	7	72	14204	0	14412
22908	13902	4	54	379	0	14339
22909	350	9	48	13725	0	14132
22910	13559	5	32	376	0	13972
22911	13753	10	24	167	0	13954
22912	398	6	21	13626	0	14051
22913	165	11	22	13846	0	14044
22914	13511	4	25	419	0	13959
22915	355	13282	24	176	0	13837
22916	150	13522	32	153	0	13857
22917	127	299	31	13248	0	13705
22918	87	97	13043	366	0	13593
22919	93	64	265	13169	0	13591
22920	13061	61	89	395	0	13606
22921	321	63	69	13152	0	13605
22922	13142	49	58	401	0	13650
22923	328	40	12963	195	0	13526
22924	13032	24	305	161	0	13522
22925	387	20	99	13123	0	13629
22926	176	19	76	13468	0	13739
22927	153	12	13328	412	0	13905
22928	139	10	302	13385	0	13836
22929	120	21	110	13709	0	13960
22930	101	23	78	13872	0	14074
22931	13456	27	68	513	0	14064
22932	308	34	13349	267	0	13958
22933	134	21	13248	204	0	13607
22934	13233	8	370	198	0	13809
22935	13587	7	140	190	0	13924
22936	411	11	13362	138	0	13922
22937	206	37	351	12980	0	13574
22938	158	13272	155	350	0	13935
22939	157	257	127	13627	0	14168
22940	13562	74	128	406	0	14170
22941	13778	57	121	212	0	14168
22942	417	40	115	13502	0	14074
22943	188	13237	113	417	0	13955
22944	173	278	97	12917	0	13465
22945	150	13147	82	431	0	13810
22946	13253	295	87	227	0	13862
22947	12755	107	88	218	0	13168
22948	13104	86	93	202	0	13485
22949	439	12305	81	200	0	13025
22950	234	12861	74	170	0	13339
22951	197	359	73	12895	0	13524
22952	200	123	64	13141	0	13528
22953	183	84	56	13083	0	13406
22954	174	62	47	13253	0	13536
22955	149	69	12651	530	0	13399
22956	12603	64	306	309	0	13282
22957	403	62	12941	255	0	13661
22958	13282	54	348	253	0	13937
22959	438	40	13454	232	0	14164
22960	13522	37	403	232	0	14194
22961	480	47	13640	184	0	14351
22962	13599	41	403	174	0	14217
22963	499	45	170	13712	0	14426
22964	13933	43	142	445	0	14563
22965	501	40	131	13922	0	14594
22966	272	39	112	14065	0	14488
22967	221	25	95	13657	0	13998
22968	174	13110	109	547	0	13940
22969	13221	301	82	310	0	13914
22970	13348	96	73	284	0	13801
22971	498	13078	69	240	0	13885
22972	250	329	71	13195	0	13845
22973	216	134	12909	467	0	13726
22974	12949	82	356	264	0	13651
22975	13354	78	124	209	0	13765
22976	13228	65	107	206	0	13606
22977	542	65	87	12370	0	13064
22978	250	12142	98	425	0	12915
22979	237	314	77	12057	0	12685
22980	11983	105	92	440	0	12620
22981	501	71	74	11427	0	12073
22982	214	10793	73	371	0	11451
22983	10612	282	54	196	0	11144
22984	375	115	10473	157	0	11120
22985	219	96	10312	138	0	10765
22986	158	10208	311	147	0	10824
22987	136	10016	113	114	0	10379
22988	252	279	9327	89	0	9947
22989	204	119	8685	70	0	9078
22990	148	634	234	6487	0	7503
22991	6674	44	103	137	0	6958
22992	142	23	6522	50	0	6737
22993	37	5921	83	31	0	6072
22994	5735	72	79	21	0	5907
22995	73	5685	16	15	0	5789
22996	5402	67	14	9	0	5492
22997	68	5340	14	6	0	5428
22998	24	5508	10	13	0	5555
22999	26	66	19	5535	0	5646
23000	24	24	16	5547	0	5611
23001	21	13	5316	61	0	5411
23002	19	9	48	5267	0	5343
23003	5278	7	15	64	0	5364
23004	5326	10	7	34	0	5377
23005	78	9	3	5247	0	5337
23006	29	8	5154	57	0	5248
23007	15	9	5091	29	0	5144
23008	17	2	61	5200	0	5280
23009	9	6	5311	62	0	5388
23010	15	6	64	5315	0	5400
23011	20	5	25	5337	0	5387
23012	16	5	5940	68	0	6029
23013	5770	5	65	44	0	5884
23014	6010	9	30	22	0	6071
23015	84	7	6085	12	0	6188
23016	37	4	6219	15	0	6275
23017	33	6	108	6450	0	6597
23018	20	8	39	7068	0	7135
23019	28	4	20	7280	0	7332
23020	21	15	13	7235	0	7284
23021	7278	10	14	144	0	7446
23022	7714	7	7	54	0	7782
23023	157	10	12	8080	0	8259
23024	69	7	13	8524	0	8613
23025	23	11	8953	181	0	9168
23026	39	10	155	9245	0	9449
23027	21	1	62	9698	0	9782
23028	9838	8	38	288	0	10172
23029	211	10365	19	161	0	10756
23030	104	230	10	10493	0	10837
23031	59	66	6	10679	0	10810
23032	40	40	13	10581	0	10674
23033	17	9567	14	356	0	9954
23034	11	10385	31	149	0	10576
23035	26	272	15	10393	0	10706
23036	33	95	9	10504	0	10641
23037	37	48	9	10600	0	10694
23038	10082	36	11	367	0	10496
23039	222	10187	18	162	0	10589
23040	10313	231	13	106	0	10663
23041	10511	79	14	86	0	10690
23042	329	51	18	10176	0	10574
23043	125	10139	10	272	0	10546
23044	10193	242	12	141	0	10588
23045	275	92	10	10235	0	10612
23046	10387	45	10	305	0	10747
23047	301	36	9	10476	0	10822
23048	110	44	10359	312	0	10825
23049	78	26	10595	136	0	10835
23050	61	26	290	10606	0	10983
23051	45	19	113	10848	0	11025
23052	41	29	51	10703	0	10824
23053	49	10182	31	369	0	10631
23054	37	10771	22	168	0	10998
23055	10563	284	17	107	0	10971
23056	10440	114	16	94	0	10664
23057	313	10086	21	70	0	10490
23058	119	9619	20	56	0	9814
23059	54	10059	13	65	0	10191
23060	9615	275	19	71	0	9980
23061	218	9696	12	59	0	9985
23062	93	241	14	9702	0	10050
23063	9648	94	9	243	0	9994
23064	9747	59	13	109	0	9928
23065	289	30	20	9457	0	9796
23066	115	33	9272	242	0	9662
23067	73	33	9340	118	0	9564
23068	63	31	243	9383	0	9720
23069	54	35	9559	243	0	9891
23070	42	40	225	9573	0	9880
23071	60	31	90	9656	0	9837
23072	38	35	9526	310	0	9909
23073	53	27	9546	142	0	9768
23074	49	34	263	9539	0	9885
23075	45	35	107	9896	0	10083
23076	9588	30	63	322	0	10003
23077	221	9428	48	161	0	9858
23078	90	9860	44	113	0	10107
23079	9678	272	23	127	0	10100
23080	9943	108	25	103	0	10179
23081	297	9609	32	93	0	10031
23082	117	9864	36	95	0	10112
23083	9822	282	32	83	0	10219
23084	271	111	22	9786	0	10190
23085	9643	76	24	300	0	10043
23086	253	9677	26	156	0	10112
23087	9743	233	31	135	0	10142
23088	281	97	9591	110	0	10079
23089	9606	56	215	110	0	9987
23090	288	55	9656	100	0	10099
23091	134	63	248	9530	0	9975
23092	9442	47	93	299	0	9881
23093	264	36	9305	169	0	9774
23094	133	47	231	9394	0	9805
23095	9286	67	92	305	0	9750
23096	285	62	9237	157	0	9741
23097	138	57	229	9350	0	9774
23098	9164	51	84	331	0	9630
23099	261	9096	56	176	0	9589
23100	139	232	45	9343	0	9759
23101	107	122	36	9225	0	9490
23102	84	93	31	9360	0	9568
23103	90	9320	30	360	0	9800
23104	87	256	29	9706	0	10078
23105	78	112	29	9902	0	10121
23106	101	78	32	9864	0	10075
23107	104	66	29	10077	0	10276
23108	103	62	9670	386	0	10221
23109	9341	57	228	196	0	9822
23110	9688	47	106	136	0	9977
23111	336	9491	59	129	0	10015
23112	160	222	44	9064	0	9490
23113	96	94	43	9183	0	9416
23114	81	8999	39	340	0	9459
23115	60	206	55	9004	0	9325
23116	8600	78	45	306	0	9029
23117	206	8340	59	158	0	8763
23118	7962	181	42	125	0	8310
23119	225	83	30	7872	0	8210
23120	94	65	7745	246	0	8150
23121	60	7805	182	130	0	8177
23122	7396	188	76	89	0	7749
23123	189	6927	36	52	0	7204
23124	74	6796	27	45	0	6942
23125	6042	134	61	37	0	6274
23126	118	43	5926	35	0	6122
23127	31	5531	71	26	0	5659
23128	4792	130	193	53	0	5168
23129	4429	18	28	24	0	4499
23130	43	4403	6	5	0	4457
23131	16	38	3	4530	0	4587
23132	18	8	4599	39	0	4664
23133	4	12	38	4608	0	4662
23134	16	4	9	4502	0	4531
23135	10	5	7	4768	0	4790
23136	6	9	4764	50	0	4829
23137	14	10	28	4656	0	4708
23138	6	7	4723	42	0	4778
23139	4	8	4447	14	0	4473
23140	4268	6	41	12	0	4327
23141	39	4612	12	8	0	4671
23142	10	4683	8	9	0	4710
23143	17	38	5	4816	0	4876
23144	5125	14	5	54	0	5198
23145	5175	6	6	17	0	5204
23146	5039	6	5	21	0	5071
23147	5097	0	3	16	0	5116
23148	4952	4	7	14	0	4977
23149	49	6	4812	7	0	4874
23150	19	1	35	4802	0	4857
23151	9	4678	14	36	0	4737
23152	11	34	8	4832	0	4885
23153	4886	9	5	48	0	4948
23154	37	4783	5	12	0	4837
23155	11	38	4	4954	0	5007
23156	4967	10	1	42	0	5020
23157	5112	12	3	18	0	5145
23158	51	5	6	5123	0	5185
23159	29	5	1	5032	0	5067
23160	23	7	3	5075	0	5108
23161	10	12	4997	52	0	5071
23162	10	4	5008	27	0	5049
23163	14	8	43	5114	0	5179
23164	9	7	14	5206	0	5236
23165	5179	3	11	64	0	5257
23166	5158	6	3	30	0	5197
23167	5238	6	4	17	0	5265
23168	5299	5	5	18	0	5327
23169	5228	6	5	17	0	5256
23170	53	5269	7	15	0	5344
23171	5394	32	4	17	0	5447
23172	5424	10	5	18	0	5457
23173	5392	15	5	14	0	5426
23174	68	4	5	5496	0	5573
23175	29	4	5440	52	0	5525
23176	23	5	48	5542	0	5618
23177	12	4	5860	69	0	5945
23178	21	5	53	5687	0	5766
23179	12	5845	14	53	0	5924
23180	5891	49	10	25	0	5975
23181	6124	14	7	21	0	6166
23182	66	9	6	6211	0	6292
23183	30	7	3	6488	0	6528
23184	21	4	3	6508	0	6536
23185	16	6572	6	70	0	6664
23186	6568	49	6	33	0	6656
23187	6601	16	7	19	0	6643
23188	67	6636	7	11	0	6721
23189	37	56	6	6680	0	6779
23190	21	18	3	6630	0	6672
23191	15	6703	6	65	0	6789
23192	6821	55	3	37	0	6916
23193	6870	15	3	20	0	6908
23194	82	13	4	6850	0	6949
23195	34	6	6875	63	0	6978
23196	22	6	6684	31	0	6743
23197	22	6	70	7086	0	7184
23198	18	5	26	7124	0	7173
23199	16	6	11	7267	0	7300
23200	7138	3	4	97	0	7242
23201	7242	6	5	51	0	7304
23202	76	7512	7	30	0	7625
23203	7496	56	4	23	0	7579
23204	76	26	7445	8	0	7555
23205	40	14	7350	10	0	7414
23206	21	7711	68	10	0	7810
23207	7533	50	29	19	0	7631
23208	49	7537	9	18	0	7613
23209	7555	56	3	9	0	7623
23210	62	21	7571	4	0	7658
23211	28	8	7465	7	0	7508
23212	15	9	64	7460	0	7548
23213	11	7	7722	50	0	7790
23214	9	5	59	7829	0	7902
23215	24	6	32	7122	0	7184
23216	8	7874	14	68	0	7964
23217	15	47	8	8015	0	8085
23218	12	21	5	8108	0	8146
23219	8294	10	5	73	0	8382
23220	59	8306	7	37	0	8409
23221	28	57	9	8545	0	8639
23222	14	23	8515	65	0	8617
23223	7861	16	63	45	0	7985
23224	71	14	8486	27	0	8598
23225	44	11	70	8318	0	8443
23226	20	8697	18	67	0	8802
23227	19	73	12	8714	0	8818
23228	8800	18	13	94	0	8925
23229	8825	19	8	36	0	8888
23230	96	8956	11	34	0	9097
23231	9232	76	8	41	0	9357
23232	9293	31	12	35	0	9371
23233	9295	20	6	36	0	9357
23234	9515	12	9	26	0	9562
23235	8982	10	8	50	0	9050
23236	103	13	9264	14	0	9394
23237	50	8	75	9287	0	9420
23238	45	13	27	9037	0	9122
23239	39	12	13	9317	0	9381
23240	23	9323	15	99	0	9460
23241	25	72	15	9303	0	9415
23242	22	33	9265	90	0	9410
23243	13	9036	73	43	0	9165
23244	20	8964	26	31	0	9041
23245	43	93	23	8948	0	9107
23246	23	40	16	8953	0	9032
23247	24	21	16	8847	0	8908
23248	22	8647	15	109	0	8793
23249	17	8800	19	50	0	8886
23250	8827	91	15	44	0	8977
23251	8809	30	13	36	0	8888
23252	92	8858	13	26	0	8989
23253	8966	83	11	37	0	9097
23254	9221	33	16	34	0	9304
23255	113	21	14	9293	0	9441
23256	51	20	19	9627	0	9717
23257	32	16	15	9642	0	9705
23258	22	15	9624	117	0	9778
23259	23	16	9576	54	0	9669
23260	24	10147	104	36	0	10311
23261	10384	93	44	41	0	10562
23262	112	43	10478	25	0	10658
23263	10394	22	110	43	0	10569
23264	140	21	11048	19	0	11228
23265	11035	15	141	30	0	11221
23266	144	11594	49	28	0	11815
23267	11654	141	19	29	0	11843
23268	163	47	21	11545	0	11776
23269	74	27	13	11781	0	11895
23270	40	26	11662	173	0	11901
23271	30	11956	110	72	0	12168
23272	43	140	39	12094	0	12316
23273	33	46	12038	148	0	12265
23274	11354	29	134	76	0	11593
23275	136	11897	43	37	0	12113
23276	11799	122	29	35	0	11985
23277	142	11479	21	33	0	11675
23278	61	142	16	11488	0	11707
23279	11397	45	16	147	0	11605
23280	120	11455	17	56	0	11648
23281	58	126	10	11460	0	11654
23282	27	53	11289	132	0	11501
23283	10788	20	112	62	0	10982
23284	126	21	39	11153	0	11339
23285	51	19	11034	133	0	11237
23286	37	10999	115	47	0	11198
23287	34	116	33	11075	0	11258
23288	32	42	11056	123	0	11253
23289	42	34	114	10769	0	10959
23290	31	11007	38	128	0	11204
23291	23	11180	19	72	0	11294
23292	26	148	11076	25	0	11275
23293	35	52	110	10987	0	11184
23294	21	31	11099	129	0	11280
23295	10816	18	120	54	0	11008
23296	124	33	44	10818	0	11019
23297	49	10551	25	119	0	10744
23298	24	10975	22	44	0	11065
23299	10794	121	16	48	0	10979
23300	105	11061	14	31	0	11211
23301	11087	117	19	28	0	11251
23302	127	39	10855	17	0	11038
23303	10369	25	106	38	0	10538
23304	116	10617	32	17	0	10782
23305	10604	104	30	30	0	10768
23306	113	10441	16	22	0	10592
23307	52	112	17	10405	0	10586
23308	29	37	20	10677	0	10763
23309	22	25	10599	132	0	10778
23310	10146	27	103	62	0	10338
23311	109	23	10777	27	0	10936
23312	10937	17	114	30	0	11098
23313	128	19	39	10870	0	11056
23314	51	18	20	10978	0	11067
23315	28	11081	21	155	0	11285
23316	27	142	16	11379	0	11564
23317	33	39	18	11594	0	11684
23318	28	19	11414	173	0	11634
23319	10635	28	122	86	0	10871
23320	130	11115	45	42	0	11332
23321	11058	132	20	31	0	11241
23322	153	43	17	11037	0	11250
23323	68	25	17	11131	0	11241
23324	10974	17	20	181	0	11192
23325	142	11133	21	65	0	11361
23326	10877	117	14	47	0	11055
23327	135	10781	22	33	0	10971
23328	58	10835	13	22	0	10928
23329	10792	148	34	30	0	11004
23330	143	53	19	10567	0	10782
23331	48	33	10558	126	0	10765
23332	43	16	127	10372	0	10558
23333	36	19	45	10375	0	10475
23334	25	10406	22	165	0	10618
23335	35	128	17	10578	0	10758
23336	33	67	5	10628	0	10733
23337	23	22	11	10831	0	10887
23338	23	28	16	11013	0	11080
23339	17	22	10896	199	0	11134
23340	22	20	11093	77	0	11212
23341	36	27	165	11294	0	11522
23342	39	22	11365	161	0	11587
23343	25	25	11264	74	0	11388
23344	35	25	180	11397	0	11637
23345	32	24	11739	165	0	11960
23346	31	20	157	11351	0	11559
23347	23	11737	61	152	0	11973
23348	12341	153	24	80	0	12598
23349	167	50	13092	44	0	13353
23350	71	39	202	13135	0	13447
23351	35	22	13481	216	0	13754
23352	49	17	211	13996	0	14273
23353	30	16	82	14311	0	14439
23354	14147	16	39	293	0	14495
23355	223	28	36	14377	0	14664
23356	13767	19	35	269	0	14090
23357	14051	14	31	127	0	14223
23358	265	13824	36	66	0	14191
23359	13620	209	19	74	0	13922
23360	228	13263	28	46	0	13565
23361	76	13493	29	46	0	13644
23362	13140	242	37	62	0	13481
23363	223	75	13171	31	0	13500
23364	78	36	12742	32	0	12888
23365	12310	70	284	46	0	12710
23366	12388	18	97	37	0	12540
23367	222	12361	45	31	0	12659
23368	12618	175	27	41	0	12861
23369	12733	56	19	43	0	12851
23370	12637	28	27	37	0	12729
23371	266	19	14	12342	0	12641
23372	12262	19	23	196	0	12500
23373	212	12529	11	76	0	12828
23374	105	175	20	12777	0	13077
23375	63	56	18	12863	0	13000
23376	43	12786	26	229	0	13084
23377	50	188	12	12921	0	13171
23378	12796	69	21	219	0	13105
23379	12895	35	20	92	0	13042
23380	235	12467	31	55	0	12788
23381	101	12768	22	45	0	12936
23382	12716	216	21	50	0	13003
23383	215	75	12547	40	0	12877
23384	102	45	12537	25	0	12709
23385	82	37	220	12419	0	12758
23386	62	28	70	12682	0	12842
23387	52	34	12486	231	0	12803
23388	39	12023	193	91	0	12346
23389	84	184	61	11786	0	12115
23390	48	71	12432	200	0	12751
23391	53	39	192	12378	0	12662
23392	53	36	67	12390	0	12546
23393	47	12606	29	243	0	12925
23394	41	190	39	12635	0	12905
23395	55	71	22	12766	0	12914
23396	52	32	28	12854	0	12966
23397	12638	37	24	276	0	12975
23398	206	27	23	12386	0	12642
23399	103	12429	20	205	0	12757
23400	12342	189	29	100	0	12660
23401	209	66	12039	71	0	12385
23402	99	38	11892	65	0	12094
23403	11953	35	221	51	0	12260
23404	208	52	85	12098	0	12443
23405	101	27	12163	208	0	12499
23406	58	35	195	12103	0	12391
23407	59	29	70	12375	0	12533
23408	12139	22	48	281	0	12490
23409	12193	28	43	114	0	12378
23410	247	12142	32	83	0	12504
23411	109	192	31	11968	0	12300
23412	76	71	11950	203	0	12300
23413	58	12276	168	102	0	12604
23414	12215	178	61	75	0	12529
23415	197	12460	37	64	0	12758
23416	12413	180	30	60	0	12683
23417	202	70	12336	47	0	12655
23418	12200	48	163	44	0	12455
23419	12709	37	59	59	0	12864
23420	246	37	12852	46	0	13181
23421	115	63	193	12546	0	12917
23422	67	12437	67	215	0	12786
23423	59	13101	48	87	0	13295
23424	56	13201	34	66	0	13357
23425	83	252	29	12866	0	13230
23426	58	95	13015	208	0	13376
23427	63	70	186	12912	0	13231
23428	64	37	58	13230	0	13389
23429	53	40	13087	237	0	13417
23430	49	12932	204	210	0	13395
23431	51	189	66	12900	0	13206
23432	12994	64	47	228	0	13333
23433	213	38	42	12988	0	13281
23434	82	42	24	12916	0	13064
23435	66	12747	21	254	0	13088
23436	12810	194	26	115	0	13145
23437	211	65	25	13037	0	13338
23438	79	44	12834	216	0	13173
23439	51	12698	161	84	0	12994
23440	12405	180	74	68	0	12727
23441	169	88	12496	42	0	12795
23442	12224	40	174	60	0	12498
23443	196	38	80	12279	0	12593
23444	74	12345	45	186	0	12650
23445	12186	168	30	94	0	12478
23446	12167	62	33	62	0	12324
23447	200	12307	28	48	0	12583
23448	84	146	21	11937	0	12188
23449	36	45	13	11398	0	11492
23450	11081	27	17	159	0	11284
23451	114	11039	19	68	0	11240
23452	52	125	15	10458	0	10650
23453	24	10262	22	105	0	10413
23454	21	10180	8	37	0	10246
23455	51	106	28	9887	0	10072
23456	9829	33	28	95	0	9985
23457	80	9887	11	31	0	10009
23458	34	82	7	9902	0	10025
23459	23	36	6	9957	0	10022
23460	23	19	9906	88	0	10036
23461	20	13	9375	36	0	9444
23462	14	9721	86	23	0	9844
23463	12	74	9565	23	0	9674
23464	11	30	83	9541	0	9665
23465	16	13	9636	70	0	9735
23466	19	21	69	9813	0	9922
23467	15	7	24	9982	0	10028
23468	15	19	10	9961	0	10005
23469	9744	14	11	102	0	9871
23470	66	17	1	9682	0	9766
23471	30	16	5	9681	0	9732
23472	15	9625	8	94	0	9742
23473	17	69	6	9409	0	9501
23474	9371	21	6	116	0	9514
23475	65	9590	14	36	0	9705
23476	9696	68	14	42	0	9820
23477	72	40	9714	15	0	9841
23478	28	25	9897	15	0	9965
23479	27	16	75	10242	0	10360
23480	24	19	36	10381	0	10460
23481	9	10425	20	105	0	10559
23482	32	79	16	9903	0	10030
23483	10450	25	7	117	0	10599
23484	10439	16	14	51	0	10520
23485	101	19	9	10559	0	10688
23486	38	16	10987	101	0	11142
23487	33	22	93	11093	0	11241
23488	19	14	37	11524	0	11594
23489	28	11	18	11618	0	11675
23490	10	19	14	11529	0	11572
23491	25	18	11	11370	0	11424
23492	15	11363	14	142	0	11534
23493	11236	91	15	75	0	11417
23494	11455	29	10	68	0	11562
23495	11574	16	9	57	0	11656
23496	125	11723	9	39	0	11896
23497	11644	105	8	46	0	11803
23498	117	11683	5	29	0	11834
23499	52	116	11601	27	0	11796
23500	43	46	104	11468	0	11661
23501	21	18	11761	115	0	11915
23502	12	11843	116	58	0	12029
23503	11770	110	44	53	0	11977
23504	113	42	12047	38	0	12240
23505	53	21	12577	35	0	12686
23506	26	13151	153	47	0	13377
23507	42	147	72	13371	0	13632
23508	26	69	14229	163	0	14487
23509	58	35	175	13983	0	14251
23510	40	22	78	15618	0	15758
23511	38	17	27	16561	0	16643
23512	16957	21	24	350	0	17352
23513	16993	12	13	165	0	17183
23514	365	19	22	16820	0	17226
23515	16918	16	14	316	0	17264
23516	301	15	16560	135	0	17011
23517	137	13	16399	56	0	16605
23518	72	19	16455	56	0	16602
23519	56	13	16595	38	0	16702
23520	41	16255	327	55	0	16678
23521	118	233	141	16033	0	16525
23522	49	91	16378	226	0	16744
23523	15597	21	266	136	0	16020
23524	16346	20	120	59	0	16545
23525	337	16060	74	173	0	16644
23526	16145	239	74	71	0	16529
23527	294	92	79	16068	0	16533
23528	135	37	16426	236	0	16834
23529	86	47	285	15676	0	16094
23530	42	16564	147	229	0	16982
23531	16124	261	75	141	0	16601
23532	16637	106	56	88	0	16887
23533	333	16552	49	71	0	17005
23534	16712	254	49	68	0	17083
23535	16705	109	37	77	0	16928
23536	371	16602	29	63	0	17065
23537	188	261	36	16132	0	16617
23538	91	16442	37	252	0	16822
23539	16492	267	41	137	0	16937
23540	304	168	40	16424	0	16936
23541	16497	62	33	290	0	16882
23542	318	67	31	16416	0	16832
23543	186	68	16214	273	0	16741
23544	15971	60	242	144	0	16417
23545	331	69	16223	55	0	16678
23546	194	59	245	16097	0	16595
23547	109	63	15999	278	0	16449
23548	96	59	266	16002	0	16423
23549	90	51	15966	303	0	16410
23550	15591	44	269	189	0	16093
23551	294	15848	145	95	0	16382
23552	15872	245	69	115	0	16301
23553	315	104	84	15744	0	16247
23554	15637	37	84	316	0	16074
23555	288	15575	85	159	0	16107
23556	157	15508	82	74	0	15821
23557	83	16137	78	106	0	16404
23558	16139	325	78	103	0	16645
23559	308	138	69	16181	0	16696
23560	191	66	57	16361	0	16675
23561	106	85	16065	366	0	16622
23562	106	67	16019	157	0	16349
23563	119	65	323	16187	0	16694
23564	117	75	16364	298	0	16854
23565	85	16117	287	177	0	16666
23566	16025	294	145	102	0	16566
23567	325	158	16198	72	0	16753
23568	159	80	16204	85	0	16528
23569	107	69	366	16036	0	16578
23570	16277	53	174	322	0	16826
23571	318	51	109	16354	0	16832
23572	16361	41	108	342	0	16852
23573	306	45	122	16358	0	16831
23574	157	69	16445	318	0	16989
23575	114	16118	321	171	0	16724
23576	105	282	16388	104	0	16879
23577	94	16313	331	96	0	16834
23578	134	330	173	15967	0	16604
23579	15853	122	99	342	0	16416
23580	317	49	15839	171	0	16376
23581	186	55	284	15708	0	16233
23582	120	46	125	16157	0	16448
23583	16101	50	80	405	0	16636
23584	327	54	92	15812	0	16285
23585	139	16042	100	308	0	16589
23586	15624	285	85	181	0	16175
23587	298	152	15464	83	0	15997
23588	15003	81	279	98	0	15461
23589	302	15333	121	94	0	15850
23590	189	290	70	14869	0	15418
23591	99	15553	62	274	0	15988
23592	15427	266	56	151	0	15900
23593	310	128	15448	100	0	15986
23594	15142	107	251	128	0	15628
23595	312	15548	110	100	0	16070
23596	163	255	70	15608	0	16096
23597	15789	131	65	300	0	16285
23598	16046	69	70	145	0	16330
23599	361	65	78	15932	0	16436
23600	183	92	52	16019	0	16346
23601	97	15973	52	342	0	16464
23602	117	299	60	15973	0	16449
23603	107	17473	58	273	0	17911
23604	105	18226	52	156	0	18539
23605	117	577	60	16615	0	17369
23606	82	17283	43	308	0	17716
23607	143	281	17130	122	0	17676
23608	206	124	17094	98	0	17522
23609	79	17430	323	105	0	17937
23610	77	251	16844	58	0	17230
23611	47	106	16431	64	0	16648
23612	30	51	15495	38	0	15614
23613	7	15410	252	23	0	15692
23614	14985	203	194	48	0	15430
23615	156	14910	51	26	0	15143
23616	67	182	14969	16	0	15234
23617	66	82	173	14776	0	15097
23618	14885	40	78	187	0	15190
23619	160	36	14844	66	0	15106
23620	94	23	186	14851	0	15154
23621	41	23	15078	173	0	15315
23622	42	22	200	14886	0	15150
23623	14844	18	95	212	0	15169
23624	169	25	15111	75	0	15380
23625	67	15233	190	61	0	15551
23626	72	173	81	15052	0	15378
23627	15529	74	53	202	0	15858
23628	192	49	15327	75	0	15643
23629	113	39	198	14635	0	14985
23630	46	15197	94	196	0	15533
23631	15441	180	59	99	0	15779
23632	15855	76	46	74	0	16051
23633	280	59	24	15732	0	16095
23634	99	15803	44	202	0	16148
23635	57	16475	33	101	0	16666
23636	16958	258	32	66	0	17314
23637	258	99	31	16733	0	17121
23638	87	16993	32	239	0	17351
23639	17103	230	35	117	0	17485
23640	263	82	34	17184	0	17563
23641	123	55	27	17383	0	17588
23642	69	42	16740	298	0	17149
23643	42	16944	203	129	0	17318
23644	35	17824	75	78	0	18012
23645	57	291	50	17811	0	18209
23646	17790	110	25	275	0	18200
23647	234	17837	43	99	0	18213
23648	17862	263	31	82	0	18238
23649	256	17884	27	51	0	18218
23650	126	265	31	17943	0	18365
23651	17967	102	29	275	0	18373
23652	271	75	28	17981	0	18355
23653	100	74	18000	269	0	18443
23654	90	58	230	17461	0	17839
23655	55	17845	88	258	0	18246
23656	17796	246	54	143	0	18239
23657	246	17765	39	75	0	18125
23658	118	279	35	17415	0	17847
23659	94	117	34	17746	0	17991
23660	48	80	17359	324	0	17811
23661	54	52	17186	135	0	17427
23662	66	83	288	17269	0	17706
23663	69	64	17158	273	0	17564
23664	48	17117	264	135	0	17564
23665	17107	271	111	116	0	17605
23666	245	123	17447	71	0	17886
23667	17199	103	248	92	0	17642
23668	17622	76	116	87	0	17901
23669	17628	60	85	79	0	17852
23670	17667	74	66	72	0	17879
23671	365	50	68	17363	0	17846
23672	169	61	63	17079	0	17372
23673	96	17006	72	306	0	17480
23674	16933	267	75	134	0	17409
23675	285	131	16753	90	0	17259
23676	152	81	265	16555	0	17053
23677	105	89	124	16777	0	17095
23678	90	73	16439	323	0	16925
23679	77	16471	267	166	0	16981
23680	111	245	123	15702	0	16181
23681	98	112	82	16833	0	17125
23682	16432	73	77	352	0	16934
23683	249	16264	58	196	0	16767
23684	139	258	62	16134	0	16593
23685	104	16124	68	286	0	16582
23686	108	266	53	16368	0	16795
23687	16164	128	51	323	0	16666
23688	16360	92	57	162	0	16671
23689	340	78	48	16117	0	16583
23690	15975	45	46	333	0	16399
23691	15967	68	43	184	0	16262
23692	323	15808	55	119	0	16305
23693	200	253	37	15426	0	15916
23694	112	15694	38	273	0	16117
23695	118	268	37	15623	0	16046
23696	15508	139	30	294	0	15971
23697	285	112	36	15343	0	15776
23698	167	94	25	15447	0	15733
23699	105	81	14983	364	0	15533
23700	120	14213	214	175	0	14722
23701	95	14882	80	143	0	15200
23702	14497	270	48	146	0	14961
23703	226	158	44	12713	0	13141
23704	12091	76	17	209	0	12393
23705	203	11748	26	102	0	12079
23706	89	11146	28	85	0	11348
23707	65	11568	16	64	0	11713
23708	10498	170	155	79	0	10902
23709	122	10478	41	51	0	10692
23710	10207	121	94	57	0	10479
23711	10058	38	16	52	0	10164
23712	10415	18	9	36	0	10478
23713	128	21	12	10911	0	11072
23714	49	25	10	11211	0	11295
23715	45	23	7	11284	0	11359
23716	36	26	10	11181	0	11253
23717	11096	15	12	176	0	11299
23718	141	10937	9	72	0	11159
23719	57	120	8	10932	0	11117
23720	10929	35	12	145	0	11121
23721	146	23	14	10764	0	10947
23722	53	13	11	10845	0	10922
23723	10704	23	9	176	0	10912
23724	139	14	10390	61	0	10604
23725	49	20	109	10325	0	10503
23726	36	10	10418	145	0	10609
23727	33	16	109	10202	0	10360
23728	29	33	27	10181	0	10270
23729	9972	21	13	167	0	10173
23730	120	9751	11	60	0	9942
23731	43	9583	5	48	0	9679
23732	9264	105	9	44	0	9422
23733	108	9372	9	26	0	9515
23734	9337	83	22	48	0	9490
23735	107	25	9224	25	0	9381
23736	8611	15	72	30	0	8728
23737	8778	2	22	28	0	8830
23738	8836	4	9	28	0	8877
23739	80	8	9	8691	0	8788
23740	31	13	2	8639	0	8685
23741	13	8642	4	78	0	8737
23742	20	114	4	8459	0	8597
23743	8382	23	3	82	0	8490
23744	62	8281	2	26	0	8371
23745	23	8241	3	15	0	8282
23746	8225	70	7	20	0	8322
23747	69	22	8169	6	0	8266
23748	30	9	60	8074	0	8173
23749	12	8	8196	64	0	8280
23750	23	5	58	8044	0	8130
23751	8	8112	18	56	0	8194
23752	12	61	7	8262	0	8342
23753	8163	19	3	79	0	8264
23754	74	13	2	8155	0	8244
23755	25	12	8361	69	0	8467
23756	7962	9	59	42	0	8072
23757	70	8423	27	15	0	8535
23758	23	8897	14	12	0	8946
23759	9339	87	6	29	0	9461
23760	9777	31	11	22	0	9841
23761	131	12	9763	11	0	9917
23762	9526	9	99	29	0	9663
23763	109	9800	26	23	0	9958
23764	9946	101	11	32	0	10090
23765	116	34	4	9638	0	9792
23766	45	9177	7	106	0	9335
23767	9296	104	6	54	0	9460
23768	118	38	9247	14	0	9417
23769	55	24	96	9322	0	9497
23770	9493	8	35	134	0	9670
23771	128	12	9449	39	0	9628
23772	9510	11	111	30	0	9662
23773	138	9	32	9416	0	9595
23774	54	11	21	9631	0	9717
23775	25	10	9646	142	0	9823
23776	32	10	100	9633	0	9775
23777	9735	8	37	141	0	9921
23778	114	9616	20	57	0	9807
23779	9693	113	12	39	0	9857
23780	9779	39	5	36	0	9859
23781	157	31	7	9720	0	9915
23782	62	26	9792	122	0	10002
23783	48	7	111	9816	0	9982
23784	9852	11	37	147	0	10047
23785	129	9758	26	62	0	9975
23786	10042	109	12	43	0	10206
23787	145	42	8	10005	0	10200
23788	66	17	5	10201	0	10289
23789	34	23	19	10258	0	10334
23790	33	10	10081	181	0	10305
23791	40	14	113	10213	0	10380
23792	25	19	10166	146	0	10356
23793	35	15	10242	61	0	10353
23794	40	17	144	11179	0	11380
23795	30	19	11348	164	0	11561
23796	11960	18	162	91	0	12231
23797	214	10	63	12345	0	12632
23798	107	10	34	12264	0	12415
23799	48	12545	29	249	0	12871
23800	12671	198	25	129	0	13023
23801	13000	71	18	94	0	13183
23802	278	13028	15	53	0	13374
23803	126	203	18	13006	0	13353
23804	79	88	13032	216	0	13415
23805	12776	47	201	125	0	13149
23806	13251	40	84	65	0	13440
23807	322	22	40	12733	0	13117
23808	144	25	12323	216	0	12708
23809	75	12178	204	109	0	12566
23810	12004	207	83	69	0	12363
23811	245	85	12057	52	0	12439
23812	110	11812	204	50	0	12176
23813	11170	191	126	48	0	11535
23814	11179	70	58	50	0	11357
23815	269	45	30	10988	0	11332
23816	121	11028	32	191	0	11372
23817	98	192	21	11549	0	11860
23818	62	78	28	11794	0	11962
23819	69	48	31	11529	0	11677
23820	64	34	29	11841	0	11968
23821	52	30	11627	301	0	12010
23822	58	27	189	11810	0	12084
23823	53	32	75	12053	0	12213
23824	61	27	11734	279	0	12101
23825	42	11749	197	139	0	12127
23826	11749	197	76	113	0	12135
23827	11913	77	54	90	0	12134
23828	267	48	35	11888	0	12238
23829	11974	34	27	260	0	12295
23830	269	29	28	12257	0	12583
23831	112	18	12322	284	0	12736
23832	73	30	12268	136	0	12507
23833	53	12447	257	111	0	12868
23834	12339	209	121	95	0	12764
23835	248	89	13041	74	0	13452
23836	140	51	266	12642	0	13099
23837	103	40	113	13369	0	13625
23838	78	27	69	13738	0	13912
23839	74	32	52	13695	0	13853
23840	78	38	37	13667	0	13820
23841	58	39	13264	460	0	13821
23842	77	26	276	13471	0	13850
23843	13269	32	123	394	0	13818
23844	286	13161	74	191	0	13712
23845	13187	263	57	147	0	13654
23846	319	13221	55	122	0	13717
23847	13261	303	48	106	0	13718
23848	13560	133	37	131	0	13861
23849	413	71	57	13269	0	13810
23850	210	50	37	13531	0	13828
23851	13244	44	43	412	0	13743
23852	13113	40	45	240	0	13438
23853	13222	47	43	158	0	13470
23854	424	12622	42	126	0	13214
23855	204	12852	42	100	0	13198
23856	122	324	12637	100	0	13183
23857	125	209	257	12352	0	12943
23858	85	82	12140	322	0	12629
23859	83	11673	281	182	0	12219
23860	95	250	120	11258	0	11723
23861	77	115	55	11435	0	11682
23862	82	70	51	11603	0	11806
23863	11264	49	42	381	0	11736
23864	11299	48	33	217	0	11597
23865	334	11242	32	160	0	11768
23866	163	237	50	11338	0	11788
23867	120	110	11230	298	0	11758
23868	113	79	10958	153	0	11303
23869	11056	61	314	113	0	11544
23870	11254	59	134	99	0	11546
23871	358	47	86	11085	0	11576
23872	11180	43	64	309	0	11596
23873	319	34	11040	176	0	11569
23874	168	10988	253	116	0	11525
23875	140	239	111	10985	0	11475
23876	96	111	11212	300	0	11719
23877	75	73	270	11308	0	11726
23878	77	60	121	11571	0	11829
23879	87	40	11473	400	0	12000
23880	11291	31	271	245	0	11838
23881	11688	34	114	187	0	12023
23882	325	12029	87	144	0	12585
23883	12278	267	69	152	0	12766
23884	12659	106	73	131	0	12969
23885	407	90	12355	125	0	12977
23886	12408	51	270	107	0	12836
23887	357	12902	118	126	0	13503
23888	13023	284	73	119	0	13499
23889	13437	124	64	130	0	13755
23890	13691	82	74	102	0	13949
23891	13006	74	49	123	0	13252
23892	13642	52	38	99	0	13831
23893	498	13090	52	91	0	13731
23894	12332	237	43	118	0	12730
23895	341	12015	57	84	0	12497
23896	151	10997	41	61	0	11250
23897	105	11608	44	45	0	11802
23898	11370	265	152	69	0	11856
23899	11313	109	45	73	0	11540
23900	307	52	10991	52	0	11402
23901	11488	44	184	61	0	11777
23902	11568	28	73	64	0	11733
23903	327	47	11592	55	0	12021
23904	165	39	217	11520	0	11941
23905	125	31	105	11302	0	11563
23906	90	33	46	12078	0	12247
23907	83	34	39	12093	0	12249
23908	104	27	38	12124	0	12293
23909	63	42	11704	340	0	12149
23910	69	11692	215	146	0	12122
23911	11490	218	101	71	0	11880
23912	257	11510	53	56	0	11876
23913	11541	246	34	64	0	11885
23914	11552	109	32	60	0	11753
23915	347	50	11217	48	0	11662
23916	161	61	212	10490	0	10924
23917	92	10786	104	205	0	11187
23918	10911	216	49	118	0	11294
23919	10999	96	38	86	0	11219
23920	11097	43	43	67	0	11250
23921	336	10989	41	55	0	11421
23922	11104	198	32	56	0	11390
23923	11237	100	35	45	0	11417
23924	11294	54	28	41	0	11417
23925	356	40	34	10923	0	11353
23926	174	41	27	11103	0	11345
23927	128	31	23	11212	0	11394
23928	10930	39	23	279	0	11271
23929	257	10918	20	126	0	11321
23930	10857	184	16	58	0	11115
23931	10683	106	30	29	0	10848
23932	10347	60	20	38	0	10465
23933	10261	55	14	30	0	10360
23934	318	9935	14	27	0	10294
23935	9190	149	14	19	0	9372
23936	230	8891	14	18	0	9153
23937	113	8834	11	16	0	8974
23938	8841	166	14	21	0	9042
23939	169	8635	11	20	0	8835
23940	111	8876	11	16	0	9014
23941	8893	165	40	25	0	9123
23942	8932	78	6	38	0	9054
23943	192	43	3	8756	0	8994
23944	115	28	6	8936	0	9085
23945	9033	33	7	182	0	9255
23946	9311	33	23	84	0	9451
23947	9101	50	9	51	0	9211
23948	209	37	9020	18	0	9284
23949	9407	28	113	34	0	9582
23950	190	25	49	9439	0	9703
23951	109	26	24	9558	0	9717
23952	74	24	26	9614	0	9738
23953	67	22	21	9626	0	9736
23954	53	31	9314	196	0	9594
23955	59	27	9362	96	0	9544
23956	67	29	145	9420	0	9661
23957	63	30	9439	150	0	9682
23958	71	34	9402	87	0	9594
23959	88	21	157	9495	0	9761
23960	72	26	73	9672	0	9843
23961	60	33	43	9940	0	10076
23962	79	26	23	9654	0	9782
23963	9870	31	18	220	0	10139
23964	10153	33	33	117	0	10336
23965	229	25	22	9961	0	10237
23966	136	33	25	10032	0	10226
23967	89	36	19	10042	0	10186
23968	92	28	12	10023	0	10155
23969	101	17	23	9940	0	10081
23970	81	9854	25	209	0	10169
23971	9855	147	21	121	0	10144
23972	177	9858	18	88	0	10141
23973	9858	146	13	85	0	10102
23974	9912	71	14	72	0	10069
23975	9917	45	16	61	0	10039
23976	230	47	13	9513	0	9803
23977	9499	34	11	168	0	9712
23978	213	40	7	9364	0	9624
23979	152	37	10	9229	0	9428
23980	9238	35	3	199	0	9475
23981	197	9012	10	103	0	9322
23982	101	8718	8	57	0	8884
23983	8539	117	8	53	0	8717
23984	149	61	8464	32	0	8706
23985	8238	41	84	45	0	8408
23986	166	76	39	8297	0	8578
23987	88	7801	9	99	0	7997
23988	70	7958	6	53	0	8087
23989	8041	111	14	46	0	8212
23990	107	58	8	8061	0	8234
23991	79	8362	1	76	0	8518
23992	8305	73	11	52	0	8441
23993	8379	30	10	45	0	8464
23994	8430	25	2	40	0	8497
23995	8444	27	5	38	0	8514
23996	117	8094	3	36	0	8250
23997	52	8008	5	22	0	8087
23998	8156	66	4	24	0	8250
23999	8433	27	3	29	0	8492
24000	97	20	8344	19	0	8480
24001	36	8181	56	5	0	8278
24002	8307	59	21	18	0	8405
24003	8617	10	8	17	0	8652
24004	78	13	8697	10	0	8798
24005	8618	16	64	23	0	8721
24006	105	11	9017	5	0	9138
24007	25	11	9546	8	0	9590
24008	33	22	100	9094	0	9249
24009	23	9197	28	82	0	9330
24010	9990	95	18	28	0	10131
24011	106	25	12	9976	0	10119
24012	42	13	3	10097	0	10155
24013	32	11	4	10165	0	10212
24014	10154	2	11	148	0	10315
24015	111	13	4	10150	0	10278
24016	47	5	6	10398	0	10456
24017	31	8	10386	130	0	10555
24018	10256	2	109	56	0	10423
24019	10566	6	27	44	0	10643
24020	137	11	10494	23	0	10665
24021	10247	4	110	29	0	10390
24022	143	6	30	10229	0	10408
24023	46	9770	23	599	0	10438
24024	42	102	14	10327	0	10485
24025	10291	25	14	148	0	10478
24026	124	10300	11	54	0	10489
24027	49	122	7	10387	0	10565
24028	47	37	10	10611	0	10705
24029	38	16	6	10652	0	10712
24030	29	13	10	10382	0	10434
24031	17	10830	13	163	0	11023
24032	10958	124	5	71	0	11158
24033	11088	38	11	54	0	11191
24034	178	11346	10	47	0	11581
24035	12115	150	11	44	0	12320
24036	12570	41	11	47	0	12669
24037	12502	31	8	38	0	12579
24038	283	16	12194	32	0	12525
24039	130	14	182	12153	0	12479
24040	75	23	11882	214	0	12194
24041	11989	14	193	94	0	12290
24042	232	12111	62	57	0	12462
24043	12064	184	39	71	0	12358
24044	241	12176	29	48	0	12494
24045	120	217	28	11773	0	12138
24046	86	68	16	12084	0	12254
24047	63	55	11966	251	0	12335
24048	62	12128	190	113	0	12493
24049	12012	228	71	68	0	12379
24050	252	81	11969	51	0	12353
24051	11977	64	218	53	0	12312
24052	280	45	82	12005	0	12412
24053	110	44	12028	243	0	12425
24054	78	12005	235	103	0	12421
24055	75	224	83	11996	0	12378
24056	77	78	12063	232	0	12450
24057	59	61	12043	103	0	12266
24058	69	11961	257	82	0	12369
24059	72	225	110	11781	0	12188
24060	77	80	69	11705	0	11931
24061	45	11642	55	271	0	12013
24062	11785	222	43	140	0	12190
24063	246	100	42	11590	0	11978
24064	124	11536	36	238	0	11934
24065	11685	232	36	123	0	12076
24066	11683	92	49	105	0	11929
24067	11829	67	45	82	0	12023
24068	321	11616	41	86	0	12064
24069	11799	231	35	78	0	12143
24070	11915	96	40	69	0	12120
24071	351	84	34	11642	0	12111
24072	11819	54	27	263	0	12163
24073	303	60	29	11794	0	12186
24074	150	45	11563	291	0	12049
24075	127	47	11759	134	0	12067
24076	97	36	285	11879	0	12297
24077	81	56	11968	273	0	12378
24078	11819	44	265	157	0	12285
24079	292	32	110	12036	0	12470
24080	142	38	74	12161	0	12415
24081	109	42	11882	330	0	12363
24082	74	11558	255	162	0	12049
24083	79	11996	99	129	0	12303
24084	69	292	85	11688	0	12134
24085	90	109	49	11833	0	12081
24086	76	67	11439	321	0	11903
24087	71	77	11607	140	0	11895
24088	76	62	296	11580	0	12014
24089	83	44	11431	294	0	11852
24090	11314	49	283	142	0	11788
24091	295	56	100	11287	0	11738
24092	11340	55	64	316	0	11775
24093	323	48	62	11249	0	11682
24094	144	48	56	11479	0	11727
24095	116	41	11148	364	0	11669
24096	79	11219	266	168	0	11732
24097	114	248	109	11207	0	11678
24098	71	99	11146	298	0	11614
24099	77	10838	239	142	0	11296
24100	79	211	124	10958	0	11372
24101	10883	93	74	277	0	11327
24102	240	49	10788	141	0	11218
24103	10181	38	228	110	0	10557
24104	247	34	10111	78	0	10470
24105	9497	25	256	81	0	9859
24106	226	9490	115	60	0	9891
24107	85	9214	66	67	0	9432
24108	89	310	58	8716	0	9173
24109	47	8733	60	191	0	9031
24110	8687	198	47	99	0	9031
24111	193	72	50	8697	0	9012
24112	88	52	34	8805	0	8979
24113	55	47	20	8903	0	9025
24114	41	41	8583	266	0	8931
24115	52	29	176	8570	0	8827
24116	35	42	8410	227	0	8714
24117	31	8173	195	114	0	8513
24118	7848	160	89	78	0	8175
24119	170	8056	49	64	0	8339
24120	8212	168	32	75	0	8487
24121	8299	60	46	51	0	8456
24122	8337	45	16	65	0	8463
24123	8278	28	46	50	0	8402
24124	241	36	8011	27	0	8315
24125	117	32	161	7981	0	8291
24126	83	50	63	7895	0	8091
24127	69	24	47	8147	0	8287
24128	7376	38	29	229	0	7672
24129	7450	29	31	106	0	7616
24130	195	7751	27	80	0	8053
24131	90	125	7378	57	0	7650
24132	69	44	7270	48	0	7431
24133	52	7142	172	49	0	7415
24134	40	7089	58	62	0	7249
24135	160	148	179	5924	0	6411
24136	27	31	20	5803	0	5881
24137	5892	22	17	91	0	6022
24138	77	5832	18	43	0	5970
24139	36	69	22	5934	0	6061
24140	33	25	6064	84	0	6206
24141	31	18	78	6154	0	6281
24142	30	16	25	6256	0	6327
24143	24	8	16	6343	0	6391
24144	24	12	19	6228	0	6283
24145	22	12	6082	108	0	6224
24146	16	5815	70	50	0	5951
24147	15	5817	30	28	0	5890
24148	5594	73	18	21	0	5706
24149	63	5527	10	27	0	5627
24150	21	5738	12	19	0	5790
24151	30	75	12	5740	0	5857
24152	21	22	13	5791	0	5847
24153	19	15	15	5767	0	5816
24154	14	16	5655	90	0	5775
24155	15	5638	59	39	0	5751
24156	21	69	16	5518	0	5624
24157	16	5647	13	62	0	5738
24158	5598	69	16	30	0	5713
24159	59	5601	13	27	0	5700
24160	5619	63	11	23	0	5716
24161	63	27	5565	17	0	5672
24162	5589	16	57	25	0	5687
24163	64	14	19	5686	0	5783
24164	25	12	5697	67	0	5801
24165	5615	16	56	23	0	5710
24166	5674	12	15	23	0	5724
24167	5714	15	17	27	0	5773
24168	80	9	14	5685	0	5788
24169	26	16	5661	62	0	5765
24170	5681	13	53	30	0	5777
24171	67	12	14	5822	0	5915
24172	21	15	15	5804	0	5855
24173	26	10	5899	66	0	6001
24174	17	5839	51	26	0	5933
24175	20	57	16	5684	0	5777
24176	9	5790	13	56	0	5868
24177	5713	50	13	28	0	5804
24178	5717	20	6	25	0	5768
24179	59	10	13	5667	0	5749
24180	5632	12	6	60	0	5710
24181	52	5620	12	20	0	5704
24182	5573	53	7	22	0	5655
24183	51	5632	10	23	0	5716
24184	25	57	10	5662	0	5754
24185	29	22	4	5591	0	5646
24186	16	5643	4	50	0	5713
24187	13	59	9	5579	0	5660
24188	20	16	5587	50	0	5673
24189	9	5353	34	21	0	5417
24190	5072	29	7	15	0	5123
24191	24	5071	7	13	0	5115
24192	7	22	10	5066	0	5105
24193	14	4	5086	23	0	5127
24194	9	14	15	5104	0	5142
24195	6	7	5	5112	0	5130
24196	4993	3	8	38	0	5042
24197	31	8	4994	11	0	5044
24198	6	5048	24	16	0	5094
24199	6	26	5216	11	0	5259
24200	4	3	5042	11	0	5060
24201	7	6	5001	4	0	5018
24202	34	69	47	4842	0	4992
24203	5042	2	26	42	0	5112
24204	35	5025	2	8	0	5070
24205	5125	36	1	11	0	5173
24206	5271	4	2	8	0	5285
24207	47	2	1	5157	0	5207
24208	6	5166	1	40	0	5213
24209	5178	37	2	16	0	5233
24210	41	5209	0	13	0	5263
24211	9	38	2	5155	0	5204
24212	3	9	2	5348	0	5362
24213	5	5353	2	43	0	5403
24214	8	39	1	5376	0	5424
24215	1	5	5301	42	0	5349
24216	1	5	5243	9	0	5258
24217	5	1	39	5349	0	5394
24218	6	5	5	5433	0	5449
24219	5	4	5211	40	0	5260
24220	7	2	5082	6	0	5097
24221	4843	3	43	10	0	4899
24222	38	5050	7	9	0	5104
24223	7	5353	5	8	0	5373
24224	6	45	4	5226	0	5281
24225	8	5	1	5301	0	5315
24226	7	5	1	5327	0	5340
24227	3	6	5273	46	0	5328
24228	8	5	5189	9	0	5211
24229	9	2	40	5390	0	5441
24230	1	6	5330	41	0	5378
24231	1	5286	45	9	0	5341
24232	5244	39	8	10	0	5301
24233	40	12	5222	5	0	5279
24234	9	3	5199	10	0	5221
24235	11	5	46	5335	0	5397
24236	6	12	5774	44	0	5836
24237	7	5923	50	20	0	6000
24238	12	51	18	6018	0	6099
24239	4	17	6085	60	0	6166
24240	3	5934	56	22	0	6015
24241	5885	61	19	21	0	5986
24242	56	27	17	5852	0	5952
24243	16	14	13	5927	0	5970
24244	5885	7	9	82	0	5983
24245	60	5874	9	34	0	5977
24246	5902	60	4	28	0	5994
24247	5930	16	8	9	0	5963
24248	5957	14	8	14	0	5993
24249	90	7	3	5887	0	5987
24250	5719	4	9	66	0	5798
24251	66	5461	12	19	0	5558
24252	28	5578	6	23	0	5635
24253	5821	65	10	16	0	5912
24254	68	34	10	5846	0	5958
24255	29	25	4	5861	0	5919
24256	32	8	9	5886	0	5935
24257	9	11	5689	96	0	5805
24258	8	5704	60	45	0	5817
24259	13	58	26	5836	0	5933
24260	5838	24	16	77	0	5955
24261	74	17	9	5828	0	5928
24262	24	12	5816	82	0	5934
24263	23	5851	57	28	0	5959
24264	5869	65	18	32	0	5984
24265	5876	22	20	25	0	5943
24266	5931	20	13	24	0	5988
24267	105	11	10	5954	0	6080
24268	47	16	5965	77	0	6105
24269	32	15	6081	38	0	6166
24270	23	6310	84	25	0	6442
24271	29	94	32	6273	0	6428
24272	24	30	18	6433	0	6505
24273	6155	19	11	118	0	6303
24274	94	17	9	6277	0	6397
24275	6409	9	8	122	0	6548
24276	111	17	6344	46	0	6518
24277	44	14	6470	36	0	6564
24278	44	9	109	6392	0	6554
24279	37	5	41	6556	0	6639
24280	25	7	30	6724	0	6786
24281	6890	12	17	155	0	7074
24282	7296	14	15	58	0	7383
24283	157	16	17	7341	0	7531
24284	56	10	7234	152	0	7452
24285	38	8	7421	65	0	7532
24286	24	7	159	7414	0	7604
24287	7504	8	56	171	0	7739
24288	150	14	43	7459	0	7666
24289	60	13	24	7648	0	7745
24290	36	13	7549	194	0	7792
24291	32	5	7552	79	0	7668
24292	7375	7	168	66	0	7616
24293	148	15	7525	44	0	7732
24294	61	17	161	7289	0	7528
24295	56	11	55	7499	0	7621
24296	7401	7	39	183	0	7630
24297	156	7286	31	84	0	7557
24298	7213	127	26	70	0	7436
24299	157	7002	35	35	0	7229
24300	6895	142	36	35	0	7108
24301	162	51	6779	43	0	7035
24302	6485	36	141	47	0	6709
24303	6600	15	45	49	0	6709
24304	171	27	36	6525	0	6759
24305	79	14	6510	136	0	6739
24306	57	17	126	6306	0	6506
24307	53	8	56	6374	0	6491
24308	23	6323	57	175	0	6578
24309	42	101	23	6211	0	6377
24310	35	6298	26	156	0	6515
24311	40	127	20	6330	0	6517
24312	6283	43	18	162	0	6506
24313	153	35	19	6324	0	6531
24314	61	27	6301	168	0	6557
24315	6302	23	131	70	0	6526
24316	153	16	6538	59	0	6766
24317	6554	21	151	53	0	6779
24318	6746	8	49	49	0	6852
24319	186	6639	49	48	0	6922
24320	82	6969	35	48	0	7134
24321	6924	154	36	40	0	7154
24322	7159	58	34	44	0	7295
24323	7019	43	34	41	0	7137
24324	7031	19	25	55	0	7130
24325	7051	21	28	45	0	7145
24326	224	27	13	6892	0	7156
24327	114	18	21	7074	0	7227
24328	78	26	6943	191	0	7238
24329	6906	9	139	88	0	7142
24330	188	20	57	6924	0	7189
24331	79	16	48	7074	0	7217
24332	76	12	6950	193	0	7231
24333	59	6635	140	107	0	6941
24334	55	6976	57	67	0	7155
24335	6806	174	47	64	0	7091
24336	6435	57	28	39	0	6559
24337	186	6088	23	39	0	6336
24338	79	6158	20	32	0	6289
24339	6174	139	32	26	0	6371
24340	6474	46	17	44	0	6581
24341	182	29	18	6343	0	6572
24342	80	23	22	6445	0	6570
24343	65	12	19	6612	0	6708
24344	6452	26	10	190	0	6678
24345	6565	17	13	87	0	6682
24346	182	21	22	6593	0	6818
24347	6785	15	22	160	0	6982
24348	175	31	6800	61	0	7067
24349	85	16	134	6867	0	7102
24350	69	16	6822	159	0	7066
24351	54	6786	143	74	0	7057
24352	49	153	51	6815	0	7068
24353	6778	48	32	161	0	7019
24354	170	29	31	6749	0	6979
24355	83	25	19	6831	0	6958
24356	57	20	6699	193	0	6969
24357	41	27	6704	89	0	6861
24358	53	6863	142	63	0	7121
24359	6890	130	56	42	0	7118
24360	6998	52	30	44	0	7124
24361	7032	22	18	41	0	7113
24362	7088	22	29	32	0	7171
24363	215	17	25	6937	0	7194
24364	89	18	19	7007	0	7133
24365	64	7025	24	167	0	7280
24366	7068	140	20	76	0	7304
24367	7070	48	14	53	0	7185
24368	199	25	6815	36	0	7075
24369	6344	14	114	46	0	6518
24370	157	6470	49	35	0	6711
24371	83	182	32	6265	0	6562
24372	51	6491	17	131	0	6690
24373	6442	129	19	63	0	6653
24374	156	6473	21	40	0	6690
24375	84	115	17	6328	0	6544
24376	61	41	15	6416	0	6533
24377	33	26	15	6284	0	6358
24378	40	6143	15	168	0	6366
24379	47	141	11	6145	0	6344
24380	49	74	6	6045	0	6174
24381	37	5540	9	144	0	5730
24382	27	5400	15	54	0	5496
24383	5115	86	13	26	0	5240
24384	79	5168	7	23	0	5277
24385	5037	69	11	18	0	5135
24386	82	35	5004	13	0	5134
24387	42	4945	62	11	0	5060
24388	4951	69	26	18	0	5064
24389	4921	26	9	24	0	4980
24390	92	13	4834	20	0	4959
24391	43	9	58	4816	0	4926
24392	19	15	4887	76	0	4997
24393	14	4852	67	36	0	4969
24394	4821	73	27	32	0	4953
24395	68	4821	13	19	0	4921
24396	33	71	7	4791	0	4902
24397	35	31	3	4881	0	4950
24398	19	18	4829	86	0	4952
24399	19	14	4694	37	0	4764
24400	4631	14	80	23	0	4748
24401	4818	22	22	17	0	4879
24402	4818	11	14	13	0	4856
24403	4817	14	6	14	0	4851
24404	94	4784	7	24	0	4909
24405	38	59	8	4794	0	4899
24406	27	30	9	4830	0	4896
24407	18	4894	8	78	0	4998
24408	4968	67	5	32	0	5072
24409	5006	24	11	27	0	5068
24410	92	22	4984	14	0	5112
24411	5006	7	63	18	0	5094
24412	84	17	23	4985	0	5109
24413	40	9	4927	63	0	5039
24414	24	19	66	4889	0	4998
24415	20	12	4926	76	0	5034
24416	23	7	4760	28	0	4818
24417	26	42	74	4586	0	4728
24418	10	4596	33	46	0	4685
24419	4606	49	22	19	0	4696
24420	4451	23	12	20	0	4506
24421	67	4587	7	11	0	4672
24422	29	4663	7	15	0	4714
24423	4738	56	15	15	0	4824
24424	4780	28	5	18	0	4831
24425	4814	9	8	18	0	4849
24426	4811	11	6	11	0	4839
24427	78	11	5	4848	0	4942
24428	34	10	4798	47	0	4889
24429	16	4762	46	21	0	4845
24430	4729	49	17	13	0	4808
24431	51	4829	9	8	0	4897
24432	4832	46	4	11	0	4893
24433	4833	18	5	10	0	4866
24434	58	9	4888	4	0	4959
24435	24	4984	39	7	0	5054
24436	13	48	21	4993	0	5075
24437	15	20	3	5075	0	5113
24438	21	6	8	4892	0	4927
24439	4971	5	4	56	0	5036
24440	4749	7	6	23	0	4785
24441	4766	6	4	13	0	4789
24442	56	4721	8	10	0	4795
24443	4624	41	2	5	0	4672
24444	46	4658	3	5	0	4712
24445	24	40	4651	7	0	4722
24446	5	4589	33	9	0	4636
24447	19	62	36	4322	0	4439
24448	12	7	10	4261	0	4290
24449	8	4	4231	33	0	4276
24450	12	5	26	4150	0	4193
24451	12	3	7	4212	0	4234
24452	4243	5	5	40	0	4293
24453	4173	2	4	15	0	4194
24454	4254	6	5	7	0	4272
24455	32	4262	4	8	0	4306
24456	4222	28	3	9	0	4262
24457	4094	10	2	6	0	4112
24458	39	4204	4	6	0	4253
24459	19	27	3	4187	0	4236
24460	11	8	5	4215	0	4239
24461	4194	4	3	36	0	4237
24462	31	2	4093	13	0	4139
24463	8	3956	23	9	0	3996
24464	11	42	2	3783	0	3838
24465	9	3738	5	24	0	3776
24466	7	3789	1	4	0	3801
24467	3809	21	10	5	0	3845
24468	3811	7	4	6	0	3828
24469	23	10	2	3852	0	3887
24470	5	8	4	3758	0	3775
24471	8	6	1	3770	0	3785
24472	7	2	2	3758	0	3769
24473	4	4	3693	24	0	3725
24474	4	3	3481	9	0	3497
24475	3	2	19	3713	0	3737
24476	4	7	3916	26	0	3953
24477	8	3986	22	9	0	4025
24478	4060	21	2	9	0	4092
24479	4126	2	5	9	0	4142
24480	30	6	3	4164	0	4203
24481	13	2	3	4195	0	4213
24482	13	4	4	4237	0	4258
24483	6	4315	3	31	0	4355
24484	4322	26	4	14	0	4366
24485	4363	6	2	18	0	4389
24486	37	5	4348	7	0	4397
24487	13	5	33	4616	0	4667
24488	9	7	4706	48	0	4770
24489	9	6	46	5050	0	5111
24490	14	9	4	5064	0	5091
24491	18	5	5	5028	0	5056
24492	24	3	6	5185	0	5218
24493	5193	6	6	79	0	5284
24494	5291	3	5	25	0	5324
24495	5396	6	1	22	0	5425
24496	99	5	3	5385	0	5492
24497	29	3	5331	81	0	5444
24498	5254	2	73	25	0	5354
24499	85	14	19	5354	0	5472
24500	5396	3	11	88	0	5498
24501	82	4	11	5407	0	5504
24502	23	5253	5	82	0	5363
24503	14	5546	6	27	0	5593
24504	22	88	4	5549	0	5663
24505	27	18	1	5562	0	5608
24506	14	11	1	5604	0	5630
24507	10	5484	4	86	0	5584
24508	5444	72	2	34	0	5552
24509	79	5477	10	17	0	5583
24510	19	76	5477	15	0	5587
24511	24	19	74	5441	0	5558
24512	13	5619	16	82	0	5730
24513	7	87	14	5595	0	5703
24514	21	14	8	5662	0	5705
24515	7	9	5584	116	0	5716
24516	5341	5	78	37	0	5461
24517	87	5747	17	29	0	5880
24518	5792	84	8	26	0	5910
24519	5969	22	8	17	0	6016
24520	6003	10	6	19	0	6038
24521	114	14	5739	16	0	5883
24522	39	6	84	5659	0	5788
24523	29	10	17	5704	0	5760
24524	16	9	5558	113	0	5696
24525	5281	8	82	34	0	5405
24526	92	7	5585	27	0	5711
24527	21	5	5428	25	0	5479
24528	9	5499	98	18	0	5624
24529	35	76	27	5519	0	5657
24530	16	25	5545	83	0	5669
24531	5260	8	81	34	0	5383
24532	5439	14	22	17	0	5492
24533	103	8	5444	16	0	5571
24534	33	11	87	5470	0	5601
24535	19	8	5559	90	0	5676
24536	15	5589	81	43	0	5728
24537	5817	83	27	28	0	5955
24538	5884	24	17	24	0	5949
24539	5990	13	10	16	0	6029
24540	117	14	14	5918	0	6063
24541	49	8	9	6046	0	6112
24542	23	7	5941	116	0	6087
24543	5886	10	92	40	0	6028
24544	108	6	31	5968	0	6113
24545	5921	5	10	112	0	6048
24546	106	6	5942	35	0	6089
24547	37	4	6063	24	0	6128
24548	27	7	110	5911	0	6055
24549	18	11	39	6165	0	6233
24550	24	10	6094	114	0	6242
24551	5983	9	96	40	0	6128
24552	109	7	29	6034	0	6179
24553	38	6230	11	106	0	6385
24554	6300	93	13	49	0	6455
24555	113	6348	17	23	0	6501
24556	6369	102	18	22	0	6511
24557	120	28	6502	24	0	6674
24558	38	10	6386	24	0	6458
24559	26	6531	101	27	0	6685
24560	6542	101	45	23	0	6711
24561	119	23	6513	25	0	6680
24562	6347	12	104	27	0	6490
24563	116	6501	36	27	0	6680
24564	49	99	29	6609	0	6786
24565	38	23	24	6632	0	6717
24566	25	6371	16	131	0	6543
24567	6795	105	15	45	0	6960
24568	6968	27	16	29	0	7040
24569	7048	20	16	24	0	7108
24570	145	15	6968	24	0	7152
24571	55	13	111	6961	0	7140
24572	36	12	42	7048	0	7138
24573	36	15	23	7190	0	7264
24574	33	11	7055	130	0	7229
24575	20	6860	112	52	0	7044
24576	6705	105	30	25	0	6865
24577	116	42	6719	19	0	6896
24578	6554	21	104	28	0	6707
24579	113	6651	35	21	0	6820
24580	6694	104	25	23	0	6846
24581	127	43	27	6587	0	6784
24582	6704	17	22	104	0	6847
24583	116	13	26	6671	0	6826
24584	44	14	6786	106	0	6950
24585	45	39	92	6689	0	6865
24586	28	20	6663	111	0	6822
24587	6152	11	81	42	0	6286
24588	89	6339	39	21	0	6488
24589	32	78	19	5899	0	6028
24590	24	6135	14	66	0	6239
24591	6106	60	25	35	0	6226
24592	6115	18	21	18	0	6172
24593	80	6028	15	13	0	6136
24594	6027	56	18	22	0	6123
24595	6129	17	22	28	0	6196
24596	77	11	10	6076	0	6174
24597	26	15	11	6147	0	6199
24598	6314	9	15	69	0	6407
24599	6439	4	10	35	0	6488
24600	84	14	13	6336	0	6447
24601	44	9	10	6677	0	6740
24602	6781	13	7	87	0	6888
24603	77	13	6696	37	0	6823
24604	6418	13	70	23	0	6524
24605	92	9	6546	19	0	6666
24606	39	6475	66	16	0	6596
24607	38	69	24	6436	0	6567
24608	18	19	6586	66	0	6689
24609	32	6699	61	25	0	6817
24610	6647	67	31	34	0	6779
24611	67	22	6664	25	0	6778
24612	6463	12	64	32	0	6571
24613	6693	14	21	15	0	6743
24614	6774	11	12	27	0	6824
24615	80	10	16	6597	0	6703
24616	43	6609	19	51	0	6722
24617	6601	56	10	34	0	6701
24618	80	14	6608	20	0	6722
24619	6147	13	57	29	0	6246
24620	72	11	6602	15	0	6700
24621	30	6522	64	19	0	6635
24622	24	50	23	6574	0	6671
24623	23	18	16	6565	0	6622
24624	21	6470	20	63	0	6574
24625	27	64	14	6606	0	6711
24626	28	17	6614	64	0	6723
24627	21	6632	59	27	0	6739
24628	29	63	16	6533	0	6641
24629	6518	22	16	70	0	6626
24630	6691	16	11	26	0	6744
24631	92	20	9	6762	0	6883
24632	37	6869	14	65	0	6985
24633	31	61	10	6875	0	6977
24634	34	19	16	6733	0	6802
24635	25	16	6439	85	0	6565
24636	20	6460	73	37	0	6590
24637	22	72	15	6356	0	6465
24638	18	22	6297	71	0	6408
24639	17	6226	58	41	0	6342
24640	25	72	18	6291	0	6406
24641	6302	15	13	77	0	6407
24642	66	6361	14	29	0	6470
24643	24	68	12	6421	0	6525
24644	6508	19	3	81	0	6611
24645	6573	17	16	31	0	6637
24646	6558	14	11	24	0	6607
24647	6462	13	9	40	0	6524
24648	79	16	11	6411	0	6517
24649	29	15	6438	69	0	6551
24650	32	20	58	6287	0	6397
24651	22	6369	17	66	0	6474
24652	6427	61	6	33	0	6527
24653	66	16	6247	24	0	6353
24654	6037	11	59	21	0	6128
24655	66	15	6114	18	0	6213
24656	39	10	53	6052	0	6154
24657	28	8	6042	52	0	6130
24658	25	14	49	5929	0	6017
24659	24	11	5932	59	0	6026
24660	19	10	63	5855	0	5947
24661	5940	12	17	73	0	6042
24662	60	6168	19	24	0	6271
24663	29	50	14	6233	0	6326
24664	25	19	15	6229	0	6288
24665	24	8	6395	66	0	6493
24666	17	15	6108	26	0	6166
24667	5998	18	60	37	0	6113
24668	63	6156	19	23	0	6261
24669	6143	44	15	28	0	6230
24670	6200	15	19	16	0	6250
24671	68	10	15	6162	0	6255
24672	28	6281	15	63	0	6387
24673	6420	52	17	32	0	6521
24674	6558	13	9	30	0	6610
24675	6614	13	12	29	0	6668
24676	6661	13	15	27	0	6716
24677	6607	7	15	29	0	6658
24678	75	11	6496	12	0	6594
24679	6454	9	51	22	0	6536
24680	69	13	6572	15	0	6669
24681	47	7	54	6479	0	6587
24682	28	8	26	6777	0	6839
24683	27	12	6628	71	0	6738
24684	6579	8	57	32	0	6676
24685	78	11	15	6891	0	6995
24686	39	12	11	7070	0	7132
24687	32	6	14	7165	0	7217
24688	28	9	10	7082	0	7129
24689	26	9	12	7160	0	7207
24690	27	5	7182	88	0	7302
24691	20	11	78	7119	0	7228
24692	21	5	7252	91	0	7369
24693	18	10	7178	42	0	7248
24694	7244	6	97	39	0	7386
24695	7547	4	32	34	0	7617
24696	7989	7	19	34	0	8049
24697	112	13	8156	27	0	8308
24698	38	5	8106	33	0	8182
24699	32	3	8293	26	0	8354
24700	28	8610	120	24	0	8782
24701	84	126	91	8422	0	8723
24702	8865	28	29	111	0	9033
24703	111	12	28	9225	0	9376
24704	47	9438	23	119	0	9627
24705	9581	97	19	60	0	9757
24706	129	39	19	9500	0	9687
24707	61	9671	20	127	0	9879
24708	38	108	24	9751	0	9921
24709	35	34	24	9734	0	9827
24710	9591	18	27	157	0	9793
24711	121	23	12	9583	0	9739
24712	55	18	9500	145	0	9718
24713	55	14	112	9411	0	9592
24714	29	9197	57	148	0	9431
24715	27	9500	39	70	0	9636
24716	39	141	30	9282	0	9492
24717	23	64	27	9236	0	9350
24718	33	9131	29	150	0	9343
24719	30	9127	20	100	0	9277
24720	32	9295	14	70	0	9411
24721	56	161	16	8766	0	8999
24722	35	9200	18	151	0	9404
24723	9135	145	31	70	0	9381
24724	119	78	9246	73	0	9516
24725	70	66	107	9065	0	9308
24726	51	9290	42	162	0	9545
24727	9213	132	31	119	0	9495
24728	128	77	9270	83	0	9558
24729	64	9233	120	80	0	9497
24730	9109	137	54	80	0	9380
24731	125	8990	33	49	0	9197
24732	46	9131	33	71	0	9281
24733	44	170	28	9031	0	9273
24734	40	9200	15	150	0	9405
24735	9158	158	22	88	0	9426
24736	115	98	19	9157	0	9389
24737	47	74	9066	149	0	9336
24738	47	70	9023	85	0	9225
24739	47	86	126	9049	0	9308
24740	37	78	9139	128	0	9382
24741	42	56	119	9159	0	9376
24742	8962	63	63	165	0	9253
24743	127	69	9005	77	0	9278
24744	77	44	111	8817	0	9049
24745	37	8823	72	139	0	9071
24746	52	123	42	9005	0	9222
24747	48	82	30	8991	0	9151
24748	43	8803	58	148	0	9052
24749	36	135	49	9125	0	9345
24750	35	95	32	9183	0	9345
24751	42	69	9028	168	0	9307
24752	25	8963	104	119	0	9211
24753	9008	141	60	96	0	9305
24754	114	86	58	9054	0	9312
24755	73	56	9088	152	0	9369
24756	50	63	123	9060	0	9296
24757	24	52	8995	175	0	9246
24758	8676	45	145	123	0	8989
24759	113	8962	93	84	0	9252
24760	73	119	64	9093	0	9349
24761	71	68	51	9192	0	9382
24762	8850	52	63	197	0	9162
24763	128	54	57	8879	0	9118
24764	73	53	8779	168	0	9073
24765	48	61	111	8466	0	8686
24766	42	8283	81	169	0	8575
24767	29	8533	54	143	0	8759
24768	33	8695	57	91	0	8876
24769	49	183	34	8598	0	8864
24770	40	112	8451	176	0	8779
24771	30	8418	117	124	0	8689
24772	8280	141	77	99	0	8597
24773	114	8345	42	94	0	8595
24774	8341	128	46	108	0	8623
24775	8337	75	57	97	0	8566
24776	149	63	8309	88	0	8609
24777	8456	57	125	91	0	8729
24778	8771	52	72	94	0	8989
24779	8365	69	53	92	0	8579
24780	8787	58	37	102	0	8984
24781	159	53	8633	80	0	8925
24782	8549	56	106	83	0	8794
24783	8842	58	68	74	0	9042
24784	139	8985	39	70	0	9233
24785	80	128	37	8739	0	8984
24786	66	93	20	8699	0	8878
24787	41	8694	43	150	0	8928
24788	8646	135	29	102	0	8912
24789	118	8703	48	57	0	8926
24790	8481	134	30	60	0	8705
24791	8605	77	29	39	0	8750
24792	150	8685	28	39	0	8902
24793	109	123	31	8614	0	8877
24794	86	59	8713	112	0	8970
24795	63	8483	101	55	0	8702
24796	79	192	56	7757	0	8084
24797	38	7885	36	83	0	8042
24798	49	8153	21	51	0	8274
24799	67	184	33	7702	0	7986
24800	36	46	7812	82	0	7976
24801	26	7438	66	48	0	7578
24802	20	7286	37	29	0	7372
24803	6672	65	41	16	0	6794
24804	46	24	13	6811	0	6894
24805	25	18	4	6914	0	6961
24806	16	12	2	7076	0	7106
24807	16	11	7178	83	0	7288
24808	13	8	65	7308	0	7394
24809	7	7522	17	88	0	7634
24810	7872	77	9	34	0	7992
24811	92	23	8	7886	0	8009
24812	23	11	7842	96	0	7972
24813	7955	13	82	37	0	8087
24814	102	15	26	8197	0	8340
24815	32	9	8626	105	0	8772
24816	16	13	8678	33	0	8740
24817	8807	7	123	28	0	8965
24818	9125	10	32	26	0	9193
24819	9078	4	23	22	0	9127
24820	9159	10	18	19	0	9206
24821	149	16	9058	14	0	9237
24822	55	9149	106	28	0	9338
24823	9195	110	39	31	0	9375
24824	128	9112	18	28	0	9286
24825	9093	112	17	22	0	9244
24826	125	9129	13	20	0	9287
24827	64	124	16	9075	0	9279
24828	39	38	20	9127	0	9224
24829	36	34	13	9061	0	9144
24830	32	8894	12	141	0	9079
24831	23	9067	13	51	0	9154
24832	33	131	9	8762	0	8935
24833	18	8834	17	133	0	9002
24834	27	127	8825	41	0	9020
24835	33	49	112	8792	0	8986
24836	21	32	8839	138	0	9030
24837	8689	32	118	51	0	8890
24838	8805	28	42	28	0	8903
24839	146	26	8751	36	0	8959
24840	60	28	8709	26	0	8823
24841	47	23	144	8637	0	8851
24842	34	30	8678	135	0	8877
24843	28	24	138	8349	0	8539
24844	31	7905	61	130	0	8127
24845	37	141	22	8655	0	8855
24846	33	50	30	8757	0	8870
24847	32	24	29	8739	0	8824
24848	14	34	8552	173	0	8773
24849	19	30	131	8420	0	8600
24850	38	25	42	8511	0	8616
24851	38	29	23	8326	0	8416
24852	25	8472	37	146	0	8680
24853	8493	121	31	77	0	8722
24854	8515	40	33	61	0	8649
24855	8496	24	35	52	0	8607
24856	159	29	34	8395	0	8617
24857	63	23	8329	145	0	8560
24858	92	27	8204	63	0	8386
24859	44	8331	132	52	0	8559
24860	8196	122	47	61	0	8426
24861	122	8276	43	54	0	8495
24862	8341	123	41	49	0	8554
24863	126	8338	30	66	0	8560
24864	8285	142	41	50	0	8518
24865	142	8575	25	49	0	8791
24866	77	155	24	8582	0	8838
24867	56	61	8533	147	0	8797
24868	54	41	8607	88	0	8790
24869	56	26	159	8539	0	8780
24870	45	37	62	8591	0	8735
24871	43	39	50	8705	0	8837
24872	52	38	8544	181	0	8815
24873	45	41	137	8468	0	8691
24874	8318	33	62	180	0	8593
24875	8342	28	42	107	0	8519
24876	166	8169	55	59	0	8449
24877	8003	128	35	65	0	8231
24878	154	7940	30	62	0	8186
24879	7907	140	47	37	0	8131
24880	7960	60	35	46	0	8101
24881	7805	41	38	47	0	7931
24882	191	42	7791	38	0	8062
24883	82	36	7695	48	0	7861
24884	7550	22	150	42	0	7764
24885	7745	32	67	36	0	7880
24886	195	24	36	7694	0	7949
24887	89	27	36	7861	0	8013
24888	63	28	34	7973	0	8098
24889	61	33	31	8025	0	8150
24890	44	35	35	8146	0	8260
24891	7913	37	25	204	0	8179
24892	161	33	12	7847	0	8053
24893	59	37	7676	168	0	7940
24894	7458	18	122	91	0	7689
24895	7642	26	50	67	0	7785
24896	176	7508	30	61	0	7775
24897	68	7562	32	46	0	7708
24898	7050	111	28	44	0	7233
24899	129	7272	25	38	0	7464
24900	7155	116	44	38	0	7353
24901	7608	31	29	39	0	7707
24902	7656	17	21	45	0	7739
24903	169	23	16	7378	0	7586
24904	62	7305	15	130	0	7512
24905	7312	107	10	48	0	7477
24906	149	28	15	7260	0	7452
24907	53	17	13	6982	0	7065
24908	6540	11	7	134	0	6692
24909	109	6478	5	49	0	6641
24910	31	91	7	6317	0	6446
24911	6352	20	6	118	0	6496
24912	101	6408	4	31	0	6544
24913	6413	89	4	27	0	6533
24914	97	28	6021	21	0	6167
24915	5827	13	60	15	0	5915
24916	97	5932	16	10	0	6055
24917	5832	79	23	22	0	5956
24918	5813	15	5	18	0	5851
24919	95	5929	3	10	0	6037
24920	5925	75	2	14	0	6016
24921	93	5857	2	16	0	5968
24922	6076	77	1	13	0	6167
24923	99	25	0	6080	0	6204
24924	32	15	1	6135	0	6183
24925	25	7	3	6178	0	6213
24926	16	12	6005	96	0	6129
24927	15	9	71	6009	0	6104
24928	19	7	6019	90	0	6135
24929	20	8	78	5984	0	6090
24930	15	6052	17	86	0	6170
24931	11	77	12	6150	0	6250
24932	11	19	6142	90	0	6262
24933	16	17	6254	21	0	6308
24934	15	11	83	6259	0	6368
24935	6248	9	20	99	0	6376
24936	6287	6	18	27	0	6338
24937	97	6347	14	21	0	6479
24938	30	79	3	6422	0	6534
24939	24	18	6547	81	0	6670
24940	20	10	77	6559	0	6666
24941	19	11	6592	88	0	6710
24942	6510	11	81	46	0	6648
24943	93	9	23	6675	0	6800
24944	37	11	6603	88	0	6739
24945	27	10	81	6581	0	6699
24946	22	8	22	6714	0	6766
24947	21	10	6649	104	0	6784
24948	18	11	83	6623	0	6735
24949	6663	7	25	108	0	6803
24950	6753	7	18	43	0	6821
24951	108	4	12	6802	0	6926
24952	6825	8	17	101	0	6951
24953	111	10	6840	43	0	7004
24954	43	6	6776	26	0	6851
24955	6863	10	102	23	0	6998
24956	7083	10	31	29	0	7153
24957	117	8	20	6981	0	7126
24958	50	6	18	7098	0	7172
24959	28	16	6972	117	0	7133
24960	34	9	88	6763	0	6894
24961	24	6877	28	168	0	7097
24962	7047	80	20	43	0	7190
24963	7401	20	14	29	0	7464
24964	133	7362	17	23	0	7535
24965	7116	101	9	30	0	7256
24966	7177	25	10	26	0	7238
24967	126	7174	15	21	0	7336
24968	7176	113	10	31	0	7330
24969	127	7212	12	19	0	7370
24970	7254	113	17	26	0	7410
24971	132	24	7263	23	0	7442
24972	45	23	104	7244	0	7416
24973	39	16	25	7471	0	7551
24974	28	11	17	7817	0	7873
24975	7771	12	14	165	0	7962
24976	143	9	11	8001	0	8164
24977	42	15	7981	156	0	8194
24978	7970	13	126	48	0	8157
24979	152	9	30	7979	0	8170
24980	35	7794	26	149	0	8004
24981	29	8092	16	49	0	8186
24982	43	139	20	7902	0	8104
24983	33	33	18	7919	0	8003
24984	33	18	19	7975	0	8045
24985	32	10	7676	169	0	7887
24986	18	7565	124	64	0	7771
24987	7410	114	25	49	0	7598
24988	7373	28	25	41	0	7467
24989	138	7220	23	23	0	7404
24990	38	7363	16	23	0	7440
24991	52	129	23	7183	0	7387
24992	28	28	7164	123	0	7343
24993	6913	32	113	39	0	7097
24994	7140	16	27	41	0	7224
24995	135	8	19	7026	0	7188
24996	44	11	16	7077	0	7148
24997	6849	9	15	137	0	7010
24998	121	7	6787	44	0	6959
24999	6513	11	102	48	0	6674
25000	119	6602	25	26	0	6772
25001	35	80	15	6091	0	6221
25002	14	6125	6	101	0	6246
25003	6184	82	13	33	0	6312
25004	105	16	15	6087	0	6223
25005	29	11	8	6091	0	6139
25006	31	6047	7	95	0	6180
25007	6116	82	13	26	0	6237
25008	6151	13	8	34	0	6206
25009	110	21	6054	16	0	6201
25010	32	11	5816	20	0	5879
25011	5888	7	89	21	0	6005
25012	90	14	5959	18	0	6081
25013	27	9	5797	13	0	5846
25014	5773	10	89	20	0	5892
25015	91	10	6426	16	0	6543
25016	33	6	117	6515	0	6671
25017	20	7	34	6680	0	6741
25018	7032	7	21	163	0	7223
25019	148	15	7154	51	0	7368
25020	7526	3	142	40	0	7711
25021	188	10	46	7539	0	7783
25022	7536	13	35	163	0	7747
25023	7640	5	12	59	0	7716
25024	7675	6	13	60	0	7754
25025	265	8	11	7504	0	7788
25026	7618	6	13	180	0	7817
25027	242	5	13	7580	0	7840
25028	101	2	12	7700	0	7815
25029	92	5	14	7721	0	7832
25030	72	6	4	7756	0	7838
25031	7518	6	10	263	0	7797
25032	7605	11	8	122	0	7746
25033	249	7	7428	82	0	7766
25034	7511	5	169	64	0	7749
25035	7713	4	53	66	0	7836
25036	244	5	33	7482	0	7764
25037	111	7386	17	207	0	7721
25038	7496	162	20	76	0	7754
25039	230	53	19	7298	0	7600
25040	7240	34	32	204	0	7510
25041	246	7180	20	72	0	7518
25042	7300	161	15	57	0	7533
25043	250	58	13	7163	0	7484
25044	89	7132	14	190	0	7425
25045	7293	170	10	80	0	7553
25046	203	7119	12	80	0	7414
25047	84	7501	4	62	0	7651
25048	7472	204	11	54	0	7741
25049	211	98	7358	40	0	7707
25050	7458	49	155	46	0	7708
25051	243	29	49	7402	0	7723
25052	108	30	7463	177	0	7778
25053	104	24	163	7354	0	7645
25054	69	28	53	7589	0	7739
25055	74	21	7442	229	0	7766
25056	7383	18	227	111	0	7739
25057	230	18	67	7475	0	7790
25058	111	12	45	7597	0	7765
25059	79	11	33	7620	0	7743
25060	7459	11	27	286	0	7783
25061	214	12	7320	155	0	7701
25062	99	13	7383	105	0	7600
25063	96	13	187	7117	0	7413
25064	69	13	7085	206	0	7373
25065	7008	10	169	118	0	7305
25066	181	7010	70	109	0	7370
25067	7035	137	66	60	0	7298
25068	231	54	40	6825	0	7150
25069	109	6843	44	175	0	7171
25070	103	163	37	6821	0	7124
25071	67	6916	37	202	0	7222
25072	92	188	27	6961	0	7268
25073	68	79	6794	215	0	7156
25074	65	66	6498	102	0	6731
25075	63	6481	165	100	0	6809
25076	6233	141	87	80	0	6541
25077	152	73	50	6186	0	6461
25078	95	60	17	6283	0	6455
25079	6250	35	31	200	0	6516
25080	6289	28	43	110	0	6470
25081	206	31	40	6226	0	6503
25082	123	30	6120	163	0	6436
25083	88	6106	131	98	0	6423
25084	76	134	54	6194	0	6458
25085	75	60	48	6150	0	6333
25086	69	6285	36	176	0	6566
25087	6370	132	26	112	0	6640
25088	173	65	6320	91	0	6649
25089	90	59	142	6305	0	6596
25090	79	40	56	6340	0	6515
25091	40	45	6260	218	0	6563
25092	50	28	144	6366	0	6588
25093	6388	41	73	206	0	6708
25094	6420	43	61	105	0	6629
25095	6518	25	44	105	0	6692
25096	211	6372	46	85	0	6714
25097	6761	121	38	81	0	7001
25098	221	55	40	6707	0	7023
25099	110	46	47	6709	0	6912
25100	93	7166	33	221	0	7513
25101	7648	158	32	125	0	7963
25102	7991	74	33	90	0	8188
25103	8086	67	23	71	0	8247
25104	8225	42	22	75	0	8364
25105	8233	35	21	74	0	8363
25106	284	31	7970	79	0	8364
25107	8132	37	164	65	0	8398
25108	8254	40	70	68	0	8432
25109	8150	25	68	53	0	8296
25110	317	20	46	7935	0	8318
25111	191	25	43	7936	0	8195
25112	147	20	7637	224	0	8028
25113	6811	29	165	137	0	7142
25114	205	7438	72	94	0	7809
25115	103	6928	39	59	0	7129
25116	84	123	6712	46	0	6965
25117	66	6559	100	51	0	6776
25118	36	6324	44	44	0	6448
25119	101	232	90	5472	0	5895
25120	15	5631	17	68	0	5731
25121	5573	81	6	25	0	5685
25122	5514	31	14	18	0	5577
25123	93	19	7	5443	0	5562
25124	38	17	5412	70	0	5537
25125	5338	13	57	32	0	5440
25126	87	11	5407	18	0	5523
25127	38	10	5429	21	0	5498
25128	43	8	78	5280	0	5409
25129	32	3	30	5408	0	5473
25130	17	9	5432	79	0	5537
25131	15	5275	74	39	0	5403
25132	18	5506	23	34	0	5581
25133	5517	78	26	23	0	5644
25134	5567	29	21	15	0	5632
25135	76	24	5481	15	0	5596
25136	5437	16	54	17	0	5524
25137	5712	8	19	25	0	5764
25138	86	12	18	5669	0	5785
25139	51	10	10	5705	0	5776
25140	50	11	7	5723	0	5791
25141	5749	4	8	89	0	5850
25142	5776	6	8	46	0	5836
25143	5828	8	11	29	0	5876
25144	96	3	10	5813	0	5922
25145	53	6	5694	66	0	5819
25146	5642	6	54	30	0	5732
25147	5610	7	15	30	0	5662
25148	92	9	23	5508	0	5632
25149	46	5572	17	68	0	5703
25150	52	57	5	5545	0	5659
25151	39	5593	15	78	0	5725
25152	32	83	8	5445	0	5568
25153	27	5612	10	75	0	5724
25154	5566	68	10	34	0	5678
25155	82	30	12	5547	0	5671
25156	33	5532	4	77	0	5646
25157	34	64	5496	22	0	5616
25158	5415	19	59	39	0	5532
25159	75	21	19	5473	0	5588
25160	34	5434	24	65	0	5557
25161	36	57	9	5321	0	5423
25162	26	5242	9	76	0	5353
25163	489	5029	11	28	0	5557
25164	5454	76	13	35	0	5578
25165	5549	32	10	27	0	5618
25166	75	30	5535	18	0	5658
25167	5508	18	56	26	0	5608
25168	5575	13	18	20	0	5626
25169	75	5525	20	15	0	5635
25170	50	56	11	5545	0	5662
25171	46	19	9	5530	0	5604
25172	34	19	5467	70	0	5590
25173	32	14	5343	30	0	5419
25174	5445	12	65	27	0	5549
25175	5523	11	32	27	0	5593
25176	5524	6	22	26	0	5578
25177	91	9	5410	19	0	5529
25178	49	9	63	5371	0	5492
25179	5428	7	22	66	0	5523
25180	81	6	16	5407	0	5510
25181	26	10	5321	70	0	5427
25182	5167	3	61	36	0	5267
25183	69	8	5450	20	0	5547
25184	29	5315	60	20	0	5424
25185	5362	53	27	12	0	5454
25186	69	14	5321	19	0	5423
25187	26	21	57	5253	0	5357
25188	5280	11	26	66	0	5383
25189	71	8	17	5320	0	5416
25190	5378	8	12	75	0	5473
25191	70	6	12	5330	0	5418
25192	5435	8	4	82	0	5529
25193	5420	5	11	36	0	5472
25194	5426	7	6	26	0	5465
25195	5313	6	6	29	0	5354
25196	98	14	8	5301	0	5421
25197	34	3	5051	50	0	5138
25198	34	9	5006	17	0	5066
25199	19	4989	49	22	0	5079
25200	19	4493	19	10	0	4541
25201	3991	35	102	22	0	4150
25202	34	9	6	3844	0	3893
25203	6	2	3868	21	0	3897
25204	6	3	3902	2	0	3913
25205	6	8	22	3907	0	3943
25206	3913	1	2	23	0	3939
25207	21	3963	6	8	0	3998
25208	4156	19	3	13	0	4191
25209	24	3	5	4227	0	4259
25210	7	1	3	4236	0	4247
25211	5	2	2	4256	0	4265
25212	6	4	4230	22	0	4262
25213	7	3	4143	6	0	4159
25214	8	4179	23	6	0	4216
25215	9	21	7	4297	0	4334
25216	4266	5	4	31	0	4306
25217	27	8	4189	7	0	4231
25218	8	4	4247	5	0	4264
25219	8	4	33	4328	0	4373
25220	8	4	5	4448	0	4465
25221	9	2	7	4489	0	4507
25222	8	3	7	4825	0	4843
25223	4891	1	6	59	0	4957
25224	56	5	4	4953	0	5018
25225	4953	4	2	62	0	5021
25226	60	2	5002	13	0	5077
25227	8	5018	53	14	0	5093
25228	16	51	11	5060	0	5138
25229	5	7	5132	60	0	5204
25230	11	6	5080	13	0	5110
25231	7	5162	60	13	0	5242
25232	17	55	20	5087	0	5179
25233	12	8	11	5126	0	5157
25234	9	8	5176	69	0	5262
25235	5103	2	63	25	0	5193
25236	60	8	17	5195	0	5280
25237	18	4	14	5092	0	5128
25238	12	11	5208	71	0	5302
25239	6	5195	71	24	0	5296
25240	15	5806	15	18	0	5854
25241	5887	73	17	19	0	5996
25242	80	19	10	5932	0	6041
25243	6227	8	15	94	0	6344
25244	102	5	6212	29	0	6348
25245	31	12	92	6181	0	6316
25246	6197	8	18	115	0	6338
25247	6270	6	17	38	0	6331
25248	117	4	7	6232	0	6360
25249	32	9	6179	103	0	6323
25250	21	5	6276	29	0	6331
25251	16	14	110	6220	0	6360
25252	17	10	6242	98	0	6367
25253	6073	9	95	36	0	6213
25254	93	6149	35	31	0	6308
25255	6235	89	26	21	0	6371
25256	6348	17	15	36	0	6416
25257	125	17	10	6304	0	6456
25258	40	4	23	6393	0	6460
25259	6362	10	18	118	0	6508
25260	106	9	12	6392	0	6519
25261	35	15	6343	110	0	6503
25262	23	6341	103	39	0	6506
25263	25	97	27	6273	0	6422
25264	26	26	23	6316	0	6391
25265	21	21	12	6352	0	6406
25266	20	6	6184	131	0	6341
25267	23	6121	102	51	0	6297
25268	30	90	24	6227	0	6371
25269	17	17	6174	120	0	6328
25270	24	13	104	6156	0	6297
25271	6146	13	30	126	0	6315
25272	114	15	24	6196	0	6349
25273	41	8	6135	122	0	6306
25274	6083	11	102	60	0	6256
25275	95	6160	42	47	0	6344
25276	34	6379	29	30	0	6472
25277	6396	107	25	48	0	6576
25278	109	36	6472	35	0	6652
25279	51	24	95	6444	0	6614
25280	41	13	37	6598	0	6689
25281	22	15	6580	124	0	6741
25282	23	6562	101	56	0	6742
25283	40	87	35	6081	0	6243
25284	29	33	6500	113	0	6675
25285	31	19	101	6499	0	6650
25286	6480	14	50	122	0	6666
25287	102	22	6618	52	0	6794
25288	47	14	99	6621	0	6781
25289	37	16	37	6686	0	6776
25290	25	17	6535	142	0	6719
25291	33	19	112	6367	0	6531
25292	30	5825	50	126	0	6031
25293	33	95	37	6070	0	6235
25294	24	6437	27	131	0	6619
25295	6434	95	29	70	0	6628
25296	6321	32	29	49	0	6431
25297	124	23	6272	53	0	6472
25298	51	16	6184	41	0	6292
25299	32	18	6143	39	0	6232
25300	26	6099	114	49	0	6288
25301	32	88	62	6222	0	6404
25302	29	33	6300	117	0	6479
25303	29	25	111	6083	0	6248
25304	27	22	45	6154	0	6248
25305	21	25	6157	136	0	6339
25306	32	15	105	6175	0	6327
25307	29	22	39	6051	0	6141
25308	26	5908	30	134	0	6098
25309	35	89	31	5985	0	6140
25310	23	29	34	6116	0	6202
25311	25	24	6017	143	0	6209
25312	33	23	106	5947	0	6109
25313	25	17	5976	133	0	6151
25314	16	15	5882	69	0	5982
25315	5792	17	122	57	0	5988
25316	92	21	57	5734	0	5904
25317	32	5818	30	106	0	5986
25318	27	5881	30	64	0	6002
25319	30	118	35	5787	0	5970
25320	21	43	5787	112	0	5963
25321	29	5730	96	69	0	5924
25322	24	73	44	5476	0	5617
25323	20	22	5644	91	0	5777
25324	19	5693	71	51	0	5834
25325	5867	67	34	47	0	6015
25326	5843	21	32	47	0	5943
25327	5916	21	25	35	0	5997
25328	82	19	22	6144	0	6267
25329	31	19	22	6170	0	6242
25330	25	17	24	6117	0	6183
25331	13	13	6004	118	0	6148
25332	5937	13	77	62	0	6089
25333	83	12	34	5995	0	6124
25334	29	14	5784	93	0	5920
25335	5872	20	78	44	0	6014
25336	6033	16	33	43	0	6125
25337	97	26	5266	47	0	5436
25338	5856	16	59	38	0	5969
25339	74	6067	26	40	0	6207
25340	32	46	5644	20	0	5742
25341	5359	26	81	33	0	5499
25342	54	5465	25	30	0	5574
25343	17	33	12	5124	0	5186
25344	5	5180	8	40	0	5233
25345	16	36	3	5234	0	5289
25346	7	12	5248	40	0	5307
25347	4805	4	41	33	0	4883
25348	39	5	5263	18	0	5325
25349	18	5088	34	16	0	5156
25350	3	5148	24	7	0	5182
25351	5079	37	10	18	0	5144
25352	31	17	5092	10	0	5150
25353	12	11	30	5038	0	5091
25354	7	10	5179	33	0	5229
25355	13	5230	30	13	0	5286
25356	12	26	16	5024	0	5078
25357	1	5238	13	24	0	5276
25358	5391	26	9	16	0	5442
25359	5420	12	8	13	0	5453
25360	5403	7	0	14	0	5424
25361	37	8	5344	8	0	5397
25362	14	7	5153	6	0	5180
25363	5209	2	37	15	0	5263
25364	34	0	5515	8	0	5557
25365	16	2	39	5307	0	5364
25366	5	5447	15	32	0	5499
25367	5629	30	5	27	0	5691
25368	5619	19	4	13	0	5655
25369	5786	3	3	19	0	5811
25370	51	4	4	5891	0	5950
25371	19	1	6	5952	0	5978
25372	5921	5	7	57	0	5990
25373	40	5878	10	20	0	5948
25374	5894	36	3	10	0	5943
25375	38	13	7	5830	0	5888
25376	19	2	1	5844	0	5866
25377	5710	5	3	53	0	5771
25378	37	5641	1	16	0	5695
25379	5668	34	1	12	0	5715
25380	39	5693	2	7	0	5741
25381	5630	35	3	15	0	5683
25382	47	11	3	5874	0	5935
25383	5999	8	0	42	0	6049
25384	6292	4	2	26	0	6324
25385	6864	6	4	19	0	6893
25386	71	7084	2	13	0	7170
25387	35	49	6975	8	0	7067
25388	6976	23	51	11	0	7061
25389	7106	10	27	12	0	7155
25390	80	7090	9	2	0	7181
25391	46	61	5	7153	0	7265
25392	33	26	7	7172	0	7238
25393	7210	11	6	84	0	7311
25394	70	8	2	7342	0	7422
25395	37	5	7342	67	0	7451
25396	24	13	7229	38	0	7304
25397	7516	5	80	20	0	7621
25398	71	7	36	7581	0	7695
25399	44	2	12	7657	0	7715
25400	17	9	12	7755	0	7793
25401	17	10	7868	91	0	7986
25402	21	1	66	7835	0	7923
25403	21	7	32	7992	0	8052
25404	20	2	11	8150	0	8183
25405	8046	4	15	111	0	8176
25406	82	4	12	8149	0	8247
25407	37	8	8317	85	0	8447
25408	8610	10	70	51	0	8741
25409	93	7	8971	24	0	9095
25410	9152	4	91	39	0	9286
25411	9242	6	35	26	0	9309
25412	138	5	21	9413	0	9577
25413	58	9485	13	118	0	9674
25414	40	111	13	9659	0	9823
25415	37	34	15	9741	0	9827
25416	26	9737	10	163	0	9936
25417	9808	107	12	82	0	10009
25418	122	9815	19	51	0	10007
25419	9897	124	17	41	0	10079
25420	10009	33	18	41	0	10101
25421	165	26	11	9926	0	10128
25422	77	13	14	9901	0	10005
25423	43	11	9556	162	0	9772
25424	29	16	9285	75	0	9405
25425	9158	10	133	67	0	9368
25426	9347	11	50	59	0	9467
25427	157	9004	27	37	0	9225
25428	75	104	20	8888	0	9087
25429	51	35	9295	115	0	9496
25430	53	72	108	9313	0	9546
25431	9285	19	47	147	0	9498
25432	9210	11	25	71	0	9317
25433	144	9223	15	49	0	9431
25434	65	102	18	9276	0	9461
25435	58	47	16	9343	0	9464
25436	38	26	17	9343	0	9424
25437	40	21	8989	160	0	9210
25438	8455	21	96	86	0	8658
25439	8740	15	46	61	0	8862
25440	146	23	8843	36	0	9048
25441	80	8823	110	40	0	9053
25442	8832	94	42	49	0	9017
25443	8884	46	29	36	0	8995
25444	1095	29	7746	44	0	8914
25445	84	25	8954	37	0	9100
25446	65	16	123	8988	0	9192
25447	50	20	9061	122	0	9253
25448	8897	22	117	73	0	9109
25449	9074	25	52	50	0	9201
25450	9178	12	36	43	0	9269
25451	176	18	32	8867	0	9093
25452	87	9215	20	131	0	9453
25453	9416	101	20	72	0	9609
25454	9316	37	31	61	0	9445
25455	156	31	9177	46	0	9410
25456	95	19	8969	35	0	9118
25457	9026	15	124	52	0	9217
25458	150	30	53	9114	0	9347
25459	79	26	9107	113	0	9325
25460	65	9076	112	71	0	9324
25461	62	103	47	9149	0	9361
25462	9116	43	43	133	0	9335
25463	133	9269	34	74	0	9510
25464	87	112	34	9080	0	9313
25465	82	9018	31	118	0	9249
25466	60	9257	26	65	0	9408
25467	48	117	39	9247	0	9451
25468	52	47	24	9264	0	9387
25469	53	9202	43	155	0	9453
25470	9122	102	30	72	0	9326
25471	141	48	9135	44	0	9368
25472	9105	40	114	46	0	9305
25473	160	37	41	9322	0	9560
25474	83	30	39	9361	0	9513
25475	72	22	37	9397	0	9528
25476	63	18	24	9416	0	9521
25477	48	32	9381	159	0	9620
25478	54	23	117	9467	0	9661
25479	54	37	43	9624	0	9758
25480	47	9918	41	155	0	10161
25481	47	119	10047	88	0	10301
25482	41	10245	120	67	0	10473
25483	48	142	10380	49	0	10619
25484	63	10265	124	40	0	10492
25485	71	152	92	9585	0	9900
25486	9500	36	46	132	0	9714
25487	127	9491	27	54	0	9699
25488	64	108	29	9619	0	9820
25489	51	40	9652	129	0	9872
25490	33	9773	123	52	0	9981
25491	9706	120	45	69	0	9940
25492	9795	44	32	60	0	9931
25493	142	9726	33	42	0	9943
25494	72	123	9584	38	0	9817
25495	9433	44	116	36	0	9629
25496	141	55	41	9678	0	9915
25497	9584	33	38	153	0	9808
25498	138	9689	26	58	0	9911
25499	55	9822	24	48	0	9949
25500	55	139	9674	40	0	9908
25501	9514	47	127	38	0	9726
25502	137	56	45	9620	0	9858
25503	9602	19	36	133	0	9790
25504	131	9615	26	56	0	9828
25505	9630	114	15	56	0	9815
25506	9547	47	20	60	0	9674
25507	143	39	9535	32	0	9749
25508	50	8956	98	20	0	9124
25509	39	9045	27	30	0	9141
25510	43	149	22	8435	0	8649
25511	18	8343	9	74	0	8444
25512	8408	77	17	36	0	8538
25513	66	8374	12	23	0	8475
25514	37	87	14	8150	0	8288
25515	20	8095	7	69	0	8191
25516	13	7948	5	25	0	7991
25517	16	8131	10	20	0	8177
25518	35	98	23	8072	0	8228
25519	25	27	8	8130	0	8190
25520	19	21	7	8056	0	8103
25521	10	7936	10	89	0	8045
25522	11	73	7864	26	0	7974
25523	14	36	7673	17	0	7740
25524	7703	19	69	24	0	7815
25525	60	22	25	7920	0	8027
25526	30	22	7952	62	0	8066
25527	21	19	7908	30	0	7978
25528	9	8179	71	22	0	8281
25529	23	64	27	7800	0	7914
25530	18	41	14	7910	0	7983
25531	7874	26	16	82	0	7998
25532	58	17	11	7895	0	7981
25533	29	17	12	7851	0	7909
25534	17	28	7974	81	0	8100
25535	13	18	60	7969	0	8060
25536	28	12	30	8210	0	8280
25537	13	20	8196	84	0	8313
25538	20	13	8125	39	0	8197
25539	11	8135	77	36	0	8259
25540	17	63	8117	23	0	8220
25541	16	34	71	8042	0	8163
25542	54	36	55	6529	0	6674
25543	15	21	8190	83	0	8309
25544	13	8066	64	42	0	8185
25545	7755	67	30	33	0	7885
25546	50	7834	22	37	0	7943
25547	23	69	19	7870	0	7981
25548	14	37	24	7922	0	7997
25549	14	7908	16	96	0	8034
25550	17	65	19	7926	0	8027
25551	13	33	19	7935	0	8000
25552	15	29	7581	87	0	7712
25553	14	7527	58	53	0	7652
25554	17	68	33	7592	0	7710
25555	14	32	7527	81	0	7654
25556	22	23	67	7471	0	7583
25557	21	26	36	7460	0	7543
25558	17	28	19	7570	0	7634
25559	25	21	20	7533	0	7599
25560	16	23	18	7426	0	7483
25561	13	7516	19	95	0	7643
25562	7447	60	13	61	0	7581
25563	58	40	7319	36	0	7453
25564	6784	16	64	54	0	6918
25565	62	23	7580	33	0	7698
25566	25	7961	67	41	0	8094
25567	70	70	7844	27	0	8011
25568	18	7981	73	36	0	8108
25569	32	69	38	7480	0	7619
25570	18	38	27	7770	0	7853
25571	17	7882	15	84	0	7998
25572	8	8095	19	53	0	8175
25573	8135	75	17	39	0	8266
25574	8234	41	17	43	0	8335
25575	8254	27	14	28	0	8323
25576	8358	20	10	35	0	8423
25577	87	26	19	8236	0	8368
25578	37	8164	8	67	0	8276
25579	8070	58	13	48	0	8189
25580	52	32	9	7781	0	7874
25581	7520	20	10	62	0	7612
25582	7313	9	8	44	0	7374
25583	50	6979	6	15	0	7050
25584	22	6741	6	14	0	6783
25585	11	7025	7	11	0	7054
25586	18	91	23	6735	0	6867
25587	9	6977	9	53	0	7048
25588	6986	30	5	24	0	7045
25589	7196	15	7	15	0	7233
25590	7138	8	2	20	0	7168
25591	7276	9	2	14	0	7301
25592	7363	4	4	18	0	7389
25593	53	12	7654	4	0	7723
25594	7649	6	42	15	0	7712
25595	58	5	7762	7	0	7832
25596	7698	7	41	11	0	7757
25597	62	4	19	7755	0	7840
25598	30	7	7255	49	0	7341
25599	23	3	7940	24	0	7990
25600	14	8502	60	18	0	8594
25601	8651	53	30	21	0	8755
25602	8912	17	17	19	0	8965
25603	82	9738	9	8	0	9837
25604	56	80	6	10958	0	11100
25605	11786	29	7	121	0	11943
25606	153	28	11924	36	0	12141
25607	49	11890	127	38	0	12104
25608	11707	134	49	33	0	11923
25609	146	11851	31	26	0	12054
25610	86	162	20	11432	0	11700
25611	55	11923	31	117	0	12126
25612	39	199	19	11533	0	11790
25613	35	11622	3	158	0	11818
25614	29	11989	7	65	0	12090
25615	11760	191	9	64	0	12024
25616	11990	100	11	43	0	12144
25617	187	75	11827	36	0	12125
25618	105	50	11499	14	0	11668
25619	59	51	11756	17	0	11883
25620	81	47	199	11801	0	12128
25621	66	34	11943	143	0	12186
25622	51	37	199	11820	0	12107
25623	42	38	89	11834	0	12003
25624	29	11891	67	195	0	12182
25625	11904	148	38	121	0	12211
25626	154	11926	42	81	0	12203
25627	73	194	35	12078	0	12380
25628	81	83	26	12148	0	12338
25629	69	80	28	12137	0	12314
25630	52	60	11981	229	0	12322
25631	50	46	170	11979	0	12245
25632	57	45	69	12136	0	12307
25633	59	47	55	12217	0	12378
25634	31	44	11760	266	0	12101
25635	31	11696	172	140	0	12039
25636	11594	182	68	136	0	11980
25637	11332	89	53	112	0	11586
25638	193	11630	44	80	0	11947
25639	109	204	48	11576	0	11937
25640	90	92	37	11814	0	12033
25641	73	77	11600	243	0	11993
25642	67	11551	169	141	0	11928
25643	51	187	93	11636	0	11967
25644	43	89	11667	236	0	12035
25645	47	86	174	11602	0	11909
25646	57	52	88	11656	0	11853
25647	40	71	11629	246	0	11986
25648	45	67	176	11538	0	11826
25649	62	41	91	11498	0	11692
25650	71	47	11563	267	0	11948
25651	44	74	188	11597	0	11903
25652	55	58	92	11360	0	11565
25653	52	31	86	11754	0	11923
25654	38	45	11526	300	0	11909
25655	39	51	200	11556	0	11846
25656	11387	32	91	301	0	11811
25657	11371	35	96	186	0	11688
25658	203	11396	62	174	0	11835
25659	11494	163	68	140	0	11865
25660	212	79	11674	110	0	12075
25661	116	68	177	11716	0	12077
25662	107	47	89	11814	0	12057
25663	63	58	88	11924	0	12133
25664	11524	43	60	313	0	11940
25665	175	11374	66	209	0	11824
25666	82	158	57	10786	0	11083
25667	67	10930	57	243	0	11297
25668	10793	199	51	167	0	11210
25669	197	10877	38	136	0	11248
25670	10703	203	50	131	0	11087
25671	191	10560	48	123	0	10922
25672	97	10548	47	124	0	10816
25673	102	228	56	10440	0	10826
25674	76	120	37	10513	0	10746
25675	56	107	50	10478	0	10691
25676	57	73	33	10459	0	10622
25677	63	71	10173	303	0	10610
25678	36	10115	171	194	0	10516
25679	43	179	67	9765	0	10054
25680	42	9986	72	250	0	10350
25681	718	204	9321	145	0	10388
25682	57	104	159	9981	0	10301
25683	56	87	71	10210	0	10424
25684	49	77	9996	259	0	10381
25685	46	9826	182	162	0	10216
25686	45	161	89	9872	0	10167
25687	52	76	9755	254	0	10137
25688	32	9700	182	166	0	10080
25689	46	206	75	9467	0	9794
25690	44	80	9423	233	0	9780
25691	39	85	9126	135	0	9385
25692	38	8979	179	141	0	9337
25693	37	9418	97	92	0	9644
25694	50	193	107	9495	0	9845
25695	46	95	59	10015	0	10215
25696	32	95	9765	252	0	10144
25697	9479	69	185	156	0	9889
25698	9596	71	72	134	0	9873
25699	194	56	9256	117	0	9623
25700	86	8727	170	103	0	9086
25701	66	8670	79	73	0	8888
25702	56	8391	64	70	0	8581
25703	70	6680	95	94	0	6939
25704	183	351	137	6100	0	6771
25705	25	36	23	6740	0	6824
25706	11	28	2	6672	0	6713
25707	14	16	5	6764	0	6799
25708	4	6748	2	173	0	6927
25709	12	120	4	6729	0	6865
25710	5	6742	7	148	0	6902
25711	13	138	4	6838	0	6993
25712	6762	44	5	169	0	6980
25713	119	33	6	6833	0	6991
25714	42	6836	8	153	0	7039
25715	36	123	5	6990	0	7154
25716	16	51	6	7260	0	7333
25717	16	43	3	7389	0	7451
25718	7195	31	4	228	0	7458
25719	133	41	6	7391	0	7571
25720	48	33	7186	211	0	7478
25721	33	7484	127	121	0	7765
25722	25	150	46	7716	0	7937
25723	35	69	26	8044	0	8174
25724	40	41	15	8151	0	8247
25725	7886	39	17	269	0	8211
25726	165	40	7728	138	0	8071
25727	76	37	146	7509	0	7768
25728	41	7657	52	208	0	7958
25729	35	192	32	7716	0	7975
25730	7436	71	20	243	0	7770
25731	149	7575	16	132	0	7872
25732	60	179	12	7640	0	7891
25733	48	75	12	7699	0	7834
25734	18	7585	11	267	0	7881
25735	30	180	13	7740	0	7963
25736	29	84	8	7883	0	8004
25737	23	70	7609	289	0	7991
25738	33	7615	153	159	0	7960
25739	7640	186	55	140	0	8021
25740	174	88	7616	116	0	7994
25741	7554	64	168	114	0	7900
25742	210	46	7553	136	0	7945
25743	87	43	183	7663	0	7976
25744	7580	42	74	271	0	7967
25745	193	48	43	7724	0	8008
25746	7642	55	37	297	0	8031
25747	7762	53	27	176	0	8018
25748	7696	60	23	153	0	7932
25749	251	7622	32	123	0	8028
25750	132	182	27	7650	0	7991
25751	91	90	27	7817	0	8025
25752	74	71	42	7833	0	8020
25753	60	43	7571	353	0	8027
25754	75	52	185	7731	0	8043
25755	7607	47	86	312	0	8052
25756	7773	43	53	192	0	8061
25757	263	60	7583	137	0	8043
25758	7647	45	186	142	0	8020
25759	7814	53	76	118	0	8061
25760	264	67	72	7428	0	7831
25761	7388	50	29	303	0	7770
25762	7473	45	34	206	0	7758
25763	274	52	42	7400	0	7768
25764	7381	52	50	289	0	7772
25765	7486	44	49	175	0	7754
25766	279	58	65	7331	0	7733
25767	181	69	5689	281	0	6220
25768	7137	49	142	152	0	7480
25769	250	44	7234	155	0	7683
25770	168	58	7308	121	0	7655
25771	128	7193	237	157	0	7715
25772	127	184	117	7230	0	7658
25773	141	89	74	7413	0	7717
25774	138	58	53	7389	0	7638
25775	135	46	7195	340	0	7716
25776	136	47	7198	187	0	7568
25777	124	7217	236	158	0	7735
25778	121	189	110	7139	0	7559
25779	133	66	89	7384	0	7672
25780	107	59	76	7490	0	7732
25781	118	35	7187	357	0	7697
25782	122	7091	222	203	0	7638
25783	122	182	99	7254	0	7657
25784	131	80	7225	269	0	7705
25785	136	54	7246	167	0	7603
25786	7207	48	259	145	0	7659
25787	7289	43	141	126	0	7599
25788	7377	43	96	128	0	7644
25789	309	47	75	7145	0	7576
25790	190	31	7023	286	0	7530
25791	154	6870	201	186	0	7411
25792	125	7137	112	177	0	7551
25793	133	181	6393	109	0	6816
25794	133	191	208	5842	0	6374
25795	112	85	112	5511	0	5820
25796	101	5363	75	212	0	5751
25797	110	5617	58	127	0	5912
25798	5525	153	62	108	0	5848
25799	5663	63	65	90	0	5881
25800	5717	39	52	100	0	5908
25801	5609	38	48	97	0	5792
25802	5313	26	46	100	0	5485
25803	233	5026	50	95	0	5404
25804	107	4167	46	53	0	4373
25805	52	3672	42	32	0	3798
25806	3569	94	124	48	0	3835
25807	129	64	43	3438	0	3674
25808	56	15	24	3469	0	3564
25809	3403	9	29	111	0	3552
25810	93	3426	23	53	0	3595
25811	62	63	22	3438	0	3585
25812	40	24	25	3502	0	3591
25813	45	18	28	3462	0	3553
25814	3294	9	21	87	0	3411
25815	88	11	23	3304	0	3426
25816	50	18	3073	69	0	3210
25817	3009	13	59	30	0	3111
25818	71	16	29	2992	0	3108
25819	33	14	2962	64	0	3073
25820	29	2915	53	29	0	3026
25821	18	2726	18	26	0	2788
25822	2514	55	66	22	0	2657
25823	2448	16	21	16	0	2501
25824	29	2554	6	11	0	2600
25825	21	26	1	2659	0	2707
25826	2758	3	4	35	0	2800
25827	36	12	5	2883	0	2936
25828	14	4	1	3026	0	3045
25829	13	0	5	3042	0	3060
25830	9	4	8	3038	0	3059
25831	7	2992	3	62	0	3064
25832	12	31	5	3027	0	3075
25833	9	8	3	3061	0	3081
25834	13	10	2	3069	0	3094
25835	8	8	2938	53	0	3007
25836	5	2974	36	29	0	3044
25837	6	43	10	3004	0	3063
25838	4	12	2973	48	0	3037
25839	5	8	2827	16	0	2856
25840	1	2961	37	14	0	3013
25841	2924	35	16	21	0	2996
25842	33	9	20	2964	0	3026
25843	2959	10	11	37	0	3017
25844	35	2978	3	17	0	3033
25845	20	34	3	3009	0	3066
25846	2941	11	2	49	0	3003
25847	3008	10	2	18	0	3038
25848	43	11	3	2994	0	3051
25849	22	2	2	2981	0	3007
25850	21	3	2971	44	0	3039
25851	13	1	32	2954	0	3000
25852	4	5	11	3037	0	3057
25853	2960	2	7	58	0	3027
25854	30	2987	10	23	0	3050
25855	11	28	2949	25	0	3013
25856	2879	11	24	24	0	2938
25857	40	2994	8	11	0	3053
25858	13	31	7	3004	0	3055
25859	2985	12	12	36	0	3045
25860	38	10	4	2951	0	3003
25861	10	11	3	2981	0	3005
25862	11	3	2939	52	0	3005
25863	14	6	28	2945	0	2993
25864	2961	2	9	56	0	3028
25865	33	3	9	2975	0	3020
25866	2935	5	10	42	0	2992
25867	33	2892	4	29	0	2958
25868	22	2953	4	12	0	2991
25869	11	35	3	2979	0	3028
25870	15	20	1	2974	0	3010
25871	2891	13	1	46	0	2951
25872	29	2934	1	27	0	2991
25873	2956	28	3	26	0	3013
25874	2967	15	2	20	0	3004
25875	45	9	0	2950	0	3004
25876	2957	9	2	35	0	3003
25877	53	2	2860	11	0	2926
25878	21	7	29	2882	0	2939
25879	12	4	2925	45	0	2986
25880	17	3	33	2952	0	3005
25881	2901	3	17	48	0	2969
25882	2918	3	7	32	0	2960
25883	42	2911	14	15	0	2982
25884	21	33	2	2937	0	2993
25885	25	9	4	2942	0	2980
25886	21	2936	3	46	0	3006
25887	12	41	2	3031	0	3086
25888	7	12	3	3046	0	3068
25889	7	2984	4	56	0	3051
25890	2911	38	2	35	0	2986
25891	2923	10	2	32	0	2967
25892	45	12	7	2907	0	2971
25893	18	16	4	2920	0	2958
25894	24	5	2893	49	0	2971
25895	24	7	28	2870	0	2929
25896	7	2845	8	50	0	2910
25897	2902	32	11	28	0	2973
25898	34	13	10	2890	0	2947
25899	11	15	3	2826	0	2855
25900	2763	13	8	47	0	2831
25901	46	2751	4	26	0	2827
25902	18	36	1	2827	0	2882
25903	22	10	2	2816	0	2850
25904	16	2793	4	51	0	2864
25905	2785	39	2	32	0	2858
25906	42	14	2761	22	0	2839
25907	15	13	2764	19	0	2811
25908	14	12	38	2791	0	2855
25909	19	7	2784	39	0	2849
25910	2724	8	43	21	0	2796
25911	41	1	17	2808	0	2867
25912	18	6	2874	46	0	2944
25913	16	9	2893	21	0	2939
25914	15	2976	35	23	0	3049
25915	2962	30	17	21	0	3030
25916	33	3053	14	16	0	3116
25917	3084	34	13	17	0	3148
25918	3110	22	5	10	0	3147
25919	46	3027	7	9	0	3089
25920	3020	35	3	10	0	3068
25921	3025	10	3	9	0	3047
25922	44	8	3031	11	0	3094
25923	26	90	25	2893	0	3034
25924	16	2793	11	23	0	2843
25925	11	2750	2	9	0	2772
25926	40	45	18	2591	0	2694
25927	2505	14	11	44	0	2574
25928	21	3	0	2470	0	2494
25929	4	3	4	2574	0	2585
25930	3	0	0	2658	0	2661
25931	1	2794	1	24	0	2820
25932	4	21	2	2940	0	2967
25933	3	3	3113	32	0	3151
25934	3013	4	27	9	0	3053
25935	3189	1	6	9	0	3205
25936	36	3138	4	4	0	3182
25937	3162	30	3	5	0	3200
25938	40	7	3	3220	0	3270
25939	11	4	3203	33	0	3251
25940	3157	2	31	10	0	3200
25941	36	3252	6	2	0	3296
25942	11	37	2	3242	0	3292
25943	3337	5	2	36	0	3380
25944	36	3307	2	11	0	3356
25945	9	3403	5	7	0	3424
25946	3388	38	5	10	0	3441
25947	36	13	3313	4	0	3366
25948	3348	6	32	9	0	3395
25949	38	8	5	3344	0	3395
25950	10	8	3	3356	0	3377
25951	12	3	3337	45	0	3397
25952	14	3	3295	10	0	3322
25953	7	4	36	3378	0	3425
25954	5	2	3337	44	0	3388
25955	4	1	3359	14	0	3378
25956	5	3	41	3360	0	3409
25957	7	3	10	3407	0	3427
25958	3402	2	12	42	0	3458
25959	39	2	8	3407	0	3456
25960	3402	1	4	46	0	3453
25961	38	3402	4	13	0	3457
25962	15	36	4	3463	0	3518
25963	7	10	3534	41	0	3592
25964	3507	6	31	18	0	3562
25965	3618	4	7	9	0	3638
25966	3629	7	3	9	0	3648
25967	3589	5	4	11	0	3609
25968	3577	4	5	7	0	3593
25969	51	9	3	3494	0	3557
25970	20	5	3481	37	0	3543
25971	19	3	3432	9	0	3463
25972	15	2	3493	6	0	3516
25973	3431	4	43	10	0	3488
25974	3564	2	14	9	0	3589
25975	48	5	9	3492	0	3554
25976	17	3578	14	37	0	3646
25977	14	38	10	3625	0	3687
25978	11	9	3622	47	0	3689
25979	9	4	3550	17	0	3580
25980	3465	7	48	10	0	3530
25981	43	6	3732	15	0	3796
25982	16	5	40	3759	0	3820
25983	3878	3	13	43	0	3937
25984	3712	11	10	21	0	3754
25985	3958	2	6	16	0	3982
25986	3970	11	7	8	0	3996
25987	59	4	3880	12	0	3955
25988	3818	4	46	15	0	3883
25989	53	3887	20	3	0	3963
25990	34	33	10	3970	0	4047
25991	20	15	3989	40	0	4064
25992	29	8	36	3972	0	4045
25993	27	7	4058	50	0	4142
25994	14	9	46	4008	0	4077
25995	17	8	21	4068	0	4114
25996	13	10	4012	56	0	4091
25997	15	6	52	3979	0	4052
25998	4044	2	19	59	0	4124
25999	53	7	12	4055	0	4127
26000	17	9	9	4117	0	4152
26001	4060	10	7	60	0	4137
26002	50	4068	11	30	0	4159
26003	4115	39	9	20	0	4183
26004	53	4131	14	15	0	4213
26005	4262	42	10	25	0	4339
26006	55	14	4253	10	0	4332
26007	29	6	51	4229	0	4315
26008	26	9	17	4260	0	4312
26009	4226	4	13	64	0	4307
26010	53	4177	16	29	0	4275
26011	28	42	12	4129	0	4211
26012	12	10	17	4116	0	4155
26013	16	3971	13	57	0	4057
26014	3949	39	8	36	0	4032
26015	50	3959	14	17	0	4040
26016	30	45	7	3891	0	3973
26017	19	17	4	3808	0	3848
26018	19	3743	12	53	0	3827
26019	3738	43	8	30	0	3819
26020	54	14	3678	20	0	3766
26021	3591	10	44	16	0	3661
26022	54	3631	18	14	0	3717
26023	32	41	10	3625	0	3708
26024	3654	13	11	51	0	3729
26025	60	5	9	3665	0	3739
26026	32	8	6	3673	0	3719
26027	3671	5	8	62	0	3746
26028	52	3596	9	20	0	3677
26029	19	3617	7	17	0	3660
26030	3556	38	12	12	0	3618
26031	36	14	3510	15	0	3575
26032	22	3294	24	10	0	3350
26033	22	30	39	3269	0	3360
26034	5	10	3579	22	0	3616
26035	9	11	30	3447	0	3497
26036	3500	2	8	34	0	3544
26037	31	3573	3	15	0	3622
26038	11	30	2	3458	0	3501
26039	6	3550	2	24	0	3582
26040	3578	32	1	18	0	3629
26041	3672	9	1	10	0	3692
26042	38	3725	2	3	0	3768
26043	18	34	1	3702	0	3755
26044	7	3762	1	36	0	3806
26045	3821	42	0	16	0	3879
26046	3890	14	4	8	0	3916
26047	63	12	3	3843	0	3921
26048	28	8	0	3885	0	3921
26049	13	5	3797	56	0	3871
26050	3626	7	38	27	0	3698
26051	45	1	3771	13	0	3830
26052	23	5	47	3732	0	3807
26053	3748	1	16	48	0	3813
26054	40	3814	9	21	0	3884
26055	3669	43	3	21	0	3736
26056	45	26	3486	14	0	3571
26057	3622	14	28	8	0	3672
26058	55	3763	9	14	0	3841
26059	3807	45	6	8	0	3866
26060	49	3909	4	18	0	3980
26061	28	51	7	3887	0	3973
26062	21	26	3820	44	0	3911
26063	20	14	3680	22	0	3736
26064	15	12	55	3731	0	3813
26065	18	7	3761	48	0	3834
26066	20	11	50	3736	0	3817
26067	19	10	19	3750	0	3798
26068	13	9	3847	63	0	3932
26069	3430	7	46	43	0	3526
26070	3844	11	18	19	0	3892
26071	65	3777	13	8	0	3863
26072	3804	40	3	14	0	3861
26073	52	22	3	3793	0	3870
26074	22	12	3921	49	0	4004
26075	19	7	49	3914	0	3989
26076	15	7	21	3948	0	3991
26077	3889	8	13	62	0	3972
26078	48	3827	9	32	0	3916
26079	27	3851	5	22	0	3905
26080	19	50	13	3896	0	3978
26081	13	25	10	3776	0	3824
26082	20	3758	7	54	0	3839
26083	18	46	8	3707	0	3779
26084	16	23	3	3695	0	3737
26085	15	3664	9	52	0	3740
26086	3648	38	9	31	0	3726
26087	43	20	7	3648	0	3718
26088	18	3665	16	45	0	3744
26089	17	40	6	3659	0	3722
26090	3632	16	6	54	0	3708
26091	39	3607	12	25	0	3683
26092	3655	38	6	23	0	3722
26093	3667	17	3	32	0	3719
26094	59	19	7	3720	0	3805
26095	3822	12	5	54	0	3893
26096	3901	12	4	40	0	3957
26097	3931	15	7	25	0	3978
26098	3932	14	3	23	0	3972
26099	71	7	11	3918	0	4007
26100	30	11	9	3969	0	4019
26101	20	10	3907	73	0	4010
26102	20	8	39	3962	0	4029
26103	23	11	14	3993	0	4041
26104	19	18	3909	67	0	4013
26105	3804	17	45	33	0	3899
26106	66	7	11	3930	0	4014
26107	28	7	3992	66	0	4093
26108	3952	17	52	34	0	4055
26109	76	9	4397	30	0	4512
26110	28	4560	68	32	0	4688
26111	28	4816	20	23	0	4887
26112	23	66	15	5142	0	5246
26113	18	29	5664	83	0	5794
26114	5738	18	79	45	0	5880
26115	6081	6	23	45	0	6155
26116	121	9	6005	20	0	6155
26117	6047	14	80	26	0	6167
26118	6161	5	26	37	0	6229
26119	106	6162	31	23	0	6322
26120	6180	78	14	23	0	6295
26121	108	26	22	6152	0	6308
26122	45	21	6217	84	0	6367
26123	44	17	74	5944	0	6079
26124	21	6232	38	79	0	6370
26125	36	6390	27	42	0	6495
26126	6361	90	23	34	0	6508
26127	6337	33	21	24	0	6415
26128	6374	28	23	16	0	6441
26129	133	21	17	6290	0	6461
26130	74	29	17	6117	0	6237
26131	49	6127	21	116	0	6313
26132	6110	87	28	56	0	6281
26133	123	6180	27	42	0	6372
26134	5899	69	24	30	0	6022
26135	109	5867	41	29	0	6046
26136	5899	77	30	23	0	6029
26137	5762	42	12	23	0	5839
26138	129	44	18	5740	0	5931
26139	88	5879	19	73	0	6059
26140	85	66	5654	46	0	5851
26141	5560	32	69	54	0	5715
26142	87	5436	35	47	0	5605
26143	47	95	5635	34	0	5811
26144	46	58	5642	23	0	5769
26145	60	46	66	5473	0	5645
26146	66	31	23	5456	0	5576
26147	54	5645	11	68	0	5778
26148	5779	73	9	49	0	5910
26149	102	33	5	5734	0	5874
26150	63	5760	4	82	0	5909
26151	58	5970	11	35	0	6074
26152	51	88	5916	29	0	6084
26153	56	51	5892	19	0	6018
26154	5839	54	64	18	0	5975
26155	107	39	5945	18	0	6109
26156	66	28	63	5886	0	6043
26157	42	39	20	6053	0	6154
26158	39	38	6001	94	0	6172
26159	44	39	71	5921	0	6075
26160	55	25	39	5615	0	5734
26161	5860	39	27	93	0	6019
26162	5957	35	53	37	0	6082
26163	91	28	50	5871	0	6040
26164	40	5780	42	89	0	5951
26165	30	6037	37	55	0	6159
26166	6071	87	39	40	0	6237
26167	89	34	6014	45	0	6182
26168	37	31	70	6000	0	6138
26169	6129	56	28	100	0	6313
26170	6180	56	34	44	0	6314
26171	95	39	43	6163	0	6340
26172	52	36	6160	87	0	6335
26173	71	37	5850	44	0	6002
26174	5788	32	114	43	0	5977
26175	5955	25	67	53	0	6100
26176	110	5924	58	65	0	6157
26177	64	6095	66	47	0	6272
26178	6186	84	52	67	0	6389
26179	6259	43	30	82	0	6414
26180	133	36	33	6347	0	6549
26181	99	19	36	6426	0	6580
26182	75	23	32	6459	0	6589
26183	6361	48	19	127	0	6555
26184	138	57	30	6386	0	6611
26185	89	40	6402	100	0	6631
26186	6328	44	81	48	0	6501
26187	138	37	39	6417	0	6631
26188	89	46	6425	97	0	6657
26189	6313	38	79	66	0	6496
26190	5840	40	47	86	0	6013
26191	106	6562	57	54	0	6779
26192	81	6697	45	41	0	6864
26193	90	98	6167	47	0	6402
26194	6502	51	66	57	0	6676
26195	130	6693	34	36	0	6893
26196	95	103	6206	37	0	6441
26197	6448	52	72	37	0	6609
26198	148	6810	22	51	0	7031
26199	67	98	6761	63	0	6989
26200	6603	58	74	64	0	6799
26201	140	6778	18	62	0	6998
26202	70	80	24	6731	0	6905
26203	6696	28	29	117	0	6870
26204	94	6702	38	73	0	6907
26205	70	90	37	6610	0	6807
26206	6598	20	31	118	0	6767
26207	79	20	6571	59	0	6729
26208	59	6378	78	32	0	6547
26209	54	55	6172	35	0	6316
26210	35	62	56	5878	0	6031
26211	24	25	5825	51	0	5925
26212	18	5389	39	25	0	5471
26213	11	4961	19	4	0	4995
26214	24	45	9	4806	0	4884
26215	10	4	1	4642	0	4657
26216	6	2	4	4685	0	4697
26217	4	3	4781	28	0	4816
26218	10	2	23	4796	0	4831
26219	4777	1	5	32	0	4815
26220	4748	3	5	9	0	4765
26221	26	6	4868	5	0	4905
26222	8	4802	23	6	0	4839
26223	4801	21	4	9	0	4835
26224	23	4741	4	12	0	4780
26225	4764	21	3	19	0	4807
26226	4784	3	1	12	0	4800
26227	28	1	4766	5	0	4800
26228	10	4859	18	8	0	4895
26229	6	21	7	4900	0	4934
26230	6	7	4923	23	0	4959
26231	4777	5	23	11	0	4816
26232	24	7	7	4948	0	4986
26233	12	3	4873	22	0	4910
26234	4812	5	23	5	0	4845
26235	28	6	5068	3	0	5105
26236	12	2	26	5201	0	5241
26237	5286	5	6	36	0	5333
26238	32	5433	8	8	0	5481
26239	15	34	5527	1	0	5577
26240	5485	10	40	13	0	5548
26241	5937	0	9	8	0	5954
26242	58	6058	4	9	0	6129
26243	21	51	2	6091	0	6165
26244	9	16	1	6075	0	6101
26245	6033	5	1	70	0	6109
26246	54	4	3	6094	0	6155
26247	17	5	6092	59	0	6173
26248	17	5	50	6019	0	6091
26249	6035	0	17	67	0	6119
26250	53	5991	12	16	0	6072
26251	18	51	1	5816	0	5886
26252	7	5891	2	50	0	5950
26253	5968	59	3	24	0	6054
26254	60	19	1	6260	0	6340
26255	26	10	1	6359	0	6396
26256	10	6354	4	83	0	6451
26257	7	64	6285	34	0	6390
26258	14	25	66	6225	0	6330
26259	10	9	20	6359	0	6398
26260	11	4	14	6330	0	6359
26261	7	6287	3	101	0	6398
26262	10	68	6278	32	0	6388
26263	5	31	6308	14	0	6358
26264	6346	12	91	12	0	6461
26265	6476	6	27	15	0	6524
26266	97	4	6531	14	0	6646
26267	6438	9	73	21	0	6541
26268	85	5	6711	7	0	6808
26269	6517	4	83	16	0	6620
26270	85	6769	37	12	0	6903
26271	6953	73	19	23	0	7068
26272	95	25	7066	9	0	7195
26273	38	19	7183	9	0	7249
26274	24	4	105	7751	0	7884
26275	7931	9	39	116	0	8095
26276	116	8412	24	34	0	8586
26277	42	125	9116	20	0	9303
26278	42	29	165	9344	0	9580
26279	24	18	41	9653	0	9736
26280	9420	13	32	213	0	9678
26281	9531	11	13	68	0	9623
26282	217	11	10	9429	0	9667
26283	9469	5	17	186	0	9677
26284	199	11	9310	55	0	9575
26285	65	13	172	9264	0	9514
26286	48	10	43	9542	0	9643
26287	9440	5	34	232	0	9711
26288	9491	12	13	86	0	9602
26289	224	13	22	9370	0	9629
26290	9386	5	18	201	0	9610
26291	202	18	9152	72	0	9444
26292	67	9100	174	55	0	9396
26293	55	159	9180	26	0	9420
26294	46	57	181	9248	0	9532
26295	9103	23	43	199	0	9368
26296	185	9068	32	68	0	9353
26297	69	172	28	8984	0	9253
26298	50	52	28	8834	0	8964
26299	30	8876	24	216	0	9146
26300	47	175	17	8975	0	9214
26301	52	75	15	9015	0	9157
26302	56	35	17	9103	0	9211
26303	46	16	25	9085	0	9172
26304	46	18	17	8995	0	9076
26305	47	8736	25	258	0	9066
26306	42	173	26	8887	0	9128
26307	48	50	22	8940	0	9060
26308	42	29	8628	258	0	8957
26309	33	8581	172	121	0	8907
26310	47	173	50	8670	0	8940
26311	44	61	29	8761	0	8895
26312	49	35	27	8665	0	8776
26313	33	8463	31	266	0	8793
26314	36	173	8475	115	0	8799
26315	46	63	178	8631	0	8918
26316	42	28	8519	230	0	8819
26317	45	28	8443	105	0	8621
26318	38	24	215	8454	0	8731
26319	8441	28	81	243	0	8793
26320	195	27	49	8486	0	8757
26321	76	30	33	8405	0	8544
26322	46	8338	32	250	0	8666
26323	35	168	31	8551	0	8785
26324	44	55	29	8702	0	8830
26325	41	38	8503	281	0	8863
26326	30	8471	170	141	0	8812
26327	29	168	63	8616	0	8876
26328	8372	70	40	244	0	8726
26329	179	41	8379	113	0	8712
26330	67	28	185	8369	0	8649
26331	50	34	67	8530	0	8681
26332	8266	34	38	286	0	8624
26333	185	8220	34	154	0	8593
26334	8069	186	28	106	0	8389
26335	183	8023	29	105	0	8340
26336	62	182	24	7955	0	8223
26337	7776	60	33	257	0	8126
26338	185	45	7686	121	0	8037
26339	68	7414	158	108	0	7748
26340	60	7517	63	99	0	7739
26341	7122	179	58	92	0	7451
26342	161	61	36	6910	0	7168
26343	58	6835	37	214	0	7144
26344	51	7073	34	112	0	7270
26345	42	195	21	7026	0	7284
26346	51	65	25	7118	0	7259
26347	6887	44	21	233	0	7185
26348	161	6881	26	116	0	7184
26349	72	171	31	6852	0	7126
26350	42	62	6810	192	0	7106
26351	33	6764	166	112	0	7075
26352	37	160	6696	91	0	6984
26353	48	6705	157	80	0	6990
26354	64	179	77	6415	0	6735
26355	42	53	34	6366	0	6495
26356	32	6384	25	184	0	6625
26357	35	145	6397	94	0	6671
26358	6404	58	135	79	0	6676
26359	146	53	42	6698	0	6939
26360	41	40	32	6844	0	6957
26361	38	48	6703	205	0	6994
26362	35	52	145	6742	0	6974
26363	33	56	6672	189	0	6950
26364	39	43	142	6680	0	6904
26365	18	41	6763	205	0	7027
26366	23	6815	148	112	0	7098
26367	24	157	6941	79	0	7201
26368	37	63	143	6869	0	7112
26369	6760	49	40	213	0	7062
26370	132	6633	42	107	0	6914
26371	55	169	30	6518	0	6772
26372	37	51	6370	179	0	6637
26373	28	6350	136	85	0	6599
26374	29	139	49	5714	0	5931
26375	14	50	5647	131	0	5842
26376	14	5070	86	57	0	5227
26377	4131	89	92	71	0	4383
26378	3890	20	30	27	0	3967
26379	47	10	6	3881	0	3944
26380	3867	12	7	45	0	3931
26381	42	8	6	3844	0	3900
26382	17	5	6	3900	0	3928
26383	11	8	3963	46	0	4028
26384	9	10	30	3911	0	3960
26385	7	7	11	3956	0	3981
26386	3886	2	12	48	0	3948
26387	3831	7	11	25	0	3874
26388	41	3841	4	19	0	3905
26389	17	31	3856	14	0	3918
26390	16	26	32	3803	0	3877
26391	11	13	3770	38	0	3832
26392	3522	5	38	25	0	3590
26393	29	8	3623	19	0	3679
26394	19	12	35	3505	0	3571
26395	14	3547	12	32	0	3605
26396	11	26	10	3549	0	3596
26397	7	11	9	3550	0	3577
26398	6	9	3590	41	0	3646
26399	11	6	26	3587	0	3630
26400	3579	2	16	45	0	3642
26401	3604	4	12	22	0	3642
26402	3600	5	8	21	0	3634
26403	3580	4	5	16	0	3605
26404	43	3526	7	17	0	3593
26405	18	3542	10	17	0	3587
26406	19	36	6	3301	0	3362
26407	9	13	6	3546	0	3574
26408	6	3396	12	40	0	3454
26409	10	31	6	3562	0	3609
26410	13	16	6	3559	0	3594
26411	12	6	4	3567	0	3589
26412	9	7	6	3562	0	3584
26413	10	7	6	3579	0	3602
26414	3529	5	5	49	0	3588
26415	30	3466	9	27	0	3532
26416	12	30	3462	19	0	3523
26417	13	11	30	3440	0	3494
26418	8	13	11	3486	0	3518
26419	9	9	10	3450	0	3478
26420	3543	5	7	48	0	3603
26421	34	3985	5	30	0	4054
26422	24	52	6	4091	0	4173
26423	17	4262	3	81	0	4363
26424	15	83	8	4161	0	4267
26425	10	4183	4	88	0	4285
26426	12	94	4547	30	0	4683
26427	8	21	98	4869	0	4996
26428	9	20	5539	125	0	5693
26429	16	12	131	5580	0	5739
26430	17	12	31	6024	0	6084
26431	5958	10	31	171	0	6170
26432	6061	11	13	78	0	6163
26433	6114	12	10	53	0	6189
26434	6130	7	12	38	0	6187
26435	6140	7	16	29	0	6192
26436	199	5	9	5869	0	6082
26437	69	5973	8	139	0	6189
26438	57	137	12	5949	0	6155
26439	30	33	5788	175	0	6026
26440	5849	32	120	60	0	6061
26441	6026	12	32	57	0	6127
26442	195	12	31	5908	0	6146
26443	73	7	12	5898	0	5990
26444	53	5738	5	185	0	5981
26445	41	133	11	5864	0	6049
26446	41	33	10	5850	0	5934
26447	30	5756	10	178	0	5974
26448	26	145	11	5878	0	6060
26449	5526	41	11	202	0	5780
26450	138	44	5685	65	0	5932
26451	5646	21	125	72	0	5864
26452	164	21	5707	47	0	5939
26453	58	16	153	5653	0	5880
26454	54	18	38	5593	0	5703
26455	31	5472	31	187	0	5721
26456	33	5656	17	89	0	5795
26457	44	155	16	5458	0	5673
26458	26	65	5413	159	0	5663
26459	5193	36	127	60	0	5416
26460	154	15	34	5228	0	5431
26461	49	5163	43	153	0	5408
26462	52	131	11	5208	0	5402
26463	35	47	9	5185	0	5276
26464	28	5059	14	177	0	5278
26465	40	132	13	4880	0	5065
26466	26	42	4560	156	0	4784
26467	21	42	4509	60	0	4632
26468	27	29	128	4292	0	4476
26469	13	4463	43	112	0	4631
26470	23	121	28	4506	0	4678
26471	4505	40	11	154	0	4710
26472	4588	28	20	66	0	4702
26473	4449	16	21	59	0	4545
26474	152	4340	13	40	0	4545
26475	54	113	4340	39	0	4546
26476	4314	43	113	41	0	4511
26477	4428	35	35	39	0	4537
26478	151	4315	36	33	0	4535
26479	73	120	16	4345	0	4554
26480	4342	50	16	136	0	4544
26481	4411	43	21	53	0	4528
26482	4453	28	19	58	0	4558
26483	179	21	17	4254	0	4471
26484	4292	25	21	151	0	4489
26485	166	23	23	4256	0	4468
26486	63	19	19	4378	0	4479
26487	4279	17	19	174	0	4489
26488	162	15	22	4262	0	4461
26489	4239	17	18	179	0	4453
26490	184	24	19	4243	0	4470
26491	80	18	10	4389	0	4497
26492	4234	19	19	198	0	4470
26493	176	23	4217	105	0	4521
26494	92	29	113	4313	0	4547
26495	88	21	41	4372	0	4522
26496	67	13	34	4373	0	4487
26497	73	21	20	4421	0	4535
26498	66	19	21	4339	0	4445
26499	51	4193	17	213	0	4474
26500	51	124	24	4259	0	4458
26501	54	42	4181	195	0	4472
26502	74	36	110	4259	0	4479
26503	62	24	36	4341	0	4463
26504	51	26	30	4410	0	4517
26505	46	33	4206	218	0	4503
26506	47	30	4204	111	0	4392
26507	4161	22	142	104	0	4429
26508	4282	30	62	74	0	4448
26509	165	4368	42	88	0	4663
26510	91	127	16	4553	0	4787
26511	57	47	29	4727	0	4860
26512	41	47	31	4794	0	4913
26513	4666	24	28	221	0	4939
26514	4781	32	34	110	0	4957
26515	167	27	23	4766	0	4983
26516	73	32	23	4808	0	4936
26517	54	36	23	4823	0	4936
26518	54	26	19	4851	0	4950
26519	4620	23	28	220	0	4891
26520	143	24	4463	109	0	4739
26521	51	3775	97	103	0	4026
26522	38	3690	29	61	0	3818
26523	3514	79	29	56	0	3678
26524	89	112	16	3450	0	3667
26525	35	43	3440	91	0	3609
26526	35	26	2960	54	0	3075
26527	22	2901	58	46	0	3027
26528	2200	16	41	13	0	2270
26529	24	7	2166	11	0	2208
26530	1812	13	17	11	0	1853
26531	8	1	4	1885	0	1898
26532	4	3	4	1910	0	1921
26533	5	1897	2	7	0	1911
26534	3	1895	3	8	0	1909
26535	1941	7	6	5	0	1959
26536	1950	2	3	7	0	1962
26537	6	1914	3	4	0	1927
26538	13	6	1855	12	0	1886
26539	5	5	1909	5	0	1924
26540	9	7	6	1935	0	1957
26541	1994	1	8	10	0	2013
26542	4	1985	3	6	0	1998
26543	4	9	2	2082	0	2097
26544	2112	4	2	10	0	2128
26545	11	2	2	2155	0	2170
26546	6	1	3	2232	0	2242
26547	2211	2	1	16	0	2230
26548	9	2201	2	11	0	2223
26549	5	2304	2	5	0	2316
26550	3	12	2373	2	0	2390
26551	6	5	10	2422	0	2443
26552	2	3	2	2445	0	2452
26553	5	2	2515	14	0	2536
26554	2225	4	7	13	0	2249
26555	2347	1	5	12	0	2365
26556	11	1	2478	5	0	2495
26557	2162	2	9	15	0	2188
26558	32	2	2530	1	0	2565
26559	5	2635	14	8	0	2662
26560	5	9	4	2805	0	2823
26561	6	2	3	2885	0	2896
26562	2894	2	2	20	0	2918
26563	2885	2	2	8	0	2897
26564	2882	3	4	8	0	2897
26565	2904	3	1	6	0	2914
26566	2899	3	3	4	0	2909
26567	19	5	2813	1	0	2838
26568	10	2850	10	6	0	2876
26569	5	13	3	2880	0	2901
26570	5	2856	2	12	0	2875
26571	5	2905	1	4	0	2915
26572	7	10	2	2907	0	2926
26573	3	2	1	2928	0	2934
26574	5	4	2911	11	0	2931
26575	2722	1	11	8	0	2742
26576	2912	3	1	4	0	2920
26577	9	2880	3	3	0	2895
26578	2909	10	1	5	0	2925
26579	2970	2	2	13	0	2987
26580	14	1	2	2975	0	2992
26581	5	4	3066	13	0	3088
26582	5	1	3021	4	0	3031
26583	3085	0	12	5	0	3102
26584	3132	0	2	7	0	3141
26585	9	3100	3	4	0	3116
26586	4	3229	2	1	0	3236
26587	7	13	0	3310	0	3330
26588	3322	3	1	14	0	3340
26589	16	2	3354	2	0	3374
26590	9	1	15	3408	0	3433
26591	3496	0	3	20	0	3519
26592	3508	0	1	13	0	3522
26593	18	2	0	3575	0	3595
26594	3588	1	2	19	0	3610
26595	23	1	3486	5	0	3515
26596	7	0	3696	5	0	3708
26597	9	2	20	3668	0	3699
26598	1	4	6	3853	0	3864
26599	5	2	3	3828	0	3838
26600	4	3714	4	21	0	3743
26601	1	3815	2	12	0	3830
26602	5	16	3	3876	0	3900
26603	3910	4	3	21	0	3938
26604	19	5	4	3920	0	3948
26605	10	2	2	3940	0	3954
26606	5	3879	1	23	0	3908
26607	3	4014	2	10	0	4029
26608	0	20	3	4053	0	4076
26609	2	8	3	3862	0	3875
26610	3758	4	1	24	0	3787
26611	19	3700	0	7	0	3726
26612	3715	14	1	14	0	3744
26613	16	4	1	3746	0	3767
26614	8	7	3684	13	0	3712
26615	7	6	3584	4	0	3601
26616	3733	0	18	12	0	3763
26617	15	3	5	3882	0	3905
26618	12	0	3	3904	0	3919
26619	6	4	1	3930	0	3941
26620	7	4	3967	22	0	4000
26621	5	0	14	3996	0	4015
26622	2	3926	8	25	0	3961
26623	3	17	7	4130	0	4157
26624	6	6	1	4132	0	4145
26625	3	4189	1	28	0	4221
26626	1	26	0	4334	0	4361
26627	4262	4	2	38	0	4306
26628	26	4277	4	7	0	4314
26629	4405	26	0	22	0	4453
26630	4460	11	1	7	0	4479
26631	43	4	1	4453	0	4501
26632	16	2	1	4428	0	4447
26633	9	6	1	4486	0	4502
26634	9	5	4372	55	0	4441
26635	10	4240	35	17	0	4302
26636	4	4399	11	18	0	4432
26637	5	44	1	4363	0	4413
26638	4342	11	4	44	0	4401
26639	40	3	1	4302	0	4346
26640	15	15	4317	48	0	4395
26641	3	4246	33	15	0	4297
26642	5	4344	11	9	0	4369
26643	4331	38	3	14	0	4386
26644	4392	14	7	10	0	4423
26645	36	4699	4	15	0	4754
26646	4758	33	3	22	0	4816
26647	42	10	4726	7	0	4785
26648	14	8	4606	7	0	4635
26649	4738	13	40	6	0	4797
26650	4890	8	13	14	0	4925
26651	58	6	3	4895	0	4962
26652	4878	1	1	54	0	4934
26653	47	3	4921	13	0	4984
26654	18	10	5237	6	0	5271
26655	22	6	59	5593	0	5680
26656	13	4	21	6415	0	6453
26657	13	2	7	6641	0	6663
26658	14	4	6	6629	0	6653
26659	19	1	4	7144	0	7168
26660	5	6	6962	159	0	7132
26661	14	6	104	6916	0	7040
26662	6935	3	55	146	0	7139
26663	110	4	25	7002	0	7141
26664	6975	4	12	146	0	7137
26665	127	4	5	7017	0	7153
26666	7134	0	15	161	0	7310
26667	7370	1	16	96	0	7483
26668	170	8	14	7308	0	7500
26669	69	5	12	7435	0	7521
26670	7329	3	2	187	0	7521
26671	7352	8	8	90	0	7458
26672	171	5	7359	72	0	7607
26673	97	3	104	7349	0	7553
26674	60	8	38	7616	0	7722
26675	7537	6	19	172	0	7734
26676	7680	5	12	101	0	7798
26677	179	5	6	7683	0	7873
26678	104	4	14	7759	0	7881
26679	69	6	12	7767	0	7854
26680	50	4	16	7701	0	7771
26681	31	7300	15	211	0	7557
26682	34	7444	9	121	0	7608
26683	40	131	12	7416	0	7599
26684	44	7403	10	159	0	7616
26685	33	116	8	7520	0	7677
26686	17	49	7407	189	0	7662
26687	22	28	7138	114	0	7302
26688	19	7432	137	86	0	7674
26689	28	135	49	7410	0	7622
26690	23	60	7416	157	0	7656
26691	28	36	117	7298	0	7479
26692	31	29	53	7490	0	7603
26693	7329	20	35	212	0	7596
26694	141	21	34	7472	0	7668
26695	60	26	7532	178	0	7796
26696	54	19	7408	106	0	7587
26697	40	7381	153	82	0	7656
26698	37	7851	66	82	0	8036
26699	8017	135	44	83	0	8279
26700	150	54	8614	75	0	8893
26701	88	27	128	8657	0	8900
26702	8778	20	66	169	0	9033
26703	8812	12	50	106	0	8980
26704	169	8876	52	72	0	9169
26705	105	134	34	8684	0	8957
26706	66	57	28	9227	0	9378
26707	66	26	22	9184	0	9298
26708	9064	20	22	227	0	9333
26709	148	18	8970	133	0	9269
26710	76	9154	121	101	0	9452
26711	57	134	52	9170	0	9413
26712	47	63	26	9435	0	9571
26713	37	47	9307	220	0	9611
26714	39	27	120	9262	0	9448
26715	41	27	62	9459	0	9589
26716	38	27	43	9480	0	9588
26717	53	33	32	9408	0	9526
26718	22	30	9198	258	0	9508
26719	25	31	137	9235	0	9428
26720	28	25	9291	233	0	9577
26721	33	9231	148	155	0	9567
26722	38	111	85	9366	0	9600
26723	36	52	38	9533	0	9659
26724	34	31	9314	251	0	9630
26725	35	9147	129	157	0	9468
26726	50	126	71	9157	0	9404
26727	41	47	9193	189	0	9470
26728	45	9038	122	117	0	9322
26729	45	119	53	9153	0	9370
26730	46	54	9117	188	0	9405
26731	59	33	130	9059	0	9281
26732	66	35	61	9040	0	9202
26733	37	28	52	9365	0	9482
26734	9203	30	35	210	0	9478
26735	121	9158	22	137	0	9438
26736	9192	112	35	109	0	9448
26737	141	52	9182	97	0	9472
26738	9319	32	115	125	0	9591
26739	9808	40	51	118	0	10017
26740	160	23	36	9796	0	10015
26741	9976	31	39	184	0	10230
26742	10050	40	29	125	0	10244
26743	10294	31	22	116	0	10463
26744	160	28	33	10294	0	10515
26745	99	27	33	10017	0	10176
26746	60	32	9721	188	0	10001
26747	54	20	9176	136	0	9386
26748	9495	20	131	97	0	9743
26749	123	59	59	9671	0	9912
26750	67	9667	54	144	0	9932
26751	9698	94	49	117	0	9958
26752	113	9663	31	84	0	9891
26753	55	9590	25	98	0	9768
26754	74	132	9063	81	0	9350
26755	42	26	9148	41	0	9257
26756	46	132	95	9018	0	9291
26757	24	17	9401	67	0	9509
26758	17	10	8695	22	0	8744
26759	8458	2	32	27	0	8519
26760	8829	3	6	25	0	8863
26761	20	2	6	8954	0	8982
26762	19	4	5	8971	0	8999
26763	5	8	9126	23	0	9162
26764	3	9237	15	8	0	9263
26765	12	17	8	9182	0	9219
26766	9574	8	2	50	0	9634
26767	15	2	5	9614	0	9636
26768	4	9648	8	26	0	9686
26769	8	19	9604	10	0	9641
26770	3	9800	14	15	0	9832
26771	9863	15	6	14	0	9898
26772	9738	2	2	23	0	9765
26773	28	9	2	9726	0	9765
26774	6	5	9832	21	0	9864
26775	20	6	9135	15	0	9176
26776	4	9743	25	11	0	9783
26777	19	19	5	9471	0	9514
26778	7	3	11	9899	0	9920
26779	11	6	9877	19	0	9913
26780	16	6	16	9769	0	9807
26781	1	10255	5	70	0	10331
26782	10	42	7	10425	0	10484
26783	9	9	5	10451	0	10474
26784	11	10	10479	50	0	10550
26785	16	9	44	10277	0	10346
26786	10375	2	7	80	0	10464
26787	53	2	10472	13	0	10540
26788	13	1	10250	10	0	10274
26789	9	10741	65	13	0	10828
26790	16	56	16	11131	0	11219
26791	14	10	5	11685	0	11714
26792	5	11	11486	79	0	11581
26793	11063	4	74	45	0	11186
26794	77	7	23	11520	0	11627
26795	26	12	11373	74	0	11485
26796	29	6	75	11110	0	11220
26797	11	7	11305	84	0	11407
26798	17	3	10924	37	0	10981
26799	4	11098	107	15	0	11224
26800	12	73	33	10448	0	10566
26801	4	10711	19	83	0	10817
26802	10551	71	18	57	0	10697
26803	77	37	10605	14	0	10733
26804	21	10410	72	26	0	10529
26805	20	72	29	10437	0	10558
26806	10359	27	12	106	0	10504
26807	65	10363	25	33	0	10486
26808	40	72	19	10505	0	10636
26809	17	34	7	10524	0	10582
26810	12	10612	13	92	0	10729
26811	10765	83	9	57	0	10914
26812	89	27	17	11756	0	11889
26813	40	17	20	12218	0	12295
26814	13	21	12126	182	0	12342
26815	11	12498	140	83	0	12732
26816	26	155	44	12698	0	12923
26817	24	52	24	13482	0	13582
26818	7	13660	30	210	0	13907
26819	25	186	16	13803	0	14030
26820	32	68	13	14192	0	14305
26821	32	30	146	14193	0	14401
26822	11	14291	17	264	0	14583
26823	14193	183	14	128	0	14518
26824	180	64	14263	60	0	14567
26825	13792	41	179	71	0	14083
26826	205	14225	61	30	0	14521
26827	73	184	36	14220	0	14513
26828	40	69	14280	202	0	14591
26829	48	28	194	14265	0	14535
26830	34	38	64	14280	0	14416
26831	40	34	35	14524	0	14633
26832	19	21	14293	293	0	14626
26833	20	14151	192	123	0	14486
26834	14	187	14344	83	0	14628
26835	23	14351	211	77	0	14662
26836	14	208	14579	52	0	14853
26837	27	85	220	14509	0	14841
26838	14282	48	88	255	0	14673
26839	167	14404	65	139	0	14775
26840	69	202	14452	86	0	14809
26841	32	14338	195	70	0	14635
26842	33	227	14406	74	0	14740
26843	50	101	225	13915	0	14291
26844	45	61	91	13823	0	14020
26845	26	13894	61	276	0	14257
26846	20	14388	43	132	0	14583
26847	14337	268	54	107	0	14766
26848	229	110	39	14452	0	14830
26849	85	71	14447	253	0	14856
26850	61	66	225	14299	0	14651
26851	37	54	14435	285	0	14811
26852	32	49	14388	141	0	14610
26853	54	43	289	13905	0	14291
26854	24	14151	122	241	0	14538
26855	13684	227	80	152	0	14143
26856	221	109	65	13542	0	13937
26857	92	60	71	13178	0	13401
26858	41	13326	64	305	0	13736
26859	13208	259	47	141	0	13655
26860	13309	112	56	115	0	13592
26861	278	81	56	13025	0	13440
26862	110	12897	65	266	0	13338
26863	68	13416	47	155	0	13686
26864	13190	283	61	106	0	13640
26865	231	135	13192	93	0	13651
26866	12757	96	254	91	0	13198
26867	12868	84	96	89	0	13137
26868	12813	62	68	95	0	13038
26869	290	12618	44	97	0	13049
26870	136	242	61	12696	0	13135
26871	12670	121	48	284	0	13123
26872	12718	70	53	144	0	12985
26873	277	12655	65	110	0	13107
26874	12777	249	51	90	0	13167
26875	276	123	53	12835	0	13287
26876	125	74	49	12822	0	13070
26877	72	12704	49	310	0	13135
26878	60	248	49	12910	0	13267
26879	82	121	35	13000	0	13238
26880	60	12767	41	342	0	13210
26881	71	228	35	12132	0	12466
26882	51	12459	38	280	0	12828
26883	12431	234	52	145	0	12862
26884	12170	119	52	102	0	12443
26885	258	12174	35	109	0	12576
26886	116	217	11978	82	0	12393
26887	91	159	177	11851	0	12278
26888	69	93	11765	217	0	12144
26889	65	11303	194	134	0	11696
26890	46	11464	91	105	0	11706
26891	10808	199	53	77	0	11137
26892	191	11027	30	77	0	11325
26893	95	196	41	10805	0	11137
26894	70	10863	40	172	0	11145
26895	61	11136	26	95	0	11318
26896	11044	207	36	80	0	11367
26897	194	89	29	11063	0	11375
26898	89	73	11000	195	0	11357
26899	72	62	10922	101	0	11157
26900	54	11153	184	86	0	11477
26901	11107	187	73	82	0	11449
26902	174	11275	55	61	0	11565
26903	86	232	36	11641	0	11995
26904	11716	91	31	207	0	12045
26905	218	85	28	11855	0	12186
26906	113	53	31	11991	0	12188
26907	66	12014	32	255	0	12367
26908	82	206	24	12136	0	12448
26909	58	97	12253	210	0	12618
26910	12158	58	185	120	0	12521
26911	199	12399	80	77	0	12755
26912	57	12130	36	48	0	12271
26913	11683	167	17	49	0	11916
26914	165	72	11895	24	0	12156
26915	11569	56	131	38	0	11794
26916	148	12938	42	40	0	13168
26917	53	13881	23	28	0	13985
26918	29	249	14096	21	0	14395
26919	16	14245	230	36	0	14527
26920	66	268	113	13187	0	13634
26921	30	89	43	13493	0	13655
26922	10	13717	20	243	0	13990
26923	47	225	8	13859	0	14139
26924	13881	89	6	260	0	14236
26925	218	51	13855	92	0	14216
26926	13867	43	215	69	0	14194
26927	14307	32	85	42	0	14466
26928	14263	49	43	55	0	14410
26929	330	38	14115	27	0	14510
26930	142	34	222	14175	0	14573
26931	64	39	14272	245	0	14620
26932	13902	33	264	129	0	14328
26933	13955	37	80	99	0	14171
26934	290	14073	57	50	0	14470
26935	149	242	29	14054	0	14474
26936	85	14470	37	239	0	14831
26937	68	260	14589	91	0	15008
26938	87	104	250	14620	0	15061
26939	14471	57	107	303	0	14938
26940	14676	34	52	135	0	14897
26941	361	36	38	14160	0	14595
26942	144	14197	41	245	0	14627
26943	82	253	14404	109	0	14848
26944	62	111	14582	60	0	14815
26945	14199	73	334	64	0	14670
26946	278	48	14536	55	0	14917
26947	123	14433	281	89	0	14926
26948	106	270	116	14403	0	14895
26949	61	112	14647	268	0	15088
26950	77	68	281	14510	0	14936
26951	71	48	14578	295	0	14992
26952	14167	44	298	137	0	14646
26953	285	34	132	14244	0	14695
26954	136	14003	84	279	0	14502
26955	77	14419	69	134	0	14699
26956	68	340	69	14217	0	14694
26957	70	142	58	14168	0	14438
26958	61	14171	65	359	0	14656
26959	62	286	14161	151	0	14660
26960	51	121	289	14259	0	14720
26961	51	81	14332	296	0	14760
26962	40	53	14074	158	0	14325
26963	13487	50	369	112	0	14018
26964	294	13756	160	76	0	14286
26965	13780	289	100	73	0	14242
26966	319	149	60	13455	0	13983
26967	130	13816	47	275	0	14268
26968	100	304	72	13893	0	14369
26969	61	145	76	13891	0	14173
26970	58	13787	73	374	0	14292
26971	66	302	13741	181	0	14290
26972	89	140	305	13791	0	14325
26973	13757	93	150	333	0	14333
26974	328	75	95	13728	0	14226
26975	157	72	75	13801	0	14105
26976	106	78	13491	401	0	14076
26977	90	13422	307	187	0	14006
26978	71	301	133	13409	0	13914
26979	74	144	13379	345	0	13942
26980	64	106	13329	189	0	13688
26981	12941	91	377	156	0	13565
26982	288	13179	183	132	0	13782
26983	13108	304	118	122	0	13652
26984	326	13055	95	117	0	13593
26985	153	13297	92	125	0	13667
26986	13085	399	87	111	0	13682
26987	348	183	89	12769	0	13389
26988	163	12987	108	322	0	13580
26989	135	316	84	13184	0	13719
26990	13104	144	102	358	0	13708
26991	335	109	13073	181	0	13698
26992	181	79	12808	125	0	13193
26993	12665	87	382	123	0	13257
26994	321	12830	189	110	0	13450
26995	181	318	12781	83	0	13363
26996	126	12796	320	90	0	13332
26997	118	338	151	12599	0	13206
26998	90	175	12685	328	0	13278
26999	99	126	312	12469	0	13006
27000	81	77	12363	387	0	12908
27001	11770	76	350	205	0	12401
27002	301	12131	184	129	0	12745
27003	11816	277	133	106	0	12332
27004	340	146	98	11579	0	12163
27005	134	12096	104	298	0	12632
27006	11920	315	99	155	0	12489
27007	11286	154	119	131	0	11690
27008	331	126	11752	93	0	12302
27009	160	76	11522	102	0	11860
27010	10428	81	338	78	0	10925
27011	259	10510	162	98	0	11029
27012	121	10278	105	68	0	10572
27013	187	467	124	9566	0	10344
27014	93	135	9594	228	0	10050
27015	81	9001	213	125	0	9420
27016	62	8055	89	87	0	8293
27017	251	157	81	6132	0	6621
27018	6208	29	33	98	0	6368
27019	6217	27	16	45	0	6305
27020	6299	17	21	23	0	6360
27021	115	17	6228	14	0	6374
27022	6160	18	88	14	0	6280
27023	6242	23	29	18	0	6312
27024	6348	10	17	20	0	6395
27025	122	19	19	6148	0	6308
27026	49	6099	11	77	0	6236
27027	6044	80	15	33	0	6172
27028	100	6048	12	19	0	6179
27029	38	86	13	5980	0	6117
27030	27	35	6194	79	0	6335
27031	23	23	79	6155	0	6280
27032	21	15	35	6235	0	6306
27033	18	17	6217	101	0	6353
27034	18	6114	78	40	0	6250
27035	24	72	26	5732	0	5854
27036	5629	29	18	69	0	5745
27037	68	5498	8	22	0	5596
27038	5324	57	4	23	0	5408
27039	76	29	11	5200	0	5316
27040	26	5295	10	58	0	5389
27041	5261	58	6	22	0	5347
27042	65	5287	5	14	0	5371
27043	24	65	5172	6	0	5267
27044	5119	29	57	24	0	5229
27045	5211	21	17	13	0	5262
27046	71	5156	14	12	0	5253
27047	24	46	4989	14	0	5073
27048	10	5105	53	8	0	5176
27049	88	78	42	3516	0	3724
27050	6	19	11	5220	0	5256
27051	13	12	6	5193	0	5224
27052	6	5191	5	75	0	5277
27053	11	62	3	5209	0	5285
27054	15	14	4	5249	0	5282
27055	5149	16	5	76	0	5246
27056	70	11	3	5158	0	5242
27057	32	6	3	5235	0	5276
27058	5165	11	8	75	0	5259
27059	65	5192	3	29	0	5289
27060	5246	55	6	19	0	5326
27061	5250	24	3	16	0	5293
27062	5283	14	11	9	0	5317
27063	87	12	2	5235	0	5336
27064	27	15	5	5319	0	5366
27065	25	14	5179	71	0	5289
27066	15	14	5017	37	0	5083
27067	8	16	5019	23	0	5066
27068	4863	6	68	22	0	4959
27069	67	14	4986	19	0	5086
27070	27	5053	65	21	0	5166
27071	18	70	23	5071	0	5182
27072	18	24	13	5004	0	5059
27073	22	5081	10	76	0	5189
27074	16	65	5185	29	0	5295
27075	18	5232	57	26	0	5333
27076	5253	70	17	26	0	5366
27077	78	28	5246	11	0	5363
27078	34	5239	58	30	0	5361
27079	29	64	5285	18	0	5396
27080	25	25	68	5280	0	5398
27081	17	14	5357	74	0	5462
27082	29	9	68	5254	0	5360
27083	5369	13	28	82	0	5492
27084	75	14	5370	29	0	5488
27085	26	5362	70	25	0	5483
27086	5443	70	22	26	0	5561
27087	76	30	5590	26	0	5722
27088	19	25	5615	29	0	5688
27089	26	18	79	5564	0	5687
27090	22	15	5622	81	0	5740
27091	5377	15	75	41	0	5508
27092	74	5526	33	32	0	5665
27093	40	79	18	5637	0	5774
27094	21	5877	15	77	0	5990
27095	5954	77	16	37	0	6084
27096	80	32	5918	25	0	6055
27097	33	20	6138	22	0	6213
27098	30	16	87	6092	0	6225
27099	23	21	30	6209	0	6283
27100	22	15	24	6270	0	6331
27101	27	17	13	6285	0	6342
27102	16	17	6334	103	0	6470
27103	19	6230	81	36	0	6366
27104	16	75	25	5981	0	6097
27105	14	25	5768	65	0	5872
27106	13	5713	67	36	0	5829
27107	5735	63	34	22	0	5854
27108	75	30	13	5729	0	5847
27109	5670	16	17	74	0	5777
27110	71	5667	9	25	0	5772
27111	5644	61	14	23	0	5742
27112	68	23	5817	15	0	5923
27113	31	43	62	5626	0	5762
27114	18	5782	24	63	0	5887
27115	16	55	5754	29	0	5854
27116	5	5656	59	31	0	5751
27117	39	87	28	4181	0	4335
27118	5314	17	14	59	0	5404
27119	48	5296	16	25	0	5385
27120	5249	53	14	15	0	5331
27121	56	20	5230	13	0	5319
27122	38	14	5100	16	0	5168
27123	5141	11	54	23	0	5229
27124	64	11	20	5192	0	5287
27125	20	16	18	5240	0	5294
27126	17	12	5288	58	0	5375
27127	18	5	5229	22	0	5274
27128	14	5380	53	13	0	5460
27129	5247	50	42	20	0	5359
27130	5029	17	9	14	0	5069
27131	43	4962	15	16	0	5036
27132	27	40	10	5104	0	5181
27133	5171	18	16	41	0	5246
27134	39	9	8	5193	0	5249
27135	5262	10	4	46	0	5322
27136	5314	1	11	25	0	5351
27137	5487	11	7	18	0	5523
27138	51	11	6	5428	0	5496
27139	25	3	7	5635	0	5670
27140	5498	9	6	49	0	5562
27141	5495	4	8	23	0	5530
27142	5477	7	6	22	0	5512
27143	52	5394	8	15	0	5469
27144	5193	27	3	17	0	5240
27145	34	5149	3	12	0	5198
27146	5104	26	4	17	0	5151
27147	36	11	5058	5	0	5110
27148	4737	9	31	17	0	4794
27149	26	4819	8	9	0	4862
27150	11	4899	7	4	0	4921
27151	5038	24	5	14	0	5081
27152	24	9	1	5142	0	5176
27153	14	4	2	5376	0	5396
27154	8	5386	1	33	0	5428
27155	6	5840	1	7	0	5854
27156	6152	35	4	7	0	6198
27157	47	13	6500	2	0	6562
27158	18	3	40	6969	0	7030
27159	7131	5	9	63	0	7208
27160	65	3	7176	12	0	7256
27161	12	7720	61	8	0	7801
27162	8154	84	11	17	0	8266
27163	125	14	8416	14	0	8569
27164	27	10	121	8830	0	8988
27165	17	4	9068	129	0	9218
27166	8810	2	137	36	0	8985
27167	131	9222	31	16	0	9400
27168	9306	133	9	20	0	9468
27169	9401	25	7	9	0	9442
27170	168	12	2	9313	0	9495
27171	9377	8	4	155	0	9544
27172	154	2	5	9412	0	9573
27173	35	7	7	9523	0	9572
27174	15	8	9221	161	0	9405
27175	14	9248	129	36	0	9427
27176	14	137	25	9362	0	9538
27177	12	25	7	9458	0	9502
27178	18	8	6	9451	0	9483
27179	7	11	9269	155	0	9442
27180	6	9193	126	39	0	9364
27181	17	129	20	9313	0	9479
27182	18	23	11	9453	0	9505
27183	13	11	9275	150	0	9449
27184	9	12	125	9193	0	9339
27185	9250	5	23	153	0	9431
27186	123	9231	10	40	0	9404
27187	9084	128	7	23	0	9242
27188	142	30	9053	14	0	9239
27189	40	23	130	9057	0	9250
27190	9163	11	26	143	0	9343
27191	9192	7	17	41	0	9257
27192	158	8	9187	18	0	9371
27193	46	12	136	9075	0	9269
27194	28	7	9076	138	0	9249
27195	8768	3	140	43	0	8954
27196	133	8989	28	28	0	9178
27197	9015	132	9	26	0	9182
27198	8985	26	18	14	0	9043
27199	161	9020	10	12	0	9203
27200	9089	145	13	23	0	9270
27201	159	25	9001	11	0	9196
27202	9030	15	133	20	0	9198
27203	159	10	23	9104	0	9296
27204	52	8	9296	140	0	9496
27205	37	14	146	9242	0	9439
27206	36	14	25	9141	0	9216
27207	38	3	24	9315	0	9380
27208	18	9251	20	169	0	9458
27209	9332	138	14	62	0	9546
27210	162	31	15	9342	0	9550
27211	40	9260	17	167	0	9484
27212	32	150	16	9020	0	9218
27213	34	9115	20	158	0	9327
27214	25	151	9162	45	0	9383
27215	38	31	140	9173	0	9382
27216	39	23	36	9283	0	9381
27217	26	19	9190	182	0	9417
27218	8672	21	158	55	0	8906
27219	153	9126	32	49	0	9360
27220	52	149	23	9198	0	9422
27221	39	27	30	9158	0	9254
27222	43	24	17	9080	0	9164
27223	27	9071	18	177	0	9293
27224	9027	150	15	72	0	9264
27225	166	38	9017	51	0	9272
27226	45	26	8888	39	0	8998
27227	35	22	160	8855	0	9072
27228	38	15	43	9013	0	9109
27229	8878	12	31	203	0	9124
27230	162	8779	44	64	0	9049
27231	47	156	31	8922	0	9156
27232	8800	38	19	185	0	9042
27233	175	31	16	8723	0	8945
27234	8744	22	19	174	0	8959
27235	177	19	8508	62	0	8766
27236	60	8641	151	48	0	8900
27237	8622	153	43	45	0	8863
27238	183	40	8620	39	0	8882
27239	8396	20	163	44	0	8623
27240	169	19	8475	41	0	8704
27241	8489	21	153	46	0	8709
27242	184	17	39	8536	0	8776
27243	8602	23	32	172	0	8829
27244	181	16	23	8579	0	8799
27245	58	15	27	8669	0	8769
27246	8555	24	22	188	0	8789
27247	168	8661	14	75	0	8918
27248	62	144	18	8762	0	8986
27249	8829	43	20	171	0	9063
27250	9096	32	20	62	0	9210
27251	201	21	20	9066	0	9308
27252	66	23	25	9278	0	9392
27253	9261	14	21	198	0	9494
27254	199	8	17	9365	0	9589
27255	71	20	24	9131	0	9246
27256	8765	17	12	201	0	8995
27257	170	9	20	8450	0	8649
27258	37	8	7757	163	0	7965
27259	7557	11	122	64	0	7754
27260	154	9	7728	30	0	7921
27261	45	8	7114	12	0	7179
27262	6627	28	173	16	0	6844
27263	67	6496	36	15	0	6614
27264	47	59	32	6209	0	6347
27265	19	13	9	6201	0	6242
27266	15	7	4	6568	0	6594
27267	8	3	4	6673	0	6688
27268	6475	6	4	113	0	6598
27269	6938	2	0	29	0	6969
27270	7177	0	3	15	0	7195
27271	116	3	7497	8	0	7624
27272	37	3	111	7783	0	7934
27273	21	2	27	7987	0	8037
27274	16	4	8	7788	0	7816
27275	7	7551	8	169	0	7735
27276	10	7688	4	59	0	7761
27277	7992	157	6	29	0	8184
27278	149	51	6	8009	0	8215
27279	52	23	4	8452	0	8531
27280	32	8	4	8591	0	8635
27281	21	10	8332	210	0	8573
27282	576	13	7676	81	0	8346
27283	8276	7	170	49	0	8502
27284	8568	7	52	43	0	8670
27285	202	7	24	8392	0	8625
27286	70	8462	15	160	0	8707
27287	52	145	6	8544	0	8747
27288	39	48	13	8614	0	8714
27289	24	17	8353	212	0	8606
27290	8471	12	144	90	0	8717
27291	170	3	54	8786	0	9013
27292	62	10	27	8717	0	8816
27293	8472	6	22	225	0	8725
27294	178	8629	12	103	0	8922
27295	8800	158	9	64	0	9031
27296	197	70	11	8688	0	8966
27297	76	8580	5	192	0	8853
27298	8708	166	7	87	0	8968
27299	188	66	13	8669	0	8936
27300	8588	28	10	195	0	8821
27301	8511	24	13	85	0	8633
27302	8546	11	10	61	0	8628
27303	232	8222	8	55	0	8517
27304	101	8249	7	42	0	8399
27305	83	194	8	8051	0	8336
27306	45	8114	12	177	0	8348
27307	8297	191	13	74	0	8575
27308	192	63	13	8283	0	8551
27309	8267	34	13	208	0	8522
27310	8416	26	19	88	0	8549
27311	246	26	10	8264	0	8546
27312	107	18	9	8586	0	8720
27313	8539	26	13	243	0	8821
27314	8625	26	7	126	0	8784
27315	8787	22	11	81	0	8901
27316	8895	19	11	73	0	8998
27317	9002	16	7	72	0	9097
27318	287	22	6	8806	0	9121
27319	153	16	9	8934	0	9112
27320	96	23	11	9006	0	9136
27321	8823	19	10	279	0	9131
27322	222	19	2	8769	0	9012
27323	117	8700	7	251	0	9075
27324	70	178	7	8904	0	9159
27325	8713	77	13	238	0	9041
27326	8834	40	17	120	0	9011
27327	287	31	8591	72	0	8981
27328	146	29	165	8474	0	8814
27329	82	8613	61	216	0	8972
27330	8767	176	23	123	0	9089
27331	215	8793	19	88	0	9115
27332	129	188	9	8915	0	9241
27333	9011	82	14	220	0	9327
27334	9091	36	16	118	0	9261
27335	290	8979	6	88	0	9363
27336	151	179	11	8928	0	9269
27337	106	66	8865	226	0	9263
27338	8662	42	171	117	0	8992
27339	237	35	8831	81	0	9184
27340	8879	20	189	81	0	9169
27341	9053	38	69	73	0	9233
27342	295	35	22	8937	0	9289
27343	9044	35	20	235	0	9334
27344	9241	28	17	122	0	9408
27345	9300	34	11	81	0	9426
27346	334	27	15	9049	0	9425
27347	8982	23	17	231	0	9253
27348	257	27	19	8923	0	9226
27349	151	31	26	8903	0	9111
27350	111	8709	21	262	0	9103
27351	106	167	19	8388	0	8680
27352	86	8371	14	208	0	8679
27353	8153	161	7	101	0	8422
27354	8087	75	5	79	0	8246
27355	253	40	10	7922	0	8225
27356	131	37	9	7972	0	8149
27357	7812	21	14	231	0	8078
27358	212	27	7574	121	0	7934
27359	7655	23	130	74	0	7882
27360	223	26	50	7516	0	7815
27361	125	22	7114	168	0	7429
27362	7139	25	131	100	0	7395
27363	7302	18	47	63	0	7430
27364	240	17	7133	63	0	7453
27365	7074	17	124	55	0	7270
27366	206	15	6861	51	0	7133
27367	112	6820	127	54	0	7113
27368	6864	111	95	52	0	7122
27369	6749	63	33	46	0	6891
27370	190	6352	22	39	0	6603
27371	84	5983	18	29	0	6114
27372	5646	86	53	27	0	5812
27373	5647	26	15	18	0	5706
27374	111	20	6	5709	0	5846
27375	58	12	5524	71	0	5665
27376	32	7	5342	44	0	5425
27377	5447	18	69	22	0	5556
27378	78	12	5487	23	0	5600
27379	5172	26	91	20	0	5309
27380	67	8	24	5122	0	5221
27381	45	4	14	5149	0	5212
27382	32	10	5202	64	0	5308
27383	5232	4	48	47	0	5331
27384	62	19	18	5322	0	5421
27385	41	4	10	5489	0	5544
27386	5399	3	12	74	0	5488
27387	5411	5	7	38	0	5461
27388	5411	3	5	38	0	5457
27389	80	5502	9	16	0	5607
27390	39	44	5210	15	0	5308
27391	5134	15	42	17	0	5208
27392	5229	7	20	14	0	5270
27393	70	5134	11	12	0	5227
27394	4943	34	16	13	0	5006
27395	42	11	5	4891	0	4949
27396	30	6	5083	30	0	5149
27397	5001	8	28	28	0	5065
27398	5133	8	13	20	0	5174
27399	5208	4	5	16	0	5233
27400	5237	3	5	8	0	5253
27401	60	1	3	5214	0	5278
27402	26	2	4	5227	0	5259
27403	5255	2	7	52	0	5316
27404	45	0	9	5253	0	5307
27405	23	0	10	5259	0	5292
27406	16	5206	9	43	0	5274
27407	16	32	3	5321	0	5372
27408	9	9	5	5361	0	5384
27409	10	7	5	5381	0	5403
27410	20	2	9	5447	0	5478
27411	18	5373	4	48	0	5443
27412	16	41	2	5280	0	5339
27413	12	11	2	5180	0	5205
27414	11	12	5103	44	0	5170
27415	18	5	4910	12	0	4945
27416	12	4994	38	14	0	5058
27417	5833	40	12	12	0	5897
27418	82	5920	11	10	0	6023
27419	29	83	8	6324	0	6444
27420	16	14	6769	92	0	6891
27421	7260	8	97	37	0	7402
27422	121	6	16	7525	0	7668
27423	7459	5	16	114	0	7594
27424	7642	3	9	35	0	7689
27425	126	7632	8	21	0	7787
27426	7656	101	7	22	0	7786
27427	122	7945	7	19	0	8093
27428	43	140	4	8045	0	8232
27429	27	8138	5	116	0	8286
27430	30	125	8122	34	0	8311
27431	17	8205	111	21	0	8354
27432	30	152	25	8043	0	8250
27433	8107	35	12	135	0	8289
27434	119	8246	14	41	0	8420
27435	42	131	5	8309	0	8487
27436	25	37	8	8518	0	8588
27437	20	20	8436	165	0	8641
27438	27	16	140	8432	0	8615
27439	18	16	8470	155	0	8659
27440	8215	14	141	76	0	8446
27441	156	14	8563	26	0	8759
27442	54	8569	147	39	0	8809
27443	30	149	46	8592	0	8817
27444	46	40	16	8645	0	8747
27445	32	32	14	8670	0	8748
27446	8616	23	3	208	0	8850
27447	167	23	15	8509	0	8714
27448	45	8507	26	166	0	8744
27449	8371	153	11	76	0	8611
27450	148	8294	12	55	0	8509
27451	67	155	16	8288	0	8526
27452	8285	55	14	172	0	8526
27453	157	8150	18	71	0	8396
27454	49	8496	14	48	0	8607
27455	8443	158	15	56	0	8672
27456	8600	61	14	49	0	8724
27457	196	28	8514	41	0	8779
27458	8645	27	154	42	0	8868
27459	202	34	8799	24	0	9059
27460	79	34	164	8892	0	9169
27461	35	28	8921	184	0	9168
27462	41	22	176	8950	0	9189
27463	29	22	9002	201	0	9254
27464	52	20	177	8857	0	9106
27465	24	28	61	9118	0	9231
27466	8901	30	25	224	0	9180
27467	186	29	8834	77	0	9126
27468	8552	24	160	67	0	8803
27469	195	18	8760	50	0	9023
27470	78	23	8796	42	0	8939
27471	46	31	186	8710	0	8973
27472	8733	26	63	181	0	9003
27473	177	8748	36	63	0	9024
27474	8736	157	27	46	0	8966
27475	8779	51	34	39	0	8903
27476	207	8660	21	48	0	8936
27477	8679	160	31	37	0	8907
27478	196	55	8752	36	0	9039
27479	80	32	167	8768	0	9047
27480	8795	19	59	180	0	9053
27481	174	8846	52	64	0	9136
27482	70	156	33	8772	0	9031
27483	58	40	22	8848	0	8968
27484	46	28	29	8948	0	9051
27485	50	21	26	8981	0	9078
27486	8799	16	26	217	0	9058
27487	8886	24	30	99	0	9039
27488	8885	14	36	57	0	8992
27489	8735	14	27	60	0	8836
27490	208	20	8634	45	0	8907
27491	8650	17	154	43	0	8864
27492	8848	20	58	34	0	8960
27493	231	8590	28	40	0	8889
27494	91	8818	31	36	0	8976
27495	72	187	27	8663	0	8949
27496	60	58	32	8690	0	8840
27497	57	37	8509	214	0	8817
27498	51	8539	158	81	0	8829
27499	50	176	56	8348	0	8630
27500	47	8570	28	169	0	8814
27501	43	172	31	8786	0	9032
27502	54	56	16	8866	0	8992
27503	45	8956	36	220	0	9257
27504	47	190	20	9086	0	9343
27505	51	60	9186	211	0	9508
27506	48	42	9185	92	0	9367
27507	9093	24	207	84	0	9408
27508	9364	25	74	62	0	9525
27509	226	9198	52	58	0	9534
27510	9232	171	33	50	0	9486
27511	214	75	35	9192	0	9516
27512	9184	49	22	200	0	9455
27513	211	9161	13	97	0	9482
27514	118	169	9019	59	0	9365
27515	8867	65	177	69	0	9178
27516	222	46	9269	40	0	9577
27517	79	24	8292	29	0	8424
27518	51	31	8268	25	0	8375
27519	38	7939	142	30	0	8149
27520	7302	158	219	40	0	7719
27521	7023	40	29	27	0	7119
27522	115	19	17	6882	0	7033
27523	53	20	14	6858	0	6945
27524	30	6967	11	114	0	7122
27525	6996	81	16	52	0	7145
27526	102	6992	9	27	0	7130
27527	35	6785	16	21	0	6857
27528	6666	75	30	19	0	6790
27529	79	30	20	6578	0	6707
27530	38	16	10	6554	0	6618
27531	29	21	8	6598	0	6656
27532	17	6547	5	89	0	6658
27533	6446	54	5	40	0	6545
27534	62	36	7	6372	0	6477
27535	26	6142	6	58	0	6232
27536	17	6113	5	27	0	6162
27537	15	62	3	5978	0	6058
27538	13	6084	7	44	0	6148
27539	18	53	7	6046	0	6124
27540	5970	22	4	59	0	6055
27541	42	19	5840	19	0	5920
27542	14	5926	33	14	0	5987
27543	17	48	13	5983	0	6061
27544	12	15	6126	48	0	6201
27545	5984	17	44	28	0	6073
27546	56	12	21	6136	0	6225
27547	6163	9	13	53	0	6238
27548	6140	8	8	30	0	6186
27549	57	6243	6	182	0	6488
27550	6491	41	5	23	0	6560
27551	6507	23	3	22	0	6555
27552	6536	13	4	17	0	6570
27553	72	7	3	6414	0	6496
27554	42	13	4	6353	0	6412
27555	25	10	5	6385	0	6425
27556	19	9	6275	66	0	6369
27557	18	6156	37	31	0	6242
27558	6015	31	15	23	0	6084
27559	31	5946	12	22	0	6011
27560	18	36	5	5921	0	5980
27561	14	16	5868	35	0	5933
27562	5538	15	29	33	0	5615
27563	34	5835	15	12	0	5896
27564	23	32	6	5827	0	5888
27565	19	13	7	5808	0	5847
27566	8	10	5762	41	0	5821
27567	11	5748	31	21	0	5811
27568	14	35	13	5764	0	5826
27569	12	18	7	5803	0	5840
27570	14	8	5	5711	0	5738
27571	5597	7	5	65	0	5674
27572	35	10	5554	27	0	5626
27573	17	5505	28	23	0	5573
27574	5441	33	13	29	0	5516
27575	34	5553	7	18	0	5612
27576	21	36	7	5476	0	5540
27577	13	5622	9	37	0	5681
27578	5550	41	5	17	0	5613
27579	5691	21	4	27	0	5743
27580	56	14	2	5939	0	6011
27581	33	7	2	6022	0	6064
27582	15	13	4	6244	0	6276
27583	16	5	6357	80	0	6458
27584	10	6593	67	34	0	6704
27585	21	71	16	7446	0	7554
27586	11	33	10	7597	0	7651
27587	21	11	5	7673	0	7710
27588	19	8	7	7713	0	7747
27589	8	15	7566	153	0	7742
27590	14	7909	99	60	0	8082
27591	9	106	32	8245	0	8392
27592	15	41	18	8765	0	8839
27593	7	28	8651	150	0	8836
27594	18	12	110	8443	0	8583
27595	12	8424	36	134	0	8606
27596	5	8666	24	69	0	8764
27597	19	138	9	8577	0	8743
27598	8	60	8404	145	0	8617
27599	7849	27	118	89	0	8083
27600	118	8302	44	52	0	8516
27601	38	116	8067	37	0	8258
27602	25	59	8004	40	0	8128
27603	17	7990	137	38	0	8182
27604	32	108	8091	27	0	8258
27605	47	128	136	7761	0	8072
27606	7725	32	49	129	0	7935
27607	7859	23	29	64	0	7975
27608	7896	20	24	37	0	7977
27609	8144	18	20	40	0	8222
27610	145	8298	19	33	0	8495
27611	8420	120	17	39	0	8596
27612	137	8554	26	30	0	8747
27613	59	138	8464	31	0	8692
27614	49	56	131	8287	0	8523
27615	20	8583	43	126	0	8772
27616	34	131	34	8339	0	8538
27617	8214	59	21	156	0	8450
27618	151	32	17	8082	0	8282
27619	55	8284	17	136	0	8492
27620	8328	128	20	59	0	8535
27621	137	50	8323	49	0	8559
27622	63	45	129	8295	0	8532
27623	45	23	45	8457	0	8570
27624	8145	26	33	179	0	8383
27625	130	8088	28	92	0	8338
27626	60	130	8013	50	0	8253
27627	55	58	126	8039	0	8278
27628	29	39	8098	148	0	8314
27629	26	7899	136	74	0	8135
27630	30	8126	50	60	0	8266
27631	8050	167	38	42	0	8297
27632	140	74	8040	41	0	8295
27633	8130	40	143	57	0	8370
27634	159	45	50	8014	0	8268
27635	51	8177	47	140	0	8415
27636	8144	139	27	66	0	8376
27637	137	67	8235	61	0	8500
27638	71	47	135	8168	0	8421
27639	52	38	53	8280	0	8423
27640	43	39	50	8194	0	8326
27641	28	8147	34	187	0	8396
27642	7941	143	32	93	0	8209
27643	150	7878	28	56	0	8112
27644	54	7957	30	48	0	8089
27645	51	162	38	7959	0	8210
27646	7978	71	37	155	0	8241
27647	7954	51	29	75	0	8109
27648	7937	50	27	50	0	8064
27649	180	7577	30	51	0	7838
27650	81	150	31	7610	0	7872
27651	55	67	7580	151	0	7853
27652	64	50	135	7480	0	7729
27653	53	51	46	7465	0	7615
27654	44	7543	40	172	0	7799
27655	7602	145	24	93	0	7864
27656	161	74	25	7471	0	7731
27657	72	7547	28	156	0	7803
27658	7581	151	24	86	0	7842
27659	159	62	7513	66	0	7800
27660	7397	61	132	49	0	7639
27661	169	7586	56	58	0	7869
27662	7675	159	34	60	0	7928
27663	7723	73	29	49	0	7874
27664	168	57	7657	52	0	7934
27665	7654	43	135	53	0	7885
27666	178	45	7911	42	0	8176
27667	90	46	7983	44	0	8163
27668	7856	45	155	40	0	8096
27669	8036	41	70	41	0	8188
27670	202	36	8063	33	0	8334
27671	94	35	143	7958	0	8230
27672	82	42	52	7988	0	8164
27673	70	8270	49	144	0	8533
27674	8095	132	44	80	0	8351
27675	8332	60	30	63	0	8485
27676	180	61	8273	40	0	8554
27677	8295	37	125	44	0	8501
27678	8469	32	58	42	0	8601
27679	190	8252	52	38	0	8532
27680	102	140	30	8071	0	8343
27681	94	52	31	7728	0	7905
27682	63	42	32	7738	0	7875
27683	7402	28	34	146	0	7610
27684	133	7092	19	74	0	7318
27685	40	95	19	6205	0	6359
27686	35	6148	16	74	0	6273
27687	38	197	15	5879	0	6129
27688	31	5941	17	73	0	6062
27689	22	5991	20	33	0	6066
27690	5523	94	42	50	0	5709
27691	5462	34	42	38	0	5576
27692	52	20	7	5151	0	5230
27693	22	5	7	5212	0	5246
27694	16	9	5	5253	0	5283
27695	15	6	6	5251	0	5278
27696	13	4	5	5192	0	5214
27697	9	5139	5	51	0	5204
27698	22	36	6	5200	0	5264
27699	8	10	12	5287	0	5317
27700	5207	10	6	52	0	5275
27701	54	6	2	5227	0	5289
27702	13	6	9	5202	0	5230
27703	18	9	5194	50	0	5271
27704	7	3	41	5061	0	5112
27705	17	19	6	5225	0	5267
27706	22	7	5297	44	0	5370
27707	10	5285	34	24	0	5353
27708	7	41	5332	18	0	5398
27709	24	9	5169	6	0	5208
27710	5	5004	39	8	0	5056
27711	5080	32	33	12	0	5157
27712	5027	6	6	7	0	5046
27713	30	11	1	4991	0	5033
27714	5058	2	5	36	0	5101
27715	39	3	5176	6	0	5224
27716	10	3	29	5242	0	5284
27717	12	3	5677	30	0	5722
27718	7	4	35	5737	0	5783
27719	12	3	6	5831	0	5852
27720	9	0	8	5850	0	5867
27721	5862	3	4	56	0	5925
27722	35	5	3	5938	0	5981
27723	5930	1	5	52	0	5988
27724	5970	0	5	24	0	5999
27725	36	5937	6	13	0	5992
27726	5994	31	4	18	0	6047
27727	40	6149	8	13	0	6210
27728	12	37	2	6127	0	6178
27729	18	10	3	6196	0	6227
27730	15	13	4	6248	0	6280
27731	14	7	6109	54	0	6184
27732	15	6044	38	19	0	6116
27733	16	41	8	5981	0	6046
27734	9	10	7	5984	0	6010
27735	5	6073	8	52	0	6138
27736	6108	36	6	31	0	6181
27737	41	5948	6	22	0	6017
27738	5901	47	1	26	0	5975
27739	49	6043	6	16	0	6114
27740	19	47	2	5990	0	6058
27741	12	6143	6	49	0	6210
27742	6300	40	2	24	0	6366
27743	6358	19	2	24	0	6403
27744	6356	12	3	28	0	6399
27745	6309	8	2	22	0	6341
27746	59	5	6317	12	0	6393
27747	6374	10	37	18	0	6439
27748	6547	4	5	19	0	6575
27749	6529	8	16	19	0	6572
27750	52	9	6457	15	0	6533
27751	6441	9	33	22	0	6505
27752	44	6620	13	20	0	6697
27753	6715	41	7	22	0	6785
27754	48	18	7113	14	0	7193
27755	7139	12	32	27	0	7210
27756	7302	10	9	16	0	7337
27757	53	5	7	7274	0	7339
27758	24	4	7219	34	0	7281
27759	7335	9	28	29	0	7401
27760	54	6	8	7512	0	7580
27761	30	6	10	7663	0	7709
27762	25	7	7737	49	0	7818
27763	7394	3	34	34	0	7465
27764	7769	4	13	32	0	7818
27765	46	7778	11	26	0	7861
27766	27	42	12	7774	0	7855
27767	30	8	7	7765	0	7810
27768	15	17	8	7723	0	7763
27769	12	7811	7	61	0	7891
27770	7835	40	9	27	0	7911
27771	45	12	5	7807	0	7869
27772	32	11	7	7830	0	7880
27773	7635	7	6	52	0	7700
27774	7568	8	10	33	0	7619
27775	50	9	7	7709	0	7775
27776	25	11	7	7625	0	7668
27777	16	10	7375	54	0	7455
27778	7063	7	36	44	0	7150
27779	53	7483	6	27	0	7569
27780	20	40	10	7944	0	8014
27781	29	8	9	8120	0	8166
27782	24	8442	3	73	0	8542
27783	19	68	9	8717	0	8813
27784	9252	23	4	106	0	9385
27785	104	16	12	10312	0	10444
27786	46	6	3	10590	0	10645
27787	33	13	4	10783	0	10833
27788	20	7	10631	244	0	10902
27789	27	8	132	10714	0	10881
27790	24	8	10595	218	0	10845
27791	18	10372	153	116	0	10659
27792	34	138	74	10502	0	10748
27793	22	63	52	10570	0	10707
27794	25	38	23	10742	0	10828
27795	24	23	24	10720	0	10791
27796	26	25	16	10831	0	10898
27797	10451	14	13	300	0	10778
27798	130	17	10487	153	0	10787
27799	62	10210	130	111	0	10513
27800	49	10809	57	79	0	10994
27801	32	180	38	10809	0	11059
27802	31	88	23	10966	0	11108
27803	26	56	20	10861	0	10963
27804	18	10741	18	251	0	11028
27805	24	150	13	10851	0	11038
27806	9	75	10638	216	0	10938
27807	10	10413	133	132	0	10688
27808	19	158	58	10539	0	10774
27809	10385	78	43	195	0	10701
27810	135	43	18	10478	0	10674
27811	70	36	18	10425	0	10549
27812	42	10036	20	229	0	10327
27813	24	10630	10	140	0	10804
27814	41	171	14	10605	0	10831
27815	31	90	14	10607	0	10742
27816	15	59	10403	237	0	10714
27817	18	47	918	9301	0	10284
27818	22	28	72	10225	0	10347
27819	18	23	52	10171	0	10264
27820	17	16	27	10296	0	10356
27821	9971	25	27	273	0	10296
27822	10068	20	22	177	0	10287
27823	195	12	16	10241	0	10464
27824	104	13	16	10493	0	10626
27825	10324	14	12	288	0	10638
27826	179	14	9	10621	0	10823
27827	94	10	10565	265	0	10934
27828	58	10600	148	177	0	10983
27829	39	145	72	10830	0	11086
27830	33	72	54	11013	0	11172
27831	10956	50	37	279	0	11322
27832	161	36	29	11166	0	11392
27833	82	32	18	11371	0	11503
27834	11320	23	12	326	0	11681
27835	176	21	14	11489	0	11700
27836	98	11487	12	279	0	11876
27837	64	173	18	11977	0	12232
27838	47	81	16	12318	0	12462
27839	51	54	17	12264	0	12386
27840	46	41	13	12327	0	12427
27841	22	48	11941	337	0	12348
27842	26	26	11724	217	0	11993
27843	29	31	214	11891	0	12165
27844	26	31	98	11731	0	11886
27845	14	11760	63	320	0	12157
27846	31	174	46	11541	0	11792
27847	10	11637	50	273	0	11970
27848	11526	210	32	184	0	11952
27849	179	11884	24	146	0	12233
27850	92	214	21	12151	0	12478
27851	65	97	14	12368	0	12544
27852	46	68	12049	313	0	12476
27853	11620	58	171	205	0	12054
27854	11579	57	64	158	0	11858
27855	235	11554	43	137	0	11969
27856	119	180	46	11387	0	11732
27857	74	89	11860	237	0	12260
27858	49	11993	181	162	0	12385
27859	11840	200	89	140	0	12269
27860	11854	93	51	120	0	12118
27861	248	55	11380	112	0	11795
27862	11443	49	175	86	0	11753
27863	257	43	79	11510	0	11889
27864	132	11498	48	251	0	11929
27865	11464	184	27	153	0	11828
27866	228	86	32	11431	0	11777
27867	11553	60	26	260	0	11899
27868	12041	39	29	157	0	12266
27869	281	47	23	11856	0	12207
27870	141	34	11968	264	0	12407
27871	12155	33	178	172	0	12538
27872	12475	26	80	147	0	12728
27873	12564	32	43	131	0	12770
27874	304	12697	35	119	0	13155
27875	169	195	34	12654	0	13052
27876	112	99	31	13171	0	13413
27877	84	71	12977	335	0	13467
27878	75	52	194	12729	0	13050
27879	52	12686	93	297	0	13128
27880	12309	186	44	182	0	12721
27881	197	12263	34	147	0	12641
27882	99	206	11964	82	0	12351
27883	63	11988	188	96	0	12335
27884	51	11848	98	76	0	12073
27885	135	145	87	10469	0	10836
27886	10472	44	33	140	0	10689
27887	10461	22	9	66	0	10558
27888	10306	16	13	49	0	10384
27889	138	10484	12	38	0	10672
27890	56	112	10421	26	0	10615
27891	10359	35	104	41	0	10539
27892	10586	26	39	53	0	10704
27893	137	10506	10	40	0	10693
27894	10722	109	21	41	0	10893
27895	139	45	18	10737	0	10939
27896	60	25	11208	122	0	11415
27897	11214	21	110	70	0	11415
27898	11228	27	43	49	0	11347
27899	11653	12	19	42	0	11726
27900	170	20	13	11430	0	11633
27901	79	24	15	11718	0	11836
27902	53	20	6	12164	0	12243
27903	34	12079	17	199	0	12329
27904	81	147	29	12213	0	12470
27905	49	63	13	13608	0	13733
27906	33	45	13541	244	0	13863
27907	41	30	178	13562	0	13811
27908	56	20	56	13835	0	13967
27909	58	19	32	13887	0	13996
27910	65	9	24	13814	0	13912
27911	28	13712	15	291	0	14046
27912	38	195	18	13842	0	14093
27913	52	58	23	13797	0	13930
27914	13592	35	25	303	0	13955
27915	232	31	13505	119	0	13887
27916	101	26	13251	83	0	13461
27917	13104	34	245	91	0	13474
27918	13553	17	83	84	0	13737
27919	268	17	45	12803	0	13133
27920	95	13351	42	206	0	13694
27921	13381	193	21	103	0	13698
27922	234	70	18	13133	0	13455
27923	83	13194	34	214	0	13525
27924	13196	178	17	110	0	13501
27925	203	13260	17	66	0	13546
27926	13074	194	14	76	0	13358
27927	12841	72	13	65	0	12991
27928	252	12563	24	42	0	12881
27929	116	181	21	12474	0	12792
27930	76	73	12389	194	0	12732
27931	71	57	159	12251	0	12538
27932	12217	39	50	235	0	12541
27933	203	36	12038	82	0	12359
27934	82	11936	164	65	0	12247
27935	81	211	52	11784	0	12128
27936	47	75	11695	197	0	12014
27937	35	11500	170	91	0	11796
27938	11394	182	79	87	0	11742
27939	192	63	46	11541	0	11842
27940	88	40	30	11666	0	11824
27941	74	34	24	11553	0	11685
27942	30	11478	29	244	0	11781
27943	11467	164	28	125	0	11784
27944	179	11313	25	86	0	11603
27945	74	11645	15	64	0	11798
27946	11601	202	16	70	0	11889
27947	11662	87	28	70	0	11847
27948	220	64	11428	50	0	11762
27949	11164	41	169	57	0	11431
27950	11177	39	51	43	0	11310
27951	260	39	34	10926	0	11259
27952	108	48	10840	177	0	11173
27953	94	35	161	10890	0	11180
27954	11099	29	52	227	0	11407
27955	206	28	11368	92	0	11694
27956	122	33	184	12155	0	12494
27957	105	21	76	13144	0	13346
27958	67	30	50	14094	0	14241
27959	13955	28	35	412	0	14430
27960	328	14142	34	149	0	14653
27961	14196	314	32	95	0	14637
27962	356	91	14240	65	0	14752
27963	152	46	307	13829	0	14334
27964	67	14263	83	335	0	14748
27965	14372	314	49	144	0	14879
27966	363	97	35	14346	0	14841
27967	129	62	14052	361	0	14604
27968	98	39	297	13846	0	14280
27969	13515	33	99	376	0	14023
27970	312	13448	53	149	0	13962
27971	147	329	31	12476	0	12983
27972	70	13269	31	317	0	13687
27973	13034	320	23	266	0	13643
27974	13018	101	29	85	0	13233
27975	365	12758	45	80	0	13248
27976	12620	290	31	65	0	13006
27977	361	98	21	12208	0	12688
27978	115	12498	19	294	0	12926
27979	12513	308	18	95	0	12934
27980	12771	87	22	75	0	12955
27981	372	12141	33	68	0	12614
27982	131	12379	16	50	0	12576
27983	12131	326	13	55	0	12525
27984	329	110	20	12067	0	12526
27985	12150	72	22	310	0	12554
27986	372	49	10	12128	0	12559
27987	143	42	11984	310	0	12479
27988	97	51	268	12162	0	12578
27989	12017	50	61	336	0	12464
27990	334	38	12043	114	0	12529
27991	125	36	282	12066	0	12509
27992	109	34	61	12390	0	12594
27993	80	34	12084	364	0	12562
27994	11768	27	279	129	0	12203
27995	340	31	77	11965	0	12413
27996	102	31	11366	330	0	11829
27997	10846	38	289	114	0	11287
27998	305	11224	82	87	0	11698
27999	86	11132	52	91	0	11361
28000	59	11400	45	67	0	11571
28001	69	294	10824	54	0	11241
28002	63	149	268	10408	0	10888
28003	43	46	10391	293	0	10773
28004	43	260	242	9294	0	9839
28005	28	9065	75	258	0	9426
28006	26	9169	26	76	0	9297
28007	67	270	31	8950	0	9318
28008	8973	61	29	258	0	9321
28009	239	28	21	9123	0	9411
28010	69	27	16	9106	0	9218
28011	25	9014	17	265	0	9321
28012	8918	217	11	88	0	9234
28013	212	8997	18	53	0	9280
28014	80	227	21	9005	0	9333
28015	50	66	17	9070	0	9203
28016	45	8930	22	279	0	9276
28017	43	221	16	9074	0	9354
28018	8994	76	14	291	0	9375
28019	267	70	7	9024	0	9368
28020	122	51	15	9077	0	9265
28021	82	8922	35	260	0	9299
28022	66	225	38	9052	0	9381
28023	8739	78	30	276	0	9123
28024	8972	65	17	108	0	9162
28025	9042	54	20	81	0	9197
28026	310	41	30	8848	0	9229
28027	103	44	8679	286	0	9112
28028	91	43	8695	109	0	8938
28029	84	54	237	8803	0	9178
28030	8838	62	66	269	0	9235
28031	270	65	20	8905	0	9260
28032	9031	53	21	267	0	9372
28033	282	56	19	9057	0	9414
28034	147	60	17	9263	0	9487
28035	9132	46	12	302	0	9492
28036	290	53	8896	96	0	9335
28037	8877	59	204	86	0	9226
28038	294	54	8891	68	0	9307
28039	136	34	212	8751	0	9133
28040	8830	47	61	252	0	9190
28041	276	52	8846	86	0	9260
28042	113	40	8857	73	0	9083
28043	8762	41	242	79	0	9124
28044	278	38	8866	72	0	9254
28045	114	8763	221	95	0	9193
28046	75	205	87	9116	0	9483
28047	9543	57	50	308	0	9958
28048	263	28	9721	107	0	10119
28049	9748	24	246	85	0	10103
28050	10049	12	100	96	0	10257
28051	10039	22	61	97	0	10219
28052	10065	19	67	81	0	10232
28053	291	68	48	9695	0	10102
28054	100	9380	42	509	0	10031
28055	9242	185	59	104	0	9590
28056	218	51	8335	46	0	8650
28057	48	6913	87	29	0	7077
28058	6285	69	60	29	0	6443
28059	61	5948	19	15	0	6043
28060	24	6154	8	13	0	6199
28061	158	82	81	5983	0	6304
28062	18	18	18	6147	0	6201
28063	14	7	4	6162	0	6187
28064	6226	4	4	62	0	6296
28065	6456	4	6	28	0	6494
28066	73	4	5	6630	0	6712
28067	28	4	6	6949	0	6987
28068	15	4	7164	86	0	7269
28069	7093	4	73	32	0	7202
28070	7383	7	21	14	0	7425
28071	106	4	9	7327	0	7446
28072	39	4	5	7398	0	7446
28073	18	2	7324	106	0	7450
28074	23	3	82	7322	0	7430
28075	17	2	7549	96	0	7664
28076	17	7526	88	37	0	7668
28077	16	74	7648	25	0	7763
28078	22	33	86	7504	0	7645
28079	10	13	7834	84	0	7941
28080	14	8	7495	31	0	7548
28081	7745	7	104	22	0	7878
28082	89	10	33	8166	0	8298
28083	26	4	8167	88	0	8285
28084	7693	3	87	46	0	7829
28085	86	2	8197	12	0	8297
28086	32	5	8824	9	0	8870
28087	21	9105	97	26	0	9249
28088	17	71	31	9141	0	9260
28089	11	20	9107	74	0	9212
28090	18	13	8813	21	0	8865
28091	14	11	96	9027	0	9148
28092	17	6	26	9082	0	9131
28093	7	9152	13	97	0	9269
28094	9	73	13	9236	0	9331
28095	9352	18	15	98	0	9483
28096	9368	9	13	48	0	9438
28097	9503	5	9	38	0	9555
28098	106	9	10	9323	0	9448
28099	39	9418	8	85	0	9550
28100	9481	68	13	50	0	9612
28101	74	9472	12	35	0	9593
28102	29	9257	14	19	0	9319
28103	15	9381	17	15	0	9428
28104	9498	76	23	17	0	9614
28105	72	30	13	9461	0	9576
28106	29	13	16	9461	0	9519
28107	17	9465	13	78	0	9573
28108	9289	64	18	39	0	9410
28109	67	24	9221	24	0	9336
28110	32	20	66	9233	0	9351
28111	9253	9	28	80	0	9370
28112	62	9533	27	31	0	9653
28113	9918	63	15	37	0	10033
28114	84	21	17	10081	0	10203
28115	27	10252	11	75	0	10365
28116	23	69	10155	26	0	10273
28117	10121	27	66	31	0	10245
28118	75	23	27	10396	0	10521
28119	10520	6	16	89	0	10631
28120	82	15	11	10488	0	10596
28121	30	10490	11	85	0	10616
28122	31	69	10694	33	0	10827
28123	28	23	10638	31	0	10720
28124	26	43	76	10781	0	10926
28125	11001	8	35	90	0	11134
28126	11025	14	15	39	0	11093
28127	85	15	11	10957	0	11068
28128	38	13	13	10999	0	11063
28129	11181	8	7	100	0	11296
28130	73	14	10	11229	0	11326
28131	11260	5	10	100	0	11375
28132	83	11141	8	50	0	11282
28133	11127	68	12	41	0	11248
28134	91	25	11279	20	0	11415
28135	43	17	66	11267	0	11393
28136	28	14	28	11460	0	11530
28137	33	11	28	11513	0	11585
28138	26	11267	13	103	0	11409
28139	34	9486	32	65	0	9617
28140	26	78	12	11388	0	11504
28141	16	31	11400	95	0	11542
28142	22	15	80	11373	0	11490
28143	22	13	33	11638	0	11706
28144	24	21	18	11717	0	11780
28145	11409	12	23	116	0	11560
28146	86	11054	19	51	0	11210
28147	24	11111	26	44	0	11205
28148	41	85	18	10883	0	11027
28149	29	37	29	11137	0	11232
28150	28	17	18	11114	0	11177
28151	28	16	13	11197	0	11254
28152	11034	11	16	117	0	11178
28153	74	10980	18	122	0	11194
28154	11145	73	10	51	0	11279
28155	11340	30	18	45	0	11433
28156	91	23	15	11263	0	11392
28157	46	16	11	11380	0	11453
28158	11320	10	12	123	0	11465
28159	11383	15	10	52	0	11460
28160	106	9	13	11134	0	11262
28161	46	22	6	11158	0	11232
28162	29	11	11090	106	0	11236
28163	27	10798	58	65	0	10948
28164	25	11204	16	41	0	11286
28165	10842	66	17	36	0	10961
28166	69	29	10983	23	0	11104
28167	30	13	10398	20	0	10461
28168	9817	12	75	18	0	9922
28169	10190	11	30	28	0	10259
28170	45	10930	9	12	0	10996
28171	18	11383	16	8	0	11425
28172	17	39	2	11586	0	11644
28173	12015	10	2	64	0	12091
28174	12136	10	4	29	0	12179
28175	12225	4	1	26	0	12256
28176	49	3	3	12122	0	12177
28177	24	4	3	12258	0	12289
28178	8	10	12168	50	0	12236
28179	16	10	11411	29	0	11466
28180	9	12	12261	13	0	12295
28181	24	102	49	12094	0	12269
28182	12024	3	18	56	0	12101
28183	50	4	12398	12	0	12464
28184	19	4	45	12350	0	12418
28185	8	12583	10	47	0	12648
28186	14	43	4	12395	0	12456
28187	17	5	7	12509	0	12538
28188	15	6	12849	81	0	12951
28189	11	6	78	12690	0	12785
28190	13298	5	10	108	0	13421
28191	105	10	13823	21	0	13959
28192	27	2	94	13837	0	13960
28193	17	4	14169	102	0	14292
28194	11	14185	111	26	0	14333
28195	22	104	14341	17	0	14484
28196	27	21	122	13672	0	13842
28197	14	16	28	14557	0	14615
28198	20	21	14961	137	0	15139
28199	20	7	121	14662	0	14810
28200	33	10	23	14620	0	14686
28201	10	14695	23	135	0	14863
28202	15	112	14878	43	0	15048
28203	20	21	124	14805	0	14970
28204	13	20	27	15056	0	15116
28205	9	15074	24	161	0	15268
28206	16	120	17	15271	0	15424
28207	15303	23	14	168	0	15508
28208	137	18	16	15342	0	15513
28209	31	18	15434	161	0	15644
28210	15181	9	136	91	0	15417
28211	16257	11	32	60	0	16360
28212	184	7	16173	32	0	16396
28213	15603	9	165	63	0	15840
28214	193	16334	39	32	0	16598
28215	52	167	38	16605	0	16862
28216	49	38	20	17718	0	17825
28217	56	43	19	17482	0	17600
28218	30	23	22	18004	0	18079
28219	31	10	22	18035	0	18098
28220	17789	14	17	321	0	18141
28221	213	16	17595	116	0	17940
28222	16853	6	211	112	0	17182
28223	251	9	17288	82	0	17630
28224	76	14	236	17212	0	17538
28225	17322	11	69	271	0	17673
28226	250	17	50	17226	0	17543
28227	73	17353	49	266	0	17741
28228	17870	203	36	99	0	18208
28229	270	77	25	18305	0	18677
28230	89	43	17102	276	0	17510
28231	17323	24	184	129	0	17660
28232	256	18623	51	102	0	19032
28233	77	236	19069	70	0	19452
28234	91	59	251	18815	0	19216
28235	83	51	82	18392	0	18608
28236	52	18742	68	297	0	19159
28237	45	236	18850	123	0	19254
28238	58	73	238	18740	0	19109
28239	32	63	19165	313	0	19573
28240	46	34	272	19029	0	19381
28241	41	21	85	19151	0	19298
28242	38	31	18956	359	0	19384
28243	62	25	271	18857	0	19215
28244	159	40	183	15481	0	15863
28245	57	15	93	19970	0	20135
28246	66	27	74	20035	0	20202
28247	19477	27	55	434	0	19993
28248	284	25	19261	213	0	19783
28249	19691	21	291	174	0	20177
28250	349	28	108	20389	0	20874
28251	134	40	92	20776	0	21042
28252	95	34	74	20613	0	20816
28253	66	20254	67	641	0	21028
28254	20589	319	63	224	0	21195
28255	331	95	75	21465	0	21966
28256	102	21472	69	395	0	22038
28257	86	291	59	21764	0	22200
28258	21813	88	67	446	0	22414
28259	21865	76	50	236	0	22227
28260	21787	57	72	197	0	22113
28261	396	21694	56	181	0	22327
28262	156	308	21724	145	0	22333
28263	21576	92	313	181	0	22162
28264	22112	71	111	177	0	22471
28265	401	22296	89	150	0	22936
28266	22261	293	69	166	0	22789
28267	21942	106	67	163	0	22278
28268	22509	77	48	166	0	22800
28269	448	22823	57	149	0	23477
28270	236	301	58	22634	0	23229
28271	22641	104	50	409	0	23204
28272	23248	86	54	184	0	23572
28273	22674	64	40	172	0	22950
28274	23036	56	39	161	0	23292
28275	514	74	35	22650	0	23273
28276	230	71	22448	433	0	23182
28277	197	53	324	22409	0	22983
28278	166	22755	108	443	0	23472
28279	173	365	71	23392	0	24001
28280	134	134	23502	454	0	24224
28281	23432	84	395	213	0	24124
28282	496	56	132	23845	0	24529
28283	23611	56	91	478	0	24236
28284	23834	72	72	234	0	24212
28285	552	76	49	23703	0	24380
28286	256	52	23630	474	0	24412
28287	248	62	22439	203	0	22952
28288	22007	60	396	174	0	22637
28289	450	22457	153	165	0	23225
28290	212	22122	99	112	0	22545
28291	170	21828	69	127	0	22194
28292	148	22515	75	113	0	22851
28293	21871	397	146	128	0	22542
28294	21980	140	65	131	0	22316
28295	21904	101	47	115	0	22167
28296	21945	83	50	106	0	22184
28297	509	92	35	21289	0	21925
28298	242	20925	57	338	0	21562
28299	20904	310	53	186	0	21453
28300	440	116	20770	113	0	21439
28301	194	20731	298	116	0	21339
28302	188	304	20778	89	0	21359
28303	20479	121	307	114	0	21021
28304	20988	90	113	127	0	21318
28305	20940	116	72	103	0	21231
28306	492	68	66	20656	0	21282
28307	262	77	20579	315	0	21233
28308	209	20527	284	139	0	21159
28309	20136	293	105	142	0	20676
28310	397	19943	86	106	0	20532
28311	184	19230	44	200	0	19658
28312	161	19177	38	83	0	19459
28313	137	19173	51	83	0	19444
28314	147	301	18232	53	0	18733
28315	145	18300	248	63	0	18756
28316	17296	246	102	79	0	17723
28317	280	87	38	17247	0	17652
28318	152	59	33	17420	0	17664
28319	17256	58	32	277	0	17623
28320	260	17128	48	102	0	17538
28321	124	224	17383	66	0	17797
28322	136	93	203	17242	0	17674
28323	128	56	72	17530	0	17786
28324	127	58	43	17673	0	17901
28325	103	66	17351	274	0	17794
28326	102	70	17256	107	0	17535
28327	104	62	238	17271	0	17675
28328	101	65	17114	214	0	17494
28329	102	74	16245	92	0	16513
28330	15439	54	234	79	0	15806
28331	235	16275	79	73	0	16662
28332	125	15799	48	60	0	16032
28333	105	16044	49	63	0	16261
28334	129	256	54	15472	0	15911
28335	101	16465	45	182	0	16793
28336	16766	211	59	115	0	17151
28337	258	97	17081	75	0	17511
28338	17434	67	214	84	0	17799
28339	287	71	93	17484	0	17935
28340	146	59	69	17722	0	17996
28341	83	18369	60	273	0	18785
28342	18424	259	49	133	0	18865
28343	18562	101	81	91	0	18835
28344	382	19396	54	70	0	19902
28345	546	334	42	18444	0	19366
28346	107	116	19086	290	0	19599
28347	80	70	19150	114	0	19414
28348	78	19558	358	73	0	20067
28349	19378	347	133	119	0	19977
28350	324	120	19494	32	0	19970
28351	176	63	297	19297	0	19833
28352	19627	53	100	302	0	20082
28353	20043	41	53	144	0	20281
28354	386	22532	54	78	0	23050
28355	138	23639	57	59	0	23893
28356	23690	510	52	49	0	24301
28357	468	204	23707	29	0	24408
28358	23759	103	408	52	0	24322
28359	24120	81	161	54	0	24416
28360	617	76	69	23723	0	24485
28361	228	58	24096	412	0	24794
28362	153	65	23853	145	0	24216
28363	23339	53	546	99	0	24037
28364	479	78	23926	61	0	24544
28365	22931	54	467	69	0	23521
28366	23125	40	525	65	0	23755
28367	552	23195	103	58	0	23908
28368	235	413	23043	33	0	23724
28369	136	22764	434	49	0	23383
28370	22289	426	201	73	0	22989
28371	464	170	22027	44	0	22705
28372	248	139	403	21127	0	21917
28373	146	74	21570	384	0	22174
28374	126	55	21583	139	0	21903
28375	120	50	21546	55	0	21771
28376	123	48	21458	49	0	21678
28377	90	20767	572	38	0	21467
28378	117	364	20525	44	0	21050
28379	100	20138	430	51	0	20719
28380	97	368	19822	62	0	20349
28381	19624	154	422	52	0	20252
28382	430	86	210	18559	0	19285
28383	203	19784	136	312	0	20435
28384	19557	353	133	141	0	20184
28385	19726	168	100	88	0	20082
28386	18576	107	113	86	0	18882
28387	19485	78	120	66	0	19749
28388	504	19376	122	56	0	20058
28389	18690	374	126	75	0	19265
28390	19466	175	121	69	0	19831
28391	514	18814	130	85	0	19543
28392	261	407	17868	59	0	18595
28393	190	200	405	18003	0	18798
28394	144	18812	239	328	0	19523
28395	145	413	18890	149	0	19597
28396	179	213	18954	74	0	19420
28397	167	18584	521	57	0	19329
28398	164	18778	266	70	0	19278
28399	166	19532	176	115	0	19989
28400	169	19488	154	67	0	19878
28401	19715	550	144	67	0	20476
28402	20054	285	137	63	0	20539
28403	638	185	20142	71	0	21036
28404	347	149	20500	59	0	21055
28405	270	127	602	20099	0	21098
28406	254	146	310	20588	0	21298
28407	277	142	201	20868	0	21488
28408	20682	147	179	551	0	21559
28409	513	20573	190	291	0	21567
28410	344	21305	184	146	0	21979
28411	283	21825	189	99	0	22396
28412	21452	662	197	77	0	22388
28413	21861	337	207	96	0	22501
28414	733	230	205	21474	0	22642
28415	22198	182	242	455	0	23077
28416	22363	180	243	204	0	22990
28417	784	203	215	21984	0	23186
28418	22191	207	217	500	0	23115
28419	663	21922	273	240	0	23098
28420	433	534	282	21762	0	23011
28421	365	284	21712	459	0	22820
28422	306	21644	662	232	0	22844
28423	316	572	21995	146	0	23029
28424	344	322	675	20943	0	22284
28425	305	21953	444	460	0	23162
28426	352	549	382	21784	0	23067
28427	330	336	307	22103	0	23076
28428	339	240	21780	615	0	22974
28429	306	228	22586	284	0	23404
28430	288	196	794	22206	0	23484
28431	309	221	466	21492	0	22488
28432	262	22414	389	608	0	23673
28433	21659	585	330	303	0	22877
28434	681	21864	294	198	0	23037
28435	376	22201	268	169	0	23014
28436	255	716	21247	159	0	22377
28437	201	21231	625	135	0	22192
28438	242	631	397	19724	0	20994
28439	250	20801	317	446	0	21814
28440	225	595	264	19900	0	20984
28441	154	20263	242	487	0	21146
28442	20021	544	243	235	0	21043
28443	544	20223	219	165	0	21151
28444	291	541	169	18039	0	19040
28445	224	19071	146	384	0	19825
28446	18919	520	155	181	0	19775
28447	18872	296	120	130	0	19418
28448	581	18569	134	104	0	19388
28449	18145	442	97	108	0	18792
28450	560	525	99	17273	0	18457
28451	288	186	17490	386	0	18350
28452	257	187	17451	170	0	18065
28453	193	17573	449	134	0	18349
28454	13950	235	257	86	0	14528
28455	13797	81	72	54	0	14004
28456	247	74	13640	54	0	14015
28457	95	54	13370	52	0	13571
28458	13183	58	212	62	0	13515
28459	13518	69	70	59	0	13716
28460	237	59	13265	44	0	13605
28461	12499	76	187	58	0	12820
28462	214	12712	80	41	0	13047
28463	67	13274	51	52	0	13444
28464	63	232	71	13076	0	13442
28465	53	90	51	13261	0	13455
28466	13258	83	36	224	0	13601
28467	13245	62	38	92	0	13437
28468	13256	54	41	80	0	13431
28469	222	72	42	13102	0	13438
28470	99	45	50	13133	0	13327
28471	64	12655	28	232	0	12979
28472	64	12772	32	104	0	12972
28473	64	13212	34	54	0	13364
28474	79	241	34	12650	0	13004
28475	66	13012	30	182	0	13290
28476	82	222	12626	59	0	12989
28477	12097	98	157	71	0	12423
28478	196	76	12724	64	0	13060
28479	87	77	12628	50	0	12842
28480	12491	80	196	44	0	12811
28481	202	12817	63	58	0	13140
28482	12892	218	38	61	0	13209
28483	12950	79	38	69	0	13136
28484	228	83	12586	53	0	12950
28485	99	69	12848	51	0	13067
28486	94	13085	197	34	0	13410
28487	85	214	13354	49	0	13702
28488	90	87	204	13429	0	13810
28489	126	86	95	11412	0	11719
28490	75	13401	60	206	0	13742
28491	76	13803	63	77	0	14019
28492	13680	236	55	74	0	14045
28493	14061	112	48	57	0	14278
28494	230	84	69	13965	0	14348
28495	120	64	57	14154	0	14395
28496	13889	70	63	229	0	14251
28497	13997	72	61	94	0	14224
28498	250	14094	47	80	0	14471
28499	13482	187	47	58	0	13774
28500	236	13029	37	39	0	13341
28501	106	13417	49	46	0	13618
28502	13345	199	43	57	0	13644
28503	13225	84	41	58	0	13408
28504	234	81	32	12996	0	13343
28505	12905	53	30	162	0	13150
28506	223	55	12782	51	0	13111
28507	88	12811	142	48	0	13089
28508	12655	170	49	72	0	12946
28509	190	53	12726	58	0	13027
28510	94	119	142	11895	0	12250
28511	68	11986	54	119	0	12227
28512	67	12209	31	42	0	12349
28513	12136	143	50	48	0	12377
28514	164	56	11877	38	0	12135
28515	11401	22	136	31	0	11590
28516	153	39	59	11548	0	11799
28517	70	38	11498	108	0	11714
28518	11274	34	98	48	0	11454
28519	133	11814	49	27	0	12023
28520	53	12276	34	34	0	12397
28521	12400	145	55	39	0	12639
28522	12425	55	25	34	0	12539
28523	12584	25	19	50	0	12678
28524	147	31	25	12452	0	12655
28525	84	27	26	12517	0	12654
28526	65	27	12384	113	0	12589
28527	60	30	12034	35	0	12159
28528	50	12278	105	45	0	12478
28529	40	118	45	11792	0	11995
28530	11736	25	17	83	0	11861
28531	89	11733	9	28	0	11859
28532	35	83	16	11743	0	11877
28533	11730	25	12	97	0	11864
28534	79	11653	12	42	0	11786
28535	37	12021	9	19	0	12086
28536	41	79	11714	13	0	11847
28537	11550	41	70	30	0	11691
28538	11808	20	25	31	0	11884
28539	86	25	11604	26	0	11741
28540	10991	14	67	19	0	11091
28541	79	15	11518	13	0	11625
28542	24	11299	59	12	0	11394
28543	46	68	23	11158	0	11295
28544	11091	21	27	57	0	11196
28545	58	10949	12	22	0	11041
28546	34	10943	5	12	0	10994
28547	10645	43	12	18	0	10718
28548	43	18	11078	8	0	11147
28549	10679	8	36	33	0	10756
28550	48	11273	17	10	0	11348
28551	25	44	10907	2	0	10978
28552	10692	16	33	17	0	10758
28553	11001	9	12	14	0	11036
28554	50	11	8	10943	0	11012
28555	27	11	3	11106	0	11147
28556	17	11066	8	35	0	11126
28557	20	51	11026	17	0	11114
28558	24	15	48	11194	0	11281
28559	20	15	11757	64	0	11856
28560	13	15	11748	21	0	11797
28561	20	12	87	12505	0	12624
28562	19	9	12778	105	0	12911
28563	55	6	12515	22	0	12598
28564	24	7	122	12402	0	12555
28565	15	13	12674	113	0	12815
28566	11924	8	123	49	0	12104
28567	109	12404	33	29	0	12575
28568	35	108	12728	10	0	12881
28569	20	24	13412	12	0	13468
28570	28	16	141	12913	0	13098
28571	13789	7	48	132	0	13976
28572	13903	12	25	45	0	13985
28573	13848	13	15	36	0	13912
28574	13914	6	33	25	0	13978
28575	153	6	24	13686	0	13869
28576	52	11	13809	118	0	13990
28577	13750	8	122	58	0	13938
28578	13968	5	35	42	0	14050
28579	14046	9	26	28	0	14109
28580	161	10	13685	17	0	13873
28581	13331	7	112	32	0	13482
28582	143	13	37	14209	0	14402
28583	53	14392	38	117	0	14600
28584	51	129	28	14042	0	14250
28585	32	14326	33	130	0	14521
28586	14426	131	30	55	0	14642
28587	160	31	14483	29	0	14703
28588	60	28	148	14042	0	14278
28589	35	14176	52	139	0	14402
28590	24	14657	42	41	0	14764
28591	14626	162	44	44	0	14876
28592	14621	47	39	28	0	14735
28593	186	28	14107	23	0	14344
28594	14249	24	161	30	0	14464
28595	196	17	51	14282	0	14546
28596	66	19	14646	152	0	14883
28597	74	17	14534	45	0	14670
28598	74	13	177	14913	0	15177
28599	15755	11	64	197	0	16027
28600	229	13	43	15698	0	15983
28601	99	9	37	15769	0	15914
28602	84	13	36	15703	0	15836
28603	58	15893	37	252	0	16240
28604	64	176	32	16093	0	16365
28605	15809	49	37	249	0	16144
28606	213	15878	33	98	0	16222
28607	89	192	37	16108	0	16426
28608	16053	65	31	229	0	16378
28609	217	15715	30	96	0	16058
28610	84	16005	32	79	0	16200
28611	61	241	27	16108	0	16437
28612	15851	88	30	232	0	16201
28613	239	47	15783	91	0	16160
28614	94	47	15634	64	0	15839
28615	16038	37	247	62	0	16384
28616	16685	40	100	58	0	16883
28617	308	16932	52	56	0	17348
28618	147	230	53	16548	0	16978
28619	85	83	16721	239	0	17128
28620	68	48	16366	98	0	16580
28621	98	41	17325	67	0	17531
28622	59	17117	343	59	0	17578
28623	52	17486	118	61	0	17717
28624	17381	296	70	83	0	17830
28625	294	104	17365	68	0	17831
28626	17195	65	284	68	0	17612
28627	17518	50	89	81	0	17738
28628	361	47	17546	51	0	18005
28629	132	17945	291	56	0	18424
28630	133	293	94	17599	0	18119
28631	79	95	18276	305	0	18755
28632	85	79	17515	105	0	17784
28633	17566	73	316	94	0	18049
28634	321	18115	114	60	0	18610
28635	142	307	71	17595	0	18115
28636	110	117	68	17609	0	17904
28637	73	17512	74	362	0	18021
28638	65	17952	81	126	0	18224
28639	83	18284	67	87	0	18521
28640	87	388	47	18474	0	18996
28641	18847	133	48	348	0	19376
28642	384	86	44	19052	0	19566
28643	131	69	18999	385	0	19584
28644	111	58	18998	135	0	19302
28645	91	68	406	19300	0	19865
28646	68	79	19474	363	0	19984
28647	79	19489	376	132	0	20076
28648	85	348	133	19954	0	20520
28649	20500	124	99	409	0	21132
28650	20435	86	82	173	0	20776
28651	477	20625	70	118	0	21290
28652	20775	413	67	105	0	21360
28653	21233	153	55	103	0	21544
28654	21267	98	63	103	0	21531
28655	551	104	18851	88	0	19594
28656	20133	60	319	86	0	20598
28657	455	20276	120	79	0	20930
28658	179	384	20091	62	0	20716
28659	139	123	20004	67	0	20333
28660	101	19684	433	95	0	20313
28661	19317	360	206	79	0	19962
28662	403	129	118	18694	0	19344
28663	152	18750	65	321	0	19288
28664	18981	338	62	140	0	19521
28665	375	135	50	19102	0	19662
28666	19311	84	47	385	0	19827
28667	406	71	55	19410	0	19942
28668	162	64	19127	376	0	19729
28669	113	68	18673	150	0	19004
28670	98	85	18859	98	0	19140
28671	115	80	431	18413	0	19039
28672	110	71	167	19094	0	19442
28673	105	76	18841	425	0	19447
28674	114	18723	375	177	0	19389
28675	19106	348	153	113	0	19720
28676	19200	157	118	75	0	19550
28677	476	19281	91	82	0	19930
28678	231	398	87	19442	0	20158
28679	162	161	19860	368	0	20551
28680	19435	104	400	170	0	20109
28681	434	88	19915	113	0	20550
28682	217	78	18590	71	0	18956
28683	147	74	19352	82	0	19655
28684	18721	87	481	85	0	19374
28685	415	77	19069	74	0	19635
28686	185	18340	430	74	0	19029
28687	139	19033	232	67	0	19471
28688	140	419	141	18430	0	19130
28689	124	167	105	18718	0	19114
28690	112	110	18513	434	0	19169
28691	17996	81	376	187	0	18640
28692	18927	79	189	100	0	19295
28693	495	91	135	18622	0	19343
28694	18557	63	119	391	0	19130
28695	415	18459	111	185	0	19170
28696	18289	357	95	120	0	18861
28697	407	17926	98	122	0	18553
28698	179	18084	85	76	0	18424
28699	17434	372	98	99	0	18003
28700	17335	153	97	85	0	17670
28701	17822	91	83	71	0	18067
28702	17987	79	77	81	0	18224
28703	480	68	16951	61	0	17560
28704	16900	68	316	75	0	17359
28705	392	67	152	16687	0	17298
28706	160	16926	111	303	0	17500
28707	16906	288	89	120	0	17403
28708	357	16857	82	87	0	17383
28709	16926	314	68	79	0	17387
28710	365	126	72	16887	0	17450
28711	184	95	61	17104	0	17444
28712	141	73	16450	355	0	17019
28713	132	66	16705	139	0	17042
28714	114	16927	324	105	0	17470
28715	16348	291	132	85	0	16856
28716	340	16060	87	69	0	16556
28717	170	15833	66	69	0	16138
28718	145	16370	62	51	0	16628
28719	138	336	15766	43	0	16283
28720	121	15848	262	40	0	16271
28721	14762	305	135	56	0	15258
28722	14755	113	71	49	0	14988
28723	342	86	45	14433	0	14906
28724	161	14179	55	222	0	14617
28725	118	14582	49	87	0	14836
28726	120	285	47	14398	0	14850
28727	113	122	14457	226	0	14918
28728	103	14099	239	100	0	14541
28729	140	270	78	13787	0	14275
28730	13564	107	59	248	0	13978
28731	13612	84	40	100	0	13836
28732	273	13698	58	72	0	14101
28733	13731	250	44	70	0	14095
28734	13838	99	52	56	0	14045
28735	298	92	44	13372	0	13806
28736	150	82	13191	207	0	13630
28737	99	13382	218	99	0	13798
28738	102	262	101	13212	0	13677
28739	79	118	13175	183	0	13555
28740	68	12809	183	89	0	13149
28741	12246	200	101	62	0	12609
28742	12284	98	54	63	0	12499
28743	238	82	45	12148	0	12513
28744	116	12265	41	172	0	12594
28745	87	192	12196	76	0	12551
28746	102	126	161	11965	0	12354
28747	69	72	12159	172	0	12472
28748	45	11498	156	80	0	11779
28749	113	150	88	10696	0	11047
28750	10669	50	45	107	0	10871
28751	101	10566	27	42	0	10736
28752	10419	110	10	45	0	10584
28753	10299	57	18	26	0	10400
28754	150	10494	20	31	0	10695
28755	81	106	16	10511	0	10714
28756	47	77	24	10420	0	10568
28757	40	10211	25	124	0	10400
28758	35	10450	24	58	0	10567
28759	37	134	26	9991	0	10188
28760	29	10270	21	88	0	10408
28761	10313	114	22	44	0	10493
28762	10212	47	19	33	0	10311
28763	124	40	10139	31	0	10334
28764	61	31	10033	31	0	10156
28765	10112	31	104	33	0	10280
28766	10310	25	45	33	0	10413
28767	102	10643	30	29	0	10804
28768	10605	103	22	32	0	10762
28769	10526	45	18	32	0	10621
28770	124	10398	10	30	0	10562
28771	10608	105	17	26	0	10756
28772	138	57	7	12076	0	12278
28773	71	34	17	12463	0	12585
28774	50	35	13094	182	0	13361
28775	33	12612	152	145	0	12942
28776	30	13275	34	42	0	13381
28777	12935	302	82	89	0	13408
28778	12976	62	30	54	0	13122
28779	12594	34	11	50	0	12689
28780	13114	18	17	40	0	13189
28781	207	28	12388	28	0	12651
28782	53	29	12898	15	0	12995
28783	33	13138	172	15	0	13358
28784	62	171	46	13075	0	13354
28785	63	41	28	12981	0	13113
28786	40	13329	18	161	0	13548
28787	63	179	23	13064	0	13329
28788	13021	44	22	181	0	13268
28789	187	13055	24	38	0	13304
28790	63	176	13262	30	0	13531
28791	45	13452	144	43	0	13684
28792	13365	176	41	43	0	13625
28793	171	51	13360	54	0	13636
28794	13170	41	172	45	0	13428
28795	13508	36	39	38	0	13621
28796	210	40	13367	27	0	13644
28797	56	41	13195	20	0	13312
28798	48	34	13116	17	0	13215
28799	12492	24	191	23	0	12730
28800	200	25	13101	12	0	13338
28801	58	12917	169	18	0	13162
28802	12860	162	53	26	0	13101
28803	178	32	12899	9	0	13118
28804	12363	34	185	23	0	12605
28805	195	14	12772	19	0	13000
28806	64	15	13134	16	0	13229
28807	39	13336	190	12	0	13577
28808	49	161	13432	16	0	13658
28809	48	43	13298	6	0	13395
28810	50	11854	200	21	0	12125
28811	12986	158	77	22	0	13243
28812	188	44	13138	16	0	13386
28813	68	31	184	12386	0	12669
28814	36	13176	68	143	0	13423
28815	13263	162	53	44	0	13522
28816	13212	41	55	29	0	13337
28817	196	37	13212	21	0	13466
28818	56	12825	183	17	0	13081
28819	35	13235	73	23	0	13366
28820	41	205	45	12850	0	13141
28821	53	12171	46	152	0	12422
28822	96	189	30	11767	0	12082
28823	69	55	46	13164	0	13334
28824	46	13227	50	179	0	13502
28825	60	191	41	13015	0	13307
28826	49	13152	39	190	0	13430
28827	61	191	13009	54	0	13315
28828	60	72	177	12897	0	13206
28829	53	49	72	12946	0	13120
28830	44	12838	55	194	0	13131
28831	36	13192	47	71	0	13346
28832	61	216	45	12698	0	13020
28833	54	12936	46	183	0	13219
28834	12850	205	39	86	0	13180
28835	204	60	61	12828	0	13153
28836	60	12906	48	184	0	13198
28837	12646	197	45	57	0	12945
28838	181	12629	57	44	0	12911
28839	75	207	12535	54	0	12871
28840	68	78	202	12423	0	12771
28841	12591	65	61	206	0	12923
28842	207	56	12741	67	0	13071
28843	88	74	195	12362	0	12719
28844	79	12506	66	159	0	12810
28845	69	199	12366	50	0	12684
28846	68	12555	202	51	0	12876
28847	11819	194	98	52	0	12163
28848	12298	70	87	44	0	12499
28849	236	12182	62	42	0	12522
28850	12170	198	82	42	0	12492
28851	205	82	12064	35	0	12386
28852	76	71	220	11880	0	12247
28853	84	56	82	11900	0	12122
28854	82	6390	76	5756	0	12304
28855	12436	133	86	141	0	12796
28856	12653	89	65	53	0	12860
28857	215	79	12622	27	0	12943
28858	12527	43	207	46	0	12823
28859	12847	60	90	53	0	13050
28860	12903	40	74	62	0	13079
28861	248	65	54	12607	0	12974
28862	101	56	70	12714	0	12941
28863	63	12781	68	181	0	13093
28864	12323	203	76	57	0	12659
28865	12450	70	47	65	0	12632
28866	238	12395	58	47	0	12738
28867	89	241	52	12067	0	12449
28868	64	12405	29	175	0	12673
28869	58	12957	44	65	0	13124
28870	12635	221	80	75	0	13011
28871	230	93	12331	58	0	12712
28872	57	39	10677	25	0	10798
28873	27	10559	106	30	0	10722
28874	9661	92	87	24	0	9864
28875	84	35	9584	13	0	9716
28876	32	8971	77	17	0	9097
28877	8766	71	21	12	0	8870
28878	64	14	8692	8	0	8778
28879	23	23	65	8499	0	8610
28880	8972	12	17	85	0	9086
28881	88	9	8961	14	0	9072
28882	23	20	9206	12	0	9261
28883	27	10	9424	10	0	9471
28884	9	13	9417	8	0	9447
28885	9107	11	107	11	0	9236
28886	9880	12	22	27	0	9941
28887	95	9973	14	13	0	10095
28888	28	101	11	10336	0	10476
28889	21	19	9	10655	0	10704
28890	10	10443	14	130	0	10597
28891	15	131	13	10587	0	10746
28892	16	10858	4	137	0	11015
28893	12	11120	5	27	0	11164
28894	19	154	5	10986	0	11164
28895	11	45	11097	129	0	11282
28896	9	11123	128	46	0	11306
28897	16	134	39	11208	0	11397
28898	11295	35	31	149	0	11510
28899	140	35	11252	34	0	11461
28900	11006	14	145	40	0	11205
28901	11476	10	39	21	0	11546
28902	207	22	27	11643	0	11899
28903	57	17	12007	184	0	12265
28904	35	15	12034	54	0	12138
28905	22	12578	227	34	0	12861
28906	34	210	83	12269	0	12596
28907	18	68	12350	200	0	12636
28908	17	43	12363	65	0	12488
28909	11	12530	245	53	0	12839
28910	12577	202	102	25	0	12906
28911	12850	70	44	20	0	12984
28912	273	38	25	13038	0	13374
28913	100	18	13341	228	0	13687
28914	49	15	13337	75	0	13476
28915	24	13676	292	54	0	14046
28916	24	239	13805	20	0	14088
28917	30	81	13713	29	0	13853
28918	36	64	320	13033	0	13453
28919	24	24	13681	250	0	13979
28920	13262	25	301	85	0	13673
28921	252	22	102	13637	0	14013
28922	91	27	13948	254	0	14320
28923	53	13968	274	90	0	14385
28924	29	255	113	14055	0	14452
28925	34	91	14289	261	0	14675
28926	23	14663	297	91	0	15074
28927	44	278	117	14330	0	14769
28928	31	14852	83	259	0	15225
28929	42	306	64	14889	0	15301
28930	48	99	63	15079	0	15289
28931	31	60	14862	379	0	15332
28932	26	14895	308	143	0	15372
28933	28	295	123	14955	0	15401
28934	23	105	92	15136	0	15356
28935	39	71	58	15310	0	15478
28936	20	47	14868	402	0	15337
28937	27	14802	302	157	0	15288
28938	27	288	118	14862	0	15295
28939	82	106	14768	316	0	15272
28940	26	14789	307	132	0	15254
28941	30	312	119	14794	0	15255
28942	25	118	14827	319	0	15289
28943	14	14817	299	146	0	15276
28944	20	297	128	14676	0	15121
28945	25	128	89	15126	0	15368
28946	24	77	15093	394	0	15588
28947	14260	58	310	191	0	14819
28948	268	15085	137	120	0	15610
28949	15174	316	94	102	0	15686
28950	310	127	15213	88	0	15738
28951	15182	79	338	97	0	15696
28952	331	74	140	15358	0	15903
28953	115	60	98	15756	0	16029
28954	59	73	15476	405	0	16013
28955	14472	56	334	200	0	15062
28956	14814	60	128	131	0	15133
28957	347	14527	96	102	0	15072
28958	133	15030	84	93	0	15340
28959	14913	372	81	91	0	15457
28960	332	168	14827	78	0	15405
28961	122	15160	325	105	0	15712
28962	103	303	146	15370	0	15922
28963	64	134	114	15711	0	16023
28964	59	83	15475	409	0	16026
28965	15011	56	345	190	0	15602
28966	346	60	15695	107	0	16208
28967	15399	64	356	94	0	15913
28968	367	50	15809	77	0	16303
28969	129	15642	351	69	0	16191
28970	15691	318	185	89	0	16283
28971	15820	124	105	100	0	16149
28972	15624	84	77	101	0	15886
28973	15764	61	84	82	0	15991
28974	433	76	74	15400	0	15983
28975	192	66	15296	326	0	15880
28976	129	75	318	14997	0	15519
28977	81	15181	151	328	0	15741
28978	96	304	93	15304	0	15797
28979	69	119	15200	352	0	15740
28980	86	72	15078	152	0	15388
28981	82	63	384	14793	0	15322
28982	14562	50	158	311	0	15081
28983	14133	50	109	146	0	14438
28984	14393	50	71	114	0	14628
28985	402	44	14194	73	0	14713
28986	191	38	13921	74	0	14224
28987	100	13556	346	80	0	14082
28988	83	13809	141	60	0	14093
28989	13147	287	176	81	0	13691
28990	13211	118	82	74	0	13485
28991	307	13318	72	75	0	13772
28992	13027	224	62	59	0	13372
28993	13090	90	56	74	0	13310
28994	303	13048	58	74	0	13483
28995	13160	222	62	74	0	13518
28996	13116	101	50	60	0	13327
28997	310	13184	54	65	0	13613
28998	13247	225	58	61	0	13591
28999	13385	90	79	47	0	13601
29000	333	67	13243	47	0	13690
29001	175	47	13133	53	0	13408
29002	104	12736	220	46	0	13106
29003	100	12890	99	32	0	13121
29004	12645	224	174	57	0	13100
29005	12229	76	58	48	0	12411
29006	12050	40	48	20	0	12158
29007	219	12037	39	27	0	12322
29008	100	148	38	11948	0	12234
29009	102	60	12038	131	0	12331
29010	87	141	141	11610	0	11979
29011	80	12048	66	117	0	12311
29012	11695	119	32	52	0	11898
29013	151	11495	33	31	0	11710
29014	86	118	34	11467	0	11705
29015	12010	51	27	132	0	12220
29016	11952	41	27	53	0	12073
29017	171	33	11916	29	0	12149
29018	12104	31	103	52	0	12290
29019	12752	34	38	35	0	12859
29020	12860	32	46	35	0	12973
29021	186	41	41	12472	0	12740
29022	94	12476	36	110	0	12716
29023	89	138	20	12698	0	12945
29024	76	55	12789	130	0	13050
29025	74	12784	129	53	0	13040
29026	64	118	49	12460	0	12691
29027	48	49	12448	112	0	12657
29028	46	12403	121	50	0	12620
29029	78	122	46	12030	0	12276
29030	61	59	12340	109	0	12569
29031	11382	37	118	84	0	11621
29032	156	34	12506	31	0	12727
29033	84	36	12397	34	0	12551
29034	59	12720	139	26	0	12944
29035	68	126	57	12761	0	13012
29036	62	61	43	12499	0	12665
29037	56	12340	41	129	0	12566
29038	65	132	28	12954	0	13179
29039	13131	57	30	136	0	13354
29040	13147	33	42	67	0	13289
29041	182	42	12323	45	0	12592
29042	12939	39	103	47	0	13128
29043	13286	35	52	42	0	13415
29044	185	41	13282	29	0	13537
29045	88	13244	131	38	0	13501
29046	63	13318	69	35	0	13485
29047	82	161	45	12243	0	12531
29048	56	13130	30	108	0	13324
29049	81	163	11835	48	0	12127
29050	85	56	12586	31	0	12758
29051	67	13126	149	28	0	13370
29052	12976	137	67	45	0	13225
29053	13257	76	37	39	0	13409
29054	13391	60	36	38	0	13525
29055	13381	42	26	47	0	13496
29056	12678	51	27	57	0	12813
29057	177	13180	27	31	0	13415
29058	100	134	13107	21	0	13362
29059	79	65	125	12966	0	13235
29060	12847	44	60	142	0	13093
29061	164	12617	35	61	0	12877
29062	94	151	24	12323	0	12592
29063	62	69	12375	113	0	12619
29064	57	11970	121	53	0	12201
29065	48	12256	50	25	0	12379
29066	11728	177	79	81	0	12065
29067	114	11640	30	31	0	11815
29068	73	99	22	11304	0	11498
29069	11350	40	19	103	0	11512
29070	11321	33	13	45	0	11412
29071	11368	26	14	33	0	11441
29072	138	21	11234	20	0	11413
29073	54	11330	90	23	0	11497
29074	11583	108	32	36	0	11759
29075	116	43	21	11567	0	11747
29076	11719	26	17	105	0	11867
29077	112	11671	22	55	0	11860
29078	12307	110	18	45	0	12480
29079	13133	45	18	41	0	13237
29080	192	38	15	12999	0	13244
29081	92	34	13454	154	0	13734
29082	82	29	156	13659	0	13926
29083	13709	24	63	195	0	13991
29084	13778	28	41	85	0	13932
29085	232	13674	34	61	0	14001
29086	13470	170	23	49	0	13712
29087	214	13508	25	40	0	13787
29088	13626	191	14	39	0	13870
29089	13329	65	20	63	0	13477
29090	221	67	13531	28	0	13847
29091	107	13519	161	46	0	13833
29092	90	198	67	13675	0	14030
29093	65	72	41	13878	0	14056
29094	66	59	27	13542	0	13694
29095	50	13659	34	237	0	13980
29096	42	183	13618	100	0	13943
29097	35	73	13788	69	0	13965
29098	39	16073	214	42	0	16368
29099	16115	250	87	58	0	16510
29100	258	112	16114	18	0	16502
29101	15743	68	258	40	0	16109
29102	290	15949	104	30	0	16373
29103	134	251	16070	35	0	16490
29104	117	111	250	15940	0	16418
29105	60	74	16271	253	0	16658
29106	53	45	16609	114	0	16821
29107	89	49	332	15590	0	16060
29108	59	16047	134	220	0	16460
29109	42	16679	83	92	0	16896
29110	16587	323	46	61	0	17017
29111	287	135	16466	30	0	16918
29112	16510	79	268	51	0	16908
29113	16723	57	117	26	0	16923
29114	351	16779	74	20	0	17224
29115	16193	254	36	23	0	16506
29116	16314	93	33	32	0	16472
29117	15748	64	26	35	0	15873
29118	375	15313	24	31	0	15743
29119	170	14263	16	41	0	14490
29120	96	15193	28	20	0	15337
29121	15108	319	107	33	0	15567
29122	15106	130	52	34	0	15322
29123	336	77	14192	18	0	14623
29124	177	59	14247	16	0	14499
29125	14682	41	259	25	0	15007
29126	14939	29	125	39	0	15132
29127	15162	25	73	40	0	15300
29128	341	16	53	14810	0	15220
29129	170	25	33	15062	0	15290
29130	108	37	26	15235	0	15406
29131	79	60	24	15298	0	15461
29132	76	44	14166	309	0	14595
29133	60	37	14483	134	0	14714
29134	82	30	14496	69	0	14677
29135	77	25	14449	42	0	14593
29136	14401	38	305	31	0	14775
29137	266	14520	124	36	0	14946
29138	145	15063	73	30	0	15311
29139	14926	264	42	51	0	15283
29140	272	137	14916	41	0	15366
29141	131	89	14551	45	0	14816
29142	14599	63	291	67	0	15020
29143	15029	44	145	58	0	15276
29144	322	14981	79	38	0	15420
29145	191	211	70	14959	0	15431
29146	15232	93	72	218	0	15615
29147	15522	78	39	94	0	15733
29148	352	64	35	15304	0	15755
29149	195	15753	37	201	0	16186
29150	15848	221	27	132	0	16228
29151	287	101	15570	85	0	16043
29152	15251	72	240	79	0	15642
29153	265	15540	110	84	0	15999
29154	15678	237	78	71	0	16064
29155	15404	105	74	76	0	15659
29156	301	75	15706	46	0	16128
29157	156	56	15372	47	0	15631
29158	15553	54	326	40	0	15973
29159	15936	51	168	40	0	16195
29160	310	16128	94	46	0	16578
29161	186	246	70	16252	0	16754
29162	125	106	16244	204	0	16679
29163	16123	72	258	91	0	16544
29164	290	72	131	16369	0	16862
29165	166	63	86	16617	0	16932
29166	16546	54	67	309	0	16976
29167	260	17009	80	166	0	17515
29168	17228	228	69	97	0	17622
29169	17295	102	61	77	0	17535
29170	17544	79	48	75	0	17746
29171	367	17298	53	58	0	17776
29172	17462	262	51	41	0	17816
29173	341	109	69	17346	0	17865
29174	212	98	46	17344	0	17700
29175	191	74	17321	292	0	17878
29176	141	70	16919	140	0	17270
29177	133	17053	285	78	0	17549
29178	105	17126	140	51	0	17422
29179	100	235	16388	22	0	16745
29180	101	16478	197	28	0	16804
29181	16536	248	114	60	0	16958
29182	16699	89	34	31	0	16853
29183	16856	51	25	48	0	16980
29184	297	34	35	16317	0	16683
29185	152	32	21	16612	0	16817
29186	81	32	16690	254	0	17057
29187	54	16570	170	131	0	16925
29188	16569	190	114	70	0	16943
29189	216	16649	44	41	0	16950
29190	16722	202	36	43	0	17003
29191	16775	70	35	36	0	16916
29192	301	43	26	16334	0	16704
29193	151	38	19	16376	0	16584
29194	100	36	25	16757	0	16918
29195	78	30	16146	283	0	16537
29196	50	15655	181	141	0	16027
29197	35	15559	81	82	0	15757
29198	26	13230	9	26	0	13291
29199	15	13237	15	33	0	13300
29200	19	13370	13	26	0	13428
29201	12682	104	33	34	0	12853
29202	99	40	12848	19	0	13006
29203	24	12862	88	22	0	12996
29204	31	92	12485	15	0	12623
29205	17	12854	86	12	0	12969
29206	93	139	51	9427	0	9710
29207	25	36	11	12325	0	12397
29208	18	12508	14	87	0	12627
29209	12349	97	10	42	0	12498
29210	99	29	12261	18	0	12407
29211	31	12344	80	30	0	12485
29212	32	98	12158	18	0	12306
29213	31	30	85	12083	0	12229
29214	34	20	27	11497	0	11578
29215	18	11969	15	93	0	12095
29216	24	97	14	12118	0	12253
29217	27	29	21	12158	0	12235
29218	20	12057	18	104	0	12199
29219	26	95	11968	26	0	12115
29220	25	31	11840	19	0	11915
29221	11607	18	98	31	0	11754
29222	12191	19	23	23	0	12256
29223	104	21	11	11864	0	12000
29224	40	15	11783	95	0	11933
29225	29	18	95	11483	0	11625
29226	31	11960	22	89	0	12102
29227	26	98	11929	31	0	12084
29228	18	11746	84	27	0	11875
29229	25	109	11752	14	0	11900
29230	18	11766	87	24	0	11895
29231	11727	96	23	25	0	11871
29232	101	28	20	11650	0	11799
29233	31	33	15	11593	0	11672
29234	21	24	11591	97	0	11733
29235	25	23	11162	40	0	11250
29236	47	11489	88	38	0	11662
29237	11548	90	31	35	0	11704
29238	93	33	19	11329	0	11474
29239	37	34	11490	83	0	11644
29240	31	22	11159	19	0	11231
29241	10515	28	108	36	0	10687
29242	10937	16	34	32	0	11019
29243	107	21	11139	23	0	11290
29244	31	50	107	10676	0	10864
29245	16	10862	30	101	0	11009
29246	10992	101	18	45	0	11156
29247	92	10942	17	32	0	11083
29248	10624	89	15	24	0	10752
29249	79	10607	19	17	0	10722
29250	29	10818	16	13	0	10876
29251	38	89	15	10830	0	10972
29252	32	26	12	10886	0	10956
29253	12	10888	15	108	0	11023
29254	16	78	10700	37	0	10831
29255	13	27	10473	29	0	10542
29256	11	24	10586	17	0	10638
29257	10209	25	102	23	0	10359
29258	10616	18	37	20	0	10691
29259	93	11070	22	22	0	11207
29260	31	117	10913	10	0	11071
29261	29	35	110	10900	0	11074
29262	9	31	11445	124	0	11609
29263	15	17	11778	42	0	11852
29264	24	23	150	12588	0	12785
29265	30	21	58	13261	0	13370
29266	13	22	13952	246	0	14233
29267	13449	18	180	136	0	13783
29268	201	14243	95	85	0	14624
29269	91	15023	78	32	0	15224
29270	89	304	37	14663	0	15093
29271	15211	158	30	220	0	15619
29272	260	15546	17	116	0	15939
29273	15694	275	23	107	0	16099
29274	307	15848	18	56	0	16229
29275	16430	343	6	58	0	16837
29276	384	151	16360	33	0	16928
29277	163	120	16615	35	0	16933
29278	171	129	370	16114	0	16784
29279	53	74	16336	278	0	16741
29280	64	15358	352	124	0	15898
29281	48	15381	163	135	0	15727
29282	15586	390	131	57	0	16164
29283	308	198	58	15078	0	15642
29284	142	15723	58	267	0	16190
29285	15904	328	41	129	0	16402
29286	15736	159	56	94	0	16045
29287	16120	122	52	48	0	16342
29288	503	61	39	15734	0	16337
29289	275	47	45	16022	0	16389
29290	164	55	15876	403	0	16498
29291	98	69	15803	209	0	16179
29292	15625	37	385	144	0	16191
29293	361	46	201	15639	0	16247
29294	174	51	15673	331	0	16229
29295	15459	38	331	178	0	16006
29296	355	16084	170	155	0	16764
29297	16284	305	135	86	0	16810
29298	16554	135	71	98	0	16858
29299	16578	118	59	91	0	16846
29300	543	53	16011	66	0	16673
29301	16101	50	362	53	0	16566
29302	518	38	148	15555	0	16259
29303	235	15193	134	325	0	15887
29304	211	16193	86	150	0	16640
29305	16062	388	65	124	0	16639
29306	16255	200	52	72	0	16579
29307	16373	130	55	77	0	16635
29308	600	68	38	15786	0	16492
29309	332	84	58	16032	0	16506
29310	248	55	58	15693	0	16054
29311	161	15819	53	492	0	16525
29312	15796	328	46	258	0	16428
29313	16073	166	34	183	0	16456
29314	16383	149	36	113	0	16681
29315	598	89	16052	93	0	16832
29316	16450	88	317	72	0	16927
29317	582	66	137	15697	0	16482
29318	289	16042	111	348	0	16790
29319	16128	363	61	199	0	16751
29320	16191	158	65	163	0	16577
29321	570	150	16088	84	0	16892
29322	369	92	349	15815	0	16625
29323	255	16265	149	354	0	17023
29324	16745	361	126	171	0	17403
29325	503	163	85	16719	0	17470
29326	286	130	88	16872	0	17376
29327	241	76	47	17185	0	17549
29328	156	104	58	17683	0	18001
29329	186	85	17110	626	0	18007
29330	153	17179	382	321	0	18035
29331	191	396	177	17270	0	18034
29332	147	167	17408	489	0	18211
29333	17220	163	402	266	0	18051
29334	17764	97	190	207	0	18258
29335	597	90	142	17578	0	18407
29336	17752	82	93	505	0	18432
29337	18042	84	83	281	0	18490
29338	628	80	17614	225	0	18547
29339	366	17606	428	147	0	18547
29340	17859	405	186	144	0	18594
29341	549	176	156	17718	0	18599
29342	18039	147	113	472	0	18771
29343	613	82	96	17836	0	18627
29344	328	90	80	18187	0	18685
29345	273	88	17528	584	0	18473
29346	16865	74	394	368	0	17701
29347	533	17681	177	239	0	18630
29348	294	406	17552	179	0	18431
29349	247	17478	409	148	0	18282
29350	17309	478	194	153	0	18134
29351	553	208	139	17196	0	18096
29352	17165	155	86	483	0	17889
29353	582	16955	82	262	0	17881
29354	17306	429	76	231	0	18042
29355	17600	171	96	140	0	18007
29356	17563	151	82	145	0	17941
29357	17426	92	77	136	0	17731
29358	681	16980	82	148	0	17891
29359	16800	372	74	111	0	17357
29360	598	192	67	16447	0	17304
29361	380	173	50	16196	0	16799
29362	307	15033	47	486	0	15873
29363	240	14895	54	273	0	15462
29364	193	14533	53	159	0	14938
29365	13591	375	70	112	0	14148
29366	369	12649	35	95	0	13148
29367	158	11982	46	69	0	12255
29368	11673	288	165	73	0	12199
29369	11349	77	41	64	0	11531
29370	277	11269	28	91	0	11665
29371	10905	209	24	65	0	11203
29372	274	61	10471	44	0	10850
29373	10149	64	172	51	0	10436
29374	266	63	10168	40	0	10537
29375	99	9219	144	42	0	9504
29376	76	9376	38	42	0	9532
29377	239	236	107	8881	0	9463
29378	9095	40	39	149	0	9323
29379	9209	37	18	59	0	9323
29380	9354	30	18	62	0	9464
29381	9362	22	24	48	0	9456
29382	9197	39	11	46	0	9293
29383	166	42	8904	28	0	9140
29384	115	46	8449	27	0	8637
29385	8816	44	102	42	0	9004
29386	477	8711	33	34	0	9255
29387	8926	112	27	38	0	9103
29388	9195	42	15	37	0	9289
29389	9461	34	11	51	0	9557
29390	9494	16	20	34	0	9564
29391	9490	36	19	46	0	9591
29392	168	25	9366	33	0	9592
29393	9566	38	107	46	0	9757
29394	9755	25	34	29	0	9843
29395	140	55	8992	43	0	9230
29396	8981	28	61	59	0	9129
29397	9576	32	35	40	0	9683
29398	174	35	9834	38	0	10081
29399	97	33	9774	28	0	9932
29400	99	10036	110	25	0	10270
29401	99	120	58	10033	0	10310
29402	91	43	10142	104	0	10380
29403	10363	39	110	48	0	10560
29404	175	33	45	10876	0	11129
29405	88	33	11187	119	0	11427
29406	11132	32	110	66	0	11340
29407	11502	40	40	38	0	11620
29408	11516	32	35	42	0	11625
29409	196	11755	23	40	0	12014
29410	120	131	26	11555	0	11832
29411	89	11751	28	130	0	11998
29412	11890	154	24	52	0	12120
29413	11825	48	39	40	0	11952
29414	181	55	11629	22	0	11887
29415	92	11120	107	21	0	11340
29416	67	11272	37	23	0	11399
29417	72	123	30	11218	0	11443
29418	71	64	9	11339	0	11483
29419	11269	34	14	123	0	11440
29420	155	11089	18	49	0	11311
29421	80	11102	12	41	0	11235
29422	95	121	11047	18	0	11281
29423	63	11338	92	17	0	11510
29424	11157	118	70	34	0	11379
29425	146	43	11087	26	0	11302
29426	10162	35	93	37	0	10327
29427	125	24	10636	14	0	10799
29428	9522	16	77	25	0	9640
29429	94	10429	22	15	0	10560
29430	10568	86	26	14	0	10694
29431	105	30	10917	5	0	11057
29432	10904	27	94	23	0	11048
29433	11088	16	22	27	0	11153
29434	113	16	11522	6	0	11657
29435	11524	9	85	20	0	11638
29436	11926	6	24	16	0	11972
29437	11790	14	20	13	0	11837
29438	124	11629	12	10	0	11775
29439	11917	87	18	19	0	12041
29440	123	31	12183	4	0	12341
29441	44	12960	91	13	0	13108
29442	13328	108	40	24	0	13500
29443	13315	20	21	16	0	13372
29444	13460	14	14	16	0	13504
29445	159	13387	10	13	0	13569
29446	67	113	12	14491	0	14683
29447	109	40	14504	160	0	14813
29448	42	21	164	14518	0	14745
29449	41	20	14894	182	0	15137
29450	14332	15	178	60	0	14585
29451	198	15037	63	19	0	15317
29452	82	179	23	14961	0	15245
29453	47	15313	13	164	0	15537
29454	60	197	12	15380	0	15649
29455	40	69	10	15498	0	15617
29456	29	15766	15	236	0	16046
29457	48	213	17	15991	0	16269
29458	45	65	17	16544	0	16671
29459	28	16495	14	253	0	16790
29460	24	16990	14	84	0	17112
29461	40	266	18	16899	0	17223
29462	40	84	16806	252	0	17182
29463	22	17069	233	75	0	17399
29464	42	255	69	17128	0	17494
29465	39	80	17653	259	0	18031
29466	22	17783	245	99	0	18149
29467	17702	278	62	80	0	18122
29468	272	87	17686	41	0	18086
29469	17564	54	269	61	0	17948
29470	297	50	68	17645	0	18060
29471	107	47	38	17791	0	17983
29472	69	32	38	17877	0	18016
29473	41	44	17590	343	0	18018
29474	113	49	17236	121	0	17519
29475	17044	43	313	86	0	17486
29476	288	45	96	17572	0	18001
29477	93	49	17711	277	0	18130
29478	17464	51	273	120	0	17908
29479	311	32	82	17726	0	18151
29480	100	41	61	17805	0	18007
29481	85	62	45	17733	0	17925
29482	61	17720	40	355	0	18176
29483	72	262	45	17351	0	17730
29484	51	17250	39	296	0	17636
29485	51	17889	39	113	0	18092
29486	17686	316	44	115	0	18161
29487	16608	116	54	115	0	16893
29488	17649	71	38	86	0	17844
29489	334	17253	44	92	0	17723
29490	17221	271	46	90	0	17628
29491	17390	99	43	78	0	17610
29492	356	70	38	17028	0	17492
29493	132	58	37	17179	0	17406
29494	73	52	16782	363	0	17270
29495	62	16980	270	154	0	17466
29496	16736	269	78	115	0	17198
29497	16801	94	55	118	0	17068
29498	294	16568	48	81	0	16991
29499	16434	287	45	82	0	16848
29500	16499	106	32	84	0	16721
29501	327	87	40	16247	0	16701
29502	132	15870	52	285	0	16339
29503	116	16270	36	125	0	16547
29504	15984	297	37	112	0	16430
29505	289	111	39	15715	0	16154
29506	112	85	15529	284	0	16010
29507	15102	72	244	151	0	15569
29508	285	62	15866	121	0	16334
29509	111	15597	244	98	0	16050
29510	15513	267	110	87	0	15977
29511	291	95	15487	215	0	16088
29512	119	90	256	15818	0	16283
29513	86	94	16427	295	0	16902
29514	90	16575	244	139	0	17048
29515	87	268	95	16640	0	17090
29516	68	129	16552	283	0	17032
29517	15693	76	249	158	0	16176
29518	263	16909	99	115	0	17386
29519	127	264	57	16490	0	16938
29520	80	17070	55	270	0	17475
29521	16883	270	54	133	0	17340
29522	16819	114	48	120	0	17101
29523	295	16799	63	104	0	17261
29524	132	263	57	16540	0	16992
29525	103	16894	51	267	0	17315
29526	16896	270	54	132	0	17352
29527	16827	121	69	100	0	17117
29528	323	84	16725	74	0	17206
29529	139	16600	212	96	0	17047
29530	103	17173	88	96	0	17460
29531	102	280	51	16778	0	17211
29532	16616	110	57	258	0	17041
29533	16609	78	59	136	0	16882
29534	16118	65	44	105	0	16332
29535	298	16366	55	98	0	16817
29536	142	230	54	16144	0	16570
29537	102	16324	54	237	0	16717
29538	16320	240	55	107	0	16722
29539	282	99	42	16102	0	16525
29540	130	58	15485	227	0	15900
29541	94	15136	193	111	0	15534
29542	14807	194	71	71	0	15143
29543	213	86	14766	70	0	15135
29544	14399	51	188	80	0	14718
29545	211	14617	58	68	0	14954
29546	79	13740	21	40	0	13880
29547	13500	137	27	38	0	13702
29548	132	13725	20	45	0	13922
29549	13486	114	31	39	0	13670
29550	125	13578	33	18	0	13754
29551	13672	128	24	37	0	13861
29552	13673	48	26	33	0	13780
29553	149	40	13868	18	0	14075
29554	65	30	13458	23	0	13576
29555	48	13751	101	36	0	13936
29556	13551	97	80	27	0	13755
29557	99	38	13320	25	0	13482
29558	12751	40	70	18	0	12879
29559	83	57	28	12760	0	12928
29560	29	23	13048	56	0	13156
29561	23	14	12332	24	0	12393
29562	23	26	13082	6	0	13137
29563	20	13225	60	15	0	13320
29564	93	185	95	12859	0	13232
29565	12681	11	11	35	0	12738
29566	33	4	1	12870	0	12908
29567	12981	3	3	56	0	13043
29568	44	4	4	13045	0	13097
29569	13254	4	4	64	0	13326
29570	13041	11	7	54	0	13113
29571	14465	4	3	19	0	14491
29572	78	14680	5	9	0	14772
29573	22	75	14790	2	0	14889
29574	20	22	77	14798	0	14917
29575	276	81	171	7634	0	8162
29576	15	11	4	15161	0	15191
29577	23	4	2	14945	0	14974
29578	5	14563	10	110	0	14688
29579	13	78	14465	42	0	14598
29580	8	14694	79	33	0	14814
29581	19	95	25	13859	0	13998
29582	8	37	9	14837	0	14891
29583	16	11	1	14867	0	14895
29584	17	6	7	14803	0	14833
29585	7	14443	10	110	0	14570
29586	7	14555	10	35	0	14607
29587	6	102	14374	30	0	14512
29588	13	35	87	14436	0	14571
29589	16	14	31	14581	0	14642
29590	15	12	6	14898	0	14931
29591	14965	12	5	138	0	15120
29592	100	14927	16	48	0	15091
29593	41	104	14860	14	0	15019
29594	14778	35	99	33	0	14945
29595	113	12	27	14963	0	15115
29596	15185	13	9	137	0	15344
29597	118	16	7	15290	0	15431
29598	15373	15	6	126	0	15520
29599	113	20	12	15363	0	15508
29600	15270	12	18	127	0	15427
29601	119	19	15510	50	0	15698
29602	66	13	95	15466	0	15640
29603	24	15894	36	116	0	16070
29604	39	117	11	16227	0	16394
29605	16142	46	9	142	0	16339
29606	125	15986	19	54	0	16184
29607	55	129	15	16761	0	16960
29608	25	16584	13	144	0	16766
29609	36	161	7	16785	0	16989
29610	31	60	8	16870	0	16969
29611	28	30	16557	196	0	16811
29612	35	26	135	16138	0	16334
29613	17	22	15685	168	0	15892
29614	14	15411	161	83	0	15669
29615	15453	144	58	55	0	15710
29616	153	56	15494	43	0	15746
29617	15050	23	164	55	0	15292
29618	15642	20	57	46	0	15765
29619	202	18	35	15885	0	16140
29620	67	23	16438	175	0	16703
29621	16178	15	170	102	0	16465
29622	17266	18	73	66	0	17423
29623	263	17	36	16917	0	17233
29624	122	15	29	16986	0	17152
29625	47	16936	23	276	0	17282
29626	45	209	17	16825	0	17096
29627	38	17004	22	217	0	17281
29628	34	212	16833	104	0	17183
29629	38	117	177	16504	0	16836
29630	16289	44	80	237	0	16650
29631	16513	30	28	124	0	16695
29632	232	16522	31	70	0	16855
29633	111	181	17	17033	0	17342
29634	17143	75	22	245	0	17485
29635	221	16810	26	108	0	17165
29636	16983	221	10	90	0	17304
29637	261	89	16	17847	0	18213
29638	18802	44	21	296	0	19163
29639	307	59	20179	111	0	20656
29640	113	20252	311	85	0	20761
29641	20242	323	108	88	0	20761
29642	338	20961	54	72	0	21425
29643	21298	363	34	87	0	21782
29644	21834	119	29	68	0	22050
29645	484	73	21771	43	0	22371
29646	226	56	349	21718	0	22349
29647	22178	42	112	416	0	22748
29648	422	45	22064	143	0	22674
29649	22032	39	380	106	0	22557
29650	464	45	114	22046	0	22669
29651	171	48	21826	408	0	22453
29652	138	37	375	21731	0	22281
29653	21328	38	133	440	0	21939
29654	408	51	21422	159	0	22040
29655	212	45	355	21386	0	21998
29656	148	43	132	21656	0	21979
29657	21582	42	80	504	0	22208
29658	21567	31	62	216	0	21876
29659	505	21551	61	135	0	22252
29660	237	385	63	21264	0	21949
29661	172	133	55	21442	0	21802
29662	153	80	57	21258	0	21548
29663	20764	64	53	534	0	21415
29664	21038	54	67	228	0	21387
29665	557	77	65	20499	0	21198
29666	265	20188	70	437	0	20960
29667	207	410	54	19703	0	20374
29668	172	20259	74	424	0	20929
29669	19968	402	69	232	0	20671
29670	477	19642	84	151	0	20354
29671	18727	353	70	147	0	19297
29672	496	138	90	18377	0	19101
29673	18274	86	85	416	0	18861
29674	487	52	17885	202	0	18626
29675	219	18130	357	190	0	18896
29676	18059	345	196	164	0	18764
29677	18338	134	94	180	0	18746
29678	546	87	75	17704	0	18412
29679	251	17786	96	437	0	18570
29680	213	342	61	18337	0	18953
29681	180	124	66	18557	0	18927
29682	184	83	78	18671	0	19016
29683	18380	72	55	588	0	19095
29684	18717	82	62	274	0	19135
29685	555	85	54	18081	0	18775
29686	282	18252	35	461	0	19030
29687	18516	363	43	276	0	19198
29688	498	151	18269	201	0	19119
29689	268	123	319	18504	0	19214
29690	221	96	18324	470	0	19111
29691	204	101	351	18282	0	18938
29692	189	90	18176	510	0	18965
29693	192	115	364	18225	0	18896
29694	18217	109	131	479	0	18936
29695	18224	131	84	265	0	18704
29696	560	17739	66	216	0	18581
29697	18012	398	65	195	0	18670
29698	552	184	57	17735	0	18528
29699	300	130	76	18110	0	18616
29700	18072	111	68	553	0	18804
29701	517	116	17499	273	0	18405
29702	311	97	17461	228	0	18097
29703	240	118	16894	217	0	17469
29704	16982	100	388	206	0	17676
29705	501	99	17208	202	0	18010
29706	355	105	16554	221	0	17235
29707	16020	89	429	217	0	16755
29708	433	16183	181	254	0	17051
29709	281	313	127	16309	0	17030
29710	236	139	115	16757	0	17247
29711	205	105	16565	485	0	17360
29712	16522	67	347	312	0	17248
29713	16676	81	182	232	0	17171
29714	15554	82	131	237	0	16004
29715	484	84	16593	198	0	17359
29716	16334	70	349	248	0	17001
29717	473	78	15748	208	0	16507
29718	258	15799	308	250	0	16615
29719	235	15951	149	207	0	16542
29720	15080	322	127	211	0	15740
29721	402	14769	107	181	0	15459
29722	229	14832	100	169	0	15330
29723	14642	323	112	160	0	15237
29724	388	14695	109	160	0	15352
29725	14718	316	98	160	0	15292
29726	414	118	109	14978	0	15619
29727	226	100	113	15277	0	15716
29728	186	86	128	15391	0	15791
29729	201	84	114	15068	0	15467
29730	165	14991	126	431	0	15713
29731	15330	311	105	187	0	15933
29732	406	16082	130	143	0	16761
29733	309	16229	112	226	0	16876
29734	253	386	16620	149	0	17408
29735	16426	157	409	158	0	17150
29736	519	108	17133	124	0	17884
29737	286	52	16957	104	0	17399
29738	142	16055	406	110	0	16713
29739	60	15395	110	52	0	15617
29740	15341	353	169	78	0	15941
29741	316	16066	69	76	0	16527
29742	147	331	15714	36	0	16228
29743	95	15308	294	53	0	15750
29744	65	308	15296	30	0	15699
29745	44	118	14819	23	0	15004
29746	14279	81	380	41	0	14781
29747	548	41	14282	25	0	14896
29748	140	43	317	14000	0	14500
29749	13881	21	147	274	0	14323
29750	283	13843	81	116	0	14323
29751	118	250	13965	66	0	14399
29752	13891	97	286	43	0	14317
29753	319	61	109	13410	0	13899
29754	120	13152	75	257	0	13604
29755	76	237	13630	90	0	14033
29756	13496	85	296	62	0	13939
29757	284	59	13653	32	0	14028
29758	127	23	309	13571	0	14030
29759	79	35	13399	276	0	13789
29760	59	21	333	13405	0	13818
29761	13223	14	127	341	0	13705
29762	262	13493	83	135	0	13973
29763	13639	271	42	95	0	14047
29764	333	91	13584	42	0	14050
29765	143	62	286	13732	0	14223
29766	80	37	13885	275	0	14277
29767	13732	28	322	118	0	14200
29768	13942	26	126	75	0	14169
29769	364	13911	92	68	0	14435
29770	14029	277	57	42	0	14405
29771	14201	99	59	32	0	14391
29772	425	64	43	13862	0	14394
29773	185	47	13793	278	0	14303
29774	113	13469	283	135	0	14000
29775	81	285	100	13493	0	13959
29776	13552	102	69	319	0	14042
29777	314	80	13424	117	0	13935
29778	128	56	13429	74	0	13687
29779	100	43	13213	48	0	13404
29780	12981	37	405	46	0	13469
29781	326	41	13119	24	0	13510
29782	12861	39	384	37	0	13321
29783	346	35	11973	32	0	12386
29784	136	12687	316	21	0	13160
29785	121	271	135	12486	0	13013
29786	80	112	12583	261	0	13036
29787	63	12141	304	110	0	12618
29788	54	12494	150	66	0	12764
29789	58	362	87	12269	0	12776
29790	12186	143	85	282	0	12696
29791	294	99	72	12270	0	12735
29792	12137	59	66	331	0	12593
29793	340	67	57	12118	0	12582
29794	147	55	12025	336	0	12563
29795	113	44	12133	136	0	12426
29796	11840	35	377	118	0	12370
29797	12021	41	180	81	0	12323
29798	386	34	11809	65	0	12294
29799	11623	44	317	65	0	12049
29800	374	49	11642	42	0	12107
29801	184	11076	357	41	0	11658
29802	143	11168	169	28	0	11508
29803	98	11230	138	48	0	11514
29804	91	374	102	10924	0	11491
29805	10832	162	103	271	0	11368
29806	11021	126	75	118	0	11340
29807	397	74	86	10776	0	11333
29808	216	73	10432	297	0	11018
29809	132	69	305	10449	0	10955
29810	113	50	10413	335	0	10911
29811	100	39	348	10268	0	10755
29812	10126	37	181	347	0	10691
29813	10291	48	145	154	0	10638
29814	10329	31	98	122	0	10580
29815	10365	37	92	86	0	10580
29816	455	27	81	9946	0	10509
29817	273	27	79	10150	0	10529
29818	10007	39	75	383	0	10504
29819	10206	39	72	175	0	10492
29820	433	39	63	9928	0	10463
29821	235	33	60	10083	0	10411
29822	157	38	64	9958	0	10217
29823	126	34	60	10020	0	10240
29824	9650	35	62	443	0	10190
29825	312	39	9431	221	0	10003
29826	170	27	275	9119	0	9591
29827	8947	35	148	319	0	9449
29828	313	36	8773	181	0	9303
29829	196	34	299	8773	0	9302
29830	135	38	8725	305	0	9203
29831	127	8145	296	157	0	8725
29832	131	186	163	6927	0	7407
29833	6419	79	107	192	0	6797
29834	171	145	73	5659	0	6048
29835	117	5406	65	190	0	5778
29836	101	4952	47	94	0	5194
29837	62	3941	33	69	0	4105
29838	69	3653	44	40	0	3806
29839	2187	241	235	184	0	2847
29840	109	74	69	1577	0	1829
29841	15	4	1284	35	0	1338
29842	12	8	22	1188	0	1230
29843	14	4	1171	32	0	1221
29844	1176	2	22	10	0	1210
29845	32	5	10	1166	0	1213
29846	14	5	7	1180	0	1206
29847	9	4	9	1181	0	1203
29848	13	3	4	1181	0	1201
29849	1149	5	7	31	0	1192
29850	1158	4	4	20	0	1186
29851	32	2	6	1135	0	1175
29852	1090	3	4	36	0	1133
29853	27	1	1077	23	0	1128
29854	12	1057	20	16	0	1105
29855	5	18	12	1057	0	1092
29856	12	8	9	1033	0	1062
29857	10	1018	9	26	0	1063
29858	16	17	4	992	0	1029
29859	12	24	7	967	0	1010
29860	967	2	9	25	0	1003
29861	19	6	884	13	0	922
29862	4	4	784	8	0	800
29863	743	5	16	9	0	773
29864	16	2	683	8	0	709
29865	391	2	20	3	0	416
29866	304	0	15	4	0	323
29867	17	5	3	236	0	261
29868	4	0	171	8	0	183
29869	145	0	6	2	0	153
29870	4	142	2	3	0	151
29871	96	4	22	3	0	125
29872	93	2	11	4	0	110
29873	105	0	2	2	0	109
29874	140	0	0	0	0	140
29875	136	0	0	0	0	136
29876	142	0	0	0	0	142
29877	139	0	0	0	0	139
29878	145	0	0	0	0	145
29879	142	0	0	0	0	142
29880	145	0	0	0	0	145
29881	135	0	0	0	0	135
29882	134	0	0	0	0	134
29883	135	0	0	0	0	135
29884	132	0	0	0	0	132
29885	132	1	0	0	0	133
29886	143	1	0	0	0	144
29887	140	1	0	0	0	141
29888	132	0	0	0	0	132
29889	124	0	0	1	0	125
29890	130	0	1	0	0	131
29891	128	0	0	1	0	129
29892	135	0	1	0	0	136
29893	133	0	0	0	0	133
29894	136	0	0	1	0	137
29895	143	0	0	1	0	144
29896	133	0	0	1	0	134
29897	129	0	0	1	0	130
29898	128	0	0	0	0	128
29899	141	0	0	0	0	141
29900	131	0	1	1	0	133
29901	126	0	0	0	0	126
29902	119	0	3	0	0	122
29903	78	0	13	0	0	91
29904	0	0	0	1	0	1
29905	0	0	0	1	0	1
29906	0	1	0	0	0	1
29907	0	0	0	1	0	1
29908	0	0	0	1	0	1
29909	1	0	0	0	0	1
29910	0	0	1	0	0	1
29911	0	0	1	0	0	1
29912	1	0	0	0	0	1
29913	0	0	1	0	0	1
29914	1	0	0	0	0	1
29915	1	0	0	0	0	1
29916	0	0	0	1	0	1
29917	0	0	1	0	0	1
29918	1	0	0	0	0	1
29919	0	1	0	0	0	1
29920	1	0	0	0	0	1
29921	1	0	0	0	0	1
29922	1	0	0	0	0	1
29923	1	0	0	0	0	1
29924	1	0	0	0	0	1
29925	1	0	0	0	0	1
29926	1	0	0	0	0	1
29927	1	0	0	0	0	1
29928	1	0	0	0	0	1
29929	1	0	0	0	0	1
29930	1	0	0	0	0	1
29931	1	0	0	0	0	1
