Pos	A	C	G	T	Other	Total
1	12	0	0	0	0	12
2	0	0	0	35	0	35
3	0	0	0	50	0	50
4	123	0	0	4	0	127
5	254	0	0	0	0	254
6	272	0	0	0	0	272
7	1	0	301	0	0	302
8	0	0	324	0	0	324
9	0	0	1	332	0	333
10	4	0	0	357	0	361
11	1	0	0	391	0	392
12	779	0	0	18	0	797
13	3	14	0	1631	0	1648
14	2704	1	1	35	0	2741
15	4	4046	2	3	0	4055
16	4	7622	5	22	0	7653
17	52	18	3	20101	0	20174
18	32	8	2	22624	0	22666
19	2	32017	19	73	0	32111
20	4	35277	24	61	0	35366
21	3	40607	24	116	0	40750
22	42503	42	74	181	0	42800
23	69	74	43744	28	0	43915
24	55	56	44173	20	0	44304
25	15	17	45	46532	0	46609
26	49297	4	23	151	0	49475
27	49674	6	9	88	0	49777
28	76	50329	45	99	0	50549
29	57058	57	9	219	0	57343
30	60389	37	30	190	0	60646
31	61895	14	16	106	0	62031
32	90	63278	43	71	0	63482
33	38	64930	46	103	0	65117
34	66606	89	7	141	0	66843
35	66912	55	13	104	0	67084
36	80	69320	49	149	0	69598
37	37	73592	41	129	0	73799
38	73342	91	14	80	0	73527
39	73379	59	8	78	0	73524
40	104	74950	39	130	0	75223
41	80	85	3	77285	0	77453
42	89	48	10	78100	0	78247
43	59	27	14	78619	0	78719
44	35	79048	37	210	0	79330
45	85	145	77567	98	0	77895
46	71621	95	88	106	0	71910
47	109	31	39	79572	0	79751
48	76	81119	50	136	0	81381
49	46	110	10	81355	0	81521
50	25	82433	91	154	0	82703
51	60	111	16	82842	0	83029
52	52	79	9	83856	0	83996
53	68	159	84393	211	0	84831
54	41	33	98	83540	0	83712
55	83668	22	77	222	0	83989
56	168	99	84728	155	0	85150
57	81501	41	137	119	0	81798
58	162	45	88	85235	0	85530
59	97	86895	92	211	0	87295
60	69	162	22	87592	0	87845
61	84	189	87861	210	0	88344
62	68	49	139	86462	0	86718
63	63	41	102	88256	0	88462
64	28	90335	81	330	0	90774
65	133	192	35	89777	0	90137
66	139	90724	84	271	0	91218
67	85	209	37	91027	0	91358
68	90717	140	32	259	0	91148
69	89394	78	58	189	0	89719
70	90549	57	50	168	0	90824
71	449	92950	59	204	0	93662
72	294	312	92513	98	0	93217
73	90038	175	264	141	0	90618
74	96681	60	197	129	0	97067
75	504	102176	83	165	0	102928
76	292	457	28	85438	0	86215
77	128	334	62	88599	0	89123
78	96	101	43	88768	0	89008
79	89503	53	60	983	0	90599
80	89919	78	59	609	0	90665
81	90219	62	49	175	0	90505
82	91179	83	54	158	0	91474
83	1103	59	45	88988	0	90195
84	592	90232	102	653	0	91579
85	217	525	44	93407	0	94193
86	243	657	93746	709	0	95355
87	192	127	575	97583	0	98477
88	214	157	100326	864	0	101561
89	153	77	811	99550	0	100591
90	196	148	103625	992	0	104961
91	182	167	104649	733	0	105731
92	129	107360	1515	528	0	109532
93	226	988	749	110195	0	112158
94	288	779	114657	1017	0	116741
95	168	211	1008	108417	0	109804
96	112	115600	847	1113	0	117672
97	113419	1011	199	871	0	115500
98	914	119383	208	373	0	120878
99	806	1121	159	112583	0	114669
100	198	119160	238	1042	0	120638
101	243	1182	116436	839	0	118700
102	350	911	118264	369	0	119894
103	150	118628	1777	620	0	121175
104	251	1072	898	117429	0	119650
105	538	920	119162	1162	0	121782
106	181	119291	1193	1135	0	121800
107	118503	1078	846	359	0	120786
108	1104	881	257	118324	0	120566
109	939	369	122066	1238	0	124612
110	269	122476	1171	1072	0	124988
111	258	1155	909	120813	0	123135
112	259	914	306	123228	0	124707
113	116181	297	304	1936	0	118718
114	1189	327	121983	1079	0	124578
115	872	247	1177	119883	0	122179
116	360	329	120012	1354	0	122055
117	203	112296	1324	1234	0	115057
118	106436	1203	943	476	0	109058
119	1040	107211	425	461	0	109137
120	947	1313	284	97290	0	99834
121	255	102818	353	1161	0	104587
122	98259	1321	290	940	0	100810
123	1136	101187	333	533	0	103189
124	991	1389	98401	447	0	101228
125	313	100252	1252	412	0	102229
126	97173	1338	1012	391	0	99914
127	1303	1072	100019	406	0	102800
128	1009	420	1302	99171	0	101902
129	97489	384	1020	1346	0	100239
130	1365	369	362	95642	0	97738
131	96103	361	301	1563	0	98328
132	96394	349	312	1183	0	98238
133	2107	367	296	94846	0	97616
134	1249	319	328	95385	0	97281
135	93694	360	280	2257	0	96591
136	93448	334	313	1347	0	95442
137	2274	308	312	91525	0	94419
138	92529	338	294	1592	0	94753
139	92311	319	365	1231	0	94226
140	2187	92942	401	711	0	96241
141	1356	1354	334	92907	0	95951
142	94454	1064	376	1655	0	97549
143	95678	438	342	1332	0	97790
144	2251	380	347	95062	0	98040
145	1309	368	395	96311	0	98383
146	93894	351	390	2378	0	97013
147	1448	95932	434	1564	0	99378
148	1288	1355	366	95111	0	98120
149	667	1152	96035	1585	0	99439
150	558	560	1375	91992	0	94485
151	494	94764	1123	1644	0	98025
152	542	1394	95664	1291	0	98891
153	462	1127	1394	92976	0	95959
154	581	478	1085	94291	0	96435
155	515	444	96115	2353	0	99427
156	87869	381	1445	1518	0	91213
157	1389	98285	1240	846	0	101760
158	97820	1359	580	647	0	100406
159	1643	1177	97559	696	0	101075
160	1241	582	99552	605	0	101980
161	92709	439	2127	586	0	95861
162	1446	99883	1247	690	0	103266
163	98224	1386	454	664	0	100728
164	1547	100856	481	650	0	103534
165	1273	1606	100753	568	0	104200
166	98282	1110	1298	627	0	101317
167	1598	629	103213	562	0	106002
168	1265	420	1376	100573	0	103634
169	101326	369	1129	1527	0	104351
170	100332	386	483	1251	0	102452
171	2021	101953	556	702	0	105232
172	1227	2898	462	95995	0	100582
173	614	99605	444	1314	0	101977
174	603	1285	97470	1017	0	100375
175	608	1638	1108	87193	0	90547
176	454	89847	826	1057	0	92184
177	534	1006	370	84904	0	86814
178	74730	573	352	1154	0	76809
179	920	258	220	82876	0	84274
180	658	84112	275	912	0	85957
181	471	740	193	84702	0	86106
182	414	581	234	83718	0	84947
183	378	85273	251	1185	0	87087
184	434	846	230	85245	0	86755
185	482	545	84206	906	0	86139
186	353	84150	715	707	0	85925
187	76086	542	541	321	0	77490
188	684	442	79454	276	0	80856
189	532	226	78552	276	0	79586
190	283	77694	699	323	0	78999
191	864	1170	935	72467	0	75436
192	289	294	72322	403	0	73308
193	215	68713	330	385	0	69643
194	269	285	236	67956	0	68746
195	228	265	123	69048	0	69664
196	68036	120	99	484	0	68739
197	293	70164	147	509	0	71113
198	373	346	67546	200	0	68465
199	211	303	69994	210	0	70718
200	155	163	403	68465	0	69186
201	165	126	258	79519	0	80068
202	150	131	118	79898	0	80297
203	130	92891	197	1132	0	94350
204	237	892	95823	598	0	97550
205	184	789	887	93416	0	95276
206	144	103939	784	993	0	105860
207	135	106170	296	841	0	107442
208	283	1798	109183	311	0	111575
209	154	964	1224	106910	0	109252
210	215	328	118713	1328	0	120584
211	180	177	1482	114608	0	116447
212	214	252	1163	118363	0	119992
213	359	251	119014	2345	0	121969
214	119	118764	1544	1441	0	121868
215	114956	1358	1236	411	0	117961
216	1498	1183	120996	263	0	123940
217	1055	120666	1524	428	0	123673
218	248	122529	1272	373	0	124422
219	319	2513	118708	237	0	121777
220	112862	1358	1530	277	0	116027
221	1536	581	1236	106078	0	109431
222	1090	120043	541	1255	0	122929
223	118765	1501	279	1069	0	121614
224	1469	1276	286	112256	0	115287
225	1112	118486	383	1489	0	121470
226	118129	1515	304	1257	0	121205
227	1486	1259	116977	486	0	120208
228	1079	117438	1587	383	0	120487
229	114162	1452	1207	340	0	117161
230	1246	116895	472	342	0	118955
231	114543	1637	294	247	0	116721
232	1472	1344	343	109944	0	113103
233	1086	113549	430	1310	0	116375
234	368	1482	349	113955	0	116154
235	111893	1177	424	1599	0	115093
236	1423	517	111467	1324	0	114731
237	1288	447	112865	539	0	115139
238	417	376	2428	107468	0	110689
239	403	446	1382	110790	0	113021
240	379	396	497	107676	0	108948
241	285	107962	490	2445	0	111182
242	378	1685	105991	1286	0	109340
243	362	1356	1553	99306	0	102577
244	356	104424	1353	1342	0	107475
245	389	105669	491	1308	0	107857
246	449	2399	103979	504	0	107331
247	466	1545	105403	360	0	107774
248	466	636	107403	364	0	108869
249	388	527	2523	101056	0	104494
250	446	534	106120	1464	0	108564
251	424	415	1742	102174	0	104755
252	427	485	104962	1619	0	107493
253	93072	445	1785	1375	0	96677
254	1484	105138	1442	595	0	108659
255	1264	109538	545	611	0	111958
256	585	2630	110485	542	0	114242
257	105792	1566	1684	571	0	109613
258	110377	624	1438	543	0	112982
259	110250	533	625	545	0	111953
260	2869	510	107045	501	0	110925
261	1600	486	108430	550	0	111066
262	462	447	3000	103822	0	107731
263	106555	465	1796	1959	0	110775
264	105493	505	844	1690	0	108532
265	2643	573	103874	784	0	107874
266	102217	600	2089	605	0	105511
267	1767	610	1837	101268	0	105482
268	1451	725	104132	1852	0	108160
269	494	827	104507	1597	0	107425
270	97041	700	3334	846	0	101921
271	1718	685	104093	673	0	107169
272	97250	578	2486	746	0	101060
273	1937	606	103928	743	0	107214
274	1527	99947	2590	811	0	104875
275	689	103103	2214	754	0	106760
276	770	2960	1186	98494	0	103410
277	715	1855	1029	102607	0	106206
278	809	903	101564	2885	0	106161
279	758	1063	2347	95277	0	99445
280	786	97712	2116	1890	0	102504
281	901	99393	1083	1580	0	102957
282	949	100011	980	672	0	102612
283	1240	3298	1027	94789	0	100354
284	1027	1888	96519	1756	0	101190
285	953	916	95666	1542	0	99077
286	1128	993	3261	90362	0	95744
287	958	701	1997	91087	0	94743
288	1175	694	966	84206	0	87041
289	985	91141	920	2762	0	95808
290	91022	1938	820	1563	0	95343
291	90068	1733	746	824	0	93371
292	3118	90614	872	784	0	95388
293	1952	2067	90967	669	0	95655
294	90175	1713	2039	667	0	94594
295	2189	839	93023	636	0	96687
296	90930	737	2241	562	0	94470
297	91061	661	1971	739	0	94432
298	90995	751	1031	700	0	93477
299	89333	636	841	934	0	91744
300	2863	89214	937	1101	0	94115
301	77242	1481	715	905	0	80343
302	1482	78546	813	946	0	81787
303	63084	1105	618	498	0	65305
304	1048	61267	598	511	0	63424
305	856	857	54796	293	0	56802
306	334	4863	969	45431	0	51597
307	244	50845	861	723	0	52673
308	251	47613	330	634	0	48828
309	42665	1286	1758	800	0	46509
310	37779	362	239	195	0	38575
311	630	39572	190	243	0	40635
312	439	343	184	37412	0	38378
313	200	42802	200	315	0	43517
314	42933	390	163	324	0	43810
315	510	367	43610	139	0	44626
316	450	170	465	41624	0	42709
317	246	82	456	41754	0	42538
318	230	124	195	42158	0	42707
319	235	163	41830	624	0	42852
320	194	42013	479	395	0	43081
321	230	42994	412	133	0	43769
322	206	689	191	43406	0	44492
323	255	421	44284	415	0	45375
324	215	201	463	43658	0	44537
325	216	200	461	44197	0	45074
326	229	214	200	43921	0	44564
327	243	222	154	44004	0	44623
328	42734	170	197	764	0	43865
329	449	43763	247	518	0	44977
330	43536	461	301	232	0	44530
331	510	443	43790	246	0	44989
332	533	211	44175	212	0	45131
333	261	201	721	42083	0	43266
334	235	201	460	40685	0	41581
335	218	44655	237	754	0	45864
336	216	455	45092	453	0	46216
337	166	45333	573	338	0	46410
338	228	459	45776	220	0	46683
339	41312	430	514	256	0	42512
340	445	45716	491	261	0	46913
341	504	509	46054	191	0	47258
342	258	475	489	44768	0	45990
343	237	268	46334	485	0	47324
344	187	45954	513	528	0	47182
345	240	535	440	43544	0	44759
346	206	45803	209	548	0	46766
347	300	524	45689	486	0	46999
348	245	501	485	44359	0	45590
349	44759	274	379	541	0	45953
350	505	44741	199	546	0	45991
351	505	550	44230	212	0	45497
352	211	988	472	41777	0	43448
353	187	216	43798	450	0	44651
354	200	211	40070	368	0	40849
355	99	36720	597	158	0	37574
356	224	237	331	32811	0	33603
357	79	213	99	33021	0	33412
358	74	70	53	32961	0	33158
359	80	85	34093	344	0	34602
360	79	103	33795	199	0	34176
361	29739	71	357	103	0	30270
362	222	93	33676	98	0	34089
363	31045	78	221	104	0	31448
364	204	33053	218	129	0	33604
365	201	252	117	30815	0	31385
366	46	33985	103	212	0	34346
367	39	34469	102	262	0	34872
368	60	374	33721	110	0	34265
369	42	233	253	32735	0	33263
370	84	115	33991	223	0	34413
371	65	138	32594	223	0	33020
372	30934	86	369	123	0	31512
373	194	104	32920	118	0	33336
374	190	85	32487	115	0	32877
375	30180	69	330	154	0	30733
376	180	73	32194	132	0	32579
377	173	115	32686	122	0	33096
378	73	102	348	30387	0	30910
379	48	32517	247	239	0	33051
380	74	225	119	32438	0	32856
381	67	201	120	32284	0	32672
382	32569	78	142	390	0	33179
383	206	74	143	31359	0	31782
384	167	33712	123	300	0	34302
385	33165	231	136	255	0	33787
386	209	241	33740	119	0	34309
387	31464	112	336	139	0	32051
388	230	142	36302	102	0	36776
389	197	107	37031	121	0	37456
390	38	38062	458	170	0	38728
391	37943	261	331	150	0	38685
392	221	39143	162	227	0	39753
393	246	284	39894	141	0	40565
394	165	279	304	34695	0	35443
395	62	40610	327	267	0	41266
396	40637	292	156	217	0	41302
397	40159	282	127	96	0	40664
398	423	40959	164	164	0	41710
399	41449	314	160	91	0	42014
400	274	261	157	39665	0	40357
401	201	41188	181	311	0	41881
402	65	296	165	41817	0	42343
403	60	279	148	43556	0	44043
404	44236	119	192	449	0	44996
405	43606	114	160	276	0	44156
406	43434	91	170	117	0	43812
407	516	113	43759	110	0	44498
408	41856	93	361	107	0	42417
409	330	227	361	43218	0	44136
410	283	95	44040	306	0	44724
411	124	93	42019	282	0	42518
412	67	41602	528	134	0	42331
413	36270	247	408	70	0	36995
414	212	38674	87	63	0	39036
415	207	190	49	37860	0	38306
416	140	176	49	38218	0	38583
417	84	92	39508	330	0	40014
418	77	48	234	37075	0	37434
419	64	37	40019	222	0	40342
420	65	45	39191	197	0	39498
421	44	39485	354	68	0	39951
422	131	152	164	37729	0	38176
423	50	145	47	37663	0	37905
424	37825	32	46	266	0	38169
425	192	46	38318	159	0	38715
426	174	33	173	38423	0	38803
427	38998	29	161	208	0	39396
428	183	46	39744	171	0	40144
429	38068	33	232	69	0	38402
430	39547	44	172	60	0	39823
431	323	65	41291	42	0	41721
432	179	48	200	39808	0	40235
433	75	44	163	40691	0	40973
434	67	51	43141	321	0	43580
435	40941	38	246	217	0	41442
436	42946	50	213	75	0	43284
437	42187	35	93	63	0	42378
438	42441	56	68	63	0	42628
439	42077	66	121	79	0	42343
440	359	75	41315	89	0	41838
441	220	71	43782	80	0	44153
442	80	43999	366	109	0	44554
443	109	212	44156	94	0	44571
444	106	243	239	42252	0	42840
445	137	117	281	36711	0	37246
446	105	69	85	44081	0	44340
447	118	64	65	44550	0	44797
448	158	58	44672	404	0	45292
449	122	44437	265	246	0	45070
450	133	47144	246	135	0	47658
451	171	383	103	42841	0	43498
452	113	47525	124	220	0	47982
453	47337	235	88	220	0	47880
454	46720	201	91	118	0	47130
455	430	50073	124	141	0	50768
456	313	237	86	49619	0	50255
457	136	193	111	50963	0	51403
458	136	88	51546	473	0	52243
459	45587	66	329	328	0	46310
460	51016	79	285	131	0	51511
461	476	53776	123	209	0	54584
462	53578	276	116	165	0	54135
463	388	269	55816	136	0	56609
464	318	56024	319	187	0	56848
465	148	57590	322	154	0	58214
466	124	57270	166	171	0	57731
467	163	572	120	56057	0	56912
468	55954	275	124	350	0	56703
469	369	92	117	57066	0	57644
470	422	87	59302	403	0	60214
471	198	86	378	58672	0	59334
472	200	105	62290	414	0	63009
473	166	104	428	58970	0	59668
474	201	152	396	55268	0	56017
475	154	61865	176	592	0	62787
476	62891	369	146	380	0	63786
477	437	352	147	59930	0	60866
478	384	63082	145	416	0	64027
479	63018	380	142	397	0	63937
480	57568	370	155	179	0	58272
481	62236	147	136	179	0	62698
482	623	63579	166	251	0	64619
483	422	385	63562	198	0	64567
484	168	357	407	62575	0	63507
485	173	281	380	60403	0	61237
486	156	63384	193	674	0	64407
487	193	399	63751	407	0	64750
488	193	336	62490	244	0	63263
489	57747	135	642	183	0	58707
490	447	271	350	60301	0	61369
491	433	147	63255	371	0	64206
492	158	65820	377	383	0	66738
493	223	574	314	59490	0	60601
494	142	66617	165	314	0	67238
495	145	364	65578	328	0	66415
496	59714	367	341	189	0	60611
497	64186	109	337	150	0	64782
498	583	65973	141	271	0	66968
499	347	336	102	65127	0	65912
500	219	417	65730	359	0	66725
501	140	65351	377	381	0	66249
502	62670	331	335	168	0	63504
503	297	63266	130	154	0	63847
504	267	63239	104	167	0	63777
505	176	514	116	60717	0	61523
506	81	63010	108	372	0	63571
507	62297	308	95	282	0	62982
508	301	296	81	61919	0	62597
509	299	125	60992	280	0	61696
510	129	129	59027	279	0	59564
511	130	210	434	57458	0	58232
512	72	59985	269	281	0	60607
513	59662	286	97	268	0	60313
514	299	288	72	58307	0	58966
515	283	133	58703	307	0	59426
516	112	109	262	57680	0	58163
517	84	169	258	58160	0	58671
518	57515	112	127	483	0	58237
519	272	112	88	56833	0	57305
520	330	148	57579	298	0	58355
521	139	143	57750	293	0	58325
522	119	104	453	57632	0	58308
523	117	169	306	58363	0	58955
524	138	150	60368	468	0	61124
525	51086	118	318	402	0	51924
526	322	141	60088	165	0	60716
527	282	59823	318	163	0	60586
528	146	285	313	60437	0	61181
529	151	322	61029	351	0	61853
530	157	152	60865	320	0	61494
531	121	130	471	58243	0	58965
532	59285	102	326	336	0	60049
533	318	129	61603	347	0	62397
534	263	61813	307	187	0	62570
535	61754	271	310	201	0	62536
536	319	298	62922	183	0	63722
537	58460	109	321	195	0	59085
538	62169	98	320	147	0	62734
539	458	65142	179	239	0	66018
540	323	285	147	60375	0	61130
541	140	65037	152	313	0	65642
542	144	319	63842	319	0	64624
543	60491	339	345	201	0	61376
544	65745	145	312	177	0	66379
545	531	169	67775	161	0	68636
546	380	145	67509	129	0	68163
547	121	69369	562	175	0	70227
548	69732	351	368	143	0	70594
549	418	331	142	68623	0	69514
550	342	152	135	64796	0	65425
551	120	68450	175	494	0	69239
552	66682	318	152	321	0	67473
553	373	330	68600	144	0	69447
554	319	139	338	72633	0	73429
555	73244	114	380	422	0	74160
556	421	75154	187	602	0	76364
557	393	435	84175	138	0	85141
558	208	379	85745	118	0	86450
559	164	643	931	78287	0	80025
560	90	84962	504	514	0	86070
561	155	568	86366	381	0	87470
562	167	494	639	83446	0	84746
563	85610	117	485	614	0	86826
564	615	136	88790	403	0	89944
565	437	187	682	86631	0	87937
566	183	125	90650	709	0	91667
567	156	113	92113	473	0	92855
568	142	537	1126	87644	0	89449
569	216	119	92366	666	0	93367
570	72286	82	982	600	0	73950
571	626	95	90243	140	0	91104
572	79863	65	738	134	0	80800
573	590	88065	545	163	0	89363
574	88561	600	194	161	0	89516
575	583	92417	236	159	0	93395
576	447	650	108	90854	0	92059
577	126	404	153	94230	0	94913
578	161	118	94111	1033	0	95423
579	147	170	95294	473	0	96084
580	132	71	1162	94518	0	95883
581	170	129	97288	792	0	98379
582	136	126	880	88487	0	89629
583	111	95304	624	735	0	96774
584	170	97670	293	606	0	98739
585	159	1160	267	94993	0	96579
586	156	541	212	96057	0	96966
587	137	185	95310	1130	0	96762
588	149	221	830	89304	0	90504
589	96	94148	584	840	0	95668
590	144	94437	316	601	0	95498
591	153	93521	272	352	0	94298
592	182	1141	271	83517	0	85111
593	106	88826	366	850	0	90148
594	87163	733	281	513	0	88690
595	757	491	306	86908	0	88462
596	505	210	87704	888	0	89307
597	194	197	906	85568	0	86865
598	233	178	88635	849	0	89895
599	214	210	88912	575	0	89911
600	218	203	89704	283	0	90408
601	172	87693	1294	488	0	89647
602	245	857	89121	288	0	90511
603	86773	501	961	336	0	88571
604	88815	237	727	273	0	90052
605	89873	220	382	294	0	90769
606	1113	254	365	88847	0	90579
607	88455	229	391	918	0	89993
608	766	88272	455	780	0	90273
609	512	91506	383	426	0	92827
610	90460	1141	402	342	0	92345
611	838	624	92702	335	0	94499
612	555	295	1003	90363	0	92216
613	262	340	94246	923	0	95771
614	217	393	94990	695	0	96295
615	173	94352	1351	429	0	96305
616	225	946	759	89073	0	91003
617	219	648	408	94199	0	95474
618	92567	332	353	1317	0	94569
619	740	94387	471	965	0	96563
620	569	95992	469	487	0	97517
621	442	1305	95179	410	0	97336
622	233	96595	1142	444	0	98414
623	93300	986	811	458	0	95555
624	93220	693	543	431	0	94887
625	1167	487	96507	396	0	98557
626	563	446	97072	405	0	98486
627	339	309	1612	89790	0	92050
628	299	352	956	91617	0	93224
629	306	94416	661	1406	0	96789
630	333	993	562	93325	0	95213
631	347	674	603	92101	0	93725
632	335	93917	567	1424	0	96243
633	355	967	516	92775	0	94613
634	404	703	587	89017	0	90711
635	320	89635	610	1509	0	92074
636	367	1012	89939	778	0	92096
637	367	700	1181	91283	0	93531
638	91693	447	881	1058	0	94079
639	90133	422	532	770	0	91857
640	1310	492	90777	461	0	93040
641	88016	480	1117	477	0	90090
642	89989	471	771	468	0	91699
643	1217	90471	501	678	0	92867
644	655	1039	88214	489	0	90397
645	351	678	88377	578	0	89984
646	367	628	1410	88013	0	90418
647	91207	363	864	1087	0	93521
648	94241	402	544	685	0	95872
649	1301	465	473	98009	0	100248
650	107058	394	474	1135	0	109061
651	108903	418	411	809	0	110541
652	103723	442	601	478	0	105244
653	1606	469	110083	453	0	112611
654	717	373	107655	351	0	109096
655	100522	237	1347	390	0	102496
656	935	354	105720	320	0	107329
657	471	96942	748	299	0	98460
658	546	854	1041	91345	0	93786
659	233	465	100061	558	0	101317
660	150	223	98920	372	0	99665
661	289	631	1070	90638	0	92628
662	145	111	97480	590	0	98326
663	182	142	95607	435	0	96366
664	109	91156	889	191	0	92345
665	125	94116	457	110	0	94808
666	91675	768	402	133	0	92978
667	572	467	92	91149	0	92280
668	91188	97	134	485	0	91904
669	551	97	93349	325	0	94322
670	380	104	501	90516	0	91501
671	143	108	359	92277	0	92887
672	87441	99	149	784	0	88473
673	468	92642	157	497	0	93764
674	421	491	91042	117	0	92071
675	213	553	91404	104	0	92274
676	85	91894	858	259	0	93096
677	194	455	91024	118	0	91791
678	96	91260	545	157	0	92058
679	129	87809	360	123	0	88421
680	237	731	83261	121	0	84350
681	75371	352	536	94	0	76353
682	443	93	321	84464	0	85321
683	307	89232	133	472	0	90144
684	141	399	87	86106	0	86733
685	87135	300	106	427	0	87968
686	83003	65	137	313	0	83518
687	82497	42	113	122	0	82774
688	629	63	82941	67	0	83700
689	325	77	434	77420	0	78256
690	68	84136	364	391	0	84959
691	86024	373	150	324	0	86871
692	399	297	117	86824	0	87637
693	315	119	119	87314	0	87867
694	223	136	114	89103	0	89576
695	122	112	92274	649	0	93157
696	79734	84	451	470	0	80739
697	447	93430	380	160	0	94417
698	373	397	126	92146	0	93042
699	181	314	106	93283	0	93884
700	90536	84	171	733	0	91524
701	544	127	95279	373	0	96323
702	435	114	96674	147	0	97370
703	186	94822	840	215	0	96063
704	180	483	97609	136	0	98408
705	80257	398	765	216	0	81636
706	488	98252	492	243	0	99475
707	406	528	98973	133	0	100040
708	78789	427	1036	182	0	80434
709	589	180	101048	162	0	101979
710	453	100609	648	206	0	101916
711	243	549	482	99207	0	100481
712	240	412	249	101344	0	102245
713	269	180	100558	846	0	101853
714	278	151	99664	473	0	100566
715	238	98792	1016	252	0	100298
716	93595	555	589	229	0	94968
717	588	100886	398	262	0	102134
718	525	623	338	98470	0	99956
719	309	507	100616	654	0	102086
720	86591	224	921	480	0	88216
721	668	168	692	96262	0	97790
722	472	98288	454	644	0	99858
723	222	100461	473	516	0	101672
724	196	932	399	98746	0	100273
725	233	561	327	100324	0	101445
726	97150	302	352	965	0	98769
727	635	274	319	100647	0	101875
728	503	271	101328	779	0	102881
729	94041	221	804	610	0	95676
730	100861	226	675	325	0	102087
731	959	280	102985	285	0	104509
732	95097	299	859	285	0	96540
733	739	269	577	104024	0	105609
734	592	310	312	104695	0	105909
735	322	285	305	104925	0	105837
736	346	241	335	100815	0	101737
737	232	104120	370	1143	0	105865
738	104935	735	342	596	0	106608
739	107512	574	321	374	0	108781
740	1152	371	113200	312	0	115035
741	112020	281	862	323	0	113486
742	117696	269	697	275	0	118937
743	119201	290	325	303	0	120119
744	121820	275	316	291	0	122702
745	1382	122120	321	372	0	124195
746	746	1315	214	115924	0	118199
747	428	563	118326	869	0	120186
748	381	296	112912	545	0	114134
749	93845	1370	2260	513	0	97988
750	95590	319	1062	236	0	97207
751	852	93986	172	158	0	95168
752	94384	557	124	141	0	95206
753	672	95978	123	166	0	96939
754	502	671	117	93805	0	95095
755	97312	313	156	715	0	98496
756	96890	104	97	349	0	97440
757	95251	97	93	167	0	95608
758	911	95465	140	238	0	96754
759	95240	595	98	138	0	96071
760	744	328	103	96133	0	97308
761	97695	111	150	653	0	98609
762	806	159	97619	337	0	98921
763	450	98540	657	271	0	99918
764	98094	584	338	139	0	99155
765	782	398	100261	88	0	101529
766	488	182	654	97103	0	98427
767	291	170	101716	648	0	102825
768	284	158	101823	364	0	102629
769	301	116	900	97916	0	99233
770	348	158	104089	650	0	105245
771	294	130	696	101602	0	102722
772	284	145	386	103703	0	104518
773	102370	137	163	970	0	103640
774	737	106344	203	566	0	107850
775	484	109649	196	273	0	110602
776	306	112039	221	221	0	112787
777	650	1051	111512	157	0	113370
778	282	607	786	109371	0	111046
779	296	246	114816	797	0	116155
780	103554	139	916	549	0	105158
781	110346	159	527	253	0	111285
782	1077	115228	251	365	0	116921
783	635	837	200	109476	0	111148
784	298	116530	214	721	0	117763
785	115442	766	224	502	0	116934
786	914	516	225	115112	0	116767
787	668	275	117522	822	0	119287
788	362	116429	825	695	0	118311
789	475	839	118909	260	0	120483
790	347	566	849	115718	0	117480
791	336	316	117837	829	0	119318
792	106046	236	958	640	0	107880
793	957	281	119003	353	0	120594
794	639	118833	927	377	0	120776
795	384	797	632	116454	0	118267
796	316	581	366	118839	0	120102
797	117944	274	315	1161	0	119694
798	116897	258	329	645	0	118129
799	1239	117967	331	544	0	120081
800	728	836	116489	270	0	118323
801	488	610	115753	256	0	117107
802	111456	276	1227	348	0	113307
803	1050	361	118565	317	0	120293
804	767	346	116200	262	0	117575
805	494	317	118850	345	0	120006
806	505	370	118343	331	0	119549
807	416	119141	1308	378	0	121243
808	118516	872	915	344	0	120647
809	1168	722	444	115662	0	117996
810	116745	352	481	873	0	118451
811	1093	117122	457	692	0	119364
812	115779	913	464	341	0	117497
813	996	123112	520	420	0	125048
814	882	894	490	120665	0	122931
815	465	129164	570	983	0	131182
816	629	1049	128229	728	0	130635
817	477	132598	1172	461	0	134708
818	531	1125	825	137628	0	140109
819	138388	786	462	1151	0	140787
820	1233	458	456	138796	0	140943
821	1028	530	141557	1163	0	144278
822	639	486	1246	132236	0	134607
823	496	141420	1002	1150	0	144068
824	524	1202	141356	880	0	143962
825	134765	902	1322	484	0	137473
826	1309	485	1029	144114	0	146937
827	144694	416	624	1228	0	146962
828	141700	446	543	1050	0	143739
829	1688	146231	629	598	0	149146
830	145517	1189	581	518	0	147805
831	144099	974	540	556	0	146169
832	1684	147901	673	513	0	150771
833	1014	1231	620	147890	0	150755
834	571	974	645	145363	0	147553
835	447	148632	705	1779	0	151563
836	459	1296	600	150226	0	152581
837	512	1146	149178	1284	0	152120
838	540	831	1356	144829	0	147556
839	635	484	145913	1323	0	148355
840	549	459	135980	993	0	137981
841	405	136000	1712	564	0	138681
842	399	135331	1009	519	0	137258
843	447	137343	585	451	0	138826
844	994	1682	689	128758	0	132123
845	399	868	131634	839	0	133740
846	121584	349	965	809	0	123707
847	869	244	832	131632	0	133577
848	809	323	133976	799	0	135907
849	378	385	133576	773	0	135112
850	266	135054	1434	437	0	137191
851	327	1050	916	132064	0	134357
852	129050	870	364	794	0	131078
853	694	132018	379	1047	0	134138
854	711	131531	406	469	0	133117
855	306	131298	380	455	0	132439
856	291	1540	331	128402	0	130564
857	248	134804	459	936	0	136447
858	283	989	380	140998	0	142650
859	292	886	362	143698	0	145238
860	301	435	142575	1750	0	145061
861	112056	367	1372	1522	0	115317
862	1143	467	146330	382	0	148322
863	955	575	1214	142283	0	145027
864	454	426	147707	1240	0	149827
865	234	145778	1351	1174	0	148537
866	144222	1289	1283	439	0	147233
867	1232	1107	428	140812	0	143579
868	947	366	378	142318	0	144009
869	142968	300	402	1979	0	145649
870	141245	344	359	1126	0	143074
871	144679	328	351	536	0	145894
872	2015	366	144949	363	0	147693
873	128361	351	1219	419	0	130350
874	1124	142310	1020	388	0	144842
875	914	141515	361	376	0	143166
876	408	1856	376	135100	0	137740
877	358	1174	248	129509	0	131289
878	297	135012	284	1900	0	137493
879	351	1200	205	133400	0	135156
880	126581	988	250	1352	0	129171
881	1231	450	133105	1138	0	135924
882	942	132625	1185	582	0	135334
883	123304	1213	996	475	0	125988
884	981	129938	492	625	0	132036
885	918	1313	129793	446	0	132470
886	394	1077	1181	125631	0	128283
887	409	517	130165	1296	0	132387
888	311	127942	1251	1242	0	130746
889	408	1225	1050	125007	0	127690
890	421	1085	127316	1229	0	130051
891	494	577	127718	1105	0	129894
892	476	469	1836	121772	0	124553
893	126346	401	1098	1236	0	129081
894	125826	454	447	1109	0	127836
895	126987	390	395	560	0	128332
896	2003	455	129830	544	0	132832
897	1080	129806	1269	582	0	132737
898	464	1306	1025	127076	0	129871
899	432	1133	448	121223	0	123236
900	375	129072	459	1881	0	131787
901	126119	1286	416	1199	0	129020
902	1170	1073	380	127104	0	129727
903	1074	569	127679	1370	0	130692
904	459	128029	1288	1288	0	131064
905	119928	1270	1115	597	0	122910
906	1100	126169	605	711	0	128585
907	1032	1311	569	122271	0	125183
908	467	1150	594	123393	0	125604
909	483	570	592	122328	0	123973
910	511	633	123876	2028	0	127048
911	587	579	1380	113531	0	116077
912	530	121190	1325	1507	0	124552
913	597	117243	736	1336	0	119912
914	798	1816	112808	714	0	116136
915	103466	1115	1395	747	0	106723
916	108286	647	1240	819	0	110992
917	1826	108268	596	849	0	111539
918	100551	1020	632	654	0	102857
919	98969	840	433	684	0	100926
920	1636	104338	524	778	0	107276
921	1215	1079	468	103923	0	106685
922	830	1012	110079	1238	0	113159
923	826	689	107264	988	0	109767
924	104454	665	1841	692	0	107652
925	1301	110681	1130	816	0	113928
926	1178	1281	519	109346	0	112324
927	658	1157	470	110267	0	112552
928	681	668	476	110204	0	112029
929	107089	620	512	2047	0	110268
930	1473	639	509	107996	0	110617
931	1242	624	449	107011	0	109326
932	790	686	104323	1840	0	107639
933	93048	547	1260	1220	0	96075
934	1312	102920	1108	769	0	106109
935	100746	1264	557	571	0	103138
936	1245	100203	609	640	0	102697
937	1083	1314	573	95257	0	98227
938	100044	1001	531	1239	0	102815
939	99699	607	603	1096	0	102005
940	1585	651	100669	641	0	103546
941	97968	564	1240	742	0	100514
942	1306	593	103068	657	0	105624
943	1083	565	99751	563	0	101962
944	710	610	100389	628	0	102337
945	674	603	105803	559	0	107639
946	657	618	1957	103602	0	106834
947	705	610	108394	1429	0	111138
948	631	505	1524	105410	0	108070
949	106274	580	1107	1537	0	109498
950	1430	572	603	105390	0	107995
951	101750	536	601	1643	0	104530
952	1258	105530	661	1411	0	108860
953	1025	1561	632	104185	0	107403
954	738	1132	103550	1619	0	107039
955	570	109176	1463	1493	0	112702
956	734	2265	1087	105393	0	109479
957	719	991	107798	1489	0	110997
958	454	103076	1191	1027	0	105748
959	398	102363	789	573	0	104123
960	803	1630	100541	408	0	103382
961	586	1695	1236	94119	0	97636
962	319	272	96064	1119	0	97774
963	88067	143	1015	635	0	89860
964	91753	102	567	232	0	92654
965	1301	91941	252	239	0	93733
966	91807	899	145	193	0	93044
967	1005	577	153	91662	0	93397
968	625	231	91651	946	0	93453
969	84694	119	978	707	0	86498
970	1029	155	91021	315	0	92520
971	578	89719	997	228	0	91522
972	90943	934	568	201	0	92646
973	939	593	183	89978	0	91693
974	636	213	91133	893	0	92875
975	89077	92	945	619	0	90733
976	89609	95	651	219	0	90574
977	90280	132	213	165	0	90790
978	1454	129	161	89417	0	91161
979	689	120	135	90939	0	91883
980	225	163	90828	1469	0	92685
981	174	90333	1016	782	0	92305
982	245	876	657	88256	0	90034
983	253	589	218	90939	0	91999
984	277	225	90718	1443	0	92663
985	245	178	90533	761	0	91717
986	185	105	1511	89151	0	90952
987	87568	140	774	998	0	89480
988	924	89850	327	815	0	91916
989	88913	938	227	291	0	90369
990	1003	89750	332	354	0	91439
991	743	1039	88927	237	0	90946
992	322	680	89971	249	0	91222
993	84798	230	1616	288	0	86932
994	92025	187	795	310	0	93317
995	1652	92647	351	519	0	95169
996	956	1080	90039	383	0	92458
997	427	707	1195	88091	0	90420
998	358	226	851	85573	0	87008
999	374	89818	401	1730	0	92323
1000	391	1126	235	89492	0	91244
1001	324	847	90346	1247	0	92764
1002	86383	328	1249	849	0	88809
1003	88218	250	878	382	0	89728
1004	88413	258	401	334	0	89406
1005	89403	240	353	312	0	90308
1006	1964	352	87396	259	0	89971
1007	85521	208	1319	279	0	87327
1008	1534	240	87665	284	0	89723
1009	1034	86616	1463	354	0	89467
1010	532	1121	1054	86373	0	89080
1011	87353	751	483	1199	0	89786
1012	1292	302	482	89870	0	91946
1013	1018	289	90508	1343	0	93158
1014	88075	239	1426	953	0	90693
1015	90015	271	1001	497	0	91784
1016	2025	217	439	89157	0	91838
1017	1130	231	397	90329	0	92087
1018	646	296	89612	2058	0	92612
1019	450	89628	1402	1200	0	92680
1020	84811	1181	1028	520	0	87540
1021	1333	895	81401	352	0	83981
1022	74607	309	1263	326	0	76505
1023	1400	77127	954	361	0	79842
1024	75045	1119	460	230	0	76854
1025	1402	74110	381	333	0	76226
1026	1026	74571	394	333	0	76324
1027	640	1688	396	72043	0	74767
1028	495	858	355	73508	0	75216
1029	466	367	333	73823	0	74989
1030	458	267	347	74067	0	75139
1031	410	308	72204	1890	0	74812
1032	69499	243	1200	1058	0	72000
1033	72452	228	895	498	0	74073
1034	73359	198	468	431	0	74456
1035	1996	187	375	71491	0	74049
1036	1223	195	325	72226	0	73969
1037	71799	206	339	1702	0	74046
1038	71885	232	346	926	0	73389
1039	72130	234	338	422	0	73124
1040	1923	324	351	68842	0	71440
1041	1084	402	304	67538	0	69328
1042	534	249	65976	1636	0	68395
1043	482	296	65040	886	0	66704
1044	406	63780	1619	511	0	66316
1045	54695	1460	1990	810	0	58955
1046	53139	624	656	368	0	54787
1047	52872	207	302	338	0	53719
1048	1309	195	52435	297	0	54236
1049	51066	177	743	284	0	52270
1050	51935	165	603	285	0	52988
1051	52470	149	282	281	0	53182
1052	1368	138	286	50699	0	52491
1053	840	168	249	50899	0	52156
1054	504	141	257	50553	0	51455
1055	393	169	46514	1130	0	48206
1056	41619	148	649	638	0	43054
1057	788	43565	552	297	0	45202
1058	37091	419	155	171	0	37836
1059	596	36702	128	218	0	37644
1060	476	36499	152	206	0	37333
1061	478	761	217	35361	0	36817
1062	422	414	277	34140	0	35253
1063	203	34814	145	690	0	35852
1064	34106	407	101	441	0	35055
1065	33989	331	116	222	0	34658
1066	752	116	119	33499	0	34486
1067	480	115	33298	494	0	34387
1068	303	96	33021	380	0	33800
1069	303	104	33781	183	0	34371
1070	307	102	33101	160	0	33670
1071	29733	306	933	189	0	31161
1072	29701	55	396	136	0	30288
1073	675	64	172	28967	0	29878
1074	450	97	28658	414	0	29619
1075	265	92	394	27936	0	28687
1076	180	29451	348	430	0	30409
1077	210	31925	142	386	0	32663
1078	31544	567	116	205	0	32432
1079	31322	323	103	163	0	31911
1080	31182	128	106	157	0	31573
1081	683	111	91	30557	0	31442
1082	428	106	90	31081	0	31705
1083	261	83	86	31387	0	31817
1084	226	76	67	31431	0	31800
1085	222	83	31006	665	0	31976
1086	194	63	339	30709	0	31305
1087	31854	56	281	487	0	32678
1088	449	56	146	32176	0	32827
1089	394	66	111	32426	0	32997
1090	204	242	115	31789	0	32350
1091	178	31602	113	712	0	32605
1092	186	31168	121	417	0	31892
1093	146	30871	116	191	0	31324
1094	143	429	98	27114	0	27784
1095	122	230	104	27543	0	27999
1096	27597	74	46	471	0	28188
1097	27556	59	57	281	0	27953
1098	27875	37	50	131	0	28093
1099	500	96	54	27544	0	28194
1100	309	52	47	27094	0	27502
1101	144	27721	59	445	0	28369
1102	149	28479	66	293	0	28987
1103	27879	397	40	132	0	28448
1104	325	223	43	27458	0	28049
1105	27344	50	58	300	0	27752
1106	27799	38	53	281	0	28171
1107	439	35	53	26885	0	27412
1108	259	28731	70	276	0	29336
1109	28859	232	42	257	0	29390
1110	29378	214	38	113	0	29743
1111	466	78	30028	115	0	30687
1112	26972	34	182	76	0	27264
1113	201	27673	160	80	0	28114
1114	215	154	26	28251	0	28646
1115	32385	141	27	270	0	32823
1116	268	33	17	33128	0	33446
1117	217	37	25	32443	0	32722
1118	66	33281	28	398	0	33773
1119	32983	215	17	232	0	33447
1120	33094	192	19	93	0	33398
1121	396	33424	29	95	0	33944
1122	207	35816	25	79	0	36127
1123	35701	337	52	74	0	36164
1124	35402	213	45	72	0	35732
1125	409	62	34981	74	0	35526
1126	239	72	33938	56	0	34305
1127	94	47	36541	53	0	36735
1128	73	28	370	36050	0	36521
1129	52	53	197	37204	0	37506
1130	58	52	37314	377	0	37801
1131	36091	37	203	247	0	36578
1132	38481	25	165	107	0	38778
1133	38758	39	38	72	0	38907
1134	38382	28	35	73	0	38518
1135	443	49	43583	49	0	44124
1136	44317	31	231	118	0	44697
1137	46885	35	223	139	0	47282
1138	47248	43	78	78	0	47447
1139	47452	29	55	68	0	47604
1140	47228	48	43	103	0	47422
1141	453	69	49093	94	0	49709
1142	269	49873	225	84	0	50451
1143	117	207	186	50093	0	50603
1144	106	177	50	50845	0	51178
1145	115	79	50859	382	0	51435
1146	46789	62	235	281	0	47367
1147	282	48	193	50973	0	51496
1148	268	62	53368	252	0	53950
1149	141	90	53210	240	0	53681
1150	115	56602	405	134	0	57256
1151	163	240	212	57487	0	58102
1152	130	199	81	58324	0	58734
1153	91	73	59	58864	0	59087
1154	58716	44	66	454	0	59280
1155	269	55	49	59059	0	59432
1156	291	88	59119	332	0	59830
1157	155	86	56874	268	0	57383
1158	146	98	63922	122	0	64288
1159	157	67	440	63880	0	64544
1160	66075	49	283	297	0	66704
1161	330	95	66971	258	0	67654
1162	65092	49	265	135	0	65541
1163	78412	53	239	324	0	79028
1164	566	60	104	81211	0	81941
1165	346	42	74	82627	0	83089
1166	164	85218	98	536	0	86016
1167	206	327	85882	319	0	86734
1168	81836	243	297	180	0	82556
1169	369	88	278	89855	0	90590
1170	300	91494	165	396	0	92355
1171	174	313	71	92603	0	93161
1172	168	366	93228	411	0	94173
1173	150	158	358	90412	0	91078
1174	142	93352	405	394	0	94293
1175	165	314	109	92766	0	93354
1176	92038	260	110	414	0	92822
1177	377	111	102	92046	0	92636
1178	342	92481	164	401	0	93388
1179	154	93945	113	447	0	94659
1180	89424	489	107	243	0	90263
1181	427	359	95264	198	0	96248
1182	358	120	330	94183	0	94991
1183	186	109	293	99446	0	100034
1184	214	139	102539	631	0	103523
1185	143	103479	414	685	0	104721
1186	193	400	104465	220	0	105278
1187	212	515	370	99019	0	100116
1188	117	109054	345	436	0	109952
1189	111124	318	154	448	0	112044
1190	349	112701	177	292	0	113519
1191	286	115126	149	286	0	115847
1192	116480	504	165	263	0	117412
1193	120929	297	140	315	0	121681
1194	123728	100	106	255	0	124189
1195	563	116	101	124367	0	125147
1196	367	177	125646	469	0	126659
1197	120554	96	347	484	0	121481
1198	132042	104	318	245	0	132709
1199	713	91	127	137339	0	138270
1200	448	187	139014	572	0	140221
1201	132	139245	551	578	0	140506
1202	138431	465	368	228	0	139492
1203	144344	397	155	336	0	145232
1204	769	149924	192	319	0	151204
1205	453	155479	175	252	0	156359
1206	155221	773	100	302	0	156396
1207	154315	445	84	208	0	155052
1208	154643	144	97	230	0	155114
1209	885	121	96	154144	0	155246
1210	556	253	161005	582	0	162396
1211	293	161	510	157986	0	158950
1212	316	225	162228	641	0	163410
1213	179	161364	604	586	0	162733
1214	172	163789	524	313	0	164798
1215	324	767	153	156912	0	158156
1216	194	365	106	161838	0	162503
1217	195	176	105	158203	0	158679
1218	122	163961	183	881	0	165147
1219	160800	483	126	523	0	161932
1220	157783	444	96	242	0	158565
1221	771	166461	194	456	0	167882
1222	520	546	74	161622	0	162762
1223	205	166170	173	654	0	167202
1224	248	609	101	164074	0	165032
1225	218	168276	195	697	0	169386
1226	167620	559	184	667	0	169030
1227	606	459	138	168560	0	169763
1228	562	347	169619	630	0	171158
1229	161930	209	528	599	0	163266
1230	168194	190	423	389	0	169196
1231	903	336	171040	282	0	172561
1232	581	246	473	168487	0	169787
1233	345	404	175503	645	0	176897
1234	281	267	520	173474	0	174542
1235	342	367	172975	679	0	174363
1236	158648	238	588	627	0	160101
1237	590	327	400	168287	0	169604
1238	478	173338	285	763	0	174864
1239	176051	614	193	622	0	177480
1240	680	550	142	178805	0	180177
1241	601	226	168	178791	0	179786
1242	414	372	178926	1007	0	180719
1243	378	263	593	182240	0	183474
1244	515	396	191811	928	0	193650
1245	485	381	198510	706	0	200082
1246	373	285	1307	200628	0	202593
1247	435	386	219943	1006	0	221770
1248	207042	232	1282	964	0	209520
1249	244563	235	799	499	0	246096
1250	243019	424	338	443	0	244224
1251	2598	268131	414	703	0	271846
1252	1572	2070	281	267847	0	271770
1253	694	1607	280	249113	0	251694
1254	499	276513	401	2928	0	280341
1255	271745	2051	386	1427	0	275609
1256	2222	1337	272	268478	0	272309
1257	1574	601	283557	2237	0	287969
1258	797	551	275170	1605	0	278123
1259	444	274509	3336	1005	0	279294
1260	273434	2052	1558	644	0	277688
1261	2455	1558	277640	583	0	282236
1262	240900	502	2413	752	0	244567
1263	2121	252407	1766	1029	0	257323
1264	1647	2060	265375	680	0	269762
1265	748	1515	267002	445	0	269710
1266	735	722	269712	493	0	271662
1267	545	260312	3567	940	0	265364
1268	973	2436	263060	562	0	267031
1269	249401	1342	2385	579	0	253707
1270	2241	560	1442	255656	0	259899
1271	1478	349	530	265597	0	267954
1272	569	384	434	267737	0	269124
1273	573	364	417	269290	0	270644
1274	577	568	269740	3497	0	274382
1275	625	356	2300	264478	0	267759
1276	546	335	1475	267661	0	270017
1277	266430	306	644	3511	0	270891
1278	270556	323	592	1925	0	273396
1279	263987	300	699	929	0	265915
1280	3594	529	274659	632	0	279414
1281	1664	278938	2584	860	0	284046
1282	587	283707	1811	768	0	286873
1283	257920	3663	640	694	0	262917
1284	2146	276070	751	868	0	279835
1285	1758	2668	575	269526	0	274527
1286	755	1634	526	275444	0	278359
1287	705	719	274789	3875	0	280088
1288	492	267426	2846	2396	0	273160
1289	637	2536	268160	854	0	272187
1290	254378	1556	2789	894	0	259617
1291	266347	513	1905	807	0	269572
1292	3912	405	738	265763	0	270818
1293	2007	334	699	263037	0	266077
1294	762	417	693	263408	0	265280
1295	765	452	701	264051	0	265969
1296	785	545	263403	4182	0	268915
1297	862	771	2656	254770	0	259059
1298	762	533	260561	2880	0	264736
1299	753	521	252769	2023	0	256066
1300	487	252664	3982	1156	0	258289
1301	249791	2471	2181	832	0	255275
1302	2346	257864	1030	972	0	262212
1303	1928	2919	851	242233	0	247931
1304	827	1834	259343	2613	0	264617
1305	238397	566	3109	2028	0	244100
1306	2923	679	256165	960	0	260727
1307	249666	544	3211	869	0	254290
1308	254247	533	2165	1001	0	257946
1309	4307	510	1028	260084	0	265929
1310	2382	530	865	255667	0	259444
1311	1113	604	1214	257203	0	260134
1312	1022	787	253729	4740	0	260278
1313	235955	689	3237	2767	0	242648
1314	3235	248655	2473	1597	0	255960
1315	2629	2927	1017	242746	0	249319
1316	250879	2122	988	3319	0	257308
1317	252709	908	1088	2462	0	257167
1318	252620	909	1009	1468	0	256006
1319	5145	1172	249468	1289	0	257074
1320	246281	1105	3429	1419	0	252234
1321	250099	1215	2533	1568	0	255415
1322	5095	1070	246345	1559	0	254069
1323	2793	1099	256172	1312	0	261376
1324	1552	1056	5420	248433	0	256461
1325	1503	985	258341	3557	0	264386
1326	1172	250191	4806	2905	0	259074
1327	1231	257601	3785	1245	0	263862
1328	247655	4812	2042	1060	0	255569
1329	3652	257095	1874	1257	0	263878
1330	2910	3403	1714	255071	0	263098
1331	244689	2328	1903	3822	0	252742
1332	3297	256871	1752	3275	0	265195
1333	2449	3533	1756	253402	0	261140
1334	1348	2392	1837	256225	0	261802
1335	1147	1075	253387	5854	0	261463
1336	1364	816	4028	248133	0	254341
1337	1359	1067	253129	4710	0	260265
1338	1567	806	250025	3568	0	255966
1339	1693	714	4907	239423	0	246737
1340	1436	700	2568	243437	0	248141
1341	241148	627	1245	5934	0	248954
1342	3591	256045	1435	3882	0	264953
1343	2822	3454	1153	243909	0	251338
1344	1725	3817	1132	244225	0	250899
1345	230015	875	873	5825	0	237588
1346	3815	228068	1078	3484	0	236445
1347	2634	214496	1033	1497	0	219660
1348	1211	205353	1086	1181	0	208831
1349	781	183669	928	968	0	186346
1350	158052	3151	4434	654	0	166291
1351	153259	1355	921	586	0	156121
1352	147875	487	365	557	0	149284
1353	147938	331	302	530	0	149101
1354	2847	357	349	144574	0	148127
1355	1359	446	144037	1987	0	147829
1356	512	142913	1954	1499	0	146878
1357	567	1773	1276	139181	0	142797
1358	579	1242	140712	1901	0	144434
1359	556	419	1815	138086	0	140876
1360	561	342	1201	139092	0	141196
1361	511	485	139351	2840	0	143187
1362	500	386	1836	137186	0	139908
1363	495	357	1272	135011	0	137135
1364	138730	360	515	2924	0	142529
1365	136166	397	405	1594	0	138562
1366	135909	374	444	732	0	137459
1367	135042	438	421	670	0	136571
1368	3030	428	406	131933	0	135797
1369	1612	415	403	133144	0	135574
1370	790	464	406	133552	0	135212
1371	130077	386	442	3127	0	134032
1372	2248	391	440	131081	0	134160
1373	1736	342	430	130564	0	133072
1374	854	528	125939	3045	0	130366
1375	854	934	1888	119620	0	123296
1376	693	123378	1336	2211	0	127618
1377	687	125785	548	1944	0	128964
1378	116391	2498	415	858	0	120162
1379	2080	1281	116721	848	0	120930
1380	1330	109517	1617	769	0	113233
1381	105942	1509	1500	606	0	109557
1382	1790	1063	399	106914	0	110166
1383	1236	500	107128	1873	0	110737
1384	656	601	1557	99962	0	102776
1385	529	108921	1137	1884	0	112471
1386	106787	1516	499	1331	0	110133
1387	1644	110211	527	817	0	113199
1388	109372	1605	359	735	0	112071
1389	109784	1102	389	635	0	111910
1390	2571	561	333	108363	0	111828
1391	1362	395	315	104299	0	106371
1392	612	108758	397	2578	0	112345
1393	108339	1619	345	1480	0	111783
1394	1901	1228	107943	711	0	111783
1395	103583	512	1493	692	0	106280
1396	102957	479	986	747	0	105169
1397	3225	457	100599	763	0	105044
1398	1331	695	1408	95624	0	99058
1399	97340	354	1087	1804	0	100585
1400	1696	470	97199	1402	0	100767
1401	1231	476	94062	681	0	96450
1402	85722	388	2214	654	0	88978
1403	1534	88835	1136	666	0	92171
1404	1133	82487	435	595	0	84650
1405	1082	2129	631	79593	0	83435
1406	637	1029	80046	1416	0	83128
1407	73334	436	1366	1119	0	76255
1408	1466	463	78142	625	0	80696
1409	954	72196	1239	482	0	74871
1410	71540	1241	855	508	0	74144
1411	1410	855	314	71238	0	73817
1412	71865	352	338	1438	0	73993
1413	1440	364	71500	1087	0	74391
1414	1048	389	1190	67904	0	70531
1415	564	71655	802	1263	0	74284
1416	548	1328	350	69674	0	71900
1417	634	906	335	70937	0	72812
1418	700	431	70738	1829	0	73698
1419	683	68435	1247	1063	0	71428
1420	660	68332	835	611	0	70438
1421	697	1506	64278	539	0	67020
1422	57957	703	1151	502	0	60313
1423	60291	239	794	495	0	61819
1424	1759	392	369	58334	0	60854
1425	55492	250	369	1093	0	57204
1426	1122	53881	347	900	0	56250
1427	791	55040	358	572	0	56761
1428	54480	1352	484	503	0	56819
1429	1364	829	396	53576	0	56165
1430	54400	263	340	1128	0	56131
1431	54733	296	287	850	0	56166
1432	1555	324	250	51486	0	53615
1433	922	316	51613	1098	0	53949
1434	50032	278	1034	725	0	52069
1435	51264	282	710	318	0	52574
1436	1671	302	336	48875	0	51184
1437	844	50186	356	1049	0	52435
1438	474	1176	276	50054	0	51980
1439	471	661	49794	1167	0	52093
1440	619	276	49024	781	0	50700
1441	443	48043	1399	448	0	50333
1442	888	724	828	30761	0	33201
1443	188	301	291	31088	0	31868
1444	184	132	31258	538	0	32112
1445	29226	112	399	317	0	30054
1446	31293	102	294	171	0	31860
1447	31313	101	158	121	0	31693
1448	30912	98	137	148	0	31295
1449	614	30263	140	191	0	31208
1450	380	31260	125	166	0	31931
1451	31521	555	130	168	0	32374
1452	447	301	155	32043	0	32946
1453	385	183	113	31924	0	32605
1454	210	32463	130	642	0	33445
1455	206	421	123	32568	0	33318
1456	211	321	130	31370	0	32032
1457	218	31899	133	621	0	32871
1458	238	404	31674	401	0	32717
1459	236	319	415	31493	0	32463
1460	31648	131	334	454	0	32567
1461	31040	143	136	357	0	31676
1462	699	141	30900	184	0	31924
1463	454	132	30644	161	0	31391
1464	261	114	30372	166	0	30913
1465	245	166	626	28782	0	29819
1466	206	132	29838	423	0	30599
1467	219	142	29583	352	0	30296
1468	235	420	603	26879	0	28137
1469	274	29792	363	406	0	30835
1470	294	374	29878	374	0	30920
1471	148	30391	421	208	0	31168
1472	29181	433	350	186	0	30150
1473	387	29895	138	215	0	30635
1474	364	400	174	28988	0	29926
1475	29234	308	136	401	0	30079
1476	403	126	126	29169	0	29824
1477	367	123	125	29411	0	30026
1478	211	108	29732	580	0	30631
1479	182	28736	395	377	0	29690
1480	206	29374	332	179	0	30091
1481	207	545	180	27265	0	28197
1482	178	272	122	27292	0	27864
1483	164	115	126	27050	0	27455
1484	137	113	26441	492	0	27183
1485	143	128	24682	280	0	25233
1486	21348	94	447	174	0	22063
1487	246	66	22739	124	0	23175
1488	194	80	22254	114	0	22642
1489	94	21223	376	141	0	21834
1490	181	282	292	20720	0	21475
1491	104	164	21153	232	0	21653
1492	85	71	205	20289	0	20650
1493	86	58	21599	246	0	21989
1494	66	51	225	21287	0	21629
1495	83	67	22632	254	0	23036
1496	71	50	248	21957	0	22326
1497	66	56	217	21615	0	21954
1498	66	22996	104	357	0	23523
1499	61	208	82	22571	0	22922
1500	48	23431	86	244	0	23809
1501	53	236	81	23503	0	23873
1502	53	193	81	23576	0	23903
1503	22925	81	97	371	0	23474
1504	210	97	81	23078	0	23466
1505	206	87	23051	265	0	23609
1506	90	43	229	22853	0	23215
1507	62	63	216	23078	0	23419
1508	64	62	22854	403	0	23383
1509	76	79	22670	254	0	23079
1510	52	67	379	21413	0	21911
1511	64	82	239	22241	0	22626
1512	60	91	22668	418	0	23237
1513	37	22223	258	291	0	22809
1514	46	22774	240	175	0	23235
1515	22257	330	134	137	0	22858
1516	228	234	80	22446	0	22988
1517	22894	61	127	283	0	23365
1518	22081	68	115	249	0	22513
1519	311	22723	116	151	0	23301
1520	22871	226	99	116	0	23312
1521	22680	176	127	131	0	23114
1522	331	79	22705	133	0	23248
1523	195	114	235	22203	0	22747
1524	63	81	23451	276	0	23871
1525	58	87	279	23085	0	23509
1526	68	59	23339	277	0	23743
1527	38	22022	270	247	0	22577
1528	44	22120	245	133	0	22542
1529	228	369	149	20826	0	21572
1530	20607	158	119	212	0	21096
1531	159	51	75	20719	0	21004
1532	150	50	72	20755	0	21027
1533	44	55	21170	316	0	21585
1534	55	49	21192	217	0	21513
1535	61	54	21553	93	0	21761
1536	32	62	330	20788	0	21212
1537	49	55	225	19945	0	20274
1538	38	21512	96	333	0	21979
1539	35	22154	100	246	0	22535
1540	21308	292	86	110	0	21796
1541	153	21966	76	122	0	22317
1542	149	215	21233	101	0	21698
1543	64	167	198	20769	0	21198
1544	43	57	22204	224	0	22528
1545	28	22205	233	269	0	22735
1546	47	244	211	21971	0	22473
1547	21105	157	101	245	0	21608
1548	157	70	21945	206	0	22378
1549	132	22129	197	139	0	22597
1550	50	162	21856	104	0	22172
1551	29	21380	196	94	0	21699
1552	114	280	233	20114	0	20741
1553	20277	135	75	149	0	20636
1554	19898	46	39	167	0	20150
1555	207	20093	57	83	0	20440
1556	20278	118	44	87	0	20527
1557	142	111	56	20093	0	20402
1558	20406	65	75	142	0	20688
1559	145	54	21318	181	0	21698
1560	130	39	21690	93	0	21952
1561	57	50	269	20386	0	20762
1562	49	40	151	22257	0	22497
1563	58	59	22239	274	0	22630
1564	49	50	177	22205	0	22481
1565	22456	48	150	199	0	22853
1566	22289	33	61	188	0	22571
1567	258	22099	72	93	0	22522
1568	146	21791	59	79	0	22075
1569	21030	237	40	60	0	21367
1570	174	143	47	20710	0	21074
1571	20544	65	51	165	0	20825
1572	154	20472	59	158	0	20843
1573	20394	153	69	72	0	20688
1574	159	128	20110	62	0	20459
1575	137	71	20180	72	0	20460
1576	67	67	259	19749	0	20142
1577	50	67	20501	157	0	20775
1578	48	60	159	19553	0	19820
1579	62	44	144	19471	0	19721
1580	62	47	20397	234	0	20740
1581	56	52	156	20170	0	20434
1582	52	47	154	21005	0	21258
1583	55	48	21641	254	0	21998
1584	41	42	21481	160	0	21724
1585	20515	30	297	77	0	20919
1586	185	41	22142	65	0	22433
1587	21753	45	282	59	0	22139
1588	23505	30	152	56	0	23743
1589	328	38	24269	52	0	24687
1590	213	31	24901	36	0	25181
1591	72	151	427	23577	0	24227
1592	62	33	203	22764	0	23062
1593	43	24064	86	345	0	24538
1594	31	24781	79	219	0	25110
1595	51	344	23968	64	0	24427
1596	22867	174	238	79	0	23358
1597	23686	53	213	58	0	24010
1598	391	39	23407	75	0	23912
1599	206	33	23651	45	0	23935
1600	71	43	389	22252	0	22755
1601	52	23887	224	215	0	24378
1602	66	213	69	23760	0	24108
1603	57	173	55	24149	0	24434
1604	24081	59	57	373	0	24570
1605	23876	43	58	207	0	24184
1606	386	27	64	24282	0	24759
1607	229	58	24501	243	0	25031
1608	23037	36	248	221	0	23542
1609	220	24836	215	90	0	25361
1610	25063	212	98	64	0	25437
1611	24259	170	62	83	0	24574
1612	344	24820	83	72	0	25319
1613	209	25106	74	95	0	25484
1614	99	355	69	24784	0	25307
1615	70	201	75	24674	0	25020
1616	62	24914	81	411	0	25468
1617	76	238	48	24712	0	25074
1618	91	191	72	24891	0	25245
1619	80	76	24670	407	0	25233
1620	23842	38	265	244	0	24389
1621	24795	32	230	102	0	25159
1622	25005	30	111	70	0	25216
1623	450	49	88	24340	0	24927
1624	23738	29	98	254	0	24119
1625	289	23663	119	224	0	24295
1626	225	280	66	21753	0	22324
1627	78	23141	113	243	0	23575
1628	65	23580	103	194	0	23942
1629	23337	329	113	128	0	23907
1630	23356	188	116	90	0	23750
1631	23086	63	91	76	0	23316
1632	23056	53	54	90	0	23253
1633	22932	49	73	74	0	23128
1634	407	73	22661	48	0	23189
1635	22311	54	242	67	0	22674
1636	290	71	22811	58	0	23230
1637	22036	47	260	81	0	22424
1638	22150	48	182	90	0	22470
1639	21762	51	114	93	0	22020
1640	386	66	22297	65	0	22814
1641	260	117	244	20337	0	20958
1642	93	22550	221	192	0	23056
1643	22670	210	122	196	0	23198
1644	22165	168	88	92	0	22513
1645	407	22404	106	169	0	23086
1646	22698	217	105	87	0	23107
1647	302	165	77	21611	0	22155
1648	221	22733	107	250	0	23311
1649	22437	225	88	201	0	22951
1650	22301	178	84	118	0	22681
1651	426	77	87	22168	0	22758
1652	22386	64	113	247	0	22810
1653	337	64	102	22533	0	23036
1654	261	70	107	22667	0	23105
1655	184	70	22601	382	0	23237
1656	150	88	238	22209	0	22685
1657	138	102	196	22417	0	22853
1658	128	106	22286	386	0	22906
1659	112	82	21166	195	0	21555
1660	132	67	322	20806	0	21327
1661	128	60	21120	229	0	21537
1662	19319	58	230	208	0	19815
1663	229	20885	179	112	0	21405
1664	197	209	82	20343	0	20831
1665	124	144	43	20849	0	21160
1666	111	74	30	20965	0	21180
1667	20794	53	41	334	0	21222
1668	20813	46	33	197	0	21089
1669	21023	64	44	112	0	21243
1670	360	21007	57	121	0	21545
1671	242	185	32	21022	0	21481
1672	136	177	36	21247	0	21596
1673	21139	74	36	304	0	21553
1674	21118	63	34	192	0	21407
1675	372	86	49	20932	0	21439
1676	232	89	20991	227	0	21539
1677	20638	56	187	173	0	21054
1678	21240	63	128	99	0	21530
1679	374	78	21319	73	0	21844
1680	19670	42	182	117	0	20011
1681	263	44	20923	108	0	21338
1682	19556	24	221	67	0	19868
1683	277	234	155	20203	0	20869
1684	196	21867	64	206	0	22333
1685	160	182	22779	135	0	23256
1686	100	22786	216	85	0	23187
1687	85	21782	147	72	0	22086
1688	20397	365	256	201	0	21219
1689	217	104	87	19953	0	20361
1690	77	14	14	19635	0	19740
1691	20510	5	15	189	0	20719
1692	119	7	11	20926	0	21063
1693	86	15	22	21018	0	21141
1694	32	13	13	20957	0	21015
1695	20	10	14	20857	0	20901
1696	32	29	20859	165	0	21085
1697	43	25	20573	82	0	20723
1698	30	20857	151	33	0	21071
1699	21220	96	72	54	0	21442
1700	109	68	18	21422	0	21617
1701	82	22068	23	113	0	22286
1702	39	134	11	22948	0	23132
1703	34	74	17	23113	0	23238
1704	37	25	18	23273	0	23353
1705	30	12	13	23589	0	23644
1706	33	21	15	23392	0	23461
1707	40	23231	27	179	0	23477
1708	42	99	17	23498	0	23656
1709	35	76	23027	139	0	23277
1710	22	23228	103	177	0	23530
1711	38	111	68	23276	0	23493
1712	46	83	23	23011	0	23163
1713	20	23027	26	187	0	23260
1714	30	23271	30	130	0	23461
1715	22671	159	27	44	0	22901
1716	87	23087	22	67	0	23263
1717	22599	103	34	47	0	22783
1718	22265	70	38	60	0	22433
1719	158	34	24421	42	0	24655
1720	88	18	94	23118	0	23318
1721	26	44	25253	145	0	25468
1722	21	26166	110	153	0	26450
1723	19	149	65	25726	0	25959
1724	27	76	21	26739	0	26863
1725	34	26	14	27089	0	27163
1726	23	31	19	27465	0	27538
1727	45	39	28071	195	0	28350
1728	39	16	111	27810	0	27976
1729	39	39	28830	139	0	29047
1730	47	43	28943	89	0	29122
1731	27290	21	247	92	0	27650
1732	28933	20	938	64	0	29955
1733	30037	28	22	60	0	30147
1734	183	29982	32	78	0	30275
1735	98	123	21	30096	0	30338
1736	63	111	31880	141	0	32195
1737	32	24	127	31524	0	31707
1738	58	52	33919	158	0	34187
1739	33320	30	123	156	0	33629
1740	34220	28	88	42	0	34378
1741	34227	19	31	68	0	34345
1742	212	43	33851	34	0	34140
1743	118	61	34577	36	0	34792
1744	47	16	201	34787	0	35051
1745	32	21	93	35642	0	35788
1746	26	26	17	36094	0	36163
1747	53	30	36551	202	0	36836
1748	40	49	34973	114	0	35176
1749	34953	33	198	70	0	35254
1750	133	22	94	37333	0	37582
1751	97	18	23	37639	0	37777
1752	38612	8	21	256	0	38897
1753	139	10	28	38461	0	38638
1754	42554	23	29	265	0	42871
1755	44640	19	26	194	0	44879
1756	44444	18	38	112	0	44612
1757	231	50	46318	74	0	46673
1758	100	46767	143	106	0	47116
1759	49352	106	98	153	0	49709
1760	140	96	28	49763	0	50027
1761	127	26	27	49040	0	49220
1762	24	50786	58	247	0	51115
1763	50693	115	19	158	0	50985
1764	51317	94	26	115	0	51552
1765	52172	20	23	101	0	52316
1766	205	53786	67	82	0	54140
1767	57312	134	27	148	0	57621
1768	57938	95	32	100	0	58165
1769	58442	28	23	100	0	58593
1770	232	19	17	57766	0	58034
1771	123	28	30	58509	0	58690
1772	90	95	61520	272	0	61977
1773	63	21	134	60111	0	60329
1774	54	18	108	61737	0	61917
1775	88	80	61824	246	0	62238
1776	57972	31	134	194	0	58331
1777	62210	21	106	100	0	62437
1778	249	59	31	61541	0	61880
1779	141	61918	62	163	0	62284
1780	76	62565	74	163	0	62878
1781	69	329	45	61968	0	62411
1782	97	165	61565	189	0	62016
1783	104	126	112	58884	0	59226
1784	84	89	62034	131	0	62338
1785	93	90	65674	121	0	65978
1786	59	23	121	66872	0	67075
1787	68484	18	83	133	0	68718
1788	68282	18	34	189	0	68523
1789	143	27	23	72215	0	72408
1790	118	10	33	74539	0	74700
1791	49	26	47	74854	0	74976
1792	47	25	30	75802	0	75904
1793	76773	10	44	241	0	77068
1794	75914	30	58	180	0	76182
1795	76161	35	52	120	0	76368
1796	195	90	77437	70	0	77792
1797	137	13	73	76545	0	76768
1798	69	26	82	79277	0	79454
1799	79615	13	45	229	0	79902
1800	128	80664	97	176	0	81065
1801	81997	69	44	170	0	82280
1802	81839	86	37	117	0	82079
1803	81832	28	38	93	0	81991
1804	81950	22	57	85	0	82114
1805	262	108	88563	47	0	88980
1806	205	127	85730	61	0	86123
1807	91173	27	208	165	0	91573
1808	94038	28	116	132	0	94314
1809	93917	27	43	100	0	94087
1810	95537	33	47	166	0	95783
1811	306	113	102744	92	0	103255
1812	168	107918	252	142	0	108480
1813	345	253	171	114672	0	115441
1814	127848	199	119	625	0	128791
1815	130406	89	54	402	0	130951
1816	137007	33	55	228	0	137323
1817	138786	43	56	178	0	139063
1818	139039	39	49	166	0	139293
1819	135327	58	218	198	0	135801
1820	1118	177	134723	123	0	136141
1821	595	172	135784	51	0	136602
1822	245	233	726	132718	0	133922
1823	246	166	138464	536	0	139412
1824	153	136933	593	460	0	138139
1825	166	144391	522	232	0	145311
1826	333	978	169	144396	0	145876
1827	245	524	156703	512	0	157984
1828	202	258	152453	454	0	153367
1829	148206	107	919	253	0	149485
1830	167527	94	457	238	0	168316
1831	1183	65	139	171525	0	172912
1832	175096	55	134	1043	0	176328
1833	1041	76	131	174744	0	175992
1834	626	58	93	175964	0	176741
1835	317	203	183503	1468	0	185491
1836	297	224	181217	664	0	182402
1837	190	83	1455	180772	0	182500
1838	330	230	183950	1087	0	185597
1839	168784	52	1097	832	0	170765
1840	185193	77	671	405	0	186346
1841	1517	194567	304	448	0	196836
1842	195608	967	160	326	0	197061
1843	1302	763	195345	231	0	197641
1844	190652	116	1149	243	0	192160
1845	197167	58	690	315	0	198230
1846	198998	68	259	352	0	199677
1847	1885	192	261	193681	0	196019
1848	871	201163	398	1219	0	203651
1849	202282	1070	242	853	0	204447
1850	202737	636	223	345	0	203941
1851	1959	318	228	206912	0	209417
1852	207670	94	202	1429	0	209395
1853	1607	216604	380	1091	0	219682
1854	1141	1457	180	214426	0	217204
1855	688	986	215212	1575	0	218461
1856	180532	290	1713	1473	0	184008
1857	1838	308	215989	513	0	218648
1858	1354	251	1640	210323	0	213568
1859	512	216744	1197	1618	0	220071
1860	482	229920	545	1379	0	232326
1861	688	2808	346	227080	0	230922
1862	605	241924	462	2094	0	245085
1863	700	2628	368	283009	0	286705
1864	703	1440	347	293861	0	296351
1865	705	538	335	298620	0	300198
1866	286155	400	364	5271	0	292190
1867	3756	351	343	292246	0	296696
1868	2508	530	288829	3989	0	295856
1869	899	289309	3548	2565	0	296321
1870	284911	3409	1861	985	0	291166
1871	3857	1971	458	287261	0	293547
1872	2467	590	372	291107	0	294536
1873	1012	433	328	295521	0	297294
1874	1141	726	290210	5715	0	297792
1875	753	290813	3825	2963	0	298354
1876	287142	3566	2065	1161	0	293934
1877	3821	2317	763	267143	0	274044
1878	2246	293370	779	3740	0	300135
1879	290709	3659	624	2609	0	297601
1880	4047	2242	290710	1194	0	298193
1881	280973	780	3929	1200	0	286882
1882	4332	917	294675	1052	0	300976
1883	2715	947	293461	1063	0	298186
1884	1036	289944	5527	1799	0	298306
1885	1251	3791	2343	279244	0	286629
1886	1232	2569	284399	4295	0	292495
1887	927	276069	4139	3338	0	284473
1888	1046	3838	2557	263934	0	271375
1889	955	275978	1188	4191	0	282312
1890	1139	4103	272352	2798	0	280392
1891	977	2489	3992	265130	0	272588
1892	1128	1210	276273	4547	0	283158
1893	1219	1005	4139	267769	0	274132
1894	1205	826	2567	275363	0	279961
1895	1256	1115	272799	6256	0	281426
1896	1153	911	4347	268565	0	274976
1897	262715	845	2776	4981	0	271317
1898	3944	266498	1619	4379	0	276440
1899	3043	4233	265171	2099	0	274546
1900	253885	2541	4325	2000	0	262751
1901	4498	1246	2839	250199	0	258782
1902	2862	265467	1373	4428	0	274130
1903	265149	4232	1297	3242	0	273920
1904	266255	2880	1337	1872	0	272344
1905	6081	1456	1272	254488	0	263297
1906	3160	1325	1126	258969	0	264580
1907	1409	1189	1244	260004	0	263846
1908	1231	1334	1184	253943	0	257692
1909	1333	253260	1473	7338	0	263404
1910	1668	6333	1402	231649	0	241052
1911	1368	243400	1339	5149	0	251256
1912	1456	240095	1409	4239	0	247199
1913	1188	235174	1629	2657	0	240648
1914	2270	6086	213271	2328	0	223955
1915	1361	222483	4479	2362	0	230685
1916	205861	4589	3527	2485	0	216462
1917	3977	212446	1541	3071	0	221035
1918	2959	4251	1516	188809	0	197535
1919	1620	212388	1713	5310	0	221031
1920	1584	4582	1451	206742	0	214359
1921	1682	3292	1654	211265	0	217893
1922	1741	2268	207258	6813	0	218080
1923	190150	2125	4572	4260	0	201107
1924	204032	1962	2924	2982	0	211900
1925	198745	2008	1868	2833	0	205454
1926	5707	197874	2135	3474	0	209190
1927	3006	4545	2007	187404	0	196962
1928	1960	3442	186453	5797	0	197652
1929	1629	184778	4860	4519	0	195786
1930	1999	5291	3178	147881	0	158349
1931	1540	170657	1966	4095	0	178258
1932	166816	4363	1849	3297	0	176325
1933	168262	3226	1793	2322	0	175603
1934	169593	2010	1815	2184	0	175602
1935	165227	1850	2136	2082	0	171295
1936	5484	1555	2257	159189	0	168485
1937	2936	1883	2153	154830	0	161802
1938	1634	158950	2293	5553	0	168430
1939	1742	4050	1847	159776	0	167415
1940	1494	3117	155785	4896	0	165292
1941	1296	1893	3926	149979	0	157094
1942	1318	2131	149064	4802	0	157315
1943	1171	145219	4174	3897	0	154461
1944	1347	4301	146668	2545	0	154861
1945	1392	3213	4443	143194	0	152242
1946	1387	2066	146353	4727	0	154533
1947	1444	1800	4143	142025	0	149412
1948	1464	1801	3023	141977	0	148265
1949	1745	1689	1713	141619	0	146766
1950	1914	1748	1648	140719	0	146029
1951	132512	1619	1337	5640	0	141108
1952	3471	133755	1475	3568	0	142269
1953	123907	3669	1163	2513	0	131252
1954	3259	2638	121633	2345	0	129875
1955	117017	1683	3195	2190	0	124085
1956	119989	1584	1990	2287	0	125850
1957	4836	1781	117173	2032	0	125822
1958	3654	1629	112513	1880	0	119676
1959	1816	110302	3652	2205	0	117975
1960	1341	99875	1860	2057	0	105133
1961	2714	3638	89643	2286	0	98281
1962	1276	75756	2502	2619	0	82153
1963	1954	2940	1912	30966	0	37772
1964	27077	338	660	411	0	28486
1965	252	125	88	26748	0	27213
1966	27215	110	49	239	0	27613
1967	27120	112	51	212	0	27495
1968	276	28467	64	144	0	28951
1969	28041	185	48	127	0	28401
1970	27980	160	47	132	0	28319
1971	248	147	37	27675	0	28107
1972	28230	88	39	240	0	28597
1973	180	29248	38	200	0	29666
1974	144	190	42	28901	0	29277
1975	29097	151	39	215	0	29502
1976	161	114	29387	168	0	29830
1977	28549	52	157	101	0	28859
1978	171	159	134	29554	0	30018
1979	145	70	30354	125	0	30694
1980	91	66	30045	131	0	30333
1981	28837	135	253	96	0	29321
1982	30260	28	159	78	0	30525
1983	182	21	27	30467	0	30697
1984	125	23	26	30847	0	31021
1985	55	27	16	30418	0	30516
1986	29	31397	41	217	0	31684
1987	31798	100	28	157	0	32083
1988	110	32287	23	93	0	32513
1989	31930	125	60	52	0	32167
1990	149	112	32139	51	0	32451
1991	109	35	104	32165	0	32413
1992	33435	35	89	140	0	33699
1993	130	13	43	33536	0	33722
1994	125	39	40	32856	0	33060
1995	66	33373	37	220	0	33696
1996	33217	113	27	136	0	33493
1997	103	35421	37	86	0	35647
1998	125	152	25	36056	0	36358
1999	69	123	35908	152	0	36252
2000	30581	46	158	192	0	30977
2001	162	34	35885	78	0	36159
2002	32134	44	155	73	0	32406
2003	156	36588	117	81	0	36942
2004	114	166	33	34816	0	35129
2005	52	36829	54	159	0	37094
2006	36817	161	38	147	0	37163
2007	177	128	28	37514	0	37847
2008	156	36	29	38188	0	38409
2009	83	60	37481	286	0	37910
2010	33059	24	183	242	0	33508
2011	191	28	143	38100	0	38462
2012	179	50	37743	211	0	38183
2013	68	37897	187	218	0	38370
2014	64	193	138	37898	0	38293
2015	38462	142	57	213	0	38874
2016	203	65	24	38721	0	39013
2017	171	52	39202	228	0	39653
2018	39094	34	185	179	0	39492
2019	237	32	146	40892	0	41307
2020	215	64	44462	245	0	44986
2021	117	32	250	44850	0	45249
2022	95	55	223	43964	0	44337
2023	74	46156	82	467	0	46779
2024	45190	274	38	256	0	45758
2025	262	46345	57	137	0	46801
2026	46300	285	52	102	0	46739
2027	318	231	53	45191	0	45793
2028	264	46776	63	324	0	47427
2029	113	287	29	46641	0	47070
2030	79	244	45964	359	0	46646
2031	43138	79	290	291	0	43798
2032	344	47	224	44758	0	45373
2033	280	49	79	44432	0	44840
2034	113	42	43	44975	0	45173
2035	97	66	44272	530	0	44965
2036	142	57	44070	339	0	44608
2037	78	44516	490	223	0	45307
2038	84	288	256	43530	0	44158
2039	43563	224	78	324	0	44189
2040	283	44839	78	326	0	45526
2041	286	321	65	45935	0	46607
2042	46727	251	50	373	0	47401
2043	46252	85	66	318	0	46721
2044	561	47347	71	190	0	48169
2045	50622	351	75	151	0	51199
2046	54152	292	62	161	0	54667
2047	778	109	45	55838	0	56770
2048	453	57035	97	594	0	58179
2049	175	519	63	58018	0	58775
2050	56907	436	60	669	0	58072
2051	636	190	58232	529	0	59587
2052	542	84	543	57509	0	58678
2053	196	82	456	58204	0	58938
2054	184	154	58348	1015	0	59701
2055	136	101	551	57958	0	58746
2056	57876	120	512	717	0	59225
2057	55396	99	173	604	0	56272
2058	951	93	106	57230	0	58380
2059	579	95	57368	745	0	58787
2060	232	128	55862	633	0	56855
2061	161	56320	986	362	0	57829
2062	212	57275	583	276	0	58346
2063	246	969	174	55235	0	56624
2064	54786	517	154	674	0	56131
2065	551	55629	181	611	0	56972
2066	54740	591	141	251	0	55723
2067	631	524	143	54048	0	55346
2068	546	208	116	53759	0	54629
2069	52205	143	108	1055	0	53511
2070	631	52993	132	681	0	54437
2071	52936	610	111	318	0	53975
2072	722	529	51480	239	0	52970
2073	570	208	50546	239	0	51563
2074	298	207	931	48410	0	49846
2075	235	168	50391	669	0	51463
2076	213	161	49450	564	0	50388
2077	247	145	988	45645	0	47025
2078	202	141	48257	691	0	49291
2079	188	110	691	46129	0	47118
2080	181	111	537	46523	0	47352
2081	221	159	46883	1042	0	48305
2082	188	128	681	45080	0	46077
2083	175	125	552	43589	0	44441
2084	151	45075	300	1055	0	46581
2085	44637	564	202	681	0	46084
2086	608	519	44894	377	0	46398
2087	545	173	645	43788	0	45151
2088	246	150	542	44693	0	45631
2089	194	141	44008	1113	0	45456
2090	39469	161	641	728	0	40999
2091	607	42975	564	839	0	44985
2092	536	593	254	42511	0	43894
2093	245	548	194	41783	0	42770
2094	206	42887	222	1086	0	44401
2095	298	626	42233	701	0	43858
2096	193	43061	661	414	0	44329
2097	40360	688	581	352	0	41981
2098	619	528	40378	312	0	41837
2099	530	326	618	39083	0	40557
2100	251	204	40667	727	0	41849
2101	271	191	40422	645	0	41529
2102	236	39731	972	356	0	41295
2103	403	597	638	37324	0	38962
2104	37663	508	278	650	0	39099
2105	37576	187	229	644	0	38636
2106	876	37938	298	366	0	39478
2107	535	555	246	37419	0	38755
2108	37372	478	222	668	0	38740
2109	37573	170	237	605	0	38585
2110	880	37611	252	382	0	39125
2111	37764	491	215	331	0	38801
2112	671	455	197	36187	0	37510
2113	549	37700	211	712	0	39172
2114	290	545	218	38163	0	39216
2115	259	516	235	37784	0	38794
2116	249	378	214	38127	0	38968
2117	250	210	37098	1008	0	38566
2118	209	234	34891	623	0	35957
2119	181	34784	803	396	0	36164
2120	30511	437	556	299	0	31803
2121	443	30446	237	278	0	31404
2122	421	456	183	29477	0	30537
2123	203	365	30514	563	0	31645
2124	163	188	503	29796	0	30650
2125	155	186	417	30331	0	31089
2126	154	187	206	30603	0	31150
2127	29845	186	175	762	0	30968
2128	427	154	196	30095	0	30872
2129	343	182	31300	565	0	32390
2130	29966	123	470	557	0	31116
2131	30951	125	451	305	0	31832
2132	31506	106	230	297	0	32139
2133	31563	106	189	264	0	32122
2134	31349	81	193	293	0	31916
2135	729	30988	240	274	0	32231
2136	469	376	165	29037	0	30047
2137	224	30722	201	498	0	31645
2138	30336	396	160	438	0	31330
2139	30029	336	153	240	0	30758
2140	28774	171	160	201	0	29306
2141	661	27796	157	199	0	28813
2142	388	26853	169	194	0	27604
2143	184	27131	140	189	0	27644
2144	303	639	26058	204	0	27204
2145	339	2302	443	19607	0	22691
2146	77	17267	161	183	0	17688
2147	13	15033	34	68	0	15148
2148	67	71	29	14686	0	14853
2149	17	34	15	14733	0	14799
2150	15	24	15005	86	0	15130
2151	14812	11	49	69	0	14941
2152	54	13	44	16207	0	16318
2153	48	13	12	16265	0	16338
2154	14	20	16162	97	0	16293
2155	23	33	15979	56	0	16091
2156	17	17004	98	20	0	17139
2157	18	61	42	17145	0	17266
2158	23	46	12	17355	0	17436
2159	26	26	17269	92	0	17413
2160	15960	22	72	66	0	16120
2161	17634	15	39	28	0	17716
2162	105	25	18479	26	0	18635
2163	18369	6	69	31	0	18475
2164	91	29	19174	13	0	19307
2165	18918	14	72	22	0	19026
2166	19497	11	58	18	0	19584
2167	145	17	20405	18	0	20585
2168	76	12	74	20451	0	20613
2169	25	27	67	21642	0	21761
2170	34	12	9	22122	0	22177
2171	22080	15	22	177	0	22294
2172	22051	20	14	99	0	22184
2173	183	28	23389	45	0	23645
2174	107	36	23213	25	0	23381
2175	23730	13	204	43	0	23990
2176	24610	18	111	37	0	24776
2177	196	26	24509	56	0	24787
2178	120	27	24817	31	0	24995
2179	39	11	195	24858	0	25103
2180	49	29	25902	134	0	26114
2181	32	12	119	25128	0	25291
2182	26563	27	146	137	0	26873
2183	146	27	28239	119	0	28531
2184	27003	17	153	47	0	27220
2185	170	28	31138	41	0	31377
2186	162	10	172	30521	0	30865
2187	51	10	160	32323	0	32544
2188	48	15	32	32085	0	32180
2189	38	33062	50	329	0	33479
2190	62	163	23	32425	0	32673
2191	59	152	23	33149	0	33383
2192	32834	22	49	333	0	33238
2193	225	22	32760	150	0	33157
2194	30669	14	187	45	0	30915
2195	220	25	32826	29	0	33100
2196	27584	23	205	116	0	27928
2197	199	31906	186	95	0	32386
2198	203	171	32338	41	0	32753
2199	74	164	32229	44	0	32511
2200	85	166	344	29143	0	29738
2201	44	36	170	31336	0	31586
2202	50	31	32038	297	0	32416
2203	69	27	32050	164	0	32310
2204	87	31	33655	34	0	33807
2205	32774	14	355	64	0	33207
2206	33641	9	177	50	0	33877
2207	33734	16	49	47	0	33846
2208	302	10	55	33197	0	33564
2209	185	10	51	33429	0	33675
2210	54	31	34360	325	0	34770
2211	62	15	191	33567	0	33835
2212	44	10	189	33699	0	33942
2213	33760	6	63	346	0	34175
2214	33447	17	53	199	0	33716
2215	34022	18	54	73	0	34167
2216	360	14	54	33716	0	34144
2217	188	16	57	33748	0	34009
2218	67	11	59	33766	0	33903
2219	33517	15	57	353	0	33942
2220	227	35	55	31339	0	31656
2221	189	33489	84	198	0	33960
2222	94	160	66	31200	0	31520
2223	63	32730	84	186	0	33063
2224	32621	162	86	160	0	33029
2225	31177	155	78	75	0	31485
2226	326	32662	92	94	0	33174
2227	185	33038	108	88	0	33419
2228	81	342	84	32451	0	32958
2229	82	171	31726	236	0	32215
2230	79	25	229	30767	0	31100
2231	76	34	32006	259	0	32375
2232	83	32200	249	281	0	32813
2233	83	172	206	32151	0	32612
2234	100	169	77	32490	0	32836
2235	94	41	33521	390	0	34046
2236	97	364	222	32609	0	33292
2237	92	44	34159	273	0	34568
2238	33061	36	232	280	0	33609
2239	34264	29	220	112	0	34625
2240	34639	25	87	127	0	34878
2241	404	54	70	34115	0	34643
2242	248	34	92	34221	0	34595
2243	128	57	35025	401	0	35611
2244	131	178	255	32783	0	33347
2245	91	34433	271	335	0	35130
2246	108	208	34705	271	0	35292
2247	106	189	33713	126	0	34134
2248	119	175	403	30866	0	31563
2249	106	76	34108	261	0	34551
2250	105	75	33773	271	0	34224
2251	30508	67	364	174	0	31113
2252	222	36085	234	191	0	36732
2253	37213	181	101	185	0	37680
2254	37022	167	93	176	0	37458
2255	37460	53	116	164	0	37793
2256	382	45	103	37117	0	37647
2257	260	40	96	37667	0	38063
2258	132	68	38103	385	0	38688
2259	149	34	237	36680	0	37100
2260	121	38472	271	275	0	39139
2261	37644	159	124	249	0	38176
2262	215	38235	132	155	0	38737
2263	213	38289	135	171	0	38808
2264	144	323	112	37893	0	38472
2265	120	178	39125	253	0	39676
2266	117	72	228	38307	0	38724
2267	130	58	38958	262	0	39408
2268	101	38269	244	308	0	38922
2269	37468	154	209	137	0	37968
2270	37609	126	79	132	0	37946
2271	38733	53	84	184	0	39054
2272	301	78	42045	131	0	42555
2273	219	86	40047	122	0	40474
2274	41256	23	269	178	0	41726
2275	42600	28	192	164	0	42984
2276	43315	34	63	163	0	43575
2277	286	50	45	42781	0	43162
2278	187	47	48	43496	0	43778
2279	43396	25	55	312	0	43788
2280	42662	30	67	212	0	42971
2281	272	82	45401	130	0	45885
2282	146	74	43888	89	0	44197
2283	42220	49	172	118	0	42559
2284	147	44	44778	95	0	45064
2285	41283	22	101	89	0	41495
2286	111	67	43495	57	0	43730
2287	76	86	83	41258	0	41503
2288	87	75	45884	91	0	46137
2289	65	38	52	47203	0	47358
2290	28	34	55	47957	0	48074
2291	38	51286	64	191	0	51579
2292	50695	28	51	122	0	50896
2293	68	94	52857	50	0	53069
2294	49093	26	59	96	0	49274
2295	41	55045	72	99	0	55257
2296	58272	36	61	119	0	58488
2297	74	39	20	58333	0	58466
2298	91	24	24	59258	0	59397
2299	28	63562	68	190	0	63848
2300	56	86	22	66703	0	66867
2301	54	89	21	67492	0	67656
2302	33	29	15	68683	0	68760
2303	67386	18	20	363	0	67787
2304	64814	22	23	230	0	65089
2305	339	71	66104	91	0	66605
2306	161	67913	203	173	0	68450
2307	57	176	152	69344	0	69729
2308	57	182	27	71301	0	71567
2309	71	84	72621	367	0	73143
2310	47	39	213	70922	0	71221
2311	72548	17	197	305	0	73067
2312	73026	25	34	270	0	73355
2313	74401	28	45	150	0	74624
2314	424	34	35	76676	0	77169
2315	85090	36	43	497	0	85666
2316	85585	17	45	371	0	86018
2317	88067	24	33	215	0	88339
2318	524	41	49	88193	0	88807
2319	292	28	42	89798	0	90160
2320	125	33	19	90520	0	90697
2321	102	39	32	89568	0	89741
2322	104	27	35	89901	0	90067
2323	105	111	89141	540	0	89897
2324	173	123	88839	328	0	89463
2325	99	89631	513	236	0	90479
2326	122	256	245	91034	0	91657
2327	108	224	47	91962	0	92341
2328	99	69	34	92583	0	92785
2329	124	174	92364	604	0	93266
2330	139	69	273	90554	0	91035
2331	129	127	93373	379	0	94008
2332	93	55	321	92372	0	92841
2333	221	148	103883	439	0	104691
2334	77	105465	418	709	0	106669
2335	128	366	260	106587	0	107341
2336	156	347	106265	472	0	107240
2337	89971	78	403	588	0	91040
2338	321	110801	355	340	0	111817
2339	354	320	85	111307	0	112066
2340	83	113087	119	479	0	113768
2341	108	399	57	113447	0	114011
2342	114910	261	79	482	0	115732
2343	385	98	63	114281	0	114827
2344	315	117007	163	523	0	118008
2345	117714	322	72	473	0	118581
2346	404	299	85	120351	0	121139
2347	366	272	67	122769	0	123474
2348	125224	68	71	918	0	126281
2349	525	73	62	134745	0	135405
2350	561	44	61	159666	0	160332
2351	340	202	166043	2005	0	168590
2352	273	245	166868	912	0	168298
2353	164	83	2366	165925	0	168538
2354	284	194	170527	1697	0	172702
2355	291	219	167230	1016	0	168756
2356	152106	89	2616	577	0	155388
2357	1893	181	176439	383	0	178896
2358	936	176581	2034	3001	0	182552
2359	360	1741	1043	180099	0	183243
2360	186504	883	316	1906	0	189609
2361	188384	211	258	1209	0	190062
2362	186967	156	212	542	0	187877
2363	2785	190690	442	537	0	194454
2364	1376	1893	243	188433	0	191945
2365	483	1068	243	192423	0	194217
2366	188594	254	321	3066	0	192235
2367	190289	152	263	1499	0	192203
2368	190567	146	277	703	0	191693
2369	3137	420	193314	533	0	197404
2370	1391	193107	2340	689	0	197527
2371	550	210702	1620	774	0	213646
2372	558	3571	612	205467	0	210208
2373	468	1654	418	211626	0	214166
2374	611	559	212659	4025	0	217854
2375	200941	280	2984	2058	0	206263
2376	213830	280	1706	743	0	216559
2377	4217	352	611	213208	0	218388
2378	2060	352	359	214963	0	217734
2379	920	233	290	216861	0	218304
2380	213696	206	517	4493	0	218912
2381	3332	414	211898	2041	0	217685
2382	2085	515	212386	910	0	215896
2383	837	362	4218	206499	0	211916
2384	697	437	212499	3248	0	216881
2385	202196	284	3179	2255	0	207914
2386	209404	291	1853	1019	0	212567
2387	211021	170	701	879	0	212771
2388	4511	206267	802	940	0	212520
2389	204991	2839	539	720	0	209089
2390	3331	1814	462	202309	0	207916
2391	2049	582	526	201993	0	205150
2392	946	302	558	206497	0	208303
2393	859	478	201601	4894	0	207832
2394	987	509	3208	190006	0	194710
2395	826	199360	2159	3419	0	205764
2396	191331	2749	869	2337	0	197286
2397	2943	197462	835	1795	0	203035
2398	2489	3127	194060	1273	0	200949
2399	1088	194116	3236	1250	0	199690
2400	185225	3042	2408	1139	0	191814
2401	3004	188991	1335	1263	0	194593
2402	2327	3059	1147	163815	0	170348
2403	962	188124	1075	2863	0	193024
2404	186530	2902	1062	1954	0	192448
2405	186730	1744	982	1089	0	190545
2406	179787	809	1147	1085	0	182828
2407	4816	875	184766	871	0	191328
2408	2659	846	183757	856	0	188118
2409	1474	955	182703	1216	0	186348
2410	178278	716	4737	1238	0	184969
2411	3586	769	2400	178507	0	185262
2412	2494	625	1203	180361	0	184683
2413	1416	905	178973	4702	0	185996
2414	1300	861	3344	176433	0	181938
2415	169283	816	2205	3826	0	176130
2416	3590	169801	1402	2777	0	177570
2417	171216	3145	1034	1297	0	176692
2418	4253	2334	168491	986	0	176064
2419	168046	1158	3366	1034	0	173604
2420	170831	1122	2209	1117	0	175279
2421	171560	1090	1210	1213	0	175073
2422	5256	1101	167449	1362	0	175168
2423	3335	769	3243	165024	0	172371
2424	2240	724	168033	3574	0	174571
2425	2158	676	3461	166290	0	172585
2426	1991	812	167986	3667	0	174456
2427	1907	757	3647	162885	0	169196
2428	1600	715	2354	167584	0	172253
2429	165854	627	1312	4975	0	172768
2430	165187	605	1235	2822	0	169849
2431	166032	523	1360	1718	0	169633
2432	5217	537	1434	155470	0	162658
2433	2848	148568	1428	3636	0	156480
2434	1787	153036	1283	2786	0	158892
2435	150875	3960	935	1651	0	157421
2436	4069	2179	148814	1295	0	156357
2437	148023	874	3396	1354	0	153647
2438	4198	912	147296	1232	0	153638
2439	146512	742	3545	1385	0	152184
2440	145300	653	2332	1491	0	149776
2441	4956	627	146553	1519	0	153655
2442	144526	510	3507	1598	0	150141
2443	145473	561	2481	1342	0	149857
2444	144478	673	1549	1216	0	147916
2445	5241	143461	1230	1398	0	151330
2446	3030	4879	1511	136560	0	145980
2447	1928	2021	138259	3437	0	145645
2448	1847	1097	137371	2300	0	142615
2449	1605	123635	3969	1339	0	130548
2450	1116	93681	1686	858	0	97341
2451	2592	1861	2102	80878	0	87433
2452	79123	884	848	1528	0	82383
2453	1666	80653	573	1276	0	84168
2454	1484	1399	477	76660	0	80020
2455	887	80721	434	1345	0	83387
2456	77623	1442	463	885	0	80413
2457	1713	1201	452	75802	0	79168
2458	1251	568	74311	1375	0	77505
2459	818	71415	1381	1018	0	74632
2460	660	70422	1003	575	0	72660
2461	775	1688	509	61273	0	64245
2462	647	67462	472	1089	0	69670
2463	628	1322	441	65398	0	67789
2464	65809	883	327	1261	0	68280
2465	65927	532	365	813	0	67637
2466	67277	373	420	497	0	68567
2467	67324	442	501	379	0	68646
2468	1882	468	67187	430	0	69967
2469	1051	63830	1195	438	0	66514
2470	599	62441	816	396	0	64252
2471	254	48310	242	238	0	49044
2472	221	46982	271	185	0	47659
2473	43064	713	1182	186	0	45145
2474	40274	261	208	106	0	40849
2475	40568	70	72	79	0	40789
2476	40705	70	41	73	0	40889
2477	558	76	40117	41	0	40792
2478	42180	51	308	111	0	42650
2479	43129	52	238	70	0	43489
2480	43462	49	68	63	0	43642
2481	599	51	49	42795	0	43494
2482	330	48	50	43244	0	43672
2483	43504	48	42	537	0	44131
2484	369	66	44	42583	0	43062
2485	296	42882	73	357	0	43608
2486	128	317	54	43303	0	43802
2487	106	246	50	42854	0	43256
2488	90	44105	58	537	0	44790
2489	98	323	40	43993	0	44454
2490	122	247	48	44343	0	44760
2491	43606	72	44	516	0	44238
2492	366	118	42530	265	0	43279
2493	41584	65	306	106	0	42061
2494	418	101	43162	89	0	43770
2495	317	90	42068	72	0	42547
2496	144	86	43029	76	0	43335
2497	41104	77	557	106	0	41844
2498	390	102	44899	78	0	45469
2499	43787	102	375	125	0	44389
2500	45233	59	245	114	0	45651
2501	45224	80	84	99	0	45487
2502	560	45415	72	97	0	46144
2503	45181	344	58	107	0	45690
2504	347	46581	61	130	0	47119
2505	286	379	50	46668	0	47383
2506	140	286	36	46180	0	46642
2507	123	47045	61	542	0	47771
2508	132	47486	86	322	0	48026
2509	139	48734	80	143	0	49096
2510	47940	531	64	105	0	48640
2511	406	49574	106	120	0	50206
2512	49736	362	74	103	0	50275
2513	460	305	48589	93	0	49447
2514	48420	122	330	96	0	48968
2515	50087	110	254	102	0	50553
2516	653	140	49171	150	0	50114
2517	418	103	320	48518	0	49359
2518	213	141	50558	406	0	51318
2519	191	112	342	49646	0	50291
2520	176	90	261	50650	0	51177
2521	50738	96	95	596	0	51525
2522	50507	97	76	349	0	51029
2523	600	50729	93	191	0	51613
2524	51775	368	68	146	0	52357
2525	503	328	52434	107	0	53372
2526	52040	127	379	153	0	52699
2527	534	137	56520	127	0	57318
2528	430	142	56978	103	0	57653
2529	57522	87	707	146	0	58462
2530	59662	92	406	120	0	60280
2531	808	142	61972	104	0	63026
2532	519	109	493	58536	0	59657
2533	242	119	363	62297	0	63021
2534	208	171	62000	727	0	63106
2535	234	154	475	59112	0	59975
2536	228	62032	398	528	0	63186
2537	283	486	130	63680	0	64579
2538	292	372	116	64059	0	64839
2539	300	187	63371	698	0	64556
2540	57000	128	498	485	0	58111
2541	62810	113	399	230	0	63552
2542	62831	110	166	163	0	63270
2543	62137	92	140	190	0	62559
2544	926	62071	180	199	0	63376
2545	628	456	133	60670	0	61887
2546	347	395	60490	554	0	61786
2547	326	207	61078	408	0	62019
2548	313	171	743	59102	0	60329
2549	249	169	61626	632	0	62676
2550	58646	81	554	499	0	59780
2551	527	90	370	61908	0	62895
2552	421	102	145	62560	0	63228
2553	224	100	122	63155	0	63601
2554	61881	78	142	848	0	62949
2555	495	63235	159	623	0	64512
2556	63032	437	140	281	0	63890
2557	63058	300	166	241	0	63765
2558	753	62763	221	242	0	63979
2559	487	63363	228	194	0	64272
2560	64935	595	231	170	0	65931
2561	622	338	217	64851	0	66028
2562	476	113	226	65145	0	65960
2563	67611	68	217	715	0	68611
2564	669	151	68323	367	0	69510
2565	66997	71	568	205	0	67841
2566	68634	93	415	169	0	69311
2567	898	71286	241	311	0	72736
2568	74866	465	122	192	0	75645
2569	73923	366	119	206	0	74614
2570	875	84515	156	253	0	85799
2571	402	86063	166	249	0	86880
2572	349	1072	124	83795	0	85340
2573	84039	501	92	792	0	85424
2574	711	87013	101	609	0	88434
2575	532	762	82	88178	0	89554
2576	88813	462	61	873	0	90209
2577	915	166	89687	562	0	91330
2578	600	72	807	88546	0	90025
2579	240	157	90681	877	0	91955
2580	85176	73	954	630	0	86833
2581	90248	65	566	251	0	91130
2582	1337	125	91119	176	0	92757
2583	638	90372	942	333	0	92285
2584	249	862	567	90704	0	92382
2585	243	602	92680	867	0	94392
2586	173	165	922	91157	0	92417
2587	207	88	562	94497	0	95354
2588	212	181	93787	1374	0	95554
2589	84860	115	977	799	0	86751
2590	92575	87	589	277	0	93528
2591	1482	218	94417	201	0	96318
2592	675	94713	998	466	0	96852
2593	329	924	599	89198	0	91050
2594	201	94279	269	918	0	95667
2595	195	95514	207	659	0	96575
2596	94756	1390	140	295	0	96581
2597	966	640	127	95185	0	96918
2598	668	209	119	94878	0	95874
2599	326	207	96409	1479	0	98421
2600	272	218	95599	767	0	96856
2601	261	130	1478	93795	0	95664
2602	276	130	740	96588	0	97734
2603	283	207	96438	1516	0	98444
2604	308	260	96383	796	0	97747
2605	234	182	1567	95163	0	97146
2606	96348	204	775	1152	0	98479
2607	1021	97654	321	1041	0	100037
2608	97075	1058	224	386	0	98743
2609	1140	98185	238	397	0	99960
2610	821	98841	275	393	0	100330
2611	96625	1600	205	335	0	98765
2612	1232	845	97402	298	0	99777
2613	860	248	1165	96052	0	98325
2614	347	227	817	98063	0	99454
2615	327	175	322	102302	0	103126
2616	331	255	101792	1860	0	104238
2617	334	246	1213	101006	0	102799
2618	102240	213	935	1422	0	104810
2619	1296	253	347	103374	0	105270
2620	953	188	239	106933	0	108313
2621	106500	216	295	2115	0	109126
2622	103993	210	267	1194	0	105664
2623	2003	105725	283	623	0	108634
2624	1108	1256	106360	355	0	109079
2625	463	929	104585	291	0	106268
2626	368	332	105526	373	0	106599
2627	255	100264	2131	460	0	103110
2628	566	1305	1338	95902	0	99111
2629	289	833	352	98370	0	99844
2630	97805	260	330	1938	0	100333
2631	1244	217	278	96217	0	97956
2632	988	312	95990	1457	0	98747
2633	371	202	1319	95671	0	97563
2634	287	220	952	95848	0	97307
2635	377	274	95474	2081	0	98206
2636	261	93912	1403	1248	0	96824
2637	448	1262	1017	80447	0	83174
2638	262	92669	506	1229	0	94666
2639	266	1293	91772	966	0	94297
2640	89061	878	1385	510	0	91834
2641	91236	326	1006	502	0	93070
2642	91935	261	437	444	0	93077
2643	2105	325	391	88259	0	91080
2644	1083	91383	398	1364	0	94228
2645	90672	1278	328	1064	0	93342
2646	90964	920	406	514	0	92804
2647	89333	312	411	513	0	90569
2648	2047	276	88405	565	0	91293
2649	83653	249	1327	532	0	85761
2650	1335	86528	1113	587	0	89563
2651	84644	1233	454	445	0	86776
2652	1352	85480	458	519	0	87809
2653	85358	1283	450	514	0	87605
2654	1503	940	84690	425	0	87558
2655	83081	285	1385	433	0	85184
2656	84118	284	915	455	0	85772
2657	80728	310	391	415	0	81844
2658	84887	309	332	357	0	85885
2659	2157	333	82950	421	0	85861
2660	1231	285	1351	80541	0	83408
2661	80088	288	1029	1362	0	82767
2662	1335	80219	524	1178	0	83256
2663	1066	1199	373	77630	0	80268
2664	530	884	76684	1388	0	79486
2665	533	806	1292	75291	0	77922
2666	559	300	76082	1433	0	78374
2667	389	72255	1377	1253	0	75274
2668	376	67242	1008	547	0	69173
2669	452	65817	402	462	0	67133
2670	678	1652	402	53508	0	56240
2671	392	639	229	53178	0	54438
2672	347	279	52077	1152	0	53855
2673	266	50424	726	715	0	52131
2674	46667	681	516	253	0	48117
2675	642	46009	224	263	0	47138
2676	505	45262	225	253	0	46245
2677	971	921	288	42834	0	45014
2678	42419	483	235	645	0	43782
2679	42575	187	175	518	0	43455
2680	957	160	161	42134	0	43412
2681	41929	164	141	665	0	42899
2682	631	144	138	41660	0	42573
2683	530	156	41232	709	0	42627
2684	40471	139	597	564	0	41771
2685	651	172	470	39968	0	41261
2686	527	197	39374	602	0	40700
2687	244	218	38646	470	0	39578
2688	225	185	882	37905	0	39197
2689	38333	182	559	576	0	39650
2690	38135	145	217	493	0	38990
2691	884	38276	194	230	0	39584
2692	38778	545	173	241	0	39737
2693	38682	453	140	228	0	39503
2694	38894	139	132	232	0	39397
2695	927	38878	178	214	0	40197
2696	38302	505	154	215	0	39176
2697	38485	405	128	210	0	39228
2698	1015	139	110	37758	0	39022
2699	35346	103	149	516	0	36114
2700	586	35266	170	472	0	36494
2701	475	35577	156	202	0	36410
2702	307	688	133	34728	0	35856
2703	295	464	115	34123	0	34997
2704	272	34871	132	647	0	35922
2705	33815	418	114	344	0	34691
2706	531	32693	142	175	0	33541
2707	31442	400	91	107	0	32040
2708	520	31948	101	132	0	32701
2709	492	454	72	28857	0	29875
2710	274	32005	95	334	0	32708
2711	31589	450	327	284	0	32650
2712	31194	326	177	150	0	31847
2713	30889	172	153	150	0	31364
2714	666	153	29622	133	0	30574
2715	370	127	26977	91	0	27565
2716	164	25717	390	121	0	26392
2717	223	282	25110	102	0	25717
2718	161	251	23507	124	0	24043
2719	156	706	336	18331	0	19529
2720	65	82	19348	161	0	19656
2721	44	18758	147	154	0	19103
2722	18354	130	86	42	0	18612
2723	119	18413	38	37	0	18607
2724	94	18550	41	54	0	18739
2725	18581	197	35	58	0	18871
2726	18673	106	30	57	0	18866
2727	183	19531	32	67	0	19813
2728	19638	153	23	37	0	19851
2729	19617	91	26	31	0	19765
2730	19667	40	20	46	0	19773
2731	234	46	19301	23	0	19604
2732	126	49	19477	35	0	19687
2733	49	56	190	19475	0	19770
2734	51	34	104	20140	0	20329
2735	20022	28	28	215	0	20293
2736	134	20191	42	119	0	20486
2737	117	147	36	20565	0	20865
2738	46	103	29	20955	0	21133
2739	74	30	33	21241	0	21378
2740	63	30	32	21416	0	21541
2741	62	43	21313	242	0	21660
2742	42	65	21349	105	0	21561
2743	56	25	190	21321	0	21592
2744	62	27	21869	136	0	22094
2745	20748	24	163	131	0	21066
2746	159	29	103	21981	0	22272
2747	149	27	22297	139	0	22612
2748	20331	28	148	138	0	20645
2749	147	22272	116	63	0	22598
2750	21922	106	37	34	0	22099
2751	137	23035	28	41	0	23241
2752	121	130	15	22668	0	22934
2753	53	109	23154	120	0	23436
2754	55	55	125	22259	0	22494
2755	41	40	22608	147	0	22836
2756	21989	16	123	109	0	22237
2757	134	33	90	23036	0	23293
2758	23186	19	32	141	0	23378
2759	149	33	23324	101	0	23607
2760	24337	15	116	58	0	24526
2761	26980	19	95	30	0	27124
2762	266	37	27972	25	0	28300
2763	123	42	154	27356	0	27675
2764	60	28	28615	163	0	28866
2765	31	28693	176	137	0	29037
2766	28357	155	215	82	0	28809
2767	28225	104	47	56	0	28432
2768	259	42	28706	37	0	29044
2769	146	32	29049	19	0	29246
2770	51	21	240	28247	0	28559
2771	40	27	125	29423	0	29615
2772	29700	22	44	245	0	30011
2773	168	30096	48	156	0	30468
2774	30716	139	34	49	0	30938
2775	30669	103	39	44	0	30855
2776	255	43	30438	36	0	30772
2777	29095	25	177	45	0	29342
2778	194	38	30899	42	0	31173
2779	153	22	172	31051	0	31398
2780	75	52	33286	173	0	33586
2781	57	16	189	32973	0	33235
2782	51	28	33664	183	0	33926
2783	32337	40	182	139	0	32698
2784	33251	14	139	54	0	33458
2785	264	34	46	33293	0	33637
2786	34342	25	54	203	0	34624
2787	208	25	47	35264	0	35544
2788	147	36832	79	200	0	37258
2789	36679	141	56	139	0	37015
2790	193	37133	84	75	0	37485
2791	161	173	40	37146	0	37520
2792	94	98	41	36622	0	36855
2793	59	32	58	36448	0	36597
2794	60	27	55	36265	0	36407
2795	83	57	35428	286	0	35854
2796	31555	38	160	216	0	31969
2797	34489	27	115	96	0	34727
2798	255	35219	68	88	0	35630
2799	164	134	50	35094	0	35442
2800	83	106	52	35460	0	35701
2801	87	44	35075	279	0	35485
2802	33464	34	191	163	0	33852
2803	203	27	152	34982	0	35364
2804	157	79	35488	193	0	35917
2805	35145	17	179	224	0	35565
2806	36742	23	134	100	0	36999
2807	36874	15	67	104	0	37060
2808	294	42	36757	71	0	37164
2809	183	39	35505	108	0	35835
2810	35136	24	262	80	0	35502
2811	163	58	140	36584	0	36945
2812	158	35	49	37748	0	37990
2813	98	48	38068	249	0	38463
2814	35432	31	144	200	0	35807
2815	177	29	126	38892	0	39224
2816	41058	25	64	213	0	41360
2817	41274	16	43	190	0	41523
2818	41377	20	40	123	0	41560
2819	278	71	43375	84	0	43808
2820	178	30	157	43354	0	43719
2821	45034	19	163	233	0	45449
2822	221	47226	96	190	0	47733
2823	202	149	45	47922	0	48318
2824	89	134	61	48369	0	48653
2825	48243	31	64	346	0	48684
2826	48164	18	72	208	0	48462
2827	343	29	55	48313	0	48740
2828	240	67	48805	221	0	49333
2829	46847	33	217	210	0	47307
2830	278	75	50662	95	0	51110
2831	50637	17	225	125	0	51004
2832	51681	30	194	109	0	52014
2833	391	50	52930	104	0	53475
2834	247	46	238	52544	0	53075
2835	132	64	56339	305	0	56840
2836	129	59672	303	294	0	60398
2837	157	390	235	56279	0	57061
2838	101	61973	103	311	0	62488
2839	123	315	69	62146	0	62653
2840	149	269	63546	388	0	64352
2841	95	64414	384	418	0	65311
2842	98	65435	318	133	0	65984
2843	212	762	111	64823	0	65908
2844	66236	295	59	462	0	67052
2845	474	87	69	71409	0	72039
2846	72419	40	72	543	0	73074
2847	497	74175	100	551	0	75323
2848	79310	505	58	130	0	80003
2849	708	435	83838	123	0	85104
2850	534	77	645	82246	0	83502
2851	140	63	473	82823	0	83499
2852	152	96	83736	1096	0	85080
2853	78295	61	657	594	0	79607
2854	81545	107	507	166	0	82325
2855	1065	83958	128	174	0	85325
2856	632	878	108	76087	0	77705
2857	135	83166	152	650	0	84103
2858	157	667	83717	542	0	85083
2859	226	560	84105	146	0	85037
2860	284	890	1099	79860	0	82133
2861	79772	97	518	657	0	81044
2862	588	79123	122	687	0	80520
2863	79746	596	79	126	0	80547
2864	721	537	78840	110	0	80208
2865	78795	94	617	127	0	79633
2866	80853	95	487	132	0	81567
2867	1146	145	81038	139	0	82468
2868	592	96	677	78822	0	80187
2869	81661	89	525	671	0	82946
2870	81607	87	121	563	0	82378
2871	81759	94	148	153	0	82154
2872	1159	109	104	80646	0	82018
2873	661	107	80938	696	0	82402
2874	77984	110	719	582	0	79395
2875	804	139	83383	158	0	84484
2876	646	104	714	81658	0	83122
2877	250	124	577	79573	0	80524
2878	203	83213	181	1273	0	84870
2879	257	696	82964	620	0	84537
2880	201	81434	768	193	0	82596
2881	303	82032	643	260	0	83238
2882	282	1237	243	80775	0	82537
2883	311	578	81541	772	0	83202
2884	283	146	744	80662	0	81835
2885	279	192	82811	794	0	84076
2886	251	148	797	80508	0	81704
2887	261	135	618	80563	0	81577
2888	275	175	79119	1228	0	80797
2889	251	140	803	76894	0	78088
2890	414	202	80064	852	0	81532
2891	367	176	78974	716	0	80233
2892	225	78662	1298	372	0	80557
2893	78887	731	673	282	0	80573
2894	904	636	79188	262	0	80990
2895	72390	202	913	275	0	73780
2896	874	149	737	79001	0	80761
2897	747	228	79327	887	0	81189
2898	276	78884	921	961	0	81042
2899	310	811	705	78444	0	80270
2900	368	720	79481	844	0	81413
2901	343	245	899	73839	0	75326
2902	271	79249	782	795	0	81097
2903	79302	802	324	686	0	81114
2904	896	706	320	79359	0	81281
2905	79277	223	294	991	0	80785
2906	79212	218	337	793	0	80560
2907	80262	226	331	402	0	81221
2908	80532	185	299	373	0	81389
2909	78779	225	323	362	0	79689
2910	1415	77957	345	405	0	80122
2911	858	805	324	77543	0	79530
2912	448	643	347	77767	0	79205
2913	465	182	326	78048	0	79021
2914	441	259	76358	1389	0	78447
2915	400	75475	925	936	0	77736
2916	75515	759	791	371	0	77436
2917	75616	658	357	396	0	77027
2918	1480	75836	402	460	0	78178
2919	823	75608	413	416	0	77260
2920	73818	1277	416	417	0	75928
2921	1034	703	72370	379	0	74486
2922	816	390	1008	68710	0	70924
2923	69837	228	883	978	0	71926
2924	1002	238	358	67657	0	69255
2925	772	69353	382	924	0	71431
2926	435	879	313	69151	0	70778
2927	381	716	69137	938	0	71172
2928	65613	247	1011	771	0	67642
2929	69315	230	757	396	0	70698
2930	1508	210	332	66933	0	68983
2931	972	194	306	67431	0	68903
2932	64962	199	280	1393	0	66834
2933	973	65384	386	846	0	67589
2934	804	726	294	63647	0	65471
2935	504	651	285	63149	0	64589
2936	57734	148	235	1241	0	59358
2937	778	59087	314	788	0	60967
2938	57568	641	243	343	0	58795
2939	877	58604	262	312	0	60055
2940	648	58119	244	336	0	59347
2941	56005	967	231	269	0	57472
2942	749	57170	257	282	0	58458
2943	619	1425	511	54560	0	57115
2944	338	499	54933	764	0	56534
2945	217	163	48262	445	0	49087
2946	189	119	46849	207	0	47364
2947	118	45804	991	156	0	47069
2948	38563	527	1126	129	0	40345
2949	387	259	123	36651	0	37420
2950	281	89	61	37566	0	37997
2951	122	78	37184	589	0	37973
2952	35030	72	380	357	0	35839
2953	386	44	272	38348	0	39050
2954	295	52	88	38773	0	39208
2955	102	57	44	38710	0	38913
2956	37428	51	72	648	0	38199
2957	424	74	37447	349	0	38294
2958	36445	40	367	144	0	36996
2959	427	70	268	37356	0	38121
2960	332	76	37559	403	0	38370
2961	35372	68	368	322	0	36130
2962	446	109	38159	136	0	38850
2963	323	314	430	36151	0	37218
2964	165	98	38317	402	0	38982
2965	123	88	36653	299	0	37163
2966	33349	59	659	140	0	34207
2967	434	84	35714	114	0	36346
2968	296	98	470	34084	0	34948
2969	34889	57	337	384	0	35667
2970	420	71	132	35014	0	35637
2971	323	74	35150	435	0	35982
2972	156	68	35368	334	0	35926
2973	106	35068	613	215	0	36002
2974	165	378	333	33950	0	34826
2975	32961	259	208	406	0	33834
2976	365	32877	112	327	0	33681
2977	32924	357	92	175	0	33548
2978	413	256	88	32343	0	33100
2979	32241	78	95	412	0	32826
2980	431	32154	122	344	0	33051
2981	320	386	95	31660	0	32461
2982	31761	248	104	401	0	32514
2983	403	32127	115	325	0	32970
2984	320	371	106	31806	0	32603
2985	179	266	111	31632	0	32188
2986	31843	99	103	604	0	32649
2987	400	63	131	32006	0	32600
2988	305	68	140	32060	0	32573
2989	177	55	128	32670	0	33030
2990	153	74	31037	684	0	31948
2991	29070	54	422	437	0	29983
2992	431	59	319	35250	0	36059
2993	349	67	36324	527	0	37267
2994	34432	54	554	434	0	35474
2995	556	97	37369	191	0	38213
2996	414	91	556	35082	0	36143
2997	159	36630	412	557	0	37758
2998	158	484	158	36827	0	37627
2999	192	364	36909	566	0	38031
3000	170	149	37542	424	0	38285
3001	156	119	814	37060	0	38149
3002	177	95	37336	610	0	38218
3003	34737	102	604	467	0	35910
3004	600	119	36729	188	0	37636
3005	409	103	596	34927	0	36035
3006	189	105	402	35809	0	36505
3007	136	107	163	35370	0	35776
3008	34922	65	153	899	0	36039
3009	35093	72	155	523	0	35843
3010	35596	65	141	262	0	36064
3011	852	79	148	35039	0	36118
3012	471	95	139	35439	0	36144
3013	226	78	34743	931	0	35978
3014	225	73	34914	498	0	35710
3015	166	34628	858	307	0	35959
3016	310	616	446	30527	0	31899
3017	176	310	167	28878	0	29531
3018	147	30806	169	662	0	31784
3019	30336	383	137	384	0	31240
3020	418	30825	165	208	0	31616
3021	30525	422	133	215	0	31295
3022	473	285	159	30303	0	31220
3023	30407	85	178	458	0	31128
3024	493	65	155	30478	0	31191
3025	382	73	30091	528	0	31074
3026	163	45	475	30248	0	30931
3027	29499	46	402	538	0	30485
3028	474	61	162	29989	0	30686
3029	357	49	143	29737	0	30286
3030	161	67	29693	777	0	30698
3031	151	52	445	29800	0	30448
3032	166	45	344	28919	0	29474
3033	155	29067	153	766	0	30141
3034	165	382	119	29353	0	30019
3035	162	282	92	29585	0	30121
3036	186	91	93	28883	0	29253
3037	97	27356	112	725	0	28290
3038	90	383	84	25887	0	26444
3039	24375	222	72	410	0	25079
3040	308	24354	75	328	0	25065
3041	203	22892	60	125	0	23280
3042	67	22454	55	129	0	22705
3043	88	643	86	20173	0	20990
3044	77	21236	116	294	0	21723
3045	90	21397	132	272	0	21891
3046	20596	351	227	94	0	21268
3047	260	192	20209	126	0	20787
3048	19713	69	273	136	0	20191
3049	238	64	240	20180	0	20722
3050	191	53	20209	317	0	20770
3051	19314	30	388	271	0	20003
3052	265	47	19839	199	0	20350
3053	204	50	19606	145	0	20005
3054	19563	37	490	140	0	20230
3055	280	29	318	19976	0	20603
3056	211	54	20250	381	0	20896
3057	19705	34	322	370	0	20431
3058	20241	36	253	247	0	20777
3059	509	49	20307	197	0	21062
3060	20540	28	284	184	0	21036
3061	20918	27	227	180	0	21352
3062	487	35	20041	217	0	20780
3063	19923	43	302	244	0	20512
3064	20052	47	285	201	0	20585
3065	441	70	19912	164	0	20587
3066	229	87	20956	152	0	21424
3067	91	100	418	20771	0	21380
3068	99	95	21164	408	0	21766
3069	20632	97	308	324	0	21361
3070	340	116	221	20522	0	21199
3071	288	145	59	20694	0	21186
3072	174	109	20279	490	0	21052
3073	169	84	276	19965	0	20494
3074	170	92	20320	387	0	20969
3075	20188	60	288	336	0	20872
3076	20549	69	246	193	0	21057
3077	497	78	20383	196	0	21154
3078	20289	52	270	227	0	20838
3079	20772	60	214	218	0	21264
3080	474	60	20696	243	0	21473
3081	20929	42	318	260	0	21549
3082	21102	43	254	260	0	21659
3083	444	66	20850	250	0	21610
3084	20519	78	277	251	0	21125
3085	289	106	21255	264	0	21914
3086	234	67	271	20792	0	21364
3087	84	74	196	21093	0	21447
3088	86	94	57	21461	0	21698
3089	87	113	20823	553	0	21576
3090	19055	98	251	395	0	19799
3091	294	141	20171	204	0	20810
3092	146	15790	194	91	0	16221
3093	41	14865	123	72	0	15101
3094	13593	163	171	58	0	13985
3095	130	91	37	13284	0	13542
3096	89	13823	26	118	0	14056
3097	13238	73	49	84	0	13444
3098	12986	63	24	37	0	13110
3099	146	13485	32	44	0	13707
3100	116	80	28	11715	0	11939
3101	25	12881	34	99	0	13039
3102	12982	69	17	71	0	13139
3103	12994	70	25	25	0	13114
3104	164	13	19	12752	0	12948
3105	12869	7	23	89	0	12988
3106	98	5	32	12834	0	12969
3107	90	14	12744	80	0	12928
3108	12380	10	89	83	0	12562
3109	106	18	12773	22	0	12919
3110	87	20	85	12025	0	12217
3111	12253	4	95	87	0	12439
3112	86	8	24	12373	0	12491
3113	78	12	12339	83	0	12512
3114	46	20	12094	77	0	12237
3115	51	118	149	11863	0	12181
3116	11837	19	148	82	0	12086
3117	80	12077	38	75	0	12270
3118	82	69	15	12030	0	12196
3119	26	78	12231	69	0	12404
3120	11810	17	83	76	0	11986
3121	12425	7	72	31	0	12535
3122	140	22	12457	20	0	12639
3123	12184	13	108	20	0	12325
3124	107	12	93	12512	0	12724
3125	89	18	12441	79	0	12627
3126	11987	13	83	69	0	12152
3127	84	13	68	12128	0	12293
3128	78	8	19	11807	0	11912
3129	11916	9	12	112	0	12049
3130	69	11640	23	77	0	11809
3131	71	11763	20	28	0	11882
3132	11739	98	11	35	0	11883
3133	11306	53	20	24	0	11403
3134	124	10	11835	23	0	11992
3135	74	14	11786	17	0	11891
3136	24	17	112	11752	0	11905
3137	12335	9	70	60	0	12474
3138	12213	5	18	60	0	12296
3139	12279	8	26	26	0	12339
3140	106	12351	35	27	0	12519
3141	69	12562	28	30	0	12689
3142	24	103	21	12990	0	13138
3143	28	57	12	12999	0	13096
3144	40	9	12	13574	0	13635
3145	33	11	13852	124	0	14020
3146	30	15	12960	66	0	13071
3147	13402	9	136	20	0	13567
3148	14061	7	76	34	0	14178
3149	144	4	21	13914	0	14083
3150	82	5	17	13914	0	14018
3151	28	9	28	14406	0	14471
3152	38	12	14323	149	0	14522
3153	31	20	14192	82	0	14325
3154	23	26	133	13927	0	14109
3155	27	15	14201	112	0	14355
3156	27	13907	93	82	0	14109
3157	14	14227	83	37	0	14361
3158	13805	139	26	21	0	13991
3159	104	13914	17	31	0	14066
3160	84	92	19	13734	0	13929
3161	29	62	20	13737	0	13848
3162	29	14758	23	153	0	14963
3163	32	127	15	14962	0	15136
3164	44	87	14684	122	0	14937
3165	27	14798	121	136	0	15082
3166	34	89	69	13879	0	14071
3167	30	80	13895	101	0	14106
3168	12	13795	115	95	0	14017
3169	30	94	79	12931	0	13134
3170	15	13891	33	95	0	14034
3171	35	94	13	13733	0	13875
3172	24	75	16	12959	0	13074
3173	25	13656	21	153	0	13855
3174	13124	95	15	87	0	13321
3175	12687	75	29	28	0	12819
3176	155	13192	20	33	0	13400
3177	83	13295	25	41	0	13444
3178	33	171	28	13108	0	13340
3179	25	91	13078	95	0	13289
3180	12476	26	96	102	0	12700
3181	12697	27	84	28	0	12836
3182	166	26	12653	36	0	12881
3183	12363	25	92	32	0	12512
3184	12668	23	87	30	0	12808
3185	168	26	12359	28	0	12581
3186	11928	17	104	38	0	12087
3187	109	23	12599	36	0	12767
3188	93	12504	106	24	0	12727
3189	12555	96	91	28	0	12770
3190	12566	88	15	29	0	12698
3191	167	37	12634	23	0	12861
3192	12638	32	98	38	0	12806
3193	12841	15	86	43	0	12985
3194	177	32	12865	29	0	13103
3195	12908	27	114	35	0	13084
3196	13164	19	93	33	0	13309
3197	182	33	13082	28	0	13325
3198	13202	25	103	27	0	13357
3199	109	20	93	12897	0	13119
3200	99	20	24	13012	0	13155
3201	34	22	13008	170	0	13234
3202	25	34	12942	96	0	13097
3203	40	21	170	12803	0	13034
3204	37	21	95	12998	0	13151
3205	13514	27	37	151	0	13729
3206	116	26	13483	86	0	13711
3207	13453	31	111	31	0	13626
3208	125	39	94	13784	0	14042
3209	102	33	14004	114	0	14253
3210	14423	25	104	106	0	14658
3211	128	21	96	15112	0	15357
3212	107	22	15251	125	0	15505
3213	14838	35	133	120	0	15126
3214	120	25	92	15267	0	15504
3215	15456	13	35	115	0	15619
3216	131	19	16416	92	0	16658
3217	110	31	133	14915	0	15189
3218	36	16835	93	122	0	17086
3219	16915	118	26	99	0	17158
3220	16631	70	45	34	0	16780
3221	188	17231	35	30	0	17484
3222	17270	114	24	48	0	17456
3223	17180	82	37	31	0	17330
3224	17040	30	21	26	0	17117
3225	198	16898	30	47	0	17173
3226	111	115	26	16965	0	17217
3227	56	91	17262	125	0	17534
3228	55	31	123	16964	0	17173
3229	49	17	97	17287	0	17450
3230	36	27	17230	205	0	17498
3231	35	29	17186	114	0	17364
3232	59	26	203	15393	0	15681
3233	41	17264	108	104	0	17517
3234	17095	118	30	84	0	17327
3235	16559	92	31	29	0	16711
3236	205	17044	37	39	0	17325
3237	16841	119	20	33	0	17013
3238	16722	82	35	53	0	16892
3239	203	40	16856	24	0	17123
3240	16114	28	131	41	0	16314
3241	147	16865	95	63	0	17170
3242	116	115	16443	28	0	16702
3243	73	95	16280	37	0	16485
3244	40	15904	217	59	0	16220
3245	15556	105	104	18	0	15783
3246	145	87	15671	37	0	15940
3247	100	23	110	15328	0	15561
3248	42	17	15692	110	0	15861
3249	14659	19	126	97	0	14901
3250	130	26	18161	41	0	18358
3251	103	22	17948	31	0	18104
3252	17149	26	170	36	0	17381
3253	110	18234	86	53	0	18483
3254	18306	91	53	35	0	18485
3255	18567	73	28	45	0	18713
3256	170	23	24	18166	0	18383
3257	80	19938	45	104	0	20167
3258	20110	94	31	96	0	20331
3259	125	79	20472	22	0	20698
3260	19802	22	106	35	0	19965
3261	109	20562	89	47	0	20807
3262	19528	66	33	40	0	19667
3263	19419	46	28	21	0	19514
3264	108	19908	43	55	0	20114
3265	55	83	35	19909	0	20082
3266	20276	35	45	76	0	20432
3267	88	20317	37	56	0	20498
3268	54	101	15	20361	0	20531
3269	20869	41	30	101	0	21041
3270	93	18	25	21904	0	22040
3271	59	31	18	21583	0	21691
3272	32	22111	30	150	0	22323
3273	22162	89	23	81	0	22355
3274	22557	69	20	39	0	22685
3275	22838	27	19	31	0	22915
3276	179	23781	38	38	0	24036
3277	24115	100	20	40	0	24275
3278	24111	70	21	20	0	24222
3279	175	31	27	23837	0	24070
3280	95	21	25	24125	0	24266
3281	66	39	24166	157	0	24428
3282	52	28	92	23639	0	23811
3283	47	21	79	24016	0	24163
3284	56	33	24371	149	0	24609
3285	21125	31	127	128	0	21411
3286	129	40	24375	49	0	24593
3287	127	44	24795	26	0	24992
3288	59	29	161	24530	0	24779
3289	57	31	80	24588	0	24756
3290	53	25737	61	168	0	26019
3291	25575	111	31	78	0	25795
3292	25327	75	29	49	0	25480
3293	179	26083	40	48	0	26350
3294	120	28231	40	73	0	28464
3295	114	236	28	27453	0	27831
3296	45	30337	41	164	0	30587
3297	30193	209	23	118	0	30543
3298	29981	148	40	53	0	30222
3299	340	40	40	29708	0	30128
3300	169	30	37	30096	0	30332
3301	30173	28	32	327	0	30560
3302	242	43	29737	157	0	30179
3303	29420	33	202	63	0	29718
3304	259	45	29955	49	0	30308
3305	28855	27	213	54	0	29149
3306	254	36	118	29345	0	29753
3307	169	38	30221	215	0	30643
3308	81	52	29803	130	0	30066
3309	28754	87	360	87	0	29288
3310	29299	26	160	65	0	29550
3311	303	30880	61	54	0	31298
3312	178	182	21	31730	0	32111
3313	74	155	35	32732	0	32996
3314	32475	41	26	377	0	32919
3315	244	32617	38	243	0	33142
3316	31679	215	22	74	0	31990
3317	222	31812	40	56	0	32130
3318	177	31551	30	74	0	31832
3319	31453	334	40	61	0	31888
3320	265	202	31181	54	0	31702
3321	196	60	226	30562	0	31044
3322	66	23	164	31275	0	31528
3323	84	45	31483	387	0	31999
3324	59	32	218	30980	0	31289
3325	84	28	167	29663	0	29942
3326	47	31619	57	384	0	32107
3327	31441	219	59	233	0	31952
3328	291	190	31790	73	0	32344
3329	30018	48	231	66	0	30363
3330	252	31823	188	66	0	32329
3331	220	239	56	31889	0	32404
3332	33304	180	26	273	0	33783
3333	262	50	28	33448	0	33788
3334	204	31	25	33562	0	33822
3335	81	58	33513	410	0	34062
3336	31211	37	240	251	0	31739
3337	33334	35	177	94	0	33640
3338	428	50	33757	72	0	34307
3339	225	27	234	33277	0	33763
3340	83	51	34160	273	0	34567
3341	33026	27	266	222	0	33541
3342	34905	28	184	87	0	35204
3343	398	23	49	34652	0	35122
3344	34736	30	46	270	0	35082
3345	307	42	37312	218	0	37879
3346	210	28	250	37213	0	37701
3347	83	41	192	37966	0	38282
3348	71	31	57	38758	0	38917
3349	63	29	37	38804	0	38933
3350	35921	40	37	459	0	36457
3351	298	58	35594	234	0	36184
3352	223	26	236	35636	0	36121
3353	87	50	35790	309	0	36236
3354	90	62	35327	236	0	35715
3355	64	41	405	35058	0	35568
3356	80	25	198	35641	0	35944
3357	34533	27	53	423	0	35036
3358	261	31	44	34712	0	35048
3359	210	37	39	35006	0	35292
3360	58	16	43	35433	0	35550
3361	35170	18	44	484	0	35716
3362	35080	20	34	262	0	35396
3363	35540	33	43	88	0	35704
3364	35137	26	42	103	0	35308
3365	441	37520	58	110	0	38129
3366	240	298	34	37273	0	37845
3367	123	222	41	37803	0	38189
3368	38598	44	48	532	0	39222
3369	333	40436	70	362	0	41201
3370	265	316	31	41690	0	42302
3371	100	287	44167	395	0	44949
3372	44995	52	410	396	0	45853
3373	459	48891	350	156	0	49856
3374	50799	455	87	107	0	51448
3375	51288	407	45	78	0	51818
3376	935	58	34	50978	0	52005
3377	553	59	51216	567	0	52395
3378	135	47	524	52317	0	53023
3379	52684	43	434	643	0	53804
3380	609	46	78	52886	0	53619
3381	52947	43	62	611	0	53663
3382	594	52652	73	569	0	53888
3383	54641	531	52	160	0	55384
3384	674	454	43	54586	0	55757
3385	577	74	56	56325	0	57032
3386	58472	54	85	1056	0	59667
3387	58201	49	50	581	0	58881
3388	58820	53	45	179	0	59097
3389	58519	41	53	128	0	58741
3390	58196	48	54	128	0	58426
3391	1142	39	43	57018	0	58242
3392	636	80	56656	645	0	58017
3393	219	56079	600	604	0	57502
3394	53891	530	558	192	0	55171
3395	638	482	52326	124	0	53570
3396	50769	68	509	113	0	51459
3397	617	51888	432	135	0	53072
3398	52390	471	122	129	0	53112
3399	637	427	68	51911	0	53043
3400	549	106	62	52276	0	52993
3401	250	91	52535	965	0	53841
3402	213	32	520	51507	0	52272
3403	230	92	53437	590	0	54349
3404	239	105	52556	514	0	53414
3405	52245	50	907	218	0	53420
3406	53956	72	513	230	0	54771
3407	1025	99	53081	187	0	54392
3408	52114	71	532	207	0	52924
3409	52743	64	441	207	0	53455
3410	1067	91	52374	165	0	53697
3411	652	51528	563	186	0	52929
3412	599	605	478	52135	0	53817
3413	53964	419	163	565	0	55111
3414	55299	106	104	531	0	56040
3415	55519	74	92	215	0	55900
3416	55390	85	116	175	0	55766
3417	55159	78	168	166	0	55571
3418	1093	130	54570	168	0	55961
3419	750	149	55462	147	0	56508
3420	406	171	860	54869	0	56306
3421	56319	120	523	618	0	57580
3422	56541	94	167	576	0	57378
3423	56948	106	164	285	0	57503
3424	55660	80	155	276	0	56171
3425	1056	56282	226	329	0	57893
3426	694	58820	187	341	0	60042
3427	59122	802	167	282	0	60373
3428	59032	479	173	256	0	59940
3429	1108	59607	198	286	0	61199
3430	60289	507	144	265	0	61205
3431	931	551	59962	266	0	61710
3432	818	156	549	58558	0	60081
3433	562	188	60119	629	0	61498
3434	562	170	60090	535	0	61357
3435	538	104	880	59323	0	60845
3436	537	110	523	61100	0	62270
3437	578	145	62671	923	0	64317
3438	508	104	606	60419	0	61637
3439	452	116	537	62471	0	63576
3440	62147	108	273	941	0	63469
3441	61927	126	244	592	0	62889
3442	1245	125	226	62001	0	63597
3443	839	222	62860	632	0	64553
3444	489	62983	628	757	0	64857
3445	61137	547	567	351	0	62602
3446	911	459	64381	307	0	66058
3447	766	64587	675	327	0	66355
3448	458	66641	603	321	0	68023
3449	66818	817	309	265	0	68209
3450	67496	470	267	252	0	68485
3451	1216	152	285	66590	0	68243
3452	864	183	71855	649	0	73551
3453	527	120	726	71597	0	72970
3454	475	151	661	72250	0	73537
3455	500	123	317	73189	0	74129
3456	72066	110	264	1061	0	73501
3457	852	71770	327	666	0	73615
3458	805	75920	308	360	0	77393
3459	544	974	221	74491	0	76230
3460	468	522	232	76505	0	77727
3461	75961	158	225	1086	0	77430
3462	72546	175	222	681	0	73624
3463	75504	131	216	319	0	76170
3464	1293	75573	326	287	0	77479
3465	73491	483	253	252	0	74479
3466	836	762	237	72408	0	74243
3467	844	162	72506	587	0	74099
3468	561	174	68664	492	0	69891
3469	65104	124	934	299	0	66461
3470	685	120	66720	153	0	67678
3471	551	111	62799	150	0	63611
3472	55696	73	547	143	0	56459
3473	355	71	58055	137	0	58618
3474	258	91	56511	86	0	56946
3475	190	399	399	52814	0	53802
3476	133	64	57837	212	0	58246
3477	106	63	174	54982	0	55325
3478	112	59	137	57062	0	57370
3479	138	88	59964	320	0	60510
3480	63	61557	185	241	0	62046
3481	61249	135	210	168	0	61762
3482	247	173	64110	80	0	64610
3483	149	97	63510	78	0	63834
3484	51540	49	389	150	0	52128
3485	188	93	62996	102	0	63379
3486	113	62351	184	139	0	62787
3487	89	63301	187	132	0	63709
3488	113	230	95	64116	0	64554
3489	72	138	36	63892	0	64138
3490	65885	26	43	301	0	66255
3491	65031	33	47	185	0	65296
3492	65472	50	27	91	0	65640
3493	258	48	33	65738	0	66077
3494	66520	39	59	224	0	66842
3495	65238	62	78	210	0	65588
3496	283	75	67446	59	0	67863
3497	191	82	66532	68	0	66873
3498	51	68479	284	125	0	68939
3499	66	133	132	68432	0	68763
3500	69148	129	64	195	0	69536
3501	150	69331	86	237	0	69804
3502	156	140	60	70223	0	70579
3503	70611	141	51	224	0	71027
3504	69694	44	47	194	0	69979
3505	254	72094	87	191	0	72626
3506	71499	158	57	129	0	71843
3507	71970	138	39	156	0	72303
3508	322	41	51	72339	0	72753
3509	221	124	74557	215	0	75117
3510	87	73939	200	273	0	74499
3511	66	74457	205	184	0	74912
3512	72268	256	62	93	0	72679
3513	223	185	59	72786	0	73253
3514	209	125	74385	226	0	74945
3515	77	74817	231	227	0	75352
3516	74485	177	152	123	0	74937
3517	74770	140	53	107	0	75070
3518	377	139	77330	105	0	77951
3519	195	43	203	74138	0	74579
3520	105	68	159	79643	0	79975
3521	134	128	87684	393	0	88339
3522	85711	58	343	327	0	86439
3523	106458	52	287	183	0	106980
3524	985	66	125	118528	0	119704
3525	505	123905	176	1179	0	125765
3526	229	1119	75	129036	0	130459
3527	212	691	130409	1267	0	132579
3528	124438	167	1270	805	0	126680
3529	1296	65	705	135267	0	137333
3530	823	128	135993	1285	0	138229
3531	126735	85	1321	868	0	129009
3532	1315	76	729	135354	0	137474
3533	776	141	242	135459	0	136618
3534	133996	115	154	2003	0	136268
3535	1234	136113	272	1081	0	138700
3536	134926	1199	195	400	0	136720
3537	1550	751	158	134232	0	136691
3538	133832	217	191	1439	0	135679
3539	1627	247	133667	996	0	136537
3540	941	134309	1445	545	0	137240
3541	419	1332	827	134988	0	137566
3542	134381	869	297	1578	0	137125
3543	1362	135331	378	1222	0	138293
3544	1130	1403	286	134976	0	137795
3545	135990	827	203	1590	0	138610
3546	132767	238	312	1210	0	134527
3547	2338	244	330	130467	0	133379
3548	1380	334	130968	1686	0	134368
3549	540	348	130160	1319	0	132367
3550	125061	280	2209	775	0	128325
3551	1715	130156	1081	708	0	133660
3552	1144	127706	451	581	0	129882
3553	124072	2011	501	588	0	127172
3554	1670	128890	321	701	0	131582
3555	1373	1482	331	127027	0	130213
3556	703	989	380	129855	0	131927
3557	128527	539	335	2467	0	131868
3558	126129	373	320	1443	0	128265
3559	126200	429	334	721	0	127684
3560	2646	599	124075	613	0	127933
3561	1529	396	1444	122710	0	126079
3562	987	453	125303	1678	0	128421
3563	936	398	124435	1268	0	127037
3564	716	391	126847	768	0	128722
3565	702	338	2478	116567	0	120085
3566	810	432	126826	1599	0	129667
3567	976	534	127218	1093	0	129821
3568	680	546	2300	122592	0	126118
3569	125526	453	1180	1756	0	128915
3570	2004	510	127364	1275	0	131153
3571	1356	471	1709	122447	0	125983
3572	821	409	1215	127801	0	130246
3573	754	439	129326	2544	0	133063
3574	800	379	1757	125664	0	128600
3575	886	398	131425	1976	0	134685
3576	827	369	2003	126251	0	129450
3577	787	351	1371	128232	0	130741
3578	755	327	746	129224	0	131052
3579	699	317	810	128120	0	129946
3580	123476	259	883	2808	0	127426
3581	121761	283	791	1774	0	124609
3582	2639	351	124094	962	0	128046
3583	1431	122066	2173	1316	0	126986
3584	866	1493	125237	876	0	128472
3585	765	1015	124044	959	0	126783
3586	117015	318	2810	874	0	121017
3587	1706	124387	1915	1149	0	129157
3588	124150	1486	960	1044	0	127640
3589	1869	126509	1065	1022	0	130465
3590	125730	1667	893	907	0	129197
3591	126263	1029	876	982	0	129150
3592	2687	386	931	124384	0	128388
3593	1463	127720	867	2439	0	132489
3594	910	1507	760	128710	0	131887
3595	684	1046	801	130337	0	132868
3596	809	491	129317	3117	0	133734
3597	777	129396	2123	1855	0	134151
3598	898	1593	1556	128615	0	132662
3599	128342	1193	944	2213	0	132692
3600	131049	600	793	1621	0	134063
3601	132031	394	791	1054	0	134270
3602	2837	131620	854	1159	0	136470
3603	132752	1820	585	971	0	136128
3604	2257	140703	751	1043	0	144754
3605	1848	2079	598	141759	0	146284
3606	1179	1641	142334	2239	0	147393
3607	1086	629	2168	136413	0	140296
3608	856	141712	1779	2377	0	146724
3609	835	2080	829	139716	0	143460
3610	778	1692	631	138062	0	141163
3611	658	141586	764	3460	0	146468
3612	141092	2163	643	1889	0	145787
3613	2369	1599	622	139703	0	144293
3614	1802	868	138231	2445	0	143346
3615	1048	536	2123	137447	0	141154
3616	1015	538	1580	140072	0	143205
3617	1020	680	140748	3499	0	145947
3618	1000	845	2190	128379	0	132414
3619	778	136537	1694	2850	0	141859
3620	1068	2241	135846	1826	0	140981
3621	1877	1599	126443	895	0	130814
3622	534	120460	2865	1000	0	124859
3623	421	104411	1379	626	0	106837
3624	407	89074	807	404	0	90692
3625	82402	1500	1510	309	0	85721
3626	72630	6643	326	266	0	79865
3627	78008	197	167	215	0	78587
3628	1262	290	117	77325	0	78994
3629	692	203	77171	850	0	78916
3630	214	149	752	76049	0	77164
3631	150	146	615	76855	0	77766
3632	76885	124	185	1311	0	78505
3633	76326	128	160	808	0	77422
3634	1243	77425	197	323	0	79188
3635	77675	762	135	264	0	78836
3636	77584	624	141	219	0	78568
3637	78379	235	144	271	0	79029
3638	1390	172	77124	222	0	78908
3639	769	190	77025	172	0	78156
3640	283	221	1283	74929	0	76716
3641	211	212	77382	815	0	78620
3642	72709	169	826	717	0	74421
3643	75867	156	623	340	0	76986
3644	1322	195	75210	192	0	76919
3645	71981	142	750	192	0	73065
3646	829	74445	644	270	0	76188
3647	75213	757	176	192	0	76338
3648	882	642	156	73977	0	75657
3649	726	210	154	70894	0	71984
3650	252	74200	220	1264	0	75936
3651	73591	755	156	708	0	75210
3652	73451	638	131	289	0	74509
3653	1268	74125	216	236	0	75845
3654	775	779	173	71239	0	72966
3655	328	703	161	70779	0	71971
3656	248	71915	213	1293	0	73669
3657	339	804	169	71516	0	72828
3658	280	698	191	72379	0	73548
3659	71018	255	197	1370	0	72840
3660	70534	186	158	815	0	71693
3661	1379	240	70758	356	0	72733
3662	68411	225	791	358	0	69785
3663	956	300	70812	292	0	72360
3664	794	272	800	68076	0	69942
3665	379	244	69541	957	0	71121
3666	287	68348	862	917	0	70414
3667	356	849	752	66804	0	68761
3668	316	665	209	67856	0	69046
3669	66908	251	197	1305	0	68661
3670	885	200	187	66273	0	67545
3671	770	277	65876	883	0	67806
3672	64078	228	826	771	0	65903
3673	65215	217	716	357	0	66505
3674	66513	251	244	348	0	67356
3675	65447	240	227	323	0	66237
3676	1433	223	257	67373	0	69286
3677	881	206	229	68977	0	70293
3678	435	210	219	70963	0	71827
3679	412	196	208	71412	0	72228
3680	69545	194	228	1640	0	71607
3681	69203	180	264	875	0	70522
3682	1706	158	203	62559	0	64626
3683	949	66117	253	1009	0	68328
3684	65738	840	312	789	0	67679
3685	1248	733	65713	369	0	68063
3686	924	65661	945	354	0	67884
3687	61277	795	704	323	0	63099
3688	964	62620	269	310	0	64163
3689	888	867	61486	232	0	63473
3690	60853	670	869	213	0	62605
3691	60999	190	717	256	0	62162
3692	1591	199	60021	275	0	62086
3693	1018	153	825	59018	0	61014
3694	516	104	718	58293	0	59631
3695	411	59374	289	1421	0	61495
3696	414	778	235	58768	0	60195
3697	56325	617	209	990	0	58141
3698	957	57051	206	887	0	59101
3699	830	750	159	53533	0	55272
3700	439	620	139	53803	0	55001
3701	344	211	52476	1293	0	54324
3702	317	52001	735	741	0	53794
3703	46802	800	601	371	0	48574
3704	599	39850	130	195	0	40774
3705	375	36514	143	153	0	37185
3706	35255	650	525	126	0	36556
3707	521	321	108	33754	0	34704
3708	352	104	67	34196	0	34719
3709	33730	80	66	691	0	34567
3710	490	78	46	34153	0	34767
3711	398	88	53	34293	0	34832
3712	34040	70	72	746	0	34928
3713	517	74	46	33549	0	34186
3714	368	33772	76	505	0	34721
3715	33396	411	36	392	0	34235
3716	475	309	32581	163	0	33528
3717	345	30897	414	175	0	31831
3718	145	499	262	30015	0	30921
3719	132	285	29561	412	0	30390
3720	126	109	29431	311	0	29977
3721	230	779	616	27130	0	28755
3722	27300	78	337	404	0	28119
3723	367	46	76	27069	0	27558
3724	279	56	65	27207	0	27607
3725	110	63	48	27492	0	27713
3726	86	71	55	27440	0	27652
3727	109	66	45	27555	0	27775
3728	119	72	26232	694	0	27117
3729	101	74	25776	320	0	26271
3730	81	51	536	25730	0	26398
3731	90	70	26068	409	0	26637
3732	80	25746	367	389	0	26582
3733	101	351	263	25759	0	26474
3734	108	278	25103	406	0	25895
3735	21588	104	359	358	0	22409
3736	340	24621	259	157	0	25377
3737	242	24036	83	140	0	24501
3738	102	24392	76	149	0	24719
3739	130	531	73	23609	0	24343
3740	23679	239	49	397	0	24364
3741	325	80	57	23719	0	24181
3742	23293	74	48	416	0	23831
3743	323	22853	52	318	0	23546
3744	23301	310	45	177	0	23833
3745	372	257	44	23200	0	23873
3746	290	106	48	23097	0	23541
3747	117	22972	58	536	0	23683
3748	111	332	55	23110	0	23608
3749	122	256	70	23148	0	23596
3750	115	92	65	23046	0	23318
3751	22311	76	67	592	0	23046
3752	22265	95	60	355	0	22775
3753	536	85	22089	169	0	22879
3754	21885	73	305	172	0	22435
3755	363	90	22419	169	0	23041
3756	299	85	328	21786	0	22498
3757	137	73	253	22302	0	22765
3758	94	72	93	22568	0	22827
3759	100	89	21936	581	0	22706
3760	86	68	330	21831	0	22315
3761	98	94	22251	434	0	22877
3762	68	76	334	21988	0	22466
3763	21678	66	260	442	0	22446
3764	326	96	21867	356	0	22645
3765	21466	81	319	209	0	22075
3766	338	78	246	21953	0	22615
3767	22063	60	94	422	0	22639
3768	323	22011	87	384	0	22805
3769	266	310	88	22178	0	22842
3770	134	264	22836	407	0	23641
3771	86	115	301	22255	0	22757
3772	112	438	250	21001	0	21801
3773	107	21617	93	575	0	22392
3774	162	284	20779	348	0	21573
3775	75	20282	308	168	0	20833
3776	16014	233	215	137	0	16599
3777	161	16189	56	110	0	16516
3778	14536	126	195	54	0	14911
3779	14487	85	36	76	0	14684
3780	14410	29	27	58	0	14524
3781	230	23	26	14508	0	14787
3782	123	24	14505	150	0	14802
3783	42	26	125	13977	0	14170
3784	35	14476	114	171	0	14796
3785	29	127	40	14492	0	14688
3786	14098	98	28	182	0	14406
3787	115	14419	35	169	0	14738
3788	112	118	32	13952	0	14214
3789	41	120	27	14022	0	14210
3790	13822	24	26	246	0	14118
3791	137	37	13895	133	0	14202
3792	103	13703	126	78	0	14010
3793	48	152	92	13146	0	13438
3794	26	90	13135	116	0	13367
3795	32	27	102	12596	0	12757
3796	23	13346	97	118	0	13584
3797	25	95	37	13632	0	13789
3798	21	89	17	13460	0	13587
3799	25	22	20	13557	0	13624
3800	17	30	13366	200	0	13613
3801	12534	18	99	122	0	12773
3802	110	17	82	14392	0	14601
3803	15651	16	30	140	0	15837
3804	16038	27	14	114	0	16193
3805	16320	14	17	39	0	16390
3806	16180	19	15	39	0	16253
3807	16425	14	13	52	0	16504
3808	250	12	18	15982	0	16262
3809	134	16095	18	145	0	16392
3810	43	117	14	15530	0	15704
3811	30	15744	16	158	0	15948
3812	27	129	11	15097	0	15264
3813	14886	85	18	136	0	15125
3814	111	22	13	14902	0	15048
3815	92	27	14861	124	0	15104
3816	13823	14	106	114	0	14057
3817	105	14983	79	77	0	15244
3818	15048	102	41	33	0	15224
3819	14989	73	20	29	0	15111
3820	14498	21	15	29	0	14563
3821	167	15029	24	35	0	15255
3822	91	97	11	14968	0	15167
3823	39	73	5	15120	0	15237
3824	35	25	15024	173	0	15257
3825	39	18	101	14247	0	14405
3826	34	9	71	14619	0	14733
3827	37	14	16	14471	0	14538
3828	28	14912	29	211	0	15180
3829	15095	106	15	95	0	15311
3830	14558	86	10	45	0	14699
3831	191	35	15196	29	0	15451
3832	117	15186	119	47	0	15469
3833	61	128	91	15186	0	15466
3834	53	84	22	15405	0	15564
3835	34	27	22	15471	0	15554
3836	36	24	21	15819	0	15900
3837	33	23	11	15962	0	16029
3838	30	30	15632	223	0	15915
3839	33	30	15094	126	0	15283
3840	15813	19	181	70	0	16083
3841	16836	22	86	58	0	17002
3842	16976	24	30	49	0	17079
3843	256	14	23	16932	0	17225
3844	137	29	16755	159	0	17080
3845	16484	22	149	131	0	16786
3846	17015	30	111	78	0	17234
3847	246	31	16745	47	0	17069
3848	16455	25	155	43	0	16678
3849	204	35	17797	49	0	18085
3850	150	18	155	17494	0	17817
3851	60	32	17892	193	0	18177
3852	17071	20	206	152	0	17449
3853	17812	24	118	69	0	18023
3854	17866	23	35	65	0	17989
3855	17794	21	37	78	0	17930
3856	312	31	18462	45	0	18850
3857	158	18454	185	62	0	18859
3858	18687	165	120	54	0	19026
3859	18723	104	52	64	0	18943
3860	300	39	18620	53	0	19012
3861	166	35	186	17727	0	18114
3862	83	37	111	18461	0	18692
3863	59	33	18351	302	0	18745
3864	17206	17	190	169	0	17582
3865	18223	27	130	83	0	18463
3866	299	18435	59	72	0	18865
3867	18809	164	41	76	0	19090
3868	18768	103	52	48	0	18971
3869	18821	32	36	52	0	18941
3870	18039	26	46	58	0	18169
3871	344	30	17535	46	0	17955
3872	17072	18	200	45	0	17335
3873	258	79	121	16742	0	17200
3874	180	17462	55	209	0	17906
3875	115	167	17165	138	0	17585
3876	82	17341	190	74	0	17687
3877	108	300	163	15971	0	16542
3878	95	101	16235	167	0	16598
3879	15074	40	175	109	0	15398
3880	194	31	16002	56	0	16283
3881	15563	16	157	52	0	15788
3882	198	22	96	15688	0	16004
3883	137	20	53	15550	0	15760
3884	82	15602	60	213	0	15957
3885	71	16072	42	110	0	16295
3886	75	204	41	16161	0	16481
3887	16031	99	53	157	0	16340
3888	16058	34	39	97	0	16228
3889	16094	27	37	59	0	16217
3890	249	24	15975	48	0	16296
3891	15703	15	153	49	0	15920
3892	206	20	16147	42	0	16415
3893	122	30	15549	32	0	15733
3894	15187	26	253	51	0	15517
3895	15567	30	103	69	0	15769
3896	236	35	15483	26	0	15780
3897	144	26	128	14919	0	15217
3898	78	19	92	15594	0	15783
3899	15631	20	47	188	0	15886
3900	15394	10	36	101	0	15541
3901	222	13	16288	49	0	16572
3902	107	15512	149	31	0	15799
3903	63	14592	100	28	0	14783
3904	14228	130	84	31	0	14473
3905	155	53	51	14208	0	14467
3906	101	17	43	14467	0	14628
3907	74	11	30	14772	0	14887
3908	12807	21	32	177	0	13037
3909	145	9	30	14721	0	14905
3910	14838	9	38	116	0	15001
3911	15282	24	28	67	0	15401
3912	217	16583	35	41	0	16876
3913	127	110	44	18753	0	19034
3914	65	80	19132	150	0	19427
3915	18577	30	154	127	0	18888
3916	19266	18	130	46	0	19460
3917	19480	16	49	46	0	19591
3918	288	24	20056	48	0	20416
3919	173	9	167	19946	0	20295
3920	20418	14	120	174	0	20726
3921	19798	21	36	130	0	19985
3922	19778	18	38	42	0	19876
3923	268	19782	59	44	0	20153
3924	148	20638	34	46	0	20866
3925	82	247	18	20962	0	21309
3926	97	116	35	20602	0	20850
3927	80	20945	36	259	0	21320
3928	20810	151	31	133	0	21125
3929	202	126	21286	46	0	21660
3930	158	25	160	21019	0	21362
3931	79	11	109	21158	0	21357
3932	65	47	21174	256	0	21542
3933	19811	30	160	143	0	20144
3934	21342	26	123	56	0	21547
3935	263	21226	52	75	0	21616
3936	20904	149	34	43	0	21130
3937	202	120	21549	39	0	21910
3938	21681	26	169	65	0	21941
3939	259	29	22368	37	0	22693
3940	21164	73	254	41	0	21532
3941	21302	19	109	48	0	21478
3942	21327	14	49	30	0	21420
3943	21045	13	17	36	0	21111
3944	223	21243	42	47	0	21555
3945	21608	110	23	29	0	21770
3946	22249	86	30	44	0	22409
3947	251	42	22493	27	0	22813
3948	22189	19	104	34	0	22346
3949	157	37	94	22477	0	22765
3950	152	29	22874	123	0	23178
3951	22634	22	120	99	0	22875
3952	166	20	101	23300	0	23587
3953	24052	23	37	161	0	24273
3954	26891	31	31	207	0	27160
3955	262	44	29182	45	0	29533
3956	28986	9	131	61	0	29187
3957	29721	19	113	56	0	29909
3958	29991	23	25	47	0	30086
3959	30420	19	34	48	0	30521
3960	267	24	45	29441	0	29777
3961	168	30560	38	143	0	30909
3962	30400	124	38	119	0	30681
3963	30857	97	36	44	0	31034
3964	31056	23	36	50	0	31165
3965	303	44	30951	31	0	31329
3966	172	31316	154	53	0	31695
3967	120	134	122	31360	0	31736
3968	112	92	55	31717	0	31976
3969	124	46	33211	235	0	33616
3970	107	26	201	33039	0	33373
3971	122	48	34100	211	0	34481
3972	102	24	233	33504	0	33863
3973	95	25	145	34150	0	34415
3974	113	43	34982	331	0	35469
3975	33105	35	213	203	0	33556
3976	35604	25	153	105	0	35887
3977	399	61	36642	55	0	37157
3978	35716	38	220	77	0	36051
3979	36834	30	176	82	0	37122
3980	419	49	38555	69	0	39092
3981	256	23	240	37738	0	38257
3982	129	20	180	38705	0	39034
3983	38884	22	72	376	0	39354
3984	284	40395	72	244	0	40995
3985	38871	212	72	96	0	39251
3986	40213	145	62	90	0	40510
3987	424	42403	70	107	0	43004
3988	42784	229	46	66	0	43125
3989	42470	176	49	48	0	42743
3990	465	43058	81	88	0	43692
3991	246	223	51	42824	0	43344
3992	127	44555	77	243	0	45002
3993	146	236	67	44446	0	44895
3994	148	204	44517	253	0	45122
3995	148	96	44626	195	0	45065
3996	43357	43	379	130	0	43909
3997	45401	43	210	92	0	45746
3998	469	89	45893	58	0	46509
3999	45417	29	264	106	0	45816
4000	46943	36	211	108	0	47298
4001	46354	25	87	82	0	46548
4002	468	48124	101	123	0	48816
4003	283	214	64	48786	0	49347
4004	48986	168	83	286	0	49523
4005	48254	48	65	234	0	48601
4006	497	81	50472	86	0	51136
4007	304	46	251	49266	0	49867
4008	152	52	204	49826	0	50234
4009	129	51127	92	375	0	51723
4010	160	53560	77	277	0	54074
4011	171	709	69	50715	0	51664
4012	118	53305	99	282	0	53804
4013	50821	227	50	181	0	51279
4014	277	53602	62	96	0	54037
4015	54160	261	47	89	0	54557
4016	384	223	55131	41	0	55779
4017	55625	62	346	95	0	56128
4018	57980	41	239	75	0	58335
4019	57953	30	63	58	0	58104
4020	56897	42	57	93	0	57089
4021	615	57717	75	108	0	58515
4022	351	319	33	58074	0	58777
4023	127	273	46	58477	0	58923
4024	136	110	58340	603	0	59189
4025	108	64	339	56970	0	57481
4026	103	48	276	58487	0	58914
4027	58492	53	84	613	0	59242
4028	407	59713	99	374	0	60593
4029	365	375	58	60295	0	61093
4030	136	318	63	61228	0	61745
4031	146	87	50	61771	0	62054
4032	61206	77	70	746	0	62099
4033	468	63	78	61967	0	62576
4034	62573	56	67	521	0	63217
4035	500	51	84	62696	0	63331
4036	440	50	74	63491	0	64055
4037	234	86	62195	707	0	63222
4038	54939	57	424	511	0	55931
4039	475	62734	407	185	0	63801
4040	65082	374	109	206	0	65771
4041	561	324	80	64782	0	65747
4042	466	103	85	65628	0	66282
4043	66974	78	69	789	0	67910
4044	67620	63	58	477	0	68218
4045	899	96	58	71966	0	73019
4046	523	137	73442	624	0	74726
4047	258	116	73955	540	0	74869
4048	144	77730	898	265	0	79037
4049	78845	615	594	203	0	80257
4050	77696	502	195	187	0	78580
4051	1115	135	53	77824	0	79127
4052	565	82122	94	693	0	83474
4053	270	688	54	81783	0	82795
4054	187	571	65	77824	0	78647
4055	167	76829	117	1199	0	78312
4056	75467	647	99	628	0	76841
4057	762	572	101	75584	0	77019
4058	655	79882	119	699	0	81355
4059	250	81968	134	617	0	82969
4060	81217	1056	133	203	0	82609
4061	848	627	81381	182	0	83038
4062	80050	184	660	218	0	81112
4063	855	212	542	81861	0	83470
4064	714	157	129	80613	0	81613
4065	258	82563	150	1274	0	84245
4066	302	966	100	82632	0	84000
4067	336	634	82881	893	0	84744
4068	229	82374	712	786	0	84101
4069	181	82748	566	334	0	83829
4070	79734	1099	144	275	0	81252
4071	664	82749	121	300	0	83834
4072	701	770	100	80882	0	82453
4073	248	82911	145	825	0	84129
4074	288	732	81	82831	0	83932
4075	270	619	78	83130	0	84097
4076	264	332	81421	1350	0	83367
4077	262	176	672	79995	0	81105
4078	276	196	596	81273	0	82341
4079	79402	195	193	1348	0	81138
4080	897	272	80215	840	0	82224
4081	770	232	664	80677	0	82343
4082	405	243	82025	971	0	83644
4083	77492	204	738	869	0	79303
4084	836	83008	666	536	0	85046
4085	86778	818	204	527	0	88327
4086	986	734	166	88515	0	90401
4087	881	291	153	88533	0	89858
4088	375	284	88183	1665	0	90507
4089	76592	271	864	1233	0	78960
4090	915	89027	734	595	0	91271
4091	82181	1029	211	532	0	83953
4092	1060	870	186	86825	0	88941
4093	896	89954	237	1166	0	92253
4094	87817	966	198	1031	0	90012
4095	983	91853	227	537	0	93600
4096	924	1043	160	90802	0	92929
4097	380	852	172	91551	0	92955
4098	395	301	213	90530	0	91439
4099	319	90248	261	1906	0	92734
4100	366	995	210	90640	0	92211
4101	397	907	197	91062	0	92563
4102	88880	363	195	1794	0	91232
4103	88956	370	188	1143	0	90657
4104	89516	378	190	554	0	90638
4105	1834	393	89601	521	0	92349
4106	88310	388	927	506	0	90131
4107	90158	392	795	500	0	91845
4108	88885	377	257	553	0	90072
4109	1749	457	86871	528	0	89605
4110	83854	380	862	498	0	85594
4111	1194	341	741	87192	0	89468
4112	983	387	86286	1272	0	88928
4113	435	86170	944	1116	0	88665
4114	462	1783	755	79539	0	82539
4115	342	83562	311	1066	0	85281
4116	351	83935	280	947	0	85513
4117	79983	1343	474	476	0	82276
4118	922	761	196	79885	0	81764
4119	80785	310	201	976	0	82272
4120	931	298	145	80768	0	82142
4121	80727	305	208	988	0	82228
4122	951	286	179	80924	0	82340
4123	80931	317	179	1018	0	82445
4124	973	322	79473	833	0	81601
4125	825	310	729	79299	0	81163
4126	452	378	82087	965	0	83882
4127	447	367	79502	857	0	81173
4128	380	333	82623	474	0	83810
4129	353	417	1206	78385	0	80361
4130	380	312	81560	1014	0	83266
4131	79152	237	772	946	0	81107
4132	871	277	627	81167	0	82942
4133	803	257	86745	1099	0	88904
4134	382	230	761	86006	0	87379
4135	384	242	635	87547	0	88808
4136	463	285	93982	1471	0	96201
4137	505	184	787	92859	0	94335
4138	468	267	680	91584	0	92999
4139	495	96347	324	1324	0	98490
4140	95263	698	263	838	0	97062
4141	95141	619	262	517	0	96539
4142	1395	298	93517	454	0	95664
4143	89583	204	736	417	0	90940
4144	926	248	90191	404	0	91769
4145	690	219	85646	345	0	86900
4146	364	219	87121	312	0	88016
4147	469	1901	1132	81312	0	84814
4148	289	200	86549	662	0	87700
4149	287	253	540	83306	0	84386
4150	218	111	414	85617	0	86360
4151	223	108	142	85476	0	85949
4152	228	95	141	85604	0	86068
4153	84698	98	132	891	0	85819
4154	83543	104	134	572	0	84353
4155	786	86546	188	492	0	88012
4156	503	439	153	87427	0	88522
4157	324	401	89471	594	0	90790
4158	252	90006	553	605	0	91416
4159	274	558	491	92476	0	93799
4160	266	464	94800	597	0	96127
4161	226	183	648	91494	0	92551
4162	227	174	94572	712	0	95685
4163	221	162	93669	533	0	94585
4164	209	84	929	94219	0	95441
4165	209	106	518	95201	0	96034
4166	95496	92	194	1065	0	96847
4167	589	83	180	95758	0	96610
4168	95407	93	166	793	0	96459
4169	555	96212	220	729	0	97716
4170	484	99818	221	397	0	100920
4171	250	921	131	102083	0	103385
4172	102957	447	166	711	0	104281
4173	638	104812	240	695	0	106385
4174	595	585	164	107854	0	109198
4175	113353	421	224	791	0	114789
4176	114382	111	187	607	0	115287
4177	114485	99	225	332	0	115141
4178	114834	84	238	325	0	115481
4179	116213	68	282	312	0	116875
4180	1175	161	114858	249	0	116443
4181	735	220	113759	268	0	114982
4182	188	114705	1056	379	0	116328
4183	404	1008	711	113189	0	115312
4184	276	547	117381	613	0	118817
4185	227	337	114339	453	0	115356
4186	217	327	905	111764	0	113213
4187	232	181	121818	595	0	122826
4188	269	150	123913	518	0	124850
4189	148	147227	1115	373	0	148863
4190	145883	978	598	282	0	147741
4191	850	158771	284	441	0	160346
4192	803	1211	153	156454	0	158621
4193	163039	699	186	1149	0	165073
4194	1065	171443	263	937	0	173708
4195	847	1242	166	168319	0	170574
4196	279	904	172546	1270	0	174999
4197	166798	188	1288	880	0	169154
4198	174246	156	877	292	0	175571
4199	175953	148	248	301	0	176650
4200	2107	111	183	175842	0	178243
4201	1065	284	178999	1398	0	181746
4202	297	178938	1420	1189	0	181844
4203	354	1374	877	176794	0	179399
4204	174467	900	283	1401	0	177051
4205	1441	357	178782	952	0	181532
4206	976	173832	1489	546	0	176843
4207	442	1383	179306	278	0	181409
4208	171773	864	1508	336	0	174481
4209	180159	242	1025	293	0	181719
4210	180531	177	310	324	0	181342
4211	2413	322	178492	299	0	181526
4212	1154	176623	1474	473	0	179724
4213	514	1346	1020	174914	0	177794
4214	426	943	381	177494	0	179244
4215	388	309	338	177498	0	178533
4216	426	407	176618	2187	0	179638
4217	162776	241	1514	1318	0	165849
4218	1673	346	179049	352	0	181420
4219	175735	274	1593	422	0	178024
4220	180431	266	1143	463	0	182303
4221	181210	249	414	379	0	182252
4222	177862	262	378	446	0	178948
4223	2599	408	179093	284	0	182384
4224	1403	286	1568	173498	0	176755
4225	721	447	178154	1602	0	180924
4226	527	174203	1695	1418	0	177843
4227	501	178038	1282	758	0	180579
4228	176269	2247	482	573	0	179571
4229	172267	1192	518	469	0	174446
4230	2413	178022	681	693	0	181809
4231	178769	1596	484	491	0	181340
4232	2067	1284	172807	446	0	176604
4233	168755	451	1600	577	0	171383
4234	2063	174655	1376	629	0	178723
4235	177001	1740	510	465	0	179716
4236	170994	1282	509	509	0	173294
4237	3108	530	537	166792	0	170967
4238	1872	511	544	169021	0	171948
4239	166949	593	668	2605	0	170815
4240	2307	627	615	167568	0	171117
4241	167986	539	598	1998	0	171121
4242	2598	491	575	167272	0	170936
4243	165887	452	752	1926	0	169017
4244	162912	495	695	1424	0	165526
4245	3071	162877	865	759	0	167572
4246	1930	164352	897	679	0	167858
4247	158237	2639	731	675	0	162282
4248	2257	160411	864	783	0	164315
4249	1959	1989	821	156156	0	160925
4250	1130	1460	793	158475	0	161858
4251	150872	723	748	2895	0	155238
4252	2277	156035	1007	1793	0	161112
4253	1920	154753	868	996	0	158537
4254	1236	155008	914	1089	0	158247
4255	1597	2876	146979	847	0	152299
4256	1462	1636	150781	758	0	154637
4257	1564	942	151230	886	0	154622
4258	1677	2025	2908	125883	0	132493
4259	1254	143734	1689	1809	0	148486
4260	143644	1770	735	1411	0	147560
4261	2513	1434	142127	848	0	146922
4262	2063	699	141997	1020	0	145779
4263	1410	581	143535	825	0	146351
4264	1601	679	2790	137918	0	142988
4265	1473	624	1578	141023	0	144698
4266	1638	664	860	141868	0	145030
4267	141036	702	776	2435	0	144949
4268	139977	767	847	1349	0	142940
4269	139831	662	884	731	0	142108
4270	3126	618	995	133809	0	138548
4271	1894	710	129353	1684	0	133641
4272	1237	845	130716	1200	0	133998
4273	1372	648	2429	127382	0	131831
4274	1395	641	1366	125836	0	129238
4275	123025	612	728	2323	0	126688
4276	2363	121766	767	1520	0	126416
4277	121211	1523	601	820	0	124155
4278	2184	120839	661	1020	0	124704
4279	1913	1583	510	119272	0	123278
4280	1350	1108	119069	1996	0	123523
4281	1358	856	1590	116802	0	120606
4282	118511	470	1070	1977	0	122028
4283	2356	529	117187	1474	0	121546
4284	110495	491	1547	732	0	113265
4285	2491	531	110844	725	0	114591
4286	2087	607	106230	614	0	109538
4287	96576	469	2168	804	0	100017
4288	2119	514	98073	690	0	101396
4289	967	319	70231	378	0	71895
4290	1088	67333	2077	463	0	70961
4291	54716	1367	2765	735	0	59583
4292	50148	393	569	255	0	51365
4293	49680	95	161	209	0	50145
4294	654	142	47399	188	0	48383
4295	45045	113	356	165	0	45679
4296	454	46860	263	179	0	47756
4297	45202	365	111	142	0	45820
4298	496	269	45160	131	0	46056
4299	354	541	371	41813	0	43079
4300	139	100	42112	352	0	42703
4301	103	41610	321	281	0	42315
4302	213	283	300	39157	0	39953
4303	179	160	79	40093	0	40511
4304	40744	43	63	403	0	41253
4305	40673	28	63	213	0	40977
4306	40763	44	61	83	0	40951
4307	40788	56	67	91	0	41002
4308	40284	52	71	73	0	40480
4309	425	71	40359	67	0	40922
4310	238	35	254	39601	0	40128
4311	130	58	42208	269	0	42665
4312	97	53	281	42352	0	42783
4313	43017	50	228	303	0	43598
4314	43770	44	82	233	0	44129
4315	44252	38	80	88	0	44458
4316	45059	32	83	104	0	45278
4317	519	57	46761	75	0	47412
4318	305	58	320	45943	0	46626
4319	106	75	46927	360	0	47468
4320	110	47949	368	365	0	48792
4321	95	48951	321	95	0	49462
4322	158	629	128	47543	0	48458
4323	116	286	76	50213	0	50691
4324	103	64	77	52170	0	52414
4325	125	36	72	53941	0	54174
4326	52506	38	86	850	0	53480
4327	494	52801	103	469	0	53867
4328	49865	427	67	110	0	50469
4329	506	352	51	49508	0	50417
4330	428	73	72	47482	0	48055
4331	97	49660	90	768	0	50615
4332	108	467	62	49668	0	50305
4333	48816	338	54	489	0	49697
4334	465	48057	87	474	0	49083
4335	373	46815	66	170	0	47424
4336	46301	677	44	82	0	47104
4337	459	363	55	46089	0	46966
4338	376	46763	78	458	0	47675
4339	165	455	59	47483	0	48162
4340	47457	361	105	506	0	48429
4341	456	78	47	47550	0	48131
4342	399	71	35	47850	0	48355
4343	47390	53	38	827	0	48308
4344	477	58	25	47274	0	47834
4345	402	47701	64	519	0	48686
4346	136	424	46	47056	0	47662
4347	92	47500	63	511	0	48166
4348	102	454	38	47544	0	48138
4349	47104	365	46	501	0	48016
4350	47379	80	45	447	0	47951
4351	793	79	49	47687	0	48608
4352	440	90	47242	502	0	48274
4353	45183	80	442	465	0	46170
4354	535	98	47376	147	0	48156
4355	45878	58	461	150	0	46547
4356	46580	68	368	131	0	47147
4357	826	97	45703	144	0	46770
4358	414	45189	435	152	0	46190
4359	45046	429	391	161	0	46027
4360	45213	361	88	159	0	45821
4361	777	119	46867	109	0	47872
4362	46279	77	427	146	0	46929
4363	46413	64	340	137	0	46954
4364	46945	63	73	134	0	47215
4365	776	73	52	46334	0	47235
4366	445	52	41	46692	0	47230
4367	133	47969	59	744	0	48905
4368	145	403	34	48830	0	49412
4369	158	386	27	48989	0	49560
4370	151	110	48203	771	0	49235
4371	168	127	46601	466	0	47362
4372	42570	78	704	196	0	43548
4373	45851	74	367	159	0	46451
4374	749	46252	114	193	0	47308
4375	459	425	67	46417	0	47368
4376	186	448	47981	509	0	49124
4377	148	95	403	48255	0	48901
4378	153	83	391	49142	0	49769
4379	142	105	78	49972	0	50297
4380	128	50528	91	934	0	51681
4381	210	436	60	51346	0	52052
4382	187	435	63	51834	0	52519
4383	221	179	51217	883	0	52500
4384	189	133	51251	556	0	52129
4385	48015	90	809	271	0	49185
4386	51156	104	511	208	0	51979
4387	857	107	103	52584	0	53651
4388	514	91	91	51420	0	52116
4389	186	110	86	52261	0	52643
4390	199	151	50699	1017	0	52066
4391	171	49662	528	798	0	51159
4392	191	537	50175	268	0	51171
4393	48271	471	605	230	0	49577
4394	678	168	50715	208	0	51769
4395	49714	104	570	208	0	50596
4396	49743	94	475	223	0	50535
4397	50831	110	123	179	0	51243
4398	1040	86	87	49764	0	50977
4399	600	103	50114	691	0	51508
4400	217	50747	565	659	0	52188
4401	228	580	473	49956	0	51237
4402	214	467	150	50619	0	51450
4403	222	177	51923	1035	0	53357
4404	190	50996	609	734	0	52529
4405	52091	565	541	237	0	53434
4406	677	53789	173	300	0	54939
4407	56828	635	143	207	0	57813
4408	789	616	137	56845	0	58387
4409	805	197	58303	767	0	60072
4410	239	58457	774	725	0	60195
4411	58254	696	718	280	0	59948
4412	825	623	58327	158	0	59933
4413	57592	123	761	204	0	58680
4414	57999	89	658	205	0	58951
4415	1318	123	58198	147	0	59786
4416	56041	72	761	162	0	57036
4417	56023	72	610	149	0	56854
4418	54812	75	195	131	0	55213
4419	1228	54158	173	211	0	55770
4420	51991	599	112	147	0	52849
4421	706	53153	147	201	0	54207
4422	671	646	52438	145	0	53900
4423	188	52092	641	187	0	53108
4424	48945	598	793	155	0	50491
4425	49005	421	127	115	0	49668
4426	49447	87	118	105	0	49757
4427	959	84	95	48120	0	49258
4428	553	77	96	49129	0	49855
4429	48125	70	104	865	0	49164
4430	48464	79	88	487	0	49118
4431	968	60	103	47320	0	48451
4432	563	101	48056	514	0	49234
4433	170	46777	541	470	0	47958
4434	166	47863	474	150	0	48653
4435	186	854	145	46974	0	48159
4436	196	477	47499	502	0	48674
4437	202	190	488	44309	0	45189
4438	163	46409	469	527	0	47568
4439	186	497	126	46326	0	47135
4440	190	450	46153	560	0	47353
4441	186	119	501	45949	0	46755
4442	218	124	47955	573	0	48870
4443	223	111	544	46688	0	47566
4444	228	119	48697	576	0	49620
4445	187	113	48139	496	0	48935
4446	44935	115	902	191	0	46143
4447	47877	117	511	138	0	48643
4448	48281	109	155	142	0	48687
4449	964	47909	201	154	0	49228
4450	608	510	132	47935	0	49185
4451	47385	471	141	530	0	48527
4452	47789	161	133	498	0	48581
4453	47752	111	144	209	0	48216
4454	986	133	47700	189	0	49008
4455	559	46086	582	195	0	47422
4456	241	48004	528	199	0	48972
4457	47362	854	211	143	0	48570
4458	694	503	167	46998	0	48362
4459	47136	152	186	533	0	48007
4460	739	161	46588	479	0	47967
4461	666	149	555	44496	0	45866
4462	364	134	507	45077	0	46082
4463	356	149	180	43040	0	43725
4464	320	44756	188	832	0	46096
4465	44335	547	156	480	0	45518
4466	43955	522	133	166	0	44776
4467	1028	43384	189	177	0	44778
4468	656	563	136	42493	0	43848
4469	42664	478	152	553	0	43847
4470	709	177	154	42556	0	43596
4471	42628	153	142	566	0	43489
4472	711	42264	167	603	0	43745
4473	41785	556	189	181	0	42711
4474	757	524	41409	170	0	42860
4475	629	41592	551	240	0	43012
4476	341	562	40476	185	0	41564
4477	521	900	645	38616	0	40682
4478	38722	185	567	584	0	40058
4479	38861	120	187	448	0	39616
4480	38267	149	119	192	0	38727
4481	978	128	149	36999	0	38254
4482	37361	113	141	535	0	38150
4483	678	113	127	36842	0	37760
4484	36760	106	166	546	0	37578
4485	36726	139	168	469	0	37502
4486	952	136	36684	244	0	38016
4487	516	142	34854	145	0	35657
4488	232	143	34959	155	0	35489
4489	206	158	716	33421	0	34501
4490	33890	92	527	447	0	34956
4491	504	107	155	34018	0	34784
4492	479	113	125	34478	0	35195
4493	36185	91	122	741	0	37139
4494	36009	64	93	451	0	36617
4495	36380	79	71	195	0	36725
4496	36624	65	93	181	0	36963
4497	808	81	102	35898	0	36889
4498	35457	74	100	467	0	36098
4499	517	35064	138	410	0	36129
4500	34487	351	134	187	0	35159
4501	34221	324	201	170	0	34916
4502	697	140	32710	128	0	33675
4503	29873	94	383	139	0	30489
4504	443	95	30086	120	0	30744
4505	310	58	27209	111	0	27688
4506	209	97	27141	100	0	27547
4507	305	823	413	21190	0	22731
4508	90	36	22224	161	0	22511
4509	80	158	115	19892	0	20245
4510	69	27	20637	117	0	20850
4511	59	29	22731	112	0	22931
4512	60	46	160	21700	0	21966
4513	79	35	113	23782	0	24009
4514	50	21	25604	166	0	25841
4515	24291	10	117	116	0	24534
4516	134	12	127	26203	0	26476
4517	125	15	26	26650	0	26816
4518	26782	12	37	236	0	27067
4519	136	57	23	28497	0	28713
4520	162	28	28886	160	0	29236
4521	69	33	28202	139	0	28443
4522	45	17	253	27551	0	27866
4523	50	38	28939	185	0	29212
4524	29	30305	194	155	0	30683
4525	48	161	141	30027	0	30377
4526	30438	125	33	168	0	30764
4527	162	46	30758	163	0	31129
4528	29661	10	163	78	0	29912
4529	180	14	143	31783	0	32120
4530	155	11	44	32263	0	32473
4531	51	13	32	32548	0	32644
4532	47	10	34	32763	0	32854
4533	31939	14	37	341	0	32331
4534	164	34570	55	217	0	35006
4535	189	195	27	34970	0	35381
4536	75	176	34	35058	0	35343
4537	52	33	42	35280	0	35407
4538	63	20	38	35391	0	35512
4539	34811	18	43	430	0	35302
4540	221	34971	61	299	0	35552
4541	34258	190	31	115	0	34594
4542	217	33397	45	125	0	33784
4543	171	33719	42	116	0	34048
4544	33132	340	47	60	0	33579
4545	251	198	33906	69	0	34424
4546	194	53	220	33686	0	34153
4547	34576	28	191	277	0	35072
4548	35087	22	55	266	0	35430
4549	33111	45	54	172	0	33382
4550	36107	31	38	119	0	36295
4551	386	38126	64	115	0	38691
4552	38451	267	35	100	0	38853
4553	39155	215	38	86	0	39494
4554	471	41935	72	117	0	42595
4555	280	351	43	43337	0	44011
4556	133	298	43757	426	0	44614
4557	106	56	366	43960	0	44488
4558	43508	53	289	477	0	44327
4559	437	74	45876	357	0	46744
4560	313	45378	448	208	0	46347
4561	153	418	46908	143	0	47622
4562	142	367	431	41961	0	42901
4563	79	46668	360	359	0	47466
4564	46304	408	95	349	0	47156
4565	407	47579	110	185	0	48281
4566	346	446	64	46707	0	47563
4567	149	329	46	48019	0	48543
4568	47304	92	56	742	0	48194
4569	493	95	58	45448	0	46094
4570	361	47525	106	519	0	48511
4571	47241	424	74	425	0	48164
4572	47301	341	70	163	0	47875
4573	701	48599	83	189	0	49572
4574	48338	474	48	185	0	49045
4575	472	48401	87	216	0	49176
4576	47831	469	72	176	0	48548
4577	499	48575	103	198	0	49375
4578	455	479	63	46194	0	47191
4579	210	394	82	48634	0	49320
4580	47905	138	87	782	0	48912
4581	48654	125	87	476	0	49342
4582	764	48997	96	370	0	50227
4583	506	530	48407	190	0	49633
4584	48517	410	472	194	0	49593
4585	580	149	352	48610	0	49691
4586	437	50021	140	556	0	51154
4587	220	522	93	50218	0	51053
4588	50396	387	77	573	0	51433
4589	50683	163	83	486	0	51415
4590	51202	179	82	261	0	51724
4591	956	139	55	50497	0	51647
4592	548	199	50785	573	0	52105
4593	47668	178	452	504	0	48802
4594	49374	142	369	224	0	50109
4595	49750	157	112	207	0	50226
4596	887	49532	102	256	0	50777
4597	566	518	90	49310	0	50484
4598	249	51380	100	579	0	52308
4599	277	590	66	51732	0	52665
4600	268	443	91	52542	0	53344
4601	259	250	55313	898	0	56720
4602	260	192	498	58575	0	59525
4603	268	177	426	59972	0	60843
4604	59436	171	117	1111	0	60835
4605	725	60621	129	703	0	62178
4606	60440	718	111	242	0	61511
4607	61630	609	95	233	0	62567
4608	1259	256	91	61057	0	62663
4609	790	244	62064	741	0	63839
4610	332	61570	655	658	0	63215
4611	260	60871	556	350	0	62037
4612	58109	1128	264	262	0	59763
4613	779	60408	151	286	0	61624
4614	615	706	85	57163	0	58569
4615	247	563	107	59060	0	59977
4616	247	241	58496	1069	0	60053
4617	261	218	58169	635	0	59283
4618	223	58197	1022	272	0	59714
4619	202	698	500	56474	0	57874
4620	56193	542	133	649	0	57517
4621	671	194	142	57242	0	58249
4622	541	241	57796	709	0	59287
4623	240	159	597	56921	0	57917
4624	54440	166	483	752	0	55841
4625	54514	187	115	618	0	55434
4626	1055	55468	145	316	0	56984
4627	54962	648	95	235	0	55940
4628	724	55529	135	255	0	56643
4629	55003	693	74	202	0	55972
4630	784	598	73	53789	0	55244
4631	647	230	54105	668	0	55650
4632	301	211	53784	566	0	54862
4633	282	54426	977	234	0	55919
4634	348	610	509	51729	0	53196
4635	243	508	156	53153	0	54060
4636	53029	167	98	998	0	54292
4637	53327	174	113	579	0	54193
4638	54172	172	92	283	0	54719
4639	1061	168	92	53485	0	54806
4640	682	147	84	54225	0	55138
4641	296	170	92	54867	0	55425
4642	285	196	54172	996	0	55649
4643	278	220	53990	583	0	55071
4644	50974	164	902	281	0	52321
4645	53015	159	494	261	0	53929
4646	1062	186	53323	235	0	54806
4647	51273	131	614	287	0	52305
4648	51372	134	505	233	0	52244
4649	1089	164	51467	228	0	52948
4650	639	51330	621	273	0	52863
4651	338	788	516	48765	0	50407
4652	348	469	50363	635	0	51815
4653	246	51459	576	613	0	52894
4654	370	929	429	44594	0	46322
4655	203	47613	193	513	0	48522
4656	230	515	46259	457	0	47461
4657	262	436	46681	225	0	47604
4658	217	522	770	45276	0	46785
4659	46026	151	463	539	0	47179
4660	528	189	136	46019	0	46872
4661	45945	151	133	528	0	46757
4662	551	135	123	46249	0	47058
4663	505	172	46185	501	0	47363
4664	43378	124	492	554	0	44548
4665	500	166	46838	216	0	47720
4666	45429	142	519	235	0	46325
4667	517	131	510	45209	0	46367
4668	469	46858	204	581	0	48112
4669	248	469	153	46295	0	47165
4670	224	48201	186	573	0	49184
4671	286	480	155	44154	0	45075
4672	239	48110	170	553	0	49072
4673	46898	468	161	534	0	48061
4674	47276	411	145	251	0	48083
4675	47003	166	167	257	0	47593
4676	913	177	47072	227	0	48389
4677	631	134	488	46241	0	47494
4678	338	189	47926	534	0	48987
4679	263	46709	574	529	0	48075
4680	260	47548	509	243	0	48560
4681	45834	779	262	192	0	47067
4682	582	480	46474	188	0	47724
4683	520	45908	516	218	0	47162
4684	266	472	505	46072	0	47315
4685	46042	448	207	582	0	47279
4686	519	47040	240	549	0	48348
4687	47328	476	199	262	0	48265
4688	580	544	47333	233	0	48690
4689	560	186	483	47449	0	48678
4690	259	140	505	48871	0	49775
4691	272	174	214	50361	0	51021
4692	254	50645	236	1000	0	52135
4693	301	545	185	49698	0	50729
4694	289	504	51808	683	0	53284
4695	306	143	576	50677	0	51702
4696	245	147	588	51636	0	52616
4697	279	124	257	50470	0	51130
4698	239	50029	226	1006	0	51500
4699	296	493	205	49643	0	50637
4700	343	576	184	48414	0	49517
4701	153	45150	206	909	0	46418
4702	39775	351	104	442	0	40672
4703	323	40840	124	210	0	41497
4704	335	40012	115	151	0	40613
4705	174	754	121	39134	0	40183
4706	165	374	38879	373	0	39791
4707	34471	133	356	401	0	35361
4708	318	98	324	37902	0	38642
4709	333	93	37259	405	0	38090
4710	96	37235	349	449	0	38129
4711	104	364	335	37061	0	37864
4712	140	346	37498	383	0	38367
4713	119	132	360	36121	0	36732
4714	101	114	324	36469	0	37008
4715	35585	68	98	635	0	36386
4716	308	35789	127	450	0	36674
4717	35700	317	93	175	0	36285
4718	376	333	36330	162	0	37201
4719	343	36833	357	164	0	37697
4720	169	358	37028	133	0	37688
4721	178	429	387	37301	0	38295
4722	37519	84	373	382	0	38358
4723	332	81	98	37324	0	37835
4724	37841	71	78	410	0	38400
4725	38043	68	90	405	0	38606
4726	654	83	78	38808	0	39623
4727	427	96	41480	431	0	42434
4728	154	125	42992	403	0	43674
4729	139	89	658	43473	0	44359
4730	100	89	413	44578	0	45180
4731	44349	94	140	754	0	45337
4732	397	90	88	44412	0	44987
4733	425	44739	125	468	0	45757
4734	176	390	81	45055	0	45702
4735	145	437	74	45219	0	45875
4736	44156	109	88	794	0	45147
4737	377	45131	104	557	0	46169
4738	431	390	94	45445	0	46360
4739	134	415	104	45138	0	45791
4740	98	45283	109	841	0	46331
4741	134	421	72	45952	0	46579
4742	113	437	96	45072	0	45718
4743	100	44809	109	860	0	45878
4744	96	380	91	45375	0	45942
4745	96	431	98	44595	0	45220
4746	75	44767	126	882	0	45850
4747	101	410	76	45514	0	46101
4748	44890	449	86	597	0	46022
4749	44869	175	64	638	0	45746
4750	44749	129	74	298	0	45250
4751	44493	120	68	302	0	44983
4752	732	43205	89	296	0	44322
4753	40965	385	65	232	0	41647
4754	374	40816	97	285	0	41572
4755	373	40451	92	248	0	41164
4756	201	681	115	40115	0	41112
4757	142	416	40514	443	0	41515
4758	38630	154	341	464	0	39589
4759	40313	113	330	230	0	40986
4760	657	120	41933	203	0	42913
4761	41022	93	376	209	0	41700
4762	42250	88	335	234	0	42907
4763	674	41737	99	196	0	42706
4764	45524	370	71	277	0	46242
4765	450	372	59	45067	0	45948
4766	450	118	73	45117	0	45758
4767	172	114	93	45506	0	45885
4768	161	137	77	45375	0	45750
4769	45048	88	74	817	0	46027
4770	435	119	80	44768	0	45402
4771	452	108	58	44862	0	45480
4772	222	143	43952	771	0	45088
4773	40023	114	349	568	0	41054
4774	43923	110	339	275	0	44647
4775	44202	91	97	270	0	44660
4776	708	43870	145	260	0	44983
4777	459	44589	106	253	0	45407
4778	43987	615	65	242	0	44909
4779	473	433	78	44048	0	45032
4780	429	45265	100	562	0	46356
4781	196	405	66	44656	0	45323
4782	161	45460	94	569	0	46284
4783	44473	449	50	529	0	45501
4784	449	45691	88	320	0	46548
4785	448	432	60	44741	0	45681
4786	221	410	42	45610	0	46283
4787	230	178	46333	823	0	47564
4788	190	48378	408	605	0	49581
4789	256	584	355	49275	0	50470
4790	232	466	50005	629	0	51332
4791	227	183	50436	492	0	51338
4792	207	182	816	50020	0	51225
4793	206	143	511	49492	0	50352
4794	153	49322	155	1026	0	50656
4795	180	50483	113	645	0	51421
4796	181	1042	82	50012	0	51317
4797	49960	551	61	681	0	51253
4798	645	185	60	52168	0	53058
4799	53501	132	63	777	0	54473
4800	54244	126	71	660	0	55101
4801	55051	144	48	297	0	55540
4802	1194	171	54780	246	0	56391
4803	54056	118	616	239	0	55029
4804	814	114	513	54864	0	56305
4805	668	124	147	55308	0	56247
4806	317	145	54662	1202	0	56326
4807	272	155	54569	748	0	55744
4808	238	213	1037	52405	0	53893
4809	210	53306	610	757	0	54883
4810	208	54299	210	677	0	55394
4811	247	1070	107	53921	0	55345
4812	53486	601	103	773	0	54963
4813	709	202	101	54023	0	55035
4814	650	122	89	53040	0	53901
4815	232	53899	128	1149	0	55408
4816	241	669	70	54434	0	55414
4817	243	591	54690	796	0	56320
4818	208	247	53284	663	0	54402
4819	48875	150	1024	333	0	50382
4820	704	52731	613	285	0	54333
4821	51694	597	169	235	0	52695
4822	51378	516	126	218	0	52238
4823	1049	209	120	47562	0	48940
4824	575	50910	160	642	0	52287
4825	293	622	120	50729	0	51764
4826	50192	500	103	712	0	51507
4827	592	48773	142	722	0	50229
4828	46692	590	90	275	0	47647
4829	594	47271	121	250	0	48236
4830	47129	633	90	209	0	48061
4831	46817	460	72	197	0	47546
4832	939	46445	123	214	0	47721
4833	571	616	87	46140	0	47414
4834	46255	423	110	647	0	47435
4835	654	179	45218	540	0	46591
4836	516	171	45329	251	0	46267
4837	284	374	886	43860	0	45404
4838	44766	124	510	595	0	45995
4839	570	140	158	44735	0	45603
4840	44938	131	109	658	0	45836
4841	676	152	46260	515	0	47603
4842	46274	108	529	259	0	47170
4843	48435	123	398	230	0	49186
4844	945	95	139	47907	0	49086
4845	589	103	98	48262	0	49052
4846	263	123	98	48167	0	48651
4847	197	48306	142	1004	0	49649
4848	204	509	137	48321	0	49171
4849	214	419	164	48647	0	49444
4850	48265	161	147	982	0	49555
4851	48375	111	132	614	0	49232
4852	947	182	47884	291	0	49304
4853	47020	144	540	284	0	47988
4854	686	186	48236	252	0	49360
4855	44960	121	631	284	0	45996
4856	679	129	47626	301	0	48735
4857	546	158	46775	252	0	47731
4858	275	271	886	44889	0	46321
4859	257	147	46558	658	0	47620
4860	44298	126	612	602	0	45638
4861	614	135	451	46892	0	48092
4862	48045	130	167	691	0	49033
4863	48223	132	141	568	0	49064
4864	45585	120	134	244	0	46083
4865	45067	87	126	249	0	45529
4866	1037	97	45330	213	0	46677
4867	656	85	516	44854	0	46111
4868	366	113	46385	623	0	47487
4869	307	94	566	45478	0	46445
4870	45550	93	465	672	0	46780
4871	632	93	206	46419	0	47350
4872	47002	117	172	689	0	47980
4873	665	97	152	47424	0	48338
4874	540	134	139	47858	0	48671
4875	47422	135	149	946	0	48652
4876	612	47525	174	606	0	48917
4877	47016	512	106	278	0	47912
4878	607	47296	133	330	0	48366
4879	494	550	112	47293	0	48449
4880	47165	393	117	623	0	48298
4881	642	165	47456	527	0	48790
4882	495	112	490	47352	0	48449
4883	47605	101	427	586	0	48719
4884	48783	115	188	449	0	49535
4885	969	102	136	47811	0	49018
4886	616	49492	169	555	0	50832
4887	289	48468	140	493	0	49390
4888	301	1628	100	44153	0	46182
4889	44426	362	116	450	0	45354
4890	448	43456	74	389	0	44367
4891	251	41571	71	160	0	42053
4892	39903	429	84	89	0	40505
4893	286	40391	43	120	0	40840
4894	41537	285	109	80	0	42011
4895	523	213	67	41137	0	41940
4896	256	75	22	40778	0	41131
4897	78	41427	50	449	0	42004
4898	49	41166	45	320	0	41580
4899	38714	376	34	75	0	39199
4900	217	40999	45	89	0	41350
4901	170	43869	46	91	0	44176
4902	171	509	59	43377	0	44116
4903	44492	309	29	347	0	45177
4904	392	84	47068	312	0	47856
4905	46385	43	450	96	0	46974
4906	491	36	358	50432	0	51317
4907	415	51	51779	543	0	52788
4908	137	63	52740	424	0	53364
4909	60	52	911	52499	0	53522
4910	90	63	54788	559	0	55500
4911	52926	34	643	504	0	54107
4912	54838	41	482	165	0	55526
4913	1014	54	55680	78	0	56826
4914	529	39	617	54348	0	55533
4915	153	47	487	55395	0	56082
4916	55746	35	152	1031	0	56964
4917	650	82	83	52277	0	53092
4918	502	54809	121	640	0	56072
4919	54081	571	59	511	0	55222
4920	612	55209	83	217	0	56121
4921	493	56493	87	162	0	57235
4922	226	996	80	55350	0	56652
4923	129	565	65	55594	0	56353
4924	143	163	53	56162	0	56521
4925	153	162	55088	1101	0	56504
4926	49474	135	614	656	0	50879
4927	610	54228	518	306	0	55662
4928	55028	637	133	174	0	55972
4929	54977	518	76	193	0	55764
4930	1121	165	76	53926	0	55288
4931	629	54817	90	664	0	56200
4932	236	664	91	55497	0	56488
4933	175	510	83	56063	0	56831
4934	56205	174	68	1155	0	57602
4935	55951	141	88	691	0	56871
4936	1167	165	55803	256	0	57391
4937	55406	122	606	232	0	56366
4938	761	56914	539	295	0	58509
4939	56371	710	138	173	0	57392
4940	780	59739	108	253	0	60880
4941	647	809	86	57326	0	58868
4942	304	624	79	56775	0	57782
4943	196	57047	88	1249	0	58580
4944	253	756	83	57839	0	58931
4945	192	672	75	57998	0	58937
4946	162	252	94	56834	0	57342
4947	181	56265	110	1417	0	57973
4948	202	782	78	56899	0	57961
4949	202	656	100	56950	0	57908
4950	197	262	92	57501	0	58052
4951	219	225	55810	1436	0	57690
4952	51703	222	745	951	0	53621
4953	835	216	56386	387	0	57824
4954	54434	172	778	356	0	55740
4955	920	207	56199	316	0	57642
4956	55024	193	829	299	0	56345
4957	55850	185	625	308	0	56968
4958	1331	217	55779	317	0	57644
4959	878	192	771	54171	0	56012
4960	405	196	54445	858	0	55904
4961	50444	186	865	782	0	52277
4962	927	211	54894	370	0	56402
4963	757	219	54290	350	0	55616
4964	51957	151	1285	353	0	53746
4965	854	53842	842	344	0	55882
4966	782	799	335	53447	0	55363
4967	54284	618	258	953	0	56113
4968	924	265	305	54071	0	55565
4969	796	164	296	54775	0	56031
4970	53906	179	296	1413	0	55794
4971	53993	144	282	966	0	55385
4972	1461	189	53351	478	0	55479
4973	957	173	53406	417	0	54953
4974	460	146	1394	52737	0	54737
4975	410	191	54261	1027	0	55889
4976	382	186	930	53188	0	54686
4977	438	149	821	53241	0	54649
4978	440	154	372	54574	0	55540
4979	52372	203	261	1573	0	54409
4980	933	53445	309	1023	0	55710
4981	53305	775	238	541	0	54859
4982	52636	685	203	511	0	54035
4983	1360	52607	256	564	0	54787
4984	50671	709	153	468	0	52001
4985	936	693	50133	401	0	52163
4986	771	426	698	48428	0	50323
4987	49214	221	582	920	0	50937
4988	826	313	48909	747	0	50795
4989	47619	190	665	453	0	48927
4990	858	50542	611	396	0	52407
4991	54755	647	275	371	0	56048
4992	54657	536	213	346	0	55752
4993	1514	56111	223	344	0	58192
4994	57041	810	194	315	0	58360
4995	1218	661	179	57485	0	59543
4996	946	282	163	58462	0	59853
4997	58048	189	162	1455	0	59854
4998	53859	229	173	935	0	55196
4999	1465	57653	195	525	0	59838
5000	891	57064	175	452	0	58582
5001	400	1577	158	49984	0	52119
5002	303	53825	174	724	0	55026
5003	278	54711	175	635	0	55799
5004	49715	1012	267	280	0	51274
5005	584	51021	121	281	0	52007
5006	47289	523	135	154	0	48101
5007	566	49639	70	192	0	50467
5008	582	565	48915	162	0	50224
5009	199	49864	451	199	0	50713
5010	48166	770	536	232	0	49704
5011	47209	359	162	108	0	47838
5012	751	155	47640	108	0	48654
5013	468	94	434	45705	0	46701
5014	210	71	345	47969	0	48595
5015	160	78	48153	708	0	49099
5016	133	97	425	46455	0	47110
5017	160	88	48422	535	0	49205
5018	124	96	47297	421	0	47938
5019	45067	69	685	220	0	46041
5020	447	47621	428	127	0	48623
5021	47372	416	145	96	0	48029
5022	536	360	87	47303	0	48286
5023	429	221	48287	423	0	49360
5024	226	104	418	45194	0	45942
5025	136	48882	354	446	0	49818
5026	49058	415	136	341	0	49950
5027	49006	355	109	164	0	49634
5028	745	159	75	49272	0	50251
5029	448	120	49113	430	0	50111
5030	45751	78	417	362	0	46608
5031	472	48681	342	186	0	49681
5032	48355	410	129	96	0	48990
5033	644	337	55	47896	0	48932
5034	47942	148	101	424	0	48615
5035	598	143	50	47763	0	48554
5036	477	164	48431	525	0	49597
5037	268	103	47651	421	0	48443
5038	44631	88	632	303	0	45654
5039	455	48846	381	226	0	49908
5040	47939	390	318	138	0	48785
5041	47879	326	79	109	0	48393
5042	590	48951	91	133	0	49765
5043	48541	457	35	111	0	49144
5044	523	419	53650	129	0	54721
5045	376	240	328	53730	0	54674
5046	224	187	267	54547	0	55225
5047	192	150	105	55187	0	55634
5048	226	202	54537	653	0	55618
5049	186	202	54903	365	0	55656
5050	168	173	625	52907	0	53873
5051	117	55033	443	390	0	55983
5052	144	56913	183	351	0	57591
5053	57121	641	113	168	0	58043
5054	57295	377	110	176	0	57958
5055	634	61709	183	204	0	62730
5056	400	446	97	62593	0	63536
5057	196	336	107	63303	0	63942
5058	65069	167	176	821	0	66233
5059	551	111	160	67841	0	68663
5060	462	130	152	67955	0	68699
5061	269	144	149	68271	0	68833
5062	246	215	65935	833	0	67229
5063	260	199	64075	522	0	65056
5064	64551	111	725	316	0	65703
5065	529	115	455	69696	0	70795
5066	462	175	70618	545	0	71800
5067	266	191	69084	424	0	69965
5068	67632	165	835	340	0	68972
5069	745	214	79320	241	0	80520
5070	546	81685	698	283	0	83212
5071	288	628	524	87595	0	89035
5072	281	587	88863	740	0	90471
5073	86521	218	777	628	0	88144
5074	872	191	601	93764	0	95428
5075	778	198	93598	900	0	95474
5076	333	131	824	93692	0	94980
5077	247	118	699	94615	0	95679
5078	95262	85	283	1447	0	97077
5079	873	97415	311	916	0	99515
5080	776	830	223	94887	0	96716
5081	97479	653	144	933	0	99209
5082	97890	224	146	746	0	99006
5083	99020	119	123	334	0	99596
5084	100380	147	165	297	0	100989
5085	1692	156	185	98607	0	100640
5086	99332	92	186	963	0	100573
5087	98615	82	201	800	0	99698
5088	96230	85	199	398	0	96912
5089	95847	101	173	355	0	96476
5090	1454	93447	253	331	0	95485
5091	527	87845	121	155	0	88648
5092	218	1122	108	85260	0	86708
5093	130	87924	127	578	0	88759
5094	87442	593	176	522	0	88733
5095	732	576	55	87509	0	88872
5096	88193	99	75	675	0	89042
5097	89521	66	83	646	0	90316
5098	1072	84	66	93941	0	95163
5099	591	52	70	92545	0	93258
5100	171	94388	133	1127	0	95819
5101	94526	567	92	636	0	95821
5102	658	95593	144	224	0	96619
5103	96303	616	78	244	0	97241
5104	726	517	61	96995	0	98299
5105	639	203	96997	740	0	98579
5106	94744	83	615	617	0	96059
5107	94003	187	550	266	0	95006
5108	1215	155	95630	166	0	97166
5109	722	167	96083	155	0	97127
5110	322	109	1038	91904	0	93373
5111	101759	81	523	810	0	103173
5112	107028	85	123	695	0	107931
5113	112279	99	88	283	0	112749
5114	112562	101	84	274	0	113021
5115	1501	112772	167	321	0	114761
5116	117159	815	100	321	0	118395
5117	1054	635	94	116917	0	118700
5118	898	167	99	119340	0	120504
5119	409	140	115	123391	0	124055
5120	322	130	103	124644	0	125199
5121	122287	138	129	1679	0	124233
5122	1109	127	102	127645	0	128983
5123	977	225	127173	1179	0	129554
5124	431	101	945	129085	0	130562
5125	402	141	781	130206	0	131530
5126	438	104	164	129914	0	130620
5127	383	148	159	128873	0	129563
5128	125642	119	136	1984	0	127881
5129	1175	127349	219	1264	0	130007
5130	1032	128519	270	451	0	130272
5131	463	1742	168	126189	0	128562
5132	126998	935	155	1190	0	129278
5133	128908	230	188	1061	0	130387
5134	2024	224	180	130308	0	132736
5135	1286	261	129116	1252	0	131915
5136	126222	163	1090	1212	0	128687
5137	1445	212	914	134140	0	136711
5138	1307	270	134778	1375	0	137730
5139	124280	159	1161	1325	0	126925
5140	1398	135015	1022	611	0	138046
5141	145363	1173	217	513	0	147266
5142	1861	151349	271	522	0	154003
5143	1676	1824	128	149088	0	152716
5144	599	153289	232	2207	0	156327
5145	619	2122	119	157537	0	160397
5146	150455	1552	194	2432	0	154633
5147	1930	154702	243	2140	0	159015
5148	1830	2002	154877	719	0	159428
5149	709	1631	1844	154661	0	158845
5150	655	472	158606	2283	0	162016
5151	644	329	2043	152717	0	155733
5152	613	312	1511	157491	0	159927
5153	632	322	156189	3369	0	160512
5154	132469	253	2130	2375	0	137227
5155	2326	290	154608	710	0	157934
5156	1887	344	152235	605	0	155071
5157	637	152572	3316	724	0	157249
5158	615	1984	1630	150317	0	154546
5159	553	1589	418	151031	0	153591
5160	544	485	304	149993	0	151326
5161	575	331	247	153429	0	154582
5162	490	393	149844	3731	0	154458
5163	130869	301	2126	2414	0	135710
5164	2346	295	150212	1007	0	153860
5165	1797	232	2077	145307	0	149413
5166	143408	208	1562	2309	0	147487
5167	1971	146291	612	2231	0	151105
5168	1689	2721	361	141512	0	146283
5169	136597	1400	363	2118	0	140478
5170	1926	134990	402	1782	0	139100
5171	1346	133078	301	696	0	135421
5172	129859	2720	322	604	0	133505
5173	1692	132815	307	595	0	135409
5174	128017	1790	337	552	0	130696
5175	1735	130988	362	595	0	133680
5176	130582	1816	262	518	0	133178
5177	129963	1354	252	537	0	132106
5178	2768	132972	406	1285	0	137431
5179	1659	1733	267	132238	0	135897
5180	644	1435	131355	1930	0	135364
5181	125877	453	1715	1565	0	129610
5182	1850	371	1323	127909	0	131453
5183	1478	129026	478	1972	0	132954
5184	509	131776	353	1646	0	134284
5185	453	2812	285	131055	0	134605
5186	129901	1428	288	2045	0	133662
5187	1888	593	131134	1613	0	135228
5188	1553	313	1729	131296	0	134891
5189	600	290	1343	133828	0	136061
5190	417	361	433	136048	0	137259
5191	444	306	313	132391	0	133454
5192	341	131452	406	3362	0	135561
5193	440	1751	329	133294	0	135814
5194	805	1505	129451	2191	0	133952
5195	491	672	127735	1643	0	130541
5196	505	568	129942	760	0	131775
5197	431	486	2877	124775	0	128569
5198	121525	454	1619	2005	0	125603
5199	2016	467	123398	1649	0	127530
5200	1632	574	124272	707	0	127185
5201	667	442	2925	118694	0	122728
5202	121938	384	1609	2108	0	126039
5203	1835	122001	763	1782	0	126381
5204	120908	1879	448	911	0	124146
5205	2081	1495	447	120490	0	124513
5206	1694	728	122663	2083	0	127168
5207	750	1167	1924	113698	0	117539
5208	552	122188	1637	2111	0	126488
5209	123845	1973	690	1597	0	128105
5210	2149	1643	124961	857	0	129610
5211	1402	119736	1907	849	0	123894
5212	116119	1889	1748	750	0	120506
5213	2160	1548	717	115381	0	119806
5214	1570	488	527	116355	0	118940
5215	116250	371	536	3157	0	120314
5216	115522	323	499	1971	0	118315
5217	119582	342	585	870	0	121379
5218	3509	452	508	112026	0	116495
5219	1864	113201	493	2207	0	117765
5220	113055	1854	421	1806	0	117136
5221	2028	114036	473	940	0	117477
5222	109733	1979	407	622	0	112741
5223	2085	107692	528	558	0	110863
5224	1632	1976	395	105711	0	109714
5225	107830	1511	332	2016	0	111689
5226	108473	680	292	1671	0	111116
5227	109598	469	212	862	0	111141
5228	110112	426	287	680	0	111505
5229	109633	415	295	521	0	110864
5230	3480	500	107268	485	0	111733
5231	2069	493	1755	104601	0	108918
5232	912	473	108087	1920	0	111392
5233	803	487	106330	1512	0	109132
5234	103310	490	2977	655	0	107432
5235	105188	454	1594	570	0	107806
5236	104826	450	539	479	0	106294
5237	3383	582	307	100422	0	104694
5238	99078	427	328	1914	0	101747
5239	2329	99405	347	1641	0	103722
5240	1783	100277	354	747	0	103161
5241	659	89147	224	430	0	90460
5242	80402	1844	520	321	0	83087
5243	1130	82429	260	354	0	84173
5244	78619	962	378	258	0	80217
5245	76925	844	145	272	0	78186
5246	1928	288	76928	235	0	79379
5247	1269	198	955	74358	0	76780
5248	573	183	834	78517	0	80107
5249	78847	156	247	1698	0	80948
5250	78663	177	180	1030	0	80050
5251	1942	169	162	77987	0	80260
5252	1279	211	77744	1063	0	80297
5253	633	228	78162	984	0	80007
5254	505	201	1693	77526	0	79925
5255	517	186	960	78128	0	79791
5256	489	185	266	79803	0	80743
5257	76971	192	170	1884	0	79217
5258	76685	220	163	1099	0	78167
5259	1917	76760	236	451	0	79364
5260	1312	1029	180	76345	0	78866
5261	633	967	165	75566	0	77331
5262	529	77007	240	1786	0	79562
5263	576	1068	185	77398	0	79227
5264	76913	925	211	1251	0	79300
5265	1369	302	227	76848	0	78746
5266	1304	194	228	77124	0	78850
5267	75300	212	211	1939	0	77662
5268	75270	189	216	1200	0	76875
5269	75850	218	246	539	0	76853
5270	2308	437	329	73217	0	76291
5271	1395	275	70778	1152	0	73600
5272	754	252	69912	1069	0	71987
5273	636	277	69614	490	0	71017
5274	539	66882	1759	535	0	69715
5275	64880	1081	1266	470	0	67697
5276	1321	884	63792	376	0	66373
5277	61420	268	877	383	0	62948
5278	1307	210	840	61021	0	63378
5279	61113	202	320	1069	0	62704
5280	61335	228	246	1094	0	62903
5281	1747	61899	250	539	0	64435
5282	62986	872	211	441	0	64510
5283	62293	799	208	508	0	63808
5284	1826	61822	272	532	0	64452
5285	1312	844	243	62375	0	64774
5286	757	850	62539	1102	0	65248
5287	652	264	898	60778	0	62592
5288	578	245	849	61587	0	63259
5289	60106	260	315	1789	0	62470
5290	1346	223	251	59716	0	61536
5291	1208	61659	299	1165	0	64331
5292	632	996	243	60963	0	62834
5293	580	897	271	61981	0	63729
5294	637	378	60812	1837	0	63664
5295	589	59995	996	1296	0	62876
5296	612	61034	890	679	0	63215
5297	57934	1569	323	482	0	60308
5298	1183	61396	328	632	0	63539
5299	1233	1054	300	60204	0	62791
5300	733	962	60644	1180	0	63519
5301	572	60983	1061	1156	0	63772
5302	60149	984	987	567	0	62687
5303	1256	955	406	59919	0	62536
5304	1260	367	318	61098	0	63043
5305	700	301	60076	1849	0	62926
5306	562	287	972	57636	0	59457
5307	601	276	912	58710	0	60499
5308	56799	259	388	1887	0	59333
5309	51962	208	249	1198	0	53617
5310	1700	51569	231	714	0	54214
5311	47008	724	205	473	0	48410
5312	1008	46122	213	484	0	47827
5313	802	1062	197	40375	0	42436
5314	380	43027	221	819	0	44447
5315	387	43540	211	812	0	44950
5316	40474	1070	468	487	0	42499
5317	38601	559	190	440	0	39790
5318	898	38173	179	349	0	39599
5319	38359	482	192	312	0	39345
5320	38126	438	146	339	0	39049
5321	39202	200	139	326	0	39867
5322	961	168	128	38952	0	40209
5323	39273	200	135	623	0	40231
5324	692	207	37650	532	0	39081
5325	36872	178	494	314	0	37858
5326	689	218	38142	285	0	39334
5327	586	201	530	37254	0	38571
5328	315	203	420	38789	0	39727
5329	314	221	38715	874	0	40124
5330	36885	164	497	578	0	38124
5331	38418	175	415	295	0	39303
5332	943	190	39796	274	0	41203
5333	579	160	481	38522	0	39742
5334	331	142	412	39500	0	40385
5335	274	130	189	40179	0	40772
5336	39132	156	134	914	0	40336
5337	39011	163	175	584	0	39933
5338	927	147	159	36649	0	37882
5339	474	36021	145	530	0	37170
5340	216	34676	126	437	0	35455
5341	31844	537	143	205	0	32729
5342	420	32718	113	219	0	33470
5343	324	31314	111	175	0	31924
5344	257	418	85	27515	0	28275
5345	130	194	27707	222	0	28253
5346	87	27311	185	223	0	27806
5347	118	398	176	26213	0	26905
5348	74	27080	74	219	0	27447
5349	101	168	73	26356	0	26698
5350	26410	137	48	217	0	26812
5351	159	27070	54	198	0	27481
5352	27220	149	30	117	0	27516
5353	26648	142	36	85	0	26911
5354	259	79	26479	96	0	26913
5355	25789	58	133	103	0	26083
5356	204	74	112	26775	0	27165
5357	153	82	27182	179	0	27596
5358	86	27379	130	174	0	27769
5359	89	232	107	26804	0	27232
5360	69	112	32	26958	0	27171
5361	26848	53	27	216	0	27144
5362	161	54	30	26920	0	27165
5363	156	68	18	26977	0	27219
5364	26946	47	25	239	0	27257
5365	150	27079	56	161	0	27446
5366	26727	136	32	113	0	27008
5367	172	146	26733	60	0	27111
5368	24537	50	129	102	0	24818
5369	197	74	28038	68	0	28377
5370	156	28665	142	74	0	29037
5371	28790	132	111	68	0	29101
5372	27846	110	55	74	0	28085
5373	257	87	28702	71	0	29117
5374	181	58	29627	65	0	29931
5375	119	59	31397	72	0	31647
5376	83	32129	279	95	0	32586
5377	87	189	162	32449	0	32887
5378	102	167	36638	205	0	37112
5379	89	81	36112	164	0	36446
5380	98	66	454	35205	0	35823
5381	113	77	37133	269	0	37592
5382	35177	41	307	272	0	35797
5383	40431	42	235	111	0	40819
5384	603	87	40509	75	0	41274
5385	327	40543	396	173	0	41439
5386	135	353	282	39815	0	40585
5387	155	309	41104	366	0	41934
5388	89	41282	383	331	0	42085
5389	159	494	297	40498	0	41448
5390	40328	253	94	377	0	41052
5391	39195	59	65	274	0	39593
5392	526	40986	90	144	0	41746
5393	286	364	57	40953	0	41660
5394	111	257	49	41296	0	41713
5395	95	68	65	41183	0	41411
5396	105	66	42	41305	0	41518
5397	86	82	40889	611	0	41668
5398	99	59	329	40045	0	40532
5399	59	81	39961	390	0	40491
5400	40	39262	368	334	0	40004
5401	38320	312	240	115	0	38987
5402	273	40771	95	135	0	41274
5403	253	328	57	40585	0	41223
5404	92	238	39	40719	0	41088
5405	40503	79	35	537	0	41154
5406	321	54	35	40094	0	40504
5407	228	40442	48	363	0	41081
5408	68	291	34	41194	0	41587
5409	53	236	32	41175	0	41496
5410	40520	58	53	544	0	41175
5411	339	85	40192	284	0	40900
5412	222	40075	310	134	0	40741
5413	63	40734	228	123	0	41148
5414	86	482	45	39621	0	40234
5415	39101	243	33	307	0	39684
5416	268	39654	52	307	0	40281
5417	221	309	33	39965	0	40528
5418	87	263	39567	338	0	40255
5419	70	74	303	39234	0	39681
5420	39946	53	219	346	0	40564
5421	38898	63	55	288	0	39304
5422	508	34	42	39238	0	39822
5423	40037	34	43	354	0	40468
5424	39275	55	57	278	0	39665
5425	546	84	39557	81	0	40268
5426	37964	43	301	112	0	38420
5427	325	39720	252	108	0	40405
5428	40124	287	57	97	0	40565
5429	405	286	39360	61	0	40112
5430	271	63	324	39645	0	40303
5431	41038	45	272	376	0	41731
5432	379	76	39194	284	0	39933
5433	310	74	39730	83	0	40197
5434	123	36	580	38423	0	39162
5435	94	67	40374	367	0	40902
5436	39043	37	406	318	0	39804
5437	422	96	41108	87	0	41713
5438	326	40	419	41410	0	42195
5439	103	42	310	42932	0	43387
5440	44137	43	152	668	0	45000
5441	471	72	44739	380	0	45662
5442	373	74	46886	126	0	47459
5443	126	43	783	48769	0	49721
5444	135	80	50180	553	0	50948
5445	48436	47	619	429	0	49531
5446	541	45	499	48945	0	50030
5447	459	68	50400	574	0	51501
5448	170	22	633	49455	0	50280
5449	160	52	472	50285	0	50969
5450	50341	65	137	891	0	51434
5451	611	59	50543	494	0	51707
5452	48115	60	613	209	0	48997
5453	650	95	52114	183	0	53042
5454	50378	70	647	192	0	51287
5455	51384	85	470	149	0	52088
5456	51360	50	154	179	0	51743
5457	932	50346	178	214	0	51670
5458	51076	514	100	175	0	51865
5459	50691	397	95	176	0	51359
5460	991	75	100	50305	0	51471
5461	530	101	50235	659	0	51525
5462	48249	71	572	559	0	49451
5463	660	71	51527	241	0	52499
5464	503	75	674	49578	0	50830
5465	186	56	484	51691	0	52417
5466	51365	52	195	948	0	52560
5467	603	52770	188	539	0	54100
5468	506	543	111	52055	0	53215
5469	236	427	101	52214	0	52978
5470	178	139	51951	981	0	53249
5471	177	76	539	51177	0	51969
5472	203	85	419	52273	0	52980
5473	209	55	127	49674	0	50065
5474	135	50495	157	988	0	51775
5475	48605	465	126	498	0	49694
5476	48230	365	117	240	0	48952
5477	843	48604	144	236	0	49827
5478	44542	394	92	131	0	45159
5479	527	375	76	45774	0	46752
5480	412	78	48493	486	0	49469
5481	117	49119	486	389	0	50111
5482	143	49897	352	288	0	50680
5483	48557	543	241	113	0	49454
5484	50118	268	103	109	0	50598
5485	676	59	83	51051	0	51869
5486	393	47	83	51865	0	52388
5487	136	40	76	51850	0	52102
5488	50555	41	86	755	0	51437
5489	488	64	50688	405	0	51645
5490	50200	41	457	169	0	50867
5491	506	54	367	50954	0	51881
5492	399	41	127	50064	0	50631
5493	148	50918	133	752	0	51951
5494	180	416	97	51835	0	52528
5495	148	322	113	52143	0	52726
5496	215	110	52476	774	0	53575
5497	140	52876	483	492	0	53991
5498	53865	395	369	224	0	54853
5499	52959	317	139	189	0	53604
5500	54371	84	105	163	0	54723
5501	54203	79	127	173	0	54582
5502	818	113	52619	135	0	53685
5503	51407	66	470	172	0	52115
5504	595	90	53303	182	0	54170
5505	474	59	485	50969	0	51987
5506	193	53395	417	570	0	54575
5507	220	418	125	53551	0	54314
5508	190	341	134	53936	0	54601
5509	210	129	53835	834	0	55008
5510	50485	81	494	554	0	51614
5511	52843	80	394	263	0	53580
5512	793	52919	188	333	0	54233
5513	524	440	53405	268	0	54637
5514	247	349	495	53057	0	54148
5515	243	172	54227	578	0	55220
5516	265	139	53252	499	0	54155
5517	258	112	752	52511	0	53633
5518	271	136	53500	561	0	54468
5519	243	107	479	52802	0	53631
5520	286	118	54730	623	0	55757
5521	232	122	505	54322	0	55181
5522	55145	94	391	604	0	56234
5523	54996	71	173	509	0	55749
5524	54855	76	122	287	0	55340
5525	54357	115	136	246	0	54854
5526	829	55120	157	303	0	56409
5527	489	435	115	54420	0	55459
5528	260	334	132	54959	0	55685
5529	250	193	54635	815	0	55893
5530	235	149	485	53161	0	54030
5531	193	166	54060	622	0	55041
5532	211	122	52204	471	0	53008
5533	49562	104	717	297	0	50680
5534	486	54769	416	296	0	55967
5535	54942	417	179	270	0	55808
5536	54758	335	156	236	0	55485
5537	753	56825	159	267	0	58004
5538	56653	373	158	277	0	57461
5539	575	343	57510	229	0	58657
5540	359	57102	419	237	0	58117
5541	56381	345	448	252	0	57426
5542	429	309	55630	170	0	56538
5543	51483	115	355	185	0	52138
5544	307	54947	283	205	0	55742
5545	55198	251	110	198	0	55757
5546	54566	210	102	162	0	55040
5547	468	55057	141	199	0	55865
5548	289	55632	146	169	0	56236
5549	152	58356	133	168	0	58809
5550	202	436	137	58935	0	59710
5551	137	243	113	59894	0	60387
5552	60871	71	154	531	0	61627
5553	60047	59	140	381	0	60627
5554	523	113	61600	189	0	62425
5555	351	124	61149	169	0	61793
5556	179	116	63055	163	0	63513
5557	173	69	557	62585	0	63384
5558	219	120	65350	396	0	66085
5559	182	54	347	64421	0	65004
5560	66098	83	314	447	0	66942
5561	472	111	68049	304	0	68936
5562	66143	68	377	209	0	66797
5563	68563	95	301	191	0	69150
5564	649	140	70677	180	0	71646
5565	335	73712	437	278	0	74762
5566	164	311	340	74135	0	74950
5567	160	368	74677	434	0	75639
5568	187	85	416	73108	0	73796
5569	179	66	358	77608	0	78211
5570	76588	75	168	694	0	77525
5571	453	102	131	76998	0	77684
5572	433	174	77425	467	0	78499
5573	177	88	409	77137	0	77811
5574	78245	76	410	489	0	79220
5575	446	80775	203	455	0	81879
5576	81275	376	182	204	0	82037
5577	541	469	190	81688	0	82888
5578	526	203	82760	445	0	83934
5579	268	151	82662	386	0	83467
5580	344	177	82438	255	0	83214
5581	126	81792	750	224	0	82892
5582	79380	714	664	245	0	81003
5583	391	79486	185	223	0	80285
5584	76584	304	111	140	0	77139
5585	327	78486	137	139	0	79089
5586	344	344	64	79038	0	79790
5587	104	289	78	79768	0	80239
5588	108	78	67	79814	0	80067
5589	64	80652	116	690	0	81522
5590	133	348	75	84093	0	84649
5591	142	322	62	93482	0	94008
5592	97903	66	84	964	0	99017
5593	811	60	105	102411	0	103387
5594	617	138	107990	890	0	109635
5595	104054	70	954	714	0	105792
5596	108344	77	673	202	0	109296
5597	1475	110545	246	386	0	112652
5598	111194	942	90	228	0	112454
5599	113485	705	104	218	0	114512
5600	1778	145	116	113045	0	115084
5601	936	122	103	114918	0	116079
5602	299	94	122	117844	0	118359
5603	117354	106	125	1924	0	119509
5604	117629	94	121	1036	0	118880
5605	2012	202	118261	256	0	120731
5606	116280	117	1110	292	0	117799
5607	117651	111	812	284	0	118858
5608	118280	95	200	291	0	118866
5609	2132	169	116390	291	0	118982
5610	1098	181	116641	269	0	118189
5611	423	87	1866	115769	0	118145
5612	461	183	119490	1284	0	121418
5613	427	104	1265	115999	0	117795
5614	604	185	943	104488	0	106220
5615	373	118575	416	1844	0	121208
5616	118104	1127	301	979	0	120511
5617	1521	907	119814	299	0	122541
5618	116299	194	1374	322	0	118189
5619	1592	208	977	121101	0	123878
5620	118932	151	329	1478	0	120890
5621	1553	119120	307	1222	0	122202
5622	1200	121320	299	691	0	123510
5623	625	2088	496	119811	0	123020
5624	519	1003	221	121467	0	123210
5625	602	373	120468	2378	0	123821
5626	634	164	1417	119401	0	121616
5627	116747	158	1133	1672	0	119710
5628	1607	118110	475	1548	0	121740
5629	1438	1408	118254	541	0	121641
5630	720	1049	1456	116587	0	119812
5631	600	336	119673	1612	0	122221
5632	520	226	1621	116450	0	118817
5633	543	238	119735	1781	0	122297
5634	523	270	116543	1277	0	118613
5635	499	310	2311	113759	0	116879
5636	115727	216	1235	1620	0	118798
5637	113272	294	474	1218	0	115258
5638	112047	249	391	565	0	113252
5639	2383	111152	517	655	0	114707
5640	111037	1315	354	575	0	113281
5641	109353	1001	399	606	0	111359
5642	2472	401	108251	609	0	111733
5643	1336	107056	1504	649	0	110545
5644	702	1499	1174	104118	0	107493
5645	104727	1034	429	1609	0	107799
5646	1635	105273	446	1356	0	108710
5647	106459	1372	408	640	0	108879
5648	105734	1034	405	606	0	107779
5649	104041	450	397	571	0	105459
5650	103005	334	441	506	0	104286
5651	2519	339	438	99891	0	103187
5652	100011	290	437	1681	0	102419
5653	1776	311	403	97384	0	99874
5654	1321	96341	513	1717	0	99892
5655	676	1265	465	96763	0	99169
5656	95604	899	484	1642	0	98629
5657	1777	384	95086	1310	0	98557
5658	1513	181	1374	93920	0	96988
5659	93275	232	1081	1600	0	96188
5660	1793	92717	535	1317	0	96362
5661	91999	1302	385	594	0	94280
5662	91257	979	399	532	0	93167
5663	2396	90986	483	625	0	94490
5664	89789	1303	468	530	0	92090
5665	1918	1008	85473	449	0	88848
5666	1437	440	84830	501	0	87208
5667	81444	351	2098	528	0	84421
5668	1840	399	83357	561	0	86157
5669	1539	384	1319	74758	0	78000
5670	935	79852	964	1311	0	83062
5671	79357	1231	432	982	0	82002
5672	1720	79327	454	530	0	82031
5673	1418	79269	424	570	0	81681
5674	971	1861	440	78592	0	81864
5675	758	912	425	77875	0	79970
5676	732	403	387	77293	0	78815
5677	745	347	353	76706	0	78151
5678	660	390	73785	2132	0	76967
5679	648	334	1255	70425	0	72662
5680	668	340	899	70763	0	72670
5681	68735	333	412	1946	0	71426
5682	1514	360	323	68920	0	71117
5683	1231	374	67325	1398	0	70328
5684	64322	313	1216	1029	0	66880
5685	1628	352	837	65629	0	68446
5686	1193	382	65514	1310	0	68399
5687	769	613	1285	61054	0	63721
5688	634	64822	974	1229	0	67659
5689	63816	1097	458	941	0	66312
5690	1425	796	60239	410	0	62870
5691	820	48796	900	349	0	50865
5692	42295	697	771	302	0	44065
5693	633	37494	269	215	0	38611
5694	376	32065	167	180	0	32788
5695	30495	560	525	144	0	31724
5696	465	29275	156	143	0	30039
5697	279	27459	95	137	0	27970
5698	766	568	356	25775	0	27465
5699	193	202	25636	285	0	26316
5700	126	25680	255	225	0	26286
5701	217	396	156	22795	0	23564
5702	107	23414	63	192	0	23776
5703	22677	177	55	162	0	23071
5704	226	143	22541	147	0	23057
5705	204	77	152	22155	0	22588
5706	22823	53	132	208	0	23216
5707	208	65	66	23445	0	23784
5708	186	58	23515	210	0	23969
5709	22339	57	190	190	0	22776
5710	23528	64	146	89	0	23827
5711	298	24701	77	91	0	25167
5712	198	177	47	24257	0	24679
5713	101	156	42	24986	0	25285
5714	25353	62	55	272	0	25742
5715	24765	52	60	185	0	25062
5716	321	76	25447	85	0	25929
5717	188	24924	153	60	0	25325
5718	24385	113	116	74	0	24688
5719	156	120	39	24277	0	24592
5720	140	45	25014	143	0	25342
5721	50	56	24465	129	0	24700
5722	104	329	210	23096	0	23739
5723	23585	18	124	110	0	23837
5724	98	23732	23	106	0	23959
5725	25499	96	22	72	0	25689
5726	110	90	23	25907	0	26130
5727	101	25	20	26186	0	26332
5728	29	18	24	26584	0	26655
5729	25831	8	21	196	0	26056
5730	79	26836	32	127	0	27074
5731	102	92	16	27230	0	27440
5732	27	85	5	27070	0	27187
5733	28	28	27437	152	0	27645
5734	25	11	89	26740	0	26865
5735	31	45	27888	120	0	28084
5736	20	27341	103	106	0	27570
5737	33	80	74	26943	0	27130
5738	26661	65	21	84	0	26831
5739	90	25	27241	65	0	27421
5740	81	3	69	27075	0	27228
5741	32	22	27526	77	0	27657
5742	25126	11	85	100	0	25322
5743	93	24	27956	20	0	28093
5744	73	10	84	26704	0	26871
5745	27500	10	68	84	0	27662
5746	73	26164	29	124	0	26390
5747	26513	81	9	38	0	26641
5748	85	26520	20	35	0	26660
5749	78	81	7	27157	0	27323
5750	27	91	27133	88	0	27339
5751	35	47	27645	89	0	27816
5752	20	8	155	27216	0	27399
5753	28482	13	89	112	0	28696
5754	28250	9	31	112	0	28402
5755	161	9	19	28075	0	28264
5756	97	14	14	28853	0	28978
5757	28070	10	10	177	0	28267
5758	78	28852	25	139	0	29094
5759	103	30321	16	66	0	30506
5760	30054	147	14	58	0	30273
5761	106	111	30573	51	0	30841
5762	120	21	82	29768	0	29991
5763	51	41	31295	101	0	31488
5764	32	21	100	30541	0	30694
5765	43	32	32115	118	0	32308
5766	36	45	32137	122	0	32340
5767	43	15	186	31323	0	31567
5768	23	32191	129	97	0	32440
5769	32818	92	39	120	0	33069
5770	104	33214	44	65	0	33427
5771	125	112	22	33313	0	33572
5772	33689	101	30	135	0	33955
5773	133	27	32	34717	0	34909
5774	35223	18	31	163	0	35435
5775	35314	27	24	142	0	35507
5776	35644	20	24	68	0	35756
5777	218	35536	42	88	0	35884
5778	36772	107	31	66	0	36976
5779	150	189	31	38457	0	38827
5780	40067	35	28	226	0	40356
5781	185	33	43	41523	0	41784
5782	41594	30	40	264	0	41928
5783	41944	24	41	231	0	42240
5784	325	42688	66	181	0	43260
5785	230	187	36	46614	0	47067
5786	89	207	27	46634	0	46957
5787	60	50036	57	508	0	50661
5788	77	317	37	50925	0	51356
5789	50591	257	50	453	0	51351
5790	53018	69	40	371	0	53498
5791	52382	51	56	165	0	52654
5792	655	71	55932	126	0	56784
5793	56593	37	382	166	0	57178
5794	59344	50	318	107	0	59819
5795	59555	33	109	140	0	59837
5796	747	60117	73	110	0	61047
5797	425	400	64	60661	0	61550
5798	181	335	44	61716	0	62276
5799	125	100	65	61765	0	62055
5800	123	84	60296	820	0	61323
5801	114	58	430	60844	0	61446
5802	60977	47	369	597	0	61990
5803	480	55	127	61827	0	62489
5804	453	70	61	63280	0	63864
5805	238	77	62888	848	0	64051
5806	134	62826	492	588	0	64040
5807	64487	443	366	243	0	65539
5808	544	397	129	64367	0	65437
5809	64889	120	86	576	0	65671
5810	616	129	64866	467	0	66078
5811	60187	77	478	297	0	61039
5812	619	66793	416	344	0	68172
5813	531	466	66407	190	0	67594
5814	277	418	66976	145	0	67816
5815	224	247	804	63581	0	64856
5816	220	116	69618	610	0	70564
5817	178	69888	542	557	0	71165
5818	198	476	392	69351	0	70417
5819	177	389	150	70543	0	71259
5820	162	133	86	71097	0	71478
5821	69420	90	114	927	0	70551
5822	486	70678	134	641	0	71939
5823	482	439	108	71357	0	72386
5824	221	405	93	72638	0	73357
5825	71038	145	92	923	0	72198
5826	537	72392	145	709	0	73783
5827	73743	460	107	380	0	74690
5828	73474	407	122	295	0	74298
5829	73076	177	107	345	0	73705
5830	1053	176	73069	239	0	74537
5831	680	137	487	69980	0	71284
5832	338	73830	450	647	0	75265
5833	285	75615	240	640	0	76780
5834	369	827	137	71760	0	73093
5835	237	77390	168	593	0	78388
5836	79284	565	166	712	0	80727
5837	663	523	79108	368	0	80662
5838	76533	234	514	419	0	77700
5839	80623	157	472	369	0	81621
5840	971	204	233	81571	0	82979
5841	82046	171	165	782	0	83164
5842	748	88534	219	752	0	90253
5843	90409	572	153	547	0	91681
5844	90540	519	190	439	0	91688
5845	95889	297	205	493	0	96884
5846	1429	275	96561	365	0	98630
5847	1004	381	98450	414	0	100249
5848	594	235	1210	97370	0	99409
5849	484	99658	817	927	0	101886
5850	532	102266	370	907	0	104075
5851	499	1244	254	101233	0	103230
5852	102069	846	225	1093	0	104233
5853	953	346	261	102438	0	103998
5854	834	287	243	104002	0	105366
5855	103118	250	260	1616	0	105244
5856	963	104448	347	1438	0	107196
5857	975	859	104337	655	0	106826
5858	600	797	103409	543	0	105349
5859	106142	331	1316	545	0	108334
5860	1015	357	815	105242	0	107429
5861	935	343	110178	1060	0	112516
5862	582	277	877	106835	0	108571
5863	494	297	726	109247	0	110764
5864	519	256	399	111286	0	112460
5865	500	314	283	109118	0	110215
5866	446	109034	366	1682	0	111528
5867	465	857	330	109982	0	111634
5868	109270	750	321	1241	0	111582
5869	981	109301	472	1071	0	111825
5870	113416	878	373	691	0	115358
5871	114800	772	324	676	0	116572
5872	115939	403	351	660	0	117353
5873	1660	472	113715	481	0	116328
5874	113227	377	848	640	0	115092
5875	117038	303	778	554	0	118673
5876	117192	330	381	562	0	118465
5877	117030	268	266	582	0	118146
5878	1616	117103	372	601	0	119692
5879	115480	860	234	510	0	117084
5880	1223	859	115934	431	0	118447
5881	1006	345	739	112919	0	115009
5882	639	275	620	116716	0	118250
5883	119852	235	295	1410	0	121792
5884	1080	119839	291	1039	0	122249
5885	116490	724	181	442	0	117837
5886	908	120527	283	499	0	122217
5887	119832	652	173	403	0	121060
5888	118690	487	154	289	0	119620
5889	1137	133043	232	462	0	134874
5890	135018	877	188	267	0	136350
5891	138823	672	177	294	0	139966
5892	1662	135518	232	306	0	137718
5893	833	140786	231	323	0	142173
5894	148215	1527	370	294	0	150406
5895	1632	855	130	151116	0	153733
5896	154891	294	138	1516	0	156839
5897	159135	177	100	1036	0	160448
5898	160904	171	83	426	0	161584
5899	159317	180	116	330	0	159943
5900	2395	158569	259	471	0	161694
5901	1185	162595	247	534	0	164561
5902	163283	2157	141	298	0	165879
5903	1789	1233	165283	169	0	168474
5904	1186	397	1501	160578	0	163662
5905	486	258	957	167130	0	168831
5906	165265	192	237	2525	0	168219
5907	1544	166857	300	1493	0	170194
5908	1264	1512	125	166183	0	169084
5909	503	1101	109	170793	0	172506
5910	169899	332	124	2718	0	173073
5911	1839	263	130	170950	0	173182
5912	171886	235	178	2010	0	174309
5913	171068	216	180	1368	0	172832
5914	171272	213	168	551	0	172204
5915	3037	237	126	169325	0	172725
5916	1583	243	156	170387	0	172369
5917	786	360	178799	2735	0	182680
5918	638	403	174427	1476	0	176944
5919	174285	228	3385	615	0	178513
5920	2329	234	1588	181812	0	185963
5921	1856	360	189567	2371	0	194154
5922	800	376	189365	1743	0	192284
5923	664	559	3922	187668	0	192813
5924	867	432	190633	2669	0	194601
5925	730	295	2722	186274	0	190021
5926	629	273	1806	188664	0	191372
5927	659	395	190490	4157	0	195701
5928	638	214	2546	188787	0	192185
5929	665	240	1773	188518	0	191196
5930	770	274	563	193277	0	194884
5931	741	419	190129	4558	0	195847
5932	800	335	2483	191460	0	195078
5933	191609	284	1821	3276	0	196990
5934	2835	192082	784	2560	0	198261
5935	194584	2554	453	959	0	198550
5936	3490	1984	191279	733	0	197486
5937	191142	517	2753	684	0	195096
5938	194017	430	1959	697	0	197103
5939	193349	496	693	676	0	195214
5940	5000	487	538	188891	0	194916
5941	2945	412	540	191603	0	195500
5942	1376	470	182047	4803	0	188696
5943	167470	316	2820	2808	0	173414
5944	3375	177625	2199	1274	0	184473
5945	2345	170849	802	1117	0	175113
5946	1172	175774	584	1061	0	178591
5947	1441	4134	658	168961	0	175194
5948	167959	2045	555	2955	0	173514
5949	167372	652	538	2349	0	170911
5950	4671	639	165622	1186	0	172118
5951	2703	472	2673	162321	0	168169
5952	1373	479	1928	164906	0	168686
5953	1230	708	163884	4595	0	170417
5954	1114	596	161389	2659	0	165758
5955	156345	440	4200	1450	0	162435
5956	3012	161334	2385	1500	0	168231
5957	162886	2565	868	1323	0	167642
5958	162605	1830	672	1141	0	166248
5959	4824	647	696	159128	0	165295
5960	3013	420	595	162207	0	166235
5961	157957	406	569	4714	0	163646
5962	3520	423	635	158198	0	162776
5963	2589	380	764	158754	0	162487
5964	157143	280	789	4898	0	163110
5965	3419	297	840	157976	0	162532
5966	158542	303	857	3698	0	163400
5967	158477	336	913	2877	0	162603
5968	4722	505	156136	1556	0	162919
5969	156067	424	3126	1455	0	161072
5970	154961	329	2414	1460	0	159164
5971	154331	286	1183	1599	0	157399
5972	4954	452	144028	1561	0	150995
5973	145882	299	2899	1548	0	150628
5974	3434	146317	2342	1895	0	153988
5975	148982	2353	1101	1710	0	154146
5976	149485	1639	989	1696	0	153809
5977	4801	454	965	147111	0	153331
5978	2990	328	964	145881	0	150163
5979	1560	146924	1095	4987	0	154566
5980	1599	2522	883	146671	0	151675
5981	1666	1779	854	148388	0	152687
5982	144512	566	914	5022	0	151014
5983	3662	453	963	142116	0	147194
5984	3028	361	833	142173	0	146395
5985	1729	449	885	139855	0	142918
5986	1508	133708	1037	5148	0	141401
5987	129532	2409	919	3138	0	135998
5988	3415	131193	1055	1919	0	137582
5989	116386	2318	950	1390	0	121044
5990	3251	1671	111520	1313	0	117755
5991	102737	546	2336	1217	0	106836
5992	2989	488	105969	1229	0	110675
5993	2185	100255	2420	1287	0	106147
5994	90910	1928	2973	1180	0	96991
5995	87493	1292	951	980	0	90716
5996	2901	84703	597	978	0	89179
5997	1823	83045	553	872	0	86293
5998	80632	2200	685	794	0	84311
5999	81276	1306	410	654	0	83646
6000	2922	489	370	79247	0	83028
6001	1878	449	377	80628	0	83332
6002	1149	494	78591	2618	0	82852
6003	74182	413	1446	1590	0	77631
6004	2188	364	1160	74056	0	77768
6005	1752	75500	619	1750	0	79621
6006	1036	1380	281	74529	0	77226
6007	912	1066	256	74350	0	76584
6008	838	497	72107	2568	0	76010
6009	840	506	1304	71845	0	74495
6010	69887	390	1001	1891	0	73169
6011	1714	68807	457	1532	0	72510
6012	1375	68320	364	793	0	70852
6013	67663	2021	377	623	0	70684
6014	67483	1166	357	580	0	69586
6015	67255	456	320	526	0	68557
6016	2572	65263	384	549	0	68768
6017	991	55167	216	378	0	56752
6018	56397	1248	388	320	0	58353
6019	56647	755	276	326	0	58004
6020	1550	54940	233	352	0	57075
6021	538	46571	108	229	0	47446
6022	45668	812	246	200	0	46926
6023	671	469	75	45000	0	46215
6024	45958	142	59	563	0	46722
6025	678	186	57	45087	0	46008
6026	520	47266	78	564	0	48428
6027	292	47178	75	478	0	48023
6028	48186	867	157	200	0	49410
6029	49250	500	86	178	0	50014
6030	49399	154	100	187	0	49840
6031	1037	48536	94	183	0	49850
6032	543	528	45159	106	0	46336
6033	159	45374	438	125	0	46096
6034	43740	657	509	103	0	45009
6035	42017	373	120	104	0	42614
6036	729	155	41617	81	0	42582
6037	348	40675	399	134	0	41556
6038	193	430	373	40430	0	41426
6039	138	325	67	38784	0	39314
6040	101	39218	83	608	0	40010
6041	154	427	39612	308	0	40501
6042	39346	338	383	110	0	40177
6043	445	117	265	40631	0	41458
6044	40852	84	56	408	0	41400
6045	40877	101	46	340	0	41364
6046	709	103	55	41785	0	42652
6047	423	98	40	43722	0	44283
6048	182	99	46	44833	0	45160
6049	159	97	42	45283	0	45581
6050	44118	89	64	874	0	45145
6051	44386	95	47	495	0	45023
6052	885	119	44752	182	0	45938
6053	516	115	467	44473	0	45571
6054	221	102	387	45279	0	45989
6055	154	94	106	45779	0	46133
6056	199	119	44853	907	0	46078
6057	183	95	481	44429	0	45188
6058	43929	81	405	610	0	45025
6059	588	94	117	44237	0	45036
6060	505	139	44213	618	0	45475
6061	233	99	499	44234	0	45065
6062	168	135	44523	647	0	45473
6063	44202	105	518	526	0	45351
6064	607	107	423	44728	0	45865
6065	45195	94	148	596	0	46033
6066	44463	109	80	521	0	45173
6067	949	101	89	44450	0	45589
6068	45141	104	79	670	0	45994
6069	679	109	76	43926	0	44790
6070	536	46812	113	641	0	48102
6071	48220	534	84	523	0	49361
6072	48126	469	69	239	0	48903
6073	48647	140	73	214	0	49074
6074	1118	109	79	47905	0	49211
6075	630	118	83	48113	0	48944
6076	274	104	77	48723	0	49178
6077	256	115	46798	1116	0	48285
6078	213	46238	579	729	0	47759
6079	232	560	457	44941	0	46190
6080	273	468	44451	654	0	45846
6081	43181	125	538	582	0	44426
6082	643	86	460	44170	0	45359
6083	555	131	43984	682	0	45352
6084	43687	71	511	627	0	44896
6085	630	87	438	44926	0	46081
6086	580	69	123	45216	0	45988
6087	246	58	87	45778	0	46169
6088	45086	66	99	1074	0	46325
6089	45416	91	97	626	0	46230
6090	44788	74	97	299	0	45258
6091	992	43560	162	277	0	44991
6092	574	43830	142	261	0	44807
6093	43609	811	99	230	0	44749
6094	698	457	43419	202	0	44776
6095	572	112	486	42313	0	43483
6096	285	129	448	43236	0	44098
6097	42627	80	118	970	0	43795
6098	41441	49	97	629	0	42216
6099	950	41755	108	316	0	43129
6100	612	467	86	41609	0	42774
6101	289	416	41198	654	0	42557
6102	256	128	41544	587	0	42515
6103	248	68	829	41137	0	42282
6104	231	75	461	42185	0	42952
6105	41140	76	152	1056	0	42424
6106	644	71	153	41898	0	42766
6107	42895	67	122	765	0	43849
6108	42659	77	133	632	0	43501
6109	959	88	43115	335	0	44497
6110	42098	45	514	297	0	42954
6111	42534	46	437	316	0	43333
6112	42860	38	162	304	0	43364
6113	962	42441	152	322	0	43877
6114	537	42285	152	320	0	43294
6115	298	917	114	41719	0	43048
6116	271	416	41551	664	0	42902
6117	185	39941	490	591	0	41207
6118	305	554	393	36486	0	37738
6119	247	284	119	35193	0	35843
6120	192	36038	124	615	0	36969
6121	36107	308	86	437	0	36938
6122	36216	287	82	244	0	36829
6123	721	99	37129	186	0	38135
6124	35957	68	331	212	0	36568
6125	479	93	35704	160	0	36436
6126	32781	79	335	164	0	33359
6127	467	81	34492	178	0	35218
6128	374	33188	324	135	0	34021
6129	337	258	405	31326	0	32326
6130	187	211	123	31850	0	32371
6131	31903	53	80	501	0	32537
6132	31929	40	71	363	0	32403
6133	31726	51	66	185	0	32028
6134	513	83	32617	139	0	33352
6135	351	48	250	32440	0	33089
6136	169	60	248	33496	0	33973
6137	33407	32	94	496	0	34029
6138	313	34134	104	318	0	34869
6139	36917	229	60	267	0	37473
6140	356	232	59	38013	0	38660
6141	349	66	60	39570	0	40045
6142	177	52	59	39972	0	40260
6143	152	56	47	40322	0	40577
6144	142	89	55	40211	0	40497
6145	134	39657	74	565	0	40430
6146	122	38576	72	293	0	39063
6147	108	37562	64	100	0	37834
6148	109	293	63	37204	0	37669
6149	104	152	36828	153	0	37237
6150	33027	34	157	229	0	33447
6151	183	38769	162	90	0	39204
6152	237	112	54	38478	0	38881
6153	82	133	46	39017	0	39278
6154	39806	47	41	306	0	40200
6155	39337	32	49	189	0	39607
6156	39978	36	43	119	0	40176
6157	310	41	39	42922	0	43312
6158	229	58	43712	225	0	44224
6159	126	59	46425	195	0	46805
6160	86	27	311	46408	0	46832
6161	100	70	47410	237	0	47817
6162	44674	22	200	236	0	45132
6163	219	34	159	46870	0	47282
6164	244	61	47326	213	0	47844
6165	119	48	160	46296	0	46623
6166	106	68	49782	244	0	50200
6167	104	73	53895	213	0	54285
6168	137	139	355	58430	0	59061
6169	94	71	64083	340	0	64588
6170	90	90	62943	241	0	63364
6171	36	59330	614	149	0	60129
6172	250	474	293	63021	0	64038
6173	66309	217	76	500	0	67102
6174	336	53	29	66921	0	67339
6175	241	33	25	69252	0	69551
6176	107	96	68617	655	0	69475
6177	59275	31	424	385	0	60115
6178	368	19	246	70142	0	70775
6179	252	18	65	71851	0	72186
6180	70014	25	45	664	0	70748
6181	376	32	30	72443	0	72881
6182	72482	33	51	492	0	73058
6183	73016	22	50	324	0	73412
6184	73630	32	39	176	0	73877
6185	610	73296	85	129	0	74120
6186	74195	370	57	119	0	74741
6187	399	75145	82	136	0	75762
6188	295	419	38	75372	0	76124
6189	77193	282	38	488	0	78001
6190	422	78575	80	478	0	79555
6191	78675	434	40	143	0	79292
6192	465	79575	84	205	0	80329
6193	77002	493	38	110	0	77643
6194	471	79260	81	156	0	79968
6195	368	81454	62	173	0	82057
6196	124	85813	87	173	0	86197
6197	112	834	46	81325	0	82317
6198	78	87349	78	521	0	88026
6199	128	576	37	86810	0	87551
6200	112	404	35	88424	0	88975
6201	107	90	38	89145	0	89380
6202	132	61	31	89964	0	90188
6203	87749	70	60	978	0	88857
6204	90077	88	53	591	0	90809
6205	1026	145	90348	163	0	91682
6206	93100	73	571	241	0	93985
6207	99799	99	443	178	0	100519
6208	103929	110	114	181	0	104334
6209	1352	165	104305	146	0	105968
6210	714	156	105785	135	0	106790
6211	100288	83	1398	234	0	102003
6212	1031	162	110512	194	0	111899
6213	728	114691	1007	288	0	116714
6214	268	1026	677	115225	0	117196
6215	119307	726	180	1081	0	121294
6216	119649	165	160	855	0	120829
6217	120640	124	154	259	0	121177
6218	1829	149	126	119485	0	121589
6219	956	120	134	122684	0	123894
6220	362	211	124528	1852	0	126953
6221	288	119	1082	123714	0	125203
6222	290	128	811	126489	0	127718
6223	125381	92	215	1927	0	127615
6224	1189	127482	200	1077	0	129948
6225	129130	1098	134	406	0	130768
6226	1351	821	173	128835	0	131180
6227	128662	178	165	1351	0	130356
6228	128147	114	145	1006	0	129412
6229	122134	164	156	420	0	122874
6230	1937	126181	226	444	0	128788
6231	1082	128678	278	413	0	130451
6232	483	1925	192	128595	0	131195
6233	129174	892	251	1328	0	131645
6234	1344	222	207	128345	0	130118
6235	1093	168	188	130089	0	131538
6236	510	342	129448	2086	0	132386
6237	476	261	1167	128195	0	130099
6238	506	231	841	129406	0	130984
6239	498	221	221	129218	0	130158
6240	536	273	127489	2198	0	130496
6241	561	311	125094	1316	0	127282
6242	408	126009	1949	680	0	129046
6243	125578	1185	976	559	0	128298
6244	1444	926	277	126213	0	128860
6245	1209	357	127592	1511	0	130669
6246	599	213	1223	125019	0	127054
6247	565	229	900	132298	0	133992
6248	131153	198	278	2229	0	133858
6249	130715	220	281	1286	0	132502
6250	2158	132102	397	657	0	135314
6251	131598	1222	279	533	0	133632
6252	130913	919	325	515	0	132672
6253	2253	361	326	129758	0	132698
6254	1359	457	129986	1497	0	133299
6255	591	130826	1288	1344	0	134049
6256	130295	1310	916	609	0	133130
6257	131062	972	313	600	0	132947
6258	2236	133370	341	737	0	136684
6259	1383	1259	253	134656	0	137551
6260	139687	960	286	1765	0	142698
6261	140524	298	325	1447	0	142594
6262	2555	273	307	140506	0	143641
6263	143449	254	367	1850	0	145920
6264	147930	317	339	1548	0	150134
6265	149141	336	356	787	0	150620
6266	3010	416	150988	693	0	155107
6267	1611	147950	1638	824	0	152023
6268	830	147885	1223	786	0	150724
6269	140596	2255	487	742	0	144080
6270	1889	143111	422	727	0	146149
6271	1731	1643	142458	580	0	146412
6272	914	1199	1514	140866	0	144493
6273	141563	414	1243	1749	0	144969
6274	1963	404	368	141763	0	144498
6275	143122	375	268	1923	0	145688
6276	142436	342	279	1591	0	144648
6277	142015	331	348	749	0	143443
6278	2782	140434	508	798	0	144522
6279	1627	147397	493	830	0	150347
6280	147210	2373	279	808	0	150670
6281	145936	1254	322	802	0	148314
6282	146779	429	339	725	0	148272
6283	2968	450	321	144399	0	148138
6284	142764	330	328	1972	0	145394
6285	1965	141611	400	1768	0	145744
6286	1683	145192	402	908	0	148185
6287	962	2308	316	143256	0	146842
6288	1006	1271	141770	1925	0	145972
6289	991	498	139164	1461	0	142114
6290	946	375	2197	137422	0	140940
6291	893	529	140021	1739	0	143182
6292	881	513	1464	138715	0	141573
6293	139351	509	1073	1770	0	142703
6294	2087	460	380	139311	0	142238
6295	137253	411	394	1826	0	139884
6296	1887	133916	459	1512	0	137774
6297	1815	1601	134138	676	0	138230
6298	917	1229	1458	129882	0	133486
6299	923	502	1062	135012	0	137499
6300	907	562	135086	2601	0	139156
6301	983	465	1443	128167	0	131058
6302	812	136142	1208	1774	0	139936
6303	1001	1541	395	135885	0	138822
6304	1017	1130	351	136391	0	138889
6305	998	442	275	139046	0	140761
6306	997	437	136518	2590	0	140542
6307	849	386	126800	1278	0	129313
6308	110939	315	2142	654	0	114050
6309	1673	428	118719	482	0	121302
6310	1175	117508	1307	494	0	120484
6311	116173	1153	1008	420	0	118754
6312	1396	117969	388	441	0	120194
6313	113335	1101	610	371	0	115417
6314	112478	794	521	433	0	114226
6315	110698	305	286	388	0	111677
6316	110672	315	224	420	0	111631
6317	1779	109346	287	496	0	111908
6318	1033	110011	261	506	0	111811
6319	110277	1505	297	364	0	112443
6320	1385	882	107831	377	0	110475
6321	1062	379	1006	105186	0	107633
6322	612	261	797	108463	0	110133
6323	586	337	108076	1629	0	110628
6324	97912	322	1069	991	0	100294
6325	107340	352	762	453	0	108907
6326	106331	367	298	390	0	107386
6327	1838	105465	331	492	0	108126
6328	109490	1088	326	500	0	111404
6329	1340	879	351	104399	0	106969
6330	1022	114176	431	1236	0	116865
6331	116394	1211	395	950	0	118950
6332	116816	971	345	483	0	118615
6333	122957	447	329	458	0	124191
6334	2334	430	335	120922	0	124021
6335	1427	398	300	120611	0	122736
6336	648	119487	407	2240	0	122782
6337	740	1399	120701	1251	0	124091
6338	843	991	1326	118799	0	121959
6339	871	358	1021	119492	0	121742
6340	746	394	392	123403	0	124935
6341	765	398	121545	2324	0	125032
6342	115103	410	1401	1356	0	118270
6343	1733	468	1017	122380	0	125598
6344	1436	473	123739	1578	0	127226
6345	781	369	1434	121485	0	124069
6346	123565	293	1145	1704	0	126707
6347	1665	124789	559	1427	0	128440
6348	1371	1499	427	126951	0	130248
6349	740	1161	127509	1701	0	131111
6350	117979	429	1606	1380	0	121394
6351	125328	348	1196	723	0	127595
6352	2530	435	126962	714	0	130641
6353	1576	641	1639	112854	0	116710
6354	647	125373	1327	1546	0	128893
6355	125980	1514	655	1255	0	129404
6356	1864	1084	125005	669	0	128622
6357	118272	457	1849	754	0	121332
6358	2111	418	119312	592	0	122433
6359	1462	302	112140	489	0	114393
6360	103676	346	2114	531	0	106667
6361	1440	110737	1141	719	0	114037
6362	1497	1268	109265	502	0	112532
6363	602	106816	1439	616	0	109473
6364	845	1263	102859	512	0	105479
6365	357	102668	1276	413	0	104714
6366	96399	1219	1200	475	0	99293
6367	1081	705	95412	366	0	97564
6368	868	270	94640	304	0	96082
6369	463	224	93138	296	0	94121
6370	88577	261	1691	231	0	90760
6371	90543	143	823	237	0	91746
6372	1336	149	303	88779	0	90567
6373	763	181	95159	893	0	96996
6374	369	217	96056	678	0	97320
6375	94148	156	1425	296	0	96025
6376	999	166	797	96944	0	98906
6377	97464	134	358	917	0	98873
6378	96511	165	297	683	0	97656
6379	1504	176	257	92507	0	94444
6380	853	94584	366	877	0	96680
6381	465	817	316	95197	0	96795
6382	411	596	317	96097	0	97421
6383	416	306	95798	1354	0	97874
6384	380	94594	1024	907	0	96905
6385	335	96318	787	379	0	97819
6386	368	1310	392	92208	0	94278
6387	323	742	95199	834	0	97098
6388	319	95894	1115	863	0	98191
6389	360	940	96273	323	0	97896
6390	92591	665	1125	318	0	94699
6391	96790	278	854	335	0	98257
6392	1471	301	97147	282	0	99201
6393	94748	214	1105	263	0	96330
6394	1176	290	851	96377	0	98694
6395	855	103580	517	1007	0	105959
6396	535	912	428	104394	0	106269
6397	103092	666	414	1005	0	105177
6398	103190	249	430	769	0	104638
6399	103118	234	411	378	0	104141
6400	101153	215	393	370	0	102131
6401	1510	101362	447	407	0	103726
6402	813	100182	448	484	0	101927
6403	99149	1192	472	265	0	101078
6404	1070	711	100183	245	0	102209
6405	836	1217	980	95059	0	98092
6406	396	103456	819	898	0	105569
6407	406	916	438	98869	0	100629
6408	293	105103	403	973	0	106772
6409	368	1051	348	105220	0	106987
6410	356	718	107948	990	0	110012
6411	103815	318	1135	750	0	106018
6412	108428	225	800	321	0	109774
6413	1516	321	109602	217	0	111656
6414	107151	264	1127	296	0	108838
6415	110137	262	810	285	0	111494
6416	1597	316	109947	285	0	112145
6417	950	247	1147	105911	0	108255
6418	109188	194	825	1012	0	111219
6419	1179	294	110339	695	0	112507
6420	867	272	1128	105118	0	107385
6421	525	321	117276	986	0	119108
6422	472	298	115890	693	0	117353
6423	113812	290	1669	402	0	116173
6424	120439	252	879	363	0	121933
6425	120114	229	396	253	0	120992
6426	123808	240	380	306	0	124734
6427	1815	331	348	119332	0	121826
6428	926	119418	402	1088	0	121834
6429	507	121956	427	804	0	123694
6430	459	1644	319	114403	0	116825
6431	113940	581	369	923	0	115813
6432	1004	113344	360	667	0	115375
6433	513	110686	247	291	0	111737
6434	109273	1020	219	185	0	110697
6435	945	549	220	107921	0	109635
6436	109610	183	246	840	0	110879
6437	911	110302	248	556	0	112017
6438	112424	764	213	251	0	113652
6439	1026	496	117619	196	0	119337
6440	127816	209	1026	247	0	129298
6441	134215	151	532	245	0	135143
6442	137019	187	216	342	0	137764
6443	1917	286	132500	210	0	134913
6444	132020	206	1072	250	0	133548
6445	1288	136569	698	320	0	138875
6446	817	1218	136043	178	0	138256
6447	554	1002	1272	128750	0	131578
6448	331	264	711	126054	0	127360
6449	231	132531	288	1626	0	134676
6450	326	1051	145	132489	0	134011
6451	275	620	157	133523	0	134575
6452	310	243	131658	1587	0	133798
6453	115502	100	1196	986	0	117784
6454	1261	167	133202	288	0	134918
6455	821	130	1240	129054	0	131245
6456	423	234	134324	1166	0	136147
6457	261	111	1317	132366	0	134055
6458	137552	105	787	1298	0	139742
6459	140700	118	330	775	0	141923
6460	1980	106	257	141269	0	143612
6461	1028	186	145151	1381	0	147746
6462	464	129	1342	143763	0	145698
6463	421	200	145126	1431	0	147178
6464	136153	147	1510	971	0	138781
6465	142964	173	808	410	0	144355
6466	142456	193	273	319	0	143241
6467	138706	243	236	301	0	139486
6468	2065	138662	289	513	0	141529
6469	1166	1405	211	138798	0	141580
6470	135368	874	255	1434	0	137931
6471	1448	138073	337	1081	0	140939
6472	1081	139213	342	536	0	141172
6473	719	2020	129553	310	0	132602
6474	128687	882	1520	335	0	131424
6475	133032	299	983	350	0	134664
6476	2413	293	130944	310	0	133960
6477	1379	171	1522	126737	0	129809
6478	780	146	979	131905	0	133810
6479	679	211	132239	2081	0	135210
6480	613	149	1585	128382	0	130729
6481	129449	151	1190	1572	0	132362
6482	1782	246	129557	936	0	132521
6483	1252	261	130348	434	0	132295
6484	124146	220	2241	447	0	127054
6485	1729	299	130802	387	0	133217
6486	125704	279	1678	395	0	128056
6487	1764	128780	1064	524	0	132132
6488	129142	1435	368	432	0	131377
6489	1835	903	306	126899	0	129943
6490	1218	407	303	128656	0	130584
6491	127091	380	353	2198	0	130022
6492	1727	340	337	127534	0	129938
6493	127358	288	309	1727	0	129682
6494	1736	127772	406	1188	0	131102
6495	1322	1510	302	121377	0	124511
6496	713	976	321	124618	0	126628
6497	121618	390	326	2196	0	124530
6498	122413	302	334	1189	0	124238
6499	122739	271	378	539	0	123927
6500	2558	120675	427	535	0	124195
6501	1384	121681	501	537	0	124103
6502	120353	1930	372	409	0	123064
6503	1977	1028	118359	383	0	121747
6504	1287	117953	1570	473	0	121283
6505	110677	1642	2037	636	0	114992
6506	107370	743	573	320	0	109006
6507	106603	240	248	290	0	107381
6508	2017	209	295	102512	0	105033
6509	104495	125	305	1234	0	106159
6510	102701	142	272	880	0	103995
6511	1999	169	230	99201	0	101599
6512	101079	147	232	1225	0	102683
6513	1427	226	97686	852	0	100191
6514	1006	185	1085	97323	0	99599
6515	480	210	765	99161	0	100616
6516	418	137	366	101263	0	102184
6517	99806	140	256	1990	0	102192
6518	102405	166	253	987	0	103811
6519	102678	190	246	445	0	103559
6520	102636	126	245	417	0	103424
6521	96240	78	268	353	0	96939
6522	2013	97	283	91012	0	93405
6523	1153	102	229	92422	0	93906
6524	89998	94	275	1746	0	92113
6525	1214	88641	305	1102	0	91262
6526	88090	919	259	390	0	89658
6527	1333	657	84822	317	0	87129
6528	88534	164	1001	303	0	90002
6529	91396	111	682	295	0	92484
6530	1944	166	95294	264	0	97668
6531	96824	134	1297	234	0	98489
6532	1644	138	99170	331	0	101283
6533	1171	156	103159	177	0	104663
6534	666	291	2024	97921	0	100902
6535	583	235	1032	104663	0	106513
6536	541	171	105774	2094	0	108580
6537	569	164	105628	1109	0	107470
6538	349	101785	2093	483	0	104710
6539	298	97149	1046	448	0	98941
6540	77638	1548	986	262	0	80434
6541	919	81797	266	222	0	83204
6542	76645	932	375	154	0	78106
6543	906	76206	158	188	0	77458
6544	75102	873	220	104	0	76299
6545	977	602	73536	102	0	75217
6546	71827	180	817	90	0	72914
6547	987	131	559	70644	0	72321
6548	650	73582	213	778	0	75223
6549	288	790	115	73936	0	75129
6550	73272	561	112	876	0	74821
6551	73863	181	84	589	0	74717
6552	1401	139	79	72221	0	73840
6553	746	118	72607	821	0	74292
6554	315	99	71986	633	0	73033
6555	188	72282	1275	256	0	74001
6556	296	1213	657	70053	0	72219
6557	219	626	70581	823	0	72249
6558	157	63957	787	545	0	65446
6559	572	912	799	61391	0	63674
6560	171	455	218	62174	0	63018
6561	58364	124	101	1022	0	59611
6562	681	77	90	58730	0	59578
6563	468	116	58277	750	0	59611
6564	165	79	641	57333	0	58218
6565	53864	55	475	792	0	55186
6566	720	98	56779	525	0	58122
6567	53017	64	651	218	0	53950
6568	718	57027	497	163	0	58405
6569	57572	626	165	121	0	58484
6570	57808	414	113	115	0	58450
6571	1080	120	124	54709	0	56033
6572	585	71	87	56383	0	57126
6573	209	56226	99	1104	0	57638
6574	162	628	93	57194	0	58077
6575	53920	440	86	779	0	55225
6576	715	181	55661	505	0	57062
6577	534	124	639	53924	0	55221
6578	218	55204	455	683	0	56560
6579	159	655	169	55160	0	56143
6580	133	456	139	56392	0	57120
6581	54050	190	117	1030	0	55387
6582	672	55094	100	609	0	56475
6583	531	638	112	54924	0	56205
6584	53717	459	122	718	0	55016
6585	720	180	97	54252	0	55249
6586	518	131	91	55053	0	55793
6587	53398	105	100	1152	0	54755
6588	53923	94	108	676	0	54801
6589	1141	130	54057	254	0	55582
6590	52413	112	677	232	0	53434
6591	54274	115	476	214	0	55079
6592	54444	111	209	172	0	54936
6593	1154	51805	187	183	0	53329
6594	595	51500	157	199	0	52451
6595	301	1028	138	50423	0	51890
6596	50644	549	152	663	0	52008
6597	50947	204	123	522	0	51796
6598	1121	157	100	49300	0	50678
6599	650	150	50545	734	0	52079
6600	49519	125	643	562	0	50849
6601	52413	144	467	277	0	53301
6602	1116	128	192	50348	0	51784
6603	650	111	125	51718	0	52604
6604	50766	118	125	1071	0	52080
6605	808	139	111	50222	0	51280
6606	563	50614	134	866	0	52177
6607	328	634	115	51755	0	52832
6608	50268	462	94	818	0	51642
6609	774	193	50579	585	0	52131
6610	48327	133	641	349	0	49450
6611	811	145	50833	278	0	52067
6612	588	115	704	49440	0	50847
6613	50532	98	464	791	0	51885
6614	767	104	187	50371	0	51429
6615	585	97	132	50909	0	51723
6616	48263	97	162	1126	0	49648
6617	766	98	49053	657	0	50574
6618	613	112	51503	345	0	52573
6619	298	73	982	50194	0	51547
6620	227	117	517	52577	0	53438
6621	233	108	183	53604	0	54128
6622	235	100	54027	1163	0	55525
6623	50496	83	659	740	0	51978
6624	54893	66	443	350	0	55752
6625	55261	91	193	286	0	55831
6626	54779	81	130	292	0	55282
6627	1157	53498	136	340	0	55131
6628	637	53293	132	307	0	54369
6629	287	51131	128	282	0	51828
6630	258	847	146	40967	0	42218
6631	283	246	106	41310	0	41945
6632	176	56	38968	417	0	39617
6633	84	33873	207	219	0	34383
6634	376	202	146	30268	0	30992
6635	28842	89	73	162	0	29166
6636	96	30374	49	162	0	30681
6637	110	146	28	29424	0	29708
6638	42	30862	26	146	0	31076
6639	31240	102	47	125	0	31514
6640	146	96	22	30901	0	31165
6641	105	44	31318	132	0	31599
6642	59	40	31431	103	0	31633
6643	58	138	199	31751	0	32146
6644	46	30	97	32111	0	32284
6645	36	18	22	32980	0	33056
6646	32551	16	42	228	0	32837
6647	170	41	32514	122	0	32847
6648	100	32445	129	85	0	32759
6649	36	120	75	32325	0	32556
6650	56	84	32896	148	0	33184
6651	33	33061	144	161	0	33399
6652	63	134	87	34009	0	34293
6653	50	99	34745	138	0	35032
6654	34	26	103	34004	0	34167
6655	20	10	78	35154	0	35262
6656	36467	12	21	173	0	36673
6657	36544	14	18	117	0	36693
6658	225	13	22	36851	0	37111
6659	37107	10	29	163	0	37309
6660	184	34	38259	136	0	38613
6661	139	26	157	38348	0	38670
6662	71	44	40049	197	0	40361
6663	56	60	175	39979	0	40270
6664	27	40686	144	267	0	41124
6665	23	42228	53	180	0	42484
6666	47	42875	43	93	0	43058
6667	59	378	33	42844	0	43314
6668	35	156	28	47387	0	47606
6669	49	58	47636	425	0	48168
6670	65	80	48941	238	0	49324
6671	73	72	50819	49	0	51013
6672	49976	45	548	58	0	50627
6673	337	30	260	53288	0	53915
6674	54122	25	50	388	0	54585
6675	379	55923	74	315	0	56691
6676	327	483	51	55944	0	56805
6677	57050	358	57	522	0	57987
6678	507	72	46	57341	0	57966
6679	57111	35	47	578	0	57771
6680	575	79	58545	435	0	59634
6681	414	59327	531	164	0	60436
6682	120	479	396	59679	0	60674
6683	60114	393	95	582	0	61184
6684	61005	84	82	454	0	61625
6685	872	59	77	61032	0	62040
6686	474	52	78	61717	0	62321
6687	60611	49	80	944	0	61684
6688	563	45	96	60171	0	60875
6689	475	86	60517	625	0	61703
6690	137	60429	582	509	0	61657
6691	167	518	447	60764	0	61896
6692	60420	411	140	651	0	61622
6693	60454	101	82	521	0	61158
6694	988	116	61940	203	0	63247
6695	549	61000	562	226	0	62337
6696	189	63147	475	245	0	64056
6697	195	996	134	62387	0	63712
6698	173	527	90	63642	0	64432
6699	208	144	106	63375	0	63833
6700	180	147	94	62890	0	63311
6701	139	62439	137	1249	0	63964
6702	227	639	96	62689	0	63651
6703	220	497	110	63531	0	64358
6704	62222	148	99	1210	0	63679
6705	61877	115	109	748	0	62849
6706	1099	62977	143	378	0	64597
6707	63845	629	106	338	0	64918
6708	63740	492	128	282	0	64642
6709	63978	176	120	314	0	64588
6710	1236	174	62673	300	0	64383
6711	721	118	624	61709	0	63172
6712	315	128	510	63941	0	64894
6713	301	196	62830	1197	0	64524
6714	230	157	693	61656	0	62736
6715	274	202	533	60948	0	61957
6716	61350	146	201	1271	0	62968
6717	798	198	61750	797	0	63543
6718	680	163	646	59136	0	60625
6719	58515	159	546	948	0	60168
6720	732	58710	212	900	0	60554
6721	58525	698	131	464	0	59818
6722	56580	557	129	500	0	57766
6723	1194	56356	166	460	0	58176
6724	742	718	102	56118	0	57680
6725	56163	548	134	937	0	57782
6726	851	56322	166	839	0	58178
6727	755	780	130	56313	0	57978
6728	55186	578	159	914	0	56837
6729	54023	235	178	759	0	55195
6730	1268	54004	207	500	0	55979
6731	54082	1149	181	407	0	55819
6732	913	600	183	54381	0	56077
6733	54575	203	211	997	0	55986
6734	955	215	53657	862	0	55689
6735	782	153	726	53185	0	54846
6736	428	137	634	53451	0	54650
6737	52301	166	238	1418	0	54123
6738	894	51681	264	924	0	53763
6739	50523	728	178	473	0	51902
6740	969	50735	193	499	0	52396
6741	891	795	48903	390	0	50979
6742	528	667	48805	392	0	50392
6743	475	612	1077	47446	0	49610
6744	492	252	48419	937	0	50100
6745	430	281	700	47878	0	49289
6746	411	263	506	47793	0	48973
6747	451	197	182	49193	0	50023
6748	48146	222	139	1413	0	49920
6749	47806	249	132	894	0	49081
6750	48175	226	119	510	0	49030
6751	1412	47813	183	467	0	49875
6752	915	49407	176	456	0	50954
6753	590	1153	50902	419	0	53064
6754	535	680	868	51253	0	53336
6755	435	316	51504	1164	0	53419
6756	454	228	931	49580	0	51193
6757	433	208	747	50071	0	51459
6758	408	191	244	50409	0	51252
6759	380	232	48166	1716	0	50494
6760	358	202	841	47391	0	48792
6761	46099	172	768	1208	0	48247
6762	942	44910	322	981	0	47155
6763	818	821	202	44326	0	46167
6764	44006	709	195	1048	0	45958
6765	43517	266	203	903	0	44889
6766	1466	196	211	42117	0	43990
6767	967	140	196	40756	0	42059
6768	36843	128	146	1381	0	38498
6769	934	125	127	36929	0	38115
6770	33570	86	128	942	0	34726
6771	857	107	95	32549	0	33608
6772	632	94	30479	824	0	32029
6773	264	28818	539	655	0	30276
6774	227	29036	437	270	0	29970
6775	424	775	523	26246	0	27968
6776	373	403	263	26623	0	27662
6777	25822	115	92	799	0	26828
6778	451	89	85	26332	0	26957
6779	404	66	81	26340	0	26891
6780	153	73	94	24438	0	24758
6781	134	23904	90	866	0	24994
6782	151	380	76	24565	0	25172
6783	152	349	63	24329	0	24893
6784	128	107	77	24390	0	24702
6785	22531	78	98	877	0	23584
6786	445	23172	98	548	0	24263
6787	419	415	72	23430	0	24336
6788	184	369	71	23539	0	24163
6789	157	121	83	23859	0	24220
6790	22791	81	82	901	0	23855
6791	505	56	73	23136	0	23770
6792	426	62	59	22891	0	23438
6793	170	67	21453	829	0	22519
6794	106	20735	368	562	0	21771
6795	105	421	309	21081	0	21916
6796	20293	297	124	517	0	21231
6797	405	20832	67	454	0	21758
6798	20301	331	90	236	0	20958
6799	20314	315	64	185	0	20878
6800	598	118	58	20118	0	20892
6801	373	60	70	20524	0	21027
6802	150	53	20615	728	0	21546
6803	108	52	336	21268	0	21764
6804	114	73	21505	541	0	22233
6805	106	56	380	21837	0	22379
6806	20137	46	312	553	0	21048
6807	371	20915	121	489	0	21896
6808	373	372	65	22213	0	23023
6809	157	342	86	22464	0	23049
6810	124	110	82	22467	0	22783
6811	110	80	84	22622	0	22896
6812	21657	59	85	819	0	22620
6813	362	21525	93	610	0	22590
6814	342	336	77	22418	0	23173
6815	22275	293	88	626	0	23282
6816	421	114	22105	525	0	23165
6817	21858	69	338	336	0	22601
6818	22354	70	329	281	0	23034
6819	676	112	21897	257	0	22942
6820	423	90	354	21694	0	22561
6821	22114	94	318	557	0	23083
6822	434	22885	120	540	0	23979
6823	23465	342	77	330	0	24214
6824	23276	302	44	294	0	23916
6825	23453	91	64	272	0	23880
6826	715	68	55	22829	0	23667
6827	468	58	46	23115	0	23687
6828	190	25607	70	784	0	26651
6829	195	385	60	26578	0	27218
6830	26056	333	54	577	0	27020
6831	465	122	25629	465	0	26681
6832	25055	83	320	268	0	25726
6833	26647	69	298	247	0	27261
6834	674	87	79	25985	0	26825
6835	427	65	46	26777	0	27315
6836	26723	53	41	749	0	27566
6837	26662	51	50	534	0	27297
6838	26456	52	52	295	0	26855
6839	698	80	26392	230	0	27400
6840	381	26184	317	200	0	27082
6841	26325	331	275	199	0	27130
6842	409	315	81	26178	0	26983
6843	366	26692	59	449	0	27566
6844	197	351	32	27040	0	27620
6845	26941	295	60	477	0	27773
6846	392	113	58	27502	0	28065
6847	443	78	27999	493	0	29013
6848	142	27664	298	474	0	28578
6849	103	28455	298	258	0	29114
6850	154	494	27266	154	0	28068
6851	23147	521	490	237	0	24395
6852	265	25083	246	166	0	25760
6853	289	162	57	21571	0	22079
6854	21562	85	46	84	0	21777
6855	90	21773	22	113	0	21998
6856	109	79	16	21816	0	22020
6857	22044	79	15	104	0	22242
6858	103	16	12	21983	0	22114
6859	22033	25	7	114	0	22179
6860	118	28	22930	119	0	23195
6861	99	23358	86	61	0	23604
6862	24881	80	83	92	0	25136
6863	24767	90	34	77	0	24968
6864	24807	32	20	57	0	24916
6865	202	41	24592	47	0	24882
6866	23813	30	79	59	0	23981
6867	25157	26	78	62	0	25323
6868	185	26	23	25227	0	25461
6869	25445	26	20	117	0	25608
6870	128	25285	28	123	0	25564
6871	121	95	30	25510	0	25756
6872	78	99	26121	109	0	26407
6873	55	33	101	25722	0	25911
6874	51	34	81	26688	0	26854
6875	26639	39	28	183	0	26889
6876	26308	33	29	128	0	26498
6877	213	47	26398	62	0	26720
6878	25381	25	91	66	0	25563
6879	153	36	26684	56	0	26929
6880	155	29	87	26308	0	26579
6881	96	62	27035	129	0	27322
6882	78	27	98	26361	0	26564
6883	57	27066	114	126	0	27363
6884	91	118	27713	110	0	28032
6885	101	107	28489	45	0	28742
6886	95	52	220	24391	0	24758
6887	29120	29	115	128	0	29392
6888	29074	27	42	127	0	29270
6889	29416	24	23	70	0	29533
6890	243	23	32	28916	0	29214
6891	162	21	29	29474	0	29686
6892	82	26	30	29554	0	29692
6893	72	27	28	29563	0	29690
6894	100	54	29284	234	0	29672
6895	71	25	119	28722	0	28937
6896	58	29064	127	156	0	29405
6897	55	113	43	29338	0	29549
6898	29197	109	38	154	0	29498
6899	189	40	29972	135	0	30336
6900	26016	33	154	110	0	26313
6901	194	43	30725	55	0	31017
6902	187	23	30288	52	0	30550
6903	55	30163	281	82	0	30581
6904	116	200	199	28519	0	29034
6905	60	169	54	29486	0	29769
6906	36	29393	66	310	0	29805
6907	32605	173	34	156	0	32968
6908	264	185	44	34162	0	34655
6909	261	49	36	36609	0	36955
6910	91	38	47	38193	0	38369
6911	40719	20	39	679	0	41457
6912	43056	19	38	378	0	43491
6913	799	34	32	42905	0	43770
6914	424	33	25	43166	0	43648
6915	42233	19	35	842	0	43129
6916	490	34	30	42671	0	43225
6917	402	30	40	42975	0	43447
6918	124	33	30	43551	0	43738
6919	129	47	42082	891	0	43149
6920	38595	31	456	552	0	39634
6921	41255	33	361	177	0	41826
6922	875	46	40497	139	0	41557
6923	490	146	433	36788	0	37857
6924	125	40206	409	476	0	41216
6925	39203	414	89	420	0	40126
6926	447	40259	100	187	0	40993
6927	383	39223	83	196	0	39885
6928	175	713	63	37187	0	38138
6929	36535	371	68	499	0	37473
6930	37160	61	41	459	0	37721
6931	819	49	41	36604	0	37513
6932	473	36	44	36838	0	37391
6933	168	53	34	36840	0	37095
6934	138	75	32	36705	0	36950
6935	139	61	41	35678	0	35919
6936	89	35368	48	886	0	36391
6937	114	426	43	35928	0	36511
6938	35027	358	43	608	0	36036
6939	35573	69	52	499	0	36193
6940	35745	36	43	242	0	36066
6941	824	34960	68	240	0	36092
6942	479	435	73	34638	0	35625
6943	196	385	34673	554	0	35808
6944	33093	125	462	500	0	34180
6945	528	145	374	34021	0	35068
6946	33906	101	111	570	0	34688
6947	32874	89	60	467	0	33490
6948	33096	86	40	167	0	33389
6949	858	81	25	32025	0	32989
6950	32301	74	44	544	0	32963
6951	569	61	36	32263	0	32929
6952	483	54	42	32367	0	32946
6953	31835	49	47	865	0	32796
6954	549	68	29	32341	0	32987
6955	31874	54	37	646	0	32611
6956	31958	41	26	546	0	32571
6957	870	58	31	31573	0	32532
6958	542	59	27	32006	0	32634
6959	236	72	31	32376	0	32715
6960	241	66	30145	923	0	31375
6961	219	66	30266	579	0	31130
6962	220	53	729	28918	0	29920
6963	239	58	374	29259	0	29930
6964	192	59	85	29672	0	30008
6965	212	45	62	29410	0	29729
6966	206	53	75	29636	0	29970
6967	28378	43	72	949	0	29442
6968	544	28339	88	589	0	29560
6969	494	419	75	28596	0	29584
6970	28554	338	85	629	0	29606
6971	569	87	70	28712	0	29438
6972	470	71	50	28291	0	28882
6973	27566	65	39	942	0	28612
6974	27444	66	41	616	0	28167
6975	882	90	27118	298	0	28388
6976	540	57	398	27129	0	28124
6977	273	66	27476	654	0	28469
6978	223	43	444	27526	0	28236
6979	205	32	354	27404	0	27995
6980	205	39	84	27774	0	28102
6981	194	43	26594	1002	0	27833
6982	135	26031	455	662	0	27283
6983	164	26917	396	338	0	27815
6984	185	681	128	25919	0	26913
6985	25148	350	111	653	0	26262
6986	538	99	25000	566	0	26203
6987	461	74	25637	287	0	26459
6988	202	80	738	25150	0	26170
6989	168	74	407	24229	0	24878
6990	144	25605	111	883	0	26743
6991	155	454	94	25792	0	26495
6992	164	382	70	26361	0	26977
6993	203	103	89	26818	0	27213
6994	25825	61	96	919	0	26901
6995	25802	51	76	562	0	26491
6996	846	48	92	25550	0	26536
6997	470	25379	112	640	0	26601
6998	180	397	85	25375	0	26037
6999	24278	324	69	664	0	25335
7000	452	24773	92	575	0	25892
7001	425	408	48	22439	0	23320
7002	148	23120	73	549	0	23890
7003	22460	397	73	490	0	23420
7004	21344	337	148	235	0	22064
7005	652	22244	95	237	0	23228
7006	348	21546	96	174	0	22164
7007	217	493	19490	170	0	20370
7008	89	17584	301	164	0	18138
7009	164	509	419	14385	0	15477
7010	84	165	13965	264	0	14478
7011	21	10075	119	119	0	10334
7012	31	91	72	8316	0	8510
7013	13	66	15	8406	0	8500
7014	10	8	10	8498	0	8526
7015	8261	10	10	123	0	8404
7016	68	15	8159	83	0	8325
7017	65	12	8248	26	0	8351
7018	16	15	110	8148	0	8289
7019	17	17	8768	79	0	8881
7020	9	11	71	8746	0	8837
7021	10	8	72	8668	0	8758
7022	13	9	10	8974	0	9006
7023	10	11	12	9034	0	9067
7024	8791	10	12	139	0	8952
7025	8775	11	9	87	0	8882
7026	122	9	11	8917	0	9059
7027	76	14	9576	82	0	9748
7028	23	15	60	9545	0	9643
7029	17	9615	71	80	0	9783
7030	10	65	22	9666	0	9763
7031	9579	67	13	101	0	9760
7032	9924	13	12	102	0	10051
7033	133	22	11	10113	0	10279
7034	73	28	14	10211	0	10326
7035	18	8	11	10377	0	10414
7036	10008	19	15	158	0	10200
7037	71	21	10308	100	0	10500
7038	92	17	10238	44	0	10391
7039	24	10166	129	34	0	10353
7040	10322	60	77	37	0	10496
7041	66	68	22	10957	0	11113
7042	69	26	11898	87	0	12080
7043	27	12124	63	102	0	12316
7044	21	12707	69	50	0	12847
7045	27	110	19	12996	0	13152
7046	18	74	17	13928	0	14037
7047	22	14214	21	140	0	14397
7048	21	63	10	14444	0	14538
7049	22	65	20	14492	0	14599
7050	14281	21	16	139	0	14457
7051	56	14553	26	117	0	14752
7052	69	66	19	14551	0	14705
7053	35	89	14675	93	0	14892
7054	23	28	60	14551	0	14662
7055	14725	15	68	93	0	14901
7056	53	15439	30	114	0	15636
7057	82	62	16	15867	0	16027
7058	21	78	15989	89	0	16177
7059	29	39	19320	108	0	19496
7060	36	24	155	19555	0	19770
7061	22	26	101	20436	0	20585
7062	20983	21	25	190	0	21219
7063	94	22732	22	146	0	22994
7064	23208	136	20	76	0	23440
7065	149	142	24311	48	0	24650
7066	24506	26	153	42	0	24727
7067	209	30	26563	41	0	26843
7068	25932	25	215	71	0	26243
7069	26744	19	171	52	0	26986
7070	371	35	29458	38	0	29902
7071	225	39	29814	52	0	30130
7072	41	29759	394	163	0	30357
7073	48	212	213	30269	0	30742
7074	30811	191	39	255	0	31296
7075	223	31	40	31780	0	32074
7076	208	38	37	32553	0	32836
7077	58	24	29	33055	0	33166
7078	54	45	32965	453	0	33517
7079	29730	35	241	301	0	30307
7080	32427	24	231	83	0	32765
7081	424	34094	76	85	0	34679
7082	259	213	45	32989	0	33506
7083	59	34872	64	259	0	35254
7084	58	245	36	35274	0	35613
7085	34797	235	30	280	0	35342
7086	255	35273	66	305	0	35899
7087	272	236	47	34722	0	35277
7088	34595	240	42	277	0	35154
7089	34510	51	41	279	0	34881
7090	497	28	39	34437	0	35001
7091	299	50	34765	272	0	35386
7092	105	125	257	32811	0	33298
7093	62	35009	277	270	0	35618
7094	34176	246	70	265	0	34757
7095	256	35009	87	109	0	35461
7096	286	268	50	34546	0	35150
7097	34747	229	48	309	0	35333
7098	272	62	48	35632	0	36014
7099	286	54	36	35716	0	36092
7100	122	65	35589	486	0	36262
7101	83	35721	280	353	0	36437
7102	34731	264	228	104	0	35327
7103	30123	277	117	142	0	30659
7104	381	35179	73	120	0	35753
7105	244	35414	62	103	0	35823
7106	176	433	57	34995	0	35661
7107	34422	253	61	271	0	35007
7108	262	34991	75	281	0	35609
7109	263	241	48	35155	0	35707
7110	131	246	34959	285	0	35621
7111	104	76	235	34849	0	35264
7112	34764	62	229	324	0	35379
7113	254	35482	92	303	0	36131
7114	268	271	61	35898	0	36498
7115	138	242	35739	296	0	36415
7116	135	104	35668	312	0	36219
7117	112	76	434	35135	0	35757
7118	136	70	248	35229	0	35683
7119	108	35934	102	560	0	36704
7120	136	281	54	36025	0	36496
7121	35820	290	95	330	0	36535
7122	324	109	88	36239	0	36760
7123	35828	112	83	333	0	36356
7124	342	36036	129	349	0	36856
7125	349	36728	104	174	0	37355
7126	182	473	117	36985	0	37757
7127	182	289	137	36787	0	37395
7128	201	138	36608	533	0	37480
7129	185	139	328	36075	0	36727
7130	36014	130	310	407	0	36861
7131	396	158	36461	371	0	37386
7132	393	132	322	36203	0	37050
7133	249	143	37632	450	0	38474
7134	219	124	352	37309	0	38004
7135	181	118	362	37508	0	38169
7136	219	116	173	38137	0	38645
7137	200	151	37912	670	0	38933
7138	198	129	336	36652	0	37315
7139	161	37979	320	480	0	38940
7140	166	369	123	38062	0	38720
7141	143	362	95	37853	0	38453
7142	36583	165	107	669	0	37524
7143	420	191	36578	511	0	37700
7144	385	156	282	36382	0	37205
7145	263	212	36252	493	0	37220
7146	217	192	35326	504	0	36239
7147	218	181	489	35352	0	36240
7148	201	146	332	35774	0	36453
7149	195	175	107	36946	0	37423
7150	36183	187	108	717	0	37195
7151	437	194	36156	505	0	37292
7152	35821	191	341	348	0	36701
7153	448	157	308	37898	0	38811
7154	385	146	151	38211	0	38893
7155	184	40151	120	742	0	41197
7156	180	366	126	40397	0	41069
7157	187	332	127	39942	0	40588
7158	280	159	137	39833	0	40409
7159	33100	104	114	640	0	33958
7160	308	93	32674	451	0	33526
7161	28792	90	304	279	0	29465
7162	298	32040	250	254	0	32842
7163	29081	218	82	135	0	29516
7164	222	29146	79	164	0	29611
7165	183	28162	106	171	0	28622
7166	649	391	204	25350	0	26594
7167	25727	121	189	216	0	26253
7168	132	56	30	25648	0	25866
7169	107	25347	42	175	0	25671
7170	33	26700	46	171	0	26950
7171	40	222	59	26649	0	26970
7172	31	135	35	26403	0	26604
7173	26	27138	40	281	0	27485
7174	31	196	20	27937	0	28184
7175	46	113	24	28217	0	28400
7176	48	45	28	28807	0	28928
7177	28422	25	35	332	0	28814
7178	176	48	28990	176	0	29390
7179	28143	31	157	148	0	28479
7180	29903	27	127	105	0	30162
7181	29441	45	31	73	0	29590
7182	244	29591	37	108	0	29980
7183	139	147	39	28910	0	29235
7184	29043	89	27	191	0	29350
7185	163	39	27	29430	0	29659
7186	29388	34	28	188	0	29638
7187	148	32300	29	174	0	32651
7188	33766	143	26	121	0	34056
7189	34350	112	33	97	0	34592
7190	34932	44	25	104	0	35105
7191	252	40	20	35102	0	35414
7192	141	48	17	36532	0	36738
7193	37062	27	35	285	0	37409
7194	158	37288	39	183	0	37668
7195	125	37606	35	109	0	37875
7196	39144	207	21	134	0	39506
7197	174	112	21	39334	0	39641
7198	143	43	26	40890	0	41102
7199	66	35	33	41675	0	41809
7200	57	41876	37	395	0	42365
7201	41767	195	28	226	0	42216
7202	232	151	26	42466	0	42875
7203	185	44116	53	286	0	44640
7204	91	247	21	46206	0	46565
7205	98	153	17	47263	0	47531
7206	72	55	24	47440	0	47591
7207	77	59	20	47750	0	47906
7208	47261	61	24	420	0	47766
7209	46874	39	25	276	0	47214
7210	48344	37	28	175	0	48584
7211	384	46	18	49100	0	49548
7212	275	84	48744	293	0	49396
7213	160	95	46058	256	0	46569
7214	163	93	49061	140	0	49457
7215	50455	59	334	172	0	51020
7216	273	57	175	53293	0	53798
7217	225	66	50	53220	0	53561
7218	104	86	32	53945	0	54167
7219	53198	55	21	460	0	53734
7220	52364	60	50	304	0	52778
7221	385	58505	49	201	0	59140
7222	238	220	30	59421	0	59909
7223	156	231	58780	319	0	59486
7224	114	61346	214	301	0	61975
7225	131	313	149	62102	0	62695
7226	114	175	67	62632	0	62988
7227	112	97	40	62193	0	62442
7228	128	71	29	61439	0	61667
7229	175	107	61417	478	0	62177
7230	158	115	59690	326	0	60289
7231	108	63581	341	191	0	64221
7232	113	194	175	63856	0	64338
7233	128	161	49	63370	0	63708
7234	61829	67	60	452	0	62408
7235	330	114	63878	271	0	64593
7236	221	72	197	62959	0	63449
7237	173	81	204	66690	0	67148
7238	208	150	69364	434	0	70156
7239	95	69795	234	342	0	70466
7240	69598	201	186	252	0	70237
7241	323	251	69301	213	0	70088
7242	66042	80	212	214	0	66548
7243	345	140	75378	191	0	76054
7244	230	61	229	75056	0	75576
7245	196	141	78669	313	0	79319
7246	203	150	82908	332	0	83593
7247	115	59	338	83476	0	83988
7248	152	101	246	81048	0	81547
7249	114	59	70	89870	0	90113
7250	120	54	81	89384	0	89639
7251	121	106	87	89387	0	89701
7252	147	160	91630	493	0	92430
7253	205	160	86472	383	0	87220
7254	76	92832	388	235	0	93531
7255	92796	214	190	227	0	93427
7256	270	233	90	93975	0	94568
7257	94809	44	90	428	0	95371
7258	314	75	66	94939	0	95394
7259	99727	47	94	568	0	100436
7260	317	68	67	101714	0	102166
7261	242	64	88	102814	0	103208
7262	89	108194	155	595	0	109033
7263	117	330	65	111867	0	112379
7264	128	258	68	112268	0	112722
7265	128	79	69	112279	0	112555
7266	105	75	74	111831	0	112085
7267	62	110649	130	637	0	111478
7268	110012	217	92	399	0	110720
7269	221	110904	159	254	0	111538
7270	191	235	43	109916	0	110385
7271	108493	166	78	396	0	109133
7272	369	191	105884	281	0	106725
7273	313	225	107124	183	0	107845
7274	179	163	417	103657	0	104416
7275	101	48	249	111231	0	111629
7276	96	51	67	112124	0	112338
7277	99	58	78	108975	0	109210
7278	83	67	62	110448	0	110660
7279	65	109439	139	582	0	110225
7280	75	232	61	111798	0	112166
7281	110565	169	88	403	0	111225
7282	270	64	56	111990	0	112380
7283	312	208	113596	409	0	114525
7284	97	70	313	111024	0	111504
7285	112289	43	254	525	0	113111
7286	293	120682	169	440	0	121584
7287	315	356	63	126404	0	127138
7288	125	290	49	131607	0	132071
7289	222	190	130446	952	0	131810
7290	251	216	161219	644	0	162330
7291	186399	85	2044	465	0	188993
7292	2727	121	1089	196584	0	200521
7293	1690	102	330	201602	0	203724
7294	714	222	214074	4607	0	219617
7295	606	334	213942	2467	0	217349
7296	141	218050	5058	1267	0	224516
7297	321	3245	2441	214186	0	220193
7298	626	2096	217039	3141	0	222902
7299	124	219185	3435	2323	0	225067
7300	218292	3204	2141	773	0	224410
7301	221275	2065	716	474	0	224530
7302	5083	752	317	211569	0	217721
7303	2489	220670	658	3238	0	227055
7304	220166	3282	292	2183	0	225923
7305	4053	2477	720	183119	0	190369
7306	2615	854	217100	2404	0	222973
7307	812	218127	3484	1933	0	224356
7308	215263	3308	2143	806	0	221520
7309	217146	2228	661	649	0	220684
7310	5265	652	367	216086	0	222370
7311	2676	339	368	220067	0	223450
7312	1080	495	214460	5560	0	221595
7313	721	333	3301	214056	0	218411
7314	646	318	2325	209322	0	212611
7315	564	286	831	215143	0	216824
7316	516	335	456	215779	0	217086
7317	553	304	402	207722	0	208981
7318	380	209531	584	6172	0	216667
7319	205711	3271	416	3264	0	212662
7320	3748	2362	208196	1558	0	215864
7321	2366	204920	3533	1204	0	212023
7322	1025	3333	2314	205731	0	212403
7323	203866	2313	958	3931	0	211068
7324	3545	869	629	206520	0	211563
7325	2515	525	541	205156	0	208737
7326	1177	560	621	206960	0	209318
7327	821	535	506	208690	0	210552
7328	903	453	202244	6693	0	210293
7329	579	201626	3703	3969	0	209877
7330	199408	3432	2441	2006	0	207287
7331	3909	2443	201070	1448	0	208870
7332	2578	903	3826	199337	0	206644
7333	201482	553	2600	4218	0	208853
7334	3671	201467	1186	3203	0	209527
7335	201824	3620	667	1639	0	207750
7336	4501	2583	685	190298	0	198067
7337	2865	1069	676	201658	0	206268
7338	1388	732	562	201190	0	203872
7339	989	602	575	202145	0	204311
7340	192697	646	659	7019	0	201021
7341	4021	682	689	196200	0	201592
7342	2887	543	664	199335	0	203429
7343	187619	512	591	6695	0	195417
7344	4168	730	186388	4013	0	195299
7345	3115	645	3673	185780	0	193213
7346	179199	542	2589	4741	0	187071
7347	179694	568	1108	3605	0	184975
7348	6137	497	870	175617	0	183121
7349	3465	520	842	174660	0	179487
7350	1428	172806	931	6685	0	181850
7351	1134	3572	655	177243	0	182604
7352	1159	2410	619	174941	0	179129
7353	1125	1065	168344	7019	0	177553
7354	863	872	167091	4381	0	173207
7355	783	166231	5786	2469	0	175269
7356	1043	3597	3108	164111	0	171859
7357	961	2424	1396	169435	0	174216
7358	166187	1064	1006	6603	0	174860
7359	4106	706	985	164420	0	170217
7360	3044	839	160298	5394	0	169575
7361	1615	745	3746	162001	0	168107
7362	1128	750	155748	5648	0	163274
7363	1213	846	155269	3941	0	161269
7364	1363	801	6105	148583	0	156852
7365	1039	802	3322	155168	0	160331
7366	152571	873	1383	6555	0	161382
7367	154922	708	960	4120	0	160710
7368	6230	684	967	153487	0	161368
7369	156056	753	622	5046	0	162477
7370	157273	531	644	3959	0	162407
7371	6426	660	680	154174	0	161940
7372	3688	638	609	157387	0	162322
7373	152161	678	680	6868	0	160387
7374	155536	443	701	4509	0	161189
7375	6204	466	689	152097	0	159456
7376	3603	151305	1048	5107	0	161063
7377	1915	3606	529	154866	0	160916
7378	1609	2306	572	157192	0	161679
7379	1320	1033	151329	7529	0	161211
7380	1046	521	3638	155611	0	160816
7381	146944	425	2643	6056	0	156068
7382	3696	149890	1436	4469	0	159491
7383	150513	3348	621	2855	0	157337
7384	150520	2324	552	2562	0	155958
7385	152297	942	524	2271	0	156034
7386	6675	1664	629	140257	0	149225
7387	4613	701	130196	4516	0	140026
7388	2758	778	124793	3251	0	131580
7389	1288	123291	5144	2160	0	131883
7390	704	84336	1897	1034	0	87971
7391	431	51136	909	401	0	52877
7392	429	48794	1114	411	0	50748
7393	1627	1105	44339	336	0	47407
7394	27901	1524	2080	335	0	31840
7395	279	217	274	28109	0	28879
7396	245	35	49	27783	0	28112
7397	93	45	36	27330	0	27504
7398	49	27757	60	480	0	28346
7399	27368	179	64	286	0	27897
7400	236	213	27994	114	0	28557
7401	188	26431	187	97	0	26903
7402	131	199	250	26486	0	27066
7403	26851	167	73	211	0	27302
7404	184	46	27	26969	0	27226
7405	228	38	26642	218	0	27126
7406	98	40	26652	229	0	27019
7407	64	39	325	26967	0	27395
7408	71	38	201	27158	0	27468
7409	27175	23	65	371	0	27634
7410	209	55	27340	260	0	27864
7411	26649	33	182	104	0	26968
7412	27175	33	192	86	0	27486
7413	354	33	55	27530	0	27972
7414	241	50	28132	229	0	28652
7415	84	34	167	28103	0	28388
7416	28213	37	208	240	0	28698
7417	203	28580	83	258	0	29124
7418	29381	175	58	133	0	29747
7419	229	194	53	29316	0	29792
7420	240	31042	77	267	0	31626
7421	113	207	62	31253	0	31635
7422	91	221	50	31374	0	31736
7423	82	31989	83	477	0	32631
7424	115	228	64	32473	0	32880
7425	114	218	60	32772	0	33164
7426	86	67	73	33221	0	33447
7427	130	52	32872	557	0	33611
7428	73	32845	303	383	0	33604
7429	33149	265	268	154	0	33836
7430	318	256	97	32968	0	33639
7431	297	34863	88	354	0	35602
7432	36548	289	72	373	0	37282
7433	380	286	61	36851	0	37578
7434	361	76	54	37125	0	37616
7435	170	45	59	36923	0	37197
7436	159	58	56	36596	0	36869
7437	36173	73	51	703	0	37000
7438	405	63	47	36937	0	37452
7439	376	71	58	37000	0	37505
7440	36760	71	72	704	0	37607
7441	407	73	58	37331	0	37869
7442	397	110	36803	518	0	37828
7443	142	89	340	37110	0	37681
7444	35884	79	316	511	0	36790
7445	395	82	98	36442	0	37017
7446	364	104	36448	481	0	37397
7447	163	100	35775	455	0	36493
7448	35951	72	703	233	0	36959
7449	37882	93	356	205	0	38536
7450	38109	72	96	194	0	38471
7451	38171	67	86	181	0	38505
7452	721	89	37861	193	0	38864
7453	441	63	354	36905	0	37763
7454	191	76	342	38166	0	38775
7455	37375	50	95	741	0	38261
7456	426	70	92	37814	0	38402
7457	380	68	37324	506	0	38278
7458	136	65	378	37270	0	37849
7459	117	64	37933	527	0	38641
7460	108	37739	436	461	0	38744
7461	38053	353	446	256	0	39108
7462	445	301	103	37873	0	38722
7463	413	80	37816	483	0	38792
7464	184	45	378	37639	0	38246
7465	138	43	336	39053	0	39570
7466	180	71	39425	733	0	40409
7467	138	51	420	39323	0	39932
7468	39054	66	375	573	0	40068
7469	508	75	38241	472	0	39296
7470	35754	54	429	283	0	36520
7471	470	36939	383	261	0	38053
7472	422	356	36659	212	0	37649
7473	204	371	36785	199	0	37559
7474	247	437	667	30624	0	31975
7475	154	52	379	33843	0	34428
7476	131	80	34246	703	0	35160
7477	128	60	381	34083	0	34652
7478	34470	38	319	552	0	35379
7479	34482	32	140	461	0	35115
7480	633	36	128	33622	0	34419
7481	413	48	105	33355	0	33921
7482	195	34144	135	667	0	35141
7483	34505	316	120	500	0	35441
7484	436	284	116	34207	0	35043
7485	376	35308	159	472	0	36315
7486	35489	322	121	482	0	36414
7487	35435	289	137	273	0	36134
7488	649	36498	142	289	0	37578
7489	447	330	116	36010	0	36903
7490	218	302	126	36144	0	36790
7491	192	103	35457	778	0	36530
7492	185	44	418	34893	0	35540
7493	34790	46	386	574	0	35796
7494	480	56	159	34576	0	35271
7495	436	59	33771	585	0	34851
7496	32991	62	422	477	0	33952
7497	482	51	390	33671	0	34594
7498	432	61	33358	547	0	34398
7499	209	51	427	32833	0	33520
7500	191	63	32690	527	0	33471
7501	196	42	435	32076	0	32749
7502	193	45	368	32400	0	33006
7503	31571	37	169	735	0	32512
7504	387	31657	165	496	0	32705
7505	32051	310	157	249	0	32767
7506	31523	265	137	218	0	32143
7507	31619	92	121	216	0	32048
7508	687	31369	151	232	0	32439
7509	449	341	31208	173	0	32171
7510	206	289	413	30886	0	31794
7511	31613	89	370	454	0	32526
7512	31736	60	200	416	0	32412
7513	662	58	150	30553	0	31423
7514	30994	44	148	487	0	31673
7515	468	69	30588	443	0	31568
7516	29813	61	429	252	0	30555
7517	537	43	30442	221	0	31243
7518	389	29394	452	207	0	30442
7519	29016	300	364	178	0	29858
7520	27537	252	165	212	0	28166
7521	578	27621	157	212	0	28568
7522	27297	299	168	211	0	27975
7523	26372	262	132	172	0	26938
7524	551	113	25937	172	0	26773
7525	24761	57	318	152	0	25288
7526	395	82	25270	134	0	25881
7527	298	218	294	22361	0	23171
7528	175	24010	268	271	0	24724
7529	152	247	23764	272	0	24435
7530	21437	560	385	393	0	22775
7531	21396	121	256	170	0	21943
7532	342	57	78	20001	0	20478
7533	240	55	19905	217	0	20417
7534	119	30	198	19825	0	20172
7535	19873	35	182	239	0	20329
7536	225	20382	80	219	0	20906
7537	19955	144	63	89	0	20251
7538	19743	116	48	85	0	19992
7539	276	19869	61	59	0	20265
7540	188	138	49	19508	0	19883
7541	19884	112	45	192	0	20233
7542	193	51	47	19982	0	20273
7543	178	42	36	20837	0	21093
7544	129	39	21197	263	0	21628
7545	85	35	168	20887	0	21175
7546	82	35	127	21168	0	21412
7547	20863	29	56	280	0	21228
7548	20866	26	42	160	0	21094
7549	315	36	36	20866	0	21253
7550	216	41	20593	187	0	21037
7551	108	50	20262	178	0	20598
7552	78	46	291	19951	0	20366
7553	106	33	21131	199	0	21469
7554	72	90	198	20569	0	20929
7555	78	19	157	20675	0	20929
7556	20697	19	73	304	0	21093
7557	212	47	20551	179	0	20989
7558	19883	24	186	84	0	20177
7559	19944	21	152	67	0	20184
7560	330	26	19471	66	0	19893
7561	188	36	19547	46	0	19817
7562	117	669	279	17872	0	18937
7563	61	18512	164	158	0	18895
7564	76	18908	80	176	0	19240
7565	233	245	57	17172	0	17707
7566	55	95	32	16870	0	17052
7567	42	22	22	17194	0	17280
7568	46	12	20	17263	0	17341
7569	16749	9	37	198	0	16993
7570	134	22	23	16945	0	17124
7571	121	31	16849	146	0	17147
7572	43	6	113	16339	0	16501
7573	54	16601	114	121	0	16890
7574	46	103	32	16652	0	16833
7575	16473	78	36	119	0	16706
7576	131	21	35	17049	0	17236
7577	127	26	17036	130	0	17319
7578	42	16859	136	110	0	17147
7579	40	101	119	16968	0	17228
7580	16966	87	32	125	0	17210
7581	16957	19	30	119	0	17125
7582	218	20	33	17224	0	17495
7583	114	26	16489	129	0	16758
7584	66	30	15750	97	0	15943
7585	15781	17	207	45	0	16050
7586	139	24	16708	21	0	16892
7587	123	18	16452	21	0	16614
7588	50	131	155	15247	0	15583
7589	16486	6	123	115	0	16730
7590	16403	9	19	86	0	16517
7591	16347	17	18	33	0	16415
7592	171	19	17526	29	0	17745
7593	103	15	17560	27	0	17705
7594	27	18245	173	29	0	18474
7595	24	94	89	18197	0	18404
7596	22	74	24	18390	0	18510
7597	27	11	15	18008	0	18061
7598	20	11	15	18479	0	18525
7599	44	19	18471	172	0	18706
7600	19	18847	115	121	0	19102
7601	19771	95	82	57	0	20005
7602	22099	85	34	46	0	22264
7603	22307	18	18	34	0	22377
7604	284	22888	32	52	0	23256
7605	164	165	24	22740	0	23093
7606	23634	145	22	182	0	23983
7607	195	24844	34	209	0	25282
7608	24568	184	20	54	0	24826
7609	187	24737	42	63	0	25029
7610	24759	196	24	42	0	25021
7611	24565	177	23	46	0	24811
7612	367	39	21	25267	0	25694
7613	200	26	25	26264	0	26515
7614	74	26	26278	390	0	26768
7615	51	28	26135	231	0	26445
7616	26070	17	447	60	0	26594
7617	26692	14	221	61	0	26988
7618	437	20	40	26549	0	27046
7619	254	25	29	26805	0	27113
7620	71	41	26526	482	0	27120
7621	59	23	246	26022	0	26350
7622	74	39	26568	310	0	26991
7623	63	27	277	26329	0	26696
7624	80	30	217	27000	0	27327
7625	26759	30	51	498	0	27338
7626	26313	25	55	266	0	26659
7627	494	48	29	26479	0	27050
7628	299	24	26	26610	0	26959
7629	106	45	26462	495	0	27108
7630	78	23	259	26538	0	26898
7631	86	45	26871	328	0	27330
7632	25589	24	309	288	0	26210
7633	299	32	256	26957	0	27544
7634	26712	29	70	321	0	27132
7635	302	26638	69	315	0	27324
7636	26532	253	65	135	0	26985
7637	329	240	62	26205	0	26836
7638	287	53	75	25947	0	26362
7639	93	26108	57	543	0	26801
7640	118	254	63	26552	0	26987
7641	115	235	25968	342	0	26660
7642	103	48	290	25832	0	26273
7643	84	49	25211	367	0	25711
7644	72	24345	294	336	0	25047
7645	95	242	276	24388	0	25001
7646	111	235	24377	309	0	25032
7647	107	59	24054	303	0	24523
7648	97	112	441	23245	0	23895
7649	23252	27	323	294	0	23896
7650	287	48	23195	289	0	23819
7651	253	27	270	22749	0	23299
7652	23126	19	246	314	0	23705
7653	273	22597	91	301	0	23262
7654	23673	227	55	148	0	24103
7655	295	226	64	23534	0	24119
7656	285	47	44	23694	0	24070
7657	112	46	42	24080	0	24280
7658	23531	43	54	539	0	24167
7659	280	38	53	24066	0	24437
7660	276	35	70	24219	0	24600
7661	23173	17	88	522	0	23800
7662	288	59	23382	328	0	24057
7663	274	36	273	23498	0	24081
7664	102	55	23589	343	0	24089
7665	22751	29	304	324	0	23408
7666	299	40	269	23423	0	24031
7667	310	60	23835	307	0	24512
7668	22815	49	276	330	0	23470
7669	23574	51	256	159	0	24040
7670	525	65	24430	135	0	25155
7671	302	44	270	23890	0	24506
7672	141	40	254	24418	0	24853
7673	105	81	24876	539	0	25601
7674	95	24742	311	392	0	25540
7675	125	267	25205	196	0	25793
7676	23611	223	322	179	0	24335
7677	333	72	25527	151	0	26083
7678	24204	34	328	189	0	24755
7679	337	50	25465	172	0	26024
7680	24404	25	321	177	0	24927
7681	301	25504	335	158	0	26298
7682	295	238	124	24896	0	25553
7683	153	215	94	25491	0	25953
7684	124	73	25624	528	0	26349
7685	150	42	288	23850	0	24330
7686	85	24868	287	362	0	25602
7687	24048	217	100	329	0	24694
7688	257	24438	123	184	0	25002
7689	262	236	69	24254	0	24821
7690	24302	201	114	362	0	24979
7691	293	24642	102	374	0	25411
7692	24108	251	86	154	0	24599
7693	345	245	24541	148	0	25279
7694	310	62	302	24249	0	24923
7695	126	35	308	24410	0	24879
7696	141	24	118	24993	0	25276
7697	24748	46	110	553	0	25457
7698	24962	38	92	340	0	25432
7699	24968	41	107	143	0	25259
7700	24467	40	99	143	0	24749
7701	494	58	23036	120	0	23708
7702	19336	26	222	87	0	19671
7703	234	19753	189	86	0	20262
7704	173	19497	87	66	0	19823
7705	19434	281	448	112	0	20275
7706	19441	144	184	86	0	19855
7707	267	28	42	18638	0	18975
7708	19155	14	54	185	0	19408
7709	18875	27	35	145	0	19082
7710	20517	23	42	76	0	20658
7711	324	24	39	20303	0	20690
7712	161	20329	51	209	0	20750
7713	62	20187	32	141	0	20422
7714	78	294	49	19951	0	20372
7715	19584	118	33	177	0	19912
7716	140	20034	55	154	0	20383
7717	140	129	27	19890	0	20186
7718	70	121	20178	157	0	20526
7719	18370	28	137	178	0	18713
7720	139	20468	143	65	0	20815
7721	144	20750	39	64	0	20997
7722	20289	217	35	49	0	20590
7723	167	135	20716	45	0	21063
7724	142	40	123	19837	0	20142
7725	59	20714	135	118	0	21026
7726	60	123	24	20874	0	21081
7727	50	136	26	20625	0	20837
7728	50	20766	30	254	0	21100
7729	57	143	32	21390	0	21622
7730	52	132	19	21494	0	21697
7731	21146	40	24	249	0	21459
7732	142	21167	39	157	0	21505
7733	21158	141	12	66	0	21377
7734	166	140	17	20961	0	21284
7735	137	21727	36	175	0	22075
7736	93	162	21763	126	0	22144
7737	79	153	127	21767	0	22126
7738	51	59	114	22698	0	22922
7739	60	59	22962	265	0	23346
7740	21222	39	138	178	0	21577
7741	149	43	133	25466	0	25791
7742	25331	35	32	237	0	25635
7743	254	41	25172	217	0	25684
7744	222	40	207	25139	0	25608
7745	87	53	26622	259	0	27021
7746	58	78	252	26444	0	26832
7747	54	56	216	27043	0	27369
7748	26880	39	49	470	0	27438
7749	236	27656	41	285	0	28218
7750	27687	258	21	93	0	28059
7751	309	268	27841	66	0	28484
7752	264	48	244	27709	0	28265
7753	75	70	29166	287	0	29598
7754	25437	34	299	304	0	26074
7755	28375	39	240	107	0	28761
7756	530	63	28608	75	0	29276
7757	28144	41	288	70	0	28543
7758	29097	47	261	89	0	29494
7759	499	31	77	28949	0	29556
7760	333	46	28857	324	0	29560
7761	131	58	30071	295	0	30555
7762	75	42	510	29651	0	30278
7763	106	37	289	28847	0	29279
7764	102	29447	130	543	0	30222
7765	101	29983	74	393	0	30551
7766	29692	479	82	158	0	30411
7767	328	299	90	29368	0	30085
7768	300	29628	107	344	0	30379
7769	121	30292	88	349	0	30850
7770	28149	508	87	151	0	28895
7771	338	312	60	29519	0	30229
7772	316	30207	111	339	0	30973
7773	152	318	73	30050	0	30593
7774	121	289	95	29885	0	30390
7775	124	85	89	30036	0	30334
7776	28988	69	87	600	0	29744
7777	360	29545	112	381	0	30398
7778	368	301	102	29479	0	30250
7779	169	290	108	29698	0	30265
7780	155	88	87	30021	0	30351
7781	142	82	28968	634	0	29826
7782	27170	61	346	424	0	28001
7783	360	82	349	29059	0	29850
7784	28572	68	159	384	0	29183
7785	28497	63	110	395	0	29065
7786	28615	94	90	201	0	29000
7787	637	105	28459	162	0	29363
7788	378	28345	338	166	0	29227
7789	166	371	284	27576	0	28397
7790	127	312	27849	350	0	28638
7791	137	165	27383	343	0	28028
7792	150	186	479	25291	0	26106
7793	101	26428	327	358	0	27214
7794	26926	284	124	362	0	27696
7795	27469	288	88	232	0	28077
7796	27864	124	55	229	0	28272
7797	27791	77	76	217	0	28161
7798	555	110	27702	180	0	28547
7799	27055	110	261	181	0	27607
7800	359	28430	314	191	0	29294
7801	316	285	102	28712	0	29415
7802	161	290	84	29117	0	29652
7803	29078	77	99	579	0	29833
7804	373	58	85	29170	0	29686
7805	375	92	28388	384	0	29239
7806	26793	72	288	392	0	27545
7807	28114	63	289	227	0	28693
7808	28246	41	150	187	0	28624
7809	603	87	27990	136	0	28816
7810	25365	56	289	160	0	25870
7811	326	26459	289	157	0	27231
7812	26584	230	200	166	0	27180
7813	378	253	129	26020	0	26780
7814	330	106	103	26109	0	26648
7815	171	26164	111	463	0	26909
7816	152	253	79	26059	0	26543
7817	149	26273	107	328	0	26857
7818	200	274	71	25774	0	26319
7819	157	26077	85	295	0	26614
7820	175	274	83	25694	0	26226
7821	146	26223	94	303	0	26766
7822	169	283	56	26692	0	27200
7823	125	27439	103	372	0	28039
7824	29228	295	64	334	0	29921
7825	406	245	62	29946	0	30659
7826	389	99	68	30226	0	30782
7827	194	99	65	31589	0	31947
7828	171	56	71	32115	0	32413
7829	188	102	32342	721	0	33353
7830	188	78	370	32469	0	33105
7831	179	68	329	32850	0	33426
7832	32317	62	110	713	0	33202
7833	31669	84	65	440	0	32258
7834	684	33128	84	204	0	34100
7835	468	390	64	32857	0	33779
7836	217	331	62	34397	0	35007
7837	35222	117	61	767	0	36167
7838	508	129	34952	465	0	36054
7839	33362	86	423	209	0	34080
7840	514	35117	358	171	0	36160
7841	32541	338	61	105	0	33045
7842	31944	258	46	88	0	32336
7843	575	32279	58	107	0	33019
7844	300	33211	63	128	0	33702
7845	227	662	62	31757	0	32708
7846	83	275	31812	347	0	32517
7847	30595	63	338	278	0	31274
7848	355	77	31788	80	0	32300
7849	30232	48	311	74	0	30665
7850	371	41	31370	83	0	31865
7851	241	30988	330	81	0	31640
7852	89	290	216	31065	0	31660
7853	30439	216	56	321	0	31032
7854	30766	57	36	236	0	31095
7855	518	48	31	31058	0	31655
7856	32456	27	31	344	0	32858
7857	32131	58	34	261	0	32484
7858	578	32096	50	123	0	32847
7859	32277	341	42	77	0	32737
7860	397	32888	57	89	0	33431
7861	285	369	32	32834	0	33520
7862	33100	251	41	370	0	33762
7863	33387	67	40	287	0	33781
7864	33548	51	33	91	0	33723
7865	646	69	31966	1452	0	34133
7866	333	87	33759	80	0	34259
7867	136	55	576	33738	0	34505
7868	115	65	276	34748	0	35204
7869	106	36870	82	704	0	37762
7870	36736	433	48	373	0	37590
7871	484	352	47	36562	0	37445
7872	415	103	58	37006	0	37582
7873	162	81	36940	798	0	37981
7874	113	36484	440	480	0	37517
7875	129	37352	341	154	0	37976
7876	137	773	71	36897	0	37878
7877	36495	406	54	496	0	37451
7878	499	96	59	36363	0	37017
7879	432	60	64	37084	0	37640
7880	36847	77	58	809	0	37791
7881	37053	67	55	459	0	37634
7882	837	74	60	36946	0	37917
7883	494	87	36774	573	0	37928
7884	157	69	446	37150	0	37822
7885	136	79	368	37581	0	38164
7886	37177	68	116	845	0	38206
7887	549	71	73	37500	0	38193
7888	37411	71	70	583	0	38135
7889	596	96	37419	487	0	38598
7890	481	80	458	37630	0	38649
7891	213	81	395	38316	0	39005
7892	188	98	100	38738	0	39124
7893	163	86	62	38426	0	38737
7894	191	80	72	37923	0	38266
7895	190	109	36575	982	0	37856
7896	35306	88	518	570	0	36482
7897	604	87	421	36522	0	37634
7898	527	82	36028	637	0	37274
7899	263	94	36016	566	0	36939
7900	198	78	864	35276	0	36416
7901	35172	83	466	622	0	36343
7902	35171	94	131	559	0	35955
7903	35711	95	105	273	0	36184
7904	1034	81	127	33140	0	34382
7905	546	34672	143	657	0	36018
7906	35181	483	123	556	0	36343
7907	35156	442	142	243	0	35983
7908	35266	143	111	231	0	35751
7909	34933	83	124	242	0	35382
7910	1026	103	113	34045	0	35287
7911	635	108	33906	664	0	35313
7912	292	89	526	33678	0	34585
7913	267	118	33925	684	0	34994
7914	33010	79	551	602	0	34242
7915	33643	58	456	331	0	34488
7916	1006	85	33130	266	0	34487
7917	32740	71	550	277	0	33638
7918	33597	81	440	293	0	34411
7919	1019	92	177	32182	0	33470
7920	635	32869	168	631	0	34303
7921	32648	482	140	570	0	33840
7922	694	639	129	30642	0	32104
7923	571	30623	137	589	0	31920
7924	314	461	94	28982	0	29851
7925	259	306	28393	575	0	29533
7926	233	28384	432	526	0	29575
7927	27009	446	506	320	0	28281
7928	26791	349	175	256	0	27571
7929	25924	81	124	202	0	26331
7930	26013	39	107	211	0	26370
7931	702	135	114	24552	0	25503
7932	435	25158	151	430	0	26174
7933	24666	314	139	405	0	25524
7934	503	301	24361	202	0	25367
7935	446	23662	384	180	0	24672
7936	281	272	22073	187	0	22813
7937	200	271	305	19419	0	20195
7938	167	19436	283	337	0	20223
7939	199	241	88	20328	0	20856
7940	202	243	20771	346	0	21562
7941	173	84	267	20362	0	20886
7942	207	56	252	20719	0	21234
7943	176	57	103	21257	0	21593
7944	19840	48	85	572	0	20545
7945	342	20105	142	380	0	20969
7946	359	221	90	20072	0	20742
7947	19560	240	106	340	0	20246
7948	358	19856	116	365	0	20695
7949	19798	227	109	169	0	20303
7950	415	252	19830	156	0	20653
7951	393	137	266	18608	0	19404
7952	213	19665	274	315	0	20467
7953	19501	246	119	292	0	20158
7954	396	266	19178	155	0	19995
7955	363	18376	286	157	0	19182
7956	167	233	214	16856	0	17470
7957	136	229	109	16945	0	17419
7958	16663	77	79	433	0	17252
7959	257	69	98	16585	0	17009
7960	299	73	15955	273	0	16600
7961	193	56	177	15120	0	15546
7962	146	48	15624	267	0	16085
7963	164	162	235	14233	0	14794
7964	140	15401	222	226	0	15989
7965	15008	168	83	243	0	15502
7966	14383	189	82	109	0	14763
7967	333	13683	64	73	0	14153
7968	143	11814	60	79	0	12096
7969	332	141	122	10622	0	11217
7970	10690	81	28	91	0	10890
7971	120	28	26	10581	0	10755
7972	10493	31	22	95	0	10641
7973	100	10497	38	88	0	10723
7974	84	85	15	10761	0	10945
7975	59	76	11338	93	0	11566
7976	69	27	75	11160	0	11331
7977	52	23	73	11457	0	11605
7978	11684	22	37	159	0	11902
7979	108	12378	25	108	0	12619
7980	86	72	29	12310	0	12497
7981	12258	66	32	92	0	12448
7982	98	32	12408	76	0	12614
7983	12004	23	74	50	0	12151
7984	114	85	59	12428	0	12686
7985	76	13213	34	96	0	13419
7986	13131	88	34	84	0	13337
7987	102	82	13740	30	0	13954
7988	77	28	13669	35	0	13809
7989	38	13784	136	34	0	13992
7990	13006	60	108	58	0	13232
7991	60	49	11	13224	0	13344
7992	52	9	11	13525	0	13597
7993	13500	11	16	129	0	13656
7994	87	16	13737	64	0	13904
7995	69	7	78	13784	0	13938
7996	30	14	15017	100	0	15161
7997	29	13	79	14582	0	14703
7998	16	15374	82	211	0	15683
7999	19	85	17	15761	0	15882
8000	21	94	15799	102	0	16016
8001	15137	12	108	102	0	15359
8002	105	18	85	16006	0	16214
8003	91	16	16316	116	0	16539
8004	32	14	111	15840	0	15997
8005	30	13	86	16296	0	16425
8006	23	28	16450	181	0	16682
8007	29	19	16848	104	0	17000
8008	23	16	175	16908	0	17122
8009	34	20	17229	125	0	17408
8010	16598	12	133	108	0	16851
8011	114	13	97	17388	0	17612
8012	17395	12	25	132	0	17564
8013	136	25	17477	104	0	17742
8014	113	15	120	17766	0	18014
8015	41	30	19524	148	0	19743
8016	33	19219	154	143	0	19549
8017	39	132	19875	30	0	20076
8018	30	129	19535	42	0	19736
8019	18648	23	244	47	0	18962
8020	19760	19	120	41	0	19940
8021	235	25	20578	34	0	20872
8022	116	9	162	19308	0	19595
8023	44	11	126	21041	0	21222
8024	39	24	21617	252	0	21932
8025	20	21119	174	181	0	21494
8026	20730	126	137	51	0	21044
8027	193	127	21538	40	0	21898
8028	129	23	165	21344	0	21661
8029	41	19	134	22037	0	22231
8030	22447	10	52	276	0	22785
8031	22627	15	37	168	0	22847
8032	22743	19	43	61	0	22866
8033	22795	13	39	46	0	22893
8034	282	14	45	22630	0	22971
8035	164	33	23688	186	0	24071
8036	59	16	187	23548	0	23810
8037	50	13	154	23662	0	23879
8038	46	13	55	24434	0	24548
8039	54	33	24150	293	0	24530
8040	22730	12	180	191	0	23113
8041	185	11	163	24111	0	24470
8042	186	34	24597	213	0	25030
8043	45	24980	206	200	0	25431
8044	66	153	197	25090	0	25506
8045	48	153	53	25402	0	25656
8046	25049	27	60	336	0	25472
8047	196	25783	78	221	0	26278
8048	188	183	25815	86	0	26272
8049	70	150	203	25246	0	25669
8050	53	32	193	25550	0	25828
8051	25399	26	59	362	0	25846
8052	25271	18	42	214	0	25545
8053	354	24	68	25713	0	26159
8054	25596	25	67	234	0	25922
8055	213	25548	80	237	0	26078
8056	218	187	26669	89	0	27163
8057	78	155	208	26495	0	26936
8058	80	32	189	27245	0	27546
8059	89	36	69	27338	0	27532
8060	89	32	57	26724	0	26902
8061	63	26927	85	396	0	27471
8062	26176	174	73	218	0	26641
8063	218	160	60	26191	0	26629
8064	181	27855	84	245	0	28365
8065	27810	181	61	226	0	28278
8066	27450	160	43	121	0	27774
8067	339	28612	68	134	0	29153
8068	228	183	74	28732	0	29217
8069	102	177	63	28992	0	29334
8070	90	42	53	28846	0	29031
8071	88	38	68	28966	0	29160
8072	28947	43	63	410	0	29463
8073	28963	34	57	281	0	29335
8074	363	29539	86	174	0	30162
8075	228	229	28927	120	0	29504
8076	88	197	242	28595	0	29122
8077	29109	47	211	269	0	29636
8078	270	28842	92	289	0	29493
8079	221	28631	90	153	0	29095
8080	29000	346	56	120	0	29522
8081	29153	203	45	102	0	29503
8082	425	81	66	28811	0	29383
8083	255	73	29603	304	0	30235
8084	144	75	30328	273	0	30820
8085	30542	67	389	173	0	31171
8086	31676	42	257	151	0	32126
8087	31440	62	67	111	0	31680
8088	31313	45	61	119	0	31538
8089	31071	42	97	134	0	31344
8090	428	31667	80	143	0	32318
8091	315	294	50	29884	0	30543
8092	119	33543	57	246	0	33965
8093	33709	253	62	261	0	34285
8094	33465	207	70	132	0	33874
8095	33314	71	43	140	0	33568
8096	32925	63	50	137	0	33175
8097	376	32819	86	154	0	33435
8098	32438	198	65	133	0	32834
8099	259	33076	57	140	0	33532
8100	243	233	44	32913	0	33433
8101	32697	167	49	251	0	33164
8102	277	108	34467	206	0	35058
8103	234	71	196	33538	0	34039
8104	123	75	157	35195	0	35550
8105	144	89	35380	380	0	35993
8106	123	35491	197	289	0	36100
8107	35079	212	179	128	0	35598
8108	34576	177	57	135	0	34945
8109	354	35021	78	109	0	35562
8110	236	216	41	34710	0	35203
8111	216	190	36575	240	0	37221
8112	120	38569	208	202	0	39099
8113	37833	223	191	125	0	38372
8114	310	192	37990	69	0	38561
8115	33927	73	169	111	0	34280
8116	36325	75	157	95	0	36652
8117	350	63	38445	104	0	38962
8118	210	38874	176	102	0	39362
8119	154	305	147	38851	0	39457
8120	160	160	39432	196	0	39948
8121	35909	80	186	219	0	36394
8122	38385	50	120	92	0	38647
8123	263	39144	57	104	0	39568
8124	178	148	35	38569	0	38930
8125	103	157	34	39460	0	39754
8126	128	85	40101	260	0	40574
8127	81	41754	154	162	0	42151
8128	45199	174	127	256	0	45756
8129	45914	124	42	118	0	46198
8130	47094	119	39	151	0	47403
8131	280	97	47289	94	0	47760
8132	45540	47	123	109	0	45819
8133	47715	39	125	96	0	47975
8134	267	57	40	48201	0	48565
8135	203	85	47950	138	0	48376
8136	96	52	129	47387	0	47664
8137	124	101	49314	156	0	49695
8138	92	102	124	47632	0	47950
8139	80	49564	145	152	0	49941
8140	68	54104	79	185	0	54436
8141	113	201	35	54575	0	54924
8142	82	127	31	54097	0	54337
8143	53997	45	31	304	0	54377
8144	180	78	55329	148	0	55735
8145	51681	42	145	119	0	51987
8146	164	57221	138	114	0	57637
8147	57083	141	37	112	0	57373
8148	57185	95	43	74	0	57397
8149	236	50	33	57309	0	57628
8150	188	79	61800	174	0	62241
8151	113	48	135	61284	0	61580
8152	76	67072	138	263	0	67549
8153	88	202	52	67363	0	67705
8154	78	168	39	67716	0	68001
8155	67271	55	53	416	0	67795
8156	241	48	28	67021	0	67338
8157	186	67087	95	264	0	67632
8158	103	221	31	68137	0	68492
8159	68178	166	35	296	0	68675
8160	222	70694	78	326	0	71320
8161	245	278	45	72681	0	73249
8162	89	196	37	73162	0	73484
8163	83	58	43	76650	0	76834
8164	72	58	36	76665	0	76831
8165	77079	50	47	689	0	77865
8166	390	53	36	78848	0	79327
8167	352	45	32	80361	0	80790
8168	114	68	49	81124	0	81355
8169	86	83337	64	834	0	84321
8170	81916	467	72	453	0	82908
8171	624	447	83482	114	0	84667
8172	374	83500	493	215	0	84582
8173	81285	453	347	151	0	82236
8174	566	427	85963	146	0	87102
8175	400	87261	531	228	0	88420
8176	203	596	412	84206	0	85417
8177	97	88680	149	583	0	89509
8178	144	498	88464	360	0	89466
8179	211	460	89622	169	0	90462
8180	53	90561	837	247	0	91698
8181	90020	447	449	195	0	91111
8182	89843	359	126	161	0	90489
8183	772	161	88947	114	0	89994
8184	469	132	85874	138	0	86613
8185	211	166	89762	119	0	90258
8186	109	70	790	87657	0	88626
8187	112	73	387	88977	0	89549
8188	107	79	117	91627	0	91930
8189	172	143	95623	847	0	96785
8190	125	82	476	92293	0	92976
8191	131	90	387	95516	0	96124
8192	141	134	95168	909	0	96352
8193	85640	99	603	600	0	86942
8194	567	118	431	100374	0	101490
8195	510	77	115	98894	0	99596
8196	127	103089	167	1029	0	104412
8197	102584	564	253	580	0	103981
8198	648	529	102824	243	0	104244
8199	100228	120	632	225	0	101205
8200	648	120	480	103015	0	104263
8201	613	333	106282	691	0	107919
8202	171	111	640	104655	0	105577
8203	107130	122	582	829	0	108663
8204	668	230	108311	581	0	109790
8205	105075	103	668	324	0	106170
8206	108578	89	652	290	0	109609
8207	110115	91	208	248	0	110662
8208	1059	109872	256	361	0	111548
8209	621	602	165	113791	0	115179
8210	117761	497	167	763	0	119188
8211	117449	133	200	662	0	118444
8212	119318	118	1635	285	0	121356
8213	1426	229	118437	233	0	120325
8214	120159	107	869	323	0	121458
8215	1040	106	672	128183	0	130001
8216	800	205	128624	1170	0	130799
8217	343	123	1065	132188	0	133719
8218	298	118	806	134105	0	135327
8219	401	208	137547	2114	0	140270
8220	315	114	1252	136840	0	138521
8221	338	136	983	142319	0	143776
8222	315	261	157568	2349	0	160493
8223	159013	116	1765	1433	0	162327
8224	173187	111	1446	559	0	175303
8225	3227	116	466	178297	0	182106
8226	1912	260	179647	2237	0	184056
8227	773	120	2109	173837	0	176839
8228	458	177328	1747	2555	0	182088
8229	570	1942	555	176740	0	179807
8230	521	1491	387	178433	0	180832
8231	177877	382	402	3735	0	182396
8232	177125	238	351	2236	0	179950
8233	180312	242	317	973	0	181844
8234	3916	219	316	177479	0	181930
8235	2301	202	294	180187	0	182984
8236	1116	390	178580	3926	0	184012
8237	948	338	2201	169951	0	173438
8238	769	177666	1889	2796	0	183120
8239	176873	1957	644	2198	0	181672
8240	2294	176107	694	1350	0	180445
8241	177591	2258	563	954	0	181366
8242	2741	1802	477	165969	0	170989
8243	1974	174176	623	2678	0	179451
8244	173930	2154	445	2178	0	178707
8245	172440	1799	481	1093	0	175813
8246	4059	661	417	170337	0	175474
8247	2389	173351	564	2793	0	179097
8248	1161	2309	437	174189	0	178096
8249	1046	1895	172126	2989	0	178056
8250	162571	614	2353	2440	0	167978
8251	2605	168607	1989	1475	0	174676
8252	165378	2243	676	1088	0	169385
8253	2865	1748	548	164381	0	169542
8254	167286	686	577	2753	0	171302
8255	3147	638	168043	2216	0	174044
8256	168407	481	2350	1262	0	172500
8257	170849	460	1895	1141	0	174345
8258	4656	547	170121	1318	0	176642
8259	3101	407	2534	166280	0	172322
8260	1646	394	2102	168796	0	172938
8261	164921	536	906	4533	0	170896
8262	2931	165329	873	3259	0	172392
8263	2465	2689	814	161194	0	167162
8264	1528	1995	161423	3059	0	168005
8265	1415	901	159173	2633	0	164122
8266	1331	157342	3639	1854	0	164166
8267	1760	2449	157751	1333	0	163293
8268	149712	2061	2931	1435	0	156139
8269	2896	934	2026	148019	0	153875
8270	153414	586	1061	2848	0	157909
8271	2998	864	152023	2412	0	158297
8272	2501	676	2548	149547	0	155272
8273	1471	797	1956	152011	0	156235
8274	1408	956	149414	3985	0	155763
8275	1436	770	2386	148664	0	153256
8276	147564	830	1943	3101	0	153438
8277	147827	655	933	2555	0	151970
8278	4383	619	719	146635	0	152356
8279	147163	660	698	2973	0	151494
8280	145219	610	684	2599	0	149112
8281	4406	143608	859	1726	0	150599
8282	2958	2250	783	143943	0	149934
8283	145010	1821	749	2987	0	150567
8284	3203	881	793	145626	0	150503
8285	141783	708	813	3176	0	146480
8286	3475	730	747	142072	0	147024
8287	2939	802	142806	3431	0	149978
8288	1863	142322	2633	2741	0	149559
8289	1976	2484	2146	118094	0	124700
8290	1691	138935	1217	2637	0	144480
8291	134645	2431	1101	2386	0	140563
8292	2930	135211	1153	1731	0	141025
8293	2535	134143	1041	1613	0	139332
8294	1817	3682	1017	129778	0	136294
8295	129957	2276	869	3046	0	136148
8296	3010	1071	760	128899	0	133740
8297	128604	907	761	3261	0	133533
8298	126764	923	879	2708	0	131274
8299	3990	127449	998	1879	0	134316
8300	129667	2345	1059	1376	0	134447
8301	127051	1993	963	1325	0	131332
8302	127012	1035	900	1248	0	130195
8303	4873	853	121490	1228	0	128444
8304	3331	742	2359	118540	0	124972
8305	2065	723	1997	121291	0	126076
8306	1941	707	119642	4044	0	126334
8307	116689	665	2462	2834	0	122650
8308	120196	570	2054	1836	0	124656
8309	117755	546	1048	1642	0	120991
8310	112354	555	855	1516	0	115280
8311	4597	109032	919	1584	0	116132
8312	106802	1846	697	1238	0	110583
8313	3668	1672	586	104404	0	110330
8314	2974	861	99444	2413	0	105692
8315	92261	555	1713	2065	0	96594
8316	2915	94168	1530	1358	0	99971
8317	86112	1670	693	1043	0	89518
8318	2696	86215	544	1103	0	90558
8319	2211	81446	551	1092	0	85300
8320	1447	80625	693	1104	0	83869
8321	1752	76299	1043	1195	0	80289
8322	1764	1923	57257	1014	0	61958
8323	1444	4066	1790	43651	0	50951
8324	514	329	40270	772	0	41885
8325	30978	204	529	479	0	32190
8326	537	32214	375	361	0	33487
8327	442	32434	195	331	0	33402
8328	320	666	157	31099	0	32242
8329	312	456	91	31490	0	32349
8330	315	228	31117	695	0	32355
8331	252	217	30923	419	0	31811
8332	275	273	616	29926	0	31090
8333	260	176	30631	499	0	31566
8334	247	29974	488	439	0	31148
8335	305	465	330	29226	0	30326
8336	321	359	156	30931	0	31767
8337	372	159	30522	668	0	31721
8338	326	122	393	29614	0	30455
8339	29764	94	318	520	0	30696
8340	557	119	182	29540	0	30398
8341	456	107	152	29047	0	29762
8342	261	118	28867	823	0	30069
8343	26535	105	453	495	0	27588
8344	559	28951	380	280	0	30170
8345	585	383	113	28512	0	29593
8346	437	314	28521	454	0	29726
8347	356	187	371	28199	0	29113
8348	28135	167	302	495	0	29099
8349	616	170	28522	397	0	29705
8350	490	194	436	27978	0	29098
8351	291	136	28886	530	0	29843
8352	297	28750	424	523	0	29994
8353	382	471	28422	248	0	29523
8354	241	27676	454	209	0	28580
8355	184	343	23557	168	0	24252
8356	284	626	365	18801	0	20076
8357	73	20748	256	200	0	21277
8358	19720	189	47	162	0	20118
8359	208	188	38	19748	0	20182
8360	20083	61	41	202	0	20387
8361	231	49	41	20571	0	20892
8362	211	53	30	20877	0	21171
8363	20655	37	49	354	0	21095
8364	21101	35	35	209	0	21380
8365	401	40	34	21784	0	22259
8366	232	52	22311	238	0	22833
8367	97	22026	243	216	0	22582
8368	130	236	22448	68	0	22882
8369	81	22731	245	63	0	23120
8370	21845	224	240	62	0	22371
8371	247	180	21730	62	0	22219
8372	203	55	21615	52	0	21925
8373	65	43	359	20457	0	20924
8374	21248	21	204	225	0	21698
8375	261	50	22103	198	0	22612
8376	215	22619	247	41	0	23122
8377	23029	228	189	46	0	23492
8378	23174	180	55	60	0	23469
8379	23457	42	47	64	0	23610
8380	23396	47	53	58	0	23554
8381	23203	38	51	60	0	23352
8382	393	54	22861	55	0	23363
8383	212	82	209	20550	0	21053
8384	60	22116	193	199	0	22568
8385	21929	197	46	165	0	22337
8386	198	22299	43	89	0	22629
8387	20699	160	65	52	0	20976
8388	20420	117	40	48	0	20625
8389	279	20512	48	45	0	20884
8390	20766	156	34	55	0	21011
8391	216	119	40	20662	0	21037
8392	144	40	41	20967	0	21192
8393	62	40	20681	276	0	21059
8394	40	21094	185	162	0	21481
8395	58	165	144	21029	0	21396
8396	62	137	39	21216	0	21454
8397	60	28	40	21331	0	21459
8398	49	56	20768	296	0	21169
8399	18872	36	189	160	0	19257
8400	197	34	150	20869	0	21250
8401	21088	26	55	197	0	21366
8402	231	38	31	21133	0	21433
8403	164	51	21760	211	0	22186
8404	83	46	22229	167	0	22525
8405	20527	35	313	92	0	20967
8406	22085	30	154	58	0	22327
8407	309	21916	68	92	0	22385
8408	194	192	22114	55	0	22555
8409	81	145	208	21625	0	22059
8410	76	54	152	21203	0	21485
8411	23392	35	54	318	0	23799
8412	23252	40	41	175	0	23508
8413	23367	44	43	81	0	23535
8414	347	51	23058	56	0	23512
8415	23446	39	207	105	0	23797
8416	253	34	150	23923	0	24360
8417	192	42	59	24102	0	24395
8418	88	40	47	24137	0	24312
8419	67	24038	74	337	0	24516
8420	23759	199	57	192	0	24207
8421	240	143	55	23572	0	24010
8422	203	66	23512	221	0	24002
8423	99	38	211	22898	0	23246
8424	77	23514	191	223	0	24005
8425	23675	204	70	157	0	24106
8426	239	140	53	23562	0	23994
8427	187	51	50	23359	0	23647
8428	110	52	23687	334	0	24183
8429	95	47	205	23068	0	23415
8430	99	23784	174	230	0	24287
8431	112	208	49	24095	0	24464
8432	117	165	24188	231	0	24701
8433	21441	40	216	204	0	21901
8434	23324	42	159	95	0	23620
8435	329	23964	74	102	0	24469
8436	23110	163	60	75	0	23408
8437	23818	109	38	73	0	24038
8438	286	23864	66	80	0	24296
8439	176	211	41	23994	0	24422
8440	24522	115	70	227	0	24934
8441	211	25196	68	177	0	25652
8442	182	203	25287	74	0	25746
8443	24876	130	210	77	0	25293
8444	26300	41	136	89	0	26566
8445	26541	35	43	78	0	26697
8446	26414	33	37	92	0	26576
8447	347	27292	49	96	0	27784
8448	27673	198	39	89	0	27999
8449	28386	133	37	76	0	28632
8450	28850	47	33	72	0	29002
8451	410	37	44	28850	0	29341
8452	28559	31	40	288	0	28918
8453	257	30452	59	227	0	30995
8454	199	266	32483	63	0	33011
8455	104	186	270	33773	0	34333
8456	34073	42	217	345	0	34677
8457	363	61	34627	230	0	35281
8458	260	44	307	34369	0	34980
8459	92	56	34857	369	0	35374
8460	59	34511	335	385	0	35290
8461	79	343	219	33793	0	34434
8462	119	218	34370	363	0	35070
8463	60	34357	311	267	0	34995
8464	132	305	213	33348	0	33998
8465	34277	201	153	381	0	35012
8466	34725	37	41	255	0	35058
8467	35110	34	39	68	0	35251
8468	34973	27	43	60	0	35103
8469	34936	23	33	75	0	35067
8470	522	45	34980	44	0	35591
8471	34862	31	299	63	0	35255
8472	35572	27	211	77	0	35887
8473	505	44	60	35456	0	36065
8474	35641	40	38	310	0	36029
8475	34200	37	42	233	0	34512
8476	452	34274	85	103	0	34914
8477	277	283	34	34326	0	34920
8478	123	216	41	34697	0	35077
8479	34278	38	27	494	0	34837
8480	327	34418	68	288	0	35101
8481	270	35056	61	120	0	35507
8482	131	502	46	35371	0	36050
8483	121	248	43	35675	0	36087
8484	123	43	50	35640	0	35856
8485	129	44	40	35944	0	36157
8486	34967	50	36	552	0	35605
8487	34698	29	34	299	0	35060
8488	606	76	35195	80	0	35957
8489	327	48	299	34111	0	34785
8490	139	52	224	35045	0	35460
8491	142	55	35017	537	0	35751
8492	32429	47	318	299	0	33093
8493	360	34901	257	112	0	35630
8494	34714	314	61	80	0	35169
8495	380	263	47	34331	0	35021
8496	293	77	34733	382	0	35485
8497	142	68	301	34670	0	35181
8498	154	83	36015	375	0	36627
8499	124	36182	334	341	0	36981
8500	35052	302	279	159	0	35792
8501	35137	223	62	103	0	35525
8502	485	35379	86	150	0	36100
8503	307	290	43	34436	0	35076
8504	33938	222	66	320	0	34546
8505	329	33996	102	295	0	34722
8506	321	288	50	33907	0	34566
8507	34121	241	50	337	0	34749
8508	377	85	33817	298	0	34577
8509	32618	50	288	161	0	33117
8510	325	33867	308	114	0	34614
8511	33623	286	84	134	0	34127
8512	33307	233	78	128	0	33746
8513	550	125	33041	109	0	33825
8514	385	69	288	31553	0	32295
8515	173	80	229	32828	0	33310
8516	161	110	32795	507	0	33573
8517	169	65	287	32017	0	32538
8518	179	63	241	32281	0	32764
8519	32996	65	74	507	0	33642
8520	33030	54	79	343	0	33506
8521	575	58	97	32628	0	33358
8522	384	88	32930	362	0	33764
8523	201	80	301	32905	0	33487
8524	179	81	266	33216	0	33742
8525	203	99	33602	548	0	34452
8526	201	55	305	33915	0	34476
8527	33575	69	271	390	0	34305
8528	33205	87	84	367	0	33743
8529	529	33474	93	220	0	34316
8530	34016	289	90	173	0	34568
8531	33521	243	64	171	0	33999
8532	549	34117	68	177	0	34911
8533	34500	283	52	165	0	35000
8534	34303	235	66	131	0	34735
8535	34911	64	68	147	0	35190
8536	590	80	34046	155	0	34871
8537	33172	55	288	164	0	33679
8538	380	63	240	34078	0	34761
8539	34002	37	117	370	0	34526
8540	388	94	33422	342	0	34246
8541	334	32891	294	163	0	33682
8542	32542	257	247	124	0	33170
8543	318	33975	99	139	0	34531
8544	299	248	71	33080	0	33698
8545	141	241	53	33793	0	34228
8546	33740	79	75	492	0	34386
8547	33074	65	67	312	0	33518
8548	536	75	33240	131	0	33982
8549	311	82	31176	135	0	31704
8550	137	60	31338	119	0	31654
8551	141	432	382	29449	0	30404
8552	137	55	30439	249	0	30880
8553	135	127	28052	206	0	28520
8554	571	947	318	23572	0	25408
8555	25141	97	215	282	0	25735
8556	25016	10	24	136	0	25186
8557	25370	6	25	51	0	25452
8558	25380	11	19	50	0	25460
8559	189	11	24	25544	0	25768
8560	107	12	24	25898	0	26041
8561	45	44	27179	179	0	27447
8562	38	24	111	26533	0	26706
8563	50	16	106	27147	0	27319
8564	28101	17	24	231	0	28373
8565	28095	14	24	156	0	28289
8566	240	7	18	28127	0	28392
8567	28624	14	30	157	0	28825
8568	28719	18	25	161	0	28923
8569	248	11	34	28994	0	29287
8570	157	11	28	28719	0	28915
8571	65	29	28652	283	0	29029
8572	77	39	28533	169	0	28818
8573	50	42	258	28698	0	29048
8574	56	20	145	29411	0	29632
8575	74	36	29648	254	0	30012
8576	28058	17	140	182	0	28397
8577	28828	13	138	83	0	29062
8578	321	40	29159	76	0	29596
8579	170	29227	160	82	0	29639
8580	29756	112	156	94	0	30118
8581	191	128	32618	55	0	32992
8582	157	25	142	32174	0	32498
8583	83	29	143	33405	0	33660
8584	35041	10	59	332	0	35442
8585	37570	16	54	253	0	37893
8586	309	11	50	38163	0	38533
8587	200	17	38	40611	0	40866
8588	40939	8	44	369	0	41360
8589	40928	14	39	236	0	41217
8590	40642	12	39	107	0	40800
8591	440	53	41760	58	0	42311
8592	258	13	233	41540	0	42044
8593	83	28	217	42926	0	43254
8594	42634	15	68	447	0	43164
8595	232	43348	87	312	0	43979
8596	46862	207	49	148	0	47266
8597	376	48550	60	114	0	49100
8598	334	342	45	49680	0	50401
8599	130	282	44	50457	0	50913
8600	172	74	50382	731	0	51359
8601	139	25	430	50043	0	50637
8602	152	67	51085	556	0	51860
8603	102	54	478	50798	0	51432
8604	120	29	376	50569	0	51094
8605	91	50132	129	852	0	51204
8606	105	51891	119	538	0	52653
8607	133	756	61	51200	0	52150
8608	142	361	68	52526	0	53097
8609	150	69	57	53173	0	53449
8610	160	46	58	54026	0	54290
8611	148	51	54	54566	0	54819
8612	169	90	53834	943	0	55036
8613	148	35	491	53329	0	54003
8614	109	59	412	54337	0	54917
8615	129	107	53078	974	0	54288
8616	88	52819	525	782	0	54214
8617	117	456	420	53197	0	54190
8618	194	437	53298	603	0	54532
8619	117	54501	548	591	0	55757
8620	133	474	423	54758	0	55788
8621	55874	403	130	669	0	57076
8622	544	118	101	56071	0	56834
8623	479	97	85	56748	0	57409
8624	161	95	118	57505	0	57879
8625	137	91	97	56244	0	56569
8626	99	55401	128	1101	0	56729
8627	160	477	102	56640	0	57379
8628	58841	419	122	839	0	60221
8629	537	126	116	59939	0	60718
8630	480	99	99	59714	0	60392
8631	152	95	127	60622	0	60996
8632	58545	122	130	1176	0	59973
8633	58780	123	130	751	0	59784
8634	927	107	117	59952	0	61103
8635	58926	109	107	808	0	59950
8636	58162	110	104	686	0	59062
8637	834	59530	139	503	0	61006
8638	59006	478	102	404	0	59990
8639	511	60148	165	397	0	61221
8640	430	60393	122	411	0	61356
8641	201	802	157	61147	0	62307
8642	177	507	63400	806	0	64890
8643	171	219	506	61963	0	62859
8644	180	153	431	62729	0	63493
8645	139	63205	204	1062	0	64610
8646	62477	520	138	741	0	63876
8647	510	449	125	63068	0	64152
8648	503	208	69029	828	0	70568
8649	204	166	499	68081	0	68950
8650	158	71115	453	841	0	72567
8651	71112	496	141	802	0	72551
8652	576	451	111	71639	0	72777
8653	485	283	73430	927	0	75125
8654	241	186	501	72804	0	73732
8655	177	72996	479	846	0	74498
8656	181	577	137	73893	0	74788
8657	76409	497	131	950	0	77987
8658	78639	199	134	960	0	79932
8659	79431	162	164	589	0	80346
8660	1102	81221	244	638	0	83205
8661	81406	658	186	576	0	82826
8662	808	574	171	81795	0	83348
8663	81286	236	144	1082	0	82748
8664	765	83210	183	1028	0	85186
8665	700	772	157	84587	0	86216
8666	300	757	86694	1080	0	88831
8667	77899	315	697	1117	0	80028
8668	726	88346	589	728	0	90389
8669	666	824	182	88926	0	90598
8670	261	647	159	90855	0	91922
8671	260	217	135	91034	0	91646
8672	246	227	162	87969	0	88604
8673	200	89832	206	1590	0	91828
8674	89694	768	138	1101	0	91701
8675	89140	595	164	610	0	90509
8676	1319	351	91709	540	0	93919
8677	786	241	686	91035	0	92748
8678	386	265	93640	1098	0	95389
8679	89768	246	802	932	0	91748
8680	93603	231	561	560	0	94955
8681	90960	213	220	535	0	91928
8682	1401	233	178	88105	0	89917
8683	762	90268	192	1128	0	92350
8684	92131	798	131	891	0	93951
8685	1070	646	106	90529	0	92351
8686	91120	281	274	1139	0	92814
8687	1020	274	89362	900	0	91556
8688	821	261	88433	441	0	89956
8689	89290	205	1145	458	0	91098
8690	1004	164	612	91112	0	92892
8691	90606	164	206	1044	0	92020
8692	969	92132	190	866	0	94157
8693	92656	802	186	463	0	94107
8694	92995	630	191	471	0	94287
8695	1476	309	94510	409	0	96704
8696	683	233	89233	251	0	90400
8697	283	90589	1040	304	0	92216
8698	522	617	695	90338	0	92172
8699	92308	413	396	694	0	93811
8700	673	127	120	93054	0	93974
8701	540	127	98	96330	0	97095
8702	329	188	95567	1012	0	97096
8703	89986	112	566	641	0	91305
8704	749	153	425	98810	0	100137
8705	668	193	98741	692	0	100294
8706	408	243	98163	516	0	99330
8707	293	368	907	98028	0	99596
8708	295	188	101212	723	0	102418
8709	332	180	100861	534	0	101907
8710	234	186	966	88874	0	90260
8711	372	237	104075	682	0	105366
8712	250	169	647	98426	0	99492
8713	174	102941	507	785	0	104407
8714	105577	565	202	594	0	106938
8715	623	109873	251	408	0	111155
8716	581	758	174	106941	0	108454
8717	312	113313	206	898	0	114729
8718	355	870	116464	592	0	118281
8719	305	558	868	126414	0	128145
8720	306	297	148357	1417	0	150377
8721	138403	143	1711	975	0	141232
8722	1639	154775	1086	471	0	157971
8723	156187	1639	342	312	0	158480
8724	1959	953	263	152887	0	156062
8725	154918	247	336	1746	0	157247
8726	2082	291	155834	1100	0	159307
8727	1250	157476	1821	500	0	161047
8728	154186	1724	1031	360	0	157301
8729	1960	1168	319	144470	0	147917
8730	1197	156495	348	1655	0	159695
8731	518	1837	258	157449	0	160062
8732	156115	1070	281	2042	0	159508
8733	1794	166403	410	1337	0	169944
8734	166316	2024	284	485	0	169109
8735	2338	1403	164325	393	0	168459
8736	157091	389	2141	379	0	160000
8737	2417	264	1199	163074	0	166954
8738	161233	252	424	2191	0	164100
8739	2196	163236	500	1392	0	167324
8740	1419	2046	456	161918	0	165839
8741	671	1245	279	165142	0	167337
8742	582	465	159559	3138	0	163744
8743	520	345	2068	155289	0	158222
8744	537	266	1237	160823	0	162863
8745	464	325	461	160823	0	162073
8746	508	243	364	161848	0	162963
8747	455	407	159492	3433	0	163787
8748	444	152487	2241	1859	0	157031
8749	515	2020	1343	152368	0	156246
8750	149755	1228	484	2357	0	153824
8751	150113	379	375	1570	0	152437
8752	3015	152676	466	804	0	156961
8753	150228	2117	380	585	0	153310
8754	149509	1247	462	625	0	151843
8755	147986	420	432	646	0	149484
8756	3237	146744	494	668	0	151143
8757	142451	1934	300	474	0	145159
8758	2298	1277	284	138576	0	142435
8759	1446	446	138505	2170	0	142567
8760	538	137480	1974	1452	0	141444
8761	641	2010	1244	136380	0	140275
8762	454	1193	135212	2020	0	138879
8763	127580	367	1948	1364	0	131259
8764	1974	297	1139	133543	0	136953
8765	1230	313	415	134366	0	136324
8766	491	326	302	132509	0	133628
8767	464	291	277	133237	0	134269
8768	500	336	128153	3059	0	132048
8769	111430	300	1954	1740	0	115424
8770	1962	126293	1188	788	0	130231
8771	125756	1908	395	533	0	128592
8772	2072	127022	353	596	0	130043
8773	126670	2029	319	493	0	129511
8774	2266	1239	291	125216	0	129012
8775	1452	524	125370	2082	0	129428
8776	822	439	124330	1309	0	126900
8777	672	494	2811	120711	0	124688
8778	594	407	1300	122681	0	124982
8779	558	398	433	124414	0	125803
8780	120074	345	440	3075	0	123934
8781	2103	414	121790	1639	0	125946
8782	1286	119495	2048	949	0	123778
8783	674	122143	1241	802	0	124860
8784	115258	2665	402	713	0	119038
8785	2146	1320	116101	638	0	120205
8786	1304	114424	1961	881	0	118570
8787	763	1893	113188	627	0	116471
8788	680	1242	1938	110933	0	114793
8789	679	554	112861	2024	0	116118
8790	657	491	112698	1303	0	115149
8791	623	436	2574	109239	0	112872
8792	592	502	110746	2094	0	113934
8793	680	414	110465	1426	0	112985
8794	582	396	2685	102700	0	106363
8795	104630	395	1302	2053	0	108380
8796	1982	442	104431	1457	0	108312
8797	1301	340	1919	99567	0	103127
8798	637	363	1144	103577	0	105721
8799	100763	344	542	2851	0	104500
8800	1998	386	451	100775	0	103610
8801	98351	332	455	2238	0	101376
8802	2010	97151	530	1578	0	101269
8803	1349	1754	438	96784	0	100325
8804	96483	1077	478	2049	0	100087
8805	96698	420	391	1476	0	98985
8806	2825	383	385	94529	0	98122
8807	1381	414	94499	2142	0	98436
8808	89268	356	1819	1487	0	92930
8809	1874	92639	1241	844	0	96598
8810	91350	1695	537	816	0	94398
8811	90435	981	457	755	0	92628
8812	90680	375	482	712	0	92249
8813	2827	358	87851	836	0	91872
8814	1290	84850	1776	680	0	88596
8815	769	2367	1072	80435	0	84643
8816	770	1897	489	81115	0	84271
8817	687	420	78845	2431	0	82383
8818	568	71102	1512	1286	0	74468
8819	418	54169	735	464	0	55786
8820	244	37646	286	273	0	38449
8821	30893	736	2774	179	0	34582
8822	879	320	195	28365	0	29759
8823	349	92	95	28485	0	29021
8824	157	100	28222	591	0	29070
8825	26429	79	415	308	0	27231
8826	420	75	234	27501	0	28230
8827	315	379	102	27412	0	28208
8828	168	74	27218	588	0	28048
8829	92	26568	408	354	0	27422
8830	206	685	244	25810	0	26945
8831	125	223	25714	417	0	26479
8832	70	22037	302	254	0	22663
8833	16388	96	136	48	0	16668
8834	105	83	17080	51	0	17319
8835	87	33	93	15571	0	15784
8836	25	16765	69	116	0	16975
8837	16680	75	59	84	0	16898
8838	87	68	21	16693	0	16869
8839	16867	19	19	100	0	17005
8840	16607	12	23	82	0	16724
8841	122	16843	27	46	0	17038
8842	16895	80	13	41	0	17029
8843	17353	57	25	49	0	17484
8844	146	23	17692	29	0	17890
8845	17258	11	96	35	0	17400
8846	109	34	17674	27	0	17844
8847	17045	11	75	26	0	17157
8848	17304	17	86	25	0	17432
8849	137	26	18111	28	0	18302
8850	76	30	64	17763	0	17933
8851	41	30	18902	70	0	19043
8852	34	24	18032	58	0	18148
8853	55	30	19913	41	0	20039
8854	69	46	126	19175	0	19416
8855	32	22	56	21833	0	21943
8856	36	15	21	22044	0	22116
8857	23	20	17	22971	0	23031
8858	41	33	24280	183	0	24537
8859	35	15	122	23629	0	23801
8860	34	24336	117	186	0	24673
8861	52	133	26017	127	0	26329
8862	34	97	153	25126	0	25410
8863	60	41	27282	179	0	27562
8864	23	27200	175	154	0	27552
8865	32	27642	153	64	0	27891
8866	27	271	38	27504	0	27840
8867	46	155	27687	196	0	28084
8868	46	44	28399	152	0	28641
8869	26	39	298	28171	0	28534
8870	50	20	152	28772	0	28994
8871	29	28	35	29366	0	29458
8872	51	59	29347	305	0	29762
8873	33	29647	197	225	0	30102
8874	23	30936	170	83	0	31212
8875	44	331	59	30606	0	31040
8876	43	176	30925	225	0	31369
8877	55	46	31421	187	0	31709
8878	39	32316	343	102	0	32800
8879	32057	220	179	79	0	32535
8880	189	33546	60	96	0	33891
8881	183	251	35508	69	0	36011
8882	34567	164	281	64	0	35076
8883	271	48	205	36304	0	36828
8884	37119	36	61	316	0	37532
8885	296	51	44	37471	0	37862
8886	235	38	49	38229	0	38551
8887	38044	50	48	508	0	38650
8888	284	39576	64	357	0	40281
8889	277	334	39606	91	0	40308
8890	53	40533	345	107	0	41038
8891	39684	319	264	74	0	40341
8892	301	40434	86	110	0	40931
8893	40258	324	46	86	0	40714
8894	39907	262	69	80	0	40318
8895	521	40782	76	107	0	41486
8896	277	317	58	40329	0	40981
8897	40273	272	59	355	0	40959
8898	40432	53	65	281	0	40831
8899	565	54	53	40125	0	40797
8900	316	73	39816	333	0	40538
8901	99	83	39873	273	0	40328
8902	90	73	540	39520	0	40223
8903	59	62	39881	356	0	40358
8904	36803	52	367	309	0	37531
8905	303	39040	287	130	0	39760
8906	298	320	80	38939	0	39637
8907	73	261	64	39242	0	39640
8908	70	53	86	39336	0	39545
8909	68	57	57	39027	0	39209
8910	73	63	60	39335	0	39531
8911	83	71	38862	577	0	39593
8912	58	39080	341	347	0	39826
8913	39231	335	277	102	0	39945
8914	347	287	69	39168	0	39871
8915	301	73	67	39449	0	39890
8916	92	59	87	39571	0	39809
8917	65	39821	88	655	0	40629
8918	83	353	65	40846	0	41347
8919	77	324	56	41178	0	41635
8920	39903	67	78	655	0	40703
8921	356	39876	87	411	0	40730
8922	313	40223	88	168	0	40792
8923	87	626	58	40281	0	41052
8924	39863	321	71	436	0	40691
8925	386	111	40412	356	0	41265
8926	37544	91	371	170	0	38176
8927	423	103	41345	127	0	41998
8928	355	87	379	40578	0	41399
8929	117	94	327	41506	0	42044
8930	94	66	89	41488	0	41737
8931	98	75	76	41240	0	41489
8932	101	79	85	41176	0	41441
8933	40042	56	59	705	0	40862
8934	395	84	40187	391	0	41057
8935	338	81	364	40341	0	41124
8936	118	108	42124	464	0	42814
8937	90	41934	400	494	0	42918
8938	41122	368	321	187	0	41998
8939	439	347	43363	186	0	44335
8940	347	116	391	42930	0	43784
8941	125	80	327	44400	0	44932
8942	127	104	44732	738	0	45701
8943	134	104	45011	448	0	45697
8944	113	114	690	42081	0	42998
8945	44527	67	358	520	0	45472
8946	44739	70	99	437	0	45345
8947	682	45084	114	226	0	46106
8948	45522	412	81	196	0	46211
8949	474	328	80	43947	0	44829
8950	372	46171	107	556	0	47206
8951	135	397	87	46335	0	46954
8952	169	385	47034	538	0	48126
8953	178	91	397	44896	0	45562
8954	185	99	337	45893	0	46514
8955	43382	71	89	700	0	44242
8956	391	43828	109	475	0	44803
8957	42864	357	78	154	0	43453
8958	354	42841	122	204	0	43521
8959	40523	331	76	139	0	41069
8960	349	41049	100	157	0	41655
8961	295	40562	84	157	0	41098
8962	40486	510	83	169	0	41248
8963	403	304	100	38015	0	38822
8964	276	39948	76	397	0	40697
8965	40513	299	115	339	0	41266
8966	40196	244	81	142	0	40663
8967	41192	64	69	163	0	41488
8968	40392	70	69	152	0	40683
8969	517	41309	107	154	0	42087
8970	281	297	76	41293	0	41947
8971	109	251	61	41991	0	42412
8972	42345	64	75	599	0	43083
8973	343	71	62	41767	0	42243
8974	41049	60	64	396	0	41569
8975	319	101	40470	314	0	41204
8976	38922	67	261	226	0	39476
8977	326	83	41338	148	0	41895
8978	266	291	278	40069	0	40904
8979	40387	66	255	341	0	41049
8980	296	40404	89	317	0	41106
8981	37931	208	97	133	0	38369
8982	233	39470	59	168	0	39930
8983	249	331	99	41036	0	41715
8984	112	206	40600	253	0	41171
8985	35532	190	330	269	0	36321
8986	192	40455	155	126	0	40928
8987	193	249	55	39864	0	40361
8988	91	112	40	39681	0	39924
8989	67	56	48	39642	0	39813
8990	102	67	40447	312	0	40928
8991	72	40411	170	234	0	40887
8992	39786	159	130	103	0	40178
8993	39785	124	48	99	0	40056
8994	243	40351	58	128	0	40780
8995	41920	161	44	152	0	42277
8996	192	124	67	41835	0	42218
8997	137	42409	63	219	0	42828
8998	42020	155	42	176	0	42393
8999	226	149	41450	137	0	41962
9000	144	42863	173	108	0	43288
9001	102	197	129	43242	0	43670
9002	75	166	47	43893	0	44181
9003	105	94	43635	265	0	44099
9004	74	55	151	41805	0	42085
9005	109	87	44277	215	0	44688
9006	81	67	156	43471	0	43775
9007	106	62	107	44737	0	45012
9008	80	50	44	44949	0	45123
9009	79	60	43	45464	0	45646
9010	104	99	45456	299	0	45958
9011	107	94	48845	183	0	49229
9012	85	53814	397	199	0	54495
9013	100	378	219	56175	0	56872
9014	195	310	59684	407	0	60596
9015	60	59537	479	463	0	60539
9016	135	585	311	60962	0	61993
9017	92	370	63975	477	0	64914
9018	57473	103	521	409	0	58506
9019	65905	52	339	104	0	66400
9020	827	79	61	65730	0	66697
9021	442	92	66433	597	0	67564
9022	121	88	529	65443	0	66181
9023	65821	52	364	627	0	66864
9024	524	69048	135	498	0	70205
9025	71203	563	56	223	0	72045
9026	71782	371	43	194	0	72390
9027	911	93	55	70618	0	71677
9028	441	69	54	71796	0	72360
9029	160	63	52	72473	0	72748
9030	141	57	59	72170	0	72427
9031	127	65	61	72443	0	72696
9032	71475	73	61	1018	0	72627
9033	72028	52	46	528	0	72654
9034	72237	48	92	194	0	72571
9035	1025	138	70780	154	0	72097
9036	68506	75	569	179	0	69329
9037	668	108	414	70129	0	71319
9038	482	131	70468	701	0	71782
9039	159	69983	645	580	0	71367
9040	195	649	457	69458	0	70759
9041	183	415	168	68991	0	69757
9042	165	70704	151	990	0	72010
9043	229	555	104	72392	0	73280
9044	233	444	72056	766	0	73499
9045	201	161	73190	597	0	74149
9046	180	97	1063	73120	0	74460
9047	72561	117	549	783	0	74010
9048	71947	125	154	671	0	72897
9049	1194	164	73600	270	0	75228
9050	638	70948	674	276	0	72536
9051	252	72793	521	334	0	73900
9052	68460	1004	163	335	0	69962
9053	757	551	70939	364	0	72611
9054	571	128	649	69536	0	70884
9055	70058	101	506	862	0	71527
9056	755	70016	187	755	0	71713
9057	634	71250	159	339	0	72382
9058	69971	986	152	258	0	71367
9059	800	552	141	70675	0	72168
9060	73777	123	139	879	0	74918
9061	914	108	157	79860	0	81039
9062	736	121	170	81097	0	82124
9063	350	203	81935	1519	0	84007
9064	293	151	893	82921	0	84258
9065	279	181	651	84301	0	85412
9066	84370	134	265	1703	0	86472
9067	1044	156	199	85879	0	87278
9068	799	191	85443	1291	0	87724
9069	82197	115	1071	992	0	84375
9070	1047	162	826	85206	0	87241
9071	84940	155	281	1205	0	86581
9072	1176	83180	285	1093	0	85734
9073	900	85543	309	536	0	87288
9074	84802	1592	233	392	0	87019
9075	84840	888	211	372	0	86311
9076	1723	301	251	83967	0	86242
9077	1057	288	83996	1165	0	86506
9078	478	167	1041	84706	0	86392
9079	83032	214	824	1352	0	85422
9080	1148	84261	370	1094	0	86873
9081	1036	1054	222	83782	0	86094
9082	83839	850	213	1249	0	86151
9083	1294	357	82453	1012	0	85116
9084	80991	183	1044	639	0	82857
9085	81159	185	815	600	0	82759
9086	1867	254	82563	541	0	85225
9087	1087	249	83996	574	0	85906
9088	604	189	1666	80005	0	82464
9089	553	210	946	80831	0	82540
9090	467	84341	365	1913	0	87086
9091	488	1054	290	85121	0	86953
9092	530	850	86315	1470	0	89165
9093	516	259	1174	86177	0	88126
9094	519	214	935	89952	0	91620
9095	536	256	88316	2125	0	91233
9096	451	87796	1242	1473	0	90962
9097	485	1188	942	87759	0	90374
9098	519	933	362	89538	0	91352
9099	88852	313	297	2101	0	91563
9100	1413	248	349	88712	0	90722
9101	1106	292	88396	1566	0	91360
9102	85947	240	1238	1309	0	88734
9103	88239	298	986	650	0	90173
9104	88877	327	421	630	0	90255
9105	2174	332	86665	574	0	89745
9106	1303	244	1279	85122	0	87948
9107	666	208	1024	86945	0	88843
9108	611	222	509	87992	0	89334
9109	84551	229	412	2216	0	87408
9110	1367	84544	478	1675	0	88064
9111	1079	1029	78986	727	0	81821
9112	485	76230	1045	637	0	78397
9113	407	73225	805	546	0	74983
9114	417	71741	410	553	0	73121
9115	1078	1663	825	68838	0	72404
9116	460	743	68032	1073	0	70308
9117	57064	459	870	949	0	59342
9118	743	65662	730	642	0	67777
9119	62554	636	293	479	0	63962
9120	770	65755	260	495	0	67280
9121	66143	745	221	452	0	67561
9122	845	67698	266	426	0	69235
9123	820	837	68611	403	0	70671
9124	457	616	745	66851	0	68669
9125	363	282	653	70547	0	71845
9126	70394	207	282	1471	0	72354
9127	944	222	232	76991	0	78389
9128	812	323	77312	1232	0	79679
9129	460	212	969	78179	0	79820
9130	453	280	78460	1291	0	80484
9131	320	78020	1119	1218	0	80677
9132	413	971	863	72175	0	74422
9133	335	79134	428	1083	0	80980
9134	78492	1044	305	901	0	80742
9135	1139	777	296	78230	0	80442
9136	945	349	78764	1202	0	81260
9137	482	330	78062	957	0	79831
9138	74957	266	1597	555	0	77375
9139	1093	292	879	76106	0	78370
9140	936	327	76511	1095	0	78869
9141	459	346	74375	936	0	76116
9142	272	75479	1640	540	0	77931
9143	343	1240	1061	68478	0	71122
9144	299	75103	478	1026	0	76906
9145	259	1099	287	74216	0	75861
9146	74663	705	303	1175	0	76846
9147	988	278	318	75003	0	76587
9148	777	243	289	75914	0	77223
9149	75798	222	302	1663	0	77985
9150	1059	278	278	79174	0	80789
9151	836	288	284	76735	0	78143
9152	402	81333	345	1738	0	83818
9153	81247	1020	299	1031	0	83597
9154	82329	818	286	539	0	83972
9155	1647	330	275	82310	0	84562
9156	956	256	319	82437	0	83968
9157	456	260	279	81226	0	82221
9158	328	80016	348	1939	0	82631
9159	315	81836	367	1173	0	83691
9160	432	1514	328	77903	0	80177
9161	69031	601	220	891	0	70743
9162	67357	189	173	792	0	68511
9163	1084	67358	258	461	0	69161
9164	63500	727	166	238	0	64631
9165	637	65186	180	308	0	66311
9166	536	64810	168	280	0	65794
9167	649	1086	224	63373	0	65332
9168	62012	505	194	827	0	63538
9169	631	62034	164	666	0	63495
9170	489	62687	195	350	0	63721
9171	248	972	118	62213	0	63551
9172	186	514	104	63119	0	63923
9173	182	223	62472	1064	0	63941
9174	59032	156	654	639	0	60481
9175	60927	206	465	309	0	61907
9176	1042	225	62781	272	0	64320
9177	579	207	62463	315	0	63564
9178	227	231	996	61847	0	63301
9179	223	161	477	63113	0	63974
9180	166	63024	156	1201	0	64547
9181	249	722	111	63626	0	64708
9182	240	669	62630	859	0	64398
9183	241	226	655	61505	0	62627
9184	252	200	503	62041	0	62996
9185	60793	199	176	1262	0	62430
9186	802	235	60162	789	0	61988
9187	57500	192	719	390	0	58801
9188	813	236	59009	406	0	60464
9189	562	234	719	56842	0	58357
9190	252	262	57245	876	0	58635
9191	230	280	56827	779	0	58116
9192	284	415	1102	54542	0	56343
9193	53270	291	859	997	0	55417
9194	51157	226	287	735	0	52405
9195	979	52008	287	459	0	53733
9196	51821	720	320	418	0	53279
9197	50742	576	268	371	0	51957
9198	1033	51558	312	393	0	53296
9199	673	738	288	51924	0	53623
9200	306	574	329	52608	0	53817
9201	226	242	281	52566	0	53315
9202	266	244	281	52790	0	53581
9203	270	281	51842	1275	0	53668
9204	48243	206	750	897	0	50096
9205	756	205	629	51731	0	53321
9206	660	204	305	50594	0	51763
9207	297	51919	269	1306	0	53791
9208	358	760	162	52742	0	54022
9209	328	651	52880	1014	0	54873
9210	47886	276	768	928	0	49858
9211	870	263	53217	545	0	54895
9212	731	300	641	51324	0	52996
9213	50776	223	482	1047	0	52528
9214	788	51796	165	956	0	53705
9215	741	738	112	52660	0	54251
9216	409	669	52817	1017	0	54912
9217	347	340	627	52873	0	54187
9218	51831	269	541	994	0	53635
9219	913	290	52404	848	0	54455
9220	768	287	50830	478	0	52363
9221	303	49998	1093	476	0	51870
9222	47102	849	651	442	0	49044
9223	754	46495	180	512	0	47941
9224	647	747	44852	337	0	46583
9225	256	570	41868	294	0	42988
9226	224	40821	878	278	0	42201
9227	32610	414	624	137	0	33785
9228	357	33054	185	173	0	33769
9229	353	314	79	31760	0	32506
9230	108	284	85	32434	0	32911
9231	109	91	32274	553	0	33027
9232	90	63	348	31834	0	32335
9233	83	84	32539	372	0	33078
9234	31008	51	345	363	0	31767
9235	32111	66	328	120	0	32625
9236	32239	77	103	120	0	32539
9237	575	68	31826	142	0	32611
9238	31379	57	343	138	0	31917
9239	351	81	318	29670	0	30420
9240	311	31419	118	366	0	32214
9241	31509	285	136	309	0	32239
9242	349	286	30956	104	0	31695
9243	29483	57	335	138	0	30013
9244	29324	34	339	119	0	29816
9245	539	69	28153	139	0	28900
9246	275	28061	342	147	0	28825
9247	128	480	311	27800	0	28719
9248	118	239	28119	312	0	28788
9249	113	81	26929	262	0	27385
9250	145	691	410	22183	0	23429
9251	89	35	22426	219	0	22769
9252	58	51	211	20765	0	21085
9253	68	34	177	20364	0	20643
9254	51	35	62	20892	0	21040
9255	76	42	20728	328	0	21174
9256	68	28	212	20676	0	20984
9257	76	54	20991	198	0	21319
9258	66	36	226	21069	0	21397
9259	21498	48	200	211	0	21957
9260	208	35	64	21369	0	21676
9261	189	22271	74	237	0	22771
9262	63	207	69	23018	0	23357
9263	22936	180	58	268	0	23442
9264	198	23338	80	249	0	23865
9265	230	204	59	23214	0	23707
9266	22970	201	68	253	0	23492
9267	240	53	23371	256	0	23920
9268	238	44	248	22890	0	23420
9269	75	52	23732	266	0	24125
9270	63	41	23439	259	0	23802
9271	75	54	422	22889	0	23440
9272	23213	34	261	241	0	23749
9273	250	56	22901	253	0	23460
9274	22386	41	258	59	0	22744
9275	251	59	245	22747	0	23302
9276	240	54	22753	220	0	23267
9277	91	44	22534	225	0	22894
9278	72	56	22387	84	0	22599
9279	64	242	379	20659	0	21344
9280	21179	34	441	217	0	21871
9281	177	21352	87	215	0	21831
9282	206	171	77	20846	0	21300
9283	105	186	59	21278	0	21628
9284	21304	37	89	331	0	21761
9285	21154	34	67	222	0	21477
9286	316	21341	99	90	0	21846
9287	21519	173	66	77	0	21835
9288	21397	167	82	59	0	21705
9289	340	34	73	21151	0	21598
9290	214	39	21433	209	0	21895
9291	20960	42	194	205	0	21401
9292	208	33	203	21791	0	22235
9293	197	41	64	21885	0	22187
9294	21591	23	70	354	0	22038
9295	216	48	60	20788	0	21112
9296	213	39	55	20914	0	21221
9297	20503	24	54	365	0	20946
9298	213	21069	76	214	0	21572
9299	20746	152	35	90	0	21023
9300	209	163	20812	63	0	21247
9301	20293	22	216	80	0	20611
9302	196	27	189	20155	0	20567
9303	175	21056	67	208	0	21506
9304	66	175	63	21291	0	21595
9305	75	146	53	21197	0	21471
9306	68	34	41	21198	0	21341
9307	20552	18	59	343	0	20972
9308	183	20247	46	191	0	20667
9309	143	19747	49	69	0	20008
9310	19258	243	48	63	0	19612
9311	181	137	20191	51	0	20560
9312	155	38	19981	57	0	20231
9313	18880	118	385	76	0	19459
9314	170	39	19727	59	0	19995
9315	108	15	113	18500	0	18736
9316	41	11	106	18522	0	18680
9317	32	8	40	19198	0	19278
9318	46	12	28	18855	0	18941
9319	30	18982	38	235	0	19285
9320	33	115	31	19294	0	19473
9321	42	126	19040	134	0	19342
9322	39	25	125	18850	0	19039
9323	42	36	18909	164	0	19151
9324	59	33	18674	127	0	18893
9325	39	31	221	18792	0	19083
9326	56	47	19258	155	0	19516
9327	45	18	141	18950	0	19154
9328	19106	27	131	162	0	19426
9329	142	45	19340	142	0	19669
9330	18175	15	142	67	0	18399
9331	150	18	130	19078	0	19376
9332	147	36	19170	163	0	19516
9333	53	19047	149	168	0	19417
9334	46	116	137	19693	0	19992
9335	69	114	20687	160	0	21030
9336	46	27	152	20618	0	20843
9337	21234	16	144	186	0	21580
9338	21280	20	57	165	0	21522
9339	21780	24	46	93	0	21943
9340	254	18	43	22172	0	22487
9341	174	21	43	22459	0	22697
9342	57	23	36	22904	0	23020
9343	23338	24	39	311	0	23712
9344	178	24209	61	210	0	24658
9345	206	198	41	24229	0	24674
9346	62	173	38	24817	0	25090
9347	24573	40	31	398	0	25042
9348	227	25369	54	255	0	25905
9349	235	232	31	26427	0	26925
9350	26917	204	31	325	0	27477
9351	26702	45	45	281	0	27073
9352	521	37	40	26629	0	27227
9353	26801	27	35	329	0	27192
9354	355	30	48	26744	0	27177
9355	301	40	27681	353	0	28375
9356	96	30	293	27550	0	27969
9357	93	28	249	27981	0	28351
9358	111	29	66	28320	0	28526
9359	26740	31	45	544	0	27360
9360	294	26958	63	340	0	27655
9361	25632	274	36	96	0	26038
9362	275	25819	42	93	0	26229
9363	193	26204	43	73	0	26513
9364	25715	424	17	72	0	26228
9365	263	26672	38	62	0	27035
9366	215	279	28	26368	0	26890
9367	26186	196	55	305	0	26742
9368	26255	50	30	241	0	26576
9369	460	20	28	26235	0	26743
9370	252	31	26	25585	0	25894
9371	55	26554	29	475	0	27113
9372	26749	281	18	267	0	27315
9373	25650	210	21	127	0	26008
9374	455	27867	45	107	0	28474
9375	233	27974	45	94	0	28346
9376	79	488	24	28248	0	28839
9377	28149	241	27	381	0	28798
9378	347	55	27	28422	0	28851
9379	272	51	27	28851	0	29201
9380	92	42	28308	583	0	29025
9381	107	51	28272	293	0	28723
9382	83	63	522	27963	0	28631
9383	89	55	28474	387	0	29005
9384	55	28287	343	349	0	29034
9385	110	350	248	28202	0	28910
9386	90	248	48	28756	0	29142
9387	87	66	30	29078	0	29261
9388	68	77	28937	596	0	29678
9389	89	90	28467	328	0	28974
9390	26728	48	505	141	0	27422
9391	348	28672	266	150	0	29436
9392	28367	317	43	103	0	28830
9393	370	250	38	28103	0	28761
9394	28725	74	49	371	0	29219
9395	386	72	30	27632	0	28120
9396	265	28895	42	376	0	29578
9397	28996	317	43	320	0	29676
9398	377	266	28515	156	0	29314
9399	279	28346	317	119	0	29061
9400	28236	318	240	128	0	28922
9401	362	266	59	27197	0	27884
9402	260	27548	59	347	0	28214
9403	125	321	45	27904	0	28395
9404	27587	250	38	389	0	28264
9405	371	71	37	27846	0	28325
9406	27639	72	37	406	0	28154
9407	402	80	27503	303	0	28288
9408	296	78	295	27131	0	27800
9409	26933	77	221	411	0	27642
9410	382	99	27050	338	0	27869
9411	304	26033	330	200	0	26867
9412	137	333	239	25486	0	26195
9413	119	289	25604	388	0	26400
9414	155	112	25445	306	0	26018
9415	106	161	507	24972	0	25746
9416	129	96	25579	398	0	26202
9417	152	112	25326	319	0	25909
9418	142	104	502	24173	0	24921
9419	24896	81	259	396	0	25632
9420	372	78	81	24964	0	25495
9421	292	76	73	25373	0	25814
9422	132	73	25510	567	0	26282
9423	118	72	314	25965	0	26469
9424	26227	67	269	449	0	27012
9425	344	79	26753	356	0	27532
9426	283	26878	350	186	0	27697
9427	127	334	271	27125	0	27857
9428	27391	258	91	410	0	28150
9429	363	115	80	27241	0	27799
9430	278	27730	99	417	0	28524
9431	127	364	28425	342	0	29258
9432	119	288	349	28797	0	29553
9433	30747	89	297	416	0	31549
9434	454	91	30633	359	0	31537
9435	346	68	415	31143	0	31972
9436	31988	54	335	516	0	32893
9437	33095	63	120	402	0	33680
9438	731	33807	112	190	0	34840
9439	33353	428	96	147	0	34024
9440	495	352	84	33100	0	34031
9441	405	126	34066	506	0	35103
9442	140	33515	456	415	0	34526
9443	110	33728	369	166	0	34373
9444	132	723	272	31893	0	33020
9445	142	369	100	32659	0	33270
9446	115	84	31590	631	0	32420
9447	92	31214	411	379	0	32096
9448	66	30975	303	132	0	31476
9449	202	647	203	28487	0	29539
9450	28051	253	73	298	0	28675
9451	263	28364	68	277	0	28972
9452	249	288	36	28621	0	29194
9453	29241	224	55	367	0	29887
9454	284	58	52	29613	0	30007
9455	249	46	62	29228	0	29585
9456	92	63	41	29611	0	29807
9457	86	58	48	29610	0	29802
9458	28690	48	52	521	0	29311
9459	283	41	50	29142	0	29516
9460	255	78	28390	317	0	29040
9461	26995	66	289	308	0	27658
9462	306	69	28351	118	0	28844
9463	278	56	29094	104	0	29532
9464	72	53	471	28374	0	28970
9465	91	51	266	28766	0	29174
9466	66	48	63	29477	0	29654
9467	28955	54	57	499	0	29565
9468	300	61	28951	297	0	29609
9469	28036	44	281	145	0	28506
9470	28944	43	227	123	0	29337
9471	475	66	29361	96	0	29998
9472	27971	36	268	120	0	28395
9473	310	54	29513	112	0	29989
9474	223	29409	269	114	0	30015
9475	157	275	317	29192	0	29941
9476	77	181	61	29562	0	29881
9477	61	47	42	29375	0	29525
9478	65	28	53	29333	0	29479
9479	92	63	29288	429	0	29872
9480	87	41	29166	252	0	29546
9481	67	28	403	28991	0	29489
9482	66	49	29731	277	0	30123
9483	27648	44	262	258	0	28212
9484	29629	37	214	126	0	30006
9485	401	47	66	29375	0	29889
9486	29358	42	69	283	0	29752
9487	266	30249	62	292	0	30869
9488	30008	209	66	127	0	30410
9489	297	213	30244	124	0	30878
9490	244	57	235	29343	0	29879
9491	79	30683	238	285	0	31285
9492	31074	217	72	253	0	31616
9493	260	199	67	31218	0	31744
9494	245	75	31324	296	0	31940
9495	94	43	232	30892	0	31261
9496	30734	41	213	331	0	31319
9497	304	75	31904	281	0	32564
9498	251	38	261	31699	0	32249
9499	100	44	239	32557	0	32940
9500	110	71	32548	483	0	33212
9501	95	32069	270	319	0	32753
9502	113	31498	274	177	0	32062
9503	133	405	95	33298	0	33931
9504	108	253	93	34142	0	34596
9505	106	76	74	34731	0	34987
9506	33487	69	72	541	0	34169
9507	33648	64	78	352	0	34142
9508	477	68	94	34170	0	34809
9509	34075	78	75	365	0	34593
9510	280	34724	75	371	0	35450
9511	284	292	72	35259	0	35907
9512	93	265	70	35686	0	36114
9513	89	78	69	36057	0	36293
9514	33727	67	79	576	0	34449
9515	295	34457	101	380	0	35233
9516	282	255	77	34821	0	35435
9517	34592	249	61	387	0	35289
9518	316	59	57	35085	0	35517
9519	308	41	66	34611	0	35026
9520	125	34105	73	576	0	34879
9521	103	34978	90	409	0	35580
9522	122	445	60	34615	0	35242
9523	118	245	90	34225	0	34678
9524	32860	51	76	582	0	33569
9525	327	38	83	33370	0	33818
9526	292	70	32657	404	0	33423
9527	141	57	275	32095	0	32568
9528	107	31972	289	412	0	32780
9529	32651	240	100	384	0	33375
9530	338	233	87	32655	0	33313
9531	311	69	66	31523	0	31969
9532	125	31795	88	516	0	32524
9533	29519	178	78	282	0	30057
9534	218	31408	82	174	0	31882
9535	240	235	92	30193	0	30760
9536	130	185	29581	240	0	30136
9537	249	500	207	26545	0	27501
9538	26877	21	144	201	0	27243
9539	142	27429	24	204	0	27799
9540	146	171	22	27092	0	27431
9541	42	27229	37	183	0	27491
9542	43	160	31	27568	0	27802
9543	56	154	27530	202	0	27942
9544	43	141	151	27016	0	27351
9545	33	37	140	27409	0	27619
9546	37	36	22	28037	0	28132
9547	26893	29	23	301	0	27246
9548	27009	34	23	204	0	27270
9549	269	27655	20	122	0	28066
9550	27264	166	27	87	0	27544
9551	169	27417	31	92	0	27709
9552	142	27725	28	92	0	27987
9553	26790	272	20	98	0	27180
9554	202	159	26198	89	0	26648
9555	168	52	147	25879	0	26246
9556	58	51	127	27095	0	27331
9557	64	46	21	27667	0	27798
9558	26716	49	27	347	0	27139
9559	179	27310	35	266	0	27790
9560	169	221	22	26900	0	27312
9561	64	27544	41	275	0	27924
9562	27943	210	30	225	0	28408
9563	229	173	26	28081	0	28509
9564	179	75	26	32940	0	33220
9565	54	35937	34	596	0	36621
9566	63	368	26	37719	0	38176
9567	60	376	27	37901	0	38364
9568	35850	94	22	868	0	36834
9569	385	36018	42	602	0	37047
9570	361	36488	48	263	0	37160
9571	156	737	18	36361	0	37272
9572	138	453	34953	529	0	36073
9573	122	189	34467	492	0	35270
9574	98	179	712	34310	0	35299
9575	101	137	34243	554	0	35035
9576	88	98	474	34368	0	35028
9577	94	115	435	33330	0	33974
9578	79	106	120	35344	0	35649
9579	33741	93	96	1005	0	34935
9580	436	76	100	34410	0	35022
9581	425	77	83	33759	0	34344
9582	130	33183	91	976	0	34380
9583	125	431	59	34767	0	35382
9584	145	451	33305	696	0	34597
9585	108	160	403	34182	0	34853
9586	101	137	394	34699	0	35331
9587	32473	134	106	1045	0	33758
9588	456	121	105	33443	0	34125
9589	444	131	83	32909	0	33567
9590	152	124	70	33538	0	33884
9591	30106	139	79	1124	0	31448
9592	445	31378	96	731	0	32650
9593	416	505	95	32007	0	33023
9594	143	476	91	32156	0	32866
9595	137	214	31043	1061	0	32455
9596	127	165	475	31482	0	32249
9597	28775	146	490	812	0	30223
9598	438	29781	171	812	0	31202
9599	432	495	152	29366	0	30445
9600	200	526	113	29615	0	30454
9601	159	215	28759	1154	0	30287
9602	26234	154	466	858	0	27712
9603	445	28140	496	561	0	29642
9604	27404	516	192	521	0	28633
9605	471	521	158	27990	0	29140
9606	459	224	135	28298	0	29116
9607	221	206	145	28692	0	29264
9608	215	209	139	28836	0	29399
9609	27524	198	106	1290	0	29118
9610	513	175	144	27203	0	28035
9611	458	26165	173	960	0	27756
9612	209	436	170	27242	0	28057
9613	183	443	193	27657	0	28476
9614	26503	181	172	1238	0	28094
9615	510	26364	170	975	0	28019
9616	479	517	130	27403	0	28529
9617	26632	491	110	992	0	28225
9618	26951	223	141	966	0	28281
9619	897	193	124	27306	0	28520
9620	615	216	26499	979	0	28309
9621	26240	244	436	921	0	27841
9622	581	223	443	27226	0	28473
9623	528	172	26752	1045	0	28497
9624	246	158	571	27712	0	28687
9625	260	195	488	27494	0	28437
9626	287	167	178	27151	0	27783
9627	284	27363	168	1303	0	29118
9628	218	484	132	28781	0	29615
9629	204	457	117	28416	0	29194
9630	244	211	141	28564	0	29160
9631	274	206	101	28423	0	29004
9632	250	230	90	27906	0	28476
9633	238	249	119	27823	0	28429
9634	24168	193	115	1396	0	25872
9635	478	177	23670	1053	0	25378
9636	472	23089	454	735	0	24750
9637	22982	421	407	614	0	24424
9638	473	23403	167	576	0	24619
9639	23062	462	174	567	0	24265
9640	647	440	186	22950	0	24223
9641	23244	180	186	810	0	24420
9642	604	155	139	23332	0	24230
9643	577	165	132	21646	0	22520
9644	335	22260	122	1049	0	23766
9645	22458	402	94	930	0	23884
9646	498	415	22799	680	0	24392
9647	510	180	346	23374	0	24410
9648	300	122	23553	907	0	24882
9649	281	159	23049	847	0	24336
9650	22956	171	644	598	0	24369
9651	428	161	430	23052	0	24071
9652	494	126	23422	842	0	24884
9653	294	123	23994	847	0	25258
9654	251	134	661	23988	0	25034
9655	227	164	412	24649	0	25452
9656	24334	135	177	1056	0	25702
9657	566	106	148	24869	0	25689
9658	541	123	25201	832	0	26697
9659	309	108	410	25690	0	26517
9660	310	237	394	24873	0	25814
9661	248	25979	195	957	0	27379
9662	24993	338	150	772	0	26253
9663	396	24872	174	564	0	26006
9664	19983	151	97	317	0	20548
9665	125	16449	42	133	0	16749
9666	92	15819	56	83	0	16050
9667	79	128	132	15587	0	15926
9668	54	71	63	15534	0	15722
9669	45	38	30	15562	0	15675
9670	14914	19	22	153	0	15108
9671	95	35	15023	113	0	15266
9672	55	20	56	14889	0	15020
9673	14383	23	57	96	0	14559
9674	63	14897	36	101	0	15097
9675	67	14881	25	77	0	15050
9676	47	97	47	15036	0	15227
9677	19	50	20	15150	0	15239
9678	23	38	14	15210	0	15285
9679	35	15592	24	123	0	15774
9680	34	45	21	15663	0	15763
9681	37	69	15569	93	0	15768
9682	40	40	14940	80	0	15100
9683	14646	20	73	58	0	14797
9684	60	18	44	15620	0	15742
9685	15733	20	15	81	0	15849
9686	15557	12	22	80	0	15671
9687	65	15965	33	48	0	16111
9688	16185	34	13	57	0	16289
9689	16752	45	15	79	0	16891
9690	86	22	16	16785	0	16909
9691	61	14	18	17336	0	17429
9692	45	28	18225	110	0	18408
9693	21	18975	65	102	0	19163
9694	29	44	45	18697	0	18815
9695	28	57	23	19390	0	19498
9696	19441	21	19	110	0	19591
9697	53	25	21	19611	0	19710
9698	19982	17	17	92	0	20108
9699	66	17	29	20410	0	20522
9700	55	21066	33	100	0	21254
9701	21725	72	16	118	0	21931
9702	104	68	14	24399	0	24585
9703	87	25	21	26853	0	26986
9704	57	16	17	28740	0	28830
9705	45	39	28721	430	0	29235
9706	39	18	251	29122	0	29430
9707	29771	16	189	349	0	30325
9708	276	21	31	31656	0	31984
9709	228	24	27	35786	0	36065
9710	64	40	26	35447	0	35577
9711	32	36211	38	771	0	37052
9712	37	37666	36	398	0	38137
9713	36790	750	13	91	0	37644
9714	432	37716	47	110	0	38305
9715	37448	501	16	60	0	38025
9716	37238	348	18	63	0	37667
9717	37396	58	14	73	0	37541
9718	844	67	37284	69	0	38264
9719	386	37892	486	57	0	38821
9720	37697	473	332	62	0	38564
9721	513	332	43	38057	0	38945
9722	381	54	31	38552	0	39018
9723	74	32	22	38478	0	38606
9724	51	37511	51	886	0	38499
9725	56	466	7	38147	0	38676
9726	37205	327	23	587	0	38142
9727	473	50	20	37150	0	37693
9728	359	41	17	37514	0	37931
9729	92	65	36800	915	0	37872
9730	102	51	37443	468	0	38064
9731	67	40	802	37308	0	38217
9732	97	27	380	37351	0	37855
9733	62	37603	115	936	0	38716
9734	96	499	67	38083	0	38745
9735	87	358	51	38398	0	38894
9736	81	84	26	38774	0	38965
9737	36946	78	42	987	0	38053
9738	577	141	37822	519	0	39059
9739	456	106	487	38127	0	39176
9740	38344	112	350	615	0	39421
9741	38336	104	66	442	0	38948
9742	916	129	51	37889	0	38985
9743	512	87	50	38479	0	39128
9744	37390	91	43	971	0	38495
9745	621	37592	87	540	0	38840
9746	464	37952	97	196	0	38709
9747	190	904	78	37126	0	38298
9748	37532	462	52	654	0	38700
9749	37852	123	44	534	0	38553
9750	37530	98	53	278	0	37959
9751	947	104	37481	281	0	38813
9752	35603	129	547	281	0	36560
9753	701	154	36881	239	0	37975
9754	35277	110	561	281	0	36229
9755	595	36233	443	327	0	37598
9756	498	572	36176	317	0	37563
9757	212	424	575	35719	0	36930
9758	186	163	36087	771	0	37207
9759	171	137	577	35216	0	36101
9760	34668	142	437	828	0	36075
9761	645	156	34893	688	0	36382
9762	491	127	594	33952	0	35164
9763	189	36173	497	803	0	37662
9764	231	541	153	37022	0	37947
9765	232	407	151	36813	0	37603
9766	218	155	126	36921	0	37420
9767	36189	159	112	1159	0	37619
9768	36452	133	88	750	0	37423
9769	1009	132	62	36631	0	37834
9770	606	153	36120	886	0	37765
9771	302	172	36113	661	0	37248
9772	255	169	913	36341	0	37678
9773	320	174	37793	817	0	39104
9774	314	171	590	37630	0	38705
9775	344	136	438	37204	0	38122
9776	326	122	161	37785	0	38394
9777	319	36404	185	1095	0	38003
9778	302	37867	184	647	0	39000
9779	306	921	157	37754	0	39138
9780	271	520	171	38007	0	38969
9781	313	193	145	38364	0	39015
9782	36814	163	148	1123	0	38248
9783	761	163	37828	719	0	39471
9784	625	140	634	37716	0	39115
9785	37533	92	537	812	0	38974
9786	715	37859	266	710	0	39550
9787	585	618	211	38352	0	39766
9788	278	449	205	38996	0	39928
9789	226	168	187	38700	0	39281
9790	225	120	195	38779	0	39319
9791	233	137	37411	1249	0	39030
9792	34254	104	620	827	0	35805
9793	36166	135	488	489	0	37278
9794	1048	128	36077	422	0	37675
9795	35088	93	669	421	0	36271
9796	36278	85	509	378	0	37250
9797	1070	132	36529	399	0	38130
9798	536	37155	710	414	0	38815
9799	283	741	549	36561	0	38134
9800	266	380	38019	761	0	39426
9801	245	37120	623	723	0	38711
9802	298	475	34883	330	0	35986
9803	134	32687	501	261	0	33583
9804	207	438	541	30272	0	31458
9805	147	226	30654	415	0	31442
9806	151	106	427	29530	0	30214
9807	160	76	31069	455	0	31760
9808	61	29877	358	366	0	30662
9809	24734	104	280	103	0	25221
9810	68	24788	40	57	0	24953
9811	103	26446	69	110	0	26728
9812	286	135	123	25947	0	26491
9813	11	70	59	26201	0	26341
9814	11	14	6	26209	0	26240
9815	20	4	6	26134	0	26164
9816	19	4	7	26486	0	26516
9817	30	40	29905	122	0	30097
9818	22	6	40	29263	0	29331
9819	10	7	73	30817	0	30907
9820	31631	4	8	157	0	31800
9821	32036	10	15	101	0	32162
9822	32663	8	6	47	0	32724
9823	130	9	5	33112	0	33256
9824	37561	9	17	118	0	37705
9825	41028	16	7	172	0	41223
9826	42310	7	18	69	0	42404
9827	323	46	42859	16	0	43244
9828	41343	15	150	47	0	41555
9829	44037	10	160	67	0	44274
9830	44807	10	27	51	0	44895
9831	347	14	9	44956	0	45326
9832	202	57	45993	197	0	46449
9833	42	16	159	45381	0	45598
9834	48202	9	180	271	0	48662
9835	206	11	22	49277	0	49516
9836	199	53789	60	194	0	54242
9837	56	171	19	55465	0	55711
9838	55672	182	15	237	0	56106
9839	56271	24	26	277	0	56598
9840	55690	12	27	64	0	55793
9841	485	67	59207	66	0	59825
9842	264	17	219	57678	0	58178
9843	84	40	224	61149	0	61497
9844	90	45	62731	478	0	63344
9845	42	61951	272	364	0	62629
9846	135	271	62940	78	0	63424
9847	79	230	247	62175	0	62731
9848	63392	32	258	286	0	63968
9849	310	65	67123	308	0	67806
9850	292	21	235	66330	0	66878
9851	116	53	68112	298	0	68579
9852	64572	23	277	321	0	65193
9853	285	34	242	68955	0	69516
9854	304	93	73922	318	0	74637
9855	109	33	272	73029	0	73443
9856	132	73	76884	403	0	77492
9857	74	78371	326	501	0	79272
9858	104	273	253	78920	0	79550
9859	80697	247	78	386	0	81408
9860	362	56	68	81332	0	81818
9861	337	36	68	80941	0	81382
9862	80900	24	77	602	0	81603
9863	341	79303	84	398	0	80126
9864	329	82312	98	206	0	82945
9865	156	556	64	82227	0	83003
9866	93	83869	114	419	0	84495
9867	113	299	59	84217	0	84688
9868	124	266	63	84200	0	84653
9869	84507	50	61	669	0	85287
9870	329	85704	100	633	0	86766
9871	426	372	85747	235	0	86780
9872	149	89300	329	233	0	90011
9873	88651	318	276	166	0	89411
9874	90441	279	93	187	0	91000
9875	607	90	90	89972	0	90759
9876	93095	64	90	457	0	93706
9877	455	64	75	92835	0	93429
9878	94206	57	105	531	0	94899
9879	96245	54	90	480	0	96869
9880	750	66	99	101712	0	102627
9881	103743	44	124	593	0	104504
9882	561	148	104618	420	0	105747
9883	100913	58	443	280	0	101694
9884	499	73	357	105937	0	106866
9885	107835	56	125	544	0	108560
9886	534	112785	196	448	0	113963
9887	484	369	89	113335	0	114277
9888	243	315	144	113991	0	114693
9889	112870	99	136	798	0	113903
9890	609	198	116273	512	0	117592
9891	488	117157	500	328	0	118473
9892	291	400	358	117611	0	118660
9893	214	122095	199	545	0	123053
9894	256	456	121	123747	0	124580
9895	241	330	118	122727	0	123416
9896	263	114	102	124363	0	124842
9897	123646	140	121	926	0	124833
9898	530	128	98	123211	0	123967
9899	125663	129	114	760	0	126666
9900	126536	117	118	671	0	127442
9901	828	134	94	128983	0	130039
9902	129381	105	150	658	0	130294
9903	125890	111	136	593	0	126730
9904	901	246	130205	294	0	131646
9905	524	116	472	125517	0	126629
9906	132019	134	407	611	0	133171
9907	480	134967	274	586	0	136307
9908	137687	422	171	393	0	138673
9909	136789	380	112	360	0	137641
9910	943	218	136614	243	0	138018
9911	566	139	452	129498	0	130655
9912	151730	109	431	943	0	153213
9913	723	135	156	158701	0	159715
9914	634	92	134	165288	0	166148
9915	322	94	138	167523	0	168077
9916	311	82	140	176371	0	176904
9917	176542	84	166	1649	0	178441
9918	1365	285	184205	931	0	186786
9919	1030	206	1185	187692	0	190113
9920	511	302	208480	1504	0	210797
9921	472	269	216710	1188	0	218639
9922	202942	178	3880	688	0	207688
9923	3073	267	231844	448	0	235632
9924	1804	226916	2959	465	0	232144
9925	232646	2576	2333	461	0	238016
9926	234008	1728	472	334	0	236542
9927	4383	360	243	229979	0	234965
9928	2344	263	238301	2601	0	243509
9929	685	318	238054	1884	0	240941
9930	233256	148	4520	640	0	238564
9931	2897	221	2226	249074	0	254418
9932	252383	103	541	2851	0	255878
9933	3000	261123	553	2275	0	266951
9934	261050	2815	325	647	0	264837
9935	258350	1999	291	474	0	261114
9936	4829	260884	458	411	0	266582
9937	2487	2895	262	260668	0	266312
9938	258361	2022	330	3134	0	263847
9939	3438	635	261760	2278	0	268111
9940	2404	264560	3316	797	0	271077
9941	950	2964	2307	260558	0	266779
9942	262409	2101	721	3134	0	268365
9943	3191	266513	602	2458	0	272764
9944	268533	3062	469	819	0	272883
9945	3943	2637	265925	505	0	273010
9946	253764	666	3257	617	0	258304
9947	3985	540	269678	516	0	274719
9948	256148	314	3634	586	0	260682
9949	260233	333	2640	651	0	263857
9950	5752	524	263797	677	0	270750
9951	3005	264538	3537	1048	0	272128
9952	1315	3159	2534	256835	0	263843
9953	1231	2631	265371	3539	0	272772
9954	983	261870	3557	2833	0	269243
9955	1101	3265	2689	254893	0	261948
9956	1193	2506	1034	262305	0	267038
9957	1257	877	259867	5528	0	267529
9958	1214	522	3668	248097	0	253501
9959	1173	505	2998	259712	0	264388
9960	1245	803	259455	5616	0	267119
9961	1242	720	3861	244341	0	250164
9962	1055	258541	3254	3853	0	266703
9963	257725	3435	1367	2871	0	265398
9964	4096	2683	1341	254054	0	262174
9965	3352	263572	1604	3795	0	272323
9966	2076	3595	1454	245890	0	253015
9967	1738	269064	1647	3648	0	276097
9968	2405	3997	265166	2806	0	274374
9969	1662	270161	4278	1407	0	277508
9970	264047	4047	3413	1307	0	272814
9971	263357	2986	1602	1346	0	269291
9972	263634	1292	1503	1498	0	267927
9973	6972	1116	269790	1362	0	279240
9974	4423	1231	266506	1429	0	273589
9975	2207	273984	6675	1578	0	284444
9976	2369	4260	3884	255055	0	265568
9977	2000	279675	1898	4078	0	287651
9978	2579	4898	1552	245834	0	254863
9979	2143	278253	1699	3985	0	286080
9980	276082	4757	1453	3311	0	285603
9981	293441	3899	1493	1658	0	300491
9982	8429	1729	1404	304968	0	316530
9983	5582	1556	306769	5520	0	319427
9984	286486	1513	5784	4534	0	298317
9985	6230	309840	4811	2171	0	323052
9986	5283	5543	2231	302630	0	315687
9987	3229	4622	1736	291385	0	300972
9988	2559	309519	1854	8016	0	321948
9989	306178	5852	1872	4706	0	318608
9990	7048	4952	306101	1774	0	319875
9991	5764	2233	5853	302622	0	316472
9992	304306	1761	4781	5773	0	316621
9993	297776	1757	2408	4848	0	306789
9994	9451	302907	2135	2394	0	316887
9995	5876	5958	2089	288350	0	302273
9996	2567	306473	2193	5854	0	317087
9997	302987	6269	2202	5142	0	316600
9998	6491	5221	305652	2481	0	319845
9999	5511	2835	305602	2059	0	316007
10000	2772	2091	8679	292063	0	305605
10001	2338	1938	5393	288896	0	298565
10002	2211	300874	2852	8702	0	314639
10003	2255	5974	2194	300313	0	310736
10004	2415	4906	297995	6779	0	312095
10005	282035	2298	6202	5471	0	296006
10006	6132	2127	4820	297801	0	310880
10007	5140	2446	293918	6414	0	307918
10008	2810	2177	5806	291159	0	301952
10009	2177	1974	5028	280544	0	289723
10010	1736	291758	2635	9131	0	305260
10011	2205	6094	1843	289181	0	299323
10012	1950	4787	1987	277735	0	286459
10013	2075	2501	1973	276263	0	282812
10014	256180	1723	1711	9363	0	268977
10015	5695	255697	1885	5692	0	268969
10016	4599	250966	1630	2917	0	260112
10017	234950	6966	1619	2153	0	245688
10018	223745	3970	1602	1920	0	231237
10019	6655	222711	1714	1676	0	232756
10020	3235	202968	1061	1255	0	208519
10021	177076	4236	931	834	0	183077
10022	2708	180392	625	900	0	184625
10023	2103	175978	572	897	0	179550
10024	169358	3957	1965	822	0	176102
10025	2494	170246	526	873	0	174139
10026	167002	2833	747	791	0	171373
10027	165019	2191	573	728	0	168511
10028	162943	1157	454	751	0	165305
10029	4123	162676	559	871	0	168229
10030	2525	160767	501	929	0	164722
10031	1373	3921	327	152272	0	157893
10032	1084	158684	505	2315	0	162588
10033	1150	2902	437	155444	0	159933
10034	154258	2216	485	2807	0	159766
10035	2618	1222	466	150953	0	155259
10036	2306	151554	599	2867	0	157326
10037	147753	2523	537	2311	0	153124
10038	2542	149697	521	1423	0	154183
10039	2278	151175	459	1215	0	155127
10040	1437	4693	437	140681	0	147248
10041	947	148185	539	2392	0	152063
10042	144473	2881	615	2071	0	150040
10043	2666	2394	143062	1105	0	149227
10044	2161	142231	2311	1137	0	147840
10045	1162	2533	1887	141085	0	146667
10046	1099	2447	141438	2747	0	147731
10047	965	1214	2237	138219	0	142635
10048	944	1039	2012	141179	0	145174
10049	949	977	988	142786	0	145700
10050	1022	879	797	141884	0	144582
10051	1069	1008	138499	4593	0	145169
10052	723	137485	2494	3330	0	144032
10053	135601	2374	2036	1951	0	141962
10054	2338	2396	135193	1702	0	141629
10055	132329	1215	2201	1644	0	137389
10056	2818	1043	137265	1417	0	142543
10057	2420	999	2530	134097	0	140046
10058	1557	1099	136350	2706	0	141712
10059	1377	1065	138039	2393	0	142874
10060	1083	1057	3781	133192	0	139113
10061	1109	999	2358	133160	0	137626
10062	1018	1065	1097	137857	0	141037
10063	931	1112	794	136081	0	138918
10064	131963	1050	869	4464	0	138346
10065	2515	1076	132719	2987	0	139297
10066	130664	1048	2100	1940	0	135752
10067	130935	1044	1767	1572	0	135318
10068	131099	1110	795	1301	0	134305
10069	130751	1089	533	1241	0	133614
10070	131125	1053	535	1063	0	133776
10071	4862	952	473	126559	0	132846
10072	3149	1072	124536	2494	0	131251
10073	1712	1121	120002	2081	0	124916
10074	1347	120099	3079	1321	0	125846
10075	112078	2399	2323	1162	0	117962
10076	2272	2589	898	109244	0	115003
10077	2004	2440	523	105558	0	110525
10078	1196	108338	500	3133	0	113167
10079	1032	107625	468	2202	0	111327
10080	1060	103470	349	1041	0	105920
10081	76448	2934	737	964	0	81083
10082	823	1888	254	60965	0	63930
10083	568	60704	192	581	0	62045
10084	239	541	107	60627	0	61514
10085	230	575	60612	553	0	61970
10086	267	239	63327	544	0	64377
10087	285	252	807	67280	0	68624
10088	70936	173	575	707	0	72391
10089	74283	192	101	627	0	75203
10090	74583	176	85	229	0	75073
10091	1495	241	75312	171	0	77219
10092	853	245	719	73314	0	75131
10093	299	225	689	76351	0	77564
10094	290	272	76174	1329	0	78065
10095	68720	207	872	901	0	70700
10096	931	241	76943	406	0	78521
10097	741	204	74644	194	0	75783
10098	254	159	76475	218	0	77106
10099	201	165	1419	71961	0	73746
10100	163	101	789	74148	0	75201
10101	195	136	76835	1442	0	78608
10102	174	116	787	76312	0	77389
10103	77487	87	794	944	0	79312
10104	780	97	252	79448	0	80577
10105	792	155	80862	990	0	82799
10106	280	146	85332	878	0	86636
10107	217	126	1475	83027	0	84845
10108	86957	90	883	930	0	88860
10109	941	92750	360	922	0	94973
10110	95153	892	258	363	0	96666
10111	95478	802	277	328	0	96885
10112	1958	194	98671	288	0	101111
10113	1128	94	1172	96915	0	99309
10114	99081	74	1112	1239	0	101506
10115	96257	66	404	1172	0	97899
10116	1791	99596	351	488	0	102226
10117	1158	935	310	99088	0	101491
10118	388	841	316	101068	0	102613
10119	355	208	100299	1957	0	102819
10120	340	91	1206	97901	0	99538
10121	374	143	101036	1311	0	102864
10122	411	150	99677	1147	0	101385
10123	398	105	1930	96039	0	98472
10124	96576	72	1198	1212	0	99058
10125	1125	95907	462	1354	0	98848
10126	95553	946	341	480	0	97320
10127	94249	871	323	405	0	95848
10128	1939	95525	381	494	0	98339
10129	1183	975	308	90246	0	92712
10130	91129	851	269	1040	0	93289
10131	1190	92437	305	1024	0	94956
10132	89983	937	241	384	0	91545
10133	1154	89738	283	359	0	91534
10134	965	919	269	86099	0	88252
10135	444	736	270	88273	0	89723
10136	86586	193	236	1609	0	88624
10137	84728	184	228	975	0	86115
10138	1600	87328	319	687	0	89934
10139	956	892	85891	415	0	88154
10140	384	739	85828	445	0	87396
10141	363	238	1647	79867	0	82115
10142	304	86650	1064	1001	0	89019
10143	429	842	481	86869	0	88621
10144	366	746	439	86949	0	88500
10145	380	251	434	87750	0	88815
10146	418	253	86873	1765	0	89309
10147	457	243	87046	1124	0	88870
10148	459	87934	1707	574	0	90674
10149	485	952	987	86286	0	88710
10150	503	816	402	89793	0	91514
10151	532	370	89149	1696	0	91747
10152	72913	330	1274	1333	0	75850
10153	1177	225	1015	88906	0	91323
10154	1071	303	89891	1214	0	92479
10155	80098	261	1193	1233	0	82785
10156	1154	89387	1023	694	0	92258
10157	1230	1049	91377	558	0	94214
10158	706	825	1206	89915	0	92652
10159	89735	315	1138	1255	0	92443
10160	1214	286	91916	1148	0	94564
10161	1045	259	1288	90662	0	93254
10162	540	238	1126	92741	0	94645
10163	418	294	556	97891	0	99159
10164	97865	265	492	2088	0	100710
10165	1167	95425	533	1554	0	98679
10166	1077	1084	457	95569	0	98187
10167	526	1002	97003	1536	0	100067
10168	514	433	1380	91904	0	94231
10169	445	95882	1277	1448	0	99052
10170	482	99111	568	1294	0	101455
10171	96989	1845	432	735	0	100001
10172	97295	1112	420	688	0	99515
10173	2214	470	97871	588	0	101143
10174	93617	392	1259	577	0	95845
10175	1448	97236	1225	607	0	100516
10176	97541	1202	464	639	0	99846
10177	1517	1074	344	96990	0	99925
10178	1362	578	98971	1340	0	102251
10179	677	433	1273	97705	0	100088
10180	636	423	99269	1552	0	101880
10181	93448	333	1412	1350	0	96543
10182	1351	371	1146	96548	0	99416
10183	1111	100742	555	1495	0	103903
10184	661	1431	448	100805	0	103345
10185	629	1149	100086	1621	0	103485
10186	475	97670	1329	1435	0	100909
10187	89096	1159	1058	657	0	91970
10188	905	88039	444	575	0	89963
10189	752	84609	392	421	0	86174
10190	481	1451	339	80040	0	82311
10191	228	83761	308	855	0	85152
10192	364	962	235	83631	0	85192
10193	342	836	83335	905	0	85418
10194	73234	352	846	839	0	75271
10195	79569	299	679	360	0	80907
10196	1377	293	80479	366	0	82515
10197	75147	222	759	350	0	76478
10198	813	78349	703	326	0	80191
10199	78121	783	266	306	0	79476
10200	834	699	228	76654	0	78415
10201	711	282	77248	832	0	79073
10202	278	78637	763	768	0	80446
10203	457	962	762	75901	0	78082
10204	284	620	219	76509	0	77632
10205	73513	228	235	1177	0	75153
10206	69309	168	190	744	0	70411
10207	1012	70156	269	357	0	71794
10208	480	65427	191	219	0	66317
10209	139	61997	141	200	0	62477
10210	560	768	371	59025	0	60724
10211	58816	315	289	370	0	59790
10212	57279	133	72	342	0	57826
10213	582	113	67	57107	0	57869
10214	345	101	73	57153	0	57672
10215	56760	99	81	596	0	57536
10216	367	104	65	58085	0	58621
10217	361	132	59057	392	0	59942
10218	57612	118	329	432	0	58491
10219	59155	106	304	187	0	59752
10220	650	149	61155	175	0	62129
10221	61323	110	332	219	0	61984
10222	446	117	295	63457	0	64315
10223	368	123	111	63544	0	64146
10224	173	114	95	64258	0	64640
10225	62639	126	97	697	0	63559
10226	393	65998	136	479	0	67006
10227	398	404	95	65371	0	66268
10228	178	65515	136	445	0	66274
10229	65195	395	101	390	0	66081
10230	451	348	103	66008	0	66910
10231	439	153	104	67240	0	67936
10232	201	68059	133	734	0	69127
10233	271	511	67086	460	0	68328
10234	203	399	390	67641	0	68633
10235	68282	136	388	491	0	69297
10236	73780	134	135	521	0	74570
10237	1049	202	78743	243	0	80237
10238	655	134	745	78146	0	79680
10239	218	82681	640	797	0	84336
10240	188	803	142	83926	0	85059
10241	83416	684	150	950	0	85200
10242	83392	200	138	769	0	84499
10243	1487	152	125	81782	0	83546
10244	751	82284	145	913	0	84093
10245	87771	824	85	795	0	89475
10246	943	759	85	90422	0	92209
10247	91448	200	105	1044	0	92797
10248	95832	157	78	1018	0	97085
10249	1688	188	71	96551	0	98498
10250	990	150	86	96933	0	98159
10251	327	143	112	98528	0	99110
10252	260	99163	148	1828	0	101399
10253	288	970	92	100364	0	101714
10254	300	828	105	99797	0	101030
10255	363	256	97317	1801	0	99737
10256	301	228	96188	1060	0	97777
10257	267	156	1638	94783	0	96844
10258	93901	136	909	1178	0	96124
10259	983	95316	267	1215	0	97781
10260	93349	954	172	424	0	94899
10261	1245	863	95145	374	0	97627
10262	1019	272	92873	419	0	94583
10263	265	93092	1648	325	0	95330
10264	501	946	1088	92387	0	94922
10265	342	774	93386	948	0	95450
10266	295	253	96400	807	0	97755
10267	265	243	1427	94482	0	96417
10268	95277	101	777	984	0	97139
10269	95066	91	193	874	0	96224
10270	1497	112	144	94474	0	96227
10271	908	211	105457	1049	0	107625
10272	362	108	872	106747	0	108089
10273	266	129	764	103499	0	104658
10274	184	108540	274	1545	0	110543
10275	107947	804	167	875	0	109793
10276	107076	715	160	430	0	108381
10277	1463	110519	180	441	0	112603
10278	931	890	140	103894	0	105855
10279	242	109907	269	1038	0	111456
10280	109196	881	274	830	0	111181
10281	1059	859	108484	346	0	110748
10282	941	348	106082	318	0	107689
10283	390	242	106358	281	0	107271
10284	229	259	1588	103872	0	105948
10285	209	145	862	105794	0	107010
10286	105533	145	267	1610	0	107555
10287	904	147	191	105351	0	106593
10288	852	142	196	109273	0	110463
10289	398	248	118984	1618	0	121248
10290	380	253	116827	1007	0	118467
10291	112187	170	1518	519	0	114394
10292	899	119583	881	461	0	121824
10293	120712	837	234	476	0	122259
10294	1076	745	237	120540	0	122598
10295	935	199	242	119582	0	120958
10296	338	120593	315	1662	0	122908
10297	294	975	233	121134	0	122636
10298	119657	788	248	1162	0	121855
10299	1008	260	204	121020	0	122492
10300	1080	377	122654	1238	0	125349
10301	385	122159	1023	1161	0	124728
10302	120798	880	835	564	0	123077
10303	122847	799	332	591	0	124569
10304	123052	288	298	548	0	124186
10305	123854	238	253	538	0	124883
10306	1763	213	262	122764	0	125002
10307	1114	226	275	124427	0	126042
10308	615	320	125569	1827	0	128331
10309	541	212	922	124490	0	126165
10310	563	381	125951	1351	0	128246
10311	446	250	984	124803	0	126483
10312	124141	247	857	1421	0	126666
10313	1011	131502	428	1298	0	134239
10314	1067	885	335	133812	0	136099
10315	452	887	341	136534	0	138214
10316	134863	257	385	1957	0	137462
10317	130595	222	364	1321	0	132502
10318	1752	344	135254	757	0	138107
10319	1007	137091	1125	695	0	139918
10320	445	947	939	135805	0	138136
10321	429	897	390	136734	0	138450
10322	135281	284	447	1836	0	137848
10323	133508	250	484	1240	0	135482
10324	1851	454	137116	608	0	140029
10325	1176	479	137962	549	0	140166
10326	542	252	1719	134306	0	136819
10327	486	246	1075	138155	0	139962
10328	578	346	137824	1841	0	140589
10329	128764	273	1143	1265	0	131445
10330	1251	235	991	137890	0	140367
10331	137720	168	475	1275	0	139638
10332	1008	137807	478	1642	0	140935
10333	144953	892	468	878	0	147191
10334	1586	984	165822	653	0	169045
10335	1191	166469	1427	797	0	169884
10336	464	165906	1046	549	0	167965
10337	159029	1437	1444	481	0	162391
10338	156173	783	203	321	0	157480
10339	1599	231	153	154934	0	156917
10340	831	157943	284	989	0	160047
10341	248	161144	303	974	0	162669
10342	228	1594	179	160813	0	162814
10343	163191	826	202	1016	0	165235
10344	162357	242	165	1049	0	163813
10345	1631	322	157986	211	0	160150
10346	149395	145	726	314	0	150580
10347	822	163482	788	363	0	165455
10348	165584	852	168	254	0	166858
10349	1060	194813	281	346	0	196500
10350	877	208658	258	341	0	210134
10351	763	3579	278	221817	0	226437
10352	236216	1663	373	2890	0	241142
10353	238735	366	149	1927	0	241177
10354	4980	479	238001	537	0	243997
10355	2530	225	2915	236441	0	242111
10356	239757	188	1948	3236	0	245129
10357	3323	176	484	243117	0	247100
10358	245412	161	244	3554	0	249371
10359	244617	235	208	2318	0	247378
10360	5194	387	247067	756	0	253404
10361	2720	220	3012	240205	0	246157
10362	1059	232	2000	246373	0	249664
10363	747	240	538	248090	0	249615
10364	650	433	242042	5419	0	248544
10365	597	227	3110	241191	0	245125
10366	571	345	2101	230281	0	233298
10367	459	240785	874	5213	0	247331
10368	1098	3408	237356	2630	0	244492
10369	424	243970	3415	1338	0	249147
10370	240127	3614	2131	819	0	246691
10371	3534	2318	647	227346	0	233845
10372	2716	886	388	213107	0	217097
10373	920	231130	571	4933	0	237554
10374	228527	3187	380	2672	0	234766
10375	228820	2153	312	1139	0	232424
10376	107905	125309	453	1020	0	234687
10377	4129	230348	515	996	0	235988
10378	229839	4112	369	776	0	235096
10379	4166	2570	228640	699	0	236075
10380	2794	972	228485	774	0	233025
10381	215874	593	5179	879	0	222525
10382	3439	226718	2795	1076	0	234028
10383	226742	3378	1011	926	0	232057
10384	4083	2606	226420	1033	0	234142
10385	219149	1026	3422	1164	0	224761
10386	3961	229965	2490	1133	0	237549
10387	3117	3601	998	228787	0	236503
10388	1594	2401	721	230043	0	234759
10389	1415	942	554	219882	0	222793
10390	1388	691	580	221280	0	223939
10391	1279	707	654	211991	0	214631
10392	1240	217434	710	6267	0	225651
10393	216503	3514	617	3407	0	224041
10394	4387	2567	216117	1711	0	224782
10395	3296	1106	3473	216534	0	224409
10396	1854	1063	219294	4150	0	226361
10397	1427	881	4132	216385	0	222825
10398	1317	811	2865	218904	0	223897
10399	214789	813	1398	6352	0	223352
10400	4317	1095	213245	3792	0	222449
10401	3235	212068	4003	2094	0	221400
10402	1881	3807	2975	210055	0	218718
10403	1638	2931	1339	216190	0	222098
10404	1766	1654	214294	5994	0	223708
10405	1667	1299	3754	212035	0	218755
10406	1754	1164	2638	216190	0	221746
10407	207075	982	1172	6607	0	215836
10408	4123	211797	996	4247	0	221163
10409	212314	4112	766	2446	0	219638
10410	213186	3095	831	1970	0	219082
10411	6485	1593	805	210233	0	219116
10412	4233	1492	210059	4467	0	220251
10413	2454	1497	207964	3442	0	215357
10414	1878	1265	5983	200758	0	209884
10415	2040	1279	3589	190853	0	197761
10416	1820	202624	2062	6154	0	212660
10417	200183	3937	1495	3841	0	209456
10418	4750	199352	1477	2475	0	208054
10419	3722	201261	1359	2345	0	208687
10420	198679	5790	1112	2190	0	207771
10421	5052	3263	1097	194431	0	203843
10422	3858	204301	1301	5211	0	214671
10423	2308	4074	1199	206574	0	214155
10424	1814	3068	201267	5907	0	212056
10425	1619	1463	201224	4823	0	209129
10426	1802	1140	5946	199358	0	208246
10427	1587	1177	203504	5523	0	211791
10428	1605	1086	4816	199882	0	207389
10429	1639	1231	3351	200747	0	206968
10430	1472	1201	1976	205101	0	209750
10431	195098	1175	1641	7287	0	205201
10432	3970	193651	1777	4906	0	204304
10433	2868	189917	1448	2834	0	197067
10434	167970	5088	1070	2262	0	176390
10435	168245	2984	987	2082	0	174298
10436	5325	1601	923	163772	0	171621
10437	3240	1504	164930	4284	0	173958
10438	1764	1233	3362	164997	0	171356
10439	1508	1399	166595	4744	0	174246
10440	1395	165129	3884	3450	0	173858
10441	1545	3549	2597	164661	0	172352
10442	164789	2425	1507	4041	0	172762
10443	4127	1417	1171	165320	0	172035
10444	3035	1187	161831	4024	0	170077
10445	152177	1029	3883	3086	0	160175
10446	4205	989	162761	1933	0	169888
10447	3424	820	157189	1526	0	162959
10448	1367	150559	4975	1659	0	158560
10449	818	118469	2250	1002	0	122539
10450	907	108935	1832	1019	0	112693
10451	81011	2577	4123	1601	0	89312
10452	71914	345	352	381	0	72992
10453	360	64	40	75041	0	75505
10454	227	38	45	76791	0	77101
10455	81	49	36	79113	0	79279
10456	47	81307	96	463	0	81913
10457	81611	187	58	303	0	82159
10458	189	82631	121	145	0	83086
10459	187	230	54	83005	0	83476
10460	84654	200	60	394	0	85308
10461	268	75	63	85172	0	85578
10462	233	76	70	88051	0	88430
10463	88547	51	62	544	0	89204
10464	86396	61	94	370	0	86921
10465	495	150	89203	154	0	90002
10466	364	182	88287	123	0	88956
10467	207	188	93966	162	0	94523
10468	111	109	464	92579	0	93263
10469	111	79	273	95426	0	95889
10470	85	97026	171	604	0	97886
10471	99875	264	71	445	0	100655
10472	319	308	70	101507	0	102204
10473	318	104	62	102757	0	103241
10474	105	106146	124	679	0	107054
10475	128	115037	125	499	0	115789
10476	159	654	61	119924	0	120798
10477	126	396	65	133528	0	134115
10478	135212	108	71	1398	0	136789
10479	134549	86	105	791	0	135531
10480	1419	103	62	135436	0	137020
10481	812	227	136603	1002	0	138644
10482	353	276	133443	784	0	134856
10483	209	115	1384	135816	0	137524
10484	181	123	646	135467	0	136417
10485	140	137267	299	1539	0	139245
10486	135079	850	141	958	0	137028
10487	924	612	108	135695	0	137339
10488	787	282	137206	1071	0	139346
10489	247	100	912	139271	0	140530
10490	347	258	141111	1208	0	142924
10491	337	314	143300	848	0	144799
10492	185	260	1517	144584	0	146546
10493	145573	137	798	1175	0	147683
10494	1071	217	145967	951	0	148206
10495	746	107	965	141398	0	143216
10496	444	311	159670	1227	0	161652
10497	292	96	1011	157565	0	158964
10498	217	111	728	160297	0	161353
10499	343	235	160192	1795	0	162565
10500	373	267	157405	939	0	158984
10501	365	141	1677	146910	0	149093
10502	232	170	833	162050	0	163285
10503	227	108	307	163551	0	164193
10504	189	112	238	162864	0	163403
10505	160413	103	200	1924	0	162640
10506	160333	119	261	1105	0	161818
10507	1584	162256	367	621	0	164828
10508	164257	938	236	520	0	165951
10509	1118	724	266	165158	0	167266
10510	167088	155	309	1359	0	168911
10511	1282	324	166336	1067	0	169009
10512	164658	126	1205	608	0	166597
10513	1258	161	967	173183	0	175569
10514	953	144	327	180590	0	182014
10515	180398	115	323	2188	0	183024
10516	1319	127	290	197159	0	198895
10517	1210	287	207499	2094	0	211090
10518	199041	164	1902	1800	0	202907
10519	1818	214648	1621	859	0	218946
10520	1580	1727	367	225347	0	229021
10521	686	1465	243001	2443	0	247595
10522	464	262	2308	240002	0	243036
10523	532	543	246622	2938	0	250635
10524	429	227	2588	243065	0	246309
10525	352	250277	2115	2957	0	255701
10526	571	2420	485	249007	0	252483
10527	403	261949	536	3122	0	266010
10528	611	3068	392	252615	0	256686
10529	543	2078	447	271146	0	274214
10530	651	352	453	273939	0	275395
10531	674	237	461	273855	0	275227
10532	684	256	475	275110	0	276525
10533	785	459	268674	5638	0	275556
10534	564	261	3119	267151	0	271095
10535	546	250	2530	269548	0	272874
10536	267061	265	864	5666	0	273856
10537	2908	267942	730	3848	0	275428
10538	267302	3007	559	1437	0	272305
10539	3421	2407	552	267172	0	273552
10540	2874	862	266658	4050	0	274444
10541	628	267697	3452	3712	0	275489
10542	258449	3052	2799	1603	0	265903
10543	2945	267407	1059	1615	0	273026
10544	2339	270776	873	1554	0	275542
10545	264766	5017	714	1469	0	271966
10546	3336	2766	571	274283	0	280956
10547	275423	588	649	4333	0	280993
10548	3664	416	632	271573	0	276285
10549	2970	660	271140	4607	0	279377
10550	949	706	266847	3660	0	272162
10551	247974	447	5781	2003	0	256205
10552	265054	460	3179	1708	0	270401
10553	5830	466	1007	259704	0	267007
10554	3259	557	685	262600	0	267101
10555	252422	492	629	6618	0	260161
10556	3447	253848	795	4299	0	262389
10557	2936	258345	789	2040	0	264110
10558	254765	5492	619	1474	0	262350
10559	252953	2938	695	1382	0	257968
10560	5967	253622	816	1519	0	261924
10561	3432	3711	622	251927	0	259692
10562	1523	3026	250242	4180	0	258971
10563	1227	1091	249479	3560	0	255357
10564	234304	668	6044	1708	0	242724
10565	4337	849	250146	1532	0	256864
10566	3376	710	3752	237182	0	245020
10567	1409	749	2932	231638	0	236728
10568	1094	240777	1163	6320	0	249354
10569	237523	3613	886	3695	0	245717
10570	4271	2868	875	235850	0	243864
10571	3599	1093	234529	4469	0	243690
10572	1367	232994	3841	4483	0	242685
10573	1271	4175	3001	230327	0	238774
10574	1352	3014	229745	4405	0	238516
10575	1602	1255	222367	3813	0	229037
10576	974	217674	5729	2212	0	226589
10577	198442	3258	3140	1618	0	206458
10578	3044	203574	1123	1801	0	209542
10579	200993	3304	942	1797	0	207036
10580	3439	2848	198617	1774	0	206678
10581	189103	1081	3208	1685	0	195077
10582	3324	197915	2869	1974	0	206082
10583	2821	3134	1094	196119	0	203168
10584	1088	2691	1003	201246	0	206028
10585	198030	1131	996	5784	0	205941
10586	3416	1047	198210	3855	0	206528
10587	193492	1011	3379	1990	0	199872
10588	197074	967	2864	1809	0	202714
10589	5287	1113	192649	1859	0	200908
10590	3181	1170	193995	1793	0	200139
10591	1466	1278	5037	185732	0	193513
10592	189389	1101	2921	4130	0	197541
10593	188645	1052	1202	3590	0	194489
10594	5247	190218	1092	1981	0	198538
10595	3341	3678	897	190624	0	198540
10596	1713	2770	928	182760	0	188171
10597	1546	1231	1020	184474	0	188271
10598	1734	935	1035	186006	0	189710
10599	181054	987	1086	5795	0	188922
10600	3980	1045	1046	183617	0	189688
10601	3605	1268	180720	3992	0	189585
10602	2103	1111	179965	3193	0	186372
10603	168475	1063	5285	1663	0	176486
10604	3941	176697	3175	1648	0	185461
10605	3541	180724	1415	1449	0	187129
10606	2079	5333	1195	178438	0	187045
10607	1778	3043	1082	181597	0	187500
10608	1789	1245	1070	180440	0	184544
10609	1797	1027	1123	182053	0	186000
10610	1748	1196	176407	5736	0	185087
10611	1838	981	3246	173159	0	179224
10612	1926	886	2850	172163	0	177825
10613	1515	984	165060	5439	0	172998
10614	147884	761	3711	3469	0	155825
10615	3515	157018	3049	2624	0	166206
10616	138525	2302	1316	1341	0	143484
10617	2987	1820	128784	1168	0	134759
10618	2286	717	121806	1015	0	125824
10619	1016	117436	3534	989	0	122975
10620	97822	4080	9327	2031	0	113260
10621	86832	1337	1146	848	0	90163
10622	84859	427	528	597	0	86411
10623	2228	82309	471	643	0	85651
10624	77920	1126	423	490	0	79959
10625	1445	926	77232	433	0	80036
10626	945	75789	1165	505	0	78404
10627	70519	984	1052	399	0	72954
10628	997	71947	458	396	0	73798
10629	67723	861	282	288	0	69154
10630	66201	647	302	289	0	67439
10631	1469	198	67552	255	0	69474
10632	742	67704	958	335	0	69739
10633	66170	800	753	247	0	67970
10634	946	679	66459	241	0	68325
10635	738	66590	862	325	0	68515
10636	346	797	644	63918	0	65705
10637	263	614	64009	749	0	65635
10638	248	213	62756	652	0	63869
10639	268	313	1035	61465	0	63081
10640	60864	113	605	747	0	62329
10641	668	61817	224	893	0	63602
10642	601	646	61547	243	0	63037
10643	369	500	60709	168	0	61746
10644	55119	207	1010	184	0	56520
10645	608	60448	607	171	0	61834
10646	50362	263	219	86	0	50930
10647	298	51808	97	92	0	52295
10648	52747	315	242	101	0	53405
10649	51812	235	70	70	0	52187
10650	502	52392	119	129	0	53142
10651	271	319	99	52772	0	53461
10652	56376	266	62	376	0	57080
10653	362	84	89	57571	0	58106
10654	295	85	96	61184	0	61660
10655	61210	61	95	654	0	62020
10656	375	61673	128	450	0	62626
10657	62509	392	92	163	0	63156
10658	479	391	63101	113	0	64084
10659	359	90	427	63200	0	64076
10660	143	95	329	64349	0	64916
10661	64593	77	92	724	0	65486
10662	64339	86	89	378	0	64892
10663	723	89	68	64641	0	65521
10664	394	171	67259	492	0	68316
10665	203	62	395	66500	0	67160
10666	160	88	325	67939	0	68512
10667	143	91	82	68514	0	68830
10668	158	84	71	68529	0	68842
10669	67067	108	68	762	0	68005
10670	505	131	67814	499	0	68949
10671	389	69683	450	225	0	70747
10672	169	401	325	68909	0	69804
10673	179	343	81	71016	0	71619
10674	221	130	71343	810	0	72504
10675	190	186	70823	459	0	71658
10676	177	76	737	71777	0	72767
10677	186	71	396	72448	0	73101
10678	259	143	72435	924	0	73761
10679	182	92	508	71693	0	72475
10680	72461	87	448	660	0	73656
10681	551	77603	211	653	0	79018
10682	561	587	77446	334	0	78928
10683	184	78655	601	271	0	79711
10684	197	655	420	79274	0	80546
10685	235	493	80484	675	0	81887
10686	160	80609	636	725	0	82130
10687	185	529	464	80544	0	81722
10688	235	483	82826	612	0	84156
10689	204	135	556	81578	0	82473
10690	173	145	451	83072	0	83841
10691	83335	106	187	1039	0	84667
10692	633	86	159	83591	0	84469
10693	84402	110	154	769	0	85435
10694	81528	105	177	642	0	82452
10695	82185	120	178	336	0	82819
10696	1062	96	134	82133	0	83425
10697	587	141	82521	643	0	83892
10698	234	168	81298	580	0	82280
10699	79952	120	997	373	0	81442
10700	692	186	84904	254	0	86036
10701	78825	117	748	284	0	79974
10702	594	84331	611	347	0	85883
10703	84651	543	184	315	0	85693
10704	724	506	86832	312	0	88374
10705	607	215	90275	255	0	91352
10706	235	154	1020	89679	0	91088
10707	235	135	96917	866	0	98153
10708	252	127	98838	682	0	99899
10709	210	82	1277	98558	0	100127
10710	242	142	683	100967	0	102034
10711	256	118	196	106133	0	106703
10712	188	109811	268	1829	0	112096
10713	320	1014	202	104520	0	106056
10714	171	111805	295	1099	0	113370
10715	110472	994	220	907	0	112593
10716	109189	769	256	411	0	110625
10717	1677	214	245	109039	0	111175
10718	916	111272	347	1258	0	113793
10719	334	1042	112542	1034	0	114952
10720	110900	766	1226	469	0	113361
10721	1196	227	966	112527	0	114916
10722	967	142	338	113373	0	114820
10723	325	251	232	115923	0	116731
10724	111955	160	312	2072	0	114499
10725	1160	112361	323	1245	0	115089
10726	932	114176	336	579	0	116023
10727	108844	1778	253	388	0	111263
10728	1063	112241	334	463	0	114101
10729	111490	1195	265	417	0	113367
10730	110080	865	257	412	0	111614
10731	1800	111799	342	524	0	114465
10732	1017	1164	265	107781	0	110227
10733	345	112020	280	1339	0	113984
10734	347	1230	254	110761	0	112592
10735	331	917	232	114793	0	116273
10736	115244	271	233	2217	0	117965
10737	117436	248	287	1311	0	119282
10738	2379	274	266	117663	0	120582
10739	1398	284	116829	1609	0	120120
10740	109288	263	1495	1413	0	112459
10741	1435	115958	1247	705	0	119345
10742	1229	1478	435	115521	0	118663
10743	544	1148	309	117154	0	119155
10744	408	429	339	118337	0	119513
10745	113036	360	284	2678	0	116358
10746	111799	352	293	1529	0	113973
10747	2369	111156	381	748	0	114654
10748	1329	111905	351	634	0	114219
10749	629	2295	306	110421	0	113651
10750	555	1389	311	111755	0	114010
10751	566	569	111039	2451	0	114625
10752	491	465	1423	106737	0	109116
10753	475	376	106719	1811	0	109381
10754	488	327	101687	1321	0	103823
10755	429	101095	2132	745	0	104401
10756	602	1399	1180	100795	0	103976
10757	101203	1091	359	1588	0	104241
10758	1556	421	223	100405	0	102605
10759	1327	410	99743	1691	0	103171
10760	94109	370	1368	1323	0	97170
10761	96661	386	1021	648	0	98716
10762	2401	438	97256	546	0	100641
10763	1477	326	1366	96973	0	100142
10764	96108	351	1049	1644	0	99152
10765	1602	97556	457	1431	0	101046
10766	98410	1425	334	751	0	100920
10767	99451	1163	333	672	0	101619
10768	2401	505	377	97944	0	101227
10769	1442	374	305	100855	0	102976
10770	99401	361	345	2654	0	102761
10771	1740	362	341	99733	0	102176
10772	1434	439	98814	2023	0	102710
10773	92639	345	1495	1566	0	96045
10774	94920	383	1147	788	0	97238
10775	2404	95133	459	775	0	98771
10776	1374	95959	318	706	0	98357
10777	604	2566	278	91537	0	94985
10778	470	95482	326	1832	0	98110
10779	640	1776	341	94700	0	97457
10780	92476	1179	299	1875	0	95829
10781	88688	450	318	1401	0	90857
10782	2310	88721	392	768	0	92191
10783	86696	1458	283	663	0	89100
10784	1656	87049	349	687	0	89741
10785	85910	1531	315	649	0	88405
10786	85539	1103	328	731	0	87701
10787	2458	496	83597	677	0	87228
10788	80198	374	1381	614	0	82567
10789	1777	80881	1124	626	0	84408
10790	1378	82064	415	608	0	84465
10791	81449	2103	364	570	0	84486
10792	1869	1212	258	80575	0	83914
10793	1469	579	80434	1569	0	84051
10794	851	434	1292	79459	0	82036
10795	771	456	996	80750	0	82973
10796	698	432	78953	2370	0	82453
10797	72998	350	1320	1528	0	76196
10798	1693	76730	1087	818	0	80328
10799	74655	1325	362	645	0	76987
10800	1883	1034	266	72059	0	75242
10801	71843	430	261	1567	0	74101
10802	1747	70948	328	1274	0	74297
10803	1463	1532	258	69968	0	73221
10804	68368	1021	273	1613	0	71275
10805	1660	430	64242	1280	0	67612
10806	1224	324	58906	642	0	61096
10807	53312	432	2106	541	0	56391
10808	1414	53289	927	457	0	56087
10809	952	45814	269	308	0	47343
10810	1443	1735	783	41076	0	45037
10811	466	42648	225	916	0	44255
10812	456	989	297	41763	0	43505
10813	423	689	228	42684	0	44024
10814	394	262	225	41783	0	42664
10815	356	40821	314	1366	0	42857
10816	386	814	257	40239	0	41696
10817	410	676	39266	929	0	41281
10818	388	38248	736	736	0	40108
10819	400	853	479	33246	0	34978
10820	336	35717	228	689	0	36970
10821	35043	676	202	561	0	36482
10822	35175	490	186	344	0	36195
10823	35214	239	197	298	0	35948
10824	1135	35463	241	315	0	37154
10825	736	644	203	34819	0	36402
10826	445	558	34647	639	0	36289
10827	434	336	34338	547	0	35655
10828	32442	376	927	284	0	34029
10829	33067	272	456	310	0	34105
10830	1000	261	166	33680	0	35107
10831	666	278	146	34427	0	35517
10832	414	232	34540	1110	0	36296
10833	333	33828	646	707	0	35514
10834	318	34335	563	356	0	35572
10835	298	732	30506	235	0	31771
10836	324	826	631	26621	0	28402
10837	177	176	338	25416	0	26107
10838	216	147	67	27091	0	27521
10839	197	162	76	27151	0	27586
10840	26632	139	97	534	0	27402
10841	462	172	25925	290	0	26849
10842	25429	159	322	136	0	26046
10843	454	149	242	25714	0	26559
10844	25771	142	96	367	0	26376
10845	436	145	109	25835	0	26525
10846	361	149	26060	374	0	26944
10847	179	158	329	26165	0	26831
10848	196	160	26921	410	0	27687
10849	145	134	323	25912	0	26514
10850	154	139	27620	430	0	28343
10851	126	27309	347	351	0	28133
10852	169	355	252	27207	0	27983
10853	121	257	98	26509	0	26985
10854	116	27717	104	476	0	28413
10855	28371	334	75	308	0	29088
10856	350	255	89	28286	0	28980
10857	289	110	75	28240	0	28714
10858	28650	112	89	578	0	29429
10859	29108	92	76	342	0	29618
10860	30330	82	84	203	0	30699
10861	30460	95	97	146	0	30798
10862	588	123	29456	154	0	30321
10863	28690	91	325	145	0	29251
10864	29651	95	256	157	0	30159
10865	544	83	118	28248	0	28993
10866	307	105	79	28023	0	28514
10867	26686	70	68	492	0	27316
10868	300	26629	74	324	0	27327
10869	208	242	44	25438	0	25932
10870	71	189	26819	288	0	27367
10871	46	26233	224	203	0	26706
10872	25666	247	229	105	0	26247
10873	25709	145	81	85	0	26020
10874	25672	30	40	41	0	25783
10875	25855	27	30	57	0	25969
10876	330	29	19	25189	0	25567
10877	186	39	25111	196	0	25532
10878	70	45	26876	162	0	27153
10879	46	33	344	28256	0	28679
10880	29839	13	194	292	0	30338
10881	293	25	38	30015	0	30371
10882	250	30	30756	305	0	31341
10883	30710	13	277	255	0	31255
10884	31096	13	215	65	0	31389
10885	504	14	37	31691	0	32246
10886	260	38	33574	318	0	34190
10887	92	40	34894	234	0	35260
10888	32866	20	485	91	0	33462
10889	286	34637	261	160	0	35344
10890	279	259	35181	62	0	35781
10891	81	212	290	34675	0	35258
10892	35268	24	236	320	0	35848
10893	286	34975	67	260	0	35588
10894	246	35315	57	134	0	35752
10895	35097	441	45	62	0	35645
10896	303	233	41	35090	0	35667
10897	37743	34	46	345	0	38168
10898	354	24	41	38799	0	39218
10899	264	41	47	38986	0	39338
10900	97	40	39322	570	0	40029
10901	89	58	38074	302	0	38523
10902	109	49	40042	86	0	40286
10903	94	29	607	39312	0	40042
10904	40106	32	315	389	0	40842
10905	426	36	40572	319	0	41353
10906	359	33	373	40152	0	40917
10907	135	99	41562	416	0	42212
10908	96	42176	444	361	0	43077
10909	119	383	340	42516	0	43358
10910	115	302	83	42821	0	43321
10911	84	52	90	43409	0	43635
10912	42956	29	94	738	0	43817
10913	436	54	80	42963	0	43533
10914	390	58	69	43157	0	43674
10915	43020	40	90	728	0	43878
10916	456	65	42719	393	0	43633
10917	42036	35	404	142	0	42617
10918	42367	52	347	121	0	42887
10919	740	79	42210	114	0	43143
10920	40480	53	430	133	0	41096
10921	493	41	377	41733	0	42644
10922	406	63	43683	407	0	44559
10923	42816	49	427	405	0	43697
10924	43938	31	354	173	0	44496
10925	740	35	115	43869	0	44759
10926	448	33	88	44258	0	44827
10927	162	35	98	44784	0	45079
10928	43538	35	103	775	0	44451
10929	451	44394	109	499	0	45453
10930	43328	332	114	170	0	43944
10931	700	42192	133	184	0	43209
10932	366	42343	145	175	0	43029
10933	187	645	145	42746	0	43723
10934	174	312	107	43197	0	43790
10935	135	52	101	43124	0	43412
10936	123	40	123	43364	0	43650
10937	153	76	42484	708	0	43421
10938	40482	52	413	453	0	41400
10939	449	51	357	42576	0	43433
10940	411	86	43567	475	0	44539
10941	154	67	402	43587	0	44210
10942	164	59	342	44342	0	44907
10943	187	108	46810	736	0	47841
10944	154	66	435	46495	0	47150
10945	172	59	366	47063	0	47660
10946	46752	67	121	806	0	47746
10947	482	91	47919	488	0	48980
10948	45053	55	438	283	0	45829
10949	464	48756	417	216	0	49853
10950	47815	379	147	222	0	48563
10951	46651	322	146	218	0	47337
10952	775	78	139	46909	0	47901
10953	468	94	46887	571	0	48020
10954	160	49632	486	507	0	50785
10955	177	451	376	46743	0	47747
10956	121	51765	170	505	0	52561
10957	51349	458	155	472	0	52434
10958	531	356	50675	250	0	51812
10959	443	91	50294	229	0	51057
10960	179	95	731	49056	0	50061
10961	203	101	52090	564	0	52958
10962	167	64	503	52264	0	52998
10963	156	78	377	52799	0	53410
10964	53553	69	128	902	0	54652
10965	529	54726	134	602	0	55991
10966	461	477	122	55433	0	56493
10967	191	333	144	56478	0	57146
10968	165	80	151	55780	0	56176
10969	167	56457	178	935	0	57737
10970	172	56705	181	575	0	57633
10971	55768	751	145	263	0	56927
10972	55710	385	146	250	0	56491
10973	55503	89	154	242	0	55988
10974	900	128	55352	241	0	56621
10975	474	166	521	54456	0	55617
10976	228	142	55423	689	0	56482
10977	155	55078	563	619	0	56415
10978	52527	523	554	259	0	53863
10979	561	388	51794	241	0	52984
10980	384	162	409	49956	0	50911
10981	207	93	51523	515	0	52338
10982	48864	84	492	453	0	49893
10983	51622	64	348	251	0	52285
10984	52017	85	119	206	0	52427
10985	51133	73	137	177	0	51520
10986	720	134	52776	181	0	53811
10987	50282	69	390	204	0	50945
10988	51467	57	330	180	0	52034
10989	607	51621	145	221	0	52594
10990	51046	335	116	166	0	51663
10991	51535	272	105	180	0	52092
10992	655	87	115	49408	0	50265
10993	357	53147	137	396	0	54037
10994	55103	370	106	345	0	55924
10995	58863	296	111	176	0	59446
10996	878	149	67232	213	0	68472
10997	521	118	68155	133	0	68927
10998	249	109	69741	127	0	70226
10999	183	252	1257	67704	0	69396
11000	68010	72	661	777	0	69520
11001	736	69051	187	715	0	70689
11002	67379	719	165	160	0	68423
11003	803	68951	155	184	0	70093
11004	67008	774	120	123	0	68025
11005	797	68199	167	168	0	69331
11006	574	68860	139	181	0	69754
11007	65627	1127	123	166	0	67043
11008	726	69030	150	156	0	70062
11009	587	782	120	68260	0	69749
11010	293	569	69207	714	0	70783
11011	232	191	69411	533	0	70367
11012	187	116	1158	67683	0	69144
11013	180	105	601	69807	0	70693
11014	218	148	69525	1211	0	71102
11015	221	104	740	68397	0	69462
11016	222	96	534	70060	0	70912
11017	69403	128	190	1233	0	70954
11018	780	70171	186	807	0	71944
11019	661	802	165	65137	0	66765
11020	233	71071	192	761	0	72257
11021	69903	840	172	581	0	71496
11022	812	71266	208	238	0	72524
11023	70932	830	139	168	0	72069
11024	70430	609	148	172	0	71359
11025	1357	230	129	69817	0	71533
11026	805	181	176	70275	0	71437
11027	344	202	179	71068	0	71793
11028	271	179	191	71237	0	71878
11029	277	250	69235	1364	0	71126
11030	62044	197	812	810	0	63863
11031	850	68705	675	303	0	70533
11032	781	814	222	69186	0	71003
11033	321	639	219	68717	0	69896
11034	258	69930	231	1285	0	71704
11035	69116	820	208	721	0	70865
11036	891	70686	238	348	0	72163
11037	757	899	208	70131	0	71995
11038	376	690	191	71620	0	72877
11039	362	267	143	72201	0	72973
11040	342	234	148	71754	0	72478
11041	69614	224	201	1428	0	71467
11042	1040	301	70017	772	0	72130
11043	785	234	871	67706	0	69596
11044	362	251	733	68338	0	69684
11045	314	253	329	68728	0	69624
11046	346	250	251	68294	0	69141
11047	64897	232	240	1567	0	66936
11048	1067	269	66548	879	0	68763
11049	828	336	815	62016	0	63995
11050	370	63763	684	921	0	65738
11051	312	65707	276	807	0	67102
11052	64463	1326	166	478	0	66433
11053	1000	862	64997	349	0	67208
11054	59794	378	765	308	0	61245
11055	1030	366	62638	318	0	64352
11056	667	230	721	59218	0	60836
11057	60551	200	585	909	0	62245
11058	698	62247	321	971	0	64237
11059	615	751	291	58077	0	59734
11060	285	62095	319	805	0	63504
11061	61056	775	257	776	0	62864
11062	60734	582	247	451	0	62014
11063	1232	253	212	60804	0	62501
11064	734	250	60100	998	0	62082
11065	412	274	60302	820	0	61808
11066	329	377	1082	58294	0	60082
11067	258	61577	628	827	0	63290
11068	320	972	200	62522	0	64014
11069	342	771	92	61028	0	62233
11070	339	390	75	61424	0	62228
11071	333	368	60741	1409	0	62851
11072	349	253	677	60754	0	62033
11073	267	230	589	60842	0	61928
11074	185	60762	272	1959	0	63178
11075	201	954	222	58857	0	60234
11076	152	569	219	64048	0	64988
11077	202	184	234	64751	0	65371
11078	222	132	238	64779	0	65371
11079	214	170	189	64014	0	64587
11080	209	213	159	63802	0	64383
11081	236	223	124	62881	0	63464
11082	238	276	146	61781	0	62441
11083	293	328	52572	6569	0	59762
11084	274	283	583	59922	0	61062
11085	58714	238	496	1113	0	60561
11086	843	197	182	58406	0	59628
11087	767	218	59423	1039	0	61447
11088	57441	179	709	997	0	59326
11089	60543	154	574	613	0	61884
11090	60837	193	236	519	0	61785
11091	60993	147	161	553	0	61854
11092	1349	150	158	61222	0	62879
11093	783	143	60853	1153	0	62932
11094	266	58745	747	964	0	60722
11095	182	55744	602	537	0	57065
11096	842	899	1366	43569	0	46676
11097	205	280	496	44313	0	45294
11098	80	74	37	44474	0	44665
11099	47	51	36	45441	0	45575
11100	57	35	46	49429	0	49567
11101	51783	34	43	750	0	52610
11102	463	52954	70	515	0	54002
11103	445	54711	81	205	0	55442
11104	137	1104	48	56137	0	57426
11105	84	533	44	57263	0	57924
11106	75	121	51	57534	0	57781
11107	78	63	27	57497	0	57665
11108	99	80	55151	1284	0	56614
11109	59	54579	636	826	0	56100
11110	76	622	491	54403	0	55592
11111	53391	504	103	725	0	54723
11112	583	124	51	54562	0	55320
11113	560	115	54491	771	0	55937
11114	167	93	53510	663	0	54433
11115	144	116	55370	255	0	55885
11116	82	242	1147	53064	0	54535
11117	55295	51	733	765	0	56844
11118	603	61	136	56002	0	56802
11119	551	67	74	57044	0	57736
11120	56164	66	61	1240	0	57531
11121	671	60	73	57591	0	58395
11122	595	55	71	57758	0	58479
11123	191	118	60038	1276	0	61623
11124	84	60372	715	794	0	61965
11125	105	660	570	62070	0	63405
11126	61292	538	158	848	0	62836
11127	682	147	109	62650	0	63588
11128	668	151	62766	892	0	64477
11129	194	140	674	62412	0	63420
11130	112	63177	653	953	0	64895
11131	152	693	156	64532	0	65533
11132	160	663	63532	949	0	65304
11133	88	67609	769	909	0	69375
11134	181	932	671	68246	0	70030
11135	110	725	186	75171	0	76192
11136	139	215	111	76779	0	77244
11137	156	129	137	77597	0	78019
11138	184	127	75441	2047	0	77799
11139	88	75575	1016	1269	0	77948
11140	75744	927	856	493	0	78020
11141	76313	837	248	351	0	77749
11142	1709	220	158	76191	0	78278
11143	1002	161	75716	1212	0	78091
11144	72430	113	1021	1106	0	74670
11145	1014	86	893	76431	0	78424
11146	969	152	77838	1281	0	80240
11147	269	76	1054	78380	0	79779
11148	200	96	923	78316	0	79535
11149	165	113	239	79727	0	80244
11150	227	180	79859	2169	0	82435
11151	294	148	1039	74544	0	76025
11152	178	79715	1011	1367	0	82271
11153	79889	980	294	1174	0	82337
11154	80137	938	220	547	0	81842
11155	80357	271	186	509	0	81323
11156	1936	79394	276	506	0	82112
11157	79320	1048	194	471	0	81033
11158	1216	944	219	77272	0	79651
11159	77188	273	265	1385	0	79111
11160	76915	177	211	1346	0	78649
11161	1936	226	75866	671	0	78699
11162	1086	75361	1158	626	0	78231
11163	74528	1026	996	457	0	77007
11164	1184	962	289	74374	0	76809
11165	1088	338	73646	1357	0	76429
11166	398	73623	1142	1232	0	76395
11167	71782	1067	1007	619	0	74475
11168	1219	954	322	72415	0	74910
11169	1109	300	239	73437	0	75085
11170	450	213	247	73322	0	74232
11171	351	72225	280	2366	0	75222
11172	374	1095	217	72864	0	74550
11173	297	72425	294	1645	0	74661
11174	373	1125	271	72436	0	74205
11175	372	1047	71299	1551	0	74269
11176	372	397	1141	71615	0	73525
11177	420	242	1036	72306	0	74004
11178	448	216	390	73458	0	74512
11179	453	297	71450	2488	0	74688
11180	379	214	1214	71892	0	73699
11181	393	243	1117	72991	0	74744
11182	376	279	402	74017	0	75074
11183	439	255	349	73901	0	74944
11184	432	223	342	74488	0	75485
11185	452	332	72035	2508	0	75327
11186	453	327	1147	72108	0	74035
11187	508	214	1081	70846	0	72649
11188	67480	234	428	2432	0	70574
11189	1199	67635	386	1761	0	70981
11190	1234	69281	392	948	0	71855
11191	629	1855	314	68720	0	71518
11192	456	1102	318	67509	0	69385
11193	418	65178	374	2304	0	68274
11194	478	1196	296	65298	0	67268
11195	385	65151	347	1772	0	67655
11196	578	1175	262	64435	0	66450
11197	555	1002	268	63407	0	65232
11198	470	439	60951	2099	0	63959
11199	372	59902	1078	1489	0	62841
11200	390	57091	790	784	0	59055
11201	48890	1227	491	660	0	51268
11202	701	50779	297	580	0	52357
11203	761	723	241	49077	0	50802
11204	418	662	47950	970	0	50000
11205	369	379	594	47616	0	48958
11206	46808	256	558	1018	0	48640
11207	715	290	48296	968	0	50269
11208	638	49587	656	629	0	51510
11209	377	706	654	47273	0	49010
11210	322	617	243	50633	0	51815
11211	51253	246	250	1502	0	53251
11212	635	227	249	52410	0	53521
11213	602	248	203	52289	0	53342
11214	281	231	166	52509	0	53187
11215	203	259	189	52470	0	53121
11216	50463	237	209	1530	0	52439
11217	50479	260	183	1134	0	52056
11218	996	228	183	51025	0	52432
11219	49996	206	214	1068	0	51484
11220	676	184	181	49632	0	50673
11221	642	221	48343	1092	0	50298
11222	321	219	47617	1003	0	49160
11223	311	536	891	43181	0	44919
11224	229	45164	570	975	0	46938
11225	272	561	188	44880	0	45901
11226	43925	530	166	923	0	45544
11227	494	256	172	44881	0	45803
11228	43895	207	168	974	0	45244
11229	605	195	163	44854	0	45817
11230	513	252	45279	932	0	46976
11231	207	44698	503	868	0	46276
11232	156	46307	470	526	0	47459
11233	218	1357	181	40739	0	42495
11234	191	408	41478	627	0	42704
11235	41	34659	158	277	0	35135
11236	162	195	176	33161	0	33694
11237	32550	94	70	205	0	32919
11238	104	66	33950	189	0	34309
11239	121	26	78	33897	0	34122
11240	32	42	91	35427	0	35592
11241	46	64	35520	207	0	35837
11242	54	83	34165	165	0	34467
11243	37	61	36284	104	0	36486
11244	40	87	165	35730	0	36022
11245	49	66	37564	149	0	37828
11246	33815	29	128	184	0	34156
11247	152	34	138	39322	0	39646
11248	171	90	49640	228	0	50129
11249	51	51852	201	334	0	52438
11250	98	226	52458	101	0	52883
11251	56	184	198	51953	0	52391
11252	55667	32	257	314	0	56270
11253	215	32	37	57770	0	58054
11254	204	37	33	58618	0	58892
11255	62877	20	50	485	0	63432
11256	287	35	32	64883	0	65237
11257	273	81	66501	397	0	67252
11258	64036	23	320	350	0	64729
11259	311	68272	325	157	0	69065
11260	69045	301	65	138	0	69549
11261	375	271	35	69256	0	69937
11262	315	143	69288	400	0	70146
11263	142	105	71154	322	0	71723
11264	114	101	646	70063	0	70924
11265	73	38	309	71016	0	71436
11266	122	100	73780	599	0	74601
11267	105	92	71600	361	0	72158
11268	72096	26	633	121	0	72876
11269	383	35	351	73497	0	74266
11270	74949	43	155	432	0	75579
11271	438	26	63	74567	0	75094
11272	396	113	79197	523	0	80229
11273	156	104	83045	420	0	83725
11274	133	59	759	83502	0	84453
11275	108	27	413	86121	0	86669
11276	99	89	89186	849	0	90223
11277	85064	22	583	516	0	86185
11278	588	38	443	91905	0	92974
11279	95328	35	121	701	0	96185
11280	635	107901	183	639	0	109358
11281	589	903	95	110207	0	111794
11282	110596	584	118	1123	0	112421
11283	1125	186	112637	766	0	114714
11284	726	89	1054	112274	0	114143
11285	258	63	706	113185	0	114212
11286	195	69	198	115630	0	116092
11287	181	124	114778	1811	0	116894
11288	187	95	1092	111063	0	112437
11289	125	115405	877	1274	0	117681
11290	193	973	221	116327	0	117714
11291	242	724	115934	1229	0	118129
11292	249	205	116750	860	0	118064
11293	241	117	1743	115484	0	117585
11294	201	74	841	116818	0	117934
11295	193	102	293	119131	0	119719
11296	209	86	265	119657	0	120217
11297	118405	79	228	1961	0	120673
11298	116706	66	210	1076	0	118058
11299	1784	173	117644	479	0	120080
11300	844	118989	1258	460	0	121551
11301	325	1097	806	119887	0	122115
11302	123916	716	282	1438	0	126352
11303	119503	159	279	1055	0	120996
11304	124581	132	249	491	0	125453
11305	124522	98	294	510	0	125424
11306	1990	199	123750	413	0	126352
11307	118172	109	1215	483	0	119979
11308	1271	121522	944	551	0	124288
11309	973	1070	318	122247	0	124608
11310	431	833	122879	1389	0	125532
11311	428	200	1284	120166	0	122078
11312	479	286	122078	1547	0	124390
11313	392	168	1333	121005	0	122898
11314	304	162	983	123201	0	124650
11315	122144	148	389	2205	0	124886
11316	1395	188	391	122879	0	124853
11317	1045	275	123800	1674	0	126794
11318	451	163	1364	125679	0	127657
11319	125153	137	1043	1715	0	128048
11320	1418	138	482	126732	0	128770
11321	1138	239	126499	1706	0	129582
11322	426	124597	1451	1501	0	127975
11323	127781	1144	1074	836	0	130835
11324	1434	807	544	121430	0	124215
11325	1008	130262	619	1522	0	133411
11326	128650	1195	417	1332	0	131594
11327	1556	926	129460	822	0	132764
11328	1022	127894	1573	932	0	131421
11329	522	1207	1141	129196	0	132066
11330	621	866	128627	1700	0	131814
11331	484	280	1546	124186	0	126496
11332	124783	212	1108	1894	0	127997
11333	1519	280	125677	1501	0	128977
11334	1284	193	1442	123587	0	126506
11335	665	340	126339	1804	0	129148
11336	679	244	1559	123455	0	125937
11337	580	286	1120	126585	0	128571
11338	123835	243	570	2453	0	127101
11339	1480	125081	636	1664	0	128861
11340	1216	1227	462	125392	0	128297
11341	123784	843	449	1887	0	126963
11342	123669	295	506	1459	0	125929
11343	2135	335	560	120847	0	123877
11344	1153	121625	612	1834	0	125224
11345	563	124251	546	1523	0	126883
11346	557	1870	479	121656	0	124562
11347	585	948	477	120994	0	123004
11348	109994	290	519	2290	0	113093
11349	1464	221	453	109711	0	111849
11350	995	258	106587	1785	0	109625
11351	96233	189	1304	1445	0	99171
11352	1284	102905	933	1036	0	106158
11353	101351	1008	438	817	0	103614
11354	1535	757	103613	710	0	106615
11355	907	104840	1227	747	0	107721
11356	105161	1267	1117	618	0	108163
11357	104072	720	612	676	0	106080
11358	1951	322	105349	519	0	108141
11359	102992	289	1315	503	0	105099
11360	106062	225	883	484	0	107654
11361	1896	108830	437	644	0	111807
11362	1072	1246	325	111805	0	114448
11363	692	931	111144	1523	0	114290
11364	558	310	1434	111662	0	113964
11365	537	370	114560	1683	0	117150
11366	448	252	1437	110691	0	112828
11367	112216	216	1060	1649	0	115141
11368	1441	150	416	114808	0	116815
11369	1142	233	121730	1584	0	124689
11370	119320	186	1469	1275	0	122250
11371	1715	156	1117	124360	0	127348
11372	1201	200	120541	1676	0	123618
11373	111612	154	1603	1277	0	114646
11374	1722	283	1048	117001	0	120054
11375	1232	237	115047	1595	0	118111
11376	568	270	112095	1085	0	114018
11377	451	1516	2045	106862	0	110874
11378	468	209	112141	1425	0	114243
11379	294	106335	1380	992	0	109001
11380	567	1234	838	92278	0	94917
11381	92072	529	227	850	0	93678
11382	763	135	93657	630	0	95185
11383	640	127	92570	211	0	93548
11384	84398	39	1321	255	0	86013
11385	794	117	93208	154	0	94273
11386	85376	58	829	224	0	86487
11387	832	94	92268	198	0	93392
11388	653	93	806	88884	0	90436
11389	242	134	93056	729	0	94161
11390	169	76	794	90121	0	91160
11391	231	147	94403	796	0	95577
11392	187	93	93028	666	0	93974
11393	81021	58	1335	315	0	82729
11394	669	93277	752	240	0	94938
11395	93434	623	268	163	0	94488
11396	740	95075	238	181	0	96234
11397	654	731	225	94238	0	95848
11398	244	578	239	96129	0	97190
11399	95273	100	202	1192	0	96767
11400	783	98	203	95076	0	96160
11401	700	142	95086	828	0	96756
11402	89147	79	811	680	0	90717
11403	92271	82	710	272	0	93335
11404	1258	90	281	92365	0	93994
11405	849	144	93952	804	0	95749
11406	291	97	827	92140	0	93355
11407	193	95101	795	910	0	96999
11408	240	692	317	94909	0	96158
11409	253	598	249	96731	0	97831
11410	272	210	95470	1404	0	97356
11411	79713	149	938	1070	0	81870
11412	825	94846	841	499	0	97011
11413	93989	710	318	444	0	95461
11414	845	96736	367	390	0	98338
11415	784	746	321	93843	0	95694
11416	286	97023	352	994	0	98655
11417	375	841	93675	882	0	95773
11418	334	651	995	89808	0	91788
11419	343	167	858	92872	0	94240
11420	316	136	433	94871	0	95756
11421	92901	107	394	1594	0	94996
11422	919	159	414	93101	0	94593
11423	91367	132	418	1126	0	93043
11424	91352	137	429	958	0	92876
11425	90040	142	439	512	0	91133
11426	1563	231	91054	432	0	93280
11427	940	162	1109	90194	0	92405
11428	440	185	997	94048	0	95670
11429	359	162	567	95934	0	97022
11430	98260	133	595	1730	0	100718
11431	1196	157	526	98749	0	100628
11432	1012	135	594	100525	0	102266
11433	103039	169	608	1928	0	105744
11434	1305	150	566	105748	0	107769
11435	1147	278	107594	1466	0	110485
11436	568	231	108601	1198	0	110598
11437	516	190	2162	108886	0	111754
11438	108024	154	1366	1531	0	111075
11439	102168	170	719	1312	0	104369
11440	2217	161	573	106129	0	109080
11441	1329	229	106928	1501	0	109987
11442	582	106398	1527	1278	0	109785
11443	536	1147	1286	108437	0	111406
11444	492	910	532	109623	0	111557
11445	538	263	504	109983	0	111288
11446	107907	224	485	2318	0	110934
11447	1464	253	108676	1472	0	111865
11448	106314	198	1438	681	0	108631
11449	1571	220	1214	105469	0	108474
11450	1285	108416	542	1575	0	111818
11451	108228	1159	422	1380	0	111189
11452	105927	1008	442	716	0	108093
11453	2275	373	111193	700	0	114541
11454	1293	106131	1405	779	0	109608
11455	477	101789	1143	692	0	104101
11456	99673	1630	538	606	0	102447
11457	1308	918	348	99534	0	102108
11458	1222	290	317	98327	0	100156
11459	560	237	352	96398	0	97547
11460	428	94652	333	2043	0	97456
11461	338	92931	283	1267	0	94819
11462	89071	1383	207	517	0	91178
11463	1077	765	198	87931	0	89971
11464	884	257	94617	1107	0	96865
11465	384	250	1171	98212	0	100017
11466	401	274	110239	1623	0	112537
11467	419	248	110328	1133	0	112128
11468	473	255	110672	461	0	111861
11469	214	99417	2651	357	0	102639
11470	598	1827	1997	90989	0	95411
11471	222	97326	517	1394	0	99459
11472	320	1682	276	91847	0	94125
11473	225	1078	182	97640	0	99125
11474	97099	316	153	2462	0	100030
11475	1476	180	146	98148	0	99950
11476	97312	130	140	1830	0	99412
11477	97134	135	113	1298	0	98680
11478	2472	142	131	93100	0	95845
11479	1289	94960	214	1649	0	98112
11480	507	1426	141	93775	0	95849
11481	279	95343	225	1769	0	97616
11482	276	1576	163	94877	0	96892
11483	309	1141	94135	1836	0	97421
11484	280	338	1495	93772	0	95885
11485	304	200	1104	95972	0	97580
11486	91190	159	402	2719	0	94470
11487	1415	93646	351	1650	0	97062
11488	1195	1499	237	93376	0	96307
11489	517	1130	219	92109	0	93975
11490	296	91441	276	2626	0	94639
11491	321	1553	227	91877	0	93978
11492	87871	1146	208	2043	0	91268
11493	88986	421	202	1447	0	91056
11494	2465	88696	207	751	0	92119
11495	1437	1551	164	88594	0	91746
11496	85638	1118	164	1836	0	88756
11497	1589	87778	226	1460	0	91053
11498	1273	1643	183	82657	0	85756
11499	493	86906	272	1770	0	89441
11500	85263	1708	328	1372	0	88671
11501	1745	1294	84349	698	0	88086
11502	1307	534	84553	555	0	86949
11503	554	384	2516	83295	0	86749
11504	467	337	85631	1798	0	88233
11505	332	302	1849	82769	0	85252
11506	82452	294	1302	1951	0	85999
11507	1636	340	82557	1472	0	86005
11508	1264	294	1599	81101	0	84258
11509	537	303	1194	82734	0	84768
11510	81417	287	429	2709	0	84842
11511	1545	82203	354	1725	0	85827
11512	82493	1553	216	819	0	85081
11513	81009	1175	197	587	0	82968
11514	2520	79173	295	818	0	82806
11515	1462	1555	260	79598	0	82875
11516	667	1273	78183	1730	0	81853
11517	455	695	1522	76366	0	79038
11518	351	78545	1173	1906	0	81975
11519	78817	1625	459	1411	0	82312
11520	1631	1182	361	79455	0	82629
11521	1217	571	79651	1946	0	83385
11522	517	395	1588	79871	0	82371
11523	413	376	1258	81144	0	83191
11524	412	351	501	82149	0	83413
11525	342	334	320	82635	0	83631
11526	365	313	291	79942	0	80911
11527	421	361	76840	3184	0	80806
11528	675	379	74635	1830	0	77519
11529	367	71731	2365	1026	0	75489
11530	315	71533	1231	688	0	73767
11531	69232	2005	522	592	0	72351
11532	1487	1213	69000	580	0	72280
11533	63111	553	1581	502	0	65747
11534	1498	336	63026	448	0	65308
11535	975	308	60010	347	0	61640
11536	441	253	1926	56403	0	59023
11537	58678	240	1096	1318	0	61332
11538	1172	250	422	59580	0	61424
11539	901	252	237	60177	0	61567
11540	413	216	62932	2170	0	65731
11541	307	211	1193	63430	0	65141
11542	282	135	805	63798	0	65020
11543	327	151	295	63262	0	64035
11544	321	149	186	63375	0	64031
11545	303	127	156	63597	0	64183
11546	60755	173	136	2271	0	63335
11547	1215	185	98	61469	0	62967
11548	903	264	59466	1628	0	62261
11549	396	247	1057	59923	0	61623
11550	312	242	59618	1561	0	61733
11551	246	270	1309	59399	0	61224
11552	247	198	60921	1601	0	62967
11553	221	311	1367	57168	0	59067
11554	218	156	885	59360	0	60619
11555	234	196	58663	1974	0	61067
11556	52914	167	1212	1241	0	55534
11557	1145	203	59437	657	0	61442
11558	848	181	1342	58824	0	61195
11559	59763	112	905	1363	0	62143
11560	1243	145	376	60423	0	62187
11561	914	292	225	60888	0	62319
11562	559	139	60729	1962	0	63389
11563	262	58815	1072	1266	0	61415
11564	144	50459	662	536	0	51801
11565	128	45846	321	369	0	46664
11566	1273	325	964	30350	0	32912
11567	31626	103	181	166	0	32076
11568	94	28	19	31658	0	31799
11569	108	13	31	32169	0	32321
11570	32	15	28	32664	0	32739
11571	24	6	26	32746	0	32802
11572	20	32793	34	260	0	33107
11573	34	99	32	33624	0	33789
11574	13	102	24	33531	0	33670
11575	18	33640	46	241	0	33945
11576	34078	103	27	178	0	34386
11577	114	104	25	34180	0	34423
11578	34085	26	22	161	0	34294
11579	33782	18	28	171	0	33999
11580	210	35331	48	100	0	35689
11581	148	128	28	38352	0	38656
11582	44	124	38396	162	0	38726
11583	55	59	38044	146	0	38304
11584	48	108	198	38090	0	38444
11585	39245	16	130	161	0	39552
11586	40554	16	51	190	0	40811
11587	207	20	36	41571	0	41834
11588	41973	22	43	204	0	42242
11589	141	42058	44	192	0	42435
11590	42208	122	30	114	0	42474
11591	139	48369	41	121	0	48670
11592	133	153	35	49445	0	49766
11593	58	132	30	49502	0	49722
11594	28	50276	64	326	0	50694
11595	49951	138	34	225	0	50348
11596	171	180	49794	94	0	50239
11597	157	56	130	49681	0	50024
11598	108	81	52030	207	0	52426
11599	71	47	152	51633	0	51903
11600	52854	29	157	248	0	53288
11601	161	65	50	53009	0	53285
11602	52763	30	44	277	0	53114
11603	52563	48	61	263	0	52935
11604	273	39	50	52618	0	52980
11605	191	63	53090	244	0	53588
11606	107	57980	182	264	0	58533
11607	105	163	136	58578	0	58982
11608	58045	137	52	274	0	58508
11609	257	95	60264	233	0	60849
11610	214	69	154	59853	0	60290
11611	106	65	142	60948	0	61261
11612	97	71	57	61728	0	61953
11613	61685	84	45	399	0	62213
11614	198	48	65	61968	0	62279
11615	184	56	67	62666	0	62973
11616	106	108	64419	383	0	65016
11617	108	58	196	64126	0	64488
11618	125	46	189	66270	0	66630
11619	118	41	96	68071	0	68326
11620	96	68141	122	507	0	68866
11621	139	161	60	68291	0	68651
11622	129	169	56	68008	0	68362
11623	65016	44	55	481	0	65596
11624	318	116	66873	278	0	67585
11625	255	96	64872	175	0	65398
11626	122	67386	339	181	0	68028
11627	127	240	240	69149	0	69756
11628	69393	186	114	416	0	70109
11629	229	84	68	69506	0	69887
11630	238	60	62	70895	0	71255
11631	117	40	76	71543	0	71776
11632	112	39	69	71319	0	71539
11633	96	56	59	71463	0	71674
11634	122	91	70747	529	0	71489
11635	111	45	194	71190	0	71540
11636	70818	51	186	422	0	71477
11637	219	71319	102	418	0	72058
11638	213	204	77	72392	0	72886
11639	119	200	57	73045	0	73421
11640	149	114	73536	545	0	74344
11641	104	81	239	72473	0	72897
11642	109	83	219	78252	0	78663
11643	78062	60	93	748	0	78963
11644	375	82021	112	574	0	83082
11645	370	450	96	83065	0	83981
11646	180	324	111	84361	0	84976
11647	150	309	118	84737	0	85314
11648	136	117	85909	990	0	87152
11649	198	160	83993	648	0	84999
11650	112	86134	800	432	0	87478
11651	98	89686	476	421	0	90681
11652	135	816	165	87573	0	88689
11653	80	89293	172	802	0	90347
11654	151	835	117	96742	0	97845
11655	128	530	96	105011	0	105765
11656	103	187	110	109939	0	110339
11657	125	128	109	119906	0	120268
11658	157	144	119599	2298	0	122198
11659	157	107	1176	120169	0	121609
11660	116	108	1019	121269	0	122512
11661	118	92	378	123854	0	124442
11662	117403	97	213	2873	0	120586
11663	1154	124386	267	1936	0	127743
11664	1160	1383	174	111390	0	114107
11665	347	126112	187	1579	0	128225
11666	120371	1572	174	1460	0	123577
11667	102001	1417	201	929	0	104548
11668	1816	126362	182	796	0	129156
11669	1026	129409	210	654	0	131299
11670	588	2548	123865	548	0	127549
11671	297	130504	1347	553	0	132701
11672	412	1861	1127	126535	0	129935
11673	126325	1401	455	1708	0	129889
11674	1256	130499	291	1595	0	133641
11675	1145	1615	249	131126	0	134135
11676	422	1361	217	133296	0	135296
11677	278	560	234	135744	0	136816
11678	130602	364	233	3246	0	134445
11679	1533	438	132114	2156	0	136241
11680	122946	327	1441	1198	0	125912
11681	1682	130257	1280	991	0	134210
11682	1311	1635	408	130685	0	134039
11683	648	1438	129584	1945	0	133615
11684	115441	635	1573	1761	0	119410
11685	1552	129818	1325	901	0	133596
11686	1448	1724	455	125431	0	129058
11687	527	129215	342	1801	0	131885
11688	348	1857	290	129549	0	132044
11689	337	1475	297	130914	0	133023
11690	361	818	128284	2968	0	132431
11691	350	595	123287	2014	0	126246
11692	338	489	2505	122701	0	126033
11693	402	557	125423	2179	0	128561
11694	263	405	1792	123635	0	126095
11695	306	354	1431	122781	0	124872
11696	285	364	673	127057	0	128379
11697	123382	307	454	3392	0	127535
11698	1595	344	474	125430	0	127843
11699	1418	424	125370	2534	0	129746
11700	121286	378	1578	2156	0	125398
11701	1613	411	1416	127207	0	130647
11702	1455	411	661	128629	0	131156
11703	125127	415	457	3320	0	129319
11704	1586	130218	559	2373	0	134736
11705	1498	1661	400	131836	0	135395
11706	642	1480	405	129191	0	131718
11707	125403	710	395	3516	0	130024
11708	1737	642	127405	2433	0	132217
11709	1486	539	1611	125635	0	129271
11710	739	525	1511	126782	0	129557
11711	566	521	679	123785	0	125551
11712	492	125587	598	3545	0	130222
11713	468	1737	553	126702	0	129460
11714	123054	1534	486	2814	0	127888
11715	1597	124885	557	2588	0	129627
11716	121180	1770	424	1597	0	124971
11717	1839	124709	462	1339	0	128349
11718	123243	1985	457	1311	0	126996
11719	2166	1728	121891	1150	0	126935
11720	1768	976	120870	1168	0	124782
11721	117593	669	2605	1200	0	122067
11722	2006	709	123750	1176	0	127641
11723	1755	575	1939	120702	0	124971
11724	986	510	1673	117951	0	121120
11725	731	519	888	124376	0	126514
11726	121532	501	624	3505	0	126162
11727	1863	562	120488	2451	0	125364
11728	117992	493	1770	1536	0	121791
11729	2084	510	1513	123988	0	128095
11730	124748	535	715	2560	0	128558
11731	2261	599	530	125873	0	129263
11732	128796	564	526	2650	0	132536
11733	2399	618	485	136877	0	140379
11734	1956	616	140609	2879	0	146060
11735	138451	552	1949	2369	0	143321
11736	144107	488	1697	1471	0	147763
11737	3547	444	838	144674	0	149503
11738	2323	535	706	137529	0	141093
11739	1079	145491	864	3708	0	151142
11740	137280	1816	764	2473	0	142333
11741	2224	142691	688	1568	0	147171
11742	135275	1917	892	1307	0	139391
11743	2391	1548	137643	1226	0	142808
11744	1892	739	137240	1104	0	140975
11745	1170	475	136332	1017	0	138994
11746	126006	478	3410	981	0	130875
11747	2196	135521	2003	1026	0	140746
11748	1986	1648	872	131463	0	135969
11749	128742	1396	731	2133	0	133002
11750	1967	133750	715	2291	0	138723
11751	1836	3620	558	121789	0	127803
11752	914	130481	631	2053	0	134079
11753	706	126294	612	1953	0	129565
11754	691	124416	466	1089	0	126662
11755	107463	2464	914	1024	0	111865
11756	1287	111806	409	776	0	114278
11757	831	98581	355	553	0	100320
11758	426	96775	419	497	0	98117
11759	95417	1266	700	387	0	97770
11760	94925	658	369	406	0	96358
11761	1489	316	93579	375	0	95759
11762	89682	185	791	390	0	91048
11763	93275	149	638	370	0	94432
11764	1368	183	194	92556	0	94301
11765	94615	170	227	915	0	95927
11766	1025	199	93780	721	0	95725
11767	765	98143	850	390	0	100148
11768	97768	862	679	355	0	99664
11769	995	695	203	99162	0	101055
11770	101031	250	164	964	0	102409
11771	1127	270	98216	816	0	100429
11772	96993	191	853	319	0	98356
11773	1104	197	688	99729	0	101718
11774	907	197	100382	953	0	102439
11775	291	98341	920	816	0	100368
11776	260	101018	768	338	0	102384
11777	420	1608	366	96105	0	98499
11778	358	820	143	89714	0	91035
11779	167	98932	151	1307	0	100557
11780	98608	855	101	652	0	100216
11781	97735	679	103	170	0	98687
11782	96326	173	142	168	0	96809
11783	1540	98880	140	304	0	100864
11784	1014	865	114	88143	0	90136
11785	284	99094	149	781	0	100308
11786	98414	900	134	665	0	100113
11787	96982	681	106	264	0	98033
11788	1497	97207	172	212	0	99088
11789	98321	867	112	185	0	99485
11790	1064	712	103	97519	0	99398
11791	813	216	155	97733	0	98917
11792	98696	181	168	1514	0	100559
11793	96324	209	158	799	0	97490
11794	96944	190	140	262	0	97536
11795	1606	213	136	96094	0	98049
11796	925	201	159	97486	0	98771
11797	371	314	96907	1499	0	99091
11798	377	278	884	94582	0	96121
11799	350	282	728	93604	0	94964
11800	409	348	92864	1479	0	95100
11801	378	353	91045	828	0	92604
11802	383	322	93393	283	0	94381
11803	416	294	1584	90382	0	92676
11804	504	376	89721	964	0	91565
11805	395	337	951	87622	0	89305
11806	388	343	751	89378	0	90860
11807	454	372	89452	1522	0	91800
11808	427	408	88973	859	0	90667
11809	378	363	1530	85663	0	87934
11810	417	417	91194	985	0	93013
11811	486	430	90184	840	0	91940
11812	381	88901	1573	420	0	91275
11813	90425	1052	851	294	0	92622
11814	90369	876	304	295	0	91844
11815	90455	387	221	296	0	91359
11816	1761	90291	272	358	0	92682
11817	1119	90551	269	367	0	92306
11818	547	1610	259	89038	0	91454
11819	469	933	284	88356	0	90042
11820	495	424	87344	1669	0	89932
11821	480	319	988	86270	0	88057
11822	86492	296	871	1147	0	88806
11823	1253	314	371	77914	0	79852
11824	1007	86895	346	1082	0	89330
11825	88490	1046	336	855	0	90727
11826	88817	880	283	432	0	90412
11827	89774	332	261	423	0	90790
11828	1942	297	88332	381	0	90952
11829	1103	627	961	83548	0	86239
11830	89299	245	877	1180	0	91601
11831	1317	294	91111	976	0	93698
11832	996	86042	1118	465	0	88621
11833	368	79616	884	335	0	81203
11834	70444	1275	739	224	0	72682
11835	847	71659	350	269	0	73125
11836	804	777	217	68402	0	70200
11837	358	695	69457	837	0	71347
11838	340	306	722	68590	0	69958
11839	67561	161	668	928	0	69318
11840	787	67731	236	881	0	69635
11841	67082	691	171	321	0	68265
11842	851	638	66546	330	0	68365
11843	755	354	795	61657	0	63561
11844	241	67000	714	780	0	68735
11845	284	863	271	66884	0	68302
11846	67437	607	263	838	0	69145
11847	68008	206	190	715	0	69119
11848	68213	132	191	267	0	68803
11849	68511	153	209	231	0	69104
11850	1343	149	203	66156	0	67851
11851	782	198	68002	856	0	69838
11852	333	164	793	63792	0	65082
11853	236	67559	685	912	0	69392
11854	67237	691	317	668	0	68913
11855	844	591	66561	284	0	68280
11856	63843	160	793	245	0	65041
11857	804	136	639	64861	0	66440
11858	688	230	66887	800	0	68605
11859	353	153	722	66047	0	67275
11860	66944	110	623	850	0	68527
11861	67048	134	241	695	0	68118
11862	67081	145	244	285	0	67755
11863	1197	191	65150	234	0	66772
11864	671	253	702	62701	0	64327
11865	317	209	65232	730	0	66488
11866	253	64313	742	672	0	65980
11867	59383	615	608	248	0	60854
11868	604	58823	223	280	0	59930
11869	54130	467	222	158	0	54977
11870	552	317	124	51251	0	52244
11871	392	54032	163	395	0	54982
11872	54153	385	148	368	0	55054
11873	540	391	54593	165	0	55689
11874	388	143	365	52710	0	53606
11875	53412	100	307	430	0	54249
11876	470	141	53773	377	0	54761
11877	442	97	382	51186	0	52107
11878	250	53385	374	390	0	54399
11879	241	406	162	53467	0	54276
11880	223	376	125	53727	0	54451
11881	52349	158	116	642	0	53265
11882	422	53412	143	535	0	54512
11883	438	398	116	51030	0	51982
11884	185	53536	174	442	0	54337
11885	267	485	141	51672	0	52565
11886	218	54532	165	434	0	55349
11887	53488	442	143	403	0	54476
11888	583	410	55202	198	0	56393
11889	455	151	431	54273	0	55310
11890	250	142	382	54802	0	55576
11891	248	137	134	55081	0	55600
11892	263	146	132	54662	0	55203
11893	316	179	54347	734	0	55576
11894	304	56262	451	508	0	57525
11895	55878	411	376	251	0	56916
11896	55601	354	151	242	0	56348
11897	651	56697	177	296	0	57821
11898	57048	418	139	260	0	57865
11899	56406	379	154	259	0	57198
11900	722	59002	160	232	0	60116
11901	584	456	119	55474	0	56633
11902	279	59518	200	376	0	60373
11903	58530	427	155	434	0	59546
11904	558	354	58280	263	0	59455
11905	53208	140	469	320	0	54137
11906	562	154	59594	281	0	60591
11907	500	147	470	58341	0	59458
11908	59210	120	340	506	0	60176
11909	612	155	59087	427	0	60281
11910	55585	123	441	262	0	56411
11911	57869	119	385	267	0	58640
11912	755	153	182	56616	0	57706
11913	455	59360	167	448	0	60430
11914	59688	466	105	414	0	60673
11915	550	443	117	58275	0	59385
11916	491	59378	139	497	0	60505
11917	58854	425	135	428	0	59842
11918	506	401	146	59288	0	60341
11919	411	63657	191	570	0	64829
11920	219	432	162	65244	0	66057
11921	65819	339	153	606	0	66917
11922	65419	132	153	467	0	66171
11923	66074	131	167	260	0	66632
11924	748	133	133	64324	0	65338
11925	425	149	135	64321	0	65030
11926	256	199	64984	694	0	66133
11927	288	315	426	63834	0	64863
11928	296	206	67113	496	0	68111
11929	254	156	61552	313	0	62275
11930	135	112	59543	114	0	59904
11931	73	62098	381	193	0	62745
11932	226	358	525	57154	0	58263
11933	53	67324	128	242	0	67747
11934	68880	314	84	241	0	69519
11935	68723	261	75	108	0	69167
11936	516	94	55	70998	0	71663
11937	376	96	74745	378	0	75595
11938	123	63	437	74035	0	74658
11939	172	121	77760	535	0	78588
11940	139	107	477	74263	0	74986
11941	79	78171	463	581	0	79294
11942	86	80654	125	522	0	81387
11943	77873	776	91	149	0	78889
11944	565	492	81075	108	0	82240
11945	474	106	491	79159	0	80230
11946	146	78	389	81557	0	82170
11947	82376	74	106	895	0	83451
11948	492	84039	146	682	0	85359
11949	83540	486	104	210	0	84340
11950	495	86792	138	205	0	87630
11951	84841	495	108	188	0	85632
11952	86335	457	92	223	0	87107
11953	918	122	108	87579	0	88727
11954	525	212	88592	583	0	89912
11955	82491	100	552	577	0	83720
11956	533	89566	505	315	0	90919
11957	90658	538	126	228	0	91550
11958	629	479	102	88134	0	89344
11959	533	140	77	87389	0	88139
11960	170	89462	148	963	0	90743
11961	232	581	96	87780	0	88689
11962	160	91625	141	643	0	92569
11963	231	578	95	90413	0	91317
11964	174	482	100	89435	0	90191
11965	86286	130	104	1035	0	87555
11966	709	206	89014	534	0	90463
11967	535	88633	576	263	0	90007
11968	271	569	461	88977	0	90278
11969	91208	474	142	724	0	92548
11970	92087	160	165	613	0	93025
11971	93208	140	143	282	0	93773
11972	1076	230	93323	235	0	94864
11973	92750	178	653	266	0	93847
11974	729	161	528	95750	0	97168
11975	94540	153	154	788	0	95635
11976	696	95357	195	687	0	96935
11977	628	690	144	95985	0	97447
11978	95175	544	142	782	0	96643
11979	729	99220	186	722	0	100857
11980	687	693	127	99975	0	101482
11981	383	701	102655	793	0	104532
11982	99243	229	772	847	0	101091
11983	107636	225	634	319	0	108814
11984	1594	273	111238	286	0	113391
11985	848	110519	893	430	0	112690
11986	326	114324	761	328	0	115739
11987	453	1498	244	112957	0	115152
11988	388	835	236	111343	0	112802
11989	348	286	179	113947	0	114760
11990	406	298	118135	1579	0	120418
11991	113457	253	960	1046	0	115716
11992	122985	237	810	404	0	124436
11993	126484	255	231	459	0	127429
11994	127237	250	222	425	0	128134
11995	129124	255	229	456	0	130064
11996	130835	276	248	421	0	131780
11997	2070	266	249	136196	0	138781
11998	1268	376	136982	1350	0	139976
11999	596	417	138526	1158	0	140697
12000	489	319	2037	137205	0	140050
12001	491	276	1060	136854	0	138681
12002	565	347	280	133911	0	135103
12003	475	140298	337	2319	0	143429
12004	138889	1351	239	1240	0	141719
12005	1570	145315	301	540	0	147726
12006	1409	1380	231	142297	0	145317
12007	138748	1128	281	1570	0	141727
12008	1480	142544	317	1486	0	145827
12009	1385	1452	257	142433	0	145527
12010	666	1214	216	144423	0	146519
12011	545	406	198	144398	0	145547
12012	443	143689	308	2662	0	147102
12013	566	1398	269	145719	0	147952
12014	562	1321	145178	1835	0	148896
12015	523	447	1402	145952	0	148324
12016	541	340	1128	147434	0	149443
12017	564	437	272	152769	0	154042
12018	599	370	222	154462	0	155653
12019	693	444	149938	3147	0	154222
12020	497	149904	1693	2042	0	154136
12021	621	1827	1356	148295	0	152099
12022	551	1464	383	151930	0	154328
12023	583	448	315	145530	0	146876
12024	490	149042	492	3254	0	153278
12025	550	152833	377	2102	0	155862
12026	149543	2877	283	892	0	153595
12027	2049	1582	260	147123	0	151014
12028	1773	617	147206	2230	0	151826
12029	538	146821	1758	2076	0	151193
12030	141867	1796	1532	897	0	146092
12031	1983	1450	141673	809	0	145915
12032	1621	554	140475	773	0	143423
12033	661	455	139038	676	0	140830
12034	517	1401	2887	132042	0	136847
12035	532	399	136061	2036	0	139028
12036	342	131245	1867	1783	0	135237
12037	396	1564	1329	125671	0	128960
12038	492	1234	128594	1676	0	131996
12039	329	463	1592	124797	0	127181
12040	123354	288	1302	1941	0	126885
12041	1604	382	124998	1573	0	128557
12042	118414	309	1688	783	0	121194
12043	1659	125588	1381	734	0	129362
12044	124384	1526	524	645	0	127079
12045	1757	1225	488	123343	0	126813
12046	123659	440	535	1890	0	126524
12047	122601	400	507	1605	0	125113
12048	119618	436	455	843	0	121352
12049	2512	122693	508	884	0	126597
12050	121629	1518	484	738	0	124369
12051	120798	1181	521	738	0	123238
12052	2803	464	119777	739	0	123783
12053	1682	119009	1691	740	0	123122
12054	985	1703	1353	117402	0	121443
12055	836	1297	566	119328	0	122027
12056	737	485	493	120434	0	122149
12057	708	476	118142	2821	0	122147
12058	661	397	1649	117323	0	120030
12059	648	456	119140	2191	0	122435
12060	114426	404	1849	1795	0	118474
12061	118090	409	1397	1048	0	120944
12062	2727	510	117761	869	0	121867
12063	115488	472	1703	888	0	118551
12064	118179	429	1389	856	0	120853
12065	119127	439	603	884	0	121053
12066	2842	450	591	115926	0	119809
12067	1723	576	117312	2171	0	121782
12068	749	117342	1750	1913	0	121754
12069	778	1700	1425	115070	0	118973
12070	764	1386	117001	2122	0	121273
12071	702	632	113324	1846	0	116504
12072	105891	562	2465	1043	0	109961
12073	1585	114053	1503	1081	0	118222
12074	113506	1516	674	979	0	116675
12075	112899	1218	678	917	0	115712
12076	2393	113772	761	1014	0	117940
12077	112300	1510	702	862	0	115374
12078	1878	1241	114326	900	0	118345
12079	1504	485	111187	797	0	113973
12080	908	527	110787	758	0	112980
12081	652	104789	2455	700	0	108596
12082	97843	1261	2532	566	0	102202
12083	96851	928	836	589	0	99204
12084	2014	94527	706	623	0	97870
12085	1234	96650	647	631	0	99162
12086	715	1838	567	94290	0	97410
12087	624	1127	472	95486	0	97709
12088	95112	510	472	1925	0	98019
12089	1392	96186	627	1209	0	99414
12090	93123	1250	525	550	0	95448
12091	90157	967	484	547	0	92155
12092	1927	510	90032	464	0	92933
12093	1227	88157	1211	458	0	91053
12094	977	1281	1090	85670	0	89018
12095	83702	856	565	943	0	86066
12096	1494	391	446	81766	0	84097
12097	75594	240	460	919	0	77213
12098	1138	301	74136	622	0	76197
12099	844	72681	969	427	0	74921
12100	574	73012	719	321	0	74626
12101	702	1638	663	65892	0	68895
12102	490	73439	426	627	0	74982
12103	72516	884	486	659	0	74545
12104	869	687	71163	330	0	73049
12105	66541	373	765	335	0	68014
12106	917	363	72501	321	0	74102
12107	743	323	724	71173	0	72963
12108	554	264	555	72238	0	73611
12109	561	235	325	73086	0	74207
12110	71727	218	270	962	0	73177
12111	923	268	73487	565	0	75243
12112	719	205	639	72865	0	74428
12113	513	271	489	71660	0	72933
12114	399	72626	297	978	0	74300
12115	358	72328	251	695	0	73632
12116	405	75263	265	390	0	76323
12117	358	960	239	71074	0	72631
12118	313	532	188	67915	0	68948
12119	106	68468	123	421	0	69118
12120	112	69170	97	227	0	69606
12121	68914	305	324	208	0	69751
12122	232	287	93	68770	0	69382
12123	164	69623	80	211	0	70078
12124	70793	139	128	184	0	71244
12125	215	134	52	72869	0	73270
12126	80834	51	74	288	0	81247
12127	399	49	63	83756	0	84267
12128	353	119	88212	435	0	89119
12129	68	89145	446	381	0	90040
12130	85650	389	307	180	0	86526
12131	457	350	90802	92	0	91701
12132	314	91526	407	173	0	92420
12133	104	414	322	92948	0	93788
12134	50	284	76	93904	0	94314
12135	49	77	22	93152	0	93300
12136	77	44	24	93166	0	93311
12137	95	101	93266	646	0	94108
12138	46	93341	390	479	0	94256
12139	71	365	253	92564	0	93253
12140	88063	295	43	447	0	88848
12141	297	93962	103	522	0	94884
12142	277	367	29	97344	0	98017
12143	173	364	98666	513	0	99716
12144	42	100306	539	559	0	101446
12145	457	652	380	84900	0	86389
12146	56	103239	102	354	0	103751
12147	103692	559	30	292	0	104573
12148	103734	424	47	170	0	104375
12149	1015	128	103386	73	0	104602
12150	100131	72	572	185	0	100960
12151	103822	55	462	158	0	104497
12152	1083	149	103544	133	0	104909
12153	515	105558	612	170	0	106855
12154	158	579	445	105502	0	106684
12155	115	470	91	106875	0	107551
12156	107006	71	74	1061	0	108212
12157	629	60	53	105945	0	106687
12158	513	103	107896	583	0	109095
12159	97481	85	639	596	0	98801
12160	715	142	107164	201	0	108222
12161	475	107461	719	300	0	108955
12162	103551	635	583	152	0	104921
12163	655	551	107453	122	0	108781
12164	580	181	105572	111	0	106444
12165	127	107770	1046	190	0	109133
12166	87	613	520	108277	0	109497
12167	210	588	107495	686	0	108979
12168	143	119	674	98043	0	98979
12169	132	72	529	106642	0	107375
12170	163	122	105453	1101	0	106839
12171	66	106179	699	706	0	107650
12172	103	642	489	106755	0	107989
12173	104918	475	151	702	0	106246
12174	103902	117	99	577	0	104695
12175	1072	93	77	105090	0	106332
12176	600	134	105553	703	0	106990
12177	230	214	111062	559	0	112065
12178	157	121	1107	110677	0	112062
12179	185	176	111691	860	0	112912
12180	106952	101	764	668	0	108485
12181	802	111	572	114698	0	116183
12182	669	97	164	116085	0	117015
12183	146	118193	215	1341	0	119895
12184	187	846	116	120226	0	121375
12185	209	749	117515	870	0	119343
12186	109358	189	821	786	0	111154
12187	116915	91	611	293	0	117910
12188	1382	189	120242	230	0	122043
12189	720	158	813	124014	0	125705
12190	237	112	655	129142	0	130146
12191	231	221	129681	1800	0	131933
12192	232	113	1041	129161	0	130547
12193	307	145	794	130571	0	131817
12194	141	135415	302	1861	0	137719
12195	286	1133	183	138859	0	140461
12196	255	826	148	140167	0	141396
12197	142632	151	215	2147	0	145145
12198	146392	157	203	1130	0	147882
12199	148937	145	176	406	0	149664
12200	148016	163	218	326	0	148723
12201	147151	143	192	364	0	147850
12202	2299	247	143445	385	0	146376
12203	1184	131	1352	141373	0	144040
12204	380	139	972	145784	0	147275
12205	350	192	145529	2228	0	148299
12206	137794	149	1406	1234	0	140583
12207	143866	143	1014	398	0	145421
12208	2329	345	141945	239	0	144858
12209	142729	110	1369	411	0	144619
12210	146630	129	1016	323	0	148098
12211	2390	280	147241	264	0	150175
12212	1309	196	1480	140168	0	143153
12213	431	155303	1163	1498	0	158395
12214	445	1423	345	160925	0	163138
12215	400	986	274	161299	0	162959
12216	384	222	228	160771	0	161605
12217	393	234	156863	2577	0	160067
12218	146898	116	1595	1398	0	150007
12219	155908	114	1147	438	0	157607
12220	2561	111	304	154834	0	157810
12221	1297	191	153269	1680	0	156437
12222	399	217	1597	150023	0	152236
12223	370	209	156573	1773	0	158925
12224	442	183	157791	1318	0	159734
12225	284	160066	2577	609	0	163536
12226	997	1301	1241	149014	0	152553
12227	149165	793	443	1379	0	151780
12228	145458	146	227	1049	0	146880
12229	148330	116	236	397	0	149079
12230	2175	108	217	145574	0	148074
12231	1052	155727	310	1533	0	158622
12232	442	1381	185	158553	0	160561
12233	375	988	162111	1647	0	165121
12234	165169	175	1522	1285	0	168151
12235	179154	120	1075	501	0	180850
12236	2828	100	298	180798	0	184024
12237	1415	148	276	182317	0	184156
12238	516	125	254	184310	0	185205
12239	473	247	180488	3110	0	184318
12240	149519	203	2042	2205	0	153969
12241	1846	178034	1401	779	0	182060
12242	1222	174555	435	687	0	176899
12243	569	2382	175109	462	0	178522
12244	489	1277	1739	169822	0	173327
12245	426	311	175589	1882	0	178208
12246	162083	268	1920	1336	0	165607
12247	1895	223	1116	169977	0	173211
12248	1364	286	170947	1800	0	174397
12249	469	175136	1775	1876	0	179256
12250	170102	1553	1259	637	0	173551
12251	2077	1098	179102	576	0	182853
12252	1296	177460	1917	632	0	181305
12253	464	180931	1343	627	0	183365
12254	180618	2496	453	545	0	184112
12255	1870	1239	368	180893	0	184370
12256	1396	388	187115	2013	0	190912
12257	484	187271	2026	1639	0	191420
12258	186260	1725	1282	614	0	189881
12259	186790	1147	430	535	0	188902
12260	2766	187443	526	819	0	191554
12261	1610	1955	189476	504	0	193545
12262	636	1183	1966	188758	0	192543
12263	190543	356	1306	2036	0	194241
12264	189959	287	482	1412	0	192140
12265	3116	384	189776	583	0	193859
12266	1696	297	1977	182065	0	186035
12267	763	259	1347	189513	0	191882
12268	712	336	190519	2948	0	194515
12269	716	390	187679	1462	0	190247
12270	187091	308	2998	715	0	191112
12271	193238	321	1530	575	0	195664
12272	194215	355	570	587	0	195727
12273	194474	301	643	578	0	195996
12274	3209	432	191004	571	0	195216
12275	187977	288	2087	512	0	190864
12276	2551	276	1438	186879	0	191144
12277	1682	379	189018	2114	0	193193
12278	827	397	188889	1492	0	191605
12279	616	187968	3049	956	0	192589
12280	669	1748	1466	181559	0	185442
12281	725	1194	184999	1948	0	188866
12282	171756	445	2114	1434	0	175749
12283	2225	482	1487	158704	0	162898
12284	1444	183497	759	1580	0	187280
12285	183461	1755	590	1375	0	187181
12286	183239	1107	693	658	0	185697
12287	3058	510	183633	640	0	187841
12288	1604	181035	2112	773	0	185524
12289	937	1550	1311	173885	0	177683
12290	173248	1122	565	1677	0	176612
12291	2011	508	587	171839	0	174945
12292	1409	454	169071	1806	0	172740
12293	147871	427	1709	1379	0	151386
12294	1734	165477	1344	722	0	169277
12295	1149	160526	692	617	0	162984
12296	597	166412	711	662	0	168382
12297	162106	2097	1628	613	0	166444
12298	159474	1010	599	493	0	161576
12299	160235	355	542	438	0	161570
12300	2211	358	447	158112	0	161128
12301	1309	504	160696	1391	0	163900
12302	733	356	1463	160605	0	163157
12303	161993	323	1029	1528	0	164873
12304	1700	314	514	162883	0	165411
12305	166587	316	460	1499	0	168862
12306	164022	328	486	1142	0	165978
12307	164495	315	538	540	0	165888
12308	2130	166097	575	698	0	169500
12309	164116	1379	525	448	0	166468
12310	1787	963	163056	448	0	166254
12311	1397	546	163075	392	0	165410
12312	748	160810	2176	413	0	164147
12313	1303	1384	1500	150114	0	154301
12314	149730	838	496	1230	0	152294
12315	1657	365	149638	816	0	152476
12316	142811	241	1350	398	0	144800
12317	1565	274	1029	142764	0	145632
12318	1106	149976	573	1289	0	152944
12319	656	1169	487	151688	0	154000
12320	659	880	152494	1231	0	155264
12321	138416	284	1476	1145	0	141321
12322	1591	421	154870	526	0	157408
12323	1203	340	149004	359	0	150906
12324	139249	245	1774	413	0	141681
12325	1430	144185	1068	409	0	147092
12326	146986	1116	495	310	0	148907
12327	147035	760	409	404	0	148608
12328	2121	410	145168	336	0	148035
12329	138513	278	1533	372	0	140696
12330	1465	334	142835	476	0	145110
12331	1063	318	135386	384	0	137151
12332	738	260	137042	436	0	138476
12333	481	130717	1757	384	0	133339
12334	116724	1632	3781	574	0	122711
12335	114190	622	680	444	0	115936
12336	113437	134	194	215	0	113980
12337	113745	91	207	253	0	114296
12338	1082	230	115135	132	0	116579
12339	650	81	614	112930	0	114275
12340	361	121	464	116713	0	117659
12341	116562	130	192	942	0	117826
12342	710	117438	263	537	0	118948
12343	560	546	192	116376	0	117674
12344	115225	380	212	673	0	116490
12345	756	210	119107	454	0	120527
12346	608	183	598	117458	0	118847
12347	304	250	123435	751	0	124740
12348	263	122506	713	726	0	124208
12349	584	935	624	117281	0	119424
12350	117098	456	267	740	0	118561
12351	716	173	153	121148	0	122190
12352	649	255	122789	741	0	124434
12353	233	123608	679	690	0	125210
12354	120863	610	511	331	0	122315
12355	754	502	123110	186	0	124552
12356	115979	137	712	274	0	117102
12357	726	123200	559	279	0	124764
12358	124086	633	480	193	0	125392
12359	125286	555	127	235	0	126203
12360	1204	134	131	125873	0	127342
12361	753	223	127859	802	0	129637
12362	206	129933	763	750	0	131652
12363	278	751	588	133086	0	134703
12364	263	626	177	135454	0	136520
12365	240	132	165	141492	0	142029
12366	244	134	141	143702	0	144221
12367	185	157661	271	1915	0	160032
12368	161080	1276	153	1007	0	163516
12369	1428	163119	258	447	0	165252
12370	1164	1587	162	167187	0	170100
12371	169534	1033	142	1663	0	172372
12372	1750	259	148	170461	0	172618
12373	1373	316	169985	1921	0	173595
12374	376	169859	1723	1484	0	173442
12375	406	1658	1184	168921	0	172169
12376	361	1217	230	172595	0	174403
12377	166793	265	231	2786	0	170075
12378	1852	342	166894	1383	0	170471
12379	161840	276	1684	612	0	164412
12380	165163	225	1205	506	0	167099
12381	165539	281	263	527	0	166610
12382	3024	417	164552	462	0	168455
12383	1535	391	1732	159805	0	163463
12384	623	283	1213	162838	0	164957
12385	484	470	164938	2968	0	168860
12386	566	434	166142	1565	0	168707
12387	163370	264	2953	733	0	167320
12388	2055	281	1453	168172	0	171961
12389	171987	274	520	2129	0	174910
12390	173901	313	442	1652	0	176308
12391	3323	257	380	172755	0	176715
12392	1919	395	180193	2277	0	184784
12393	166053	263	2347	1928	0	170591
12394	2561	248	1649	181242	0	185700
12395	2096	421	181833	2470	0	186820
12396	877	180114	2257	2112	0	185360
12397	177058	2075	1763	809	0	181705
12398	2394	181793	764	916	0	185867
12399	2347	2365	543	157896	0	163151
12400	902	181690	637	2337	0	185566
12401	176023	2325	666	1838	0	180852
12402	176133	1677	612	997	0	179419
12403	3717	177156	671	1239	0	182783
12404	175735	2102	627	984	0	179448
12405	173133	1675	583	943	0	176334
12406	3849	171813	672	1094	0	177428
12407	172408	2208	593	929	0	176138
12408	2932	1680	607	169505	0	174724
12409	2455	558	652	171505	0	175170
12410	170865	478	616	3675	0	175634
12411	3115	519	611	157969	0	162214
12412	2364	166525	708	2411	0	172008
12413	165922	2222	605	1952	0	170701
12414	164064	1786	620	992	0	167462
12415	3778	166309	740	1172	0	171999
12416	166942	2302	620	1014	0	170878
12417	167093	1836	643	882	0	170454
12418	4314	686	601	162938	0	168539
12419	2836	789	162993	2645	0	169263
12420	1513	161883	2287	2309	0	167992
12421	162995	2380	1660	1092	0	168127
12422	162844	1885	616	1085	0	166430
12423	4872	890	158845	1021	0	165628
12424	159282	670	2315	1117	0	163384
12425	3393	809	157469	1070	0	162741
12426	155340	765	2449	1003	0	159557
12427	3264	915	1754	155076	0	161009
12428	2692	966	154636	2773	0	161067
12429	1656	1108	155588	2134	0	160486
12430	1628	1230	3447	149575	0	155880
12431	1518	950	1853	150127	0	154448
12432	1626	995	146783	3858	0	153262
12433	1845	826	2354	145185	0	150210
12434	1870	1030	147104	2735	0	152739
12435	1781	938	2602	143406	0	148727
12436	1975	981	1831	138994	0	143781
12437	1852	141311	998	3715	0	147876
12438	1857	140197	910	2445	0	145409
12439	1783	143848	986	1630	0	148247
12440	1815	3673	854	139787	0	146129
12441	1742	1936	981	142335	0	146994
12442	1646	938	138955	4238	0	145777
12443	131798	778	2620	2686	0	137882
12444	138564	750	2129	1417	0	142860
12445	4543	134689	1163	1433	0	141828
12446	133806	2348	990	1145	0	138289
12447	3591	1804	907	129978	0	136280
12448	131748	821	1069	2795	0	136433
12449	131655	736	969	2317	0	135677
12450	4544	793	987	127732	0	134056
12451	119120	856	1031	2795	0	123802
12452	2963	117185	1082	2352	0	123582
12453	2519	116989	1024	1261	0	121793
12454	1759	3483	1002	106317	0	112561
12455	1708	114724	1020	2279	0	119731
12456	1646	2367	842	106855	0	111710
12457	1807	1742	784	108819	0	113152
12458	105292	799	784	3206	0	110081
12459	2901	103434	920	2185	0	109440
12460	101798	2088	846	1142	0	105874
12461	97218	1546	873	1147	0	100784
12462	3433	97455	889	1377	0	103154
12463	94586	1975	749	1182	0	98492
12464	2839	1546	91862	1244	0	97491
12465	1790	85353	1836	1147	0	90126
12466	78249	1564	1382	1087	0	82282
12467	1718	990	67220	736	0	70664
12468	1049	59449	1076	688	0	62262
12469	700	60119	1233	633	0	62685
12470	52397	1237	1295	426	0	55355
12471	50901	688	356	389	0	52334
12472	50701	395	217	347	0	51660
12473	1326	50118	284	404	0	52132
12474	857	774	237	50142	0	52010
12475	49923	608	272	885	0	51688
12476	50219	345	288	724	0	51576
12477	1282	355	243	49213	0	51093
12478	872	350	49789	827	0	51838
12479	565	349	50163	662	0	51739
12480	500	269	1142	49104	0	51015
12481	507	242	691	50503	0	51943
12482	511	251	50255	1215	0	52232
12483	523	217	817	47061	0	48618
12484	454	49523	681	915	0	51573
12485	47371	652	341	668	0	49032
12486	927	687	342	45768	0	47724
12487	42484	203	260	760	0	43707
12488	716	42769	273	731	0	44489
12489	549	42425	297	413	0	43684
12490	40516	726	239	366	0	41847
12491	590	431	39171	353	0	40545
12492	30222	414	488	155	0	31279
12493	371	31054	354	190	0	31969
12494	264	219	221	26981	0	27685
12495	26871	155	70	249	0	27345
12496	261	93	51	26636	0	27041
12497	27137	63	58	310	0	27568
12498	26513	49	62	216	0	26840
12499	326	28250	68	133	0	28777
12500	27078	178	47	109	0	27412
12501	204	27098	52	105	0	27459
12502	27031	197	46	76	0	27350
12503	223	144	42	26984	0	27393
12504	27643	53	30	220	0	27946
12505	196	52	25	28589	0	28862
12506	29928	49	26	228	0	30231
12507	31028	58	26	182	0	31294
12508	31429	55	21	101	0	31606
12509	31697	44	17	79	0	31837
12510	32049	46	29	74	0	32198
12511	328	54	18	32486	0	32886
12512	31893	44	30	190	0	32157
12513	228	31669	32	176	0	32105
12514	178	216	31855	63	0	32312
12515	101	117	159	31254	0	31631
12516	98	94	32940	180	0	33312
12517	73	63	161	34114	0	34411
12518	88	64	35261	244	0	35657
12519	33690	24	213	180	0	34107
12520	245	34	132	35252	0	35663
12521	181	62	35054	196	0	35493
12522	129	46	36430	147	0	36752
12523	88	130	274	36376	0	36868
12524	40888	49	160	255	0	41352
12525	242	44314	71	257	0	44884
12526	44663	257	31	93	0	45044
12527	44505	172	17	73	0	44767
12528	421	45429	43	72	0	45965
12529	47551	267	24	122	0	47964
12530	328	188	46	47832	0	48394
12531	235	55	24	48059	0	48373
12532	83	39	25	48793	0	48940
12533	48282	29	28	467	0	48806
12534	279	50422	57	281	0	51039
12535	229	308	26	51069	0	51632
12536	92	222	26	51846	0	52186
12537	51525	51	42	533	0	52151
12538	354	52	23	51811	0	52240
12539	285	78	54164	444	0	54971
12540	85	57392	412	341	0	58230
12541	58049	484	273	124	0	58930
12542	540	359	78	55023	0	56000
12543	373	59697	86	476	0	60632
12544	59608	488	53	369	0	60518
12545	618	395	59590	159	0	60762
12546	382	59834	522	125	0	60863
12547	59887	516	372	120	0	60895
12548	552	358	82	59753	0	60745
12549	407	81	54	60321	0	60863
12550	151	120	60292	868	0	61431
12551	125	65	482	59031	0	59703
12552	144	101	64901	584	0	65730
12553	127	104	63348	438	0	64017
12554	119	80	65613	123	0	65935
12555	63350	56	913	146	0	64465
12556	65058	42	454	91	0	65645
12557	66806	44	117	111	0	67078
12558	926	61	88	64147	0	65222
12559	469	66281	92	515	0	67357
12560	176	67696	96	445	0	68413
12561	68282	825	62	169	0	69338
12562	67835	439	68	139	0	68481
12563	814	69154	83	142	0	70193
12564	68384	502	117	113	0	69116
12565	601	426	67241	111	0	68379
12566	493	132	67926	120	0	68671
12567	172	80	814	63648	0	64714
12568	136	78	407	68853	0	69474
12569	137	86	69182	834	0	70239
12570	99	56	560	67220	0	67935
12571	68598	40	435	615	0	69688
12572	556	83	68869	416	0	69924
12573	66221	49	559	141	0	66970
12574	598	55	392	69043	0	70088
12575	521	106	72232	550	0	73409
12576	153	73191	572	486	0	74402
12577	73770	485	390	175	0	74820
12578	585	404	72632	150	0	73771
12579	71007	112	540	104	0	71763
12580	595	93	387	72459	0	73534
12581	72881	64	122	560	0	73627
12582	651	115	78260	438	0	79464
12583	526	67	559	78407	0	79559
12584	82646	58	423	664	0	83791
12585	85333	65	165	528	0	86091
12586	88590	70	106	209	0	88975
12587	89049	79	93	203	0	89424
12588	1125	64	117	86648	0	87954
12589	624	85	91	87272	0	88072
12590	293	167	88655	1093	0	90208
12591	247	78	663	87654	0	88642
12592	246	89	484	86569	0	87388
12593	168	91046	173	1134	0	92521
12594	91526	662	140	590	0	92918
12595	93046	505	110	249	0	93910
12596	1163	97787	180	296	0	99426
12597	692	848	125	96922	0	98587
12598	251	564	126	99058	0	99999
12599	96382	114	115	1488	0	98099
12600	1009	163	103504	769	0	105445
12601	735	80	917	104024	0	105756
12602	338	178	106378	1037	0	107931
12603	101794	85	996	817	0	103692
12604	106778	75	652	300	0	107805
12605	108032	92	174	295	0	108593
12606	1592	96	154	105471	0	107313
12607	857	98	125	105818	0	106898
12608	105393	103	173	1509	0	107178
12609	1118	193	105061	758	0	107130
12610	782	114	912	104314	0	106122
12611	104844	98	625	1041	0	106608
12612	1058	118	211	105507	0	106894
12613	836	157	113471	1077	0	115541
12614	373	138	112944	774	0	114229
12615	106413	146	1481	384	0	108424
12616	988	114161	793	366	0	116308
12617	117097	806	308	410	0	118621
12618	119497	530	185	391	0	120603
12619	1510	122	207	120521	0	122360
12620	788	156	186	119633	0	120763
12621	322	121558	267	1491	0	123638
12622	120840	829	207	818	0	122694
12623	1058	126174	225	374	0	127831
12624	728	126539	181	352	0	127800
12625	351	1232	161	122934	0	124678
12626	123519	567	149	959	0	125194
12627	126555	158	121	737	0	127571
12628	1438	111	143	126145	0	127837
12629	792	118	127	124840	0	125877
12630	417	96	125	125260	0	125898
12631	122859	105	162	1457	0	124583
12632	1062	179	124571	815	0	126627
12633	760	124623	907	424	0	126714
12634	123598	691	542	358	0	125189
12635	921	726	251	122845	0	124743
12636	741	244	124386	943	0	126314
12637	463	172	125543	743	0	126921
12638	291	126377	1243	392	0	128303
12639	337	128869	635	412	0	130253
12640	655	1172	519	122392	0	124738
12641	248	123940	199	695	0	125082
12642	285	554	137	125213	0	126189
12643	253	404	115	126406	0	127178
12644	126847	133	163	1054	0	128197
12645	677	180	137	128209	0	129203
12646	580	128	117	128909	0	129734
12647	369	207	128877	1025	0	130478
12648	308	123	577	129810	0	130818
12649	131739	117	442	843	0	133141
12650	132041	122	180	657	0	133000
12651	1049	139968	209	464	0	141690
12652	137709	691	177	418	0	138995
12653	995	609	139329	431	0	141364
12654	651	143387	769	433	0	145240
12655	387	761	553	145247	0	146948
12656	361	568	217	148064	0	149210
12657	368	223	190	147345	0	148126
12658	148279	145	234	1468	0	150126
12659	136363	163	481	874	0	137881
12660	1439	271	147542	382	0	149634
12661	851	284	147421	448	0	149004
12662	565	330	151691	411	0	152997
12663	358	153312	1323	522	0	155515
12664	367	155689	715	443	0	157214
12665	155626	1253	224	477	0	157580
12666	152952	712	244	475	0	154383
12667	1438	190	196	158144	0	159968
12668	806	225	206	154756	0	155993
12669	350	162435	300	1624	0	164709
12670	341	857	234	165549	0	166981
12671	528	848	165197	1104	0	167677
12672	378	168568	970	1315	0	171231
12673	415	923	701	168895	0	170934
12674	570	842	178993	1097	0	181502
12675	632	426	904	160258	0	162220
12676	326	177680	863	1113	0	179982
12677	183445	976	250	983	0	185654
12678	182853	886	191	508	0	184438
12679	186272	312	184	579	0	187347
12680	1845	344	201	188215	0	190605
12681	1131	303	203	187067	0	188704
12682	189005	309	232	2004	0	191550
12683	1235	189128	357	1233	0	191953
12684	193688	1092	297	604	0	195681
12685	1394	1071	196219	489	0	199173
12686	196331	251	1266	502	0	198350
12687	200166	251	1138	528	0	202083
12688	2453	273	281	196297	0	199304
12689	205079	231	251	1462	0	207023
12690	202095	269	287	1322	0	203973
12691	2425	278	249	204837	0	207789
12692	1466	355	206399	1440	0	209660
12693	185908	293	1518	1493	0	189212
12694	1605	429	207307	450	0	209791
12695	1221	211269	1503	504	0	214497
12696	754	1260	1475	209323	0	212812
12697	317	1131	323	211238	0	213009
12698	217422	273	271	2329	0	220295
12699	1503	371	222947	1391	0	226212
12700	1382	573	1363	198650	0	201968
12701	415	219692	1349	1398	0	222854
12702	393	216448	465	1526	0	218832
12703	473	2619	348	215849	0	219289
12704	601	1454	219002	1570	0	222627
12705	453	447	1472	217044	0	219416
12706	490	443	1392	212812	0	215137
12707	596	627	213864	2682	0	217769
12708	480	221054	1466	1758	0	224758
12709	206878	1618	1366	700	0	210562
12710	1524	223522	496	858	0	226400
12711	1539	1650	357	214970	0	218516
12712	207756	1494	377	1725	0	211352
12713	1462	211164	577	1948	0	215151
12714	1638	1675	213268	760	0	217341
12715	200516	1479	1580	754	0	204329
12716	1607	216376	1589	869	0	220441
12717	214138	1525	511	731	0	216905
12718	1941	1634	210306	656	0	214537
12719	202824	467	1581	715	0	205587
12720	1950	466	1491	203346	0	207253
12721	1935	675	205595	7058	0	215263
12722	925	486	1551	196395	0	199357
12723	715	204504	1645	1958	0	208822
12724	862	1607	484	204717	0	207670
12725	800	1632	542	201091	0	204065
12726	1027	759	202144	2935	0	206865
12727	948	516	1742	199185	0	202391
12728	1086	820	184948	2055	0	188909
12729	1050	200955	1600	2506	0	206111
12730	1031	1836	1464	199630	0	203961
12731	1385	1786	203284	2131	0	208586
12732	1098	204021	1967	2224	0	209310
12733	1224	207400	1714	1298	0	211636
12734	1553	3079	204498	1087	0	210217
12735	1471	1945	204344	1100	0	208860
12736	1344	780	3067	199705	0	204896
12737	200359	685	1951	2382	0	205377
12738	2549	201091	823	2796	0	207259
12739	2591	2184	783	195043	0	200601
12740	196414	1843	676	2484	0	201417
12741	2966	199357	868	2567	0	205758
12742	199078	1969	743	1278	0	203068
12743	3105	203258	846	1556	0	208765
12744	202610	2015	781	1335	0	206741
12745	202093	1901	784	1478	0	206256
12746	203272	906	839	1365	0	206382
12747	4668	211777	1066	1705	0	219216
12748	3253	2285	1017	212170	0	218725
12749	2538	2078	208880	2969	0	216465
12750	2090	209056	2625	3131	0	216902
12751	2305	2581	2311	201218	0	208415
12752	2583	2256	1177	201309	0	207325
12753	2239	1118	196283	4005	0	203645
12754	2186	191509	2667	2964	0	199326
12755	187959	2165	2427	1539	0	194090
12756	3407	189282	1170	1824	0	195683
12757	2846	2246	1103	187218	0	193413
12758	1727	2070	188050	3124	0	194971
12759	173310	989	2812	2745	0	179856
12760	2777	1078	2302	188456	0	194613
12761	2099	1223	186411	3137	0	192870
12762	169236	1221	2881	2759	0	176097
12763	2392	180538	2198	1919	0	187047
12764	180364	2667	1375	1703	0	186109
12765	178790	2583	943	1968	0	184284
12766	3408	1150	1015	179269	0	184842
12767	2019	1371	178477	3049	0	184916
12768	1044	177239	2516	2735	0	183534
12769	972	2809	175306	1606	0	180693
12770	727	2703	2340	167293	0	173063
12771	823	1690	2034	172491	0	177038
12772	166482	1212	1104	3777	0	172575
12773	2162	1120	166856	2757	0	172895
12774	1722	158429	2560	1323	0	164034
12775	1079	2343	1782	155143	0	160347
12776	904	2072	739	155842	0	159557
12777	151130	1052	791	2824	0	155797
12778	2179	153501	657	1976	0	158313
12779	1768	2118	510	145690	0	150086
12780	141325	1647	561	1904	0	145437
12781	1647	141395	668	1714	0	145424
12782	136357	1636	515	558	0	139066
12783	133907	1331	551	519	0	136308
12784	2431	132415	700	781	0	136327
12785	119759	1179	266	367	0	121571
12786	1309	120998	383	423	0	123113
12787	119979	1134	318	362	0	121793
12788	118681	892	367	380	0	120320
12789	1824	117723	331	507	0	120385
12790	113283	1070	207	334	0	114894
12791	114998	814	250	313	0	116375
12792	114647	314	303	401	0	115665
12793	1861	324	113008	413	0	115606
12794	1009	350	107122	298	0	108779
12795	340	321	108182	230	0	109073
12796	105665	428	2094	305	0	108492
12797	1209	308	106092	321	0	107930
12798	940	313	95949	259	0	97461
12799	470	577	1438	88748	0	91233
12800	91155	186	743	924	0	93008
12801	1035	267	91895	677	0	93874
12802	803	321	94919	230	0	96273
12803	361	229	1447	91760	0	93797
12804	368	204	682	94114	0	95368
12805	387	218	174	95113	0	95892
12806	383	282	94084	1475	0	96224
12807	347	228	954	92825	0	94354
12808	91765	220	703	1001	0	93689
12809	1020	93634	260	983	0	95897
12810	839	969	178	92531	0	94517
12811	405	756	190	94147	0	95498
12812	415	357	96292	1514	0	98578
12813	320	94519	1113	914	0	96866
12814	93710	1124	789	316	0	95939
12815	1079	95957	360	420	0	97816
12816	877	1056	268	94913	0	97114
12817	409	833	95230	1116	0	97588
12818	387	277	1149	97534	0	99347
12819	358	241	913	98982	0	100494
12820	99041	216	398	1752	0	101407
12821	1283	199	345	95170	0	96997
12822	931	97285	432	1297	0	99945
12823	378	100110	446	1064	0	101998
12824	423	1773	100352	443	0	102991
12825	98083	895	1271	381	0	100630
12826	1328	266	1004	100522	0	103120
12827	1067	215	399	100702	0	102383
12828	443	237	378	101860	0	102918
12829	101271	185	339	2010	0	103805
12830	1255	102270	414	1455	0	105394
12831	101107	1138	442	538	0	103225
12832	1366	877	96601	413	0	99257
12833	947	312	95606	457	0	97322
12834	95707	204	1935	429	0	98275
12835	1370	259	1248	95996	0	98873
12836	996	252	402	97621	0	99271
12837	380	254	382	98950	0	99966
12838	382	274	97780	2058	0	100494
12839	95528	219	1276	1158	0	98181
12840	97640	210	963	559	0	99372
12841	93751	232	408	515	0	94906
12842	1962	400	352	91473	0	94187
12843	1013	306	89810	1364	0	92493
12844	532	262	88135	1107	0	90036
12845	408	299	89958	605	0	91270
12846	352	85041	1853	576	0	87822
12847	1017	988	1732	73736	0	77473
12848	73359	612	321	919	0	75211
12849	852	264	73764	856	0	75736
12850	73162	140	850	463	0	74615
12851	909	141	732	73843	0	75625
12852	771	178	260	72371	0	73580
12853	362	72870	301	1403	0	74936
12854	315	73906	308	916	0	75445
12855	283	75728	351	525	0	76887
12856	336	1271	333	74550	0	76490
12857	74399	645	362	925	0	76331
12858	74376	210	299	857	0	75742
12859	1370	230	73722	443	0	75765
12860	72231	151	902	464	0	73748
12861	948	208	73657	440	0	75253
12862	817	161	962	72361	0	74301
12863	405	208	73641	966	0	75220
12864	70875	154	997	892	0	72918
12865	974	212	824	71980	0	73990
12866	784	240	74809	945	0	76778
12867	390	215	72185	854	0	73644
12868	68939	187	1375	512	0	71013
12869	71175	178	806	508	0	72667
12870	1312	72160	421	501	0	74394
12871	784	746	351	72160	0	74041
12872	405	654	72432	901	0	74392
12873	424	299	71945	842	0	73510
12874	463	329	1253	70852	0	72897
12875	70988	240	941	1052	0	73221
12876	808	70936	455	933	0	73132
12877	782	715	348	71390	0	73235
12878	71255	639	313	984	0	73191
12879	918	276	306	70353	0	71853
12880	815	71558	373	1043	0	73789
12881	459	710	348	72149	0	73666
12882	71272	593	376	973	0	73214
12883	986	237	355	71750	0	73328
12884	71706	189	343	980	0	73218
12885	877	73042	395	971	0	75285
12886	72797	682	424	519	0	74422
12887	939	613	71286	503	0	73341
12888	68758	261	913	454	0	70386
12889	71046	232	767	426	0	72471
12890	1251	72106	427	481	0	74265
12891	824	772	333	68618	0	70547
12892	447	574	69051	781	0	70853
12893	424	289	67024	678	0	68415
12894	62036	571	1176	519	0	64302
12895	60922	197	639	417	0	62175
12896	871	62361	286	450	0	63968
12897	586	63090	276	355	0	64307
12898	61905	774	295	344	0	63318
12899	640	62323	315	308	0	63586
12900	571	63697	327	335	0	64930
12901	535	690	221	62647	0	64093
12902	329	395	196	61337	0	62257
12903	308	176	62374	918	0	63776
12904	305	109	537	62010	0	62961
12905	61787	95	583	647	0	63112
12906	669	184	62150	543	0	63546
12907	635	162	62983	304	0	64084
12908	418	165	819	61081	0	62483
12909	341	151	556	63448	0	64496
12910	346	155	311	63710	0	64522
12911	320	143	62977	820	0	64260
12912	293	157	525	58011	0	58986
12913	288	164	457	60391	0	61300
12914	57994	121	207	633	0	58955
12915	414	57855	216	457	0	58942
12916	57446	310	194	187	0	58137
12917	479	275	58542	208	0	59504
12918	49777	74	300	160	0	50311
12919	295	56297	254	172	0	57018
12920	51658	141	86	70	0	51955
12921	173	52239	54	109	0	52575
12922	50141	144	151	76	0	50512
12923	103	49706	61	55	0	49925
12924	144	49659	97	126	0	50026
12925	253	210	175	49344	0	49982
12926	50585	61	98	133	0	50877
12927	50808	16	8	69	0	50901
12928	50965	25	19	51	0	51060
12929	182	36	50793	44	0	51055
12930	96	43	51505	27	0	51671
12931	44	48	149	51095	0	51336
12932	22	54341	78	111	0	54552
12933	34	55362	34	97	0	55527
12934	67	185	10	53037	0	53299
12935	54617	77	12	125	0	54831
12936	54880	24	23	108	0	55035
12937	55101	23	7	33	0	55164
12938	224	44	55931	26	0	56225
12939	108	19	127	56117	0	56371
12940	53	48	57986	140	0	58227
12941	57432	16	152	121	0	57721
12942	58584	21	94	53	0	58752
12943	240	42	58945	29	0	59256
12944	117	25	136	59081	0	59359
12945	59691	19	92	237	0	60039
12946	171	20	27	63099	0	63317
12947	124	20	19	64135	0	64298
12948	73	38	18	68265	0	68394
12949	71200	17	15	420	0	71652
12950	287	23	20	76294	0	76624
12951	76203	29	44	382	0	76658
12952	320	85967	52	285	0	86624
12953	286	418	23	90992	0	91719
12954	85	285	35	90963	0	91368
12955	106	63	29	87261	0	87459
12956	90347	23	26	710	0	91106
12957	476	29	31	89901	0	90437
12958	455	38	23	80763	0	81279
12959	92639	29	30	675	0	93373
12960	92648	28	47	310	0	93033
12961	91653	42	51	116	0	91862
12962	824	63	91867	89	0	92843
12963	443	95	88007	68	0	88613
12964	91084	56	697	103	0	91940
12965	525	43	326	92756	0	93650
12966	476	57	69	83107	0	83709
12967	93822	37	45	786	0	94690
12968	92672	36	65	379	0	93152
12969	87985	61	43	168	0	88257
12970	762	91366	83	293	0	92504
12971	92269	433	55	103	0	92860
12972	87078	353	64	135	0	87630
12973	786	93337	89	188	0	94400
12974	393	91201	114	152	0	91860
12975	324	658	75	84806	0	85863
12976	96270	271	67	442	0	97050
12977	96087	58	84	341	0	96570
12978	94530	44	84	185	0	94843
12979	869	32	68	93515	0	94484
12980	94290	35	88	532	0	94945
12981	605	111	95274	373	0	96363
12982	90967	73	489	193	0	91722
12983	614	102	96152	154	0	97022
12984	497	131	92575	179	0	93382
12985	231	104	728	91324	0	92387
12986	90976	91	416	582	0	92065
12987	556	82	98	92442	0	93178
12988	478	126	94655	643	0	95902
12989	299	127	94909	524	0	95859
12990	297	114	706	92091	0	93208
12991	90835	128	368	600	0	91931
12992	577	97073	141	634	0	98425
12993	556	453	114	98383	0	99506
12994	398	332	127	98611	0	99468
12995	398	123	102622	978	0	104121
12996	399	131	100956	562	0	102048
12997	320	65	840	101551	0	102776
12998	101877	68	468	797	0	103210
12999	868	130	103523	693	0	105214
13000	721	110	511	102971	0	104313
13001	500	117	416	104067	0	105100
13002	413	119	207	103419	0	104158
13003	102150	104	182	1247	0	103683
13004	881	256	93477	900	0	95514
13005	744	103636	426	837	0	105643
13006	575	535	330	105024	0	106464
13007	717	435	105525	1100	0	107777
13008	696	105614	639	1027	0	107976
13009	718	107348	493	768	0	109327
13010	106879	878	250	729	0	108736
13011	1126	107774	256	953	0	110109
13012	108884	662	258	921	0	110725
13013	1221	573	108557	1032	0	111383
13014	1073	307	664	110316	0	112360
13015	110660	194	534	1644	0	113032
13016	1337	113127	283	1736	0	116483
13017	1402	710	113085	1191	0	116388
13018	1354	631	719	101695	0	104399
13019	1184	113799	657	1273	0	116913
13020	1287	800	340	115163	0	117590
13021	114486	646	476	1324	0	116932
13022	1667	117390	531	1267	0	120855
13023	117761	771	464	856	0	119852
13024	117385	600	459	869	0	119313
13025	2298	334	117625	805	0	121062
13026	1804	121237	1016	813	0	124870
13027	1501	1048	818	124823	0	128190
13028	1566	776	129014	1189	0	132545
13029	1593	459	136749	930	0	139731
13030	1455	727	1744	136620	0	140546
13031	141378	375	1120	1266	0	144139
13032	138959	416	518	1148	0	141041
13033	2699	443	369	140173	0	143684
13034	1890	544	142424	1501	0	146359
13035	1167	143424	1277	1366	0	147234
13036	146712	1311	1013	680	0	149716
13037	145398	1076	404	615	0	147493
13038	2653	148123	500	742	0	152018
13039	149265	1289	413	564	0	151531
13040	2074	1082	146996	501	0	150653
13041	144384	324	1538	556	0	146802
13042	139949	297	1447	618	0	142311
13043	2380	357	146861	511	0	150109
13044	1458	261	1646	142171	0	145536
13045	915	251	145109	1643	0	147918
13046	713	140966	1783	1579	0	145041
13047	633	141574	1624	881	0	144712
13048	728	2608	782	131401	0	135519
13049	645	838	132901	1314	0	135698
13050	289	125961	1308	1143	0	128701
13051	231	123785	1036	470	0	125522
13052	111776	1510	586	439	0	114311
13053	110971	604	214	198	0	111987
13054	1242	178	137	112366	0	113923
13055	695	160	132	107839	0	108826
13056	199	113970	204	1291	0	115664
13057	110587	753	135	683	0	112158
13058	111643	624	133	255	0	112655
13059	1228	113617	173	363	0	115381
13060	717	776	131	113925	0	115549
13061	312	693	113927	815	0	115747
13062	258	217	788	112936	0	114199
13063	114083	186	643	932	0	115844
13064	897	216	179	114832	0	116124
13065	787	204	193	116329	0	117513
13066	116399	155	163	1451	0	118168
13067	938	200	206	113244	0	114588
13068	731	116371	236	947	0	118285
13069	475	791	181	117359	0	118806
13070	340	699	210	117762	0	119011
13071	307	264	201	113774	0	114546
13072	244	117551	321	1461	0	119577
13073	296	896	226	115859	0	117277
13074	371	822	115007	959	0	117159
13075	356	271	861	113575	0	115063
13076	412	361	114944	1048	0	116765
13077	359	113970	994	1031	0	116354
13078	402	958	813	115136	0	117309
13079	435	845	295	115382	0	116957
13080	475	342	307	115944	0	117068
13081	457	275	310	115441	0	116483
13082	541	394	114455	1719	0	117109
13083	405	113922	1037	1176	0	116540
13084	513	1010	801	114906	0	117230
13085	616	967	117064	1086	0	119733
13086	530	370	1108	116856	0	118864
13087	117612	340	1071	1238	0	120261
13088	1273	450	116453	1098	0	119274
13089	112480	350	1135	532	0	114497
13090	1403	338	1023	116977	0	119741
13091	1321	436	117859	1390	0	121006
13092	634	115716	1310	1500	0	119160
13093	704	1184	1046	114740	0	117674
13094	763	1138	117718	1403	0	121022
13095	583	116252	1376	1264	0	119475
13096	732	1359	1081	114959	0	118131
13097	115731	1133	571	1350	0	118785
13098	116549	566	524	1236	0	118875
13099	116823	527	503	659	0	118512
13100	2360	558	115953	664	0	119535
13101	1478	117291	1378	661	0	120808
13102	860	1303	1152	116067	0	119382
13103	750	1271	581	120214	0	122816
13104	122040	603	539	2162	0	125344
13105	1459	124185	593	1550	0	127787
13106	123945	1486	516	800	0	126747
13107	121641	1390	457	728	0	124216
13108	124143	679	466	753	0	126041
13109	2405	638	122151	752	0	125946
13110	120867	529	1427	696	0	123519
13111	1651	573	1177	121720	0	125121
13112	1404	546	447	120868	0	123265
13113	118538	467	366	2479	0	121850
13114	1554	496	312	115541	0	117903
13115	1284	115706	414	1778	0	119182
13116	680	1400	226	113792	0	116098
13117	110293	1197	245	1799	0	113534
13118	1489	516	110288	1611	0	113904
13119	1269	109065	1308	860	0	112502
13120	637	1239	1012	106698	0	109586
13121	105909	1078	344	1584	0	108915
13122	1398	448	105549	1534	0	108929
13123	1392	1734	1270	101709	0	106105
13124	939	359	103991	1570	0	106859
13125	843	407	100935	1463	0	103648
13126	843	266	97298	763	0	99170
13127	635	262	94639	687	0	96223
13128	641	353	89773	614	0	91381
13129	73106	1170	2742	483	0	77501
13130	704	75555	813	429	0	77501
13131	72074	478	323	235	0	73110
13132	71054	481	193	181	0	71909
13133	947	71877	208	232	0	73264
13134	558	72949	208	215	0	73930
13135	72628	864	214	232	0	73938
13136	72381	509	153	216	0	73259
13137	979	165	155	69086	0	70385
13138	608	72775	188	546	0	74117
13139	73051	497	156	577	0	74281
13140	560	73417	202	243	0	74422
13141	619	554	141	73086	0	74400
13142	73792	534	146	590	0	75062
13143	73322	146	147	625	0	74240
13144	1047	164	121	73088	0	74420
13145	695	125	145	73924	0	74889
13146	326	180	73554	958	0	75018
13147	300	153	538	71614	0	72605
13148	268	202	73860	667	0	74997
13149	299	135	580	70936	0	71950
13150	253	112	569	72335	0	73269
13151	72115	125	205	1070	0	73515
13152	71152	155	190	674	0	72171
13153	1092	205	71472	263	0	73032
13154	69296	139	597	230	0	70262
13155	718	120	575	70735	0	72148
13156	734	189	71288	622	0	72833
13157	389	129	609	70754	0	71881
13158	362	142	583	74881	0	75968
13159	320	147	75418	1132	0	77017
13160	298	113	681	75992	0	77084
13161	384	197	79971	764	0	81316
13162	284	213	748	82484	0	83729
13163	86767	151	756	927	0	88601
13164	973	90023	316	1173	0	92485
13165	89881	927	229	338	0	91375
13166	1066	93061	303	408	0	94838
13167	90318	1053	205	272	0	91848
13168	1123	91661	266	354	0	93404
13169	88524	1031	227	340	0	90122
13170	1094	90996	265	338	0	92693
13171	1046	1055	217	89991	0	92309
13172	517	969	90790	1057	0	93333
13173	468	322	90469	1010	0	92269
13174	424	272	1743	88601	0	91040
13175	87767	213	1071	1076	0	90127
13176	1141	89775	440	1191	0	92547
13177	1089	1068	240	88870	0	91267
13178	476	947	89746	1181	0	92350
13179	428	347	90562	1047	0	92384
13180	492	714	1825	80200	0	83231
13181	284	89521	1121	1126	0	92052
13182	87883	1055	372	996	0	90306
13183	1212	990	90542	417	0	93161
13184	1124	324	87934	417	0	89799
13185	313	87700	1902	392	0	90307
13186	84665	1243	1620	412	0	87940
13187	83917	842	390	278	0	85427
13188	1776	295	319	82854	0	85244
13189	84568	211	315	1060	0	86154
13190	82079	189	349	927	0	83544
13191	1666	83393	377	392	0	85828
13192	82815	916	366	285	0	84382
13193	1229	853	84424	250	0	86756
13194	953	280	1052	81739	0	84024
13195	410	232	900	82301	0	83843
13196	80494	219	389	1590	0	82692
13197	1022	81335	329	1145	0	83831
13198	79126	941	292	345	0	80704
13199	1095	82837	271	361	0	84564
13200	882	81094	263	383	0	82622
13201	620	1484	79874	267	0	82245
13202	534	913	78830	219	0	80496
13203	71047	611	1507	202	0	73367
13204	72765	294	744	241	0	74044
13205	1365	243	71478	188	0	73274
13206	693	69641	738	213	0	71285
13207	293	71289	584	181	0	72347
13208	69824	1129	257	142	0	71352
13209	69369	678	185	138	0	70370
13210	1164	274	159	69740	0	71337
13211	71152	190	208	719	0	72269
13212	807	218	214	70555	0	71794
13213	710	262	70742	775	0	72489
13214	365	240	69107	643	0	70355
13215	68187	186	1120	278	0	69771
13216	839	233	638	66460	0	68170
13217	658	75580	283	665	0	77186
13218	76374	705	243	565	0	77887
13219	75996	610	224	272	0	77102
13220	1223	306	77036	210	0	78775
13221	75808	208	793	231	0	77040
13222	79045	195	658	216	0	80114
13223	1269	207	309	77382	0	79167
13224	822	78910	285	753	0	80770
13225	426	82771	269	686	0	84152
13226	392	1253	238	81819	0	83702
13227	422	740	224	80473	0	81859
13228	412	297	177	81654	0	82540
13229	456	333	80658	1367	0	82814
13230	461	335	78584	764	0	80144
13231	456	272	1281	77418	0	79427
13232	459	318	79551	829	0	81157
13233	431	314	78591	736	0	80072
13234	383	300	1333	75202	0	77218
13235	566	292	81458	910	0	83226
13236	333	80623	976	901	0	82833
13237	83775	873	820	424	0	85892
13238	989	820	399	80795	0	83003
13239	822	83193	395	889	0	85299
13240	562	905	85396	771	0	87634
13241	360	773	996	83976	0	86105
13242	409	363	89270	964	0	91006
13243	387	251	1025	88190	0	89853
13244	380	236	903	91170	0	92689
13245	377	309	95212	1590	0	97488
13246	376	292	1069	90320	0	92057
13247	331	96297	1059	1055	0	98742
13248	412	1006	414	97254	0	99086
13249	444	948	97860	1129	0	100381
13250	420	315	1023	96410	0	98168
13251	94011	242	964	1130	0	96347
13252	1026	97438	470	1292	0	100226
13253	998	998	362	97682	0	100040
13254	593	914	100621	1066	0	103194
13255	362	99388	1092	1163	0	102005
13256	365	100392	984	540	0	102281
13257	610	1647	97472	382	0	100111
13258	402	992	947	91263	0	93604
13259	445	761	896	92618	0	94720
13260	481	256	93019	1469	0	95225
13261	245	89072	898	932	0	91147
13262	215	87266	730	412	0	88623
13263	78179	785	356	180	0	79500
13264	409	79355	206	217	0	80187
13265	77201	446	185	181	0	78013
13266	600	416	99	74928	0	76043
13267	78579	129	114	597	0	79419
13268	502	142	79582	448	0	80674
13269	76768	91	441	214	0	77514
13270	545	119	417	79834	0	80915
13271	441	82382	181	565	0	83569
13272	82632	465	119	503	0	83719
13273	522	820	128	81648	0	83118
13274	459	85701	153	527	0	86840
13275	153	90120	162	525	0	90960
13276	88909	746	197	234	0	90086
13277	90108	454	114	169	0	90845
13278	91069	144	91	162	0	91466
13279	846	147	70	88501	0	89564
13280	464	89089	143	496	0	90192
13281	140	91201	126	517	0	91984
13282	105	757	93	90823	0	91778
13283	90823	470	109	548	0	91950
13284	89169	134	107	528	0	89938
13285	90104	100	103	280	0	90587
13286	904	148	92609	137	0	93798
13287	569	194	92210	141	0	93114
13288	96087	102	806	214	0	97209
13289	491	104	506	97824	0	98925
13290	494	128	156	98790	0	99568
13291	188	105	118	98607	0	99018
13292	119	117	108	99458	0	99802
13293	177	225	97936	961	0	99299
13294	118	129	476	95947	0	96670
13295	202	210	97605	713	0	98730
13296	87592	88	586	694	0	88960
13297	445	99296	557	353	0	100651
13298	504	485	230	101631	0	102850
13299	172	484	151	101249	0	102056
13300	101053	200	168	1003	0	102424
13301	99943	149	143	654	0	100889
13302	100079	148	174	329	0	100730
13303	99581	165	166	289	0	100201
13304	1004	246	101575	222	0	103047
13305	704	214	100273	214	0	101405
13306	242	160	839	99739	0	100980
13307	102116	159	575	581	0	103431
13308	100274	141	239	666	0	101320
13309	934	261	101534	358	0	103087
13310	605	147	548	97949	0	99249
13311	100492	131	540	692	0	101855
13312	566	140	224	100464	0	101394
13313	606	227	103141	749	0	104723
13314	298	208	539	101617	0	102662
13315	104019	178	513	785	0	105495
13316	526	115939	267	744	0	117476
13317	114686	543	152	449	0	115830
13318	116549	520	149	394	0	117612
13319	116637	224	156	338	0	117355
13320	1071	207	134	116342	0	117754
13321	115005	166	130	646	0	115947
13322	583	122375	241	669	0	123868
13323	552	125883	212	377	0	127024
13324	382	1402	154	123331	0	125269
13325	124970	709	120	868	0	126667
13326	852	132666	191	818	0	134527
13327	154284	947	133	357	0	155721
13328	160009	883	139	372	0	161403
13329	2476	175548	184	402	0	178610
13330	1460	1812	129	177419	0	180820
13331	534	1297	131	181328	0	183290
13332	536	437	185239	2992	0	189204
13333	558	291	1851	179410	0	182110
13334	601	375	186049	2302	0	189327
13335	364	182020	2132	1787	0	186303
13336	441	1975	1347	183835	0	187598
13337	178213	1283	427	2271	0	182194
13338	179430	356	329	1728	0	181843
13339	3113	354	329	181811	0	185607
13340	1589	400	180685	2262	0	184936
13341	157445	304	2070	1844	0	161663
13342	1953	176647	1463	972	0	181035
13343	1398	176094	506	727	0	178725
13344	688	177880	371	678	0	179617
13345	837	3438	447	169552	0	174274
13346	635	1566	177052	2005	0	181258
13347	499	542	1889	172732	0	175662
13348	482	534	179766	2067	0	182849
13349	462	545	177898	1432	0	180337
13350	533	552	183161	610	0	184856
13351	487	407	3114	168275	0	172283
13352	361	360	1516	181701	0	183938
13353	300	352	643	185154	0	186449
13354	273	403	553	183265	0	184494
13355	182655	216	599	3276	0	186746
13356	1804	182890	688	1956	0	187338
13357	181360	1819	512	866	0	184557
13358	1878	187529	538	959	0	190904
13359	1358	1945	397	186202	0	189902
13360	571	1268	344	194305	0	196488
13361	193832	455	334	3378	0	197999
13362	195682	391	306	1903	0	198282
13363	197695	480	356	893	0	199424
13364	198322	471	278	795	0	199866
13365	197732	416	199	737	0	199084
13366	3225	199131	253	794	0	203403
13367	194523	1953	205	684	0	197365
13368	2323	196280	337	698	0	199638
13369	193398	1963	291	503	0	196155
13370	2620	1381	195644	530	0	200175
13371	1868	655	1723	186758	0	191004
13372	936	199687	1233	1889	0	203745
13373	840	1996	349	199210	0	202395
13374	1019	1540	199265	2128	0	203952
13375	832	643	1854	191123	0	194452
13376	188504	489	1283	2350	0	192626
13377	1960	195073	613	2288	0	199934
13378	1433	197844	531	1318	0	201126
13379	1040	3114	201216	1024	0	206394
13380	711	1734	2088	191101	0	195634
13381	560	208575	1563	2438	0	213136
13382	733	2166	675	210883	0	214457
13383	726	1727	213931	2506	0	218890
13384	574	211226	2223	2586	0	216609
13385	823	2410	210664	1046	0	214943
13386	1009	1899	208512	906	0	212326
13387	650	917	3046	202797	0	207410
13388	210656	715	1742	2475	0	215588
13389	2204	760	850	211801	0	215615
13390	1775	1015	216488	2545	0	221823
13391	765	902	2517	214889	0	219073
13392	660	1047	232406	2738	0	236851
13393	759	974	232520	2101	0	236354
13394	225389	713	4070	1553	0	231725
13395	244818	597	2094	1443	0	248952
13396	244930	534	1355	1385	0	248204
13397	3599	687	247175	1317	0	252778
13398	1980	634	249255	1235	0	253104
13399	979	572	3957	239440	0	244948
13400	933	565	2260	249060	0	252818
13401	247887	548	1091	4065	0	253591
13402	2738	476	985	249117	0	253316
13403	2198	693	254641	3077	0	260609
13404	1202	752	250719	2392	0	255065
13405	1000	255954	3838	1491	0	262283
13406	1086	2486	2010	256665	0	262247
13407	1396	1934	264489	2806	0	270625
13408	1032	764	2746	253785	0	258327
13409	259407	572	2078	3248	0	265305
13410	2924	829	271518	2392	0	277663
13411	2221	562	2798	267441	0	273022
13412	1273	595	2083	273547	0	277498
13413	1284	849	272305	4111	0	278549
13414	1264	630	2828	261754	0	266476
13415	1200	868	271952	3272	0	277292
13416	242681	603	2920	2544	0	248748
13417	2898	629	1998	252734	0	258259
13418	2068	259302	1210	3049	0	265629
13419	257484	2429	834	2290	0	263037
13420	252384	1790	861	1369	0	256404
13421	3824	259016	1005	1639	0	265484
13422	3271	11730	1051	230220	0	246272
13423	1124	247637	748	2355	0	251864
13424	1095	248320	687	1935	0	252037
13425	2743	3545	236637	952	0	243877
13426	1112	234603	2395	1309	0	239419
13427	1395	2054	205334	980	0	209763
13428	158811	1496	1428	521	0	162256
13429	167794	268	597	253	0	168912
13430	906	190160	263	443	0	191772
13431	577	191642	248	290	0	192757
13432	190	200345	232	272	0	201039
13433	202151	1044	221	195	0	203611
13434	960	880	154	205937	0	207931
13435	837	280	221906	862	0	223885
13436	167	223830	972	1170	0	226139
13437	222	924	816	226206	0	228168
13438	318	1009	222	210493	0	212042
13439	121	247838	263	1881	0	250103
13440	255289	1235	211	958	0	257693
13441	1593	1235	261758	332	0	264918
13442	1540	417	1511	267443	0	270911
13443	210	310282	1391	2336	0	314219
13444	303229	2668	336	1515	0	307748
13445	3038	1806	307501	492	0	312837
13446	1681	301542	2888	757	0	306868
13447	462	2750	1681	300985	0	305878
13448	557	1835	302338	2823	0	307553
13449	278509	370	2949	1780	0	283608
13450	2820	268	1774	295149	0	300011
13451	2048	559	298951	2929	0	304487
13452	356	296693	3011	2725	0	302785
13453	288068	2750	1791	518	0	293127
13454	2528	298589	763	768	0	302648
13455	296861	2894	332	437	0	300524
13456	296802	1845	323	473	0	299443
13457	4415	452	351	285659	0	290877
13458	1961	284841	627	3129	0	290558
13459	834	2893	284926	1969	0	290622
13460	551	1794	2947	281000	0	286292
13461	637	790	2087	257164	0	260678
13462	586	355	472	283729	0	285142
13463	600	393	395	283395	0	284783
13464	600	387	468	282600	0	284055
13465	277775	402	442	4728	0	283347
13466	274780	425	483	2419	0	278107
13467	267735	454	482	868	0	269539
13468	4231	268191	687	1288	0	274397
13469	2248	2861	272887	681	0	278677
13470	764	1990	275240	640	0	278634
13471	784	786	277696	571	0	279837
13472	691	590	4749	257707	0	263737
13473	654	516	2171	269605	0	272946
13474	599	454	594	270750	0	272397
13475	703	581	268434	4895	0	274613
13476	524	261368	3300	3420	0	268612
13477	690	3073	266179	984	0	270926
13478	869	2176	266596	799	0	270440
13479	681	640	4641	253728	0	259690
13480	873	673	262842	3213	0	267601
13481	648	607	3293	250093	0	254641
13482	252440	552	2327	3344	0	258663
13483	248105	577	890	2238	0	251810
13484	4878	732	248937	839	0	255386
13485	2462	679	3351	238102	0	244594
13486	1109	788	249057	3382	0	254336
13487	660	246604	3599	2913	0	253776
13488	241516	3266	2476	910	0	248168
13489	3607	2409	245690	951	0	252657
13490	2271	238938	3564	1112	0	245885
13491	790	236579	2448	1033	0	240850
13492	800	228848	1062	1131	0	231841
13493	1171	4886	215865	960	0	222882
13494	1109	3225	3464	196992	0	204790
13495	755	209852	2334	3063	0	216004
13496	971	3175	953	206327	0	211426
13497	1003	2186	837	206837	0	210863
13498	198974	791	812	4792	0	205369
13499	3030	201266	952	2935	0	208183
13500	195435	3163	783	1058	0	200439
13501	3127	197719	849	1315	0	203010
13502	2111	198866	956	1236	0	203169
13503	1487	4532	192594	1100	0	199713
13504	943	2459	3181	188660	0	195243
13505	896	1052	190784	3464	0	196196
13506	753	184762	3344	3681	0	192540
13507	977	3072	185161	1354	0	190564
13508	1145	2150	184535	1291	0	189121
13509	741	182722	4602	1307	0	189372
13510	171832	2951	2322	1205	0	178310
13511	2865	175926	1219	1399	0	181409
13512	174469	3168	1317	1150	0	180104
13513	3282	2150	174160	1158	0	180750
13514	2240	901	174944	1153	0	179238
13515	781	172266	4690	1161	0	178898
13516	167318	3022	2491	1027	0	173858
13517	2858	170952	1374	1249	0	176433
13518	2002	3018	1319	168562	0	174901
13519	169242	2052	1282	3168	0	175744
13520	2994	1045	170160	2392	0	176591
13521	2023	823	3495	169002	0	175343
13522	167111	882	2329	3241	0	173563
13523	3050	167533	1283	2579	0	174445
13524	2154	3102	1039	166107	0	172402
13525	1009	2120	166595	3255	0	172979
13526	162571	805	3458	2210	0	169044
13527	3033	760	2413	163815	0	170021
13528	1900	861	159900	3249	0	165910
13529	922	723	3256	151471	0	156372
13530	656	157238	2384	3417	0	163695
13531	957	2951	156590	2317	0	162815
13532	968	1807	3021	143713	0	149509
13533	136311	724	1946	2794	0	141775
13534	2959	703	906	130379	0	134947
13535	117240	638	813	2465	0	121156
13536	2468	116643	798	1598	0	121507
13537	111995	2425	1116	581	0	116117
13538	2395	1587	109772	602	0	114356
13539	1409	659	91463	435	0	93966
13540	544	549	77923	408	0	79424
13541	506	71048	3644	525	0	75723
13542	2098	483	5582	22528	0	30691
13543	240	218	331	22344	0	23133
13544	75	115	116	22351	0	22657
13545	83	67	85	22564	0	22799
13546	59	88	22256	380	0	22783
13547	20030	90	260	229	0	20609
13548	209	22021	205	114	0	22549
13549	21096	230	103	73	0	21502
13550	232	190	92	20595	0	21109
13551	178	21453	83	226	0	21940
13552	95	287	96	21446	0	21924
13553	21106	211	68	251	0	21636
13554	204	21898	92	191	0	22385
13555	21340	231	96	84	0	21751
13556	20947	185	75	76	0	21283
13557	322	109	72	21021	0	21524
13558	197	77	21138	213	0	21625
13559	20163	101	299	184	0	20747
13560	198	86	176	21611	0	22071
13561	21817	72	78	229	0	22196
13562	22431	72	82	195	0	22780
13563	22461	62	77	111	0	22711
13564	371	86	22572	75	0	23104
13565	231	69	217	21548	0	22065
13566	21816	67	185	252	0	22320
13567	230	74	22660	224	0	23188
13568	195	22345	215	104	0	22859
13569	127	247	230	21180	0	21784
13570	73	188	21726	192	0	22179
13571	83	82	21514	172	0	21851
13572	93	215	322	20728	0	21358
13573	125	47	238	21159	0	21569
13574	70	49	91	21387	0	21597
13575	79	61	66	21342	0	21548
13576	81	68	21179	337	0	21665
13577	72	21399	215	217	0	21903
13578	84	176	180	21477	0	21917
13579	21428	166	91	220	0	21905
13580	21067	59	63	199	0	21388
13581	21310	45	54	117	0	21526
13582	328	44	76	21019	0	21467
13583	213	129	51	20350	0	20743
13584	83	19651	64	313	0	20111
13585	82	19903	74	186	0	20245
13586	223	369	67	18536	0	19195
13587	18072	210	99	261	0	18642
13588	17811	35	40	163	0	18049
13589	17679	29	41	77	0	17826
13590	17724	33	40	59	0	17856
13591	17702	31	34	77	0	17844
13592	224	17793	54	76	0	18147
13593	149	106	40	17877	0	18172
13594	18367	102	40	166	0	18675
13595	18600	34	36	155	0	18825
13596	215	27	29	18548	0	18819
13597	152	23	34	18826	0	19035
13598	65	56	19164	230	0	19515
13599	57	22	113	18733	0	18925
13600	65	38	113	19211	0	19427
13601	79	36	19898	228	0	20241
13602	74	68	114	19262	0	19518
13603	67	20377	108	164	0	20716
13604	77	111	20260	142	0	20590
13605	53	20393	119	78	0	20643
13606	56	139	100	19566	0	19861
13607	54	120	37	19144	0	19355
13608	40	19677	38	187	0	19942
13609	42	19979	33	139	0	20193
13610	20128	162	43	76	0	20409
13611	20034	109	26	60	0	20229
13612	207	42	19970	57	0	20276
13613	20255	20	89	91	0	20455
13614	21453	23	92	90	0	21658
13615	21580	27	35	70	0	21712
13616	21396	22	117	66	0	21601
13617	226	46	21056	67	0	21395
13618	149	44	20338	52	0	20583
13619	20949	28	171	61	0	21209
13620	119	21986	103	90	0	22298
13621	101	72	21399	32	0	21604
13622	21185	60	79	44	0	21368
13623	21614	19	70	41	0	21744
13624	137	35	21798	34	0	22004
13625	21206	33	94	45	0	21378
13626	104	29	83	23935	0	24151
13627	95	41	25343	120	0	25599
13628	23067	26	113	135	0	23341
13629	91	25851	102	97	0	26141
13630	26404	80	37	103	0	26624
13631	29881	79	56	161	0	30177
13632	163	20	43	29987	0	30213
13633	107	18	43	30376	0	30544
13634	54	25	36	30920	0	31035
13635	30905	17	28	215	0	31165
13636	32514	17	24	174	0	32729
13637	241	22	21	32765	0	33049
13638	148	26	27	32804	0	33005
13639	86	60	32520	243	0	32909
13640	30568	30	130	190	0	30918
13641	159	42	99	33532	0	33832
13642	157	41	36	33401	0	33635
13643	74	33516	39	320	0	33949
13644	77	147	21	33637	0	33882
13645	84	126	15	33683	0	33908
13646	32676	45	24	282	0	33027
13647	202	34321	35	193	0	34751
13648	197	139	13	35001	0	35350
13649	123	132	14	35016	0	35285
13650	108	29	21	35688	0	35846
13651	109	50	35401	317	0	35877
13652	93	41	143	35008	0	35285
13653	34634	26	136	253	0	35049
13654	224	70	35621	206	0	36121
13655	168	30	168	36127	0	36493
13656	86	13	142	37159	0	37400
13657	37479	19	39	401	0	37938
13658	36790	24	57	238	0	37109
13659	331	53	37624	98	0	38106
13660	34450	41	175	146	0	34812
13661	216	63	37892	104	0	38275
13662	36367	38	174	105	0	36684
13663	187	42049	174	123	0	42533
13664	42888	174	38	100	0	43200
13665	222	43951	52	121	0	44346
13666	44900	224	70	123	0	45317
13667	223	47427	49	103	0	47802
13668	189	224	47	48209	0	48669
13669	73	155	36	48397	0	48661
13670	58	41	30	48306	0	48435
13671	44	48366	67	435	0	48912
13672	64	222	25	48173	0	48484
13673	39	49212	60	280	0	49591
13674	55	229	32	49236	0	49552
13675	49492	165	29	297	0	49983
13676	48384	52	37	219	0	48692
13677	393	49208	57	174	0	49832
13678	223	232	28	49365	0	49848
13679	48759	198	35	286	0	49278
13680	254	50848	47	290	0	51439
13681	212	51408	57	151	0	51828
13682	51531	406	28	99	0	52064
13683	51551	228	34	90	0	51903
13684	436	51905	52	117	0	52510
13685	52198	270	29	112	0	52609
13686	327	242	19	52503	0	53091
13687	305	124	56701	294	0	57424
13688	56286	62	328	300	0	56976
13689	57553	65	257	178	0	58053
13690	631	109	59025	101	0	59866
13691	59063	54	334	181	0	59632
13692	61592	57	285	180	0	62114
13693	63863	60	50	179	0	64152
13694	669	64267	88	160	0	65184
13695	65206	391	41	161	0	65799
13696	65372	383	35	140	0	65930
13697	779	114	30	65391	0	66314
13698	484	87	49	66696	0	67316
13699	184	85	36	67657	0	67962
13700	67535	98	45	814	0	68492
13701	478	80	40	67299	0	67897
13702	68149	77	37	576	0	68839
13703	68753	105	39	546	0	69443
13704	860	124	41	68918	0	69943
13705	549	99	40	71374	0	72062
13706	254	93	49	72072	0	72468
13707	71903	101	58	910	0	72972
13708	557	72814	86	593	0	74050
13709	562	484	48	73806	0	74900
13710	232	463	61	75013	0	75769
13711	74402	147	61	1019	0	75629
13712	74571	106	61	665	0	75403
13713	1036	155	74120	244	0	75555
13714	713	172	74112	213	0	75210
13715	76235	109	901	231	0	77476
13716	754	98	531	79078	0	80461
13717	707	129	121	87448	0	88405
13718	359	195	89031	1436	0	91021
13719	314	219	849	84120	0	85502
13720	235	89474	673	978	0	91360
13721	231	91347	187	858	0	92623
13722	88638	1397	102	332	0	90469
13723	1105	819	88975	300	0	91199
13724	816	91208	831	435	0	93290
13725	406	929	651	91473	0	93459
13726	438	757	91473	1002	0	93670
13727	311	218	862	88839	0	90230
13728	297	161	690	90320	0	91468
13729	362	194	90664	1629	0	92849
13730	280	90613	987	1049	0	92929
13731	311	926	724	87161	0	89122
13732	87907	688	230	1036	0	89861
13733	87865	215	189	868	0	89137
13734	87944	176	148	388	0	88656
13735	1626	87790	256	403	0	90075
13736	86056	878	178	373	0	87485
13737	1108	833	171	86376	0	88488
13738	884	306	86509	1071	0	88770
13739	82353	194	879	948	0	84374
13740	973	86677	785	486	0	88921
13741	853	867	256	85796	0	87772
13742	388	738	194	84885	0	86205
13743	301	86070	297	1631	0	88299
13744	378	1035	221	86986	0	88620
13745	390	760	207	87623	0	88980
13746	438	326	250	88867	0	89881
13747	86514	317	281	1751	0	88863
13748	85418	255	248	1171	0	87092
13749	1617	365	86412	608	0	89002
13750	1035	408	987	85172	0	87602
13751	545	280	782	87433	0	89040
13752	405	347	472	88184	0	89408
13753	86489	422	317	1857	0	89085
13754	1192	360	85372	1225	0	88149
13755	83076	305	1134	629	0	85144
13756	85944	349	788	631	0	87712
13757	1741	252	329	85064	0	87386
13758	85571	264	417	1311	0	87563
13759	1364	405	85187	1150	0	88106
13760	80905	242	1036	854	0	83037
13761	1336	91012	916	919	0	94183
13762	1199	1073	90225	621	0	93118
13763	710	945	90202	698	0	92555
13764	662	703	1681	87433	0	90479
13765	742	380	90188	1402	0	92712
13766	84426	374	1129	1305	0	87234
13767	1217	86691	949	841	0	89698
13768	87305	1021	367	773	0	89466
13769	1278	911	300	88276	0	90765
13770	1204	351	88545	1479	0	91579
13771	693	328	88914	1381	0	91316
13772	568	507	1646	88297	0	91018
13773	89434	259	985	1593	0	92271
13774	1140	89231	446	1602	0	92419
13775	1037	92596	447	1048	0	95128
13776	91520	1514	422	862	0	94318
13777	1323	93620	443	934	0	96320
13778	93897	1078	464	768	0	96207
13779	1570	895	398	92869	0	95732
13780	92696	306	446	1419	0	94867
13781	1476	306	472	92931	0	95185
13782	93723	249	486	1428	0	95886
13783	1365	289	560	91957	0	94171
13784	1193	92406	568	1458	0	95625
13785	91869	958	489	1188	0	94504
13786	1224	92576	533	1024	0	95357
13787	1238	1052	86647	599	0	89536
13788	711	812	1206	81902	0	84631
13789	631	88960	922	1104	0	91617
13790	86770	1021	411	898	0	89100
13791	84482	819	531	554	0	86386
13792	1682	85012	539	621	0	87854
13793	981	1020	83524	655	0	86180
13794	676	721	1165	79661	0	82223
13795	590	83583	933	1129	0	86235
13796	522	977	494	83855	0	85848
13797	700	756	524	84374	0	86354
13798	83438	434	318	1619	0	85809
13799	1234	83551	462	1008	0	86255
13800	1018	976	410	84010	0	86414
13801	84509	803	316	1222	0	86850
13802	84017	420	335	877	0	85649
13803	83449	487	364	648	0	84948
13804	1829	428	349	82872	0	85478
13805	81450	387	310	1156	0	83303
13806	1151	82028	409	946	0	84534
13807	80973	877	299	607	0	82756
13808	1124	83962	321	630	0	86037
13809	83298	973	400	493	0	85164
13810	82662	662	269	623	0	84216
13811	1563	709	321	81965	0	84558
13812	1035	425	87179	1014	0	89653
13813	733	442	86134	861	0	88170
13814	687	87420	1136	576	0	89819
13815	84066	950	852	471	0	86339
13816	1054	684	83688	308	0	85734
13817	65039	188	396	223	0	65846
13818	361	71398	291	237	0	72287
13819	451	76194	149	196	0	76990
13820	255	639	108	76605	0	77607
13821	196	80720	136	438	0	81490
13822	256	521	81108	402	0	82287
13823	294	491	414	77547	0	78746
13824	205	84469	446	507	0	85627
13825	174	574	104	85047	0	85899
13826	85256	467	88	612	0	86423
13827	547	213	96	86223	0	87079
13828	572	217	87472	647	0	88908
13829	204	90415	584	609	0	91812
13830	177	750	499	89770	0	91196
13831	215	569	162	90649	0	91595
13832	195	205	137	92073	0	92610
13833	89748	210	131	1065	0	91154
13834	88790	175	156	701	0	89822
13835	1114	232	92538	245	0	94129
13836	701	325	91995	203	0	93224
13837	221	93796	1059	316	0	95392
13838	95096	643	546	331	0	96616
13839	731	553	167	95719	0	97170
13840	625	227	116	96466	0	97434
13841	298	172	107	96831	0	97408
13842	316	167	64	97304	0	97851
13843	365	270	94723	1183	0	96541
13844	88833	162	642	786	0	90423
13845	822	180	516	104794	0	106312
13846	790	269	104495	1036	0	106590
13847	102464	189	993	888	0	104534
13848	113022	160	759	428	0	114369
13849	2134	295	126054	264	0	128747
13850	1351	255	129923	209	0	131738
13851	475	178	2215	126880	0	129748
13852	130391	184	1199	1495	0	133269
13853	131275	161	376	1170	0	132982
13854	2366	207	288	127603	0	130464
13855	1321	160	259	131394	0	133134
13856	512	293	131341	2312	0	134458
13857	367	283	1494	128444	0	130588
13858	536	265	131414	1733	0	133948
13859	120849	193	1605	1307	0	123954
13860	1438	131100	1296	666	0	134500
13861	125250	1280	325	399	0	127254
13862	1421	125566	349	487	0	127823
13863	124704	1446	425	309	0	126884
13864	1664	1000	182	121310	0	124156
13865	1337	289	154	121861	0	123641
13866	123754	151	153	2304	0	126362
13867	123680	152	177	1287	0	125296
13868	124806	142	166	537	0	125651
13869	125152	115	244	393	0	125904
13870	2731	230	122886	343	0	126190
13871	121826	117	1452	390	0	123785
13872	124059	93	1109	353	0	125614
13873	123535	142	347	327	0	124351
13874	2830	110	227	121169	0	124336
13875	116710	144	252	1714	0	118820
13876	1704	118485	345	1296	0	121830
13877	1394	1352	246	118554	0	121546
13878	695	1042	228	120132	0	122097
13879	580	379	118003	2657	0	121619
13880	601	185	1499	111183	0	113468
13881	462	117647	1265	1864	0	121238
13882	114956	1463	389	1416	0	118224
13883	1668	117558	490	690	0	120406
13884	117094	1598	324	576	0	119592
13885	2044	1263	313	116552	0	120172
13886	115034	340	287	1750	0	117411
13887	1830	114333	375	1549	0	118087
13888	115334	1490	266	644	0	117734
13889	114765	1169	308	547	0	116789
13890	2855	335	358	112823	0	116371
13891	1732	200	336	115172	0	117440
13892	896	322	113155	2824	0	117197
13893	793	259	1579	112086	0	114717
13894	791	270	1169	113410	0	115640
13895	780	308	111637	2805	0	115530
13896	718	211	1662	111710	0	114301
13897	670	266	111869	2136	0	114941
13898	107478	239	1810	1692	0	111219
13899	2095	219	1329	109561	0	113204
13900	1755	357	108444	1912	0	112468
13901	105542	265	1651	1565	0	109023
13902	2148	234	1275	108415	0	112072
13903	1718	332	108726	2002	0	112778
13904	105224	243	1681	1643	0	108791
13905	2188	222	1328	108113	0	111851
13906	1794	222	497	108594	0	111107
13907	107789	212	401	2948	0	111350
13908	2210	231	435	105736	0	108612
13909	1815	228	369	106288	0	108700
13910	1042	264	384	101033	0	102723
13911	860	102403	546	2980	0	106789
13912	98123	1439	434	1769	0	101765
13913	98106	1105	413	892	0	100516
13914	3089	369	389	95785	0	99632
13915	97001	262	408	2092	0	99763
13916	96477	249	446	1763	0	98935
13917	97317	272	402	932	0	98923
13918	90758	252	508	878	0	92396
13919	92277	249	536	923	0	93985
13920	3087	287	86176	850	0	90400
13921	1856	305	83086	830	0	86077
13922	80112	297	2281	696	0	83386
13923	1981	80847	1303	893	0	85024
13924	1587	1359	578	77810	0	81334
13925	994	1002	77898	1703	0	81597
13926	958	454	77611	1428	0	80451
13927	961	1085	2135	75192	0	79373
13928	74675	565	1769	1828	0	78837
13929	1872	299	372	74318	0	76861
13930	1503	330	73962	1735	0	77530
13931	75348	194	1291	1435	0	78268
13932	1847	200	1063	76279	0	79389
13933	1598	149	474	77010	0	79231
13934	1015	165	339	78197	0	79716
13935	937	141	330	75937	0	77345
13936	919	232	73717	2489	0	77357
13937	997	124	1301	73541	0	75963
13938	72674	157	1142	1754	0	75727
13939	1751	225	71644	1429	0	75049
13940	71447	179	1338	853	0	73817
13941	72914	202	1006	711	0	74833
13942	72856	204	451	753	0	74264
13943	71057	186	405	818	0	72466
13944	2296	70085	406	882	0	73669
13945	1059	60161	272	508	0	62000
13946	607	61321	307	549	0	62784
13947	54656	1815	1664	901	0	59036
13948	1084	640	50213	539	0	52476
13949	33507	490	1037	191	0	35225
13950	762	82	351	31350	0	32545
13951	31382	36	68	375	0	31861
13952	365	22	65	31431	0	31883
13953	31327	29	72	390	0	31818
13954	368	24	68	31359	0	31819
13955	327	35	58	31942	0	32362
13956	27104	44	71	667	0	27886
13957	356	34508	85	380	0	35329
13958	319	285	34092	143	0	34839
13959	152	33965	325	158	0	34600
13960	154	214	31808	115	0	32291
13961	184	518	346	29180	0	30228
13962	30001	43	371	247	0	30662
13963	229	71	51	29465	0	29816
13964	28972	35	46	231	0	29284
13965	243	31865	46	301	0	32455
13966	336	178	32639	99	0	33252
13967	92	32951	189	106	0	33338
13968	80	32883	169	107	0	33239
13969	30451	185	143	73	0	30852
13970	29350	106	75	75	0	29606
13971	203	30542	66	111	0	30922
13972	130	105	30	30760	0	31025
13973	71	94	41	30907	0	31113
13974	31002	30	34	242	0	31308
13975	171	38	31382	138	0	31729
13976	128	51	31343	76	0	31598
13977	81	25	222	31247	0	31575
13978	83	56	32449	188	0	32776
13979	30402	35	153	167	0	30757
13980	32155	26	132	83	0	32396
13981	266	32792	56	114	0	33228
13982	190	170	33887	81	0	34328
13983	114	139	159	33336	0	33748
13984	98	70	36406	201	0	36775
13985	77	47	193	35931	0	36248
13986	36038	25	169	224	0	36456
13987	198	38141	73	335	0	38747
13988	218	189	40584	91	0	41082
13989	97	41814	208	96	0	42215
13990	95	43323	199	131	0	43748
13991	43365	298	71	132	0	43866
13992	42389	164	66	141	0	42760
13993	371	86	43909	128	0	44494
13994	213	46029	231	184	0	46657
13995	138	211	192	46239	0	46780
13996	124	172	84	46398	0	46778
13997	127	60	99	46467	0	46753
13998	153	91	47475	430	0	48149
13999	148	53	212	46726	0	47139
14000	115	57	181	48816	0	49169
14001	50092	49	96	434	0	50671
14002	50248	74	70	298	0	50690
14003	51425	73	83	198	0	51779
14004	51014	82	69	134	0	51299
14005	50860	73	75	137	0	51145
14006	416	50834	148	148	0	51546
14007	50207	221	53	107	0	50588
14008	349	226	50684	106	0	51365
14009	253	153	208	50221	0	50835
14010	51325	93	173	264	0	51855
14011	252	52648	98	239	0	53237
14012	53302	238	116	134	0	53790
14013	55491	189	62	199	0	55941
14014	406	87	61	56894	0	57448
14015	240	92	84	57251	0	57667
14016	129	64736	95	420	0	65380
14017	146	233	60	66024	0	66463
14018	149	284	69348	312	0	70093
14019	152	81	257	69947	0	70437
14020	141	130	71376	387	0	72034
14021	63208	68	363	399	0	64038
14022	327	64	233	72353	0	72977
14023	355	136	74527	373	0	75391
14024	129	73746	357	362	0	74594
14025	108	74262	288	194	0	74852
14026	72876	459	241	120	0	73696
14027	409	261	106	72534	0	73310
14028	267	156	78422	369	0	79214
14029	96	79201	317	402	0	80016
14030	133	385	79907	120	0	80545
14031	76411	218	287	179	0	77095
14032	78480	60	201	134	0	78875
14033	79326	60	80	147	0	79613
14034	454	61	71	79779	0	80365
14035	277	146	80510	371	0	81304
14036	91	81422	333	309	0	82155
14037	124	267	185	82566	0	83142
14038	137	263	81341	317	0	82058
14039	150	145	79706	277	0	80278
14040	95	49	438	81315	0	81897
14041	82910	49	249	363	0	83571
14042	265	79	105	82907	0	83356
14043	232	47	93	84743	0	85115
14044	124	160	86986	516	0	87786
14045	137	56	316	85559	0	86068
14046	126	57	236	87401	0	87820
14047	177	158	89588	499	0	90422
14048	170	122	88936	303	0	89531
14049	108	97	465	88178	0	88848
14050	195	152	91451	367	0	92165
14051	98	89	347	90437	0	90971
14052	91224	53	285	445	0	92007
14053	289	96492	198	547	0	97526
14054	283	341	120	97585	0	98329
14055	188	281	97085	381	0	97935
14056	78455	118	416	634	0	79623
14057	331	94067	331	279	0	95008
14058	95073	300	117	284	0	95774
14059	381	240	86	95104	0	95811
14060	277	94	125	95306	0	95802
14061	97546	63	181	652	0	98442
14062	397	141	98817	332	0	99687
14063	94972	85	367	209	0	95633
14064	396	141	264	99358	0	100159
14065	98104	56	144	498	0	98802
14066	98367	89	168	403	0	99027
14067	602	86	118	97792	0	98598
14068	336	102194	189	522	0	103241
14069	104113	382	150	421	0	105066
14070	103804	282	133	297	0	104516
14071	829	204	105838	168	0	107039
14072	101494	114	521	223	0	102352
14073	613	119	357	104981	0	106070
14074	449	108001	196	581	0	109227
14075	289	495	150	104060	0	104994
14076	188	108009	216	589	0	109002
14077	107182	488	150	438	0	108258
14078	109333	315	156	224	0	110028
14079	877	244	120	119938	0	121179
14080	531	193	121400	837	0	122961
14081	320	228	120923	605	0	122076
14082	214	104	1204	123799	0	125321
14083	124888	87	627	959	0	126561
14084	128503	98	229	709	0	129539
14085	1366	132953	251	457	0	135027
14086	764	932	184	132769	0	134649
14087	365	698	136024	1133	0	138220
14088	315	264	140581	879	0	142039
14089	307	396	1829	147598	0	150130
14090	160832	131	1070	1558	0	163591
14091	1678	136	269	163862	0	165945
14092	1165	181	163648	1836	0	166830
14093	159823	103	1767	1249	0	162942
14094	1696	101	1130	161779	0	164706
14095	1194	77	325	164413	0	166009
14096	424	189	235	158659	0	159507
14097	241	161208	401	2759	0	164609
14098	382	1589	163263	1243	0	166477
14099	355	1114	165100	535	0	167104
14100	298	250	2666	162392	0	165606
14101	382	273	165691	1924	0	168270
14102	158304	155	1955	1298	0	161712
14103	1823	157	1237	161598	0	164815
14104	1297	136	406	161209	0	163048
14105	434	180	332	159504	0	160450
14106	283	163142	483	2938	0	166846
14107	163871	1678	304	1441	0	167294
14108	1967	1087	270	162977	0	166301
14109	161654	258	359	2087	0	164358
14110	1907	163083	365	1584	0	166939
14111	161528	1800	271	650	0	164249
14112	157806	1115	340	598	0	159859
14113	156324	282	337	620	0	157563
14114	2990	155927	478	711	0	160106
14115	1517	157540	461	645	0	160163
14116	145737	2627	298	592	0	149254
14117	1913	149871	389	691	0	152864
14118	1474	1936	145553	561	0	149524
14119	518	142823	1819	717	0	145877
14120	426	144350	1297	792	0	146865
14121	142616	2528	537	459	0	146140
14122	1948	1328	142135	446	0	145857
14123	1400	504	141113	439	0	143456
14124	663	390	2757	135513	0	139323
14125	106218	315	34738	2002	0	143273
14126	1696	343	140926	1437	0	144402
14127	1184	310	2179	136589	0	140262
14128	591	375	136262	2028	0	139256
14129	559	363	133144	1486	0	135552
14130	125987	324	2807	696	0	129814
14131	2074	457	132798	533	0	135862
14132	1469	371	2028	127410	0	131278
14133	767	408	1373	127249	0	129797
14134	575	130284	737	2802	0	134398
14135	572	132762	685	1661	0	135680
14136	639	2676	631	129548	0	133494
14137	648	1431	130416	2184	0	134679
14138	642	539	1995	128893	0	132069
14139	645	430	1448	131113	0	133636
14140	539	559	132298	3116	0	136512
14141	576	411	2090	132007	0	135084
14142	132824	408	1540	2421	0	137193
14143	2063	570	132528	1692	0	136853
14144	128791	408	2199	942	0	132340
14145	2261	417	1671	128681	0	133030
14146	1659	365	850	129732	0	132606
14147	800	131456	912	3250	0	136418
14148	794	1971	791	132209	0	135765
14149	741	1386	752	135198	0	138077
14150	133870	534	777	3435	0	138616
14151	2255	505	771	134330	0	137861
14152	1682	531	710	135530	0	138453
14153	129127	533	788	3594	0	134042
14154	2266	564	821	130560	0	134211
14155	1735	574	847	122917	0	126073
14156	833	129202	924	3443	0	134402
14157	128482	1992	867	2111	0	133452
14158	2386	1418	760	129561	0	134125
14159	1794	657	618	131724	0	134793
14160	997	599	129556	3706	0	134858
14161	849	532	2227	127016	0	130624
14162	782	539	1616	128992	0	131929
14163	125122	587	766	3652	0	130127
14164	125802	598	733	2168	0	129301
14165	3349	592	728	125061	0	129730
14166	1766	658	124083	2719	0	129226
14167	937	120862	2266	1983	0	126048
14168	876	122448	1678	1160	0	126162
14169	1217	3061	976	119334	0	124588
14170	119171	1420	829	2521	0	123941
14171	2208	679	590	119929	0	123406
14172	120580	658	477	2554	0	124269
14173	2249	612	491	122079	0	125431
14174	1665	551	599	121935	0	124750
14175	119049	577	579	3218	0	123423
14176	116848	672	573	1879	0	119972
14177	3083	120553	681	1135	0	125452
14178	1705	122687	636	948	0	125976
14179	699	2299	451	106932	0	110381
14180	666	1213	517	108531	0	110927
14181	730	500	106960	2480	0	110670
14182	93271	377	1604	1615	0	96867
14183	1468	102595	1203	1017	0	106283
14184	873	97215	516	801	0	99405
14185	92781	1505	991	640	0	95917
14186	1415	721	94002	613	0	96751
14187	973	309	90792	566	0	92640
14188	723	562	83552	511	0	85348
14189	319	73658	1167	394	0	75538
14190	676	352	1393	61305	0	63726
14191	111	231	114	61406	0	61862
14192	112	66	82	62304	0	62564
14193	61251	60	88	560	0	61959
14194	60104	60	77	384	0	60625
14195	447	62460	127	298	0	63332
14196	294	305	94	65102	0	65795
14197	337	295	67771	414	0	68817
14198	119	69819	330	450	0	70718
14199	68548	278	275	258	0	69359
14200	392	281	69266	163	0	70102
14201	60779	115	308	276	0	61478
14202	370	179	70003	283	0	70835
14203	267	271	242	66861	0	67641
14204	121	71262	252	418	0	72053
14205	71807	243	72	356	0	72478
14206	299	72771	131	300	0	73501
14207	71899	271	97	246	0	72513
14208	337	210	67	71543	0	72157
14209	302	214	75572	419	0	76507
14210	186	105	272	76453	0	77016
14211	179	167	204	83256	0	83806
14212	215	190	83680	668	0	84753
14213	74205	106	436	563	0	75310
14214	454	85398	368	344	0	86564
14215	84464	405	97	289	0	85255
14216	459	86770	140	341	0	87710
14217	377	567	75	88562	0	89581
14218	252	405	88510	655	0	89822
14219	96873	114	528	557	0	98072
14220	845	106145	391	411	0	107792
14221	620	922	122	105598	0	107262
14222	230	552	79	109534	0	110395
14223	114684	176	98	1457	0	116415
14224	118875	121	114	760	0	119870
14225	1684	126738	199	404	0	129025
14226	135951	1250	121	331	0	137653
14227	136212	772	118	276	0	137378
14228	138086	241	125	300	0	138752
14229	2634	326	140752	272	0	143984
14230	1194	139601	1589	353	0	142737
14231	350	143970	1108	385	0	145813
14232	392	2410	268	136218	0	139288
14233	350	1188	148	141189	0	142875
14234	141334	314	176	2396	0	144220
14235	1584	141365	259	1308	0	144516
14236	142491	1633	150	410	0	144684
14237	1821	1166	142	140011	0	143140
14238	1206	376	129	142361	0	144072
14239	140351	218	151	2553	0	143273
14240	137980	205	165	1337	0	139687
14241	2679	355	137399	408	0	140841
14242	1409	374	1544	134818	0	138145
14243	536	324	136250	1675	0	138785
14244	435	308	134353	1156	0	136252
14245	493	328	136318	408	0	137547
14246	130391	371	2757	352	0	133871
14247	1746	277	1230	131002	0	134255
14248	1283	211	332	129430	0	131256
14249	455	220	261	134559	0	135495
14250	426	267	133038	2607	0	136338
14251	414	200	1606	130728	0	132948
14252	488	199	1076	133442	0	135205
14253	132193	205	316	2564	0	135278
14254	132131	221	185	1403	0	133940
14255	134176	226	257	592	0	135251
14256	134032	209	232	448	0	134921
14257	2946	256	278	131213	0	134693
14258	132426	262	271	1824	0	134783
14259	2087	312	201	131901	0	134501
14260	1636	356	128852	1934	0	132778
14261	125266	269	1586	1429	0	128550
14262	2081	129457	1245	695	0	133478
14263	1580	1729	393	127970	0	131672
14264	845	1316	300	126210	0	128671
14265	665	129817	439	2732	0	133653
14266	127308	1753	337	1472	0	130870
14267	2040	126811	430	1044	0	130325
14268	1648	1836	125902	591	0	129977
14269	926	1318	126502	614	0	129360
14270	121521	496	2673	714	0	125404
14271	126751	391	1373	698	0	129213
14272	3042	465	124624	602	0	128733
14273	121313	384	1791	670	0	124158
14274	2371	480	123536	618	0	127005
14275	121490	317	1986	715	0	124508
14276	2416	459	123489	823	0	127187
14277	1989	416	122705	743	0	125853
14278	1005	482	2872	112943	0	117302
14279	961	371	1580	117435	0	120347
14280	118964	351	700	3014	0	123029
14281	119018	354	573	1757	0	121702
14282	119964	320	624	937	0	121845
14283	119659	400	556	882	0	121497
14284	3444	116591	734	886	0	121655
14285	2144	1777	554	113215	0	117690
14286	1277	117097	660	2220	0	121254
14287	1312	1803	642	116650	0	120407
14288	1274	1368	587	114334	0	117563
14289	1433	624	604	113779	0	116440
14290	1320	678	110503	3412	0	115913
14291	102299	500	2039	2192	0	107030
14292	2610	107313	1559	1406	0	112888
14293	1960	110249	802	1279	0	114290
14294	1602	2752	109427	1062	0	114843
14295	1228	1539	2001	107251	0	112019
14296	1333	683	1534	107080	0	110630
14297	104990	498	757	3353	0	109598
14298	2599	545	696	103420	0	107260
14299	2187	505	762	103587	0	107041
14300	1304	493	733	104646	0	107176
14301	1262	434	846	105098	0	107640
14302	101150	276	832	3531	0	105789
14303	101489	341	1025	2101	0	104956
14304	102302	299	887	1161	0	104649
14305	3586	336	970	100764	0	105656
14306	101386	301	998	2581	0	105266
14307	2536	249	966	102567	0	106318
14308	2184	344	1059	104105	0	107692
14309	1480	291	99013	3418	0	104202
14310	1197	281	96175	2147	0	99800
14311	1251	264	92230	1158	0	94903
14312	87636	305	3224	1111	0	92276
14313	2523	523	1931	81785	0	86762
14314	2075	87261	883	2274	0	92493
14315	88004	1447	921	1865	0	92237
14316	2671	1121	86120	1062	0	90974
14317	81420	366	1808	1068	0	84662
14318	2561	79654	1544	860	0	84619
14319	63678	942	534	606	0	65760
14320	1902	1009	419	61838	0	65168
14321	60344	233	394	1324	0	62295
14322	1527	58162	365	1280	0	61334
14323	1257	55046	378	676	0	57357
14324	45966	1201	423	401	0	47991
14325	940	44992	349	456	0	46737
14326	449	33180	173	188	0	33990
14327	392	33156	429	201	0	34178
14328	29683	727	1234	147	0	31791
14329	27687	303	114	85	0	28189
14330	27705	107	50	67	0	27929
14331	511	100	45	27221	0	27877
14332	329	83	49	27483	0	27944
14333	151	92	27306	461	0	28010
14334	142	67	251	27276	0	27736
14335	160	79	27734	292	0	28265
14336	139	57	259	27351	0	27806
14337	117	67	223	27686	0	28093
14338	27388	64	81	496	0	28029
14339	27044	63	61	337	0	27505
14340	464	27234	88	171	0	27957
14341	323	286	61	26963	0	27633
14342	138	287	27718	314	0	28457
14343	129	101	259	27537	0	28026
14344	123	81	235	27716	0	28155
14345	137	80	68	27985	0	28270
14346	124	89	27422	525	0	28160
14347	120	78	26259	331	0	26788
14348	25694	56	445	166	0	26361
14349	293	61	287	26832	0	27473
14350	289	44	26441	351	0	27125
14351	24762	31	286	344	0	25423
14352	272	26442	304	197	0	27215
14353	26636	232	109	160	0	27137
14354	326	249	27009	147	0	27731
14355	25897	75	275	141	0	26388
14356	311	77	296	26338	0	27022
14357	314	89	27051	292	0	27746
14358	129	26818	292	334	0	27573
14359	26713	246	307	142	0	27408
14360	321	254	110	26468	0	27153
14361	301	93	99	26205	0	26698
14362	139	27083	112	457	0	27791
14363	121	258	118	27160	0	27657
14364	156	272	27079	317	0	27824
14365	110	27038	273	318	0	27739
14366	26674	247	267	154	0	27342
14367	277	270	118	26587	0	27252
14368	307	115	77	26530	0	27029
14369	169	123	26487	446	0	27225
14370	123	135	230	26404	0	26892
14371	221	144	27447	283	0	28095
14372	112	27685	271	308	0	28376
14373	26903	268	309	161	0	27641
14374	26787	278	123	119	0	27307
14375	26517	119	87	149	0	26872
14376	460	28139	103	142	0	28844
14377	329	231	94	28112	0	28766
14378	170	248	88	28174	0	28680
14379	128	111	74	27950	0	28263
14380	27800	74	96	498	0	28468
14381	27639	88	84	356	0	28167
14382	465	74	70	27587	0	28196
14383	347	92	30839	325	0	31603
14384	138	84	227	30739	0	31188
14385	139	73	270	31037	0	31519
14386	164	64	99	31034	0	31361
14387	140	66	89	31178	0	31473
14388	31024	82	94	553	0	31753
14389	281	73	76	31659	0	32089
14390	299	74	80	31311	0	31764
14391	135	31810	92	562	0	32599
14392	116	243	77	32261	0	32697
14393	110	33624	88	399	0	34221
14394	138	268	80	33317	0	33803
14395	32642	293	71	405	0	33411
14396	293	33442	84	437	0	34256
14397	33001	263	78	211	0	33553
14398	372	318	33840	180	0	34710
14399	361	99	260	33350	0	34070
14400	184	88	35096	399	0	35767
14401	124	84	312	34763	0	35283
14402	122	151	321	33781	0	34375
14403	132	35060	175	597	0	35964
14404	108	35064	117	435	0	35724
14405	82	34896	90	187	0	35255
14406	33260	378	118	160	0	33916
14407	190	32351	53	152	0	32746
14408	156	31359	46	154	0	31715
14409	646	273	108	31240	0	32267
14410	31386	143	17	177	0	31723
14411	120	34460	35	209	0	34824
14412	35223	129	28	115	0	35495
14413	35034	134	26	76	0	35270
14414	256	79	37255	65	0	37655
14415	174	34	135	36313	0	36656
14416	41	46	158	37862	0	38107
14417	41	52	27	38251	0	38371
14418	52	32	33	37946	0	38063
14419	62	73	37419	319	0	37873
14420	73	100	34702	187	0	35062
14421	33793	47	263	95	0	34198
14422	125	37220	160	86	0	37591
14423	150	37750	55	91	0	38046
14424	37624	255	24	80	0	37983
14425	129	38676	37	94	0	38936
14426	166	151	28	39037	0	39382
14427	39359	162	42	197	0	39760
14428	174	91	40107	207	0	40579
14429	175	41	141	40258	0	40615
14430	73	65	41775	183	0	42096
14431	39465	55	158	228	0	39906
14432	190	70	45964	82	0	46306
14433	45948	42	160	132	0	46282
14434	48250	44	192	126	0	48612
14435	48670	45	41	97	0	48853
14436	48775	53	36	86	0	48950
14437	48949	38	40	101	0	49128
14438	355	42	38	48926	0	49361
14439	51843	53	34	344	0	52274
14440	190	66	41	52429	0	52726
14441	235	40	39	52481	0	52795
14442	98	49	35	53982	0	54164
14443	107	88	54644	400	0	55239
14444	103	50	175	53396	0	53724
14445	77	52	221	55843	0	56193
14446	108	104	55052	411	0	55675
14447	48739	55	204	348	0	49346
14448	221	75	212	56154	0	56662
14449	266	85	56589	260	0	57200
14450	159	85	55379	240	0	55863
14451	91	81	323	54813	0	55308
14452	168	85	57623	294	0	58170
14453	95	84	202	57811	0	58192
14454	109	55	193	57975	0	58332
14455	74	59040	107	388	0	59609
14456	76	59711	100	293	0	60180
14457	60018	314	46	175	0	60553
14458	221	212	46	60503	0	60982
14459	247	66	58	60096	0	60467
14460	119	43	55	61854	0	62071
14461	118	97	62501	481	0	63197
14462	98	55	197	61313	0	61663
14463	61455	59	246	293	0	62053
14464	259	79	63894	303	0	64535
14465	277	50	203	65294	0	65824
14466	103	64	239	66785	0	67191
14467	120	60	74	66782	0	67036
14468	88	72605	119	496	0	73308
14469	72946	358	77	353	0	73734
14470	76249	296	74	175	0	76794
14471	722	80044	101	160	0	81027
14472	456	439	75	84347	0	85317
14473	220	429	85832	604	0	87085
14474	184	163	85371	526	0	86244
14475	85490	71	1173	215	0	86949
14476	783	52	610	90069	0	91514
14477	94010	48	191	821	0	95070
14478	904	97825	156	806	0	99691
14479	680	99553	132	306	0	100671
14480	96761	1508	87	182	0	98538
14481	865	102641	149	178	0	103833
14482	751	979	85	102280	0	104095
14483	312	734	101	95641	0	96788
14484	137	104856	143	1546	0	106682
14485	105284	970	113	854	0	107221
14486	1102	835	106399	223	0	108559
14487	100289	207	1046	291	0	101833
14488	1201	198	107862	174	0	109435
14489	96120	110	1139	357	0	97726
14490	1304	227	108751	222	0	110504
14491	839	107246	1196	313	0	109594
14492	395	1218	987	106666	0	109266
14493	106019	742	307	1063	0	108131
14494	1143	228	105986	794	0	108151
14495	948	187	106138	263	0	107536
14496	338	153	1737	101959	0	104187
14497	307	229	106901	1064	0	108501
14498	216	142	1188	103857	0	105403
14499	242	88	829	104539	0	105698
14500	258	269	105600	1811	0	107938
14501	214	139	1088	104324	0	105765
14502	106734	98	912	1288	0	109032
14503	1060	107590	352	1012	0	110014
14504	108921	1019	198	374	0	110512
14505	1175	791	179	106854	0	108999
14506	108068	206	226	1164	0	109664
14507	109457	146	222	951	0	110776
14508	1901	176	207	106759	0	109043
14509	963	110972	257	1159	0	113351
14510	111724	1009	250	944	0	113927
14511	1196	842	108660	420	0	111118
14512	977	295	108209	291	0	109772
14513	104982	205	1806	302	0	107295
14514	1205	191	989	107688	0	110073
14515	980	219	109720	1185	0	112104
14516	409	150	1167	109133	0	110859
14517	109966	143	925	1267	0	112301
14518	112214	153	362	1011	0	113740
14519	111579	184	287	404	0	112454
14520	1915	116387	275	402	0	118979
14521	1101	1125	213	116424	0	118863
14522	435	938	200	116955	0	118528
14523	116488	308	225	1878	0	118899
14524	1193	116996	274	1173	0	119636
14525	116567	1107	198	469	0	118341
14526	1377	925	197	115541	0	118040
14527	115155	359	279	1248	0	117041
14528	1447	376	112849	1081	0	115753
14529	1106	113984	1195	517	0	116802
14530	696	1243	916	106849	0	109704
14531	438	117734	443	990	0	119605
14532	485	1267	238	113498	0	115488
14533	112902	897	267	1300	0	115366
14534	1363	424	110726	969	0	113482
14535	106859	253	1228	491	0	108831
14536	1337	115383	1084	427	0	118231
14537	1134	1089	450	116729	0	119402
14538	472	856	414	118592	0	120334
14539	114741	327	352	1943	0	117363
14540	1339	370	116628	1176	0	119513
14541	1129	213	1256	116622	0	119220
14542	561	252	996	116519	0	118328
14543	489	260	461	116472	0	117682
14544	435	234	375	117607	0	118651
14545	115335	229	300	2141	0	118005
14546	114802	279	319	1285	0	116685
14547	2116	346	117536	570	0	120568
14548	1224	376	116298	556	0	118454
14549	119124	234	1801	615	0	121774
14550	123795	222	1014	627	0	125658
14551	2092	252	396	122974	0	125714
14552	1254	220	388	123236	0	125098
14553	121670	207	397	2034	0	124308
14554	1414	124041	510	1317	0	127282
14555	1228	1025	399	124394	0	127046
14556	649	808	370	125853	0	127680
14557	589	391	123925	2070	0	126975
14558	612	206	1223	122620	0	124661
14559	603	339	125183	1513	0	127638
14560	574	238	1302	123871	0	125985
14561	121960	199	974	1564	0	124697
14562	1479	229	392	125020	0	127120
14563	1184	302	124786	1608	0	127880
14564	586	121777	1265	1545	0	125173
14565	636	1190	924	126966	0	129716
14566	748	910	130183	1440	0	133281
14567	554	131715	1214	1418	0	134901
14568	604	1328	790	127253	0	129975
14569	582	885	126911	1310	0	129688
14570	94496	343	1123	1405	0	97367
14571	1056	122753	843	586	0	125238
14572	710	118050	314	520	0	119594
14573	381	120204	315	397	0	121297
14574	856	2012	394	114459	0	117721
14575	395	726	119233	886	0	121240
14576	230	118485	856	833	0	120404
14577	671	1496	758	113878	0	116803
14578	118337	502	219	881	0	119939
14579	889	179	76	146906	0	148050
14580	919	263	169692	1712	0	172586
14581	241	172476	1770	1235	0	175722
14582	163839	1803	930	441	0	167013
14583	1660	172726	393	576	0	175355
14584	1431	2041	166644	378	0	170494
14585	285	169736	1921	560	0	172502
14586	364	2249	1151	165107	0	168871
14587	419	1306	166204	1802	0	169731
14588	299	166009	1966	1374	0	169648
14589	382	2168	1093	160610	0	164253
14590	344	1371	557	159645	0	161917
14591	129	165258	642	2658	0	168687
14592	263	2219	496	165450	0	168428
14593	317	1482	165108	2198	0	169105
14594	310	858	166606	1342	0	169116
14595	187	712	2750	164578	0	168227
14596	164473	575	1339	2418	0	168805
14597	163886	587	571	1584	0	166628
14598	2579	631	476	159194	0	162880
14599	1110	163954	794	2488	0	168346
14600	522	2189	750	164625	0	168086
14601	161510	1317	859	2557	0	166243
14602	2121	776	726	161352	0	164975
14603	1615	806	516	162785	0	165722
14604	159692	800	494	3268	0	164254
14605	2136	160800	770	1996	0	165702
14606	1291	2510	623	157337	0	161761
14607	158661	1563	463	2742	0	163429
14608	2350	889	156869	1973	0	162081
14609	154531	693	2145	1409	0	158778
14610	2404	716	1220	158120	0	162460
14611	157501	766	570	2919	0	161756
14612	157537	833	441	2104	0	160915
14613	150219	749	547	1483	0	152998
14614	3184	154265	960	1537	0	159946
14615	2067	2229	152649	1147	0	158092
14616	1247	154982	2562	1250	0	160041
14617	150772	2340	1393	1172	0	155677
14618	2928	153193	720	1262	0	158103
14619	2326	2405	492	151386	0	156609
14620	145726	1796	576	2507	0	150605
14621	2480	148170	678	2108	0	153436
14622	2040	2779	147505	1244	0	153568
14623	1465	1866	2139	146386	0	151856
14624	1256	1272	148525	2954	0	154007
14625	1093	147833	2452	3092	0	154470
14626	1094	2958	1471	143956	0	149479
14627	1122	1953	878	146505	0	150458
14628	1129	1281	820	147380	0	150610
14629	1235	993	1057	140653	0	143938
14630	1150	144944	1161	3731	0	150986
14631	141571	2617	1012	2527	0	147727
14632	2840	1950	143192	1941	0	149923
14633	2121	1390	2753	142415	0	148679
14634	140614	1448	1943	3276	0	147281
14635	3276	1843	142300	2388	0	149807
14636	2118	139208	2866	1860	0	146052
14637	1325	3810	2206	134561	0	141902
14638	1452	2876	137825	3136	0	145289
14639	1132	139030	3020	2763	0	145945
14640	130280	3182	2227	2218	0	137907
14641	2619	136274	1664	2159	0	142716
14642	1970	3675	1271	131480	0	138396
14643	1192	2647	1232	137020	0	142091
14644	132284	2026	1328	4716	0	140354
14645	2527	134009	1719	3515	0	141770
14646	1962	3396	2017	134530	0	141905
14647	129092	2493	2165	3723	0	137473
14648	126100	1790	1610	3450	0	132950
14649	4133	126352	1230	3064	0	134779
14650	126652	3221	962	2421	0	133256
14651	127079	2798	739	2393	0	133009
14652	4349	2335	773	124790	0	132247
14653	2827	2153	123479	4079	0	132538
14654	2262	1568	2724	120710	0	127264
14655	2286	1309	1947	122252	0	127794
14656	2181	1442	118767	5136	0	127526
14657	2132	117691	2854	3571	0	126248
14658	2182	3447	1701	116994	0	124324
14659	1849	2444	1317	119543	0	125153
14660	1984	1569	1523	119836	0	124912
14661	2054	1466	1673	114117	0	119310
14662	2201	116054	1656	4875	0	124786
14663	116357	2848	1089	3598	0	123892
14664	115743	1953	808	3099	0	121603
14665	110937	1365	600	2702	0	115604
14666	5059	104633	658	2674	0	113024
14667	2985	3529	699	103175	0	110388
14668	2010	2740	102766	3762	0	111278
14669	2318	2363	2565	96512	0	103758
14670	2548	103032	1700	3252	0	110532
14671	99142	3210	879	2404	0	105635
14672	98595	2317	625	2265	0	103802
14673	95352	1616	838	2194	0	100000
14674	4066	94654	1283	1992	0	101995
14675	2276	88302	1749	1979	0	94306
14676	1537	89225	1732	2221	0	94715
14677	1852	3261	87273	1890	0	94276
14678	1935	3460	77310	1772	0	84477
14679	2863	10594	2512	33966	0	49935
14680	21771	247	1457	389	0	23864
14681	21088	80	63	187	0	21418
14682	274	79	40	22276	0	22669
14683	181	67	51	22396	0	22695
14684	86	67	60	22930	0	23143
14685	80	79	49	23095	0	23303
14686	23175	81	52	316	0	23624
14687	23544	90	48	195	0	23877
14688	300	24685	52	146	0	25183
14689	25437	207	50	142	0	25836
14690	25588	161	51	130	0	25930
14691	25747	88	55	118	0	26008
14692	355	100	24611	114	0	25180
14693	24448	79	184	101	0	24812
14694	249	25887	152	114	0	26402
14695	187	224	60	26196	0	26667
14696	128	149	56	26053	0	26386
14697	100	26281	62	388	0	26831
14698	108	234	47	26911	0	27300
14699	26555	186	50	310	0	27101
14700	276	95	40	27045	0	27456
14701	228	91	26684	308	0	27311
14702	24874	76	205	251	0	25406
14703	277	27490	148	159	0	28074
14704	231	253	54	27447	0	27985
14705	142	183	37	27430	0	27792
14706	137	100	34	27473	0	27744
14707	156	84	27016	431	0	27687
14708	116	26446	234	280	0	27076
14709	136	232	129	26389	0	26886
14710	135	190	25939	242	0	26506
14711	114	76	181	25336	0	25707
14712	106	90	25715	258	0	26169
14713	114	125	192	24409	0	24840
14714	87	25329	162	275	0	25853
14715	120	206	47	24761	0	25134
14716	24717	145	41	261	0	25164
14717	24595	79	44	191	0	24909
14718	337	76	24694	115	0	25222
14719	178	105	23777	72	0	24132
14720	77	70	25847	96	0	26090
14721	52	60	308	25406	0	25826
14722	67	40	156	26916	0	27179
14723	60	51	56	26889	0	27056
14724	62	27649	47	407	0	28165
14725	68	243	49	27559	0	27919
14726	67	189	41	28130	0	28427
14727	70	53	44	28893	0	29060
14728	28577	39	60	428	0	29104
14729	28279	47	44	267	0	28637
14730	409	61	29059	109	0	29638
14731	237	65	28948	103	0	29353
14732	28061	62	394	98	0	28615
14733	29555	38	213	115	0	29921
14734	453	56	30976	88	0	31573
14735	245	52	30305	100	0	30702
14736	29431	38	424	98	0	29991
14737	30224	42	230	98	0	30594
14738	440	70	31315	106	0	31931
14739	241	42	260	30572	0	31115
14740	95	41	219	30935	0	31290
14741	78	32662	86	498	0	33324
14742	101	281	51	33136	0	33569
14743	126	241	35046	370	0	35783
14744	105	54	340	34936	0	35435
14745	99	37	286	35393	0	35815
14746	122	67	35015	594	0	35798
14747	32999	37	338	358	0	33732
14748	35259	29	289	144	0	35721
14749	578	46	83	34829	0	35536
14750	328	54	73	35407	0	35862
14751	35487	32	75	602	0	36196
14752	35326	40	85	329	0	35780
14753	35049	38	77	148	0	35312
14754	35587	42	90	115	0	35834
14755	598	35207	103	117	0	36025
14756	34488	308	85	131	0	35012
14757	363	35013	96	144	0	35616
14758	315	313	65	34613	0	35306
14759	98	279	69	34237	0	34683
14760	95	34243	92	632	0	35062
14761	98	321	79	34467	0	34965
14762	97	242	56	33850	0	34245
14763	89	33936	88	619	0	34732
14764	96	331	79	34034	0	34540
14765	124	257	79	34126	0	34586
14766	114	70	83	34324	0	34591
14767	150	70	33577	644	0	34441
14768	107	32674	365	432	0	33578
14769	172	412	292	30474	0	31350
14770	116	32555	126	356	0	33153
14771	31730	306	119	313	0	32468
14772	395	261	31710	172	0	32538
14773	312	100	31145	156	0	31713
14774	29310	78	527	138	0	30053
14775	403	213	310	30190	0	31116
14776	286	57	29420	341	0	30104
14777	136	59	28918	282	0	29395
14778	159	228	475	27693	0	28555
14779	27524	69	287	352	0	28232
14780	27225	61	90	291	0	27667
14781	485	64	62	27211	0	27822
14782	289	64	26856	371	0	27580
14783	97	27932	307	389	0	28725
14784	121	316	234	27589	0	28260
14785	145	249	27757	384	0	28535
14786	92	27570	305	351	0	28318
14787	140	366	254	26576	0	27336
14788	26420	206	100	346	0	27072
14789	287	55	72	25496	0	25910
14790	233	26117	95	350	0	26795
14791	26060	233	89	294	0	26676
14792	298	250	27326	134	0	28008
14793	254	27195	266	160	0	27875
14794	133	269	27069	106	0	27577
14795	25463	239	314	131	0	26147
14796	282	67	250	25862	0	26461
14797	248	56	108	26898	0	27310
14798	27028	39	105	434	0	27606
14799	291	45	90	27152	0	27578
14800	264	66	26847	302	0	27479
14801	24853	43	267	301	0	25464
14802	284	27310	254	158	0	28006
14803	273	239	92	26727	0	27331
14804	26601	190	81	314	0	27186
14805	271	26662	91	314	0	27338
14806	263	250	102	27335	0	27950
14807	27726	219	68	332	0	28345
14808	290	78	66	27642	0	28076
14809	230	27989	79	369	0	28667
14810	130	285	28597	285	0	29297
14811	108	217	237	29214	0	29776
14812	115	79	229	29078	0	29501
14813	29435	63	65	460	0	30023
14814	286	73	69	29679	0	30107
14815	29757	73	64	306	0	30200
14816	29564	67	73	270	0	29974
14817	450	86	47	28844	0	29427
14818	252	29893	87	320	0	30552
14819	155	259	55	29264	0	29733
14820	27892	224	44	316	0	28476
14821	272	28733	59	304	0	29368
14822	201	30200	67	107	0	30575
14823	30464	363	44	140	0	31011
14824	30741	191	61	105	0	31098
14825	390	31392	66	101	0	31949
14826	31458	279	148	103	0	31988
14827	31087	198	74	94	0	31453
14828	473	70	33	31404	0	31980
14829	253	80	33484	310	0	34127
14830	84	110	309	33334	0	33837
14831	100	69	34683	350	0	35202
14832	79	109	317	34272	0	34777
14833	97	106	34853	385	0	35441
14834	32656	37	360	284	0	33337
14835	390	38	263	33414	0	34105
14836	34647	22	69	346	0	35084
14837	388	117	48	33192	0	33745
14838	295	35844	52	362	0	36553
14839	36334	298	49	333	0	37014
14840	383	297	35871	88	0	36639
14841	33546	52	262	77	0	33937
14842	319	35163	250	72	0	35804
14843	33485	236	69	57	0	33847
14844	33219	209	24	64	0	33516
14845	442	34090	41	50	0	34623
14846	262	269	24	34959	0	35514
14847	34737	223	35	329	0	35324
14848	304	35488	50	274	0	36116
14849	263	291	26	35800	0	36380
14850	35936	239	28	349	0	36552
14851	328	58	32	36171	0	36589
14852	287	37	35	36532	0	36891
14853	106	44	18	36801	0	36969
14854	91	71	36125	580	0	36867
14855	100	34	304	36156	0	36594
14856	36315	47	246	389	0	36997
14857	353	71	36896	303	0	37623
14858	306	32	327	36611	0	37276
14859	115	55	239	37226	0	37635
14860	82	63	37065	590	0	37800
14861	34815	34	329	349	0	35527
14862	37377	39	266	126	0	37808
14863	593	70	37664	96	0	38423
14864	343	37	343	36667	0	37390
14865	173	42	267	38049	0	38531
14866	107	56	39732	608	0	40503
14867	113	28	352	39923	0	40416
14868	110	38	278	40600	0	41026
14869	108	63	41612	693	0	42476
14870	39408	40	406	402	0	40256
14871	430	44	317	42343	0	43134
14872	42325	37	106	501	0	42969
14873	42200	38	84	429	0	42751
14874	731	74	42591	212	0	43608
14875	401	36	442	41826	0	42705
14876	42197	20	323	531	0	43071
14877	454	43093	150	437	0	44134
14878	376	410	86	43939	0	44811
14879	153	312	80	44514	0	45059
14880	125	66	92	45356	0	45639
14881	120	63	44720	863	0	45766
14882	39740	45	501	515	0	40801
14883	510	31	383	43281	0	44205
14884	422	34	113	43661	0	44230
14885	180	66	43290	858	0	44394
14886	137	53	506	42816	0	43512
14887	159	37	389	43489	0	44074
14888	42350	42	141	870	0	43403
14889	522	42609	119	561	0	43811
14890	457	436	42561	243	0	43697
14891	41680	318	507	191	0	42696
14892	538	75	390	41499	0	42502
14893	468	67	42214	607	0	43356
14894	219	78	42617	472	0	43386
14895	162	67	787	42154	0	43170
14896	157	76	43346	627	0	44206
14897	185	54	43147	545	0	43931
14898	131	40472	839	313	0	41755
14899	154	477	461	42714	0	43806
14900	212	355	43167	613	0	44347
14901	141	86	536	41721	0	42484
14902	43296	51	435	668	0	44450
14903	542	58	174	43427	0	44201
14904	413	70	136	44459	0	45078
14905	42471	44	136	920	0	43571
14906	43146	68	141	571	0	43926
14907	825	69	158	44847	0	45899
14908	506	70	45418	661	0	46655
14909	197	44757	573	561	0	46088
14910	165	514	462	44366	0	45507
14911	43359	342	243	673	0	44617
14912	44009	87	179	561	0	44836
14913	843	43944	191	327	0	45305
14914	463	45001	216	267	0	45947
14915	44591	766	179	251	0	45787
14916	44972	391	174	263	0	45800
14917	906	122	46058	253	0	47339
14918	518	95	586	42832	0	44031
14919	184	46455	505	637	0	47781
14920	46852	482	192	561	0	48087
14921	618	440	141	45335	0	46534
14922	467	45141	183	699	0	46490
14923	298	513	44617	524	0	45952
14924	245	544	555	39942	0	41286
14925	162	45116	453	622	0	46353
14926	44293	491	177	520	0	45481
14927	43988	365	176	264	0	44793
14928	783	44127	155	271	0	45336
14929	41580	396	115	210	0	42301
14930	40596	303	160	189	0	41248
14931	651	40929	137	188	0	41905
14932	380	41030	133	187	0	41730
14933	307	666	168	39380	0	40521
14934	39340	303	132	469	0	40244
14935	482	131	40899	367	0	41879
14936	36972	116	405	203	0	37696
14937	417	39926	290	198	0	40831
14938	39608	363	164	168	0	40303
14939	39687	254	117	152	0	40210
14940	39916	101	95	176	0	40288
14941	632	119	101	38126	0	38978
14942	319	39228	141	446	0	40134
14943	39065	360	95	350	0	39870
14944	476	294	39503	167	0	40440
14945	314	39496	383	157	0	40350
14946	162	402	281	39304	0	40149
14947	161	273	38925	347	0	39706
14948	139	118	39672	278	0	40207
14949	144	141	547	37971	0	38803
14950	133	107	280	39907	0	40427
14951	125	85	100	40834	0	41144
14952	146	95	89	39945	0	40275
14953	145	39733	112	579	0	40569
14954	131	40862	100	319	0	41412
14955	40784	521	87	164	0	41556
14956	404	282	76	40978	0	41740
14957	347	97	61	41232	0	41737
14958	170	95	78	41930	0	42273
14959	40973	105	74	580	0	41732
14960	41634	88	69	327	0	42118
14961	611	102	77	41514	0	42304
14962	42224	96	86	394	0	42800
14963	42103	82	72	306	0	42563
14964	42941	102	76	150	0	43269
14965	611	93	99	41913	0	42716
14966	317	86	40394	336	0	41133
14967	134	98	39189	240	0	39661
14968	142	71	40416	118	0	40747
14969	129	88	40584	68	0	40869
14970	162	320	482	38768	0	39732
14971	39730	57	292	269	0	40348
14972	39291	61	55	195	0	39602
14973	422	56	39990	83	0	40551
14974	244	67	40714	83	0	41108
14975	75	43686	395	78	0	44234
14976	124	263	216	43558	0	44161
14977	43722	193	101	271	0	44287
14978	248	71	44191	202	0	44712
14979	41918	45	198	114	0	42275
14980	217	46156	178	132	0	46683
14981	190	200	46	46980	0	47416
14982	76	156	36	48894	0	49162
14983	83	61	37	49119	0	49300
14984	49149	49	38	467	0	49703
14985	290	37	44	49585	0	49956
14986	248	49	44	49873	0	50214
14987	49754	43	46	456	0	50299
14988	290	50	37	49713	0	50090
14989	264	80	50767	324	0	51435
14990	49295	51	257	282	0	49885
14991	297	31	217	51631	0	52176
14992	274	36	55	50618	0	50983
14993	76	51651	95	441	0	52263
14994	52162	247	38	266	0	52713
14995	52827	235	49	113	0	53224
14996	504	54	34	52443	0	53035
14997	294	84	52845	302	0	53525
14998	48759	54	291	303	0	49407
14999	357	78	54567	127	0	55129
15000	281	48	311	53447	0	54087
15001	110	53	246	55959	0	56368
15002	55963	35	68	565	0	56631
15003	374	42	53	59678	0	60147
15004	326	79	60391	391	0	61187
15005	58112	31	362	332	0	58837
15006	404	66	65083	175	0	65728
15007	327	101	65930	124	0	66482
15008	67645	46	729	163	0	68583
15009	567	106	347	71316	0	72336
15010	344	76843	135	458	0	77780
15011	77350	440	95	364	0	78249
15012	77019	303	72	155	0	77549
15013	787	95	77309	107	0	78298
15014	75652	53	507	106	0	76318
15015	572	86	327	77956	0	78941
15016	402	111	80655	526	0	81694
15017	113	80175	514	412	0	81214
15018	78466	519	391	195	0	79571
15019	454	82712	135	202	0	83503
15020	408	491	140	82453	0	83492
15021	146	301	88	83507	0	84042
15022	144	67	64	84451	0	84726
15023	127	88	67	82944	0	83226
15024	110	84677	96	873	0	85756
15025	213	500	82782	460	0	83955
15026	103	84527	506	208	0	85344
15027	83993	463	356	162	0	84974
15028	517	372	86	83947	0	84922
15029	84688	60	77	563	0	85388
15030	549	101	94	85470	0	86214
15031	89905	61	93	647	0	90706
15032	556	93198	136	536	0	94426
15033	96606	482	94	246	0	97428
15034	97615	337	88	213	0	98253
15035	96792	84	84	184	0	97144
15036	97801	73	76	204	0	98154
15037	872	98334	141	247	0	99594
15038	533	532	98898	166	0	100129
15039	225	362	492	99056	0	100135
15040	99881	107	383	577	0	100948
15041	101325	90	105	450	0	101970
15042	903	81	117	103161	0	104262
15043	511	178	107358	675	0	108722
15044	257	126	627	104039	0	105049
15045	203	109265	503	670	0	110641
15046	109412	636	130	559	0	110737
15047	748	490	113	108486	0	109837
15048	538	111437	156	711	0	112842
15049	219	116126	165	565	0	117075
15050	197	117769	161	275	0	118402
15051	242	1112	114	117183	0	118651
15052	117498	522	141	826	0	118987
15053	709	120375	155	651	0	121890
15054	607	739	83	121206	0	122635
15055	120873	515	86	846	0	122320
15056	815	183	102	121456	0	122556
15057	121093	180	116	846	0	122235
15058	121443	115	96	643	0	122297
15059	1219	128871	148	377	0	130615
15060	865	768	92	121551	0	123276
15061	248	130337	151	679	0	131415
15062	129142	789	135	549	0	130615
15063	129832	569	124	273	0	130798
15064	132371	203	125	279	0	132978
15065	1343	180	124	131935	0	133582
15066	809	230	132545	840	0	134424
15067	127809	177	779	675	0	129440
15068	133922	182	542	330	0	134976
15069	1348	231	136	130751	0	132466
15070	764	137316	198	897	0	139175
15071	441	839	119	137875	0	139274
15072	407	667	116	139593	0	140783
15073	139054	297	153	1273	0	140777
15074	138411	276	146	756	0	139589
15075	1398	292	136181	349	0	138220
15076	855	227	802	135049	0	136933
15077	136515	263	539	1017	0	138334
15078	1128	284	161	139261	0	140834
15079	889	344	141183	1122	0	143538
15080	371	137666	847	959	0	139843
15081	382	142593	576	473	0	144024
15082	152782	1323	195	403	0	154703
15083	1284	712	152	159489	0	161637
15084	937	329	108	176935	0	178309
15085	175506	275	173	2316	0	178270
15086	1870	361	178896	1181	0	182308
15087	1250	251	1547	174628	0	177676
15088	737	345	181823	1732	0	184637
15089	476	182758	1766	1262	0	186262
15090	188804	1607	979	634	0	192024
15091	190870	984	322	417	0	192593
15092	191920	419	217	400	0	192956
15093	2846	369	188815	423	0	192453
15094	186466	335	1582	430	0	188813
15095	192278	238	936	411	0	193863
15096	2871	269	319	190895	0	194354
15097	173424	264	740	1875	0	176303
15098	1822	348	192036	1125	0	195331
15099	180170	274	1732	638	0	182814
15100	2337	368	189754	464	0	192923
15101	1380	194571	1768	774	0	198493
15102	852	3590	1139	172003	0	177584
15103	629	194675	518	1476	0	197298
15104	768	1885	190351	1039	0	194043
15105	598	194399	1717	732	0	197446
15106	179009	1828	1011	493	0	182341
15107	1557	183151	462	542	0	185712
15108	1060	178884	365	477	0	180786
15109	855	2103	174630	302	0	177890
15110	536	1135	1531	171020	0	174222
15111	173397	477	965	1633	0	176472
15112	1673	505	175385	1053	0	178616
15113	1091	175248	1589	730	0	178658
15114	742	1505	951	168889	0	172087
15115	728	1042	176102	1712	0	179584
15116	791	515	174321	1119	0	176746
15117	696	391	2495	170897	0	174479
15118	719	452	175124	1839	0	178134
15119	757	564	2026	152431	0	155778
15120	665	170081	1371	1528	0	173645
15121	979	1672	631	161943	0	165225
15122	957	170465	625	1594	0	173641
15123	1118	1828	481	168277	0	171704
15124	166479	989	665	1649	0	169782
15125	2227	511	569	164185	0	167492
15126	1568	167573	583	1806	0	171530
15127	1015	1590	557	169095	0	172257
15128	1066	1054	168832	1894	0	172846
15129	945	573	1923	166913	0	170354
15130	166216	486	1402	1912	0	170016
15131	2099	672	163971	1229	0	167971
15132	1471	764	1965	157911	0	162111
15133	156644	626	1271	1951	0	160492
15134	1987	157394	892	1596	0	161869
15135	1674	2009	868	154171	0	158722
15136	157282	1450	896	1887	0	161515
15137	2374	965	791	156020	0	160150
15138	1699	948	155223	1983	0	159853
15139	145907	1070	2122	1531	0	150630
15140	2131	155085	1798	990	0	160004
15141	1481	155581	1251	1091	0	159404
15142	155603	2482	1203	876	0	160164
15143	151807	1531	1132	818	0	155288
15144	2662	1254	979	148368	0	153263
15145	150689	1014	1090	2010	0	154803
15146	2295	1145	150460	1604	0	155504
15147	146484	860	2415	1342	0	151101
15148	2144	147995	1980	1544	0	153663
15149	147007	1950	1571	1387	0	151915
15150	2575	1408	148789	1468	0	154240
15151	2278	1458	2628	146265	0	152629
15152	1599	1171	2242	147924	0	152936
15153	1655	1405	1776	135381	0	140217
15154	1583	146652	1832	2657	0	152724
15155	147946	2215	1291	1861	0	153313
15156	3624	1498	1639	132474	0	139235
15157	2853	141028	1401	2188	0	147470
15158	153357	1930	1639	1863	0	158789
15159	146581	1464	1869	1531	0	151445
15160	149846	1181	1474	1591	0	154092
15161	149221	1178	1519	1756	0	153674
15162	146242	1052	1543	1811	0	150648
15163	3238	1370	1682	144918	0	151208
15164	2378	1491	1759	144147	0	149775
15165	141976	1645	1523	2934	0	148078
15166	2176	1948	1626	142214	0	147964
15167	1944	2086	1428	141223	0	146681
15168	1469	2031	135876	3163	0	142539
15169	134799	2094	2817	2126	0	141836
15170	138344	1980	2328	1751	0	144403
15171	139731	2401	1500	1493	0	145125
15172	3225	2220	1734	125064	0	132243
15173	2071	136296	1495	2747	0	142609
15174	143592	2585	1734	2077	0	149988
15175	140482	1945	1895	2375	0	146697
15176	3502	1400	1748	146955	0	153605
15177	146552	1319	2029	3161	0	153061
15178	3325	2716	128626	2647	0	137314
15179	2130	150103	2885	2275	0	157393
15180	2123	152819	2420	2679	0	160041
15181	2773	3045	148474	2428	0	156720
15182	1212	134207	2918	2400	0	140737
15183	1399	126562	2038	2545	0	132544
15184	104431	1497	2103	1326	0	109357
15185	1121	105163	752	1419	0	108455
15186	1264	1365	740	105072	0	108441
15187	108551	932	610	1758	0	111851
15188	1543	732	106657	1464	0	110396
15189	102672	838	760	1457	0	105727
15190	1469	907	105147	1273	0	108796
15191	1104	559	104793	1245	0	107701
15192	98332	491	1221	1339	0	101383
15193	1292	435	106341	1306	0	109374
15194	1060	104697	946	812	0	107515
15195	799	672	940	103798	0	106209
15196	103565	574	473	1065	0	105677
15197	1115	102165	352	976	0	104608
15198	915	884	389	101970	0	104158
15199	916	669	101638	1051	0	104274
15200	1004	441	536	101400	0	103381
15201	98846	361	669	1105	0	100981
15202	1296	336	98226	764	0	100622
15203	1288	443	678	95901	0	98310
15204	97219	671	534	905	0	99329
15205	98984	487	329	738	0	100538
15206	1849	398	320	97887	0	100454
15207	1338	366	220	99105	0	101029
15208	998	427	102745	1243	0	105413
15209	1077	306	103047	810	0	105240
15210	98571	242	1137	541	0	100491
15211	106212	316	540	495	0	107563
15212	1476	107164	353	522	0	109515
15213	107023	579	389	252	0	108243
15214	110485	458	402	522	0	111867
15215	1295	302	121178	657	0	123432
15216	710	126177	744	712	0	128343
15217	128717	630	575	434	0	130356
15218	128670	436	157	210	0	129473
15219	132126	138	124	242	0	132630
15220	1123	184	94	129628	0	131029
15221	694	131	95	130522	0	131442
15222	310	132025	197	1080	0	133612
15223	260	647	76	133660	0	134643
15224	132551	433	122	838	0	133944
15225	822	153	71	133570	0	134616
15226	636	222	133078	831	0	134767
15227	410	228	130648	562	0	131848
15228	325	101	1057	130200	0	131683
15229	335	212	134480	870	0	135897
15230	308	211	134231	641	0	135391
15231	273	105	1196	124225	0	125799
15232	272	156	632	134641	0	135701
15233	322	173	137295	1185	0	138975
15234	408	187	138066	733	0	139394
15235	246	139761	1238	381	0	141626
15236	139808	739	671	259	0	141477
15237	803	145262	334	372	0	146771
15238	144752	807	216	279	0	146054
15239	145979	568	189	222	0	146958
15240	1223	148680	236	368	0	150507
15241	149014	859	112	268	0	150253
15242	1063	597	111	146537	0	148308
15243	750	342	150754	923	0	152769
15244	372	185	853	146324	0	147734
15245	252	147	574	151788	0	152761
15246	146624	109	273	1433	0	148439
15247	146116	97	211	799	0	147223
15248	147069	106	205	365	0	147745
15249	147011	116	203	296	0	147626
15250	142203	126	170	331	0	142830
15251	1459	140557	291	349	0	142656
15252	845	808	201	142770	0	144624
15253	396	673	146432	938	0	148439
15254	338	192	929	144702	0	146161
15255	308	166	664	147697	0	148835
15256	310	149	288	153922	0	154669
15257	162100	147	235	1726	0	164208
15258	1448	125	220	162838	0	164631
15259	165695	142	251	1637	0	167725
15260	1772	254	174081	1026	0	177133
15261	1240	123	1501	197225	0	200089
15262	571	237	206398	2349	0	209555
15263	200088	140	2351	1428	0	204007
15264	2383	180	1326	204530	0	208419
15265	1559	254	210932	2404	0	215149
15266	625	120	2348	209843	0	212936
15267	210464	122	1496	2728	0	214810
15268	2582	243	217477	1547	0	221849
15269	212840	147	2473	730	0	216190
15270	220664	110	1448	661	0	222883
15271	218462	130	582	562	0	219736
15272	212649	142	489	594	0	213874
15273	3663	214379	606	835	0	219483
15274	1734	209592	565	538	0	212429
15275	841	209574	609	628	0	211652
15276	1069	4496	774	184956	0	191295
15277	525	196044	499	2147	0	199215
15278	189461	2117	382	1318	0	193278
15279	2115	191010	525	689	0	194339
15280	1426	194194	434	687	0	196741
15281	830	2945	399	191263	0	195437
15282	746	1532	361	195329	0	197968
15283	191470	527	366	3204	0	195567
15284	2384	460	371	193521	0	196736
15285	1572	528	189682	2477	0	194259
15286	875	543	183377	1606	0	186401
15287	909	522	189225	776	0	191432
15288	928	366	3157	178228	0	182679
15289	916	356	1418	192277	0	194967
15290	941	549	189905	3309	0	194704
15291	959	512	187518	1637	0	190626
15292	872	621	192020	787	0	194300
15293	185031	564	3545	729	0	189869
15294	2531	623	1664	191290	0	196108
15295	1556	526	707	193878	0	196667
15296	191290	567	732	3609	0	196198
15297	2666	555	679	189511	0	193411
15298	1602	193153	798	2931	0	198484
15299	764	198914	660	2034	0	202372
15300	782	3324	518	195409	0	200033
15301	196376	1493	580	2932	0	201381
15302	196133	524	591	1997	0	199245
15303	199234	400	697	1100	0	201431
15304	3846	384	725	197009	0	201964
15305	2009	476	196000	2903	0	201388
15306	1015	327	2664	194332	0	198338
15307	1013	449	196130	3014	0	200606
15308	178494	391	2916	2138	0	183939
15309	2829	418	1862	188602	0	193711
15310	184315	327	1124	2954	0	188720
15311	2927	430	188111	2041	0	193509
15312	169581	390	2883	1330	0	174184
15313	3254	464	193246	1073	0	198037
15314	2175	184590	2692	1235	0	190692
15315	1204	181190	1736	1115	0	185245
15316	173856	3335	922	1019	0	179132
15317	2944	1730	637	172164	0	177475
15318	2042	915	174722	2765	0	180444
15319	1096	171637	2565	2040	0	177338
15320	998	175665	1776	1120	0	179559
15321	1201	3510	761	172691	0	178163
15322	174099	1585	773	2807	0	179264
15323	173720	657	751	1986	0	177114
15324	3625	174449	1141	1285	0	180500
15325	174570	2538	827	1159	0	179094
15326	3038	1527	928	173625	0	179118
15327	2194	800	173816	3098	0	179908
15328	1155	175382	2949	2238	0	181724
15329	1408	2494	1971	173829	0	179702
15330	1223	1533	1101	175715	0	179572
15331	173687	658	938	3829	0	179112
15332	3176	711	173185	1997	0	179069
15333	168683	718	2736	1071	0	173208
15334	171534	786	1807	973	0	175100
15335	4123	816	863	168987	0	174789
15336	2334	785	696	172507	0	176322
15337	167553	902	714	3773	0	172942
15338	3147	1029	733	167276	0	172185
15339	2048	1138	166564	2986	0	172736
15340	1161	1010	164694	2053	0	168918
15341	1064	163529	3346	1295	0	169234
15342	1131	171805	1696	1398	0	176030
15343	1298	3626	788	153812	0	159524
15344	1092	166359	777	2611	0	170839
15345	163975	2692	727	2028	0	169422
15346	2567	169270	995	1346	0	174178
15347	1887	2701	776	167172	0	172536
15348	1101	1631	745	170911	0	174388
15349	999	925	169577	4050	0	175551
15350	1086	588	2784	166431	0	170889
15351	1118	549	2003	168880	0	172550
15352	915	172535	1292	4041	0	178783
15353	1043	2418	1119	169156	0	173736
15354	1061	1480	947	172768	0	176256
15355	1341	879	169557	4327	0	176104
15356	928	165948	2835	2607	0	172318
15357	1030	9865	1609	136426	0	148930
15358	742	151055	870	2301	0	154968
15359	897	2029	142678	1717	0	147321
15360	606	136968	2002	957	0	140533
15361	103351	2423	2147	1109	0	109030
15362	98982	679	324	364	0	100349
15363	98616	305	148	315	0	99384
15364	1272	99543	212	292	0	101319
15365	98136	833	141	270	0	99380
15366	953	680	201	97335	0	99169
15367	95900	283	153	903	0	97239
15368	857	96413	156	775	0	98201
15369	96285	861	130	368	0	97644
15370	98419	612	160	327	0	99518
15371	1325	101433	248	388	0	103394
15372	791	997	102120	336	0	104244
15373	315	705	939	108565	0	110524
15374	303	344	117927	1200	0	119774
15375	274	243	1223	119162	0	120902
15376	283	254	808	126628	0	127973
15377	311	316	129495	2023	0	132145
15378	264	226	1367	129198	0	131055
15379	129847	218	1100	1638	0	132803
15380	1493	271	132409	1105	0	135278
15381	917	132722	1452	537	0	135628
15382	405	1407	897	129247	0	131956
15383	343	967	248	133642	0	135200
15384	352	354	133324	2229	0	136259
15385	309	331	1421	121966	0	124027
15386	227	132505	1000	1466	0	135198
15387	125855	1385	329	1065	0	128634
15388	1142	131073	329	487	0	133031
15389	121248	1339	239	333	0	123159
15390	1114	126949	222	420	0	128705
15391	762	129171	308	404	0	130645
15392	360	1918	123950	343	0	126571
15393	294	1163	1410	123524	0	126391
15394	269	294	871	123952	0	125386
15395	248	202	281	125722	0	126453
15396	215	130662	340	2102	0	133319
15397	259	1390	257	131224	0	133130
15398	128790	983	225	1741	0	131739
15399	1468	346	313	129498	0	131625
15400	127268	239	286	1812	0	129605
15401	1623	321	129122	1258	0	132324
15402	126056	271	1548	607	0	128482
15403	1549	361	1020	128473	0	131403
15404	1047	313	326	132263	0	133949
15405	133028	328	358	2533	0	136247
15406	1606	391	135583	1346	0	138926
15407	973	135017	1618	731	0	138339
15408	388	1656	1007	133215	0	136266
15409	135691	1149	396	1674	0	138910
15410	136002	516	276	1195	0	137989
15411	2377	475	270	134181	0	137303
15412	1151	496	136213	1749	0	139609
15413	126599	436	1528	1215	0	129778
15414	1555	456	133040	636	0	135687
15415	1197	432	1554	129306	0	132489
15416	445	405	132365	1904	0	135119
15417	458	448	1512	129289	0	131707
15418	395	362	128548	1920	0	131225
15419	417	128339	1512	1555	0	131823
15420	795	1517	991	108029	0	111332
15421	417	128631	457	1433	0	130938
15422	128633	1440	333	1134	0	131540
15423	128237	919	411	626	0	130193
15424	2324	442	127269	590	0	130625
15425	1282	319	1474	125049	0	128124
15426	126802	305	1097	1719	0	129923
15427	1707	320	456	126129	0	128612
15428	1277	312	402	124365	0	126356
15429	690	387	124092	2357	0	127526
15430	114161	354	1582	1500	0	117597
15431	1762	334	125087	796	0	127979
15432	1368	290	1622	120903	0	124183
15433	763	313	124998	1841	0	127915
15434	122072	295	1716	1452	0	125535
15435	124013	232	1368	794	0	126407
15436	122987	337	752	716	0	124792
15437	2347	289	683	120962	0	124281
15438	1285	415	121831	1891	0	125422
15439	634	444	123243	1467	0	125788
15440	612	652	2455	108423	0	112142
15441	502	121123	1483	1692	0	124800
15442	115969	1492	693	1421	0	119575
15443	1805	1142	520	116243	0	119710
15444	1338	559	117702	1871	0	121470
15445	929	490	1584	117642	0	120645
15446	905	400	122100	1900	0	125305
15447	866	470	1798	120701	0	123835
15448	740	379	125539	2078	0	128736
15449	800	305	124053	1636	0	126794
15450	660	120289	2549	1295	0	124793
15451	768	1311	122260	1045	0	125384
15452	826	971	121661	987	0	124445
15453	1041	691	2537	94603	0	98872
15454	936	473	1402	100411	0	103222
15455	767	115769	874	2115	0	119525
15456	114470	1222	839	1271	0	117802
15457	1867	115538	798	819	0	119022
15458	1463	1344	764	111464	0	115035
15459	113299	897	794	1698	0	116688
15460	1759	342	764	112614	0	115479
15461	113015	290	907	1877	0	116089
15462	1725	291	877	114934	0	117827
15463	1312	412	116534	1959	0	120217
15464	822	413	1771	115674	0	118680
15465	798	385	1303	115838	0	118324
15466	116411	302	1006	2387	0	120106
15467	116089	308	998	1562	0	118957
15468	111545	249	1081	1069	0	113944
15469	2130	113028	1144	1040	0	117342
15470	1129	109597	1051	979	0	112756
15471	105860	1550	1144	822	0	109376
15472	1371	941	109784	815	0	112911
15473	1014	522	103727	699	0	105962
15474	1043	3384	2027	87706	0	94160
15475	568	278	93051	1070	0	94967
15476	528	216	87107	867	0	88718
15477	76555	320	1778	626	0	79279
15478	76397	216	834	530	0	77977
15479	1172	82724	523	551	0	84970
15480	795	84138	480	611	0	86024
15481	635	1198	564	63889	0	66286
15482	470	83632	576	809	0	85487
15483	84899	620	599	746	0	86864
15484	921	576	497	75975	0	77969
15485	706	85628	507	903	0	87744
15486	87559	677	467	692	0	89395
15487	991	513	89949	494	0	91947
15488	797	255	88369	469	0	89890
15489	84662	185	1320	518	0	86685
15490	989	204	88021	483	0	89697
15491	81687	134	991	507	0	83319
15492	899	237	799	86389	0	88324
15493	704	313	87934	904	0	89855
15494	432	87059	999	719	0	89209
15495	399	88732	828	454	0	90413
15496	81025	652	672	317	0	82666
15497	483	83512	559	447	0	85001
15498	80073	347	553	340	0	81313
15499	79458	304	472	280	0	80514
15500	738	80999	449	291	0	82477
15501	488	487	314	80545	0	81834
15502	301	403	83192	507	0	84403
15503	172	87554	698	476	0	88900
15504	266	1949	579	85745	0	88539
15505	188	490	279	91954	0	92911
15506	89708	83	131	941	0	90863
15507	559	69	121	89842	0	90591
15508	438	86	89985	693	0	91202
15509	99	89584	686	620	0	90989
15510	110	678	540	89822	0	91150
15511	90552	440	281	683	0	91956
15512	91506	102	158	563	0	92329
15513	1009	133	223	91998	0	93363
15514	93228	74	266	718	0	94286
15515	809	197	95288	582	0	96876
15516	630	83	840	93689	0	95242
15517	263	176	97872	790	0	99101
15518	177	108	820	101499	0	102604
15519	150	136	663	101512	0	102461
15520	149	168	153	102706	0	103176
15521	229	111	136	102241	0	102717
15522	176	155	91	102786	0	103208
15523	100675	118	97	1672	0	102562
15524	101241	94	89	931	0	102355
15525	1445	102722	154	441	0	104762
15526	103167	839	93	377	0	104476
15527	1016	664	93	103372	0	105145
15528	867	111	189	104243	0	105410
15529	334	115	119	104308	0	104876
15530	339	139	105089	1736	0	107303
15531	382	158	927	96461	0	97928
15532	303	103814	766	1014	0	105897
15533	102525	886	198	848	0	104457
15534	101254	790	184	329	0	102557
15535	1662	280	102112	319	0	104373
15536	908	102169	988	522	0	104587
15537	295	906	858	101251	0	103310
15538	315	802	102831	1036	0	104984
15539	311	248	993	92739	0	94291
15540	210	100238	942	1099	0	102489
15541	95817	951	333	881	0	97982
15542	963	99079	253	724	0	101019
15543	946	981	98013	371	0	100311
15544	440	867	97899	305	0	99511
15545	264	96629	1526	337	0	98756
15546	191	93749	763	338	0	95041
15547	90019	1460	445	276	0	92200
15548	89607	777	152	278	0	90814
15549	1492	211	162	88660	0	90525
15550	841	256	89134	1004	0	91235
15551	277	186	870	87613	0	88946
15552	269	162	701	88506	0	89638
15553	86908	143	167	1599	0	88817
15554	85421	192	196	944	0	86753
15555	1558	187	178	89841	0	91764
15556	881	192	91154	1138	0	93365
15557	268	91201	972	1031	0	93472
15558	90100	967	805	408	0	92280
15559	998	93834	249	378	0	95459
15560	978	1020	198	93300	0	95496
15561	339	916	168	96119	0	97542
15562	310	261	209	95795	0	96575
15563	249	233	209	93947	0	94638
15564	91022	199	255	2009	0	93485
15565	1114	248	207	91499	0	93068
15566	993	90739	217	1399	0	93348
15567	334	1036	152	91422	0	92944
15568	88077	874	185	1431	0	90567
15569	1055	89166	257	1337	0	91815
15570	1006	1051	192	88888	0	91137
15571	400	963	87481	1414	0	90258
15572	83271	271	1068	1231	0	85841
15573	1255	306	890	85908	0	88359
15574	1130	270	85084	1368	0	87852
15575	458	264	84049	1236	0	86007
15576	556	661	1781	82391	0	85389
15577	82391	225	1185	1369	0	85170
15578	82266	233	321	1205	0	84025
15579	1813	83962	295	679	0	86749
15580	82607	1022	225	581	0	84435
15581	82233	858	250	590	0	83931
15582	82319	231	253	598	0	83401
15583	80498	245	265	588	0	81596
15584	1942	253	237	78521	0	80953
15585	1175	243	193	78408	0	80019
15586	484	265	75608	2018	0	78375
15587	406	71960	1004	1327	0	74697
15588	370	73650	869	687	0	75576
15589	484	1628	71770	582	0	74464
15590	69052	918	1065	511	0	71546
15591	1215	307	901	70596	0	73019
15592	71340	302	280	1200	0	73122
15593	70295	254	252	1116	0	71917
15594	1800	291	69521	510	0	72122
15595	1071	290	973	67324	0	69658
15596	68317	247	894	1182	0	70640
15597	1182	262	290	68324	0	70058
15598	1088	326	67902	1239	0	70555
15599	545	2113	980	62000	0	65638
15600	422	68411	948	1043	0	70824
15601	412	68787	309	992	0	70500
15602	682	1483	64262	408	0	66835
15603	322	60705	914	419	0	62360
15604	54005	1075	1116	607	0	56803
15605	50120	572	257	357	0	51306
15606	1046	151	163	49350	0	50710
15607	651	140	171	49737	0	50699
15608	288	136	135	50480	0	51039
15609	49185	151	119	1069	0	50524
15610	668	49428	173	676	0	50945
15611	47854	536	123	264	0	48777
15612	46482	497	138	246	0	47363
15613	965	46755	173	244	0	48137
15614	43252	403	115	205	0	43975
15615	523	43593	125	205	0	44446
15616	43489	406	106	244	0	44245
15617	554	451	42561	217	0	43783
15618	35001	223	607	187	0	36018
15619	358	37083	351	169	0	37961
15620	519	322	381	36573	0	37795
15621	157	289	51	37874	0	38371
15622	149	87	40	38447	0	38723
15623	38455	61	58	716	0	39290
15624	411	87	53	38951	0	39502
15625	443	99	37833	422	0	38797
15626	36070	68	330	436	0	36904
15627	384	107	37439	162	0	38092
15628	431	116	350	36413	0	37310
15629	156	101	37767	389	0	38413
15630	143	128	347	35235	0	35853
15631	96	36915	405	341	0	37757
15632	138	309	101	35865	0	36413
15633	116	36827	113	372	0	37428
15634	180	320	67	36871	0	37438
15635	36682	333	63	402	0	37480
15636	423	94	62	38339	0	38918
15637	38524	62	76	406	0	39068
15638	479	85	37185	380	0	38129
15639	37206	81	290	162	0	37739
15640	38001	70	312	136	0	38519
15641	38002	80	86	132	0	38300
15642	703	81	83	37920	0	38787
15643	37743	76	73	372	0	38264
15644	447	136	36806	357	0	37746
15645	36458	82	333	178	0	37051
15646	431	108	37116	150	0	37805
15647	36645	60	347	150	0	37202
15648	445	70	343	37488	0	38346
15649	467	98	38850	385	0	39800
15650	202	82	346	38582	0	39212
15651	150	65	379	39371	0	39965
15652	209	94	39337	682	0	40322
15653	35179	71	368	502	0	36120
15654	385	40266	398	219	0	41268
15655	37985	277	104	180	0	38546
15656	319	38258	137	148	0	38862
15657	37057	273	99	146	0	37575
15658	341	244	36725	111	0	37421
15659	32195	201	353	153	0	32902
15660	266	33805	219	99	0	34389
15661	253	117	180	32811	0	33361
15662	95	127	41	34088	0	34351
15663	95	42	29	34837	0	35003
15664	108	47	35201	339	0	35695
15665	84	23	186	34825	0	35118
15666	94	41	37869	246	0	38250
15667	39196	38	240	224	0	39698
15668	42129	24	252	129	0	42534
15669	526	30	61	43338	0	43955
15670	342	54	44497	319	0	45212
15671	42302	27	319	364	0	43012
15672	401	59	56658	131	0	57249
15673	364	31	482	56233	0	57110
15674	115	35	385	58393	0	58928
15675	96	37	85	60157	0	60375
15676	62	26	70	60977	0	61135
15677	58616	42	59	942	0	59659
15678	464	60912	114	638	0	62128
15679	563	530	59775	126	0	60994
15680	106	60732	518	151	0	61507
15681	60001	511	431	109	0	61052
15682	512	486	99	60132	0	61229
15683	61110	61	67	571	0	61809
15684	557	52	87	61554	0	62250
15685	513	56	67	61528	0	62164
15686	127	55	70	62111	0	62363
15687	143	67	61344	1009	0	62563
15688	84	60581	554	681	0	61900
15689	220	498	61980	217	0	62915
15690	119	420	593	61021	0	62153
15691	62449	80	495	613	0	63637
15692	62030	58	129	598	0	62815
15693	62059	52	109	249	0	62469
15694	962	62620	143	210	0	63935
15695	63435	505	86	233	0	64259
15696	632	461	115	63245	0	64453
15697	570	118	124	63412	0	64224
15698	203	90	104	62828	0	63225
15699	158	63859	119	1093	0	65229
15700	260	544	113	57757	0	58674
15701	181	62548	145	635	0	63509
15702	61678	602	132	622	0	63034
15703	61772	481	149	274	0	62676
15704	1035	144	104	62425	0	63708
15705	655	129	62005	720	0	63509
15706	59682	101	584	688	0	61055
15707	684	125	513	62563	0	63885
15708	614	169	62245	802	0	63830
15709	58202	108	578	714	0	59602
15710	653	111	530	62590	0	63884
15711	61955	110	157	784	0	63006
15712	669	62047	164	713	0	63593
15713	638	596	128	60375	0	61737
15714	275	63023	142	720	0	64160
15715	312	764	105	62520	0	63701
15716	237	63338	162	813	0	64550
15717	284	688	121	63757	0	64850
15718	264	577	62973	734	0	64548
15719	50465	206	589	869	0	52129
15720	615	62347	543	425	0	63930
15721	635	542	60911	301	0	62389
15722	58666	445	550	314	0	59975
15723	633	148	450	61582	0	62813
15724	622	142	61589	726	0	63079
15725	264	62124	565	815	0	63768
15726	278	530	491	62803	0	64102
15727	321	497	64128	687	0	65633
15728	261	177	528	63687	0	64653
15729	266	157	462	64904	0	65789
15730	340	220	66240	1066	0	67866
15731	253	195	547	66220	0	67215
15732	296	287	68338	781	0	69702
15733	266	193	551	68092	0	69102
15734	299	273	72553	849	0	73974
15735	290	186	615	72245	0	73336
15736	304	220	513	72254	0	73291
15737	349	190	229	70305	0	71073
15738	273	72072	262	1132	0	73739
15739	71919	598	226	788	0	73531
15740	72235	523	266	419	0	73443
15741	1096	175	229	73409	0	74909
15742	73633	181	264	915	0	74993
15743	755	235	74017	814	0	75821
15744	589	76128	622	552	0	77891
15745	75858	572	554	564	0	77548
15746	636	77968	306	514	0	79424
15747	622	663	197	77574	0	79056
15748	274	630	244	78475	0	79623
15749	75889	260	260	1193	0	77602
15750	699	223	193	76580	0	77695
15751	702	246	76408	867	0	78223
15752	288	76000	619	863	0	77770
15753	75573	590	541	460	0	77164
15754	681	515	217	74289	0	75702
15755	598	77325	250	851	0	79024
15756	368	626	244	74771	0	76009
15757	288	79310	275	740	0	80613
15758	78700	638	212	750	0	80300
15759	78126	533	255	448	0	79362
15760	1101	283	78165	452	0	80001
15761	711	264	77816	416	0	79207
15762	342	195	868	75443	0	76848
15763	286	79057	548	732	0	80623
15764	289	518	226	79750	0	80783
15765	78785	448	214	813	0	80260
15766	512	210	76065	602	0	77389
15767	428	347	468	69974	0	71217
15768	202	155	72066	523	0	72946
15769	205	145	69656	475	0	70481
15770	145	73027	615	273	0	74060
15771	1230	1750	627	67796	0	71403
15772	60988	195	200	381	0	61764
15773	239	97	61418	195	0	61949
15774	117	60638	171	101	0	61027
15775	59361	98	119	94	0	59672
15776	101	84	28	59866	0	60079
15777	62669	37	33	222	0	62961
15778	64158	29	24	209	0	64420
15779	65150	22	15	151	0	65338
15780	217	109	70401	59	0	70786
15781	66244	30	135	110	0	66519
15782	71145	19	110	104	0	71378
15783	212	76662	90	100	0	77064
15784	152	212	26	77395	0	77785
15785	58	115	30	77755	0	77958
15786	58	44	25	79035	0	79162
15787	80053	28	30	338	0	80449
15788	77683	37	35	262	0	78017
15789	401	113	80469	94	0	81077
15790	232	25	199	78682	0	79138
15791	61	81092	227	284	0	81664
15792	81111	201	52	256	0	81620
15793	276	241	81967	70	0	82554
15794	229	55	217	79912	0	80413
15795	113	33	173	81563	0	81882
15796	68	83571	108	440	0	84187
15797	103	264	55	83899	0	84321
15798	91	196	36	83311	0	83634
15799	83	69	57	85082	0	85291
15800	84418	38	50	507	0	85013
15801	268	44	60	84450	0	84822
15802	228	61	48	84649	0	84986
15803	86511	49	50	576	0	87186
15804	340	77	30	86784	0	87231
15805	235	97867	102	424	0	98628
15806	102220	517	38	403	0	103178
15807	106028	387	63	255	0	106733
15808	109227	114	52	207	0	109600
15809	116819	66	49	260	0	117194
15810	1336	125056	151	318	0	126861
15811	138936	971	54	228	0	140189
15812	139967	657	47	230	0	140901
15813	1952	163	62	140063	0	142240
15814	989	201	142005	1309	0	144504
15815	335	89	1178	141320	0	142922
15816	292	78	758	142429	0	143557
15817	256	72	157	142079	0	142564
15818	230	85	81	142398	0	142794
15819	237	90	117	143402	0	143846
15820	139239	71	90	2231	0	141631
15821	1359	72	69	141111	0	142611
15822	980	143	145586	1576	0	148285
15823	402	117	1263	141498	0	143280
15824	195	147929	947	1688	0	150759
15825	313	1374	182	147733	0	149602
15826	316	877	148138	1563	0	150894
15827	126256	221	1435	1300	0	129212
15828	138506	124	853	519	0	140002
15829	2205	237	153778	423	0	156643
15830	1005	153647	1372	454	0	156478
15831	155938	1348	916	380	0	158582
15832	155757	814	202	382	0	157155
15833	156602	216	149	353	0	157320
15834	153331	128	176	349	0	153984
15835	2569	218	127	150683	0	153597
15836	1445	325	154421	1560	0	157751
15837	734	206	1421	153565	0	155926
15838	666	174	925	157761	0	159526
15839	657	290	158083	2474	0	161504
15840	556	387	156710	1545	0	159198
15841	150270	204	2413	814	0	153701
15842	1836	159238	1250	919	0	163243
15843	1470	1517	418	159040	0	162445
15844	729	1059	157459	2218	0	161465
15845	144195	244	1848	1961	0	148248
15846	1990	297	157473	1190	0	160950
15847	147964	238	1822	1227	0	151251
15848	1798	158093	1294	1369	0	162554
15849	1344	1660	460	158179	0	161643
15850	865	1139	158266	2342	0	162612
15851	144711	376	1844	1859	0	148790
15852	2004	158395	1526	1007	0	162932
15853	1493	164929	809	936	0	168167
15854	877	2650	568	162486	0	166581
15855	737	1535	591	167573	0	170436
15856	172366	633	566	3154	0	176719
15857	2498	172208	660	1963	0	177329
15858	2208	2003	566	173641	0	178418
15859	173784	1365	540	2538	0	178227
15860	176393	531	574	2028	0	179526
15861	180659	556	596	1108	0	182919
15862	4258	573	184657	1053	0	190541
15863	2578	437	187654	1027	0	191696
15864	186116	347	3595	1107	0	191165
15865	3122	195195	2128	1278	0	201723
15866	2329	197281	1063	1484	0	202157
15867	1267	4062	890	184256	0	190475
15868	843	196043	1021	3210	0	201117
15869	195681	2749	917	2395	0	201742
15870	3092	1886	1037	194514	0	200529
15871	2499	993	195825	3024	0	202341
15872	192391	626	2998	2329	0	198344
15873	196508	690	2186	1165	0	200549
15874	4817	717	991	195163	0	201688
15875	2849	579	896	197190	0	201514
15876	1534	599	1058	198643	0	201834
15877	1566	623	881	196601	0	199671
15878	1509	929	189167	4762	0	196367
15879	1227	188141	2910	3064	0	195342
15880	1433	3034	2100	164013	0	170580
15881	1144	186027	1090	3280	0	191541
15882	1539	3250	867	161686	0	167342
15883	1162	181249	906	3083	0	186400
15884	176270	3231	791	2572	0	182864
15885	176891	2162	783	1599	0	181435
15886	4788	177926	959	1441	0	185114
15887	177477	2921	866	1340	0	182604
15888	3953	2170	911	175564	0	182598
15889	174478	1160	876	3222	0	179736
15890	3807	174799	951	2658	0	182215
15891	175301	3104	970	1215	0	180590
15892	176092	2282	1069	1113	0	180556
15893	4928	1196	1112	172200	0	179436
15894	2991	1258	173016	3188	0	180453
15895	1607	171859	3117	2498	0	179081
15896	1547	3242	2127	171116	0	178032
15897	171086	2641	1042	3338	0	178107
15898	3624	1649	170550	2635	0	178458
15899	2947	1182	2749	167026	0	173904
15900	1737	1143	2027	170393	0	175300
15901	170321	837	1065	4853	0	177076
15902	170932	950	937	3085	0	175904
15903	168182	886	962	1830	0	171860
15904	4926	164846	1051	1868	0	172691
15905	154669	2637	831	1704	0	159841
15906	3210	1931	146904	1797	0	153842
15907	2325	1021	143508	1700	0	148554
15908	1446	1027	142175	1439	0	146087
15909	2026	6701	4614	120732	0	134073
15910	1137	916	121065	2185	0	125303
15911	103473	702	1583	1462	0	107220
15912	1896	661	994	104937	0	108488
15913	1634	667	106047	1812	0	110160
15914	105227	605	1413	1542	0	108787
15915	2072	567	1027	106792	0	110458
15916	1717	625	441	108568	0	111351
15917	108395	517	431	2442	0	111785
15918	2033	595	477	110191	0	113296
15919	1691	711	110505	1833	0	114740
15920	1105	600	1561	111333	0	114599
15921	1152	633	112724	1899	0	116408
15922	967	519	1755	109458	0	112699
15923	106735	495	1284	1964	0	110478
15924	1964	105540	729	1691	0	109924
15925	1699	108550	618	1084	0	111951
15926	1215	2215	546	106013	0	109989
15927	1078	1374	565	104306	0	107323
15928	987	105610	577	2573	0	109747
15929	1011	101217	651	1730	0	104609
15930	1017	2089	642	98660	0	102408
15931	963	1147	753	98651	0	101514
15932	93738	499	701	2740	0	97678
15933	1812	95579	767	1876	0	100034
15934	1526	95540	706	1106	0	98878
15935	917	97878	711	1027	0	100533
15936	91712	2100	769	960	0	95541
15937	1768	1176	91850	957	0	95751
15938	87968	512	1766	989	0	91235
15939	1825	429	1290	87291	0	90835
15940	1355	86471	753	1845	0	90424
15941	795	89935	601	1608	0	92939
15942	87319	1938	560	1004	0	90821
15943	1705	1163	571	80863	0	84302
15944	1251	91375	647	1832	0	95105
15945	92284	1424	635	1541	0	95884
15946	92526	1132	538	1005	0	95201
15947	2354	673	91907	925	0	95859
15948	90737	635	1463	888	0	93723
15949	91963	638	1106	924	0	94631
15950	2362	635	544	87029	0	90570
15951	1397	89276	549	1813	0	93035
15952	785	90003	461	1540	0	92789
15953	759	2361	371	85028	0	88519
15954	81398	1139	562	1649	0	84748
15955	1471	608	81239	1297	0	84615
15956	1247	460	74040	559	0	76306
15957	1344	540	72584	509	0	74977
15958	1210	437	72110	478	0	74235
15959	476	71183	1554	620	0	73833
15960	493	68940	1188	549	0	71170
15961	1188	1388	62989	450	0	66015
15962	805	942	59632	541	0	61920
15963	207	53289	993	361	0	54850
15964	513	349	539	44702	0	46103
15965	97	281	48075	295	0	48748
15966	72	86	319	46487	0	46964
15967	72	48	263	49340	0	49723
15968	80	44	92	50312	0	50528
15969	56	52	77	52141	0	52326
15970	94	62	52039	645	0	52840
15971	86	53	409	50300	0	50848
15972	51067	60	323	464	0	51914
15973	408	83	51021	346	0	51858
15974	50515	59	415	141	0	51130
15975	459	57	343	51937	0	52796
15976	349	95	53196	441	0	54081
15977	51808	76	483	345	0	52712
15978	459	95	356	53282	0	54192
15979	53959	55	117	508	0	54639
15980	490	109	114	51824	0	52537
15981	336	53243	130	514	0	54223
15982	176	461	54987	381	0	56005
15983	85	317	498	54129	0	55029
15984	55481	111	385	506	0	56483
15985	55551	100	140	431	0	56222
15986	55911	82	122	194	0	56309
15987	55757	78	125	191	0	56151
15988	54331	116	114	186	0	54747
15989	713	55167	155	183	0	56218
15990	55453	454	144	186	0	56237
15991	552	389	55009	160	0	56110
15992	54529	148	510	181	0	55368
15993	583	155	561	45034	0	46333
15994	433	139	55395	353	0	56320
15995	176	164	55387	338	0	56065
15996	170	120	778	53977	0	55045
15997	55246	114	427	538	0	56325
15998	533	55580	204	465	0	56782
15999	54975	519	149	208	0	55851
16000	586	56235	155	238	0	57214
16001	473	546	149	56553	0	57721
16002	243	431	177	57547	0	58398
16003	57230	165	175	851	0	58421
16004	644	118	183	57885	0	58830
16005	507	159	58273	627	0	59566
16006	56856	138	563	482	0	58039
16007	639	130	455	59470	0	60694
16008	499	145	228	59345	0	60217
16009	294	154	59426	899	0	60773
16010	54505	148	622	548	0	55823
16011	58219	119	482	224	0	59044
16012	882	59030	268	341	0	60521
16013	593	547	57715	215	0	59070
16014	301	408	56493	232	0	57434
16015	261	449	887	54716	0	56313
16016	265	203	523	53763	0	54754
16017	206	55474	290	916	0	56886
16018	271	531	54046	472	0	55320
16019	247	370	610	52154	0	53381
16020	233	129	53771	632	0	54765
16021	211	145	628	49755	0	50739
16022	188	52344	495	624	0	53651
16023	229	491	293	52863	0	53876
16024	225	367	232	52956	0	53780
16025	220	134	209	52566	0	53129
16026	51405	120	234	925	0	52684
16027	643	141	51739	550	0	53073
16028	452	53327	641	347	0	54767
16029	242	557	475	54985	0	56259
16030	55994	418	220	788	0	57420
16031	740	112	206	56933	0	57991
16032	57176	109	218	841	0	58344
16033	822	97	57787	704	0	59410
16034	56944	110	714	327	0	58095
16035	837	106	549	58506	0	59998
16036	679	151	59020	890	0	60740
16037	305	58594	787	731	0	60417
16038	329	686	590	57604	0	59209
16039	340	533	221	58306	0	59400
16040	55386	156	234	1155	0	56931
16041	765	56894	260	741	0	58660
16042	610	55872	248	341	0	57071
16043	304	56984	222	388	0	57898
16044	51204	972	206	285	0	52667
16045	745	52365	207	311	0	53628
16046	690	649	165	50509	0	52013
16047	386	444	133	51243	0	52206
16048	50455	128	135	1033	0	51751
16049	663	50309	170	593	0	51735
16050	565	571	135	50404	0	51675
16051	51253	437	141	734	0	52565
16052	50954	124	160	534	0	51772
16053	50538	105	132	276	0	51051
16054	976	50365	161	272	0	51774
16055	47549	498	112	172	0	48331
16056	610	464	109	46161	0	47344
16057	415	46087	108	546	0	47156
16058	182	46770	109	473	0	47534
16059	284	792	162	45933	0	47171
16060	45742	350	115	523	0	46730
16061	46254	126	93	434	0	46907
16062	739	136	82	44292	0	45249
16063	371	44975	115	538	0	45999
16064	44887	429	112	423	0	45851
16065	518	355	43953	189	0	45015
16066	370	155	42930	179	0	43634
16067	41061	97	634	162	0	41954
16068	497	130	41683	148	0	42458
16069	318	106	356	38448	0	39228
16070	39011	80	297	401	0	39789
16071	392	81	91	39932	0	40496
16072	327	85	40042	399	0	40853
16073	108	41140	354	410	0	42012
16074	116	405	265	41158	0	41944
16075	137	305	41035	387	0	41864
16076	38012	112	324	349	0	38797
16077	366	97	246	40625	0	41334
16078	320	125	40840	377	0	41662
16079	135	71	319	39600	0	40125
16080	111	40992	277	376	0	41756
16081	131	358	69	42233	0	42791
16082	131	270	70	41996	0	42467
16083	134	98	89	41182	0	41503
16084	122	41609	122	560	0	42413
16085	42469	330	83	396	0	43278
16086	351	288	81	42966	0	43686
16087	329	133	72	43224	0	43758
16088	145	87	67	43928	0	44227
16089	145	148	43570	650	0	44513
16090	148	105	329	43587	0	44169
16091	43666	119	268	478	0	44531
16092	370	44468	123	430	0	45391
16093	345	387	55	45192	0	45979
16094	141	344	57	45533	0	46075
16095	45219	136	62	677	0	46094
16096	403	45954	95	453	0	46905
16097	46690	399	55	222	0	47366
16098	47657	313	54	227	0	48251
16099	708	133	55	47399	0	48295
16100	47722	107	59	479	0	48367
16101	461	46599	90	443	0	47593
16102	47321	401	60	200	0	47982
16103	536	344	63	48422	0	49365
16104	51829	123	59	544	0	52555
16105	52272	113	56	431	0	52872
16106	868	153	52175	175	0	53371
16107	51590	109	405	162	0	52266
16108	53031	97	330	169	0	53627
16109	54668	80	81	183	0	55012
16110	1024	134	57555	126	0	58839
16111	538	57819	664	185	0	59206
16112	208	683	458	57649	0	58998
16113	57727	503	96	720	0	59046
16114	702	57174	107	574	0	58557
16115	57396	660	93	171	0	58320
16116	762	475	70	58243	0	59550
16117	640	150	58477	736	0	60003
16118	59199	83	683	562	0	60527
16119	812	77	503	61664	0	63056
16120	655	106	62205	755	0	63721
16121	61334	82	777	649	0	62842
16122	940	109	65367	179	0	66595
16123	703	100	807	66257	0	67867
16124	252	79	589	69801	0	70721
16125	69924	82	151	1488	0	71645
16126	69365	81	103	827	0	70376
16127	1524	70441	115	305	0	72385
16128	70264	814	203	224	0	71505
16129	1014	604	67850	147	0	69615
16130	717	141	68709	148	0	69715
16131	66296	89	1332	131	0	67848
16132	853	69060	671	186	0	70770
16133	67150	744	173	130	0	68197
16134	850	67941	160	152	0	69103
16135	67323	770	157	108	0	68358
16136	932	536	116	66222	0	67806
16137	715	165	67617	838	0	69335
16138	295	84	786	66770	0	67935
16139	259	66	566	68358	0	69249
16140	67503	84	182	1312	0	69081
16141	941	168	67619	664	0	69392
16142	65343	73	788	279	0	66483
16143	903	67031	642	216	0	68792
16144	67274	773	180	157	0	68384
16145	998	597	151	66153	0	67899
16146	759	226	66376	860	0	68221
16147	330	95	851	66142	0	67418
16148	66512	121	643	919	0	68195
16149	976	119	199	66792	0	68086
16150	743	97	176	65466	0	66482
16151	301	65075	176	1348	0	66900
16152	316	786	167	65866	0	67135
16153	326	596	65292	959	0	67173
16154	299	152	874	64984	0	66309
16155	308	121	672	65715	0	66816
16156	64692	120	220	1435	0	66467
16157	966	150	187	64428	0	65731
16158	832	157	63923	984	0	65896
16159	359	64177	895	848	0	66279
16160	371	818	686	63714	0	65589
16161	369	632	203	64439	0	65643
16162	64984	221	197	1366	0	66768
16163	1018	64224	236	851	0	66329
16164	762	852	241	64614	0	66469
16165	63745	612	194	959	0	65510
16166	64419	196	187	800	0	65602
16167	1502	160	236	64365	0	66263
16168	916	198	65276	1060	0	67450
16169	63866	181	901	827	0	65775
16170	1141	183	707	66877	0	68908
16171	67556	143	302	1138	0	69139
16172	66816	154	242	901	0	68113
16173	1593	65602	255	510	0	67960
16174	65077	874	261	388	0	66600
16175	1170	66434	255	383	0	68242
16176	932	952	232	65692	0	67808
16177	494	748	258	63969	0	65469
16178	402	65812	274	1507	0	67995
16179	66199	901	247	922	0	68269
16180	65200	684	260	516	0	66660
16181	1586	317	63744	449	0	66096
16182	984	260	63471	428	0	65143
16183	502	204	1393	63431	0	65530
16184	64325	184	781	1214	0	66504
16185	1161	165	310	63994	0	65630
16186	942	184	295	64632	0	66053
16187	464	234	65543	1653	0	67894
16188	503	197	65188	987	0	66875
16189	503	279	65720	503	0	67005
16190	60805	199	1581	519	0	63104
16191	63469	218	849	465	0	65001
16192	1583	63117	351	459	0	65510
16193	989	64075	295	485	0	65844
16194	482	1465	268	63350	0	65565
16195	474	761	63500	1054	0	65789
16196	60475	289	915	980	0	62659
16197	1137	233	65045	530	0	66945
16198	865	220	955	62539	0	64579
16199	432	182	687	64275	0	65576
16200	442	187	276	64666	0	65571
16201	411	183	260	65578	0	66432
16202	64062	151	260	1635	0	66108
16203	1094	262	230	62928	0	64514
16204	834	166	60696	1076	0	62772
16205	54442	137	909	885	0	56373
16206	935	147	59531	462	0	61075
16207	758	167	59331	382	0	60638
16208	352	58574	1296	386	0	60608
16209	742	619	1255	52356	0	54972
16210	52619	406	337	610	0	53972
16211	582	172	129	52832	0	53715
16212	524	147	52808	678	0	54157
16213	236	91	482	52754	0	53563
16214	51988	69	466	666	0	53189
16215	548	52822	184	706	0	54260
16216	51164	426	125	316	0	52031
16217	557	51502	173	267	0	52499
16218	49639	417	177	271	0	50504
16219	467	49860	136	268	0	50731
16220	408	49383	141	223	0	50155
16221	453	602	47101	138	0	48294
16222	236	46736	436	184	0	47592
16223	40778	233	459	99	0	41569
16224	263	246	68	40339	0	40916
16225	40827	62	39	192	0	41120
16226	199	41933	68	269	0	42469
16227	41386	187	37	97	0	41707
16228	256	231	42020	73	0	42580
16229	248	61	200	40904	0	41413
16230	67	42691	256	273	0	43287
16231	78	209	62	43669	0	44018
16232	77	232	31	43770	0	44110
16233	48989	55	40	494	0	49578
16234	421	50163	70	349	0	51003
16235	50680	451	73	111	0	51315
16236	563	443	51471	112	0	52589
16237	488	127	50606	89	0	51310
16238	120	50630	918	189	0	51857
16239	101	470	493	50538	0	51602
16240	164	459	51786	503	0	52912
16241	101	108	543	48970	0	49722
16242	110	76	454	52578	0	53218
16243	112	99	52607	950	0	53768
16244	123	87	51996	522	0	52728
16245	115	85	53777	151	0	54128
16246	147	82	53892	156	0	54277
16247	78	55261	1027	227	0	56593
16248	132	569	571	54812	0	56084
16249	117	550	164	56027	0	56858
16250	160	175	55671	1028	0	57034
16251	90	121	590	54601	0	55402
16252	119	141	58078	684	0	59022
16253	114	90	633	57241	0	58078
16254	107	83	569	56132	0	56891
16255	90	58088	223	1062	0	59463
16256	127	588	126	58470	0	59311
16257	127	551	139	58096	0	58913
16258	127	187	126	58680	0	59120
16259	178	163	57401	1146	0	58888
16260	95	57377	644	725	0	58841
16261	56914	606	543	276	0	58339
16262	56758	565	184	209	0	57716
16263	1035	161	139	56414	0	57749
16264	634	147	155	54963	0	55899
16265	182	58118	159	1067	0	59526
16266	57225	609	127	633	0	58594
16267	567	58844	227	294	0	59932
16268	56561	598	195	239	0	57593
16269	659	616	56349	181	0	57805
16270	51953	183	614	222	0	52972
16271	576	55938	625	226	0	57365
16272	528	572	230	55668	0	56998
16273	174	519	175	54783	0	55651
16274	90	56452	180	1023	0	57745
16275	56110	571	157	637	0	57475
16276	611	533	171	56647	0	57962
16277	558	180	167	57752	0	58657
16278	57667	148	163	1109	0	59087
16279	57753	136	157	708	0	58754
16280	1090	144	58202	283	0	59719
16281	57552	139	644	289	0	58624
16282	692	129	604	58712	0	60137
16283	604	180	58958	703	0	60445
16284	217	138	666	57852	0	58873
16285	179	156	58662	775	0	59772
16286	190	174	58279	692	0	59335
16287	154	201	1120	56954	0	58429
16288	161	204	58849	783	0	59997
16289	128	59562	783	843	0	61316
16290	167	636	647	59079	0	60529
16291	165	611	230	61117	0	62123
16292	202	232	61428	1196	0	63058
16293	139	61624	719	845	0	63327
16294	60978	647	614	384	0	62623
16295	672	598	239	62322	0	63831
16296	62652	211	183	851	0	63897
16297	740	62247	265	786	0	64038
16298	785	791	62969	303	0	64848
16299	248	691	802	61773	0	63514
16300	61460	211	742	876	0	63289
16301	742	218	62408	784	0	64152
16302	57754	159	838	391	0	59142
16303	772	61624	762	362	0	63520
16304	566	60689	331	326	0	61912
16305	60208	1023	335	277	0	61843
16306	708	584	348	59971	0	61611
16307	585	186	316	59339	0	60426
16308	173	61752	281	1190	0	63396
16309	154	654	237	62987	0	64032
16310	175	564	249	63058	0	64046
16311	62047	162	224	1323	0	63756
16312	626	125	218	62311	0	63280
16313	571	138	62652	881	0	64242
16314	215	121	783	62159	0	63278
16315	146	117	687	64534	0	65484
16316	200	194	65027	1286	0	66707
16317	132	212	660	64766	0	65770
16318	64170	127	586	1044	0	65927
16319	62554	138	230	891	0	63813
16320	63406	133	230	454	0	64223
16321	1171	156	188	63689	0	65204
16322	696	215	64722	895	0	66528
16323	302	65343	689	841	0	67175
16324	292	661	523	65493	0	66969
16325	303	650	67181	783	0	68917
16326	223	197	607	65964	0	66991
16327	222	173	530	67106	0	68031
16328	65449	161	192	1179	0	66981
16329	644	68885	232	905	0	70666
16330	644	716	67661	369	0	69390
16331	61360	500	652	315	0	62827
16332	698	67315	537	341	0	68891
16333	318	61843	166	241	0	62568
16334	63372	549	457	209	0	64587
16335	502	340	115	64188	0	65145
16336	382	177	72510	500	0	73569
16337	179	135	402	70554	0	71270
16338	96	73162	403	525	0	74186
16339	73550	399	141	489	0	74579
16340	442	401	87	74545	0	75475
16341	76651	99	86	580	0	77416
16342	509	73	79	75094	0	75755
16343	393	79526	138	547	0	80604
16344	80171	421	66	464	0	81122
16345	78991	389	77	259	0	79716
16346	802	80431	157	258	0	81648
16347	78866	416	73	209	0	79564
16348	513	397	87	77170	0	78167
16349	415	78700	132	495	0	79742
16350	78961	442	68	475	0	79946
16351	466	80695	115	232	0	81508
16352	80345	480	76	196	0	81097
16353	529	408	85	80028	0	81050
16354	81585	139	86	576	0	82386
16355	82008	129	71	509	0	82717
16356	82316	147	75	242	0	82780
16357	852	122	66	82531	0	83571
16358	559	126	49	84010	0	84744
16359	82521	113	56	900	0	83590
16360	618	201	85712	526	0	87057
16361	540	128	474	84447	0	85589
16362	215	88391	489	632	0	89727
16363	248	557	88	89350	0	90243
16364	241	512	62	89772	0	90587
16365	286	278	89491	1026	0	91081
16366	269	150	533	94394	0	95346
16367	209	103282	511	900	0	104902
16368	232	985	124	106159	0	107500
16369	314	931	116985	1153	0	119383
16370	303	256	1233	116421	0	118213
16371	311	160	950	119574	0	120995
16372	116916	140	228	2380	0	119664
16373	117881	168	126	1322	0	119497
16374	2302	205	110	115241	0	117858
16375	1264	116930	183	1460	0	119837
16376	440	117690	181	1328	0	119639
16377	697	2131	116487	543	0	119858
16378	357	1340	1302	116307	0	119306
16379	116796	325	1080	1585	0	119786
16380	1432	265	276	118391	0	120364
16381	1157	311	118981	1685	0	122134
16382	425	213	1371	117640	0	119649
16383	386	206	1035	118972	0	120599
16384	360	192	283	121095	0	121930
16385	458	289	119269	2526	0	122542
16386	318	119688	1365	1532	0	122903
16387	116978	1403	1044	657	0	120082
16388	116090	1110	322	484	0	118006
16389	2372	386	189	115862	0	118809
16390	1401	393	116326	1615	0	119735
16391	502	116086	1432	1535	0	119555
16392	529	1719	1072	105239	0	108559
16393	360	115600	396	1446	0	117802
16394	323	116450	247	1228	0	118248
16395	112755	2173	384	555	0	115867
16396	1549	1266	114679	478	0	117972
16397	1244	467	114213	455	0	116379
16398	609	363	2183	110055	0	113210
16399	494	272	1153	113991	0	115910
16400	514	334	114849	2326	0	118023
16401	464	242	1372	110900	0	112978
16402	506	322	114317	1802	0	116947
16403	103268	241	1605	1490	0	106604
16404	1504	246	1129	112376	0	115255
16405	1233	413	114933	1675	0	118254
16406	561	396	1348	105141	0	107446
16407	412	117928	1208	1496	0	121044
16408	116179	1379	364	1323	0	119245
16409	1424	117774	395	761	0	120354
16410	117482	1471	347	721	0	120021
16411	1676	1244	116406	636	0	119962
16412	114607	446	1392	655	0	117100
16413	1625	405	1139	117045	0	120214
16414	1351	458	118224	1674	0	121707
16415	594	313	1486	116274	0	118667
16416	547	408	115808	1926	0	118689
16417	105077	324	1568	1645	0	108614
16418	1572	115991	1233	1029	0	119825
16419	1444	1438	539	106087	0	109508
16420	547	117206	493	1725	0	119971
16421	115418	1535	424	1461	0	118838
16422	114194	1182	436	862	0	116674
16423	2367	115749	491	861	0	119468
16424	1424	1543	439	114656	0	118062
16425	630	1214	473	114319	0	116636
16426	505	503	414	115202	0	116624
16427	111849	324	513	2955	0	115641
16428	1419	112588	603	2050	0	116660
16429	1267	1498	491	109557	0	112813
16430	504	1268	530	110855	0	113157
16431	107965	551	570	2818	0	111904
16432	1644	551	107539	1883	0	111617
16433	1432	513	106422	1133	0	109500
16434	99583	330	2286	1027	0	103226
16435	1714	432	103180	809	0	106135
16436	1240	521	94044	721	0	96526
16437	680	527	2195	90445	0	93847
16438	93490	389	1367	1580	0	96826
16439	1438	371	568	93380	0	95757
16440	1213	369	92697	1685	0	95964
16441	85645	383	1410	1391	0	88829
16442	1512	411	90902	837	0	93662
16443	1037	90684	1554	695	0	93970
16444	639	1400	1263	92324	0	95626
16445	93783	889	654	1596	0	96922
16446	1284	399	562	94037	0	96282
16447	1022	273	589	95033	0	96917
16448	97102	251	402	2336	0	100091
16449	1364	227	419	98469	0	100479
16450	1124	277	448	100466	0	102315
16451	569	348	100028	2249	0	103194
16452	436	294	1336	98974	0	101040
16453	100366	305	1080	1673	0	103424
16454	99464	343	496	1296	0	101599
16455	100183	366	476	640	0	101665
16456	2156	419	411	97085	0	100071
16457	1231	98343	484	1337	0	101395
16458	98160	1140	418	1085	0	100803
16459	1290	99401	597	644	0	101932
16460	96621	1180	369	575	0	98745
16461	1387	866	423	96089	0	98765
16462	95086	281	398	1327	0	97092
16463	94642	211	384	1178	0	96415
16464	94701	148	464	560	0	95873
16465	1841	94568	418	615	0	97442
16466	739	87123	343	472	0	88677
16467	79834	748	172	325	0	81079
16468	596	82394	216	343	0	83549
16469	214	73197	78	143	0	73632
16470	128	72570	135	109	0	72942
16471	72212	498	469	130	0	73309
16472	348	333	63	72060	0	72804
16473	296	70	11	73879	0	74256
16474	73922	24	18	641	0	74605
16475	347	118	78173	368	0	79006
16476	356	38	292	87121	0	87807
16477	127	45	321	90213	0	90706
16478	70	43	66	98534	0	98713
16479	90	47	31	100874	0	101042
16480	60	103387	128	1529	0	105104
16481	49	116748	164	930	0	117891
16482	116879	1793	37	315	0	119024
16483	1223	1005	45	119023	0	121296
16484	973	222	48	120485	0	121728
16485	349	214	119517	2315	0	122395
16486	179	97	1266	119145	0	120687
16487	222	234	122544	1575	0	124575
16488	134	101	1448	121442	0	123125
16489	270	172	126814	1643	0	128899
16490	78	125754	1639	1408	0	128879
16491	148	1372	1130	126210	0	128860
16492	127688	1109	258	1531	0	130586
16493	126277	243	160	1254	0	127934
16494	2457	132	111	126845	0	129545
16495	1403	213	128132	1636	0	131384
16496	446	201	127994	1338	0	129979
16497	118380	114	2494	530	0	121518
16498	1337	126638	1449	503	0	129927
16499	128757	1437	333	319	0	130846
16500	127089	1163	189	361	0	128802
16501	2726	375	127358	261	0	130720
16502	1447	175	1516	123513	0	126651
16503	454	134	1273	128384	0	130245
16504	304	156	332	131668	0	132460
16505	335	157	239	128972	0	129703
16506	303	112	234	127926	0	128575
16507	360	221	122888	3025	0	126494
16508	317	254	122974	1702	0	125247
16509	283	157	2713	121753	0	124906
16510	332	153	1449	124187	0	126121
16511	367	129	388	125656	0	126540
16512	122986	201	325	3170	0	126682
16513	1706	171	272	123737	0	125886
16514	123698	201	341	2101	0	126341
16515	1944	191	300	125968	0	128403
16516	127282	169	253	2236	0	129940
16517	128209	188	280	1874	0	130551
16518	127378	134	300	759	0	128571
16519	127522	127	325	617	0	128591
16520	127131	145	340	624	0	128240
16521	3232	159	275	124795	0	128461
16522	124747	154	280	2074	0	127255
16523	1969	123777	335	1920	0	128001
16524	124441	1549	330	796	0	127116
16525	2044	1346	319	124871	0	128580
16526	1774	415	124340	2084	0	128613
16527	647	224	1813	124607	0	127291
16528	628	358	125952	2314	0	129252
16529	585	223	1950	123499	0	126257
16530	568	191	1556	126140	0	128455
16531	640	245	125239	3367	0	129491
16532	731	245	124839	2098	0	127913
16533	591	219	3062	122957	0	126829
16534	122847	169	1735	2360	0	127111
16535	2118	280	124570	2054	0	129022
16536	1774	123934	1951	1223	0	128882
16537	894	1723	128046	876	0	131539
16538	123192	1415	2116	836	0	127559
16539	2101	388	1681	125772	0	129942
16540	128566	222	647	2312	0	131747
16541	127832	204	467	2053	0	130556
16542	3361	199	438	127294	0	131292
16543	2132	302	124525	2344	0	129303
16544	902	149	1989	122377	0	125417
16545	739	174	1675	122492	0	125080
16546	118770	203	636	3665	0	123274
16547	2051	121578	633	2413	0	126675
16548	1905	1673	443	120705	0	124726
16549	923	1502	118962	2398	0	123785
16550	110137	368	2021	2214	0	114740
16551	2111	116279	1879	1143	0	121412
16552	2031	1671	660	116799	0	121161
16553	978	1443	521	116269	0	119211
16554	818	378	517	118769	0	120482
16555	113938	239	612	3715	0	118504
16556	116082	185	559	2332	0	119158
16557	3549	181	517	116482	0	120729
16558	2232	320	115636	2594	0	120782
16559	916	115653	2013	2455	0	121037
16560	115761	1659	1712	1118	0	120250
16561	117451	1426	718	996	0	120591
16562	3636	326	542	114963	0	119467
16563	2237	219	535	117515	0	120506
16564	1065	325	116382	3809	0	121581
16565	728	116332	2072	2455	0	121587
16566	116612	1769	1817	1122	0	121320
16567	112079	1448	643	911	0	115081
16568	3289	111800	596	992	0	116677
16569	108493	1541	387	828	0	111249
16570	2310	1287	374	106729	0	110700
16571	1850	452	105901	2239	0	110442
16572	940	237	1726	105905	0	108808
16573	828	265	105826	2395	0	109314
16574	100274	169	1870	1932	0	104245
16575	1920	101435	1613	1077	0	106045
16576	1502	1670	459	89663	0	93294
16577	705	1108	89829	1717	0	93359
16578	607	337	84275	1288	0	86507
16579	74119	431	2076	668	0	77294
16580	1237	76292	1163	492	0	79184
16581	62495	558	1287	334	0	64674
16582	61000	532	391	247	0	62170
16583	61023	138	183	257	0	61601
16584	1138	229	182	59791	0	61340
16585	748	191	60426	633	0	61998
16586	311	60523	558	631	0	62023
16587	313	758	611	60348	0	62030
16588	301	524	61453	615	0	62893
16589	243	212	57640	504	0	58599
16590	171	192	743	56164	0	57270
16591	169	130	56831	506	0	57636
16592	52947	97	489	517	0	54050
16593	452	139	441	56648	0	57680
16594	467	109	153	57921	0	58650
16595	57637	88	164	776	0	58665
16596	432	57298	186	568	0	58484
16597	60191	376	148	285	0	61000
16598	491	382	136	59683	0	60692
16599	544	142	136	60074	0	60896
16600	252	108	122	60602	0	61084
16601	224	77	129	59682	0	60112
16602	57975	104	164	845	0	59088
16603	512	128	59182	553	0	60375
16604	457	58808	437	272	0	59974
16605	218	350	411	58955	0	59934
16606	58184	381	165	485	0	59215
16607	58373	93	154	496	0	59116
16608	666	59437	186	274	0	60563
16609	57579	314	142	248	0	58283
16610	404	59289	159	226	0	60078
16611	413	61387	180	258	0	62238
16612	259	622	143	61359	0	62383
16613	234	430	62103	465	0	63232
16614	191	362	336	60315	0	61204
16615	59762	126	389	488	0	60765
16616	369	60180	180	492	0	61221
16617	441	318	110	60400	0	61269
16618	225	401	67568	464	0	68658
16619	66860	122	357	551	0	67890
16620	70670	90	363	296	0	71419
16621	71265	118	155	253	0	71791
16622	701	188	70117	173	0	71179
16623	67201	110	344	222	0	67877
16624	400	70957	415	222	0	71994
16625	412	399	151	67760	0	68722
16626	227	71874	157	395	0	72653
16627	72465	349	196	443	0	73453
16628	70099	353	133	231	0	70816
16629	667	223	75002	163	0	76055
16630	374	75945	416	245	0	76980
16631	208	396	434	75746	0	76784
16632	177	374	144	76326	0	77021
16633	217	122	136	76241	0	76716
16634	221	110	111	78172	0	78614
16635	211	133	136	79206	0	79686
16636	230	144	77044	833	0	78251
16637	162	76600	467	736	0	77965
16638	74935	404	431	243	0	76013
16639	633	435	77522	204	0	78794
16640	459	79763	492	291	0	81005
16641	79784	400	406	242	0	80832
16642	556	451	82987	165	0	84159
16643	80172	139	457	221	0	80989
16644	82105	159	428	266	0	82958
16645	81887	127	178	216	0	82408
16646	810	85592	173	443	0	87018
16647	715	551	84374	242	0	85882
16648	179	87891	545	264	0	88879
16649	366	627	462	74335	0	75790
16650	162	88258	171	486	0	89077
16651	88044	483	143	464	0	89134
16652	90355	424	83	259	0	91121
16653	89077	172	117	268	0	89634
16654	1079	212	91707	208	0	93206
16655	564	95222	625	276	0	96687
16656	247	609	503	100810	0	102169
16657	108469	540	130	740	0	109879
16658	864	109777	203	784	0	111628
16659	798	901	108	108707	0	110514
16660	294	777	112082	868	0	114021
16661	107525	173	936	778	0	109412
16662	1133	222	118316	188	0	119859
16663	922	154	119699	153	0	120928
16664	108988	149	1722	284	0	111143
16665	1146	180	117280	168	0	118774
16666	108949	116	1122	136	0	110323
16667	1070	113490	894	237	0	115691
16668	116770	943	265	178	0	118156
16669	1147	777	164	117024	0	119112
16670	979	175	145	117712	0	119011
16671	302	130	132	119560	0	120124
16672	118300	109	165	1824	0	120398
16673	117489	87	142	937	0	118655
16674	116717	141	141	275	0	117274
16675	1833	117127	241	312	0	119513
16676	997	1039	131	117784	0	119951
16677	385	871	117657	1126	0	120039
16678	301	204	1040	112819	0	114364
16679	244	115416	917	1241	0	117818
16680	345	1031	209	114222	0	115807
16681	313	866	176	114687	0	116042
16682	114169	226	154	1839	0	116388
16683	1161	168	133	115022	0	116484
16684	983	254	115093	1276	0	117606
16685	413	243	113592	1053	0	115301
16686	359	183	1852	112981	0	115375
16687	111833	156	1028	1250	0	114267
16688	1232	204	338	111077	0	112851
16689	1107	151	257	112696	0	114211
16690	452	209	113000	1946	0	115607
16691	350	111437	1324	1216	0	114327
16692	420	1169	1015	110896	0	113500
16693	108765	916	433	1265	0	111379
16694	1226	110780	357	1194	0	113557
16695	1135	1090	241	110284	0	112750
16696	546	1004	110829	1326	0	113705
16697	393	273	1197	107832	0	109695
16698	105944	251	1033	1438	0	108666
16699	1246	106287	411	1365	0	109309
16700	1245	1189	107375	504	0	110313
16701	537	1018	1176	104031	0	106762
16702	483	396	108075	1456	0	110410
16703	102857	276	1348	1201	0	105682
16704	105007	285	1055	581	0	106928
16705	2119	413	105871	489	0	108892
16706	1278	292	1286	102942	0	105798
16707	647	396	107779	1431	0	110253
16708	488	105970	1519	1572	0	109549
16709	465	1228	1238	106068	0	108999
16710	584	1065	106517	1501	0	109667
16711	588	438	1510	98114	0	100650
16712	537	103537	1293	1490	0	106857
16713	584	1288	577	102773	0	105222
16714	533	1069	102957	1631	0	106190
16715	96229	412	1519	1414	0	99574
16716	1470	101338	1300	779	0	104887
16717	101538	1304	513	714	0	104069
16718	1606	1117	94862	683	0	98268
16719	91223	406	1463	656	0	93748
16720	1695	421	93034	706	0	95856
16721	90296	359	1610	644	0	92909
16722	92451	379	1222	673	0	94725
16723	2279	358	582	90898	0	94117
16724	1429	336	559	91862	0	94186
16725	90659	395	562	2358	0	93974
16726	1566	90453	641	1615	0	94275
16727	90382	1287	631	778	0	93078
16728	1722	1036	620	86914	0	90292
16729	1353	86862	731	1628	0	90574
16730	836	1295	637	87951	0	90719
16731	779	993	625	88191	0	90588
16732	712	404	621	86453	0	88190
16733	678	86833	641	2528	0	90680
16734	83982	1160	506	1489	0	87137
16735	1514	1017	438	84196	0	87165
16736	1293	435	83383	1730	0	86841
16737	687	412	82715	1484	0	85298
16738	657	396	83470	945	0	85468
16739	79671	379	2149	839	0	83038
16740	79561	355	1273	870	0	82059
16741	2078	416	78798	822	0	82114
16742	1206	436	1300	72658	0	75600
16743	580	386	1140	75098	0	77204
16744	523	385	76683	2166	0	79757
16745	457	445	76451	1361	0	78714
16746	507	348	1905	74490	0	77250
16747	73969	261	1200	1528	0	76958
16748	71865	270	629	1273	0	74037
16749	71288	237	614	731	0	72870
16750	1907	71435	660	727	0	74729
16751	1128	70863	624	669	0	73284
16752	652	1499	550	67866	0	70567
16753	67266	779	486	1297	0	69828
16754	1159	371	66017	1030	0	68577
16755	57575	294	1075	704	0	59648
16756	912	53860	735	490	0	55997
16757	481	44969	309	278	0	46037
16758	42957	726	365	292	0	44340
16759	559	43694	267	276	0	44796
16760	348	40237	251	221	0	41057
16761	35918	1227	1356	829	0	39330
16762	314	34825	194	210	0	35543
16763	180	203	81	31883	0	32347
16764	92	144	63	32228	0	32527
16765	32041	75	61	308	0	32485
16766	31582	54	77	213	0	31926
16767	294	32961	90	121	0	33466
16768	185	33154	62	126	0	33527
16769	120	311	32427	49	0	32907
16770	32157	285	252	80	0	32774
16771	34127	72	200	88	0	34487
16772	35161	43	77	83	0	35364
16773	339	48	63	35568	0	36018
16774	205	47	45	37112	0	37409
16775	37717	41	38	365	0	38161
16776	278	34	49	37913	0	38274
16777	215	56	38214	278	0	38763
16778	110	83	228	37559	0	37980
16779	73	39642	181	300	0	40196
16780	96	266	58	39943	0	40363
16781	82	192	43	41191	0	41508
16782	82	80	38	41629	0	41829
16783	40558	44	30	499	0	41131
16784	280	41177	75	304	0	41836
16785	240	265	51	41693	0	42249
16786	92	233	41809	331	0	42465
16787	100	103	40955	264	0	41422
16788	96	75	449	40819	0	41439
16789	84	45	242	41480	0	41851
16790	41029	38	88	490	0	41645
16791	321	65	46	40191	0	40623
16792	238	40649	75	451	0	41413
16793	167	280	42518	307	0	43272
16794	108	276	301	42555	0	43240
16795	94	92	44366	372	0	44924
16796	89	64	320	43701	0	44174
16797	43767	61	240	365	0	44433
16798	44158	49	95	286	0	44588
16799	451	44933	99	197	0	45680
16800	283	301	50	44448	0	45082
16801	46809	203	50	342	0	47404
16802	47496	80	61	280	0	47917
16803	48208	63	85	154	0	48510
16804	48409	52	69	136	0	48666
16805	48039	53	70	107	0	48269
16806	519	47650	95	126	0	48390
16807	46093	245	48	108	0	46494
16808	332	207	46520	74	0	47133
16809	221	53	224	45783	0	46281
16810	47247	43	165	256	0	47711
16811	46939	40	50	208	0	47237
16812	47206	33	50	86	0	47375
16813	434	80	47960	86	0	48560
16814	276	46	222	48047	0	48591
16815	50455	35	154	272	0	50916
16816	270	52058	73	223	0	52624
16817	54715	252	39	153	0	55159
16818	54111	180	34	125	0	54450
16819	54851	69	41	134	0	55095
16820	480	53	52	56513	0	57098
16821	57895	40	51	359	0	58345
16822	388	84	60004	238	0	60714
16823	283	82	60000	104	0	60469
16824	58848	62	473	159	0	59542
16825	376	82	61810	106	0	62374
16826	56255	51	303	100	0	56709
16827	364	68	61571	90	0	62093
16828	270	67	265	59497	0	60099
16829	60437	35	209	344	0	61025
16830	311	62793	115	306	0	63525
16831	62908	259	78	146	0	63391
16832	301	63503	91	147	0	64042
16833	237	67150	120	165	0	67672
16834	172	410	68	68087	0	68737
16835	111	192	79	68349	0	68731
16836	87	78	46	68596	0	68807
16837	156	97	68327	470	0	69050
16838	63840	56	326	331	0	64553
16839	70561	46	245	164	0	71016
16840	71229	43	92	149	0	71513
16841	71490	48	77	126	0	71741
16842	71064	60	228	149	0	71501
16843	634	109	70415	111	0	71269
16844	383	115	70439	98	0	71035
16845	185	50	488	70727	0	71450
16846	160	106	73535	392	0	74193
16847	68198	46	398	337	0	68979
16848	454	76913	311	165	0	77843
16849	399	372	85	79489	0	80345
16850	79936	278	99	500	0	80813
16851	582	70	72	82876	0	83600
16852	504	126	85642	505	0	86777
16853	252	123	87020	385	0	87780
16854	187	55	795	89604	0	90641
16855	229	118	91042	563	0	91952
16856	85093	71	572	483	0	86219
16857	590	97	402	90800	0	91889
16858	537	125	92184	605	0	93451
16859	161	93273	593	613	0	94640
16860	185	478	413	95895	0	96971
16861	260	433	98448	630	0	99771
16862	200	117	629	95655	0	96601
16863	192	69	481	98929	0	99671
16864	252	128	101699	1105	0	103184
16865	226	55	678	100396	0	101355
16866	210	60	550	99972	0	100792
16867	178	50	168	102218	0	102614
16868	99833	59	146	1192	0	101230
16869	674	101726	216	762	0	103378
16870	557	103773	205	300	0	104835
16871	297	1115	101417	224	0	103053
16872	94708	515	712	254	0	96189
16873	753	191	102202	168	0	103314
16874	675	179	100872	169	0	101895
16875	180	154	1037	98001	0	99372
16876	100482	49	567	680	0	101778
16877	576	102327	227	747	0	103877
16878	102106	561	175	319	0	103161
16879	99888	473	127	230	0	100718
16880	964	103256	177	280	0	104677
16881	102466	546	195	223	0	103430
16882	100628	485	200	221	0	101534
16883	927	104978	175	235	0	106315
16884	570	611	118	104966	0	106265
16885	295	532	143	106861	0	107831
16886	110195	126	107	1044	0	111472
16887	667	113489	209	692	0	115057
16888	115647	678	115	234	0	116674
16889	115634	577	90	230	0	116531
16890	121373	121	127	272	0	121893
16891	1452	82	110	120855	0	122499
16892	832	140	92	123364	0	124428
16893	123886	102	109	1466	0	125563
16894	125304	93	94	869	0	126360
16895	126083	95	109	301	0	126588
16896	1622	119	103	129491	0	131335
16897	975	258	131511	1006	0	133750
16898	320	95	949	132543	0	133907
16899	267	100	852	141204	0	142423
16900	484	235	141340	1966	0	144025
16901	363	233	150103	1173	0	151872
16902	288	96	2329	151170	0	153883
16903	346	201	154899	1605	0	157051
16904	152028	86	1631	1477	0	155222
16905	1609	106	1288	157139	0	160142
16906	1415	104	338	159137	0	160994
16907	160694	85	215	2876	0	163870
16908	1661	94	195	161542	0	163492
16909	1472	102	221	161553	0	163348
16910	438	102	213	163493	0	164246
16911	354	114	203	163853	0	164524
16912	395	240	160467	3062	0	164164
16913	338	92	1559	160261	0	162250
16914	411	232	158887	2071	0	161601
16915	286	159177	1727	2458	0	163648
16916	374	1544	1379	157444	0	160741
16917	450	1389	155988	1880	0	159707
16918	139514	257	1712	1867	0	143350
16919	1600	155108	1575	749	0	159032
16920	154544	1491	464	523	0	157022
16921	1882	1311	284	144568	0	148045
16922	1458	151494	406	1777	0	155135
16923	149949	1513	304	1646	0	153412
16924	1628	152773	332	803	0	155536
16925	151992	1653	274	570	0	154489
16926	1930	1428	288	149253	0	152899
16927	152377	337	273	1832	0	154819
16928	1793	153898	336	1909	0	157936
16929	152733	1602	330	731	0	155396
16930	2132	1488	151250	618	0	155488
16931	1702	357	1660	150724	0	154443
16932	149115	260	1570	2001	0	152946
16933	148944	221	426	1883	0	151474
16934	3127	240	327	146586	0	150280
16935	1983	333	148087	2027	0	152430
16936	656	144301	1826	1920	0	148703
16937	542	148508	1662	921	0	151633
16938	148272	2746	650	816	0	152484
16939	1921	1527	386	146861	0	150695
16940	1790	363	405	148105	0	150663
16941	146695	274	424	3241	0	150634
16942	142847	321	447	2078	0	145693
16943	3199	374	147340	864	0	151777
16944	1978	306	1782	145188	0	149254
16945	873	403	146466	2251	0	149993
16946	697	144952	1922	2222	0	149793
16947	136737	1610	1600	1111	0	141058
16948	1729	142173	686	1111	0	145699
16949	1566	141622	607	1007	0	144802
16950	1296	2743	588	139135	0	143762
16951	135202	1453	501	2176	0	139332
16952	1772	135651	616	2174	0	140213
16953	132476	1623	497	1169	0	135765
16954	1878	132083	601	1071	0	135633
16955	1820	1808	493	131390	0	135511
16956	129874	1467	562	2193	0	134096
16957	2036	665	132800	2118	0	137619
16958	1886	952	1818	129487	0	134143
16959	1108	598	131152	2341	0	135199
16960	834	125361	1868	2179	0	130242
16961	705	128403	1579	1192	0	131879
16962	123126	2757	796	1235	0	127914
16963	1684	127286	685	1205	0	130860
16964	125625	1730	648	1070	0	129073
16965	126126	1476	619	1081	0	129302
16966	2878	801	125395	919	0	129993
16967	122133	591	1718	989	0	125431
16968	2166	753	129000	1007	0	132926
16969	1880	127860	1815	940	0	132495
16970	126684	1725	1500	966	0	130875
16971	1998	128308	731	977	0	132014
16972	1914	1819	522	126546	0	130801
16973	127539	1540	456	2006	0	131541
16974	2204	761	494	127299	0	130758
16975	1974	713	129526	2228	0	134441
16976	1040	710	1624	127448	0	130822
16977	930	706	1449	129917	0	133002
16978	128061	720	569	3040	0	132390
16979	2165	816	129289	1929	0	134199
16980	128243	700	1667	1005	0	131615
16981	132583	657	1523	883	0	135646
16982	3254	668	629	130836	0	135387
16983	2172	683	516	131497	0	134868
16984	129167	683	560	2964	0	133374
16985	2191	134223	668	1932	0	139014
16986	2071	1834	473	129867	0	134245
16987	1167	1638	128039	1694	0	132538
16988	1004	843	123970	1688	0	127505
16989	877	128490	2479	907	0	132753
16990	1069	1717	1317	121680	0	125783
16991	871	1513	453	122980	0	125817
16992	120714	689	397	2495	0	124295
16993	1985	700	398	119128	0	122211
16994	114337	502	457	1759	0	117055
16995	1721	114145	448	1655	0	117969
16996	1327	114943	399	728	0	117397
16997	712	118056	466	619	0	119853
16998	112438	2131	907	693	0	116169
16999	103014	1096	661	577	0	105348
17000	1617	102900	328	593	0	105438
17001	89518	457	304	255	0	90534
17002	503	89798	134	250	0	90685
17003	491	627	91	86004	0	87213
17004	164	89621	114	552	0	90451
17005	88980	557	201	496	0	90234
17006	88856	419	80	193	0	89548
17007	782	177	84	86947	0	87990
17008	88131	127	69	565	0	88892
17009	604	167	94	87239	0	88104
17010	425	91818	145	550	0	92938
17011	263	731	108	90580	0	91682
17012	187	92185	147	583	0	93102
17013	91336	504	88	471	0	92399
17014	563	454	89453	200	0	90670
17015	84202	180	403	199	0	84984
17016	502	142	299	89874	0	90817
17017	440	212	90469	453	0	91574
17018	85575	130	411	486	0	86602
17019	542	197	94796	207	0	95742
17020	459	126	448	92711	0	93744
17021	230	138	322	95660	0	96350
17022	196	127	103	96160	0	96586
17023	201	131	97	97153	0	97582
17024	181	99558	175	943	0	100857
17025	262	579	104	104237	0	105182
17026	103952	447	126	813	0	105338
17027	781	209	105221	601	0	106812
17028	578	113105	723	270	0	114676
17029	114785	838	496	286	0	116405
17030	121203	727	141	269	0	122340
17031	1656	211	92	131007	0	132966
17032	1031	278	133010	1297	0	135616
17033	345	235	1163	130734	0	132477
17034	332	178	1029	134524	0	136063
17035	462	188	138370	2255	0	141275
17036	238	142127	1442	1435	0	145242
17037	144774	1516	1198	431	0	147919
17038	144775	1243	261	459	0	146738
17039	148257	269	226	438	0	149190
17040	2834	181	766	144946	0	148727
17041	1581	247	193	151261	0	153282
17042	153184	183	194	2890	0	156451
17043	2099	282	195	141809	0	144385
17044	1639	152157	271	1821	0	155888
17045	158351	1629	136	1535	0	161651
17046	160754	1380	170	583	0	162887
17047	167125	346	148	518	0	168137
17048	167341	237	179	583	0	168340
17049	3920	363	162028	459	0	166770
17050	2289	356	163184	427	0	166256
17051	913	302	3286	157713	0	162214
17052	801	235	1694	162022	0	164752
17053	813	261	163192	3464	0	167730
17054	799	291	163559	1901	0	166550
17055	748	221	3459	159279	0	163707
17056	161400	188	1944	2213	0	165745
17057	2317	198	718	158791	0	162024
17058	2098	267	160138	2443	0	164946
17059	761	160148	2283	2247	0	165439
17060	159512	1927	1947	903	0	164289
17061	160679	1573	747	757	0	163756
17062	161603	435	631	706	0	163375
17063	161084	292	573	709	0	162658
17064	4066	424	156490	653	0	161633
17065	2402	309	2225	154850	0	159786
17066	155356	372	1883	2372	0	159983
17067	2898	371	696	155669	0	159634
17068	2494	251	544	144862	0	148151
17069	1228	151915	595	3602	0	157340
17070	1182	2007	470	152819	0	156478
17071	148442	1600	591	2660	0	153293
17072	2493	151299	719	2440	0	156951
17073	145484	2078	546	1062	0	149170
17074	2680	151029	561	1177	0	155447
17075	2425	2345	519	134095	0	139384
17076	1209	145094	684	2310	0	149297
17077	980	147945	708	2248	0	151881
17078	143107	3390	804	1106	0	148407
17079	2821	2122	143472	1176	0	149591
17080	2471	878	141354	1068	0	145771
17081	1304	826	140524	985	0	143639
17082	125177	856	3737	1044	0	130814
17083	2575	136525	2128	1193	0	142421
17084	2482	138916	907	1083	0	143388
17085	127557	3431	667	922	0	132577
17086	2821	131408	856	1004	0	136089
17087	2404	131816	970	1029	0	136219
17088	1471	3618	842	130449	0	136380
17089	1522	2162	129283	2788	0	135755
17090	1513	1150	130490	2338	0	135491
17091	1446	1074	3533	128294	0	134347
17092	126240	954	2264	2739	0	132197
17093	2930	129416	1239	2462	0	136047
17094	2804	2621	930	129283	0	135638
17095	1861	2161	129066	2851	0	135939
17096	1820	1173	124537	2509	0	130039
17097	1682	999	3913	120289	0	126883
17098	120143	952	2459	3114	0	126668
17099	121531	956	1233	2656	0	126376
17100	4634	1016	120275	1510	0	127435
17101	119011	864	2873	1488	0	124236
17102	3664	925	120552	1388	0	126529
17103	3349	719	3045	106394	0	113507
17104	2130	117211	2669	2713	0	124723
17105	118683	2372	1489	2257	0	124801
17106	3630	2077	1290	117990	0	124987
17107	3222	972	1475	118138	0	123807
17108	2256	834	1482	120288	0	124860
17109	1994	769	1459	120707	0	124929
17110	2037	852	113616	4568	0	121073
17111	1934	112542	3064	3058	0	120598
17112	1952	2346	2722	112862	0	119882
17113	111797	1955	1702	3324	0	118778
17114	3245	985	1495	113770	0	119495
17115	2871	881	1506	114664	0	119922
17116	1861	1001	112199	4610	0	119671
17117	1823	1016	111221	3200	0	117260
17118	1770	108560	4306	1980	0	116616
17119	1654	108218	2817	2007	0	114696
17120	1663	3556	1468	105130	0	111817
17121	104995	2302	1310	3216	0	111823
17122	3140	1271	104309	2899	0	111619
17123	2732	102115	2783	1778	0	109408
17124	2022	2448	2308	90174	0	96952
17125	1492	95558	1168	2675	0	100893
17126	1658	2465	1012	86616	0	91751
17127	1415	91891	1060	2658	0	97024
17128	1476	2196	932	82490	0	87094
17129	77985	1799	871	2328	0	82983
17130	1896	71260	813	1839	0	75808
17131	1199	2270	528	57278	0	61275
17132	55228	1127	538	1591	0	58484
17133	1296	55953	549	1294	0	59092
17134	842	49489	451	747	0	51529
17135	765	49410	477	671	0	51323
17136	956	1504	933	42279	0	45672
17137	333	874	472	41126	0	42805
17138	254	41372	289	1181	0	43096
17139	300	1016	329	40308	0	41953
17140	371	717	40471	823	0	42382
17141	265	38448	669	541	0	39923
17142	274	3553	463	30236	0	34526
17143	235	34842	319	558	0	35954
17144	347	562	32706	354	0	33969
17145	136	30637	518	178	0	31469
17146	22326	717	390	292	0	23725
17147	177	157	85	21547	0	21966
17148	21391	42	38	160	0	21631
17149	151	41	21939	132	0	22263
17150	122	46	136	22014	0	22318
17151	47	37	22910	165	0	23159
17152	44	31	138	22634	0	22847
17153	23458	39	114	178	0	23789
17154	140	35	43	23686	0	23904
17155	23448	45	35	179	0	23707
17156	116	24542	44	183	0	24885
17157	24095	131	30	91	0	24347
17158	153	130	25388	76	0	25747
17159	102	26737	145	91	0	27075
17160	61	130	111	26907	0	27209
17161	51	118	34	27341	0	27544
17162	49	63	27225	226	0	27563
17163	28	27957	144	214	0	28343
17164	52	159	105	26836	0	27152
17165	30	28541	47	147	0	28765
17166	42	165	25	27007	0	27239
17167	24	28321	31	173	0	28549
17168	27593	151	37	111	0	27892
17169	149	138	60	28142	0	28489
17170	131	73	28326	129	0	28659
17171	29	29111	129	190	0	29459
17172	48	29969	103	74	0	30194
17173	111	225	29331	48	0	29715
17174	30	29836	127	60	0	30053
17175	24	113	90	29309	0	29536
17176	50	122	30271	109	0	30552
17177	24	30	95	29572	0	29721
17178	16	23	97	30745	0	30881
17179	20	40	30788	180	0	31028
17180	27894	30	123	130	0	28177
17181	114	17	88	31118	0	31337
17182	110	46	34054	137	0	34347
17183	18	35094	114	124	0	35350
17184	35191	98	99	53	0	35441
17185	96	35636	33	61	0	35826
17186	100	110	14	35666	0	35890
17187	35878	89	30	148	0	36145
17188	99	28	17	35956	0	36100
17189	115	54	37667	120	0	37956
17190	35	20	105	37410	0	37570
17191	40	55	38264	122	0	38481
17192	35987	22	121	145	0	36275
17193	138	60	38751	48	0	38997
17194	38345	39	135	100	0	38619
17195	39074	25	105	80	0	39284
17196	205	62	40241	58	0	40566
17197	132	53	39536	54	0	39775
17198	27	40902	199	78	0	41206
17199	41794	125	111	76	0	42106
17200	146	111	40	42886	0	43183
17201	114	37	34	43259	0	43444
17202	48924	37	35	394	0	49390
17203	50166	41	29	217	0	50453
17204	50403	37	54	118	0	50612
17205	50568	27	34	93	0	50722
17206	211	49	38	50189	0	50487
17207	51113	34	33	213	0	51393
17208	147	28	43	51926	0	52144
17209	126	39	38	51937	0	52140
17210	67	35	34	52532	0	52668
17211	80	81	51792	285	0	52238
17212	60	51651	149	167	0	52027
17213	54	52258	148	102	0	52562
17214	55	194	49	52205	0	52503
17215	52270	117	34	199	0	52620
17216	145	37	44	52091	0	52317
17217	52107	35	40	188	0	52370
17218	177	74	55122	147	0	55520
17219	52549	48	134	141	0	52872
17220	157	41	111	56547	0	56856
17221	58488	42	56	235	0	58821
17222	58117	50	51	190	0	58408
17223	59860	55	44	137	0	60096
17224	248	54	34	59821	0	60157
17225	194	85	60363	183	0	60825
17226	71	41	141	59736	0	59989
17227	61353	42	146	228	0	61769
17228	222	110	70013	178	0	70523
17229	196	68	199	74101	0	74564
17230	77821	43	168	322	0	78354
17231	292	136	80703	228	0	81359
17232	84105	48	267	192	0	84612
17233	89049	41	226	220	0	89536
17234	523	50	59	90687	0	91319
17235	311	53	48	92921	0	93333
17236	93145	37	45	690	0	93917
17237	399	37	57	96226	0	96719
17238	94765	65	85	622	0	95537
17239	448	97725	118	556	0	98847
17240	305	98447	120	177	0	99049
17241	156	832	56	98544	0	99588
17242	184	441	100765	544	0	101934
17243	75	102207	539	496	0	103317
17244	99626	487	385	216	0	100714
17245	438	100553	138	297	0	101426
17246	437	562	100215	107	0	101321
17247	136	348	439	97701	0	98624
17248	206	289	102611	626	0	103732
17249	61	106397	533	608	0	107599
17250	151	532	326	103746	0	104755
17251	83	104899	152	512	0	105646
17252	238	546	104861	325	0	105970
17253	102	295	505	102331	0	103233
17254	136	207	106859	518	0	107720
17255	76	77	507	104690	0	105350
17256	106101	47	330	583	0	107061
17257	553	166	105251	353	0	106323
17258	99143	53	518	204	0	99918
17259	581	163	105177	125	0	106046
17260	372	39	524	103523	0	104458
17261	203	192	111323	559	0	112277
17262	158	49	501	110685	0	111393
17263	120	88	350	112257	0	112815
17264	133	53	109	111873	0	112168
17265	128	90	84	112617	0	112919
17266	187	202	119596	894	0	120879
17267	112645	68	558	686	0	113957
17268	567	122	358	129203	0	130250
17269	130759	96	153	679	0	131687
17270	134007	97	95	510	0	134709
17271	136696	85	125	344	0	137250
17272	1103	80	88	139859	0	141130
17273	619	113	128	140228	0	141088
17274	147	160474	214	1241	0	162076
17275	177755	1277	123	711	0	179866
17276	187270	881	143	351	0	188645
17277	189557	261	160	380	0	190358
17278	3261	281	193835	257	0	197634
17279	1684	130	1821	191531	0	195166
17280	647	309	194980	1950	0	197886
17281	188246	113	2046	1467	0	191872
17282	193468	95	1368	544	0	195475
17283	3084	127	404	191855	0	195470
17284	1768	227	252	181177	0	183424
17285	533	197957	316	2960	0	201766
17286	197263	1803	216	1524	0	200806
17287	196985	1273	206	581	0	199045
17288	3132	197905	389	569	0	201995
17289	199500	1839	214	421	0	201974
17290	2362	1323	238	199427	0	203350
17291	1608	381	247	201200	0	203436
17292	201174	194	239	3268	0	204875
17293	2227	349	202365	1760	0	206701
17294	199333	172	1874	761	0	202140
17295	202064	157	1338	574	0	204133
17296	3177	202460	579	669	0	206885
17297	204792	1902	252	440	0	207386
17298	2670	1524	202196	412	0	206802
17299	2049	475	1913	200889	0	205326
17300	202098	245	1414	2131	0	205888
17301	2473	196	535	203153	0	206357
17302	1869	417	199350	2405	0	204041
17303	887	192	2127	191480	0	194686
17304	702	212838	1668	2548	0	217756
17305	937	2119	568	216690	0	220314
17306	847	1482	363	219695	0	222387
17307	714	485	295	219469	0	220963
17308	624	387	266	220651	0	221928
17309	738	627	217026	3855	0	222246
17310	830	385	1976	216875	0	220066
17311	215321	373	1527	2761	0	219982
17312	2327	217002	721	2165	0	222215
17313	1925	2075	295	220925	0	225220
17314	1120	1618	223983	2534	0	229255
17315	780	504	2075	223352	0	226711
17316	226354	280	1622	2769	0	231025
17317	225379	239	668	2100	0	228386
17318	222688	273	463	987	0	224411
17319	4149	313	410	223775	0	228647
17320	2652	463	226124	2482	0	231721
17321	1173	225090	2366	2199	0	230828
17322	227006	1987	1738	1159	0	231890
17323	2608	1498	697	226062	0	230865
17324	2219	543	546	227400	0	230708
17325	1441	515	228505	3926	0	234387
17326	1054	226940	2381	2516	0	232891
17327	932	232674	1788	1450	0	236844
17328	1180	4265	866	221137	0	227448
17329	1071	1881	219105	2734	0	224791
17330	197916	735	2276	2527	0	203454
17331	2726	641	218688	1246	0	223301
17332	197930	453	2334	1336	0	202053
17333	2762	221569	1906	1452	0	227689
17334	2375	2108	220147	1178	0	225808
17335	208062	1573	2101	1051	0	212787
17336	2601	220718	1755	1121	0	226195
17337	227102	1936	1060	1059	0	231157
17338	3036	1757	230288	1034	0	236115
17339	2300	233143	2140	1124	0	238707
17340	236019	1956	1617	980	0	240572
17341	3104	1760	233311	1034	0	239209
17342	231286	596	2159	911	0	234952
17343	2927	527	1744	234002	0	239200
17344	236965	526	869	2332	0	240692
17345	2964	543	651	236376	0	240534
17346	236888	489	640	2808	0	240825
17347	2879	680	241972	2333	0	247864
17348	2258	457	2230	242358	0	247303
17349	1271	592	1711	244185	0	247759
17350	1160	915	247624	3762	0	253461
17351	1031	599	2163	244074	0	247867
17352	877	241780	2172	3007	0	247836
17353	1018	2082	900	266987	0	270987
17354	1085	1684	686	279161	0	282616
17355	1129	683	677	299484	0	301973
17356	1241	751	298602	5242	0	305836
17357	274200	537	3240	3471	0	281448
17358	3661	548	2387	315300	0	321896
17359	3154	779	326102	4056	0	334091
17360	310941	507	3753	3266	0	318467
17361	327711	492	2725	1525	0	332453
17362	337011	576	1078	1369	0	340034
17363	6716	567	783	336510	0	344576
17364	3760	490	880	362629	0	367759
17365	1810	635	782	348802	0	352029
17366	1202	357802	1136	7574	0	367714
17367	353972	4259	958	4267	0	363456
17368	350299	2833	856	2026	0	356014
17369	7482	989	803	347579	0	356853
17370	4490	744	345734	5086	0	356054
17371	2540	777	346551	3835	0	353703
17372	1064	337906	7227	2031	0	348228
17373	1007	345631	3742	1706	0	352086
17374	312288	7640	3258	2640	0	325826
17375	3360	312303	846	966	0	317475
17376	304396	3189	655	631	0	308871
17377	303278	1927	306	566	0	306077
17378	303394	440	267	541	0	304642
17379	5414	349	278	302441	0	308482
17380	2587	287	253	321027	0	324154
17381	325533	268	303	5511	0	331615
17382	3794	256	291	332739	0	337080
17383	2713	564	332866	4111	0	340254
17384	327916	298	3641	2632	0	334487
17385	4131	358	2307	331966	0	338762
17386	2945	371	433	336400	0	340149
17387	1015	318	304	341577	0	343214
17388	909	521	333646	6440	0	341516
17389	300851	341	4088	3421	0	308701
17390	4440	551	333569	1020	0	339580
17391	2976	332	4049	326990	0	334347
17392	1256	554	336505	4334	0	342649
17393	990	346	4233	325019	0	330588
17394	913	391	2718	332233	0	336255
17395	1215	579	338890	6438	0	347122
17396	1298	495	4168	301434	0	307395
17397	823	338412	2932	4082	0	346249
17398	334390	3864	739	3056	0	342049
17399	336026	2566	521	1278	0	340391
17400	6806	609	607	334243	0	342265
17401	3653	615	340237	4802	0	349307
17402	1127	331441	4408	3774	0	340750
17403	909	341012	3061	1660	0	346642
17404	323576	5996	996	1366	0	331934
17405	4791	2986	320311	1208	0	329296
17406	314917	670	4416	1291	0	321294
17407	4854	480	3041	319442	0	327817
17408	3427	511	995	323528	0	328461
17409	312184	486	808	7134	0	320612
17410	4394	316386	1004	4645	0	326429
17411	3662	4221	318627	1692	0	328202
17412	1631	2765	4514	304619	0	313529
17413	1421	945	320275	5242	0	327883
17414	1183	313940	4956	3875	0	323954
17415	1374	4157	3298	311925	0	320754
17416	311377	2801	1227	5090	0	320495
17417	310686	840	1154	3984	0	316664
17418	7322	1253	310886	1920	0	321381
17419	3833	310659	4772	1821	0	321085
17420	303955	4337	3186	1748	0	313226
17421	4903	311610	1430	1787	0	319730
17422	4076	4776	967	303937	0	313756
17423	304996	2966	1131	5146	0	314239
17424	5327	1052	1044	307643	0	315066
17425	4078	1058	303834	5567	0	314537
17426	2069	873	4594	302305	0	309841
17427	2042	1158	303972	5702	0	312874
17428	1910	929	4961	296503	0	304303
17429	297665	759	3506	5770	0	307700
17430	5024	299336	1788	4456	0	310604
17431	296202	4565	1313	2290	0	304370
17432	5472	3290	1344	290739	0	300845
17433	3967	1378	1243	290833	0	297421
17434	2122	1403	285515	7647	0	296687
17435	2055	1274	289330	4260	0	296919
17436	1882	285230	7361	2882	0	297355
17437	2211	4802	280682	1959	0	289654
17438	248347	3334	5405	2196	0	259282
17439	5196	271750	3963	2308	0	283217
17440	3998	274574	1873	2316	0	282761
17441	2006	276822	1582	2306	0	282716
17442	2068	7399	1291	267965	0	278723
17443	2171	3806	271394	5584	0	282955
17444	1765	273417	5174	4918	0	285274
17445	2189	4801	3663	245560	0	256213
17446	1753	274596	1925	5331	0	283605
17447	263634	4710	1640	4193	0	274177
17448	265563	3217	1624	2465	0	272869
17449	7393	1742	1676	261197	0	272008
17450	4137	1083	1684	259305	0	266209
17451	245142	1000	1634	7851	0	255627
17452	4734	240726	1865	4861	0	252186
17453	3513	240061	1747	2491	0	247812
17454	2199	7596	1599	216322	0	227716
17455	1396	2800	198423	4490	0	207109
17456	1083	194829	4095	3425	0	203432
17457	177206	3589	3496	1541	0	185832
17458	3203	176305	1551	1472	0	182531
17459	2227	171123	1262	1540	0	176152
17460	159052	4469	1865	1112	0	166498
17461	2840	164570	1037	1480	0	169927
17462	2523	3078	156971	1199	0	163771
17463	892	156460	3021	1210	0	161583
17464	126926	2236	2576	753	0	132491
17465	1690	128387	738	697	0	131512
17466	125673	1929	970	649	0	129221
17467	1994	1542	560	124069	0	128165
17468	1538	752	482	126713	0	129485
17469	810	808	126234	2699	0	130551
17470	610	127070	1652	1643	0	130975
17471	711	1772	1295	126254	0	130032
17472	125559	1504	592	1784	0	129439
17473	123624	690	516	1527	0	126357
17474	2437	126207	570	858	0	130072
17475	1483	1858	525	122344	0	126210
17476	122238	1470	536	1694	0	125938
17477	122502	814	586	1437	0	125339
17478	2628	719	118878	626	0	122851
17479	1525	694	110550	483	0	113252
17480	740	598	102718	464	0	104520
17481	291	94744	1824	395	0	97254
17482	85972	1080	2314	267	0	89633
17483	955	86402	430	286	0	88073
17484	83841	1028	497	231	0	85597
17485	936	87873	229	245	0	89283
17486	736	995	161	88676	0	90568
17487	89861	731	216	869	0	91677
17488	931	371	90727	686	0	92715
17489	87990	291	801	279	0	89361
17490	90396	301	642	224	0	91563
17491	1363	91058	239	317	0	92977
17492	694	91026	201	295	0	92216
17493	92691	1237	461	219	0	94608
17494	870	787	96615	192	0	98464
17495	90403	571	882	242	0	92098
17496	91606	250	652	211	0	92719
17497	1258	234	154	90208	0	91854
17498	92361	223	158	727	0	93469
17499	852	255	150	95042	0	96299
17500	725	263	119	97300	0	98407
17501	361	205	132	94289	0	94987
17502	280	96263	185	1170	0	97898
17503	96786	742	172	633	0	98333
17504	97841	627	176	254	0	98898
17505	1267	271	165	97595	0	99298
17506	820	249	179	95087	0	96335
17507	348	97490	242	1144	0	99224
17508	96932	812	231	652	0	98627
17509	958	734	96704	244	0	98640
17510	799	325	723	96144	0	97991
17511	399	328	96143	779	0	97649
17512	401	262	716	95129	0	96508
17513	439	290	97138	814	0	98681
17514	414	256	755	94113	0	95538
17515	94987	231	595	881	0	96694
17516	944	277	98372	745	0	100338
17517	93626	237	772	340	0	94975
17518	933	102406	699	395	0	104433
17519	844	806	242	102797	0	104689
17520	461	740	204	104791	0	106196
17521	107851	342	207	1314	0	109714
17522	1020	292	204	112338	0	113854
17523	937	341	117153	832	0	119263
17524	111879	250	763	869	0	113761
17525	118136	225	590	510	0	119461
17526	118460	234	220	464	0	119378
17527	118287	213	199	458	0	119157
17528	1472	117767	258	459	0	119956
17529	878	706	200	117149	0	118933
17530	116326	580	189	899	0	117994
17531	990	282	173	115215	0	116660
17532	113306	243	274	772	0	114595
17533	1024	290	111919	666	0	113899
17534	847	292	111875	364	0	113378
17535	492	1800	988	102346	0	105626
17536	400	110984	639	766	0	112789
17537	363	113991	292	788	0	115434
17538	110225	947	345	671	0	112188
17539	748	557	111324	396	0	113025
17540	100492	197	625	451	0	101765
17541	729	110993	588	357	0	112667
17542	110794	505	238	369	0	111906
17543	777	454	197	110352	0	111780
17544	700	306	114408	750	0	116164
17545	503	166	541	112936	0	114146
17546	438	197	483	111304	0	112422
17547	376	114434	250	987	0	116047
17548	340	118664	264	766	0	120034
17549	475	849	222	115983	0	117529
17550	441	121538	277	889	0	123145
17551	512	661	119449	609	0	121231
17552	445	590	118032	348	0	119415
17553	108165	251	943	437	0	109796
17554	119275	183	533	362	0	120353
17555	1087	119643	281	451	0	121462
17556	739	580	197	118036	0	119552
17557	456	544	210	119545	0	120755
17558	470	344	120766	962	0	122542
17559	376	413	637	112155	0	113581
17560	379	120311	541	920	0	122151
17561	378	686	117670	614	0	119348
17562	424	531	117481	371	0	118807
17563	396	115610	988	649	0	117643
17564	470	663	118131	377	0	119641
17565	406	516	605	115078	0	116605
17566	423	322	473	112509	0	113727
17567	414	340	120970	989	0	122713
17568	425	327	596	116423	0	117771
17569	321	119185	562	796	0	120864
17570	330	122501	318	820	0	123969
17571	348	1002	207	119335	0	120892
17572	532	502	122141	716	0	123891
17573	255	124989	639	727	0	126610
17574	592	1036	660	122809	0	125097
17575	283	488	122965	596	0	124332
17576	111216	150	445	509	0	112320
17577	122621	124	323	234	0	123302
17578	123319	110	169	224	0	123822
17579	695	98	125	120772	0	121690
17580	381	104	151	123432	0	124068
17581	282	221	129401	710	0	130614
17582	191	128	449	126678	0	127446
17583	197	129	349	131700	0	132375
17584	204	235	130521	737	0	131697
17585	102927	150	547	750	0	104374
17586	424	124978	433	339	0	126174
17587	124387	382	128	207	0	125104
17588	379	124660	190	324	0	125553
17589	348	486	119	124212	0	125165
17590	235	417	125155	493	0	126300
17591	184	230	427	120363	0	121204
17592	212	268	123923	512	0	124915
17593	94769	146	655	723	0	96293
17594	424	196	120852	162	0	121634
17595	295	103	481	113783	0	114662
17596	223	189	121877	526	0	122815
17597	137	126367	565	515	0	127584
17598	295	530	362	134969	0	136156
17599	232	352	147	138102	0	138833
17600	210	88	94	142495	0	142887
17601	220	179	142159	1313	0	143871
17602	169	212	146368	715	0	147464
17603	168	82	1416	142694	0	144360
17604	207	82	669	169132	0	170090
17605	174	98	194	179283	0	179749
17606	183189	85	196	2695	0	186165
17607	1686	151	165	190620	0	192622
17608	1335	264	197479	2009	0	201087
17609	199805	112	1891	1556	0	203364
17610	2138	149	1412	208629	0	212328
17611	215878	114	566	2434	0	218992
17612	219297	112	321	1853	0	221583
17613	3725	129	290	221244	0	225388
17614	222426	78	373	2676	0	225553
17615	222465	92	296	1919	0	224772
17616	4004	277	222426	682	0	227389
17617	1947	224777	2539	788	0	230051
17618	764	2255	1717	215136	0	219872
17619	641	1594	409	224168	0	226812
17620	223427	305	311	4067	0	228110
17621	220281	186	407	2262	0	223136
17622	218928	162	350	1062	0	220502
17623	4407	374	209422	1025	0	215228
17624	2396	211825	2698	890	0	217809
17625	211033	2284	1919	740	0	215976
17626	2690	214266	810	965	0	218731
17627	215041	2551	377	741	0	218710
17628	3254	1725	351	212695	0	218025
17629	213665	430	491	2933	0	217519
17630	213884	389	373	2207	0	216853
17631	215073	217	372	1066	0	216728
17632	4890	430	215044	875	0	221239
17633	212394	313	2519	858	0	216084
17634	3418	215555	1987	972	0	221932
17635	219302	2480	553	816	0	223151
17636	219685	1860	487	844	0	222876
17637	221477	598	436	874	0	223385
17638	5291	398	502	209500	0	215691
17639	2937	215230	631	2851	0	221649
17640	214781	2596	588	2212	0	220177
17641	3782	2044	215525	1122	0	222473
17642	3013	216242	2809	997	0	223061
17643	2143	2787	1927	192234	0	199091
17644	1630	213236	802	2487	0	218155
17645	211387	2841	643	1920	0	216791
17646	216250	2135	548	895	0	219828
17647	5327	875	515	213737	0	220454
17648	3321	803	211146	3353	0	218623
17649	1813	211461	2888	2833	0	218995
17650	2182	2927	2399	187174	0	194682
17651	1754	2196	898	212097	0	216945
17652	1753	880	768	218696	0	222097
17653	217507	599	726	5183	0	224015
17654	218653	696	786	2962	0	223097
17655	220124	849	621	1427	0	223021
17656	221468	702	608	1356	0	224134
17657	6106	816	640	216835	0	224397
17658	3965	828	219581	3619	0	227993
17659	2465	656	3040	220561	0	226722
17660	2224	637	2270	220869	0	226000
17661	2402	677	898	221745	0	225722
17662	2421	794	654	222495	0	226364
17663	217946	661	937	5938	0	225482
17664	4778	697	942	218953	0	225370
17665	219373	670	849	4353	0	225245
17666	219569	767	977	3471	0	224784
17667	6858	848	214396	2061	0	224163
17668	4642	874	213283	1947	0	220746
17669	3162	806	219255	2060	0	225283
17670	2987	947	4995	210936	0	219865
17671	3079	855	217544	3914	0	225392
17672	2694	940	3558	210583	0	217775
17673	2538	992	2580	211974	0	218084
17674	213816	858	1055	6061	0	221790
17675	5186	876	862	207740	0	214664
17676	4614	217240	1050	4435	0	227339
17677	218304	2996	1039	3488	0	225827
17678	5066	221825	1359	2282	0	230532
17679	4542	3593	222730	1913	0	232778
17680	2771	225113	3696	1958	0	233538
17681	218714	3628	2841	1797	0	226980
17682	5220	2672	1233	217738	0	226863
17683	4510	1383	217035	4238	0	227166
17684	215463	985	3400	3283	0	223131
17685	5358	999	2643	217324	0	226324
17686	4807	1184	218917	3980	0	228888
17687	3271	914	3500	218952	0	226637
17688	2807	1073	2822	219865	0	226567
17689	2867	1259	1373	217302	0	222801
17690	2826	219048	1289	5465	0	228628
17691	220481	3466	1123	3315	0	228385
17692	5242	2633	1213	214314	0	223402
17693	4162	218715	1162	4167	0	228206
17694	2793	3636	886	217870	0	225185
17695	2887	2950	215506	4211	0	225554
17696	2342	216033	3677	3380	0	225432
17697	210571	3270	2641	1973	0	218455
17698	203428	2650	1168	1731	0	208977
17699	5229	1299	987	195812	0	203327
17700	3506	1067	874	196447	0	201894
17701	194258	942	964	4708	0	200872
17702	187658	821	946	3234	0	192659
17703	4739	190912	1191	2080	0	198922
17704	161250	1961	1045	1135	0	165391
17705	2707	1392	154378	932	0	159409
17706	2130	577	152358	880	0	155945
17707	793	148475	2420	1020	0	152708
17708	597	144930	1472	779	0	147778
17709	130551	1859	2745	623	0	135778
17710	1212	132172	562	740	0	134686
17711	128309	894	551	486	0	130240
17712	126164	971	230	407	0	127772
17713	125352	235	206	408	0	126201
17714	1479	204	194	123703	0	125580
17715	125566	194	290	1031	0	127081
17716	1182	290	125864	847	0	128183
17717	972	301	127048	420	0	128741
17718	446	127577	1403	648	0	130074
17719	498	891	128743	486	0	130618
17720	498	751	981	121167	0	123397
17721	456	355	129564	1034	0	131409
17722	486	370	127782	885	0	129523
17723	440	269	1339	125487	0	127535
17724	128517	235	799	1024	0	130575
17725	129014	226	316	866	0	130422
17726	1503	303	137679	394	0	139879
17727	133727	215	985	545	0	135472
17728	1132	334	144198	391	0	146055
17729	140812	208	1014	458	0	142492
17730	150893	219	798	489	0	152399
17731	1531	204	436	150303	0	152474
17732	943	230	313	146660	0	148146
17733	827	147477	461	1532	0	150297
17734	403	151740	405	1022	0	153570
17735	485	1306	341	148932	0	151064
17736	462	790	312	151762	0	153326
17737	148125	301	281	1512	0	150219
17738	951	149731	379	1037	0	152098
17739	148552	880	299	493	0	150224
17740	947	152140	447	532	0	154066
17741	1020	1069	150628	380	0	153097
17742	497	834	917	149373	0	151621
17743	150218	290	807	1037	0	152352
17744	156670	249	265	922	0	158106
17745	1723	163829	386	558	0	166496
17746	981	169401	367	553	0	171302
17747	437	171938	348	574	0	173297
17748	553	2480	297	181580	0	184910
17749	653	1309	185951	1784	0	189697
17750	345	186875	1722	1421	0	190363
17751	636	1957	1194	184441	0	188228
17752	391	1113	293	188317	0	190114
17753	426	461	188789	2456	0	192132
17754	411	397	188341	1275	0	190424
17755	175304	275	2678	648	0	178905
17756	1887	387	194927	416	0	197617
17757	189415	293	1719	431	0	191858
17758	190340	263	1298	376	0	192277
17759	191275	278	418	364	0	192335
17760	190516	251	353	398	0	191518
17761	2870	388	187477	448	0	191183
17762	1432	188897	1804	579	0	192712
17763	636	1638	1292	188814	0	192380
17764	630	1500	190322	1752	0	194204
17765	546	417	1718	183926	0	186607
17766	507	186552	1611	1870	0	190540
17767	633	1785	523	195942	0	198883
17768	664	1307	451	196312	0	198734
17769	658	507	425	195950	0	197540
17770	193169	384	462	3010	0	197025
17771	2099	408	414	195988	0	198909
17772	1706	464	412	196209	0	198791
17773	744	443	554	194116	0	195857
17774	473	189970	679	3337	0	194459
17775	186968	1852	554	1827	0	191201
17776	1821	183806	605	1065	0	187297
17777	1529	185692	656	904	0	188781
17778	832	2852	693	185253	0	189630
17779	777	1652	471	186516	0	189416
17780	184576	492	550	3272	0	188890
17781	2231	428	507	187602	0	190768
17782	188294	393	444	2398	0	191529
17783	207781	428	523	1896	0	210628
17784	4316	470	505	207470	0	212761
17785	2496	465	515	203653	0	207129
17786	818	211600	626	4733	0	217777
17787	214359	2957	483	2720	0	220519
17788	3047	221837	578	1535	0	226997
17789	220928	3368	657	1035	0	225988
17790	3580	2633	219362	1064	0	226639
17791	214972	824	3043	1123	0	219962
17792	224947	589	2279	1158	0	228973
17793	5314	625	627	221389	0	227955
17794	3116	679	222621	3889	0	230305
17795	1160	223019	3435	3324	0	230938
17796	1263	3470	2402	225589	0	232724
17797	1398	2803	225768	3999	0	233968
17798	1067	1055	3353	222830	0	228305
17799	217411	771	2647	4135	0	224964
17800	4137	726	220137	3160	0	228160
17801	2901	217212	3641	1590	0	225344
17802	1418	222481	2722	1354	0	227975
17803	2012	5825	1071	184315	0	193223
17804	1151	220588	850	3001	0	225590
17805	218300	3727	638	2585	0	225250
17806	217272	2719	659	1327	0	221977
17807	218044	1077	697	1354	0	221172
17808	5930	1199	209389	1134	0	217652
17809	210669	912	3420	1348	0	216349
17810	4029	1001	2596	208475	0	216101
17811	3171	877	926	211181	0	216155
17812	1552	891	803	212706	0	215952
17813	1419	916	1597	213645	0	217577
17814	1493	1150	208406	6246	0	217295
17815	1338	1119	208721	3844	0	215022
17816	1454	876	206889	1935	0	211154
17817	189146	826	5786	1775	0	197533
17818	4091	200083	3221	2095	0	209490
17819	3405	3510	1340	197136	0	205391
17820	194850	2736	1006	4248	0	202840
17821	4074	199563	1125	3611	0	208373
17822	3342	203509	1115	1822	0	209788
17823	199174	5551	918	1489	0	207132
17824	198956	3189	952	1516	0	204613
17825	5947	199976	1103	1792	0	208818
17826	3878	3874	814	178475	0	187041
17827	1865	191437	947	3946	0	198195
17828	186047	3867	963	3213	0	194090
17829	185792	3101	891	1769	0	191553
17830	181482	1450	771	1714	0	185417
17831	6309	177396	962	1995	0	186662
17832	3672	3784	791	178785	0	187032
17833	2074	3083	177102	4576	0	186835
17834	1911	1496	3461	175091	0	181959
17835	1838	1309	2697	179190	0	185034
17836	1795	1505	173362	6217	0	182879
17837	167284	1106	3603	3746	0	175739
17838	4350	1217	2931	173000	0	181498
17839	3585	1320	1151	167492	0	173548
17840	1922	170169	1031	5960	0	179082
17841	167659	3855	914	3644	0	176072
17842	4559	3235	985	161560	0	170339
17843	3571	165617	977	4330	0	174495
17844	155076	3588	880	3301	0	162845
17845	3779	154194	968	1923	0	160864
17846	143466	3345	1028	1497	0	149336
17847	4005	2551	141000	1459	0	149015
17848	2624	1156	125303	1042	0	130125
17849	1410	884	121395	941	0	124630
17850	1176	119836	4300	1078	0	126390
17851	1930	2816	3317	100494	0	108557
17852	1154	114952	903	2302	0	119311
17853	113217	2687	775	1998	0	118677
17854	2838	2210	113465	969	0	119482
17855	110054	1015	2498	953	0	114520
17856	111783	932	2061	815	0	115591
17857	4177	836	931	109140	0	115084
17858	109198	740	2795	2636	0	115369
17859	3148	806	799	110801	0	115554
17860	2284	911	109649	2798	0	115642
17861	106144	965	2465	2168	0	111742
17862	2786	108878	2112	1064	0	114840
17863	2388	2536	910	108527	0	114361
17864	108592	1991	675	2558	0	113816
17865	3056	981	690	108862	0	113589
17866	2508	951	104206	2900	0	110565
17867	1352	803	2451	100864	0	105470
17868	1098	103592	2147	2754	0	109591
17869	102444	2496	825	2081	0	107846
17870	2853	1874	769	101340	0	106836
17871	101532	799	751	2657	0	105739
17872	3108	703	539	100788	0	105138
17873	2338	652	627	96113	0	99730
17874	1173	98973	780	3735	0	104661
17875	96810	2414	680	2096	0	102000
17876	2646	101717	678	1482	0	106523
17877	2173	2411	563	88149	0	93296
17878	1005	93724	526	2402	0	97657
17879	91739	2313	460	2001	0	96513
17880	89092	1782	636	975	0	92485
17881	90218	859	604	962	0	92643
17882	3539	86670	673	867	0	91749
17883	921	63719	234	400	0	65274
17884	61642	1368	247	394	0	63651
17885	1054	63582	230	391	0	65257
17886	1108	1758	451	57494	0	60811
17887	565	672	56091	879	0	58207
17888	49518	285	609	607	0	51019
17889	51603	190	438	260	0	52491
17890	50949	213	102	215	0	51479
17891	959	50894	105	307	0	52265
17892	48431	530	104	213	0	49278
17893	676	456	50254	181	0	51567
17894	444	48967	432	196	0	50039
17895	257	896	350	43089	0	44592
17896	121	44308	116	289	0	44834
17897	41983	249	138	253	0	42623
17898	252	44278	85	123	0	44738
17899	250	237	53	43505	0	44045
17900	98	44620	68	250	0	45036
17901	117	238	67	45668	0	46090
17902	134	214	54	45112	0	45514
17903	146	121	45170	392	0	45829
17904	105	78	222	44183	0	44588
17905	44149	95	199	292	0	44735
17906	44282	78	65	253	0	44678
17907	433	97	77	44634	0	45241
17908	292	134	44527	284	0	45237
17909	139	109	233	43941	0	44422
17910	44302	93	208	299	0	44902
17911	47839	74	91	355	0	48359
17912	48756	89	76	174	0	49095
17913	436	52722	110	156	0	53424
17914	53414	256	80	156	0	53906
17915	347	292	53037	110	0	53786
17916	57722	99	277	270	0	58368
17917	349	101	225	60388	0	61063
17918	312	83	79	61052	0	61526
17919	173	104	67	61672	0	62016
17920	60497	75	58	554	0	61184
17921	59532	92	49	367	0	60040
17922	557	80	68	60064	0	60769
17923	381	152	62917	357	0	63807
17924	214	88	266	62609	0	63177
17925	175	95	208	62863	0	63341
17926	227	164	63318	591	0	64300
17927	150	64234	299	429	0	65112
17928	212	290	237	65695	0	66434
17929	66393	247	94	406	0	67140
17930	348	118	64	66769	0	67299
17931	319	127	47	67649	0	68142
17932	68227	110	48	618	0	69003
17933	399	69221	90	406	0	70116
17934	284	70117	105	251	0	70757
17935	68852	468	46	187	0	69553
17936	408	327	69168	120	0	70023
17937	63638	111	277	220	0	64246
17938	434	158	74737	173	0	75502
17939	253	76051	335	203	0	76842
17940	76446	299	244	151	0	77140
17941	76689	248	62	194	0	77193
17942	77063	106	50	215	0	77434
17943	77721	81	48	196	0	78046
17944	556	149	78174	108	0	78987
17945	308	115	251	76124	0	76798
17946	77944	69	235	353	0	78601
17947	387	166	82889	262	0	83704
17948	354	145	82817	156	0	83472
17949	110	84076	503	143	0	84832
17950	83995	237	275	142	0	84649
17951	338	215	130	83572	0	84255
17952	85682	54	63	381	0	86180
17953	272	88931	80	357	0	89640
17954	281	369	45	96438	0	97133
17955	124	227	37	97351	0	97739
17956	129	74	47	100478	0	100728
17957	158	149	103538	909	0	104754
17958	77	106404	561	633	0	107675
17959	113331	542	433	213	0	114519
17960	749	457	85	113836	0	115127
17961	114126	90	99	806	0	115121
17962	112628	52	63	639	0	113382
17963	1266	59	71	113538	0	114934
17964	763	207	117691	857	0	119518
17965	238	59	713	115219	0	116229
17966	138	120005	669	840	0	121652
17967	180	691	109	121482	0	122462
17968	244	625	121568	884	0	123321
17969	116979	104	743	767	0	118593
17970	832	47	584	122915	0	124378
17971	122503	63	178	892	0	123636
17972	877	180	123336	671	0	125064
17973	114172	84	777	360	0	115393
17974	952	231	124667	188	0	126038
17975	114572	94	826	265	0	115757
17976	817	122505	686	353	0	124361
17977	672	126381	271	391	0	127715
17978	273	1370	123	125705	0	127471
17979	244	668	142	122891	0	123945
17980	219	156	127	127012	0	127514
17981	126643	113	137	1421	0	128314
17982	888	111	102	128694	0	129795
17983	765	234	129942	1002	0	131943
17984	121308	117	811	927	0	123163
17985	797	133870	678	429	0	135774
17986	134570	779	185	367	0	135901
17987	131394	609	147	328	0	132478
17988	1503	295	135479	334	0	137611
17989	872	149	842	132621	0	134484
17990	369	156	668	142094	0	143287
17991	381	304	146425	1537	0	148647
17992	225	146404	944	1038	0	148611
17993	145466	829	693	462	0	147450
17994	146037	700	218	416	0	147371
17995	1618	235	206	150148	0	152207
17996	922	148	177	151926	0	153173
17997	397	160	204	159214	0	159975
17998	156006	163	186	1957	0	158312
17999	1151	162813	290	1272	0	165526
18000	163811	1104	247	479	0	165641
18001	161496	933	246	425	0	163100
18002	2137	413	171350	487	0	174387
18003	1250	220	1329	163641	0	166440
18004	437	176143	1207	1578	0	179365
18005	490	1442	296	178153	0	180381
18006	495	1266	234	185167	0	187162
18007	577	404	190932	2578	0	194491
18008	190384	204	1643	1638	0	193869
18009	210690	203	1300	685	0	212878
18010	216419	278	413	639	0	217749
18011	3491	224	336	214769	0	218820
18012	1992	365	319	204646	0	207322
18013	644	213131	436	3510	0	217721
18014	511	219674	472	2127	0	222784
18015	214436	3403	376	766	0	218981
18016	2316	211830	542	946	0	215634
18017	2132	2334	212764	783	0	218013
18018	799	1713	2205	212889	0	217606
18019	216906	413	1938	2491	0	221748
18020	2728	532	217145	2088	0	222493
18021	2297	518	216197	846	0	219858
18022	215510	397	3815	716	0	220438
18023	217374	424	2008	698	0	220504
18024	4196	407	512	215096	0	220211
18025	2547	627	217076	2676	0	222926
18026	966	397	2420	215964	0	219747
18027	999	679	220555	2812	0	225045
18028	1078	655	220116	2172	0	224021
18029	843	222017	4044	1262	0	228166
18030	221755	2333	2198	823	0	227109
18031	219907	1856	762	883	0	223408
18032	4108	222038	763	960	0	227869
18033	2584	2526	624	219472	0	225206
18034	1077	1961	666	221840	0	225544
18035	1030	675	619	225398	0	227722
18036	221063	493	629	4342	0	226527
18037	2776	221394	730	2795	0	227695
18038	217254	2416	710	1083	0	221463
18039	215782	1979	683	932	0	219376
18040	4395	782	212910	1036	0	219123
18041	2507	213722	2656	966	0	219851
18042	1220	2649	2085	214072	0	220026
18043	1126	2167	216591	2638	0	222522
18044	208686	683	2621	2548	0	214538
18045	217031	516	2220	1090	0	220857
18046	217690	563	797	1003	0	220053
18047	214839	527	701	1013	0	217080
18048	4671	483	670	210296	0	216120
18049	2753	680	209950	2729	0	216112
18050	1452	537	2492	208163	0	212644
18051	208724	547	2086	2877	0	214234
18052	206668	497	816	2423	0	210404
18053	4229	206097	852	1192	0	212370
18054	200512	2094	696	906	0	204208
18055	3015	1899	200640	733	0	206287
18056	2475	751	199466	709	0	203401
18057	186979	721	3887	811	0	192398
18058	2774	194974	2177	845	0	200770
18059	2280	1869	746	180017	0	184912
18060	950	188769	622	2115	0	192456
18061	963	1955	487	189636	0	193041
18062	974	1543	461	189540	0	192518
18063	1013	589	457	195677	0	197736
18064	191882	511	462	3405	0	196260
18065	192649	511	580	1875	0	195615
18066	192259	510	554	764	0	194087
18067	3775	637	190163	774	0	195349
18068	183121	466	2197	802	0	186586
18069	2607	430	1907	194390	0	199334
18070	2290	439	736	200350	0	203815
18071	1345	585	201295	3579	0	206804
18072	1218	492	2287	209219	0	213216
18073	218819	429	1970	3019	0	224237
18074	3419	576	219037	2405	0	225437
18075	2623	414	2775	218584	0	224396
18076	220636	350	2233	3055	0	226274
18077	218175	438	826	2406	0	221845
18078	4926	605	221487	964	0	227982
18079	2951	651	224630	875	0	229107
18080	1343	546	4288	224138	0	230315
18081	229466	440	2387	3028	0	235321
18082	229001	507	874	2485	0	232867
18083	4908	555	764	212443	0	218670
18084	2791	229882	905	2885	0	236463
18085	226227	2595	767	2396	0	231985
18086	3163	232458	915	1378	0	237914
18087	2873	2665	769	230621	0	236928
18088	1519	2112	229461	3058	0	236150
18089	1354	673	226240	2609	0	230876
18090	1453	556	228491	970	0	231470
18091	1385	484	4712	213637	0	220218
18092	1309	379	2513	220507	0	224708
18093	219030	336	1034	4520	0	224920
18094	3210	219407	971	2883	0	226471
18095	217282	2417	742	1115	0	221556
18096	3656	2058	730	200134	0	206578
18097	2521	210719	869	2807	0	216916
18098	1134	214926	863	2345	0	219268
18099	1248	4035	648	208956	0	214887
18100	207178	1944	628	2854	0	212604
18101	2929	210067	781	2536	0	216313
18102	196286	2125	682	904	0	199997
18103	2565	203193	747	1052	0	207557
18104	197946	2205	957	797	0	201905
18105	2981	1817	195983	730	0	201511
18106	2393	782	190222	756	0	194153
18107	954	186532	3439	816	0	191741
18108	166521	3082	3726	913	0	174242
18109	1794	162569	661	727	0	165751
18110	1342	155006	510	654	0	157512
18111	2114	2746	524	151668	0	157052
18112	151761	1138	457	1523	0	154879
18113	1573	154503	451	1497	0	158024
18114	149131	1339	394	394	0	151258
18115	1452	150962	375	567	0	153356
18116	145417	1356	289	401	0	147463
18117	1420	148499	334	449	0	150702
18118	1191	150033	319	470	0	152013
18119	667	2275	384	140256	0	143582
18120	356	149694	343	1215	0	151608
18121	145387	1348	247	920	0	147902
18122	1389	1142	146062	392	0	148985
18123	1136	409	1224	144504	0	147273
18124	501	517	150110	1395	0	152523
18125	483	291	1403	145107	0	147284
18126	509	316	1053	148921	0	150799
18127	492	439	142751	2156	0	145838
18128	120039	318	1373	1548	0	123278
18129	1510	140103	1077	692	0	143382
18130	140635	1310	452	596	0	142993
18131	1536	143450	469	662	0	146117
18132	1320	1443	362	140625	0	143750
18133	141411	1023	409	1440	0	144283
18134	141385	526	459	1205	0	143575
18135	142882	399	497	640	0	144418
18136	2370	429	414	139297	0	142510
18137	1648	444	401	138524	0	141017
18138	830	148519	503	2098	0	151950
18139	149336	1468	423	1381	0	152608
18140	150369	1206	468	667	0	152710
18141	150674	588	515	538	0	152315
18142	148053	572	508	638	0	149771
18143	2363	145289	634	613	0	148899
18144	1376	1471	604	145597	0	149048
18145	799	1323	145786	1438	0	149346
18146	139448	615	1479	1270	0	142812
18147	148749	608	1031	759	0	151147
18148	2509	713	148097	589	0	151908
18149	1618	755	149781	524	0	152678
18150	838	757	2134	145844	0	149573
18151	776	759	1121	153117	0	155773
18152	744	730	444	155246	0	157164
18153	151374	811	498	2503	0	155186
18154	1822	752	375	153096	0	156045
18155	1492	786	149673	1889	0	153840
18156	801	682	1530	150281	0	153294
18157	743	795	154628	1859	0	158025
18158	809	632	1703	150006	0	153150
18159	790	635	1264	161803	0	164492
18160	756	774	163170	2642	0	167342
18161	144160	622	1863	1774	0	148419
18162	1818	163979	1517	823	0	168137
18163	162907	2082	402	568	0	165959
18164	2255	1725	313	165787	0	170080
18165	163622	849	327	2086	0	166884
18166	2253	173689	405	1759	0	178106
18167	1797	180956	394	1067	0	184214
18168	1067	5319	383	184891	0	191660
18169	925	2223	194572	2547	0	200267
18170	943	882	188146	1785	0	191756
18171	629	189134	4059	936	0	194758
18172	165404	2542	2413	529	0	170888
18173	2147	1627	567	164927	0	169268
18174	162820	452	335	2087	0	165694
18175	2083	164107	416	1677	0	168283
18176	1523	167158	413	749	0	169843
18177	742	3564	275	163808	0	168389
18178	165050	1795	278	2124	0	169247
18179	165156	606	207	1647	0	167616
18180	3619	512	164250	610	0	168991
18181	1894	508	159734	445	0	162581
18182	153370	373	3189	420	0	157352
18183	2148	159900	1755	470	0	164273
18184	156881	2029	711	332	0	159953
18185	2565	1550	355	154601	0	159071
18186	1770	671	152866	2102	0	157409
18187	141407	374	2137	1592	0	145510
18188	2044	150064	1672	607	0	154387
18189	1509	150814	667	484	0	153474
18190	1188	3144	631	146596	0	151559
18191	148464	1644	515	2123	0	152746
18192	2139	568	420	148742	0	151869
18193	151085	471	401	2268	0	154225
18194	2433	572	148540	1550	0	153095
18195	144888	508	1882	727	0	148005
18196	149657	415	1357	594	0	152023
18197	3592	468	145614	530	0	150204
18198	139241	415	1975	541	0	142172
18199	2488	143972	1583	546	0	148589
18200	1950	2007	597	137496	0	142050
18201	952	144373	568	1982	0	147875
18202	143216	2177	590	1473	0	147456
18203	2527	1529	512	138162	0	142730
18204	1844	140190	656	2103	0	144793
18205	972	2137	488	138481	0	142078
18206	749	141183	432	2438	0	144802
18207	707	2369	328	142180	0	145584
18208	140668	1712	344	2418	0	145142
18209	2358	716	361	141613	0	145048
18210	1884	719	139640	2601	0	144844
18211	133957	624	2042	1967	0	138590
18212	2422	561	1492	139104	0	143579
18213	1936	593	136934	2485	0	141948
18214	1110	573	134555	1927	0	138165
18215	1031	504	139337	989	0	141861
18216	869	442	3570	133432	0	138313
18217	935	417	2028	138491	0	141871
18218	934	431	926	137888	0	140179
18219	842	479	814	139390	0	141525
18220	137205	471	777	3810	0	142263
18221	139085	527	712	2284	0	142608
18222	140645	574	673	1218	0	143110
18223	142019	649	556	1082	0	144306
18224	4029	628	503	137611	0	142771
18225	2416	720	141390	2797	0	147323
18226	139551	636	2153	2207	0	144547
18227	145630	609	1594	1157	0	148990
18228	4002	699	662	143026	0	148389
18229	2544	642	582	146243	0	150011
18230	146673	575	616	3954	0	151818
18231	3015	562	667	137993	0	142237
18232	2274	141785	917	2870	0	147846
18233	143893	2262	813	2116	0	149084
18234	143409	1688	761	1338	0	147196
18235	4178	894	146345	1107	0	152524
18236	2665	665	2561	143423	0	149314
18237	1431	708	1967	146915	0	151021
18238	143376	607	930	4027	0	148940
18239	144010	649	767	2444	0	147870
18240	4483	604	593	143080	0	148760
18241	2797	708	143621	3018	0	150144
18242	1679	668	144569	2358	0	149274
18243	1533	465	3539	142626	0	148163
18244	1619	620	1982	144457	0	148678
18245	140659	472	932	3921	0	145984
18246	3193	140143	921	2708	0	146965
18247	2426	139178	905	1435	0	143944
18248	1534	141764	938	1082	0	145318
18249	1571	3642	951	136192	0	142356
18250	135710	1808	910	2702	0	141130
18251	134160	817	518	2151	0	137646
18252	3814	135786	568	1309	0	141477
18253	135302	2334	403	1020	0	139059
18254	2904	1755	391	132986	0	138036
18255	2267	871	135089	2756	0	140983
18256	1403	669	2068	132634	0	136774
18257	1463	584	1459	132858	0	136364
18258	1403	543	638	132006	0	134590
18259	122549	395	515	3611	0	127070
18260	2512	643	554	115537	0	119246
18261	1979	117543	610	2673	0	122805
18262	111776	1661	951	1989	0	116377
18263	2149	113054	667	1156	0	117026
18264	1462	107812	516	986	0	110776
18265	844	109321	550	948	0	111663
18266	952	1831	95949	743	0	99475
18267	481	92752	1459	714	0	95406
18268	864	1094	77843	504	0	80305
18269	65968	670	773	347	0	67758
18270	69024	104	349	283	0	69760
18271	700	146	72367	201	0	73414
18272	70019	96	385	312	0	70812
18273	75226	75	265	270	0	75836
18274	688	142	76228	215	0	77273
18275	329	79739	407	234	0	80709
18276	269	475	240	80014	0	80998
18277	81940	250	127	548	0	82865
18278	481	138	100	81273	0	81992
18279	87287	125	113	594	0	88119
18280	85964	157	88	389	0	86598
18281	675	194	87930	207	0	89006
18282	84809	115	350	256	0	85530
18283	472	91043	265	270	0	92050
18284	91506	396	110	285	0	92297
18285	510	313	104	92125	0	93052
18286	519	212	93976	494	0	95201
18287	215	140	384	92374	0	93113
18288	92756	137	319	549	0	93761
18289	472	94953	143	840	0	96408
18290	488	504	94892	313	0	96197
18291	278	304	403	90092	0	91077
18292	364	171	96449	597	0	97581
18293	228	98265	457	490	0	99440
18294	97190	431	348	281	0	98250
18295	545	322	125	97600	0	98592
18296	444	274	98972	557	0	100247
18297	326	296	96348	435	0	97405
18298	97452	183	626	359	0	98620
18299	571	234	331	102032	0	103168
18300	468	206	171	102948	0	103793
18301	351	260	105632	705	0	106948
18302	352	264	105256	422	0	106294
18303	294	110989	771	382	0	112436
18304	332	500	398	110461	0	111691
18305	400	401	223	108154	0	109178
18306	304	114116	231	825	0	115476
18307	386	597	112860	452	0	114295
18308	102447	456	565	351	0	103819
18309	589	191	438	114634	0	115852
18310	567	288	117728	663	0	119246
18311	390	222	543	109514	0	110669
18312	421	118152	477	662	0	119712
18313	413	696	118559	516	0	120184
18314	108237	486	677	433	0	109833
18315	771	307	123568	335	0	124981
18316	600	331	122523	231	0	123685
18317	390	236	122566	238	0	123430
18318	371	222	133268	284	0	134145
18319	283	252	1152	128372	0	130059
18320	384	237	142928	835	0	144384
18321	309	356	849	131849	0	133363
18322	186	142191	726	870	0	143973
18323	148064	781	275	746	0	149866
18324	1063	646	232	149312	0	151253
18325	868	268	148764	1170	0	151070
18326	217	149062	1167	1023	0	151469
18327	325	993	829	146923	0	149070
18328	146555	750	326	1069	0	148700
18329	915	149780	335	927	0	151957
18330	823	1043	227	149478	0	151571
18331	152602	727	249	1038	0	154616
18332	1110	267	152517	843	0	154737
18333	147646	138	1092	370	0	149246
18334	1114	225	155132	211	0	156682
18335	144307	146	1111	250	0	145814
18336	146699	114	845	236	0	147894
18337	1659	246	148196	221	0	150322
18338	739	146284	971	327	0	148321
18339	300	995	860	143465	0	145620
18340	271	774	148476	934	0	150455
18341	243	344	926	139699	0	141212
18342	240	216	783	144972	0	146211
18343	294	181	146950	1516	0	148941
18344	283	228	146161	873	0	147545
18345	200	145	1523	144578	0	146446
18346	148438	109	850	978	0	150375
18347	889	149445	324	971	0	151629
18348	773	151093	237	439	0	152542
18349	151512	1449	218	325	0	153504
18350	153530	752	220	320	0	154822
18351	1617	187	223	153144	0	155171
18352	883	141	229	154417	0	155670
18353	290	139	234	156463	0	157126
18354	151594	142	255	1762	0	153753
18355	914	150695	306	1103	0	153018
18356	811	153781	344	450	0	155386
18357	271	1595	272	153722	0	155860
18358	227	774	252	155543	0	156796
18359	271	216	269	156519	0	157275
18360	153968	156	244	1770	0	156138
18361	897	157850	371	1497	0	160615
18362	159843	1014	241	408	0	161506
18363	1341	989	160058	391	0	162779
18364	964	163646	1272	434	0	166316
18365	326	1186	1016	161589	0	164117
18366	161633	1028	315	1405	0	164381
18367	1396	388	163692	1173	0	166649
18368	1281	354	163969	395	0	165999
18369	441	231	2279	159668	0	162619
18370	358	259	1193	164453	0	166263
18371	313	280	350	163863	0	164806
18372	334	268	270	160170	0	161042
18373	423	265	271	157832	0	158791
18374	299	156956	391	2504	0	160150
18375	370	1278	305	157254	0	159207
18376	153078	1114	380	1645	0	156217
18377	1324	155911	419	1550	0	159204
18378	153418	1307	410	669	0	155804
18379	1635	1259	150946	517	0	154357
18380	1368	472	152155	485	0	154480
18381	585	365	2359	152722	0	156031
18382	552	404	182246	1818	0	185020
18383	543	296	2347	177867	0	181053
18384	473	329	1834	178913	0	181549
18385	180353	266	591	3953	0	185163
18386	174540	302	519	2253	0	177614
18387	3726	184447	584	885	0	189642
18388	1967	189472	578	793	0	192810
18389	686	3977	414	185554	0	190631
18390	187416	2143	441	2804	0	192804
18391	2625	665	190286	2270	0	195846
18392	2170	421	2639	187701	0	192931
18393	794	409	2074	189545	0	192822
18394	679	506	187908	4637	0	193730
18395	571	186774	2798	3039	0	193182
18396	697	2611	2058	185994	0	191360
18397	777	2172	188803	3014	0	194766
18398	647	580	2668	185950	0	189845
18399	175764	425	2181	3214	0	181584
18400	2492	181343	927	2731	0	187493
18401	1999	183550	729	1089	0	187367
18402	834	4387	571	179044	0	184836
18403	174339	2183	526	3043	0	180091
18404	2465	177314	724	2606	0	183109
18405	176579	2566	649	1230	0	181024
18406	2969	2155	175478	1163	0	181765
18407	2301	876	179720	1161	0	184058
18408	920	664	4501	167057	0	173142
18409	877	602	2374	180698	0	184551
18410	177143	628	821	4795	0	183387
18411	3293	732	583	176317	0	180925
18412	2634	979	175011	3339	0	181963
18413	1095	924	2734	170781	0	175534
18414	1019	834	2203	175425	0	179481
18415	873	717	168801	4988	0	175379
18416	154797	620	2947	3109	0	161473
18417	2996	649	2414	165813	0	171872
18418	155115	489	975	3511	0	160090
18419	2506	147679	861	2799	0	153845
18420	143339	2469	816	1304	0	147928
18421	2420	144841	753	1330	0	149344
18422	1831	144571	856	1410	0	148668
18423	1612	3831	1311	132572	0	139326
18424	133899	1956	983	2648	0	139486
18425	133860	893	534	2051	0	137338
18426	3408	889	599	132069	0	136965
18427	133463	731	533	2775	0	137502
18428	132534	634	489	2382	0	136039
18429	3954	687	516	131663	0	136820
18430	127933	733	604	2627	0	131897
18431	2695	129065	824	2260	0	134844
18432	129583	2360	885	1246	0	134074
18433	2714	1985	130335	1342	0	136376
18434	132002	632	2294	1512	0	136440
18435	2852	479	1954	131649	0	136934
18436	2258	417	966	135180	0	138821
18437	1059	393	881	135959	0	138292
18438	958	470	956	136024	0	138408
18439	873	577	843	132232	0	134525
18440	886	126594	978	4511	0	132969
18441	961	132490	1002	2892	0	137345
18442	131219	3327	752	1655	0	136953
18443	2911	2214	130587	1337	0	137049
18444	127713	1188	2331	1183	0	132415
18445	3048	1281	131661	1266	0	137256
18446	2453	1041	2369	127503	0	133366
18447	1452	1123	1710	131555	0	135840
18448	127069	1067	636	4148	0	132920
18449	3367	977	128304	2650	0	135298
18450	2924	838	2347	127904	0	134013
18451	1822	808	135058	3141	0	140829
18452	1575	138221	2581	2790	0	145167
18453	1695	2361	1895	140339	0	146290
18454	140415	1892	768	3342	0	146417
18455	136220	841	790	2916	0	140767
18456	138452	747	842	1706	0	141747
18457	4232	140200	879	1884	0	147195
18458	2682	143244	1011	1781	0	148718
18459	127355	3680	1125	1759	0	133919
18460	2725	142243	898	2107	0	147973
18461	2101	140491	852	2257	0	145701
18462	1465	3534	135645	2043	0	142687
18463	1143	135197	2263	1773	0	140376
18464	1088	133301	1766	1595	0	137750
18465	1193	3738	715	130440	0	136086
18466	1208	2462	132494	2581	0	138745
18467	1361	1273	129457	2157	0	134248
18468	122507	829	3397	1341	0	128074
18469	3028	825	131872	1123	0	136848
18470	131401	639	2503	1320	0	135863
18471	2977	621	1966	128081	0	133645
18472	2545	134055	926	2915	0	140441
18473	138698	2055	742	2442	0	143937
18474	145085	1696	838	1552	0	149171
18475	3934	800	849	145055	0	150638
18476	2665	704	858	146428	0	150655
18477	1543	625	938	148287	0	151393
18478	145114	673	666	4097	0	150550
18479	142544	594	568	2719	0	146425
18480	144935	646	467	1507	0	147555
18481	3866	136534	512	1327	0	142239
18482	109768	951	349	535	0	111603
18483	1232	110914	269	502	0	112917
18484	964	111448	301	496	0	113209
18485	867	2432	770	104163	0	108232
18486	480	107411	387	958	0	109236
18487	102064	759	324	676	0	103823
18488	940	634	100	101832	0	103506
18489	99703	231	137	732	0	100803
18490	717	99472	162	617	0	100968
18491	572	103650	180	330	0	104732
18492	104541	939	175	276	0	105931
18493	801	109886	204	288	0	111179
18494	740	762	206	110898	0	112606
18495	456	556	173	112244	0	113429
18496	112319	227	154	1294	0	113994
18497	895	185	84	113754	0	114918
18498	826	234	117263	943	0	119266
18499	369	234	789	117093	0	118485
18500	119039	213	637	1000	0	120889
18501	937	123819	243	853	0	125852
18502	129342	1009	135	377	0	130863
18503	127485	808	147	317	0	128757
18504	129955	280	166	371	0	130772
18505	1948	328	129893	226	0	132395
18506	1043	323	126187	232	0	127785
18507	118677	220	1632	271	0	120800
18508	1058	128624	831	368	0	130881
18509	848	1109	224	128223	0	130404
18510	329	868	172	126326	0	127695
18511	276	126336	265	1693	0	128570
18512	294	130119	244	910	0	131567
18513	348	1684	177	129655	0	131864
18514	349	902	224	130504	0	131979
18515	439	371	128469	1791	0	131070
18516	431	365	123616	998	0	125410
18517	122535	250	1744	412	0	124941
18518	131389	207	921	343	0	132860
18519	1837	267	267	131160	0	133531
18520	1149	372	131923	1233	0	134677
18521	489	294	1092	130116	0	131991
18522	129141	269	871	1358	0	131639
18523	1379	357	131828	1110	0	134674
18524	1122	347	1132	132155	0	134756
18525	559	409	136737	1302	0	139007
18526	431	134401	1274	1322	0	137428
18527	653	1252	135745	499	0	138149
18528	566	1131	1280	132007	0	134984
18529	136002	381	1067	1226	0	138676
18530	1348	345	328	139647	0	141668
18531	143466	330	298	1427	0	145521
18532	143798	292	356	1134	0	145580
18533	142048	301	326	629	0	143304
18534	2172	395	140770	464	0	143801
18535	140790	327	1192	516	0	142825
18536	1545	291	1014	144155	0	147005
18537	1248	316	376	144749	0	146689
18538	732	415	145274	2014	0	148435
18539	559	443	1199	145246	0	147447
18540	148330	287	1024	1520	0	151161
18541	1347	151254	444	1387	0	154432
18542	155699	1157	315	677	0	157848
18543	156355	905	327	703	0	158290
18544	158164	355	305	606	0	159430
18545	2297	349	322	156448	0	159416
18546	1459	452	160931	1499	0	164341
18547	721	267	1316	163736	0	166040
18548	682	282	1052	166425	0	168441
18549	166509	304	504	2405	0	169722
18550	159635	310	441	1520	0	161906
18551	2509	338	160651	606	0	164104
18552	1454	338	1425	157599	0	160816
18553	758	383	165198	1750	0	168089
18554	161032	251	1793	1513	0	164589
18555	1826	186153	1336	992	0	190307
18556	187357	1664	549	599	0	190169
18557	2036	193832	565	834	0	197267
18558	190995	1892	462	608	0	193957
18559	2147	195363	519	708	0	198737
18560	1906	1965	458	192485	0	196814
18561	810	1372	398	198910	0	201490
18562	200852	335	385	3256	0	204828
18563	200402	247	365	1814	0	202828
18564	201676	271	368	751	0	203066
18565	198374	241	348	661	0	199624
18566	199214	253	338	599	0	200404
18567	3706	312	354	192833	0	197205
18568	1935	196753	492	2220	0	201400
18569	1022	1894	354	191017	0	194287
18570	779	196205	437	2258	0	199679
18571	893	2017	329	189507	0	192746
18572	754	194291	496	2293	0	197834
18573	882	2035	321	191838	0	195076
18574	899	1470	186094	2321	0	190784
18575	168175	443	1934	1920	0	172472
18576	2224	185738	1561	930	0	190453
18577	185380	1854	469	692	0	188395
18578	2577	1462	183792	677	0	188508
18579	175303	449	1987	725	0	178464
18580	2573	445	192708	690	0	196416
18581	1949	490	2137	187323	0	191899
18582	861	201237	1738	2433	0	206269
18583	961	2341	203944	1776	0	209022
18584	842	1670	2362	201408	0	206282
18585	198119	523	1806	2704	0	203152
18586	2713	434	535	206730	0	210412
18587	2211	394	468	206813	0	209886
18588	1150	413	354	210213	0	212130
18589	982	571	205981	4169	0	211703
18590	1054	443	2358	197781	0	201636
18591	861	203329	1891	2830	0	208911
18592	989	2224	491	201796	0	205500
18593	899	1790	366	201708	0	204763
18594	196596	514	334	3863	0	201307
18595	2821	515	320	202460	0	206116
18596	2253	531	205767	2784	0	211335
18597	1074	507	204611	2088	0	208280
18598	1001	451	204015	1041	0	206508
18599	706	201329	3929	1114	0	207078
18600	194845	2509	2738	808	0	200900
18601	2397	198269	729	817	0	202212
18602	193907	2279	597	674	0	197457
18603	2654	1761	350	191191	0	195956
18604	2207	705	194832	2404	0	200148
18605	960	584	191691	2111	0	195346
18606	692	196045	3677	906	0	201320
18607	799	2392	2000	192565	0	197756
18608	698	1918	643	196027	0	199286
18609	676	752	456	199305	0	201189
18610	750	649	196205	4207	0	201811
18611	170211	484	2561	2782	0	176038
18612	2816	547	197336	1155	0	201854
18613	2271	475	2619	187477	0	192842
18614	1002	465	1968	196743	0	200178
18615	930	605	194698	4203	0	200436
18616	172725	507	2719	2674	0	178625
18617	2522	193780	2196	1381	0	199879
18618	193129	2491	827	999	0	197446
18619	2814	2021	681	185257	0	190773
18620	2104	193264	763	2672	0	198803
18621	956	2574	644	195064	0	199238
18622	192410	1983	670	3041	0	198104
18623	2771	817	633	192851	0	197072
18624	2302	790	189801	3034	0	195927
18625	180902	677	2559	2537	0	186675
18626	187009	614	2017	1303	0	190943
18627	4330	666	187437	1081	0	193514
18628	2560	512	2659	183031	0	188762
18629	187895	548	2199	3103	0	193745
18630	2950	562	978	184918	0	189408
18631	2419	488	809	181699	0	185415
18632	1173	592	820	183069	0	185654
18633	1002	544	769	182961	0	185276
18634	924	722	177746	4768	0	184160
18635	895	610	2715	176690	0	180910
18636	914	559	177857	3496	0	182826
18637	167867	644	2925	2863	0	174299
18638	175450	611	2364	1540	0	179965
18639	174745	605	1053	1442	0	177845
18640	173454	616	939	1324	0	176333
18641	4500	527	921	167299	0	173247
18642	164943	482	1034	3107	0	169566
18643	3098	518	163143	2759	0	169518
18644	2432	548	162082	1285	0	166347
18645	149191	398	4084	1292	0	154965
18646	2570	154146	2566	1295	0	160577
18647	2007	151189	1119	1258	0	155573
18648	1071	3432	1197	148196	0	153896
18649	1041	1815	148313	2774	0	153943
18650	131679	650	2882	2688	0	137899
18651	2634	524	147681	1404	0	152243
18652	1949	138469	2436	1647	0	144501
18653	1315	1864	136649	1224	0	141052
18654	712	125383	2324	1128	0	129547
18655	107456	2181	2864	1042	0	113543
18656	1632	108051	810	929	0	111422
18657	1327	101789	598	848	0	104562
18658	894	2025	617	100608	0	104144
18659	697	1155	99981	1640	0	103473
18660	647	473	1536	94734	0	97390
18661	591	322	1307	97508	0	99728
18662	649	365	96164	2423	0	99601
18663	624	322	1565	90308	0	92819
18664	635	94143	1402	1570	0	97750
18665	606	1327	637	96182	0	98752
18666	95359	1112	573	1695	0	98739
18667	1549	447	605	96790	0	99391
18668	1376	438	96501	1743	0	100058
18669	775	427	1517	96579	0	99298
18670	635	473	96679	1820	0	99607
18671	92348	400	1648	1474	0	95870
18672	1547	370	1318	95860	0	99095
18673	96062	344	658	1726	0	98790
18674	1698	413	96764	1445	0	100320
18675	88610	319	1608	820	0	91357
18676	1538	96118	1433	728	0	99817
18677	1422	1357	95945	683	0	99407
18678	686	1918	1631	91778	0	96013
18679	629	470	95654	1611	0	98364
18680	463	86820	1505	1419	0	90207
18681	472	87911	1293	736	0	90412
18682	72702	1435	579	458	0	75174
18683	934	76090	432	488	0	77944
18684	75168	942	470	399	0	76979
18685	1328	868	340	75201	0	77737
18686	1000	324	75215	1078	0	77617
18687	398	75890	1077	976	0	78341
18688	502	1102	990	74842	0	77436
18689	416	847	334	77710	0	79307
18690	409	356	304	79128	0	80197
18691	367	281	327	75906	0	76881
18692	332	75013	374	1765	0	77484
18693	295	76563	392	1141	0	78391
18694	70498	1374	361	415	0	72648
18695	815	70732	312	383	0	72242
18696	658	839	234	65474	0	67205
18697	334	757	65137	813	0	67041
18698	215	64586	730	798	0	66329
18699	242	823	666	62272	0	64003
18700	290	933	251	60788	0	62262
18701	153	63007	249	1200	0	64609
18702	60281	714	252	662	0	61909
18703	701	683	61356	277	0	63017
18704	54616	241	626	227	0	55710
18705	605	59157	570	249	0	60581
18706	53400	581	241	163	0	54385
18707	509	55954	119	175	0	56757
18708	521	636	159	57596	0	58912
18709	160	586	107	58501	0	59354
18710	57241	210	105	1113	0	58669
18711	629	239	112	58183	0	59163
18712	636	227	57431	707	0	59001
18713	149	56223	592	681	0	57645
18714	128	56452	536	229	0	57345
18715	190	1131	132	55023	0	56476
18716	217	660	56068	639	0	57584
18717	121	296	537	54528	0	55482
18718	122	151	508	55639	0	56420
18719	132	224	55008	1084	0	56448
18720	203	199	53886	699	0	54987
18721	100	54808	976	312	0	56196
18722	54203	609	573	233	0	55618
18723	579	635	135	52646	0	53995
18724	530	53108	153	586	0	54377
18725	53629	651	120	627	0	55027
18726	567	627	134	53616	0	54944
18727	551	218	106	53297	0	54172
18728	153	53142	143	1132	0	54570
18729	148	624	135	52741	0	53648
18730	52144	622	153	758	0	53677
18731	617	291	113	53008	0	54029
18732	619	240	123	53346	0	54328
18733	243	248	52541	1146	0	54178
18734	197	248	50699	756	0	51900
18735	50316	233	1056	355	0	51960
18736	609	193	597	51382	0	52781
18737	589	233	194	51548	0	52564
18738	213	250	149	52441	0	53053
18739	217	270	51316	1235	0	53038
18740	49247	234	637	807	0	50925
18741	636	240	602	51029	0	52507
18742	623	230	217	51810	0	52880
18743	50173	228	193	1233	0	51827
18744	617	50503	234	1020	0	52374
18745	660	684	50658	487	0	52489
18746	248	662	624	47858	0	49392
18747	203	50573	645	862	0	52283
18748	246	657	224	51302	0	52429
18749	50136	668	215	863	0	51882
18750	694	268	188	50601	0	51751
18751	49405	282	195	934	0	50816
18752	49015	243	194	879	0	50331
18753	1098	269	191	47334	0	48892
18754	685	47872	251	896	0	49704
18755	226	49230	242	936	0	50634
18756	270	1107	48621	540	0	50538
18757	249	699	679	46793	0	48420
18758	259	271	671	49013	0	50214
18759	274	247	244	49876	0	50641
18760	48477	239	205	1374	0	50295
18761	726	251	159	49335	0	50471
18762	769	269	49073	947	0	51058
18763	47910	246	638	972	0	49766
18764	721	225	629	50546	0	52121
18765	704	249	235	51651	0	52839
18766	284	238	50674	1421	0	52617
18767	47967	225	654	987	0	49833
18768	722	239	621	51194	0	52776
18769	723	249	51948	1025	0	53945
18770	390	188	675	51435	0	52688
18771	351	214	706	44936	0	46207
18772	275	52352	346	1256	0	54229
18773	51315	598	239	874	0	53026
18774	50161	588	235	562	0	51546
18775	1051	50416	254	600	0	52321
18776	49047	588	260	492	0	50387
18777	47843	533	203	516	0	49095
18778	1108	206	195	47909	0	49418
18779	688	196	46680	862	0	48426
18780	327	163	44973	795	0	46258
18781	256	162	44064	435	0	44917
18782	253	170	45069	417	0	45909
18783	298	674	970	40708	0	42650
18784	194	125	584	43032	0	43935
18785	217	111	188	42691	0	43207
18786	242	105	130	44032	0	44509
18787	43076	85	156	1060	0	44377
18788	569	44028	183	774	0	45554
18789	43798	407	232	344	0	44781
18790	579	418	43929	275	0	45201
18791	542	153	46234	225	0	47154
18792	211	332	806	46985	0	48334
18793	47822	92	691	655	0	49260
18794	42488	131	200	636	0	43455
18795	840	47366	162	315	0	48683
18796	474	47760	163	297	0	48694
18797	201	800	119	47560	0	48680
18798	47535	427	146	551	0	48659
18799	453	48470	135	586	0	49644
18800	48495	417	112	232	0	49256
18801	48442	409	119	214	0	49184
18802	48690	102	102	239	0	49133
18803	838	96	49586	217	0	50737
18804	510	49871	459	233	0	51073
18805	49163	372	449	206	0	50190
18806	48549	371	154	192	0	49266
18807	721	47991	124	200	0	49036
18808	331	45678	81	110	0	46200
18809	45580	525	129	81	0	46315
18810	351	317	53	45498	0	46219
18811	343	120	46356	326	0	47145
18812	44545	89	299	313	0	45246
18813	350	84	278	46709	0	47421
18814	323	49407	84	511	0	50325
18815	122	327	40	50339	0	50828
18816	148	349	50947	344	0	51788
18817	154	98	294	50401	0	50947
18818	52919	73	302	409	0	53703
18819	379	65	81	53661	0	54186
18820	377	85	59	54210	0	54731
18821	164	119	58457	618	0	59358
18822	161	82	326	55663	0	56232
18823	102	59040	325	394	0	59861
18824	58946	326	110	340	0	59722
18825	56713	322	66	166	0	57267
18826	656	120	59553	148	0	60477
18827	401	107	323	56469	0	57300
18828	157	58059	335	1224	0	59775
18829	121	60216	109	372	0	60818
18830	59681	554	94	153	0	60482
18831	403	346	76	61196	0	62021
18832	403	142	61291	406	0	62242
18833	176	144	60925	390	0	61635
18834	127	87	603	61328	0	62145
18835	61434	70	354	410	0	62268
18836	61108	83	114	407	0	61712
18837	673	90	104	63955	0	64822
18838	436	154	65504	467	0	66561
18839	153	65742	384	473	0	66752
18840	65396	363	333	193	0	66285
18841	389	66907	135	227	0	67658
18842	66710	394	97	177	0	67378
18843	472	360	90	66583	0	67505
18844	422	178	67222	435	0	68257
18845	178	110	387	65679	0	66354
18846	66235	75	369	459	0	67138
18847	477	153	67557	424	0	68611
18848	400	68129	437	237	0	69203
18849	181	418	364	68349	0	69312
18850	68475	346	123	453	0	69397
18851	486	180	69414	424	0	70504
18852	462	126	410	69838	0	70836
18853	199	104	357	71693	0	72353
18854	229	179	72432	720	0	73560
18855	201	109	451	70637	0	71398
18856	230	178	72783	506	0	73697
18857	67599	118	489	519	0	68725
18858	509	121	385	77084	0	78099
18859	530	182	83654	520	0	84886
18860	209	86353	545	598	0	87705
18861	88856	524	465	244	0	90089
18862	98306	446	253	278	0	99283
18863	1169	192	124	106815	0	108300
18864	636	113532	198	950	0	115316
18865	114096	950	142	717	0	115905
18866	1074	705	118	114219	0	116116
18867	837	235	114995	1033	0	117100
18868	108437	170	958	788	0	110353
18869	1022	113289	763	297	0	115371
18870	794	927	194	113419	0	115334
18871	113820	663	191	1039	0	115713
18872	1084	255	113298	758	0	115395
18873	789	209	114783	229	0	116010
18874	301	157	1531	107372	0	109361
18875	268	209	116694	1018	0	118189
18876	281	148	1070	110192	0	111691
18877	182	115268	856	1140	0	117446
18878	249	979	259	117703	0	119190
18879	115416	665	188	1166	0	117435
18880	1078	232	117245	884	0	119439
18881	718	117801	1159	535	0	120213
18882	357	935	686	116280	0	118258
18883	297	773	120750	1087	0	122907
18884	257	497	1024	112059	0	113837
18885	216	118750	812	1026	0	120804
18886	162	122191	318	844	0	123515
18887	115762	1353	204	332	0	117651
18888	778	122497	254	394	0	123923
18889	637	958	117740	275	0	119610
18890	105301	659	1142	314	0	107416
18891	893	271	119699	140	0	121003
18892	629	159	870	107883	0	109541
18893	266	180	120064	938	0	121448
18894	141	119335	915	798	0	121189
18895	193	786	568	119285	0	120832
18896	193	510	178	119277	0	120158
18897	178	154	155	118232	0	118719
18898	186	264	119072	1345	0	120867
18899	209	209	815	115210	0	116443
18900	192	150	567	119577	0	120486
18901	116978	125	238	1343	0	118684
18902	116303	138	236	795	0	117472
18903	1294	198	119365	310	0	121167
18904	646	117814	970	437	0	119867
18905	320	881	119737	222	0	121160
18906	279	564	905	118365	0	120113
18907	272	288	123279	929	0	124768
18908	206	153	926	119489	0	120774
18909	173	134	650	123376	0	124333
18910	197	238	123425	1384	0	125244
18911	105975	126	1016	934	0	108051
18912	776	125547	714	524	0	127561
18913	636	825	268	125030	0	126759
18914	311	654	130185	987	0	132137
18915	291	332	127346	702	0	128671
18916	119662	212	1315	405	0	121594
18917	822	129078	815	447	0	131162
18918	627	862	251	128791	0	130531
18919	131302	573	259	1018	0	133152
18920	944	198	228	131264	0	132634
18921	712	250	265	132576	0	133803
18922	312	343	133307	1591	0	135553
18923	123671	197	1021	945	0	125834
18924	133520	170	764	475	0	134929
18925	1513	195	334	134303	0	136345
18926	134189	187	289	1120	0	135785
18927	1097	206	278	133737	0	135318
18928	715	133195	383	1379	0	135672
18929	337	137306	388	1053	0	139084
18930	425	1571	268	137599	0	139863
18931	135212	793	320	1269	0	137594
18932	1008	272	212	136439	0	137931
18933	138526	190	219	1318	0	140253
18934	138407	223	258	948	0	139836
18935	1699	165	269	138462	0	140595
18936	1011	183	247	141421	0	142862
18937	452	263	139430	1786	0	141931
18938	398	260	142867	982	0	144507
18939	348	242	1782	141985	0	144357
18940	318	283	153041	1346	0	154988
18941	144144	185	1435	1124	0	146888
18942	1223	201	993	162620	0	165037
18943	984	343	173248	1580	0	176155
18944	168503	170	1729	1363	0	171765
18945	184475	145	1239	609	0	186468
18946	2873	197106	595	634	0	201208
18947	1640	1998	339	200051	0	204028
18948	688	1519	209575	2081	0	213863
18949	206157	371	2175	1672	0	210375
18950	214334	240	1597	691	0	216862
18951	3463	384	216805	524	0	221176
18952	215391	178	2264	586	0	218419
18953	2521	248	1658	214616	0	219043
18954	1789	205	547	218210	0	220751
18955	216033	181	524	3529	0	220267
18956	215769	193	444	1986	0	218392
18957	3797	758	488	214347	0	219390
18958	2300	356	215165	2300	0	220121
18959	784	205080	2328	2463	0	210655
18960	914	2004	207474	796	0	211188
18961	1058	1490	204920	694	0	208162
18962	827	195127	3630	769	0	200353
18963	1356	1952	2691	173793	0	179792
18964	688	1201	805	178924	0	181618
18965	735	525	179585	2681	0	183526
18966	700	304	1896	175922	0	178822
18967	179019	267	1469	2129	0	182884
18968	2097	360	181133	1588	0	185178
18969	178406	280	1978	960	0	181624
18970	182826	193	1687	797	0	185503
18971	183980	199	863	766	0	185808
18972	3926	372	181997	646	0	186941
18973	2376	442	182640	735	0	186193
18974	1287	403	3061	177445	0	182196
18975	1306	422	2019	163720	0	167467
18976	1036	182571	986	2963	0	187556
18977	181773	1782	944	1970	0	186469
18978	178882	1294	1082	1059	0	182317
18979	3399	182378	1125	1166	0	188068
18980	181946	1828	1054	1049	0	185877
18981	2382	181881	1187	1220	0	186670
18982	182759	2073	1032	976	0	186840
18983	2654	1441	953	175693	0	180741
18984	2137	791	180040	2434	0	185402
18985	1308	588	179658	1950	0	183504
18986	1161	520	3479	174601	0	179761
18987	1206	454	2260	177528	0	181448
18988	1362	586	176078	3286	0	181312
18989	1214	523	2722	170249	0	174708
18990	1205	468	2227	175896	0	179796
18991	173700	480	1336	3425	0	178941
18992	174656	403	1158	2223	0	178440
18993	171817	537	1176	1300	0	174830
18994	3933	595	170166	1179	0	175873
18995	2414	170350	2671	1394	0	176829
18996	1659	2073	2072	168377	0	174181
18997	1869	1629	175123	2250	0	180871
18998	1625	176241	2524	1900	0	182290
18999	177264	2109	2073	996	0	182442
19000	3080	1661	1227	176512	0	182480
19001	2609	838	1136	179376	0	183959
19002	177891	739	1214	3617	0	183461
19003	2880	699	1173	177979	0	182731
19004	2490	718	1117	179000	0	183325
19005	177666	632	1237	3848	0	183383
19006	3033	860	177383	2685	0	183961
19007	2514	175698	2818	1904	0	182934
19008	175539	2114	2260	1480	0	181393
19009	3201	1881	179008	1585	0	185675
19010	173034	903	2675	1680	0	178292
19011	3190	181571	2555	1701	0	189017
19012	179689	2171	1459	1576	0	184895
19013	178486	1708	1385	1730	0	183309
19014	174150	817	1490	1565	0	178022
19015	4363	837	1432	170133	0	176765
19016	2909	1128	1471	168127	0	173635
19017	1849	170757	1573	4183	0	178362
19018	1764	172452	1522	2920	0	178658
19019	1939	174664	1365	1957	0	179925
19020	171200	2989	1292	1769	0	177250
19021	3105	1941	169288	1766	0	176100
19022	2901	946	2301	167464	0	173612
19023	1923	774	2074	164979	0	169750
19024	1533	169824	1508	3844	0	176709
19025	1940	2309	1156	169173	0	174578
19026	1722	1958	1377	165752	0	170809
19027	1702	172762	1385	3627	0	179476
19028	167218	2510	1403	2347	0	173478
19029	2997	174651	1245	1796	0	180689
19030	2678	2538	170857	1478	0	177551
19031	165323	1886	2353	1545	0	171107
19032	3013	173516	2003	1775	0	180307
19033	168595	2101	1097	1426	0	173219
19034	3227	1828	926	168940	0	174921
19035	2860	1002	1026	169678	0	174566
19036	2023	1136	168781	3199	0	175139
19037	2019	1137	168004	2017	0	173177
19038	1714	1674	2804	162541	0	168733
19039	161629	1050	1752	2313	0	166744
19040	153392	891	983	1674	0	156940
19041	3239	161047	881	1179	0	166346
19042	1798	151986	771	975	0	155530
19043	1027	143528	605	794	0	145954
19044	4560	5015	2091	125886	0	137552
19045	123097	980	3283	1984	0	129344
19046	120509	178	122	758	0	121567
19047	120278	174	140	339	0	120931
19048	1553	203	118535	230	0	120521
19049	764	135521	946	346	0	137577
19050	355	1011	699	145258	0	147323
19051	147397	742	243	1294	0	149676
19052	1304	219	136	148633	0	150292
19053	1008	144	99	153279	0	154530
19054	153335	127	122	2195	0	155779
19055	158463	161	123	1171	0	159918
19056	2522	225	161725	344	0	164816
19057	1359	145	1470	159569	0	162543
19058	449	232	162195	1575	0	164451
19059	357	158	1515	160154	0	162184
19060	474	274	161654	1673	0	164075
19061	328	279	1546	159065	0	161218
19062	152201	134	1164	1714	0	155213
19063	1392	158951	357	1512	0	162212
19064	1197	163784	302	511	0	165794
19065	704	2820	200	140234	0	143958
19066	197	164696	233	1413	0	166539
19067	162303	1616	173	1065	0	165157
19068	157453	1208	166	399	0	159226
19069	2697	382	159500	324	0	162903
19070	1293	158852	1627	468	0	162240
19071	411	1478	1122	159035	0	162046
19072	378	1176	160540	1566	0	163660
19073	154840	238	1600	1222	0	157900
19074	1679	324	1192	159207	0	162402
19075	1336	321	161060	1672	0	164389
19076	356	178	1536	159593	0	161663
19077	159111	189	1320	1735	0	162355
19078	1668	277	159690	1377	0	163012
19079	155867	173	1554	370	0	157964
19080	159577	221	1191	330	0	161319
19081	2631	244	261	156623	0	159759
19082	1429	369	158760	1619	0	162177
19083	575	332	156494	1330	0	158731
19084	150876	174	2593	498	0	154141
19085	155664	205	1379	460	0	157708
19086	2901	280	156159	364	0	159704
19087	1573	214	1684	151308	0	154779
19088	597	217	1350	146775	0	148939
19089	398	156631	528	2662	0	160219
19090	517	1567	358	155627	0	158069
19091	154628	1196	424	1918	0	158166
19092	1956	291	350	155891	0	158488
19093	1593	314	154568	1996	0	158471
19094	143616	277	1812	1629	0	147334
19095	1899	306	1379	150463	0	154047
19096	1697	470	151688	1895	0	155750
19097	565	148774	1838	1710	0	152887
19098	142302	1629	1407	794	0	146132
19099	1845	148300	589	1064	0	151798
19100	144905	1711	541	782	0	147939
19101	2249	1431	145505	796	0	149981
19102	1726	142760	1852	881	0	147219
19103	763	146067	1571	716	0	149117
19104	846	2704	702	140740	0	144992
19105	703	1407	553	143310	0	145973
19106	729	578	142521	3093	0	146921
19107	738	381	1899	141117	0	144135
19108	138808	376	1668	2301	0	143153
19109	2136	558	137650	1848	0	142192
19110	1774	473	1980	135419	0	139646
19111	816	686	136394	2179	0	140075
19112	127412	531	2103	1917	0	131963
19113	2053	135019	1739	1116	0	139927
19114	135493	1794	786	1039	0	139112
19115	136050	1423	705	976	0	139154
19116	137483	529	694	902	0	139608
19117	3539	612	132738	868	0	137757
19118	1972	132301	2258	997	0	137528
19119	1084	1869	1779	129494	0	134226
19120	903	1502	993	134808	0	138206
19121	135338	510	845	3453	0	140146
19122	2568	440	906	135880	0	139794
19123	136973	407	961	2701	0	141042
19124	136370	436	882	2122	0	139810
19125	137591	531	829	1052	0	140003
19126	136892	586	928	932	0	139338
19127	3871	539	735	131637	0	136782
19128	131841	614	764	2429	0	135648
19129	2778	596	127819	1994	0	133187
19130	126902	496	2342	944	0	130684
19131	128818	518	1926	766	0	132028
19132	3964	653	126433	779	0	131829
19133	126760	466	2311	883	0	130420
19134	128832	458	2018	834	0	132142
19135	3746	438	920	125737	0	130841
19136	2385	446	861	126711	0	130403
19137	123937	428	934	3474	0	128773
19138	2816	349	803	123427	0	127395
19139	2451	294	860	119703	0	123308
19140	1174	117074	1078	3413	0	122739
19141	1247	1340	722	110606	0	113915
19142	107035	982	690	2036	0	110743
19143	2317	295	699	105907	0	109218
19144	1713	272	738	101217	0	103940
19145	993	99152	813	2547	0	103505
19146	1136	1333	562	95069	0	98100
19147	1249	983	584	93698	0	96514
19148	89478	293	652	2143	0	92566
19149	1627	1045	321	67687	0	70680
19150	839	175	58628	1044	0	60686
19151	343	55185	846	781	0	57155
19152	308	53596	577	374	0	54855
19153	50087	1008	382	238	0	51715
19154	822	51145	229	305	0	52501
19155	43264	434	714	184	0	44596
19156	620	43231	135	187	0	44173
19157	44140	510	202	148	0	45000
19158	640	302	60	44847	0	45849
19159	405	124	65	45014	0	45608
19160	162	45766	67	838	0	46833
19161	217	641	43	46481	0	47382
19162	168	374	47548	619	0	48709
19163	44197	111	531	446	0	45285
19164	562	50017	361	220	0	51160
19165	49085	553	73	146	0	49857
19166	48960	361	56	141	0	49518
19167	49405	79	69	154	0	49707
19168	976	74	54	48396	0	49500
19169	481	86	52	47600	0	48219
19170	169	49031	71	955	0	50226
19171	48482	600	41	454	0	49577
19172	654	49167	64	254	0	50139
19173	49117	613	93	174	0	49997
19174	769	416	49571	135	0	50891
19175	50099	118	613	159	0	50989
19176	824	101	376	50888	0	52189
19177	588	119	51255	807	0	52769
19178	258	120	51407	525	0	52310
19179	195	100	1091	50692	0	52078
19180	223	122	51684	817	0	52846
19181	228	126	761	50820	0	51935
19182	48723	62	538	807	0	50130
19183	840	75	106	49854	0	50875
19184	634	109	49140	864	0	50747
19185	213	48505	750	590	0	50058
19186	224	48959	503	249	0	49935
19187	315	1089	163	47306	0	48873
19188	47423	488	232	829	0	48972
19189	801	127	68	47981	0	48977
19190	594	98	70	48345	0	49107
19191	231	97	85	48959	0	49372
19192	239	123	81	49189	0	49632
19193	246	149	48553	1235	0	50183
19194	197	120	48249	647	0	49213
19195	47037	98	1125	287	0	48547
19196	48894	107	513	239	0	49753
19197	1167	102	157	48276	0	49702
19198	635	83	130	49065	0	49913
19199	307	114	48201	1252	0	49874
19200	199	48440	762	724	0	50125
19201	48082	728	523	294	0	49627
19202	48526	501	147	262	0	49436
19203	1203	178	112	48186	0	49679
19204	659	189	48443	873	0	50164
19205	301	162	702	45564	0	46729
19206	243	48254	520	816	0	49833
19207	306	761	48125	630	0	49822
19208	46760	539	749	308	0	48356
19209	862	182	509	48585	0	50138
19210	49150	152	204	907	0	50413
19211	897	152	48239	677	0	49965
19212	47680	138	782	335	0	48935
19213	896	148	580	48179	0	49803
19214	47919	154	216	901	0	49190
19215	938	130	189	46582	0	47839
19216	621	46266	215	898	0	48000
19217	273	47215	225	698	0	48411
19218	340	1251	218	45667	0	47476
19219	316	539	45116	804	0	46775
19220	226	44180	708	624	0	45738
19221	444	647	541	40837	0	42469
19222	39768	401	232	742	0	41143
19223	39495	130	135	582	0	40342
19224	943	121	137	39336	0	40537
19225	504	135	143	38857	0	39639
19226	224	38530	178	968	0	39900
19227	195	39824	179	598	0	40796
19228	38970	838	171	291	0	40270
19229	630	429	159	38858	0	40076
19230	496	128	154	39288	0	40066
19231	226	129	38733	1079	0	40167
19232	219	95	627	37962	0	38903
19233	209	115	514	37861	0	38699
19234	224	125	164	38376	0	38889
19235	214	120	38083	1064	0	39481
19236	221	101	619	38049	0	38990
19237	37523	113	483	798	0	38917
19238	659	125	37304	647	0	38735
19239	38258	115	649	366	0	39388
19240	664	130	492	39231	0	40517
19241	544	113	175	40265	0	41097
19242	228	91	181	41702	0	42202
19243	227	85	40652	1105	0	42069
19244	37254	102	644	757	0	38757
19245	648	41748	541	388	0	43325
19246	41521	560	192	324	0	42597
19247	673	42406	206	332	0	43617
19248	528	625	191	42121	0	43465
19249	42288	440	159	783	0	43670
19250	738	178	41740	624	0	43280
19251	39948	112	618	352	0	41030
19252	726	138	42453	308	0	43625
19253	522	235	650	40797	0	42204
19254	260	132	40953	743	0	42088
19255	197	40012	657	590	0	41456
19256	472	628	631	36826	0	38557
19257	35533	398	279	781	0	36991
19258	508	106	110	33911	0	34635
19259	369	33983	119	511	0	34982
19260	220	422	131	33929	0	34702
19261	33213	297	85	513	0	34108
19262	32097	100	117	405	0	32719
19263	701	32483	113	220	0	33517
19264	304	29920	94	118	0	30436
19265	203	500	113	29152	0	29968
19266	142	263	97	29475	0	29977
19267	29048	81	79	526	0	29734
19268	28470	58	50	334	0	28912
19269	470	29511	86	160	0	30227
19270	311	335	50	28476	0	29172
19271	129	283	68	28884	0	29364
19272	132	108	28937	527	0	29704
19273	88	28880	286	360	0	29614
19274	82	27954	228	131	0	28395
19275	146	333	69	26503	0	27051
19276	99	188	26605	185	0	27077
19277	68	85	26717	189	0	27059
19278	60	79	298	26501	0	26938
19279	74	89	203	26788	0	27154
19280	73	79	27034	342	0	27528
19281	69	44	184	27006	0	27303
19282	64	67	27841	235	0	28207
19283	27553	213	202	253	0	28221
19284	244	34	202	28902	0	29382
19285	243	52	29945	276	0	30516
19286	104	70	30152	262	0	30588
19287	78	61	439	31469	0	32047
19288	74	54	35497	356	0	35981
19289	121	56	37042	311	0	37530
19290	48	35949	610	201	0	36808
19291	36767	332	334	116	0	37549
19292	407	313	38366	100	0	39186
19293	330	83	381	36839	0	37633
19294	131	62	346	38501	0	39040
19295	62	50	109	39188	0	39409
19296	59	86	38540	740	0	39425
19297	61	51	379	37938	0	38429
19298	37891	34	365	484	0	38774
19299	379	44	128	38183	0	38734
19300	361	81	38289	483	0	39214
19301	106	57	381	37962	0	38506
19302	38246	37	384	499	0	39166
19303	38739	33	150	436	0	39358
19304	38679	52	114	173	0	39018
19305	727	47	89	38417	0	39280
19306	38781	42	90	435	0	39348
19307	38541	39	119	412	0	39111
19308	38565	42	112	181	0	38900
19309	720	37806	122	162	0	38810
19310	37953	352	94	151	0	38550
19311	478	320	107	37792	0	38697
19312	420	120	37834	455	0	38829
19313	154	37858	431	452	0	38895
19314	37507	362	374	217	0	38460
19315	431	350	157	37488	0	38426
19316	427	105	122	36041	0	36695
19317	149	37569	117	717	0	38552
19318	114	38540	125	477	0	39256
19319	36358	620	123	216	0	37317
19320	404	37362	134	212	0	38112
19321	35798	416	89	140	0	36443
19322	430	36422	109	189	0	37150
19323	35194	401	119	155	0	35869
19324	418	36292	104	181	0	36995
19325	400	36775	112	199	0	37486
19326	36189	640	85	163	0	37077
19327	446	400	35809	146	0	36801
19328	393	36327	419	169	0	37308
19329	212	415	345	35963	0	36935
19330	186	369	138	37032	0	37725
19331	149	125	123	37043	0	37440
19332	166	95	89	37529	0	37879
19333	176	99	37204	803	0	38282
19334	34965	92	432	512	0	36001
19335	473	87	384	38029	0	38973
19336	38608	110	162	506	0	39386
19337	39700	98	128	451	0	40377
19338	40177	90	119	232	0	40618
19339	39011	94	149	195	0	39449
19340	877	133	38189	205	0	39404
19341	514	136	472	37031	0	38153
19342	239	102	37622	547	0	38510
19343	164	37046	600	521	0	38331
19344	258	594	492	34412	0	35756
19345	229	399	187	35632	0	36447
19346	145	128	169	35836	0	36278
19347	157	106	151	35450	0	35864
19348	167	98	34745	910	0	35920
19349	185	100	480	34637	0	35402
19350	197	92	465	35238	0	35992
19351	34882	104	204	858	0	36048
19352	35586	115	150	575	0	36426
19353	905	77	152	35946	0	37080
19354	566	91	190	36274	0	37121
19355	278	80	200	36739	0	37297
19356	36046	120	151	1115	0	37432
19357	36705	89	182	688	0	37664
19358	36610	84	177	368	0	37239
19359	36412	96	153	324	0	36985
19360	1043	36053	138	330	0	37564
19361	36494	472	143	315	0	37424
19362	36308	396	129	335	0	37168
19363	1014	147	101	35512	0	36774
19364	706	104	108	35329	0	36247
19365	34506	113	127	985	0	35731
19366	728	34073	118	676	0	35595
19367	643	34996	105	354	0	36098
19368	35128	788	101	303	0	36320
19369	786	456	97	34837	0	36176
19370	663	189	86	35280	0	36218
19371	418	162	72	35795	0	36447
19372	365	154	73	35435	0	36027
19373	373	135	74	34692	0	35274
19374	298	34038	116	1034	0	35486
19375	300	513	64	33120	0	33997
19376	32567	405	71	664	0	33707
19377	610	179	69	32293	0	33151
19378	493	163	67	32413	0	33136
19379	31591	154	88	874	0	32707
19380	577	31730	94	614	0	33015
19381	508	680	81	30449	0	31718
19382	269	31263	76	575	0	32183
19383	242	924	58	29148	0	30372
19384	250	360	28818	551	0	29979
19385	25497	224	423	435	0	26579
19386	444	27063	267	272	0	28046
19387	24224	305	102	204	0	24835
19388	406	251	22269	172	0	23098
19389	302	383	233	19127	0	20045
19390	128	20307	213	312	0	20960
19391	135	20564	97	300	0	21096
19392	19223	344	105	159	0	19831
19393	323	191	31	19351	0	19896
19394	255	71	20192	315	0	20833
19395	135	60	208	20493	0	20896
19396	120	58	20747	352	0	21277
19397	19492	64	240	294	0	20090
19398	305	71	20959	156	0	21491
19399	264	44	230	19823	0	20361
19400	149	21152	183	333	0	21817
19401	144	227	50	20160	0	20581
19402	117	21154	66	314	0	21651
19403	21362	256	52	283	0	21953
19404	337	201	39	21771	0	22348
19405	272	89	22016	371	0	22748
19406	173	78	21905	296	0	22452
19407	21388	50	367	221	0	22026
19408	22696	65	181	188	0	23130
19409	22703	65	64	191	0	23023
19410	22366	53	53	187	0	22659
19411	496	22372	68	193	0	23129
19412	22542	262	54	188	0	23046
19413	22557	193	35	174	0	22959
19414	491	104	22194	180	0	22969
19415	305	80	221	21798	0	22404
19416	22190	72	176	393	0	22831
19417	347	91	22023	317	0	22778
19418	284	85	237	21665	0	22271
19419	169	94	22722	415	0	23400
19420	194	79	267	21410	0	21950
19421	168	22922	193	363	0	23646
19422	23010	271	67	260	0	23608
19423	354	223	22597	183	0	23357
19424	22058	101	237	166	0	22562
19425	350	81	162	22307	0	22900
19426	22437	85	78	348	0	22948
19427	349	72	49	22455	0	22925
19428	24309	108	66	408	0	24891
19429	351	101	24155	292	0	24899
19430	25497	96	247	214	0	26054
19431	356	60	171	26079	0	26666
19432	252	74	90	26231	0	26647
19433	25785	49	67	470	0	26371
19434	325	91	53	25993	0	26462
19435	203	73	25645	334	0	26255
19436	156	112	221	25032	0	25521
19437	23760	35	136	281	0	24212
19438	226	23946	75	198	0	24445
19439	167	23853	50	110	0	24180
19440	23281	234	50	85	0	23650
19441	212	25856	45	84	0	26197
19442	231	177	91	25161	0	25660
19443	25908	103	69	193	0	26273
19444	25789	58	26	131	0	26004
19445	25762	46	21	69	0	25898
19446	261	59	26544	62	0	26926
19447	123	76	170	25792	0	26161
19448	43	27032	125	178	0	27378
19449	60	216	42	27120	0	27438
19450	76	119	28291	165	0	28651
19451	73	28053	169	145	0	28440
19452	82	260	78	26941	0	27361
19453	26097	70	42	124	0	26333
19454	111	26899	21	98	0	27129
19455	104	114	28305	38	0	28561
19456	42	72	140	27933	0	28187
19457	59	35	29044	172	0	29310
19458	40	27	148	27903	0	28118
19459	29632	12	136	195	0	29975
19460	163	15	23	29842	0	30043
19461	30381	18	21	171	0	30591
19462	30226	24	23	154	0	30427
19463	249	31833	43	54	0	32179
19464	32151	162	31	53	0	32397
19465	171	32581	44	76	0	32872
19466	148	183	33763	48	0	34142
19467	71	124	185	34466	0	34846
19468	55	28	126	37789	0	37998
19469	86	49	37498	362	0	37995
19470	35	37650	243	237	0	38165
19471	37966	208	162	63	0	38399
19472	39120	160	39	106	0	39425
19473	393	39	37	40341	0	40810
19474	206	19	26	40795	0	41046
19475	63	27	26	41608	0	41724
19476	41010	31	56	412	0	41509
19477	273	54	41030	221	0	41578
19478	229	55	41719	63	0	42066
19479	69	32	384	41440	0	41925
19480	84	63	42421	275	0	42843
19481	81	62	42673	218	0	43034
19482	64	38	405	40411	0	40918
19483	98	68	44054	280	0	44500
19484	61	44017	264	374	0	44716
19485	82	239	207	44491	0	45019
19486	96	212	45827	298	0	46433
19487	64	31	276	44495	0	44866
19488	40	45454	237	297	0	46028
19489	71	238	59	46102	0	46470
19490	112	205	47287	290	0	47894
19491	85	63	287	45604	0	46039
19492	45967	39	230	334	0	46570
19493	296	70	47237	237	0	47840
19494	43225	34	259	137	0	43655
19495	271	47302	225	131	0	47929
19496	47554	240	65	99	0	47958
19497	288	204	69	47414	0	47975
19498	188	48072	78	315	0	48653
19499	49240	263	54	262	0	49819
19500	288	225	70	49809	0	50392
19501	264	64	50607	349	0	51284
19502	66	51414	346	268	0	52094
19503	104	293	251	51482	0	52130
19504	51753	219	71	379	0	52422
19505	50929	57	67	262	0	51315
19506	512	44	51	51109	0	51716
19507	286	88	51360	352	0	52086
19508	46687	44	331	335	0	47397
19509	358	89	51622	118	0	52187
19510	249	68	303	50703	0	51323
19511	52382	37	253	388	0	53060
19512	311	52782	115	324	0	53532
19513	53268	278	75	155	0	53776
19514	376	280	52580	158	0	53394
19515	52622	60	348	167	0	53197
19516	352	58	293	54241	0	54944
19517	297	61	89	55689	0	56136
19518	174	98	56045	565	0	56882
19519	110	81	332	54664	0	55187
19520	56439	57	252	454	0	57202
19521	357	64	93	56838	0	57352
19522	291	59489	132	449	0	60361
19523	158	323	98	58544	0	59123
19524	88	60318	153	437	0	60996
19525	126	386	59477	340	0	60329
19526	55151	269	386	206	0	56012
19527	386	61	303	61067	0	61817
19528	373	102	60231	409	0	61115
19529	98	60480	406	411	0	61395
19530	123	379	325	59609	0	60436
19531	132	323	117	60362	0	60934
19532	60088	84	104	693	0	60969
19533	391	87	117	60999	0	61594
19534	61341	90	82	499	0	62012
19535	61027	73	132	432	0	61664
19536	653	61744	163	202	0	62762
19537	62178	366	94	189	0	62827
19538	451	316	109	66318	0	67194
19539	483	130	67410	538	0	68561
19540	66136	79	531	519	0	67265
19541	535	103	433	66638	0	67709
19542	539	115	66952	530	0	68136
19543	62819	106	490	533	0	63948
19544	546	113	425	66936	0	68020
19545	472	70139	153	592	0	71356
19546	200	496	121	67612	0	68429
19547	150	70061	164	533	0	70908
19548	68633	459	139	540	0	69771
19549	626	465	71628	225	0	72944
19550	497	71583	580	246	0	72906
19551	187	525	448	71775	0	72935
19552	210	516	72194	561	0	73481
19553	217	175	71078	577	0	72047
19554	162	72753	918	263	0	74096
19555	396	639	541	70746	0	72322
19556	173	435	145	71934	0	72687
19557	186	133	122	83672	0	84113
19558	85032	103	137	1141	0	86413
19559	859	183	90751	699	0	92492
19560	664	91331	946	313	0	93254
19561	224	888	717	89795	0	91624
19562	222	713	150	92600	0	93685
19563	256	207	92302	1585	0	94350
19564	248	232	934	91140	0	92554
19565	260	152	92287	1079	0	93778
19566	250	173	89133	837	0	90393
19567	258	169	89346	233	0	90006
19568	299	163	1497	82338	0	84297
19569	176	134	744	86473	0	87527
19570	162	109	168	89101	0	89540
19571	88082	90	161	1550	0	89883
19572	868	87818	262	888	0	89836
19573	89390	872	176	297	0	90735
19574	89012	706	183	277	0	90178
19575	90163	132	141	278	0	90714
19576	1539	91599	220	288	0	93646
19577	92122	934	158	277	0	93491
19578	91833	779	147	269	0	93028
19579	1697	196	156	90886	0	92935
19580	923	169	178	91740	0	93010
19581	284	159	193	93573	0	94209
19582	280	216	91798	1782	0	94076
19583	86567	150	1051	1053	0	88821
19584	1029	168	876	91071	0	93144
19585	89771	144	323	1211	0	91449
19586	1009	89698	324	1047	0	92078
19587	874	947	274	89752	0	91847
19588	266	776	298	90827	0	92167
19589	89598	205	263	1842	0	91908
19590	1112	164	202	89814	0	91292
19591	88082	193	201	1250	0	89726
19592	87170	177	202	1107	0	88656
19593	1744	87079	268	500	0	89591
19594	1010	88550	236	403	0	90199
19595	481	1851	229	85053	0	87614
19596	320	88195	276	1107	0	89898
19597	400	1044	179	88037	0	89660
19598	388	897	86840	1199	0	89324
19599	348	265	84707	1066	0	86386
19600	79511	246	1661	513	0	81931
19601	83231	182	934	504	0	84851
19602	1668	83118	398	484	0	85668
19603	82495	988	282	506	0	84271
19604	1053	83992	338	549	0	85932
19605	976	1031	303	83450	0	85760
19606	332	877	314	84057	0	85580
19607	334	247	328	84220	0	85129
19608	376	233	384	84548	0	85541
19609	82504	185	412	1977	0	85078
19610	1035	82812	401	1338	0	85586
19611	82706	965	351	644	0	84666
19612	82234	840	333	641	0	84048
19613	1889	349	81405	542	0	84185
19614	78591	321	990	588	0	80490
19615	1250	79897	929	545	0	82621
19616	1132	1142	303	79320	0	81897
19617	589	995	302	76258	0	78144
19618	479	78627	347	1816	0	81269
19619	78593	1068	366	1164	0	81191
19620	1386	906	76916	523	0	79731
19621	74590	278	1108	648	0	76624
19622	1409	308	75658	733	0	78108
19623	1212	234	1200	73941	0	76587
19624	580	344	1003	75635	0	77562
19625	524	291	439	76606	0	77860
19626	75166	346	390	2286	0	78188
19627	1305	375	75797	1490	0	78967
19628	74368	352	1163	956	0	76839
19629	75651	322	1059	849	0	77881
19630	75614	265	530	868	0	77277
19631	75194	245	590	700	0	76729
19632	2074	259	579	73518	0	76430
19633	1304	260	73274	1405	0	76243
19634	807	306	1087	71730	0	73930
19635	748	312	72774	1447	0	75281
19636	682	414	70719	1300	0	73115
19637	691	70943	1450	736	0	73820
19638	806	1086	794	64470	0	67156
19639	743	864	207	65527	0	67341
19640	731	447	220	62194	0	63592
19641	826	348	259	65541	0	66974
19642	64556	309	257	1513	0	66635
19643	64273	254	198	1040	0	65765
19644	1830	241	208	63137	0	65416
19645	1128	298	61352	1364	0	64142
19646	648	207	827	61991	0	63673
19647	594	213	667	62899	0	64373
19648	601	252	61944	1777	0	64574
19649	620	212	811	59913	0	61556
19650	59763	296	637	1279	0	61975
19651	59636	261	179	1111	0	61187
19652	59983	316	139	724	0	61162
19653	1664	281	149	58551	0	60645
19654	58079	225	177	1216	0	59697
19655	57164	195	282	940	0	58581
19656	1654	212	56273	530	0	58669
19657	634	115	42402	249	0	43400
19658	351	124	41651	183	0	42309
19659	32512	71	384	101	0	33068
19660	212	34264	209	101	0	34786
19661	33749	151	242	93	0	34235
19662	200	38060	85	147	0	38492
19663	245	181	53	37878	0	38357
19664	76	162	42	38632	0	38912
19665	82	41	40	39011	0	39174
19666	90	55	38653	373	0	39171
19667	34800	42	210	266	0	35318
19668	246	57	174	38253	0	38730
19669	208	71	38176	208	0	38663
19670	98	50	36500	187	0	36835
19671	35423	25	278	98	0	35824
19672	166	38315	167	86	0	38734
19673	37612	133	84	106	0	37935
19674	37408	128	65	87	0	37688
19675	251	37686	54	90	0	38081
19676	37020	121	91	58	0	37290
19677	185	153	38893	74	0	39305
19678	196	62	38021	50	0	38329
19679	85	72	39963	75	0	40195
19680	87	117	271	39164	0	39639
19681	77	35	40621	141	0	40874
19682	38316	28	135	156	0	38635
19683	39829	9	112	60	0	40010
19684	251	57	40621	48	0	40977
19685	165	17	127	39696	0	40005
19686	40791	21	123	159	0	41094
19687	131	45605	51	167	0	45954
19688	108	46656	46	90	0	46900
19689	46934	198	42	94	0	47268
19690	161	147	48255	63	0	48626
19691	148	267	120	46603	0	47138
19692	45	21	123	47977	0	48166
19693	33	18	16	48431	0	48498
19694	21	49014	44	216	0	49295
19695	36	121	18	49177	0	49352
19696	52058	93	26	176	0	52353
19697	169	28	22	52864	0	53083
19698	123	54667	64	232	0	55086
19699	56289	183	19	234	0	56725
19700	195	137	14	56852	0	57198
19701	159	39	16	60302	0	60516
19702	62961	18	17	379	0	63375
19703	63356	30	31	230	0	63647
19704	469	19	18	65966	0	66472
19705	68849	22	17	387	0	69275
19706	68413	19	20	296	0	68748
19707	595	70841	69	149	0	71654
19708	71118	400	23	86	0	71627
19709	425	71187	69	83	0	71764
19710	365	408	20	71447	0	72240
19711	142	387	74051	439	0	75019
19712	86	63	390	73510	0	74049
19713	86	56	325	74884	0	75351
19714	80	41	55	77361	0	77537
19715	76578	36	39	837	0	77490
19716	454	77200	91	598	0	78343
19717	79500	445	32	159	0	80136
19718	509	83654	86	251	0	84500
19719	85517	516	57	165	0	86255
19720	85560	419	68	125	0	86172
19721	85989	92	37	142	0	86260
19722	85848	63	51	129	0	86091
19723	1022	153	86136	82	0	87393
19724	569	62	533	85084	0	86248
19725	186	73	462	90474	0	91195
19726	168	132	89157	1057	0	90514
19727	84587	66	616	617	0	85886
19728	676	70	497	89261	0	90504
19729	633	98	88737	680	0	90148
19730	263	146	87455	582	0	88446
19731	183	97	1103	89420	0	90803
19732	296	144	93766	758	0	94964
19733	224	94	682	91539	0	92539
19734	181	73	554	92968	0	93776
19735	232	134	91869	1209	0	93444
19736	83159	91	690	773	0	84713
19737	735	65	567	91719	0	93086
19738	722	137	93734	798	0	95391
19739	251	104	672	93699	0	94726
19740	94012	67	635	829	0	95543
19741	795	151	94189	698	0	95833
19742	90156	76	709	382	0	91323
19743	96238	64	631	261	0	97194
19744	1275	56	202	96356	0	97889
19745	745	57	129	95826	0	96757
19746	328	153	96413	1268	0	98162
19747	274	66	729	95877	0	96946
19748	247	101	644	93166	0	94158
19749	253	65	218	97439	0	97975
19750	313	163	95377	1342	0	97195
19751	90699	69	740	912	0	92420
19752	96098	82	676	381	0	97237
19753	98589	97	250	393	0	99329
19754	101317	117	171	401	0	102006
19755	1395	105	214	101322	0	103036
19756	101746	108	173	951	0	102978
19757	101679	84	156	969	0	102888
19758	94147	135	273	470	0	95025
19759	102210	88	205	380	0	102883
19760	1340	101885	271	405	0	103901
19761	102944	670	199	388	0	104201
19762	99946	549	165	424	0	101084
19763	1361	100284	231	459	0	102335
19764	100744	726	236	345	0	102051
19765	1077	618	179	100733	0	102607
19766	919	165	168	101579	0	102831
19767	100593	88	210	1487	0	102378
19768	959	100144	274	971	0	102348
19769	825	100302	261	551	0	101939
19770	488	1231	208	102749	0	104676
19771	426	692	104035	990	0	106143
19772	407	161	836	101002	0	102406
19773	369	99	729	104339	0	105536
19774	102734	130	255	1498	0	104617
19775	102692	119	223	914	0	103948
19776	1559	110	238	103048	0	104955
19777	990	190	103039	983	0	105202
19778	488	112	878	103739	0	105217
19779	105394	84	826	1145	0	107449
19780	1165	153	110492	965	0	112775
19781	955	111141	1037	537	0	113670
19782	114228	872	822	435	0	116357
19783	1183	700	282	114562	0	116727
19784	1024	163	256	114850	0	116293
19785	436	144	277	118310	0	119167
19786	409	193	116183	1826	0	118611
19787	96718	111	1079	1366	0	99274
19788	1267	180	111279	477	0	113203
19789	1016	110731	1159	568	0	113474
19790	482	852	850	111363	0	113547
19791	404	713	351	112576	0	114044
19792	427	157	267	118002	0	118853
19793	449	182	117470	2041	0	120142
19794	485	190	116184	1194	0	118053
19795	470	211	120036	588	0	121305
19796	370	119673	1950	577	0	122570
19797	681	1052	1251	118643	0	121627
19798	122233	765	389	1304	0	124691
19799	127371	168	317	1164	0	129020
19800	2397	184	136856	465	0	139902
19801	1354	137257	1559	887	0	141057
19802	761	1429	137194	479	0	139863
19803	384	140492	1649	556	0	143081
19804	134422	2022	2062	628	0	139134
19805	132303	1067	440	410	0	134220
19806	2281	133293	330	496	0	136400
19807	133195	1291	286	324	0	135096
19808	1586	995	238	131900	0	134719
19809	1235	278	225	132863	0	134601
19810	132929	182	185	2249	0	135545
19811	129147	161	203	1254	0	130765
19812	128391	181	194	499	0	129265
19813	2376	129645	317	501	0	132839
19814	1177	132083	299	547	0	134106
19815	131135	2042	226	394	0	133797
19816	1594	1144	130959	308	0	134005
19817	1215	939	1316	126648	0	130118
19818	124373	215	1056	1337	0	126981
19819	1451	123606	407	1098	0	126562
19820	1098	126531	275	477	0	128381
19821	126374	1993	266	320	0	128953
19822	1545	1136	123895	246	0	126822
19823	119029	506	1363	284	0	121182
19824	1607	316	121506	239	0	123668
19825	1099	310	119706	191	0	121306
19826	517	363	1917	115644	0	118441
19827	439	300	121653	1162	0	123554
19828	116776	233	1388	932	0	119329
19829	121044	172	968	363	0	122547
19830	121741	173	369	311	0	122594
19831	120468	185	296	291	0	121240
19832	2178	201	231	116994	0	119604
19833	117415	213	251	1237	0	119116
19834	1497	117457	288	1009	0	120251
19835	1291	1221	258	109841	0	112611
19836	514	119724	324	1142	0	121704
19837	121850	1265	234	922	0	124271
19838	120531	928	234	415	0	122108
19839	2123	374	257	120270	0	123024
19840	121860	293	282	1315	0	123750
19841	121308	315	312	968	0	122903
19842	2187	275	323	120318	0	123103
19843	1359	318	309	120330	0	122316
19844	750	248	261	122463	0	123722
19845	669	375	119797	2063	0	122904
19846	743	368	116471	1136	0	118718
19847	689	340	119820	482	0	121331
19848	601	345	2137	117238	0	120321
19849	635	374	122012	1408	0	124429
19850	673	265	1510	118697	0	121145
19851	679	337	126898	1611	0	129525
19852	687	324	124469	1131	0	126611
19853	114964	329	2183	592	0	118068
19854	1571	121739	1291	511	0	125112
19855	122673	1333	604	436	0	125046
19856	1717	1005	435	121125	0	124282
19857	1405	424	391	121838	0	124058
19858	984	474	121616	2103	0	125177
19859	646	121528	1485	1514	0	125173
19860	692	1446	1103	121523	0	124764
19861	727	1121	123159	1484	0	126491
19862	581	122029	1569	1208	0	125387
19863	711	1386	1229	121172	0	124498
19864	120438	949	722	1404	0	123513
19865	119825	478	512	1072	0	121887
19866	2311	402	516	120304	0	123533
19867	120847	399	506	1470	0	123222
19868	1747	121707	557	1270	0	125281
19869	1490	1324	469	121796	0	125079
19870	1051	1090	124568	1442	0	128151
19871	952	483	1407	123442	0	126284
19872	951	463	125700	1720	0	128834
19873	118347	458	1559	1291	0	121655
19874	1925	405	1085	122561	0	125976
19875	1502	126115	564	1730	0	129911
19876	1085	1826	422	128165	0	131498
19877	937	1106	126993	1759	0	130795
19878	912	525	125901	1334	0	128672
19879	842	531	122778	696	0	124847
19880	109738	743	2698	533	0	113712
19881	1539	116098	1333	657	0	119627
19882	1237	1324	603	111460	0	114624
19883	113502	915	559	1428	0	116404
19884	1444	114070	683	1201	0	117398
19885	117116	1211	572	709	0	119608
19886	117348	957	582	534	0	119421
19887	119516	415	517	536	0	120984
19888	120305	286	582	491	0	121664
19889	2334	346	117477	404	0	120561
19890	112643	200	1517	523	0	114883
19891	1682	218	116339	443	0	118682
19892	101321	191	1552	428	0	103492
19893	1612	314	1138	109613	0	112677
19894	1236	224	107498	1180	0	110138
19895	742	105167	1203	961	0	108073
19896	964	5931	1154	94189	0	102238
19897	589	101681	468	914	0	103652
19898	514	100694	328	858	0	102394
19899	84498	1120	889	521	0	87028
19900	740	384	81964	244	0	83332
19901	370	78913	475	189	0	79947
19902	75878	467	691	167	0	77203
19903	390	78194	145	163	0	78892
19904	77820	342	95	129	0	78386
19905	450	274	83	77330	0	78137
19906	78354	93	111	383	0	78941
19907	414	76	84	77446	0	78020
19908	78173	83	117	422	0	78795
19909	415	111	85	77718	0	78329
19910	284	82242	142	439	0	83107
19911	163	370	103	83675	0	84311
19912	82969	267	104	425	0	83765
19913	356	83506	158	336	0	84356
19914	305	365	104	83222	0	83996
19915	84390	275	106	466	0	85237
19916	423	130	113	85717	0	86383
19917	341	118	95	86208	0	86762
19918	214	169	88121	627	0	89131
19919	221	139	86839	339	0	87538
19920	164	136	552	85342	0	86194
19921	244	194	91831	496	0	92765
19922	180	110	392	90622	0	91304
19923	182	121	292	88196	0	88791
19924	194	147	114	92855	0	93310
19925	216	188	93921	648	0	94973
19926	232	139	379	89990	0	90740
19927	201	124	283	91720	0	92328
19928	181	95445	171	652	0	96449
19929	203	418	109	96750	0	97480
19930	96395	298	124	532	0	97349
19931	498	117	117	98619	0	99351
19932	452	196	117185	587	0	118420
19933	106122	126	1074	588	0	107910
19934	1009	128957	813	469	0	131248
19935	835	1127	263	130037	0	132262
19936	372	883	130503	1238	0	132996
19937	118105	238	1241	1044	0	120628
19938	1168	129481	959	446	0	132054
19939	129263	1173	290	348	0	131074
19940	1320	883	192	127841	0	130236
19941	127554	280	224	1292	0	129350
19942	1479	217	128829	966	0	131491
19943	935	127990	1268	440	0	130633
19944	372	136766	942	343	0	138423
19945	137174	1811	316	345	0	139646
19946	136940	968	178	276	0	138362
19947	2053	364	137162	180	0	139759
19948	130238	200	1215	265	0	131918
19949	135101	198	851	256	0	136406
19950	136014	175	285	297	0	136771
19951	2026	134943	215	339	0	137523
19952	1058	137072	207	337	0	138674
19953	135769	1793	155	268	0	137985
19954	135477	935	145	294	0	136851
19955	1900	139740	219	329	0	142188
19956	1072	1208	113	139871	0	142264
19957	459	984	141567	1193	0	144203
19958	136819	340	1208	1073	0	139440
19959	136832	268	1028	540	0	138668
19960	149694	224	312	376	0	150606
19961	1878	150406	256	407	0	152947
19962	1150	1283	153541	318	0	156292
19963	153333	869	1201	367	0	155770
19964	1368	327	931	159174	0	161800
19965	1124	206	305	160812	0	162447
19966	502	244	173	163947	0	164866
19967	468	301	162688	2146	0	165603
19968	469	336	1184	157875	0	159864
19969	427	385	163590	1562	0	165964
19970	215	158501	1300	1295	0	161311
19971	152382	1066	904	421	0	154773
19972	1001	156370	328	406	0	158105
19973	848	158540	256	500	0	160144
19974	156841	1651	258	310	0	159060
19975	1025	165037	243	363	0	166668
19976	879	1285	132	160750	0	163046
19977	358	165680	228	1059	0	167325
19978	165223	1236	123	784	0	167366
19979	1130	168499	180	439	0	170248
19980	977	1302	126	169891	0	172296
19981	527	1049	170745	1297	0	173618
19982	300	395	1141	168841	0	170677
19983	257	173807	1006	1950	0	177020
19984	314	1349	355	176019	0	178037
19985	322	1165	197	175346	0	177030
19986	362	412	161	176780	0	177715
19987	355	215	169	179330	0	180069
19988	353	251	184	180048	0	180836
19989	382	231	222	181625	0	182460
19990	397	365	177603	2613	0	180978
19991	162132	290	1494	1651	0	165567
19992	1500	264	1105	185914	0	188783
19993	1302	419	185472	1796	0	188989
19994	749	432	185971	1417	0	188569
19995	484	365	2633	187206	0	190688
19996	190546	309	1429	1759	0	194043
19997	1856	565	187806	1310	0	191537
19998	181535	290	1677	707	0	184209
19999	2108	524	198351	428	0	201411
20000	1661	394	1878	195283	0	199216
20001	822	399	1350	203754	0	206325
20002	820	570	202649	2675	0	206714
20003	183894	422	1803	1711	0	187830
20004	2039	384	1321	200546	0	204290
20005	1752	505	203119	1776	0	207152
20006	1034	466	205522	1446	0	208468
20007	972	469	2770	188764	0	192975
20008	627	207501	1746	1617	0	211491
20009	209558	1681	575	1370	0	213184
20010	207269	1462	429	691	0	209851
20011	3192	740	212360	468	0	216760
20012	1946	418	1755	201976	0	206095
20013	210223	430	1438	2020	0	214111
20014	2116	511	214188	1619	0	218434
20015	202154	293	1843	915	0	205205
20016	2126	216257	1731	731	0	220845
20017	1727	1658	607	218768	0	222760
20018	822	1397	524	220057	0	222800
20019	226582	448	488	3157	0	230675
20020	2059	381	464	228062	0	230966
20021	1810	367	486	225726	0	228389
20022	771	374	402	228772	0	230319
20023	222283	285	538	3772	0	226878
20024	2161	497	225567	2139	0	230364
20025	219508	338	2067	1255	0	223168
20026	226527	311	1738	944	0	229520
20027	229494	333	706	897	0	231430
20028	3618	499	588	225258	0	229963
20029	2111	630	231252	2369	0	236362
20030	822	228561	2272	2037	0	233692
20031	616	233546	1828	1053	0	237043
20032	460	218624	679	759	0	220522
20033	1272	2328	216745	658	0	221003
20034	1022	2301	1734	236601	0	241658
20035	247926	268	1514	2703	0	252411
20036	260926	182	434	1889	0	263431
20037	3987	219	317	272708	0	277231
20038	2081	354	276597	2988	0	282020
20039	815	387	275400	2088	0	278690
20040	548	165	4368	274984	0	280065
20041	576	356	283407	3166	0	287505
20042	548	201	3141	280847	0	284737
20043	576	324	2028	268813	0	271741
20044	370	283035	869	4761	0	289035
20045	645	2778	484	285176	0	289083
20046	620	1878	500	291001	0	293999
20047	286258	579	554	5244	0	292635
20048	3332	266	430	289097	0	293125
20049	2389	281	457	287910	0	291037
20050	281721	231	477	5295	0	287724
20051	3131	283510	776	2964	0	290381
20052	285850	2842	608	1167	0	290467
20053	3709	2200	282947	867	0	289723
20054	276622	524	3377	1029	0	281552
20055	278150	325	2321	1060	0	281856
20056	5300	534	277414	967	0	284215
20057	2787	541	275378	995	0	279701
20058	1273	561	5111	262510	0	269455
20059	267020	289	2858	3665	0	273832
20060	3534	474	265916	2769	0	272693
20061	2553	232	3778	261487	0	268050
20062	1225	470	263313	3929	0	268937
20063	1149	331	3799	255086	0	260365
20064	1013	388	2618	255845	0	259864
20065	257068	367	1044	5772	0	264251
20066	255892	393	892	3337	0	260514
20067	258032	509	818	1824	0	261183
20068	5797	580	259567	1707	0	267651
20069	3205	546	257758	1622	0	263131
20070	1741	448	5539	251774	0	259502
20071	1239	513	3043	255375	0	260170
20072	1411	462	1589	259694	0	263156
20073	250885	467	1364	5961	0	258677
20074	3780	253401	1325	4108	0	262614
20075	242397	3207	1315	1925	0	248844
20076	237282	2147	1360	1837	0	242626
20077	5312	243555	1338	2123	0	252328
20078	3127	244651	1353	1893	0	251024
20079	236713	4502	1312	1983	0	244510
20080	3870	2209	1205	229420	0	236704
20081	3258	235222	1191	4681	0	244352
20082	2510	3185	1178	235790	0	242663
20083	2256	2230	233360	4895	0	242741
20084	1929	863	4069	230869	0	237730
20085	229192	720	3887	5047	0	238846
20086	4393	755	229151	4119	0	238418
20087	3477	766	229020	2703	0	235966
20088	2371	2828	6275	197029	0	208503
20089	1923	219745	3807	4892	0	230367
20090	1896	222634	2219	4087	0	230836
20091	1864	226219	2044	3167	0	233294
20092	217759	4565	1861	3517	0	227702
20093	216781	2321	1659	3170	0	223931
20094	209935	1011	1746	3149	0	215841
20095	5524	212222	1817	3930	0	223493
20096	215301	2908	1772	3124	0	223105
20097	212266	2323	1708	2845	0	219142
20098	6451	1695	211205	2998	0	222349
20099	4556	204087	4554	2532	0	215729
20100	3259	3510	3802	202779	0	213350
20101	202257	2343	2384	5063	0	212047
20102	5281	1245	202316	4133	0	212975
20103	3792	959	5058	190842	0	200651
20104	2495	199092	3987	5800	0	211374
20105	2782	3182	2621	197074	0	205659
20106	2835	2352	2511	196129	0	203827
20107	197225	1242	2237	6973	0	207677
20108	195846	1482	2291	4649	0	204268
20109	6360	1533	2305	193267	0	203465
20110	4395	1511	190369	5515	0	201790
20111	3310	1654	187129	4346	0	196439
20112	183744	1621	5234	3096	0	193695
20113	6296	1416	190245	2966	0	200923
20114	5271	1446	4469	160618	0	171804
20115	3588	179175	4048	4056	0	190867
20116	175558	3165	2886	3489	0	185098
20117	4978	176841	3144	2883	0	187846
20118	178612	3403	2806	3088	0	187909
20119	5177	2253	2294	175024	0	184748
20120	4374	1514	2335	174749	0	182972
20121	175460	1734	2218	5684	0	185096
20122	176959	1680	1808	3763	0	184210
20123	6963	1837	2079	174570	0	185449
20124	4845	2143	2038	172973	0	181999
20125	3429	1975	170195	5362	0	180961
20126	3023	1792	168212	3755	0	176782
20127	164292	1658	5194	3040	0	174184
20128	4985	1764	164083	3009	0	173841
20129	159202	1518	3957	2960	0	167637
20130	161586	1249	3444	2720	0	168999
20131	6481	1261	156176	2641	0	166559
20132	4120	149701	4099	2267	0	160187
20133	2930	149161	3604	1908	0	157603
20134	2189	2030	113463	966	0	118648
20135	4311	8465	5322	90580	0	108678
20136	82917	1550	3613	2830	0	90910
20137	79169	317	367	813	0	80666
20138	85301	233	283	505	0	86322
20139	96060	267	225	503	0	97055
20140	96493	256	236	446	0	97431
20141	1831	100653	354	515	0	103353
20142	96963	1035	266	305	0	98569
20143	1231	97277	290	357	0	99155
20144	94663	989	243	184	0	96079
20145	1121	653	92147	154	0	94075
20146	781	141	862	88666	0	90450
20147	351	93	536	84164	0	85144
20148	154	89618	188	1295	0	91255
20149	89995	827	100	566	0	91488
20150	90319	587	76	188	0	91170
20151	1447	166	79	88814	0	90506
20152	796	91	83	90277	0	91247
20153	89618	91	98	1391	0	91198
20154	1003	85	77	90019	0	91184
20155	687	117	81	90629	0	91514
20156	90024	95	77	1426	0	91622
20157	1016	118	59	89999	0	91192
20158	90350	99	86	1009	0	91544
20159	90287	69	86	730	0	91172
20160	1517	153	90084	237	0	91991
20161	89955	79	867	265	0	91166
20162	89423	77	564	238	0	90302
20163	89612	93	144	255	0	90104
20164	1618	148	87567	190	0	89523
20165	914	100	880	84573	0	86467
20166	450	88	568	87512	0	88618
20167	368	166	86796	1406	0	88736
20168	82633	89	966	725	0	84413
20169	1116	67	592	83714	0	85489
20170	850	156	83128	982	0	85116
20171	420	153	84156	698	0	85427
20172	363	85	1421	83137	0	85006
20173	445	134	84680	1087	0	86346
20174	372	96	1073	82984	0	84525
20175	475	83	670	84227	0	85455
20176	467	161	83717	1549	0	85894
20177	452	184	1000	77222	0	78858
20178	383	81411	747	1082	0	83623
20179	350	83648	356	876	0	85230
20180	82088	1427	272	330	0	84117
20181	81485	683	237	339	0	82744
20182	1590	81711	265	462	0	84028
20183	81704	974	218	386	0	83282
20184	81659	658	216	312	0	82845
20185	1807	295	200	80325	0	82627
20186	1067	261	181	81804	0	83313
20187	79552	266	185	1660	0	81663
20188	1272	79469	239	1002	0	81982
20189	1041	79742	287	525	0	81595
20190	673	1645	244	78734	0	81296
20191	656	784	78916	1272	0	81628
20192	75060	283	1052	1038	0	77433
20193	77548	228	747	598	0	79121
20194	75234	257	261	575	0	76327
20195	1996	76394	286	522	0	79198
20196	1334	1093	232	73255	0	75914
20197	897	760	233	76029	0	77919
20198	74462	305	259	1783	0	76809
20199	1525	74184	348	1192	0	77249
20200	1258	1109	271	72887	0	75525
20201	944	783	264	74026	0	76017
20202	934	375	229	74399	0	75937
20203	72693	319	282	1917	0	75211
20204	1734	72555	381	1299	0	75969
20205	1486	1459	290	67510	0	70745
20206	1018	72471	378	1413	0	75280
20207	71321	1195	454	1092	0	74062
20208	1705	858	70747	819	0	74129
20209	68205	313	1320	945	0	70783
20210	1595	290	69256	973	0	72114
20211	1391	833	1199	65138	0	68561
20212	65382	305	886	1560	0	68133
20213	1577	321	63838	1204	0	66940
20214	63216	253	1130	861	0	65460
20215	63741	212	859	798	0	65610
20216	63758	183	482	840	0	65263
20217	2069	182	462	60787	0	63500
20218	1280	229	447	60384	0	62340
20219	857	181	416	61437	0	62891
20220	59161	146	443	1983	0	61733
20221	1550	58897	478	1337	0	62262
20222	57421	852	479	735	0	59487
20223	57736	579	487	620	0	59422
20224	1885	348	55979	616	0	58828
20225	55531	273	1144	595	0	57543
20226	56625	250	855	600	0	58330
20227	1873	247	524	55363	0	58007
20228	1182	265	534	55496	0	57477
20229	765	260	494	55684	0	57203
20230	53370	242	492	1781	0	55885
20231	52494	229	530	1168	0	54421
20232	49156	227	473	703	0	50559
20233	1450	46288	435	693	0	48866
20234	677	41062	455	526	0	42720
20235	408	40853	438	540	0	42239
20236	39700	976	602	621	0	41899
20237	977	465	38899	600	0	40941
20238	650	276	31336	463	0	32725
20239	17586	122	566	166	0	18440
20240	281	56	17452	115	0	17904
20241	64	8	58	12067	0	12197
20242	15	12893	59	86	0	13053
20243	13068	64	53	58	0	13243
20244	13059	60	11	11	0	13141
20245	13167	11	6	28	0	13212
20246	122	14	10	13918	0	14064
20247	63	26	14545	67	0	14701
20248	32	22	14332	54	0	14440
20249	14284	14	107	23	0	14428
20250	14754	13	67	23	0	14857
20251	14700	13	18	25	0	14756
20252	123	13	10	14763	0	14909
20253	78	7	10	14943	0	15038
20254	34	15	14964	112	0	15125
20255	14544	16	67	82	0	14709
20256	79	16	49	15482	0	15626
20257	77	11	7	15422	0	15517
20258	28	12	14	15381	0	15435
20259	32	15595	12	119	0	15758
20260	36	59	13	15479	0	15587
20261	24	51	26	15529	0	15630
20262	15275	11	18	108	0	15412
20263	77	12	15222	66	0	15377
20264	14652	6	59	33	0	14750
20265	15459	12	58	27	0	15556
20266	120	15	10	15319	0	15464
20267	78	11	5	15402	0	15496
20268	15234	8	12	112	0	15366
20269	71	24	15114	86	0	15295
20270	71	15183	68	31	0	15353
20271	34	46	56	14559	0	14695
20272	14508	45	16	57	0	14626
20273	69	6	6	14234	0	14315
20274	76	9	14192	53	0	14330
20275	32	14	14470	65	0	14581
20276	14175	14	91	35	0	14315
20277	65	8	53	15082	0	15208
20278	71	6	14968	53	0	15098
20279	14556	11	45	79	0	14691
20280	15966	7	52	55	0	16080
20281	97	9	5	16012	0	16123
20282	66	8	11	15962	0	16047
20283	26	16265	19	83	0	16393
20284	17053	31	12	76	0	17172
20285	68	44	9	17165	0	17286
20286	73	10	13	17289	0	17385
20287	29	23	17677	79	0	17808
20288	16235	9	35	70	0	16349
20289	17527	2	42	44	0	17615
20290	72	17560	22	55	0	17709
20291	51	34	16965	21	0	17071
20292	22	25	16755	17	0	16819
20293	32	78	58	16381	0	16549
20294	17672	7	57	84	0	17820
20295	36	15	5	17783	0	17839
20296	19472	3	5	76	0	19556
20297	19787	6	6	49	0	19848
20298	20454	9	9	40	0	20512
20299	58	3	5	21447	0	21513
20300	36	7	6	21868	0	21917
20301	22179	3	7	46	0	22235
20302	40	19	23327	18	0	23404
20303	21073	6	24	40	0	21143
20304	22080	6	13	35	0	22134
20305	39	19	23366	14	0	23438
20306	44	6	23485	19	0	23554
20307	4	23864	45	26	0	23939
20308	19	48	31	24013	0	24111
20309	21400	40	48	89	0	21577
20310	22	5	4	24509	0	24540
20311	31	25	25473	34	0	25563
20312	7	25372	33	51	0	25463
20313	7	26429	35	38	0	26509
20314	12	35	7	27583	0	27637
20315	17	19	7	27395	0	27438
20316	8	28236	24	69	0	28337
20317	22	41	27939	40	0	28042
20318	25532	27	26	43	0	25628
20319	28714	2	19	33	0	28768
20320	37	28927	24	54	0	29042
20321	28621	33	3	33	0	28690
20322	39	49	4	28412	0	28504
20323	28826	6	5	63	0	28900
20324	37	9	3	28811	0	28860
20325	25	31427	19	64	0	31535
20326	39	77	32049	56	0	32221
20327	18	44	74	34483	0	34619
20328	18	10	53	34806	0	34887
20329	15	10	8	36368	0	36401
20330	37204	6	13	200	0	37423
20331	143	9	4	37418	0	37574
20332	141	27	40082	142	0	40392
20333	54	57	41205	112	0	41428
20334	41170	6	320	81	0	41577
20335	219	37	43645	35	0	43936
20336	42841	13	212	54	0	43120
20337	229	7	169	47160	0	47565
20338	209	17	47	48166	0	48439
20339	58	10	29	50368	0	50465
20340	41	16	31	50650	0	50738
20341	49831	7	19	579	0	50436
20342	341	37	51379	338	0	52095
20343	302	20	296	49530	0	50148
20344	40	52240	309	318	0	52907
20345	51777	297	43	292	0	52409
20346	318	277	21	51320	0	51936
20347	51108	39	36	352	0	51535
20348	389	55	51381	312	0	52137
20349	324	25	334	48725	0	49408
20350	49	51121	320	367	0	51857
20351	51194	308	47	326	0	51875
20352	375	301	51520	99	0	52295
20353	327	36	343	50226	0	50932
20354	79	20	316	51555	0	51970
20355	51115	21	92	650	0	51878
20356	374	67	51345	355	0	52141
20357	342	84	51690	97	0	52213
20358	111	26	649	50966	0	51752
20359	112	52	52126	384	0	52674
20360	107	60	52612	370	0	53149
20361	99	33	656	50743	0	51531
20362	113	38	362	51267	0	51780
20363	90	33	99	54040	0	54262
20364	53646	30	79	711	0	54466
20365	384	54449	104	532	0	55469
20366	53781	351	84	159	0	54375
20367	440	326	88	53770	0	54624
20368	380	55000	110	501	0	55991
20369	125	409	75	56135	0	56744
20370	56984	344	75	526	0	57929
20371	441	60076	101	563	0	61181
20372	440	458	80	61344	0	62322
20373	183	448	62023	594	0	63248
20374	59635	91	572	582	0	60880
20375	545	74	510	61515	0	62644
20376	526	73	145	61973	0	62717
20377	243	88	61566	1005	0	62902
20378	145	102	61268	645	0	62160
20379	58334	49	971	265	0	59619
20380	562	60401	589	236	0	61788
20381	549	511	166	59933	0	61159
20382	60242	467	138	648	0	61495
20383	640	128	60315	609	0	61692
20384	533	59619	661	288	0	61101
20385	188	560	556	59359	0	60663
20386	59330	479	150	726	0	60685
20387	58640	113	152	672	0	59577
20388	59006	90	165	324	0	59585
20389	1025	58394	210	350	0	59979
20390	648	567	58291	262	0	59768
20391	212	514	652	58168	0	59546
20392	223	144	612	54319	0	55298
20393	201	106	192	58892	0	59391
20394	233	79	176	58580	0	59068
20395	57478	85	220	1193	0	58976
20396	55725	91	204	770	0	56790
20397	1092	158	55466	344	0	57060
20398	700	117	54544	318	0	55679
20399	52213	88	1076	298	0	53675
20400	52983	96	651	324	0	54054
20401	1090	108	313	51159	0	52670
20402	653	51904	256	738	0	53551
20403	51244	575	196	708	0	52723
20404	643	51439	209	402	0	52693
20405	608	50598	218	429	0	51853
20406	406	1047	207	50163	0	51823
20407	282	548	193	50734	0	51757
20408	245	164	188	51036	0	51633
20409	252	147	203	50820	0	51422
20410	288	171	49426	1139	0	51024
20411	47222	145	624	736	0	48727
20412	48964	142	582	348	0	50036
20413	1120	156	219	47391	0	48886
20414	707	150	202	47067	0	48126
20415	46751	140	216	1147	0	48254
20416	714	158	45880	738	0	47490
20417	46136	127	652	348	0	47263
20418	46505	111	599	345	0	47560
20419	1196	149	45653	328	0	47326
20420	46195	124	672	326	0	47317
20421	752	110	650	46333	0	47845
20422	669	129	299	46730	0	47827
20423	322	117	254	46814	0	47507
20424	345	128	208	46366	0	47047
20425	42917	124	208	1111	0	44360
20426	733	110	220	42197	0	43260
20427	586	107	158	38496	0	39347
20428	231	37181	159	1014	0	38585
20429	213	37410	195	640	0	38458
20430	240	754	148	36317	0	37459
20431	36038	406	110	563	0	37117
20432	581	125	107	33513	0	34326
20433	436	121	30923	482	0	31962
20434	212	91	29563	402	0	30268
20435	28136	73	634	192	0	29035
20436	427	28852	374	204	0	29857
20437	25486	279	374	156	0	26295
20438	419	278	25316	141	0	26154
20439	568	705	334	22513	0	24120
20440	22275	71	325	330	0	23001
20441	284	22335	113	324	0	23056
20442	21727	219	116	145	0	22207
20443	338	199	23237	132	0	23906
20444	299	88	244	22582	0	23213
20445	133	59	254	23179	0	23625
20446	23572	66	135	486	0	24259
20447	23629	56	111	284	0	24080
20448	24212	73	75	146	0	24506
20449	24412	78	44	125	0	24659
20450	24456	79	64	140	0	24739
20451	439	24655	84	183	0	25361
20452	292	217	74	24730	0	25313
20453	25291	199	74	299	0	25863
20454	305	73	48	25249	0	25675
20455	316	46	49	25141	0	25552
20456	198	48	49	25036	0	25331
20457	145	24618	73	443	0	25279
20458	24598	216	70	279	0	25163
20459	277	193	63	24455	0	24988
20460	23750	46	69	318	0	24183
20461	23123	29	44	310	0	23506
20462	400	23008	66	172	0	23646
20463	22808	167	55	139	0	23169
20464	310	164	22475	118	0	23067
20465	21623	41	236	80	0	21980
20466	315	117	328	21464	0	22224
20467	247	53	22342	197	0	22839
20468	128	22600	178	261	0	23167
20469	199	176	22222	112	0	22709
20470	67	19912	118	60	0	20157
20471	17105	344	436	212	0	18097
20472	17324	59	51	84	0	17518
20473	17180	6	24	31	0	17241
20474	47	17553	19	33	0	17652
20475	17297	20	16	24	0	17357
20476	44	32	17815	10	0	17901
20477	31	27	18510	28	0	18596
20478	17	65	30	18082	0	18194
20479	17	22	44	19436	0	19519
20480	7	19765	13	65	0	19850
20481	20179	19	10	34	0	20242
20482	33	18	8	20422	0	20481
20483	26	21251	25	65	0	21367
20484	17	52	5	21903	0	21977
20485	22040	30	5	57	0	22132
20486	21806	11	11	69	0	21897
20487	81	24	21485	23	0	21613
20488	52	7	45	21664	0	21768
20489	25	59	22108	68	0	22260
20490	19	14	49	22326	0	22408
20491	53	35	22857	76	0	23021
20492	16	12	57	22592	0	22677
20493	32	29	23277	74	0	23412
20494	23	8	61	22906	0	22998
20495	53	29	24403	95	0	24580
20496	30	18	69	24229	0	24346
20497	11	22	45	24982	0	25060
20498	12	26957	35	126	0	27130
20499	19	66	9	27651	0	27745
20500	42	73	27496	85	0	27696
20501	29	17	66	27181	0	27293
20502	17	18	47	27868	0	27950
20503	28167	11	12	143	0	28333
20504	77	10	24	28696	0	28807
20505	62	9	19	28856	0	28946
20506	41	42	28313	162	0	28558
20507	27268	17	80	130	0	27495
20508	81	15	54	29769	0	29919
20509	70	9	23	29943	0	30045
20510	24	8	23	30276	0	30331
20511	30412	12	15	157	0	30596
20512	84	9	26	30892	0	31011
20513	70	10	13	30987	0	31080
20514	30716	6	27	174	0	30923
20515	85	30944	34	143	0	31206
20516	83	73	19	30841	0	31016
20517	39	64	18	31131	0	31252
20518	50	49	30713	183	0	30995
20519	23087	29	145	264	0	23525
20520	97	30	59	30716	0	30902
20521	80	52	30282	162	0	30576
20522	30102	10	83	165	0	30360
20523	106	20	64	32256	0	32446
20524	84	22	21	33023	0	33150
20525	26	14	24	33322	0	33386
20526	32	16	17	34054	0	34119
20527	63	26	36526	226	0	36841
20528	51	11	146	36684	0	36892
20529	40	13	110	44707	0	44870
20530	74	66	51813	513	0	52466
20531	52419	11	608	330	0	53368
20532	55655	15	402	130	0	56202
20533	56452	14	121	94	0	56681
20534	1194	30	61	55489	0	56774
20535	56293	25	49	711	0	57078
20536	57090	19	37	499	0	57645
20537	1155	23	35	57136	0	58349
20538	58841	24	50	770	0	59685
20539	58767	23	38	514	0	59342
20540	59059	20	48	212	0	59339
20541	59557	15	29	132	0	59733
20542	1280	20	24	57137	0	58461
20543	602	56485	91	737	0	57915
20544	239	57220	82	528	0	58069
20545	115	58286	77	245	0	58723
20546	56598	1183	46	204	0	58031
20547	57504	561	61	132	0	58258
20548	1191	218	56806	116	0	58331
20549	57146	82	729	115	0	58072
20550	933	56	483	58671	0	60143
20551	626	26	150	58601	0	59403
20552	272	33	80	59530	0	59915
20553	57720	29	59	1405	0	59213
20554	838	35	47	57893	0	58813
20555	571	57413	101	963	0	59048
20556	256	708	29	58459	0	59452
20557	199	530	59137	934	0	60800
20558	214	147	733	59078	0	60172
20559	58941	67	499	964	0	60471
20560	935	100	59515	609	0	61159
20561	646	51	782	59062	0	60541
20562	324	61	514	58325	0	59224
20563	250	62	161	59291	0	59764
20564	170	59802	111	1333	0	61416
20565	248	740	76	60484	0	61548
20566	59810	497	98	1011	0	61416
20567	59213	161	84	701	0	60159
20568	1409	134	58426	306	0	60275
20569	801	99	58914	234	0	60048
20570	360	59	1229	57529	0	59177
20571	282	64	633	59308	0	60287
20572	291	111	59719	1349	0	61470
20573	344	129	856	54372	0	55701
20574	221	59029	590	899	0	60739
20575	60155	792	203	656	0	61806
20576	59564	516	132	350	0	60562
20577	58963	161	116	296	0	59536
20578	1620	122	58609	254	0	60605
20579	907	91	855	57599	0	59452
20580	501	99	58238	1038	0	59876
20581	54887	77	945	787	0	56696
20582	980	57355	623	418	0	59376
20583	805	813	209	56583	0	58410
20584	56713	544	143	989	0	58389
20585	1059	208	110	56443	0	57820
20586	814	130	123	57660	0	58727
20587	453	175	56662	1470	0	58760
20588	51819	116	881	933	0	53749
20589	1120	56507	660	461	0	58748
20590	894	770	240	56459	0	58363
20591	56291	552	164	1049	0	58056
20592	1151	241	135	56586	0	58113
20593	56170	183	133	1179	0	57665
20594	1220	56278	142	911	0	58551
20595	56249	827	132	481	0	57689
20596	1332	606	56622	382	0	58942
20597	56020	240	947	378	0	57585
20598	55918	122	659	410	0	57109
20599	56062	149	335	388	0	56934
20600	1872	161	208	54395	0	56636
20601	1156	221	148	53582	0	55107
20602	666	262	145	54351	0	55424
20603	540	53916	139	1658	0	56253
20604	53914	910	143	1005	0	55972
20605	1296	607	181	53838	0	55922
20606	1070	243	195	53893	0	55401
20607	715	166	236	54102	0	55219
20608	52674	141	220	1744	0	54779
20609	1150	156	184	53571	0	55061
20610	882	202	52411	1462	0	54957
20611	449	52347	900	1097	0	54793
20612	369	1008	572	52843	0	54792
20613	396	746	262	53411	0	54815
20614	414	350	261	54557	0	55582
20615	474	225	52866	1750	0	55315
20616	469	183	53089	1053	0	54794
20617	429	123	1479	52918	0	54949
20618	447	159	55341	1328	0	57275
20619	351	106	1110	55525	0	57092
20620	55711	129	750	1519	0	58109
20621	57203	182	312	1198	0	58895
20622	57194	223	243	699	0	58359
20623	1759	264	55613	529	0	58165
20624	53750	217	950	501	0	55418
20625	1366	220	797	55369	0	57752
20626	986	135	55315	1133	0	57569
20627	572	88	53876	863	0	55399
20628	404	52686	1507	641	0	55238
20629	227	44718	725	303	0	45973
20630	35051	593	1317	224	0	37185
20631	431	177	100	33492	0	34200
20632	222	64	34269	276	0	34831
20633	95	62	240	34169	0	34566
20634	34558	46	188	281	0	35073
20635	285	59	37744	202	0	38290
20636	37410	43	268	156	0	37877
20637	40265	41	193	106	0	40605
20638	39920	24	62	115	0	40121
20639	505	40053	83	122	0	40763
20640	41169	283	62	153	0	41667
20641	354	191	68	41594	0	42207
20642	278	52	55	41593	0	41978
20643	146	29	45	42059	0	42279
20644	118	46	59	41820	0	42043
20645	40520	31	50	560	0	41161
20646	354	40540	81	350	0	41325
20647	229	39681	74	157	0	40141
20648	102	40896	65	134	0	41197
20649	40639	466	67	123	0	41295
20650	40659	197	67	101	0	41024
20651	40458	57	40	99	0	40654
20652	40307	43	51	94	0	40495
20653	534	37	48	40186	0	40805
20654	270	51	43	40499	0	40863
20655	40289	43	43	479	0	40854
20656	327	40493	59	303	0	41182
20657	39424	288	37	117	0	39866
20658	39687	196	47	130	0	40060
20659	533	54	42	38993	0	39622
20660	269	40014	68	371	0	40722
20661	130	346	48	40854	0	41378
20662	40130	200	50	413	0	40793
20663	424	78	41378	259	0	42139
20664	309	94	326	38677	0	39406
20665	106	41200	243	363	0	41912
20666	40973	334	71	270	0	41648
20667	40332	218	66	129	0	40745
20668	624	90	41489	90	0	42293
20669	298	40817	356	146	0	41617
20670	189	367	41408	99	0	42063
20671	127	352	335	39367	0	40181
20672	115	102	40569	341	0	41127
20673	139	96	40065	246	0	40546
20674	95	40059	492	115	0	40761
20675	39651	309	223	99	0	40282
20676	39859	213	98	136	0	40306
20677	499	42096	98	195	0	42888
20678	285	42151	80	171	0	42687
20679	185	504	40550	97	0	41336
20680	176	267	40872	103	0	41418
20681	168	120	41817	90	0	42195
20682	125	91	518	40752	0	41486
20683	172	97	42202	376	0	42847
20684	169	98	345	40481	0	41093
20685	159	56	215	41105	0	41535
20686	153	120	42116	527	0	42916
20687	108	42194	368	345	0	43015
20688	152	373	227	41997	0	42749
20689	42045	242	96	397	0	42780
20690	431	104	77	42173	0	42785
20691	349	128	42802	414	0	43693
20692	155	42946	379	344	0	43824
20693	153	44982	273	182	0	45590
20694	158	620	101	43943	0	44822
20695	44050	305	82	433	0	44870
20696	44077	136	90	297	0	44600
20697	649	87	72	43036	0	43844
20698	367	45624	118	445	0	46554
20699	211	464	74	46257	0	47006
20700	215	297	63	47464	0	48039
20701	184	166	76	47850	0	48276
20702	49698	109	78	744	0	50629
20703	554	50551	135	431	0	51671
20704	51308	526	114	210	0	52158
20705	51832	358	84	170	0	52444
20706	51777	129	71	190	0	52167
20707	52888	119	94	171	0	53272
20708	906	139	87	51620	0	52752
20709	508	136	52104	639	0	53387
20710	201	52253	563	487	0	53504
20711	53186	592	446	253	0	54477
20712	53674	410	168	169	0	54421
20713	54311	161	101	167	0	54740
20714	991	185	52873	158	0	54207
20715	51976	101	547	128	0	52752
20716	53248	128	395	134	0	53905
20717	969	115	143	52992	0	54219
20718	510	145	51382	600	0	52637
20719	215	50780	600	482	0	52077
20720	213	612	410	50392	0	51627
20721	49849	386	218	638	0	51091
20722	577	155	96	49834	0	50662
20723	421	97	97	51211	0	51826
20724	52537	86	116	891	0	53630
20725	661	128	52651	453	0	53893
20726	52469	98	580	234	0	53381
20727	52495	90	425	166	0	53176
20728	52348	83	159	145	0	52735
20729	52185	86	113	151	0	52535
20730	1025	112	50951	134	0	52222
20731	571	133	565	49978	0	51247
20732	248	125	51789	589	0	52751
20733	216	189	624	50206	0	51235
20734	219	123	51077	621	0	52040
20735	44732	98	603	460	0	45893
20736	567	46305	451	231	0	47554
20737	438	46615	150	152	0	47355
20738	342	769	213	48197	0	49521
20739	291	435	104	47769	0	48599
20740	205	51404	100	874	0	52583
20741	51705	592	75	453	0	52825
20742	53526	415	81	171	0	54193
20743	55134	116	91	158	0	55499
20744	56948	74	101	158	0	57281
20745	1275	79	91	56181	0	57626
20746	662	89	91	57570	0	58412
20747	57505	61	85	1208	0	58859
20748	917	61	111	57075	0	58164
20749	675	99	56011	900	0	57685
20750	334	119	56089	576	0	57118
20751	263	73	1192	56474	0	58002
20752	290	103	56929	895	0	58217
20753	55213	82	887	594	0	56776
20754	899	66	586	56231	0	57782
20755	56722	55	206	891	0	57874
20756	988	106	56985	670	0	58749
20757	683	78	823	56442	0	58026
20758	328	118	57930	912	0	59288
20759	266	57312	910	703	0	59191
20760	56227	845	721	315	0	58108
20761	56295	514	214	260	0	57283
20762	1302	55924	211	286	0	57723
20763	55763	759	126	228	0	56876
20764	1034	526	157	54907	0	56624
20765	757	158	143	55526	0	56584
20766	54572	100	176	1293	0	56141
20767	988	54152	159	757	0	56056
20768	765	54656	163	352	0	55936
20769	425	1234	144	53603	0	55406
20770	53357	607	141	904	0	55009
20771	53818	210	154	667	0	54849
20772	53763	153	167	299	0	54382
20773	1553	175	52592	268	0	54588
20774	951	167	52212	304	0	53634
20775	448	51991	1295	331	0	54065
20776	51788	810	689	249	0	53536
20777	1109	592	251	50257	0	52209
20778	50817	197	226	927	0	52167
20779	50697	140	213	715	0	51765
20780	1565	149	211	49739	0	51664
20781	976	176	49986	972	0	52110
20782	49352	138	893	725	0	51108
20783	1163	139	626	49747	0	51675
20784	902	129	50052	1016	0	52099
20785	48489	150	916	767	0	50322
20786	49675	126	669	449	0	50919
20787	1530	121	325	48978	0	50954
20788	962	150	48766	1049	0	50927
20789	590	151	898	46084	0	47723
20790	488	48665	733	1044	0	50930
20791	613	776	48829	752	0	50970
20792	511	49094	967	457	0	51029
20793	47651	786	706	364	0	49507
20794	47988	556	372	323	0	49239
20795	48128	211	289	340	0	48968
20796	47852	170	300	338	0	48660
20797	1657	179	283	46122	0	48241
20798	44946	174	284	921	0	46325
20799	1166	148	232	44006	0	45552
20800	42434	150	250	982	0	43816
20801	1049	42247	267	771	0	44334
20802	765	698	173	38022	0	39658
20803	423	39270	206	759	0	40658
20804	38749	709	183	594	0	40235
20805	38471	475	194	312	0	39452
20806	1204	37861	198	346	0	39609
20807	751	652	183	37289	0	38875
20808	477	454	36926	757	0	38614
20809	421	276	652	36467	0	37816
20810	440	188	36756	796	0	38180
20811	456	257	679	32357	0	33749
20812	349	34887	509	664	0	36409
20813	34625	576	230	503	0	35934
20814	34847	428	206	293	0	35774
20815	1085	192	193	34329	0	35799
20816	36097	144	183	737	0	37161
20817	884	153	170	35880	0	37087
20818	663	178	170	36099	0	37110
20819	428	144	152	36637	0	37361
20820	36286	132	166	1023	0	37607
20821	36270	115	149	647	0	37181
20822	36427	137	145	355	0	37064
20823	1040	34614	192	284	0	36130
20824	33135	513	138	225	0	34011
20825	723	32489	175	228	0	33615
20826	32845	556	124	222	0	33747
20827	779	364	126	32028	0	33297
20828	579	148	137	32751	0	33615
20829	32226	145	115	826	0	33312
20830	32151	115	130	465	0	32861
20831	916	31911	145	277	0	33249
20832	31592	493	111	236	0	32432
20833	771	332	92	30766	0	31961
20834	546	143	79	31208	0	31976
20835	30648	107	92	792	0	31639
20836	721	112	30463	464	0	31760
20837	516	29439	462	246	0	30663
20838	368	451	276	26120	0	27215
20839	253	236	24414	349	0	25252
20840	244	549	290	22760	0	23843
20841	22673	42	250	396	0	23361
20842	330	21314	97	276	0	22017
20843	207	19737	48	118	0	20110
20844	121	18390	53	64	0	18628
20845	370	467	265	17150	0	18252
20846	17381	100	317	188	0	17986
20847	156	31	11	17226	0	17424
20848	17287	22	18	145	0	17472
20849	17277	21	15	98	0	17411
20850	204	16	16	17237	0	17473
20851	17542	23	14	158	0	17737
20852	168	23	11	17898	0	18100
20853	104	32	18243	155	0	18534
20854	17951	17	129	107	0	18204
20855	165	30	20231	52	0	20478
20856	18771	21	141	55	0	18988
20857	193	43	19785	36	0	20057
20858	124	16	111	18576	0	18827
20859	36	22	87	19322	0	19467
20860	19546	14	28	202	0	19790
20861	126	18	14	20147	0	20305
20862	20302	16	19	145	0	20482
20863	138	20623	21	119	0	20901
20864	21414	108	19	57	0	21598
20865	153	102	9	22155	0	22419
20866	124	21	20	22334	0	22499
20867	46	17	8	22510	0	22581
20868	57	11	15	22532	0	22615
20869	53	30	22374	223	0	22680
20870	50	26	22206	133	0	22415
20871	47	14	205	22104	0	22370
20872	46	22	22931	174	0	23173
20873	34	22874	156	166	0	23230
20874	45	130	104	22887	0	23166
20875	44	128	24193	164	0	24529
20876	56	38	24182	156	0	24432
20877	45	48	241	24375	0	24709
20878	44	11	141	24309	0	24505
20879	29	25303	52	291	0	25675
20880	69	174	15	25680	0	25938
20881	31	143	26245	232	0	26651
20882	25146	30	182	188	0	25546
20883	191	17	156	26657	0	27021
20884	26981	18	39	214	0	27252
20885	26991	24	38	191	0	27244
20886	27632	19	43	100	0	27794
20887	359	37	27984	59	0	28439
20888	211	37	27732	58	0	28038
20889	25359	25	368	87	0	25839
20890	220	31	28252	62	0	28565
20891	199	21	212	26641	0	27073
20892	77	25	181	27307	0	27590
20893	74	38	27552	367	0	28031
20894	54	27653	224	216	0	28147
20895	27145	189	184	93	0	27611
20896	202	27776	76	99	0	28153
20897	176	28237	73	103	0	28589
20898	28004	326	78	83	0	28491
20899	232	190	29245	83	0	29750
20900	204	56	29417	84	0	29761
20901	80	60	391	28442	0	28973
20902	28945	46	227	251	0	29469
20903	231	29425	91	320	0	30067
20904	29626	224	74	85	0	30009
20905	289	216	29867	89	0	30461
20906	216	31469	274	87	0	32046
20907	93	248	230	31939	0	32510
20908	86	231	32435	298	0	33050
20909	75	47	284	32151	0	32557
20910	76	83	250	30907	0	31316
20911	93	48	82	32471	0	32694
20912	80	41	84	32526	0	32731
20913	32020	43	84	512	0	32659
20914	31644	37	84	309	0	32074
20915	494	60	32422	108	0	33084
20916	30153	39	298	107	0	30597
20917	303	30851	302	117	0	31573
20918	30847	263	96	106	0	31312
20919	346	228	31003	96	0	31673
20920	293	77	305	30050	0	30725
20921	138	56	31118	295	0	31607
20922	115	52	31065	278	0	31510
20923	120	97	505	29772	0	30494
20924	97	56	299	29427	0	29879
20925	101	65	30391	485	0	31042
20926	85	29803	328	318	0	30534
20927	68	30147	301	147	0	30663
20928	85	493	111	29648	0	30337
20929	28985	242	120	333	0	29680
20930	256	30277	109	354	0	30996
20931	265	283	30491	141	0	31180
20932	103	252	30328	103	0	30786
20933	133	104	30463	114	0	30814
20934	113	97	503	28806	0	29519
20935	29620	64	311	327	0	30322
20936	316	29562	153	340	0	30371
20937	358	288	29269	130	0	30045
20938	103	29489	372	143	0	30107
20939	94	293	319	28866	0	29572
20940	131	255	29343	365	0	30094
20941	101	29358	354	346	0	30159
20942	108	258	329	28556	0	29251
20943	103	250	123	29426	0	29902
20944	120	89	29865	510	0	30584
20945	126	86	344	28074	0	28630
20946	109	29411	338	362	0	30220
20947	120	311	29412	310	0	30153
20948	28286	276	348	146	0	29056
20949	350	86	316	29234	0	29986
20950	316	80	149	28423	0	28968
20951	127	29344	142	529	0	30142
20952	28633	266	176	292	0	29367
20953	328	280	28383	97	0	29088
20954	27212	112	342	137	0	27803
20955	293	136	286	25985	0	26700
20956	235	26473	164	280	0	27152
20957	87	265	133	26288	0	26773
20958	75	231	155	27128	0	27589
20959	26641	80	134	526	0	27381
20960	26568	71	116	300	0	27055
20961	429	102	103	26445	0	27079
20962	237	95	26211	327	0	26870
20963	23923	98	305	308	0	24634
20964	256	25931	292	133	0	26612
20965	262	291	102	25504	0	26159
20966	128	240	104	26114	0	26586
20967	96	73	130	26283	0	26582
20968	99	92	25904	487	0	26582
20969	86	85	306	24879	0	25356
20970	71	25880	301	334	0	26586
20971	101	282	120	24613	0	25116
20972	91	25397	107	330	0	25925
20973	97	288	119	25155	0	25659
20974	66	248	24895	355	0	25564
20975	21864	78	287	265	0	22494
20976	291	111	236	23491	0	24129
20977	196	84	23062	283	0	23625
20978	73	22973	258	250	0	23554
20979	22564	228	231	121	0	23144
20980	219	198	22365	123	0	22905
20981	20753	109	329	117	0	21308
20982	257	70	182	21070	0	21579
20983	187	33	88	20593	0	20901
20984	47	21177	91	309	0	21624
20985	20922	190	80	179	0	21371
20986	20200	132	60	88	0	20480
20987	263	21073	67	73	0	21476
20988	138	187	56	21101	0	21482
20989	57	155	52	21270	0	21534
20990	54	52	55	21116	0	21277
20991	44	60	20700	318	0	21122
20992	19601	52	189	199	0	20041
20993	190	58	152	20536	0	20936
20994	158	52	57	20704	0	20971
20995	63	71	20453	293	0	20880
20996	65	59	20341	193	0	20658
20997	59	81	287	20752	0	21179
20998	67	54	21320	224	0	21665
20999	19338	46	199	162	0	19745
21000	174	39	141	20241	0	20595
21001	123	43	54	20455	0	20675
21002	59	55	21168	258	0	21540
21003	50	76	160	21238	0	21524
21004	44	40	21849	213	0	22146
21005	49	21327	173	195	0	21744
21006	19083	195	338	131	0	19747
21007	18857	86	37	60	0	19040
21008	170	19049	33	93	0	19345
21009	110	112	17	19236	0	19475
21010	54	92	19631	134	0	19911
21011	32	28	111	19558	0	19729
21012	19544	13	105	155	0	19817
21013	103	19910	36	136	0	20185
21014	19857	112	26	46	0	20041
21015	133	85	28	19768	0	20014
21016	19881	29	20	140	0	20070
21017	122	19836	44	142	0	20144
21018	19983	111	25	59	0	20178
21019	132	98	19486	60	0	19776
21020	97	19847	122	57	0	20123
21021	48	99	86	19414	0	19647
21022	20251	67	36	127	0	20481
21023	20407	20	21	110	0	20558
21024	182	23	17	20428	0	20650
21025	20762	15	19	131	0	20927
21026	20623	18	34	107	0	20782
21027	21185	11	27	67	0	21290
21028	181	25	33	21174	0	21413
21029	126	25	21497	118	0	21766
21030	53	41	20788	95	0	20977
21031	50	36	21266	46	0	21398
21032	20848	18	192	59	0	21117
21033	127	14	100	21255	0	21496
21034	88	22096	57	135	0	22376
21035	61	117	31	21352	0	21561
21036	36	22608	36	144	0	22824
21037	22842	115	34	105	0	23096
21038	146	98	26	23091	0	23361
21039	113	23	26	23698	0	23860
21040	23870	20	45	222	0	24157
21041	145	22	24	24233	0	24424
21042	135	26	25	24719	0	24905
21043	25103	20	40	245	0	25408
21044	171	41	25630	136	0	25978
21045	140	23	138	25271	0	25572
21046	56	30	25596	191	0	25873
21047	24790	20	166	145	0	25121
21048	177	14	124	25620	0	25935
21049	25646	23	43	182	0	25894
21050	200	29	35	25901	0	26165
21051	177	33	26520	191	0	26921
21052	67	29	162	26992	0	27250
21053	27158	31	148	215	0	27552
21054	173	28314	79	223	0	28789
21055	184	163	28078	87	0	28512
21056	26358	115	162	80	0	26715
21057	192	28423	130	89	0	28834
21058	145	28587	48	85	0	28865
21059	63	30606	52	98	0	30819
21060	84	305	47	32040	0	32476
21061	33170	145	67	220	0	33602
21062	33669	39	47	195	0	33950
21063	389	41	33695	80	0	34205
21064	32765	46	212	56	0	33079
21065	234	33102	196	92	0	33624
21066	213	209	44	32425	0	32891
21067	34465	166	38	264	0	34933
21068	34640	41	46	191	0	34918
21069	34852	44	49	82	0	35027
21070	34409	28	35	62	0	34534
21071	34739	35	33	66	0	34873
21072	420	38	30	34545	0	35033
21073	246	43	34783	245	0	35317
21074	107	31	210	34919	0	35267
21075	106	46	176	34953	0	35281
21076	35179	35	58	391	0	35663
21077	272	34380	68	278	0	34998
21078	34836	225	39	92	0	35192
21079	35070	197	51	86	0	35404
21080	36248	50	49	138	0	36485
21081	37055	48	40	94	0	37237
21082	481	64	36921	73	0	37539
21083	36681	47	233	108	0	37069
21084	37389	33	187	107	0	37716
21085	34874	50	86	112	0	35122
21086	37467	40	44	84	0	37635
21087	503	42	54	36314	0	36913
21088	331	54	35905	280	0	36570
21089	35212	30	233	242	0	35717
21090	316	36284	218	137	0	36955
21091	313	214	62	35134	0	35723
21092	162	36890	68	281	0	37401
21093	153	237	48	37202	0	37640
21094	37632	192	61	302	0	38187
21095	37473	71	75	255	0	37874
21096	37686	51	85	126	0	37948
21097	516	72	36376	109	0	37073
21098	35925	54	245	99	0	36323
21099	358	68	36293	88	0	36807
21100	330	82	36219	69	0	36700
21101	195	62	37118	77	0	37452
21102	230	203	427	34243	0	35103
21103	195	40	231	35542	0	36008
21104	147	38	74	35888	0	36147
21105	141	46	73	36069	0	36329
21106	152	47	58	35801	0	36058
21107	137	60	70	35202	0	35469
21108	135	36054	78	443	0	36710
21109	35242	235	60	252	0	35789
21110	300	36510	89	154	0	37053
21111	295	257	80	36606	0	37238
21112	174	204	59	37075	0	37512
21113	36625	94	48	426	0	37193
21114	339	36899	88	293	0	37619
21115	37096	237	68	119	0	37520
21116	404	197	78	36973	0	37652
21117	350	69	94	37056	0	37569
21118	225	71	85	37222	0	37603
21119	198	97	37134	442	0	37871
21120	198	65	243	36804	0	37310
21121	196	79	36600	330	0	37205
21122	219	62	36128	264	0	36673
21123	230	88	38028	139	0	38485
21124	204	65	388	37089	0	37746
21125	205	70	217	38569	0	39061
21126	180	72	56	39235	0	39543
21127	39251	72	73	494	0	39890
21128	366	72	64	40538	0	41040
21129	41071	57	81	387	0	41596
21130	426	41108	86	351	0	41971
21131	43414	282	97	190	0	43983
21132	45445	238	80	186	0	45949
21133	606	47559	98	175	0	48438
21134	47774	297	79	170	0	48320
21135	47719	243	85	149	0	48196
21136	48328	62	106	138	0	48634
21137	48250	34	98	123	0	48505
21138	734	81	47713	116	0	48644
21139	428	47184	349	150	0	48111
21140	249	388	288	46755	0	47680
21141	46465	232	128	381	0	47206
21142	425	70	46363	341	0	47199
21143	331	45788	342	208	0	46669
21144	252	279	271	43029	0	43831
21145	156	45592	79	327	0	46154
21146	188	324	52	45264	0	45828
21147	189	285	72	45447	0	45993
21148	219	91	45686	469	0	46465
21149	215	102	44771	273	0	45361
21150	40654	60	508	153	0	41375
21151	435	76	44996	82	0	45589
21152	369	76	44776	92	0	45313
21153	204	122	474	43441	0	44241
21154	186	107	293	42664	0	43250
21155	119	44658	152	501	0	45430
21156	140	47893	143	336	0	48512
21157	188	517	48136	138	0	48979
21158	191	596	464	48068	0	49319
21159	96	93	48120	397	0	48706
21160	102	68	44620	297	0	45087
21161	48	44345	527	116	0	45036
21162	173	341	318	42748	0	43580
21163	43552	246	104	296	0	44198
21164	305	73	71	43722	0	44171
21165	44401	41	69	323	0	44834
21166	44190	54	63	276	0	44583
21167	44720	37	67	151	0	44975
21168	530	56	44709	83	0	45378
21169	44226	60	310	75	0	44671
21170	340	52	264	45601	0	46257
21171	46198	51	82	344	0	46675
21172	46015	40	91	303	0	46449
21173	527	46109	101	132	0	46869
21174	46302	276	81	104	0	46763
21175	370	287	47419	66	0	48142
21176	45526	73	305	88	0	45992
21177	46542	50	263	107	0	46962
21178	513	47539	93	122	0	48267
21179	47629	303	89	94	0	48115
21180	389	246	84	45898	0	46617
21181	318	89	78	45689	0	46174
21182	143	46620	105	537	0	47405
21183	133	297	77	47494	0	48001
21184	147	245	71	47526	0	47989
21185	154	84	47321	527	0	48086
21186	165	129	46501	297	0	47092
21187	44072	53	510	153	0	44788
21188	46679	75	296	102	0	47152
21189	598	47	99	47132	0	47876
21190	377	94	47780	369	0	48620
21191	156	47577	357	369	0	48459
21192	168	346	270	47242	0	48026
21193	152	296	48127	359	0	48934
21194	44858	102	380	368	0	45708
21195	390	93	306	48662	0	49451
21196	348	50400	150	392	0	51290
21197	194	392	112	50967	0	51665
21198	134	341	124	51524	0	52123
21199	186	80	124	51840	0	52230
21200	51064	76	147	683	0	51970
21201	459	82	119	50939	0	51599
21202	51235	85	114	480	0	51914
21203	50932	97	115	406	0	51550
21204	744	119	51426	188	0	52477
21205	392	51840	464	228	0	52924
21206	248	467	349	46472	0	47536
21207	185	53995	172	437	0	54789
21208	54503	431	147	358	0	55439
21209	515	375	138	54334	0	55362
21210	486	142	55132	503	0	56263
21211	229	131	54811	484	0	55655
21212	240	107	55185	195	0	55727
21213	52036	100	792	198	0	53126
21214	508	55077	486	222	0	56293
21215	54331	473	168	194	0	55166
21216	555	55405	184	189	0	56333
21217	532	467	139	55162	0	56300
21218	258	396	143	53956	0	54753
21219	208	56381	160	847	0	57596
21220	272	551	56476	509	0	57808
21221	187	57443	519	283	0	58432
21222	55515	476	409	231	0	56631
21223	577	401	162	54125	0	55265
21224	486	160	54099	554	0	55299
21225	260	136	54086	452	0	54934
21226	292	225	818	52620	0	53955
21227	274	134	53387	483	0	54278
21228	264	134	51447	415	0	52260
21229	47168	155	817	210	0	48350
21230	440	50082	465	254	0	51241
21231	48174	375	171	172	0	48892
21232	518	361	49196	174	0	50249
21233	406	47479	466	158	0	48509
21234	185	48688	414	182	0	49469
21235	470	795	356	47803	0	49424
21236	172	359	132	48700	0	49363
21237	172	122	106	49822	0	50222
21238	158	134	49406	806	0	50504
21239	192	108	427	49407	0	50134
21240	155	91	396	50477	0	51119
21241	50328	95	120	812	0	51355
21242	489	50109	117	581	0	51296
21243	437	450	112	50870	0	51869
21244	51011	403	117	520	0	52051
21245	50452	105	153	480	0	51190
21246	810	119	120	50447	0	51496
21247	483	146	51062	516	0	52207
21248	172	105	496	51151	0	51924
21249	157	124	51538	603	0	52422
21250	50977	85	525	519	0	52106
21251	54277	85	490	210	0	55062
21252	907	255	169	55417	0	56748
21253	539	141	56499	600	0	57779
21254	184	57812	603	678	0	59277
21255	227	690	59217	195	0	60329
21256	224	808	610	50053	0	51695
21257	98	55944	554	497	0	57093
21258	54132	514	92	395	0	55133
21259	547	416	84	51018	0	52065
21260	413	53868	112	525	0	54918
21261	54352	512	106	427	0	55397
21262	544	406	100	53412	0	54462
21263	401	54556	148	584	0	55689
21264	142	553	102	54913	0	55710
21265	141	432	54357	570	0	55500
21266	50966	115	549	478	0	52108
21267	52860	102	435	135	0	53532
21268	885	121	52621	120	0	53747
21269	427	52081	543	168	0	53219
21270	51976	525	436	126	0	53063
21271	516	419	114	51547	0	52596
21272	440	91	105	51530	0	52166
21273	144	122	91	52128	0	52485
21274	146	65	111	52005	0	52327
21275	108	98	110	51322	0	51638
21276	50332	97	114	915	0	51458
21277	50880	94	104	516	0	51594
21278	895	95	109	50414	0	51513
21279	493	92	114	50965	0	51664
21280	194	113	50239	949	0	51495
21281	162	118	49937	504	0	50721
21282	48167	109	882	199	0	49357
21283	618	112	440	48907	0	50077
21284	504	109	48898	605	0	50116
21285	153	103	551	48598	0	49405
21286	48679	100	464	637	0	49880
21287	49294	87	137	575	0	50093
21288	917	96	145	48739	0	49897
21289	508	96	119	49233	0	49956
21290	48529	87	148	978	0	49742
21291	596	85	117	48135	0	48933
21292	474	48707	149	659	0	49989
21293	211	589	110	48008	0	48918
21294	215	407	120	47667	0	48409
21295	184	114	46690	939	0	47927
21296	205	115	45289	534	0	46143
21297	134	45460	873	287	0	46754
21298	44390	489	491	225	0	45595
21299	43682	401	136	209	0	44428
21300	44173	107	125	213	0	44618
21301	845	43861	158	234	0	45098
21302	499	44079	145	266	0	44989
21303	42249	760	126	213	0	43348
21304	502	43584	154	295	0	44535
21305	490	545	42031	221	0	43287
21306	163	42423	571	281	0	43438
21307	207	500	40268	227	0	41202
21308	38242	349	496	191	0	39278
21309	39405	101	384	179	0	40069
21310	738	39028	133	224	0	40123
21311	39797	457	104	189	0	40547
21312	42721	358	110	202	0	43391
21313	43325	120	118	182	0	43745
21314	1023	99	101	42373	0	43596
21315	43099	108	137	654	0	43998
21316	711	126	42025	526	0	43388
21317	41576	107	583	234	0	42500
21318	752	106	459	41623	0	42940
21319	608	126	41209	639	0	42582
21320	271	148	41075	526	0	42020
21321	238	143	935	40023	0	41339
21322	213	122	487	40670	0	41492
21323	40484	119	190	965	0	41758
21324	688	94	146	40553	0	41481
21325	551	130	39976	764	0	41421
21326	255	102	575	38545	0	39477
21327	198	39993	478	701	0	41370
21328	39469	539	161	537	0	40706
21329	707	439	107	39315	0	40568
21330	567	152	38895	678	0	40292
21331	242	38506	600	598	0	39946
21332	35558	491	442	204	0	36695
21333	630	435	178	35558	0	36801
21334	548	146	35415	593	0	36702
21335	220	34752	552	516	0	36040
21336	33555	538	533	243	0	34869
21337	33118	357	162	202	0	33839
21338	33396	122	113	190	0	33821
21339	917	81	105	32181	0	33284
21340	555	66	86	32318	0	33025
21341	31510	55	90	844	0	32499
21342	553	31376	110	530	0	32569
21343	30707	418	113	222	0	31460
21344	603	316	97	30236	0	31252
21345	30710	122	90	539	0	31461
21346	598	65	125	30174	0	30962
21347	443	70	122	29883	0	30518
21348	279	96	134	30055	0	30564
21349	297	112	113	30270	0	30792
21350	206	83	27798	787	0	28874
21351	177	70	24921	400	0	25568
21352	20879	53	549	189	0	21670
21353	393	55	21845	140	0	22433
21354	251	46	18907	104	0	19308
21355	17171	32	503	101	0	17807
21356	17723	44	369	83	0	18219
21357	409	54	119	18117	0	18699
21358	18253	37	80	293	0	18663
21359	320	18405	59	239	0	19023
21360	18665	222	52	139	0	19078
21361	18344	168	65	104	0	18681
21362	18621	87	50	95	0	18853
21363	485	107	52	17894	0	18538
21364	299	17973	64	281	0	18617
21365	176	18326	47	251	0	18800
21366	18157	354	69	117	0	18697
21367	18171	222	64	93	0	18550
21368	442	89	56	17694	0	18281
21369	296	61	54	17537	0	17948
21370	135	17588	94	403	0	18220
21371	17443	238	68	247	0	17996
21372	322	199	17417	125	0	18063
21373	279	68	223	16966	0	17536
21374	163	47	168	17327	0	17705
21375	122	53	17249	427	0	17851
21376	110	34	228	16717	0	17089
21377	98	15997	201	330	0	16626
21378	115	236	88	17105	0	17544
21379	116	181	44	16750	0	17091
21380	111	16347	66	399	0	16923
21381	100	16931	68	301	0	17400
21382	120	337	72	16622	0	17151
21383	16506	200	44	336	0	17086
21384	258	77	59	16732	0	17126
21385	216	54	64	16717	0	17051
21386	120	17059	105	386	0	17670
21387	115	202	95	17338	0	17750
21388	134	149	69	17358	0	17710
21389	138	48	82	17430	0	17698
21390	16678	49	77	437	0	17241
21391	266	44	51	16914	0	17275
21392	253	60	38	16700	0	17051
21393	175	43	34	16824	0	17076
21394	135	65	16081	454	0	16735
21395	14406	59	190	300	0	14955
21396	270	16049	169	169	0	16657
21397	15809	200	73	94	0	16176
21398	301	168	45	15554	0	16068
21399	233	87	15505	244	0	16069
21400	14369	68	208	224	0	14869
21401	274	82	17758	109	0	18223
21402	240	90	217	17241	0	17788
21403	18023	41	218	226	0	18508
21404	17738	40	74	201	0	18053
21405	18284	37	54	154	0	18529
21406	400	52	35	18228	0	18715
21407	269	65	27	18560	0	18921
21408	154	89	48	18488	0	18779
21409	73	18122	48	415	0	18658
21410	86	17768	41	267	0	18162
21411	61	17208	45	137	0	17451
21412	13	14396	11	29	0	14449
21413	50	48	51	14109	0	14258
21414	8	28	3	14222	0	14261
21415	14114	5	10	75	0	14204
21416	13928	4	11	50	0	13993
21417	14480	7	10	26	0	14523
21418	54	6	11	14429	0	14500
21419	41	5	11	14823	0	14880
21420	14712	7	15	70	0	14804
21421	14261	17	22	51	0	14351
21422	69	18	14853	24	0	14964
21423	51	19	14745	10	0	14825
21424	27	22	15083	22	0	15154
21425	36	21	15695	26	0	15778
21426	22	12	54	15265	0	15353
21427	15573	12	28	48	0	15661
21428	67	15755	11	87	0	15920
21429	41	35	3	16098	0	16177
21430	32	52	16291	47	0	16422
21431	18	17486	30	74	0	17608
21432	16	25	32	17764	0	17837
21433	20	42	17976	54	0	18092
21434	20	14	26	17558	0	17618
21435	18	12	29	18276	0	18335
21436	18319	9	13	77	0	18418
21437	38	8	9	18625	0	18680
21438	61	15	18832	43	0	18951
21439	18	4	30	18569	0	18621
21440	12	20662	54	64	0	20792
21441	26	35	15	21759	0	21835
21442	27	37	15	22065	0	22144
21443	14	8	8	22237	0	22267
21444	22418	7	8	92	0	22525
21445	22476	13	16	65	0	22570
21446	22956	15	10	60	0	23041
21447	23011	15	23	44	0	23093
21448	75	22	23240	28	0	23365
21449	22072	13	37	34	0	22156
21450	23132	8	30	35	0	23205
21451	66	24	23142	29	0	23261
21452	56	28	24792	25	0	24901
21453	26	18	43	24436	0	24523
21454	12	25449	41	46	0	25548
21455	25976	24	16	52	0	26068
21456	26495	25	13	51	0	26584
21457	27134	12	9	73	0	27228
21458	55	8	17	26893	0	26973
21459	29	29842	26	66	0	29963
21460	31655	28	11	131	0	31825
21461	32457	26	11	62	0	32556
21462	66	10	9	32651	0	32736
21463	54	40	32520	72	0	32686
21464	32240	14	35	92	0	32381
21465	47	20	35	34726	0	34828
21466	35835	10	25	76	0	35946
21467	49	7	15	37063	0	37134
21468	57	41	37531	55	0	37684
21469	40059	8	40	131	0	40238
21470	41	9	34	41880	0	41964
21471	61	10	14	42301	0	42386
21472	27	8	6	42610	0	42651
21473	27	11	10	42610	0	42658
21474	43424	6	14	115	0	43559
21475	38	13	11	43354	0	43416
21476	44	43546	27	79	0	43696
21477	22	50	12	44015	0	44099
21478	24	44657	24	77	0	44782
21479	31	34	10	45499	0	45574
21480	30	39	14	46049	0	46132
21481	14	46304	43	113	0	46474
21482	29	45	15	46747	0	46836
21483	29	35	15	46682	0	46761
21484	46228	12	11	107	0	46358
21485	72	53	48134	70	0	48329
21486	65	6	54	49125	0	49250
21487	49728	7	59	104	0	49898
21488	49170	18	21	100	0	49309
21489	49665	9	11	65	0	49750
21490	156	53	50348	33	0	50590
21491	132	67	51494	33	0	51726
21492	47	40	161	51884	0	52132
21493	53797	14	113	127	0	54051
21494	127	57	53956	109	0	54249
21495	50951	31	92	82	0	51156
21496	86	56240	136	86	0	56548
21497	138	78	16	60549	0	60781
21498	52	113	18	63035	0	63218
21499	64618	22	36	274	0	64950
21500	103	54	25	66388	0	66570
21501	67002	14	21	236	0	67273
21502	69692	13	17	230	0	69952
21503	184	39	27	69676	0	69926
21504	125	16	23	70437	0	70601
21505	71917	11	27	330	0	72285
21506	194	82	81000	135	0	81411
21507	80219	25	112	264	0	80620
21508	195	123	90203	46	0	90567
21509	91069	30	117	277	0	91493
21510	103036	26	117	352	0	103531
21511	103023	18	36	203	0	103280
21512	102332	19	30	146	0	102527
21513	197	105581	97	149	0	106024
21514	108591	94	34	201	0	108920
21515	109460	107	57	203	0	109827
21516	200	121676	83	163	0	122122
21517	123200	105	35	248	0	123588
21518	253	280	122469	100	0	123102
21519	119010	42	116	197	0	119365
21520	307	350	127231	133	0	128021
21521	224	22	175	126546	0	126967
21522	91	51	168	130580	0	130890
21523	187	254	134620	434	0	135495
21524	113	24	196	132455	0	132788
21525	160	196	280	121312	0	121948
21526	141610	28	64	609	0	142311
21527	306	46	52	143478	0	143882
21528	315	60	36	143983	0	144394
21529	116	56	29	145089	0	145290
21530	62	144302	147	602	0	145113
21531	95	275	34	145422	0	145826
21532	143011	252	55	559	0	143877
21533	429	286	147649	406	0	148770
21534	351	56	331	149323	0	150061
21535	206	192	151269	527	0	152194
21536	142788	58	426	505	0	143777
21537	507	57	329	159106	0	159999
21538	596	361	198419	947	0	200323
21539	312	45	1969	198635	0	200961
21540	215	70	1521	199620	0	201426
21541	109	207670	842	3640	0	212261
21542	253	2045	303	214078	0	216679
21543	357	1557	117	226308	0	228339
21544	338	858	228215	4454	0	233865
21545	292	286	2570	226722	0	229870
21546	234	175	1887	232595	0	234891
21547	228163	163	697	4690	0	233713
21548	225272	145	406	2823	0	228646
21549	4141	230361	512	1426	0	236440
21550	232666	2578	276	894	0	236414
21551	231436	1888	278	850	0	234452
21552	4554	244190	414	790	0	249948
21553	2663	2837	204	241872	0	247576
21554	245886	2007	182	3147	0	251222
21555	246422	829	255	2452	0	249958
21556	244548	445	267	1244	0	246504
21557	5099	245504	560	1164	0	252327
21558	3194	2975	250499	787	0	257455
21559	250188	2050	2816	937	0	255991
21560	256367	879	2001	906	0	260153
21561	5415	261446	981	880	0	268722
21562	262169	3347	509	915	0	266940
21563	264390	2447	391	814	0	268042
21564	6080	961	418	262062	0	269521
21565	3802	952	268887	3773	0	277414
21566	1780	480	3267	271925	0	277452
21567	1478	499	2466	274631	0	279074
21568	1396	445	883	279919	0	282643
21569	1261	750	273125	6508	0	281644
21570	1167	474	3522	266285	0	271448
21571	1121	442	2660	276022	0	280245
21572	1088	430	940	278801	0	281259
21573	1156	441	586	278835	0	281018
21574	1285	466	513	278332	0	280596
21575	866	276695	731	8353	0	286645
21576	999	3521	493	282222	0	287235
21577	859	2641	536	289753	0	293789
21578	998	1209	284156	7320	0	293683
21579	1167	691	3881	299544	0	305283
21580	1093	530	2809	305562	0	309994
21581	1143	570	1122	314266	0	317101
21582	1078	574	869	320044	0	322565
21583	309159	555	719	9866	0	320299
21584	5303	671	650	317837	0	324461
21585	4189	831	518	320482	0	326020
21586	2260	1087	311332	9672	0	324351
21587	1522	304322	4848	6632	0	317324
21588	1118	316300	4057	4131	0	325606
21589	306697	7253	1913	3210	0	319073
21590	4769	317217	1431	3474	0	326891
21591	4020	5557	817	312922	0	323316
21592	309207	3950	913	7293	0	321363
21593	5710	2053	313868	6159	0	327790
21594	4550	1367	5014	307842	0	318773
21595	2162	316879	4061	7502	0	330604
21596	1698	5239	1684	310878	0	319499
21597	1250	317345	1303	8279	0	328177
21598	1568	5879	920	317473	0	325840
21599	308726	4459	823	8154	0	322162
21600	6129	2374	315562	6791	0	330856
21601	4975	1770	5389	296746	0	308880
21602	2330	313642	4788	7486	0	328246
21603	310876	5618	1958	6384	0	324836
21604	6492	4978	310288	4499	0	326257
21605	5158	2060	5536	305753	0	318507
21606	2891	1866	302270	8078	0	315105
21607	2581	1309	6316	298406	0	308612
21608	2276	1627	293834	8874	0	306611
21609	1826	1412	6789	281669	0	291696
21610	1781	1347	5321	284143	0	292592
21611	276757	1484	2353	11319	0	291913
21612	279400	1525	1718	7399	0	290042
21613	9811	1660	1524	270151	0	283146
21614	5957	273814	1580	8075	0	289426
21615	3244	5999	1225	275786	0	286254
21616	2456	4678	1311	270701	0	279146
21617	258338	2005	1694	11803	0	273840
21618	5893	260944	1710	8826	0	277373
21619	260412	6226	1375	5194	0	273207
21620	255715	5111	1318	4526	0	266670
21621	9336	251760	1538	4664	0	267298
21622	5834	259467	1484	4940	0	271725
21623	251131	8736	1455	4723	0	266045
21624	7020	5462	247678	5038	0	265198
21625	245065	2518	5883	4827	0	258293
21626	246053	2054	4637	4679	0	257423
21627	10082	243159	2531	4726	0	260498
21628	6826	6234	1913	216305	0	231278
21629	3179	244548	2189	8232	0	258148
21630	241275	7018	2286	7120	0	257699
21631	243811	5729	2153	4828	0	256521
21632	10200	3259	1882	234128	0	249469
21633	6595	3092	1679	241706	0	253072
21634	225400	2398	1547	11911	0	241256
21635	7053	229762	1718	8833	0	247366
21636	6266	228082	1604	5859	0	241811
21637	3676	224694	1821	4945	0	235136
21638	1929	173053	1311	3747	0	180040
21639	1758	175050	1479	3723	0	182010
21640	3076	8101	1909	165535	0	178621
21641	2193	4424	160396	5699	0	172712
21642	2136	160427	3612	4858	0	171033
21643	145643	4470	2771	2774	0	155658
21644	4610	3676	1375	143868	0	153529
21645	143862	2263	1230	4569	0	151924
21646	4348	142856	1407	4251	0	152862
21647	142619	3972	1539	2627	0	150757
21648	4556	141917	1875	4244	0	152592
21649	4027	4159	1701	142629	0	152516
21650	142290	3292	1546	4677	0	151805
21651	143685	2036	1606	4302	0	151629
21652	5945	1925	1416	142260	0	151546
21653	4263	1869	1289	141520	0	148941
21654	2824	139638	1204	6681	0	150347
21655	2830	3962	986	141048	0	148826
21656	2825	3414	850	141244	0	148333
21657	2607	2530	749	138950	0	144836
21658	2304	131161	867	6834	0	141166
21659	119259	3428	734	4261	0	127682
21660	3541	123166	729	3040	0	130476
21661	117843	3647	665	2232	0	124387
21662	3929	118348	774	2153	0	125204
21663	3844	3735	113184	1951	0	122714
21664	2634	3576	2426	112050	0	120686
21665	2339	2219	108909	3171	0	116638
21666	2214	1950	106621	2711	0	113496
21667	2276	1984	3942	103515	0	111717
21668	2396	1604	104702	3068	0	111770
21669	2311	1551	2925	101389	0	108176
21670	2365	1463	2395	102228	0	108451
21671	2148	1649	1207	104482	0	109486
21672	101271	1525	887	4980	0	108663
21673	3782	1560	750	101857	0	107949
21674	3543	1419	572	101034	0	106568
21675	94483	1211	481	4943	0	101118
21676	3523	93862	485	3780	0	101650
21677	2976	88016	369	2373	0	93734
21678	2216	87904	363	1920	0	92403
21679	1388	5494	423	65110	0	72415
21680	1149	1688	65779	1867	0	70483
21681	53437	1469	1497	1434	0	57837
21682	1349	56476	883	736	0	59444
21683	53012	1272	404	570	0	55258
21684	52336	1100	255	419	0	54110
21685	52795	627	206	355	0	53983
21686	1713	682	52030	375	0	54800
21687	1244	611	740	51780	0	54375
21688	821	519	732	52684	0	54756
21689	781	448	314	53439	0	54982
21690	718	458	259	51518	0	52953
21691	653	52187	270	1596	0	54706
21692	50070	916	248	1121	0	52355
21693	963	787	46977	571	0	49298
21694	43901	334	553	487	0	45275
21695	937	706	533	42379	0	44555
21696	791	42536	148	865	0	44340
21697	418	43967	114	811	0	45310
21698	709	2691	247	38504	0	42151
21699	356	40685	118	667	0	41826
21700	33997	374	114	380	0	34865
21701	314	318	33355	172	0	34159
21702	291	140	202	31347	0	31980
21703	107	90	173	32568	0	32938
21704	116	108	55	32994	0	33273
21705	116	74	58	33104	0	33352
21706	33107	69	58	392	0	33626
21707	245	129	46	34556	0	34976
21708	39900	78	59	376	0	40413
21709	416	81	45	42882	0	43424
21710	343	86	46	44472	0	44947
21711	121	42367	79	5977	0	48544
21712	49064	391	56	526	0	50037
21713	49157	357	61	276	0	49851
21714	847	50196	67	206	0	51316
21715	535	476	48	46177	0	47236
21716	154	49334	84	444	0	50016
21717	46473	508	1855	494	0	49330
21718	530	487	48904	176	0	50097
21719	496	175	47654	122	0	48447
21720	44015	98	787	128	0	45028
21721	435	47401	504	110	0	48450
21722	442	446	139	47103	0	48130
21723	137	428	68	47653	0	48286
21724	125	163	47637	858	0	48783
21725	104	74	439	47114	0	47731
21726	99	57	406	47529	0	48091
21727	82	47297	137	910	0	48426
21728	104	457	62	47425	0	48048
21729	110	446	54	47254	0	47864
21730	45961	119	71	890	0	47041
21731	427	45886	99	581	0	46993
21732	447	46545	83	247	0	47322
21733	167	813	67	46487	0	47534
21734	119	502	51	47042	0	47714
21735	97	154	33	46909	0	47193
21736	80	46543	64	975	0	47662
21737	120	518	45	47295	0	47978
21738	118	488	39	46792	0	47437
21739	140	148	41	47427	0	47756
21740	103	98	51	46866	0	47118
21741	103	46260	78	1008	0	47449
21742	83	48329	90	624	0	49126
21743	47321	903	57	264	0	48545
21744	47543	567	60	203	0	48373
21745	957	177	52	47910	0	49096
21746	645	142	48300	662	0	49749
21747	193	153	499	48526	0	49371
21748	155	139	471	48410	0	49175
21749	47082	149	121	1070	0	48422
21750	598	49128	88	714	0	50528
21751	579	576	63	48873	0	50091
21752	213	892	68	49096	0	50269
21753	211	231	48575	1087	0	50104
21754	180	238	48914	709	0	50041
21755	181	145	962	48322	0	49610
21756	165	188	607	47133	0	48093
21757	165	48272	233	1097	0	49767
21758	139	49319	161	757	0	50376
21759	48317	989	139	351	0	49796
21760	649	636	103	49763	0	51151
21761	575	282	50068	792	0	51717
21762	182	49890	591	759	0	51422
21763	168	620	526	50319	0	51633
21764	49858	594	169	802	0	51423
21765	610	266	86	50990	0	51952
21766	50179	192	99	912	0	51382
21767	657	50892	122	816	0	52487
21768	49965	661	81	410	0	51117
21769	670	670	70	50853	0	52263
21770	639	324	52498	819	0	54280
21771	235	255	579	51205	0	52274
21772	199	53717	608	906	0	55430
21773	175	790	183	52874	0	54022
21774	144	55795	169	920	0	57028
21775	156	852	97	57070	0	58175
21776	203	725	55581	1099	0	57608
21777	234	293	54911	1019	0	56457
21778	192	271	55913	615	0	56991
21779	51815	278	1320	492	0	53905
21780	749	54992	745	475	0	56961
21781	747	56249	231	434	0	57661
21782	54947	1283	159	412	0	56801
21783	54468	822	163	430	0	55883
21784	1288	337	163	54100	0	55888
21785	842	288	54442	1048	0	56620
21786	384	288	53187	901	0	54760
21787	251	230	1273	52193	0	53947
21788	52813	236	761	1044	0	54854
21789	733	52886	298	1125	0	55042
21790	656	822	192	53090	0	54760
21791	52667	742	206	1099	0	54714
21792	52216	280	205	1077	0	53778
21793	1266	263	52722	590	0	54841
21794	48302	281	799	565	0	49947
21795	911	330	53079	556	0	54876
21796	793	305	54033	468	0	55599
21797	370	303	1295	51331	0	53299
21798	283	251	790	52595	0	53919
21799	336	268	307	53784	0	54695
21800	269	354	52790	1566	0	54979
21801	50322	271	826	1026	0	52445
21802	881	266	672	54476	0	56295
21803	53164	217	279	1133	0	54793
21804	52202	246	210	992	0	53650
21805	1303	54137	282	557	0	56279
21806	826	54822	274	513	0	56435
21807	332	53825	278	473	0	54908
21808	476	1362	326	46201	0	48365
21809	251	582	45912	624	0	47369
21810	223	1334	599	41053	0	43209
21811	204	41939	556	605	0	43304
21812	205	41100	224	530	0	42059
21813	241	741	147	40052	0	41181
21814	39576	417	157	518	0	40668
21815	481	39721	173	456	0	40831
21816	399	39795	185	248	0	40627
21817	40651	687	112	298	0	41748
21818	512	398	149	41039	0	42098
21819	434	136	139	41204	0	41913
21820	222	124	118	42100	0	42564
21821	40983	88	114	867	0	42052
21822	41060	134	139	512	0	41845
21823	794	99	163	41172	0	42228
21824	530	164	40253	509	0	41456
21825	39196	125	483	485	0	40289
21826	512	119	453	40600	0	41684
21827	482	139	40423	566	0	41610
21828	243	143	40253	480	0	41119
21829	184	148	785	40784	0	41901
21830	202	168	43109	595	0	44074
21831	184	182	540	45428	0	46334
21832	180	165	429	45054	0	45828
21833	202	131	194	47569	0	48096
21834	46566	169	140	1066	0	47941
21835	638	181	128	47302	0	48249
21836	568	176	131	47373	0	48248
21837	255	192	132	47655	0	48234
21838	221	196	147	47844	0	48408
21839	199	200	46018	1156	0	47573
21840	200	45927	623	703	0	47453
21841	168	591	432	44585	0	45776
21842	160	479	207	42465	0	43311
21843	143	43518	217	882	0	44760
21844	176	44988	187	551	0	45902
21845	43980	800	196	316	0	45292
21846	566	43150	198	916	0	44830
21847	456	567	161	42872	0	44056
21848	272	424	43423	657	0	44776
21849	40335	167	517	591	0	41610
21850	621	145	42083	317	0	43166
21851	41127	104	577	290	0	42098
21852	41601	85	414	316	0	42416
21853	913	118	41848	318	0	43197
21854	529	91	547	38862	0	40029
21855	234	41194	460	725	0	42613
21856	218	496	213	41928	0	42855
21857	43015	394	206	734	0	44349
21858	42831	143	172	610	0	43756
21859	854	42651	209	422	0	44136
21860	41819	464	165	348	0	42796
21861	621	352	166	40522	0	41661
21862	40609	135	160	737	0	41641
21863	40692	131	168	604	0	41595
21864	894	126	112	40064	0	41196
21865	39992	126	123	752	0	40993
21866	38732	132	125	637	0	39626
21867	828	170	38940	394	0	40332
21868	37812	169	492	349	0	38822
21869	636	173	38406	289	0	39504
21870	426	136	35966	253	0	36781
21871	176	36332	717	274	0	37499
21872	264	510	501	34357	0	35632
21873	166	346	35311	461	0	36284
21874	165	175	34398	373	0	35111
21875	33196	156	601	198	0	34151
21876	416	96	298	33554	0	34364
21877	286	109	143	34669	0	35207
21878	163	112	82	35178	0	35535
21879	140	106	81	35251	0	35578
21880	160	102	70	35606	0	35938
21881	206	123	34806	684	0	35819
21882	199	128	34711	429	0	35467
21883	171	93	550	34815	0	35629
21884	34403	84	320	466	0	35273
21885	399	34309	137	488	0	35333
21886	374	363	126	34102	0	34965
21887	33957	240	112	492	0	34801
21888	453	34045	119	453	0	35070
21889	376	358	132	33925	0	34791
21890	240	276	119	34424	0	35059
21891	180	99	139	34500	0	34918
21892	33636	65	149	745	0	34595
21893	462	83	33451	509	0	34505
21894	32989	61	427	284	0	33761
21895	459	69	336	33572	0	34436
21896	341	60	184	31569	0	32154
21897	168	32539	181	714	0	33602
21898	168	357	32887	457	0	33869
21899	30992	278	401	328	0	31999
21900	32198	116	332	319	0	32965
21901	631	91	31175	259	0	32156
21902	28915	77	364	281	0	29637
21903	422	30947	341	266	0	31976
21904	357	31050	155	251	0	31813
21905	171	30663	162	228	0	31224
21906	28925	549	157	189	0	29820
21907	416	317	28902	180	0	29815
21908	361	257	353	26450	0	27421
21909	151	26975	276	345	0	27747
21910	120	27118	111	307	0	27656
21911	145	26999	112	164	0	27420
21912	233	661	103	23065	0	24062
21913	25313	241	72	378	0	26004
21914	324	25848	72	319	0	26563
21915	286	299	59	25788	0	26432
21916	154	221	85	26097	0	26557
21917	25097	79	96	489	0	25761
21918	381	57	86	25136	0	25660
21919	295	64	74	25510	0	25943
21920	166	70	25389	521	0	26146
21921	154	82	294	25266	0	25796
21922	144	67	246	26028	0	26485
21923	25731	60	114	497	0	26402
21924	25805	50	95	318	0	26268
21925	534	57	106	25906	0	26603
21926	25305	73	76	358	0	25812
21927	25167	102	83	293	0	25645
21928	481	25663	93	172	0	26409
21929	299	289	25006	120	0	25714
21930	153	23734	299	121	0	24307
21931	241	570	319	20323	0	21453
21932	19627	180	172	187	0	20166
21933	127	19595	52	189	0	19963
21934	164	124	44	19620	0	19952
21935	19601	141	45	164	0	19951
21936	19430	41	52	184	0	19707
21937	250	37	38	19502	0	19827
21938	163	55	20587	186	0	20991
21939	58	35	109	21032	0	21234
21940	56	39	129	21615	0	21839
21941	62	36	21673	301	0	22072
21942	71	35	119	21244	0	21469
21943	74	36	146	21616	0	21872
21944	22238	32	46	302	0	22618
21945	137	31	32	22527	0	22727
21946	163	35	31	22600	0	22829
21947	22414	47	37	267	0	22765
21948	22131	44	32	199	0	22406
21949	22301	42	34	81	0	22458
21950	269	46	22220	98	0	22633
21951	186	105	115	21268	0	21674
21952	73	22394	138	150	0	22755
21953	69	140	37	22815	0	23061
21954	105	152	24085	149	0	24491
21955	101	87	117	22632	0	22937
21956	71	46	23445	155	0	23717
21957	21251	72	175	126	0	21624
21958	22200	16	115	58	0	22389
21959	154	18	20	23273	0	23465
21960	109	14	23	23703	0	23849
21961	44	24	15	23764	0	23847
21962	34	25661	28	181	0	25904
21963	25855	71	29	141	0	26096
21964	26485	84	12	91	0	26672
21965	172	20	18	26575	0	26785
21966	113	18	18	26741	0	26890
21967	46	26	22	27097	0	27191
21968	43	10	21	27278	0	27352
21969	64	38	27122	187	0	27411
21970	56	12	81	27398	0	27547
21971	27170	20	99	142	0	27431
21972	26941	19	30	144	0	27134
21973	177	23	12	26738	0	26950
21974	131	38	26512	119	0	26800
21975	25221	19	90	154	0	25484
21976	125	48	93	27348	0	27614
21977	104	27728	44	163	0	28039
21978	42	29300	39	151	0	29532
21979	30251	189	47	175	0	30662
21980	140	103	16	31431	0	31690
21981	142	26	19	32383	0	32570
21982	46	21	20	34043	0	34130
21983	45	16	17	34194	0	34272
21984	38	18	24	35300	0	35380
21985	47	34	35223	370	0	35674
21986	55	41	34905	220	0	35221
21987	66	53	35381	85	0	35585
21988	60	14	350	34645	0	35069
21989	78	44	37082	244	0	37448
21990	38	12	230	36541	0	36821
21991	38	18	179	36904	0	37139
21992	48	18	34	38095	0	38195
21993	38672	16	38	481	0	39207
21994	226	27	36	39117	0	39406
21995	196	21	39	39737	0	39993
21996	39403	16	38	433	0	39890
21997	242	39795	69	306	0	40412
21998	180	41471	57	163	0	41871
21999	41443	380	41	124	0	41988
22000	229	43528	70	116	0	43943
22001	43824	268	43	122	0	44257
22002	44175	187	47	102	0	44511
22003	44510	41	34	109	0	44694
22004	44441	37	32	100	0	44610
22005	44421	28	25	99	0	44573
22006	442	44414	36	126	0	45018
22007	44565	243	37	101	0	44946
22008	44595	192	28	107	0	44922
22009	434	46889	50	114	0	47487
22010	52113	256	40	116	0	52525
22011	52754	208	37	98	0	53097
22012	56955	57	48	106	0	57166
22013	58858	53	40	98	0	59049
22014	967	81	63012	117	0	64177
22015	513	71	572	64481	0	65637
22016	201	37	450	66581	0	67269
22017	184	86	66918	1101	0	68289
22018	180	88	65878	581	0	66727
22019	64623	51	1096	167	0	65937
22020	744	79	554	67671	0	69048
22021	666	83	69479	680	0	70908
22022	230	96	69019	525	0	69870
22023	67299	54	1152	169	0	68674
22024	69980	45	573	131	0	70729
22025	69768	58	135	157	0	70118
22026	1277	87	70491	119	0	71974
22027	724	50	726	69277	0	70777
22028	290	82	71790	725	0	72887
22029	67874	53	813	640	0	69380
22030	885	120	73372	184	0	74561
22031	690	50	832	70619	0	72191
22032	304	84	630	68335	0	69353
22033	201	73968	255	1174	0	75598
22034	74100	699	167	633	0	75599
22035	904	576	74386	186	0	76052
22036	72014	102	835	217	0	73168
22037	964	106	76031	161	0	77262
22038	783	60	888	72939	0	74670
22039	315	52	699	74107	0	75173
22040	284	63	267	74836	0	75450
22041	73646	53	251	1383	0	75333
22042	964	78	232	73008	0	74282
22043	828	54	208	72820	0	73910
22044	318	72408	270	1402	0	74398
22045	335	699	253	73100	0	74387
22046	69868	560	283	1004	0	71715
22047	1041	142	72047	792	0	74022
22048	897	105	940	70621	0	72563
22049	475	110	72189	974	0	73748
22050	396	69716	1048	933	0	72093
22051	421	759	71539	388	0	73107
22052	68736	625	1073	389	0	70823
22053	70539	144	891	344	0	71918
22054	1513	91	443	68952	0	70999
22055	69835	85	424	1029	0	71373
22056	69344	80	452	831	0	70707
22057	1567	104	419	68917	0	71007
22058	1046	88	414	69527	0	71075
22059	558	154	68848	1534	0	71094
22060	512	67964	1111	928	0	70515
22061	67198	789	902	417	0	69306
22062	1132	66923	447	453	0	68955
22063	1008	813	441	65895	0	68157
22064	597	651	382	66189	0	67819
22065	534	184	463	66641	0	67822
22066	522	150	378	66579	0	67629
22067	491	183	65032	1669	0	67375
22068	60697	163	1106	1113	0	63079
22069	65082	157	924	564	0	66727
22070	1627	209	446	64242	0	66524
22071	64527	155	359	1230	0	66271
22072	1209	186	427	64647	0	66469
22073	1081	235	64010	1255	0	66581
22074	562	154	1083	61981	0	63780
22075	530	62820	903	1271	0	65524
22076	519	727	505	58899	0	60650
22077	447	61437	430	1200	0	63514
22078	534	836	376	55743	0	57489
22079	421	58776	380	1206	0	60783
22080	56109	807	353	1052	0	58321
22081	1073	697	56630	705	0	59105
22082	863	54346	994	652	0	56855
22083	505	55125	813	617	0	57060
22084	707	1248	660	52750	0	55365
22085	530	614	389	53089	0	54622
22086	438	228	481	53294	0	54441
22087	526	213	368	53232	0	54339
22088	464	52466	465	1388	0	54783
22089	526	729	348	51596	0	53199
22090	482	558	406	51553	0	52999
22091	50026	237	330	1425	0	52018
22092	1011	230	273	50398	0	51912
22093	893	228	48925	1151	0	51197
22094	558	221	47905	991	0	49675
22095	44319	199	1124	705	0	46347
22096	853	47609	728	680	0	49870
22097	702	47846	310	675	0	49533
22098	441	1131	390	45502	0	47464
22099	363	684	268	46190	0	47505
22100	415	294	44173	1409	0	46291
22101	41311	309	744	1024	0	43388
22102	43048	250	614	662	0	44574
22103	1230	274	43777	639	0	45920
22104	752	228	43348	614	0	44942
22105	42281	175	1115	650	0	44221
22106	44032	200	662	561	0	45455
22107	44156	197	285	597	0	45235
22108	43417	223	260	504	0	44404
22109	1192	40472	258	580	0	42502
22110	35049	557	231	377	0	36214
22111	700	422	33246	436	0	34804
22112	422	164	28009	298	0	28893
22113	199	154	26405	261	0	27019
22114	670	2671	966	16380	0	20687
22115	16308	42	426	145	0	16921
22116	16220	34	44	131	0	16429
22117	187	43	40	16140	0	16410
22118	114	39	39	16140	0	16332
22119	54	47	37	16078	0	16216
22120	49	17182	42	226	0	17499
22121	17511	110	39	160	0	17820
22122	17584	88	31	106	0	17809
22123	17631	36	24	89	0	17780
22124	17618	28	27	103	0	17776
22125	17551	30	35	95	0	17711
22126	218	30	31	17087	0	17366
22127	124	16993	39	158	0	17314
22128	116	95	37	16409	0	16657
22129	47	137	27	15441	0	15652
22130	14928	21	24	136	0	15109
22131	82	29	14516	94	0	14721
22132	72	22	13572	33	0	13699
22133	43	30	13726	29	0	13828
22134	13556	12	109	50	0	13727
22135	13821	7	234	42	0	14104
22136	93	15	16	14213	0	14337
22137	55	6	11	14124	0	14196
22138	29	6	8	14471	0	14514
22139	36	15	14545	98	0	14694
22140	16	11	55	14202	0	14284
22141	27	16	15560	72	0	15675
22142	21	18	66	15429	0	15534
22143	23	11	41	15592	0	15667
22144	12	6	21	15965	0	16004
22145	15998	7	13	118	0	16136
22146	16065	9	11	97	0	16182
22147	109	16	16405	31	0	16561
22148	16012	6	62	40	0	16120
22149	16282	1	48	29	0	16360
22150	101	2	15	16385	0	16503
22151	16576	9	10	84	0	16679
22152	87	7	10	17550	0	17654
22153	58	6	16	17747	0	17827
22154	47	14	17607	159	0	17827
22155	16396	4	93	99	0	16592
22156	112	1	68	17784	0	17965
22157	90	12	18089	112	0	18303
22158	41	14	19071	79	0	19205
22159	35	15	151	18490	0	18691
22160	23	16	99	18859	0	18997
22161	19029	5	36	190	0	19260
22162	106	5	20	19360	0	19491
22163	79	8	24	19447	0	19558
22164	38	3	29	19732	0	19802
22165	29	4	16	21213	0	21262
22166	21926	7	24	252	0	22209
22167	22043	3	22	164	0	22232
22168	22675	6	28	78	0	22787
22169	23103	11	19	71	0	23204
22170	318	5	19	23888	0	24230
22171	24322	3	18	212	0	24555
22172	231	9	33	24308	0	24581
22173	24549	2	31	238	0	24820
22174	251	4	31	24445	0	24731
22175	208	10	27	23843	0	24088
22176	76	24567	39	373	0	25055
22177	62	177	23	24608	0	24870
22178	24393	156	21	262	0	24832
22179	23924	32	22	229	0	24207
22180	385	20	24738	91	0	25234
22181	204	24951	221	90	0	25466
22182	24688	194	195	79	0	25156
22183	214	25743	61	82	0	26100
22184	25355	205	29	104	0	25693
22185	253	27124	55	142	0	27574
22186	240	226	27245	105	0	27816
22187	79	27639	227	114	0	28059
22188	81	27888	177	88	0	28234
22189	94	388	50	28229	0	28761
22190	28987	225	26	293	0	29531
22191	261	47	26	29408	0	29742
22192	218	39	33	29610	0	29900
22193	29459	28	37	439	0	29963
22194	30079	37	22	319	0	30457
22195	416	34	30	30382	0	30862
22196	291	18	32	30450	0	30791
22197	120	23	22	30789	0	30954
22198	29810	18	36	496	0	30360
22199	322	57	30212	268	0	30859
22200	284	24	223	29995	0	30526
22201	147	57	31488	323	0	32015
22202	89	31126	266	336	0	31817
22203	134	243	30626	157	0	31160
22204	116	204	253	30060	0	30633
22205	138	74	30498	317	0	31027
22206	28765	64	257	308	0	29394
22207	267	48	191	30253	0	30759
22208	237	31497	94	348	0	32176
22209	140	244	49	31256	0	31689
22210	115	31764	65	318	0	32262
22211	119	32062	79	280	0	32540
22212	128	32558	70	151	0	32907
22213	167	431	38	29944	0	30580
22214	106	31641	44	332	0	32123
22215	31192	262	48	290	0	31792
22216	323	253	30757	157	0	31490
22217	292	105	30872	128	0	31397
22218	161	120	31878	130	0	32289
22219	96	63	405	31733	0	32297
22220	137	71	222	31002	0	31432
22221	155	80	88	30897	0	31220
22222	159	52	77	31251	0	31539
22223	173	76	106	30793	0	31148
22224	163	32196	108	566	0	33033
22225	189	282	32303	325	0	33099
22226	202	259	32247	200	0	32908
22227	139	33384	411	244	0	34178
22228	163	265	243	33688	0	34359
22229	165	228	87	33949	0	34429
22230	137	119	65	34222	0	34543
22231	33654	113	77	530	0	34374
22232	315	133	33721	386	0	34555
22233	32781	102	236	207	0	33326
22234	33203	109	223	202	0	33737
22235	469	33174	112	205	0	33960
22236	312	33783	105	150	0	34350
22237	34011	401	109	177	0	34698
22238	338	282	93	34065	0	34778
22239	310	129	63	35264	0	35766
22240	179	137	37153	525	0	37994
22241	160	160	36046	1465	0	37831
22242	132	129	467	37814	0	38542
22243	38212	149	316	370	0	39047
22244	380	136	40284	398	0	41198
22245	41264	132	340	234	0	41970
22246	373	134	351	43162	0	44020
22247	359	119	124	44840	0	45442
22248	173	112	109	46428	0	46822
22249	169	128	46821	802	0	47920
22250	112	46792	405	545	0	47854
22251	109	48849	411	264	0	49633
22252	48182	623	135	228	0	49168
22253	48895	399	89	197	0	49580
22254	714	103	100	49458	0	50375
22255	49952	66	110	508	0	50636
22256	474	113	49254	497	0	50338
22257	474	137	48906	213	0	49730
22258	126	74	726	48160	0	49086
22259	49922	71	454	516	0	50963
22260	417	75	147	50734	0	51373
22261	431	70	132	51893	0	52526
22262	51345	81	119	851	0	52396
22263	51613	80	150	562	0	52405
22264	785	54245	152	237	0	55419
22265	53804	382	113	153	0	54452
22266	462	486	84	52186	0	53218
22267	411	53578	108	480	0	54577
22268	53014	394	78	452	0	53938
22269	414	54529	124	143	0	55210
22270	448	428	78	53660	0	54614
22271	53454	369	101	436	0	54360
22272	458	109	53152	408	0	54127
22273	443	84	53489	105	0	54121
22274	127	202	685	52326	0	53340
22275	100	71	394	53875	0	54440
22276	120	59	84	52498	0	52761
22277	78	55828	97	702	0	56705
22278	56888	390	50	454	0	57782
22279	56924	396	52	143	0	57515
22280	57211	91	69	176	0	57547
22281	803	60693	95	164	0	61755
22282	537	512	57	64727	0	65833
22283	164	435	61	65193	0	65853
22284	137	83	63	65865	0	66148
22285	61917	95	71	1044	0	63127
22286	498	63549	93	632	0	64772
22287	607	499	50	63606	0	64762
22288	183	547	65	64009	0	64804
22289	244	143	63083	1029	0	64499
22290	156	62913	523	669	0	64261
22291	199	565	504	62533	0	63801
22292	165	513	123	63127	0	63928
22293	157	118	82	63227	0	63584
22294	61462	96	85	1106	0	62749
22295	539	61680	105	801	0	63125
22296	62211	532	71	296	0	63110
22297	684	550	98	61609	0	62941
22298	62380	140	84	682	0	63286
22299	674	181	61376	694	0	62925
22300	60941	108	542	341	0	61932
22301	61670	125	529	299	0	62623
22302	1101	217	61863	256	0	63437
22303	710	172	533	61584	0	62999
22304	243	116	538	62562	0	63459
22305	63469	117	149	1239	0	64974
22306	678	171	106	64543	0	65498
22307	712	129	125	64695	0	65661
22308	260	130	111	64950	0	65451
22309	279	154	63369	1297	0	65099
22310	55387	127	595	1006	0	57115
22311	705	64291	621	367	0	65984
22312	766	628	148	62611	0	64153
22313	298	64752	169	769	0	65988
22314	320	66077	161	866	0	67424
22315	274	1120	153	66153	0	67700
22316	339	764	66483	824	0	68410
22317	337	261	66121	875	0	67594
22318	334	195	1132	66284	0	67945
22319	290	207	67363	926	0	68786
22320	64157	164	678	917	0	65916
22321	801	176	668	67971	0	69616
22322	811	190	180	68106	0	69287
22323	306	68604	166	1534	0	70610
22324	282	694	173	68827	0	69976
22325	257	709	180	67241	0	68387
22326	278	67296	195	1466	0	69235
22327	282	705	192	68385	0	69564
22328	315	702	172	67029	0	68218
22329	262	67507	203	1503	0	69475
22330	66907	721	213	995	0	68836
22331	877	752	67143	503	0	69275
22332	908	271	66580	481	0	68240
22333	399	349	1226	65685	0	67659
22334	303	276	726	67164	0	68469
22335	315	220	66981	1464	0	68980
22336	312	243	65865	1019	0	67439
22337	58134	288	1223	595	0	60240
22338	683	66055	746	600	0	68084
22339	64597	722	245	511	0	66075
22340	809	731	63482	524	0	65546
22341	737	62929	742	508	0	64916
22342	306	865	725	63421	0	65317
22343	304	726	65695	976	0	67701
22344	257	246	63547	916	0	64966
22345	342	468	1227	63756	0	65793
22346	317	236	65265	1045	0	66863
22347	218	63352	891	1062	0	65523
22348	255	807	766	62250	0	64078
22349	359	746	63199	1021	0	65325
22350	239	63442	807	999	0	65487
22351	62052	793	796	414	0	64055
22352	834	715	62038	369	0	63956
22353	721	62188	804	474	0	64187
22354	318	796	806	60922	0	62842
22355	265	695	280	62639	0	63879
22356	61965	219	248	1440	0	63872
22357	774	195	273	62103	0	63345
22358	704	182	231	61683	0	62800
22359	60096	156	256	1469	0	61977
22360	750	183	250	60209	0	61392
22361	674	181	58602	965	0	60422
22362	266	215	789	58146	0	59416
22363	218	196	58250	940	0	59604
22364	229	182	55281	780	0	56472
22365	203	183	56326	344	0	57056
22366	289	317	1191	49026	0	50823
22367	218	148	696	53799	0	54861
22368	54222	131	287	1177	0	55817
22369	639	184	242	51858	0	52923
22370	560	55288	203	890	0	56941
22371	204	603	202	56242	0	57251
22372	197	556	235	54048	0	55036
22373	111	55564	223	1243	0	57141
22374	54403	610	256	806	0	56075
22375	52967	566	254	362	0	54149
22376	998	54276	319	357	0	55950
22377	478	52917	275	327	0	53997
22378	261	1974	347	50397	0	52979
22379	51318	553	358	691	0	52920
22380	599	213	51488	640	0	52940
22381	504	180	47424	237	0	48345
22382	40834	100	823	192	0	41949
22383	395	44037	498	183	0	45113
22384	410	453	175	43874	0	44912
22385	148	409	166	44214	0	44937
22386	83	140	170	44796	0	45189
22387	116	79	147	44208	0	44550
22388	76	44052	183	904	0	45215
22389	119	433	138	44453	0	45143
22390	44118	395	144	579	0	45236
22391	443	124	142	44860	0	45569
22392	419	93	152	45068	0	45732
22393	45338	114	139	886	0	46477
22394	45598	86	146	552	0	46382
22395	46422	94	156	253	0	46925
22396	46705	106	152	242	0	47205
22397	849	98	149	46161	0	47257
22398	46349	99	127	543	0	47118
22399	532	88	113	46112	0	46845
22400	45877	74	146	602	0	46699
22401	45572	93	151	544	0	46360
22402	808	72	141	45650	0	46671
22403	481	127	45998	525	0	47131
22404	45462	93	484	546	0	46585
22405	46696	81	446	266	0	47489
22406	46900	93	187	232	0	47412
22407	46684	96	136	222	0	47138
22408	828	86	133	46831	0	47878
22409	454	137	47823	515	0	48929
22410	184	113	47464	508	0	48269
22411	45517	105	813	275	0	46710
22412	47324	80	459	206	0	48069
22413	708	47609	213	250	0	48780
22414	357	47136	164	223	0	47880
22415	47750	610	167	222	0	48749
22416	465	366	136	46683	0	47650
22417	394	131	101	48730	0	49356
22418	48188	97	101	774	0	49160
22419	427	50014	129	504	0	51074
22420	51066	393	96	251	0	51806
22421	513	376	50712	173	0	51774
22422	49820	88	408	245	0	50561
22423	489	91	322	50854	0	51756
22424	413	89	52221	588	0	53311
22425	178	52780	439	522	0	53919
22426	213	420	336	54019	0	54988
22427	238	328	57182	505	0	58253
22428	187	92	471	56391	0	57141
22429	57655	45	412	605	0	58717
22430	496	97	57957	504	0	59054
22431	55078	60	502	254	0	55894
22432	543	58700	423	207	0	59873
22433	440	451	179	58846	0	59916
22434	291	403	62524	517	0	63735
22435	163	167	493	61704	0	62527
22436	213	121	63818	624	0	64776
22437	164	63266	506	540	0	64476
22438	60757	410	344	206	0	61717
22439	464	65719	161	206	0	66550
22440	409	494	75	64573	0	65551
22441	184	377	96	65341	0	65998
22442	163	165	64038	742	0	65108
22443	49933	122	446	524	0	51025
22444	430	61086	361	181	0	62058
22445	267	57154	115	137	0	57673
22446	142	57899	83	167	0	58291
22447	312	783	206	55218	0	56519
22448	87	56636	114	296	0	57133
22449	160	403	76	54968	0	55607
22450	88	56377	102	307	0	56874
22451	118	309	44	54356	0	54827
22452	74	57465	77	315	0	57931
22453	56717	270	92	237	0	57316
22454	253	242	56862	132	0	57489
22455	54002	116	249	157	0	54524
22456	56464	88	181	152	0	56885
22457	58145	96	81	138	0	58460
22458	380	58588	93	161	0	59222
22459	59218	242	113	112	0	59685
22460	58914	220	71	122	0	59327
22461	59696	109	75	125	0	60005
22462	466	129	59221	82	0	59898
22463	326	91	226	58983	0	59626
22464	208	120	61527	261	0	62116
22465	146	95	266	60237	0	60744
22466	60542	107	213	331	0	61193
22467	310	61379	136	351	0	62176
22468	353	328	68296	158	0	69135
22469	177	266	423	68529	0	69395
22470	130	114	299	74737	0	75280
22471	129	136	82562	826	0	83653
22472	78264	106	812	469	0	79651
22473	83771	102	441	182	0	84496
22474	85902	111	147	151	0	86311
22475	1325	126	110	83485	0	85046
22476	569	84159	172	905	0	85805
22477	253	87667	163	627	0	88710
22478	205	1219	116	86448	0	87988
22479	225	614	113	84165	0	85117
22480	187	86424	148	1303	0	88062
22481	85352	839	106	563	0	86860
22482	900	86363	149	287	0	87699
22483	560	893	102	84648	0	86203
22484	244	572	85104	932	0	86852
22485	169	254	880	84018	0	85321
22486	85232	151	525	1023	0	86931
22487	988	224	85264	591	0	87067
22488	84694	167	888	294	0	86043
22489	87396	153	606	252	0	88407
22490	88329	153	201	268	0	88951
22491	88492	151	151	276	0	89070
22492	90423	164	316	261	0	91164
22493	1583	210	88261	205	0	90259
22494	874	208	88670	186	0	89938
22495	91831	151	1448	217	0	93647
22496	95334	178	657	195	0	96364
22497	1837	214	201	95578	0	97830
22498	877	98168	195	1440	0	100680
22499	370	1309	128	99210	0	101017
22500	99367	811	161	1388	0	101727
22501	1435	320	181	94243	0	96179
22502	944	101333	198	1362	0	103837
22503	100372	1295	182	855	0	102704
22504	99236	864	172	347	0	100619
22505	98653	307	153	328	0	99441
22506	2027	99008	241	418	0	101694
22507	1133	1297	212	98167	0	100809
22508	591	824	179	96605	0	98199
22509	503	96835	257	1965	0	99560
22510	542	1244	179	97405	0	99370
22511	95741	843	164	1462	0	98210
22512	95271	298	194	964	0	96727
22513	2188	95116	257	450	0	98011
22514	1322	1306	212	94328	0	97168
22515	649	895	255	94839	0	96638
22516	547	313	291	96216	0	97367
22517	92198	254	317	2209	0	94978
22518	1713	336	92019	1205	0	95273
22519	86792	260	1337	676	0	89065
22520	1844	509	90294	585	0	93232
22521	1395	400	1364	82457	0	85616
22522	809	87347	923	1476	0	90555
22523	710	90665	358	1253	0	92986
22524	87258	2120	214	706	0	90298
22525	85825	1167	255	676	0	87923
22526	2238	85055	258	721	0	88272
22527	1251	83360	256	717	0	85584
22528	83085	2074	303	553	0	86015
22529	83833	1116	275	633	0	85857
22530	2249	85311	308	728	0	88596
22531	86816	1530	275	663	0	89284
22532	1905	1161	85700	569	0	89335
22533	85481	535	1352	644	0	88012
22534	84687	434	939	646	0	86706
22535	2493	462	429	82548	0	85932
22536	1649	82289	372	1725	0	86035
22537	1157	1364	367	84271	0	87159
22538	83800	988	351	1690	0	86829
22539	2204	482	342	81391	0	84419
22540	1796	433	352	82345	0	84926
22541	1163	480	82950	2338	0	86931
22542	1100	481	1434	83085	0	86100
22543	1023	497	1017	85313	0	87850
22544	84422	550	443	2401	0	87816
22545	2022	628	84175	1445	0	88270
22546	84125	682	1402	795	0	87004
22547	2161	610	880	84705	0	88356
22548	1666	565	348	85428	0	88007
22549	1018	641	313	83950	0	85922
22550	1066	82476	381	2398	0	86321
22551	1138	84312	444	1469	0	87363
22552	1220	2130	309	82368	0	86027
22553	82985	1129	343	1761	0	86218
22554	83711	582	377	1235	0	85905
22555	3051	517	310	82717	0	86595
22556	83312	470	324	1877	0	85983
22557	2444	497	319	82419	0	85679
22558	1741	505	330	83705	0	86281
22559	80288	527	305	2668	0	83788
22560	2128	84533	396	1670	0	88727
22561	84720	1594	295	1010	0	87619
22562	85037	1110	289	969	0	87405
22563	82206	567	305	1000	0	84078
22564	2627	82282	386	1062	0	86357
22565	1774	1785	279	82610	0	86448
22566	1105	1151	353	84102	0	86711
22567	1078	581	81588	2750	0	85997
22568	962	933	1347	74024	0	77266
22569	905	489	71049	1726	0	74169
22570	735	65763	1173	1232	0	68903
22571	444	56954	657	576	0	58631
22572	515	57790	276	440	0	59021
22573	1037	1527	569	56950	0	60083
22574	538	696	205	57560	0	58999
22575	321	298	86	57749	0	58454
22576	310	255	104	58208	0	58877
22577	340	271	57778	1534	0	59923
22578	373	274	65413	949	0	67009
22579	381	224	1357	67070	0	69032
22580	427	224	70212	1217	0	72080
22581	68417	178	1046	988	0	70629
22582	70402	196	703	525	0	71826
22583	1683	273	71050	516	0	73522
22584	985	212	1011	70423	0	72631
22585	503	208	720	72424	0	73855
22586	487	220	280	73108	0	74095
22587	506	215	241	72437	0	73399
22588	476	216	224	73126	0	74042
22589	61185	310	281	1908	0	63684
22590	68488	230	213	1161	0	70092
22591	1557	69706	203	855	0	72321
22592	909	993	66917	555	0	69374
22593	366	66937	994	537	0	68834
22594	328	66793	696	515	0	68332
22595	61159	1170	218	377	0	62924
22596	782	60907	250	370	0	62309
22597	480	57350	174	302	0	58306
22598	56227	964	296	243	0	57730
22599	741	517	56150	240	0	57648
22600	54879	191	662	267	0	55999
22601	743	151	451	56273	0	57618
22602	543	138	183	54998	0	55862
22603	286	92	152	55765	0	56295
22604	275	132	54446	1200	0	56053
22605	181	54646	687	803	0	56317
22606	54502	626	423	496	0	56047
22607	683	424	228	54349	0	55684
22608	474	55338	195	956	0	56963
22609	269	686	199	56701	0	57855
22610	303	505	56560	884	0	58252
22611	308	222	698	56430	0	57658
22612	279	221	498	57795	0	58793
22613	256	215	220	58002	0	58693
22614	57119	256	180	1321	0	58876
22615	742	216	206	57682	0	58846
22616	555	211	57364	1103	0	59233
22617	284	57195	725	883	0	59087
22618	338	728	471	57169	0	58706
22619	349	506	244	57675	0	58774
22620	313	291	56977	1254	0	58835
22621	327	258	55939	775	0	57299
22622	53691	269	1325	525	0	55810
22623	54616	268	660	554	0	56098
22624	1146	55344	476	501	0	57467
22625	55370	731	289	446	0	56836
22626	1006	605	55175	419	0	57205
22627	724	255	54846	483	0	56308
22628	53287	314	1141	655	0	55397
22629	52836	212	633	703	0	54384
22630	1082	188	51577	726	0	53573
22631	49540	145	751	732	0	51168
22632	872	187	51027	659	0	52745
22633	49726	186	847	439	0	51198
22634	50516	305	545	405	0	51771
22635	1150	441	328	47354	0	49273
22636	611	52397	436	799	0	54243
22637	46093	1026	354	640	0	48113
22638	780	756	52524	382	0	54442
22639	644	53037	833	386	0	54900
22640	52782	1010	590	424	0	54806
22641	50185	654	323	494	0	51656
22642	1219	50707	372	553	0	52851
22643	800	700	455	50404	0	52359
22644	588	522	49916	1019	0	52045
22645	422	254	864	49754	0	51294
22646	430	294	50003	1149	0	51876
22647	365	262	939	49012	0	50578
22648	335	276	797	49546	0	50954
22649	407	344	49176	1292	0	51219
22650	446	48788	976	928	0	51138
22651	476	726	652	48058	0	49912
22652	513	640	44871	1014	0	47038
22653	46059	283	716	860	0	47918
22654	833	259	660	48437	0	50189
22655	657	233	387	48718	0	49995
22656	47559	232	352	1310	0	49453
22657	948	213	281	47485	0	48927
22658	848	202	306	45918	0	47274
22659	437	47276	406	1137	0	49256
22660	452	684	435	45340	0	46911
22661	385	596	44752	871	0	46604
22662	441	257	755	42068	0	43521
22663	396	43528	613	887	0	45424
22664	349	43571	544	689	0	45153
22665	404	891	444	42993	0	44732
22666	43153	526	360	773	0	44812
22667	853	342	396	43257	0	44848
22668	43259	418	355	795	0	44827
22669	963	222	412	43265	0	44862
22670	42998	233	521	845	0	44597
22671	43742	216	439	743	0	45140
22672	1281	398	416	42595	0	44690
22673	964	1511	462	40624	0	43561
22674	562	41444	492	1119	0	43617
22675	540	42005	409	832	0	43786
22676	658	757	41176	601	0	43192
22677	517	40031	652	563	0	41763
22678	29135	553	944	415	0	31047
22679	540	248	214	28357	0	29359
22680	258	27539	164	338	0	28299
22681	28235	242	138	315	0	28930
22682	322	212	120	28181	0	28835
22683	286	97	123	27661	0	28167
22684	196	101	156	28145	0	28598
22685	153	147	157	28219	0	28676
22686	156	28773	188	487	0	29604
22687	178	30254	142	317	0	30891
22688	30949	351	135	214	0	31649
22689	370	32099	132	181	0	32782
22690	335	296	134	31987	0	32752
22691	219	266	115	32112	0	32712
22692	221	138	94	32343	0	32796
22693	192	107	97	32483	0	32879
22694	31934	106	126	538	0	32704
22695	32594	94	113	369	0	33170
22696	599	93	32785	207	0	33684
22697	373	87	353	32855	0	33668
22698	256	117	33898	405	0	34676
22699	219	84	380	33568	0	34251
22700	178	116	330	34032	0	34656
22701	34497	111	107	689	0	35404
22702	416	108	114	34751	0	35389
22703	358	124	34963	497	0	35942
22704	167	132	34370	420	0	35089
22705	33528	105	619	278	0	34530
22706	429	99	35169	222	0	35919
22707	359	159	354	33425	0	34297
22708	139	98	35037	467	0	35741
22709	107	210	355	33443	0	34115
22710	74	34243	316	448	0	35081
22711	108	342	117	33473	0	34040
22712	59	34073	107	413	0	34652
22713	65	34049	80	387	0	34581
22714	139	570	57	33143	0	33909
22715	32991	290	45	381	0	33707
22716	280	33572	64	359	0	34275
22717	300	295	41	33312	0	33948
22718	33556	273	39	373	0	34241
22719	33932	76	41	342	0	34391
22720	34500	65	32	193	0	34790
22721	566	68	46	33883	0	34563
22722	319	56	49	34381	0	34805
22723	34526	56	39	602	0	35223
22724	34368	65	70	377	0	34880
22725	34892	69	46	187	0	35194
22726	577	57	59	34374	0	35067
22727	331	79	33831	351	0	34592
22728	32734	50	263	343	0	33390
22729	334	63	259	33071	0	33727
22730	306	34118	68	374	0	34866
22731	155	392	63	33554	0	34164
22732	102	34129	65	374	0	34670
22733	115	337	45	34586	0	35083
22734	121	269	33810	419	0	34619
22735	75	33746	293	380	0	34494
22736	117	287	249	31475	0	32128
22737	82	254	70	31463	0	31869
22738	86	75	45	31668	0	31874
22739	31590	74	57	542	0	32263
22740	284	32169	70	413	0	32936
22741	300	325	46	32656	0	33327
22742	32940	289	56	422	0	33707
22743	33032	95	48	386	0	33561
22744	614	90	50	33144	0	33898
22745	383	89	33807	451	0	34730
22746	131	67	349	32669	0	33216
22747	107	33770	365	436	0	34678
22748	122	360	98	34099	0	34679
22749	33658	309	66	490	0	34523
22750	390	81	81	35259	0	35811
22751	395	78	35597	522	0	36592
22752	121	38308	393	500	0	39322
22753	38625	424	337	209	0	39595
22754	481	414	39136	171	0	40202
22755	38725	93	448	189	0	39455
22756	509	74	426	40039	0	41048
22757	457	63	106	39830	0	40456
22758	139	40713	112	840	0	41804
22759	41571	422	94	538	0	42625
22760	526	396	86	42346	0	43354
22761	477	90	87	42770	0	43424
22762	154	43	86	43678	0	43961
22763	156	97	43149	945	0	44347
22764	142	66	480	43272	0	43960
22765	43382	69	449	639	0	44539
22766	43998	65	120	564	0	44747
22767	889	69	84	43610	0	44652
22768	512	92	81	44127	0	44812
22769	43421	51	67	970	0	44509
22770	548	99	43362	551	0	44560
22771	42315	82	518	212	0	43127
22772	587	105	42885	199	0	43776
22773	538	99	42667	144	0	43448
22774	182	78	824	41566	0	42650
22775	184	77	43126	575	0	43962
22776	41879	67	526	526	0	42998
22777	531	47	412	42850	0	43840
22778	514	95	42988	541	0	44138
22779	41013	53	474	547	0	42087
22780	42367	64	405	212	0	43048
22781	918	107	43207	194	0	44426
22782	559	276	473	38882	0	40190
22783	181	43634	452	484	0	44751
22784	43702	449	118	471	0	44740
22785	570	437	44111	176	0	45294
22786	40397	155	492	199	0	41243
22787	541	42250	415	174	0	43380
22788	40312	390	237	179	0	41118
22789	40015	305	74	147	0	40541
22790	40402	68	94	161	0	40725
22791	713	148	72	39697	0	40630
22792	392	40666	93	493	0	41644
22793	198	399	40265	417	0	41279
22794	122	41375	402	194	0	42093
22795	193	469	342	36169	0	37173
22796	105	39814	123	358	0	40400
22797	121	39976	93	345	0	40535
22798	38376	555	154	161	0	39246
22799	415	330	38767	125	0	39637
22800	362	101	39743	151	0	40357
22801	181	75	39106	122	0	39484
22802	97	39167	538	191	0	39993
22803	38806	292	366	169	0	39633
22804	38843	252	82	153	0	39330
22805	38629	79	76	126	0	38910
22806	537	38584	103	167	0	39391
22807	331	289	63	39474	0	40157
22808	134	271	39372	381	0	40158
22809	157	116	39871	328	0	40472
22810	39792	87	521	196	0	40596
22811	40979	75	320	174	0	41548
22812	41256	62	113	159	0	41590
22813	656	84	40631	162	0	41533
22814	40168	54	361	234	0	40817
22815	431	79	285	40737	0	41532
22816	408	90	134	40900	0	41532
22817	239	122	43121	611	0	44093
22818	193	43502	383	489	0	44567
22819	199	289	327	43447	0	44262
22820	207	284	43231	500	0	44222
22821	40079	91	423	491	0	41084
22822	468	72	355	43689	0	44584
22823	444	61	175	43903	0	44583
22824	43545	42	150	722	0	44459
22825	500	58	157	43880	0	44595
22826	43836	46	143	574	0	44599
22827	43876	64	166	490	0	44596
22828	713	62	198	44005	0	44978
22829	513	59	207	44520	0	45299
22830	44496	74	216	699	0	45485
22831	518	51	232	45357	0	46158
22832	46315	54	263	534	0	47166
22833	46251	71	246	425	0	46993
22834	46340	67	204	237	0	46848
22835	779	71	253	45636	0	46739
22836	530	77	212	46047	0	46866
22837	45833	64	228	640	0	46765
22838	499	45581	275	377	0	46732
22839	402	44519	235	190	0	45346
22840	44012	398	219	158	0	44787
22841	451	268	43850	126	0	44695
22842	43322	95	383	152	0	43952
22843	466	93	327	46501	0	47387
22844	381	123	47893	265	0	48662
22845	48036	88	298	254	0	48676
22846	430	110	227	49383	0	50150
22847	379	100	125	51069	0	51673
22848	328	104	122	52516	0	53070
22849	292	126	83	52613	0	53114
22850	51724	112	167	403	0	52406
22851	310	51486	135	281	0	52212
22852	47306	183	105	135	0	47729
22853	210	151	47720	74	0	48155
22854	191	105	46702	77	0	47075
22855	103	49908	197	79	0	50287
22856	309	434	351	48795	0	49889
22857	94	114	49254	164	0	49626
22858	60	47596	123	227	0	48006
22859	58	96	46553	141	0	46848
22860	27	34	40	45718	0	45819
22861	21	27	19	46656	0	46723
22862	46894	13	15	100	0	47022
22863	34	22	12	46762	0	46830
22864	46470	10	11	80	0	46571
22865	61	54	47283	80	0	47478
22866	30	48791	59	82	0	48962
22867	54	36	21	51459	0	51570
22868	48	71	14	55415	0	55548
22869	69	64	57014	48	0	57195
22870	71	85	55077	49	0	55282
22871	53056	16	55	87	0	53214
22872	58362	13	37	110	0	58522
22873	62	17	20	58623	0	58722
22874	60	10	9	58738	0	58817
22875	17	58818	39	101	0	58975
22876	29	61	8	61020	0	61118
22877	63659	36	15	154	0	63864
22878	64951	24	19	111	0	65105
22879	174	68451	60	97	0	68782
22880	69321	146	13	85	0	69565
22881	70448	165	21	82	0	70716
22882	376	36	20	76844	0	77276
22883	225	79109	66	319	0	79719
22884	81	270	22	80458	0	80831
22885	67	306	22	81316	0	81711
22886	88	97	80298	628	0	81111
22887	78286	28	303	430	0	79047
22888	398	32	302	85881	0	86613
22889	406	33	50	88489	0	88978
22890	51	101157	116	903	0	102227
22891	88	696	29	105427	0	106240
22892	107197	547	74	853	0	108671
22893	111977	117	74	691	0	112859
22894	1554	115	112296	159	0	114124
22895	843	113	112830	104	0	113890
22896	209	64	1580	110955	0	112808
22897	132	38	772	116339	0	117281
22898	198	113	116877	1612	0	118800
22899	180	107	117005	856	0	118148
22900	124	65	1649	111593	0	113431
22901	149	123	118834	1038	0	120144
22902	234	110	118712	820	0	119876
22903	180	58	1731	112951	0	114920
22904	117947	38	916	1052	0	119953
22905	119408	52	227	873	0	120560
22906	1753	102	145	117875	0	119875
22907	952	70	140	119407	0	120569
22908	118382	57	131	1769	0	120339
22909	1128	86	115	117031	0	118360
22910	117882	70	124	1196	0	119272
22911	116192	75	154	987	0	117408
22912	1809	49	141	117088	0	119087
22913	1017	129	144	118220	0	119510
22914	113763	97	163	1920	0	115943
22915	1068	116990	233	1209	0	119500
22916	930	118061	271	613	0	119875
22917	439	1762	222	113849	0	116272
22918	421	977	114376	1291	0	117065
22919	310	218	1092	113533	0	115153
22920	113514	143	977	1436	0	116070
22921	1204	156	332	114631	0	116323
22922	114605	113	292	1446	0	116456
22923	1352	199	113607	1309	0	116467
22924	111833	157	1163	646	0	113799
22925	1307	164	1028	114501	0	117000
22926	1112	141	373	116312	0	117938
22927	593	184	119294	2129	0	122200
22928	471	143	1223	117675	0	119512
22929	410	144	1060	119553	0	121167
22930	385	165	416	121973	0	122939
22931	119042	180	407	2365	0	121994
22932	1384	252	119821	1458	0	122915
22933	1266	260	118873	731	0	121130
22934	115439	136	2013	748	0	118336
22935	118787	126	1266	692	0	120871
22936	2196	224	121420	726	0	124566
22937	1383	165	1467	114068	0	117083
22938	610	122138	1362	1604	0	125714
22939	638	1137	682	123521	0	125978
22940	122876	865	687	1769	0	126197
22941	123409	248	740	1610	0	126007
22942	2133	199	778	120997	0	124107
22943	1316	121682	783	2051	0	125832
22944	911	1024	698	114563	0	117196
22945	745	120252	762	1842	0	123601
22946	119419	1116	681	1711	0	122927
22947	116582	911	689	1124	0	119306
22948	116246	220	672	1094	0	118232
22949	2339	114307	684	1296	0	118626
22950	1575	116972	686	1183	0	120416
22951	1030	2017	534	116901	0	120482
22952	916	1023	532	117947	0	120418
22953	875	328	535	117750	0	119488
22954	985	243	488	118742	0	120458
22955	990	340	113863	2828	0	118021
22956	105407	302	1421	2083	0	109213
22957	1906	428	115611	1214	0	119159
22958	113642	372	1531	1226	0	116771
22959	1945	469	118907	1203	0	122524
22960	116544	335	1549	1279	0	119707
22961	2000	365	121699	1205	0	125269
22962	116472	347	1699	1159	0	119677
22963	2006	292	1451	121234	0	124983
22964	123546	293	801	2173	0	126813
22965	2058	270	645	125479	0	128452
22966	1785	269	684	125388	0	128126
22967	1090	262	703	120586	0	122641
22968	906	117977	785	2981	0	122649
22969	116420	1258	635	2069	0	120382
22970	115745	1038	643	1339	0	118765
22971	2600	118069	746	1433	0	122848
22972	1850	1275	579	118177	0	121881
22973	1129	1123	116924	2138	0	121314
22974	113820	353	1553	1935	0	117661
22975	117437	285	1332	1307	0	120361
22976	116140	244	720	1182	0	118286
22977	2830	265	597	109282	0	112974
22978	1678	108917	725	1806	0	113126
22979	1056	1196	550	107433	0	110235
22980	106236	894	566	1843	0	109539
22981	1852	394	534	100317	0	103097
22982	1160	96401	554	1486	0	99601
22983	93123	970	523	1192	0	95808
22984	1591	853	95204	730	0	98378
22985	1607	422	95133	619	0	97781
22986	773	95372	1606	729	0	98480
22987	708	94074	952	630	0	96364
22988	1639	1395	88528	535	0	92097
22989	1255	900	83823	520	0	86498
22990	840	3795	1302	65342	0	71279
22991	69068	221	697	578	0	70564
22992	601	193	69806	402	0	71002
22993	268	66108	337	209	0	66922
22994	66479	277	558	232	0	67546
22995	297	67075	128	212	0	67712
22996	64361	233	134	109	0	64837
22997	241	65242	97	141	0	65721
22998	187	67086	118	150	0	67541
22999	170	365	122	67246	0	67903
23000	129	200	92	67594	0	68015
23001	172	155	65927	301	0	66555
23002	112	71	198	64334	0	64715
23003	65555	64	143	271	0	66033
23004	65890	67	55	235	0	66247
23005	336	86	44	65207	0	65673
23006	234	142	64849	267	0	65492
23007	151	124	64511	201	0	64987
23008	115	62	297	65125	0	65599
23009	168	114	68288	289	0	68859
23010	107	59	261	67381	0	67808
23011	116	67	178	68655	0	69016
23012	146	111	77348	387	0	77992
23013	70670	507	438	349	0	71964
23014	77520	62	353	167	0	78102
23015	665	100	80064	126	0	80955
23016	394	118	82959	135	0	83606
23017	186	48	925	82239	0	83398
23018	158	79	460	91549	0	92246
23019	129	71	162	93521	0	93883
23020	121	87	110	94206	0	94524
23021	93334	64	104	1246	0	94748
23022	97356	65	108	661	0	98190
23023	1264	93	113	102583	0	104053
23024	699	72	111	106744	0	107626
23025	268	145	113879	1584	0	115876
23026	198	90	1197	115655	0	117140
23027	166	70	913	120975	0	122124
23028	120836	82	216	2428	0	123562
23029	1397	130093	222	1412	0	133124
23030	1152	1672	101	129647	0	132572
23031	340	1142	103	131016	0	132601
23032	215	243	119	128346	0	128923
23033	130	123358	224	3111	0	126823
23034	171	128944	239	1689	0	131043
23035	264	2735	136	127334	0	130469
23036	191	1304	103	126737	0	128335
23037	222	306	123	128911	0	129562
23038	122087	163	126	3158	0	125534
23039	1590	124389	244	1841	0	128064
23040	125406	1677	107	601	0	127791
23041	126043	1270	129	472	0	127914
23042	2893	355	127	121324	0	124699
23043	1399	122567	193	2002	0	126161
23044	122281	1712	109	1547	0	125649
23045	1860	1396	115	122719	0	126090
23046	124037	373	197	2147	0	126754
23047	2010	288	143	125332	0	127773
23048	1512	342	125217	2252	0	129323
23049	522	292	127348	1741	0	129903
23050	358	241	2910	124837	0	128346
23051	390	276	1427	125759	0	127852
23052	433	293	318	122754	0	123798
23053	375	123948	296	3308	0	127927
23054	337	128256	270	1989	0	130852
23055	122438	2951	174	839	0	126402
23056	117597	1663	198	722	0	120180
23057	2867	123940	272	866	0	127945
23058	1439	122001	247	777	0	124464
23059	460	124231	243	815	0	125749
23060	115921	2962	245	697	0	119825
23061	1709	119349	317	881	0	122256
23062	1461	1960	174	118076	0	121671
23063	117511	1430	193	2127	0	121261
23064	116405	462	204	1770	0	118841
23065	3038	344	199	113093	0	116674
23066	1729	469	112350	2150	0	116698
23067	716	450	113213	1675	0	116054
23068	572	367	2792	111551	0	115282
23069	629	449	114459	2191	0	117728
23070	514	428	1877	112189	0	115008
23071	506	398	1377	112187	0	114468
23072	543	449	111820	3308	0	116120
23073	652	494	112098	1938	0	115182
23074	515	391	2945	109027	0	112878
23075	567	405	1559	113688	0	116219
23076	109976	432	543	3429	0	114380
23077	1900	110566	471	2275	0	115212
23078	1520	114210	458	1311	0	117499
23079	110125	3001	360	1112	0	114598
23080	111663	1732	335	1120	0	114850
23081	3045	111563	430	1239	0	116277
23082	1759	112670	404	1242	0	116075
23083	111247	3120	301	1086	0	115754
23084	2193	1793	295	109961	0	114242
23085	108615	689	371	2707	0	112382
23086	2185	108466	451	2454	0	113556
23087	109011	2002	364	1402	0	112779
23088	2479	1757	107410	1240	0	112886
23089	105556	678	1885	1213	0	109332
23090	2504	719	108353	1194	0	112770
23091	1911	643	2026	104949	0	109529
23092	103569	546	1584	2844	0	108543
23093	2283	657	101523	2495	0	106958
23094	1826	669	1957	101611	0	106063
23095	101035	687	1542	2814	0	106078
23096	2324	831	101119	2377	0	106651
23097	1899	754	1911	101012	0	105576
23098	98192	749	1521	2856	0	103318
23099	2155	98478	587	2551	0	103771
23100	1935	2246	412	99211	0	103804
23101	1049	1994	338	99793	0	103174
23102	1044	980	365	99057	0	101446
23103	931	99393	451	3743	0	104518
23104	1102	2283	333	101924	0	105642
23105	1081	1881	375	102314	0	105651
23106	1227	906	374	103328	0	105835
23107	1182	801	364	105728	0	108075
23108	1265	847	102341	3709	0	108162
23109	95233	766	2041	2369	0	100409
23110	99596	623	1693	1213	0	103125
23111	3587	98983	755	1185	0	104510
23112	2026	1894	510	91277	0	95707
23113	1004	1529	561	91001	0	94095
23114	808	91240	667	3475	0	96190
23115	705	1660	645	89241	0	92251
23116	83323	1281	701	2347	0	87652
23117	1594	81710	786	2027	0	86117
23118	77115	1457	566	954	0	80092
23119	1663	1207	469	76301	0	79640
23120	1366	505	75903	2080	0	79854
23121	529	75842	1512	1757	0	79640
23122	68986	1544	1536	792	0	72858
23123	1300	65750	406	574	0	68030
23124	990	63247	328	567	0	65132
23125	53019	1350	786	416	0	55571
23126	949	721	52117	321	0	54108
23127	486	45839	582	255	0	47162
23128	36678	1468	2617	656	0	41419
23129	32220	283	333	145	0	32981
23130	382	32714	38	122	0	33256
23131	211	230	51	33349	0	33841
23132	77	256	34280	308	0	34921
23133	81	105	223	33834	0	34243
23134	51	61	198	34051	0	34361
23135	57	52	41	35313	0	35463
23136	76	68	35260	456	0	35860
23137	81	63	228	34054	0	34426
23138	97	82	35216	290	0	35685
23139	68	64	34151	241	0	34524
23140	29395	72	398	127	0	29992
23141	233	34500	210	68	0	35011
23142	205	34781	51	81	0	35118
23143	118	404	49	35685	0	36256
23144	40777	237	32	352	0	41398
23145	41121	70	33	225	0	41449
23146	40980	72	45	114	0	41211
23147	41382	76	39	86	0	41583
23148	39990	60	36	123	0	40209
23149	439	80	39881	70	0	40470
23150	251	66	228	38731	0	39276
23151	91	39817	208	267	0	40383
23152	79	239	66	40110	0	40494
23153	40037	215	50	298	0	40600
23154	253	40433	67	280	0	41033
23155	232	256	70	40719	0	41277
23156	41027	223	62	314	0	41626
23157	42288	76	45	316	0	42725
23158	447	47	75	42447	0	43016
23159	257	60	70	42149	0	42536
23160	123	63	45	42808	0	43039
23161	111	80	42481	489	0	43161
23162	107	100	44081	293	0	44581
23163	112	63	424	44382	0	44981
23164	109	63	230	45311	0	45713
23165	45378	73	71	486	0	46008
23166	45305	76	49	332	0	45762
23167	46575	63	57	180	0	46875
23168	48670	73	62	164	0	48969
23169	48033	87	59	158	0	48337
23170	488	49600	76	171	0	50335
23171	51080	288	40	175	0	51583
23172	51609	237	68	150	0	52064
23173	51822	96	58	149	0	52125
23174	558	89	56	53425	0	54128
23175	326	118	53333	384	0	54161
23176	170	80	306	54342	0	54898
23177	186	121	59992	429	0	60728
23178	146	133	354	56128	0	56761
23179	106	60726	303	420	0	61555
23180	60856	342	107	311	0	61616
23181	63031	279	79	237	0	63626
23182	635	89	72	64740	0	65536
23183	384	84	68	68561	0	69097
23184	178	79	72	67963	0	68292
23185	155	71257	102	670	0	72184
23186	71483	358	68	379	0	72288
23187	71200	307	43	203	0	71753
23188	685	73851	108	213	0	74857
23189	426	390	49	74087	0	74952
23190	220	319	68	71585	0	72192
23191	138	75074	101	725	0	76038
23192	75759	398	79	413	0	76649
23193	75692	333	82	173	0	76280
23194	742	116	86	75812	0	76756
23195	477	110	77222	520	0	78329
23196	262	119	77535	428	0	78344
23197	164	75	714	80283	0	81236
23198	173	72	372	80430	0	81047
23199	189	80	101	82487	0	82857
23200	82578	55	85	931	0	83649
23201	82769	73	90	543	0	83475
23202	867	89109	102	309	0	90387
23203	89783	550	243	291	0	90867
23204	692	453	92134	127	0	93406
23205	613	155	92635	199	0	93602
23206	184	97626	913	217	0	98940
23207	92735	561	718	250	0	94264
23208	440	94716	207	230	0	95593
23209	94267	486	141	177	0	95071
23210	594	480	95203	156	0	96433
23211	509	153	94984	130	0	95776
23212	201	122	783	92319	0	93425
23213	235	168	98638	576	0	99617
23214	160	80	496	99046	0	99782
23215	158	125	415	93575	0	94273
23216	133	100710	183	979	0	102005
23217	197	482	102	100944	0	101725
23218	175	423	80	101807	0	102485
23219	103143	149	88	948	0	104328
23220	566	105183	137	633	0	106519
23221	557	542	167	106930	0	108196
23222	256	530	107636	662	0	109084
23223	93969	152	636	785	0	95542
23224	711	190	108674	274	0	109849
23225	642	216	631	102648	0	104137
23226	209	113205	598	694	0	114706
23227	252	726	156	110251	0	111385
23228	115083	600	136	848	0	116667
23229	113483	210	122	723	0	114538
23230	1327	119665	171	402	0	121565
23231	123707	757	117	368	0	124949
23232	124656	677	129	358	0	125820
23233	127557	217	139	373	0	128286
23234	128807	150	137	315	0	129409
23235	121372	155	216	313	0	122056
23236	1500	226	127043	207	0	128976
23237	887	159	818	125045	0	126909
23238	339	185	701	126420	0	127645
23239	296	219	215	124035	0	124765
23240	285	128088	274	1461	0	130108
23241	329	818	186	127578	0	128911
23242	378	801	127803	963	0	129945
23243	272	127255	899	930	0	129356
23244	257	125089	817	431	0	126594
23245	428	1373	273	124083	0	126157
23246	310	791	209	124030	0	125340
23247	331	324	199	120196	0	121050
23248	256	123039	268	1672	0	125235
23249	286	124464	270	1019	0	126039
23250	123491	1392	218	479	0	125580
23251	122022	821	206	435	0	123484
23252	1434	125844	271	470	0	128019
23253	127528	904	249	420	0	129101
23254	129760	797	269	559	0	131385
23255	1550	326	307	132072	0	134255
23256	1002	318	259	135801	0	137380
23257	486	260	263	136216	0	137225
23258	473	377	137585	1706	0	140141
23259	537	399	139937	1105	0	141978
23260	442	145507	1743	644	0	148336
23261	146768	1144	1074	506	0	149492
23262	1493	1082	150644	434	0	153653
23263	144162	347	1365	542	0	146416
23264	1593	434	157635	459	0	160121
23265	150969	370	1447	490	0	153276
23266	1533	162930	1287	609	0	166359
23267	160331	1430	473	550	0	162784
23268	1691	1200	378	160617	0	163886
23269	1399	458	387	163243	0	165487
23270	767	628	162521	2499	0	166415
23271	518	168775	1454	1839	0	172586
23272	601	1575	1228	169140	0	172544
23273	615	1349	168782	1701	0	172447
23274	146796	505	1534	1598	0	150433
23275	1431	166110	1332	770	0	169643
23276	161560	1405	473	636	0	164074
23277	1465	160292	432	739	0	162928
23278	1308	1477	419	158729	0	161933
23279	156540	1199	346	1644	0	159729
23280	1440	157244	440	3311	0	162435
23281	1314	1401	336	158526	0	161577
23282	651	1268	156464	1702	0	160085
23283	144041	499	1368	1376	0	147284
23284	1639	461	1025	154515	0	157640
23285	1436	477	152942	1601	0	156456
23286	645	152106	1352	1790	0	155893
23287	652	1449	1141	151612	0	154854
23288	778	1320	151764	1568	0	155430
23289	649	637	1360	143178	0	145824
23290	574	153425	1176	1525	0	156700
23291	591	154783	465	1439	0	157278
23292	879	2251	152639	544	0	156313
23293	698	1366	1261	149570	0	152895
23294	632	564	154190	1620	0	157006
23295	137272	494	1693	1405	0	140864
23296	1664	542	1078	144908	0	148192
23297	1192	147118	477	1425	0	150212
23298	535	152407	364	1239	0	154545
23299	146983	2011	318	585	0	149897
23300	1314	152361	351	666	0	154692
23301	148765	1283	449	604	0	151101
23302	1499	1085	146661	438	0	149683
23303	134141	491	1235	433	0	136300
23304	1235	142936	1047	486	0	145704
23305	140380	1267	482	409	0	142538
23306	1183	139817	297	465	0	141762
23307	1031	1294	234	137505	0	140064
23308	400	1067	216	140847	0	142530
23309	368	509	139891	1920	0	142688
23310	130801	405	1194	1231	0	133631
23311	1344	493	142893	460	0	145190
23312	141721	387	1341	441	0	143890
23313	1515	335	981	142713	0	145544
23314	1132	404	340	143566	0	145442
23315	424	147928	369	2373	0	151094
23316	437	1547	321	151939	0	154244
23317	506	1223	321	154213	0	156263
23318	472	538	152085	2587	0	155682
23319	135510	338	1586	1563	0	138997
23320	1512	148092	1321	585	0	151510
23321	146142	1470	424	454	0	148490
23322	1679	1153	339	145795	0	148966
23323	1233	492	354	147573	0	149652
23324	144483	292	365	2463	0	147603
23325	1508	147583	489	1702	0	151282
23326	140470	1386	318	486	0	142660
23327	1513	141253	479	503	0	143748
23328	1120	139692	354	446	0	141612
23329	138053	2209	664	365	0	141291
23330	1767	1219	415	134614	0	138015
23331	1189	537	133844	1550	0	137120
23332	502	404	1383	131579	0	133868
23333	471	371	1044	129434	0	131320
23334	327	131231	429	2449	0	134436
23335	687	1593	259	132487	0	135026
23336	410	1247	256	133073	0	134986
23337	384	440	285	134519	0	135628
23338	422	438	295	136790	0	137945
23339	439	494	135243	2689	0	138865
23340	486	491	138047	1574	0	140598
23341	462	390	2413	138780	0	142045
23342	509	504	139946	1949	0	142908
23343	563	503	139098	1492	0	141656
23344	548	424	2548	136656	0	140176
23345	550	578	142354	1912	0	145394
23346	594	509	1736	130249	0	133088
23347	397	142754	1477	1820	0	146448
23348	143598	1720	519	1530	0	147367
23349	1867	1520	152246	743	0	156376
23350	1543	531	1922	149706	0	153702
23351	585	569	154781	2196	0	158131
23352	471	465	1972	158083	0	160991
23353	482	478	1588	161429	0	163977
23354	157096	437	561	3689	0	161783
23355	2148	405	486	159525	0	162564
23356	151630	361	511	2606	0	155108
23357	152076	335	468	2128	0	155007
23358	3327	151124	486	1062	0	155999
23359	143965	1911	397	695	0	146968
23360	1981	143090	502	866	0	146439
23361	1425	141707	481	839	0	144452
23362	136737	2887	839	638	0	141101
23363	2048	1546	136511	580	0	140685
23364	1490	451	132082	551	0	134574
23365	123849	825	3609	614	0	128897
23366	125133	382	1650	558	0	127723
23367	2646	126335	565	560	0	130106
23368	128376	1596	424	522	0	130918
23369	127115	1293	436	616	0	129460
23370	124720	357	396	596	0	126069
23371	2954	298	355	121800	0	125407
23372	120059	309	368	1983	0	122719
23373	1854	123840	471	1710	0	127875
23374	1642	1581	388	125532	0	129143
23375	740	1314	345	125314	0	127713
23376	575	125793	463	3004	0	129835
23377	627	1613	367	127529	0	130136
23378	124657	1414	379	2092	0	128542
23379	125341	503	339	1760	0	127943
23380	2965	124436	434	840	0	128675
23381	1746	126050	371	749	0	128916
23382	125105	2714	393	621	0	128833
23383	2146	1607	124311	612	0	128676
23384	1872	645	124466	629	0	127612
23385	921	575	2801	119509	0	123806
23386	842	501	1580	123799	0	126722
23387	922	574	122854	2883	0	127233
23388	857	119308	1925	2014	0	124104
23389	925	1798	1531	116223	0	120477
23390	899	1586	120362	2006	0	124853
23391	912	562	1793	118504	0	121771
23392	833	540	1532	116137	0	119042
23393	719	122013	676	2936	0	126344
23394	806	1909	446	120792	0	123953
23395	805	1575	496	121717	0	124593
23396	820	631	521	123450	0	125422
23397	120147	508	503	3255	0	124413
23398	2179	562	465	115406	0	118612
23399	1823	118939	520	2232	0	123514
23400	117512	1847	501	1823	0	121683
23401	2249	1613	115264	940	0	120066
23402	2066	689	114366	857	0	117978
23403	111842	489	2845	900	0	116076
23404	2159	546	1675	114759	0	119139
23405	1858	644	115936	2111	0	120549
23406	907	517	1875	114778	0	118077
23407	829	529	1677	117093	0	120128
23408	115099	534	777	3258	0	119668
23409	114213	539	647	2102	0	117501
23410	3045	115472	727	1282	0	120526
23411	1919	1799	622	112110	0	116450
23412	1080	1515	112619	2118	0	117332
23413	805	117077	1748	1996	0	121626
23414	113443	1721	1478	994	0	117636
23415	1861	117560	633	954	0	121008
23416	114062	1563	555	747	0	116927
23417	1995	1435	113515	679	0	117624
23418	111122	601	1510	763	0	113996
23419	115986	515	1338	716	0	118555
23420	2822	683	119069	731	0	123305
23421	1823	945	1672	110657	0	115097
23422	899	119188	1478	1822	0	123387
23423	807	122074	581	1682	0	125144
23424	781	122736	598	824	0	124939
23425	1088	2869	550	117149	0	121656
23426	943	1580	119375	1668	0	123566
23427	803	702	1444	117387	0	120336
23428	851	571	1248	120295	0	122965
23429	910	615	119822	2628	0	123975
23430	724	119720	1597	1845	0	123886
23431	758	1560	1346	118031	0	121695
23432	118695	1390	521	1785	0	122391
23433	1671	593	497	119308	0	122069
23434	1569	574	448	117423	0	120014
23435	741	118531	452	2741	0	122465
23436	118269	1589	425	1681	0	121964
23437	1840	1480	405	122022	0	125747
23438	1664	633	121420	1803	0	125520
23439	692	120202	1454	1731	0	124079
23440	115871	1409	1323	713	0	119316
23441	1550	1371	117683	625	0	121229
23442	112639	579	1405	645	0	115268
23443	1535	607	1291	113479	0	116912
23444	1200	117675	731	1414	0	121020
23445	115660	1360	512	1364	0	118896
23446	114134	1214	486	772	0	116606
23447	2036	120365	572	687	0	123660
23448	1271	1279	419	115883	0	118852
23449	435	976	316	111964	0	113691
23450	108354	352	377	1835	0	110918
23451	1035	110292	417	1330	0	113074
23452	832	1091	229	102120	0	104272
23453	221	102344	290	914	0	103769
23454	240	101315	283	794	0	102632
23455	408	1193	316	98708	0	100625
23456	97971	613	245	749	0	99578
23457	555	100536	224	751	0	102066
23458	664	658	175	100311	0	101808
23459	230	611	160	101082	0	102083
23460	300	298	101442	1074	0	103114
23461	307	293	98687	671	0	99958
23462	226	101754	1010	400	0	103390
23463	331	714	99997	282	0	101324
23464	280	681	599	98639	0	100199
23465	302	308	104449	660	0	105719
23466	224	261	561	102198	0	103244
23467	251	249	504	105057	0	106061
23468	221	246	145	105950	0	106562
23469	104087	219	174	1187	0	105667
23470	644	253	147	104650	0	105694
23471	640	243	151	103869	0	104903
23472	198	104859	197	1156	0	106410
23473	292	687	164	103803	0	104946
23474	105182	673	155	910	0	106920
23475	599	109498	225	793	0	111115
23476	110113	695	210	496	0	111514
23477	781	749	110629	419	0	112578
23478	737	449	113626	366	0	115178
23479	308	329	1052	115147	0	116836
23480	275	310	658	117495	0	118738
23481	266	119526	304	1338	0	121434
23482	284	845	269	117882	0	119280
23483	118180	719	243	979	0	120121
23484	117239	317	237	884	0	118677
23485	1236	323	271	120591	0	122421
23486	853	406	130438	971	0	132668
23487	329	284	772	131530	0	132915
23488	334	314	784	136651	0	138083
23489	324	333	264	138653	0	139574
23490	240	329	256	137846	0	138671
23491	266	358	215	135204	0	136043
23492	225	137288	313	1741	0	139567
23493	134899	913	221	1165	0	137198
23494	136812	846	271	606	0	138535
23495	137385	333	247	651	0	138616
23496	1441	141326	353	685	0	143805
23497	138918	922	226	632	0	140698
23498	884	141157	352	687	0	143080
23499	1088	1092	139126	586	0	141892
23500	409	1027	938	133765	0	136139
23501	518	474	141904	1222	0	144118
23502	343	142678	998	1329	0	145348
23503	140288	973	942	681	0	142884
23504	1078	1093	145340	607	0	148118
23505	1174	464	154133	636	0	156407
23506	384	159711	2033	783	0	162911
23507	512	1240	1203	161351	0	164306
23508	552	1306	175013	1635	0	178506
23509	466	476	1396	171905	0	174243
23510	455	330	1233	190967	0	192985
23511	505	288	379	203200	0	204372
23512	211632	285	278	3240	0	215435
23513	210408	225	280	1983	0	212896
23514	3401	369	261	210418	0	214449
23515	211799	246	450	2317	0	214812
23516	2354	313	211051	2045	0	215763
23517	1906	312	210048	624	0	212890
23518	782	307	214970	608	0	216667
23519	623	347	217952	709	0	219631
23520	416	213441	3430	917	0	218204
23521	979	1938	1946	206225	0	211088
23522	696	1570	216605	2092	0	220963
23523	197707	322	2180	1828	0	202037
23524	212061	219	1748	710	0	214738
23525	3169	215508	870	1308	0	220855
23526	215269	1786	758	496	0	218309
23527	2188	1461	848	214724	0	219221
23528	1936	592	221775	2033	0	226336
23529	765	438	2409	203802	0	207414
23530	420	225122	2114	2039	0	229695
23531	221022	1984	764	1772	0	225542
23532	220072	1596	651	765	0	223084
23533	3302	225410	671	780	0	230163
23534	226601	2025	522	782	0	229930
23535	221197	1711	522	699	0	224129
23536	3641	226768	606	752	0	231767
23537	2275	2127	472	215726	0	220600
23538	825	223686	647	2215	0	227373
23539	223288	2250	540	1892	0	227970
23540	2457	2171	584	221360	0	226572
23541	222568	687	741	2291	0	226287
23542	2708	596	497	222767	0	226568
23543	2290	915	220959	2331	0	226495
23544	211547	615	2170	2021	0	216353
23545	2845	735	222523	866	0	226969
23546	2417	689	2324	216923	0	222353
23547	1256	711	219860	2454	0	224281
23548	1090	709	2330	216954	0	221083
23549	1145	769	220140	2688	0	224742
23550	205561	515	2535	2345	0	210956
23551	2514	218659	2178	1196	0	224547
23552	218156	2040	905	1003	0	222104
23553	2716	1776	876	216433	0	221801
23554	211113	631	847	2563	0	215154
23555	2524	217284	1048	2496	0	223352
23556	2135	217417	1091	1239	0	221882
23557	1092	225414	1061	1018	0	228585
23558	224310	3544	877	1087	0	229818
23559	2624	2013	830	223464	0	228931
23560	2335	871	730	226923	0	230859
23561	1308	1068	224103	3859	0	230338
23562	1450	954	223231	2296	0	227931
23563	1286	903	3517	221846	0	227552
23564	1394	997	229951	2761	0	235103
23565	998	228516	2668	2620	0	234802
23566	224937	2526	2527	1225	0	231215
23567	2944	2306	229684	1058	0	235992
23568	2663	1142	229780	1073	0	234658
23569	1327	813	4033	220540	0	226713
23570	230067	638	2631	2896	0	236232
23571	2754	601	1383	231141	0	235879
23572	230325	494	1395	3066	0	235280
23573	2836	695	1291	232958	0	237780
23574	2566	872	237677	2803	0	243918
23575	1204	234612	3215	2678	0	241709
23576	1416	2605	239261	1422	0	244704
23577	1085	240111	3261	1293	0	245750
23578	1277	2994	2646	232645	0	239562
23579	230904	1932	1262	2833	0	236931
23580	3052	985	234311	2434	0	240782
23581	2576	749	2667	229942	0	235934
23582	1619	767	2164	237582	0	242132
23583	240366	675	1064	4207	0	246312
23584	2833	875	1150	234163	0	239021
23585	2245	244404	1346	2993	0	250988
23586	233842	2493	1270	2415	0	240020
23587	2815	2335	234022	1205	0	240377
23588	220071	997	2569	1199	0	224836
23589	2843	236556	2235	1220	0	242854
23590	2671	2859	1033	221599	0	228162
23591	1291	239893	993	2645	0	244822
23592	235972	2512	936	2238	0	241658
23593	3092	2266	240712	1278	0	247348
23594	231750	1207	2370	1355	0	236682
23595	2816	246436	2030	1291	0	252573
23596	2485	2427	839	245542	0	251293
23597	248831	1957	864	2689	0	254341
23598	250243	959	878	2230	0	254310
23599	4075	886	777	250373	0	256111
23600	2488	1076	784	250004	0	254352
23601	1268	253408	957	4040	0	259673
23602	1327	2902	809	249308	0	254346
23603	1150	286377	1120	3027	0	291674
23604	1148	298406	1063	2654	0	303271
23605	1291	6835	1021	266255	0	275402
23606	1112	279822	1053	3367	0	285354
23607	1712	2909	288572	2285	0	295478
23608	2514	2299	292249	1187	0	298249
23609	982	287376	4940	2608	0	295906
23610	1349	2760	289653	936	0	294698
23611	1015	2120	286436	689	0	290260
23612	762	696	271185	530	0	273173
23613	253	267351	4165	785	0	272554
23614	254718	2945	2915	538	0	261116
23615	2005	260026	780	715	0	263526
23616	1910	2592	261925	332	0	266759
23617	517	1726	2404	253071	0	257718
23618	254852	474	1784	2414	0	259524
23619	2336	538	259689	1666	0	264229
23620	1706	288	2505	251012	0	255511
23621	616	535	263039	2276	0	266466
23622	453	323	2726	254650	0	258152
23623	252568	340	1990	2641	0	257539
23624	2520	474	260839	1846	0	265679
23625	1651	262523	2804	823	0	267801
23626	641	2634	1943	250894	0	256112
23627	259889	1864	743	2410	0	264906
23628	2622	780	261284	1723	0	266409
23629	2123	838	2821	228161	0	233943
23630	533	259379	2292	2291	0	264495
23631	257655	2532	839	1738	0	262764
23632	260109	1887	757	746	0	263499
23633	4164	766	645	249431	0	255006
23634	2163	264918	845	2604	0	270530
23635	697	271267	720	2319	0	275003
23636	269873	4300	661	764	0	275598
23637	2999	2559	658	258384	0	264600
23638	2152	271592	890	2918	0	277552
23639	265485	3065	734	2302	0	271586
23640	2967	2220	646	271730	0	277563
23641	2266	812	678	274459	0	278215
23642	1001	827	263081	4753	0	269662
23643	563	271289	2918	3015	0	277785
23644	792	276887	2427	1239	0	281345
23645	759	4701	852	270862	0	277174
23646	270645	2446	653	3142	0	276886
23647	2884	274023	788	2629	0	280324
23648	270646	3189	630	954	0	275419
23649	3212	273479	814	904	0	278409
23650	2453	3423	594	268854	0	275324
23651	270325	2602	544	3072	0	276543
23652	3269	1150	583	271025	0	276027
23653	2601	1247	270579	3374	0	277801
23654	1133	1020	3134	253173	0	258460
23655	790	268095	2612	3270	0	274767
23656	261367	3436	983	2505	0	268291
23657	2979	264197	1039	1239	0	269454
23658	2547	3659	875	249831	0	256912
23659	1226	2737	846	258667	0	263476
23660	1079	1354	255123	4900	0	262456
23661	1078	1383	255421	2868	0	260750
23662	1012	11411	4991	239199	0	256613
23663	1526	1536	252860	3362	0	259284
23664	794	248794	3675	2800	0	256063
23665	244730	3486	2744	1344	0	252304
23666	3454	2930	248502	1064	0	255950
23667	239141	1571	3534	1227	0	245473
23668	247291	1343	2852	1179	0	252665
23669	247381	1263	1527	1148	0	251319
23670	247372	1434	1351	1078	0	251235
23671	5141	1473	1441	240232	0	248287
23672	2999	1335	1467	234721	0	240522
23673	1224	241198	1793	4924	0	249139
23674	231622	3523	1954	2953	0	240052
23675	3569	3072	231733	1425	0	239799
23676	2881	1576	4074	222934	0	231465
23677	1493	1457	3493	226080	0	232523
23678	1353	1393	225526	5126	0	233398
23679	1319	224737	4250	3315	0	233621
23680	1719	3648	3351	213892	0	222610
23681	1720	2862	1794	225984	0	232360
23682	218781	1687	1472	5212	0	227152
23683	3593	219359	1445	3740	0	228137
23684	3338	3442	1212	211705	0	219697
23685	1722	214553	1526	3884	0	221685
23686	1646	3527	1426	215327	0	221926
23687	211224	2741	1179	4195	0	219339
23688	213259	1427	1307	3252	0	219245
23689	5444	1250	1199	207788	0	215681
23690	205922	1212	1121	4181	0	212436
23691	203814	1327	1187	3257	0	209585
23692	5187	204088	1094	2052	0	212421
23693	3620	3672	847	190439	0	198578
23694	1945	197933	1147	3542	0	204567
23695	1812	3836	767	193873	0	200288
23696	189470	3005	720	3977	0	197172
23697	3929	1858	738	188976	0	195501
23698	3251	1677	680	190349	0	195957
23699	1883	1692	186107	5453	0	195135
23700	1816	180180	2720	3568	0	188284
23701	1771	184499	2075	1994	0	190339
23702	174223	4817	861	2278	0	182179
23703	3119	3274	489	134163	0	141045
23704	120564	1003	450	2357	0	124374
23705	2224	117573	444	2180	0	122421
23706	1679	109940	417	1185	0	113221
23707	841	110822	444	1112	0	113219
23708	88402	2528	2621	819	0	94370
23709	1152	87820	536	712	0	90220
23710	79219	1175	1694	664	0	82752
23711	75852	610	313	445	0	77220
23712	77921	264	155	400	0	78740
23713	1254	295	135	82327	0	84011
23714	726	263	123	85053	0	86165
23715	378	195	156	85972	0	86701
23716	328	252	140	86300	0	87020
23717	84322	203	151	1578	0	86254
23718	936	84402	230	919	0	86487
23719	775	839	124	83820	0	85558
23720	84849	625	148	1070	0	86692
23721	1004	221	137	84086	0	85448
23722	780	230	131	84849	0	85990
23723	83259	201	161	1500	0	85121
23724	1002	300	83055	823	0	85180
23725	734	216	728	81518	0	83196
23726	372	265	83759	1007	0	85403
23727	346	190	779	81068	0	82383
23728	319	323	557	81542	0	82741
23729	78899	158	166	1378	0	80601
23730	824	78865	211	854	0	80754
23731	596	77817	155	381	0	78949
23732	73829	953	120	326	0	75228
23733	692	76445	173	336	0	77646
23734	75571	593	247	385	0	76796
23735	906	448	74451	237	0	76042
23736	67812	149	506	201	0	68668
23737	69510	74	285	175	0	70044
23738	69855	62	87	195	0	70199
23739	713	67	43	68531	0	69354
23740	373	72	54	68604	0	69103
23741	123	69210	90	728	0	70151
23742	143	764	47	68908	0	69862
23743	68012	278	61	539	0	68890
23744	422	70210	95	402	0	71129
23745	275	70125	102	196	0	70698
23746	68366	562	56	167	0	69151
23747	466	373	69546	122	0	70507
23748	341	117	361	67509	0	68328
23749	164	168	70769	477	0	71578
23750	133	80	374	68108	0	68695
23751	88	71516	299	427	0	72330
23752	117	429	42	72262	0	72850
23753	71259	247	57	453	0	72016
23754	432	62	45	71594	0	72133
23755	330	173	74745	507	0	75755
23756	66639	86	465	448	0	67638
23757	497	77669	346	235	0	78747
23758	353	82507	136	230	0	83226
23759	85005	764	60	233	0	86062
23760	90854	391	73	224	0	91542
23761	1174	198	92833	152	0	94357
23762	87515	129	762	217	0	88623
23763	814	93463	534	217	0	95028
23764	94474	752	112	240	0	95578
23765	896	507	103	89634	0	91140
23766	553	90381	142	793	0	91869
23767	91152	774	49	593	0	92568
23768	992	635	92292	167	0	94086
23769	617	153	749	91279	0	92798
23770	94239	118	523	1001	0	95881
23771	948	201	94487	664	0	96300
23772	94010	133	825	318	0	95286
23773	951	117	520	94365	0	95953
23774	669	148	137	96191	0	97145
23775	326	256	97746	1384	0	99712
23776	283	114	827	96639	0	97863
23777	97627	117	539	1142	0	99425
23778	878	97564	252	863	0	99557
23779	97907	824	139	410	0	99280
23780	98187	578	120	366	0	99251
23781	1460	216	84	97389	0	99149
23782	827	395	100048	1014	0	102284
23783	380	175	847	99295	0	100697
23784	100438	137	604	1108	0	102287
23785	981	100959	260	857	0	103057
23786	102703	851	168	393	0	104115
23787	1110	591	141	102152	0	103994
23788	794	187	155	104253	0	105389
23789	403	168	177	105476	0	106224
23790	345	250	104110	1610	0	106315
23791	374	149	923	104730	0	106176
23792	360	268	106424	1192	0	108244
23793	423	319	106856	794	0	108392
23794	383	207	1462	114280	0	116332
23795	412	313	116842	1295	0	118862
23796	119527	233	1329	1120	0	122209
23797	1580	192	904	128853	0	131529
23798	1338	224	352	125523	0	127437
23799	445	132456	351	2502	0	135754
23800	132859	1457	271	1336	0	135923
23801	138096	1150	215	682	0	140143
23802	2588	143010	309	620	0	146527
23803	1491	1539	185	142998	0	146213
23804	688	1282	144742	1705	0	148417
23805	136985	368	1555	1448	0	140356
23806	146230	255	1241	627	0	148353
23807	2780	376	375	141381	0	144912
23808	1604	364	140069	1754	0	143791
23809	594	139350	1713	1660	0	143317
23810	136210	1512	1315	610	0	139647
23811	2026	1300	138727	519	0	142572
23812	1313	137246	1715	612	0	140886
23813	130714	1354	1556	393	0	134017
23814	131028	1090	368	394	0	132880
23815	2393	332	294	127792	0	130811
23816	1354	133355	384	1404	0	136497
23817	605	1544	215	138032	0	140396
23818	520	1118	264	139143	0	141045
23819	447	360	261	138885	0	139953
23820	462	295	225	139990	0	140972
23821	540	357	138259	2750	0	141906
23822	537	232	1438	138541	0	140748
23823	488	283	1158	140724	0	142653
23824	575	372	139908	2641	0	143496
23825	398	140076	1593	1816	0	143883
23826	139207	1455	1306	754	0	142722
23827	139747	1191	440	696	0	142074
23828	2597	398	329	140404	0	143728
23829	141118	248	395	1817	0	143578
23830	1878	336	337	142872	0	145423
23831	1557	357	145917	2041	0	149872
23832	894	398	145758	1657	0	148707
23833	471	144845	2741	993	0	149050
23834	142371	1532	1461	803	0	146167
23835	1999	1409	153450	707	0	157565
23836	1655	475	2001	139038	0	143169
23837	837	334	1616	157960	0	160747
23838	644	294	627	162558	0	164123
23839	639	319	477	163071	0	164506
23840	636	332	515	163396	0	164879
23841	658	441	159836	4139	0	165074
23842	734	309	2128	159812	0	162983
23843	157881	340	1801	2882	0	162904
23844	2262	158635	747	2695	0	164339
23845	157389	2070	560	1171	0	161190
23846	2359	160082	689	1008	0	164138
23847	159130	2369	499	919	0	162917
23848	162411	1789	477	862	0	165539
23849	3914	656	519	159134	0	164223
23850	2417	479	441	161727	0	165064
23851	158490	419	460	4055	0	163424
23852	155802	427	513	2560	0	159302
23853	157691	417	450	1318	0	159876
23854	3768	155471	671	1323	0	161233
23855	2072	154951	738	1341	0	159102
23856	1178	3361	152483	961	0	157983
23857	937	2286	2106	146932	0	152261
23858	864	813	149231	2648	0	153556
23859	681	144563	2296	2462	0	150002
23860	847	2012	1789	136147	0	140795
23861	711	1562	556	136869	0	139698
23862	685	557	445	139950	0	141637
23863	136348	423	441	3492	0	140704
23864	135351	450	406	2330	0	138537
23865	3155	137470	512	1293	0	142430
23866	2111	1733	444	136957	0	141245
23867	1049	1671	137697	2237	0	142654
23868	915	753	134627	1921	0	138216
23869	132565	582	2995	1027	0	137169
23870	135732	517	1841	978	0	139068
23871	3284	444	726	134311	0	138765
23872	136482	359	672	2372	0	139885
23873	2347	499	134649	2173	0	139668
23874	1960	134156	1942	1419	0	139477
23875	1002	1826	1692	132390	0	136910
23876	879	1681	136446	2487	0	141493
23877	842	605	1927	135696	0	139070
23878	835	488	1749	137413	0	140485
23879	762	629	138769	3640	0	143800
23880	127164	470	1937	2786	0	132357
23881	138736	430	1774	1512	0	142452
23882	3120	144176	892	1473	0	149661
23883	146629	1923	604	1285	0	150441
23884	148495	1685	607	1179	0	151966
23885	3959	777	148717	1218	0	154671
23886	142396	551	2121	1223	0	146291
23887	2822	153831	1984	1217	0	159854
23888	154511	2243	743	1068	0	158565
23889	158145	1832	602	909	0	161488
23890	161566	768	656	945	0	163935
23891	157167	592	543	959	0	159261
23892	158053	615	523	1030	0	160221
23893	4507	156077	750	1227	0	162561
23894	145219	2046	574	853	0	148692
23895	2712	145293	543	866	0	149414
23896	1699	130952	473	774	0	133898
23897	847	135138	538	743	0	137266
23898	131366	2817	1640	716	0	136539
23899	130760	1465	523	563	0	133311
23900	3082	594	130143	574	0	134393
23901	129083	473	1758	612	0	131926
23902	129268	408	1339	587	0	131602
23903	3302	511	129931	550	0	134294
23904	1929	361	1916	125554	0	129760
23905	1011	360	1390	127717	0	130478
23906	831	414	481	131554	0	133280
23907	887	413	329	132517	0	134146
23908	851	347	320	132093	0	133611
23909	805	429	128738	3422	0	133394
23910	773	128334	1973	1966	0	133046
23911	124788	1926	1378	719	0	128811
23912	2255	127252	560	708	0	130775
23913	127253	2105	431	503	0	130292
23914	126086	1452	399	483	0	128420
23915	3570	635	123557	496	0	128258
23916	2184	828	1921	107377	0	112310
23917	908	118975	1528	1787	0	123198
23918	118814	1896	598	1393	0	122701
23919	119057	1339	431	748	0	121575
23920	119654	542	461	602	0	121259
23921	3294	119743	428	678	0	124143
23922	120144	1842	373	534	0	122893
23923	120502	1371	365	498	0	122736
23924	120578	538	314	488	0	121918
23925	3590	452	370	115953	0	120365
23926	2049	436	353	117950	0	120788
23927	1226	420	323	119668	0	121637
23928	116235	465	312	2975	0	119987
23929	2365	117161	420	1642	0	121588
23930	116478	1754	279	606	0	119117
23931	113546	1312	341	424	0	115623
23932	111961	502	302	383	0	113148
23933	110227	460	305	360	0	111352
23934	3481	107927	329	477	0	112214
23935	97062	1521	217	252	0	99052
23936	2149	96835	221	358	0	99563
23937	1244	92721	159	351	0	94475
23938	91246	1772	319	305	0	93642
23939	1575	90611	182	296	0	92664
23940	1227	92515	177	305	0	94224
23941	92341	1835	416	253	0	94845
23942	92501	1032	138	229	0	93900
23943	2174	547	119	89315	0	92155
23944	1437	393	117	91631	0	93578
23945	92994	381	139	1805	0	95319
23946	95451	374	173	972	0	96970
23947	95095	349	202	445	0	96091
23948	2379	523	91757	284	0	94943
23949	94799	386	1142	403	0	96730
23950	1870	406	755	94687	0	97718
23951	1405	363	318	95915	0	98001
23952	922	382	233	96821	0	98358
23953	779	395	224	97515	0	98913
23954	841	417	94389	2086	0	97733
23955	829	467	95245	1115	0	97656
23956	827	370	1722	94836	0	97755
23957	793	471	95841	1481	0	98586
23958	866	473	95951	1037	0	98327
23959	935	437	1772	93338	0	96482
23960	897	406	966	97950	0	100219
23961	885	412	428	100068	0	101793
23962	856	458	317	100571	0	102202
23963	99862	395	300	2254	0	102811
23964	104268	397	350	1384	0	106399
23965	2459	382	304	102650	0	105795
23966	1684	357	293	103269	0	105603
23967	1052	402	305	103289	0	105048
23968	967	329	296	103053	0	104645
23969	1011	351	286	101369	0	103017
23970	874	102013	404	2396	0	105687
23971	101027	1309	319	1424	0	104079
23972	1732	102844	344	1055	0	105975
23973	102713	1454	261	876	0	105304
23974	102910	1014	229	802	0	104955
23975	103389	564	205	740	0	104898
23976	2739	444	215	98007	0	101405
23977	98109	441	244	1611	0	100405
23978	2178	423	191	96325	0	99117
23979	1682	478	220	95551	0	97931
23980	95466	423	178	2081	0	98148
23981	1912	93977	212	1290	0	97391
23982	1259	89176	157	664	0	91256
23983	86832	1370	143	501	0	88846
23984	1541	823	86266	490	0	89120
23985	79486	467	970	509	0	81432
23986	1794	871	586	83023	0	86274
23987	1051	79833	207	1060	0	82151
23988	726	81095	162	821	0	82804
23989	81495	1136	267	592	0	83490
23990	1133	786	85	81227	0	83231
23991	756	86903	124	896	0	88679
23992	85435	646	222	632	0	86935
23993	84931	489	88	415	0	85923
23994	85448	265	48	356	0	86117
23995	85670	237	78	389	0	86374
23996	1135	83636	155	361	0	85287
23997	519	82375	106	289	0	83289
23998	83307	641	78	230	0	84256
23999	86036	367	114	198	0	86715
24000	917	213	86891	191	0	88212
24001	409	85807	433	164	0	86813
24002	86019	412	356	162	0	86949
24003	89475	292	74	139	0	89980
24004	805	168	90897	110	0	91980
24005	83340	116	529	179	0	84164
24006	647	121	94703	124	0	95595
24007	516	144	100524	79	0	101263
24008	226	168	970	90119	0	91483
24009	104	101482	557	633	0	102776
24010	105544	660	132	539	0	106875
24011	755	492	65	106325	0	107637
24012	580	118	56	107116	0	107870
24013	184	98	59	108563	0	108904
24014	107904	47	54	1315	0	109320
24015	741	85	84	107978	0	108888
24016	626	60	63	112284	0	113033
24017	227	147	113270	1236	0	114880
24018	107553	88	761	823	0	109225
24019	114913	62	573	251	0	115799
24020	1584	182	116905	173	0	118844
24021	111134	80	925	190	0	112329
24022	1076	116	635	112279	0	114106
24023	761	115976	219	941	0	117897
24024	305	953	86	116554	0	117898
24025	113730	643	110	1095	0	115578
24026	935	116800	196	902	0	118833
24027	822	1012	109	117657	0	119600
24028	328	670	115	120085	0	121198
24029	253	152	121	121397	0	121923
24030	312	160	121	114203	0	114796
24031	243	122762	220	1650	0	124875
24032	122534	1013	123	885	0	124555
24033	123090	781	133	367	0	124371
24034	1811	127449	218	405	0	129883
24035	135787	1147	99	327	0	137360
24036	138120	829	124	321	0	139394
24037	136943	208	127	345	0	137623
24038	2585	211	135206	263	0	138265
24039	1329	188	1402	132593	0	135512
24040	506	255	134540	1527	0	136828
24041	127904	146	1546	1216	0	130812
24042	1560	134392	1104	551	0	137607
24043	131019	1459	288	327	0	133093
24044	1651	135348	262	346	0	137607
24045	1278	1531	198	128565	0	131572
24046	604	1021	215	131726	0	133566
24047	497	437	132147	2352	0	135433
24048	378	132610	1594	1577	0	136159
24049	129978	1511	1253	455	0	133197
24050	1853	1211	130823	374	0	134261
24051	127796	410	1564	363	0	130133
24052	1868	328	1124	130317	0	133637
24053	1519	420	131151	1809	0	134899
24054	591	130887	1691	1624	0	134793
24055	521	1601	1127	129784	0	133033
24056	590	1249	131562	1723	0	135124
24057	678	489	131301	1353	0	133821
24058	607	129626	2555	764	0	133552
24059	777	1601	1383	125304	0	129065
24060	758	1207	459	119980	0	122404
24061	557	126434	444	2573	0	130008
24062	125233	1584	441	1357	0	128615
24063	1941	1277	412	121091	0	124721
24064	1475	123033	499	1748	0	126755
24065	122920	1661	437	1450	0	126468
24066	121464	1255	493	654	0	123866
24067	124120	510	431	618	0	125679
24068	2837	123251	474	782	0	127344
24069	124720	1698	423	748	0	127589
24070	123966	1338	433	745	0	126482
24071	2898	598	350	121648	0	125494
24072	123210	457	319	2096	0	126082
24073	2182	504	287	122877	0	125850
24074	1793	518	121702	2145	0	126158
24075	1040	417	122946	1633	0	126036
24076	841	411	2657	121690	0	125599
24077	827	505	123962	2140	0	127434
24078	115495	421	1902	1723	0	119541
24079	2281	458	1377	122216	0	126332
24080	1855	404	554	123619	0	126432
24081	1038	561	121830	3049	0	126478
24082	805	119095	1906	1936	0	123742
24083	831	122796	1465	933	0	126025
24084	822	2718	546	116529	0	120615
24085	793	1460	420	118255	0	120928
24086	795	669	115602	2932	0	119998
24087	804	612	116898	1675	0	119989
24088	801	529	2632	115161	0	119123
24089	808	526	112792	2178	0	116304
24090	105501	558	1866	1616	0	109541
24091	2197	579	1280	107585	0	111641
24092	108583	535	493	2095	0	111706
24093	2196	524	453	107904	0	111077
24094	1735	512	478	109290	0	112015
24095	959	590	107413	2937	0	111899
24096	754	107580	1987	1882	0	112203
24097	875	1835	1417	106244	0	110371
24098	783	1376	106150	2009	0	110318
24099	691	100907	1864	1505	0	104967
24100	734	1591	1481	100896	0	104702
24101	100886	1212	622	1861	0	104581
24102	1881	513	102069	1431	0	105894
24103	92996	285	1738	712	0	95731
24104	1891	389	96425	516	0	99221
24105	85069	300	1838	550	0	87757
24106	1486	89718	1314	638	0	93156
24107	987	83977	489	504	0	85957
24108	593	2614	518	77265	0	80990
24109	310	81136	431	1264	0	83141
24110	77618	1276	405	1007	0	80306
24111	1276	861	399	77796	0	80332
24112	986	343	321	78663	0	80313
24113	353	263	305	79721	0	80642
24114	323	278	77076	2023	0	79700
24115	300	337	1253	76082	0	77972
24116	437	305	75063	1417	0	77222
24117	245	72030	1399	1086	0	74760
24118	65227	932	819	386	0	67364
24119	1001	68425	354	345	0	70125
24120	69003	927	321	381	0	70632
24121	69190	694	219	404	0	70507
24122	69519	232	223	376	0	70350
24123	68778	208	269	329	0	69584
24124	1586	203	66948	381	0	69118
24125	832	223	1015	65654	0	67724
24126	336	257	767	66301	0	67661
24127	302	195	315	67189	0	68001
24128	61609	247	267	1579	0	63702
24129	61983	193	235	923	0	63334
24130	1462	64379	258	626	0	66725
24131	893	772	61556	282	0	63503
24132	416	597	61152	283	0	62448
24133	255	60106	1329	366	0	62056
24134	237	58444	761	309	0	59751
24135	1371	1052	1281	45959	0	49663
24136	187	388	111	45627	0	46313
24137	46137	112	101	677	0	47027
24138	413	46423	125	482	0	47443
24139	395	373	92	47593	0	48453
24140	195	363	49127	462	0	50147
24141	164	99	418	50975	0	51656
24142	119	86	380	52049	0	52634
24143	142	81	116	52634	0	52973
24144	132	79	110	52065	0	52386
24145	178	105	50843	825	0	51951
24146	123	49941	457	555	0	51076
24147	115	50314	420	166	0	51015
24148	47479	681	169	149	0	48478
24149	421	49076	128	152	0	49777
24150	397	50645	131	165	0	51338
24151	200	707	138	49568	0	50613
24152	146	413	94	50426	0	51079
24153	140	123	162	50518	0	50943
24154	174	165	50173	756	0	51268
24155	101	50127	401	547	0	51176
24156	184	428	342	47486	0	48440
24157	109	50226	122	452	0	50909
24158	49208	394	102	457	0	50161
24159	376	49895	143	259	0	50673
24160	49419	392	127	231	0	50169
24161	411	396	49340	209	0	50356
24162	48254	143	411	230	0	49038
24163	384	166	363	49430	0	50343
24164	394	182	50083	474	0	51133
24165	47973	185	379	413	0	48950
24166	49604	183	333	176	0	50296
24167	49817	154	107	169	0	50247
24168	706	148	108	48907	0	49869
24169	455	148	49474	475	0	50552
24170	47001	131	437	488	0	48057
24171	444	119	352	50436	0	51351
24172	386	127	140	50516	0	51169
24173	208	173	51754	731	0	52866
24174	126	51828	398	510	0	52862
24175	194	510	341	48242	0	49287
24176	151	51841	108	398	0	52498
24177	50280	444	153	380	0	51257
24178	50442	358	101	177	0	51078
24179	648	120	99	50419	0	51286
24180	50369	101	135	442	0	51047
24181	388	50628	129	446	0	51591
24182	50113	361	115	198	0	50787
24183	421	51129	110	197	0	51857
24184	404	383	109	50483	0	51379
24185	221	363	104	49403	0	50091
24186	202	50927	123	611	0	51863
24187	181	482	104	50378	0	51145
24188	236	358	50174	464	0	51232
24189	151	49809	383	440	0	50783
24190	47287	286	290	212	0	48075
24191	314	48597	125	224	0	49260
24192	275	308	112	47909	0	48604
24193	222	331	48471	382	0	49406
24194	132	151	286	48535	0	49104
24195	147	100	259	49186	0	49692
24196	47586	89	106	649	0	48430
24197	391	125	48970	372	0	49858
24198	354	49254	314	319	0	50241
24199	166	381	51643	153	0	52343
24200	191	325	49835	121	0	50472
24201	192	151	48681	100	0	49124
24202	430	771	677	44163	0	46041
24203	47114	54	455	352	0	47975
24204	263	47795	87	412	0	48557
24205	48636	318	32	135	0	49121
24206	50331	321	48	151	0	50851
24207	577	89	43	49296	0	50005
24208	325	51223	77	337	0	51962
24209	50265	328	34	343	0	50970
24210	267	51988	62	165	0	52482
24211	315	347	52	51481	0	52195
24212	84	318	53	53857	0	54312
24213	57	54483	86	637	0	55263
24214	91	318	53	54972	0	55434
24215	124	362	53819	363	0	54668
24216	123	153	54119	321	0	54716
24217	98	93	582	53955	0	54728
24218	74	81	352	55119	0	55626
24219	133	99	53633	615	0	54480
24220	115	93	52626	413	0	53247
24221	46712	90	641	176	0	47619
24222	322	52540	377	154	0	53393
24223	371	55912	144	205	0	56632
24224	141	663	89	53673	0	54566
24225	114	356	62	54211	0	54743
24226	109	111	63	55394	0	55677
24227	157	108	54922	611	0	55798
24228	146	126	54179	355	0	54806
24229	147	67	590	55253	0	56057
24230	143	143	56220	397	0	56903
24231	87	55634	383	568	0	56672
24232	54955	337	483	198	0	55973
24233	425	391	55373	121	0	56310
24234	417	151	55230	129	0	55927
24235	128	137	645	54535	0	55445
24236	144	106	61388	478	0	62116
24237	75	62495	499	641	0	63710
24238	140	495	463	63381	0	64479
24239	170	431	63590	518	0	64709
24240	72	62242	512	514	0	63340
24241	60435	435	516	151	0	61537
24242	466	423	157	60081	0	61127
24243	418	106	77	60628	0	61229
24244	60701	83	74	803	0	61661
24245	426	61117	119	556	0	62218
24246	61618	445	79	161	0	62303
24247	61449	436	95	130	0	62110
24248	61667	109	78	146	0	62000
24249	855	83	102	60256	0	61296
24250	59507	72	104	524	0	60207
24251	483	57999	142	522	0	59146
24252	427	59876	150	176	0	60629
24253	60128	827	125	155	0	61235
24254	541	487	106	61000	0	62134
24255	529	138	104	61514	0	62285
24256	169	104	100	62346	0	62719
24257	160	150	60452	1012	0	61774
24258	103	60743	542	638	0	62026
24259	140	541	477	62449	0	63607
24260	62292	484	141	619	0	63536
24261	560	129	119	62662	0	63470
24262	582	124	62554	688	0	63948
24263	159	62881	590	630	0	64260
24264	63395	539	543	223	0	64700
24265	63507	550	170	191	0	64418
24266	64168	176	123	179	0	64646
24267	1053	151	118	63569	0	64891
24268	699	126	64185	644	0	65654
24269	256	186	65525	648	0	66615
24270	170	67054	1093	313	0	68630
24271	232	610	631	66652	0	68125
24272	208	601	158	67922	0	68889
24273	65413	185	107	1211	0	66916
24274	681	166	109	66394	0	67350
24275	66935	123	152	791	0	68001
24276	812	179	65605	728	0	67324
24277	768	152	66732	285	0	67937
24278	289	127	1182	65296	0	66894
24279	268	136	716	66995	0	68115
24280	227	139	203	68761	0	69330
24281	69150	139	165	1329	0	70783
24282	71490	134	188	835	0	72647
24283	1408	371	153	71869	0	73801
24284	885	138	71532	946	0	73501
24285	269	178	72101	920	0	73468
24286	231	113	1495	71590	0	73429
24287	73660	137	939	945	0	75681
24288	926	150	250	73073	0	74399
24289	920	114	188	74264	0	75486
24290	318	148	74247	1577	0	76290
24291	261	157	73580	969	0	74967
24292	68794	146	1571	467	0	70978
24293	1009	165	74094	305	0	75573
24294	939	113	915	70328	0	72295
24295	405	126	810	71912	0	73253
24296	71896	75	277	1594	0	73842
24297	892	71253	278	1066	0	73489
24298	70272	768	265	400	0	71705
24299	884	68328	250	325	0	69787
24300	66871	776	244	307	0	68198
24301	942	675	65666	372	0	67655
24302	58870	248	1063	366	0	60547
24303	61750	105	705	291	0	62851
24304	1376	141	249	61730	0	63496
24305	867	139	62077	790	0	63873
24306	329	81	786	59382	0	60578
24307	233	82	706	59241	0	60262
24308	198	59539	278	1409	0	61424
24309	254	649	189	57548	0	58640
24310	251	59430	201	889	0	60771
24311	313	741	162	58812	0	60028
24312	57732	601	154	955	0	59442
24313	861	162	189	58096	0	59308
24314	813	143	57654	917	0	59527
24315	55334	114	796	863	0	57107
24316	933	141	58977	370	0	60421
24317	57582	107	842	371	0	58902
24318	58839	100	750	331	0	60020
24319	1399	58690	329	346	0	60764
24320	886	61026	296	313	0	62521
24321	60708	1300	249	288	0	62545
24322	61905	743	259	299	0	63206
24323	60351	210	204	331	0	61096
24324	60359	122	175	363	0	61019
24325	60372	113	198	346	0	61029
24326	1602	135	165	58981	0	60883
24327	978	146	221	60048	0	61393
24328	445	199	59603	1502	0	61749
24329	57326	129	850	928	0	59233
24330	1004	127	804	58160	0	60095
24331	938	120	304	58738	0	60100
24332	501	152	58334	1524	0	60511
24333	350	57106	889	1064	0	59409
24334	329	58297	890	441	0	59957
24335	56142	1314	481	434	0	58371
24336	51239	685	233	353	0	52510
24337	1276	49518	211	305	0	51310
24338	747	49197	221	227	0	50392
24339	48683	1042	232	254	0	50211
24340	49948	606	159	300	0	51013
24341	1205	148	152	49115	0	50620
24342	807	108	138	49576	0	50629
24343	340	121	149	51029	0	51639
24344	49944	116	127	1275	0	51462
24345	50076	131	138	811	0	51156
24346	1307	116	157	50519	0	52099
24347	51880	109	183	810	0	52982
24348	938	134	52123	723	0	53918
24349	833	127	704	51995	0	53659
24350	399	221	52348	845	0	53813
24351	272	51600	814	821	0	53507
24352	388	776	726	50878	0	52768
24353	50420	594	243	780	0	52037
24354	828	186	170	50396	0	51580
24355	817	118	141	50240	0	51316
24356	356	167	50142	1252	0	51917
24357	348	168	50096	794	0	51406
24358	334	50527	1173	380	0	52414
24359	49890	624	609	258	0	51381
24360	49990	563	209	229	0	50991
24361	50222	163	144	233	0	50762
24362	50132	122	163	236	0	50653
24363	1318	118	146	48800	0	50382
24364	824	147	137	46855	0	47963
24365	352	49111	153	1116	0	50732
24366	48480	636	167	687	0	49970
24367	48334	566	135	311	0	49346
24368	1221	203	46943	228	0	48595
24369	41655	119	565	181	0	42520
24370	749	43634	516	193	0	45092
24371	681	996	142	41165	0	42984
24372	293	43745	106	586	0	44730
24373	42600	669	147	568	0	43984
24374	651	43227	117	263	0	44258
24375	635	587	96	41742	0	43060
24376	295	441	79	42241	0	43056
24377	236	142	82	41148	0	41608
24378	222	40608	124	1071	0	42025
24379	266	767	95	40640	0	41768
24380	306	713	112	39099	0	40230
24381	180	36929	113	829	0	38051
24382	160	34897	104	459	0	35620
24383	32671	618	97	170	0	33556
24384	436	33368	70	182	0	34056
24385	31564	368	83	149	0	32164
24386	483	319	31286	146	0	32234
24387	345	31004	319	159	0	31827
24388	30800	339	291	142	0	31572
24389	30274	303	72	142	0	30791
24390	633	117	29950	130	0	30830
24391	392	101	296	29108	0	29897
24392	200	105	30244	376	0	30925
24393	117	29663	342	374	0	30496
24394	28812	327	325	180	0	29644
24395	367	28994	108	139	0	29608
24396	328	341	83	28284	0	29036
24397	172	295	61	28738	0	29266
24398	155	122	28652	522	0	29451
24399	154	121	28198	316	0	28789
24400	27041	79	514	173	0	27807
24401	28232	108	283	157	0	28780
24402	28502	83	78	167	0	28830
24403	28367	111	67	152	0	28697
24404	581	28431	109	154	0	29275
24405	388	318	70	28088	0	28864
24406	174	312	75	28012	0	28573
24407	151	29186	101	540	0	29978
24408	29447	322	93	345	0	30207
24409	29567	316	70	162	0	30115
24410	625	133	29529	140	0	30427
24411	29437	93	321	135	0	29986
24412	437	107	285	29434	0	30263
24413	367	154	29310	373	0	30204
24414	237	169	320	28852	0	29578
24415	168	120	29688	416	0	30392
24416	159	125	28424	291	0	28999
24417	195	355	474	26152	0	27176
24418	112	27367	279	295	0	28053
24419	27057	274	133	297	0	27761
24420	26096	262	74	139	0	26571
24421	455	28971	93	137	0	29656
24422	284	29387	93	134	0	29898
24423	30123	400	110	159	0	30792
24424	30245	259	80	110	0	30694
24425	30463	100	71	114	0	30748
24426	30542	86	70	101	0	30799
24427	513	137	51	31066	0	31767
24428	296	111	30962	273	0	31642
24429	139	31021	249	273	0	31682
24430	30275	285	257	118	0	30935
24431	279	32392	93	102	0	32866
24432	32147	269	44	104	0	32564
24433	31969	224	49	97	0	32339
24434	483	115	33650	92	0	34340
24435	292	35742	244	85	0	36363
24436	148	276	215	35770	0	36409
24437	111	242	82	36162	0	36597
24438	102	101	59	35796	0	36058
24439	35534	81	50	458	0	36123
24440	34190	89	59	268	0	34606
24441	34458	76	52	153	0	34739
24442	445	35120	82	124	0	35771
24443	34039	224	59	105	0	34427
24444	252	35284	69	136	0	35741
24445	298	261	35187	102	0	35848
24446	106	34997	218	91	0	35412
24447	212	385	398	32537	0	33532
24448	83	158	59	32326	0	32626
24449	82	94	32392	270	0	32838
24450	84	33	139	31483	0	31739
24451	70	58	143	32513	0	32784
24452	33250	46	44	285	0	33625
24453	32785	46	32	201	0	33064
24454	33501	54	46	66	0	33667
24455	320	34139	56	69	0	34584
24456	33823	162	31	74	0	34090
24457	32960	166	35	86	0	33247
24458	289	36040	56	94	0	36479
24459	212	176	46	35942	0	36376
24460	127	175	48	36299	0	36649
24461	36208	56	74	354	0	36692
24462	275	93	36205	208	0	36781
24463	204	35628	195	152	0	36179
24464	110	421	167	33619	0	34317
24465	64	35058	54	192	0	35368
24466	60	36020	53	201	0	36334
24467	35747	319	120	78	0	36264
24468	35617	193	30	69	0	35909
24469	342	69	42	36084	0	36537
24470	231	56	25	35921	0	36233
24471	91	49	44	36203	0	36387
24472	88	54	36	36091	0	36269
24473	115	85	35453	386	0	36039
24474	108	87	34618	202	0	35015
24475	92	52	306	35745	0	36195
24476	111	105	38477	224	0	38917
24477	81	38919	223	266	0	39489
24478	39333	202	195	81	0	39811
24479	39276	225	40	91	0	39632
24480	414	62	31	39980	0	40487
24481	264	52	48	40224	0	40588
24482	107	74	42	40341	0	40564
24483	89	41297	69	435	0	41890
24484	41253	244	50	277	0	41824
24485	40919	236	48	121	0	41324
24486	450	93	41437	106	0	42086
24487	296	58	226	42901	0	43481
24488	134	93	45073	308	0	45608
24489	121	55	272	47737	0	48185
24490	106	70	263	47899	0	48338
24491	106	69	42	48335	0	48552
24492	106	55	53	49067	0	49281
24493	48897	75	70	724	0	49766
24494	49377	84	58	438	0	49957
24495	50299	71	52	164	0	50586
24496	798	62	47	50068	0	50975
24497	488	85	49961	474	0	51008
24498	47863	64	399	447	0	48773
24499	466	77	373	50091	0	51007
24500	50380	60	112	480	0	51032
24501	494	68	66	50022	0	50650
24502	429	49899	92	565	0	50985
24503	163	51670	83	536	0	52452
24504	150	754	67	51586	0	52557
24505	174	421	72	51354	0	52021
24506	155	110	55	51319	0	51639
24507	109	51348	91	868	0	52416
24508	50120	421	64	538	0	51143
24509	476	51093	95	290	0	51954
24510	491	467	50967	191	0	52116
24511	182	428	448	49567	0	50625
24512	99	52424	439	568	0	53530
24513	141	458	118	51972	0	52689
24514	147	427	72	52338	0	52984
24515	146	140	52031	966	0	53283
24516	46857	73	464	666	0	48060
24517	511	53136	431	322	0	54400
24518	53404	458	112	260	0	54234
24519	53757	446	62	226	0	54491
24520	53918	122	79	235	0	54354
24521	1011	159	51008	206	0	52384
24522	558	141	501	49119	0	50319
24523	237	128	457	50095	0	50917
24524	187	143	49556	977	0	50863
24525	44047	131	507	728	0	45413
24526	573	150	49854	301	0	50878
24527	502	136	48195	269	0	49102
24528	139	48534	814	301	0	49788
24529	197	478	467	47606	0	48748
24530	207	454	48633	587	0	49881
24531	44627	139	468	545	0	45779
24532	46341	114	415	264	0	47134
24533	870	129	47104	205	0	48308
24534	516	105	488	45967	0	47076
24535	248	124	46960	555	0	47887
24536	175	46986	523	604	0	48288
24537	49904	473	473	319	0	51169
24538	50617	411	169	267	0	51464
24539	51424	148	131	268	0	51971
24540	983	123	166	50931	0	52203
24541	599	108	116	52070	0	52893
24542	258	154	51537	1032	0	52981
24543	49848	94	577	629	0	51148
24544	689	94	493	50866	0	52142
24545	50262	103	233	666	0	51264
24546	717	112	50387	614	0	51830
24547	564	132	51318	293	0	52307
24548	253	107	965	48893	0	50218
24549	201	101	560	51239	0	52101
24550	256	141	51272	1024	0	52693
24551	48335	117	663	642	0	49757
24552	700	202	560	46926	0	48388
24553	544	51919	282	631	0	53376
24554	51181	548	201	572	0	52502
24555	632	52447	232	325	0	53636
24556	52049	561	208	268	0	53086
24557	774	452	53107	259	0	54592
24558	631	160	50687	227	0	51705
24559	234	50932	937	298	0	52401
24560	50386	513	724	273	0	51896
24561	683	456	50367	259	0	51765
24562	48113	137	610	212	0	49072
24563	719	50101	518	261	0	51599
24564	610	523	235	50182	0	51550
24565	298	439	213	48235	0	49185
24566	203	51782	233	919	0	53137
24567	52740	504	214	577	0	54035
24568	53541	410	179	255	0	54385
24569	54483	156	204	249	0	55092
24570	1058	152	55099	221	0	56530
24571	588	124	668	54277	0	55657
24572	252	144	539	55211	0	56146
24573	247	137	274	56131	0	56789
24574	310	168	55782	1022	0	57282
24575	243	54643	679	730	0	56295
24576	52292	550	511	239	0	53592
24577	697	471	53431	186	0	54785
24578	50926	200	598	205	0	51929
24579	697	53103	525	209	0	54534
24580	53089	564	254	160	0	54067
24581	771	469	204	52269	0	53713
24582	53114	156	237	597	0	54104
24583	707	96	226	52987	0	54016
24584	514	173	54320	595	0	55602
24585	343	326	598	53433	0	54700
24586	272	135	53950	616	0	54973
24587	47515	118	585	465	0	48683
24588	546	51027	462	267	0	52302
24589	404	477	160	44271	0	45312
24590	173	49095	169	365	0	49802
24591	48836	344	211	273	0	49664
24592	48321	225	177	155	0	48878
24593	591	48825	144	158	0	49718
24594	48702	306	153	200	0	49361
24595	49236	209	160	169	0	49774
24596	527	75	122	48750	0	49474
24597	284	98	107	49422	0	49911
24598	51322	75	99	529	0	52025
24599	51811	83	140	271	0	52305
24600	627	72	113	51328	0	52140
24601	365	87	113	56025	0	56590
24602	57711	85	126	629	0	58551
24603	550	144	58022	326	0	59042
24604	54454	95	474	183	0	55206
24605	627	133	57371	132	0	58263
24606	364	56397	504	197	0	57462
24607	197	482	340	54780	0	55799
24608	283	324	58163	415	0	59185
24609	164	60784	506	359	0	61813
24610	59982	479	377	270	0	61108
24611	541	294	61211	109	0	62155
24612	58885	107	472	132	0	59596
24613	61391	78	279	135	0	61883
24614	61913	87	98	177	0	62275
24615	746	110	96	57297	0	58249
24616	378	63803	140	432	0	64753
24617	62947	407	99	307	0	63760
24618	524	302	63912	120	0	64858
24619	58218	96	457	166	0	58937
24620	546	126	63888	161	0	64721
24621	339	63859	478	254	0	64930
24622	207	423	271	63794	0	64695
24623	196	277	137	62754	0	63364
24624	147	64279	160	688	0	65274
24625	194	465	133	64611	0	65403
24626	211	341	64966	521	0	66039
24627	182	65393	554	354	0	66483
24628	186	503	300	63915	0	64904
24629	64051	318	106	479	0	64954
24630	65402	126	121	353	0	66002
24631	820	125	86	66430	0	67461
24632	438	69524	112	584	0	70658
24633	237	506	108	69059	0	69910
24634	229	380	97	68263	0	68969
24635	250	139	65896	845	0	67130
24636	198	66621	572	528	0	67919
24637	185	490	325	63710	0	64710
24638	175	368	63179	529	0	64251
24639	115	62485	480	470	0	63550
24640	152	511	310	61964	0	62937
24641	62530	298	125	490	0	63443
24642	477	64292	130	404	0	65303
24643	377	458	69	63998	0	64902
24644	65953	312	80	541	0	66886
24645	66142	97	75	393	0	66707
24646	66400	108	69	164	0	66741
24647	65712	104	76	169	0	66061
24648	767	85	93	65157	0	66102
24649	450	154	66823	507	0	67934
24650	210	192	469	63435	0	64306
24651	167	66636	381	494	0	67678
24652	67029	455	149	424	0	68057
24653	541	379	65492	157	0	66569
24654	62028	129	453	166	0	62776
24655	563	131	64766	186	0	65646
24656	486	119	462	63127	0	64194
24657	251	152	64883	455	0	65741
24658	198	101	463	63099	0	63861
24659	240	142	64401	541	0	65324
24660	214	104	466	62682	0	63466
24661	63970	85	338	548	0	64941
24662	513	67647	162	439	0	68761
24663	410	446	123	67599	0	68578
24664	217	359	111	67706	0	68393
24665	261	160	70133	763	0	71317
24666	226	156	68061	450	0	68893
24667	62598	119	781	246	0	63744
24668	511	67879	445	227	0	69062
24669	67358	411	164	160	0	68093
24670	68134	306	140	212	0	68792
24671	774	100	162	65352	0	66388
24672	414	69969	171	487	0	71041
24673	71206	476	191	447	0	72320
24674	72118	362	131	236	0	72847
24675	73851	124	147	211	0	74333
24676	73829	116	111	190	0	74246
24677	73314	110	131	180	0	73735
24678	888	164	71900	140	0	73092
24679	71196	104	497	180	0	71977
24680	642	146	73137	175	0	74100
24681	521	92	536	70754	0	71903
24682	253	127	412	74901	0	75693
24683	258	145	74545	816	0	75764
24684	71687	127	532	549	0	72895
24685	634	102	417	77288	0	78441
24686	527	106	157	78693	0	79483
24687	239	112	120	79445	0	79916
24688	199	141	143	79148	0	79631
24689	226	106	117	79949	0	80398
24690	240	187	79874	1109	0	81410
24691	202	114	602	78287	0	79205
24692	257	153	80538	743	0	81691
24693	231	150	79709	658	0	80748
24694	77443	111	1144	294	0	78992
24695	81724	84	626	264	0	82698
24696	85200	93	886	235	0	86414
24697	1462	141	89665	273	0	91541
24698	870	120	89761	202	0	90953
24699	352	129	90772	213	0	91466
24700	209	92336	1689	288	0	94522
24701	879	1539	1577	85831	0	89826
24702	89625	671	277	914	0	91487
24703	940	168	130	91635	0	92873
24704	814	95388	182	1106	0	97490
24705	95952	960	143	978	0	98033
24706	1089	850	139	94332	0	96410
24707	947	98135	185	1143	0	100410
24708	313	1005	178	98671	0	100167
24709	219	886	178	97740	0	99023
24710	95647	154	190	1950	0	97941
24711	1098	143	179	96706	0	98126
24712	1058	161	95823	1251	0	98293
24713	310	109	1108	92969	0	94496
24714	233	93740	1045	1251	0	96269
24715	305	95979	301	1193	0	97778
24716	273	1831	197	91799	0	94100
24717	238	1036	192	89159	0	90625
24718	224	91888	233	1920	0	94265
24719	221	92452	234	1150	0	94057
24720	241	93660	251	470	0	94622
24721	347	2100	200	83022	0	85669
24722	234	92747	207	1089	0	94277
24723	90252	1206	198	1020	0	92676
24724	1205	1069	92237	466	0	94977
24725	1076	391	1107	86088	0	88662
24726	272	92565	998	1230	0	95065
24727	90548	1146	240	1151	0	93085
24728	1327	1110	91580	478	0	94495
24729	999	91709	1172	536	0	94416
24730	87369	1145	1015	411	0	89940
24731	1051	88226	358	417	0	90052
24732	885	88447	292	455	0	90079
24733	485	2071	281	84579	0	87416
24734	260	88791	236	1237	0	90524
24735	86893	1254	195	1058	0	89400
24736	1108	1047	231	86484	0	88870
24737	1041	476	86596	1264	0	89377
24738	359	455	86772	1083	0	88669
24739	303	449	1754	85327	0	87833
24740	404	391	87877	1278	0	89950
24741	325	389	1162	86648	0	88524
24742	84559	324	956	1383	0	87222
24743	1187	376	85635	1180	0	88378
24744	1063	310	1113	81059	0	83545
24745	349	84014	1093	1159	0	86615
24746	344	1194	361	84489	0	86388
24747	328	1048	345	83351	0	85072
24748	309	85930	413	1947	0	88599
24749	351	1217	320	86359	0	88247
24750	327	1107	375	86668	0	88477
24751	337	543	85635	2082	0	88597
24752	246	85049	1178	1419	0	87892
24753	84003	1329	1058	688	0	87078
24754	1163	1127	407	85006	0	87703
24755	1063	634	86566	1517	0	89780
24756	436	513	1179	84945	0	87073
24757	426	491	86729	1615	0	89261
24758	79210	486	1321	1402	0	82419
24759	1253	86489	1166	744	0	89652
24760	1114	1321	500	85953	0	88888
24761	511	1223	426	88188	0	90348
24762	83809	575	466	2172	0	87022
24763	1273	542	404	85261	0	87480
24764	1201	602	84437	1613	0	87853
24765	521	585	1244	77972	0	80322
24766	392	80836	1173	1551	0	83952
24767	320	82724	537	1511	0	85092
24768	425	83808	471	907	0	85611
24769	437	2335	354	80548	0	83674
24770	462	1492	80098	1609	0	83661
24771	332	79421	1212	1443	0	82408
24772	76098	1512	1009	753	0	79372
24773	1063	79572	390	884	0	81909
24774	78663	1514	384	771	0	81332
24775	78461	1217	350	754	0	80782
24776	1877	685	77814	700	0	81076
24777	78667	653	1183	731	0	81234
24778	82305	589	1043	755	0	84692
24779	82692	580	404	719	0	84395
24780	82899	605	388	699	0	84591
24781	1974	684	83098	609	0	86365
24782	78678	539	1134	655	0	81006
24783	80982	622	1054	576	0	83234
24784	1707	82582	451	565	0	85305
24785	1040	1289	270	78861	0	81460
24786	479	1156	322	78520	0	80477
24787	405	80836	363	1739	0	83343
24788	78536	1215	329	1049	0	81129
24789	1087	80199	448	514	0	82248
24790	77444	1144	394	398	0	79380
24791	77403	966	295	431	0	79095
24792	1601	78899	367	486	0	81353
24793	1019	1031	317	78129	0	80496
24794	603	858	78919	1115	0	81495
24795	393	76190	1027	1095	0	78705
24796	525	1650	808	66933	0	69916
24797	337	70506	354	705	0	71902
24798	240	73010	290	806	0	74346
24799	448	1875	406	68842	0	71571
24800	353	696	71317	791	0	73157
24801	223	69592	761	701	0	71277
24802	179	67725	608	275	0	68787
24803	59468	812	390	139	0	60809
24804	417	435	40	62284	0	63176
24805	399	110	42	63205	0	63756
24806	135	80	47	64814	0	65076
24807	117	120	65635	975	0	66847
24808	119	106	540	64893	0	65658
24809	69	68757	490	698	0	70014
24810	70575	603	121	517	0	71816
24811	718	519	69	70595	0	71901
24812	570	194	70784	749	0	72297
24813	69770	97	683	594	0	71144
24814	771	114	517	73501	0	74903
24815	656	130	77878	738	0	79402
24816	193	148	78594	617	0	79552
24817	77495	83	1391	208	0	79177
24818	81929	93	710	178	0	82910
24819	81680	115	157	169	0	82121
24820	82502	107	124	188	0	82921
24821	1573	158	82045	199	0	83975
24822	789	82925	894	314	0	84922
24823	81948	891	685	162	0	83686
24824	875	83746	190	217	0	85028
24825	81670	943	122	164	0	82899
24826	920	83873	159	225	0	85177
24827	769	1027	133	83046	0	84975
24828	254	720	119	83761	0	84854
24829	208	209	135	82464	0	83016
24830	204	82491	160	1551	0	84406
24831	192	83970	159	918	0	85239
24832	242	1502	118	78100	0	79962
24833	185	81962	177	959	0	83283
24834	268	1086	81218	757	0	83329
24835	207	782	908	80671	0	82568
24836	267	306	82554	1036	0	84163
24837	78410	240	1025	819	0	80494
24838	81412	218	759	314	0	82703
24839	1599	273	81818	293	0	83983
24840	923	282	81483	295	0	82983
24841	307	262	1535	79640	0	81744
24842	332	314	81619	1065	0	83330
24843	291	270	1054	76092	0	77707
24844	237	78070	855	1026	0	80188
24845	302	1141	269	80706	0	82418
24846	266	906	238	81262	0	82672
24847	238	351	216	81976	0	82781
24848	264	398	78595	1840	0	81097
24849	309	306	1060	76604	0	78279
24850	307	335	888	76217	0	77747
24851	397	389	343	72515	0	73644
24852	260	78028	318	1627	0	80233
24853	77929	1094	244	993	0	80260
24854	77830	852	272	661	0	79615
24855	77419	360	363	583	0	78725
24856	1756	314	343	75760	0	78173
24857	1013	387	76421	1297	0	79118
24858	843	359	75783	1150	0	78135
24859	394	75888	1756	656	0	78694
24860	73361	1067	1005	584	0	76017
24861	1049	75518	539	684	0	77790
24862	75248	1073	464	524	0	77309
24863	1242	75621	430	608	0	77901
24864	73981	1181	476	513	0	76151
24865	1241	77985	534	555	0	80315
24866	1119	1264	441	77171	0	79995
24867	744	1079	77012	1347	0	80182
24868	686	560	77907	1209	0	80362
24869	671	496	1874	75604	0	78645
24870	679	508	1160	77004	0	79351
24871	649	461	586	78607	0	80303
24872	745	529	77424	1992	0	80690
24873	718	386	1229	75677	0	78010
24874	73700	479	1077	1530	0	76786
24875	74235	433	614	1236	0	76518
24876	1882	73684	542	823	0	76931
24877	71934	1236	533	666	0	74369
24878	1471	71304	508	695	0	73978
24879	71034	1322	398	653	0	73407
24880	71205	1089	552	597	0	73443
24881	69501	610	583	577	0	71271
24882	2056	557	69307	586	0	72506
24883	1312	616	68651	527	0	71106
24884	66666	488	1897	586	0	69637
24885	69145	470	1161	589	0	71365
24886	2138	486	582	68017	0	71223
24887	1530	469	469	69802	0	72270
24888	843	521	514	71125	0	73003
24889	598	512	595	71698	0	73403
24890	595	599	538	72704	0	74436
24891	69745	569	523	2243	0	73080
24892	1367	624	438	70055	0	72484
24893	1118	586	69064	1568	0	72336
24894	64239	491	1235	1431	0	67396
24895	67205	377	1063	973	0	69618
24896	1778	67753	597	937	0	71065
24897	985	67883	473	825	0	70166
24898	61487	1352	416	506	0	63761
24899	903	64449	455	524	0	66331
24900	62575	882	628	504	0	64589
24901	64497	682	576	540	0	66295
24902	65115	192	414	485	0	66206
24903	1578	215	318	61323	0	63434
24904	869	62588	378	1051	0	64886
24905	62348	699	304	927	0	64278
24906	959	629	299	62002	0	63889
24907	836	157	261	59985	0	61239
24908	56246	118	201	1324	0	57889
24909	656	55696	240	902	0	57494
24910	543	663	129	54541	0	55876
24911	55198	524	107	757	0	56586
24912	612	56476	143	758	0	57989
24913	56611	542	62	337	0	57552
24914	738	508	55118	248	0	56612
24915	51904	116	514	205	0	52739
24916	630	54457	470	199	0	55756
24917	52916	506	245	140	0	53807
24918	51793	465	53	115	0	52426
24919	895	53790	64	175	0	54924
24920	53443	483	50	121	0	54097
24921	548	53394	64	184	0	54190
24922	54581	526	42	159	0	55308
24923	589	495	48	54425	0	55557
24924	548	131	26	54755	0	55460
24925	209	101	30	55447	0	55787
24926	181	157	53639	949	0	54926
24927	182	88	457	53647	0	54374
24928	209	143	54184	610	0	55146
24929	187	96	499	52549	0	53331
24930	169	54015	493	564	0	55241
24931	196	523	81	54641	0	55441
24932	212	533	54761	565	0	56071
24933	195	197	55729	522	0	56643
24934	159	143	865	55136	0	56303
24935	55024	111	494	585	0	56214
24936	55061	80	133	594	0	55868
24937	931	55935	111	326	0	57303
24938	601	525	86	56279	0	57491
24939	281	550	57759	599	0	59189
24940	224	181	511	57547	0	58463
24941	228	128	58590	649	0	59595
24942	55260	121	566	607	0	56554
24943	659	134	477	58381	0	59651
24944	645	155	58576	651	0	60027
24945	273	138	544	58347	0	59302
24946	223	132	515	59269	0	60139
24947	287	151	59081	1075	0	60594
24948	204	139	549	58750	0	59642
24949	58940	112	523	733	0	60308
24950	59230	115	169	653	0	60167
24951	1062	119	116	59805	0	61102
24952	60593	120	158	740	0	61611
24953	721	171	60998	652	0	62542
24954	650	146	60609	273	0	61678
24955	60492	123	1038	295	0	61948
24956	63077	94	609	260	0	64040
24957	1081	132	176	61950	0	63339
24958	709	99	155	63073	0	64036
24959	305	161	62625	1207	0	64298
24960	330	148	658	57275	0	58411
24961	218	63374	635	683	0	64910
24962	63499	562	240	614	0	64915
24963	66516	538	161	308	0	67523
24964	1143	67497	189	362	0	69191
24965	64723	644	169	282	0	65818
24966	64173	584	187	247	0	65191
24967	1181	66319	237	302	0	68039
24968	65939	658	182	280	0	67059
24969	836	66674	229	280	0	68019
24970	66645	716	146	308	0	67815
24971	925	698	66444	265	0	68332
24972	784	190	696	65946	0	67616
24973	343	183	635	67935	0	69096
24974	314	157	211	70958	0	71640
24975	70269	134	180	1438	0	72021
24976	923	138	147	72601	0	73809
24977	848	194	72357	1021	0	74420
24978	71160	132	838	887	0	73017
24979	961	150	709	71511	0	73331
24980	813	71575	314	977	0	73679
24981	312	73795	274	923	0	75304
24982	341	1318	198	72348	0	74205
24983	350	743	209	72238	0	73540
24984	355	184	210	73341	0	74090
24985	336	205	70484	1537	0	72562
24986	246	69522	880	983	0	71631
24987	67213	708	668	416	0	69005
24988	65550	614	234	336	0	66734
24989	1237	66467	267	368	0	68339
24990	756	67254	226	346	0	68582
24991	618	1352	309	65543	0	67822
24992	269	621	65644	844	0	67378
24993	62165	419	735	768	0	64087
24994	64450	134	564	373	0	65521
24995	1104	123	239	64048	0	65514
24996	625	119	149	64427	0	65320
24997	62407	110	151	1180	0	63848
24998	770	165	62429	736	0	64100
24999	59335	128	670	399	0	60532
25000	738	61539	590	317	0	63184
25001	524	562	144	56724	0	57954
25002	229	58527	149	689	0	59594
25003	58663	538	131	545	0	59877
25004	668	447	115	57732	0	58962
25005	560	129	149	56745	0	57583
25006	258	57843	198	943	0	59242
25007	57851	518	164	564	0	59097
25008	57833	413	168	291	0	58705
25009	1006	197	57334	248	0	58785
25010	555	176	54626	231	0	55588
25011	53228	92	763	238	0	54321
25012	636	136	54495	184	0	55451
25013	467	153	51660	145	0	52425
25014	50406	184	768	196	0	51554
25015	529	103	55916	216	0	56764
25016	385	91	628	55092	0	56196
25017	213	67	445	56841	0	57566
25018	59780	73	163	1093	0	61109
25019	864	126	61018	559	0	62567
25020	63014	79	840	225	0	64158
25021	1066	131	601	62936	0	64734
25022	64162	115	187	917	0	65381
25023	64384	90	126	714	0	65314
25024	65035	95	102	277	0	65509
25025	1692	79	97	63772	0	65640
25026	64820	98	123	994	0	66035
25027	1228	94	96	64682	0	66100
25028	901	109	124	64739	0	65873
25029	439	82	120	65414	0	66055
25030	372	94	121	65487	0	66074
25031	64335	94	109	1702	0	66240
25032	64375	79	129	927	0	65510
25033	1626	156	64319	408	0	66509
25034	64641	70	946	360	0	66017
25035	65907	70	703	315	0	66995
25036	1747	95	204	63525	0	65571
25037	969	64290	218	1080	0	66557
25038	64932	901	151	836	0	66820
25039	1241	670	142	63053	0	65106
25040	62894	170	163	1116	0	64343
25041	1208	62464	195	915	0	64782
25042	63470	911	127	378	0	64886
25043	1296	706	103	61198	0	63303
25044	932	61566	145	1064	0	63707
25045	62056	964	106	862	0	63988
25046	1177	62337	175	482	0	64171
25047	858	64522	174	450	0	66004
25048	64270	1491	174	466	0	66401
25049	1186	847	63222	379	0	65634
25050	63900	283	935	369	0	65487
25051	1423	205	733	63158	0	65519
25052	1118	203	63554	1077	0	65952
25053	631	168	1022	62032	0	63853
25054	583	166	762	63473	0	64984
25055	584	186	62441	1708	0	64919
25056	60727	121	1076	984	0	62908
25057	1431	124	727	61922	0	64204
25058	1145	110	233	62138	0	63626
25059	631	129	163	62028	0	62951
25060	61113	113	225	1939	0	63390
25061	1355	177	60141	1206	0	62879
25062	1044	130	60129	638	0	61941
25063	501	151	1396	55786	0	57834
25064	494	136	56431	1202	0	58263
25065	54171	93	990	963	0	56217
25066	1154	55464	825	526	0	57969
25067	54808	795	393	338	0	56334
25068	1356	607	259	51937	0	54159
25069	991	53952	281	1002	0	56226
25070	661	1045	235	53060	0	55001
25071	533	54653	211	1145	0	56542
25072	559	1110	153	54808	0	56630
25073	550	709	53621	1153	0	56033
25074	496	373	51221	910	0	53000
25075	437	51488	1251	533	0	53709
25076	48483	797	769	471	0	50520
25077	945	658	254	47830	0	49687
25078	798	322	169	48653	0	49942
25079	48748	290	169	1323	0	50530
25080	48779	244	191	855	0	50069
25081	1446	199	230	48772	0	50647
25082	1013	221	48123	944	0	50301
25083	548	48486	867	803	0	50704
25084	507	771	685	48156	0	50119
25085	476	625	335	46926	0	48362
25086	391	49634	267	1378	0	51670
25087	49909	784	239	899	0	51831
25088	1019	673	50281	496	0	52469
25089	827	298	808	49479	0	51412
25090	418	202	642	49232	0	50494
25091	350	252	48878	1586	0	51066
25092	402	285	829	49222	0	50738
25093	50069	185	730	1153	0	52137
25094	49842	206	372	891	0	51311
25095	50480	170	307	572	0	51529
25096	1455	49652	375	485	0	51967
25097	52367	808	327	393	0	53895
25098	1211	630	257	51741	0	53839
25099	962	292	323	49823	0	51400
25100	543	55196	310	1398	0	57447
25101	59093	951	224	962	0	61230
25102	61947	774	243	500	0	63464
25103	62639	361	221	480	0	63701
25104	64480	306	188	503	0	65477
25105	64384	257	301	516	0	65458
25106	1939	289	62922	434	0	65584
25107	63836	246	1082	446	0	65610
25108	64409	264	851	407	0	65931
25109	64025	201	372	412	0	65010
25110	2032	178	318	62558	0	65086
25111	1243	146	330	63057	0	64776
25112	708	188	61986	1814	0	64696
25113	52691	215	1095	1157	0	55158
25114	1183	60549	880	684	0	63296
25115	812	55117	285	418	0	56632
25116	507	1038	54555	304	0	56404
25117	351	54352	728	307	0	55738
25118	255	51781	596	280	0	52912
25119	788	1771	693	42118	0	45370
25120	123	46181	159	543	0	47006
25121	45876	471	66	325	0	46738
25122	45129	329	57	159	0	45674
25123	752	113	71	44875	0	45811
25124	487	98	44779	433	0	45797
25125	43215	71	467	394	0	44147
25126	574	102	44971	174	0	45821
25127	473	81	45095	120	0	45769
25128	209	76	702	42261	0	43248
25129	184	55	381	44053	0	44673
25130	216	68	44851	683	0	45818
25131	149	44008	443	426	0	45026
25132	144	45702	364	207	0	46417
25133	44251	707	219	149	0	45326
25134	44378	338	86	163	0	44965
25135	722	123	43784	89	0	44718
25136	42703	87	392	114	0	43296
25137	44596	84	283	133	0	45096
25138	741	91	118	43165	0	44115
25139	437	77	76	44452	0	45042
25140	225	66	62	44949	0	45302
25141	44649	79	60	689	0	45477
25142	44898	65	55	403	0	45421
25143	45399	59	68	159	0	45685
25144	883	60	83	44894	0	45920
25145	598	87	44315	431	0	45431
25146	43471	65	413	333	0	44282
25147	43048	87	340	147	0	43622
25148	814	85	159	41734	0	42792
25149	544	43000	129	463	0	44136
25150	346	424	100	42532	0	43402
25151	251	43378	124	514	0	44267
25152	233	533	105	41616	0	42487
25153	207	43701	137	553	0	44598
25154	42683	467	132	362	0	43644
25155	593	376	127	42079	0	43175
25156	443	42770	128	508	0	43849
25157	288	481	42254	353	0	43376
25158	40271	377	477	179	0	41304
25159	551	214	363	41753	0	42881
25160	417	42411	172	476	0	43476
25161	273	487	92	40689	0	41541
25162	262	41417	113	478	0	42270
25163	285	42936	132	412	0	43765
25164	42564	685	146	225	0	43620
25165	42814	387	137	197	0	43535
25166	809	214	42981	129	0	44133
25167	42396	128	465	145	0	43134
25168	42703	148	406	160	0	43417
25169	731	42312	240	172	0	43455
25170	515	444	157	42179	0	43295
25171	325	361	121	42082	0	42889
25172	281	206	41722	685	0	42894
25173	283	194	40939	394	0	41810
25174	40485	151	675	194	0	41505
25175	41701	107	398	157	0	42363
25176	41673	78	197	165	0	42113
25177	837	116	40761	175	0	41889
25178	522	92	458	39517	0	40589
25179	40248	91	338	516	0	41193
25180	536	107	156	39995	0	40794
25181	422	98	39216	531	0	40267
25182	37004	106	395	421	0	37926
25183	605	119	40594	199	0	41517
25184	471	39592	435	218	0	40716
25185	39782	403	342	153	0	40680
25186	569	302	39393	183	0	40447
25187	485	176	415	38355	0	39431
25188	38976	77	315	459	0	39827
25189	537	88	129	39249	0	40003
25190	39825	102	86	534	0	40547
25191	498	127	68	39585	0	40278
25192	40968	133	76	543	0	41720
25193	40662	134	60	433	0	41289
25194	40608	142	86	214	0	41050
25195	39962	121	105	167	0	40355
25196	812	250	97	39537	0	40696
25197	435	114	38184	369	0	39102
25198	279	121	38182	301	0	38883
25199	170	37943	564	163	0	38840
25200	156	33457	343	122	0	34078
25201	27726	324	822	68	0	28940
25202	176	86	94	26192	0	26548
25203	88	36	26673	102	0	26899
25204	48	30	27809	76	0	27963
25205	70	79	168	27464	0	27781
25206	27968	18	97	107	0	28190
25207	101	28604	24	108	0	28837
25208	29924	91	13	56	0	30084
25209	101	71	20	30449	0	30641
25210	87	12	16	30546	0	30661
25211	28	21	23	30573	0	30645
25212	42	44	31038	169	0	31293
25213	47	31	30809	111	0	30998
25214	38	31525	189	41	0	31793
25215	33	95	97	31845	0	32070
25216	31677	91	30	128	0	31926
25217	128	48	31697	134	0	32007
25218	126	50	32769	43	0	32988
25219	47	23	190	32699	0	32959
25220	43	21	120	34030	0	34214
25221	40	20	32	34574	0	34666
25222	40	25	29	38471	0	38565
25223	38826	17	28	380	0	39251
25224	273	20	29	39312	0	39634
25225	39396	7	48	308	0	39759
25226	335	32	40652	221	0	41240
25227	205	41077	294	93	0	41669
25228	57	281	189	41036	0	41563
25229	67	218	42415	292	0	42992
25230	79	66	42801	243	0	43189
25231	40	43796	488	111	0	44435
25232	53	265	226	42357	0	42901
25233	51	192	40	43049	0	43332
25234	66	55	43929	472	0	44522
25235	41283	25	319	251	0	41878
25236	304	24	218	43957	0	44503
25237	217	22	61	43779	0	44079
25238	87	45	45146	531	0	45809
25239	31	45359	350	295	0	46035
25240	44	48837	283	136	0	49300
25241	49125	577	80	112	0	49894
25242	422	284	56	49598	0	50360
25243	52185	41	96	453	0	52775
25244	524	69	52390	350	0	53333
25245	367	42	463	51961	0	52833
25246	52319	50	368	517	0	53254
25247	52429	48	104	418	0	52999
25248	784	63	67	52224	0	53138
25249	427	58	52777	492	0	53754
25250	120	56	53720	422	0	54318
25251	113	89	793	52622	0	53617
25252	116	59	54101	506	0	54782
25253	49901	50	536	436	0	50923
25254	469	53701	401	213	0	54784
25255	54235	458	107	151	0	54951
25256	54508	350	94	153	0	55105
25257	827	81	107	54637	0	55652
25258	442	67	150	55194	0	55853
25259	55201	84	93	834	0	56212
25260	516	62	111	55299	0	55988
25261	458	83	55296	602	0	56439
25262	120	55458	571	482	0	56631
25263	126	531	421	54601	0	55679
25264	107	367	126	54757	0	55357
25265	155	86	100	55245	0	55586
25266	143	93	54564	943	0	55743
25267	146	54175	557	632	0	55510
25268	136	462	439	54373	0	55410
25269	178	400	54881	612	0	56071
25270	129	116	556	54517	0	55318
25271	54600	107	446	642	0	55795
25272	552	109	175	55408	0	56244
25273	512	122	55350	661	0	56645
25274	52680	69	592	571	0	53912
25275	573	56578	501	269	0	57921
25276	444	57626	240	261	0	58571
25277	57744	779	146	276	0	58945
25278	629	438	59215	218	0	60500
25279	546	124	573	57804	0	59047
25280	231	97	466	59562	0	60356
25281	213	98	60413	989	0	61713
25282	156	60418	643	702	0	61919
25283	197	513	521	56853	0	58084
25284	236	456	59555	663	0	60910
25285	209	146	602	58816	0	59773
25286	58916	139	523	707	0	60285
25287	657	154	61343	593	0	62747
25288	540	158	620	60791	0	62109
25289	241	127	494	61402	0	62264
25290	249	177	60868	1058	0	62352
25291	294	146	622	56148	0	57210
25292	214	58724	574	766	0	60278
25293	342	623	268	52865	0	54098
25294	206	60343	261	719	0	61529
25295	59789	553	262	615	0	61219
25296	57242	426	249	417	0	58334
25297	966	181	59087	373	0	60607
25298	561	180	58798	378	0	59917
25299	284	207	58426	329	0	59246
25300	211	57885	1070	423	0	59589
25301	288	577	658	58638	0	60161
25302	239	466	60374	732	0	61811
25303	319	157	672	58113	0	59261
25304	252	169	523	59561	0	60505
25305	307	150	60218	1003	0	61678
25306	306	170	635	59545	0	60656
25307	258	207	532	58149	0	59146
25308	287	59210	298	1080	0	60875
25309	336	555	252	59685	0	60828
25310	254	484	309	60424	0	61471
25311	248	192	61179	1161	0	62780
25312	233	180	682	58512	0	59607
25313	233	176	61279	893	0	62581
25314	208	217	59826	715	0	60966
25315	55764	165	1000	486	0	57415
25316	607	430	633	54750	0	56420
25317	437	60099	361	839	0	61736
25318	254	60343	318	724	0	61639
25319	260	925	355	58982	0	60522
25320	239	480	59581	902	0	61202
25321	213	59452	759	798	0	61222
25322	284	547	455	54447	0	55733
25323	224	358	57867	599	0	59048
25324	173	57963	464	559	0	59159
25325	59580	388	491	367	0	60826
25326	59078	360	266	315	0	60019
25327	58783	163	194	391	0	59531
25328	575	172	234	61993	0	62974
25329	351	175	243	61974	0	62743
25330	192	147	195	61067	0	61601
25331	119	166	61075	820	0	62180
25332	58770	158	492	612	0	60032
25333	476	115	464	58566	0	59621
25334	367	192	60941	525	0	62025
25335	59874	151	495	534	0	61054
25336	61671	134	480	361	0	62646
25337	663	224	57477	287	0	58651
25338	60102	113	447	386	0	61048
25339	395	64638	439	404	0	65876
25340	262	257	61638	218	0	62375
25341	57945	250	423	256	0	58874
25342	264	61461	291	237	0	62253
25343	135	185	102	56957	0	57379
25344	59	58534	129	236	0	58958
25345	73	194	89	58838	0	59194
25346	72	149	59092	238	0	59551
25347	50712	44	268	301	0	51325
25348	182	88	59968	154	0	60392
25349	124	59281	228	150	0	59783
25350	39	59403	172	149	0	59763
25351	58500	241	83	112	0	58936
25352	188	170	58789	84	0	59231
25353	155	41	202	57409	0	57807
25354	92	77	59421	207	0	59797
25355	37	60446	203	271	0	60957
25356	155	197	152	54666	0	55170
25357	29	60659	95	162	0	60945
25358	61535	169	71	196	0	61971
25359	62060	142	74	117	0	62393
25360	61890	56	78	94	0	62118
25361	287	91	61946	77	0	62401
25362	155	107	60088	73	0	60423
25363	59150	62	298	107	0	59617
25364	212	73	63543	104	0	63932
25365	209	38	251	58797	0	59295
25366	37	63052	207	214	0	63510
25367	64682	202	92	217	0	65193
25368	64419	152	83	109	0	64763
25369	66299	56	72	149	0	66576
25370	339	51	70	67142	0	67602
25371	188	48	63	67711	0	68010
25372	67465	45	81	414	0	68005
25373	226	67445	74	289	0	68034
25374	67272	207	86	146	0	67711
25375	261	173	53	66457	0	66944
25376	208	42	49	66543	0	66842
25377	65339	32	61	410	0	65842
25378	228	64933	87	257	0	65505
25379	64854	219	55	102	0	65230
25380	251	66001	63	130	0	66445
25381	65211	220	67	87	0	65585
25382	283	167	47	67428	0	67925
25383	68325	46	50	300	0	68721
25384	70826	47	30	236	0	71139
25385	76803	57	30	123	0	77013
25386	581	80465	64	140	0	81250
25387	396	484	78769	73	0	79722
25388	77439	307	456	93	0	78295
25389	79730	71	303	89	0	80193
25390	713	80651	118	104	0	81586
25391	394	452	37	80902	0	81785
25392	147	313	39	81132	0	81631
25393	81128	100	50	781	0	82059
25394	524	63	48	82822	0	83457
25395	436	91	83611	524	0	84662
25396	198	121	82900	406	0	83625
25397	83244	57	821	143	0	84265
25398	582	62	401	84819	0	85864
25399	463	58	101	85611	0	86233
25400	189	52	81	86735	0	87057
25401	175	96	87876	949	0	89096
25402	156	75	557	86249	0	87037
25403	172	60	427	88711	0	89370
25404	172	69	110	88884	0	89235
25405	87509	49	109	1031	0	88698
25406	696	78	74	88296	0	89144
25407	540	126	90260	714	0	91640
25408	90499	73	699	601	0	91872
25409	831	155	95652	226	0	96864
25410	95392	101	775	245	0	96513
25411	90664	158	616	243	0	91681
25412	1378	97	134	97637	0	99246
25413	693	100179	160	1039	0	102071
25414	312	851	126	101031	0	102320
25415	260	744	136	98486	0	99626
25416	200	103228	218	1544	0	105190
25417	100983	806	192	777	0	102758
25418	907	102292	209	458	0	103866
25419	102218	868	190	340	0	103616
25420	101499	637	143	345	0	102624
25421	1494	165	153	100681	0	102493
25422	798	106	158	100963	0	102025
25423	310	154	99006	1564	0	101034
25424	283	155	96395	908	0	97741
25425	92368	170	1401	450	0	94389
25426	94785	130	737	409	0	96061
25427	1449	93168	259	432	0	95308
25428	877	796	213	91650	0	93536
25429	461	634	96454	989	0	98538
25430	377	390	948	96345	0	98060
25431	95494	165	848	1134	0	97641
25432	93127	134	251	845	0	94357
25433	1471	95257	242	473	0	97443
25434	890	865	137	95047	0	96939
25435	379	659	130	95672	0	96840
25436	303	283	161	95873	0	96620
25437	340	315	92844	1593	0	95092
25438	80028	219	909	1128	0	82284
25439	88853	241	645	470	0	90209
25440	1685	269	90339	415	0	92708
25441	961	90091	929	449	0	92430
25442	90004	855	698	438	0	91995
25443	89843	649	282	449	0	91223
25444	1616	253	88787	506	0	91162
25445	975	249	90627	434	0	92285
25446	529	225	1445	88206	0	90405
25447	479	241	90650	1023	0	92393
25448	86882	261	1026	866	0	89035
25449	89143	218	751	440	0	90552
25450	90191	243	331	429	0	91194
25451	1735	221	286	82967	0	85209
25452	1032	92344	320	1098	0	94794
25453	93385	865	282	910	0	95442
25454	92119	685	309	536	0	93649
25455	1751	301	91499	569	0	94120
25456	1107	300	90084	490	0	91981
25457	83227	238	1478	567	0	85510
25458	1278	173	829	89743	0	92023
25459	1046	303	90264	1197	0	92810
25460	608	89895	1102	1091	0	92696
25461	696	965	863	89241	0	91765
25462	88392	734	409	1151	0	90686
25463	1257	91593	456	1057	0	94363
25464	1102	945	346	88158	0	90551
25465	642	90272	465	1153	0	92532
25466	600	91586	496	1056	0	93738
25467	621	1350	440	90253	0	92664
25468	663	777	453	88926	0	90819
25469	611	90745	496	1609	0	93461
25470	89246	944	394	970	0	91554
25471	1386	752	89711	525	0	92374
25472	87648	322	999	580	0	89549
25473	1401	345	821	91702	0	94269
25474	1129	260	408	91751	0	93548
25475	732	306	383	92462	0	93883
25476	697	308	440	92111	0	93556
25477	741	324	92320	1644	0	95029
25478	705	313	1108	92289	0	94415
25479	685	413	913	90750	0	92761
25480	651	97844	491	1739	0	100725
25481	675	1161	99602	1102	0	102540
25482	563	102620	1266	824	0	105273
25483	833	1267	103714	626	0	106440
25484	537	103636	1265	611	0	106049
25485	1096	1347	1266	91100	0	94809
25486	91316	786	340	965	0	93407
25487	1085	93153	350	1169	0	95757
25488	989	957	352	93938	0	96236
25489	552	817	95644	1076	0	98089
25490	425	98144	1106	1033	0	100708
25491	96432	1003	999	476	0	98910
25492	95276	900	452	439	0	97067
25493	1629	97726	471	431	0	100257
25494	1048	1028	95719	373	0	98168
25495	91362	815	1089	355	0	93621
25496	1168	430	834	96591	0	99023
25497	94640	307	377	1118	0	96442
25498	1114	100286	361	1117	0	102878
25499	911	102364	338	545	0	104158
25500	562	1608	100416	460	0	103046
25501	96075	1039	1065	391	0	98570
25502	1291	576	849	100899	0	103615
25503	101087	296	376	1064	0	102823
25504	1052	102937	381	962	0	105332
25505	102844	1039	357	356	0	104596
25506	101714	892	328	337	0	103271
25507	1787	414	104308	378	0	106887
25508	878	100015	912	285	0	102090
25509	359	100925	813	270	0	102367
25510	317	1812	237	89665	0	92031
25511	209	96128	263	749	0	97349
25512	91971	901	230	668	0	93770
25513	737	94336	219	373	0	95665
25514	755	946	134	90400	0	92235
25515	312	92507	193	730	0	93742
25516	262	90987	209	640	0	92098
25517	308	93174	194	263	0	93939
25518	529	1407	251	91873	0	94060
25519	299	764	145	92987	0	94195
25520	288	369	145	91712	0	92514
25521	261	90202	202	1283	0	91948
25522	306	841	90563	695	0	92405
25523	341	838	90844	257	0	92280
25524	86354	402	1149	258	0	88163
25525	813	360	644	91072	0	92889
25526	785	445	92868	759	0	94857
25527	413	431	93979	701	0	95524
25528	284	95766	1190	296	0	97536
25529	308	920	685	90102	0	92015
25530	251	888	209	92678	0	94026
25531	92120	455	179	1305	0	94059
25532	792	430	159	92575	0	93956
25533	729	390	227	92558	0	93904
25534	385	459	95296	1330	0	97470
25535	273	431	760	93900	0	95364
25536	344	420	699	98425	0	99888
25537	287	514	99594	1320	0	101715
25538	336	493	100048	905	0	101782
25539	262	99650	1337	493	0	101742
25540	385	1053	99490	405	0	101333
25541	246	924	852	96636	0	98658
25542	321	588	800	87435	0	89144
25543	410	519	100410	1488	0	102827
25544	227	100434	874	1064	0	102599
25545	95782	946	841	552	0	98121
25546	750	100395	489	543	0	102177
25547	706	1037	361	99242	0	101346
25548	319	965	405	100095	0	101784
25549	224	101338	536	1570	0	103668
25550	320	1066	461	101125	0	102972
25551	302	973	442	101646	0	103363
25552	355	602	97726	1621	0	100304
25553	280	97404	994	1295	0	99973
25554	310	1126	853	97805	0	100094
25555	360	1035	98299	1176	0	100870
25556	359	571	979	96864	0	98773
25557	396	477	905	97516	0	99294
25558	366	478	469	98829	0	100142
25559	374	482	436	98491	0	99783
25560	374	530	454	95296	0	96654
25561	325	98337	501	1668	0	100831
25562	95238	1030	514	1192	0	97974
25563	889	1027	96077	767	0	98760
25564	81836	533	1115	841	0	84325
25565	942	536	100349	702	0	102529
25566	685	104029	1129	903	0	106746
25567	521	1180	103055	695	0	105451
25568	281	104360	1109	918	0	106668
25569	348	1164	946	96287	0	98745
25570	375	977	519	95478	0	97349
25571	314	102286	501	1744	0	104845
25572	273	106275	420	1305	0	108273
25573	105476	1628	450	797	0	108351
25574	107655	997	431	828	0	109911
25575	108093	545	426	720	0	109784
25576	109500	476	446	727	0	111149
25577	1440	802	467	106553	0	109262
25578	762	108393	485	1186	0	110826
25579	106878	1012	426	1064	0	109380
25580	702	767	317	101637	0	103423
25581	97596	366	356	919	0	99237
25582	93163	308	335	843	0	94649
25583	830	91468	283	590	0	93171
25584	419	87994	270	396	0	89079
25585	206	91866	288	348	0	92708
25586	361	2263	458	83926	0	87008
25587	132	90216	331	625	0	91304
25588	89132	465	295	531	0	90423
25589	90707	371	206	363	0	91647
25590	91129	159	161	356	0	91805
25591	92721	168	197	338	0	93424
25592	93531	161	165	306	0	94163
25593	798	223	96403	249	0	97673
25594	94255	158	580	313	0	95306
25595	662	234	97932	246	0	99074
25596	93931	113	624	257	0	94925
25597	630	199	493	92989	0	94311
25598	512	230	97016	511	0	98269
25599	263	242	101229	481	0	102215
25600	129	108031	940	298	0	109398
25601	107383	805	715	260	0	109163
25602	110163	599	192	259	0	111213
25603	1288	125007	188	372	0	126855
25604	790	1104	101	140205	0	142200
25605	150315	846	136	1616	0	152913
25606	1875	341	156031	1194	0	159441
25607	1248	156031	1682	389	0	159350
25608	148644	1724	1229	241	0	151838
25609	1580	156285	305	389	0	158559
25610	1340	1941	176	143015	0	146472
25611	331	156795	257	1456	0	158839
25612	301	2197	123	145529	0	148150
25613	228	154459	244	1667	0	156598
25614	184	157610	250	1351	0	159395
25615	153049	2784	110	346	0	156289
25616	153925	1497	151	293	0	155866
25617	2967	479	155582	277	0	159305
25618	1646	394	154627	176	0	156843
25619	576	374	156844	172	0	157966
25620	374	322	2960	152314	0	155970
25621	476	393	158035	1738	0	160642
25622	386	308	1936	153294	0	155924
25623	356	381	1453	151791	0	153981
25624	307	156893	514	2974	0	160688
25625	153476	1858	256	1582	0	157172
25626	1644	158234	362	567	0	160807
25627	1507	2085	256	158501	0	162349
25628	570	1586	280	159256	0	161692
25629	493	646	323	160721	0	162183
25630	632	549	159526	3199	0	163906
25631	512	508	1823	157617	0	160460
25632	498	484	1457	159450	0	161889
25633	524	511	425	161938	0	163398
25634	615	631	156459	3355	0	161060
25635	423	156039	1957	2118	0	160537
25636	151779	2089	1480	816	0	156164
25637	144612	1750	516	709	0	147587
25638	2971	154305	540	698	0	158514
25639	1793	2138	484	151936	0	156351
25640	758	1848	432	155837	0	158875
25641	801	783	154191	3348	0	159123
25642	538	153425	2106	2297	0	158366
25643	558	2126	1668	153994	0	158346
25644	667	1848	155004	2290	0	159809
25645	582	733	2080	152520	0	155915
25646	585	685	1690	153182	0	156142
25647	742	875	153375	3593	0	158585
25648	728	705	2083	150733	0	154249
25649	730	707	1724	151304	0	154465
25650	749	849	153832	3622	0	159052
25651	624	723	2145	152827	0	156319
25652	575	719	1865	151981	0	155140
25653	541	675	771	156305	0	158292
25654	613	772	153888	3950	0	159223
25655	532	766	2291	153236	0	156825
25656	150260	633	1889	2938	0	155720
25657	150940	672	837	2366	0	154815
25658	3244	153380	852	1375	0	158851
25659	154941	2106	778	1232	0	159057
25660	2484	1892	160738	1210	0	166324
25661	1907	822	2383	160001	0	165113
25662	854	681	2034	159679	0	163248
25663	669	671	936	165771	0	168047
25664	158181	602	778	4153	0	163714
25665	1911	159604	914	3235	0	165664
25666	1612	2152	679	148501	0	152944
25667	609	156592	920	2715	0	160836
25668	152432	2325	647	2477	0	157881
25669	1912	156228	750	1622	0	160512
25670	151963	2279	700	1508	0	156450
25671	2021	153239	759	1591	0	157610
25672	1654	153093	815	1556	0	157118
25673	936	3482	864	150611	0	155893
25674	695	1933	804	151033	0	154465
25675	683	947	737	151513	0	153880
25676	635	885	717	151060	0	153297
25677	717	1009	147584	4198	0	153508
25678	617	147364	2231	2929	0	153141
25679	686	2327	1676	138328	0	143017
25680	599	146803	858	2747	0	151007
25681	862	2497	144884	2487	0	150730
25682	726	1849	2165	142123	0	146863
25683	672	895	1843	148239	0	151649
25684	794	753	146208	4014	0	151769
25685	548	142718	2496	3124	0	148886
25686	506	1992	2028	141107	0	145633
25687	784	1727	141267	3190	0	146968
25688	404	141374	2418	3114	0	147310
25689	513	2201	1887	138344	0	142945
25690	673	1925	138309	3009	0	143916
25691	694	1029	136751	2606	0	141080
25692	529	135407	3102	1681	0	140719
25693	615	143110	1873	1512	0	147110
25694	730	3384	1055	142749	0	147918
25695	576	2050	666	152180	0	155472
25696	576	962	151658	4302	0	157498
25697	139712	757	2358	3023	0	145850
25698	145079	704	1966	1839	0	149588
25699	3454	778	144337	1518	0	150087
25700	1740	137049	2208	1437	0	142434
25701	682	136649	1764	1226	0	140321
25702	535	130692	883	991	0	133101
25703	809	115521	1190	1084	0	118604
25704	2447	4428	1763	93312	0	101950
25705	340	688	265	102616	0	103909
25706	134	216	65	102976	0	103391
25707	102	169	55	103063	0	103389
25708	58	103317	157	2249	0	105781
25709	110	1239	64	103172	0	104585
25710	57	104076	138	1518	0	105789
25711	109	1347	77	105632	0	107165
25712	103180	986	93	1507	0	105766
25713	1158	279	92	105267	0	106796
25714	925	105212	164	1523	0	107824
25715	312	1208	113	108478	0	110111
25716	202	1030	86	109990	0	111308
25717	197	366	90	110924	0	111577
25718	105128	265	106	2582	0	108081
25719	1209	323	90	110417	0	112039
25720	1062	362	107897	1744	0	111065
25721	266	110551	1224	1445	0	113486
25722	220	1468	968	112821	0	115477
25723	287	1211	220	114982	0	116700
25724	261	419	114	116636	0	117430
25725	110773	360	90	2899	0	114122
25726	1393	410	112106	1742	0	115651
25727	1136	333	1272	106848	0	109589
25728	268	110159	1085	1995	0	113507
25729	302	1531	253	111346	0	113432
25730	104594	1208	153	2121	0	108076
25731	1273	109355	230	1803	0	112661
25732	1072	1560	124	109260	0	112016
25733	315	1273	111	109253	0	110952
25734	196	107909	162	3050	0	111317
25735	314	1501	100	109935	0	111850
25736	386	1226	146	110584	0	112342
25737	426	521	107731	3051	0	111729
25738	217	107195	1462	2066	0	110940
25739	106411	1599	1161	1074	0	110245
25740	1556	1399	106362	1066	0	110383
25741	102581	491	1443	1030	0	105545
25742	1718	460	106668	987	0	109833
25743	1326	366	1579	105022	0	108293
25744	104925	390	1293	2205	0	108813
25745	1591	447	417	106771	0	109226
25746	107193	407	308	2407	0	110315
25747	106854	441	268	2017	0	109580
25748	105541	453	297	1119	0	107410
25749	2661	105474	324	965	0	109424
25750	1616	1647	305	104280	0	107848
25751	634	1409	300	106033	0	108376
25752	564	541	300	106627	0	108032
25753	513	554	103989	3340	0	108396
25754	483	459	1590	104436	0	106968
25755	103412	472	1355	2455	0	107694
25756	104396	479	469	2111	0	107455
25757	2871	580	102660	1177	0	107288
25758	103115	442	1660	1039	0	106256
25759	103637	465	1388	977	0	106467
25760	2973	473	560	95844	0	99850
25761	95583	457	455	2379	0	98874
25762	95208	466	434	2193	0	98301
25763	3067	469	425	94092	0	98053
25764	95267	429	445	2404	0	98545
25765	94019	435	481	2045	0	96980
25766	3215	517	460	92690	0	96882
25767	2099	638	88948	2268	0	93953
25768	87649	527	1628	2090	0	91894
25769	2173	554	92172	1282	0	96181
25770	1933	525	91327	1224	0	95009
25771	999	89668	2707	1409	0	94783
25772	1047	1640	1507	87786	0	91980
25773	1040	1339	554	89590	0	92523
25774	1093	475	424	89820	0	91812
25775	1116	420	88464	3519	0	93519
25776	1100	449	88433	2304	0	92286
25777	990	87679	2712	1463	0	92844
25778	1060	1658	1572	85051	0	89341
25779	1085	1296	608	87559	0	90548
25780	1076	437	595	88685	0	90793
25781	1183	407	85679	3491	0	90760
25782	1059	84590	1871	2400	0	89920
25783	1037	1589	1526	83359	0	87511
25784	1112	1317	85803	2394	0	90626
25785	1089	502	86101	2179	0	89871
25786	83741	301	2942	1297	0	88281
25787	84613	343	1857	1128	0	87941
25788	85914	417	833	1080	0	88244
25789	3311	393	760	77703	0	82167
25790	2076	441	82929	2305	0	87751
25791	1061	80978	1873	2209	0	86121
25792	957	82548	1692	1509	0	86706
25793	1003	2147	71712	1085	0	75947
25794	1321	2654	2144	61904	0	68023
25795	788	1010	1489	55437	0	58724
25796	672	56332	795	2085	0	59884
25797	697	57567	665	1391	0	60320
25798	56193	1691	602	908	0	59394
25799	56487	910	573	793	0	58763
25800	56610	346	532	803	0	58291
25801	55243	315	549	723	0	56830
25802	52044	477	503	783	0	53807
25803	1974	49731	597	698	0	53000
25804	839	38711	467	466	0	40483
25805	352	32241	378	359	0	33330
25806	29380	688	1121	344	0	31533
25807	1007	585	457	27738	0	29787
25808	477	80	213	27399	0	28169
25809	26942	91	249	703	0	27985
25810	470	27183	285	450	0	28388
25811	415	350	238	27116	0	28119
25812	301	327	229	27389	0	28246
25813	293	122	276	27418	0	28109
25814	26095	102	259	642	0	27098
25815	502	126	196	26510	0	27334
25816	455	151	25205	427	0	26238
25817	24252	138	350	411	0	25151
25818	513	188	352	24789	0	25842
25819	419	105	24539	381	0	25444
25820	223	24429	401	361	0	25414
25821	149	22420	251	136	0	22956
25822	20350	446	533	146	0	21475
25823	19603	189	154	143	0	20089
25824	291	20262	76	91	0	20720
25825	219	169	54	20868	0	21310
25826	21611	126	40	280	0	22057
25827	241	35	37	23011	0	23324
25828	201	32	45	23845	0	24123
25829	61	39	60	24054	0	24214
25830	65	31	50	23738	0	23884
25831	49	23470	60	502	0	24081
25832	66	243	43	23902	0	24254
25833	56	201	47	23959	0	24263
25834	55	59	53	24199	0	24366
25835	73	65	23310	486	0	23934
25836	42	23408	266	356	0	24072
25837	47	259	225	23525	0	24056
25838	73	213	23409	323	0	24018
25839	80	82	22594	257	0	23013
25840	43	23084	435	122	0	23684
25841	22594	282	232	88	0	23196
25842	253	222	64	23045	0	23584
25843	22999	62	51	287	0	23399
25844	268	23268	57	262	0	23855
25845	229	286	35	23273	0	23823
25846	22513	217	31	328	0	23089
25847	22824	55	47	273	0	23199
25848	441	58	27	22738	0	23264
25849	246	44	44	22799	0	23133
25850	88	62	22547	490	0	23187
25851	92	49	253	22388	0	22782
25852	73	137	226	22800	0	23236
25853	21995	49	68	517	0	22629
25854	264	22270	52	333	0	22919
25855	232	258	21752	137	0	22379
25856	20695	212	238	145	0	21290
25857	271	21776	213	130	0	22390
25858	246	265	53	21423	0	21987
25859	21245	203	59	331	0	21838
25860	290	68	42	21295	0	21695
25861	229	81	34	21370	0	21714
25862	73	74	21117	535	0	21799
25863	76	40	262	21289	0	21667
25864	20973	67	217	383	0	21640
25865	259	68	61	21397	0	21785
25866	20908	63	51	393	0	21415
25867	300	20664	58	413	0	21435
25868	232	21226	67	236	0	21761
25869	95	443	69	21006	0	21613
25870	97	252	58	21199	0	21606
25871	20398	122	43	529	0	21092
25872	286	20577	82	392	0	21337
25873	20788	277	61	232	0	21358
25874	20781	251	72	189	0	21293
25875	452	103	75	20572	0	21202
25876	20792	99	74	383	0	21348
25877	354	102	20021	357	0	20834
25878	318	80	270	19955	0	20623
25879	137	95	20459	404	0	21095
25880	139	92	297	20486	0	21014
25881	20097	69	261	425	0	20852
25882	20029	90	77	400	0	20596
25883	483	20225	91	265	0	21064
25884	313	311	73	20005	0	20702
25885	166	245	73	19993	0	20477
25886	155	20219	74	611	0	21059
25887	145	312	67	20651	0	21175
25888	132	252	71	20236	0	20691
25889	140	20206	76	615	0	21037
25890	19482	311	74	415	0	20282
25891	19448	249	88	289	0	20074
25892	509	123	62	19468	0	20162
25893	338	116	77	19618	0	20149
25894	190	115	19412	629	0	20346
25895	188	91	278	18944	0	19501
25896	154	19421	241	455	0	20271
25897	19306	309	104	415	0	20134
25898	352	258	86	19342	0	20038
25899	336	104	62	18940	0	19442
25900	18188	122	65	626	0	19001
25901	357	18491	89	451	0	19388
25902	325	299	96	18842	0	19562
25903	176	288	71	18620	0	19155
25904	179	18723	74	645	0	19621
25905	18845	295	105	402	0	19647
25906	374	292	18673	256	0	19595
25907	323	143	18819	241	0	19526
25908	186	124	452	18717	0	19479
25909	185	133	18848	442	0	19608
25910	18204	120	316	398	0	19038
25911	418	87	237	18888	0	19630
25912	335	99	19007	434	0	19875
25913	218	104	19056	387	0	19765
25914	167	19217	445	234	0	20063
25915	18697	262	258	232	0	19449
25916	356	19386	112	256	0	20110
25917	18974	261	157	204	0	19596
25918	18620	234	82	217	0	19153
25919	424	18112	93	190	0	18819
25920	17757	236	68	160	0	18221
25921	17563	205	61	180	0	18009
25922	420	108	17344	168	0	18040
25923	289	715	183	15823	0	17010
25924	133	15884	161	242	0	16420
25925	87	15158	56	176	0	15477
25926	273	438	144	13753	0	14608
25927	12976	121	121	252	0	13470
25928	100	24	18	12792	0	12934
25929	85	32	25	13286	0	13428
25930	37	29	30	13542	0	13638
25931	46	14492	20	179	0	14737
25932	62	118	23	15304	0	15507
25933	43	111	16208	147	0	16509
25934	14832	28	140	157	0	15157
25935	16480	31	112	67	0	16690
25936	216	16478	27	49	0	16770
25937	16591	121	18	56	0	16786
25938	136	139	18	16730	0	17023
25939	140	33	16723	136	0	17032
25940	15846	15	118	130	0	16109
25941	116	16870	132	47	0	17165
25942	121	110	16	16547	0	16794
25943	17041	112	11	141	0	17305
25944	120	17373	30	140	0	17663
25945	122	17542	25	50	0	17739
25946	17432	235	33	36	0	17736
25947	139	119	17162	29	0	17449
25948	17146	36	111	22	0	17315
25949	132	27	110	17222	0	17491
25950	124	25	24	17297	0	17470
25951	50	29	17263	220	0	17562
25952	47	25	17291	118	0	17481
25953	44	31	214	17266	0	17555
25954	45	32	17243	139	0	17459
25955	36	32	17301	142	0	17511
25956	42	27	233	16596	0	16898
25957	45	28	130	16942	0	17145
25958	17214	38	38	218	0	17508
25959	147	33	27	17239	0	17446
25960	17297	22	23	143	0	17485
25961	136	17300	32	151	0	17619
25962	161	137	27	17263	0	17588
25963	56	139	17609	140	0	17944
25964	17062	35	144	143	0	17384
25965	17808	22	136	43	0	18009
25966	17948	33	39	49	0	18069
25967	17799	24	36	61	0	17920
25968	17635	27	62	49	0	17773
25969	252	23	39	17276	0	17590
25970	164	23	17354	155	0	17696
25971	50	32	17292	153	0	17527
25972	52	19	17517	58	0	17646
25973	16616	36	258	72	0	16982
25974	17386	16	146	63	0	17611
25975	240	16	44	16710	0	17010
25976	145	17559	56	147	0	17907
25977	67	116	47	17859	0	18089
25978	62	134	17824	148	0	18168
25979	71	40	17588	161	0	17860
25980	16524	33	268	66	0	16891
25981	186	25	18131	53	0	18395
25982	178	36	134	17768	0	18116
25983	18604	26	146	151	0	18927
25984	18520	24	60	147	0	18751
25985	19042	18	43	53	0	19156
25986	18995	29	41	70	0	19135
25987	294	28	18591	59	0	18972
25988	18106	23	149	55	0	18333
25989	153	18803	169	62	0	19187
25990	201	123	54	18751	0	19129
25991	103	142	18864	141	0	19250
25992	87	25	154	18648	0	18914
25993	87	45	19285	162	0	19579
25994	72	36	153	18819	0	19080
25995	62	31	164	18985	0	19242
25996	79	31	18901	261	0	19272
25997	78	28	155	18651	0	18912
25998	18946	23	179	168	0	19316
25999	172	23	68	19030	0	19293
26000	192	29	60	19256	0	19537
26001	18994	30	62	269	0	19355
26002	175	19507	55	196	0	19933
26003	19470	127	55	82	0	19734
26004	166	19751	81	75	0	20073
26005	20060	123	68	65	0	20316
26006	195	146	20021	63	0	20425
26007	188	36	154	19716	0	20094
26008	90	29	158	19927	0	20204
26009	19697	26	63	278	0	20064
26010	159	19708	80	199	0	20146
26011	177	127	62	19421	0	19787
26012	85	125	57	19188	0	19455
26013	55	18402	80	773	0	19310
26014	18463	115	65	193	0	18836
26015	155	18891	65	102	0	19213
26016	153	116	52	18237	0	18558
26017	84	118	47	17803	0	18052
26018	67	18128	65	248	0	18508
26019	17825	122	41	186	0	18174
26020	172	136	18020	74	0	18402
26021	17245	40	144	73	0	17502
26022	163	17936	143	66	0	18308
26023	161	114	51	17827	0	18153
26024	17938	115	40	159	0	18252
26025	168	30	46	18030	0	18274
26026	180	58	37	18004	0	18279
26027	18108	36	34	268	0	18446
26028	168	18065	57	178	0	18468
26029	139	18152	58	87	0	18436
26030	17690	184	40	77	0	17991
26031	144	92	17599	64	0	17899
26032	109	17115	98	48	0	17370
26033	104	179	166	15889	0	16338
26034	61	62	17897	77	0	18097
26035	27	61	93	17081	0	17262
26036	17344	16	95	111	0	17566
26037	80	18054	39	155	0	18328
26038	121	105	41	16685	0	16952
26039	26	18134	22	99	0	18281
26040	17994	104	32	98	0	18228
26041	18181	102	25	41	0	18349
26042	186	18718	28	56	0	18988
26043	122	114	20	18322	0	18578
26044	36	19552	28	125	0	19741
26045	19788	152	14	112	0	20066
26046	20020	123	16	51	0	20210
26047	250	34	26	19961	0	20271
26048	146	29	14	20439	0	20628
26049	57	40	20107	272	0	20476
26050	18592	30	141	172	0	18935
26051	185	43	20229	46	0	20503
26052	149	32	150	19729	0	20060
26053	19646	22	125	192	0	19985
26054	160	20446	46	166	0	20818
26055	20054	171	22	71	0	20318
26056	191	138	19942	53	0	20324
26057	19116	44	145	58	0	19363
26058	186	20673	126	79	0	21064
26059	20544	171	33	50	0	20798
26060	180	21353	30	65	0	21628
26061	156	178	37	21129	0	21500
26062	73	146	21028	179	0	21426
26063	78	62	20667	136	0	20943
26064	62	53	252	20468	0	20835
26065	80	62	20982	185	0	21309
26066	64	50	167	20645	0	20926
26067	72	50	131	20750	0	21003
26068	61	51	21356	294	0	21762
26069	17947	49	198	219	0	18413
26070	20882	48	146	84	0	21160
26071	263	21027	64	75	0	21429
26072	20883	162	46	64	0	21155
26073	201	118	45	20807	0	21171
26074	170	51	21658	202	0	22081
26075	67	50	180	21455	0	21752
26076	78	46	155	21686	0	21965
26077	21176	38	56	274	0	21544
26078	158	21315	45	192	0	21710
26079	141	21624	49	91	0	21905
26080	70	271	41	21599	0	21981
26081	61	144	47	21289	0	21541
26082	69	21490	44	263	0	21866
26083	61	185	21	21190	0	21457
26084	57	148	35	20839	0	21079
26085	35	20937	44	290	0	21306
26086	21009	168	24	170	0	21371
26087	187	157	46	20950	0	21340
26088	126	21502	45	216	0	21889
26089	73	181	27	21401	0	21682
26090	21100	141	37	228	0	21506
26091	184	21452	31	202	0	21869
26092	21609	194	37	84	0	21924
26093	21775	152	24	101	0	22052
26094	303	66	24	22201	0	22594
26095	23060	83	30	228	0	23401
26096	23377	56	30	169	0	23632
26097	23582	65	19	92	0	23758
26098	23555	69	31	71	0	23726
26099	333	42	27	23360	0	23762
26100	202	47	28	23598	0	23875
26101	100	68	23566	326	0	24060
26102	105	47	173	23149	0	23474
26103	98	37	117	23568	0	23820
26104	80	56	23181	344	0	23661
26105	21657	51	200	211	0	22119
26106	238	40	143	23339	0	23760
26107	185	50	23873	233	0	24341
26108	22218	37	211	224	0	22690
26109	282	44	26167	116	0	26609
26110	207	27040	257	248	0	27752
26111	89	28205	189	137	0	28620
26112	88	373	65	29714	0	30240
26113	92	200	33974	279	0	34545
26114	33057	62	331	243	0	33693
26115	36037	63	222	117	0	36439
26116	546	55	36318	99	0	37018
26117	35930	55	324	127	0	36436
26118	36807	42	249	87	0	37185
26119	518	37445	115	98	0	38176
26120	37380	299	63	87	0	37829
26121	362	233	73	37037	0	37705
26122	292	74	37578	349	0	38293
26123	124	71	324	34949	0	35468
26124	87	38222	254	316	0	38879
26125	92	39118	81	247	0	39538
26126	38775	471	63	111	0	39420
26127	38360	243	68	92	0	38763
26128	38197	74	58	96	0	38425
26129	549	61	47	37991	0	38648
26130	313	131	53	36300	0	36797
26131	113	37506	76	522	0	38217
26132	37016	325	55	288	0	37684
26133	361	38131	67	132	0	38691
26134	35221	283	47	45	0	35596
26135	321	35832	56	97	0	36306
26136	35531	284	55	60	0	35930
26137	35091	182	54	70	0	35397
26138	486	112	36	33891	0	34525
26139	256	35723	69	263	0	36311
26140	155	266	35286	176	0	35883
26141	32203	202	268	120	0	32793
26142	298	34689	183	113	0	35283
26143	214	284	34719	85	0	35302
26144	142	181	34989	62	0	35374
26145	88	102	370	32818	0	33378
26146	97	68	173	32380	0	32718
26147	99	35098	37	324	0	35558
26148	35873	248	22	198	0	36341
26149	266	206	42	34614	0	35128
26150	204	37924	40	229	0	38397
26151	113	39801	45	205	0	40164
26152	114	369	39419	101	0	40003
26153	112	206	39820	56	0	40194
26154	37567	88	347	73	0	38075
26155	298	91	40221	64	0	40674
26156	221	73	221	39008	0	39523
26157	126	80	155	40699	0	41060
26158	128	90	40922	351	0	41491
26159	111	83	235	39918	0	40347
26160	110	81	169	39912	0	40272
26161	39434	70	81	386	0	39971
26162	40760	68	65	197	0	41090
26163	391	127	79	40122	0	40719
26164	211	40778	92	263	0	41344
26165	92	42689	76	229	0	43086
26166	42468	388	110	96	0	43062
26167	314	214	42976	82	0	43586
26168	233	94	267	42398	0	42992
26169	44158	85	193	301	0	44737
26170	44374	102	97	226	0	44799
26171	455	89	81	44185	0	44810
26172	269	105	44939	280	0	45593
26173	140	146	43606	218	0	44110
26174	40944	99	432	110	0	41585
26175	43859	105	270	113	0	44347
26176	452	45029	150	131	0	45762
26177	295	46146	142	162	0	46745
26178	47205	401	114	170	0	47890
26179	48292	233	140	166	0	48831
26180	589	101	110	49745	0	50545
26181	386	92	116	50969	0	51563
26182	233	86	118	51330	0	51767
26183	50938	114	104	502	0	51658
26184	434	134	93	51264	0	51925
26185	387	154	53274	312	0	54127
26186	49512	120	326	302	0	50260
26187	391	145	212	53289	0	54037
26188	336	173	54789	342	0	55640
26189	50653	136	276	317	0	51382
26190	51191	216	238	155	0	51800
26191	452	59348	129	174	0	60103
26192	341	60963	122	182	0	61608
26193	291	481	59980	128	0	60880
26194	55055	278	300	223	0	55856
26195	367	62207	241	214	0	63029
26196	409	352	61461	136	0	62358
26197	55526	328	319	195	0	56368
26198	412	65748	236	232	0	66628
26199	380	435	65170	144	0	66129
26200	59837	313	321	182	0	60653
26201	408	66115	231	176	0	66930
26202	354	349	95	65189	0	65987
26203	65285	257	101	370	0	66013
26204	355	66117	147	367	0	66986
26205	311	478	135	65287	0	66211
26206	64311	220	169	361	0	65061
26207	405	109	65524	260	0	66298
26208	216	64899	332	198	0	65645
26209	296	362	63716	114	0	64488
26210	159	424	307	61287	0	62177
26211	110	98	62375	307	0	62890
26212	65	60141	259	235	0	60700
26213	73	57058	196	92	0	57419
26214	249	343	175	55553	0	56320
26215	39	89	30	54207	0	54365
26216	52	29	25	55204	0	55310
26217	66	67	57604	212	0	57949
26218	47	23	131	57486	0	57687
26219	57367	25	125	190	0	57707
26220	55627	43	63	166	0	55899
26221	276	56	59741	77	0	60150
26222	118	60460	153	69	0	60800
26223	59979	135	98	68	0	60280
26224	124	60512	67	115	0	60818
26225	60105	136	71	105	0	60417
26226	59944	112	37	93	0	60186
26227	254	95	60364	70	0	60783
26228	127	62697	179	120	0	63123
26229	82	152	98	62752	0	63084
26230	87	141	63212	160	0	63600
26231	57944	81	188	171	0	58384
26232	195	44	95	63407	0	63741
26233	186	86	63546	162	0	63980
26234	60001	31	201	188	0	60421
26235	308	94	66690	80	0	67172
26236	225	43	203	66722	0	67193
26237	69083	33	161	285	0	69562
26238	244	72933	64	273	0	73514
26239	290	293	75538	67	0	76188
26240	73644	193	281	128	0	74246
26241	82447	62	227	104	0	82840
26242	578	87414	95	154	0	88241
26243	358	411	64	87539	0	88372
26244	103	331	39	87994	0	88467
26245	87439	69	34	767	0	88309
26246	482	71	41	88005	0	88599
26247	424	109	88549	509	0	89591
26248	118	39	447	87211	0	87815
26249	86629	36	345	553	0	87563
26250	453	87893	141	652	0	89139
26251	423	524	46	84322	0	85315
26252	92	88162	103	511	0	88868
26253	88023	539	63	417	0	89042
26254	578	410	42	94203	0	95233
26255	474	97	64	95790	0	96425
26256	107	97254	99	1402	0	98862
26257	257	854	95636	636	0	97383
26258	120	583	821	93797	0	95321
26259	145	93	579	95679	0	96496
26260	156	87	102	94675	0	95020
26261	85	95250	174	1395	0	96904
26262	229	831	95851	647	0	97558
26263	182	644	97687	158	0	98671
26264	92656	126	1387	205	0	94374
26265	97417	94	630	208	0	98349
26266	1442	144	99899	128	0	101613
26267	95170	58	881	220	0	96329
26268	1015	141	102351	203	0	103710
26269	94843	101	965	209	0	96118
26270	907	102431	725	436	0	104499
26271	102673	873	244	215	0	104005
26272	1140	734	104446	239	0	106559
26273	862	245	105953	203	0	107263
26274	216	134	1555	108518	0	110423
26275	113467	131	758	1286	0	115642
26276	1275	118476	291	1081	0	121123
26277	1129	1370	127106	385	0	129990
26278	297	976	1675	125460	0	128408
26279	291	185	1149	129290	0	130915
26280	128426	147	252	2713	0	131538
26281	127916	140	185	1337	0	129578
26282	2765	163	192	127401	0	130521
26283	128814	152	201	1836	0	131003
26284	1999	242	126395	1326	0	129962
26285	1420	140	1741	123386	0	126687
26286	420	153	1238	126963	0	128774
26287	126092	160	310	2884	0	129446
26288	125006	173	224	1482	0	126885
26289	2926	187	231	123744	0	127088
26290	123642	164	285	1896	0	125987
26291	2054	216	120531	1439	0	124240
26292	1378	118659	1859	589	0	122485
26293	622	1696	120014	411	0	122743
26294	429	1473	1877	118282	0	122061
26295	116205	267	1367	1963	0	119802
26296	1805	116909	475	1654	0	120843
26297	1471	1754	325	114508	0	118058
26298	545	1306	327	111011	0	113189
26299	380	113549	441	2963	0	117333
26300	508	1981	347	114607	0	117443
26301	523	1443	447	114658	0	117071
26302	534	321	366	115916	0	117137
26303	598	216	343	115565	0	116722
26304	633	250	360	113788	0	115031
26305	607	111303	461	3337	0	115708
26306	651	1729	404	113245	0	116029
26307	715	1256	437	112861	0	115269
26308	757	390	109963	3345	0	114455
26309	659	108881	1987	2045	0	113572
26310	739	1859	1495	109002	0	113095
26311	789	1359	543	109019	0	111710
26312	818	395	480	108148	0	109841
26313	730	106944	573	3530	0	111777
26314	939	1818	107513	1993	0	112263
26315	795	1400	2042	108334	0	112571
26316	796	509	109226	2521	0	113052
26317	843	443	106768	1956	0	110010
26318	715	450	3129	105550	0	109844
26319	106006	373	1647	2566	0	110592
26320	2148	415	607	106327	0	109497
26321	1760	432	464	103511	0	106167
26322	703	104484	595	3670	0	109452
26323	703	1900	412	106660	0	109675
26324	710	1405	478	107363	0	109956
26325	797	524	105799	3899	0	111019
26326	609	105320	2008	2525	0	110462
26327	662	1914	1564	105792	0	109932
26328	101968	1528	652	2763	0	106911
26329	2162	661	103639	2321	0	108783
26330	1614	534	2013	103151	0	107312
26331	721	496	1614	104687	0	107518
26332	101487	531	640	3854	0	106512
26333	1959	101776	582	2820	0	107137
26334	98618	1943	476	1603	0	102640
26335	1991	99280	630	1494	0	103395
26336	1446	2096	509	96569	0	100620
26337	94286	1444	566	2866	0	99162
26338	2065	601	93020	2420	0	98106
26339	1501	89638	2101	1576	0	94816
26340	633	89608	1676	1514	0	93431
26341	80047	2462	985	1317	0	84811
26342	1799	1452	647	76228	0	80126
26343	1357	76887	660	2492	0	81396
26344	600	79106	543	2359	0	82608
26345	673	2445	485	78408	0	82011
26346	668	1446	403	79349	0	81866
26347	75842	641	471	3474	0	80428
26348	1699	76219	612	2479	0	81009
26349	1401	1912	782	75879	0	79974
26350	681	1402	74657	2426	0	79166
26351	545	74444	1875	2320	0	79184
26352	747	1617	73197	1447	0	77008
26353	646	72355	1837	1348	0	76186
26354	1165	1927	1925	64326	0	69343
26355	652	1060	400	61819	0	63931
26356	595	63171	433	2505	0	66704
26357	617	1481	63068	1689	0	66855
26358	61794	1200	1275	1186	0	65455
26359	1308	724	1093	65462	0	68587
26360	1025	686	498	66756	0	68965
26361	563	690	66091	2595	0	69939
26362	453	711	1412	66356	0	68932
26363	454	766	66147	2041	0	69408
26364	491	800	1310	65571	0	68172
26365	441	686	66612	2070	0	69809
26366	342	65027	1326	2137	0	68832
26367	467	1617	66110	1309	0	69503
26368	503	1338	1260	64519	0	67620
26369	63253	680	947	2108	0	66988
26370	1240	62376	426	1901	0	65943
26371	1035	1837	403	61138	0	64413
26372	547	1232	60280	1866	0	63925
26373	300	60993	1459	1628	0	64380
26374	330	1521	965	52314	0	55130
26375	318	969	52374	1155	0	54816
26376	157	45707	835	715	0	47414
26377	34857	771	986	492	0	37106
26378	32303	303	214	165	0	32985
26379	415	82	69	32643	0	33209
26380	32846	58	72	283	0	33259
26381	250	56	60	32685	0	33051
26382	230	60	49	33295	0	33634
26383	97	82	36014	468	0	36661
26384	69	61	238	35679	0	36047
26385	68	56	238	36321	0	36683
26386	36012	49	68	478	0	36607
26387	35028	48	53	312	0	35441
26388	413	36451	80	157	0	37101
26389	270	266	37066	110	0	37712
26390	89	271	248	36493	0	37101
26391	99	88	36882	296	0	37365
26392	33301	74	262	311	0	33948
26393	297	79	36646	141	0	37163
26394	234	70	238	35044	0	35586
26395	58	36504	240	261	0	37063
26396	65	223	96	36472	0	36856
26397	70	208	82	36425	0	36785
26398	85	90	38170	480	0	38825
26399	72	55	273	37774	0	38174
26400	37995	51	253	347	0	38646
26401	37728	51	99	329	0	38207
26402	38014	58	81	161	0	38314
26403	38049	62	95	171	0	38377
26404	381	37951	123	194	0	38649
26405	224	38485	147	185	0	39041
26406	105	390	102	36661	0	37258
26407	105	217	119	38183	0	38624
26408	111	37744	94	504	0	38453
26409	128	230	96	38677	0	39131
26410	118	263	86	38681	0	39148
26411	111	112	104	38745	0	39072
26412	80	117	101	38751	0	39049
26413	88	109	121	38943	0	39261
26414	37885	94	126	544	0	38649
26415	267	37957	137	425	0	38786
26416	311	286	37341	250	0	38188
26417	145	246	299	37166	0	37856
26418	124	110	264	37558	0	38056
26419	132	110	126	37635	0	38003
26420	36913	103	138	583	0	37737
26421	294	40472	135	505	0	41406
26422	346	342	154	39735	0	40577
26423	153	41944	143	565	0	42805
26424	212	493	98	40416	0	41219
26425	183	40618	130	607	0	41538
26426	213	539	42017	532	0	43301
26427	155	394	572	43969	0	45090
26428	174	197	51251	737	0	52359
26429	166	142	833	50597	0	51738
26430	158	137	584	54087	0	54966
26431	54225	147	193	1434	0	55999
26432	54190	151	148	811	0	55300
26433	55334	139	178	355	0	56006
26434	55146	112	147	379	0	55784
26435	55077	116	167	345	0	55705
26436	1439	134	152	52510	0	54235
26437	713	53928	179	1029	0	55849
26438	292	880	149	53850	0	55171
26439	313	659	52948	1091	0	55011
26440	50874	159	876	826	0	52735
26441	53334	138	614	395	0	54481
26442	1487	140	196	53226	0	55049
26443	786	143	131	52231	0	53291
26444	321	52017	151	1536	0	54025
26445	306	855	122	53031	0	54314
26446	283	622	142	51762	0	52809
26447	269	51873	154	1561	0	53857
26448	245	874	135	52982	0	54236
26449	50367	611	157	1201	0	52336
26450	970	226	51315	908	0	53419
26451	48338	164	884	546	0	49932
26452	1042	220	51024	447	0	52733
26453	770	166	911	49579	0	51426
26454	319	161	624	47889	0	48993
26455	283	49326	230	1545	0	51384
26456	306	49848	182	949	0	51285
26457	382	1396	141	47356	0	49275
26458	390	666	48010	1060	0	50126
26459	43783	165	819	739	0	45506
26460	904	122	569	45228	0	46823
26461	587	45243	202	1047	0	47079
26462	322	762	113	45448	0	46645
26463	286	601	95	44068	0	45050
26464	280	43849	137	1377	0	45643
26465	303	811	83	42234	0	43431
26466	269	480	39823	903	0	41475
26467	269	184	39090	580	0	40123
26468	190	206	984	36050	0	37430
26469	110	38926	485	711	0	40232
26470	148	697	101	38495	0	39441
26471	38426	462	105	810	0	39803
26472	38669	165	89	561	0	39484
26473	37047	116	84	286	0	37533
26474	1039	36883	117	300	0	38339
26475	504	740	36432	238	0	37914
26476	35532	481	690	264	0	36967
26477	36783	186	448	273	0	37690
26478	1030	36264	152	314	0	37760
26479	520	723	149	35751	0	37143
26480	36231	491	135	830	0	37687
26481	36452	162	146	630	0	37390
26482	36831	149	180	265	0	37425
26483	1197	119	155	33354	0	34825
26484	33797	110	165	883	0	34955
26485	904	184	144	33601	0	34833
26486	694	136	133	33814	0	34777
26487	33319	173	142	1233	0	34867
26488	917	202	136	32876	0	34131
26489	32372	158	145	988	0	33663
26490	937	188	154	32382	0	33661
26491	698	180	138	32734	0	33750
26492	31843	185	121	1362	0	33511
26493	992	199	31128	764	0	33083
26494	781	164	720	31557	0	33222
26495	488	159	530	31783	0	32960
26496	447	168	177	31648	0	32440
26497	414	167	150	32118	0	32849
26498	413	188	165	29753	0	30519
26499	369	29229	178	1483	0	31259
26500	469	748	143	29542	0	30902
26501	480	513	28955	1035	0	30983
26502	501	204	721	29462	0	30888
26503	492	189	459	29401	0	30541
26504	443	194	162	30287	0	31086
26505	377	213	29131	1427	0	31148
26506	304	286	29362	864	0	30816
26507	28632	242	1116	534	0	30524
26508	29295	181	574	500	0	30550
26509	1236	29686	250	512	0	31684
26510	748	813	151	30235	0	31947
26511	349	568	145	31422	0	32484
26512	322	258	185	32020	0	32785
26513	30873	204	199	1494	0	32770
26514	31424	195	217	913	0	32749
26515	1241	212	174	31298	0	32925
26516	680	244	144	31699	0	32767
26517	289	255	191	31991	0	32726
26518	303	217	199	32033	0	32752
26519	30409	176	264	1499	0	32348
26520	854	211	29848	917	0	31830
26521	512	25677	688	482	0	27359
26522	185	24995	399	428	0	26007
26523	23261	713	145	369	0	24488
26524	606	864	196	22742	0	24408
26525	420	197	23004	692	0	24313
26526	180	157	20951	488	0	21776
26527	140	19851	651	314	0	20956
26528	12874	123	465	119	0	13581
26529	145	80	12630	93	0	12948
26530	9266	90	146	39	0	9541
26531	57	11	37	9829	0	9934
26532	41	16	12	9816	0	9885
26533	12	9881	13	83	0	9989
26534	12	10292	14	52	0	10370
26535	10129	54	6	45	0	10234
26536	10147	31	13	23	0	10214
26537	54	10509	12	43	0	10618
26538	42	44	10147	19	0	10252
26539	22	36	10393	29	0	10480
26540	14	43	63	10226	0	10346
26541	10637	7	46	55	0	10745
26542	57	10787	17	52	0	10913
26543	35	44	9	11285	0	11373
26544	11375	31	9	67	0	11482
26545	55	8	34	11509	0	11606
26546	49	8	9	12048	0	12114
26547	11872	11	7	103	0	11993
26548	59	12176	3	81	0	12319
26549	56	12807	11	43	0	12917
26550	45	105	13108	26	0	13284
26551	22	61	65	13253	0	13401
26552	23	12	48	13546	0	13629
26553	19	17	13959	116	0	14111
26554	11485	12	102	108	0	11707
26555	13176	9	56	51	0	13292
26556	124	12	14049	31	0	14216
26557	11882	16	75	62	0	12035
26558	85	21	14790	25	0	14921
26559	61	15740	86	38	0	15925
26560	30	69	56	16450	0	16605
26561	23	52	14	17037	0	17126
26562	17088	14	20	146	0	17268
26563	17098	7	17	77	0	17199
26564	16989	10	18	34	0	17051
26565	17138	8	10	33	0	17189
26566	16953	13	19	33	0	17018
26567	161	21	16999	29	0	17210
26568	73	17175	76	36	0	17360
26569	41	81	60	16684	0	16866
26570	20	17499	24	77	0	17620
26571	14	17684	23	77	0	17798
26572	29	112	16	17321	0	17478
26573	22	66	12	17474	0	17574
26574	39	42	17245	127	0	17453
26575	15171	14	81	91	0	15357
26576	16873	15	59	35	0	16982
26577	110	16888	25	34	0	17057
26578	16915	65	39	25	0	17044
26579	17624	51	8	48	0	17731
26580	125	22	6	17482	0	17635
26581	63	18	18532	82	0	18695
26582	45	14	18503	60	0	18622
26583	18151	11	108	39	0	18309
26584	18813	21	69	28	0	18931
26585	122	18931	18	32	0	19103
26586	79	19921	12	29	0	20041
26587	44	120	10	20577	0	20751
26588	20676	70	13	87	0	20846
26589	93	43	21381	62	0	21579
26590	68	29	93	21636	0	21826
26591	22658	19	66	117	0	22860
26592	22853	11	32	92	0	22988
26593	156	23	15	23930	0	24124
26594	24239	14	14	132	0	24399
26595	112	30	23532	84	0	23758
26596	101	41	26060	36	0	26238
26597	50	17	140	25505	0	25712
26598	34	11	77	27239	0	27361
26599	33	15	33	27098	0	27179
26600	33	27201	29	162	0	27425
26601	37	27846	29	95	0	28007
26602	23	168	20	27893	0	28104
26603	28395	76	17	151	0	28639
26604	94	28	16	28815	0	28953
26605	79	14	20	28890	0	29003
26606	35	29206	22	164	0	29427
26607	26	30363	35	102	0	30526
26608	32	146	15	30313	0	30506
26609	29	85	10	29717	0	29841
26610	29353	36	10	157	0	29556
26611	90	29154	18	101	0	29363
26612	29338	78	17	57	0	29490
26613	112	67	8	29831	0	30018
26614	121	35	29611	105	0	29872
26615	52	41	29352	95	0	29540
26616	29588	30	170	54	0	29842
26617	120	27	76	32145	0	32368
26618	74	19	29	32291	0	32413
26619	38	15	15	32702	0	32770
26620	48	40	33296	193	0	33577
26621	29	32	84	33094	0	33239
26622	24	34164	77	145	0	34410
26623	38	108	27	34895	0	35068
26624	20	63	26	34812	0	34921
26625	28	36223	35	168	0	36454
26626	30	143	12	37279	0	37464
26627	36662	77	13	186	0	36938
26628	146	37306	31	151	0	37634
26629	38698	168	13	82	0	38961
26630	39166	120	21	66	0	39373
26631	338	45	18	39646	0	40047
26632	198	26	12	39681	0	39917
26633	72	24	15	40600	0	40711
26634	80	49	39355	401	0	39885
26635	45	39290	207	277	0	39819
26636	37	40244	172	114	0	40567
26637	38	333	45	39492	0	39908
26638	39155	153	37	238	0	39583
26639	203	48	28	39131	0	39410
26640	196	90	40110	278	0	40674
26641	53	39680	192	245	0	40170
26642	36	40488	175	108	0	40807
26643	40001	278	61	80	0	40420
26644	40384	167	45	75	0	40671
26645	299	44437	56	96	0	44888
26646	45094	201	42	81	0	45418
26647	288	188	44111	34	0	44621
26648	237	105	43873	49	0	44264
26649	44667	31	360	63	0	45121
26650	46557	36	222	71	0	46886
26651	408	33	48	46545	0	47034
26652	46765	26	45	295	0	47131
26653	328	63	47010	220	0	47621
26654	292	84	50080	92	0	50548
26655	123	33	493	57696	0	58345
26656	90	34	273	66633	0	67030
26657	77	30	84	69570	0	69761
26658	88	29	55	71860	0	72032
26659	89	47	50	76846	0	77032
26660	146	77	75349	1428	0	77000
26661	99	44	697	74878	0	75718
26662	75248	40	665	1046	0	76999
26663	736	46	141	76460	0	77383
26664	76082	34	87	1052	0	77255
26665	840	51	89	76436	0	77416
26666	77741	49	115	1071	0	78976
26667	80034	66	72	904	0	81076
26668	1441	67	85	79616	0	81209
26669	852	54	113	80824	0	81843
26670	79697	43	94	1565	0	81399
26671	79362	49	85	986	0	80482
26672	1603	83	81176	406	0	83268
26673	984	59	790	80208	0	82041
26674	433	53	652	83163	0	84301
26675	82471	48	169	1597	0	84285
26676	82883	58	130	978	0	84049
26677	1597	55	108	83093	0	84853
26678	975	54	120	83930	0	85079
26679	442	44	121	84317	0	84924
26680	334	58	133	82979	0	83504
26681	260	80239	192	1949	0	82640
26682	234	81741	165	1340	0	83480
26683	286	1382	109	80603	0	82380
26684	249	81245	158	1266	0	82918
26685	270	875	132	82020	0	83297
26686	332	780	80114	1388	0	82614
26687	275	344	78141	1282	0	80042
26688	268	79990	1400	845	0	82503
26689	308	899	790	79115	0	81112
26690	385	834	78817	1331	0	81367
26691	372	295	948	76430	0	78045
26692	298	221	809	79489	0	80817
26693	76745	191	337	1898	0	79171
26694	1092	216	265	78518	0	80091
26695	1090	165	79437	1402	0	82094
26696	574	142	77678	1273	0	79667
26697	462	77109	1503	813	0	79887
26698	445	80776	949	752	0	82922
26699	80413	1350	381	720	0	82864
26700	1260	786	85373	712	0	88131
26701	1058	240	980	84261	0	86539
26702	85363	129	840	1422	0	87754
26703	84121	173	368	1351	0	86013
26704	1657	86615	343	840	0	89455
26705	1163	934	297	84258	0	86652
26706	569	854	282	87841	0	89546
26707	453	314	231	87836	0	88834
26708	85198	238	256	2192	0	87884
26709	1202	279	85272	1532	0	88285
26710	1000	87083	967	958	0	90008
26711	563	940	827	87051	0	89381
26712	489	865	335	88680	0	90369
26713	420	457	87733	2234	0	90844
26714	438	304	1028	86715	0	88485
26715	393	301	916	88455	0	90065
26716	361	298	404	88799	0	89862
26717	379	301	398	88527	0	89605
26718	422	314	86748	2330	0	89814
26719	366	257	1169	86273	0	88065
26720	397	283	87929	1918	0	90527
26721	355	86922	1253	1773	0	90303
26722	366	897	1063	87117	0	89443
26723	429	854	444	88589	0	90316
26724	473	359	86894	2324	0	90050
26725	367	85231	1086	1973	0	88657
26726	503	954	998	84253	0	86708
26727	537	875	85765	1512	0	88689
26728	416	84981	1026	1559	0	87982
26729	469	994	950	84651	0	87064
26730	538	872	85132	1381	0	87923
26731	486	440	997	83945	0	85868
26732	521	316	863	84345	0	86045
26733	428	311	469	86714	0	87922
26734	84878	344	348	1953	0	87523
26735	957	84887	406	1618	0	87868
26736	85080	857	348	990	0	87275
26737	1128	815	85285	916	0	88144
26738	86518	336	928	1011	0	88793
26739	91083	268	853	1022	0	93226
26740	1481	302	408	90558	0	92749
26741	92828	346	310	1571	0	95055
26742	93148	284	348	1433	0	95213
26743	95294	307	389	993	0	96983
26744	1585	324	358	94330	0	96597
26745	1013	303	338	92400	0	94054
26746	450	298	90108	1810	0	92666
26747	439	270	88037	1276	0	90022
26748	84778	238	1415	854	0	87285
26749	889	830	936	86894	0	89549
26750	724	89863	475	1278	0	92340
26751	89309	735	506	1134	0	91684
26752	777	90490	436	768	0	92471
26753	710	90379	423	887	0	92399
26754	831	1362	87503	892	0	90588
26755	347	625	88305	371	0	89648
26756	493	1749	1214	82479	0	85935
26757	210	186	89354	428	0	90178
26758	177	218	82982	333	0	83710
26759	76224	73	218	152	0	76667
26760	80882	24	126	165	0	81197
26761	159	73	34	82120	0	82386
26762	124	54	33	83979	0	84190
26763	136	136	86156	213	0	86641
26764	39	87823	122	213	0	88197
26765	42	129	99	88139	0	88409
26766	93874	92	50	305	0	94321
26767	129	29	30	96307	0	96495
26768	108	98114	81	302	0	98605
26769	209	214	98410	217	0	99050
26770	32	101264	153	117	0	101566
26771	101050	142	148	138	0	101478
26772	99596	155	40	109	0	99900
26773	261	46	29	99471	0	99807
26774	237	121	102266	193	0	102817
26775	144	157	99296	240	0	99837
26776	34	102609	399	138	0	103180
26777	75	247	232	100307	0	100861
26778	47	187	49	103051	0	103334
26779	145	157	102597	400	0	103299
26780	66	33	198	100295	0	100592
26781	38	107511	285	247	0	108081
26782	64	292	55	107656	0	108067
26783	68	280	49	108319	0	108716
26784	184	171	108452	596	0	109403
26785	72	80	328	105666	0	106146
26786	106399	42	405	456	0	107302
26787	459	121	109593	351	0	110524
26788	467	164	110379	143	0	111153
26789	71	112111	822	201	0	113205
26790	113	481	422	113801	0	114817
26791	100	412	121	118869	0	119502
26792	165	180	118734	989	0	120068
26793	110353	104	700	597	0	111754
26794	613	97	530	118293	0	119533
26795	663	190	118630	643	0	120126
26796	169	110	647	114954	0	115880
26797	175	167	120978	773	0	122093
26798	255	152	118571	662	0	119640
26799	87	119689	1241	256	0	121273
26800	183	679	602	110409	0	111873
26801	55	118129	246	672	0	119102
26802	113174	666	151	615	0	114606
26803	753	635	116943	265	0	118596
26804	517	116038	762	292	0	117609
26805	155	669	605	115527	0	116956
26806	114115	561	211	827	0	115714
26807	562	116274	276	844	0	117956
26808	551	669	163	116265	0	117648
26809	148	588	163	115641	0	116540
26810	93	119436	233	1242	0	121004
26811	118944	762	158	779	0	120643
26812	757	666	180	134180	0	135783
26813	678	211	162	139740	0	140791
26814	342	232	138493	2443	0	141510
26815	124	144429	1572	1493	0	147618
26816	185	1569	1213	144469	0	147436
26817	257	1261	356	153559	0	155433
26818	144	159724	331	2860	0	163059
26819	276	2049	193	160342	0	162860
26820	282	1575	288	164020	0	166165
26821	216	422	214	164499	0	165351
26822	126	166396	346	3835	0	170703
26823	162790	2146	264	1982	0	167182
26824	2294	1756	166426	665	0	171141
26825	157579	453	2292	598	0	160922
26826	2320	166159	1853	512	0	170844
26827	1669	2288	485	165242	0	169684
26828	553	1815	166733	2537	0	171638
26829	324	570	2323	165373	0	168590
26830	360	391	1792	166231	0	168774
26831	337	327	522	170445	0	171631
26832	467	532	168133	4175	0	173307
26833	224	166766	2517	3061	0	172568
26834	469	2372	169347	1057	0	173245
26835	234	170589	2848	1102	0	174773
26836	570	2692	171938	886	0	176086
26837	345	1988	2710	168787	0	173830
26838	164243	718	1998	3077	0	170036
26839	2099	171482	760	2831	0	177172
26840	1816	2603	172638	1313	0	178370
26841	426	172222	2559	1311	0	176518
26842	584	2884	174059	1154	0	178681
26843	424	2150	2793	165212	0	170579
26844	621	947	2128	158692	0	162388
26845	412	170176	981	4255	0	175824
26846	486	175092	845	2752	0	179175
26847	172159	4283	770	1411	0	178623
26848	2621	2529	861	173739	0	179750
26849	2198	1273	175134	3402	0	182007
26850	752	832	2858	173876	0	178318
26851	669	1009	177459	3886	0	183023
26852	650	1056	177659	3069	0	182434
26853	618	930	4563	164123	0	170234
26854	465	172537	2761	3355	0	179118
26855	163978	2991	1238	2928	0	171135
26856	2650	2555	1025	162444	0	168674
26857	2132	1183	1100	155780	0	160195
26858	668	161467	1229	4774	0	168138
26859	158969	3098	1047	2961	0	166075
26860	159964	2567	1154	1667	0	165352
26861	4231	1275	1171	153961	0	160638
26862	2293	156613	1243	3455	0	163604
26863	802	169711	1341	3145	0	174999
26864	167359	4488	1147	1834	0	174828
26865	2732	2931	169219	1502	0	176384
26866	159963	1467	3270	1508	0	166208
26867	162227	1292	2623	1612	0	167754
26868	161252	1168	1293	1579	0	165292
26869	4210	162420	1124	1810	0	169564
26870	2456	3234	1189	163962	0	170841
26871	164802	2598	1184	3547	0	172131
26872	165216	1351	1149	3005	0	170721
26873	4056	166461	1443	1852	0	173812
26874	169838	3062	1123	1717	0	175740
26875	2946	2614	1117	172459	0	179136
26876	2317	1308	1104	171876	0	176605
26877	965	173716	1133	4833	0	180647
26878	1040	3082	1000	177240	0	182362
26879	1056	2708	943	177626	0	182333
26880	1057	178607	1095	5087	0	185846
26881	1169	3004	923	168412	0	173508
26882	897	177753	1057	3827	0	183534
26883	176168	3280	1094	2937	0	183479
26884	170738	2661	1094	1822	0	176315
26885	4052	175155	1014	2094	0	182315
26886	2701	3088	173427	1824	0	181040
26887	1408	2926	2595	172264	0	179193
26888	1428	1611	174506	3322	0	180867
26889	1194	170106	2835	3137	0	177272
26890	1257	172187	2205	1758	0	177407
26891	162720	3707	1114	1292	0	168833
26892	2898	171060	1039	1354	0	176351
26893	2769	2793	901	161960	0	168423
26894	1480	169737	1033	2469	0	174719
26895	1429	172395	808	2362	0	176994
26896	169280	3870	791	1570	0	175511
26897	2892	2388	758	170118	0	176156
26898	2529	1510	170743	2965	0	177747
26899	1502	1383	170228	2891	0	176004
26900	1183	174580	3568	1793	0	181124
26901	172752	2899	2098	1431	0	179180
26902	2614	178475	1211	1315	0	183615
26903	2353	3322	745	187476	0	193896
26904	188403	2569	873	3106	0	194951
26905	3165	1431	704	192953	0	198253
26906	2714	1327	759	191777	0	196577
26907	1404	195620	825	4753	0	202602
26908	1398	3255	732	197684	0	203069
26909	1152	3037	198173	3462	0	205824
26910	182028	1435	2817	2863	0	189143
26911	2832	202918	2324	1523	0	209597
26912	1916	196431	762	1028	0	200137
26913	188421	3153	519	746	0	192839
26914	2356	2153	190687	749	0	195945
26915	172592	1110	2112	653	0	176467
26916	1914	200478	1656	753	0	204801
26917	1226	210875	503	587	0	213191
26918	859	3509	211195	479	0	216042
26919	306	216758	2447	587	0	220098
26920	400	2659	1640	198245	0	202944
26921	353	1601	289	200303	0	202546
26922	163	209646	285	3116	0	213210
26923	280	2151	104	208730	0	211265
26924	211191	1553	130	2189	0	215063
26925	2258	510	211559	1546	0	215873
26926	206458	340	2077	479	0	209354
26927	214214	292	1485	406	0	216397
26928	213827	273	268	355	0	214723
26929	3852	439	214862	241	0	219394
26930	1847	330	2170	209013	0	213360
26931	656	408	215939	2152	0	219155
26932	201781	282	2424	1691	0	206178
26933	202346	384	1625	541	0	204896
26934	3430	211861	502	427	0	216220
26935	1878	2375	227	205261	0	209741
26936	466	214471	410	2279	0	217626
26937	651	2515	215246	1682	0	220094
26938	496	1755	2313	209796	0	214360
26939	212425	538	1743	2521	0	217227
26940	211924	417	416	1820	0	214577
26941	3960	495	400	198175	0	203030
26942	1958	205055	555	2260	0	209828
26943	921	2377	209873	1701	0	214872
26944	627	1913	211284	508	0	214332
26945	187381	580	4094	656	0	192711
26946	2838	566	212017	524	0	215945
26947	1951	209576	2702	923	0	215152
26948	825	2558	1899	204948	0	210230
26949	763	2136	210622	2358	0	215879
26950	610	716	2636	200272	0	204234
26951	705	573	209217	2737	0	213232
26952	182439	497	2904	2093	0	187933
26953	2698	525	2076	196363	0	201662
26954	2057	203947	750	2595	0	209349
26955	766	205360	630	2210	0	208966
26956	797	4245	611	200509	0	206162
26957	779	2115	584	196696	0	200174
26958	711	198641	792	4163	0	204307
26959	1007	2814	199101	2073	0	204995
26960	805	2162	2768	194532	0	200267
26961	920	941	202460	2746	0	207067
26962	755	872	197876	2121	0	201624
26963	169791	660	4406	982	0	175839
26964	2739	186235	2409	1031	0	192414
26965	185179	2901	853	679	0	189612
26966	3019	2311	916	176067	0	182313
26967	2223	183655	884	2861	0	189623
26968	1094	3084	979	183594	0	188751
26969	956	2415	935	178441	0	182747
26970	917	179308	851	4443	0	185519
26971	1059	3163	176530	2648	0	183400
26972	1162	2378	2879	175829	0	182248
26973	175415	1039	2416	3342	0	182212
26974	3248	957	1108	173734	0	179047
26975	2614	878	1087	172039	0	176618
26976	1425	1047	169699	4609	0	176780
26977	1210	167709	3241	2711	0	174871
26978	1271	2990	2424	164699	0	171384
26979	1244	2531	166221	3006	0	173002
26980	1232	1366	165054	2495	0	170147
26981	151282	1147	4795	1458	0	158682
26982	3052	161509	2898	1597	0	169056
26983	158736	3069	1372	1203	0	164380
26984	3112	161036	1276	1396	0	166820
26985	2508	162185	1196	1465	0	167354
26986	157636	4694	1132	1351	0	164813
26987	3303	2688	1208	152086	0	159285
26988	2706	156655	1441	3197	0	163999
26989	1645	3045	1098	158835	0	164623
26990	156256	2313	1090	3519	0	163178
26991	3629	1213	157375	2699	0	164916
26992	2692	1111	155545	1341	0	160689
26993	145773	888	4922	1365	0	152948
26994	3208	151677	3273	1449	0	159607
26995	2796	2989	151661	1183	0	158629
26996	1530	151523	3538	1369	0	157960
26997	1490	3290	2692	144862	0	152334
26998	1215	2671	148385	3254	0	155525
26999	991	1218	3385	144325	0	149919
27000	950	1081	144431	3669	0	150131
27001	133302	1144	3476	2753	0	140675
27002	2952	139577	2754	1536	0	146819
27003	127241	2561	1198	1135	0	132135
27004	2740	2131	1077	115582	0	121530
27005	1816	131135	1241	2577	0	136769
27006	129002	2802	1213	2000	0	135017
27007	126908	1969	1260	1088	0	131225
27008	3725	992	127384	1122	0	133223
27009	1985	1029	124598	866	0	128478
27010	105198	742	3720	806	0	110466
27011	2048	110313	2134	974	0	115469
27012	1246	105238	1176	796	0	108456
27013	1444	5450	1611	97076	0	105581
27014	884	1461	99267	2038	0	103650
27015	641	94380	2108	1386	0	98515
27016	550	82389	1322	751	0	85012
27017	1999	1314	793	53603	0	57709
27018	55382	515	301	655	0	56853
27019	55505	203	177	506	0	56391
27020	56327	164	161	223	0	56875
27021	994	215	56117	175	0	57501
27022	54875	177	625	184	0	55861
27023	56018	162	509	237	0	56926
27024	56738	199	190	171	0	57298
27025	996	209	140	53953	0	55298
27026	519	55600	159	609	0	56887
27027	54586	593	169	441	0	55789
27028	556	55345	198	184	0	56283
27029	454	613	160	54624	0	55851
27030	218	472	57285	621	0	58596
27031	181	200	617	56188	0	57186
27032	195	146	475	57175	0	57991
27033	193	180	57409	913	0	58695
27034	160	56636	606	548	0	57950
27035	177	562	369	52620	0	53728
27036	51401	404	161	521	0	52487
27037	495	50758	135	423	0	51811
27038	49427	473	82	164	0	50146
27039	571	501	78	47423	0	48573
27040	447	49353	118	461	0	50379
27041	48341	466	121	350	0	49278
27042	483	49309	133	141	0	50066
27043	396	442	47858	85	0	48781
27044	46678	437	485	114	0	47714
27045	46530	220	310	78	0	47138
27046	645	47081	107	88	0	47921
27047	357	442	45406	108	0	46313
27048	99	47059	395	86	0	47639
27049	186	780	385	37388	0	38739
27050	92	312	69	46900	0	47373
27051	88	114	43	46635	0	46880
27052	83	47257	56	701	0	48097
27053	132	433	36	47183	0	47784
27054	121	299	52	47346	0	47818
27055	46524	129	62	688	0	47403
27056	463	64	77	46701	0	47305
27057	374	62	40	47193	0	47669
27058	46462	60	45	689	0	47256
27059	463	47165	63	377	0	48068
27060	47698	464	47	138	0	48347
27061	47231	357	41	101	0	47730
27062	47189	118	64	121	0	47492
27063	756	124	72	46484	0	47436
27064	397	86	72	47351	0	47906
27065	147	127	47085	705	0	48064
27066	164	127	46631	409	0	47331
27067	171	141	46431	147	0	46890
27068	42042	123	786	142	0	43093
27069	564	143	45967	141	0	46815
27070	387	46118	548	195	0	47248
27071	202	548	345	45482	0	46577
27072	180	444	112	43300	0	44036
27073	188	47032	124	676	0	48020
27074	237	574	48123	380	0	49314
27075	181	48666	502	237	0	49586
27076	47633	532	371	149	0	48685
27077	585	458	48243	151	0	49437
27078	445	47656	554	257	0	48912
27079	304	527	48153	164	0	49148
27080	245	397	517	46972	0	48131
27081	232	223	48204	529	0	49188
27082	209	161	532	46133	0	47035
27083	47465	153	345	614	0	48577
27084	604	162	47943	459	0	49168
27085	455	47842	517	242	0	49056
27086	47779	535	361	236	0	48911
27087	628	416	49310	240	0	50594
27088	458	183	49475	227	0	50343
27089	247	133	794	47590	0	48764
27090	229	140	49423	653	0	50445
27091	45911	147	576	541	0	47175
27092	589	49398	437	273	0	50697
27093	520	618	176	47360	0	48674
27094	207	51742	145	590	0	52684
27095	51940	613	187	507	0	53247
27096	674	513	52154	215	0	53556
27097	526	224	54549	260	0	55559
27098	219	175	891	53163	0	54448
27099	195	177	500	54346	0	55218
27100	189	194	232	55100	0	55715
27101	220	171	179	55634	0	56204
27102	223	224	56885	983	0	58315
27103	221	56111	677	637	0	57646
27104	194	553	412	50471	0	51630
27105	160	375	48874	443	0	49852
27106	139	48268	461	393	0	49261
27107	47626	456	416	184	0	48682
27108	712	386	167	47241	0	48506
27109	46637	122	135	448	0	47342
27110	404	46871	143	382	0	47800
27111	46448	398	112	206	0	47164
27112	440	324	48662	155	0	49581
27113	345	379	439	45022	0	46185
27114	141	48476	349	432	0	49398
27115	206	395	47823	389	0	48813
27116	92	47815	418	166	0	48491
27117	160	629	340	38983	0	40112
27118	44636	281	127	384	0	45428
27119	325	45103	144	339	0	45911
27120	44827	323	118	139	0	45407
27121	375	314	44922	150	0	45761
27122	318	125	44565	153	0	45161
27123	43247	89	543	139	0	44018
27124	338	146	365	44063	0	44912
27125	294	143	172	44365	0	44974
27126	134	115	47317	507	0	48073
27127	121	110	46477	295	0	47003
27128	85	47523	564	157	0	48329
27129	45573	408	412	209	0	46602
27130	43404	272	150	106	0	43932
27131	426	43630	121	150	0	44327
27132	261	274	106	44243	0	44884
27133	45069	244	93	324	0	45730
27134	273	102	115	44989	0	45479
27135	45715	78	115	331	0	46239
27136	45720	70	110	270	0	46170
27137	47371	80	100	187	0	47738
27138	477	82	106	46539	0	47204
27139	294	80	112	48999	0	49485
27140	48110	71	120	511	0	48812
27141	48184	69	110	331	0	48694
27142	48520	90	77	158	0	48845
27143	539	48622	133	183	0	49477
27144	46717	261	93	110	0	47181
27145	274	47129	103	159	0	47665
27146	45879	241	124	200	0	46444
27147	315	225	46707	96	0	47343
27148	41210	105	410	146	0	41871
27149	249	44847	211	152	0	45459
27150	190	44760	90	112	0	45152
27151	44754	314	69	105	0	45242
27152	259	195	46	44670	0	45170
27153	239	71	41	45613	0	45964
27154	97	46515	66	360	0	47038
27155	92	48870	71	233	0	49266
27156	49962	364	54	88	0	50468
27157	331	239	51889	80	0	52539
27158	283	68	289	53880	0	54520
27159	55372	53	238	325	0	55988
27160	419	120	56159	290	0	56988
27161	318	60400	348	147	0	61213
27162	63098	430	296	99	0	63923
27163	598	390	65416	79	0	66483
27164	454	98	593	66526	0	67671
27165	183	118	69971	662	0	70934
27166	64211	68	689	524	0	65492
27167	642	70819	482	194	0	72137
27168	71106	681	133	106	0	72026
27169	70495	468	74	94	0	71131
27170	1161	132	71	70248	0	71612
27171	70467	73	71	731	0	71342
27172	732	89	56	71012	0	71889
27173	511	91	72	71181	0	71855
27174	188	150	69200	1114	0	70652
27175	119	69513	688	593	0	70913
27176	179	679	453	69814	0	71125
27177	167	475	91	70176	0	70909
27178	134	123	64	70865	0	71186
27179	185	101	70124	1124	0	71534
27180	116	69741	686	631	0	71174
27181	179	648	450	70014	0	71291
27182	199	436	109	70513	0	71257
27183	166	170	70043	1084	0	71463
27184	175	118	635	68778	0	69706
27185	69010	73	488	758	0	70329
27186	679	70030	138	577	0	71424
27187	69023	645	92	198	0	69958
27188	827	508	68868	131	0	70334
27189	557	154	652	68091	0	69454
27190	69240	110	486	713	0	70549
27191	68321	99	131	516	0	69067
27192	1105	141	69691	198	0	71135
27193	625	129	719	67002	0	68475
27194	228	130	68256	721	0	69335
27195	62481	91	761	578	0	63911
27196	675	67186	558	263	0	68682
27197	65559	659	218	239	0	66675
27198	64793	460	148	199	0	65600
27199	1074	66534	239	212	0	68059
27200	67088	686	203	209	0	68186
27201	846	513	66958	180	0	68497
27202	65612	149	720	209	0	66690
27203	819	193	554	65860	0	67426
27204	691	167	68545	825	0	70228
27205	400	162	772	67758	0	69092
27206	307	142	580	68235	0	69264
27207	355	141	238	67076	0	67810
27208	336	68358	295	1207	0	70196
27209	68116	728	202	733	0	69779
27210	919	565	223	67633	0	69340
27211	735	68555	262	956	0	70508
27212	424	740	252	64788	0	66204
27213	326	67158	294	1073	0	68851
27214	475	867	66897	802	0	69041
27215	351	567	801	65620	0	67339
27216	351	263	622	67688	0	68924
27217	365	260	67318	1371	0	69314
27218	58843	284	860	1045	0	61032
27219	843	66890	699	668	0	69100
27220	757	829	312	66699	0	68597
27221	422	613	295	64999	0	66329
27222	408	282	365	64743	0	65798
27223	390	66298	350	1425	0	68463
27224	65169	808	373	1018	0	67368
27225	1015	641	66520	669	0	68845
27226	778	322	64122	562	0	65784
27227	445	258	1243	62865	0	64811
27228	478	260	742	64498	0	65978
27229	63796	314	367	1471	0	65948
27230	977	63934	412	1074	0	66397
27231	802	769	455	64040	0	66066
27232	63116	618	368	1191	0	65293
27233	1094	371	363	62414	0	64242
27234	62736	267	348	1124	0	64475
27235	1104	311	61320	898	0	63633
27236	873	62601	947	669	0	65090
27237	61856	797	765	540	0	63958
27238	1152	660	61800	538	0	64150
27239	59311	312	895	522	0	61040
27240	1173	306	60813	484	0	62776
27241	59836	257	932	517	0	61542
27242	1075	293	703	60128	0	62199
27243	61179	255	402	1042	0	62878
27244	1070	256	356	60808	0	62490
27245	877	260	325	61181	0	62643
27246	60546	269	359	1465	0	62639
27247	978	61199	396	985	0	63558
27248	802	849	310	61746	0	63707
27249	62652	615	297	1131	0	64695
27250	64301	350	284	906	0	65841
27251	1387	357	286	64581	0	66611
27252	923	298	279	66718	0	68218
27253	68007	308	315	1517	0	70147
27254	1189	332	269	69622	0	71412
27255	897	247	281	68411	0	69836
27256	66178	273	291	1508	0	68250
27257	1104	214	262	64615	0	66195
27258	642	170	60557	1076	0	62445
27259	55533	103	840	865	0	57341
27260	893	196	60374	365	0	61828
27261	543	134	55177	199	0	56053
27262	48575	350	1460	172	0	50557
27263	458	50215	477	132	0	51282
27264	406	400	317	47341	0	48464
27265	117	256	61	47497	0	47931
27266	76	63	47	49617	0	49803
27267	79	66	24	49990	0	50159
27268	49470	16	32	705	0	50223
27269	51150	32	21	403	0	51606
27270	52528	13	19	160	0	52720
27271	796	42	55493	98	0	56429
27272	440	34	513	56633	0	57620
27273	149	26	423	57565	0	58163
27274	133	39	82	55533	0	55787
27275	76	56242	80	1109	0	57507
27276	94	57534	62	604	0	58294
27277	57418	991	53	225	0	58687
27278	655	529	49	57773	0	59006
27279	541	115	62	60235	0	60953
27280	188	59	57	61650	0	61954
27281	180	90	60034	1257	0	61561
27282	149	97	58897	695	0	59838
27283	57832	46	1149	285	0	59312
27284	60803	40	616	221	0	61680
27285	1203	48	171	59192	0	60614
27286	652	60373	144	773	0	61942
27287	251	664	86	60336	0	61337
27288	184	522	107	60427	0	61240
27289	190	158	59249	1284	0	60881
27290	56060	95	692	799	0	57646
27291	807	64	551	61442	0	62864
27292	639	61	157	60527	0	61384
27293	59215	51	121	1368	0	60755
27294	780	60784	151	856	0	62571
27295	61621	771	85	338	0	62815
27296	996	633	73	60136	0	61838
27297	691	59876	87	928	0	61582
27298	60256	785	75	734	0	61850
27299	879	619	78	59995	0	61571
27300	59353	156	91	979	0	60579
27301	58197	94	90	815	0	59196
27302	58084	72	94	369	0	58619
27303	1404	57309	125	329	0	59167
27304	831	55985	151	299	0	57266
27305	375	1292	119	54045	0	55831
27306	258	55909	131	983	0	57281
27307	56048	871	84	791	0	57794
27308	920	648	128	55994	0	57690
27309	56190	200	146	978	0	57514
27310	56570	135	134	819	0	57658
27311	1476	115	144	55207	0	56942
27312	902	132	129	57115	0	58278
27313	56923	141	100	1557	0	58721
27314	56993	159	104	972	0	58228
27315	58546	131	96	489	0	59262
27316	58887	159	93	415	0	59554
27317	59445	158	69	376	0	60048
27318	1692	129	64	58040	0	59925
27319	1004	158	95	58575	0	59832
27320	508	150	78	59391	0	60127
27321	57894	145	81	1678	0	59798
27322	1131	143	89	57158	0	58521
27323	913	57337	101	1187	0	59538
27324	460	894	78	58332	0	59764
27325	56697	752	81	1165	0	58695
27326	56775	272	112	970	0	58129
27327	1660	262	55967	455	0	58344
27328	1084	254	814	52725	0	54877
27329	479	55867	695	1029	0	58070
27330	55779	847	187	918	0	57731
27331	1055	56904	150	492	0	58601
27332	938	925	92	56724	0	58679
27333	57422	722	118	1093	0	59355
27334	57313	230	73	966	0	58582
27335	1686	57175	113	488	0	59462
27336	1079	865	65	56157	0	58166
27337	619	742	56066	1045	0	58472
27338	53433	220	814	1020	0	55487
27339	1211	189	56234	480	0	58114
27340	55548	128	922	428	0	57026
27341	56246	192	647	449	0	57534
27342	1719	181	142	55820	0	57862
27343	57118	192	100	1179	0	58589
27344	57764	198	72	941	0	58975
27345	58373	228	83	479	0	59163
27346	1930	215	69	56703	0	58917
27347	56458	152	109	1121	0	57840
27348	1307	168	91	55879	0	57445
27349	1065	151	136	54976	0	56328
27350	507	54963	157	1597	0	57224
27351	579	843	119	51230	0	52771
27352	467	52093	99	978	0	53637
27353	49192	747	42	691	0	50672
27354	47735	536	42	356	0	48669
27355	1280	200	33	46874	0	48387
27356	784	144	47	46959	0	47934
27357	46282	113	65	1190	0	47650
27358	929	146	45347	699	0	47121
27359	45814	108	572	327	0	46821
27360	1012	109	426	45163	0	46710
27361	760	117	43380	762	0	45019
27362	42656	122	569	617	0	43964
27363	43956	97	411	313	0	44777
27364	1257	139	43951	266	0	45613
27365	43611	93	556	331	0	44591
27366	878	128	43567	286	0	44859
27367	707	43673	595	280	0	45255
27368	43979	584	712	300	0	45575
27369	43181	437	205	252	0	44075
27370	977	42239	135	243	0	43594
27371	488	39398	108	197	0	40191
27372	37539	484	336	158	0	38517
27373	37489	226	77	136	0	37928
27374	621	99	36	39247	0	40003
27375	368	108	39050	372	0	39898
27376	212	104	37721	263	0	38300
27377	38197	74	473	151	0	38895
27378	440	96	39627	157	0	40320
27379	37715	191	469	163	0	38538
27380	396	70	219	37717	0	38402
27381	295	35	57	38038	0	38425
27382	186	105	38925	432	0	39648
27383	38248	40	283	293	0	38864
27384	359	77	193	39708	0	40337
27385	271	30	78	40765	0	41144
27386	40333	27	51	485	0	40896
27387	40580	40	49	292	0	40961
27388	40901	41	38	163	0	41143
27389	472	43071	97	170	0	43810
27390	290	252	41350	133	0	42025
27391	39985	163	242	89	0	40479
27392	41492	38	152	115	0	41797
27393	402	41058	72	109	0	41641
27394	39577	147	124	100	0	39948
27395	270	154	44	39209	0	39677
27396	194	84	41198	157	0	41633
27397	40440	53	180	155	0	40828
27398	41875	49	122	122	0	42168
27399	42315	33	42	93	0	42483
27400	42297	30	42	92	0	42461
27401	301	28	59	42309	0	42697
27402	187	19	45	42581	0	42832
27403	42632	24	57	285	0	42998
27404	219	26	34	42818	0	43097
27405	185	25	59	42760	0	43029
27406	99	42944	72	311	0	43426
27407	110	184	39	43393	0	43726
27408	115	108	29	43419	0	43671
27409	111	25	41	43730	0	43907
27410	105	40	38	43916	0	44099
27411	91	43658	67	305	0	44121
27412	79	145	40	43182	0	43446
27413	112	155	27	42485	0	42779
27414	103	76	42141	276	0	42596
27415	110	81	40491	177	0	40859
27416	62	41754	258	103	0	42177
27417	48816	134	139	82	0	49171
27418	271	50548	79	122	0	51020
27419	233	295	47	53572	0	54147
27420	131	228	56926	381	0	57666
27421	59341	35	391	319	0	60086
27422	448	48	276	62589	0	63361
27423	63050	37	68	443	0	63598
27424	62299	31	77	373	0	62780
27425	658	63786	68	173	0	64685
27426	63157	391	31	124	0	63703
27427	391	66104	78	140	0	66713
27428	374	531	37	65918	0	66860
27429	104	67635	90	486	0	68315
27430	195	509	66759	407	0	67870
27431	95	68530	473	148	0	69246
27432	160	609	385	66375	0	67529
27433	66207	350	58	483	0	67098
27434	400	68791	87	551	0	69829
27435	451	458	41	69072	0	70022
27436	133	459	37	70669	0	71298
27437	178	158	70671	941	0	71948
27438	150	83	566	70207	0	71006
27439	185	145	71533	591	0	72454
27440	66072	42	616	636	0	67366
27441	730	126	72933	181	0	73970
27442	582	72880	599	217	0	74278
27443	231	637	460	72163	0	73491
27444	224	507	103	71942	0	72776
27445	210	205	69	72960	0	73444
27446	72711	141	87	1130	0	74069
27447	704	180	49	70796	0	71729
27448	536	72312	146	712	0	73706
27449	70506	708	79	602	0	71895
27450	597	70612	112	322	0	71643
27451	604	707	97	69781	0	71189
27452	69414	626	84	776	0	70900
27453	659	69669	168	730	0	71226
27454	541	71284	143	348	0	72316
27455	70853	1086	182	262	0	72383
27456	71029	611	137	309	0	72086
27457	1134	210	70893	293	0	72530
27458	70861	127	715	290	0	71993
27459	815	193	72937	249	0	74194
27460	693	179	744	72009	0	73625
27461	277	230	73235	886	0	74628
27462	234	194	751	72584	0	73763
27463	316	248	73440	933	0	74937
27464	262	197	767	70866	0	72092
27465	225	176	579	72193	0	73173
27466	70746	215	172	1367	0	72500
27467	856	271	70473	767	0	72367
27468	66304	288	794	385	0	67771
27469	895	286	69799	340	0	71320
27470	793	246	69231	301	0	70571
27471	351	271	1189	67192	0	69003
27472	68513	230	661	839	0	70243
27473	805	68919	246	781	0	70751
27474	66950	777	206	306	0	68239
27475	65910	648	255	321	0	67134
27476	1272	65918	284	423	0	67897
27477	65844	729	293	252	0	67118
27478	927	737	66459	320	0	68443
27479	749	215	828	65890	0	67682
27480	66022	159	683	916	0	67780
27481	804	66996	351	848	0	68999
27482	734	726	272	65044	0	66776
27483	329	619	260	65598	0	66806
27484	332	221	247	66171	0	66971
27485	300	172	269	66450	0	67191
27486	65260	206	258	1397	0	67121
27487	65727	218	291	890	0	67126
27488	66389	198	315	375	0	67277
27489	64248	191	290	412	0	65141
27490	1503	233	63739	358	0	65833
27491	62812	250	817	342	0	64221
27492	63686	249	722	348	0	65005
27493	1508	63743	319	423	0	65993
27494	940	64822	321	364	0	66447
27495	509	1323	275	63613	0	65720
27496	459	711	291	63135	0	64596
27497	420	341	62468	1428	0	64657
27498	373	63763	905	972	0	66013
27499	438	841	716	61551	0	63546
27500	421	64433	345	979	0	66178
27501	415	883	238	65504	0	67040
27502	484	670	224	64720	0	66098
27503	392	67978	330	1534	0	70234
27504	463	809	287	68754	0	70313
27505	536	714	69623	1069	0	71942
27506	526	289	69858	943	0	71616
27507	66639	208	1455	459	0	68761
27508	69917	213	846	409	0	71385
27509	1566	69727	412	493	0	72198
27510	70185	856	261	399	0	71701
27511	1242	777	289	69453	0	71761
27512	69522	349	234	1003	0	71108
27513	1108	69924	287	1065	0	72384
27514	1227	961	69407	439	0	72034
27515	66881	769	1159	479	0	69288
27516	1244	384	72774	435	0	74837
27517	838	272	63626	294	0	65030
27518	493	279	63134	308	0	64214
27519	330	59751	1189	307	0	61577
27520	54594	1131	1968	394	0	58087
27521	52530	503	286	335	0	53654
27522	935	158	178	51903	0	53174
27523	607	176	196	51074	0	52053
27524	268	54758	208	887	0	56121
27525	55118	463	184	575	0	56340
27526	610	56768	210	296	0	57884
27527	507	54932	230	259	0	55928
27528	54468	708	247	233	0	55656
27529	612	407	254	53940	0	55213
27530	544	154	160	54290	0	55148
27531	283	142	165	54640	0	55230
27532	232	54407	167	858	0	55664
27533	53334	414	143	479	0	54370
27534	581	470	143	52550	0	53744
27535	452	51741	122	490	0	52805
27536	215	51115	132	362	0	51824
27537	220	624	121	49279	0	50244
27538	158	50790	145	401	0	51494
27539	206	462	103	50359	0	51130
27540	48819	365	136	431	0	49751
27541	396	196	48962	364	0	49918
27542	318	50735	320	160	0	51533
27543	214	383	250	51057	0	51904
27544	181	311	52258	380	0	53130
27545	49086	132	367	346	0	49931
27546	467	198	306	52430	0	53401
27547	52402	85	92	425	0	53004
27548	52137	77	68	374	0	52656
27549	588	56888	100	169	0	57745
27550	57642	320	70	174	0	58206
27551	57226	310	80	122	0	57738
27552	57708	122	66	153	0	58049
27553	672	109	64	56710	0	57555
27554	393	113	64	56718	0	57288
27555	168	103	65	57678	0	58014
27556	166	168	56987	660	0	57981
27557	118	56939	365	432	0	57854
27558	55402	325	319	159	0	56205
27559	291	56421	81	169	0	56962
27560	292	303	53	55696	0	56344
27561	143	323	55659	330	0	56455
27562	48117	106	286	398	0	48907
27563	282	56992	273	119	0	57666
27564	299	315	51	56246	0	56911
27565	112	276	41	56763	0	57192
27566	132	140	56411	507	0	57190
27567	89	56975	292	367	0	57723
27568	112	290	245	56716	0	57363
27569	99	272	70	57096	0	57537
27570	83	91	41	56863	0	57078
27571	54145	65	57	589	0	54856
27572	349	149	55514	364	0	56376
27573	301	55720	301	150	0	56472
27574	54962	294	264	122	0	55642
27575	294	56397	92	160	0	56943
27576	321	528	49	54454	0	55352
27577	124	57052	71	356	0	57603
27578	55577	302	47	306	0	56232
27579	56421	292	72	173	0	56958
27580	581	128	56	58458	0	59223
27581	354	64	63	59431	0	59912
27582	125	105	70	63247	0	63547
27583	165	100	64622	797	0	65684
27584	101	67619	481	547	0	68748
27585	176	592	424	77605	0	78797
27586	133	555	106	79381	0	80175
27587	140	167	81	80009	0	80397
27588	147	119	62	79951	0	80279
27589	190	178	78839	1534	0	80741
27590	117	81573	768	979	0	83437
27591	158	876	707	82278	0	84019
27592	149	804	111	86653	0	87717
27593	150	271	86049	1767	0	88237
27594	168	150	898	81741	0	82957
27595	116	84134	884	1106	0	86240
27596	89	85990	261	1058	0	87398
27597	144	1817	96	84299	0	86356
27598	191	958	82968	1118	0	85235
27599	70963	258	986	1220	0	73427
27600	850	81521	931	605	0	83907
27601	830	998	80545	351	0	82724
27602	267	912	80876	333	0	82388
27603	98	78459	1671	426	0	80654
27604	321	989	79335	341	0	80986
27605	296	1401	1073	75295	0	78065
27606	75827	248	877	999	0	77951
27607	75879	167	270	935	0	77251
27608	76547	167	216	367	0	77297
27609	77843	202	192	321	0	78558
27610	1589	79596	222	352	0	81759
27611	79232	952	179	323	0	80686
27612	1039	80664	265	422	0	82390
27613	1045	1122	79551	289	0	82007
27614	390	958	1006	75315	0	77669
27615	241	80429	954	1123	0	82747
27616	287	1056	305	78079	0	79727
27617	76395	1015	193	1230	0	78833
27618	1063	319	202	73919	0	75503
27619	903	77254	281	1209	0	79647
27620	76721	1035	217	1187	0	79160
27621	1129	1066	76834	498	0	79527
27622	1025	396	1030	75372	0	77823
27623	321	287	981	76635	0	78224
27624	72889	272	289	2033	0	75483
27625	1005	72984	340	1434	0	75763
27626	1015	1196	71655	509	0	74375
27627	362	1171	1108	70898	0	73539
27628	281	462	71856	1315	0	73914
27629	239	69261	1187	1378	0	72065
27630	248	70906	1065	748	0	72967
27631	69501	1808	432	603	0	72344
27632	1151	1190	69854	652	0	72847
27633	68961	506	1209	656	0	71332
27634	1175	381	1207	65813	0	68576
27635	961	69469	533	1320	0	72283
27636	68513	1232	455	1243	0	71443
27637	1171	1179	69729	700	0	72779
27638	1167	581	1199	67830	0	70777
27639	539	407	1155	68708	0	70809
27640	487	566	465	66943	0	68461
27641	428	67593	476	2062	0	70559
27642	64256	1316	433	1302	0	67307
27643	1165	65601	523	700	0	67989
27644	1082	65055	534	572	0	67243
27645	728	1912	529	63853	0	67022
27646	63724	1205	526	1301	0	66756
27647	63342	537	482	1251	0	65612
27648	63157	614	419	691	0	64881
27649	1972	59591	525	698	0	62786
27650	1252	1247	427	59132	0	62058
27651	680	1307	59500	1322	0	62809
27652	685	572	1154	59015	0	61426
27653	642	521	1116	56373	0	58652
27654	664	59339	467	2017	0	62487
27655	58704	1317	429	1396	0	61846
27656	1357	1277	419	56475	0	59528
27657	1194	58705	465	1368	0	61732
27658	58088	1386	533	1308	0	61315
27659	1347	1266	57691	798	0	61102
27660	56095	710	1175	720	0	58700
27661	1344	57491	1128	760	0	60723
27662	57885	1360	525	635	0	60405
27663	57603	1228	472	605	0	59908
27664	1975	791	56901	619	0	60286
27665	57093	664	1201	540	0	59498
27666	1468	584	58471	622	0	61145
27667	1312	661	58237	563	0	60773
27668	56687	559	1919	517	0	59682
27669	57954	537	1242	498	0	60231
27670	2087	702	57897	560	0	61246
27671	1429	542	1349	56141	0	59461
27672	832	582	1219	54413	0	57046
27673	718	59339	706	1775	0	62538
27674	59299	1255	557	1184	0	62295
27675	59952	1211	386	647	0	62196
27676	2344	648	59764	502	0	63258
27677	59411	567	1149	553	0	61680
27678	59702	533	1033	551	0	61819
27679	2158	59200	511	587	0	62456
27680	1306	1254	459	56530	0	59549
27681	948	1107	350	56279	0	58684
27682	687	538	407	53441	0	55073
27683	49486	419	431	1526	0	51862
27684	1064	46768	343	1057	0	49232
27685	645	727	181	34394	0	35947
27686	362	35390	154	487	0	36393
27687	387	1469	168	31687	0	33711
27688	293	33559	171	460	0	34483
27689	286	33843	199	446	0	34774
27690	29710	684	485	284	0	31163
27691	29599	352	398	253	0	30602
27692	416	69	117	26607	0	27209
27693	277	46	79	27036	0	27438
27694	153	55	71	27231	0	27510
27695	113	70	76	27207	0	27466
27696	93	58	76	27001	0	27228
27697	82	26872	74	409	0	27437
27698	103	231	57	27198	0	27589
27699	116	246	43	27376	0	27781
27700	26737	85	47	393	0	27262
27701	313	69	66	27246	0	27694
27702	316	61	53	27202	0	27632
27703	160	75	27734	421	0	28390
27704	129	82	191	27379	0	27781
27705	135	162	200	28516	0	29013
27706	139	92	29830	454	0	30515
27707	92	30918	260	370	0	31640
27708	138	235	31120	139	0	31632
27709	133	201	30178	108	0	30620
27710	55	29013	321	92	0	29481
27711	28493	199	273	86	0	29051
27712	28261	119	90	62	0	28532
27713	239	42	16	27957	0	28254
27714	28562	23	20	189	0	28794
27715	185	41	29903	141	0	30270
27716	156	23	149	30252	0	30580
27717	64	64	34748	214	0	35090
27718	38	28	165	34819	0	35050
27719	33	32	137	35436	0	35638
27720	44	21	33	35862	0	35960
27721	35892	28	20	356	0	36296
27722	210	30	20	36627	0	36887
27723	36639	33	26	254	0	36952
27724	36693	36	30	220	0	36979
27725	295	37253	53	119	0	37720
27726	37147	166	40	126	0	37479
27727	177	39441	58	122	0	39798
27728	182	186	45	38978	0	39391
27729	73	161	38	39739	0	40011
27730	70	59	36	40170	0	40335
27731	68	86	39883	420	0	40457
27732	59	39885	221	346	0	40511
27733	87	239	174	37687	0	38187
27734	112	221	59	37492	0	37884
27735	70	40216	50	340	0	40676
27736	39927	219	51	227	0	40424
27737	238	39687	68	184	0	40177
27738	38964	243	25	145	0	39377
27739	230	40782	69	184	0	41265
27740	223	258	32	38857	0	39370
27741	67	41377	57	305	0	41806
27742	41985	235	33	312	0	42565
27743	42460	201	41	182	0	42884
27744	42980	79	25	193	0	43277
27745	42847	54	42	158	0	43101
27746	408	83	44390	139	0	45020
27747	43742	58	200	174	0	44174
27748	45204	43	173	165	0	45585
27749	45330	80	49	191	0	45650
27750	413	113	46084	167	0	46777
27751	44926	71	211	195	0	45403
27752	241	47247	215	197	0	47900
27753	47492	215	73	215	0	47995
27754	316	248	52805	169	0	53538
27755	52422	108	231	194	0	52955
27756	53532	60	168	188	0	53948
27757	378	85	77	53539	0	54079
27758	300	116	53835	324	0	54575
27759	53872	58	212	353	0	54495
27760	273	63	189	56679	0	57204
27761	271	59	95	58652	0	59077
27762	155	96	60023	457	0	60731
27763	54917	63	252	390	0	55622
27764	59595	74	221	206	0	60096
27765	407	60822	121	197	0	61547
27766	319	235	85	61077	0	61716
27767	147	229	79	61171	0	61626
27768	179	85	75	60693	0	61032
27769	139	62149	114	509	0	62911
27770	61486	251	92	308	0	62137
27771	334	236	67	61565	0	62202
27772	321	110	58	61625	0	62114
27773	60299	52	76	533	0	60960
27774	59739	64	81	364	0	60248
27775	486	65	110	60735	0	61396
27776	328	72	88	60262	0	60750
27777	193	102	58733	540	0	59568
27778	53606	50	268	435	0	54359
27779	340	60042	289	187	0	60858
27780	346	278	66	62274	0	62964
27781	223	270	54	63431	0	63978
27782	171	66958	108	784	0	68021
27783	200	528	60	68585	0	69373
27784	72690	543	76	802	0	74111
27785	855	201	57	84963	0	86076
27786	744	111	61	87128	0	88044
27787	308	130	63	89077	0	89578
27788	254	135	86739	2693	0	89821
27789	205	99	1232	87557	0	89093
27790	255	182	86741	1916	0	89094
27791	178	84794	1506	1444	0	87922
27792	251	1233	1118	85116	0	87718
27793	222	1058	375	86676	0	88331
27794	177	355	198	88573	0	89303
27795	156	161	163	89303	0	89783
27796	136	114	139	90368	0	90757
27797	85150	109	142	2877	0	88278
27798	1373	191	86920	1697	0	90181
27799	1077	85714	1291	836	0	88918
27800	397	89235	1112	565	0	91309
27801	236	2226	348	88783	0	91593
27802	223	1323	196	90205	0	91947
27803	238	466	139	89856	0	90699
27804	152	88917	185	2776	0	92030
27805	171	1330	99	90369	0	91969
27806	227	1144	87117	1968	0	90456
27807	136	85968	1285	1639	0	89028
27808	209	1420	1046	86578	0	89253
27809	84488	1103	428	1768	0	87787
27810	1268	461	223	86601	0	88553
27811	1048	298	176	85757	0	87279
27812	394	82658	241	2692	0	85985
27813	322	86929	200	1886	0	89337
27814	327	2191	207	86798	0	89523
27815	266	1301	131	87277	0	88975
27816	235	584	84992	2956	0	88767
27817	197	390	1306	82749	0	84642
27818	214	360	1145	83344	0	85063
27819	194	354	518	83090	0	84156
27820	235	336	380	84085	0	85036
27821	80568	350	375	3458	0	84751
27822	81436	290	345	2466	0	84537
27823	2327	327	273	82765	0	85692
27824	1430	271	307	84864	0	86872
27825	81825	270	301	3709	0	86105
27826	1504	292	366	85293	0	87455
27827	1345	353	83186	3160	0	88044
27828	599	82860	1615	2774	0	87848
27829	459	1549	1482	84407	0	87897
27830	318	1422	815	86278	0	88833
27831	83804	775	510	3759	0	88848
27832	1444	655	507	87100	0	89706
27833	1282	639	318	88491	0	90730
27834	86427	471	331	4164	0	91393
27835	1607	532	325	87829	0	90293
27836	1429	86921	433	3343	0	92126
27837	730	1763	401	91912	0	94806
27838	565	1602	448	94412	0	97027
27839	589	931	428	94407	0	96355
27840	459	749	455	95019	0	96682
27841	441	896	90354	4327	0	96018
27842	384	829	89828	3302	0	94343
27843	346	696	2572	90475	0	94089
27844	363	650	1647	88741	0	91401
27845	346	89781	822	4267	0	95216
27846	404	1896	609	86772	0	89681
27847	386	88374	691	3374	0	92825
27848	85373	2071	622	2962	0	91028
27849	1597	90874	472	2483	0	95426
27850	1543	2127	383	92277	0	96330
27851	820	1758	273	94422	0	97273
27852	599	1006	90437	4526	0	96568
27853	83970	699	1586	3622	0	89877
27854	83916	675	1459	2489	0	88539
27855	2683	85070	802	2441	0	90996
27856	1876	1764	576	82413	0	86629
27857	1061	1572	87106	3245	0	92984
27858	630	88667	1869	3161	0	94327
27859	86754	1792	1448	2495	0	92489
27860	86693	1595	694	2197	0	91179
27861	3098	827	82727	2225	0	88877
27862	82643	531	1568	2122	0	86864
27863	2549	529	1386	81600	0	86064
27864	1970	82541	736	3101	0	88348
27865	82361	1736	517	2904	0	87518
27866	2103	1573	497	82426	0	86599
27867	82691	819	476	3073	0	87059
27868	84942	676	495	3009	0	89122
27869	2978	701	400	84633	0	88712
27870	2050	686	84828	3256	0	90820
27871	84356	486	1632	3192	0	89666
27872	87481	497	1437	2305	0	91720
27873	87258	463	711	1970	0	90402
27874	3190	88599	567	2092	0	94448
27875	2069	1750	490	88715	0	93024
27876	1121	1616	426	92072	0	95235
27877	834	985	90099	4167	0	96085
27878	804	777	1661	87805	0	91047
27879	580	88386	1514	3284	0	93764
27880	84130	1634	726	2588	0	89078
27881	1579	85125	604	1997	0	89305
27882	1402	1493	82212	1383	0	86490
27883	631	83515	1679	1304	0	87129
27884	468	78861	1268	880	0	81477
27885	932	852	859	64067	0	66710
27886	64219	436	395	556	0	65606
27887	63968	148	95	512	0	64723
27888	63612	113	77	267	0	64069
27889	760	66107	132	369	0	67368
27890	532	456	65355	265	0	66608
27891	65133	374	410	264	0	66181
27892	67222	152	395	267	0	68036
27893	769	67287	174	293	0	68523
27894	69399	430	110	285	0	70224
27895	556	427	107	69735	0	70825
27896	564	207	75686	565	0	77022
27897	75237	147	443	619	0	76446
27898	76751	166	431	263	0	77611
27899	79176	166	136	289	0	79767
27900	944	139	127	78328	0	79538
27901	612	143	113	81238	0	82106
27902	307	153	105	84634	0	85199
27903	229	86135	170	1210	0	87744
27904	283	687	108	90628	0	91706
27905	264	603	113	95249	0	96229
27906	310	297	95761	1454	0	97822
27907	299	195	844	95397	0	96735
27908	269	202	666	97260	0	98397
27909	248	193	203	97282	0	97926
27910	280	159	174	96142	0	96755
27911	247	96745	221	1611	0	98824
27912	307	874	159	97024	0	98364
27913	323	738	141	96602	0	97804
27914	94667	216	203	1650	0	96736
27915	1040	227	95449	948	0	97664
27916	935	266	94022	447	0	95670
27917	91713	184	1435	396	0	93728
27918	95656	171	817	398	0	97042
27919	1680	313	245	84267	0	86505
27920	962	95289	244	932	0	97427
27921	95653	875	183	815	0	97526
27922	1090	864	162	92847	0	94963
27923	881	98376	212	1084	0	100553
27924	97153	829	163	862	0	99007
27925	931	98615	209	447	0	100202
27926	97330	881	114	402	0	98727
27927	94784	689	110	410	0	95993
27928	1414	94344	196	451	0	96405
27929	895	833	137	94396	0	96261
27930	503	804	93904	990	0	96201
27931	354	381	807	92371	0	93913
27932	92186	193	642	1122	0	94143
27933	982	289	91909	905	0	94085
27934	764	91248	828	689	0	93529
27935	375	1067	651	90090	0	92183
27936	426	788	89890	992	0	92096
27937	260	89279	873	936	0	91348
27938	88277	859	692	526	0	90354
27939	834	614	251	89623	0	91322
27940	725	230	207	89809	0	90971
27941	330	222	169	87757	0	88478
27942	226	89691	246	1521	0	91684
27943	89200	770	183	875	0	91028
27944	827	89651	198	517	0	91193
27945	721	91107	194	501	0	92523
27946	90974	1226	158	366	0	92724
27947	90743	746	136	362	0	91987
27948	1383	353	89604	354	0	91694
27949	86637	244	750	334	0	87965
27950	86743	269	611	284	0	87907
27951	1465	248	176	85547	0	87436
27952	934	310	85295	895	0	87434
27953	427	240	750	84865	0	86282
27954	85814	197	659	1059	0	87729
27955	1092	252	87840	835	0	90019
27956	862	203	821	92839	0	94725
27957	474	250	690	99826	0	101240
27958	405	221	268	107630	0	108524
27959	106788	264	221	2463	0	109736
27960	1569	109093	334	1582	0	112578
27961	109183	1565	228	594	0	111570
27962	1847	1051	110290	585	0	113773
27963	1190	316	1579	104976	0	108061
27964	425	111574	1048	1780	0	114827
27965	112147	1630	301	1277	0	115355
27966	1757	1046	197	112539	0	115539
27967	1181	505	111508	1904	0	115098
27968	497	320	1610	110140	0	112567
27969	106655	314	982	2080	0	110031
27970	1637	107505	438	1687	0	111267
27971	1282	1901	228	96452	0	99863
27972	441	107052	313	1814	0	109620
27973	105073	1710	269	1176	0	108228
27974	103652	995	215	700	0	105562
27975	2428	103541	323	672	0	106964
27976	103182	1612	250	489	0	105533
27977	1926	1018	252	97097	0	100293
27978	1144	101559	323	1696	0	104722
27979	100950	1623	253	1057	0	103883
27980	101346	983	263	510	0	103102
27981	2504	99614	330	565	0	103013
27982	1311	100029	317	515	0	102172
27983	98473	2249	225	404	0	101351
27984	1878	1228	167	97829	0	101102
27985	99022	447	188	1730	0	101387
27986	2012	433	187	98637	0	101269
27987	1316	538	97487	1776	0	101117
27988	733	343	1460	98130	0	100666
27989	96083	387	888	1882	0	99240
27990	1918	426	96869	1193	0	100406
27991	1274	329	1517	94911	0	98031
27992	622	334	975	97794	0	99725
27993	632	369	96319	2533	0	99853
27994	88176	268	1631	1213	0	91288
27995	1844	316	960	93530	0	96650
27996	1130	295	87929	1807	0	91161
27997	79169	312	1622	1193	0	82296
27998	1547	86816	1047	719	0	90129
27999	1051	86475	416	583	0	88525
28000	507	87406	399	614	0	88926
28001	612	2083	82189	492	0	85376
28002	538	1603	1414	77768	0	81323
28003	486	441	78808	1577	0	81312
28004	406	1585	1318	69403	0	72712
28005	256	69117	756	1372	0	71501
28006	326	68876	244	841	0	70287
28007	592	1693	305	66811	0	69401
28008	66640	759	279	1396	0	69074
28009	1266	323	174	67729	0	69492
28010	722	365	195	67019	0	68301
28011	418	67503	193	1689	0	69803
28012	66016	1234	190	837	0	68277
28013	1234	67764	214	525	0	69737
28014	824	1316	190	67489	0	69819
28015	452	719	201	66876	0	68248
28016	378	67140	231	1811	0	69560
28017	444	1289	187	67802	0	69722
28018	67215	742	132	1607	0	69696
28019	1483	510	134	67620	0	69747
28020	995	544	155	66940	0	68634
28021	648	67089	257	1727	0	69721
28022	598	1325	264	67699	0	69886
28023	64224	789	227	1547	0	66787
28024	65445	552	171	945	0	67113
28025	66046	528	171	560	0	67305
28026	2033	460	190	64860	0	67543
28027	1068	471	64130	1568	0	67237
28028	679	445	64622	1019	0	66765
28029	710	414	1544	64115	0	66783
28030	64682	522	654	1533	0	67391
28031	1570	464	276	65206	0	67516
28032	66013	467	231	1623	0	68334
28033	1699	422	252	66207	0	68580
28034	1186	378	267	66930	0	68761
28035	66199	424	260	1854	0	68737
28036	1606	482	64936	1002	0	68026
28037	64323	405	1160	708	0	66596
28038	1634	472	64580	648	0	67334
28039	1076	319	1244	62409	0	65048
28040	63014	293	730	1521	0	65558
28041	1578	413	64176	875	0	67042
28042	949	482	64380	492	0	66303
28043	61436	409	1664	563	0	64072
28044	1561	436	64233	601	0	66831
28045	925	63023	1324	686	0	65958
28046	611	1198	758	66153	0	68720
28047	70590	649	536	1724	0	73499
28048	1376	375	73119	1078	0	75948
28049	72733	294	1423	680	0	75130
28050	74893	309	891	643	0	76736
28051	75229	355	479	660	0	76723
28052	75213	314	388	771	0	76686
28053	1771	646	454	71811	0	74682
28054	921	73556	411	1504	0	76392
28055	70765	1122	459	1091	0	73437
28056	1208	587	64291	552	0	66638
28057	424	52293	590	315	0	53622
28058	45996	307	613	190	0	47106
28059	283	43831	189	145	0	44448
28060	201	45354	100	170	0	45825
28061	1286	345	575	43788	0	45994
28062	109	134	152	45074	0	45469
28063	76	40	73	45526	0	45715
28064	47012	34	56	345	0	47447
28065	49144	29	66	226	0	49465
28066	506	49	60	52137	0	52752
28067	291	34	61	57150	0	57536
28068	157	86	61368	693	0	62304
28069	58842	39	554	430	0	59865
28070	63178	33	362	141	0	63714
28071	907	44	103	63763	0	64817
28072	484	33	76	64414	0	65007
28073	200	93	64260	967	0	65520
28074	147	75	581	63533	0	64336
28075	162	55	66499	676	0	67392
28076	145	65353	696	666	0	66860
28077	185	571	66930	235	0	67921
28078	139	463	655	63667	0	64924
28079	166	126	68174	638	0	69104
28080	158	142	66705	480	0	67485
28081	64827	90	1064	151	0	66132
28082	678	148	503	68579	0	69908
28083	518	132	70469	662	0	71781
28084	64258	70	738	578	0	65644
28085	748	99	71086	228	0	72161
28086	595	107	75050	178	0	75930
28087	163	75622	1159	322	0	77266
28088	179	631	534	74713	0	76057
28089	249	501	75475	712	0	76937
28090	226	140	74881	544	0	75791
28091	182	87	1102	72244	0	73615
28092	175	60	587	71928	0	72750
28093	116	75934	253	1130	0	77433
28094	158	696	164	76134	0	77152
28095	76763	463	181	829	0	78236
28096	76116	114	165	665	0	77060
28097	77516	64	180	309	0	78069
28098	1185	102	190	75798	0	77275
28099	592	77980	228	878	0	79678
28100	76192	642	195	657	0	77686
28101	708	78573	253	350	0	79884
28102	586	77563	269	312	0	78730
28103	206	78300	257	325	0	79088
28104	77724	1062	238	277	0	79301
28105	734	535	236	77200	0	78705
28106	561	176	245	76418	0	77400
28107	157	78318	305	1178	0	79958
28108	76559	706	289	687	0	78241
28109	813	588	77323	267	0	78991
28110	614	183	853	76975	0	78625
28111	77238	124	682	815	0	78859
28112	714	79511	343	760	0	81328
28113	81373	665	268	371	0	82677
28114	853	535	264	80257	0	81909
28115	632	83674	304	864	0	85474
28116	377	774	82562	642	0	84355
28117	80275	554	831	304	0	81964
28118	829	239	664	83737	0	85469
28119	84724	174	303	931	0	86132
28120	854	290	250	83103	0	84497
28121	627	83791	291	982	0	85691
28122	363	779	85330	697	0	87169
28123	383	656	85767	405	0	87211
28124	284	537	1183	83542	0	85546
28125	85266	179	752	891	0	87088
28126	85223	185	256	718	0	86382
28127	1222	160	237	84458	0	86077
28128	726	172	212	85617	0	86727
28129	86682	166	237	1297	0	88382
28130	938	193	241	87459	0	88831
28131	87399	193	266	991	0	88849
28132	863	87442	304	917	0	89526
28133	86831	802	299	424	0	88356
28134	1004	768	88152	412	0	90336
28135	803	262	935	87391	0	89391
28136	413	227	747	89282	0	90669
28137	433	217	404	88952	0	90006
28138	404	87733	431	1528	0	90096
28139	366	87538	419	1083	0	89406
28140	360	1251	371	88672	0	90654
28141	367	727	88734	1160	0	90988
28142	357	275	1072	88416	0	90120
28143	367	268	886	90370	0	91891
28144	377	314	467	91011	0	92169
28145	86518	291	471	1479	0	88759
28146	899	86142	495	957	0	88493
28147	759	85404	531	596	0	87290
28148	486	1384	425	82310	0	84605
28149	483	737	448	83388	0	85056
28150	489	301	400	83440	0	84630
28151	465	291	352	84330	0	85438
28152	81179	245	395	1551	0	83370
28153	899	82842	513	1026	0	85280
28154	82999	884	395	542	0	84820
28155	84864	754	413	570	0	86601
28156	1374	366	325	84297	0	86362
28157	854	343	271	85752	0	87220
28158	84859	232	272	1592	0	86955
28159	85073	273	255	1050	0	86651
28160	1502	311	151	84133	0	86097
28161	993	346	114	84229	0	85682
28162	609	361	83290	1519	0	85779
28163	518	82471	723	970	0	84682
28164	487	83918	555	499	0	85459
28165	79263	948	288	410	0	80909
28166	825	615	81284	353	0	83077
28167	689	279	74257	269	0	75494
28168	64846	263	897	241	0	66247
28169	67341	83	449	172	0	68045
28170	486	75483	120	204	0	76293
28171	252	78527	94	192	0	79065
28172	179	471	99	78802	0	79551
28173	83160	248	50	468	0	83926
28174	83649	73	44	352	0	84118
28175	84933	80	42	257	0	85312
28176	524	71	39	85047	0	85681
28177	311	91	40	86297	0	86739
28178	178	133	87460	529	0	88300
28179	164	148	84907	351	0	85570
28180	172	154	88547	157	0	89030
28181	168	988	454	85136	0	86746
28182	84554	35	282	314	0	85185
28183	289	124	89772	317	0	90502
28184	267	64	212	88068	0	88611
28185	102	92758	262	294	0	93416
28186	112	233	68	92183	0	92596
28187	102	243	42	93119	0	93506
28188	134	145	96870	573	0	97722
28189	108	43	311	95435	0	95897
28190	100240	43	336	501	0	101120
28191	568	161	107592	403	0	108724
28192	472	68	507	106621	0	107668
28193	190	133	111803	659	0	112785
28194	79	112584	665	711	0	114039
28195	320	626	114022	291	0	115259
28196	183	546	678	108806	0	110213
28197	115	135	544	114403	0	115197
28198	203	180	121396	1196	0	122975
28199	140	67	650	118552	0	119409
28200	151	89	570	118261	0	119071
28201	85	121140	238	1261	0	122724
28202	238	700	122474	793	0	124205
28203	162	536	694	120640	0	122032
28204	171	161	618	120317	0	121267
28205	90	124553	272	1303	0	126218
28206	137	812	117	125252	0	126318
28207	125840	595	145	871	0	127451
28208	715	176	148	126355	0	127394
28209	676	184	128698	938	0	130496
28210	123676	65	828	908	0	125477
28211	135124	106	728	444	0	136402
28212	1652	184	140250	246	0	142332
28213	132171	102	1015	432	0	133720
28214	1011	142925	984	358	0	145278
28215	903	1030	303	144083	0	146319
28216	325	890	190	158843	0	160248
28217	242	205	188	160648	0	161283
28218	207	129	202	162452	0	162990
28219	237	112	163	163286	0	163798
28220	161142	124	196	2687	0	164149
28221	1517	223	161019	1478	0	164237
28222	152975	99	1538	641	0	155253
28223	1666	221	160082	520	0	162489
28224	1265	144	1623	157558	0	160590
28225	159620	134	1247	1730	0	162731
28226	1668	211	426	155761	0	158066
28227	1232	162240	405	1748	0	165625
28228	165733	1402	358	1374	0	168867
28229	1664	1112	293	171316	0	174385
28230	1359	368	170003	1780	0	173510
28231	156106	167	1553	1593	0	159419
28232	1587	177198	1297	878	0	180960
28233	1468	1586	182030	566	0	185650
28234	600	1257	1720	178434	0	182011
28235	515	355	1347	176105	0	178322
28236	357	180507	604	2970	0	184438
28237	525	1636	181238	1725	0	185124
28238	393	1296	1687	178182	0	181558
28239	492	533	187340	2182	0	190547
28240	377	264	1869	183552	0	186062
28241	438	233	1462	185503	0	187636
28242	470	319	187220	3218	0	191227
28243	447	201	1835	184789	0	187272
28244	511	344	1692	169290	0	171837
28245	534	211	739	194577	0	196061
28246	507	276	592	196202	0	197577
28247	190148	195	576	3738	0	194657
28248	2053	411	190924	2162	0	195550
28249	192514	295	2047	1191	0	196047
28250	2250	291	1723	203760	0	208024
28251	1728	289	698	207357	0	210072
28252	745	310	563	204233	0	205851
28253	442	206252	718	4204	0	211616
28254	207310	2169	565	2460	0	212504
28255	2179	1621	542	217317	0	221659
28256	1693	222654	736	2674	0	227757
28257	677	1963	551	223863	0	227054
28258	225607	1542	547	3121	0	230817
28259	224507	528	543	2507	0	228085
28260	224541	447	617	1275	0	226880
28261	3514	227296	792	1469	0	233071
28262	2076	2132	230224	1419	0	235851
28263	224133	1627	2235	1364	0	229359
28264	232910	467	1810	1427	0	236614
28265	3567	236653	831	1459	0	242510
28266	234833	2060	528	1223	0	238644
28267	231998	1702	584	1234	0	235518
28268	235473	543	572	1203	0	237791
28269	3887	248608	704	1432	0	254631
28270	2487	2144	570	246500	0	251701
28271	254377	1715	588	2940	0	259620
28272	259184	634	489	2507	0	262814
28273	256798	460	463	1380	0	259101
28274	257835	487	475	1341	0	260138
28275	4336	572	432	253986	0	259326
28276	2550	753	256896	2989	0	263188
28277	1325	505	2364	250778	0	254972
28278	1128	261341	1992	3134	0	267595
28279	1218	2320	625	267658	0	271821
28280	1224	2017	270567	3148	0	276956
28281	264377	594	2540	2687	0	270198
28282	3217	527	1981	276117	0	281842
28283	276022	487	798	3303	0	280610
28284	281645	585	597	2865	0	285692
28285	4704	545	648	289063	0	294960
28286	2981	593	297552	3358	0	304484
28287	1918	648	283187	2531	0	288284
28288	260660	685	3872	1528	0	266745
28289	3082	289686	2141	1543	0	296452
28290	2305	288400	881	1365	0	292951
28291	1399	298010	675	1277	0	301361
28292	1349	307378	826	1276	0	310829
28293	298587	3846	1640	1224	0	305297
28294	300195	1795	617	1019	0	303626
28295	299668	653	484	1041	0	301846
28296	300953	625	475	1056	0	303109
28297	4029	770	528	289879	0	295206
28298	2282	294602	624	2600	0	300108
28299	291417	2142	728	2039	0	296326
28300	2910	1774	299379	950	0	305013
28301	2248	300161	2223	1588	0	306220
28302	1587	2299	300055	998	0	304939
28303	287560	1603	2213	1092	0	292468
28304	300827	648	1619	1074	0	304168
28305	301393	700	655	1073	0	303821
28306	4038	663	519	302309	0	307529
28307	2702	707	307570	2443	0	313422
28308	1449	307444	2157	2369	0	313419
28309	294433	2081	1696	1095	0	299305
28310	2679	303224	812	1350	0	308065
28311	2013	296882	533	1245	0	300673
28312	1367	300135	598	972	0	303072
28313	1259	301082	583	1060	0	303984
28314	1718	2784	287540	822	0	292864
28315	1125	299033	2024	933	0	303115
28316	279421	1601	1590	894	0	283506
28317	1788	1103	431	282656	0	285978
28318	1509	625	302	287134	0	289570
28319	284868	485	357	2108	0	287818
28320	1658	286254	535	1659	0	290106
28321	1832	1612	296028	699	0	300171
28322	1138	1122	1234	291025	0	294519
28323	1027	627	952	300560	0	303166
28324	1038	559	455	303836	0	305888
28325	1046	770	303212	2066	0	307094
28326	1051	861	303766	1095	0	306773
28327	1116	627	1927	303425	0	307095
28328	1147	787	312368	1368	0	315670
28329	1164	798	300186	1026	0	303174
28330	236834	745	2300	1126	0	241005
28331	1640	307375	1182	1018	0	311215
28332	1407	302147	556	745	0	304855
28333	1171	320676	584	920	0	323351
28334	1209	2580	635	306407	0	310831
28335	807	330335	670	1324	0	333136
28336	329536	1461	724	1213	0	332934
28337	1852	1383	336335	616	0	340186
28338	330772	675	1655	748	0	333850
28339	2044	637	1269	348711	0	352661
28340	1647	705	584	349006	0	351942
28341	800	368765	706	2754	0	373025
28342	368241	2056	581	1746	0	372624
28343	364583	1723	689	820	0	367815
28344	3597	394856	727	990	0	400170
28345	2062	2803	400	386814	0	392079
28346	1099	2325	398299	2529	0	404252
28347	13385	981	388779	1985	0	405130
28348	840	408425	4260	1420	0	414945
28349	404088	3382	2487	1261	0	411218
28350	3559	2369	414712	402	0	421042
28351	2671	840	2960	399533	0	406004
28352	413536	579	2366	3011	0	419492
28353	414720	635	811	2346	0	418512
28354	5043	503090	1135	1056	0	510324
28355	2750	519326	898	1048	0	524022
28356	519680	7545	744	817	0	528786
28357	5838	3840	524696	688	0	535062
28358	515107	1225	5537	770	0	522639
28359	524510	843	3275	811	0	529439
28360	8560	902	1067	521030	0	531559
28361	4174	1159	540549	5453	0	551335
28362	1854	1148	535572	3162	0	541736
28363	499468	749	9185	1299	0	510701
28364	6952	1273	540562	963	0	549750
28365	492317	995	6708	969	0	500989
28366	519513	903	3805	884	0	525105
28367	8509	529863	2069	1620	0	542061
28368	12268	6117	524283	771	0	543439
28369	2153	524577	6675	1071	0	534476
28370	510099	6129	4142	1126	0	521496
28371	6951	4259	515454	778	0	527442
28372	4744	1863	6467	480641	0	493715
28373	2773	1586	515139	5643	0	525141
28374	3394	1369	513987	3280	0	522030
28375	2898	1237	517984	934	0	523053
28376	2858	1230	515613	1039	0	520740
28377	2108	502064	10254	2280	0	516706
28378	2922	6615	502509	1192	0	513238
28379	2276	496312	7703	1731	0	508022
28380	3201	6764	493281	916	0	504162
28381	470484	3848	8598	878	0	483808
28382	8551	1881	5260	418181	0	433873
28383	5254	494559	3170	4315	0	507298
28384	484485	6502	3199	3325	0	497511
28385	481395	4369	3798	1436	0	490998
28386	468385	2312	3483	1120	0	475300
28387	472052	1788	3769	986	0	478595
28388	9736	478954	4205	1523	0	494418
28389	465113	6563	3138	1602	0	476416
28390	465977	4611	3645	1440	0	475673
28391	9817	459857	3888	2103	0	475665
28392	5685	7382	455505	1015	0	469587
28393	3669	5328	8387	420084	0	437468
28394	3601	456060	6601	5480	0	471742
28395	3737	7458	458210	3588	0	472993
28396	4128	5270	461822	1835	0	473055
28397	3729	453681	11795	1875	0	471080
28398	3748	458658	7054	1598	0	471058
28399	3637	474109	4774	1679	0	484199
28400	3829	473161	4242	1331	0	482563
28401	451574	11474	4087	1133	0	468268
28402	450320	6792	4124	1496	0	462732
28403	12638	4220	469646	1502	0	488006
28404	7789	3978	475283	1177	0	488227
28405	5304	3674	12500	444807	0	466285
28406	5027	3307	7704	461404	0	477442
28407	5318	4043	4560	467894	0	481815
28408	456849	3813	4807	9773	0	475242
28409	10124	465911	5037	5884	0	486956
28410	7834	480007	4954	2632	0	495427
28411	5509	486222	5087	2159	0	498977
28412	466788	12995	5031	1784	0	486598
28413	474003	7704	5230	1729	0	488666
28414	14597	5001	4573	463780	0	487951
28415	475689	4697	5325	7242	0	492953
28416	474210	4878	5165	5079	0	489332
28417	14743	5159	4909	468557	0	493368
28418	470137	5364	5256	8152	0	488909
28419	12123	469618	6477	5672	0	493890
28420	9992	10134	6837	465565	0	492528
28421	7406	8502	460277	7829	0	484014
28422	6867	457959	12583	6418	0	483827
28423	7731	11506	460988	3458	0	483683
28424	7539	8635	12881	413543	0	442598
28425	7555	462724	11195	7444	0	488918
28426	8504	10235	8139	448885	0	475763
28427	7552	8208	8294	456402	0	480456
28428	7763	5397	455752	11846	0	480758
28429	7476	5092	472755	6726	0	492049
28430	6913	4925	16080	450954	0	478872
28431	7116	5640	11491	406558	0	430805
28432	7147	461908	8602	10864	0	488521
28433	422824	11707	6984	5904	0	447419
28434	12058	445562	7738	3995	0	469353
28435	9255	443202	7220	3799	0	463476
28436	6678	14781	422798	3983	0	448240
28437	4940	425017	12533	4399	0	446889
28438	5753	11304	11320	365161	0	393538
28439	5297	412557	8007	8162	0	434023
28440	5121	11220	7401	372165	0	395907
28441	3974	396109	7849	8326	0	416258
28442	379631	11039	6849	5708	0	403227
28443	9528	391898	7041	3828	0	412295
28444	6293	10436	5817	324693	0	347239
28445	4521	361228	5685	6596	0	378030
28446	346098	10368	5448	4278	0	366192
28447	343872	8258	3860	2860	0	358850
28448	11797	345727	3873	2949	0	364346
28449	329201	9476	2384	2149	0	343210
28450	9634	10692	2758	311381	0	334465
28451	7237	4552	319263	6570	0	337622
28452	5607	4522	321396	4132	0	335657
28453	5019	314968	9726	2847	0	332560
28454	215713	3631	5127	1204	0	225675
28455	209956	2291	1295	938	0	214480
28456	3990	1161	206969	819	0	212939
28457	2016	1112	203373	716	0	207217
28458	185649	1087	3511	752	0	190999
28459	196086	883	1813	739	0	199521
28460	3437	1015	194235	747	0	199434
28461	173656	915	2442	718	0	177731
28462	2310	184263	1756	748	0	189077
28463	1594	186343	670	851	0	189458
28464	807	3653	1009	178627	0	184096
28465	778	2014	731	182392	0	185915
28466	181532	966	683	3234	0	186415
28467	180079	891	637	1779	0	183386
28468	179740	979	636	892	0	182247
28469	3337	941	588	176878	0	181744
28470	1963	948	548	174324	0	177783
28471	882	173937	696	3300	0	178815
28472	815	176143	739	1787	0	179484
28473	834	179526	680	932	0	181972
28474	1050	3778	570	159718	0	165116
28475	887	172482	617	2253	0	176239
28476	1005	2745	166316	1626	0	171692
28477	150877	2147	2148	924	0	156096
28478	2561	1337	169072	773	0	173743
28479	1936	1248	167706	775	0	171665
28480	153605	1194	3108	765	0	158672
28481	2484	164731	1646	935	0	169796
28482	164803	2539	648	892	0	168882
28483	163898	2054	702	937	0	167591
28484	3702	1191	163171	752	0	168816
28485	2229	1074	163249	774	0	167326
28486	1129	162202	3247	998	0	167576
28487	1279	2742	161887	926	0	166834
28488	1213	2169	2393	156569	0	162344
28489	1147	1326	1970	140939	0	145382
28490	986	159823	1152	3009	0	164970
28491	1024	163236	1019	1713	0	166992
28492	158304	3748	827	957	0	163836
28493	161595	2239	852	931	0	165617
28494	3571	1367	867	159213	0	165018
28495	2167	1236	866	162076	0	166345
28496	157446	1180	888	3282	0	162796
28497	157790	1096	1000	1801	0	161687
28498	3526	159893	1086	1023	0	165528
28499	145090	2276	807	653	0	148826
28500	2435	142099	710	600	0	145844
28501	1903	144575	700	650	0	147828
28502	141877	3111	837	605	0	146430
28503	140170	1826	712	636	0	143344
28504	3285	1153	558	137207	0	142203
28505	136292	1001	572	1808	0	139673
28506	2549	917	134871	1328	0	139665
28507	1904	135508	1779	904	0	140095
28508	132334	1852	1406	874	0	136466
28509	2313	1505	133068	671	0	137557
28510	1743	1722	1752	112235	0	117452
28511	967	120903	1339	1279	0	124488
28512	1022	122584	640	1020	0	125266
28513	120954	2236	978	536	0	124704
28514	2000	1332	119036	502	0	122870
28515	109905	604	1543	323	0	112375
28516	2040	545	1080	111103	0	114768
28517	1472	515	111068	1136	0	114191
28518	106294	544	1470	948	0	109256
28519	1659	115018	1069	457	0	118203
28520	1132	117348	624	411	0	119515
28521	116167	1910	921	405	0	119403
28522	115332	1102	516	481	0	117431
28523	115829	515	273	518	0	117135
28524	2115	527	313	113033	0	115988
28525	1346	551	355	113234	0	115486
28526	770	399	112734	1521	0	115424
28527	678	416	111219	864	0	113177
28528	577	111343	1528	526	0	113974
28529	624	1336	762	96575	0	99297
28530	95150	533	332	609	0	96624
28531	670	96270	202	623	0	97765
28532	585	740	139	96187	0	97651
28533	95641	533	202	674	0	97050
28534	674	97785	237	620	0	99316
28535	625	102963	211	288	0	104087
28536	546	936	98332	170	0	99984
28537	95905	613	601	246	0	97365
28538	101025	338	534	262	0	102159
28539	898	266	99875	238	0	101277
28540	90763	190	515	204	0	91672
28541	672	245	99075	126	0	100118
28542	451	96679	496	193	0	97819
28543	541	649	463	94554	0	96207
28544	93596	333	235	410	0	94574
28545	463	94458	165	360	0	95446
28546	357	93592	158	171	0	94278
28547	87957	485	108	144	0	88694
28548	381	350	94370	107	0	95208
28549	88414	106	389	169	0	89078
28550	319	97765	269	197	0	98550
28551	369	333	93333	90	0	94125
28552	92045	200	313	111	0	92669
28553	96895	77	222	107	0	97301
28554	482	93	56	95809	0	96440
28555	264	89	70	97658	0	98081
28556	100	99179	135	453	0	99867
28557	169	378	100145	274	0	100966
28558	155	224	319	100696	0	101394
28559	187	178	108331	450	0	109146
28560	170	112	109917	313	0	110512
28561	131	97	648	113186	0	114062
28562	184	128	119462	596	0	120370
28563	222	126	120321	387	0	121056
28564	146	112	957	111582	0	112797
28565	140	130	121873	592	0	122735
28566	100026	137	803	535	0	101501
28567	580	119477	473	313	0	120843
28568	508	620	124335	141	0	125604
28569	334	472	134237	107	0	135150
28570	166	156	971	126513	0	127806
28571	137552	73	465	617	0	138707
28572	137539	77	156	455	0	138227
28573	137618	63	135	179	0	137995
28574	138394	70	117	197	0	138778
28575	990	111	121	135271	0	136493
28576	589	181	141931	626	0	143327
28577	139199	103	664	508	0	140474
28578	145353	88	483	185	0	146109
28579	145887	82	165	243	0	146377
28580	1162	182	144485	141	0	145970
28581	131359	122	744	199	0	132424
28582	760	159	550	148883	0	150352
28583	511	157138	340	778	0	158767
28584	308	876	225	149779	0	151188
28585	158	158699	253	773	0	159883
28586	157514	755	265	534	0	159068
28587	919	573	163491	236	0	165219
28588	641	244	907	152956	0	154748
28589	190	164735	752	762	0	166439
28590	155	167772	328	700	0	168955
28591	166459	1246	319	276	0	168300
28592	165827	552	253	224	0	166856
28593	1410	273	162235	218	0	164136
28594	159822	150	947	200	0	161119
28595	1013	131	651	162967	0	164762
28596	812	214	175306	892	0	177224
28597	526	205	174354	641	0	175726
28598	392	175	1367	175471	0	177405
28599	187809	92	723	1194	0	189818
28600	1209	117	260	187605	0	189191
28601	935	112	212	188118	0	189377
28602	431	151	236	185558	0	186376
28603	331	191187	319	1704	0	193541
28604	420	962	236	191866	0	193484
28605	182381	675	222	1210	0	184488
28606	1092	190484	289	1061	0	192926
28607	886	1013	196	190459	0	192554
28608	186912	732	233	1241	0	189118
28609	1109	189270	355	944	0	191678
28610	846	191368	371	458	0	193043
28611	361	1735	278	188155	0	190529
28612	185170	823	274	1220	0	187487
28613	1214	412	189787	865	0	192278
28614	985	349	187764	348	0	189446
28615	182993	251	1857	363	0	185464
28616	193196	277	965	310	0	194748
28617	1949	200706	470	535	0	203660
28618	1232	1287	416	192626	0	195561
28619	587	908	198175	1272	0	200942
28620	493	346	194939	1011	0	196789
28621	477	335	206553	489	0	207854
28622	420	205898	2476	578	0	209372
28623	368	206999	1285	626	0	209278
28624	203591	2053	534	575	0	206753
28625	1725	1037	207581	406	0	210749
28626	198122	285	1601	534	0	200542
28627	204298	266	1167	527	0	206258
28628	2481	362	214474	607	0	217924
28629	1244	221952	1646	642	0	225484
28630	637	1766	1104	216370	0	219877
28631	735	1236	226126	1666	0	229763
28632	689	594	221608	1209	0	224100
28633	195239	635	2635	660	0	199169
28634	1710	224389	1320	622	0	228041
28635	1413	1799	395	215109	0	218716
28636	686	1437	437	207984	0	210544
28637	546	222375	558	2494	0	225973
28638	597	227258	588	1423	0	229866
28639	726	229814	579	605	0	231724
28640	770	2883	442	231918	0	236013
28641	238520	1352	442	1949	0	242263
28642	2270	472	493	242768	0	246003
28643	1783	566	244639	2282	0	249270
28644	762	609	244342	1592	0	247305
28645	637	527	3427	243447	0	248038
28646	757	568	249522	2288	0	253135
28647	576	249498	2526	2082	0	254682
28648	774	2217	1663	251867	0	256521
28649	262853	1532	668	2528	0	267581
28650	256925	624	569	1908	0	260026
28651	3697	267723	672	1025	0	273117
28652	271816	2610	572	842	0	275840
28653	272661	1759	507	829	0	275756
28654	272603	574	548	926	0	274651
28655	4166	749	263592	698	0	269205
28656	251314	611	2616	807	0	255348
28657	2632	264673	1874	1372	0	270551
28658	2000	2525	266679	701	0	271905
28659	1066	1859	267372	679	0	270976
28660	747	265100	3888	902	0	270637
28661	258273	2620	2283	564	0	263740
28662	2703	1783	777	247350	0	252613
28663	1699	254535	765	2418	0	259417
28664	255770	2474	608	1636	0	260488
28665	2618	1811	575	255137	0	260141
28666	258154	626	658	2656	0	262094
28667	2675	563	562	261347	0	265147
28668	1971	692	259628	2672	0	264963
28669	886	749	253216	1901	0	256752
28670	1034	775	257165	607	0	259581
28671	831	738	4019	236951	0	242539
28672	841	730	1988	253961	0	257520
28673	980	833	255613	3845	0	261271
28674	835	253959	2925	2189	0	259908
28675	255398	2607	2026	693	0	260724
28676	249351	1919	914	682	0	252866
28677	4137	256291	1003	787	0	262218
28678	2267	3333	930	250657	0	257187
28679	1089	1990	262722	2699	0	268500
28680	243737	726	3401	2019	0	249883
28681	3196	755	264824	734	0	269509
28682	2304	740	254879	611	0	258534
28683	1068	795	253701	582	0	256146
28684	229488	724	4849	690	0	235751
28685	3224	723	248498	674	0	253119
28686	2098	242573	3334	711	0	248716
28687	1146	245654	2440	657	0	249897
28688	1210	4129	1137	232144	0	238620
28689	868	1994	939	236119	0	239920
28690	838	770	237768	3813	0	243189
28691	216907	657	3140	2071	0	222775
28692	235376	638	2218	729	0	238961
28693	4292	628	1046	235672	0	241638
28694	235495	613	959	2753	0	239820
28695	2931	236080	1020	2275	0	242306
28696	227733	2707	891	794	0	232125
28697	3022	227203	949	1002	0	232176
28698	2010	225963	970	964	0	229907
28699	218015	3817	941	923	0	223696
28700	218844	1865	980	726	0	222415
28701	222297	722	983	689	0	224691
28702	223474	640	1029	674	0	225817
28703	4349	768	215394	649	0	221160
28704	207450	719	3080	607	0	211856
28705	3155	819	2111	204641	0	210726
28706	2141	214688	1129	2614	0	220572
28707	212032	2716	968	1845	0	217561
28708	3009	215382	998	1055	0	220444
28709	215207	2712	992	768	0	219679
28710	3259	1856	930	211920	0	217965
28711	2468	798	968	215522	0	219756
28712	1395	845	215646	3854	0	221740
28713	1588	839	215078	2026	0	219531
28714	1235	214034	4119	1143	0	220531
28715	201803	2633	2216	902	0	207554
28716	2981	206464	1071	986	0	211502
28717	2352	203158	889	1008	0	207407
28718	1638	208405	872	808	0	211723
28719	2204	3856	197955	642	0	204657
28720	1405	204954	2712	778	0	209849
28721	189085	2829	2064	688	0	194666
28722	189886	1871	906	635	0	193298
28723	4008	950	888	180992	0	186838
28724	2218	187518	1041	2235	0	193012
28725	1230	189986	1063	1684	0	193963
28726	1447	3644	831	184975	0	190897
28727	1626	2001	187094	2313	0	193034
28728	1288	181054	2569	1853	0	186764
28729	1697	2874	1750	172303	0	178624
28730	167539	1897	838	2344	0	172618
28731	167654	988	846	1681	0	171169
28732	3340	172284	931	1064	0	177619
28733	171119	2511	912	758	0	175300
28734	169719	1794	928	706	0	173147
28735	3647	1080	919	164316	0	169962
28736	2132	1070	163396	2221	0	168819
28737	1206	164410	2481	1895	0	169992
28738	1301	3433	1741	158983	0	165458
28739	1258	1976	159231	1903	0	164368
28740	1018	152481	2128	1368	0	156995
28741	140231	2152	1841	603	0	144827
28742	140242	1553	695	506	0	142996
28743	2787	994	554	136013	0	140348
28744	1588	140556	653	1618	0	144415
28745	1181	2007	138413	1198	0	142799
28746	1103	1994	1672	134046	0	138815
28747	1052	1016	138401	1639	0	142108
28748	799	126814	1585	1310	0	130508
28749	2034	2040	1689	111967	0	117730
28750	110853	1142	620	1154	0	113769
28751	1311	110852	441	1050	0	113654
28752	108429	1308	388	450	0	110575
28753	105625	1137	304	436	0	107502
28754	1900	109952	351	580	0	112783
28755	1328	1361	400	108171	0	111260
28756	832	1385	303	106854	0	109374
28757	677	106806	432	1617	0	109532
28758	739	108629	480	957	0	110805
28759	803	1939	361	97963	0	101066
28760	675	105106	414	1016	0	107211
28761	103778	1331	365	741	0	106215
28762	102907	1080	307	414	0	104708
28763	1726	750	103425	384	0	106285
28764	1074	637	102220	402	0	104333
28765	94252	660	1455	452	0	96819
28766	100148	606	797	368	0	101919
28767	1477	104070	460	486	0	106493
28768	102346	1238	440	496	0	104520
28769	100912	962	373	320	0	102567
28770	1547	100338	335	445	0	102665
28771	101670	1158	299	439	0	103566
28772	1329	1221	301	115101	0	117952
28773	951	860	401	119293	0	121505
28774	685	583	127125	1903	0	130296
28775	437	124815	1350	959	0	127561
28776	365	127298	812	520	0	128995
28777	119950	3029	1377	1271	0	125627
28778	120289	947	361	356	0	121953
28779	119025	346	142	303	0	119816
28780	121555	247	279	316	0	122397
28781	1816	324	121424	210	0	123774
28782	855	416	121746	208	0	123225
28783	325	122807	1697	287	0	125116
28784	360	1304	747	120612	0	123023
28785	433	947	265	112856	0	114501
28786	362	123795	225	1517	0	125899
28787	419	1311	181	120519	0	122430
28788	118985	788	214	1184	0	121171
28789	1326	121763	280	803	0	124172
28790	1035	1326	125112	294	0	127767
28791	434	128066	1263	411	0	130174
28792	126355	1330	798	359	0	128842
28793	1340	950	127586	336	0	130212
28794	123075	417	1359	379	0	125230
28795	127580	340	780	335	0	129035
28796	1897	468	127714	350	0	130429
28797	960	336	127790	257	0	129343
28798	505	413	126398	232	0	127548
28799	112977	361	1899	234	0	115471
28800	1550	332	126009	296	0	128187
28801	944	123542	1349	476	0	126311
28802	122276	1197	874	191	0	124538
28803	1397	777	123541	158	0	125873
28804	115714	273	1424	237	0	117648
28805	1471	316	123782	190	0	125759
28806	985	325	126466	177	0	127953
28807	513	126172	1921	382	0	128988
28808	521	1331	127605	250	0	129707
28809	731	829	125900	208	0	127668
28810	444	117215	2069	525	0	120253
28811	118814	1316	1015	257	0	121402
28812	1576	896	122182	200	0	124854
28813	1028	460	1584	104033	0	107105
28814	519	123133	1046	1021	0	125719
28815	120694	1354	579	790	0	123417
28816	120705	848	635	443	0	122631
28817	2047	513	123063	319	0	125942
28818	1089	120952	1680	356	0	124077
28819	611	123881	1291	310	0	126093
28820	731	2157	668	113676	0	117232
28821	716	122200	666	1456	0	125038
28822	918	1764	613	112078	0	115373
28823	990	1130	569	120376	0	123065
28824	832	123906	795	1910	0	127443
28825	920	1611	801	118873	0	122205
28826	766	123334	827	1480	0	126407
28827	806	1838	119356	1012	0	123012
28828	799	1405	1755	117943	0	121902
28829	762	987	1255	116568	0	119572
28830	778	121501	860	2050	0	125189
28831	958	124205	724	1143	0	127030
28832	923	2495	690	113193	0	117301
28833	740	122081	981	1441	0	125243
28834	116048	2048	854	1060	0	120010
28835	1857	1409	863	116951	0	121080
28836	1223	121907	1079	1587	0	125796
28837	117434	1884	828	1049	0	121195
28838	1833	119319	990	601	0	122743
28839	1532	1905	115683	555	0	119675
28840	1028	1349	2085	113920	0	118382
28841	115021	960	1592	1510	0	119083
28842	2043	787	118724	999	0	122553
28843	1310	1088	2237	108995	0	113630
28844	1041	116749	1571	1462	0	120823
28845	1174	1860	114093	942	0	118069
28846	922	117397	2210	536	0	121065
28847	111493	1768	1617	444	0	115322
28848	112134	1300	1488	444	0	115366
28849	2284	113408	1494	513	0	117699
28850	112022	1848	1341	389	0	115600
28851	1909	1336	111804	394	0	115443
28852	1240	903	2455	105900	0	110498
28853	888	1175	1674	103652	0	107389
28854	1094	110918	1297	1671	0	114980
28855	116898	1825	1426	971	0	121120
28856	121477	1431	993	587	0	124488
28857	2292	1134	122025	347	0	125798
28858	119626	872	2202	439	0	123139
28859	123049	1028	1508	462	0	126047
28860	123306	848	1225	531	0	125910
28861	2454	1045	966	119695	0	124160
28862	1313	1192	966	119566	0	123037
28863	1002	122833	859	1998	0	126692
28864	119102	2089	1017	1020	0	123228
28865	118053	1357	778	850	0	121038
28866	2110	120600	722	746	0	124178
28867	1204	2314	719	112275	0	116512
28868	819	117946	560	1613	0	120938
28869	1280	120672	674	1104	0	123730
28870	115559	2386	1020	837	0	119802
28871	1557	1589	116527	807	0	120480
28872	781	627	98831	341	0	100580
28873	346	97718	1152	384	0	99600
28874	85189	745	1291	278	0	87503
28875	677	596	86988	215	0	88476
28876	355	82777	579	301	0	84012
28877	78956	399	335	176	0	79866
28878	458	363	78981	110	0	79912
28879	270	203	389	73904	0	74766
28880	82018	132	262	441	0	82853
28881	480	175	85651	284	0	86590
28882	357	189	90324	121	0	90991
28883	150	183	93676	95	0	94104
28884	129	167	92588	98	0	92982
28885	79376	194	970	124	0	80664
28886	92448	109	432	109	0	93098
28887	583	95375	123	153	0	96234
28888	365	449	73	96346	0	97233
28889	433	346	80	98135	0	98994
28890	100	98597	115	786	0	99598
28891	142	571	63	95704	0	96480
28892	79	101551	125	529	0	102284
28893	100	101911	93	461	0	102565
28894	112	958	76	99011	0	100157
28895	151	535	100794	627	0	102107
28896	83	101783	648	577	0	103091
28897	117	624	461	100523	0	101725
28898	101709	482	139	583	0	102913
28899	668	147	99590	3393	0	103798
28900	99126	113	664	147	0	100050
28901	103495	127	491	109	0	104222
28902	1104	143	120	105025	0	106392
28903	646	141	111533	754	0	113074
28904	268	170	112649	560	0	113647
28905	144	117398	1371	247	0	119160
28906	216	953	656	113490	0	115315
28907	217	691	116625	889	0	118422
28908	177	182	118883	671	0	119913
28909	125	119340	1569	312	0	121346
28910	118626	971	769	139	0	120505
28911	119450	668	251	165	0	120534
28912	1545	214	195	123117	0	125071
28913	826	173	129406	1094	0	131499
28914	302	201	130239	868	0	131610
28915	179	131671	2023	590	0	134463
28916	336	1125	133997	191	0	135649
28917	299	943	132754	162	0	134158
28918	252	502	2315	114933	0	118002
28919	198	254	131428	1251	0	133131
28920	117418	183	1548	946	0	120095
28921	1164	171	1089	130071	0	132495
28922	997	197	134824	1241	0	137259
28923	233	134913	1410	1121	0	137677
28924	242	1220	1077	135299	0	137838
28925	317	976	138237	1269	0	140799
28926	173	141019	1481	1195	0	143868
28927	268	1331	1146	133406	0	136151
28928	199	143779	487	1176	0	145641
28929	223	1424	393	142220	0	144260
28930	247	994	440	143372	0	145053
28931	254	402	142963	2159	0	145778
28932	175	144327	1574	1342	0	147418
28933	245	1395	1421	143117	0	146178
28934	236	1036	509	143422	0	145203
28935	193	356	488	146726	0	147763
28936	247	374	143732	2313	0	146666
28937	214	142817	1606	1572	0	146209
28938	239	1410	1267	142025	0	144941
28939	330	1221	142986	1587	0	146124
28940	175	143109	1650	1601	0	146535
28941	223	1522	1267	141535	0	144547
28942	297	1265	144605	1579	0	147746
28943	160	144796	1654	1577	0	148187
28944	211	1570	1337	139859	0	142977
28945	221	1258	591	145906	0	147976
28946	261	540	150434	2408	0	153643
28947	131372	383	1845	1597	0	135197
28948	1259	150772	1395	790	0	154216
28949	150941	1531	622	632	0	153726
28950	1494	1245	152915	627	0	156281
28951	148881	500	1831	604	0	151816
28952	1516	417	1464	150599	0	153996
28953	1085	478	697	157458	0	159718
28954	400	532	156550	2486	0	159968
28955	138305	410	1901	1562	0	142178
28956	145261	421	1526	747	0	147955
28957	2181	147490	781	767	0	151219
28958	1197	151843	671	782	0	154493
28959	150382	2435	620	644	0	154081
28960	1623	1444	151995	682	0	155744
28961	1168	160096	1941	770	0	163975
28962	519	1701	1507	160588	0	164315
28963	434	1310	807	163824	0	166375
28964	438	628	164348	2504	0	167918
28965	152238	425	2004	1679	0	156346
28966	1671	533	168447	726	0	171377
28967	161292	451	2179	698	0	164620
28968	1914	512	173392	685	0	176503
28969	1295	172834	2191	734	0	177054
28970	174249	1722	1990	676	0	178637
28971	173928	1428	934	698	0	176988
28972	172723	606	755	675	0	174759
28973	172949	499	783	607	0	174838
28974	2713	495	743	169937	0	173888
28975	1439	618	171608	1849	0	175514
28976	648	597	1984	163608	0	166837
28977	502	172649	1639	1879	0	176669
28978	546	1726	833	171907	0	175012
28979	485	1325	172742	1907	0	176459
28980	507	616	172336	1415	0	174874
28981	598	701	2693	166138	0	170130
28982	166757	410	1919	1859	0	170945
28983	163747	467	841	1385	0	166440
28984	164580	459	726	748	0	166513
28985	2560	585	167980	814	0	171939
28986	1488	518	168552	678	0	171236
28987	639	168697	2610	717	0	172663
28988	471	169052	1453	757	0	171733
28989	163984	2117	1302	635	0	168038
28990	162866	1203	651	689	0	165409
28991	1996	172924	574	803	0	176297
28992	171083	1370	516	591	0	173560
28993	169154	1084	527	532	0	171297
28994	1992	172453	564	708	0	175717
28995	175359	1376	516	657	0	177908
28996	173026	1103	488	567	0	175184
28997	2079	179330	560	720	0	182689
28998	180796	1388	523	508	0	183215
28999	178932	1049	610	581	0	181172
29000	2244	644	183987	529	0	187404
29001	1374	470	183737	479	0	186060
29002	624	182274	2075	477	0	185450
29003	560	183097	1239	465	0	185361
29004	179402	1982	1781	431	0	183596
29005	175196	979	588	400	0	177163
29006	171945	361	373	312	0	172991
29007	1692	176335	427	455	0	178909
29008	1006	987	333	176237	0	178563
29009	666	891	179526	931	0	182014
29010	609	1112	1041	169200	0	171962
29011	498	181286	889	997	0	183670
29012	176355	752	345	536	0	177988
29013	940	176139	348	419	0	177846
29014	794	804	231	173190	0	175019
29015	185714	502	250	912	0	187378
29016	184030	242	269	544	0	185085
29017	1542	326	188530	237	0	190635
29018	186467	314	946	268	0	187995
29019	197022	245	672	306	0	198245
29020	198950	266	340	311	0	199867
29021	1794	400	309	190656	0	193159
29022	1024	197304	348	1082	0	199758
29023	628	1131	300	200677	0	202736
29024	657	910	203523	1122	0	206212
29025	612	206535	1250	1045	0	209442
29026	589	1201	864	201227	0	203881
29027	613	870	206212	1085	0	208780
29028	579	205336	1240	918	0	208073
29029	685	1327	792	197372	0	200176
29030	689	897	207279	987	0	209852
29031	167257	466	1475	1295	0	170493
29032	1540	466	209782	333	0	212121
29033	1162	501	210000	326	0	211989
29034	653	213274	1849	490	0	216266
29035	670	1410	928	211078	0	214086
29036	708	1131	432	199609	0	201880
29037	672	214411	484	1690	0	217257
29038	740	1358	402	211729	0	214229
29039	217983	965	369	1400	0	220717
29040	218311	437	411	942	0	220101
29041	2288	492	219128	388	0	222296
29042	211524	440	1442	409	0	213815
29043	223293	455	982	470	0	225200
29044	2358	583	226481	371	0	229793
29045	1343	229424	1524	492	0	232783
29046	802	229210	1068	407	0	231487
29047	1109	2453	543	191592	0	195697
29048	729	225210	561	1142	0	227642
29049	927	1809	216289	736	0	219761
29050	1002	1213	219947	313	0	222475
29051	736	227935	2133	499	0	231303
29052	226580	1614	958	383	0	229535
29053	230023	1130	339	404	0	231896
29054	232944	623	377	413	0	234357
29055	232701	610	385	407	0	234103
29056	224495	563	433	441	0	225932
29057	2344	228980	528	495	0	232347
29058	1486	1833	226233	308	0	229860
29059	883	1139	1500	224193	0	227715
29060	218978	656	1053	1518	0	222205
29061	1745	221337	545	1481	0	225108
29062	1404	1776	455	217533	0	221168
29063	930	1171	220068	1412	0	223581
29064	737	217361	1651	1104	0	220853
29065	596	221918	1167	561	0	224242
29066	211389	2739	954	1014	0	216096
29067	1446	215480	440	545	0	217911
29068	1210	1406	315	206191	0	209122
29069	209454	943	271	1276	0	211944
29070	208452	440	294	862	0	210048
29071	209952	419	276	387	0	211034
29072	2107	546	206846	323	0	209822
29073	1071	209896	1311	477	0	212755
29074	214403	1361	869	368	0	217001
29075	1520	1065	327	212570	0	215482
29076	216057	421	294	1424	0	218196
29077	1599	215097	437	1065	0	218198
29078	225110	1501	290	405	0	227306
29079	240350	1035	321	425	0	242131
29080	2908	500	307	238088	0	241803
29081	1677	695	251071	1943	0	255386
29082	867	462	2109	254009	0	257447
29083	253990	435	1275	2378	0	258078
29084	253911	449	491	1335	0	256186
29085	3306	255239	522	920	0	259987
29086	246889	2185	462	514	0	250050
29087	2470	253883	503	720	0	257576
29088	253929	2336	425	535	0	257225
29089	249674	1418	465	564	0	252121
29090	3416	827	251778	501	0	256522
29091	1675	254274	2326	696	0	258971
29092	971	2531	1392	254431	0	259325
29093	850	1508	560	259074	0	261992
29094	813	747	502	245576	0	247638
29095	705	255472	634	3530	0	260341
29096	818	2538	254711	1531	0	259598
29097	939	1626	258284	641	0	261490
29098	713	293890	3534	1079	0	299216
29099	291166	3257	1662	590	0	296675
29100	3522	2030	292349	605	0	298506
29101	276536	834	3318	611	0	281299
29102	3541	286663	2011	874	0	293089
29103	2378	3446	289013	545	0	295382
29104	1178	1923	3335	280547	0	286983
29105	987	1029	295038	3359	0	300413
29106	1081	867	299535	1966	0	303449
29107	1597	1039	4775	249253	0	256664
29108	1045	290864	2349	2632	0	296890
29109	1000	296471	954	1830	0	300255
29110	289368	4727	776	2954	0	297825
29111	3822	2384	291324	574	0	298104
29112	284476	1090	3574	710	0	289850
29113	290377	866	2197	693	0	294133
29114	4803	294310	1077	805	0	300995
29115	285159	3457	564	583	0	289763
29116	285080	2019	557	526	0	288182
29117	273069	865	656	633	0	275223
29118	4947	273752	723	778	0	280200
29119	2197	261062	806	687	0	264752
29120	1156	269229	724	764	0	271873
29121	267275	4419	1539	502	0	273735
29122	265859	2169	752	779	0	269559
29123	4726	1071	261235	421	0	267453
29124	2339	876	255628	360	0	259203
29125	254030	691	4022	483	0	259226
29126	260573	591	1736	449	0	263349
29127	261270	624	710	543	0	263147
29128	4557	583	589	254139	0	259868
29129	2264	577	581	259040	0	262462
29130	1163	588	569	262240	0	264560
29131	1062	673	747	263308	0	265790
29132	1084	795	257767	4120	0	263766
29133	1149	743	254912	1793	0	258597
29134	1261	747	254432	748	0	257188
29135	1206	705	251556	542	0	254009
29136	238028	553	4218	594	0	243393
29137	3293	251297	2036	789	0	257415
29138	2158	256362	985	903	0	260408
29139	251549	3927	852	585	0	256913
29140	3689	1932	251376	578	0	257575
29141	2183	935	245223	674	0	249015
29142	234601	922	4747	909	0	241179
29143	244464	653	2122	804	0	248043
29144	4283	245582	1181	1026	0	252072
29145	2452	2917	842	241728	0	247939
29146	245980	1696	779	2724	0	251179
29147	248569	1058	728	1523	0	251878
29148	4837	1045	722	237810	0	244414
29149	2690	253329	803	2795	0	259617
29150	251616	3206	635	1632	0	257089
29151	3848	2085	249173	745	0	255851
29152	239878	1028	3277	733	0	244916
29153	3597	248915	2081	873	0	255466
29154	249318	3289	1102	863	0	254572
29155	245713	2000	1024	947	0	249684
29156	4537	1109	249323	953	0	255922
29157	2352	1074	247007	787	0	251220
29158	239130	810	4726	705	0	245371
29159	247461	861	2485	687	0	251494
29160	4358	251313	1453	774	0	257898
29161	2596	3211	1111	249595	0	256513
29162	1540	2035	249616	2902	0	256093
29163	240686	969	3469	1609	0	246733
29164	3662	952	2234	247029	0	253877
29165	2384	804	1332	250239	0	254759
29166	247488	713	1159	4111	0	253471
29167	3305	255169	1406	2339	0	262219
29168	256866	3031	1176	999	0	262072
29169	257076	1793	1096	792	0	260757
29170	260006	1102	1046	647	0	262801
29171	5007	258618	965	804	0	265394
29172	259172	3406	807	586	0	263971
29173	4243	2090	951	257462	0	264746
29174	3023	1120	847	256551	0	261541
29175	2757	923	255966	4211	0	263857
29176	2376	984	253964	1824	0	259148
29177	1859	253897	4372	1002	0	261130
29178	1656	253080	2021	710	0	257467
29179	2135	3610	230342	479	0	236566
29180	1250	235483	2925	713	0	240371
29181	223787	3450	2632	1216	0	231085
29182	224885	1450	553	586	0	227474
29183	226243	680	446	471	0	227840
29184	3961	622	495	215989	0	221067
29185	2174	451	593	223700	0	226918
29186	1380	539	226986	3337	0	232242
29187	900	226125	2572	1773	0	231370
29188	218847	2530	1580	619	0	223576
29189	2618	226375	758	604	0	230355
29190	223485	2663	564	413	0	227125
29191	222067	1476	544	537	0	224624
29192	4125	568	560	215690	0	220943
29193	2108	566	614	220096	0	223384
29194	1297	731	530	223129	0	225687
29195	1476	688	215048	3513	0	220725
29196	1050	213307	2484	2051	0	218892
29197	867	210589	1558	987	0	214001
29198	506	165596	359	572	0	167033
29199	460	164748	423	532	0	166163
29200	522	166283	557	545	0	167907
29201	147497	1903	798	371	0	150569
29202	1391	1121	160089	299	0	162900
29203	987	162495	1164	561	0	165207
29204	731	1395	154502	308	0	156936
29205	497	162622	1173	459	0	164751
29206	621	1812	877	133082	0	136392
29207	626	931	339	148886	0	150782
29208	437	160755	354	1732	0	163278
29209	154791	1190	363	944	0	157288
29210	1317	1093	158623	402	0	161435
29211	955	162097	1143	618	0	164813
29212	621	1495	159484	363	0	161963
29213	550	1063	1165	156265	0	159043
29214	636	627	830	147904	0	149997
29215	579	160163	408	1637	0	162787
29216	665	1322	303	159999	0	162289
29217	596	1021	322	159505	0	161444
29218	558	163819	451	1856	0	166684
29219	597	1428	162292	1046	0	165363
29220	513	1106	163625	542	0	165786
29221	150235	745	1757	524	0	153261
29222	163191	639	891	485	0	165206
29223	1819	665	442	160045	0	162971
29224	1184	752	162514	1269	0	165719
29225	766	749	1192	153237	0	155944
29226	713	170645	991	1532	0	173881
29227	710	1521	170064	1111	0	173406
29228	498	170610	1307	846	0	173261
29229	641	1537	167628	666	0	170472
29230	380	169078	1340	757	0	171555
29231	165059	1553	981	581	0	168174
29232	1258	1250	517	164335	0	167360
29233	979	850	442	164165	0	166436
29234	637	886	165668	1696	0	168887
29235	814	805	162244	1066	0	164929
29236	552	165708	1851	728	0	168839
29237	164619	1465	1104	770	0	167958
29238	1288	1135	625	161388	0	164436
29239	1007	944	168297	1234	0	171482
29240	569	924	163870	1056	0	166419
29241	150502	811	1904	729	0	153946
29242	161920	835	1070	650	0	164475
29243	1916	879	168060	546	0	171401
29244	1188	1395	1412	155027	0	159022
29245	651	169457	1186	1254	0	172548
29246	167701	1428	670	1087	0	170886
29247	1342	169417	637	870	0	172266
29248	160878	1214	577	721	0	163390
29249	1137	164714	499	720	0	167070
29250	876	168438	539	757	0	170610
29251	693	1687	484	167400	0	170264
29252	506	1277	455	167325	0	169563
29253	418	171064	539	1793	0	173814
29254	597	1441	167213	961	0	170212
29255	563	1270	167868	449	0	170150
29256	529	857	168058	483	0	169927
29257	154579	628	1688	617	0	157512
29258	166261	637	950	596	0	168444
29259	1420	175047	653	810	0	177930
29260	921	1645	173619	561	0	176746
29261	376	1301	1437	172293	0	175407
29262	393	954	185120	1543	0	188010
29263	451	993	190294	1048	0	192786
29264	385	893	2303	198395	0	201976
29265	522	773	1371	205365	0	208031
29266	477	867	225229	3166	0	229739
29267	202727	740	2582	2099	0	208148
29268	2280	232568	2225	1142	0	238215
29269	1838	239858	1100	776	0	243572
29270	823	4589	641	227987	0	234040
29271	237004	2556	645	2459	0	242664
29272	2672	246065	780	2382	0	251899
29273	241761	3368	487	912	0	246528
29274	3131	248406	624	1132	0	253293
29275	252702	3701	616	691	0	257710
29276	3908	2798	252690	616	0	260012
29277	2883	1421	256221	492	0	261017
29278	1317	1824	4971	244508	0	252620
29279	1087	968	250594	3206	0	255855
29280	789	239667	3911	2556	0	246923
29281	699	242420	2904	974	0	246997
29282	239809	4996	1494	782	0	247081
29283	3169	3082	960	225047	0	232258
29284	2354	243558	960	2896	0	249768
29285	247048	3446	749	2201	0	253444
29286	243464	2902	618	816	0	247800
29287	250593	1383	526	721	0	253223
29288	6050	999	547	244416	0	252012
29289	3600	869	508	248757	0	253734
29290	1875	940	249528	5359	0	257702
29291	1475	818	248804	3110	0	254207
29292	242449	613	5597	1415	0	250074
29293	3859	737	3183	238311	0	246090
29294	3138	719	246903	3561	0	254321
29295	237462	615	3818	2992	0	244887
29296	3745	252677	3265	1654	0	261341
29297	254669	3423	1470	1003	0	260565
29298	255894	2716	987	966	0	260563
29299	257233	1133	987	1066	0	260419
29300	6944	856	249979	963	0	258742
29301	244273	733	3751	823	0	249580
29302	5282	4356	2979	225452	0	238069
29303	3894	238910	1659	3324	0	247787
29304	2335	250611	1234	2652	0	256832
29305	249149	5354	1155	1148	0	256806
29306	249958	3119	1002	947	0	255026
29307	252332	1354	926	921	0	255533
29308	7239	1176	811	243143	0	252369
29309	4518	1135	851	246114	0	252618
29310	2836	1138	689	231387	0	236050
29311	2217	243602	839	6112	0	252770
29312	241617	3820	857	3448	0	249742
29313	243913	3122	741	1806	0	249582
29314	247358	1482	708	1658	0	251206
29315	7483	1396	242781	1470	0	253130
29316	243314	1249	3750	1227	0	249540
29317	5950	1468	2989	223515	0	233922
29318	4664	239079	1500	3687	0	248930
29319	236643	4098	1098	2851	0	244690
29320	235017	3161	1055	1522	0	240755
29321	7599	1692	237875	1223	0	248389
29322	5244	1207	4063	224857	0	235371
29323	2880	238171	3399	4191	0	248641
29324	241686	4241	1737	3195	0	250859
29325	5697	3482	1264	239961	0	250404
29326	4737	1839	1277	235368	0	243221
29327	2979	1517	1189	238864	0	244549
29328	2605	1481	1155	245413	0	250654
29329	2759	1674	240183	7648	0	252264
29330	2508	240018	4592	5126	0	252244
29331	2653	4836	3275	238157	0	248921
29332	2518	4072	242531	5477	0	254598
29333	236957	2139	4662	4423	0	248181
29334	245503	1740	3711	2722	0	253676
29335	8030	1797	2086	242452	0	254365
29336	245917	1737	1784	5386	0	254824
29337	249543	1616	1618	4504	0	257281
29338	8696	1784	246731	2616	0	259827
29339	5987	243619	4975	2217	0	256798
29340	244692	4607	3774	2254	0	255327
29341	6551	3610	2281	242689	0	255131
29342	248459	1893	1905	5195	0	257452
29343	7046	1546	1953	242419	0	252964
29344	5608	1730	1796	245621	0	254755
29345	3885	1763	239245	7658	0	252551
29346	211497	1623	4826	5305	0	223251
29347	6190	238920	3899	3582	0	252591
29348	5887	4715	237743	2733	0	251078
29349	3837	236929	4784	2795	0	248345
29350	231044	5004	3719	2410	0	242177
29351	6750	3845	1955	227252	0	239802
29352	226824	1911	1609	5364	0	235708
29353	6529	225670	1835	4847	0	238881
29354	231561	4716	1691	2629	0	240597
29355	233365	3522	1480	2407	0	240774
29356	235086	1892	1555	2338	0	240871
29357	231553	1277	1642	2203	0	236675
29358	9367	226896	1703	2349	0	240315
29359	222424	4425	1369	1823	0	230041
29360	7514	3600	1422	215792	0	228328
29361	6469	2977	1124	207774	0	218344
29362	4437	198738	1227	6173	0	210575
29363	4018	195647	1170	3835	0	204670
29364	3415	185192	989	1996	0	191592
29365	169437	4854	1433	1526	0	177250
29366	4183	154592	736	1448	0	160959
29367	2991	138725	812	967	0	143495
29368	135311	2971	2343	974	0	141599
29369	128259	1490	613	862	0	131224
29370	3427	129348	513	971	0	134259
29371	126354	1943	434	736	0	129467
29372	2733	1413	121499	682	0	126327
29373	118288	813	1580	747	0	121428
29374	2693	818	120235	778	0	124524
29375	1617	109656	1380	656	0	113309
29376	1094	111168	888	692	0	113842
29377	2866	2733	891	102921	0	109411
29378	107256	900	529	1437	0	110122
29379	108959	569	281	1004	0	110813
29380	110764	535	299	687	0	112285
29381	110787	492	357	620	0	112256
29382	108832	543	460	631	0	110466
29383	2129	600	105490	626	0	108845
29384	1309	623	102205	575	0	104712
29385	103903	545	1480	624	0	106552
29386	1645	107586	824	622	0	110677
29387	104658	1071	451	502	0	106682
29388	107863	733	303	510	0	109409
29389	111783	398	274	626	0	113081
29390	112209	411	284	569	0	113473
29391	111950	446	336	577	0	113309
29392	1850	546	112481	595	0	115472
29393	113729	514	947	747	0	115937
29394	115983	494	676	714	0	117867
29395	1833	630	114748	675	0	117886
29396	108663	565	993	696	0	110917
29397	113187	560	814	725	0	115286
29398	1950	602	120748	604	0	123904
29399	1506	641	119994	508	0	122649
29400	1209	122357	1399	629	0	125594
29401	1325	1224	823	121314	0	124686
29402	1361	855	124145	1041	0	127402
29403	123469	530	1038	867	0	125904
29404	1906	541	750	133803	0	137000
29405	1530	638	139972	1074	0	143214
29406	135743	555	1077	876	0	138251
29407	141134	534	744	516	0	142928
29408	141854	544	422	580	0	143400
29409	2154	146929	394	736	0	150213
29410	1601	1179	377	142340	0	145497
29411	1227	148472	457	1265	0	151421
29412	149009	1214	570	856	0	151649
29413	147084	933	537	645	0	149199
29414	2051	760	147529	375	0	150715
29415	1255	144307	1053	424	0	147039
29416	956	145231	751	366	0	147304
29417	1084	1472	416	141460	0	144432
29418	1027	960	305	143522	0	145814
29419	142111	607	235	1184	0	144137
29420	1697	143592	253	1038	0	146580
29421	1538	144866	257	463	0	147124
29422	1758	1502	142904	342	0	146506
29423	1206	148582	860	367	0	151015
29424	146008	1073	831	353	0	148265
29425	1720	968	145095	279	0	148062
29426	122481	447	867	447	0	124242
29427	1294	437	140819	356	0	142906
29428	111205	315	769	497	0	112786
29429	781	144055	466	388	0	145690
29430	150038	665	298	204	0	151205
29431	1119	654	157000	100	0	158873
29432	154864	281	1036	312	0	156493
29433	157428	161	842	245	0	158676
29434	1567	332	164790	100	0	166789
29435	162359	196	801	234	0	163590
29436	171139	200	600	189	0	172128
29437	168125	170	218	183	0	168696
29438	1650	169143	253	358	0	171404
29439	173107	954	234	242	0	174537
29440	1461	850	177813	101	0	180225
29441	909	186124	1089	431	0	188553
29442	186667	1096	954	226	0	188943
29443	184347	767	291	194	0	185599
29444	185938	227	202	169	0	186536
29445	1919	187934	268	449	0	190570
29446	1133	1185	180	207168	0	209666
29447	588	999	208251	1570	0	211408
29448	457	258	1645	206896	0	209256
29449	546	333	214381	1820	0	217080
29450	194273	233	1896	1290	0	197692
29451	1910	215583	1370	447	0	219310
29452	1589	1886	311	207095	0	210881
29453	507	217448	308	1728	0	219991
29454	511	2014	229	217517	0	220271
29455	472	1477	231	213871	0	216051
29456	436	223282	328	3102	0	227148
29457	453	2158	256	222994	0	225861
29458	519	1596	206	226396	0	228717
29459	458	232190	422	3530	0	236600
29460	486	236722	406	1973	0	239587
29461	567	3748	300	234571	0	239186
29462	770	1985	234957	2443	0	240155
29463	555	238157	2420	2204	0	243336
29464	650	2574	1674	233912	0	238810
29465	1052	2048	244742	2497	0	250339
29466	538	246951	2708	2228	0	252425
29467	244325	2665	1901	648	0	249539
29468	2905	2235	245410	549	0	251099
29469	234989	706	2669	564	0	238928
29470	2904	613	1908	242220	0	247645
29471	2202	634	559	244851	0	248246
29472	852	654	444	246326	0	248276
29473	862	779	243910	4416	0	249967
29474	815	725	243395	2289	0	247224
29475	220626	693	4461	981	0	226761
29476	2899	721	2167	240666	0	246453
29477	2358	815	243482	3015	0	249670
29478	232300	721	2987	2290	0	238298
29479	3183	754	2190	240125	0	246252
29480	2479	811	755	241434	0	245479
29481	1169	773	679	236779	0	239400
29482	889	241701	846	4925	0	248361
29483	1072	3121	648	228060	0	232901
29484	901	238591	805	3092	0	243389
29485	839	242845	817	2572	0	247073
29486	237472	4498	745	1118	0	243833
29487	227734	2546	823	1058	0	232161
29488	236399	968	707	1081	0	239155
29489	4531	232288	901	1317	0	239037
29490	231168	3131	785	1136	0	236220
29491	230729	2295	795	1148	0	234967
29492	4821	957	808	224358	0	230944
29493	2645	938	828	227070	0	231481
29494	1275	1117	224030	5077	0	231499
29495	918	225206	3144	3229	0	232497
29496	220774	3128	2426	1587	0	227915
29497	217519	2450	1091	1425	0	222485
29498	4430	216340	1034	1427	0	223231
29499	214729	3196	857	1306	0	220088
29500	211230	2489	754	1517	0	215990
29501	4718	1291	802	204572	0	211383
29502	2671	208247	925	3416	0	215259
29503	1291	210443	841	3114	0	215689
29504	201765	4430	904	1723	0	208822
29505	3394	2766	721	197568	0	204449
29506	2574	1457	196872	3729	0	204632
29507	186703	1248	3071	3061	0	194083
29508	3404	1459	198970	1745	0	205578
29509	2524	193059	3182	1784	0	200549
29510	190827	3218	2403	1569	0	198017
29511	3461	2699	191393	1649	0	199202
29512	2704	1627	3050	188753	0	196134
29513	1547	1409	196217	3765	0	202938
29514	1176	195588	3284	3622	0	203670
29515	1517	3568	2401	193439	0	200925
29516	1596	2783	193866	3694	0	201939
29517	175495	1488	3131	3350	0	183464
29518	3198	196631	2420	2141	0	204390
29519	2769	3550	1148	181970	0	189437
29520	1353	197949	1133	3789	0	204224
29521	192313	3564	1085	3001	0	199963
29522	189729	2844	1070	1979	0	195622
29523	4524	190550	1303	2025	0	198402
29524	2931	3504	1443	180689	0	188567
29525	1445	190242	1176	3686	0	196549
29526	185961	3502	1452	3061	0	193976
29527	3606	2808	186822	1886	0	195122
29528	2790	1695	183056	1658	0	189199
29529	1479	176891	4116	1689	0	184175
29530	1321	171200	2685	1478	0	176684
29531	1450	4052	1472	162733	0	169707
29532	161574	2349	1094	2877	0	167894
29533	162033	1110	1170	2347	0	166660
29534	155351	980	1013	1359	0	158703
29535	4354	159366	1084	1526	0	166330
29536	2592	2419	977	147644	0	153632
29537	1503	155650	936	2889	0	160978
29538	153525	2482	1002	2457	0	159466
29539	2919	1972	956	148980	0	154827
29540	2298	1006	143751	2741	0	149796
29541	1276	140098	2393	2343	0	146110
29542	135576	2260	1746	1194	0	140776
29543	2701	1879	136119	891	0	141590
29544	130735	1081	1940	1055	0	134811
29545	2640	133688	1481	1270	0	139079
29546	1480	115658	514	681	0	118333
29547	110999	2090	564	627	0	114280
29548	1602	115703	464	626	0	118395
29549	108898	1400	463	566	0	111327
29550	1423	111164	434	526	0	113547
29551	110688	1407	511	449	0	113055
29552	110131	1090	488	399	0	112108
29553	2093	689	113010	401	0	116193
29554	1234	631	108415	307	0	110587
29555	640	108971	1399	406	0	111416
29556	103974	982	1285	396	0	106637
29557	1087	909	102322	302	0	104620
29558	92463	454	865	274	0	94056
29559	757	645	738	91602	0	93742
29560	559	283	94425	469	0	95736
29561	332	266	92245	404	0	93247
29562	381	299	96385	203	0	97268
29563	235	94927	664	185	0	96011
29564	1492	2188	1307	87127	0	92114
29565	84820	196	167	296	0	85479
29566	192	76	56	86023	0	86347
29567	86976	51	82	227	0	87336
29568	224	56	51	87412	0	87743
29569	90221	61	54	318	0	90654
29570	93602	60	52	359	0	94073
29571	104216	56	58	162	0	104492
29572	633	110470	87	150	0	111340
29573	483	566	113770	96	0	114915
29574	148	373	494	113378	0	114393
29575	376	591	627	86119	0	87713
29576	149	108	85	118656	0	118998
29577	152	110	64	117214	0	117540
29578	105	117340	116	1054	0	118615
29579	286	623	114839	577	0	116325
29580	106	118351	640	296	0	119393
29581	163	760	459	113160	0	114542
29582	141	569	107	118522	0	119339
29583	124	177	102	119963	0	120366
29584	157	146	74	118731	0	119108
29585	93	117760	132	1086	0	119071
29586	102	118209	186	684	0	119181
29587	262	1058	116178	253	0	117751
29588	128	540	641	116773	0	118082
29589	155	201	467	119306	0	120129
29590	143	167	130	122220	0	122660
29591	122449	171	125	1233	0	123978
29592	665	124600	175	840	0	126280
29593	697	814	123095	261	0	124867
29594	121549	540	684	298	0	123071
29595	801	175	496	125714	0	127186
29596	129199	164	133	937	0	130433
29597	814	182	93	130225	0	131314
29598	132168	189	122	933	0	133412
29599	848	175	127	131920	0	133070
29600	130849	134	213	908	0	132104
29601	964	254	138935	751	0	140904
29602	717	151	740	135551	0	137159
29603	267	143685	650	839	0	145441
29604	284	792	175	145662	0	146913
29605	143938	616	160	957	0	145671
29606	829	149061	270	872	0	151032
29607	804	938	177	151931	0	153850
29608	231	154325	286	1077	0	155919
29609	288	1050	166	155143	0	156647
29610	266	783	146	155566	0	156761
29611	352	358	154148	1730	0	156588
29612	317	226	1000	150342	0	151885
29613	363	322	151118	1277	0	153080
29614	202	148887	1174	1336	0	151599
29615	147084	1044	766	506	0	149400
29616	1171	823	149143	475	0	151612
29617	141805	268	1118	492	0	143683
29618	153700	208	827	504	0	155239
29619	1764	220	270	156141	0	158395
29620	985	370	165967	1346	0	168668
29621	158108	228	1560	1161	0	161057
29622	172963	178	1060	636	0	174837
29623	2282	229	334	170026	0	172871
29624	1219	210	268	170893	0	172590
29625	406	175350	327	2671	0	178754
29626	438	1612	257	171532	0	173839
29627	311	176513	352	1850	0	179026
29628	488	1762	174130	1254	0	177634
29629	317	1142	1476	172784	0	175719
29630	170226	321	1056	1888	0	173491
29631	172477	269	261	1344	0	174351
29632	2242	175338	360	810	0	178750
29633	1204	1667	227	175947	0	179045
29634	177388	1073	206	1793	0	180460
29635	1673	174977	360	1451	0	178461
29636	175816	1657	175	797	0	178445
29637	1897	1076	196	182387	0	185556
29638	192056	419	238	2097	0	194810
29639	2250	532	208159	1613	0	212554
29640	1417	212773	2412	886	0	217488
29641	208209	2424	1494	691	0	212818
29642	2264	218237	538	939	0	221978
29643	221079	2471	345	771	0	224666
29644	223942	1591	270	798	0	226601
29645	4102	640	226653	609	0	232004
29646	1958	410	2528	218638	0	223534
29647	228889	414	1573	2925	0	233801
29648	2940	548	228730	1899	0	234117
29649	225809	397	2679	859	0	229744
29650	2931	410	1565	229188	0	234094
29651	1953	554	228573	2981	0	234061
29652	738	351	2672	224291	0	228052
29653	222241	416	1689	3053	0	227399
29654	2970	607	231867	1971	0	237415
29655	1987	473	2650	230525	0	235635
29656	876	442	1749	233753	0	236820
29657	234492	322	521	4375	0	239710
29658	230568	302	529	2214	0	233613
29659	4114	243104	669	1485	0	249372
29660	2409	2674	436	242028	0	247547
29661	1165	1745	536	242677	0	246123
29662	1043	606	514	240705	0	242868
29663	236795	424	564	4513	0	242296
29664	237120	528	599	2378	0	240625
29665	4795	593	436	232541	0	238365
29666	2571	237235	548	3210	0	243564
29667	1430	3157	549	221124	0	226260
29668	1143	239106	712	3123	0	244084
29669	232501	2842	570	2395	0	238308
29670	3328	230444	831	1195	0	235798
29671	217862	2486	662	859	0	221869
29672	3254	1757	601	212425	0	218037
29673	211258	626	690	2855	0	215429
29674	3376	657	212744	2206	0	218983
29675	2286	217307	2660	1303	0	223556
29676	216371	2487	1957	1192	0	222007
29677	217971	1515	820	1124	0	221430
29678	4180	577	797	210011	0	215565
29679	2391	217418	816	3160	0	223785
29680	1568	2394	763	224774	0	229499
29681	1444	1558	775	224754	0	228531
29682	1517	672	716	224958	0	227863
29683	223742	768	702	4343	0	229555
29684	224589	732	668	2645	0	228634
29685	4647	744	581	216003	0	221975
29686	2759	225474	772	3254	0	232259
29687	225715	2478	716	2548	0	231457
29688	3807	1842	226735	1710	0	234094
29689	2867	906	2526	225100	0	231399
29690	1973	1036	231485	3472	0	237966
29691	1756	895	2576	227919	0	233146
29692	1817	1100	235388	3648	0	241953
29693	1771	953	2814	231527	0	237065
29694	234185	1080	1857	3652	0	240774
29695	232844	1023	873	2841	0	237581
29696	5082	231039	943	1789	0	238853
29697	236124	2882	786	1880	0	241672
29698	4123	2132	867	235978	0	243100
29699	3223	1188	953	236320	0	241684
29700	237648	1114	1245	4593	0	244600
29701	4326	1344	237727	2838	0	246235
29702	3571	1331	240708	2055	0	247665
29703	2564	1399	245527	2025	0	251515
29704	227790	1022	4032	2440	0	235284
29705	4448	1138	252135	2333	0	260054
29706	3545	1055	244257	2322	0	251179
29707	230217	1059	3975	2291	0	237542
29708	4086	258559	2302	2442	0	267389
29709	3362	2711	1260	263987	0	271320
29710	2479	2105	1024	267903	0	273511
29711	2504	1271	277653	4812	0	286240
29712	269142	1010	2794	3622	0	276568
29713	279731	913	2173	2792	0	285609
29714	274891	893	1375	2851	0	280010
29715	4899	1073	284236	2606	0	292814
29716	266626	811	3003	2944	0	273384
29717	4293	1282	278921	2699	0	287195
29718	3449	279753	2757	2845	0	288804
29719	2605	281276	2033	2571	0	288485
29720	269197	3184	1089	2359	0	275829
29721	3245	269158	1160	2638	0	276201
29722	2677	273946	1053	2765	0	280441
29723	270467	2949	1028	2659	0	277103
29724	3307	275371	1151	2648	0	282477
29725	276140	2273	1009	2260	0	281682
29726	3834	1766	978	286043	0	292621
29727	3152	1289	1030	289997	0	295468
29728	2310	1296	1026	291987	0	296619
29729	2172	1492	1123	282090	0	286877
29730	2134	290250	1304	4257	0	297945
29731	290922	2487	1138	2667	0	297214
29732	3537	320045	1347	2253	0	327182
29733	2959	320703	1589	2855	0	328106
29734	2506	3859	336245	1977	0	344587
29735	299879	1975	3883	2217	0	307954
29736	4592	1239	352784	1709	0	360324
29737	3601	1135	351578	1461	0	357775
29738	1755	350930	4253	1633	0	358571
29739	876	347671	1715	1127	0	351389
29740	327628	3906	1730	815	0	334079
29741	2770	353062	1009	1443	0	358284
29742	2011	2820	368246	809	0	373886
29743	722	329043	3519	1068	0	334352
29744	886	2377	367586	558	0	371407
29745	539	1268	362781	329	0	364917
29746	329666	528	4265	442	0	334901
29747	2774	463	362502	448	0	366187
29748	1323	254	2737	346501	0	350815
29749	342582	253	1445	2451	0	346731
29750	2184	345863	855	2219	0	351121
29751	1443	2390	356266	577	0	360676
29752	341859	1161	2657	387	0	346064
29753	2665	559	1478	322177	0	326879
29754	1326	329167	891	2564	0	333948
29755	583	2284	348498	2370	0	353735
29756	330662	1098	2730	514	0	335004
29757	2664	440	353899	439	0	357442
29758	1486	322	2877	332118	0	336803
29759	693	455	346571	2432	0	350151
29760	446	262	2769	337069	0	340546
29761	334547	199	1481	2771	0	338998
29762	2334	344489	664	2029	0	349516
29763	343637	2434	425	461	0	346957
29764	3012	1475	347812	457	0	352756
29765	1560	377	2782	331362	0	336081
29766	596	414	351976	2553	0	355539
29767	331435	257	3052	1490	0	336234
29768	342177	287	1549	589	0	344602
29769	3679	352039	720	973	0	357411
29770	353347	2670	447	350	0	356814
29771	351125	1378	397	387	0	353287
29772	3983	426	424	341611	0	346444
29773	1790	454	352015	2761	0	357020
29774	634	337572	3080	2152	0	343438
29775	674	2611	1542	332388	0	337215
29776	334652	1378	772	2662	0	339464
29777	2837	555	343305	1419	0	348116
29778	1849	460	342537	444	0	345290
29779	636	426	338166	333	0	339561
29780	314129	313	4440	430	0	319312
29781	2985	458	336395	381	0	340219
29782	313714	389	3294	418	0	317815
29783	3205	683	318535	382	0	322805
29784	1620	328560	3103	923	0	334206
29785	826	2925	1626	323092	0	328469
29786	767	1738	326903	2762	0	332170
29787	500	322709	3358	1786	0	328353
29788	474	326704	1942	820	0	329940
29789	738	4098	829	320529	0	326194
29790	318162	1902	682	2789	0	323535
29791	2962	920	657	318417	0	322956
29792	309208	858	746	3033	0	313845
29793	3182	898	703	311320	0	316103
29794	1854	980	312100	3003	0	317937
29795	1036	914	311081	1629	0	314660
29796	292678	651	4904	776	0	299009
29797	303154	752	2650	600	0	307156
29798	4430	1224	301397	541	0	307592
29799	282139	1012	3955	475	0	287581
29800	3745	1516	298651	525	0	304437
29801	2115	287938	4214	652	0	294919
29802	1147	286098	2913	655	0	290813
29803	1097	278520	2072	660	0	282349
29804	1208	5051	1964	270480	0	278703
29805	268171	2436	1754	2916	0	275277
29806	268439	1362	1892	1595	0	273288
29807	4714	1283	1687	265498	0	273182
29808	2572	1345	249379	3156	0	256452
29809	1447	1233	4356	242490	0	249526
29810	1364	1087	243469	3432	0	249352
29811	1391	950	4792	229366	0	236499
29812	227844	752	3285	3494	0	235375
29813	228903	689	2193	2054	0	233839
29814	228151	665	2037	1113	0	231966
29815	226173	699	1861	1076	0	229809
29816	5423	834	1721	218301	0	226279
29817	2897	731	1776	220960	0	226364
29818	218435	809	1674	4556	0	225474
29819	220490	811	1709	2290	0	225300
29820	5295	835	1490	216526	0	224146
29821	3056	819	1520	217400	0	222795
29822	1962	810	1369	211522	0	215663
29823	1779	767	1601	211624	0	215771
29824	205277	700	1728	4802	0	212507
29825	4050	595	201803	2603	0	209051
29826	2813	619	3891	189344	0	196667
29827	187447	518	2549	3645	0	194159
29828	4088	757	186027	2249	0	193121
29829	3060	1148	3535	183001	0	190744
29830	2266	792	184470	3432	0	190960
29831	1862	170117	3877	4604	0	180460
29832	2608	3173	2524	140562	0	148867
29833	127813	1192	1315	2323	0	132643
29834	2486	3557	1186	107347	0	114576
29835	1826	109356	754	1899	0	113835
29836	1186	100017	676	1077	0	102956
29837	888	80957	453	485	0	82783
29838	946	74114	749	494	0	76303
29839	42057	4290	5190	2798	0	54335
29840	2318	1704	1287	28087	0	33396
29841	343	68	23102	389	0	23902
29842	177	54	326	20947	0	21504
29843	170	50	20798	327	0	21345
29844	20357	34	292	235	0	20918
29845	366	32	201	20369	0	20968
29846	299	83	86	20507	0	20975
29847	169	61	76	20396	0	20702
29848	143	57	68	20518	0	20786
29849	20105	66	56	451	0	20678
29850	20078	52	59	279	0	20468
29851	467	46	51	19625	0	20189
29852	18882	36	50	361	0	19329
29853	304	41	18609	297	0	19251
29854	198	17991	250	233	0	18672
29855	158	213	191	17756	0	18318
29856	146	155	96	17146	0	17543
29857	109	17313	99	431	0	17952
29858	162	185	88	16928	0	17363
29859	135	352	109	16644	0	17240
29860	16511	38	126	411	0	17086
29861	313	48	15746	187	0	16294
29862	177	48	14299	106	0	14630
29863	13614	51	283	150	0	14098
29864	244	61	12972	89	0	13366
29865	7034	41	298	38	0	7411
29866	5989	17	198	58	0	6262
29867	256	147	63	4577	0	5043
29868	54	16	3601	69	0	3740
29869	2870	41	92	54	0	3057
29870	73	2850	33	44	0	3000
29871	1547	165	397	63	0	2172
29872	1134	50	140	58	0	1382
29873	553	15	8	15	0	591
29874	197	2	3	3	0	205
29875	182	0	7	8	0	197
29876	175	0	4	11	0	190
29877	158	11	6	6	0	181
29878	156	6	5	2	0	169
29879	164	0	1	1	0	166
29880	150	0	2	3	0	155
29881	139	1	1	2	0	143
29882	141	0	2	1	0	144
29883	138	2	0	3	0	143
29884	115	1	1	2	0	119
29885	102	0	4	2	0	108
29886	85	0	1	2	0	88
29887	70	2	2	0	0	74
29888	68	2	2	1	0	73
29889	67	5	1	1	0	74
29890	60	6	1	1	0	68
29891	60	3	0	1	0	64
29892	54	0	0	2	0	56
29893	56	0	1	0	0	57
29894	54	0	0	2	0	56
29895	57	0	1	0	0	58
29896	55	0	1	0	0	56
29897	47	0	4	1	0	52
29898	39	0	2	1	0	42
29899	37	0	1	1	0	39
29900	31	0	2	1	0	34
29901	24	0	4	0	0	28
29902	13	0	2	0	0	15
29903	8	0	0	1	0	9
29904	1	0	0	0	0	1
29905	0	0	1	0	0	1
29906	0	1	0	0	0	1
