Pos	A	C	G	T	Other	Total
1	0	0	0	0	0	0
2	0	0	0	0	0	0
3	0	0	0	0	0	0
4	0	0	0	0	0	0
5	0	0	0	0	0	0
6	0	0	0	0	0	0
7	0	0	0	0	0	0
8	0	0	0	0	0	0
9	0	0	0	0	0	0
10	0	0	0	0	0	0
11	0	0	0	0	0	0
12	0	0	0	0	0	0
13	0	0	0	4	0	4
14	10	0	0	1	0	11
15	0	21	1	0	0	22
16	0	41	0	0	0	41
17	0	0	0	113	0	113
18	0	0	0	121	0	121
19	0	175	0	0	0	175
20	0	196	0	0	0	196
21	0	207	0	0	0	207
22	220	0	0	2	0	222
23	0	0	217	0	0	217
24	1	0	211	0	0	212
25	1	0	0	231	0	232
26	241	0	0	1	0	242
27	239	0	0	3	0	242
28	0	245	0	0	0	245
29	284	0	0	2	0	286
30	298	0	0	3	0	301
31	314	0	0	1	0	315
32	0	322	1	0	0	323
33	1	317	0	0	0	318
34	333	0	0	0	0	333
35	335	0	0	0	0	335
36	0	341	0	2	0	343
37	0	358	0	1	0	359
38	357	0	0	2	0	359
39	356	0	0	4	0	360
40	0	367	0	0	0	367
41	0	0	0	377	0	377
42	0	0	0	380	0	380
43	0	0	0	373	0	373
44	0	373	0	0	0	373
45	2	1	368	0	0	371
46	346	0	0	2	0	348
47	1	0	0	378	0	379
48	0	381	0	0	0	381
49	0	0	0	384	0	384
50	0	380	0	0	0	380
51	2	0	0	383	0	385
52	1	0	0	389	0	390
53	0	0	391	0	0	391
54	0	0	0	384	0	384
55	376	0	0	6	0	382
56	0	1	394	0	0	395
57	367	0	0	5	0	372
58	0	0	0	396	0	396
59	0	396	2	1	0	399
60	2	0	0	401	0	403
61	0	1	399	0	0	400
62	0	0	0	384	0	384
63	1	1	0	397	0	399
64	1	401	0	1	0	403
65	1	0	0	405	0	406
66	0	403	0	0	0	403
67	0	0	0	404	0	404
68	405	0	0	5	0	410
69	396	0	0	0	0	396
70	401	0	0	2	0	403
71	2	398	1	2	0	403
72	0	1	399	0	0	400
73	387	0	1	1	0	389
74	409	0	0	3	0	412
75	0	407	0	0	0	407
76	2	0	0	360	0	362
77	0	0	1	366	0	367
78	6	0	0	330	0	336
79	330	0	0	4	0	334
80	332	0	0	3	0	335
81	328	0	0	2	0	330
82	318	0	0	3	0	321
83	2	0	0	313	0	315
84	0	304	1	1	0	306
85	0	0	0	316	0	316
86	1	0	309	1	0	311
87	1	0	2	305	0	308
88	0	4	314	2	0	320
89	0	0	2	312	0	314
90	0	0	314	2	0	316
91	0	0	312	0	0	312
92	0	319	1	0	0	320
93	1	3	0	332	0	336
94	0	0	343	2	0	345
95	1	0	2	330	0	333
96	0	339	0	2	0	341
97	338	2	0	2	0	342
98	2	354	0	0	0	356
99	1	2	0	339	0	342
100	1	346	1	0	0	348
101	2	3	347	0	0	352
102	1	1	334	2	0	338
103	0	354	2	1	0	357
104	3	1	0	355	0	359
105	1	1	362	2	0	366
106	1	356	2	1	0	360
107	354	1	0	6	0	361
108	4	1	1	352	0	358
109	0	0	376	4	0	380
110	0	378	3	0	0	381
111	2	0	0	383	0	385
112	1	0	1	376	0	378
113	378	0	1	4	0	383
114	3	2	379	0	0	384
115	0	1	2	374	0	377
116	0	0	367	3	0	370
117	1	326	3	1	0	331
118	315	2	0	1	0	318
119	2	310	0	1	0	313
120	3	1	1	291	0	296
121	2	304	0	1	0	307
122	296	3	0	6	0	305
123	4	296	0	0	0	300
124	1	2	291	0	0	294
125	1	289	2	1	0	293
126	283	3	0	6	0	292
127	2	0	288	1	0	291
128	1	1	2	291	0	295
129	277	0	1	3	0	281
130	5	0	3	269	0	277
131	277	1	1	4	0	283
132	274	1	1	4	0	280
133	7	0	2	276	0	285
134	3	0	1	280	0	284
135	274	1	3	6	0	284
136	274	3	0	2	0	279
137	6	1	0	264	0	271
138	267	0	1	4	0	272
139	272	1	0	1	0	274
140	3	267	2	2	0	274
141	5	3	1	267	0	276
142	275	3	1	5	0	284
143	278	2	2	3	0	285
144	6	1	1	269	0	277
145	5	2	1	272	0	280
146	275	0	1	5	0	281
147	4	277	1	4	0	286
148	3	3	2	275	0	283
149	1	5	282	2	0	290
150	0	4	3	271	0	278
151	2	273	3	3	0	281
152	2	2	277	3	0	284
153	2	3	6	267	0	278
154	7	1	1	256	0	265
155	2	3	272	5	0	282
156	252	1	3	6	0	262
157	5	277	2	1	0	285
158	277	3	3	3	0	286
159	4	1	275	2	0	282
160	2	4	277	2	0	285
161	264	1	3	3	0	271
162	3	280	4	2	0	289
163	276	5	2	3	0	286
164	6	283	0	2	0	291
165	3	6	278	2	0	289
166	273	2	4	1	0	280
167	3	3	286	2	0	294
168	5	1	3	269	0	278
169	271	0	1	9	0	281
170	274	0	2	6	0	282
171	3	272	2	2	0	279
172	4	2	0	266	0	272
173	1	273	3	3	0	280
174	0	6	265	2	0	273
175	4	2	4	231	0	241
176	0	247	2	1	0	250
177	1	1	1	236	0	239
178	220	1	0	4	0	225
179	3	1	0	233	0	237
180	1	231	1	2	0	235
181	3	1	1	233	0	238
182	1	3	0	227	0	231
183	2	228	1	3	0	234
184	3	1	2	226	0	232
185	0	1	225	3	0	229
186	3	218	1	1	0	223
187	205	1	1	5	0	212
188	3	1	210	0	0	214
189	3	2	203	0	0	208
190	1	200	2	2	0	205
191	4	1	2	190	0	197
192	1	1	193	0	0	195
193	1	170	0	2	0	173
194	3	0	1	171	0	175
195	2	1	1	170	0	174
196	168	3	0	2	0	173
197	1	173	0	3	0	177
198	1	1	156	2	0	160
199	3	1	158	0	0	162
200	1	2	1	150	0	154
201	0	1	2	177	0	180
202	1	0	1	178	0	180
203	2	204	0	6	0	212
204	0	6	211	5	0	222
205	1	4	5	217	0	227
206	1	220	5	5	0	231
207	0	231	1	5	0	237
208	0	11	234	0	0	245
209	1	4	7	232	0	244
210	1	4	248	6	0	259
211	2	2	6	243	0	253
212	2	1	6	251	0	260
213	1	1	241	12	0	255
214	0	239	12	5	0	256
215	237	7	4	6	0	254
216	7	5	241	3	0	256
217	4	240	11	1	0	256
218	2	252	5	1	0	260
219	2	11	241	2	0	256
220	232	7	9	2	0	250
221	9	4	5	220	0	238
222	6	234	3	5	0	248
223	231	10	2	7	0	250
224	11	7	1	225	0	244
225	5	232	3	8	0	248
226	236	8	1	7	0	252
227	10	6	225	1	0	242
228	4	228	10	4	0	246
229	216	9	6	6	0	237
230	10	224	3	3	0	240
231	208	13	3	3	0	227
232	11	8	4	202	0	225
233	6	206	5	9	0	226
234	2	12	3	211	0	228
235	207	6	4	12	0	229
236	8	2	208	8	0	226
237	6	3	218	4	0	231
238	0	3	12	217	0	232
239	6	4	5	216	0	231
240	6	4	6	210	0	226
241	4	205	8	12	0	229
242	1	13	209	7	0	230
243	4	9	11	196	0	220
244	3	206	8	10	0	227
245	5	207	4	4	0	220
246	4	14	213	4	0	235
247	4	11	215	3	0	233
248	5	4	221	5	0	235
249	5	7	11	208	0	231
250	5	6	210	11	0	232
251	3	6	12	215	0	236
252	6	5	218	6	0	235
253	198	2	13	9	0	222
254	9	221	9	3	0	242
255	8	231	1	6	0	246
256	5	13	233	4	0	255
257	226	8	11	5	0	250
258	234	8	6	4	0	252
259	240	5	5	5	0	255
260	14	4	228	5	0	251
261	9	3	229	5	0	246
262	3	2	19	223	0	247
263	230	2	9	13	0	254
264	227	1	6	12	0	246
265	14	5	220	5	0	244
266	219	3	14	9	0	245
267	14	3	12	216	0	245
268	6	6	222	15	0	249
269	4	4	232	6	0	246
270	219	5	18	4	0	246
271	9	5	228	4	0	246
272	223	2	18	3	0	246
273	10	3	229	6	0	248
274	10	211	15	5	0	241
275	2	229	10	5	0	246
276	8	17	5	215	0	245
277	3	4	11	224	0	242
278	6	4	221	13	0	244
279	3	8	13	210	0	234
280	5	204	7	12	0	228
281	6	218	4	8	0	236
282	7	231	9	3	0	250
283	8	14	2	221	0	245
284	6	9	219	10	0	244
285	6	3	230	6	0	245
286	9	5	17	213	0	244
287	6	6	7	227	0	246
288	9	2	7	210	0	228
289	7	219	7	14	0	247
290	214	7	9	7	0	237
291	220	5	7	6	0	238
292	16	217	3	7	0	243
293	6	9	218	4	0	237
294	221	4	13	9	0	247
295	14	3	227	0	0	244
296	219	4	10	5	0	238
297	233	5	10	1	0	249
298	228	6	7	3	0	244
299	224	5	9	1	0	239
300	15	218	4	5	0	242
301	194	5	5	7	0	211
302	11	193	5	5	0	214
303	155	5	4	3	0	167
304	6	147	2	2	0	157
305	1	4	133	1	0	139
306	2	10	5	112	0	129
307	2	111	1	6	0	120
308	1	114	1	1	0	117
309	100	3	4	4	0	111
310	90	2	1	0	0	93
311	3	96	2	0	0	101
312	1	1	0	94	0	96
313	1	105	1	1	0	108
314	99	2	1	2	0	104
315	3	0	100	0	0	103
316	1	1	3	99	0	104
317	1	1	0	100	0	102
318	1	0	1	99	0	101
319	1	2	98	1	0	102
320	1	93	2	0	0	96
321	1	100	1	1	0	103
322	3	1	0	98	0	102
323	0	0	100	2	0	102
324	2	0	2	98	0	102
325	1	1	1	104	0	107
326	0	1	1	102	0	104
327	2	2	0	102	0	106
328	103	0	1	3	0	107
329	1	105	3	0	0	109
330	101	1	1	1	0	104
331	1	0	101	3	0	105
332	1	0	103	3	0	107
333	0	0	2	100	0	102
334	2	1	0	100	0	103
335	1	109	0	1	0	111
336	2	2	104	0	0	108
337	0	107	2	0	0	109
338	0	1	106	1	0	108
339	101	0	2	1	0	104
340	2	105	2	0	0	109
341	1	2	103	1	0	107
342	2	0	2	101	0	105
343	1	1	103	2	0	107
344	1	107	1	0	0	109
345	3	2	0	104	0	109
346	2	107	0	1	0	110
347	0	3	105	0	0	108
348	3	0	2	106	0	111
349	105	1	1	1	0	108
350	1	107	2	0	0	110
351	1	1	97	3	0	102
352	3	4	1	92	0	100
353	1	1	101	1	0	104
354	2	1	95	1	0	99
355	1	85	0	0	0	86
356	2	0	1	75	0	78
357	0	0	0	77	0	77
358	0	0	0	77	0	77
359	0	0	78	1	0	79
360	0	0	77	0	0	77
361	77	1	0	0	0	78
362	0	1	77	0	0	78
363	70	0	0	1	0	71
364	0	73	1	0	0	74
365	1	0	0	74	0	75
366	0	76	0	1	0	77
367	1	75	0	1	0	77
368	0	0	73	1	0	74
369	1	0	0	74	0	75
370	0	1	75	0	0	76
371	1	0	73	0	0	74
372	73	0	0	2	0	75
373	0	0	77	0	0	77
374	1	0	75	1	0	77
375	74	0	0	2	0	76
376	0	1	77	0	0	78
377	0	1	74	0	0	75
378	2	1	1	71	0	75
379	0	76	1	0	0	77
380	1	0	0	74	0	75
381	0	1	0	74	0	75
382	76	0	1	0	0	77
383	0	0	0	75	0	75
384	0	74	1	0	0	75
385	67	1	0	0	0	68
386	0	0	73	1	0	74
387	67	2	0	0	0	69
388	1	0	74	0	0	75
389	0	0	74	1	0	75
390	1	72	2	0	0	75
391	72	2	0	0	0	74
392	1	76	2	0	0	79
393	0	1	77	1	0	79
394	0	1	2	69	0	72
395	0	77	1	1	0	79
396	73	2	0	2	0	77
397	74	0	0	1	0	75
398	1	74	0	1	0	76
399	74	1	0	3	0	78
400	1	0	1	71	0	73
401	0	79	2	1	0	82
402	1	1	0	80	0	82
403	0	0	1	84	0	85
404	82	0	0	1	0	83
405	80	1	0	0	0	81
406	77	0	0	3	0	80
407	2	0	82	0	0	84
408	79	1	2	0	0	82
409	2	1	0	83	0	86
410	0	0	84	2	0	86
411	0	0	81	0	0	81
412	0	77	3	0	0	80
413	74	2	0	0	0	76
414	2	74	1	0	0	77
415	0	2	0	73	0	75
416	0	0	0	75	0	75
417	0	0	74	2	0	76
418	1	0	2	67	0	70
419	0	0	75	2	0	77
420	0	0	72	0	0	72
421	0	79	3	0	0	82
422	0	2	0	75	0	77
423	0	0	0	78	0	78
424	74	0	0	3	0	77
425	2	0	74	0	0	76
426	0	0	2	78	0	80
427	77	0	0	4	0	81
428	2	1	76	0	0	79
429	80	0	2	0	0	82
430	80	0	0	1	0	81
431	2	0	83	0	0	85
432	0	0	2	80	0	82
433	0	0	0	83	0	83
434	0	0	93	2	0	95
435	91	0	2	0	0	93
436	97	0	0	0	0	97
437	97	0	0	0	0	97
438	98	0	0	0	0	98
439	93	0	0	0	0	93
440	3	0	91	0	0	94
441	0	0	99	0	0	99
442	0	99	4	0	0	103
443	0	3	103	0	0	106
444	0	0	3	95	0	98
445	1	1	0	77	0	79
446	0	0	0	99	0	99
447	0	0	0	103	0	103
448	0	0	102	3	0	105
449	0	93	2	0	0	95
450	0	113	0	0	0	113
451	0	3	0	105	0	108
452	1	112	0	2	0	115
453	109	3	1	0	0	113
454	117	0	0	0	0	117
455	4	125	0	0	0	129
456	0	3	1	121	0	125
457	0	1	0	127	0	128
458	1	0	128	4	0	133
459	113	0	4	1	0	118
460	125	1	0	1	0	127
461	3	126	0	1	0	130
462	128	2	0	2	0	132
463	5	0	128	0	0	133
464	3	128	3	0	0	134
465	1	138	1	0	0	140
466	0	138	2	0	0	140
467	1	5	0	135	0	141
468	133	1	1	4	0	139
469	3	0	1	134	0	138
470	1	0	140	4	0	145
471	0	1	4	137	0	142
472	1	1	140	5	0	147
473	0	1	5	136	0	142
474	1	1	1	135	0	138
475	0	137	0	6	0	143
476	140	4	1	1	0	146
477	4	2	0	140	0	146
478	2	140	1	4	0	147
479	139	3	1	0	0	143
480	134	3	0	0	0	137
481	142	0	0	2	0	144
482	5	138	0	2	0	145
483	2	4	141	0	0	147
484	1	0	5	136	0	142
485	2	0	1	136	0	139
486	1	136	0	4	0	141
487	0	3	137	1	0	141
488	1	0	136	0	0	137
489	134	1	4	1	0	140
490	3	0	1	133	0	137
491	1	1	144	4	0	150
492	0	151	1	3	0	155
493	1	3	2	150	0	156
494	1	156	1	3	0	161
495	1	4	153	1	0	159
496	143	1	3	1	0	148
497	154	0	2	1	0	157
498	5	144	0	2	0	151
499	1	3	0	148	0	152
500	0	2	144	3	0	149
501	1	138	3	1	0	143
502	137	3	1	1	0	142
503	3	136	0	0	0	139
504	2	141	0	0	0	143
505	1	4	0	135	0	140
506	1	136	0	2	0	139
507	133	3	0	1	0	137
508	3	1	1	136	0	141
509	1	0	132	3	0	136
510	0	0	130	2	0	132
511	1	1	2	124	0	128
512	0	130	1	2	0	133
513	130	2	1	1	0	134
514	4	1	0	126	0	131
515	1	0	130	3	0	134
516	1	0	3	132	0	136
517	0	1	1	132	0	134
518	126	0	0	4	0	130
519	2	1	0	129	0	132
520	1	0	127	2	0	130
521	1	0	127	1	0	129
522	4	0	3	124	0	131
523	0	1	1	131	0	133
524	0	0	134	3	0	137
525	114	0	3	1	0	118
526	2	1	136	0	0	139
527	1	134	2	1	0	138
528	2	3	1	136	0	142
529	1	1	141	2	0	145
530	0	0	142	2	0	144
531	0	0	4	129	0	133
532	140	0	2	3	0	145
533	2	0	141	3	0	146
534	1	152	2	1	0	156
535	150	1	1	0	0	152
536	1	1	152	1	0	155
537	148	0	2	2	0	152
538	147	0	1	2	0	150
539	2	158	0	1	0	161
540	2	1	0	152	0	155
541	0	154	0	2	0	156
542	0	1	150	0	0	151
543	148	1	2	0	0	151
544	153	0	1	4	0	158
545	2	0	155	1	0	158
546	2	0	153	0	0	155
547	1	160	2	0	0	163
548	156	1	1	3	0	161
549	1	1	1	158	0	161
550	2	0	0	152	0	154
551	0	159	1	2	0	162
552	155	1	1	2	0	159
553	1	1	156	1	0	159
554	5	0	1	166	0	172
555	170	0	2	3	0	175
556	1	172	0	2	0	175
557	1	1	181	0	0	183
558	0	1	184	1	0	186
559	2	0	2	181	0	185
560	1	192	1	2	0	196
561	1	2	193	1	0	197
562	1	0	2	189	0	192
563	191	1	0	6	0	198
564	3	2	200	0	0	205
565	1	1	4	198	0	204
566	1	0	204	6	0	211
567	3	0	217	0	0	220
568	0	4	7	204	0	215
569	0	1	216	6	0	223
570	186	0	5	2	0	193
571	2	0	213	1	0	216
572	189	0	4	3	0	196
573	3	211	3	0	0	217
574	222	3	0	3	0	228
575	2	231	2	1	0	236
576	4	4	1	230	0	239
577	2	2	0	240	0	244
578	3	1	236	3	0	243
579	0	2	237	0	0	239
580	3	0	3	238	0	244
581	0	0	250	6	0	256
582	1	1	5	231	0	238
583	0	231	3	3	0	237
584	0	251	2	3	0	256
585	3	2	2	246	0	253
586	1	0	2	253	0	256
587	2	2	244	3	0	251
588	4	5	2	230	0	241
589	0	243	2	5	0	250
590	0	235	1	2	0	238
591	0	245	4	2	0	251
592	1	3	0	233	0	237
593	0	240	3	1	0	244
594	235	5	1	5	0	246
595	4	2	0	236	0	242
596	1	0	236	3	0	240
597	0	2	3	231	0	236
598	1	1	240	4	0	246
599	0	1	227	2	0	230
600	0	0	238	2	0	240
601	0	227	4	2	0	233
602	0	3	240	2	0	245
603	232	0	6	3	0	241
604	243	1	0	2	0	246
605	244	3	0	1	0	248
606	4	2	1	237	0	244
607	239	1	1	4	0	245
608	5	225	1	3	0	234
609	1	245	0	2	0	248
610	246	4	2	3	0	255
611	4	0	247	0	0	251
612	2	1	3	246	0	252
613	1	1	249	3	0	254
614	1	0	244	1	0	246
615	0	244	4	2	0	250
616	2	6	1	235	0	244
617	3	0	4	242	0	249
618	247	0	1	6	0	254
619	4	240	3	0	0	247
620	2	251	1	1	0	255
621	0	4	248	3	0	255
622	4	244	5	0	0	253
623	241	7	1	0	0	249
624	238	2	1	2	0	243
625	5	3	247	0	0	255
626	2	2	248	1	0	253
627	4	1	4	241	0	250
628	5	1	3	233	0	242
629	0	237	3	5	0	245
630	0	5	4	239	0	248
631	1	0	5	225	0	231
632	1	232	2	8	0	243
633	1	6	2	233	0	242
634	1	2	2	229	0	234
635	1	227	1	7	0	236
636	1	6	222	3	0	232
637	3	2	5	224	0	234
638	224	0	1	10	0	235
639	226	2	2	2	0	232
640	4	2	219	2	0	227
641	209	3	5	3	0	220
642	220	3	0	3	0	226
643	4	219	1	1	0	225
644	0	6	203	2	0	211
645	1	1	208	4	0	214
646	1	1	4	209	0	215
647	215	3	1	7	0	226
648	223	0	4	3	0	230
649	6	0	4	237	0	247
650	249	1	2	7	0	259
651	249	2	3	3	0	257
652	250	2	2	4	0	258
653	7	3	243	1	0	254
654	4	2	230	1	0	237
655	228	0	5	1	0	234
656	9	1	229	1	0	240
657	2	222	4	0	0	228
658	1	4	5	213	0	223
659	1	1	220	5	0	227
660	1	1	217	0	0	219
661	1	1	7	201	0	210
662	1	0	212	4	0	217
663	1	0	210	2	0	213
664	0	194	6	1	0	201
665	0	197	3	0	0	200
666	193	3	1	1	0	198
667	3	2	1	193	0	199
668	192	0	0	4	0	196
669	2	0	186	2	0	190
670	2	0	2	180	0	184
671	1	0	1	193	0	195
672	185	0	0	5	0	190
673	3	185	0	1	0	189
674	1	3	173	1	0	178
675	1	1	177	1	0	180
676	0	185	3	1	0	189
677	1	2	181	1	0	185
678	0	183	2	0	0	185
679	0	175	2	0	0	177
680	0	3	167	1	0	171
681	156	2	3	1	0	162
682	2	0	1	173	0	176
683	1	179	0	2	0	182
684	1	3	0	182	0	186
685	186	1	0	2	0	189
686	186	0	0	1	0	187
687	186	0	0	0	0	186
688	3	1	185	0	0	189
689	3	0	2	175	0	180
690	1	190	1	2	0	194
691	200	2	0	2	0	204
692	2	1	0	202	0	205
693	1	0	1	198	0	200
694	0	0	0	203	0	203
695	0	1	207	3	0	211
696	190	0	2	2	0	194
697	2	204	1	2	0	209
698	3	2	0	199	0	204
699	2	1	0	205	0	208
700	200	0	0	6	0	206
701	4	0	199	1	0	204
702	1	1	196	0	0	198
703	1	197	4	1	0	203
704	3	2	210	0	0	215
705	194	2	2	1	0	199
706	4	211	2	1	0	218
707	0	2	215	1	0	218
708	193	2	4	0	0	199
709	3	0	220	1	0	224
710	2	225	4	2	0	233
711	2	4	3	222	0	231
712	1	2	2	232	0	237
713	2	2	228	3	0	235
714	2	1	217	1	0	221
715	2	232	4	2	0	240
716	219	3	2	2	0	226
717	2	228	4	1	0	235
718	2	4	3	232	0	241
719	0	2	231	6	0	239
720	202	2	3	3	0	210
721	6	1	2	218	0	227
722	3	216	0	4	0	223
723	1	227	5	2	0	235
724	2	4	4	225	0	235
725	1	3	1	228	0	233
726	223	2	3	4	0	232
727	2	4	1	224	0	231
728	2	2	227	4	0	235
729	214	0	5	3	0	222
730	225	4	3	2	0	234
731	4	1	223	4	0	232
732	218	2	5	4	0	229
733	3	1	4	238	0	246
734	3	1	0	240	0	244
735	4	1	2	238	0	245
736	3	0	4	228	0	235
737	0	233	1	4	0	238
738	233	4	0	6	0	243
739	239	3	1	3	0	246
740	6	1	247	5	0	259
741	247	0	3	4	0	254
742	265	1	3	3	0	272
743	262	3	1	4	0	270
744	275	2	1	3	0	281
745	10	265	2	1	0	278
746	5	7	0	257	0	269
747	0	2	260	6	0	268
748	2	1	248	3	0	254
749	200	3	6	1	0	210
750	208	0	5	0	0	213
751	6	203	0	0	0	209
752	208	4	1	0	0	213
753	4	213	0	1	0	218
754	2	3	1	213	0	219
755	222	1	2	4	0	229
756	218	0	0	2	0	220
757	228	1	0	2	0	231
758	4	223	0	1	0	228
759	222	3	1	0	0	226
760	5	1	1	218	0	225
761	228	0	0	5	0	233
762	6	0	211	1	0	218
763	1	222	3	0	0	226
764	228	3	0	1	0	232
765	3	3	227	0	0	233
766	2	0	3	223	0	228
767	1	0	226	4	0	231
768	2	0	219	0	0	221
769	2	0	4	224	0	230
770	0	2	234	4	0	240
771	1	0	3	233	0	237
772	1	0	1	235	0	237
773	234	1	0	5	0	240
774	3	231	2	0	0	236
775	1	232	1	0	0	234
776	1	247	1	1	0	250
777	1	3	239	0	0	243
778	2	0	3	241	0	246
779	1	0	248	4	0	253
780	229	0	4	1	0	234
781	232	2	0	3	0	237
782	3	250	1	1	0	255
783	1	4	1	245	0	251
784	0	246	2	4	0	252
785	250	3	0	2	0	255
786	5	1	1	250	0	257
787	1	3	260	3	0	267
788	1	258	3	1	0	263
789	0	6	248	2	0	256
790	2	1	3	253	0	259
791	1	1	255	3	0	260
792	232	0	4	4	0	240
793	5	0	255	1	0	261
794	2	258	4	0	0	264
795	2	4	1	255	0	262
796	2	2	0	261	0	265
797	254	1	0	6	0	261
798	256	1	1	4	0	262
799	5	260	2	0	0	267
800	2	4	255	0	0	261
801	2	2	252	0	0	256
802	244	0	3	4	0	251
803	3	1	262	1	0	267
804	3	0	257	0	0	260
805	1	1	261	1	0	264
806	0	2	259	1	0	262
807	2	256	6	1	0	265
808	255	4	2	4	0	265
809	8	2	0	248	0	258
810	254	3	1	4	0	262
811	5	259	1	1	0	266
812	250	5	2	3	0	260
813	6	257	3	0	0	266
814	4	5	2	240	0	251
815	2	262	2	5	0	271
816	2	5	248	1	0	256
817	3	260	6	0	0	269
818	0	6	3	270	0	279
819	267	3	2	6	0	278
820	5	2	2	262	0	271
821	3	1	260	9	0	273
822	4	1	5	256	0	266
823	0	260	6	5	0	271
824	1	7	264	3	0	275
825	250	4	6	2	0	262
826	5	1	4	263	0	273
827	267	1	1	6	0	275
828	260	1	5	5	0	271
829	7	261	2	2	0	272
830	260	5	0	5	0	270
831	255	3	2	3	0	263
832	8	251	0	3	0	262
833	5	5	1	252	0	263
834	4	4	0	249	0	257
835	0	248	1	9	0	258
836	3	6	3	252	0	264
837	2	3	252	6	0	263
838	2	1	6	245	0	254
839	0	0	247	5	0	252
840	1	2	223	3	0	229
841	4	217	7	2	0	230
842	2	210	3	0	0	215
843	2	229	0	0	0	231
844	3	6	0	214	0	223
845	2	2	220	2	0	226
846	206	2	2	2	0	212
847	3	1	3	217	0	224
848	2	2	218	5	0	227
849	0	1	220	3	0	224
850	1	225	4	1	0	231
851	2	2	3	216	0	223
852	217	2	2	2	0	223
853	2	216	2	3	0	223
854	2	209	3	0	0	214
855	0	213	2	0	0	215
856	0	7	0	210	0	217
857	1	222	0	2	0	225
858	0	3	0	229	0	232
859	2	2	1	233	0	238
860	1	1	227	4	0	233
861	187	0	2	6	0	195
862	2	1	224	0	0	227
863	6	0	4	221	0	231
864	0	2	227	3	0	232
865	0	225	3	3	0	231
866	216	3	2	3	0	224
867	4	3	0	218	0	225
868	3	2	0	228	0	233
869	219	2	0	6	0	227
870	210	1	0	3	0	214
871	213	1	0	2	0	216
872	7	1	212	1	0	221
873	190	0	4	4	0	198
874	4	196	3	2	0	205
875	3	207	1	0	0	211
876	1	5	1	204	0	211
877	3	2	1	198	0	204
878	0	201	1	7	0	209
879	2	5	1	204	0	212
880	205	3	0	6	0	214
881	6	0	205	3	0	214
882	3	203	4	1	0	211
883	191	5	2	2	0	200
884	7	198	1	0	0	206
885	4	4	195	0	0	203
886	4	1	5	186	0	196
887	1	2	195	5	0	203
888	1	190	6	2	0	199
889	1	7	1	186	0	195
890	0	1	187	6	0	194
891	1	2	186	2	0	191
892	2	2	5	178	0	187
893	185	1	2	5	0	193
894	190	0	1	2	0	193
895	183	0	1	0	0	184
896	5	2	195	0	0	202
897	2	194	3	0	0	199
898	3	5	1	190	0	199
899	0	2	2	188	0	192
900	1	194	1	6	0	202
901	191	4	1	5	0	201
902	7	2	2	191	0	202
903	1	1	193	6	0	201
904	0	198	5	3	0	206
905	191	3	4	5	0	203
906	6	193	1	2	0	202
907	3	4	2	192	0	201
908	3	2	0	194	0	199
909	4	1	1	186	0	192
910	1	1	185	5	0	192
911	2	2	5	183	0	192
912	0	181	1	6	0	188
913	1	179	1	3	0	184
914	1	3	180	1	0	185
915	161	1	3	4	0	169
916	180	0	1	1	0	182
917	3	173	2	2	0	180
918	154	4	1	2	0	161
919	160	1	1	0	0	162
920	5	165	1	0	0	171
921	0	4	0	167	0	171
922	0	1	165	6	0	172
923	1	3	163	2	0	169
924	166	0	4	2	0	172
925	6	167	1	2	0	176
926	1	3	1	165	0	170
927	2	1	0	167	0	170
928	1	0	1	170	0	172
929	166	0	0	4	0	170
930	4	0	2	158	0	164
931	1	1	0	158	0	160
932	0	1	153	4	0	158
933	141	2	4	0	0	147
934	4	146	2	2	0	154
935	146	4	1	2	0	153
936	2	147	2	1	0	152
937	0	2	1	148	0	151
938	150	0	1	3	0	154
939	153	0	1	2	0	156
940	5	1	147	0	0	153
941	149	0	4	1	0	154
942	5	2	148	0	0	155
943	0	0	145	1	0	146
944	0	1	145	1	0	147
945	0	1	152	1	0	154
946	0	1	4	150	0	155
947	0	1	153	7	0	161
948	3	0	8	152	0	163
949	155	1	1	8	0	165
950	6	0	3	155	0	164
951	151	2	2	6	0	161
952	9	154	0	2	0	165
953	2	7	0	156	0	165
954	3	1	153	8	0	165
955	1	168	6	2	0	177
956	3	6	0	164	0	173
957	1	1	163	7	0	172
958	0	163	6	0	0	169
959	2	166	0	2	0	170
960	0	6	163	2	0	171
961	2	3	7	158	0	170
962	0	3	160	7	0	170
963	148	1	7	0	0	156
964	158	0	1	1	0	160
965	6	154	1	2	0	163
966	157	6	1	0	0	164
967	8	1	0	156	0	165
968	0	1	151	6	0	158
969	145	1	6	3	0	155
970	8	0	150	1	0	159
971	1	159	7	1	0	168
972	162	5	2	1	0	170
973	7	1	2	161	0	171
974	1	2	157	5	0	165
975	158	1	4	1	0	164
976	156	0	1	4	0	161
977	162	0	1	2	0	165
978	6	0	2	158	0	166
979	3	1	0	162	0	166
980	3	0	150	3	0	156
981	1	152	5	3	0	161
982	0	5	1	152	0	158
983	2	1	1	159	0	163
984	1	1	152	5	0	159
985	1	1	154	1	0	157
986	0	0	6	150	0	156
987	142	0	1	9	0	152
988	5	148	4	0	0	157
989	152	6	0	2	0	160
990	4	152	1	2	0	159
991	2	6	149	2	0	159
992	2	1	153	0	0	156
993	136	3	6	2	0	147
994	161	1	1	1	0	164
995	9	153	3	1	0	166
996	3	8	157	0	0	168
997	4	2	5	153	0	164
998	2	2	4	158	0	166
999	0	157	2	8	0	167
1000	1	8	2	158	0	169
1001	1	2	159	9	0	171
1002	153	1	7	3	0	164
1003	167	0	3	1	0	171
1004	163	0	2	1	0	166
1005	172	0	1	1	0	174
1006	11	1	160	2	0	174
1007	159	1	8	2	0	170
1008	9	0	158	2	0	169
1009	3	155	10	0	0	168
1010	5	7	4	152	0	168
1011	161	2	2	8	0	173
1012	8	2	3	168	0	181
1013	5	0	170	7	0	182
1014	169	0	9	5	0	183
1015	181	0	2	2	0	185
1016	10	1	3	173	0	187
1017	8	1	1	177	0	187
1018	4	1	166	10	0	181
1019	3	167	7	5	0	182
1020	165	7	4	4	0	180
1021	8	4	162	1	0	175
1022	154	1	6	3	0	164
1023	9	161	3	1	0	174
1024	160	7	1	4	0	172
1025	7	161	3	1	0	172
1026	3	166	3	0	0	172
1027	3	12	1	154	0	170
1028	4	6	0	165	0	175
1029	2	3	4	166	0	175
1030	3	0	0	167	0	170
1031	0	3	156	11	0	170
1032	158	1	6	5	0	170
1033	162	1	6	2	0	171
1034	169	3	1	2	0	175
1035	13	1	2	157	0	173
1036	7	1	1	167	0	176
1037	163	1	3	12	0	179
1038	166	1	0	6	0	173
1039	168	1	3	5	0	177
1040	11	3	0	157	0	171
1041	7	0	1	161	0	169
1042	3	0	151	9	0	163
1043	3	0	151	5	0	159
1044	3	143	7	4	0	157
1045	131	4	5	2	0	142
1046	139	2	1	0	0	142
1047	149	0	0	3	0	152
1048	8	0	144	3	0	155
1049	144	1	4	2	0	151
1050	152	0	4	1	0	157
1051	157	1	1	1	0	160
1052	7	0	1	153	0	161
1053	6	0	1	156	0	163
1054	1	2	2	151	0	156
1055	4	0	137	7	0	148
1056	127	3	5	4	0	139
1057	6	140	4	0	0	150
1058	133	2	1	2	0	138
1059	3	130	0	1	0	134
1060	3	130	1	2	0	136
1061	3	5	0	130	0	138
1062	2	3	3	127	0	135
1063	2	124	1	5	0	132
1064	130	2	0	3	0	135
1065	131	3	0	1	0	135
1066	5	0	0	128	0	133
1067	3	0	127	4	0	134
1068	1	0	125	3	0	129
1069	1	2	135	0	0	138
1070	2	0	138	0	0	140
1071	121	0	7	1	0	129
1072	124	1	2	1	0	128
1073	5	1	1	123	0	130
1074	4	0	125	2	0	131
1075	1	3	2	136	0	142
1076	2	135	4	1	0	142
1077	2	157	0	2	0	161
1078	165	4	0	1	0	170
1079	163	3	2	1	0	169
1080	168	0	1	1	0	170
1081	6	0	2	163	0	171
1082	4	0	1	163	0	168
1083	2	0	0	164	0	166
1084	3	0	0	160	0	163
1085	0	2	162	8	0	172
1086	0	0	4	161	0	165
1087	164	0	3	3	0	170
1088	2	2	0	166	0	170
1089	6	1	0	161	0	168
1090	1	1	0	165	0	167
1091	1	157	0	6	0	164
1092	1	160	0	4	0	165
1093	0	168	1	2	0	171
1094	1	3	0	155	0	159
1095	3	1	0	155	0	159
1096	162	0	0	1	0	163
1097	154	0	0	3	0	157
1098	155	0	2	3	0	160
1099	2	0	1	153	0	156
1100	3	0	1	153	0	157
1101	1	152	1	1	0	155
1102	1	157	0	2	0	160
1103	155	1	0	2	0	158
1104	2	1	0	152	0	155
1105	151	0	1	1	0	153
1106	157	0	0	0	0	157
1107	1	2	0	152	0	155
1108	1	165	0	0	0	166
1109	159	0	0	5	0	164
1110	168	1	0	2	0	171
1111	2	0	186	0	0	188
1112	172	0	0	0	0	172
1113	1	182	0	1	0	184
1114	2	0	0	187	0	189
1115	207	1	0	6	0	214
1116	1	1	0	211	0	213
1117	2	1	0	207	0	210
1118	1	205	0	2	0	208
1119	203	0	0	5	0	208
1120	204	2	0	1	0	207
1121	2	200	0	0	0	202
1122	2	224	0	1	0	227
1123	228	2	0	1	0	231
1124	226	1	0	0	0	227
1125	2	0	218	0	0	220
1126	1	0	200	0	0	201
1127	2	0	223	0	0	225
1128	0	1	1	234	0	236
1129	1	0	1	236	0	238
1130	1	0	237	1	0	239
1131	227	0	0	5	0	232
1132	238	0	1	4	0	243
1133	241	1	0	1	0	243
1134	238	0	0	2	0	240
1135	4	0	284	0	0	288
1136	294	1	0	0	0	295
1137	295	1	1	4	0	301
1138	303	1	0	3	0	307
1139	308	0	0	0	0	308
1140	308	0	1	2	0	311
1141	2	0	321	0	0	323
1142	3	314	1	0	0	318
1143	0	1	1	316	0	318
1144	1	1	0	324	0	326
1145	1	0	327	1	0	329
1146	282	0	0	3	0	285
1147	2	0	1	315	0	318
1148	2	2	329	0	0	333
1149	2	0	312	1	0	315
1150	1	343	1	0	0	345
1151	2	1	1	345	0	349
1152	2	2	0	351	0	355
1153	3	0	0	343	0	346
1154	353	0	0	3	0	356
1155	2	0	0	351	0	353
1156	1	0	354	2	0	357
1157	1	2	316	2	0	321
1158	0	1	360	2	0	363
1159	3	1	1	355	0	360
1160	384	1	3	1	0	389
1161	2	2	383	2	0	389
1162	375	0	0	1	0	376
1163	444	0	2	3	0	449
1164	4	0	2	456	0	462
1165	3	2	3	452	0	460
1166	2	460	1	2	0	465
1167	1	1	468	3	0	473
1168	447	1	1	5	0	454
1169	4	0	2	486	0	492
1170	3	487	1	1	0	492
1171	4	0	2	492	0	498
1172	2	1	500	0	0	503
1173	1	1	1	465	0	468
1174	1	486	2	3	0	492
1175	2	2	1	476	0	481
1176	471	1	1	6	0	479
1177	1	0	0	465	0	466
1178	3	461	2	1	0	467
1179	1	467	1	2	0	471
1180	441	2	1	5	0	449
1181	1	3	467	1	0	472
1182	4	0	2	459	0	465
1183	1	0	2	477	0	480
1184	1	0	479	1	0	481
1185	1	482	0	3	0	486
1186	0	1	488	3	0	492
1187	0	1	4	479	0	484
1188	1	504	3	1	0	509
1189	513	1	0	8	0	522
1190	1	519	1	3	0	524
1191	2	520	1	1	0	524
1192	520	2	1	9	0	532
1193	536	1	0	7	0	544
1194	549	0	0	6	0	555
1195	1	0	1	563	0	565
1196	1	1	557	0	0	559
1197	534	1	1	5	0	541
1198	563	0	1	4	0	568
1199	4	0	1	585	0	590
1200	1	1	584	2	0	588
1201	1	579	1	2	0	583
1202	573	1	2	4	0	580
1203	607	1	0	7	0	615
1204	4	614	1	1	0	620
1205	2	631	1	1	0	635
1206	629	4	1	5	0	639
1207	620	1	0	6	0	627
1208	613	0	0	6	0	619
1209	4	1	0	616	0	621
1210	1	0	639	4	0	644
1211	1	1	3	612	0	617
1212	1	0	627	4	0	632
1213	0	609	3	1	0	613
1214	0	630	3	1	0	634
1215	3	4	1	594	0	602
1216	1	0	0	603	0	604
1217	1	0	0	595	0	596
1218	0	605	1	3	0	609
1219	598	3	0	4	0	605
1220	588	0	0	7	0	595
1221	3	596	0	0	0	599
1222	0	3	0	580	0	583
1223	0	571	1	3	0	575
1224	2	4	0	584	0	590
1225	0	583	0	4	0	587
1226	576	4	0	5	0	585
1227	6	0	0	566	0	572
1228	0	0	567	4	0	571
1229	532	0	4	9	0	545
1230	549	0	0	11	0	560
1231	4	0	550	0	0	554
1232	0	0	3	548	0	551
1233	0	0	549	4	0	553
1234	0	1	4	545	0	550
1235	1	0	525	3	0	529
1236	487	0	4	4	0	495
1237	5	0	1	514	0	520
1238	1	512	1	4	0	518
1239	521	4	0	5	0	530
1240	4	0	0	524	0	528
1241	2	0	0	519	0	521
1242	0	1	514	5	0	520
1243	1	0	5	525	0	531
1244	0	0	535	6	0	541
1245	0	0	539	0	0	539
1246	3	1	7	543	0	554
1247	1	0	582	6	0	589
1248	562	0	8	6	0	576
1249	648	1	2	6	0	657
1250	681	2	0	4	0	687
1251	19	691	1	0	0	711
1252	7	15	0	693	0	715
1253	6	5	0	688	0	699
1254	4	691	2	19	0	716
1255	685	19	0	7	0	711
1256	19	5	1	682	0	707
1257	6	3	695	20	0	724
1258	6	3	676	6	0	691
1259	2	666	23	3	0	694
1260	669	18	5	7	0	699
1261	17	5	671	3	0	696
1262	622	3	23	4	0	652
1263	19	609	6	0	0	634
1264	7	15	616	0	0	638
1265	4	5	613	2	0	624
1266	3	4	614	1	0	622
1267	3	577	22	2	0	604
1268	3	18	590	3	0	614
1269	565	5	23	3	0	596
1270	20	2	9	554	0	585
1271	7	4	4	585	0	600
1272	6	2	7	590	0	605
1273	6	1	3	598	0	608
1274	3	3	590	24	0	620
1275	10	0	18	579	0	607
1276	4	3	5	591	0	603
1277	566	1	6	27	0	600
1278	591	2	5	13	0	611
1279	559	3	2	9	0	573
1280	23	3	565	4	0	595
1281	7	571	20	5	0	603
1282	5	608	7	1	0	621
1283	573	22	8	6	0	609
1284	19	602	5	0	0	626
1285	10	22	2	590	0	624
1286	11	6	4	612	0	633
1287	3	9	608	22	0	642
1288	3	592	19	8	0	622
1289	2	18	585	7	0	612
1290	561	5	24	9	0	599
1291	606	3	10	6	0	625
1292	30	3	4	591	0	628
1293	15	1	6	588	0	610
1294	14	2	4	581	0	601
1295	4	1	2	603	0	610
1296	3	1	579	33	0	616
1297	7	2	21	568	0	598
1298	2	3	557	27	0	589
1299	3	3	545	9	0	560
1300	4	539	26	8	0	577
1301	533	20	9	14	0	576
1302	23	543	7	4	0	577
1303	11	25	4	518	0	558
1304	9	7	541	20	0	577
1305	523	6	21	5	0	555
1306	21	4	535	6	0	566
1307	528	5	23	6	0	562
1308	553	3	10	4	0	570
1309	32	4	8	539	0	583
1310	15	2	7	542	0	566
1311	11	2	3	551	0	567
1312	5	3	527	27	0	562
1313	503	3	19	16	0	541
1314	18	517	9	11	0	555
1315	7	20	8	519	0	554
1316	519	5	7	28	0	559
1317	534	6	5	14	0	559
1318	541	5	9	7	0	562
1319	31	4	505	8	0	548
1320	523	4	19	9	0	555
1321	526	6	8	7	0	547
1322	32	3	473	10	0	518
1323	14	3	532	10	0	559
1324	15	4	31	513	0	563
1325	9	5	533	22	0	569
1326	6	502	30	10	0	548
1327	7	534	14	8	0	563
1328	495	24	13	10	0	542
1329	21	525	13	6	0	565
1330	17	24	5	521	0	567
1331	506	8	8	24	0	546
1332	21	532	6	10	0	569
1333	13	22	4	536	0	575
1334	11	8	8	548	0	575
1335	8	7	527	32	0	574
1336	12	4	23	530	0	569
1337	5	3	528	31	0	567
1338	10	2	539	10	0	561
1339	9	4	24	511	0	548
1340	6	5	14	530	0	555
1341	515	3	7	29	0	554
1342	23	539	7	14	0	583
1343	13	17	4	515	0	549
1344	15	14	8	514	0	551
1345	488	5	3	32	0	528
1346	21	470	3	15	0	509
1347	14	432	6	11	0	463
1348	11	397	4	6	0	418
1349	1	336	6	4	0	347
1350	254	7	11	6	0	278
1351	246	3	3	2	0	254
1352	243	2	2	1	0	248
1353	243	0	2	4	0	249
1354	8	1	0	237	0	246
1355	2	0	226	5	0	233
1356	4	230	6	1	0	241
1357	3	9	1	224	0	237
1358	2	2	225	7	0	236
1359	5	3	5	222	0	235
1360	1	1	3	235	0	240
1361	4	1	226	7	0	238
1362	1	3	8	224	0	236
1363	3	2	1	224	0	230
1364	224	0	2	12	0	238
1365	219	0	3	6	0	228
1366	222	0	1	5	0	228
1367	221	1	2	3	0	227
1368	9	0	3	212	0	224
1369	5	1	1	215	0	222
1370	5	3	0	218	0	226
1371	209	1	0	13	0	223
1372	8	5	1	211	0	225
1373	3	0	0	220	0	223
1374	5	1	205	8	0	219
1375	6	1	8	197	0	212
1376	1	198	1	10	0	210
1377	2	213	2	4	0	221
1378	206	9	1	2	0	218
1379	10	3	202	1	0	216
1380	4	193	8	1	0	206
1381	182	7	5	0	0	194
1382	11	1	1	183	0	196
1383	3	2	182	8	0	195
1384	8	1	8	173	0	190
1385	3	185	3	6	0	197
1386	176	7	2	5	0	190
1387	7	183	1	5	0	196
1388	180	9	2	5	0	196
1389	188	3	1	3	0	195
1390	10	2	0	184	0	196
1391	3	2	2	173	0	180
1392	2	179	1	9	0	191
1393	178	5	1	7	0	191
1394	7	2	176	3	0	188
1395	172	1	6	4	0	183
1396	171	1	0	3	0	175
1397	10	1	161	3	0	175
1398	6	1	4	157	0	168
1399	155	0	5	7	0	167
1400	6	1	157	4	0	168
1401	4	1	149	2	0	156
1402	134	1	6	5	0	146
1403	6	141	3	1	0	151
1404	1	134	1	2	0	138
1405	5	6	1	122	0	134
1406	2	2	126	6	0	136
1407	118	2	4	3	0	127
1408	5	1	128	1	0	135
1409	1	116	5	1	0	123
1410	115	4	2	1	0	122
1411	4	2	0	115	0	121
1412	117	2	0	3	0	122
1413	6	0	115	1	0	122
1414	2	1	4	107	0	114
1415	3	116	2	4	0	125
1416	3	2	1	111	0	117
1417	2	1	2	117	0	122
1418	0	1	114	6	0	121
1419	1	113	4	2	0	120
1420	1	115	2	1	0	119
1421	0	5	112	0	0	117
1422	100	0	4	0	0	104
1423	107	1	1	0	0	109
1424	5	1	0	100	0	106
1425	98	0	1	4	0	103
1426	3	95	1	1	0	100
1427	3	100	1	0	0	104
1428	94	4	4	0	0	102
1429	7	3	0	91	0	101
1430	96	0	0	3	0	99
1431	97	0	1	2	0	100
1432	5	0	0	95	0	100
1433	2	0	96	3	0	101
1434	91	0	4	2	0	97
1435	96	1	2	1	0	100
1436	6	0	0	92	0	98
1437	1	89	0	4	0	94
1438	0	4	1	92	0	97
1439	1	2	89	2	0	94
1440	0	1	86	1	0	88
1441	1	86	5	0	0	92
1442	3	2	0	54	0	59
1443	2	0	0	57	0	59
1444	0	0	56	3	0	59
1445	55	0	2	0	0	57
1446	58	1	0	0	0	59
1447	54	1	0	0	0	55
1448	56	0	0	1	0	57
1449	2	53	0	2	0	57
1450	1	59	0	0	0	60
1451	62	2	0	0	0	64
1452	2	0	0	63	0	65
1453	1	0	1	62	0	64
1454	1	64	0	1	0	66
1455	2	1	1	61	0	65
1456	0	1	0	62	0	63
1457	1	59	0	2	0	62
1458	1	1	61	1	0	64
1459	0	0	2	59	0	61
1460	58	0	1	3	0	62
1461	58	2	0	0	0	60
1462	3	0	56	1	0	60
1463	0	0	56	0	0	56
1464	1	0	55	0	0	56
1465	2	0	1	52	0	55
1466	2	0	53	0	0	55
1467	1	0	52	1	0	54
1468	2	1	1	48	0	52
1469	0	53	1	1	0	55
1470	0	2	54	0	0	56
1471	1	54	0	0	0	55
1472	55	2	0	1	0	58
1473	1	55	0	0	0	56
1474	1	1	0	52	0	54
1475	52	0	1	2	0	55
1476	2	0	0	51	0	53
1477	0	0	1	55	0	56
1478	0	1	55	1	0	57
1479	0	48	1	0	0	49
1480	0	51	0	2	0	53
1481	1	0	0	50	0	51
1482	0	0	1	49	0	50
1483	0	0	0	51	0	51
1484	0	1	50	0	0	51
1485	0	0	45	0	0	45
1486	41	0	0	1	0	42
1487	0	0	43	0	0	43
1488	0	0	42	0	0	42
1489	0	40	0	0	0	40
1490	0	1	0	42	0	43
1491	0	0	42	0	0	42
1492	1	0	0	39	0	40
1493	0	0	43	0	0	43
1494	0	0	0	42	0	42
1495	0	0	56	0	0	56
1496	0	0	0	53	0	53
1497	1	0	0	52	0	53
1498	0	53	0	0	0	53
1499	0	0	0	52	0	52
1500	0	55	0	0	0	55
1501	0	0	0	54	0	54
1502	0	0	0	54	0	54
1503	52	0	0	0	0	52
1504	0	0	0	50	0	50
1505	0	0	51	0	0	51
1506	0	0	0	53	0	53
1507	0	0	0	52	0	52
1508	0	0	53	0	0	53
1509	1	0	49	0	0	50
1510	0	0	0	49	0	49
1511	0	0	0	52	0	52
1512	0	0	53	0	0	53
1513	0	48	0	0	0	48
1514	0	54	0	0	0	54
1515	52	0	0	0	0	52
1516	0	0	0	50	0	50
1517	51	0	0	1	0	52
1518	52	0	0	0	0	52
1519	0	57	0	0	0	57
1520	56	0	0	2	0	58
1521	53	0	0	1	0	54
1522	0	0	55	0	0	55
1523	0	0	0	55	0	55
1524	0	0	59	0	0	59
1525	0	0	0	56	0	56
1526	0	0	60	0	0	60
1527	0	56	0	0	0	56
1528	0	57	0	0	0	57
1529	1	0	0	52	0	53
1530	53	0	0	0	0	53
1531	0	0	0	49	0	49
1532	1	0	0	50	0	51
1533	0	0	54	0	0	54
1534	0	0	49	0	0	49
1535	0	0	51	0	0	51
1536	0	0	0	51	0	51
1537	1	0	0	51	0	52
1538	0	51	0	0	0	51
1539	0	56	0	0	0	56
1540	51	0	0	3	0	54
1541	0	53	0	0	0	53
1542	0	0	51	0	0	51
1543	0	0	0	51	0	51
1544	0	0	56	0	0	56
1545	0	60	0	0	0	60
1546	0	0	0	58	0	58
1547	59	0	0	0	0	59
1548	0	0	60	0	0	60
1549	0	58	0	0	0	58
1550	0	0	56	0	0	56
1551	0	54	0	0	0	54
1552	0	0	0	50	0	50
1553	53	0	0	1	0	54
1554	50	0	0	1	0	51
1555	0	50	0	0	0	50
1556	51	0	0	1	0	52
1557	0	0	0	51	0	51
1558	53	0	0	0	0	53
1559	0	0	54	0	0	54
1560	0	0	55	0	0	55
1561	0	0	0	54	0	54
1562	0	0	0	57	0	57
1563	0	0	58	0	0	58
1564	0	0	0	57	0	57
1565	54	0	0	3	0	57
1566	56	0	0	1	0	57
1567	1	54	0	0	0	55
1568	0	55	0	0	0	55
1569	53	1	0	1	0	55
1570	1	0	0	53	0	54
1571	52	0	0	0	0	52
1572	1	51	0	0	0	52
1573	51	1	0	1	0	53
1574	1	0	48	0	0	49
1575	0	1	49	0	0	50
1576	1	0	1	48	0	50
1577	0	0	52	1	0	53
1578	0	0	1	52	0	53
1579	1	0	0	49	0	50
1580	0	0	56	1	0	57
1581	0	0	1	55	0	56
1582	0	0	0	59	0	59
1583	0	0	59	1	0	60
1584	0	0	59	0	0	59
1585	55	0	1	0	0	56
1586	1	0	62	0	0	63
1587	69	0	1	0	0	70
1588	75	0	0	0	0	75
1589	3	0	73	0	0	76
1590	0	0	85	0	0	85
1591	2	0	3	73	0	78
1592	1	0	1	73	0	75
1593	0	74	0	3	0	77
1594	0	82	0	2	0	84
1595	0	3	68	0	0	71
1596	66	2	3	1	0	72
1597	73	0	1	1	0	75
1598	5	0	71	0	0	76
1599	1	2	72	0	0	75
1600	0	1	4	67	0	72
1601	0	74	2	3	0	79
1602	0	3	1	70	0	74
1603	0	1	0	75	0	76
1604	72	0	0	3	0	75
1605	74	0	0	1	0	75
1606	4	1	0	75	0	80
1607	2	0	77	2	0	81
1608	72	1	2	3	0	78
1609	4	77	1	1	0	83
1610	78	2	1	0	0	81
1611	82	1	2	0	0	85
1612	4	79	0	1	0	84
1613	1	79	1	1	0	82
1614	1	5	1	75	0	82
1615	0	1	0	81	0	82
1616	2	77	0	4	0	83
1617	1	3	0	78	0	82
1618	0	3	0	84	0	87
1619	1	1	76	5	0	83
1620	79	0	4	3	0	86
1621	82	0	1	1	0	84
1622	87	0	2	0	0	89
1623	6	1	1	79	0	87
1624	83	0	0	6	0	89
1625	5	81	2	1	0	89
1626	1	4	3	77	0	85
1627	1	79	0	6	0	86
1628	1	90	1	2	0	94
1629	89	5	0	1	0	95
1630	92	2	0	2	0	96
1631	91	1	2	0	0	94
1632	94	0	0	1	0	95
1633	93	0	0	3	0	96
1634	6	0	85	1	0	92
1635	84	2	5	1	0	92
1636	5	1	89	0	0	95
1637	86	0	7	0	0	93
1638	92	0	1	0	0	93
1639	94	0	0	1	0	95
1640	5	0	95	0	0	100
1641	2	0	5	86	0	93
1642	0	95	1	7	0	103
1643	96	4	1	1	0	102
1644	96	1	0	1	0	98
1645	4	98	0	1	0	103
1646	99	4	0	0	0	103
1647	6	0	0	90	0	96
1648	1	94	0	6	0	101
1649	97	4	1	2	0	104
1650	101	0	0	0	0	101
1651	4	1	0	96	0	101
1652	98	0	0	5	0	103
1653	5	0	0	103	0	108
1654	1	0	0	104	0	105
1655	0	0	100	5	0	105
1656	0	0	4	94	0	98
1657	2	1	1	99	0	103
1658	1	0	100	4	0	105
1659	0	0	100	1	0	101
1660	0	0	4	99	0	103
1661	0	0	101	4	0	105
1662	90	0	4	1	0	95
1663	4	104	1	0	0	109
1664	3	3	0	106	0	112
1665	2	1	0	110	0	113
1666	1	0	0	109	0	110
1667	108	0	0	5	0	113
1668	114	0	0	2	0	116
1669	116	0	0	1	0	117
1670	4	113	0	0	0	117
1671	2	2	0	113	0	117
1672	0	1	0	118	0	119
1673	114	0	0	4	0	118
1674	116	0	0	1	0	117
1675	4	0	0	114	0	118
1676	1	0	118	3	0	122
1677	118	0	3	1	0	122
1678	119	0	1	0	0	120
1679	3	0	120	0	0	123
1680	112	0	3	2	0	117
1681	3	0	122	1	0	126
1682	121	0	3	1	0	125
1683	4	1	1	124	0	130
1684	1	138	0	3	0	142
1685	0	4	149	1	0	154
1686	0	156	4	0	0	160
1687	0	152	1	0	0	153
1688	171	4	0	1	0	176
1689	2	2	0	175	0	179
1690	1	0	0	170	0	171
1691	177	0	0	3	0	180
1692	3	0	0	182	0	185
1693	1	0	0	178	0	179
1694	1	0	0	179	0	180
1695	0	0	0	176	0	176
1696	0	0	178	3	0	181
1697	0	0	175	1	0	176
1698	0	176	3	0	0	179
1699	181	2	1	1	0	185
1700	2	1	0	192	0	195
1701	1	201	0	1	0	203
1702	0	2	0	212	0	214
1703	0	1	0	210	0	211
1704	0	0	0	211	0	211
1705	4	0	0	213	0	217
1706	2	0	0	210	0	212
1707	0	212	0	3	0	215
1708	0	2	0	213	0	215
1709	0	1	213	2	0	216
1710	0	213	2	1	0	216
1711	0	1	1	213	0	215
1712	0	1	0	217	0	218
1713	0	213	0	3	0	216
1714	0	215	1	1	0	217
1715	216	3	0	0	0	219
1716	2	216	1	0	0	219
1717	216	1	0	1	0	218
1718	214	1	0	2	0	217
1719	2	0	230	0	0	232
1720	1	0	1	223	0	225
1721	0	0	236	1	0	237
1722	0	238	1	1	0	240
1723	3	1	1	220	0	225
1724	0	1	0	236	0	237
1725	0	0	0	237	0	237
1726	1	0	0	235	0	236
1727	0	0	245	2	0	247
1728	1	0	1	242	0	244
1729	0	0	248	1	0	249
1730	0	0	245	1	0	246
1731	237	0	2	0	0	239
1732	247	0	5	1	0	253
1733	254	0	0	0	0	254
1734	2	251	0	0	0	253
1735	2	0	0	258	0	260
1736	0	1	274	1	0	276
1737	0	0	1	270	0	271
1738	0	0	284	1	0	285
1739	279	0	1	2	0	282
1740	284	0	1	2	0	287
1741	285	0	0	1	0	286
1742	2	0	281	0	0	283
1743	2	0	273	0	0	275
1744	0	0	2	282	0	284
1745	0	0	1	278	0	279
1746	0	0	0	293	0	293
1747	0	0	294	2	0	296
1748	0	0	272	1	0	273
1749	274	0	2	0	0	276
1750	3	0	1	297	0	301
1751	1	0	0	298	0	299
1752	302	0	0	3	0	305
1753	2	1	0	300	0	303
1754	338	0	0	6	0	344
1755	356	0	0	2	0	358
1756	355	0	0	1	0	356
1757	3	0	359	0	0	362
1758	1	356	3	0	0	360
1759	367	2	1	3	0	373
1760	3	1	0	374	0	378
1761	2	0	0	369	0	371
1762	0	359	0	4	0	363
1763	364	2	0	1	0	367
1764	375	1	0	1	0	377
1765	369	0	1	3	0	373
1766	2	383	0	0	0	385
1767	414	2	0	3	0	419
1768	417	1	0	2	0	420
1769	414	0	0	3	0	417
1770	4	0	0	413	0	417
1771	3	0	0	411	0	414
1772	0	0	428	3	0	431
1773	2	0	2	410	0	414
1774	1	0	1	421	0	423
1775	1	0	429	2	0	432
1776	401	0	2	2	0	405
1777	430	0	1	2	0	433
1778	3	0	0	425	0	428
1779	1	419	0	2	0	422
1780	0	429	1	1	0	431
1781	0	2	0	429	0	431
1782	0	1	427	2	0	430
1783	1	1	2	404	0	408
1784	0	0	436	1	0	437
1785	0	0	443	1	0	444
1786	0	2	0	451	0	453
1787	462	0	0	2	0	464
1788	462	0	1	3	0	466
1789	1	0	1	466	0	468
1790	2	0	0	473	0	475
1791	0	0	0	473	0	473
1792	0	0	0	467	0	467
1793	467	0	0	8	0	475
1794	459	0	0	4	0	463
1795	454	0	0	4	0	458
1796	1	1	463	0	0	465
1797	1	1	1	456	0	459
1798	2	0	0	460	0	462
1799	457	0	0	3	0	460
1800	1	450	2	0	0	453
1801	451	1	0	1	0	453
1802	440	0	1	4	0	445
1803	436	0	0	5	0	441
1804	439	0	0	2	0	441
1805	4	1	457	0	0	462
1806	0	1	424	0	0	425
1807	476	0	3	1	0	480
1808	480	0	0	2	0	482
1809	475	0	0	4	0	479
1810	476	0	0	4	0	480
1811	4	0	481	0	0	485
1812	2	491	4	0	0	497
1813	1	4	2	523	0	530
1814	567	1	0	11	0	579
1815	581	1	0	3	0	585
1816	589	0	0	1	0	590
1817	592	0	0	5	0	597
1818	590	0	0	2	0	592
1819	572	0	1	1	0	574
1820	11	2	548	0	0	561
1821	3	0	557	0	0	560
1822	4	0	11	543	0	558
1823	1	0	557	9	0	567
1824	3	546	9	2	0	560
1825	2	558	4	0	0	564
1826	1	10	0	563	0	574
1827	1	2	580	9	0	592
1828	1	1	551	3	0	556
1829	548	0	13	2	0	563
1830	596	1	3	4	0	604
1831	19	0	1	594	0	614
1832	600	1	1	13	0	615
1833	15	1	1	596	0	613
1834	6	0	0	598	0	604
1835	2	1	612	15	0	630
1836	1	2	604	3	0	610
1837	4	1	14	594	0	613
1838	2	2	602	13	0	619
1839	551	0	13	7	0	571
1840	613	0	4	2	0	619
1841	17	615	4	0	0	636
1842	617	12	0	3	0	632
1843	14	4	611	1	0	630
1844	597	0	14	5	0	616
1845	619	0	5	4	0	628
1846	612	0	2	5	0	619
1847	20	1	2	586	0	609
1848	5	586	2	13	0	606
1849	602	15	1	7	0	625
1850	600	3	2	10	0	615
1851	17	0	4	590	0	611
1852	581	0	3	17	0	601
1853	15	603	3	8	0	629
1854	11	14	2	578	0	605
1855	1	4	576	17	0	598
1856	518	2	17	8	0	545
1857	18	0	565	5	0	588
1858	11	1	17	543	0	572
1859	5	560	8	15	0	588
1860	5	601	4	6	0	616
1861	6	22	1	586	0	615
1862	6	609	5	15	0	635
1863	10	17	3	779	0	809
1864	18	5	1	798	0	822
1865	11	5	1	817	0	834
1866	777	5	1	41	0	824
1867	37	2	3	757	0	799
1868	11	4	751	31	0	797
1869	9	747	29	10	0	795
1870	745	31	8	11	0	795
1871	31	7	1	743	0	782
1872	14	3	2	767	0	786
1873	10	5	1	774	0	790
1874	6	2	743	39	0	790
1875	4	739	31	13	0	787
1876	738	28	9	9	0	784
1877	30	13	2	702	0	747
1878	10	747	4	32	0	793
1879	742	36	3	11	0	792
1880	35	10	731	6	0	782
1881	711	2	35	12	0	760
1882	31	6	739	11	0	787
1883	13	2	743	7	0	765
1884	5	717	36	8	0	766
1885	11	30	8	697	0	746
1886	5	9	703	31	0	748
1887	7	680	33	11	0	731
1888	7	36	11	658	0	712
1889	9	684	3	31	0	727
1890	5	32	670	12	0	719
1891	7	11	36	682	0	736
1892	7	3	689	35	0	734
1893	9	6	35	680	0	730
1894	11	5	8	715	0	739
1895	5	7	680	43	0	735
1896	5	4	38	700	0	747
1897	674	7	8	42	0	731
1898	31	690	4	15	0	740
1899	12	32	687	8	0	739
1900	678	10	35	7	0	730
1901	37	4	9	667	0	717
1902	10	684	7	27	0	728
1903	694	27	6	10	0	737
1904	714	10	5	9	0	738
1905	43	3	9	663	0	718
1906	11	6	4	692	0	713
1907	13	5	3	683	0	704
1908	9	6	7	664	0	686
1909	4	639	6	41	0	690
1910	11	34	6	606	0	657
1911	5	616	3	33	0	657
1912	4	611	9	14	0	638
1913	5	612	4	14	0	635
1914	6	31	554	14	0	605
1915	5	565	26	10	0	606
1916	520	23	13	13	0	569
1917	28	533	2	12	0	575
1918	10	26	7	499	0	542
1919	4	542	9	24	0	579
1920	15	24	4	530	0	573
1921	12	12	3	556	0	583
1922	6	10	532	31	0	579
1923	527	8	24	15	0	574
1924	538	9	9	10	0	566
1925	548	6	5	10	0	569
1926	27	526	5	13	0	571
1927	13	24	9	504	0	550
1928	8	12	504	31	0	555
1929	8	500	23	14	0	545
1930	11	27	7	421	0	466
1931	7	461	5	21	0	494
1932	458	22	5	11	0	496
1933	456	5	11	7	0	479
1934	473	7	4	12	0	496
1935	466	6	4	12	0	488
1936	27	5	10	446	0	488
1937	11	8	4	446	0	469
1938	10	448	6	25	0	489
1939	6	26	6	447	0	485
1940	4	12	441	29	0	486
1941	13	5	26	423	0	467
1942	5	6	422	28	0	461
1943	7	418	22	7	0	454
1944	10	17	425	5	0	457
1945	12	7	24	412	0	455
1946	7	5	422	24	0	458
1947	13	2	21	415	0	451
1948	9	7	14	427	0	457
1949	9	7	3	431	0	450
1950	10	2	9	429	0	450
1951	406	7	6	21	0	440
1952	18	411	5	10	0	444
1953	389	21	2	9	0	421
1954	20	7	377	6	0	410
1955	376	5	21	12	0	414
1956	394	5	5	13	0	417
1957	24	7	377	6	0	414
1958	8	4	378	11	0	401
1959	7	354	19	8	0	388
1960	4	342	5	5	0	356
1961	7	15	312	8	0	342
1962	4	267	12	6	0	289
1963	3	7	7	105	0	122
1964	97	0	2	2	0	101
1965	2	0	0	92	0	94
1966	97	1	0	2	0	100
1967	101	0	0	0	0	101
1968	2	102	0	0	0	104
1969	99	1	0	0	0	100
1970	102	0	0	1	0	103
1971	1	0	0	100	0	101
1972	102	0	0	4	0	106
1973	1	111	0	0	0	112
1974	0	0	0	112	0	112
1975	113	0	0	1	0	114
1976	1	0	109	0	0	110
1977	105	0	1	0	0	106
1978	1	1	0	108	0	110
1979	0	0	106	0	0	106
1980	0	0	102	0	0	102
1981	95	2	1	1	0	99
1982	97	0	1	2	0	100
1983	0	0	0	105	0	105
1984	0	1	0	105	0	106
1985	0	0	0	106	0	106
1986	0	110	1	0	0	111
1987	112	0	0	1	0	113
1988	0	110	1	0	0	111
1989	110	1	0	1	0	112
1990	0	0	111	0	0	111
1991	2	0	0	107	0	109
1992	110	0	1	0	0	111
1993	0	0	0	109	0	109
1994	1	0	0	103	0	104
1995	0	108	0	1	0	109
1996	106	0	0	1	0	107
1997	1	110	0	0	0	111
1998	1	1	0	117	0	119
1999	0	0	115	0	0	115
2000	102	0	1	0	0	103
2001	1	0	116	0	0	117
2002	108	0	0	0	0	108
2003	0	116	0	0	0	116
2004	0	0	1	112	0	113
2005	0	115	0	0	0	115
2006	118	1	0	0	0	119
2007	0	0	1	116	0	117
2008	1	0	0	120	0	121
2009	0	1	116	1	0	118
2010	110	0	0	1	0	111
2011	0	0	0	120	0	120
2012	1	0	118	0	0	119
2013	1	112	0	0	0	113
2014	1	1	0	113	0	115
2015	115	0	0	1	0	116
2016	1	0	0	115	0	116
2017	0	1	116	2	0	119
2018	122	0	0	1	0	123
2019	0	1	0	121	0	122
2020	0	0	133	1	0	134
2021	2	0	1	132	0	135
2022	0	1	1	124	0	126
2023	1	138	0	1	0	140
2024	136	2	0	0	0	138
2025	1	135	1	0	0	137
2026	134	1	1	1	0	137
2027	3	0	1	131	0	135
2028	1	132	0	2	0	135
2029	1	1	0	136	0	138
2030	0	1	132	3	0	136
2031	127	0	1	1	0	129
2032	2	2	0	132	0	136
2033	2	0	0	132	0	134
2034	0	1	0	133	0	134
2035	1	1	130	1	0	133
2036	1	0	126	1	0	128
2037	0	126	2	2	0	130
2038	0	1	1	117	0	119
2039	118	0	0	2	0	120
2040	2	119	0	1	0	122
2041	1	2	0	122	0	125
2042	122	0	1	1	0	124
2043	123	2	1	0	0	126
2044	2	118	0	0	0	120
2045	123	1	0	2	0	126
2046	122	1	0	0	0	123
2047	4	1	0	116	0	121
2048	0	118	1	4	0	123
2049	2	4	0	121	0	127
2050	121	1	0	5	0	127
2051	5	1	120	2	0	128
2052	2	0	4	120	0	126
2053	2	1	2	122	0	127
2054	0	0	118	6	0	124
2055	1	3	3	115	0	122
2056	117	0	2	8	0	127
2057	120	0	0	2	0	122
2058	5	1	2	111	0	119
2059	1	0	112	7	0	120
2060	2	1	116	2	0	121
2061	2	99	6	0	0	107
2062	1	114	1	2	0	118
2063	4	5	0	111	0	120
2064	107	1	1	6	0	115
2065	4	108	1	4	0	117
2066	105	6	2	3	0	116
2067	3	2	2	106	0	113
2068	3	2	0	109	0	114
2069	101	2	1	7	0	111
2070	4	104	0	4	0	112
2071	109	4	0	1	0	114
2072	4	3	103	1	0	111
2073	3	0	103	2	0	108
2074	2	1	5	96	0	104
2075	0	1	99	6	0	106
2076	2	0	99	2	0	103
2077	0	2	7	88	0	97
2078	2	0	94	4	0	100
2079	2	0	6	94	0	102
2080	1	1	4	96	0	102
2081	0	0	102	9	0	111
2082	2	0	5	100	0	107
2083	0	1	4	101	0	106
2084	1	99	0	8	0	108
2085	96	4	2	4	0	106
2086	4	1	103	3	0	111
2087	2	0	4	104	0	110
2088	1	1	3	108	0	113
2089	1	1	106	7	0	115
2090	103	0	5	4	0	112
2091	4	104	3	0	0	111
2092	6	4	0	102	0	112
2093	1	1	3	101	0	106
2094	0	104	2	4	0	110
2095	2	4	100	3	0	109
2096	0	102	7	1	0	110
2097	99	4	1	3	0	107
2098	5	3	92	2	0	102
2099	1	1	5	93	0	100
2100	0	0	92	7	0	99
2101	0	1	94	2	0	97
2102	1	93	6	0	0	100
2103	4	6	2	86	0	98
2104	87	1	1	7	0	96
2105	93	0	3	2	0	98
2106	4	91	2	3	0	100
2107	2	4	3	87	0	96
2108	92	1	2	5	0	100
2109	95	3	0	1	0	99
2110	6	92	0	3	0	101
2111	96	4	0	2	0	102
2112	5	2	0	95	0	102
2113	1	92	1	3	0	97
2114	2	5	0	94	0	101
2115	3	3	0	90	0	96
2116	2	0	1	96	0	99
2117	0	1	88	7	0	96
2118	1	2	74	1	0	78
2119	0	78	5	1	0	84
2120	71	3	1	1	0	76
2121	3	68	1	2	0	74
2122	2	2	1	69	0	74
2123	0	1	79	4	0	84
2124	1	1	4	72	0	78
2125	0	0	2	78	0	80
2126	0	2	0	83	0	85
2127	81	0	0	4	0	85
2128	4	1	0	82	0	87
2129	1	0	83	3	0	87
2130	78	0	4	2	0	84
2131	80	0	1	1	0	82
2132	81	0	0	2	0	83
2133	80	0	0	4	0	84
2134	82	0	0	1	0	83
2135	4	79	1	1	0	85
2136	1	2	1	77	0	81
2137	1	78	0	2	0	81
2138	77	3	0	2	0	82
2139	80	1	0	1	0	82
2140	80	0	0	0	0	80
2141	5	73	0	0	0	78
2142	1	71	0	0	0	72
2143	0	75	0	1	0	76
2144	0	4	70	1	0	75
2145	1	2	3	59	0	65
2146	0	59	1	0	0	60
2147	0	55	1	0	0	56
2148	0	0	1	51	0	52
2149	0	0	0	55	0	55
2150	0	0	52	0	0	52
2151	53	0	0	0	0	53
2152	0	0	0	56	0	56
2153	0	0	0	55	0	55
2154	0	0	54	0	0	54
2155	0	0	54	0	0	54
2156	0	60	0	0	0	60
2157	0	0	0	60	0	60
2158	0	0	0	62	0	62
2159	0	0	58	0	0	58
2160	54	0	0	2	0	56
2161	60	0	0	0	0	60
2162	0	0	59	0	0	59
2163	61	0	0	1	0	62
2164	0	0	63	0	0	63
2165	60	0	0	0	0	60
2166	61	0	0	1	0	62
2167	0	0	64	0	0	64
2168	0	0	0	65	0	65
2169	0	0	0	62	0	62
2170	0	1	0	66	0	67
2171	66	0	0	1	0	67
2172	66	0	0	0	0	66
2173	0	0	69	0	0	69
2174	0	0	69	0	0	69
2175	70	0	0	0	0	70
2176	72	0	0	0	0	72
2177	0	0	72	0	0	72
2178	0	0	74	0	0	74
2179	0	0	0	72	0	72
2180	0	0	71	0	0	71
2181	0	0	0	72	0	72
2182	75	0	0	0	0	75
2183	0	0	73	0	0	73
2184	71	0	0	0	0	71
2185	0	0	84	0	0	84
2186	0	0	0	81	0	81
2187	1	0	0	81	0	82
2188	0	0	0	85	0	85
2189	1	85	0	0	0	86
2190	0	0	0	83	0	83
2191	1	0	0	86	0	87
2192	87	0	0	0	0	87
2193	0	0	84	0	0	84
2194	79	0	0	0	0	79
2195	0	1	84	0	0	85
2196	74	0	0	1	0	75
2197	1	85	1	0	0	87
2198	1	0	81	0	0	82
2199	0	0	83	0	0	83
2200	0	0	2	81	0	83
2201	0	0	0	85	0	85
2202	0	0	91	1	0	92
2203	0	1	98	0	0	99
2204	0	0	111	0	0	111
2205	111	0	1	1	0	113
2206	115	0	0	1	0	116
2207	116	0	1	1	0	118
2208	2	0	1	114	0	117
2209	3	0	0	117	0	120
2210	1	0	130	1	0	132
2211	0	0	2	122	0	124
2212	0	0	0	115	0	115
2213	131	0	0	2	0	133
2214	128	0	0	3	0	131
2215	130	0	0	0	0	130
2216	2	0	0	131	0	133
2217	0	0	1	133	0	134
2218	1	0	1	132	0	134
2219	131	0	0	3	0	134
2220	2	0	0	125	0	127
2221	0	129	1	1	0	131
2222	1	1	1	129	0	132
2223	0	127	0	1	0	128
2224	126	1	1	1	0	129
2225	125	0	0	1	0	126
2226	2	128	0	0	0	130
2227	0	131	1	0	0	132
2228	2	1	0	129	0	132
2229	0	0	132	1	0	133
2230	2	0	1	124	0	127
2231	0	0	128	2	0	130
2232	0	130	1	1	0	132
2233	0	2	0	133	0	135
2234	1	0	0	129	0	130
2235	1	1	143	2	0	147
2236	1	0	1	145	0	147
2237	0	0	153	1	0	154
2238	150	0	1	0	0	151
2239	146	0	1	1	0	148
2240	148	0	0	0	0	148
2241	1	2	0	144	0	147
2242	0	0	1	146	0	147
2243	0	1	155	1	0	157
2244	1	0	1	152	0	154
2245	0	157	0	2	0	159
2246	0	1	164	0	0	165
2247	1	0	159	0	0	160
2248	2	0	2	146	0	150
2249	1	0	160	1	0	162
2250	1	0	163	0	0	164
2251	160	0	1	0	0	161
2252	0	196	0	1	0	197
2253	213	1	0	2	0	216
2254	213	0	1	1	0	215
2255	215	0	0	2	0	217
2256	2	0	0	213	0	215
2257	2	0	0	216	0	218
2258	1	2	225	1	0	229
2259	1	0	1	221	0	223
2260	0	226	0	2	0	228
2261	228	1	0	2	0	231
2262	1	232	0	1	0	234
2263	0	228	0	0	0	228
2264	2	0	0	229	0	231
2265	0	1	236	1	0	238
2266	1	1	1	231	0	234
2267	0	1	236	1	0	238
2268	0	229	1	0	0	230
2269	230	1	0	1	0	232
2270	227	0	0	3	0	230
2271	231	0	0	1	0	232
2272	1	0	248	0	0	249
2273	0	1	237	0	0	238
2274	251	0	2	0	0	253
2275	259	0	0	3	0	262
2276	265	0	0	0	0	265
2277	1	0	0	261	0	262
2278	2	1	0	265	0	268
2279	264	0	0	2	0	266
2280	261	0	0	0	0	261
2281	1	0	279	0	0	280
2282	2	0	278	0	0	280
2283	270	0	1	2	0	273
2284	1	0	288	0	0	289
2285	281	1	1	0	0	283
2286	1	0	286	0	0	287
2287	1	0	1	280	0	282
2288	0	1	318	1	0	320
2289	2	0	1	339	0	342
2290	0	0	0	346	0	346
2291	0	360	0	2	0	362
2292	365	1	1	3	0	370
2293	1	0	378	0	0	379
2294	368	0	1	1	0	370
2295	1	384	0	0	0	385
2296	399	0	0	3	0	402
2297	0	0	0	391	0	391
2298	0	0	0	393	0	393
2299	0	410	0	0	0	410
2300	0	0	0	419	0	419
2301	0	0	1	417	0	418
2302	0	0	0	424	0	424
2303	415	0	0	4	0	419
2304	406	0	0	4	0	410
2305	0	0	406	0	0	406
2306	0	415	1	0	0	416
2307	0	0	0	419	0	419
2308	0	0	0	433	0	433
2309	0	0	435	1	0	436
2310	0	0	0	419	0	419
2311	428	0	0	4	0	432
2312	416	0	0	2	0	418
2313	412	0	0	5	0	417
2314	1	0	0	421	0	422
2315	443	0	0	2	0	445
2316	441	0	0	3	0	444
2317	446	0	0	1	0	447
2318	1	0	0	448	0	449
2319	1	0	0	446	0	447
2320	0	0	0	443	0	443
2321	1	0	0	437	0	438
2322	0	0	0	431	0	431
2323	0	1	428	0	0	429
2324	0	0	423	1	0	424
2325	0	416	1	1	0	418
2326	1	0	0	433	0	434
2327	2	0	0	424	0	426
2328	0	1	0	419	0	420
2329	0	1	423	0	0	424
2330	2	0	0	407	0	409
2331	0	1	419	0	0	420
2332	1	0	0	407	0	408
2333	0	1	438	0	0	439
2334	0	435	1	0	0	436
2335	0	0	0	428	0	428
2336	0	0	428	0	0	428
2337	368	0	0	2	0	370
2338	0	422	2	0	0	424
2339	0	0	0	427	0	427
2340	0	430	0	0	0	430
2341	1	0	0	427	0	428
2342	422	0	0	3	0	425
2343	0	1	0	410	0	411
2344	0	404	2	2	0	408
2345	399	1	0	4	0	404
2346	1	0	0	407	0	408
2347	1	0	0	411	0	412
2348	409	0	0	2	0	411
2349	1	0	0	440	0	441
2350	5	0	0	551	0	556
2351	0	0	561	10	0	571
2352	0	1	557	3	0	561
2353	2	1	15	545	0	563
2354	0	1	550	13	0	564
2355	1	1	542	3	0	547
2356	501	1	15	3	0	520
2357	13	1	544	2	0	560
2358	3	531	14	4	0	552
2359	1	15	5	541	0	562
2360	537	3	2	19	0	561
2361	544	0	2	11	0	557
2362	545	2	1	4	0	552
2363	17	536	4	1	0	558
2364	8	14	3	534	0	559
2365	5	3	1	552	0	561
2366	537	1	3	19	0	560
2367	537	2	2	11	0	552
2368	540	0	0	7	0	547
2369	19	0	536	2	0	557
2370	6	520	16	1	0	543
2371	2	593	3	5	0	603
2372	7	19	3	566	0	595
2373	5	5	4	591	0	605
2374	4	4	575	24	0	607
2375	555	4	21	9	0	589
2376	580	1	6	8	0	595
2377	25	1	2	570	0	598
2378	11	1	2	578	0	592
2379	10	2	1	582	0	595
2380	567	2	1	31	0	601
2381	20	1	553	8	0	582
2382	7	3	555	5	0	570
2383	10	4	23	533	0	570
2384	5	3	541	20	0	569
2385	518	0	19	14	0	551
2386	546	0	10	7	0	563
2387	560	2	2	7	0	571
2388	31	514	1	3	0	549
2389	511	21	2	13	0	547
2390	22	8	3	513	0	546
2391	12	3	2	527	0	544
2392	9	3	2	531	0	545
2393	3	0	506	29	0	538
2394	8	1	22	476	0	507
2395	5	500	7	26	0	538
2396	492	19	4	12	0	527
2397	24	497	5	5	0	531
2398	11	18	496	4	0	529
2399	5	488	19	6	0	518
2400	464	25	9	5	0	503
2401	24	472	5	6	0	507
2402	8	18	6	421	0	453
2403	5	465	4	18	0	492
2404	460	20	4	10	0	494
2405	470	8	7	5	0	490
2406	472	2	5	7	0	486
2407	28	6	453	4	0	491
2408	16	2	458	4	0	480
2409	8	5	448	4	0	465
2410	435	3	26	7	0	471
2411	20	6	9	436	0	471
2412	15	2	2	454	0	473
2413	7	4	435	27	0	473
2414	7	1	24	441	0	473
2415	417	7	7	25	0	456
2416	24	421	6	10	0	461
2417	425	22	7	4	0	458
2418	28	10	419	4	0	461
2419	434	6	19	3	0	462
2420	435	5	10	6	0	456
2421	447	6	7	5	0	465
2422	31	6	415	4	0	456
2423	16	3	20	424	0	463
2424	7	5	423	24	0	459
2425	7	3	26	421	0	457
2426	8	3	421	24	0	456
2427	13	3	24	412	0	452
2428	14	5	10	428	0	457
2429	416	2	4	29	0	451
2430	424	2	9	13	0	448
2431	434	3	4	7	0	448
2432	29	4	6	407	0	446
2433	13	354	5	21	0	393
2434	6	407	7	11	0	431
2435	399	24	3	13	0	439
2436	25	8	401	6	0	440
2437	407	4	21	5	0	437
2438	28	1	396	2	0	427
2439	411	2	21	4	0	438
2440	393	1	10	10	0	414
2441	30	2	399	6	0	437
2442	406	2	23	5	0	436
2443	422	2	9	7	0	440
2444	417	1	5	10	0	433
2445	25	409	9	4	0	447
2446	17	22	4	401	0	444
2447	10	7	403	21	0	441
2448	9	3	408	9	0	429
2449	8	359	27	4	0	398
2450	4	222	5	2	0	233
2451	7	9	2	195	0	213
2452	188	3	2	9	0	202
2453	12	189	0	4	0	205
2454	5	8	4	182	0	199
2455	2	186	1	11	0	200
2456	187	9	2	3	0	201
2457	7	1	2	187	0	197
2458	4	1	182	8	0	195
2459	4	172	7	2	0	185
2460	3	182	3	3	0	191
2461	3	8	3	162	0	176
2462	3	172	1	7	0	183
2463	6	5	1	165	0	177
2464	167	3	2	7	0	179
2465	175	1	1	5	0	182
2466	178	3	1	2	0	184
2467	182	1	0	1	0	184
2468	11	1	166	0	0	178
2469	5	160	5	2	0	172
2470	2	165	4	2	0	173
2471	0	124	1	0	0	125
2472	0	111	1	0	0	112
2473	109	3	2	1	0	115
2474	116	0	0	1	0	117
2475	118	0	0	1	0	119
2476	128	0	0	1	0	129
2477	4	1	122	0	0	127
2478	132	0	3	1	0	136
2479	139	0	0	0	0	139
2480	136	0	0	1	0	137
2481	4	0	0	135	0	139
2482	0	0	0	135	0	135
2483	135	0	0	5	0	140
2484	3	0	0	136	0	139
2485	0	138	0	3	0	141
2486	1	3	0	143	0	147
2487	2	0	0	141	0	143
2488	0	148	0	2	0	150
2489	2	2	0	149	0	153
2490	0	0	0	150	0	150
2491	149	0	0	4	0	153
2492	3	0	143	0	0	146
2493	139	0	2	0	0	141
2494	2	1	143	0	0	146
2495	0	0	139	0	0	139
2496	0	0	147	0	0	147
2497	141	0	2	0	0	143
2498	2	0	159	0	0	161
2499	157	0	2	2	0	161
2500	159	0	1	0	0	160
2501	161	0	0	1	0	162
2502	3	163	0	0	0	166
2503	163	2	0	1	0	166
2504	2	165	0	0	0	167
2505	1	1	0	165	0	167
2506	1	0	0	166	0	167
2507	0	163	0	3	0	166
2508	0	165	0	1	0	166
2509	0	174	0	0	0	174
2510	170	2	0	3	0	175
2511	2	178	0	0	0	180
2512	175	3	0	3	0	181
2513	3	1	174	0	0	178
2514	176	0	1	1	0	178
2515	175	0	1	1	0	177
2516	4	0	173	0	0	177
2517	2	0	2	170	0	174
2518	1	0	177	2	0	180
2519	1	0	2	178	0	181
2520	2	0	1	178	0	181
2521	178	0	0	5	0	183
2522	179	0	0	4	0	183
2523	5	173	0	0	0	178
2524	179	2	0	0	0	181
2525	2	2	177	0	0	181
2526	171	0	2	0	0	173
2527	3	0	182	1	0	186
2528	3	1	175	0	0	179
2529	183	0	2	2	0	187
2530	181	0	1	1	0	183
2531	5	0	195	1	0	201
2532	1	0	4	189	0	194
2533	2	0	1	199	0	202
2534	0	0	199	3	0	202
2535	2	0	2	190	0	194
2536	0	191	2	1	0	194
2537	1	2	0	195	0	198
2538	0	1	1	198	0	200
2539	1	0	200	3	0	204
2540	180	0	3	1	0	184
2541	192	0	1	1	0	194
2542	198	1	0	0	0	199
2543	196	1	0	1	0	198
2544	3	188	1	0	0	192
2545	1	1	0	187	0	189
2546	0	1	186	1	0	188
2547	0	1	173	1	0	175
2548	0	1	2	175	0	178
2549	0	1	178	1	0	180
2550	166	0	1	1	0	168
2551	1	1	1	177	0	180
2552	3	0	0	174	0	177
2553	0	0	1	178	0	179
2554	175	0	0	3	0	178
2555	2	171	0	2	0	175
2556	175	1	1	3	0	180
2557	170	1	0	6	0	177
2558	2	169	1	0	0	172
2559	1	165	0	1	0	167
2560	174	1	0	1	0	176
2561	2	1	0	177	0	180
2562	2	0	0	173	0	175
2563	174	1	0	4	0	179
2564	3	0	176	1	0	180
2565	165	0	3	3	0	171
2566	172	0	1	2	0	175
2567	3	174	1	0	0	178
2568	184	2	1	1	0	188
2569	183	2	0	1	0	186
2570	5	194	0	0	0	199
2571	0	196	1	0	0	197
2572	4	4	0	185	0	193
2573	185	2	0	5	0	192
2574	3	189	1	1	0	194
2575	3	4	0	188	0	195
2576	187	1	0	6	0	194
2577	5	2	180	1	0	188
2578	3	1	4	177	0	185
2579	2	0	181	4	0	187
2580	171	1	6	4	0	182
2581	180	0	2	3	0	185
2582	5	0	183	1	0	189
2583	2	178	4	0	0	184
2584	4	4	1	181	0	190
2585	1	1	181	4	0	187
2586	2	2	5	178	0	187
2587	0	1	1	187	0	189
2588	0	0	183	6	0	189
2589	173	0	5	3	0	181
2590	184	0	1	4	0	189
2591	7	0	185	1	0	193
2592	3	180	5	0	0	188
2593	4	5	0	176	0	185
2594	1	177	4	5	0	187
2595	0	187	2	2	0	191
2596	179	6	0	5	0	190
2597	7	2	1	179	0	189
2598	2	3	0	176	0	181
2599	3	2	170	6	0	181
2600	1	0	171	1	0	173
2601	2	3	5	164	0	174
2602	0	1	2	176	0	179
2603	0	1	171	7	0	179
2604	1	0	172	2	0	175
2605	1	1	6	166	0	174
2606	166	0	2	12	0	180
2607	8	180	0	1	0	189
2608	178	6	3	2	0	189
2609	8	171	2	2	0	183
2610	1	187	1	1	0	190
2611	178	7	0	3	0	188
2612	8	2	186	0	0	196
2613	0	3	7	181	0	191
2614	2	2	1	188	0	193
2615	3	0	2	200	0	205
2616	1	1	193	8	0	203
2617	3	1	6	197	0	207
2618	200	0	2	12	0	214
2619	10	1	3	202	0	216
2620	5	0	1	217	0	223
2621	208	1	2	11	0	222
2622	209	2	2	6	0	219
2623	7	207	1	5	0	220
2624	2	10	205	3	0	220
2625	3	2	204	1	0	210
2626	3	4	204	1	0	212
2627	2	189	10	1	0	202
2628	2	6	2	189	0	199
2629	1	0	5	198	0	204
2630	197	1	3	7	0	208
2631	8	1	1	189	0	199
2632	1	2	183	11	0	197
2633	4	1	9	183	0	197
2634	2	0	3	186	0	191
2635	0	1	182	9	0	192
2636	1	179	7	5	0	192
2637	2	9	0	166	0	177
2638	1	179	3	6	0	189
2639	3	9	178	1	0	191
2640	183	1	6	1	0	191
2641	180	4	2	1	0	187
2642	185	2	3	2	0	192
2643	9	0	2	175	0	186
2644	4	176	1	7	0	188
2645	178	7	0	1	0	186
2646	185	0	2	6	0	193
2647	180	3	2	3	0	188
2648	10	1	175	4	0	190
2649	172	0	10	2	0	184
2650	12	178	1	3	0	194
2651	176	7	1	3	0	187
2652	11	178	3	2	0	194
2653	178	11	1	3	0	193
2654	11	3	186	1	0	201
2655	181	2	9	1	0	193
2656	196	1	2	2	0	201
2657	174	2	3	6	0	185
2658	193	1	3	1	0	198
2659	12	2	180	2	0	196
2660	8	1	7	177	0	193
2661	178	1	1	9	0	189
2662	9	173	3	2	0	187
2663	5	6	4	172	0	187
2664	4	2	168	9	0	183
2665	4	3	6	169	0	182
2666	2	3	163	8	0	176
2667	1	164	9	4	0	178
2668	1	153	2	5	0	161
2669	0	153	5	4	0	162
2670	3	6	4	126	0	139
2671	1	3	0	136	0	140
2672	2	3	121	7	0	133
2673	1	116	7	2	0	126
2674	110	5	2	2	0	119
2675	7	105	0	1	0	113
2676	1	109	1	1	0	112
2677	1	4	1	112	0	118
2678	103	0	3	3	0	109
2679	108	1	1	0	0	110
2680	4	2	1	102	0	109
2681	106	1	1	4	0	112
2682	5	1	1	105	0	112
2683	1	0	102	5	0	108
2684	100	1	5	0	0	106
2685	4	0	0	105	0	109
2686	0	0	96	4	0	100
2687	1	0	96	1	0	98
2688	0	1	2	99	0	102
2689	100	0	1	5	0	106
2690	98	2	0	2	0	102
2691	2	104	1	2	0	109
2692	110	3	1	1	0	115
2693	113	1	1	1	0	116
2694	110	0	0	2	0	112
2695	3	115	0	1	0	119
2696	115	2	1	0	0	118
2697	117	0	0	1	0	118
2698	3	1	0	113	0	117
2699	109	0	0	2	0	111
2700	2	106	1	0	0	109
2701	2	109	0	0	0	111
2702	1	1	1	106	0	109
2703	4	0	0	108	0	112
2704	1	109	0	1	0	111
2705	112	1	1	0	0	114
2706	1	103	1	0	0	105
2707	104	1	0	0	0	105
2708	2	104	0	1	0	107
2709	2	1	0	98	0	101
2710	2	105	0	0	0	107
2711	107	1	2	0	0	110
2712	102	0	0	1	0	103
2713	105	0	0	0	0	105
2714	1	1	100	0	0	102
2715	0	0	101	1	0	102
2716	0	94	2	0	0	96
2717	1	0	93	1	0	95
2718	0	1	89	0	0	90
2719	1	1	0	75	0	77
2720	0	0	81	0	0	81
2721	0	83	0	0	0	83
2722	81	0	0	1	0	82
2723	0	78	0	0	0	78
2724	0	82	0	0	0	82
2725	84	0	0	1	0	85
2726	82	0	0	1	0	83
2727	0	83	0	0	0	83
2728	88	0	0	0	0	88
2729	86	0	0	0	0	86
2730	86	0	0	1	0	87
2731	0	0	84	0	0	84
2732	1	0	82	0	0	83
2733	0	0	0	85	0	85
2734	0	0	0	88	0	88
2735	92	0	0	0	0	92
2736	0	92	0	0	0	92
2737	1	0	0	91	0	92
2738	1	0	0	90	0	91
2739	0	0	0	93	0	93
2740	2	0	0	91	0	93
2741	0	0	94	2	0	96
2742	0	0	91	0	0	91
2743	0	0	2	93	0	95
2744	0	0	96	2	0	98
2745	91	0	2	1	0	94
2746	2	0	1	92	0	95
2747	1	0	92	2	0	95
2748	89	0	2	0	0	91
2749	2	94	1	0	0	97
2750	93	2	0	0	0	95
2751	2	98	0	0	0	100
2752	1	2	0	103	0	106
2753	0	0	104	2	0	106
2754	0	0	2	96	0	98
2755	0	0	99	2	0	101
2756	91	0	2	1	0	94
2757	2	0	1	93	0	96
2758	95	0	0	2	0	97
2759	2	0	98	1	0	101
2760	97	0	2	0	0	99
2761	105	0	0	0	0	105
2762	3	0	105	0	0	108
2763	2	0	2	104	0	108
2764	0	0	107	2	0	109
2765	1	113	2	1	0	117
2766	111	2	1	0	0	114
2767	107	1	1	2	0	111
2768	3	0	113	1	0	117
2769	1	0	117	0	0	118
2770	0	1	3	111	0	115
2771	1	0	1	120	0	122
2772	122	0	0	3	0	125
2773	2	120	1	1	0	124
2774	123	2	1	1	0	127
2775	125	1	0	1	0	127
2776	4	0	120	0	0	124
2777	116	0	2	0	0	118
2778	2	1	122	0	0	125
2779	2	0	2	122	0	126
2780	1	0	137	2	0	140
2781	0	1	3	127	0	131
2782	1	0	135	2	0	138
2783	131	0	3	1	0	135
2784	134	0	1	1	0	136
2785	3	0	1	130	0	134
2786	134	0	1	4	0	139
2787	2	0	1	142	0	145
2788	2	152	0	2	0	156
2789	148	2	0	4	0	154
2790	2	152	0	1	0	155
2791	3	2	0	153	0	158
2792	0	1	0	155	0	156
2793	0	1	0	152	0	153
2794	1	0	0	151	0	152
2795	0	1	145	3	0	149
2796	131	0	2	3	0	136
2797	143	0	0	1	0	144
2798	3	146	0	1	0	150
2799	1	2	0	149	0	152
2800	0	0	1	151	0	152
2801	1	0	147	4	0	152
2802	145	1	2	2	0	150
2803	2	1	1	146	0	150
2804	1	0	142	3	0	146
2805	140	0	2	3	0	145
2806	148	0	2	2	0	152
2807	149	0	0	0	0	149
2808	3	0	150	1	0	154
2809	1	0	145	0	0	146
2810	137	0	4	2	0	143
2811	3	0	1	144	0	148
2812	2	0	0	144	0	146
2813	0	0	146	3	0	149
2814	140	0	3	2	0	145
2815	3	0	1	152	0	156
2816	153	0	0	4	0	157
2817	156	0	0	2	0	158
2818	153	0	1	0	0	154
2819	3	0	152	0	0	155
2820	1	0	3	151	0	155
2821	158	0	1	4	0	163
2822	4	157	0	2	0	163
2823	3	2	0	162	0	167
2824	0	2	1	164	0	167
2825	157	0	0	7	0	164
2826	158	0	0	4	0	162
2827	5	2	0	156	0	163
2828	2	0	157	4	0	163
2829	154	0	3	3	0	160
2830	4	0	166	0	0	170
2831	165	0	3	1	0	169
2832	166	0	2	2	0	170
2833	6	0	167	0	0	173
2834	3	1	4	162	0	170
2835	0	0	172	4	0	176
2836	1	175	4	2	0	182
2837	2	5	2	172	0	181
2838	0	179	2	4	0	185
2839	1	4	0	178	0	183
2840	0	2	180	3	0	185
2841	0	178	5	2	0	185
2842	0	184	2	2	0	188
2843	1	5	1	181	0	188
2844	181	3	0	4	0	188
2845	4	1	1	198	0	204
2846	194	1	1	8	0	204
2847	5	196	0	1	0	202
2848	214	5	0	2	0	221
2849	6	2	211	1	0	220
2850	4	1	6	210	0	221
2851	6	0	2	214	0	222
2852	1	1	209	9	0	220
2853	198	1	5	5	0	209
2854	207	1	3	3	0	214
2855	9	202	3	1	0	215
2856	6	4	1	180	0	191
2857	2	200	1	6	0	209
2858	1	8	198	3	0	210
2859	2	1	195	1	0	199
2860	2	3	8	188	0	201
2861	186	0	4	8	0	198
2862	6	184	2	1	0	193
2863	181	7	0	4	0	192
2864	8	2	181	0	0	191
2865	182	2	8	3	0	195
2866	190	0	3	4	0	197
2867	9	0	187	1	0	197
2868	7	2	6	182	0	197
2869	185	0	2	7	0	194
2870	184	1	3	3	0	191
2871	186	1	1	2	0	190
2872	13	3	0	180	0	196
2873	6	0	182	7	0	195
2874	174	1	8	4	0	187
2875	7	0	188	7	0	202
2876	7	0	10	178	0	195
2877	5	3	2	181	0	191
2878	4	183	2	6	0	195
2879	1	6	181	5	0	193
2880	2	170	7	4	0	183
2881	2	183	2	3	0	190
2882	1	7	5	177	0	190
2883	1	4	179	8	0	192
2884	6	3	7	176	0	192
2885	1	2	178	9	0	190
2886	2	1	9	175	0	187
2887	1	4	2	180	0	187
2888	2	2	169	9	0	182
2889	4	1	9	165	0	179
2890	4	0	168	9	0	181
2891	2	2	167	5	0	176
2892	1	166	10	8	0	185
2893	165	9	6	6	0	186
2894	8	2	171	3	0	184
2895	170	2	9	2	0	183
2896	12	3	4	168	0	187
2897	4	3	168	8	0	183
2898	3	166	7	5	0	181
2899	5	9	3	170	0	187
2900	2	2	177	7	0	188
2901	5	3	9	158	0	175
2902	4	167	4	13	0	188
2903	170	9	7	3	0	189
2904	10	5	3	170	0	188
2905	170	4	3	8	0	185
2906	174	3	3	7	0	187
2907	182	1	2	7	0	192
2908	182	2	3	1	0	188
2909	177	2	4	4	0	187
2910	17	166	1	3	0	187
2911	11	7	3	170	0	191
2912	12	2	0	175	0	189
2913	6	2	4	179	0	191
2914	2	1	170	16	0	189
2915	5	163	11	7	0	186
2916	171	7	5	5	0	188
2917	166	8	3	4	0	181
2918	14	163	1	6	0	184
2919	4	170	5	5	0	184
2920	167	8	5	4	0	184
2921	7	5	168	3	0	183
2922	6	6	10	162	0	184
2923	167	3	5	8	0	183
2924	11	3	4	159	0	177
2925	5	156	3	8	0	172
2926	7	6	2	159	0	174
2927	4	2	162	9	0	177
2928	149	3	8	7	0	167
2929	164	0	5	6	0	175
2930	8	1	5	153	0	167
2931	8	1	2	158	0	169
2932	149	3	4	8	0	164
2933	8	141	3	5	0	157
2934	7	5	3	139	0	154
2935	7	3	3	141	0	154
2936	133	2	3	3	0	141
2937	7	129	2	6	0	144
2938	125	1	2	5	0	133
2939	6	117	3	2	0	128
2940	3	128	2	3	0	136
2941	123	4	2	5	0	134
2942	3	117	3	3	0	126
2943	3	4	0	120	0	127
2944	4	3	119	1	0	127
2945	2	1	92	4	0	99
2946	0	1	91	3	0	95
2947	3	90	4	1	0	98
2948	62	2	2	0	0	66
2949	1	0	1	60	0	62
2950	1	0	1	60	0	62
2951	0	0	60	1	0	61
2952	60	0	1	0	0	61
2953	1	0	0	63	0	64
2954	1	0	0	64	0	65
2955	2	0	0	62	0	64
2956	62	1	0	2	0	65
2957	1	0	61	1	0	63
2958	59	0	1	1	0	61
2959	2	0	0	62	0	64
2960	0	1	62	1	0	64
2961	61	0	1	0	0	62
2962	2	1	63	0	0	66
2963	0	2	1	63	0	66
2964	0	1	67	1	0	69
2965	1	1	61	0	0	63
2966	54	2	1	1	0	58
2967	1	1	57	1	0	60
2968	1	0	3	54	0	58
2969	53	1	2	2	0	58
2970	2	1	1	56	0	60
2971	0	1	55	1	0	57
2972	1	0	55	1	0	57
2973	0	52	2	2	0	56
2974	1	2	1	49	0	53
2975	52	0	1	1	0	54
2976	2	50	0	2	0	54
2977	49	1	0	4	0	54
2978	1	0	1	51	0	53
2979	51	0	0	3	0	54
2980	1	46	1	1	0	49
2981	1	1	1	49	0	52
2982	48	0	0	2	0	50
2983	2	49	1	1	0	53
2984	1	1	2	51	0	55
2985	2	0	1	51	0	54
2986	51	0	1	3	0	55
2987	1	0	2	51	0	54
2988	1	0	2	50	0	53
2989	0	0	2	52	0	54
2990	1	0	51	2	0	54
2991	48	0	3	2	0	53
2992	3	0	1	56	0	60
2993	2	0	56	2	0	60
2994	58	0	3	1	0	62
2995	1	0	61	1	0	63
2996	2	1	2	55	0	60
2997	0	54	0	3	0	57
2998	1	0	1	57	0	59
2999	2	1	56	1	0	60
3000	1	3	61	0	0	65
3001	1	0	1	65	0	67
3002	1	0	61	2	0	64
3003	61	2	2	0	0	65
3004	2	2	63	1	0	68
3005	1	1	1	61	0	64
3006	3	1	1	62	0	67
3007	1	2	1	63	0	67
3008	61	0	0	5	0	66
3009	63	0	1	1	0	65
3010	61	1	0	1	0	63
3011	2	0	1	61	0	64
3012	1	0	0	62	0	63
3013	1	0	56	4	0	61
3014	1	0	55	2	0	58
3015	2	55	2	2	0	61
3016	3	2	1	47	0	53
3017	1	0	2	49	0	52
3018	3	45	0	1	0	49
3019	44	1	1	2	0	48
3020	1	46	3	1	0	51
3021	48	2	1	1	0	52
3022	1	1	2	48	0	52
3023	48	0	2	2	0	52
3024	2	1	1	49	0	53
3025	0	1	47	3	0	51
3026	1	0	3	48	0	52
3027	47	1	1	1	0	50
3028	2	0	1	48	0	51
3029	0	0	2	48	0	50
3030	2	0	46	2	0	50
3031	0	0	2	49	0	51
3032	1	0	1	48	0	50
3033	2	44	0	3	0	49
3034	2	2	0	45	0	49
3035	2	0	0	51	0	53
3036	1	0	0	50	0	51
3037	3	47	2	3	0	55
3038	0	1	0	52	0	53
3039	50	0	1	2	0	53
3040	2	47	0	1	0	50
3041	1	44	0	1	0	46
3042	0	44	0	1	0	45
3043	0	0	0	46	0	46
3044	0	40	1	0	0	41
3045	0	39	0	2	0	41
3046	43	0	0	1	0	44
3047	0	1	41	0	0	42
3048	41	1	0	0	0	42
3049	0	1	0	46	0	47
3050	0	0	43	2	0	45
3051	43	2	0	0	0	45
3052	0	1	44	1	0	46
3053	2	0	43	0	0	45
3054	43	1	1	0	0	45
3055	1	0	0	47	0	48
3056	0	1	47	1	0	49
3057	47	0	1	1	0	49
3058	49	2	0	0	0	51
3059	0	1	52	0	0	53
3060	50	0	1	0	0	51
3061	54	0	1	0	0	55
3062	1	0	51	1	0	53
3063	49	0	1	2	0	52
3064	49	0	1	0	0	50
3065	3	0	48	0	0	51
3066	0	0	57	0	0	57
3067	3	0	2	52	0	57
3068	2	0	57	1	0	60
3069	54	0	2	2	0	58
3070	2	0	1	55	0	58
3071	3	0	0	51	0	54
3072	1	0	55	1	0	57
3073	1	0	3	50	0	54
3074	1	0	54	2	0	57
3075	55	1	1	0	0	57
3076	58	0	1	0	0	59
3077	2	0	55	1	0	58
3078	54	0	1	1	0	56
3079	56	0	2	0	0	58
3080	1	0	56	1	0	58
3081	57	0	2	1	0	60
3082	61	0	1	0	0	62
3083	2	0	57	0	0	59
3084	56	0	2	1	0	59
3085	2	0	56	1	0	59
3086	2	0	2	52	0	56
3087	0	0	0	58	0	58
3088	0	0	0	60	0	60
3089	1	0	60	1	0	62
3090	55	0	1	1	0	57
3091	0	0	58	0	0	58
3092	2	45	1	0	0	48
3093	1	47	0	1	0	49
3094	46	1	2	1	0	50
3095	2	0	1	42	0	45
3096	1	44	0	2	0	47
3097	44	1	2	0	0	47
3098	50	0	0	0	0	50
3099	2	48	1	0	0	51
3100	1	1	1	47	0	50
3101	1	48	0	2	0	51
3102	51	1	0	1	0	53
3103	51	0	1	0	0	52
3104	3	0	0	50	0	53
3105	52	0	0	1	0	53
3106	2	1	1	49	0	53
3107	1	1	51	1	0	54
3108	50	0	2	0	0	52
3109	1	0	48	1	0	50
3110	0	1	1	51	0	53
3111	52	0	0	2	0	54
3112	2	0	0	51	0	53
3113	1	1	48	1	0	51
3114	0	0	47	1	0	48
3115	0	2	2	49	0	53
3116	49	0	1	2	0	52
3117	4	46	0	0	0	50
3118	0	2	0	48	0	50
3119	1	1	49	2	0	53
3120	46	0	2	1	0	49
3121	51	0	1	0	0	52
3122	3	0	46	0	0	49
3123	43	0	3	1	0	47
3124	2	1	0	46	0	49
3125	1	0	46	2	0	49
3126	45	0	2	0	0	47
3127	2	0	0	46	0	48
3128	0	0	0	48	0	48
3129	43	0	0	3	0	46
3130	1	43	1	0	0	45
3131	1	48	0	0	0	49
3132	45	2	0	0	0	47
3133	48	0	0	1	0	49
3134	3	0	47	0	0	50
3135	0	0	45	1	0	46
3136	0	0	3	44	0	47
3137	43	0	1	2	0	46
3138	46	0	0	1	0	47
3139	46	0	0	0	0	46
3140	2	42	0	0	0	44
3141	0	46	0	1	0	47
3142	0	2	0	49	0	51
3143	1	0	0	49	0	50
3144	1	0	0	50	0	51
3145	0	0	51	2	0	53
3146	1	0	46	0	0	47
3147	48	0	2	1	0	51
3148	51	0	2	0	0	53
3149	3	0	0	48	0	51
3150	0	0	0	50	0	50
3151	0	0	0	50	0	50
3152	1	0	48	2	0	51
3153	0	0	49	0	0	49
3154	0	1	2	47	0	50
3155	1	0	49	2	0	52
3156	1	49	2	0	0	52
3157	0	55	1	0	0	56
3158	53	2	0	0	0	55
3159	2	50	0	1	0	53
3160	1	2	0	53	0	56
3161	1	0	0	53	0	54
3162	1	49	0	2	0	52
3163	0	3	0	52	0	55
3164	0	1	52	2	0	55
3165	0	49	2	1	0	52
3166	0	1	0	44	0	45
3167	0	0	46	1	0	47
3168	0	45	1	0	0	46
3169	0	1	0	43	0	44
3170	0	47	0	0	0	47
3171	0	1	0	46	0	47
3172	0	0	0	45	0	45
3173	0	44	0	1	0	45
3174	45	1	0	0	0	46
3175	43	0	0	0	0	43
3176	1	41	0	0	0	42
3177	0	45	0	0	0	45
3178	0	1	0	46	0	47
3179	0	0	45	1	0	46
3180	40	0	1	0	0	41
3181	43	0	0	0	0	43
3182	1	0	42	0	0	43
3183	41	0	1	0	0	42
3184	42	0	0	0	0	42
3185	1	0	41	0	0	42
3186	41	0	1	0	0	42
3187	1	0	44	0	0	45
3188	0	46	1	0	0	47
3189	48	1	0	0	0	49
3190	46	0	0	0	0	46
3191	1	0	47	0	0	48
3192	45	0	1	0	0	46
3193	50	0	0	0	0	50
3194	1	0	49	0	0	50
3195	48	0	1	0	0	49
3196	50	0	0	0	0	50
3197	1	0	48	0	0	49
3198	50	0	1	0	0	51
3199	1	0	0	48	0	49
3200	0	0	0	48	0	48
3201	1	0	47	1	0	49
3202	0	0	45	0	0	45
3203	0	0	1	45	0	46
3204	0	0	0	44	0	44
3205	51	0	0	1	0	52
3206	1	0	51	0	0	52
3207	51	0	1	0	0	52
3208	1	0	0	53	0	54
3209	0	0	54	1	0	55
3210	55	0	1	1	0	57
3211	1	0	0	61	0	62
3212	0	0	60	1	0	61
3213	60	0	1	0	0	61
3214	0	0	1	61	0	62
3215	60	0	0	0	0	60
3216	0	0	62	1	0	63
3217	3	0	0	58	0	61
3218	0	73	1	0	0	74
3219	73	0	0	1	0	74
3220	70	1	0	1	0	72
3221	2	74	0	0	0	76
3222	77	0	0	0	0	77
3223	75	1	0	0	0	76
3224	75	0	0	1	0	76
3225	1	76	0	0	0	77
3226	2	0	0	76	0	78
3227	0	1	73	0	0	74
3228	1	0	0	73	0	74
3229	0	0	1	74	0	75
3230	0	0	76	1	0	77
3231	0	0	70	1	0	71
3232	1	0	1	70	0	72
3233	0	76	1	0	0	77
3234	76	0	0	1	0	77
3235	76	1	0	0	0	77
3236	1	81	0	0	0	82
3237	83	0	0	1	0	84
3238	83	2	0	0	0	85
3239	1	0	82	0	0	83
3240	83	0	0	0	0	83
3241	0	84	1	0	0	85
3242	1	0	77	0	0	78
3243	0	1	76	0	0	77
3244	0	78	1	0	0	79
3245	79	0	1	0	0	80
3246	0	1	79	0	0	80
3247	1	0	0	80	0	81
3248	0	0	77	0	0	77
3249	75	0	0	1	0	76
3250	0	0	118	0	0	118
3251	1	0	117	1	0	119
3252	116	0	1	2	0	119
3253	0	116	1	0	0	117
3254	126	0	0	0	0	126
3255	129	1	0	0	0	130
3256	1	0	0	126	0	127
3257	1	146	0	0	0	147
3258	148	0	0	2	0	150
3259	0	1	150	0	0	151
3260	149	0	0	1	0	150
3261	0	152	1	0	0	153
3262	151	0	0	0	0	151
3263	150	1	0	0	0	151
3264	1	152	0	0	0	153
3265	1	0	0	154	0	155
3266	154	1	0	0	0	155
3267	0	152	0	1	0	153
3268	1	0	0	153	0	154
3269	162	1	0	0	0	163
3270	0	0	0	168	0	168
3271	2	0	0	162	0	164
3272	0	167	0	1	0	168
3273	166	0	0	2	0	168
3274	166	1	0	1	0	168
3275	170	0	0	0	0	170
3276	1	178	0	0	0	179
3277	182	0	0	1	0	183
3278	179	1	0	1	0	181
3279	2	0	0	179	0	181
3280	1	0	0	177	0	178
3281	1	0	179	1	0	181
3282	0	0	0	181	0	181
3283	1	0	1	174	0	176
3284	0	0	181	1	0	182
3285	168	0	0	1	0	169
3286	0	0	179	0	0	179
3287	1	1	181	0	0	183
3288	0	0	0	182	0	182
3289	0	0	1	179	0	180
3290	0	183	0	1	0	184
3291	187	0	0	1	0	188
3292	184	1	0	1	0	186
3293	1	183	1	1	0	186
3294	1	190	0	0	0	191
3295	0	0	0	197	0	197
3296	0	198	1	0	0	199
3297	198	0	0	2	0	200
3298	198	1	0	2	0	201
3299	1	1	0	197	0	199
3300	1	0	0	199	0	200
3301	201	0	0	2	0	203
3302	0	0	194	1	0	195
3303	192	0	0	2	0	194
3304	1	0	196	0	0	197
3305	192	0	1	0	0	193
3306	1	0	1	189	0	191
3307	1	0	190	0	0	191
3308	1	0	183	1	0	185
3309	182	1	1	1	0	185
3310	184	0	2	1	0	187
3311	1	194	2	0	0	197
3312	1	0	0	202	0	203
3313	1	0	0	199	0	200
3314	196	1	0	2	0	199
3315	0	190	1	1	0	192
3316	189	0	0	3	0	192
3317	1	179	0	0	0	180
3318	0	178	0	0	0	178
3319	177	0	0	1	0	178
3320	0	1	175	0	0	176
3321	0	1	0	174	0	175
3322	1	0	0	169	0	170
3323	0	0	168	0	0	168
3324	1	0	0	161	0	162
3325	0	0	0	141	0	141
3326	1	157	1	0	0	159
3327	164	1	0	1	0	166
3328	1	0	166	2	0	169
3329	154	2	0	1	0	157
3330	1	167	0	0	0	168
3331	2	2	1	165	0	170
3332	176	0	1	3	0	180
3333	2	1	0	175	0	178
3334	1	1	0	175	0	177
3335	2	0	174	1	0	177
3336	156	0	0	3	0	159
3337	169	0	0	2	0	171
3338	1	1	174	1	0	177
3339	3	0	2	167	0	172
3340	1	0	170	2	0	173
3341	165	0	1	1	0	167
3342	177	1	2	1	0	181
3343	2	0	1	177	0	180
3344	173	0	1	1	0	175
3345	2	1	193	1	0	197
3346	2	0	1	193	0	196
3347	1	0	1	188	0	190
3348	1	1	1	195	0	198
3349	3	1	0	195	0	199
3350	171	0	2	4	0	177
3351	2	0	173	2	0	177
3352	2	1	1	169	0	173
3353	2	0	172	2	0	176
3354	1	1	172	0	0	174
3355	2	0	0	175	0	177
3356	4	0	1	176	0	181
3357	170	0	3	4	0	177
3358	3	0	0	174	0	177
3359	1	1	1	176	0	179
3360	3	0	1	177	0	181
3361	176	1	0	5	0	182
3362	175	1	1	2	0	179
3363	175	1	2	2	0	180
3364	172	0	2	2	0	176
3365	2	182	2	2	0	188
3366	1	2	2	185	0	190
3367	4	0	1	184	0	189
3368	185	1	0	5	0	191
3369	5	200	0	2	0	207
3370	1	3	1	200	0	205
3371	2	0	210	5	0	217
3372	230	1	5	2	0	238
3373	9	239	1	1	0	250
3374	255	8	1	1	0	265
3375	268	1	0	2	0	271
3376	11	1	0	252	0	264
3377	1	1	258	10	0	270
3378	3	0	7	260	0	270
3379	257	2	1	11	0	271
3380	12	0	1	260	0	273
3381	258	2	1	10	0	271
3382	11	254	0	3	0	268
3383	265	7	3	6	0	281
3384	15	1	1	263	0	280
3385	5	3	0	288	0	296
3386	292	0	0	11	0	303
3387	298	0	1	3	0	302
3388	295	1	0	4	0	300
3389	293	0	2	2	0	297
3390	281	0	0	7	0	288
3391	13	0	0	279	0	292
3392	3	3	268	10	0	284
3393	5	271	7	1	0	284
3394	273	10	1	4	0	288
3395	8	2	262	4	0	276
3396	259	1	9	6	0	275
3397	9	262	2	6	0	279
3398	270	7	2	3	0	282
3399	13	2	0	268	0	283
3400	9	1	1	271	0	282
3401	6	1	263	10	0	280
3402	8	1	9	254	0	272
3403	2	3	268	12	0	285
3404	5	1	280	3	0	289
3405	281	2	8	6	0	297
3406	295	0	2	2	0	299
3407	12	2	286	2	0	302
3408	285	1	6	2	0	294
3409	285	1	3	2	0	291
3410	12	1	273	5	0	291
3411	6	272	6	4	0	288
3412	4	7	1	309	0	321
3413	323	1	6	12	0	342
3414	338	2	3	5	0	348
3415	339	1	2	4	0	346
3416	336	1	3	5	0	345
3417	341	0	3	0	0	344
3418	14	2	324	3	0	343
3419	8	1	340	1	0	350
3420	10	1	11	327	0	349
3421	347	4	2	9	0	362
3422	361	2	5	5	0	373
3423	362	2	2	1	0	367
3424	351	2	2	8	0	363
3425	15	339	5	3	0	362
3426	6	365	2	9	0	382
3427	371	6	3	3	0	383
3428	369	3	4	8	0	384
3429	17	366	2	3	0	388
3430	367	9	2	6	0	384
3431	16	1	367	4	0	388
3432	7	5	8	362	0	382
3433	10	2	364	10	0	386
3434	11	0	375	4	0	390
3435	13	2	8	381	0	404
3436	15	3	3	387	0	408
3437	10	1	393	10	0	414
3438	14	3	5	383	0	405
3439	6	4	4	400	0	414
3440	405	1	7	10	0	423
3441	405	4	3	8	0	420
3442	18	1	2	400	0	421
3443	7	4	401	9	0	421
3444	11	399	9	4	0	423
3445	399	9	8	6	0	422
3446	16	2	424	3	0	445
3447	4	418	9	4	0	435
3448	7	432	3	9	0	451
3449	439	7	6	8	0	460
3450	440	5	2	7	0	454
3451	15	2	6	432	0	455
3452	6	1	457	12	0	476
3453	10	2	11	450	0	473
3454	12	3	5	456	0	476
3455	10	1	7	459	0	477
3456	456	3	4	10	0	473
3457	15	443	4	6	0	468
3458	5	485	9	2	0	501
3459	7	10	0	472	0	489
3460	3	3	5	493	0	504
3461	485	6	1	13	0	505
3462	487	1	2	6	0	496
3463	484	0	1	8	0	493
3464	14	476	4	4	0	498
3465	467	6	2	5	0	480
3466	16	3	5	452	0	476
3467	5	1	454	13	0	473
3468	4	2	429	8	0	443
3469	416	2	10	2	0	430
3470	12	1	423	5	0	441
3471	8	1	403	1	0	413
3472	349	1	2	3	0	355
3473	4	0	364	2	0	370
3474	2	0	341	1	0	344
3475	2	2	1	321	0	326
3476	1	0	358	1	0	360
3477	1	1	1	342	0	345
3478	2	1	1	333	0	337
3479	1	0	351	2	0	354
3480	0	355	3	3	0	361
3481	353	0	1	1	0	355
3482	3	0	374	0	0	377
3483	1	1	376	1	0	379
3484	326	0	4	2	0	332
3485	1	1	368	0	0	370
3486	2	357	0	0	0	359
3487	0	325	3	1	0	329
3488	0	1	1	360	0	362
3489	0	1	0	356	0	357
3490	363	0	1	2	0	366
3491	361	0	0	2	0	363
3492	365	0	0	2	0	367
3493	1	0	2	361	0	364
3494	369	0	0	3	0	372
3495	362	0	0	3	0	365
3496	2	0	365	1	0	368
3497	1	1	349	0	0	351
3498	1	368	2	0	0	371
3499	1	1	1	368	0	371
3500	370	1	0	3	0	374
3501	1	363	1	1	0	366
3502	2	1	0	368	0	371
3503	371	0	0	2	0	373
3504	351	0	0	4	0	355
3505	2	366	1	0	0	369
3506	368	2	0	0	0	370
3507	361	0	0	3	0	364
3508	4	1	1	357	0	363
3509	1	0	366	2	0	369
3510	1	350	2	0	0	353
3511	0	358	1	0	0	359
3512	348	4	1	2	0	355
3513	3	0	1	343	0	347
3514	2	0	341	2	0	345
3515	0	341	4	0	0	345
3516	339	2	0	2	0	343
3517	339	2	1	0	0	342
3518	2	0	355	0	0	357
3519	1	2	2	322	0	327
3520	1	1	1	349	0	352
3521	1	1	375	2	0	379
3522	360	0	2	2	0	364
3523	441	0	4	1	0	446
3524	16	1	2	500	0	519
3525	7	511	1	19	0	538
3526	6	16	1	542	0	565
3527	2	11	528	20	0	561
3528	513	2	19	11	0	545
3529	23	2	7	544	0	576
3530	9	2	535	21	0	567
3531	507	0	19	10	0	536
3532	21	1	9	532	0	563
3533	16	1	1	543	0	561
3534	514	0	2	30	0	546
3535	22	516	3	9	0	550
3536	517	19	1	6	0	543
3537	20	8	1	515	0	544
3538	517	1	1	25	0	544
3539	21	1	497	10	0	529
3540	11	487	17	3	0	518
3541	3	18	8	498	0	527
3542	481	10	3	22	0	516
3543	24	484	3	9	0	520
3544	12	23	0	480	0	515
3545	483	8	1	25	0	517
3546	482	1	1	12	0	496
3547	30	5	1	456	0	492
3548	11	1	444	25	0	481
3549	6	1	455	13	0	475
3550	439	3	25	3	0	470
3551	23	423	11	7	0	464
3552	9	441	6	4	0	460
3553	419	28	3	4	0	454
3554	21	433	2	5	0	461
3555	9	23	1	446	0	479
3556	7	11	3	463	0	484
3557	449	4	1	34	0	488
3558	459	3	1	14	0	477
3559	462	4	0	10	0	476
3560	32	4	433	4	0	473
3561	18	2	24	435	0	479
3562	8	3	437	24	0	472
3563	5	1	441	17	0	464
3564	4	2	465	6	0	477
3565	10	2	32	435	0	479
3566	4	4	456	27	0	491
3567	8	2	465	12	0	487
3568	9	4	31	442	0	486
3569	449	5	12	30	0	496
3570	26	1	458	11	0	496
3571	17	2	26	453	0	498
3572	8	0	11	473	0	492
3573	5	1	459	33	0	498
3574	8	6	26	459	0	499
3575	7	3	471	25	0	506
3576	8	6	21	461	0	496
3577	6	4	11	471	0	492
3578	6	3	5	474	0	488
3579	11	2	5	478	0	496
3580	442	1	3	40	0	486
3581	448	0	4	19	0	471
3582	30	3	430	8	0	471
3583	12	422	24	9	0	467
3584	10	17	443	6	0	476
3585	6	11	450	4	0	471
3586	432	6	31	8	0	477
3587	23	438	16	8	0	485
3588	446	23	11	7	0	487
3589	27	447	8	6	0	488
3590	448	22	6	10	0	486
3591	460	10	6	9	0	485
3592	38	2	7	427	0	474
3593	14	426	5	27	0	472
3594	7	22	5	447	0	481
3595	8	11	7	454	0	480
3596	8	2	434	33	0	477
3597	6	426	29	13	0	474
3598	8	23	12	439	0	482
3599	417	9	7	36	0	469
3600	446	5	8	17	0	476
3601	457	5	7	9	0	478
3602	37	430	2	10	0	479
3603	450	21	3	7	0	481
3604	28	461	7	7	0	503
3605	20	25	2	450	0	497
3606	10	11	449	25	0	495
3607	11	4	25	452	0	492
3608	7	444	15	26	0	492
3609	5	24	8	460	0	497
3610	17	12	6	453	0	488
3611	10	450	3	30	0	493
3612	456	28	1	15	0	500
3613	32	14	4	452	0	502
3614	15	6	436	29	0	486
3615	14	5	23	445	0	487
3616	11	4	13	469	0	497
3617	7	5	442	39	0	493
3618	9	2	30	427	0	468
3619	7	434	11	23	0	475
3620	6	25	424	19	0	474
3621	6	8	410	6	0	430
3622	4	360	32	6	0	402
3623	5	302	6	5	0	318
3624	5	221	2	1	0	229
3625	190	9	10	2	0	211
3626	170	19	2	3	0	194
3627	185	2	2	3	0	192
3628	9	2	1	184	0	196
3629	2	2	182	10	0	196
3630	2	1	9	181	0	193
3631	0	2	1	193	0	196
3632	184	2	1	10	0	197
3633	184	0	1	4	0	189
3634	9	182	2	3	0	196
3635	182	9	1	2	0	194
3636	188	1	1	4	0	194
3637	193	1	3	1	0	198
3638	10	0	180	2	0	192
3639	2	3	185	2	0	192
3640	5	0	8	182	0	195
3641	2	1	193	6	0	202
3642	183	2	6	1	0	192
3643	193	0	1	2	0	196
3644	7	0	192	0	0	199
3645	185	0	5	3	0	193
3646	7	191	2	0	0	200
3647	191	5	2	2	0	200
3648	6	1	0	189	0	196
3649	1	1	2	187	0	191
3650	2	188	0	7	0	197
3651	191	5	0	3	0	199
3652	194	1	2	0	0	197
3653	6	191	0	0	0	197
3654	2	6	0	180	0	188
3655	3	1	0	183	0	187
3656	1	179	0	7	0	187
3657	2	5	0	182	0	189
3658	1	2	1	188	0	192
3659	176	1	1	6	0	184
3660	182	0	0	6	0	188
3661	6	2	177	1	0	186
3662	179	0	5	2	0	186
3663	7	0	177	1	0	185
3664	1	1	7	170	0	179
3665	2	0	172	6	0	180
3666	0	172	5	2	0	179
3667	2	5	1	166	0	174
3668	1	1	2	169	0	173
3669	163	0	2	8	0	173
3670	6	1	0	162	0	169
3671	1	0	153	7	0	161
3672	155	0	5	3	0	163
3673	161	0	2	1	0	164
3674	164	1	1	0	0	166
3675	158	0	0	3	0	161
3676	9	0	1	158	0	168
3677	3	0	0	167	0	170
3678	1	0	0	171	0	172
3679	1	0	2	171	0	174
3680	162	0	0	10	0	172
3681	168	0	0	2	0	170
3682	9	0	1	152	0	162
3683	3	150	1	5	0	159
3684	151	8	0	2	0	161
3685	7	1	150	2	0	160
3686	1	155	5	1	0	162
3687	143	6	1	1	0	151
3688	9	140	1	0	0	150
3689	3	7	141	0	0	151
3690	140	1	6	1	0	148
3691	148	2	1	1	0	152
3692	10	0	139	1	0	150
3693	3	0	7	143	0	153
3694	2	1	1	140	0	144
3695	2	136	1	6	0	145
3696	2	9	0	138	0	149
3697	133	1	1	7	0	142
3698	8	131	0	1	0	140
3699	5	6	0	121	0	132
3700	1	0	2	128	0	131
3701	1	0	123	5	0	129
3702	0	118	4	1	0	123
3703	111	5	1	1	0	118
3704	4	76	1	2	0	83
3705	1	77	0	1	0	79
3706	74	5	0	2	0	81
3707	5	0	0	77	0	82
3708	1	0	0	83	0	84
3709	75	1	1	4	0	81
3710	5	1	0	75	0	81
3711	3	0	1	80	0	84
3712	81	1	0	4	0	86
3713	6	1	0	78	0	85
3714	1	78	0	4	0	83
3715	79	4	1	1	0	85
3716	6	0	75	2	0	83
3717	3	69	5	2	0	79
3718	2	4	1	70	0	77
3719	1	0	68	7	0	76
3720	1	2	67	2	0	72
3721	5	4	2	55	0	66
3722	58	0	0	4	0	62
3723	3	2	1	58	0	64
3724	2	1	1	60	0	64
3725	0	2	1	65	0	68
3726	2	1	1	66	0	70
3727	1	0	2	67	0	70
3728	1	2	60	3	0	66
3729	4	0	61	1	0	66
3730	2	1	2	60	0	65
3731	1	2	59	4	0	66
3732	2	61	4	0	0	67
3733	1	2	2	65	0	70
3734	1	1	61	5	0	68
3735	56	1	2	3	0	62
3736	2	61	0	4	0	67
3737	1	59	1	3	0	64
3738	2	57	2	1	0	62
3739	3	3	0	61	0	67
3740	59	3	1	3	0	66
3741	4	2	1	59	0	66
3742	55	2	1	6	0	64
3743	4	54	1	1	0	60
3744	54	4	0	3	0	61
3745	4	1	1	54	0	60
3746	3	2	1	56	0	62
3747	0	53	0	6	0	59
3748	3	2	0	55	0	60
3749	1	0	0	56	0	57
3750	0	1	0	59	0	60
3751	51	2	0	4	0	57
3752	53	0	0	2	0	55
3753	2	1	52	4	0	59
3754	52	2	3	1	0	58
3755	4	0	52	3	0	59
3756	1	1	3	52	0	57
3757	2	1	3	52	0	58
3758	2	1	1	55	0	59
3759	1	1	54	4	0	60
3760	1	0	4	55	0	60
3761	1	0	53	6	0	60
3762	2	2	3	52	0	59
3763	52	1	1	4	0	58
3764	3	1	53	3	0	60
3765	49	1	4	3	0	57
3766	4	0	1	52	0	57
3767	50	0	1	6	0	57
3768	3	48	4	1	0	56
3769	1	4	1	48	0	54
3770	2	0	56	5	0	63
3771	1	0	4	53	0	58
3772	2	2	0	56	0	60
3773	0	55	1	4	0	60
3774	0	2	53	2	0	57
3775	1	52	1	4	0	58
3776	45	0	2	2	0	49
3777	0	47	0	0	0	47
3778	45	0	2	0	0	47
3779	47	1	0	0	0	48
3780	48	0	0	0	0	48
3781	1	1	0	47	0	49
3782	1	0	48	0	0	49
3783	1	0	0	44	0	45
3784	1	46	0	0	0	47
3785	1	0	0	47	0	48
3786	46	0	1	0	0	47
3787	0	46	0	0	0	46
3788	0	1	0	46	0	47
3789	0	0	0	44	0	44
3790	48	0	0	0	0	48
3791	0	1	47	0	0	48
3792	1	45	0	1	0	47
3793	0	0	0	43	0	43
3794	1	0	43	0	0	44
3795	0	0	1	39	0	40
3796	0	43	0	0	0	43
3797	0	0	0	44	0	44
3798	1	0	1	42	0	44
3799	0	0	0	43	0	43
3800	0	1	44	0	0	45
3801	44	0	0	2	0	46
3802	0	0	0	47	0	47
3803	49	0	0	1	0	50
3804	50	0	1	0	0	51
3805	51	0	0	0	0	51
3806	49	0	0	1	0	50
3807	50	0	0	0	0	50
3808	1	0	0	48	0	49
3809	1	50	0	0	0	51
3810	1	0	0	48	0	49
3811	1	50	0	0	0	51
3812	0	0	0	47	0	47
3813	46	0	0	0	0	46
3814	0	0	0	46	0	46
3815	0	0	45	0	0	45
3816	46	0	0	0	0	46
3817	0	46	0	0	0	46
3818	47	0	0	0	0	47
3819	44	0	0	1	0	45
3820	45	0	0	0	0	45
3821	0	47	0	0	0	47
3822	0	0	0	46	0	46
3823	0	0	0	46	0	46
3824	0	0	45	0	0	45
3825	0	1	0	44	0	45
3826	0	0	0	39	0	39
3827	0	0	0	40	0	40
3828	0	42	0	0	0	42
3829	43	0	0	0	0	43
3830	39	0	0	0	0	39
3831	0	0	43	0	0	43
3832	0	44	0	0	0	44
3833	0	0	0	40	0	40
3834	0	0	0	44	0	44
3835	0	0	0	43	0	43
3836	0	0	0	42	0	42
3837	0	0	0	39	0	39
3838	1	0	38	0	0	39
3839	0	0	38	0	0	38
3840	41	0	0	0	0	41
3841	41	0	0	1	0	42
3842	42	0	0	0	0	42
3843	0	0	0	40	0	40
3844	0	0	42	0	0	42
3845	40	0	0	0	0	40
3846	41	0	0	0	0	41
3847	0	0	39	0	0	39
3848	39	0	0	0	0	39
3849	0	0	47	0	0	47
3850	0	0	0	47	0	47
3851	0	0	50	0	0	50
3852	47	0	0	0	0	47
3853	48	0	0	0	0	48
3854	49	0	0	0	0	49
3855	51	0	0	1	0	52
3856	0	0	54	0	0	54
3857	0	55	0	0	0	55
3858	56	0	0	0	0	56
3859	56	0	1	0	0	57
3860	0	0	61	0	0	61
3861	0	0	0	59	0	59
3862	0	0	0	59	0	59
3863	0	0	60	1	0	61
3864	55	0	0	2	0	57
3865	58	0	0	2	0	60
3866	0	60	1	0	0	61
3867	61	0	0	1	0	62
3868	64	0	0	0	0	64
3869	61	0	0	0	0	61
3870	63	0	0	0	0	63
3871	0	0	59	1	0	60
3872	58	0	1	0	0	59
3873	2	0	0	58	0	60
3874	1	62	0	0	0	63
3875	0	0	57	0	0	57
3876	1	63	1	0	0	65
3877	1	0	1	60	0	62
3878	0	0	56	1	0	57
3879	52	0	1	0	0	53
3880	1	0	55	0	0	56
3881	53	0	0	0	0	53
3882	1	0	0	54	0	55
3883	1	0	0	53	0	54
3884	0	53	1	0	0	54
3885	0	58	0	0	0	58
3886	2	0	0	57	0	59
3887	61	0	0	0	0	61
3888	55	0	1	0	0	56
3889	58	0	0	1	0	59
3890	0	0	60	0	0	60
3891	59	0	0	1	0	60
3892	1	0	59	0	0	60
3893	1	0	59	0	0	60
3894	61	1	0	0	0	62
3895	61	0	0	0	0	61
3896	1	0	61	0	0	62
3897	1	0	0	57	0	58
3898	2	0	0	58	0	60
3899	60	0	0	0	0	60
3900	56	0	0	1	0	57
3901	0	0	66	1	0	67
3902	0	69	1	0	0	70
3903	0	73	0	0	0	73
3904	71	1	0	0	0	72
3905	0	0	0	71	0	71
3906	0	0	1	72	0	73
3907	2	0	0	69	0	71
3908	70	0	1	0	0	71
3909	1	0	0	70	0	71
3910	69	0	0	1	0	70
3911	66	0	0	2	0	68
3912	0	79	0	0	0	79
3913	0	1	0	79	0	80
3914	0	0	87	1	0	88
3915	82	0	0	1	0	83
3916	84	0	0	0	0	84
3917	82	0	0	1	0	83
3918	0	0	87	0	0	87
3919	1	0	0	79	0	80
3920	84	0	1	1	0	86
3921	80	0	0	0	0	80
3922	80	0	0	0	0	80
3923	1	79	0	0	0	80
3924	0	87	0	0	0	87
3925	0	0	0	91	0	91
3926	1	0	0	87	0	88
3927	1	89	0	0	0	90
3928	88	0	0	2	0	90
3929	1	0	88	0	0	89
3930	0	0	0	89	0	89
3931	0	0	0	92	0	92
3932	0	0	92	0	0	92
3933	84	1	0	1	0	86
3934	89	0	0	2	0	91
3935	0	86	0	0	0	86
3936	87	0	0	2	0	89
3937	1	0	94	0	0	95
3938	91	0	1	0	0	92
3939	1	0	93	0	0	94
3940	90	0	0	3	0	93
3941	95	1	0	1	0	97
3942	95	0	1	1	0	97
3943	95	1	1	0	0	97
3944	1	93	0	1	0	95
3945	97	0	1	1	0	99
3946	103	0	0	1	0	104
3947	0	0	107	0	0	107
3948	98	0	0	2	0	100
3949	1	0	0	106	0	107
3950	1	0	105	1	0	107
3951	103	1	0	1	0	105
3952	0	1	0	107	0	108
3953	110	1	0	1	0	112
3954	118	0	0	4	0	122
3955	1	1	128	1	0	131
3956	128	1	0	0	0	129
3957	134	0	1	1	0	136
3958	134	0	1	0	0	135
3959	133	0	1	1	0	135
3960	0	0	1	130	0	131
3961	1	129	1	0	0	131
3962	133	0	0	3	0	136
3963	129	1	1	0	0	131
3964	130	1	0	1	0	132
3965	2	0	125	1	0	128
3966	0	133	1	0	0	134
3967	1	0	1	130	0	132
3968	0	1	1	134	0	136
3969	1	0	133	1	0	135
3970	1	0	1	132	0	134
3971	1	0	130	1	0	132
3972	1	0	1	128	0	130
3973	1	1	1	131	0	134
3974	0	0	134	2	0	136
3975	127	0	1	4	0	132
3976	132	0	2	3	0	137
3977	3	0	138	0	0	141
3978	131	0	1	0	0	132
3979	138	0	2	2	0	142
3980	4	0	146	0	0	150
3981	4	1	1	143	0	149
3982	4	0	1	145	0	150
3983	145	0	2	3	0	150
3984	1	152	1	3	0	157
3985	147	1	0	3	0	151
3986	151	1	0	0	0	152
3987	2	163	0	0	0	165
3988	163	1	0	2	0	166
3989	154	1	0	4	0	159
3990	2	164	0	0	0	166
3991	3	1	0	160	0	164
3992	3	162	0	1	0	166
3993	2	3	0	161	0	166
3994	1	1	162	2	0	166
3995	1	3	154	0	0	158
3996	160	0	2	6	0	168
3997	163	0	2	1	0	166
3998	2	0	167	0	0	169
3999	173	0	1	1	0	175
4000	171	0	2	2	0	175
4001	167	0	2	4	0	173
4002	4	173	0	0	0	177
4003	3	1	1	177	0	182
4004	178	1	0	1	0	180
4005	169	2	0	1	0	172
4006	2	1	180	2	0	185
4007	4	0	2	167	0	173
4008	3	0	1	177	0	181
4009	0	175	3	2	0	180
4010	0	186	0	4	0	190
4011	1	3	0	180	0	184
4012	0	187	0	1	0	188
4013	177	4	0	5	0	186
4014	2	191	1	2	0	196
4015	191	4	0	3	0	198
4016	4	1	189	0	0	194
4017	192	2	3	0	0	197
4018	201	0	2	0	0	203
4019	197	0	2	2	0	201
4020	195	0	1	3	0	199
4021	8	191	0	1	0	200
4022	4	3	1	197	0	205
4023	2	2	0	195	0	199
4024	0	3	190	7	0	200
4025	2	0	3	185	0	190
4026	1	0	4	196	0	201
4027	189	0	2	11	0	202
4028	3	194	2	5	0	204
4029	3	3	1	199	0	206
4030	5	3	0	200	0	208
4031	2	2	1	200	0	205
4032	194	0	1	11	0	206
4033	4	0	0	203	0	207
4034	202	0	0	5	0	207
4035	5	1	1	202	0	209
4036	4	0	0	204	0	208
4037	3	0	190	7	0	200
4038	174	1	3	7	0	185
4039	4	192	3	2	0	201
4040	203	3	2	3	0	211
4041	6	4	0	196	0	206
4042	2	2	0	203	0	207
4043	206	0	0	6	0	212
4044	203	0	0	6	0	209
4045	6	1	1	201	0	209
4046	5	0	210	3	0	218
4047	3	1	196	3	0	203
4048	1	210	7	3	0	221
4049	210	5	8	2	0	225
4050	214	3	3	1	0	221
4051	9	3	0	214	0	226
4052	8	213	0	3	0	224
4053	3	5	1	218	0	227
4054	3	3	0	207	0	213
4055	2	192	1	7	0	202
4056	192	5	0	8	0	205
4057	5	3	1	193	0	202
4058	4	209	0	5	0	218
4059	4	218	0	5	0	227
4060	210	8	0	6	0	224
4061	4	4	209	0	0	217
4062	213	3	3	2	0	221
4063	7	2	2	216	0	227
4064	4	0	3	213	0	220
4065	3	221	0	7	0	231
4066	2	5	0	216	0	223
4067	1	4	219	6	0	230
4068	3	212	4	1	0	220
4069	1	217	3	3	0	224
4070	209	6	1	1	0	217
4071	3	218	0	1	0	222
4072	2	4	0	215	0	221
4073	1	218	0	3	0	222
4074	0	4	0	220	0	224
4075	0	2	1	223	0	226
4076	0	1	209	5	0	215
4077	1	1	3	206	0	211
4078	3	0	2	211	0	216
4079	202	1	1	7	0	211
4080	4	1	202	4	0	211
4081	4	1	3	204	0	212
4082	1	1	212	5	0	219
4083	200	1	4	5	0	210
4084	3	208	5	2	0	218
4085	226	3	1	5	0	235
4086	5	2	0	237	0	244
4087	5	1	0	234	0	240
4088	1	1	237	6	0	245
4089	217	1	3	5	0	226
4090	3	236	3	2	0	244
4091	233	3	1	3	0	240
4092	5	3	1	235	0	244
4093	3	245	0	4	0	252
4094	247	3	0	4	0	254
4095	4	252	0	3	0	259
4096	2	4	1	255	0	262
4097	2	2	0	258	0	262
4098	2	4	0	258	0	264
4099	3	259	0	5	0	267
4100	3	2	0	258	0	263
4101	1	4	1	258	0	264
4102	247	0	0	12	0	259
4103	256	1	0	8	0	265
4104	256	0	0	9	0	265
4105	5	0	270	5	0	280
4106	264	0	3	4	0	271
4107	270	3	3	2	0	278
4108	274	2	1	3	0	280
4109	7	0	260	3	0	270
4110	252	0	1	6	0	259
4111	7	0	2	260	0	269
4112	3	1	267	3	0	274
4113	4	260	4	2	0	270
4114	4	4	2	254	0	264
4115	3	260	2	2	0	267
4116	2	268	2	0	0	272
4117	253	2	1	6	0	262
4118	5	2	0	261	0	268
4119	254	1	0	7	0	262
4120	3	0	2	256	0	261
4121	253	1	1	4	0	259
4122	3	1	0	256	0	260
4123	252	2	0	4	0	258
4124	4	3	239	0	0	246
4125	4	0	1	253	0	258
4126	1	2	254	3	0	260
4127	5	1	236	0	0	242
4128	0	2	252	3	0	257
4129	3	1	2	250	0	256
4130	1	0	254	3	0	258
4131	259	0	2	1	0	262
4132	3	0	2	264	0	269
4133	1	0	296	3	0	300
4134	3	0	3	286	0	292
4135	1	0	2	289	0	292
4136	0	0	338	1	0	339
4137	1	0	1	329	0	331
4138	0	1	3	329	0	333
4139	3	350	1	1	0	355
4140	346	1	0	8	0	355
4141	349	0	2	1	0	352
4142	1	2	345	2	0	350
4143	336	0	1	3	0	340
4144	2	1	335	1	0	339
4145	0	0	321	2	0	323
4146	1	2	327	1	0	331
4147	0	3	0	324	0	327
4148	2	1	338	0	0	341
4149	2	1	0	331	0	334
4150	2	0	1	341	0	344
4151	1	0	0	339	0	340
4152	2	0	1	343	0	346
4153	336	0	1	6	0	343
4154	339	0	1	1	0	341
4155	1	341	0	2	0	344
4156	1	1	1	344	0	347
4157	0	0	338	2	0	340
4158	0	346	2	2	0	350
4159	0	2	1	348	0	351
4160	0	0	350	3	0	353
4161	2	1	3	327	0	333
4162	1	0	336	2	0	339
4163	0	1	323	0	0	324
4164	1	0	2	337	0	340
4165	2	0	0	341	0	343
4166	340	1	0	3	0	344
4167	4	1	0	336	0	341
4168	338	0	1	5	0	344
4169	0	329	1	1	0	331
4170	0	337	1	1	0	339
4171	1	2	0	341	0	344
4172	337	1	0	7	0	345
4173	5	344	1	1	0	351
4174	3	4	0	351	0	358
4175	359	0	0	6	0	365
4176	368	0	0	1	0	369
4177	358	0	0	5	0	363
4178	355	1	1	4	0	361
4179	361	0	1	2	0	364
4180	5	0	345	1	0	351
4181	1	1	342	0	0	344
4182	0	344	5	0	0	349
4183	2	6	1	342	0	351
4184	1	1	334	5	0	341
4185	1	0	334	2	0	337
4186	3	0	5	314	0	322
4187	1	1	337	3	0	342
4188	0	2	329	2	0	333
4189	0	404	5	1	0	410
4190	410	6	1	4	0	421
4191	7	440	2	1	0	450
4192	7	8	0	434	0	449
4193	442	3	0	13	0	458
4194	11	457	1	2	0	471
4195	4	10	0	453	0	467
4196	2	3	442	10	0	457
4197	444	1	11	3	0	459
4198	460	0	2	1	0	463
4199	456	1	1	1	0	459
4200	16	0	1	447	0	464
4201	3	0	443	12	0	458
4202	2	438	11	2	0	453
4203	1	13	2	450	0	466
4204	448	2	3	12	0	465
4205	14	3	433	3	0	453
4206	2	429	13	3	0	447
4207	3	11	431	0	0	445
4208	430	4	15	1	0	450
4209	452	4	2	3	0	461
4210	461	0	4	2	0	467
4211	16	3	430	1	0	450
4212	4	420	14	2	0	440
4213	6	11	3	425	0	445
4214	6	3	2	436	0	447
4215	4	2	0	435	0	441
4216	2	0	421	17	0	440
4217	415	1	11	6	0	433
4218	16	0	432	2	0	450
4219	432	1	16	2	0	451
4220	443	1	3	3	0	450
4221	452	1	4	1	0	458
4222	455	1	0	2	0	458
4223	16	1	427	2	0	446
4224	7	0	12	427	0	446
4225	4	0	440	15	0	459
4226	2	421	13	2	0	438
4227	1	453	5	2	0	461
4228	436	16	3	1	0	456
4229	431	5	0	3	0	439
4230	15	438	6	1	0	460
4231	445	12	3	2	0	462
4232	16	7	389	3	0	415
4233	414	5	11	3	0	433
4234	18	432	3	3	0	456
4235	440	17	4	3	0	464
4236	432	3	2	4	0	441
4237	23	4	3	414	0	444
4238	12	3	2	422	0	439
4239	412	3	2	21	0	438
4240	23	0	4	406	0	433
4241	418	4	1	18	0	441
4242	28	1	3	410	0	442
4243	415	1	4	21	0	441
4244	414	2	3	4	0	423
4245	17	389	5	8	0	419
4246	7	413	4	1	0	425
4247	396	18	1	7	0	422
4248	23	397	4	0	0	424
4249	10	19	4	388	0	421
4250	10	8	2	404	0	424
4251	378	5	6	19	0	408
4252	20	384	2	7	0	413
4253	9	383	0	8	0	400
4254	9	387	3	3	0	402
4255	3	24	378	4	0	409
4256	3	10	378	4	0	395
4257	4	9	391	5	0	409
4258	5	4	21	336	0	366
4259	9	359	6	17	0	391
4260	364	17	9	6	0	396
4261	22	6	360	7	0	395
4262	7	6	370	3	0	386
4263	14	1	378	4	0	397
4264	11	2	19	355	0	387
4265	12	1	8	372	0	393
4266	9	2	12	371	0	394
4267	362	6	5	24	0	397
4268	368	3	7	12	0	390
4269	369	1	4	13	0	387
4270	29	3	2	346	0	380
4271	9	4	338	15	0	366
4272	12	2	347	4	0	365
4273	8	4	19	343	0	374
4274	12	4	9	343	0	368
4275	337	0	7	18	0	362
4276	21	326	4	8	0	359
4277	335	17	4	5	0	361
4278	22	326	3	5	0	356
4279	12	15	5	325	0	357
4280	9	2	327	18	0	356
4281	6	7	16	330	0	359
4282	324	3	4	25	0	356
4283	21	2	330	7	0	360
4284	323	1	15	8	0	347
4285	23	2	322	3	0	350
4286	11	2	324	3	0	340
4287	299	1	14	2	0	316
4288	16	1	313	2	0	332
4289	4	0	221	3	0	228
4290	8	228	13	2	0	251
4291	192	8	8	3	0	211
4292	192	1	3	2	0	198
4293	194	2	1	2	0	199
4294	9	1	179	1	0	190
4295	177	0	6	0	0	183
4296	8	183	1	1	0	193
4297	179	5	2	2	0	188
4298	7	1	181	0	0	189
4299	1	2	5	174	0	182
4300	2	0	178	5	0	185
4301	0	176	7	1	0	184
4302	2	3	1	170	0	176
4303	0	1	2	177	0	180
4304	178	1	1	8	0	188
4305	182	0	0	4	0	186
4306	186	0	1	1	0	188
4307	181	0	1	0	0	182
4308	179	1	0	2	0	182
4309	7	0	174	0	0	181
4310	4	0	4	165	0	173
4311	2	0	183	4	0	189
4312	1	0	5	181	0	187
4313	182	0	1	5	0	188
4314	185	0	2	3	0	190
4315	188	0	0	2	0	190
4316	189	0	1	0	0	190
4317	8	1	186	0	0	195
4318	3	0	6	189	0	198
4319	1	1	196	5	0	203
4320	1	198	6	2	0	207
4321	0	202	2	2	0	206
4322	1	5	1	204	0	211
4323	1	1	1	221	0	224
4324	1	2	0	224	0	227
4325	2	2	0	228	0	232
4326	223	0	0	9	0	232
4327	5	225	1	3	0	234
4328	223	6	0	3	0	232
4329	7	1	1	215	0	224
4330	3	1	0	216	0	220
4331	2	217	1	7	0	227
4332	3	6	0	211	0	220
4333	215	1	0	6	0	222
4334	5	201	0	2	0	208
4335	1	201	0	1	0	203
4336	202	5	0	3	0	210
4337	7	1	1	195	0	204
4338	1	197	0	4	0	202
4339	0	6	0	203	0	209
4340	201	1	0	5	0	207
4341	4	0	0	203	0	207
4342	2	1	0	202	0	205
4343	192	0	0	8	0	200
4344	6	0	0	196	0	202
4345	1	196	0	5	0	202
4346	1	4	0	195	0	200
4347	0	191	1	4	0	196
4348	0	4	0	195	0	199
4349	186	3	0	5	0	194
4350	189	0	0	2	0	191
4351	5	1	0	185	0	191
4352	1	1	178	5	0	185
4353	175	1	3	2	0	181
4354	5	0	174	0	0	179
4355	177	0	4	1	0	182
4356	169	1	2	1	0	173
4357	4	0	170	1	0	175
4358	2	168	4	0	0	174
4359	168	3	1	2	0	174
4360	171	1	0	1	0	173
4361	5	0	177	0	0	182
4362	176	3	3	1	0	183
4363	181	0	1	0	0	182
4364	188	0	0	0	0	188
4365	4	0	1	180	0	185
4366	3	0	0	183	0	186
4367	1	180	1	4	0	186
4368	0	3	0	179	0	182
4369	1	0	0	186	0	187
4370	0	0	182	4	0	186
4371	0	1	169	2	0	172
4372	168	0	3	4	0	175
4373	179	0	0	3	0	182
4374	4	175	1	0	0	180
4375	3	4	1	176	0	184
4376	2	0	185	4	0	191
4377	1	0	3	183	0	187
4378	0	2	0	187	0	189
4379	1	1	0	192	0	194
4380	1	187	1	4	0	193
4381	1	3	0	198	0	202
4382	1	3	0	200	0	204
4383	0	1	196	5	0	202
4384	1	1	193	2	0	197
4385	180	1	4	1	0	186
4386	194	1	1	4	0	200
4387	7	0	1	211	0	219
4388	2	0	1	205	0	208
4389	2	0	0	211	0	213
4390	1	0	191	7	0	199
4391	1	197	4	4	0	206
4392	0	5	194	1	0	200
4393	191	3	4	3	0	201
4394	4	0	201	1	0	206
4395	197	2	4	1	0	204
4396	203	0	3	2	0	208
4397	210	0	0	1	0	211
4398	7	0	1	197	0	205
4399	3	0	193	4	0	200
4400	2	192	5	3	0	202
4401	4	5	3	191	0	203
4402	2	2	1	202	0	207
4403	2	0	200	6	0	208
4404	1	188	6	2	0	197
4405	193	6	3	1	0	203
4406	7	199	0	1	0	207
4407	220	5	2	1	0	228
4408	7	4	1	219	0	231
4409	4	2	226	5	0	237
4410	1	228	5	3	0	237
4411	227	5	2	1	0	235
4412	6	2	225	3	0	236
4413	224	1	7	2	0	234
4414	228	2	2	1	0	233
4415	8	1	227	1	0	237
4416	227	0	5	2	0	234
4417	226	0	3	2	0	231
4418	226	0	3	1	0	230
4419	7	217	2	0	0	226
4420	210	4	0	2	0	216
4421	7	212	1	0	0	220
4422	3	6	209	1	0	219
4423	1	212	3	1	0	217
4424	201	4	4	2	0	211
4425	204	2	2	1	0	209
4426	200	2	1	0	0	203
4427	7	2	1	192	0	202
4428	5	0	0	206	0	211
4429	198	0	1	5	0	204
4430	201	0	2	4	0	207
4431	5	2	0	197	0	204
4432	4	0	193	4	0	201
4433	1	179	3	3	0	186
4434	2	199	3	1	0	205
4435	2	5	1	192	0	200
4436	0	2	195	4	0	201
4437	0	4	3	178	0	185
4438	1	186	3	3	0	193
4439	0	4	1	192	0	197
4440	2	1	189	4	0	196
4441	2	1	1	193	0	197
4442	1	1	204	4	0	210
4443	2	0	4	202	0	208
4444	1	0	220	4	0	225
4445	0	1	215	3	0	219
4446	215	1	6	3	0	225
4447	209	0	4	4	0	217
4448	224	1	2	0	0	227
4449	7	217	2	0	0	226
4450	5	4	1	219	0	229
4451	214	2	0	4	0	220
4452	223	1	0	3	0	227
4453	222	1	0	1	0	224
4454	6	1	216	2	0	225
4455	5	203	3	3	0	214
4456	3	216	3	0	0	222
4457	217	5	2	1	0	225
4458	3	4	1	219	0	227
4459	222	1	1	2	0	226
4460	3	2	217	2	0	224
4461	5	2	1	213	0	221
4462	1	0	2	223	0	226
4463	2	0	2	214	0	218
4464	1	216	1	5	0	223
4465	214	3	0	6	0	223
4466	213	3	0	4	0	220
4467	5	216	2	0	0	223
4468	4	5	0	214	0	223
4469	213	4	2	4	0	223
4470	4	2	0	214	0	220
4471	210	1	2	5	0	218
4472	4	211	2	4	0	221
4473	214	3	0	4	0	221
4474	3	2	207	3	0	215
4475	4	208	4	0	0	216
4476	3	4	204	1	0	212
4477	2	4	6	200	0	212
4478	200	0	3	3	0	206
4479	199	3	2	1	0	205
4480	197	1	2	2	0	202
4481	7	0	1	189	0	197
4482	195	1	2	3	0	201
4483	5	3	1	188	0	197
4484	183	1	0	3	0	187
4485	187	0	0	5	0	192
4486	7	0	193	0	0	200
4487	0	1	162	4	0	167
4488	2	0	162	2	0	166
4489	3	0	3	161	0	167
4490	161	0	4	4	0	169
4491	1	1	3	165	0	170
4492	5	0	2	164	0	171
4493	178	1	0	2	0	181
4494	175	2	0	1	0	178
4495	175	1	0	3	0	179
4496	173	0	1	3	0	177
4497	3	0	0	174	0	177
4498	176	1	0	1	0	178
4499	3	180	0	1	0	184
4500	173	1	2	2	0	178
4501	173	1	0	2	0	176
4502	1	2	165	0	0	168
4503	164	0	0	1	0	165
4504	1	1	159	1	0	162
4505	1	0	135	1	0	137
4506	0	0	135	0	0	135
4507	0	1	1	116	0	118
4508	0	2	109	1	0	112
4509	1	1	0	99	0	101
4510	0	1	100	1	0	102
4511	0	0	111	0	0	111
4512	0	0	1	113	0	114
4513	1	0	0	114	0	115
4514	0	0	125	0	0	125
4515	119	0	0	2	0	121
4516	0	0	0	125	0	125
4517	0	0	0	129	0	129
4518	129	0	0	0	0	129
4519	0	0	0	130	0	130
4520	0	0	131	1	0	132
4521	0	0	122	0	0	122
4522	0	0	1	129	0	130
4523	0	0	135	1	0	136
4524	0	138	1	0	0	139
4525	1	1	0	140	0	142
4526	136	0	0	3	0	139
4527	1	0	136	0	0	137
4528	134	0	1	0	0	135
4529	1	0	0	139	0	140
4530	0	0	0	142	0	142
4531	1	0	0	143	0	144
4532	0	0	0	143	0	143
4533	140	0	0	2	0	142
4534	1	150	0	0	0	151
4535	1	2	0	149	0	152
4536	0	0	0	152	0	152
4537	0	0	0	153	0	153
4538	1	0	0	150	0	151
4539	148	0	0	4	0	152
4540	2	149	1	0	0	152
4541	148	2	0	2	0	152
4542	2	148	0	0	0	150
4543	0	147	0	0	0	147
4544	142	2	0	0	0	144
4545	2	1	144	0	0	147
4546	0	0	2	139	0	141
4547	142	0	0	3	0	145
4548	139	0	0	0	0	139
4549	140	1	0	0	0	141
4550	144	0	0	0	0	144
4551	3	155	0	0	0	158
4552	153	3	0	0	0	156
4553	155	1	0	1	0	157
4554	4	162	0	0	0	166
4555	1	3	0	167	0	171
4556	0	2	164	4	0	170
4557	2	1	4	157	0	164
4558	162	0	1	5	0	168
4559	5	0	165	2	0	172
4560	2	157	5	0	0	164
4561	0	4	161	1	0	166
4562	2	1	5	147	0	155
4563	0	158	2	2	0	162
4564	159	4	0	3	0	166
4565	4	160	1	1	0	166
4566	1	5	0	156	0	162
4567	0	1	0	165	0	166
4568	157	0	0	6	0	163
4569	5	0	1	152	0	158
4570	2	155	0	4	0	161
4571	155	4	0	3	0	162
4572	160	1	0	3	0	164
4573	5	161	0	1	0	167
4574	156	4	0	3	0	163
4575	4	157	0	0	0	161
4576	154	5	0	2	0	161
4577	4	154	0	1	0	159
4578	1	4	0	149	0	154
4579	0	1	0	159	0	160
4580	152	0	0	6	0	158
4581	155	0	0	1	0	156
4582	5	155	0	0	0	160
4583	2	3	147	1	0	153
4584	148	2	5	0	0	155
4585	5	1	1	154	0	161
4586	3	151	0	3	0	157
4587	1	4	1	155	0	161
4588	155	1	0	6	0	162
4589	159	0	0	2	0	161
4590	162	1	0	0	0	163
4591	6	0	0	155	0	161
4592	3	0	155	4	0	162
4593	148	2	4	1	0	155
4594	154	0	1	1	0	156
4595	157	0	1	1	0	159
4596	5	154	1	1	0	161
4597	3	4	0	157	0	164
4598	0	157	1	4	0	162
4599	0	6	0	161	0	167
4600	1	3	1	161	0	166
4601	0	0	175	7	0	182
4602	1	2	6	180	0	189
4603	3	0	2	191	0	196
4604	183	1	0	8	0	192
4605	8	182	1	2	0	193
4606	179	9	0	2	0	190
4607	194	2	1	0	0	197
4608	9	0	0	189	0	198
4609	2	2	192	8	0	204
4610	3	183	8	1	0	195
4611	1	186	1	1	0	189
4612	171	11	0	4	0	186
4613	9	177	0	1	0	187
4614	2	9	0	178	0	189
4615	2	1	0	180	0	183
4616	0	2	174	9	0	185
4617	1	0	174	2	0	177
4618	1	169	8	1	0	179
4619	2	8	1	170	0	181
4620	173	1	0	7	0	181
4621	9	2	0	170	0	181
4622	2	2	173	7	0	184
4623	1	1	7	171	0	180
4624	165	0	1	8	0	174
4625	174	0	0	2	0	176
4626	9	169	1	0	0	179
4627	168	8	0	2	0	178
4628	6	172	1	0	0	179
4629	173	7	1	1	0	182
4630	10	2	0	165	0	177
4631	1	0	171	9	0	181
4632	0	1	161	2	0	164
4633	0	168	10	1	0	179
4634	2	6	3	158	0	169
4635	5	2	0	172	0	179
4636	170	0	0	10	0	180
4637	175	0	0	3	0	178
4638	174	2	1	3	0	180
4639	11	0	1	173	0	185
4640	5	0	0	183	0	188
4641	2	0	0	187	0	189
4642	2	0	180	7	0	189
4643	0	3	182	2	0	187
4644	175	2	6	0	0	183
4645	182	2	0	3	0	187
4646	8	2	173	1	0	184
4647	166	0	7	3	0	176
4648	170	0	2	5	0	177
4649	7	0	176	2	0	185
4650	2	169	7	0	0	178
4651	2	9	0	163	0	174
4652	1	0	164	8	0	173
4653	4	171	5	1	0	181
4654	1	8	0	159	0	168
4655	1	160	2	6	0	169
4656	0	8	156	3	0	167
4657	2	0	162	1	0	165
4658	2	2	8	152	0	164
4659	156	2	1	8	0	167
4660	11	0	1	156	0	168
4661	155	2	1	11	0	169
4662	12	2	1	154	0	169
4663	0	1	158	12	0	171
4664	154	1	12	0	0	167
4665	9	1	161	1	0	172
4666	151	3	11	3	0	168
4667	9	1	0	160	0	170
4668	2	159	0	12	0	173
4669	2	9	2	160	0	173
4670	4	159	2	6	0	171
4671	5	10	0	155	0	170
4672	0	160	2	12	0	174
4673	159	8	1	2	0	170
4674	168	0	1	5	0	174
4675	164	2	2	1	0	169
4676	11	0	154	3	0	168
4677	4	2	9	151	0	166
4678	4	1	159	10	0	174
4679	0	151	11	1	0	163
4680	4	161	1	0	0	166
4681	153	11	0	4	0	168
4682	11	0	157	1	0	169
4683	2	152	10	2	0	166
4684	2	9	2	156	0	169
4685	157	1	5	10	0	173
4686	7	159	0	3	0	169
4687	155	10	1	3	0	169
4688	10	3	157	3	0	173
4689	2	2	12	156	0	172
4690	4	1	3	168	0	176
4691	4	0	1	173	0	178
4692	5	166	0	9	0	180
4693	4	10	0	157	0	171
4694	5	1	164	10	0	180
4695	4	1	12	160	0	177
4696	5	1	4	170	0	180
4697	3	3	1	171	0	178
4698	2	161	2	9	0	174
4699	2	9	2	157	0	170
4700	3	2	0	167	0	172
4701	1	145	1	8	0	155
4702	127	6	1	3	0	137
4703	6	128	2	1	0	137
4704	0	130	1	3	0	134
4705	0	6	1	132	0	139
4706	1	1	127	7	0	136
4707	111	1	5	3	0	120
4708	8	1	0	118	0	127
4709	1	0	111	6	0	118
4710	0	113	5	0	0	118
4711	1	6	0	113	0	120
4712	0	1	112	7	0	120
4713	2	2	6	110	0	120
4714	4	0	0	112	0	116
4715	107	0	1	4	0	112
4716	6	107	1	0	0	114
4717	106	5	0	3	0	114
4718	4	0	108	1	0	113
4719	0	106	6	0	0	112
4720	1	5	108	2	0	116
4721	1	1	5	110	0	117
4722	108	0	2	7	0	117
4723	5	1	0	110	0	116
4724	112	0	0	4	0	116
4725	116	1	1	0	0	118
4726	7	1	0	112	0	120
4727	0	0	122	4	0	126
4728	0	1	129	1	0	131
4729	2	0	6	128	0	136
4730	3	0	0	135	0	138
4731	132	0	0	6	0	138
4732	6	1	0	130	0	137
4733	1	120	2	7	0	130
4734	2	4	1	127	0	134
4735	0	1	1	127	0	129
4736	118	0	0	9	0	127
4737	4	123	1	1	0	129
4738	2	5	0	123	0	130
4739	0	0	0	125	0	125
4740	1	121	1	5	0	128
4741	2	3	0	123	0	128
4742	2	1	0	124	0	127
4743	1	120	1	5	0	127
4744	2	6	0	121	0	129
4745	3	0	0	126	0	129
4746	0	123	2	6	0	131
4747	1	5	0	124	0	130
4748	122	0	0	8	0	130
4749	124	1	0	1	0	126
4750	125	2	0	1	0	128
4751	124	0	0	3	0	127
4752	4	121	1	1	0	127
4753	105	5	0	1	0	111
4754	2	104	1	2	0	109
4755	0	104	0	1	0	105
4756	0	0	0	107	0	107
4757	0	0	108	1	0	109
4758	104	0	0	0	0	104
4759	108	0	0	0	0	108
4760	0	1	116	0	0	117
4761	109	0	0	1	0	110
4762	116	0	0	0	0	116
4763	0	116	0	0	0	116
4764	134	0	0	0	0	134
4765	1	0	0	137	0	138
4766	1	0	0	138	0	139
4767	0	0	0	140	0	140
4768	0	0	0	139	0	139
4769	140	0	0	0	0	140
4770	0	0	0	135	0	135
4771	2	0	0	134	0	136
4772	0	0	134	0	0	134
4773	124	0	0	2	0	126
4774	131	0	0	0	0	131
4775	133	0	0	0	0	133
4776	0	127	0	0	0	127
4777	0	132	0	0	0	132
4778	134	1	0	0	0	135
4779	3	0	0	134	0	137
4780	0	137	0	2	0	139
4781	0	2	0	133	0	135
4782	0	135	0	2	0	137
4783	134	2	0	0	0	136
4784	3	136	0	0	0	139
4785	0	3	0	135	0	138
4786	0	0	0	134	0	134
4787	0	1	135	3	0	139
4788	0	138	4	0	0	142
4789	0	4	0	139	0	143
4790	0	0	137	4	0	141
4791	0	0	141	0	0	141
4792	1	1	4	139	0	145
4793	0	0	1	140	0	141
4794	0	137	0	4	0	141
4795	0	140	0	3	0	143
4796	0	6	1	136	0	143
4797	139	1	1	4	0	145
4798	4	1	0	142	0	147
4799	146	0	0	6	0	152
4800	149	1	0	3	0	153
4801	148	0	1	0	0	149
4802	5	1	146	1	0	153
4803	140	0	4	1	0	145
4804	5	0	1	146	0	152
4805	2	1	1	146	0	150
4806	1	0	147	6	0	154
4807	2	0	147	2	0	151
4808	0	1	7	141	0	149
4809	2	141	1	2	0	146
4810	1	148	0	5	0	154
4811	2	6	0	146	0	154
4812	144	2	2	5	0	153
4813	4	0	1	148	0	153
4814	3	0	0	143	0	146
4815	1	149	0	7	0	157
4816	1	5	2	148	0	156
4817	2	1	152	4	0	159
4818	2	1	140	3	0	146
4819	137	1	5	3	0	146
4820	4	142	2	0	0	148
4821	145	5	1	2	0	153
4822	146	1	0	2	0	149
4823	4	2	2	143	0	151
4824	1	146	2	3	0	152
4825	0	5	0	150	0	155
4826	138	2	0	5	0	145
4827	5	138	1	2	0	146
4828	133	4	1	2	0	140
4829	3	137	0	2	0	142
4830	133	6	1	2	0	142
4831	136	1	1	3	0	141
4832	7	135	1	1	0	144
4833	1	5	0	136	0	142
4834	137	3	1	6	0	147
4835	5	1	136	3	0	145
4836	7	0	129	0	0	136
4837	1	3	4	133	0	141
4838	136	2	1	4	0	143
4839	6	1	0	136	0	143
4840	134	0	0	5	0	139
4841	5	2	141	1	0	149
4842	145	1	4	1	0	151
4843	148	1	1	4	0	154
4844	6	1	0	148	0	155
4845	4	0	2	152	0	158
4846	2	2	2	149	0	155
4847	1	152	1	5	0	159
4848	4	4	0	151	0	159
4849	0	3	1	156	0	160
4850	149	0	1	8	0	158
4851	154	0	1	4	0	159
4852	7	0	148	2	0	157
4853	146	1	5	4	0	156
4854	5	0	149	2	0	156
4855	140	0	4	3	0	147
4856	5	0	142	2	0	149
4857	3	1	143	0	0	147
4858	1	0	6	135	0	142
4859	2	1	140	5	0	148
4860	140	0	7	2	0	149
4861	7	1	1	151	0	160
4862	150	0	2	8	0	160
4863	158	2	0	3	0	163
4864	143	2	1	3	0	149
4865	146	0	1	3	0	150
4866	7	1	147	1	0	156
4867	4	0	5	142	0	151
4868	3	1	146	4	0	154
4869	4	0	5	143	0	152
4870	144	0	2	5	0	151
4871	4	1	2	144	0	151
4872	149	0	1	8	0	158
4873	5	1	2	153	0	161
4874	4	0	3	153	0	160
4875	150	0	2	9	0	161
4876	5	148	3	3	0	159
4877	155	2	0	2	0	159
4878	3	149	1	2	0	155
4879	5	2	0	152	0	159
4880	153	1	1	6	0	161
4881	4	0	149	2	0	155
4882	3	1	1	152	0	157
4883	152	0	2	5	0	159
4884	152	2	0	4	0	158
4885	3	0	1	151	0	155
4886	1	147	1	2	0	151
4887	2	141	2	2	0	147
4888	2	3	0	138	0	143
4889	137	2	0	3	0	142
4890	0	137	0	1	0	138
4891	0	122	0	0	0	122
4892	123	0	0	3	0	126
4893	0	122	0	0	0	122
4894	124	0	0	2	0	126
4895	0	0	0	121	0	121
4896	0	0	0	120	0	120
4897	0	118	0	0	0	118
4898	0	119	0	0	0	119
4899	112	0	0	0	0	112
4900	0	115	0	0	0	115
4901	0	127	0	0	0	127
4902	1	1	0	123	0	125
4903	125	0	0	0	0	125
4904	1	0	133	0	0	134
4905	134	0	1	0	0	135
4906	1	0	0	142	0	143
4907	0	0	139	2	0	141
4908	0	0	139	0	0	139
4909	3	0	2	139	0	144
4910	0	1	150	3	0	154
4911	142	0	4	2	0	148
4912	155	0	0	2	0	157
4913	3	0	152	1	0	156
4914	0	0	4	150	0	154
4915	3	0	1	150	0	154
4916	152	0	1	4	0	157
4917	4	0	2	145	0	151
4918	1	143	2	3	0	149
4919	142	3	3	2	0	150
4920	4	138	0	3	0	145
4921	0	149	2	3	0	154
4922	3	6	0	149	0	158
4923	4	0	0	150	0	154
4924	0	2	2	149	0	153
4925	1	1	139	6	0	147
4926	122	1	3	5	0	131
4927	6	136	0	1	0	143
4928	137	3	1	6	0	147
4929	146	2	2	1	0	151
4930	8	0	0	141	0	149
4931	0	142	1	4	0	147
4932	5	5	0	139	0	149
4933	3	0	0	146	0	149
4934	138	1	0	7	0	146
4935	139	3	0	4	0	146
4936	5	0	139	5	0	149
4937	141	0	3	3	0	147
4938	6	150	0	1	0	157
4939	149	7	0	1	0	157
4940	9	153	1	1	0	164
4941	4	6	0	151	0	161
4942	2	5	0	151	0	158
4943	3	160	0	7	0	170
4944	2	5	0	164	0	171
4945	4	3	0	169	0	176
4946	4	2	0	164	0	170
4947	2	159	2	7	0	170
4948	2	6	0	162	0	170
4949	1	5	0	169	0	175
4950	4	1	0	169	0	174
4951	3	5	158	6	0	172
4952	153	0	8	6	0	167
4953	6	1	163	4	0	174
4954	160	3	5	6	0	174
4955	6	0	166	6	0	178
4956	156	0	8	5	0	169
4957	166	1	4	4	0	175
4958	7	2	166	2	0	177
4959	5	0	9	155	0	169
4960	5	0	158	6	0	169
4961	154	0	8	3	0	165
4962	6	0	182	2	0	190
4963	5	0	175	4	0	184
4964	169	0	8	1	0	178
4965	9	172	1	3	0	185
4966	3	7	5	176	0	191
4967	184	1	3	6	0	194
4968	12	2	1	178	0	193
4969	0	3	4	184	0	191
4970	182	2	1	11	0	196
4971	184	0	2	3	0	189
4972	8	1	177	5	0	191
4973	1	2	178	4	0	185
4974	5	0	6	179	0	190
4975	5	3	183	9	0	200
4976	3	4	7	182	0	196
4977	4	0	3	185	0	192
4978	4	0	1	194	0	199
4979	181	3	3	7	0	194
4980	6	187	1	7	0	201
4981	191	5	0	7	0	203
4982	194	0	1	5	0	200
4983	9	187	2	2	0	200
4984	186	5	3	3	0	197
4985	9	1	188	3	0	201
4986	5	2	7	180	0	194
4987	185	4	0	7	0	196
4988	10	1	186	2	0	199
4989	181	1	6	3	0	191
4990	6	199	0	4	0	209
4991	206	8	1	3	0	218
4992	210	0	2	1	0	213
4993	13	210	0	1	0	224
4994	218	10	0	1	0	229
4995	13	1	1	217	0	232
4996	6	2	1	220	0	229
4997	214	3	0	10	0	227
4998	216	0	0	2	0	218
4999	9	213	1	3	0	226
5000	3	214	1	1	0	219
5001	9	12	0	193	0	214
5002	4	208	2	7	0	221
5003	3	224	1	2	0	230
5004	201	9	1	0	0	211
5005	6	198	0	2	0	206
5006	192	8	0	1	0	201
5007	6	208	0	0	0	214
5008	1	6	214	0	0	221
5009	0	216	6	0	0	222
5010	207	5	3	1	0	216
5011	211	1	0	1	0	213
5012	6	1	207	0	0	214
5013	2	0	5	197	0	204
5014	0	1	1	213	0	215
5015	0	0	207	7	0	214
5016	1	1	5	199	0	206
5017	2	0	206	4	0	212
5018	1	0	199	1	0	201
5019	196	0	6	0	0	202
5020	5	201	1	1	0	208
5021	196	4	0	1	0	201
5022	5	1	1	198	0	205
5023	1	1	196	5	0	203
5024	1	0	5	196	0	202
5025	0	207	2	3	0	212
5026	207	4	0	3	0	214
5027	215	2	0	0	0	217
5028	7	0	0	207	0	214
5029	1	0	207	5	0	213
5030	194	1	5	2	0	202
5031	5	200	1	1	0	207
5032	206	6	0	2	0	214
5033	7	1	0	206	0	214
5034	211	1	0	4	0	216
5035	7	1	0	202	0	210
5036	3	0	208	3	0	214
5037	2	3	198	1	0	204
5038	199	2	4	1	0	206
5039	5	207	1	1	0	214
5040	205	4	0	5	0	214
5041	199	3	2	3	0	207
5042	6	204	0	2	0	212
5043	201	5	1	3	0	210
5044	4	3	221	0	0	228
5045	5	1	3	220	0	229
5046	2	2	1	220	0	225
5047	2	2	1	229	0	234
5048	1	1	221	5	0	228
5049	2	2	218	2	0	224
5050	3	1	4	212	0	220
5051	1	217	3	3	0	224
5052	1	228	1	3	0	233
5053	223	4	1	1	0	229
5054	222	2	2	2	0	228
5055	4	232	0	1	0	237
5056	3	5	2	235	0	245
5057	2	2	1	241	0	246
5058	243	1	0	7	0	251
5059	4	1	2	252	0	259
5060	3	2	0	247	0	252
5061	2	0	1	255	0	258
5062	1	1	245	4	0	251
5063	3	0	221	5	0	229
5064	234	4	5	1	0	244
5065	7	0	3	247	0	257
5066	5	1	245	4	0	255
5067	0	4	230	2	0	236
5068	230	0	5	6	0	241
5069	5	2	254	3	0	264
5070	3	255	7	0	0	265
5071	3	5	1	273	0	282
5072	0	2	281	8	0	291
5073	266	0	6	5	0	277
5074	10	1	2	283	0	296
5075	2	3	277	6	0	288
5076	5	1	7	271	0	284
5077	3	0	3	278	0	284
5078	278	3	1	10	0	292
5079	7	277	1	6	0	291
5080	7	7	1	271	0	286
5081	274	4	1	8	0	287
5082	286	0	1	5	0	292
5083	287	1	2	3	0	293
5084	287	0	3	4	0	294
5085	11	0	1	287	0	299
5086	284	3	0	7	0	294
5087	283	2	1	4	0	290
5088	280	0	2	1	0	283
5089	275	1	0	6	0	282
5090	9	258	3	1	0	271
5091	1	253	0	0	0	254
5092	0	1	0	251	0	252
5093	0	250	1	1	0	252
5094	247	3	0	3	0	253
5095	5	2	0	248	0	255
5096	245	0	0	4	0	249
5097	247	0	0	4	0	251
5098	7	1	0	257	0	265
5099	4	0	0	259	0	263
5100	0	258	2	4	0	264
5101	253	3	0	7	0	263
5102	3	254	0	0	0	257
5103	254	3	0	1	0	258
5104	4	3	0	259	0	266
5105	2	0	256	3	0	261
5106	249	0	3	3	0	255
5107	244	0	2	2	0	248
5108	5	0	240	0	0	245
5109	3	1	243	0	0	247
5110	2	0	5	232	0	239
5111	262	0	1	6	0	269
5112	265	0	0	7	0	272
5113	283	0	0	1	0	284
5114	282	0	0	4	0	286
5115	5	278	0	0	0	283
5116	298	3	0	1	0	302
5117	6	2	0	288	0	296
5118	1	0	0	287	0	288
5119	0	0	0	290	0	290
5120	1	0	1	291	0	293
5121	290	0	0	6	0	296
5122	3	0	0	295	0	298
5123	4	0	283	3	0	290
5124	1	1	3	282	0	287
5125	0	0	3	293	0	296
5126	1	0	0	293	0	294
5127	2	0	0	291	0	293
5128	289	0	1	7	0	297
5129	5	284	1	4	0	294
5130	3	282	0	3	0	288
5131	2	6	0	279	0	287
5132	283	2	0	6	0	291
5133	285	2	1	2	0	290
5134	11	1	0	284	0	296
5135	4	2	280	7	0	293
5136	273	1	4	8	0	286
5137	8	0	1	285	0	294
5138	3	2	288	7	0	300
5139	260	0	5	6	0	271
5140	6	283	3	3	0	295
5141	317	6	0	2	0	325
5142	5	323	1	3	0	332
5143	10	6	1	320	0	337
5144	5	310	0	6	0	321
5145	3	10	0	330	0	343
5146	314	7	1	14	0	336
5147	9	315	0	8	0	332
5148	7	7	309	5	0	328
5149	4	6	7	319	0	336
5150	3	6	315	7	0	331
5151	7	3	7	305	0	322
5152	5	1	7	321	0	334
5153	4	2	306	10	0	322
5154	282	1	8	15	0	306
5155	6	2	309	6	0	323
5156	10	1	292	3	0	306
5157	7	292	13	1	0	313
5158	4	7	9	296	0	316
5159	7	5	6	295	0	313
5160	2	5	2	297	0	306
5161	5	1	1	312	0	319
5162	2	1	289	18	0	310
5163	267	2	7	11	0	287
5164	10	2	293	4	0	309
5165	9	3	7	281	0	300
5166	283	1	9	7	0	300
5167	8	276	3	11	0	298
5168	6	7	5	276	0	294
5169	263	6	1	11	0	281
5170	6	251	1	12	0	270
5171	7	234	2	6	0	249
5172	226	12	0	7	0	245
5173	8	232	4	5	0	249
5174	234	8	2	1	0	245
5175	9	232	2	2	0	245
5176	238	7	4	5	0	254
5177	243	8	2	5	0	258
5178	14	239	3	4	0	260
5179	14	7	0	242	0	263
5180	4	7	234	9	0	254
5181	229	3	7	9	0	248
5182	9	3	6	225	0	243
5183	10	218	5	7	0	240
5184	5	240	3	8	0	256
5185	4	13	1	239	0	257
5186	231	9	0	12	0	252
5187	9	4	226	11	0	250
5188	8	3	7	241	0	259
5189	5	2	5	245	0	257
5190	8	1	5	240	0	254
5191	2	4	1	242	0	249
5192	4	229	4	14	0	251
5193	2	8	0	247	0	257
5194	3	8	231	11	0	253
5195	2	7	238	6	0	253
5196	3	3	238	6	0	250
5197	9	1	14	225	0	249
5198	220	2	11	7	0	240
5199	6	3	218	9	0	236
5200	9	0	223	7	0	239
5201	6	4	12	213	0	235
5202	214	1	9	10	0	234
5203	7	215	3	9	0	234
5204	224	8	3	4	0	239
5205	11	8	3	218	0	240
5206	8	5	223	7	0	243
5207	7	2	7	217	0	233
5208	3	222	8	10	0	243
5209	236	6	1	8	0	251
5210	6	8	233	6	0	253
5211	8	218	7	4	0	237
5212	218	12	9	2	0	241
5213	11	9	7	211	0	238
5214	12	5	3	216	0	236
5215	215	1	4	17	0	237
5216	214	2	3	13	0	232
5217	219	1	3	12	0	235
5218	19	1	3	210	0	233
5219	12	208	1	10	0	231
5220	211	12	2	6	0	231
5221	10	213	3	9	0	235
5222	203	13	3	2	0	221
5223	15	201	3	2	0	221
5224	9	13	3	198	0	223
5225	202	5	1	13	0	221
5226	210	5	0	10	0	225
5227	211	1	4	8	0	224
5228	215	1	4	4	0	224
5229	209	2	2	5	0	218
5230	20	1	190	2	0	213
5231	10	2	9	193	0	214
5232	7	3	199	7	0	216
5233	3	2	198	11	0	214
5234	194	0	18	7	0	219
5235	204	1	12	3	0	220
5236	207	2	6	1	0	216
5237	21	3	1	190	0	215
5238	194	0	4	9	0	207
5239	10	186	1	9	0	206
5240	12	184	1	5	0	202
5241	3	162	0	2	0	167
5242	139	11	2	0	0	152
5243	7	136	0	1	0	144
5244	135	7	1	0	0	143
5245	138	3	0	2	0	143
5246	9	3	131	0	0	143
5247	6	0	6	118	0	130
5248	4	1	5	137	0	147
5249	132	1	3	11	0	147
5250	144	0	1	6	0	151
5251	11	1	0	138	0	150
5252	7	0	129	6	0	142
5253	4	0	135	5	0	144
5254	3	0	8	135	0	146
5255	3	2	5	138	0	148
5256	1	1	2	147	0	151
5257	137	3	0	13	0	153
5258	142	0	0	6	0	148
5259	9	136	1	2	0	148
5260	10	6	0	133	0	149
5261	4	4	0	137	0	145
5262	2	139	1	9	0	151
5263	5	5	0	138	0	148
5264	137	2	0	10	0	149
5265	10	2	0	137	0	149
5266	8	0	0	140	0	148
5267	138	0	0	11	0	149
5268	136	0	3	6	0	145
5269	142	0	1	3	0	146
5270	14	1	2	125	0	142
5271	8	0	127	6	0	141
5272	4	0	127	3	0	134
5273	2	0	130	3	0	135
5274	2	125	7	0	0	134
5275	122	6	4	3	0	135
5276	6	1	122	1	0	130
5277	123	2	3	2	0	130
5278	7	0	2	124	0	133
5279	116	0	3	6	0	125
5280	128	0	0	3	0	131
5281	5	133	0	4	0	142
5282	135	4	0	2	0	141
5283	137	1	0	1	0	139
5284	6	132	0	1	0	139
5285	4	4	1	141	0	150
5286	2	1	138	5	0	146
5287	0	2	4	134	0	140
5288	1	0	2	144	0	147
5289	137	0	3	6	0	146
5290	5	1	0	135	0	141
5291	2	138	0	7	0	147
5292	3	6	1	136	0	146
5293	2	2	0	144	0	148
5294	0	2	136	8	0	146
5295	1	137	5	3	0	146
5296	1	142	1	3	0	147
5297	132	7	1	1	0	141
5298	5	138	0	1	0	144
5299	2	6	0	140	0	148
5300	3	1	134	3	0	141
5301	1	138	5	1	0	145
5302	138	5	1	3	0	147
5303	7	2	1	135	0	145
5304	2	1	1	143	0	147
5305	3	1	139	4	0	147
5306	1	0	5	133	0	139
5307	2	1	1	138	0	142
5308	132	0	3	7	0	142
5309	121	0	1	4	0	126
5310	5	117	0	2	0	124
5311	111	3	0	1	0	115
5312	5	112	0	0	0	117
5313	1	4	0	104	0	109
5314	1	105	1	2	0	109
5315	1	106	2	2	0	111
5316	111	3	0	5	0	119
5317	114	3	0	1	0	118
5318	3	110	1	2	0	116
5319	117	2	0	0	0	119
5320	118	1	0	1	0	120
5321	118	2	0	1	0	121
5322	4	0	0	119	0	123
5323	120	0	0	5	0	125
5324	3	2	116	1	0	122
5325	116	0	2	1	0	119
5326	4	0	126	1	0	131
5327	1	0	3	134	0	138
5328	1	1	1	136	0	139
5329	1	0	132	3	0	136
5330	128	0	2	2	0	132
5331	134	1	1	2	0	138
5332	3	0	148	2	0	153
5333	1	0	3	146	0	150
5334	1	0	2	148	0	151
5335	1	0	2	151	0	154
5336	148	1	0	5	0	154
5337	149	0	0	4	0	153
5338	3	0	2	147	0	152
5339	1	143	0	3	0	147
5340	0	144	0	3	0	147
5341	139	3	0	1	0	143
5342	4	136	0	0	0	140
5343	0	139	1	0	0	140
5344	0	1	0	129	0	130
5345	0	2	133	1	0	136
5346	0	132	1	1	0	134
5347	0	1	1	132	0	134
5348	0	130	0	1	0	131
5349	0	1	0	131	0	132
5350	130	1	0	2	0	133
5351	1	134	0	1	0	136
5352	135	1	0	1	0	137
5353	135	0	0	0	0	135
5354	2	0	133	0	0	135
5355	126	0	1	1	0	128
5356	1	0	1	128	0	130
5357	1	0	132	1	0	134
5358	0	135	1	1	0	137
5359	0	1	1	131	0	133
5360	0	1	0	133	0	134
5361	136	0	0	2	0	138
5362	1	0	0	132	0	133
5363	2	0	0	132	0	134
5364	135	0	0	2	0	137
5365	1	133	0	1	0	135
5366	131	1	0	2	0	134
5367	1	1	129	0	0	131
5368	128	0	1	0	0	129
5369	1	0	133	0	0	134
5370	1	130	1	0	0	132
5371	140	1	1	0	0	142
5372	136	1	0	3	0	140
5373	2	0	137	0	0	139
5374	1	0	130	0	0	131
5375	0	0	138	0	0	138
5376	0	140	4	0	0	144
5377	2	3	1	135	0	141
5378	0	1	152	3	0	156
5379	0	2	146	1	0	149
5380	2	0	4	143	0	149
5381	1	0	154	4	0	159
5382	148	0	6	1	0	155
5383	164	0	2	1	0	167
5384	5	0	161	0	0	166
5385	1	161	5	0	0	167
5386	1	4	1	161	0	167
5387	0	1	160	4	0	165
5388	0	163	4	2	0	169
5389	1	3	1	161	0	166
5390	161	1	2	3	0	167
5391	160	1	1	2	0	164
5392	5	167	1	2	0	175
5393	3	3	3	169	0	178
5394	1	5	1	171	0	178
5395	0	1	0	171	0	172
5396	0	0	3	169	0	172
5397	0	2	166	5	0	173
5398	0	1	3	170	0	174
5399	2	1	166	5	0	174
5400	4	160	5	1	0	170
5401	164	5	1	2	0	172
5402	3	172	2	2	0	179
5403	0	3	0	174	0	177
5404	1	1	0	174	0	176
5405	172	1	1	6	0	180
5406	4	1	2	173	0	180
5407	1	166	1	7	0	175
5408	2	3	2	175	0	182
5409	2	3	1	172	0	178
5410	167	3	0	6	0	176
5411	3	2	170	3	0	178
5412	0	161	3	4	0	168
5413	2	171	0	3	0	176
5414	2	2	1	169	0	174
5415	167	1	1	4	0	173
5416	3	164	0	1	0	168
5417	1	4	0	161	0	166
5418	1	1	161	6	0	169
5419	3	1	3	160	0	167
5420	163	1	2	5	0	171
5421	165	2	2	2	0	171
5422	5	3	0	166	0	174
5423	170	1	0	6	0	177
5424	170	0	0	2	0	172
5425	4	3	164	1	0	172
5426	156	1	3	4	0	164
5427	4	167	2	1	0	174
5428	167	4	2	2	0	175
5429	7	0	161	1	0	169
5430	3	2	4	165	0	174
5431	172	1	0	6	0	179
5432	6	0	147	2	0	155
5433	4	0	157	1	0	162
5434	3	2	6	155	0	166
5435	1	0	163	5	0	169
5436	154	2	6	1	0	163
5437	6	1	154	1	0	162
5438	3	0	7	155	0	165
5439	2	0	1	168	0	171
5440	171	0	1	9	0	181
5441	9	0	174	3	0	186
5442	2	0	188	2	0	192
5443	2	0	10	190	0	202
5444	1	0	195	9	0	205
5445	192	1	11	1	0	205
5446	11	0	3	192	0	206
5447	1	0	198	10	0	209
5448	4	0	8	195	0	207
5449	4	0	1	201	0	206
5450	195	0	4	14	0	213
5451	9	0	199	3	0	211
5452	190	0	10	6	0	206
5453	11	0	202	2	0	215
5454	197	0	12	0	0	209
5455	199	0	2	2	0	203
5456	205	0	4	4	0	213
5457	14	198	1	2	0	215
5458	203	9	2	4	0	218
5459	206	1	1	1	0	209
5460	12	2	4	196	0	214
5461	6	0	198	10	0	214
5462	189	0	12	2	0	203
5463	13	0	207	2	0	222
5464	4	1	10	202	0	217
5465	6	0	2	214	0	222
5466	212	2	2	10	0	226
5467	11	204	0	5	0	220
5468	5	9	2	202	0	218
5469	6	1	1	210	0	218
5470	1	1	208	11	0	221
5471	3	0	10	206	0	219
5472	4	0	3	215	0	222
5473	4	0	4	210	0	218
5474	0	201	3	11	0	215
5475	196	8	2	5	0	211
5476	202	1	2	6	0	211
5477	10	203	1	2	0	216
5478	194	7	2	4	0	207
5479	10	1	2	201	0	214
5480	2	2	215	12	0	231
5481	5	210	8	3	0	226
5482	3	216	4	4	0	227
5483	207	9	5	1	0	222
5484	224	3	1	4	0	232
5485	14	2	4	220	0	240
5486	9	0	1	235	0	245
5487	4	0	2	238	0	244
5488	222	1	4	17	0	244
5489	14	1	223	5	0	243
5490	218	0	11	8	0	237
5491	16	1	5	224	0	246
5492	4	0	3	232	0	239
5493	5	217	1	14	0	237
5494	2	12	4	221	0	239
5495	6	3	0	231	0	240
5496	5	1	220	15	0	241
5497	6	227	12	4	0	249
5498	233	15	3	2	0	253
5499	237	4	0	3	0	244
5500	243	2	1	2	0	248
5501	249	1	0	6	0	256
5502	15	2	225	5	0	247
5503	235	0	13	1	0	249
5504	15	2	233	2	0	252
5505	4	1	14	224	0	243
5506	7	230	3	13	0	253
5507	5	11	1	239	0	256
5508	2	5	1	243	0	251
5509	1	4	228	17	0	250
5510	221	2	12	7	0	242
5511	237	0	6	6	0	249
5512	13	224	3	6	0	246
5513	5	12	221	5	0	243
5514	2	4	11	228	0	245
5515	2	4	223	16	0	245
5516	6	1	235	5	0	247
5517	8	0	13	226	0	247
5518	4	4	229	12	0	249
5519	6	2	13	219	0	240
5520	4	0	234	15	0	253
5521	0	2	16	240	0	258
5522	235	5	4	16	0	260
5523	246	5	3	6	0	260
5524	244	3	2	6	0	255
5525	243	1	5	1	0	250
5526	17	240	1	6	0	264
5527	8	10	2	236	0	256
5528	8	3	0	244	0	255
5529	7	2	233	14	0	256
5530	4	0	13	228	0	245
5531	5	1	232	13	0	251
5532	2	0	240	5	0	247
5533	214	2	14	6	0	236
5534	10	236	3	5	0	254
5535	234	11	2	5	0	252
5536	243	2	2	8	0	255
5537	13	240	5	3	0	261
5538	245	9	1	5	0	260
5539	15	1	251	3	0	270
5540	6	248	6	1	0	261
5541	242	9	2	5	0	258
5542	9	3	228	2	0	242
5543	204	1	7	1	0	213
5544	8	215	2	2	0	227
5545	214	5	3	2	0	224
5546	214	1	1	3	0	219
5547	6	207	2	1	0	216
5548	1	211	2	2	0	216
5549	1	226	2	2	0	231
5550	1	7	2	223	0	233
5551	3	2	0	228	0	233
5552	226	0	0	6	0	232
5553	229	2	0	2	0	233
5554	9	0	219	0	0	228
5555	2	1	224	1	0	228
5556	0	1	228	1	0	230
5557	3	0	7	215	0	225
5558	1	0	224	5	0	230
5559	1	0	6	220	0	227
5560	220	2	2	9	0	233
5561	6	0	225	2	0	233
5562	213	0	5	6	0	224
5563	225	3	2	2	0	232
5564	9	1	222	0	0	232
5565	4	222	5	0	0	231
5566	1	8	1	225	0	235
5567	1	1	232	6	0	240
5568	2	1	4	221	0	228
5569	1	1	1	248	0	251
5570	235	0	3	7	0	245
5571	7	0	2	236	0	245
5572	2	0	238	6	0	246
5573	1	1	5	240	0	247
5574	236	0	4	7	0	247
5575	4	239	1	3	0	247
5576	239	4	1	1	0	245
5577	6	3	2	234	0	245
5578	5	3	230	2	0	240
5579	3	1	226	2	0	232
5580	1	2	222	3	0	228
5581	3	221	3	1	0	228
5582	215	3	8	1	0	227
5583	4	211	3	0	0	218
5584	204	2	0	1	0	207
5585	2	198	2	0	0	202
5586	4	3	0	197	0	204
5587	1	1	0	196	0	198
5588	1	1	1	195	0	198
5589	0	201	0	2	0	203
5590	2	2	0	204	0	208
5591	1	1	0	229	0	231
5592	249	2	0	4	0	255
5593	5	0	1	254	0	260
5594	0	1	254	8	0	263
5595	251	0	6	0	0	257
5596	259	1	0	4	0	264
5597	8	254	4	0	0	266
5598	253	5	1	2	0	261
5599	258	1	2	1	0	262
5600	7	2	1	254	0	264
5601	5	0	2	254	0	261
5602	4	1	0	267	0	272
5603	263	0	2	12	0	277
5604	260	1	2	7	0	270
5605	14	0	255	5	0	274
5606	256	3	8	1	0	268
5607	266	0	4	2	0	272
5608	265	1	4	4	0	274
5609	13	2	251	1	0	267
5610	7	1	253	0	0	261
5611	7	1	8	251	0	267
5612	1	1	258	10	0	270
5613	6	0	13	246	0	265
5614	4	2	3	233	0	242
5615	3	250	4	11	0	268
5616	253	7	2	7	0	269
5617	9	3	255	6	0	273
5618	254	6	9	4	0	273
5619	15	1	2	258	0	276
5620	245	2	6	12	0	265
5621	10	238	3	9	0	260
5622	5	260	2	12	0	279
5623	8	12	4	252	0	276
5624	8	8	1	262	0	279
5625	6	4	260	11	0	281
5626	7	3	11	260	0	281
5627	253	2	3	17	0	275
5628	9	255	8	7	0	279
5629	9	10	260	6	0	285
5630	4	4	9	259	0	276
5631	2	6	260	14	0	282
5632	11	2	11	257	0	281
5633	5	0	261	18	0	284
5634	5	2	266	5	0	278
5635	7	1	12	261	0	281
5636	258	1	9	12	0	280
5637	261	2	6	6	0	275
5638	256	2	4	5	0	267
5639	17	247	3	6	0	273
5640	255	8	4	4	0	271
5641	255	3	4	3	0	265
5642	12	7	239	5	0	263
5643	8	246	15	2	0	271
5644	9	7	6	242	0	264
5645	235	5	5	17	0	262
5646	12	244	5	3	0	264
5647	243	11	0	10	0	264
5648	253	3	2	4	0	262
5649	242	10	0	3	0	255
5650	236	2	2	8	0	248
5651	18	2	4	230	0	254
5652	233	2	1	15	0	251
5653	16	3	0	227	0	246
5654	6	216	4	17	0	243
5655	10	9	3	221	0	243
5656	219	5	2	15	0	241
5657	10	5	219	8	0	242
5658	8	0	9	227	0	244
5659	218	2	6	13	0	239
5660	9	212	9	5	0	235
5661	219	8	2	8	0	237
5662	221	4	5	1	0	231
5663	13	214	3	3	0	233
5664	217	8	3	6	0	234
5665	14	3	205	3	0	225
5666	5	3	200	5	0	213
5667	205	2	11	1	0	219
5668	11	0	201	1	0	213
5669	7	1	13	181	0	202
5670	7	187	3	8	0	205
5671	193	8	4	3	0	208
5672	10	188	1	4	0	203
5673	3	195	1	1	0	200
5674	7	13	1	203	0	224
5675	4	6	0	208	0	218
5676	7	2	3	203	0	215
5677	4	2	1	212	0	219
5678	4	0	198	16	0	218
5679	7	1	6	193	0	207
5680	2	2	3	192	0	199
5681	186	0	4	13	0	203
5682	10	1	1	188	0	200
5683	4	1	182	12	0	199
5684	180	0	7	6	0	193
5685	10	1	5	185	0	201
5686	3	2	192	10	0	207
5687	8	1	6	190	0	205
5688	4	192	3	7	0	206
5689	197	7	3	4	0	211
5690	13	3	185	3	0	204
5691	3	157	5	1	0	166
5692	138	4	3	3	0	148
5693	4	127	3	0	0	134
5694	2	115	3	0	0	120
5695	115	3	3	1	0	122
5696	2	108	3	1	0	114
5697	1	107	0	1	0	109
5698	2	5	0	102	0	109
5699	1	1	104	2	0	108
5700	0	101	2	1	0	104
5701	1	2	1	101	0	105
5702	0	95	0	1	0	96
5703	98	1	0	0	0	99
5704	1	0	93	0	0	94
5705	0	0	1	95	0	96
5706	100	0	0	2	0	102
5707	0	0	0	97	0	97
5708	0	0	94	1	0	95
5709	89	0	1	0	0	90
5710	91	0	0	0	0	91
5711	0	97	0	0	0	97
5712	0	1	0	98	0	99
5713	0	0	0	105	0	105
5714	100	0	0	1	0	101
5715	96	0	0	2	0	98
5716	0	0	102	0	0	102
5717	0	99	1	0	0	100
5718	97	1	0	0	0	98
5719	0	0	0	91	0	91
5720	0	0	94	0	0	94
5721	0	0	88	0	0	88
5722	0	2	0	86	0	88
5723	93	0	0	0	0	93
5724	0	90	0	0	0	90
5725	102	0	0	1	0	103
5726	0	0	0	109	0	109
5727	0	0	0	107	0	107
5728	0	0	0	107	0	107
5729	108	0	0	1	0	109
5730	0	110	0	0	0	110
5731	0	0	0	113	0	113
5732	1	0	0	112	0	113
5733	0	0	109	0	0	109
5734	0	0	0	102	0	102
5735	0	0	107	0	0	107
5736	0	105	0	0	0	105
5737	0	0	0	104	0	104
5738	102	0	0	0	0	102
5739	0	0	105	0	0	105
5740	1	0	0	102	0	103
5741	0	0	103	0	0	103
5742	97	0	1	3	0	101
5743	1	0	109	0	0	110
5744	1	0	1	103	0	105
5745	106	0	0	2	0	108
5746	1	96	0	0	0	97
5747	101	1	0	1	0	103
5748	4	102	0	0	0	106
5749	1	1	0	109	0	111
5750	0	0	109	1	0	110
5751	0	0	103	0	0	103
5752	0	0	1	106	0	107
5753	107	0	1	1	0	109
5754	107	0	0	0	0	107
5755	0	0	0	111	0	111
5756	0	0	0	108	0	108
5757	107	0	0	2	0	109
5758	2	108	0	0	0	110
5759	0	118	0	0	0	118
5760	120	2	0	0	0	122
5761	2	0	123	0	0	125
5762	1	0	2	122	0	125
5763	0	0	121	2	0	123
5764	0	0	2	127	0	129
5765	0	0	129	2	0	131
5766	1	0	119	0	0	120
5767	1	0	2	128	0	131
5768	0	123	0	2	0	125
5769	128	2	0	0	0	130
5770	2	128	1	0	0	131
5771	0	2	0	131	0	133
5772	130	0	0	4	0	134
5773	2	0	0	136	0	138
5774	135	0	0	2	0	137
5775	135	0	0	1	0	136
5776	135	0	0	3	0	138
5777	2	131	0	0	0	133
5778	138	2	0	0	0	140
5779	2	0	0	138	0	140
5780	138	0	0	3	0	141
5781	2	0	0	148	0	150
5782	144	0	0	2	0	146
5783	147	0	0	1	0	148
5784	2	143	0	0	0	145
5785	0	2	0	160	0	162
5786	0	0	0	158	0	158
5787	0	159	0	4	0	163
5788	0	6	0	160	0	166
5789	160	2	0	7	0	169
5790	181	0	0	1	0	182
5791	179	0	0	0	0	179
5792	9	0	196	0	0	205
5793	195	0	8	4	0	207
5794	212	0	1	0	0	213
5795	222	0	0	1	0	223
5796	8	208	1	0	0	217
5797	0	5	0	218	0	223
5798	1	1	0	222	0	224
5799	1	0	0	219	0	220
5800	0	0	211	8	0	219
5801	0	0	7	205	0	212
5802	218	0	1	7	0	226
5803	7	0	0	220	0	227
5804	1	0	0	220	0	221
5805	0	0	214	7	0	221
5806	0	216	7	1	0	224
5807	224	7	0	1	0	232
5808	7	1	1	220	0	229
5809	219	1	0	8	0	228
5810	8	0	220	1	0	229
5811	201	0	8	3	0	212
5812	8	228	1	0	0	237
5813	1	8	221	1	0	231
5814	3	3	234	0	0	240
5815	2	1	9	229	0	241
5816	1	0	247	8	0	256
5817	1	257	10	1	0	269
5818	2	7	2	255	0	266
5819	4	2	0	266	0	272
5820	2	2	0	271	0	275
5821	265	1	1	9	0	276
5822	7	258	2	3	0	270
5823	1	6	0	269	0	276
5824	3	1	1	271	0	276
5825	263	2	1	9	0	275
5826	7	260	0	5	0	272
5827	270	7	0	6	0	283
5828	276	2	1	2	0	281
5829	274	1	0	3	0	278
5830	10	1	271	1	0	283
5831	7	2	6	265	0	280
5832	3	274	1	7	0	285
5833	2	282	2	3	0	289
5834	4	10	0	281	0	295
5835	4	289	2	6	0	301
5836	307	8	0	5	0	320
5837	8	3	299	0	0	310
5838	287	1	9	4	0	301
5839	312	0	2	4	0	318
5840	10	2	1	316	0	329
5841	314	1	2	9	0	326
5842	7	348	1	5	0	361
5843	353	6	1	6	0	366
5844	360	1	1	8	0	370
5845	370	1	2	4	0	377
5846	11	0	367	1	0	379
5847	3	4	376	2	0	385
5848	4	1	6	372	0	383
5849	2	365	4	10	0	381
5850	2	382	2	2	0	388
5851	2	8	2	380	0	392
5852	381	3	0	11	0	395
5853	14	2	0	376	0	392
5854	3	1	3	388	0	395
5855	380	0	2	10	0	392
5856	6	375	1	5	0	387
5857	1	8	384	2	0	395
5858	1	4	385	0	0	390
5859	379	0	7	4	0	390
5860	9	0	5	373	0	387
5861	2	1	395	9	0	407
5862	3	0	7	372	0	382
5863	5	2	2	381	0	390
5864	2	2	2	392	0	398
5865	4	0	1	389	0	394
5866	3	387	1	7	0	398
5867	6	6	0	388	0	400
5868	388	3	1	12	0	404
5869	9	384	1	3	0	397
5870	391	6	0	7	0	404
5871	398	2	3	3	0	406
5872	398	3	2	4	0	407
5873	11	1	371	2	0	385
5874	382	3	7	1	0	393
5875	394	1	2	4	0	401
5876	382	2	3	5	0	392
5877	389	3	0	2	0	394
5878	9	378	1	2	0	390
5879	379	7	0	1	0	387
5880	11	3	370	1	0	385
5881	1	3	7	371	0	382
5882	6	0	3	378	0	387
5883	382	1	4	8	0	395
5884	8	383	0	5	0	396
5885	375	4	0	3	0	382
5886	6	385	0	1	0	392
5887	376	4	0	2	0	382
5888	373	2	1	1	0	377
5889	3	394	1	1	0	399
5890	393	3	0	5	0	401
5891	408	1	0	3	0	412
5892	6	388	2	0	0	396
5893	5	395	1	0	0	401
5894	415	4	1	3	0	423
5895	9	4	0	412	0	425
5896	408	4	0	6	0	418
5897	424	3	0	3	0	430
5898	419	1	0	7	0	427
5899	416	1	1	5	0	423
5900	12	402	0	2	0	416
5901	6	406	0	1	0	413
5902	409	8	0	3	0	420
5903	8	4	390	1	0	403
5904	6	2	8	389	0	405
5905	5	1	4	402	0	412
5906	389	2	2	11	0	404
5907	10	387	1	5	0	403
5908	3	8	2	386	0	399
5909	3	4	0	398	0	405
5910	391	3	1	15	0	410
5911	11	0	0	397	0	408
5912	386	2	0	10	0	398
5913	390	1	0	5	0	396
5914	392	1	0	6	0	399
5915	22	1	0	378	0	401
5916	7	1	0	386	0	394
5917	6	0	390	13	0	409
5918	4	1	395	5	0	405
5919	392	0	19	3	0	414
5920	18	0	9	403	0	430
5921	7	2	424	19	0	452
5922	3	2	426	8	0	439
5923	4	1	24	417	0	446
5924	4	1	430	17	0	452
5925	0	1	22	419	0	442
5926	5	0	5	430	0	440
5927	2	1	428	25	0	456
5928	7	1	19	430	0	457
5929	5	1	7	428	0	441
5930	5	1	2	447	0	455
5931	3	3	419	28	0	453
5932	6	1	19	424	0	450
5933	424	2	6	27	0	459
5934	21	421	4	7	0	453
5935	428	18	1	8	0	455
5936	23	8	417	2	0	450
5937	412	3	19	5	0	439
5938	437	0	10	4	0	451
5939	428	1	6	6	0	441
5940	30	2	1	410	0	443
5941	16	2	2	424	0	444
5942	6	1	380	27	0	414
5943	365	0	21	14	0	400
5944	21	374	8	7	0	410
5945	6	371	4	4	0	385
5946	5	382	2	4	0	393
5947	4	23	4	355	0	386
5948	343	8	4	21	0	376
5949	351	3	2	13	0	369
5950	26	2	333	6	0	367
5951	12	3	18	334	0	367
5952	7	1	8	344	0	360
5953	4	2	337	25	0	368
5954	5	0	333	13	0	351
5955	322	1	23	9	0	355
5956	20	334	9	6	0	369
5957	339	17	7	4	0	367
5958	348	6	3	8	0	365
5959	28	1	3	330	0	362
5960	10	3	3	349	0	365
5961	329	2	2	26	0	359
5962	26	1	4	328	0	359
5963	14	3	1	339	0	357
5964	329	0	2	23	0	354
5965	23	1	1	323	0	348
5966	332	2	2	22	0	358
5967	341	1	3	11	0	356
5968	24	2	322	7	0	355
5969	328	2	17	6	0	353
5970	332	2	4	5	0	343
5971	339	1	6	3	0	349
5972	26	4	273	6	0	309
5973	316	3	15	5	0	339
5974	22	308	7	3	0	340
5975	314	17	5	6	0	342
5976	328	5	5	8	0	346
5977	28	2	4	311	0	345
5978	16	1	2	316	0	335
5979	6	317	6	21	0	350
5980	6	18	3	326	0	353
5981	7	7	1	340	0	355
5982	322	3	4	26	0	355
5983	25	0	2	324	0	351
5984	12	2	2	334	0	350
5985	7	3	2	332	0	344
5986	6	310	2	28	0	346
5987	302	18	2	12	0	334
5988	23	303	3	6	0	335
5989	278	18	5	6	0	307
5990	25	5	260	2	0	292
5991	248	2	16	5	0	271
5992	22	0	242	7	0	271
5993	11	230	20	3	0	264
5994	207	15	11	4	0	237
5995	216	4	4	3	0	227
5996	23	189	1	2	0	215
5997	8	202	1	3	0	214
5998	193	17	5	2	0	217
5999	208	4	0	2	0	214
6000	22	3	0	190	0	215
6001	13	2	2	205	0	222
6002	9	0	190	19	0	218
6003	194	2	15	7	0	218
6004	16	0	5	195	0	216
6005	6	196	3	16	0	221
6006	7	14	1	198	0	220
6007	1	5	1	207	0	214
6008	5	3	186	19	0	213
6009	6	3	14	195	0	218
6010	192	1	2	19	0	214
6011	21	184	0	5	0	210
6012	5	190	1	3	0	199
6013	186	16	2	4	0	208
6014	192	4	2	5	0	203
6015	196	2	1	2	0	201
6016	17	178	5	2	0	202
6017	4	163	2	0	0	169
6018	164	6	2	3	0	175
6019	165	4	2	2	0	173
6020	10	163	1	1	0	175
6021	2	128	1	0	0	131
6022	128	2	0	3	0	133
6023	3	0	0	129	0	132
6024	128	0	1	2	0	131
6025	2	0	0	124	0	126
6026	2	124	0	2	0	128
6027	2	130	0	0	0	132
6028	130	4	0	2	0	136
6029	138	0	0	0	0	138
6030	137	0	0	0	0	137
6031	4	134	1	0	0	139
6032	1	4	127	0	0	132
6033	0	127	3	0	0	130
6034	127	3	0	1	0	131
6035	129	0	0	0	0	129
6036	3	1	121	0	0	125
6037	0	119	3	0	0	122
6038	1	3	0	118	0	122
6039	2	0	0	117	0	119
6040	2	108	0	3	0	113
6041	2	4	111	1	0	118
6042	111	2	3	0	0	116
6043	4	3	0	114	0	121
6044	121	0	0	3	0	124
6045	126	1	0	1	0	128
6046	7	2	0	120	0	129
6047	1	1	1	128	0	131
6048	1	3	0	125	0	129
6049	3	2	0	125	0	130
6050	127	0	0	7	0	134
6051	123	1	1	1	0	126
6052	5	3	116	2	0	126
6053	2	2	4	122	0	130
6054	0	0	1	130	0	131
6055	3	1	0	124	0	128
6056	1	2	122	5	0	130
6057	4	0	6	115	0	125
6058	120	2	1	5	0	128
6059	8	1	0	120	0	129
6060	3	0	122	5	0	130
6061	3	0	5	124	0	132
6062	0	4	122	6	0	132
6063	123	0	5	3	0	131
6064	5	1	0	131	0	137
6065	127	1	0	6	0	134
6066	125	0	1	0	0	126
6067	8	0	2	124	0	134
6068	134	1	1	7	0	143
6069	5	0	0	136	0	141
6070	2	132	0	6	0	140
6071	138	3	1	3	0	145
6072	139	0	1	3	0	143
6073	142	0	0	2	0	144
6074	7	0	1	136	0	144
6075	4	0	1	140	0	145
6076	3	0	1	143	0	147
6077	0	1	136	7	0	144
6078	1	129	5	2	0	137
6079	2	4	0	131	0	137
6080	2	0	124	8	0	134
6081	125	0	5	1	0	131
6082	7	0	1	126	0	134
6083	2	1	125	6	0	134
6084	125	0	4	3	0	132
6085	5	1	1	129	0	136
6086	2	1	0	131	0	134
6087	4	0	2	131	0	137
6088	134	0	0	4	0	138
6089	135	0	0	3	0	138
6090	129	0	0	3	0	132
6091	4	128	1	3	0	136
6092	0	134	1	3	0	138
6093	135	3	2	1	0	141
6094	4	1	139	2	0	146
6095	2	1	3	133	0	139
6096	7	0	1	136	0	144
6097	136	0	0	5	0	141
6098	129	0	1	4	0	134
6099	5	134	2	1	0	142
6100	2	3	0	139	0	144
6101	0	1	135	6	0	142
6102	1	0	141	3	0	145
6103	3	1	2	140	0	146
6104	4	0	0	145	0	149
6105	143	0	2	2	0	147
6106	6	0	0	144	0	150
6107	153	1	0	6	0	160
6108	152	0	2	3	0	157
6109	3	2	164	1	0	170
6110	163	0	2	2	0	167
6111	158	0	1	3	0	162
6112	164	0	0	1	0	165
6113	4	152	0	2	0	158
6114	2	164	0	0	0	166
6115	5	3	0	159	0	167
6116	0	1	159	4	0	164
6117	1	152	5	0	0	158
6118	2	6	0	146	0	154
6119	0	1	1	148	0	150
6120	1	143	0	2	0	146
6121	145	3	0	1	0	149
6122	147	1	0	0	0	148
6123	2	0	143	1	0	146
6124	141	0	4	1	0	146
6125	4	0	142	1	0	147
6126	134	0	3	0	0	137
6127	2	0	138	0	0	140
6128	0	134	2	1	0	137
6129	0	1	1	136	0	138
6130	2	0	1	133	0	136
6131	137	1	0	3	0	141
6132	138	0	1	0	0	139
6133	138	0	0	0	0	138
6134	2	0	134	1	0	137
6135	0	0	2	142	0	144
6136	0	0	0	141	0	141
6137	144	0	0	3	0	147
6138	3	148	1	0	0	152
6139	155	3	0	1	0	159
6140	2	1	0	166	0	169
6141	0	0	1	174	0	175
6142	2	1	0	174	0	177
6143	0	0	1	175	0	176
6144	1	0	1	171	0	173
6145	1	170	1	2	0	174
6146	2	164	0	1	0	167
6147	0	160	0	2	0	162
6148	2	1	0	164	0	167
6149	1	0	163	1	0	165
6150	146	0	1	1	0	148
6151	2	160	0	1	0	163
6152	3	2	0	165	0	170
6153	0	1	0	170	0	171
6154	173	0	0	3	0	176
6155	169	0	1	1	0	171
6156	168	0	1	2	0	171
6157	1	0	0	183	0	184
6158	1	0	183	2	0	186
6159	2	0	192	0	0	194
6160	0	2	1	193	0	196
6161	1	0	195	2	0	198
6162	185	0	2	4	0	191
6163	1	0	1	197	0	199
6164	0	0	198	3	0	201
6165	2	0	1	186	0	189
6166	1	0	196	2	0	199
6167	0	0	219	1	0	220
6168	1	1	1	226	0	229
6169	0	1	236	2	0	239
6170	0	0	234	1	0	235
6171	0	224	7	0	0	231
6172	0	2	2	234	0	238
6173	246	3	0	5	0	254
6174	3	0	0	254	0	257
6175	2	0	0	259	0	261
6176	0	1	251	4	0	256
6177	236	0	2	4	0	242
6178	4	0	2	256	0	262
6179	2	0	0	259	0	261
6180	259	0	1	5	0	265
6181	2	0	2	263	0	267
6182	271	0	0	4	0	275
6183	265	0	1	4	0	270
6184	267	1	0	2	0	270
6185	5	272	1	2	0	280
6186	276	2	1	2	0	281
6187	3	278	0	1	0	282
6188	6	2	1	275	0	284
6189	280	2	1	3	0	286
6190	2	276	0	4	0	282
6191	283	2	2	1	0	288
6192	2	277	3	0	0	282
6193	281	3	0	2	0	286
6194	2	274	1	2	0	279
6195	4	284	0	0	0	288
6196	1	299	1	2	0	303
6197	0	7	1	289	0	297
6198	1	298	1	4	0	304
6199	3	4	1	298	0	306
6200	0	3	1	302	0	306
6201	3	0	0	298	0	301
6202	2	0	1	301	0	304
6203	294	1	1	6	0	302
6204	295	1	0	5	0	301
6205	5	0	292	2	0	299
6206	307	0	3	4	0	314
6207	310	1	2	4	0	317
6208	319	0	0	4	0	323
6209	6	1	308	1	0	316
6210	3	0	317	1	0	321
6211	313	0	5	2	0	320
6212	4	1	333	2	0	340
6213	6	348	4	1	0	359
6214	2	5	4	356	0	367
6215	365	4	2	7	0	378
6216	365	1	2	6	0	374
6217	361	1	1	2	0	365
6218	8	1	1	365	0	375
6219	5	1	2	366	0	374
6220	3	3	373	9	0	388
6221	4	0	5	370	0	379
6222	3	0	5	370	0	378
6223	367	0	0	10	0	377
6224	4	369	1	7	0	381
6225	384	3	2	3	0	392
6226	5	5	1	387	0	398
6227	386	0	0	7	0	393
6228	381	0	1	7	0	389
6229	378	1	0	2	0	381
6230	10	364	0	1	0	375
6231	7	377	1	2	0	387
6232	4	8	1	369	0	382
6233	375	5	1	8	0	389
6234	7	0	0	368	0	375
6235	6	2	1	368	0	377
6236	1	2	360	9	0	372
6237	3	3	4	362	0	372
6238	4	1	4	353	0	362
6239	6	1	0	361	0	368
6240	1	1	358	11	0	371
6241	1	1	346	6	0	354
6242	1	353	9	3	0	366
6243	358	4	5	7	0	374
6244	9	4	0	364	0	377
6245	4	1	366	7	0	378
6246	5	2	6	353	0	366
6247	2	3	4	378	0	387
6248	378	1	1	14	0	394
6249	375	1	0	8	0	384
6250	9	376	1	1	0	387
6251	372	5	2	3	0	382
6252	365	4	3	3	0	375
6253	12	2	0	368	0	382
6254	8	1	367	5	0	381
6255	1	364	7	6	0	378
6256	366	7	2	4	0	379
6257	364	4	0	5	0	373
6258	13	363	0	2	0	378
6259	9	4	2	374	0	389
6260	384	5	1	9	0	399
6261	386	1	0	11	0	398
6262	12	0	1	387	0	400
6263	384	1	3	9	0	397
6264	402	1	1	10	0	414
6265	408	1	3	5	0	417
6266	18	2	404	0	0	424
6267	7	372	9	4	0	392
6268	4	388	6	2	0	400
6269	368	9	3	7	0	387
6270	13	375	0	1	0	389
6271	4	7	366	0	0	377
6272	3	3	8	360	0	374
6273	352	3	2	10	0	367
6274	9	1	1	360	0	371
6275	356	0	0	10	0	366
6276	365	1	0	5	0	371
6277	363	0	2	4	0	369
6278	10	343	1	2	0	356
6279	5	361	1	1	0	368
6280	358	10	1	4	0	373
6281	351	2	1	5	0	359
6282	356	2	1	3	0	362
6283	12	1	2	341	0	356
6284	348	2	1	7	0	358
6285	9	330	0	3	0	342
6286	5	345	1	2	0	353
6287	2	9	1	337	0	349
6288	3	3	330	8	0	344
6289	0	1	332	6	0	339
6290	3	1	9	330	0	343
6291	3	1	331	7	0	342
6292	3	2	8	326	0	339
6293	334	3	2	10	0	349
6294	12	1	3	328	0	344
6295	330	0	1	9	0	340
6296	11	312	1	4	0	328
6297	5	8	321	2	0	336
6298	6	3	7	306	0	322
6299	3	2	2	328	0	335
6300	2	3	328	9	0	342
6301	3	4	7	315	0	329
6302	1	328	2	9	0	340
6303	3	7	4	329	0	343
6304	3	3	1	341	0	348
6305	5	1	0	350	0	356
6306	1	1	343	10	0	355
6307	4	0	308	5	0	317
6308	296	1	9	2	0	308
6309	7	1	296	1	0	305
6310	4	297	6	1	0	308
6311	298	7	4	1	0	310
6312	9	302	2	1	0	314
6313	292	7	2	2	0	303
6314	295	3	1	1	0	300
6315	284	4	2	3	0	293
6316	298	0	0	2	0	300
6317	9	277	1	0	0	287
6318	2	292	2	2	0	298
6319	284	5	0	7	0	296
6320	8	2	274	1	0	285
6321	2	3	6	270	0	281
6322	4	1	1	282	0	288
6323	3	0	273	6	0	282
6324	258	0	7	4	0	269
6325	268	3	1	4	0	276
6326	268	2	2	3	0	275
6327	8	262	1	2	0	273
6328	268	5	1	3	0	277
6329	10	0	2	259	0	271
6330	2	283	1	9	0	295
6331	293	6	1	2	0	302
6332	293	3	2	2	0	300
6333	311	4	1	2	0	318
6334	12	2	0	307	0	321
6335	7	0	5	310	0	322
6336	2	297	4	13	0	316
6337	2	8	303	9	0	322
6338	0	4	11	303	0	318
6339	4	2	4	301	0	311
6340	8	1	2	307	0	318
6341	1	1	299	16	0	317
6342	291	3	11	7	0	312
6343	13	2	5	302	0	322
6344	6	1	302	12	0	321
6345	5	1	10	304	0	320
6346	308	2	3	10	0	323
6347	11	314	5	5	0	335
6348	7	8	1	316	0	332
6349	2	6	318	11	0	337
6350	309	2	8	8	0	327
6351	316	1	4	6	0	327
6352	13	1	316	4	0	334
6353	9	0	11	295	0	315
6354	5	313	6	8	0	332
6355	325	8	2	3	0	338
6356	11	4	316	1	0	332
6357	307	5	8	5	0	325
6358	13	2	299	4	0	318
6359	6	3	280	0	0	289
6360	260	1	13	0	0	274
6361	14	256	5	1	0	276
6362	8	9	260	1	0	278
6363	3	252	8	2	0	265
6364	5	6	246	1	0	258
6365	4	251	4	2	0	261
6366	236	5	8	4	0	253
6367	7	6	234	3	0	250
6368	5	2	235	3	0	245
6369	2	4	236	4	0	246
6370	221	1	11	6	0	239
6371	232	2	6	4	0	244
6372	10	1	6	229	0	246
6373	4	0	248	7	0	259
6374	4	0	239	10	0	253
6375	233	4	8	4	0	249
6376	9	2	6	237	0	254
6377	239	3	5	8	0	255
6378	245	0	4	5	0	254
6379	14	2	3	228	0	247
6380	7	234	3	7	0	251
6381	10	4	3	233	0	250
6382	7	8	0	238	0	253
6383	4	3	238	10	0	255
6384	6	235	7	4	0	252
6385	5	233	7	3	0	248
6386	6	11	0	229	0	246
6387	4	3	232	6	0	245
6388	1	227	10	6	0	244
6389	5	7	229	4	0	245
6390	224	7	7	5	0	243
6391	218	2	10	6	0	236
6392	13	6	219	3	0	241
6393	224	2	12	5	0	243
6394	8	4	8	223	0	243
6395	10	233	3	8	0	254
6396	7	5	7	233	0	252
6397	223	7	3	6	0	239
6398	230	2	4	7	0	243
6399	224	4	5	3	0	236
6400	219	3	2	8	0	232
6401	14	211	3	3	0	231
6402	9	220	6	1	0	236
6403	219	7	4	4	0	234
6404	8	4	218	5	0	235
6405	8	4	6	212	0	230
6406	3	220	3	5	0	231
6407	7	5	3	217	0	232
6408	1	219	6	8	0	234
6409	5	8	1	226	0	240
6410	5	6	229	6	0	246
6411	219	1	7	9	0	236
6412	229	3	7	1	0	240
6413	11	1	228	4	0	244
6414	224	1	11	4	0	240
6415	224	1	6	6	0	237
6416	11	4	218	2	0	235
6417	4	5	8	211	0	228
6418	220	2	5	8	0	235
6419	8	3	214	4	0	229
6420	9	3	9	207	0	228
6421	5	1	233	9	0	248
6422	6	0	229	3	0	238
6423	224	2	14	2	0	242
6424	237	3	8	2	0	250
6425	240	0	5	2	0	247
6426	244	1	5	1	0	251
6427	16	3	1	229	0	249
6428	8	222	2	11	0	243
6429	5	235	4	5	0	249
6430	6	10	2	219	0	237
6431	211	5	4	10	0	230
6432	12	211	3	4	0	230
6433	3	194	0	0	0	197
6434	192	4	1	2	0	199
6435	6	1	0	192	0	199
6436	189	0	0	6	0	195
6437	3	189	2	1	0	195
6438	199	3	0	2	0	204
6439	5	1	203	2	0	211
6440	228	0	6	0	0	234
6441	245	0	3	2	0	250
6442	250	0	1	2	0	253
6443	15	0	214	0	0	229
6444	228	0	9	3	0	240
6445	12	232	3	1	0	248
6446	6	11	231	0	0	248
6447	2	3	9	220	0	234
6448	1	1	2	218	0	222
6449	1	222	1	13	0	237
6450	1	10	0	231	0	242
6451	2	3	0	240	0	245
6452	0	1	231	14	0	246
6453	216	0	12	5	0	233
6454	11	0	225	2	0	238
6455	4	1	12	220	0	237
6456	2	0	227	12	0	241
6457	1	0	12	227	0	240
6458	228	0	4	12	0	244
6459	240	0	1	2	0	243
6460	14	0	1	230	0	245
6461	4	1	233	12	0	250
6462	2	0	12	237	0	251
6463	0	0	235	13	0	248
6464	227	0	12	4	0	243
6465	237	0	2	3	0	242
6466	234	0	2	2	0	238
6467	238	0	1	1	0	240
6468	14	221	0	1	0	236
6469	4	11	1	227	0	243
6470	226	3	0	13	0	242
6471	11	214	1	4	0	230
6472	4	231	1	1	0	237
6473	4	12	220	0	0	236
6474	217	4	11	1	0	233
6475	228	2	4	2	0	236
6476	15	0	215	0	0	230
6477	5	0	11	212	0	228
6478	2	1	3	227	0	233
6479	0	0	220	15	0	235
6480	4	0	11	217	0	232
6481	213	0	4	13	0	230
6482	11	0	208	4	0	223
6483	3	0	220	2	0	225
6484	215	0	15	2	0	232
6485	12	0	211	1	0	224
6486	217	0	12	1	0	230
6487	14	214	3	0	0	231
6488	219	11	2	0	0	232
6489	12	3	1	216	0	232
6490	8	2	0	220	0	230
6491	218	1	2	13	0	234
6492	15	0	0	218	0	233
6493	216	1	0	12	0	229
6494	13	217	1	3	0	234
6495	4	12	0	211	0	227
6496	6	2	0	216	0	224
6497	207	1	1	15	0	224
6498	217	1	1	5	0	224
6499	216	2	0	1	0	219
6500	15	194	1	0	0	210
6501	5	213	1	2	0	221
6502	207	14	0	2	0	223
6503	14	4	201	1	0	220
6504	7	195	11	1	0	214
6505	177	9	8	2	0	196
6506	180	4	2	1	0	187
6507	176	2	0	1	0	179
6508	17	0	1	163	0	181
6509	168	1	2	10	0	181
6510	177	1	0	4	0	182
6511	15	1	0	159	0	175
6512	166	0	1	9	0	176
6513	13	0	157	4	0	174
6514	4	0	9	161	0	174
6515	2	2	4	165	0	173
6516	1	1	1	170	0	173
6517	159	0	0	17	0	176
6518	168	1	2	3	0	174
6519	166	1	1	2	0	170
6520	170	0	1	2	0	173
6521	162	0	1	2	0	165
6522	16	0	0	137	0	153
6523	7	0	0	150	0	157
6524	142	0	0	14	0	156
6525	13	136	1	3	0	153
6526	138	9	0	4	0	151
6527	14	1	127	0	0	142
6528	137	1	10	3	0	151
6529	149	0	2	3	0	154
6530	13	0	139	1	0	153
6531	145	1	5	2	0	153
6532	10	0	149	0	0	159
6533	6	0	157	0	0	163
6534	7	0	13	151	0	171
6535	7	0	7	161	0	175
6536	3	0	157	13	0	173
6537	2	1	166	5	0	174
6538	2	151	12	6	0	171
6539	2	149	6	1	0	158
6540	116	5	4	1	0	126
6541	1	126	2	3	0	132
6542	118	3	1	3	0	125
6543	4	116	2	1	0	123
6544	119	3	2	0	0	124
6545	3	6	110	0	0	119
6546	112	4	1	0	0	117
6547	6	1	3	106	0	116
6548	3	112	4	1	0	120
6549	4	1	1	114	0	120
6550	117	5	0	4	0	126
6551	118	2	1	2	0	123
6552	4	1	3	112	0	120
6553	7	0	111	2	0	120
6554	2	0	109	5	0	116
6555	0	116	2	2	0	120
6556	2	2	3	110	0	117
6557	3	1	111	1	0	116
6558	3	107	3	1	0	114
6559	0	2	2	109	0	113
6560	0	2	5	107	0	114
6561	101	2	2	3	0	108
6562	3	4	0	99	0	106
6563	2	0	98	7	0	107
6564	3	0	2	99	0	104
6565	99	3	2	2	0	106
6566	1	0	102	5	0	108
6567	101	0	2	5	0	108
6568	6	105	2	1	0	114
6569	107	1	2	4	0	114
6570	112	2	3	0	0	117
6571	6	2	0	113	0	121
6572	7	1	0	106	0	114
6573	3	111	1	3	0	118
6574	4	1	0	115	0	120
6575	111	5	0	4	0	120
6576	4	2	112	3	0	121
6577	6	1	1	108	0	116
6578	2	112	2	5	0	121
6579	2	1	2	114	0	119
6580	1	5	1	113	0	120
6581	111	2	0	6	0	119
6582	3	112	0	4	0	119
6583	3	1	3	115	0	122
6584	110	2	0	5	0	117
6585	3	5	0	111	0	119
6586	3	0	0	115	0	118
6587	115	0	0	7	0	122
6588	118	0	0	4	0	122
6589	3	3	114	3	0	123
6590	121	0	1	5	0	127
6591	122	0	2	0	0	124
6592	117	0	2	3	0	122
6593	5	116	1	3	0	125
6594	8	114	0	0	0	122
6595	7	2	0	116	0	125
6596	116	4	2	1	0	123
6597	120	2	0	2	0	124
6598	6	1	0	118	0	125
6599	6	0	118	2	0	126
6600	117	2	1	3	0	123
6601	124	2	2	2	0	130
6602	4	0	2	125	0	131
6603	7	0	1	122	0	130
6604	126	0	0	3	0	129
6605	2	0	0	126	0	128
6606	2	116	3	4	0	125
6607	5	1	0	127	0	133
6608	125	1	0	3	0	129
6609	2	2	120	5	0	129
6610	120	1	1	5	0	127
6611	6	0	119	0	0	125
6612	4	0	3	119	0	126
6613	121	3	1	1	0	126
6614	4	0	2	130	0	136
6615	5	0	1	127	0	133
6616	133	0	2	4	0	139
6617	5	0	126	4	0	135
6618	2	0	139	3	0	144
6619	2	0	3	143	0	148
6620	5	0	4	143	0	152
6621	1	0	3	147	0	151
6622	0	0	150	8	0	158
6623	142	0	1	4	0	147
6624	150	0	5	3	0	158
6625	147	0	5	1	0	153
6626	151	0	1	3	0	155
6627	6	140	0	3	0	149
6628	6	137	0	3	0	146
6629	3	145	2	0	0	150
6630	4	1	0	133	0	138
6631	2	0	0	132	0	134
6632	2	0	128	1	0	131
6633	0	119	1	0	0	120
6634	1	0	0	111	0	112
6635	110	0	0	1	0	111
6636	0	114	0	0	0	114
6637	0	0	0	113	0	113
6638	0	115	0	0	0	115
6639	115	0	0	0	0	115
6640	0	0	0	113	0	113
6641	0	0	115	0	0	115
6642	0	0	112	0	0	112
6643	0	1	0	118	0	119
6644	2	0	1	113	0	116
6645	0	0	0	117	0	117
6646	114	0	0	2	0	116
6647	1	1	111	1	0	114
6648	1	108	1	0	0	110
6649	0	1	1	111	0	113
6650	0	0	110	1	0	111
6651	0	112	1	1	0	114
6652	0	1	1	118	0	120
6653	0	1	118	1	0	120
6654	0	0	1	121	0	122
6655	0	0	1	125	0	126
6656	122	0	0	2	0	124
6657	122	0	0	2	0	124
6658	2	0	0	121	0	123
6659	123	0	0	1	0	124
6660	1	0	125	1	0	127
6661	1	0	1	124	0	126
6662	0	0	127	1	0	128
6663	1	1	1	124	0	127
6664	0	122	1	2	0	125
6665	0	133	0	1	0	134
6666	0	138	0	0	0	138
6667	1	2	0	138	0	141
6668	0	1	0	147	0	148
6669	0	0	144	4	0	148
6670	1	0	138	1	0	140
6671	1	0	141	0	0	142
6672	151	0	4	1	0	156
6673	3	0	1	161	0	165
6674	162	0	0	5	0	167
6675	4	167	0	1	0	172
6676	2	4	0	167	0	173
6677	174	1	0	4	0	179
6678	5	0	0	173	0	178
6679	175	0	0	5	0	180
6680	4	1	180	2	0	187
6681	2	181	4	0	0	187
6682	0	4	1	184	0	189
6683	182	1	0	6	0	189
6684	180	0	0	2	0	182
6685	4	0	0	182	0	186
6686	2	0	0	183	0	185
6687	179	0	0	7	0	186
6688	5	0	1	175	0	181
6689	2	0	179	4	0	185
6690	1	172	4	2	0	179
6691	1	4	2	177	0	184
6692	174	2	1	5	0	182
6693	175	1	0	2	0	178
6694	4	0	183	2	0	189
6695	4	180	4	0	0	188
6696	0	184	2	1	0	187
6697	1	6	0	184	0	191
6698	1	2	1	186	0	190
6699	1	1	0	191	0	193
6700	1	0	0	188	0	189
6701	1	184	1	7	0	193
6702	2	5	0	188	0	195
6703	0	2	0	194	0	196
6704	192	0	1	6	0	199
6705	192	2	0	3	0	197
6706	6	195	0	4	0	205
6707	204	3	2	2	0	211
6708	208	4	0	1	0	213
6709	207	0	1	3	0	211
6710	8	1	199	0	0	208
6711	3	1	2	207	0	213
6712	0	0	3	214	0	217
6713	2	2	204	7	0	215
6714	3	1	4	202	0	210
6715	0	0	3	189	0	192
6716	199	2	1	9	0	211
6717	6	1	198	4	0	209
6718	3	0	5	194	0	202
6719	189	0	1	7	0	197
6720	7	192	0	3	0	202
6721	188	6	2	4	0	200
6722	184	2	0	2	0	188
6723	8	167	0	1	0	176
6724	3	6	1	170	0	180
6725	172	4	1	6	0	183
6726	7	169	0	4	0	180
6727	4	6	0	173	0	183
6728	171	1	1	7	0	180
6729	173	0	1	6	0	180
6730	8	170	0	5	0	183
6731	169	5	1	2	0	177
6732	7	2	2	166	0	177
6733	167	1	0	9	0	177
6734	9	0	168	5	0	182
6735	5	1	5	164	0	175
6736	2	1	3	169	0	175
6737	164	0	1	8	0	173
6738	7	161	0	3	0	171
6739	160	5	0	3	0	168
6740	9	157	2	1	0	169
6741	1	8	149	1	0	159
6742	1	2	153	4	0	160
6743	4	0	8	145	0	157
6744	1	2	154	7	0	164
6745	1	2	5	148	0	156
6746	6	0	1	144	0	151
6747	2	2	1	150	0	155
6748	150	1	0	10	0	161
6749	154	1	1	1	0	157
6750	154	1	0	2	0	157
6751	9	149	0	2	0	160
6752	6	162	2	0	0	170
6753	0	11	169	2	0	182
6754	2	3	5	166	0	176
6755	3	1	164	8	0	176
6756	2	2	7	163	0	174
6757	1	2	3	171	0	177
6758	3	2	1	172	0	178
6759	1	3	164	10	0	178
6760	2	1	9	157	0	169
6761	153	1	5	9	0	168
6762	7	154	2	7	0	170
6763	4	6	2	162	0	174
6764	157	3	2	11	0	173
6765	155	1	2	6	0	164
6766	13	0	0	146	0	159
6767	7	3	0	140	0	150
6768	130	1	3	9	0	143
6769	9	1	1	130	0	141
6770	119	2	1	7	0	129
6771	5	1	3	115	0	124
6772	1	0	106	8	0	115
6773	1	93	4	6	0	104
6774	2	95	5	2	0	104
6775	2	5	1	94	0	102
6776	3	2	2	93	0	100
6777	91	0	1	6	0	98
6778	4	2	2	94	0	102
6779	2	2	0	96	0	100
6780	3	0	0	93	0	96
6781	0	90	1	6	0	97
6782	3	3	0	90	0	96
6783	2	1	0	93	0	96
6784	3	1	0	96	0	100
6785	86	1	1	8	0	96
6786	5	87	0	3	0	95
6787	3	5	0	91	0	99
6788	2	2	1	97	0	102
6789	1	1	2	99	0	103
6790	95	0	0	9	0	104
6791	5	2	2	96	0	105
6792	1	2	2	99	0	104
6793	0	1	93	8	0	102
6794	0	91	2	7	0	100
6795	2	3	3	94	0	102
6796	91	1	0	6	0	98
6797	3	89	0	4	0	96
6798	88	4	1	1	0	94
6799	93	3	1	1	0	98
6800	6	1	1	88	0	96
6801	3	0	0	92	0	95
6802	1	2	90	5	0	98
6803	1	2	3	98	0	104
6804	3	0	104	4	0	111
6805	3	0	3	103	0	109
6806	99	0	3	5	0	107
6807	3	102	1	5	0	111
6808	2	3	2	109	0	116
6809	0	3	1	112	0	116
6810	0	1	2	113	0	116
6811	3	0	0	115	0	118
6812	108	1	0	5	0	114
6813	3	108	1	3	0	115
6814	1	2	0	117	0	120
6815	112	0	1	5	0	118
6816	3	0	106	6	0	115
6817	106	1	2	3	0	112
6818	108	0	1	4	0	113
6819	4	1	107	2	0	114
6820	4	1	2	107	0	114
6821	113	0	3	2	0	118
6822	3	113	1	3	0	120
6823	116	2	2	3	0	123
6824	116	1	1	3	0	121
6825	118	1	1	3	0	123
6826	5	0	0	116	0	121
6827	3	1	1	117	0	122
6828	3	134	0	5	0	142
6829	3	2	1	141	0	147
6830	138	4	0	3	0	145
6831	3	0	135	6	0	144
6832	130	0	4	1	0	135
6833	142	1	2	1	0	146
6834	5	1	0	140	0	146
6835	2	0	0	146	0	148
6836	146	0	0	6	0	152
6837	139	0	1	4	0	144
6838	143	0	1	1	0	145
6839	4	0	136	3	0	143
6840	1	138	4	2	0	145
6841	138	4	2	2	0	146
6842	4	2	0	142	0	148
6843	3	140	0	5	0	148
6844	1	1	0	146	0	148
6845	141	2	1	2	0	146
6846	2	2	0	143	0	147
6847	3	0	144	6	0	153
6848	1	139	0	4	0	144
6849	0	147	1	2	0	150
6850	1	1	144	3	0	149
6851	135	2	1	3	0	141
6852	0	128	2	2	0	132
6853	1	0	0	114	0	115
6854	112	1	0	2	0	115
6855	0	116	0	1	0	117
6856	1	0	0	117	0	118
6857	117	0	0	1	0	118
6858	0	0	0	116	0	116
6859	118	0	0	0	0	118
6860	1	0	120	1	0	122
6861	1	118	0	0	0	119
6862	124	0	1	0	0	125
6863	123	1	0	1	0	125
6864	126	0	0	0	0	126
6865	1	0	119	0	0	120
6866	122	0	0	0	0	122
6867	123	0	1	2	0	126
6868	1	0	0	125	0	126
6869	123	0	0	2	0	125
6870	0	120	1	1	0	122
6871	1	0	0	125	0	126
6872	0	1	122	0	0	123
6873	0	0	0	121	0	121
6874	0	0	1	122	0	123
6875	123	0	0	1	0	124
6876	120	0	0	2	0	122
6877	1	0	118	0	0	119
6878	113	0	0	1	0	114
6879	1	0	116	0	0	117
6880	1	0	0	115	0	116
6881	0	0	118	0	0	118
6882	0	0	0	116	0	116
6883	0	111	1	0	0	112
6884	0	0	113	1	0	114
6885	0	1	116	0	0	117
6886	2	1	1	96	0	100
6887	116	0	1	1	0	118
6888	115	0	0	1	0	116
6889	112	0	0	1	0	113
6890	2	0	0	114	0	116
6891	1	0	0	112	0	113
6892	0	0	0	112	0	112
6893	0	0	0	115	0	115
6894	0	0	111	1	0	112
6895	0	0	0	111	0	111
6896	0	105	1	0	0	106
6897	0	0	0	112	0	112
6898	111	1	0	0	0	112
6899	0	0	108	1	0	109
6900	105	0	0	1	0	106
6901	0	0	105	0	0	105
6902	1	0	107	0	0	108
6903	0	101	2	0	0	103
6904	1	1	1	89	0	92
6905	0	0	0	101	0	101
6906	0	89	1	2	0	92
6907	105	2	0	1	0	108
6908	2	0	0	113	0	115
6909	1	0	1	123	0	125
6910	0	0	0	131	0	131
6911	138	0	0	7	0	145
6912	146	0	0	2	0	148
6913	6	0	0	145	0	151
6914	2	0	0	144	0	146
6915	139	1	1	8	0	149
6916	5	1	0	141	0	147
6917	1	0	1	147	0	149
6918	3	0	1	145	0	149
6919	2	2	138	7	0	149
6920	136	1	4	4	0	145
6921	142	0	0	5	0	147
6922	9	1	136	2	0	148
6923	2	0	5	131	0	138
6924	1	131	1	6	0	139
6925	128	4	2	4	0	138
6926	3	128	1	6	0	138
6927	4	128	0	3	0	135
6928	5	4	1	108	0	118
6929	107	1	3	7	0	118
6930	109	2	0	4	0	115
6931	7	2	1	108	0	118
6932	2	0	2	106	0	110
6933	2	3	0	111	0	116
6934	2	3	0	108	0	113
6935	3	1	2	105	0	111
6936	4	103	0	6	0	113
6937	4	6	0	106	0	116
6938	105	0	1	9	0	115
6939	109	2	0	4	0	115
6940	102	2	0	6	0	110
6941	7	101	0	6	0	114
6942	1	4	0	107	0	112
6943	2	3	100	7	0	112
6944	103	1	3	7	0	114
6945	8	1	1	109	0	119
6946	109	1	2	7	0	119
6947	113	0	0	3	0	116
6948	108	3	1	3	0	115
6949	8	1	0	107	0	116
6950	103	3	1	7	0	114
6951	8	2	0	104	0	114
6952	1	2	1	114	0	118
6953	113	1	1	5	0	120
6954	9	1	0	110	0	120
6955	108	0	0	9	0	117
6956	109	0	1	3	0	113
6957	8	1	0	107	0	116
6958	2	1	0	114	0	117
6959	3	0	1	113	0	117
6960	5	1	95	7	0	108
6961	1	0	105	8	0	114
6962	5	1	3	102	0	111
6963	6	0	1	106	0	113
6964	4	0	1	112	0	117
6965	3	1	0	113	0	117
6966	3	0	0	114	0	117
6967	103	1	2	9	0	115
6968	5	99	2	6	0	112
6969	2	4	2	108	0	116
6970	106	0	2	7	0	115
6971	6	1	1	107	0	115
6972	4	0	0	114	0	118
6973	107	0	1	11	0	119
6974	114	0	1	5	0	120
6975	4	2	103	8	0	117
6976	4	0	5	110	0	119
6977	6	1	107	6	0	120
6978	0	1	5	113	0	119
6979	4	0	0	108	0	112
6980	5	0	1	111	0	117
6981	5	1	101	9	0	116
6982	3	91	6	6	0	106
6983	4	103	0	6	0	113
6984	0	5	4	104	0	113
6985	99	1	0	10	0	110
6986	7	1	98	3	0	109
6987	2	0	103	5	0	110
6988	2	0	6	102	0	110
6989	1	2	2	105	0	110
6990	2	103	3	5	0	113
6991	3	5	0	105	0	113
6992	3	2	1	108	0	114
6993	1	1	2	110	0	114
6994	103	1	3	7	0	114
6995	112	0	0	5	0	117
6996	6	2	1	104	0	113
6997	1	101	1	8	0	111
6998	2	5	0	108	0	115
6999	105	2	1	7	0	115
7000	6	102	1	5	0	114
7001	2	4	1	100	0	107
7002	2	90	0	5	0	97
7003	94	4	1	4	0	103
7004	94	2	0	4	0	100
7005	2	89	0	5	0	96
7006	3	87	0	2	0	92
7007	1	3	81	2	0	87
7008	0	67	0	2	0	69
7009	0	3	1	61	0	65
7010	1	0	58	1	0	60
7011	0	37	0	0	0	37
7012	0	0	1	31	0	32
7013	0	0	0	30	0	30
7014	0	0	0	30	0	30
7015	30	0	0	0	0	30
7016	0	0	28	0	0	28
7017	1	0	27	0	0	28
7018	0	0	0	27	0	27
7019	0	0	31	0	0	31
7020	1	0	0	32	0	33
7021	0	0	0	30	0	30
7022	0	0	0	30	0	30
7023	0	0	0	31	0	31
7024	31	0	0	0	0	31
7025	30	0	0	1	0	31
7026	0	0	0	31	0	31
7027	0	0	33	0	0	33
7028	0	0	0	32	0	32
7029	0	29	0	0	0	29
7030	0	0	0	31	0	31
7031	30	0	0	1	0	31
7032	30	0	0	0	0	30
7033	0	0	0	29	0	29
7034	0	0	0	29	0	29
7035	0	0	0	31	0	31
7036	29	0	0	2	0	31
7037	0	0	31	0	0	31
7038	0	0	29	0	0	29
7039	0	27	0	0	0	27
7040	30	0	0	1	0	31
7041	0	0	0	30	0	30
7042	0	0	35	0	0	35
7043	1	35	0	0	0	36
7044	0	33	0	0	0	33
7045	0	0	0	34	0	34
7046	0	0	0	37	0	37
7047	0	35	0	0	0	35
7048	0	0	0	39	0	39
7049	0	0	0	38	0	38
7050	38	0	0	0	0	38
7051	0	38	1	0	0	39
7052	0	0	0	38	0	38
7053	0	0	35	0	0	35
7054	0	0	0	33	0	33
7055	35	0	0	0	0	35
7056	0	36	0	0	0	36
7057	0	0	0	36	0	36
7058	0	0	39	0	0	39
7059	0	0	43	0	0	43
7060	0	0	0	40	0	40
7061	0	0	0	42	0	42
7062	39	0	0	2	0	41
7063	0	42	0	0	0	42
7064	42	0	0	1	0	43
7065	0	0	43	0	0	43
7066	37	0	0	0	0	37
7067	0	0	45	0	0	45
7068	41	0	0	0	0	41
7069	46	0	0	0	0	46
7070	0	0	49	0	0	49
7071	1	0	46	0	0	47
7072	0	46	0	0	0	46
7073	0	1	0	49	0	50
7074	49	0	0	0	0	49
7075	0	0	0	47	0	47
7076	0	0	0	46	0	46
7077	1	0	0	46	0	47
7078	0	0	49	0	0	49
7079	44	0	0	0	0	44
7080	47	0	0	1	0	48
7081	0	47	0	0	0	47
7082	0	1	0	49	0	50
7083	0	52	1	0	0	53
7084	0	0	1	52	0	53
7085	55	0	0	1	0	56
7086	1	52	0	0	0	53
7087	0	1	0	53	0	54
7088	54	0	0	0	0	54
7089	52	0	1	0	0	53
7090	1	0	0	51	0	52
7091	0	0	50	0	0	50
7092	1	1	0	47	0	49
7093	1	51	1	0	0	53
7094	51	0	1	0	0	52
7095	0	50	1	0	0	51
7096	0	1	0	49	0	50
7097	53	1	0	1	0	55
7098	1	0	0	57	0	58
7099	0	0	0	56	0	56
7100	0	0	55	2	0	57
7101	0	56	0	2	0	58
7102	54	0	2	2	0	58
7103	55	1	0	0	0	56
7104	3	54	0	0	0	57
7105	0	52	0	1	0	53
7106	0	2	0	54	0	56
7107	52	2	0	1	0	55
7108	0	54	0	2	0	56
7109	2	0	0	55	0	57
7110	0	3	50	0	0	53
7111	0	0	0	54	0	54
7112	53	0	1	1	0	55
7113	1	52	0	2	0	55
7114	0	0	0	55	0	55
7115	0	1	56	0	0	57
7116	0	0	54	2	0	56
7117	2	1	1	54	0	58
7118	1	0	1	57	0	59
7119	0	59	0	1	0	60
7120	1	1	0	58	0	60
7121	59	1	0	1	0	61
7122	1	0	0	59	0	60
7123	58	1	0	1	0	60
7124	0	60	1	2	0	63
7125	0	63	1	0	0	64
7126	1	1	0	65	0	67
7127	2	1	0	67	0	70
7128	0	2	66	1	0	69
7129	0	1	0	66	0	67
7130	65	0	2	1	0	68
7131	1	0	64	1	0	66
7132	1	1	0	64	0	66
7133	0	0	68	2	0	70
7134	0	1	0	68	0	69
7135	0	0	1	65	0	66
7136	2	0	0	66	0	68
7137	0	1	66	2	0	69
7138	1	0	0	63	0	64
7139	0	68	2	0	0	70
7140	0	1	1	70	0	72
7141	0	1	0	71	0	72
7142	67	0	0	2	0	69
7143	0	1	67	1	0	69
7144	1	0	0	66	0	67
7145	2	0	65	0	0	67
7146	0	1	62	2	0	65
7147	0	0	1	64	0	65
7148	0	1	2	60	0	63
7149	0	0	0	72	0	72
7150	65	0	0	6	0	71
7151	0	0	70	3	0	73
7152	76	0	2	0	0	78
7153	0	0	1	84	0	85
7154	3	1	0	79	0	83
7155	0	94	0	2	0	96
7156	0	0	0	100	0	100
7157	1	1	1	95	0	98
7158	0	0	1	96	0	97
7159	90	0	0	2	0	92
7160	0	0	87	1	0	88
7161	79	0	1	0	0	80
7162	0	90	0	1	0	91
7163	85	0	0	1	0	86
7164	0	82	0	1	0	83
7165	1	82	0	0	0	83
7166	0	0	2	85	0	87
7167	86	0	0	0	0	86
7168	0	0	0	84	0	84
7169	0	83	0	1	0	84
7170	0	86	1	0	0	87
7171	0	0	0	93	0	93
7172	0	0	0	90	0	90
7173	0	88	0	1	0	89
7174	1	0	0	94	0	95
7175	0	0	1	96	0	97
7176	1	0	0	98	0	99
7177	103	0	0	0	0	103
7178	0	0	102	0	0	102
7179	102	0	0	1	0	103
7180	110	0	1	1	0	112
7181	108	0	0	1	0	109
7182	0	110	0	0	0	110
7183	0	0	0	111	0	111
7184	109	0	0	1	0	110
7185	0	0	0	111	0	111
7186	114	0	0	0	0	114
7187	0	119	0	0	0	119
7188	128	0	0	0	0	128
7189	130	0	0	0	0	130
7190	128	0	0	1	0	129
7191	0	0	0	132	0	132
7192	0	0	0	141	0	141
7193	143	0	0	1	0	144
7194	0	147	0	0	0	147
7195	0	147	1	1	0	149
7196	153	0	0	1	0	154
7197	0	0	0	152	0	152
7198	1	0	0	148	0	149
7199	0	0	0	154	0	154
7200	0	157	0	0	0	157
7201	155	0	0	0	0	155
7202	0	0	0	159	0	159
7203	0	161	0	0	0	161
7204	0	0	0	167	0	167
7205	0	0	0	167	0	167
7206	0	0	0	169	0	169
7207	0	0	0	165	0	165
7208	167	0	0	0	0	167
7209	164	0	0	1	0	165
7210	171	0	0	1	0	172
7211	0	0	0	175	0	175
7212	0	0	172	0	0	172
7213	1	0	156	0	0	157
7214	1	0	169	0	0	170
7215	182	0	0	0	0	182
7216	0	0	0	189	0	189
7217	0	0	0	184	0	184
7218	0	0	0	187	0	187
7219	184	0	0	2	0	186
7220	183	1	0	0	0	184
7221	0	212	0	0	0	212
7222	0	0	0	216	0	216
7223	1	0	218	1	0	220
7224	0	230	0	0	0	230
7225	0	0	0	235	0	235
7226	0	0	0	233	0	233
7227	0	0	0	230	0	230
7228	1	0	0	222	0	223
7229	0	0	228	0	0	228
7230	1	0	216	0	0	217
7231	1	233	1	0	0	235
7232	1	0	0	232	0	233
7233	0	1	0	232	0	233
7234	230	0	0	2	0	232
7235	1	0	238	0	0	239
7236	1	0	0	232	0	233
7237	2	0	1	241	0	244
7238	0	2	255	0	0	257
7239	1	252	0	0	0	253
7240	250	0	0	0	0	250
7241	1	0	248	0	0	249
7242	238	0	0	1	0	239
7243	1	0	273	1	0	275
7244	1	0	0	274	0	275
7245	0	1	287	0	0	288
7246	0	1	300	1	0	302
7247	2	0	0	309	0	311
7248	3	0	0	272	0	275
7249	1	0	0	332	0	333
7250	0	0	0	328	0	328
7251	0	1	0	313	0	314
7252	1	0	330	0	0	331
7253	1	0	314	1	0	316
7254	0	336	0	0	0	336
7255	343	0	0	2	0	345
7256	1	0	0	341	0	342
7257	339	0	0	1	0	340
7258	1	1	0	336	0	338
7259	357	0	0	4	0	361
7260	1	0	0	358	0	359
7261	1	0	0	356	0	357
7262	0	383	1	1	0	385
7263	2	0	1	395	0	398
7264	0	0	1	398	0	399
7265	2	0	1	388	0	391
7266	2	0	0	393	0	395
7267	1	394	0	1	0	396
7268	389	0	0	3	0	392
7269	0	391	1	0	0	392
7270	0	0	0	393	0	393
7271	383	0	0	2	0	385
7272	0	0	383	0	0	383
7273	0	0	380	0	0	380
7274	0	1	1	371	0	373
7275	0	0	0	385	0	385
7276	0	0	0	384	0	384
7277	2	0	1	362	0	365
7278	0	0	0	376	0	376
7279	0	375	0	0	0	375
7280	1	0	0	378	0	379
7281	372	0	0	4	0	376
7282	1	0	0	369	0	370
7283	0	1	370	1	0	372
7284	0	0	2	369	0	371
7285	369	0	0	2	0	371
7286	2	385	0	0	0	387
7287	0	1	0	383	0	384
7288	0	0	0	379	0	379
7289	0	0	375	2	0	377
7290	0	1	469	1	0	471
7291	568	0	9	3	0	580
7292	17	0	3	574	0	594
7293	3	0	3	604	0	610
7294	4	3	607	16	0	630
7295	0	0	617	9	0	626
7296	1	610	19	4	0	634
7297	1	15	9	612	0	637
7298	1	5	607	16	0	629
7299	0	607	17	7	0	631
7300	600	16	7	7	0	630
7301	615	5	6	2	0	628
7302	22	5	0	590	0	617
7303	9	596	2	17	0	624
7304	594	19	1	7	0	621
7305	21	7	0	566	0	594
7306	8	4	575	17	0	604
7307	5	577	19	7	0	608
7308	564	19	6	7	0	596
7309	588	7	5	3	0	603
7310	22	4	2	554	0	582
7311	11	1	0	570	0	582
7312	6	1	546	24	0	577
7313	2	1	19	553	0	575
7314	3	1	7	543	0	554
7315	4	0	4	560	0	568
7316	8	1	1	539	0	549
7317	3	0	1	539	0	543
7318	0	527	1	28	0	556
7319	518	18	1	14	0	551
7320	21	5	520	6	0	552
7321	8	511	19	3	0	541
7322	7	17	6	509	0	539
7323	510	8	7	23	0	548
7324	23	5	3	512	0	543
7325	18	1	3	521	0	543
7326	7	1	5	527	0	540
7327	4	3	3	532	0	542
7328	5	3	489	32	0	529
7329	4	502	22	15	0	543
7330	502	21	9	13	0	545
7331	21	7	499	8	0	535
7332	9	7	22	501	0	539
7333	498	4	9	29	0	540
7334	20	495	10	11	0	536
7335	502	22	4	13	0	541
7336	30	8	1	485	0	524
7337	11	5	4	526	0	546
7338	13	5	0	524	0	542
7339	8	1	0	529	0	538
7340	500	5	4	30	0	539
7341	25	2	1	513	0	541
7342	10	2	3	529	0	544
7343	484	5	5	29	0	523
7344	21	3	475	20	0	519
7345	14	0	21	497	0	532
7346	476	4	7	27	0	514
7347	488	0	4	23	0	515
7348	34	2	2	469	0	507
7349	15	4	4	478	0	501
7350	9	454	5	32	0	500
7351	4	23	3	472	0	502
7352	8	8	0	478	0	494
7353	6	5	450	32	0	493
7354	5	4	452	21	0	482
7355	7	444	24	13	0	488
7356	5	22	13	447	0	487
7357	3	7	10	466	0	486
7358	442	9	3	34	0	488
7359	27	5	6	433	0	471
7360	14	3	428	31	0	476
7361	9	1	25	444	0	479
7362	5	5	414	35	0	459
7363	8	3	433	18	0	462
7364	8	3	24	416	0	451
7365	6	3	14	433	0	456
7366	411	7	7	36	0	461
7367	439	0	5	19	0	463
7368	30	6	3	423	0	462
7369	433	0	6	27	0	466
7370	436	5	2	20	0	463
7371	32	3	3	431	0	469
7372	20	3	0	448	0	471
7373	429	3	3	39	0	474
7374	439	2	2	26	0	469
7375	29	2	8	428	0	467
7376	16	412	2	32	0	462
7377	12	22	1	433	0	468
7378	13	5	4	450	0	472
7379	6	3	409	35	0	453
7380	8	3	17	444	0	472
7381	411	4	10	35	0	460
7382	26	417	5	15	0	463
7383	422	16	8	13	0	459
7384	420	8	5	10	0	443
7385	435	4	5	11	0	455
7386	35	4	1	412	0	452
7387	11	4	394	30	0	439
7388	10	5	394	17	0	426
7389	8	378	22	11	0	419
7390	6	249	9	4	0	268
7391	3	126	0	3	0	132
7392	3	125	5	2	0	135
7393	4	7	113	2	0	126
7394	80	2	3	0	0	85
7395	4	0	1	78	0	83
7396	2	0	0	79	0	81
7397	1	0	0	80	0	81
7398	0	78	0	3	0	81
7399	73	2	0	2	0	77
7400	2	1	72	1	0	76
7401	1	73	2	1	0	77
7402	0	1	1	73	0	75
7403	72	0	0	1	0	73
7404	1	1	0	71	0	73
7405	1	0	69	1	0	71
7406	1	0	69	0	0	70
7407	1	0	1	71	0	73
7408	0	0	0	70	0	70
7409	71	0	0	1	0	72
7410	1	0	72	0	0	73
7411	70	0	1	0	0	71
7412	75	0	0	0	0	75
7413	1	0	0	76	0	77
7414	0	0	75	2	0	77
7415	1	0	1	75	0	77
7416	78	0	0	1	0	79
7417	1	77	0	0	0	78
7418	74	0	0	0	0	74
7419	1	0	0	77	0	78
7420	0	84	0	2	0	86
7421	1	1	0	86	0	88
7422	0	0	0	88	0	88
7423	0	84	0	3	0	87
7424	0	1	0	87	0	88
7425	0	0	0	88	0	88
7426	0	0	0	91	0	91
7427	0	0	88	2	0	90
7428	0	87	1	0	0	88
7429	85	2	0	0	0	87
7430	3	0	0	86	0	89
7431	0	89	0	1	0	90
7432	90	3	0	0	0	93
7433	2	1	0	92	0	95
7434	0	0	0	93	0	93
7435	0	1	1	94	0	96
7436	1	0	0	94	0	95
7437	93	0	0	4	0	97
7438	2	1	1	92	0	96
7439	2	1	0	93	0	96
7440	90	0	0	3	0	93
7441	4	0	0	93	0	97
7442	0	0	90	4	0	94
7443	0	0	3	94	0	97
7444	86	0	2	3	0	91
7445	2	1	0	90	0	93
7446	1	1	89	2	0	93
7447	0	1	83	2	0	86
7448	84	1	3	0	0	88
7449	90	0	2	1	0	93
7450	92	0	0	0	0	92
7451	90	0	1	1	0	92
7452	4	0	89	1	0	94
7453	2	0	2	87	0	91
7454	1	1	1	91	0	94
7455	89	0	0	3	0	92
7456	1	0	2	90	0	93
7457	1	1	89	3	0	94
7458	0	0	1	90	0	91
7459	2	1	91	1	0	95
7460	0	89	1	3	0	93
7461	92	1	3	1	0	97
7462	2	1	1	88	0	92
7463	1	0	90	1	0	92
7464	0	1	1	88	0	90
7465	3	0	1	87	0	91
7466	0	0	90	2	0	92
7467	1	0	2	89	0	92
7468	85	0	1	2	0	88
7469	1	1	81	2	0	85
7470	85	0	2	0	0	87
7471	1	87	1	2	0	91
7472	3	1	78	0	0	82
7473	0	2	80	0	0	82
7474	2	1	2	64	0	69
7475	0	1	1	71	0	73
7476	0	0	74	2	0	76
7477	1	0	2	75	0	78
7478	74	0	1	2	0	77
7479	74	0	0	2	0	76
7480	2	0	1	70	0	73
7481	1	0	0	73	0	74
7482	1	70	0	2	0	73
7483	75	1	0	2	0	78
7484	2	2	0	74	0	78
7485	2	73	0	2	0	77
7486	73	2	0	2	0	77
7487	74	1	0	1	0	76
7488	2	76	0	1	0	79
7489	1	2	0	76	0	79
7490	3	1	0	78	0	82
7491	1	0	77	3	0	81
7492	0	1	1	80	0	82
7493	76	0	1	3	0	80
7494	1	0	0	79	0	80
7495	1	0	74	1	0	76
7496	71	0	1	3	0	75
7497	3	0	1	75	0	79
7498	1	0	75	2	0	78
7499	0	0	3	76	0	79
7500	1	0	77	1	0	79
7501	2	0	1	74	0	77
7502	1	0	2	75	0	78
7503	76	0	0	2	0	78
7504	2	74	1	1	0	78
7505	73	1	1	0	0	75
7506	71	1	0	3	0	75
7507	78	0	0	1	0	79
7508	3	77	0	0	0	80
7509	2	1	73	1	0	77
7510	2	1	2	72	0	77
7511	78	0	1	2	0	81
7512	80	1	1	1	0	83
7513	2	1	1	78	0	82
7514	77	0	0	2	0	79
7515	1	1	74	2	0	78
7516	75	0	2	0	0	77
7517	1	0	71	2	0	74
7518	2	69	1	1	0	73
7519	63	0	4	0	0	67
7520	62	1	0	2	0	65
7521	2	62	1	0	0	65
7522	61	1	0	0	0	62
7523	62	1	0	0	0	63
7524	2	1	59	0	0	62
7525	54	1	0	0	0	55
7526	0	0	57	0	0	57
7527	2	0	0	49	0	51
7528	0	52	2	1	0	55
7529	1	0	52	1	0	54
7530	48	3	1	1	0	53
7531	48	0	0	0	0	48
7532	0	0	0	47	0	47
7533	0	0	47	0	0	47
7534	0	0	0	48	0	48
7535	48	0	0	0	0	48
7536	0	48	0	0	0	48
7537	43	0	0	0	0	43
7538	44	0	0	0	0	44
7539	0	42	0	0	0	42
7540	0	0	0	43	0	43
7541	43	0	0	0	0	43
7542	0	0	0	46	0	46
7543	0	0	0	50	0	50
7544	0	0	50	0	0	50
7545	0	0	1	50	0	51
7546	1	0	0	48	0	49
7547	48	0	0	0	0	48
7548	48	0	0	0	0	48
7549	0	0	0	47	0	47
7550	0	0	46	1	0	47
7551	0	1	47	0	0	48
7552	2	0	0	45	0	47
7553	0	0	47	1	0	48
7554	1	2	0	46	0	49
7555	0	0	0	43	0	43
7556	47	0	1	0	0	48
7557	0	1	42	0	0	43
7558	44	0	0	2	0	46
7559	43	0	1	1	0	45
7560	0	0	44	1	0	45
7561	0	0	44	2	0	46
7562	2	0	0	42	0	44
7563	0	42	1	1	0	44
7564	1	45	1	0	0	47
7565	2	0	0	43	0	45
7566	0	0	1	42	0	43
7567	0	0	2	41	0	43
7568	0	0	0	42	0	42
7569	39	1	0	0	0	40
7570	0	1	0	40	0	41
7571	0	0	38	1	0	39
7572	1	0	0	37	0	38
7573	0	37	0	1	0	38
7574	2	0	0	38	0	40
7575	40	0	0	0	0	40
7576	0	0	0	41	0	41
7577	0	0	42	0	0	42
7578	0	40	0	1	0	41
7579	0	1	0	39	0	40
7580	41	0	0	1	0	42
7581	40	0	0	0	0	40
7582	0	0	0	42	0	42
7583	0	0	38	0	0	38
7584	0	1	40	0	0	41
7585	40	0	0	1	0	41
7586	1	0	42	0	0	43
7587	1	0	39	0	0	40
7588	1	0	0	34	0	35
7589	41	0	1	0	0	42
7590	41	0	1	0	0	42
7591	41	0	1	0	0	42
7592	0	0	42	1	0	43
7593	0	0	44	1	0	45
7594	1	39	0	1	0	41
7595	2	0	0	39	0	41
7596	0	0	0	42	0	42
7597	1	0	1	39	0	41
7598	0	0	2	41	0	43
7599	0	0	39	1	0	40
7600	0	42	1	0	0	43
7601	44	0	0	2	0	46
7602	50	0	0	2	0	52
7603	53	0	0	1	0	54
7604	0	55	1	1	0	57
7605	1	0	1	52	0	54
7606	57	1	0	0	0	58
7607	1	57	1	0	0	59
7608	60	0	1	0	0	61
7609	1	56	0	1	0	58
7610	56	1	0	0	0	57
7611	58	1	0	0	0	59
7612	1	0	0	58	0	59
7613	0	1	0	61	0	62
7614	1	0	58	1	0	60
7615	1	1	56	0	0	58
7616	60	0	0	0	0	60
7617	60	0	0	1	0	61
7618	0	0	1	60	0	61
7619	0	0	0	61	0	61
7620	0	1	60	0	0	61
7621	0	0	1	60	0	61
7622	3	0	59	0	0	62
7623	1	0	0	60	0	61
7624	0	1	1	60	0	62
7625	61	1	0	1	0	63
7626	62	0	0	0	0	62
7627	1	1	0	61	0	63
7628	1	0	1	61	0	63
7629	0	1	61	2	0	64
7630	1	0	1	61	0	63
7631	2	0	62	0	0	64
7632	60	0	0	1	0	61
7633	0	0	1	63	0	64
7634	62	0	2	1	0	65
7635	0	63	2	1	0	66
7636	65	0	0	1	0	66
7637	1	0	1	63	0	65
7638	1	0	0	64	0	65
7639	0	63	0	2	0	65
7640	1	0	1	65	0	67
7641	0	1	63	1	0	65
7642	1	0	1	61	0	63
7643	0	0	58	2	0	60
7644	0	53	0	1	0	54
7645	1	1	0	56	0	58
7646	1	0	55	1	0	57
7647	0	0	49	1	0	50
7648	0	0	0	57	0	57
7649	54	0	1	0	0	55
7650	0	0	53	0	0	53
7651	0	0	1	57	0	58
7652	57	0	0	0	0	57
7653	0	59	0	1	0	60
7654	65	0	0	0	0	65
7655	0	1	1	62	0	64
7656	1	0	0	63	0	64
7657	0	0	0	65	0	65
7658	65	0	0	1	0	66
7659	0	0	0	64	0	64
7660	0	0	0	66	0	66
7661	65	0	1	0	0	66
7662	0	0	66	1	0	67
7663	0	0	1	65	0	66
7664	1	1	67	0	0	69
7665	67	0	0	1	0	68
7666	0	0	1	68	0	69
7667	1	0	70	0	0	71
7668	69	0	0	2	0	71
7669	69	1	0	0	0	70
7670	1	0	73	0	0	74
7671	0	1	0	70	0	71
7672	1	0	0	70	0	71
7673	1	1	72	0	0	74
7674	1	74	0	0	0	75
7675	0	0	75	2	0	77
7676	73	0	1	0	0	74
7677	0	0	78	1	0	79
7678	75	0	0	1	0	76
7679	1	0	77	1	0	79
7680	73	0	0	1	0	74
7681	1	78	0	1	0	80
7682	0	0	2	78	0	80
7683	0	0	0	80	0	80
7684	0	0	79	0	0	79
7685	1	0	0	76	0	77
7686	0	75	0	2	0	77
7687	77	0	1	0	0	78
7688	1	75	0	0	0	76
7689	1	0	0	79	0	80
7690	78	0	1	1	0	80
7691	0	77	1	1	0	79
7692	78	0	0	0	0	78
7693	0	0	82	0	0	82
7694	1	1	0	82	0	84
7695	0	0	1	83	0	84
7696	2	0	0	80	0	82
7697	82	1	1	0	0	84
7698	85	0	0	0	0	85
7699	79	0	1	1	0	81
7700	83	0	0	1	0	84
7701	0	3	77	0	0	80
7702	60	0	0	1	0	61
7703	0	66	0	0	0	66
7704	0	68	0	0	0	68
7705	71	0	3	0	0	74
7706	74	0	0	0	0	74
7707	0	0	0	72	0	72
7708	73	0	0	0	0	73
7709	73	0	0	0	0	73
7710	75	0	0	1	0	76
7711	0	0	0	77	0	77
7712	0	75	0	0	0	75
7713	0	75	0	0	0	75
7714	0	0	0	74	0	74
7715	73	0	0	0	0	73
7716	0	71	0	0	0	71
7717	0	0	0	68	0	68
7718	1	0	66	0	0	67
7719	61	0	0	0	0	61
7720	0	63	0	1	0	64
7721	1	63	0	0	0	64
7722	65	1	0	0	0	66
7723	0	0	63	1	0	64
7724	0	0	1	63	0	64
7725	1	65	0	0	0	66
7726	1	0	0	67	0	68
7727	0	1	0	66	0	67
7728	1	59	0	0	0	60
7729	1	0	1	65	0	67
7730	0	0	0	68	0	68
7731	65	1	0	3	0	69
7732	0	64	0	1	0	65
7733	68	0	0	1	0	69
7734	0	1	0	66	0	67
7735	0	67	0	1	0	68
7736	0	0	65	1	0	66
7737	1	0	0	67	0	68
7738	0	1	0	71	0	72
7739	1	0	73	0	0	74
7740	67	0	0	2	0	69
7741	0	1	0	75	0	76
7742	76	0	0	0	0	76
7743	0	0	73	1	0	74
7744	0	0	0	72	0	72
7745	0	0	75	0	0	75
7746	2	0	0	77	0	79
7747	0	0	0	78	0	78
7748	76	0	0	1	0	77
7749	0	71	1	0	0	72
7750	72	0	0	2	0	74
7751	0	0	75	0	0	75
7752	0	0	0	76	0	76
7753	0	0	76	1	0	77
7754	69	0	0	0	0	69
7755	76	1	0	0	0	77
7756	2	0	71	0	0	73
7757	71	0	1	0	0	72
7758	76	0	0	1	0	77
7759	0	0	0	78	0	78
7760	1	0	76	0	0	77
7761	1	0	80	0	0	81
7762	0	0	1	81	0	82
7763	1	0	0	78	0	79
7764	0	77	0	0	0	77
7765	0	79	0	1	0	80
7766	77	0	0	1	0	78
7767	0	0	1	79	0	80
7768	0	76	0	1	0	77
7769	0	78	0	1	0	79
7770	73	1	0	0	0	74
7771	2	1	0	75	0	78
7772	1	85	0	0	0	86
7773	0	0	0	82	0	82
7774	1	0	0	79	0	80
7775	1	1	0	79	0	81
7776	77	0	0	1	0	78
7777	0	79	0	1	0	80
7778	0	1	0	81	0	82
7779	2	0	0	79	0	81
7780	0	0	0	80	0	80
7781	0	0	79	1	0	80
7782	78	0	0	0	0	78
7783	0	1	0	81	0	82
7784	80	0	0	0	0	80
7785	80	0	0	1	0	81
7786	79	0	0	2	0	81
7787	0	0	78	0	0	78
7788	1	82	0	0	0	83
7789	0	0	0	82	0	82
7790	1	0	82	0	0	83
7791	2	0	79	0	0	81
7792	2	0	0	70	0	72
7793	1	73	1	0	0	75
7794	75	0	0	1	0	76
7795	74	0	0	2	0	76
7796	76	0	1	1	0	78
7797	73	0	1	0	0	74
7798	0	0	71	1	0	72
7799	71	1	0	1	0	73
7800	1	73	0	0	0	74
7801	1	0	0	77	0	78
7802	1	0	0	78	0	79
7803	76	0	0	0	0	76
7804	0	0	1	76	0	77
7805	0	0	74	0	0	74
7806	66	1	0	2	0	69
7807	73	0	0	1	0	74
7808	67	0	0	2	0	69
7809	0	1	73	0	0	74
7810	63	0	0	1	0	64
7811	0	67	1	0	0	68
7812	67	0	0	1	0	68
7813	0	0	0	67	0	67
7814	1	0	0	64	0	65
7815	0	67	0	0	0	67
7816	0	0	0	66	0	66
7817	0	64	0	0	0	64
7818	0	0	0	64	0	64
7819	0	62	0	0	0	62
7820	0	0	0	63	0	63
7821	0	61	0	0	0	61
7822	0	0	0	63	0	63
7823	0	72	0	0	0	72
7824	74	0	0	0	0	74
7825	0	0	0	74	0	74
7826	0	0	0	72	0	72
7827	0	0	0	71	0	71
7828	0	0	0	70	0	70
7829	0	0	71	1	0	72
7830	0	0	0	71	0	71
7831	0	0	1	72	0	73
7832	70	0	0	3	0	73
7833	71	0	0	1	0	72
7834	1	68	0	0	0	69
7835	1	0	0	70	0	71
7836	0	1	0	68	0	69
7837	75	0	0	3	0	78
7838	2	0	72	1	0	75
7839	70	0	2	0	0	72
7840	2	73	1	0	0	76
7841	67	2	0	0	0	69
7842	66	1	0	1	0	68
7843	3	63	0	1	0	67
7844	3	64	0	1	0	68
7845	0	4	1	62	0	67
7846	1	1	59	4	0	65
7847	55	0	2	2	0	59
7848	3	1	58	1	0	63
7849	54	0	3	2	0	59
7850	2	1	59	2	0	64
7851	1	60	3	2	0	66
7852	2	2	1	60	0	65
7853	60	1	1	2	0	64
7854	58	1	0	1	0	60
7855	5	0	1	55	0	61
7856	59	2	0	3	0	64
7857	59	0	0	3	0	62
7858	6	55	1	1	0	63
7859	61	3	0	1	0	65
7860	3	60	0	1	0	64
7861	6	2	0	62	0	70
7862	60	3	2	2	0	67
7863	63	2	0	4	0	69
7864	68	1	1	1	0	71
7865	7	1	62	2	0	72
7866	4	0	66	0	0	70
7867	2	1	5	60	0	68
7868	1	0	4	65	0	70
7869	2	65	0	6	0	73
7870	64	2	2	4	0	72
7871	2	6	2	66	0	76
7872	7	0	0	62	0	69
7873	0	1	60	7	0	68
7874	2	64	2	5	0	73
7875	3	62	6	1	0	72
7876	1	7	0	65	0	73
7877	65	5	0	4	0	74
7878	3	2	1	69	0	75
7879	8	1	1	62	0	72
7880	63	2	0	8	0	73
7881	62	0	2	7	0	71
7882	8	0	1	62	0	71
7883	6	0	60	4	0	70
7884	1	1	2	66	0	70
7885	2	1	5	64	0	72
7886	63	0	1	9	0	73
7887	4	0	0	67	0	71
7888	68	0	1	5	0	74
7889	3	2	64	6	0	75
7890	7	1	2	65	0	75
7891	1	1	5	69	0	76
7892	2	0	0	77	0	79
7893	3	0	2	70	0	75
7894	3	1	1	73	0	78
7895	1	1	67	9	0	78
7896	71	0	2	6	0	79
7897	6	0	5	68	0	79
7898	5	1	68	5	0	79
7899	0	0	66	7	0	73
7900	1	0	8	66	0	75
7901	67	0	6	4	0	77
7902	65	1	0	7	0	73
7903	71	0	3	2	0	76
7904	9	0	1	60	0	70
7905	5	67	2	5	0	79
7906	69	3	1	6	0	79
7907	70	6	0	4	0	80
7908	78	1	0	1	0	80
7909	76	0	1	3	0	80
7910	8	1	0	71	0	80
7911	7	0	65	5	0	77
7912	5	0	3	73	0	81
7913	2	1	73	4	0	80
7914	68	1	3	5	0	77
7915	68	1	7	3	0	79
7916	9	0	70	2	0	81
7917	74	0	2	4	0	80
7918	76	0	6	4	0	86
7919	11	0	1	73	0	85
7920	7	71	1	4	0	83
7921	76	3	2	7	0	88
7922	4	5	2	69	0	80
7923	7	63	0	4	0	74
7924	1	2	0	67	0	70
7925	2	4	62	2	0	70
7926	1	61	2	6	0	70
7927	63	2	4	1	0	70
7928	65	5	1	0	0	71
7929	65	0	0	3	0	68
7930	63	0	0	1	0	64
7931	6	1	0	58	0	65
7932	4	57	1	3	0	65
7933	60	2	0	5	0	67
7934	3	4	58	0	0	65
7935	5	56	2	0	0	63
7936	1	0	58	2	0	61
7937	0	4	1	47	0	52
7938	0	44	5	0	0	49
7939	1	0	0	54	0	55
7940	1	4	57	0	0	62
7941	1	0	0	62	0	63
7942	1	0	4	58	0	63
7943	1	0	0	62	0	63
7944	55	1	0	5	0	61
7945	1	57	0	4	0	62
7946	4	0	0	57	0	61
7947	57	4	0	1	0	62
7948	1	55	0	4	0	60
7949	61	0	0	1	0	62
7950	0	3	61	0	0	64
7951	4	0	0	57	0	61
7952	0	59	4	0	0	63
7953	62	0	0	2	0	64
7954	1	3	58	0	0	62
7955	3	58	1	0	0	62
7956	1	0	2	53	0	56
7957	1	1	0	55	0	57
7958	55	0	0	2	0	57
7959	0	1	0	56	0	57
7960	3	0	52	0	0	55
7961	1	0	0	53	0	54
7962	0	1	56	0	0	57
7963	0	0	0	52	0	52
7964	0	54	3	0	0	57
7965	54	1	0	2	0	57
7966	56	2	0	0	0	58
7967	2	51	0	0	0	53
7968	1	50	0	0	0	51
7969	0	0	0	51	0	51
7970	52	0	0	0	0	52
7971	0	0	0	51	0	51
7972	51	0	0	0	0	51
7973	0	52	0	0	0	52
7974	0	0	0	53	0	53
7975	0	0	52	0	0	52
7976	0	0	0	53	0	53
7977	0	0	0	51	0	51
7978	54	0	0	0	0	54
7979	0	54	0	0	0	54
7980	0	0	0	56	0	56
7981	56	0	0	0	0	56
7982	0	0	54	0	0	54
7983	54	0	0	0	0	54
7984	0	0	0	55	0	55
7985	0	56	0	0	0	56
7986	57	0	0	0	0	57
7987	0	0	56	0	0	56
7988	0	0	55	0	0	55
7989	0	56	0	0	0	56
7990	54	0	0	0	0	54
7991	0	0	0	57	0	57
7992	0	0	0	56	0	56
7993	57	0	0	0	0	57
7994	0	1	53	0	0	54
7995	0	0	0	59	0	59
7996	0	0	62	0	0	62
7997	0	0	0	59	0	59
7998	0	62	0	1	0	63
7999	0	0	0	65	0	65
8000	0	0	62	0	0	62
8001	62	0	0	0	0	62
8002	0	0	0	62	0	62
8003	0	0	62	0	0	62
8004	0	0	0	62	0	62
8005	0	0	0	59	0	59
8006	0	0	62	0	0	62
8007	0	0	63	0	0	63
8008	0	0	0	63	0	63
8009	0	0	63	0	0	63
8010	58	0	0	0	0	58
8011	0	0	0	61	0	61
8012	63	0	0	0	0	63
8013	0	0	65	0	0	65
8014	0	0	0	64	0	64
8015	0	0	72	0	0	72
8016	0	72	0	0	0	72
8017	0	0	71	0	0	71
8018	0	0	67	0	0	67
8019	67	0	0	0	0	67
8020	70	0	0	1	0	71
8021	0	0	74	0	0	74
8022	0	0	0	70	0	70
8023	2	0	0	71	0	73
8024	0	0	81	1	0	82
8025	0	80	1	0	0	81
8026	78	1	0	0	0	79
8027	1	0	80	0	0	81
8028	0	0	1	74	0	75
8029	1	0	1	80	0	82
8030	78	0	0	4	0	82
8031	79	0	0	1	0	80
8032	83	0	0	0	0	83
8033	84	1	0	0	0	85
8034	1	0	0	78	0	79
8035	1	0	92	1	0	94
8036	1	0	2	90	0	93
8037	1	0	0	90	0	91
8038	0	0	0	93	0	93
8039	0	1	89	1	0	91
8040	86	0	1	0	0	87
8041	1	0	1	89	0	91
8042	0	0	95	1	0	96
8043	0	95	1	0	0	96
8044	1	1	0	102	0	104
8045	0	0	0	101	0	101
8046	99	0	0	1	0	100
8047	2	105	0	0	0	107
8048	0	2	103	0	0	105
8049	0	0	1	105	0	106
8050	0	0	1	106	0	107
8051	103	0	0	0	0	103
8052	101	1	0	0	0	102
8053	1	0	0	103	0	104
8054	100	0	1	2	0	103
8055	2	101	0	0	0	103
8056	0	1	112	0	0	113
8057	1	0	2	111	0	114
8058	1	0	0	114	0	115
8059	1	0	0	114	0	115
8060	0	0	1	113	0	114
8061	0	112	0	1	0	113
8062	115	1	0	1	0	117
8063	1	0	1	115	0	117
8064	0	120	0	1	0	121
8065	124	1	0	1	0	126
8066	125	0	0	0	0	125
8067	1	128	1	0	0	130
8068	0	1	0	133	0	134
8069	0	0	1	127	0	128
8070	1	1	0	126	0	128
8071	0	1	0	130	0	131
8072	132	0	1	2	0	135
8073	129	1	0	0	0	130
8074	4	133	0	0	0	137
8075	0	2	129	0	0	131
8076	0	1	2	127	0	130
8077	133	0	0	3	0	136
8078	4	134	0	0	0	138
8079	0	135	0	0	0	135
8080	132	3	0	3	0	138
8081	137	1	1	1	0	140
8082	3	0	0	135	0	138
8083	0	0	144	4	0	148
8084	2	0	154	0	0	156
8085	168	1	3	0	0	172
8086	173	2	0	0	0	175
8087	166	0	1	0	0	167
8088	169	0	0	1	0	170
8089	170	0	0	2	0	172
8090	3	179	2	0	0	184
8091	1	4	1	178	0	184
8092	2	184	1	4	0	191
8093	190	3	1	1	0	195
8094	188	0	0	4	0	192
8095	190	0	1	0	0	191
8096	193	0	1	1	0	195
8097	5	187	0	0	0	192
8098	190	4	1	1	0	196
8099	4	190	1	1	0	196
8100	3	3	0	195	0	201
8101	194	1	0	5	0	200
8102	4	1	201	0	0	206
8103	4	0	3	189	0	196
8104	1	2	0	203	0	206
8105	2	0	208	4	0	214
8106	1	204	3	0	0	208
8107	202	3	0	2	0	207
8108	205	0	0	4	0	209
8109	5	207	1	1	0	214
8110	2	4	0	202	0	208
8111	1	1	210	3	0	215
8112	1	219	4	2	0	226
8113	219	5	0	1	0	225
8114	5	0	215	1	0	221
8115	204	2	3	2	0	211
8116	221	1	0	2	0	224
8117	4	0	225	1	0	230
8118	1	231	3	0	0	235
8119	4	4	1	223	0	232
8120	2	1	233	5	0	241
8121	220	1	4	2	0	227
8122	224	1	0	4	0	229
8123	4	223	1	1	0	229
8124	1	4	1	220	0	226
8125	4	2	1	224	0	231
8126	0	0	226	5	0	231
8127	1	241	3	2	0	247
8128	259	2	1	1	0	263
8129	259	2	1	3	0	265
8130	262	4	1	2	0	269
8131	6	0	259	3	0	268
8132	247	1	3	4	0	255
8133	257	0	1	4	0	262
8134	4	1	1	256	0	262
8135	2	1	251	2	0	256
8136	2	0	3	249	0	254
8137	3	1	260	3	0	267
8138	2	1	4	249	0	256
8139	2	254	0	2	0	258
8140	2	272	1	1	0	276
8141	1	2	1	273	0	277
8142	1	0	2	268	0	271
8143	271	1	2	5	0	279
8144	5	0	272	0	0	277
8145	265	0	2	1	0	268
8146	3	273	0	1	0	277
8147	266	3	2	4	0	275
8148	254	0	1	6	0	261
8149	4	0	2	259	0	265
8150	1	1	275	4	0	281
8151	1	1	4	265	0	271
8152	0	275	0	3	0	278
8153	1	3	1	280	0	285
8154	1	1	1	283	0	286
8155	283	2	0	3	0	288
8156	3	1	1	273	0	278
8157	1	269	0	5	0	275
8158	1	3	1	271	0	276
8159	270	1	0	7	0	278
8160	3	277	2	1	0	283
8161	2	2	0	286	0	290
8162	4	1	0	284	0	289
8163	3	2	0	289	0	294
8164	1	1	1	288	0	291
8165	289	0	0	8	0	297
8166	6	1	0	287	0	294
8167	1	1	1	294	0	297
8168	3	0	0	301	0	304
8169	1	299	0	5	0	305
8170	296	2	1	6	0	305
8171	3	1	296	2	0	302
8172	1	292	2	1	0	296
8173	288	3	0	4	0	295
8174	2	0	300	2	0	304
8175	2	314	2	0	0	318
8176	2	3	0	301	0	306
8177	0	309	2	1	0	312
8178	0	4	302	2	0	308
8179	4	0	305	2	0	311
8180	0	301	3	1	0	305
8181	294	2	1	3	0	300
8182	293	0	2	7	0	302
8183	1	2	291	2	0	296
8184	1	0	278	1	0	280
8185	2	2	299	0	0	303
8186	2	1	2	289	0	294
8187	2	0	2	284	0	288
8188	3	1	2	295	0	301
8189	1	2	304	3	0	310
8190	3	0	4	280	0	287
8191	0	2	1	288	0	291
8192	0	1	283	6	0	290
8193	275	2	2	5	0	284
8194	7	0	2	299	0	308
8195	1	1	4	297	0	303
8196	2	300	0	5	0	307
8197	292	4	0	7	0	303
8198	4	1	299	1	0	305
8199	285	2	5	0	0	292
8200	7	2	2	285	0	296
8201	2	0	298	4	0	304
8202	4	1	5	291	0	301
8203	284	1	3	8	0	296
8204	4	2	287	1	0	294
8205	274	0	6	6	0	286
8206	280	2	0	5	0	287
8207	287	0	4	3	0	294
8208	5	279	2	2	0	288
8209	5	4	3	289	0	301
8210	292	0	1	7	0	300
8211	290	3	0	7	0	300
8212	298	0	2	6	0	306
8213	9	0	285	0	0	294
8214	297	1	6	3	0	307
8215	11	0	2	318	0	331
8216	2	1	322	8	0	333
8217	8	0	7	321	0	336
8218	3	0	3	330	0	336
8219	2	0	334	10	0	346
8220	2	2	7	333	0	344
8221	2	0	4	339	0	345
8222	1	0	377	13	0	391
8223	393	0	10	8	0	411
8224	417	0	6	7	0	430
8225	19	1	8	419	0	447
8226	12	0	414	15	0	441
8227	13	1	14	402	0	430
8228	3	405	8	15	0	431
8229	9	12	4	408	0	433
8230	8	4	2	421	0	435
8231	408	4	2	23	0	437
8232	415	1	3	10	0	429
8233	421	1	4	10	0	436
8234	28	5	0	404	0	437
8235	12	0	2	421	0	435
8236	9	1	399	21	0	430
8237	7	3	12	381	0	403
8238	3	391	6	20	0	420
8239	386	15	6	10	0	417
8240	16	385	2	11	0	414
8241	388	16	3	4	0	411
8242	20	6	4	353	0	383
8243	9	379	3	16	0	407
8244	382	16	4	8	0	410
8245	387	7	3	10	0	407
8246	20	4	1	370	0	395
8247	12	367	6	17	0	402
8248	13	14	2	370	0	399
8249	4	10	363	22	0	399
8250	345	5	14	10	0	374
8251	16	354	9	7	0	386
8252	353	15	4	8	0	380
8253	21	10	1	349	0	381
8254	357	5	2	21	0	385
8255	23	2	350	8	0	383
8256	362	2	14	9	0	387
8257	373	5	7	6	0	391
8258	26	2	361	3	0	392
8259	16	2	14	359	0	391
8260	9	3	7	369	0	388
8261	355	0	10	25	0	390
8262	20	348	1	17	0	386
8263	14	18	1	351	0	384
8264	8	8	340	20	0	376
8265	3	8	344	13	0	368
8266	8	338	20	9	0	375
8267	10	15	347	3	0	375
8268	324	10	18	6	0	358
8269	18	4	9	315	0	346
8270	329	0	8	22	0	359
8271	19	3	318	13	0	353
8272	9	4	18	317	0	348
8273	10	4	7	330	0	351
8274	5	2	305	20	0	332
8275	6	3	19	311	0	339
8276	301	4	9	20	0	334
8277	313	2	8	12	0	335
8278	23	3	2	307	0	335
8279	313	2	2	17	0	334
8280	312	1	6	11	0	330
8281	24	287	4	8	0	323
8282	18	15	4	292	0	329
8283	290	8	6	21	0	325
8284	18	7	4	301	0	330
8285	295	1	2	26	0	324
8286	30	3	3	291	0	327
8287	12	6	285	21	0	324
8288	9	275	13	15	0	312
8289	11	11	12	241	0	275
8290	8	290	9	16	0	323
8291	276	21	3	12	0	312
8292	19	276	7	9	0	311
8293	10	283	6	5	0	304
8294	13	20	1	266	0	300
8295	264	8	2	22	0	296
8296	19	9	6	268	0	302
8297	263	4	1	27	0	295
8298	273	7	2	12	0	294
8299	18	260	4	8	0	290
8300	270	13	3	10	0	296
8301	280	9	3	5	0	297
8302	285	9	3	6	0	303
8303	27	5	260	6	0	298
8304	20	3	15	259	0	297
8305	15	4	6	271	0	296
8306	9	3	258	23	0	293
8307	261	2	14	15	0	292
8308	278	3	8	10	0	299
8309	274	3	8	9	0	294
8310	267	6	2	6	0	281
8311	31	245	5	6	0	287
8312	242	12	3	6	0	263
8313	27	6	2	228	0	263
8314	11	5	215	14	0	245
8315	196	3	8	8	0	215
8316	16	197	5	8	0	226
8317	182	14	5	2	0	203
8318	17	171	0	8	0	196
8319	10	162	2	6	0	180
8320	10	159	4	2	0	175
8321	3	172	4	3	0	182
8322	5	14	104	2	0	125
8323	2	9	6	75	0	92
8324	1	2	63	5	0	71
8325	47	0	4	2	0	53
8326	5	47	0	2	0	54
8327	0	50	2	1	0	53
8328	2	3	0	46	0	51
8329	0	0	0	49	0	49
8330	1	1	47	3	0	52
8331	0	2	48	1	0	51
8332	2	0	3	46	0	51
8333	0	1	47	3	0	51
8334	1	44	5	0	0	50
8335	0	5	0	47	0	52
8336	1	1	2	47	0	51
8337	1	1	44	4	0	50
8338	2	0	1	46	0	49
8339	46	0	0	4	0	50
8340	3	0	2	45	0	50
8341	1	0	0	50	0	51
8342	1	1	47	2	0	51
8343	46	0	3	1	0	50
8344	3	45	0	2	0	50
8345	2	2	1	46	0	51
8346	2	0	47	2	0	51
8347	0	1	2	47	0	50
8348	46	0	0	4	0	50
8349	3	0	44	0	0	47
8350	2	1	1	45	0	49
8351	2	0	48	3	0	53
8352	2	47	3	0	0	52
8353	1	1	46	3	0	51
8354	1	48	3	0	0	52
8355	1	1	38	0	0	40
8356	0	1	2	30	0	33
8357	0	35	0	0	0	35
8358	33	0	1	2	0	36
8359	1	0	0	37	0	38
8360	36	1	0	1	0	38
8361	2	0	0	39	0	41
8362	1	0	0	40	0	41
8363	40	1	0	0	0	41
8364	41	0	0	1	0	42
8365	2	0	0	42	0	44
8366	2	0	41	0	0	43
8367	1	43	1	0	0	45
8368	0	0	42	2	0	44
8369	0	43	1	1	0	45
8370	43	1	0	0	0	44
8371	1	0	40	0	0	41
8372	1	1	39	0	0	41
8373	2	0	0	40	0	42
8374	42	0	1	1	0	44
8375	0	1	50	0	0	51
8376	1	54	0	1	0	56
8377	58	0	0	1	0	59
8378	59	0	2	0	0	61
8379	59	1	0	0	0	60
8380	58	1	0	1	0	60
8381	60	0	0	0	0	60
8382	1	1	58	0	0	60
8383	2	2	0	55	0	59
8384	1	58	0	0	0	59
8385	57	1	1	1	0	60
8386	0	58	1	1	0	60
8387	55	0	0	1	0	56
8388	54	0	0	0	0	54
8389	0	53	0	0	0	53
8390	56	0	0	0	0	56
8391	0	0	0	57	0	57
8392	0	0	0	58	0	58
8393	0	0	56	0	0	56
8394	0	56	0	0	0	56
8395	0	0	0	58	0	58
8396	0	0	0	59	0	59
8397	0	0	0	57	0	57
8398	0	0	55	0	0	55
8399	50	0	0	0	0	50
8400	0	0	0	55	0	55
8401	55	0	0	1	0	56
8402	0	0	0	56	0	56
8403	0	0	59	0	0	59
8404	1	0	59	0	0	60
8405	55	0	0	0	0	55
8406	62	0	0	0	0	62
8407	0	59	0	0	0	59
8408	0	0	61	0	0	61
8409	0	0	0	60	0	60
8410	0	0	0	52	0	52
8411	67	0	0	2	0	69
8412	66	0	0	1	0	67
8413	66	0	0	2	0	68
8414	0	0	68	0	0	68
8415	69	0	0	2	0	71
8416	0	0	0	74	0	74
8417	1	0	0	73	0	74
8418	0	0	0	75	0	75
8419	0	74	0	0	0	74
8420	69	0	0	1	0	70
8421	0	0	0	71	0	71
8422	0	0	69	0	0	69
8423	1	0	0	69	0	70
8424	0	70	0	0	0	70
8425	71	0	0	0	0	71
8426	1	0	0	71	0	72
8427	0	0	0	70	0	70
8428	0	0	74	0	0	74
8429	0	0	0	73	0	73
8430	0	69	0	0	0	69
8431	0	0	0	70	0	70
8432	0	0	68	0	0	68
8433	62	0	0	1	0	63
8434	65	0	0	1	0	66
8435	0	65	0	1	0	66
8436	64	0	0	1	0	65
8437	69	0	0	1	0	70
8438	0	69	0	0	0	69
8439	0	1	0	68	0	69
8440	67	0	0	0	0	67
8441	0	68	1	1	0	70
8442	0	0	68	0	0	68
8443	71	0	0	0	0	71
8444	77	0	0	1	0	78
8445	76	0	0	1	0	77
8446	76	0	0	1	0	77
8447	0	79	0	0	0	79
8448	81	0	0	0	0	81
8449	79	0	0	2	0	81
8450	82	0	0	0	0	82
8451	0	0	0	82	0	82
8452	81	0	0	3	0	84
8453	0	88	0	0	0	88
8454	0	0	91	0	0	91
8455	1	0	0	91	0	92
8456	92	0	0	1	0	93
8457	0	0	93	0	0	93
8458	1	0	0	93	0	94
8459	0	1	92	0	0	93
8460	0	92	0	0	0	92
8461	0	0	0	95	0	95
8462	0	1	95	0	0	96
8463	0	96	1	0	0	97
8464	1	0	0	92	0	93
8465	92	0	0	2	0	94
8466	91	0	0	0	0	91
8467	94	0	0	1	0	95
8468	94	0	0	0	0	94
8469	92	0	0	0	0	92
8470	0	0	93	0	0	93
8471	88	0	0	2	0	90
8472	91	0	0	1	0	92
8473	1	0	0	90	0	91
8474	88	0	0	1	0	89
8475	87	0	0	1	0	88
8476	0	90	0	0	0	90
8477	0	0	0	93	0	93
8478	0	0	0	96	0	96
8479	95	0	0	1	0	96
8480	1	92	0	0	0	93
8481	0	94	0	0	0	94
8482	1	0	0	103	0	104
8483	0	0	0	103	0	103
8484	0	0	0	102	0	102
8485	0	0	0	104	0	104
8486	101	0	0	1	0	102
8487	95	0	0	0	0	95
8488	0	0	98	0	0	98
8489	0	0	0	97	0	97
8490	0	0	0	97	0	97
8491	0	1	93	0	0	94
8492	85	0	0	1	0	86
8493	0	94	0	0	0	94
8494	91	0	0	1	0	92
8495	0	0	0	94	0	94
8496	0	0	93	0	0	93
8497	1	0	0	96	0	97
8498	0	2	102	0	0	104
8499	1	105	0	1	0	107
8500	104	0	0	1	0	105
8501	104	0	1	0	0	105
8502	0	107	0	1	0	108
8503	0	0	0	101	0	101
8504	99	1	0	1	0	101
8505	1	104	0	0	0	105
8506	1	0	0	103	0	104
8507	100	1	0	0	0	101
8508	0	0	103	1	0	104
8509	97	0	0	0	0	97
8510	0	98	0	0	0	98
8511	105	0	0	1	0	106
8512	104	0	0	0	0	104
8513	0	0	105	0	0	105
8514	1	0	0	100	0	101
8515	1	1	0	97	0	99
8516	1	0	107	0	0	108
8517	1	0	0	104	0	105
8518	0	0	1	95	0	96
8519	105	0	0	2	0	107
8520	105	0	0	1	0	106
8521	0	0	1	105	0	106
8522	0	0	107	1	0	108
8523	0	0	0	108	0	108
8524	1	0	0	106	0	107
8525	1	0	108	0	0	109
8526	0	1	0	107	0	108
8527	110	0	1	0	0	111
8528	109	0	0	1	0	110
8529	0	109	0	1	0	110
8530	110	0	1	1	0	112
8531	107	0	0	4	0	111
8532	1	115	0	0	0	116
8533	117	0	0	0	0	117
8534	116	1	0	0	0	117
8535	122	0	0	0	0	122
8536	0	0	118	1	0	119
8537	112	1	0	0	0	113
8538	2	0	0	114	0	116
8539	117	0	0	0	0	117
8540	1	0	114	0	0	115
8541	0	110	1	0	0	111
8542	110	0	0	0	0	110
8543	1	103	0	1	0	105
8544	1	0	0	106	0	107
8545	0	0	1	108	0	109
8546	107	1	0	0	0	108
8547	99	0	0	3	0	102
8548	0	1	103	0	0	104
8549	1	0	97	1	0	99
8550	1	0	102	0	0	103
8551	1	0	0	99	0	100
8552	1	0	100	0	0	101
8553	0	0	97	0	0	97
8554	1	0	1	94	0	96
8555	100	0	0	0	0	100
8556	99	0	0	2	0	101
8557	105	0	1	0	0	106
8558	103	0	1	1	0	105
8559	1	0	0	103	0	104
8560	1	0	0	103	0	104
8561	2	0	117	0	0	119
8562	1	0	1	107	0	109
8563	2	0	0	106	0	108
8564	117	0	0	1	0	118
8565	114	0	0	2	0	116
8566	1	0	1	113	0	115
8567	121	0	0	4	0	125
8568	118	0	0	2	0	120
8569	3	0	0	121	0	124
8570	2	0	0	122	0	124
8571	0	2	115	2	0	119
8572	1	0	120	0	0	121
8573	1	0	2	121	0	124
8574	0	0	0	131	0	131
8575	0	0	127	2	0	129
8576	115	0	3	0	0	118
8577	114	0	1	1	0	116
8578	2	0	110	1	0	113
8579	1	112	1	1	0	115
8580	119	1	1	0	0	121
8581	3	1	128	0	0	132
8582	0	0	1	122	0	123
8583	1	0	1	128	0	130
8584	133	1	1	2	0	137
8585	147	0	0	1	0	148
8586	1	0	1	149	0	151
8587	2	0	1	152	0	155
8588	154	0	0	4	0	158
8589	155	0	0	3	0	158
8590	150	0	0	1	0	151
8591	3	0	156	0	0	159
8592	2	0	1	160	0	163
8593	1	0	0	159	0	160
8594	162	0	1	3	0	166
8595	1	154	1	3	0	159
8596	173	1	0	2	0	176
8597	3	169	2	1	0	175
8598	0	1	2	184	0	187
8599	2	0	1	182	0	185
8600	3	0	175	4	0	182
8601	2	0	4	179	0	185
8602	3	1	176	3	0	183
8603	4	0	4	178	0	186
8604	1	0	3	179	0	183
8605	1	170	0	6	0	177
8606	2	186	0	3	0	191
8607	2	3	1	175	0	181
8608	2	1	1	185	0	189
8609	0	1	0	191	0	192
8610	2	0	0	188	0	190
8611	3	0	0	189	0	192
8612	1	0	188	5	0	194
8613	2	0	3	181	0	186
8614	3	0	3	185	0	191
8615	2	0	178	6	0	186
8616	0	176	3	3	0	182
8617	1	3	1	182	0	187
8618	0	3	181	5	0	189
8619	0	179	3	4	0	186
8620	3	4	1	185	0	193
8621	190	2	0	8	0	200
8622	4	0	1	192	0	197
8623	3	1	1	192	0	197
8624	2	0	1	196	0	199
8625	0	0	2	194	0	196
8626	0	192	1	6	0	199
8627	1	3	1	198	0	203
8628	201	3	2	6	0	212
8629	3	2	0	211	0	216
8630	2	0	1	214	0	217
8631	1	2	0	214	0	217
8632	207	0	0	7	0	214
8633	210	0	0	5	0	215
8634	4	0	0	209	0	213
8635	196	0	1	8	0	205
8636	202	1	0	6	0	209
8637	5	199	0	4	0	208
8638	208	4	2	0	0	214
8639	2	204	0	4	0	210
8640	1	211	0	4	0	216
8641	3	3	2	210	0	218
8642	2	4	220	4	0	230
8643	2	0	3	219	0	224
8644	1	1	2	221	0	225
8645	2	224	0	6	0	232
8646	224	3	0	3	0	230
8647	6	1	1	219	0	227
8648	4	3	240	5	0	252
8649	3	1	3	235	0	242
8650	1	247	0	4	0	252
8651	246	4	0	4	0	254
8652	3	2	0	250	0	255
8653	1	0	250	5	0	256
8654	3	1	4	247	0	255
8655	1	241	1	6	0	249
8656	2	3	0	248	0	253
8657	250	2	0	6	0	258
8658	255	1	1	2	0	259
8659	257	0	0	4	0	261
8660	6	253	2	3	0	264
8661	247	3	0	3	0	253
8662	5	1	0	246	0	252
8663	247	0	2	4	0	253
8664	3	249	1	4	0	257
8665	3	4	2	251	0	260
8666	0	0	265	7	0	272
8667	250	2	3	3	0	258
8668	3	272	1	2	0	278
8669	4	3	0	271	0	278
8670	1	2	1	278	0	282
8671	3	0	1	271	0	275
8672	0	2	0	270	0	272
8673	2	268	0	6	0	276
8674	271	4	0	5	0	280
8675	272	1	0	7	0	280
8676	5	1	267	3	0	276
8677	3	1	3	269	0	276
8678	1	1	276	5	0	283
8679	265	1	4	3	0	273
8680	273	1	2	4	0	280
8681	264	0	1	5	0	270
8682	4	1	1	249	0	255
8683	2	253	0	7	0	262
8684	262	3	1	2	0	268
8685	6	2	0	246	0	254
8686	249	0	1	6	0	256
8687	4	2	239	3	0	248
8688	3	1	238	0	0	242
8689	240	0	3	3	0	246
8690	6	0	2	234	0	242
8691	235	0	1	8	0	244
8692	3	234	1	3	0	241
8693	233	5	0	2	0	240
8694	236	1	0	2	0	239
8695	5	0	230	3	0	238
8696	2	2	222	2	0	228
8697	1	224	4	3	0	232
8698	2	2	1	223	0	228
8699	231	0	1	3	0	235
8700	2	0	1	227	0	230
8701	2	1	1	223	0	227
8702	1	1	222	2	0	226
8703	216	1	2	0	0	219
8704	3	0	0	224	0	227
8705	2	0	216	2	0	220
8706	2	3	201	0	0	206
8707	2	1	1	207	0	211
8708	0	1	212	2	0	215
8709	1	0	207	0	0	208
8710	0	1	2	198	0	201
8711	0	0	204	3	0	207
8712	1	0	3	196	0	200
8713	2	195	2	1	0	200
8714	203	2	0	1	0	206
8715	1	209	1	0	0	211
8716	0	1	0	206	0	207
8717	0	215	0	2	0	217
8718	1	1	208	0	0	210
8719	0	2	1	228	0	231
8720	1	0	263	3	0	267
8721	257	1	6	1	0	265
8722	6	269	3	0	0	278
8723	270	6	1	4	0	281
8724	7	1	1	272	0	281
8725	273	1	0	9	0	283
8726	7	1	265	1	0	274
8727	1	267	7	1	0	276
8728	262	6	0	2	0	270
8729	7	2	2	242	0	253
8730	2	253	3	7	0	265
8731	3	7	1	254	0	265
8732	266	0	0	5	0	271
8733	7	277	2	0	0	286
8734	281	10	1	2	0	294
8735	10	0	271	2	0	283
8736	268	1	7	3	0	279
8737	12	2	1	272	0	287
8738	269	2	1	8	0	280
8739	10	269	2	0	0	281
8740	2	8	0	266	0	276
8741	3	1	0	282	0	286
8742	1	1	260	9	0	271
8743	5	3	7	249	0	264
8744	2	3	0	265	0	270
8745	6	0	1	265	0	272
8746	2	1	2	274	0	279
8747	2	0	261	13	0	276
8748	0	239	11	4	0	254
8749	5	10	1	249	0	265
8750	241	1	1	14	0	257
8751	241	2	2	4	0	249
8752	5	255	1	4	0	265
8753	253	7	1	8	0	269
8754	252	1	3	3	0	259
8755	257	4	1	3	0	265
8756	7	250	2	3	0	262
8757	245	7	2	6	0	260
8758	14	0	1	236	0	251
8759	1	3	238	9	0	251
8760	4	236	8	1	0	249
8761	4	7	0	237	0	248
8762	2	1	241	10	0	254
8763	236	3	8	3	0	250
8764	11	0	2	236	0	249
8765	5	0	2	240	0	247
8766	2	1	2	239	0	244
8767	5	4	0	237	0	246
8768	3	1	226	11	0	241
8769	206	1	10	4	0	221
8770	7	219	1	4	0	231
8771	220	8	3	5	0	236
8772	10	219	1	2	0	232
8773	224	11	1	3	0	239
8774	13	3	0	227	0	243
8775	4	3	230	9	0	246
8776	6	1	232	5	0	244
8777	8	2	9	231	0	250
8778	4	3	3	236	0	246
8779	3	3	2	236	0	244
8780	232	0	3	11	0	246
8781	8	5	228	5	0	246
8782	3	119	9	109	0	240
8783	5	234	2	8	0	249
8784	225	9	0	2	0	236
8785	12	2	223	5	0	242
8786	2	226	9	5	0	242
8787	3	8	229	3	0	243
8788	5	0	9	236	0	250
8789	2	3	230	15	0	250
8790	5	5	235	2	0	247
8791	6	2	6	238	0	252
8792	2	3	228	8	0	241
8793	4	6	239	2	0	251
8794	2	4	9	231	0	246
8795	228	0	2	12	0	242
8796	9	1	229	5	0	244
8797	5	3	11	217	0	236
8798	6	0	4	237	0	247
8799	224	2	4	12	0	242
8800	10	3	2	232	0	247
8801	225	1	2	18	0	246
8802	14	222	4	3	0	243
8803	5	8	4	229	0	246
8804	228	3	2	13	0	246
8805	235	6	1	4	0	246
8806	15	2	1	229	0	247
8807	2	2	228	12	0	244
8808	220	4	10	5	0	239
8809	10	225	3	6	0	244
8810	216	8	3	9	0	236
8811	223	1	4	7	0	235
8812	223	3	1	7	0	234
8813	11	2	216	6	0	235
8814	5	209	15	3	0	232
8815	7	11	4	206	0	228
8816	7	4	3	211	0	225
8817	6	2	203	11	0	222
8818	3	197	11	7	0	218
8819	2	155	0	5	0	162
8820	1	123	0	2	0	126
8821	115	2	3	2	0	122
8822	3	0	2	110	0	115
8823	3	0	1	105	0	109
8824	0	0	113	4	0	117
8825	108	0	3	2	0	113
8826	3	0	1	112	0	116
8827	1	0	1	114	0	116
8828	1	0	112	3	0	116
8829	0	111	3	0	0	114
8830	1	2	0	114	0	117
8831	0	0	112	2	0	114
8832	0	103	1	0	0	104
8833	85	0	2	0	0	87
8834	0	0	90	1	0	91
8835	0	0	1	86	0	87
8836	0	88	1	0	0	89
8837	90	0	0	1	0	91
8838	1	0	1	90	0	92
8839	88	0	1	1	0	90
8840	88	0	0	3	0	91
8841	2	91	0	0	0	93
8842	92	0	1	2	0	95
8843	92	0	0	2	0	94
8844	0	1	92	1	0	94
8845	89	0	0	0	0	89
8846	0	0	90	1	0	91
8847	90	0	0	1	0	91
8848	90	1	0	2	0	93
8849	0	0	96	1	0	97
8850	1	0	0	99	0	100
8851	1	0	95	0	0	96
8852	0	0	88	1	0	89
8853	1	0	91	0	0	92
8854	2	0	1	86	0	89
8855	0	0	0	98	0	98
8856	0	0	0	94	0	94
8857	0	0	0	92	0	92
8858	0	0	99	0	0	99
8859	0	0	0	104	0	104
8860	0	108	0	0	0	108
8861	0	0	113	0	0	113
8862	1	0	0	112	0	113
8863	0	0	118	0	0	118
8864	0	116	0	0	0	116
8865	0	115	0	0	0	115
8866	0	0	0	117	0	117
8867	0	0	115	0	0	115
8868	1	0	109	0	0	110
8869	0	0	0	110	0	110
8870	0	0	0	110	0	110
8871	0	0	0	114	0	114
8872	0	0	115	0	0	115
8873	0	114	0	0	0	114
8874	0	117	0	0	0	117
8875	0	0	0	117	0	117
8876	0	0	114	0	0	114
8877	0	0	117	0	0	117
8878	0	122	0	0	0	122
8879	120	0	0	0	0	120
8880	0	115	0	0	0	115
8881	0	0	122	0	0	122
8882	120	0	0	1	0	121
8883	1	0	0	128	0	129
8884	129	0	1	0	0	130
8885	1	0	0	127	0	128
8886	2	0	0	130	0	132
8887	134	0	0	1	0	135
8888	0	143	0	1	0	144
8889	0	1	144	1	0	146
8890	1	145	0	0	0	146
8891	141	1	0	1	0	143
8892	0	142	2	0	0	144
8893	138	1	0	1	0	140
8894	139	0	0	0	0	139
8895	0	139	0	1	0	140
8896	1	0	1	140	0	142
8897	135	0	0	1	0	136
8898	134	2	0	0	0	136
8899	0	0	1	137	0	138
8900	1	1	131	0	0	133
8901	1	0	124	0	0	125
8902	1	1	0	132	0	134
8903	0	1	131	0	0	132
8904	113	0	1	2	0	116
8905	0	129	1	1	0	131
8906	1	0	1	129	0	131
8907	2	0	0	132	0	134
8908	0	1	1	126	0	128
8909	4	0	0	122	0	126
8910	1	0	1	126	0	128
8911	0	2	127	1	0	130
8912	0	130	1	1	0	132
8913	127	0	0	2	0	129
8914	1	0	2	129	0	132
8915	0	1	1	123	0	125
8916	1	1	0	126	0	128
8917	1	129	0	1	0	131
8918	2	0	0	130	0	132
8919	1	0	2	129	0	132
8920	129	2	0	1	0	132
8921	0	128	0	2	0	130
8922	1	123	0	3	0	127
8923	4	0	1	126	0	131
8924	127	1	1	1	0	130
8925	1	2	125	1	0	129
8926	120	1	0	1	0	122
8927	1	0	129	1	0	131
8928	1	1	2	130	0	134
8929	1	1	0	133	0	135
8930	0	2	1	128	0	131
8931	2	0	0	128	0	130
8932	2	0	1	128	0	131
8933	128	1	1	1	0	131
8934	0	2	122	2	0	126
8935	1	0	0	126	0	127
8936	2	1	129	0	0	132
8937	0	132	2	1	0	135
8938	132	0	1	1	0	134
8939	0	0	142	1	0	143
8940	0	1	0	138	0	139
8941	3	0	1	143	0	147
8942	1	1	143	3	0	148
8943	1	2	139	1	0	143
8944	1	1	2	137	0	141
8945	141	0	1	4	0	146
8946	140	1	1	1	0	143
8947	3	144	1	2	0	150
8948	145	3	0	2	0	150
8949	5	0	1	142	0	148
8950	1	157	0	2	0	160
8951	3	3	0	154	0	160
8952	0	0	160	5	0	165
8953	1	1	2	156	0	160
8954	4	0	0	163	0	167
8955	158	1	1	4	0	164
8956	2	161	0	2	0	165
8957	154	1	1	1	0	157
8958	1	151	0	1	0	153
8959	142	3	1	0	0	146
8960	5	133	0	0	0	138
8961	0	143	0	0	0	143
8962	141	2	0	0	0	143
8963	1	1	0	137	0	139
8964	0	140	0	3	0	143
8965	144	2	1	3	0	150
8966	142	0	0	1	0	143
8967	143	1	0	1	0	145
8968	140	0	0	2	0	142
8969	2	142	0	0	0	144
8970	3	2	0	143	0	148
8971	3	0	0	146	0	149
8972	151	1	0	2	0	154
8973	4	0	0	147	0	151
8974	146	0	0	3	0	149
8975	2	0	142	0	0	144
8976	132	0	2	2	0	136
8977	3	0	141	1	0	145
8978	1	1	3	135	0	140
8979	140	0	0	3	0	143
8980	2	137	2	0	0	141
8981	130	1	0	1	0	132
8982	2	132	1	0	0	135
8983	1	2	0	151	0	154
8984	0	0	147	2	0	149
8985	138	0	2	1	0	141
8986	2	150	1	0	0	153
8987	1	2	0	143	0	146
8988	0	0	0	140	0	140
8989	1	0	0	134	0	135
8990	1	0	144	2	0	147
8991	0	145	2	0	0	147
8992	143	3	0	0	0	146
8993	147	0	0	4	0	151
8994	2	144	1	0	0	147
8995	152	2	1	1	0	156
8996	4	0	0	151	0	155
8997	0	146	1	2	0	149
8998	149	2	0	2	0	153
8999	2	0	149	1	0	152
9000	0	146	2	1	0	149
9001	1	2	0	151	0	154
9002	0	0	0	156	0	156
9003	0	0	155	2	0	157
9004	1	0	3	141	0	145
9005	0	0	147	3	0	150
9006	0	0	3	146	0	149
9007	1	1	0	145	0	147
9008	0	0	0	143	0	143
9009	1	0	1	146	0	148
9010	0	0	150	3	0	153
9011	0	1	152	1	0	154
9012	0	165	4	0	0	169
9013	0	5	1	168	0	174
9014	1	0	179	6	0	186
9015	0	176	7	0	0	183
9016	2	8	0	184	0	194
9017	0	1	184	7	0	192
9018	168	0	7	2	0	177
9019	190	0	0	2	0	192
9020	8	0	0	188	0	196
9021	0	0	192	8	0	200
9022	2	1	8	187	0	198
9023	189	0	0	10	0	199
9024	8	199	0	0	0	207
9025	205	8	0	3	0	216
9026	207	0	0	4	0	211
9027	11	0	0	202	0	213
9028	1	0	0	206	0	207
9029	1	0	0	208	0	209
9030	5	0	0	199	0	204
9031	0	0	0	202	0	202
9032	197	0	0	12	0	209
9033	202	0	0	1	0	203
9034	198	1	0	4	0	203
9035	8	1	190	0	0	199
9036	188	0	7	0	0	195
9037	11	1	0	188	0	200
9038	0	0	189	9	0	198
9039	1	179	9	0	0	189
9040	1	9	0	175	0	185
9041	0	0	0	178	0	178
9042	0	174	2	7	0	183
9043	3	7	0	178	0	188
9044	1	1	167	7	0	176
9045	0	0	184	1	0	185
9046	0	0	10	174	0	184
9047	170	0	0	11	0	181
9048	181	0	0	0	0	181
9049	10	1	176	0	0	187
9050	1	159	8	2	0	170
9051	1	175	0	1	0	177
9052	154	9	0	6	0	169
9053	10	0	163	1	0	174
9054	1	1	9	157	0	168
9055	159	0	0	10	0	169
9056	9	164	0	1	0	174
9057	1	169	0	1	0	171
9058	162	9	0	3	0	174
9059	10	0	0	164	0	174
9060	171	0	1	11	0	183
9061	10	0	0	179	0	189
9062	1	0	0	185	0	186
9063	1	1	185	10	0	197
9064	2	1	9	180	0	192
9065	1	0	0	195	0	196
9066	181	0	0	17	0	198
9067	12	1	1	184	0	198
9068	0	0	183	14	0	197
9069	172	0	14	1	0	187
9070	12	1	1	181	0	195
9071	171	0	0	17	0	188
9072	13	171	0	0	0	184
9073	1	182	0	2	0	185
9074	170	12	1	3	0	186
9075	185	0	1	5	0	191
9076	11	0	0	179	0	190
9077	2	0	169	13	0	184
9078	3	0	13	171	0	187
9079	169	0	1	14	0	184
9080	13	178	0	0	0	191
9081	1	13	1	172	0	187
9082	169	1	0	12	0	182
9083	13	0	157	1	0	171
9084	162	0	12	3	0	177
9085	171	1	0	0	0	172
9086	12	1	158	4	0	175
9087	0	1	167	1	0	169
9088	6	1	13	145	0	165
9089	2	0	0	174	0	176
9090	1	164	1	13	0	179
9091	2	12	3	163	0	180
9092	0	0	164	16	0	180
9093	4	0	14	161	0	179
9094	4	1	1	185	0	191
9095	0	0	176	16	0	192
9096	3	174	13	1	0	191
9097	3	14	0	178	0	195
9098	2	1	1	196	0	200
9099	182	0	3	14	0	199
9100	14	1	1	185	0	201
9101	1	1	185	15	0	202
9102	183	2	13	0	0	198
9103	195	3	1	1	0	200
9104	195	1	1	2	0	199
9105	14	2	182	2	0	200
9106	5	1	12	179	0	197
9107	4	0	0	195	0	199
9108	1	1	5	188	0	195
9109	176	2	1	16	0	195
9110	15	174	0	2	0	191
9111	1	12	163	4	0	180
9112	3	148	12	2	0	165
9113	3	149	2	3	0	157
9114	2	144	4	2	0	152
9115	6	6	5	134	0	151
9116	2	0	132	9	0	143
9117	122	0	8	3	0	133
9118	5	133	3	2	0	143
9119	126	6	0	5	0	137
9120	6	130	1	4	0	141
9121	132	6	0	2	0	140
9122	6	132	1	3	0	142
9123	0	7	133	1	0	141
9124	3	1	6	126	0	136
9125	2	0	0	135	0	137
9126	125	0	2	9	0	136
9127	7	2	2	133	0	144
9128	1	1	137	11	0	150
9129	3	0	8	139	0	150
9130	3	1	137	8	0	149
9131	1	136	8	7	0	152
9132	3	8	3	126	0	140
9133	2	140	2	9	0	153
9134	145	7	0	2	0	154
9135	8	3	0	144	0	155
9136	1	1	144	9	0	155
9137	3	0	145	3	0	151
9138	137	1	9	2	0	149
9139	8	1	2	137	0	148
9140	2	2	136	7	0	147
9141	1	2	138	3	0	144
9142	1	125	10	1	0	137
9143	0	7	1	118	0	126
9144	0	132	1	7	0	140
9145	3	5	1	129	0	138
9146	131	3	1	5	0	140
9147	5	0	1	132	0	138
9148	4	2	0	135	0	141
9149	135	1	3	5	0	144
9150	4	1	1	148	0	154
9151	2	1	3	144	0	150
9152	2	145	1	7	0	155
9153	147	6	0	3	0	156
9154	151	1	1	2	0	155
9155	6	0	3	149	0	158
9156	2	0	2	147	0	151
9157	1	1	1	147	0	150
9158	0	135	4	8	0	147
9159	0	147	1	1	0	149
9160	0	7	0	134	0	141
9161	111	1	2	4	0	118
9162	112	0	1	2	0	115
9163	5	106	0	1	0	112
9164	108	1	1	1	0	111
9165	1	105	0	2	0	108
9166	2	107	0	1	0	110
9167	1	3	0	108	0	112
9168	105	1	1	2	0	109
9169	2	100	0	3	0	105
9170	2	99	0	3	0	104
9171	0	2	0	109	0	111
9172	1	1	0	107	0	109
9173	0	2	107	2	0	111
9174	108	0	2	1	0	111
9175	108	1	1	2	0	112
9176	3	1	110	2	0	116
9177	2	2	105	1	0	110
9178	1	1	2	108	0	112
9179	3	0	2	107	0	112
9180	0	108	0	3	0	111
9181	1	3	0	114	0	118
9182	2	1	111	3	0	117
9183	3	2	2	103	0	110
9184	1	2	1	108	0	112
9185	109	1	0	4	0	114
9186	2	2	104	2	0	110
9187	108	1	1	1	0	111
9188	2	1	110	1	0	114
9189	5	0	1	104	0	110
9190	0	2	103	2	0	107
9191	1	2	100	2	0	105
9192	1	0	5	100	0	106
9193	96	0	3	4	0	103
9194	91	1	3	1	0	96
9195	3	94	0	1	0	98
9196	95	1	1	3	0	100
9197	93	2	3	2	0	100
9198	3	91	3	2	0	99
9199	3	1	0	93	0	97
9200	5	0	1	92	0	98
9201	1	2	3	90	0	96
9202	3	0	1	94	0	98
9203	1	0	91	4	0	96
9204	81	1	2	4	0	88
9205	1	1	2	88	0	92
9206	2	1	1	90	0	94
9207	0	92	3	5	0	100
9208	3	2	0	94	0	99
9209	1	1	90	3	0	95
9210	88	1	1	2	0	92
9211	2	0	96	2	0	100
9212	2	0	2	96	0	100
9213	98	2	2	2	0	104
9214	2	95	1	5	0	103
9215	1	1	2	100	0	104
9216	1	3	100	2	0	106
9217	2	0	2	98	0	102
9218	100	0	2	2	0	104
9219	3	1	95	3	0	102
9220	1	2	89	3	0	95
9221	0	89	2	3	0	94
9222	89	2	2	3	0	96
9223	1	93	0	3	0	97
9224	2	1	90	2	0	95
9225	1	1	86	0	0	88
9226	0	87	4	2	0	93
9227	77	1	1	1	0	80
9228	1	76	0	0	0	77
9229	1	1	0	76	0	78
9230	0	0	1	78	0	79
9231	0	0	74	1	0	75
9232	0	2	0	72	0	74
9233	1	0	75	1	0	77
9234	72	1	0	0	0	73
9235	77	0	0	1	0	78
9236	73	0	1	2	0	76
9237	1	0	76	0	0	77
9238	76	0	0	2	0	78
9239	1	1	1	72	0	75
9240	2	75	0	0	0	77
9241	75	0	1	0	0	76
9242	1	0	72	1	0	74
9243	75	0	1	0	0	76
9244	74	0	1	0	0	75
9245	0	0	72	1	0	73
9246	0	72	0	0	0	72
9247	3	0	0	69	0	72
9248	0	1	72	0	0	73
9249	1	0	65	0	0	66
9250	0	0	0	57	0	57
9251	0	0	57	0	0	57
9252	0	1	0	57	0	58
9253	0	0	0	56	0	56
9254	0	0	2	55	0	57
9255	1	0	58	0	0	59
9256	0	0	1	58	0	59
9257	0	0	58	1	0	59
9258	0	0	0	59	0	59
9259	58	1	0	1	0	60
9260	0	0	0	57	0	57
9261	0	56	2	0	0	58
9262	0	0	0	60	0	60
9263	60	0	1	0	0	61
9264	1	57	2	1	0	61
9265	0	1	1	59	0	61
9266	60	1	0	1	0	62
9267	2	0	59	0	0	61
9268	0	2	0	58	0	60
9269	0	0	59	1	0	60
9270	1	0	61	0	0	62
9271	0	1	1	59	0	61
9272	59	0	0	1	0	60
9273	0	1	58	1	0	60
9274	54	0	1	1	0	56
9275	1	1	0	56	0	58
9276	1	0	53	1	0	55
9277	1	0	53	1	0	55
9278	1	0	57	1	0	59
9279	1	0	0	52	0	53
9280	53	0	3	0	0	56
9281	1	50	2	0	0	53
9282	0	0	2	52	0	54
9283	2	0	0	50	0	52
9284	52	0	1	1	0	54
9285	49	2	0	1	0	52
9286	1	50	0	2	0	53
9287	51	0	1	2	0	54
9288	53	0	1	0	0	54
9289	1	0	1	51	0	53
9290	0	1	51	1	0	53
9291	50	1	0	0	0	51
9292	2	1	0	50	0	53
9293	0	0	1	51	0	52
9294	49	0	2	1	0	52
9295	2	0	0	45	0	47
9296	2	0	1	46	0	49
9297	45	1	0	2	0	48
9298	2	50	0	1	0	53
9299	50	0	0	2	0	52
9300	0	0	51	2	0	53
9301	50	0	0	1	0	51
9302	0	1	1	48	0	50
9303	1	53	0	1	0	55
9304	1	0	1	51	0	53
9305	3	0	0	53	0	56
9306	0	2	0	55	0	57
9307	49	1	0	3	0	53
9308	3	51	0	1	0	55
9309	0	52	1	0	0	53
9310	49	0	0	3	0	52
9311	1	0	57	0	0	58
9312	1	1	55	0	0	57
9313	54	1	1	3	0	59
9314	2	1	52	0	0	55
9315	1	0	3	53	0	57
9316	2	0	2	51	0	55
9317	1	0	0	55	0	56
9318	1	0	2	56	0	59
9319	0	53	1	3	0	57
9320	2	2	1	52	0	57
9321	1	1	54	2	0	58
9322	1	0	2	54	0	57
9323	0	2	56	1	0	59
9324	1	0	54	1	0	56
9325	1	0	3	55	0	59
9326	2	0	56	2	0	60
9327	1	0	3	57	0	61
9328	61	0	2	4	0	67
9329	4	0	60	2	0	66
9330	63	1	3	0	0	67
9331	2	0	1	64	0	67
9332	2	0	62	2	0	66
9333	1	61	3	2	0	67
9334	1	2	2	62	0	67
9335	0	1	66	4	0	71
9336	1	0	3	66	0	70
9337	67	1	3	3	0	74
9338	72	0	0	5	0	77
9339	77	0	1	0	0	78
9340	4	0	0	74	0	78
9341	3	0	0	75	0	78
9342	2	0	1	76	0	79
9343	74	0	1	3	0	78
9344	3	74	0	1	0	78
9345	1	2	0	76	0	79
9346	0	1	1	78	0	80
9347	75	0	0	6	0	81
9348	4	76	0	1	0	81
9349	3	3	0	78	0	84
9350	78	2	0	5	0	85
9351	80	1	0	2	0	83
9352	5	2	0	75	0	82
9353	77	0	0	5	0	82
9354	4	0	1	76	0	81
9355	3	1	77	3	0	84
9356	1	0	4	77	0	82
9357	1	0	1	82	0	84
9358	1	0	0	85	0	86
9359	73	1	0	5	0	79
9360	2	75	0	3	0	80
9361	73	3	0	1	0	77
9362	4	75	0	1	0	80
9363	1	78	0	0	0	79
9364	76	4	0	1	0	81
9365	4	78	0	0	0	82
9366	2	2	0	78	0	82
9367	78	1	0	4	0	83
9368	85	0	0	2	0	87
9369	5	0	0	79	0	84
9370	1	0	1	83	0	85
9371	0	82	0	4	0	86
9372	86	3	0	3	0	92
9373	87	1	0	2	0	90
9374	4	88	0	1	0	93
9375	1	89	0	0	0	90
9376	1	4	0	88	0	93
9377	87	1	0	4	0	92
9378	3	1	0	87	0	91
9379	3	0	0	89	0	92
9380	0	1	87	4	0	92
9381	0	0	86	2	0	88
9382	1	0	4	90	0	95
9383	1	0	87	3	0	91
9384	0	88	3	1	0	92
9385	0	3	1	84	0	88
9386	0	2	0	94	0	96
9387	1	0	0	94	0	95
9388	2	0	91	4	0	97
9389	0	3	86	1	0	90
9390	84	1	4	2	0	91
9391	3	87	1	2	0	93
9392	90	3	1	0	0	94
9393	4	2	0	88	0	94
9394	88	0	0	7	0	95
9395	4	0	1	88	0	93
9396	2	83	2	2	0	89
9397	86	3	0	4	0	93
9398	4	0	84	0	0	88
9399	1	81	3	1	0	86
9400	82	3	2	1	0	88
9401	3	1	0	79	0	83
9402	1	72	0	5	0	78
9403	0	3	1	77	0	81
9404	75	1	1	3	0	80
9405	4	1	0	75	0	80
9406	77	1	0	3	0	81
9407	4	1	73	1	0	79
9408	1	1	3	76	0	81
9409	77	0	1	4	0	82
9410	3	1	75	2	0	81
9411	1	70	3	1	0	75
9412	2	2	1	68	0	73
9413	1	0	67	2	0	70
9414	0	1	68	1	0	70
9415	1	0	2	71	0	74
9416	0	1	72	3	0	76
9417	1	1	71	0	0	73
9418	1	0	2	67	0	70
9419	69	0	0	2	0	71
9420	2	1	0	68	0	71
9421	2	0	0	70	0	72
9422	1	0	70	2	0	73
9423	1	0	1	68	0	70
9424	69	0	0	5	0	74
9425	1	0	72	0	0	73
9426	0	68	2	1	0	71
9427	0	2	0	71	0	73
9428	64	0	2	2	0	68
9429	1	1	1	66	0	69
9430	0	68	0	3	0	71
9431	1	1	68	2	0	72
9432	1	1	1	70	0	73
9433	73	0	1	3	0	77
9434	4	0	72	0	0	76
9435	1	1	2	76	0	80
9436	78	1	0	6	0	85
9437	82	0	1	3	0	86
9438	7	80	1	2	0	90
9439	83	2	1	2	0	88
9440	3	2	1	81	0	87
9441	3	3	77	3	0	86
9442	2	70	5	3	0	80
9443	1	80	2	1	0	84
9444	0	8	1	73	0	82
9445	1	2	2	77	0	82
9446	0	0	75	6	0	81
9447	0	65	2	3	0	70
9448	0	70	2	3	0	75
9449	0	3	1	71	0	75
9450	67	2	2	3	0	74
9451	3	68	0	3	0	74
9452	3	2	0	71	0	76
9453	71	2	2	2	0	77
9454	2	1	1	74	0	78
9455	3	0	0	74	0	77
9456	3	0	0	76	0	79
9457	1	1	1	78	0	81
9458	71	3	0	5	0	79
9459	3	0	1	76	0	80
9460	3	0	71	4	0	78
9461	64	1	3	3	0	71
9462	2	1	69	0	0	72
9463	2	1	74	2	0	79
9464	1	0	3	70	0	74
9465	1	0	3	68	0	72
9466	0	2	2	71	0	75
9467	69	0	0	6	0	75
9468	4	2	66	3	0	75
9469	69	0	3	1	0	73
9470	67	3	1	1	0	72
9471	5	2	72	1	0	80
9472	70	1	2	3	0	76
9473	2	0	73	2	0	77
9474	2	73	2	3	0	80
9475	0	4	3	76	0	83
9476	1	3	1	79	0	84
9477	1	1	0	76	0	78
9478	2	1	1	74	0	78
9479	0	2	72	6	0	80
9480	2	1	71	3	0	77
9481	2	1	4	72	0	79
9482	1	0	75	4	0	80
9483	68	1	3	3	0	75
9484	76	0	2	5	0	83
9485	6	0	0	76	0	82
9486	76	0	0	5	0	81
9487	3	81	1	5	0	90
9488	85	2	2	1	0	90
9489	6	1	80	1	0	88
9490	4	1	5	80	0	90
9491	2	84	3	3	0	92
9492	85	2	3	3	0	93
9493	3	3	2	85	0	93
9494	2	1	84	5	0	92
9495	2	0	3	85	0	90
9496	81	0	3	6	0	90
9497	3	0	85	5	0	93
9498	3	0	4	83	0	90
9499	2	0	5	80	0	87
9500	2	0	92	5	0	99
9501	1	88	5	3	0	97
9502	3	67	4	0	0	74
9503	2	4	1	90	0	97
9504	1	3	0	90	0	94
9505	1	0	0	95	0	96
9506	89	1	0	5	0	95
9507	89	1	0	3	0	93
9508	6	0	1	85	0	92
9509	89	0	2	3	0	94
9510	2	87	0	2	0	91
9511	3	3	0	88	0	94
9512	1	2	1	90	0	94
9513	1	0	1	94	0	96
9514	84	0	1	4	0	89
9515	3	81	0	4	0	88
9516	2	1	1	83	0	87
9517	81	3	1	4	0	89
9518	3	1	0	85	0	89
9519	2	0	2	83	0	87
9520	0	78	1	5	0	84
9521	0	84	0	2	0	86
9522	1	5	0	80	0	86
9523	0	2	0	84	0	86
9524	80	0	1	6	0	87
9525	2	0	0	82	0	84
9526	4	0	79	1	0	84
9527	1	0	3	74	0	78
9528	1	74	2	3	0	80
9529	79	3	0	3	0	85
9530	2	3	1	79	0	85
9531	2	0	0	82	0	84
9532	0	75	0	4	0	79
9533	72	2	0	4	0	78
9534	3	75	0	1	0	79
9535	1	2	0	72	0	75
9536	1	1	64	2	0	68
9537	0	1	0	57	0	58
9538	58	0	1	0	0	59
9539	0	56	0	1	0	57
9540	2	0	0	53	0	55
9541	0	52	0	0	0	52
9542	0	0	0	57	0	57
9543	0	1	59	0	0	60
9544	0	0	0	60	0	60
9545	2	0	1	55	0	58
9546	2	0	0	59	0	61
9547	53	0	0	3	0	56
9548	55	0	0	0	0	55
9549	2	54	0	0	0	56
9550	57	1	0	1	0	59
9551	1	57	0	0	0	58
9552	1	55	0	0	0	56
9553	55	2	0	0	0	57
9554	1	1	50	0	0	52
9555	1	0	2	50	0	53
9556	0	0	1	56	0	57
9557	0	0	0	58	0	58
9558	53	0	0	4	0	57
9559	1	53	0	1	0	55
9560	1	1	0	56	0	58
9561	0	56	0	1	0	57
9562	60	1	1	1	0	63
9563	1	1	0	63	0	65
9564	2	0	0	80	0	82
9565	0	84	0	1	0	85
9566	0	1	0	83	0	84
9567	0	1	0	87	0	88
9568	85	0	0	4	0	89
9569	2	81	0	1	0	84
9570	0	88	0	1	0	89
9571	0	2	0	86	0	88
9572	0	1	87	2	0	90
9573	0	0	87	1	0	88
9574	0	0	3	87	0	90
9575	0	2	87	2	0	91
9576	0	0	2	86	0	88
9577	0	0	2	77	0	79
9578	1	0	0	88	0	89
9579	88	0	0	3	0	91
9580	2	1	0	88	0	91
9581	2	0	0	90	0	92
9582	0	89	1	3	0	93
9583	0	2	1	92	0	95
9584	0	1	90	3	0	94
9585	0	0	3	92	0	95
9586	1	0	1	92	0	94
9587	83	0	0	4	0	87
9588	2	1	0	83	0	86
9589	3	0	0	82	0	85
9590	0	0	0	86	0	86
9591	80	0	0	5	0	85
9592	2	81	0	1	0	84
9593	2	1	0	82	0	85
9594	0	1	1	82	0	84
9595	1	1	80	4	0	86
9596	1	1	2	79	0	83
9597	77	1	1	1	0	80
9598	2	80	0	3	0	85
9599	1	2	1	81	0	85
9600	0	1	1	81	0	83
9601	2	1	78	3	0	84
9602	76	1	3	2	0	82
9603	2	77	1	1	0	81
9604	83	2	0	0	0	85
9605	2	1	1	77	0	81
9606	3	0	0	82	0	85
9607	0	0	0	84	0	84
9608	1	1	0	86	0	88
9609	85	1	0	4	0	90
9610	2	0	0	85	0	87
9611	1	78	2	2	0	83
9612	2	2	0	84	0	88
9613	1	2	0	86	0	89
9614	86	0	0	3	0	89
9615	2	81	0	3	0	86
9616	1	2	0	85	0	88
9617	81	1	0	5	0	87
9618	84	0	0	2	0	86
9619	4	2	0	83	0	89
9620	1	0	79	5	0	85
9621	82	1	2	3	0	88
9622	3	0	2	82	0	87
9623	1	0	85	5	0	91
9624	3	0	3	85	0	91
9625	1	2	1	89	0	93
9626	1	0	0	90	0	91
9627	0	89	1	5	0	95
9628	1	2	1	94	0	98
9629	1	1	0	92	0	94
9630	0	1	1	94	0	96
9631	2	1	0	93	0	96
9632	0	0	1	95	0	96
9633	2	0	1	93	0	96
9634	84	0	0	5	0	89
9635	2	0	85	2	0	89
9636	1	84	2	2	0	89
9637	84	3	0	2	0	89
9638	3	84	0	1	0	88
9639	81	2	1	3	0	87
9640	3	1	0	84	0	88
9641	86	0	0	3	0	89
9642	2	2	0	86	0	90
9643	1	1	0	80	0	82
9644	3	80	0	1	0	84
9645	83	1	1	0	0	85
9646	1	1	86	2	0	90
9647	1	0	2	84	0	87
9648	1	1	83	1	0	86
9649	2	0	78	1	0	81
9650	85	0	3	2	0	90
9651	2	0	0	88	0	90
9652	0	1	86	3	0	90
9653	0	0	88	2	0	90
9654	2	2	1	87	0	92
9655	2	0	0	92	0	94
9656	88	0	2	2	0	92
9657	1	0	1	91	0	93
9658	0	0	98	3	0	101
9659	0	0	3	95	0	98
9660	3	0	0	101	0	104
9661	0	102	0	2	0	104
9662	97	1	2	1	0	101
9663	1	96	0	1	0	98
9664	79	1	0	1	0	81
9665	1	73	0	1	0	75
9666	1	71	0	0	0	72
9667	0	1	1	72	0	74
9668	1	0	1	68	0	70
9669	0	1	0	69	0	70
9670	69	1	0	0	0	70
9671	0	0	68	1	0	69
9672	0	0	0	68	0	68
9673	68	0	0	1	0	69
9674	1	67	0	0	0	68
9675	0	69	1	0	0	70
9676	0	0	0	69	0	69
9677	1	0	0	72	0	73
9678	0	1	0	73	0	74
9679	0	75	0	0	0	75
9680	0	0	0	77	0	77
9681	0	0	76	0	0	76
9682	1	0	65	1	0	67
9683	68	1	0	1	0	70
9684	0	0	0	76	0	76
9685	76	0	1	0	0	77
9686	76	0	1	0	0	77
9687	1	79	0	0	0	80
9688	81	0	0	0	0	81
9689	83	0	0	0	0	83
9690	1	0	0	80	0	81
9691	0	1	0	85	0	86
9692	1	0	83	0	0	84
9693	1	80	0	1	0	82
9694	3	0	1	74	0	78
9695	0	0	0	83	0	83
9696	80	0	1	2	0	83
9697	0	1	0	82	0	83
9698	83	0	0	2	0	85
9699	0	0	0	87	0	87
9700	1	83	0	0	0	84
9701	88	1	0	1	0	90
9702	2	0	0	97	0	99
9703	2	0	0	108	0	110
9704	1	1	0	110	0	112
9705	1	0	107	1	0	109
9706	1	0	1	105	0	107
9707	108	0	0	3	0	111
9708	1	0	0	110	0	111
9709	0	0	1	118	0	119
9710	0	0	0	119	0	119
9711	1	112	0	0	0	113
9712	1	120	0	1	0	122
9713	115	2	0	1	0	118
9714	1	116	0	1	0	118
9715	119	2	0	1	0	122
9716	116	0	0	2	0	118
9717	118	0	1	1	0	120
9718	2	0	116	1	0	119
9719	1	119	2	0	0	122
9720	122	1	0	4	0	127
9721	2	0	0	124	0	126
9722	1	0	0	121	0	122
9723	1	0	0	117	0	118
9724	0	118	0	2	0	120
9725	0	2	0	119	0	121
9726	118	1	0	4	0	123
9727	2	0	0	114	0	116
9728	0	1	0	116	0	117
9729	1	1	113	2	0	117
9730	1	1	120	0	0	122
9731	1	2	2	113	0	118
9732	2	0	0	118	0	120
9733	1	122	0	3	0	126
9734	1	2	0	121	0	124
9735	1	0	1	122	0	124
9736	0	2	0	126	0	128
9737	120	1	0	5	0	126
9738	3	2	121	1	0	127
9739	1	0	2	125	0	128
9740	124	1	0	4	0	129
9741	122	1	1	0	0	124
9742	3	0	1	122	0	126
9743	4	0	0	118	0	122
9744	118	0	1	3	0	122
9745	1	118	0	1	0	120
9746	1	118	2	1	0	122
9747	1	2	1	122	0	126
9748	118	0	0	5	0	123
9749	123	0	0	2	0	125
9750	122	2	1	1	0	126
9751	2	0	119	4	0	125
9752	119	0	2	1	0	122
9753	3	0	118	2	0	123
9754	116	0	2	3	0	121
9755	2	119	3	1	0	125
9756	1	2	123	1	0	127
9757	1	1	2	118	0	122
9758	0	1	118	4	0	123
9759	1	1	2	116	0	120
9760	118	0	0	5	0	123
9761	4	0	119	1	0	124
9762	1	1	2	120	0	124
9763	1	123	1	2	0	127
9764	2	2	1	127	0	132
9765	2	0	1	127	0	130
9766	2	0	0	119	0	121
9767	126	1	0	4	0	131
9768	126	0	3	1	0	130
9769	4	0	0	126	0	130
9770	2	0	122	2	0	126
9771	0	1	120	2	0	123
9772	1	2	2	122	0	127
9773	0	0	139	4	0	143
9774	2	1	2	133	0	138
9775	1	1	1	137	0	140
9776	2	0	0	141	0	143
9777	0	136	1	3	0	140
9778	2	137	1	1	0	141
9779	3	3	1	139	0	146
9780	3	1	0	141	0	145
9781	0	1	1	141	0	143
9782	140	1	2	2	0	145
9783	4	0	145	2	0	151
9784	3	0	3	143	0	149
9785	143	0	1	4	0	148
9786	3	145	0	2	0	150
9787	0	3	2	144	0	149
9788	0	0	1	149	0	150
9789	1	2	0	147	0	150
9790	2	1	1	146	0	150
9791	0	0	142	5	0	147
9792	137	0	2	2	0	141
9793	144	0	0	1	0	145
9794	3	1	145	0	0	149
9795	142	1	2	1	0	146
9796	145	0	1	2	0	148
9797	2	0	148	1	0	151
9798	0	163	2	2	0	167
9799	2	2	1	163	0	168
9800	0	0	174	2	0	176
9801	0	171	1	3	0	175
9802	1	1	161	2	0	165
9803	0	160	2	0	0	162
9804	1	2	0	160	0	163
9805	0	0	159	2	0	161
9806	2	0	1	154	0	157
9807	0	0	166	3	0	169
9808	1	167	1	0	0	169
9809	156	1	1	0	0	158
9810	1	154	0	0	0	155
9811	0	169	1	0	0	170
9812	0	0	0	167	0	167
9813	0	0	0	173	0	173
9814	1	0	0	171	0	172
9815	1	0	0	168	0	169
9816	0	0	0	175	0	175
9817	0	1	199	0	0	200
9818	0	0	0	188	0	188
9819	1	0	0	202	0	203
9820	205	0	0	2	0	207
9821	206	0	0	1	0	207
9822	204	0	0	2	0	206
9823	0	0	0	207	0	207
9824	237	0	0	1	0	238
9825	256	0	2	2	0	260
9826	255	0	0	4	0	259
9827	1	0	262	0	0	263
9828	251	0	1	0	0	252
9829	264	0	0	2	0	266
9830	266	0	0	1	0	267
9831	2	0	0	259	0	261
9832	0	0	271	1	0	272
9833	3	0	1	262	0	266
9834	281	0	0	3	0	284
9835	2	0	0	284	0	286
9836	0	302	1	1	0	304
9837	0	1	0	314	0	315
9838	310	0	0	3	0	313
9839	313	0	0	3	0	316
9840	305	1	0	4	0	310
9841	1	0	325	1	0	327
9842	3	0	2	313	0	318
9843	1	0	0	326	0	327
9844	1	0	335	2	0	338
9845	0	323	3	0	0	326
9846	0	2	325	1	0	328
9847	1	0	2	330	0	333
9848	334	1	1	2	0	338
9849	1	1	348	1	0	351
9850	1	1	3	348	0	353
9851	0	0	354	3	0	357
9852	338	0	2	5	0	345
9853	3	0	1	350	0	354
9854	1	0	373	2	0	376
9855	1	1	3	358	0	363
9856	2	0	372	2	0	376
9857	0	384	3	1	0	388
9858	0	3	1	381	0	385
9859	386	0	0	9	0	395
9860	3	0	1	392	0	396
9861	0	1	0	387	0	388
9862	386	0	0	6	0	392
9863	4	374	0	1	0	379
9864	0	388	0	1	0	389
9865	1	3	0	387	0	391
9866	0	387	0	4	0	391
9867	3	4	0	388	0	395
9868	0	1	0	388	0	389
9869	385	0	0	5	0	390
9870	4	380	0	0	0	384
9871	1	3	369	1	0	374
9872	0	384	3	1	0	388
9873	382	3	0	3	0	388
9874	381	1	0	0	0	382
9875	4	0	2	375	0	381
9876	379	2	1	4	0	386
9877	5	0	0	382	0	387
9878	380	0	0	6	0	386
9879	378	1	0	6	0	385
9880	3	0	0	398	0	401
9881	405	0	0	9	0	414
9882	6	0	404	2	0	412
9883	397	0	3	2	0	402
9884	4	0	1	399	0	404
9885	396	0	1	4	0	401
9886	4	402	1	2	0	409
9887	4	2	1	406	0	413
9888	3	2	0	411	0	416
9889	406	1	2	4	0	413
9890	5	1	410	1	0	417
9891	2	396	5	2	0	405
9892	3	3	1	403	0	410
9893	2	404	1	4	0	411
9894	2	3	3	415	0	423
9895	2	1	1	401	0	405
9896	2	0	1	412	0	415
9897	398	1	1	9	0	409
9898	5	0	1	392	0	398
9899	387	0	1	10	0	398
9900	389	2	1	5	0	397
9901	6	1	0	397	0	404
9902	394	0	0	5	0	399
9903	395	0	1	3	0	399
9904	5	0	391	3	0	399
9905	3	0	3	384	0	390
9906	388	1	2	8	0	399
9907	4	396	1	2	0	403
9908	396	5	3	1	0	405
9909	393	2	0	4	0	399
9910	6	2	385	2	0	395
9911	1	1	3	362	0	367
9912	416	0	1	7	0	424
9913	6	1	2	432	0	441
9914	2	1	2	448	0	453
9915	0	1	2	457	0	460
9916	5	1	1	469	0	476
9917	456	0	0	16	0	472
9918	10	0	465	2	0	477
9919	4	1	9	489	0	503
9920	2	0	546	13	0	561
9921	5	1	571	3	0	580
9922	551	1	23	6	0	581
9923	22	0	604	4	0	630
9924	12	570	23	3	0	608
9925	584	17	14	4	0	619
9926	590	11	7	2	0	610
9927	37	3	2	567	0	609
9928	16	0	587	17	0	620
9929	6	4	583	14	0	607
9930	597	2	27	7	0	633
9931	26	0	13	609	0	648
9932	627	0	4	19	0	650
9933	20	631	6	14	0	671
9934	635	18	3	7	0	663
9935	641	10	3	7	0	661
9936	32	623	2	3	0	660
9937	17	16	1	636	0	670
9938	636	13	3	20	0	672
9939	20	7	627	11	0	665
9940	17	629	19	4	0	669
9941	12	15	10	624	0	661
9942	619	15	5	22	0	661
9943	19	623	3	14	0	659
9944	644	17	2	8	0	671
9945	23	15	622	1	0	661
9946	610	8	16	9	0	643
9947	24	1	634	3	0	662
9948	627	3	23	4	0	657
9949	611	3	14	6	0	634
9950	34	2	597	2	0	635
9951	18	603	18	2	0	641
9952	11	18	12	589	0	630
9953	7	13	624	15	0	659
9954	6	605	18	13	0	642
9955	6	16	15	598	0	635
9956	4	14	8	620	0	646
9957	4	8	605	28	0	645
9958	10	2	17	595	0	624
9959	9	3	18	616	0	646
9960	2	5	604	30	0	641
9961	6	3	14	591	0	614
9962	7	599	18	16	0	640
9963	610	19	9	14	0	652
9964	24	14	6	593	0	637
9965	19	617	6	19	0	661
9966	14	19	7	577	0	617
9967	6	622	3	22	0	653
9968	9	22	596	18	0	645
9969	7	620	23	8	0	658
9970	604	25	17	8	0	654
9971	622	18	7	14	0	661
9972	634	10	9	9	0	662
9973	38	10	619	4	0	671
9974	22	6	621	7	0	656
9975	16	618	34	4	0	672
9976	12	19	20	597	0	648
9977	11	634	10	15	0	670
9978	10	26	7	572	0	615
9979	12	612	5	22	0	651
9980	593	27	7	21	0	648
9981	637	20	0	13	0	670
9982	32	12	5	660	0	709
9983	20	7	655	23	0	705
9984	633	10	21	20	0	684
9985	26	663	14	14	0	717
9986	24	22	15	640	0	701
9987	21	17	4	637	0	679
9988	3	651	14	36	0	704
9989	653	22	7	23	0	705
9990	34	21	642	11	0	708
9991	24	10	24	644	0	702
9992	632	7	20	26	0	685
9993	646	3	15	25	0	689
9994	40	643	9	10	0	702
9995	34	25	5	619	0	683
9996	17	637	8	28	0	690
9997	628	33	7	28	0	696
9998	34	19	632	11	0	696
9999	23	14	633	11	0	681
10000	17	8	38	619	0	682
10001	3	9	27	640	0	679
10002	11	623	12	35	0	681
10003	16	21	8	636	0	681
10004	4	18	625	31	0	678
10005	594	15	23	31	0	663
10006	29	6	13	634	0	682
10007	18	10	619	27	0	674
10008	15	13	21	616	0	665
10009	4	5	21	615	0	645
10010	10	606	15	35	0	666
10011	14	22	5	619	0	660
10012	17	19	5	592	0	633
10013	11	11	9	593	0	624
10014	548	5	5	47	0	605
10015	17	530	8	28	0	583
10016	18	536	5	13	0	572
10017	514	21	9	10	0	554
10018	493	25	7	12	0	537
10019	27	468	3	7	0	505
10020	17	403	1	3	0	424
10021	355	14	2	4	0	375
10022	6	350	2	6	0	364
10023	4	351	2	2	0	359
10024	341	8	3	4	0	356
10025	6	343	1	3	0	353
10026	339	8	1	7	0	355
10027	335	5	3	3	0	346
10028	328	7	1	5	0	341
10029	10	322	2	2	0	336
10030	9	312	1	3	0	325
10031	8	8	2	304	0	322
10032	4	310	2	5	0	321
10033	6	12	0	311	0	329
10034	307	4	2	14	0	327
10035	8	9	0	305	0	322
10036	3	302	1	13	0	319
10037	304	6	3	7	0	320
10038	6	298	2	6	0	312
10039	7	312	0	4	0	323
10040	8	8	2	294	0	312
10041	7	308	0	6	0	321
10042	299	11	1	6	0	317
10043	6	9	301	4	0	320
10044	3	297	8	3	0	311
10045	5	4	4	302	0	315
10046	0	6	299	7	0	312
10047	7	4	3	291	0	305
10048	4	3	5	296	0	308
10049	6	5	4	296	0	311
10050	5	3	0	295	0	303
10051	5	2	294	8	0	309
10052	2	289	4	8	0	303
10053	281	6	4	10	0	301
10054	5	5	276	5	0	291
10055	273	6	3	6	0	288
10056	6	5	280	3	0	294
10057	6	4	8	273	0	291
10058	6	4	282	7	0	299
10059	4	1	284	6	0	295
10060	6	2	9	282	0	299
10061	8	3	7	263	0	281
10062	3	3	5	284	0	295
10063	2	4	2	287	0	295
10064	275	3	3	14	0	295
10065	4	2	283	8	0	297
10066	279	3	3	12	0	297
10067	287	1	2	8	0	298
10068	282	2	5	4	0	293
10069	285	4	0	7	0	296
10070	293	3	2	2	0	300
10071	10	4	2	281	0	297
10072	13	1	273	2	0	289
10073	8	2	263	4	0	277
10074	3	267	5	6	0	281
10075	266	1	7	0	0	274
10076	5	2	5	256	0	268
10077	3	7	1	254	0	265
10078	5	255	1	4	0	265
10079	2	248	2	5	0	257
10080	2	247	0	5	0	254
10081	209	8	1	1	0	219
10082	1	1	2	181	0	185
10083	1	179	1	2	0	183
10084	2	2	0	178	0	182
10085	2	0	182	2	0	186
10086	1	0	188	1	0	190
10087	1	1	1	195	0	198
10088	196	0	0	4	0	200
10089	205	1	1	3	0	210
10090	201	1	2	1	0	205
10091	3	1	206	2	0	212
10092	4	1	2	206	0	213
10093	3	0	1	210	0	214
10094	2	2	205	3	0	212
10095	191	2	3	2	0	198
10096	2	2	206	1	0	211
10097	1	4	196	2	0	203
10098	1	1	207	2	0	211
10099	1	0	4	201	0	206
10100	1	1	2	208	0	212
10101	0	0	217	6	0	223
10102	1	0	4	208	0	213
10103	211	1	2	7	0	221
10104	5	0	1	216	0	222
10105	3	0	221	3	0	227
10106	4	1	230	4	0	239
10107	4	0	5	235	0	244
10108	239	0	4	5	0	248
10109	3	247	3	4	0	257
10110	250	3	2	6	0	261
10111	258	2	2	4	0	266
10112	8	0	259	1	0	268
10113	5	1	4	257	0	267
10114	265	1	5	4	0	275
10115	261	0	2	7	0	270
10116	3	257	3	2	0	265
10117	3	2	2	268	0	275
10118	2	3	2	269	0	276
10119	2	1	260	7	0	270
10120	6	2	3	254	0	265
10121	2	0	266	6	0	274
10122	3	0	252	7	0	262
10123	0	1	10	255	0	266
10124	252	0	4	7	0	263
10125	4	256	3	4	0	267
10126	259	4	1	1	0	265
10127	254	2	0	6	0	262
10128	9	267	2	1	0	279
10129	3	3	4	256	0	266
10130	258	2	1	6	0	267
10131	6	260	1	4	0	271
10132	253	5	1	0	0	259
10133	5	241	1	0	0	247
10134	5	1	1	235	0	242
10135	3	2	2	240	0	247
10136	230	1	4	5	0	240
10137	230	1	0	7	0	238
10138	5	243	2	0	0	250
10139	3	2	237	1	0	243
10140	1	2	230	5	0	238
10141	8	0	3	230	0	241
10142	1	238	2	4	0	245
10143	3	2	3	240	0	248
10144	2	2	5	231	0	240
10145	1	3	2	232	0	238
10146	1	2	234	7	0	244
10147	2	1	230	7	0	240
10148	4	240	5	3	0	252
10149	6	2	5	244	0	257
10150	3	3	5	252	0	263
10151	2	2	257	4	0	265
10152	219	3	3	10	0	235
10153	4	1	2	253	0	260
10154	7	3	251	3	0	264
10155	236	3	2	5	0	246
10156	6	260	5	3	0	274
10157	3	4	275	3	0	285
10158	4	3	7	267	0	281
10159	274	2	4	7	0	287
10160	5	4	288	5	0	302
10161	10	1	3	288	0	302
10162	5	5	4	284	0	298
10163	5	1	6	309	0	321
10164	307	0	4	11	0	322
10165	6	312	3	6	0	327
10166	2	6	2	316	0	326
10167	3	4	321	9	0	337
10168	4	2	7	308	0	321
10169	3	318	3	8	0	332
10170	2	323	4	10	0	339
10171	317	9	5	10	0	341
10172	322	6	3	8	0	339
10173	6	4	314	7	0	331
10174	302	3	8	3	0	316
10175	8	309	5	3	0	325
10176	325	6	5	5	0	341
10177	11	4	4	315	0	334
10178	5	3	339	8	0	355
10179	6	2	6	337	0	351
10180	4	2	338	10	0	354
10181	318	2	9	9	0	338
10182	6	2	4	342	0	354
10183	4	340	4	9	0	357
10184	9	7	5	342	0	363
10185	2	6	348	10	0	366
10186	1	339	8	5	0	353
10187	321	6	2	9	0	338
10188	8	317	3	2	0	330
10189	1	317	3	2	0	323
10190	6	5	0	311	0	322
10191	2	313	2	6	0	323
10192	2	6	2	319	0	329
10193	1	3	312	7	0	323
10194	285	5	6	5	0	301
10195	307	0	1	9	0	317
10196	8	0	312	1	0	321
10197	303	1	7	3	0	314
10198	7	309	1	2	0	319
10199	312	7	3	5	0	327
10200	8	1	0	315	0	324
10201	3	2	317	6	0	328
10202	2	328	7	1	0	338
10203	4	4	0	328	0	336
10204	3	2	3	327	0	335
10205	315	4	1	8	0	328
10206	297	1	0	7	0	305
10207	4	303	2	2	0	311
10208	3	294	1	2	0	300
10209	3	291	3	1	0	298
10210	1	7	1	284	0	293
10211	279	2	1	12	0	294
10212	277	2	3	1	0	283
10213	6	0	2	274	0	282
10214	3	1	0	277	0	281
10215	270	1	1	5	0	277
10216	7	0	0	276	0	283
10217	0	0	291	6	0	297
10218	271	3	5	1	0	280
10219	286	0	0	8	0	294
10220	4	1	296	2	0	303
10221	301	2	3	1	0	307
10222	9	0	0	317	0	326
10223	1	3	2	309	0	315
10224	2	2	0	319	0	323
10225	308	1	0	8	0	317
10226	6	324	0	2	0	332
10227	4	4	0	327	0	335
10228	3	316	2	4	0	325
10229	316	5	0	3	0	324
10230	5	0	0	310	0	315
10231	3	2	1	311	0	317
10232	3	311	0	6	0	320
10233	0	5	309	2	0	316
10234	3	1	4	309	0	317
10235	305	2	0	9	0	316
10236	313	0	4	1	0	318
10237	8	1	324	1	0	334
10238	2	0	7	329	0	338
10239	2	330	1	9	0	342
10240	3	5	3	334	0	345
10241	332	1	1	8	0	342
10242	333	4	0	3	0	340
10243	10	2	0	330	0	342
10244	4	325	0	7	0	336
10245	341	7	0	8	0	356
10246	9	0	0	363	0	372
10247	359	2	0	13	0	374
10248	393	1	0	7	0	401
10249	9	0	1	393	0	403
10250	4	0	0	401	0	405
10251	6	0	0	405	0	411
10252	1	396	1	12	0	410
10253	0	8	1	401	0	410
10254	6	1	0	404	0	411
10255	0	5	387	9	0	401
10256	1	1	364	4	0	370
10257	1	0	9	370	0	380
10258	367	0	4	11	0	382
10259	7	368	5	2	0	382
10260	352	9	1	5	0	367
10261	12	1	369	1	0	383
10262	3	2	351	1	0	357
10263	3	356	8	0	0	367
10264	4	6	4	368	0	382
10265	1	2	373	5	0	381
10266	1	2	394	1	0	398
10267	0	2	7	386	0	395
10268	381	0	3	9	0	393
10269	387	0	3	4	0	394
10270	9	0	1	384	0	394
10271	3	0	459	8	0	470
10272	6	0	6	466	0	478
10273	3	1	1	478	0	483
10274	0	477	2	8	0	487
10275	479	6	3	6	0	494
10276	476	1	0	5	0	482
10277	6	475	2	1	0	484
10278	6	6	0	460	0	472
10279	4	470	1	5	0	480
10280	472	9	1	3	0	485
10281	8	2	471	2	0	483
10282	1	2	445	2	0	450
10283	2	2	447	0	0	451
10284	3	1	7	455	0	466
10285	0	0	4	455	0	459
10286	452	0	4	9	0	465
10287	9	0	2	448	0	459
10288	3	0	0	471	0	474
10289	2	0	510	9	0	521
10290	2	0	490	3	0	495
10291	497	1	5	10	0	513
10292	5	513	4	3	0	525
10293	527	4	3	4	0	538
10294	5	1	2	526	0	534
10295	4	3	1	519	0	527
10296	4	520	0	7	0	531
10297	4	4	0	531	0	539
10298	523	3	0	10	0	536
10299	9	2	0	522	0	533
10300	2	3	526	7	0	538
10301	4	520	6	2	0	532
10302	510	6	1	8	0	525
10303	519	1	3	9	0	532
10304	517	2	4	3	0	526
10305	523	1	1	5	0	530
10306	8	0	0	512	0	520
10307	6	2	0	512	0	520
10308	5	0	511	5	0	521
10309	4	0	5	506	0	515
10310	0	0	511	7	0	518
10311	1	2	7	507	0	517
10312	493	1	2	14	0	510
10313	5	529	3	3	0	540
10314	4	4	2	540	0	550
10315	2	1	0	550	0	553
10316	542	2	0	10	0	554
10317	514	1	0	7	0	522
10318	6	1	522	5	0	534
10319	5	521	6	1	0	533
10320	4	4	2	519	0	529
10321	1	1	3	519	0	524
10322	510	4	2	8	0	524
10323	499	1	1	6	0	507
10324	8	0	504	3	0	515
10325	5	1	493	1	0	500
10326	3	0	6	493	0	502
10327	3	1	2	499	0	505
10328	2	0	484	7	0	493
10329	453	1	9	7	0	470
10330	7	0	1	487	0	495
10331	471	1	4	8	0	484
10332	10	471	1	2	0	484
10333	477	6	0	7	0	490
10334	12	3	530	2	0	547
10335	2	531	12	2	0	547
10336	0	514	1	5	0	520
10337	490	7	6	5	0	508
10338	485	0	2	2	0	489
10339	10	3	2	470	0	485
10340	2	474	3	6	0	485
10341	2	488	0	0	0	490
10342	4	7	0	488	0	499
10343	478	1	0	12	0	491
10344	476	1	0	2	0	479
10345	7	2	462	1	0	472
10346	433	1	5	5	0	444
10347	9	463	1	1	0	474
10348	456	6	0	3	0	465
10349	9	537	1	2	0	549
10350	1	583	3	0	0	587
10351	7	20	0	626	0	653
10352	641	8	0	22	0	671
10353	654	3	0	15	0	672
10354	29	4	628	2	0	663
10355	11	0	16	629	0	656
10356	639	0	9	24	0	672
10357	28	0	2	645	0	675
10358	643	2	3	26	0	674
10359	652	1	2	14	0	669
10360	34	2	636	4	0	676
10361	12	1	19	616	0	648
10362	9	0	8	645	0	662
10363	9	1	1	648	0	659
10364	4	1	615	32	0	652
10365	6	0	18	627	0	651
10366	7	1	9	609	0	626
10367	4	601	4	31	0	640
10368	2	17	602	16	0	637
10369	3	614	22	6	0	645
10370	609	23	9	11	0	652
10371	24	12	4	560	0	600
10372	17	5	4	559	0	585
10373	6	572	4	24	0	606
10374	565	24	3	17	0	609
10375	577	9	3	13	0	602
10376	154	434	3	10	0	601
10377	17	578	3	11	0	609
10378	579	29	0	8	0	616
10379	32	10	564	5	0	611
10380	17	9	571	4	0	601
10381	542	6	31	8	0	587
10382	21	579	11	7	0	618
10383	586	23	7	8	0	624
10384	24	13	580	7	0	624
10385	594	3	19	11	0	627
10386	30	595	12	7	0	644
10387	20	23	7	609	0	659
10388	17	9	7	622	0	655
10389	18	9	2	579	0	608
10390	17	6	4	605	0	632
10391	7	5	4	601	0	617
10392	5	592	3	40	0	640
10393	579	25	5	25	0	634
10394	27	9	586	16	0	638
10395	19	6	23	596	0	644
10396	10	7	599	27	0	643
10397	9	9	25	591	0	634
10398	13	4	13	603	0	633
10399	577	6	9	38	0	630
10400	25	6	575	18	0	624
10401	15	575	23	12	0	625
10402	6	26	12	576	0	620
10403	11	12	4	607	0	634
10404	4	5	583	38	0	630
10405	12	9	22	576	0	619
10406	12	7	13	597	0	629
10407	546	5	9	42	0	602
10408	23	567	5	24	0	619
10409	566	22	7	13	0	608
10410	577	12	4	20	0	613
10411	35	4	6	575	0	620
10412	19	7	559	27	0	612
10413	12	3	561	17	0	593
10414	16	6	29	545	0	596
10415	9	5	15	518	0	547
10416	8	537	12	35	0	592
10417	532	22	12	21	0	587
10418	23	526	4	19	0	572
10419	12	558	7	12	0	589
10420	542	29	4	16	0	591
10421	28	18	3	534	0	583
10422	19	560	3	29	0	611
10423	11	29	4	566	0	610
10424	8	15	552	31	0	606
10425	5	7	563	23	0	598
10426	10	5	32	560	0	607
10427	5	3	575	31	0	614
10428	5	7	26	560	0	598
10429	8	3	17	563	0	591
10430	10	3	8	578	0	599
10431	540	5	9	42	0	596
10432	21	538	10	18	0	587
10433	12	540	4	13	0	569
10434	485	29	2	16	0	532
10435	495	14	3	12	0	524
10436	27	11	2	495	0	535
10437	17	9	494	18	0	538
10438	13	8	18	496	0	535
10439	7	6	497	26	0	536
10440	7	490	24	13	0	534
10441	3	18	13	506	0	540
10442	493	11	6	26	0	536
10443	22	4	7	500	0	533
10444	13	5	486	20	0	524
10445	468	5	18	19	0	510
10446	20	6	486	8	0	520
10447	17	6	473	7	0	503
10448	9	456	26	8	0	499
10449	7	368	8	6	0	389
10450	4	348	6	6	0	364
10451	254	5	7	11	0	277
10452	245	0	1	3	0	249
10453	1	1	0	255	0	257
10454	3	0	0	252	0	255
10455	2	0	0	259	0	261
10456	0	270	0	1	0	271
10457	265	0	1	3	0	269
10458	1	268	0	0	0	269
10459	1	0	1	268	0	270
10460	282	0	1	1	0	284
10461	0	1	0	286	0	287
10462	0	1	0	291	0	292
10463	288	1	0	3	0	292
10464	285	0	0	0	0	285
10465	1	1	277	0	0	279
10466	0	0	275	1	0	276
10467	0	0	282	1	0	283
10468	1	0	0	280	0	281
10469	0	1	0	286	0	287
10470	1	293	1	1	0	296
10471	292	2	0	2	0	296
10472	1	0	0	297	0	298
10473	1	0	0	295	0	296
10474	0	301	0	2	0	303
10475	0	317	0	1	0	318
10476	2	1	0	320	0	323
10477	2	0	0	339	0	341
10478	342	0	1	4	0	347
10479	342	0	1	2	0	345
10480	4	0	1	340	0	345
10481	2	0	331	3	0	336
10482	2	0	323	0	0	325
10483	1	0	4	324	0	329
10484	0	0	1	325	0	326
10485	0	317	0	4	0	321
10486	308	3	0	3	0	314
10487	3	2	0	308	0	313
10488	1	0	309	3	0	313
10489	2	0	3	308	0	313
10490	0	0	314	3	0	317
10491	0	0	313	1	0	314
10492	0	0	4	318	0	322
10493	313	0	1	4	0	318
10494	3	1	313	1	0	318
10495	3	0	2	301	0	306
10496	0	0	345	3	0	348
10497	1	0	3	342	0	346
10498	0	0	1	343	0	344
10499	0	0	341	4	0	345
10500	1	0	331	1	0	333
10501	4	0	4	319	0	327
10502	0	0	1	330	0	331
10503	2	0	0	332	0	334
10504	1	0	0	326	0	327
10505	320	1	0	9	0	330
10506	332	0	0	2	0	334
10507	4	325	0	0	0	329
10508	323	4	0	6	0	333
10509	5	1	0	323	0	329
10510	314	0	0	8	0	322
10511	4	0	312	1	0	317
10512	310	0	3	3	0	316
10513	4	0	2	317	0	323
10514	2	0	0	320	0	322
10515	313	0	1	8	0	322
10516	5	0	1	340	0	346
10517	2	1	350	7	0	360
10518	342	2	8	6	0	358
10519	11	360	2	2	0	375
10520	2	11	3	380	0	396
10521	3	2	396	13	0	414
10522	0	1	15	380	0	396
10523	1	1	392	17	0	411
10524	1	2	17	377	0	397
10525	1	382	1	17	0	401
10526	1	14	2	390	0	407
10527	0	404	2	17	0	423
10528	1	15	1	393	0	410
10529	2	3	1	421	0	427
10530	4	2	3	418	0	427
10531	4	1	0	426	0	431
10532	4	2	1	423	0	430
10533	2	0	408	22	0	432
10534	3	0	17	405	0	425
10535	1	1	5	421	0	428
10536	400	1	4	25	0	430
10537	16	393	2	10	0	421
10538	396	21	1	7	0	425
10539	20	4	3	392	0	419
10540	5	3	388	19	0	415
10541	2	386	15	9	0	412
10542	381	16	4	13	0	414
10543	18	385	2	6	0	411
10544	3	403	3	3	0	412
10545	390	20	2	6	0	418
10546	20	6	1	409	0	436
10547	409	3	2	22	0	436
10548	22	4	1	406	0	433
10549	6	0	399	24	0	429
10550	2	2	406	10	0	420
10551	380	2	23	10	0	415
10552	410	1	7	8	0	426
10553	22	2	5	384	0	413
10554	11	3	2	404	0	420
10555	372	1	0	30	0	403
10556	19	363	3	7	0	392
10557	3	394	1	8	0	406
10558	373	20	1	8	0	402
10559	384	7	2	6	0	399
10560	23	379	3	3	0	408
10561	12	21	1	381	0	415
10562	7	5	382	18	0	412
10563	6	4	389	6	0	405
10564	368	2	21	10	0	401
10565	22	0	383	6	0	411
10566	9	2	22	368	0	401
10567	7	3	5	369	0	384
10568	6	373	4	23	0	406
10569	374	18	5	9	0	406
10570	20	7	3	372	0	402
10571	10	3	362	20	0	395
10572	3	360	17	11	0	391
10573	6	20	6	367	0	399
10574	5	3	358	26	0	392
10575	4	6	344	7	0	361
10576	2	344	23	7	0	376
10577	305	15	8	10	0	338
10578	17	316	8	5	0	346
10579	310	18	6	9	0	343
10580	19	4	311	8	0	342
10581	307	5	21	4	0	337
10582	21	313	6	4	0	344
10583	6	21	3	316	0	346
10584	5	5	3	337	0	350
10585	322	4	1	19	0	346
10586	17	6	314	11	0	348
10587	315	5	17	8	0	345
10588	329	4	4	8	0	345
10589	20	5	310	5	0	340
10590	8	3	327	6	0	344
10591	4	3	23	307	0	337
10592	311	2	7	24	0	344
10593	321	3	9	7	0	340
10594	19	325	5	5	0	354
10595	12	16	1	325	0	354
10596	7	4	7	325	0	343
10597	6	7	3	323	0	339
10598	9	3	1	327	0	340
10599	311	3	2	27	0	343
10600	21	2	3	319	0	345
10601	9	5	314	20	0	348
10602	2	5	328	9	0	344
10603	310	3	19	3	0	335
10604	23	289	6	8	0	326
10605	8	320	9	2	0	339
10606	7	17	6	314	0	344
10607	8	7	2	326	0	343
10608	9	4	5	317	0	335
10609	7	2	5	329	0	343
10610	8	4	302	23	0	337
10611	11	2	15	303	0	331
10612	5	2	4	317	0	328
10613	1	3	289	23	0	316
10614	286	1	15	10	0	312
10615	15	286	6	10	0	317
10616	261	10	4	7	0	282
10617	10	2	255	3	0	270
10618	6	1	254	3	0	264
10619	3	239	7	4	0	253
10620	200	10	10	4	0	224
10621	193	2	2	1	0	198
10622	198	0	1	3	0	202
10623	6	192	0	0	0	198
10624	187	3	0	0	0	190
10625	3	2	194	0	0	199
10626	1	190	3	1	0	195
10627	181	3	1	1	0	186
10628	4	188	0	1	0	193
10629	178	4	0	3	0	185
10630	178	1	0	1	0	180
10631	4	0	175	3	0	182
10632	1	178	5	0	0	184
10633	173	4	2	3	0	182
10634	5	1	174	1	0	181
10635	1	177	5	0	0	183
10636	2	2	0	169	0	173
10637	0	2	169	3	0	174
10638	1	0	163	2	0	166
10639	0	0	5	162	0	167
10640	159	0	2	5	0	166
10641	2	166	1	1	0	170
10642	2	2	162	1	0	167
10643	1	1	153	1	0	156
10644	147	0	4	1	0	152
10645	3	163	2	1	0	169
10646	141	1	0	2	0	144
10647	1	147	1	0	0	149
10648	151	2	1	0	0	154
10649	145	0	0	1	0	146
10650	2	146	0	0	0	148
10651	1	1	0	146	0	148
10652	156	0	1	1	0	158
10653	1	0	2	156	0	159
10654	1	1	0	164	0	166
10655	164	1	0	1	0	166
10656	1	166	1	0	0	168
10657	166	2	0	3	0	171
10658	1	0	167	2	0	170
10659	1	0	2	166	0	169
10660	0	0	1	166	0	167
10661	167	0	1	3	0	171
10662	167	0	0	2	0	169
10663	1	1	0	168	0	170
10664	0	0	168	1	0	169
10665	1	0	2	171	0	174
10666	1	1	0	173	0	175
10667	2	2	0	172	0	176
10668	1	0	1	167	0	169
10669	173	1	1	1	0	176
10670	2	1	175	0	0	178
10671	2	170	1	0	0	173
10672	1	2	0	175	0	178
10673	1	0	0	178	0	179
10674	1	2	176	2	0	181
10675	1	0	169	1	0	171
10676	1	0	3	174	0	178
10677	2	1	0	178	0	181
10678	1	1	181	2	0	185
10679	2	1	1	173	0	177
10680	174	0	1	2	0	177
10681	3	184	2	1	0	190
10682	0	4	176	2	0	182
10683	2	179	2	0	0	183
10684	4	3	0	179	0	186
10685	1	0	185	3	0	189
10686	0	186	6	0	0	192
10687	0	3	0	188	0	191
10688	0	0	188	5	0	193
10689	1	0	3	184	0	188
10690	1	0	0	192	0	193
10691	188	0	0	4	0	192
10692	3	1	1	188	0	193
10693	181	1	1	6	0	189
10694	171	0	1	4	0	176
10695	177	0	0	4	0	181
10696	4	1	1	176	0	182
10697	3	0	173	2	0	178
10698	1	0	165	1	0	167
10699	163	1	3	3	0	170
10700	2	0	168	1	0	171
10701	161	0	3	3	0	167
10702	4	165	2	0	0	171
10703	163	4	3	1	0	171
10704	3	0	170	2	0	175
10705	0	2	172	2	0	176
10706	2	0	5	172	0	179
10707	0	0	181	4	0	185
10708	2	0	188	0	0	190
10709	0	1	3	191	0	195
10710	0	0	3	196	0	199
10711	0	2	2	199	0	203
10712	0	198	0	6	0	204
10713	0	2	2	189	0	193
10714	0	203	0	3	0	206
10715	195	2	0	3	0	200
10716	199	0	2	1	0	202
10717	4	0	0	190	0	194
10718	1	189	0	5	0	195
10719	4	2	194	2	0	202
10720	202	0	2	4	0	208
10721	4	2	0	198	0	204
10722	5	0	1	193	0	199
10723	4	0	1	201	0	206
10724	196	0	0	5	0	201
10725	2	184	3	2	0	191
10726	1	193	2	2	0	198
10727	187	2	0	2	0	191
10728	3	190	2	1	0	196
10729	189	3	1	2	0	195
10730	186	1	0	3	0	190
10731	4	192	1	1	0	198
10732	1	2	4	184	0	191
10733	2	190	3	3	0	198
10734	2	3	0	192	0	197
10735	1	0	3	203	0	207
10736	195	2	1	6	0	204
10737	202	0	0	5	0	207
10738	6	2	1	202	0	211
10739	2	2	198	5	0	207
10740	188	2	3	2	0	195
10741	4	202	1	4	0	211
10742	3	5	3	199	0	210
10743	6	1	3	203	0	213
10744	2	3	0	209	0	214
10745	205	0	0	10	0	215
10746	198	7	1	2	0	208
10747	5	189	4	5	0	203
10748	4	195	0	3	0	202
10749	3	3	0	196	0	202
10750	4	3	1	198	0	206
10751	0	2	198	10	0	210
10752	3	2	2	192	0	199
10753	3	1	190	4	0	198
10754	2	4	178	2	0	186
10755	1	174	3	6	0	184
10756	3	5	2	177	0	187
10757	180	1	2	6	0	189
10758	10	1	0	171	0	182
10759	4	2	170	6	0	182
10760	165	4	3	4	0	176
10761	168	2	1	4	0	175
10762	6	2	174	3	0	185
10763	4	1	4	175	0	184
10764	175	0	3	5	0	183
10765	5	171	4	4	0	184
10766	171	3	2	3	0	179
10767	177	4	4	2	0	187
10768	9	3	0	170	0	182
10769	4	2	1	172	0	179
10770	178	1	1	7	0	187
10771	8	2	0	173	0	183
10772	3	1	172	7	0	183
10773	167	2	5	2	0	176
10774	165	2	1	3	0	171
10775	6	163	2	2	0	173
10776	3	165	0	3	0	171
10777	4	4	1	155	0	164
10778	3	168	0	5	0	176
10779	6	5	0	165	0	176
10780	168	2	0	8	0	178
10781	157	1	1	5	0	164
10782	7	157	0	4	0	168
10783	163	3	0	4	0	170
10784	4	157	0	5	0	166
10785	158	3	5	2	0	168
10786	163	1	0	4	0	168
10787	6	2	157	2	0	167
10788	149	1	4	3	0	157
10789	4	148	2	2	0	156
10790	3	149	1	6	0	159
10791	151	7	1	2	0	161
10792	3	3	1	155	0	162
10793	4	3	152	3	0	162
10794	4	4	2	155	0	165
10795	4	2	1	154	0	161
10796	4	2	151	5	0	162
10797	145	2	4	3	0	154
10798	7	150	1	3	0	161
10799	154	4	2	0	0	160
10800	3	3	2	147	0	155
10801	147	1	3	3	0	154
10802	5	147	1	3	0	156
10803	7	6	1	143	0	157
10804	147	1	1	6	0	155
10805	2	1	140	5	0	148
10806	4	1	131	2	0	138
10807	127	4	5	2	0	138
10808	4	123	1	4	0	132
10809	4	108	2	1	0	115
10810	5	5	2	95	0	107
10811	0	98	1	6	0	105
10812	6	2	1	97	0	106
10813	2	2	1	103	0	108
10814	3	1	1	101	0	106
10815	3	96	2	3	0	104
10816	2	3	0	100	0	105
10817	3	1	97	3	0	104
10818	1	95	4	3	0	103
10819	3	1	1	81	0	86
10820	1	87	0	3	0	91
10821	87	2	2	2	0	93
10822	87	1	1	0	0	89
10823	85	0	1	1	0	87
10824	4	86	2	0	0	92
10825	2	3	0	87	0	92
10826	1	2	84	3	0	90
10827	0	3	82	1	0	86
10828	81	0	3	3	0	87
10829	83	1	1	1	0	86
10830	3	0	0	84	0	87
10831	3	1	0	90	0	94
10832	2	0	91	4	0	97
10833	0	83	3	9	0	95
10834	0	84	2	3	0	89
10835	1	1	80	1	0	83
10836	2	2	1	75	0	80
10837	2	0	0	65	0	67
10838	1	1	0	76	0	78
10839	2	0	0	74	0	76
10840	74	1	0	1	0	76
10841	1	0	71	2	0	74
10842	70	1	2	1	0	74
10843	1	0	1	75	0	77
10844	70	0	1	1	0	72
10845	2	0	1	69	0	72
10846	1	0	71	2	0	74
10847	2	0	1	72	0	75
10848	0	0	78	2	0	80
10849	0	1	1	72	0	74
10850	0	1	73	1	0	75
10851	0	74	1	0	0	75
10852	0	1	0	76	0	77
10853	0	0	1	78	0	79
10854	0	77	0	3	0	80
10855	79	1	0	2	0	82
10856	4	0	0	80	0	84
10857	0	0	1	83	0	84
10858	83	0	0	3	0	86
10859	81	0	1	1	0	83
10860	87	0	0	0	0	87
10861	87	0	0	2	0	89
10862	4	0	76	0	0	80
10863	81	0	2	2	0	85
10864	85	0	2	0	0	87
10865	3	0	0	80	0	83
10866	1	0	1	81	0	83
10867	78	0	0	3	0	81
10868	3	78	1	0	0	82
10869	0	3	0	75	0	78
10870	0	0	84	3	0	87
10871	0	86	2	1	0	89
10872	83	1	0	0	0	84
10873	84	0	0	1	0	85
10874	86	0	0	1	0	87
10875	87	0	0	1	0	88
10876	1	0	0	81	0	82
10877	0	1	80	2	0	83
10878	1	0	82	1	0	84
10879	1	0	4	86	0	91
10880	94	1	0	3	0	98
10881	3	0	0	95	0	98
10882	0	0	94	4	0	98
10883	92	1	3	1	0	97
10884	98	0	0	1	0	99
10885	3	0	0	97	0	100
10886	0	0	100	4	0	104
10887	1	0	98	0	0	99
10888	102	0	2	1	0	105
10889	5	100	0	1	0	106
10890	2	3	103	0	0	108
10891	1	0	4	102	0	107
10892	101	0	1	4	0	106
10893	5	96	0	0	0	101
10894	1	106	0	1	0	108
10895	103	3	0	2	0	108
10896	4	0	1	102	0	107
10897	109	1	0	3	0	113
10898	4	0	0	111	0	115
10899	0	1	1	115	0	117
10900	0	1	114	3	0	118
10901	2	0	104	1	0	107
10902	2	0	115	0	0	117
10903	1	0	3	114	0	118
10904	116	1	0	4	0	121
10905	3	0	113	1	0	117
10906	0	0	4	114	0	118
10907	1	0	119	3	0	123
10908	0	122	4	2	0	128
10909	1	3	0	126	0	130
10910	0	0	1	131	0	132
10911	0	0	2	130	0	132
10912	128	0	1	4	0	133
10913	5	0	0	129	0	134
10914	3	0	0	132	0	135
10915	125	0	2	4	0	131
10916	3	0	128	1	0	132
10917	127	0	4	0	0	131
10918	128	2	0	0	0	130
10919	3	0	126	1	0	130
10920	123	0	2	2	0	127
10921	4	0	0	129	0	133
10922	1	1	134	3	0	139
10923	133	1	3	1	0	138
10924	142	0	0	1	0	143
10925	5	0	0	139	0	144
10926	1	0	1	143	0	145
10927	1	0	0	142	0	143
10928	135	0	0	4	0	139
10929	2	136	1	0	0	139
10930	130	3	1	0	0	134
10931	3	129	1	1	0	134
10932	0	127	2	1	0	130
10933	2	3	0	132	0	137
10934	2	0	1	134	0	137
10935	0	1	0	132	0	133
10936	0	0	1	134	0	135
10937	0	1	127	4	0	132
10938	125	0	3	1	0	129
10939	3	1	0	128	0	132
10940	1	0	133	4	0	138
10941	1	1	3	129	0	134
10942	1	1	0	136	0	138
10943	0	0	137	4	0	141
10944	1	0	3	139	0	143
10945	2	0	2	145	0	149
10946	144	1	1	4	0	150
10947	5	0	139	1	0	145
10948	132	0	3	2	0	137
10949	3	139	0	3	0	145
10950	138	3	2	0	0	143
10951	140	0	0	3	0	143
10952	4	0	0	139	0	143
10953	1	1	138	3	0	143
10954	0	141	5	1	0	147
10955	2	1	0	134	0	137
10956	3	136	0	1	0	140
10957	136	1	2	2	0	141
10958	3	1	133	0	0	137
10959	2	1	130	1	0	134
10960	1	0	2	133	0	136
10961	3	0	141	1	0	145
10962	1	0	1	147	0	149
10963	1	0	1	147	0	149
10964	145	0	1	2	0	148
10965	1	150	1	2	0	154
10966	2	3	1	147	0	153
10967	0	1	0	156	0	157
10968	3	0	1	152	0	156
10969	0	150	2	1	0	153
10970	0	147	1	2	0	150
10971	146	1	2	1	0	150
10972	146	1	1	2	0	150
10973	144	0	1	3	0	148
10974	3	0	142	2	0	147
10975	0	0	3	148	0	151
10976	2	0	142	6	0	150
10977	0	145	1	3	0	149
10978	138	0	1	2	0	141
10979	0	1	139	2	0	142
10980	1	0	1	139	0	141
10981	2	0	140	0	0	142
10982	133	0	0	2	0	135
10983	135	1	0	2	0	138
10984	136	1	0	1	0	138
10985	137	0	1	0	0	138
10986	2	0	142	0	0	144
10987	139	1	0	0	0	140
10988	138	0	1	0	0	139
10989	1	139	0	1	0	141
10990	142	0	1	1	0	144
10991	141	1	1	0	0	143
10992	1	1	0	141	0	143
10993	0	146	1	0	0	147
10994	152	1	0	2	0	155
10995	160	0	1	2	0	163
10996	3	0	180	0	0	183
10997	2	0	179	0	0	181
10998	1	0	179	1	0	181
10999	2	1	7	178	0	188
11000	174	0	1	8	0	183
11001	6	176	1	1	0	184
11002	174	6	1	1	0	182
11003	6	176	1	0	0	183
11004	174	6	0	1	0	181
11005	6	172	0	0	0	178
11006	0	181	0	1	0	182
11007	171	7	0	1	0	179
11008	6	181	0	0	0	187
11009	2	5	0	176	0	183
11010	0	1	174	6	0	181
11011	0	1	179	0	0	180
11012	1	0	7	167	0	175
11013	0	1	0	177	0	178
11014	1	0	174	8	0	183
11015	0	1	8	170	0	179
11016	0	0	1	182	0	183
11017	171	1	0	10	0	182
11018	8	172	0	1	0	181
11019	1	7	1	171	0	180
11020	0	173	1	6	0	180
11021	173	7	1	4	0	185
11022	8	178	1	0	0	187
11023	172	8	0	4	0	184
11024	175	0	1	4	0	180
11025	7	2	1	167	0	177
11026	2	0	0	176	0	178
11027	0	2	0	173	0	175
11028	2	1	1	174	0	178
11029	2	0	166	9	0	177
11030	156	1	6	4	0	167
11031	8	159	1	1	0	169
11032	0	9	1	170	0	180
11033	1	0	1	175	0	177
11034	0	170	1	7	0	178
11035	169	7	1	3	0	180
11036	7	174	0	1	0	182
11037	2	7	0	169	0	178
11038	1	1	1	178	0	181
11039	1	1	0	179	0	181
11040	2	1	0	174	0	177
11041	167	2	0	10	0	179
11042	8	1	164	2	0	175
11043	0	1	9	164	0	174
11044	1	1	0	172	0	174
11045	2	1	1	167	0	171
11046	1	2	1	162	0	166
11047	154	0	1	12	0	167
11048	8	2	157	1	0	168
11049	2	0	8	154	0	164
11050	0	151	1	9	0	161
11051	0	157	0	4	0	161
11052	154	7	0	3	0	164
11053	7	2	155	0	0	164
11054	146	0	7	4	0	157
11055	7	3	152	0	0	162
11056	1	1	8	143	0	153
11057	149	1	0	11	0	161
11058	8	153	1	1	0	163
11059	3	7	1	143	0	154
11060	0	138	1	9	0	148
11061	146	7	0	5	0	158
11062	154	0	0	2	0	156
11063	7	2	0	145	0	154
11064	0	0	147	9	0	156
11065	1	2	150	0	0	153
11066	1	1	8	145	0	155
11067	1	147	0	8	0	156
11068	1	7	0	160	0	168
11069	1	1	1	161	0	164
11070	1	0	1	159	0	161
11071	2	1	160	8	0	171
11072	0	1	8	157	0	166
11073	1	0	0	161	0	162
11074	0	156	1	7	0	164
11075	1	8	0	150	0	159
11076	3	1	1	160	0	165
11077	0	0	2	163	0	165
11078	2	0	0	163	0	165
11079	0	2	1	164	0	167
11080	0	0	0	160	0	160
11081	1	1	0	160	0	162
11082	1	1	0	159	0	161
11083	1	0	141	16	0	158
11084	0	2	5	151	0	158
11085	152	1	0	10	0	163
11086	9	1	0	142	0	152
11087	2	0	148	9	0	159
11088	141	1	10	1	0	153
11089	154	0	1	2	0	157
11090	154	0	1	1	0	156
11091	151	1	0	4	0	156
11092	10	0	1	146	0	157
11093	1	0	140	9	0	150
11094	1	138	6	3	0	148
11095	1	132	2	0	0	135
11096	2	1	4	106	0	113
11097	1	1	0	107	0	109
11098	0	0	0	106	0	106
11099	0	0	0	109	0	109
11100	1	1	0	117	0	119
11101	128	0	0	2	0	130
11102	1	125	0	0	0	126
11103	0	135	0	1	0	136
11104	0	4	0	135	0	139
11105	0	1	0	139	0	140
11106	0	0	0	139	0	139
11107	3	1	0	134	0	138
11108	0	0	130	3	0	133
11109	0	126	4	2	0	132
11110	1	2	2	126	0	131
11111	126	0	0	5	0	131
11112	3	0	0	125	0	128
11113	3	0	124	2	0	129
11114	0	1	119	3	0	123
11115	0	0	124	2	0	126
11116	0	1	3	123	0	127
11117	124	1	2	3	0	130
11118	2	0	0	128	0	130
11119	1	0	1	128	0	130
11120	127	0	0	4	0	131
11121	2	0	0	135	0	137
11122	2	0	0	129	0	131
11123	1	0	137	2	0	140
11124	0	131	2	1	0	134
11125	0	3	2	133	0	138
11126	126	1	1	7	0	135
11127	4	0	0	133	0	137
11128	3	1	131	4	0	139
11129	0	0	4	139	0	143
11130	1	137	2	5	0	145
11131	2	5	0	145	0	152
11132	0	1	138	5	0	144
11133	1	150	4	2	0	157
11134	1	5	2	153	0	161
11135	2	2	1	179	0	184
11136	1	0	0	186	0	187
11137	4	1	1	184	0	190
11138	0	1	181	7	0	189
11139	1	177	5	2	0	185
11140	177	3	1	5	0	186
11141	187	2	0	2	0	191
11142	7	0	0	190	0	197
11143	1	0	185	6	0	192
11144	183	1	5	3	0	192
11145	6	0	2	188	0	196
11146	1	1	196	6	0	204
11147	1	0	4	197	0	202
11148	3	1	1	198	0	203
11149	1	0	0	205	0	206
11150	1	1	202	6	0	210
11151	1	1	4	197	0	203
11152	1	203	1	5	0	210
11153	206	5	0	5	0	216
11154	204	1	1	2	0	208
11155	207	1	0	2	0	210
11156	6	203	0	2	0	211
11157	201	6	2	2	0	211
11158	6	3	0	198	0	207
11159	201	0	0	8	0	209
11160	201	0	0	3	0	204
11161	6	1	197	2	0	206
11162	3	194	6	1	0	204
11163	194	5	1	4	0	204
11164	6	1	2	200	0	209
11165	2	2	196	7	0	207
11166	3	198	4	1	0	206
11167	198	6	1	5	0	210
11168	4	1	1	201	0	207
11169	2	0	0	204	0	206
11170	3	0	0	198	0	201
11171	1	193	1	8	0	203
11172	0	6	3	198	0	207
11173	1	198	0	7	0	206
11174	4	6	1	203	0	214
11175	2	4	200	8	0	214
11176	2	0	8	203	0	213
11177	3	2	3	210	0	218
11178	3	1	1	213	0	218
11179	1	2	204	7	0	214
11180	6	0	5	199	0	210
11181	3	0	2	204	0	209
11182	4	1	2	212	0	219
11183	2	1	2	205	0	210
11184	2	2	0	212	0	216
11185	2	2	197	9	0	210
11186	1	0	7	197	0	205
11187	3	1	3	200	0	207
11188	197	2	0	8	0	207
11189	8	190	0	3	0	201
11190	3	200	2	0	0	205
11191	2	6	0	200	0	208
11192	4	2	0	197	0	203
11193	3	189	1	7	0	200
11194	1	4	2	193	0	200
11195	1	195	1	7	0	204
11196	3	6	1	192	0	202
11197	3	1	1	189	0	194
11198	1	1	186	9	0	197
11199	3	179	5	2	0	189
11200	1	181	1	2	0	185
11201	152	3	2	5	0	162
11202	3	160	0	2	0	165
11203	2	3	0	155	0	160
11204	3	1	149	2	0	155
11205	0	0	4	148	0	152
11206	143	2	1	5	0	151
11207	5	0	141	1	0	147
11208	0	148	4	3	0	155
11209	2	4	2	138	0	146
11210	2	1	0	153	0	156
11211	154	0	1	5	0	160
11212	3	0	1	159	0	163
11213	0	0	1	159	0	160
11214	0	0	0	158	0	158
11215	1	2	1	154	0	158
11216	150	0	0	7	0	157
11217	148	1	0	2	0	151
11218	5	0	1	143	0	149
11219	142	2	1	4	0	149
11220	3	0	0	142	0	145
11221	2	0	136	5	0	143
11222	1	1	135	2	0	139
11223	2	2	3	129	0	136
11224	0	133	2	5	0	140
11225	0	4	0	132	0	136
11226	133	2	0	4	0	139
11227	3	0	0	134	0	137
11228	130	0	1	1	0	132
11229	1	1	1	131	0	134
11230	1	0	139	3	0	143
11231	0	129	1	2	0	132
11232	1	135	0	2	0	138
11233	1	3	0	123	0	127
11234	0	0	126	0	0	126
11235	0	104	0	0	0	104
11236	1	0	0	95	0	96
11237	96	0	0	1	0	97
11238	0	0	101	0	0	101
11239	0	0	1	96	0	97
11240	0	0	0	100	0	100
11241	0	0	101	1	0	102
11242	0	0	90	0	0	90
11243	1	0	98	0	0	99
11244	0	0	1	95	0	96
11245	0	0	100	1	0	101
11246	92	1	1	0	0	94
11247	1	1	0	111	0	113
11248	0	0	130	1	0	131
11249	0	143	2	0	0	145
11250	0	2	148	0	0	150
11251	0	0	1	149	0	150
11252	149	0	0	2	0	151
11253	0	0	1	151	0	152
11254	2	1	0	154	0	157
11255	168	0	0	2	0	170
11256	1	0	1	171	0	173
11257	0	0	175	1	0	176
11258	164	0	2	1	0	167
11259	1	178	0	1	0	180
11260	176	0	2	1	0	179
11261	1	0	0	178	0	179
11262	2	0	172	1	0	175
11263	0	0	181	1	0	182
11264	0	1	1	177	0	179
11265	1	0	1	180	0	182
11266	0	0	183	2	0	185
11267	1	0	175	0	0	176
11268	183	0	1	1	0	185
11269	2	1	0	183	0	186
11270	187	0	0	1	0	188
11271	2	0	0	184	0	186
11272	0	0	195	1	0	196
11273	1	0	193	0	0	194
11274	1	1	1	193	0	196
11275	2	0	0	201	0	203
11276	0	0	199	2	0	201
11277	188	0	4	1	0	193
11278	3	0	1	208	0	212
11279	217	0	0	5	0	222
11280	3	238	1	1	0	243
11281	0	3	1	245	0	249
11282	247	2	2	3	0	254
11283	4	0	245	2	0	251
11284	5	0	3	243	0	251
11285	1	0	2	246	0	249
11286	0	0	1	251	0	252
11287	1	0	250	5	0	256
11288	1	0	4	238	0	243
11289	1	245	2	4	0	252
11290	0	1	0	253	0	254
11291	0	2	241	4	0	247
11292	2	2	237	2	0	243
11293	0	0	4	243	0	247
11294	1	0	2	246	0	249
11295	0	1	0	245	0	246
11296	1	0	0	239	0	240
11297	238	1	1	6	0	246
11298	235	0	2	5	0	242
11299	6	0	230	2	0	238
11300	4	239	4	2	0	249
11301	0	1	3	244	0	248
11302	247	2	3	6	0	258
11303	241	1	0	4	0	246
11304	255	0	0	4	0	259
11305	257	0	1	3	0	261
11306	7	0	247	1	0	255
11307	245	1	4	0	0	250
11308	5	252	2	1	0	260
11309	2	3	2	253	0	260
11310	1	3	248	4	0	256
11311	2	0	4	247	0	253
11312	3	0	247	4	0	254
11313	0	0	3	242	0	245
11314	0	0	3	251	0	254
11315	243	0	2	9	0	254
11316	4	2	1	242	0	249
11317	4	2	238	7	0	251
11318	5	0	3	246	0	254
11319	242	0	5	7	0	254
11320	3	0	4	244	0	251
11321	3	0	244	7	0	254
11322	2	237	4	5	0	248
11323	243	3	6	5	0	257
11324	4	2	4	235	0	245
11325	5	249	0	5	0	259
11326	243	4	0	9	0	256
11327	4	3	244	2	0	253
11328	2	244	6	1	0	253
11329	3	4	4	244	0	255
11330	1	3	243	8	0	255
11331	3	1	5	237	0	246
11332	240	0	3	8	0	251
11333	6	0	239	4	0	249
11334	6	0	4	240	0	250
11335	2	1	243	5	0	251
11336	0	3	5	241	0	249
11337	0	2	3	245	0	250
11338	239	0	1	10	0	250
11339	4	243	2	6	0	255
11340	7	1	2	243	0	253
11341	243	4	0	6	0	253
11342	242	1	2	6	0	251
11343	10	0	3	240	0	253
11344	5	235	1	5	0	246
11345	2	244	2	6	0	254
11346	1	3	2	247	0	253
11347	0	4	2	246	0	252
11348	231	2	4	7	0	244
11349	5	0	0	231	0	236
11350	3	1	214	7	0	225
11351	210	0	2	7	0	219
11352	3	212	3	4	0	222
11353	215	2	3	1	0	221
11354	4	3	220	3	0	230
11355	3	233	3	2	0	241
11356	228	4	4	3	0	239
11357	230	3	2	3	0	238
11358	7	2	233	0	0	242
11359	231	1	3	3	0	238
11360	235	0	4	3	0	242
11361	7	237	2	0	0	246
11362	4	5	1	246	0	256
11363	3	3	241	4	0	251
11364	4	4	4	241	0	253
11365	1	2	249	7	0	259
11366	4	0	7	243	0	254
11367	248	0	2	7	0	257
11368	8	1	2	251	0	262
11369	5	1	269	7	0	282
11370	274	0	7	6	0	287
11371	5	1	7	279	0	292
11372	4	0	275	9	0	288
11373	267	0	8	7	0	282
11374	9	0	4	277	0	290
11375	7	3	265	6	0	281
11376	3	2	255	7	0	267
11377	3	1	11	257	0	272
11378	2	2	269	5	0	278
11379	3	254	7	7	0	271
11380	3	2	3	243	0	251
11381	238	2	3	6	0	249
11382	5	2	249	3	0	259
11383	3	0	250	4	0	257
11384	240	0	8	1	0	249
11385	4	0	255	1	0	260
11386	234	1	8	2	0	245
11387	5	1	247	2	0	255
11388	4	1	6	239	0	250
11389	3	0	251	5	0	259
11390	3	0	8	243	0	254
11391	2	0	258	4	0	264
11392	1	1	249	3	0	254
11393	242	1	8	3	0	254
11394	5	254	6	0	0	265
11395	258	3	2	4	0	267
11396	6	253	3	2	0	264
11397	3	3	3	254	0	263
11398	2	2	2	256	0	262
11399	252	2	3	8	0	265
11400	4	0	2	256	0	262
11401	4	1	251	4	0	260
11402	242	1	5	3	0	251
11403	241	3	3	2	0	249
11404	6	2	2	238	0	248
11405	4	1	244	6	0	255
11406	2	1	5	240	0	248
11407	1	237	3	7	0	248
11408	3	2	3	249	0	257
11409	4	3	1	254	0	262
11410	3	1	248	6	0	258
11411	226	1	4	4	0	235
11412	6	243	4	5	0	258
11413	248	3	5	3	0	259
11414	6	240	1	4	0	251
11415	4	5	3	233	0	245
11416	2	240	4	6	0	252
11417	1	6	239	4	0	250
11418	3	1	4	226	0	234
11419	4	2	3	231	0	240
11420	2	2	6	235	0	245
11421	230	2	2	11	0	245
11422	11	4	2	227	0	244
11423	228	3	2	9	0	242
11424	225	2	4	4	0	235
11425	227	1	3	3	0	234
11426	6	2	233	5	0	246
11427	6	1	8	227	0	242
11428	4	1	5	237	0	247
11429	3	1	5	244	0	253
11430	251	0	3	11	0	265
11431	9	1	3	252	0	265
11432	5	1	4	260	0	270
11433	271	0	4	9	0	284
11434	11	1	3	281	0	296
11435	3	2	287	11	0	303
11436	4	0	279	8	0	291
11437	7	1	7	292	0	307
11438	286	1	4	14	0	305
11439	284	1	7	8	0	300
11440	12	2	0	283	0	297
11441	6	0	281	12	0	299
11442	4	278	7	8	0	297
11443	8	3	5	278	0	294
11444	2	2	2	295	0	301
11445	3	2	8	286	0	299
11446	283	3	4	12	0	302
11447	7	0	283	10	0	300
11448	284	2	7	7	0	300
11449	10	1	5	276	0	292
11450	2	275	3	12	0	292
11451	283	5	7	3	0	298
11452	273	5	2	8	0	288
11453	7	3	273	7	0	290
11454	7	256	5	3	0	271
11455	4	253	2	5	0	264
11456	253	5	3	4	0	265
11457	7	3	5	249	0	264
11458	9	3	2	252	0	266
11459	7	1	4	237	0	249
11460	4	239	1	9	0	253
11461	0	247	4	8	0	259
11462	235	6	1	4	0	246
11463	9	2	1	232	0	244
11464	4	5	238	6	0	253
11465	6	2	8	241	0	257
11466	5	4	263	7	0	279
11467	2	1	259	7	0	269
11468	1	2	256	5	0	264
11469	1	215	13	3	0	232
11470	3	8	10	205	0	226
11471	1	219	5	6	0	231
11472	3	12	2	200	0	217
11473	5	6	0	218	0	229
11474	210	3	1	13	0	227
11475	6	1	0	219	0	226
11476	216	0	2	13	0	231
11477	221	0	1	7	0	229
11478	13	1	4	205	0	223
11479	5	204	3	7	0	219
11480	7	7	2	197	0	213
11481	3	208	2	10	0	223
11482	3	9	1	204	0	217
11483	0	5	198	13	0	216
11484	5	3	8	205	0	221
11485	2	4	3	215	0	224
11486	200	0	2	16	0	218
11487	8	201	2	7	0	218
11488	7	7	0	208	0	222
11489	6	4	0	202	0	212
11490	3	197	2	11	0	213
11491	4	9	2	197	0	212
11492	187	2	0	16	0	205
11493	194	6	0	5	0	205
11494	12	193	0	5	0	210
11495	8	8	1	194	0	211
11496	192	2	2	11	0	207
11497	9	202	1	3	0	215
11498	4	10	0	191	0	205
11499	3	195	0	10	0	208
11500	196	9	0	6	0	211
11501	8	5	190	5	0	208
11502	2	5	192	6	0	205
11503	5	3	10	196	0	214
11504	5	2	197	8	0	212
11505	2	2	14	193	0	211
11506	189	2	4	13	0	208
11507	9	0	195	7	0	211
11508	4	5	10	189	0	208
11509	5	2	4	203	0	214
11510	198	3	5	10	0	216
11511	11	202	4	6	0	223
11512	203	10	0	9	0	222
11513	205	4	0	9	0	218
11514	13	194	1	3	0	211
11515	8	11	1	200	0	220
11516	5	4	194	11	0	214
11517	6	4	8	193	0	211
11518	3	198	4	12	0	217
11519	195	6	5	9	0	215
11520	9	4	2	202	0	217
11521	2	3	203	16	0	224
11522	10	4	10	202	0	226
11523	5	1	3	220	0	229
11524	4	2	4	216	0	226
11525	6	1	3	216	0	226
11526	3	2	0	220	0	225
11527	3	1	205	19	0	228
11528	1	2	204	10	0	217
11529	1	184	7	9	0	201
11530	1	186	6	4	0	197
11531	184	9	4	2	0	199
11532	7	6	178	2	0	193
11533	161	5	8	1	0	175
11534	10	2	154	4	0	170
11535	3	0	153	3	0	159
11536	3	2	10	145	0	160
11537	145	0	7	8	0	160
11538	8	1	5	151	0	165
11539	4	0	2	164	0	170
11540	3	2	182	12	0	199
11541	4	1	9	189	0	203
11542	1	2	4	194	0	201
11543	4	1	5	191	0	201
11544	1	1	3	194	0	199
11545	7	0	2	190	0	199
11546	177	0	3	16	0	196
11547	13	0	0	184	0	197
11548	2	2	180	11	0	195
11549	5	0	7	183	0	195
11550	2	3	179	11	0	195
11551	6	2	8	173	0	189
11552	1	1	183	10	0	195
11553	2	0	10	179	0	191
11554	1	0	6	191	0	198
11555	1	3	188	10	0	202
11556	163	1	6	11	0	181
11557	7	1	185	7	0	200
11558	6	0	10	180	0	196
11559	189	2	5	12	0	208
11560	8	0	2	200	0	210
11561	8	0	1	201	0	210
11562	4	1	201	12	0	218
11563	2	197	5	12	0	216
11564	1	188	5	3	0	197
11565	0	194	2	3	0	199
11566	0	2	0	164	0	166
11567	161	1	0	3	0	165
11568	0	0	0	162	0	162
11569	2	0	0	164	0	166
11570	0	0	0	164	0	164
11571	0	0	0	166	0	166
11572	0	162	0	2	0	164
11573	0	0	0	164	0	164
11574	0	2	0	161	0	163
11575	0	160	0	3	0	163
11576	156	1	0	4	0	161
11577	1	2	0	158	0	161
11578	159	0	0	2	0	161
11579	155	0	0	3	0	158
11580	3	159	0	0	0	162
11581	2	1	0	162	0	165
11582	0	1	164	1	0	166
11583	0	0	159	2	0	161
11584	1	0	3	161	0	165
11585	165	0	2	2	0	169
11586	164	0	0	2	0	166
11587	3	0	0	163	0	166
11588	164	0	0	2	0	166
11589	1	158	0	2	0	161
11590	160	1	0	0	0	161
11591	2	173	0	0	0	175
11592	2	1	0	175	0	178
11593	1	2	0	176	0	179
11594	0	172	0	4	0	176
11595	174	1	0	3	0	178
11596	2	2	170	0	0	174
11597	2	0	1	170	0	173
11598	0	1	170	1	0	172
11599	0	0	1	169	0	170
11600	167	0	3	2	0	172
11601	1	0	0	165	0	166
11602	156	0	0	4	0	160
11603	159	0	0	4	0	163
11604	3	0	0	160	0	163
11605	2	0	150	1	0	153
11606	1	156	1	2	0	160
11607	0	1	2	155	0	158
11608	155	2	0	2	0	159
11609	2	0	148	2	0	152
11610	3	0	1	147	0	151
11611	1	0	2	148	0	151
11612	0	0	0	155	0	155
11613	148	0	0	4	0	152
11614	1	0	0	149	0	150
11615	3	0	0	150	0	153
11616	1	0	149	3	0	153
11617	1	0	1	152	0	154
11618	0	0	2	152	0	154
11619	0	0	0	160	0	160
11620	0	156	0	3	0	159
11621	2	1	0	155	0	158
11622	1	2	0	152	0	155
11623	143	0	0	2	0	145
11624	1	0	146	2	0	149
11625	2	0	133	0	0	135
11626	0	134	3	0	0	137
11627	0	1	2	144	0	147
11628	137	1	0	3	0	141
11629	2	0	0	137	0	139
11630	3	0	0	138	0	141
11631	0	0	0	142	0	142
11632	0	0	0	141	0	141
11633	0	0	0	143	0	143
11634	0	0	137	5	0	142
11635	0	1	1	138	0	140
11636	135	0	2	5	0	142
11637	1	135	0	3	0	139
11638	3	2	0	135	0	140
11639	1	2	0	135	0	138
11640	0	0	129	4	0	133
11641	4	0	1	124	0	129
11642	1	0	2	134	0	137
11643	135	1	0	5	0	141
11644	1	139	1	4	0	145
11645	3	1	1	141	0	146
11646	1	3	1	139	0	144
11647	0	0	1	139	0	140
11648	1	0	137	5	0	143
11649	0	0	120	4	0	124
11650	0	138	5	2	0	145
11651	2	139	3	1	0	145
11652	1	4	2	137	0	144
11653	1	131	1	3	0	136
11654	0	4	1	140	0	145
11655	1	2	2	146	0	151
11656	1	1	1	156	0	159
11657	1	3	0	171	0	175
11658	3	1	167	9	0	180
11659	0	2	4	169	0	175
11660	0	1	3	173	0	177
11661	1	0	4	176	0	181
11662	161	0	3	18	0	182
11663	4	163	5	11	0	183
11664	5	4	3	166	0	178
11665	6	161	1	6	0	174
11666	156	9	0	9	0	174
11667	138	5	0	11	0	154
11668	7	156	2	5	0	170
11669	8	158	1	4	0	171
11670	7	9	154	4	0	174
11671	2	167	4	3	0	176
11672	3	12	3	159	0	177
11673	163	7	5	4	0	179
11674	4	173	1	5	0	183
11675	5	8	1	176	0	190
11676	4	6	2	176	0	188
11677	3	7	2	178	0	190
11678	174	3	1	15	0	193
11679	3	2	174	16	0	195
11680	165	3	3	10	0	181
11681	11	173	5	6	0	195
11682	12	5	4	177	0	198
11683	6	5	178	7	0	196
11684	171	8	3	8	0	190
11685	5	176	6	7	0	194
11686	10	5	6	169	0	190
11687	7	180	3	4	0	194
11688	6	11	2	176	0	195
11689	4	8	3	182	0	197
11690	3	8	175	11	0	197
11691	2	3	166	11	0	182
11692	2	4	7	179	0	192
11693	1	5	187	9	0	202
11694	0	2	9	189	0	200
11695	4	1	7	187	0	199
11696	2	1	8	189	0	200
11697	179	0	7	18	0	204
11698	4	0	6	199	0	209
11699	7	1	191	14	0	213
11700	193	2	3	11	0	209
11701	5	1	7	203	0	216
11702	10	1	6	201	0	218
11703	201	3	1	12	0	217
11704	7	200	2	16	0	225
11705	10	3	4	210	0	227
11706	8	6	3	209	0	226
11707	204	5	2	13	0	224
11708	4	3	206	13	0	226
11709	9	3	4	215	0	231
11710	10	1	5	210	0	226
11711	6	4	6	209	0	225
11712	3	207	4	14	0	228
11713	4	4	2	214	0	224
11714	205	5	4	14	0	228
11715	6	206	4	12	0	228
11716	205	5	3	14	0	227
11717	7	212	1	12	0	232
11718	211	10	1	9	0	231
11719	11	10	207	7	0	235
11720	9	8	211	7	0	235
11721	216	6	7	7	0	236
11722	9	5	219	3	0	236
11723	8	6	11	214	0	239
11724	13	3	7	187	0	210
11725	6	2	9	218	0	235
11726	210	2	7	13	0	232
11727	4	5	211	14	0	234
11728	209	1	6	11	0	227
11729	12	2	6	219	0	239
11730	217	4	6	11	0	238
11731	12	2	2	226	0	242
11732	229	3	2	15	0	249
11733	15	3	3	244	0	265
11734	11	1	245	13	0	270
11735	241	2	5	13	0	261
11736	250	2	5	10	0	267
11737	13	0	10	251	0	274
11738	16	0	4	243	0	263
11739	11	242	4	14	0	271
11740	252	4	3	14	0	273
11741	7	250	5	12	0	274
11742	249	8	2	8	0	267
11743	13	8	241	4	0	266
11744	6	5	238	6	0	255
11745	7	5	237	6	0	255
11746	239	3	10	2	0	254
11747	8	246	8	4	0	266
11748	6	6	7	239	0	258
11749	250	3	5	7	0	265
11750	9	245	4	4	0	262
11751	6	5	8	233	0	252
11752	5	225	5	9	0	244
11753	5	235	3	7	0	250
11754	5	235	3	5	0	248
11755	220	10	0	7	0	237
11756	6	209	0	9	0	224
11757	5	187	0	2	0	194
11758	4	187	1	3	0	195
11759	188	6	2	1	0	197
11760	189	0	0	3	0	192
11761	4	2	182	1	0	189
11762	183	0	3	2	0	188
11763	184	0	3	2	0	189
11764	6	0	1	184	0	191
11765	179	1	1	5	0	186
11766	5	0	178	1	0	184
11767	4	192	3	0	0	199
11768	195	3	1	5	0	204
11769	4	1	0	203	0	208
11770	201	2	0	4	0	207
11771	4	1	191	3	0	199
11772	188	2	2	0	0	192
11773	4	2	1	190	0	197
11774	2	1	186	3	0	192
11775	1	184	5	1	0	191
11776	0	193	3	0	0	196
11777	2	6	1	188	0	197
11778	1	2	0	192	0	195
11779	1	191	0	2	0	194
11780	192	3	0	0	0	195
11781	186	0	1	1	0	188
11782	178	0	1	0	0	179
11783	4	187	0	0	0	191
11784	1	3	0	180	0	184
11785	1	188	0	3	0	192
11786	186	3	1	0	0	190
11787	185	0	0	0	0	185
11788	4	188	0	0	0	192
11789	187	3	0	2	0	192
11790	4	0	0	189	0	193
11791	0	1	1	189	0	191
11792	192	0	0	3	0	195
11793	180	0	0	2	0	182
11794	189	0	1	1	0	191
11795	4	1	1	181	0	187
11796	2	1	0	187	0	190
11797	0	0	188	5	0	193
11798	2	0	4	183	0	189
11799	2	2	0	186	0	190
11800	1	1	182	4	0	188
11801	3	0	170	1	0	174
11802	1	1	178	0	0	180
11803	2	2	3	172	0	179
11804	1	1	182	4	0	188
11805	4	1	3	180	0	188
11806	3	0	1	184	0	188
11807	1	2	187	2	0	192
11808	0	1	190	1	0	192
11809	3	1	3	181	0	188
11810	0	0	195	4	0	199
11811	1	0	193	2	0	196
11812	2	195	3	0	0	200
11813	198	4	0	1	0	203
11814	195	0	0	2	0	197
11815	196	1	0	3	0	200
11816	4	194	1	1	0	200
11817	1	198	1	0	0	200
11818	3	2	0	192	0	197
11819	1	1	0	190	0	192
11820	0	0	190	4	0	194
11821	2	1	5	182	0	190
11822	190	0	1	4	0	195
11823	6	1	0	180	0	187
11824	0	188	4	3	0	195
11825	191	3	1	3	0	198
11826	195	0	1	2	0	198
11827	193	0	1	2	0	196
11828	4	2	192	0	0	198
11829	0	2	4	187	0	193
11830	207	1	0	5	0	213
11831	3	0	210	0	0	213
11832	0	211	5	0	0	216
11833	2	205	0	1	0	208
11834	189	3	1	0	0	193
11835	4	190	1	0	0	195
11836	1	5	0	181	0	187
11837	1	0	189	4	0	194
11838	2	1	3	185	0	191
11839	189	0	1	5	0	195
11840	3	189	0	0	0	192
11841	185	6	0	0	0	191
11842	5	0	186	1	0	192
11843	0	1	3	175	0	179
11844	0	196	1	5	0	202
11845	2	3	1	201	0	207
11846	206	0	0	4	0	210
11847	201	0	0	1	0	202
11848	204	2	0	1	0	207
11849	204	1	0	1	0	206
11850	5	0	2	194	0	201
11851	2	0	212	4	0	218
11852	2	1	4	196	0	203
11853	0	208	1	5	0	214
11854	208	3	2	4	0	217
11855	5	0	209	0	0	214
11856	210	0	3	1	0	214
11857	4	2	2	209	0	217
11858	1	1	225	5	0	232
11859	2	2	4	218	0	226
11860	224	1	1	6	0	232
11861	223	1	2	0	0	226
11862	223	0	1	4	0	228
11863	4	0	228	1	0	233
11864	2	1	4	230	0	237
11865	1	2	235	3	0	241
11866	2	235	5	0	0	242
11867	224	2	1	3	0	230
11868	3	225	0	1	0	229
11869	216	3	0	2	0	221
11870	2	0	0	215	0	217
11871	1	222	2	1	0	226
11872	230	2	0	2	0	234
11873	3	0	227	0	0	230
11874	1	1	2	229	0	233
11875	225	0	1	4	0	230
11876	2	3	232	0	0	237
11877	1	0	3	224	0	228
11878	1	220	1	3	0	225
11879	1	2	1	234	0	238
11880	1	0	2	235	0	238
11881	227	1	1	6	0	235
11882	4	225	1	2	0	232
11883	1	5	1	221	0	228
11884	1	228	2	2	0	233
11885	1	1	3	224	0	229
11886	1	232	0	3	0	236
11887	231	4	0	2	0	237
11888	3	0	234	3	0	240
11889	4	1	2	233	0	240
11890	1	2	1	239	0	243
11891	0	3	1	238	0	242
11892	5	2	0	229	0	236
11893	1	1	237	4	0	243
11894	3	245	3	0	0	251
11895	241	1	0	5	0	247
11896	241	2	2	1	0	246
11897	4	243	0	2	0	249
11898	243	3	2	3	0	251
11899	246	0	2	2	0	250
11900	4	251	1	3	0	259
11901	1	4	3	242	0	250
11902	2	249	0	4	0	255
11903	257	3	1	1	0	262
11904	4	0	245	2	0	251
11905	227	2	2	3	0	234
11906	5	0	253	1	0	259
11907	2	2	2	245	0	251
11908	249	1	1	4	0	255
11909	3	2	244	1	0	250
11910	228	1	2	1	0	232
11911	233	2	1	1	0	237
11912	4	0	2	238	0	244
11913	1	241	2	4	0	248
11914	247	4	1	2	0	254
11915	5	0	0	245	0	250
11916	2	237	1	3	0	243
11917	238	2	2	5	0	247
11918	5	0	1	248	0	254
11919	1	257	2	2	0	262
11920	2	2	0	269	0	273
11921	264	2	1	3	0	270
11922	249	2	0	4	0	255
11923	259	0	0	1	0	260
11924	6	1	1	246	0	254
11925	3	2	0	240	0	245
11926	1	2	243	4	0	250
11927	2	3	3	242	0	250
11928	0	0	250	7	0	257
11929	2	0	230	1	0	233
11930	1	1	220	0	0	222
11931	0	225	4	0	0	229
11932	3	3	2	212	0	220
11933	0	246	0	2	0	248
11934	245	2	0	3	0	250
11935	243	2	0	2	0	247
11936	4	1	0	247	0	252
11937	2	0	261	4	0	267
11938	1	0	4	258	0	263
11939	0	1	271	5	0	277
11940	1	0	3	254	0	258
11941	0	263	2	5	0	270
11942	0	281	1	0	0	282
11943	268	7	0	2	0	277
11944	4	3	278	0	0	285
11945	5	0	5	272	0	282
11946	0	0	2	294	0	296
11947	292	0	0	8	0	300
11948	4	295	0	2	0	301
11949	292	6	0	5	0	303
11950	6	307	0	0	0	313
11951	295	5	0	4	0	304
11952	304	2	0	4	0	310
11953	9	0	0	315	0	324
11954	2	0	310	6	0	318
11955	292	0	6	6	0	304
11956	6	306	2	0	0	314
11957	311	6	0	0	0	317
11958	7	2	0	306	0	315
11959	2	0	0	310	0	312
11960	0	305	0	8	0	313
11961	2	6	0	297	0	305
11962	0	306	0	5	0	311
11963	1	6	0	300	0	307
11964	0	1	1	301	0	303
11965	292	0	0	9	0	301
11966	5	0	298	2	0	305
11967	2	291	7	2	0	302
11968	0	6	2	295	0	303
11969	295	2	0	7	0	304
11970	306	0	0	3	0	309
11971	302	0	0	5	0	307
11972	8	0	302	0	0	310
11973	293	0	5	4	0	302
11974	6	0	3	304	0	313
11975	299	0	1	8	0	308
11976	7	301	1	3	0	312
11977	4	6	0	298	0	308
11978	294	3	0	6	0	303
11979	5	305	0	4	0	314
11980	4	5	0	298	0	307
11981	1	2	298	6	0	307
11982	293	2	2	3	0	300
11983	315	0	2	5	0	322
11984	9	1	306	0	0	316
11985	4	308	9	0	0	321
11986	2	313	2	2	0	319
11987	3	10	1	308	0	322
11988	4	6	1	288	0	299
11989	3	2	0	311	0	316
11990	1	2	322	11	0	336
11991	314	1	8	6	0	329
11992	335	0	2	3	0	340
11993	333	1	2	2	0	338
11994	341	0	1	1	0	343
11995	337	1	1	2	0	341
11996	340	0	2	6	0	348
11997	14	2	2	341	0	359
11998	4	3	344	10	0	361
11999	2	2	347	4	0	355
12000	2	3	11	342	0	358
12001	7	0	3	336	0	346
12002	5	1	5	333	0	344
12003	3	340	3	14	0	360
12004	337	13	1	7	0	358
12005	13	354	0	3	0	370
12006	7	12	2	344	0	365
12007	338	5	0	18	0	361
12008	14	342	1	6	0	363
12009	6	12	2	346	0	366
12010	6	6	2	350	0	364
12011	5	2	2	353	0	362
12012	4	341	2	20	0	367
12013	4	10	1	354	0	369
12014	4	5	342	16	0	367
12015	6	5	13	343	0	367
12016	8	2	6	355	0	371
12017	7	3	2	371	0	383
12018	2	2	2	371	0	377
12019	4	3	354	24	0	385
12020	3	353	14	11	0	381
12021	5	12	5	352	0	374
12022	3	7	2	371	0	383
12023	4	4	3	355	0	366
12024	3	343	1	18	0	365
12025	3	365	0	11	0	379
12026	354	14	2	10	0	380
12027	13	8	2	342	0	365
12028	7	4	334	16	0	361
12029	4	341	11	9	0	365
12030	340	10	5	7	0	362
12031	12	4	336	4	0	356
12032	7	5	328	4	0	344
12033	7	2	324	2	0	335
12034	2	4	14	305	0	325
12035	1	1	312	14	0	328
12036	1	303	14	6	0	324
12037	1	9	8	294	0	312
12038	2	4	295	10	0	311
12039	4	3	10	298	0	315
12040	287	2	5	14	0	308
12041	7	6	283	9	0	305
12042	277	2	8	6	0	293
12043	10	297	5	3	0	315
12044	294	9	4	3	0	310
12045	12	5	5	293	0	315
12046	302	3	0	11	0	316
12047	302	3	4	5	0	314
12048	296	2	4	4	0	306
12049	12	296	2	6	0	316
12050	300	6	4	3	0	313
12051	300	6	3	5	0	314
12052	14	4	289	2	0	309
12053	6	294	10	3	0	313
12054	6	7	6	293	0	312
12055	3	7	4	301	0	315
12056	8	3	2	302	0	315
12057	2	2	299	15	0	318
12058	6	0	8	295	0	309
12059	8	2	302	10	0	322
12060	307	1	11	9	0	328
12061	314	3	9	5	0	331
12062	13	0	311	6	0	330
12063	317	2	9	2	0	330
12064	322	1	9	3	0	335
12065	327	4	3	2	0	336
12066	14	2	3	309	0	328
12067	14	0	315	10	0	339
12068	6	323	9	8	0	346
12069	7	9	7	319	0	342
12070	2	8	333	10	0	353
12071	4	2	318	8	0	332
12072	303	2	12	7	0	324
12073	9	331	7	4	0	351
12074	332	6	6	7	0	351
12075	339	4	3	4	0	350
12076	14	344	2	2	0	362
12077	349	9	1	0	0	359
12078	10	5	352	4	0	371
12079	9	1	351	0	0	361
12080	5	2	353	2	0	362
12081	6	328	13	3	0	350
12082	325	7	11	3	0	346
12083	324	4	3	5	0	336
12084	9	327	3	1	0	340
12085	5	344	1	3	0	353
12086	4	9	3	339	0	355
12087	5	5	3	343	0	356
12088	345	3	2	11	0	361
12089	8	350	1	7	0	366
12090	342	7	2	3	0	354
12091	336	4	2	3	0	345
12092	14	2	328	0	0	344
12093	8	333	4	1	0	346
12094	5	7	8	326	0	346
12095	323	4	3	9	0	339
12096	9	2	3	322	0	336
12097	310	2	1	6	0	319
12098	3	0	306	5	0	314
12099	5	286	3	5	0	299
12100	1	304	6	1	0	312
12101	7	6	3	291	0	307
12102	2	309	2	2	0	315
12103	301	4	2	3	0	310
12104	3	5	293	0	0	301
12105	284	2	1	3	0	290
12106	3	3	306	1	0	313
12107	4	0	3	303	0	310
12108	3	1	3	294	0	301
12109	3	3	1	304	0	311
12110	297	0	1	7	0	305
12111	2	2	307	3	0	314
12112	3	1	4	311	0	319
12113	3	1	2	306	0	312
12114	1	304	1	4	0	310
12115	4	306	1	2	0	313
12116	1	308	0	2	0	311
12117	2	4	0	288	0	294
12118	3	1	1	280	0	285
12119	0	274	1	0	0	275
12120	0	270	0	0	0	270
12121	269	0	0	3	0	272
12122	2	0	0	263	0	265
12123	0	259	0	1	0	260
12124	264	0	0	0	0	264
12125	0	0	1	259	0	260
12126	286	1	0	2	0	289
12127	2	1	0	291	0	294
12128	0	0	306	2	0	308
12129	0	312	1	0	0	313
12130	305	1	0	3	0	309
12131	1	2	316	1	0	320
12132	1	316	1	0	0	318
12133	2	3	1	325	0	331
12134	0	1	0	335	0	336
12135	1	0	0	319	0	320
12136	1	0	1	313	0	315
12137	1	1	319	1	0	322
12138	0	318	3	1	0	322
12139	1	1	0	323	0	325
12140	314	1	0	3	0	318
12141	1	320	1	0	0	322
12142	4	1	0	338	0	343
12143	0	0	337	4	0	341
12144	2	336	3	0	0	341
12145	0	3	0	317	0	320
12146	0	346	3	1	0	350
12147	347	6	0	2	0	355
12148	345	0	0	3	0	348
12149	3	1	342	0	0	346
12150	332	3	3	2	0	340
12151	344	0	0	2	0	346
12152	4	0	332	2	0	338
12153	1	336	3	2	0	342
12154	2	2	0	338	0	342
12155	2	0	3	342	0	347
12156	332	3	0	3	0	338
12157	5	1	0	336	0	342
12158	2	1	335	5	0	343
12159	314	2	2	3	0	321
12160	4	0	328	2	0	334
12161	0	329	5	1	0	335
12162	317	5	1	2	0	325
12163	4	1	316	0	0	321
12164	1	3	305	0	0	309
12165	4	313	3	1	0	321
12166	6	3	1	313	0	323
12167	0	0	314	3	0	317
12168	4	1	4	277	0	286
12169	3	1	0	306	0	310
12170	0	1	301	4	0	306
12171	0	293	4	1	0	298
12172	2	3	0	299	0	304
12173	292	0	1	6	0	299
12174	287	1	0	0	0	288
12175	3	2	0	292	0	297
12176	1	0	288	4	0	293
12177	4	1	294	0	0	299
12178	2	1	5	282	0	290
12179	0	3	280	4	0	287
12180	269	0	6	0	0	275
12181	5	0	4	281	0	290
12182	1	0	3	282	0	286
12183	2	284	1	4	0	291
12184	3	3	0	287	0	293
12185	1	1	275	6	0	283
12186	262	2	5	3	0	272
12187	272	1	0	5	0	278
12188	5	0	275	1	0	281
12189	3	2	6	285	0	296
12190	4	1	0	293	0	298
12191	2	0	294	5	0	301
12192	3	0	4	285	0	292
12193	2	1	0	297	0	300
12194	0	295	4	7	0	306
12195	2	5	4	302	0	313
12196	3	0	0	313	0	316
12197	308	2	2	15	0	327
12198	316	2	0	7	0	325
12199	322	0	0	4	0	326
12200	323	0	1	3	0	327
12201	323	1	1	0	0	325
12202	17	1	293	1	0	312
12203	8	0	14	295	0	317
12204	6	0	3	311	0	320
12205	2	0	302	14	0	318
12206	284	2	14	7	0	307
12207	307	0	3	6	0	316
12208	14	2	281	2	0	299
12209	293	0	14	3	0	310
12210	310	2	3	0	0	315
12211	16	0	289	3	0	308
12212	6	1	13	264	0	284
12213	5	294	4	13	0	316
12214	6	14	4	299	0	323
12215	4	3	2	319	0	328
12216	8	2	2	311	0	323
12217	3	1	299	22	0	325
12218	299	0	15	6	0	320
12219	308	0	3	9	0	320
12220	16	1	4	301	0	322
12221	6	1	302	16	0	325
12222	6	0	17	294	0	317
12223	2	0	308	20	0	330
12224	3	0	323	4	0	330
12225	4	315	18	2	0	339
12226	5	12	6	286	0	309
12227	285	3	5	17	0	310
12228	294	4	2	8	0	308
12229	303	2	2	7	0	314
12230	23	0	1	287	0	311
12231	7	308	1	14	0	330
12232	8	13	2	313	0	336
12233	1	5	322	19	0	347
12234	346	3	15	6	0	370
12235	367	1	2	7	0	377
12236	21	0	4	353	0	378
12237	10	0	1	361	0	372
12238	11	0	1	364	0	376
12239	1	3	346	21	0	371
12240	322	0	14	12	0	348
12241	14	348	4	8	0	374
12242	4	328	7	3	0	342
12243	9	13	328	1	0	351
12244	9	4	14	324	0	351
12245	5	6	333	14	0	358
12246	317	1	17	4	0	339
12247	16	3	4	321	0	344
12248	3	3	320	17	0	343
12249	6	332	14	7	0	359
12250	329	15	6	6	0	356
12251	19	2	333	2	0	356
12252	3	325	14	5	0	347
12253	4	345	6	5	0	360
12254	344	16	6	2	0	368
12255	20	5	1	341	0	367
12256	4	8	353	17	0	382
12257	6	350	13	5	0	374
12258	358	15	3	7	0	383
12259	366	2	8	3	0	379
12260	16	363	2	2	0	383
12261	13	14	369	0	0	396
12262	9	3	17	368	0	397
12263	371	8	3	17	0	399
12264	386	3	8	4	0	401
12265	19	3	378	8	0	408
12266	10	0	17	373	0	400
12267	9	2	5	387	0	403
12268	2	4	390	18	0	414
12269	5	1	389	7	0	402
12270	381	1	19	11	0	412
12271	393	2	10	4	0	409
12272	402	0	9	3	0	414
12273	411	2	3	5	0	421
12274	24	2	383	3	0	412
12275	393	0	16	5	0	414
12276	19	1	8	386	0	414
12277	4	1	412	19	0	436
12278	7	3	415	5	0	430
12279	5	417	19	4	0	445
12280	10	12	10	410	0	442
12281	4	3	417	17	0	441
12282	403	5	20	4	0	432
12283	18	0	5	385	0	408
12284	7	416	8	14	0	445
12285	424	13	6	3	0	446
12286	430	4	5	7	0	446
12287	18	5	422	7	0	452
12288	11	418	16	3	0	448
12289	10	14	6	391	0	421
12290	394	4	6	15	0	419
12291	19	5	0	395	0	419
12292	4	3	379	17	0	403
12293	335	1	15	8	0	359
12294	14	355	4	10	0	383
12295	4	339	5	1	0	349
12296	9	364	2	3	0	378
12297	364	11	8	1	0	384
12298	354	2	2	4	0	362
12299	356	8	2	4	0	370
12300	15	3	1	354	0	373
12301	8	2	363	8	0	381
12302	5	0	8	366	0	379
12303	368	1	4	12	0	385
12304	14	1	4	362	0	381
12305	370	3	3	13	0	389
12306	381	3	2	5	0	391
12307	376	1	2	8	0	387
12308	15	376	1	3	0	395
12309	382	9	3	3	0	397
12310	15	0	367	1	0	383
12311	3	6	383	4	0	396
12312	9	378	11	1	0	399
12313	5	5	4	362	0	376
12314	364	0	6	6	0	376
12315	5	3	364	4	0	376
12316	355	2	5	9	0	371
12317	8	3	3	353	0	367
12318	3	356	6	3	0	368
12319	10	8	0	369	0	387
12320	6	2	368	7	0	383
12321	345	5	7	2	0	359
12322	9	1	373	4	0	387
12323	2	3	365	1	0	371
12324	353	2	4	4	0	363
12325	4	358	6	3	0	371
12326	365	3	8	2	0	378
12327	363	0	2	8	0	373
12328	8	5	351	2	0	366
12329	337	3	4	5	0	349
12330	10	1	333	3	0	347
12331	2	1	326	2	0	331
12332	7	1	319	0	0	327
12333	1	311	7	0	0	319
12334	282	1	6	3	0	292
12335	280	0	2	1	0	283
12336	274	1	2	2	0	279
12337	274	1	0	0	0	275
12338	1	1	276	2	0	280
12339	4	2	2	267	0	275
12340	4	0	2	266	0	272
12341	275	1	2	2	0	280
12342	3	270	0	2	0	275
12343	3	2	1	270	0	276
12344	263	0	1	6	0	270
12345	3	1	267	0	0	271
12346	2	1	2	268	0	273
12347	2	0	279	3	0	284
12348	1	266	3	2	0	272
12349	4	1	2	262	0	269
12350	264	2	1	1	0	268
12351	2	1	1	271	0	275
12352	3	1	270	3	0	277
12353	1	277	3	1	0	282
12354	263	3	1	8	0	275
12355	3	1	268	0	0	272
12356	264	1	2	1	0	268
12357	3	276	1	0	0	280
12358	276	2	0	4	0	282
12359	274	1	0	4	0	279
12360	4	0	1	281	0	286
12361	1	1	274	3	0	279
12362	2	269	2	1	0	274
12363	2	3	1	278	0	284
12364	3	1	0	284	0	288
12365	4	1	0	284	0	289
12366	4	0	2	290	0	296
12367	1	324	1	6	0	332
12368	336	6	1	7	0	350
12369	8	337	2	0	0	347
12370	4	10	1	350	0	365
12371	358	2	0	9	0	369
12372	15	2	1	346	0	364
12373	3	1	348	9	0	361
12374	3	348	10	3	0	364
12375	5	10	2	346	0	363
12376	3	3	2	361	0	369
12377	338	3	1	12	0	354
12378	10	2	333	6	0	351
12379	319	3	10	4	0	336
12380	335	1	2	7	0	345
12381	336	0	2	6	0	344
12382	12	2	328	3	0	345
12383	8	2	10	312	0	332
12384	5	3	3	331	0	342
12385	5	0	324	12	0	341
12386	2	1	329	5	0	337
12387	318	1	11	9	0	339
12388	14	1	6	326	0	347
12389	339	2	2	12	0	355
12390	342	1	4	5	0	352
12391	16	2	1	336	0	355
12392	5	1	348	14	0	368
12393	335	1	11	10	0	357
12394	17	2	3	347	0	369
12395	6	3	347	11	0	367
12396	2	349	11	5	0	367
12397	351	9	4	4	0	368
12398	13	358	3	5	0	379
12399	7	10	4	319	0	340
12400	4	356	3	10	0	373
12401	338	12	4	5	0	359
12402	351	5	4	4	0	364
12403	12	350	3	4	0	369
12404	346	11	1	8	0	366
12405	350	3	2	7	0	362
12406	15	338	3	3	0	359
12407	348	11	3	3	0	365
12408	17	6	1	337	0	361
12409	10	3	1	349	0	363
12410	346	2	2	14	0	364
12411	18	2	2	318	0	340
12412	8	329	4	13	0	354
12413	326	12	2	6	0	346
12414	328	3	3	7	0	341
12415	16	324	2	3	0	345
12416	322	12	1	11	0	346
12417	335	5	0	7	0	347
12418	22	5	2	320	0	349
12419	10	3	312	11	0	336
12420	8	313	9	5	0	335
12421	314	9	3	7	0	333
12422	321	4	3	5	0	333
12423	16	4	308	3	0	331
12424	303	4	10	8	0	325
12425	14	2	286	6	0	308
12426	300	3	12	4	0	319
12427	25	2	5	291	0	323
12428	8	2	297	14	0	321
12429	6	4	313	3	0	326
12430	11	3	10	300	0	324
12431	8	1	5	309	0	323
12432	4	6	300	13	0	323
12433	9	0	12	299	0	320
12434	5	3	304	13	0	325
12435	6	3	12	302	0	323
12436	13	2	7	293	0	315
12437	5	290	1	17	0	313
12438	5	293	4	9	0	311
12439	9	296	5	5	0	315
12440	5	13	3	296	0	317
12441	8	6	1	301	0	316
12442	7	3	295	12	0	317
12443	287	6	10	6	0	309
12444	298	4	5	5	0	312
12445	14	288	6	6	0	314
12446	286	10	2	7	0	305
12447	17	2	3	278	0	300
12448	283	3	3	9	0	298
12449	283	5	5	3	0	296
12450	18	2	0	275	0	295
12451	262	1	4	11	0	278
12452	11	252	3	4	0	270
12453	7	259	2	5	0	273
12454	11	8	4	243	0	266
12455	5	262	2	8	0	277
12456	8	8	0	240	0	256
12457	4	5	3	252	0	264
12458	245	4	1	14	0	264
12459	11	241	2	4	0	258
12460	230	9	3	7	0	249
12461	238	2	1	7	0	248
12462	13	233	3	0	0	249
12463	231	9	1	1	0	242
12464	11	5	223	3	0	242
12465	6	216	4	2	0	228
12466	203	4	2	3	0	212
12467	6	3	164	2	0	175
12468	1	139	4	3	0	147
12469	3	149	1	2	0	155
12470	135	2	3	0	0	140
12471	127	0	0	0	0	127
12472	118	1	1	1	0	121
12473	1	120	0	1	0	122
12474	3	1	0	123	0	127
12475	124	0	0	2	0	126
12476	121	1	1	0	0	123
12477	3	1	0	120	0	124
12478	1	1	125	0	0	127
12479	1	1	123	1	0	126
12480	3	0	1	126	0	130
12481	4	0	0	128	0	132
12482	0	0	134	2	0	136
12483	2	0	1	128	0	131
12484	0	136	0	1	0	137
12485	134	0	1	0	0	135
12486	1	0	1	130	0	132
12487	119	0	1	2	0	122
12488	1	132	0	1	0	134
12489	0	131	2	0	0	133
12490	132	0	0	2	0	134
12491	1	0	129	1	0	131
12492	100	0	2	1	0	103
12493	0	110	1	0	0	111
12494	0	0	0	108	0	108
12495	106	0	0	2	0	108
12496	1	0	1	107	0	109
12497	113	0	0	1	0	114
12498	112	0	1	0	0	113
12499	0	124	0	1	0	125
12500	125	0	0	1	0	126
12501	0	120	0	0	0	120
12502	123	0	0	1	0	124
12503	1	0	0	121	0	122
12504	124	0	0	1	0	125
12505	0	0	0	127	0	127
12506	130	0	0	4	0	134
12507	137	0	0	0	0	137
12508	137	0	0	0	0	137
12509	135	0	0	0	0	135
12510	133	0	0	0	0	133
12511	0	0	0	137	0	137
12512	133	0	0	1	0	134
12513	0	132	1	0	0	133
12514	0	0	136	0	0	136
12515	1	0	0	136	0	137
12516	1	0	137	0	0	138
12517	0	0	0	138	0	138
12518	0	0	140	0	0	140
12519	138	0	0	0	0	138
12520	0	0	0	142	0	142
12521	0	1	137	0	0	138
12522	0	0	143	0	0	143
12523	0	0	0	144	0	144
12524	166	0	0	1	0	167
12525	0	181	0	0	0	181
12526	174	0	0	6	0	180
12527	181	1	0	1	0	183
12528	1	178	0	0	0	179
12529	192	0	0	2	0	194
12530	1	2	0	191	0	194
12531	4	0	0	191	0	195
12532	1	1	0	190	0	192
12533	191	1	0	3	0	195
12534	1	190	0	1	0	192
12535	2	0	0	195	0	197
12536	0	1	0	198	0	199
12537	192	1	0	3	0	196
12538	1	0	0	193	0	194
12539	1	1	200	0	0	202
12540	0	206	0	2	0	208
12541	209	0	1	1	0	211
12542	3	1	0	199	0	203
12543	1	210	0	1	0	212
12544	216	0	1	2	0	219
12545	0	2	214	0	0	216
12546	2	213	0	0	0	215
12547	213	0	1	1	0	215
12548	0	3	0	211	0	214
12549	3	0	0	212	0	215
12550	1	0	213	1	0	215
12551	2	2	0	204	0	208
12552	2	1	223	0	0	226
12553	1	1	213	2	0	217
12554	2	0	228	1	0	231
12555	232	0	3	2	0	237
12556	232	2	1	1	0	236
12557	235	1	0	0	0	236
12558	3	0	1	234	0	238
12559	1	233	1	3	0	238
12560	3	227	0	1	0	231
12561	232	1	0	4	0	237
12562	239	2	2	3	0	246
12563	1	240	0	3	0	244
12564	240	1	0	3	0	244
12565	1	4	229	0	0	234
12566	3	1	217	2	0	223
12567	3	1	2	210	0	216
12568	1	3	3	234	0	241
12569	3	3	234	1	0	241
12570	1	0	2	228	0	231
12571	237	2	2	3	0	244
12572	2	0	234	5	0	241
12573	226	0	2	1	0	229
12574	0	3	2	239	0	244
12575	4	1	234	2	0	241
12576	3	250	3	4	0	260
12577	251	1	5	2	0	259
12578	5	2	245	1	0	253
12579	242	0	2	5	0	249
12580	3	1	4	254	0	262
12581	250	1	3	4	0	258
12582	1	3	270	4	0	278
12583	6	2	2	270	0	280
12584	277	2	2	2	0	283
12585	278	1	2	3	0	284
12586	285	3	0	2	0	290
12587	289	1	1	1	0	292
12588	5	1	2	274	0	282
12589	4	0	3	277	0	284
12590	3	2	279	5	0	289
12591	2	4	1	270	0	277
12592	4	0	3	271	0	278
12593	1	279	4	5	0	289
12594	288	2	2	3	0	295
12595	287	1	4	3	0	295
12596	7	292	4	1	0	304
12597	5	2	2	289	0	298
12598	2	2	3	291	0	298
12599	285	3	0	7	0	295
12600	5	1	313	1	0	320
12601	3	1	3	318	0	325
12602	5	1	319	3	0	328
12603	297	2	4	5	0	308
12604	318	1	2	0	0	321
12605	320	1	3	2	0	326
12606	5	0	3	310	0	318
12607	6	1	2	305	0	314
12608	309	0	0	10	0	319
12609	5	1	307	1	0	314
12610	5	2	3	309	0	319
12611	312	0	3	7	0	322
12612	6	0	2	312	0	320
12613	4	1	334	1	0	340
12614	4	0	319	5	0	328
12615	319	0	4	3	0	326
12616	4	329	2	1	0	336
12617	344	1	0	6	0	351
12618	358	1	3	2	0	364
12619	4	1	1	360	0	366
12620	2	0	0	359	0	361
12621	2	356	1	4	0	363
12622	357	1	2	3	0	363
12623	1	371	2	2	0	376
12624	1	364	0	4	0	369
12625	1	1	1	358	0	361
12626	358	0	0	3	0	361
12627	359	0	0	4	0	363
12628	3	0	0	359	0	362
12629	1	1	0	347	0	349
12630	3	0	0	349	0	352
12631	352	0	0	2	0	354
12632	3	1	352	0	0	356
12633	0	350	1	2	0	353
12634	350	1	0	3	0	354
12635	3	0	0	345	0	348
12636	1	0	345	2	0	348
12637	0	1	342	1	0	344
12638	0	341	1	2	0	344
12639	1	343	2	1	0	347
12640	3	3	0	336	0	342
12641	3	301	1	1	0	306
12642	4	1	0	321	0	326
12643	0	1	1	330	0	332
12644	327	0	0	5	0	332
12645	3	0	1	329	0	333
12646	1	0	1	326	0	328
12647	2	0	323	2	0	327
12648	4	0	1	323	0	328
12649	327	1	2	2	0	332
12650	325	0	2	1	0	328
12651	3	329	1	1	0	334
12652	320	2	0	1	0	323
12653	2	1	316	0	0	319
12654	2	313	4	2	0	321
12655	5	3	1	324	0	333
12656	0	0	1	336	0	337
12657	2	1	0	336	0	339
12658	335	1	0	4	0	340
12659	315	1	0	5	0	321
12660	2	3	314	2	0	321
12661	1	2	315	1	0	319
12662	3	1	320	1	0	325
12663	1	328	4	1	0	334
12664	3	336	1	1	0	341
12665	333	5	0	3	0	341
12666	333	0	1	3	0	337
12667	5	0	0	333	0	338
12668	3	1	1	330	0	335
12669	1	337	2	4	0	344
12670	2	5	0	339	0	346
12671	2	2	344	7	0	355
12672	0	342	6	3	0	351
12673	2	7	2	340	0	351
12674	1	2	359	7	0	369
12675	1	2	7	339	0	349
12676	1	346	1	9	0	357
12677	356	8	0	4	0	368
12678	357	1	0	5	0	363
12679	355	0	1	4	0	360
12680	11	1	0	344	0	356
12681	2	0	0	366	0	368
12682	350	0	0	15	0	365
12683	8	350	2	3	0	363
12684	352	6	1	6	0	365
12685	9	1	364	1	0	375
12686	361	1	9	1	0	372
12687	378	1	1	1	0	381
12688	14	1	0	365	0	380
12689	370	0	1	10	0	381
12690	373	1	1	2	0	377
12691	9	2	0	371	0	382
12692	3	0	370	10	0	383
12693	339	0	8	8	0	355
12694	9	1	373	1	0	384
12695	1	373	9	0	0	383
12696	0	8	3	367	0	378
12697	0	1	0	381	0	382
12698	397	0	0	14	0	411
12699	8	0	395	2	0	405
12700	1	0	7	377	0	385
12701	0	388	2	8	0	398
12702	1	386	2	1	0	390
12703	1	9	0	390	0	400
12704	0	3	396	9	0	408
12705	5	0	9	380	0	394
12706	3	1	2	386	0	392
12707	1	1	380	10	0	392
12708	0	389	8	2	0	399
12709	377	10	1	4	0	392
12710	9	386	0	0	0	395
12711	6	9	0	388	0	403
12712	373	3	1	12	0	389
12713	10	372	0	2	0	384
12714	2	9	366	1	0	378
12715	357	2	10	3	0	372
12716	8	371	2	0	0	381
12717	368	8	1	1	0	378
12718	9	4	350	0	0	363
12719	348	0	10	5	0	363
12720	10	0	3	350	0	363
12721	3	1	348	18	0	370
12722	2	0	8	336	0	346
12723	3	333	3	9	0	348
12724	2	10	1	349	0	362
12725	3	3	0	358	0	364
12726	1	3	343	13	0	360
12727	3	1	10	343	0	357
12728	2	5	302	10	0	319
12729	3	341	7	3	0	354
12730	5	9	4	336	0	354
12731	3	5	342	10	0	360
12732	4	339	9	3	0	355
12733	3	357	4	2	0	366
12734	2	13	349	4	0	368
12735	4	2	354	3	0	363
12736	4	1	10	342	0	357
12737	341	1	6	11	0	359
12738	12	339	2	4	0	357
12739	9	11	2	339	0	361
12740	344	7	0	12	0	363
12741	13	346	1	6	0	366
12742	349	9	3	4	0	365
12743	13	357	1	3	0	374
12744	359	9	3	5	0	376
12745	343	2	1	12	0	358
12746	359	3	2	2	0	366
12747	15	372	1	1	0	389
12748	9	12	2	367	0	390
12749	2	7	367	12	0	388
12750	6	358	14	9	0	387
12751	7	13	6	346	0	372
12752	3	9	2	365	0	379
12753	6	3	344	19	0	372
12754	7	337	12	9	0	365
12755	325	17	5	7	0	354
12756	13	332	5	6	0	356
12757	10	11	4	324	0	349
12758	3	7	326	13	0	349
12759	300	7	13	9	0	329
12760	17	1	7	328	0	353
12761	6	5	327	13	0	351
12762	302	5	9	10	0	326
12763	12	317	4	6	0	339
12764	312	11	4	11	0	338
12765	325	5	3	4	0	337
12766	14	5	3	321	0	343
12767	6	4	312	13	0	335
12768	3	317	10	8	0	338
12769	4	12	320	4	0	340
12770	6	5	12	298	0	321
12771	2	6	8	318	0	334
12772	303	4	3	15	0	325
12773	8	5	302	8	0	323
12774	6	286	10	2	0	304
12775	4	7	3	289	0	303
12776	8	7	1	287	0	303
12777	278	5	3	12	0	298
12778	9	283	2	8	0	302
12779	7	9	0	268	0	284
12780	264	7	2	7	0	280
12781	6	261	2	8	0	277
12782	258	5	2	4	0	269
12783	252	5	4	2	0	263
12784	8	249	3	2	0	262
12785	217	3	1	3	0	224
12786	4	212	2	2	0	220
12787	208	3	0	5	0	216
12788	213	2	2	5	0	222
12789	7	210	3	0	0	220
12790	196	4	0	5	0	205
12791	200	3	2	1	0	206
12792	201	0	0	4	0	205
12793	6	1	187	1	0	195
12794	3	2	183	2	0	190
12795	1	0	190	3	0	194
12796	183	0	8	1	0	192
12797	5	2	184	1	0	192
12798	1	1	159	0	0	161
12799	1	3	7	145	0	156
12800	142	0	3	5	0	150
12801	6	0	145	2	0	153
12802	2	0	153	1	0	156
12803	1	2	7	148	0	158
12804	2	1	2	155	0	160
12805	1	0	0	161	0	162
12806	2	0	154	6	0	162
12807	0	1	5	151	0	157
12808	151	0	2	6	0	159
12809	5	149	1	3	0	158
12810	5	4	0	147	0	156
12811	4	2	1	150	0	157
12812	2	0	153	7	0	162
12813	1	154	4	2	0	161
12814	153	5	2	1	0	161
12815	5	152	1	1	0	159
12816	3	6	0	154	0	163
12817	1	2	151	6	0	160
12818	3	2	5	159	0	169
12819	3	0	3	165	0	171
12820	171	2	0	8	0	181
12821	8	0	0	164	0	172
12822	2	161	3	6	0	172
12823	0	174	1	3	0	178
12824	0	8	176	1	0	185
12825	172	1	7	2	0	182
12826	8	0	3	176	0	187
12827	4	1	2	180	0	187
12828	2	3	0	187	0	192
12829	181	0	1	11	0	193
12830	10	184	2	2	0	198
12831	180	7	1	4	0	192
12832	9	3	163	3	0	178
12833	5	3	165	3	0	176
12834	172	1	10	2	0	185
12835	10	1	5	176	0	192
12836	3	3	0	188	0	194
12837	4	0	0	185	0	189
12838	0	1	180	10	0	191
12839	176	1	8	4	0	189
12840	187	1	4	3	0	195
12841	188	0	3	1	0	192
12842	12	1	2	177	0	192
12843	4	0	171	8	0	183
12844	2	1	172	2	0	177
12845	2	0	182	2	0	186
12846	3	174	10	3	0	190
12847	4	4	4	153	0	165
12848	151	1	3	7	0	162
12849	5	0	154	2	0	161
12850	151	0	5	4	0	160
12851	7	0	2	152	0	161
12852	1	2	1	157	0	161
12853	1	151	3	8	0	163
12854	2	157	1	6	0	166
12855	0	166	3	2	0	171
12856	2	10	1	159	0	172
12857	154	1	1	10	0	166
12858	165	2	0	5	0	172
12859	6	3	160	2	0	171
12860	161	2	5	3	0	171
12861	6	1	158	4	0	169
12862	2	1	6	156	0	165
12863	3	3	162	5	0	173
12864	155	1	6	4	0	166
12865	5	3	3	167	0	178
12866	2	0	178	7	0	187
12867	4	0	166	1	0	171
12868	165	0	5	5	0	175
12869	169	1	3	4	0	177
12870	7	174	1	3	0	185
12871	0	4	4	180	0	188
12872	3	2	178	6	0	189
12873	1	2	179	3	0	185
12874	5	1	6	173	0	185
12875	182	0	3	8	0	193
12876	4	179	3	2	0	188
12877	3	5	2	185	0	195
12878	186	1	2	5	0	194
12879	6	2	2	183	0	193
12880	1	177	1	8	0	187
12881	1	4	2	183	0	190
12882	182	3	2	7	0	194
12883	7	0	1	184	0	192
12884	183	1	0	8	0	192
12885	6	188	0	5	0	199
12886	189	8	2	1	0	200
12887	5	2	180	2	0	189
12888	171	1	6	3	0	181
12889	182	2	0	4	0	188
12890	4	194	1	2	0	201
12891	2	6	0	196	0	204
12892	3	1	195	5	0	204
12893	2	0	190	2	0	194
12894	185	1	5	1	0	192
12895	182	1	0	5	0	188
12896	5	186	1	1	0	193
12897	1	196	1	2	0	200
12898	183	4	1	4	0	192
12899	5	183	2	1	0	191
12900	2	191	2	0	0	195
12901	2	4	1	186	0	193
12902	1	1	2	184	0	188
12903	1	2	181	4	0	188
12904	3	0	4	182	0	189
12905	188	1	1	5	0	195
12906	4	2	180	2	0	188
12907	0	1	184	2	0	187
12908	2	0	4	185	0	191
12909	1	2	1	188	0	192
12910	1	1	0	191	0	193
12911	2	0	186	6	0	194
12912	0	0	6	173	0	179
12913	1	1	3	192	0	197
12914	189	0	0	6	0	195
12915	5	189	0	0	0	194
12916	182	3	0	3	0	188
12917	4	0	184	0	0	188
12918	158	1	3	1	0	163
12919	4	179	0	1	0	184
12920	168	2	0	1	0	171
12921	2	167	0	0	0	169
12922	160	2	0	1	0	163
12923	3	157	0	0	0	160
12924	0	158	0	0	0	158
12925	0	1	1	162	0	164
12926	165	0	0	2	0	167
12927	166	0	0	2	0	168
12928	164	0	0	0	0	164
12929	1	1	158	0	0	160
12930	0	1	155	0	0	156
12931	1	0	1	154	0	156
12932	0	163	0	1	0	164
12933	0	172	0	0	0	172
12934	0	1	0	165	0	166
12935	165	0	0	1	0	166
12936	154	0	0	2	0	156
12937	157	0	0	2	0	159
12938	1	1	154	0	0	156
12939	0	0	1	160	0	161
12940	0	0	166	1	0	167
12941	162	0	1	1	0	164
12942	163	0	0	0	0	163
12943	1	0	165	1	0	167
12944	1	0	2	157	0	160
12945	165	0	0	2	0	167
12946	2	0	0	166	0	168
12947	0	0	1	161	0	162
12948	0	0	0	168	0	168
12949	185	0	0	1	0	186
12950	1	0	0	188	0	189
12951	194	0	0	3	0	197
12952	1	201	1	4	0	207
12953	4	0	0	208	0	212
12954	0	4	0	210	0	214
12955	2	0	0	212	0	214
12956	206	1	0	6	0	213
12957	3	0	0	209	0	212
12958	4	0	1	205	0	210
12959	210	0	0	6	0	216
12960	210	1	0	6	0	217
12961	209	0	0	1	0	210
12962	5	1	198	1	0	205
12963	6	1	187	0	0	194
12964	200	0	5	0	0	205
12965	3	1	4	203	0	211
12966	5	0	1	192	0	198
12967	201	0	2	6	0	209
12968	197	0	0	5	0	202
12969	195	0	0	3	0	198
12970	6	195	1	2	0	204
12971	194	1	1	2	0	198
12972	194	4	0	2	0	200
12973	7	190	2	1	0	200
12974	5	193	1	1	0	200
12975	1	6	0	198	0	205
12976	205	3	0	2	0	210
12977	206	1	0	2	0	209
12978	209	2	0	1	0	212
12979	6	1	1	208	0	216
12980	209	0	0	4	0	213
12981	4	0	200	3	0	207
12982	206	0	0	0	0	206
12983	1	0	207	1	0	209
12984	5	0	202	1	0	208
12985	4	0	5	201	0	210
12986	206	0	5	1	0	212
12987	1	0	1	208	0	210
12988	5	0	211	1	0	217
12989	1	0	209	7	0	217
12990	4	1	4	206	0	215
12991	209	2	4	3	0	218
12992	3	217	2	7	0	229
12993	7	1	0	213	0	221
12994	3	5	1	219	0	228
12995	3	2	219	7	0	231
12996	4	1	214	6	0	225
12997	3	0	3	230	0	236
12998	230	0	4	6	0	240
12999	3	0	232	8	0	243
13000	6	0	2	230	0	238
13001	5	0	6	229	0	240
13002	3	0	1	237	0	241
13003	229	0	1	10	0	240
13004	3	0	220	8	0	231
13005	8	223	4	3	0	238
13006	2	0	5	235	0	242
13007	6	4	232	2	0	244
13008	3	229	3	7	0	242
13009	2	234	5	3	0	244
13010	235	6	1	5	0	247
13011	2	238	1	5	0	246
13012	243	1	1	6	0	251
13013	3	8	234	3	0	248
13014	9	2	0	242	0	253
13015	246	1	4	3	0	254
13016	4	249	1	6	0	260
13017	9	2	247	2	0	260
13018	3	5	2	218	0	228
13019	5	254	4	2	0	265
13020	6	1	3	261	0	271
13021	254	5	2	4	0	265
13022	5	263	2	8	0	278
13023	270	2	0	4	0	276
13024	263	5	1	4	0	273
13025	9	0	258	4	0	271
13026	9	268	2	0	0	279
13027	6	2	7	277	0	292
13028	4	3	288	3	0	298
13029	3	3	316	7	0	329
13030	4	3	10	327	0	344
13031	329	1	6	8	0	344
13032	313	2	2	7	0	324
13033	12	1	4	326	0	343
13034	8	2	329	6	0	345
13035	4	328	4	10	0	346
13036	341	3	5	3	0	352
13037	337	7	2	3	0	349
13038	10	347	4	4	0	365
13039	351	3	4	5	0	363
13040	4	9	336	2	0	351
13041	336	0	5	4	0	345
13042	334	0	7	2	0	343
13043	10	2	337	2	0	351
13044	10	0	4	332	0	346
13045	3	0	339	7	0	349
13046	2	329	4	10	0	345
13047	1	337	6	3	0	347
13048	2	5	3	323	0	333
13049	1	4	328	5	0	338
13050	1	314	5	3	0	323
13051	0	312	3	1	0	316
13052	297	5	1	0	0	303
13053	304	3	0	3	0	310
13054	5	0	1	301	0	307
13055	3	1	0	295	0	299
13056	1	309	2	4	0	316
13057	303	2	1	5	0	311
13058	305	2	0	2	0	309
13059	7	299	1	1	0	308
13060	5	3	0	312	0	320
13061	2	1	314	2	0	319
13062	2	2	4	305	0	313
13063	310	1	2	5	0	318
13064	5	0	1	313	0	319
13065	5	1	1	317	0	324
13066	326	2	0	7	0	335
13067	9	0	2	314	0	325
13068	4	315	2	5	0	326
13069	6	3	0	323	0	332
13070	6	2	1	323	0	332
13071	1	1	2	318	0	322
13072	1	321	2	8	0	332
13073	2	2	2	328	0	334
13074	1	6	317	3	0	327
13075	1	2	4	321	0	328
13076	1	1	321	7	0	330
13077	1	311	6	1	0	319
13078	2	7	2	319	0	330
13079	6	3	2	321	0	332
13080	5	1	2	321	0	329
13081	4	3	0	319	0	326
13082	2	2	311	7	0	322
13083	2	309	4	7	0	322
13084	6	6	2	312	0	326
13085	4	3	316	4	0	327
13086	1	3	5	319	0	328
13087	318	2	4	10	0	334
13088	4	1	306	3	0	314
13089	307	0	4	5	0	316
13090	8	3	3	313	0	327
13091	5	1	313	7	0	326
13092	4	312	6	6	0	328
13093	1	5	6	314	0	326
13094	4	5	323	7	0	339
13095	4	319	4	5	0	332
13096	6	4	3	319	0	332
13097	317	5	2	12	0	336
13098	325	2	2	7	0	336
13099	318	5	1	4	0	328
13100	10	2	306	4	0	322
13101	7	316	5	3	0	331
13102	4	7	4	309	0	324
13103	3	3	2	319	0	327
13104	321	3	4	12	0	340
13105	8	322	1	5	0	336
13106	326	4	0	7	0	337
13107	320	3	3	5	0	331
13108	328	3	1	7	0	339
13109	11	2	319	2	0	334
13110	317	2	6	5	0	330
13111	11	3	2	313	0	329
13112	5	1	3	316	0	325
13113	311	0	4	14	0	329
13114	9	2	1	302	0	314
13115	3	294	2	9	0	308
13116	11	4	1	293	0	309
13117	291	2	1	11	0	305
13118	7	4	282	6	0	299
13119	3	279	8	6	0	296
13120	9	5	3	268	0	285
13121	269	3	4	11	0	287
13122	4	2	268	5	0	279
13123	6	5	3	263	0	277
13124	4	2	262	10	0	278
13125	2	2	256	4	0	264
13126	3	4	252	8	0	267
13127	2	0	251	3	0	256
13128	2	1	234	1	0	238
13129	180	5	10	0	0	195
13130	4	188	4	1	0	197
13131	185	2	1	1	0	189
13132	180	1	1	1	0	183
13133	4	185	2	1	0	192
13134	1	189	2	2	0	194
13135	188	4	1	1	0	194
13136	184	2	2	3	0	191
13137	5	1	1	178	0	185
13138	2	176	2	6	0	186
13139	184	3	1	3	0	191
13140	2	189	0	1	0	192
13141	3	2	0	184	0	189
13142	185	0	2	4	0	191
13143	182	2	2	1	0	187
13144	6	1	1	184	0	192
13145	6	0	0	178	0	184
13146	3	0	183	2	0	188
13147	2	1	3	178	0	184
13148	0	1	185	4	0	190
13149	2	1	4	181	0	188
13150	0	3	1	183	0	187
13151	180	0	1	6	0	187
13152	184	0	0	3	0	187
13153	5	2	174	1	0	182
13154	175	1	2	1	0	179
13155	5	0	2	174	0	181
13156	3	1	181	2	0	187
13157	3	0	3	179	0	185
13158	1	0	2	188	0	191
13159	2	0	185	4	0	191
13160	2	2	2	181	0	187
13161	3	0	184	4	0	191
13162	5	0	3	190	0	198
13163	212	1	3	5	0	221
13164	6	213	3	4	0	226
13165	224	4	0	3	0	231
13166	7	220	3	1	0	231
13167	217	8	0	4	0	229
13168	8	224	1	2	0	235
13169	218	8	1	4	0	231
13170	9	220	1	2	0	232
13171	7	7	1	213	0	228
13172	4	6	214	7	0	231
13173	2	2	213	4	0	221
13174	2	2	10	205	0	219
13175	204	0	7	12	0	223
13176	6	210	5	4	0	225
13177	7	6	2	210	0	225
13178	2	6	212	8	0	228
13179	3	2	216	5	0	226
13180	2	2	12	205	0	221
13181	0	206	10	6	0	222
13182	200	6	5	9	0	220
13183	8	5	216	3	0	232
13184	8	3	220	2	0	233
13185	4	221	9	1	0	235
13186	219	7	7	4	0	237
13187	225	4	2	2	0	233
13188	12	2	1	217	0	232
13189	215	1	2	7	0	225
13190	220	0	0	5	0	225
13191	10	218	0	2	0	230
13192	223	6	2	2	0	233
13193	7	5	224	1	0	237
13194	5	1	8	213	0	227
13195	3	1	5	217	0	226
13196	214	1	1	12	0	228
13197	6	216	0	5	0	227
13198	209	5	0	3	0	217
13199	8	228	0	1	0	237
13200	6	227	1	1	0	235
13201	1	9	212	0	0	222
13202	4	5	208	0	0	217
13203	197	3	8	1	0	209
13204	204	2	4	2	0	212
13205	9	0	200	1	0	210
13206	5	193	6	1	0	205
13207	3	201	4	1	0	209
13208	198	7	1	1	0	207
13209	198	5	1	1	0	205
13210	8	2	1	198	0	209
13211	211	1	1	6	0	219
13212	8	0	1	208	0	217
13213	6	0	203	6	0	215
13214	1	3	202	5	0	211
13215	205	0	8	2	0	215
13216	4	1	6	198	0	209
13217	4	229	3	4	0	240
13218	235	7	1	3	0	246
13219	238	4	0	1	0	243
13220	10	3	236	0	0	249
13221	246	1	5	3	0	255
13222	259	0	5	1	0	265
13223	13	1	2	246	0	262
13224	3	241	1	5	0	250
13225	2	249	1	4	0	256
13226	3	10	1	249	0	263
13227	2	5	0	249	0	256
13228	1	2	2	253	0	258
13229	2	2	245	10	0	259
13230	0	2	239	6	0	247
13231	4	0	10	232	0	246
13232	2	2	244	6	0	254
13233	1	1	238	5	0	245
13234	2	0	12	235	0	249
13235	0	1	265	7	0	273
13236	2	259	9	4	0	274
13237	277	7	4	5	0	293
13238	9	5	2	284	0	300
13239	6	283	1	7	0	297
13240	2	9	293	3	0	307
13241	4	4	7	281	0	296
13242	2	2	316	8	0	328
13243	4	2	9	303	0	318
13244	4	1	4	319	0	328
13245	2	0	333	11	0	346
13246	2	0	8	321	0	331
13247	0	334	5	8	0	347
13248	2	7	1	351	0	361
13249	1	7	343	8	0	359
13250	3	2	7	335	0	347
13251	336	1	6	9	0	352
13252	7	335	2	5	0	349
13253	7	8	1	340	0	356
13254	3	4	356	8	0	371
13255	1	346	8	5	0	360
13256	0	362	4	1	0	367
13257	0	11	340	2	0	353
13258	2	4	8	333	0	347
13259	2	5	3	341	0	351
13260	1	1	336	11	0	349
13261	1	315	7	2	0	325
13262	0	330	3	2	0	335
13263	301	5	1	1	0	308
13264	4	307	3	0	0	314
13265	311	3	0	2	0	316
13266	4	1	0	299	0	304
13267	316	0	0	7	0	323
13268	3	0	320	1	0	324
13269	306	0	3	3	0	312
13270	6	0	1	329	0	336
13271	1	327	0	5	0	333
13272	325	5	0	6	0	336
13273	6	1	0	341	0	348
13274	2	350	0	6	0	358
13275	0	379	0	2	0	381
13276	374	7	0	2	0	383
13277	374	0	1	3	0	378
13278	382	0	0	3	0	385
13279	6	0	1	372	0	379
13280	1	362	0	6	0	369
13281	0	375	0	1	0	376
13282	1	5	1	371	0	378
13283	367	0	0	8	0	375
13284	352	1	0	4	0	357
13285	368	0	0	2	0	370
13286	5	0	379	0	0	384
13287	0	0	357	1	0	358
13288	389	0	5	0	0	394
13289	5	1	0	393	0	399
13290	0	0	0	397	0	397
13291	0	0	1	394	0	395
13292	1	0	0	399	0	400
13293	0	0	387	5	0	392
13294	1	0	5	379	0	385
13295	0	1	386	6	0	393
13296	349	0	5	4	0	358
13297	5	395	1	0	0	401
13298	1	5	0	395	0	401
13299	0	1	0	390	0	391
13300	382	0	0	8	0	390
13301	384	1	0	1	0	386
13302	382	0	0	3	0	385
13303	380	0	0	2	0	382
13304	7	0	376	0	0	383
13305	0	1	358	1	0	360
13306	3	1	5	370	0	379
13307	383	1	0	10	0	394
13308	375	1	0	1	0	377
13309	6	0	378	1	0	385
13310	0	0	4	360	0	364
13311	370	1	0	8	0	379
13312	5	2	0	372	0	379
13313	1	0	379	4	0	384
13314	1	1	4	371	0	377
13315	383	0	0	10	0	393
13316	4	412	0	2	0	418
13317	411	4	0	2	0	417
13318	406	0	0	4	0	410
13319	399	0	1	6	0	406
13320	4	0	0	402	0	406
13321	400	0	1	7	0	408
13322	3	419	0	0	0	422
13323	1	425	1	0	0	427
13324	0	5	1	419	0	425
13325	421	0	0	10	0	431
13326	7	418	1	1	0	427
13327	480	6	0	2	0	488
13328	501	2	0	3	0	506
13329	15	508	1	3	0	527
13330	5	14	2	507	0	528
13331	1	3	1	524	0	529
13332	1	2	519	18	0	540
13333	6	0	13	514	0	533
13334	2	2	522	17	0	543
13335	4	508	16	4	0	532
13336	2	13	3	518	0	536
13337	488	4	1	20	0	513
13338	500	1	1	10	0	512
13339	21	1	2	496	0	520
13340	4	0	495	18	0	517
13341	457	4	15	11	0	487
13342	14	469	5	4	0	492
13343	6	490	1	3	0	500
13344	4	500	2	2	0	508
13345	6	16	2	476	0	500
13346	4	3	499	17	0	523
13347	7	4	13	493	0	517
13348	2	2	499	18	0	521
13349	4	5	486	5	0	500
13350	2	3	506	4	0	515
13351	6	3	20	470	0	499
13352	3	3	7	499	0	512
13353	4	3	2	513	0	522
13354	4	3	3	493	0	503
13355	489	2	5	27	0	523
13356	15	484	4	6	0	509
13357	493	15	2	7	0	517
13358	12	502	8	2	0	524
13359	4	15	2	518	0	539
13360	2	3	3	559	0	567
13361	544	4	1	24	0	573
13362	571	2	1	12	0	586
13363	579	2	1	8	0	590
13364	579	3	2	5	0	589
13365	572	4	1	9	0	586
13366	20	557	6	6	0	589
13367	554	16	4	12	0	586
13368	16	560	5	4	0	585
13369	555	14	2	13	0	584
13370	20	5	566	4	0	595
13371	11	5	10	550	0	576
13372	8	574	5	13	0	600
13373	10	15	0	570	0	595
13374	7	6	567	16	0	596
13375	8	5	16	529	0	558
13376	533	4	5	20	0	562
13377	13	534	3	7	0	557
13378	5	555	3	7	0	570
13379	5	18	553	5	0	581
13380	10	7	14	551	0	582
13381	6	572	6	18	0	602
13382	6	15	6	587	0	614
13383	5	5	597	18	0	625
13384	4	591	17	6	0	618
13385	3	18	588	6	0	615
13386	2	8	590	6	0	606
13387	2	9	17	577	0	605
13388	594	4	6	21	0	625
13389	14	6	6	595	0	621
13390	5	8	594	21	0	628
13391	7	6	18	600	0	631
13392	1	4	650	22	0	677
13393	3	8	640	7	0	658
13394	627	3	19	12	0	661
13395	673	2	13	8	0	696
13396	666	7	7	7	0	687
13397	19	3	661	10	0	693
13398	9	2	674	8	0	693
13399	8	3	21	648	0	680
13400	11	1	10	662	0	684
13401	654	3	9	22	0	688
13402	21	5	6	647	0	679
13403	8	5	661	19	0	693
13404	8	2	656	10	0	676
13405	7	664	20	5	0	696
13406	10	10	8	669	0	697
13407	8	3	678	18	0	707
13408	13	3	16	646	0	678
13409	659	4	9	23	0	695
13410	17	1	671	8	0	697
13411	13	5	19	658	0	695
13412	9	3	8	674	0	694
13413	5	5	666	19	0	695
13414	10	2	14	631	0	657
13415	4	4	654	18	0	680
13416	594	2	20	11	0	627
13417	18	6	10	610	0	644
13418	7	604	7	25	0	643
13419	609	11	9	11	0	640
13420	601	5	7	12	0	625
13421	19	595	8	9	0	631
13422	13	28	7	553	0	601
13423	6	562	7	14	0	589
13424	7	565	1	9	0	582
13425	6	16	546	8	0	576
13426	5	541	16	9	0	571
13427	2	7	478	7	0	494
13428	410	5	4	4	0	423
13429	407	2	4	5	0	418
13430	0	423	0	4	0	427
13431	1	416	3	2	0	422
13432	4	431	2	1	0	438
13433	427	4	1	7	0	439
13434	4	4	1	431	0	440
13435	4	2	448	3	0	457
13436	3	455	6	2	0	466
13437	1	10	2	460	0	473
13438	4	3	2	454	0	463
13439	2	517	5	7	0	531
13440	542	11	1	3	0	557
13441	12	0	540	4	0	556
13442	6	3	10	620	0	639
13443	0	680	3	14	0	697
13444	671	19	1	9	0	700
13445	18	8	666	3	0	695
13446	9	644	15	5	0	673
13447	9	22	8	646	0	685
13448	4	12	649	16	0	681
13449	623	3	20	9	0	655
13450	19	5	9	628	0	661
13451	6	4	630	23	0	663
13452	3	623	23	9	0	658
13453	598	19	10	5	0	632
13454	17	633	2	8	0	660
13455	616	18	6	10	0	650
13456	634	11	4	5	0	654
13457	33	4	2	601	0	640
13458	11	580	9	18	0	618
13459	6	18	598	8	0	630
13460	17	8	18	574	0	617
13461	22	3	10	527	0	562
13462	6	7	3	596	0	612
13463	11	4	5	593	0	613
13464	7	1	6	603	0	617
13465	581	4	3	34	0	622
13466	569	3	2	16	0	590
13467	568	1	6	14	0	589
13468	24	568	2	11	0	605
13469	14	21	567	6	0	608
13470	11	8	578	3	0	600
13471	5	8	586	4	0	603
13472	13	6	24	552	0	595
13473	8	6	13	578	0	605
13474	12	1	6	591	0	610
13475	5	4	570	25	0	604
13476	3	568	22	14	0	607
13477	3	16	589	8	0	616
13478	2	8	596	9	0	615
13479	7	2	29	574	0	612
13480	3	5	603	24	0	635
13481	12	1	20	591	0	624
13482	587	1	14	24	0	626
13483	593	2	5	15	0	615
13484	29	6	579	5	0	619
13485	17	5	24	569	0	615
13486	10	3	581	22	0	616
13487	8	581	22	10	0	621
13488	583	18	15	10	0	626
13489	21	11	578	8	0	618
13490	13	549	21	8	0	591
13491	3	566	17	7	0	593
13492	5	568	8	5	0	586
13493	6	25	529	8	0	568
13494	9	17	27	484	0	537
13495	5	513	9	24	0	551
13496	6	27	9	518	0	560
13497	16	11	11	527	0	565
13498	507	7	8	32	0	554
13499	26	507	6	12	0	551
13500	506	22	5	12	0	545
13501	23	495	10	8	0	536
13502	17	528	4	7	0	556
13503	7	24	501	9	0	541
13504	11	18	22	490	0	541
13505	7	8	508	23	0	546
13506	6	485	24	18	0	533
13507	4	27	490	10	0	531
13508	4	15	506	8	0	533
13509	8	486	28	8	0	530
13510	451	20	18	15	0	504
13511	20	479	7	8	0	514
13512	478	22	12	9	0	521
13513	23	13	468	13	0	517
13514	15	11	477	7	0	510
13515	10	458	34	9	0	511
13516	457	29	13	12	0	511
13517	26	459	11	10	0	506
13518	16	25	14	466	0	521
13519	472	12	7	24	0	515
13520	23	7	463	14	0	507
13521	20	9	27	460	0	516
13522	444	10	16	24	0	494
13523	25	451	10	12	0	498
13524	16	25	15	447	0	503
13525	7	10	455	27	0	499
13526	449	4	26	15	0	494
13527	31	4	17	451	0	503
13528	11	8	443	24	0	486
13529	13	5	24	428	0	470
13530	8	433	20	21	0	482
13531	6	21	428	22	0	477
13532	9	9	19	414	0	451
13533	398	4	18	20	0	440
13534	20	5	7	407	0	439
13535	367	5	8	15	0	395
13536	19	363	3	10	0	395
13537	354	14	9	3	0	380
13538	15	13	342	6	0	376
13539	11	5	283	2	0	301
13540	2	4	254	4	0	264
13541	3	236	23	2	0	264
13542	6	0	13	66	0	85
13543	0	2	2	60	0	64
13544	0	1	2	57	0	60
13545	2	0	1	60	0	63
13546	2	0	58	1	0	61
13547	51	0	3	0	0	54
13548	1	56	1	2	0	60
13549	58	1	2	0	0	61
13550	1	1	1	56	0	59
13551	1	59	1	0	0	61
13552	1	2	2	62	0	67
13553	61	2	0	0	0	63
13554	1	68	0	1	0	70
13555	66	1	1	1	0	69
13556	64	0	2	1	0	67
13557	0	1	0	66	0	67
13558	1	1	66	1	0	69
13559	65	1	1	1	0	68
13560	1	0	0	71	0	72
13561	70	1	0	0	0	71
13562	68	1	1	0	0	70
13563	69	0	0	1	0	70
13564	0	2	67	0	0	69
13565	1	1	0	65	0	67
13566	67	0	0	1	0	68
13567	0	1	76	0	0	77
13568	2	78	0	0	0	80
13569	3	0	0	74	0	77
13570	0	0	80	0	0	80
13571	0	0	77	1	0	78
13572	1	0	0	80	0	81
13573	1	0	1	80	0	82
13574	1	0	0	83	0	84
13575	3	0	0	78	0	81
13576	0	0	82	1	0	83
13577	0	85	1	1	0	87
13578	0	1	0	92	0	93
13579	91	0	0	2	0	93
13580	89	0	2	0	0	91
13581	91	1	1	1	0	94
13582	0	0	1	93	0	94
13583	0	1	1	90	0	92
13584	0	84	1	0	0	85
13585	0	92	0	2	0	94
13586	2	0	0	95	0	97
13587	91	0	1	2	0	94
13588	93	0	0	1	0	94
13589	92	0	0	0	0	92
13590	93	0	0	1	0	94
13591	96	0	0	0	0	96
13592	0	95	0	0	0	95
13593	0	0	0	101	0	101
13594	105	0	0	1	0	106
13595	104	0	0	2	0	106
13596	0	0	0	106	0	106
13597	0	0	0	106	0	106
13598	0	0	107	0	0	107
13599	0	0	0	106	0	106
13600	0	0	0	108	0	108
13601	0	0	113	0	0	113
13602	1	0	0	113	0	114
13603	0	123	0	0	0	123
13604	0	0	117	1	0	118
13605	0	117	0	0	0	117
13606	0	1	0	119	0	120
13607	0	0	0	117	0	117
13608	0	121	0	0	0	121
13609	0	129	0	0	0	129
13610	129	0	0	2	0	131
13611	127	0	0	1	0	128
13612	0	0	132	0	0	132
13613	146	0	0	2	0	148
13614	151	0	0	1	0	152
13615	149	0	0	1	0	150
13616	148	0	0	2	0	150
13617	0	1	142	0	0	143
13618	0	0	131	0	0	131
13619	146	0	0	1	0	147
13620	0	148	0	0	0	148
13621	0	0	153	0	0	153
13622	150	0	1	0	0	151
13623	151	0	0	0	0	151
13624	1	0	145	0	0	146
13625	142	0	1	0	0	143
13626	2	1	0	166	0	169
13627	1	0	175	1	0	177
13628	175	0	1	1	0	177
13629	1	182	0	1	0	184
13630	188	1	1	2	0	192
13631	230	1	0	5	0	236
13632	2	1	0	231	0	234
13633	2	0	0	234	0	236
13634	1	1	0	240	0	242
13635	239	0	0	4	0	243
13636	246	0	0	4	0	250
13637	4	0	0	243	0	247
13638	1	1	0	243	0	245
13639	1	0	238	2	0	241
13640	224	0	1	4	0	229
13641	2	0	1	242	0	245
13642	2	0	1	232	0	235
13643	1	236	0	2	0	239
13644	0	1	0	241	0	242
13645	0	1	0	233	0	234
13646	233	0	0	2	0	235
13647	1	235	0	2	0	238
13648	1	1	0	241	0	243
13649	2	2	0	237	0	241
13650	0	1	0	237	0	238
13651	0	0	236	4	0	240
13652	0	1	1	235	0	237
13653	230	0	1	5	0	236
13654	1	0	229	2	0	232
13655	2	0	1	225	0	228
13656	3	2	1	231	0	237
13657	233	0	1	6	0	240
13658	228	0	0	5	0	233
13659	2	0	227	2	0	231
13660	218	0	2	0	0	220
13661	2	1	229	1	0	233
13662	218	0	2	0	0	220
13663	2	250	2	0	0	254
13664	254	1	1	1	0	257
13665	2	253	0	1	0	256
13666	261	1	0	2	0	264
13667	3	266	0	0	0	269
13668	0	3	1	265	0	269
13669	3	1	0	262	0	266
13670	2	2	1	259	0	264
13671	2	259	0	3	0	264
13672	0	3	0	258	0	261
13673	1	258	0	3	0	262
13674	2	5	0	258	0	265
13675	252	1	1	3	0	257
13676	254	3	2	3	0	262
13677	3	247	1	4	0	255
13678	3	1	1	254	0	259
13679	252	1	0	4	0	257
13680	4	258	0	2	0	264
13681	2	255	1	3	0	261
13682	257	4	0	2	0	263
13683	252	3	2	4	0	261
13684	6	249	0	1	0	256
13685	260	2	0	1	0	263
13686	7	2	0	255	0	264
13687	1	4	266	3	0	274
13688	263	0	3	4	0	270
13689	268	3	1	4	0	276
13690	6	1	267	1	0	275
13691	264	0	3	3	0	270
13692	271	0	1	3	0	275
13693	272	2	2	3	0	279
13694	10	267	1	1	0	279
13695	268	4	0	4	0	276
13696	265	2	1	4	0	272
13697	8	3	0	261	0	272
13698	10	0	0	263	0	273
13699	4	2	1	273	0	280
13700	271	0	0	10	0	281
13701	5	1	0	273	0	279
13702	278	1	0	6	0	285
13703	280	2	0	4	0	286
13704	6	4	0	275	0	285
13705	9	1	0	281	0	291
13706	5	1	0	286	0	292
13707	286	0	0	13	0	299
13708	5	277	0	7	0	289
13709	4	6	1	288	0	299
13710	5	2	0	290	0	297
13711	282	2	0	10	0	294
13712	284	0	1	7	0	292
13713	12	0	276	3	0	291
13714	5	1	268	2	0	276
13715	282	0	10	3	0	295
13716	10	2	3	277	0	292
13717	6	1	2	329	0	338
13718	3	3	325	12	0	343
13719	1	0	9	334	0	344
13720	3	325	3	13	0	344
13721	1	340	3	8	0	352
13722	330	10	1	4	0	345
13723	8	6	330	3	0	347
13724	7	342	8	1	0	358
13725	5	9	2	344	0	360
13726	2	2	339	9	0	352
13727	5	2	9	326	0	342
13728	1	1	3	332	0	337
13729	2	2	326	13	0	343
13730	1	330	7	5	0	343
13731	2	9	3	310	0	324
13732	311	4	1	11	0	327
13733	310	3	1	5	0	319
13734	310	1	3	3	0	317
13735	12	305	2	2	0	321
13736	306	9	4	2	0	321
13737	11	2	2	307	0	322
13738	5	2	311	9	0	327
13739	304	0	9	10	0	323
13740	10	319	3	3	0	335
13741	4	9	2	322	0	337
13742	5	4	0	318	0	327
13743	2	314	2	11	0	329
13744	7	9	0	323	0	339
13745	3	3	1	328	0	335
13746	2	2	0	334	0	338
13747	323	1	0	16	0	340
13748	314	2	1	7	0	324
13749	13	1	323	4	0	341
13750	6	1	9	325	0	341
13751	4	0	2	353	0	359
13752	4	2	2	349	0	357
13753	339	0	0	14	0	353
13754	9	0	340	5	0	354
13755	322	2	8	3	0	335
13756	338	0	2	5	0	345
13757	12	0	0	336	0	348
13758	339	0	0	10	0	349
13759	11	2	315	3	0	331
13760	318	0	6	5	0	329
13761	12	364	3	1	0	380
13762	2	10	367	3	0	382
13763	5	3	371	2	0	381
13764	2	1	14	367	0	384
13765	5	0	376	10	0	391
13766	354	1	11	8	0	374
13767	11	364	3	3	0	381
13768	373	10	5	2	0	390
13769	15	3	1	381	0	400
13770	3	1	383	10	0	397
13771	2	4	385	5	0	396
13772	1	1	13	388	0	403
13773	394	1	8	10	0	413
13774	9	387	2	7	0	405
13775	2	402	4	5	0	413
13776	400	10	4	2	0	416
13777	8	404	1	2	0	415
13778	406	12	1	4	0	423
13779	10	4	2	406	0	422
13780	405	4	5	9	0	423
13781	11	0	3	402	0	416
13782	401	3	1	19	0	424
13783	16	0	4	400	0	420
13784	3	405	1	13	0	422
13785	399	13	0	7	0	419
13786	13	403	1	3	0	420
13787	4	14	375	1	0	394
13788	10	2	8	357	0	377
13789	2	393	1	9	0	405
13790	377	8	1	5	0	391
13791	383	2	1	9	0	395
13792	12	375	3	4	0	394
13793	3	8	372	4	0	387
13794	6	5	8	363	0	382
13795	4	370	3	11	0	388
13796	3	10	3	382	0	398
13797	5	3	2	382	0	392
13798	374	3	1	14	0	392
13799	8	371	2	7	0	388
13800	6	7	0	378	0	391
13801	379	3	1	11	0	394
13802	382	3	0	5	0	390
13803	380	0	2	4	0	386
13804	13	1	1	369	0	384
13805	369	2	1	10	0	382
13806	9	369	0	6	0	384
13807	361	5	1	5	0	372
13808	9	372	2	1	0	384
13809	373	6	0	5	0	384
13810	378	1	1	7	0	387
13811	9	3	1	370	0	383
13812	6	0	387	4	0	397
13813	6	2	367	1	0	376
13814	2	385	3	4	0	394
13815	373	2	4	6	0	385
13816	3	4	380	2	0	389
13817	300	1	1	2	0	304
13818	1	308	0	1	0	310
13819	2	317	1	0	0	320
13820	5	1	0	318	0	324
13821	0	321	0	3	0	324
13822	1	3	332	0	0	336
13823	2	2	5	311	0	320
13824	1	331	0	2	0	334
13825	3	3	2	330	0	338
13826	332	1	2	5	0	340
13827	9	2	0	322	0	333
13828	1	3	319	6	0	329
13829	2	322	6	3	0	333
13830	2	6	3	314	0	325
13831	4	3	3	306	0	316
13832	4	1	3	313	0	321
13833	300	0	3	11	0	314
13834	301	1	0	7	0	309
13835	7	2	304	3	0	316
13836	4	1	299	1	0	305
13837	1	297	7	4	0	309
13838	299	7	4	1	0	311
13839	6	2	3	305	0	316
13840	3	1	1	301	0	306
13841	3	1	1	307	0	312
13842	2	1	0	307	0	310
13843	5	2	289	8	0	304
13844	278	2	5	5	0	290
13845	6	2	6	318	0	332
13846	3	2	318	7	0	330
13847	308	2	5	4	0	319
13848	337	0	1	11	0	349
13849	11	3	389	8	0	411
13850	6	2	403	2	0	413
13851	5	0	15	384	0	404
13852	386	2	6	18	0	412
13853	401	0	6	5	0	412
13854	19	2	2	380	0	403
13855	6	0	4	400	0	410
13856	5	1	386	19	0	411
13857	11	1	13	372	0	397
13858	7	0	380	15	0	402
13859	365	1	16	8	0	390
13860	13	381	6	4	0	404
13861	345	11	4	5	0	365
13862	14	343	1	4	0	362
13863	341	13	3	5	0	362
13864	17	3	1	333	0	354
13865	9	3	2	336	0	350
13866	336	1	3	19	0	359
13867	347	1	2	5	0	355
13868	346	0	1	7	0	354
13869	344	1	2	7	0	354
13870	17	0	327	4	0	348
13871	328	1	13	5	0	347
13872	342	1	1	2	0	346
13873	341	0	4	1	0	346
13874	18	0	1	326	0	345
13875	314	2	4	18	0	338
13876	18	305	5	4	0	332
13877	11	12	1	313	0	337
13878	12	2	1	325	0	340
13879	3	2	309	17	0	331
13880	7	2	12	298	0	319
13881	4	308	4	18	0	334
13882	310	11	5	10	0	336
13883	20	309	4	6	0	339
13884	316	13	5	5	0	339
13885	19	6	2	317	0	344
13886	310	5	3	16	0	334
13887	21	304	2	6	0	333
13888	313	16	3	4	0	336
13889	321	2	2	10	0	335
13890	19	4	4	311	0	338
13891	13	3	1	324	0	341
13892	10	6	301	16	0	333
13893	13	2	12	307	0	334
13894	9	2	4	322	0	337
13895	6	2	299	25	0	332
13896	5	5	15	310	0	335
13897	6	2	298	21	0	327
13898	299	4	16	9	0	328
13899	22	2	4	305	0	333
13900	7	4	303	19	0	333
13901	308	2	13	7	0	330
13902	21	3	8	301	0	333
13903	11	1	302	18	0	332
13904	303	2	17	10	0	332
13905	23	0	6	316	0	345
13906	12	3	3	329	0	347
13907	325	2	2	21	0	350
13908	17	2	5	317	0	341
13909	12	1	5	319	0	337
13910	6	1	4	318	0	329
13911	6	310	1	25	0	342
13912	287	13	5	7	0	312
13913	294	4	1	10	0	309
13914	21	3	1	292	0	317
13915	293	3	3	18	0	317
13916	301	4	0	10	0	315
13917	301	3	4	6	0	314
13918	235	2	5	7	0	249
13919	283	2	1	12	0	298
13920	23	1	262	6	0	292
13921	12	3	249	5	0	269
13922	239	1	13	5	0	258
13923	17	241	2	7	0	267
13924	10	9	3	235	0	257
13925	4	1	240	16	0	261
13926	6	2	239	6	0	253
13927	6	3	13	229	0	251
13928	232	3	2	14	0	251
13929	11	1	4	236	0	252
13930	6	0	229	14	0	249
13931	241	1	11	6	0	259
13932	20	0	2	239	0	261
13933	11	1	3	247	0	262
13934	9	0	1	251	0	261
13935	4	1	5	247	0	257
13936	6	1	236	15	0	258
13937	7	1	10	242	0	260
13938	237	1	3	15	0	256
13939	12	2	231	11	0	256
13940	226	1	12	8	0	247
13941	240	2	4	4	0	250
13942	242	0	2	7	0	251
13943	244	3	3	3	0	253
13944	13	226	3	8	0	250
13945	8	194	2	2	0	206
13946	4	205	1	4	0	214
13947	187	7	6	2	0	202
13948	8	1	174	3	0	186
13949	98	1	2	1	0	102
13950	1	0	0	93	0	94
13951	94	0	0	1	0	95
13952	0	1	1	93	0	95
13953	93	0	2	0	0	95
13954	1	0	0	89	0	90
13955	1	0	0	94	0	95
13956	82	0	1	1	0	84
13957	1	126	1	0	0	128
13958	1	0	124	0	0	125
13959	1	122	0	1	0	124
13960	1	0	119	0	0	120
13961	0	2	0	117	0	119
13962	117	0	1	1	0	119
13963	0	0	0	116	0	116
13964	116	0	0	1	0	117
13965	0	128	0	0	0	128
13966	0	0	135	0	0	135
13967	0	132	0	1	0	133
13968	0	130	0	0	0	130
13969	125	0	0	1	0	126
13970	124	0	0	0	0	124
13971	0	120	0	0	0	120
13972	0	0	0	124	0	124
13973	0	0	0	123	0	123
13974	123	0	0	0	0	123
13975	0	0	126	0	0	126
13976	0	0	122	0	0	122
13977	1	0	0	125	0	126
13978	0	0	129	0	0	129
13979	120	0	0	1	0	121
13980	122	0	0	3	0	125
13981	0	129	0	0	0	129
13982	2	0	130	0	0	132
13983	0	0	0	128	0	128
13984	0	0	142	1	0	143
13985	0	0	0	135	0	135
13986	138	0	0	2	0	140
13987	0	152	0	0	0	152
13988	0	0	159	0	0	159
13989	0	154	0	0	0	154
13990	1	157	0	0	0	158
13991	158	1	0	4	0	163
13992	156	0	0	0	0	156
13993	1	1	157	0	0	159
13994	0	165	1	0	0	166
13995	1	1	0	165	0	167
13996	1	0	0	164	0	165
13997	1	0	1	159	0	161
13998	0	1	170	1	0	172
13999	1	0	1	170	0	172
14000	0	0	0	171	0	171
14001	170	0	0	3	0	173
14002	172	0	1	0	0	173
14003	174	0	0	2	0	176
14004	171	0	0	0	0	171
14005	172	0	0	3	0	175
14006	1	171	1	0	0	173
14007	168	0	0	1	0	169
14008	2	0	171	0	0	173
14009	1	1	0	168	0	170
14010	172	1	0	1	0	174
14011	2	170	1	1	0	174
14012	169	1	1	1	0	172
14013	179	0	0	1	0	180
14014	1	0	0	187	0	188
14015	1	1	0	186	0	188
14016	1	202	2	1	0	206
14017	1	2	0	207	0	210
14018	0	0	214	3	0	217
14019	0	0	2	209	0	211
14020	0	1	214	2	0	217
14021	202	0	2	1	0	205
14022	4	0	1	211	0	216
14023	1	0	223	2	0	226
14024	0	213	4	0	0	217
14025	1	217	0	0	0	218
14026	216	2	0	2	0	220
14027	2	0	1	218	0	221
14028	0	2	231	2	0	235
14029	0	241	2	0	0	243
14030	1	2	246	0	0	249
14031	237	0	1	2	0	240
14032	238	0	1	1	0	240
14033	241	1	0	0	0	242
14034	2	0	0	243	0	245
14035	1	0	235	2	0	238
14036	1	244	1	0	0	246
14037	1	1	0	253	0	255
14038	0	0	246	3	0	249
14039	0	0	241	0	0	241
14040	0	1	1	250	0	252
14041	253	0	0	5	0	258
14042	2	0	1	250	0	253
14043	3	0	1	257	0	261
14044	0	0	263	3	0	266
14045	1	0	2	262	0	265
14046	0	0	0	272	0	272
14047	0	0	272	3	0	275
14048	0	0	270	0	0	270
14049	0	0	2	269	0	271
14050	0	0	266	2	0	268
14051	3	0	2	260	0	265
14052	268	0	1	3	0	272
14053	2	282	1	1	0	286
14054	2	2	1	284	0	289
14055	0	1	286	3	0	290
14056	250	0	2	2	0	254
14057	2	271	0	1	0	274
14058	272	0	1	1	0	274
14059	3	1	1	268	0	273
14060	1	1	1	267	0	270
14061	271	1	0	3	0	275
14062	3	0	273	0	0	276
14063	267	0	1	1	0	269
14064	3	0	0	281	0	284
14065	279	0	2	2	0	283
14066	268	2	1	0	0	271
14067	3	0	0	272	0	275
14068	1	278	2	3	0	284
14069	284	3	0	1	0	288
14070	278	2	0	2	0	282
14071	5	0	277	1	0	283
14072	273	1	2	3	0	279
14073	3	0	2	274	0	279
14074	2	282	0	2	0	286
14075	2	2	1	268	0	273
14076	2	276	0	3	0	281
14077	271	2	1	2	0	276
14078	272	2	1	0	0	275
14079	4	1	0	300	0	305
14080	0	1	304	3	0	308
14081	1	1	294	2	0	298
14082	5	0	4	303	0	312
14083	304	1	2	7	0	314
14084	302	0	0	5	0	307
14085	4	311	4	1	0	320
14086	5	4	0	311	0	320
14087	1	3	308	5	0	317
14088	1	0	308	2	0	311
14089	0	3	6	334	0	343
14090	358	0	1	7	0	366
14091	6	0	1	361	0	368
14092	2	1	352	5	0	360
14093	360	0	6	5	0	371
14094	8	0	2	367	0	377
14095	5	1	1	366	0	373
14096	5	1	0	358	0	364
14097	1	357	0	9	0	367
14098	1	7	354	1	0	363
14099	1	2	352	2	0	357
14100	2	0	8	358	0	368
14101	3	0	356	7	0	366
14102	346	1	7	4	0	358
14103	9	0	3	346	0	358
14104	4	1	0	349	0	354
14105	0	1	0	350	0	351
14106	1	342	1	9	0	353
14107	346	7	1	8	0	362
14108	10	3	1	352	0	366
14109	346	0	3	10	0	359
14110	8	347	3	3	0	361
14111	346	6	4	7	0	363
14112	340	2	1	7	0	350
14113	344	2	0	4	0	350
14114	10	336	1	4	0	351
14115	5	343	2	2	0	352
14116	324	8	1	4	0	337
14117	6	335	1	1	0	343
14118	3	7	327	4	0	341
14119	3	304	4	4	0	315
14120	4	333	3	0	0	340
14121	336	9	2	2	0	349
14122	10	3	325	1	0	339
14123	5	2	333	2	0	342
14124	5	2	10	323	0	340
14125	310	4	27	7	0	348
14126	9	0	336	6	0	351
14127	7	3	5	334	0	349
14128	2	4	337	6	0	349
14129	4	3	317	4	0	328
14130	321	1	8	3	0	333
14131	7	1	325	3	0	336
14132	9	1	8	320	0	338
14133	4	3	3	319	0	329
14134	5	319	5	12	0	341
14135	5	329	2	5	0	341
14136	6	9	2	326	0	343
14137	3	9	319	9	0	340
14138	5	4	11	320	0	340
14139	5	0	9	324	0	338
14140	5	4	336	11	0	356
14141	5	0	10	342	0	357
14142	344	4	5	12	0	365
14143	8	4	340	9	0	361
14144	334	4	4	7	0	349
14145	11	2	9	334	0	356
14146	6	2	6	345	0	359
14147	3	348	1	19	0	371
14148	8	6	5	354	0	373
14149	6	4	6	362	0	378
14150	360	4	2	17	0	383
14151	9	0	7	364	0	380
14152	11	0	6	362	0	379
14153	346	4	2	18	0	370
14154	10	2	4	360	0	376
14155	7	2	1	337	0	347
14156	4	348	5	15	0	372
14157	348	13	2	10	0	373
14158	16	6	2	350	0	374
14159	9	3	1	363	0	376
14160	6	1	357	13	0	377
14161	9	4	4	355	0	372
14162	4	3	4	367	0	378
14163	348	2	6	13	0	369
14164	351	4	1	11	0	367
14165	14	2	3	345	0	364
14166	7	4	354	6	0	371
14167	6	336	6	5	0	353
14168	3	341	4	5	0	353
14169	3	7	7	341	0	358
14170	337	7	3	11	0	358
14171	10	2	1	342	0	355
14172	350	1	1	10	0	362
14173	12	2	4	347	0	365
14174	7	2	2	347	0	358
14175	347	2	3	11	0	363
14176	345	1	6	5	0	357
14177	10	344	1	7	0	362
14178	5	358	4	2	0	369
14179	2	8	3	314	0	327
14180	8	2	2	319	0	331
14181	2	3	308	9	0	322
14182	281	2	8	8	0	299
14183	7	297	5	4	0	313
14184	2	293	2	2	0	299
14185	283	6	1	8	0	298
14186	7	3	286	1	0	297
14187	1	1	277	1	0	280
14188	1	2	261	2	0	266
14189	1	240	6	1	0	248
14190	2	2	2	219	0	225
14191	0	0	1	219	0	220
14192	0	1	0	221	0	222
14193	215	0	0	3	0	218
14194	210	0	0	2	0	212
14195	2	224	0	1	0	227
14196	4	1	0	226	0	231
14197	1	0	227	2	0	230
14198	0	228	2	0	0	230
14199	221	2	0	3	0	226
14200	1	0	226	0	0	227
14201	208	1	1	0	0	210
14202	2	0	221	0	0	223
14203	2	1	2	217	0	222
14204	1	226	0	1	0	228
14205	228	1	1	2	0	232
14206	1	225	0	1	0	227
14207	218	1	0	0	0	219
14208	2	0	0	214	0	216
14209	0	0	222	1	0	223
14210	1	0	1	219	0	221
14211	1	0	0	234	0	235
14212	0	0	239	1	0	240
14213	215	0	1	2	0	218
14214	1	232	0	0	0	233
14215	231	1	0	2	0	234
14216	1	233	0	0	0	234
14217	0	1	0	236	0	237
14218	0	0	226	1	0	227
14219	240	0	0	2	0	242
14220	2	251	0	0	0	253
14221	0	2	0	243	0	245
14222	2	0	0	250	0	252
14223	250	0	0	4	0	254
14224	258	0	0	2	0	260
14225	2	261	0	1	0	264
14226	287	2	0	1	0	290
14227	289	1	1	1	0	292
14228	289	0	0	1	0	290
14229	4	2	287	0	0	293
14230	2	276	4	2	0	284
14231	2	285	0	1	0	288
14232	2	6	0	265	0	273
14233	3	1	0	277	0	281
14234	272	1	0	7	0	280
14235	6	273	0	1	0	280
14236	275	4	0	3	0	282
14237	8	3	0	267	0	278
14238	3	1	1	274	0	279
14239	263	1	0	6	0	270
14240	242	1	0	4	0	247
14241	6	0	247	1	0	254
14242	3	1	4	241	0	249
14243	3	1	236	4	0	244
14244	0	0	228	3	0	231
14245	1	0	238	2	0	241
14246	229	0	6	1	0	236
14247	5	1	1	229	0	236
14248	3	0	1	234	0	238
14249	1	0	0	238	0	239
14250	1	0	236	6	0	243
14251	3	1	5	226	0	235
14252	2	0	2	238	0	242
14253	232	0	2	7	0	241
14254	231	0	0	3	0	234
14255	229	0	1	4	0	234
14256	225	1	1	4	0	231
14257	5	0	2	227	0	234
14258	227	0	0	7	0	234
14259	7	0	1	225	0	233
14260	2	1	213	7	0	223
14261	212	1	2	6	0	221
14262	6	221	3	0	0	230
14263	5	3	0	217	0	225
14264	1	2	1	220	0	224
14265	7	215	1	5	0	228
14266	215	7	0	5	0	227
14267	7	211	2	2	0	222
14268	6	3	207	4	0	220
14269	4	4	211	3	0	222
14270	208	1	6	3	0	218
14271	216	1	3	3	0	223
14272	6	4	202	2	0	214
14273	202	2	4	2	0	210
14274	6	5	198	2	0	211
14275	194	2	6	6	0	208
14276	7	3	194	3	0	207
14277	4	4	192	2	0	202
14278	10	2	4	177	0	193
14279	6	2	3	184	0	195
14280	187	3	1	11	0	202
14281	184	4	5	4	0	197
14282	186	1	2	5	0	194
14283	191	2	4	4	0	201
14284	11	180	2	4	0	197
14285	8	4	2	174	0	188
14286	6	178	4	6	0	194
14287	5	6	5	184	0	200
14288	6	2	3	184	0	195
14289	8	2	3	179	0	192
14290	6	2	171	10	0	189
14291	166	1	7	7	0	181
14292	13	161	3	5	0	182
14293	3	163	3	8	0	177
14294	4	7	172	8	0	191
14295	6	5	5	165	0	181
14296	7	2	4	167	0	180
14297	168	0	3	13	0	184
14298	14	2	1	167	0	184
14299	4	3	6	171	0	184
14300	11	0	3	169	0	183
14301	7	2	2	178	0	189
14302	168	1	4	11	0	184
14303	173	0	2	10	0	185
14304	176	2	1	4	0	183
14305	6	2	3	170	0	181
14306	167	2	3	12	0	184
14307	9	1	3	175	0	188
14308	9	2	2	179	0	192
14309	4	3	171	11	0	189
14310	7	0	164	6	0	177
14311	2	3	159	4	0	168
14312	153	0	7	6	0	166
14313	13	1	2	142	0	158
14314	5	146	4	8	0	163
14315	151	5	3	4	0	163
14316	8	1	145	5	0	159
14317	140	3	9	1	0	153
14318	8	134	5	2	0	149
14319	120	5	1	2	0	128
14320	8	5	2	113	0	128
14321	116	0	1	6	0	123
14322	7	108	2	3	0	120
14323	5	110	1	3	0	119
14324	95	4	3	2	0	104
14325	7	97	0	2	0	106
14326	0	64	0	3	0	67
14327	4	66	0	1	0	71
14328	60	2	1	2	0	65
14329	61	2	0	1	0	64
14330	63	1	0	0	0	64
14331	2	3	0	62	0	67
14332	1	2	0	65	0	68
14333	1	3	61	1	0	66
14334	2	1	1	62	0	66
14335	2	1	61	2	0	66
14336	5	0	1	60	0	66
14337	1	0	1	66	0	68
14338	64	0	0	3	0	67
14339	63	0	2	1	0	66
14340	1	63	0	2	0	66
14341	0	2	3	62	0	67
14342	1	0	65	4	0	70
14343	0	0	3	70	0	73
14344	3	0	0	70	0	73
14345	1	1	0	71	0	73
14346	3	2	69	1	0	75
14347	1	0	66	4	0	71
14348	64	1	2	1	0	68
14349	1	1	1	73	0	76
14350	0	1	75	3	0	79
14351	71	0	2	3	0	76
14352	1	73	1	1	0	76
14353	72	2	2	2	0	78
14354	3	2	71	0	0	76
14355	75	0	2	1	0	78
14356	3	0	3	74	0	80
14357	3	0	79	2	0	84
14358	0	84	2	1	0	87
14359	82	1	0	2	0	85
14360	1	2	2	84	0	89
14361	5	0	0	82	0	87
14362	0	86	2	4	0	92
14363	3	2	3	82	0	90
14364	1	3	82	3	0	89
14365	4	86	2	0	0	92
14366	88	2	0	3	0	93
14367	4	2	0	85	0	91
14368	2	1	0	87	0	90
14369	2	1	84	3	0	90
14370	1	1	4	81	0	87
14371	1	3	91	4	0	99
14372	2	93	3	2	0	100
14373	96	3	2	1	0	102
14374	96	0	0	4	0	100
14375	97	0	3	1	0	101
14376	2	105	0	5	0	112
14377	0	2	4	108	0	114
14378	4	1	1	105	0	111
14379	2	1	2	102	0	107
14380	107	3	0	4	0	114
14381	106	1	2	2	0	111
14382	4	2	1	102	0	109
14383	1	0	129	6	0	136
14384	2	1	1	132	0	136
14385	1	1	0	134	0	136
14386	3	1	1	129	0	134
14387	2	0	2	132	0	136
14388	128	0	1	5	0	134
14389	2	0	3	127	0	132
14390	0	0	1	131	0	132
14391	0	129	1	5	0	135
14392	1	2	1	136	0	140
14393	2	138	0	4	0	144
14394	3	2	1	141	0	147
14395	139	0	0	7	0	146
14396	2	138	3	2	0	145
14397	137	2	1	3	0	143
14398	1	1	136	1	0	139
14399	3	3	1	143	0	150
14400	0	0	149	5	0	154
14401	3	1	3	144	0	151
14402	1	2	0	147	0	150
14403	2	148	1	4	0	155
14404	0	149	2	0	0	151
14405	2	154	0	0	0	156
14406	150	3	2	1	0	156
14407	1	149	0	2	0	152
14408	0	144	0	1	0	145
14409	0	3	0	149	0	152
14410	149	0	0	2	0	151
14411	1	158	0	0	0	159
14412	163	1	0	2	0	166
14413	156	1	0	0	0	157
14414	1	1	165	0	0	167
14415	0	1	1	150	0	152
14416	2	0	0	162	0	164
14417	1	1	0	165	0	167
14418	1	0	0	166	0	167
14419	1	1	155	1	0	158
14420	0	0	141	0	0	141
14421	145	0	0	1	0	146
14422	1	158	0	0	0	159
14423	0	164	0	0	0	164
14424	162	1	0	2	0	165
14425	1	161	0	0	0	162
14426	0	1	0	163	0	164
14427	161	0	0	2	0	163
14428	1	0	164	0	0	165
14429	0	0	1	164	0	165
14430	0	0	166	1	0	167
14431	155	0	1	1	0	157
14432	1	1	182	0	0	184
14433	185	0	1	0	0	186
14434	196	0	1	0	0	197
14435	198	0	0	2	0	200
14436	194	0	0	2	0	196
14437	197	0	0	0	0	197
14438	2	0	0	196	0	198
14439	204	0	0	4	0	208
14440	1	0	0	210	0	211
14441	1	0	0	208	0	209
14442	1	0	0	208	0	209
14443	0	0	207	2	0	209
14444	0	0	1	206	0	207
14445	0	0	1	210	0	211
14446	0	0	205	2	0	207
14447	183	0	1	2	0	186
14448	1	0	2	202	0	205
14449	1	0	205	1	0	207
14450	0	0	203	1	0	204
14451	0	0	2	202	0	204
14452	0	0	215	1	0	216
14453	0	0	1	219	0	220
14454	1	0	1	214	0	216
14455	0	217	0	2	0	219
14456	0	217	0	1	0	218
14457	216	1	0	0	0	217
14458	1	0	0	216	0	217
14459	1	0	0	209	0	210
14460	0	0	0	218	0	218
14461	0	0	222	2	0	224
14462	0	0	1	217	0	218
14463	214	0	1	3	0	218
14464	1	0	224	1	0	226
14465	1	0	1	229	0	231
14466	0	0	1	229	0	230
14467	0	0	0	232	0	232
14468	0	255	0	2	0	257
14469	251	3	0	4	0	258
14470	259	2	0	1	0	262
14471	5	283	0	0	0	288
14472	2	2	0	302	0	306
14473	1	1	297	3	0	302
14474	0	0	278	3	0	281
14475	289	0	7	7	0	303
14476	6	0	3	296	0	305
14477	311	0	0	7	0	318
14478	6	311	0	3	0	320
14479	3	318	0	0	0	321
14480	308	10	0	1	0	319
14481	7	330	0	0	0	337
14482	3	7	0	328	0	338
14483	1	4	0	314	0	319
14484	2	326	0	10	0	338
14485	327	7	0	7	0	341
14486	7	3	336	0	0	346
14487	323	0	8	4	0	335
14488	7	0	340	0	0	347
14489	308	0	7	2	0	317
14490	8	0	345	0	0	353
14491	4	338	6	1	0	349
14492	1	7	2	345	0	355
14493	339	5	0	10	0	354
14494	8	1	341	3	0	353
14495	6	0	339	0	0	345
14496	2	2	11	327	0	342
14497	0	0	346	8	0	354
14498	2	2	6	332	0	342
14499	2	1	3	325	0	331
14500	1	0	338	9	0	348
14501	3	0	7	329	0	339
14502	338	0	5	9	0	352
14503	6	340	1	4	0	351
14504	348	6	1	7	0	362
14505	7	6	0	344	0	357
14506	348	1	1	9	0	359
14507	359	0	0	5	0	364
14508	12	0	1	361	0	374
14509	4	378	1	6	0	389
14510	378	6	1	5	0	390
14511	6	3	384	1	0	394
14512	5	0	377	1	0	383
14513	371	0	10	2	0	383
14514	7	0	4	379	0	390
14515	5	0	392	7	0	404
14516	2	2	5	394	0	403
14517	391	1	5	11	0	408
14518	414	1	0	5	0	420
14519	412	1	0	5	0	418
14520	11	437	0	2	0	450
14521	7	6	0	444	0	457
14522	3	5	0	449	0	457
14523	438	1	0	13	0	452
14524	6	439	2	4	0	451
14525	441	6	1	1	0	449
14526	5	3	3	439	0	450
14527	438	0	1	9	0	448
14528	7	1	428	5	0	441
14529	4	421	9	1	0	435
14530	3	7	4	417	0	431
14531	2	438	2	8	0	450
14532	2	6	1	422	0	431
14533	415	3	1	8	0	427
14534	7	3	405	4	0	419
14535	390	1	7	3	0	401
14536	5	433	5	4	0	447
14537	6	6	0	432	0	444
14538	1	4	3	444	0	452
14539	434	1	0	12	0	447
14540	8	0	441	4	0	453
14541	6	3	6	445	0	460
14542	3	2	3	449	0	457
14543	4	1	1	447	0	453
14544	2	1	2	453	0	458
14545	445	1	2	12	0	460
14546	430	1	0	11	0	442
14547	9	2	434	1	0	446
14548	5	0	429	2	0	436
14549	434	0	9	5	0	448
14550	457	1	5	6	0	469
14551	9	1	0	458	0	468
14552	5	0	0	455	0	460
14553	445	2	1	12	0	460
14554	7	451	2	5	0	465
14555	6	6	1	454	0	467
14556	4	3	0	464	0	471
14557	3	0	451	10	0	464
14558	2	1	6	450	0	459
14559	1	2	451	8	0	462
14560	6	0	5	445	0	456
14561	439	0	6	10	0	455
14562	6	1	1	441	0	449
14563	7	0	444	6	0	457
14564	2	433	6	6	0	447
14565	5	7	5	435	0	452
14566	0	4	446	10	0	460
14567	2	436	7	2	0	447
14568	4	7	2	424	0	437
14569	2	3	416	7	0	428
14570	343	3	4	7	0	357
14571	5	389	3	4	0	401
14572	1	383	1	3	0	388
14573	1	375	1	3	0	380
14574	1	8	3	363	0	375
14575	2	0	377	3	0	382
14576	0	379	4	4	0	387
14577	2	3	2	363	0	370
14578	374	2	1	8	0	385
14579	6	3	1	466	0	476
14580	0	1	529	9	0	539
14581	2	532	12	1	0	547
14582	508	12	1	6	0	527
14583	13	525	3	0	0	541
14584	3	14	501	2	0	520
14585	2	506	18	4	0	530
14586	4	20	3	495	0	522
14587	6	4	496	13	0	519
14588	4	492	13	1	0	510
14589	4	16	7	473	0	500
14590	3	10	6	486	0	505
14591	0	481	2	18	0	501
14592	3	16	7	484	0	510
14593	1	9	479	16	0	505
14594	0	5	490	7	0	502
14595	2	5	13	485	0	505
14596	472	7	2	18	0	499
14597	476	4	2	11	0	493
14598	17	3	7	455	0	482
14599	4	459	10	15	0	488
14600	5	14	8	462	0	489
14601	456	4	3	15	0	478
14602	25	1	1	445	0	472
14603	10	2	1	466	0	479
14604	441	6	2	18	0	467
14605	14	446	2	12	0	474
14606	6	15	0	442	0	463
14607	436	2	2	24	0	464
14608	14	3	420	14	0	451
14609	412	2	12	8	0	434
14610	18	8	2	414	0	442
14611	416	4	3	21	0	444
14612	427	3	2	9	0	441
14613	405	4	8	8	0	425
14614	25	414	4	4	0	447
14615	9	15	412	8	0	444
14616	11	421	14	6	0	452
14617	426	15	2	7	0	450
14618	22	424	4	4	0	454
14619	12	18	2	415	0	447
14620	400	5	7	17	0	429
14621	15	413	4	4	0	436
14622	9	19	408	5	0	441
14623	10	14	14	397	0	435
14624	7	8	398	20	0	433
14625	8	408	17	8	0	441
14626	5	23	5	395	0	428
14627	8	5	9	411	0	433
14628	6	7	6	419	0	438
14629	7	1	11	395	0	414
14630	3	404	6	20	0	433
14631	388	21	3	16	0	428
14632	15	7	389	16	0	427
14633	5	4	16	399	0	424
14634	381	2	4	31	0	418
14635	16	9	391	14	0	430
14636	10	377	13	9	0	409
14637	14	18	9	373	0	414
14638	9	7	384	20	0	420
14639	8	384	16	9	0	417
14640	362	18	12	10	0	402
14641	18	374	6	4	0	402
14642	8	19	8	372	0	407
14643	5	8	7	390	0	410
14644	365	10	4	27	0	406
14645	22	374	5	8	0	409
14646	13	27	4	367	0	411
14647	358	10	4	30	0	402
14648	369	8	6	19	0	402
14649	23	362	3	11	0	399
14650	366	23	4	7	0	400
14651	369	10	4	12	0	395
14652	28	6	3	359	0	396
14653	18	4	352	22	0	396
14654	18	13	14	342	0	387
14655	16	8	4	359	0	387
14656	13	8	345	23	0	389
14657	11	337	17	11	0	376
14658	12	15	8	345	0	380
14659	8	8	7	364	0	387
14660	10	4	6	369	0	389
14661	10	4	7	349	0	370
14662	8	338	9	22	0	377
14663	344	25	7	13	0	389
14664	350	5	4	20	0	379
14665	341	6	3	17	0	367
14666	19	319	4	19	0	361
14667	13	21	2	327	0	363
14668	11	8	319	23	0	361
14669	19	10	11	306	0	346
14670	19	316	1	15	0	351
14671	310	22	4	8	0	344
14672	312	11	3	13	0	339
14673	305	6	10	7	0	328
14674	17	288	6	11	0	322
14675	8	270	4	11	0	293
14676	9	275	2	7	0	293
14677	12	15	271	4	0	302
14678	16	10	248	4	0	278
14679	9	35	10	86	0	140
14680	51	0	3	4	0	58
14681	52	0	0	0	0	52
14682	2	1	1	51	0	55
14683	1	0	0	52	0	53
14684	1	0	0	52	0	53
14685	0	0	0	55	0	55
14686	50	0	1	3	0	54
14687	57	0	0	2	0	59
14688	3	57	0	1	0	61
14689	54	3	1	2	0	60
14690	61	1	0	0	0	62
14691	63	0	0	2	0	65
14692	3	0	51	1	0	55
14693	56	0	3	1	0	60
14694	3	58	1	0	0	62
14695	0	3	0	59	0	62
14696	1	0	0	60	0	61
14697	1	57	0	3	0	61
14698	1	3	0	61	0	65
14699	59	1	0	5	0	65
14700	3	0	0	64	0	67
14701	0	0	62	3	0	65
14702	61	0	3	1	0	65
14703	3	63	0	0	0	66
14704	1	3	0	62	0	66
14705	1	0	0	64	0	65
14706	1	0	0	64	0	65
14707	0	0	62	3	0	65
14708	0	60	3	0	0	63
14709	0	4	0	64	0	68
14710	0	0	63	3	0	66
14711	1	0	4	62	0	67
14712	0	0	61	4	0	65
14713	1	0	3	60	0	64
14714	1	58	0	3	0	62
14715	0	3	0	61	0	64
14716	58	0	0	4	0	62
14717	58	0	0	2	0	60
14718	2	0	59	1	0	62
14719	0	1	55	0	0	56
14720	0	0	66	0	0	66
14721	0	0	3	66	0	69
14722	0	0	0	70	0	70
14723	2	0	0	67	0	69
14724	1	65	0	2	0	68
14725	1	2	0	63	0	66
14726	0	0	0	68	0	68
14727	1	0	0	68	0	69
14728	68	0	0	3	0	71
14729	67	0	0	1	0	68
14730	2	0	69	1	0	72
14731	0	1	68	0	0	69
14732	66	0	2	0	0	68
14733	68	0	0	1	0	69
14734	4	0	73	0	0	77
14735	0	0	71	0	0	71
14736	71	0	3	0	0	74
14737	72	1	0	1	0	74
14738	3	0	72	1	0	76
14739	0	0	4	71	0	75
14740	1	1	0	73	0	75
14741	0	75	0	4	0	79
14742	1	3	0	78	0	82
14743	0	1	83	3	0	87
14744	0	0	4	83	0	87
14745	1	0	0	83	0	84
14746	1	1	79	3	0	84
14747	77	0	3	3	0	83
14748	85	0	0	1	0	86
14749	3	0	1	81	0	85
14750	0	0	2	83	0	85
14751	80	1	0	3	0	84
14752	84	0	0	1	0	85
14753	80	0	2	0	0	82
14754	84	0	1	1	0	86
14755	4	78	1	0	0	83
14756	80	3	0	0	0	83
14757	3	77	1	0	0	81
14758	0	3	0	83	0	86
14759	3	0	0	80	0	83
14760	0	79	0	2	0	81
14761	0	3	1	82	0	86
14762	0	0	1	80	0	81
14763	0	81	0	5	0	86
14764	0	4	0	79	0	83
14765	0	0	1	85	0	86
14766	1	0	1	83	0	85
14767	1	0	82	4	0	87
14768	0	80	3	2	0	85
14769	0	2	1	74	0	77
14770	2	82	0	3	0	87
14771	83	2	0	0	0	85
14772	3	0	80	1	0	84
14773	1	0	82	1	0	84
14774	77	1	1	0	0	79
14775	5	0	1	77	0	83
14776	0	1	77	1	0	79
14777	1	0	75	1	0	77
14778	0	2	1	76	0	79
14779	75	1	0	1	0	77
14780	73	1	0	1	0	75
14781	1	0	0	78	0	79
14782	0	2	70	2	0	74
14783	0	78	1	1	0	80
14784	0	1	0	79	0	80
14785	0	0	77	2	0	79
14786	0	70	2	0	0	72
14787	0	2	0	74	0	76
14788	71	0	0	3	0	74
14789	1	1	0	68	0	70
14790	1	71	1	1	0	74
14791	71	2	1	0	0	74
14792	1	0	80	0	0	81
14793	1	78	1	0	0	80
14794	1	1	75	1	0	78
14795	70	0	3	2	0	75
14796	0	0	1	74	0	75
14797	3	0	0	78	0	81
14798	80	0	0	2	0	82
14799	2	0	1	78	0	81
14800	0	0	77	1	0	78
14801	72	0	2	1	0	75
14802	2	79	1	0	0	82
14803	2	1	0	79	0	82
14804	79	0	1	2	0	82
14805	0	82	3	0	0	85
14806	0	2	0	84	0	86
14807	84	0	0	3	0	87
14808	1	1	1	82	0	85
14809	0	84	0	2	0	86
14810	1	0	82	1	0	84
14811	2	1	1	81	0	85
14812	1	1	0	83	0	85
14813	84	1	2	2	0	89
14814	5	0	0	85	0	90
14815	87	0	1	2	0	90
14816	84	0	0	3	0	87
14817	1	0	1	81	0	83
14818	2	84	0	2	0	88
14819	1	1	0	86	0	88
14820	84	0	0	2	0	86
14821	3	82	0	0	0	85
14822	0	88	0	1	0	89
14823	89	1	1	0	0	91
14824	86	1	0	0	0	87
14825	3	88	0	1	0	92
14826	90	1	0	0	0	91
14827	91	2	0	1	0	94
14828	1	0	0	89	0	90
14829	1	0	91	3	0	95
14830	1	1	0	95	0	97
14831	0	0	98	1	0	99
14832	1	1	0	100	0	102
14833	0	0	99	1	0	100
14834	90	1	0	3	0	94
14835	0	0	1	99	0	100
14836	100	0	0	0	0	100
14837	1	1	0	95	0	97
14838	2	94	0	0	0	96
14839	98	0	0	3	0	101
14840	0	0	94	0	0	94
14841	81	0	1	1	0	83
14842	1	88	1	0	0	90
14843	82	1	0	0	0	83
14844	83	1	0	1	0	85
14845	2	80	0	0	0	82
14846	3	1	0	82	0	86
14847	85	1	0	2	0	88
14848	1	86	0	2	0	89
14849	1	0	1	84	0	86
14850	84	1	0	2	0	87
14851	1	0	1	84	0	86
14852	2	0	0	83	0	85
14853	0	0	1	82	0	83
14854	1	0	81	2	0	84
14855	1	0	1	83	0	85
14856	83	0	1	1	0	85
14857	1	0	82	2	0	85
14858	1	1	1	82	0	85
14859	1	0	1	82	0	84
14860	0	0	81	2	0	83
14861	78	0	1	3	0	82
14862	80	1	1	0	0	82
14863	3	0	81	0	0	84
14864	2	0	1	81	0	84
14865	1	1	1	84	0	87
14866	0	0	83	2	0	85
14867	2	0	1	85	0	88
14868	1	1	1	83	0	86
14869	0	0	91	3	0	94
14870	89	0	2	1	0	92
14871	2	0	1	94	0	97
14872	90	0	0	2	0	92
14873	92	0	0	1	0	93
14874	3	0	93	0	0	96
14875	3	0	2	87	0	92
14876	92	0	1	2	0	95
14877	2	94	0	1	0	97
14878	2	1	0	98	0	101
14879	0	1	0	98	0	99
14880	0	0	1	99	0	100
14881	1	0	94	3	0	98
14882	86	0	2	2	0	90
14883	2	0	2	92	0	96
14884	1	0	0	96	0	97
14885	0	0	94	4	0	98
14886	0	0	3	94	0	97
14887	0	0	1	98	0	99
14888	93	0	0	5	0	98
14889	1	93	1	1	0	96
14890	2	2	92	0	0	96
14891	87	1	2	3	0	93
14892	3	0	1	87	0	91
14893	2	0	94	2	0	98
14894	0	0	95	1	0	96
14895	0	0	3	97	0	100
14896	1	0	99	2	0	102
14897	0	1	91	1	0	93
14898	0	95	4	1	0	100
14899	0	2	1	106	0	109
14900	0	1	105	3	0	109
14901	2	0	3	97	0	102
14902	112	0	1	2	0	115
14903	2	0	0	111	0	113
14904	1	0	0	113	0	114
14905	109	0	1	3	0	113
14906	107	0	0	2	0	109
14907	3	0	0	120	0	123
14908	2	0	123	2	0	127
14909	0	119	1	1	0	121
14910	0	2	2	124	0	128
14911	121	1	1	4	0	127
14912	123	0	0	5	0	128
14913	3	123	0	1	0	127
14914	1	126	2	0	0	129
14915	126	3	0	2	0	131
14916	127	1	1	1	0	130
14917	4	0	129	0	0	133
14918	2	1	2	128	0	133
14919	0	134	2	3	0	139
14920	131	3	0	2	0	136
14921	3	1	0	134	0	138
14922	1	135	0	3	0	139
14923	0	3	138	2	0	143
14924	0	1	3	134	0	138
14925	2	137	0	3	0	142
14926	143	3	1	1	0	148
14927	143	0	0	0	0	143
14928	3	141	1	1	0	146
14929	138	3	0	1	0	142
14930	140	0	1	0	0	141
14931	3	136	0	2	0	141
14932	0	141	0	1	0	142
14933	2	3	0	141	0	146
14934	146	1	0	3	0	150
14935	3	0	156	0	0	159
14936	155	0	3	0	0	158
14937	3	161	1	1	0	166
14938	157	3	1	1	0	162
14939	163	0	1	0	0	164
14940	166	0	0	1	0	167
14941	2	0	1	158	0	161
14942	0	163	1	2	0	166
14943	162	3	1	1	0	167
14944	2	0	172	1	0	175
14945	0	173	3	0	0	176
14946	1	2	0	183	0	186
14947	1	0	175	2	0	178
14948	0	0	171	1	0	172
14949	0	0	2	174	0	176
14950	1	1	2	180	0	184
14951	1	0	0	180	0	181
14952	0	0	0	174	0	174
14953	0	171	1	2	0	174
14954	0	181	0	0	0	181
14955	177	2	0	0	0	179
14956	4	0	0	177	0	181
14957	2	0	0	179	0	181
14958	0	1	0	184	0	185
14959	180	1	0	3	0	184
14960	178	0	0	0	0	178
14961	4	0	0	172	0	176
14962	179	0	1	4	0	184
14963	183	0	0	1	0	184
14964	181	1	0	2	0	184
14965	4	0	0	181	0	185
14966	0	0	173	3	0	176
14967	1	0	159	0	0	160
14968	0	1	170	0	0	171
14969	0	0	170	0	0	170
14970	0	1	2	166	0	169
14971	168	0	0	3	0	171
14972	169	0	0	0	0	169
14973	2	0	169	0	0	171
14974	0	0	164	0	0	164
14975	0	192	2	0	0	194
14976	0	2	0	198	0	200
14977	195	0	1	4	0	200
14978	2	1	198	0	0	201
14979	189	0	1	2	0	192
14980	2	218	0	0	0	220
14981	0	2	0	229	0	231
14982	0	0	0	230	0	230
14983	0	0	0	229	0	229
14984	230	0	0	5	0	235
14985	4	0	0	234	0	238
14986	0	0	0	233	0	233
14987	227	0	0	7	0	234
14988	4	0	0	226	0	230
14989	0	0	237	4	0	241
14990	232	0	5	0	0	237
14991	4	0	0	235	0	239
14992	0	0	0	230	0	230
14993	0	234	0	5	0	239
14994	235	4	0	2	0	241
14995	245	2	0	0	0	247
14996	4	1	0	237	0	242
14997	2	0	235	4	0	241
14998	208	1	5	1	0	215
14999	4	0	243	1	0	248
15000	0	0	4	236	0	240
15001	3	0	0	244	0	247
15002	242	0	0	5	0	247
15003	4	1	0	248	0	253
15004	1	0	247	4	0	252
15005	228	0	4	1	0	233
15006	5	0	249	0	0	254
15007	1	2	239	1	0	243
15008	249	0	6	4	0	259
15009	8	0	1	270	0	279
15010	0	284	1	5	0	290
15011	285	5	1	3	0	294
15012	284	0	2	3	0	289
15013	6	0	285	0	0	291
15014	274	0	6	1	0	281
15015	5	0	1	283	0	289
15016	0	1	287	5	0	293
15017	1	279	5	1	0	286
15018	280	3	1	3	0	287
15019	5	286	1	0	0	292
15020	1	4	2	293	0	300
15021	1	0	0	290	0	291
15022	0	1	1	293	0	295
15023	0	1	0	280	0	281
15024	0	282	0	5	0	287
15025	0	4	284	1	0	289
15026	1	277	4	3	0	285
15027	285	4	0	3	0	292
15028	5	0	0	285	0	290
15029	287	0	1	6	0	294
15030	3	2	0	294	0	299
15031	304	0	2	7	0	313
15032	4	310	0	3	0	317
15033	317	4	0	2	0	323
15034	317	0	0	5	0	322
15035	305	0	0	3	0	308
15036	312	1	0	4	0	317
15037	8	314	0	0	0	322
15038	1	5	311	2	0	319
15039	6	1	5	308	0	320
15040	314	0	0	7	0	321
15041	314	1	2	3	0	320
15042	5	1	1	311	0	318
15043	2	1	324	7	0	334
15044	5	0	6	310	0	321
15045	4	326	1	8	0	339
15046	325	6	2	5	0	338
15047	8	2	1	328	0	339
15048	4	331	1	6	0	342
15049	1	356	1	2	0	360
15050	1	355	1	2	0	359
15051	2	8	0	351	0	361
15052	348	1	0	11	0	360
15053	6	349	2	2	0	359
15054	4	8	0	354	0	366
15055	350	2	1	8	0	361
15056	7	2	1	351	0	361
15057	351	1	0	9	0	361
15058	346	0	0	4	0	350
15059	6	374	0	2	0	382
15060	2	5	0	364	0	371
15061	4	374	0	3	0	381
15062	367	4	2	2	0	375
15063	378	2	0	2	0	382
15064	384	0	0	1	0	385
15065	6	2	1	387	0	396
15066	3	1	380	6	0	390
15067	361	0	5	4	0	370
15068	380	1	1	2	0	384
15069	8	1	0	371	0	380
15070	3	384	2	6	0	395
15071	3	5	0	391	0	399
15072	3	1	1	390	0	395
15073	387	1	0	5	0	393
15074	383	3	1	3	0	390
15075	6	1	365	2	0	374
15076	7	0	5	361	0	373
15077	375	0	1	7	0	383
15078	11	0	0	376	0	387
15079	2	0	379	9	0	390
15080	1	348	7	2	0	358
15081	1	372	3	1	0	377
15082	395	8	0	2	0	405
15083	11	1	2	416	0	430
15084	2	1	0	446	0	449
15085	432	2	1	15	0	450
15086	14	0	426	7	0	447
15087	5	3	13	430	0	451
15088	4	1	439	13	0	457
15089	2	429	15	6	0	452
15090	443	14	4	9	0	470
15091	454	5	2	4	0	465
15092	458	3	3	1	0	465
15093	21	1	438	4	0	464
15094	433	1	15	2	0	451
15095	449	2	4	6	0	461
15096	25	1	3	441	0	470
15097	422	0	1	18	0	441
15098	15	2	437	4	0	458
15099	408	1	15	5	0	429
15100	20	2	420	1	0	443
15101	10	439	15	0	0	464
15102	7	14	4	425	0	450
15103	6	444	3	10	0	463
15104	2	15	435	5	0	457
15105	3	438	15	4	0	460
15106	417	13	7	7	0	444
15107	16	407	2	0	0	425
15108	5	405	2	4	0	416
15109	5	22	377	0	0	404
15110	5	6	15	371	0	397
15111	375	5	6	18	0	404
15112	17	1	374	6	0	398
15113	8	374	12	2	0	396
15114	2	13	7	376	0	398
15115	2	7	376	13	0	398
15116	3	3	375	6	0	387
15117	4	3	15	367	0	389
15118	4	1	387	10	0	402
15119	4	5	16	353	0	378
15120	1	358	7	15	0	381
15121	5	13	6	365	0	389
15122	2	379	5	15	0	401
15123	7	14	1	379	0	401
15124	371	6	2	16	0	395
15125	13	4	1	374	0	392
15126	4	373	3	16	0	396
15127	8	11	2	388	0	409
15128	2	5	384	15	0	406
15129	2	3	13	376	0	394
15130	373	1	7	17	0	398
15131	14	2	363	8	0	387
15132	7	3	15	353	0	378
15133	354	1	7	15	0	377
15134	15	344	5	5	0	369
15135	9	15	0	351	0	375
15136	356	8	1	13	0	378
15137	15	2	5	349	0	371
15138	7	3	341	17	0	368
15139	339	0	15	9	0	363
15140	14	337	8	4	0	363
15141	7	351	3	5	0	366
15142	337	15	2	9	0	363
15143	341	6	6	4	0	357
15144	16	7	1	329	0	353
15145	329	2	1	15	0	347
15146	16	5	328	5	0	354
15147	310	3	11	11	0	335
15148	16	319	7	4	0	346
15149	325	10	4	6	0	345
15150	14	6	346	5	0	371
15151	9	4	11	331	0	355
15152	10	2	8	334	0	354
15153	3	7	3	332	0	345
15154	5	330	2	16	0	353
15155	335	12	2	9	0	358
15156	16	4	5	325	0	350
15157	12	334	4	9	0	359
15158	358	12	2	8	0	380
15159	353	8	3	3	0	367
15160	366	4	1	8	0	379
15161	358	1	3	6	0	368
15162	357	1	5	5	0	368
15163	23	1	2	339	0	365
15164	12	1	7	345	0	365
15165	340	3	1	18	0	362
15166	16	3	3	335	0	357
15167	10	6	1	346	0	363
15168	5	3	334	17	0	359
15169	325	7	10	9	0	351
15170	342	1	5	7	0	355
15171	340	5	3	7	0	355
15172	21	4	1	320	0	346
15173	9	331	2	12	0	354
15174	348	9	4	9	0	370
15175	351	4	1	6	0	362
15176	22	4	1	354	0	381
15177	372	1	4	12	0	389
15178	19	5	317	13	0	354
15179	9	346	9	6	0	370
15180	6	376	7	3	0	392
15181	11	20	368	5	0	404
15182	4	318	13	3	0	338
15183	4	291	7	2	0	304
15184	263	5	0	2	0	270
15185	5	260	1	0	0	266
15186	4	5	0	265	0	274
15187	272	3	0	5	0	280
15188	6	1	266	3	0	276
15189	250	1	7	2	0	260
15190	6	1	259	1	0	267
15191	3	1	250	2	0	256
15192	262	1	8	1	0	272
15193	5	2	272	0	0	279
15194	3	264	5	1	0	273
15195	1	6	3	264	0	274
15196	263	2	1	8	0	274
15197	7	257	0	3	0	267
15198	3	5	2	260	0	270
15199	1	3	263	5	0	272
15200	2	0	6	257	0	265
15201	250	0	5	9	0	264
15202	8	1	250	3	0	262
15203	4	0	8	242	0	254
15204	247	1	3	8	0	259
15205	253	1	0	7	0	261
15206	12	0	0	252	0	264
15207	3	0	1	257	0	261
15208	0	0	260	12	0	272
15209	1	0	253	3	0	257
15210	249	0	11	2	0	262
15211	267	0	3	1	0	271
15212	11	264	1	0	0	276
15213	264	7	0	1	0	272
15214	274	3	0	0	0	277
15215	10	0	286	1	0	297
15216	5	294	8	0	0	307
15217	299	6	2	4	0	311
15218	308	3	1	1	0	313
15219	314	0	1	1	0	316
15220	12	0	0	300	0	312
15221	7	0	0	298	0	305
15222	1	291	1	9	0	302
15223	2	7	1	300	0	310
15224	298	5	0	8	0	311
15225	10	0	1	292	0	303
15226	5	1	290	7	0	303
15227	2	1	292	4	0	299
15228	2	0	11	286	0	299
15229	2	0	289	8	0	299
15230	1	1	280	5	0	287
15231	2	0	11	270	0	283
15232	2	1	5	290	0	298
15233	1	0	287	13	0	301
15234	1	0	284	4	0	289
15235	0	288	13	1	0	302
15236	287	7	4	3	0	301
15237	6	296	5	0	0	307
15238	297	8	1	1	0	307
15239	301	4	1	4	0	310
15240	12	296	1	1	0	310
15241	301	9	1	2	0	313
15242	9	4	0	297	0	310
15243	4	1	308	8	0	321
15244	0	0	9	306	0	315
15245	1	3	4	317	0	325
15246	296	0	0	14	0	310
15247	305	1	0	5	0	311
15248	308	0	0	1	0	309
15249	306	0	0	3	0	309
15250	292	1	0	2	0	295
15251	13	275	2	1	0	291
15252	4	7	1	281	0	293
15253	0	3	285	9	0	297
15254	4	0	8	285	0	297
15255	3	0	4	282	0	289
15256	2	1	0	297	0	300
15257	305	0	0	12	0	317
15258	12	0	0	304	0	316
15259	303	1	1	11	0	316
15260	10	1	320	5	0	336
15261	9	1	10	370	0	390
15262	1	0	383	14	0	398
15263	377	0	14	8	0	399
15264	14	0	4	378	0	396
15265	8	0	387	13	0	408
15266	0	0	14	393	0	407
15267	393	0	6	16	0	415
15268	13	1	402	8	0	424
15269	415	0	14	3	0	432
15270	428	0	7	1	0	436
15271	422	0	2	5	0	429
15272	404	0	1	2	0	407
15273	19	395	4	2	0	420
15274	8	382	1	1	0	392
15275	3	379	2	1	0	385
15276	3	14	2	324	0	343
15277	2	341	1	8	0	352
15278	335	8	0	6	0	349
15279	10	322	2	0	0	334
15280	2	340	1	0	0	343
15281	0	11	0	329	0	340
15282	2	3	0	338	0	343
15283	326	0	2	14	0	342
15284	13	1	1	334	0	349
15285	5	3	316	10	0	334
15286	2	2	308	3	0	315
15287	0	2	316	3	0	321
15288	4	0	8	315	0	327
15289	2	0	4	339	0	345
15290	2	0	320	12	0	334
15291	3	0	323	4	0	330
15292	1	0	328	2	0	331
15293	328	1	15	2	0	346
15294	9	0	6	334	0	349
15295	3	1	0	348	0	352
15296	342	1	2	15	0	360
15297	10	0	3	336	0	349
15298	4	347	2	9	0	362
15299	1	364	2	3	0	370
15300	6	9	0	360	0	375
15301	357	6	0	11	0	374
15302	359	0	2	6	0	367
15303	369	0	2	5	0	376
15304	10	3	0	362	0	375
15305	5	2	361	10	0	378
15306	6	1	8	356	0	371
15307	3	1	364	8	0	376
15308	345	1	11	5	0	362
15309	12	2	4	351	0	369
15310	350	0	2	14	0	366
15311	5	1	356	6	0	368
15312	335	0	10	4	0	349
15313	9	1	371	1	0	382
15314	6	347	10	0	0	363
15315	3	353	3	3	0	362
15316	346	9	0	3	0	358
15317	13	3	1	345	0	362
15318	2	1	349	10	0	362
15319	3	347	9	2	0	361
15320	1	354	4	0	0	359
15321	2	12	1	348	0	363
15322	350	5	0	12	0	367
15323	349	2	0	6	0	357
15324	12	349	2	1	0	364
15325	351	8	3	3	0	365
15326	13	6	2	351	0	372
15327	2	1	355	12	0	370
15328	1	355	11	6	0	373
15329	5	8	3	346	0	362
15330	2	3	2	357	0	364
15331	350	2	1	15	0	368
15332	10	1	343	5	0	359
15333	340	2	10	4	0	356
15334	344	1	6	2	0	353
15335	15	3	1	342	0	361
15336	4	1	2	353	0	360
15337	332	1	0	15	0	348
15338	13	1	2	336	0	352
15339	6	1	340	8	0	355
15340	3	1	337	5	0	346
15341	2	315	12	3	0	332
15342	3	339	2	2	0	346
15343	3	10	0	320	0	333
15344	5	324	0	9	0	338
15345	328	9	2	4	0	343
15346	10	336	3	2	0	351
15347	3	8	2	339	0	352
15348	4	7	2	344	0	357
15349	0	4	338	13	0	355
15350	7	2	8	338	0	355
15351	5	1	4	338	0	348
15352	3	345	1	13	0	362
15353	4	9	1	346	0	360
15354	5	4	0	356	0	365
15355	2	0	337	16	0	355
15356	3	329	13	5	0	350
15357	1	17	4	303	0	325
15358	1	317	0	9	0	327
15359	1	10	299	5	0	315
15360	1	282	10	1	0	294
15361	214	7	2	2	0	225
15362	201	2	1	7	0	211
15363	201	1	1	3	0	206
15364	6	203	0	1	0	210
15365	197	6	1	1	0	205
15366	6	1	1	196	0	204
15367	185	2	0	6	0	193
15368	8	178	0	1	0	187
15369	180	6	0	0	0	186
15370	183	1	0	3	0	187
15371	7	180	0	1	0	188
15372	2	6	180	0	0	188
15373	2	1	6	185	0	194
15374	1	1	194	7	0	203
15375	2	2	6	201	0	211
15376	3	0	2	215	0	220
15377	1	0	214	9	0	224
15378	0	1	8	214	0	223
15379	219	1	3	9	0	232
15380	8	0	214	4	0	226
15381	2	216	7	0	0	225
15382	2	7	3	204	0	216
15383	4	2	0	221	0	227
15384	1	1	219	10	0	231
15385	1	0	9	195	0	205
15386	0	215	2	9	0	226
15387	210	7	2	3	0	222
15388	7	213	0	2	0	222
15389	197	7	0	4	0	208
15390	6	198	1	2	0	207
15391	1	214	1	2	0	218
15392	3	8	197	1	0	209
15393	1	4	10	186	0	201
15394	3	1	2	195	0	201
15395	1	3	0	200	0	204
15396	1	200	1	10	0	212
15397	1	10	2	201	0	214
15398	199	3	0	10	0	212
15399	8	2	1	202	0	213
15400	199	1	0	9	0	209
15401	8	3	191	2	0	204
15402	194	0	8	4	0	206
15403	10	2	2	189	0	203
15404	2	1	0	200	0	203
15405	192	1	1	10	0	204
15406	8	0	190	4	0	202
15407	5	185	11	1	0	202
15408	1	6	2	196	0	205
15409	197	3	0	9	0	209
15410	203	0	1	3	0	207
15411	12	0	1	192	0	205
15412	2	3	195	8	0	208
15413	188	0	7	5	0	200
15414	10	0	192	0	0	202
15415	6	0	8	190	0	204
15416	0	1	191	10	0	202
15417	1	0	9	194	0	204
15418	4	0	190	7	0	201
15419	2	192	10	2	0	206
15420	3	8	2	177	0	190
15421	0	193	4	6	0	203
15422	191	6	0	4	0	201
15423	191	2	3	3	0	199
15424	7	2	186	2	0	197
15425	3	3	7	182	0	195
15426	186	0	2	8	0	196
15427	8	1	2	183	0	194
15428	6	1	0	192	0	199
15429	1	0	187	8	0	196
15430	177	1	6	8	0	192
15431	10	0	185	0	0	195
15432	6	1	7	186	0	200
15433	1	0	194	8	0	203
15434	185	1	7	4	0	197
15435	195	0	2	1	0	198
15436	200	0	2	1	0	203
15437	8	1	2	194	0	205
15438	2	1	194	6	0	203
15439	4	0	198	3	0	205
15440	1	0	10	179	0	190
15441	4	188	2	8	0	202
15442	190	5	2	3	0	200
15443	8	1	4	184	0	197
15444	3	1	187	5	0	196
15445	1	0	6	191	0	198
15446	0	2	191	8	0	201
15447	5	0	8	191	0	204
15448	1	0	197	10	0	208
15449	1	1	206	2	0	210
15450	1	198	5	4	0	208
15451	1	5	206	1	0	213
15452	1	2	201	3	0	207
15453	2	2	8	160	0	172
15454	1	2	3	176	0	182
15455	1	191	3	2	0	197
15456	182	3	2	5	0	192
15457	3	185	4	2	0	194
15458	1	4	1	187	0	193
15459	181	4	1	6	0	192
15460	2	3	1	189	0	195
15461	193	0	2	5	0	200
15462	5	1	3	186	0	195
15463	2	1	204	7	0	214
15464	5	1	6	198	0	210
15465	3	0	2	206	0	211
15466	205	1	1	6	0	213
15467	205	0	0	6	0	211
15468	202	0	1	4	0	207
15469	3	197	3	3	0	206
15470	3	191	2	2	0	198
15471	188	3	0	5	0	196
15472	3	4	195	0	0	202
15473	5	1	182	1	0	189
15474	4	11	2	160	0	177
15475	0	1	169	2	0	172
15476	4	0	156	1	0	161
15477	146	0	4	3	0	153
15478	145	0	2	3	0	150
15479	3	156	3	0	0	162
15480	2	159	2	1	0	164
15481	2	3	2	143	0	150
15482	1	157	1	1	0	160
15483	162	2	1	1	0	166
15484	1	2	0	155	0	158
15485	2	161	0	2	0	165
15486	165	2	0	4	0	171
15487	2	2	170	2	0	176
15488	2	2	158	1	0	163
15489	167	0	2	1	0	170
15490	2	1	168	0	0	171
15491	159	0	1	3	0	163
15492	5	0	4	163	0	172
15493	2	0	170	2	0	174
15494	2	162	3	1	0	168
15495	0	169	2	3	0	174
15496	156	1	1	0	0	158
15497	1	160	0	0	0	161
15498	154	1	0	1	0	156
15499	151	1	0	1	0	153
15500	1	152	0	1	0	154
15501	2	0	1	146	0	149
15502	1	1	156	0	0	158
15503	0	168	0	0	0	168
15504	1	2	1	159	0	163
15505	1	1	1	167	0	170
15506	168	0	0	4	0	172
15507	2	0	0	166	0	168
15508	1	0	165	3	0	169
15509	1	163	2	1	0	167
15510	0	2	1	162	0	165
15511	167	1	1	2	0	171
15512	166	1	0	1	0	168
15513	3	0	0	165	0	168
15514	174	0	0	2	0	176
15515	3	0	170	1	0	174
15516	2	0	2	170	0	174
15517	1	0	173	2	0	176
15518	0	0	3	188	0	191
15519	1	0	1	180	0	182
15520	1	0	1	183	0	185
15521	0	1	0	182	0	183
15522	1	1	0	181	0	183
15523	179	0	0	4	0	183
15524	181	0	0	2	0	183
15525	3	173	0	1	0	177
15526	179	2	0	1	0	182
15527	3	1	0	177	0	181
15528	1	1	0	175	0	177
15529	1	0	0	175	0	176
15530	0	0	176	3	0	179
15531	2	0	2	160	0	164
15532	0	170	1	4	0	175
15533	174	2	1	0	0	177
15534	168	2	0	4	0	174
15535	5	1	165	0	0	171
15536	3	164	3	0	0	170
15537	2	2	3	162	0	169
15538	0	2	169	2	0	173
15539	3	0	3	152	0	158
15540	1	168	2	3	0	174
15541	158	2	1	4	0	165
15542	4	165	1	1	0	171
15543	2	4	169	1	0	176
15544	1	4	165	1	0	171
15545	0	164	5	2	0	171
15546	0	166	2	2	0	170
15547	160	4	0	2	0	166
15548	163	2	0	3	0	168
15549	6	1	0	163	0	170
15550	3	0	158	3	0	164
15551	2	0	3	159	0	164
15552	2	1	3	162	0	168
15553	164	1	0	4	0	169
15554	158	0	1	4	0	163
15555	4	0	0	168	0	172
15556	2	0	171	6	0	179
15557	0	171	4	3	0	178
15558	170	3	1	1	0	175
15559	2	175	0	1	0	178
15560	7	3	0	174	0	184
15561	4	4	0	180	0	188
15562	3	1	1	182	0	187
15563	3	2	1	173	0	179
15564	167	2	0	7	0	176
15565	2	1	2	167	0	172
15566	2	163	2	6	0	173
15567	2	5	0	171	0	178
15568	167	3	0	3	0	173
15569	3	170	0	4	0	177
15570	5	3	3	169	0	180
15571	1	3	169	2	0	175
15572	162	3	3	4	0	172
15573	4	2	2	162	0	170
15574	5	1	158	2	0	166
15575	4	1	160	3	0	168
15576	4	1	4	158	0	167
15577	158	1	5	6	0	170
15578	158	0	2	6	0	166
15579	4	164	2	3	0	173
15580	165	2	0	3	0	170
15581	168	1	0	4	0	173
15582	166	1	0	4	0	171
15583	168	0	1	3	0	172
15584	5	1	1	165	0	172
15585	5	0	1	170	0	176
15586	3	2	165	3	0	173
15587	3	155	2	3	0	163
15588	1	156	1	4	0	162
15589	0	2	160	5	0	167
15590	157	1	2	5	0	165
15591	4	1	1	158	0	164
15592	161	0	2	4	0	167
15593	161	2	0	3	0	166
15594	4	2	160	3	0	169
15595	7	2	2	152	0	163
15596	158	1	1	3	0	163
15597	3	1	2	159	0	165
15598	2	2	156	4	0	164
15599	5	3	3	140	0	151
15600	1	154	3	7	0	165
15601	1	156	3	3	0	163
15602	3	4	157	1	0	165
15603	1	146	3	2	0	152
15604	135	3	2	2	0	142
15605	137	0	1	2	0	140
15606	4	2	0	125	0	131
15607	5	1	0	129	0	135
15608	3	1	0	136	0	140
15609	136	0	0	2	0	138
15610	2	134	0	1	0	137
15611	133	0	0	2	0	135
15612	131	1	0	2	0	134
15613	1	127	2	2	0	132
15614	115	1	0	2	0	118
15615	1	123	1	0	0	125
15616	122	1	1	1	0	125
15617	2	2	118	0	0	122
15618	99	1	1	2	0	103
15619	3	97	1	0	0	101
15620	1	0	3	103	0	107
15621	2	1	1	102	0	106
15622	3	1	0	104	0	108
15623	108	0	1	3	0	112
15624	1	0	0	112	0	113
15625	2	0	106	2	0	110
15626	107	0	1	3	0	111
15627	1	0	109	0	0	110
15628	3	1	2	109	0	115
15629	1	1	113	1	0	116
15630	1	1	1	109	0	112
15631	0	112	2	2	0	116
15632	0	1	1	106	0	108
15633	0	106	0	1	0	107
15634	1	2	0	110	0	113
15635	109	0	0	3	0	112
15636	1	1	0	115	0	117
15637	113	0	0	3	0	116
15638	3	0	108	0	0	111
15639	110	1	1	3	0	115
15640	117	0	0	0	0	117
15641	113	0	1	0	0	114
15642	2	1	0	111	0	114
15643	115	0	0	1	0	116
15644	2	0	110	0	0	112
15645	107	0	1	1	0	109
15646	2	0	108	0	0	110
15647	106	0	2	0	0	108
15648	3	0	0	108	0	111
15649	0	0	122	1	0	123
15650	3	0	1	116	0	120
15651	1	0	0	119	0	120
15652	0	0	121	1	0	122
15653	114	0	1	1	0	116
15654	1	123	0	1	0	125
15655	120	1	2	2	0	125
15656	2	120	0	0	0	122
15657	119	2	0	2	0	123
15658	2	0	122	0	0	124
15659	106	2	2	4	0	114
15660	1	112	0	0	0	113
15661	0	0	0	108	0	108
15662	0	0	0	112	0	112
15663	0	0	0	112	0	112
15664	0	0	110	1	0	111
15665	0	0	1	111	0	112
15666	0	0	117	1	0	118
15667	112	0	1	1	0	114
15668	122	0	0	1	0	123
15669	1	0	0	124	0	125
15670	0	0	129	1	0	130
15671	116	1	1	0	0	118
15672	1	0	160	1	0	162
15673	0	0	3	152	0	155
15674	1	0	0	165	0	166
15675	1	0	1	167	0	169
15676	1	0	0	169	0	170
15677	162	0	0	4	0	166
15678	2	170	2	3	0	177
15679	0	2	170	1	0	173
15680	1	167	2	0	0	170
15681	169	3	0	3	0	175
15682	2	0	1	173	0	176
15683	177	1	0	3	0	181
15684	2	0	0	178	0	180
15685	0	0	1	181	0	182
15686	4	0	0	178	0	182
15687	0	0	178	4	0	182
15688	0	176	2	2	0	180
15689	0	1	174	2	0	177
15690	1	0	3	177	0	181
15691	179	1	0	6	0	186
15692	177	1	0	1	0	179
15693	183	1	1	2	0	187
15694	3	187	1	0	0	191
15695	199	3	0	2	0	204
15696	4	0	0	204	0	208
15697	1	1	0	202	0	204
15698	1	0	0	200	0	201
15699	0	205	0	5	0	210
15700	0	1	0	204	0	205
15701	0	202	1	4	0	207
15702	199	3	1	1	0	204
15703	202	1	1	1	0	205
15704	2	1	1	207	0	211
15705	2	0	205	3	0	210
15706	198	0	2	1	0	201
15707	2	0	0	208	0	210
15708	1	1	204	2	0	208
15709	198	1	2	2	0	203
15710	5	0	0	210	0	215
15711	208	0	1	6	0	215
15712	2	207	0	3	0	212
15713	0	3	0	206	0	209
15714	1	214	0	3	0	218
15715	0	3	0	210	0	213
15716	0	217	0	3	0	220
15717	3	2	0	220	0	225
15718	1	0	226	3	0	230
15719	176	1	4	2	0	183
15720	1	228	0	1	0	230
15721	1	1	216	1	0	219
15722	214	0	2	2	0	218
15723	3	1	1	221	0	226
15724	0	1	227	2	0	230
15725	2	226	1	1	0	230
15726	2	2	0	228	0	232
15727	0	1	236	2	0	239
15728	0	2	1	230	0	233
15729	1	0	0	231	0	232
15730	1	1	245	2	0	249
15731	3	1	1	237	0	242
15732	0	0	250	4	0	254
15733	3	0	3	247	0	253
15734	1	1	275	3	0	280
15735	3	2	3	271	0	279
15736	1	0	1	285	0	287
15737	2	0	1	278	0	281
15738	0	282	2	2	0	286
15739	282	3	1	3	0	289
15740	277	0	0	6	0	283
15741	2	1	1	281	0	285
15742	281	0	0	3	0	284
15743	2	0	280	3	0	285
15744	0	288	2	3	0	293
15745	291	1	1	4	0	297
15746	1	292	4	1	0	298
15747	0	3	0	300	0	303
15748	1	0	1	301	0	303
15749	294	1	1	3	0	299
15750	4	0	0	294	0	298
15751	1	0	293	4	0	298
15752	1	292	1	0	0	294
15753	292	3	0	1	0	296
15754	5	0	1	288	0	294
15755	1	301	0	3	0	305
15756	3	1	0	300	0	304
15757	1	301	1	3	0	306
15758	299	4	1	2	0	306
15759	300	1	0	4	0	305
15760	2	3	299	1	0	305
15761	2	1	288	0	0	291
15762	2	0	1	299	0	302
15763	1	302	1	4	0	308
15764	2	1	1	309	0	313
15765	305	0	1	3	0	309
15766	1	1	296	1	0	299
15767	1	1	2	280	0	284
15768	1	0	283	2	0	286
15769	0	1	268	1	0	270
15770	1	282	2	1	0	286
15771	2	4	1	274	0	281
15772	254	1	0	3	0	258
15773	0	1	258	0	0	259
15774	0	253	1	1	0	255
15775	251	1	0	4	0	256
15776	1	1	0	246	0	248
15777	257	0	1	4	0	262
15778	267	0	0	6	0	273
15779	260	1	0	3	0	264
15780	1	1	276	0	0	278
15781	263	1	1	1	0	266
15782	280	0	0	1	0	281
15783	1	289	0	0	0	290
15784	0	2	0	291	0	293
15785	0	0	0	282	0	282
15786	0	1	0	292	0	293
15787	290	0	0	4	0	294
15788	275	0	0	4	0	279
15789	2	0	284	0	0	286
15790	1	0	2	275	0	278
15791	0	273	1	2	0	276
15792	275	2	0	3	0	280
15793	2	1	275	0	0	278
15794	0	0	2	263	0	265
15795	1	0	1	264	0	266
15796	1	259	1	0	0	261
15797	0	2	0	260	0	262
15798	2	0	0	240	0	242
15799	1	0	0	260	0	261
15800	258	0	0	4	0	262
15801	2	0	0	251	0	253
15802	1	0	0	253	0	254
15803	255	0	0	6	0	261
15804	2	0	0	257	0	259
15805	0	277	0	2	0	279
15806	283	2	0	3	0	288
15807	291	1	0	4	0	296
15808	293	0	0	2	0	295
15809	324	0	0	5	0	329
15810	4	335	0	1	0	340
15811	376	5	0	2	0	383
15812	387	1	0	3	0	391
15813	10	2	1	380	0	393
15814	4	0	378	8	0	390
15815	3	1	7	363	0	374
15816	2	0	1	383	0	386
15817	2	0	3	367	0	372
15818	1	0	0	371	0	372
15819	0	0	0	371	0	371
15820	360	1	0	13	0	374
15821	10	0	0	360	0	370
15822	1	0	366	12	0	379
15823	3	0	7	359	0	369
15824	1	356	1	11	0	369
15825	1	8	1	365	0	375
15826	0	1	361	10	0	372
15827	328	4	8	1	0	341
15828	352	0	1	4	0	357
15829	9	2	360	1	0	372
15830	6	362	9	1	0	378
15831	375	9	1	0	0	385
15832	365	1	3	4	0	373
15833	369	3	1	4	0	377
15834	353	1	0	3	0	357
15835	16	0	0	336	0	352
15836	4	2	338	9	0	353
15837	6	1	8	339	0	354
15838	3	1	2	360	0	366
15839	2	1	343	12	0	358
15840	0	2	339	7	0	348
15841	325	0	11	8	0	344
15842	9	338	2	5	0	354
15843	2	9	3	348	0	362
15844	5	1	344	12	0	362
15845	332	3	9	5	0	349
15846	14	2	344	3	0	363
15847	330	0	11	8	0	349
15848	13	339	4	2	0	358
15849	4	11	4	342	0	361
15850	9	4	345	8	0	366
15851	328	4	8	4	0	344
15852	16	329	3	2	0	350
15853	5	359	4	2	0	370
15854	9	11	1	352	0	373
15855	7	2	4	361	0	374
15856	365	7	0	17	0	389
15857	11	366	4	8	0	389
15858	6	9	1	376	0	392
15859	369	1	1	16	0	387
15860	372	3	2	6	0	383
15861	376	3	1	15	0	395
15862	14	0	382	6	0	402
15863	10	2	375	2	0	389
15864	385	1	10	11	0	407
15865	13	391	13	0	0	417
15866	2	403	8	6	0	419
15867	8	16	1	378	0	403
15868	4	393	1	14	0	412
15869	398	16	6	8	0	428
15870	18	2	5	393	0	418
15871	9	8	386	12	0	415
15872	390	4	17	5	0	416
15873	401	5	4	8	0	418
15874	22	2	5	392	0	421
15875	17	2	1	394	0	414
15876	13	3	4	401	0	421
15877	9	3	3	399	0	414
15878	8	3	365	23	0	399
15879	7	366	12	8	0	393
15880	7	13	5	335	0	360
15881	7	365	9	14	0	395
15882	8	15	6	327	0	356
15883	6	355	6	16	0	383
15884	355	18	1	8	0	382
15885	358	7	3	8	0	376
15886	16	351	4	9	0	380
15887	357	15	6	3	0	381
15888	23	3	4	343	0	373
15889	333	7	3	18	0	361
15890	21	339	5	5	0	370
15891	349	14	6	6	0	375
15892	358	4	4	7	0	373
15893	15	14	3	338	0	370
15894	12	6	332	21	0	371
15895	7	337	15	8	0	367
15896	7	15	4	346	0	372
15897	348	5	11	13	0	377
15898	18	10	342	6	0	376
15899	14	4	11	335	0	364
15900	12	6	3	350	0	371
15901	348	4	6	18	0	376
15902	351	6	2	12	0	371
15903	348	2	5	10	0	365
15904	23	341	2	4	0	370
15905	317	13	3	9	0	342
15906	19	1	299	8	0	327
15907	4	7	292	7	0	310
15908	11	5	283	4	0	303
15909	10	12	17	230	0	269
15910	9	1	224	11	0	245
15911	187	4	6	5	0	202
15912	9	4	2	189	0	204
15913	5	4	195	7	0	211
15914	197	3	8	4	0	212
15915	12	5	2	194	0	213
15916	7	2	4	207	0	220
15917	206	1	3	9	0	219
15918	7	2	4	210	0	223
15919	6	4	210	10	0	230
15920	10	2	8	209	0	229
15921	8	1	214	11	0	234
15922	5	4	10	213	0	232
15923	214	2	2	13	0	231
15924	7	211	5	8	0	231
15925	6	225	5	5	0	241
15926	5	7	5	217	0	234
15927	3	2	4	224	0	233
15928	5	212	3	11	0	231
15929	4	208	3	8	0	223
15930	7	5	2	211	0	225
15931	4	4	3	208	0	219
15932	199	5	3	12	0	219
15933	10	193	3	5	0	211
15934	2	197	4	8	0	211
15935	5	207	4	5	0	221
15936	198	8	4	5	0	215
15937	8	3	195	4	0	210
15938	186	3	8	5	0	202
15939	11	0	2	195	0	208
15940	2	180	4	8	0	194
15941	6	192	3	5	0	206
15942	183	8	3	5	0	199
15943	6	6	3	181	0	196
15944	3	200	5	6	0	214
15945	197	5	1	9	0	212
15946	201	2	3	6	0	212
15947	7	6	195	3	0	211
15948	198	3	5	5	0	211
15949	200	3	4	4	0	211
15950	11	1	3	199	0	214
15951	5	191	2	9	0	207
15952	5	206	1	4	0	216
15953	7	10	0	193	0	210
15954	184	5	1	9	0	199
15955	6	2	175	2	0	185
15956	2	0	164	5	0	171
15957	4	0	155	2	0	161
15958	2	1	163	1	0	167
15959	2	161	8	0	0	171
15960	2	166	1	1	0	170
15961	2	6	146	0	0	154
15962	1	1	143	1	0	146
15963	0	120	6	0	0	126
15964	0	3	2	117	0	122
15965	0	1	119	3	0	123
15966	0	1	3	120	0	124
15967	0	0	1	126	0	127
15968	1	0	1	131	0	133
15969	0	0	0	135	0	135
15970	0	0	129	5	0	134
15971	1	0	4	125	0	130
15972	126	0	1	6	0	133
15973	4	0	122	2	0	128
15974	121	0	3	3	0	127
15975	5	0	1	131	0	137
15976	1	0	133	4	0	138
15977	126	0	4	2	0	132
15978	3	0	1	132	0	136
15979	128	0	2	4	0	134
15980	4	0	0	126	0	130
15981	2	133	1	4	0	140
15982	2	3	137	2	0	144
15983	2	1	5	131	0	139
15984	137	2	1	6	0	146
15985	140	0	2	2	0	144
15986	141	1	0	2	0	144
15987	148	2	0	1	0	151
15988	142	3	0	4	0	149
15989	5	141	0	2	0	148
15990	140	4	0	3	0	147
15991	4	3	133	1	0	141
15992	131	2	3	1	0	137
15993	4	2	2	131	0	139
15994	3	0	142	4	0	149
15995	1	1	136	1	0	139
15996	2	2	4	133	0	141
15997	139	2	2	6	0	149
15998	4	140	2	1	0	147
15999	135	5	2	4	0	146
16000	7	142	0	0	0	149
16001	2	4	1	153	0	160
16002	4	3	1	153	0	161
16003	151	2	0	8	0	161
16004	6	0	0	155	0	161
16005	1	1	154	6	0	162
16006	155	1	3	2	0	161
16007	7	0	2	157	0	166
16008	5	1	1	157	0	164
16009	4	0	154	3	0	161
16010	141	0	4	3	0	148
16011	153	0	3	2	0	158
16012	6	154	2	2	0	164
16013	1	4	153	0	0	158
16014	1	2	149	1	0	153
16015	0	1	5	141	0	147
16016	1	0	1	140	0	142
16017	0	150	0	4	0	154
16018	0	2	145	3	0	150
16019	0	1	3	139	0	143
16020	0	0	150	3	0	153
16021	2	0	2	139	0	143
16022	1	141	1	3	0	146
16023	1	2	0	153	0	156
16024	3	2	1	146	0	152
16025	2	0	0	150	0	152
16026	144	1	0	6	0	151
16027	3	0	142	2	0	147
16028	3	150	3	0	0	156
16029	2	2	1	161	0	166
16030	163	3	0	4	0	170
16031	4	0	1	168	0	173
16032	165	0	1	4	0	170
16033	4	0	164	4	0	172
16034	165	0	4	3	0	172
16035	5	2	2	166	0	175
16036	3	0	168	5	0	176
16037	0	166	4	5	0	175
16038	2	4	3	161	0	170
16039	0	4	0	176	0	180
16040	165	0	0	8	0	173
16041	4	159	0	5	0	168
16042	5	163	1	0	0	169
16043	1	175	0	0	0	176
16044	161	6	0	0	0	167
16045	3	163	1	0	0	167
16046	4	4	0	158	0	166
16047	1	3	0	163	0	167
16048	159	0	0	6	0	165
16049	4	157	0	4	0	165
16050	4	4	0	157	0	165
16051	160	4	0	5	0	169
16052	163	0	0	4	0	167
16053	161	0	0	1	0	162
16054	6	153	0	0	0	159
16055	155	2	0	0	0	157
16056	2	3	0	151	0	156
16057	3	151	1	2	0	157
16058	0	155	0	2	0	157
16059	1	5	1	155	0	162
16060	151	3	0	3	0	157
16061	157	0	0	5	0	162
16062	5	0	0	152	0	157
16063	2	159	0	2	0	163
16064	159	2	0	2	0	163
16065	2	3	160	0	0	165
16066	3	0	155	0	0	158
16067	150	1	5	1	0	157
16068	2	0	153	0	0	155
16069	3	0	2	149	0	154
16070	149	0	3	2	0	154
16071	2	0	0	153	0	155
16072	2	0	152	2	0	156
16073	0	160	2	3	0	165
16074	2	2	2	162	0	168
16075	0	3	162	3	0	168
16076	154	0	3	3	0	160
16077	3	0	3	166	0	172
16078	3	0	162	3	0	168
16079	0	0	3	166	0	169
16080	0	158	2	3	0	163
16081	1	3	0	168	0	172
16082	3	4	0	160	0	167
16083	2	0	0	157	0	159
16084	0	156	0	6	0	162
16085	158	3	0	2	0	163
16086	4	3	0	160	0	167
16087	3	0	0	160	0	163
16088	1	0	0	165	0	166
16089	0	0	159	7	0	166
16090	0	0	3	157	0	160
16091	152	0	3	6	0	161
16092	4	157	0	3	0	164
16093	2	4	0	160	0	166
16094	0	3	0	165	0	168
16095	161	0	0	7	0	168
16096	3	158	0	4	0	165
16097	166	4	0	0	0	170
16098	164	2	0	0	0	166
16099	6	0	0	160	0	166
16100	164	1	0	6	0	171
16101	5	148	0	4	0	157
16102	155	3	0	0	0	158
16103	5	3	0	154	0	162
16104	167	0	0	6	0	173
16105	177	1	0	4	0	182
16106	14	0	165	0	0	179
16107	175	0	8	2	0	185
16108	185	0	3	1	0	189
16109	197	0	0	2	0	199
16110	15	0	190	1	0	206
16111	3	190	13	0	0	206
16112	2	12	2	191	0	207
16113	195	2	0	12	0	209
16114	12	188	0	3	0	203
16115	192	12	1	0	0	205
16116	12	3	0	189	0	204
16117	4	0	193	11	0	208
16118	190	1	12	3	0	206
16119	13	1	2	190	0	206
16120	3	0	193	13	0	209
16121	188	0	13	4	0	205
16122	13	1	200	0	0	214
16123	4	0	12	206	0	222
16124	3	0	2	226	0	231
16125	211	1	2	16	0	230
16126	222	1	0	5	0	228
16127	17	213	2	3	0	235
16128	212	16	0	3	0	231
16129	18	2	200	2	0	222
16130	5	2	221	0	0	228
16131	212	3	16	1	0	232
16132	16	210	2	2	0	230
16133	201	13	3	1	0	218
16134	13	199	4	1	0	217
16135	199	14	2	2	0	217
16136	16	1	0	197	0	214
16137	3	3	196	13	0	215
16138	6	2	13	196	0	217
16139	2	1	1	221	0	225
16140	201	0	2	18	0	221
16141	17	0	199	2	0	218
16142	195	1	14	3	0	213
16143	14	195	1	4	0	214
16144	203	13	2	2	0	220
16145	18	0	4	195	0	217
16146	2	0	204	14	0	220
16147	2	4	14	202	0	222
16148	209	1	0	16	0	226
16149	18	2	1	204	0	225
16150	6	3	2	209	0	220
16151	5	195	2	13	0	215
16152	4	13	1	201	0	219
16153	2	0	202	16	0	220
16154	3	1	14	204	0	222
16155	4	2	1	216	0	223
16156	197	3	2	16	0	218
16157	18	1	4	195	0	218
16158	4	3	195	14	0	216
16159	5	195	13	4	0	217
16160	3	13	2	196	0	214
16161	4	0	3	209	0	216
16162	197	0	2	17	0	216
16163	16	193	3	2	0	214
16164	6	12	1	191	0	210
16165	185	1	2	16	0	204
16166	201	2	2	4	0	209
16167	16	4	1	189	0	210
16168	3	4	192	17	0	216
16169	191	0	15	8	0	214
16170	18	2	1	201	0	222
16171	203	1	0	16	0	220
16172	208	2	2	7	0	219
16173	17	189	4	3	0	213
16174	184	15	2	7	0	208
16175	15	191	2	6	0	214
16176	5	14	1	193	0	213
16177	3	2	4	197	0	206
16178	3	189	2	17	0	211
16179	194	17	0	5	0	216
16180	202	1	1	5	0	209
16181	14	1	185	7	0	207
16182	5	2	192	1	0	200
16183	3	4	14	192	0	213
16184	188	0	3	18	0	209
16185	18	1	0	190	0	209
16186	4	2	3	200	0	209
16187	3	2	190	18	0	213
16188	5	3	200	3	0	211
16189	5	1	204	2	0	212
16190	186	3	13	7	0	209
16191	198	2	4	7	0	211
16192	15	185	3	5	0	208
16193	4	198	0	3	0	205
16194	5	16	3	192	0	216
16195	5	4	184	16	0	209
16196	191	2	12	3	0	208
16197	16	2	193	4	0	215
16198	2	2	16	191	0	211
16199	4	2	2	208	0	216
16200	5	0	1	214	0	220
16201	1	2	1	214	0	218
16202	192	1	2	16	0	211
16203	16	1	1	195	0	213
16204	1	3	185	11	0	200
16205	168	1	11	6	0	186
16206	11	1	184	6	0	202
16207	6	0	181	2	0	189
16208	1	181	11	1	0	194
16209	4	7	3	160	0	174
16210	166	1	0	8	0	175
16211	8	0	0	166	0	174
16212	0	0	168	8	0	176
16213	1	2	8	161	0	172
16214	168	1	0	9	0	178
16215	7	172	0	2	0	181
16216	170	7	0	2	0	179
16217	8	166	0	2	0	176
16218	168	7	1	2	0	178
16219	9	175	1	0	0	185
16220	3	186	0	0	0	189
16221	0	7	180	2	0	189
16222	1	178	8	0	0	187
16223	159	4	2	3	0	168
16224	5	0	0	157	0	162
16225	155	0	0	6	0	161
16226	4	155	0	0	0	159
16227	151	4	0	2	0	157
16228	4	0	159	0	0	163
16229	0	0	4	152	0	156
16230	0	153	0	4	0	157
16231	0	4	0	160	0	164
16232	1	0	1	158	0	160
16233	170	0	0	7	0	177
16234	6	177	0	1	0	184
16235	183	6	0	1	0	190
16236	6	0	183	0	0	189
16237	0	1	175	0	0	176
16238	1	181	6	0	0	188
16239	0	7	0	187	0	194
16240	0	0	188	7	0	195
16241	2	0	5	171	0	178
16242	1	1	0	189	0	191
16243	1	1	181	6	0	189
16244	1	0	182	0	0	183
16245	1	0	187	0	0	188
16246	0	0	190	1	0	191
16247	0	196	6	2	0	204
16248	3	6	0	191	0	200
16249	1	1	0	203	0	205
16250	1	0	196	7	0	204
16251	2	0	8	184	0	194
16252	0	0	209	6	0	215
16253	1	1	5	196	0	203
16254	1	0	0	208	0	209
16255	2	201	1	6	0	210
16256	2	6	0	207	0	215
16257	0	1	0	207	0	208
16258	0	1	1	208	0	210
16259	0	0	205	6	0	211
16260	1	198	5	0	0	204
16261	195	6	3	0	0	204
16262	202	1	0	2	0	205
16263	5	0	1	195	0	201
16264	0	1	0	186	0	187
16265	0	196	1	5	0	202
16266	200	5	0	2	0	207
16267	8	202	2	1	0	213
16268	193	6	1	2	0	202
16269	6	1	192	2	0	201
16270	182	1	6	4	0	193
16271	6	200	2	1	0	209
16272	3	7	1	204	0	215
16273	2	1	0	207	0	210
16274	0	207	2	6	0	215
16275	203	6	1	4	0	214
16276	6	2	1	212	0	221
16277	3	0	2	209	0	214
16278	210	1	2	8	0	221
16279	214	1	1	4	0	220
16280	6	1	205	1	0	213
16281	206	1	6	2	0	215
16282	6	1	1	206	0	214
16283	3	1	201	6	0	211
16284	2	1	7	204	0	214
16285	2	0	201	6	0	209
16286	0	2	200	2	0	204
16287	1	1	5	206	0	213
16288	0	1	205	8	0	214
16289	0	216	5	4	0	225
16290	2	4	2	216	0	224
16291	0	3	0	226	0	229
16292	2	0	220	8	0	230
16293	2	216	4	1	0	223
16294	215	4	3	3	0	225
16295	6	2	2	220	0	230
16296	225	2	0	7	0	234
16297	7	224	1	4	0	236
16298	1	6	231	4	0	242
16299	6	2	4	223	0	235
16300	226	2	5	3	0	236
16301	3	2	233	3	0	241
16302	216	1	5	4	0	226
16303	5	219	5	3	0	232
16304	2	226	1	2	0	231
16305	225	6	1	1	0	233
16306	3	2	1	222	0	228
16307	3	1	3	224	0	231
16308	2	231	1	5	0	239
16309	4	3	1	238	0	246
16310	2	2	0	241	0	245
16311	237	1	1	6	0	245
16312	6	1	1	232	0	240
16313	2	0	234	6	0	242
16314	2	0	4	227	0	233
16315	3	1	1	243	0	248
16316	1	0	244	5	0	250
16317	2	2	4	245	0	253
16318	241	1	1	6	0	249
16319	230	1	4	2	0	237
16320	230	1	1	2	0	234
16321	5	1	1	232	0	239
16322	2	1	233	3	0	239
16323	2	233	2	2	0	239
16324	1	3	1	239	0	244
16325	1	1	244	3	0	249
16326	1	1	2	242	0	246
16327	1	2	1	245	0	249
16328	244	1	2	2	0	249
16329	1	244	1	4	0	250
16330	3	1	244	3	0	251
16331	229	2	3	2	0	236
16332	2	237	2	1	0	242
16333	1	221	1	0	0	223
16334	231	1	2	1	0	235
16335	1	2	0	234	0	237
16336	1	1	261	0	0	263
16337	3	0	0	246	0	249
16338	0	263	2	1	0	266
16339	264	0	1	2	0	267
16340	0	1	0	265	0	266
16341	271	2	0	0	0	273
16342	2	0	0	265	0	267
16343	1	272	1	1	0	275
16344	272	1	0	8	0	281
16345	271	1	0	4	0	276
16346	3	274	0	0	0	277
16347	262	1	1	3	0	267
16348	4	1	0	261	0	266
16349	1	263	0	2	0	266
16350	268	1	1	3	0	273
16351	1	267	0	2	0	270
16352	258	2	1	3	0	264
16353	2	1	2	259	0	264
16354	259	1	0	8	0	268
16355	261	1	1	5	0	268
16356	264	1	0	3	0	268
16357	3	0	0	265	0	268
16358	4	0	0	267	0	271
16359	262	0	1	4	0	267
16360	1	2	268	2	0	273
16361	5	0	2	262	0	269
16362	2	267	1	2	0	272
16363	2	3	1	271	0	277
16364	1	2	0	269	0	272
16365	1	1	270	4	0	276
16366	1	1	2	278	0	282
16367	2	301	1	7	0	311
16368	0	10	1	311	0	322
16369	1	2	321	10	0	334
16370	2	1	9	312	0	324
16371	3	0	4	325	0	332
16372	319	0	1	14	0	334
16373	320	0	1	5	0	326
16374	12	2	0	312	0	326
16375	4	295	1	15	0	315
16376	3	307	1	5	0	316
16377	1	12	304	1	0	318
16378	1	4	6	296	0	307
16379	302	3	3	11	0	319
16380	9	1	1	304	0	315
16381	3	1	311	11	0	326
16382	2	0	9	301	0	312
16383	1	0	2	310	0	313
16384	2	1	1	323	0	327
16385	1	0	309	14	0	324
16386	0	303	12	5	0	320
16387	303	8	2	4	0	317
16388	308	3	1	2	0	314
16389	12	1	1	291	0	305
16390	5	1	301	8	0	315
16391	2	290	11	4	0	307
16392	4	9	3	285	0	301
16393	0	301	3	8	0	312
16394	0	316	3	2	0	321
16395	301	11	1	2	0	315
16396	11	3	301	1	0	316
16397	4	2	301	2	0	309
16398	1	1	12	293	0	307
16399	2	1	3	308	0	314
16400	0	1	305	13	0	319
16401	3	0	10	292	0	305
16402	1	2	303	10	0	316
16403	283	1	9	5	0	298
16404	10	0	5	296	0	311
16405	4	1	324	11	0	340
16406	3	0	9	297	0	309
16407	3	348	5	7	0	363
16408	349	11	0	9	0	369
16409	10	344	1	1	0	356
16410	357	11	0	2	0	370
16411	9	8	342	0	0	359
16412	348	0	10	4	0	362
16413	9	2	3	353	0	367
16414	5	0	356	9	0	370
16415	1	1	10	353	0	365
16416	2	0	351	11	0	364
16417	326	0	11	8	0	345
16418	11	355	3	3	0	372
16419	3	7	1	346	0	357
16420	1	368	1	8	0	378
16421	364	10	0	5	0	379
16422	359	4	2	1	0	366
16423	12	365	0	3	0	380
16424	3	11	1	367	0	382
16425	2	3	2	378	0	385
16426	2	2	0	377	0	381
16427	362	1	1	16	0	380
16428	10	363	0	6	0	379
16429	5	11	1	360	0	377
16430	3	3	0	366	0	372
16431	358	1	3	13	0	375
16432	9	1	351	6	0	367
16433	3	0	348	4	0	355
16434	332	1	12	4	0	349
16435	10	1	339	2	0	352
16436	5	0	315	1	0	321
16437	2	0	13	302	0	317
16438	309	0	4	12	0	325
16439	9	2	1	306	0	318
16440	3	1	312	10	0	326
16441	289	2	9	6	0	306
16442	11	2	300	1	0	314
16443	6	307	7	1	0	321
16444	2	9	5	317	0	333
16445	315	3	4	8	0	330
16446	9	1	2	321	0	333
16447	6	1	0	318	0	325
16448	319	1	1	18	0	339
16449	10	2	1	326	0	339
16450	5	1	1	332	0	339
16451	2	1	328	12	0	343
16452	3	0	9	322	0	334
16453	331	0	4	13	0	348
16454	334	0	1	8	0	343
16455	339	3	2	4	0	348
16456	13	1	1	323	0	338
16457	5	323	2	7	0	337
16458	324	10	0	7	0	341
16459	9	325	1	1	0	336
16460	316	7	2	3	0	328
16461	9	4	1	316	0	330
16462	318	1	1	8	0	328
16463	310	2	0	7	0	319
16464	315	1	2	2	0	320
16465	12	311	0	3	0	326
16466	4	289	3	0	0	296
16467	268	1	1	0	0	270
16468	1	265	1	2	0	269
16469	1	252	3	0	0	256
16470	0	246	2	2	0	250
16471	250	2	0	1	0	253
16472	1	1	0	248	0	250
16473	1	1	0	247	0	249
16474	253	1	0	2	0	256
16475	2	1	252	1	0	256
16476	1	0	1	276	0	278
16477	1	0	1	279	0	281
16478	0	0	0	295	0	295
16479	2	0	1	308	0	311
16480	1	296	2	9	0	308
16481	0	324	1	8	0	333
16482	332	12	0	5	0	349
16483	8	8	0	335	0	351
16484	8	3	0	339	0	350
16485	3	2	327	14	0	346
16486	3	1	8	330	0	342
16487	1	1	333	11	0	346
16488	3	2	11	337	0	353
16489	2	1	350	12	0	365
16490	1	351	12	7	0	371
16491	2	8	7	351	0	368
16492	350	5	6	11	0	372
16493	348	2	1	10	0	361
16494	16	1	3	341	0	361
16495	8	1	349	13	0	371
16496	4	2	344	7	0	357
16497	322	3	14	5	0	344
16498	11	333	9	5	0	358
16499	348	10	3	3	0	364
16500	351	6	1	2	0	360
16501	19	2	336	2	0	359
16502	10	2	12	324	0	348
16503	8	1	8	330	0	347
16504	6	0	6	354	0	366
16505	4	4	2	334	0	344
16506	4	1	3	327	0	335
16507	5	2	290	24	0	321
16508	4	1	300	12	0	317
16509	3	1	15	303	0	322
16510	0	1	13	308	0	322
16511	4	1	5	311	0	321
16512	295	0	3	23	0	321
16513	15	2	1	304	0	322
16514	300	1	6	15	0	322
16515	16	0	5	298	0	319
16516	311	1	5	16	0	333
16517	318	1	2	16	0	337
16518	311	0	0	13	0	324
16519	320	3	0	4	0	327
16520	316	1	1	9	0	327
16521	24	0	1	302	0	327
16522	291	0	4	15	0	310
16523	16	290	5	10	0	321
16524	306	10	3	9	0	328
16525	17	6	2	305	0	330
16526	13	3	294	14	0	324
16527	10	2	12	303	0	327
16528	4	0	301	22	0	327
16529	9	1	14	307	0	331
16530	1	3	7	318	0	329
16531	6	0	300	22	0	328
16532	4	0	306	21	0	331
16533	6	1	20	300	0	327
16534	299	0	12	23	0	334
16535	13	0	305	10	0	328
16536	10	296	15	12	0	333
16537	8	12	319	8	0	347
16538	312	9	17	4	0	342
16539	20	6	11	309	0	346
16540	321	2	6	20	0	349
16541	332	0	6	12	0	350
16542	20	1	6	315	0	342
16543	17	3	304	15	0	339
16544	7	2	14	314	0	337
16545	9	0	7	311	0	327
16546	292	2	6	26	0	326
16547	15	293	12	12	0	332
16548	11	11	4	306	0	332
16549	10	7	293	20	0	330
16550	286	5	16	12	0	319
16551	13	290	8	12	0	323
16552	8	15	10	289	0	322
16553	12	6	4	299	0	321
16554	3	6	4	306	0	319
16555	288	3	1	30	0	322
16556	300	1	4	18	0	323
16557	24	1	4	294	0	323
16558	15	4	287	16	0	322
16559	7	277	13	19	0	316
16560	283	10	10	15	0	318
16561	301	5	5	12	0	323
16562	27	6	3	280	0	316
16563	16	6	2	296	0	320
16564	11	2	291	23	0	327
16565	6	287	20	13	0	326
16566	290	15	10	9	0	324
16567	294	7	3	8	0	312
16568	24	281	3	7	0	315
16569	281	11	1	13	0	306
16570	20	7	2	275	0	304
16571	10	6	270	19	0	305
16572	10	3	14	279	0	306
16573	7	4	272	20	0	303
16574	257	3	17	11	0	288
16575	16	257	8	7	0	288
16576	10	13	4	221	0	248
16577	9	3	224	15	0	251
16578	1	2	224	9	0	236
16579	182	2	11	10	0	205
16580	8	194	7	4	0	213
16581	162	5	4	2	0	173
16582	168	2	1	1	0	172
16583	167	3	2	3	0	175
16584	10	1	1	159	0	171
16585	2	1	163	6	0	172
16586	4	160	7	1	0	172
16587	3	6	2	165	0	176
16588	2	1	168	5	0	176
16589	3	1	150	1	0	155
16590	3	2	5	146	0	156
16591	2	1	139	5	0	147
16592	128	1	5	2	0	136
16593	3	3	2	136	0	144
16594	0	1	2	144	0	147
16595	144	0	3	4	0	151
16596	5	137	1	1	0	144
16597	154	5	1	2	0	162
16598	7	1	0	158	0	166
16599	2	1	1	154	0	158
16600	3	0	0	162	0	165
16601	3	1	2	152	0	158
16602	147	1	1	7	0	156
16603	4	1	151	3	0	159
16604	0	151	4	2	0	157
16605	4	4	2	153	0	163
16606	148	0	2	5	0	155
16607	151	1	1	3	0	156
16608	4	156	1	3	0	164
16609	149	3	0	4	0	156
16610	6	150	1	1	0	158
16611	2	162	1	1	0	166
16612	3	6	0	151	0	160
16613	4	2	154	3	0	163
16614	1	2	3	149	0	155
16615	145	0	0	7	0	152
16616	3	145	1	4	0	153
16617	1	3	2	155	0	161
16618	3	1	176	5	0	185
16619	183	3	5	1	0	192
16620	187	0	0	6	0	193
16621	189	2	3	1	0	195
16622	5	0	181	3	0	189
16623	176	0	4	2	0	182
16624	5	178	2	0	0	185
16625	2	4	0	174	0	180
16626	2	178	0	2	0	182
16627	185	3	0	2	0	190
16628	175	1	0	2	0	178
16629	4	1	188	1	0	194
16630	0	184	4	1	0	189
16631	1	2	1	190	0	194
16632	2	3	2	185	0	192
16633	0	1	1	192	0	194
16634	0	1	1	190	0	192
16635	1	0	2	195	0	198
16636	2	1	189	3	0	195
16637	1	190	3	1	0	195
16638	185	4	0	5	0	194
16639	4	0	190	1	0	195
16640	1	193	3	1	0	198
16641	192	3	0	2	0	197
16642	3	0	190	3	0	196
16643	188	0	3	2	0	193
16644	190	0	1	1	0	192
16645	186	0	0	1	0	187
16646	4	187	0	0	0	191
16647	0	3	188	0	0	191
16648	0	191	2	0	0	193
16649	2	3	0	163	0	168
16650	1	189	1	3	0	194
16651	192	3	0	0	0	195
16652	198	1	0	0	0	199
16653	196	0	0	2	0	198
16654	4	2	191	0	0	197
16655	0	202	5	0	0	207
16656	0	5	0	221	0	226
16657	228	0	1	8	0	237
16658	6	223	1	3	0	233
16659	2	6	0	226	0	234
16660	1	1	232	5	0	239
16661	225	0	6	1	0	232
16662	7	1	235	1	0	244
16663	2	1	232	1	0	236
16664	222	0	8	3	0	233
16665	9	1	230	0	0	240
16666	215	1	7	1	0	224
16667	7	223	5	1	0	236
16668	230	7	2	1	0	240
16669	9	1	1	224	0	235
16670	2	0	3	226	0	231
16671	4	1	1	231	0	237
16672	224	1	1	9	0	235
16673	226	1	1	3	0	231
16674	230	2	0	2	0	234
16675	10	217	1	1	0	229
16676	2	8	1	222	0	233
16677	3	1	217	10	0	231
16678	5	0	9	204	0	218
16679	5	204	1	9	0	219
16680	2	11	2	209	0	224
16681	2	2	1	216	0	221
16682	207	2	3	10	0	222
16683	11	2	1	212	0	226
16684	2	2	211	11	0	226
16685	1	2	216	3	0	222
16686	7	1	8	215	0	231
16687	218	1	1	10	0	230
16688	9	2	2	215	0	228
16689	3	2	2	222	0	229
16690	4	2	216	11	0	233
16691	5	215	9	5	0	234
16692	5	10	2	217	0	234
16693	217	3	0	13	0	233
16694	12	224	0	5	0	241
16695	3	9	3	231	0	246
16696	3	2	228	13	0	246
16697	4	3	12	213	0	232
16698	212	2	3	13	0	230
16699	11	215	2	4	0	232
16700	5	9	220	4	0	238
16701	4	3	11	217	0	235
16702	1	3	215	14	0	233
16703	214	0	11	6	0	231
16704	225	2	4	4	0	235
16705	14	0	217	5	0	236
16706	7	1	9	220	0	237
16707	5	1	220	9	0	235
16708	3	213	9	5	0	230
16709	5	10	3	218	0	236
16710	1	4	223	10	0	238
16711	5	0	10	212	0	227
16712	3	220	5	9	0	237
16713	2	12	1	227	0	242
16714	1	2	226	13	0	242
16715	213	0	12	8	0	233
16716	10	230	2	3	0	245
16717	229	11	1	5	0	246
16718	10	1	218	4	0	233
16719	208	1	13	3	0	225
16720	11	2	216	4	0	233
16721	213	1	11	2	0	227
16722	226	0	4	3	0	233
16723	12	1	2	209	0	224
16724	3	1	4	224	0	232
16725	213	1	6	13	0	233
16726	13	215	2	4	0	234
16727	209	9	3	5	0	226
16728	11	2	3	202	0	218
16729	5	204	2	12	0	223
16730	3	10	3	213	0	229
16731	2	3	3	217	0	225
16732	7	0	4	218	0	229
16733	3	208	2	12	0	225
16734	203	13	1	3	0	220
16735	10	3	1	209	0	223
16736	3	1	209	10	0	223
16737	3	3	212	5	0	223
16738	2	2	205	5	0	214
16739	204	0	12	3	0	219
16740	209	1	4	5	0	219
16741	13	2	206	2	0	223
16742	6	0	10	192	0	208
16743	4	2	4	205	0	215
16744	5	2	213	10	0	230
16745	2	1	213	2	0	218
16746	5	1	12	212	0	230
16747	217	2	1	12	0	232
16748	209	2	1	6	0	218
16749	211	0	3	5	0	219
16750	10	201	1	6	0	218
16751	2	213	2	4	0	221
16752	5	6	2	200	0	213
16753	197	1	3	11	0	212
16754	7	1	194	6	0	208
16755	176	2	7	4	0	189
16756	8	163	2	2	0	175
16757	2	152	1	1	0	156
16758	147	5	1	4	0	157
16759	4	146	1	1	0	152
16760	0	141	2	0	0	143
16761	137	2	0	6	0	145
16762	2	133	0	2	0	137
16763	0	2	1	141	0	144
16764	0	1	1	140	0	142
16765	139	0	0	3	0	142
16766	135	0	0	2	0	137
16767	2	146	1	1	0	150
16768	1	150	1	0	0	152
16769	0	2	147	0	0	149
16770	146	1	2	0	0	149
16771	148	0	0	3	0	151
16772	148	0	1	1	0	150
16773	1	0	0	153	0	154
16774	2	0	0	150	0	152
16775	155	0	1	2	0	158
16776	1	0	1	155	0	157
16777	1	0	157	1	0	159
16778	1	0	1	153	0	155
16779	1	161	0	1	0	163
16780	2	1	0	162	0	165
16781	0	1	0	159	0	160
16782	0	1	0	160	0	161
16783	159	0	0	4	0	163
16784	2	159	0	1	0	162
16785	0	2	1	152	0	155
16786	0	1	155	2	0	158
16787	0	1	146	1	0	148
16788	1	2	2	149	0	154
16789	1	0	1	154	0	156
16790	153	1	0	3	0	157
16791	1	1	0	149	0	151
16792	2	146	0	1	0	149
16793	0	2	154	1	0	157
16794	0	1	1	147	0	149
16795	0	0	157	2	0	159
16796	2	0	1	150	0	153
16797	154	0	1	2	0	157
16798	155	1	1	1	0	158
16799	2	156	1	0	0	159
16800	2	1	1	157	0	161
16801	161	1	0	4	0	166
16802	163	0	0	1	0	164
16803	168	0	0	0	0	168
16804	163	1	0	2	0	166
16805	158	0	1	2	0	161
16806	3	158	0	2	0	163
16807	157	1	2	3	0	163
16808	1	1	159	1	0	162
16809	3	1	1	160	0	165
16810	160	0	1	4	0	165
16811	158	1	0	2	0	161
16812	160	0	0	1	0	161
16813	4	0	161	0	0	165
16814	3	1	2	158	0	164
16815	165	0	1	2	0	168
16816	1	171	1	1	0	174
16817	189	2	0	1	0	192
16818	182	2	0	3	0	187
16819	189	0	0	1	0	190
16820	5	0	0	189	0	194
16821	189	0	0	6	0	195
16822	3	1	199	1	0	204
16823	3	0	185	0	0	188
16824	195	0	3	2	0	200
16825	2	0	205	0	0	207
16826	184	0	2	3	0	189
16827	4	0	201	0	0	205
16828	3	1	2	194	0	200
16829	201	1	1	3	0	206
16830	3	199	0	3	0	205
16831	199	2	0	2	0	203
16832	4	200	1	1	0	206
16833	4	204	0	1	0	209
16834	0	3	1	212	0	216
16835	1	1	1	211	0	214
16836	1	2	0	213	0	216
16837	1	0	212	4	0	217
16838	204	0	1	3	0	208
16839	215	0	2	4	0	221
16840	220	0	0	6	0	226
16841	222	0	0	0	0	222
16842	222	1	0	1	0	224
16843	6	0	209	0	0	215
16844	1	1	211	1	0	214
16845	4	1	2	215	0	222
16846	0	1	217	4	0	222
16847	208	0	1	3	0	212
16848	4	220	1	2	0	227
16849	4	4	1	232	0	241
16850	233	2	1	6	0	242
16851	7	0	0	237	0	244
16852	3	0	247	3	0	253
16853	1	0	254	3	0	258
16854	3	0	5	254	0	262
16855	1	0	260	3	0	264
16856	249	1	4	2	0	256
16857	5	0	3	257	0	265
16858	3	0	257	4	0	264
16859	4	246	5	1	0	256
16860	2	4	3	249	0	258
16861	2	2	250	4	0	258
16862	2	1	4	244	0	251
16863	1	1	2	247	0	251
16864	1	0	254	7	0	262
16865	0	0	5	255	0	260
16866	1	0	3	242	0	246
16867	2	0	1	250	0	253
16868	246	0	0	5	0	251
16869	6	242	1	3	0	252
16870	4	255	2	0	0	261
16871	2	6	252	0	0	260
16872	241	2	5	2	0	250
16873	4	0	250	0	0	254
16874	2	0	245	2	0	249
16875	0	1	5	238	0	244
16876	239	0	3	4	0	246
16877	3	235	0	4	0	242
16878	232	2	0	3	0	237
16879	237	2	0	1	0	240
16880	5	234	1	2	0	242
16881	230	4	1	4	0	239
16882	227	2	0	1	0	230
16883	4	226	2	2	0	234
16884	2	1	1	230	0	234
16885	1	2	0	236	0	239
16886	239	0	0	6	0	245
16887	7	244	1	1	0	253
16888	245	5	0	2	0	252
16889	241	3	0	6	0	250
16890	269	1	1	3	0	274
16891	11	0	1	255	0	267
16892	5	0	1	264	0	270
16893	255	0	1	12	0	268
16894	258	0	1	9	0	268
16895	262	0	1	4	0	267
16896	13	1	1	259	0	274
16897	5	1	258	8	0	272
16898	4	0	7	268	0	279
16899	3	2	5	292	0	302
16900	2	0	283	12	0	297
16901	2	1	301	6	0	310
16902	4	0	13	306	0	323
16903	1	0	313	12	0	326
16904	310	0	11	11	0	332
16905	14	0	8	319	0	341
16906	10	1	2	330	0	343
16907	332	0	1	18	0	351
16908	12	1	2	337	0	352
16909	12	1	0	345	0	358
16910	2	1	2	353	0	358
16911	3	0	0	354	0	357
16912	1	1	323	22	0	347
16913	1	0	8	335	0	344
16914	1	0	321	14	0	336
16915	1	324	11	10	0	346
16916	2	10	8	330	0	350
16917	2	7	314	9	0	332
16918	291	3	7	12	0	313
16919	11	317	8	1	0	337
16920	329	9	3	6	0	347
16921	15	9	1	310	0	335
16922	8	329	2	11	0	350
16923	333	8	2	10	0	353
16924	9	341	3	4	0	357
16925	343	10	0	6	0	359
16926	11	10	5	332	0	358
16927	337	2	0	12	0	351
16928	13	347	0	11	0	371
16929	354	12	2	5	0	373
16930	18	6	339	3	0	366
16931	13	4	10	345	0	372
16932	347	2	9	12	0	370
16933	356	0	4	13	0	373
16934	19	2	1	348	0	370
16935	13	3	346	16	0	378
16936	5	320	13	11	0	349
16937	5	341	13	4	0	363
16938	341	16	4	8	0	369
16939	16	10	4	337	0	367
16940	12	3	3	351	0	369
16941	339	1	0	28	0	368
16942	343	2	6	15	0	366
16943	21	2	337	6	0	366
16944	15	1	8	340	0	364
16945	5	2	344	15	0	366
16946	6	331	11	13	0	361
16947	311	10	10	10	0	341
16948	10	329	3	8	0	350
16949	10	333	2	6	0	351
16950	5	15	3	325	0	348
16951	313	12	2	12	0	339
16952	12	321	2	14	0	349
16953	320	10	4	8	0	342
16954	16	317	3	1	0	337
16955	11	14	1	314	0	340
16956	313	10	4	12	0	339
16957	11	5	320	11	0	347
16958	12	4	9	324	0	349
16959	9	4	326	10	0	349
16960	7	301	10	12	0	330
16961	5	330	7	6	0	348
16962	315	13	4	8	0	340
16963	11	338	2	6	0	357
16964	338	12	8	1	0	359
16965	340	10	0	7	0	357
16966	20	7	330	2	0	359
16967	324	4	8	8	0	344
16968	17	3	340	8	0	368
16969	13	335	13	3	0	364
16970	343	11	10	5	0	369
16971	11	336	5	5	0	357
16972	13	10	3	334	0	360
16973	337	11	2	18	0	368
16974	18	4	2	345	0	369
16975	13	5	346	11	0	375
16976	11	4	7	347	0	369
16977	8	1	13	348	0	370
16978	338	5	4	21	0	368
16979	12	2	337	15	0	366
16980	344	1	14	5	0	364
16981	346	1	8	10	0	365
16982	15	5	7	334	0	361
16983	16	4	1	339	0	360
16984	327	2	4	19	0	352
16985	12	357	2	9	0	380
16986	12	9	1	345	0	367
16987	6	9	338	7	0	360
16988	8	3	311	5	0	327
16989	2	335	10	7	0	354
16990	7	5	6	329	0	347
16991	3	8	3	335	0	349
16992	324	3	0	10	0	337
16993	6	2	5	317	0	330
16994	319	2	1	8	0	330
16995	6	310	1	5	0	322
16996	9	304	0	1	0	314
16997	1	317	1	4	0	323
16998	308	6	3	5	0	322
16999	284	5	2	1	0	292
17000	8	274	1	1	0	284
17001	248	1	0	1	0	250
17002	2	243	0	1	0	246
17003	1	1	0	240	0	242
17004	1	240	3	0	0	244
17005	238	1	1	3	0	243
17006	239	0	0	4	0	243
17007	2	2	0	234	0	238
17008	234	1	1	0	0	236
17009	2	0	0	236	0	238
17010	2	252	0	0	0	254
17011	1	2	0	252	0	255
17012	0	253	0	2	0	255
17013	252	1	0	2	0	255
17014	0	1	246	1	0	248
17015	237	0	1	2	0	240
17016	1	0	1	243	0	245
17017	0	0	237	0	0	237
17018	232	1	0	0	0	233
17019	0	0	241	2	0	243
17020	1	0	1	232	0	234
17021	2	0	0	230	0	232
17022	0	0	1	232	0	233
17023	1	0	0	228	0	229
17024	0	230	0	1	0	231
17025	1	2	0	236	0	239
17026	238	1	0	6	0	245
17027	3	1	234	0	0	238
17028	0	254	2	1	0	257
17029	258	4	0	1	0	263
17030	273	0	1	1	0	275
17031	10	2	0	298	0	310
17032	1	0	300	12	0	313
17033	1	1	12	295	0	309
17034	2	0	0	321	0	323
17035	1	0	306	14	0	321
17036	0	304	13	3	0	320
17037	316	12	1	0	0	329
17038	318	0	0	4	0	322
17039	326	1	0	1	0	328
17040	15	0	1	315	0	331
17041	2	1	1	326	0	330
17042	324	0	0	15	0	339
17043	14	0	1	313	0	328
17044	3	313	1	10	0	327
17045	328	16	0	6	0	350
17046	350	2	1	5	0	358
17047	352	0	0	5	0	357
17048	359	1	1	1	0	362
17049	18	1	313	4	0	336
17050	3	1	332	3	0	339
17051	3	0	18	318	0	339
17052	5	1	2	325	0	333
17053	4	2	317	16	0	339
17054	4	0	322	4	0	330
17055	5	0	20	305	0	330
17056	311	0	4	19	0	334
17057	19	1	0	306	0	326
17058	5	0	310	17	0	332
17059	1	322	19	3	0	345
17060	320	17	3	6	0	346
17061	329	2	1	6	0	338
17062	334	0	1	3	0	338
17063	324	1	2	4	0	331
17064	20	1	298	2	0	321
17065	5	2	15	298	0	320
17066	301	0	3	20	0	324
17067	22	2	1	302	0	327
17068	8	1	1	299	0	309
17069	3	298	3	19	0	323
17070	4	16	2	311	0	333
17071	304	2	0	20	0	326
17072	19	305	0	5	0	329
17073	300	16	1	6	0	323
17074	17	299	1	5	0	322
17075	8	17	0	279	0	304
17076	5	286	1	15	0	307
17077	3	309	1	3	0	316
17078	294	18	0	4	0	316
17079	20	3	291	1	0	315
17080	4	2	300	0	0	306
17081	2	2	295	1	0	300
17082	278	1	17	5	0	301
17083	16	292	4	2	0	314
17084	4	304	3	3	0	314
17085	273	17	3	5	0	298
17086	18	268	4	4	0	294
17087	6	284	1	3	0	294
17088	6	19	2	268	0	295
17089	2	6	274	17	0	299
17090	4	3	288	3	0	298
17091	10	3	17	266	0	296
17092	271	3	2	19	0	295
17093	19	277	2	4	0	302
17094	8	16	4	274	0	302
17095	1	6	271	19	0	297
17096	3	2	289	6	0	300
17097	7	0	19	275	0	301
17098	278	1	6	19	0	304
17099	285	4	2	8	0	299
17100	21	2	278	5	0	306
17101	278	0	18	3	0	299
17102	19	5	282	2	0	308
17103	9	5	15	260	0	289
17104	10	278	7	13	0	308
17105	288	16	2	6	0	312
17106	22	3	1	294	0	320
17107	9	1	2	306	0	318
17108	8	1	5	309	0	323
17109	2	3	5	310	0	320
17110	4	2	273	24	0	303
17111	4	280	19	6	0	309
17112	5	16	6	284	0	311
17113	276	5	2	24	0	307
17114	19	4	1	280	0	304
17115	10	2	4	292	0	308
17116	2	4	282	21	0	309
17117	4	4	282	6	0	296
17118	4	268	18	4	0	294
17119	2	286	7	6	0	301
17120	6	21	5	270	0	302
17121	270	6	4	21	0	301
17122	23	1	276	7	0	307
17123	5	278	18	4	0	305
17124	3	19	4	264	0	290
17125	2	277	4	17	0	300
17126	3	16	4	263	0	286
17127	3	265	2	18	0	288
17128	5	14	1	250	0	270
17129	243	3	2	13	0	261
17130	12	222	3	5	0	242
17131	2	6	1	189	0	198
17132	181	2	1	8	0	192
17133	6	178	0	4	0	188
17134	2	168	0	2	0	172
17135	3	170	1	0	0	174
17136	2	6	1	167	0	176
17137	1	1	0	162	0	164
17138	2	160	0	4	0	166
17139	1	4	0	160	0	165
17140	0	1	163	3	0	167
17141	1	162	3	2	0	168
17142	0	8	2	157	0	167
17143	2	161	0	1	0	164
17144	1	4	160	0	0	165
17145	1	148	2	1	0	152
17146	138	1	2	0	0	141
17147	3	1	1	132	0	137
17148	136	1	0	4	0	141
17149	1	0	133	2	0	136
17150	1	0	2	132	0	135
17151	0	2	137	2	0	141
17152	0	0	1	147	0	148
17153	150	1	1	3	0	155
17154	2	0	1	154	0	157
17155	159	1	0	2	0	162
17156	2	150	0	0	0	152
17157	149	2	0	1	0	152
17158	3	1	159	0	0	163
17159	1	177	3	0	0	181
17160	0	2	1	180	0	183
17161	0	0	1	179	0	180
17162	0	0	176	4	0	180
17163	1	180	2	2	0	185
17164	0	2	1	179	0	182
17165	1	179	0	2	0	182
17166	0	2	0	182	0	184
17167	1	176	0	2	0	179
17168	173	2	1	3	0	179
17169	2	2	0	174	0	178
17170	1	1	181	3	0	186
17171	0	184	2	2	0	188
17172	0	186	2	0	0	188
17173	1	3	182	0	0	186
17174	0	184	2	1	0	187
17175	0	2	1	184	0	187
17176	0	1	198	2	0	201
17177	0	0	2	191	0	193
17178	1	0	2	198	0	201
17179	0	1	195	3	0	199
17180	172	0	2	3	0	177
17181	3	1	1	198	0	203
17182	3	1	216	2	0	222
17183	0	226	3	2	0	231
17184	224	3	3	5	0	235
17185	2	222	4	1	0	229
17186	1	2	1	228	0	232
17187	230	2	0	5	0	237
17188	4	0	0	225	0	229
17189	3	1	235	2	0	241
17190	1	1	3	229	0	234
17191	1	1	230	3	0	235
17192	221	0	4	5	0	230
17193	2	3	233	0	0	238
17194	232	0	2	3	0	237
17195	228	3	0	4	0	235
17196	5	0	239	1	0	245
17197	3	1	222	1	0	227
17198	0	241	3	1	0	245
17199	249	3	1	3	0	256
17200	3	2	0	255	0	260
17201	1	1	2	248	0	252
17202	301	2	1	9	0	313
17203	311	0	1	5	0	317
17204	308	0	1	4	0	313
17205	308	1	0	4	0	313
17206	3	2	2	314	0	321
17207	315	0	2	8	0	325
17208	3	2	2	320	0	327
17209	2	0	0	325	0	327
17210	0	0	1	319	0	320
17211	0	0	317	6	0	323
17212	3	309	2	2	0	316
17213	1	316	1	0	0	318
17214	3	3	0	321	0	327
17215	320	1	1	3	0	325
17216	3	1	1	317	0	322
17217	312	1	0	5	0	318
17218	3	0	323	3	0	329
17219	306	1	3	3	0	313
17220	4	1	1	332	0	338
17221	346	0	1	3	0	350
17222	337	1	0	2	0	340
17223	342	1	1	4	0	348
17224	4	1	0	348	0	353
17225	3	0	346	2	0	351
17226	2	0	2	351	0	355
17227	349	0	3	5	0	357
17228	3	1	408	1	0	413
17229	6	1	3	440	0	450
17230	446	0	4	5	0	455
17231	3	2	453	2	0	460
17232	464	0	2	4	0	470
17233	487	0	3	3	0	493
17234	5	0	0	484	0	489
17235	5	0	1	492	0	498
17236	481	0	2	9	0	492
17237	4	0	0	495	0	499
17238	496	0	0	6	0	502
17239	5	492	3	3	0	503
17240	2	505	0	1	0	508
17241	2	4	0	511	0	517
17242	0	2	525	3	0	530
17243	0	520	3	4	0	527
17244	508	3	2	9	0	522
17245	3	517	1	0	0	521
17246	3	3	514	1	0	521
17247	3	3	2	498	0	506
17248	0	1	531	2	0	534
17249	1	545	2	2	0	550
17250	1	1	3	541	0	546
17251	1	535	4	1	0	541
17252	2	2	534	2	0	540
17253	3	2	1	517	0	523
17254	0	1	537	2	0	540
17255	2	0	2	531	0	535
17256	536	0	2	8	0	546
17257	2	0	522	2	0	526
17258	482	2	1	1	0	486
17259	2	0	528	1	0	531
17260	3	0	1	521	0	525
17261	0	0	548	2	0	550
17262	5	0	1	528	0	534
17263	2	0	3	535	0	540
17264	1	1	1	520	0	523
17265	3	1	1	534	0	539
17266	1	3	576	5	0	585
17267	548	1	2	7	0	558
17268	2	2	4	610	0	618
17269	602	1	0	4	0	607
17270	610	3	2	7	0	622
17271	613	3	1	7	0	624
17272	8	2	1	630	0	641
17273	6	1	2	638	0	647
17274	2	676	1	11	0	690
17275	725	9	2	6	0	742
17276	734	8	1	7	0	750
17277	738	3	2	11	0	754
17278	23	2	741	1	0	767
17279	12	1	14	747	0	774
17280	7	3	754	13	0	777
17281	721	0	16	13	0	750
17282	751	3	7	7	0	768
17283	20	1	3	747	0	771
17284	13	3	5	729	0	750
17285	6	763	4	18	0	791
17286	763	14	1	12	0	790
17287	772	7	4	10	0	793
17288	22	748	3	8	0	781
17289	766	17	2	7	0	792
17290	25	8	3	763	0	799
17291	16	7	1	774	0	798
17292	761	2	5	28	0	796
17293	18	3	754	11	0	786
17294	752	3	14	14	0	783
17295	770	0	6	13	0	789
17296	28	745	3	5	0	781
17297	762	14	4	11	0	791
17298	21	6	737	3	0	767
17299	16	2	15	741	0	774
17300	743	7	6	16	0	772
17301	29	2	3	742	0	776
17302	13	1	737	17	0	768
17303	10	0	14	717	0	741
17304	8	827	9	15	0	859
17305	6	17	3	844	0	870
17306	13	6	5	843	0	867
17307	10	4	2	820	0	836
17308	15	6	3	840	0	864
17309	5	8	830	28	0	871
17310	3	2	14	830	0	849
17311	824	3	10	32	0	869
17312	20	825	4	12	0	861
17313	17	14	6	846	0	883
17314	7	8	851	25	0	891
17315	12	4	17	849	0	882
17316	857	7	6	27	0	897
17317	853	1	7	18	0	879
17318	839	4	4	11	0	858
17319	27	4	4	838	0	873
17320	23	3	835	17	0	878
17321	13	818	18	14	0	863
17322	836	16	12	14	0	878
17323	24	6	5	834	0	869
17324	18	5	11	830	0	864
17325	12	6	822	30	0	870
17326	12	801	20	15	0	848
17327	8	836	10	14	0	868
17328	12	18	6	784	0	820
17329	8	11	764	22	0	805
17330	695	10	16	17	0	738
17331	25	5	737	7	0	774
17332	677	6	16	16	0	715
17333	20	752	15	8	0	795
17334	18	17	744	7	0	786
17335	730	6	22	11	0	769
17336	21	741	9	9	0	780
17337	771	13	6	8	0	798
17338	26	11	763	2	0	802
17339	15	772	15	7	0	809
17340	784	18	8	7	0	817
17341	22	12	771	5	0	810
17342	768	5	19	5	0	797
17343	18	3	9	767	0	797
17344	776	4	8	25	0	813
17345	32	3	5	773	0	813
17346	762	5	8	27	0	802
17347	24	3	784	15	0	826
17348	19	6	15	780	0	820
17349	10	4	9	791	0	814
17350	17	1	778	24	0	820
17351	7	5	23	756	0	791
17352	13	642	10	28	0	693
17353	8	15	7	820	0	850
17354	6	7	7	852	0	872
17355	15	1	10	916	0	942
17356	6	6	895	43	0	950
17357	880	5	28	25	0	938
17358	40	2	12	949	0	1003
17359	15	4	945	47	0	1011
17360	923	3	40	28	0	994
17361	982	0	14	19	0	1015
17362	1011	3	11	18	0	1043
17363	61	2	6	974	0	1043
17364	31	1	5	1077	0	1114
17365	12	6	8	1059	0	1085
17366	20	1016	5	60	0	1101
17367	989	48	5	31	0	1073
17368	1011	14	2	26	0	1053
17369	58	4	3	990	0	1055
17370	21	7	956	50	0	1034
17371	13	10	977	18	0	1018
17372	18	912	56	12	0	998
17373	12	962	18	15	0	1007
17374	860	48	11	16	0	935
17375	38	840	9	2	0	889
17376	830	36	5	4	0	875
17377	830	15	1	7	0	853
17378	843	5	3	6	0	857
17379	45	5	4	807	0	861
17380	23	6	2	856	0	887
17381	849	3	2	47	0	901
17382	52	2	2	846	0	902
17383	17	2	825	38	0	882
17384	837	1	32	25	0	895
17385	42	3	11	831	0	887
17386	24	2	1	860	0	887
17387	13	1	4	881	0	899
17388	8	0	829	48	0	885
17389	787	1	34	27	0	849
17390	38	4	824	12	0	878
17391	23	1	34	813	0	871
17392	4	6	831	40	0	881
17393	18	1	39	811	0	869
17394	11	3	15	862	0	891
17395	4	2	846	52	0	904
17396	9	1	39	785	0	834
17397	2	840	22	31	0	895
17398	854	35	5	17	0	911
17399	874	13	5	10	0	902
17400	52	1	7	844	0	904
17401	14	4	843	43	0	904
17402	8	811	35	18	0	872
17403	16	850	15	4	0	885
17404	787	40	1	15	0	843
17405	36	12	771	12	0	831
17406	778	5	38	11	0	832
17407	39	9	15	772	0	835
17408	33	5	2	797	0	837
17409	753	1	10	56	0	820
17410	37	750	11	17	0	815
17411	21	32	762	12	0	827
17412	12	12	34	764	0	822
17413	13	2	759	47	0	821
17414	12	759	41	20	0	832
17415	6	34	23	773	0	836
17416	761	13	8	47	0	829
17417	781	5	9	27	0	822
17418	57	7	754	8	0	826
17419	17	747	38	13	0	815
17420	748	32	18	14	0	812
17421	46	760	8	10	0	824
17422	21	38	12	755	0	826
17423	742	17	9	44	0	812
17424	46	11	4	750	0	811
17425	25	7	741	37	0	810
17426	16	7	35	751	0	809
17427	9	6	744	43	0	802
17428	18	6	36	740	0	800
17429	714	11	15	51	0	791
17430	41	726	8	23	0	798
17431	733	35	10	18	0	796
17432	40	16	12	722	0	790
17433	24	5	6	742	0	777
17434	11	9	645	58	0	723
17435	12	8	726	19	0	765
17436	15	709	40	11	0	775
17437	6	34	703	21	0	764
17438	634	12	42	20	0	708
17439	41	665	25	8	0	739
17440	16	702	7	6	0	731
17441	7	712	11	9	0	739
17442	15	44	7	669	0	735
17443	10	14	669	45	0	738
17444	6	672	42	20	0	740
17445	13	40	14	616	0	683
17446	7	687	6	39	0	739
17447	665	37	12	19	0	733
17448	686	17	8	10	0	721
17449	50	12	6	658	0	726
17450	25	7	8	677	0	717
17451	629	8	5	57	0	699
17452	41	614	8	24	0	687
17453	21	648	7	7	0	683
17454	11	41	7	557	0	616
17455	6	12	510	27	0	555
17456	6	495	24	14	0	539
17457	443	17	15	6	0	481
17458	21	418	3	9	0	451
17459	8	422	5	10	0	445
17460	397	18	4	4	0	423
17461	18	414	3	3	0	438
17462	4	16	399	4	0	423
17463	2	391	15	5	0	413
17464	284	7	10	3	0	304
17465	3	287	3	3	0	296
17466	289	10	1	2	0	302
17467	9	4	1	283	0	297
17468	4	5	0	293	0	302
17469	3	3	292	8	0	306
17470	2	289	5	4	0	300
17471	2	7	3	299	0	311
17472	295	3	3	8	0	309
17473	291	3	1	9	0	304
17474	11	296	3	3	0	313
17475	6	11	1	303	0	321
17476	306	2	1	10	0	319
17477	298	5	2	4	0	309
17478	8	6	292	2	0	308
17479	5	3	262	3	0	273
17480	2	1	285	1	0	289
17481	0	275	8	1	0	284
17482	255	10	5	0	0	270
17483	10	248	0	0	0	258
17484	250	8	1	1	0	260
17485	7	270	1	0	0	278
17486	0	7	0	287	0	294
17487	287	0	0	8	0	295
17488	5	2	283	1	0	291
17489	273	2	6	0	0	281
17490	289	0	1	1	0	291
17491	6	291	1	2	0	300
17492	2	303	1	0	0	306
17493	310	7	0	2	0	319
17494	6	2	333	3	0	344
17495	315	1	7	1	0	324
17496	332	0	1	1	0	334
17497	7	4	0	323	0	334
17498	321	1	1	10	0	333
17499	8	1	0	343	0	352
17500	6	0	1	353	0	360
17501	0	2	2	343	0	347
17502	2	340	1	6	0	349
17503	338	7	2	5	0	352
17504	350	4	0	3	0	357
17505	11	0	1	338	0	350
17506	2	4	0	337	0	343
17507	2	345	1	8	0	356
17508	344	9	0	2	0	355
17509	6	2	338	3	0	349
17510	5	2	4	339	0	350
17511	1	0	340	7	0	348
17512	4	1	5	337	0	347
17513	3	0	348	6	0	357
17514	1	1	8	326	0	336
17515	341	3	3	10	0	357
17516	8	0	359	2	0	369
17517	349	2	8	3	0	362
17518	10	401	1	0	0	412
17519	3	7	0	408	0	418
17520	1	1	0	415	0	417
17521	427	1	0	10	0	438
17522	7	1	0	453	0	461
17523	2	1	490	8	0	501
17524	467	0	6	6	0	479
17525	489	2	1	2	0	494
17526	498	0	0	2	0	500
17527	494	1	0	4	0	499
17528	9	482	0	1	0	492
17529	5	2	0	495	0	502
17530	497	2	1	7	0	507
17531	4	0	0	500	0	504
17532	502	0	1	4	0	507
17533	2	0	494	3	0	499
17534	3	0	495	0	0	498
17535	0	5	4	465	0	474
17536	0	487	2	4	0	493
17537	0	514	0	3	0	517
17538	505	5	1	2	0	513
17539	3	1	502	0	0	506
17540	456	0	3	3	0	462
17541	2	503	1	1	0	507
17542	505	2	0	3	0	510
17543	2	2	0	500	0	504
17544	2	0	545	2	0	549
17545	0	0	2	535	0	537
17546	2	0	3	539	0	544
17547	0	533	1	3	0	537
17548	1	553	1	1	0	556
17549	1	2	0	560	0	563
17550	2	566	0	3	0	571
17551	1	1	564	0	0	566
17552	0	3	537	1	0	541
17553	519	1	4	2	0	526
17554	555	1	1	5	0	562
17555	4	546	0	1	0	551
17556	4	2	1	541	0	548
17557	2	1	1	543	0	547
17558	0	0	544	4	0	548
17559	0	2	1	515	0	518
17560	0	528	2	1	0	531
17561	2	1	522	1	0	526
17562	1	1	511	0	0	513
17563	1	499	1	1	0	502
17564	0	2	515	1	0	518
17565	2	3	1	499	0	505
17566	5	0	2	464	0	471
17567	0	0	524	2	0	526
17568	3	0	1	503	0	507
17569	0	505	4	1	0	510
17570	0	509	0	2	0	511
17571	2	5	1	506	0	514
17572	0	1	511	2	0	514
17573	1	504	3	1	0	509
17574	1	2	2	506	0	511
17575	1	1	506	1	0	509
17576	462	1	2	3	0	468
17577	496	1	1	5	0	503
17578	490	0	1	4	0	495
17579	6	1	0	487	0	494
17580	4	0	0	479	0	483
17581	1	0	500	2	0	503
17582	2	0	2	496	0	500
17583	3	1	1	494	0	499
17584	2	2	488	3	0	495
17585	410	0	2	4	0	416
17586	2	453	3	0	0	458
17587	450	3	0	5	0	458
17588	4	440	1	3	0	448
17589	0	2	1	449	0	452
17590	3	1	440	2	0	446
17591	2	1	3	422	0	428
17592	2	0	426	2	0	430
17593	354	1	3	2	0	360
17594	2	0	412	2	0	416
17595	2	0	5	391	0	398
17596	0	2	409	5	0	416
17597	0	419	3	1	0	423
17598	1	4	1	434	0	440
17599	1	0	0	441	0	442
17600	1	1	0	444	0	446
17601	2	0	437	5	0	444
17602	0	2	440	0	0	442
17603	0	0	5	440	0	445
17604	3	0	1	522	0	526
17605	3	1	1	549	0	554
17606	550	0	2	21	0	573
17607	17	1	2	568	0	588
17608	4	2	581	19	0	606
17609	583	0	16	8	0	607
17610	22	1	6	605	0	634
17611	618	2	5	24	0	649
17612	644	0	2	12	0	658
17613	29	0	3	638	0	670
17614	632	0	0	29	0	661
17615	651	0	3	14	0	668
17616	29	3	629	5	0	666
17617	12	645	21	8	0	686
17618	12	17	7	627	0	663
17619	10	6	6	641	0	663
17620	624	2	5	33	0	664
17621	633	2	3	18	0	656
17622	631	2	3	16	0	652
17623	34	1	577	7	0	619
17624	15	590	20	4	0	629
17625	592	18	9	7	0	626
17626	27	597	5	7	0	636
17627	605	24	3	8	0	640
17628	33	7	6	588	0	634
17629	596	7	2	22	0	627
17630	618	2	4	13	0	637
17631	611	6	3	6	0	626
17632	36	2	597	7	0	642
17633	616	2	19	10	0	647
17634	34	616	9	4	0	663
17635	644	20	6	8	0	678
17636	663	10	3	9	0	685
17637	670	5	5	11	0	691
17638	37	4	4	632	0	677
17639	23	649	5	14	0	691
17640	653	25	1	11	0	690
17641	32	8	641	10	0	691
17642	20	656	21	5	0	702
17643	23	21	7	610	0	661
17644	14	644	7	16	0	681
17645	640	26	4	15	0	685
17646	669	11	9	10	0	699
17647	41	10	1	655	0	707
17648	20	3	638	26	0	687
17649	18	656	21	12	0	707
17650	22	21	8	567	0	618
17651	13	13	12	661	0	699
17652	19	9	3	679	0	710
17653	670	4	4	37	0	715
17654	685	10	3	20	0	718
17655	680	2	6	10	0	698
17656	711	7	2	8	0	728
17657	43	5	3	662	0	713
17658	29	4	691	24	0	748
17659	26	8	21	692	0	747
17660	22	2	9	710	0	743
17661	20	7	5	719	0	751
17662	20	7	3	721	0	751
17663	702	2	6	44	0	754
17664	42	9	4	703	0	758
17665	713	2	3	30	0	748
17666	728	4	6	20	0	758
17667	41	7	679	9	0	736
17668	29	2	679	9	0	719
17669	18	9	708	11	0	746
17670	23	1	32	683	0	739
17671	15	5	705	30	0	755
17672	17	6	29	686	0	738
17673	11	2	16	709	0	738
17674	711	8	10	35	0	764
17675	31	2	5	693	0	731
17676	16	731	7	32	0	786
17677	745	19	2	19	0	785
17678	37	734	3	17	0	791
17679	22	26	749	8	0	805
17680	19	754	25	11	0	809
17681	734	29	13	8	0	784
17682	37	10	7	725	0	779
17683	18	10	722	26	0	776
17684	715	8	29	17	0	769
17685	34	7	10	729	0	780
17686	21	3	730	29	0	783
17687	18	3	23	741	0	785
17688	18	2	10	745	0	775
17689	17	5	6	757	0	785
17690	17	710	8	36	0	771
17691	733	23	13	13	0	782
17692	29	13	5	713	0	760
17693	18	731	7	25	0	781
17694	10	26	6	736	0	778
17695	12	10	718	29	0	769
17696	14	720	24	16	0	774
17697	717	19	10	19	0	765
17698	703	12	8	11	0	734
17699	34	5	5	679	0	723
17700	19	5	8	687	0	719
17701	672	6	3	37	0	718
17702	665	7	2	20	0	694
17703	34	658	2	11	0	705
17704	564	10	4	6	0	584
17705	19	6	530	4	0	559
17706	8	2	523	5	0	538
17707	3	514	13	4	0	534
17708	3	522	5	2	0	532
17709	467	7	10	6	0	490
17710	5	480	2	4	0	491
17711	471	5	3	3	0	482
17712	471	2	0	2	0	475
17713	463	2	1	3	0	469
17714	10	0	0	461	0	471
17715	469	2	0	10	0	481
17716	9	0	462	0	0	471
17717	5	1	476	1	0	483
17718	4	475	5	0	0	484
17719	1	6	482	3	0	492
17720	3	2	6	457	0	468
17721	2	0	482	5	0	489
17722	1	1	468	1	0	471
17723	0	1	5	462	0	468
17724	469	2	2	11	0	484
17725	472	0	0	4	0	476
17726	6	2	485	4	0	497
17727	475	1	9	3	0	488
17728	6	2	507	2	0	517
17729	502	2	6	3	0	513
17730	527	0	2	3	0	532
17731	7	1	4	516	0	528
17732	6	0	1	493	0	500
17733	0	490	3	10	0	503
17734	2	507	4	0	0	513
17735	4	7	0	494	0	505
17736	2	0	0	498	0	500
17737	480	1	1	10	0	492
17738	6	469	0	2	0	477
17739	467	8	1	4	0	480
17740	10	475	1	5	0	491
17741	2	7	468	1	0	478
17742	4	1	6	455	0	466
17743	461	2	1	10	0	474
17744	476	4	2	4	0	486
17745	11	481	2	2	0	496
17746	6	491	1	1	0	499
17747	2	494	1	1	0	498
17748	4	10	0	530	0	544
17749	1	5	520	8	0	534
17750	1	534	8	3	0	546
17751	5	9	2	535	0	551
17752	4	4	1	542	0	551
17753	4	1	541	8	0	554
17754	1	2	519	5	0	527
17755	518	1	9	3	0	531
17756	7	1	546	2	0	556
17757	530	0	8	4	0	542
17758	524	2	5	4	0	535
17759	536	1	1	2	0	540
17760	526	0	3	2	0	531
17761	12	3	517	1	0	533
17762	6	511	6	2	0	525
17763	7	6	4	509	0	526
17764	2	3	512	7	0	524
17765	5	3	11	494	0	513
17766	2	460	6	7	0	475
17767	3	5	2	533	0	543
17768	5	4	2	527	0	538
17769	6	2	2	521	0	531
17770	512	1	3	14	0	530
17771	11	2	1	517	0	531
17772	9	2	3	515	0	529
17773	4	2	4	509	0	519
17774	3	493	3	11	0	510
17775	481	11	4	7	0	503
17776	8	463	3	6	0	480
17777	4	458	2	4	0	468
17778	3	11	2	465	0	481
17779	9	4	1	458	0	472
17780	455	2	1	11	0	469
17781	11	2	3	458	0	474
17782	458	0	2	14	0	474
17783	544	1	3	5	0	553
17784	18	1	2	527	0	548
17785	7	3	2	538	0	550
17786	6	551	1	9	0	567
17787	557	12	1	10	0	580
17788	11	574	1	5	0	591
17789	577	12	3	4	0	596
17790	13	6	558	7	0	584
17791	565	4	10	6	0	585
17792	583	5	5	3	0	596
17793	19	5	3	570	0	597
17794	8	2	562	18	0	590
17795	6	562	14	7	0	589
17796	7	15	5	575	0	602
17797	6	6	569	19	0	600
17798	10	4	15	567	0	596
17799	565	5	7	18	0	595
17800	17	1	559	11	0	588
17801	11	543	13	6	0	573
17802	5	566	6	7	0	584
17803	14	16	7	482	0	519
17804	7	565	2	12	0	586
17805	566	16	2	8	0	592
17806	561	6	2	12	0	581
17807	564	4	3	5	0	576
17808	19	6	544	2	0	571
17809	551	4	11	6	0	572
17810	20	5	6	550	0	581
17811	11	2	4	562	0	579
17812	9	5	5	555	0	574
17813	13	6	1	554	0	574
17814	9	2	534	22	0	567
17815	6	3	533	14	0	556
17816	9	3	519	7	0	538
17817	507	2	17	10	0	536
17818	16	514	10	9	0	549
17819	8	11	7	528	0	554
17820	519	10	1	23	0	553
17821	17	533	3	11	0	564
17822	6	543	5	4	0	558
17823	527	19	4	9	0	559
17824	531	9	5	6	0	551
17825	17	529	2	7	0	555
17826	18	15	2	509	0	544
17827	5	520	3	18	0	546
17828	527	11	0	6	0	544
17829	518	7	3	9	0	537
17830	518	5	1	8	0	532
17831	19	510	2	8	0	539
17832	15	12	3	517	0	547
17833	8	7	510	11	0	536
17834	10	7	10	508	0	535
17835	11	5	6	510	0	532
17836	7	2	512	15	0	536
17837	495	2	12	11	0	520
17838	21	0	6	501	0	528
17839	12	3	5	487	0	507
17840	2	493	6	18	0	519
17841	493	11	4	11	0	519
17842	11	6	2	477	0	496
17843	6	490	3	13	0	512
17844	456	11	4	16	0	487
17845	18	467	2	6	0	493
17846	443	17	1	6	0	467
17847	16	3	438	4	0	461
17848	5	9	380	2	0	396
17849	10	5	375	1	0	391
17850	3	370	13	5	0	391
17851	4	14	8	327	0	353
17852	7	358	1	7	0	373
17853	369	10	1	6	0	386
17854	11	0	369	3	0	383
17855	357	5	10	4	0	376
17856	370	1	2	6	0	379
17857	11	1	9	359	0	380
17858	360	5	4	13	0	382
17859	17	1	0	367	0	385
17860	2	3	370	11	0	386
17861	360	7	9	1	0	377
17862	11	366	2	2	0	381
17863	6	9	1	370	0	386
17864	369	6	1	10	0	386
17865	19	1	2	363	0	385
17866	7	1	368	11	0	387
17867	9	1	8	359	0	377
17868	2	365	8	9	0	384
17869	372	9	3	5	0	389
17870	13	3	3	369	0	388
17871	366	2	3	14	0	385
17872	11	0	4	367	0	382
17873	4	0	2	355	0	361
17874	4	362	7	5	0	378
17875	358	6	5	6	0	375
17876	8	385	4	2	0	399
17877	9	8	1	362	0	380
17878	2	373	1	8	0	384
17879	372	8	0	5	0	385
17880	371	0	0	4	0	375
17881	360	4	0	7	0	371
17882	7	355	2	0	0	364
17883	2	250	0	1	0	253
17884	242	7	1	1	0	251
17885	4	254	0	2	0	260
17886	3	7	0	239	0	249
17887	1	0	242	4	0	247
17888	216	0	3	1	0	220
17889	225	0	0	2	0	227
17890	223	0	1	2	0	226
17891	3	222	0	0	0	225
17892	215	2	0	3	0	220
17893	2	0	229	0	0	231
17894	0	229	2	0	0	231
17895	1	4	0	215	0	220
17896	0	224	0	2	0	226
17897	221	3	0	1	0	225
17898	2	231	0	0	0	233
17899	0	1	1	226	0	228
17900	1	235	0	1	0	237
17901	1	1	0	237	0	239
17902	2	0	0	233	0	235
17903	1	1	234	0	0	236
17904	1	0	1	229	0	231
17905	235	0	1	4	0	240
17906	233	0	1	3	0	237
17907	3	1	0	238	0	242
17908	1	0	238	2	0	241
17909	2	0	1	231	0	234
17910	230	0	0	7	0	237
17911	244	0	2	4	0	250
17912	247	0	0	6	0	253
17913	2	273	0	0	0	275
17914	268	0	0	2	0	270
17915	0	0	257	1	0	258
17916	281	0	1	4	0	286
17917	5	0	0	289	0	294
17918	2	1	1	293	0	297
17919	1	1	0	296	0	298
17920	293	1	0	2	0	296
17921	286	1	0	3	0	290
17922	2	0	0	289	0	291
17923	2	1	303	0	0	306
17924	2	0	0	299	0	301
17925	1	2	0	303	0	306
17926	2	0	305	0	0	307
17927	0	311	0	1	0	312
17928	2	1	0	321	0	324
17929	323	0	2	1	0	326
17930	1	2	0	318	0	321
17931	0	0	0	322	0	322
17932	324	0	1	1	0	326
17933	1	312	0	2	0	315
17934	1	320	0	2	0	323
17935	317	0	1	3	0	321
17936	1	4	316	0	0	321
17937	310	1	0	2	0	313
17938	1	1	358	0	0	360
17939	1	361	1	0	0	363
17940	366	1	0	3	0	370
17941	359	1	2	2	0	364
17942	355	2	0	3	0	360
17943	361	1	0	6	0	368
17944	1	2	358	2	0	363
17945	1	1	2	351	0	355
17946	354	0	1	5	0	360
17947	2	0	373	1	0	376
17948	2	1	365	1	0	369
17949	1	361	1	2	0	365
17950	374	1	2	3	0	380
17951	2	0	1	372	0	375
17952	360	1	0	2	0	363
17953	4	378	1	0	0	383
17954	3	1	0	404	0	408
17955	4	1	0	397	0	402
17956	1	1	0	408	0	410
17957	0	0	421	4	0	425
17958	1	407	2	1	0	411
17959	431	3	0	4	0	438
17960	6	0	1	433	0	440
17961	434	1	0	7	0	442
17962	420	1	0	9	0	430
17963	9	0	0	421	0	430
17964	3	0	436	5	0	444
17965	2	0	6	439	0	447
17966	0	434	3	8	0	445
17967	1	3	1	445	0	450
17968	0	2	438	5	0	445
17969	431	2	4	4	0	441
17970	5	0	2	439	0	446
17971	437	0	1	10	0	448
17972	5	0	437	4	0	446
17973	414	0	4	8	0	426
17974	6	1	429	0	0	436
17975	410	1	4	5	0	420
17976	4	420	3	0	0	427
17977	3	435	2	0	0	440
17978	3	5	1	435	0	444
17979	2	3	0	398	0	403
17980	1	1	1	432	0	435
17981	425	1	0	12	0	438
17982	6	0	0	435	0	441
17983	3	0	430	5	0	438
17984	420	0	3	7	0	430
17985	5	444	2	1	0	452
17986	445	4	2	7	0	458
17987	440	2	0	5	0	447
17988	7	1	443	0	0	451
17989	5	0	5	438	0	448
17990	4	1	3	468	0	476
17991	0	3	476	7	0	486
17992	2	462	5	3	0	472
17993	463	5	3	4	0	475
17994	488	2	1	3	0	494
17995	7	2	0	492	0	501
17996	5	3	0	482	0	490
17997	4	0	1	510	0	515
17998	493	0	0	13	0	506
17999	8	497	1	3	0	509
18000	503	9	1	2	0	515
18001	512	2	2	3	0	519
18002	11	0	504	2	0	517
18003	9	0	9	464	0	482
18004	2	503	3	11	0	519
18005	0	12	2	512	0	526
18006	6	3	1	527	0	537
18007	1	0	531	15	0	547
18008	546	1	11	5	0	563
18009	578	1	2	11	0	592
18010	603	0	2	5	0	610
18011	16	1	0	592	0	609
18012	9	0	0	580	0	589
18013	4	564	3	18	0	589
18014	3	605	2	4	0	614
18015	578	20	0	7	0	605
18016	17	574	1	3	0	595
18017	9	16	556	4	0	585
18018	7	5	15	569	0	596
18019	578	1	7	19	0	605
18020	19	1	560	7	0	587
18021	6	1	551	3	0	561
18022	555	1	19	6	0	581
18023	562	3	6	9	0	580
18024	22	0	5	550	0	577
18025	10	3	551	17	0	581
18026	14	2	16	546	0	578
18027	6	0	542	23	0	571
18028	2	3	554	9	0	568
18029	3	559	20	3	0	585
18030	557	19	6	9	0	591
18031	573	5	5	3	0	586
18032	21	565	3	2	0	591
18033	7	21	5	561	0	594
18034	7	5	0	585	0	597
18035	7	3	1	582	0	593
18036	564	1	4	31	0	600
18037	16	564	7	6	0	593
18038	557	15	1	9	0	582
18039	554	4	5	6	0	569
18040	23	1	537	3	0	564
18041	8	539	18	1	0	566
18042	11	15	5	546	0	577
18043	5	4	549	17	0	575
18044	535	3	19	9	0	566
18045	555	3	6	8	0	572
18046	562	3	2	7	0	574
18047	543	1	2	8	0	554
18048	32	5	1	529	0	567
18049	8	4	523	19	0	554
18050	12	0	14	528	0	554
18051	523	2	4	23	0	552
18052	528	0	4	17	0	549
18053	20	523	2	5	0	550
18054	518	13	1	7	0	539
18055	19	6	509	0	0	534
18056	11	4	502	3	0	520
18057	493	4	18	3	0	518
18058	21	492	8	4	0	525
18059	10	11	7	459	0	487
18060	6	459	1	18	0	484
18061	13	12	4	466	0	495
18062	11	4	1	468	0	484
18063	12	2	3	487	0	504
18064	474	2	0	24	0	500
18065	468	4	6	11	0	489
18066	474	2	3	7	0	486
18067	20	3	453	5	0	481
18068	448	1	16	3	0	468
18069	23	3	6	467	0	499
18070	9	5	4	498	0	516
18071	7	1	491	17	0	516
18072	12	6	16	496	0	530
18073	532	2	6	23	0	563
18074	16	4	531	8	0	559
18075	9	2	15	527	0	553
18076	533	3	6	17	0	559
18077	525	2	5	13	0	545
18078	22	0	536	10	0	568
18079	12	2	547	6	0	567
18080	13	2	16	552	0	583
18081	553	1	11	17	0	582
18082	566	2	6	10	0	584
18083	23	3	8	529	0	563
18084	18	548	2	17	0	585
18085	553	14	4	12	0	583
18086	18	554	11	12	0	595
18087	12	15	7	556	0	590
18088	12	6	545	20	0	583
18089	14	5	531	7	0	557
18090	8	4	544	6	0	562
18091	3	5	23	515	0	546
18092	11	1	9	535	0	556
18093	523	4	6	20	0	553
18094	19	506	6	12	0	543
18095	507	13	7	12	0	539
18096	18	8	7	491	0	524
18097	13	503	5	13	0	534
18098	6	520	3	8	0	537
18099	11	12	3	520	0	546
18100	509	8	4	13	0	534
18101	14	523	4	6	0	547
18102	492	11	6	6	0	515
18103	14	512	3	9	0	538
18104	498	10	7	6	0	521
18105	14	8	501	1	0	524
18106	7	9	491	3	0	510
18107	8	478	11	5	0	502
18108	441	12	9	5	0	467
18109	7	412	3	0	0	422
18110	3	395	2	2	0	402
18111	7	8	1	403	0	419
18112	407	3	2	5	0	417
18113	5	406	5	3	0	419
18114	395	6	1	5	0	407
18115	6	396	1	3	0	406
18116	396	7	1	1	0	405
18117	5	396	5	1	0	407
18118	2	401	2	3	0	408
18119	5	7	1	393	0	406
18120	6	400	1	3	0	410
18121	395	10	1	6	0	412
18122	5	5	398	2	0	410
18123	6	3	4	397	0	410
18124	5	4	413	3	0	425
18125	3	5	5	394	0	407
18126	3	3	0	407	0	413
18127	2	5	386	5	0	398
18128	351	2	4	4	0	361
18129	4	369	4	2	0	379
18130	379	4	4	5	0	392
18131	4	386	3	5	0	398
18132	3	6	3	390	0	402
18133	383	2	1	7	0	393
18134	378	1	2	7	0	388
18135	382	1	3	5	0	391
18136	7	3	3	374	0	387
18137	5	3	0	374	0	382
18138	5	387	1	5	0	398
18139	383	4	1	9	0	397
18140	386	2	2	3	0	393
18141	389	2	2	2	0	395
18142	383	2	0	5	0	390
18143	8	369	0	3	0	380
18144	6	6	0	383	0	395
18145	5	3	378	4	0	390
18146	359	3	4	4	0	370
18147	379	0	1	4	0	384
18148	10	3	365	1	0	379
18149	6	1	361	1	0	369
18150	2	5	5	362	0	374
18151	5	2	4	371	0	382
18152	4	2	4	374	0	384
18153	360	3	2	6	0	371
18154	7	1	1	366	0	375
18155	3	2	353	5	0	363
18156	3	1	8	354	0	366
18157	3	0	358	6	0	367
18158	5	1	5	357	0	368
18159	4	1	1	382	0	388
18160	4	2	379	6	0	391
18161	356	3	6	5	0	370
18162	6	385	3	6	0	400
18163	383	7	4	7	0	401
18164	15	4	2	389	0	410
18165	389	5	2	12	0	408
18166	12	386	2	4	0	404
18167	4	405	2	5	0	416
18168	9	17	2	414	0	442
18169	4	9	424	14	0	451
18170	3	3	407	7	0	420
18171	2	411	22	7	0	442
18172	350	16	9	4	0	379
18173	16	8	3	341	0	368
18174	336	4	1	18	0	359
18175	19	325	4	5	0	353
18176	5	349	5	4	0	363
18177	8	23	1	336	0	368
18178	330	11	0	17	0	358
18179	338	5	1	10	0	354
18180	21	3	322	5	0	351
18181	8	8	318	0	0	334
18182	312	4	20	3	0	339
18183	16	318	9	3	0	346
18184	318	13	2	4	0	337
18185	23	7	3	305	0	338
18186	6	5	304	13	0	328
18187	286	2	15	7	0	310
18188	16	296	8	3	0	323
18189	9	310	3	4	0	326
18190	8	17	3	293	0	321
18191	295	9	4	18	0	326
18192	15	3	3	305	0	326
18193	311	5	2	18	0	336
18194	22	3	294	6	0	325
18195	297	5	11	8	0	321
18196	316	1	8	6	0	331
18197	23	0	294	5	0	322
18198	280	3	15	5	0	303
18199	21	285	6	2	0	314
18200	12	14	4	284	0	314
18201	9	293	2	11	0	315
18202	298	14	4	10	0	326
18203	18	6	5	294	0	323
18204	8	293	3	14	0	318
18205	10	15	0	295	0	320
18206	3	307	2	13	0	325
18207	8	13	1	303	0	325
18208	296	8	1	20	0	325
18209	20	6	1	301	0	328
18210	9	2	290	18	0	319
18211	279	7	11	8	0	305
18212	18	2	5	294	0	319
18213	10	2	291	14	0	317
18214	6	1	273	10	0	290
18215	3	2	306	4	0	315
18216	4	4	23	289	0	320
18217	4	2	9	312	0	327
18218	8	2	5	322	0	337
18219	7	1	3	319	0	330
18220	308	2	4	21	0	335
18221	318	3	2	13	0	336
18222	324	1	2	10	0	337
18223	324	2	1	8	0	335
18224	25	0	2	316	0	343
18225	13	1	321	15	0	350
18226	314	0	15	11	0	340
18227	336	1	9	3	0	349
18228	26	0	3	325	0	354
18229	14	1	1	333	0	349
18230	333	0	3	22	0	358
18231	16	0	3	324	0	343
18232	12	319	5	16	0	352
18233	331	14	1	11	0	357
18234	335	5	1	15	0	356
18235	22	5	328	3	0	358
18236	17	0	14	314	0	345
18237	9	3	7	342	0	361
18238	320	1	4	24	0	349
18239	338	2	0	12	0	352
18240	25	1	4	321	0	351
18241	11	2	314	18	0	345
18242	9	2	315	9	0	335
18243	9	1	18	315	0	343
18244	11	1	10	329	0	351
18245	314	2	5	25	0	346
18246	17	302	3	14	0	336
18247	6	309	5	7	0	327
18248	9	331	2	4	0	346
18249	6	20	1	311	0	338
18250	310	10	2	16	0	338
18251	312	4	3	12	0	331
18252	20	308	3	4	0	335
18253	311	15	1	6	0	333
18254	16	8	2	307	0	333
18255	14	4	309	14	0	341
18256	12	1	12	310	0	335
18257	9	2	9	313	0	333
18258	5	4	7	305	0	321
18259	280	2	1	26	0	309
18260	18	1	4	270	0	293
18261	9	263	2	16	0	290
18262	256	9	2	9	0	276
18263	9	249	2	7	0	267
18264	7	237	2	6	0	252
18265	4	267	1	5	0	277
18266	4	4	250	5	0	263
18267	5	252	7	1	0	265
18268	4	3	218	0	0	225
18269	192	2	1	4	0	199
18270	200	0	2	5	0	207
18271	2	0	213	2	0	217
18272	213	0	2	2	0	217
18273	229	0	1	5	0	235
18274	2	0	235	1	0	238
18275	1	248	1	2	0	252
18276	2	0	1	257	0	260
18277	252	0	1	9	0	262
18278	1	1	0	259	0	261
18279	268	1	0	7	0	276
18280	271	1	0	2	0	274
18281	1	2	269	0	0	272
18282	263	0	0	3	0	266
18283	1	277	0	1	0	279
18284	284	0	0	3	0	287
18285	1	2	0	282	0	285
18286	2	0	285	0	0	287
18287	2	1	1	274	0	278
18288	277	0	1	2	0	280
18289	1	279	0	3	0	283
18290	0	0	280	1	0	281
18291	2	0	0	257	0	259
18292	2	0	271	0	0	273
18293	1	274	2	1	0	278
18294	274	1	0	1	0	276
18295	0	0	1	270	0	271
18296	0	2	276	0	0	278
18297	1	0	256	1	0	258
18298	262	2	0	1	0	265
18299	2	1	1	275	0	279
18300	0	0	0	275	0	275
18301	1	0	281	1	0	283
18302	1	1	265	0	0	267
18303	1	286	2	0	0	289
18304	1	1	0	295	0	297
18305	3	0	0	293	0	296
18306	1	296	1	1	0	299
18307	1	1	295	0	0	297
18308	271	1	1	2	0	275
18309	2	0	1	289	0	292
18310	1	1	300	1	0	303
18311	1	0	1	287	0	289
18312	2	294	0	1	0	297
18313	0	1	295	1	0	297
18314	275	0	3	2	0	280
18315	3	0	303	0	0	306
18316	1	1	291	0	0	293
18317	2	1	297	0	0	300
18318	0	1	309	1	0	311
18319	1	0	2	301	0	304
18320	0	0	324	4	0	328
18321	2	0	2	312	0	316
18322	0	320	1	3	0	324
18323	338	1	3	2	0	344
18324	5	3	0	352	0	360
18325	0	1	344	6	0	351
18326	1	336	5	1	0	343
18327	5	4	1	339	0	349
18328	339	1	2	9	0	351
18329	6	342	1	1	0	350
18330	5	3	1	351	0	360
18331	350	1	0	8	0	359
18332	5	1	343	3	0	352
18333	328	1	6	4	0	339
18334	8	0	341	0	0	349
18335	319	0	8	2	0	329
18336	325	0	2	2	0	329
18337	8	0	319	0	0	327
18338	3	319	7	0	0	329
18339	1	8	3	296	0	308
18340	0	1	322	9	0	332
18341	1	1	9	312	0	323
18342	3	0	1	316	0	320
18343	0	2	318	8	0	328
18344	2	0	309	2	0	313
18345	2	0	8	308	0	318
18346	307	0	4	11	0	322
18347	7	306	1	1	0	315
18348	2	311	0	2	0	315
18349	310	8	0	2	0	320
18350	318	4	0	1	0	323
18351	10	1	0	313	0	324
18352	4	0	0	321	0	325
18353	3	1	2	322	0	328
18354	314	0	0	11	0	325
18355	8	302	2	2	0	314
18356	4	317	0	2	0	323
18357	4	7	1	316	0	328
18358	1	4	2	315	0	322
18359	2	3	0	319	0	324
18360	306	0	0	15	0	321
18361	7	321	2	1	0	331
18362	324	6	0	4	0	334
18363	8	1	317	2	0	328
18364	1	315	10	0	0	326
18365	3	8	3	313	0	327
18366	310	1	2	10	0	323
18367	11	1	310	1	0	323
18368	2	3	306	1	0	312
18369	2	1	8	301	0	312
18370	2	0	3	310	0	315
18371	2	0	1	314	0	317
18372	3	1	2	298	0	304
18373	4	1	0	291	0	296
18374	0	291	0	15	0	306
18375	2	8	2	293	0	305
18376	279	5	1	10	0	295
18377	8	293	0	4	0	305
18378	289	8	0	3	0	300
18379	9	4	285	3	0	301
18380	2	2	280	3	0	287
18381	6	0	8	278	0	292
18382	2	2	359	8	0	371
18383	5	0	15	345	0	365
18384	2	0	7	360	0	369
18385	352	3	3	21	0	379
18386	365	1	0	8	0	374
18387	21	360	2	3	0	386
18388	6	389	2	2	0	399
18389	5	20	3	373	0	401
18390	371	9	1	18	0	399
18391	18	5	373	9	0	405
18392	9	0	17	375	0	401
18393	7	2	6	394	0	409
18394	1	3	382	22	0	408
18395	1	377	15	11	0	404
18396	7	17	5	371	0	400
18397	3	6	385	17	0	411
18398	1	6	17	379	0	403
18399	357	0	5	24	0	386
18400	16	358	8	8	0	390
18401	5	377	2	8	0	392
18402	4	19	1	370	0	394
18403	355	8	1	24	0	388
18404	18	364	1	6	0	389
18405	364	15	1	9	0	389
18406	20	6	353	3	0	382
18407	6	3	372	5	0	386
18408	7	2	22	345	0	376
18409	2	2	9	384	0	397
18410	370	1	4	23	0	398
18411	21	5	2	376	0	404
18412	8	3	369	21	0	401
18413	9	3	19	371	0	402
18414	5	3	7	390	0	405
18415	3	3	365	26	0	397
18416	344	1	19	13	0	377
18417	20	1	7	371	0	399
18418	353	2	6	24	0	385
18419	20	339	2	10	0	371
18420	336	18	1	9	0	364
18421	20	341	3	6	0	370
18422	7	360	3	3	0	373
18423	3	21	3	318	0	345
18424	309	9	4	14	0	336
18425	323	4	1	8	0	336
18426	21	2	0	309	0	332
18427	315	3	2	15	0	335
18428	327	2	0	6	0	335
18429	20	2	2	311	0	335
18430	306	3	3	11	0	323
18431	13	307	2	6	0	328
18432	314	11	3	8	0	336
18433	18	5	323	2	0	348
18434	336	4	10	6	0	356
18435	18	1	5	336	0	360
18436	9	1	3	354	0	367
18437	5	2	4	352	0	363
18438	4	2	0	348	0	354
18439	6	1	1	346	0	354
18440	2	308	3	18	0	331
18441	5	340	2	9	0	356
18442	330	15	4	6	0	355
18443	16	7	326	2	0	351
18444	323	7	13	4	0	347
18445	17	2	331	3	0	353
18446	6	3	15	325	0	349
18447	6	2	5	347	0	360
18448	333	0	4	21	0	358
18449	14	6	327	9	0	356
18450	10	3	12	329	0	354
18451	7	2	353	14	0	376
18452	6	364	14	8	0	392
18453	6	11	5	376	0	398
18454	373	6	4	16	0	399
18455	358	5	2	10	0	375
18456	367	2	4	13	0	386
18457	25	357	1	3	0	386
18458	8	376	4	3	0	391
18459	357	17	2	8	0	384
18460	12	367	1	7	0	387
18461	7	376	1	5	0	389
18462	3	18	356	6	0	383
18463	5	348	11	4	0	368
18464	2	358	5	4	0	369
18465	4	17	4	352	0	377
18466	1	10	350	14	0	375
18467	8	7	341	3	0	359
18468	326	3	18	4	0	351
18469	16	2	353	3	0	374
18470	353	1	17	5	0	376
18471	18	1	4	347	0	370
18472	3	357	6	16	0	382
18473	377	11	1	10	0	399
18474	394	4	6	8	0	412
18475	15	4	2	390	0	411
18476	7	1	6	392	0	406
18477	8	3	1	393	0	405
18478	383	0	1	23	0	407
18479	381	1	4	10	0	396
18480	384	1	1	8	0	394
18481	20	363	1	4	0	388
18482	287	4	0	2	0	293
18483	6	290	2	0	0	298
18484	3	289	0	1	0	293
18485	3	4	1	271	0	279
18486	4	269	0	5	0	278
18487	266	2	0	0	0	268
18488	3	0	0	265	0	268
18489	266	1	0	4	0	271
18490	2	260	1	0	0	263
18491	1	275	0	0	0	276
18492	275	1	1	3	0	280
18493	4	288	1	0	0	293
18494	0	2	1	292	0	295
18495	0	1	2	284	0	287
18496	281	0	0	6	0	287
18497	7	0	0	281	0	288
18498	1	0	287	4	0	292
18499	2	0	4	285	0	291
18500	287	0	1	5	0	293
18501	4	293	0	0	0	297
18502	308	3	0	3	0	314
18503	308	0	0	2	0	310
18504	304	1	0	2	0	307
18505	6	0	306	0	0	312
18506	1	2	298	0	0	301
18507	293	1	4	0	0	298
18508	4	297	1	0	0	302
18509	1	4	0	300	0	305
18510	2	2	0	295	0	299
18511	0	284	1	5	0	290
18512	1	295	0	1	0	297
18513	1	4	0	292	0	297
18514	1	1	0	301	0	303
18515	0	0	289	6	0	295
18516	1	0	274	1	0	276
18517	280	0	5	2	0	287
18518	295	0	2	2	0	299
18519	7	1	1	283	0	292
18520	2	0	291	6	0	299
18521	6	1	4	279	0	290
18522	285	1	1	7	0	294
18523	6	2	294	2	0	304
18524	3	0	5	296	0	304
18525	1	0	297	6	0	304
18526	0	297	6	3	0	306
18527	1	5	298	2	0	306
18528	3	0	3	279	0	285
18529	290	4	1	3	0	298
18530	5	2	0	304	0	311
18531	293	0	0	7	0	300
18532	305	2	0	2	0	309
18533	285	2	2	4	0	293
18534	5	0	286	2	0	293
18535	291	1	4	2	0	298
18536	8	1	1	294	0	304
18537	1	0	1	302	0	304
18538	1	0	299	6	0	306
18539	3	0	4	288	0	295
18540	295	0	1	7	0	303
18541	4	299	3	2	0	308
18542	306	4	0	6	0	316
18543	309	1	2	2	0	314
18544	308	1	2	1	0	312
18545	6	0	1	306	0	313
18546	2	0	320	5	0	327
18547	1	1	4	324	0	330
18548	0	0	2	327	0	329
18549	329	0	0	10	0	339
18550	318	0	0	5	0	323
18551	7	3	307	1	0	318
18552	3	0	6	306	0	315
18553	2	0	308	6	0	316
18554	299	1	5	2	0	307
18555	5	339	3	1	0	348
18556	341	5	2	2	0	350
18557	8	346	0	1	0	355
18558	343	7	0	5	0	355
18559	7	342	1	0	0	350
18560	5	7	0	344	0	356
18561	3	1	0	349	0	353
18562	349	2	0	11	0	362
18563	350	1	0	3	0	354
18564	338	0	1	7	0	346
18565	336	0	0	7	0	343
18566	332	0	1	1	0	334
18567	9	0	1	325	0	335
18568	4	318	1	6	0	329
18569	3	7	1	315	0	326
18570	4	321	1	8	0	334
18571	4	7	1	311	0	323
18572	4	317	1	5	0	327
18573	1	10	0	318	0	329
18574	3	1	301	7	0	312
18575	282	3	5	6	0	296
18576	8	307	2	3	0	320
18577	306	7	2	4	0	319
18578	10	4	295	1	0	310
18579	295	1	8	2	0	306
18580	9	3	309	2	0	323
18581	6	1	8	308	0	323
18582	5	334	2	10	0	351
18583	4	9	336	3	0	352
18584	4	3	9	339	0	355
18585	327	3	2	13	0	345
18586	11	3	1	344	0	359
18587	4	1	1	353	0	359
18588	4	3	0	356	0	363
18589	2	3	336	17	0	358
18590	4	2	10	330	0	346
18591	3	330	3	11	0	347
18592	4	9	3	333	0	349
18593	7	5	1	332	0	345
18594	325	5	0	14	0	344
18595	15	3	0	328	0	346
18596	4	2	338	12	0	356
18597	6	0	335	6	0	347
18598	3	1	333	4	0	341
18599	3	326	11	3	0	343
18600	324	9	4	2	0	339
18601	10	318	3	2	0	333
18602	311	10	3	5	0	329
18603	12	2	1	312	0	327
18604	4	2	303	12	0	321
18605	2	5	297	4	0	308
18606	2	303	11	5	0	321
18607	2	11	6	302	0	321
18608	4	2	4	313	0	323
18609	4	6	2	306	0	318
18610	4	4	302	11	0	321
18611	287	2	9	9	0	307
18612	10	3	305	5	0	323
18613	9	2	11	295	0	317
18614	7	4	6	305	0	322
18615	3	1	297	15	0	316
18616	279	3	7	10	0	299
18617	10	298	7	4	0	319
18618	307	7	5	9	0	328
18619	14	6	2	294	0	316
18620	4	304	6	10	0	324
18621	5	9	1	313	0	328
18622	304	4	1	18	0	327
18623	8	3	5	309	0	325
18624	5	1	292	15	0	313
18625	292	5	11	4	0	312
18626	295	0	7	5	0	307
18627	9	3	299	6	0	317
18628	7	4	9	301	0	321
18629	301	2	4	12	0	319
18630	14	3	2	295	0	314
18631	7	1	3	306	0	317
18632	4	0	4	301	0	309
18633	2	2	3	302	0	309
18634	6	1	291	11	0	309
18635	5	2	10	289	0	306
18636	3	5	290	14	0	312
18637	282	1	10	10	0	303
18638	292	1	7	9	0	309
18639	292	2	3	8	0	305
18640	292	3	6	8	0	309
18641	15	0	2	281	0	298
18642	275	1	4	13	0	293
18643	8	3	275	9	0	295
18644	4	0	265	8	0	277
18645	256	1	9	9	0	275
18646	10	256	8	4	0	278
18647	6	249	6	6	0	267
18648	7	9	2	250	0	268
18649	4	4	245	12	0	265
18650	240	2	6	13	0	261
18651	6	2	254	9	0	271
18652	5	235	11	6	0	257
18653	6	6	240	2	0	254
18654	3	218	8	4	0	233
18655	195	8	5	3	0	211
18656	4	196	2	4	0	206
18657	6	192	1	3	0	202
18658	5	7	0	192	0	204
18659	5	2	190	5	0	202
18660	1	2	5	186	0	194
18661	3	1	8	189	0	201
18662	1	3	185	8	0	197
18663	4	2	8	175	0	189
18664	3	181	3	6	0	193
18665	4	7	2	181	0	194
18666	183	4	0	9	0	196
18667	8	1	2	184	0	195
18668	5	0	183	8	0	196
18669	4	0	6	183	0	193
18670	3	1	186	6	0	196
18671	173	1	5	8	0	187
18672	5	2	7	190	0	204
18673	186	1	2	12	0	201
18674	8	3	185	3	0	199
18675	172	4	6	3	0	185
18676	6	181	4	3	0	194
18677	2	4	185	5	0	196
18678	4	5	7	182	0	198
18679	5	0	197	7	0	209
18680	3	175	6	6	0	190
18681	4	175	5	1	0	185
18682	132	5	1	4	0	142
18683	6	153	0	0	0	159
18684	148	1	2	1	0	152
18685	5	2	1	143	0	151
18686	3	1	144	4	0	152
18687	1	148	4	2	0	155
18688	1	3	1	150	0	155
18689	1	2	2	157	0	162
18690	3	1	1	157	0	162
18691	2	1	0	153	0	156
18692	3	145	2	5	0	155
18693	0	153	0	3	0	156
18694	144	3	2	1	0	150
18695	3	144	0	1	0	148
18696	2	1	1	134	0	138
18697	1	1	128	2	0	132
18698	1	133	1	1	0	136
18699	0	0	1	134	0	135
18700	1	1	1	127	0	130
18701	0	134	1	1	0	136
18702	130	0	0	1	0	131
18703	1	1	125	0	0	127
18704	126	0	1	0	0	127
18705	0	126	1	0	0	127
18706	123	0	0	1	0	124
18707	0	126	0	0	0	126
18708	1	0	0	131	0	132
18709	0	1	0	129	0	130
18710	127	0	0	2	0	129
18711	0	0	0	131	0	131
18712	1	0	128	0	0	129
18713	0	126	0	1	0	127
18714	0	125	1	1	0	127
18715	0	1	0	125	0	126
18716	0	2	127	0	0	129
18717	1	0	0	125	0	126
18718	0	2	1	123	0	126
18719	0	0	125	2	0	127
18720	0	0	114	1	0	115
18721	0	122	1	0	0	123
18722	124	0	1	1	0	126
18723	0	1	0	121	0	122
18724	1	122	0	0	0	123
18725	127	0	0	3	0	130
18726	0	1	0	128	0	129
18727	2	0	0	121	0	123
18728	0	122	0	1	0	123
18729	1	0	0	123	0	124
18730	121	2	0	3	0	126
18731	0	0	0	126	0	126
18732	1	0	0	127	0	128
18733	1	0	126	1	0	128
18734	1	1	108	2	0	112
18735	118	2	2	0	0	122
18736	0	2	1	117	0	120
18737	2	1	1	118	0	122
18738	0	1	0	121	0	122
18739	1	0	116	2	0	119
18740	117	0	1	2	0	120
18741	0	0	3	117	0	120
18742	1	1	0	119	0	121
18743	118	0	1	2	0	121
18744	0	122	0	3	0	125
18745	2	2	112	1	0	117
18746	2	1	0	116	0	119
18747	0	113	1	1	0	115
18748	1	1	0	119	0	121
18749	116	2	0	1	0	119
18750	0	1	0	117	0	118
18751	114	1	0	1	0	116
18752	110	0	1	3	0	114
18753	2	1	0	106	0	109
18754	1	106	1	2	0	110
18755	0	111	1	3	0	115
18756	1	2	110	0	0	113
18757	2	1	1	103	0	107
18758	1	0	2	106	0	109
18759	1	0	0	111	0	112
18760	108	1	1	2	0	112
18761	2	0	0	110	0	112
18762	1	1	113	1	0	116
18763	108	0	0	3	0	111
18764	1	0	1	112	0	114
18765	3	1	0	114	0	118
18766	1	0	111	2	0	114
18767	109	1	1	2	0	113
18768	0	1	1	111	0	113
18769	1	1	115	2	0	119
18770	0	0	0	115	0	115
18771	1	0	2	105	0	108
18772	1	123	0	2	0	126
18773	122	0	0	4	0	126
18774	123	1	1	2	0	127
18775	3	121	1	0	0	125
18776	120	2	0	2	0	124
18777	115	1	1	2	0	119
18778	0	2	0	124	0	126
18779	0	2	122	0	0	124
18780	0	0	112	3	0	115
18781	1	0	116	1	0	118
18782	0	0	116	3	0	119
18783	1	1	1	114	0	117
18784	1	0	2	116	0	119
18785	1	0	2	114	0	117
18786	3	1	0	116	0	120
18787	116	0	1	1	0	118
18788	1	117	0	2	0	120
18789	117	1	1	1	0	120
18790	2	1	116	0	0	119
18791	0	0	136	2	0	138
18792	0	0	0	140	0	140
18793	139	2	0	0	0	141
18794	137	0	0	2	0	139
18795	2	136	0	1	0	139
18796	0	139	0	2	0	141
18797	2	0	0	138	0	140
18798	141	1	1	0	0	143
18799	2	140	1	0	0	143
18800	142	0	1	0	0	143
18801	145	0	2	3	0	150
18802	145	0	1	1	0	147
18803	1	0	150	1	0	152
18804	1	148	1	0	0	150
18805	149	1	0	0	0	150
18806	146	0	0	1	0	147
18807	0	143	0	2	0	145
18808	1	143	0	0	0	144
18809	144	1	0	0	0	145
18810	2	0	0	140	0	142
18811	1	1	147	0	0	149
18812	147	0	0	0	0	147
18813	0	0	1	155	0	156
18814	0	161	0	0	0	161
18815	1	0	0	163	0	164
18816	1	0	164	0	0	165
18817	1	1	0	165	0	167
18818	168	1	0	3	0	172
18819	2	0	0	171	0	173
18820	0	0	0	172	0	172
18821	0	0	185	0	0	185
18822	0	0	0	184	0	184
18823	0	187	0	2	0	189
18824	183	1	0	3	0	187
18825	178	0	0	1	0	179
18826	0	1	188	0	0	189
18827	0	0	0	176	0	176
18828	1	185	1	0	0	187
18829	0	180	0	1	0	181
18830	183	0	0	2	0	185
18831	0	0	1	189	0	190
18832	0	0	188	1	0	189
18833	0	1	179	0	0	180
18834	2	0	0	187	0	189
18835	186	0	0	5	0	191
18836	186	0	1	0	0	187
18837	1	1	0	190	0	192
18838	0	2	199	0	0	201
18839	0	200	1	0	0	201
18840	193	0	0	2	0	195
18841	1	198	0	1	0	200
18842	200	1	1	0	0	202
18843	1	0	1	201	0	203
18844	1	0	199	1	0	201
18845	2	0	0	200	0	202
18846	203	0	1	0	0	204
18847	0	1	196	1	0	198
18848	1	194	1	0	0	196
18849	1	0	0	199	0	200
18850	195	1	0	3	0	199
18851	0	1	198	0	0	199
18852	2	0	0	195	0	197
18853	0	0	0	204	0	204
18854	0	1	203	0	0	204
18855	1	0	1	195	0	197
18856	1	0	195	1	0	197
18857	179	1	2	1	0	183
18858	2	1	1	205	0	209
18859	0	0	218	1	0	219
18860	1	217	0	3	0	221
18861	227	0	1	1	0	229
18862	249	1	0	5	0	255
18863	2	1	0	275	0	278
18864	1	282	3	1	0	287
18865	281	1	0	3	0	285
18866	3	2	1	282	0	288
18867	3	2	287	1	0	293
18868	274	0	1	2	0	277
18869	1	281	4	1	0	287
18870	2	2	1	278	0	283
18871	282	1	0	3	0	286
18872	3	2	280	0	0	285
18873	2	1	275	1	0	279
18874	4	2	2	276	0	284
18875	1	0	290	3	0	294
18876	4	1	2	270	0	277
18877	1	283	3	2	0	289
18878	4	1	1	291	0	297
18879	289	3	1	2	0	295
18880	3	0	285	3	0	291
18881	2	286	3	1	0	292
18882	1	3	4	281	0	289
18883	2	1	307	3	0	313
18884	0	2	2	290	0	294
18885	1	298	2	1	0	302
18886	2	304	1	2	0	309
18887	300	2	2	5	0	309
18888	3	308	2	2	0	315
18889	2	3	302	1	0	308
18890	280	0	4	5	0	289
18891	4	1	308	0	0	313
18892	5	0	1	282	0	288
18893	0	1	315	2	0	318
18894	1	319	2	1	0	323
18895	2	3	1	324	0	330
18896	4	1	0	319	0	324
18897	2	1	1	312	0	316
18898	2	1	329	2	0	334
18899	2	0	2	318	0	322
18900	4	0	2	329	0	335
18901	320	0	2	9	0	331
18902	317	1	0	6	0	324
18903	2	1	321	1	0	325
18904	1	323	1	2	0	327
18905	1	1	329	1	0	332
18906	3	1	3	321	0	328
18907	0	3	340	2	0	345
18908	0	0	1	332	0	333
18909	1	0	2	334	0	337
18910	1	0	340	3	0	344
18911	309	1	2	4	0	316
18912	1	348	3	0	0	352
18913	4	1	0	345	0	350
18914	0	4	369	2	0	375
18915	0	0	365	2	0	367
18916	345	1	3	3	0	352
18917	1	372	4	2	0	379
18918	3	1	1	376	0	381
18919	375	2	1	2	0	380
18920	4	2	0	368	0	374
18921	5	0	0	381	0	386
18922	0	0	390	5	0	395
18923	370	1	2	3	0	376
18924	392	0	4	3	0	399
18925	4	1	1	396	0	402
18926	393	0	1	4	0	398
18927	5	1	0	392	0	398
18928	4	365	0	2	0	371
18929	1	386	2	5	0	394
18930	1	3	2	397	0	403
18931	394	4	2	1	0	401
18932	2	0	1	396	0	399
18933	396	0	2	5	0	403
18934	392	0	1	5	0	398
18935	7	0	0	393	0	400
18936	5	1	1	382	0	389
18937	3	1	396	5	0	405
18938	1	2	400	6	0	409
18939	3	0	6	395	0	404
18940	1	1	435	2	0	439
18941	415	0	2	9	0	426
18942	2	0	5	449	0	456
18943	4	0	463	4	0	471
18944	451	2	3	7	0	463
18945	477	1	5	5	0	488
18946	8	505	2	2	0	517
18947	5	5	0	531	0	541
18948	2	5	548	5	0	560
18949	548	2	5	7	0	562
18950	555	1	4	8	0	568
18951	10	1	572	2	0	585
18952	570	0	6	5	0	581
18953	9	1	4	563	0	577
18954	6	2	2	575	0	585
18955	565	0	2	15	0	582
18956	558	0	1	9	0	568
18957	14	0	3	555	0	572
18958	7	0	562	7	0	576
18959	3	553	4	6	0	566
18960	3	3	559	2	0	567
18961	2	3	545	1	0	551
18962	0	530	9	2	0	541
18963	4	6	5	493	0	508
18964	4	3	4	498	0	509
18965	0	2	500	9	0	511
18966	2	0	4	488	0	494
18967	503	3	4	6	0	516
18968	4	1	510	7	0	522
18969	511	0	6	3	0	520
18970	520	1	3	4	0	528
18971	525	0	2	3	0	530
18972	11	1	512	2	0	526
18973	8	1	505	1	0	515
18974	6	2	8	493	0	509
18975	2	0	4	490	0	496
18976	2	502	6	6	0	516
18977	505	4	2	8	0	519
18978	503	3	0	3	0	509
18979	10	505	2	1	0	518
18980	510	6	0	8	0	524
18981	9	509	1	2	0	521
18982	505	7	2	5	0	519
18983	9	4	1	494	0	508
18984	5	2	505	5	0	517
18985	4	2	503	4	0	513
18986	4	0	8	503	0	515
18987	0	1	6	501	0	508
18988	2	0	520	9	0	531
18989	4	0	6	508	0	518
18990	4	0	4	513	0	521
18991	520	1	1	10	0	532
18992	521	0	3	9	0	533
18993	522	0	2	6	0	530
18994	11	0	510	3	0	524
18995	8	514	6	2	0	530
18996	7	5	4	524	0	540
18997	3	3	530	6	0	542
18998	0	535	7	4	0	546
18999	529	6	5	8	0	548
19000	9	4	1	532	0	546
19001	4	4	2	537	0	547
19002	534	1	1	11	0	547
19003	6	1	1	529	0	537
19004	5	1	1	517	0	524
19005	519	0	1	12	0	532
19006	7	0	512	5	0	524
19007	4	513	6	5	0	528
19008	514	5	3	6	0	528
19009	8	2	534	2	0	546
19010	507	2	7	5	0	521
19011	8	538	3	1	0	550
19012	532	5	1	2	0	540
19013	522	2	4	4	0	532
19014	513	2	1	3	0	519
19015	11	1	0	502	0	514
19016	9	0	0	490	0	499
19017	5	500	2	7	0	514
19018	2	501	2	5	0	510
19019	1	512	0	5	0	518
19020	502	9	0	6	0	517
19021	7	5	500	0	0	512
19022	2	4	5	499	0	510
19023	5	1	3	501	0	510
19024	1	498	1	7	0	507
19025	2	5	3	500	0	510
19026	2	1	1	492	0	496
19027	0	506	1	6	0	513
19028	499	6	0	9	0	514
19029	4	508	0	5	0	517
19030	1	7	499	1	0	508
19031	492	2	5	3	0	502
19032	8	511	2	1	0	522
19033	501	6	2	4	0	513
19034	11	0	1	494	0	506
19035	6	1	0	496	0	503
19036	2	1	493	5	0	501
19037	2	0	493	1	0	496
19038	1	1	6	475	0	483
19039	480	0	1	6	0	487
19040	455	0	3	3	0	461
19041	6	479	1	1	0	487
19042	1	467	0	3	0	471
19043	1	451	2	1	0	455
19044	3	8	1	441	0	453
19045	431	0	4	6	0	441
19046	424	0	0	3	0	427
19047	422	0	0	2	0	424
19048	8	0	404	0	0	412
19049	2	491	6	1	0	500
19050	1	9	2	537	0	549
19051	536	2	0	14	0	552
19052	17	2	0	532	0	551
19053	8	0	0	554	0	562
19054	548	0	0	15	0	563
19055	571	0	1	6	0	578
19056	18	0	566	3	0	587
19057	11	0	15	566	0	592
19058	3	0	561	15	0	579
19059	1	0	15	564	0	580
19060	3	0	554	16	0	573
19061	5	3	18	548	0	574
19062	532	0	5	25	0	562
19063	18	539	3	5	0	565
19064	4	577	1	4	0	586
19065	8	22	0	508	0	538
19066	3	572	1	17	0	593
19067	569	19	0	8	0	596
19068	567	5	3	5	0	580
19069	22	1	550	4	0	577
19070	8	534	23	0	0	565
19071	7	13	5	549	0	574
19072	1	5	545	20	0	571
19073	531	2	19	11	0	563
19074	21	0	6	545	0	572
19075	7	5	551	17	0	580
19076	12	3	17	540	0	572
19077	544	2	7	21	0	574
19078	17	4	536	7	0	564
19079	542	0	17	5	0	564
19080	553	1	5	2	0	561
19081	26	0	3	541	0	570
19082	8	4	532	18	0	562
19083	3	3	541	8	0	555
19084	515	1	22	6	0	544
19085	546	1	8	2	0	557
19086	23	1	526	4	0	554
19087	10	1	18	524	0	553
19088	5	1	6	526	0	538
19089	2	524	4	21	0	551
19090	4	17	3	546	0	570
19091	542	5	1	21	0	569
19092	21	2	2	537	0	562
19093	7	1	531	24	0	563
19094	531	0	20	8	0	559
19095	19	2	5	524	0	550
19096	9	1	526	15	0	551
19097	7	512	19	6	0	544
19098	488	17	8	3	0	516
19099	19	526	3	5	0	553
19100	528	19	1	8	0	556
19101	20	8	508	2	0	538
19102	7	491	19	6	0	523
19103	6	519	9	2	0	536
19104	6	22	2	510	0	540
19105	7	7	4	524	0	542
19106	6	2	503	25	0	536
19107	7	2	20	504	0	533
19108	501	3	7	21	0	532
19109	15	5	493	10	0	523
19110	12	0	18	484	0	514
19111	8	3	495	19	0	525
19112	474	0	23	8	0	505
19113	21	492	7	4	0	524
19114	492	17	6	5	0	520
19115	508	10	5	4	0	527
19116	505	4	5	6	0	520
19117	26	0	470	6	0	502
19118	9	475	21	2	0	507
19119	5	17	5	472	0	499
19120	11	6	6	494	0	517
19121	496	3	6	27	0	532
19122	30	4	3	508	0	545
19123	505	1	3	27	0	536
19124	518	2	4	10	0	534
19125	503	2	5	9	0	519
19126	523	4	3	2	0	532
19127	40	2	3	484	0	529
19128	494	2	2	23	0	521
19129	29	1	459	9	0	498
19130	467	4	23	7	0	501
19131	489	2	11	6	0	508
19132	30	5	458	7	0	500
19133	475	0	21	5	0	501
19134	494	0	6	6	0	506
19135	34	0	8	453	0	495
19136	19	2	3	480	0	504
19137	460	5	1	29	0	495
19138	29	1	5	452	0	487
19139	16	1	3	457	0	477
19140	10	430	2	23	0	465
19141	8	15	5	414	0	442
19142	400	5	3	20	0	428
19143	30	2	0	396	0	428
19144	12	1	2	394	0	409
19145	6	380	1	19	0	406
19146	3	14	1	369	0	387
19147	6	3	1	378	0	388
19148	355	2	2	22	0	381
19149	15	5	3	246	0	269
19150	5	0	198	13	0	216
19151	3	184	8	3	0	198
19152	2	184	3	3	0	192
19153	168	13	1	3	0	185
19154	10	168	1	0	0	179
19155	130	9	1	4	0	144
19156	7	130	2	1	0	140
19157	132	12	0	0	0	144
19158	9	2	0	135	0	146
19159	5	0	0	140	0	145
19160	2	135	0	9	0	146
19161	0	8	0	141	0	149
19162	0	2	139	10	0	151
19163	138	2	6	3	0	149
19164	7	147	1	4	0	159
19165	145	6	2	2	0	155
19166	149	2	0	3	0	154
19167	147	2	1	2	0	152
19168	9	1	2	141	0	153
19169	7	1	0	140	0	148
19170	3	142	0	7	0	152
19171	142	8	0	3	0	153
19172	9	144	1	2	0	156
19173	143	10	0	3	0	156
19174	9	1	140	1	0	151
19175	142	2	6	3	0	153
19176	12	1	2	140	0	155
19177	3	1	143	9	0	156
19178	4	2	148	3	0	157
19179	2	0	12	140	0	154
19180	1	0	145	9	0	155
19181	2	1	11	138	0	152
19182	135	0	2	11	0	148
19183	11	1	3	135	0	150
19184	2	0	132	12	0	146
19185	3	131	9	3	0	146
19186	0	142	2	4	0	148
19187	1	11	3	132	0	147
19188	134	4	0	9	0	147
19189	8	4	0	135	0	147
19190	5	0	0	143	0	148
19191	3	0	1	140	0	144
19192	2	0	0	142	0	144
19193	0	0	135	14	0	149
19194	1	0	134	4	0	139
19195	130	0	12	3	0	145
19196	144	0	5	2	0	151
19197	9	0	3	137	0	149
19198	6	0	0	151	0	157
19199	4	0	139	11	0	154
19200	0	138	7	5	0	150
19201	139	9	3	3	0	154
19202	145	3	3	1	0	152
19203	12	4	0	136	0	152
19204	4	0	136	10	0	150
19205	5	0	9	132	0	146
19206	0	134	2	10	0	146
19207	0	9	136	3	0	148
19208	135	2	9	4	0	150
19209	11	2	2	134	0	149
19210	144	0	4	8	0	156
19211	11	0	138	2	0	151
19212	133	1	8	5	0	147
19213	13	0	2	134	0	149
19214	138	0	2	10	0	150
19215	11	0	0	131	0	142
19216	2	125	1	12	0	140
19217	3	134	0	2	0	139
19218	2	9	0	131	0	142
19219	1	4	122	7	0	134
19220	0	120	7	2	0	129
19221	2	4	2	110	0	118
19222	104	1	2	5	0	112
19223	108	2	0	2	0	112
19224	7	0	0	102	0	109
19225	5	0	0	104	0	109
19226	2	100	0	6	0	108
19227	1	103	0	3	0	107
19228	98	6	0	4	0	108
19229	6	4	0	101	0	111
19230	2	2	0	106	0	110
19231	2	0	104	7	0	113
19232	1	0	4	102	0	107
19233	1	0	2	102	0	105
19234	0	0	1	103	0	104
19235	1	0	100	8	0	109
19236	1	0	5	99	0	105
19237	97	0	2	7	0	106
19238	4	0	96	3	0	103
19239	102	0	5	2	0	109
19240	6	0	3	105	0	114
19241	2	0	2	112	0	116
19242	3	0	1	113	0	117
19243	0	0	106	9	0	115
19244	106	0	4	3	0	113
19245	4	108	1	3	0	116
19246	106	4	3	2	0	115
19247	5	108	0	0	0	113
19248	1	6	0	108	0	115
19249	110	2	0	5	0	117
19250	5	1	105	2	0	113
19251	103	0	4	7	0	114
19252	6	0	112	1	0	119
19253	6	0	6	101	0	113
19254	2	0	105	5	0	112
19255	0	102	7	2	0	111
19256	0	2	3	101	0	106
19257	97	1	1	2	0	101
19258	4	1	0	94	0	99
19259	2	91	0	4	0	97
19260	1	2	0	96	0	99
19261	92	2	1	2	0	97
19262	88	1	0	2	0	91
19263	5	88	0	1	0	94
19264	3	79	0	0	0	82
19265	1	4	0	81	0	86
19266	1	2	0	83	0	86
19267	81	1	0	4	0	86
19268	79	0	0	3	0	82
19269	3	79	0	2	0	84
19270	3	3	0	77	0	83
19271	1	1	0	80	0	82
19272	0	2	79	4	0	85
19273	0	77	2	3	0	82
19274	0	76	1	0	0	77
19275	0	2	0	76	0	78
19276	1	1	74	0	0	76
19277	0	1	72	1	0	74
19278	1	0	1	73	0	75
19279	2	0	1	76	0	79
19280	0	0	75	1	0	76
19281	2	0	0	75	0	77
19282	0	0	79	0	0	79
19283	71	0	0	2	0	73
19284	0	0	2	77	0	79
19285	1	1	73	1	0	76
19286	0	0	77	1	0	78
19287	2	0	1	84	0	87
19288	0	0	86	2	0	88
19289	0	1	86	2	0	89
19290	0	77	3	1	0	81
19291	84	0	2	2	0	88
19292	1	1	85	0	0	87
19293	2	0	1	84	0	87
19294	2	2	2	85	0	91
19295	2	0	0	90	0	92
19296	0	0	87	3	0	90
19297	2	0	0	86	0	88
19298	84	0	2	1	0	87
19299	0	1	0	86	0	87
19300	2	0	83	1	0	86
19301	1	0	0	85	0	86
19302	82	0	3	2	0	87
19303	79	0	0	5	0	84
19304	83	1	0	2	0	86
19305	2	1	0	82	0	85
19306	85	0	1	1	0	87
19307	78	0	1	3	0	82
19308	84	0	0	0	0	84
19309	2	80	0	2	0	84
19310	81	2	0	2	0	85
19311	1	2	0	83	0	86
19312	3	0	81	1	0	85
19313	0	80	0	3	0	83
19314	83	0	3	1	0	87
19315	1	3	1	82	0	87
19316	5	0	2	77	0	84
19317	0	74	1	5	0	80
19318	0	84	0	3	0	87
19319	81	4	1	3	0	89
19320	0	88	0	2	0	90
19321	81	1	1	0	0	83
19322	0	78	1	1	0	80
19323	78	0	0	2	0	80
19324	0	77	0	2	0	79
19325	4	78	2	1	0	85
19326	80	4	1	1	0	86
19327	2	2	81	0	0	85
19328	2	79	0	0	0	81
19329	1	1	3	80	0	85
19330	2	3	1	81	0	87
19331	2	0	0	76	0	78
19332	2	1	0	79	0	82
19333	2	0	80	4	0	86
19334	79	1	0	6	0	86
19335	2	1	3	83	0	89
19336	84	0	0	2	0	86
19337	85	0	2	4	0	91
19338	88	1	0	1	0	90
19339	91	2	0	1	0	94
19340	5	1	88	1	0	95
19341	4	0	0	90	0	94
19342	2	1	92	0	0	95
19343	1	91	0	3	0	95
19344	1	1	4	83	0	89
19345	0	4	0	87	0	91
19346	1	0	1	91	0	93
19347	0	2	0	89	0	91
19348	1	1	88	4	0	94
19349	3	1	0	88	0	92
19350	0	1	3	87	0	91
19351	88	0	0	5	0	93
19352	83	0	2	4	0	89
19353	5	1	0	86	0	92
19354	4	0	1	83	0	88
19355	1	0	1	91	0	93
19356	85	0	1	5	0	91
19357	85	0	1	5	0	91
19358	83	1	2	2	0	88
19359	84	0	0	5	0	89
19360	4	82	0	3	0	89
19361	88	0	0	3	0	91
19362	83	2	1	1	0	87
19363	4	0	1	84	0	89
19364	3	1	0	85	0	89
19365	82	0	1	3	0	86
19366	3	76	0	3	0	82
19367	3	79	1	2	0	85
19368	89	2	0	2	0	93
19369	1	2	0	94	0	97
19370	3	0	1	92	0	96
19371	2	2	0	93	0	97
19372	4	0	0	89	0	93
19373	2	0	1	90	0	93
19374	2	82	0	3	0	87
19375	2	1	0	87	0	90
19376	83	1	0	2	0	86
19377	4	0	0	84	0	88
19378	2	2	0	86	0	90
19379	84	0	0	5	0	89
19380	2	87	0	3	0	92
19381	4	3	0	80	0	87
19382	2	84	1	0	0	87
19383	3	0	0	92	0	95
19384	2	2	89	1	0	94
19385	82	1	0	3	0	86
19386	2	90	2	1	0	95
19387	77	0	0	2	0	79
19388	1	2	80	0	0	83
19389	1	1	0	73	0	75
19390	2	77	1	1	0	81
19391	2	79	1	1	0	83
19392	80	0	1	2	0	83
19393	3	1	0	79	0	83
19394	2	1	85	0	0	88
19395	0	1	0	89	0	90
19396	0	1	84	1	0	86
19397	75	0	0	4	0	79
19398	0	0	86	1	0	87
19399	4	0	1	80	0	85
19400	1	83	1	0	0	85
19401	1	1	0	82	0	84
19402	1	85	2	0	0	88
19403	84	0	1	3	0	88
19404	0	2	0	97	0	99
19405	1	2	100	0	0	103
19406	1	1	100	1	0	103
19407	96	0	1	4	0	101
19408	104	0	2	1	0	107
19409	105	0	1	2	0	108
19410	105	0	1	2	0	108
19411	1	103	2	1	0	107
19412	106	0	0	1	0	107
19413	106	1	1	2	0	110
19414	1	1	106	1	0	109
19415	0	1	0	105	0	106
19416	107	1	0	0	0	108
19417	1	1	103	0	0	105
19418	0	0	0	103	0	103
19419	0	1	111	1	0	113
19420	1	0	0	110	0	111
19421	0	121	1	0	0	122
19422	117	0	0	2	0	119
19423	2	0	116	1	0	119
19424	114	0	1	0	0	115
19425	0	0	1	117	0	118
19426	119	0	0	1	0	120
19427	1	0	0	117	0	118
19428	127	0	0	3	0	130
19429	1	0	132	1	0	134
19430	138	1	1	1	0	141
19431	1	0	1	146	0	148
19432	1	0	0	147	0	148
19433	141	0	1	1	0	143
19434	0	0	0	149	0	149
19435	1	1	152	0	0	154
19436	1	0	1	147	0	149
19437	144	0	0	2	0	146
19438	0	140	2	0	0	142
19439	0	141	0	1	0	142
19440	141	1	0	1	0	143
19441	1	156	1	0	0	158
19442	0	0	0	153	0	153
19443	153	0	0	4	0	157
19444	153	0	0	2	0	155
19445	151	0	0	1	0	152
19446	0	0	148	1	0	149
19447	1	0	0	147	0	148
19448	0	151	2	0	0	153
19449	2	0	0	153	0	155
19450	0	0	156	1	0	157
19451	0	153	1	1	0	155
19452	1	0	0	158	0	159
19453	156	0	0	3	0	159
19454	0	158	1	0	0	159
19455	0	0	161	1	0	162
19456	3	0	1	155	0	159
19457	0	1	161	1	0	163
19458	1	1	1	151	0	154
19459	164	0	0	1	0	165
19460	2	1	0	162	0	165
19461	162	0	0	5	0	167
19462	169	0	0	0	0	169
19463	3	169	0	0	0	172
19464	174	0	0	2	0	176
19465	1	168	2	0	0	171
19466	0	1	176	0	0	177
19467	3	1	0	176	0	180
19468	0	0	0	186	0	186
19469	0	1	182	1	0	184
19470	0	182	1	0	0	183
19471	185	1	0	1	0	187
19472	193	0	0	1	0	194
19473	2	1	0	189	0	192
19474	1	0	1	186	0	188
19475	0	0	0	196	0	196
19476	191	0	1	2	0	194
19477	1	0	181	1	0	183
19478	1	1	190	0	0	192
19479	0	0	1	196	0	197
19480	1	0	195	1	0	197
19481	1	1	193	0	0	195
19482	0	1	1	188	0	190
19483	0	0	202	1	0	203
19484	0	202	1	0	0	203
19485	0	1	0	202	0	203
19486	0	0	209	2	0	211
19487	0	1	1	203	0	205
19488	0	188	1	1	0	190
19489	0	2	0	199	0	201
19490	1	0	207	1	0	209
19491	3	0	1	188	0	192
19492	204	0	0	3	0	207
19493	1	0	205	2	0	208
19494	190	0	3	4	0	197
19495	2	204	0	0	0	206
19496	201	1	0	1	0	203
19497	2	0	1	205	0	208
19498	0	204	0	3	0	207
19499	209	1	0	1	0	211
19500	2	0	0	205	0	207
19501	1	0	205	1	0	207
19502	0	203	3	0	0	206
19503	2	1	1	204	0	208
19504	194	0	0	3	0	197
19505	191	0	2	1	0	194
19506	2	1	1	182	0	186
19507	0	1	191	3	0	195
19508	172	0	1	3	0	176
19509	3	1	183	0	0	187
19510	2	0	1	180	0	183
19511	184	0	2	3	0	189
19512	2	183	2	1	0	188
19513	185	2	1	3	0	191
19514	1	1	186	2	0	190
19515	187	0	2	0	0	189
19516	1	1	0	184	0	186
19517	2	1	0	188	0	191
19518	1	0	195	1	0	197
19519	4	0	1	186	0	191
19520	190	1	1	2	0	194
19521	3	1	0	187	0	191
19522	0	191	1	3	0	195
19523	3	2	0	188	0	193
19524	2	183	0	2	0	187
19525	0	2	186	3	0	191
19526	175	1	3	2	0	181
19527	2	1	0	190	0	193
19528	0	1	179	2	0	182
19529	1	177	2	1	0	181
19530	5	1	0	170	0	176
19531	1	1	1	172	0	175
19532	172	0	2	3	0	177
19533	3	1	1	178	0	183
19534	172	0	2	2	0	176
19535	173	1	0	6	0	180
19536	3	171	3	1	0	178
19537	173	3	1	3	0	180
19538	5	0	1	192	0	198
19539	3	1	192	2	0	198
19540	188	1	2	2	0	193
19541	4	1	2	183	0	190
19542	3	1	183	4	0	191
19543	179	1	4	3	0	187
19544	5	0	3	184	0	192
19545	3	188	2	4	0	197
19546	3	1	1	184	0	189
19547	2	184	2	2	0	190
19548	180	3	0	5	0	188
19549	2	4	186	0	0	192
19550	2	184	2	4	0	192
19551	4	4	2	183	0	193
19552	1	2	181	5	0	189
19553	2	2	175	1	0	180
19554	0	177	3	4	0	184
19555	4	2	3	168	0	177
19556	0	2	1	175	0	178
19557	1	3	2	206	0	212
19558	214	2	1	5	0	222
19559	3	1	223	3	0	230
19560	2	227	1	4	0	234
19561	4	1	4	229	0	238
19562	3	4	1	230	0	238
19563	1	2	231	5	0	239
19564	3	1	1	225	0	230
19565	2	0	229	4	0	235
19566	1	1	209	8	0	219
19567	3	0	226	2	0	231
19568	2	0	5	216	0	223
19569	2	1	6	204	0	213
19570	3	0	2	227	0	232
19571	213	1	2	8	0	224
19572	4	212	1	4	0	221
19573	216	2	0	9	0	227
19574	216	5	1	3	0	225
19575	222	1	1	0	0	224
19576	7	220	1	1	0	229
19577	222	3	0	2	0	227
19578	222	4	1	1	0	228
19579	6	2	2	214	0	224
19580	4	3	1	217	0	225
19581	3	1	1	222	0	227
19582	1	2	208	8	0	219
19583	204	2	3	6	0	215
19584	4	0	4	213	0	221
19585	208	1	2	5	0	216
19586	2	204	5	5	0	216
19587	5	4	2	204	0	215
19588	0	3	2	212	0	217
19589	207	3	0	8	0	218
19590	2	1	1	212	0	216
19591	191	0	0	6	0	197
19592	203	1	3	5	0	212
19593	8	190	3	2	0	203
19594	5	205	2	1	0	213
19595	2	5	1	198	0	206
19596	1	209	2	3	0	215
19597	1	4	0	212	0	217
19598	2	4	202	5	0	213
19599	2	1	196	6	0	205
19600	185	2	7	2	0	196
19601	200	3	3	2	0	208
19602	7	193	2	4	0	206
19603	199	2	1	3	0	205
19604	2	215	2	2	0	221
19605	4	4	2	213	0	223
19606	1	2	3	215	0	221
19607	0	1	3	212	0	216
19608	3	0	2	213	0	218
19609	209	0	0	12	0	221
19610	2	212	1	7	0	222
19611	215	2	2	3	0	222
19612	217	4	1	0	0	222
19613	6	4	202	2	0	214
19614	204	2	2	2	0	210
19615	5	207	3	2	0	217
19616	8	4	1	199	0	212
19617	4	7	1	190	0	202
19618	3	195	1	5	0	204
19619	204	2	0	9	0	215
19620	5	3	197	5	0	210
19621	202	2	4	5	0	213
19622	6	1	205	3	0	215
19623	6	0	6	206	0	218
19624	4	3	3	211	0	221
19625	1	0	3	218	0	222
19626	221	1	0	12	0	234
19627	2	2	230	6	0	240
19628	235	1	3	9	0	248
19629	240	0	6	3	0	249
19630	239	2	3	4	0	248
19631	241	1	3	4	0	249
19632	11	1	0	228	0	240
19633	7	1	226	5	0	239
19634	4	4	3	228	0	239
19635	3	4	221	4	0	232
19636	3	2	222	8	0	235
19637	5	221	6	4	0	236
19638	6	6	2	196	0	210
19639	4	2	2	205	0	213
19640	3	3	4	191	0	201
19641	7	2	0	206	0	215
19642	208	0	1	8	0	217
19643	200	3	0	7	0	210
19644	6	1	2	202	0	211
19645	5	2	198	7	0	212
19646	3	0	4	203	0	210
19647	5	1	3	203	0	212
19648	3	1	205	10	0	219
19649	2	2	2	204	0	210
19650	205	2	3	5	0	215
19651	205	1	0	6	0	212
19652	211	1	1	6	0	219
19653	11	0	1	204	0	216
19654	205	3	2	6	0	216
19655	206	2	1	5	0	214
19656	6	2	201	2	0	211
19657	4	2	154	1	0	161
19658	2	1	162	1	0	166
19659	138	1	3	0	0	142
19660	3	141	0	0	0	144
19661	144	3	1	0	0	148
19662	4	161	0	2	0	167
19663	2	3	0	163	0	168
19664	1	0	0	157	0	158
19665	1	0	1	159	0	161
19666	0	1	160	2	0	163
19667	144	0	2	0	0	146
19668	4	0	0	152	0	156
19669	1	1	154	0	0	156
19670	1	0	139	0	0	140
19671	148	0	1	1	0	150
19672	1	150	1	1	0	153
19673	150	1	0	4	0	155
19674	147	0	1	3	0	151
19675	1	149	1	3	0	154
19676	150	2	0	2	0	154
19677	1	1	158	0	0	160
19678	1	0	151	1	0	153
19679	1	0	159	1	0	161
19680	1	0	2	164	0	167
19681	2	0	164	1	0	167
19682	160	1	1	0	0	162
19683	164	0	0	3	0	167
19684	1	1	164	1	0	167
19685	0	1	1	157	0	159
19686	159	0	0	4	0	163
19687	1	161	1	1	0	164
19688	1	168	0	0	0	169
19689	164	2	1	0	0	167
19690	2	0	167	1	0	170
19691	1	1	1	154	0	157
19692	1	0	0	157	0	158
19693	1	0	0	161	0	162
19694	0	157	1	2	0	160
19695	0	1	0	145	0	146
19696	164	0	0	1	0	165
19697	2	0	0	167	0	169
19698	0	177	0	1	0	178
19699	181	1	0	1	0	183
19700	1	0	0	179	0	180
19701	0	0	0	184	0	184
19702	188	0	0	1	0	189
19703	193	0	0	0	0	193
19704	1	0	0	195	0	196
19705	202	0	0	2	0	204
19706	199	0	0	1	0	200
19707	1	205	1	0	0	207
19708	203	1	0	0	0	204
19709	1	200	0	0	0	201
19710	1	1	0	206	0	208
19711	0	0	209	1	0	210
19712	0	0	1	204	0	205
19713	1	0	0	205	0	206
19714	0	0	0	213	0	213
19715	212	0	0	2	0	214
19716	3	215	0	1	0	219
19717	217	2	0	3	0	222
19718	4	230	0	0	0	234
19719	238	4	0	2	0	244
19720	244	0	0	1	0	245
19721	237	2	0	0	0	239
19722	231	1	0	2	0	234
19723	4	0	233	1	0	238
19724	1	1	5	228	0	235
19725	2	0	0	239	0	241
19726	1	1	229	6	0	237
19727	225	1	6	1	0	233
19728	8	1	1	224	0	234
19729	1	2	226	6	0	235
19730	2	0	222	0	0	224
19731	4	1	5	224	0	234
19732	3	0	236	6	0	245
19733	3	0	6	238	0	247
19734	4	0	1	242	0	247
19735	1	0	237	6	0	244
19736	232	1	4	3	0	240
19737	6	1	1	242	0	250
19738	2	0	240	6	0	248
19739	4	0	7	243	0	254
19740	245	0	1	7	0	253
19741	5	0	243	2	0	250
19742	239	0	6	3	0	248
19743	253	1	2	1	0	257
19744	4	0	1	247	0	252
19745	1	0	1	251	0	253
19746	0	0	247	8	0	255
19747	3	0	5	241	0	249
19748	3	0	1	236	0	240
19749	2	0	1	252	0	255
19750	1	0	238	8	0	247
19751	227	1	6	3	0	237
19752	240	0	1	1	0	242
19753	240	0	0	1	0	241
19754	253	1	1	1	0	256
19755	10	0	1	246	0	257
19756	245	1	0	8	0	254
19757	248	0	1	5	0	254
19758	202	1	2	7	0	212
19759	243	0	1	4	0	248
19760	5	236	0	4	0	245
19761	241	4	1	2	0	248
19762	239	1	0	4	0	244
19763	8	237	3	0	0	248
19764	240	6	0	3	0	249
19765	10	2	1	237	0	250
19766	6	0	1	247	0	254
19767	232	0	1	10	0	243
19768	8	231	1	4	0	244
19769	5	234	1	1	0	241
19770	3	5	2	244	0	254
19771	3	2	242	8	0	255
19772	4	1	6	239	0	250
19773	4	1	3	247	0	255
19774	241	1	0	9	0	251
19775	247	1	1	4	0	253
19776	8	2	2	239	0	251
19777	3	1	237	9	0	250
19778	3	0	6	245	0	254
19779	246	1	2	8	0	257
19780	10	1	255	3	0	269
19781	3	259	7	4	0	273
19782	258	6	4	4	0	272
19783	9	2	1	260	0	272
19784	6	1	2	265	0	274
19785	2	2	3	267	0	274
19786	4	1	252	11	0	268
19787	233	0	7	8	0	248
19788	7	1	247	6	0	261
19789	4	244	5	6	0	259
19790	6	5	5	251	0	267
19791	6	2	1	260	0	269
19792	4	1	2	276	0	283
19793	4	1	269	8	0	282
19794	3	0	257	8	0	268
19795	3	1	269	6	0	279
19796	4	266	10	3	0	283
19797	4	10	7	259	0	280
19798	266	2	2	11	0	281
19799	293	1	3	3	0	300
19800	16	2	285	2	0	305
19801	5	289	13	4	0	311
19802	2	13	281	4	0	300
19803	5	298	9	3	0	315
19804	285	14	9	2	0	310
19805	284	6	1	3	0	294
19806	16	278	4	3	0	301
19807	283	16	1	0	0	300
19808	17	5	2	275	0	299
19809	8	4	3	277	0	292
19810	271	3	3	15	0	292
19811	274	1	3	4	0	282
19812	273	4	3	3	0	283
19813	17	257	3	4	0	281
19814	10	276	1	3	0	290
19815	270	14	2	4	0	290
19816	16	3	264	2	0	285
19817	9	6	12	253	0	280
19818	251	2	5	13	0	271
19819	15	249	2	3	0	269
19820	5	256	3	1	0	265
19821	255	14	0	2	0	271
19822	14	6	241	1	0	262
19823	244	2	10	2	0	258
19824	15	1	245	4	0	265
19825	5	2	242	3	0	252
19826	3	4	12	240	0	259
19827	8	2	251	7	0	268
19828	244	3	11	4	0	262
19829	255	3	4	1	0	263
19830	259	1	3	4	0	267
19831	259	2	5	0	0	266
19832	15	2	3	247	0	267
19833	251	0	4	12	0	267
19834	12	243	3	6	0	264
19835	9	8	1	237	0	255
19836	5	253	2	8	0	268
19837	264	8	3	3	0	278
19838	264	6	1	4	0	275
19839	18	1	1	256	0	276
19840	260	2	2	10	0	274
19841	267	2	2	6	0	277
19842	16	2	0	258	0	276
19843	10	2	1	260	0	273
19844	7	2	0	271	0	280
19845	5	2	250	13	0	270
19846	5	1	251	6	0	263
19847	5	0	255	3	0	263
19848	3	1	13	255	0	272
19849	4	2	264	12	0	282
19850	2	2	10	258	0	272
19851	2	0	288	15	0	305
19852	3	1	284	7	0	295
19853	264	0	18	5	0	287
19854	10	271	7	5	0	293
19855	283	9	4	2	0	298
19856	11	3	3	281	0	298
19857	7	0	3	287	0	297
19858	3	2	291	13	0	309
19859	5	278	12	6	0	301
19860	1	11	6	298	0	316
19861	3	6	298	12	0	319
19862	4	288	10	5	0	307
19863	5	10	4	296	0	315
19864	293	2	4	12	0	311
19865	298	2	2	3	0	305
19866	13	3	1	288	0	305
19867	294	1	3	12	0	310
19868	9	291	2	6	0	308
19869	5	8	1	304	0	318
19870	2	3	302	10	0	317
19871	3	3	8	300	0	314
19872	1	2	305	12	0	320
19873	292	1	9	5	0	307
19874	11	2	4	293	0	310
19875	4	294	0	12	0	310
19876	3	13	3	300	0	319
19877	3	2	299	11	0	315
19878	1	0	307	6	0	314
19879	3	2	301	1	0	307
19880	263	1	9	4	0	277
19881	9	279	1	3	0	292
19882	4	8	1	279	0	292
19883	272	3	3	11	0	289
19884	6	276	4	2	0	288
19885	294	7	4	4	0	309
19886	306	1	6	1	0	314
19887	305	4	2	3	0	314
19888	307	1	1	4	0	313
19889	11	2	290	1	0	304
19890	269	3	8	3	0	283
19891	11	1	286	2	0	300
19892	260	1	6	1	0	268
19893	11	3	1	281	0	296
19894	5	2	263	6	0	276
19895	5	264	7	1	0	277
19896	5	10	2	257	0	274
19897	1	260	3	3	0	267
19898	4	262	1	2	0	269
19899	226	4	3	3	0	236
19900	4	1	226	1	0	232
19901	0	225	3	0	0	228
19902	220	4	1	1	0	226
19903	1	224	0	0	0	225
19904	229	1	0	1	0	231
19905	2	0	0	221	0	223
19906	227	1	0	1	0	229
19907	2	0	0	224	0	226
19908	224	0	0	1	0	225
19909	2	0	0	231	0	233
19910	1	242	0	1	0	244
19911	0	2	1	251	0	254
19912	247	0	0	2	0	249
19913	1	247	1	0	0	249
19914	1	1	0	246	0	248
19915	252	0	0	5	0	257
19916	1	0	1	254	0	256
19917	0	1	0	252	0	253
19918	0	0	244	2	0	246
19919	0	1	236	0	0	237
19920	0	1	1	236	0	238
19921	2	0	251	1	0	254
19922	0	0	2	237	0	239
19923	3	1	0	216	0	220
19924	1	0	0	245	0	246
19925	0	1	248	1	0	250
19926	1	0	1	235	0	237
19927	0	0	0	241	0	241
19928	1	242	0	1	0	244
19929	1	1	0	248	0	250
19930	247	0	0	1	0	248
19931	3	0	0	247	0	250
19932	0	1	269	4	0	274
19933	249	1	4	1	0	255
19934	6	276	2	0	0	284
19935	2	5	0	282	0	289
19936	0	2	280	5	0	287
19937	248	0	4	3	0	255
19938	6	274	2	1	0	283
19939	270	6	0	4	0	280
19940	7	2	2	274	0	285
19941	267	0	1	7	0	275
19942	6	0	270	3	0	279
19943	2	262	6	1	0	271
19944	1	297	2	1	0	301
19945	301	6	0	4	0	311
19946	302	2	0	2	0	306
19947	6	0	299	0	0	305
19948	285	0	4	3	0	292
19949	302	0	3	2	0	307
19950	304	0	0	3	0	307
19951	7	287	0	1	0	295
19952	3	289	3	0	0	295
19953	288	6	0	2	0	296
19954	291	2	0	1	0	294
19955	7	299	0	1	0	307
19956	4	6	0	304	0	314
19957	1	3	302	4	0	310
19958	305	0	5	3	0	313
19959	311	0	2	3	0	316
19960	317	2	2	5	0	326
19961	7	316	1	1	0	325
19962	2	4	324	2	0	332
19963	332	1	4	2	0	339
19964	6	1	3	343	0	353
19965	2	1	0	341	0	344
19966	0	1	0	357	0	358
19967	1	0	353	6	0	360
19968	5	1	3	346	0	355
19969	1	0	362	4	0	367
19970	0	354	4	4	0	362
19971	344	4	2	2	0	352
19972	3	350	1	2	0	356
19973	2	357	0	2	0	361
19974	359	4	1	1	0	365
19975	4	371	0	0	0	375
19976	4	5	0	359	0	368
19977	1	355	0	5	0	361
19978	355	6	0	4	0	365
19979	5	353	0	0	0	358
19980	3	6	0	356	0	365
19981	0	2	358	8	0	368
19982	0	1	7	358	0	366
19983	0	353	3	6	0	362
19984	0	7	1	362	0	370
19985	2	3	0	358	0	363
19986	0	0	1	356	0	357
19987	1	0	0	366	0	367
19988	1	1	0	360	0	362
19989	1	1	0	375	0	377
19990	0	0	365	11	0	376
19991	343	1	8	6	0	358
19992	9	1	3	388	0	401
19993	3	0	389	10	0	402
19994	0	1	389	6	0	396
19995	1	2	11	395	0	409
19996	394	1	5	14	0	414
19997	10	0	392	6	0	408
19998	380	1	9	5	0	395
19999	10	1	414	3	0	428
20000	4	0	10	420	0	434
20001	5	1	5	430	0	441
20002	2	1	424	12	0	439
20003	400	0	9	9	0	418
20004	11	2	6	416	0	435
20005	5	1	418	10	0	434
20006	6	0	415	5	0	426
20007	5	0	13	396	0	414
20008	3	419	7	3	0	432
20009	424	9	5	7	0	445
20010	415	4	3	6	0	428
20011	13	2	426	4	0	445
20012	5	1	12	398	0	416
20013	415	3	4	14	0	436
20014	12	0	419	6	0	437
20015	389	0	11	7	0	407
20016	11	411	7	4	0	433
20017	7	8	6	422	0	443
20018	10	3	3	422	0	438
20019	434	3	3	14	0	454
20020	16	1	3	433	0	453
20021	10	2	3	431	0	446
20022	1	2	3	439	0	445
20023	422	2	3	19	0	446
20024	13	3	416	6	0	438
20025	405	0	9	9	0	423
20026	415	3	6	9	0	433
20027	420	1	2	7	0	430
20028	17	2	2	404	0	425
20029	7	2	413	15	0	437
20030	6	404	8	9	0	427
20031	5	402	6	4	0	417
20032	3	385	3	6	0	397
20033	4	9	378	7	0	398
20034	10	2	10	435	0	457
20035	451	3	4	15	0	473
20036	482	1	3	13	0	499
20037	22	1	2	493	0	518
20038	11	1	493	15	0	520
20039	7	0	493	9	0	509
20040	6	3	18	491	0	518
20041	4	3	515	15	0	537
20042	5	4	16	518	0	543
20043	8	4	8	501	0	521
20044	5	485	6	20	0	516
20045	11	15	5	506	0	537
20046	3	6	7	519	0	535
20047	499	3	3	25	0	530
20048	21	3	5	506	0	535
20049	10	2	6	517	0	535
20050	501	0	3	25	0	529
20051	22	502	7	9	0	540
20052	509	14	6	11	0	540
20053	15	3	502	13	0	533
20054	480	3	21	11	0	515
20055	498	3	7	13	0	521
20056	21	5	478	9	0	513
20057	13	2	468	8	0	491
20058	11	2	24	461	0	498
20059	468	4	9	25	0	506
20060	23	1	472	13	0	509
20061	15	2	18	466	0	501
20062	10	3	457	19	0	489
20063	9	5	18	455	0	487
20064	10	2	9	459	0	480
20065	453	1	9	24	0	487
20066	453	4	7	12	0	476
20067	460	1	6	12	0	479
20068	23	3	454	9	0	489
20069	17	4	442	9	0	472
20070	19	2	26	435	0	482
20071	12	4	15	459	0	490
20072	9	2	11	476	0	498
20073	444	3	9	28	0	484
20074	21	448	12	16	0	497
20075	446	14	9	17	0	486
20076	448	5	7	12	0	472
20077	28	428	6	11	0	473
20078	14	449	5	11	0	479
20079	447	19	8	12	0	486
20080	20	5	7	436	0	468
20081	11	435	6	23	0	475
20082	11	14	5	448	0	478
20083	9	6	437	25	0	477
20084	17	4	17	431	0	469
20085	434	4	6	22	0	466
20086	22	6	425	13	0	466
20087	15	2	426	9	0	452
20088	15	8	19	392	0	434
20089	9	391	10	20	0	430
20090	10	404	10	11	0	435
20091	8	427	9	10	0	454
20092	412	18	4	15	0	449
20093	416	8	5	10	0	439
20094	391	4	6	13	0	414
20095	18	391	6	15	0	430
20096	407	12	4	14	0	437
20097	408	5	4	13	0	430
20098	22	4	396	10	0	432
20099	11	388	15	12	0	426
20100	17	14	9	386	0	426
20101	389	7	10	17	0	423
20102	17	5	382	14	0	418
20103	8	6	18	369	0	401
20104	9	381	9	20	0	419
20105	15	13	5	384	0	417
20106	13	7	9	383	0	412
20107	388	3	7	24	0	422
20108	389	4	6	15	0	414
20109	27	9	8	372	0	416
20110	12	6	372	17	0	407
20111	9	5	361	16	0	391
20112	370	4	18	11	0	403
20113	20	5	370	12	0	407
20114	20	4	16	318	0	358
20115	7	343	13	18	0	381
20116	351	13	7	11	0	382
20117	20	348	10	9	0	387
20118	348	13	9	14	0	384
20119	21	8	9	343	0	381
20120	19	4	4	351	0	378
20121	346	4	6	24	0	380
20122	357	7	6	13	0	383
20123	26	5	4	349	0	384
20124	17	5	7	349	0	378
20125	14	3	333	16	0	366
20126	13	5	330	9	0	357
20127	329	7	17	7	0	360
20128	14	5	333	8	0	360
20129	329	3	12	9	0	353
20130	334	4	7	9	0	354
20131	19	4	315	10	0	348
20132	11	308	11	5	0	335
20133	5	305	12	4	0	326
20134	6	5	220	4	0	235
20135	9	23	13	181	0	226
20136	172	4	5	7	0	188
20137	171	3	0	2	0	176
20138	180	1	0	1	0	182
20139	197	0	1	2	0	200
20140	196	2	0	1	0	199
20141	6	188	0	2	0	196
20142	182	2	2	3	0	189
20143	4	185	1	2	0	192
20144	185	3	0	0	0	188
20145	4	2	179	0	0	185
20146	4	1	3	172	0	180
20147	1	0	2	164	0	167
20148	0	172	0	4	0	176
20149	175	3	0	2	0	180
20150	172	2	1	2	0	177
20151	6	0	0	170	0	176
20152	4	0	0	171	0	175
20153	171	1	1	6	0	179
20154	4	1	0	172	0	177
20155	4	1	0	173	0	178
20156	170	0	1	7	0	178
20157	3	0	0	175	0	178
20158	178	0	0	5	0	183
20159	179	2	0	3	0	184
20160	8	0	178	1	0	187
20161	182	1	4	1	0	188
20162	179	0	2	4	0	185
20163	179	1	1	4	0	185
20164	5	1	174	1	0	181
20165	2	1	4	166	0	173
20166	2	1	2	174	0	179
20167	2	0	171	6	0	179
20168	168	0	2	4	0	174
20169	4	0	3	170	0	177
20170	2	2	173	4	0	181
20171	4	1	173	2	0	180
20172	3	1	5	173	0	182
20173	3	0	178	6	0	187
20174	6	0	2	176	0	184
20175	5	0	4	180	0	189
20176	3	0	180	8	0	191
20177	5	1	4	167	0	177
20178	4	164	4	3	0	175
20179	6	179	0	4	0	189
20180	177	6	1	2	0	186
20181	183	2	1	2	0	188
20182	6	177	2	2	0	187
20183	180	4	1	3	0	188
20184	175	4	1	4	0	184
20185	9	1	1	179	0	190
20186	9	0	3	178	0	190
20187	171	2	2	7	0	182
20188	7	172	1	6	0	186
20189	4	175	3	1	0	183
20190	7	4	1	174	0	186
20191	2	2	170	8	0	182
20192	162	0	5	6	0	173
20193	169	0	5	5	0	179
20194	164	1	1	6	0	172
20195	8	165	1	3	0	177
20196	4	4	1	160	0	169
20197	6	4	1	161	0	172
20198	163	0	1	6	0	170
20199	6	159	2	4	0	171
20200	10	4	0	155	0	169
20201	6	2	3	161	0	172
20202	6	0	1	164	0	171
20203	158	1	1	6	0	166
20204	9	151	1	3	0	164
20205	8	4	2	146	0	160
20206	6	155	2	4	0	167
20207	160	3	3	6	0	172
20208	4	6	155	3	0	168
20209	156	0	4	4	0	164
20210	4	3	149	3	0	159
20211	8	4	3	145	0	160
20212	146	0	4	5	0	155
20213	4	1	144	8	0	157
20214	141	0	3	7	0	151
20215	146	1	3	6	0	156
20216	153	1	2	1	0	157
20217	7	3	1	142	0	153
20218	4	2	1	146	0	153
20219	3	2	2	149	0	156
20220	144	1	1	7	0	153
20221	7	146	2	4	0	159
20222	143	3	1	5	0	152
20223	146	3	3	4	0	156
20224	9	3	140	4	0	156
20225	143	1	3	5	0	152
20226	148	3	3	4	0	158
20227	7	2	4	149	0	162
20228	4	3	2	148	0	157
20229	5	1	2	151	0	159
20230	146	1	3	5	0	155
20231	143	0	1	5	0	149
20232	132	1	2	3	0	138
20233	7	119	2	2	0	130
20234	2	111	1	3	0	117
20235	1	114	1	4	0	120
20236	109	1	1	6	0	117
20237	2	1	110	4	0	117
20238	4	2	97	0	0	103
20239	75	0	1	0	0	76
20240	1	1	75	1	0	78
20241	1	0	1	62	0	64
20242	2	67	0	0	0	69
20243	72	0	1	0	0	73
20244	68	0	0	2	0	70
20245	73	0	0	1	0	74
20246	1	0	0	78	0	79
20247	1	0	83	1	0	85
20248	1	0	82	1	0	84
20249	81	0	0	1	0	82
20250	88	1	0	0	0	89
20251	84	1	0	0	0	85
20252	1	1	0	85	0	87
20253	2	0	0	86	0	88
20254	0	0	86	0	0	86
20255	86	0	1	0	0	87
20256	2	0	0	89	0	91
20257	0	0	0	84	0	84
20258	0	0	0	88	0	88
20259	0	86	0	1	0	87
20260	2	0	0	86	0	88
20261	2	0	0	84	0	86
20262	85	0	0	1	0	86
20263	0	1	84	1	0	86
20264	79	1	1	0	0	81
20265	84	1	0	0	0	85
20266	3	0	0	83	0	86
20267	0	0	1	82	0	83
20268	84	0	0	0	0	84
20269	1	0	82	1	0	84
20270	0	81	1	1	0	83
20271	0	0	1	84	0	85
20272	85	1	0	0	0	86
20273	1	0	0	82	0	83
20274	1	0	83	1	0	85
20275	1	0	85	1	0	87
20276	83	0	0	1	0	84
20277	0	0	0	95	0	95
20278	0	0	93	1	0	94
20279	90	0	0	3	0	93
20280	101	0	0	0	0	101
20281	2	0	0	100	0	102
20282	1	0	0	101	0	102
20283	0	101	0	2	0	103
20284	106	0	0	1	0	107
20285	2	0	0	106	0	108
20286	0	0	1	108	0	109
20287	0	1	106	1	0	108
20288	102	0	1	2	0	105
20289	102	1	0	0	0	103
20290	0	102	0	2	0	104
20291	0	0	106	1	0	107
20292	1	0	103	0	0	104
20293	2	1	1	101	0	105
20294	105	0	0	3	0	108
20295	1	0	1	108	0	110
20296	110	0	0	3	0	113
20297	108	0	0	2	0	110
20298	112	0	0	2	0	114
20299	0	0	0	113	0	113
20300	0	1	0	115	0	116
20301	115	0	0	1	0	116
20302	1	0	120	1	0	122
20303	109	0	0	0	0	109
20304	104	0	0	1	0	105
20305	0	0	116	0	0	116
20306	0	0	112	0	0	112
20307	0	113	0	0	0	113
20308	0	0	1	112	0	113
20309	104	0	0	0	0	104
20310	0	0	0	112	0	112
20311	0	0	118	0	0	118
20312	0	113	0	0	0	113
20313	0	115	0	0	0	115
20314	1	0	1	112	0	114
20315	0	0	0	117	0	117
20316	0	111	0	0	0	111
20317	0	0	108	0	0	108
20318	101	0	0	2	0	103
20319	114	0	0	0	0	114
20320	0	116	0	0	0	116
20321	109	0	0	1	0	110
20322	0	0	0	108	0	108
20323	106	0	0	1	0	107
20324	0	0	0	109	0	109
20325	0	110	0	0	0	110
20326	0	2	113	0	0	115
20327	0	0	2	122	0	124
20328	1	0	0	118	0	119
20329	0	0	0	128	0	128
20330	127	0	0	4	0	131
20331	2	0	0	130	0	132
20332	2	0	131	2	0	135
20333	1	0	137	1	0	139
20334	131	0	6	1	0	138
20335	5	0	135	0	0	140
20336	132	0	5	3	0	140
20337	5	0	1	150	0	156
20338	1	0	0	145	0	146
20339	1	0	0	157	0	158
20340	0	0	0	153	0	153
20341	150	0	0	5	0	155
20342	6	0	146	1	0	153
20343	3	0	7	141	0	151
20344	0	146	3	6	0	155
20345	144	6	0	2	0	152
20346	7	2	0	143	0	152
20347	140	0	0	10	0	150
20348	8	0	140	2	0	150
20349	2	0	7	132	0	141
20350	0	140	2	5	0	147
20351	139	6	0	1	0	146
20352	7	2	134	0	0	143
20353	1	0	7	136	0	144
20354	1	0	2	143	0	146
20355	133	0	1	10	0	144
20356	7	0	134	2	0	143
20357	2	0	137	0	0	139
20358	1	0	9	134	0	144
20359	0	0	137	7	0	144
20360	0	0	136	2	0	138
20361	3	1	8	124	0	136
20362	2	0	2	136	0	140
20363	0	0	0	143	0	143
20364	135	0	0	9	0	144
20365	7	140	0	2	0	149
20366	140	6	0	1	0	147
20367	7	2	0	139	0	148
20368	2	142	0	7	0	151
20369	1	7	0	149	0	157
20370	148	2	1	7	0	158
20371	8	151	0	2	0	161
20372	2	7	0	158	0	167
20373	0	1	157	9	0	167
20374	153	0	7	3	0	163
20375	8	0	2	152	0	162
20376	4	0	0	153	0	157
20377	0	0	153	11	0	164
20378	0	0	154	4	0	158
20379	144	1	10	1	0	156
20380	10	141	2	0	0	153
20381	3	7	1	145	0	156
20382	146	1	2	8	0	157
20383	9	0	147	2	0	158
20384	3	140	8	2	0	153
20385	0	9	4	136	0	149
20386	144	2	0	10	0	156
20387	144	0	1	5	0	150
20388	149	0	0	1	0	150
20389	7	142	2	3	0	154
20390	3	7	142	2	0	154
20391	1	3	8	147	0	159
20392	2	0	5	145	0	152
20393	1	0	1	153	0	155
20394	2	1	0	146	0	149
20395	137	0	2	11	0	150
20396	143	0	0	6	0	149
20397	12	0	138	1	0	151
20398	3	2	141	2	0	148
20399	135	1	11	1	0	148
20400	143	2	2	1	0	148
20401	11	1	2	131	0	145
20402	7	130	1	8	0	146
20403	129	9	3	5	0	146
20404	7	132	1	5	0	145
20405	4	139	0	5	0	148
20406	1	11	3	133	0	148
20407	5	2	3	141	0	151
20408	1	0	2	149	0	152
20409	3	0	1	147	0	151
20410	2	2	136	9	0	149
20411	135	0	9	5	0	149
20412	140	2	3	2	0	147
20413	14	0	1	131	0	146
20414	4	0	3	134	0	141
20415	133	3	0	11	0	147
20416	9	2	127	5	0	143
20417	136	1	6	1	0	144
20418	136	3	4	2	0	145
20419	11	1	127	4	0	143
20420	136	1	10	3	0	150
20421	15	1	2	135	0	153
20422	4	0	2	147	0	153
20423	3	1	4	144	0	152
20424	3	1	2	140	0	146
20425	126	0	3	8	0	137
20426	7	1	2	128	0	138
20427	1	1	1	119	0	122
20428	1	100	3	9	0	113
20429	2	116	0	6	0	124
20430	2	5	2	111	0	120
20431	110	4	1	7	0	122
20432	9	0	1	101	0	111
20433	3	1	97	1	0	102
20434	1	0	88	1	0	90
20435	89	2	3	0	0	94
20436	3	93	1	1	0	98
20437	83	2	0	0	0	85
20438	2	2	84	0	0	88
20439	1	2	2	80	0	85
20440	82	0	1	2	0	85
20441	2	83	0	1	0	86
20442	81	1	0	1	0	83
20443	1	0	103	0	0	104
20444	1	0	1	97	0	99
20445	1	0	0	102	0	103
20446	108	0	0	2	0	110
20447	103	0	0	2	0	105
20448	115	0	0	1	0	116
20449	116	0	0	0	0	116
20450	116	0	0	0	0	116
20451	1	117	0	0	0	118
20452	0	1	0	122	0	123
20453	124	0	0	2	0	126
20454	2	0	0	125	0	127
20455	0	0	0	126	0	126
20456	1	1	0	122	0	124
20457	0	122	0	1	0	123
20458	119	1	0	1	0	121
20459	1	0	0	122	0	123
20460	121	0	0	1	0	122
20461	117	0	0	2	0	119
20462	1	117	0	0	0	118
20463	116	0	0	1	0	117
20464	1	0	113	0	0	114
20465	113	0	1	0	0	114
20466	2	1	0	109	0	112
20467	1	0	116	1	0	118
20468	1	114	2	0	0	117
20469	0	0	114	0	0	114
20470	0	112	2	0	0	114
20471	105	1	2	1	0	109
20472	104	0	0	0	0	104
20473	106	0	0	1	0	107
20474	0	108	0	0	0	108
20475	106	0	0	1	0	107
20476	0	0	108	0	0	108
20477	0	0	108	0	0	108
20478	0	1	0	109	0	110
20479	0	0	0	112	0	112
20480	0	110	1	1	0	112
20481	110	1	0	0	0	111
20482	1	0	0	111	0	112
20483	0	109	0	1	0	110
20484	0	1	0	111	0	112
20485	113	0	1	1	0	115
20486	111	0	0	1	0	112
20487	1	0	109	0	0	110
20488	0	0	1	111	0	112
20489	0	0	107	1	0	108
20490	0	0	1	109	0	110
20491	0	0	109	1	0	110
20492	0	0	1	104	0	105
20493	0	0	111	1	0	112
20494	1	0	1	101	0	103
20495	0	0	110	1	0	111
20496	1	0	1	105	0	107
20497	0	0	0	108	0	108
20498	0	110	0	1	0	111
20499	0	1	0	113	0	114
20500	0	0	112	1	0	113
20501	0	0	1	107	0	108
20502	0	0	0	112	0	112
20503	111	0	0	1	0	112
20504	1	0	0	114	0	115
20505	0	1	0	113	0	114
20506	0	0	110	1	0	111
20507	108	0	1	0	0	109
20508	1	0	0	113	0	114
20509	0	0	0	110	0	110
20510	0	0	0	110	0	110
20511	108	0	0	1	0	109
20512	1	0	0	105	0	106
20513	0	0	0	106	0	106
20514	100	0	0	3	0	103
20515	2	107	0	0	0	109
20516	0	2	0	104	0	106
20517	0	0	0	108	0	108
20518	0	0	105	2	0	107
20519	83	0	2	3	0	88
20520	2	0	0	100	0	102
20521	0	0	101	2	0	103
20522	98	0	2	0	0	100
20523	2	0	1	103	0	106
20524	0	0	0	109	0	109
20525	0	0	0	107	0	107
20526	0	0	0	109	0	109
20527	0	0	113	2	0	115
20528	0	0	2	114	0	116
20529	0	0	0	139	0	139
20530	0	0	158	5	0	163
20531	154	0	8	1	0	163
20532	163	0	0	2	0	165
20533	166	0	1	1	0	168
20534	11	0	2	155	0	168
20535	159	0	0	8	0	167
20536	163	0	0	0	0	163
20537	10	0	1	157	0	168
20538	155	1	0	10	0	166
20539	162	0	0	0	0	162
20540	157	0	0	2	0	159
20541	152	0	0	4	0	156
20542	13	0	0	146	0	159
20543	3	134	0	7	0	144
20544	4	140	0	1	0	145
20545	3	149	0	2	0	154
20546	134	10	0	4	0	148
20547	146	2	0	0	0	148
20548	8	4	132	1	0	145
20549	137	2	9	2	0	150
20550	12	0	0	139	0	151
20551	3	1	2	143	0	149
20552	4	1	2	141	0	148
20553	139	0	0	12	0	151
20554	10	0	1	135	0	146
20555	2	135	2	12	0	151
20556	5	7	0	136	0	148
20557	4	0	136	10	0	150
20558	1	2	8	145	0	156
20559	143	2	0	11	0	156
20560	12	0	143	2	0	157
20561	1	0	8	146	0	155
20562	6	2	0	143	0	151
20563	2	2	2	143	0	149
20564	2	144	3	10	0	159
20565	2	8	0	146	0	156
20566	150	0	0	13	0	163
20567	153	3	2	2	0	160
20568	10	3	140	3	0	156
20569	3	1	149	4	0	157
20570	7	0	8	147	0	162
20571	4	1	2	159	0	166
20572	1	1	158	9	0	169
20573	2	1	10	150	0	163
20574	1	159	1	12	0	173
20575	158	7	3	4	0	172
20576	163	0	3	2	0	168
20577	160	1	1	2	0	164
20578	12	2	150	2	0	166
20579	5	2	9	152	0	168
20580	4	0	156	11	0	171
20581	155	1	10	2	0	168
20582	9	154	3	5	0	171
20583	4	7	2	157	0	170
20584	153	1	3	8	0	165
20585	10	2	1	156	0	169
20586	1	2	1	169	0	173
20587	2	0	161	11	0	174
20588	153	2	8	1	0	164
20589	6	152	1	4	0	163
20590	4	7	2	159	0	172
20591	157	0	3	8	0	168
20592	11	2	1	156	0	170
20593	151	4	1	10	0	166
20594	10	154	1	4	0	169
20595	162	6	0	3	0	171
20596	10	1	162	2	0	175
20597	156	2	9	2	0	169
20598	172	3	2	2	0	179
20599	174	0	3	1	0	178
20600	14	0	3	158	0	175
20601	8	2	0	161	0	171
20602	10	0	0	165	0	175
20603	5	163	1	9	0	178
20604	163	7	1	7	0	178
20605	12	0	0	162	0	174
20606	6	3	1	167	0	177
20607	2	2	1	168	0	173
20608	163	1	0	10	0	174
20609	9	0	1	165	0	175
20610	3	1	157	12	0	173
20611	4	164	8	3	0	179
20612	6	5	0	167	0	178
20613	1	4	1	168	0	174
20614	3	3	1	172	0	179
20615	3	1	158	9	0	171
20616	2	0	162	5	0	169
20617	5	0	7	163	0	175
20618	2	4	164	8	0	178
20619	4	2	8	173	0	187
20620	178	0	3	12	0	193
20621	190	0	2	4	0	196
20622	186	2	3	5	0	196
20623	10	2	178	3	0	193
20624	183	0	7	5	0	195
20625	11	1	3	181	0	196
20626	3	1	178	9	0	191
20627	5	1	178	1	0	185
20628	5	167	7	3	0	182
20629	2	148	1	4	0	155
20630	126	1	1	1	0	129
20631	1	1	0	122	0	124
20632	0	0	124	0	0	124
20633	0	0	1	119	0	120
20634	127	0	0	0	0	127
20635	0	1	126	0	0	127
20636	132	0	0	0	0	132
20637	138	0	0	1	0	139
20638	140	0	0	1	0	141
20639	0	139	0	1	0	140
20640	143	1	0	0	0	144
20641	1	0	0	147	0	148
20642	1	0	0	138	0	139
20643	1	0	0	144	0	145
20644	1	0	0	145	0	146
20645	140	0	0	1	0	141
20646	0	141	0	0	0	141
20647	0	141	1	0	0	142
20648	0	151	0	0	0	151
20649	149	0	0	2	0	151
20650	148	0	0	1	0	149
20651	149	0	0	2	0	151
20652	150	0	1	0	0	151
20653	0	0	1	151	0	152
20654	0	0	1	149	0	150
20655	147	0	1	4	0	152
20656	1	149	0	1	0	151
20657	145	0	1	1	0	147
20658	144	0	0	0	0	144
20659	2	0	0	144	0	146
20660	1	140	1	0	0	142
20661	1	1	0	146	0	148
20662	144	0	0	2	0	146
20663	0	0	143	1	0	144
20664	1	0	1	135	0	137
20665	0	140	0	1	0	141
20666	144	1	0	1	0	146
20667	137	0	0	1	0	138
20668	0	1	140	1	0	142
20669	0	145	1	0	0	146
20670	0	1	142	1	0	144
20671	2	1	0	133	0	136
20672	0	0	138	1	0	139
20673	2	0	133	0	0	135
20674	2	134	0	0	0	136
20675	135	0	0	1	0	136
20676	132	1	1	1	0	135
20677	2	141	0	0	0	143
20678	0	143	0	1	0	144
20679	2	0	139	1	0	142
20680	2	0	133	1	0	136
20681	0	0	142	0	0	142
20682	0	1	0	137	0	138
20683	0	1	142	1	0	144
20684	2	0	0	137	0	139
20685	0	0	1	130	0	131
20686	0	0	140	0	0	140
20687	0	138	0	0	0	138
20688	2	0	1	137	0	140
20689	140	0	0	2	0	142
20690	0	0	1	135	0	136
20691	0	1	140	1	0	142
20692	0	141	1	1	0	143
20693	0	141	0	1	0	142
20694	0	0	1	141	0	142
20695	137	0	1	1	0	139
20696	136	1	0	0	0	137
20697	2	0	0	127	0	129
20698	1	137	0	0	0	138
20699	0	1	0	138	0	139
20700	0	1	0	135	0	136
20701	1	0	1	129	0	131
20702	138	0	1	2	0	141
20703	3	138	1	0	0	142
20704	141	3	0	1	0	145
20705	142	3	1	0	0	146
20706	138	0	0	2	0	140
20707	144	0	0	1	0	145
20708	6	0	1	138	0	145
20709	3	1	137	4	0	145
20710	0	137	3	4	0	144
20711	139	4	3	0	0	146
20712	141	4	0	1	0	146
20713	146	0	1	0	0	147
20714	8	1	129	0	0	138
20715	136	1	3	0	0	140
20716	137	0	3	1	0	141
20717	9	0	0	132	0	141
20718	4	0	125	4	0	133
20719	0	126	4	4	0	134
20720	1	5	3	123	0	132
20721	119	2	0	5	0	126
20722	4	0	0	122	0	126
20723	2	0	0	124	0	126
20724	124	0	0	6	0	130
20725	4	1	115	3	0	123
20726	123	0	4	2	0	129
20727	122	0	4	0	0	126
20728	128	0	0	0	0	128
20729	122	0	0	2	0	124
20730	8	0	118	0	0	126
20731	4	0	4	117	0	125
20732	0	0	116	4	0	120
20733	1	0	4	115	0	120
20734	0	0	113	4	0	117
20735	96	0	4	5	0	105
20736	4	100	4	0	0	108
20737	4	102	0	0	0	106
20738	0	6	0	97	0	103
20739	0	4	0	105	0	109
20740	0	110	0	8	0	118
20741	111	4	0	4	0	119
20742	118	5	0	0	0	123
20743	126	0	0	0	0	126
20744	132	0	0	1	0	133
20745	10	1	0	123	0	134
20746	5	0	0	131	0	136
20747	130	0	0	10	0	140
20748	7	0	0	129	0	136
20749	5	0	123	5	0	133
20750	0	0	125	5	0	130
20751	2	0	10	127	0	139
20752	0	0	134	5	0	139
20753	124	0	5	5	0	134
20754	5	0	4	122	0	131
20755	133	0	0	5	0	138
20756	5	0	129	5	0	139
20757	7	0	5	126	0	138
20758	0	1	138	5	0	144
20759	0	131	5	5	0	141
20760	132	5	6	0	0	143
20761	136	5	0	1	0	142
20762	11	134	0	1	0	146
20763	141	5	0	3	0	149
20764	6	4	1	137	0	148
20765	6	1	0	139	0	146
20766	134	0	1	12	0	147
20767	6	133	1	6	0	146
20768	8	131	0	1	0	140
20769	0	11	2	131	0	144
20770	131	5	1	7	0	144
20771	139	0	0	7	0	146
20772	138	0	0	1	0	139
20773	12	0	129	0	0	141
20774	7	1	125	3	0	136
20775	0	131	11	1	0	143
20776	131	7	5	0	0	143
20777	9	5	0	131	0	145
20778	135	0	0	7	0	142
20779	137	1	0	4	0	142
20780	11	0	2	129	0	142
20781	8	0	128	6	0	142
20782	129	0	5	7	0	141
20783	8	0	5	130	0	143
20784	7	1	135	5	0	148
20785	130	1	5	5	0	141
20786	129	0	5	5	0	139
20787	13	0	1	129	0	143
20788	7	0	127	7	0	141
20789	3	0	6	129	0	138
20790	3	127	7	5	0	142
20791	0	5	129	6	0	140
20792	2	132	5	1	0	140
20793	129	5	6	1	0	141
20794	134	5	0	2	0	141
20795	137	1	0	2	0	140
20796	139	0	1	0	0	140
20797	11	0	1	127	0	139
20798	131	0	2	6	0	139
20799	7	0	1	130	0	138
20800	128	1	0	6	0	135
20801	4	123	2	6	0	135
20802	6	3	0	108	0	117
20803	1	115	0	2	0	118
20804	114	1	0	3	0	118
20805	111	2	1	1	0	115
20806	4	112	0	2	0	118
20807	3	3	0	107	0	113
20808	0	3	107	1	0	111
20809	0	2	1	104	0	107
20810	1	0	106	2	0	109
20811	2	0	1	99	0	102
20812	2	103	2	0	0	107
20813	104	1	0	2	0	107
20814	103	2	1	1	0	107
20815	4	0	1	101	0	106
20816	106	1	0	2	0	109
20817	4	0	0	102	0	106
20818	3	1	0	102	0	106
20819	1	0	0	106	0	107
20820	100	1	0	4	0	105
20821	100	0	0	2	0	102
20822	104	0	1	2	0	107
20823	4	96	0	0	0	100
20824	98	1	0	2	0	101
20825	1	96	2	0	0	99
20826	97	1	0	1	0	99
20827	2	1	1	95	0	99
20828	1	0	0	98	0	99
20829	95	1	1	2	0	99
20830	95	0	0	3	0	98
20831	3	95	0	0	0	98
20832	90	1	1	1	0	93
20833	2	2	0	89	0	93
20834	2	0	0	91	0	93
20835	87	0	0	3	0	90
20836	2	0	91	2	0	95
20837	3	80	1	0	0	84
20838	2	1	1	76	0	80
20839	1	0	73	1	0	75
20840	1	2	1	68	0	72
20841	66	0	0	1	0	67
20842	0	65	0	0	0	65
20843	1	61	0	0	0	62
20844	0	51	0	1	0	52
20845	0	0	1	51	0	52
20846	49	0	2	0	0	51
20847	0	0	0	51	0	51
20848	48	0	0	1	0	49
20849	49	1	0	0	0	50
20850	0	1	0	45	0	46
20851	47	0	0	0	0	47
20852	0	0	0	46	0	46
20853	1	0	45	0	0	46
20854	44	0	0	1	0	45
20855	1	0	47	0	0	48
20856	42	0	0	0	0	42
20857	0	0	44	1	0	45
20858	0	0	0	37	0	37
20859	0	0	0	41	0	41
20860	44	0	1	0	0	45
20861	1	0	0	41	0	42
20862	42	0	1	0	0	43
20863	0	43	0	0	0	43
20864	44	0	1	0	0	45
20865	0	0	0	41	0	41
20866	0	0	0	43	0	43
20867	2	0	0	39	0	41
20868	1	0	0	41	0	42
20869	0	0	40	1	0	41
20870	0	1	38	0	0	39
20871	1	0	0	42	0	43
20872	0	0	41	1	0	42
20873	0	39	0	1	0	40
20874	0	0	0	42	0	42
20875	0	0	43	1	0	44
20876	0	0	41	0	0	41
20877	0	0	2	40	0	42
20878	0	0	0	43	0	43
20879	0	41	1	0	0	42
20880	0	1	0	42	0	43
20881	0	0	46	1	0	47
20882	42	0	0	1	0	43
20883	0	0	1	44	0	45
20884	43	0	0	1	0	44
20885	43	0	0	1	0	44
20886	43	1	0	0	0	44
20887	0	0	46	1	0	47
20888	0	0	43	0	0	43
20889	40	0	0	0	0	40
20890	0	0	46	1	0	47
20891	1	0	0	39	0	40
20892	2	0	0	40	0	42
20893	1	0	41	0	0	42
20894	0	42	1	0	0	43
20895	42	0	1	0	0	43
20896	1	42	0	0	0	43
20897	0	43	1	0	0	44
20898	43	0	0	2	0	45
20899	0	0	43	1	0	44
20900	0	0	43	0	0	43
20901	1	1	0	41	0	43
20902	39	0	0	0	0	39
20903	0	45	0	0	0	45
20904	45	1	0	0	0	46
20905	1	0	44	0	0	45
20906	0	46	1	0	0	47
20907	0	0	1	47	0	48
20908	0	0	49	1	0	50
20909	1	0	0	49	0	50
20910	0	1	1	47	0	49
20911	2	0	0	50	0	52
20912	0	0	1	52	0	53
20913	51	1	0	0	0	52
20914	50	0	0	0	0	50
20915	0	0	54	0	0	54
20916	49	0	0	1	0	50
20917	0	49	0	1	0	50
20918	53	0	0	1	0	54
20919	0	0	51	1	0	52
20920	1	0	0	54	0	55
20921	1	0	54	0	0	55
20922	0	0	53	0	0	53
20923	1	0	0	53	0	54
20924	0	2	0	52	0	54
20925	1	0	53	1	0	55
20926	0	52	1	0	0	53
20927	0	52	0	2	0	54
20928	0	0	1	54	0	55
20929	48	0	1	1	0	50
20930	0	57	0	1	0	58
20931	1	0	54	2	0	57
20932	1	0	55	0	0	56
20933	0	1	54	0	0	55
20934	1	1	0	54	0	56
20935	53	1	0	1	0	55
20936	2	55	0	0	0	57
20937	0	1	57	0	0	58
20938	0	55	0	1	0	56
20939	1	0	1	55	0	57
20940	0	0	57	0	0	57
20941	1	57	0	0	0	58
20942	1	0	0	57	0	58
20943	0	0	1	57	0	58
20944	0	1	61	0	0	62
20945	1	0	0	56	0	57
20946	0	58	0	1	0	59
20947	1	0	63	0	0	64
20948	60	1	0	0	0	61
20949	0	0	1	63	0	64
20950	0	0	1	59	0	60
20951	0	61	1	0	0	62
20952	59	0	0	2	0	61
20953	1	0	60	0	0	61
20954	63	1	0	0	0	64
20955	1	0	1	63	0	65
20956	0	66	0	0	0	66
20957	0	0	0	68	0	68
20958	0	0	1	65	0	66
20959	65	1	0	0	0	66
20960	61	0	0	1	0	62
20961	1	0	0	63	0	64
20962	0	0	64	0	0	64
20963	59	0	0	1	0	60
20964	0	63	0	0	0	63
20965	0	0	1	63	0	64
20966	1	0	0	64	0	65
20967	0	0	0	64	0	64
20968	0	0	62	1	0	63
20969	0	1	0	62	0	63
20970	1	63	0	0	0	64
20971	0	0	1	62	0	63
20972	1	65	0	0	0	66
20973	1	0	0	65	0	66
20974	0	1	65	0	0	66
20975	60	0	0	1	0	61
20976	0	0	0	68	0	68
20977	1	0	77	0	0	78
20978	1	76	0	0	0	77
20979	76	0	0	1	0	77
20980	0	0	75	0	0	75
20981	71	0	0	0	0	71
20982	0	1	0	71	0	72
20983	0	0	0	72	0	72
20984	0	73	0	1	0	74
20985	72	0	0	1	0	73
20986	69	0	1	1	0	71
20987	0	81	0	1	0	82
20988	0	1	0	85	0	86
20989	1	0	0	84	0	85
20990	0	1	0	82	0	83
20991	0	0	79	1	0	80
20992	77	0	0	1	0	78
20993	0	0	0	81	0	81
20994	1	0	0	82	0	83
20995	0	0	81	0	0	81
20996	0	1	80	0	0	81
20997	2	0	0	79	0	81
20998	0	0	86	0	0	86
20999	82	0	0	1	0	83
21000	0	0	0	87	0	87
21001	0	0	0	91	0	91
21002	0	1	95	0	0	96
21003	1	0	0	95	0	96
21004	1	0	102	0	0	103
21005	0	104	0	0	0	104
21006	96	0	2	2	0	100
21007	99	0	0	0	0	99
21008	0	97	0	0	0	97
21009	2	1	0	94	0	97
21010	0	1	98	0	0	99
21011	1	0	0	96	0	97
21012	96	0	0	1	0	97
21013	0	97	0	0	0	97
21014	97	0	0	1	0	98
21015	1	0	0	97	0	98
21016	97	0	0	1	0	98
21017	0	95	0	0	0	95
21018	98	0	0	0	0	98
21019	0	0	95	0	0	95
21020	0	96	0	0	0	96
21021	0	0	0	97	0	97
21022	98	0	0	0	0	98
21023	98	0	0	1	0	99
21024	0	0	0	98	0	98
21025	99	0	0	2	0	101
21026	98	0	0	1	0	99
21027	99	0	0	1	0	100
21028	0	0	0	103	0	103
21029	0	0	100	0	0	100
21030	0	0	86	0	0	86
21031	0	0	95	0	0	95
21032	98	0	0	2	0	100
21033	0	0	0	100	0	100
21034	0	95	0	0	0	95
21035	0	0	0	99	0	99
21036	0	99	1	0	0	100
21037	100	0	0	0	0	100
21038	0	0	0	102	0	102
21039	0	0	0	107	0	107
21040	110	0	0	2	0	112
21041	0	0	0	111	0	111
21042	0	0	0	112	0	112
21043	109	0	0	1	0	110
21044	0	0	112	0	0	112
21045	0	0	0	110	0	110
21046	0	0	114	0	0	114
21047	111	0	0	1	0	112
21048	0	0	0	114	0	114
21049	113	0	0	0	0	113
21050	0	0	0	114	0	114
21051	0	0	123	0	0	123
21052	0	0	0	126	0	126
21053	126	0	1	1	0	128
21054	0	128	0	0	0	128
21055	1	0	131	0	0	132
21056	117	0	0	2	0	119
21057	0	131	1	0	0	132
21058	0	126	0	3	0	129
21059	1	141	2	0	0	144
21060	0	1	0	156	0	157
21061	155	0	1	1	0	157
21062	161	1	0	1	0	163
21063	1	2	157	0	0	160
21064	153	0	0	2	0	155
21065	1	156	1	0	0	158
21066	1	1	0	159	0	161
21067	163	1	0	2	0	166
21068	164	0	1	3	0	168
21069	168	1	1	1	0	171
21070	163	0	1	1	0	165
21071	170	1	0	0	0	171
21072	2	1	0	163	0	166
21073	2	0	160	2	0	164
21074	2	0	0	159	0	161
21075	5	0	1	162	0	168
21076	164	0	0	2	0	166
21077	2	153	1	2	0	158
21078	159	0	1	1	0	161
21079	156	1	2	4	0	163
21080	161	0	1	3	0	165
21081	171	0	0	4	0	175
21082	3	0	170	1	0	174
21083	161	2	0	1	0	164
21084	169	2	1	1	0	173
21085	159	1	0	1	0	161
21086	169	0	0	1	0	170
21087	4	0	1	158	0	163
21088	2	0	154	2	0	158
21089	155	0	0	2	0	157
21090	3	156	1	3	0	163
21091	4	1	0	155	0	160
21092	4	154	0	2	0	160
21093	5	0	1	163	0	169
21094	167	0	1	3	0	171
21095	168	0	2	1	0	171
21096	169	1	1	2	0	173
21097	3	1	162	2	0	168
21098	164	1	1	1	0	167
21099	1	1	158	4	0	164
21100	3	1	161	2	0	167
21101	3	0	158	3	0	164
21102	2	0	2	154	0	158
21103	3	0	2	159	0	164
21104	3	1	1	161	0	166
21105	1	1	2	165	0	169
21106	2	1	1	154	0	158
21107	2	0	2	162	0	166
21108	2	163	2	2	0	169
21109	159	1	1	4	0	165
21110	3	163	0	2	0	168
21111	1	1	1	165	0	168
21112	3	1	1	163	0	168
21113	161	1	1	7	0	170
21114	2	162	2	3	0	169
21115	164	2	1	1	0	168
21116	2	4	1	161	0	168
21117	2	1	0	162	0	165
21118	3	2	0	161	0	166
21119	3	1	158	3	0	165
21120	5	2	0	159	0	166
21121	5	1	156	2	0	164
21122	6	1	150	3	0	160
21123	4	0	166	3	0	173
21124	2	1	4	168	0	175
21125	3	0	2	173	0	178
21126	0	1	1	174	0	176
21127	177	0	2	4	0	183
21128	3	1	2	173	0	179
21129	172	0	2	3	0	177
21130	4	174	0	3	0	181
21131	182	2	0	4	0	188
21132	196	1	0	5	0	202
21133	5	191	2	2	0	200
21134	199	1	1	5	0	206
21135	196	2	2	2	0	202
21136	199	1	2	3	0	205
21137	203	1	1	0	0	205
21138	7	1	197	2	0	207
21139	6	190	2	1	0	199
21140	4	3	2	189	0	198
21141	190	1	2	3	0	196
21142	6	0	186	2	0	194
21143	4	190	2	1	0	197
21144	1	3	2	185	0	191
21145	1	193	1	4	0	199
21146	2	3	0	193	0	198
21147	3	2	0	188	0	193
21148	3	0	187	5	0	195
21149	2	1	187	1	0	191
21150	177	0	5	0	0	182
21151	5	1	187	1	0	194
21152	1	1	178	1	0	181
21153	2	1	5	171	0	179
21154	1	0	1	170	0	172
21155	1	167	1	4	0	173
21156	1	183	1	2	0	187
21157	1	4	184	2	0	191
21158	0	1	4	187	0	192
21159	0	1	171	6	0	178
21160	0	0	156	0	0	156
21161	0	158	3	1	0	162
21162	0	3	1	159	0	163
21163	158	0	1	5	0	164
21164	4	0	1	162	0	167
21165	166	0	0	4	0	170
21166	165	0	0	1	0	166
21167	169	0	0	1	0	170
21168	4	0	162	0	0	166
21169	158	0	3	2	0	163
21170	3	0	0	161	0	164
21171	161	1	0	3	0	165
21172	160	0	0	1	0	161
21173	4	161	0	1	0	166
21174	162	4	0	0	0	166
21175	4	0	170	0	0	174
21176	161	0	4	3	0	168
21177	169	0	0	0	0	169
21178	2	166	0	0	0	168
21179	166	3	0	1	0	170
21180	3	0	0	159	0	162
21181	0	0	0	161	0	161
21182	0	166	0	0	0	166
21183	0	3	0	169	0	172
21184	0	0	0	172	0	172
21185	0	0	174	3	0	177
21186	0	0	167	0	0	167
21187	162	0	3	0	0	165
21188	165	0	0	1	0	166
21189	4	1	0	165	0	170
21190	2	0	167	3	0	172
21191	1	163	4	0	0	168
21192	0	5	0	165	0	170
21193	1	0	162	3	0	166
21194	154	0	5	1	0	160
21195	5	0	0	166	0	171
21196	1	167	1	4	0	173
21197	0	5	1	172	0	178
21198	0	1	0	176	0	177
21199	0	0	0	172	0	172
21200	165	0	0	9	0	174
21201	6	0	1	162	0	169
21202	166	1	0	7	0	174
21203	170	0	0	1	0	171
21204	7	0	164	0	0	171
21205	0	161	7	1	0	169
21206	0	7	0	153	0	160
21207	0	165	1	5	0	171
21208	163	7	0	3	0	173
21209	9	0	0	168	0	177
21210	1	0	166	7	0	174
21211	0	0	172	0	0	172
21212	0	0	176	1	0	177
21213	160	0	8	2	0	170
21214	8	168	1	0	0	177
21215	165	9	0	1	0	175
21216	8	168	2	0	0	178
21217	0	7	0	170	0	177
21218	0	0	1	177	0	178
21219	0	171	1	8	0	180
21220	0	9	169	0	0	178
21221	0	170	8	1	0	179
21222	165	7	0	0	0	172
21223	7	1	0	159	0	167
21224	1	1	157	7	0	166
21225	1	0	163	1	0	165
21226	1	0	7	157	0	165
21227	0	0	150	7	0	157
21228	1	1	154	0	0	156
21229	138	0	6	2	0	146
21230	5	143	0	0	0	148
21231	135	7	0	2	0	144
21232	7	0	128	0	0	135
21233	1	124	7	0	0	132
21234	1	137	0	0	0	138
21235	0	6	2	130	0	138
21236	1	0	0	133	0	134
21237	1	0	0	137	0	138
21238	1	0	130	6	0	137
21239	1	0	5	128	0	134
21240	0	0	0	137	0	137
21241	129	0	0	7	0	136
21242	6	127	1	0	0	134
21243	2	5	0	124	0	131
21244	123	0	0	7	0	130
21245	126	0	0	1	0	127
21246	6	0	0	121	0	127
21247	0	0	122	7	0	129
21248	0	0	5	121	0	126
21249	0	0	118	6	0	124
21250	121	0	6	3	0	130
21251	146	0	0	1	0	147
21252	6	0	1	150	0	157
21253	0	0	155	7	0	162
21254	0	159	7	0	0	166
21255	1	5	160	0	0	166
21256	1	0	7	143	0	151
21257	0	147	0	6	0	153
21258	141	7	0	1	0	149
21259	7	0	0	136	0	143
21260	0	137	0	6	0	143
21261	144	6	0	0	0	150
21262	7	0	0	138	0	145
21263	0	147	0	6	0	153
21264	1	6	1	143	0	151
21265	0	0	146	5	0	151
21266	139	0	5	1	0	145
21267	148	0	0	0	0	148
21268	6	0	139	0	0	145
21269	0	143	6	0	0	149
21270	138	6	0	2	0	146
21271	7	0	0	135	0	142
21272	1	0	0	138	0	139
21273	1	0	0	139	0	140
21274	2	0	0	143	0	145
21275	3	0	0	136	0	139
21276	129	0	0	8	0	137
21277	138	0	0	0	0	138
21278	5	0	0	132	0	137
21279	0	0	0	141	0	141
21280	1	0	131	5	0	137
21281	0	0	133	0	0	133
21282	130	0	5	0	0	135
21283	7	0	0	129	0	136
21284	0	0	127	5	0	132
21285	0	0	6	130	0	136
21286	130	0	0	7	0	137
21287	135	0	1	1	0	137
21288	4	0	0	130	0	134
21289	1	0	0	131	0	132
21290	130	0	0	5	0	135
21291	5	0	0	131	0	136
21292	0	133	0	4	0	137
21293	0	3	0	131	0	134
21294	0	0	0	136	0	136
21295	0	0	129	4	0	133
21296	1	0	129	0	0	130
21297	0	131	4	0	0	135
21298	124	4	0	1	0	129
21299	127	0	0	0	0	127
21300	131	0	0	1	0	132
21301	3	123	1	0	0	127
21302	0	130	0	0	0	130
21303	124	3	0	1	0	128
21304	2	127	1	1	0	131
21305	0	3	123	0	0	126
21306	0	124	4	0	0	128
21307	0	3	121	1	0	125
21308	120	0	4	0	0	124
21309	126	1	0	0	0	127
21310	2	120	0	0	0	122
21311	123	2	0	1	0	126
21312	123	0	0	0	0	123
21313	123	0	1	0	0	124
21314	2	0	0	124	0	126
21315	124	2	1	1	0	128
21316	4	1	119	1	0	125
21317	121	0	2	2	0	125
21318	2	2	0	122	0	126
21319	1	1	118	2	0	122
21320	1	0	119	1	0	121
21321	3	0	2	116	0	121
21322	3	0	0	119	0	122
21323	120	0	2	2	0	124
21324	3	1	0	120	0	124
21325	2	1	117	2	0	122
21326	1	1	5	114	0	121
21327	1	121	2	3	0	127
21328	124	3	1	2	0	130
21329	5	0	1	122	0	128
21330	2	0	123	4	0	129
21331	2	115	3	2	0	122
21332	118	4	0	2	0	124
21333	4	1	0	129	0	134
21334	2	1	122	6	0	131
21335	1	120	3	1	0	125
21336	122	2	2	3	0	129
21337	119	3	0	3	0	125
21338	119	0	2	2	0	123
21339	5	1	2	115	0	123
21340	4	0	2	118	0	124
21341	118	2	0	4	0	124
21342	6	109	2	1	0	118
21343	117	2	2	2	0	123
21344	8	0	2	114	0	124
21345	121	1	0	4	0	126
21346	3	0	2	120	0	125
21347	3	1	1	121	0	126
21348	7	0	0	118	0	125
21349	4	0	0	124	0	128
21350	2	1	114	3	0	120
21351	1	0	94	3	0	98
21352	73	1	1	3	0	78
21353	2	1	79	1	0	83
21354	2	0	69	3	0	74
21355	66	2	1	2	0	71
21356	68	0	1	2	0	71
21357	1	0	0	85	0	86
21358	82	1	2	0	0	85
21359	1	89	1	2	0	93
21360	92	2	1	1	0	96
21361	92	0	2	0	0	94
21362	98	1	0	2	0	101
21363	2	0	1	90	0	93
21364	0	95	1	1	0	97
21365	1	96	1	0	0	98
21366	97	1	0	1	0	99
21367	94	0	1	1	0	96
21368	2	1	0	93	0	96
21369	2	1	0	92	0	95
21370	2	94	0	1	0	97
21371	96	0	0	2	0	98
21372	2	0	94	1	0	97
21373	0	1	0	95	0	96
21374	1	1	0	92	0	94
21375	0	1	94	1	0	96
21376	3	0	0	91	0	94
21377	1	79	0	2	0	82
21378	1	0	0	104	0	105
21379	0	0	0	101	0	101
21380	0	99	0	2	0	101
21381	1	105	1	1	0	108
21382	1	0	2	101	0	104
21383	107	0	1	1	0	109
21384	0	0	2	103	0	105
21385	1	0	2	104	0	107
21386	1	115	1	1	0	118
21387	1	1	1	116	0	119
21388	2	0	0	115	0	117
21389	2	0	0	115	0	117
21390	117	2	0	2	0	121
21391	1	1	1	115	0	118
21392	1	1	1	109	0	112
21393	5	0	0	114	0	119
21394	2	0	112	2	0	116
21395	95	0	1	0	0	96
21396	1	107	0	1	0	109
21397	112	1	0	1	0	114
21398	0	1	0	108	0	109
21399	1	0	103	1	0	105
21400	101	1	0	1	0	103
21401	2	0	170	1	0	173
21402	2	0	0	175	0	177
21403	190	0	0	2	0	192
21404	188	0	1	1	0	190
21405	197	1	0	1	0	199
21406	0	2	0	200	0	202
21407	2	0	0	204	0	206
21408	1	0	0	204	0	205
21409	0	198	1	1	0	200
21410	1	203	0	1	0	205
21411	0	204	0	0	0	204
21412	1	213	2	0	0	216
21413	0	0	1	218	0	219
21414	0	0	0	220	0	220
21415	218	0	0	3	0	221
21416	217	0	1	1	0	219
21417	219	0	0	1	0	220
21418	0	0	0	210	0	210
21419	0	0	0	220	0	220
21420	218	0	0	2	0	220
21421	210	1	0	1	0	212
21422	0	1	212	0	0	213
21423	1	0	206	1	0	208
21424	1	0	213	0	0	214
21425	0	0	216	1	0	217
21426	0	0	0	215	0	215
21427	220	1	0	0	0	221
21428	0	217	0	2	0	219
21429	0	0	0	223	0	223
21430	0	1	220	2	0	223
21431	1	228	0	0	0	229
21432	0	0	0	236	0	236
21433	0	0	237	1	0	238
21434	1	0	0	234	0	235
21435	0	0	1	230	0	231
21436	235	0	0	0	0	235
21437	0	1	0	237	0	238
21438	1	0	240	0	0	241
21439	0	0	0	234	0	234
21440	0	258	1	0	0	259
21441	1	0	0	277	0	278
21442	0	0	1	272	0	273
21443	0	0	0	277	0	277
21444	279	0	0	2	0	281
21445	279	0	0	2	0	281
21446	283	0	0	0	0	283
21447	278	0	0	3	0	281
21448	0	0	278	1	0	279
21449	262	0	0	2	0	264
21450	274	0	0	1	0	275
21451	0	0	273	0	0	273
21452	0	0	291	0	0	291
21453	0	0	1	302	0	303
21454	0	300	1	0	0	301
21455	305	0	1	6	0	312
21456	308	0	0	2	0	310
21457	315	0	0	1	0	316
21458	0	0	0	313	0	313
21459	0	331	0	0	0	331
21460	352	0	0	4	0	356
21461	354	0	0	1	0	355
21462	0	0	0	351	0	351
21463	0	0	342	0	0	342
21464	331	0	0	2	0	333
21465	0	0	0	343	0	343
21466	347	0	0	0	0	347
21467	1	0	1	342	0	344
21468	1	2	333	1	0	337
21469	361	0	0	1	0	362
21470	0	0	0	382	0	382
21471	0	0	0	380	0	380
21472	1	0	0	378	0	379
21473	0	0	0	381	0	381
21474	375	0	0	3	0	378
21475	0	0	0	377	0	377
21476	1	373	0	0	0	374
21477	0	1	0	381	0	382
21478	0	386	1	0	0	387
21479	2	0	0	391	0	393
21480	0	0	0	397	0	397
21481	0	394	0	0	0	394
21482	0	1	0	399	0	400
21483	0	0	0	392	0	392
21484	391	0	0	3	0	394
21485	0	0	394	0	0	394
21486	1	1	0	396	0	398
21487	398	0	0	2	0	400
21488	392	0	0	4	0	396
21489	390	1	0	4	0	395
21490	1	0	392	0	0	393
21491	2	1	392	0	0	395
21492	2	1	1	402	0	406
21493	411	0	2	3	0	416
21494	1	0	406	0	0	407
21495	392	0	1	4	0	397
21496	3	416	1	2	0	422
21497	1	1	1	459	0	462
21498	2	1	0	471	0	474
21499	478	2	0	4	0	484
21500	2	0	0	473	0	475
21501	453	0	1	6	0	460
21502	474	0	0	0	0	474
21503	1	0	0	471	0	472
21504	2	1	0	469	0	472
21505	466	0	0	6	0	472
21506	1	0	523	2	0	526
21507	515	0	1	5	0	521
21508	3	0	546	0	0	549
21509	539	0	3	4	0	546
21510	592	0	0	4	0	596
21511	589	0	1	2	0	592
21512	580	0	0	3	0	583
21513	4	575	1	1	0	581
21514	596	2	0	1	0	599
21515	589	0	0	6	0	595
21516	2	638	0	0	0	640
21517	641	2	0	7	0	650
21518	4	0	634	0	0	638
21519	624	2	2	1	0	629
21520	4	0	643	0	0	647
21521	3	0	3	633	0	639
21522	3	0	1	642	0	646
21523	0	0	658	3	0	661
21524	0	0	2	633	0	635
21525	17	2	7	438	0	464
21526	663	0	2	8	0	673
21527	4	0	1	670	0	675
21528	4	0	0	664	0	668
21529	4	0	0	670	0	674
21530	0	642	2	6	0	650
21531	1	2	1	659	0	663
21532	650	1	0	9	0	660
21533	5	1	654	4	0	664
21534	3	0	6	656	0	665
21535	2	0	662	8	0	672
21536	631	0	8	4	0	643
21537	10	1	1	664	0	676
21538	1	2	859	6	0	868
21539	7	0	19	847	0	873
21540	5	0	11	855	0	871
21541	0	851	11	28	0	890
21542	2	21	2	876	0	901
21543	4	9	6	917	0	936
21544	2	8	898	38	0	946
21545	3	1	24	924	0	952
21546	2	5	12	941	0	960
21547	893	0	8	53	0	954
21548	908	1	2	27	0	938
21549	33	912	3	10	0	958
21550	919	21	1	18	0	959
21551	927	10	2	17	0	956
21552	39	921	4	4	0	968
21553	26	25	0	922	0	973
21554	917	14	2	35	0	968
21555	938	8	2	21	0	969
21556	938	3	4	15	0	960
21557	46	908	5	4	0	963
21558	25	26	897	11	0	959
21559	906	14	24	9	0	953
21560	917	13	7	8	0	945
21561	43	898	9	8	0	958
21562	910	32	3	13	0	958
21563	920	11	6	7	0	944
21564	53	15	3	871	0	942
21565	27	5	867	34	0	933
21566	22	6	30	873	0	931
21567	18	5	13	891	0	927
21568	17	4	8	905	0	934
21569	6	8	851	53	0	918
21570	17	3	34	820	0	874
21571	10	2	14	879	0	905
21572	7	3	11	885	0	906
21573	12	2	6	874	0	894
21574	15	1	7	876	0	899
21575	7	830	3	60	0	900
21576	8	29	3	866	0	906
21577	11	13	7	889	0	920
21578	9	12	836	52	0	909
21579	9	3	27	908	0	947
21580	9	8	13	925	0	955
21581	12	3	11	942	0	968
21582	14	1	3	960	0	978
21583	899	9	6	67	0	981
21584	36	4	6	936	0	982
21585	28	1	2	950	0	981
21586	15	6	879	63	0	963
21587	8	836	37	44	0	925
21588	10	913	18	27	0	968
21589	868	41	13	33	0	955
21590	38	892	7	22	0	959
21591	23	39	9	891	0	962
21592	875	23	5	55	0	958
21593	39	15	865	32	0	951
21594	27	8	35	862	0	932
21595	12	857	17	50	0	936
21596	14	36	11	862	0	923
21597	16	848	8	51	0	923
21598	8	45	7	864	0	924
21599	831	15	4	73	0	923
21600	41	20	847	37	0	945
21601	28	5	40	829	0	902
21602	17	835	19	50	0	921
21603	833	40	12	43	0	928
21604	47	20	827	29	0	923
21605	35	20	38	828	0	921
21606	23	11	799	53	0	886
21607	21	14	42	795	0	872
21608	20	2	776	57	0	855
21609	12	11	47	756	0	826
21610	10	16	20	792	0	838
21611	740	2	23	65	0	830
21612	761	9	13	41	0	824
21613	53	6	12	730	0	801
21614	31	718	8	54	0	811
21615	28	34	8	744	0	814
21616	21	20	12	745	0	798
21617	688	16	5	73	0	782
21618	39	695	7	38	0	779
21619	693	46	5	33	0	777
21620	699	17	9	30	0	755
21621	51	665	5	26	0	747
21622	28	695	13	21	0	757
21623	671	49	8	30	0	758
21624	47	26	658	27	0	758
21625	655	16	34	30	0	735
21626	658	15	21	26	0	720
21627	57	632	15	23	0	727
21628	35	32	9	579	0	655
21629	18	639	14	45	0	716
21630	634	50	6	33	0	723
21631	661	24	7	26	0	718
21632	53	22	9	624	0	708
21633	38	13	4	654	0	709
21634	606	16	3	54	0	679
21635	45	584	9	42	0	680
21636	30	578	8	28	0	644
21637	17	606	6	24	0	653
21638	14	338	1	13	0	366
21639	7	364	7	10	0	388
21640	12	22	5	340	0	379
21641	9	15	322	19	0	365
21642	8	326	15	13	0	362
21643	280	18	5	7	0	310
21644	12	9	6	275	0	302
21645	275	5	2	17	0	299
21646	15	280	5	4	0	304
21647	282	11	2	6	0	301
21648	19	276	5	6	0	306
21649	11	17	3	271	0	302
21650	273	8	6	17	0	304
21651	288	7	2	10	0	307
21652	21	6	6	276	0	309
21653	13	6	1	279	0	299
21654	8	270	2	19	0	299
21655	11	12	2	284	0	309
21656	9	8	1	291	0	309
21657	5	8	3	289	0	305
21658	7	269	1	18	0	295
21659	242	8	3	14	0	267
21660	9	253	0	10	0	272
21661	245	12	0	7	0	264
21662	13	251	0	4	0	268
21663	13	8	239	1	0	261
21664	7	9	6	237	0	259
21665	6	7	231	9	0	253
21666	6	2	235	4	0	247
21667	7	3	12	228	0	250
21668	4	3	232	11	0	250
21669	8	2	10	228	0	248
21670	6	3	5	225	0	239
21671	7	5	2	232	0	246
21672	226	2	1	14	0	243
21673	11	7	1	224	0	243
21674	8	2	0	227	0	237
21675	213	3	1	13	0	230
21676	13	208	1	5	0	227
21677	4	197	0	7	0	208
21678	6	197	0	5	0	208
21679	5	9	0	141	0	155
21680	3	4	138	1	0	146
21681	114	4	2	3	0	123
21682	2	116	2	1	0	121
21683	110	0	2	1	0	113
21684	108	1	1	2	0	112
21685	114	0	1	0	0	115
21686	1	2	114	1	0	118
21687	2	0	0	117	0	119
21688	2	1	1	115	0	119
21689	3	0	0	115	0	118
21690	1	0	0	110	0	111
21691	0	113	0	4	0	117
21692	116	0	0	3	0	119
21693	1	1	109	0	0	111
21694	101	0	0	0	0	101
21695	0	1	1	103	0	105
21696	1	100	0	0	0	101
21697	0	106	0	1	0	107
21698	1	4	0	98	0	103
21699	0	102	0	0	0	102
21700	89	0	0	0	0	89
21701	2	0	86	0	0	88
21702	1	0	0	84	0	85
21703	0	0	0	83	0	83
21704	0	0	0	81	0	81
21705	1	0	0	80	0	81
21706	85	0	0	0	0	85
21707	0	46	0	43	0	89
21708	94	0	0	1	0	95
21709	1	0	0	94	0	95
21710	1	0	0	97	0	98
21711	0	92	0	7	0	99
21712	102	2	0	0	0	104
21713	105	1	0	0	0	106
21714	3	99	0	0	0	102
21715	1	2	0	98	0	101
21716	0	101	0	2	0	103
21717	94	2	4	1	0	101
21718	2	1	98	0	0	101
21719	1	0	96	0	0	97
21720	86	0	3	0	0	89
21721	2	90	1	1	0	94
21722	2	2	0	91	0	95
21723	0	1	0	93	0	94
21724	0	2	88	4	0	94
21725	0	1	2	87	0	90
21726	1	0	1	91	0	93
21727	1	86	0	3	0	90
21728	0	3	0	85	0	88
21729	0	1	0	88	0	89
21730	85	1	0	3	0	89
21731	3	82	0	1	0	86
21732	1	84	1	0	0	86
21733	1	3	1	84	0	89
21734	1	1	0	84	0	86
21735	0	1	0	87	0	88
21736	0	82	0	3	0	85
21737	0	2	0	85	0	87
21738	0	1	1	84	0	86
21739	0	0	0	87	0	87
21740	0	0	0	86	0	86
21741	0	78	0	3	0	81
21742	0	86	0	2	0	88
21743	83	3	0	2	0	88
21744	86	1	0	0	0	87
21745	3	1	0	85	0	89
21746	1	1	88	2	0	92
21747	0	0	2	92	0	94
21748	0	0	1	94	0	95
21749	87	0	0	4	0	91
21750	2	95	0	1	0	98
21751	1	2	0	95	0	98
21752	0	1	0	98	0	99
21753	0	0	95	3	0	98
21754	1	0	93	2	0	96
21755	1	2	3	92	0	98
21756	0	1	1	93	0	95
21757	1	94	0	2	0	97
21758	1	96	0	0	0	97
21759	94	3	0	1	0	98
21760	3	1	1	93	0	98
21761	3	0	99	3	0	105
21762	1	100	2	3	0	106
21763	1	3	1	102	0	107
21764	101	3	0	3	0	107
21765	3	1	0	103	0	107
21766	101	0	0	3	0	104
21767	2	102	2	1	0	107
21768	102	2	2	1	0	107
21769	4	2	0	101	0	107
21770	2	1	103	3	0	109
21771	0	1	3	100	0	104
21772	0	108	1	3	0	112
21773	2	2	1	107	0	112
21774	0	113	0	4	0	117
21775	0	2	1	119	0	122
21776	0	3	111	3	0	117
21777	0	0	118	3	0	121
21778	1	0	117	3	0	121
21779	113	0	5	2	0	120
21780	4	114	2	2	0	122
21781	1	118	2	1	0	122
21782	115	5	0	2	0	122
21783	117	1	0	3	0	121
21784	5	2	1	115	0	123
21785	2	1	111	4	0	118
21786	2	1	112	3	0	118
21787	0	1	4	115	0	120
21788	111	1	2	5	0	119
21789	3	111	0	3	0	117
21790	1	4	2	114	0	121
21791	109	2	1	4	0	116
21792	113	2	1	2	0	118
21793	6	0	110	3	0	119
21794	101	2	3	1	0	107
21795	4	2	112	1	0	119
21796	2	0	115	1	0	118
21797	3	0	5	109	0	117
21798	2	0	4	111	0	117
21799	3	1	4	112	0	120
21800	0	1	110	7	0	118
21801	109	1	3	5	0	118
21802	7	0	1	115	0	123
21803	111	2	2	5	0	120
21804	114	0	0	7	0	121
21805	5	116	2	2	0	125
21806	1	117	3	0	0	121
21807	1	115	1	1	0	118
21808	3	5	0	100	0	108
21809	0	3	102	4	0	109
21810	1	5	4	89	0	99
21811	2	96	1	3	0	102
21812	2	92	1	1	0	96
21813	0	2	1	92	0	95
21814	88	1	1	2	0	92
21815	2	88	2	0	0	92
21816	0	91	1	2	0	94
21817	90	2	0	2	0	94
21818	3	1	0	90	0	94
21819	0	1	0	92	0	93
21820	2	1	1	90	0	94
21821	90	0	0	3	0	93
21822	88	0	1	3	0	92
21823	4	0	0	89	0	93
21824	2	0	89	3	0	94
21825	89	1	3	0	0	93
21826	3	1	0	88	0	92
21827	0	1	86	4	0	91
21828	1	0	81	2	0	84
21829	0	0	4	82	0	86
21830	2	0	89	4	0	95
21831	0	1	4	100	0	105
21832	1	0	1	90	0	92
21833	3	0	1	101	0	105
21834	100	2	1	2	0	105
21835	3	2	0	100	0	105
21836	1	1	0	101	0	103
21837	3	0	0	100	0	103
21838	2	1	1	102	0	106
21839	1	0	95	6	0	102
21840	0	91	2	4	0	97
21841	1	3	0	96	0	100
21842	1	0	1	89	0	91
21843	2	90	2	3	0	97
21844	1	92	1	0	0	94
21845	92	3	0	3	0	98
21846	3	87	1	3	0	94
21847	1	4	1	86	0	92
21848	1	1	86	3	0	91
21849	84	1	4	2	0	91
21850	3	1	83	2	0	89
21851	76	0	2	5	0	83
21852	80	0	2	3	0	85
21853	4	0	79	2	0	85
21854	3	0	3	72	0	78
21855	3	73	0	6	0	82
21856	2	2	2	79	0	85
21857	79	0	2	6	0	87
21858	77	1	1	4	0	83
21859	2	80	2	3	0	87
21860	77	2	0	4	0	83
21861	4	1	1	72	0	78
21862	75	3	1	1	0	80
21863	73	3	0	1	0	77
21864	3	0	0	72	0	75
21865	70	2	0	5	0	77
21866	69	3	0	1	0	73
21867	4	1	71	3	0	79
21868	69	1	4	2	0	76
21869	3	2	66	2	0	73
21870	2	1	61	0	0	64
21871	3	65	3	0	0	71
21872	3	2	4	56	0	65
21873	2	0	62	2	0	66
21874	2	3	59	0	0	64
21875	62	2	3	1	0	68
21876	3	0	1	62	0	66
21877	1	1	1	63	0	66
21878	0	2	1	63	0	66
21879	3	0	0	65	0	68
21880	3	0	0	61	0	64
21881	3	1	63	1	0	68
21882	2	1	62	2	0	67
21883	1	0	2	69	0	72
21884	66	0	0	3	0	69
21885	4	66	1	1	0	72
21886	2	1	3	67	0	73
21887	68	0	1	3	0	72
21888	3	68	0	1	0	72
21889	1	1	3	64	0	69
21890	1	1	1	73	0	76
21891	2	0	1	70	0	73
21892	67	1	3	3	0	74
21893	2	1	67	1	0	71
21894	67	1	1	2	0	71
21895	1	0	1	71	0	73
21896	1	0	2	67	0	70
21897	1	65	2	3	0	71
21898	2	1	71	2	0	76
21899	70	1	1	4	0	76
21900	71	0	0	4	0	75
21901	0	1	73	3	0	77
21902	67	1	1	5	0	74
21903	1	69	1	1	0	72
21904	1	71	2	0	0	74
21905	0	67	2	2	0	71
21906	68	0	0	1	0	69
21907	1	2	70	0	0	73
21908	1	1	0	66	0	68
21909	0	65	0	2	0	67
21910	1	67	0	1	0	69
21911	0	67	0	0	0	67
21912	1	0	1	54	0	56
21913	61	0	0	3	0	64
21914	0	68	0	1	0	69
21915	1	0	0	70	0	71
21916	0	1	1	69	0	71
21917	68	0	1	2	0	71
21918	3	0	0	68	0	71
21919	2	0	0	69	0	71
21920	1	1	76	0	0	78
21921	2	0	1	73	0	76
21922	2	2	0	74	0	78
21923	77	1	0	2	0	80
21924	76	1	1	1	0	79
21925	4	0	0	79	0	83
21926	80	1	1	2	0	84
21927	76	0	0	3	0	79
21928	1	85	0	0	0	86
21929	2	1	81	0	0	84
21930	0	80	2	0	0	82
21931	1	0	0	71	0	72
21932	68	0	3	1	0	72
21933	0	64	1	0	0	65
21934	0	1	0	65	0	66
21935	66	0	0	1	0	67
21936	64	0	1	0	0	65
21937	1	0	1	60	0	62
21938	1	0	69	0	0	70
21939	0	0	0	70	0	70
21940	1	0	0	71	0	72
21941	0	0	73	1	0	74
21942	1	0	0	70	0	71
21943	1	0	0	70	0	71
21944	74	0	1	1	0	76
21945	0	0	1	74	0	75
21946	1	0	0	73	0	74
21947	73	0	0	1	0	74
21948	73	1	0	0	0	74
21949	71	0	0	2	0	73
21950	1	0	73	0	0	74
21951	0	1	0	71	0	72
21952	0	71	0	1	0	72
21953	0	0	0	74	0	74
21954	0	0	73	1	0	74
21955	2	0	0	62	0	64
21956	0	0	72	0	0	72
21957	67	0	0	1	0	68
21958	71	0	0	0	0	71
21959	0	0	0	76	0	76
21960	1	0	0	79	0	80
21961	0	0	0	81	0	81
21962	0	86	0	0	0	86
21963	88	0	0	0	0	88
21964	86	0	0	2	0	88
21965	0	1	0	85	0	86
21966	0	0	0	87	0	87
21967	0	0	0	87	0	87
21968	1	0	0	85	0	86
21969	0	0	87	1	0	88
21970	0	1	0	88	0	89
21971	84	0	0	3	0	87
21972	86	0	0	2	0	88
21973	1	0	0	84	0	85
21974	0	0	84	0	0	84
21975	78	1	0	1	0	80
21976	0	0	0	86	0	86
21977	0	86	0	0	0	86
21978	0	91	0	0	0	91
21979	96	0	0	0	0	96
21980	1	0	0	94	0	95
21981	0	0	0	94	0	94
21982	0	0	0	99	0	99
21983	0	0	0	100	0	100
21984	0	0	0	100	0	100
21985	0	0	101	0	0	101
21986	0	0	97	0	0	97
21987	0	0	93	0	0	93
21988	0	0	0	95	0	95
21989	0	0	98	0	0	98
21990	1	0	0	95	0	96
21991	0	0	0	97	0	97
21992	0	0	0	100	0	100
21993	101	0	0	1	0	102
21994	1	0	0	103	0	104
21995	0	0	0	104	0	104
21996	106	0	0	0	0	106
21997	0	105	0	0	0	105
21998	0	106	0	0	0	106
21999	104	0	0	0	0	104
22000	0	108	0	0	0	108
22001	107	0	0	0	0	107
22002	110	0	0	1	0	111
22003	110	0	0	0	0	110
22004	108	0	0	1	0	109
22005	107	0	0	1	0	108
22006	0	111	0	0	0	111
22007	109	0	0	0	0	109
22008	108	0	0	1	0	109
22009	0	113	0	0	0	113
22010	117	0	0	1	0	118
22011	119	0	0	0	0	119
22012	123	0	0	1	0	124
22013	128	0	0	0	0	128
22014	2	0	129	0	0	131
22015	1	0	2	137	0	140
22016	0	1	1	135	0	137
22017	1	1	133	2	0	137
22018	1	1	132	1	0	135
22019	130	0	3	0	0	133
22020	2	0	1	133	0	136
22021	1	0	136	2	0	139
22022	1	0	127	1	0	129
22023	127	0	3	2	0	132
22024	133	0	1	2	0	136
22025	138	0	0	0	0	138
22026	3	0	129	0	0	132
22027	2	0	2	127	0	131
22028	0	0	127	2	0	129
22029	122	0	3	3	0	128
22030	3	1	123	0	0	127
22031	1	0	3	119	0	123
22032	0	1	0	116	0	117
22033	1	126	0	4	0	131
22034	127	4	0	2	0	133
22035	4	1	127	0	0	132
22036	121	0	4	1	0	126
22037	4	0	125	1	0	130
22038	1	0	5	125	0	131
22039	1	0	2	129	0	132
22040	2	0	0	129	0	131
22041	124	0	0	7	0	131
22042	7	0	1	125	0	133
22043	2	0	2	128	0	132
22044	1	120	1	5	0	127
22045	2	4	0	127	0	133
22046	121	1	1	5	0	128
22047	4	0	125	2	0	131
22048	2	0	5	130	0	137
22049	1	0	127	4	0	132
22050	1	122	6	2	0	131
22051	1	4	130	0	0	135
22052	127	1	5	2	0	135
22053	137	0	2	1	0	140
22054	7	1	1	131	0	140
22055	133	0	1	5	0	139
22056	135	0	2	2	0	139
22057	8	0	1	132	0	141
22058	1	0	2	140	0	143
22059	1	0	131	7	0	139
22060	1	129	5	2	0	137
22061	129	4	1	4	0	138
22062	5	128	2	0	0	135
22063	2	5	0	130	0	137
22064	1	1	1	134	0	137
22065	1	2	1	137	0	141
22066	2	0	1	138	0	141
22067	1	0	134	6	0	141
22068	123	0	5	4	0	132
22069	132	0	2	2	0	136
22070	6	0	1	130	0	137
22071	131	1	0	6	0	138
22072	4	1	1	134	0	140
22073	3	1	127	5	0	136
22074	1	1	4	131	0	137
22075	1	126	1	6	0	134
22076	2	5	1	126	0	134
22077	1	130	1	5	0	137
22078	2	4	1	128	0	135
22079	1	126	2	4	0	133
22080	124	4	2	2	0	132
22081	5	3	123	0	0	131
22082	4	115	4	0	0	123
22083	1	122	2	1	0	126
22084	2	5	0	115	0	122
22085	1	0	0	118	0	119
22086	3	0	0	122	0	125
22087	1	0	0	122	0	123
22088	1	111	2	6	0	120
22089	1	5	1	119	0	126
22090	3	2	0	118	0	123
22091	115	1	1	6	0	123
22092	5	1	0	117	0	123
22093	2	0	115	7	0	124
22094	0	1	116	3	0	120
22095	106	1	5	4	0	116
22096	3	110	2	2	0	117
22097	2	113	1	2	0	118
22098	2	6	1	109	0	118
22099	2	1	1	112	0	116
22100	2	1	104	6	0	113
22101	104	0	4	2	0	110
22102	107	0	2	3	0	112
22103	6	1	111	0	0	118
22104	1	2	107	2	0	112
22105	109	2	6	1	0	118
22106	118	1	1	3	0	123
22107	117	1	0	4	0	122
22108	119	1	0	3	0	123
22109	6	112	0	0	0	118
22110	100	4	0	1	0	105
22111	4	1	96	1	0	102
22112	1	0	84	0	0	85
22113	0	0	88	0	0	88
22114	3	8	4	56	0	71
22115	59	0	1	3	0	63
22116	61	0	0	0	0	61
22117	3	0	0	60	0	63
22118	0	0	0	59	0	59
22119	0	0	0	65	0	65
22120	0	67	0	3	0	70
22121	71	2	0	1	0	74
22122	75	0	0	2	0	77
22123	76	0	0	0	0	76
22124	77	0	0	1	0	78
22125	74	0	0	0	0	74
22126	2	0	0	72	0	74
22127	0	73	0	3	0	76
22128	0	2	0	73	0	75
22129	0	0	0	76	0	76
22130	72	0	0	2	0	74
22131	2	0	71	0	0	73
22132	0	0	65	0	0	65
22133	0	0	63	0	0	63
22134	66	0	2	0	0	68
22135	68	0	0	0	0	68
22136	1	0	0	71	0	72
22137	0	0	0	75	0	75
22138	0	0	0	75	0	75
22139	0	0	74	1	0	75
22140	0	0	1	72	0	73
22141	0	0	82	1	0	83
22142	0	0	1	77	0	78
22143	0	0	0	78	0	78
22144	0	0	0	79	0	79
22145	82	0	0	1	0	83
22146	82	0	0	0	0	82
22147	1	0	81	0	0	82
22148	86	0	1	0	0	87
22149	89	0	0	1	0	90
22150	1	0	0	89	0	90
22151	91	0	0	2	0	93
22152	1	0	0	93	0	94
22153	0	0	0	97	0	97
22154	0	0	94	2	0	96
22155	91	0	2	0	0	93
22156	1	1	0	97	0	99
22157	0	0	100	1	0	101
22158	0	0	98	1	0	99
22159	0	0	1	98	0	99
22160	0	0	0	101	0	101
22161	103	0	0	2	0	105
22162	2	0	0	104	0	106
22163	0	0	1	100	0	101
22164	1	0	0	98	0	99
22165	1	0	0	104	0	105
22166	106	0	0	2	0	108
22167	109	0	0	0	0	109
22168	109	0	0	2	0	111
22169	110	0	0	2	0	112
22170	1	0	1	111	0	113
22171	111	0	0	1	0	112
22172	1	0	0	112	0	113
22173	110	0	1	1	0	112
22174	2	0	1	110	0	113
22175	0	0	0	113	0	113
22176	0	106	0	2	0	108
22177	1	1	0	108	0	110
22178	107	0	0	2	0	109
22179	104	0	0	2	0	106
22180	1	0	107	1	0	109
22181	0	105	1	1	0	107
22182	107	1	0	0	0	108
22183	2	107	1	0	0	110
22184	111	1	0	0	0	112
22185	2	115	0	0	0	117
22186	0	1	114	1	0	116
22187	1	115	1	0	0	117
22188	0	117	0	1	0	118
22189	1	1	0	117	0	119
22190	122	0	0	2	0	124
22191	1	0	0	124	0	125
22192	0	1	0	125	0	126
22193	122	0	0	2	0	124
22194	128	0	0	0	0	128
22195	2	0	0	128	0	130
22196	0	0	1	131	0	132
22197	0	1	0	129	0	130
22198	129	0	0	2	0	131
22199	1	1	130	0	0	132
22200	1	0	1	128	0	130
22201	0	1	132	1	0	134
22202	0	125	2	0	0	127
22203	0	2	124	0	0	126
22204	0	1	1	123	0	125
22205	0	0	126	2	0	128
22206	126	0	1	0	0	127
22207	2	0	0	130	0	132
22208	0	134	0	2	0	136
22209	1	1	0	132	0	134
22210	1	134	0	2	0	137
22211	0	132	0	1	0	133
22212	0	135	0	1	0	136
22213	1	0	0	130	0	131
22214	1	132	0	0	0	133
22215	130	0	1	0	0	131
22216	0	0	127	1	0	128
22217	0	0	125	0	0	125
22218	0	1	125	0	0	126
22219	2	0	1	125	0	128
22220	0	0	0	126	0	126
22221	0	0	1	120	0	121
22222	2	0	0	120	0	122
22223	1	0	0	107	0	108
22224	0	128	0	0	0	128
22225	0	0	125	1	0	126
22226	1	1	123	0	0	125
22227	1	127	0	0	0	128
22228	2	1	0	126	0	129
22229	1	0	0	127	0	128
22230	2	1	0	123	0	126
22231	128	0	0	1	0	129
22232	1	0	129	0	0	130
22233	123	0	1	2	0	126
22234	127	0	1	1	0	129
22235	0	125	0	2	0	127
22236	1	128	0	1	0	130
22237	130	0	0	1	0	131
22238	1	0	0	133	0	134
22239	0	1	1	134	0	136
22240	0	1	138	2	0	141
22241	1	0	132	5	0	138
22242	1	1	1	138	0	141
22243	144	0	2	1	0	147
22244	1	2	152	1	0	156
22245	154	0	3	1	0	158
22246	3	2	1	156	0	162
22247	2	1	0	161	0	164
22248	0	1	0	164	0	165
22249	1	0	161	5	0	167
22250	0	156	2	4	0	162
22251	0	166	4	1	0	171
22252	163	5	0	2	0	170
22253	169	2	0	1	0	172
22254	6	0	0	169	0	175
22255	171	0	0	6	0	177
22256	3	0	160	4	0	167
22257	5	0	165	0	0	170
22258	1	0	7	167	0	175
22259	174	0	3	7	0	184
22260	3	0	0	179	0	182
22261	4	1	1	185	0	191
22262	178	1	2	6	0	187
22263	180	1	0	7	0	188
22264	7	187	2	0	0	196
22265	191	3	0	1	0	195
22266	3	3	0	181	0	187
22267	3	180	0	4	0	187
22268	175	4	2	4	0	185
22269	5	180	1	0	0	186
22270	3	4	0	183	0	190
22271	181	3	0	5	0	189
22272	4	0	178	4	0	186
22273	3	0	180	1	0	184
22274	1	0	7	179	0	187
22275	1	0	2	184	0	187
22276	0	1	0	173	0	174
22277	1	179	0	5	0	185
22278	184	6	0	4	0	194
22279	183	4	0	0	0	187
22280	188	0	0	2	0	190
22281	8	192	0	0	0	200
22282	2	5	0	205	0	212
22283	1	3	0	203	0	207
22284	0	0	1	206	0	207
22285	196	0	1	9	0	206
22286	5	196	0	3	0	204
22287	3	6	0	201	0	210
22288	2	3	0	207	0	212
22289	0	2	195	8	0	205
22290	1	188	5	4	0	198
22291	2	6	2	188	0	198
22292	1	2	0	197	0	200
22293	1	1	0	202	0	204
22294	186	0	0	12	0	198
22295	6	187	1	3	0	197
22296	189	6	0	1	0	196
22297	7	3	0	188	0	198
22298	194	1	0	6	0	201
22299	6	0	187	4	0	197
22300	186	0	6	1	0	193
22301	189	1	4	1	0	195
22302	9	1	188	0	0	198
22303	4	1	6	188	0	199
22304	0	0	4	192	0	196
22305	188	0	0	12	0	200
22306	8	0	0	193	0	201
22307	3	1	0	200	0	204
22308	1	0	0	200	0	201
22309	1	0	186	10	0	197
22310	181	2	6	3	0	192
22311	5	197	6	0	0	208
22312	6	6	0	191	0	203
22313	1	192	0	6	0	199
22314	0	202	2	5	0	209
22315	2	8	0	202	0	212
22316	0	3	198	8	0	209
22317	2	0	204	3	0	209
22318	2	1	9	196	0	208
22319	1	0	195	8	0	204
22320	192	0	7	7	0	206
22321	6	0	4	206	0	216
22322	6	1	0	207	0	214
22323	1	208	0	9	0	218
22324	0	7	0	207	0	214
22325	4	4	0	213	0	221
22326	2	199	0	10	0	211
22327	1	8	0	214	0	223
22328	2	5	1	210	0	218
22329	0	204	1	11	0	216
22330	209	6	0	9	0	224
22331	7	4	211	1	0	223
22332	6	0	209	0	0	215
22333	2	1	9	199	0	211
22334	0	0	4	213	0	217
22335	0	2	204	13	0	219
22336	0	1	203	7	0	211
22337	182	1	10	4	0	197
22338	7	199	2	3	0	211
22339	194	4	0	4	0	202
22340	6	3	185	4	0	198
22341	5	192	6	0	0	203
22342	3	6	4	193	0	206
22343	1	4	190	7	0	202
22344	0	0	179	6	0	185
22345	3	4	8	183	0	198
22346	0	3	180	4	0	187
22347	0	169	4	3	0	176
22348	1	4	2	174	0	181
22349	0	2	173	4	0	179
22350	1	171	5	3	0	180
22351	170	5	1	4	0	180
22352	7	2	167	1	0	177
22353	1	168	4	5	0	178
22354	2	7	0	167	0	176
22355	2	3	1	171	0	177
22356	170	0	2	7	0	179
22357	6	1	1	170	0	178
22358	1	1	1	166	0	169
22359	157	0	0	9	0	166
22360	4	0	1	162	0	167
22361	3	1	151	4	0	159
22362	2	1	3	153	0	159
22363	1	0	153	6	0	160
22364	0	1	139	3	0	143
22365	0	0	155	2	0	157
22366	2	1	3	144	0	150
22367	0	2	2	146	0	150
22368	141	0	2	6	0	149
22369	4	1	1	138	0	144
22370	1	159	1	3	0	164
22371	2	3	0	163	0	168
22372	2	1	3	161	0	167
22373	0	159	2	5	0	166
22374	158	4	0	4	0	166
22375	156	1	2	4	0	163
22376	4	151	2	2	0	159
22377	2	158	1	2	0	163
22378	3	4	0	155	0	162
22379	159	4	0	2	0	165
22380	2	1	155	3	0	161
22381	2	1	137	2	0	142
22382	119	1	2	1	0	123
22383	1	127	1	1	0	130
22384	1	0	3	129	0	133
22385	1	1	3	130	0	135
22386	1	0	1	136	0	138
22387	0	1	1	137	0	139
22388	0	133	0	4	0	137
22389	1	0	0	140	0	141
22390	134	2	0	4	0	140
22391	0	1	1	137	0	139
22392	3	0	0	137	0	140
22393	141	0	0	4	0	145
22394	140	2	0	2	0	144
22395	137	0	1	1	0	139
22396	141	0	0	3	0	144
22397	5	0	0	140	0	145
22398	143	1	0	0	0	144
22399	1	0	0	145	0	146
22400	146	0	0	1	0	147
22401	141	0	1	5	0	147
22402	3	0	1	145	0	149
22403	3	0	147	2	0	152
22404	146	1	1	2	0	150
22405	151	0	3	0	0	154
22406	144	0	1	6	0	151
22407	147	0	2	3	0	152
22408	3	1	0	149	0	153
22409	4	1	152	1	0	158
22410	3	0	150	3	0	156
22411	158	1	2	1	0	162
22412	155	0	3	4	0	162
22413	2	155	3	2	0	162
22414	4	155	2	0	0	161
22415	164	3	0	3	0	170
22416	2	2	0	165	0	169
22417	4	1	0	174	0	179
22418	171	2	0	5	0	178
22419	3	175	0	3	0	181
22420	184	0	1	1	0	186
22421	1	3	177	2	0	183
22422	180	0	1	3	0	184
22423	0	1	3	182	0	186
22424	3	0	188	0	0	191
22425	1	186	2	2	0	191
22426	2	1	3	193	0	199
22427	2	0	193	2	0	197
22428	1	0	2	191	0	194
22429	198	0	1	2	0	201
22430	1	0	189	4	0	194
22431	189	1	4	0	0	194
22432	2	185	2	2	0	191
22433	3	1	1	195	0	200
22434	0	3	211	1	0	215
22435	2	1	1	210	0	214
22436	2	1	213	1	0	217
22437	0	206	1	4	0	211
22438	211	3	2	0	0	216
22439	1	223	0	3	0	227
22440	3	2	1	225	0	231
22441	0	3	1	225	0	229
22442	2	0	218	2	0	222
22443	188	1	1	1	0	191
22444	1	211	1	1	0	214
22445	1	208	0	1	0	210
22446	0	206	0	0	0	206
22447	1	2	0	204	0	207
22448	0	202	2	1	0	205
22449	0	1	0	203	0	204
22450	0	198	1	1	0	200
22451	1	2	0	197	0	200
22452	0	210	1	2	0	213
22453	206	1	1	5	0	213
22454	1	1	205	1	0	208
22455	196	0	1	3	0	200
22456	209	0	1	0	0	210
22457	215	0	0	4	0	219
22458	2	213	0	0	0	215
22459	213	1	0	3	0	217
22460	211	1	1	2	0	215
22461	215	0	0	4	0	219
22462	2	0	215	0	0	217
22463	1	1	1	210	0	213
22464	1	0	220	1	0	222
22465	0	1	1	208	0	210
22466	209	0	1	3	0	213
22467	1	215	0	2	0	218
22468	1	1	236	0	0	238
22469	3	1	1	226	0	231
22470	1	1	1	227	0	230
22471	0	1	240	2	0	243
22472	228	1	1	1	0	231
22473	236	0	1	0	0	237
22474	244	1	0	1	0	246
22475	3	0	0	233	0	236
22476	1	231	0	1	0	233
22477	0	242	1	1	0	244
22478	2	4	0	236	0	242
22479	3	0	0	229	0	232
22480	0	231	1	2	0	234
22481	227	1	0	1	0	229
22482	0	228	0	0	0	228
22483	4	1	0	221	0	226
22484	0	1	225	1	0	227
22485	2	0	1	215	0	218
22486	224	0	0	4	0	228
22487	2	0	220	0	0	222
22488	216	0	2	0	0	218
22489	222	0	0	2	0	224
22490	225	0	1	0	0	226
22491	226	0	0	1	0	227
22492	228	0	0	3	0	231
22493	1	1	222	0	0	224
22494	0	0	214	0	0	214
22495	226	0	1	3	0	230
22496	229	0	0	3	0	232
22497	3	0	1	236	0	240
22498	1	240	0	2	0	243
22499	1	3	0	248	0	252
22500	251	1	0	6	0	258
22501	3	1	1	237	0	242
22502	2	255	0	4	0	261
22503	255	4	0	3	0	262
22504	246	2	2	5	0	255
22505	245	1	0	3	0	249
22506	6	251	1	1	0	259
22507	4	3	0	247	0	254
22508	3	3	0	244	0	250
22509	2	234	0	5	0	241
22510	2	4	2	246	0	254
22511	243	4	0	7	0	254
22512	241	1	0	5	0	247
22513	6	235	3	1	0	245
22514	7	3	0	244	0	254
22515	3	5	0	243	0	251
22516	2	2	0	244	0	248
22517	224	0	2	9	0	235
22518	5	2	226	4	0	237
22519	214	1	5	4	0	224
22520	5	0	228	1	0	234
22521	7	0	4	209	0	220
22522	3	213	2	3	0	221
22523	2	219	1	4	0	226
22524	213	7	0	3	0	223
22525	208	3	0	4	0	215
22526	4	203	3	0	0	210
22527	4	210	2	1	0	217
22528	213	5	0	2	0	220
22529	214	3	2	3	0	222
22530	5	218	1	2	0	226
22531	218	4	0	1	0	223
22532	5	3	211	1	0	220
22533	222	1	3	1	0	227
22534	217	0	2	0	0	219
22535	5	2	2	207	0	216
22536	5	211	0	2	0	218
22537	8	1	0	212	0	221
22538	216	2	0	4	0	222
22539	5	1	1	204	0	211
22540	6	0	1	205	0	212
22541	2	0	207	6	0	215
22542	3	1	2	205	0	211
22543	3	0	2	211	0	216
22544	211	2	1	7	0	221
22545	4	0	209	3	0	216
22546	208	1	2	3	0	214
22547	5	0	2	213	0	220
22548	3	2	1	215	0	221
22549	2	0	0	213	0	215
22550	3	211	1	5	0	220
22551	0	214	2	3	0	219
22552	1	5	0	207	0	213
22553	207	2	0	3	0	212
22554	203	0	1	3	0	207
22555	6	3	0	202	0	211
22556	201	1	0	4	0	206
22557	6	0	0	203	0	209
22558	4	0	0	204	0	208
22559	196	3	0	5	0	204
22560	2	209	1	4	0	216
22561	207	2	0	4	0	213
22562	206	2	0	1	0	209
22563	197	2	0	1	0	200
22564	7	189	1	1	0	198
22565	7	3	1	189	0	200
22566	2	2	1	191	0	196
22567	2	1	187	7	0	197
22568	3	2	4	166	0	175
22569	1	2	161	4	0	168
22570	3	155	5	3	0	166
22571	1	126	3	2	0	132
22572	1	140	1	0	0	142
22573	3	7	2	134	0	146
22574	1	2	1	135	0	139
22575	0	1	0	140	0	141
22576	1	0	1	141	0	143
22577	0	0	135	7	0	142
22578	0	0	150	4	0	154
22579	0	1	6	154	0	161
22580	0	1	154	4	0	159
22581	149	1	7	2	0	159
22582	160	0	0	2	0	162
22583	7	1	156	2	0	166
22584	3	0	5	153	0	161
22585	1	0	2	167	0	170
22586	3	1	2	161	0	167
22587	4	1	1	159	0	165
22588	0	0	0	164	0	164
22589	127	1	1	9	0	138
22590	150	0	0	4	0	154
22591	7	149	0	3	0	159
22592	4	5	145	0	0	154
22593	1	141	5	3	0	150
22594	0	147	2	2	0	151
22595	128	5	1	2	0	136
22596	4	130	0	1	0	135
22597	0	118	0	0	0	118
22598	117	3	0	0	0	120
22599	4	0	113	0	0	117
22600	107	1	2	2	0	112
22601	2	0	0	114	0	116
22602	0	0	0	109	0	109
22603	1	0	1	107	0	109
22604	0	0	106	4	0	110
22605	0	104	4	0	0	108
22606	106	4	0	1	0	111
22607	3	1	0	108	0	112
22608	0	104	1	3	0	108
22609	1	3	0	109	0	113
22610	0	0	109	5	0	114
22611	1	0	3	107	0	111
22612	0	0	0	115	0	115
22613	1	0	1	109	0	111
22614	106	0	1	3	0	110
22615	4	0	0	109	0	113
22616	0	0	110	4	0	114
22617	1	108	4	0	0	113
22618	1	4	0	106	0	111
22619	1	0	1	115	0	117
22620	0	0	108	5	0	113
22621	0	0	109	1	0	110
22622	105	0	5	3	0	113
22623	108	0	2	3	0	113
22624	5	103	3	1	0	112
22625	105	4	0	1	0	110
22626	6	0	103	1	0	110
22627	0	1	110	1	0	112
22628	98	0	5	3	0	106
22629	106	0	0	2	0	108
22630	5	0	97	2	0	104
22631	88	1	4	2	0	95
22632	5	0	97	1	0	103
22633	95	0	5	1	0	101
22634	104	1	1	0	0	106
22635	5	2	1	94	0	102
22636	1	109	0	3	0	113
22637	94	6	2	3	0	105
22638	5	2	108	0	0	115
22639	2	109	5	0	0	116
22640	105	6	0	0	0	111
22641	109	1	1	0	0	111
22642	5	105	1	2	0	113
22643	3	5	1	104	0	113
22644	1	0	102	6	0	109
22645	0	0	5	108	0	113
22646	0	1	104	7	0	112
22647	1	1	4	106	0	112
22648	4	1	1	107	0	113
22649	1	2	104	4	0	111
22650	1	103	5	1	0	110
22651	1	5	1	102	0	109
22652	0	2	91	6	0	99
22653	98	0	6	1	0	105
22654	3	1	1	107	0	112
22655	1	1	0	110	0	112
22656	107	0	1	6	0	114
22657	4	1	1	105	0	111
22658	3	0	1	105	0	109
22659	0	106	1	6	0	113
22660	2	3	1	102	0	108
22661	0	1	97	8	0	106
22662	0	0	6	98	0	104
22663	1	101	1	4	0	107
22664	2	104	2	0	0	108
22665	1	3	1	103	0	108
22666	101	1	0	3	0	105
22667	4	1	0	103	0	108
22668	101	1	2	3	0	107
22669	4	0	2	102	0	108
22670	100	1	2	3	0	106
22671	105	1	1	3	0	110
22672	5	0	1	100	0	106
22673	4	3	1	99	0	107
22674	1	98	3	4	0	106
22675	3	103	1	0	0	107
22676	1	3	98	2	0	104
22677	3	93	4	2	0	102
22678	74	2	2	1	0	79
22679	2	0	0	74	0	76
22680	0	73	1	2	0	76
22681	75	3	0	0	0	78
22682	2	1	0	74	0	77
22683	1	0	0	75	0	76
22684	0	2	0	74	0	76
22685	1	0	0	75	0	76
22686	0	73	1	2	0	76
22687	0	80	0	1	0	81
22688	77	1	1	0	0	79
22689	1	78	0	2	0	81
22690	1	1	0	80	0	82
22691	0	0	1	79	0	80
22692	0	1	0	80	0	81
22693	0	1	0	81	0	82
22694	74	0	0	2	0	76
22695	81	0	0	0	0	81
22696	1	1	73	1	0	76
22697	1	0	1	75	0	77
22698	1	0	76	2	0	79
22699	0	0	1	79	0	80
22700	0	0	1	79	0	80
22701	74	1	0	2	0	77
22702	2	0	0	76	0	78
22703	1	0	79	1	0	81
22704	0	0	68	2	0	70
22705	74	0	3	1	0	78
22706	1	1	77	1	0	80
22707	1	0	1	71	0	73
22708	1	0	78	1	0	80
22709	0	1	1	80	0	82
22710	1	80	2	1	0	84
22711	0	1	0	83	0	84
22712	2	79	0	1	0	82
22713	1	80	0	1	0	82
22714	0	1	0	82	0	83
22715	81	1	1	0	0	83
22716	0	83	0	1	0	84
22717	1	0	0	85	0	86
22718	87	1	0	0	0	88
22719	88	0	0	0	0	88
22720	88	0	0	1	0	89
22721	1	0	0	86	0	87
22722	1	0	0	86	0	87
22723	87	0	0	1	0	88
22724	83	0	0	1	0	84
22725	91	0	0	0	0	91
22726	1	0	0	90	0	91
22727	1	0	86	0	0	87
22728	86	0	0	2	0	88
22729	0	0	1	91	0	92
22730	1	93	1	0	0	95
22731	0	0	0	92	0	92
22732	0	94	0	0	0	94
22733	0	0	0	92	0	92
22734	0	1	88	0	0	89
22735	0	90	0	1	0	91
22736	0	0	1	80	0	81
22737	0	1	0	79	0	80
22738	0	0	0	80	0	80
22739	82	0	0	2	0	84
22740	0	84	0	1	0	85
22741	0	0	0	87	0	87
22742	90	1	0	0	0	91
22743	85	0	0	1	0	86
22744	2	0	1	86	0	89
22745	1	0	93	0	0	94
22746	0	0	0	87	0	87
22747	0	88	1	0	0	89
22748	0	0	0	94	0	94
22749	91	1	0	0	0	92
22750	0	0	0	103	0	103
22751	1	0	106	1	0	108
22752	0	109	1	1	0	111
22753	111	0	1	0	0	112
22754	0	2	111	0	0	113
22755	113	0	0	0	0	113
22756	0	0	1	118	0	119
22757	1	0	0	112	0	113
22758	0	115	0	1	0	116
22759	121	0	0	2	0	123
22760	2	1	0	123	0	126
22761	1	0	0	129	0	130
22762	0	0	0	133	0	133
22763	0	0	136	2	0	138
22764	0	0	1	134	0	135
22765	136	0	1	1	0	138
22766	139	0	0	2	0	141
22767	3	0	0	141	0	144
22768	2	1	0	145	0	148
22769	142	0	0	3	0	145
22770	2	0	147	1	0	150
22771	143	0	1	0	0	144
22772	1	0	140	1	0	142
22773	1	0	140	0	0	141
22774	0	0	2	141	0	143
22775	0	1	146	1	0	148
22776	147	0	1	2	0	150
22777	3	0	1	153	0	157
22778	1	0	154	2	0	157
22779	148	0	2	1	0	151
22780	159	1	1	0	0	161
22781	3	0	177	0	0	180
22782	1	0	2	167	0	170
22783	1	182	1	1	0	185
22784	189	1	0	2	0	192
22785	1	0	197	1	0	199
22786	183	1	1	1	0	186
22787	2	192	1	0	0	195
22788	193	1	2	2	0	198
22789	196	1	0	2	0	199
22790	203	0	0	2	0	205
22791	2	0	1	211	0	214
22792	1	211	0	3	0	215
22793	1	2	206	1	0	210
22794	1	213	1	0	0	215
22795	0	1	1	204	0	206
22796	0	213	0	1	0	214
22797	1	214	0	0	0	215
22798	211	1	1	1	0	214
22799	3	1	208	0	0	212
22800	0	0	226	0	0	226
22801	0	0	230	0	0	230
22802	0	238	1	1	0	240
22803	239	2	1	1	0	243
22804	237	0	0	1	0	238
22805	242	0	0	1	0	243
22806	1	240	1	0	0	242
22807	1	1	0	248	0	250
22808	1	0	247	1	0	249
22809	0	0	246	0	0	246
22810	248	0	1	2	0	251
22811	260	1	0	0	0	261
22812	262	0	0	1	0	263
22813	1	0	254	0	0	255
22814	259	0	1	0	0	260
22815	2	1	0	259	0	262
22816	2	0	0	260	0	262
22817	0	0	287	1	0	288
22818	0	284	1	1	0	286
22819	1	1	0	289	0	291
22820	0	1	289	1	0	291
22821	265	0	2	0	0	267
22822	1	1	0	284	0	286
22823	1	1	0	284	0	286
22824	285	1	0	1	0	287
22825	1	2	0	282	0	285
22826	281	0	0	1	0	282
22827	277	0	1	0	0	278
22828	2	0	1	273	0	276
22829	0	0	1	277	0	278
22830	278	1	0	1	0	280
22831	4	0	0	278	0	282
22832	284	0	0	1	0	285
22833	288	0	0	0	0	288
22834	284	1	0	0	0	285
22835	2	0	0	280	0	282
22836	2	0	1	277	0	280
22837	278	0	1	2	0	281
22838	1	273	1	0	0	275
22839	0	263	1	0	0	264
22840	268	1	0	0	0	269
22841	1	0	264	0	0	265
22842	257	0	1	1	0	259
22843	1	0	0	272	0	273
22844	0	0	271	1	0	272
22845	264	0	1	1	0	266
22846	1	0	0	274	0	275
22847	1	0	0	270	0	271
22848	0	0	0	269	0	269
22849	1	0	0	270	0	271
22850	265	0	0	1	0	266
22851	1	257	1	0	0	259
22852	243	1	0	3	0	247
22853	1	0	250	0	0	251
22854	0	0	232	0	0	232
22855	0	250	1	0	0	251
22856	2	1	0	247	0	250
22857	0	0	252	1	0	253
22858	0	227	1	0	0	228
22859	0	1	239	0	0	240
22860	0	0	0	236	0	236
22861	0	0	0	240	0	240
22862	236	0	0	0	0	236
22863	0	0	0	229	0	229
22864	227	0	0	0	0	227
22865	0	0	228	0	0	228
22866	0	232	0	0	0	232
22867	0	0	0	244	0	244
22868	0	0	0	257	0	257
22869	0	0	263	0	0	263
22870	1	0	239	0	0	240
22871	244	0	0	0	0	244
22872	258	0	0	2	0	260
22873	1	0	0	260	0	261
22874	0	0	0	252	0	252
22875	0	248	0	0	0	248
22876	0	0	0	258	0	258
22877	260	0	0	2	0	262
22878	261	0	0	0	0	261
22879	0	257	0	1	0	258
22880	259	0	0	0	0	259
22881	254	1	0	0	0	255
22882	2	0	0	275	0	277
22883	1	279	0	0	0	280
22884	1	1	0	286	0	288
22885	0	1	0	283	0	284
22886	0	0	282	4	0	286
22887	266	1	2	2	0	271
22888	2	1	1	285	0	289
22889	1	0	0	302	0	303
22890	0	336	2	8	0	346
22891	1	9	0	354	0	364
22892	358	1	0	11	0	370
22893	372	0	0	5	0	377
22894	12	2	354	0	0	368
22895	3	1	357	2	0	363
22896	5	1	12	363	0	381
22897	4	0	1	389	0	394
22898	1	2	377	12	0	392
22899	1	0	385	3	0	389
22900	1	0	14	350	0	365
22901	1	0	374	13	0	388
22902	2	0	377	2	0	381
22903	2	1	15	361	0	379
22904	371	0	2	16	0	389
22905	381	2	2	4	0	389
22906	16	0	3	376	0	395
22907	4	0	3	382	0	389
22908	377	1	2	14	0	394
22909	13	1	2	374	0	390
22910	368	0	2	15	0	385
22911	364	0	1	7	0	372
22912	16	0	2	357	0	375
22913	6	1	2	367	0	376
22914	364	0	2	18	0	384
22915	11	355	0	6	0	372
22916	3	353	2	4	0	362
22917	7	10	1	347	0	365
22918	6	2	339	14	0	361
22919	4	2	12	340	0	358
22920	345	3	4	14	0	366
22921	14	1	1	343	0	359
22922	351	1	2	13	0	367
22923	14	1	342	5	0	362
22924	349	1	14	2	0	366
22925	17	1	3	359	0	380
22926	8	3	2	373	0	386
22927	2	1	387	18	0	408
22928	9	1	13	384	0	407
22929	7	1	4	399	0	411
22930	7	1	2	413	0	423
22931	401	1	6	19	0	427
22932	14	0	393	13	0	420
22933	5	3	387	7	0	402
22934	374	2	13	9	0	398
22935	397	1	3	7	0	408
22936	17	2	390	6	0	415
22937	7	1	15	378	0	401
22938	5	387	6	18	0	416
22939	8	12	3	401	0	424
22940	400	2	7	16	0	425
22941	409	2	6	8	0	425
22942	16	4	4	398	0	422
22943	4	401	5	26	0	436
22944	8	11	5	402	0	426
22945	8	410	9	13	0	440
22946	408	11	3	14	0	436
22947	411	3	6	10	0	430
22948	410	0	4	11	0	425
22949	19	383	3	8	0	413
22950	9	408	5	5	0	427
22951	10	16	4	403	0	433
22952	7	2	2	423	0	434
22953	7	4	7	410	0	428
22954	13	2	5	410	0	430
22955	6	0	396	25	0	427
22956	373	4	12	11	0	400
22957	19	3	396	8	0	426
22958	388	6	13	12	0	419
22959	20	3	399	7	0	429
22960	408	1	12	9	0	430
22961	18	3	408	6	0	435
22962	395	2	16	8	0	421
22963	17	3	9	408	0	437
22964	416	3	5	22	0	446
22965	18	2	6	420	0	446
22966	17	1	5	421	0	444
22967	8	3	6	411	0	428
22968	6	384	6	21	0	417
22969	380	12	5	16	0	413
22970	384	3	6	7	0	400
22971	21	384	1	9	0	415
22972	10	12	2	394	0	418
22973	10	2	383	18	0	413
22974	375	1	14	14	0	404
22975	397	4	4	8	0	413
22976	388	3	5	11	0	407
22977	20	1	2	372	0	395
22978	7	367	4	19	0	397
22979	7	12	6	374	0	399
22980	374	1	4	23	0	402
22981	18	3	2	346	0	369
22982	8	342	4	11	0	365
22983	336	10	2	9	0	357
22984	15	6	337	2	0	360
22985	4	2	330	8	0	344
22986	5	326	11	5	0	347
22987	7	334	3	6	0	350
22988	4	9	309	7	0	329
22989	7	4	286	4	0	301
22990	8	11	3	213	0	235
22991	223	0	2	4	0	229
22992	1	0	223	1	0	225
22993	1	211	0	0	0	212
22994	207	1	0	2	0	210
22995	0	201	1	1	0	203
22996	196	0	2	1	0	199
22997	0	196	0	2	0	198
22998	1	194	0	1	0	196
22999	0	1	1	192	0	194
23000	2	2	0	191	0	195
23001	1	0	187	1	0	189
23002	1	1	1	182	0	185
23003	178	0	1	1	0	180
23004	176	1	0	3	0	180
23005	2	1	1	172	0	176
23006	1	0	171	2	0	174
23007	1	2	164	2	0	169
23008	0	0	2	170	0	172
23009	1	0	172	1	0	174
23010	3	0	0	171	0	174
23011	2	0	1	163	0	166
23012	0	1	188	2	0	191
23013	172	0	1	2	0	175
23014	181	0	2	1	0	184
23015	1	0	183	1	0	185
23016	1	0	181	0	0	182
23017	1	0	2	181	0	184
23018	1	0	1	201	0	203
23019	0	0	1	204	0	205
23020	2	0	0	201	0	203
23021	203	0	0	4	0	207
23022	212	0	1	2	0	215
23023	5	0	1	221	0	227
23024	1	0	0	237	0	238
23025	0	1	253	5	0	259
23026	1	0	4	252	0	257
23027	0	0	2	268	0	270
23028	266	0	2	7	0	275
23029	7	279	0	4	0	290
23030	5	7	0	270	0	282
23031	3	2	0	283	0	288
23032	1	2	1	273	0	277
23033	1	253	0	11	0	265
23034	0	274	0	5	0	279
23035	2	7	0	271	0	280
23036	0	5	0	273	0	278
23037	3	1	0	273	0	277
23038	255	0	1	12	0	268
23039	7	263	0	6	0	276
23040	261	8	1	5	0	275
23041	269	3	0	3	0	275
23042	8	2	0	257	0	267
23043	6	255	0	8	0	269
23044	255	9	0	5	0	269
23045	8	2	0	258	0	268
23046	260	4	0	9	0	273
23047	9	1	0	272	0	282
23048	3	3	257	10	0	273
23049	3	1	267	4	0	275
23050	0	2	9	272	0	283
23051	3	0	3	277	0	283
23052	0	1	2	267	0	270
23053	3	262	1	8	0	274
23054	1	286	1	5	0	293
23055	272	8	1	5	0	286
23056	276	6	1	1	0	284
23057	9	268	0	2	0	279
23058	4	269	1	3	0	277
23059	3	280	0	1	0	284
23060	262	9	1	3	0	275
23061	5	265	1	1	0	272
23062	6	9	1	265	0	281
23063	265	3	1	10	0	279
23064	272	3	3	3	0	281
23065	12	0	0	264	0	276
23066	4	3	257	9	0	273
23067	3	1	261	7	0	272
23068	4	1	8	270	0	283
23069	2	2	271	10	0	285
23070	3	2	9	267	0	281
23071	5	1	3	272	0	281
23072	2	2	270	11	0	285
23073	3	2	274	6	0	285
23074	5	2	12	252	0	271
23075	2	0	6	273	0	281
23076	256	1	4	11	0	272
23077	11	265	0	7	0	283
23078	4	274	2	6	0	286
23079	265	9	2	7	0	283
23080	276	4	1	6	0	287
23081	12	266	0	4	0	282
23082	7	278	2	3	0	290
23083	272	11	0	4	0	287
23084	12	5	1	268	0	286
23085	259	3	1	13	0	276
23086	11	264	1	7	0	283
23087	270	8	1	6	0	285
23088	11	6	259	5	0	281
23089	265	3	8	6	0	282
23090	14	0	259	5	0	278
23091	6	3	9	265	0	283
23092	264	3	3	13	0	283
23093	11	5	255	5	0	276
23094	5	4	7	257	0	273
23095	255	2	3	15	0	275
23096	8	1	254	11	0	274
23097	8	1	8	259	0	276
23098	260	4	4	8	0	276
23099	8	265	1	8	0	282
23100	8	5	0	264	0	277
23101	4	4	2	270	0	280
23102	2	4	0	269	0	275
23103	5	258	2	9	0	274
23104	5	8	0	274	0	287
23105	9	3	1	268	0	281
23106	6	3	1	273	0	283
23107	4	2	0	270	0	276
23108	2	4	261	13	0	280
23109	254	0	7	10	0	271
23110	266	1	3	7	0	277
23111	13	261	3	5	0	282
23112	6	9	0	245	0	260
23113	4	3	2	247	0	256
23114	1	241	2	14	0	258
23115	5	8	0	243	0	256
23116	232	5	0	13	0	250
23117	4	234	0	6	0	244
23118	213	10	1	6	0	230
23119	9	5	0	213	0	227
23120	3	2	213	9	0	227
23121	5	212	6	4	0	227
23122	194	8	4	7	0	213
23123	6	187	3	0	0	196
23124	4	190	0	1	0	195
23125	158	3	2	0	0	163
23126	3	1	157	0	0	161
23127	2	130	2	0	0	134
23128	111	1	5	4	0	121
23129	107	1	1	0	0	109
23130	2	105	0	0	0	107
23131	2	1	0	103	0	106
23132	0	1	113	1	0	115
23133	0	0	1	103	0	104
23134	0	0	0	104	0	104
23135	0	0	0	116	0	116
23136	0	0	116	2	0	118
23137	1	0	1	108	0	110
23138	0	0	113	1	0	114
23139	0	0	101	2	0	103
23140	95	0	1	1	0	97
23141	1	107	1	0	0	109
23142	1	109	0	1	0	111
23143	2	3	0	111	0	116
23144	130	1	0	2	0	133
23145	133	0	1	3	0	137
23146	126	0	0	1	0	127
23147	128	1	0	0	0	129
23148	121	0	0	3	0	124
23149	1	0	125	1	0	127
23150	1	0	2	123	0	126
23151	0	116	2	1	0	119
23152	1	2	1	124	0	128
23153	125	1	0	2	0	128
23154	2	128	0	1	0	131
23155	1	3	0	132	0	136
23156	130	1	1	4	0	136
23157	132	0	0	0	0	132
23158	5	0	0	127	0	132
23159	2	0	0	131	0	133
23160	1	0	0	133	0	134
23161	1	0	129	4	0	134
23162	1	1	128	0	0	130
23163	0	0	2	136	0	138
23164	1	1	0	139	0	141
23165	137	1	0	4	0	142
23166	133	1	0	2	0	136
23167	139	1	0	2	0	142
23168	141	0	1	2	0	144
23169	142	0	1	0	0	143
23170	4	141	0	1	0	146
23171	146	2	1	2	0	151
23172	148	1	0	0	0	149
23173	148	0	0	1	0	149
23174	2	1	1	142	0	146
23175	0	1	146	4	0	151
23176	4	0	3	144	0	151
23177	1	1	155	4	0	161
23178	2	1	3	155	0	161
23179	4	157	1	3	0	165
23180	160	4	0	3	0	167
23181	171	1	0	2	0	174
23182	4	0	0	175	0	179
23183	1	0	0	182	0	183
23184	0	1	0	184	0	185
23185	1	182	0	5	0	188
23186	185	4	1	2	0	192
23187	187	2	0	1	0	190
23188	6	181	0	0	0	187
23189	1	4	1	184	0	190
23190	1	3	0	180	0	184
23191	2	184	0	4	0	190
23192	180	3	0	1	0	184
23193	179	2	0	0	0	181
23194	4	0	0	178	0	182
23195	1	0	176	3	0	180
23196	0	1	170	2	0	173
23197	0	0	3	172	0	175
23198	2	0	1	173	0	176
23199	1	0	1	177	0	179
23200	173	0	0	6	0	179
23201	177	0	0	0	0	177
23202	4	184	0	0	0	188
23203	190	3	0	2	0	195
23204	3	2	192	0	0	197
23205	1	0	194	0	0	195
23206	1	195	5	0	0	201
23207	196	3	1	4	0	204
23208	2	201	0	0	0	203
23209	195	2	0	3	0	200
23210	2	1	198	1	0	202
23211	1	1	197	0	0	199
23212	2	1	3	188	0	194
23213	1	0	218	2	0	221
23214	0	1	2	219	0	222
23215	2	0	1	194	0	197
23216	0	216	1	2	0	219
23217	0	2	1	220	0	223
23218	1	1	0	218	0	220
23219	221	0	2	5	0	228
23220	1	230	2	3	0	236
23221	1	3	0	232	0	236
23222	1	2	233	2	0	238
23223	210	0	2	4	0	216
23224	3	0	227	1	0	231
23225	4	0	3	225	0	232
23226	0	242	3	2	0	247
23227	0	3	0	243	0	246
23228	242	2	2	3	0	249
23229	244	0	0	5	0	249
23230	6	248	2	1	0	257
23231	261	5	0	5	0	271
23232	266	2	0	2	0	270
23233	282	0	0	2	0	284
23234	276	0	0	2	0	278
23235	267	1	0	2	0	270
23236	6	0	262	1	0	269
23237	5	0	5	258	0	268
23238	3	0	2	262	0	267
23239	2	0	1	269	0	272
23240	1	274	0	7	0	282
23241	1	4	0	268	0	273
23242	0	1	275	6	0	282
23243	1	268	4	3	0	276
23244	1	263	4	0	0	268
23245	0	6	0	264	0	270
23246	4	3	0	259	0	266
23247	1	0	1	262	0	264
23248	3	249	1	5	0	258
23249	1	259	1	2	0	263
23250	251	6	0	3	0	260
23251	249	3	1	2	0	255
23252	5	249	1	3	0	258
23253	258	2	1	4	0	265
23254	261	4	0	5	0	270
23255	5	2	0	267	0	274
23256	5	1	0	273	0	279
23257	2	0	1	273	0	276
23258	1	1	274	5	0	281
23259	3	1	272	2	0	278
23260	2	279	5	2	0	288
23261	287	3	4	4	0	298
23262	5	2	290	3	0	300
23263	280	1	4	3	0	288
23264	5	3	304	1	0	313
23265	292	1	5	2	0	300
23266	5	311	2	2	0	320
23267	314	5	2	1	0	322
23268	7	4	1	311	0	323
23269	6	1	0	319	0	326
23270	2	0	315	7	0	324
23271	2	333	4	6	0	345
23272	1	6	3	334	0	344
23273	1	3	330	5	0	339
23274	305	3	6	4	0	318
23275	5	330	1	3	0	339
23276	318	4	2	3	0	327
23277	5	313	1	0	0	319
23278	4	6	0	306	0	316
23279	304	1	1	5	0	311
23280	6	305	0	2	0	313
23281	3	6	2	306	0	317
23282	5	1	300	4	0	310
23283	275	2	5	6	0	288
23284	6	0	2	299	0	307
23285	2	2	295	6	0	305
23286	4	298	5	2	0	309
23287	2	5	2	301	0	310
23288	1	3	300	6	0	310
23289	2	0	7	271	0	280
23290	2	299	2	7	0	310
23291	1	304	2	2	0	309
23292	1	9	299	1	0	310
23293	1	2	5	293	0	301
23294	0	3	298	9	0	310
23295	282	1	7	5	0	295
23296	6	4	2	299	0	311
23297	1	291	2	6	0	300
23298	4	306	1	1	0	312
23299	300	7	0	6	0	313
23300	4	308	4	1	0	317
23301	301	7	1	3	0	312
23302	6	2	290	1	0	299
23303	274	1	5	6	0	286
23304	8	280	1	0	0	289
23305	280	6	3	2	0	291
23306	7	274	1	3	0	285
23307	4	7	2	268	0	281
23308	4	1	1	283	0	289
23309	0	3	274	8	0	285
23310	265	1	6	7	0	279
23311	5	1	274	1	0	281
23312	273	1	6	3	0	283
23313	9	1	3	273	0	286
23314	4	0	2	278	0	284
23315	2	276	0	8	0	286
23316	3	10	0	288	0	301
23317	1	2	1	297	0	301
23318	2	3	286	7	0	298
23319	271	1	6	4	0	282
23320	9	278	2	0	0	289
23321	272	5	1	0	0	278
23322	8	0	1	275	0	284
23323	0	3	2	277	0	282
23324	267	1	1	9	0	278
23325	5	273	3	3	0	284
23326	260	5	1	5	0	271
23327	6	258	2	1	0	267
23328	2	256	1	1	0	260
23329	252	5	4	2	0	263
23330	6	1	3	245	0	255
23331	1	3	250	6	0	260
23332	4	0	3	237	0	244
23333	3	0	2	236	0	241
23334	0	235	2	7	0	244
23335	1	4	2	236	0	243
23336	3	4	1	232	0	240
23337	5	1	1	243	0	250
23338	2	1	1	247	0	251
23339	2	2	244	6	0	254
23340	2	2	249	1	0	254
23341	4	2	4	248	0	258
23342	2	2	245	5	0	254
23343	2	2	242	1	0	247
23344	2	2	3	243	0	250
23345	2	2	252	5	0	261
23346	6	1	5	245	0	257
23347	0	254	3	7	0	264
23348	257	5	3	2	0	267
23349	6	2	274	4	0	286
23350	2	3	9	273	0	287
23351	2	1	283	8	0	294
23352	2	1	10	287	0	300
23353	3	2	0	299	0	304
23354	290	2	1	13	0	306
23355	9	4	2	292	0	307
23356	280	2	0	16	0	298
23357	293	0	3	6	0	302
23358	9	289	3	5	0	306
23359	280	8	1	2	0	291
23360	10	277	2	1	0	290
23361	1	298	3	1	0	303
23362	284	6	2	4	0	296
23363	6	1	283	1	0	291
23364	1	1	279	1	0	282
23365	260	1	8	6	0	275
23366	268	0	4	0	0	272
23367	4	270	1	1	0	276
23368	277	6	0	2	0	285
23369	277	0	0	2	0	279
23370	261	2	1	3	0	267
23371	9	0	1	257	0	267
23372	259	1	1	6	0	267
23373	6	291	0	1	0	298
23374	1	6	0	300	0	307
23375	3	0	2	305	0	310
23376	0	300	1	9	0	310
23377	5	5	2	305	0	317
23378	310	0	1	8	0	319
23379	308	4	1	2	0	315
23380	8	314	2	1	0	325
23381	2	314	0	3	0	319
23382	314	7	1	3	0	325
23383	8	1	311	1	0	321
23384	1	2	311	1	0	315
23385	3	1	6	305	0	315
23386	3	1	2	316	0	322
23387	1	3	310	6	0	320
23388	2	303	4	3	0	312
23389	2	3	1	290	0	296
23390	3	1	323	6	0	333
23391	4	1	5	311	0	321
23392	2	1	0	317	0	320
23393	2	336	1	6	0	345
23394	7	6	0	330	0	343
23395	2	1	2	336	0	341
23396	3	3	1	343	0	350
23397	335	2	1	8	0	346
23398	6	2	2	322	0	332
23399	1	334	4	6	0	345
23400	335	6	1	3	0	345
23401	6	2	323	2	0	333
23402	4	3	324	0	0	331
23403	318	1	8	2	0	329
23404	5	1	5	329	0	340
23405	4	1	343	4	0	352
23406	5	2	4	336	0	347
23407	2	3	0	345	0	350
23408	348	1	3	5	0	357
23409	336	2	1	3	0	342
23410	7	345	2	5	0	359
23411	4	7	1	338	0	350
23412	4	1	342	7	0	354
23413	2	363	5	2	0	372
23414	356	5	0	4	0	365
23415	8	359	1	3	0	371
23416	353	7	0	4	0	364
23417	6	2	354	3	0	365
23418	350	1	5	1	0	357
23419	361	1	2	2	0	366
23420	6	2	373	2	0	383
23421	3	2	4	363	0	372
23422	3	359	2	6	0	370
23423	0	383	4	1	0	388
23424	2	390	1	2	0	395
23425	2	8	1	369	0	380
23426	1	2	381	7	0	391
23427	1	3	5	359	0	368
23428	4	2	0	380	0	386
23429	1	1	378	7	0	387
23430	2	371	7	2	0	382
23431	5	5	0	365	0	375
23432	374	0	1	8	0	383
23433	7	1	1	374	0	383
23434	0	2	0	376	0	378
23435	1	373	0	10	0	384
23436	372	7	3	2	0	384
23437	7	1	2	385	0	395
23438	2	1	382	8	0	393
23439	2	375	6	3	0	386
23440	359	6	1	4	0	370
23441	6	0	371	1	0	378
23442	356	1	6	4	0	367
23443	9	0	0	373	0	382
23444	2	384	2	6	0	394
23445	384	7	1	2	0	394
23446	376	2	1	7	0	386
23447	8	391	2	2	0	403
23448	4	6	2	389	0	401
23449	2	2	1	384	0	389
23450	375	1	1	8	0	385
23451	4	380	1	2	0	387
23452	2	6	1	360	0	369
23453	2	354	1	4	0	361
23454	0	368	0	1	0	369
23455	2	4	0	358	0	364
23456	349	1	2	8	0	360
23457	3	358	0	2	0	363
23458	2	3	2	352	0	359
23459	3	2	1	356	0	362
23460	2	0	350	6	0	358
23461	2	1	326	2	0	331
23462	0	342	4	2	0	348
23463	0	7	341	1	0	349
23464	1	3	3	347	0	354
23465	1	0	355	3	0	359
23466	1	0	3	353	0	357
23467	0	0	2	361	0	363
23468	1	3	1	359	0	364
23469	355	1	1	8	0	365
23470	5	0	1	359	0	365
23471	2	2	1	358	0	363
23472	0	345	0	8	0	353
23473	4	4	0	343	0	351
23474	350	1	1	6	0	358
23475	6	357	0	1	0	364
23476	351	6	0	8	0	365
23477	5	2	353	0	0	360
23478	2	2	356	2	0	362
23479	2	0	6	354	0	362
23480	1	4	1	366	0	372
23481	2	360	0	7	0	369
23482	2	6	2	331	0	341
23483	356	1	1	5	0	363
23484	353	1	2	3	0	359
23485	7	1	1	363	0	372
23486	1	4	393	6	0	404
23487	2	1	7	392	0	402
23488	0	1	1	407	0	409
23489	6	1	3	399	0	409
23490	1	5	1	402	0	409
23491	1	3	0	404	0	408
23492	0	397	2	7	0	406
23493	394	6	1	5	0	406
23494	403	1	3	5	0	412
23495	395	1	0	6	0	402
23496	5	401	2	4	0	412
23497	397	5	1	5	0	408
23498	6	402	1	1	0	410
23499	1	6	392	3	0	402
23500	3	0	5	383	0	391
23501	1	2	395	7	0	405
23502	1	395	5	3	0	404
23503	387	6	0	4	0	397
23504	5	1	403	3	0	412
23505	1	2	424	2	0	429
23506	0	446	8	2	0	456
23507	3	9	1	448	0	461
23508	3	1	505	9	0	518
23509	5	0	8	490	0	503
23510	1	0	2	545	0	548
23511	1	1	1	568	0	571
23512	579	1	1	14	0	595
23513	581	1	0	2	0	584
23514	14	2	1	573	0	590
23515	582	1	0	17	0	600
23516	18	0	574	1	0	593
23517	2	0	576	4	0	582
23518	3	0	588	2	0	593
23519	4	0	612	3	0	619
23520	2	602	15	4	0	623
23521	10	13	4	589	0	616
23522	3	1	621	15	0	640
23523	575	3	14	3	0	595
23524	616	1	4	8	0	629
23525	15	609	8	3	0	635
23526	607	14	6	7	0	634
23527	17	0	7	611	0	635
23528	1	8	648	13	0	670
23529	5	3	17	616	0	641
23530	3	660	5	15	0	683
23531	642	15	5	5	0	667
23532	665	0	3	8	0	676
23533	15	661	2	3	0	681
23534	666	14	2	6	0	688
23535	663	1	2	11	0	677
23536	15	660	3	3	0	681
23537	12	12	2	643	0	669
23538	4	645	3	15	0	667
23539	651	19	2	4	0	676
23540	20	1	4	657	0	682
23541	648	6	5	16	0	675
23542	21	3	3	645	0	672
23543	5	4	648	19	0	676
23544	614	6	13	10	0	643
23545	17	4	634	11	0	666
23546	5	4	16	639	0	664
23547	11	5	643	13	0	672
23548	10	2	18	628	0	658
23549	6	6	637	19	0	668
23550	624	2	18	5	0	649
23551	13	632	6	11	0	662
23552	629	15	8	6	0	658
23553	19	0	7	634	0	660
23554	622	7	4	25	0	658
23555	16	629	8	5	0	658
23556	7	637	5	7	0	656
23557	10	657	3	6	0	676
23558	678	16	5	8	0	707
23559	20	6	4	674	0	704
23560	9	10	5	684	0	708
23561	7	5	668	21	0	701
23562	7	7	649	8	0	671
23563	18	4	13	657	0	692
23564	5	9	675	18	0	707
23565	9	677	17	4	0	707
23566	668	15	1	12	0	696
23567	18	6	686	5	0	715
23568	8	10	671	10	0	699
23569	14	4	18	647	0	683
23570	672	6	12	19	0	709
23571	19	2	11	660	0	692
23572	659	1	10	25	0	695
23573	23	5	11	656	0	695
23574	8	6	690	19	0	723
23575	9	673	20	6	0	708
23576	10	12	694	5	0	721
23577	5	684	23	10	0	722
23578	13	20	6	674	0	713
23579	677	7	9	20	0	713
23580	18	5	671	8	0	702
23581	7	6	16	666	0	695
23582	14	2	7	677	0	700
23583	678	6	7	19	0	710
23584	21	5	6	655	0	687
23585	9	671	9	14	0	703
23586	652	17	8	9	0	686
23587	16	8	647	8	0	679
23588	622	7	18	9	0	656
23589	17	646	11	6	0	680
23590	10	17	5	628	0	660
23591	8	651	3	20	0	682
23592	652	16	6	7	0	681
23593	17	3	650	9	0	679
23594	628	6	13	10	0	657
23595	19	645	5	7	0	676
23596	16	14	7	647	0	684
23597	654	6	2	21	0	683
23598	668	7	8	2	0	685
23599	19	6	4	656	0	685
23600	9	5	7	662	0	683
23601	12	653	5	16	0	686
23602	8	15	7	652	0	682
23603	9	722	2	15	0	748
23604	8	760	4	6	0	778
23605	10	20	3	713	0	746
23606	5	717	6	13	0	741
23607	10	17	718	6	0	751
23608	7	6	726	8	0	747
23609	5	725	18	8	0	756
23610	3	20	721	6	0	750
23611	6	2	706	4	0	718
23612	2	2	667	2	0	673
23613	1	662	17	1	0	681
23614	633	13	8	3	0	657
23615	11	635	5	3	0	654
23616	2	15	636	0	0	653
23617	7	6	11	618	0	642
23618	623	3	2	14	0	642
23619	13	2	607	3	0	625
23620	4	3	13	614	0	634
23621	2	2	621	12	0	637
23622	4	3	15	592	0	614
23623	578	1	7	16	0	602
23624	10	5	594	4	0	613
23625	4	585	15	5	0	609
23626	5	17	4	571	0	597
23627	591	4	6	15	0	616
23628	14	5	577	4	0	600
23629	5	5	15	540	0	565
23630	2	565	5	15	0	587
23631	567	12	4	9	0	592
23632	574	5	5	5	0	589
23633	17	3	3	572	0	595
23634	6	565	3	16	0	590
23635	5	594	4	6	0	609
23636	588	15	4	6	0	613
23637	15	6	1	582	0	604
23638	4	585	5	12	0	606
23639	597	14	6	6	0	623
23640	20	6	3	601	0	630
23641	5	5	6	610	0	626
23642	5	3	585	16	0	609
23643	3	594	14	7	0	618
23644	5	636	5	5	0	651
23645	8	17	4	624	0	653
23646	630	7	2	17	0	656
23647	15	635	5	5	0	660
23648	627	16	1	10	0	654
23649	18	624	2	1	0	645
23650	7	17	3	623	0	650
23651	629	4	1	18	0	652
23652	19	6	3	625	0	653
23653	6	6	623	19	0	654
23654	7	2	16	593	0	618
23655	3	621	6	18	0	648
23656	607	18	4	8	0	637
23657	17	606	1	8	0	632
23658	7	21	1	586	0	615
23659	12	5	2	600	0	619
23660	6	6	590	19	0	621
23661	4	6	586	8	0	604
23662	5	12	17	577	0	611
23663	4	5	580	19	0	608
23664	3	576	18	6	0	603
23665	582	14	5	11	0	612
23666	16	10	598	3	0	627
23667	578	3	15	6	0	602
23668	605	5	5	7	0	622
23669	602	6	2	6	0	616
23670	609	3	4	4	0	620
23671	21	4	4	595	0	624
23672	6	6	3	575	0	590
23673	5	579	5	20	0	609
23674	561	16	5	6	0	588
23675	12	10	558	7	0	587
23676	8	2	16	552	0	578
23677	5	8	7	551	0	571
23678	3	6	546	18	0	573
23679	6	544	18	6	0	574
23680	7	14	12	531	0	564
23681	8	5	7	563	0	583
23682	542	4	1	19	0	566
23683	15	539	6	7	0	567
23684	12	18	3	528	0	561
23685	8	526	3	19	0	556
23686	5	15	5	534	0	559
23687	528	7	2	21	0	558
23688	536	5	4	11	0	556
23689	20	5	6	523	0	554
23690	515	4	2	22	0	543
23691	530	1	6	12	0	549
23692	17	506	6	7	0	536
23693	11	15	3	505	0	534
23694	8	516	3	20	0	547
23695	10	15	5	510	0	540
23696	514	6	4	17	0	541
23697	17	10	2	509	0	538
23698	12	7	3	512	0	534
23699	10	6	495	21	0	532
23700	6	470	12	9	0	497
23701	8	501	3	7	0	519
23702	492	18	1	6	0	517
23703	15	6	2	387	0	410
23704	355	4	2	13	0	374
23705	13	340	0	1	0	354
23706	1	315	2	5	0	323
23707	5	342	2	2	0	351
23708	269	3	3	5	0	280
23709	4	279	1	1	0	285
23710	270	2	2	2	0	276
23711	253	2	0	0	0	255
23712	264	0	0	3	0	267
23713	2	1	0	276	0	279
23714	2	0	2	277	0	281
23715	0	0	3	283	0	286
23716	1	0	0	278	0	279
23717	276	0	2	6	0	284
23718	3	275	1	1	0	280
23719	2	3	0	276	0	281
23720	282	0	1	5	0	288
23721	4	1	0	278	0	283
23722	5	0	0	276	0	281
23723	277	1	0	3	0	281
23724	7	0	271	0	0	278
23725	0	1	3	266	0	270
23726	1	0	269	7	0	277
23727	1	1	3	266	0	271
23728	3	0	0	268	0	271
23729	252	0	2	4	0	258
23730	4	250	0	3	0	257
23731	1	251	0	2	0	254
23732	239	3	1	0	0	243
23733	2	255	1	1	0	259
23734	256	4	0	2	0	262
23735	3	0	256	2	0	261
23736	235	2	2	0	0	239
23737	251	0	0	1	0	252
23738	246	0	1	1	0	248
23739	3	0	1	240	0	244
23740	1	0	0	243	0	244
23741	1	239	0	2	0	242
23742	1	1	0	242	0	244
23743	237	0	0	9	0	246
23744	2	245	0	0	0	247
23745	0	240	1	1	0	242
23746	239	1	0	0	0	240
23747	1	1	236	1	0	239
23748	0	1	1	233	0	235
23749	1	1	241	1	0	244
23750	0	1	2	238	0	241
23751	0	248	1	1	0	250
23752	0	1	2	253	0	256
23753	247	0	0	2	0	249
23754	1	1	0	241	0	243
23755	0	0	255	2	0	257
23756	220	0	1	0	0	221
23757	2	254	0	2	0	258
23758	0	279	3	0	0	282
23759	276	1	0	4	0	281
23760	283	1	0	3	0	287
23761	3	2	289	0	0	294
23762	268	1	3	2	0	274
23763	5	282	1	0	0	288
23764	291	2	1	0	0	294
23765	4	1	1	275	0	281
23766	3	267	0	2	0	272
23767	269	4	0	5	0	278
23768	6	1	274	1	0	282
23769	3	1	5	272	0	281
23770	271	2	1	6	0	280
23771	5	2	270	1	0	278
23772	270	0	4	2	0	276
23773	4	1	1	270	0	276
23774	5	2	1	267	0	275
23775	2	0	274	4	0	280
23776	1	0	5	271	0	277
23777	277	0	1	9	0	287
23778	5	272	1	3	0	281
23779	270	3	3	4	0	280
23780	273	1	0	3	0	277
23781	7	1	0	268	0	276
23782	2	2	273	5	0	282
23783	3	0	4	279	0	286
23784	284	0	1	8	0	293
23785	5	280	1	2	0	288
23786	288	5	1	0	0	294
23787	6	1	0	286	0	293
23788	4	1	0	293	0	298
23789	1	1	1	290	0	293
23790	1	0	289	7	0	297
23791	1	0	3	295	0	299
23792	3	1	289	4	0	297
23793	2	1	291	2	0	296
23794	4	0	6	313	0	323
23795	0	0	322	9	0	331
23796	322	0	7	6	0	335
23797	10	0	5	342	0	357
23798	9	0	3	345	0	357
23799	1	345	3	16	0	365
23800	340	9	4	9	0	362
23801	365	5	1	6	0	377
23802	15	364	1	2	0	382
23803	9	12	2	366	0	389
23804	7	7	371	10	0	395
23805	355	1	8	10	0	374
23806	369	2	7	5	0	383
23807	17	0	2	354	0	373
23808	11	1	348	10	0	370
23809	7	342	9	6	0	364
23810	334	12	6	7	0	359
23811	10	8	345	3	0	366
23812	8	343	10	0	0	361
23813	331	10	9	2	0	352
23814	338	6	2	4	0	350
23815	17	1	2	325	0	345
23816	7	324	3	7	0	341
23817	9	10	0	344	0	363
23818	9	6	2	340	0	357
23819	4	3	2	332	0	341
23820	4	2	1	341	0	348
23821	2	3	322	19	0	346
23822	5	3	8	325	0	341
23823	3	2	9	327	0	341
23824	4	4	315	19	0	342
23825	3	316	15	10	0	344
23826	313	10	7	9	0	339
23827	314	7	4	11	0	336
23828	16	2	4	317	0	339
23829	322	4	2	11	0	339
23830	15	2	0	325	0	342
23831	12	1	326	14	0	353
23832	3	6	326	11	0	346
23833	6	315	16	4	0	341
23834	313	11	10	8	0	342
23835	14	12	327	3	0	356
23836	12	2	12	324	0	350
23837	9	1	8	353	0	371
23838	5	0	3	368	0	376
23839	5	1	6	368	0	380
23840	4	2	4	362	0	372
23841	2	3	340	30	0	375
23842	5	2	17	343	0	367
23843	331	4	11	23	0	369
23844	17	335	4	12	0	368
23845	337	16	3	8	0	364
23846	20	340	0	8	0	368
23847	340	17	1	9	0	367
23848	355	11	4	11	0	381
23849	29	2	4	338	0	373
23850	12	2	3	354	0	371
23851	335	1	4	27	0	367
23852	337	3	2	14	0	356
23853	354	3	2	6	0	365
23854	27	323	4	5	0	359
23855	15	332	3	4	0	354
23856	5	26	316	6	0	353
23857	7	8	17	311	0	343
23858	6	5	310	21	0	342
23859	5	301	16	13	0	335
23860	2	13	9	297	0	321
23861	1	8	3	299	0	311
23862	4	2	2	307	0	315
23863	291	3	1	25	0	320
23864	296	3	2	11	0	312
23865	22	289	6	2	0	319
23866	12	15	1	296	0	324
23867	7	9	286	16	0	318
23868	3	2	292	8	0	305
23869	286	5	20	7	0	318
23870	301	0	8	9	0	318
23871	28	0	3	289	0	320
23872	304	1	1	18	0	324
23873	19	2	287	10	0	318
23874	10	284	13	5	0	312
23875	5	14	9	296	0	324
23876	3	8	307	16	0	334
23877	4	4	15	312	0	335
23878	5	4	9	317	0	335
23879	3	2	306	23	0	334
23880	291	0	15	16	0	322
23881	315	0	6	9	0	330
23882	24	318	0	5	0	347
23883	327	14	3	5	0	349
23884	332	10	1	2	0	345
23885	24	3	322	4	0	353
23886	330	2	20	3	0	355
23887	20	335	9	4	0	368
23888	350	16	6	3	0	375
23889	359	6	4	7	0	376
23890	367	4	2	5	0	378
23891	357	1	3	7	0	368
23892	367	3	2	2	0	374
23893	28	344	2	3	0	377
23894	320	15	1	4	0	340
23895	17	306	2	7	0	332
23896	2	272	1	6	0	281
23897	3	287	1	3	0	294
23898	268	13	1	4	0	286
23899	278	3	2	0	0	283
23900	13	3	255	1	0	272
23901	263	0	10	2	0	275
23902	272	2	2	0	0	276
23903	15	0	252	1	0	268
23904	6	1	10	253	0	270
23905	5	1	2	246	0	254
23906	5	1	1	263	0	270
23907	2	1	0	269	0	272
23908	1	1	1	267	0	270
23909	1	2	256	15	0	274
23910	1	251	13	4	0	269
23911	250	11	2	3	0	266
23912	11	255	2	1	0	269
23913	253	14	0	0	0	267
23914	257	2	0	3	0	262
23915	14	1	248	2	0	265
23916	4	0	11	231	0	246
23917	2	249	2	10	0	263
23918	251	10	1	2	0	264
23919	257	3	0	3	0	263
23920	266	1	0	4	0	271
23921	13	269	1	0	0	283
23922	277	10	1	0	0	288
23923	287	3	0	0	0	290
23924	287	1	0	3	0	291
23925	15	1	1	273	0	290
23926	4	0	1	287	0	292
23927	2	0	1	293	0	296
23928	276	1	0	14	0	291
23929	8	276	0	5	0	289
23930	277	8	1	4	0	290
23931	270	3	1	3	0	277
23932	269	1	1	3	0	274
23933	274	0	1	4	0	279
23934	12	265	1	0	0	278
23935	248	8	0	1	0	257
23936	10	247	1	1	0	259
23937	3	234	0	0	0	237
23938	236	4	1	0	0	241
23939	6	221	1	0	0	228
23940	2	234	0	0	0	236
23941	230	5	0	2	0	237
23942	231	3	0	1	0	235
23943	7	2	0	219	0	228
23944	4	2	0	228	0	234
23945	237	1	0	4	0	242
23946	235	1	0	5	0	241
23947	236	0	1	1	0	238
23948	7	2	235	0	0	244
23949	236	1	5	2	0	244
23950	6	2	1	242	0	251
23951	2	0	1	246	0	249
23952	3	1	0	246	0	250
23953	2	0	0	245	0	247
23954	2	0	232	7	0	241
23955	0	0	241	2	0	243
23956	1	0	5	239	0	245
23957	1	1	237	6	0	245
23958	0	0	244	1	0	245
23959	0	2	4	238	0	244
23960	5	0	1	246	0	252
23961	1	1	1	257	0	260
23962	4	0	2	247	0	253
23963	253	1	0	9	0	263
23964	260	1	1	2	0	264
23965	5	2	0	260	0	267
23966	4	1	0	263	0	268
23967	4	1	0	261	0	266
23968	3	1	1	261	0	266
23969	2	0	0	252	0	254
23970	1	257	1	5	0	264
23971	253	4	0	2	0	259
23972	5	254	1	3	0	263
23973	256	5	0	3	0	264
23974	258	1	0	4	0	263
23975	263	1	0	0	0	264
23976	7	2	0	244	0	253
23977	246	0	1	5	0	252
23978	8	1	0	240	0	249
23979	3	0	0	236	0	239
23980	241	0	0	6	0	247
23981	5	234	0	3	0	242
23982	0	221	1	2	0	224
23983	223	1	0	0	0	224
23984	2	2	215	0	0	219
23985	203	1	1	1	0	206
23986	5	0	0	215	0	220
23987	1	210	0	2	0	213
23988	2	207	0	0	0	209
23989	210	2	0	1	0	213
23990	1	1	1	214	0	217
23991	0	215	1	1	0	217
23992	218	1	0	2	0	221
23993	217	0	0	0	0	217
23994	218	0	0	0	0	218
23995	219	0	0	0	0	219
23996	1	217	0	0	0	218
23997	0	210	0	1	0	211
23998	217	0	0	2	0	219
23999	226	0	0	1	0	227
24000	1	1	225	0	0	227
24001	1	219	1	0	0	221
24002	221	1	1	1	0	224
24003	232	1	0	2	0	235
24004	2	1	237	0	0	240
24005	224	0	1	2	0	227
24006	2	0	245	0	0	247
24007	1	0	247	0	0	248
24008	2	0	4	234	0	240
24009	0	247	2	3	0	252
24010	265	3	1	2	0	271
24011	6	1	0	261	0	268
24012	4	1	0	256	0	261
24013	1	0	0	266	0	267
24014	262	0	0	8	0	270
24015	4	0	0	264	0	268
24016	2	0	0	278	0	280
24017	2	0	273	5	0	280
24018	265	0	4	3	0	272
24019	274	1	2	1	0	278
24020	6	0	274	0	0	280
24021	256	0	4	3	0	263
24022	6	1	2	265	0	274
24023	3	268	1	4	0	276
24024	4	4	1	270	0	279
24025	257	1	1	8	0	267
24026	5	263	1	3	0	272
24027	5	5	0	265	0	275
24028	3	1	0	274	0	278
24029	0	1	1	271	0	273
24030	3	0	1	267	0	271
24031	3	265	1	6	0	275
24032	265	4	1	3	0	273
24033	264	3	1	7	0	275
24034	9	272	0	1	0	282
24035	279	5	1	7	0	292
24036	293	2	1	3	0	299
24037	299	1	0	4	0	304
24038	18	0	281	0	0	299
24039	13	1	14	278	0	306
24040	3	0	275	17	0	295
24041	268	2	13	7	0	290
24042	15	279	6	3	0	303
24043	278	13	1	7	0	299
24044	11	286	4	1	0	302
24045	11	14	0	264	0	289
24046	4	7	0	286	0	297
24047	3	4	275	18	0	300
24048	1	274	13	9	0	297
24049	266	14	5	6	0	291
24050	15	5	266	3	0	289
24051	266	1	16	1	0	284
24052	16	3	5	260	0	284
24053	8	0	258	16	0	282
24054	2	254	16	6	0	278
24055	4	16	4	247	0	271
24056	3	3	256	16	0	278
24057	2	3	258	5	0	268
24058	2	254	18	2	0	276
24059	6	13	4	243	0	266
24060	1	7	4	251	0	263
24061	3	239	2	17	0	261
24062	243	16	1	7	0	267
24063	15	5	1	239	0	260
24064	7	244	3	16	0	270
24065	253	16	1	7	0	277
24066	259	7	2	2	0	270
24067	265	3	1	7	0	276
24068	17	257	1	2	0	277
24069	262	13	2	5	0	282
24070	269	4	3	4	0	280
24071	20	4	2	256	0	282
24072	251	6	1	14	0	272
24073	21	1	0	254	0	276
24074	8	5	244	14	0	271
24075	6	0	252	8	0	266
24076	4	3	19	254	0	280
24077	4	2	257	16	0	279
24078	250	3	15	8	0	276
24079	16	2	9	248	0	275
24080	10	2	4	267	0	283
24081	2	2	254	20	0	278
24082	4	233	17	7	0	261
24083	3	259	6	5	0	273
24084	0	20	3	242	0	265
24085	3	7	4	249	0	263
24086	1	6	234	21	0	262
24087	1	3	244	9	0	257
24088	2	2	20	233	0	257
24089	1	0	232	22	0	255
24090	225	2	19	6	0	252
24091	20	1	7	226	0	254
24092	231	2	3	18	0	254
24093	21	1	3	228	0	253
24094	12	1	1	242	0	256
24095	5	2	231	22	0	260
24096	7	232	14	7	0	260
24097	4	14	5	235	0	258
24098	2	5	232	16	0	255
24099	3	222	18	6	0	249
24100	2	16	7	227	0	252
24101	224	4	3	21	0	252
24102	15	2	223	6	0	246
24103	200	2	18	3	0	223
24104	18	1	202	4	0	225
24105	184	0	18	3	0	205
24106	16	182	8	4	0	210
24107	7	182	4	1	0	194
24108	2	22	1	162	0	187
24109	2	171	2	13	0	188
24110	163	14	2	8	0	187
24111	11	8	2	174	0	195
24112	7	3	1	178	0	189
24113	1	3	2	184	0	190
24114	3	1	169	20	0	193
24115	0	0	14	170	0	184
24116	2	1	169	15	0	187
24117	0	163	14	8	0	185
24118	144	12	7	4	0	167
24119	13	153	5	4	0	175
24120	163	12	2	2	0	179
24121	170	7	2	2	0	181
24122	177	3	1	2	0	183
24123	173	2	0	4	0	179
24124	20	1	156	2	0	179
24125	10	2	14	150	0	176
24126	4	3	4	163	0	174
24127	3	1	2	174	0	180
24128	148	1	5	19	0	173
24129	155	2	2	10	0	169
24130	16	163	1	4	0	184
24131	5	12	162	3	0	182
24132	4	5	165	1	0	175
24133	3	155	14	1	0	173
24134	1	163	8	0	0	172
24135	5	3	7	135	0	150
24136	0	2	1	134	0	137
24137	136	3	0	4	0	143
24138	6	133	0	3	0	142
24139	1	5	0	141	0	147
24140	3	1	144	4	0	152
24141	1	1	2	150	0	154
24142	2	0	1	148	0	151
24143	3	0	1	153	0	157
24144	2	0	2	150	0	154
24145	0	1	145	7	0	153
24146	0	141	5	4	0	150
24147	0	144	3	2	0	149
24148	132	6	1	1	0	140
24149	4	134	0	0	0	138
24150	3	145	0	0	0	148
24151	3	7	1	138	0	149
24152	2	3	1	142	0	148
24153	2	3	0	143	0	148
24154	0	1	139	7	0	147
24155	0	139	4	5	0	148
24156	0	4	2	131	0	137
24157	1	139	1	5	0	146
24158	134	5	0	4	0	143
24159	4	136	0	3	0	143
24160	138	5	2	0	0	145
24161	3	3	131	2	0	139
24162	133	1	4	1	0	139
24163	5	0	2	130	0	137
24164	2	2	135	5	0	144
24165	131	1	5	4	0	141
24166	136	2	2	3	0	143
24167	140	1	1	2	0	144
24168	7	1	1	134	0	143
24169	3	2	138	4	0	147
24170	129	2	4	3	0	138
24171	4	0	2	139	0	145
24172	2	1	2	142	0	147
24173	3	0	153	8	0	164
24174	0	153	6	4	0	163
24175	3	6	3	153	0	165
24176	0	150	1	4	0	155
24177	147	7	0	3	0	157
24178	151	2	0	4	0	157
24179	7	3	1	147	0	158
24180	154	1	0	5	0	160
24181	5	149	1	4	0	159
24182	153	3	0	2	0	158
24183	3	147	0	4	0	154
24184	2	3	4	144	0	153
24185	2	1	0	144	0	147
24186	1	140	2	4	0	147
24187	1	4	0	142	0	147
24188	1	1	143	4	0	149
24189	0	142	4	1	0	147
24190	132	3	1	0	0	136
24191	4	131	0	1	0	136
24192	2	3	0	131	0	136
24193	0	1	131	3	0	135
24194	1	0	3	130	0	134
24195	1	0	1	134	0	136
24196	128	0	0	6	0	134
24197	3	0	128	1	0	132
24198	1	129	3	0	0	133
24199	0	3	133	0	0	136
24200	0	1	138	0	0	139
24201	0	0	130	0	0	130
24202	0	0	3	129	0	132
24203	134	0	1	4	0	139
24204	2	135	0	1	0	138
24205	134	2	0	1	0	137
24206	138	1	0	0	0	139
24207	4	0	0	135	0	139
24208	2	139	0	2	0	143
24209	135	2	0	5	0	142
24210	2	139	0	1	0	142
24211	4	2	0	133	0	139
24212	0	2	0	141	0	143
24213	0	137	0	3	0	140
24214	0	2	0	142	0	144
24215	0	2	136	2	0	140
24216	0	0	134	2	0	136
24217	0	0	4	133	0	137
24218	0	0	2	132	0	134
24219	0	0	136	4	0	140
24220	0	0	134	2	0	136
24221	121	0	5	0	0	126
24222	2	128	2	0	0	132
24223	2	141	0	0	0	143
24224	0	4	0	140	0	144
24225	0	2	0	141	0	143
24226	0	0	0	140	0	140
24227	0	0	138	4	0	142
24228	0	0	139	2	0	141
24229	0	0	4	138	0	142
24230	0	0	136	2	0	138
24231	0	134	1	2	0	137
24232	131	3	2	0	0	136
24233	3	1	136	0	0	140
24234	2	0	135	0	0	137
24235	1	0	4	128	0	133
24236	0	0	139	3	0	142
24237	0	141	3	2	0	146
24238	1	3	2	135	0	141
24239	1	1	140	3	0	145
24240	0	138	3	1	0	142
24241	137	2	1	2	0	142
24242	3	2	0	133	0	138
24243	2	0	0	136	0	138
24244	132	0	0	6	0	138
24245	3	134	0	1	0	138
24246	138	3	1	1	0	143
24247	139	1	1	0	0	141
24248	137	1	0	1	0	139
24249	4	0	0	137	0	141
24250	138	1	2	3	0	144
24251	1	136	0	2	0	139
24252	2	134	0	0	0	136
24253	137	4	1	2	0	144
24254	3	0	2	142	0	147
24255	1	0	0	145	0	146
24256	0	0	2	150	0	152
24257	1	2	138	5	0	146
24258	0	142	4	2	0	148
24259	2	3	3	143	0	151
24260	140	2	0	5	0	147
24261	4	0	0	144	0	148
24262	4	0	140	3	0	147
24263	0	142	2	2	0	146
24264	142	3	1	1	0	147
24265	140	1	0	0	0	141
24266	141	0	0	2	0	143
24267	4	1	0	142	0	147
24268	2	0	141	3	0	146
24269	0	2	146	3	0	151
24270	1	150	4	1	0	156
24271	1	4	1	152	0	158
24272	0	4	0	154	0	158
24273	147	0	0	8	0	155
24274	3	0	0	151	0	154
24275	153	0	0	4	0	157
24276	2	1	146	4	0	153
24277	3	0	149	2	0	154
24278	1	1	6	146	0	154
24279	0	0	1	150	0	151
24280	1	0	0	160	0	161
24281	158	1	0	8	0	167
24282	160	0	1	3	0	164
24283	9	1	0	161	0	171
24284	6	0	157	5	0	168
24285	1	0	165	3	0	169
24286	0	0	9	167	0	176
24287	166	0	6	6	0	178
24288	8	1	2	167	0	178
24289	4	0	0	176	0	180
24290	2	1	170	11	0	184
24291	1	1	167	6	0	175
24292	161	0	11	3	0	175
24293	8	0	173	0	0	181
24294	4	0	6	160	0	170
24295	3	0	5	170	0	178
24296	165	0	2	13	0	180
24297	9	166	1	7	0	183
24298	165	6	1	4	0	176
24299	8	160	2	2	0	172
24300	159	7	2	1	0	169
24301	7	4	154	2	0	167
24302	139	3	7	4	0	153
24303	149	0	5	2	0	156
24304	12	0	3	147	0	162
24305	4	1	149	8	0	162
24306	3	0	7	141	0	151
24307	2	0	5	147	0	154
24308	2	137	3	10	0	152
24309	0	4	3	146	0	153
24310	2	143	1	8	0	154
24311	1	7	2	140	0	150
24312	136	3	0	8	0	147
24313	8	1	2	144	0	155
24314	4	0	137	9	0	150
24315	131	2	8	4	0	145
24316	8	1	142	2	0	153
24317	139	2	7	3	0	151
24318	153	0	2	2	0	157
24319	11	145	3	1	0	160
24320	9	156	1	2	0	168
24321	155	9	4	3	0	171
24322	156	4	5	4	0	169
24323	156	1	3	3	0	163
24324	158	1	2	7	0	168
24325	160	0	0	5	0	165
24326	13	2	0	147	0	162
24327	7	1	1	157	0	166
24328	2	2	150	10	0	164
24329	144	0	8	9	0	161
24330	10	1	5	144	0	160
24331	5	0	4	152	0	161
24332	3	1	146	10	0	160
24333	5	137	6	6	0	154
24334	2	146	5	4	0	157
24335	141	9	3	4	0	157
24336	129	6	4	2	0	141
24337	12	126	1	3	0	142
24338	7	124	1	4	0	136
24339	132	9	3	1	0	145
24340	137	5	1	6	0	149
24341	14	4	0	129	0	147
24342	5	3	1	135	0	144
24343	6	1	2	138	0	147
24344	132	0	2	13	0	147
24345	133	2	1	6	0	142
24346	13	2	2	129	0	146
24347	134	0	3	9	0	146
24348	12	0	128	4	0	144
24349	7	1	6	131	0	145
24350	3	1	133	9	0	146
24351	1	127	9	8	0	145
24352	3	8	4	129	0	144
24353	125	3	3	7	0	138
24354	8	3	1	124	0	136
24355	9	1	1	123	0	134
24356	4	1	122	12	0	139
24357	1	1	124	9	0	135
24358	4	120	9	5	0	138
24359	125	8	7	2	0	142
24360	130	4	1	3	0	138
24361	133	2	1	2	0	138
24362	136	2	1	4	0	143
24363	15	2	1	124	0	142
24364	10	1	3	127	0	141
24365	4	130	1	11	0	146
24366	129	9	2	4	0	144
24367	135	4	2	3	0	144
24368	12	2	122	2	0	138
24369	111	0	7	4	0	122
24370	11	110	3	3	0	127
24371	2	10	0	113	0	125
24372	1	117	0	10	0	128
24373	115	10	1	4	0	130
24374	8	115	1	3	0	127
24375	5	8	0	113	0	126
24376	3	1	2	120	0	126
24377	0	2	1	119	0	122
24378	1	111	0	10	0	122
24379	2	6	0	113	0	121
24380	1	2	0	119	0	122
24381	1	101	0	8	0	110
24382	0	102	1	3	0	106
24383	95	7	1	0	0	103
24384	6	100	0	0	0	106
24385	90	4	0	0	0	94
24386	5	0	90	0	0	95
24387	1	93	4	0	0	98
24388	94	4	0	1	0	99
24389	94	0	0	2	0	96
24390	4	0	90	1	0	95
24391	0	1	3	84	0	88
24392	1	0	89	5	0	95
24393	2	86	4	0	0	92
24394	87	3	2	0	0	92
24395	4	84	0	1	0	89
24396	1	4	0	86	0	91
24397	0	1	0	88	0	89
24398	0	0	84	4	0	88
24399	2	0	82	0	0	84
24400	75	1	2	1	0	79
24401	87	0	0	2	0	89
24402	86	0	1	1	0	88
24403	87	0	1	1	0	89
24404	3	86	0	0	0	89
24405	2	3	0	85	0	90
24406	1	1	0	92	0	94
24407	1	92	0	5	0	98
24408	92	4	0	1	0	97
24409	95	1	0	1	0	97
24410	5	1	94	1	0	101
24411	93	1	3	2	0	99
24412	6	0	2	91	0	99
24413	2	0	88	4	0	94
24414	2	0	5	89	0	96
24415	1	0	94	4	0	99
24416	0	1	95	1	0	97
24417	2	1	5	90	0	98
24418	0	89	2	3	0	94
24419	88	5	0	2	0	95
24420	86	1	1	0	0	88
24421	4	105	1	1	0	111
24422	2	106	0	2	0	110
24423	108	5	0	4	0	117
24424	112	2	1	0	0	115
24425	111	0	1	1	0	113
24426	111	1	0	2	0	114
24427	8	1	0	106	0	115
24428	2	1	102	5	0	110
24429	2	101	4	1	0	108
24430	103	6	1	0	0	110
24431	7	104	1	0	0	112
24432	104	3	2	1	0	110
24433	108	3	0	0	0	111
24434	5	0	104	1	0	110
24435	3	109	4	0	0	116
24436	1	3	3	112	0	119
24437	2	1	1	116	0	120
24438	2	0	2	109	0	113
24439	106	1	1	5	0	113
24440	112	1	0	2	0	115
24441	109	1	1	0	0	111
24442	5	107	1	2	0	115
24443	108	4	1	2	0	115
24444	3	115	2	0	0	120
24445	3	3	104	2	0	112
24446	1	110	3	0	0	114
24447	2	2	2	101	0	107
24448	2	1	0	100	0	103
24449	0	0	96	4	0	100
24450	2	1	3	98	0	104
24451	2	1	1	97	0	101
24452	98	0	0	3	0	101
24453	100	1	0	1	0	102
24454	103	0	0	1	0	104
24455	2	101	0	1	0	104
24456	102	2	1	1	0	106
24457	102	3	0	0	0	105
24458	3	97	1	2	0	103
24459	1	3	0	94	0	98
24460	2	0	0	98	0	100
24461	97	0	0	3	0	100
24462	3	0	94	0	0	97
24463	2	95	1	0	0	98
24464	0	1	0	92	0	93
24465	1	86	0	2	0	89
24466	0	93	0	2	0	95
24467	92	2	1	1	0	96
24468	91	2	0	1	0	94
24469	3	0	0	93	0	96
24470	1	1	0	90	0	92
24471	1	1	1	88	0	91
24472	1	1	0	86	0	88
24473	0	0	84	3	0	87
24474	1	1	82	1	0	85
24475	1	0	2	93	0	96
24476	0	0	93	2	0	95
24477	0	97	2	1	0	100
24478	97	1	1	1	0	100
24479	100	1	0	1	0	102
24480	3	2	0	99	0	104
24481	1	0	0	100	0	101
24482	2	2	0	100	0	104
24483	1	97	0	1	0	99
24484	98	1	1	1	0	101
24485	98	2	0	0	0	100
24486	2	1	91	2	0	96
24487	2	1	2	99	0	104
24488	0	1	103	3	0	107
24489	3	0	2	109	0	114
24490	2	0	4	108	0	114
24491	0	1	1	106	0	108
24492	1	0	0	116	0	117
24493	109	1	1	9	0	120
24494	111	2	0	4	0	117
24495	119	0	1	1	0	121
24496	8	0	1	109	0	118
24497	4	0	109	6	0	119
24498	107	0	5	4	0	116
24499	6	0	1	118	0	125
24500	121	0	1	7	0	129
24501	9	0	0	117	0	126
24502	3	111	1	5	0	120
24503	1	129	2	3	0	135
24504	1	4	1	125	0	131
24505	1	3	1	123	0	128
24506	3	1	0	124	0	128
24507	1	123	0	9	0	133
24508	121	5	0	4	0	130
24509	4	124	0	2	0	130
24510	2	5	122	1	0	130
24511	4	1	4	114	0	123
24512	1	123	1	5	0	130
24513	0	4	1	122	0	127
24514	2	1	1	126	0	130
24515	1	2	123	4	0	130
24516	108	0	5	5	0	118
24517	5	132	1	2	0	140
24518	129	6	1	3	0	139
24519	134	2	1	2	0	139
24520	140	2	0	1	0	143
24521	6	0	131	1	0	138
24522	4	0	5	131	0	140
24523	2	1	1	136	0	140
24524	1	1	131	6	0	139
24525	125	0	5	4	0	134
24526	6	0	132	2	0	140
24527	1	0	136	0	0	137
24528	1	129	5	2	0	137
24529	2	5	2	131	0	140
24530	0	1	134	6	0	141
24531	122	0	5	2	0	129
24532	127	0	3	2	0	132
24533	7	0	128	1	0	136
24534	2	2	6	126	0	136
24535	3	0	137	6	0	146
24536	1	139	6	2	0	148
24537	144	5	1	2	0	152
24538	153	1	2	2	0	158
24539	156	2	1	2	0	161
24540	7	1	0	148	0	156
24541	2	0	2	156	0	160
24542	2	1	148	7	0	158
24543	147	0	6	3	0	156
24544	7	1	2	146	0	156
24545	149	1	1	4	0	155
24546	6	1	151	3	0	161
24547	2	0	155	2	0	159
24548	2	0	7	141	0	150
24549	4	1	1	155	0	161
24550	0	0	152	8	0	160
24551	145	0	5	2	0	152
24552	4	0	4	146	0	154
24553	2	148	3	5	0	158
24554	150	6	0	2	0	158
24555	9	156	0	2	0	167
24556	158	7	2	0	0	167
24557	9	1	159	2	0	171
24558	2	1	164	3	0	170
24559	1	164	8	1	0	174
24560	162	6	2	2	0	172
24561	7	2	169	0	0	178
24562	160	1	6	0	0	167
24563	7	164	3	0	0	174
24564	1	6	4	168	0	179
24565	2	3	2	165	0	172
24566	1	153	0	9	0	163
24567	168	6	2	2	0	178
24568	177	1	0	1	0	179
24569	172	2	0	1	0	175
24570	7	0	169	2	0	178
24571	4	1	6	168	0	179
24572	1	1	1	174	0	177
24573	0	1	1	172	0	174
24574	1	0	169	8	0	178
24575	1	163	7	2	0	173
24576	164	6	1	1	0	172
24577	5	1	159	1	0	166
24578	161	1	7	3	0	172
24579	6	165	2	1	0	174
24580	167	7	1	0	0	175
24581	9	1	0	166	0	176
24582	173	1	1	6	0	181
24583	8	0	1	170	0	179
24584	2	0	175	7	0	184
24585	1	1	5	177	0	184
24586	1	0	171	8	0	180
24587	156	0	7	1	0	164
24588	5	161	0	2	0	168
24589	0	3	0	147	0	150
24590	0	155	0	3	0	158
24591	152	2	0	0	0	154
24592	151	1	0	0	0	152
24593	3	152	0	0	0	155
24594	150	2	0	1	0	153
24595	159	0	0	0	0	159
24596	2	0	0	153	0	155
24597	0	0	0	156	0	156
24598	155	0	0	3	0	158
24599	158	0	0	0	0	158
24600	2	0	0	155	0	157
24601	2	0	0	167	0	169
24602	168	0	0	4	0	172
24603	5	0	164	0	0	169
24604	157	0	5	1	0	163
24605	6	0	162	0	0	168
24606	0	160	7	0	0	167
24607	2	5	0	159	0	166
24608	0	0	162	4	0	166
24609	0	171	5	0	0	176
24610	166	6	0	1	0	173
24611	4	1	167	0	0	172
24612	162	1	4	0	0	167
24613	166	0	0	1	0	167
24614	165	0	1	1	0	167
24615	5	0	0	159	0	164
24616	1	165	0	2	0	168
24617	168	4	1	2	0	175
24618	3	0	170	1	0	174
24619	155	0	4	2	0	161
24620	5	0	168	0	0	173
24621	0	167	4	0	0	171
24622	2	4	0	166	0	172
24623	0	0	2	167	0	169
24624	0	161	0	3	0	164
24625	0	4	0	164	0	168
24626	0	2	160	3	0	165
24627	0	166	4	0	0	170
24628	0	5	0	160	0	165
24629	161	0	1	5	0	167
24630	169	1	0	0	0	170
24631	6	0	0	169	0	175
24632	1	169	0	5	0	175
24633	1	6	0	176	0	183
24634	2	0	0	177	0	179
24635	0	1	163	7	0	171
24636	0	165	6	1	0	172
24637	0	6	0	162	0	168
24638	0	0	160	6	0	166
24639	0	158	6	0	0	164
24640	0	7	0	156	0	163
24641	156	0	1	7	0	164
24642	7	157	0	0	0	164
24643	0	7	0	160	0	167
24644	163	0	0	8	0	171
24645	169	1	0	2	0	172
24646	172	0	0	1	0	173
24647	166	0	0	1	0	167
24648	7	0	0	163	0	170
24649	1	0	170	7	0	178
24650	3	0	7	159	0	169
24651	0	164	0	7	0	171
24652	167	7	1	1	0	176
24653	7	0	166	1	0	174
24654	160	1	5	0	0	166
24655	7	1	154	0	0	162
24656	0	0	7	156	0	163
24657	1	0	160	6	0	167
24658	0	1	6	154	0	161
24659	0	0	158	6	0	164
24660	0	1	7	157	0	165
24661	159	0	0	9	0	168
24662	6	174	1	0	0	181
24663	0	6	0	169	0	175
24664	1	1	0	172	0	174
24665	0	2	183	6	0	191
24666	0	0	183	1	0	184
24667	166	0	6	4	0	176
24668	6	181	1	0	0	188
24669	183	6	1	2	0	192
24670	196	0	0	0	0	196
24671	6	1	1	189	0	197
24672	2	191	0	5	0	198
24673	201	6	1	1	0	209
24674	206	1	0	3	0	210
24675	209	1	0	1	0	211
24676	211	0	1	1	0	213
24677	207	1	0	1	0	209
24678	8	0	202	0	0	210
24679	192	0	7	0	0	199
24680	7	0	196	0	0	203
24681	1	0	7	194	0	202
24682	2	0	0	202	0	204
24683	0	0	192	8	0	200
24684	195	0	6	1	0	202
24685	8	0	0	200	0	208
24686	1	0	2	204	0	207
24687	2	0	0	209	0	211
24688	0	0	1	205	0	206
24689	0	1	0	208	0	209
24690	0	0	198	9	0	207
24691	0	0	7	198	0	205
24692	0	1	196	8	0	205
24693	0	0	199	1	0	200
24694	192	0	8	2	0	202
24695	207	1	1	0	0	209
24696	209	0	4	2	0	215
24697	9	0	209	0	0	218
24698	3	1	219	0	0	223
24699	2	0	221	0	0	223
24700	1	224	9	0	0	234
24701	3	8	0	212	0	223
24702	225	0	0	7	0	232
24703	9	0	0	223	0	232
24704	0	226	0	7	0	233
24705	232	6	0	1	0	239
24706	8	1	1	225	0	235
24707	1	238	0	8	0	247
24708	1	7	0	240	0	248
24709	1	1	1	245	0	248
24710	240	0	1	8	0	249
24711	9	0	0	240	0	249
24712	1	0	238	8	0	247
24713	0	0	7	238	0	245
24714	0	231	1	8	0	240
24715	0	237	1	2	0	240
24716	2	8	1	227	0	238
24717	1	1	0	231	0	233
24718	0	215	1	8	0	224
24719	0	227	1	2	0	230
24720	1	231	0	1	0	233
24721	2	9	0	213	0	224
24722	1	219	1	6	0	227
24723	213	6	1	3	0	223
24724	7	2	218	0	0	227
24725	1	0	8	207	0	216
24726	1	220	1	5	0	227
24727	213	6	0	2	0	221
24728	8	1	215	0	0	224
24729	1	217	6	0	0	224
24730	204	6	2	0	0	212
24731	6	205	1	0	0	212
24732	1	210	1	1	0	213
24733	0	7	1	203	0	211
24734	1	201	0	6	0	208
24735	203	5	0	3	0	211
24736	7	1	0	203	0	211
24737	2	0	206	6	0	214
24738	0	0	204	2	0	206
24739	0	1	4	206	0	211
24740	1	1	220	4	0	226
24741	1	1	4	218	0	224
24742	212	0	1	5	0	218
24743	4	0	218	3	0	225
24744	2	0	5	208	0	215
24745	0	205	1	4	0	210
24746	3	6	1	204	0	214
24747	1	2	0	213	0	216
24748	1	216	2	6	0	225
24749	1	4	1	219	0	225
24750	2	2	1	220	0	225
24751	1	0	222	5	0	228
24752	0	219	4	1	0	224
24753	217	4	2	3	0	226
24754	5	2	2	217	0	226
24755	2	1	224	4	0	231
24756	3	1	5	211	0	220
24757	0	1	222	6	0	229
24758	204	2	4	2	0	212
24759	5	219	1	1	0	226
24760	2	6	0	220	0	228
24761	4	2	0	222	0	228
24762	210	0	0	7	0	217
24763	6	2	1	205	0	214
24764	1	1	206	5	0	213
24765	0	0	4	196	0	200
24766	1	194	2	4	0	201
24767	1	202	0	3	0	206
24768	1	203	1	1	0	206
24769	2	5	2	197	0	206
24770	0	4	193	5	0	202
24771	0	196	4	2	0	202
24772	191	4	2	1	0	198
24773	3	201	0	2	0	206
24774	197	5	0	2	0	204
24775	194	2	1	0	0	197
24776	5	0	190	1	0	196
24777	193	0	4	2	0	199
24778	200	0	1	1	0	202
24779	196	0	1	0	0	197
24780	198	0	1	3	0	202
24781	5	1	203	1	0	210
24782	200	1	3	0	0	204
24783	207	0	1	0	0	208
24784	4	203	1	0	0	208
24785	1	3	0	206	0	210
24786	3	1	0	206	0	210
24787	1	203	0	5	0	209
24788	206	4	0	2	0	212
24789	3	201	0	1	0	205
24790	206	4	0	1	0	211
24791	205	1	0	0	0	206
24792	4	205	1	0	0	210
24793	2	3	0	207	0	212
24794	1	0	206	3	0	210
24795	0	200	3	1	0	204
24796	1	5	1	185	0	192
24797	0	184	0	3	0	187
24798	0	189	0	2	0	191
24799	2	6	0	180	0	188
24800	0	3	188	2	0	193
24801	0	178	2	3	0	183
24802	0	167	3	1	0	171
24803	159	3	2	0	0	164
24804	1	4	0	164	0	169
24805	2	1	0	167	0	170
24806	3	0	1	163	0	167
24807	0	1	161	4	0	166
24808	0	1	1	161	0	163
24809	1	164	2	2	0	169
24810	166	1	1	3	0	171
24811	3	2	0	165	0	170
24812	3	3	161	1	0	168
24813	163	0	1	3	0	167
24814	1	0	1	170	0	172
24815	2	2	180	2	0	186
24816	2	1	172	2	0	177
24817	175	0	3	3	0	181
24818	185	0	4	0	0	189
24819	185	0	1	0	0	186
24820	188	0	0	1	0	189
24821	4	0	188	0	0	192
24822	3	186	3	0	0	192
24823	192	2	2	1	0	197
24824	3	187	1	1	0	192
24825	189	5	0	0	0	194
24826	4	189	0	1	0	194
24827	3	3	1	185	0	192
24828	1	3	0	185	0	189
24829	2	2	0	186	0	190
24830	1	179	1	4	0	185
24831	0	188	0	5	0	193
24832	2	5	0	179	0	186
24833	1	183	0	4	0	188
24834	0	4	185	3	0	192
24835	3	2	3	183	0	191
24836	1	3	185	3	0	192
24837	183	2	3	3	0	191
24838	181	0	3	4	0	188
24839	4	2	182	0	0	188
24840	5	1	172	0	0	178
24841	3	0	4	179	0	186
24842	1	0	185	2	0	188
24843	4	1	4	165	0	174
24844	2	165	3	4	0	174
24845	3	2	2	180	0	187
24846	6	2	1	178	0	187
24847	1	2	0	181	0	184
24848	1	1	180	6	0	188
24849	2	2	3	171	0	178
24850	3	1	3	173	0	180
24851	1	2	1	164	0	168
24852	1	174	0	6	0	181
24853	177	3	0	3	0	183
24854	176	3	2	3	0	184
24855	173	1	0	2	0	176
24856	7	1	1	172	0	181
24857	3	2	175	3	0	183
24858	3	1	170	3	0	177
24859	3	175	5	2	0	185
24860	174	3	3	2	0	182
24861	5	174	2	0	0	181
24862	179	3	1	3	0	186
24863	2	170	5	1	0	178
24864	180	2	1	2	0	185
24865	4	182	1	1	0	188
24866	3	5	1	181	0	190
24867	1	4	181	3	0	189
24868	1	4	179	4	0	188
24869	1	0	5	181	0	187
24870	4	0	3	176	0	183
24871	3	1	2	183	0	189
24872	1	1	179	8	0	189
24873	2	1	3	178	0	184
24874	176	0	4	6	0	186
24875	173	2	3	3	0	181
24876	5	172	1	4	0	182
24877	176	2	1	4	0	183
24878	4	172	4	2	0	182
24879	176	5	0	2	0	183
24880	178	2	0	2	0	182
24881	170	1	3	2	0	176
24882	6	2	161	1	0	170
24883	5	0	151	4	0	160
24884	155	1	7	2	0	165
24885	160	0	3	2	0	165
24886	5	5	0	152	0	162
24887	8	1	0	162	0	171
24888	1	3	2	161	0	167
24889	2	0	1	167	0	170
24890	4	0	2	168	0	174
24891	169	0	0	6	0	175
24892	4	1	2	167	0	174
24893	2	0	169	3	0	174
24894	157	1	3	6	0	167
24895	170	0	4	1	0	175
24896	5	159	2	4	0	170
24897	4	167	2	1	0	174
24898	159	1	0	1	0	161
24899	2	162	1	1	0	166
24900	154	3	0	0	0	157
24901	162	0	0	1	0	163
24902	161	0	1	1	0	163
24903	2	0	2	153	0	157
24904	0	157	0	3	0	160
24905	155	2	0	4	0	161
24906	4	0	0	154	0	158
24907	2	1	1	151	0	155
24908	148	0	0	5	0	153
24909	3	144	1	0	0	148
24910	4	1	0	137	0	142
24911	140	1	0	3	0	144
24912	4	141	0	0	0	145
24913	142	3	0	2	0	147
24914	3	1	135	0	0	139
24915	135	0	2	0	0	137
24916	3	136	0	2	0	141
24917	130	1	0	3	0	134
24918	131	0	0	1	0	132
24919	1	139	1	0	0	141
24920	137	1	0	1	0	139
24921	2	138	0	0	0	140
24922	143	1	0	0	0	144
24923	2	0	0	144	0	146
24924	1	1	1	145	0	148
24925	3	0	0	146	0	149
24926	0	2	144	1	0	147
24927	3	0	1	147	0	151
24928	1	0	146	1	0	148
24929	2	1	1	143	0	147
24930	1	144	0	1	0	146
24931	1	2	0	151	0	154
24932	1	0	149	1	0	151
24933	0	1	150	1	0	152
24934	2	0	1	150	0	153
24935	153	0	0	3	0	156
24936	150	0	1	1	0	152
24937	1	156	0	1	0	158
24938	1	1	1	156	0	159
24939	0	0	163	2	0	165
24940	1	1	1	160	0	163
24941	0	0	164	2	0	166
24942	159	0	2	3	0	164
24943	2	0	1	168	0	171
24944	0	0	168	2	0	170
24945	2	0	1	163	0	166
24946	2	1	0	166	0	169
24947	0	1	162	1	0	164
24948	1	0	1	164	0	166
24949	162	0	1	3	0	166
24950	171	0	0	1	0	172
24951	1	0	1	169	0	171
24952	169	0	0	2	0	171
24953	1	0	170	1	0	172
24954	0	0	171	0	0	171
24955	173	0	1	1	0	175
24956	177	1	0	1	0	179
24957	3	0	1	168	0	172
24958	1	0	0	170	0	171
24959	1	0	169	1	0	171
24960	3	0	1	158	0	162
24961	0	163	0	2	0	165
24962	170	1	0	1	0	172
24963	180	0	1	1	0	182
24964	1	183	1	0	0	185
24965	182	1	0	1	0	184
24966	182	0	0	2	0	184
24967	0	189	0	1	0	190
24968	187	1	0	3	0	191
24969	1	189	0	1	0	191
24970	194	1	0	1	0	196
24971	1	0	192	0	0	193
24972	2	0	1	188	0	191
24973	1	0	0	191	0	192
24974	1	0	0	196	0	197
24975	197	0	0	1	0	198
24976	1	0	0	200	0	201
24977	0	0	200	2	0	202
24978	204	0	2	1	0	207
24979	3	0	0	201	0	204
24980	0	197	1	2	0	200
24981	2	201	0	0	0	203
24982	3	3	0	201	0	207
24983	2	2	0	198	0	202
24984	4	1	0	197	0	202
24985	0	2	198	4	0	204
24986	1	197	2	1	0	201
24987	191	2	1	2	0	196
24988	187	0	1	1	0	189
24989	1	190	0	1	0	192
24990	1	188	0	1	0	190
24991	4	2	0	189	0	195
24992	0	1	190	3	0	194
24993	172	1	3	1	0	177
24994	177	1	2	1	0	181
24995	3	1	1	181	0	186
24996	2	0	0	182	0	184
24997	178	1	0	2	0	181
24998	3	0	176	2	0	181
24999	166	1	2	3	0	172
25000	4	171	0	2	0	177
25001	1	1	3	166	0	171
25002	3	174	1	1	0	179
25003	170	4	0	2	0	176
25004	3	0	0	172	0	175
25005	1	2	0	168	0	171
25006	2	169	0	1	0	172
25007	169	1	1	2	0	173
25008	169	1	1	2	0	173
25009	4	2	164	0	0	170
25010	2	0	154	1	0	157
25011	159	0	1	3	0	163
25012	2	0	159	2	0	163
25013	1	1	147	2	0	151
25014	155	0	1	2	0	158
25015	2	1	164	1	0	168
25016	1	1	3	167	0	172
25017	4	0	1	170	0	175
25018	185	1	2	4	0	192
25019	3	0	186	3	0	192
25020	186	1	3	1	0	191
25021	5	0	2	185	0	192
25022	184	1	2	6	0	193
25023	192	0	0	2	0	194
25024	191	0	2	1	0	194
25025	5	1	1	186	0	193
25026	189	0	1	5	0	195
25027	7	0	0	182	0	189
25028	1	1	2	190	0	194
25029	2	1	1	188	0	192
25030	2	0	0	191	0	193
25031	178	0	2	7	0	187
25032	182	0	0	3	0	185
25033	6	0	176	2	0	184
25034	176	0	3	3	0	182
25035	178	0	2	2	0	182
25036	6	0	1	168	0	175
25037	2	169	3	3	0	177
25038	176	3	0	3	0	182
25039	4	2	0	175	0	181
25040	175	1	1	3	0	180
25041	6	169	1	2	0	178
25042	172	3	1	2	0	178
25043	6	1	0	164	0	171
25044	5	163	0	5	0	173
25045	169	4	0	6	0	179
25046	6	164	0	3	0	173
25047	6	170	1	1	0	178
25048	175	4	1	3	0	183
25049	4	1	167	4	0	176
25050	170	1	3	2	0	176
25051	7	0	2	168	0	177
25052	4	0	169	7	0	180
25053	7	1	3	162	0	173
25054	6	0	3	171	0	180
25055	1	0	178	7	0	186
25056	182	1	3	4	0	190
25057	7	1	2	180	0	190
25058	4	2	4	175	0	185
25059	5	1	0	180	0	186
25060	174	1	0	13	0	188
25061	7	1	180	4	0	192
25062	3	2	182	3	0	190
25063	5	0	4	165	0	174
25064	3	0	163	5	0	171
25065	156	2	4	2	0	164
25066	7	155	1	3	0	166
25067	157	3	0	3	0	163
25068	3	3	0	154	0	160
25069	4	159	1	4	0	168
25070	4	5	1	156	0	166
25071	2	166	2	4	0	174
25072	3	3	1	166	0	173
25073	0	2	164	5	0	171
25074	3	1	156	2	0	162
25075	0	155	3	6	0	164
25076	150	6	3	1	0	160
25077	7	1	1	145	0	154
25078	3	1	0	149	0	153
25079	150	2	1	6	0	159
25080	154	0	0	3	0	157
25081	5	1	2	145	0	153
25082	4	0	149	4	0	157
25083	0	149	3	4	0	156
25084	2	2	4	151	0	159
25085	2	2	2	149	0	155
25086	0	150	2	5	0	157
25087	151	2	2	0	0	155
25088	4	2	153	0	0	159
25089	3	0	2	147	0	152
25090	0	2	1	148	0	151
25091	1	1	145	5	0	152
25092	3	1	3	147	0	154
25093	146	2	3	5	0	156
25094	142	0	4	4	0	150
25095	145	1	1	2	0	149
25096	3	143	3	1	0	150
25097	153	3	0	1	0	157
25098	4	3	1	147	0	155
25099	5	1	0	142	0	148
25100	2	150	1	6	0	159
25101	169	4	1	2	0	176
25102	174	1	0	4	0	179
25103	172	2	2	4	0	180
25104	171	1	1	2	0	175
25105	171	2	1	2	0	176
25106	5	0	165	0	0	170
25107	166	4	3	2	0	175
25108	171	1	1	2	0	175
25109	168	0	1	4	0	173
25110	5	1	1	163	0	170
25111	6	0	0	164	0	170
25112	2	0	162	5	0	169
25113	148	0	5	5	0	158
25114	3	155	3	3	0	164
25115	2	147	0	0	0	149
25116	1	2	143	2	0	148
25117	1	137	2	0	0	140
25118	0	126	1	0	0	127
25119	4	1	0	115	0	120
25120	0	118	1	1	0	120
25121	117	1	0	3	0	121
25122	115	0	0	2	0	117
25123	1	0	1	109	0	111
25124	0	0	109	2	0	111
25125	104	0	1	0	0	105
25126	2	0	103	0	0	105
25127	1	0	106	0	0	107
25128	0	1	1	101	0	103
25129	1	0	0	107	0	108
25130	1	0	104	2	0	107
25131	0	104	1	1	0	106
25132	0	111	0	0	0	111
25133	112	1	0	1	0	114
25134	118	0	0	1	0	119
25135	2	0	117	0	0	119
25136	113	0	1	0	0	114
25137	123	0	0	0	0	123
25138	2	0	1	123	0	126
25139	2	0	1	125	0	128
25140	4	0	0	122	0	126
25141	129	0	0	2	0	131
25142	129	0	0	2	0	131
25143	130	0	0	2	0	132
25144	1	0	0	137	0	138
25145	1	0	136	1	0	138
25146	134	0	1	0	0	135
25147	133	0	0	0	0	133
25148	1	0	0	133	0	134
25149	0	137	1	1	0	139
25150	2	2	1	131	0	136
25151	1	136	0	1	0	138
25152	2	1	0	133	0	136
25153	0	142	0	1	0	143
25154	139	1	1	3	0	144
25155	1	1	0	140	0	142
25156	0	138	0	2	0	140
25157	0	2	142	0	0	144
25158	136	0	1	1	0	138
25159	2	0	0	141	0	143
25160	0	140	0	1	0	141
25161	0	1	1	136	0	138
25162	1	136	0	1	0	138
25163	0	148	0	1	0	149
25164	143	2	0	2	0	147
25165	148	0	0	2	0	150
25166	1	1	152	0	0	154
25167	144	1	1	1	0	147
25168	147	0	0	1	0	148
25169	1	147	0	0	0	148
25170	0	1	0	146	0	147
25171	2	0	0	147	0	149
25172	0	0	147	1	0	148
25173	0	0	139	0	0	139
25174	145	0	1	1	0	147
25175	146	0	0	1	0	147
25176	147	0	0	1	0	148
25177	1	0	147	0	0	148
25178	0	0	1	145	0	146
25179	143	0	0	2	0	145
25180	3	0	0	141	0	144
25181	1	0	140	1	0	142
25182	134	0	1	0	0	135
25183	1	0	145	0	0	146
25184	0	145	2	0	0	147
25185	146	1	0	1	0	148
25186	1	0	149	0	0	150
25187	1	0	1	144	0	146
25188	145	0	0	1	0	146
25189	2	0	0	143	0	145
25190	146	0	0	1	0	147
25191	2	0	0	143	0	145
25192	144	0	0	5	0	149
25193	147	0	0	0	0	147
25194	146	0	0	0	0	146
25195	139	0	0	0	0	139
25196	2	0	0	133	0	135
25197	0	0	133	1	0	134
25198	0	0	132	0	0	132
25199	0	135	1	0	0	136
25200	0	124	0	1	0	125
25201	97	0	3	1	0	101
25202	0	0	0	93	0	93
25203	0	0	95	0	0	95
25204	0	0	101	0	0	101
25205	0	0	0	107	0	107
25206	106	0	0	1	0	107
25207	0	103	0	1	0	104
25208	110	0	0	3	0	113
25209	0	0	0	113	0	113
25210	0	0	0	112	0	112
25211	0	0	0	106	0	106
25212	0	0	110	0	0	110
25213	0	0	100	0	0	100
25214	0	105	0	0	0	105
25215	0	0	0	107	0	107
25216	104	0	0	1	0	105
25217	0	0	105	0	0	105
25218	0	0	105	0	0	105
25219	1	0	0	107	0	108
25220	1	0	0	106	0	107
25221	0	0	0	108	0	108
25222	1	0	0	116	0	117
25223	125	0	0	1	0	126
25224	2	0	0	125	0	127
25225	123	0	0	6	0	129
25226	1	0	126	0	0	127
25227	0	132	1	0	0	133
25228	0	1	0	130	0	131
25229	1	0	134	1	0	136
25230	1	0	125	0	0	126
25231	0	128	1	0	0	129
25232	0	1	0	129	0	130
25233	0	0	1	126	0	127
25234	0	0	132	1	0	133
25235	127	1	2	0	0	130
25236	2	0	0	132	0	134
25237	0	0	0	132	0	132
25238	0	0	132	2	0	134
25239	1	134	2	0	0	137
25240	0	152	0	1	0	153
25241	151	4	0	2	0	157
25242	4	0	1	154	0	159
25243	158	1	0	5	0	164
25244	5	1	156	0	0	162
25245	1	0	6	152	0	159
25246	156	0	0	7	0	163
25247	164	0	0	1	0	165
25248	5	0	1	151	0	157
25249	0	0	153	6	0	159
25250	2	0	154	0	0	156
25251	2	0	5	153	0	160
25252	1	0	152	5	0	158
25253	139	0	7	1	0	147
25254	5	143	0	0	0	148
25255	145	5	0	3	0	153
25256	151	0	2	0	0	153
25257	6	0	2	143	0	151
25258	1	2	0	148	0	151
25259	147	0	0	6	0	153
25260	8	0	0	147	0	155
25261	0	2	142	6	0	150
25262	2	143	5	1	0	151
25263	2	5	0	139	0	146
25264	0	1	0	142	0	143
25265	1	0	2	143	0	146
25266	2	2	126	5	0	135
25267	0	130	5	2	0	137
25268	1	5	1	132	0	139
25269	0	2	129	6	0	137
25270	3	0	6	125	0	134
25271	124	0	1	7	0	132
25272	5	0	0	128	0	133
25273	1	1	127	5	0	134
25274	118	1	5	3	0	127
25275	5	126	0	2	0	133
25276	0	132	2	2	0	136
25277	131	5	2	1	0	139
25278	6	0	136	1	0	143
25279	0	1	6	138	0	145
25280	0	1	1	144	0	146
25281	2	1	141	5	0	149
25282	1	141	6	0	0	148
25283	1	5	0	130	0	136
25284	1	0	138	5	0	144
25285	1	0	6	139	0	146
25286	138	1	0	8	0	147
25287	6	1	148	3	0	158
25288	0	0	7	147	0	154
25289	2	1	0	155	0	158
25290	2	0	143	7	0	152
25291	4	0	6	133	0	143
25292	1	135	2	8	0	146
25293	1	5	2	137	0	145
25294	1	151	2	5	0	159
25295	149	5	1	4	0	159
25296	151	1	1	4	0	157
25297	5	1	149	2	0	157
25298	2	1	150	1	0	154
25299	2	1	146	2	0	151
25300	1	147	7	2	0	157
25301	3	6	1	148	0	158
25302	3	2	148	6	0	159
25303	2	1	5	141	0	149
25304	2	1	2	146	0	151
25305	0	1	146	8	0	155
25306	1	0	7	143	0	151
25307	1	0	1	148	0	150
25308	0	139	1	11	0	151
25309	0	7	4	146	0	157
25310	3	3	0	151	0	157
25311	1	0	149	11	0	161
25312	0	0	8	146	0	154
25313	2	0	151	10	0	163
25314	1	0	145	3	0	149
25315	145	1	7	5	0	158
25316	6	0	1	152	0	159
25317	2	143	3	6	0	154
25318	1	153	1	2	0	157
25319	2	5	1	145	0	153
25320	2	0	144	8	0	154
25321	1	138	9	2	0	150
25322	3	6	2	130	0	141
25323	1	1	141	9	0	152
25324	0	145	8	0	0	153
25325	145	7	1	1	0	154
25326	147	0	1	4	0	152
25327	153	0	2	3	0	158
25328	6	1	0	156	0	163
25329	1	0	2	155	0	158
25330	0	0	1	159	0	160
25331	0	2	156	7	0	165
25332	151	1	7	2	0	161
25333	8	0	0	157	0	165
25334	2	0	147	5	0	154
25335	154	0	5	4	0	163
25336	151	0	2	5	0	158
25337	5	2	139	3	0	149
25338	149	1	5	4	0	159
25339	5	159	1	0	0	165
25340	1	2	146	1	0	150
25341	142	0	6	2	0	150
25342	2	144	0	0	0	146
25343	1	1	0	138	0	140
25344	0	135	1	1	0	137
25345	4	1	0	132	0	137
25346	1	0	140	1	0	142
25347	125	0	3	1	0	129
25348	3	0	139	0	0	142
25349	0	130	2	0	0	132
25350	0	137	1	0	0	138
25351	131	1	0	0	0	132
25352	1	1	134	0	0	136
25353	0	0	1	132	0	133
25354	0	1	137	1	0	139
25355	0	139	1	1	0	141
25356	1	1	1	134	0	137
25357	1	134	0	1	0	136
25358	139	1	1	2	0	143
25359	138	1	0	1	0	140
25360	139	1	0	1	0	141
25361	2	0	137	0	0	139
25362	0	0	135	0	0	135
25363	128	0	1	3	0	132
25364	1	0	142	1	0	144
25365	1	1	1	132	0	135
25366	0	136	0	1	0	137
25367	141	3	0	2	0	146
25368	141	0	0	0	0	141
25369	138	0	0	1	0	139
25370	3	0	0	141	0	144
25371	1	0	1	143	0	145
25372	139	0	1	2	0	142
25373	3	136	0	0	0	139
25374	137	2	1	1	0	141
25375	2	0	0	140	0	142
25376	0	1	0	139	0	140
25377	137	0	0	2	0	139
25378	3	135	0	0	0	138
25379	133	2	0	1	0	136
25380	2	133	1	1	0	137
25381	129	2	0	3	0	134
25382	3	0	0	143	0	146
25383	146	1	0	2	0	149
25384	152	0	0	0	0	152
25385	162	0	0	0	0	162
25386	4	163	0	1	0	168
25387	1	5	159	0	0	165
25388	156	2	4	2	0	164
25389	164	0	0	0	0	164
25390	4	160	0	1	0	165
25391	2	4	0	157	0	163
25392	2	0	0	164	0	166
25393	159	0	0	6	0	165
25394	6	1	0	161	0	168
25395	1	0	166	5	0	172
25396	1	2	165	0	0	168
25397	165	0	4	0	0	169
25398	5	1	0	163	0	169
25399	1	1	0	166	0	168
25400	0	1	0	168	0	169
25401	1	0	169	4	0	174
25402	3	0	3	159	0	165
25403	2	0	1	169	0	172
25404	3	0	1	173	0	177
25405	169	0	1	8	0	178
25406	7	0	1	169	0	177
25407	1	0	178	7	0	186
25408	185	0	6	3	0	194
25409	7	0	191	1	0	199
25410	186	1	6	4	0	197
25411	195	1	1	4	0	201
25412	12	0	0	189	0	201
25413	2	192	0	11	0	205
25414	2	7	1	194	0	204
25415	4	0	2	198	0	204
25416	2	196	3	8	0	209
25417	201	7	3	0	0	211
25418	10	197	0	2	0	209
25419	199	7	1	5	0	212
25420	204	1	0	4	0	209
25421	8	1	0	201	0	210
25422	1	0	1	209	0	211
25423	0	1	191	10	0	202
25424	1	0	186	3	0	190
25425	182	1	6	4	0	193
25426	198	2	0	1	0	201
25427	9	179	3	1	0	192
25428	3	8	2	182	0	195
25429	2	0	216	9	0	227
25430	2	1	8	213	0	224
25431	217	0	2	8	0	227
25432	221	0	1	1	0	223
25433	7	214	0	1	0	222
25434	1	8	0	210	0	219
25435	2	1	0	222	0	225
25436	1	1	2	218	0	222
25437	5	1	204	7	0	217
25438	189	0	8	1	0	198
25439	205	1	0	2	0	208
25440	12	2	205	0	0	219
25441	2	204	6	4	0	216
25442	204	8	0	8	0	220
25443	211	2	1	4	0	218
25444	8	0	202	2	0	212
25445	3	2	209	0	0	214
25446	8	1	6	206	0	221
25447	3	0	211	7	0	221
25448	204	3	8	2	0	217
25449	216	0	1	2	0	219
25450	221	0	1	3	0	225
25451	9	0	3	208	0	220
25452	3	230	4	5	0	242
25453	239	6	2	0	0	247
25454	238	2	2	5	0	247
25455	10	1	229	3	0	243
25456	2	1	230	3	0	236
25457	223	1	9	3	0	236
25458	11	0	2	234	0	247
25459	2	2	233	8	0	245
25460	4	229	8	1	0	242
25461	6	8	3	231	0	248
25462	229	2	1	10	0	242
25463	9	236	2	2	0	249
25464	3	6	3	233	0	245
25465	1	230	5	10	0	246
25466	1	241	2	3	0	247
25467	1	7	2	241	0	251
25468	4	2	1	246	0	253
25469	4	240	2	7	0	253
25470	245	6	2	1	0	254
25471	9	1	246	2	0	258
25472	243	2	6	2	0	253
25473	8	2	1	247	0	258
25474	6	0	3	243	0	252
25475	2	0	3	248	0	253
25476	2	1	5	249	0	257
25477	6	1	246	7	0	260
25478	4	0	9	240	0	253
25479	4	2	1	252	0	259
25480	3	255	1	7	0	266
25481	1	9	259	4	0	273
25482	2	266	7	3	0	278
25483	2	9	271	2	0	284
25484	3	282	9	0	0	294
25485	1	9	3	264	0	277
25486	259	1	2	9	0	271
25487	7	261	2	2	0	272
25488	3	8	2	261	0	274
25489	1	4	260	8	0	273
25490	2	275	8	3	0	288
25491	267	8	2	2	0	279
25492	272	4	1	2	0	279
25493	9	270	1	1	0	281
25494	3	9	263	2	0	277
25495	253	4	6	1	0	264
25496	9	1	4	265	0	279
25497	267	2	1	10	0	280
25498	6	273	2	4	0	285
25499	5	289	0	0	0	294
25500	3	10	271	2	0	286
25501	279	2	10	3	0	294
25502	14	1	2	276	0	293
25503	284	1	0	8	0	293
25504	4	284	3	3	0	294
25505	283	5	0	4	0	292
25506	280	2	1	5	0	288
25507	8	1	288	1	0	298
25508	2	266	4	1	0	273
25509	2	276	3	1	0	282
25510	3	6	1	253	0	263
25511	1	260	1	2	0	264
25512	263	4	0	4	0	271
25513	5	264	1	0	0	270
25514	1	5	0	264	0	270
25515	2	262	0	3	0	267
25516	2	261	1	2	0	266
25517	0	269	0	1	0	270
25518	2	4	1	257	0	264
25519	2	3	0	261	0	266
25520	1	2	0	262	0	265
25521	2	254	1	5	0	262
25522	2	4	251	3	0	260
25523	2	3	240	1	0	246
25524	240	1	5	3	0	249
25525	3	2	2	251	0	258
25526	2	3	258	3	0	266
25527	1	1	257	2	0	261
25528	2	269	5	1	0	277
25529	2	4	2	249	0	257
25530	2	3	1	253	0	259
25531	254	3	1	6	0	264
25532	4	2	0	252	0	258
25533	3	0	0	258	0	261
25534	1	1	264	7	0	273
25535	1	2	4	267	0	274
25536	1	3	2	279	0	285
25537	1	0	275	7	0	283
25538	1	1	278	2	0	282
25539	2	278	5	1	0	286
25540	0	4	272	2	0	278
25541	2	2	5	268	0	277
25542	4	2	4	217	0	227
25543	1	3	271	6	0	281
25544	0	268	5	4	0	277
25545	252	4	3	5	0	264
25546	4	267	1	2	0	274
25547	2	3	1	270	0	276
25548	1	4	0	273	0	278
25549	3	270	3	6	0	282
25550	0	6	1	266	0	273
25551	2	2	1	268	0	273
25552	1	2	257	7	0	267
25553	0	244	6	4	0	254
25554	3	3	3	250	0	259
25555	0	6	258	4	0	268
25556	1	0	5	254	0	260
25557	1	3	4	258	0	266
25558	4	2	2	261	0	269
25559	3	2	1	255	0	261
25560	4	0	0	256	0	260
25561	0	250	2	7	0	259
25562	245	5	2	9	0	261
25563	5	5	239	3	0	252
25564	223	2	4	7	0	236
25565	5	1	261	3	0	270
25566	3	263	3	2	0	271
25567	0	6	261	0	0	267
25568	1	260	6	2	0	269
25569	1	3	4	243	0	251
25570	2	3	3	241	0	249
25571	2	246	1	6	0	255
25572	0	264	1	4	0	269
25573	262	5	2	4	0	273
25574	273	4	0	4	0	281
25575	273	1	2	3	0	279
25576	282	2	0	2	0	286
25577	10	2	0	277	0	289
25578	4	276	2	7	0	289
25579	284	5	1	4	0	294
25580	5	3	1	272	0	281
25581	267	2	2	5	0	276
25582	264	0	1	6	0	271
25583	4	247	2	0	0	253
25584	3	237	1	0	0	241
25585	0	246	0	0	0	246
25586	1	2	1	237	0	241
25587	0	247	0	2	0	249
25588	246	0	0	2	0	248
25589	244	1	0	1	0	246
25590	243	0	0	0	0	243
25591	247	0	0	1	0	248
25592	249	0	0	0	0	249
25593	1	0	258	0	0	259
25594	258	0	0	1	0	259
25595	0	0	260	0	0	260
25596	249	0	0	1	0	250
25597	0	0	1	257	0	258
25598	1	1	245	0	0	247
25599	0	0	261	1	0	262
25600	0	277	1	2	0	280
25601	275	2	1	1	0	279
25602	277	1	0	2	0	280
25603	2	308	0	0	0	310
25604	5	1	0	354	0	360
25605	367	2	0	4	0	373
25606	4	0	378	3	0	385
25607	5	377	3	0	0	385
25608	365	5	4	2	0	376
25609	5	368	1	2	0	376
25610	8	4	1	358	0	371
25611	1	372	1	5	0	379
25612	2	5	1	366	0	374
25613	1	363	2	4	0	370
25614	0	376	1	2	0	379
25615	360	7	0	3	0	370
25616	375	4	0	5	0	384
25617	8	1	372	2	0	383
25618	4	2	371	2	0	379
25619	2	1	369	1	0	373
25620	3	1	6	377	0	387
25621	2	1	384	4	0	391
25622	1	2	5	372	0	380
25623	2	1	5	372	0	380
25624	1	385	1	8	0	395
25625	381	5	0	8	0	394
25626	4	375	1	1	0	381
25627	3	6	1	392	0	402
25628	2	6	0	377	0	385
25629	2	2	0	377	0	381
25630	5	0	380	7	0	392
25631	1	2	6	387	0	396
25632	2	0	6	382	0	390
25633	5	0	2	388	0	395
25634	0	0	380	8	0	388
25635	0	374	4	5	0	383
25636	368	4	5	5	0	382
25637	363	6	0	5	0	374
25638	9	378	0	2	0	389
25639	4	8	1	377	0	390
25640	2	5	0	384	0	391
25641	1	3	372	9	0	385
25642	1	373	3	7	0	384
25643	6	6	4	372	0	388
25644	1	5	381	7	0	394
25645	2	0	5	378	0	385
25646	3	1	5	374	0	383
25647	0	1	379	10	0	390
25648	2	2	5	379	0	388
25649	5	2	6	364	0	377
25650	3	2	380	10	0	395
25651	5	1	4	386	0	396
25652	2	2	5	375	0	384
25653	2	2	1	396	0	401
25654	1	2	387	9	0	399
25655	6	1	5	377	0	389
25656	367	2	7	11	0	387
25657	363	3	1	15	0	382
25658	8	370	2	6	0	386
25659	370	7	2	9	0	388
25660	5	4	392	5	0	406
25661	4	3	5	393	0	405
25662	0	0	5	394	0	399
25663	4	4	1	397	0	406
25664	378	2	1	11	0	392
25665	6	379	4	4	0	393
25666	5	5	0	365	0	375
25667	0	380	3	9	0	392
25668	365	5	3	10	0	383
25669	4	371	5	2	0	382
25670	357	7	0	11	0	375
25671	8	355	3	2	0	368
25672	3	365	1	2	0	371
25673	2	7	2	360	0	371
25674	3	6	1	355	0	365
25675	5	0	3	360	0	368
25676	2	5	1	356	0	364
25677	2	2	342	12	0	358
25678	2	345	5	7	0	359
25679	2	5	3	337	0	347
25680	1	345	3	7	0	356
25681	1	5	338	10	0	354
25682	3	6	3	330	0	342
25683	3	3	2	356	0	364
25684	2	2	339	9	0	352
25685	4	329	7	3	0	343
25686	3	6	4	327	0	340
25687	4	4	322	8	0	338
25688	0	328	7	6	0	341
25689	3	4	3	322	0	332
25690	2	3	316	10	0	331
25691	1	1	314	7	0	323
25692	3	304	7	2	0	316
25693	0	314	3	3	0	320
25694	3	6	4	313	0	326
25695	2	4	2	331	0	339
25696	0	1	329	15	0	345
25697	311	1	7	9	0	328
25698	315	2	4	6	0	327
25699	10	2	307	5	0	324
25700	6	292	8	4	0	310
25701	1	293	6	3	0	303
25702	0	290	2	3	0	295
25703	3	239	5	2	0	249
25704	5	13	2	209	0	229
25705	1	2	0	231	0	234
25706	1	1	0	227	0	229
25707	1	0	0	232	0	233
25708	0	222	0	10	0	232
25709	1	6	0	225	0	232
25710	0	220	0	9	0	229
25711	0	7	0	225	0	232
25712	218	3	0	9	0	230
25713	6	2	0	219	0	227
25714	2	216	0	9	0	227
25715	2	7	0	221	0	230
25716	2	2	0	227	0	231
25717	2	2	0	228	0	232
25718	220	1	0	11	0	232
25719	8	0	0	223	0	231
25720	2	0	208	10	0	220
25721	3	218	6	3	0	230
25722	1	7	2	225	0	235
25723	3	2	2	233	0	240
25724	5	3	2	232	0	242
25725	228	2	0	14	0	244
25726	8	1	224	7	0	240
25727	3	0	7	215	0	225
25728	4	222	2	9	0	237
25729	1	8	2	226	0	237
25730	209	4	1	11	0	225
25731	8	222	1	5	0	236
25732	5	10	0	214	0	229
25733	3	2	0	224	0	229
25734	3	221	0	10	0	234
25735	1	9	0	224	0	234
25736	2	3	1	233	0	239
25737	1	3	218	10	0	232
25738	0	214	8	8	0	230
25739	216	8	1	5	0	230
25740	9	2	215	3	0	229
25741	205	2	9	3	0	219
25742	10	3	219	0	0	232
25743	6	0	10	214	0	230
25744	223	1	4	9	0	237
25745	11	0	1	224	0	236
25746	217	1	3	11	0	232
25747	224	1	0	7	0	232
25748	219	0	2	5	0	226
25749	10	218	0	4	0	232
25750	9	10	0	209	0	228
25751	6	2	1	223	0	232
25752	5	2	2	219	0	228
25753	0	3	216	11	0	230
25754	0	2	8	222	0	232
25755	218	0	1	16	0	235
25756	228	1	3	6	0	238
25757	12	0	218	3	0	233
25758	219	0	9	3	0	231
25759	227	0	3	3	0	233
25760	12	3	2	203	0	220
25761	206	0	2	10	0	218
25762	216	1	1	3	0	221
25763	15	1	0	206	0	222
25764	208	0	2	12	0	222
25765	211	1	0	6	0	218
25766	16	1	1	198	0	216
25767	5	1	175	13	0	194
25768	199	0	9	5	0	213
25769	12	2	201	2	0	217
25770	4	1	198	4	0	207
25771	5	196	12	1	0	214
25772	4	8	4	193	0	209
25773	5	2	5	195	0	207
25774	2	2	4	196	0	204
25775	4	1	191	12	0	208
25776	3	0	196	10	0	209
25777	3	193	11	7	0	214
25778	4	9	7	184	0	204
25779	3	3	5	200	0	211
25780	2	2	3	202	0	209
25781	3	3	192	13	0	211
25782	1	190	10	8	0	209
25783	3	8	4	187	0	202
25784	4	2	190	11	0	207
25785	2	2	198	3	0	205
25786	188	3	12	3	0	206
25787	192	1	5	3	0	201
25788	200	1	4	3	0	208
25789	14	1	4	182	0	201
25790	8	2	186	11	0	207
25791	6	182	9	4	0	201
25792	2	189	5	8	0	204
25793	2	12	167	3	0	184
25794	2	3	10	150	0	165
25795	2	2	1	144	0	149
25796	3	127	5	8	0	143
25797	4	150	4	0	0	158
25798	137	8	2	4	0	151
25799	145	2	1	3	0	151
25800	140	3	1	3	0	147
25801	136	2	3	2	0	143
25802	133	1	0	1	0	135
25803	9	125	1	1	0	136
25804	4	104	1	1	0	110
25805	4	79	0	0	0	83
25806	79	2	3	2	0	86
25807	3	4	2	69	0	78
25808	1	0	1	67	0	69
25809	68	1	1	1	0	71
25810	3	64	2	0	0	69
25811	0	2	2	66	0	70
25812	1	1	0	67	0	69
25813	2	0	0	66	0	68
25814	61	1	0	5	0	67
25815	2	0	1	66	0	69
25816	1	0	61	2	0	64
25817	56	1	1	2	0	60
25818	3	1	0	61	0	65
25819	1	0	59	4	0	64
25820	0	60	2	3	0	65
25821	1	51	3	0	0	55
25822	50	1	2	2	0	55
25823	48	0	2	2	0	52
25824	0	51	2	0	0	53
25825	0	2	1	50	0	53
25826	57	0	0	2	0	59
25827	3	0	0	59	0	62
25828	1	1	0	60	0	62
25829	0	0	1	64	0	65
25830	0	0	2	61	0	63
25831	0	65	0	1	0	66
25832	0	1	0	63	0	64
25833	2	0	1	61	0	64
25834	0	0	0	65	0	65
25835	0	1	61	1	0	63
25836	0	64	0	0	0	64
25837	0	0	0	62	0	62
25838	0	0	60	0	0	60
25839	0	0	52	0	0	52
25840	1	58	0	0	0	59
25841	59	1	0	0	0	60
25842	1	0	0	55	0	56
25843	57	0	0	1	0	58
25844	0	60	1	0	0	61
25845	0	1	0	62	0	63
25846	62	1	0	0	0	63
25847	61	0	1	0	0	62
25848	0	0	0	61	0	61
25849	0	0	0	62	0	62
25850	0	2	61	0	0	63
25851	0	1	0	57	0	58
25852	1	0	0	62	0	63
25853	62	0	0	1	0	63
25854	1	59	0	0	0	60
25855	0	0	55	0	0	55
25856	47	0	0	1	0	48
25857	0	55	0	0	0	55
25858	0	0	0	58	0	58
25859	58	0	0	0	0	58
25860	0	0	0	54	0	54
25861	0	0	0	57	0	57
25862	0	0	54	0	0	54
25863	0	0	0	56	0	56
25864	56	0	0	0	0	56
25865	0	0	0	59	0	59
25866	58	0	0	0	0	58
25867	0	56	0	0	0	56
25868	0	59	0	0	0	59
25869	0	0	0	57	0	57
25870	0	0	0	57	0	57
25871	56	0	0	0	0	56
25872	0	53	0	0	0	53
25873	57	0	0	0	0	57
25874	55	0	0	0	0	55
25875	0	0	0	55	0	55
25876	55	0	0	1	0	56
25877	0	0	51	0	0	51
25878	0	0	0	54	0	54
25879	0	1	52	0	0	53
25880	0	0	0	52	0	52
25881	52	0	0	1	0	53
25882	50	0	0	3	0	53
25883	0	53	0	0	0	53
25884	0	0	0	51	0	51
25885	0	0	0	51	0	51
25886	0	51	0	0	0	51
25887	0	0	0	53	0	53
25888	0	0	0	49	0	49
25889	0	49	0	0	0	49
25890	48	0	0	2	0	50
25891	50	0	0	1	0	51
25892	0	0	0	51	0	51
25893	0	0	0	51	0	51
25894	0	1	52	0	0	53
25895	1	0	0	48	0	49
25896	1	53	0	0	0	54
25897	46	0	0	1	0	47
25898	1	0	0	51	0	52
25899	1	0	0	50	0	51
25900	49	0	0	3	0	52
25901	0	50	0	0	0	50
25902	0	0	0	51	0	51
25903	0	0	0	48	0	48
25904	0	47	0	1	0	48
25905	47	0	1	1	0	49
25906	0	1	48	0	0	49
25907	0	0	47	1	0	48
25908	0	0	1	52	0	53
25909	0	0	52	0	0	52
25910	50	1	0	0	0	51
25911	1	0	0	51	0	52
25912	0	0	55	1	0	56
25913	0	0	51	0	0	51
25914	0	59	0	0	0	59
25915	56	0	0	1	0	57
25916	0	57	0	0	0	57
25917	62	0	0	1	0	63
25918	61	0	0	2	0	63
25919	0	62	0	1	0	63
25920	60	0	1	1	0	62
25921	61	0	0	1	0	62
25922	0	0	60	1	0	61
25923	1	3	0	55	0	59
25924	0	54	0	0	0	54
25925	0	53	0	0	0	53
25926	0	2	0	47	0	49
25927	44	0	0	1	0	45
25928	0	0	0	45	0	45
25929	0	0	0	42	0	42
25930	0	0	0	42	0	42
25931	0	44	0	1	0	45
25932	0	0	0	50	0	50
25933	0	0	53	1	0	54
25934	48	0	1	0	0	49
25935	57	0	0	0	0	57
25936	1	53	0	1	0	55
25937	53	1	0	1	0	55
25938	1	0	0	57	0	58
25939	0	1	57	2	0	60
25940	55	1	1	1	0	58
25941	1	58	0	0	0	59
25942	0	1	0	59	0	60
25943	63	0	0	1	0	64
25944	1	61	0	1	0	63
25945	1	64	0	0	0	65
25946	61	1	0	1	0	63
25947	1	1	62	0	0	64
25948	60	0	1	1	0	62
25949	1	0	1	63	0	65
25950	1	0	0	64	0	65
25951	1	0	64	1	0	66
25952	0	1	64	0	0	65
25953	1	0	1	66	0	68
25954	0	0	63	2	0	65
25955	0	0	62	0	0	62
25956	1	0	1	61	0	63
25957	0	1	0	67	0	68
25958	65	0	0	3	0	68
25959	2	0	0	66	0	68
25960	66	1	0	1	0	68
25961	1	67	0	0	0	68
25962	1	1	0	66	0	68
25963	0	0	72	1	0	73
25964	71	0	1	0	0	72
25965	74	0	0	1	0	75
25966	73	0	0	1	0	74
25967	74	0	1	0	0	75
25968	73	0	1	0	0	74
25969	1	0	0	73	0	74
25970	0	0	70	1	0	71
25971	0	0	70	0	0	70
25972	0	0	71	1	0	72
25973	68	0	1	2	0	71
25974	72	1	0	0	0	73
25975	1	0	0	71	0	72
25976	1	70	0	2	0	73
25977	0	2	0	70	0	72
25978	1	0	68	2	0	71
25979	0	0	73	0	0	73
25980	64	0	1	1	0	66
25981	2	1	69	0	0	72
25982	1	0	1	66	0	68
25983	71	0	1	1	0	73
25984	67	1	0	0	0	68
25985	75	0	0	1	0	76
25986	72	2	1	1	0	76
25987	2	0	70	0	0	72
25988	71	0	2	0	0	73
25989	2	73	1	0	0	76
25990	3	0	0	71	0	74
25991	0	1	68	2	0	71
25992	0	2	2	69	0	73
25993	2	1	66	2	0	71
25994	2	1	2	68	0	73
25995	1	2	2	69	0	74
25996	4	0	69	1	0	74
25997	1	0	1	68	0	70
25998	69	0	1	3	0	73
25999	2	0	1	68	0	71
26000	2	1	1	70	0	74
26001	68	0	1	5	0	74
26002	3	75	2	0	0	80
26003	80	2	2	1	0	85
26004	1	79	1	2	0	83
26005	86	2	1	1	0	90
26006	2	0	80	2	0	84
26007	2	0	2	75	0	79
26008	2	0	0	78	0	80
26009	77	1	1	3	0	82
26010	1	77	1	1	0	80
26011	0	2	2	75	0	79
26012	0	0	1	79	0	80
26013	1	76	2	2	0	81
26014	76	1	1	2	0	80
26015	1	75	0	1	0	77
26016	2	1	0	77	0	80
26017	2	0	0	76	0	78
26018	1	76	1	1	0	79
26019	75	1	0	1	0	77
26020	1	2	75	0	0	78
26021	68	0	2	2	0	72
26022	2	72	3	0	0	77
26023	1	1	0	73	0	75
26024	71	1	0	3	0	75
26025	2	0	0	73	0	75
26026	2	0	0	71	0	73
26027	75	0	1	1	0	77
26028	2	72	0	1	0	75
26029	0	80	2	0	0	82
26030	79	0	1	2	0	82
26031	1	0	85	0	0	86
26032	1	79	0	0	0	80
26033	0	0	0	76	0	76
26034	1	0	87	0	0	88
26035	0	0	1	84	0	85
26036	87	0	0	2	0	89
26037	1	90	0	0	0	91
26038	1	1	0	85	0	87
26039	0	88	0	1	0	89
26040	90	1	0	0	0	91
26041	93	0	0	0	0	93
26042	1	94	0	0	0	95
26043	1	1	0	88	0	90
26044	1	90	0	1	0	92
26045	89	2	0	1	0	92
26046	91	0	1	2	0	94
26047	1	1	0	91	0	93
26048	2	0	0	92	0	94
26049	1	0	90	2	0	93
26050	86	0	1	1	0	88
26051	1	1	90	1	0	93
26052	0	0	2	84	0	86
26053	89	1	0	2	0	92
26054	2	90	1	0	0	93
26055	87	1	0	3	0	91
26056	2	1	85	0	0	88
26057	82	2	1	1	0	86
26058	2	94	0	0	0	96
26059	91	1	1	1	0	94
26060	3	97	1	0	0	101
26061	2	2	0	97	0	101
26062	2	0	96	2	0	100
26063	0	2	97	0	0	99
26064	1	0	1	93	0	95
26065	0	1	94	1	0	96
26066	1	0	2	94	0	97
26067	2	0	0	93	0	95
26068	0	2	99	1	0	102
26069	94	0	1	0	0	95
26070	101	1	0	2	0	104
26071	4	99	1	0	0	104
26072	99	2	0	1	0	102
26073	4	0	0	101	0	105
26074	0	1	106	2	0	109
26075	2	0	1	99	0	102
26076	1	0	1	107	0	109
26077	105	0	3	2	0	110
26078	1	108	0	3	0	112
26079	1	110	1	1	0	113
26080	2	2	0	111	0	115
26081	1	1	0	111	0	113
26082	0	111	2	1	0	114
26083	3	1	0	111	0	115
26084	1	1	0	108	0	110
26085	1	110	0	1	0	112
26086	109	2	0	1	0	112
26087	2	0	0	108	0	110
26088	0	109	2	2	0	113
26089	1	2	0	109	0	112
26090	106	0	0	7	0	113
26091	3	109	1	0	0	113
26092	110	3	0	3	0	116
26093	109	1	1	2	0	113
26094	2	1	1	107	0	111
26095	111	0	0	4	0	115
26096	115	2	0	0	0	117
26097	112	0	0	2	0	114
26098	108	1	0	1	0	110
26099	4	1	0	109	0	114
26100	2	1	1	107	0	111
26101	2	1	107	4	0	114
26102	1	0	2	109	0	112
26103	1	3	0	110	0	114
26104	2	1	104	3	0	110
26105	98	3	2	1	0	104
26106	5	0	0	108	0	113
26107	1	0	108	5	0	114
26108	99	2	4	2	0	107
26109	6	0	114	2	0	122
26110	1	118	4	1	0	124
26111	3	125	0	1	0	129
26112	5	3	1	129	0	138
26113	0	2	133	8	0	143
26114	141	2	5	3	0	151
26115	152	0	4	1	0	157
26116	9	0	145	1	0	155
26117	143	2	6	3	0	154
26118	154	0	2	0	0	156
26119	9	150	1	0	0	160
26120	147	6	1	4	0	158
26121	8	0	2	150	0	160
26122	1	2	157	5	0	165
26123	4	0	5	152	0	161
26124	1	163	1	7	0	172
26125	3	165	1	2	0	171
26126	164	5	0	3	0	172
26127	163	1	4	3	0	171
26128	169	1	1	1	0	172
26129	9	0	1	159	0	169
26130	1	3	2	156	0	162
26131	5	155	1	4	0	165
26132	158	5	0	7	0	170
26133	5	158	2	2	0	167
26134	142	5	0	1	0	148
26135	5	140	0	0	0	145
26136	139	6	0	0	0	145
26137	144	0	0	1	0	145
26138	5	0	0	132	0	137
26139	1	139	0	4	0	144
26140	1	4	141	1	0	147
26141	134	0	3	2	0	139
26142	5	130	0	0	0	135
26143	1	5	135	0	0	141
26144	0	1	147	0	0	148
26145	2	0	3	136	0	141
26146	1	1	0	141	0	143
26147	1	145	0	4	0	150
26148	157	4	0	1	0	162
26149	3	0	0	155	0	158
26150	0	161	0	4	0	165
26151	0	183	1	0	0	184
26152	2	3	179	0	0	184
26153	0	0	181	0	0	181
26154	165	0	4	1	0	170
26155	4	0	176	0	0	180
26156	3	0	4	175	0	182
26157	0	0	0	184	0	184
26158	0	1	183	5	0	189
26159	2	0	5	175	0	182
26160	1	1	1	176	0	179
26161	174	1	0	6	0	181
26162	183	1	1	2	0	187
26163	5	0	2	171	0	178
26164	1	175	2	3	0	181
26165	1	182	1	0	0	184
26166	183	6	0	1	0	190
26167	4	2	175	3	0	184
26168	0	0	6	177	0	183
26169	182	0	2	4	0	188
26170	181	0	1	2	0	184
26171	7	1	1	176	0	185
26172	3	1	175	5	0	184
26173	3	0	160	1	0	164
26174	161	1	7	5	0	174
26175	173	1	0	1	0	175
26176	7	177	0	1	0	185
26177	1	182	2	1	0	186
26178	179	5	2	2	0	188
26179	188	1	0	1	0	190
26180	9	3	0	193	0	205
26181	3	1	0	198	0	202
26182	2	0	0	200	0	202
26183	194	0	2	5	0	201
26184	9	0	1	193	0	203
26185	1	1	200	7	0	209
26186	196	2	4	1	0	203
26187	6	2	0	197	0	205
26188	2	2	200	4	0	208
26189	195	1	4	0	0	200
26190	195	1	0	2	0	198
26191	5	220	1	1	0	227
26192	2	233	0	1	0	236
26193	3	3	221	2	0	229
26194	221	2	2	4	0	229
26195	4	234	1	1	0	240
26196	1	4	234	0	0	239
26197	223	1	4	1	0	229
26198	3	250	1	1	0	255
26199	0	4	246	0	0	250
26200	232	0	5	3	0	240
26201	5	244	0	2	0	251
26202	0	3	0	242	0	245
26203	241	0	0	4	0	245
26204	2	247	0	1	0	250
26205	1	3	0	248	0	252
26206	244	0	0	5	0	249
26207	3	0	249	0	0	252
26208	0	235	2	0	0	237
26209	0	2	241	0	0	243
26210	1	1	1	230	0	233
26211	0	0	231	2	0	233
26212	0	215	2	0	0	217
26213	0	207	0	0	0	207
26214	0	1	0	207	0	208
26215	0	1	0	203	0	204
26216	1	0	1	200	0	202
26217	0	0	203	2	0	205
26218	0	0	2	199	0	201
26219	201	1	0	2	0	204
26220	197	1	0	1	0	199
26221	1	0	199	1	0	201
26222	0	206	1	1	0	208
26223	203	1	1	2	0	207
26224	1	204	1	1	0	207
26225	207	1	0	1	0	209
26226	209	0	0	1	0	210
26227	2	0	205	1	0	208
26228	0	206	2	0	0	208
26229	1	1	0	206	0	208
26230	1	1	209	1	0	212
26231	193	1	2	3	0	199
26232	3	0	0	206	0	209
26233	1	0	209	2	0	212
26234	201	0	3	1	0	205
26235	3	1	212	1	0	217
26236	0	0	3	212	0	215
26237	226	0	1	4	0	231
26238	3	244	1	2	0	250
26239	1	2	245	1	0	249
26240	239	1	3	2	0	245
26241	247	0	2	3	0	252
26242	4	259	2	1	0	266
26243	3	1	0	267	0	271
26244	1	5	0	263	0	269
26245	259	1	1	4	0	265
26246	3	1	1	258	0	263
26247	6	0	258	2	0	266
26248	3	1	2	247	0	253
26249	249	1	5	4	0	259
26250	2	248	0	5	0	255
26251	5	2	0	240	0	247
26252	1	241	2	2	0	246
26253	246	2	1	7	0	256
26254	3	3	0	264	0	270
26255	6	0	1	262	0	269
26256	2	255	1	6	0	264
26257	0	4	251	4	0	259
26258	1	4	3	250	0	258
26259	2	1	3	259	0	265
26260	3	1	0	261	0	265
26261	0	248	1	6	0	255
26262	0	3	251	4	0	258
26263	1	3	250	0	0	254
26264	244	1	7	2	0	254
26265	256	0	3	4	0	263
26266	6	0	252	2	0	260
26267	248	0	3	1	0	252
26268	4	1	260	1	0	266
26269	248	0	7	2	0	257
26270	5	259	4	2	0	270
26271	267	4	0	2	0	273
26272	5	4	270	1	0	280
26273	4	0	280	2	0	286
26274	2	1	8	288	0	299
26275	304	1	4	6	0	315
26276	9	318	1	6	0	334
26277	3	10	349	1	0	363
26278	3	5	13	341	0	362
26279	4	0	7	367	0	378
26280	345	0	3	22	0	370
26281	365	1	0	7	0	373
26282	23	2	0	345	0	370
26283	356	1	3	13	0	373
26284	12	1	343	7	0	363
26285	9	1	13	335	0	358
26286	6	0	4	354	0	364
26287	348	0	2	20	0	370
26288	350	1	2	9	0	362
26289	22	0	1	339	0	362
26290	341	1	3	15	0	360
26291	14	1	326	8	0	349
26292	7	317	12	3	0	339
26293	4	13	323	3	0	343
26294	6	5	14	326	0	351
26295	322	2	5	17	0	346
26296	14	310	2	8	0	334
26297	7	12	3	317	0	339
26298	3	7	3	310	0	323
26299	2	308	4	15	0	329
26300	5	13	3	313	0	334
26301	3	5	0	322	0	330
26302	6	2	1	321	0	330
26303	4	1	1	324	0	330
26304	7	2	0	319	0	328
26305	2	295	4	21	0	322
26306	4	14	3	304	0	325
26307	7	4	2	311	0	324
26308	3	1	285	24	0	313
26309	4	287	14	11	0	316
26310	8	13	5	295	0	321
26311	2	8	0	316	0	326
26312	5	0	1	309	0	315
26313	2	300	2	23	0	327
26314	4	14	307	8	0	333
26315	4	7	16	304	0	331
26316	1	0	317	21	0	339
26317	3	2	303	11	0	319
26318	2	1	20	305	0	328
26319	301	5	4	20	0	330
26320	15	1	5	306	0	327
26321	5	3	0	317	0	325
26322	1	303	3	19	0	326
26323	3	13	2	320	0	338
26324	3	5	1	333	0	342
26325	2	1	315	23	0	341
26326	2	321	13	11	0	347
26327	2	14	6	327	0	349
26328	312	8	2	19	0	341
26329	11	0	318	14	0	343
26330	9	1	13	322	0	345
26331	5	1	9	334	0	349
26332	318	6	2	22	0	348
26333	14	316	4	11	0	345
26334	308	16	3	8	0	335
26335	14	308	2	8	0	332
26336	6	14	2	310	0	332
26337	301	5	3	20	0	329
26338	17	3	287	11	0	318
26339	8	273	17	5	0	303
26340	4	296	7	4	0	311
26341	266	15	4	8	0	293
26342	17	4	1	257	0	279
26343	7	245	4	18	0	274
26344	5	269	4	8	0	286
26345	6	16	1	265	0	288
26346	6	4	2	275	0	287
26347	260	3	2	16	0	281
26348	13	254	5	8	0	280
26349	6	12	2	259	0	279
26350	2	3	250	21	0	276
26351	8	251	13	6	0	278
26352	3	17	252	7	0	279
26353	6	249	12	8	0	275
26354	3	18	4	234	0	259
26355	3	7	0	233	0	243
26356	2	227	2	17	0	248
26357	4	14	226	9	0	253
26358	231	6	15	8	0	260
26359	17	3	2	238	0	260
26360	6	5	1	248	0	260
26361	1	3	234	21	0	259
26362	6	8	13	231	0	258
26363	1	5	236	17	0	259
26364	2	3	15	236	0	256
26365	1	5	248	18	0	272
26366	3	251	14	10	0	278
26367	1	13	257	10	0	281
26368	4	4	12	256	0	276
26369	249	5	6	15	0	275
26370	13	256	4	7	0	280
26371	4	15	2	256	0	277
26372	0	5	252	16	0	273
26373	0	254	15	9	0	278
26374	4	9	6	222	0	241
26375	2	5	221	10	0	238
26376	2	190	5	6	0	203
26377	152	4	5	2	0	163
26378	146	2	0	3	0	151
26379	1	0	2	141	0	144
26380	140	2	1	2	0	145
26381	1	1	0	146	0	148
26382	1	0	2	141	0	144
26383	1	2	147	1	0	151
26384	2	0	1	144	0	147
26385	3	0	0	150	0	153
26386	149	0	0	4	0	153
26387	145	0	0	2	0	147
26388	1	142	1	3	0	147
26389	0	1	144	3	0	148
26390	0	1	3	142	0	146
26391	1	0	146	3	0	150
26392	134	0	1	2	0	137
26393	3	1	143	0	0	147
26394	3	1	1	138	0	143
26395	0	145	0	2	0	147
26396	0	1	1	140	0	142
26397	1	0	0	141	0	142
26398	0	1	149	1	0	151
26399	3	1	1	140	0	145
26400	144	1	1	2	0	148
26401	143	0	0	3	0	146
26402	142	2	0	3	0	147
26403	147	0	1	2	0	150
26404	0	147	0	3	0	150
26405	1	144	3	1	0	149
26406	1	2	0	135	0	138
26407	3	0	0	142	0	145
26408	3	136	0	2	0	141
26409	2	1	0	138	0	141
26410	2	1	0	141	0	144
26411	0	1	0	141	0	142
26412	0	2	0	135	0	137
26413	3	1	0	137	0	141
26414	138	0	0	3	0	141
26415	1	137	0	1	0	139
26416	0	1	131	3	0	135
26417	0	0	0	132	0	132
26418	1	0	0	132	0	133
26419	3	0	0	129	0	132
26420	128	2	0	3	0	133
26421	3	142	1	0	0	146
26422	2	3	0	142	0	147
26423	0	146	3	1	0	150
26424	1	1	0	146	0	148
26425	1	143	1	3	0	148
26426	0	1	147	3	0	151
26427	3	0	1	151	0	155
26428	0	2	178	2	0	182
26429	0	0	3	179	0	182
26430	2	3	1	189	0	195
26431	189	0	2	6	0	197
26432	192	2	0	2	0	196
26433	190	0	2	1	0	193
26434	185	0	1	3	0	189
26435	189	0	2	2	0	193
26436	6	1	0	180	0	187
26437	1	181	1	5	0	188
26438	3	3	0	178	0	184
26439	1	0	171	8	0	180
26440	173	2	3	1	0	179
26441	181	0	0	3	0	184
26442	6	1	1	175	0	183
26443	2	2	0	176	0	180
26444	3	168	0	5	0	176
26445	1	4	0	175	0	180
26446	1	1	2	172	0	176
26447	2	169	0	4	0	175
26448	2	4	1	170	0	177
26449	162	0	0	10	0	172
26450	5	1	163	3	0	172
26451	159	2	4	5	0	170
26452	5	0	163	2	0	170
26453	1	2	5	156	0	164
26454	3	1	0	156	0	160
26455	0	161	1	5	0	167
26456	1	161	1	1	0	164
26457	3	3	1	157	0	164
26458	3	0	148	3	0	154
26459	147	2	4	1	0	154
26460	7	0	1	147	0	155
26461	0	148	2	6	0	156
26462	2	4	0	152	0	158
26463	2	1	1	148	0	152
26464	1	148	1	6	0	156
26465	2	4	1	140	0	147
26466	4	0	128	6	0	138
26467	2	2	133	1	0	138
26468	2	0	3	124	0	129
26469	1	134	1	3	0	139
26470	0	4	1	132	0	137
26471	130	0	0	7	0	137
26472	137	3	0	1	0	141
26473	130	1	0	3	0	134
26474	4	129	1	2	0	136
26475	2	3	131	1	0	137
26476	128	1	4	0	0	133
26477	132	1	0	4	0	137
26478	2	130	1	3	0	136
26479	2	4	0	130	0	136
26480	131	0	0	6	0	137
26481	134	2	0	1	0	137
26482	131	1	0	1	0	133
26483	6	1	1	125	0	133
26484	130	0	2	3	0	135
26485	7	0	1	126	0	134
26486	3	1	0	128	0	132
26487	126	1	2	4	0	133
26488	3	0	0	130	0	133
26489	126	1	1	5	0	133
26490	6	1	0	128	0	135
26491	3	2	0	130	0	135
26492	129	0	1	6	0	136
26493	4	0	124	3	0	131
26494	3	1	4	127	0	135
26495	2	0	0	130	0	132
26496	4	0	2	126	0	132
26497	2	1	0	125	0	128
26498	3	1	0	123	0	127
26499	1	124	0	6	0	131
26500	1	3	3	124	0	131
26501	4	0	122	3	0	129
26502	4	1	5	121	0	131
26503	2	1	0	127	0	130
26504	2	0	1	130	0	133
26505	1	2	124	5	0	132
26506	1	1	121	3	0	126
26507	121	0	3	4	0	128
26508	123	2	2	1	0	128
26509	3	126	1	2	0	132
26510	1	3	1	126	0	131
26511	1	1	1	138	0	141
26512	3	2	0	135	0	140
26513	131	0	1	7	0	139
26514	136	0	1	4	0	141
26515	5	1	0	135	0	141
26516	2	0	0	139	0	141
26517	6	1	2	136	0	145
26518	1	0	2	141	0	144
26519	135	1	1	5	0	142
26520	4	0	134	3	0	141
26521	2	103	4	4	0	113
26522	2	112	0	2	0	116
26523	92	2	1	2	0	97
26524	4	5	0	92	0	101
26525	0	2	94	4	0	100
26526	2	0	87	1	0	90
26527	1	95	3	2	0	101
26528	63	2	0	0	0	65
26529	1	0	62	1	0	64
26530	45	0	0	0	0	45
26531	1	0	0	48	0	49
26532	1	0	0	52	0	53
26533	0	51	0	1	0	52
26534	1	52	0	0	0	53
26535	53	0	0	1	0	54
26536	54	0	0	1	0	55
26537	1	51	0	0	0	52
26538	0	0	50	1	0	51
26539	1	0	53	0	0	54
26540	0	0	0	57	0	57
26541	57	0	0	2	0	59
26542	1	57	0	0	0	58
26543	0	0	0	62	0	62
26544	61	0	0	1	0	62
26545	0	0	0	62	0	62
26546	0	0	0	64	0	64
26547	61	0	0	1	0	62
26548	0	64	0	0	0	64
26549	0	67	0	0	0	67
26550	0	0	72	0	0	72
26551	0	0	0	69	0	69
26552	1	0	0	71	0	72
26553	0	0	74	0	0	74
26554	59	0	0	0	0	59
26555	66	0	0	0	0	66
26556	0	0	76	0	0	76
26557	61	0	0	2	0	63
26558	0	0	78	0	0	78
26559	0	85	0	0	0	85
26560	0	0	0	89	0	89
26561	0	0	0	93	0	93
26562	93	0	0	1	0	94
26563	96	0	0	0	0	96
26564	91	0	0	0	0	91
26565	92	0	0	0	0	92
26566	93	0	0	0	0	93
26567	0	0	91	0	0	91
26568	0	89	0	0	0	89
26569	0	0	0	91	0	91
26570	0	91	0	0	0	91
26571	0	94	0	0	0	94
26572	0	0	0	94	0	94
26573	0	0	0	95	0	95
26574	0	0	94	0	0	94
26575	86	0	0	0	0	86
26576	94	0	0	0	0	94
26577	0	89	1	0	0	90
26578	95	0	0	2	0	97
26579	100	0	0	1	0	101
26580	0	0	0	102	0	102
26581	0	0	108	0	0	108
26582	0	0	110	0	0	110
26583	103	0	0	0	0	103
26584	110	0	0	0	0	110
26585	0	107	0	0	0	107
26586	1	108	0	0	0	109
26587	0	0	0	118	0	118
26588	117	0	0	1	0	118
26589	1	1	121	0	0	123
26590	1	0	1	116	0	118
26591	120	0	0	3	0	123
26592	121	1	0	1	0	123
26593	1	0	0	133	0	134
26594	132	0	0	4	0	136
26595	1	1	129	0	0	131
26596	0	0	140	0	0	140
26597	1	0	1	138	0	140
26598	2	0	0	145	0	147
26599	0	1	0	145	0	146
26600	0	142	0	0	0	142
26601	0	147	0	0	0	147
26602	0	1	0	149	0	150
26603	154	0	0	3	0	157
26604	1	0	0	150	0	151
26605	1	0	0	152	0	153
26606	0	151	1	1	0	153
26607	0	157	0	0	0	157
26608	0	1	0	152	0	153
26609	0	0	0	154	0	154
26610	150	0	0	2	0	152
26611	1	149	0	0	0	150
26612	149	0	0	1	0	150
26613	1	0	0	150	0	151
26614	0	0	149	1	0	150
26615	0	0	141	0	0	141
26616	140	0	1	0	0	141
26617	1	0	0	151	0	152
26618	0	0	0	152	0	152
26619	0	0	0	151	0	151
26620	0	0	155	1	0	156
26621	1	0	1	156	0	158
26622	0	155	1	1	0	157
26623	0	1	0	155	0	156
26624	0	0	0	157	0	157
26625	0	152	0	1	0	153
26626	0	1	0	156	0	157
26627	149	0	0	3	0	152
26628	1	147	0	0	0	148
26629	155	2	0	1	0	158
26630	153	0	0	6	0	159
26631	2	0	0	157	0	159
26632	1	1	0	149	0	151
26633	4	0	0	157	0	161
26634	2	1	158	1	0	162
26635	0	153	1	2	0	156
26636	0	155	0	2	0	157
26637	0	1	1	157	0	159
26638	157	1	1	1	0	160
26639	1	2	0	145	0	148
26640	0	1	149	2	0	152
26641	1	147	1	1	0	150
26642	1	145	1	1	0	148
26643	142	1	0	4	0	147
26644	147	0	1	0	0	148
26645	1	150	1	0	0	152
26646	152	2	0	1	0	155
26647	3	0	148	0	0	151
26648	1	1	142	0	0	144
26649	148	1	1	0	0	150
26650	151	1	1	0	0	153
26651	2	0	1	148	0	151
26652	149	0	1	1	0	151
26653	3	0	149	0	0	152
26654	1	0	160	1	0	162
26655	3	0	3	171	0	177
26656	2	0	0	195	0	197
26657	0	0	2	203	0	205
26658	2	0	1	200	0	203
26659	1	0	1	224	0	226
26660	0	0	214	14	0	228
26661	1	1	9	211	0	222
26662	214	0	1	12	0	227
26663	9	0	1	207	0	217
26664	204	0	1	12	0	217
26665	12	1	1	205	0	219
26666	213	0	1	11	0	225
26667	224	0	0	5	0	229
26668	13	0	0	215	0	228
26669	3	1	0	227	0	231
26670	220	1	0	12	0	233
26671	220	1	0	5	0	226
26672	10	0	220	4	0	234
26673	6	0	9	215	0	230
26674	5	0	1	232	0	238
26675	220	0	1	15	0	236
26676	229	3	0	5	0	237
26677	10	2	1	218	0	231
26678	5	0	0	235	0	240
26679	5	0	0	233	0	238
26680	1	0	0	225	0	226
26681	2	212	2	13	0	229
26682	2	219	0	4	0	225
26683	3	10	0	213	0	226
26684	3	213	2	10	0	228
26685	2	10	1	217	0	230
26686	2	3	216	12	0	233
26687	4	1	212	2	0	219
26688	3	212	12	3	0	230
26689	1	10	3	216	0	230
26690	1	1	218	13	0	233
26691	3	1	11	207	0	222
26692	1	1	1	229	0	232
26693	214	1	2	13	0	230
26694	9	1	2	219	0	231
26695	2	0	225	13	0	240
26696	2	1	230	4	0	237
26697	2	219	11	4	0	236
26698	2	247	4	3	0	256
26699	245	10	3	8	0	266
26700	10	4	282	2	0	298
26701	1	2	11	285	0	299
26702	282	1	2	16	0	301
26703	285	0	2	8	0	295
26704	12	284	3	4	0	303
26705	4	10	1	290	0	305
26706	4	1	0	307	0	312
26707	3	1	2	304	0	310
26708	289	1	1	18	0	309
26709	11	1	280	7	0	299
26710	4	299	9	6	0	318
26711	7	10	1	294	0	312
26712	2	1	4	306	0	313
26713	0	2	309	16	0	327
26714	3	2	9	302	0	316
26715	5	2	2	309	0	318
26716	4	1	2	317	0	324
26717	3	1	2	307	0	313
26718	0	0	302	20	0	322
26719	5	0	11	301	0	317
26720	5	0	306	14	0	325
26721	2	305	10	3	0	320
26722	1	11	1	309	0	322
26723	1	2	2	322	0	327
26724	0	1	302	18	0	321
26725	2	300	12	4	0	318
26726	2	11	3	301	0	317
26727	0	2	312	12	0	326
26728	1	305	12	5	0	323
26729	1	10	1	315	0	327
26730	2	2	316	10	0	330
26731	2	1	10	307	0	320
26732	5	2	3	299	0	309
26733	4	2	1	315	0	322
26734	305	0	1	17	0	323
26735	7	301	3	4	0	315
26736	296	10	2	5	0	313
26737	11	4	303	3	0	321
26738	318	2	10	10	0	340
26739	338	1	4	4	0	347
26740	10	1	2	340	0	353
26741	344	0	3	14	0	361
26742	353	3	3	4	0	363
26743	362	3	0	2	0	367
26744	14	1	2	359	0	376
26745	3	2	2	361	0	368
26746	2	1	346	15	0	364
26747	3	2	341	5	0	351
26748	328	1	11	4	0	344
26749	12	1	2	333	0	348
26750	2	347	3	13	0	365
26751	350	10	3	8	0	371
26752	11	350	1	3	0	365
26753	4	360	2	1	0	367
26754	2	9	340	2	0	353
26755	2	5	367	2	0	376
26756	3	2	4	361	0	370
26757	1	1	387	5	0	394
26758	1	0	359	2	0	362
26759	333	1	1	2	0	337
26760	366	0	0	2	0	368
26761	2	0	0	365	0	367
26762	1	0	0	360	0	361
26763	1	2	373	2	0	378
26764	0	367	1	1	0	369
26765	0	1	1	364	0	366
26766	387	0	1	7	0	395
26767	1	0	0	393	0	394
26768	0	400	0	3	0	403
26769	0	3	389	1	0	393
26770	0	396	1	2	0	399
26771	399	1	1	4	0	405
26772	392	0	0	3	0	395
26773	1	0	1	387	0	389
26774	0	0	385	1	0	386
26775	1	0	372	1	0	374
26776	0	388	1	1	0	390
26777	0	0	2	368	0	370
26778	0	1	0	391	0	392
26779	0	0	388	1	0	389
26780	1	0	1	379	0	381
26781	0	394	1	0	0	395
26782	1	0	0	405	0	406
26783	0	1	1	398	0	400
26784	0	0	395	1	0	396
26785	1	0	0	369	0	370
26786	374	0	1	7	0	382
26787	2	0	392	1	0	395
26788	2	0	390	0	0	392
26789	1	398	3	0	0	402
26790	2	2	2	394	0	400
26791	1	1	0	410	0	412
26792	1	1	405	4	0	411
26793	362	0	3	3	0	368
26794	5	0	1	408	0	414
26795	2	0	409	3	0	414
26796	3	0	3	383	0	389
26797	1	1	410	4	0	416
26798	1	1	390	3	0	395
26799	0	401	5	1	0	407
26800	0	3	3	378	0	384
26801	0	389	1	5	0	395
26802	375	3	1	3	0	382
26803	4	1	384	0	0	389
26804	1	377	3	1	0	382
26805	0	4	2	382	0	388
26806	370	1	0	10	0	381
26807	1	371	1	3	0	376
26808	3	3	2	374	0	382
26809	2	2	0	375	0	379
26810	0	387	0	5	0	392
26811	382	5	1	4	0	392
26812	5	1	1	420	0	427
26813	4	0	2	425	0	431
26814	0	2	419	6	0	427
26815	0	426	5	4	0	435
26816	2	6	3	434	0	445
26817	1	5	1	476	0	483
26818	1	475	2	9	0	487
26819	1	5	1	473	0	480
26820	1	8	0	469	0	478
26821	3	1	0	476	0	480
26822	1	461	1	12	0	475
26823	450	7	1	7	0	465
26824	6	6	458	3	0	473
26825	423	5	6	5	0	439
26826	6	450	4	2	0	462
26827	5	5	1	455	0	466
26828	1	6	456	7	0	470
26829	2	1	6	454	0	463
26830	2	0	5	455	0	462
26831	2	1	2	461	0	466
26832	0	1	465	11	0	477
26833	1	457	8	6	0	472
26834	0	7	471	2	0	480
26835	1	474	6	2	0	483
26836	0	8	472	1	0	481
26837	5	4	7	466	0	482
26838	465	2	5	9	0	481
26839	5	476	2	5	0	488
26840	4	6	481	3	0	494
26841	2	482	7	2	0	493
26842	0	8	495	0	0	503
26843	4	6	5	459	0	474
26844	4	2	6	468	0	480
26845	0	470	2	11	0	483
26846	0	495	1	5	0	501
26847	500	10	1	3	0	514
26848	12	7	0	502	0	521
26849	5	3	514	10	0	532
26850	2	1	10	504	0	517
26851	1	7	525	10	0	543
26852	4	0	523	6	0	533
26853	1	2	13	509	0	525
26854	5	520	7	8	0	540
26855	514	11	2	7	0	534
26856	10	6	1	515	0	532
26857	7	3	2	497	0	509
26858	0	513	3	17	0	533
26859	501	9	2	15	0	527
26860	509	4	3	9	0	525
26861	12	4	5	487	0	508
26862	7	509	2	11	0	529
26863	4	568	4	8	0	584
26864	559	15	2	4	0	580
26865	8	7	560	5	0	580
26866	540	4	8	10	0	562
26867	563	1	6	6	0	576
26868	546	6	4	8	0	564
26869	14	548	1	5	0	568
26870	7	11	3	562	0	583
26871	559	4	4	13	0	580
26872	568	8	2	5	0	583
26873	11	565	3	8	0	587
26874	573	11	3	7	0	594
26875	13	4	3	579	0	599
26876	10	4	1	582	0	597
26877	3	578	2	15	0	598
26878	4	9	7	584	0	604
26879	3	8	2	590	0	603
26880	2	584	4	15	0	605
26881	3	10	3	566	0	582
26882	1	591	5	13	0	610
26883	583	14	2	7	0	606
26884	593	4	1	3	0	601
26885	9	590	2	4	0	605
26886	8	8	588	4	0	608
26887	0	9	7	575	0	591
26888	3	3	586	9	0	601
26889	2	573	9	7	0	591
26890	2	573	4	9	0	588
26891	557	12	3	2	0	574
26892	7	573	1	3	0	584
26893	10	8	1	556	0	575
26894	3	555	2	6	0	566
26895	4	562	2	3	0	571
26896	552	8	0	6	0	566
26897	13	6	3	547	0	569
26898	5	3	543	7	0	558
26899	3	3	522	6	0	534
26900	3	548	8	3	0	562
26901	535	7	6	5	0	553
26902	7	541	2	2	0	552
26903	10	7	2	557	0	576
26904	561	6	1	12	0	580
26905	12	2	0	559	0	573
26906	4	5	1	562	0	572
26907	3	561	0	14	0	578
26908	6	13	0	563	0	582
26909	4	7	554	11	0	576
26910	515	1	9	10	0	535
26911	9	541	4	5	0	559
26912	2	522	2	3	0	529
26913	511	8	1	4	0	524
26914	13	5	492	2	0	512
26915	467	1	10	6	0	484
26916	6	525	2	4	0	537
26917	0	532	5	2	0	539
26918	2	9	525	2	0	538
26919	0	533	10	1	0	544
26920	5	6	2	478	0	491
26921	4	3	0	507	0	514
26922	2	509	1	7	0	519
26923	1	7	0	510	0	518
26924	506	3	0	10	0	519
26925	8	2	498	3	0	511
26926	492	1	6	1	0	500
26927	505	2	2	5	0	514
26928	496	0	1	3	0	500
26929	7	4	489	1	0	501
26930	7	1	7	481	0	496
26931	1	2	490	7	0	500
26932	461	2	6	7	0	476
26933	458	1	4	8	0	471
26934	9	471	1	4	0	485
26935	3	8	2	458	0	471
26936	4	471	0	8	0	483
26937	5	5	467	2	0	479
26938	4	5	8	459	0	476
26939	458	1	3	12	0	474
26940	459	3	1	7	0	470
26941	10	0	5	434	0	449
26942	4	441	1	8	0	454
26943	3	8	445	3	0	459
26944	4	5	447	0	0	456
26945	409	1	9	6	0	425
26946	7	4	447	1	0	459
26947	3	423	11	2	0	439
26948	4	6	4	425	0	439
26949	4	3	436	6	0	449
26950	1	1	8	418	0	428
26951	1	2	431	8	0	442
26952	403	2	6	4	0	415
26953	8	1	6	420	0	435
26954	2	421	1	9	0	433
26955	2	425	2	1	0	430
26956	6	7	5	418	0	436
26957	3	5	1	410	0	419
26958	2	408	2	9	0	421
26959	0	8	415	1	0	424
26960	2	5	5	413	0	425
26961	2	2	422	9	0	435
26962	2	1	393	4	0	400
26963	352	2	12	3	0	369
26964	10	367	2	3	0	382
26965	372	6	3	2	0	383
26966	10	4	1	346	0	361
26967	4	364	2	8	0	378
26968	2	11	0	373	0	386
26969	8	3	3	354	0	368
26970	3	364	0	10	0	377
26971	2	10	360	3	0	375
26972	7	4	9	356	0	376
26973	360	2	5	12	0	379
26974	7	8	2	352	0	369
26975	10	0	9	343	0	362
26976	2	4	339	12	0	357
26977	6	343	6	3	0	358
26978	5	7	2	346	0	360
26979	4	5	338	11	0	358
26980	0	6	335	5	0	346
26981	325	2	11	5	0	343
26982	6	333	6	7	0	352
26983	323	9	3	0	0	335
26984	8	323	4	4	0	339
26985	7	337	0	4	0	348
26986	327	12	4	2	0	345
26987	9	3	3	304	0	319
26988	4	315	4	7	0	330
26989	6	7	2	323	0	338
26990	325	3	3	5	0	336
26991	7	3	323	6	0	339
26992	3	4	321	4	0	332
26993	311	5	7	3	0	326
26994	10	312	5	2	0	329
26995	4	8	317	2	0	331
26996	5	309	7	0	0	321
26997	8	9	4	303	0	324
26998	2	9	310	5	0	326
26999	2	2	8	313	0	325
27000	3	4	307	7	0	321
27001	286	2	10	8	0	306
27002	8	302	6	2	0	318
27003	276	4	4	4	0	288
27004	3	5	5	266	0	279
27005	5	291	3	7	0	306
27006	283	8	4	2	0	297
27007	268	3	4	6	0	281
27008	8	5	281	4	0	298
27009	6	5	272	3	0	286
27010	246	2	10	4	0	262
27011	7	249	4	4	0	264
27012	3	241	4	3	0	251
27013	8	12	3	227	0	250
27014	3	3	229	7	0	242
27015	1	225	6	4	0	236
27016	1	187	5	2	0	195
27017	5	6	1	100	0	112
27018	107	0	0	5	0	112
27019	107	0	0	0	0	107
27020	113	0	0	0	0	113
27021	5	0	109	0	0	114
27022	106	0	5	0	0	111
27023	112	0	0	1	0	113
27024	115	0	0	0	0	115
27025	6	0	0	106	0	112
27026	0	110	0	5	0	115
27027	110	5	0	0	0	115
27028	5	108	0	0	0	113
27029	0	4	0	104	0	108
27030	0	0	112	5	0	117
27031	0	0	4	111	0	115
27032	2	0	0	114	0	116
27033	0	0	107	4	0	111
27034	0	104	4	0	0	108
27035	0	3	0	99	0	102
27036	96	0	0	4	0	100
27037	4	94	0	0	0	98
27038	93	4	0	0	0	97
27039	4	0	0	92	0	96
27040	0	97	0	4	0	101
27041	97	3	0	0	0	100
27042	4	97	0	0	0	101
27043	0	5	96	0	0	101
27044	94	0	4	2	0	100
27045	107	0	0	0	0	107
27046	5	103	0	0	0	108
27047	0	6	97	0	0	103
27048	0	103	5	0	0	108
27049	3	4	0	87	0	94
27050	3	0	0	106	0	109
27051	1	0	0	112	0	113
27052	0	107	0	6	0	113
27053	2	5	0	107	0	114
27054	0	1	0	112	0	113
27055	108	0	0	6	0	114
27056	6	0	0	106	0	112
27057	2	0	0	112	0	114
27058	106	0	0	7	0	113
27059	5	110	0	1	0	116
27060	110	5	0	0	0	115
27061	115	1	0	0	0	116
27062	117	0	0	1	0	118
27063	7	0	0	105	0	112
27064	2	0	0	117	0	119
27065	1	0	112	6	0	119
27066	0	0	114	1	0	115
27067	1	0	110	0	0	111
27068	98	0	5	0	0	103
27069	5	0	108	0	0	113
27070	1	110	5	0	0	116
27071	1	5	1	114	0	121
27072	0	2	0	118	0	120
27073	0	117	0	6	0	123
27074	0	5	120	1	0	126
27075	1	123	5	0	0	129
27076	122	4	1	0	0	127
27077	6	2	120	0	0	128
27078	1	118	6	0	0	125
27079	0	4	127	0	0	131
27080	1	1	5	125	0	132
27081	0	0	125	6	0	131
27082	2	0	5	116	0	123
27083	120	1	1	5	0	127
27084	5	1	121	2	0	129
27085	1	118	5	1	0	125
27086	120	5	1	0	0	126
27087	5	1	127	1	0	134
27088	1	0	136	1	0	138
27089	2	0	6	125	0	133
27090	1	0	131	4	0	136
27091	126	0	5	2	0	133
27092	6	132	1	0	0	139
27093	2	5	0	131	0	138
27094	0	135	1	6	0	142
27095	135	5	0	2	0	142
27096	5	1	133	0	0	139
27097	1	0	138	0	0	139
27098	1	0	6	131	0	138
27099	3	0	1	136	0	140
27100	0	0	1	139	0	140
27101	0	1	0	141	0	142
27102	0	0	141	7	0	148
27103	0	138	5	2	0	145
27104	0	3	1	129	0	133
27105	0	1	126	2	0	129
27106	0	127	2	1	0	130
27107	122	2	1	1	0	126
27108	4	1	1	121	0	127
27109	120	1	0	3	0	124
27110	2	118	2	1	0	123
27111	119	1	0	1	0	121
27112	2	1	134	0	0	137
27113	2	0	1	128	0	131
27114	1	132	1	1	0	135
27115	0	1	128	1	0	130
27116	0	131	1	0	0	132
27117	3	3	2	99	0	107
27118	127	1	0	1	0	129
27119	1	129	1	1	0	132
27120	125	1	0	2	0	128
27121	1	1	124	0	0	126
27122	2	0	121	0	0	123
27123	128	1	2	0	0	131
27124	1	0	1	129	0	131
27125	2	1	0	127	0	130
27126	1	0	142	2	0	145
27127	0	0	137	1	0	138
27128	0	144	4	0	0	148
27129	142	1	1	2	0	146
27130	136	1	0	2	0	139
27131	2	133	0	1	0	136
27132	1	1	0	133	0	135
27133	136	1	1	1	0	139
27134	1	1	0	134	0	136
27135	139	0	0	2	0	141
27136	133	0	1	2	0	136
27137	145	1	0	1	0	147
27138	3	0	0	141	0	144
27139	1	0	0	147	0	148
27140	141	0	0	2	0	143
27141	138	1	0	2	0	141
27142	142	0	0	0	0	142
27143	2	137	1	0	0	140
27144	138	0	0	0	0	138
27145	0	137	0	0	0	137
27146	137	0	0	0	0	137
27147	0	1	134	0	0	135
27148	126	0	0	1	0	127
27149	0	135	1	0	0	136
27150	0	138	0	0	0	138
27151	145	0	0	0	0	145
27152	0	0	0	145	0	145
27153	0	0	0	149	0	149
27154	0	151	0	0	0	151
27155	1	157	1	0	0	159
27156	162	0	0	1	0	163
27157	1	0	160	0	0	161
27158	0	0	0	166	0	166
27159	170	0	0	3	0	173
27160	1	0	172	0	0	173
27161	0	184	1	0	0	185
27162	202	2	0	2	0	206
27163	3	0	206	0	0	209
27164	1	0	3	208	0	212
27165	0	0	226	4	0	230
27166	208	0	5	1	0	214
27167	3	230	0	1	0	234
27168	241	4	0	1	0	246
27169	240	0	2	1	0	243
27170	4	0	0	235	0	239
27171	241	0	1	5	0	247
27172	4	0	0	242	0	246
27173	0	1	0	246	0	247
27174	2	0	241	3	0	246
27175	0	238	4	0	0	242
27176	2	4	0	244	0	250
27177	2	0	0	245	0	247
27178	1	0	0	245	0	246
27179	2	0	237	3	0	242
27180	0	239	5	0	0	244
27181	3	5	0	237	0	245
27182	2	0	0	244	0	246
27183	2	0	240	4	0	246
27184	3	0	4	223	0	230
27185	238	0	1	5	0	244
27186	4	240	0	0	0	244
27187	239	4	0	1	0	244
27188	5	0	240	0	0	245
27189	0	0	5	237	0	242
27190	235	0	0	6	0	241
27191	239	0	0	1	0	240
27192	4	1	241	0	0	246
27193	2	0	4	232	0	238
27194	1	1	241	3	0	246
27195	224	0	4	5	0	233
27196	5	246	0	0	0	251
27197	252	4	0	0	0	256
27198	251	0	1	0	0	252
27199	4	257	2	1	0	264
27200	262	4	1	2	0	269
27201	6	1	264	0	0	271
27202	259	1	5	2	0	267
27203	5	0	0	258	0	263
27204	1	0	276	4	0	281
27205	0	0	4	270	0	274
27206	0	0	0	273	0	273
27207	3	0	1	271	0	275
27208	2	267	0	4	0	273
27209	273	4	0	3	0	280
27210	4	0	0	272	0	276
27211	1	268	0	3	0	272
27212	0	4	0	266	0	270
27213	0	266	2	4	0	272
27214	0	6	267	0	0	273
27215	3	0	5	271	0	279
27216	2	1	0	264	0	267
27217	0	0	267	4	0	271
27218	251	1	3	2	0	257
27219	5	265	0	0	0	270
27220	0	4	1	266	0	271
27221	1	0	0	257	0	258
27222	0	0	0	260	0	260
27223	0	260	0	4	0	264
27224	258	5	0	1	0	264
27225	5	1	260	0	0	266
27226	0	0	246	1	0	247
27227	3	0	4	249	0	256
27228	1	0	0	261	0	262
27229	255	1	1	5	0	262
27230	6	246	0	1	0	253
27231	0	4	1	253	0	258
27232	256	0	1	6	0	263
27233	6	1	0	255	0	262
27234	250	0	0	7	0	257
27235	5	0	248	0	0	253
27236	0	248	4	1	0	253
27237	255	4	0	0	0	259
27238	6	0	247	0	0	253
27239	237	0	4	4	0	245
27240	5	0	242	0	0	247
27241	241	1	5	1	0	248
27242	5	1	0	249	0	255
27243	251	0	0	6	0	257
27244	6	0	1	248	0	255
27245	2	0	1	248	0	251
27246	243	0	1	8	0	252
27247	5	241	0	1	0	247
27248	2	4	0	242	0	248
27249	248	0	0	5	0	253
27250	256	0	0	1	0	257
27251	5	0	0	248	0	253
27252	0	0	0	250	0	250
27253	254	0	0	7	0	261
27254	6	0	1	250	0	257
27255	1	0	0	253	0	254
27256	244	0	0	8	0	252
27257	6	0	0	238	0	244
27258	1	0	233	4	0	238
27259	206	0	3	3	0	212
27260	4	0	227	0	0	231
27261	2	0	200	0	0	202
27262	193	2	4	1	0	200
27263	2	188	1	0	0	191
27264	0	2	0	190	0	192
27265	0	0	0	180	0	180
27266	0	0	0	184	0	184
27267	1	0	0	187	0	188
27268	178	0	0	8	0	186
27269	191	0	0	4	0	195
27270	202	0	0	0	0	202
27271	8	0	218	0	0	226
27272	3	0	7	233	0	243
27273	2	0	2	242	0	246
27274	0	1	0	237	0	238
27275	0	217	0	12	0	229
27276	1	234	1	4	0	240
27277	232	10	0	3	0	245
27278	9	4	0	239	0	252
27279	4	2	0	254	0	260
27280	1	1	0	260	0	262
27281	1	0	252	13	0	266
27282	1	0	235	5	0	241
27283	235	0	12	4	0	251
27284	262	0	2	3	0	267
27285	14	0	2	250	0	266
27286	6	248	1	9	0	264
27287	3	9	0	253	0	265
27288	3	3	1	255	0	262
27289	0	1	239	15	0	255
27290	237	1	10	8	0	256
27291	11	0	3	263	0	277
27292	4	0	1	265	0	270
27293	253	1	1	18	0	273
27294	12	255	1	5	0	273
27295	256	11	1	4	0	272
27296	11	4	0	249	0	264
27297	6	243	0	13	0	262
27298	249	11	2	5	0	267
27299	12	4	2	249	0	267
27300	251	2	0	11	0	264
27301	248	1	1	6	0	256
27302	250	0	1	5	0	256
27303	16	241	0	2	0	259
27304	6	246	1	2	0	255
27305	2	12	1	238	0	253
27306	1	240	3	10	0	254
27307	249	11	0	5	0	265
27308	14	3	0	250	0	267
27309	249	1	0	16	0	266
27310	257	2	2	5	0	266
27311	18	1	1	247	0	267
27312	9	1	2	258	0	270
27313	254	1	1	17	0	273
27314	265	1	0	10	0	276
27315	275	4	0	6	0	285
27316	281	3	1	7	0	292
27317	290	3	0	4	0	297
27318	21	2	1	275	0	299
27319	12	0	0	282	0	294
27320	3	2	1	296	0	302
27321	273	4	1	21	0	299
27322	17	1	2	272	0	292
27323	6	275	2	16	0	299
27324	8	11	1	284	0	304
27325	276	5	1	17	0	299
27326	278	3	1	8	0	290
27327	17	3	272	5	0	297
27328	6	2	11	270	0	289
27329	6	265	5	14	0	290
27330	272	12	2	7	0	293
27331	16	267	3	5	0	291
27332	8	16	0	283	0	307
27333	283	8	0	20	0	311
27334	296	2	1	9	0	308
27335	20	285	2	5	0	312
27336	12	13	3	283	0	311
27337	6	4	275	20	0	305
27338	274	4	12	8	0	298
27339	22	2	276	5	0	305
27340	280	5	15	3	0	303
27341	290	1	5	6	0	302
27342	24	4	1	273	0	302
27343	288	4	2	17	0	311
27344	293	4	1	14	0	312
27345	300	4	0	7	0	311
27346	24	2	2	287	0	315
27347	290	3	1	18	0	312
27348	21	4	1	291	0	317
27349	15	2	0	297	0	314
27350	8	291	0	24	0	323
27351	9	15	1	285	0	310
27352	5	280	0	18	0	303
27353	273	15	0	11	0	299
27354	281	5	2	4	0	292
27355	25	2	0	270	0	297
27356	13	2	1	280	0	296
27357	271	1	0	23	0	295
27358	18	3	257	10	0	288
27359	269	4	11	8	0	292
27360	23	3	3	259	0	288
27361	9	1	249	17	0	276
27362	249	3	11	6	0	269
27363	268	1	3	9	0	281
27364	18	2	248	8	0	276
27365	260	1	9	8	0	278
27366	18	0	259	4	0	281
27367	11	258	12	3	0	284
27368	259	13	6	6	0	284
27369	262	6	1	6	0	275
27370	15	245	1	2	0	263
27371	8	220	0	2	0	230
27372	200	3	1	5	0	209
27373	201	2	1	1	0	205
27374	8	0	0	207	0	215
27375	3	0	205	5	0	213
27376	2	1	185	2	0	190
27377	200	0	6	1	0	207
27378	4	0	203	3	0	210
27379	196	1	5	0	0	202
27380	5	0	1	199	0	205
27381	1	1	0	200	0	202
27382	0	0	192	5	0	197
27383	188	1	4	1	0	194
27384	5	0	1	197	0	203
27385	2	1	0	209	0	212
27386	202	0	0	5	0	207
27387	204	1	1	2	0	208
27388	209	0	0	1	0	210
27389	5	212	2	0	0	219
27390	1	3	203	0	0	207
27391	198	0	3	2	0	203
27392	205	0	0	3	0	208
27393	4	203	1	0	0	208
27394	200	2	0	1	0	203
27395	4	0	0	200	0	204
27396	1	0	210	4	0	215
27397	211	0	3	1	0	215
27398	221	0	0	3	0	224
27399	226	0	0	1	0	227
27400	217	0	0	3	0	220
27401	3	1	0	222	0	226
27402	1	2	0	217	0	220
27403	217	0	0	4	0	221
27404	5	1	0	215	0	221
27405	1	0	0	220	0	221
27406	1	211	2	2	0	216
27407	1	3	1	218	0	223
27408	1	0	0	215	0	216
27409	2	0	1	219	0	222
27410	1	0	1	218	0	220
27411	1	216	0	4	0	221
27412	0	3	0	217	0	220
27413	0	0	2	210	0	212
27414	2	0	207	3	0	212
27415	1	0	194	1	0	196
27416	0	196	3	1	0	200
27417	242	2	0	0	0	244
27418	4	238	1	0	0	243
27419	1	3	0	255	0	259
27420	1	1	260	4	0	266
27421	273	0	5	1	0	279
27422	6	1	1	279	0	287
27423	274	1	0	4	0	279
27424	274	1	0	2	0	277
27425	5	275	1	0	0	281
27426	274	4	0	4	0	282
27427	3	278	2	1	0	284
27428	3	5	1	270	0	279
27429	3	277	0	5	0	285
27430	1	5	277	1	0	284
27431	3	282	5	0	0	290
27432	1	5	1	274	0	281
27433	267	1	0	5	0	273
27434	3	274	0	1	0	278
27435	5	2	1	272	0	280
27436	0	4	0	280	0	284
27437	0	1	271	6	0	278
27438	4	0	3	262	0	269
27439	2	1	264	4	0	271
27440	256	0	4	6	0	266
27441	6	1	279	2	0	288
27442	2	276	6	1	0	285
27443	2	5	1	272	0	280
27444	2	3	1	271	0	277
27445	1	1	1	277	0	280
27446	272	0	2	8	0	282
27447	5	3	1	263	0	272
27448	2	264	2	7	0	275
27449	259	7	1	3	0	270
27450	5	252	2	5	0	264
27451	4	6	3	255	0	268
27452	257	4	0	7	0	268
27453	4	251	0	7	0	262
27454	5	262	0	6	0	273
27455	259	7	2	2	0	270
27456	266	3	1	3	0	273
27457	8	4	259	0	0	271
27458	264	3	3	2	0	272
27459	6	4	260	3	0	273
27460	2	3	4	266	0	275
27461	4	0	269	7	0	280
27462	3	5	4	271	0	283
27463	2	3	272	8	0	285
27464	3	2	4	264	0	273
27465	4	3	2	279	0	288
27466	270	3	3	11	0	287
27467	9	0	259	4	0	272
27468	250	4	9	0	0	263
27469	5	1	269	9	0	284
27470	5	1	275	2	0	283
27471	3	4	7	268	0	282
27472	270	2	6	8	0	286
27473	6	273	1	7	0	287
27474	270	6	2	6	0	284
27475	267	3	2	6	0	278
27476	8	262	6	3	0	279
27477	271	5	2	5	0	283
27478	7	3	274	2	0	286
27479	7	3	9	270	0	289
27480	269	1	3	12	0	285
27481	9	278	1	3	0	291
27482	6	7	1	274	0	288
27483	4	3	2	268	0	277
27484	9	0	0	269	0	278
27485	5	4	2	276	0	287
27486	272	1	0	11	0	284
27487	276	2	4	2	0	284
27488	270	0	3	4	0	277
27489	272	2	2	3	0	279
27490	9	5	266	2	0	282
27491	264	3	5	5	0	277
27492	276	1	3	5	0	285
27493	9	267	1	2	0	279
27494	4	279	2	5	0	290
27495	8	7	1	268	0	284
27496	7	3	5	274	0	289
27497	5	0	271	11	0	287
27498	6	279	8	3	0	296
27499	3	7	5	271	0	286
27500	3	283	5	7	0	298
27501	6	5	0	288	0	299
27502	4	4	2	284	0	294
27503	3	293	1	11	0	308
27504	3	7	3	298	0	311
27505	6	2	296	9	0	313
27506	3	0	307	4	0	314
27507	293	6	9	3	0	311
27508	299	1	5	7	0	312
27509	8	300	3	3	0	314
27510	300	6	0	9	0	315
27511	13	2	0	304	0	319
27512	296	7	0	6	0	309
27513	10	299	1	4	0	314
27514	8	4	302	2	0	316
27515	292	5	9	3	0	309
27516	11	0	311	4	0	326
27517	8	1	255	0	0	264
27518	2	3	254	3	0	262
27519	4	247	5	1	0	257
27520	226	8	6	3	0	243
27521	217	1	0	8	0	226
27522	8	2	2	215	0	227
27523	5	2	2	213	0	222
27524	3	221	3	6	0	233
27525	223	2	2	5	0	232
27526	6	219	8	0	0	233
27527	5	220	4	1	0	230
27528	221	3	5	1	0	230
27529	5	4	3	219	0	231
27530	5	0	0	220	0	225
27531	2	0	0	219	0	221
27532	0	214	3	6	0	223
27533	213	6	1	1	0	221
27534	4	3	0	210	0	217
27535	2	204	2	4	0	212
27536	0	203	2	1	0	206
27537	3	5	0	199	0	207
27538	1	199	0	5	0	205
27539	1	5	0	202	0	208
27540	193	1	0	7	0	201
27541	1	1	190	4	0	196
27542	2	201	3	0	0	206
27543	2	3	1	206	0	212
27544	1	2	207	2	0	212
27545	192	2	3	4	0	201
27546	5	3	2	201	0	211
27547	203	1	1	6	0	211
27548	200	0	1	5	0	206
27549	1	217	1	1	0	220
27550	217	2	2	2	0	223
27551	219	1	1	1	0	222
27552	215	1	1	1	0	218
27553	4	0	1	215	0	220
27554	2	1	2	203	0	208
27555	1	1	0	208	0	210
27556	1	1	203	4	0	209
27557	2	203	3	1	0	209
27558	196	2	1	6	0	205
27559	1	199	1	2	0	203
27560	2	2	0	197	0	201
27561	1	0	196	3	0	200
27562	181	1	2	1	0	185
27563	3	189	0	1	0	193
27564	0	1	0	188	0	189
27565	0	1	0	189	0	190
27566	0	0	184	1	0	185
27567	0	182	1	1	0	184
27568	1	3	0	178	0	182
27569	0	1	0	184	0	185
27570	1	0	0	175	0	176
27571	165	0	2	4	0	171
27572	2	1	168	0	0	171
27573	0	166	0	1	0	167
27574	165	1	1	2	0	169
27575	1	166	0	1	0	168
27576	0	1	1	166	0	168
27577	1	167	0	1	0	169
27578	164	1	0	2	0	167
27579	162	1	0	1	0	164
27580	1	0	0	165	0	166
27581	2	0	0	164	0	166
27582	0	0	1	174	0	175
27583	0	1	172	2	0	175
27584	1	185	2	1	0	189
27585	1	2	0	212	0	215
27586	0	0	1	217	0	218
27587	0	2	0	215	0	217
27588	3	0	0	213	0	216
27589	1	1	211	9	0	222
27590	0	217	9	2	0	228
27591	1	9	2	219	0	231
27592	2	1	0	237	0	240
27593	0	1	226	10	0	237
27594	2	1	9	217	0	229
27595	0	222	1	11	0	234
27596	0	233	1	2	0	236
27597	1	10	0	222	0	233
27598	0	1	218	10	0	229
27599	194	0	8	4	0	206
27600	9	207	1	1	0	218
27601	2	9	207	1	0	219
27602	1	1	214	0	0	216
27603	0	201	11	0	0	212
27604	0	9	208	1	0	218
27605	2	3	9	195	0	209
27606	192	0	1	10	0	203
27607	194	0	0	1	0	195
27608	200	0	0	0	0	200
27609	200	0	0	1	0	201
27610	10	201	1	0	0	212
27611	202	10	0	4	0	216
27612	9	204	0	1	0	214
27613	1	10	206	1	0	218
27614	0	1	10	200	0	211
27615	0	209	2	9	0	220
27616	3	10	0	204	0	217
27617	191	3	1	12	0	207
27618	9	1	1	194	0	205
27619	1	192	3	10	0	206
27620	199	10	0	6	0	215
27621	10	3	195	2	0	210
27622	4	1	9	191	0	205
27623	1	0	3	208	0	212
27624	197	2	0	11	0	210
27625	10	192	2	2	0	206
27626	2	9	192	3	0	206
27627	2	3	10	194	0	209
27628	1	1	198	11	0	211
27629	1	192	9	2	0	204
27630	1	206	2	1	0	210
27631	198	10	1	2	0	211
27632	10	5	199	0	0	214
27633	194	1	10	3	0	208
27634	11	1	2	199	0	213
27635	1	195	4	10	0	210
27636	198	10	3	3	0	214
27637	9	4	205	3	0	221
27638	7	1	11	199	0	218
27639	1	1	1	214	0	217
27640	4	1	2	211	0	218
27641	5	198	2	7	0	212
27642	189	12	1	4	0	206
27643	12	186	2	3	0	203
27644	1	208	4	2	0	215
27645	4	11	4	203	0	222
27646	204	7	2	12	0	225
27647	211	4	4	4	0	223
27648	215	1	0	5	0	221
27649	13	198	4	1	0	216
27650	7	8	1	199	0	215
27651	5	5	199	9	0	218
27652	4	3	10	197	0	214
27653	4	2	6	197	0	209
27654	3	200	2	11	0	216
27655	200	11	5	4	0	220
27656	11	2	2	203	0	218
27657	3	206	0	11	0	220
27658	205	11	2	3	0	221
27659	15	2	199	3	0	219
27660	194	2	9	4	0	209
27661	11	202	1	3	0	217
27662	204	12	0	2	0	218
27663	210	4	1	3	0	218
27664	11	3	209	1	0	224
27665	205	1	8	6	0	220
27666	11	3	215	2	0	231
27667	3	4	220	3	0	230
27668	212	1	10	2	0	225
27669	223	1	3	4	0	231
27670	11	2	218	4	0	235
27671	4	2	10	222	0	238
27672	5	3	4	217	0	229
27673	6	230	1	12	0	249
27674	233	10	2	3	0	248
27675	247	3	1	2	0	253
27676	13	3	240	2	0	258
27677	239	4	10	2	0	255
27678	254	2	2	2	0	260
27679	10	253	4	2	0	269
27680	6	9	2	250	0	267
27681	0	5	1	253	0	259
27682	5	1	0	251	0	257
27683	236	3	3	11	0	253
27684	12	223	1	2	0	238
27685	4	4	0	189	0	197
27686	0	193	1	3	0	197
27687	6	6	1	175	0	188
27688	2	175	3	3	0	183
27689	2	181	1	2	0	186
27690	170	2	1	4	0	177
27691	168	1	0	1	0	170
27692	2	0	1	159	0	162
27693	0	0	0	165	0	165
27694	1	0	0	164	0	165
27695	1	1	0	162	0	164
27696	1	0	0	162	0	163
27697	0	159	0	1	0	160
27698	0	0	1	160	0	161
27699	1	0	0	162	0	163
27700	161	0	0	1	0	162
27701	1	1	1	159	0	162
27702	0	0	0	158	0	158
27703	0	0	156	2	0	158
27704	0	0	1	153	0	154
27705	2	0	0	155	0	157
27706	0	1	158	1	0	160
27707	0	156	1	1	0	158
27708	1	2	161	0	0	164
27709	0	0	158	0	0	158
27710	0	155	1	0	0	156
27711	152	2	2	3	0	159
27712	156	0	0	1	0	157
27713	3	0	0	150	0	153
27714	149	0	0	2	0	151
27715	1	0	163	1	0	165
27716	0	0	1	160	0	161
27717	0	0	189	2	0	191
27718	0	1	1	190	0	192
27719	1	1	0	196	0	198
27720	0	0	0	200	0	200
27721	199	0	0	6	0	205
27722	3	0	0	202	0	205
27723	195	0	0	5	0	200
27724	194	0	0	5	0	199
27725	2	204	1	0	0	207
27726	204	2	0	3	0	209
27727	2	212	0	1	0	215
27728	0	2	1	212	0	215
27729	0	1	0	210	0	211
27730	0	0	1	212	0	213
27731	0	0	210	2	0	212
27732	0	198	2	0	0	200
27733	2	2	0	202	0	206
27734	2	0	0	200	0	202
27735	0	203	0	4	0	207
27736	207	2	0	1	0	210
27737	2	201	1	0	0	204
27738	192	2	0	3	0	197
27739	2	205	1	1	0	209
27740	0	2	0	206	0	208
27741	0	207	0	3	0	210
27742	208	2	0	3	0	213
27743	208	0	0	2	0	210
27744	210	0	0	3	0	213
27745	212	0	0	0	0	212
27746	3	0	210	0	0	213
27747	209	1	2	0	0	212
27748	213	0	0	2	0	215
27749	209	1	0	3	0	213
27750	2	0	219	1	0	222
27751	213	0	2	3	0	218
27752	2	221	0	1	0	224
27753	226	1	1	2	0	230
27754	1	3	253	0	0	257
27755	249	0	1	1	0	251
27756	259	0	0	2	0	261
27757	1	0	0	262	0	263
27758	0	0	261	1	0	262
27759	254	0	1	2	0	257
27760	1	0	0	269	0	270
27761	2	0	0	275	0	277
27762	1	0	277	1	0	279
27763	254	0	1	1	0	256
27764	280	0	0	1	0	281
27765	0	281	0	0	0	281
27766	0	1	0	289	0	290
27767	0	0	0	285	0	285
27768	0	0	0	286	0	286
27769	0	285	0	0	0	285
27770	283	1	0	4	0	288
27771	1	0	0	287	0	288
27772	0	0	0	289	0	289
27773	273	0	0	3	0	276
27774	277	0	0	2	0	279
27775	2	0	0	280	0	282
27776	3	0	0	275	0	278
27777	0	0	269	1	0	270
27778	242	0	1	3	0	246
27779	0	259	1	1	0	261
27780	2	1	1	268	0	272
27781	2	0	0	273	0	275
27782	1	270	1	1	0	273
27783	1	3	0	275	0	279
27784	290	0	0	5	0	295
27785	5	1	0	325	0	331
27786	0	0	0	326	0	326
27787	3	1	0	328	0	332
27788	1	0	325	8	0	334
27789	3	0	5	325	0	333
27790	1	0	325	9	0	335
27791	2	324	8	2	0	336
27792	1	5	1	332	0	339
27793	1	1	4	328	0	334
27794	0	4	0	337	0	341
27795	1	0	3	339	0	343
27796	2	1	0	344	0	347
27797	325	1	1	11	0	338
27798	5	1	332	6	0	344
27799	1	323	5	6	0	335
27800	3	349	1	2	0	355
27801	0	6	2	346	0	354
27802	4	4	0	345	0	353
27803	0	2	1	344	0	347
27804	2	339	0	9	0	350
27805	1	5	1	337	0	344
27806	0	2	340	9	0	351
27807	0	338	5	3	0	346
27808	1	6	2	340	0	349
27809	333	3	3	10	0	349
27810	4	3	0	338	0	345
27811	1	2	1	340	0	344
27812	5	324	0	8	0	337
27813	1	360	1	6	0	368
27814	2	7	0	360	0	369
27815	1	4	0	359	0	364
27816	1	3	358	8	0	370
27817	2	3	5	339	0	349
27818	2	1	1	353	0	357
27819	2	1	4	348	0	355
27820	2	2	0	351	0	355
27821	335	0	1	20	0	356
27822	351	2	0	11	0	364
27823	6	1	1	353	0	361
27824	4	0	1	360	0	365
27825	349	1	0	12	0	362
27826	6	0	1	361	0	368
27827	3	0	379	9	0	391
27828	4	376	4	4	0	388
27829	3	4	2	387	0	396
27830	1	2	3	395	0	401
27831	383	4	1	10	0	398
27832	6	1	1	390	0	398
27833	1	1	0	399	0	401
27834	392	0	2	15	0	409
27835	5	1	1	397	0	404
27836	2	405	0	10	0	417
27837	3	4	1	417	0	425
27838	5	1	0	429	0	435
27839	2	2	1	424	0	429
27840	2	1	0	430	0	433
27841	1	2	410	10	0	423
27842	0	1	406	10	0	417
27843	3	2	6	418	0	429
27844	3	0	4	406	0	413
27845	0	409	5	8	0	422
27846	1	7	1	404	0	413
27847	0	409	2	10	0	421
27848	404	8	1	7	0	420
27849	5	421	1	6	0	433
27850	3	8	0	439	0	450
27851	4	1	1	448	0	454
27852	1	4	436	7	0	448
27853	409	1	5	7	0	422
27854	409	4	1	3	0	417
27855	6	415	3	5	0	429
27856	6	6	1	410	0	423
27857	2	3	432	8	0	445
27858	2	434	5	5	0	446
27859	432	7	3	8	0	450
27860	433	2	2	3	0	440
27861	7	3	410	3	0	423
27862	416	1	7	3	0	427
27863	10	2	1	411	0	424
27864	2	414	3	7	0	426
27865	416	7	0	5	0	428
27866	10	2	1	410	0	423
27867	417	2	0	9	0	428
27868	433	0	2	5	0	440
27869	9	3	0	428	0	440
27870	3	2	449	7	0	461
27871	433	2	5	5	0	445
27872	452	0	1	8	0	461
27873	443	0	2	9	0	454
27874	8	453	0	2	0	463
27875	5	5	1	449	0	460
27876	5	3	1	451	0	460
27877	3	4	453	6	0	466
27878	2	1	5	434	0	442
27879	1	447	2	9	0	459
27880	444	5	2	4	0	455
27881	5	437	3	4	0	449
27882	1	7	440	1	0	449
27883	2	446	4	3	0	455
27884	0	429	2	2	0	433
27885	3	1	1	384	0	389
27886	378	0	1	5	0	384
27887	376	0	1	3	0	380
27888	363	0	1	1	0	365
27889	1	386	0	1	0	388
27890	0	3	382	1	0	386
27891	365	1	1	0	0	367
27892	376	0	0	2	0	378
27893	1	375	0	0	0	376
27894	379	1	0	1	0	381
27895	2	2	0	372	0	376
27896	0	0	407	2	0	409
27897	405	0	1	6	0	412
27898	421	0	1	1	0	423
27899	422	0	1	0	0	423
27900	3	0	0	409	0	412
27901	2	1	0	418	0	421
27902	2	0	0	436	0	438
27903	0	427	0	3	0	430
27904	2	3	0	441	0	446
27905	3	1	0	469	0	473
27906	1	1	475	6	0	483
27907	0	0	6	474	0	480
27908	2	0	0	473	0	475
27909	0	0	2	475	0	477
27910	0	1	0	468	0	469
27911	1	462	1	8	0	472
27912	1	5	0	467	0	473
27913	2	1	0	460	0	463
27914	452	2	1	8	0	463
27915	5	0	442	5	0	452
27916	2	1	433	3	0	439
27917	426	0	6	2	0	434
27918	443	0	3	1	0	447
27919	5	2	2	415	0	424
27920	3	444	1	6	0	454
27921	440	5	0	6	0	451
27922	6	1	0	430	0	437
27923	1	456	0	6	0	463
27924	455	5	1	8	0	469
27925	7	464	0	2	0	473
27926	454	7	1	3	0	465
27927	442	1	0	5	0	448
27928	6	430	0	1	0	437
27929	5	5	1	436	0	447
27930	3	2	431	6	0	442
27931	2	4	6	421	0	433
27932	428	1	1	8	0	438
27933	5	2	419	2	0	428
27934	2	417	5	4	0	428
27935	4	6	1	404	0	415
27936	0	2	413	4	0	419
27937	2	410	3	2	0	417
27938	406	5	3	5	0	419
27939	4	1	4	419	0	428
27940	5	2	0	412	0	419
27941	6	1	0	408	0	415
27942	1	415	1	9	0	426
27943	413	5	0	8	0	426
27944	5	404	1	4	0	414
27945	1	420	1	1	0	423
27946	420	5	0	3	0	428
27947	422	2	0	3	0	427
27948	5	4	411	2	0	422
27949	399	0	5	3	0	407
27950	392	1	1	3	0	397
27951	5	1	2	392	0	400
27952	1	1	389	6	0	397
27953	2	1	5	380	0	388
27954	385	1	1	8	0	395
27955	6	1	382	2	0	391
27956	3	0	6	401	0	410
27957	4	1	2	431	0	438
27958	2	1	3	463	0	469
27959	455	0	2	15	0	472
27960	10	457	1	3	0	471
27961	456	9	0	8	0	473
27962	14	3	452	4	0	473
27963	8	5	11	433	0	457
27964	4	457	3	10	0	474
27965	461	10	4	5	0	480
27966	14	6	0	455	0	475
27967	4	5	452	10	0	471
27968	7	4	10	446	0	467
27969	435	0	3	15	0	453
27970	10	436	4	4	0	454
27971	4	12	3	393	0	412
27972	5	430	0	10	0	445
27973	422	13	1	6	0	442
27974	415	4	0	9	0	428
27975	12	422	2	3	0	439
27976	416	11	1	8	0	436
27977	18	6	0	388	0	412
27978	2	416	2	11	0	431
27979	416	12	2	6	0	436
27980	424	4	0	5	0	433
27981	15	393	2	2	0	412
27982	7	408	2	2	0	419
27983	404	13	0	2	0	419
27984	17	4	0	400	0	421
27985	399	4	1	12	0	416
27986	14	3	0	396	0	413
27987	8	2	393	12	0	415
27988	9	2	8	393	0	412
27989	394	3	2	15	0	414
27990	14	3	393	3	0	413
27991	4	2	11	390	0	407
27992	10	0	1	403	0	414
27993	3	1	408	13	0	425
27994	383	2	13	7	0	405
27995	12	1	1	409	0	423
27996	4	0	387	12	0	403
27997	360	1	12	4	0	377
27998	13	388	4	4	0	409
27999	2	381	4	4	0	391
28000	2	400	1	2	0	405
28001	3	12	370	3	0	388
28002	7	4	10	356	0	377
28003	1	2	368	11	0	382
28004	3	11	9	323	0	346
28005	0	317	3	9	0	329
28006	0	325	1	4	0	330
28007	2	9	1	314	0	326
28008	307	2	1	10	0	320
28009	8	2	0	316	0	326
28010	2	1	2	318	0	323
28011	2	321	0	10	0	333
28012	315	8	0	4	0	327
28013	8	323	0	2	0	333
28014	3	8	0	322	0	333
28015	5	3	0	323	0	331
28016	2	316	0	9	0	327
28017	2	7	0	320	0	329
28018	315	2	0	14	0	331
28019	10	1	1	324	0	336
28020	1	4	0	319	0	324
28021	3	317	1	10	0	331
28022	3	7	2	320	0	332
28023	311	2	1	13	0	327
28024	321	3	0	3	0	327
28025	318	3	0	3	0	324
28026	13	0	0	311	0	324
28027	3	1	303	9	0	316
28028	6	1	298	3	0	308
28029	3	1	9	305	0	318
28030	302	2	3	11	0	318
28031	8	2	2	305	0	317
28032	306	3	1	9	0	319
28033	12	1	1	310	0	324
28034	6	0	1	312	0	319
28035	309	2	1	13	0	325
28036	11	1	294	4	0	310
28037	294	1	7	3	0	305
28038	9	2	293	4	0	308
28039	7	1	9	288	0	305
28040	294	0	2	10	0	306
28041	11	3	288	2	0	304
28042	2	4	286	2	0	294
28043	283	2	10	2	0	297
28044	11	0	288	2	0	301
28045	2	289	10	3	0	304
28046	5	8	0	309	0	322
28047	321	1	2	13	0	337
28048	9	3	327	3	0	342
28049	331	2	8	3	0	344
28050	341	0	3	4	0	348
28051	340	0	3	2	0	345
28052	338	1	1	6	0	346
28053	10	0	2	336	0	348
28054	5	324	2	7	0	338
28055	312	6	1	8	0	327
28056	7	1	299	1	0	308
28057	1	227	4	2	0	234
28058	196	2	2	0	0	200
28059	2	185	0	1	0	188
28060	0	203	2	0	0	205
28061	3	3	2	197	0	205
28062	3	0	0	203	0	206
28063	2	0	0	201	0	203
28064	197	0	1	8	0	206
28065	209	0	0	2	0	211
28066	3	0	1	214	0	218
28067	2	0	1	230	0	233
28068	2	0	239	2	0	243
28069	231	0	5	3	0	239
28070	239	2	0	0	0	241
28071	4	0	0	241	0	245
28072	4	0	1	246	0	251
28073	1	1	245	2	0	249
28074	4	0	3	234	0	241
28075	3	1	243	3	0	250
28076	1	246	3	0	0	250
28077	1	2	249	2	0	254
28078	0	1	4	241	0	246
28079	0	2	252	4	0	258
28080	2	1	240	0	0	243
28081	237	0	4	3	0	244
28082	3	1	1	253	0	258
28083	1	0	255	4	0	260
28084	236	1	3	2	0	242
28085	3	1	259	1	0	264
28086	0	2	293	1	0	296
28087	1	305	3	3	0	312
28088	3	2	2	305	0	312
28089	1	0	312	2	0	315
28090	3	1	311	0	0	315
28091	2	0	3	314	0	319
28092	1	0	1	314	0	316
28093	1	313	5	4	0	323
28094	3	2	0	314	0	319
28095	317	1	1	6	0	325
28096	308	1	1	3	0	313
28097	315	1	1	7	0	324
28098	3	1	2	313	0	319
28099	1	335	2	3	0	341
28100	341	2	3	1	0	347
28101	1	338	1	2	0	342
28102	0	333	3	2	0	338
28103	2	341	0	3	0	346
28104	346	3	3	6	0	358
28105	3	1	2	341	0	347
28106	8	1	0	342	0	351
28107	2	349	1	4	0	356
28108	343	1	3	7	0	354
28109	3	2	342	1	0	348
28110	3	1	3	339	0	346
28111	337	1	3	6	0	347
28112	1	360	2	1	0	364
28113	374	2	0	8	0	384
28114	3	0	3	385	0	391
28115	1	393	3	3	0	400
28116	1	1	395	4	0	401
28117	392	2	1	3	0	398
28118	6	3	1	402	0	412
28119	418	0	2	6	0	426
28120	6	1	2	402	0	411
28121	4	409	3	3	0	419
28122	6	1	417	1	0	425
28123	2	1	415	5	0	423
28124	2	4	2	415	0	423
28125	426	2	3	5	0	436
28126	420	2	4	6	0	432
28127	3	3	4	429	0	439
28128	2	3	1	425	0	431
28129	432	1	2	5	0	440
28130	4	1	1	433	0	439
28131	434	1	5	3	0	443
28132	2	433	2	3	0	440
28133	432	1	3	4	0	440
28134	2	3	436	2	0	443
28135	6	1	1	439	0	447
28136	7	2	1	442	0	452
28137	1	5	5	445	0	456
28138	5	446	5	3	0	459
28139	5	411	3	6	0	425
28140	1	2	2	456	0	461
28141	1	3	460	3	0	467
28142	2	2	4	437	0	445
28143	3	1	2	457	0	463
28144	2	184	5	269	0	460
28145	443	2	2	8	0	455
28146	1	425	3	7	0	436
28147	2	458	3	2	0	465
28148	4	4	2	451	0	461
28149	2	1	2	455	0	460
28150	4	0	2	443	0	449
28151	4	2	2	448	0	456
28152	437	0	1	9	0	447
28153	3	438	2	3	0	446
28154	440	4	1	5	0	450
28155	451	2	2	5	0	460
28156	6	3	2	435	0	446
28157	3	4	1	437	0	445
28158	437	0	0	9	0	446
28159	428	2	3	4	0	437
28160	3	2	1	434	0	440
28161	3	1	1	431	0	436
28162	2	0	432	3	0	437
28163	2	425	3	1	0	431
28164	2	437	3	2	0	444
28165	423	2	0	3	0	428
28166	5	1	426	3	0	435
28167	2	2	389	1	0	394
28168	359	0	1	2	0	362
28169	385	0	1	2	0	388
28170	1	436	0	0	0	437
28171	0	449	0	0	0	449
28172	0	0	0	454	0	454
28173	474	0	0	5	0	479
28174	473	0	0	2	0	475
28175	476	0	0	2	0	478
28176	0	0	0	469	0	469
28177	2	0	0	470	0	472
28178	0	0	460	1	0	461
28179	0	0	441	1	0	442
28180	0	0	452	0	0	452
28181	0	4	1	452	0	457
28182	453	0	0	2	0	455
28183	1	1	477	0	0	479
28184	3	0	1	471	0	475
28185	0	476	1	1	0	478
28186	1	1	0	470	0	472
28187	0	0	0	473	0	473
28188	0	0	480	1	0	481
28189	1	0	1	472	0	474
28190	487	0	1	3	0	491
28191	2	1	518	1	0	522
28192	6	0	2	504	0	512
28193	0	0	528	2	0	530
28194	0	525	2	4	0	531
28195	0	2	524	0	0	526
28196	7	4	2	492	0	505
28197	3	0	4	524	0	531
28198	1	1	543	5	0	550
28199	3	0	2	521	0	526
28200	1	2	3	511	0	517
28201	0	518	1	6	0	525
28202	1	3	515	2	0	521
28203	0	4	3	505	0	512
28204	0	0	4	510	0	514
28205	0	512	1	5	0	518
28206	0	2	0	527	0	529
28207	520	3	1	8	0	532
28208	5	0	0	528	0	533
28209	3	0	539	5	0	547
28210	523	2	5	8	0	538
28211	565	0	6	10	0	581
28212	16	0	578	4	0	598
28213	559	0	12	4	0	575
28214	12	583	6	0	0	601
28215	7	11	1	593	0	612
28216	3	6	0	654	0	663
28217	1	1	0	649	0	651
28218	1	1	1	666	0	669
28219	6	1	2	657	0	666
28220	637	0	0	34	0	671
28221	19	3	631	8	0	661
28222	605	0	21	6	0	632
28223	20	4	639	5	0	668
28224	7	0	22	628	0	657
28225	623	4	7	25	0	659
28226	20	1	3	619	0	643
28227	7	625	3	22	0	657
28228	643	20	1	16	0	680
28229	24	8	3	660	0	695
28230	8	2	644	24	0	678
28231	631	0	22	10	0	663
28232	20	688	11	3	0	722
28233	7	24	706	5	0	742
28234	11	5	22	690	0	728
28235	7	4	5	687	0	703
28236	2	699	3	26	0	730
28237	6	22	695	10	0	733
28238	4	7	24	690	0	725
28239	2	2	710	30	0	744
28240	10	0	23	693	0	726
28241	7	1	8	709	0	725
28242	3	1	705	34	0	743
28243	7	1	28	703	0	739
28244	10	2	8	632	0	652
28245	8	2	5	743	0	758
28246	7	1	5	750	0	763
28247	694	3	2	40	0	739
28248	26	2	686	11	0	725
28249	701	1	21	19	0	742
28250	24	2	10	741	0	777
28251	12	4	4	760	0	780
28252	4	2	4	763	0	773
28253	2	728	7	35	0	772
28254	736	25	5	13	0	779
28255	29	9	3	748	0	789
28256	12	750	4	23	0	789
28257	9	20	7	761	0	797
28258	771	7	1	36	0	815
28259	775	2	1	16	0	794
28260	766	4	5	9	0	784
28261	26	761	2	13	0	802
28262	12	24	767	6	0	809
28263	755	12	25	9	0	801
28264	791	1	9	12	0	813
28265	29	779	1	9	0	818
28266	779	22	4	13	0	818
28267	779	6	2	13	0	800
28268	789	2	3	15	0	809
28269	37	814	1	8	0	860
28270	10	23	6	805	0	844
28271	823	6	6	30	0	865
28272	854	2	5	19	0	880
28273	834	2	3	14	0	853
28274	850	3	2	15	0	870
28275	39	0	4	820	0	863
28276	13	6	795	29	0	843
28277	10	5	25	800	0	840
28278	11	814	8	24	0	857
28279	9	24	6	845	0	884
28280	10	9	829	28	0	876
28281	806	3	26	13	0	848
28282	35	0	8	833	0	876
28283	824	3	1	32	0	860
28284	849	3	4	18	0	874
28285	39	7	4	850	0	900
28286	14	1	885	31	0	931
28287	9	6	838	12	0	865
28288	797	5	31	7	0	840
28289	29	832	15	3	0	879
28290	11	847	3	10	0	871
28291	10	869	3	9	0	891
28292	7	904	0	8	0	919
28293	864	30	9	7	0	910
28294	880	5	1	8	0	894
28295	875	1	5	7	0	888
28296	872	2	6	8	0	888
28297	33	2	1	841	0	877
28298	7	831	3	24	0	865
28299	823	20	3	11	0	857
28300	28	5	825	7	0	865
28301	10	833	21	5	0	869
28302	4	21	837	8	0	870
28303	815	3	23	11	0	852
28304	854	5	5	7	0	871
28305	858	3	2	7	0	870
28306	34	2	1	832	0	869
28307	10	5	848	23	0	886
28308	11	831	21	8	0	871
28309	817	20	3	4	0	844
28310	25	827	3	2	0	857
28311	7	797	1	4	0	809
28312	4	795	2	6	0	807
28313	4	798	3	6	0	811
28314	8	17	736	1	0	762
28315	11	774	11	1	0	797
28316	704	8	2	6	0	720
28317	11	5	3	699	0	718
28318	7	4	2	702	0	715
28319	693	1	1	12	0	707
28320	9	690	1	5	0	705
28321	3	6	714	4	0	727
28322	9	3	9	698	0	719
28323	8	2	2	711	0	723
28324	8	2	1	706	0	717
28325	6	1	701	8	0	716
28326	2	4	703	6	0	715
28327	4	1	9	692	0	706
28328	5	2	685	5	0	697
28329	6	1	651	1	0	659
28330	577	3	8	8	0	596
28331	8	649	5	1	0	663
28332	4	616	2	2	0	624
28333	2	653	1	2	0	658
28334	7	5	3	627	0	642
28335	4	648	3	2	0	657
28336	653	3	0	5	0	661
28337	4	3	635	2	0	644
28338	640	1	3	5	0	649
28339	12	3	1	644	0	660
28340	5	3	0	636	0	644
28341	2	663	4	6	0	675
28342	659	7	1	5	0	672
28343	658	3	2	8	0	671
28344	12	683	0	4	0	699
28345	6	11	1	675	0	693
28346	4	5	673	10	0	692
28347	9	2	675	4	0	690
28348	1	675	12	3	0	691
28349	668	15	5	8	0	696
28350	13	3	661	0	0	677
28351	7	2	12	646	0	667
28352	651	2	4	19	0	676
28353	672	1	2	7	0	682
28354	17	766	1	4	0	788
28355	4	809	2	2	0	817
28356	793	27	4	4	0	828
28357	24	7	788	1	0	820
28358	777	6	24	2	0	809
28359	811	4	5	4	0	824
28360	32	1	4	783	0	820
28361	10	2	793	19	0	824
28362	7	3	791	5	0	806
28363	755	3	27	5	0	790
28364	25	2	785	1	0	813
28365	726	4	23	1	0	754
28366	776	1	7	6	0	790
28367	31	760	5	1	0	797
28368	18	22	752	0	0	792
28369	7	734	23	1	0	765
28370	719	26	5	6	0	756
28371	22	10	732	2	0	766
28372	16	4	26	682	0	728
28373	9	3	725	20	0	757
28374	9	2	730	6	0	747
28375	8	1	728	5	0	742
28376	4	4	727	5	0	740
28377	2	688	37	1	0	728
28378	2	21	708	0	0	731
28379	5	689	29	2	0	725
28380	5	25	687	1	0	718
28381	683	4	26	4	0	717
28382	26	4	10	650	0	690
28383	6	707	8	21	0	742
28384	696	22	9	5	0	732
28385	709	7	7	3	0	726
28386	667	5	6	9	0	687
28387	683	4	5	7	0	699
28388	29	664	5	6	0	704
28389	663	22	9	5	0	699
28390	699	7	6	2	0	714
28391	28	652	7	2	0	689
28392	8	27	642	3	0	680
28393	11	9	22	629	0	671
28394	11	655	9	18	0	693
28395	7	26	660	6	0	699
28396	6	3	675	3	0	687
28397	8	657	32	3	0	700
28398	8	683	12	4	0	707
28399	6	688	11	3	0	708
28400	13	679	6	3	0	701
28401	666	35	7	4	0	712
28402	684	12	4	9	0	709
28403	39	9	673	1	0	722
28404	13	12	693	2	0	720
28405	21	8	34	666	0	729
28406	15	6	18	674	0	713
28407	13	7	10	696	0	726
28408	667	7	11	38	0	723
28409	31	669	5	14	0	719
28410	14	712	9	8	0	743
28411	8	722	16	6	0	752
28412	686	34	13	3	0	736
28413	711	19	11	3	0	744
28414	42	10	8	676	0	736
28415	698	8	11	30	0	747
28416	716	11	4	13	0	744
28417	53	3	5	691	0	752
28418	693	7	8	26	0	734
28419	36	679	16	8	0	739
28420	16	34	15	686	0	751
28421	17	12	663	33	0	725
28422	12	659	37	12	0	720
28423	13	29	660	13	0	715
28424	18	13	37	598	0	666
28425	13	668	17	25	0	723
28426	17	37	16	653	0	723
28427	17	18	10	673	0	718
28428	21	14	659	31	0	725
28429	14	6	688	14	0	722
28430	17	9	40	646	0	712
28431	15	7	27	644	0	693
28432	12	663	18	34	0	727
28433	623	33	11	26	0	693
28434	36	641	11	7	0	695
28435	19	670	10	5	0	704
28436	12	41	623	10	0	686
28437	6	620	40	5	0	671
28438	9	44	17	552	0	622
28439	7	601	20	28	0	656
28440	10	33	9	578	0	630
28441	7	594	7	31	0	639
28442	573	32	4	18	0	627
28443	35	582	7	14	0	638
28444	19	31	7	487	0	544
28445	11	529	9	21	0	570
28446	512	33	6	14	0	565
28447	512	16	7	15	0	550
28448	29	513	5	4	0	551
28449	497	24	3	5	0	529
28450	27	28	6	458	0	519
28451	18	16	451	19	0	504
28452	12	8	459	14	0	493
28453	3	461	27	9	0	500
28454	291	11	14	6	0	322
28455	291	9	5	5	0	310
28456	16	6	278	4	0	304
28457	11	6	279	4	0	300
28458	259	6	14	4	0	283
28459	284	2	9	4	0	299
28460	19	6	271	1	0	297
28461	251	6	13	4	0	274
28462	12	251	10	3	0	276
28463	10	279	7	2	0	298
28464	7	17	2	269	0	295
28465	3	10	5	271	0	289
28466	264	7	3	15	0	289
28467	271	7	2	9	0	289
28468	280	3	3	6	0	292
28469	18	5	4	265	0	292
28470	13	2	4	270	0	289
28471	9	243	2	18	0	272
28472	5	255	2	12	0	274
28473	7	277	1	6	0	291
28474	5	18	1	254	0	278
28475	6	267	1	8	0	282
28476	2	14	253	9	0	278
28477	232	9	12	5	0	258
28478	14	7	256	2	0	279
28479	8	6	266	3	0	283
28480	233	6	14	3	0	256
28481	13	240	10	3	0	266
28482	254	14	5	6	0	279
28483	254	7	6	3	0	270
28484	19	7	251	3	0	280
28485	15	3	251	1	0	270
28486	8	260	16	3	0	287
28487	8	11	264	0	0	283
28488	8	5	15	252	0	280
28489	11	6	9	234	0	260
28490	2	260	9	14	0	285
28491	5	277	2	7	0	291
28492	266	15	3	6	0	290
28493	289	11	3	3	0	306
28494	18	6	5	287	0	316
28495	11	5	3	293	0	312
28496	295	5	2	15	0	317
28497	293	3	2	14	0	312
28498	14	302	3	9	0	328
28499	294	10	2	6	0	312
28500	14	281	0	4	0	299
28501	12	297	0	2	0	311
28502	293	9	2	4	0	308
28503	292	11	1	6	0	310
28504	15	6	2	301	0	324
28505	307	5	1	6	0	319
28506	12	6	303	6	0	327
28507	7	313	5	5	0	330
28508	315	7	7	5	0	334
28509	9	6	328	4	0	347
28510	8	4	14	286	0	312
28511	5	299	12	4	0	320
28512	4	324	6	3	0	337
28513	323	11	3	2	0	339
28514	13	5	312	2	0	332
28515	311	3	9	2	0	325
28516	12	4	8	313	0	337
28517	9	3	317	5	0	334
28518	312	2	12	4	0	330
28519	6	333	11	3	0	353
28520	8	350	5	2	0	365
28521	356	13	3	5	0	377
28522	360	9	1	6	0	376
28523	367	8	1	6	0	382
28524	14	6	1	360	0	381
28525	11	4	2	363	0	380
28526	13	1	355	9	0	378
28527	10	0	348	8	0	366
28528	5	347	10	9	0	371
28529	5	5	1	342	0	353
28530	337	3	0	7	0	347
28531	6	340	1	0	0	347
28532	4	7	1	339	0	351
28533	337	5	1	7	0	350
28534	6	338	0	2	0	346
28535	5	355	2	1	0	363
28536	5	4	332	2	0	343
28537	336	1	5	5	0	347
28538	352	0	2	4	0	358
28539	8	3	339	1	0	351
28540	318	3	6	1	0	328
28541	6	1	330	1	0	338
28542	2	324	6	1	0	333
28543	1	5	2	323	0	331
28544	319	2	1	5	0	327
28545	4	329	0	1	0	334
28546	2	329	2	1	0	334
28547	325	3	1	3	0	332
28548	3	0	344	2	0	349
28549	326	0	3	2	0	331
28550	2	349	1	0	0	352
28551	0	4	337	0	0	341
28552	327	2	2	1	0	332
28553	340	1	0	0	0	341
28554	6	0	0	336	0	342
28555	4	0	1	344	0	349
28556	2	337	0	3	0	342
28557	0	2	354	2	0	358
28558	0	1	3	353	0	357
28559	0	0	379	5	0	384
28560	1	2	373	0	0	376
28561	1	2	3	377	0	383
28562	2	1	381	4	0	388
28563	3	1	378	0	0	382
28564	3	1	4	361	0	369
28565	2	0	376	5	0	383
28566	333	2	3	1	0	339
28567	3	361	1	0	0	365
28568	1	4	380	0	0	385
28569	3	0	419	0	0	422
28570	6	1	4	393	0	404
28571	424	2	1	5	0	432
28572	434	1	1	1	0	437
28573	426	0	2	2	0	430
28574	423	1	2	4	0	430
28575	6	1	1	416	0	424
28576	1	0	433	3	0	437
28577	424	2	5	3	0	434
28578	436	2	1	1	0	440
28579	427	2	2	5	0	436
28580	4	0	411	2	0	417
28581	383	2	4	0	0	389
28582	5	2	1	439	0	447
28583	1	445	2	3	0	451
28584	2	2	3	440	0	447
28585	2	446	1	3	0	452
28586	441	1	1	6	0	449
28587	4	0	451	1	0	456
28588	4	0	2	437	0	443
28589	1	450	1	4	0	456
28590	1	460	3	2	0	466
28591	458	2	1	4	0	465
28592	455	1	2	3	0	461
28593	6	0	439	3	0	448
28594	438	2	5	5	0	450
28595	8	0	2	451	0	461
28596	0	2	482	4	0	488
28597	1	0	469	3	0	473
28598	3	1	5	466	0	475
28599	488	3	0	11	0	502
28600	8	1	0	494	0	503
28601	6	1	1	500	0	508
28602	4	1	1	494	0	500
28603	4	510	3	3	0	520
28604	5	4	1	512	0	522
28605	489	1	3	9	0	502
28606	8	500	2	1	0	511
28607	7	5	2	509	0	523
28608	502	0	0	9	0	511
28609	5	495	4	3	0	507
28610	3	499	5	2	0	509
28611	7	5	2	504	0	518
28612	477	7	1	11	0	496
28613	8	3	488	4	0	503
28614	2	3	482	5	0	492
28615	467	1	5	8	0	481
28616	494	3	4	6	0	507
28617	5	507	3	7	0	522
28618	8	9	1	497	0	515
28619	5	8	498	6	0	517
28620	2	6	491	4	0	503
28621	8	1	517	6	0	532
28622	3	512	10	2	0	527
28623	2	526	7	3	0	538
28624	519	8	5	7	0	539
28625	13	3	522	3	0	541
28626	499	6	10	5	0	520
28627	520	2	6	11	0	539
28628	11	1	529	6	0	547
28629	9	547	8	4	0	568
28630	5	9	7	528	0	549
28631	1	5	553	12	0	571
28632	7	8	522	4	0	541
28633	500	4	12	9	0	525
28634	6	542	8	4	0	560
28635	9	7	4	532	0	552
28636	11	7	3	513	0	534
28637	5	528	5	8	0	546
28638	3	533	8	5	0	549
28639	4	546	3	5	0	558
28640	6	12	5	545	0	568
28641	574	5	7	11	0	597
28642	19	5	9	563	0	596
28643	8	8	570	14	0	600
28644	13	3	569	8	0	593
28645	11	3	21	561	0	596
28646	1	10	572	11	0	594
28647	5	565	18	9	0	597
28648	3	14	13	589	0	619
28649	627	7	8	17	0	659
28650	619	6	2	10	0	637
28651	17	646	3	9	0	675
28652	645	17	7	8	0	677
28653	668	6	4	10	0	688
28654	661	9	5	5	0	680
28655	26	4	616	1	0	647
28656	626	9	11	6	0	652
28657	19	632	9	8	0	668
28658	9	14	639	3	0	665
28659	7	3	624	8	0	642
28660	4	611	21	3	0	639
28661	606	17	12	2	0	637
28662	17	9	5	595	0	626
28663	8	602	5	12	0	627
28664	600	16	6	9	0	631
28665	21	5	1	607	0	634
28666	626	10	1	12	0	649
28667	24	3	4	619	0	650
28668	9	4	613	21	0	647
28669	9	3	595	6	0	613
28670	10	3	603	4	0	620
28671	8	4	21	573	0	606
28672	10	2	15	595	0	622
28673	9	3	599	18	0	629
28674	9	597	15	8	0	629
28675	604	15	8	9	0	636
28676	587	7	10	6	0	610
28677	21	607	6	1	0	635
28678	16	19	5	602	0	642
28679	8	9	614	21	0	652
28680	598	10	17	6	0	631
28681	22	1	624	9	0	656
28682	9	3	599	2	0	613
28683	9	5	602	2	0	618
28684	562	0	30	3	0	595
28685	18	3	586	6	0	613
28686	5	568	22	6	0	601
28687	6	591	15	3	0	615
28688	1	24	10	572	0	607
28689	10	8	4	577	0	599
28690	8	5	567	26	0	606
28691	543	6	19	13	0	581
28692	577	3	8	13	0	601
28693	24	4	11	563	0	602
28694	584	4	3	20	0	611
28695	23	570	7	6	0	606
28696	556	18	5	6	0	585
28697	23	534	6	5	0	568
28698	10	557	5	2	0	574
28699	540	18	6	5	0	569
28700	535	11	6	5	0	557
28701	569	8	5	4	0	586
28702	568	4	6	8	0	586
28703	31	5	515	4	0	555
28704	519	3	22	3	0	547
28705	30	4	5	513	0	552
28706	4	522	11	19	0	556
28707	523	15	8	9	0	555
28708	21	512	7	9	0	549
28709	522	22	5	2	0	551
28710	23	4	7	512	0	546
28711	10	11	3	532	0	556
28712	10	6	506	19	0	541
28713	11	3	499	9	0	522
28714	6	516	15	8	0	545
28715	499	19	8	2	0	528
28716	22	498	5	4	0	529
28717	10	503	3	3	0	519
28718	13	514	4	2	0	533
28719	10	19	507	4	0	540
28720	7	515	20	2	0	544
28721	483	17	8	1	0	509
28722	472	7	9	5	0	493
28723	19	9	2	460	0	490
28724	7	456	4	18	0	485
28725	7	484	2	7	0	500
28726	14	13	3	465	0	495
28727	6	8	466	14	0	494
28728	7	459	14	4	0	484
28729	9	13	3	452	0	477
28730	437	1	7	20	0	465
28731	442	7	4	5	0	458
28732	18	452	4	4	0	478
28733	453	17	6	2	0	478
28734	456	6	3	4	0	469
28735	23	8	2	434	0	467
28736	9	4	433	11	0	457
28737	6	441	18	3	0	468
28738	5	12	5	442	0	464
28739	7	8	431	10	0	456
28740	8	417	11	5	0	441
28741	380	10	3	5	0	398
28742	391	4	2	4	0	401
28743	11	5	3	375	0	394
28744	6	389	3	8	0	406
28745	4	9	389	3	0	405
28746	8	4	10	380	0	402
28747	3	7	381	10	0	401
28748	5	336	7	3	0	351
28749	6	8	4	287	0	305
28750	281	1	2	6	0	290
28751	7	282	0	2	0	291
28752	277	6	1	3	0	287
28753	276	1	3	1	0	281
28754	6	288	1	0	0	295
28755	3	5	1	285	0	294
28756	7	2	0	280	0	289
28757	1	276	0	7	0	284
28758	2	288	1	0	0	291
28759	3	7	1	263	0	274
28760	1	279	0	8	0	288
28761	275	5	1	1	0	282
28762	265	1	1	4	0	271
28763	5	2	264	2	0	273
28764	2	1	261	0	0	264
28765	257	1	4	3	0	265
28766	265	1	1	2	0	269
28767	2	278	0	1	0	281
28768	277	7	0	4	0	288
28769	280	1	0	4	0	285
28770	5	271	0	2	0	278
28771	274	3	0	4	0	281
28772	2	1	1	327	0	331
28773	5	0	1	333	0	339
28774	0	2	349	5	0	356
28775	2	335	4	1	0	342
28776	0	343	1	2	0	346
28777	323	6	2	4	0	335
28778	330	2	0	2	0	334
28779	323	0	1	6	0	330
28780	334	2	1	1	0	338
28781	5	0	329	0	0	334
28782	3	0	324	1	0	328
28783	1	335	3	2	0	341
28784	0	6	2	332	0	340
28785	1	3	0	335	0	339
28786	1	342	1	6	0	350
28787	1	6	1	331	0	339
28788	332	2	0	6	0	340
28789	6	333	1	3	0	343
28790	4	3	346	1	0	354
28791	2	348	6	0	0	356
28792	342	5	2	3	0	352
28793	5	3	343	1	0	352
28794	335	0	5	4	0	344
28795	348	1	2	3	0	354
28796	6	2	347	1	0	356
28797	2	2	337	2	0	343
28798	3	3	338	0	0	344
28799	315	1	5	3	0	324
28800	6	2	335	0	0	343
28801	4	328	4	0	0	336
28802	320	3	3	4	0	330
28803	4	4	326	0	0	334
28804	304	3	5	2	0	314
28805	5	4	323	1	0	333
28806	4	1	330	3	0	338
28807	5	336	7	1	0	349
28808	3	6	346	1	0	356
28809	6	1	341	1	0	349
28810	3	316	7	1	0	327
28811	335	6	5	3	0	349
28812	6	4	350	0	0	360
28813	7	3	6	332	0	348
28814	3	356	3	3	0	365
28815	357	7	4	5	0	373
28816	361	2	1	5	0	369
28817	10	1	355	2	0	368
28818	4	344	8	1	0	357
28819	1	361	7	0	0	369
28820	3	10	4	336	0	353
28821	5	340	2	5	0	352
28822	7	10	4	318	0	339
28823	7	2	3	342	0	354
28824	5	349	2	6	0	362
28825	5	6	3	336	0	350
28826	3	349	5	7	0	364
28827	4	9	344	2	0	359
28828	8	4	10	335	0	357
28829	4	3	7	346	0	360
28830	4	346	4	6	0	360
28831	4	355	4	2	0	365
28832	12	8	3	327	0	350
28833	8	339	5	6	0	358
28834	336	9	3	6	0	354
28835	11	3	5	326	0	345
28836	4	350	7	6	0	367
28837	340	8	5	4	0	357
28838	8	331	6	3	0	348
28839	3	9	326	3	0	341
28840	7	9	8	314	0	338
28841	327	3	8	10	0	348
28842	10	4	335	6	0	355
28843	6	8	6	319	0	339
28844	3	324	4	11	0	342
28845	2	12	325	3	0	342
28846	4	334	9	3	0	350
28847	329	9	6	4	0	348
28848	334	9	3	1	0	347
28849	12	330	4	3	0	349
28850	333	10	4	5	0	352
28851	10	2	325	4	0	341
28852	2	4	11	326	0	343
28853	9	5	2	309	0	325
28854	5	327	1	10	0	343
28855	347	11	5	6	0	369
28856	363	5	5	4	0	377
28857	8	4	371	5	0	388
28858	358	3	7	5	0	373
28859	371	5	5	1	0	382
28860	375	7	6	2	0	390
28861	11	3	3	363	0	380
28862	10	3	4	354	0	371
28863	5	359	5	7	0	376
28864	352	10	4	7	0	373
28865	348	5	4	7	0	364
28866	12	352	4	1	0	369
28867	4	9	5	331	0	349
28868	2	339	2	8	0	351
28869	7	348	0	2	0	357
28870	347	8	2	2	0	359
28871	9	2	339	2	0	352
28872	2	1	267	2	0	272
28873	1	271	6	1	0	279
28874	249	6	2	3	0	260
28875	6	2	248	1	0	257
28876	1	233	6	2	0	242
28877	228	5	0	2	0	235
28878	6	0	228	0	0	234
28879	0	1	6	225	0	232
28880	245	0	0	7	0	252
28881	5	1	242	0	0	248
28882	1	1	262	0	0	264
28883	0	0	268	0	0	268
28884	0	0	271	0	0	271
28885	253	1	6	4	0	264
28886	275	0	0	1	0	276
28887	5	272	1	0	0	278
28888	0	6	0	291	0	297
28889	0	0	0	295	0	295
28890	0	283	1	6	0	290
28891	0	6	0	296	0	302
28892	0	296	0	6	0	302
28893	0	307	1	0	0	308
28894	3	7	0	300	0	310
28895	0	1	309	7	0	317
28896	0	307	7	0	0	314
28897	0	7	0	305	0	312
28898	306	0	0	6	0	312
28899	7	0	302	2	0	311
28900	300	0	7	3	0	310
28901	304	0	0	1	0	305
28902	8	0	0	309	0	317
28903	0	0	312	7	0	319
28904	0	0	324	0	0	324
28905	1	350	9	0	0	360
28906	1	12	0	330	0	343
28907	1	0	340	9	0	350
28908	0	1	334	0	0	335
28909	0	342	9	0	0	351
28910	342	9	0	4	0	355
28911	357	0	1	0	0	358
28912	11	1	0	354	0	366
28913	0	0	371	13	0	384
28914	1	0	371	1	0	373
28915	0	382	12	4	0	398
28916	2	9	391	0	0	402
28917	2	1	390	0	0	393
28918	3	1	13	374	0	391
28919	1	0	390	10	0	401
28920	366	0	12	4	0	382
28921	10	1	2	395	0	408
28922	1	0	405	11	0	417
28923	1	396	12	2	0	411
28924	2	10	2	407	0	421
28925	1	3	406	10	0	420
28926	1	421	10	2	0	434
28927	0	11	2	398	0	411
28928	0	418	1	10	0	429
28929	1	12	2	420	0	435
28930	4	3	2	423	0	432
28931	1	2	420	13	0	436
28932	2	424	12	3	0	441
28933	1	10	4	423	0	438
28934	1	2	3	424	0	430
28935	3	2	4	431	0	440
28936	1	2	422	14	0	439
28937	0	418	14	3	0	435
28938	1	11	6	415	0	433
28939	1	3	426	13	0	443
28940	2	419	12	3	0	436
28941	4	11	3	417	0	435
28942	0	3	432	13	0	448
28943	2	429	14	2	0	447
28944	3	15	1	426	0	445
28945	1	2	3	442	0	448
28946	0	1	452	14	0	467
28947	403	4	13	5	0	425
28948	10	444	2	3	0	459
28949	444	13	2	6	0	465
28950	12	4	444	5	0	465
28951	428	2	14	7	0	451
28952	14	2	5	446	0	467
28953	5	3	3	461	0	472
28954	1	4	450	18	0	473
28955	407	2	15	9	0	433
28956	424	2	5	6	0	437
28957	13	437	7	3	0	460
28958	3	456	4	2	0	465
28959	445	15	4	6	0	470
28960	11	6	443	4	0	464
28961	4	468	15	4	0	491
28962	3	12	3	479	0	497
28963	2	4	4	502	0	512
28964	0	4	495	16	0	515
28965	456	3	14	6	0	479
28966	10	2	489	6	0	507
28967	463	2	17	6	0	488
28968	15	3	499	3	0	520
28969	6	499	13	4	0	522
28970	499	14	4	8	0	525
28971	511	4	4	7	0	526
28972	508	1	2	6	0	517
28973	504	3	5	8	0	520
28974	15	4	4	497	0	520
28975	4	2	493	14	0	513
28976	5	2	14	480	0	501
28977	2	487	5	15	0	509
28978	1	15	4	495	0	515
28979	2	7	491	12	0	512
28980	2	3	485	8	0	498
28981	3	2	19	465	0	489
28982	466	4	6	16	0	492
28983	457	2	1	12	0	472
28984	469	1	4	6	0	480
28985	13	4	466	4	0	487
28986	6	2	469	4	0	481
28987	4	471	13	4	0	492
28988	3	488	5	4	0	500
28989	467	13	4	4	0	488
28990	474	8	2	3	0	487
28991	15	487	2	1	0	505
28992	485	8	2	3	0	498
28993	477	3	2	6	0	488
28994	12	484	1	3	0	500
28995	498	8	2	8	0	516
28996	484	3	5	10	0	502
28997	13	501	1	4	0	519
28998	508	11	1	7	0	527
28999	510	7	2	3	0	522
29000	11	2	511	1	0	525
29001	6	1	526	1	0	534
29002	2	513	11	3	0	529
29003	3	524	1	3	0	531
29004	502	11	8	8	0	529
29005	476	3	3	9	0	491
29006	480	0	2	8	0	490
29007	8	490	2	0	0	500
29008	5	9	1	499	0	514
29009	3	3	515	7	0	528
29010	8	2	7	490	0	507
29011	1	518	4	6	0	529
29012	515	4	0	5	0	524
29013	4	508	1	3	0	516
29014	3	3	1	506	0	513
29015	529	1	3	8	0	541
29016	527	0	2	5	0	534
29017	8	1	550	0	0	559
29018	551	0	5	5	0	561
29019	574	3	3	2	0	582
29020	582	2	1	6	0	591
29021	8	2	1	566	0	577
29022	4	564	4	4	0	576
29023	5	4	2	565	0	576
29024	3	3	573	4	0	583
29025	2	580	4	3	0	589
29026	5	2	2	559	0	568
29027	1	2	569	5	0	577
29028	1	567	3	2	0	573
29029	7	5	1	523	0	536
29030	1	0	566	4	0	571
29031	470	4	7	8	0	489
29032	6	0	569	3	0	578
29033	3	0	552	2	0	557
29034	4	568	6	0	0	578
29035	6	4	1	562	0	573
29036	3	2	4	550	0	559
29037	2	547	5	3	0	557
29038	0	6	4	587	0	597
29039	578	6	2	6	0	592
29040	572	3	1	4	0	580
29041	9	1	554	1	0	565
29042	541	1	5	3	0	550
29043	550	3	1	4	0	558
29044	6	3	553	4	0	566
29045	5	555	5	3	0	568
29046	3	563	2	2	0	570
29047	1	6	2	528	0	537
29048	4	554	2	6	0	566
29049	5	4	529	1	0	539
29050	2	3	532	1	0	538
29051	4	561	7	2	0	574
29052	559	4	3	1	0	567
29053	554	3	2	3	0	562
29054	555	4	1	5	0	565
29055	551	3	2	2	0	558
29056	539	3	2	2	0	546
29057	6	545	1	1	0	553
29058	3	4	531	1	0	539
29059	3	5	5	526	0	539
29060	534	1	1	5	0	541
29061	8	517	1	1	0	527
29062	7	2	1	506	0	516
29063	3	2	508	3	0	516
29064	3	487	4	1	0	495
29065	2	517	1	2	0	522
29066	496	6	4	3	0	509
29067	3	495	1	1	0	500
29068	5	3	1	473	0	482
29069	475	2	2	6	0	485
29070	465	1	0	6	0	472
29071	459	2	2	3	0	466
29072	5	1	452	2	0	460
29073	1	460	5	0	0	466
29074	466	5	1	3	0	475
29075	7	3	0	466	0	476
29076	468	1	0	5	0	474
29077	5	460	1	3	0	469
29078	489	3	1	1	0	494
29079	521	3	1	2	0	527
29080	19	0	2	510	0	531
29081	5	1	530	11	0	547
29082	10	1	11	530	0	552
29083	535	3	3	21	0	562
29084	544	1	1	7	0	553
29085	14	530	0	2	0	546
29086	512	12	0	6	0	530
29087	13	516	1	1	0	531
29088	514	13	1	11	0	539
29089	512	2	2	4	0	520
29090	15	3	514	3	0	535
29091	7	511	11	1	0	530
29092	9	11	2	509	0	531
29093	7	4	1	518	0	530
29094	9	3	0	506	0	518
29095	3	496	2	13	0	514
29096	3	14	496	3	0	516
29097	1	6	513	1	0	521
29098	3	609	12	3	0	627
29099	611	19	2	4	0	636
29100	18	8	620	1	0	647
29101	592	5	16	6	0	619
29102	21	604	10	3	0	638
29103	8	21	612	2	0	643
29104	9	9	21	583	0	622
29105	5	6	625	17	0	653
29106	2	5	644	7	0	658
29107	6	2	24	574	0	606
29108	4	607	13	16	0	640
29109	4	636	9	5	0	654
29110	621	22	6	7	0	656
29111	22	10	607	2	0	641
29112	610	10	18	5	0	643
29113	646	1	10	4	0	661
29114	23	630	7	6	0	666
29115	619	18	5	1	0	643
29116	628	10	3	3	0	644
29117	599	7	2	4	0	612
29118	28	578	3	3	0	612
29119	13	531	3	3	0	550
29120	13	577	3	1	0	594
29121	574	27	3	3	0	607
29122	580	13	3	2	0	598
29123	23	6	555	2	0	586
29124	15	4	572	2	0	593
29125	574	4	24	1	0	603
29126	599	1	9	5	0	614
29127	604	6	6	4	0	620
29128	26	5	6	580	0	617
29129	20	2	3	587	0	612
29130	13	3	3	610	0	629
29131	16	4	3	613	0	636
29132	3	6	587	29	0	625
29133	7	4	586	11	0	608
29134	5	3	603	5	0	616
29135	8	1	604	4	0	617
29136	588	0	27	7	0	622
29137	20	590	12	4	0	626
29138	11	631	8	4	0	654
29139	620	23	5	4	0	652
29140	25	11	611	2	0	649
29141	15	7	606	2	0	630
29142	593	5	30	5	0	633
29143	633	4	12	4	0	653
29144	27	625	8	1	0	661
29145	20	21	5	610	0	656
29146	629	9	4	19	0	661
29147	647	7	10	7	0	671
29148	27	7	5	613	0	652
29149	16	636	3	22	0	677
29150	646	21	2	7	0	676
29151	24	10	621	6	0	661
29152	610	8	18	6	0	642
29153	27	626	11	2	0	666
29154	643	20	7	6	0	676
29155	641	7	8	4	0	660
29156	31	7	629	3	0	670
29157	14	3	611	6	0	634
29158	622	5	25	4	0	656
29159	638	2	13	7	0	660
29160	24	638	12	6	0	680
29161	17	22	6	654	0	699
29162	9	11	650	18	0	688
29163	629	6	23	7	0	665
29164	27	6	7	646	0	686
29165	18	5	9	645	0	677
29166	638	2	8	24	0	672
29167	21	666	7	9	0	703
29168	670	15	5	8	0	698
29169	674	7	4	5	0	690
29170	680	4	4	6	0	694
29171	30	653	3	4	0	690
29172	657	17	2	9	0	685
29173	32	7	1	652	0	692
29174	11	5	3	652	0	671
29175	13	5	635	22	0	675
29176	7	3	636	8	0	654
29177	6	627	23	8	0	664
29178	8	628	11	3	0	650
29179	8	14	594	1	0	617
29180	6	597	13	1	0	617
29181	585	16	8	5	0	614
29182	584	7	6	4	0	601
29183	596	4	7	2	0	609
29184	21	3	4	562	0	590
29185	12	3	6	583	0	604
29186	9	4	603	12	0	628
29187	4	596	7	9	0	616
29188	592	10	4	12	0	618
29189	13	600	5	4	0	622
29190	604	12	2	8	0	626
29191	601	6	1	6	0	614
29192	24	4	0	584	0	612
29193	15	3	3	578	0	599
29194	14	2	0	602	0	618
29195	7	2	577	14	0	600
29196	5	557	8	9	0	579
29197	8	558	3	6	0	575
29198	1	429	2	1	0	433
29199	1	426	2	0	0	429
29200	2	428	1	1	0	432
29201	400	3	0	6	0	409
29202	4	2	405	1	0	412
29203	0	411	3	2	0	416
29204	1	2	392	1	0	396
29205	1	409	3	0	0	413
29206	6	3	1	317	0	327
29207	1	2	0	391	0	394
29208	1	405	2	2	0	410
29209	407	4	1	3	0	415
29210	5	1	390	0	0	396
29211	3	414	3	0	0	420
29212	2	4	416	0	0	422
29213	3	1	3	410	0	417
29214	3	2	1	387	0	393
29215	2	414	0	5	0	421
29216	2	3	0	419	0	424
29217	0	1	2	427	0	430
29218	2	424	3	2	0	431
29219	1	4	424	0	0	429
29220	1	4	405	0	0	410
29221	387	1	4	1	0	393
29222	416	1	1	5	0	423
29223	5	2	0	408	0	415
29224	3	1	410	3	0	417
29225	1	0	2	399	0	402
29226	1	449	1	7	0	458
29227	1	5	451	2	0	459
29228	0	446	6	2	0	454
29229	0	5	440	1	0	446
29230	1	449	3	0	0	453
29231	435	4	1	3	0	443
29232	4	3	0	436	0	443
29233	5	1	2	432	0	440
29234	4	1	436	4	0	445
29235	4	1	412	1	0	418
29236	0	425	3	4	0	432
29237	418	3	1	12	0	434
29238	4	1	2	420	0	427
29239	0	5	428	2	0	435
29240	4	2	417	0	0	423
29241	390	3	4	3	0	400
29242	415	3	0	4	0	422
29243	4	2	422	0	0	428
29244	2	1	3	413	0	419
29245	0	430	0	4	0	434
29246	424	3	1	7	0	435
29247	2	413	3	2	0	420
29248	406	2	1	4	0	413
29249	1	403	0	0	0	404
29250	0	413	1	1	0	415
29251	0	2	1	415	0	418
29252	1	2	0	411	0	414
29253	3	414	0	3	0	420
29254	0	2	403	1	0	406
29255	0	2	390	1	0	393
29256	2	0	399	1	0	402
29257	377	2	1	3	0	383
29258	392	0	1	3	0	396
29259	1	414	0	3	0	418
29260	0	2	415	1	0	418
29261	1	2	1	407	0	411
29262	1	2	432	1	0	436
29263	0	1	447	2	0	450
29264	1	0	4	467	0	472
29265	2	0	2	499	0	503
29266	1	0	531	10	0	542
29267	487	4	8	9	0	508
29268	10	527	8	3	0	548
29269	7	561	2	3	0	573
29270	4	23	2	544	0	573
29271	560	11	4	13	0	588
29272	16	577	3	10	0	606
29273	589	15	1	4	0	609
29274	17	583	2	0	0	602
29275	602	16	0	4	0	622
29276	20	11	590	3	0	624
29277	12	7	598	3	0	620
29278	9	3	25	555	0	592
29279	5	3	576	16	0	600
29280	3	541	19	9	0	572
29281	4	541	11	3	0	559
29282	537	25	4	7	0	573
29283	20	11	3	522	0	556
29284	8	530	6	13	0	557
29285	545	17	4	13	0	579
29286	529	11	1	6	0	547
29287	545	5	3	1	0	554
29288	29	3	1	516	0	549
29289	19	5	1	533	0	558
29290	8	3	521	22	0	554
29291	3	2	529	15	0	549
29292	515	3	26	3	0	547
29293	26	2	11	505	0	544
29294	11	1	511	20	0	543
29295	497	3	16	12	0	528
29296	18	528	12	7	0	565
29297	545	17	6	4	0	572
29298	552	9	4	5	0	570
29299	560	3	3	3	0	569
29300	32	0	532	2	0	566
29301	539	3	17	3	0	562
29302	21	4	12	514	0	551
29303	16	512	6	15	0	549
29304	8	571	1	11	0	591
29305	553	25	3	6	0	587
29306	570	13	3	1	0	587
29307	580	4	2	4	0	590
29308	37	2	3	540	0	582
29309	17	6	1	559	0	583
29310	12	5	1	548	0	566
29311	7	541	3	27	0	578
29312	544	18	1	12	0	575
29313	557	10	2	5	0	574
29314	572	4	1	8	0	585
29315	28	3	542	7	0	580
29316	557	3	18	7	0	585
29317	26	5	11	502	0	544
29318	17	541	3	15	0	576
29319	546	18	1	13	0	578
29320	547	10	4	6	0	567
29321	32	8	549	1	0	590
29322	22	4	17	527	0	570
29323	9	539	13	18	0	579
29324	555	19	2	12	0	588
29325	26	14	4	556	0	600
29326	23	6	4	545	0	578
29327	13	4	4	557	0	578
29328	12	3	3	574	0	592
29329	7	7	536	33	0	583
29330	5	542	19	18	0	584
29331	10	18	14	543	0	585
29332	10	12	554	22	0	598
29333	542	7	15	18	0	582
29334	556	3	13	13	0	585
29335	32	5	5	544	0	586
29336	554	5	5	25	0	589
29337	580	4	4	13	0	601
29338	36	5	554	5	0	600
29339	22	554	17	7	0	600
29340	564	17	16	9	0	606
29341	31	11	8	550	0	600
29342	566	5	4	21	0	596
29343	27	1	6	568	0	602
29344	21	6	6	576	0	609
29345	15	5	553	25	0	598
29346	497	3	21	19	0	540
29347	25	558	15	5	0	603
29348	18	19	554	9	0	600
29349	8	561	17	10	0	596
29350	540	20	13	8	0	581
29351	36	9	5	537	0	587
29352	548	5	3	23	0	579
29353	26	534	6	16	0	582
29354	555	20	4	9	0	588
29355	573	16	2	4	0	595
29356	574	5	5	10	0	594
29357	569	5	3	7	0	584
29358	34	557	2	5	0	598
29359	554	18	4	5	0	581
29360	28	14	4	526	0	572
29361	25	6	3	535	0	569
29362	12	494	2	30	0	538
29363	9	491	7	11	0	518
29364	7	505	2	2	0	516
29365	465	14	1	4	0	484
29366	11	415	1	5	0	432
29367	7	379	1	0	0	387
29368	376	8	3	3	0	390
29369	356	3	4	5	0	368
29370	12	373	1	1	0	387
29371	375	5	0	2	0	382
29372	6	4	349	2	0	361
29373	334	4	4	3	0	345
29374	7	3	344	2	0	356
29375	3	310	4	3	0	320
29376	1	320	2	4	0	327
29377	2	4	1	314	0	321
29378	320	2	0	4	0	326
29379	329	1	1	2	0	333
29380	340	1	0	2	0	343
29381	336	1	1	3	0	341
29382	332	2	1	2	0	337
29383	3	3	325	0	0	331
29384	7	1	323	0	0	331
29385	333	2	2	2	0	339
29386	3	345	3	1	0	352
29387	342	2	2	2	0	348
29388	354	1	1	4	0	360
29389	376	0	1	2	0	379
29390	380	1	1	0	0	382
29391	375	1	0	2	0	378
29392	2	3	379	1	0	385
29393	380	0	2	1	0	383
29394	390	0	1	6	0	397
29395	4	1	377	2	0	384
29396	378	1	1	2	0	382
29397	376	1	1	2	0	380
29398	3	1	403	1	0	408
29399	3	0	397	2	0	402
29400	2	399	5	0	0	406
29401	3	3	2	404	0	412
29402	5	2	414	0	0	421
29403	411	1	1	3	0	416
29404	5	1	2	435	0	443
29405	5	0	462	2	0	469
29406	440	0	3	1	0	444
29407	451	2	3	1	0	457
29408	443	0	2	2	0	447
29409	4	468	0	1	0	473
29410	3	2	1	456	0	462
29411	3	468	0	4	0	475
29412	468	1	0	5	0	474
29413	466	1	2	7	0	476
29414	4	0	460	1	0	465
29415	3	444	1	0	0	448
29416	1	445	2	1	0	449
29417	1	3	3	443	0	450
29418	2	2	0	443	0	447
29419	442	0	0	4	0	446
29420	2	435	2	2	0	441
29421	4	427	0	1	0	432
29422	3	3	423	0	0	429
29423	3	436	1	0	0	440
29424	429	3	5	3	0	440
29425	3	3	424	1	0	431
29426	392	1	2	4	0	399
29427	3	1	407	1	0	412
29428	375	0	1	1	0	377
29429	2	411	1	0	0	414
29430	429	1	0	3	0	433
29431	3	0	440	0	0	443
29432	424	0	3	3	0	430
29433	441	0	0	0	0	441
29434	3	0	451	0	0	454
29435	438	0	4	2	0	444
29436	464	0	0	1	0	465
29437	455	0	0	1	0	456
29438	5	451	0	0	0	456
29439	461	5	0	1	0	467
29440	5	0	464	0	0	469
29441	0	477	7	0	0	484
29442	481	9	0	5	0	495
29443	475	0	0	5	0	480
29444	481	0	0	1	0	482
29445	8	486	1	1	0	496
29446	4	7	0	528	0	539
29447	2	1	527	9	0	539
29448	1	0	11	514	0	526
29449	1	2	526	10	0	539
29450	501	0	12	5	0	518
29451	12	523	3	0	0	538
29452	4	12	0	511	0	527
29453	0	524	1	11	0	536
29454	3	13	0	534	0	550
29455	2	3	0	530	0	535
29456	0	536	0	14	0	550
29457	4	13	0	534	0	551
29458	4	2	1	553	0	560
29459	4	542	0	12	0	558
29460	1	558	3	2	0	564
29461	3	16	0	546	0	565
29462	2	4	546	13	0	565
29463	1	539	14	5	0	559
29464	3	14	4	536	0	557
29465	2	4	542	13	0	561
29466	1	549	15	6	0	571
29467	541	17	5	0	0	563
29468	14	5	533	2	0	554
29469	522	3	16	4	0	545
29470	16	2	4	520	0	542
29471	6	2	3	527	0	538
29472	6	2	1	534	0	543
29473	6	1	518	20	0	545
29474	1	5	509	5	0	520
29475	480	5	19	3	0	507
29476	20	1	5	518	0	544
29477	4	1	515	17	0	537
29478	503	5	18	5	0	531
29479	19	1	5	519	0	544
29480	11	2	3	522	0	538
29481	7	4	4	517	0	532
29482	6	528	2	18	0	554
29483	5	14	4	511	0	534
29484	6	523	3	13	0	545
29485	3	533	1	11	0	548
29486	523	20	5	8	0	556
29487	495	4	1	10	0	510
29488	519	2	4	5	0	530
29489	19	497	4	4	0	524
29490	507	16	2	5	0	530
29491	512	7	3	6	0	528
29492	25	3	4	492	0	524
29493	15	6	2	496	0	519
29494	4	5	484	26	0	519
29495	3	493	15	10	0	521
29496	478	17	5	10	0	510
29497	489	8	2	4	0	503
29498	20	471	3	7	0	501
29499	471	16	3	7	0	497
29500	475	12	2	6	0	495
29501	25	3	0	470	0	498
29502	6	446	8	16	0	476
29503	8	482	3	6	0	499
29504	472	22	2	3	0	499
29505	21	5	4	462	0	492
29506	16	4	454	14	0	488
29507	438	5	14	15	0	472
29508	17	3	470	10	0	500
29509	7	465	16	8	0	496
29510	458	17	8	11	0	494
29511	17	14	456	4	0	491
29512	16	2	16	465	0	499
29513	5	10	495	17	0	527
29514	6	493	16	10	0	525
29515	10	15	10	495	0	530
29516	5	12	489	19	0	525
29517	456	2	15	9	0	482
29518	15	496	6	7	0	524
29519	13	18	2	470	0	503
29520	6	494	5	18	0	523
29521	481	19	6	10	0	516
29522	488	10	2	7	0	507
29523	24	489	7	4	0	524
29524	11	20	4	481	0	516
29525	11	494	5	12	0	522
29526	496	18	6	8	0	528
29527	17	10	485	8	0	520
29528	12	1	488	4	0	505
29529	2	468	20	5	0	495
29530	6	467	7	10	0	490
29531	6	16	9	461	0	492
29532	447	13	3	17	0	480
29533	464	4	2	11	0	481
29534	451	5	4	7	0	467
29535	17	469	3	7	0	496
29536	16	9	3	461	0	489
29537	8	472	5	10	0	495
29538	470	14	1	14	0	499
29539	18	7	2	466	0	493
29540	7	6	460	11	0	484
29541	9	450	9	6	0	474
29542	446	9	10	5	0	470
29543	9	6	449	5	0	469
29544	424	6	10	7	0	447
29545	7	437	7	5	0	456
29546	5	390	0	3	0	398
29547	381	6	1	6	0	394
29548	7	390	2	2	0	401
29549	378	4	0	6	0	388
29550	5	373	3	1	0	382
29551	380	6	0	3	0	389
29552	374	6	0	6	0	386
29553	7	3	386	0	0	396
29554	6	0	368	2	0	376
29555	2	376	6	1	0	385
29556	379	5	2	2	0	388
29557	5	6	365	2	0	378
29558	344	0	3	1	0	348
29559	7	1	2	343	0	353
29560	3	2	349	3	0	357
29561	4	1	324	3	0	332
29562	0	3	363	0	0	366
29563	2	365	4	1	0	372
29564	3	6	2	363	0	374
29565	348	0	0	3	0	351
29566	1	1	0	350	0	352
29567	350	0	0	3	0	353
29568	2	0	0	350	0	352
29569	357	0	0	6	0	363
29570	374	0	0	2	0	376
29571	404	0	0	2	0	406
29572	6	406	0	0	0	412
29573	2	5	416	0	0	423
29574	4	2	5	423	0	434
29575	9	1	2	285	0	297
29576	1	1	1	439	0	442
29577	1	0	0	431	0	432
29578	2	422	1	5	0	430
29579	0	5	409	2	0	416
29580	1	415	4	0	0	420
29581	0	6	1	390	0	397
29582	0	1	1	424	0	426
29583	1	1	0	418	0	420
29584	2	0	0	415	0	417
29585	1	403	0	8	0	412
29586	1	410	0	1	0	412
29587	0	5	409	2	0	416
29588	1	3	4	404	0	412
29589	2	1	1	410	0	414
29590	1	0	0	423	0	424
29591	423	0	1	7	0	431
29592	4	426	0	3	0	433
29593	4	5	416	0	0	425
29594	415	1	6	1	0	423
29595	6	1	1	420	0	428
29596	430	1	1	8	0	440
29597	6	1	0	433	0	440
29598	436	0	0	8	0	444
29599	7	1	0	428	0	436
29600	425	0	0	6	0	431
29601	6	1	453	1	0	461
29602	2	0	4	453	0	459
29603	2	467	2	4	0	475
29604	1	6	1	469	0	477
29605	467	1	1	5	0	474
29606	4	470	0	1	0	475
29607	4	5	0	498	0	507
29608	1	489	1	5	0	496
29609	3	5	0	499	0	507
29610	2	3	1	496	0	502
29611	0	1	491	7	0	499
29612	1	0	5	476	0	482
29613	0	0	478	7	0	485
29614	2	459	10	1	0	472
29615	470	7	2	3	0	482
29616	6	1	463	1	0	471
29617	442	2	6	2	0	452
29618	483	0	1	4	0	488
29619	7	0	0	482	0	489
29620	5	1	504	5	0	515
29621	471	1	5	6	0	483
29622	525	0	2	3	0	530
29623	7	0	2	513	0	522
29624	5	0	1	512	0	518
29625	3	528	1	8	0	540
29626	3	6	0	532	0	541
29627	1	523	0	8	0	532
29628	1	7	520	2	0	530
29629	0	3	6	514	0	523
29630	503	1	1	10	0	515
29631	502	1	2	4	0	509
29632	5	503	0	6	0	514
29633	4	5	1	506	0	516
29634	497	4	0	8	0	509
29635	6	467	0	6	0	479
29636	478	7	2	5	0	492
29637	10	4	1	481	0	496
29638	504	2	0	15	0	521
29639	9	2	567	5	0	583
29640	7	566	8	3	0	584
29641	567	12	4	2	0	585
29642	9	584	4	2	0	599
29643	595	14	1	2	0	612
29644	601	6	0	4	0	611
29645	20	3	600	2	0	625
29646	12	1	11	586	0	610
29647	612	1	4	14	0	631
29648	15	1	607	5	0	628
29649	601	3	12	8	0	624
29650	21	2	3	602	0	628
29651	4	1	609	13	0	627
29652	10	3	11	591	0	615
29653	580	0	5	17	0	602
29654	12	4	624	4	0	644
29655	8	1	12	624	0	645
29656	8	0	4	628	0	640
29657	627	1	6	14	0	648
29658	629	0	0	10	0	639
29659	18	652	2	4	0	676
29660	11	9	4	650	0	674
29661	9	4	0	642	0	655
29662	6	4	2	639	0	651
29663	624	3	2	17	0	646
29664	629	1	2	13	0	645
29665	21	2	3	615	0	641
29666	10	615	4	12	0	641
29667	10	11	0	600	0	621
29668	2	619	3	16	0	640
29669	605	14	2	8	0	629
29670	17	590	1	4	0	612
29671	573	10	2	4	0	589
29672	15	6	1	561	0	583
29673	556	3	1	13	0	573
29674	11	2	567	8	0	588
29675	9	584	9	4	0	606
29676	585	10	6	5	0	606
29677	580	5	4	5	0	594
29678	16	5	0	567	0	588
29679	8	573	3	12	0	596
29680	10	12	1	593	0	616
29681	7	4	2	593	0	606
29682	6	4	2	590	0	602
29683	594	0	1	19	0	614
29684	586	4	1	11	0	602
29685	20	0	2	589	0	611
29686	8	586	4	11	0	609
29687	585	12	1	11	0	609
29688	12	5	575	6	0	598
29689	12	5	9	575	0	601
29690	9	1	591	12	0	613
29691	7	6	10	586	0	609
29692	7	1	605	16	0	629
29693	4	5	9	608	0	626
29694	606	3	3	21	0	633
29695	607	5	3	11	0	626
29696	19	600	0	4	0	623
29697	618	9	3	6	0	636
29698	13	7	2	612	0	634
29699	12	4	4	615	0	635
29700	619	3	6	15	0	643
29701	17	3	616	8	0	644
29702	9	4	604	7	0	624
29703	6	5	621	9	0	641
29704	596	4	16	4	0	620
29705	13	2	629	9	0	653
29706	8	3	598	6	0	615
29707	583	4	13	5	0	605
29708	14	639	6	8	0	667
29709	15	7	6	639	0	667
29710	11	3	2	656	0	672
29711	9	7	664	13	0	693
29712	635	2	11	12	0	660
29713	649	3	7	12	0	671
29714	658	1	3	12	0	674
29715	16	3	653	3	0	675
29716	615	1	9	13	0	638
29717	15	4	644	8	0	671
29718	8	632	12	5	0	657
29719	10	650	6	6	0	672
29720	618	11	1	6	0	636
29721	12	609	2	6	0	629
29722	7	611	5	6	0	629
29723	601	9	5	7	0	622
29724	11	599	5	6	0	621
29725	602	10	2	5	0	619
29726	15	4	4	603	0	626
29727	12	4	4	607	0	627
29728	11	4	5	605	0	625
29729	7	4	4	607	0	622
29730	5	597	2	15	0	619
29731	607	11	2	13	0	633
29732	14	641	4	2	0	661
29733	7	654	5	7	0	673
29734	2	17	664	5	0	688
29735	641	5	18	6	0	670
29736	20	5	683	2	0	710
29737	11	3	708	4	0	726
29738	7	683	27	3	0	720
29739	1	659	5	1	0	666
29740	652	22	4	6	0	684
29741	16	677	4	1	0	698
29742	11	19	679	1	0	710
29743	5	673	19	1	0	698
29744	5	19	683	1	0	708
29745	2	12	666	1	0	681
29746	627	6	26	5	0	664
29747	19	5	667	0	0	691
29748	12	4	21	630	0	667
29749	619	1	15	18	0	653
29750	15	624	7	8	0	654
29751	6	18	638	3	0	665
29752	613	9	22	4	0	648
29753	22	3	11	602	0	638
29754	8	583	7	15	0	613
29755	4	18	602	11	0	635
29756	580	9	18	6	0	613
29757	20	7	598	3	0	628
29758	13	3	24	565	0	605
29759	8	3	573	18	0	602
29760	7	3	21	563	0	594
29761	543	6	12	22	0	583
29762	17	559	10	10	0	596
29763	572	19	4	4	0	599
29764	17	9	563	5	0	594
29765	16	5	18	562	0	601
29766	5	4	577	12	0	598
29767	540	3	21	14	0	578
29768	563	2	13	5	0	583
29769	27	559	6	4	0	596
29770	575	18	7	6	0	606
29771	589	8	4	3	0	604
29772	30	5	5	565	0	605
29773	13	4	578	19	0	614
29774	14	548	20	7	0	589
29775	8	19	6	551	0	584
29776	560	13	5	24	0	602
29777	23	6	562	8	0	599
29778	14	3	574	5	0	596
29779	7	5	565	7	0	584
29780	551	2	31	2	0	586
29781	21	7	563	1	0	592
29782	541	2	27	8	0	578
29783	28	0	527	6	0	561
29784	13	541	24	2	0	580
29785	8	18	15	536	0	577
29786	6	10	543	19	0	578
29787	8	519	24	7	0	558
29788	5	556	16	5	0	582
29789	11	25	9	534	0	579
29790	531	13	5	19	0	568
29791	24	11	4	532	0	571
29792	523	5	4	21	0	553
29793	29	3	6	520	0	558
29794	11	5	517	23	0	556
29795	7	6	530	11	0	554
29796	506	2	25	10	0	543
29797	520	2	14	7	0	543
29798	27	3	500	7	0	537
29799	493	3	25	5	0	526
29800	26	4	495	7	0	532
29801	16	461	24	4	0	505
29802	7	476	18	2	0	503
29803	9	485	10	3	0	507
29804	10	24	7	468	0	509
29805	464	14	7	22	0	507
29806	471	7	9	9	0	496
29807	31	6	9	462	0	508
29808	18	4	423	20	0	465
29809	11	11	20	427	0	469
29810	8	5	427	24	0	464
29811	11	3	25	414	0	453
29812	405	5	12	27	0	449
29813	430	6	7	13	0	456
29814	429	4	9	7	0	449
29815	431	2	10	10	0	453
29816	35	2	5	404	0	446
29817	19	2	8	418	0	447
29818	407	1	5	31	0	444
29819	417	0	6	13	0	436
29820	37	3	3	395	0	438
29821	18	2	2	414	0	436
29822	19	2	5	404	0	430
29823	15	2	6	413	0	436
29824	385	4	4	32	0	425
29825	25	3	379	15	0	422
29826	18	2	19	375	0	414
29827	370	2	10	26	0	408
29828	23	2	362	14	0	401
29829	11	1	21	370	0	403
29830	12	2	367	22	0	403
29831	10	330	20	12	0	372
29832	4	14	17	289	0	324
29833	270	5	7	16	0	298
29834	16	3	6	233	0	258
29835	8	222	3	15	0	248
29836	5	198	5	8	0	216
29837	2	152	4	4	0	162
29838	4	135	3	5	0	147
29839	72	8	17	10	0	107
29840	5	2	2	50	0	59
29841	2	0	35	2	0	39
29842	3	0	2	31	0	36
29843	2	1	31	1	0	35
29844	32	0	1	2	0	35
29845	2	0	0	33	0	35
29846	1	0	0	35	0	36
29847	1	1	0	33	0	35
29848	0	1	0	34	0	35
29849	32	1	0	3	0	36
29850	31	1	0	1	0	33
29851	2	0	0	34	0	36
29852	32	0	0	3	0	35
29853	2	0	33	0	0	35
29854	0	29	2	2	0	33
29855	1	1	1	32	0	35
29856	2	0	0	32	0	34
29857	0	31	1	3	0	35
29858	0	1	1	34	0	36
29859	0	2	1	33	0	36
29860	31	1	0	3	0	35
29861	2	0	30	1	0	33
29862	2	0	29	1	0	32
29863	29	1	1	2	0	33
29864	2	2	26	0	0	30
29865	12	1	3	0	0	16
29866	13	0	1	0	0	14
29867	1	0	0	12	0	13
29868	0	0	11	0	0	11
29869	11	0	0	0	0	11
29870	0	10	0	0	0	10
29871	7	0	1	0	0	8
29872	17	0	0	0	0	17
29873	66	0	1	0	0	67
29874	225	0	0	0	0	225
29875	187	0	0	0	0	187
29876	220	0	0	0	0	220
29877	197	0	0	0	0	197
29878	185	0	0	0	0	185
29879	234	0	0	0	0	234
29880	233	0	0	0	0	233
29881	219	0	0	0	0	219
29882	191	0	0	0	0	191
29883	231	0	0	0	0	231
29884	203	0	0	0	0	203
29885	194	0	0	0	0	194
29886	229	0	0	0	0	229
29887	210	0	0	0	0	210
29888	203	0	0	0	0	203
29889	173	0	0	0	0	173
29890	213	0	0	0	0	213
29891	188	0	0	0	0	188
29892	221	0	0	0	0	221
29893	209	0	0	0	0	209
29894	234	0	0	0	0	234
29895	235	0	0	0	0	235
29896	233	0	0	0	0	233
29897	212	0	0	0	0	212
29898	202	0	0	0	0	202
29899	230	0	0	0	0	230
29900	224	0	1	0	0	225
29901	221	0	0	0	0	221
29902	218	0	0	0	0	218
29903	165	0	35	0	0	200
