Pos	A	C	G	T	Other	Total
1	0	0	0	0	0	0
2	0	0	0	0	0	0
3	0	0	0	1	0	1
4	1	0	0	0	0	1
5	1	0	0	0	0	1
6	1	0	0	0	0	1
7	0	0	1	0	0	1
8	0	0	1	0	0	1
9	0	0	0	1	0	1
10	0	0	0	2	0	2
11	0	0	0	2	0	2
12	2	0	0	0	0	2
13	0	0	0	3	0	3
14	6	0	0	0	0	6
15	0	12	0	0	0	12
16	0	19	0	0	0	19
17	0	0	0	48	0	48
18	0	0	0	57	0	57
19	0	83	0	0	0	83
20	0	87	0	0	0	87
21	0	97	0	0	0	97
22	103	0	0	0	0	103
23	0	0	104	0	0	104
24	0	0	101	0	0	101
25	0	0	0	115	0	115
26	118	0	0	0	0	118
27	119	0	0	0	0	119
28	0	120	0	0	0	120
29	137	0	0	1	0	138
30	144	0	0	0	0	144
31	145	0	0	1	0	146
32	0	144	0	1	0	145
33	0	145	0	0	0	145
34	154	0	0	0	0	154
35	155	0	0	1	0	156
36	0	161	0	0	0	161
37	0	175	0	0	0	175
38	176	0	0	1	0	177
39	178	0	0	0	0	178
40	0	176	0	0	0	176
41	0	0	0	184	0	184
42	0	0	0	192	0	192
43	0	0	0	197	0	197
44	0	197	0	0	0	197
45	0	0	197	0	0	197
46	186	0	0	0	0	186
47	0	0	0	197	0	197
48	0	196	0	0	0	196
49	0	0	0	198	0	198
50	0	201	0	0	0	201
51	0	0	0	202	0	202
52	0	0	0	204	0	204
53	0	0	204	0	0	204
54	0	0	0	206	0	206
55	210	0	0	0	0	210
56	0	0	210	0	0	210
57	207	0	1	0	0	208
58	0	0	0	215	0	215
59	0	213	0	0	0	213
60	0	0	0	216	0	216
61	0	0	216	0	0	216
62	0	0	0	212	0	212
63	0	0	0	216	0	216
64	0	215	0	0	0	215
65	0	0	0	217	0	217
66	0	215	0	0	0	215
67	0	0	0	216	0	216
68	213	4	0	0	0	217
69	215	0	0	1	0	216
70	215	0	0	0	0	215
71	0	217	0	0	0	217
72	0	0	216	0	0	216
73	218	0	0	0	0	218
74	223	0	0	0	0	223
75	0	232	0	0	0	232
76	0	0	0	179	0	179
77	0	0	0	181	0	181
78	0	0	0	167	0	167
79	168	0	0	3	0	171
80	171	0	0	2	0	173
81	173	0	0	2	0	175
82	172	0	0	0	0	172
83	3	0	0	168	0	171
84	2	169	0	1	0	172
85	2	2	0	174	0	178
86	0	0	175	4	0	179
87	0	2	1	186	0	189
88	0	0	184	4	0	188
89	1	0	4	188	0	193
90	0	0	190	4	0	194
91	0	0	195	0	0	195
92	0	191	2	2	0	195
93	0	2	2	199	0	203
94	0	0	202	2	0	204
95	1	2	2	197	0	202
96	0	204	0	4	0	208
97	202	2	2	0	0	206
98	1	215	0	1	0	217
99	1	4	0	213	0	218
100	2	216	0	2	0	220
101	0	4	214	0	0	218
102	0	0	213	2	0	215
103	0	218	2	0	0	220
104	0	1	2	218	0	221
105	0	0	219	2	0	221
106	0	217	2	0	0	219
107	217	2	0	2	0	221
108	2	0	2	216	0	220
109	0	2	220	1	0	223
110	2	217	2	0	0	221
111	0	2	0	221	0	223
112	0	0	2	221	0	223
113	218	2	0	2	0	222
114	2	0	218	2	0	222
115	0	0	2	215	0	217
116	2	0	207	2	0	211
117	0	195	4	0	0	199
118	193	2	0	2	0	197
119	1	188	2	0	0	191
120	0	4	0	183	0	187
121	1	182	0	2	0	185
122	180	4	0	0	0	184
123	1	181	0	1	0	183
124	0	4	179	0	0	183
125	2	174	2	0	0	178
126	172	4	0	0	0	176
127	2	0	175	0	0	177
128	0	2	2	174	0	178
129	174	0	0	2	0	176
130	2	0	2	170	0	174
131	173	0	0	4	0	177
132	176	0	0	0	0	176
133	2	0	0	172	0	174
134	2	0	0	170	0	172
135	171	0	0	2	0	173
136	170	0	0	2	0	172
137	2	0	0	167	0	169
138	167	0	0	2	0	169
139	171	0	0	0	0	171
140	2	172	0	2	0	176
141	2	2	0	170	0	174
142	174	0	0	2	0	176
143	174	2	0	0	0	176
144	1	0	0	172	0	173
145	2	0	0	174	0	176
146	172	0	0	2	0	174
147	2	169	0	2	0	173
148	0	1	0	173	0	174
149	2	0	174	2	0	178
150	0	1	2	168	0	171
151	0	172	0	4	0	176
152	0	2	175	0	0	177
153	0	0	2	171	0	173
154	0	1	2	165	0	168
155	0	0	173	3	0	176
156	162	0	3	1	0	166
157	2	172	1	2	0	177
158	168	3	2	0	0	173
159	4	0	170	1	0	175
160	0	2	175	0	0	177
161	171	0	2	1	0	174
162	2	180	2	0	0	184
163	177	2	2	0	0	181
164	4	183	0	0	0	187
165	0	4	185	1	0	190
166	185	1	2	0	0	188
167	2	2	185	0	0	189
168	0	0	5	185	0	190
169	185	1	0	3	0	189
170	184	0	2	1	0	187
171	2	186	1	2	0	191
172	2	8	0	177	0	187
173	3	180	0	2	0	185
174	0	4	177	1	0	182
175	0	5	3	165	0	173
176	0	159	0	1	0	160
177	0	0	1	146	0	147
178	138	0	0	3	0	141
179	1	0	0	141	0	142
180	0	139	1	0	0	140
181	0	0	0	142	0	142
182	1	0	1	139	0	141
183	0	143	0	0	0	143
184	1	1	0	140	0	142
185	0	1	139	0	0	140
186	0	136	0	1	0	137
187	123	0	0	1	0	124
188	0	0	126	0	0	126
189	0	0	119	0	0	119
190	0	119	0	0	0	119
191	0	1	0	112	0	113
192	0	0	113	0	0	113
193	0	100	0	0	0	100
194	0	0	0	110	0	110
195	0	0	0	109	0	109
196	110	0	0	1	0	111
197	0	111	0	0	0	111
198	0	0	99	0	0	99
199	0	0	100	0	0	100
200	0	0	0	102	0	102
201	1	0	0	122	0	123
202	0	1	0	121	0	122
203	0	144	1	0	0	145
204	0	1	147	0	0	148
205	0	0	2	153	0	155
206	0	156	0	3	0	159
207	0	158	0	1	0	159
208	0	2	165	0	0	167
209	0	0	3	165	0	168
210	0	0	183	4	0	187
211	0	1	4	179	0	184
212	1	1	0	188	0	190
213	0	0	190	4	0	194
214	0	186	4	3	0	193
215	185	4	2	2	0	193
216	4	0	184	2	0	190
217	0	185	4	2	0	191
218	1	189	2	0	0	192
219	0	6	178	0	0	184
220	176	1	3	0	0	180
221	4	1	2	170	0	177
222	0	180	1	2	0	183
223	178	6	0	0	0	184
224	4	0	2	175	0	181
225	2	178	0	4	0	184
226	179	5	0	2	0	186
227	4	1	178	1	0	184
228	2	177	4	1	0	184
229	177	4	1	1	0	183
230	4	174	1	1	0	180
231	171	5	0	0	0	176
232	5	0	3	168	0	176
233	0	172	0	4	0	176
234	5	4	0	170	0	179
235	168	2	1	5	0	176
236	6	2	167	0	0	175
237	0	1	167	3	0	171
238	2	2	5	164	0	173
239	1	0	2	168	0	171
240	2	1	1	161	0	165
241	0	153	2	6	0	161
242	1	4	152	1	0	158
243	1	0	4	154	0	159
244	0	154	0	7	0	161
245	1	159	1	2	0	163
246	1	6	160	1	0	168
247	0	2	164	1	0	167
248	0	2	163	2	0	167
249	1	3	4	155	0	163
250	1	2	161	4	0	168
251	0	1	6	160	0	167
252	1	0	159	5	0	165
253	153	1	6	1	0	161
254	6	159	1	2	0	168
255	0	165	4	0	0	169
256	1	4	172	2	0	179
257	165	0	5	2	0	172
258	175	1	0	1	0	177
259	170	2	2	1	0	175
260	4	3	163	0	0	170
261	1	0	170	1	0	172
262	2	0	3	162	0	167
263	160	0	1	5	0	166
264	159	2	1	0	0	162
265	4	1	154	1	0	160
266	151	0	8	1	0	160
267	5	1	1	154	0	161
268	2	2	151	5	0	160
269	3	1	155	0	0	159
270	144	1	7	2	0	154
271	6	1	150	1	0	158
272	147	0	7	3	0	157
273	5	1	152	1	0	159
274	0	145	8	2	0	155
275	3	154	3	1	0	161
276	2	5	3	149	0	159
277	4	1	1	151	0	157
278	1	3	150	4	0	158
279	2	3	6	146	0	157
280	1	147	2	3	0	153
281	1	148	2	3	0	154
282	3	152	0	3	0	158
283	1	5	4	148	0	158
284	1	2	146	5	0	154
285	2	3	146	2	0	153
286	1	2	4	144	0	151
287	2	4	2	146	0	154
288	2	0	4	142	0	148
289	3	148	2	5	0	158
290	151	5	2	2	0	160
291	154	0	1	3	0	158
292	4	151	3	2	0	160
293	4	5	151	1	0	161
294	151	4	5	2	0	162
295	9	2	150	1	0	162
296	152	0	6	2	0	160
297	155	3	2	0	0	160
298	152	1	3	2	0	158
299	153	1	1	3	0	158
300	5	149	3	2	0	159
301	131	4	1	0	0	136
302	7	129	0	3	0	139
303	108	3	2	1	0	114
304	4	106	0	1	0	111
305	0	6	93	0	0	99
306	2	11	2	78	0	93
307	0	89	1	2	0	92
308	0	84	1	1	0	86
309	76	1	2	3	0	82
310	60	0	1	2	0	63
311	0	63	0	1	0	64
312	0	2	0	59	0	61
313	0	68	0	0	0	68
314	69	1	0	0	0	70
315	0	0	70	1	0	71
316	0	0	1	69	0	70
317	1	0	1	70	0	72
318	0	0	0	70	0	70
319	0	0	70	1	0	71
320	0	69	0	1	0	70
321	0	70	0	0	0	70
322	1	0	0	76	0	77
323	1	0	79	0	0	80
324	0	1	0	78	0	79
325	0	0	1	79	0	80
326	1	0	0	79	0	80
327	0	0	1	76	0	77
328	76	0	0	0	0	76
329	1	75	0	0	0	76
330	77	0	0	0	0	77
331	1	0	76	0	0	77
332	0	1	76	0	0	77
333	1	0	0	81	0	82
334	0	1	0	78	0	79
335	1	80	0	0	0	81
336	0	0	77	0	0	77
337	1	79	1	0	0	81
338	0	0	80	1	0	81
339	77	0	0	0	0	77
340	0	79	0	0	0	79
341	1	0	81	0	0	82
342	1	0	0	80	0	81
343	0	1	81	0	0	82
344	0	78	0	1	0	79
345	0	1	0	76	0	77
346	1	76	0	0	0	77
347	0	0	78	0	0	78
348	0	0	0	77	0	77
349	75	0	0	2	0	77
350	0	74	0	1	0	75
351	0	0	73	0	0	73
352	1	1	0	70	0	72
353	0	1	72	0	0	73
354	0	0	62	1	0	63
355	0	62	0	0	0	62
356	0	0	0	51	0	51
357	0	0	0	52	0	52
358	0	0	0	51	0	51
359	0	0	50	0	0	50
360	0	0	52	0	0	52
361	48	0	0	1	0	49
362	0	0	53	0	0	53
363	52	0	0	1	0	53
364	0	53	0	0	0	53
365	0	0	0	52	0	52
366	0	50	0	0	0	50
367	0	59	0	0	0	59
368	0	0	61	0	0	61
369	0	0	0	61	0	61
370	0	0	61	0	0	61
371	0	0	59	0	0	59
372	55	0	0	0	0	55
373	0	0	57	0	0	57
374	0	0	58	0	0	58
375	55	0	0	1	0	56
376	0	0	55	0	0	55
377	0	0	55	0	0	55
378	0	1	0	53	0	54
379	1	55	0	0	0	56
380	0	0	1	55	0	56
381	0	0	0	54	0	54
382	55	0	0	1	0	56
383	0	0	0	56	0	56
384	0	56	1	0	0	57
385	56	1	0	0	0	57
386	0	0	55	0	0	55
387	53	0	0	1	0	54
388	0	0	59	0	0	59
389	0	0	53	1	0	54
390	0	54	0	1	0	55
391	54	0	0	1	0	55
392	0	53	0	1	0	54
393	0	0	54	0	0	54
394	0	1	0	51	0	52
395	1	54	0	0	0	55
396	55	0	1	0	0	56
397	55	0	1	0	0	56
398	0	56	0	1	0	57
399	56	0	0	1	0	57
400	0	1	0	56	0	57
401	0	56	1	0	0	57
402	1	1	0	55	0	57
403	0	0	1	63	0	64
404	63	0	0	1	0	64
405	63	1	0	0	0	64
406	63	0	1	0	0	64
407	1	0	62	1	0	64
408	62	0	2	0	0	64
409	1	2	0	61	0	64
410	0	0	62	2	0	64
411	0	1	61	0	0	62
412	0	60	3	0	0	63
413	49	2	2	0	0	53
414	1	51	0	0	0	52
415	0	1	0	53	0	54
416	0	0	0	56	0	56
417	0	0	59	2	0	61
418	1	0	2	57	0	60
419	0	0	59	2	0	61
420	0	0	59	0	0	59
421	0	60	2	0	0	62
422	0	2	0	56	0	58
423	0	0	0	55	0	55
424	53	0	0	2	0	55
425	2	0	54	0	0	56
426	0	0	2	54	0	56
427	53	0	0	2	0	55
428	2	0	53	0	0	55
429	52	0	2	0	0	54
430	56	0	0	0	0	56
431	2	0	58	0	0	60
432	0	0	2	58	0	60
433	0	0	0	57	0	57
434	0	0	56	1	0	57
435	53	0	2	0	0	55
436	58	0	0	0	0	58
437	58	0	0	0	0	58
438	57	0	0	0	0	57
439	58	0	0	0	0	58
440	2	0	46	0	0	48
441	0	0	56	0	0	56
442	0	55	2	0	0	57
443	0	1	55	0	0	56
444	0	0	2	55	0	57
445	0	0	0	44	0	44
446	0	0	0	58	0	58
447	0	0	0	56	0	56
448	0	0	56	2	0	58
449	0	54	2	0	0	56
450	0	64	0	0	0	64
451	0	2	0	56	0	58
452	0	61	0	2	0	63
453	62	2	0	0	0	64
454	63	0	0	1	0	64
455	2	64	0	0	0	66
456	0	2	0	68	0	70
457	0	0	0	71	0	71
458	0	0	69	3	0	72
459	67	0	2	0	0	69
460	77	0	0	0	0	77
461	3	74	0	0	0	77
462	76	3	0	0	0	79
463	3	0	77	0	0	80
464	0	77	3	0	0	80
465	0	85	0	0	0	85
466	0	85	0	0	0	85
467	0	3	0	74	0	77
468	73	0	0	3	0	76
469	3	0	0	76	0	79
470	1	0	78	3	0	82
471	2	0	3	77	0	82
472	1	0	80	3	0	84
473	1	0	4	80	0	85
474	1	0	0	82	0	83
475	0	86	0	3	0	89
476	88	3	1	0	0	92
477	4	0	1	86	0	91
478	0	90	0	4	0	94
479	88	3	0	0	0	91
480	83	1	1	0	0	85
481	87	1	0	2	0	90
482	4	88	0	1	0	93
483	0	4	89	0	0	93
484	0	0	3	90	0	93
485	0	1	1	90	0	92
486	0	91	2	2	0	95
487	2	4	91	2	0	99
488	1	0	95	1	0	97
489	92	0	4	2	0	98
490	4	1	1	93	0	99
491	0	0	94	5	0	99
492	0	104	4	2	0	110
493	2	2	0	104	0	108
494	0	105	3	4	0	112
495	1	4	106	1	0	112
496	106	0	3	2	0	111
497	109	0	3	1	0	113
498	4	105	0	1	0	110
499	1	3	0	104	0	108
500	1	1	105	3	0	110
501	1	103	4	1	0	109
502	104	4	0	1	0	109
503	3	93	2	0	0	98
504	1	100	0	1	0	102
505	1	2	0	94	0	97
506	1	93	1	2	0	97
507	97	3	1	0	0	101
508	3	0	1	95	0	99
509	1	1	93	4	0	99
510	0	1	94	1	0	96
511	0	0	2	94	0	96
512	0	97	0	1	0	98
513	97	1	0	0	0	98
514	1	1	0	94	0	96
515	1	0	91	1	0	93
516	1	0	2	91	0	94
517	1	0	0	89	0	90
518	87	2	0	1	0	90
519	2	0	0	87	0	89
520	0	0	88	1	0	89
521	0	1	82	0	0	83
522	1	0	1	82	0	84
523	0	1	0	81	0	82
524	1	0	81	0	0	82
525	77	0	1	2	0	80
526	1	1	77	0	0	79
527	1	80	2	0	0	83
528	0	1	0	85	0	86
529	0	0	84	1	0	85
530	0	0	85	0	0	85
531	1	0	1	79	0	81
532	80	1	1	0	0	82
533	2	1	87	0	0	90
534	0	88	1	2	0	91
535	91	1	2	0	0	94
536	1	0	93	1	0	95
537	90	0	1	2	0	93
538	94	0	0	0	0	94
539	1	96	1	0	0	98
540	0	1	1	89	0	91
541	1	94	0	1	0	96
542	0	0	96	1	0	97
543	96	0	1	1	0	98
544	99	0	1	0	0	100
545	2	0	97	0	0	99
546	0	0	102	1	0	103
547	0	104	1	0	0	105
548	102	1	1	0	0	104
549	2	0	1	102	0	105
550	1	0	1	95	0	97
551	0	96	1	1	0	98
552	97	1	1	0	0	99
553	1	1	99	0	0	101
554	1	1	1	105	0	108
555	107	0	0	3	0	110
556	2	107	1	1	0	111
557	1	2	115	0	0	118
558	2	0	117	0	0	119
559	0	2	2	111	0	115
560	0	114	0	3	0	117
561	2	1	116	0	0	119
562	0	2	2	111	0	115
563	115	0	1	1	0	117
564	2	0	121	0	0	123
565	0	0	1	119	0	120
566	0	1	118	1	0	120
567	0	0	121	0	0	121
568	1	3	1	117	0	122
569	2	0	121	1	0	124
570	109	0	2	0	0	111
571	1	0	122	1	0	124
572	113	0	2	0	0	115
573	1	116	1	0	0	118
574	120	1	0	1	0	122
575	1	120	1	0	0	122
576	0	2	0	117	0	119
577	0	0	1	121	0	122
578	1	0	120	1	0	122
579	0	0	126	0	0	126
580	0	0	1	126	0	127
581	0	1	126	1	0	128
582	0	0	1	122	0	123
583	0	124	0	2	0	126
584	1	128	1	0	0	130
585	0	2	1	125	0	128
586	0	0	1	125	0	126
587	0	0	121	1	0	122
588	0	0	1	119	0	120
589	0	120	0	1	0	121
590	0	120	1	0	0	121
591	0	122	0	1	0	123
592	1	1	0	113	0	115
593	0	110	1	1	0	112
594	109	1	0	1	0	111
595	1	0	1	108	0	110
596	0	0	108	1	0	109
597	0	0	1	107	0	108
598	0	0	113	1	0	114
599	1	0	115	0	0	116
600	0	0	115	0	0	115
601	0	117	1	0	0	118
602	0	2	120	0	0	122
603	121	0	1	0	0	122
604	120	1	0	0	0	121
605	121	0	0	1	0	122
606	1	0	0	121	0	122
607	121	0	1	1	0	123
608	1	118	0	0	0	119
609	0	119	0	1	0	120
610	119	1	1	0	0	121
611	1	0	121	1	0	123
612	0	0	1	118	0	119
613	0	1	124	1	0	126
614	0	0	121	1	0	122
615	0	124	1	1	0	126
616	0	1	1	121	0	123
617	1	0	0	130	0	131
618	129	0	0	1	0	130
619	1	126	0	0	0	127
620	0	131	0	0	0	131
621	0	1	131	1	0	133
622	0	131	1	1	0	133
623	130	1	0	0	0	131
624	129	0	0	1	0	130
625	1	0	132	0	0	133
626	0	0	132	1	0	133
627	0	0	2	125	0	127
628	0	0	1	124	0	125
629	0	125	1	1	0	127
630	0	2	0	129	0	131
631	0	0	1	129	0	130
632	1	128	0	1	0	130
633	1	1	0	122	0	124
634	1	0	0	119	0	120
635	0	117	0	2	0	119
636	0	1	115	0	0	116
637	0	0	1	120	0	121
638	120	1	0	1	0	122
639	119	0	0	0	0	119
640	1	0	119	0	0	120
641	117	0	1	1	0	119
642	121	0	0	0	0	121
643	1	122	1	0	0	124
644	0	2	116	0	0	118
645	0	0	118	1	0	119
646	0	0	1	121	0	122
647	124	0	0	1	0	125
648	129	1	0	0	0	130
649	1	1	0	147	0	149
650	156	0	1	1	0	158
651	157	1	0	1	0	159
652	155	0	0	1	0	156
653	2	0	157	0	0	159
654	0	0	150	0	0	150
655	151	0	0	0	0	151
656	0	0	152	0	0	152
657	0	141	0	0	0	141
658	0	0	0	142	0	142
659	0	0	141	0	0	141
660	0	0	142	0	0	142
661	0	4	0	132	0	136
662	0	0	144	0	0	144
663	0	0	139	0	0	139
664	0	137	0	0	0	137
665	0	136	0	0	0	136
666	132	0	0	2	0	134
667	0	0	0	132	0	132
668	137	0	0	0	0	137
669	1	0	136	0	0	137
670	1	0	0	134	0	135
671	1	0	0	135	0	136
672	133	0	1	0	0	134
673	0	135	1	0	0	136
674	1	0	133	0	0	134
675	0	0	130	0	0	130
676	0	131	0	0	0	131
677	0	0	129	2	0	131
678	1	127	1	0	0	129
679	1	121	1	2	0	125
680	1	0	126	1	0	128
681	126	0	1	0	0	127
682	0	0	2	128	0	130
683	2	131	0	0	0	133
684	0	1	1	132	0	134
685	132	1	0	0	0	133
686	127	0	0	2	0	129
687	128	0	1	0	0	129
688	0	0	131	0	0	131
689	0	0	1	126	0	127
690	1	127	1	1	0	130
691	131	0	1	0	0	132
692	0	2	0	132	0	134
693	0	1	1	129	0	131
694	1	0	2	132	0	135
695	0	1	134	1	0	136
696	131	0	1	1	0	133
697	0	134	1	0	0	135
698	0	1	0	131	0	132
699	0	1	1	130	0	132
700	130	1	0	0	0	131
701	1	1	125	1	0	128
702	0	1	128	1	0	130
703	1	131	1	1	0	134
704	1	1	135	0	0	137
705	129	0	1	1	0	131
706	0	136	0	1	0	137
707	1	1	133	0	0	135
708	125	1	1	0	0	127
709	1	1	137	0	0	139
710	1	137	1	0	0	139
711	0	2	0	136	0	138
712	0	0	1	138	0	139
713	1	1	133	1	0	136
714	1	1	135	0	0	137
715	2	131	0	0	0	133
716	132	1	1	0	0	134
717	0	135	0	3	0	138
718	0	1	0	137	0	138
719	2	0	131	1	0	134
720	126	0	1	1	0	128
721	1	0	1	135	0	137
722	1	134	0	1	0	136
723	0	134	1	0	0	135
724	2	0	0	136	0	138
725	0	0	1	135	0	136
726	133	0	1	1	0	135
727	2	0	0	135	0	137
728	1	1	132	2	0	136
729	131	0	1	1	0	133
730	134	0	1	1	0	136
731	1	1	139	1	0	142
732	137	1	2	0	0	140
733	1	0	1	142	0	144
734	0	2	0	142	0	144
735	2	0	1	141	0	144
736	1	1	1	137	0	140
737	0	139	2	1	0	142
738	142	2	1	0	0	145
739	144	0	1	1	0	146
740	1	0	144	2	0	147
741	149	2	2	0	0	153
742	149	1	2	0	0	152
743	152	1	0	0	0	153
744	154	0	1	1	0	156
745	1	161	0	0	0	162
746	0	0	0	153	0	153
747	0	0	150	1	0	151
748	3	0	145	0	0	148
749	117	1	2	0	0	120
750	115	0	0	1	0	116
751	0	114	1	0	0	115
752	112	0	1	0	0	113
753	1	113	0	0	0	114
754	1	0	0	114	0	115
755	120	1	0	0	0	121
756	121	0	0	0	0	121
757	121	1	0	0	0	122
758	0	120	0	2	0	122
759	121	0	0	1	0	122
760	1	0	0	121	0	122
761	120	1	0	0	0	121
762	1	1	113	0	0	115
763	2	116	0	0	0	118
764	115	0	0	1	0	116
765	2	0	115	0	0	117
766	1	0	1	114	0	116
767	1	1	119	0	0	121
768	2	0	116	0	0	118
769	0	1	1	111	0	113
770	0	0	117	2	0	119
771	0	0	2	116	0	118
772	0	0	1	119	0	120
773	120	0	0	1	0	121
774	1	119	1	0	0	121
775	0	120	0	1	0	121
776	1	122	0	1	0	124
777	1	1	126	0	0	128
778	0	1	0	124	0	125
779	1	1	127	0	0	129
780	122	1	0	0	0	123
781	124	0	1	0	0	125
782	0	127	0	1	0	128
783	1	0	1	127	0	129
784	1	127	0	1	0	129
785	127	0	0	0	0	127
786	0	1	0	126	0	127
787	0	0	130	0	0	130
788	1	131	0	0	0	132
789	1	0	130	0	0	131
790	0	0	0	127	0	127
791	0	0	128	0	0	128
792	125	1	1	0	0	127
793	0	0	129	1	0	130
794	0	133	1	1	0	135
795	0	0	1	134	0	135
796	1	0	0	133	0	134
797	134	0	0	0	0	134
798	133	2	0	0	0	135
799	0	132	0	1	0	133
800	0	1	132	1	0	134
801	1	0	129	0	0	130
802	131	0	0	1	0	132
803	0	1	130	0	0	131
804	1	0	123	0	0	124
805	1	0	128	0	0	129
806	1	1	126	0	0	128
807	0	129	1	0	0	130
808	129	1	0	0	0	130
809	1	0	1	125	0	127
810	126	0	1	1	0	128
811	0	128	1	0	0	129
812	127	1	0	0	0	128
813	0	127	1	1	0	129
814	1	0	0	130	0	131
815	0	130	2	0	0	132
816	2	0	127	0	0	129
817	0	127	0	0	0	127
818	1	1	0	147	0	149
819	148	1	0	2	0	151
820	1	0	0	149	0	150
821	1	1	144	0	0	146
822	1	0	0	141	0	142
823	1	144	0	0	0	145
824	0	0	147	1	0	148
825	142	0	2	0	0	144
826	1	0	0	153	0	154
827	151	1	1	0	0	153
828	151	0	1	0	0	152
829	1	154	1	2	0	158
830	153	0	1	1	0	155
831	155	1	0	0	0	156
832	2	154	0	0	0	156
833	0	0	0	151	0	151
834	1	0	0	153	0	154
835	1	155	0	0	0	156
836	0	1	1	156	0	158
837	0	0	155	1	0	156
838	1	0	0	150	0	151
839	0	1	152	0	0	153
840	0	0	143	1	0	144
841	0	145	1	0	0	146
842	0	143	0	1	0	144
843	0	146	1	0	0	147
844	2	0	2	136	0	140
845	0	0	140	0	0	140
846	133	1	0	1	0	135
847	0	0	0	142	0	142
848	0	0	139	0	0	139
849	0	0	138	0	0	138
850	0	141	0	0	0	141
851	0	7	0	137	0	144
852	142	0	0	0	0	142
853	0	138	0	0	0	138
854	0	135	0	2	0	137
855	0	129	0	0	0	129
856	0	0	0	134	0	134
857	0	133	0	0	0	133
858	0	0	0	138	0	138
859	0	0	0	139	0	139
860	0	0	140	0	0	140
861	136	0	0	0	0	136
862	1	0	147	0	0	148
863	0	0	2	147	0	149
864	1	0	151	0	0	152
865	0	150	1	0	0	151
866	149	1	0	2	0	152
867	1	0	1	152	0	154
868	0	0	0	154	0	154
869	151	1	0	1	0	153
870	151	0	1	0	0	152
871	157	0	0	1	0	158
872	1	0	158	1	0	160
873	149	0	0	1	0	150
874	2	154	1	0	0	157
875	0	154	0	1	0	155
876	1	1	1	152	0	155
877	1	1	0	147	0	149
878	1	149	1	0	0	151
879	2	1	0	148	0	151
880	146	0	0	2	0	148
881	2	1	148	1	0	152
882	0	145	1	1	0	147
883	138	2	1	0	0	141
884	2	143	1	1	0	147
885	0	1	145	1	0	147
886	0	1	2	141	0	144
887	1	2	139	1	0	143
888	1	139	1	1	0	142
889	1	2	0	140	0	143
890	0	1	141	2	0	144
891	1	0	140	1	0	142
892	2	0	1	139	0	142
893	140	1	1	2	0	144
894	139	0	1	1	0	141
895	140	0	1	1	0	142
896	0	2	142	0	0	144
897	0	143	2	2	0	147
898	1	2	0	142	0	145
899	0	1	1	141	0	143
900	0	147	0	1	0	148
901	145	2	0	1	0	148
902	1	1	1	146	0	149
903	0	1	147	1	0	149
904	0	148	1	3	0	152
905	140	1	1	1	0	143
906	2	141	1	0	0	144
907	2	1	0	143	0	146
908	0	0	2	141	0	143
909	0	1	1	144	0	146
910	0	0	142	3	0	145
911	1	1	1	138	0	141
912	2	136	0	1	0	139
913	2	137	0	1	0	140
914	0	1	135	0	0	136
915	131	1	1	0	0	133
916	130	1	0	2	0	133
917	2	132	0	1	0	135
918	112	3	0	0	0	115
919	112	0	0	1	0	113
920	1	120	0	2	0	123
921	0	1	1	125	0	127
922	0	1	135	1	0	137
923	1	0	129	1	0	131
924	138	2	1	0	0	141
925	1	142	0	1	0	144
926	0	1	1	139	0	141
927	1	0	0	139	0	140
928	1	0	1	137	0	139
929	135	1	0	2	0	138
930	2	1	0	130	0	133
931	1	1	0	132	0	134
932	0	1	133	1	0	135
933	127	0	1	1	0	129
934	2	130	1	0	0	133
935	126	2	1	0	0	129
936	3	119	0	0	0	122
937	1	2	0	126	0	129
938	125	1	0	2	0	128
939	124	0	0	2	0	126
940	1	0	122	1	0	124
941	128	0	2	0	0	130
942	2	0	127	1	0	130
943	1	1	121	1	0	124
944	0	0	122	1	0	123
945	1	0	127	1	0	129
946	0	4	2	133	0	139
947	1	0	132	2	0	135
948	1	1	2	131	0	135
949	135	0	0	4	0	139
950	2	0	1	132	0	135
951	134	0	0	2	0	136
952	2	130	1	0	0	133
953	3	2	0	129	0	134
954	2	0	133	1	0	136
955	0	138	3	1	0	142
956	1	3	1	138	0	143
957	0	0	139	2	0	141
958	0	137	3	1	0	141
959	1	141	1	0	0	143
960	0	2	139	0	0	141
961	0	0	1	137	0	138
962	0	0	131	1	0	132
963	128	0	1	0	0	129
964	128	0	0	0	0	128
965	1	125	0	0	0	126
966	126	1	0	0	0	127
967	2	0	0	123	0	125
968	0	0	123	1	0	124
969	120	0	1	0	0	121
970	1	0	122	0	0	123
971	0	123	1	0	0	124
972	126	2	0	0	0	128
973	1	0	0	125	0	126
974	0	0	126	1	0	127
975	126	0	1	0	0	127
976	123	0	0	0	0	123
977	127	0	0	0	0	127
978	1	0	0	127	0	128
979	0	0	0	128	0	128
980	0	0	127	1	0	128
981	0	128	1	0	0	129
982	0	1	0	127	0	128
983	0	0	0	130	0	130
984	0	0	130	1	0	131
985	0	0	129	0	0	129
986	0	0	1	130	0	131
987	129	0	0	1	0	130
988	1	127	0	0	0	128
989	130	1	0	0	0	131
990	1	129	0	0	0	130
991	0	1	127	0	0	128
992	0	0	130	0	0	130
993	129	0	1	0	0	130
994	135	0	0	0	0	135
995	1	138	0	0	0	139
996	1	1	131	0	0	133
997	0	1	1	128	0	130
998	0	0	1	130	0	131
999	0	134	0	2	0	136
1000	0	1	0	132	0	133
1001	0	3	131	1	0	135
1002	131	0	1	1	0	133
1003	129	0	1	0	0	130
1004	128	0	0	0	0	128
1005	131	0	0	0	0	131
1006	2	1	127	0	0	130
1007	128	0	1	0	0	129
1008	1	0	129	0	0	130
1009	1	129	1	0	0	131
1010	0	1	1	127	0	129
1011	130	1	0	1	0	132
1012	1	0	0	141	0	142
1013	1	0	141	1	0	143
1014	141	0	1	1	0	143
1015	142	0	1	0	0	143
1016	2	0	0	142	0	144
1017	1	0	0	145	0	146
1018	0	1	143	2	0	146
1019	0	146	1	1	0	148
1020	137	1	1	0	0	139
1021	1	1	129	0	0	131
1022	126	0	1	1	0	128
1023	1	128	2	0	0	131
1024	119	1	0	0	0	120
1025	2	116	0	0	0	118
1026	1	115	0	0	0	116
1027	1	2	0	113	0	116
1028	0	1	0	118	0	119
1029	0	0	1	119	0	120
1030	1	0	0	120	0	121
1031	0	0	116	2	0	118
1032	114	1	1	1	0	117
1033	118	0	1	0	0	119
1034	125	0	0	1	0	126
1035	2	0	0	122	0	124
1036	2	0	0	123	0	125
1037	122	0	0	2	0	124
1038	122	0	0	1	0	123
1039	122	0	0	1	0	123
1040	3	0	0	118	0	121
1041	2	0	0	117	0	119
1042	0	1	112	1	0	114
1043	0	0	113	2	0	115
1044	0	112	1	1	0	114
1045	103	0	2	2	0	107
1046	96	1	2	0	0	99
1047	96	0	0	1	0	97
1048	2	0	98	0	0	100
1049	99	1	0	0	0	100
1050	99	0	1	0	0	100
1051	100	1	0	0	0	101
1052	1	0	1	98	0	100
1053	1	0	1	99	0	101
1054	1	0	0	96	0	97
1055	0	0	89	1	0	90
1056	83	1	0	1	0	85
1057	0	88	2	0	0	90
1058	84	0	0	0	0	84
1059	0	81	0	0	0	81
1060	0	76	0	0	0	76
1061	0	1	0	77	0	78
1062	0	1	0	75	0	76
1063	0	75	0	2	0	77
1064	75	0	0	1	0	76
1065	74	1	0	0	0	75
1066	1	0	0	75	0	76
1067	1	0	73	0	0	74
1068	0	0	69	1	0	70
1069	0	0	77	0	0	77
1070	0	0	75	0	0	75
1071	69	1	1	0	0	71
1072	66	0	1	0	0	67
1073	1	0	0	65	0	66
1074	1	0	64	0	0	65
1075	0	0	0	67	0	67
1076	0	66	1	0	0	67
1077	0	75	0	1	0	76
1078	78	1	0	1	0	80
1079	78	1	0	1	0	80
1080	78	0	1	0	0	79
1081	2	0	0	77	0	79
1082	3	0	0	78	0	81
1083	0	0	0	83	0	83
1084	0	0	0	81	0	81
1085	0	0	81	1	0	82
1086	0	1	0	81	0	82
1087	82	0	1	0	0	83
1088	0	0	0	82	0	82
1089	2	0	0	81	0	83
1090	0	1	0	81	0	82
1091	1	78	0	2	0	81
1092	0	77	0	1	0	78
1093	0	80	0	0	0	80
1094	0	1	0	71	0	72
1095	0	0	0	74	0	74
1096	72	0	0	2	0	74
1097	72	0	0	1	0	73
1098	71	0	1	0	0	72
1099	3	0	0	69	0	72
1100	1	0	0	70	0	71
1101	1	65	0	1	0	67
1102	0	68	0	1	0	69
1103	68	1	0	1	0	70
1104	2	0	0	67	0	69
1105	66	0	0	1	0	67
1106	70	0	0	0	0	70
1107	1	0	0	70	0	71
1108	0	70	0	2	0	72
1109	69	1	1	0	0	71
1110	71	0	1	0	0	72
1111	1	1	69	0	0	71
1112	61	0	1	0	0	62
1113	1	59	0	0	0	60
1114	0	1	0	60	0	61
1115	68	0	0	1	0	69
1116	1	0	0	67	0	68
1117	1	0	0	67	0	68
1118	0	69	0	1	0	70
1119	68	1	0	1	0	70
1120	69	0	0	0	0	69
1121	1	67	0	0	0	68
1122	0	70	0	0	0	70
1123	73	1	0	0	0	74
1124	73	0	0	1	0	74
1125	1	0	69	0	0	70
1126	0	0	66	0	0	66
1127	0	0	68	0	0	68
1128	0	0	1	68	0	69
1129	0	0	0	71	0	71
1130	0	0	68	1	0	69
1131	67	0	1	0	0	68
1132	73	0	0	0	0	73
1133	73	0	0	0	0	73
1134	70	0	0	0	0	70
1135	1	0	77	0	0	78
1136	81	0	1	0	0	82
1137	88	0	0	0	0	88
1138	89	0	0	1	0	90
1139	91	0	0	1	0	92
1140	89	0	0	1	0	90
1141	1	0	90	1	0	92
1142	0	91	1	0	0	92
1143	0	2	0	89	0	91
1144	0	1	0	91	0	92
1145	0	0	90	2	0	92
1146	85	0	1	1	0	87
1147	2	0	0	97	0	99
1148	1	0	100	1	0	102
1149	1	0	94	0	0	95
1150	0	104	1	1	0	106
1151	0	1	0	115	0	116
1152	0	1	0	115	0	116
1153	1	1	0	112	0	114
1154	116	0	0	1	0	117
1155	1	0	0	116	0	117
1156	1	0	112	1	0	114
1157	1	0	105	0	0	106
1158	0	1	115	0	0	116
1159	0	1	1	123	0	125
1160	125	0	0	2	0	127
1161	2	0	132	0	0	134
1162	129	0	2	0	0	131
1163	149	0	0	0	0	149
1164	3	1	0	149	0	153
1165	0	0	0	154	0	154
1166	1	155	0	1	0	157
1167	0	1	157	1	0	159
1168	149	0	1	2	0	152
1169	2	1	0	158	0	161
1170	1	158	0	1	0	160
1171	1	1	0	158	0	160
1172	0	0	156	1	0	157
1173	0	1	1	154	0	156
1174	1	157	0	1	0	159
1175	1	1	0	156	0	158
1176	157	0	1	1	0	159
1177	1	0	1	149	0	151
1178	0	145	1	1	0	147
1179	0	150	0	1	0	151
1180	145	1	0	1	0	147
1181	1	0	152	0	0	153
1182	1	0	1	147	0	149
1183	1	0	0	154	0	155
1184	1	0	163	1	0	165
1185	1	160	1	0	0	162
1186	0	1	165	0	0	166
1187	0	0	1	164	0	165
1188	0	171	0	1	0	172
1189	175	0	0	0	0	175
1190	0	174	0	0	0	174
1191	0	181	0	0	0	181
1192	183	0	0	2	0	185
1193	184	0	0	0	0	184
1194	187	0	0	0	0	187
1195	1	0	0	188	0	189
1196	0	0	188	0	0	188
1197	196	0	0	0	0	196
1198	209	0	0	0	0	209
1199	1	0	0	223	0	224
1200	0	0	226	0	0	226
1201	0	226	0	0	0	226
1202	226	0	0	1	0	227
1203	243	0	0	1	0	244
1204	0	247	0	0	0	247
1205	0	250	0	2	0	252
1206	251	0	0	0	0	251
1207	248	0	0	0	0	248
1208	249	0	0	0	0	249
1209	0	0	0	246	0	246
1210	0	0	257	0	0	257
1211	0	0	0	255	0	255
1212	0	0	257	0	0	257
1213	0	249	1	0	0	250
1214	0	260	0	1	0	261
1215	0	0	0	252	0	252
1216	2	0	0	249	0	251
1217	1	0	0	247	0	248
1218	0	254	0	1	0	255
1219	253	0	1	0	0	254
1220	251	1	0	0	0	252
1221	1	260	0	0	0	261
1222	1	0	0	252	0	253
1223	0	252	0	0	0	252
1224	0	2	0	247	0	249
1225	1	253	0	0	0	254
1226	255	0	0	1	0	256
1227	1	0	0	252	0	253
1228	0	0	256	1	0	257
1229	252	0	1	0	0	253
1230	257	0	0	1	0	258
1231	0	0	255	0	0	255
1232	1	1	0	253	0	255
1233	0	1	258	0	0	259
1234	0	0	0	255	0	255
1235	2	0	245	1	0	248
1236	239	0	0	1	0	240
1237	0	1	0	242	0	243
1238	1	249	0	0	0	250
1239	252	0	0	0	0	252
1240	0	1	0	254	0	255
1241	0	0	0	252	0	252
1242	0	1	248	0	0	249
1243	0	0	0	263	0	263
1244	0	0	263	0	0	263
1245	1	0	270	1	0	272
1246	0	0	1	282	0	283
1247	0	0	296	0	0	296
1248	303	0	0	1	0	304
1249	348	0	1	1	0	350
1250	364	0	1	1	0	366
1251	3	365	0	1	0	369
1252	4	0	1	367	0	372
1253	2	3	0	357	0	362
1254	1	369	1	3	0	374
1255	375	2	0	2	0	379
1256	1	4	0	370	0	375
1257	4	1	378	2	0	385
1258	2	2	369	4	0	377
1259	1	371	4	2	0	378
1260	375	0	4	2	0	381
1261	0	3	370	2	0	375
1262	365	0	3	1	0	369
1263	0	350	5	0	0	355
1264	4	3	354	0	0	361
1265	2	4	341	2	0	349
1266	2	0	357	1	0	360
1267	3	348	3	1	0	355
1268	1	3	358	0	0	362
1269	344	3	2	1	0	350
1270	3	1	5	338	0	347
1271	4	1	1	350	0	356
1272	0	1	1	354	0	356
1273	1	2	2	353	0	358
1274	2	0	350	6	0	358
1275	1	1	0	355	0	357
1276	1	1	3	352	0	357
1277	346	1	1	8	0	356
1278	346	1	2	6	0	355
1279	347	0	1	4	0	352
1280	4	0	350	3	0	357
1281	4	353	2	1	0	360
1282	3	359	2	1	0	365
1283	357	3	2	0	0	362
1284	1	352	2	2	0	357
1285	3	1	3	351	0	358
1286	1	6	0	350	0	357
1287	1	2	352	4	0	359
1288	2	340	0	4	0	346
1289	1	2	341	2	0	346
1290	332	3	0	5	0	340
1291	335	1	5	4	0	345
1292	7	1	2	336	0	346
1293	6	1	2	337	0	346
1294	1	1	4	338	0	344
1295	2	1	1	342	0	346
1296	2	0	340	6	0	348
1297	1	4	1	327	0	333
1298	2	0	331	2	0	335
1299	0	0	309	7	0	316
1300	0	306	5	2	0	313
1301	307	1	3	2	0	313
1302	1	312	1	2	0	316
1303	4	1	4	294	0	303
1304	0	4	312	2	0	318
1305	302	1	2	3	0	308
1306	3	2	313	0	0	318
1307	316	1	2	1	0	320
1308	313	1	5	2	0	321
1309	5	1	1	320	0	327
1310	4	1	1	309	0	315
1311	1	1	2	315	0	319
1312	5	0	306	4	0	315
1313	301	0	2	7	0	310
1314	2	297	5	2	0	306
1315	4	1	3	306	0	314
1316	306	4	1	4	0	315
1317	308	0	2	4	0	314
1318	310	0	1	2	0	313
1319	5	4	301	2	0	312
1320	308	1	1	3	0	313
1321	305	1	4	2	0	312
1322	7	1	282	1	0	291
1323	6	0	300	0	0	306
1324	2	1	5	305	0	313
1325	4	1	311	1	0	317
1326	4	293	4	3	0	304
1327	1	308	5	2	0	316
1328	299	3	1	4	0	307
1329	1	304	3	5	0	313
1330	4	1	3	305	0	313
1331	298	4	2	3	0	307
1332	2	303	3	4	0	312
1333	6	3	2	296	0	307
1334	2	5	1	302	0	310
1335	3	0	299	6	0	308
1336	4	2	2	300	0	308
1337	1	2	300	4	0	307
1338	1	1	289	8	0	299
1339	0	2	6	289	0	297
1340	3	0	4	291	0	298
1341	287	1	3	7	0	298
1342	2	309	5	4	0	320
1343	4	3	1	304	0	312
1344	2	8	2	301	0	313
1345	293	2	1	6	0	302
1346	4	276	1	7	0	288
1347	3	260	2	2	0	267
1348	4	240	0	2	0	246
1349	1	205	0	1	0	207
1350	175	2	2	2	0	181
1351	177	0	1	1	0	179
1352	174	0	0	1	0	175
1353	173	1	0	1	0	175
1354	2	1	1	170	0	174
1355	1	1	166	2	0	170
1356	1	167	2	0	0	170
1357	1	2	1	161	0	165
1358	1	0	158	2	0	161
1359	2	0	2	157	0	161
1360	2	0	1	156	0	159
1361	0	1	151	3	0	155
1362	1	1	3	148	0	153
1363	2	1	0	143	0	146
1364	152	1	0	3	0	156
1365	147	0	1	1	0	149
1366	147	0	0	1	0	148
1367	148	1	0	1	0	150
1368	2	0	1	147	0	150
1369	0	0	0	151	0	151
1370	0	0	1	146	0	147
1371	145	0	0	3	0	148
1372	3	0	1	143	0	147
1373	1	0	1	145	0	147
1374	1	0	142	3	0	146
1375	0	0	2	141	0	143
1376	2	135	1	3	0	141
1377	1	144	1	1	0	147
1378	143	2	0	1	0	146
1379	2	0	140	2	0	144
1380	0	134	2	2	0	138
1381	129	2	2	0	0	133
1382	4	0	0	130	0	134
1383	0	1	128	2	0	131
1384	0	0	2	127	0	129
1385	0	135	0	2	0	137
1386	133	2	0	1	0	136
1387	3	135	0	0	0	138
1388	135	4	0	1	0	140
1389	141	0	0	1	0	142
1390	3	0	0	140	0	143
1391	0	0	1	137	0	138
1392	0	136	0	4	0	140
1393	133	2	1	1	0	137
1394	3	0	135	0	0	138
1395	126	1	2	0	0	129
1396	126	0	0	1	0	127
1397	4	0	124	0	0	128
1398	0	2	2	114	0	118
1399	114	0	0	3	0	117
1400	2	0	115	1	0	118
1401	0	0	115	0	0	115
1402	108	1	2	0	0	111
1403	2	110	0	0	0	112
1404	0	95	0	1	0	96
1405	0	3	1	90	0	94
1406	1	0	93	2	0	96
1407	85	0	2	1	0	88
1408	3	0	86	0	0	89
1409	1	82	2	0	0	85
1410	81	2	1	1	0	85
1411	3	0	0	80	0	83
1412	81	1	0	2	0	84
1413	2	0	81	1	0	84
1414	1	0	3	79	0	83
1415	0	80	0	3	0	83
1416	0	2	0	81	0	83
1417	0	0	1	82	0	83
1418	0	0	83	3	0	86
1419	0	80	2	1	0	83
1420	0	81	0	0	0	81
1421	0	2	78	0	0	80
1422	75	1	3	0	0	79
1423	77	0	0	0	0	77
1424	2	0	0	71	0	73
1425	69	0	0	2	0	71
1426	2	67	0	0	0	69
1427	0	69	0	0	0	69
1428	68	2	0	0	0	70
1429	2	0	0	68	0	70
1430	69	0	0	2	0	71
1431	71	0	0	0	0	71
1432	2	0	0	69	0	71
1433	0	1	69	2	0	72
1434	70	0	2	0	0	72
1435	70	0	0	0	0	70
1436	2	0	0	69	0	71
1437	0	68	0	2	0	70
1438	0	2	0	68	0	70
1439	0	0	68	2	0	70
1440	0	0	66	0	0	66
1441	0	68	2	0	0	70
1442	1	1	0	42	0	44
1443	0	0	0	42	0	42
1444	0	0	41	1	0	42
1445	40	0	1	0	0	41
1446	42	0	0	0	0	42
1447	40	0	0	0	0	40
1448	38	0	0	0	0	38
1449	1	38	0	0	0	39
1450	0	38	0	0	0	38
1451	39	1	0	0	0	40
1452	1	0	0	42	0	43
1453	0	0	0	42	0	42
1454	0	42	0	1	0	43
1455	1	1	0	42	0	44
1456	0	0	0	44	0	44
1457	0	43	0	1	0	44
1458	0	1	43	0	0	44
1459	0	0	1	43	0	44
1460	43	0	0	1	0	44
1461	43	0	0	0	0	43
1462	1	0	43	0	0	44
1463	0	0	43	0	0	43
1464	0	0	43	0	0	43
1465	0	0	1	43	0	44
1466	0	0	43	1	0	44
1467	0	0	43	0	0	43
1468	0	1	1	41	0	43
1469	0	40	0	1	0	41
1470	0	1	42	0	0	43
1471	0	42	1	0	0	43
1472	41	1	0	0	0	42
1473	1	42	0	0	0	43
1474	0	1	0	39	0	40
1475	39	0	0	1	0	40
1476	1	0	0	39	0	40
1477	1	0	0	39	0	40
1478	0	0	40	1	0	41
1479	0	39	1	0	0	40
1480	0	38	0	0	0	38
1481	0	1	0	35	0	36
1482	0	0	0	36	0	36
1483	0	0	0	35	0	35
1484	0	0	35	0	0	35
1485	0	0	31	0	0	31
1486	28	0	1	0	0	29
1487	0	0	27	0	0	27
1488	0	0	29	0	0	29
1489	0	29	0	0	0	29
1490	0	0	0	27	0	27
1491	0	0	27	0	0	27
1492	0	0	0	27	0	27
1493	0	0	28	0	0	28
1494	0	0	0	28	0	28
1495	0	0	28	0	0	28
1496	0	0	0	29	0	29
1497	0	0	0	28	0	28
1498	0	29	0	0	0	29
1499	0	0	0	30	0	30
1500	0	29	0	0	0	29
1501	0	0	0	30	0	30
1502	0	0	0	30	0	30
1503	30	0	0	0	0	30
1504	0	0	0	30	0	30
1505	0	0	30	0	0	30
1506	0	0	0	29	0	29
1507	0	0	0	29	0	29
1508	0	0	29	0	0	29
1509	0	0	27	0	0	27
1510	0	0	0	28	0	28
1511	0	0	0	29	0	29
1512	0	0	29	0	0	29
1513	0	29	0	0	0	29
1514	0	29	0	0	0	29
1515	29	0	0	0	0	29
1516	0	0	0	26	0	26
1517	27	0	0	0	0	27
1518	25	0	0	0	0	25
1519	0	26	0	0	0	26
1520	25	0	0	0	0	25
1521	25	0	0	0	0	25
1522	0	0	24	0	0	24
1523	0	0	0	26	0	26
1524	0	0	26	0	0	26
1525	0	0	0	26	0	26
1526	0	0	26	0	0	26
1527	0	25	0	0	0	25
1528	0	25	0	0	0	25
1529	0	0	0	25	0	25
1530	26	0	0	0	0	26
1531	0	0	0	26	0	26
1532	0	0	0	26	0	26
1533	0	0	27	0	0	27
1534	0	0	27	0	0	27
1535	0	0	27	0	0	27
1536	0	0	0	26	0	26
1537	0	0	0	27	0	27
1538	0	27	0	0	0	27
1539	0	26	0	0	0	26
1540	27	0	0	0	0	27
1541	0	26	0	0	0	26
1542	0	0	25	0	0	25
1543	0	0	0	25	0	25
1544	0	0	25	0	0	25
1545	0	25	0	0	0	25
1546	0	0	0	25	0	25
1547	24	0	0	0	0	24
1548	0	0	26	0	0	26
1549	0	25	0	0	0	25
1550	0	0	25	0	0	25
1551	0	25	0	0	0	25
1552	0	0	0	21	0	21
1553	22	0	0	0	0	22
1554	22	0	0	0	0	22
1555	0	21	0	0	0	21
1556	21	0	0	0	0	21
1557	0	0	0	21	0	21
1558	21	0	0	0	0	21
1559	0	0	22	0	0	22
1560	0	1	20	0	0	21
1561	1	0	0	18	0	19
1562	0	0	0	23	0	23
1563	0	0	22	0	0	22
1564	0	0	0	22	0	22
1565	23	0	0	0	0	23
1566	22	0	0	0	0	22
1567	0	23	0	0	0	23
1568	0	22	0	0	0	22
1569	23	0	0	0	0	23
1570	0	0	0	26	0	26
1571	25	0	0	0	0	25
1572	0	23	0	0	0	23
1573	26	0	0	0	0	26
1574	0	0	26	0	0	26
1575	0	0	23	0	0	23
1576	0	0	0	26	0	26
1577	0	0	28	0	0	28
1578	0	0	0	27	0	27
1579	0	0	0	26	0	26
1580	0	0	27	0	0	27
1581	1	0	0	25	0	26
1582	0	0	0	28	0	28
1583	0	0	29	0	0	29
1584	0	0	28	0	0	28
1585	30	0	0	0	0	30
1586	0	0	27	0	0	27
1587	30	0	1	0	0	31
1588	33	0	0	0	0	33
1589	1	0	32	0	0	33
1590	0	0	34	0	0	34
1591	0	0	1	32	0	33
1592	0	0	0	34	0	34
1593	0	33	0	0	0	33
1594	0	33	1	0	0	34
1595	0	0	34	0	0	34
1596	33	0	1	0	0	34
1597	35	0	0	0	0	35
1598	1	0	33	0	0	34
1599	0	0	31	0	0	31
1600	0	0	1	30	0	31
1601	0	31	0	1	0	32
1602	0	0	0	31	0	31
1603	0	0	0	32	0	32
1604	32	0	0	1	0	33
1605	32	0	0	0	0	32
1606	1	0	0	33	0	34
1607	0	0	35	1	0	36
1608	35	0	1	0	0	36
1609	1	36	0	0	0	37
1610	36	1	0	0	0	37
1611	37	0	0	0	0	37
1612	1	35	0	0	0	36
1613	0	37	0	0	0	37
1614	0	1	0	36	0	37
1615	0	0	0	37	0	37
1616	0	35	0	1	0	36
1617	0	1	0	35	0	36
1618	0	0	0	36	0	36
1619	0	0	35	1	0	36
1620	35	0	1	0	0	36
1621	38	0	0	0	0	38
1622	38	0	0	0	0	38
1623	1	0	0	35	0	36
1624	35	0	0	1	0	36
1625	1	35	0	0	0	36
1626	1	1	0	34	0	36
1627	0	36	0	1	0	37
1628	0	38	0	0	0	38
1629	34	1	1	2	0	38
1630	36	0	0	0	0	36
1631	36	0	0	0	0	36
1632	36	0	0	0	0	36
1633	34	0	0	0	0	34
1634	1	0	33	0	0	34
1635	33	0	1	0	0	34
1636	1	0	35	0	0	36
1637	33	0	1	0	0	34
1638	36	0	0	0	0	36
1639	36	0	0	1	0	37
1640	1	0	37	0	0	38
1641	0	0	1	34	0	35
1642	1	35	0	0	0	36
1643	38	1	1	0	0	40
1644	40	0	0	0	0	40
1645	2	35	0	0	0	37
1646	38	1	1	0	0	40
1647	1	0	1	37	0	39
1648	0	35	0	1	0	36
1649	36	1	0	1	0	38
1650	36	1	0	0	0	37
1651	1	1	0	35	0	37
1652	36	0	1	1	0	38
1653	2	0	1	36	0	39
1654	1	0	1	38	0	40
1655	0	0	37	2	0	39
1656	0	0	3	38	0	41
1657	0	1	0	40	0	41
1658	0	2	37	1	0	40
1659	0	1	38	2	0	41
1660	1	1	1	37	0	40
1661	2	0	38	1	0	41
1662	36	0	2	0	0	38
1663	2	37	1	1	0	41
1664	0	1	2	39	0	42
1665	1	1	1	39	0	42
1666	0	1	0	40	0	41
1667	39	1	0	1	0	41
1668	41	0	0	1	0	42
1669	38	1	0	1	0	40
1670	2	34	0	1	0	37
1671	1	0	1	35	0	37
1672	2	0	0	34	0	36
1673	33	2	1	1	0	37
1674	36	0	0	1	0	37
1675	2	1	0	34	0	37
1676	1	1	33	1	0	36
1677	31	1	1	0	0	33
1678	32	1	0	1	0	34
1679	2	1	32	0	0	35
1680	31	1	1	2	0	35
1681	1	0	31	2	0	34
1682	31	1	1	1	0	34
1683	1	0	1	36	0	38
1684	1	36	0	2	0	39
1685	1	1	39	0	0	41
1686	2	39	1	0	0	42
1687	1	36	0	1	0	38
1688	42	0	0	0	0	42
1689	0	0	0	45	0	45
1690	0	0	0	42	0	42
1691	45	0	0	0	0	45
1692	0	0	0	45	0	45
1693	0	0	0	46	0	46
1694	0	0	0	45	0	45
1695	0	0	0	44	0	44
1696	0	0	45	0	0	45
1697	0	0	45	0	0	45
1698	0	44	0	0	0	44
1699	43	0	0	1	0	44
1700	0	0	0	44	0	44
1701	0	46	0	0	0	46
1702	0	0	0	48	0	48
1703	0	0	0	49	0	49
1704	0	0	0	50	0	50
1705	0	0	0	50	0	50
1706	0	0	0	50	0	50
1707	0	47	0	0	0	47
1708	0	0	0	48	0	48
1709	0	0	50	0	0	50
1710	0	50	0	0	0	50
1711	0	0	0	51	0	51
1712	0	0	0	50	0	50
1713	0	51	0	0	0	51
1714	0	49	0	0	0	49
1715	51	0	0	0	0	51
1716	0	50	0	0	0	50
1717	49	0	0	1	0	50
1718	49	0	0	0	0	49
1719	0	0	54	0	0	54
1720	0	0	0	50	0	50
1721	0	0	55	0	0	55
1722	0	54	0	0	0	54
1723	0	0	0	54	0	54
1724	0	0	0	56	0	56
1725	0	0	0	56	0	56
1726	0	0	0	57	0	57
1727	0	0	58	0	0	58
1728	0	0	0	57	0	57
1729	0	0	60	0	0	60
1730	0	0	56	0	0	56
1731	55	0	0	0	0	55
1732	60	0	0	0	0	60
1733	57	0	0	0	0	57
1734	0	57	1	0	0	58
1735	0	0	0	59	0	59
1736	0	0	59	0	0	59
1737	0	0	0	65	0	65
1738	0	0	61	0	0	61
1739	67	0	0	0	0	67
1740	65	0	0	0	0	65
1741	67	0	0	0	0	67
1742	0	0	66	0	0	66
1743	0	0	66	0	0	66
1744	0	0	0	67	0	67
1745	0	0	0	67	0	67
1746	0	0	0	71	0	71
1747	0	0	73	0	0	73
1748	0	0	70	0	0	70
1749	73	0	0	0	0	73
1750	0	0	0	79	0	79
1751	0	0	0	79	0	79
1752	82	0	0	1	0	83
1753	0	0	0	84	0	84
1754	93	0	0	0	0	93
1755	96	0	0	0	0	96
1756	93	0	0	0	0	93
1757	0	0	97	0	0	97
1758	0	97	0	0	0	97
1759	105	0	0	2	0	107
1760	0	0	0	107	0	107
1761	0	1	0	107	0	108
1762	0	108	0	0	0	108
1763	109	0	0	1	0	110
1764	109	0	0	2	0	111
1765	114	0	0	0	0	114
1766	0	115	0	0	0	115
1767	122	0	0	0	0	122
1768	122	0	0	0	0	122
1769	122	0	0	0	0	122
1770	0	0	0	121	0	121
1771	0	0	0	122	0	122
1772	0	0	129	0	0	129
1773	0	0	0	131	0	131
1774	0	0	0	132	0	132
1775	0	0	133	0	0	133
1776	129	0	0	0	0	129
1777	133	0	0	0	0	133
1778	0	0	0	133	0	133
1779	0	129	0	0	0	129
1780	0	133	0	0	0	133
1781	0	0	0	134	0	134
1782	0	0	130	0	0	130
1783	0	0	0	127	0	127
1784	0	0	136	0	0	136
1785	1	0	148	0	0	149
1786	0	0	0	151	0	151
1787	156	0	0	0	0	156
1788	158	0	0	0	0	158
1789	0	0	0	163	0	163
1790	0	0	0	164	0	164
1791	0	0	0	164	0	164
1792	1	0	0	163	0	164
1793	166	0	0	0	0	166
1794	166	0	0	0	0	166
1795	163	0	0	1	0	164
1796	0	0	170	0	0	170
1797	0	0	0	170	0	170
1798	0	0	0	172	0	172
1799	171	0	0	1	0	172
1800	0	171	0	0	0	171
1801	180	0	0	1	0	181
1802	179	0	0	1	0	180
1803	181	0	0	0	0	181
1804	178	0	0	0	0	178
1805	0	0	183	0	0	183
1806	0	0	178	0	0	178
1807	185	0	1	0	0	186
1808	195	0	0	0	0	195
1809	191	0	0	0	0	191
1810	189	0	0	1	0	190
1811	0	0	207	0	0	207
1812	0	207	0	0	0	207
1813	0	0	0	224	0	224
1814	242	0	0	2	0	244
1815	244	0	0	1	0	245
1816	250	0	0	0	0	250
1817	252	0	0	3	0	255
1818	255	0	0	0	0	255
1819	246	0	0	0	0	246
1820	2	0	244	0	0	246
1821	1	0	244	0	0	245
1822	2	0	1	242	0	245
1823	1	0	250	1	0	252
1824	0	248	2	0	0	250
1825	0	262	1	0	0	263
1826	0	2	0	272	0	274
1827	0	0	275	1	0	276
1828	0	1	270	0	0	271
1829	263	1	2	0	0	266
1830	292	0	0	1	0	293
1831	3	0	1	296	0	300
1832	304	0	0	2	0	306
1833	3	0	0	306	0	309
1834	2	0	0	305	0	307
1835	0	0	311	4	0	315
1836	1	0	306	1	0	308
1837	0	0	4	305	0	309
1838	0	1	308	3	0	312
1839	293	0	3	2	0	298
1840	306	0	2	2	0	310
1841	4	302	0	1	0	307
1842	312	2	1	0	0	315
1843	4	1	308	0	0	313
1844	306	0	2	1	0	309
1845	314	1	1	1	0	317
1846	314	0	1	1	0	316
1847	3	0	1	306	0	310
1848	3	311	0	3	0	317
1849	313	2	1	1	0	317
1850	313	2	0	1	0	316
1851	4	1	0	312	0	317
1852	312	1	0	3	0	316
1853	5	322	1	1	0	329
1854	4	2	2	316	0	324
1855	2	1	317	3	0	323
1856	301	0	2	4	0	307
1857	2	1	320	2	0	325
1858	2	1	3	319	0	325
1859	0	315	3	3	0	321
1860	1	328	0	4	0	333
1861	1	3	4	336	0	344
1862	1	331	3	3	0	338
1863	2	3	0	452	0	457
1864	1	3	1	468	0	473
1865	2	0	0	481	0	483
1866	473	1	1	7	0	482
1867	4	1	0	468	0	473
1868	4	1	459	6	0	470
1869	2	459	5	5	0	471
1870	460	3	2	4	0	469
1871	5	3	1	464	0	473
1872	8	1	3	451	0	463
1873	2	1	0	458	0	461
1874	2	1	455	7	0	465
1875	2	456	3	4	0	465
1876	456	4	1	4	0	465
1877	4	2	1	452	0	459
1878	4	461	3	3	0	471
1879	463	6	0	4	0	473
1880	6	2	457	2	0	467
1881	449	2	4	4	0	459
1882	5	4	455	0	0	464
1883	5	1	452	0	0	458
1884	2	446	6	4	0	458
1885	5	5	2	425	0	437
1886	1	3	429	4	0	437
1887	1	414	5	3	0	423
1888	0	6	3	405	0	414
1889	1	407	3	6	0	417
1890	1	5	402	4	0	412
1891	1	3	5	405	0	414
1892	1	3	411	6	0	421
1893	1	4	5	412	0	422
1894	0	1	5	416	0	422
1895	0	2	410	9	0	421
1896	2	1	6	408	0	417
1897	401	1	3	10	0	415
1898	3	397	3	6	0	409
1899	2	3	402	5	0	412
1900	397	2	4	5	0	408
1901	6	4	3	390	0	403
1902	4	393	4	5	0	406
1903	397	3	3	3	0	406
1904	403	4	0	3	0	410
1905	6	2	3	383	0	394
1906	5	3	2	390	0	400
1907	6	2	0	392	0	400
1908	2	1	1	388	0	392
1909	1	374	2	13	0	390
1910	4	12	0	368	0	384
1911	1	360	1	9	0	371
1912	0	356	0	6	0	362
1913	1	346	2	3	0	352
1914	0	8	327	3	0	338
1915	2	332	4	1	0	339
1916	318	5	2	5	0	330
1917	2	324	3	3	0	332
1918	5	6	2	309	0	322
1919	3	328	2	6	0	339
1920	2	5	2	322	0	331
1921	4	7	0	326	0	337
1922	2	2	318	8	0	330
1923	304	3	4	6	0	317
1924	309	3	3	5	0	320
1925	301	3	3	2	0	309
1926	8	293	1	2	0	304
1927	7	4	2	291	0	304
1928	5	2	288	5	0	300
1929	2	282	3	4	0	291
1930	3	5	2	250	0	260
1931	2	261	3	8	0	274
1932	260	5	5	1	0	271
1933	261	4	0	4	0	269
1934	264	4	2	1	0	271
1935	259	3	4	0	0	266
1936	7	2	2	253	0	264
1937	6	1	2	249	0	258
1938	4	251	2	4	0	261
1939	2	4	2	257	0	265
1940	2	2	253	7	0	264
1941	2	3	3	253	0	261
1942	1	2	251	6	0	260
1943	0	247	3	7	0	257
1944	1	3	252	2	0	258
1945	1	1	3	248	0	253
1946	1	2	251	4	0	258
1947	0	3	4	251	0	258
1948	1	1	5	249	0	256
1949	3	2	2	250	0	257
1950	0	2	3	253	0	258
1951	242	1	3	8	0	254
1952	4	242	1	6	0	253
1953	232	2	0	6	0	240
1954	3	5	225	3	0	236
1955	227	2	2	2	0	233
1956	228	2	0	3	0	233
1957	5	2	223	4	0	234
1958	6	4	205	2	0	217
1959	6	204	4	4	0	218
1960	3	202	2	2	0	209
1961	5	4	190	1	0	200
1962	2	170	3	3	0	178
1963	5	8	1	52	0	66
1964	45	0	3	0	0	48
1965	0	1	0	45	0	46
1966	47	0	0	1	0	48
1967	48	0	0	1	0	49
1968	0	47	0	1	0	48
1969	49	0	0	0	0	49
1970	51	0	0	0	0	51
1971	0	1	0	48	0	49
1972	49	0	0	0	0	49
1973	1	49	0	0	0	50
1974	1	0	0	48	0	49
1975	50	0	0	0	0	50
1976	0	1	49	0	0	50
1977	49	0	0	0	0	49
1978	1	0	0	48	0	49
1979	0	0	46	0	0	46
1980	2	0	44	0	0	46
1981	46	0	0	0	0	46
1982	45	0	0	0	0	45
1983	0	0	0	46	0	46
1984	0	0	0	45	0	45
1985	0	0	0	43	0	43
1986	0	44	0	0	0	44
1987	46	0	0	1	0	47
1988	0	46	0	0	0	46
1989	47	0	0	0	0	47
1990	0	0	47	0	0	47
1991	0	0	0	45	0	45
1992	48	0	0	0	0	48
1993	0	0	0	48	0	48
1994	0	0	0	43	0	43
1995	0	44	0	0	0	44
1996	45	0	0	0	0	45
1997	0	48	0	0	0	48
1998	0	0	0	52	0	52
1999	0	0	49	0	0	49
2000	46	0	0	0	0	46
2001	0	0	47	0	0	47
2002	46	0	0	0	0	46
2003	0	52	0	0	0	52
2004	0	0	0	48	0	48
2005	0	54	0	0	0	54
2006	54	0	0	0	0	54
2007	0	0	0	54	0	54
2008	0	0	0	54	0	54
2009	0	0	53	0	0	53
2010	54	0	0	0	0	54
2011	0	0	0	54	0	54
2012	0	0	54	0	0	54
2013	0	54	0	0	0	54
2014	0	0	0	53	0	53
2015	55	0	0	0	0	55
2016	0	0	0	55	0	55
2017	0	0	56	0	0	56
2018	60	0	0	0	0	60
2019	0	0	0	61	0	61
2020	0	0	65	0	0	65
2021	0	0	0	66	0	66
2022	0	1	0	66	0	67
2023	0	67	0	0	0	67
2024	65	1	0	0	0	66
2025	0	66	0	0	0	66
2026	66	0	0	0	0	66
2027	0	0	0	66	0	66
2028	0	64	0	0	0	64
2029	0	0	0	66	0	66
2030	0	1	66	0	0	67
2031	62	0	0	0	0	62
2032	0	0	0	65	0	65
2033	0	0	0	63	0	63
2034	0	0	0	64	0	64
2035	0	0	64	0	0	64
2036	0	0	60	0	0	60
2037	0	64	0	0	0	64
2038	0	0	0	64	0	64
2039	63	0	0	0	0	63
2040	0	63	0	0	0	63
2041	0	0	0	65	0	65
2042	65	0	0	0	0	65
2043	65	0	0	0	0	65
2044	0	66	0	0	0	66
2045	70	0	0	0	0	70
2046	81	0	0	0	0	81
2047	1	0	0	82	0	83
2048	0	80	0	1	0	81
2049	0	1	0	81	0	82
2050	81	0	0	1	0	82
2051	1	0	79	0	0	80
2052	0	0	1	80	0	81
2053	0	0	0	82	0	82
2054	0	0	81	1	0	82
2055	0	0	1	81	0	82
2056	80	0	0	1	0	81
2057	80	0	0	0	0	80
2058	0	0	0	80	0	80
2059	0	0	76	1	0	77
2060	0	0	78	0	0	78
2061	0	76	1	0	0	77
2062	0	77	0	0	0	77
2063	0	1	0	76	0	77
2064	76	0	0	1	0	77
2065	1	76	0	0	0	77
2066	74	1	0	0	0	75
2067	1	0	0	74	0	75
2068	0	0	0	74	0	74
2069	71	0	0	1	0	72
2070	1	71	0	0	0	72
2071	71	1	0	0	0	72
2072	1	0	70	0	0	71
2073	0	0	72	0	0	72
2074	0	0	1	71	0	72
2075	0	0	71	1	0	72
2076	0	0	69	0	0	69
2077	0	0	1	68	0	69
2078	0	0	68	1	0	69
2079	0	0	1	66	0	67
2080	0	0	0	66	0	66
2081	0	0	67	1	0	68
2082	0	0	1	66	0	67
2083	0	0	0	65	0	65
2084	0	65	0	1	0	66
2085	65	1	0	0	0	66
2086	1	0	66	0	0	67
2087	0	0	1	64	0	65
2088	0	0	0	63	0	63
2089	0	0	63	1	0	64
2090	62	0	1	0	0	63
2091	1	62	0	1	0	64
2092	0	1	0	60	0	61
2093	0	0	0	60	0	60
2094	0	60	0	0	0	60
2095	0	1	59	0	0	60
2096	0	60	1	0	0	61
2097	57	1	0	0	0	58
2098	5	0	49	0	0	54
2099	0	0	1	54	0	55
2100	0	0	54	1	0	55
2101	0	0	53	0	0	53
2102	0	53	1	0	0	54
2103	0	1	0	49	0	50
2104	48	0	0	0	0	48
2105	46	0	0	0	0	46
2106	1	45	0	0	0	46
2107	0	1	0	45	0	46
2108	44	0	0	1	0	45
2109	45	0	0	0	0	45
2110	1	45	0	0	0	46
2111	45	1	0	0	0	46
2112	1	0	0	44	0	45
2113	0	45	0	1	0	46
2114	0	2	0	45	0	47
2115	0	0	0	49	0	49
2116	0	0	0	49	0	49
2117	0	0	50	1	0	51
2118	0	0	43	0	0	43
2119	0	42	1	0	0	43
2120	38	1	0	0	0	39
2121	1	36	0	0	0	37
2122	0	1	0	40	0	41
2123	0	0	42	1	0	43
2124	0	0	1	39	0	40
2125	0	0	0	43	0	43
2126	0	0	0	43	0	43
2127	41	0	0	1	0	42
2128	1	0	0	42	0	43
2129	0	0	47	1	0	48
2130	45	0	1	0	0	46
2131	48	0	0	0	0	48
2132	48	0	0	0	0	48
2133	49	0	0	0	0	49
2134	49	0	0	0	0	49
2135	1	47	0	0	0	48
2136	0	1	0	45	0	46
2137	0	47	0	1	0	48
2138	45	1	0	0	0	46
2139	48	0	0	0	0	48
2140	47	0	0	0	0	47
2141	1	45	0	0	0	46
2142	0	47	0	0	0	47
2143	0	47	0	0	0	47
2144	0	1	43	0	0	44
2145	0	3	3	36	0	42
2146	0	28	0	0	0	28
2147	0	25	0	0	0	25
2148	0	0	0	24	0	24
2149	0	0	0	24	0	24
2150	0	0	25	0	0	25
2151	25	0	0	0	0	25
2152	0	0	0	25	0	25
2153	0	0	0	26	0	26
2154	0	0	26	0	0	26
2155	0	0	26	0	0	26
2156	0	29	0	0	0	29
2157	0	0	0	29	0	29
2158	0	0	0	29	0	29
2159	0	0	29	0	0	29
2160	28	0	0	0	0	28
2161	30	0	0	0	0	30
2162	0	0	29	0	0	29
2163	29	0	0	0	0	29
2164	1	0	28	0	0	29
2165	30	0	0	0	0	30
2166	31	0	0	0	0	31
2167	0	0	32	0	0	32
2168	0	0	0	34	0	34
2169	0	0	0	34	0	34
2170	0	0	0	34	0	34
2171	34	0	0	0	0	34
2172	33	0	0	0	0	33
2173	0	0	35	0	0	35
2174	0	0	35	0	0	35
2175	35	0	0	0	0	35
2176	35	0	0	0	0	35
2177	0	0	35	0	0	35
2178	0	0	36	0	0	36
2179	0	0	0	35	0	35
2180	0	0	36	0	0	36
2181	0	0	0	36	0	36
2182	37	0	0	0	0	37
2183	0	0	38	0	0	38
2184	37	0	0	0	0	37
2185	0	0	46	0	0	46
2186	0	0	0	45	0	45
2187	0	0	0	46	0	46
2188	0	0	0	45	0	45
2189	0	47	0	0	0	47
2190	0	0	0	44	0	44
2191	0	0	0	46	0	46
2192	48	0	0	0	0	48
2193	0	0	48	0	0	48
2194	45	0	0	0	0	45
2195	0	0	48	0	0	48
2196	45	0	0	0	0	45
2197	0	47	0	0	0	47
2198	0	0	47	0	0	47
2199	0	0	49	0	0	49
2200	0	0	0	48	0	48
2201	0	0	0	48	0	48
2202	0	0	48	0	0	48
2203	0	0	51	0	0	51
2204	0	0	55	0	0	55
2205	58	0	0	1	0	59
2206	59	0	0	0	0	59
2207	59	0	0	0	0	59
2208	0	0	0	59	0	59
2209	0	0	0	58	0	58
2210	0	0	58	0	0	58
2211	0	0	0	58	0	58
2212	0	0	0	61	0	61
2213	63	0	0	1	0	64
2214	63	0	0	1	0	64
2215	60	0	0	1	0	61
2216	1	0	0	59	0	60
2217	1	0	0	57	0	58
2218	0	0	1	58	0	59
2219	56	0	1	0	0	57
2220	1	0	0	56	0	57
2221	1	58	0	0	0	59
2222	0	0	1	53	0	54
2223	0	53	1	0	0	54
2224	52	0	0	1	0	53
2225	51	0	1	0	0	52
2226	0	52	0	1	0	53
2227	0	53	0	0	0	53
2228	0	0	1	53	0	54
2229	1	0	49	0	0	50
2230	0	0	0	45	0	45
2231	0	0	48	1	0	49
2232	0	49	0	1	0	50
2233	0	0	0	52	0	52
2234	0	1	0	51	0	52
2235	0	0	53	1	0	54
2236	0	0	0	57	0	57
2237	1	0	59	0	0	60
2238	57	0	0	0	0	57
2239	61	0	0	0	0	61
2240	61	0	1	0	0	62
2241	1	0	0	59	0	60
2242	0	1	0	59	0	60
2243	0	0	61	0	0	61
2244	0	0	1	61	0	62
2245	0	61	0	1	0	62
2246	0	0	61	1	0	62
2247	0	0	59	0	0	59
2248	0	0	1	57	0	58
2249	0	0	63	0	0	63
2250	1	0	63	0	0	64
2251	62	0	0	0	0	62
2252	1	74	0	0	0	75
2253	77	0	0	1	0	78
2254	76	0	0	1	0	77
2255	76	0	1	0	0	77
2256	0	0	0	76	0	76
2257	0	0	0	80	0	80
2258	1	0	79	0	0	80
2259	1	0	0	78	0	79
2260	1	82	0	0	0	83
2261	82	0	0	1	0	83
2262	0	83	0	1	0	84
2263	0	86	0	1	0	87
2264	1	1	0	86	0	88
2265	0	0	89	1	0	90
2266	0	1	0	87	0	88
2267	0	0	84	1	0	85
2268	0	86	0	0	0	86
2269	87	0	0	0	0	87
2270	87	0	0	0	0	87
2271	88	0	0	0	0	88
2272	0	0	92	0	0	92
2273	0	0	89	0	0	89
2274	95	0	0	0	0	95
2275	97	0	0	0	0	97
2276	100	0	0	0	0	100
2277	0	0	0	99	0	99
2278	0	0	0	102	0	102
2279	102	0	0	0	0	102
2280	100	0	0	0	0	100
2281	0	0	104	0	0	104
2282	0	0	106	0	0	106
2283	105	0	0	0	0	105
2284	1	0	104	0	0	105
2285	99	0	0	0	0	99
2286	0	0	102	0	0	102
2287	0	0	0	101	0	101
2288	0	0	109	0	0	109
2289	0	0	0	113	0	113
2290	0	0	0	111	0	111
2291	0	115	0	0	0	115
2292	118	0	0	0	0	118
2293	0	0	126	0	0	126
2294	124	0	0	0	0	124
2295	0	126	0	0	0	126
2296	131	0	0	0	0	131
2297	0	0	0	129	0	129
2298	0	0	0	129	0	129
2299	0	136	0	0	0	136
2300	0	0	0	143	0	143
2301	0	0	0	142	0	142
2302	0	0	0	144	0	144
2303	140	0	0	1	0	141
2304	135	0	0	1	0	136
2305	1	0	132	0	0	133
2306	1	135	0	0	0	136
2307	0	0	1	136	0	137
2308	0	1	0	141	0	142
2309	0	0	141	1	0	142
2310	0	0	0	145	0	145
2311	144	0	1	0	0	145
2312	145	0	0	1	0	146
2313	149	0	0	0	0	149
2314	2	0	0	148	0	150
2315	165	0	0	1	0	166
2316	166	0	0	2	0	168
2317	169	0	0	0	0	169
2318	0	0	0	169	0	169
2319	1	0	0	167	0	168
2320	0	0	0	167	0	167
2321	0	0	0	166	0	166
2322	0	0	0	169	0	169
2323	0	0	170	1	0	171
2324	0	0	168	1	0	169
2325	0	165	1	0	0	166
2326	0	0	1	168	0	169
2327	0	0	0	168	0	168
2328	0	0	0	170	0	170
2329	0	0	168	1	0	169
2330	0	0	0	168	0	168
2331	0	0	169	0	0	169
2332	0	0	0	166	0	166
2333	0	0	176	0	0	176
2334	0	176	0	1	0	177
2335	0	0	1	174	0	175
2336	0	1	171	0	0	172
2337	157	0	0	1	0	158
2338	0	169	1	0	0	170
2339	0	0	0	169	0	169
2340	0	169	0	0	0	169
2341	0	0	0	167	0	167
2342	175	1	0	1	0	177
2343	0	0	0	175	0	175
2344	1	174	0	0	0	175
2345	174	0	0	2	0	176
2346	0	1	0	182	0	183
2347	1	0	0	184	0	185
2348	187	0	0	2	0	189
2349	0	0	1	212	0	213
2350	1	0	0	272	0	273
2351	1	0	279	4	0	284
2352	1	0	275	1	0	277
2353	1	0	4	275	0	280
2354	1	0	276	2	0	279
2355	1	0	274	1	0	276
2356	268	0	3	2	0	273
2357	4	0	274	0	0	278
2358	1	277	4	1	0	283
2359	2	3	1	281	0	287
2360	282	1	1	4	0	288
2361	285	1	0	2	0	288
2362	282	0	0	3	0	285
2363	4	280	2	0	0	286
2364	1	2	2	282	0	287
2365	1	2	0	284	0	287
2366	277	1	1	4	0	283
2367	278	0	1	4	0	283
2368	285	0	0	3	0	288
2369	5	0	279	0	0	284
2370	2	278	3	1	0	284
2371	1	301	2	1	0	305
2372	2	5	0	296	0	303
2373	1	2	1	303	0	307
2374	2	3	300	5	0	310
2375	301	1	4	5	0	311
2376	303	0	3	4	0	310
2377	6	0	3	299	0	308
2378	5	1	0	302	0	308
2379	2	0	1	302	0	305
2380	297	1	0	7	0	305
2381	4	1	287	5	0	297
2382	3	0	291	1	0	295
2383	4	1	5	288	0	298
2384	1	1	290	5	0	297
2385	287	1	5	2	0	295
2386	286	0	2	4	0	292
2387	290	0	2	2	0	294
2388	9	275	0	0	0	284
2389	273	3	0	3	0	279
2390	7	2	0	272	0	281
2391	2	2	2	275	0	281
2392	3	0	1	275	0	279
2393	0	1	264	8	0	273
2394	1	0	5	263	0	269
2395	1	262	2	7	0	272
2396	258	4	4	2	0	268
2397	5	260	0	3	0	268
2398	3	7	258	2	0	270
2399	4	255	5	2	0	266
2400	247	5	2	1	0	255
2401	6	249	3	2	0	260
2402	2	6	2	233	0	243
2403	2	246	4	5	0	257
2404	249	6	1	2	0	258
2405	250	0	3	4	0	257
2406	243	3	2	1	0	249
2407	9	1	248	1	0	259
2408	6	0	248	0	0	254
2409	3	2	241	2	0	248
2410	237	1	8	1	0	247
2411	7	2	4	237	0	250
2412	3	1	3	242	0	249
2413	3	1	229	7	0	240
2414	1	3	4	234	0	242
2415	213	1	3	8	0	225
2416	8	214	2	2	0	226
2417	217	5	2	2	0	226
2418	10	4	211	1	0	226
2419	216	5	4	2	0	227
2420	221	1	4	2	0	228
2421	219	1	4	2	0	226
2422	8	3	214	1	0	226
2423	4	1	5	216	0	226
2424	5	0	214	8	0	227
2425	2	1	8	215	0	226
2426	4	0	218	8	0	230
2427	5	2	7	214	0	228
2428	3	0	1	221	0	225
2429	217	1	4	6	0	228
2430	217	0	4	4	0	225
2431	221	0	1	5	0	227
2432	9	1	2	210	0	222
2433	4	197	1	10	0	212
2434	3	204	2	3	0	212
2435	204	5	2	5	0	216
2436	8	4	203	1	0	216
2437	201	2	9	1	0	213
2438	8	2	207	1	0	218
2439	204	2	6	3	0	215
2440	203	2	4	2	0	211
2441	7	0	202	4	0	213
2442	205	1	3	2	0	211
2443	208	1	2	2	0	213
2444	204	1	4	2	0	211
2445	9	205	1	2	0	217
2446	3	7	2	195	0	207
2447	5	1	191	8	0	205
2448	2	2	194	2	0	200
2449	3	164	7	3	0	177
2450	2	94	1	0	0	97
2451	4	1	3	83	0	91
2452	81	1	0	2	0	84
2453	1	82	0	1	0	84
2454	1	1	1	83	0	86
2455	1	81	1	2	0	85
2456	84	1	0	0	0	85
2457	1	1	1	80	0	83
2458	2	1	77	1	0	81
2459	2	67	2	0	0	71
2460	1	69	1	1	0	72
2461	2	1	1	67	0	71
2462	2	69	0	1	0	72
2463	1	1	1	68	0	71
2464	69	1	0	3	0	73
2465	71	1	1	1	0	74
2466	71	0	1	2	0	74
2467	72	0	1	0	0	73
2468	2	1	71	1	0	75
2469	2	70	1	1	0	74
2470	2	67	0	1	0	70
2471	0	50	0	0	0	50
2472	0	48	0	0	0	48
2473	42	0	2	0	0	44
2474	41	0	0	0	0	41
2475	45	0	0	0	0	45
2476	48	0	0	0	0	48
2477	0	0	50	0	0	50
2478	52	0	0	0	0	52
2479	53	0	0	0	0	53
2480	53	0	0	0	0	53
2481	0	0	0	52	0	52
2482	0	0	0	53	0	53
2483	51	0	0	0	0	51
2484	0	0	0	52	0	52
2485	0	53	0	0	0	53
2486	0	0	0	55	0	55
2487	0	0	0	55	0	55
2488	0	54	0	0	0	54
2489	0	0	0	55	0	55
2490	0	0	0	55	0	55
2491	54	0	0	0	0	54
2492	0	1	53	0	0	54
2493	52	0	0	0	0	52
2494	0	0	57	0	0	57
2495	0	0	57	0	0	57
2496	0	0	58	0	0	58
2497	60	0	0	0	0	60
2498	0	0	63	0	0	63
2499	60	0	0	0	0	60
2500	61	0	0	0	0	61
2501	61	0	0	0	0	61
2502	0	62	0	0	0	62
2503	62	0	0	0	0	62
2504	0	63	0	0	0	63
2505	0	0	0	65	0	65
2506	0	0	0	67	0	67
2507	0	68	0	0	0	68
2508	0	66	0	0	0	66
2509	0	66	0	0	0	66
2510	68	0	0	0	0	68
2511	0	67	0	0	0	67
2512	68	0	0	0	0	68
2513	0	0	69	0	0	69
2514	67	0	0	0	0	67
2515	70	0	0	0	0	70
2516	0	0	70	0	0	70
2517	1	0	0	70	0	71
2518	0	0	75	0	0	75
2519	0	0	0	73	0	73
2520	0	0	0	74	0	74
2521	76	0	0	0	0	76
2522	76	0	0	0	0	76
2523	0	76	0	0	0	76
2524	76	0	0	0	0	76
2525	0	0	79	1	0	80
2526	81	0	0	0	0	81
2527	0	0	92	0	0	92
2528	0	0	89	0	0	89
2529	94	0	0	0	0	94
2530	95	0	0	0	0	95
2531	0	0	95	0	0	95
2532	0	0	0	95	0	95
2533	0	0	0	97	0	97
2534	0	0	97	0	0	97
2535	0	0	0	97	0	97
2536	0	98	0	0	0	98
2537	0	0	0	102	0	102
2538	0	0	0	100	0	100
2539	0	0	99	0	0	99
2540	93	0	0	0	0	93
2541	98	0	0	0	0	98
2542	99	0	0	0	0	99
2543	98	0	0	0	0	98
2544	0	96	0	0	0	96
2545	0	0	0	95	0	95
2546	0	0	95	0	0	95
2547	0	0	97	1	0	98
2548	0	0	0	100	0	100
2549	0	0	103	0	0	103
2550	102	0	0	0	0	102
2551	1	0	1	106	0	108
2552	1	0	0	107	0	108
2553	0	0	0	107	0	107
2554	106	0	0	2	0	108
2555	0	106	0	1	0	107
2556	108	0	0	0	0	108
2557	108	1	0	0	0	109
2558	1	105	0	0	0	106
2559	1	106	0	0	0	107
2560	110	1	0	1	0	112
2561	0	1	0	111	0	112
2562	1	0	0	110	0	111
2563	113	0	0	0	0	113
2564	0	0	112	1	0	113
2565	110	0	0	0	0	110
2566	112	0	1	0	0	113
2567	1	118	0	0	0	119
2568	123	0	0	0	0	123
2569	125	1	0	0	0	126
2570	1	142	1	0	0	144
2571	1	144	0	0	0	145
2572	0	2	0	144	0	146
2573	148	0	0	1	0	149
2574	1	150	0	1	0	152
2575	1	2	0	148	0	151
2576	151	1	0	2	0	154
2577	2	0	150	1	0	153
2578	1	0	2	146	0	149
2579	0	0	148	2	0	150
2580	144	0	2	2	0	148
2581	152	0	0	0	0	152
2582	3	0	150	0	0	153
2583	1	151	2	0	0	154
2584	0	2	1	152	0	155
2585	0	1	154	2	0	157
2586	2	0	2	152	0	156
2587	0	0	1	156	0	157
2588	0	0	159	3	0	162
2589	151	0	2	1	0	154
2590	159	0	0	0	0	159
2591	3	0	158	0	0	161
2592	1	159	2	0	0	162
2593	0	1	1	155	0	157
2594	0	156	0	2	0	158
2595	1	155	0	0	0	156
2596	153	2	0	0	0	155
2597	2	1	0	152	0	155
2598	1	0	0	150	0	151
2599	0	0	149	3	0	152
2600	0	0	150	1	0	151
2601	0	0	3	147	0	150
2602	0	0	1	150	0	151
2603	0	0	148	3	0	151
2604	0	0	148	1	0	149
2605	0	0	3	146	0	149
2606	144	0	1	2	0	147
2607	2	144	0	1	0	147
2608	147	2	0	0	0	149
2609	2	147	0	0	0	149
2610	1	146	0	0	0	147
2611	145	3	0	0	0	148
2612	2	2	144	0	0	148
2613	4	0	2	142	0	148
2614	2	0	1	144	0	147
2615	0	2	0	152	0	154
2616	0	1	149	3	0	153
2617	0	0	2	153	0	155
2618	159	0	1	2	0	162
2619	2	2	0	161	0	165
2620	1	0	0	167	0	168
2621	168	0	0	3	0	171
2622	168	0	2	1	0	171
2623	3	163	0	2	0	168
2624	1	1	167	0	0	169
2625	2	0	159	0	0	161
2626	2	1	160	0	0	163
2627	0	148	5	0	0	153
2628	0	4	1	144	0	149
2629	0	1	0	149	0	150
2630	144	0	2	3	0	149
2631	2	0	0	146	0	148
2632	1	0	143	4	0	148
2633	0	0	3	145	0	148
2634	2	0	1	145	0	148
2635	2	0	144	3	0	149
2636	0	133	3	1	0	137
2637	0	4	1	126	0	131
2638	0	140	0	3	0	143
2639	0	4	141	1	0	146
2640	140	3	2	1	0	146
2641	143	0	1	1	0	145
2642	141	0	0	2	0	143
2643	4	0	0	135	0	139
2644	2	138	2	2	0	144
2645	139	2	4	1	0	146
2646	137	1	1	3	0	142
2647	135	0	1	2	0	138
2648	4	1	131	0	0	136
2649	122	0	4	2	0	128
2650	1	123	1	3	0	128
2651	123	3	0	0	0	126
2652	2	123	0	2	0	127
2653	122	1	2	0	0	125
2654	2	2	122	2	0	128
2655	121	2	2	2	0	127
2656	125	0	1	0	0	126
2657	114	1	2	1	0	118
2658	124	0	0	3	0	127
2659	3	1	119	2	0	125
2660	0	1	3	118	0	122
2661	119	0	2	3	0	124
2662	3	117	0	2	0	122
2663	3	3	0	115	0	121
2664	1	0	113	3	0	117
2665	0	1	3	113	0	117
2666	4	1	111	3	0	119
2667	3	112	3	0	0	118
2668	1	107	1	0	0	109
2669	0	103	0	1	0	104
2670	1	1	0	82	0	84
2671	0	1	1	81	0	83
2672	1	0	80	1	0	82
2673	0	73	1	1	0	75
2674	67	0	0	0	0	67
2675	0	63	1	0	0	64
2676	1	62	0	0	0	63
2677	1	0	0	61	0	62
2678	61	0	0	0	0	61
2679	62	0	0	0	0	62
2680	0	0	1	59	0	60
2681	58	0	0	1	0	59
2682	1	0	0	58	0	59
2683	0	1	56	0	0	57
2684	56	0	0	1	0	57
2685	0	0	1	54	0	55
2686	0	0	52	0	0	52
2687	0	0	54	0	0	54
2688	0	1	0	50	0	51
2689	50	1	0	0	0	51
2690	51	1	0	0	0	52
2691	0	50	0	1	0	51
2692	49	0	0	1	0	50
2693	50	0	1	0	0	51
2694	50	1	0	0	0	51
2695	1	50	0	0	0	51
2696	51	0	0	0	0	51
2697	52	1	0	0	0	53
2698	0	0	0	58	0	58
2699	54	0	0	0	0	54
2700	1	56	0	0	0	57
2701	0	55	0	1	0	56
2702	1	0	0	56	0	57
2703	0	0	0	57	0	57
2704	0	57	1	0	0	58
2705	58	0	0	0	0	58
2706	0	57	0	1	0	58
2707	56	0	1	0	0	57
2708	0	57	1	0	0	58
2709	0	0	0	58	0	58
2710	1	58	0	0	0	59
2711	59	0	0	0	0	59
2712	59	1	0	0	0	60
2713	60	0	0	0	0	60
2714	1	0	60	0	0	61
2715	0	0	53	0	0	53
2716	0	54	0	0	0	54
2717	1	0	51	0	0	52
2718	1	0	42	0	0	43
2719	0	2	0	34	0	36
2720	0	0	35	0	0	35
2721	0	33	0	0	0	33
2722	34	0	0	0	0	34
2723	0	35	0	0	0	35
2724	0	34	0	0	0	34
2725	34	0	1	0	0	35
2726	36	0	0	0	0	36
2727	0	36	0	0	0	36
2728	36	0	0	0	0	36
2729	36	0	0	0	0	36
2730	36	0	0	0	0	36
2731	0	0	34	0	0	34
2732	0	0	35	0	0	35
2733	0	0	0	36	0	36
2734	0	0	0	36	0	36
2735	36	0	0	0	0	36
2736	0	37	0	0	0	37
2737	0	0	0	39	0	39
2738	0	0	0	40	0	40
2739	0	0	0	41	0	41
2740	0	0	0	41	0	41
2741	0	0	42	0	0	42
2742	0	0	41	0	0	41
2743	0	0	0	43	0	43
2744	0	0	45	0	0	45
2745	43	0	0	0	0	43
2746	0	0	0	45	0	45
2747	0	0	45	0	0	45
2748	45	0	0	0	0	45
2749	0	45	0	0	0	45
2750	46	0	0	0	0	46
2751	0	47	0	0	0	47
2752	0	0	0	48	0	48
2753	0	0	48	0	0	48
2754	0	0	0	47	0	47
2755	0	0	45	0	0	45
2756	47	0	0	0	0	47
2757	0	0	0	48	0	48
2758	48	0	0	0	0	48
2759	1	0	46	0	0	47
2760	51	0	0	0	0	51
2761	54	0	0	0	0	54
2762	0	0	53	0	0	53
2763	0	0	0	53	0	53
2764	0	0	51	0	0	51
2765	0	55	1	0	0	56
2766	52	0	3	0	0	55
2767	54	0	0	0	0	54
2768	0	0	52	0	0	52
2769	0	0	52	0	0	52
2770	0	0	0	54	0	54
2771	0	0	0	55	0	55
2772	57	0	0	0	0	57
2773	0	57	0	0	0	57
2774	63	0	0	1	0	64
2775	64	0	0	1	0	65
2776	0	0	64	0	0	64
2777	64	0	0	1	0	65
2778	0	0	66	0	0	66
2779	0	0	0	68	0	68
2780	0	0	74	0	0	74
2781	0	0	0	74	0	74
2782	0	0	75	1	0	76
2783	73	0	0	0	0	73
2784	78	0	0	1	0	79
2785	0	0	0	79	0	79
2786	80	0	0	0	0	80
2787	0	0	0	82	0	82
2788	0	87	0	0	0	87
2789	87	0	0	1	0	88
2790	0	89	0	0	0	89
2791	0	0	0	89	0	89
2792	0	0	0	89	0	89
2793	0	0	0	88	0	88
2794	0	0	0	87	0	87
2795	0	0	87	0	0	87
2796	81	0	0	0	0	81
2797	86	0	0	1	0	87
2798	0	82	0	0	0	82
2799	0	0	0	81	0	81
2800	0	0	0	84	0	84
2801	0	0	81	0	0	81
2802	82	0	0	1	0	83
2803	0	0	0	84	0	84
2804	0	1	82	0	0	83
2805	85	0	0	1	0	86
2806	85	0	0	0	0	85
2807	85	0	0	1	0	86
2808	0	0	81	0	0	81
2809	0	0	77	0	0	77
2810	80	0	0	0	0	80
2811	0	1	0	81	0	82
2812	1	0	0	84	0	85
2813	0	0	84	0	0	84
2814	75	0	0	1	0	76
2815	0	0	0	82	0	82
2816	81	0	0	0	0	81
2817	80	0	0	1	0	81
2818	82	0	0	1	0	83
2819	0	0	86	0	0	86
2820	1	0	0	86	0	87
2821	87	0	0	0	0	87
2822	0	90	0	0	0	90
2823	0	0	0	89	0	89
2824	0	0	0	88	0	88
2825	89	0	0	0	0	89
2826	90	0	0	1	0	91
2827	0	0	0	94	0	94
2828	0	0	93	0	0	93
2829	88	0	0	1	0	89
2830	0	0	93	0	0	93
2831	93	0	0	0	0	93
2832	96	0	0	0	0	96
2833	0	0	98	0	0	98
2834	0	0	1	102	0	103
2835	0	0	104	0	0	104
2836	0	112	0	0	0	112
2837	0	1	0	112	0	113
2838	0	118	0	1	0	119
2839	0	1	0	118	0	119
2840	0	1	122	1	0	124
2841	0	120	1	1	0	122
2842	0	132	1	0	0	133
2843	0	3	0	132	0	135
2844	129	1	0	3	0	133
2845	3	0	0	143	0	146
2846	148	0	0	2	0	150
2847	2	152	0	1	0	155
2848	167	2	0	1	0	170
2849	2	1	168	0	0	171
2850	0	0	2	164	0	166
2851	0	0	1	166	0	167
2852	0	0	161	3	0	164
2853	162	0	2	1	0	165
2854	162	2	1	1	0	166
2855	4	165	0	0	0	169
2856	0	2	1	163	0	166
2857	0	169	0	2	0	171
2858	0	2	168	1	0	171
2859	0	0	170	0	0	170
2860	2	1	3	164	0	170
2861	165	0	1	3	0	169
2862	2	166	0	1	0	169
2863	166	2	0	1	0	169
2864	2	3	162	0	0	167
2865	163	0	3	0	0	166
2866	167	0	2	0	0	169
2867	3	0	165	1	0	169
2868	3	0	2	160	0	165
2869	167	1	1	2	0	171
2870	166	0	0	1	0	167
2871	168	0	1	0	0	169
2872	4	0	0	163	0	167
2873	1	0	162	2	0	165
2874	156	0	3	2	0	161
2875	2	0	160	1	0	163
2876	1	0	2	159	0	162
2877	1	0	1	164	0	166
2878	1	159	0	3	0	163
2879	0	2	156	1	0	159
2880	0	153	3	0	0	156
2881	1	149	1	0	0	151
2882	0	4	1	149	0	154
2883	0	1	146	3	0	150
2884	0	0	2	151	0	153
2885	1	1	152	2	0	156
2886	0	1	3	148	0	152
2887	1	1	0	148	0	150
2888	0	1	142	3	0	146
2889	0	0	2	144	0	146
2890	0	0	144	3	0	147
2891	0	0	144	2	0	146
2892	1	141	4	0	0	146
2893	144	2	1	1	0	148
2894	2	2	142	1	0	147
2895	142	0	3	1	0	146
2896	2	1	1	145	0	149
2897	1	0	146	2	0	149
2898	0	145	4	1	0	150
2899	0	3	1	147	0	151
2900	2	1	144	2	0	149
2901	0	1	3	140	0	144
2902	2	141	1	2	0	146
2903	143	2	1	2	0	148
2904	3	1	1	145	0	150
2905	143	1	0	2	0	146
2906	146	0	1	2	0	149
2907	146	0	1	1	0	148
2908	146	0	0	1	0	147
2909	140	1	0	2	0	143
2910	5	140	2	0	0	147
2911	1	2	0	144	0	147
2912	1	1	1	142	0	145
2913	3	0	0	142	0	145
2914	2	1	140	3	0	146
2915	2	138	2	2	0	144
2916	143	1	1	0	0	145
2917	145	3	0	1	0	149
2918	3	142	2	2	0	149
2919	1	140	1	1	0	143
2920	140	4	0	1	0	145
2921	3	1	137	1	0	142
2922	1	2	3	132	0	138
2923	133	0	1	4	0	138
2924	4	0	1	132	0	137
2925	1	133	0	3	0	137
2926	1	1	1	130	0	133
2927	1	1	130	3	0	135
2928	129	0	3	4	0	136
2929	134	1	2	2	0	139
2930	5	1	1	130	0	137
2931	1	1	2	131	0	135
2932	129	2	0	3	0	134
2933	3	125	1	2	0	131
2934	2	2	2	122	0	128
2935	1	1	1	125	0	128
2936	108	0	1	3	0	112
2937	2	110	0	2	0	114
2938	102	1	0	3	0	106
2939	2	101	1	2	0	106
2940	0	101	2	0	0	103
2941	92	1	0	2	0	95
2942	1	89	2	1	0	93
2943	0	0	0	93	0	93
2944	1	2	89	1	0	93
2945	2	0	77	0	0	79
2946	0	0	70	0	0	70
2947	1	69	0	0	0	70
2948	55	0	0	1	0	56
2949	0	0	1	55	0	56
2950	0	1	0	55	0	56
2951	0	0	55	1	0	56
2952	54	0	1	0	0	55
2953	0	0	0	56	0	56
2954	0	1	0	54	0	55
2955	1	0	0	53	0	54
2956	52	0	0	1	0	53
2957	1	0	52	0	0	53
2958	52	0	0	0	0	52
2959	1	0	0	52	0	53
2960	1	0	52	0	0	53
2961	49	0	0	0	0	49
2962	0	1	51	0	0	52
2963	0	0	0	52	0	52
2964	0	0	52	1	0	53
2965	0	0	46	1	0	47
2966	44	0	0	0	0	44
2967	0	1	43	0	0	44
2968	1	0	0	42	0	43
2969	44	0	0	0	0	44
2970	0	0	0	46	0	46
2971	0	1	46	0	0	47
2972	1	0	46	0	0	47
2973	0	45	1	0	0	46
2974	0	0	0	42	0	42
2975	40	0	0	0	0	40
2976	0	41	0	0	0	41
2977	41	0	0	0	0	41
2978	0	0	0	40	0	40
2979	40	0	0	0	0	40
2980	0	39	0	0	0	39
2981	0	0	0	41	0	41
2982	40	0	0	0	0	40
2983	0	40	0	0	0	40
2984	0	0	0	41	0	41
2985	0	0	0	37	0	37
2986	38	0	0	0	0	38
2987	0	0	0	38	0	38
2988	0	0	0	38	0	38
2989	0	0	0	39	0	39
2990	0	0	40	0	0	40
2991	41	0	0	0	0	41
2992	0	0	0	48	0	48
2993	0	0	50	0	0	50
2994	50	0	0	0	0	50
2995	0	0	49	0	0	49
2996	1	0	0	49	0	50
2997	0	49	0	0	0	49
2998	0	0	0	47	0	47
2999	0	0	48	0	0	48
3000	0	0	52	0	0	52
3001	0	0	0	51	0	51
3002	0	0	50	0	0	50
3003	50	0	0	0	0	50
3004	0	0	48	0	0	48
3005	0	0	0	51	0	51
3006	0	0	0	47	0	47
3007	1	0	0	45	0	46
3008	47	0	0	0	0	47
3009	45	0	0	0	0	45
3010	48	0	0	0	0	48
3011	0	0	0	51	0	51
3012	0	0	0	53	0	53
3013	0	0	50	0	0	50
3014	0	0	48	0	0	48
3015	0	49	0	0	0	49
3016	0	1	0	47	0	48
3017	0	0	0	45	0	45
3018	0	43	0	0	0	43
3019	45	0	0	0	0	45
3020	0	46	0	0	0	46
3021	45	0	0	0	0	45
3022	0	0	0	46	0	46
3023	46	0	0	0	0	46
3024	0	0	0	45	0	45
3025	0	0	44	0	0	44
3026	0	0	0	44	0	44
3027	42	0	0	0	0	42
3028	1	0	0	42	0	43
3029	0	0	0	41	0	41
3030	0	0	40	0	0	40
3031	0	0	0	38	0	38
3032	0	0	0	39	0	39
3033	0	39	0	0	0	39
3034	0	0	0	41	0	41
3035	0	0	0	38	0	38
3036	0	0	0	40	0	40
3037	0	40	0	0	0	40
3038	0	0	0	42	0	42
3039	40	0	0	0	0	40
3040	0	37	0	0	0	37
3041	0	33	0	0	0	33
3042	0	36	0	0	0	36
3043	0	0	0	37	0	37
3044	0	34	0	1	0	35
3045	0	36	1	0	0	37
3046	36	0	0	0	0	36
3047	0	0	39	0	0	39
3048	37	0	0	1	0	38
3049	0	1	0	36	0	37
3050	0	0	35	1	0	36
3051	37	0	1	0	0	38
3052	0	0	36	0	0	36
3053	0	0	36	1	0	37
3054	38	0	1	0	0	39
3055	1	0	0	37	0	38
3056	0	0	39	0	0	39
3057	36	0	0	1	0	37
3058	38	0	0	1	0	39
3059	0	0	36	1	0	37
3060	40	0	0	0	0	40
3061	39	0	0	0	0	39
3062	0	0	39	1	0	40
3063	39	0	0	1	0	40
3064	40	0	0	1	0	41
3065	0	0	39	0	0	39
3066	0	0	41	0	0	41
3067	0	1	0	39	0	40
3068	1	0	39	0	0	40
3069	41	0	0	1	0	42
3070	0	1	0	37	0	38
3071	1	0	0	38	0	39
3072	0	2	37	0	0	39
3073	2	0	0	37	0	39
3074	1	1	37	0	0	39
3075	38	0	0	0	0	38
3076	39	0	0	1	0	40
3077	0	0	40	0	0	40
3078	38	0	0	1	0	39
3079	39	0	0	0	0	39
3080	0	0	40	1	0	41
3081	40	0	0	1	0	41
3082	40	0	1	0	0	41
3083	0	0	40	1	0	41
3084	39	0	0	0	0	39
3085	0	1	39	0	0	40
3086	0	0	0	40	0	40
3087	0	0	0	39	0	39
3088	0	0	0	40	0	40
3089	0	1	38	0	0	39
3090	35	0	0	1	0	36
3091	1	0	35	0	0	36
3092	0	27	0	0	0	27
3093	0	27	0	0	0	27
3094	26	0	0	0	0	26
3095	0	0	0	26	0	26
3096	0	25	0	0	0	25
3097	26	0	0	0	0	26
3098	26	0	0	0	0	26
3099	0	26	0	0	0	26
3100	0	0	0	21	0	21
3101	0	21	0	0	0	21
3102	24	0	0	0	0	24
3103	24	0	0	0	0	24
3104	0	0	0	24	0	24
3105	24	0	0	0	0	24
3106	0	0	0	24	0	24
3107	0	0	24	0	0	24
3108	24	0	0	0	0	24
3109	0	0	24	0	0	24
3110	0	0	0	18	0	18
3111	20	0	0	0	0	20
3112	0	0	0	19	0	19
3113	0	0	21	0	0	21
3114	0	0	22	0	0	22
3115	0	0	0	22	0	22
3116	22	0	0	0	0	22
3117	0	21	0	0	0	21
3118	0	0	0	22	0	22
3119	0	0	23	0	0	23
3120	20	0	0	0	0	20
3121	23	0	0	0	0	23
3122	0	0	21	0	0	21
3123	23	0	0	0	0	23
3124	0	0	0	23	0	23
3125	0	0	23	0	0	23
3126	22	0	0	0	0	22
3127	0	0	0	23	0	23
3128	0	0	0	24	0	24
3129	26	0	0	0	0	26
3130	0	25	0	0	0	25
3131	0	26	0	0	0	26
3132	25	0	0	0	0	25
3133	25	0	0	0	0	25
3134	0	0	24	0	0	24
3135	0	0	27	0	0	27
3136	0	0	0	25	0	25
3137	26	0	0	0	0	26
3138	26	0	0	0	0	26
3139	26	0	0	0	0	26
3140	0	26	0	0	0	26
3141	0	26	0	0	0	26
3142	0	0	0	26	0	26
3143	0	0	0	26	0	26
3144	0	0	0	28	0	28
3145	0	0	28	0	0	28
3146	0	0	23	0	0	23
3147	24	0	0	0	0	24
3148	26	0	0	0	0	26
3149	0	0	0	26	0	26
3150	0	0	0	26	0	26
3151	0	0	0	26	0	26
3152	0	0	25	0	0	25
3153	0	0	26	0	0	26
3154	0	0	0	25	0	25
3155	0	0	25	0	0	25
3156	0	26	0	0	0	26
3157	0	26	0	0	0	26
3158	26	0	0	0	0	26
3159	0	23	0	0	0	23
3160	0	0	0	28	0	28
3161	0	0	0	28	0	28
3162	0	35	0	0	0	35
3163	0	1	0	36	0	37
3164	0	0	35	1	0	36
3165	0	36	1	0	0	37
3166	0	1	0	37	0	38
3167	0	0	36	1	0	37
3168	0	37	1	0	0	38
3169	0	1	0	38	0	39
3170	0	38	0	1	0	39
3171	0	1	0	36	0	37
3172	0	0	0	37	0	37
3173	0	36	0	1	0	37
3174	36	1	0	0	0	37
3175	33	0	0	0	0	33
3176	1	33	0	0	0	34
3177	0	34	0	0	0	34
3178	0	1	0	35	0	36
3179	0	0	33	1	0	34
3180	32	0	1	0	0	33
3181	35	0	0	0	0	35
3182	1	0	33	0	0	34
3183	33	0	1	0	0	34
3184	33	0	0	0	0	33
3185	1	0	33	0	0	34
3186	34	0	1	0	0	35
3187	1	0	34	0	0	35
3188	0	33	1	0	0	34
3189	34	1	0	0	0	35
3190	34	0	0	0	0	34
3191	1	0	34	0	0	35
3192	32	1	1	0	0	34
3193	33	0	0	1	0	34
3194	1	0	32	0	0	33
3195	33	1	1	0	0	35
3196	34	0	0	1	0	35
3197	1	0	34	0	0	35
3198	32	1	1	0	0	34
3199	1	0	0	33	0	34
3200	0	1	0	33	0	34
3201	0	0	33	2	0	35
3202	0	0	34	1	0	35
3203	0	1	1	35	0	37
3204	1	0	0	36	0	37
3205	37	0	0	2	0	39
3206	1	1	38	0	0	40
3207	36	1	1	0	0	38
3208	1	0	0	38	0	39
3209	0	0	40	1	0	41
3210	38	0	1	0	0	39
3211	2	0	0	39	0	41
3212	0	0	42	1	0	43
3213	36	0	1	0	0	37
3214	2	0	0	36	0	38
3215	39	0	1	2	0	42
3216	2	0	43	0	0	45
3217	0	0	2	42	0	44
3218	0	45	0	1	0	46
3219	44	1	0	0	0	45
3220	43	1	0	1	0	45
3221	1	44	1	0	0	46
3222	47	1	0	0	0	48
3223	47	1	0	0	0	48
3224	48	0	1	0	0	49
3225	3	45	0	0	0	48
3226	2	2	0	45	0	49
3227	0	0	46	1	0	47
3228	1	0	1	45	0	47
3229	0	0	1	42	0	43
3230	0	0	41	3	0	44
3231	0	0	43	1	0	44
3232	0	0	3	39	0	42
3233	0	43	1	2	0	46
3234	43	1	0	1	0	45
3235	42	1	0	0	0	43
3236	2	40	1	0	0	43
3237	40	1	0	0	0	41
3238	38	1	0	1	0	40
3239	2	0	39	0	0	41
3240	41	0	2	0	0	43
3241	1	39	1	2	0	43
3242	1	1	40	0	0	42
3243	2	1	39	0	0	42
3244	1	37	2	1	0	41
3245	38	2	0	0	0	40
3246	2	1	37	0	0	40
3247	2	0	1	37	0	40
3248	1	1	37	1	0	40
3249	37	1	1	1	0	40
3250	2	0	47	1	0	50
3251	1	1	50	0	0	52
3252	50	0	2	1	0	53
3253	1	49	1	1	0	52
3254	52	2	1	0	0	55
3255	54	2	1	0	0	57
3256	2	0	0	54	0	56
3257	1	65	1	1	0	68
3258	65	1	0	1	0	67
3259	2	1	66	1	0	70
3260	65	1	2	0	0	68
3261	2	63	1	0	0	66
3262	57	0	0	0	0	57
3263	55	1	0	0	0	56
3264	2	54	0	0	0	56
3265	2	1	0	52	0	55
3266	54	1	1	0	0	56
3267	0	52	1	1	0	54
3268	2	1	0	53	0	56
3269	56	0	0	0	0	56
3270	0	0	1	58	0	59
3271	1	0	0	58	0	59
3272	0	57	1	1	0	59
3273	60	0	0	1	0	61
3274	60	1	0	0	0	61
3275	63	0	1	0	0	64
3276	2	62	0	0	0	64
3277	66	1	0	0	0	67
3278	65	1	0	0	0	66
3279	2	0	0	65	0	67
3280	1	0	0	66	0	67
3281	0	1	65	1	0	67
3282	1	0	0	65	0	66
3283	0	0	2	63	0	65
3284	1	0	62	1	0	64
3285	63	1	0	1	0	65
3286	1	0	65	0	0	66
3287	2	0	65	0	0	67
3288	0	1	1	65	0	67
3289	0	0	1	67	0	68
3290	1	68	0	1	0	70
3291	69	0	0	0	0	69
3292	69	1	0	1	0	71
3293	2	68	0	0	0	70
3294	1	75	0	1	0	77
3295	0	1	0	76	0	77
3296	0	75	0	0	0	75
3297	77	1	0	1	0	79
3298	77	1	0	0	0	78
3299	1	0	0	76	0	77
3300	1	1	0	75	0	77
3301	77	0	0	2	0	79
3302	2	0	73	1	0	76
3303	74	0	1	1	0	76
3304	1	0	74	1	0	76
3305	73	0	2	0	0	75
3306	1	0	1	75	0	77
3307	1	0	76	2	0	79
3308	0	0	77	1	0	78
3309	75	0	2	0	0	77
3310	77	0	2	0	0	79
3311	2	82	1	0	0	85
3312	1	1	0	85	0	87
3313	0	1	0	86	0	87
3314	84	1	1	1	0	87
3315	2	82	0	1	0	85
3316	83	1	0	0	0	84
3317	1	83	0	0	0	84
3318	0	81	0	0	0	81
3319	79	1	0	2	0	82
3320	1	0	80	0	0	81
3321	0	0	0	81	0	81
3322	0	0	0	81	0	81
3323	0	0	79	0	0	79
3324	0	0	1	79	0	80
3325	0	0	1	73	0	74
3326	0	80	0	1	0	81
3327	80	1	0	1	0	82
3328	1	0	81	0	0	82
3329	80	0	1	0	0	81
3330	1	81	0	0	0	82
3331	0	1	0	81	0	82
3332	85	0	0	1	0	86
3333	1	0	0	88	0	89
3334	0	0	0	89	0	89
3335	1	0	88	0	0	89
3336	88	0	0	0	0	88
3337	88	0	0	1	0	89
3338	1	0	87	0	0	88
3339	0	0	0	90	0	90
3340	0	0	90	1	0	91
3341	87	0	1	1	0	89
3342	91	0	0	1	0	92
3343	1	0	0	92	0	93
3344	93	0	0	1	0	94
3345	1	0	104	0	0	105
3346	0	0	1	105	0	106
3347	0	0	0	104	0	104
3348	0	0	0	104	0	104
3349	0	0	0	103	0	103
3350	94	0	0	1	0	95
3351	1	0	93	0	0	94
3352	0	0	1	91	0	92
3353	0	0	91	1	0	92
3354	0	0	92	0	0	92
3355	0	0	1	90	0	91
3356	0	0	0	90	0	90
3357	79	0	0	2	0	81
3358	1	0	0	80	0	81
3359	0	0	0	79	0	79
3360	1	0	0	79	0	80
3361	78	0	0	2	0	80
3362	79	0	0	1	0	80
3363	81	0	0	0	0	81
3364	79	0	0	1	0	80
3365	1	84	0	0	0	85
3366	0	1	0	84	0	85
3367	0	0	0	85	0	85
3368	85	0	0	2	0	87
3369	2	93	0	0	0	95
3370	0	1	0	100	0	101
3371	0	0	105	2	0	107
3372	127	0	2	0	0	129
3373	5	130	0	0	0	135
3374	132	5	2	0	0	139
3375	140	0	0	0	0	140
3376	5	0	0	137	0	142
3377	0	0	138	4	0	142
3378	0	0	5	145	0	150
3379	147	0	0	6	0	153
3380	4	0	0	147	0	151
3381	148	0	0	5	0	153
3382	5	147	0	0	0	152
3383	148	5	0	0	0	153
3384	4	0	0	148	0	152
3385	0	0	0	159	0	159
3386	153	0	1	4	0	158
3387	155	0	0	1	0	156
3388	154	0	0	1	0	155
3389	155	0	0	0	0	155
3390	154	0	0	0	0	154
3391	6	0	0	148	0	154
3392	1	0	144	4	0	149
3393	1	143	2	0	0	146
3394	142	4	0	1	0	147
3395	4	0	139	0	0	143
3396	141	1	5	0	0	147
3397	6	138	0	0	0	144
3398	140	4	1	0	0	145
3399	8	0	0	142	0	150
3400	1	3	0	146	0	150
3401	3	0	142	5	0	150
3402	2	0	5	142	0	149
3403	1	0	139	8	0	148
3404	1	0	148	0	0	149
3405	141	0	4	4	0	149
3406	149	0	1	0	0	150
3407	4	1	145	2	0	152
3408	146	0	3	0	0	149
3409	146	2	0	1	0	149
3410	6	0	141	1	0	148
3411	2	132	4	2	0	140
3412	2	4	0	141	0	147
3413	144	0	1	4	0	149
3414	150	1	0	0	0	151
3415	149	0	0	2	0	151
3416	152	0	0	1	0	153
3417	149	0	1	0	0	150
3418	6	1	144	2	0	153
3419	3	0	150	0	0	153
3420	2	2	4	148	0	156
3421	153	0	2	4	0	159
3422	152	1	3	0	0	156
3423	159	0	0	2	0	161
3424	155	2	0	2	0	159
3425	8	153	1	1	0	163
3426	2	164	1	2	0	169
3427	163	4	0	5	0	172
3428	167	2	3	0	0	172
3429	4	160	1	2	0	167
3430	171	4	2	0	0	177
3431	6	0	169	0	0	175
3432	1	2	5	162	0	170
3433	5	0	164	4	0	173
3434	1	0	167	0	0	168
3435	2	0	5	167	0	174
3436	2	1	1	171	0	175
3437	0	1	170	5	0	176
3438	2	0	4	164	0	170
3439	1	0	0	176	0	177
3440	171	0	2	4	0	177
3441	171	0	0	2	0	173
3442	7	0	0	168	0	175
3443	4	0	171	4	0	179
3444	4	168	4	0	0	176
3445	160	4	2	3	0	169
3446	5	0	169	0	0	174
3447	1	163	4	2	0	170
3448	5	175	0	0	0	180
3449	176	4	2	0	0	182
3450	178	2	0	0	0	180
3451	6	3	0	171	0	180
3452	2	1	189	4	0	196
3453	3	2	4	192	0	201
3454	2	1	0	199	0	202
3455	2	0	0	198	0	200
3456	192	2	1	6	0	201
3457	6	192	0	3	0	201
3458	0	202	2	2	0	206
3459	2	4	1	201	0	208
3460	0	2	2	209	0	213
3461	205	2	2	5	0	214
3462	207	0	1	4	0	212
3463	199	0	0	4	0	203
3464	6	205	1	1	0	213
3465	202	4	0	1	0	207
3466	6	0	0	202	0	208
3467	2	2	199	5	0	208
3468	4	0	193	0	0	197
3469	187	0	1	4	0	192
3470	4	0	185	0	0	189
3471	0	3	175	0	0	178
3472	155	0	1	0	0	156
3473	0	0	152	0	0	152
3474	0	0	151	0	0	151
3475	3	3	1	142	0	149
3476	0	0	154	0	0	154
3477	0	0	1	149	0	150
3478	0	0	0	149	0	149
3479	0	0	153	0	0	153
3480	0	146	0	1	0	147
3481	155	0	0	2	0	157
3482	0	0	160	0	0	160
3483	0	1	154	0	0	155
3484	147	0	0	0	0	147
3485	0	0	159	0	0	159
3486	0	157	0	0	0	157
3487	1	148	1	0	0	150
3488	0	0	2	159	0	161
3489	0	0	0	155	0	155
3490	167	1	0	0	0	168
3491	164	0	0	1	0	165
3492	162	0	0	1	0	163
3493	1	0	0	169	0	170
3494	173	0	0	0	0	173
3495	168	0	0	1	0	169
3496	0	0	175	1	0	176
3497	1	0	169	0	0	170
3498	1	179	0	0	0	180
3499	0	0	1	179	0	180
3500	179	0	0	0	0	179
3501	0	178	0	0	0	178
3502	0	1	0	186	0	187
3503	186	0	0	0	0	186
3504	180	1	0	0	0	181
3505	0	184	0	1	0	185
3506	186	0	0	0	0	186
3507	183	0	0	0	0	183
3508	0	0	0	185	0	185
3509	1	0	185	0	0	186
3510	1	181	0	0	0	182
3511	0	184	0	1	0	185
3512	179	0	0	0	0	179
3513	0	0	0	182	0	182
3514	0	0	179	0	0	179
3515	0	182	0	0	0	182
3516	182	0	0	0	0	182
3517	183	0	0	0	0	183
3518	0	0	184	0	0	184
3519	0	0	0	184	0	184
3520	0	0	0	192	0	192
3521	0	0	205	0	0	205
3522	202	0	0	0	0	202
3523	246	0	0	0	0	246
3524	2	0	0	285	0	287
3525	0	284	0	3	0	287
3526	0	3	0	305	0	308
3527	0	0	303	4	0	307
3528	298	1	3	0	0	302
3529	4	0	0	308	0	312
3530	0	0	303	3	0	306
3531	302	0	2	1	0	305
3532	3	0	0	306	0	309
3533	1	0	1	300	0	302
3534	302	0	0	3	0	305
3535	3	299	0	1	0	303
3536	299	3	0	1	0	303
3537	4	0	0	297	0	301
3538	298	1	1	3	0	303
3539	4	0	300	0	0	304
3540	1	296	3	1	0	301
3541	1	2	0	300	0	303
3542	298	1	1	3	0	303
3543	3	300	1	0	0	304
3544	1	3	1	302	0	307
3545	304	0	0	3	0	307
3546	302	1	0	2	0	305
3547	3	0	1	296	0	300
3548	2	0	291	3	0	296
3549	1	0	286	1	0	288
3550	288	0	3	2	0	293
3551	4	288	1	0	0	293
3552	0	274	2	1	0	277
3553	270	4	0	1	0	275
3554	3	275	0	3	0	281
3555	2	2	2	277	0	283
3556	2	0	1	282	0	285
3557	283	2	0	5	0	290
3558	273	0	1	3	0	277
3559	279	0	0	2	0	281
3560	4	1	271	0	0	276
3561	3	0	2	275	0	280
3562	4	0	271	4	0	279
3563	2	1	272	1	0	276
3564	1	1	277	2	0	281
3565	0	0	4	275	0	279
3566	1	1	275	4	0	281
3567	3	0	275	0	0	278
3568	0	3	3	271	0	277
3569	269	1	1	4	0	275
3570	6	0	271	0	0	277
3571	2	2	3	270	0	277
3572	2	0	0	274	0	276
3573	1	0	269	4	0	274
3574	3	1	4	262	0	270
3575	3	0	266	6	0	275
3576	2	1	5	258	0	266
3577	2	2	2	263	0	269
3578	2	1	2	262	0	267
3579	1	2	1	256	0	260
3580	254	1	1	7	0	263
3581	256	0	1	2	0	259
3582	3	2	244	3	0	252
3583	2	247	4	2	0	255
3584	3	2	247	3	0	255
3585	3	0	243	1	0	247
3586	246	1	3	2	0	252
3587	4	249	3	2	0	258
3588	249	4	4	1	0	258
3589	7	246	1	2	0	256
3590	243	6	2	3	0	254
3591	247	0	2	2	0	251
3592	6	1	3	242	0	252
3593	2	240	0	7	0	249
3594	3	5	1	238	0	247
3595	0	1	2	245	0	248
3596	3	1	232	7	0	243
3597	3	235	5	2	0	245
3598	2	4	1	235	0	242
3599	234	0	2	8	0	244
3600	243	2	1	4	0	250
3601	242	0	2	3	0	247
3602	7	236	2	3	0	248
3603	244	4	3	1	0	252
3604	6	254	0	4	0	264
3605	2	6	2	258	0	268
3606	2	1	255	6	0	264
3607	2	1	6	254	0	263
3608	4	251	1	7	0	263
3609	1	5	3	252	0	261
3610	0	3	1	260	0	264
3611	1	255	1	9	0	266
3612	254	7	2	3	0	266
3613	6	1	3	252	0	262
3614	2	3	248	7	0	260
3615	4	0	4	251	0	259
3616	2	0	2	253	0	257
3617	2	1	253	9	0	265
3618	1	1	7	247	0	256
3619	1	248	1	6	0	256
3620	4	5	243	4	0	256
3621	1	2	226	2	0	231
3622	0	215	6	2	0	223
3623	1	183	1	1	0	186
3624	2	149	0	0	0	151
3625	134	3	9	1	0	147
3626	121	3	4	0	0	128
3627	126	0	0	0	0	126
3628	3	0	0	124	0	127
3629	1	0	121	2	0	124
3630	0	0	2	122	0	124
3631	0	0	1	121	0	122
3632	117	0	0	3	0	120
3633	122	0	0	1	0	123
3634	3	118	0	0	0	121
3635	119	2	0	0	0	121
3636	120	1	0	0	0	121
3637	123	0	0	0	0	123
3638	3	0	120	0	0	123
3639	2	0	117	0	0	119
3640	0	1	3	116	0	120
3641	0	0	115	3	0	118
3642	113	0	3	1	0	117
3643	116	0	1	1	0	118
3644	3	1	107	0	0	111
3645	108	0	2	1	0	111
3646	2	106	1	1	0	110
3647	107	3	0	1	0	111
3648	3	1	0	104	0	108
3649	1	0	0	104	0	105
3650	0	106	1	3	0	110
3651	106	2	0	1	0	109
3652	108	1	0	1	0	110
3653	3	105	1	0	0	109
3654	1	2	0	101	0	104
3655	0	2	0	102	0	104
3656	0	100	1	3	0	104
3657	0	2	1	96	0	99
3658	0	2	0	99	0	101
3659	96	1	0	3	0	100
3660	94	1	0	1	0	96
3661	4	0	90	0	0	94
3662	90	0	2	0	0	92
3663	3	0	88	0	0	91
3664	1	0	2	86	0	89
3665	0	0	87	2	0	89
3666	0	81	3	4	0	88
3667	0	2	1	86	0	89
3668	1	1	0	89	0	91
3669	88	0	0	3	0	91
3670	2	1	0	86	0	89
3671	2	0	87	2	0	91
3672	93	0	2	1	0	96
3673	96	0	1	0	0	97
3674	93	0	1	0	0	94
3675	94	0	1	1	0	96
3676	4	0	0	100	0	104
3677	1	0	1	100	0	102
3678	2	0	0	106	0	108
3679	1	0	0	107	0	108
3680	106	0	1	4	0	111
3681	110	0	0	1	0	111
3682	3	0	0	101	0	104
3683	2	103	0	3	0	108
3684	104	3	0	2	0	109
3685	3	1	102	1	0	107
3686	1	102	3	0	0	106
3687	96	2	1	0	0	99
3688	2	95	0	0	0	97
3689	1	3	93	0	0	97
3690	96	1	2	1	0	100
3691	98	0	1	1	0	100
3692	3	1	95	0	0	99
3693	1	0	2	98	0	101
3694	0	0	1	102	0	103
3695	1	96	0	3	0	100
3696	1	2	0	100	0	103
3697	97	0	1	2	0	100
3698	2	93	0	1	0	96
3699	1	2	0	89	0	92
3700	1	0	0	89	0	90
3701	0	0	88	2	0	90
3702	0	84	1	1	0	86
3703	72	2	1	2	0	77
3704	1	62	0	0	0	63
3705	0	62	0	0	0	62
3706	61	1	0	0	0	62
3707	1	0	0	61	0	62
3708	0	0	0	61	0	61
3709	58	0	0	1	0	59
3710	1	0	0	58	0	59
3711	0	0	0	59	0	59
3712	58	0	0	1	0	59
3713	1	0	0	56	0	57
3714	0	57	0	1	0	58
3715	58	1	0	0	0	59
3716	1	0	56	0	0	57
3717	0	52	1	0	0	53
3718	0	1	0	51	0	52
3719	0	0	49	1	0	50
3720	0	0	49	0	0	49
3721	0	2	1	44	0	47
3722	47	0	0	1	0	48
3723	1	0	0	46	0	47
3724	0	0	0	46	0	46
3725	0	1	0	45	0	46
3726	0	0	0	46	0	46
3727	0	0	0	44	0	44
3728	0	0	42	1	0	43
3729	0	0	42	0	0	42
3730	0	0	1	42	0	43
3731	0	0	42	1	0	43
3732	0	42	1	0	0	43
3733	0	1	0	42	0	43
3734	0	0	42	1	0	43
3735	41	0	1	0	0	42
3736	1	41	0	0	0	42
3737	0	44	0	0	0	44
3738	0	43	0	0	0	43
3739	0	1	0	41	0	42
3740	41	0	0	1	0	42
3741	1	0	0	41	0	42
3742	41	0	0	1	0	42
3743	1	41	0	0	0	42
3744	41	1	0	0	0	42
3745	1	0	0	42	0	43
3746	0	0	0	43	0	43
3747	0	42	0	1	0	43
3748	0	1	0	42	0	43
3749	0	0	0	43	0	43
3750	0	0	0	43	0	43
3751	42	0	0	1	0	43
3752	39	0	0	0	0	39
3753	1	0	42	0	0	43
3754	42	0	1	0	0	43
3755	1	0	42	0	0	43
3756	0	0	1	40	0	41
3757	0	0	0	39	0	39
3758	0	0	0	42	0	42
3759	0	0	41	1	0	42
3760	0	0	1	40	0	41
3761	0	0	40	1	0	41
3762	0	0	1	42	0	43
3763	42	0	0	1	0	43
3764	1	0	41	0	0	42
3765	43	0	1	0	0	44
3766	1	0	0	44	0	45
3767	45	0	0	2	0	47
3768	1	45	0	0	0	46
3769	0	1	0	45	0	46
3770	0	0	45	1	0	46
3771	1	0	1	40	0	42
3772	0	0	0	35	0	35
3773	0	35	0	1	0	36
3774	0	1	36	0	0	37
3775	0	36	1	0	0	37
3776	28	1	0	0	0	29
3777	1	36	0	0	0	37
3778	32	1	1	0	0	34
3779	32	0	0	0	0	32
3780	31	0	0	0	0	31
3781	0	0	0	31	0	31
3782	0	0	30	0	0	30
3783	0	0	0	30	0	30
3784	0	31	0	0	0	31
3785	0	0	0	30	0	30
3786	30	0	0	0	0	30
3787	0	32	0	0	0	32
3788	0	0	0	32	0	32
3789	0	0	0	32	0	32
3790	32	0	0	0	0	32
3791	0	0	31	0	0	31
3792	0	32	0	0	0	32
3793	0	0	0	30	0	30
3794	0	0	28	0	0	28
3795	0	0	0	27	0	27
3796	0	28	0	0	0	28
3797	0	0	0	28	0	28
3798	0	0	0	29	0	29
3799	0	0	0	27	0	27
3800	0	0	27	0	0	27
3801	27	0	0	0	0	27
3802	0	0	0	29	0	29
3803	31	0	0	0	0	31
3804	32	0	0	0	0	32
3805	31	0	0	0	0	31
3806	32	0	0	0	0	32
3807	32	0	0	0	0	32
3808	1	0	0	32	0	33
3809	0	32	0	1	0	33
3810	0	1	0	31	0	32
3811	0	31	0	1	0	32
3812	0	1	0	31	0	32
3813	30	0	0	1	0	31
3814	1	0	0	29	0	30
3815	0	0	30	1	0	31
3816	30	0	1	0	0	31
3817	1	30	0	0	0	31
3818	30	1	0	0	0	31
3819	31	0	0	0	0	31
3820	30	0	0	0	0	30
3821	1	29	0	0	0	30
3822	0	1	0	27	0	28
3823	0	0	0	27	0	27
3824	0	0	27	1	0	28
3825	0	0	1	27	0	28
3826	0	0	0	25	0	25
3827	0	0	0	27	0	27
3828	0	27	0	1	0	28
3829	27	1	0	0	0	28
3830	29	0	0	0	0	29
3831	2	0	31	0	0	33
3832	0	30	2	0	0	32
3833	0	2	0	31	0	33
3834	0	0	0	33	0	33
3835	0	0	0	33	0	33
3836	0	0	0	33	0	33
3837	0	0	0	33	0	33
3838	0	0	30	3	0	33
3839	0	0	33	0	0	33
3840	31	0	3	0	0	34
3841	37	0	0	0	0	37
3842	37	0	0	0	0	37
3843	3	0	0	34	0	37
3844	0	0	34	3	0	37
3845	34	0	3	0	0	37
3846	38	0	0	0	0	38
3847	4	0	34	0	0	38
3848	34	0	4	0	0	38
3849	4	0	36	0	0	40
3850	0	0	4	37	0	41
3851	0	0	38	4	0	42
3852	38	0	4	0	0	42
3853	42	0	0	0	0	42
3854	41	0	0	0	0	41
3855	44	0	0	0	0	44
3856	4	0	41	0	0	45
3857	0	40	4	0	0	44
3858	40	4	0	1	0	45
3859	45	0	0	0	0	45
3860	4	0	42	0	0	46
3861	0	0	3	42	0	45
3862	0	0	0	45	0	45
3863	0	0	41	4	0	45
3864	40	0	4	0	0	44
3865	44	0	0	0	0	44
3866	4	38	0	0	0	42
3867	36	4	0	0	0	40
3868	38	0	0	0	0	38
3869	41	0	0	0	0	41
3870	41	0	0	0	0	41
3871	4	0	37	0	0	41
3872	37	0	4	0	0	41
3873	5	0	0	36	0	41
3874	0	37	0	4	0	41
3875	0	4	36	0	0	40
3876	0	36	4	0	0	40
3877	1	4	1	26	0	32
3878	0	0	26	4	0	30
3879	26	0	4	0	0	30
3880	4	0	26	0	0	30
3881	26	0	4	0	0	30
3882	4	0	0	25	0	29
3883	0	0	0	30	0	30
3884	0	26	0	4	0	30
3885	0	30	0	0	0	30
3886	0	3	0	27	0	30
3887	24	0	0	4	0	28
3888	28	0	0	0	0	28
3889	28	0	0	0	0	28
3890	4	0	24	0	0	28
3891	24	0	4	0	0	28
3892	4	0	25	0	0	29
3893	0	0	28	0	0	28
3894	23	1	4	0	0	28
3895	28	0	0	0	0	28
3896	4	0	23	0	0	27
3897	0	0	4	24	0	28
3898	0	0	0	28	0	28
3899	24	0	0	4	0	28
3900	28	0	0	0	0	28
3901	4	0	27	0	0	31
3902	0	26	4	0	0	30
3903	0	28	0	0	0	28
3904	26	3	0	0	0	29
3905	3	0	0	26	0	29
3906	0	0	0	29	0	29
3907	0	0	0	32	0	32
3908	28	0	0	3	0	31
3909	4	0	0	28	0	32
3910	29	0	0	3	0	32
3911	32	0	0	0	0	32
3912	3	32	1	0	0	36
3913	1	3	0	34	0	38
3914	1	0	34	3	0	38
3915	34	0	4	0	0	38
3916	38	0	0	0	0	38
3917	37	0	1	0	0	38
3918	3	0	35	1	0	39
3919	0	0	4	35	0	39
3920	36	0	0	3	0	39
3921	39	0	0	0	0	39
3922	39	0	0	0	0	39
3923	4	35	0	0	0	39
3924	0	44	1	0	0	45
3925	0	3	0	42	0	45
3926	1	0	0	45	0	46
3927	1	42	0	3	0	46
3928	41	3	1	0	0	45
3929	3	0	44	0	0	47
3930	0	0	2	43	0	45
3931	0	0	1	43	0	44
3932	1	0	41	2	0	44
3933	41	0	2	0	0	43
3934	44	1	0	0	0	45
3935	3	41	0	0	0	44
3936	43	1	0	0	0	44
3937	2	0	43	0	0	45
3938	44	0	1	0	0	45
3939	1	0	45	0	0	46
3940	42	0	1	0	0	43
3941	39	0	0	0	0	39
3942	39	0	0	0	0	39
3943	39	0	0	0	0	39
3944	1	39	0	0	0	40
3945	39	0	0	0	0	39
3946	41	0	0	0	0	41
3947	0	0	42	0	0	42
3948	38	0	0	1	0	39
3949	0	0	0	39	0	39
3950	0	0	38	0	0	38
3951	38	0	0	0	0	38
3952	0	0	0	39	0	39
3953	41	0	0	0	0	41
3954	42	0	0	0	0	42
3955	0	0	45	0	0	45
3956	45	0	0	0	0	45
3957	44	0	1	0	0	45
3958	45	0	0	0	0	45
3959	46	0	0	0	0	46
3960	0	0	0	44	0	44
3961	0	45	0	0	0	45
3962	44	0	0	0	0	44
3963	43	0	0	1	0	44
3964	45	0	0	0	0	45
3965	0	0	45	0	0	45
3966	0	46	0	0	0	46
3967	0	0	0	46	0	46
3968	0	0	0	46	0	46
3969	0	0	52	0	0	52
3970	0	0	0	52	0	52
3971	0	0	55	0	0	55
3972	0	0	0	57	0	57
3973	0	0	0	57	0	57
3974	0	0	60	0	0	60
3975	60	0	0	0	0	60
3976	65	0	0	0	0	65
3977	0	0	65	0	0	65
3978	66	0	0	0	0	66
3979	66	0	0	0	0	66
3980	0	0	70	0	0	70
3981	0	0	0	70	0	70
3982	0	0	0	70	0	70
3983	70	0	0	0	0	70
3984	0	78	0	0	0	78
3985	78	0	0	0	0	78
3986	77	0	0	0	0	77
3987	0	78	0	0	0	78
3988	80	0	0	0	0	80
3989	79	0	0	0	0	79
3990	0	80	0	0	0	80
3991	0	0	0	84	0	84
3992	0	84	0	0	0	84
3993	0	0	0	84	0	84
3994	0	0	83	0	0	83
3995	0	0	84	0	0	84
3996	81	0	0	0	0	81
3997	83	0	0	0	0	83
3998	0	0	82	0	0	82
3999	83	0	0	0	0	83
4000	84	0	0	0	0	84
4001	81	0	0	0	0	81
4002	0	80	0	0	0	80
4003	0	0	0	81	0	81
4004	80	0	0	0	0	80
4005	77	0	0	0	0	77
4006	0	0	82	0	0	82
4007	0	0	0	79	0	79
4008	0	0	0	79	0	79
4009	0	79	0	0	0	79
4010	0	85	0	0	0	85
4011	0	0	0	82	0	82
4012	0	83	0	0	0	83
4013	81	0	0	0	0	81
4014	0	86	0	0	0	86
4015	87	0	0	0	0	87
4016	0	0	86	0	0	86
4017	88	0	0	0	0	88
4018	92	0	0	0	0	92
4019	96	0	0	0	0	96
4020	93	0	0	0	0	93
4021	1	98	0	0	0	99
4022	1	0	0	97	0	98
4023	0	1	0	95	0	96
4024	0	0	91	1	0	92
4025	0	0	0	91	0	91
4026	0	0	0	91	0	91
4027	94	0	0	1	0	95
4028	0	93	0	0	0	93
4029	1	0	0	98	0	99
4030	0	1	0	96	0	97
4031	0	0	0	99	0	99
4032	98	0	0	1	0	99
4033	0	0	0	98	0	98
4034	99	0	0	0	0	99
4035	0	0	0	99	0	99
4036	1	0	0	101	0	102
4037	0	0	99	1	0	100
4038	93	0	0	1	0	94
4039	0	96	1	0	0	97
4040	106	0	0	0	0	106
4041	0	1	0	106	0	107
4042	1	0	0	105	0	106
4043	111	0	0	0	0	111
4044	108	0	0	1	0	109
4045	1	0	0	120	0	121
4046	1	0	118	0	0	119
4047	0	0	114	0	0	114
4048	0	120	1	1	0	122
4049	127	0	0	0	0	127
4050	128	1	0	0	0	129
4051	1	0	0	129	0	130
4052	1	132	0	0	0	133
4053	0	0	0	131	0	131
4054	0	1	0	129	0	130
4055	0	125	0	1	0	126
4056	126	0	0	1	0	127
4057	0	1	0	128	0	129
4058	1	125	0	0	0	126
4059	0	126	0	1	0	127
4060	129	0	0	0	0	129
4061	0	1	128	0	0	129
4062	132	0	0	0	0	132
4063	0	0	1	130	0	131
4064	1	0	0	131	0	132
4065	0	130	0	1	0	131
4066	0	0	0	135	0	135
4067	0	1	132	0	0	133
4068	0	125	1	1	0	127
4069	0	127	0	0	0	127
4070	124	0	0	0	0	124
4071	0	127	0	0	0	127
4072	1	0	0	126	0	127
4073	0	126	0	0	0	126
4074	0	0	0	123	0	123
4075	0	1	0	122	0	123
4076	0	0	118	1	0	119
4077	0	0	0	118	0	118
4078	0	0	0	117	0	117
4079	117	0	0	1	0	118
4080	0	0	117	1	0	118
4081	1	0	0	115	0	116
4082	0	0	113	0	0	113
4083	116	0	0	1	0	117
4084	0	115	0	0	0	115
4085	119	0	0	0	0	119
4086	0	1	0	120	0	121
4087	1	0	0	121	0	122
4088	0	0	120	1	0	121
4089	115	0	0	1	0	116
4090	0	123	1	0	0	124
4091	121	0	0	0	0	121
4092	0	1	0	125	0	126
4093	2	122	0	0	0	124
4094	123	0	0	0	0	123
4095	0	131	0	0	0	131
4096	2	0	0	130	0	132
4097	1	1	0	130	0	132
4098	0	0	0	130	0	130
4099	0	126	0	1	0	127
4100	0	0	0	128	0	128
4101	0	1	0	129	0	130
4102	129	0	0	0	0	129
4103	128	0	0	1	0	129
4104	128	0	0	0	0	128
4105	1	0	134	0	0	135
4106	134	0	0	0	0	134
4107	132	0	1	0	0	133
4108	128	0	0	0	0	128
4109	1	0	130	0	0	131
4110	125	0	0	0	0	125
4111	0	0	0	130	0	130
4112	1	0	132	0	0	133
4113	0	130	0	1	0	131
4114	1	0	1	127	0	129
4115	0	121	0	0	0	121
4116	0	131	0	1	0	132
4117	123	0	0	0	0	123
4118	0	0	0	121	0	121
4119	122	0	0	0	0	122
4120	0	0	0	122	0	122
4121	122	0	0	0	0	122
4122	0	0	0	122	0	122
4123	120	0	0	0	0	120
4124	0	0	119	0	0	119
4125	0	0	0	118	0	118
4126	0	0	123	0	0	123
4127	0	0	113	0	0	113
4128	0	0	125	0	0	125
4129	0	0	0	120	0	120
4130	0	0	120	0	0	120
4131	123	0	0	0	0	123
4132	0	0	0	124	0	124
4133	0	0	139	0	0	139
4134	0	0	0	137	0	137
4135	0	0	0	135	0	135
4136	0	0	145	0	0	145
4137	0	0	0	147	0	147
4138	0	0	0	143	0	143
4139	0	148	0	0	0	148
4140	146	0	0	0	0	146
4141	142	0	0	0	0	142
4142	0	0	140	0	0	140
4143	136	0	0	0	0	136
4144	0	1	128	0	0	129
4145	0	0	126	0	0	126
4146	0	0	129	0	0	129
4147	0	2	0	122	0	124
4148	0	1	130	0	0	131
4149	0	2	0	122	0	124
4150	0	0	0	128	0	128
4151	0	0	0	130	0	130
4152	0	0	0	129	0	129
4153	130	0	0	0	0	130
4154	127	0	0	0	0	127
4155	0	126	1	0	0	127
4156	0	0	0	129	0	129
4157	0	0	129	0	0	129
4158	0	134	0	0	0	134
4159	0	0	0	140	0	140
4160	0	0	143	0	0	143
4161	0	0	0	138	0	138
4162	0	0	140	0	0	140
4163	0	0	137	0	0	137
4164	0	0	0	140	0	140
4165	0	0	0	142	0	142
4166	140	0	0	0	0	140
4167	0	0	0	142	0	142
4168	142	0	0	0	0	142
4169	0	140	0	0	0	140
4170	0	145	1	0	0	146
4171	0	0	0	150	0	150
4172	145	0	0	1	0	146
4173	0	146	0	0	0	146
4174	0	0	0	151	0	151
4175	159	0	0	0	0	159
4176	153	0	0	1	0	154
4177	155	0	0	0	0	155
4178	155	0	0	0	0	155
4179	158	0	0	0	0	158
4180	0	0	155	0	0	155
4181	0	0	151	0	0	151
4182	0	154	0	0	0	154
4183	0	0	0	153	0	153
4184	0	0	161	0	0	161
4185	0	0	161	0	0	161
4186	0	0	0	159	0	159
4187	0	0	168	0	0	168
4188	0	0	163	1	0	164
4189	0	213	0	0	0	213
4190	210	1	1	0	0	212
4191	1	233	1	0	0	235
4192	0	2	0	240	0	242
4193	243	0	0	1	0	244
4194	1	246	0	0	0	247
4195	0	1	0	243	0	244
4196	0	0	249	1	0	250
4197	252	1	1	0	0	254
4198	256	0	0	1	0	257
4199	258	0	1	0	0	259
4200	2	0	0	256	0	258
4201	1	1	253	0	0	255
4202	1	258	1	0	0	260
4203	1	1	0	256	0	258
4204	257	0	1	2	0	260
4205	1	1	251	0	0	253
4206	0	242	1	3	0	246
4207	1	1	252	0	0	254
4208	254	0	2	0	0	256
4209	259	1	0	0	0	260
4210	255	0	1	0	0	256
4211	2	0	254	0	0	256
4212	1	252	2	0	0	255
4213	1	1	0	255	0	257
4214	0	0	0	257	0	257
4215	0	1	0	256	0	257
4216	0	0	251	2	0	253
4217	246	0	1	1	0	248
4218	1	0	251	1	0	253
4219	250	0	1	2	0	253
4220	260	0	0	0	0	260
4221	259	0	1	0	0	260
4222	255	0	0	0	0	255
4223	2	0	260	0	0	262
4224	2	0	1	257	0	260
4225	1	1	257	1	0	260
4226	1	251	2	0	0	254
4227	0	258	0	1	0	259
4228	262	1	1	0	0	264
4229	259	1	0	0	0	260
4230	0	265	0	0	0	265
4231	265	1	0	1	0	267
4232	1	0	245	1	0	247
4233	246	1	0	0	0	247
4234	3	246	0	0	0	249
4235	253	1	1	0	0	255
4236	244	0	0	1	0	245
4237	1	1	0	238	0	240
4238	1	1	0	242	0	244
4239	240	0	0	2	0	242
4240	2	0	0	239	0	241
4241	242	0	1	2	0	245
4242	3	0	0	240	0	243
4243	238	0	1	2	0	241
4244	236	0	0	0	0	236
4245	2	234	0	1	0	237
4246	2	237	0	0	0	239
4247	239	1	0	0	0	240
4248	1	238	1	0	0	240
4249	3	2	0	228	0	233
4250	0	1	0	231	0	232
4251	227	1	0	2	0	230
4252	1	228	1	1	0	231
4253	1	222	0	1	0	224
4254	0	228	1	0	0	229
4255	1	3	222	0	0	226
4256	1	1	216	1	0	219
4257	2	1	222	0	0	225
4258	1	0	2	205	0	208
4259	1	218	2	1	0	222
4260	219	1	1	1	0	222
4261	1	1	215	2	0	219
4262	0	2	216	0	0	218
4263	1	0	213	0	0	214
4264	1	0	2	215	0	218
4265	2	0	1	211	0	214
4266	1	1	2	212	0	216
4267	212	1	0	3	0	216
4268	207	0	2	1	0	210
4269	211	0	0	0	0	211
4270	2	1	0	206	0	209
4271	3	0	200	1	0	204
4272	3	0	204	0	0	207
4273	0	1	1	205	0	207
4274	1	0	1	205	0	207
4275	196	0	1	2	0	199
4276	1	197	0	3	0	201
4277	196	1	1	1	0	199
4278	2	194	0	1	0	197
4279	0	1	1	195	0	197
4280	3	0	192	1	0	196
4281	1	2	1	191	0	195
4282	195	1	0	2	0	198
4283	2	0	199	0	0	201
4284	187	1	2	1	0	191
4285	2	0	191	2	0	195
4286	0	1	183	1	0	185
4287	167	0	1	0	0	168
4288	1	1	168	0	0	170
4289	0	0	125	0	0	125
4290	4	123	3	0	0	130
4291	105	1	2	2	0	110
4292	95	0	0	1	0	96
4293	95	0	0	0	0	95
4294	1	0	89	0	0	90
4295	88	0	0	0	0	88
4296	0	89	0	0	0	89
4297	87	0	0	0	0	87
4298	0	0	86	0	0	86
4299	0	0	0	85	0	85
4300	0	0	88	0	0	88
4301	0	89	0	0	0	89
4302	0	0	0	88	0	88
4303	0	0	0	92	0	92
4304	91	0	0	0	0	91
4305	90	0	0	1	0	91
4306	92	0	0	0	0	92
4307	93	0	0	0	0	93
4308	92	0	0	0	0	92
4309	0	0	93	0	0	93
4310	0	0	0	89	0	89
4311	0	0	96	0	0	96
4312	0	0	0	94	0	94
4313	95	0	0	0	0	95
4314	97	0	0	1	0	98
4315	99	0	0	0	0	99
4316	98	0	0	1	0	99
4317	0	0	102	0	0	102
4318	0	0	0	101	0	101
4319	0	0	104	0	0	104
4320	0	104	0	0	0	104
4321	0	106	0	0	0	106
4322	0	0	0	104	0	104
4323	0	0	0	114	0	114
4324	2	0	0	115	0	117
4325	0	0	0	125	0	125
4326	125	0	0	0	0	125
4327	0	122	0	0	0	122
4328	113	0	0	1	0	114
4329	0	0	0	113	0	113
4330	0	0	0	109	0	109
4331	0	112	0	2	0	114
4332	0	0	0	114	0	114
4333	115	0	0	1	0	116
4334	0	117	0	0	0	117
4335	0	116	0	0	0	116
4336	115	0	0	0	0	115
4337	0	0	0	113	0	113
4338	0	110	0	0	0	110
4339	0	0	0	113	0	113
4340	114	0	0	0	0	114
4341	0	0	0	110	0	110
4342	0	0	0	111	0	111
4343	109	0	0	1	0	110
4344	0	0	0	111	0	111
4345	0	111	0	0	0	111
4346	0	0	0	112	0	112
4347	0	113	0	0	0	113
4348	0	0	0	111	0	111
4349	111	0	0	0	0	111
4350	112	0	0	0	0	112
4351	0	0	0	112	0	112
4352	0	0	111	0	0	111
4353	114	0	0	0	0	114
4354	0	0	113	0	0	113
4355	117	0	0	0	0	117
4356	117	0	0	0	0	117
4357	0	0	115	0	0	115
4358	0	111	0	0	0	111
4359	109	0	0	1	0	110
4360	112	0	0	0	0	112
4361	0	0	116	0	0	116
4362	115	0	0	0	0	115
4363	120	0	0	0	0	120
4364	119	0	0	0	0	119
4365	0	0	0	120	0	120
4366	0	0	0	118	0	118
4367	0	120	0	0	0	120
4368	0	0	0	124	0	124
4369	0	0	0	124	0	124
4370	0	0	124	0	0	124
4371	0	0	116	0	0	116
4372	112	0	0	0	0	112
4373	115	0	0	0	0	115
4374	0	115	0	0	0	115
4375	0	0	0	118	0	118
4376	0	0	119	1	0	120
4377	0	0	2	120	0	122
4378	0	0	0	126	0	126
4379	1	0	0	129	0	130
4380	1	129	0	1	0	131
4381	1	1	0	130	0	132
4382	1	0	0	133	0	134
4383	1	0	127	1	0	129
4384	0	0	126	1	0	127
4385	121	0	2	0	0	123
4386	126	1	0	0	0	127
4387	1	0	0	131	0	132
4388	0	0	0	130	0	130
4389	0	0	0	131	0	131
4390	0	0	125	3	0	128
4391	0	124	2	1	0	127
4392	1	2	125	0	0	128
4393	122	0	1	0	0	123
4394	3	0	122	0	0	125
4395	121	0	2	1	0	124
4396	123	0	0	1	0	124
4397	123	1	0	0	0	124
4398	2	0	0	124	0	126
4399	1	0	125	1	0	127
4400	0	124	2	0	0	126
4401	0	3	0	124	0	127
4402	1	0	0	127	0	128
4403	1	0	124	3	0	128
4404	0	122	2	0	0	124
4405	127	2	0	1	0	130
4406	3	130	0	0	0	133
4407	142	3	0	2	0	147
4408	3	0	0	145	0	148
4409	1	0	148	2	0	151
4410	0	146	3	1	0	150
4411	151	3	0	0	0	154
4412	3	0	153	0	0	156
4413	152	0	3	0	0	155
4414	152	0	0	0	0	152
4415	2	0	149	0	0	151
4416	145	0	3	0	0	148
4417	146	0	1	0	0	147
4418	142	0	0	0	0	142
4419	1	140	0	0	0	141
4420	134	3	0	0	0	137
4421	3	135	0	0	0	138
4422	0	2	130	0	0	132
4423	0	125	3	0	0	128
4424	120	2	2	0	0	124
4425	118	0	0	0	0	118
4426	119	0	0	0	0	119
4427	3	0	0	118	0	121
4428	0	0	0	120	0	120
4429	117	0	0	4	0	121
4430	119	0	0	0	0	119
4431	3	0	0	117	0	120
4432	0	0	115	3	0	118
4433	0	111	3	0	0	114
4434	0	116	0	0	0	116
4435	0	1	0	115	0	116
4436	0	0	114	3	0	117
4437	0	0	3	113	0	116
4438	0	113	0	3	0	116
4439	0	3	0	117	0	120
4440	0	0	114	3	0	117
4441	0	0	3	116	0	119
4442	0	0	121	3	0	124
4443	0	0	3	118	0	121
4444	0	0	120	3	0	123
4445	0	0	120	0	0	120
4446	118	0	2	0	0	120
4447	120	0	0	0	0	120
4448	121	0	0	0	0	121
4449	2	118	0	0	0	120
4450	0	3	0	118	0	121
4451	116	0	0	3	0	119
4452	118	0	0	0	0	118
4453	116	0	0	0	0	116
4454	2	0	115	0	0	117
4455	0	109	3	1	0	113
4456	0	115	0	0	0	115
4457	111	3	0	1	0	115
4458	4	0	0	112	0	116
4459	108	0	0	4	0	112
4460	3	0	106	0	0	109
4461	0	0	4	100	0	104
4462	0	0	0	105	0	105
4463	0	0	1	102	0	103
4464	0	100	0	3	0	103
4465	100	3	0	0	0	103
4466	103	0	0	0	0	103
4467	4	99	0	0	0	103
4468	0	3	0	97	0	100
4469	96	0	0	4	0	100
4470	4	0	0	97	0	101
4471	97	0	0	2	0	99
4472	3	96	0	0	0	99
4473	96	3	1	1	0	101
4474	3	1	96	0	0	100
4475	0	94	2	0	0	96
4476	1	2	91	0	0	94
4477	2	3	2	87	0	94
4478	82	0	0	4	0	86
4479	83	0	1	0	0	84
4480	82	0	0	1	0	83
4481	2	0	0	80	0	82
4482	78	0	0	3	0	81
4483	2	0	0	78	0	80
4484	77	0	0	2	0	79
4485	80	0	0	0	0	80
4486	2	1	78	0	0	81
4487	0	0	66	1	0	67
4488	1	0	63	0	0	64
4489	0	0	1	66	0	67
4490	66	0	0	1	0	67
4491	1	0	0	63	0	64
4492	1	0	0	65	0	66
4493	71	0	1	1	0	73
4494	71	1	0	0	0	72
4495	70	0	1	0	0	71
4496	70	0	0	2	0	72
4497	2	0	0	72	0	74
4498	72	0	0	1	0	73
4499	2	72	0	0	0	74
4500	68	1	0	1	0	70
4501	70	0	0	0	0	70
4502	1	0	66	1	0	68
4503	58	0	1	1	0	60
4504	2	0	57	0	0	59
4505	0	0	55	0	0	55
4506	0	0	52	0	0	52
4507	1	1	2	35	0	39
4508	0	0	37	1	0	38
4509	1	0	0	32	0	33
4510	0	0	35	1	0	36
4511	0	0	35	1	0	36
4512	1	0	0	35	0	36
4513	1	0	0	38	0	39
4514	1	0	38	0	0	39
4515	38	0	0	0	0	38
4516	0	0	0	41	0	41
4517	1	0	0	39	0	40
4518	41	1	0	0	0	42
4519	1	0	0	42	0	43
4520	1	0	42	0	0	43
4521	1	0	42	0	0	43
4522	1	0	0	38	0	39
4523	0	0	40	0	0	40
4524	0	41	1	0	0	42
4525	0	0	1	40	0	41
4526	42	0	0	0	0	42
4527	0	0	42	0	0	42
4528	40	0	1	2	0	43
4529	1	0	1	48	0	50
4530	0	0	1	50	0	51
4531	0	0	0	51	0	51
4532	0	0	0	51	0	51
4533	49	0	1	1	0	51
4534	2	55	0	0	0	57
4535	0	1	0	58	0	59
4536	0	0	0	57	0	57
4537	1	0	0	56	0	57
4538	0	0	0	58	0	58
4539	56	0	1	1	0	58
4540	1	55	1	0	0	57
4541	52	1	0	0	0	53
4542	1	49	0	0	0	50
4543	0	50	0	0	0	50
4544	48	1	0	0	0	49
4545	1	0	54	0	0	55
4546	0	0	1	53	0	54
4547	55	0	0	1	0	56
4548	56	0	0	0	0	56
4549	52	0	0	1	0	53
4550	57	0	0	0	0	57
4551	1	64	0	0	0	65
4552	63	2	0	0	0	65
4553	68	0	0	0	0	68
4554	2	78	0	1	0	81
4555	0	2	0	80	0	82
4556	0	0	81	2	0	83
4557	0	0	2	81	0	83
4558	84	0	0	2	0	86
4559	2	0	84	0	0	86
4560	0	86	2	0	0	88
4561	0	2	91	0	0	93
4562	2	0	2	87	0	91
4563	0	92	0	1	0	93
4564	91	2	0	0	0	93
4565	2	91	1	0	0	94
4566	1	2	0	89	0	92
4567	0	0	0	93	0	93
4568	92	0	1	2	0	95
4569	2	1	0	91	0	94
4570	0	91	0	3	0	94
4571	92	2	0	0	0	94
4572	91	0	1	0	0	92
4573	3	93	0	0	0	96
4574	93	2	0	0	0	95
4575	2	93	0	1	0	96
4576	94	2	0	1	0	97
4577	2	96	0	1	0	99
4578	0	1	0	95	0	96
4579	0	1	0	97	0	98
4580	96	0	0	3	0	99
4581	99	0	0	1	0	100
4582	2	94	0	1	0	97
4583	0	1	103	1	0	105
4584	105	0	2	0	0	107
4585	2	1	0	104	0	107
4586	1	104	0	0	0	105
4587	0	3	0	105	0	108
4588	105	1	0	2	0	108
4589	108	0	0	0	0	108
4590	108	0	0	0	0	108
4591	2	0	0	110	0	112
4592	1	0	110	2	0	113
4593	106	0	2	0	0	108
4594	105	0	0	1	0	106
4595	107	0	0	0	0	107
4596	2	104	0	0	0	106
4597	1	2	0	103	0	106
4598	1	102	0	1	0	104
4599	0	1	0	102	0	103
4600	1	0	0	106	0	107
4601	0	0	107	2	0	109
4602	0	0	2	115	0	117
4603	2	0	0	117	0	119
4604	117	0	1	3	0	121
4605	3	118	0	0	0	121
4606	115	4	0	0	0	119
4607	121	0	0	1	0	122
4608	3	1	0	119	0	123
4609	1	0	123	3	0	127
4610	0	117	3	0	0	120
4611	0	124	0	1	0	125
4612	118	3	0	1	0	122
4613	4	118	0	0	0	122
4614	1	3	0	118	0	122
4615	0	0	0	122	0	122
4616	1	0	120	3	0	124
4617	1	0	118	0	0	119
4618	0	117	3	0	0	120
4619	1	3	0	119	0	123
4620	120	0	0	3	0	123
4621	3	0	0	118	0	121
4622	0	0	122	3	0	125
4623	0	0	3	121	0	124
4624	118	0	0	3	0	121
4625	121	0	0	1	0	122
4626	3	121	0	0	0	124
4627	123	2	0	0	0	125
4628	2	123	0	0	0	125
4629	118	2	0	0	0	120
4630	2	2	0	115	0	119
4631	1	0	118	1	0	120
4632	0	0	113	0	0	113
4633	0	116	2	0	0	118
4634	1	2	0	113	0	116
4635	0	0	0	114	0	114
4636	111	0	0	2	0	113
4637	114	0	0	0	0	114
4638	113	0	0	0	0	113
4639	2	0	0	109	0	111
4640	0	0	0	112	0	112
4641	0	0	0	112	0	112
4642	0	0	111	2	0	113
4643	0	0	113	0	0	113
4644	111	0	2	0	0	113
4645	109	0	0	0	0	109
4646	2	0	105	4	0	111
4647	109	0	2	0	0	111
4648	110	0	0	0	0	110
4649	2	0	106	0	0	108
4650	0	107	3	0	0	110
4651	0	1	0	106	0	107
4652	0	0	104	1	0	105
4653	0	112	1	0	0	113
4654	0	3	0	99	0	102
4655	0	103	0	0	0	103
4656	0	1	102	0	0	103
4657	0	0	102	0	0	102
4658	0	0	1	102	0	103
4659	100	0	0	2	0	102
4660	1	0	0	99	0	100
4661	96	0	0	1	0	97
4662	1	0	0	96	0	97
4663	0	0	96	1	0	97
4664	97	0	1	0	0	98
4665	1	0	96	0	0	97
4666	98	0	1	0	0	99
4667	1	0	0	95	0	96
4668	0	97	0	1	0	98
4669	0	1	0	98	0	99
4670	0	103	0	1	0	104
4671	0	1	0	99	0	100
4672	0	102	0	1	0	103
4673	102	1	1	0	0	104
4674	103	0	0	0	0	103
4675	100	0	0	1	0	101
4676	2	0	98	0	0	100
4677	0	0	1	101	0	102
4678	1	0	102	1	0	104
4679	0	102	1	0	0	103
4680	0	103	1	0	0	104
4681	101	1	0	0	0	102
4682	1	0	100	0	0	101
4683	1	90	1	0	0	92
4684	0	1	0	94	0	95
4685	94	1	0	2	0	97
4686	2	94	0	0	0	96
4687	95	3	0	0	0	98
4688	2	0	94	1	0	97
4689	0	1	2	95	0	98
4690	1	0	0	97	0	98
4691	1	0	0	97	0	98
4692	1	91	0	2	0	94
4693	0	1	1	90	0	92
4694	0	0	91	3	0	94
4695	0	0	3	95	0	98
4696	0	1	0	99	0	100
4697	0	1	0	100	0	101
4698	1	93	0	1	0	95
4699	0	2	1	96	0	99
4700	0	1	0	97	0	98
4701	0	91	0	3	0	94
4702	80	1	0	0	0	81
4703	1	82	0	0	0	83
4704	1	78	0	0	0	79
4705	0	1	0	81	0	82
4706	0	0	80	2	0	82
4707	75	0	1	1	0	77
4708	1	0	0	81	0	82
4709	0	1	78	1	0	80
4710	0	76	1	1	0	78
4711	0	1	1	76	0	78
4712	0	0	77	2	0	79
4713	0	0	1	74	0	75
4714	0	0	0	75	0	75
4715	72	1	0	1	0	74
4716	1	72	0	0	0	73
4717	74	1	0	1	0	76
4718	1	1	72	0	0	74
4719	1	69	1	0	0	71
4720	0	2	67	0	0	69
4721	0	1	1	71	0	73
4722	68	0	0	2	0	70
4723	1	0	1	69	0	71
4724	68	0	0	2	0	70
4725	73	0	0	1	0	74
4726	1	0	1	69	0	71
4727	0	1	73	1	0	75
4728	0	0	69	1	0	70
4729	0	0	2	74	0	76
4730	0	0	0	75	0	75
4731	73	0	0	2	0	75
4732	2	0	0	75	0	77
4733	0	76	0	1	0	77
4734	1	1	0	74	0	76
4735	0	0	1	76	0	77
4736	73	0	0	1	0	74
4737	1	72	1	0	0	74
4738	0	1	0	76	0	77
4739	1	0	0	73	0	74
4740	0	75	0	2	0	77
4741	1	1	0	75	0	77
4742	1	0	0	77	0	78
4743	1	77	0	2	0	80
4744	0	1	1	79	0	81
4745	0	0	1	77	0	78
4746	0	72	1	2	0	75
4747	0	1	0	77	0	78
4748	76	0	0	2	0	78
4749	75	0	0	1	0	76
4750	73	1	0	1	0	75
4751	70	1	0	1	0	72
4752	1	68	0	2	0	71
4753	60	1	0	1	0	62
4754	2	58	0	0	0	60
4755	0	61	0	0	0	61
4756	0	1	0	59	0	60
4757	0	0	58	1	0	59
4758	59	1	1	0	0	61
4759	61	0	0	1	0	62
4760	1	0	62	1	0	64
4761	59	0	1	0	0	60
4762	62	0	1	1	0	64
4763	1	59	0	1	0	61
4764	66	2	0	1	0	69
4765	1	0	0	66	0	67
4766	1	0	0	68	0	69
4767	1	0	0	66	0	67
4768	1	0	0	67	0	68
4769	69	0	0	1	0	70
4770	1	1	0	65	0	67
4771	1	0	0	70	0	71
4772	0	1	69	1	0	71
4773	64	1	1	0	0	66
4774	69	0	0	1	0	70
4775	69	0	1	0	0	70
4776	2	66	0	0	0	68
4777	1	67	0	0	0	68
4778	66	1	1	0	0	68
4779	2	0	0	66	0	68
4780	1	66	1	1	0	69
4781	0	2	1	66	0	69
4782	1	67	0	2	0	70
4783	67	1	0	2	0	70
4784	2	67	0	1	0	70
4785	0	0	0	68	0	68
4786	0	2	0	66	0	68
4787	1	0	66	1	0	68
4788	0	71	0	2	0	73
4789	1	0	0	78	0	79
4790	0	1	83	0	0	84
4791	1	0	82	1	0	84
4792	1	0	0	83	0	84
4793	0	1	1	84	0	86
4794	0	80	0	1	0	81
4795	0	78	0	1	0	79
4796	1	1	0	78	0	80
4797	78	0	0	1	0	79
4798	0	1	0	80	0	81
4799	83	1	0	1	0	85
4800	86	1	0	1	0	88
4801	88	0	0	0	0	88
4802	1	1	86	0	0	88
4803	89	0	0	1	0	90
4804	1	0	0	89	0	90
4805	0	1	1	87	0	89
4806	1	1	86	0	0	88
4807	0	1	86	1	0	88
4808	0	2	0	84	0	86
4809	0	83	1	2	0	86
4810	0	83	0	1	0	84
4811	1	0	0	85	0	86
4812	88	1	0	0	0	89
4813	0	1	1	88	0	90
4814	1	0	0	86	0	87
4815	2	90	0	0	0	92
4816	0	1	0	90	0	91
4817	2	0	90	0	0	92
4818	1	0	86	1	0	88
4819	88	0	0	2	0	90
4820	0	89	1	1	0	91
4821	90	0	0	1	0	91
4822	89	0	0	1	0	90
4823	0	0	0	90	0	90
4824	0	90	1	1	0	92
4825	0	0	0	86	0	86
4826	88	0	0	0	0	88
4827	0	84	0	1	0	85
4828	83	0	0	0	0	83
4829	0	83	0	0	0	83
4830	87	0	0	0	0	87
4831	84	0	0	0	0	84
4832	0	86	0	0	0	86
4833	0	0	0	84	0	84
4834	84	0	0	0	0	84
4835	0	0	78	0	0	78
4836	0	0	83	0	0	83
4837	0	0	0	82	0	82
4838	82	0	0	0	0	82
4839	0	0	0	82	0	82
4840	82	0	0	0	0	82
4841	0	0	86	0	0	86
4842	90	0	0	0	0	90
4843	94	0	0	0	0	94
4844	0	0	0	93	0	93
4845	0	0	0	94	0	94
4846	0	0	0	94	0	94
4847	0	96	0	0	0	96
4848	0	0	0	97	0	97
4849	0	0	0	98	0	98
4850	99	0	0	0	0	99
4851	95	0	0	0	0	95
4852	0	0	98	0	0	98
4853	98	0	0	0	0	98
4854	0	0	98	0	0	98
4855	94	0	0	0	0	94
4856	0	0	96	0	0	96
4857	0	0	93	0	0	93
4858	0	0	0	91	0	91
4859	0	0	89	0	0	89
4860	84	0	0	0	0	84
4861	0	0	0	91	0	91
4862	95	0	0	0	0	95
4863	95	0	0	0	0	95
4864	89	0	0	0	0	89
4865	88	0	0	0	0	88
4866	0	0	87	0	0	87
4867	0	0	0	88	0	88
4868	0	0	87	0	0	87
4869	0	0	0	87	0	87
4870	84	0	0	0	0	84
4871	0	0	0	82	0	82
4872	84	0	0	0	0	84
4873	0	0	0	85	0	85
4874	0	0	0	86	0	86
4875	87	0	0	0	0	87
4876	0	85	0	0	0	85
4877	86	0	0	0	0	86
4878	0	86	0	0	0	86
4879	0	0	0	89	0	89
4880	88	0	0	0	0	88
4881	0	0	87	0	0	87
4882	0	0	0	86	0	86
4883	86	0	0	0	0	86
4884	90	0	0	0	0	90
4885	0	0	0	90	0	90
4886	0	91	0	0	0	91
4887	0	89	0	0	0	89
4888	0	0	0	88	0	88
4889	82	0	0	0	0	82
4890	0	72	0	0	0	72
4891	0	71	0	0	0	71
4892	69	0	0	0	0	69
4893	0	68	0	0	0	68
4894	69	0	0	0	0	69
4895	0	0	0	69	0	69
4896	0	0	0	67	0	67
4897	0	66	0	0	0	66
4898	0	66	0	0	0	66
4899	66	0	0	0	0	66
4900	0	69	0	0	0	69
4901	0	77	0	0	0	77
4902	1	0	1	76	0	78
4903	77	0	0	0	0	77
4904	0	0	82	0	0	82
4905	85	1	0	0	0	86
4906	0	0	1	92	0	93
4907	2	0	91	0	0	93
4908	0	0	92	1	0	93
4909	1	0	1	92	0	94
4910	0	0	96	1	0	97
4911	97	0	1	1	0	99
4912	93	0	2	1	0	96
4913	1	0	94	1	0	96
4914	1	0	2	93	0	96
4915	1	0	1	94	0	96
4916	94	0	1	1	0	96
4917	1	0	1	92	0	94
4918	1	93	0	1	0	95
4919	96	0	1	1	0	98
4920	1	93	0	1	0	95
4921	1	95	0	2	0	98
4922	1	2	0	95	0	98
4923	1	1	0	95	0	97
4924	1	2	0	93	0	96
4925	1	1	93	1	0	96
4926	89	0	0	3	0	92
4927	0	93	1	1	0	95
4928	93	0	0	2	0	95
4929	94	1	1	1	0	97
4930	2	0	0	91	0	93
4931	1	93	1	0	0	95
4932	2	0	0	95	0	97
4933	1	2	0	94	0	97
4934	101	0	0	2	0	103
4935	102	1	0	1	0	104
4936	1	0	98	2	0	101
4937	105	1	0	1	0	107
4938	1	106	1	1	0	109
4939	111	0	0	1	0	112
4940	1	112	1	0	0	114
4941	2	0	0	104	0	106
4942	0	2	0	106	0	108
4943	2	102	0	1	0	105
4944	0	2	0	109	0	111
4945	2	1	0	107	0	110
4946	0	1	0	109	0	110
4947	0	103	0	2	0	105
4948	0	0	0	108	0	108
4949	0	2	0	106	0	108
4950	0	0	0	106	0	106
4951	0	1	104	2	0	107
4952	101	0	0	3	0	104
4953	0	1	99	1	0	101
4954	102	0	0	2	0	104
4955	0	0	103	1	0	104
4956	105	0	0	1	0	106
4957	101	0	3	2	0	106
4958	3	0	103	0	0	106
4959	1	0	2	102	0	105
4960	2	0	98	0	0	100
4961	98	0	1	2	0	101
4962	1	0	106	0	0	107
4963	2	0	100	1	0	103
4964	102	0	3	0	0	105
4965	1	104	1	1	0	107
4966	1	0	2	104	0	107
4967	108	0	1	0	0	109
4968	1	0	1	107	0	109
4969	2	0	1	106	0	109
4970	106	0	0	2	0	108
4971	104	1	0	2	0	107
4972	1	0	104	1	0	106
4973	2	1	104	1	0	108
4974	1	0	1	106	0	108
4975	1	0	104	1	0	106
4976	1	0	1	106	0	108
4977	1	0	1	104	0	106
4978	1	0	0	105	0	106
4979	100	0	2	2	0	104
4980	0	101	0	2	0	103
4981	102	0	1	1	0	104
4982	102	1	0	2	0	105
4983	2	105	0	1	0	108
4984	102	0	0	1	0	103
4985	1	2	102	0	0	105
4986	1	1	0	100	0	102
4987	103	1	1	1	0	106
4988	2	0	101	1	0	104
4989	108	1	0	0	0	109
4990	1	113	0	1	0	115
4991	132	0	1	0	0	133
4992	134	1	1	2	0	138
4993	2	137	0	0	0	139
4994	139	1	0	0	0	140
4995	2	1	0	142	0	145
4996	3	1	0	143	0	147
4997	146	1	0	1	0	148
4998	144	0	0	1	0	145
4999	1	144	0	1	0	146
5000	1	140	0	1	0	142
5001	0	4	0	124	0	128
5002	0	129	0	2	0	131
5003	1	131	0	1	0	133
5004	121	0	0	0	0	121
5005	0	125	0	1	0	126
5006	118	0	0	0	0	118
5007	0	116	0	0	0	116
5008	0	0	121	0	0	121
5009	0	122	0	0	0	122
5010	120	1	0	0	0	121
5011	120	0	0	0	0	120
5012	0	0	118	0	0	118
5013	0	0	0	116	0	116
5014	0	0	0	118	0	118
5015	0	0	118	0	0	118
5016	0	0	0	114	0	114
5017	0	0	116	0	0	116
5018	0	0	113	0	0	113
5019	112	0	0	0	0	112
5020	0	114	0	0	0	114
5021	115	0	0	0	0	115
5022	0	0	0	115	0	115
5023	0	0	115	0	0	115
5024	0	0	0	115	0	115
5025	0	118	0	0	0	118
5026	119	0	0	0	0	119
5027	120	0	0	0	0	120
5028	0	0	0	121	0	121
5029	0	0	119	0	0	119
5030	118	0	0	0	0	118
5031	0	118	0	0	0	118
5032	116	0	0	0	0	116
5033	0	0	0	116	0	116
5034	109	0	0	0	0	109
5035	0	0	0	108	0	108
5036	0	0	108	0	0	108
5037	0	0	101	0	0	101
5038	103	0	0	0	0	103
5039	0	109	0	0	0	109
5040	107	0	0	0	0	107
5041	108	0	0	0	0	108
5042	0	109	0	0	0	109
5043	105	0	0	0	0	105
5044	1	0	118	0	0	119
5045	0	0	1	117	0	118
5046	0	0	0	119	0	119
5047	0	0	0	119	0	119
5048	0	0	117	1	0	118
5049	0	0	119	0	0	119
5050	0	0	1	115	0	116
5051	0	117	0	1	0	118
5052	0	120	1	0	0	121
5053	121	1	0	0	0	122
5054	120	0	0	0	0	120
5055	1	123	0	0	0	124
5056	0	1	0	125	0	126
5057	0	0	0	126	0	126
5058	126	0	0	2	0	128
5059	1	0	0	132	0	133
5060	0	0	0	133	0	133
5061	0	0	0	133	0	133
5062	0	0	126	1	0	127
5063	0	0	123	0	0	123
5064	121	0	1	0	0	122
5065	1	0	0	128	0	129
5066	0	0	128	1	0	129
5067	0	0	126	0	0	126
5068	131	0	1	0	0	132
5069	1	0	139	0	0	140
5070	0	147	1	0	0	148
5071	0	1	0	172	0	173
5072	0	1	169	1	0	171
5073	172	0	1	0	0	173
5074	1	0	0	189	0	190
5075	0	0	189	1	0	190
5076	0	0	1	192	0	193
5077	0	0	0	191	0	191
5078	190	0	0	1	0	191
5079	1	190	0	0	0	191
5080	0	1	0	194	0	195
5081	195	0	0	1	0	196
5082	196	0	0	0	0	196
5083	195	0	0	0	0	195
5084	196	0	0	0	0	196
5085	2	0	0	193	0	195
5086	190	0	0	1	0	191
5087	188	0	0	0	0	188
5088	182	0	0	0	0	182
5089	184	0	0	0	0	184
5090	0	169	0	0	0	169
5091	0	154	0	0	0	154
5092	0	1	0	151	0	152
5093	0	149	0	1	0	150
5094	153	1	1	0	0	155
5095	1	0	0	151	0	152
5096	149	0	0	1	0	150
5097	149	0	0	0	0	149
5098	1	0	0	154	0	155
5099	0	0	0	154	0	154
5100	0	151	0	1	0	152
5101	152	1	0	0	0	153
5102	1	152	0	3	0	156
5103	157	1	0	0	0	158
5104	1	0	0	157	0	158
5105	0	0	157	1	0	158
5106	153	0	1	0	0	154
5107	154	0	0	0	0	154
5108	1	0	147	0	0	148
5109	0	0	151	0	0	151
5110	0	0	1	150	0	151
5111	163	0	0	1	0	164
5112	172	0	0	0	0	172
5113	178	0	0	1	0	179
5114	179	0	0	0	0	179
5115	1	180	0	0	0	181
5116	181	1	0	0	0	182
5117	3	0	0	180	0	183
5118	1	0	0	184	0	185
5119	0	0	0	186	0	186
5120	1	0	0	187	0	188
5121	185	0	0	2	0	187
5122	1	0	1	194	0	196
5123	0	1	189	2	0	192
5124	0	0	1	197	0	198
5125	1	0	0	196	0	197
5126	0	0	0	194	0	194
5127	1	0	0	195	0	196
5128	192	0	0	2	0	194
5129	2	191	0	0	0	193
5130	1	191	0	0	0	192
5131	1	1	0	193	0	195
5132	193	0	1	3	0	197
5133	196	0	0	2	0	198
5134	2	0	0	201	0	203
5135	2	1	199	1	0	203
5136	196	1	1	2	0	200
5137	1	1	0	206	0	208
5138	1	1	202	2	0	206
5139	191	1	2	2	0	196
5140	3	201	0	1	0	205
5141	228	2	0	1	0	231
5142	3	222	0	1	0	226
5143	2	1	0	223	0	226
5144	2	219	0	2	0	223
5145	1	3	1	231	0	236
5146	224	1	0	5	0	230
5147	5	221	0	2	0	228
5148	5	4	222	0	0	231
5149	2	4	3	225	0	234
5150	1	1	228	5	0	235
5151	0	2	4	226	0	232
5152	0	0	3	230	0	233
5153	1	1	223	6	0	231
5154	214	1	4	2	0	221
5155	4	0	220	1	0	225
5156	2	1	220	1	0	224
5157	1	221	6	1	0	229
5158	1	4	2	218	0	225
5159	2	1	0	219	0	222
5160	1	1	1	216	0	219
5161	3	0	0	220	0	223
5162	0	2	209	6	0	217
5163	204	0	5	2	0	211
5164	4	2	213	2	0	221
5165	3	0	5	211	0	219
5166	211	0	2	6	0	219
5167	5	212	0	4	0	221
5168	3	5	1	206	0	215
5169	197	2	2	5	0	206
5170	4	187	1	3	0	195
5171	3	170	1	1	0	175
5172	166	7	0	2	0	175
5173	4	170	0	1	0	175
5174	156	5	0	0	0	161
5175	3	157	0	1	0	161
5176	160	4	0	0	0	164
5177	161	3	0	2	0	166
5178	4	156	0	2	0	162
5179	2	4	0	160	0	166
5180	0	3	158	4	0	165
5181	158	0	4	2	0	164
5182	4	1	1	156	0	162
5183	3	158	0	3	0	164
5184	0	159	0	4	0	163
5185	0	7	0	158	0	165
5186	154	2	1	5	0	162
5187	4	0	159	2	0	165
5188	3	0	4	160	0	167
5189	0	0	2	164	0	166
5190	0	1	0	165	0	166
5191	1	1	0	162	0	164
5192	0	156	0	6	0	162
5193	2	4	0	159	0	165
5194	0	2	154	4	0	160
5195	0	0	151	2	0	153
5196	0	0	157	1	0	158
5197	0	0	8	148	0	156
5198	147	0	2	5	0	154
5199	4	1	149	2	0	156
5200	2	0	152	1	0	155
5201	0	0	6	149	0	155
5202	150	0	3	4	0	157
5203	4	151	1	2	0	158
5204	154	4	0	1	0	159
5205	5	2	0	151	0	158
5206	2	0	152	4	0	158
5207	0	0	5	152	0	157
5208	0	149	2	5	0	156
5209	156	4	0	1	0	161
5210	4	3	157	0	0	164
5211	3	142	4	0	0	149
5212	139	4	2	1	0	146
5213	6	2	1	135	0	144
5214	3	1	0	140	0	144
5215	137	1	0	7	0	145
5216	140	0	0	3	0	143
5217	146	0	1	1	0	148
5218	9	1	0	134	0	144
5219	3	134	0	6	0	143
5220	133	6	0	3	0	142
5221	6	138	0	2	0	146
5222	128	5	0	1	0	134
5223	8	128	0	0	0	136
5224	2	6	0	123	0	131
5225	127	3	0	6	0	136
5226	130	1	0	3	0	134
5227	133	0	0	1	0	134
5228	136	0	0	0	0	136
5229	136	0	0	0	0	136
5230	10	0	127	0	0	137
5231	4	1	6	127	0	138
5232	1	1	130	6	0	138
5233	0	0	132	4	0	136
5234	122	0	8	2	0	132
5235	128	0	3	1	0	132
5236	133	0	1	0	0	134
5237	10	0	0	117	0	127
5238	122	0	0	4	0	126
5239	5	121	1	3	0	130
5240	3	126	0	2	0	131
5241	1	98	1	0	0	100
5242	87	7	3	1	0	98
5243	6	93	0	0	0	99
5244	82	4	0	0	0	86
5245	79	1	0	0	0	80
5246	4	1	74	1	0	80
5247	2	0	3	74	0	79
5248	1	1	1	78	0	81
5249	75	1	1	4	0	81
5250	76	1	0	2	0	79
5251	4	0	0	74	0	78
5252	2	1	75	3	0	81
5253	2	0	76	1	0	79
5254	1	0	4	76	0	81
5255	0	0	3	78	0	81
5256	0	0	1	80	0	81
5257	71	0	0	7	0	78
5258	77	0	0	2	0	79
5259	5	75	0	1	0	81
5260	2	3	0	75	0	80
5261	1	1	1	78	0	81
5262	0	74	1	4	0	79
5263	0	3	0	77	0	80
5264	78	0	0	5	0	83
5265	3	1	0	80	0	84
5266	2	0	0	83	0	85
5267	79	0	0	4	0	83
5268	79	0	0	3	0	82
5269	81	0	0	2	0	83
5270	5	0	0	77	0	82
5271	2	1	73	3	0	79
5272	1	0	75	3	0	79
5273	2	0	69	2	0	73
5274	1	69	6	1	0	77
5275	66	3	2	1	0	72
5276	5	1	64	0	0	70
5277	63	1	3	1	0	68
5278	6	1	0	64	0	71
5279	63	0	1	4	0	68
5280	68	1	1	1	0	71
5281	4	65	1	2	0	72
5282	68	4	0	0	0	72
5283	69	2	0	1	0	72
5284	6	65	0	0	0	71
5285	3	3	1	68	0	75
5286	3	1	71	3	0	78
5287	1	1	2	69	0	73
5288	2	0	1	71	0	74
5289	68	0	2	3	0	73
5290	3	1	0	71	0	75
5291	2	67	1	3	0	73
5292	2	3	1	67	0	73
5293	1	2	0	70	0	73
5294	1	1	67	5	0	74
5295	1	68	3	2	0	74
5296	0	68	1	4	0	73
5297	68	3	1	1	0	73
5298	3	72	0	0	0	75
5299	0	4	0	69	0	73
5300	2	3	69	2	0	76
5301	1	68	2	3	0	74
5302	69	4	1	1	0	75
5303	4	1	2	69	0	76
5304	2	2	0	72	0	76
5305	1	1	70	4	0	76
5306	1	0	3	71	0	75
5307	0	2	1	75	0	78
5308	71	0	1	5	0	77
5309	68	0	1	2	0	71
5310	4	63	1	2	0	70
5311	58	1	1	1	0	61
5312	2	55	1	2	0	60
5313	2	2	0	56	0	60
5314	1	54	1	3	0	59
5315	0	58	0	4	0	62
5316	54	1	1	3	0	59
5317	57	0	1	0	0	58
5318	2	55	0	1	0	58
5319	54	2	0	2	0	58
5320	54	0	0	2	0	56
5321	53	2	0	0	0	55
5322	2	0	0	56	0	58
5323	55	0	0	1	0	56
5324	1	0	52	1	0	54
5325	49	0	1	2	0	52
5326	2	1	49	0	0	52
5327	1	0	1	51	0	53
5328	2	0	0	51	0	53
5329	0	0	52	3	0	55
5330	45	0	2	1	0	48
5331	51	0	1	0	0	52
5332	2	0	57	0	0	59
5333	1	1	1	54	0	57
5334	1	0	0	56	0	57
5335	0	0	1	56	0	57
5336	56	0	0	1	0	57
5337	55	0	1	1	0	57
5338	2	1	0	54	0	57
5339	2	50	0	1	0	53
5340	0	51	1	0	0	52
5341	50	1	0	0	0	51
5342	2	47	0	1	0	50
5343	0	48	0	0	0	48
5344	0	0	0	48	0	48
5345	0	0	49	0	0	49
5346	0	48	0	1	0	49
5347	0	0	0	49	0	49
5348	1	49	0	0	0	50
5349	0	0	0	50	0	50
5350	49	1	0	0	0	50
5351	0	49	0	1	0	50
5352	48	0	0	1	0	49
5353	46	0	1	0	0	47
5354	0	0	45	0	0	45
5355	45	0	0	0	0	45
5356	0	0	0	45	0	45
5357	0	0	44	0	0	44
5358	0	45	0	0	0	45
5359	0	0	0	44	0	44
5360	0	0	0	43	0	43
5361	43	0	0	0	0	43
5362	0	0	0	46	0	46
5363	0	0	0	44	0	44
5364	42	0	0	0	0	42
5365	0	42	0	0	0	42
5366	41	0	0	1	0	42
5367	0	0	41	0	0	41
5368	41	0	0	0	0	41
5369	0	0	44	0	0	44
5370	0	45	0	0	0	45
5371	45	0	0	0	0	45
5372	45	0	0	0	0	45
5373	0	0	45	0	0	45
5374	0	0	43	0	0	43
5375	0	0	44	0	0	44
5376	0	45	0	0	0	45
5377	0	0	0	45	0	45
5378	0	0	52	0	0	52
5379	0	0	51	0	0	51
5380	0	2	0	49	0	51
5381	0	0	56	0	0	56
5382	56	0	0	0	0	56
5383	68	0	0	0	0	68
5384	1	0	67	0	0	68
5385	0	71	1	0	0	72
5386	0	1	0	66	0	67
5387	0	0	66	1	0	67
5388	0	68	0	0	0	68
5389	0	1	0	68	0	69
5390	68	0	0	1	0	69
5391	69	0	0	0	0	69
5392	1	65	0	0	0	66
5393	0	1	0	70	0	71
5394	0	0	0	71	0	71
5395	1	0	0	69	0	70
5396	0	1	0	71	0	72
5397	0	0	68	2	0	70
5398	0	0	2	66	0	68
5399	0	0	65	1	0	66
5400	0	63	1	1	0	65
5401	62	1	0	0	0	63
5402	2	64	0	0	0	66
5403	0	2	0	64	0	66
5404	0	0	0	67	0	67
5405	66	0	0	2	0	68
5406	1	0	0	68	0	69
5407	0	64	0	2	0	66
5408	0	1	1	68	0	70
5409	0	0	0	70	0	70
5410	68	0	1	1	0	70
5411	1	1	65	0	0	67
5412	1	67	0	0	0	68
5413	0	67	0	0	0	67
5414	0	1	0	68	0	69
5415	65	0	0	2	0	67
5416	2	62	0	0	0	64
5417	0	1	0	66	0	67
5418	0	1	65	1	0	67
5419	0	0	1	65	0	66
5420	64	0	0	2	0	66
5421	66	0	0	0	0	66
5422	1	0	1	64	0	66
5423	64	1	0	0	0	65
5424	66	1	0	0	0	67
5425	1	0	64	1	0	66
5426	65	0	1	0	0	66
5427	1	67	0	0	0	68
5428	66	1	0	1	0	68
5429	1	0	67	0	0	68
5430	0	0	1	68	0	69
5431	69	0	0	1	0	70
5432	1	0	58	0	0	59
5433	0	0	64	1	0	65
5434	1	0	1	63	0	65
5435	1	0	62	1	0	64
5436	63	0	2	0	0	65
5437	2	0	63	0	0	65
5438	0	1	1	65	0	67
5439	1	0	0	64	0	65
5440	68	0	1	1	0	70
5441	1	0	69	1	0	71
5442	0	0	72	0	0	72
5443	0	0	2	81	0	83
5444	0	0	80	1	0	81
5445	79	0	0	1	0	80
5446	1	0	1	79	0	81
5447	0	0	81	1	0	82
5448	0	0	2	82	0	84
5449	0	0	0	85	0	85
5450	84	0	0	2	0	86
5451	1	0	84	0	0	85
5452	82	0	1	0	0	83
5453	1	0	87	0	0	88
5454	87	0	0	1	0	88
5455	88	0	1	0	0	89
5456	88	0	0	1	0	89
5457	1	88	0	1	0	90
5458	90	1	1	1	0	93
5459	91	0	0	1	0	92
5460	1	0	0	92	0	93
5461	1	0	89	2	0	92
5462	90	0	2	1	0	93
5463	0	0	89	0	0	89
5464	1	0	2	92	0	95
5465	1	0	0	93	0	94
5466	93	0	0	1	0	94
5467	2	94	0	0	0	96
5468	1	2	0	94	0	97
5469	1	1	0	93	0	95
5470	2	0	95	1	0	98
5471	1	0	1	97	0	99
5472	0	0	1	99	0	100
5473	1	0	1	96	0	98
5474	1	98	1	1	0	101
5475	98	1	1	0	0	100
5476	98	0	0	2	0	100
5477	2	98	0	1	0	101
5478	90	2	0	0	0	92
5479	1	1	0	98	0	100
5480	1	0	101	3	0	105
5481	0	97	2	1	0	100
5482	0	98	1	1	0	100
5483	90	0	2	1	0	93
5484	92	0	2	0	0	94
5485	0	0	0	92	0	92
5486	0	1	0	91	0	92
5487	1	0	0	91	0	92
5488	91	0	0	0	0	91
5489	0	1	91	0	0	92
5490	90	0	0	0	0	90
5491	0	0	0	92	0	92
5492	0	0	1	87	0	88
5493	0	95	0	0	0	95
5494	0	1	0	97	0	98
5495	1	0	0	97	0	98
5496	0	0	101	0	0	101
5497	0	99	0	1	0	100
5498	102	0	0	1	0	103
5499	107	0	0	1	0	108
5500	107	0	0	0	0	107
5501	108	0	1	0	0	109
5502	1	0	109	0	0	110
5503	108	0	0	1	0	109
5504	0	0	109	1	0	110
5505	0	1	1	108	0	110
5506	0	113	0	1	0	114
5507	0	0	0	114	0	114
5508	0	0	1	114	0	115
5509	0	1	113	0	0	114
5510	114	0	0	0	0	114
5511	113	0	0	0	0	113
5512	1	109	0	0	0	110
5513	0	0	115	1	0	116
5514	0	0	1	116	0	117
5515	1	0	117	0	0	118
5516	0	0	115	0	0	115
5517	0	0	0	119	0	119
5518	0	1	118	0	0	119
5519	0	0	0	118	0	118
5520	0	0	121	1	0	122
5521	0	0	1	120	0	121
5522	122	0	0	0	0	122
5523	121	0	0	1	0	122
5524	119	1	0	0	0	120
5525	119	0	1	0	0	120
5526	0	120	0	1	0	121
5527	1	0	0	120	0	121
5528	0	0	1	122	0	123
5529	0	0	118	1	0	119
5530	0	0	1	117	0	118
5531	0	0	121	1	0	122
5532	0	0	118	0	0	118
5533	116	0	0	2	0	118
5534	2	123	0	0	0	125
5535	122	0	2	0	0	124
5536	124	0	0	0	0	124
5537	0	129	0	0	0	129
5538	130	0	0	0	0	130
5539	0	0	128	0	0	128
5540	0	129	0	0	0	129
5541	129	0	0	0	0	129
5542	0	0	119	0	0	119
5543	114	0	0	0	0	114
5544	0	124	0	0	0	124
5545	125	0	0	0	0	125
5546	125	0	0	1	0	126
5547	0	124	0	0	0	124
5548	0	121	0	0	0	121
5549	0	129	0	0	0	129
5550	0	0	0	132	0	132
5551	1	0	0	132	0	133
5552	132	0	0	1	0	133
5553	128	0	0	0	0	128
5554	1	0	129	0	0	130
5555	0	0	124	1	0	125
5556	0	0	134	0	0	134
5557	0	0	1	131	0	132
5558	0	0	135	1	0	136
5559	0	0	1	134	0	135
5560	133	0	0	1	0	134
5561	1	0	134	0	0	135
5562	130	0	1	0	0	131
5563	134	0	0	0	0	134
5564	1	0	133	0	0	134
5565	0	140	1	0	0	141
5566	0	1	0	138	0	139
5567	0	0	138	1	0	139
5568	0	0	1	137	0	138
5569	1	0	0	150	0	151
5570	146	0	0	2	0	148
5571	2	0	0	143	0	145
5572	0	0	143	2	0	145
5573	0	0	2	144	0	146
5574	147	0	0	2	0	149
5575	2	142	0	2	0	146
5576	148	2	0	0	0	150
5577	2	1	0	148	0	151
5578	0	0	150	2	0	152
5579	0	0	144	0	0	144
5580	0	0	140	0	0	140
5581	0	141	1	0	0	142
5582	140	3	0	0	0	143
5583	1	134	0	0	0	135
5584	130	2	0	0	0	132
5585	2	127	0	0	0	129
5586	0	2	0	130	0	132
5587	0	0	0	133	0	133
5588	1	0	0	129	0	130
5589	0	132	0	2	0	134
5590	0	2	0	141	0	143
5591	0	0	0	163	0	163
5592	167	0	0	5	0	172
5593	4	0	0	172	0	176
5594	0	0	178	3	0	181
5595	174	0	3	0	0	177
5596	182	1	0	0	0	183
5597	4	178	1	1	0	184
5598	177	5	2	0	0	184
5599	181	0	1	1	0	183
5600	5	0	0	177	0	182
5601	2	0	1	176	0	179
5602	0	0	0	182	0	182
5603	177	0	1	5	0	183
5604	180	0	1	1	0	182
5605	6	0	175	0	0	181
5606	170	1	4	0	0	175
5607	175	0	1	0	0	176
5608	174	1	0	1	0	176
5609	5	0	171	1	0	177
5610	0	0	174	0	0	174
5611	0	0	5	167	0	172
5612	0	1	168	6	0	175
5613	2	0	5	166	0	173
5614	0	1	0	162	0	163
5615	1	164	1	2	0	168
5616	166	6	0	1	0	173
5617	5	0	169	1	0	175
5618	174	1	5	1	0	181
5619	6	0	0	175	0	181
5620	168	1	0	6	0	175
5621	4	171	0	1	0	176
5622	0	179	1	1	0	181
5623	1	5	1	175	0	182
5624	0	0	0	179	0	179
5625	1	0	176	5	0	182
5626	2	1	5	172	0	180
5627	170	0	0	5	0	175
5628	3	174	0	0	0	177
5629	1	3	172	0	0	176
5630	1	1	4	171	0	177
5631	0	0	173	7	0	180
5632	0	1	4	171	0	176
5633	0	0	169	7	0	176
5634	0	0	171	1	0	172
5635	2	0	5	164	0	171
5636	167	0	0	7	0	174
5637	169	0	0	0	0	169
5638	167	0	0	1	0	168
5639	6	162	1	0	0	169
5640	162	6	1	0	0	169
5641	165	0	0	0	0	165
5642	4	1	159	1	0	165
5643	1	155	4	0	0	160
5644	0	5	0	152	0	157
5645	147	0	0	7	0	154
5646	6	151	0	1	0	158
5647	153	5	0	1	0	159
5648	153	0	1	0	0	154
5649	146	0	0	0	0	146
5650	146	0	1	1	0	148
5651	9	0	0	137	0	146
5652	138	0	1	4	0	143
5653	5	1	1	138	0	145
5654	0	137	1	5	0	143
5655	0	4	0	137	0	141
5656	134	0	1	5	0	140
5657	4	0	134	1	0	139
5658	2	0	4	128	0	134
5659	129	1	0	5	0	135
5660	3	129	1	0	0	133
5661	130	4	0	1	0	135
5662	134	0	2	0	0	136
5663	5	130	0	1	0	136
5664	126	4	1	1	0	132
5665	5	0	121	0	0	126
5666	0	1	123	0	0	124
5667	120	1	4	0	0	125
5668	4	0	117	0	0	121
5669	0	0	2	107	0	109
5670	0	109	1	2	0	112
5671	105	3	0	1	0	109
5672	4	108	0	0	0	112
5673	0	113	0	0	0	113
5674	0	2	1	109	0	112
5675	0	0	0	113	0	113
5676	0	0	1	109	0	110
5677	0	0	0	110	0	110
5678	0	0	104	3	0	107
5679	0	0	4	99	0	103
5680	0	0	0	102	0	102
5681	98	0	0	3	0	101
5682	4	0	0	98	0	102
5683	1	0	96	3	0	100
5684	96	1	3	0	0	100
5685	4	0	0	97	0	101
5686	1	0	101	3	0	105
5687	1	0	4	97	0	102
5688	0	101	0	1	0	102
5689	98	3	0	1	0	102
5690	4	0	89	0	0	93
5691	0	71	1	0	0	72
5692	64	1	0	0	0	65
5693	1	55	0	0	0	56
5694	0	49	0	0	0	49
5695	47	1	2	0	0	50
5696	0	43	1	0	0	44
5697	0	48	0	0	0	48
5698	0	3	0	45	0	48
5699	0	0	45	0	0	45
5700	0	44	0	0	0	44
5701	0	0	0	40	0	40
5702	0	37	0	0	0	37
5703	39	0	0	0	0	39
5704	0	0	37	0	0	37
5705	0	0	0	38	0	38
5706	40	0	0	0	0	40
5707	0	0	0	41	0	41
5708	0	0	42	0	0	42
5709	43	0	0	0	0	43
5710	47	0	0	0	0	47
5711	0	54	0	0	0	54
5712	1	0	0	52	0	53
5713	0	0	0	54	0	54
5714	53	0	0	0	0	53
5715	53	0	0	0	0	53
5716	0	1	53	0	0	54
5717	0	52	0	0	0	52
5718	50	0	0	0	0	50
5719	0	2	0	48	0	50
5720	0	0	53	0	0	53
5721	0	0	48	0	0	48
5722	0	0	0	50	0	50
5723	49	0	0	0	0	49
5724	0	48	0	0	0	48
5725	56	0	0	0	0	56
5726	0	0	0	62	0	62
5727	0	0	0	61	0	61
5728	0	0	0	61	0	61
5729	61	0	0	1	0	62
5730	0	61	0	0	0	61
5731	0	0	0	63	0	63
5732	0	0	0	63	0	63
5733	0	0	64	0	0	64
5734	0	0	0	64	0	64
5735	0	0	64	0	0	64
5736	0	63	0	0	0	63
5737	0	0	0	62	0	62
5738	62	0	0	0	0	62
5739	0	0	60	0	0	60
5740	0	0	0	58	0	58
5741	0	0	61	0	0	61
5742	59	0	0	0	0	59
5743	0	0	62	0	0	62
5744	0	0	0	59	0	59
5745	61	0	0	0	0	61
5746	0	60	0	0	0	60
5747	60	0	0	0	0	60
5748	0	57	1	0	0	58
5749	0	0	0	63	0	63
5750	0	0	59	0	0	59
5751	0	0	61	0	0	61
5752	0	0	0	60	0	60
5753	67	0	0	0	0	67
5754	64	0	0	0	0	64
5755	0	0	0	65	0	65
5756	0	0	0	67	0	67
5757	67	0	0	0	0	67
5758	0	69	0	0	0	69
5759	0	71	0	0	0	71
5760	71	0	0	0	0	71
5761	0	0	68	0	0	68
5762	0	0	0	65	0	65
5763	0	0	72	0	0	72
5764	0	0	0	72	0	72
5765	0	0	72	0	0	72
5766	0	0	74	0	0	74
5767	0	0	0	72	0	72
5768	0	69	0	0	0	69
5769	75	0	0	0	0	75
5770	0	74	0	0	0	74
5771	0	0	0	75	0	75
5772	76	0	0	0	0	76
5773	0	0	0	73	0	73
5774	72	0	0	0	0	72
5775	71	0	0	0	0	71
5776	73	0	0	0	0	73
5777	0	72	0	0	0	72
5778	73	0	0	0	0	73
5779	0	0	0	74	0	74
5780	72	0	0	1	0	73
5781	0	0	0	76	0	76
5782	76	0	0	0	0	76
5783	76	0	0	0	0	76
5784	0	73	0	0	0	73
5785	0	0	0	84	0	84
5786	0	0	0	90	0	90
5787	0	96	0	1	0	97
5788	0	1	0	102	0	103
5789	101	0	0	2	0	103
5790	111	2	0	0	0	113
5791	108	0	0	2	0	110
5792	3	0	117	0	0	120
5793	123	0	1	0	0	124
5794	124	0	0	0	0	124
5795	122	0	2	0	0	124
5796	3	127	0	0	0	130
5797	2	1	0	131	0	134
5798	2	0	0	131	0	133
5799	0	2	0	131	0	133
5800	0	0	131	3	0	134
5801	0	0	1	131	0	132
5802	131	0	0	3	0	134
5803	1	0	2	131	0	134
5804	0	0	0	136	0	136
5805	2	0	130	1	0	133
5806	0	127	1	2	0	130
5807	134	1	0	3	0	138
5808	1	0	2	134	0	137
5809	133	2	0	1	0	136
5810	3	0	130	0	0	133
5811	120	0	2	3	0	125
5812	3	123	0	0	0	126
5813	0	1	130	0	0	131
5814	4	0	128	0	0	132
5815	0	2	1	130	0	133
5816	0	0	136	1	0	137
5817	0	134	2	0	0	136
5818	0	1	0	137	0	138
5819	0	0	2	137	0	139
5820	0	2	0	136	0	138
5821	134	0	0	3	0	137
5822	1	134	0	2	0	137
5823	0	1	0	139	0	140
5824	2	0	0	138	0	140
5825	135	2	0	1	0	138
5826	1	133	0	2	0	136
5827	137	1	0	2	0	140
5828	137	0	0	0	0	137
5829	137	2	0	0	0	139
5830	3	0	138	0	0	141
5831	2	0	1	135	0	138
5832	2	136	0	1	0	139
5833	0	139	2	0	0	141
5834	0	1	0	143	0	144
5835	0	143	0	1	0	144
5836	148	3	0	1	0	152
5837	1	0	148	2	0	151
5838	145	2	1	0	0	148
5839	153	0	0	0	0	153
5840	1	0	1	154	0	156
5841	156	0	0	2	0	158
5842	3	169	0	0	0	172
5843	173	2	0	3	0	178
5844	176	0	0	0	0	176
5845	188	2	0	0	0	190
5846	5	0	190	0	0	195
5847	2	1	189	0	0	192
5848	5	0	2	193	0	200
5849	1	193	4	2	0	200
5850	1	197	4	0	0	202
5851	0	3	0	197	0	200
5852	195	3	0	3	0	201
5853	2	4	0	191	0	197
5854	0	0	0	201	0	201
5855	197	0	1	2	0	200
5856	2	199	0	6	0	207
5857	1	2	202	4	0	209
5858	3	0	198	1	0	202
5859	198	4	2	1	0	205
5860	2	0	4	199	0	205
5861	0	1	212	2	0	215
5862	5	0	2	209	0	216
5863	0	0	0	210	0	210
5864	2	0	3	210	0	215
5865	0	0	1	212	0	213
5866	1	207	0	6	0	214
5867	0	3	1	211	0	215
5868	208	1	1	6	0	216
5869	3	213	1	1	0	218
5870	217	2	0	6	0	225
5871	222	0	1	1	0	224
5872	221	5	1	0	0	227
5873	7	0	218	1	0	226
5874	225	0	2	1	0	228
5875	229	0	1	1	0	231
5876	223	0	5	0	0	228
5877	229	1	0	0	0	230
5878	6	222	1	1	0	230
5879	227	2	0	1	0	230
5880	7	0	229	1	0	237
5881	0	5	2	228	0	235
5882	5	0	0	233	0	238
5883	235	0	4	2	0	241
5884	3	234	0	4	0	241
5885	223	1	1	4	0	229
5886	4	218	1	1	0	224
5887	216	3	0	0	0	219
5888	215	1	0	0	0	216
5889	2	244	0	0	0	246
5890	248	3	0	0	0	251
5891	264	0	0	0	0	264
5892	3	246	2	0	0	251
5893	1	250	0	1	0	252
5894	264	3	2	1	0	270
5895	3	2	0	268	0	273
5896	268	1	0	5	0	274
5897	276	1	0	0	0	277
5898	274	0	0	3	0	277
5899	277	0	1	0	0	278
5900	7	269	0	0	0	276
5901	4	276	0	1	0	281
5902	281	4	0	0	0	285
5903	3	2	282	0	0	287
5904	1	2	3	277	0	283
5905	1	0	2	285	0	288
5906	281	0	2	4	0	287
5907	3	278	0	3	0	284
5908	1	3	0	280	0	284
5909	2	1	0	282	0	285
5910	281	1	0	4	0	286
5911	4	0	0	283	0	287
5912	282	0	0	5	0	287
5913	282	0	0	1	0	283
5914	280	0	0	2	0	282
5915	5	0	0	275	0	280
5916	3	0	0	274	0	277
5917	2	0	295	4	0	301
5918	0	0	289	3	0	292
5919	293	0	5	2	0	300
5920	4	0	3	297	0	304
5921	1	0	319	4	0	324
5922	2	0	319	1	0	322
5923	0	0	5	318	0	323
5924	0	0	322	4	0	326
5925	0	0	6	315	0	321
5926	0	0	3	316	0	319
5927	0	0	322	6	0	328
5928	0	0	2	329	0	331
5929	0	0	3	321	0	324
5930	0	0	2	329	0	331
5931	0	1	321	9	0	331
5932	0	0	5	327	0	332
5933	326	0	2	7	0	335
5934	4	328	2	3	0	337
5935	333	4	0	3	0	340
5936	6	3	329	0	0	338
5937	333	2	4	1	0	340
5938	340	0	2	0	0	342
5939	337	1	2	0	0	340
5940	11	0	0	328	0	339
5941	5	0	1	332	0	338
5942	4	0	310	6	0	320
5943	306	1	3	5	0	315
5944	5	308	3	2	0	318
5945	4	293	1	1	0	299
5946	1	296	0	2	0	299
5947	3	3	1	288	0	295
5948	282	2	0	2	0	286
5949	280	1	0	4	0	285
5950	7	1	279	1	0	288
5951	2	1	4	280	0	287
5952	2	1	3	281	0	287
5953	3	1	279	6	0	289
5954	2	0	273	3	0	278
5955	273	1	7	2	0	283
5956	3	278	2	4	0	287
5957	287	3	1	1	0	292
5958	280	4	2	0	0	286
5959	7	0	2	279	0	288
5960	4	0	0	280	0	284
5961	267	1	1	7	0	276
5962	4	0	2	267	0	273
5963	4	0	1	266	0	271
5964	266	0	1	7	0	274
5965	4	1	0	268	0	273
5966	270	0	0	5	0	275
5967	271	0	0	5	0	276
5968	6	0	266	3	0	275
5969	269	0	4	2	0	275
5970	263	0	3	2	0	268
5971	263	0	1	2	0	266
5972	7	0	239	3	0	249
5973	260	0	4	0	0	264
5974	4	257	3	2	0	266
5975	261	3	1	0	0	265
5976	262	3	1	1	0	267
5977	7	0	2	258	0	267
5978	5	0	1	257	0	263
5979	2	259	1	7	0	269
5980	2	2	0	255	0	259
5981	1	3	1	256	0	261
5982	253	0	2	5	0	260
5983	3	1	0	255	0	259
5984	4	1	0	254	0	259
5985	2	2	0	255	0	259
5986	1	251	0	7	0	259
5987	243	2	1	5	0	251
5988	4	248	0	1	0	253
5989	221	1	0	2	0	224
5990	3	3	206	2	0	214
5991	194	1	1	2	0	198
5992	2	0	195	3	0	200
5993	3	193	2	1	0	199
5994	172	2	5	1	0	180
5995	170	4	1	0	0	175
5996	6	156	1	0	0	163
5997	3	161	0	0	0	164
5998	158	3	0	0	0	161
5999	157	2	1	1	0	161
6000	5	0	0	154	0	159
6001	3	1	1	155	0	160
6002	0	1	151	4	0	156
6003	153	0	1	2	0	156
6004	5	0	2	151	0	158
6005	2	152	1	3	0	158
6006	2	1	0	157	0	160
6007	2	3	0	155	0	160
6008	3	0	153	3	0	159
6009	1	0	1	156	0	158
6010	153	1	2	3	0	159
6011	2	148	0	3	0	153
6012	3	148	1	1	0	153
6013	148	3	1	2	0	154
6014	146	3	0	2	0	151
6015	148	0	0	1	0	149
6016	3	143	0	1	0	147
6017	2	126	1	1	0	130
6018	130	1	0	1	0	132
6019	131	3	0	0	0	134
6020	2	127	0	1	0	130
6021	1	105	0	0	0	106
6022	105	0	0	0	0	105
6023	1	0	1	103	0	105
6024	109	0	0	0	0	109
6025	0	1	1	111	0	113
6026	1	110	0	0	0	111
6027	2	101	0	1	0	104
6028	104	1	0	0	0	105
6029	105	3	1	0	0	109
6030	113	2	0	0	0	115
6031	3	112	0	0	0	115
6032	2	0	108	1	0	111
6033	0	107	0	1	0	108
6034	101	0	1	0	0	102
6035	98	1	1	0	0	100
6036	2	0	96	0	0	98
6037	1	94	0	1	0	96
6038	0	0	0	92	0	92
6039	0	0	0	89	0	89
6040	0	90	0	1	0	91
6041	0	0	92	0	0	92
6042	92	0	0	0	0	92
6043	1	0	0	93	0	94
6044	93	1	0	0	0	94
6045	91	1	0	1	0	93
6046	1	0	0	91	0	92
6047	1	0	0	95	0	96
6048	1	0	0	96	0	97
6049	0	0	0	94	0	94
6050	94	1	0	0	0	95
6051	96	0	0	0	0	96
6052	1	0	96	0	0	97
6053	0	1	0	93	0	94
6054	0	1	0	95	0	96
6055	1	0	0	95	0	96
6056	0	0	95	1	0	96
6057	1	0	0	93	0	94
6058	93	0	0	1	0	94
6059	1	1	0	92	0	94
6060	1	1	92	0	0	94
6061	1	1	0	92	0	94
6062	1	1	98	0	0	100
6063	97	0	0	0	0	97
6064	0	1	0	98	0	99
6065	96	0	1	0	0	97
6066	94	1	0	1	0	96
6067	1	1	0	94	0	96
6068	95	1	0	0	0	96
6069	1	0	1	95	0	97
6070	1	102	0	0	0	103
6071	104	0	0	0	0	104
6072	100	1	0	1	0	102
6073	99	0	1	0	0	100
6074	0	1	0	101	0	102
6075	1	0	0	101	0	102
6076	1	0	0	101	0	102
6077	0	0	101	0	0	101
6078	0	98	0	0	0	98
6079	1	0	0	96	0	97
6080	0	0	98	1	0	99
6081	93	1	0	0	0	94
6082	0	0	0	93	0	93
6083	1	0	93	0	0	94
6084	97	0	0	2	0	99
6085	1	0	0	97	0	98
6086	1	0	0	94	0	95
6087	0	0	0	97	0	97
6088	96	0	0	1	0	97
6089	97	0	0	1	0	98
6090	94	0	0	1	0	95
6091	1	96	0	0	0	97
6092	1	92	0	1	0	94
6093	96	0	1	1	0	98
6094	0	0	96	2	0	98
6095	0	0	0	97	0	97
6096	2	0	2	93	0	97
6097	92	0	1	0	0	93
6098	90	0	1	1	0	92
6099	1	95	0	1	0	97
6100	0	0	0	96	0	96
6101	0	0	94	1	0	95
6102	0	0	96	1	0	97
6103	0	0	1	97	0	98
6104	3	0	0	93	0	96
6105	95	0	0	2	0	97
6106	1	0	1	94	0	96
6107	97	0	0	1	0	98
6108	96	0	1	1	0	98
6109	2	0	98	0	0	100
6110	93	0	0	2	0	95
6111	95	1	0	1	0	97
6112	100	0	0	0	0	100
6113	1	97	0	1	0	99
6114	2	95	0	0	0	97
6115	0	0	0	99	0	99
6116	0	1	97	1	0	99
6117	1	91	0	1	0	93
6118	2	0	0	83	0	85
6119	1	0	0	83	0	84
6120	0	86	0	1	0	87
6121	85	0	0	1	0	86
6122	85	0	0	1	0	86
6123	0	0	86	0	0	86
6124	82	1	0	0	0	83
6125	0	0	78	1	0	79
6126	73	0	1	0	0	74
6127	1	0	80	0	0	81
6128	0	78	0	1	0	79
6129	1	0	1	67	0	69
6130	1	0	0	67	0	68
6131	68	0	0	1	0	69
6132	68	0	0	1	0	69
6133	67	0	0	2	0	69
6134	1	0	72	0	0	73
6135	1	0	0	71	0	72
6136	1	0	0	74	0	75
6137	73	0	0	0	0	73
6138	0	74	0	0	0	74
6139	76	0	0	0	0	76
6140	0	0	1	79	0	80
6141	0	0	0	80	0	80
6142	0	0	0	84	0	84
6143	1	0	0	83	0	84
6144	1	0	0	84	0	85
6145	0	87	0	0	0	87
6146	0	85	0	0	0	85
6147	0	80	0	0	0	80
6148	0	0	0	82	0	82
6149	0	0	82	0	0	82
6150	77	0	0	0	0	77
6151	0	84	0	0	0	84
6152	0	0	0	84	0	84
6153	0	0	0	85	0	85
6154	87	0	0	0	0	87
6155	83	0	0	0	0	83
6156	87	0	0	0	0	87
6157	0	0	0	88	0	88
6158	0	0	86	0	0	86
6159	0	0	91	0	0	91
6160	0	0	0	91	0	91
6161	0	0	92	0	0	92
6162	85	0	0	0	0	85
6163	0	0	0	91	0	91
6164	0	0	91	0	0	91
6165	0	0	0	93	0	93
6166	0	0	97	0	0	97
6167	0	0	107	0	0	107
6168	0	0	0	120	0	120
6169	0	0	130	0	0	130
6170	0	0	125	0	0	125
6171	0	114	0	7	0	121
6172	0	0	0	127	0	127
6173	133	0	0	0	0	133
6174	0	0	0	133	0	133
6175	0	0	0	138	0	138
6176	0	0	140	0	0	140
6177	125	0	0	0	0	125
6178	0	0	0	140	0	140
6179	0	0	0	141	0	141
6180	139	0	0	0	0	139
6181	0	0	0	142	0	142
6182	147	0	0	1	0	148
6183	142	0	0	0	0	142
6184	147	0	0	0	0	147
6185	0	141	0	0	0	141
6186	148	0	0	0	0	148
6187	0	146	0	0	0	146
6188	0	0	0	147	0	147
6189	147	0	0	0	0	147
6190	0	150	0	0	0	150
6191	150	0	0	0	0	150
6192	0	149	0	0	0	149
6193	148	0	0	0	0	148
6194	0	149	0	0	0	149
6195	0	149	0	0	0	149
6196	0	155	0	2	0	157
6197	0	0	0	152	0	152
6198	0	154	0	0	0	154
6199	1	0	0	154	0	155
6200	0	0	0	154	0	154
6201	0	0	0	155	0	155
6202	0	0	0	154	0	154
6203	153	0	0	0	0	153
6204	155	0	0	0	0	155
6205	0	0	154	0	0	154
6206	156	0	0	0	0	156
6207	166	0	0	0	0	166
6208	172	0	0	0	0	172
6209	3	0	168	0	0	171
6210	0	0	175	0	0	175
6211	170	0	5	0	0	175
6212	4	0	170	0	0	174
6213	0	183	3	1	0	187
6214	1	4	0	188	0	193
6215	187	0	0	5	0	192
6216	189	0	0	1	0	190
6217	192	0	0	0	0	192
6218	5	0	0	185	0	190
6219	0	0	0	192	0	192
6220	0	0	196	5	0	201
6221	2	0	4	197	0	203
6222	0	0	0	203	0	203
6223	194	0	0	4	0	198
6224	5	205	0	0	0	210
6225	208	4	0	1	0	213
6226	4	1	0	210	0	215
6227	205	0	0	4	0	209
6228	206	1	0	0	0	207
6229	208	0	0	1	0	209
6230	5	201	0	0	0	206
6231	0	207	0	0	0	207
6232	1	3	0	206	0	210
6233	208	1	0	4	0	213
6234	5	0	0	202	0	207
6235	0	1	0	210	0	211
6236	0	1	207	4	0	212
6237	0	1	4	202	0	207
6238	0	0	0	210	0	210
6239	1	1	0	202	0	204
6240	0	0	201	5	0	206
6241	0	0	198	0	0	198
6242	0	195	2	1	0	198
6243	194	4	0	1	0	199
6244	5	0	0	196	0	201
6245	1	0	198	4	0	203
6246	0	0	4	196	0	200
6247	1	0	0	214	0	215
6248	211	0	0	4	0	215
6249	215	0	0	0	0	215
6250	4	210	1	0	0	215
6251	209	4	0	0	0	213
6252	212	0	0	0	0	212
6253	4	0	1	208	0	213
6254	0	1	206	4	0	211
6255	0	207	4	3	0	214
6256	213	4	0	0	0	217
6257	215	0	0	1	0	216
6258	4	215	0	0	0	219
6259	0	4	0	226	0	230
6260	233	0	0	7	0	240
6261	240	0	1	0	0	241
6262	6	0	0	238	0	244
6263	233	0	0	7	0	240
6264	259	0	0	0	0	259
6265	260	1	0	1	0	262
6266	6	0	257	0	0	263
6267	0	255	3	1	0	259
6268	1	248	0	0	0	249
6269	235	6	0	0	0	241
6270	6	231	0	0	0	237
6271	0	6	237	0	0	243
6272	1	0	7	229	0	237
6273	233	0	0	6	0	239
6274	7	0	0	233	0	240
6275	231	1	0	7	0	239
6276	237	1	0	0	0	238
6277	238	0	0	1	0	239
6278	6	232	0	0	0	238
6279	0	249	1	0	0	250
6280	245	6	0	1	0	252
6281	250	0	0	0	0	250
6282	246	0	0	1	0	247
6283	7	0	0	240	0	247
6284	235	0	0	6	0	241
6285	7	230	0	0	0	237
6286	0	239	0	0	0	239
6287	0	7	0	237	0	244
6288	1	0	236	6	0	243
6289	1	1	232	0	0	234
6290	2	0	5	230	0	237
6291	0	0	231	7	0	238
6292	1	0	6	230	0	237
6293	232	1	0	5	0	238
6294	6	1	0	229	0	236
6295	226	0	0	9	0	235
6296	7	225	0	0	0	232
6297	1	6	226	0	0	233
6298	0	0	5	223	0	228
6299	3	0	1	234	0	238
6300	2	1	231	7	0	241
6301	2	0	6	230	0	238
6302	1	230	1	7	0	239
6303	2	7	0	232	0	241
6304	0	2	0	240	0	242
6305	2	0	1	247	0	250
6306	1	1	246	9	0	257
6307	1	0	234	1	0	236
6308	227	0	7	1	0	235
6309	6	1	226	1	0	234
6310	0	226	4	1	0	231
6311	228	4	0	1	0	233
6312	5	231	0	1	0	237
6313	219	4	1	1	0	225
6314	218	1	1	1	0	221
6315	219	0	1	1	0	221
6316	225	0	0	1	0	226
6317	6	212	1	0	0	219
6318	2	221	0	0	0	223
6319	220	4	0	1	0	225
6320	4	2	210	0	0	216
6321	0	1	4	211	0	216
6322	2	0	0	220	0	222
6323	1	0	216	6	0	223
6324	202	0	5	0	0	207
6325	208	1	1	1	0	211
6326	208	1	0	2	0	211
6327	6	201	1	0	0	208
6328	204	4	0	2	0	210
6329	6	0	0	207	0	213
6330	0	214	1	6	0	221
6331	215	5	2	0	0	222
6332	224	2	0	1	0	227
6333	232	0	2	0	0	234
6334	5	1	0	225	0	231
6335	1	1	1	230	0	233
6336	2	222	1	5	0	230
6337	2	4	227	2	0	235
6338	0	3	4	226	0	233
6339	3	0	1	234	0	238
6340	3	0	0	235	0	238
6341	1	0	229	8	0	238
6342	224	1	9	2	0	236
6343	6	1	1	233	0	241
6344	2	2	232	6	0	242
6345	1	0	8	226	0	235
6346	230	1	0	8	0	239
6347	6	237	1	3	0	247
6348	1	6	1	244	0	252
6349	1	2	245	5	0	253
6350	237	1	6	0	0	244
6351	247	0	1	2	0	250
6352	7	1	241	0	0	249
6353	1	1	6	232	0	240
6354	1	241	0	5	0	247
6355	243	6	1	0	0	250
6356	6	0	239	2	0	247
6357	234	0	5	0	0	239
6358	7	0	223	2	0	232
6359	1	1	214	0	0	216
6360	200	0	4	0	0	204
6361	4	207	0	1	0	212
6362	0	5	204	0	0	209
6363	1	202	5	1	0	209
6364	1	3	193	0	0	197
6365	2	192	4	0	0	198
6366	179	4	3	1	0	187
6367	5	0	177	0	0	182
6368	0	1	175	1	0	177
6369	1	0	170	1	0	172
6370	168	1	4	0	0	173
6371	170	0	1	1	0	172
6372	4	1	0	168	0	173
6373	1	1	171	5	0	178
6374	0	0	179	1	0	180
6375	174	0	4	1	0	179
6376	6	0	1	178	0	185
6377	176	0	1	5	0	182
6378	176	0	0	1	0	177
6379	5	1	0	167	0	173
6380	1	165	1	4	0	171
6381	1	5	0	165	0	171
6382	1	0	1	170	0	172
6383	0	1	168	4	0	173
6384	2	161	4	0	0	167
6385	1	171	1	0	0	173
6386	0	4	2	165	0	171
6387	0	1	165	4	0	170
6388	1	167	4	1	0	173
6389	2	4	168	0	0	174
6390	168	0	5	0	0	173
6391	176	0	1	0	0	177
6392	4	0	171	0	0	175
6393	172	0	5	1	0	178
6394	5	0	0	174	0	179
6395	0	176	0	4	0	180
6396	1	4	1	179	0	185
6397	175	1	0	4	0	180
6398	179	1	1	0	0	181
6399	173	1	2	2	0	178
6400	174	0	0	1	0	175
6401	4	175	2	2	0	183
6402	0	172	2	0	0	174
6403	173	4	1	2	0	180
6404	6	0	173	1	0	180
6405	3	4	3	164	0	174
6406	1	178	0	3	0	182
6407	1	2	3	175	0	181
6408	2	179	1	2	0	184
6409	3	3	0	185	0	191
6410	1	0	179	3	0	183
6411	180	0	3	1	0	184
6412	180	1	0	2	0	183
6413	3	2	172	1	0	178
6414	171	1	3	2	0	177
6415	174	1	0	1	0	176
6416	3	1	165	2	0	171
6417	1	0	5	165	0	171
6418	169	2	0	2	0	173
6419	3	3	163	1	0	170
6420	1	0	5	162	0	168
6421	3	1	173	2	0	179
6422	2	1	177	0	0	180
6423	174	2	4	1	0	181
6424	182	0	0	1	0	183
6425	180	0	1	2	0	183
6426	183	1	3	0	0	187
6427	4	0	1	182	0	187
6428	2	172	2	4	0	180
6429	2	179	2	0	0	183
6430	3	3	0	170	0	176
6431	173	0	3	4	0	180
6432	5	163	2	0	0	170
6433	4	167	0	0	0	171
6434	168	4	1	2	0	175
6435	6	1	0	167	0	174
6436	164	1	0	4	0	169
6437	4	164	1	4	0	173
6438	166	6	0	0	0	172
6439	3	1	171	1	0	176
6440	199	1	3	2	0	205
6441	210	0	0	0	0	210
6442	216	1	0	1	0	218
6443	6	1	197	0	0	204
6444	201	2	3	1	0	207
6445	4	208	1	1	0	214
6446	2	2	201	0	0	205
6447	1	3	3	191	0	198
6448	2	0	2	186	0	190
6449	1	186	0	4	0	191
6450	2	3	1	187	0	193
6451	2	1	1	192	0	196
6452	3	1	188	4	0	196
6453	182	0	5	1	0	188
6454	5	0	190	1	0	196
6455	1	1	3	189	0	194
6456	1	1	191	3	0	196
6457	1	1	3	197	0	202
6458	193	1	2	5	0	201
6459	197	1	1	2	0	201
6460	6	0	0	193	0	199
6461	2	1	199	4	0	206
6462	1	0	3	201	0	205
6463	1	2	200	4	0	207
6464	185	0	5	4	0	194
6465	196	1	2	2	0	201
6466	195	0	2	1	0	198
6467	193	0	1	3	0	197
6468	5	185	3	0	0	193
6469	3	3	0	191	0	197
6470	183	1	1	4	0	189
6471	6	185	1	3	0	195
6472	2	194	0	2	0	198
6473	0	4	181	0	0	185
6474	179	1	3	2	0	185
6475	180	1	4	0	0	185
6476	7	0	174	2	0	183
6477	5	0	4	174	0	183
6478	1	1	3	179	0	184
6479	2	1	175	6	0	184
6480	3	1	5	173	0	182
6481	177	1	1	5	0	184
6482	7	1	173	2	0	183
6483	4	1	180	1	0	186
6484	171	1	6	3	0	181
6485	6	1	177	1	0	185
6486	178	2	5	0	0	185
6487	5	172	3	2	0	182
6488	177	3	0	2	0	182
6489	3	3	2	174	0	182
6490	2	2	1	177	0	182
6491	172	0	1	5	0	178
6492	3	1	1	171	0	176
6493	172	1	2	3	0	178
6494	5	174	1	2	0	182
6495	4	3	2	171	0	180
6496	3	2	0	172	0	177
6497	170	1	2	4	0	177
6498	172	0	0	4	0	176
6499	174	1	0	2	0	177
6500	7	163	0	1	0	171
6501	3	168	0	3	0	174
6502	168	3	1	1	0	173
6503	5	2	166	1	0	174
6504	2	162	5	1	0	170
6505	150	3	4	0	0	157
6506	143	3	1	0	0	147
6507	149	0	0	1	0	150
6508	6	1	0	141	0	148
6509	140	1	0	3	0	144
6510	137	0	0	4	0	141
6511	7	0	0	133	0	140
6512	138	2	0	3	0	143
6513	3	1	132	3	0	139
6514	4	0	4	132	0	140
6515	1	1	3	139	0	144
6516	1	0	0	143	0	144
6517	137	0	1	4	0	142
6518	142	0	0	3	0	145
6519	143	0	0	0	0	143
6520	137	0	1	1	0	139
6521	132	1	0	1	0	134
6522	7	1	0	120	0	128
6523	3	0	1	127	0	131
6524	122	0	2	4	0	128
6525	4	118	0	2	0	124
6526	120	2	1	1	0	124
6527	4	2	116	1	0	123
6528	123	1	2	1	0	127
6529	127	0	2	1	0	130
6530	6	0	134	1	0	141
6531	133	0	1	1	0	135
6532	2	0	134	1	0	137
6533	3	0	135	1	0	139
6534	2	0	5	132	0	139
6535	0	1	2	140	0	143
6536	0	0	138	5	0	143
6537	0	0	138	6	0	144
6538	2	136	4	1	0	143
6539	1	133	3	0	0	137
6540	95	2	4	0	0	101
6541	0	101	0	0	0	101
6542	92	1	0	0	0	93
6543	2	92	0	0	0	94
6544	90	2	0	0	0	92
6545	3	2	84	0	0	89
6546	86	1	1	0	0	88
6547	2	0	2	86	0	90
6548	2	84	1	1	0	88
6549	1	1	0	88	0	90
6550	85	2	0	2	0	89
6551	85	1	0	2	0	88
6552	3	0	0	84	0	87
6553	3	0	80	1	0	84
6554	1	0	79	2	0	82
6555	0	80	3	1	0	84
6556	0	1	3	81	0	85
6557	0	2	82	1	0	85
6558	0	81	1	2	0	84
6559	0	1	1	82	0	84
6560	0	2	1	79	0	82
6561	78	1	0	2	0	81
6562	1	0	0	80	0	81
6563	2	0	75	2	0	79
6564	1	0	1	77	0	79
6565	73	0	0	2	0	75
6566	1	0	76	1	0	78
6567	77	0	1	1	0	79
6568	2	76	1	0	0	79
6569	77	1	1	0	0	79
6570	79	1	0	0	0	80
6571	2	1	0	77	0	80
6572	2	0	0	77	0	79
6573	1	75	0	2	0	78
6574	0	1	0	78	0	79
6575	76	0	0	2	0	78
6576	1	1	75	1	0	78
6577	1	0	1	77	0	79
6578	1	76	0	0	0	77
6579	0	1	1	77	0	79
6580	0	1	0	78	0	79
6581	76	1	0	2	0	79
6582	1	76	0	2	0	79
6583	1	1	0	77	0	79
6584	75	1	0	1	0	77
6585	1	0	0	76	0	77
6586	0	0	0	78	0	78
6587	78	0	0	2	0	80
6588	77	0	0	2	0	79
6589	2	0	82	1	0	85
6590	83	0	1	0	0	84
6591	84	0	1	0	0	85
6592	83	0	1	0	0	84
6593	3	79	0	0	0	82
6594	2	77	0	0	0	79
6595	1	2	0	78	0	81
6596	76	3	0	1	0	80
6597	80	0	0	2	0	82
6598	2	0	0	79	0	81
6599	2	0	82	1	0	85
6600	82	0	1	1	0	84
6601	86	0	1	0	0	87
6602	2	0	1	83	0	86
6603	2	0	0	83	0	85
6604	84	0	0	2	0	86
6605	1	0	0	84	0	85
6606	1	81	0	4	0	86
6607	1	1	0	87	0	89
6608	87	1	0	2	0	90
6609	1	1	87	1	0	90
6610	88	0	1	1	0	90
6611	2	0	86	0	0	88
6612	1	0	2	86	0	89
6613	88	0	1	1	0	90
6614	1	0	1	89	0	91
6615	1	0	0	89	0	90
6616	88	0	0	2	0	90
6617	1	0	86	2	0	89
6618	1	0	99	1	0	101
6619	1	0	2	98	0	101
6620	0	0	2	103	0	105
6621	0	0	1	105	0	106
6622	0	0	103	3	0	106
6623	108	0	1	3	0	112
6624	111	0	1	1	0	113
6625	111	0	1	0	0	112
6626	113	0	0	0	0	113
6627	3	103	0	0	0	106
6628	3	109	0	0	0	112
6629	1	116	0	0	0	117
6630	0	4	0	89	0	93
6631	0	0	0	91	0	91
6632	0	0	89	0	0	89
6633	0	82	0	0	0	82
6634	0	0	0	81	0	81
6635	80	0	0	0	0	80
6636	0	80	0	0	0	80
6637	0	0	0	78	0	78
6638	0	80	0	0	0	80
6639	81	0	0	0	0	81
6640	0	0	0	80	0	80
6641	0	0	81	0	0	81
6642	0	0	76	0	0	76
6643	0	0	0	82	0	82
6644	0	0	0	81	0	81
6645	0	0	0	89	0	89
6646	87	0	0	2	0	89
6647	2	0	89	0	0	91
6648	0	88	1	0	0	89
6649	0	2	0	88	0	90
6650	0	0	91	2	0	93
6651	0	91	2	0	0	93
6652	0	2	0	94	0	96
6653	0	0	96	2	0	98
6654	0	0	2	94	0	96
6655	0	0	0	96	0	96
6656	95	0	0	2	0	97
6657	94	0	0	0	0	94
6658	2	0	0	91	0	93
6659	90	0	0	2	0	92
6660	2	0	90	0	0	92
6661	0	0	2	90	0	92
6662	0	0	95	2	0	97
6663	0	0	2	96	0	98
6664	0	97	0	2	0	99
6665	0	100	0	0	0	100
6666	0	97	1	0	0	98
6667	0	2	0	103	0	105
6668	0	0	0	117	0	117
6669	0	0	117	3	0	120
6670	0	0	120	0	0	120
6671	0	0	123	0	0	123
6672	132	0	3	0	0	135
6673	3	0	0	137	0	140
6674	139	0	0	3	0	142
6675	3	148	0	0	0	151
6676	0	2	0	150	0	152
6677	151	0	0	3	0	154
6678	3	0	0	154	0	157
6679	153	0	0	3	0	156
6680	3	0	158	1	0	162
6681	1	154	3	0	0	158
6682	0	3	1	157	0	161
6683	155	1	0	3	0	159
6684	163	0	0	2	0	165
6685	4	0	0	162	0	166
6686	1	0	0	162	0	163
6687	161	0	0	4	0	165
6688	3	0	0	164	0	167
6689	1	0	156	3	0	160
6690	0	155	3	1	0	159
6691	0	3	1	158	0	162
6692	160	1	0	3	0	164
6693	160	0	0	1	0	161
6694	4	0	159	0	0	163
6695	1	152	3	0	0	156
6696	0	165	1	0	0	166
6697	0	4	0	161	0	165
6698	0	1	0	165	0	166
6699	1	0	0	164	0	165
6700	0	0	0	163	0	163
6701	0	154	0	4	0	158
6702	1	3	0	159	0	163
6703	0	1	0	160	0	161
6704	159	0	0	4	0	163
6705	160	0	0	1	0	161
6706	4	162	0	0	0	166
6707	162	3	0	0	0	165
6708	163	1	0	0	0	164
6709	165	0	0	0	0	165
6710	4	0	161	0	0	165
6711	1	0	3	160	0	164
6712	0	0	1	166	0	167
6713	0	0	161	4	0	165
6714	0	0	3	161	0	164
6715	0	0	1	154	0	155
6716	162	0	0	4	0	166
6717	3	0	162	1	0	166
6718	1	0	3	149	0	153
6719	150	0	1	3	0	154
6720	3	145	0	3	0	151
6721	145	3	0	0	0	148
6722	145	1	0	0	0	146
6723	4	138	0	1	0	143
6724	1	3	0	140	0	144
6725	139	1	0	3	0	143
6726	3	139	1	2	0	145
6727	2	3	0	143	0	148
6728	134	1	0	4	0	139
6729	133	0	0	2	0	135
6730	4	131	1	0	0	136
6731	131	4	0	0	0	135
6732	3	1	0	132	0	136
6733	131	0	0	3	0	134
6734	4	0	131	1	0	136
6735	1	0	4	133	0	138
6736	0	0	1	135	0	136
6737	131	0	0	5	0	136
6738	2	128	0	3	0	133
6739	128	3	1	0	0	132
6740	3	130	0	0	0	133
6741	1	3	124	1	0	129
6742	2	1	128	0	0	131
6743	1	1	4	124	0	130
6744	1	0	126	2	0	129
6745	0	1	2	120	0	123
6746	0	2	1	121	0	124
6747	0	0	0	126	0	126
6748	128	0	0	3	0	131
6749	125	0	0	2	0	127
6750	128	0	0	2	0	130
6751	2	127	0	1	0	130
6752	2	128	0	0	0	130
6753	0	2	143	2	0	147
6754	1	1	2	146	0	150
6755	1	1	148	1	0	151
6756	0	1	1	150	0	152
6757	2	0	2	149	0	153
6758	2	0	0	151	0	153
6759	1	0	145	2	0	148
6760	1	0	2	149	0	152
6761	144	2	1	3	0	150
6762	1	141	0	4	0	146
6763	1	1	1	140	0	143
6764	137	1	0	5	0	143
6765	136	0	0	2	0	138
6766	3	2	0	134	0	139
6767	1	0	1	127	0	129
6768	116	0	0	4	0	120
6769	3	0	1	114	0	118
6770	108	1	0	2	0	111
6771	2	0	0	103	0	105
6772	1	1	95	0	0	97
6773	1	90	0	3	0	94
6774	2	90	1	0	0	93
6775	1	2	1	80	0	84
6776	0	0	3	79	0	82
6777	78	0	0	2	0	80
6778	1	0	1	78	0	80
6779	0	0	0	81	0	81
6780	1	0	0	74	0	75
6781	0	72	0	2	0	74
6782	0	0	2	74	0	76
6783	0	0	0	75	0	75
6784	1	1	0	67	0	69
6785	68	2	1	1	0	72
6786	0	68	0	3	0	71
6787	2	0	0	69	0	71
6788	1	0	0	67	0	68
6789	1	0	0	69	0	70
6790	67	1	0	2	0	70
6791	1	1	0	64	0	66
6792	0	0	0	66	0	66
6793	1	0	63	2	0	66
6794	1	58	0	2	0	61
6795	1	0	1	62	0	64
6796	60	2	0	1	0	63
6797	0	60	1	1	0	62
6798	58	1	0	2	0	61
6799	58	0	0	3	0	61
6800	3	0	0	58	0	61
6801	0	1	0	60	0	61
6802	1	0	56	2	0	59
6803	1	0	1	58	0	60
6804	0	1	59	1	0	61
6805	0	0	0	64	0	64
6806	56	0	1	1	0	58
6807	0	59	0	2	0	61
6808	2	0	1	61	0	64
6809	1	1	0	61	0	63
6810	1	0	0	62	0	63
6811	0	1	0	62	0	63
6812	60	0	0	2	0	62
6813	1	59	0	2	0	62
6814	0	0	1	61	0	62
6815	61	0	0	3	0	64
6816	1	0	62	0	0	63
6817	60	3	0	0	0	63
6818	61	0	0	3	0	64
6819	1	0	61	1	0	63
6820	0	1	1	63	0	65
6821	65	0	0	1	0	66
6822	3	64	0	0	0	67
6823	66	1	1	1	0	69
6824	65	0	0	3	0	68
6825	67	0	1	0	0	68
6826	0	1	1	66	0	68
6827	1	0	1	62	0	64
6828	2	67	1	1	0	71
6829	2	0	1	68	0	71
6830	68	1	0	1	0	70
6831	2	0	68	2	0	72
6832	67	2	0	2	0	71
6833	71	1	0	3	0	75
6834	2	0	0	70	0	72
6835	3	0	1	69	0	73
6836	72	1	1	1	0	75
6837	72	0	0	2	0	74
6838	69	1	0	1	0	71
6839	0	0	70	3	0	73
6840	3	68	0	1	0	72
6841	73	0	1	0	0	74
6842	2	0	0	66	0	68
6843	2	67	1	1	0	71
6844	1	1	1	68	0	71
6845	71	2	0	1	0	74
6846	2	0	0	70	0	72
6847	2	0	63	1	0	66
6848	1	61	0	1	0	63
6849	1	60	0	2	0	63
6850	1	0	59	1	0	61
6851	51	0	2	1	0	54
6852	0	47	1	2	0	50
6853	1	2	0	31	0	34
6854	31	1	0	0	0	32
6855	0	32	1	0	0	33
6856	1	0	0	32	0	33
6857	32	1	0	0	0	33
6858	0	0	0	33	0	33
6859	33	0	0	0	0	33
6860	0	1	32	0	0	33
6861	0	32	0	0	0	32
6862	35	0	0	0	0	35
6863	33	0	0	1	0	34
6864	36	0	0	0	0	36
6865	0	0	34	0	0	34
6866	33	1	0	0	0	34
6867	36	0	0	0	0	36
6868	1	0	0	35	0	36
6869	36	0	0	0	0	36
6870	0	35	1	0	0	36
6871	1	0	0	35	0	36
6872	1	0	36	0	0	37
6873	0	0	0	35	0	35
6874	1	0	0	35	0	36
6875	35	1	0	0	0	36
6876	38	0	0	0	0	38
6877	0	0	38	0	0	38
6878	36	0	0	1	0	37
6879	1	0	35	0	0	36
6880	1	0	0	37	0	38
6881	1	0	37	0	0	38
6882	0	0	1	36	0	37
6883	1	37	0	0	0	38
6884	0	0	43	0	0	43
6885	1	0	44	0	0	45
6886	0	0	1	42	0	43
6887	44	0	0	1	0	45
6888	44	1	0	0	0	45
6889	44	0	1	0	0	45
6890	0	0	0	43	0	43
6891	0	0	0	44	0	44
6892	1	0	0	44	0	45
6893	1	0	0	44	0	45
6894	1	0	43	0	0	44
6895	0	0	1	44	0	45
6896	0	44	0	2	0	46
6897	0	1	0	44	0	45
6898	45	0	0	2	0	47
6899	1	0	49	0	0	50
6900	46	0	1	1	0	48
6901	1	1	47	0	0	49
6902	0	0	47	1	0	48
6903	1	48	2	0	0	51
6904	0	1	2	42	0	45
6905	1	1	0	47	0	49
6906	0	40	1	1	0	42
6907	47	1	1	1	0	50
6908	1	2	0	46	0	49
6909	1	0	0	53	0	54
6910	0	0	0	55	0	55
6911	61	1	0	2	0	64
6912	66	0	0	2	0	68
6913	3	0	0	66	0	69
6914	1	0	0	68	0	69
6915	64	0	0	3	0	67
6916	4	0	0	65	0	69
6917	2	0	0	67	0	69
6918	0	0	0	69	0	69
6919	1	0	62	4	0	67
6920	62	0	2	2	0	66
6921	63	0	1	2	0	66
6922	3	0	60	2	0	65
6923	1	0	3	56	0	60
6924	1	57	0	2	0	60
6925	58	2	0	1	0	61
6926	2	58	1	0	0	61
6927	1	59	0	1	0	61
6928	0	4	0	54	0	58
6929	58	1	0	2	0	61
6930	60	1	0	1	0	62
6931	3	1	1	58	0	63
6932	1	0	0	61	0	62
6933	1	1	0	57	0	59
6934	1	0	0	57	0	58
6935	1	0	0	58	0	59
6936	0	51	1	4	0	56
6937	1	2	0	55	0	58
6938	53	1	0	3	0	57
6939	55	0	1	2	0	58
6940	53	2	0	0	0	55
6941	3	52	0	2	0	57
6942	2	2	0	53	0	57
6943	1	2	52	2	0	57
6944	52	0	1	1	0	54
6945	2	1	1	51	0	55
6946	53	0	0	4	0	57
6947	53	0	1	2	0	56
6948	57	0	0	0	0	57
6949	4	0	0	53	0	57
6950	54	0	0	3	0	57
6951	3	0	0	54	0	57
6952	3	0	0	54	0	57
6953	52	0	0	5	0	57
6954	3	0	0	53	0	56
6955	52	0	0	4	0	56
6956	53	0	1	2	0	56
6957	4	0	0	51	0	55
6958	2	0	0	54	0	56
6959	1	0	1	54	0	56
6960	2	0	48	3	0	53
6961	0	1	52	2	0	55
6962	1	0	3	50	0	54
6963	0	1	1	52	0	54
6964	0	1	1	51	0	53
6965	1	0	1	49	0	51
6966	1	0	0	51	0	52
6967	47	0	0	4	0	51
6968	2	47	0	3	0	52
6969	1	2	0	49	0	52
6970	47	1	0	4	0	52
6971	2	0	0	49	0	51
6972	1	1	0	48	0	50
6973	45	1	0	4	0	50
6974	49	0	0	2	0	51
6975	4	0	45	1	0	50
6976	2	0	2	44	0	48
6977	2	0	46	2	0	50
6978	1	1	2	45	0	49
6979	0	0	2	48	0	50
6980	0	0	1	49	0	50
6981	1	0	46	3	0	50
6982	0	44	2	3	0	49
6983	1	46	1	1	0	49
6984	0	3	0	43	0	46
6985	40	1	1	2	0	44
6986	2	1	42	1	0	46
6987	2	1	43	0	0	46
6988	0	0	3	44	0	47
6989	1	0	1	43	0	45
6990	1	40	1	3	0	45
6991	0	2	1	44	0	47
6992	1	1	0	45	0	47
6993	1	0	0	47	0	48
6994	43	1	0	2	0	46
6995	43	0	0	2	0	45
6996	2	0	0	45	0	47
6997	1	44	0	2	0	47
6998	1	1	0	40	0	42
6999	39	1	0	1	0	41
7000	1	39	0	2	0	42
7001	0	2	0	39	0	41
7002	0	42	0	2	0	44
7003	40	1	0	0	0	41
7004	41	1	0	1	0	43
7005	1	39	0	1	0	41
7006	0	41	0	0	0	41
7007	1	1	38	0	0	40
7008	0	36	1	0	0	37
7009	0	1	0	31	0	32
7010	0	0	31	1	0	32
7011	0	21	1	0	0	22
7012	0	0	0	18	0	18
7013	0	0	0	19	0	19
7014	0	0	0	19	0	19
7015	19	0	0	0	0	19
7016	0	0	17	0	0	17
7017	0	0	17	0	0	17
7018	0	0	0	16	0	16
7019	0	0	17	0	0	17
7020	0	0	0	17	0	17
7021	0	0	0	16	0	16
7022	0	0	0	17	0	17
7023	0	0	0	17	0	17
7024	17	0	0	0	0	17
7025	17	0	0	0	0	17
7026	0	0	0	17	0	17
7027	0	0	20	0	0	20
7028	0	0	0	20	0	20
7029	0	18	0	0	0	18
7030	0	0	0	17	0	17
7031	17	0	0	0	0	17
7032	17	0	0	0	0	17
7033	0	0	0	17	0	17
7034	0	0	0	17	0	17
7035	0	0	0	16	0	16
7036	17	0	0	0	0	17
7037	0	0	16	0	0	16
7038	0	0	17	0	0	17
7039	0	17	0	0	0	17
7040	17	0	0	0	0	17
7041	0	0	0	16	0	16
7042	0	0	17	0	0	17
7043	0	16	0	0	0	16
7044	0	19	0	0	0	19
7045	0	0	0	19	0	19
7046	0	0	0	18	0	18
7047	0	19	0	0	0	19
7048	0	0	0	20	0	20
7049	0	0	0	20	0	20
7050	20	0	0	0	0	20
7051	0	20	0	0	0	20
7052	0	0	0	20	0	20
7053	0	0	20	0	0	20
7054	0	0	0	20	0	20
7055	19	0	0	1	0	20
7056	0	19	0	0	0	19
7057	0	0	0	21	0	21
7058	0	0	21	0	0	21
7059	0	0	24	0	0	24
7060	0	0	0	28	0	28
7061	0	0	0	27	0	27
7062	28	0	0	0	0	28
7063	0	30	0	0	0	30
7064	30	0	0	0	0	30
7065	0	0	32	0	0	32
7066	32	0	0	0	0	32
7067	0	0	32	0	0	32
7068	32	0	0	0	0	32
7069	31	0	0	0	0	31
7070	0	0	37	0	0	37
7071	0	0	39	0	0	39
7072	0	38	0	0	0	38
7073	0	0	0	38	0	38
7074	40	0	0	0	0	40
7075	0	0	0	42	0	42
7076	0	0	0	41	0	41
7077	0	0	0	41	0	41
7078	0	0	40	0	0	40
7079	41	0	0	0	0	41
7080	40	0	0	0	0	40
7081	0	40	0	0	0	40
7082	0	0	0	39	0	39
7083	0	42	0	0	0	42
7084	0	1	0	43	0	44
7085	42	0	0	1	0	43
7086	1	41	0	0	0	42
7087	0	1	0	41	0	42
7088	41	0	0	1	0	42
7089	41	0	0	0	0	41
7090	1	0	0	41	0	42
7091	0	0	41	1	0	42
7092	0	0	0	39	0	39
7093	0	40	0	0	0	40
7094	41	1	0	0	0	42
7095	1	40	0	0	0	41
7096	0	1	0	42	0	43
7097	42	0	0	1	0	43
7098	1	1	0	41	0	43
7099	0	0	0	44	0	44
7100	1	0	41	1	0	43
7101	0	40	1	0	0	41
7102	38	1	0	1	0	40
7103	38	0	0	0	0	38
7104	1	37	0	0	0	38
7105	0	37	0	1	0	38
7106	0	1	1	36	0	38
7107	36	0	0	2	0	38
7108	1	36	0	0	0	37
7109	1	1	0	36	0	38
7110	0	1	37	1	0	39
7111	0	0	1	37	0	38
7112	39	0	0	1	0	40
7113	1	37	0	1	0	39
7114	0	1	0	39	0	40
7115	0	0	39	1	0	40
7116	0	1	38	0	0	39
7117	1	0	2	36	0	39
7118	1	0	0	40	0	41
7119	0	37	0	2	0	39
7120	1	1	0	38	0	40
7121	38	1	0	2	0	41
7122	3	0	0	39	0	42
7123	39	0	1	1	0	41
7124	2	38	0	1	0	41
7125	0	42	2	0	0	44
7126	1	1	0	42	0	44
7127	2	0	0	40	0	42
7128	0	1	40	1	0	42
7129	0	0	2	41	0	43
7130	40	1	1	1	0	43
7131	1	0	41	1	0	43
7132	1	0	1	38	0	40
7133	0	0	45	3	0	48
7134	0	1	1	46	0	48
7135	0	0	0	47	0	47
7136	1	0	1	45	0	47
7137	0	0	45	2	0	47
7138	2	0	1	44	0	47
7139	0	44	0	1	0	45
7140	0	2	0	46	0	48
7141	0	1	0	47	0	48
7142	46	0	0	3	0	49
7143	1	0	46	0	0	47
7144	0	1	1	44	0	46
7145	1	0	44	2	0	47
7146	1	0	45	0	0	46
7147	1	0	1	42	0	44
7148	0	0	1	43	0	44
7149	0	0	1	44	0	45
7150	43	0	0	3	0	46
7151	1	1	43	1	0	46
7152	45	0	2	0	0	47
7153	1	1	0	49	0	51
7154	0	1	0	50	0	51
7155	1	56	0	1	0	58
7156	0	1	0	60	0	61
7157	1	0	0	59	0	60
7158	0	0	2	57	0	59
7159	50	0	0	2	0	52
7160	1	0	44	0	0	45
7161	40	0	1	0	0	41
7162	1	44	0	1	0	46
7163	43	1	0	1	0	45
7164	1	43	0	1	0	45
7165	1	42	0	0	0	43
7166	0	1	1	41	0	43
7167	43	0	0	1	0	44
7168	1	0	0	43	0	44
7169	0	41	0	1	0	42
7170	0	49	0	0	0	49
7171	0	1	0	49	0	50
7172	0	0	0	48	0	48
7173	0	44	0	2	0	46
7174	1	0	0	45	0	46
7175	0	0	1	44	0	45
7176	2	0	0	45	0	47
7177	46	1	0	1	0	48
7178	2	0	47	0	0	49
7179	45	1	1	0	0	47
7180	47	0	0	0	0	47
7181	46	0	0	1	0	47
7182	2	48	0	0	0	50
7183	0	0	0	45	0	45
7184	45	0	0	0	0	45
7185	1	0	0	46	0	47
7186	46	0	0	1	0	47
7187	1	47	0	0	0	48
7188	53	1	0	0	0	54
7189	55	0	0	0	0	55
7190	56	0	0	0	0	56
7191	1	0	0	55	0	56
7192	0	0	0	57	0	57
7193	59	0	0	1	0	60
7194	1	60	0	0	0	61
7195	0	58	0	0	0	58
7196	61	1	0	0	0	62
7197	1	0	0	65	0	66
7198	0	0	0	68	0	68
7199	0	0	0	69	0	69
7200	0	71	0	1	0	72
7201	72	1	0	0	0	73
7202	1	0	0	71	0	72
7203	0	78	0	1	0	79
7204	0	1	0	82	0	83
7205	0	0	0	87	0	87
7206	0	0	0	87	0	87
7207	0	0	0	84	0	84
7208	86	0	0	1	0	87
7209	86	0	0	0	0	86
7210	86	0	0	0	0	86
7211	1	0	0	85	0	86
7212	0	0	86	1	0	87
7213	0	0	82	0	0	82
7214	0	0	86	0	0	86
7215	92	0	1	0	0	93
7216	1	0	0	94	0	95
7217	0	0	0	98	0	98
7218	0	0	0	97	0	97
7219	97	0	0	1	0	98
7220	95	0	0	0	0	95
7221	1	105	0	0	0	106
7222	0	1	0	106	0	107
7223	0	0	106	1	0	107
7224	0	106	1	0	0	107
7225	0	3	0	102	0	105
7226	1	0	0	106	0	107
7227	0	0	0	105	0	105
7228	0	0	0	106	0	106
7229	0	0	103	1	0	104
7230	0	0	96	0	0	96
7231	0	108	1	0	0	109
7232	0	1	0	107	0	108
7233	0	0	0	108	0	108
7234	107	0	0	1	0	108
7235	1	0	112	0	0	113
7236	0	0	1	112	0	113
7237	1	0	0	118	0	119
7238	0	0	118	1	0	119
7239	0	118	1	2	0	121
7240	121	1	0	1	0	123
7241	1	0	120	0	0	121
7242	119	0	1	0	0	120
7243	2	0	127	0	0	129
7244	0	0	1	133	0	134
7245	0	0	134	1	0	135
7246	0	0	137	0	0	137
7247	0	0	1	145	0	146
7248	1	0	0	129	0	130
7249	0	0	0	153	0	153
7250	0	0	0	149	0	149
7251	0	0	0	153	0	153
7252	0	0	152	1	0	153
7253	0	0	154	0	0	154
7254	0	155	1	0	0	156
7255	148	1	0	0	0	149
7256	1	0	0	148	0	149
7257	149	0	0	1	0	150
7258	1	0	0	148	0	149
7259	161	0	0	1	0	162
7260	1	0	0	161	0	162
7261	0	0	0	163	0	163
7262	0	171	0	1	0	172
7263	0	1	0	177	0	178
7264	0	0	0	177	0	177
7265	0	0	0	175	0	175
7266	0	0	0	175	0	175
7267	0	173	0	1	0	174
7268	172	1	0	0	0	173
7269	1	174	0	0	0	175
7270	0	1	0	171	0	172
7271	168	0	0	1	0	169
7272	1	0	168	0	0	169
7273	0	0	170	0	0	170
7274	0	0	1	168	0	169
7275	0	0	0	172	0	172
7276	0	1	0	173	0	174
7277	0	0	0	161	0	161
7278	0	0	0	170	0	170
7279	0	169	0	1	0	170
7280	0	1	0	171	0	172
7281	170	0	0	1	0	171
7282	1	0	0	171	0	172
7283	0	0	169	1	0	170
7284	0	0	0	168	0	168
7285	171	0	0	1	0	172
7286	0	174	0	1	0	175
7287	0	0	0	188	0	188
7288	0	0	0	192	0	192
7289	0	0	190	4	0	194
7290	0	0	250	0	0	250
7291	301	0	7	0	0	308
7292	9	0	0	308	0	317
7293	0	0	1	317	0	318
7294	1	0	320	10	0	331
7295	1	0	329	1	0	331
7296	0	325	11	2	0	338
7297	1	10	2	317	0	330
7298	0	0	318	9	0	327
7299	0	320	12	0	0	332
7300	318	11	0	3	0	332
7301	326	0	2	2	0	330
7302	12	2	1	316	0	331
7303	1	316	1	9	0	327
7304	313	12	0	0	0	325
7305	12	0	0	305	0	317
7306	0	2	312	10	0	324
7307	2	313	11	0	0	326
7308	311	12	0	5	0	328
7309	322	0	2	2	0	326
7310	12	2	3	311	0	328
7311	2	4	0	318	0	324
7312	4	0	303	12	0	319
7313	2	0	12	307	0	321
7314	1	1	1	311	0	314
7315	0	2	1	317	0	320
7316	4	0	1	317	0	322
7317	1	0	0	306	0	307
7318	0	303	1	15	0	319
7319	305	11	0	4	0	320
7320	12	0	302	2	0	316
7321	0	295	10	1	0	306
7322	2	13	0	296	0	311
7323	299	0	2	13	0	314
7324	11	2	2	295	0	310
7325	1	1	0	308	0	310
7326	1	1	0	306	0	308
7327	2	0	2	306	0	310
7328	1	0	293	15	0	309
7329	2	294	10	6	0	312
7330	292	11	0	9	0	312
7331	13	0	291	4	0	308
7332	0	2	14	291	0	307
7333	290	4	3	11	0	308
7334	12	289	2	3	0	306
7335	283	10	2	6	0	301
7336	14	2	2	273	0	291
7337	2	5	1	285	0	293
7338	7	1	1	286	0	295
7339	2	1	1	291	0	295
7340	272	1	1	18	0	292
7341	13	3	1	276	0	293
7342	3	2	0	289	0	294
7343	270	0	3	13	0	286
7344	13	2	264	4	0	283
7345	3	2	11	267	0	283
7346	261	2	1	13	0	277
7347	264	0	1	2	0	267
7348	13	0	1	250	0	264
7349	2	2	1	256	0	261
7350	4	237	3	14	0	258
7351	3	10	1	241	0	255
7352	1	1	1	246	0	249
7353	0	2	229	19	0	250
7354	1	1	237	8	0	247
7355	3	231	11	5	0	250
7356	2	13	2	229	0	246
7357	3	0	3	244	0	250
7358	228	3	2	14	0	247
7359	10	4	2	224	0	240
7360	2	0	217	20	0	239
7361	6	1	12	218	0	237
7362	3	1	210	18	0	232
7363	0	2	221	7	0	230
7364	1	0	12	213	0	226
7365	1	1	4	221	0	227
7366	210	0	5	13	0	228
7367	220	3	1	8	0	232
7368	13	0	5	214	0	232
7369	214	1	2	16	0	233
7370	222	1	1	3	0	227
7371	14	1	2	217	0	234
7372	4	3	1	224	0	232
7373	213	1	0	14	0	228
7374	218	1	2	6	0	227
7375	12	0	2	212	0	226
7376	3	201	2	18	0	224
7377	6	12	1	205	0	224
7378	9	0	1	216	0	226
7379	5	2	202	15	0	224
7380	1	1	9	215	0	226
7381	204	0	1	17	0	222
7382	14	202	6	4	0	226
7383	206	11	1	10	0	228
7384	216	1	1	4	0	222
7385	214	4	0	4	0	222
7386	17	1	0	199	0	217
7387	7	0	179	15	0	201
7388	5	2	182	4	0	193
7389	4	174	6	7	0	191
7390	0	117	2	4	0	123
7391	2	58	2	0	0	62
7392	1	55	0	2	0	58
7393	1	2	53	1	0	57
7394	39	0	2	1	0	42
7395	0	1	0	37	0	38
7396	0	0	0	36	0	36
7397	1	0	0	37	0	38
7398	0	36	0	1	0	37
7399	37	0	0	1	0	38
7400	0	0	37	1	0	38
7401	0	36	0	0	0	36
7402	1	0	0	35	0	36
7403	36	0	1	0	0	37
7404	1	1	0	37	0	39
7405	0	0	35	2	0	37
7406	1	0	39	0	0	40
7407	0	0	1	39	0	40
7408	0	0	1	39	0	40
7409	37	0	1	1	0	39
7410	1	0	38	1	0	40
7411	38	0	1	1	0	40
7412	40	0	0	0	0	40
7413	1	0	1	39	0	41
7414	1	0	39	1	0	41
7415	0	0	1	39	0	40
7416	39	0	0	2	0	41
7417	1	39	0	0	0	40
7418	38	1	0	1	0	40
7419	2	0	0	36	0	38
7420	0	38	0	1	0	39
7421	1	1	0	38	0	40
7422	0	0	0	40	0	40
7423	0	41	0	1	0	42
7424	0	1	0	40	0	41
7425	0	0	0	40	0	40
7426	0	0	0	40	0	40
7427	0	0	35	2	0	37
7428	0	37	1	1	0	39
7429	38	1	0	1	0	40
7430	1	0	1	39	0	41
7431	0	41	0	1	0	42
7432	45	1	0	0	0	46
7433	1	0	0	44	0	45
7434	0	0	0	45	0	45
7435	1	0	0	44	0	45
7436	0	0	0	46	0	46
7437	46	0	0	2	0	48
7438	1	0	0	46	0	47
7439	0	0	0	48	0	48
7440	46	0	0	1	0	47
7441	1	0	0	46	0	47
7442	0	0	46	2	0	48
7443	1	0	1	46	0	48
7444	45	0	0	2	0	47
7445	1	0	1	45	0	47
7446	0	0	46	2	0	48
7447	1	0	45	0	0	46
7448	45	0	1	0	0	46
7449	47	0	1	0	0	48
7450	47	0	0	0	0	47
7451	49	0	0	0	0	49
7452	2	0	48	0	0	50
7453	1	0	1	46	0	48
7454	1	0	0	47	0	48
7455	46	0	1	1	0	48
7456	1	0	0	47	0	48
7457	0	0	45	1	0	46
7458	0	0	1	46	0	47
7459	0	0	45	1	0	46
7460	0	45	1	0	0	46
7461	47	1	0	0	0	48
7462	1	0	0	45	0	46
7463	0	0	45	1	0	46
7464	0	0	1	45	0	46
7465	0	0	0	48	0	48
7466	0	0	45	1	0	46
7467	0	0	1	45	0	46
7468	46	0	0	1	0	47
7469	1	0	42	0	0	43
7470	45	0	1	0	0	46
7471	1	44	0	0	0	45
7472	0	1	43	0	0	44
7473	0	0	44	0	0	44
7474	0	0	1	39	0	40
7475	0	0	0	44	0	44
7476	0	0	42	1	0	43
7477	0	0	1	42	0	43
7478	44	0	0	1	0	45
7479	45	0	0	0	0	45
7480	1	0	0	44	0	45
7481	0	0	0	45	0	45
7482	0	46	0	1	0	47
7483	48	1	0	0	0	49
7484	1	0	0	49	0	50
7485	0	52	0	1	0	53
7486	52	1	0	0	0	53
7487	54	0	0	0	0	54
7488	2	53	0	0	0	55
7489	0	2	0	54	0	56
7490	0	0	0	54	0	54
7491	0	0	50	2	0	52
7492	0	0	2	51	0	53
7493	52	0	0	2	0	54
7494	2	0	0	51	0	53
7495	0	0	49	2	0	51
7496	50	0	2	0	0	52
7497	2	0	0	51	0	53
7498	0	0	51	2	0	53
7499	0	0	2	48	0	50
7500	0	0	48	2	0	50
7501	0	0	2	48	0	50
7502	0	0	0	50	0	50
7503	47	0	0	1	0	48
7504	1	46	0	0	0	47
7505	47	1	0	0	0	48
7506	44	0	0	0	0	44
7507	45	0	0	0	0	45
7508	1	47	0	0	0	48
7509	0	1	49	0	0	50
7510	0	0	1	49	0	50
7511	47	0	0	1	0	48
7512	50	0	0	0	0	50
7513	1	0	0	47	0	48
7514	48	0	0	1	0	49
7515	1	0	47	0	0	48
7516	47	0	1	0	0	48
7517	1	0	46	0	0	47
7518	0	48	1	0	0	49
7519	47	1	0	0	0	48
7520	48	0	0	0	0	48
7521	1	46	0	0	0	47
7522	46	1	0	0	0	47
7523	45	0	0	0	0	45
7524	1	0	44	0	0	45
7525	43	0	1	0	0	44
7526	1	0	44	0	0	45
7527	0	0	1	44	0	45
7528	1	41	0	1	0	43
7529	0	1	44	0	0	45
7530	41	1	0	1	0	43
7531	42	0	0	0	0	42
7532	1	0	0	40	0	41
7533	0	0	39	1	0	40
7534	0	0	1	39	0	40
7535	39	0	0	1	0	40
7536	1	41	0	0	0	42
7537	39	1	0	0	0	40
7538	40	0	0	0	0	40
7539	1	39	0	0	0	40
7540	0	0	0	41	0	41
7541	41	0	0	1	0	42
7542	1	0	0	41	0	42
7543	0	0	0	44	0	44
7544	0	0	43	1	0	44
7545	0	0	1	43	0	44
7546	0	0	0	44	0	44
7547	43	0	0	1	0	44
7548	45	0	0	0	0	45
7549	1	0	0	43	0	44
7550	0	0	44	1	0	45
7551	0	0	40	0	0	40
7552	0	0	1	40	0	41
7553	0	0	42	1	0	43
7554	0	0	1	42	0	43
7555	0	0	0	43	0	43
7556	42	0	0	1	0	43
7557	1	0	40	0	0	41
7558	41	0	1	0	0	42
7559	42	0	0	0	0	42
7560	1	0	41	0	0	42
7561	0	0	40	0	0	40
7562	0	0	1	40	0	41
7563	0	38	0	1	0	39
7564	0	42	0	0	0	42
7565	0	0	0	40	0	40
7566	0	0	0	39	0	39
7567	0	0	0	41	0	41
7568	0	0	0	40	0	40
7569	38	0	0	1	0	39
7570	1	0	0	38	0	39
7571	0	0	37	1	0	38
7572	0	0	1	37	0	38
7573	0	37	0	1	0	38
7574	0	0	0	37	0	37
7575	36	0	0	1	0	37
7576	1	0	0	36	0	37
7577	0	0	34	1	0	35
7578	0	35	1	0	0	36
7579	0	1	0	35	0	36
7580	35	0	0	1	0	36
7581	35	0	0	0	0	35
7582	1	0	0	32	0	33
7583	0	0	29	1	0	30
7584	0	0	30	0	0	30
7585	29	0	1	0	0	30
7586	1	0	32	0	0	33
7587	0	0	33	0	0	33
7588	2	0	0	29	0	31
7589	30	0	0	0	0	30
7590	29	0	0	0	0	29
7591	30	0	0	0	0	30
7592	0	0	34	0	0	34
7593	0	0	33	0	0	33
7594	0	39	0	0	0	39
7595	0	0	0	38	0	38
7596	0	0	0	39	0	39
7597	0	0	0	36	0	36
7598	0	0	0	39	0	39
7599	0	0	39	0	0	39
7600	0	39	0	0	0	39
7601	45	0	0	0	0	45
7602	49	0	0	0	0	49
7603	51	0	0	0	0	51
7604	0	49	0	0	0	49
7605	0	0	0	52	0	52
7606	52	0	0	0	0	52
7607	0	53	0	0	0	53
7608	49	0	0	0	0	49
7609	0	49	0	0	0	49
7610	49	0	0	0	0	49
7611	49	0	0	0	0	49
7612	0	0	0	48	0	48
7613	0	0	0	50	0	50
7614	0	0	50	0	0	50
7615	0	0	50	0	0	50
7616	51	0	0	0	0	51
7617	53	0	0	0	0	53
7618	1	0	0	51	0	52
7619	0	0	0	52	0	52
7620	0	0	51	1	0	52
7621	0	0	1	49	0	50
7622	0	0	50	1	0	51
7623	0	0	1	51	0	52
7624	0	0	0	53	0	53
7625	52	0	0	1	0	53
7626	51	0	0	0	0	51
7627	1	0	0	50	0	51
7628	0	0	0	53	0	53
7629	0	0	50	1	0	51
7630	0	0	1	50	0	51
7631	0	0	51	1	0	52
7632	49	0	1	0	0	50
7633	1	0	0	51	0	52
7634	50	0	0	1	0	51
7635	1	52	0	0	0	53
7636	50	1	0	0	0	51
7637	1	0	0	49	0	50
7638	0	0	0	53	0	53
7639	0	52	0	1	0	53
7640	0	1	0	51	0	52
7641	0	0	51	1	0	52
7642	0	0	1	48	0	49
7643	0	0	48	1	0	49
7644	0	51	1	0	0	52
7645	0	1	0	50	0	51
7646	0	0	49	1	0	50
7647	0	0	47	0	0	47
7648	0	0	1	48	0	49
7649	49	0	0	1	0	50
7650	1	0	49	0	0	50
7651	0	0	1	48	0	49
7652	48	0	0	1	0	49
7653	1	48	0	0	0	49
7654	49	1	0	0	0	50
7655	1	0	0	48	0	49
7656	0	0	0	50	0	50
7657	0	0	0	49	0	49
7658	49	0	0	1	0	50
7659	1	0	0	50	0	51
7660	0	0	0	51	0	51
7661	48	0	0	1	0	49
7662	1	0	48	0	0	49
7663	0	0	1	48	0	49
7664	0	0	47	1	0	48
7665	47	0	1	0	0	48
7666	1	0	0	48	0	49
7667	1	0	48	1	0	50
7668	49	0	1	0	0	50
7669	46	1	0	0	0	47
7670	1	0	49	1	0	51
7671	1	0	1	47	0	49
7672	0	1	0	49	0	50
7673	1	0	49	1	0	51
7674	0	51	1	0	0	52
7675	1	1	49	0	0	51
7676	47	0	1	0	0	48
7677	1	0	50	1	0	52
7678	50	0	1	0	0	51
7679	1	0	53	0	0	54
7680	51	0	2	0	0	53
7681	2	52	0	0	0	54
7682	1	1	0	54	0	56
7683	0	0	0	56	0	56
7684	0	0	54	2	0	56
7685	0	0	2	52	0	54
7686	0	50	0	2	0	52
7687	49	0	1	0	0	50
7688	1	47	0	1	0	49
7689	0	0	0	51	0	51
7690	52	0	0	2	0	54
7691	3	51	0	0	0	54
7692	47	2	0	1	0	50
7693	2	0	52	0	0	54
7694	0	0	2	46	0	48
7695	0	0	0	50	0	50
7696	0	0	1	50	0	51
7697	48	0	0	2	0	50
7698	50	0	0	2	0	52
7699	49	0	0	0	0	49
7700	50	1	0	0	0	51
7701	3	0	44	0	0	47
7702	37	0	2	0	0	39
7703	2	35	0	0	0	37
7704	0	39	0	0	0	39
7705	35	2	1	1	0	39
7706	42	0	0	0	0	42
7707	1	0	0	40	0	41
7708	40	0	0	2	0	42
7709	41	0	0	1	0	42
7710	40	0	0	0	0	40
7711	2	0	0	39	0	41
7712	0	39	0	2	0	41
7713	0	39	0	0	0	39
7714	1	2	0	37	0	40
7715	37	0	0	2	0	39
7716	2	37	0	0	0	39
7717	0	0	0	37	0	37
7718	0	0	36	1	0	37
7719	34	0	0	0	0	34
7720	1	36	0	0	0	37
7721	0	38	0	0	0	38
7722	37	1	0	0	0	38
7723	1	0	38	0	0	39
7724	0	0	1	37	0	38
7725	0	37	0	1	0	38
7726	0	1	0	37	0	38
7727	0	0	0	37	0	37
7728	0	37	0	1	0	38
7729	0	1	0	37	0	38
7730	0	0	0	40	0	40
7731	39	0	0	1	0	40
7732	0	39	0	0	0	39
7733	38	0	0	0	0	38
7734	1	0	0	39	0	40
7735	1	42	0	2	0	45
7736	0	1	47	0	0	48
7737	0	2	1	47	0	50
7738	0	0	0	48	0	48
7739	0	0	48	1	0	49
7740	45	0	1	0	0	46
7741	1	0	0	47	0	48
7742	47	0	0	1	0	48
7743	1	0	47	0	0	48
7744	0	0	1	43	0	44
7745	0	0	47	1	0	48
7746	0	0	1	44	0	45
7747	0	0	0	45	0	45
7748	43	0	0	2	0	45
7749	1	46	0	0	0	47
7750	45	1	0	0	0	46
7751	1	0	47	0	0	48
7752	0	0	1	48	0	49
7753	0	0	48	1	0	49
7754	45	0	1	0	0	46
7755	47	0	0	0	0	47
7756	1	0	47	0	0	48
7757	47	0	1	0	0	48
7758	48	0	0	0	0	48
7759	1	0	0	48	0	49
7760	0	0	47	1	0	48
7761	0	0	50	0	0	50
7762	0	0	1	51	0	52
7763	0	0	1	53	0	54
7764	0	48	0	2	0	50
7765	0	51	0	1	0	52
7766	52	1	0	1	0	54
7767	2	0	0	53	0	55
7768	1	53	0	1	0	55
7769	1	54	0	0	0	55
7770	58	1	1	0	0	60
7771	1	0	1	59	0	61
7772	1	55	0	2	0	58
7773	1	2	0	58	0	61
7774	0	2	0	56	0	58
7775	2	0	0	57	0	59
7776	56	0	1	1	0	58
7777	1	51	0	1	0	53
7778	1	0	1	55	0	57
7779	2	0	0	54	0	56
7780	2	0	0	55	0	57
7781	0	0	55	2	0	57
7782	55	1	1	0	0	57
7783	2	1	0	54	0	57
7784	52	0	0	3	0	55
7785	54	0	1	0	0	55
7786	55	1	1	0	0	57
7787	1	0	54	2	0	57
7788	0	53	2	1	0	56
7789	1	0	0	52	0	53
7790	0	2	52	0	0	54
7791	1	1	53	0	0	55
7792	1	0	0	57	0	58
7793	0	50	0	0	0	50
7794	53	1	0	0	0	54
7795	57	0	0	0	0	57
7796	56	0	0	1	0	57
7797	57	1	0	0	0	58
7798	0	0	57	1	0	58
7799	56	0	0	1	0	57
7800	0	58	0	1	0	59
7801	1	0	0	56	0	57
7802	0	0	0	57	0	57
7803	56	0	0	1	0	57
7804	0	0	0	57	0	57
7805	0	0	56	1	0	57
7806	52	0	1	0	0	53
7807	55	0	0	0	0	55
7808	56	0	0	1	0	57
7809	1	0	55	0	0	56
7810	54	0	0	0	0	54
7811	1	57	0	0	0	58
7812	55	0	1	0	0	56
7813	0	1	0	56	0	57
7814	0	0	0	58	0	58
7815	0	57	1	0	0	58
7816	0	0	1	58	0	59
7817	0	58	0	1	0	59
7818	0	1	0	56	0	57
7819	1	58	0	0	0	59
7820	1	0	0	60	0	61
7821	1	59	0	0	0	60
7822	1	0	0	65	0	66
7823	0	64	1	0	0	65
7824	69	0	0	0	0	69
7825	0	1	0	67	0	68
7826	0	0	0	69	0	69
7827	0	0	0	69	0	69
7828	1	0	0	69	0	70
7829	0	0	69	1	0	70
7830	0	0	1	68	0	69
7831	1	0	0	67	0	68
7832	68	0	0	0	0	68
7833	68	0	0	0	0	68
7834	0	72	1	0	0	73
7835	1	0	0	71	0	72
7836	0	1	0	73	0	74
7837	74	0	0	0	0	74
7838	0	0	72	2	0	74
7839	72	0	0	0	0	72
7840	0	72	1	0	0	73
7841	72	0	0	1	0	73
7842	69	2	0	0	0	71
7843	0	69	0	1	0	70
7844	1	71	1	0	0	73
7845	0	0	0	71	0	71
7846	0	1	71	0	0	72
7847	70	0	0	1	0	71
7848	0	0	71	0	0	71
7849	69	0	0	0	0	69
7850	0	1	67	0	0	68
7851	1	62	0	0	0	63
7852	0	0	1	64	0	65
7853	65	0	0	0	0	65
7854	64	0	0	1	0	65
7855	1	0	0	65	0	66
7856	68	0	0	0	0	68
7857	67	0	0	1	0	68
7858	1	68	0	0	0	69
7859	70	0	0	0	0	70
7860	0	68	0	0	0	68
7861	1	0	0	69	0	70
7862	66	1	0	0	0	67
7863	68	0	0	1	0	69
7864	69	0	0	0	0	69
7865	1	0	69	1	0	71
7866	1	0	64	0	0	65
7867	0	0	1	69	0	70
7868	1	0	1	68	0	70
7869	0	71	1	1	0	73
7870	67	0	0	1	0	68
7871	2	1	0	65	0	68
7872	1	1	1	66	0	69
7873	1	0	68	1	0	70
7874	0	68	0	1	0	69
7875	1	67	1	0	0	69
7876	1	1	0	67	0	69
7877	67	2	0	0	0	69
7878	0	1	0	67	0	68
7879	1	0	0	66	0	67
7880	66	0	1	1	0	68
7881	68	0	0	1	0	69
7882	2	0	1	66	0	69
7883	1	0	65	0	0	66
7884	0	0	2	67	0	69
7885	0	1	1	66	0	68
7886	66	0	0	3	0	69
7887	2	0	0	67	0	69
7888	68	0	1	1	0	70
7889	1	0	65	4	0	70
7890	2	0	1	67	0	70
7891	1	1	1	63	0	66
7892	1	0	0	65	0	66
7893	1	0	0	64	0	65
7894	1	1	0	63	0	65
7895	0	0	60	3	0	63
7896	60	0	1	1	0	62
7897	2	1	1	58	0	62
7898	2	0	57	2	0	61
7899	1	0	57	1	0	59
7900	0	0	3	58	0	61
7901	57	0	0	3	0	60
7902	57	0	0	1	0	58
7903	60	1	0	0	0	61
7904	3	0	0	56	0	59
7905	1	55	1	2	0	59
7906	57	1	0	3	0	61
7907	57	1	1	1	0	60
7908	59	1	0	0	0	60
7909	58	1	0	1	0	60
7910	3	0	0	57	0	60
7911	2	0	55	1	0	58
7912	0	0	0	57	0	57
7913	0	0	55	3	0	58
7914	55	0	1	2	0	58
7915	57	0	1	1	0	59
7916	2	0	54	2	0	58
7917	54	0	3	0	0	57
7918	55	0	1	0	0	56
7919	1	0	0	51	0	52
7920	2	52	1	0	0	55
7921	52	0	1	2	0	55
7922	2	1	0	45	0	48
7923	2	44	1	1	0	48
7924	1	1	0	41	0	43
7925	1	1	40	2	0	44
7926	0	39	1	2	0	42
7927	38	4	1	1	0	44
7928	40	1	0	0	0	41
7929	38	0	1	0	0	39
7930	39	0	0	0	0	39
7931	2	0	0	37	0	39
7932	1	33	1	2	0	37
7933	33	1	2	1	0	37
7934	0	1	30	2	0	33
7935	2	24	2	0	0	28
7936	2	1	23	0	0	26
7937	1	0	0	21	0	22
7938	0	20	1	1	0	22
7939	0	1	0	21	0	22
7940	1	0	23	1	0	25
7941	0	0	1	23	0	24
7942	0	1	0	24	0	25
7943	1	0	0	24	0	25
7944	22	0	0	1	0	23
7945	1	22	0	0	0	23
7946	0	1	0	24	0	25
7947	23	0	1	1	0	25
7948	1	24	0	0	0	25
7949	23	1	0	0	0	24
7950	2	0	24	0	0	26
7951	1	0	1	24	0	26
7952	1	25	0	0	0	26
7953	25	1	0	1	0	27
7954	1	1	26	0	0	28
7955	0	25	1	0	0	26
7956	0	1	1	25	0	27
7957	0	1	0	26	0	27
7958	22	0	1	1	0	24
7959	1	0	0	23	0	24
7960	0	1	25	1	0	27
7961	0	0	1	21	0	22
7962	0	0	22	1	0	23
7963	0	0	1	22	0	23
7964	0	21	0	2	0	23
7965	19	1	0	1	0	21
7966	19	0	0	0	0	19
7967	1	17	0	0	0	18
7968	0	16	0	0	0	16
7969	0	1	0	17	0	18
7970	17	0	0	1	0	18
7971	1	0	0	17	0	18
7972	16	0	0	1	0	17
7973	1	16	0	0	0	17
7974	0	1	0	16	0	17
7975	0	0	15	1	0	16
7976	0	0	1	15	0	16
7977	0	0	0	17	0	17
7978	15	0	0	1	0	16
7979	1	15	0	0	0	16
7980	0	0	0	15	0	15
7981	15	0	0	0	0	15
7982	0	0	15	0	0	15
7983	17	0	0	0	0	17
7984	0	0	0	17	0	17
7985	0	19	0	0	0	19
7986	21	0	0	0	0	21
7987	0	0	22	0	0	22
7988	0	0	23	0	0	23
7989	0	24	0	0	0	24
7990	22	0	0	0	0	22
7991	0	0	0	22	0	22
7992	0	0	0	22	0	22
7993	22	0	0	0	0	22
7994	0	0	22	0	0	22
7995	0	0	0	24	0	24
7996	0	0	27	0	0	27
7997	0	0	0	27	0	27
7998	0	25	0	0	0	25
7999	0	0	0	27	0	27
8000	0	0	27	0	0	27
8001	26	0	0	0	0	26
8002	0	0	0	27	0	27
8003	0	0	26	0	0	26
8004	0	0	0	26	0	26
8005	0	0	0	26	0	26
8006	0	0	23	0	0	23
8007	0	0	22	0	0	22
8008	0	0	0	23	0	23
8009	0	0	24	0	0	24
8010	24	0	0	0	0	24
8011	0	0	0	23	0	23
8012	24	0	0	0	0	24
8013	0	0	24	0	0	24
8014	0	0	0	23	0	23
8015	0	0	26	0	0	26
8016	0	26	0	0	0	26
8017	0	0	26	0	0	26
8018	0	0	26	0	0	26
8019	24	0	0	0	0	24
8020	26	0	0	0	0	26
8021	1	0	26	0	0	27
8022	0	0	1	28	0	29
8023	0	0	0	29	0	29
8024	0	0	30	1	0	31
8025	0	29	1	0	0	30
8026	28	1	0	0	0	29
8027	1	0	28	0	0	29
8028	0	0	1	29	0	30
8029	0	0	0	29	0	29
8030	30	0	0	1	0	31
8031	33	0	0	0	0	33
8032	33	0	0	0	0	33
8033	32	0	0	0	0	32
8034	1	0	0	31	0	32
8035	0	0	32	1	0	33
8036	0	0	1	32	0	33
8037	0	0	0	32	0	32
8038	0	0	0	32	0	32
8039	0	0	32	1	0	33
8040	29	0	1	1	0	31
8041	1	0	0	31	0	32
8042	1	0	33	1	0	35
8043	0	34	1	0	0	35
8044	0	1	0	34	0	35
8045	0	0	0	35	0	35
8046	34	0	0	1	0	35
8047	1	34	0	0	0	35
8048	0	1	36	0	0	37
8049	0	0	1	34	0	35
8050	0	0	0	35	0	35
8051	34	0	0	1	0	35
8052	34	0	0	0	0	34
8053	1	0	0	34	0	35
8054	33	0	0	1	0	34
8055	1	33	0	0	0	34
8056	0	1	33	0	0	34
8057	0	0	1	34	0	35
8058	1	0	0	36	0	37
8059	0	0	0	37	0	37
8060	0	0	0	33	0	33
8061	0	34	0	1	0	35
8062	35	1	0	0	0	36
8063	1	0	0	35	0	36
8064	0	35	0	1	0	36
8065	35	1	0	0	0	36
8066	34	0	0	0	0	34
8067	1	35	0	0	0	36
8068	0	1	0	39	0	40
8069	0	0	0	40	0	40
8070	0	0	0	40	0	40
8071	0	0	0	38	0	38
8072	39	0	0	1	0	40
8073	40	0	0	0	0	40
8074	2	39	0	0	0	41
8075	0	2	40	0	0	42
8076	0	0	2	40	0	42
8077	39	0	0	2	0	41
8078	2	39	0	0	0	41
8079	0	40	0	0	0	40
8080	44	2	0	0	0	46
8081	44	0	0	0	0	44
8082	2	0	0	43	0	45
8083	0	0	43	2	0	45
8084	0	0	48	0	0	48
8085	45	0	3	0	0	48
8086	46	0	1	0	0	47
8087	46	0	0	0	0	46
8088	44	0	0	1	0	45
8089	44	0	0	1	0	45
8090	2	45	0	0	0	47
8091	0	1	0	47	0	48
8092	0	50	0	0	0	50
8093	50	2	0	0	0	52
8094	50	0	0	1	0	51
8095	48	0	0	1	0	49
8096	46	0	0	2	0	48
8097	2	46	0	0	0	48
8098	44	1	0	1	0	46
8099	2	45	0	0	0	47
8100	0	2	0	46	0	48
8101	45	0	0	3	0	48
8102	2	1	47	0	0	50
8103	0	0	2	47	0	49
8104	0	0	0	51	0	51
8105	0	0	52	1	0	53
8106	0	53	2	0	0	55
8107	54	2	0	1	0	57
8108	55	0	0	0	0	55
8109	2	54	0	0	0	56
8110	0	1	0	55	0	56
8111	0	0	55	2	0	57
8112	1	61	2	0	0	64
8113	62	2	0	0	0	64
8114	2	0	61	0	0	63
8115	59	0	1	0	0	60
8116	57	0	0	1	0	58
8117	1	0	65	0	0	66
8118	0	69	2	0	0	71
8119	0	2	0	71	0	73
8120	0	0	72	1	0	73
8121	67	2	1	0	0	70
8122	71	0	0	0	0	71
8123	1	72	0	0	0	73
8124	0	0	0	71	0	71
8125	0	0	0	74	0	74
8126	0	0	74	1	0	75
8127	0	79	1	0	0	80
8128	88	1	0	0	0	89
8129	88	0	0	0	0	88
8130	88	0	0	0	0	88
8131	1	0	88	0	0	89
8132	81	0	1	0	0	82
8133	90	0	0	0	0	90
8134	1	0	0	88	0	89
8135	0	0	88	1	0	89
8136	0	0	1	88	0	89
8137	0	0	89	1	0	90
8138	0	1	1	86	0	88
8139	0	88	0	1	0	89
8140	0	95	0	1	0	96
8141	0	1	0	95	0	96
8142	0	0	0	93	0	93
8143	93	0	0	1	0	94
8144	1	0	93	0	0	94
8145	93	0	1	0	0	94
8146	1	98	0	0	0	99
8147	99	1	0	0	0	100
8148	97	0	0	1	0	98
8149	1	0	0	97	0	98
8150	0	0	102	1	0	103
8151	0	0	1	101	0	102
8152	0	113	0	1	0	114
8153	1	1	0	113	0	115
8154	0	0	0	115	0	115
8155	112	0	0	2	0	114
8156	1	0	0	110	0	111
8157	0	110	0	1	0	111
8158	0	1	0	110	0	111
8159	112	0	0	2	0	114
8160	1	120	0	0	0	121
8161	0	0	0	121	0	121
8162	0	0	0	121	0	121
8163	0	0	0	126	0	126
8164	0	0	0	126	0	126
8165	123	0	0	3	0	126
8166	1	0	0	125	0	126
8167	0	0	0	129	0	129
8168	0	0	0	123	0	123
8169	0	125	0	1	0	126
8170	124	1	0	1	0	126
8171	1	1	124	0	0	126
8172	1	124	1	0	0	126
8173	124	0	1	1	0	126
8174	2	1	131	0	0	134
8175	1	131	0	0	0	132
8176	0	0	1	134	0	135
8177	0	136	0	0	0	136
8178	0	1	135	1	0	137
8179	0	1	136	0	0	137
8180	0	133	1	0	0	134
8181	135	0	1	0	0	136
8182	136	1	0	0	0	137
8183	1	0	135	0	0	136
8184	1	0	127	0	0	128
8185	0	0	133	0	0	133
8186	0	0	2	129	0	131
8187	0	0	1	129	0	130
8188	0	0	0	131	0	131
8189	0	0	138	2	0	140
8190	0	1	1	131	0	133
8191	0	0	1	134	0	135
8192	0	0	135	2	0	137
8193	131	0	1	1	0	133
8194	1	0	1	140	0	142
8195	1	0	0	140	0	141
8196	0	143	0	2	0	145
8197	146	1	0	0	0	147
8198	1	1	144	0	0	146
8199	144	0	0	0	0	144
8200	1	0	1	144	0	146
8201	1	0	153	1	0	155
8202	0	0	1	152	0	153
8203	158	0	1	1	0	160
8204	1	0	155	1	0	157
8205	153	0	1	0	0	154
8206	153	0	1	0	0	154
8207	156	0	0	0	0	156
8208	1	155	0	0	0	156
8209	1	1	0	161	0	163
8210	163	1	0	1	0	165
8211	163	0	0	1	0	164
8212	163	0	0	0	0	163
8213	2	0	159	0	0	161
8214	162	0	0	0	0	162
8215	2	0	0	168	0	170
8216	1	0	165	2	0	168
8217	0	0	2	177	0	179
8218	0	0	1	174	0	175
8219	0	0	187	3	0	190
8220	0	0	2	188	0	190
8221	0	0	1	192	0	193
8222	0	0	210	3	0	213
8223	222	1	3	1	0	227
8224	235	0	1	0	0	236
8225	4	0	0	242	0	246
8226	0	0	242	3	0	245
8227	0	0	3	237	0	240
8228	0	224	1	2	0	227
8229	0	3	0	231	0	234
8230	1	1	0	230	0	232
8231	229	0	1	5	0	235
8232	228	0	1	1	0	230
8233	229	1	0	1	0	231
8234	4	0	0	227	0	231
8235	1	0	0	233	0	234
8236	0	0	232	5	0	237
8237	1	1	3	222	0	227
8238	1	221	1	5	0	228
8239	227	3	0	1	0	231
8240	2	220	0	3	0	225
8241	227	2	0	1	0	230
8242	4	1	1	223	0	229
8243	1	224	0	3	0	228
8244	226	3	0	1	0	230
8245	227	1	0	1	0	229
8246	4	1	0	218	0	223
8247	2	222	0	3	0	227
8248	0	3	0	222	0	225
8249	0	2	221	3	0	226
8250	217	0	2	1	0	220
8251	4	214	1	1	0	220
8252	207	2	0	1	0	210
8253	3	2	0	206	0	211
8254	208	0	0	4	0	212
8255	3	0	217	1	0	221
8256	221	0	4	0	0	225
8257	228	1	1	0	0	230
8258	5	0	227	0	0	232
8259	1	0	3	226	0	230
8260	2	0	2	223	0	227
8261	220	0	0	6	0	226
8262	4	213	1	6	0	224
8263	2	3	0	219	0	224
8264	0	2	218	5	0	225
8265	1	1	213	3	0	218
8266	1	212	4	3	0	220
8267	3	2	215	2	0	222
8268	214	2	3	2	0	221
8269	6	0	1	212	0	219
8270	214	0	2	5	0	221
8271	3	0	212	4	0	219
8272	0	2	5	213	0	220
8273	2	1	2	213	0	218
8274	2	2	204	4	0	212
8275	2	1	3	204	0	210
8276	200	1	1	4	0	206
8277	201	2	1	0	0	204
8278	5	0	0	204	0	209
8279	199	1	0	6	0	206
8280	204	1	2	2	0	209
8281	7	200	0	1	0	208
8282	4	2	0	198	0	204
8283	196	1	1	4	0	202
8284	3	1	1	199	0	204
8285	195	1	1	4	0	201
8286	5	1	2	191	0	199
8287	1	1	193	5	0	200
8288	2	191	3	2	0	198
8289	4	1	1	178	0	184
8290	3	186	0	2	0	191
8291	188	2	1	0	0	191
8292	3	182	2	3	0	190
8293	2	185	0	3	0	190
8294	2	2	2	180	0	186
8295	181	2	1	6	0	190
8296	2	3	0	182	0	187
8297	180	1	0	4	0	185
8298	181	2	0	2	0	185
8299	3	178	2	1	0	184
8300	181	3	1	3	0	188
8301	174	2	3	0	0	179
8302	177	1	1	1	0	180
8303	4	1	165	2	0	172
8304	4	0	3	167	0	174
8305	1	2	2	169	0	174
8306	3	0	159	5	0	167
8307	167	0	3	1	0	171
8308	169	0	3	1	0	173
8309	162	1	1	4	0	168
8310	162	0	0	3	0	165
8311	4	156	1	3	0	164
8312	157	2	0	2	0	161
8313	6	0	1	155	0	162
8314	4	0	149	2	0	155
8315	149	1	1	1	0	152
8316	4	146	0	1	0	151
8317	131	3	1	0	0	135
8318	2	131	0	3	0	136
8319	3	111	0	2	0	116
8320	1	110	0	2	0	113
8321	4	106	2	2	0	114
8322	2	2	90	0	0	94
8323	1	7	2	67	0	77
8324	0	1	62	1	0	64
8325	47	0	0	1	0	48
8326	0	48	0	0	0	48
8327	0	49	0	0	0	49
8328	0	0	0	49	0	49
8329	0	0	1	48	0	49
8330	0	0	50	0	0	50
8331	0	1	49	0	0	50
8332	0	0	1	49	0	50
8333	1	0	49	0	0	50
8334	0	50	0	1	0	51
8335	1	0	0	50	0	51
8336	0	0	1	52	0	53
8337	0	0	52	1	0	53
8338	0	0	0	53	0	53
8339	51	0	1	1	0	53
8340	0	0	0	53	0	53
8341	1	0	0	51	0	52
8342	1	0	49	1	0	51
8343	52	0	0	1	0	53
8344	1	50	0	0	0	51
8345	1	0	0	51	0	52
8346	0	1	51	0	0	52
8347	0	0	0	51	0	51
8348	52	0	0	0	0	52
8349	0	0	51	1	0	52
8350	1	0	0	49	0	50
8351	0	0	51	1	0	52
8352	0	50	1	0	0	51
8353	0	1	51	0	0	52
8354	0	50	0	0	0	50
8355	0	0	41	0	0	41
8356	0	1	0	37	0	38
8357	0	34	0	0	0	34
8358	31	0	0	0	0	31
8359	0	0	0	31	0	31
8360	31	0	0	0	0	31
8361	0	0	0	33	0	33
8362	0	0	0	33	0	33
8363	31	0	0	0	0	31
8364	32	0	0	0	0	32
8365	0	0	0	33	0	33
8366	0	0	35	0	0	35
8367	0	34	0	0	0	34
8368	0	0	35	0	0	35
8369	0	35	0	0	0	35
8370	30	0	0	0	0	30
8371	0	0	30	0	0	30
8372	0	0	30	0	0	30
8373	0	0	0	30	0	30
8374	29	0	0	0	0	29
8375	0	0	29	0	0	29
8376	0	31	0	0	0	31
8377	31	0	0	0	0	31
8378	29	0	0	0	0	29
8379	30	0	0	0	0	30
8380	30	0	0	0	0	30
8381	30	0	0	0	0	30
8382	0	0	31	0	0	31
8383	0	0	0	30	0	30
8384	0	31	0	0	0	31
8385	30	0	0	1	0	31
8386	0	31	0	0	0	31
8387	31	0	0	0	0	31
8388	31	0	0	0	0	31
8389	0	30	0	0	0	30
8390	31	0	0	0	0	31
8391	0	0	0	31	0	31
8392	0	0	0	31	0	31
8393	0	0	31	0	0	31
8394	0	32	0	0	0	32
8395	0	0	0	32	0	32
8396	0	0	0	32	0	32
8397	0	0	0	32	0	32
8398	0	0	32	0	0	32
8399	30	0	0	0	0	30
8400	0	0	0	33	0	33
8401	33	0	0	0	0	33
8402	0	0	0	34	0	34
8403	0	0	34	0	0	34
8404	0	0	37	0	0	37
8405	36	0	0	0	0	36
8406	37	0	0	0	0	37
8407	0	37	0	0	0	37
8408	0	0	38	0	0	38
8409	0	0	0	37	0	37
8410	0	0	0	30	0	30
8411	37	0	0	0	0	37
8412	38	0	0	0	0	38
8413	37	0	0	0	0	37
8414	0	0	39	0	0	39
8415	39	0	0	0	0	39
8416	0	0	0	39	0	39
8417	0	0	0	39	0	39
8418	0	0	0	38	0	38
8419	0	38	0	0	0	38
8420	37	0	0	0	0	37
8421	0	0	0	37	0	37
8422	0	0	38	0	0	38
8423	1	0	0	37	0	38
8424	0	38	0	0	0	38
8425	38	0	0	0	0	38
8426	0	0	0	37	0	37
8427	0	0	0	37	0	37
8428	0	0	38	0	0	38
8429	0	0	0	38	0	38
8430	0	36	0	0	0	36
8431	0	0	0	38	0	38
8432	0	0	38	0	0	38
8433	36	0	0	0	0	36
8434	35	0	0	0	0	35
8435	0	35	0	1	0	36
8436	34	0	0	0	0	34
8437	34	0	0	0	0	34
8438	0	34	0	0	0	34
8439	0	0	0	34	0	34
8440	34	0	0	0	0	34
8441	0	34	0	0	0	34
8442	0	0	34	0	0	34
8443	33	0	0	0	0	33
8444	35	0	0	0	0	35
8445	35	0	0	0	0	35
8446	38	0	0	0	0	38
8447	0	38	0	0	0	38
8448	40	0	0	0	0	40
8449	41	0	0	0	0	41
8450	42	0	0	0	0	42
8451	0	0	0	41	0	41
8452	41	0	0	0	0	41
8453	0	42	0	0	0	42
8454	0	0	47	0	0	47
8455	0	0	0	52	0	52
8456	52	0	0	0	0	52
8457	0	0	51	0	0	51
8458	0	0	0	53	0	53
8459	0	0	55	0	0	55
8460	0	56	0	0	0	56
8461	0	0	0	54	0	54
8462	0	0	53	0	0	53
8463	0	53	0	0	0	53
8464	0	0	0	53	0	53
8465	55	0	0	0	0	55
8466	54	0	0	0	0	54
8467	55	0	0	0	0	55
8468	54	0	0	0	0	54
8469	55	0	0	0	0	55
8470	0	0	53	0	0	53
8471	55	0	0	0	0	55
8472	56	0	0	0	0	56
8473	0	0	0	57	0	57
8474	57	0	0	0	0	57
8475	56	0	0	0	0	56
8476	0	54	0	0	0	54
8477	0	0	0	55	0	55
8478	0	0	0	55	0	55
8479	58	0	0	0	0	58
8480	0	56	0	0	0	56
8481	0	59	0	0	0	59
8482	0	0	0	60	0	60
8483	0	0	0	61	0	61
8484	0	0	0	59	0	59
8485	0	0	0	61	0	61
8486	59	0	0	0	0	59
8487	56	0	0	0	0	56
8488	0	0	61	0	0	61
8489	0	0	0	59	0	59
8490	0	0	0	61	0	61
8491	0	0	60	1	0	61
8492	59	0	0	0	0	59
8493	0	60	0	0	0	60
8494	60	0	0	0	0	60
8495	0	0	0	58	0	58
8496	0	0	58	0	0	58
8497	0	0	0	58	0	58
8498	0	0	60	0	0	60
8499	0	61	0	0	0	61
8500	58	0	0	0	0	58
8501	56	0	1	1	0	58
8502	0	57	0	0	0	57
8503	0	0	0	57	0	57
8504	55	0	0	0	0	55
8505	0	53	0	1	0	54
8506	0	0	0	56	0	56
8507	56	1	0	0	0	57
8508	0	0	55	0	0	55
8509	54	0	0	0	0	54
8510	0	51	0	0	0	51
8511	54	0	0	0	0	54
8512	53	0	0	0	0	53
8513	0	0	53	0	0	53
8514	0	0	0	50	0	50
8515	1	0	0	50	0	51
8516	0	0	52	0	0	52
8517	1	0	0	50	0	51
8518	0	0	0	52	0	52
8519	53	0	0	0	0	53
8520	50	0	0	0	0	50
8521	0	0	0	52	0	52
8522	0	0	52	1	0	53
8523	1	0	0	53	0	54
8524	0	0	0	54	0	54
8525	0	0	55	0	0	55
8526	0	0	0	53	0	53
8527	56	0	0	0	0	56
8528	55	0	0	0	0	55
8529	0	54	0	0	0	54
8530	54	0	0	0	0	54
8531	54	0	0	0	0	54
8532	0	55	0	0	0	55
8533	57	0	0	0	0	57
8534	58	0	0	0	0	58
8535	61	0	0	0	0	61
8536	0	0	57	0	0	57
8537	59	0	0	0	0	59
8538	0	0	0	59	0	59
8539	62	0	0	0	0	62
8540	0	0	61	0	0	61
8541	0	61	0	0	0	61
8542	62	0	0	0	0	62
8543	0	68	0	0	0	68
8544	0	0	0	67	0	67
8545	0	0	0	68	0	68
8546	66	0	0	0	0	66
8547	64	0	0	0	0	64
8548	0	0	63	0	0	63
8549	0	0	53	0	0	53
8550	0	0	57	0	0	57
8551	0	0	0	60	0	60
8552	0	0	58	0	0	58
8553	0	0	59	0	0	59
8554	3	1	0	48	0	52
8555	49	0	0	0	0	49
8556	50	0	0	0	0	50
8557	51	0	0	0	0	51
8558	52	0	0	0	0	52
8559	0	0	0	51	0	51
8560	0	0	0	50	0	50
8561	0	0	53	0	0	53
8562	0	0	0	53	0	53
8563	0	1	0	53	0	54
8564	53	0	0	1	0	54
8565	53	0	0	0	0	53
8566	0	0	0	53	0	53
8567	53	0	0	0	0	53
8568	54	0	0	0	0	54
8569	0	0	0	58	0	58
8570	0	0	0	58	0	58
8571	0	0	57	1	0	58
8572	0	0	54	1	0	55
8573	0	0	1	51	0	52
8574	0	0	1	57	0	58
8575	0	0	57	1	0	58
8576	57	0	0	1	0	58
8577	53	0	1	1	0	55
8578	1	0	56	0	0	57
8579	1	57	0	0	0	58
8580	53	0	1	0	0	54
8581	0	1	61	0	0	62
8582	1	0	0	60	0	61
8583	0	0	1	60	0	61
8584	61	0	0	1	0	62
8585	61	0	0	1	0	62
8586	1	0	0	62	0	63
8587	1	0	0	64	0	65
8588	68	0	0	1	0	69
8589	66	0	0	1	0	67
8590	68	0	0	0	0	68
8591	1	0	70	0	0	71
8592	1	0	0	68	0	69
8593	0	0	1	69	0	70
8594	70	0	0	1	0	71
8595	0	68	0	1	0	69
8596	74	0	0	0	0	74
8597	0	77	0	0	0	77
8598	1	0	0	81	0	82
8599	0	1	0	82	0	83
8600	0	0	81	1	0	82
8601	0	0	0	82	0	82
8602	0	0	84	0	0	84
8603	0	0	0	84	0	84
8604	1	0	1	83	0	85
8605	0	83	0	2	0	85
8606	0	83	0	2	0	85
8607	1	1	0	80	0	82
8608	1	1	0	82	0	84
8609	1	0	0	84	0	85
8610	0	0	1	86	0	87
8611	0	0	0	88	0	88
8612	0	0	84	2	0	86
8613	1	0	0	87	0	88
8614	1	1	1	85	0	88
8615	1	0	85	1	0	87
8616	0	85	0	0	0	85
8617	0	0	1	85	0	86
8618	0	1	85	1	0	87
8619	0	86	1	1	0	88
8620	0	0	1	87	0	88
8621	89	1	1	1	0	92
8622	1	0	0	91	0	92
8623	2	0	0	89	0	91
8624	0	1	0	91	0	92
8625	1	1	0	88	0	90
8626	1	85	0	2	0	88
8627	0	0	0	90	0	90
8628	93	1	1	1	0	96
8629	0	0	0	97	0	97
8630	1	0	0	97	0	98
8631	1	0	1	94	0	96
8632	92	1	0	2	0	95
8633	93	0	0	2	0	95
8634	1	0	1	92	0	94
8635	90	1	0	1	0	92
8636	89	0	0	3	0	92
8637	1	91	2	0	0	94
8638	92	1	0	1	0	94
8639	0	93	0	1	0	94
8640	2	93	0	1	0	96
8641	1	1	0	95	0	97
8642	0	2	102	1	0	105
8643	0	1	0	100	0	101
8644	0	0	1	98	0	99
8645	0	94	0	2	0	96
8646	97	0	0	4	0	101
8647	1	1	0	99	0	101
8648	1	0	106	2	0	109
8649	0	0	0	107	0	107
8650	0	111	1	3	0	115
8651	111	1	0	2	0	114
8652	2	1	1	111	0	115
8653	1	2	112	2	0	117
8654	1	0	1	117	0	119
8655	1	112	2	1	0	116
8656	1	3	0	112	0	116
8657	118	1	0	2	0	121
8658	122	0	0	1	0	123
8659	122	0	0	1	0	123
8660	3	121	0	1	0	125
8661	122	2	0	1	0	125
8662	2	1	0	124	0	127
8663	121	1	0	2	0	124
8664	2	122	0	2	0	126
8665	2	2	0	125	0	129
8666	0	1	135	3	0	139
8667	131	0	2	2	0	135
8668	2	131	1	1	0	135
8669	1	2	0	130	0	133
8670	0	0	0	133	0	133
8671	1	1	0	132	0	134
8672	0	1	0	135	0	136
8673	0	130	0	2	0	132
8674	132	2	0	1	0	135
8675	131	0	0	2	0	133
8676	2	1	134	1	0	138
8677	0	0	2	135	0	137
8678	1	0	137	2	0	140
8679	136	0	3	1	0	140
8680	140	0	0	1	0	141
8681	133	0	1	1	0	135
8682	2	2	0	131	0	135
8683	1	131	0	3	0	135
8684	133	2	1	1	0	137
8685	2	0	1	136	0	139
8686	135	0	0	3	0	138
8687	3	1	134	0	0	138
8688	0	0	130	0	0	130
8689	134	0	2	1	0	137
8690	2	0	0	137	0	139
8691	131	0	0	3	0	134
8692	2	134	0	0	0	136
8693	136	2	0	1	0	139
8694	138	0	0	0	0	138
8695	2	0	135	1	0	138
8696	0	0	136	1	0	137
8697	0	131	1	1	0	133
8698	1	2	1	126	0	130
8699	126	0	0	2	0	128
8700	2	0	0	125	0	127
8701	0	0	0	129	0	129
8702	1	0	127	2	0	130
8703	122	0	2	0	0	124
8704	2	0	0	127	0	129
8705	0	0	127	2	0	129
8706	0	0	126	0	0	126
8707	0	0	2	126	0	128
8708	0	0	122	2	0	124
8709	2	0	126	0	0	128
8710	0	0	2	124	0	126
8711	0	0	131	2	0	133
8712	0	0	2	129	0	131
8713	0	128	0	2	0	130
8714	134	2	0	0	0	136
8715	2	133	0	0	0	135
8716	0	2	0	135	0	137
8717	0	134	0	2	0	136
8718	0	2	144	0	0	146
8719	0	0	2	162	0	164
8720	0	0	188	3	0	191
8721	183	0	4	1	0	188
8722	4	201	1	0	0	206
8723	201	4	1	1	0	207
8724	4	1	0	205	0	210
8725	203	0	1	4	0	208
8726	5	1	200	1	0	207
8727	1	201	4	0	0	206
8728	196	4	1	0	0	201
8729	3	1	0	197	0	201
8730	2	194	0	2	0	198
8731	0	4	1	197	0	202
8732	198	2	0	4	0	204
8733	4	204	0	1	0	209
8734	203	4	0	1	0	208
8735	4	3	202	0	0	209
8736	201	0	4	1	0	206
8737	5	0	1	203	0	209
8738	202	1	0	4	0	207
8739	5	198	0	1	0	204
8740	1	4	1	200	0	206
8741	1	1	0	203	0	205
8742	1	0	190	6	0	197
8743	1	0	4	189	0	194
8744	1	1	1	193	0	196
8745	1	0	1	196	0	198
8746	0	0	1	198	0	199
8747	1	0	190	5	0	196
8748	0	184	3	3	0	190
8749	1	2	1	183	0	187
8750	176	2	0	4	0	182
8751	181	0	0	2	0	183
8752	4	182	1	0	0	187
8753	179	4	1	0	0	184
8754	179	0	1	1	0	181
8755	178	1	0	0	0	179
8756	5	174	0	1	0	180
8757	172	3	0	0	0	175
8758	3	1	0	166	0	170
8759	2	0	164	3	0	169
8760	1	164	3	0	0	168
8761	1	4	2	161	0	168
8762	1	1	160	3	0	165
8763	157	0	3	2	0	162
8764	3	0	2	159	0	164
8765	2	1	0	158	0	161
8766	0	0	1	156	0	157
8767	1	0	2	152	0	155
8768	1	0	147	4	0	152
8769	147	0	3	2	0	152
8770	2	150	1	2	0	155
8771	149	3	1	1	0	154
8772	4	150	0	1	0	155
8773	150	4	1	0	0	155
8774	4	0	0	150	0	154
8775	1	2	146	3	0	152
8776	2	0	148	1	0	151
8777	0	1	3	142	0	146
8778	1	1	2	139	0	143
8779	2	0	0	145	0	147
8780	141	1	1	4	0	147
8781	2	1	142	1	0	146
8782	1	135	2	6	0	144
8783	2	144	1	1	0	148
8784	139	3	0	1	0	143
8785	4	1	138	0	0	143
8786	1	138	4	0	0	143
8787	1	3	135	0	0	139
8788	0	2	2	132	0	136
8789	2	0	132	2	0	136
8790	0	1	133	1	0	135
8791	0	1	3	131	0	135
8792	0	0	132	3	0	135
8793	0	0	129	2	0	131
8794	0	0	4	128	0	132
8795	129	0	2	3	0	134
8796	2	0	125	2	0	129
8797	1	0	3	128	0	132
8798	0	0	3	127	0	130
8799	126	0	0	4	0	130
8800	3	0	0	128	0	131
8801	125	0	1	2	0	128
8802	3	122	0	2	0	127
8803	1	3	0	124	0	128
8804	125	1	0	2	0	128
8805	124	0	0	2	0	126
8806	5	0	0	121	0	126
8807	1	1	117	2	0	121
8808	119	0	2	2	0	123
8809	2	119	1	1	0	123
8810	110	2	1	0	0	113
8811	116	1	0	1	0	118
8812	117	0	0	1	0	118
8813	3	0	116	0	0	119
8814	2	115	2	0	0	119
8815	1	2	1	114	0	118
8816	1	3	0	114	0	118
8817	0	0	111	4	0	115
8818	0	99	2	1	0	102
8819	0	79	2	0	0	81
8820	0	54	0	0	0	54
8821	44	0	5	0	0	49
8822	1	0	0	39	0	40
8823	0	0	0	37	0	37
8824	0	0	38	0	0	38
8825	39	0	0	0	0	39
8826	0	0	0	39	0	39
8827	1	0	0	37	0	38
8828	0	0	38	0	0	38
8829	0	38	0	0	0	38
8830	0	0	0	39	0	39
8831	0	0	39	0	0	39
8832	0	34	0	0	0	34
8833	30	0	0	0	0	30
8834	0	0	33	0	0	33
8835	0	0	0	30	0	30
8836	0	29	0	0	0	29
8837	29	0	0	0	0	29
8838	0	0	0	30	0	30
8839	30	0	0	0	0	30
8840	31	0	0	0	0	31
8841	0	31	0	0	0	31
8842	30	0	0	1	0	31
8843	35	0	0	0	0	35
8844	0	0	34	0	0	34
8845	33	0	0	0	0	33
8846	0	0	32	0	0	32
8847	32	0	0	0	0	32
8848	34	0	0	0	0	34
8849	0	0	34	0	0	34
8850	0	0	0	34	0	34
8851	0	0	33	0	0	33
8852	0	0	31	0	0	31
8853	0	0	37	0	0	37
8854	0	0	0	37	0	37
8855	0	0	0	42	0	42
8856	0	0	0	42	0	42
8857	0	0	0	45	0	45
8858	0	0	49	0	0	49
8859	0	0	0	49	0	49
8860	0	46	0	0	0	46
8861	0	0	52	0	0	52
8862	0	0	0	53	0	53
8863	0	0	54	0	0	54
8864	0	55	0	0	0	55
8865	0	55	0	0	0	55
8866	0	0	0	54	0	54
8867	0	0	54	0	0	54
8868	0	0	49	0	0	49
8869	0	0	0	55	0	55
8870	0	0	0	56	0	56
8871	0	0	0	55	0	55
8872	0	0	56	0	0	56
8873	0	57	0	0	0	57
8874	0	58	0	0	0	58
8875	0	0	0	57	0	57
8876	0	0	57	0	0	57
8877	0	0	56	0	0	56
8878	0	56	0	0	0	56
8879	57	0	0	0	0	57
8880	0	55	0	0	0	55
8881	0	0	56	0	0	56
8882	55	0	0	0	0	55
8883	0	0	0	58	0	58
8884	59	0	0	0	0	59
8885	0	0	0	59	0	59
8886	0	0	0	61	0	61
8887	63	0	0	0	0	63
8888	1	63	0	0	0	64
8889	0	1	61	0	0	62
8890	0	60	1	0	0	61
8891	62	0	0	0	0	62
8892	1	62	0	0	0	63
8893	60	1	0	0	0	61
8894	63	0	0	0	0	63
8895	1	60	0	0	0	61
8896	0	1	0	60	0	61
8897	60	0	0	1	0	61
8898	60	0	0	0	0	60
8899	1	0	0	60	0	61
8900	0	0	60	1	0	61
8901	0	0	61	0	0	61
8902	0	0	1	60	0	61
8903	0	0	61	1	0	62
8904	62	0	1	0	0	63
8905	1	57	0	0	0	58
8906	0	1	0	64	0	65
8907	0	0	0	65	0	65
8908	0	0	0	65	0	65
8909	0	0	0	61	0	61
8910	0	0	0	64	0	64
8911	0	0	65	1	0	66
8912	0	63	1	0	0	64
8913	65	1	0	0	0	66
8914	1	0	0	61	0	62
8915	0	0	0	63	0	63
8916	0	0	0	62	0	62
8917	0	62	0	1	0	63
8918	0	0	0	64	0	64
8919	0	0	0	65	0	65
8920	64	0	0	1	0	65
8921	1	61	0	0	0	62
8922	0	64	0	0	0	64
8923	0	1	0	63	0	64
8924	61	0	0	1	0	62
8925	1	0	64	0	0	65
8926	60	0	1	0	0	61
8927	1	0	64	0	0	65
8928	0	0	1	64	0	65
8929	0	0	0	69	0	69
8930	0	0	0	67	0	67
8931	0	0	0	67	0	67
8932	0	0	0	67	0	67
8933	67	0	0	1	0	68
8934	1	0	62	0	0	63
8935	0	0	0	63	0	63
8936	0	0	63	1	0	64
8937	0	65	1	0	0	66
8938	63	0	0	0	0	63
8939	1	0	67	0	0	68
8940	0	0	1	69	0	70
8941	0	0	0	74	0	74
8942	0	0	74	1	0	75
8943	0	0	74	0	0	74
8944	1	0	1	69	0	71
8945	73	0	0	1	0	74
8946	74	0	0	0	0	74
8947	1	72	0	0	0	73
8948	71	1	0	0	0	72
8949	1	0	0	70	0	71
8950	0	74	0	1	0	75
8951	0	1	0	77	0	78
8952	0	0	79	1	0	80
8953	0	0	1	72	0	73
8954	0	0	0	75	0	75
8955	71	0	0	1	0	72
8956	1	71	0	0	0	72
8957	68	1	0	0	0	69
8958	0	65	0	0	0	65
8959	63	1	0	0	0	64
8960	0	62	0	0	0	62
8961	0	63	0	0	0	63
8962	66	0	0	0	0	66
8963	1	0	0	65	0	66
8964	0	65	0	1	0	66
8965	68	0	0	0	0	68
8966	70	0	0	0	0	70
8967	70	0	0	0	0	70
8968	67	0	0	0	0	67
8969	1	66	0	0	0	67
8970	0	0	0	67	0	67
8971	0	0	0	69	0	69
8972	71	0	0	1	0	72
8973	1	0	0	70	0	71
8974	70	0	0	1	0	71
8975	1	0	68	0	0	69
8976	69	0	1	0	0	70
8977	1	0	70	0	0	71
8978	0	0	1	70	0	71
8979	68	0	0	1	0	69
8980	1	70	0	0	0	71
8981	68	1	0	0	0	69
8982	1	68	0	0	0	69
8983	0	1	0	70	0	71
8984	0	0	67	0	0	67
8985	66	0	1	0	0	67
8986	0	70	0	0	0	70
8987	0	0	0	67	0	67
8988	0	0	0	68	0	68
8989	0	0	0	68	0	68
8990	0	0	70	0	0	70
8991	0	68	0	0	0	68
8992	69	0	0	0	0	69
8993	66	0	0	0	0	66
8994	0	67	0	0	0	67
8995	72	0	0	0	0	72
8996	0	0	0	72	0	72
8997	0	71	0	0	0	71
8998	71	0	0	0	0	71
8999	0	0	71	0	0	71
9000	0	73	0	0	0	73
9001	0	0	0	70	0	70
9002	0	0	0	72	0	72
9003	0	0	72	0	0	72
9004	0	0	0	70	0	70
9005	0	0	71	0	0	71
9006	0	0	0	66	0	66
9007	0	0	0	70	0	70
9008	0	0	0	70	0	70
9009	1	0	0	68	0	69
9010	0	0	68	0	0	68
9011	0	0	74	1	0	75
9012	0	80	0	0	0	80
9013	0	0	0	87	0	87
9014	0	0	96	1	0	97
9015	0	97	1	0	0	98
9016	0	1	0	99	0	100
9017	0	0	111	1	0	112
9018	106	0	1	0	0	107
9019	114	0	0	0	0	114
9020	1	0	0	112	0	113
9021	0	0	112	1	0	113
9022	0	0	1	111	0	112
9023	112	0	0	1	0	113
9024	1	113	0	0	0	114
9025	115	0	0	0	0	115
9026	116	0	0	0	0	116
9027	1	0	0	116	0	117
9028	0	0	0	117	0	117
9029	0	0	0	115	0	115
9030	0	0	0	112	0	112
9031	0	0	0	112	0	112
9032	112	0	0	0	0	112
9033	114	0	0	0	0	114
9034	112	0	0	0	0	112
9035	1	0	110	0	0	111
9036	112	0	1	0	0	113
9037	1	0	0	112	0	113
9038	0	0	113	1	0	114
9039	0	111	1	0	0	112
9040	0	1	0	110	0	111
9041	0	0	0	109	0	109
9042	0	105	0	1	0	106
9043	0	0	0	109	0	109
9044	0	0	108	1	0	109
9045	0	0	110	0	0	110
9046	0	0	1	110	0	111
9047	111	0	0	1	0	112
9048	111	0	0	0	0	111
9049	1	0	110	0	0	111
9050	0	107	0	0	0	107
9051	0	108	0	0	0	108
9052	105	1	0	0	0	106
9053	1	0	110	0	0	111
9054	0	0	1	109	0	110
9055	110	0	0	1	0	111
9056	1	109	0	0	0	110
9057	0	111	0	0	0	111
9058	111	1	0	0	0	112
9059	1	0	0	111	0	112
9060	111	0	0	1	0	112
9061	1	0	0	121	0	122
9062	0	0	0	116	0	116
9063	0	0	116	2	0	118
9064	0	0	1	118	0	119
9065	0	0	1	120	0	121
9066	117	0	0	3	0	120
9067	2	0	0	121	0	123
9068	1	0	119	2	0	122
9069	120	0	1	1	0	122
9070	2	0	1	119	0	122
9071	118	0	0	2	0	120
9072	2	114	0	1	0	117
9073	1	115	0	0	0	116
9074	116	3	0	0	0	119
9075	116	1	0	0	0	117
9076	3	0	0	114	0	117
9077	1	0	115	2	0	118
9078	0	0	1	115	0	116
9079	117	0	1	2	0	120
9080	2	116	0	1	0	119
9081	1	0	0	116	0	117
9082	113	1	0	2	0	116
9083	2	0	113	1	0	116
9084	117	0	2	0	0	119
9085	111	0	1	0	0	112
9086	3	0	113	0	0	116
9087	1	0	111	0	0	112
9088	1	0	2	109	0	112
9089	0	0	1	115	0	116
9090	0	119	0	3	0	122
9091	0	2	0	121	0	123
9092	0	1	123	2	0	126
9093	0	0	2	121	0	123
9094	0	0	1	127	0	128
9095	0	0	121	2	0	123
9096	0	122	1	1	0	124
9097	1	2	1	123	0	127
9098	0	1	0	127	0	128
9099	126	0	0	3	0	129
9100	2	1	0	127	0	130
9101	1	2	123	2	0	128
9102	123	0	2	2	0	127
9103	128	0	1	0	0	129
9104	128	0	0	2	0	130
9105	3	0	125	0	0	128
9106	1	0	2	126	0	129
9107	1	0	1	127	0	129
9108	0	1	0	129	0	130
9109	123	0	0	4	0	127
9110	3	125	0	1	0	129
9111	1	2	113	0	0	116
9112	1	110	2	0	0	113
9113	1	100	1	0	0	102
9114	0	98	1	0	0	99
9115	0	3	1	98	0	102
9116	0	1	96	2	0	99
9117	81	0	1	2	0	84
9118	1	82	1	0	0	84
9119	81	1	0	2	0	84
9120	1	88	0	0	0	89
9121	88	1	0	1	0	90
9122	1	95	0	1	0	97
9123	1	1	95	0	0	97
9124	0	2	1	95	0	98
9125	0	0	1	103	0	104
9126	101	0	0	3	0	104
9127	2	0	0	109	0	111
9128	1	0	108	2	0	111
9129	0	0	2	108	0	110
9130	1	0	108	1	0	110
9131	1	105	1	1	0	108
9132	1	1	1	106	0	109
9133	0	105	1	2	0	108
9134	104	1	0	3	0	108
9135	1	1	0	107	0	109
9136	1	0	106	2	0	109
9137	1	0	104	1	0	106
9138	101	1	2	0	0	104
9139	1	0	2	105	0	108
9140	1	1	107	1	0	110
9141	0	1	102	1	0	104
9142	0	108	2	0	0	110
9143	0	0	1	102	0	103
9144	0	103	2	0	0	105
9145	0	1	0	103	0	104
9146	104	2	0	1	0	107
9147	2	0	0	104	0	106
9148	1	1	0	105	0	107
9149	107	0	0	2	0	109
9150	1	1	0	108	0	110
9151	1	0	1	107	0	109
9152	0	105	1	3	0	109
9153	105	1	0	2	0	108
9154	104	1	0	0	0	105
9155	2	0	0	104	0	106
9156	1	0	1	102	0	104
9157	0	0	0	104	0	104
9158	0	99	1	3	0	103
9159	0	103	0	1	0	104
9160	0	2	0	100	0	102
9161	90	1	0	1	0	92
9162	91	0	0	0	0	91
9163	1	87	0	1	0	89
9164	86	0	1	0	0	87
9165	0	84	1	0	0	85
9166	1	83	0	0	0	84
9167	0	0	0	82	0	82
9168	81	0	1	0	0	82
9169	0	80	0	0	0	80
9170	0	78	0	0	0	78
9171	0	0	0	80	0	80
9172	1	0	0	79	0	80
9173	0	0	80	0	0	80
9174	80	0	0	0	0	80
9175	78	0	0	0	0	78
9176	0	0	79	0	0	79
9177	0	0	78	0	0	78
9178	0	0	0	80	0	80
9179	0	0	0	78	0	78
9180	0	78	0	0	0	78
9181	0	0	0	81	0	81
9182	0	0	77	0	0	77
9183	0	0	0	76	0	76
9184	0	0	0	75	0	75
9185	77	0	0	0	0	77
9186	0	0	75	0	0	75
9187	75	0	0	0	0	75
9188	0	0	73	0	0	73
9189	0	0	0	72	0	72
9190	0	0	68	0	0	68
9191	0	0	67	1	0	68
9192	0	0	0	65	0	65
9193	65	0	1	0	0	66
9194	62	0	0	2	0	64
9195	0	63	2	0	0	65
9196	60	0	0	2	0	62
9197	59	0	1	1	0	61
9198	1	59	0	0	0	60
9199	0	0	1	60	0	61
9200	1	1	0	62	0	64
9201	1	0	1	62	0	64
9202	0	0	0	64	0	64
9203	0	0	64	0	0	64
9204	61	0	2	0	0	63
9205	1	0	0	61	0	62
9206	1	0	0	61	0	62
9207	1	61	1	0	0	63
9208	0	1	1	61	0	63
9209	1	1	61	0	0	63
9210	62	0	0	0	0	62
9211	0	3	62	0	0	65
9212	0	0	0	65	0	65
9213	63	0	0	1	0	64
9214	0	64	0	2	0	66
9215	1	0	0	65	0	66
9216	1	0	66	1	0	68
9217	1	0	1	66	0	68
9218	65	0	0	3	0	68
9219	1	1	66	1	0	69
9220	1	1	62	0	0	64
9221	0	57	1	1	0	59
9222	51	1	1	0	0	53
9223	2	49	0	1	0	52
9224	0	1	48	0	0	49
9225	0	0	39	1	0	40
9226	1	38	1	0	0	40
9227	30	2	0	0	0	32
9228	1	31	0	1	0	33
9229	0	1	1	31	0	33
9230	0	0	0	33	0	33
9231	1	0	32	1	0	34
9232	0	0	2	32	0	34
9233	0	0	33	1	0	34
9234	31	1	1	0	0	33
9235	33	0	0	1	0	34
9236	32	1	1	0	0	34
9237	1	0	32	1	0	34
9238	30	0	2	0	0	32
9239	1	1	1	29	0	32
9240	1	29	1	1	0	32
9241	26	3	0	0	0	29
9242	2	0	26	1	0	29
9243	28	1	1	1	0	31
9244	29	0	2	0	0	31
9245	1	0	26	1	0	28
9246	0	25	2	0	0	27
9247	2	1	0	25	0	28
9248	1	1	25	1	0	28
9249	1	0	24	1	0	26
9250	0	1	1	24	0	26
9251	1	0	24	1	0	26
9252	0	0	1	26	0	27
9253	0	1	1	25	0	27
9254	2	0	0	25	0	27
9255	1	0	23	1	0	25
9256	2	0	1	25	0	28
9257	1	0	25	1	0	27
9258	1	0	2	25	0	28
9259	25	1	0	2	0	28
9260	1	1	0	23	0	25
9261	1	24	1	1	0	27
9262	0	1	2	25	0	28
9263	26	0	0	2	0	28
9264	2	24	1	0	0	27
9265	0	1	1	26	0	28
9266	25	1	0	1	0	27
9267	1	0	26	2	0	29
9268	0	0	3	27	0	30
9269	0	0	29	2	0	31
9270	0	0	29	1	0	30
9271	0	0	2	29	0	31
9272	29	0	0	2	0	31
9273	1	0	28	2	0	31
9274	28	1	1	1	0	31
9275	1	0	1	29	0	31
9276	1	0	30	2	0	33
9277	0	1	31	0	0	32
9278	0	0	28	2	0	30
9279	2	0	0	25	0	27
9280	25	0	1	1	0	27
9281	1	26	0	0	0	27
9282	0	0	0	26	0	26
9283	0	0	0	25	0	25
9284	25	1	0	1	0	27
9285	26	0	0	1	0	27
9286	1	25	0	0	0	26
9287	25	1	1	0	0	27
9288	25	0	0	1	0	26
9289	1	0	1	25	0	27
9290	0	0	25	1	0	26
9291	25	0	1	1	0	27
9292	2	0	0	25	0	27
9293	0	0	1	26	0	27
9294	28	0	0	1	0	29
9295	1	0	0	27	0	28
9296	0	0	1	28	0	29
9297	27	0	1	1	0	29
9298	1	27	1	0	0	29
9299	27	1	0	1	0	29
9300	2	0	25	0	0	27
9301	23	1	1	0	0	25
9302	1	0	0	26	0	27
9303	0	26	0	2	0	28
9304	1	0	0	26	0	27
9305	1	0	0	27	0	28
9306	0	1	0	26	0	27
9307	28	0	0	1	0	29
9308	2	27	0	0	0	29
9309	0	24	0	0	0	24
9310	23	1	0	0	0	24
9311	2	0	22	0	0	24
9312	0	0	24	1	0	25
9313	23	0	1	1	0	25
9314	2	0	24	0	0	26
9315	0	0	0	21	0	21
9316	0	0	0	21	0	21
9317	0	0	0	22	0	22
9318	0	0	0	22	0	22
9319	0	22	0	0	0	22
9320	0	0	0	23	0	23
9321	0	0	23	0	0	23
9322	0	0	0	23	0	23
9323	0	0	24	0	0	24
9324	0	0	23	0	0	23
9325	0	0	0	24	0	24
9326	0	0	24	0	0	24
9327	0	0	0	24	0	24
9328	24	0	0	0	0	24
9329	0	0	24	0	0	24
9330	24	0	0	0	0	24
9331	0	0	0	23	0	23
9332	0	0	23	0	0	23
9333	0	24	0	0	0	24
9334	0	0	0	25	0	25
9335	0	0	27	0	0	27
9336	0	0	0	25	0	25
9337	28	0	0	0	0	28
9338	28	0	0	0	0	28
9339	31	0	0	0	0	31
9340	0	0	0	31	0	31
9341	0	0	0	31	0	31
9342	0	0	0	33	0	33
9343	36	0	0	0	0	36
9344	0	36	0	0	0	36
9345	0	0	0	38	0	38
9346	0	0	0	38	0	38
9347	39	0	0	0	0	39
9348	0	38	0	0	0	38
9349	0	0	0	41	0	41
9350	44	0	0	0	0	44
9351	41	0	0	0	0	41
9352	0	0	0	43	0	43
9353	43	0	0	0	0	43
9354	0	0	0	43	0	43
9355	0	0	48	0	0	48
9356	0	0	0	48	0	48
9357	0	0	0	47	0	47
9358	0	0	0	47	0	47
9359	48	0	0	0	0	48
9360	0	47	0	0	0	47
9361	47	0	0	0	0	47
9362	0	47	0	0	0	47
9363	0	47	0	0	0	47
9364	47	0	0	0	0	47
9365	0	48	0	0	0	48
9366	0	0	0	48	0	48
9367	48	0	0	0	0	48
9368	46	0	0	0	0	46
9369	0	0	0	46	0	46
9370	0	0	0	47	0	47
9371	0	48	0	0	0	48
9372	49	0	0	0	0	49
9373	49	0	0	0	0	49
9374	0	49	0	0	0	49
9375	0	48	0	0	0	48
9376	0	0	0	47	0	47
9377	47	0	0	0	0	47
9378	0	0	0	47	0	47
9379	0	0	0	47	0	47
9380	0	0	50	0	0	50
9381	0	0	48	0	0	48
9382	0	0	0	50	0	50
9383	0	0	49	0	0	49
9384	0	50	0	0	0	50
9385	0	0	0	49	0	49
9386	0	0	0	51	0	51
9387	0	0	0	51	0	51
9388	0	0	50	0	0	50
9389	0	0	51	0	0	51
9390	52	0	0	0	0	52
9391	0	51	0	0	0	51
9392	51	0	0	0	0	51
9393	0	0	0	52	0	52
9394	50	0	0	0	0	50
9395	0	0	0	51	0	51
9396	0	50	0	0	0	50
9397	49	0	0	0	0	49
9398	0	0	49	0	0	49
9399	0	49	0	0	0	49
9400	49	0	0	0	0	49
9401	0	0	0	50	0	50
9402	0	48	0	0	0	48
9403	0	0	0	49	0	49
9404	49	0	0	0	0	49
9405	0	0	0	49	0	49
9406	49	0	0	0	0	49
9407	0	0	48	0	0	48
9408	0	0	0	49	0	49
9409	47	0	0	1	0	48
9410	0	0	48	0	0	48
9411	0	47	0	0	0	47
9412	0	0	0	43	0	43
9413	0	0	45	0	0	45
9414	1	0	42	0	0	43
9415	0	0	0	43	0	43
9416	0	0	42	0	0	42
9417	0	0	42	0	0	42
9418	0	0	0	42	0	42
9419	41	0	0	0	0	41
9420	0	0	0	40	0	40
9421	0	0	0	39	0	39
9422	0	0	40	0	0	40
9423	0	0	0	41	0	41
9424	42	0	0	1	0	43
9425	0	0	42	0	0	42
9426	0	42	1	0	0	43
9427	0	1	0	42	0	43
9428	43	0	0	2	0	45
9429	1	0	0	43	0	44
9430	0	45	0	1	0	46
9431	0	1	46	0	0	47
9432	0	0	0	47	0	47
9433	49	0	0	2	0	51
9434	1	0	53	0	0	54
9435	0	0	0	50	0	50
9436	53	0	0	1	0	54
9437	57	0	0	0	0	57
9438	1	56	0	0	0	57
9439	55	1	0	0	0	56
9440	1	0	0	55	0	56
9441	0	0	55	1	0	56
9442	0	53	1	0	0	54
9443	0	52	0	0	0	52
9444	0	0	0	49	0	49
9445	0	0	0	52	0	52
9446	0	0	52	1	0	53
9447	0	50	1	0	0	51
9448	0	50	0	0	0	50
9449	0	1	2	46	0	49
9450	45	0	0	1	0	46
9451	1	43	0	0	0	44
9452	0	0	0	45	0	45
9453	47	0	0	1	0	48
9454	1	0	0	47	0	48
9455	0	0	0	42	0	42
9456	0	0	0	42	0	42
9457	0	0	0	41	0	41
9458	41	0	0	1	0	42
9459	1	0	0	41	0	42
9460	0	0	40	1	0	41
9461	39	0	1	0	0	40
9462	1	0	41	0	0	42
9463	0	0	44	0	0	44
9464	0	0	0	42	0	42
9465	0	0	0	42	0	42
9466	0	0	0	43	0	43
9467	42	0	0	1	0	43
9468	1	0	42	0	0	43
9469	40	0	1	0	0	41
9470	41	0	0	0	0	41
9471	1	0	42	0	0	43
9472	41	0	0	0	0	41
9473	1	0	41	0	0	42
9474	0	39	1	0	0	40
9475	0	1	0	39	0	40
9476	0	0	0	42	0	42
9477	0	0	0	41	0	41
9478	0	0	0	42	0	42
9479	0	0	40	1	0	41
9480	0	0	40	0	0	40
9481	0	0	1	39	0	40
9482	0	0	42	1	0	43
9483	41	0	1	0	0	42
9484	42	0	0	0	0	42
9485	1	0	0	42	0	43
9486	41	0	0	1	0	42
9487	1	46	0	0	0	47
9488	46	1	0	0	0	47
9489	1	0	46	0	0	47
9490	0	0	1	47	0	48
9491	0	47	0	1	0	48
9492	49	1	0	0	0	50
9493	1	0	0	48	0	49
9494	0	0	48	1	0	49
9495	0	0	1	46	0	47
9496	47	0	0	1	0	48
9497	1	0	48	0	0	49
9498	0	0	1	48	0	49
9499	0	0	0	50	0	50
9500	0	0	50	1	0	51
9501	0	46	1	0	0	47
9502	0	39	0	0	0	39
9503	0	1	0	51	0	52
9504	0	0	0	52	0	52
9505	0	0	0	51	0	51
9506	50	0	0	1	0	51
9507	49	0	0	0	0	49
9508	1	0	0	50	0	51
9509	50	0	0	1	0	51
9510	1	50	0	0	0	51
9511	0	1	0	51	0	52
9512	0	0	0	51	0	51
9513	0	0	0	52	0	52
9514	49	0	0	1	0	50
9515	1	50	0	0	0	51
9516	0	0	0	49	0	49
9517	50	0	0	1	0	51
9518	1	0	0	52	0	53
9519	0	0	0	52	0	52
9520	0	50	0	1	0	51
9521	0	51	0	0	0	51
9522	0	1	0	53	0	54
9523	0	0	0	50	0	50
9524	49	0	0	0	0	49
9525	0	0	1	50	0	51
9526	0	0	47	1	0	48
9527	0	0	0	49	0	49
9528	0	46	1	0	0	47
9529	47	0	0	1	0	48
9530	1	1	0	46	0	48
9531	0	0	0	47	0	47
9532	0	45	0	1	0	46
9533	40	0	0	1	0	41
9534	1	38	0	0	0	39
9535	1	0	0	40	0	41
9536	0	0	40	1	0	41
9537	1	0	0	33	0	34
9538	34	1	0	1	0	36
9539	0	35	0	1	0	36
9540	0	0	0	37	0	37
9541	0	35	0	1	0	36
9542	1	0	0	36	0	37
9543	0	1	36	0	0	37
9544	0	0	0	35	0	35
9545	1	0	0	35	0	36
9546	0	0	0	36	0	36
9547	34	0	0	1	0	35
9548	34	1	0	0	0	35
9549	0	36	0	0	0	36
9550	35	0	0	1	0	36
9551	0	34	0	1	0	35
9552	1	35	0	0	0	36
9553	33	0	0	0	0	33
9554	0	0	32	0	0	32
9555	0	0	0	28	0	28
9556	0	1	0	30	0	31
9557	1	0	0	32	0	33
9558	32	0	0	1	0	33
9559	0	30	0	1	0	31
9560	0	1	0	32	0	33
9561	1	31	0	0	0	32
9562	32	1	0	0	0	33
9563	1	0	0	33	0	34
9564	0	0	1	37	0	38
9565	0	37	0	2	0	39
9566	1	1	0	41	0	43
9567	0	1	0	42	0	43
9568	39	0	0	2	0	41
9569	1	42	0	1	0	44
9570	0	42	0	1	0	43
9571	0	0	1	42	0	43
9572	0	0	40	2	0	42
9573	0	0	43	1	0	44
9574	0	0	1	42	0	43
9575	1	0	41	1	0	43
9576	1	0	1	42	0	44
9577	0	1	0	39	0	40
9578	1	0	0	43	0	44
9579	40	1	0	1	0	42
9580	1	1	0	42	0	44
9581	1	0	0	43	0	44
9582	0	42	1	1	0	44
9583	0	0	0	43	0	43
9584	0	0	39	2	0	41
9585	0	0	1	42	0	43
9586	1	0	0	43	0	44
9587	38	0	0	1	0	39
9588	1	0	0	37	0	38
9589	0	1	0	35	0	36
9590	1	0	0	36	0	37
9591	29	0	0	2	0	31
9592	1	33	0	1	0	35
9593	0	3	0	33	0	36
9594	0	0	0	35	0	35
9595	0	0	32	2	0	34
9596	0	0	1	34	0	35
9597	31	0	0	2	0	33
9598	2	30	0	0	0	32
9599	0	1	0	30	0	31
9600	0	0	0	31	0	31
9601	0	0	30	2	0	32
9602	28	0	1	0	0	29
9603	0	30	0	0	0	30
9604	29	1	0	1	0	31
9605	2	0	0	29	0	31
9606	0	0	0	30	0	30
9607	0	1	0	29	0	30
9608	1	0	0	30	0	31
9609	29	1	0	2	0	32
9610	2	0	0	28	0	30
9611	0	28	0	2	0	30
9612	0	2	1	28	0	31
9613	0	0	0	31	0	31
9614	29	1	1	1	0	32
9615	2	27	1	0	0	30
9616	0	1	0	29	0	30
9617	27	0	1	2	0	30
9618	26	0	0	2	0	28
9619	1	0	0	28	0	29
9620	1	0	25	2	0	28
9621	27	0	1	1	0	29
9622	1	1	0	27	0	29
9623	0	0	27	3	0	30
9624	0	1	1	29	0	31
9625	1	0	0	30	0	31
9626	0	0	1	28	0	29
9627	0	34	0	3	0	37
9628	1	1	0	35	0	37
9629	2	0	0	35	0	37
9630	0	0	0	36	0	36
9631	0	0	1	35	0	36
9632	1	0	0	34	0	35
9633	1	0	0	35	0	36
9634	32	1	0	1	0	34
9635	1	0	31	2	0	34
9636	0	32	1	2	0	35
9637	30	1	1	2	0	34
9638	1	31	0	1	0	33
9639	31	1	0	1	0	33
9640	1	0	0	32	0	33
9641	30	0	0	3	0	33
9642	1	0	0	34	0	35
9643	0	0	1	30	0	31
9644	1	31	0	2	0	34
9645	33	1	0	0	0	34
9646	2	0	36	0	0	38
9647	0	1	1	36	0	38
9648	1	0	35	2	0	38
9649	0	1	34	1	0	36
9650	37	0	1	1	0	39
9651	2	0	0	41	0	43
9652	1	0	41	2	0	44
9653	0	1	43	1	0	45
9654	0	0	1	46	0	47
9655	0	1	0	49	0	50
9656	50	0	0	1	0	51
9657	1	1	1	46	0	49
9658	0	0	52	3	0	55
9659	1	0	2	52	0	55
9660	1	0	1	53	0	55
9661	1	56	0	2	0	59
9662	54	0	1	1	0	56
9663	1	54	1	0	0	56
9664	49	0	1	1	0	51
9665	0	46	0	1	0	47
9666	0	44	0	1	0	45
9667	2	0	0	43	0	45
9668	0	0	0	44	0	44
9669	0	1	1	42	0	44
9670	42	0	0	1	0	43
9671	0	0	41	1	0	42
9672	0	1	0	41	0	42
9673	42	0	0	0	0	42
9674	0	42	0	0	0	42
9675	1	40	0	0	0	41
9676	0	1	0	41	0	42
9677	0	1	0	41	0	42
9678	0	0	0	40	0	40
9679	0	40	0	1	0	41
9680	0	0	0	41	0	41
9681	1	0	39	0	0	40
9682	0	0	38	0	0	38
9683	36	0	0	0	0	36
9684	0	0	0	39	0	39
9685	39	0	0	0	0	39
9686	38	0	0	0	0	38
9687	0	37	0	0	0	37
9688	39	0	0	0	0	39
9689	39	0	0	0	0	39
9690	0	0	0	39	0	39
9691	0	0	0	37	0	37
9692	0	0	42	0	0	42
9693	0	42	0	0	0	42
9694	0	0	0	38	0	38
9695	0	0	0	41	0	41
9696	43	0	0	0	0	43
9697	0	0	0	43	0	43
9698	41	0	0	0	0	41
9699	0	0	0	44	0	44
9700	0	43	0	0	0	43
9701	42	0	0	0	0	42
9702	0	0	0	59	0	59
9703	0	0	0	62	0	62
9704	1	0	0	64	0	65
9705	0	0	62	0	0	62
9706	0	0	0	66	0	66
9707	66	0	0	0	0	66
9708	0	0	0	68	0	68
9709	0	0	0	74	0	74
9710	0	0	0	75	0	75
9711	0	72	0	0	0	72
9712	0	79	0	0	0	79
9713	79	0	0	0	0	79
9714	0	77	0	0	0	77
9715	80	0	0	0	0	80
9716	78	0	0	0	0	78
9717	79	0	0	1	0	80
9718	0	0	80	0	0	80
9719	0	81	1	0	0	82
9720	81	0	0	0	0	81
9721	0	0	0	80	0	80
9722	0	0	0	81	0	81
9723	0	0	0	78	0	78
9724	0	79	0	0	0	79
9725	0	0	0	80	0	80
9726	80	0	0	0	0	80
9727	0	0	0	75	0	75
9728	0	0	0	75	0	75
9729	0	0	75	1	0	76
9730	0	0	72	1	0	73
9731	0	0	1	77	0	78
9732	0	0	0	79	0	79
9733	1	77	0	0	0	78
9734	0	0	0	79	0	79
9735	0	0	0	80	0	80
9736	0	0	0	78	0	78
9737	77	1	0	0	0	78
9738	0	0	77	0	0	77
9739	0	0	0	79	0	79
9740	81	1	0	0	0	82
9741	80	0	0	0	0	80
9742	1	0	0	80	0	81
9743	2	0	0	77	0	79
9744	77	0	0	0	0	77
9745	0	78	0	0	0	78
9746	1	76	0	0	0	77
9747	0	0	0	76	0	76
9748	79	0	0	1	0	80
9749	73	0	0	2	0	75
9750	75	1	0	0	0	76
9751	0	0	76	1	0	77
9752	74	0	0	0	0	74
9753	0	0	70	1	0	71
9754	69	0	0	1	0	70
9755	0	68	1	0	0	69
9756	0	0	71	0	0	71
9757	0	0	0	71	0	71
9758	0	0	68	1	0	69
9759	0	1	0	66	0	67
9760	64	0	0	1	0	65
9761	0	0	65	1	0	66
9762	0	0	0	66	0	66
9763	1	67	0	0	0	68
9764	0	0	1	73	0	74
9765	0	0	0	74	0	74
9766	1	0	0	72	0	73
9767	73	0	0	0	0	73
9768	71	0	0	1	0	72
9769	0	0	0	74	0	74
9770	1	0	73	0	0	74
9771	0	1	68	0	0	69
9772	0	1	0	72	0	73
9773	0	0	74	1	0	75
9774	1	0	0	73	0	74
9775	1	0	0	73	0	74
9776	1	0	0	75	0	76
9777	0	74	0	0	0	74
9778	1	74	0	0	0	75
9779	0	0	1	77	0	78
9780	0	0	0	75	0	75
9781	0	1	0	77	0	78
9782	75	0	1	1	0	77
9783	0	0	83	1	0	84
9784	0	0	0	84	0	84
9785	83	0	0	1	0	84
9786	1	81	0	0	0	82
9787	0	0	1	84	0	85
9788	0	0	0	84	0	84
9789	0	1	0	81	0	82
9790	0	0	0	83	0	83
9791	0	0	83	1	0	84
9792	78	0	0	1	0	79
9793	79	0	0	1	0	80
9794	1	0	80	0	0	81
9795	77	0	0	1	0	78
9796	78	0	1	1	0	80
9797	0	0	81	0	0	81
9798	0	91	0	1	0	92
9799	1	0	1	89	0	91
9800	0	0	94	1	0	95
9801	0	94	0	1	0	95
9802	0	0	78	1	0	79
9803	0	79	0	0	0	79
9804	0	0	0	76	0	76
9805	0	0	76	0	0	76
9806	0	0	0	76	0	76
9807	0	0	78	0	0	78
9808	0	78	0	0	0	78
9809	70	0	0	0	0	70
9810	0	70	0	0	0	70
9811	0	72	0	0	0	72
9812	1	0	0	76	0	77
9813	0	0	0	75	0	75
9814	0	0	0	76	0	76
9815	0	0	0	75	0	75
9816	2	0	0	75	0	77
9817	0	0	82	0	0	82
9818	0	0	0	82	0	82
9819	0	0	0	82	0	82
9820	82	0	0	0	0	82
9821	89	0	0	0	0	89
9822	92	0	0	0	0	92
9823	0	0	0	92	0	92
9824	110	0	0	0	0	110
9825	126	0	0	0	0	126
9826	127	0	0	0	0	127
9827	1	0	129	0	0	130
9828	129	0	0	0	0	129
9829	130	0	1	0	0	131
9830	133	0	0	0	0	133
9831	1	0	0	130	0	131
9832	1	0	128	0	0	129
9833	0	0	0	130	0	130
9834	135	0	1	0	0	136
9835	0	0	0	135	0	135
9836	1	147	0	0	0	148
9837	0	0	0	154	0	154
9838	154	1	0	1	0	156
9839	157	0	0	1	0	158
9840	158	0	0	0	0	158
9841	1	0	154	0	0	155
9842	1	0	0	153	0	154
9843	0	0	1	155	0	156
9844	0	0	154	1	0	155
9845	0	155	0	1	0	156
9846	0	0	158	0	0	158
9847	0	1	0	153	0	154
9848	154	0	1	0	0	155
9849	0	0	157	2	0	159
9850	1	0	0	157	0	158
9851	0	0	161	0	0	161
9852	160	0	0	1	0	161
9853	0	0	1	161	0	162
9854	1	0	167	0	0	168
9855	0	0	0	170	0	170
9856	0	1	171	0	0	172
9857	0	170	0	2	0	172
9858	0	0	1	175	0	176
9859	175	0	0	0	0	175
9860	0	0	0	180	0	180
9861	1	0	0	178	0	179
9862	177	0	0	2	0	179
9863	0	168	0	1	0	169
9864	0	174	0	0	0	174
9865	0	1	0	175	0	176
9866	0	178	0	0	0	178
9867	1	0	0	177	0	178
9868	0	1	0	178	0	179
9869	177	0	0	1	0	178
9870	0	178	0	1	0	179
9871	1	0	175	0	0	176
9872	0	181	0	0	0	181
9873	177	0	0	0	0	177
9874	182	1	0	0	0	183
9875	1	0	0	182	0	183
9876	180	0	0	1	0	181
9877	0	0	0	179	0	179
9878	182	0	0	0	0	182
9879	179	0	0	1	0	180
9880	1	0	0	186	0	187
9881	187	0	0	1	0	188
9882	0	0	187	1	0	188
9883	186	0	0	0	0	186
9884	0	0	1	187	0	188
9885	191	0	0	0	0	191
9886	0	190	0	1	0	191
9887	1	0	0	193	0	194
9888	0	1	0	199	0	200
9889	199	0	0	1	0	200
9890	0	0	203	1	0	204
9891	1	202	0	0	0	203
9892	0	0	1	206	0	207
9893	0	200	0	0	0	200
9894	0	0	0	211	0	211
9895	0	1	0	208	0	209
9896	0	0	0	208	0	208
9897	209	0	0	1	0	210
9898	0	0	0	200	0	200
9899	206	0	0	0	0	206
9900	199	0	0	1	0	200
9901	1	0	0	203	0	204
9902	210	0	0	0	0	210
9903	204	0	0	1	0	205
9904	1	0	206	0	0	207
9905	1	0	0	204	0	205
9906	205	0	1	0	0	206
9907	0	206	0	1	0	207
9908	207	0	0	1	0	208
9909	207	1	0	1	0	209
9910	1	0	203	0	0	204
9911	2	0	0	200	0	202
9912	208	0	1	1	0	210
9913	0	0	0	223	0	223
9914	1	0	0	235	0	236
9915	0	0	0	235	0	235
9916	0	0	1	254	0	255
9917	254	0	0	1	0	255
9918	0	0	262	1	0	263
9919	2	0	0	273	0	275
9920	0	0	308	0	0	308
9921	0	0	322	2	0	324
9922	324	0	5	0	0	329
9923	3	0	331	1	0	335
9924	3	308	3	3	0	317
9925	300	4	2	0	0	306
9926	303	2	1	1	0	307
9927	5	0	0	302	0	307
9928	2	0	304	3	0	309
9929	0	0	304	3	0	307
9930	313	0	6	0	0	319
9931	3	0	4	315	0	322
9932	312	1	0	3	0	316
9933	3	322	1	2	0	328
9934	319	3	0	0	0	322
9935	320	2	0	2	0	324
9936	6	307	1	0	0	314
9937	2	3	1	310	0	316
9938	310	1	1	4	0	316
9939	3	0	304	3	0	310
9940	4	308	3	0	0	315
9941	0	3	2	308	0	313
9942	310	2	0	3	0	315
9943	4	308	0	2	0	314
9944	315	3	0	0	0	318
9945	4	2	310	1	0	317
9946	314	1	3	0	0	318
9947	3	0	319	1	0	323
9948	324	0	3	0	0	327
9949	315	0	3	1	0	319
9950	6	1	316	0	0	323
9951	2	317	3	1	0	323
9952	3	3	2	308	0	316
9953	0	3	316	3	0	322
9954	2	310	3	1	0	316
9955	2	3	4	302	0	311
9956	3	3	0	306	0	312
9957	1	0	306	5	0	312
9958	1	0	4	296	0	301
9959	1	1	2	302	0	306
9960	0	0	301	6	0	307
9961	0	1	4	297	0	302
9962	0	302	2	6	0	310
9963	309	3	1	3	0	316
9964	4	3	0	303	0	310
9965	2	305	3	4	0	314
9966	0	3	0	301	0	304
9967	0	311	2	4	0	317
9968	0	3	310	2	0	315
9969	0	314	3	2	0	319
9970	311	4	3	0	0	318
9971	314	2	0	1	0	317
9972	316	1	0	1	0	318
9973	6	1	314	0	0	321
9974	2	0	315	0	0	317
9975	0	323	4	0	0	327
9976	0	3	4	319	0	326
9977	0	329	0	2	0	331
9978	2	3	0	308	0	313
9979	0	330	1	3	0	334
9980	333	3	0	1	0	337
9981	360	2	1	0	0	363
9982	6	0	1	372	0	379
9983	2	1	370	3	0	376
9984	377	0	4	3	0	384
9985	3	382	3	0	0	388
9986	3	3	0	383	0	389
9987	1	2	0	373	0	376
9988	1	379	0	6	0	386
9989	384	4	1	2	0	391
9990	5	2	380	1	0	388
9991	3	1	4	379	0	387
9992	377	1	2	5	0	385
9993	377	1	0	4	0	382
9994	6	380	0	1	0	387
9995	4	2	1	367	0	374
9996	0	386	1	3	0	390
9997	386	3	0	5	0	394
9998	5	1	388	0	0	394
9999	3	1	378	1	0	383
10000	2	0	5	384	0	391
10001	2	0	2	379	0	383
10002	1	378	0	5	0	384
10003	2	3	1	380	0	386
10004	1	3	377	3	0	384
10005	377	0	5	2	0	384
10006	3	0	4	384	0	391
10007	2	1	376	5	0	384
10008	1	2	3	380	0	386
10009	0	0	2	378	0	380
10010	0	382	3	3	0	388
10011	2	5	0	383	0	390
10012	2	2	1	379	0	384
10013	3	0	3	365	0	371
10014	346	0	0	8	0	354
10015	3	344	0	4	0	351
10016	2	325	2	0	0	329
10017	322	4	0	3	0	329
10018	311	2	0	3	0	316
10019	5	294	0	2	0	301
10020	2	262	0	0	0	264
10021	230	1	0	1	0	232
10022	0	224	0	1	0	225
10023	2	229	0	0	0	231
10024	229	0	0	0	0	229
10025	2	230	0	0	0	232
10026	229	1	0	1	0	231
10027	232	0	1	0	0	233
10028	228	1	0	1	0	230
10029	0	225	0	0	0	225
10030	2	215	0	1	0	218
10031	0	2	0	216	0	218
10032	2	216	1	0	0	219
10033	3	0	0	222	0	225
10034	235	0	1	1	0	237
10035	0	1	0	232	0	233
10036	1	229	0	0	0	230
10037	228	0	0	3	0	231
10038	0	226	0	1	0	227
10039	0	226	1	3	0	230
10040	1	3	0	224	0	228
10041	1	227	0	1	0	229
10042	227	1	0	0	0	228
10043	2	1	225	1	0	229
10044	0	230	0	1	0	231
10045	1	2	0	227	0	230
10046	0	1	230	2	0	233
10047	0	2	0	224	0	226
10048	3	0	1	219	0	223
10049	2	0	1	223	0	226
10050	0	3	0	222	0	225
10051	0	0	223	3	0	226
10052	0	225	1	1	0	227
10053	223	0	0	3	0	226
10054	0	1	219	2	0	222
10055	219	0	1	3	0	223
10056	0	0	219	3	0	222
10057	0	0	2	227	0	229
10058	0	3	221	0	0	224
10059	2	1	222	1	0	226
10060	0	1	3	223	0	227
10061	3	0	1	213	0	217
10062	1	0	2	223	0	226
10063	0	1	1	221	0	223
10064	224	1	2	1	0	228
10065	1	0	221	1	0	223
10066	214	1	0	3	0	218
10067	221	1	0	2	0	224
10068	218	0	0	3	0	221
10069	216	1	0	3	0	220
10070	220	1	0	0	0	221
10071	0	0	1	218	0	219
10072	5	3	210	0	0	218
10073	3	0	206	1	0	210
10074	3	209	1	0	0	213
10075	203	1	0	0	0	204
10076	4	3	1	193	0	201
10077	1	3	0	196	0	200
10078	1	191	2	1	0	195
10079	0	191	2	1	0	194
10080	2	181	0	0	0	183
10081	157	1	1	0	0	159
10082	0	3	0	132	0	135
10083	0	132	0	2	0	134
10084	0	0	1	133	0	134
10085	0	1	126	0	0	127
10086	1	1	132	1	0	135
10087	1	0	0	142	0	143
10088	152	0	0	4	0	156
10089	157	1	1	1	0	160
10090	162	1	0	1	0	164
10091	3	0	163	0	0	166
10092	0	0	3	160	0	163
10093	1	0	0	164	0	165
10094	1	1	158	2	0	162
10095	159	0	2	2	0	163
10096	3	0	160	0	0	163
10097	0	1	159	0	0	160
10098	0	1	151	2	0	154
10099	0	2	2	151	0	155
10100	1	0	0	152	0	153
10101	0	0	149	3	0	152
10102	1	1	2	150	0	154
10103	158	0	1	3	0	162
10104	3	0	1	162	0	166
10105	1	0	161	3	0	165
10106	1	0	165	1	0	167
10107	1	0	2	163	0	166
10108	170	0	0	3	0	173
10109	2	173	1	1	0	177
10110	171	3	1	1	0	176
10111	180	0	1	0	0	181
10112	3	1	187	0	0	191
10113	2	2	3	183	0	190
10114	181	0	1	3	0	185
10115	183	0	0	3	0	186
10116	3	184	1	0	0	188
10117	0	4	1	182	0	187
10118	0	0	0	187	0	187
10119	1	0	186	4	0	191
10120	0	0	3	185	0	188
10121	0	0	184	3	0	187
10122	2	0	182	1	0	185
10123	0	0	4	181	0	185
10124	177	0	1	3	0	181
10125	4	173	0	2	0	179
10126	175	3	0	0	0	178
10127	178	0	0	0	0	178
10128	5	177	0	0	0	182
10129	0	3	1	177	0	181
10130	174	0	1	4	0	179
10131	4	171	1	1	0	177
10132	167	4	0	1	0	172
10133	5	158	0	0	0	163
10134	1	3	1	148	0	153
10135	0	0	0	152	0	152
10136	150	0	0	4	0	154
10137	148	0	1	0	0	149
10138	3	148	1	0	0	152
10139	0	3	146	1	0	150
10140	1	0	148	0	0	149
10141	1	2	4	140	0	147
10142	1	142	0	2	0	145
10143	3	3	1	139	0	146
10144	0	2	1	141	0	144
10145	0	0	0	142	0	142
10146	1	0	142	3	0	146
10147	1	0	142	0	0	143
10148	0	143	4	0	0	147
10149	0	3	2	139	0	144
10150	1	0	1	145	0	147
10151	1	0	137	4	0	142
10152	132	1	3	1	0	137
10153	5	0	1	137	0	143
10154	1	0	136	4	0	141
10155	131	0	4	0	0	135
10156	3	133	0	2	0	138
10157	1	2	136	0	0	139
10158	3	0	4	137	0	144
10159	136	1	0	4	0	141
10160	4	1	137	1	0	143
10161	1	1	3	140	0	145
10162	1	0	1	148	0	150
10163	1	0	0	159	0	160
10164	158	0	2	4	0	164
10165	3	153	1	1	0	158
10166	2	3	0	156	0	161
10167	3	0	156	3	0	162
10168	0	2	3	158	0	163
10169	1	149	0	4	0	154
10170	1	161	0	1	0	163
10171	158	4	3	0	0	165
10172	161	0	0	2	0	163
10173	4	0	159	0	0	163
10174	160	1	4	0	0	165
10175	3	160	0	1	0	164
10176	161	4	0	0	0	165
10177	3	1	0	162	0	166
10178	0	0	159	3	0	162
10179	2	0	3	163	0	168
10180	1	1	162	3	0	167
10181	157	1	3	1	0	162
10182	4	0	1	156	0	161
10183	0	160	1	3	0	164
10184	2	5	0	163	0	170
10185	0	2	164	3	0	169
10186	0	156	3	1	0	160
10187	143	1	0	2	0	146
10188	1	134	0	0	0	135
10189	0	127	0	0	0	127
10190	0	0	0	120	0	120
10191	0	121	0	1	0	122
10192	0	1	0	120	0	121
10193	0	0	122	1	0	123
10194	115	0	1	0	0	116
10195	116	0	0	0	0	116
10196	1	0	113	0	0	114
10197	113	0	1	0	0	114
10198	1	113	0	0	0	114
10199	116	1	0	0	0	117
10200	1	0	0	111	0	112
10201	0	0	120	1	0	121
10202	0	119	1	0	0	120
10203	2	1	0	113	0	116
10204	0	0	0	109	0	109
10205	107	0	0	1	0	108
10206	107	0	0	0	0	107
10207	1	103	0	0	0	104
10208	0	91	0	1	0	92
10209	0	94	0	0	0	94
10210	3	0	1	88	0	92
10211	86	0	1	0	0	87
10212	83	0	0	0	0	83
10213	0	0	0	82	0	82
10214	0	0	0	82	0	82
10215	83	0	0	0	0	83
10216	0	0	0	83	0	83
10217	0	0	84	0	0	84
10218	88	0	0	0	0	88
10219	87	0	0	0	0	87
10220	0	0	89	0	0	89
10221	91	0	0	0	0	91
10222	0	0	0	96	0	96
10223	0	0	0	96	0	96
10224	0	0	0	96	0	96
10225	97	0	0	0	0	97
10226	0	102	0	0	0	102
10227	0	0	0	103	0	103
10228	0	100	0	0	0	100
10229	102	0	0	0	0	102
10230	0	0	0	101	0	101
10231	0	0	0	104	0	104
10232	0	102	0	0	0	102
10233	0	0	104	0	0	104
10234	0	0	0	104	0	104
10235	104	0	0	0	0	104
10236	113	0	0	0	0	113
10237	1	0	123	0	0	124
10238	0	0	2	123	0	125
10239	0	122	0	2	0	124
10240	0	2	0	125	0	127
10241	128	0	0	2	0	130
10242	128	0	0	0	0	128
10243	3	0	0	123	0	126
10244	0	128	0	2	0	130
10245	132	2	0	0	0	134
10246	2	0	0	133	0	135
10247	139	0	0	2	0	141
10248	147	0	0	1	0	148
10249	2	0	0	152	0	154
10250	0	0	0	153	0	153
10251	0	0	0	161	0	161
10252	0	159	0	2	0	161
10253	1	2	0	159	0	162
10254	1	0	0	163	0	164
10255	0	0	159	2	0	161
10256	0	0	159	0	0	159
10257	1	0	2	154	0	157
10258	157	0	0	3	0	160
10259	3	159	0	0	0	162
10260	156	2	0	1	0	159
10261	2	0	157	1	0	160
10262	0	0	154	2	0	156
10263	0	154	2	1	0	157
10264	0	3	0	149	0	152
10265	0	0	146	3	0	149
10266	0	0	153	1	0	154
10267	0	0	3	153	0	156
10268	150	0	1	5	0	156
10269	152	0	0	1	0	153
10270	3	0	0	153	0	156
10271	0	1	165	2	0	168
10272	2	0	2	167	0	171
10273	1	0	1	165	0	167
10274	0	166	1	3	0	170
10275	169	3	0	1	0	173
10276	167	1	0	1	0	169
10277	3	169	2	1	0	175
10278	1	2	1	169	0	173
10279	1	172	0	2	0	175
10280	172	2	0	1	0	175
10281	3	1	168	0	0	172
10282	1	0	164	1	0	166
10283	0	0	165	2	0	167
10284	0	2	2	164	0	168
10285	1	0	0	165	0	166
10286	163	1	0	5	0	169
10287	4	0	0	165	0	169
10288	2	0	0	172	0	174
10289	0	2	182	2	0	186
10290	0	0	183	2	0	185
10291	181	1	3	2	0	187
10292	3	184	0	0	0	187
10293	189	2	2	1	0	194
10294	2	0	0	192	0	194
10295	1	0	1	192	0	194
10296	0	192	1	3	0	196
10297	1	2	0	192	0	195
10298	193	1	0	2	0	196
10299	3	0	0	192	0	195
10300	1	2	194	3	0	200
10301	1	190	3	2	0	196
10302	188	3	2	1	0	194
10303	196	1	1	1	0	199
10304	199	1	0	1	0	201
10305	200	0	0	1	0	201
10306	2	0	0	197	0	199
10307	1	0	0	200	0	201
10308	1	1	196	3	0	201
10309	1	0	1	204	0	206
10310	2	0	197	4	0	203
10311	1	2	2	199	0	204
10312	195	0	1	4	0	200
10313	3	208	0	2	0	213
10314	1	3	0	211	0	215
10315	2	1	1	215	0	219
10316	211	1	0	6	0	218
10317	211	0	0	1	0	212
10318	2	1	208	1	0	212
10319	1	210	4	1	0	216
10320	0	2	3	211	0	216
10321	1	0	1	214	0	216
10322	205	2	1	3	0	211
10323	206	0	0	2	0	208
10324	3	0	213	1	0	217
10325	0	1	208	1	0	210
10326	1	0	3	206	0	210
10327	1	0	1	212	0	214
10328	3	0	210	2	0	215
10329	203	1	3	2	0	209
10330	3	0	2	208	0	213
10331	206	1	0	5	0	212
10332	4	205	0	1	0	210
10333	210	4	0	2	0	216
10334	4	0	231	1	0	236
10335	3	229	2	1	0	235
10336	0	219	1	1	0	221
10337	209	0	1	1	0	211
10338	206	0	0	2	0	208
10339	0	0	0	208	0	208
10340	0	207	1	0	0	208
10341	1	208	0	0	0	209
10342	0	1	0	210	0	211
10343	211	0	0	1	0	212
10344	207	1	0	0	0	208
10345	1	0	202	0	0	203
10346	198	0	1	0	0	199
10347	1	213	0	0	0	214
10348	214	2	0	0	0	216
10349	1	273	0	0	0	274
10350	0	303	0	0	0	303
10351	1	4	0	331	0	336
10352	357	1	0	6	0	364
10353	361	1	0	1	0	363
10354	5	1	363	1	0	370
10355	6	0	4	364	0	374
10356	367	0	1	4	0	372
10357	6	0	1	368	0	375
10358	370	0	1	4	0	375
10359	368	0	0	4	0	372
10360	6	0	370	1	0	377
10361	2	0	4	361	0	367
10362	4	0	1	361	0	366
10363	1	0	1	363	0	365
10364	1	0	357	6	0	364
10365	0	0	4	356	0	360
10366	0	0	1	355	0	356
10367	0	345	1	6	0	352
10368	0	4	345	3	0	352
10369	0	350	4	3	0	357
10370	348	5	2	1	0	356
10371	4	2	1	340	0	347
10372	1	1	1	333	0	336
10373	1	336	0	7	0	344
10374	336	4	1	2	0	343
10375	338	2	0	2	0	342
10376	7	335	0	1	0	343
10377	2	339	0	1	0	342
10378	337	5	0	1	0	343
10379	5	3	332	0	0	340
10380	2	2	332	0	0	336
10381	329	2	5	0	0	336
10382	5	330	3	0	0	338
10383	332	5	2	0	0	339
10384	6	1	337	0	0	344
10385	330	1	5	0	0	336
10386	5	335	2	0	0	342
10387	4	4	1	340	0	349
10388	2	2	1	341	0	346
10389	4	2	0	313	0	319
10390	3	2	0	323	0	328
10391	2	0	0	324	0	326
10392	1	319	1	7	0	328
10393	320	4	0	5	0	329
10394	4	1	316	2	0	323
10395	2	1	4	318	0	325
10396	3	1	319	4	0	327
10397	2	1	5	319	0	327
10398	2	1	2	319	0	324
10399	316	0	1	6	0	323
10400	4	0	317	2	0	323
10401	1	306	5	4	0	316
10402	2	4	1	313	0	320
10403	2	2	1	312	0	317
10404	1	0	310	6	0	317
10405	1	1	5	308	0	315
10406	1	1	2	312	0	316
10407	299	3	1	8	0	311
10408	4	302	2	4	0	312
10409	302	5	0	3	0	310
10410	306	1	1	3	0	311
10411	7	1	0	304	0	312
10412	2	1	302	6	0	311
10413	3	2	301	1	0	307
10414	3	2	5	299	0	309
10415	3	1	3	296	0	303
10416	1	297	2	7	0	307
10417	295	5	2	3	0	305
10418	5	289	1	3	0	298
10419	1	294	3	1	0	299
10420	298	6	1	2	0	307
10421	7	1	1	295	0	304
10422	1	312	0	5	0	318
10423	4	5	0	313	0	322
10424	2	2	306	6	0	316
10425	1	2	306	2	0	311
10426	1	2	5	304	0	312
10427	0	0	305	8	0	313
10428	1	1	6	301	0	309
10429	0	1	2	307	0	310
10430	1	0	2	310	0	313
10431	297	0	2	9	0	308
10432	4	291	0	4	0	299
10433	2	303	2	2	0	309
10434	280	6	2	2	0	290
10435	287	2	0	3	0	292
10436	5	2	1	283	0	291
10437	2	2	286	6	0	296
10438	3	2	4	292	0	301
10439	3	2	287	5	0	297
10440	2	286	6	2	0	296
10441	2	5	2	280	0	289
10442	282	2	1	6	0	291
10443	6	3	2	279	0	290
10444	2	2	280	6	0	290
10445	278	0	6	4	0	288
10446	8	1	280	2	0	291
10447	2	1	272	3	0	278
10448	3	267	6	0	0	276
10449	0	201	2	2	0	205
10450	0	177	1	2	0	180
10451	125	2	4	3	0	134
10452	110	1	0	0	0	111
10453	1	1	0	111	0	113
10454	1	1	0	111	0	113
10455	1	1	0	115	0	117
10456	1	118	0	1	0	120
10457	119	0	0	2	0	121
10458	0	118	1	0	0	119
10459	1	0	0	119	0	120
10460	120	1	0	0	0	121
10461	0	0	0	124	0	124
10462	2	0	0	125	0	127
10463	128	0	0	1	0	129
10464	128	0	0	1	0	129
10465	1	0	127	0	0	128
10466	1	0	125	0	0	126
10467	0	0	128	0	0	128
10468	0	0	0	126	0	126
10469	0	0	1	128	0	129
10470	0	127	0	1	0	128
10471	132	0	0	1	0	133
10472	0	1	0	131	0	132
10473	1	0	0	131	0	132
10474	0	134	0	1	0	135
10475	0	142	0	1	0	143
10476	0	1	0	146	0	147
10477	0	1	0	168	0	169
10478	168	0	0	1	0	169
10479	166	0	0	1	0	167
10480	1	0	0	165	0	166
10481	1	0	165	0	0	166
10482	0	0	159	1	0	160
10483	0	0	1	165	0	166
10484	0	0	1	159	0	160
10485	0	160	0	1	0	161
10486	157	0	0	1	0	158
10487	0	0	0	158	0	158
10488	3	0	157	0	0	160
10489	0	0	0	163	0	163
10490	0	0	163	0	0	163
10491	0	0	164	1	0	165
10492	0	0	1	163	0	164
10493	165	0	0	0	0	165
10494	0	0	164	1	0	165
10495	0	0	0	163	0	163
10496	0	1	181	0	0	182
10497	0	0	0	180	0	180
10498	0	0	0	176	0	176
10499	0	0	180	1	0	181
10500	0	0	175	1	0	176
10501	1	0	1	171	0	173
10502	0	0	1	178	0	179
10503	0	0	0	179	0	179
10504	0	0	0	176	0	176
10505	177	0	0	1	0	178
10506	179	0	0	1	0	180
10507	1	181	0	0	0	182
10508	183	0	0	0	0	183
10509	0	1	1	183	0	185
10510	185	0	1	0	0	186
10511	0	0	188	2	0	190
10512	188	0	0	2	0	190
10513	0	1	1	185	0	187
10514	2	0	2	190	0	194
10515	191	0	1	2	0	194
10516	0	0	1	207	0	208
10517	1	1	212	0	0	214
10518	209	2	0	1	0	212
10519	2	218	2	1	0	223
10520	1	1	0	219	0	221
10521	1	0	228	2	0	231
10522	3	0	1	224	0	228
10523	0	2	231	2	0	235
10524	0	0	2	232	0	234
10525	0	230	4	4	0	238
10526	1	3	0	242	0	246
10527	1	243	1	3	0	248
10528	0	3	0	240	0	243
10529	2	1	1	249	0	253
10530	1	0	1	263	0	265
10531	1	1	1	258	0	261
10532	0	0	0	261	0	261
10533	1	1	253	6	0	261
10534	2	0	4	257	0	263
10535	0	0	2	256	0	258
10536	255	0	2	6	0	263
10537	3	250	2	3	0	258
10538	250	3	1	3	0	257
10539	3	2	1	256	0	262
10540	3	1	253	6	0	263
10541	3	254	3	3	0	263
10542	256	3	2	1	0	262
10543	3	252	1	3	0	259
10544	1	260	3	1	0	265
10545	260	5	0	2	0	267
10546	4	1	0	267	0	272
10547	263	1	1	5	0	270
10548	4	2	1	258	0	265
10549	3	0	258	4	0	265
10550	0	1	258	4	0	263
10551	256	0	5	0	0	261
10552	256	0	1	4	0	261
10553	6	0	2	253	0	261
10554	2	0	3	252	0	257
10555	249	1	0	5	0	255
10556	6	243	0	2	0	251
10557	1	243	1	3	0	248
10558	243	4	0	2	0	249
10559	247	1	2	1	0	251
10560	5	246	1	1	0	253
10561	2	4	0	244	0	250
10562	1	2	239	4	0	246
10563	2	0	238	1	0	241
10564	235	1	4	2	0	242
10565	3	0	237	3	0	243
10566	1	0	4	235	0	240
10567	0	0	2	236	0	238
10568	2	230	0	4	0	236
10569	232	3	1	1	0	237
10570	3	2	0	233	0	238
10571	2	0	231	4	0	237
10572	0	234	3	2	0	239
10573	2	4	1	232	0	239
10574	0	1	230	4	0	235
10575	1	0	226	1	0	228
10576	0	220	5	0	0	225
10577	191	3	1	1	0	196
10578	3	195	1	0	0	199
10579	196	3	1	0	0	200
10580	3	2	190	0	0	195
10581	193	0	3	0	0	196
10582	3	194	1	0	0	198
10583	2	3	0	193	0	198
10584	0	1	1	199	0	201
10585	197	0	0	3	0	200
10586	3	1	195	1	0	200
10587	193	0	3	1	0	197
10588	197	0	1	1	0	199
10589	5	0	193	0	0	198
10590	1	0	195	0	0	196
10591	1	2	4	185	0	192
10592	189	0	1	3	0	193
10593	189	0	1	1	0	191
10594	4	184	1	4	0	193
10595	1	2	0	191	0	194
10596	2	1	0	178	0	181
10597	1	0	0	177	0	178
10598	1	0	0	177	0	178
10599	176	0	0	6	0	182
10600	3	0	1	182	0	186
10601	2	0	184	3	0	189
10602	1	0	178	2	0	181
10603	180	0	4	0	0	184
10604	3	179	1	2	0	185
10605	1	185	2	1	0	189
10606	1	3	1	184	0	189
10607	1	2	0	187	0	190
10608	0	2	0	184	0	186
10609	0	1	0	185	0	186
10610	1	1	179	5	0	186
10611	0	1	3	177	0	181
10612	0	0	1	180	0	181
10613	0	0	169	4	0	173
10614	166	0	5	1	0	172
10615	4	158	1	10	0	173
10616	150	2	1	1	0	154
10617	3	1	147	1	0	152
10618	1	0	146	0	0	147
10619	0	146	3	0	0	149
10620	133	5	8	2	0	148
10621	127	0	4	1	0	132
10622	125	0	1	0	0	126
10623	2	120	0	0	0	122
10624	116	1	0	1	0	118
10625	1	0	121	0	0	122
10626	0	115	1	0	0	116
10627	107	2	3	0	0	112
10628	1	115	0	0	0	116
10629	104	1	0	0	0	105
10630	100	0	0	0	0	100
10631	0	0	104	0	0	104
10632	1	106	0	0	0	107
10633	103	1	0	0	0	104
10634	0	0	105	1	0	106
10635	0	102	0	0	0	102
10636	1	3	0	101	0	105
10637	0	0	98	0	0	98
10638	1	0	94	0	0	95
10639	1	0	0	94	0	95
10640	92	0	1	0	0	93
10641	0	95	1	0	0	96
10642	0	0	92	1	0	93
10643	1	0	90	0	0	91
10644	90	0	0	0	0	90
10645	0	87	0	0	0	87
10646	82	0	0	0	0	82
10647	0	81	0	0	0	81
10648	87	0	0	0	0	87
10649	84	0	0	0	0	84
10650	0	86	0	0	0	86
10651	0	0	0	86	0	86
10652	91	0	0	0	0	91
10653	0	0	0	91	0	91
10654	0	0	0	93	0	93
10655	94	0	0	0	0	94
10656	0	91	0	0	0	91
10657	93	0	0	0	0	93
10658	0	0	94	0	0	94
10659	0	0	0	96	0	96
10660	0	0	0	93	0	93
10661	92	0	0	0	0	92
10662	89	0	0	0	0	89
10663	0	0	0	90	0	90
10664	0	0	91	0	0	91
10665	0	0	0	90	0	90
10666	0	0	0	91	0	91
10667	0	0	0	90	0	90
10668	0	0	0	89	0	89
10669	92	0	0	0	0	92
10670	0	0	91	0	0	91
10671	0	89	0	0	0	89
10672	0	0	0	91	0	91
10673	0	0	0	93	0	93
10674	0	0	95	0	0	95
10675	1	0	90	0	0	91
10676	0	0	0	93	0	93
10677	0	0	0	92	0	92
10678	0	0	92	0	0	92
10679	0	0	0	93	0	93
10680	94	0	0	0	0	94
10681	0	95	0	0	0	95
10682	0	0	93	0	0	93
10683	0	95	0	0	0	95
10684	0	0	0	94	0	94
10685	0	0	96	0	0	96
10686	0	96	1	0	0	97
10687	0	0	0	97	0	97
10688	0	0	97	0	0	97
10689	0	0	0	95	0	95
10690	0	0	0	93	0	93
10691	95	0	0	0	0	95
10692	0	0	0	94	0	94
10693	94	0	0	0	0	94
10694	90	0	0	0	0	90
10695	91	0	0	0	0	91
10696	1	0	0	99	0	100
10697	0	0	100	1	0	101
10698	0	0	97	1	0	98
10699	96	0	0	0	0	96
10700	0	0	99	0	0	99
10701	98	0	0	0	0	98
10702	0	95	2	0	0	97
10703	98	0	1	1	0	100
10704	0	0	101	2	0	103
10705	2	0	102	0	0	104
10706	1	0	2	107	0	110
10707	0	0	116	2	0	118
10708	1	0	118	1	0	120
10709	0	1	1	128	0	130
10710	0	0	2	128	0	130
10711	0	1	0	130	0	131
10712	0	130	0	2	0	132
10713	1	0	1	128	0	130
10714	0	134	1	0	0	135
10715	131	1	0	0	0	132
10716	132	1	1	1	0	135
10717	1	0	0	132	0	133
10718	1	124	1	1	0	127
10719	1	0	129	1	0	131
10720	124	1	0	2	0	127
10721	1	0	1	125	0	127
10722	2	0	1	123	0	126
10723	1	0	0	124	0	125
10724	123	0	0	2	0	125
10725	0	118	1	1	0	120
10726	1	117	2	0	0	120
10727	115	2	0	0	0	117
10728	0	116	1	1	0	118
10729	119	0	1	0	0	120
10730	116	3	0	0	0	119
10731	2	117	0	1	0	120
10732	0	0	2	116	0	118
10733	0	114	1	0	0	115
10734	0	0	0	117	0	117
10735	1	1	1	122	0	125
10736	123	0	1	2	0	126
10737	127	0	0	2	0	129
10738	1	0	0	127	0	128
10739	2	0	123	0	0	125
10740	122	1	0	2	0	125
10741	1	122	2	2	0	127
10742	1	1	1	129	0	132
10743	2	0	2	127	0	131
10744	2	0	1	130	0	133
10745	127	1	0	2	0	130
10746	125	2	1	2	0	130
10747	2	125	1	2	0	130
10748	3	117	1	1	0	122
10749	1	2	1	119	0	123
10750	1	1	1	119	0	122
10751	0	1	119	2	0	122
10752	1	1	0	114	0	116
10753	0	1	113	1	0	115
10754	0	2	104	1	0	107
10755	1	106	2	2	0	111
10756	0	1	2	107	0	110
10757	107	1	1	1	0	110
10758	1	0	1	107	0	109
10759	2	2	104	0	0	108
10760	101	0	0	4	0	105
10761	104	1	1	0	0	106
10762	2	0	105	2	0	109
10763	1	0	0	108	0	109
10764	107	0	1	1	0	109
10765	2	111	1	1	0	115
10766	115	0	1	1	0	117
10767	115	1	1	1	0	118
10768	3	0	1	116	0	120
10769	2	2	0	114	0	118
10770	114	0	0	1	0	115
10771	3	0	0	114	0	117
10772	1	0	115	2	0	118
10773	112	0	1	2	0	115
10774	114	0	1	0	0	115
10775	2	110	0	1	0	113
10776	1	112	1	0	0	114
10777	1	3	0	111	0	115
10778	1	113	0	1	0	115
10779	0	2	0	110	0	112
10780	105	2	0	1	0	108
10781	105	0	0	2	0	107
10782	2	105	0	0	0	107
10783	104	1	0	1	0	106
10784	2	105	0	0	0	107
10785	104	1	0	0	0	105
10786	100	2	0	0	0	102
10787	2	0	99	0	0	101
10788	101	1	1	0	0	103
10789	2	100	1	0	0	103
10790	2	104	0	0	0	106
10791	103	2	1	0	0	106
10792	2	1	0	104	0	107
10793	2	1	103	1	0	107
10794	1	1	1	103	0	106
10795	2	0	1	105	0	108
10796	0	0	102	3	0	105
10797	100	0	2	1	0	103
10798	1	102	1	1	0	105
10799	101	1	0	2	0	104
10800	1	1	1	95	0	98
10801	95	0	0	2	0	97
10802	2	94	0	1	0	97
10803	1	1	0	89	0	91
10804	86	1	0	2	0	89
10805	2	1	83	0	0	86
10806	0	1	74	1	0	76
10807	70	0	1	2	0	73
10808	2	67	1	0	0	70
10809	0	57	1	1	0	59
10810	1	1	2	55	0	59
10811	1	57	0	2	0	60
10812	0	3	0	57	0	60
10813	0	1	0	60	0	61
10814	1	0	0	59	0	60
10815	0	58	0	2	0	60
10816	0	1	1	58	0	60
10817	1	0	54	2	0	57
10818	1	55	1	1	0	58
10819	0	2	1	53	0	56
10820	0	54	0	2	0	56
10821	54	1	1	0	0	56
10822	55	2	0	0	0	57
10823	56	0	0	0	0	56
10824	2	55	0	0	0	57
10825	2	1	0	55	0	58
10826	1	0	55	2	0	58
10827	2	0	55	0	0	57
10828	53	1	1	1	0	56
10829	52	0	0	1	0	53
10830	2	0	1	58	0	61
10831	1	0	0	59	0	60
10832	1	1	59	1	0	62
10833	1	59	1	0	0	61
10834	0	56	0	2	0	58
10835	0	1	50	2	0	53
10836	0	1	1	48	0	50
10837	0	0	0	44	0	44
10838	0	0	0	48	0	48
10839	0	0	0	48	0	48
10840	47	0	0	1	0	48
10841	1	0	45	0	0	46
10842	44	0	1	0	0	45
10843	1	0	0	43	0	44
10844	44	0	0	1	0	45
10845	1	0	0	43	0	44
10846	0	0	43	1	0	44
10847	0	0	1	44	0	45
10848	1	0	46	1	0	48
10849	0	0	1	46	0	47
10850	0	0	47	1	0	48
10851	0	49	1	1	0	51
10852	0	1	0	51	0	52
10853	0	0	1	52	0	53
10854	1	49	0	1	0	51
10855	53	2	0	0	0	55
10856	2	0	0	53	0	55
10857	0	0	0	55	0	55
10858	56	0	0	1	0	57
10859	56	1	0	0	0	57
10860	59	0	0	1	0	60
10861	61	0	0	0	0	61
10862	1	0	55	0	0	56
10863	53	0	2	0	0	55
10864	57	0	0	0	0	57
10865	1	1	0	49	0	51
10866	0	1	0	49	0	50
10867	49	0	0	2	0	51
10868	1	48	0	0	0	49
10869	0	1	0	48	0	49
10870	0	0	47	1	0	48
10871	0	49	0	0	0	49
10872	47	1	0	0	0	48
10873	45	0	0	1	0	46
10874	45	0	1	0	0	46
10875	45	1	0	0	0	46
10876	0	0	0	45	0	45
10877	0	1	45	0	0	46
10878	1	0	47	0	0	48
10879	2	0	0	52	0	54
10880	55	0	0	0	0	55
10881	0	1	0	54	0	55
10882	0	0	58	1	0	59
10883	58	0	0	0	0	58
10884	56	0	1	0	0	57
10885	1	0	0	58	0	59
10886	1	0	61	0	0	62
10887	0	0	63	1	0	64
10888	56	0	0	2	0	58
10889	0	60	1	0	0	61
10890	0	1	59	0	0	60
10891	0	0	0	56	0	56
10892	61	0	0	0	0	61
10893	0	60	0	0	0	60
10894	0	59	0	0	0	59
10895	64	0	0	0	0	64
10896	0	0	0	63	0	63
10897	71	0	0	0	0	71
10898	0	0	0	71	0	71
10899	0	0	0	72	0	72
10900	0	0	73	0	0	73
10901	0	0	67	0	0	67
10902	0	0	71	0	0	71
10903	0	0	0	68	0	68
10904	71	0	0	0	0	71
10905	0	0	69	0	0	69
10906	1	0	0	70	0	71
10907	0	0	71	0	0	71
10908	0	74	0	0	0	74
10909	0	0	1	73	0	74
10910	0	0	0	73	0	73
10911	1	0	0	77	0	78
10912	78	0	0	0	0	78
10913	0	0	0	77	0	77
10914	0	0	0	78	0	78
10915	78	0	0	0	0	78
10916	0	0	77	0	0	77
10917	78	0	0	0	0	78
10918	78	0	0	0	0	78
10919	0	0	77	0	0	77
10920	75	0	0	0	0	75
10921	0	0	0	79	0	79
10922	0	0	81	0	0	81
10923	82	0	0	0	0	82
10924	82	0	0	0	0	82
10925	0	0	0	81	0	81
10926	0	0	0	82	0	82
10927	0	0	0	81	0	81
10928	80	0	0	0	0	80
10929	0	82	0	0	0	82
10930	75	0	0	0	0	75
10931	0	73	1	0	0	74
10932	0	74	0	0	0	74
10933	0	1	0	75	0	76
10934	0	0	0	76	0	76
10935	0	0	0	74	0	74
10936	0	0	0	74	0	74
10937	0	0	73	0	0	73
10938	72	0	0	0	0	72
10939	0	0	0	73	0	73
10940	0	0	75	0	0	75
10941	0	0	0	73	0	73
10942	0	0	0	74	0	74
10943	0	0	74	0	0	74
10944	0	0	0	75	0	75
10945	0	0	0	73	0	73
10946	77	0	0	0	0	77
10947	0	0	77	0	0	77
10948	75	0	0	0	0	75
10949	0	74	0	0	0	74
10950	75	0	0	0	0	75
10951	71	0	0	0	0	71
10952	0	0	0	73	0	73
10953	0	0	73	0	0	73
10954	0	77	0	0	0	77
10955	0	0	0	74	0	74
10956	0	82	0	0	0	82
10957	82	1	0	0	0	83
10958	1	0	79	0	0	80
10959	0	0	77	0	0	77
10960	0	0	1	72	0	73
10961	0	0	78	1	0	79
10962	0	0	1	76	0	77
10963	0	0	0	78	0	78
10964	79	0	0	1	0	80
10965	1	81	0	0	0	82
10966	0	1	0	80	0	81
10967	0	0	0	83	0	83
10968	0	0	0	83	0	83
10969	0	85	0	0	0	85
10970	0	85	0	0	0	85
10971	83	1	0	0	0	84
10972	84	0	0	0	0	84
10973	83	0	0	1	0	84
10974	1	0	83	0	0	84
10975	0	0	1	82	0	83
10976	0	0	82	1	0	83
10977	0	82	1	0	0	83
10978	79	0	1	0	0	80
10979	1	0	75	0	0	76
10980	0	0	1	75	0	76
10981	0	0	77	1	0	78
10982	71	0	1	0	0	72
10983	73	0	0	0	0	73
10984	73	0	0	0	0	73
10985	72	0	0	0	0	72
10986	1	0	70	0	0	71
10987	67	0	1	0	0	68
10988	65	0	0	0	0	65
10989	1	67	0	0	0	68
10990	67	1	0	0	0	68
10991	72	0	0	0	0	72
10992	1	0	0	70	0	71
10993	0	70	0	1	0	71
10994	75	1	0	1	0	77
10995	77	0	0	0	0	77
10996	1	0	92	0	0	93
10997	0	0	90	0	0	90
10998	0	1	87	0	0	88
10999	0	0	1	89	0	90
11000	88	0	0	1	0	89
11001	1	89	0	0	0	90
11002	89	1	0	0	0	90
11003	1	87	0	0	0	88
11004	89	1	0	0	0	90
11005	1	89	0	0	0	90
11006	0	89	0	0	0	89
11007	91	1	0	0	0	92
11008	1	91	1	0	0	93
11009	0	1	1	90	0	92
11010	0	0	91	2	0	93
11011	0	0	87	0	0	87
11012	0	0	1	85	0	86
11013	0	0	0	88	0	88
11014	1	0	87	1	0	89
11015	0	1	1	87	0	89
11016	0	0	0	89	0	89
11017	87	0	0	2	0	89
11018	1	85	0	1	0	87
11019	0	2	0	84	0	86
11020	0	93	0	0	0	93
11021	92	1	0	0	0	93
11022	2	94	0	0	0	96
11023	94	1	0	0	0	95
11024	91	0	1	1	0	93
11025	1	0	0	92	0	93
11026	0	0	1	92	0	93
11027	0	1	0	92	0	93
11028	1	0	0	91	0	92
11029	0	0	91	1	0	92
11030	85	0	1	1	0	87
11031	1	93	0	0	0	94
11032	1	0	0	94	0	95
11033	1	0	0	95	0	96
11034	1	93	0	1	0	95
11035	94	1	0	0	0	95
11036	0	95	0	0	0	95
11037	1	1	0	97	0	99
11038	1	0	0	101	0	102
11039	0	1	0	102	0	103
11040	1	0	0	100	0	101
11041	100	0	0	1	0	101
11042	1	0	98	1	0	100
11043	1	1	1	97	0	100
11044	1	0	0	98	0	99
11045	1	0	1	98	0	100
11046	0	0	3	97	0	100
11047	95	0	2	2	0	99
11048	2	0	97	0	0	99
11049	0	1	0	93	0	94
11050	3	94	0	1	0	98
11051	0	100	0	0	0	100
11052	97	1	0	0	0	98
11053	1	2	95	0	0	98
11054	92	1	1	0	0	94
11055	1	2	90	0	0	93
11056	0	2	0	85	0	87
11057	87	0	0	1	0	88
11058	0	90	1	0	0	91
11059	0	0	1	89	0	90
11060	0	89	1	1	0	91
11061	89	0	1	1	0	91
11062	90	0	0	1	0	91
11063	0	0	0	94	0	94
11064	0	0	98	1	0	99
11065	1	0	96	1	0	98
11066	0	1	0	96	0	97
11067	1	97	0	0	0	98
11068	0	2	0	103	0	105
11069	1	0	0	99	0	100
11070	0	2	0	96	0	98
11071	2	0	98	0	0	100
11072	2	1	0	98	0	101
11073	1	0	0	102	0	103
11074	1	97	0	2	0	100
11075	0	0	0	102	0	102
11076	0	0	0	106	0	106
11077	0	0	0	107	0	107
11078	1	0	0	106	0	107
11079	0	1	0	107	0	108
11080	0	0	0	108	0	108
11081	0	1	0	105	0	106
11082	0	1	0	106	0	107
11083	1	0	103	2	0	106
11084	0	1	0	105	0	106
11085	106	0	0	1	0	107
11086	0	1	0	106	0	107
11087	0	0	107	1	0	108
11088	103	0	0	2	0	105
11089	109	0	0	1	0	110
11090	108	0	1	1	0	110
11091	105	0	0	1	0	106
11092	0	0	1	106	0	107
11093	0	0	106	2	0	108
11094	0	96	0	3	0	99
11095	0	91	0	1	0	92
11096	1	1	1	79	0	82
11097	0	0	1	76	0	77
11098	0	0	0	77	0	77
11099	0	0	0	81	0	81
11100	0	0	0	89	0	89
11101	102	0	0	0	0	102
11102	0	102	0	0	0	102
11103	1	106	1	0	0	108
11104	0	1	0	114	0	115
11105	0	1	0	114	0	115
11106	0	0	0	114	0	114
11107	0	0	0	112	0	112
11108	0	0	109	1	0	110
11109	0	106	0	1	0	107
11110	0	0	1	105	0	106
11111	104	1	0	0	0	105
11112	0	0	0	105	0	105
11113	1	0	105	0	0	106
11114	0	0	102	2	0	104
11115	0	1	103	0	0	104
11116	0	0	1	105	0	106
11117	104	0	1	1	0	106
11118	0	0	0	108	0	108
11119	1	0	0	107	0	108
11120	97	0	0	2	0	99
11121	0	0	0	102	0	102
11122	1	0	0	98	0	99
11123	0	0	103	1	0	104
11124	0	104	0	1	0	105
11125	0	0	1	103	0	104
11126	106	1	0	0	0	107
11127	0	0	0	107	0	107
11128	1	0	106	0	0	107
11129	0	0	0	107	0	107
11130	0	105	1	0	0	106
11131	0	0	0	105	0	105
11132	0	1	105	0	0	106
11133	0	109	0	2	0	111
11134	1	1	2	111	0	115
11135	0	1	1	122	0	124
11136	0	0	0	124	0	124
11137	0	1	0	121	0	122
11138	0	0	117	2	0	119
11139	0	118	0	2	0	120
11140	117	0	1	2	0	120
11141	118	1	1	0	0	120
11142	1	0	0	119	0	120
11143	1	0	116	0	0	117
11144	118	0	0	1	0	119
11145	0	0	1	121	0	122
11146	1	0	121	1	0	123
11147	0	0	0	126	0	126
11148	0	0	1	124	0	125
11149	0	0	0	125	0	125
11150	0	0	126	2	0	128
11151	0	0	0	124	0	124
11152	0	125	1	1	0	127
11153	125	0	1	1	0	127
11154	126	1	0	1	0	128
11155	128	0	0	0	0	128
11156	1	126	0	1	0	128
11157	124	0	1	0	0	125
11158	1	1	0	119	0	121
11159	119	0	0	0	0	119
11160	118	0	0	1	0	119
11161	2	0	116	0	0	118
11162	1	112	0	1	0	114
11163	111	0	1	0	0	112
11164	0	1	0	107	0	108
11165	1	0	108	0	0	109
11166	0	110	0	1	0	111
11167	103	0	1	3	0	107
11168	0	2	0	105	0	107
11169	1	0	0	104	0	105
11170	0	0	0	106	0	106
11171	0	105	0	2	0	107
11172	1	0	0	107	0	108
11173	0	105	1	0	0	106
11174	0	0	0	101	0	101
11175	0	1	99	0	0	100
11176	1	0	0	101	0	102
11177	0	0	1	102	0	103
11178	0	0	1	103	0	104
11179	1	0	101	1	0	103
11180	0	0	0	103	0	103
11181	0	0	2	100	0	102
11182	0	0	0	103	0	103
11183	0	0	0	102	0	102
11184	0	0	0	101	0	101
11185	0	0	101	1	0	102
11186	0	0	0	100	0	100
11187	0	1	1	97	0	99
11188	97	0	0	1	0	98
11189	1	90	1	1	0	93
11190	2	96	0	0	0	98
11191	0	2	0	98	0	100
11192	1	1	0	95	0	97
11193	0	91	0	2	0	93
11194	1	0	0	100	0	101
11195	1	100	0	0	0	101
11196	0	0	1	100	0	101
11197	0	2	0	100	0	102
11198	1	0	97	1	0	99
11199	0	94	0	2	0	96
11200	0	87	3	1	0	91
11201	70	1	0	1	0	72
11202	1	71	2	1	0	75
11203	0	0	4	68	0	72
11204	0	1	64	1	0	66
11205	1	0	0	64	0	65
11206	66	1	0	0	0	67
11207	0	0	65	1	0	66
11208	0	69	1	0	0	70
11209	1	0	0	64	0	65
11210	0	0	1	68	0	69
11211	70	0	1	1	0	72
11212	0	0	0	74	0	74
11213	0	0	0	72	0	72
11214	0	0	1	71	0	72
11215	0	0	1	72	0	73
11216	71	0	0	1	0	72
11217	71	1	0	1	0	73
11218	1	0	0	71	0	72
11219	71	0	0	1	0	72
11220	1	0	1	69	0	71
11221	0	1	69	1	0	71
11222	1	0	69	1	0	71
11223	1	0	0	64	0	65
11224	1	65	0	0	0	66
11225	1	1	0	65	0	67
11226	63	0	1	1	0	65
11227	0	1	0	64	0	65
11228	67	1	0	0	0	68
11229	0	0	0	70	0	70
11230	0	1	77	0	0	78
11231	0	73	0	1	0	74
11232	1	75	0	1	0	77
11233	0	1	0	67	0	68
11234	0	0	69	1	0	70
11235	0	58	0	0	0	58
11236	0	0	0	58	0	58
11237	58	0	0	0	0	58
11238	0	0	58	0	0	58
11239	0	0	0	59	0	59
11240	0	0	0	62	0	62
11241	0	0	63	0	0	63
11242	0	0	61	0	0	61
11243	0	0	65	0	0	65
11244	0	0	0	63	0	63
11245	1	0	64	0	0	65
11246	66	0	0	0	0	66
11247	0	0	0	70	0	70
11248	0	0	85	0	0	85
11249	0	89	0	0	0	89
11250	0	0	91	0	0	91
11251	0	0	1	90	0	91
11252	94	0	0	1	0	95
11253	0	0	1	95	0	96
11254	0	1	0	96	0	97
11255	103	0	1	0	0	104
11256	0	0	0	104	0	104
11257	1	0	106	0	0	107
11258	104	0	0	1	0	105
11259	0	110	0	1	0	111
11260	110	0	0	1	0	111
11261	0	0	0	111	0	111
11262	0	0	110	0	0	110
11263	1	0	110	0	0	111
11264	1	1	0	110	0	112
11265	1	0	2	105	0	108
11266	0	0	108	1	0	109
11267	0	0	104	0	0	104
11268	106	0	1	0	0	107
11269	0	0	0	109	0	109
11270	106	0	0	2	0	108
11271	0	0	1	107	0	108
11272	0	0	108	0	0	108
11273	1	0	107	0	0	108
11274	0	0	0	112	0	112
11275	1	0	0	111	0	112
11276	0	0	117	1	0	118
11277	117	0	1	0	0	118
11278	0	0	1	121	0	122
11279	126	0	0	2	0	128
11280	1	148	0	1	0	150
11281	0	1	1	153	0	155
11282	154	0	0	1	0	155
11283	1	0	153	1	0	155
11284	2	0	1	153	0	156
11285	0	1	0	155	0	156
11286	0	2	0	156	0	158
11287	1	0	155	3	0	159
11288	2	0	2	154	0	158
11289	0	152	2	2	0	156
11290	0	1	0	157	0	158
11291	1	0	152	4	0	157
11292	0	0	153	2	0	155
11293	0	0	3	154	0	157
11294	1	1	0	153	0	155
11295	0	2	0	151	0	153
11296	0	0	0	154	0	154
11297	147	0	3	1	0	151
11298	150	0	2	1	0	153
11299	1	0	149	3	0	153
11300	0	151	0	3	0	154
11301	1	1	0	158	0	160
11302	157	0	0	3	0	160
11303	144	1	0	0	0	145
11304	159	0	0	0	0	159
11305	157	1	2	0	0	160
11306	1	2	155	1	0	159
11307	154	0	1	2	0	157
11308	4	152	0	0	0	156
11309	2	2	1	153	0	158
11310	4	0	155	2	0	161
11311	2	2	3	150	0	157
11312	2	0	150	2	0	154
11313	2	2	2	149	0	155
11314	0	2	0	154	0	156
11315	151	0	1	4	0	156
11316	2	0	3	150	0	155
11317	0	0	151	5	0	156
11318	0	0	5	151	0	156
11319	151	0	0	7	0	158
11320	3	0	1	157	0	161
11321	2	0	153	4	0	159
11322	1	150	2	2	0	155
11323	155	2	2	3	0	162
11324	4	0	1	159	0	164
11325	2	161	1	3	0	167
11326	162	2	0	4	0	168
11327	4	1	163	1	0	169
11328	1	161	3	1	0	166
11329	2	2	0	162	0	166
11330	1	1	154	5	0	161
11331	2	2	2	152	0	158
11332	155	0	2	2	0	159
11333	2	1	150	1	0	154
11334	1	3	2	148	0	154
11335	1	0	149	5	0	155
11336	2	0	5	149	0	156
11337	2	1	0	156	0	159
11338	152	0	1	4	0	157
11339	3	146	3	3	0	155
11340	2	2	3	151	0	158
11341	146	0	3	4	0	153
11342	152	0	0	6	0	158
11343	4	0	1	149	0	154
11344	2	146	3	3	0	154
11345	1	149	1	2	0	153
11346	2	3	0	150	0	155
11347	4	0	0	143	0	147
11348	133	0	1	2	0	136
11349	2	0	1	131	0	134
11350	2	2	124	2	0	130
11351	120	2	3	2	0	127
11352	3	121	0	4	0	128
11353	120	2	0	5	0	127
11354	4	0	123	1	0	128
11355	1	132	3	2	0	138
11356	132	1	3	2	0	138
11357	135	1	1	0	0	137
11358	1	3	133	3	0	140
11359	131	0	3	2	0	136
11360	132	0	5	0	0	137
11361	2	134	0	2	0	138
11362	3	2	1	136	0	142
11363	2	0	137	4	0	143
11364	0	0	2	138	0	140
11365	3	0	133	3	0	139
11366	3	0	4	138	0	145
11367	139	3	2	3	0	147
11368	3	0	1	147	0	151
11369	0	0	162	3	0	165
11370	164	1	3	4	0	172
11371	5	0	2	168	0	175
11372	1	1	167	5	0	174
11373	160	0	3	2	0	165
11374	4	1	1	166	0	172
11375	1	0	163	4	0	168
11376	4	0	159	0	0	163
11377	0	1	3	156	0	160
11378	0	0	159	3	0	162
11379	2	149	4	0	0	155
11380	0	3	0	127	0	130
11381	124	0	1	3	0	128
11382	3	0	129	0	0	132
11383	0	0	133	1	0	134
11384	131	0	3	0	0	134
11385	3	0	129	0	0	132
11386	127	0	4	0	0	131
11387	4	0	128	0	0	132
11388	0	0	4	129	0	133
11389	1	0	130	3	0	134
11390	0	0	4	129	0	133
11391	0	0	132	4	0	136
11392	0	0	131	0	0	131
11393	125	0	2	1	0	128
11394	3	131	1	0	0	135
11395	132	3	0	0	0	135
11396	4	135	0	0	0	139
11397	0	4	0	135	0	139
11398	1	0	0	139	0	140
11399	135	1	0	2	0	138
11400	3	0	0	133	0	136
11401	0	0	132	4	0	136
11402	130	0	2	0	0	132
11403	134	0	0	1	0	135
11404	3	0	1	130	0	134
11405	1	0	131	3	0	135
11406	1	0	3	132	0	136
11407	0	132	0	5	0	137
11408	0	1	1	134	0	136
11409	0	0	0	138	0	138
11410	0	1	135	3	0	139
11411	126	0	5	2	0	133
11412	2	132	1	1	0	136
11413	133	3	1	1	0	138
11414	5	135	0	0	0	140
11415	0	2	0	134	0	136
11416	1	140	1	2	0	144
11417	0	3	137	0	0	140
11418	0	0	3	137	0	140
11419	0	1	1	136	0	138
11420	1	0	1	137	0	139
11421	134	0	0	5	0	139
11422	3	0	1	134	0	138
11423	130	0	1	5	0	136
11424	132	0	1	1	0	134
11425	131	0	1	2	0	134
11426	5	0	128	0	0	133
11427	1	0	3	129	0	133
11428	2	0	1	133	0	136
11429	1	0	2	130	0	133
11430	132	0	1	5	0	138
11431	5	0	0	134	0	139
11432	1	0	1	136	0	138
11433	145	0	0	5	0	150
11434	4	0	1	147	0	152
11435	0	0	153	6	0	159
11436	1	0	151	1	0	153
11437	0	0	4	154	0	158
11438	150	1	2	5	0	158
11439	154	0	2	1	0	157
11440	6	0	1	152	0	159
11441	2	1	153	4	0	160
11442	2	144	4	1	0	151
11443	1	5	1	149	0	156
11444	0	0	2	153	0	155
11445	2	1	0	152	0	155
11446	149	0	2	5	0	156
11447	4	1	144	3	0	152
11448	144	0	6	1	0	151
11449	7	0	0	143	0	150
11450	1	144	2	4	0	151
11451	145	2	2	1	0	150
11452	150	0	1	1	0	152
11453	4	2	147	1	0	154
11454	3	133	3	0	0	139
11455	1	129	1	1	0	132
11456	126	2	1	3	0	132
11457	4	0	2	128	0	134
11458	2	1	0	131	0	134
11459	1	1	0	130	0	132
11460	2	118	2	4	0	126
11461	2	128	0	1	0	131
11462	124	4	0	2	0	130
11463	4	1	0	121	0	126
11464	0	2	128	3	0	133
11465	1	0	3	134	0	138
11466	0	0	149	5	0	154
11467	1	0	158	0	0	159
11468	0	0	153	2	0	155
11469	0	127	3	0	0	130
11470	1	4	3	124	0	132
11471	0	124	0	4	0	128
11472	1	3	0	117	0	121
11473	0	0	0	122	0	122
11474	121	0	0	3	0	124
11475	4	0	0	119	0	123
11476	118	0	0	3	0	121
11477	122	0	0	0	0	122
11478	3	0	0	115	0	118
11479	0	115	0	3	0	118
11480	0	3	0	115	0	118
11481	0	115	0	4	0	119
11482	0	3	0	110	0	113
11483	0	0	113	3	0	116
11484	1	0	3	112	0	116
11485	0	0	0	117	0	117
11486	111	0	0	3	0	114
11487	3	115	0	0	0	118
11488	0	3	0	115	0	118
11489	1	0	0	115	0	116
11490	0	113	0	3	0	116
11491	0	3	0	113	0	116
11492	107	0	0	3	0	110
11493	112	0	0	0	0	112
11494	3	108	0	0	0	111
11495	0	3	0	108	0	111
11496	102	0	0	4	0	106
11497	2	105	0	1	0	108
11498	3	3	0	103	0	109
11499	0	105	0	3	0	108
11500	107	3	1	0	0	111
11501	3	0	106	0	0	109
11502	0	0	104	1	0	105
11503	1	0	3	106	0	110
11504	1	0	104	3	0	108
11505	0	0	3	103	0	106
11506	101	0	1	3	0	105
11507	3	1	103	0	0	107
11508	2	0	2	103	0	107
11509	1	0	0	107	0	108
11510	106	0	0	3	0	109
11511	2	107	0	0	0	109
11512	104	2	1	0	0	107
11513	109	0	0	0	0	109
11514	1	100	0	2	0	103
11515	0	3	0	104	0	107
11516	1	0	99	2	0	102
11517	1	0	2	98	0	101
11518	0	100	1	2	0	103
11519	98	3	0	0	0	101
11520	3	1	0	99	0	103
11521	1	0	99	2	0	102
11522	0	0	2	104	0	106
11523	0	0	0	105	0	105
11524	1	0	0	102	0	103
11525	0	0	0	102	0	102
11526	0	1	0	100	0	101
11527	1	0	96	2	0	99
11528	1	0	94	1	0	96
11529	0	86	3	0	0	89
11530	0	91	1	1	0	93
11531	88	1	1	0	0	90
11532	1	0	90	0	0	91
11533	75	2	1	0	0	78
11534	1	0	73	0	0	74
11535	0	1	65	0	0	66
11536	0	0	2	65	0	67
11537	68	1	1	2	0	72
11538	3	0	1	67	0	71
11539	0	1	0	71	0	72
11540	1	0	81	2	0	84
11541	1	1	1	80	0	83
11542	0	0	0	83	0	83
11543	0	1	0	82	0	83
11544	1	0	0	82	0	83
11545	0	1	0	82	0	83
11546	80	0	0	2	0	82
11547	2	0	1	80	0	83
11548	0	0	80	3	0	83
11549	0	1	1	80	0	82
11550	1	0	76	2	0	79
11551	0	2	1	79	0	82
11552	0	0	79	3	0	82
11553	0	0	2	80	0	82
11554	0	1	0	83	0	84
11555	0	0	80	2	0	82
11556	75	0	1	0	0	76
11557	2	1	80	0	0	83
11558	0	1	1	81	0	83
11559	80	0	0	3	0	83
11560	2	0	0	81	0	83
11561	0	0	0	83	0	83
11562	1	1	81	1	0	84
11563	1	82	1	0	0	84
11564	1	74	0	0	0	75
11565	0	69	1	1	0	71
11566	2	0	1	48	0	51
11567	44	0	0	0	0	44
11568	0	0	0	49	0	49
11569	0	0	0	48	0	48
11570	0	0	0	48	0	48
11571	0	0	0	48	0	48
11572	0	49	0	0	0	49
11573	0	0	0	50	0	50
11574	0	0	0	50	0	50
11575	0	51	0	0	0	51
11576	49	0	0	0	0	49
11577	0	0	0	51	0	51
11578	50	0	0	1	0	51
11579	51	0	0	0	0	51
11580	0	51	0	0	0	51
11581	0	0	0	55	0	55
11582	0	0	55	0	0	55
11583	0	0	53	0	0	53
11584	0	1	0	54	0	55
11585	54	0	0	0	0	54
11586	55	0	0	0	0	55
11587	0	0	0	54	0	54
11588	54	0	0	1	0	55
11589	0	55	0	0	0	55
11590	54	0	0	0	0	54
11591	0	61	0	0	0	61
11592	0	0	0	62	0	62
11593	0	0	0	62	0	62
11594	0	62	0	0	0	62
11595	64	0	0	0	0	64
11596	0	1	61	0	0	62
11597	0	0	0	61	0	61
11598	0	0	62	0	0	62
11599	0	0	0	61	0	61
11600	64	0	0	0	0	64
11601	0	0	0	65	0	65
11602	64	0	0	0	0	64
11603	65	0	0	0	0	65
11604	0	0	0	65	0	65
11605	0	0	66	0	0	66
11606	0	71	0	0	0	71
11607	0	0	0	70	0	70
11608	67	0	0	1	0	68
11609	0	0	70	0	0	70
11610	0	0	0	69	0	69
11611	0	0	0	69	0	69
11612	0	0	0	71	0	71
11613	73	0	0	1	0	74
11614	0	0	0	72	0	72
11615	0	0	0	74	0	74
11616	0	0	75	0	0	75
11617	0	0	0	73	0	73
11618	0	0	0	77	0	77
11619	0	0	0	78	0	78
11620	0	81	0	0	0	81
11621	0	0	0	78	0	78
11622	0	0	0	79	0	79
11623	79	0	0	0	0	79
11624	0	0	79	0	0	79
11625	0	0	78	0	0	78
11626	0	76	0	0	0	76
11627	0	0	0	80	0	80
11628	81	0	0	0	0	81
11629	0	0	0	77	0	77
11630	0	0	0	81	0	81
11631	0	0	0	83	0	83
11632	0	0	0	83	0	83
11633	0	0	0	83	0	83
11634	0	0	85	0	0	85
11635	0	1	0	84	0	85
11636	85	0	0	0	0	85
11637	0	82	0	0	0	82
11638	0	0	0	81	0	81
11639	0	0	0	79	0	79
11640	0	0	73	0	0	73
11641	0	0	0	76	0	76
11642	0	0	0	76	0	76
11643	83	0	0	0	0	83
11644	0	84	0	0	0	84
11645	0	0	0	84	0	84
11646	0	0	0	82	0	82
11647	0	0	0	84	0	84
11648	0	0	84	0	0	84
11649	0	0	80	0	0	80
11650	0	86	0	0	0	86
11651	0	90	0	0	0	90
11652	0	0	0	88	0	88
11653	0	86	1	1	0	88
11654	0	0	0	94	0	94
11655	0	0	1	105	0	106
11656	0	0	1	106	0	107
11657	0	1	0	122	0	123
11658	0	1	126	2	0	129
11659	1	0	2	124	0	127
11660	0	1	0	128	0	129
11661	0	0	0	132	0	132
11662	132	0	0	4	0	136
11663	2	134	1	1	0	138
11664	0	2	0	133	0	135
11665	0	129	1	2	0	132
11666	126	2	0	1	0	129
11667	123	0	0	2	0	125
11668	2	125	0	1	0	128
11669	1	133	0	1	0	135
11670	0	4	129	0	0	133
11671	1	130	2	0	0	133
11672	1	3	0	131	0	135
11673	133	1	0	2	0	136
11674	3	136	0	0	0	139
11675	0	3	1	137	0	141
11676	0	1	0	138	0	139
11677	0	0	1	143	0	144
11678	142	1	0	3	0	146
11679	3	1	139	1	0	144
11680	139	0	2	1	0	142
11681	2	138	1	1	0	142
11682	1	2	0	138	0	141
11683	1	0	139	3	0	143
11684	133	0	4	1	0	138
11685	5	136	0	0	0	141
11686	0	3	1	140	0	144
11687	1	137	0	4	0	142
11688	0	3	1	138	0	142
11689	1	0	0	142	0	143
11690	0	1	136	3	0	140
11691	1	0	130	0	0	131
11692	0	2	2	132	0	136
11693	0	1	130	3	0	134
11694	0	2	2	136	0	140
11695	0	0	1	135	0	136
11696	0	0	1	138	0	139
11697	132	0	1	3	0	136
11698	2	0	2	139	0	143
11699	0	0	138	4	0	142
11700	139	0	3	1	0	143
11701	2	1	0	142	0	145
11702	2	0	0	143	0	145
11703	141	0	0	5	0	146
11704	3	149	1	1	0	154
11705	1	2	1	151	0	155
11706	0	0	2	145	0	147
11707	143	1	0	3	0	147
11708	3	0	141	1	0	145
11709	0	1	2	141	0	144
11710	0	1	0	138	0	139
11711	0	1	0	140	0	141
11712	1	136	0	4	0	141
11713	0	2	1	137	0	140
11714	135	0	0	4	0	139
11715	2	133	2	1	0	138
11716	132	2	0	4	0	138
11717	2	136	0	2	0	140
11718	134	2	0	3	0	139
11719	5	1	131	0	0	137
11720	0	2	130	1	0	133
11721	134	0	2	0	0	136
11722	2	2	135	0	0	139
11723	5	0	2	129	0	136
11724	1	1	1	129	0	132
11725	1	0	1	136	0	138
11726	136	0	1	2	0	139
11727	2	0	136	0	0	138
11728	132	0	2	2	0	136
11729	2	0	1	138	0	141
11730	138	0	0	3	0	141
11731	3	0	0	138	0	141
11732	143	0	1	4	0	148
11733	4	0	0	149	0	153
11734	0	0	161	2	0	163
11735	161	0	2	1	0	164
11736	167	0	0	2	0	169
11737	6	0	0	167	0	173
11738	2	0	0	168	0	170
11739	1	166	1	3	0	171
11740	165	3	0	2	0	170
11741	4	164	1	0	0	169
11742	163	3	0	1	0	167
11743	4	1	160	1	0	166
11744	1	1	162	0	0	164
11745	1	0	163	0	0	164
11746	162	1	5	0	0	168
11747	4	164	0	1	0	169
11748	2	3	1	158	0	164
11749	160	1	0	3	0	164
11750	3	161	0	1	0	165
11751	2	4	0	158	0	164
11752	0	158	0	3	0	161
11753	0	155	0	2	0	157
11754	1	155	0	0	0	156
11755	143	3	0	0	0	146
11756	2	144	0	0	0	146
11757	1	121	0	0	0	122
11758	0	122	0	0	0	122
11759	119	1	1	0	0	121
11760	119	0	0	0	0	119
11761	2	0	118	0	0	120
11762	109	0	1	0	0	110
11763	112	0	1	0	0	113
11764	2	0	0	110	0	112
11765	110	0	0	1	0	111
11766	1	0	106	1	0	108
11767	1	106	1	0	0	108
11768	108	1	1	0	0	110
11769	1	1	0	111	0	113
11770	113	0	0	1	0	114
11771	1	0	107	1	0	109
11772	110	0	1	0	0	111
11773	1	0	1	111	0	113
11774	1	1	109	1	0	112
11775	0	106	2	1	0	109
11776	0	114	0	0	0	114
11777	0	3	0	108	0	111
11778	0	1	0	108	0	109
11779	0	109	0	3	0	112
11780	110	2	0	2	0	114
11781	112	1	0	0	0	113
11782	112	0	0	0	0	112
11783	3	112	0	1	0	116
11784	2	2	0	108	0	112
11785	0	112	0	1	0	113
11786	111	2	0	1	0	114
11787	114	1	0	1	0	116
11788	3	109	0	1	0	113
11789	114	3	0	0	0	117
11790	2	1	0	115	0	118
11791	1	0	0	117	0	118
11792	117	0	0	3	0	120
11793	116	1	0	1	0	118
11794	119	0	0	0	0	119
11795	5	0	0	112	0	117
11796	2	0	0	118	0	120
11797	0	1	114	4	0	119
11798	0	1	2	113	0	116
11799	1	1	1	113	0	116
11800	1	0	109	4	0	114
11801	2	0	107	1	0	110
11802	0	1	113	0	0	114
11803	1	0	5	107	0	113
11804	0	0	110	4	0	114
11805	1	0	3	107	0	111
11806	1	1	1	111	0	114
11807	1	0	108	4	0	113
11808	2	0	111	1	0	114
11809	0	1	3	107	0	111
11810	0	0	109	5	0	114
11811	0	1	111	1	0	113
11812	0	110	4	1	0	115
11813	111	4	1	1	0	117
11814	113	1	1	0	0	115
11815	117	1	0	0	0	118
11816	4	113	1	0	0	118
11817	1	116	0	1	0	118
11818	0	4	1	112	0	117
11819	1	1	0	112	0	114
11820	0	0	108	6	0	114
11821	1	0	3	108	0	112
11822	108	0	2	3	0	113
11823	3	0	0	108	0	111
11824	1	106	1	3	0	111
11825	108	3	1	1	0	113
11826	111	2	0	0	0	113
11827	114	0	0	0	0	114
11828	6	0	109	1	0	116
11829	3	0	4	110	0	117
11830	127	1	0	4	0	132
11831	5	1	129	0	0	135
11832	0	121	4	2	0	127
11833	0	115	0	1	0	116
11834	95	5	1	0	0	101
11835	3	99	0	1	0	103
11836	2	3	0	96	0	101
11837	0	0	91	4	0	95
11838	0	0	3	92	0	95
11839	89	0	0	3	0	92
11840	4	89	0	0	0	93
11841	88	3	0	0	0	91
11842	3	0	87	0	0	90
11843	0	0	3	88	0	91
11844	0	88	0	3	0	91
11845	0	3	1	88	0	92
11846	86	1	0	3	0	90
11847	89	1	0	0	0	90
11848	91	0	0	0	0	91
11849	91	1	0	0	0	92
11850	3	0	0	86	0	89
11851	0	0	90	3	0	93
11852	1	1	4	84	0	90
11853	1	88	0	3	0	92
11854	90	5	0	0	0	95
11855	5	0	89	0	0	94
11856	89	1	4	0	0	94
11857	3	0	0	88	0	91
11858	0	1	90	3	0	94
11859	0	0	3	89	0	92
11860	96	0	0	3	0	99
11861	98	1	0	0	0	99
11862	98	0	0	0	0	98
11863	5	0	92	0	0	97
11864	0	0	3	96	0	99
11865	0	1	95	3	0	99
11866	0	95	3	2	0	100
11867	96	4	0	0	0	100
11868	5	96	0	1	0	102
11869	91	3	0	0	0	94
11870	4	0	0	91	0	95
11871	0	90	0	4	0	94
11872	87	3	1	0	0	91
11873	3	0	87	1	0	91
11874	0	1	2	90	0	93
11875	91	0	0	2	0	93
11876	2	0	87	0	0	89
11877	1	0	2	81	0	84
11878	0	85	0	3	0	88
11879	0	2	1	85	0	88
11880	0	0	0	86	0	86
11881	83	0	0	2	0	85
11882	3	78	0	0	0	81
11883	1	2	0	80	0	83
11884	0	82	1	2	0	85
11885	0	2	0	83	0	85
11886	0	87	1	1	0	89
11887	87	3	0	0	0	90
11888	3	0	90	0	0	93
11889	0	1	2	87	0	90
11890	1	0	0	90	0	91
11891	0	0	0	92	0	92
11892	0	0	0	85	0	85
11893	1	0	85	2	0	88
11894	0	86	3	0	0	89
11895	86	2	0	1	0	89
11896	87	0	0	0	0	87
11897	2	86	1	0	0	89
11898	87	2	0	0	0	89
11899	85	1	0	0	0	86
11900	1	88	0	1	0	90
11901	0	1	0	91	0	92
11902	1	90	0	1	0	92
11903	90	2	0	0	0	92
11904	1	0	89	1	0	91
11905	84	1	1	0	0	86
11906	1	0	91	0	0	92
11907	0	1	1	92	0	94
11908	94	0	0	1	0	95
11909	1	0	95	0	0	96
11910	90	0	1	1	0	92
11911	96	0	0	2	0	98
11912	1	0	0	94	0	95
11913	0	92	0	2	0	94
11914	96	1	1	0	0	98
11915	1	1	0	96	0	98
11916	1	94	0	1	0	96
11917	94	1	0	0	0	95
11918	1	0	0	95	0	96
11919	1	103	0	1	0	105
11920	1	1	0	105	0	107
11921	106	1	0	1	0	108
11922	107	0	0	1	0	108
11923	107	1	0	0	0	108
11924	2	0	0	108	0	110
11925	0	0	1	107	0	108
11926	1	0	106	0	0	107
11927	0	0	1	114	0	115
11928	0	0	116	1	0	117
11929	1	0	105	0	0	106
11930	0	0	96	0	0	96
11931	0	99	0	0	0	99
11932	0	0	0	97	0	97
11933	0	115	0	0	0	115
11934	115	0	0	0	0	115
11935	118	0	0	0	0	118
11936	0	0	0	121	0	121
11937	0	0	130	0	0	130
11938	1	0	1	134	0	136
11939	0	0	140	1	0	141
11940	0	0	1	138	0	139
11941	0	139	0	1	0	140
11942	0	143	0	0	0	143
11943	139	1	0	0	0	140
11944	1	0	146	0	0	147
11945	0	0	1	142	0	143
11946	0	0	0	150	0	150
11947	149	0	0	1	0	150
11948	1	149	0	0	0	150
11949	147	1	0	0	0	148
11950	1	154	0	0	0	155
11951	150	1	0	0	0	151
11952	155	0	0	0	0	155
11953	1	0	0	156	0	157
11954	0	0	157	1	0	158
11955	152	0	1	0	0	153
11956	1	156	0	0	0	157
11957	155	1	0	0	0	156
11958	1	0	0	155	0	156
11959	0	0	0	155	0	155
11960	0	154	0	1	0	155
11961	0	1	0	152	0	153
11962	0	153	0	3	0	156
11963	0	1	0	153	0	154
11964	0	0	0	154	0	154
11965	152	0	0	1	0	153
11966	1	0	152	0	0	153
11967	0	150	1	0	0	151
11968	0	1	0	150	0	151
11969	152	0	0	1	0	153
11970	153	0	0	0	0	153
11971	151	0	0	0	0	151
11972	1	0	150	0	0	151
11973	152	0	1	0	0	153
11974	0	0	0	153	0	153
11975	152	0	0	1	0	153
11976	1	149	0	0	0	150
11977	0	1	0	154	0	155
11978	153	0	0	1	0	154
11979	1	156	0	0	0	157
11980	0	1	0	156	0	157
11981	0	0	158	1	0	159
11982	159	0	1	1	0	161
11983	167	0	0	0	0	167
11984	1	0	166	0	0	167
11985	0	166	1	0	0	167
11986	0	165	0	0	0	165
11987	0	1	0	167	0	168
11988	0	0	1	162	0	163
11989	1	0	0	166	0	167
11990	0	0	176	1	0	177
11991	175	0	2	0	0	177
11992	182	0	0	0	0	182
11993	181	0	0	0	0	181
11994	184	0	0	0	0	184
11995	193	0	0	0	0	193
11996	197	1	1	0	0	199
11997	2	0	0	199	0	201
11998	0	0	197	2	0	199
11999	0	1	201	1	0	203
12000	0	1	3	202	0	206
12001	0	2	0	200	0	202
12002	1	0	0	207	0	208
12003	0	205	1	2	0	208
12004	203	2	0	1	0	206
12005	3	206	0	1	0	210
12006	1	2	0	205	0	208
12007	203	0	1	3	0	207
12008	3	206	0	1	0	210
12009	0	3	1	205	0	209
12010	0	0	0	205	0	205
12011	1	0	0	201	0	202
12012	0	200	0	3	0	203
12013	1	2	1	201	0	205
12014	1	0	202	2	0	205
12015	0	1	2	205	0	208
12016	0	0	0	210	0	210
12017	1	0	0	219	0	220
12018	0	1	0	222	0	223
12019	1	2	208	2	0	213
12020	0	211	2	2	0	215
12021	1	2	0	211	0	214
12022	1	0	1	217	0	219
12023	0	1	0	217	0	218
12024	2	203	1	3	0	209
12025	1	210	1	1	0	213
12026	210	4	0	1	0	215
12027	3	1	0	201	0	205
12028	0	1	202	2	0	205
12029	2	199	2	0	0	203
12030	193	2	0	1	0	196
12031	2	0	195	0	0	197
12032	1	1	190	0	0	192
12033	1	0	180	1	0	182
12034	3	2	4	171	0	180
12035	0	1	174	2	0	177
12036	0	171	4	1	0	176
12037	0	2	0	154	0	156
12038	0	0	156	2	0	158
12039	0	1	3	148	0	152
12040	148	1	0	2	0	151
12041	2	0	148	1	0	151
12042	142	0	1	2	0	145
12043	3	148	0	0	0	151
12044	142	4	0	0	0	146
12045	3	1	0	143	0	147
12046	141	1	0	2	0	144
12047	139	0	0	1	0	140
12048	139	0	1	1	0	141
12049	3	145	0	0	0	148
12050	142	2	0	0	0	144
12051	143	0	1	0	0	144
12052	2	1	136	0	0	139
12053	1	134	3	0	0	138
12054	1	2	0	139	0	142
12055	0	0	2	139	0	141
12056	1	2	0	137	0	140
12057	0	0	137	4	0	141
12058	0	0	3	137	0	140
12059	0	0	137	4	0	141
12060	136	0	3	0	0	139
12061	136	0	1	1	0	138
12062	3	0	137	0	0	140
12063	137	1	2	0	0	140
12064	140	0	0	0	0	140
12065	139	0	1	1	0	141
12066	4	0	0	138	0	142
12067	2	0	140	2	0	144
12068	2	137	2	1	0	142
12069	0	3	0	140	0	143
12070	1	0	142	2	0	145
12071	1	1	141	0	0	143
12072	137	0	3	1	0	141
12073	2	139	1	0	0	142
12074	149	2	1	1	0	153
12075	152	0	0	1	0	153
12076	1	153	0	1	0	155
12077	152	1	1	1	0	155
12078	2	0	158	1	0	161
12079	0	1	163	0	0	164
12080	2	0	161	0	0	163
12081	1	156	2	0	0	159
12082	157	2	2	0	0	161
12083	153	0	2	0	0	155
12084	3	152	0	0	0	155
12085	2	158	0	0	0	160
12086	1	2	0	159	0	162
12087	0	1	2	158	0	161
12088	158	2	0	2	0	162
12089	2	163	0	2	0	167
12090	153	1	2	1	0	157
12091	152	0	1	0	0	153
12092	2	1	149	0	0	152
12093	1	151	1	0	0	153
12094	2	0	1	146	0	149
12095	138	0	2	1	0	141
12096	1	2	0	134	0	137
12097	130	0	0	2	0	132
12098	2	0	127	0	0	129
12099	0	125	2	1	0	128
12100	0	122	1	0	0	123
12101	1	2	2	121	0	126
12102	1	122	0	2	0	125
12103	122	3	0	0	0	125
12104	1	1	120	0	0	122
12105	115	2	1	0	0	118
12106	2	0	123	1	0	126
12107	0	0	1	122	0	123
12108	2	0	0	119	0	121
12109	0	1	1	121	0	123
12110	120	0	0	2	0	122
12111	2	0	118	1	0	121
12112	1	0	2	127	0	130
12113	1	1	0	129	0	131
12114	0	126	1	2	0	129
12115	1	123	0	1	0	125
12116	0	128	0	2	0	130
12117	1	2	0	116	0	119
12118	0	0	1	116	0	117
12119	0	112	0	1	0	113
12120	0	114	0	0	0	114
12121	114	3	0	0	0	117
12122	1	0	0	114	0	115
12123	0	112	0	1	0	113
12124	114	1	0	0	0	115
12125	0	0	0	114	0	114
12126	124	0	0	1	0	125
12127	1	0	0	133	0	134
12128	0	0	141	1	0	142
12129	0	138	1	0	0	139
12130	143	1	0	0	0	144
12131	1	0	141	0	0	142
12132	0	138	0	0	0	138
12133	0	0	0	143	0	143
12134	0	0	0	144	0	144
12135	0	0	0	140	0	140
12136	0	0	0	141	0	141
12137	0	0	142	0	0	142
12138	0	143	0	0	0	143
12139	0	0	0	141	0	141
12140	144	0	0	0	0	144
12141	0	140	0	0	0	140
12142	0	0	0	154	0	154
12143	0	0	152	0	0	152
12144	0	144	0	0	0	144
12145	1	0	0	139	0	140
12146	0	152	0	0	0	152
12147	156	0	0	0	0	156
12148	156	0	0	0	0	156
12149	0	0	151	0	0	151
12150	155	0	0	0	0	155
12151	154	0	0	0	0	154
12152	0	0	153	0	0	153
12153	0	152	0	0	0	152
12154	0	0	0	148	0	148
12155	1	0	0	153	0	154
12156	154	0	0	0	0	154
12157	0	0	0	155	0	155
12158	0	0	156	0	0	156
12159	153	0	0	0	0	153
12160	0	0	157	0	0	157
12161	0	158	0	0	0	158
12162	157	0	0	0	0	157
12163	0	0	155	0	0	155
12164	0	0	152	1	0	153
12165	0	160	0	0	0	160
12166	0	0	0	159	0	159
12167	0	0	160	0	0	160
12168	0	0	0	154	0	154
12169	0	0	0	159	0	159
12170	0	0	158	0	0	158
12171	0	160	0	0	0	160
12172	1	0	0	160	0	161
12173	159	0	0	0	0	159
12174	151	0	0	0	0	151
12175	0	0	0	151	0	151
12176	0	0	151	0	0	151
12177	0	0	154	0	0	154
12178	0	0	0	147	0	147
12179	0	0	145	0	0	145
12180	143	0	0	0	0	143
12181	0	0	0	143	0	143
12182	0	0	0	139	0	139
12183	0	141	0	0	0	141
12184	0	0	0	142	0	142
12185	0	0	139	0	0	139
12186	134	0	0	0	0	134
12187	135	0	0	0	0	135
12188	0	0	137	0	0	137
12189	0	0	0	153	0	153
12190	1	0	0	156	0	157
12191	0	0	157	1	0	158
12192	1	0	1	162	0	164
12193	0	0	0	159	0	159
12194	0	165	1	1	0	167
12195	0	1	0	168	0	169
12196	0	0	0	172	0	172
12197	175	0	0	3	0	178
12198	184	0	0	0	0	184
12199	187	0	0	0	0	187
12200	186	0	0	0	0	186
12201	181	0	0	0	0	181
12202	3	0	179	0	0	182
12203	0	0	3	180	0	183
12204	0	0	0	184	0	184
12205	0	0	181	2	0	183
12206	174	0	3	0	0	177
12207	180	0	0	0	0	180
12208	3	0	174	0	0	177
12209	178	1	1	0	0	180
12210	183	0	0	0	0	183
12211	3	0	177	0	0	180
12212	0	0	3	172	0	175
12213	0	177	0	2	0	179
12214	0	3	0	185	0	188
12215	1	0	0	186	0	187
12216	0	0	0	179	0	179
12217	0	0	177	3	0	180
12218	175	0	3	0	0	178
12219	178	0	0	0	0	178
12220	3	0	0	177	0	180
12221	0	0	175	3	0	178
12222	0	0	3	173	0	176
12223	0	0	177	3	0	180
12224	0	0	179	0	0	179
12225	0	179	4	0	0	183
12226	3	6	0	167	0	176
12227	165	0	0	4	0	169
12228	159	0	0	0	0	159
12229	164	0	0	0	0	164
12230	5	0	0	156	0	161
12231	0	166	0	6	0	172
12232	0	5	1	167	0	173
12233	1	0	176	5	0	182
12234	192	0	5	0	0	197
12235	210	0	1	0	0	211
12236	7	0	0	203	0	210
12237	0	0	0	213	0	213
12238	0	0	1	213	0	214
12239	0	0	205	8	0	213
12240	199	0	7	0	0	206
12241	7	196	0	0	0	203
12242	0	200	0	1	0	201
12243	0	5	195	1	0	201
12244	0	0	7	194	0	201
12245	1	0	195	7	0	203
12246	190	0	7	0	0	197
12247	8	0	0	188	0	196
12248	1	0	189	7	0	197
12249	0	195	8	0	0	203
12250	198	6	0	0	0	204
12251	7	0	203	0	0	210
12252	0	197	7	0	0	204
12253	1	204	1	0	0	206
12254	204	7	0	0	0	211
12255	7	0	1	203	0	211
12256	1	0	204	9	0	214
12257	1	206	8	0	0	215
12258	206	8	1	2	0	217
12259	212	0	1	3	0	216
12260	9	205	1	0	0	215
12261	0	10	212	0	0	222
12262	2	1	8	210	0	221
12263	209	0	1	9	0	219
12264	216	1	1	1	0	219
12265	8	1	204	0	0	213
12266	2	0	7	206	0	215
12267	1	0	0	209	0	210
12268	1	0	205	8	0	214
12269	0	2	210	1	0	213
12270	206	0	8	3	0	217
12271	213	0	3	1	0	217
12272	215	2	1	0	0	218
12273	213	1	1	1	0	216
12274	10	1	199	1	0	211
12275	208	0	8	2	0	218
12276	10	0	1	205	0	216
12277	1	1	207	9	0	218
12278	2	1	210	0	0	213
12279	2	210	8	2	0	222
12280	0	9	1	206	0	216
12281	1	0	211	9	0	221
12282	211	0	7	2	0	220
12283	9	1	1	202	0	213
12284	2	214	0	7	0	223
12285	212	7	2	1	0	222
12286	223	0	1	1	0	225
12287	7	1	213	1	0	222
12288	1	211	11	0	0	223
12289	1	7	2	191	0	201
12290	193	1	0	7	0	201
12291	8	0	1	190	0	199
12292	3	0	179	7	0	189
12293	174	0	7	2	0	183
12294	7	185	1	0	0	193
12295	1	180	0	1	0	182
12296	1	192	0	1	0	194
12297	187	6	4	0	0	197
12298	185	2	1	0	0	188
12299	184	1	1	1	0	187
12300	5	1	0	181	0	187
12301	2	0	177	5	0	184
12302	3	0	5	177	0	185
12303	182	0	1	5	0	188
12304	5	1	0	182	0	188
12305	185	0	1	5	0	191
12306	190	0	1	1	0	192
12307	190	0	2	0	0	192
12308	6	186	0	1	0	193
12309	186	5	0	1	0	192
12310	8	0	181	0	0	189
12311	2	0	197	1	0	200
12312	0	197	7	0	0	204
12313	5	5	1	185	0	196
12314	184	1	1	6	0	192
12315	5	1	184	0	0	190
12316	180	2	6	0	0	188
12317	6	1	0	185	0	192
12318	2	189	0	6	0	197
12319	2	5	2	192	0	201
12320	2	0	192	6	0	200
12321	192	0	6	1	0	199
12322	5	2	200	1	0	208
12323	2	0	197	1	0	200
12324	194	0	5	1	0	200
12325	5	200	1	0	0	206
12326	207	5	1	0	0	213
12327	212	0	0	1	0	213
12328	6	1	203	0	0	210
12329	201	1	3	1	0	206
12330	4	0	206	0	0	210
12331	1	0	200	0	0	201
12332	0	1	200	0	0	201
12333	2	192	2	0	0	196
12334	170	1	9	2	0	182
12335	170	1	1	0	0	172
12336	168	0	0	1	0	169
12337	168	1	1	2	0	172
12338	1	1	168	1	0	171
12339	2	0	1	171	0	174
12340	1	0	0	172	0	173
12341	177	0	0	1	0	178
12342	2	178	1	0	0	181
12343	0	1	0	178	0	179
12344	176	1	0	2	0	179
12345	3	0	181	0	0	184
12346	0	1	2	180	0	183
12347	0	0	185	2	0	187
12348	1	183	1	0	0	185
12349	2	1	1	174	0	178
12350	173	0	0	2	0	175
12351	1	0	1	167	0	169
12352	1	1	168	1	0	171
12353	0	169	1	1	0	171
12354	168	2	0	0	0	170
12355	0	0	171	0	0	171
12356	168	0	1	0	0	169
12357	1	171	0	0	0	172
12358	172	0	1	0	0	173
12359	171	0	2	1	0	174
12360	1	0	0	171	0	172
12361	0	1	164	0	0	165
12362	1	170	0	0	0	171
12363	1	0	0	179	0	180
12364	0	0	1	189	0	190
12365	1	0	0	202	0	203
12366	0	0	1	212	0	213
12367	0	236	1	1	0	238
12368	246	1	0	0	0	247
12369	1	246	0	0	0	247
12370	3	1	0	264	0	268
12371	270	0	0	1	0	271
12372	5	0	0	265	0	270
12373	0	0	268	1	0	269
12374	0	262	2	4	0	268
12375	1	1	0	267	0	269
12376	0	0	0	272	0	272
12377	265	0	0	1	0	266
12378	1	1	263	0	0	265
12379	259	0	1	1	0	261
12380	259	0	0	0	0	259
12381	258	0	1	0	0	259
12382	1	0	258	1	0	260
12383	0	0	1	255	0	256
12384	1	1	0	252	0	254
12385	0	0	251	2	0	253
12386	1	0	252	0	0	253
12387	254	0	1	1	0	256
12388	2	0	1	256	0	259
12389	255	1	0	3	0	259
12390	263	0	0	0	0	263
12391	1	0	1	262	0	264
12392	1	0	276	1	0	278
12393	271	2	1	0	0	274
12394	3	0	0	269	0	272
12395	1	0	271	2	0	274
12396	1	266	1	3	0	271
12397	262	1	1	0	0	264
12398	2	263	0	0	0	265
12399	3	2	0	251	0	256
12400	1	265	0	5	0	271
12401	266	1	0	2	0	269
12402	273	0	0	1	0	274
12403	1	270	0	2	0	273
12404	272	1	2	0	0	275
12405	265	1	1	1	0	268
12406	2	269	0	1	0	272
12407	268	1	0	2	0	271
12408	2	0	0	266	0	268
12409	3	0	1	264	0	268
12410	267	0	0	2	0	269
12411	2	0	1	249	0	252
12412	2	257	0	1	0	260
12413	254	1	1	1	0	257
12414	254	0	1	1	0	256
12415	1	258	0	1	0	260
12416	260	1	1	0	0	262
12417	261	1	1	0	0	263
12418	3	0	0	254	0	257
12419	0	1	254	3	0	258
12420	1	251	1	0	0	253
12421	253	1	0	0	0	254
12422	248	2	0	1	0	251
12423	3	0	242	1	0	246
12424	247	0	1	1	0	249
12425	1	1	236	1	0	239
12426	235	0	3	0	0	238
12427	1	2	0	236	0	239
12428	1	0	232	3	0	236
12429	3	1	233	1	0	238
12430	1	2	1	233	0	237
12431	0	2	1	230	0	233
12432	3	0	226	1	0	230
12433	3	0	1	225	0	229
12434	1	2	223	1	0	227
12435	2	0	2	221	0	225
12436	2	0	0	216	0	218
12437	0	212	0	3	0	215
12438	2	212	1	0	0	215
12439	0	221	1	1	0	223
12440	2	1	0	218	0	221
12441	3	0	0	216	0	219
12442	1	0	212	3	0	216
12443	208	1	2	0	0	211
12444	211	1	1	2	0	215
12445	3	205	0	0	0	208
12446	203	2	0	2	0	207
12447	3	0	1	204	0	208
12448	202	0	2	1	0	205
12449	201	1	0	2	0	204
12450	3	0	1	200	0	204
12451	199	2	1	2	0	204
12452	2	196	1	2	0	201
12453	1	196	1	0	0	198
12454	2	1	1	195	0	199
12455	1	198	1	2	0	202
12456	0	2	2	198	0	202
12457	2	1	0	200	0	203
12458	195	1	0	3	0	199
12459	2	193	0	2	0	197
12460	195	1	1	1	0	198
12461	188	0	1	3	0	192
12462	2	185	1	2	0	190
12463	182	1	1	0	0	184
12464	2	1	171	3	0	177
12465	1	161	3	0	0	165
12466	145	1	0	3	0	149
12467	2	0	122	0	0	124
12468	1	107	0	0	0	108
12469	1	108	0	1	0	110
12470	90	0	0	1	0	91
12471	88	0	0	1	0	89
12472	88	0	0	0	0	88
12473	0	88	0	0	0	88
12474	0	0	0	90	0	90
12475	90	0	0	0	0	90
12476	88	0	0	0	0	88
12477	0	0	0	89	0	89
12478	0	0	89	0	0	89
12479	0	0	89	0	0	89
12480	0	0	0	88	0	88
12481	0	0	0	90	0	90
12482	0	0	87	0	0	87
12483	0	0	0	86	0	86
12484	0	89	0	0	0	89
12485	89	0	0	0	0	89
12486	0	0	0	87	0	87
12487	85	0	0	0	0	85
12488	0	86	0	0	0	86
12489	0	91	0	0	0	91
12490	86	0	0	0	0	86
12491	0	0	85	0	0	85
12492	71	0	0	0	0	71
12493	0	73	0	0	0	73
12494	0	0	0	66	0	66
12495	66	0	0	0	0	66
12496	0	0	0	65	0	65
12497	69	0	0	1	0	70
12498	69	0	0	0	0	69
12499	0	67	0	0	0	67
12500	63	0	0	0	0	63
12501	0	63	0	0	0	63
12502	62	0	0	0	0	62
12503	0	0	0	59	0	59
12504	59	0	0	0	0	59
12505	0	0	0	59	0	59
12506	62	0	0	0	0	62
12507	67	0	0	0	0	67
12508	65	0	0	1	0	66
12509	68	0	0	0	0	68
12510	69	0	0	0	0	69
12511	0	0	0	68	0	68
12512	67	0	0	0	0	67
12513	0	66	0	0	0	66
12514	0	0	67	0	0	67
12515	0	0	0	65	0	65
12516	0	0	66	0	0	66
12517	0	0	0	66	0	66
12518	0	0	66	0	0	66
12519	66	0	0	0	0	66
12520	0	0	0	67	0	67
12521	0	0	67	0	0	67
12522	0	0	66	0	0	66
12523	0	0	0	69	0	69
12524	75	0	0	2	0	77
12525	0	78	0	0	0	78
12526	77	0	0	0	0	77
12527	77	0	0	0	0	77
12528	0	77	0	0	0	77
12529	79	0	0	0	0	79
12530	0	0	0	80	0	80
12531	0	0	0	80	0	80
12532	0	0	0	79	0	79
12533	80	0	0	0	0	80
12534	0	79	0	0	0	79
12535	1	0	0	81	0	82
12536	0	0	0	83	0	83
12537	83	0	0	0	0	83
12538	0	0	0	80	0	80
12539	0	0	90	0	0	90
12540	0	99	0	0	0	99
12541	99	0	1	0	0	100
12542	0	1	0	98	0	99
12543	1	104	0	0	0	105
12544	106	0	0	1	0	107
12545	0	1	104	0	0	105
12546	1	105	0	0	0	106
12547	106	0	1	0	0	107
12548	0	1	0	106	0	107
12549	0	0	0	104	0	104
12550	0	0	105	1	0	106
12551	0	0	0	104	0	104
12552	0	0	111	0	0	111
12553	0	0	106	1	0	107
12554	0	0	111	0	0	111
12555	114	0	1	0	0	115
12556	113	0	1	0	0	114
12557	116	0	0	0	0	116
12558	1	0	0	113	0	114
12559	1	114	0	0	0	115
12560	0	117	0	1	0	118
12561	115	1	0	0	0	116
12562	113	3	0	1	0	117
12563	1	114	0	0	0	115
12564	113	0	0	1	0	114
12565	0	2	114	0	0	116
12566	1	0	114	0	0	115
12567	0	0	1	112	0	113
12568	0	0	1	115	0	116
12569	0	0	116	1	0	117
12570	0	0	0	112	0	112
12571	113	0	1	0	0	114
12572	0	0	112	1	0	113
12573	114	0	0	0	0	114
12574	0	0	1	115	0	116
12575	1	0	114	0	0	115
12576	0	116	0	1	0	117
12577	117	0	1	0	0	118
12578	0	1	113	0	0	114
12579	114	0	0	0	0	114
12580	0	0	1	114	0	115
12581	114	0	0	1	0	115
12582	0	0	120	1	0	121
12583	2	0	0	118	0	120
12584	124	0	1	0	0	125
12585	124	0	0	1	0	125
12586	127	0	0	0	0	127
12587	128	0	0	0	0	128
12588	1	0	0	121	0	122
12589	1	0	0	121	0	122
12590	0	0	127	1	0	128
12591	0	0	0	125	0	125
12592	1	0	1	122	0	124
12593	0	129	0	2	0	131
12594	138	0	0	1	0	139
12595	146	1	0	0	0	147
12596	2	151	0	0	0	153
12597	2	1	0	148	0	151
12598	0	2	0	150	0	152
12599	145	0	0	6	0	151
12600	2	0	152	2	0	156
12601	2	0	1	156	0	159
12602	0	0	157	3	0	160
12603	154	0	2	2	0	158
12604	160	0	2	0	0	162
12605	164	0	0	0	0	164
12606	3	1	0	154	0	158
12607	2	0	0	151	0	153
12608	152	0	0	5	0	157
12609	3	0	152	2	0	157
12610	2	0	3	151	0	156
12611	151	0	2	4	0	157
12612	2	0	1	156	0	159
12613	3	0	175	2	0	180
12614	2	0	171	2	0	175
12615	172	0	4	0	0	176
12616	2	169	3	1	0	175
12617	179	2	0	1	0	182
12618	180	2	0	0	0	182
12619	4	0	1	177	0	182
12620	2	0	0	177	0	179
12621	1	176	0	4	0	181
12622	180	2	0	3	0	185
12623	1	181	1	0	0	183
12624	1	175	0	0	0	176
12625	3	4	0	170	0	177
12626	173	3	0	1	0	177
12627	176	0	0	3	0	179
12628	4	0	0	171	0	175
12629	2	0	0	173	0	175
12630	0	0	0	173	0	173
12631	168	1	0	4	0	173
12632	3	0	168	2	0	173
12633	2	169	2	0	0	173
12634	171	3	2	0	0	176
12635	1	2	0	176	0	179
12636	3	0	179	2	0	184
12637	3	0	176	2	0	181
12638	0	182	4	1	0	187
12639	0	183	1	1	0	185
12640	0	3	0	172	0	175
12641	1	166	0	2	0	169
12642	0	2	1	171	0	174
12643	0	2	0	171	0	173
12644	174	0	0	3	0	177
12645	2	0	0	175	0	177
12646	1	0	0	177	0	178
12647	0	0	176	3	0	179
12648	0	0	1	180	0	181
12649	180	1	1	3	0	185
12650	185	0	0	2	0	187
12651	2	195	0	0	0	197
12652	191	2	0	0	0	193
12653	2	1	194	1	0	198
12654	2	194	2	1	0	199
12655	0	2	1	201	0	204
12656	1	1	0	198	0	200
12657	0	0	2	198	0	200
12658	197	1	0	4	0	202
12659	190	0	0	5	0	195
12660	4	0	194	1	0	199
12661	1	1	191	1	0	194
12662	1	0	200	0	0	201
12663	1	196	3	0	0	200
12664	0	200	1	0	0	201
12665	198	2	1	1	0	202
12666	198	1	0	1	0	200
12667	3	1	0	201	0	205
12668	2	1	0	202	0	205
12669	2	202	0	2	0	206
12670	1	1	1	206	0	209
12671	0	1	204	3	0	208
12672	0	202	3	2	0	207
12673	0	2	2	206	0	210
12674	1	2	210	3	0	216
12675	1	0	2	209	0	212
12676	1	209	2	2	0	214
12677	212	2	0	4	0	218
12678	209	2	1	1	0	213
12679	226	1	0	1	0	228
12680	4	1	0	224	0	229
12681	2	0	1	227	0	230
12682	224	1	0	5	0	230
12683	3	225	0	2	0	230
12684	226	4	0	1	0	231
12685	3	2	237	0	0	242
12686	239	0	3	0	0	242
12687	244	1	2	1	0	248
12688	6	0	0	243	0	249
12689	245	0	1	3	0	249
12690	249	0	0	2	0	251
12691	7	0	0	245	0	252
12692	2	0	247	5	0	254
12693	244	0	4	3	0	251
12694	5	0	247	0	0	252
12695	2	242	3	1	0	248
12696	1	2	2	238	0	243
12697	2	0	0	246	0	248
12698	272	1	0	3	0	276
12699	2	1	282	2	0	287
12700	1	0	2	275	0	278
12701	0	279	1	3	0	283
12702	2	282	1	1	0	286
12703	2	3	1	281	0	287
12704	0	0	278	3	0	281
12705	0	2	3	277	0	282
12706	0	1	2	275	0	278
12707	0	2	272	4	0	278
12708	0	278	3	1	0	282
12709	272	2	1	1	0	276
12710	3	281	0	1	0	285
12711	0	2	1	278	0	281
12712	272	2	0	3	0	277
12713	3	252	0	1	0	256
12714	1	3	259	1	0	264
12715	255	0	2	1	0	258
12716	3	258	1	0	0	262
12717	257	3	0	2	0	262
12718	2	1	252	0	0	255
12719	253	0	2	0	0	255
12720	2	2	1	255	0	260
12721	3	1	254	2	0	260
12722	2	0	3	247	0	252
12723	2	251	1	2	0	256
12724	0	2	0	258	0	260
12725	0	1	0	259	0	260
12726	1	0	248	4	0	253
12727	1	2	2	254	0	259
12728	1	0	236	3	0	240
12729	0	254	3	2	0	259
12730	0	2	2	254	0	258
12731	1	1	260	3	0	265
12732	0	255	3	2	0	260
12733	1	263	0	0	0	264
12734	1	3	262	1	0	267
12735	0	1	250	1	0	252
12736	0	1	4	249	0	254
12737	248	1	1	3	0	253
12738	3	247	1	1	0	252
12739	1	4	1	243	0	249
12740	242	1	0	5	0	248
12741	4	247	0	2	0	253
12742	245	4	0	0	0	249
12743	3	247	1	1	0	252
12744	248	3	0	0	0	251
12745	248	3	0	0	0	251
12746	253	1	0	0	0	254
12747	5	260	0	0	0	265
12748	2	4	0	254	0	260
12749	2	1	253	4	0	260
12750	1	250	5	2	0	258
12751	1	4	2	238	0	245
12752	2	1	0	240	0	243
12753	0	1	228	5	0	234
12754	1	226	3	1	0	231
12755	224	3	1	0	0	228
12756	3	222	0	1	0	226
12757	2	3	1	223	0	229
12758	1	1	223	3	0	228
12759	218	0	3	1	0	222
12760	3	1	1	227	0	232
12761	1	0	221	4	0	226
12762	212	0	3	2	0	217
12763	4	212	1	0	0	217
12764	213	3	1	0	0	217
12765	216	1	0	1	0	218
12766	4	2	0	212	0	218
12767	1	0	214	4	0	219
12768	0	211	3	2	0	216
12769	0	3	212	0	0	215
12770	1	1	3	204	0	209
12771	0	0	1	215	0	216
12772	209	0	1	3	0	213
12773	3	2	210	0	0	215
12774	0	202	3	4	0	209
12775	0	5	1	206	0	212
12776	0	1	0	210	0	211
12777	204	0	1	4	0	209
12778	3	206	0	1	0	210
12779	0	2	1	194	0	197
12780	192	1	0	3	0	196
12781	3	187	1	0	0	191
12782	183	4	0	1	0	188
12783	183	0	0	1	0	184
12784	2	183	1	0	0	186
12785	163	2	0	1	0	166
12786	1	162	1	1	0	165
12787	161	2	1	0	0	164
12788	162	0	0	1	0	163
12789	2	160	1	0	0	163
12790	152	1	0	0	0	153
12791	156	1	0	0	0	157
12792	155	0	0	1	0	156
12793	2	0	157	0	0	159
12794	0	1	152	1	0	154
12795	0	0	155	0	0	155
12796	152	1	2	1	0	156
12797	1	0	148	1	0	150
12798	1	0	120	1	0	122
12799	2	0	2	105	0	109
12800	103	1	0	1	0	105
12801	1	0	103	1	0	105
12802	0	1	100	1	0	102
12803	1	0	1	98	0	100
12804	1	1	0	99	0	101
12805	2	0	0	100	0	102
12806	1	1	99	1	0	102
12807	0	1	1	99	0	101
12808	102	0	0	1	0	103
12809	2	101	0	0	0	103
12810	1	2	0	101	0	104
12811	3	0	0	102	0	105
12812	0	2	103	1	0	106
12813	2	101	1	0	0	104
12814	99	2	0	0	0	101
12815	2	101	0	0	0	103
12816	2	1	0	102	0	105
12817	1	0	102	1	0	104
12818	2	0	1	103	0	106
12819	1	0	1	104	0	106
12820	110	0	1	1	0	112
12821	1	0	2	107	0	110
12822	1	105	1	1	0	108
12823	0	105	2	0	0	107
12824	1	1	110	0	0	112
12825	108	0	2	1	0	111
12826	2	0	1	108	0	111
12827	0	0	1	110	0	111
12828	2	0	1	109	0	112
12829	115	0	1	2	0	118
12830	1	115	1	1	0	118
12831	108	1	0	2	0	111
12832	0	0	101	1	0	102
12833	0	0	99	1	0	100
12834	104	0	2	0	0	106
12835	1	1	1	102	0	105
12836	3	0	0	103	0	106
12837	0	1	1	103	0	105
12838	0	0	101	1	0	102
12839	98	1	0	1	0	100
12840	104	0	1	2	0	107
12841	96	1	1	2	0	100
12842	3	0	1	95	0	99
12843	0	1	93	3	0	97
12844	1	2	83	2	0	88
12845	0	2	87	2	0	91
12846	0	86	3	1	0	90
12847	2	0	0	77	0	79
12848	78	0	0	2	0	80
12849	0	1	76	2	0	79
12850	74	0	0	3	0	77
12851	3	0	0	75	0	78
12852	1	2	1	73	0	77
12853	2	71	0	0	0	73
12854	1	74	2	0	0	77
12855	0	74	2	0	0	76
12856	2	0	0	76	0	78
12857	75	0	1	2	0	78
12858	75	0	0	3	0	78
12859	0	0	73	3	0	76
12860	74	0	2	0	0	76
12861	1	0	73	1	0	75
12862	3	0	0	72	0	75
12863	2	1	70	0	0	73
12864	72	0	1	3	0	76
12865	1	0	2	75	0	78
12866	0	0	76	1	0	77
12867	0	0	74	1	0	75
12868	74	2	0	1	0	77
12869	76	0	0	2	0	78
12870	2	75	0	0	0	77
12871	0	0	2	74	0	76
12872	2	0	75	0	0	77
12873	0	0	77	2	0	79
12874	1	1	0	80	0	82
12875	78	1	1	2	0	82
12876	0	78	0	1	0	79
12877	0	2	0	80	0	82
12878	79	0	1	2	0	82
12879	3	0	0	81	0	84
12880	3	82	0	0	0	85
12881	1	0	1	83	0	85
12882	83	0	0	1	0	84
12883	0	0	3	82	0	85
12884	81	0	0	2	0	83
12885	0	85	2	0	0	87
12886	86	1	0	0	0	87
12887	0	0	81	3	0	84
12888	82	0	2	0	0	84
12889	81	0	3	0	0	84
12890	2	84	0	0	0	86
12891	2	0	0	77	0	79
12892	0	2	78	1	0	81
12893	0	1	71	2	0	74
12894	69	2	2	0	0	73
12895	69	0	2	0	0	71
12896	0	70	0	2	0	72
12897	2	71	0	0	0	73
12898	70	2	0	0	0	72
12899	0	68	0	2	0	70
12900	2	71	0	0	0	73
12901	0	0	0	75	0	75
12902	0	1	0	73	0	74
12903	0	0	76	2	0	78
12904	2	0	0	77	0	79
12905	77	0	0	2	0	79
12906	2	0	77	0	0	79
12907	0	2	75	0	0	77
12908	2	0	0	75	0	77
12909	0	0	2	77	0	79
12910	2	0	0	78	0	80
12911	2	0	76	0	0	78
12912	0	1	0	75	0	76
12913	0	0	0	79	0	79
12914	78	0	1	0	0	79
12915	0	79	2	0	0	81
12916	79	0	0	0	0	79
12917	2	1	78	0	0	81
12918	73	0	0	0	0	73
12919	0	78	0	1	0	79
12920	66	0	0	0	0	66
12921	0	65	0	0	0	65
12922	64	0	0	0	0	64
12923	0	67	0	0	0	67
12924	0	64	0	0	0	64
12925	0	0	0	64	0	64
12926	64	0	1	0	0	65
12927	61	0	0	0	0	61
12928	63	0	0	0	0	63
12929	0	0	58	0	0	58
12930	0	0	62	0	0	62
12931	0	0	0	67	0	67
12932	0	67	0	0	0	67
12933	0	68	0	0	0	68
12934	0	0	0	68	0	68
12935	68	0	0	0	0	68
12936	66	0	0	0	0	66
12937	67	0	0	0	0	67
12938	0	0	71	0	0	71
12939	0	0	0	71	0	71
12940	0	0	72	0	0	72
12941	71	0	0	0	0	71
12942	73	0	0	0	0	73
12943	0	0	72	0	0	72
12944	0	0	0	73	0	73
12945	76	0	0	0	0	76
12946	0	0	0	79	0	79
12947	0	0	0	81	0	81
12948	0	0	0	95	0	95
12949	102	0	0	0	0	102
12950	1	0	0	109	0	110
12951	116	0	0	1	0	117
12952	1	124	0	0	0	125
12953	0	3	0	125	0	128
12954	0	0	0	127	0	127
12955	0	0	0	127	0	127
12956	126	0	0	3	0	129
12957	3	0	0	124	0	127
12958	0	0	0	132	0	132
12959	130	0	0	2	0	132
12960	130	0	0	1	0	131
12961	132	0	0	1	0	133
12962	3	0	127	1	0	131
12963	0	0	127	1	0	128
12964	130	0	3	0	0	133
12965	3	0	0	130	0	133
12966	0	0	0	127	0	127
12967	126	0	0	3	0	129
12968	128	0	0	0	0	128
12969	128	0	0	0	0	128
12970	3	127	1	0	0	131
12971	126	3	1	0	0	130
12972	127	0	0	0	0	127
12973	2	120	0	1	0	123
12974	0	124	0	1	0	125
12975	1	2	0	125	0	128
12976	129	0	0	3	0	132
12977	130	0	0	0	0	130
12978	127	1	0	0	0	128
12979	4	0	0	123	0	127
12980	123	0	0	3	0	126
12981	3	1	118	0	0	122
12982	122	1	3	0	0	126
12983	3	0	121	1	0	125
12984	1	0	120	0	0	121
12985	1	0	2	116	0	119
12986	117	0	0	3	0	120
12987	3	0	0	119	0	122
12988	1	0	119	3	0	123
12989	0	0	119	0	0	119
12990	1	0	3	114	0	118
12991	117	0	1	2	0	120
12992	3	115	1	0	0	119
12993	0	1	1	120	0	122
12994	1	0	0	128	0	129
12995	1	2	123	2	0	128
12996	0	0	125	1	0	126
12997	0	0	4	125	0	129
12998	127	0	0	4	0	131
12999	5	0	125	1	0	131
13000	0	0	3	127	0	130
13001	0	1	0	129	0	130
13002	0	0	0	130	0	130
13003	119	0	1	4	0	124
13004	3	0	116	1	0	120
13005	0	117	3	2	0	122
13006	0	4	0	122	0	126
13007	0	0	123	5	0	128
13008	1	115	4	1	0	121
13009	1	123	0	1	0	125
13010	120	4	0	1	0	125
13011	4	119	1	0	0	124
13012	122	4	1	0	0	127
13013	5	1	119	0	0	125
13014	0	0	4	123	0	127
13015	119	0	1	5	0	125
13016	5	128	0	0	0	133
13017	1	4	126	0	0	131
13018	2	0	4	118	0	124
13019	0	127	0	4	0	131
13020	2	4	0	127	0	133
13021	130	0	1	4	0	135
13022	3	129	0	1	0	133
13023	128	5	0	1	0	134
13024	133	1	0	2	0	136
13025	5	0	133	1	0	139
13026	3	140	3	1	0	147
13027	1	5	0	142	0	148
13028	0	0	142	7	0	149
13029	4	0	161	1	0	166
13030	1	2	4	164	0	171
13031	179	0	0	4	0	183
13032	182	0	2	1	0	185
13033	4	0	2	179	0	185
13034	1	0	177	5	0	183
13035	1	176	4	2	0	183
13036	183	4	1	2	0	190
13037	188	0	2	0	0	190
13038	3	189	1	1	0	194
13039	189	3	0	1	0	193
13040	5	0	188	1	0	194
13041	188	1	3	1	0	193
13042	188	1	1	1	0	191
13043	4	1	190	1	0	196
13044	2	1	4	185	0	192
13045	1	0	186	4	0	191
13046	1	179	3	1	0	184
13047	4	179	0	0	0	183
13048	2	3	3	161	0	169
13049	1	0	162	4	0	167
13050	2	152	1	1	0	156
13051	1	145	1	0	0	147
13052	138	2	0	0	0	140
13053	137	0	0	1	0	138
13054	1	0	2	139	0	142
13055	1	1	0	136	0	138
13056	2	139	0	1	0	142
13057	139	1	1	0	0	141
13058	136	1	0	1	0	138
13059	2	134	1	0	0	137
13060	0	2	1	138	0	141
13061	1	1	138	1	0	141
13062	0	0	1	139	0	140
13063	140	0	1	1	0	142
13064	1	1	0	143	0	145
13065	0	1	1	147	0	149
13066	152	1	0	1	0	154
13067	2	1	0	146	0	149
13068	0	149	0	1	0	150
13069	0	1	1	150	0	152
13070	0	1	0	150	0	151
13071	1	1	0	148	0	150
13072	1	148	0	1	0	150
13073	1	1	0	146	0	148
13074	0	0	141	3	0	144
13075	0	0	2	144	0	146
13076	0	1	142	2	0	145
13077	2	143	1	0	0	146
13078	1	1	0	144	0	146
13079	0	0	0	144	0	144
13080	2	0	0	142	0	144
13081	0	0	1	141	0	142
13082	0	1	140	2	0	143
13083	1	140	1	1	0	143
13084	0	1	0	143	0	144
13085	0	0	142	3	0	145
13086	2	1	0	143	0	146
13087	143	0	0	3	0	146
13088	1	1	142	0	0	144
13089	137	0	1	2	0	140
13090	1	0	1	146	0	148
13091	0	1	143	1	0	145
13092	0	144	1	1	0	146
13093	0	1	0	147	0	148
13094	0	0	144	2	0	146
13095	0	142	1	2	0	145
13096	0	0	2	144	0	146
13097	142	2	0	1	0	145
13098	145	0	0	0	0	145
13099	144	0	1	1	0	146
13100	0	0	144	2	0	146
13101	2	145	0	0	0	147
13102	0	0	1	146	0	147
13103	1	0	0	148	0	149
13104	148	0	0	2	0	150
13105	0	151	2	0	0	153
13106	151	1	0	1	0	153
13107	151	0	0	1	0	152
13108	154	0	2	0	0	156
13109	1	0	149	0	0	150
13110	151	0	0	3	0	154
13111	2	0	1	152	0	155
13112	1	1	1	150	0	153
13113	151	0	0	1	0	152
13114	0	0	1	148	0	149
13115	0	147	1	0	0	148
13116	0	1	0	141	0	142
13117	137	0	0	2	0	139
13118	2	1	137	0	0	140
13119	1	136	0	0	0	137
13120	1	0	0	137	0	138
13121	136	0	0	0	0	136
13122	2	0	134	0	0	136
13123	1	0	0	132	0	133
13124	4	0	130	0	0	134
13125	0	1	129	1	0	131
13126	0	0	121	2	0	123
13127	1	0	123	1	0	125
13128	1	0	119	0	0	120
13129	95	3	1	0	0	99
13130	2	102	0	1	0	105
13131	92	1	0	0	0	93
13132	91	0	1	0	0	92
13133	0	89	1	0	0	90
13134	2	91	0	1	0	94
13135	93	0	1	1	0	95
13136	91	0	1	1	0	93
13137	1	0	0	91	0	92
13138	0	88	0	2	0	90
13139	91	1	0	0	0	92
13140	0	90	0	2	0	92
13141	1	1	0	91	0	93
13142	91	0	1	1	0	93
13143	92	0	0	0	0	92
13144	0	0	1	92	0	93
13145	0	1	0	91	0	92
13146	0	0	92	1	0	93
13147	1	0	0	90	0	91
13148	0	0	92	0	0	92
13149	0	0	1	84	0	85
13150	0	0	2	84	0	86
13151	86	0	2	0	0	88
13152	85	0	2	0	0	87
13153	1	0	87	0	0	88
13154	85	0	1	0	0	86
13155	2	0	0	84	0	86
13156	1	1	83	0	0	85
13157	1	1	0	85	0	87
13158	1	1	0	93	0	95
13159	0	1	92	1	0	94
13160	1	1	1	95	0	98
13161	1	1	98	1	0	101
13162	1	1	0	102	0	104
13163	117	0	0	1	0	118
13164	2	116	0	0	0	118
13165	118	1	0	1	0	120
13166	2	117	0	0	0	119
13167	114	2	0	1	0	117
13168	2	114	0	2	0	118
13169	114	1	0	1	0	116
13170	2	114	1	1	0	118
13171	1	2	0	118	0	121
13172	1	1	117	1	0	120
13173	1	0	117	2	0	120
13174	1	0	2	116	0	119
13175	116	0	0	2	0	118
13176	3	121	0	1	0	125
13177	1	2	1	122	0	126
13178	2	0	123	3	0	128
13179	1	0	125	1	0	127
13180	1	0	3	122	0	126
13181	0	125	0	3	0	128
13182	124	2	1	2	0	129
13183	3	0	124	1	0	128
13184	0	0	122	3	0	125
13185	0	124	2	0	0	126
13186	123	2	0	3	0	128
13187	126	0	1	0	0	127
13188	2	0	1	122	0	125
13189	123	0	0	3	0	126
13190	121	1	1	0	0	123
13191	3	120	1	0	0	124
13192	120	3	0	0	0	123
13193	3	0	121	0	0	124
13194	0	1	2	121	0	124
13195	2	0	0	121	0	123
13196	119	0	0	2	0	121
13197	2	117	0	1	0	120
13198	116	2	1	0	0	119
13199	2	121	1	0	0	124
13200	0	121	0	1	0	122
13201	1	2	117	0	0	120
13202	0	1	120	0	0	121
13203	117	0	1	1	0	119
13204	119	1	0	0	0	120
13205	2	0	114	0	0	116
13206	0	108	2	0	0	110
13207	0	111	0	0	0	111
13208	108	2	0	0	0	110
13209	108	0	0	0	0	108
13210	2	0	0	109	0	111
13211	112	0	0	2	0	114
13212	2	0	0	116	0	118
13213	0	0	114	2	0	116
13214	0	0	114	0	0	114
13215	115	0	2	0	0	117
13216	2	0	0	113	0	115
13217	0	119	0	2	0	121
13218	124	2	0	0	0	126
13219	125	0	0	0	0	125
13220	2	0	121	0	0	123
13221	123	0	2	0	0	125
13222	126	0	0	0	0	126
13223	2	1	0	122	0	125
13224	1	119	0	2	0	122
13225	0	123	0	0	0	123
13226	1	2	0	126	0	129
13227	0	1	0	125	0	126
13228	1	0	0	126	0	127
13229	0	1	124	2	0	127
13230	0	0	116	1	0	117
13231	0	0	3	116	0	119
13232	0	0	119	2	0	121
13233	0	1	117	1	0	119
13234	1	0	2	119	0	122
13235	0	1	125	2	0	128
13236	0	123	2	1	0	126
13237	128	2	1	0	0	131
13238	2	0	1	125	0	128
13239	0	131	0	3	0	134
13240	0	3	134	0	0	137
13241	1	0	2	133	0	136
13242	0	0	140	2	0	142
13243	0	0	3	141	0	144
13244	0	1	0	144	0	145
13245	1	0	146	2	0	149
13246	1	0	2	147	0	150
13247	0	145	0	3	0	148
13248	1	2	0	149	0	152
13249	1	0	148	3	0	152
13250	0	1	3	147	0	151
13251	148	0	0	3	0	151
13252	3	146	0	0	0	149
13253	0	3	0	149	0	152
13254	0	0	151	4	0	155
13255	1	149	3	0	0	153
13256	0	156	0	0	0	156
13257	1	4	149	0	0	154
13258	0	1	3	149	0	153
13259	3	2	0	145	0	150
13260	0	0	145	3	0	148
13261	0	139	4	0	0	143
13262	1	139	0	0	0	140
13263	121	2	0	0	0	123
13264	2	124	0	0	0	126
13265	117	3	3	0	0	123
13266	2	1	0	114	0	117
13267	119	0	0	4	0	123
13268	2	0	127	1	0	130
13269	132	0	2	0	0	134
13270	2	0	1	127	0	130
13271	0	128	1	2	0	131
13272	128	2	0	1	0	131
13273	2	0	1	133	0	136
13274	0	133	1	1	0	135
13275	0	140	0	1	0	141
13276	133	1	1	0	0	135
13277	135	1	0	0	0	136
13278	138	0	0	0	0	138
13279	2	0	0	135	0	137
13280	0	133	0	1	0	134
13281	0	135	1	0	0	136
13282	0	1	0	135	0	136
13283	136	0	1	1	0	138
13284	132	0	0	2	0	134
13285	134	0	0	2	0	136
13286	1	0	138	0	0	139
13287	0	1	139	1	0	141
13288	147	1	1	0	0	149
13289	1	0	0	148	0	149
13290	0	0	1	148	0	149
13291	0	0	0	146	0	146
13292	1	0	0	148	0	149
13293	0	1	145	1	0	147
13294	0	0	1	143	0	144
13295	1	0	142	1	0	144
13296	139	1	1	1	0	142
13297	2	142	0	0	0	144
13298	0	1	2	143	0	146
13299	1	0	0	140	0	141
13300	140	0	0	3	0	143
13301	135	1	1	2	0	139
13302	141	1	0	0	0	142
13303	143	1	0	1	0	145
13304	2	1	142	0	0	145
13305	0	2	139	0	0	141
13306	2	0	1	142	0	145
13307	147	0	0	2	0	149
13308	148	0	0	0	0	148
13309	1	0	145	1	0	147
13310	1	1	1	141	0	144
13311	142	1	0	2	0	145
13312	1	1	0	137	0	139
13313	2	0	142	1	0	145
13314	1	0	1	146	0	148
13315	151	1	0	1	0	153
13316	1	164	1	0	0	166
13317	160	1	1	0	0	162
13318	161	0	0	0	0	161
13319	159	0	0	1	0	160
13320	1	0	0	161	0	162
13321	160	0	0	2	0	162
13322	1	164	0	1	0	166
13323	0	172	1	1	0	174
13324	0	2	0	169	0	171
13325	167	0	1	2	0	170
13326	2	176	0	0	0	178
13327	220	3	0	0	0	223
13328	243	0	0	1	0	244
13329	6	243	0	1	0	250
13330	3	5	0	247	0	255
13331	1	0	0	256	0	257
13332	1	0	251	7	0	259
13333	1	0	5	249	0	255
13334	0	0	250	6	0	256
13335	1	245	6	0	0	252
13336	0	6	0	249	0	255
13337	244	0	0	6	0	250
13338	248	0	0	1	0	249
13339	7	0	1	245	0	253
13340	0	0	240	7	0	247
13341	236	0	6	2	0	244
13342	6	239	0	1	0	246
13343	0	243	1	0	0	244
13344	0	246	0	3	0	249
13345	2	6	1	234	0	243
13346	1	1	246	6	0	254
13347	2	0	6	250	0	258
13348	1	0	261	5	0	267
13349	3	0	257	0	0	260
13350	1	0	262	1	0	264
13351	0	1	5	256	0	262
13352	0	2	0	265	0	267
13353	0	1	0	267	0	268
13354	2	0	1	262	0	265
13355	264	0	0	6	0	270
13356	5	261	1	0	0	267
13357	256	5	1	1	0	263
13358	5	262	1	0	0	268
13359	0	4	0	266	0	270
13360	2	0	0	279	0	281
13361	272	0	0	7	0	279
13362	283	0	0	4	0	287
13363	277	1	0	1	0	279
13364	276	2	0	2	0	280
13365	277	0	0	2	0	279
13366	6	272	0	1	0	279
13367	274	6	0	2	0	282
13368	6	268	0	1	0	275
13369	270	5	0	0	0	275
13370	5	2	268	0	0	275
13371	1	0	5	266	0	272
13372	1	271	0	6	0	278
13373	1	5	1	266	0	273
13374	1	1	266	8	0	276
13375	1	0	6	263	0	270
13376	263	2	0	6	0	271
13377	5	266	1	1	0	273
13378	1	272	1	0	0	274
13379	2	4	279	0	0	285
13380	2	1	5	275	0	283
13381	0	286	1	5	0	292
13382	1	6	1	291	0	299
13383	1	1	300	6	0	308
13384	1	297	5	0	0	303
13385	1	7	293	0	0	301
13386	0	0	287	1	0	288
13387	1	0	7	291	0	299
13388	295	0	0	8	0	303
13389	5	1	0	297	0	303
13390	0	0	299	6	0	305
13391	0	0	7	304	0	311
13392	0	2	316	7	0	325
13393	0	0	315	1	0	316
13394	323	0	7	2	0	332
13395	341	0	0	2	0	343
13396	339	0	0	1	0	340
13397	6	1	330	1	0	338
13398	1	1	334	0	0	336
13399	0	1	5	327	0	333
13400	1	0	1	333	0	335
13401	328	0	1	8	0	337
13402	8	0	0	327	0	335
13403	2	0	328	6	0	336
13404	2	0	320	0	0	322
13405	1	322	7	0	0	330
13406	1	5	1	324	0	331
13407	0	1	329	7	0	337
13408	1	0	7	327	0	335
13409	329	1	0	6	0	336
13410	7	0	331	1	0	339
13411	1	0	8	333	0	342
13412	0	0	1	334	0	335
13413	0	2	320	6	0	328
13414	0	0	6	324	0	330
13415	1	0	319	6	0	326
13416	301	0	6	2	0	309
13417	8	0	0	302	0	310
13418	0	305	1	5	0	311
13419	302	5	0	1	0	308
13420	308	0	0	1	0	309
13421	6	303	2	0	0	311
13422	3	14	1	281	0	299
13423	0	281	1	4	0	286
13424	1	293	0	0	0	294
13425	0	8	282	0	0	290
13426	2	282	3	0	0	287
13427	0	1	231	0	0	232
13428	200	0	1	1	0	202
13429	201	0	0	0	0	201
13430	1	204	0	0	0	205
13431	0	204	0	0	0	204
13432	0	204	0	0	0	204
13433	211	1	0	0	0	212
13434	1	0	0	218	0	219
13435	0	0	224	1	0	225
13436	0	224	2	0	0	226
13437	0	1	0	230	0	231
13438	0	0	0	229	0	229
13439	0	263	0	1	0	264
13440	283	1	0	0	0	284
13441	2	1	280	0	0	283
13442	4	0	1	344	0	349
13443	0	368	1	3	0	372
13444	373	3	0	2	0	378
13445	4	1	371	0	0	376
13446	1	352	3	0	0	356
13447	0	4	0	358	0	362
13448	0	1	350	4	0	355
13449	339	0	4	1	0	344
13450	4	0	1	345	0	350
13451	1	0	344	4	0	349
13452	0	347	4	2	0	353
13453	344	5	0	0	0	349
13454	5	348	0	0	0	353
13455	348	5	3	0	0	356
13456	349	2	0	2	0	353
13457	5	1	1	345	0	352
13458	1	336	1	6	0	344
13459	1	3	334	2	0	340
13460	0	2	5	335	0	342
13461	2	1	2	298	0	303
13462	1	1	1	337	0	340
13463	2	0	1	337	0	340
13464	0	2	0	336	0	338
13465	332	0	1	5	0	338
13466	332	2	0	2	0	336
13467	319	0	0	2	0	321
13468	5	327	0	0	0	332
13469	2	4	330	1	0	337
13470	1	2	323	1	0	327
13471	0	0	329	2	0	331
13472	0	1	5	324	0	330
13473	0	0	4	327	0	331
13474	1	0	0	327	0	328
13475	1	0	316	6	0	323
13476	1	313	4	4	0	322
13477	2	5	317	1	0	325
13478	2	2	312	2	0	318
13479	2	1	4	304	0	311
13480	2	2	308	4	0	316
13481	1	1	7	298	0	307
13482	294	2	3	5	0	304
13483	284	0	1	3	0	288
13484	5	0	282	3	0	290
13485	3	0	6	283	0	292
13486	0	3	281	8	0	292
13487	1	280	5	1	0	287
13488	282	8	2	1	0	293
13489	10	1	281	1	0	293
13490	1	269	9	0	0	279
13491	1	268	1	3	0	273
13492	2	265	2	0	0	269
13493	3	4	244	3	0	254
13494	2	1	8	236	0	247
13495	1	240	1	5	0	247
13496	1	5	2	241	0	249
13497	2	2	2	246	0	252
13498	238	0	3	7	0	248
13499	5	237	0	5	0	247
13500	232	5	3	2	0	242
13501	6	232	2	0	0	240
13502	6	238	0	0	0	244
13503	1	7	238	1	0	247
13504	2	3	5	234	0	244
13505	2	2	237	4	0	245
13506	1	229	4	7	0	241
13507	0	7	233	2	0	242
13508	2	1	230	3	0	236
13509	1	230	6	4	0	241
13510	227	6	1	5	0	239
13511	5	230	2	3	0	240
13512	228	7	2	3	0	240
13513	5	4	229	4	0	242
13514	4	2	232	2	0	240
13515	2	222	8	4	0	236
13516	226	8	3	2	0	239
13517	7	228	3	3	0	241
13518	4	5	5	228	0	242
13519	230	1	6	6	0	243
13520	7	2	230	2	0	241
13521	3	4	7	229	0	243
13522	226	2	3	7	0	238
13523	7	232	3	3	0	245
13524	5	5	4	229	0	243
13525	0	5	229	7	0	241
13526	228	3	8	2	0	241
13527	6	2	4	228	0	240
13528	2	2	230	9	0	243
13529	0	4	8	229	0	241
13530	1	230	0	12	0	243
13531	4	7	229	4	0	244
13532	4	1	6	226	0	237
13533	217	1	4	8	0	230
13534	9	0	1	212	0	222
13535	202	2	1	5	0	210
13536	7	201	0	1	0	209
13537	198	7	4	0	0	209
13538	6	3	197	3	0	209
13539	2	2	161	1	0	166
13540	1	3	136	2	0	142
13541	1	130	8	4	0	143
13542	4	3	14	35	0	56
13543	0	0	1	37	0	38
13544	0	0	0	37	0	37
13545	0	0	0	35	0	35
13546	0	0	33	2	0	35
13547	32	0	2	0	0	34
13548	1	33	0	0	0	34
13549	33	2	0	0	0	35
13550	2	0	0	32	0	34
13551	0	33	0	1	0	34
13552	0	2	0	34	0	36
13553	34	0	0	2	0	36
13554	2	36	0	0	0	38
13555	35	2	0	1	0	38
13556	37	0	0	0	0	37
13557	2	0	0	37	0	39
13558	0	0	36	2	0	38
13559	37	0	1	0	0	38
13560	2	0	0	37	0	39
13561	37	0	0	2	0	39
13562	40	0	0	0	0	40
13563	40	0	0	0	0	40
13564	2	0	39	0	0	41
13565	0	0	2	36	0	38
13566	37	0	0	2	0	39
13567	2	0	38	0	0	40
13568	0	35	2	0	0	37
13569	0	2	0	30	0	32
13570	0	0	32	2	0	34
13571	0	0	34	1	0	35
13572	0	0	2	33	0	35
13573	0	0	0	34	0	34
13574	0	0	0	35	0	35
13575	0	0	0	35	0	35
13576	0	0	35	1	0	36
13577	0	37	2	0	0	39
13578	0	2	0	40	0	42
13579	39	0	0	3	0	42
13580	41	0	0	0	0	41
13581	43	0	0	0	0	43
13582	2	0	0	41	0	43
13583	0	0	0	42	0	42
13584	0	40	0	2	0	42
13585	0	38	0	0	0	38
13586	0	1	0	39	0	40
13587	37	1	0	1	0	39
13588	40	0	0	0	0	40
13589	40	0	0	0	0	40
13590	40	0	0	0	0	40
13591	41	0	0	0	0	41
13592	1	40	0	0	0	41
13593	0	0	0	40	0	40
13594	45	0	0	1	0	46
13595	46	0	0	0	0	46
13596	1	0	0	45	0	46
13597	0	0	0	46	0	46
13598	0	0	47	1	0	48
13599	0	0	1	46	0	47
13600	0	0	0	47	0	47
13601	0	0	52	1	0	53
13602	0	0	1	52	0	53
13603	0	53	0	1	0	54
13604	0	1	52	0	0	53
13605	0	53	1	0	0	54
13606	0	0	0	52	0	52
13607	0	0	0	54	0	54
13608	0	54	0	0	0	54
13609	0	56	0	0	0	56
13610	59	0	0	0	0	59
13611	57	0	0	0	0	57
13612	0	0	59	0	0	59
13613	59	0	0	0	0	59
13614	62	0	0	0	0	62
13615	63	0	0	0	0	63
13616	61	0	0	1	0	62
13617	0	0	62	0	0	62
13618	0	0	66	0	0	66
13619	66	0	0	0	0	66
13620	0	68	0	0	0	68
13621	0	0	74	0	0	74
13622	74	0	0	0	0	74
13623	76	0	0	0	0	76
13624	0	0	70	0	0	70
13625	71	0	0	0	0	71
13626	0	0	0	84	0	84
13627	0	0	89	0	0	89
13628	86	0	0	0	0	86
13629	0	88	0	0	0	88
13630	88	0	0	1	0	89
13631	98	0	0	1	0	99
13632	0	0	0	98	0	98
13633	0	0	0	102	0	102
13634	0	0	0	102	0	102
13635	102	0	0	0	0	102
13636	105	0	0	0	0	105
13637	0	0	0	106	0	106
13638	0	0	0	104	0	104
13639	0	0	103	0	0	103
13640	104	0	0	0	0	104
13641	0	0	0	108	0	108
13642	0	0	0	108	0	108
13643	0	107	0	0	0	107
13644	0	0	0	107	0	107
13645	0	0	0	107	0	107
13646	106	0	0	0	0	106
13647	0	110	0	0	0	110
13648	0	0	0	111	0	111
13649	0	0	0	113	0	113
13650	1	0	0	113	0	114
13651	0	0	112	0	0	112
13652	0	0	0	110	0	110
13653	109	0	0	0	0	109
13654	0	0	108	0	0	108
13655	0	0	0	111	0	111
13656	0	0	0	113	0	113
13657	110	0	0	0	0	110
13658	110	0	0	0	0	110
13659	0	0	111	0	0	111
13660	105	0	0	0	0	105
13661	0	0	114	0	0	114
13662	114	0	0	0	0	114
13663	1	125	0	0	0	126
13664	123	1	0	2	0	126
13665	2	127	0	0	0	129
13666	131	2	0	0	0	133
13667	2	142	0	0	0	144
13668	0	2	0	145	0	147
13669	0	0	0	144	0	144
13670	0	0	0	149	0	149
13671	0	143	0	1	0	144
13672	0	2	0	142	0	144
13673	0	140	0	2	0	142
13674	0	2	0	145	0	147
13675	147	0	0	2	0	149
13676	146	0	0	0	0	146
13677	2	144	0	0	0	146
13678	0	2	0	142	0	144
13679	142	0	0	1	0	143
13680	2	142	0	0	0	144
13681	0	145	0	0	0	145
13682	143	2	0	0	0	145
13683	146	0	0	0	0	146
13684	2	144	0	0	0	146
13685	144	2	0	0	0	146
13686	2	0	0	144	0	146
13687	0	0	147	2	0	149
13688	150	0	2	0	0	152
13689	153	0	0	0	0	153
13690	2	1	153	0	0	156
13691	156	0	2	0	0	158
13692	158	0	0	1	0	159
13693	161	1	0	0	0	162
13694	3	156	0	0	0	159
13695	158	2	0	2	0	162
13696	161	0	1	0	0	162
13697	3	0	0	158	0	161
13698	1	0	0	164	0	165
13699	0	1	0	166	0	167
13700	167	0	0	2	0	169
13701	3	0	0	162	0	165
13702	163	0	0	1	0	164
13703	165	1	0	0	0	166
13704	3	0	0	162	0	165
13705	2	0	0	163	0	165
13706	0	0	0	169	0	169
13707	169	0	0	3	0	172
13708	2	165	0	1	0	168
13709	1	2	0	169	0	172
13710	0	0	0	177	0	177
13711	174	0	0	2	0	176
13712	175	0	0	0	0	175
13713	3	0	170	1	0	174
13714	0	0	173	1	0	174
13715	191	0	3	1	0	195
13716	4	1	0	197	0	202
13717	0	0	0	233	0	233
13718	2	0	226	4	0	232
13719	0	0	4	224	0	228
13720	1	227	0	4	0	232
13721	1	233	0	0	0	234
13722	223	4	1	0	0	228
13723	4	0	224	0	0	228
13724	1	232	4	0	0	237
13725	1	3	0	236	0	240
13726	0	0	229	5	0	234
13727	0	0	4	222	0	226
13728	1	0	0	227	0	228
13729	0	1	225	4	0	230
13730	0	227	3	0	0	230
13731	1	4	0	216	0	221
13732	219	0	0	4	0	223
13733	219	1	0	1	0	221
13734	220	0	0	1	0	221
13735	4	217	0	0	0	221
13736	217	4	0	1	0	222
13737	5	0	0	217	0	222
13738	1	0	210	4	0	215
13739	212	0	5	0	0	217
13740	5	213	0	1	0	219
13741	2	4	0	217	0	223
13742	2	0	1	220	0	223
13743	1	215	0	5	0	221
13744	1	5	0	220	0	226
13745	3	1	1	224	0	229
13746	2	0	0	228	0	230
13747	217	0	1	5	0	223
13748	220	2	0	2	0	224
13749	6	1	224	1	0	232
13750	1	0	6	220	0	227
13751	1	0	0	230	0	231
13752	2	1	0	229	0	232
13753	223	0	2	7	0	232
13754	4	1	221	3	0	229
13755	218	0	4	5	0	227
13756	225	0	1	0	0	226
13757	5	2	0	220	0	227
13758	223	0	1	7	0	231
13759	5	1	217	2	0	225
13760	221	0	4	2	0	227
13761	7	232	0	2	0	241
13762	2	5	228	0	0	235
13763	2	1	228	0	0	231
13764	5	3	2	220	0	230
13765	1	0	229	5	0	235
13766	221	0	4	3	0	228
13767	3	211	1	0	0	215
13768	215	3	1	3	0	222
13769	4	1	0	220	0	225
13770	0	3	218	3	0	224
13771	3	0	221	1	0	225
13772	1	1	6	219	0	227
13773	219	1	2	5	0	227
13774	4	217	0	1	0	222
13775	2	227	1	2	0	232
13776	223	4	0	2	0	229
13777	5	220	1	2	0	228
13778	221	3	3	4	0	231
13779	4	2	1	223	0	230
13780	222	1	1	4	0	228
13781	4	0	1	220	0	225
13782	223	0	1	3	0	227
13783	5	1	0	219	0	225
13784	1	220	0	5	0	226
13785	222	4	1	0	0	227
13786	3	217	2	2	0	224
13787	2	3	216	1	0	222
13788	0	1	3	215	0	219
13789	0	216	2	3	0	221
13790	216	3	1	1	0	221
13791	212	2	0	1	0	215
13792	4	212	1	2	0	219
13793	2	2	207	2	0	213
13794	0	3	4	202	0	209
13795	1	200	0	4	0	205
13796	1	3	0	210	0	214
13797	1	0	2	212	0	215
13798	206	1	1	2	0	210
13799	4	203	0	1	0	208
13800	2	3	1	206	0	212
13801	204	2	0	5	0	211
13802	208	2	1	1	0	212
13803	208	0	1	3	0	212
13804	5	1	0	205	0	211
13805	205	0	2	5	0	212
13806	7	205	0	1	0	213
13807	204	4	1	2	0	211
13808	4	208	1	2	0	215
13809	203	3	0	2	0	208
13810	201	1	1	2	0	205
13811	5	5	2	195	0	207
13812	1	1	202	3	0	207
13813	1	1	203	0	0	205
13814	1	199	4	0	0	204
13815	182	3	0	1	0	186
13816	3	1	178	0	0	182
13817	139	1	2	0	0	142
13818	2	143	0	0	0	145
13819	1	147	0	1	0	149
13820	1	1	0	156	0	158
13821	0	160	1	2	0	163
13822	1	2	161	0	0	164
13823	0	0	2	157	0	159
13824	1	164	0	3	0	168
13825	1	3	0	166	0	170
13826	164	2	0	3	0	169
13827	2	1	1	167	0	171
13828	0	1	170	3	0	174
13829	1	169	5	0	0	175
13830	1	5	0	171	0	177
13831	2	0	1	175	0	178
13832	1	2	0	177	0	180
13833	171	0	0	6	0	177
13834	175	0	0	2	0	177
13835	6	2	171	1	0	180
13836	0	0	172	1	0	173
13837	0	165	6	2	0	173
13838	171	4	0	1	0	176
13839	6	1	0	169	0	176
13840	0	1	0	170	0	171
13841	2	1	0	172	0	175
13842	2	0	0	170	0	172
13843	1	1	160	5	0	167
13844	156	0	5	1	0	162
13845	7	1	0	187	0	195
13846	2	1	186	5	0	194
13847	187	0	5	2	0	194
13848	208	1	0	1	0	210
13849	6	0	236	2	0	244
13850	1	1	247	1	0	250
13851	0	0	6	251	0	257
13852	252	0	1	5	0	258
13853	254	0	2	1	0	257
13854	6	0	1	252	0	259
13855	2	0	1	253	0	256
13856	2	0	247	5	0	254
13857	1	0	6	248	0	255
13858	1	3	247	5	0	256
13859	244	1	5	1	0	251
13860	6	249	0	3	0	258
13861	240	4	0	1	0	245
13862	4	237	0	1	0	242
13863	233	3	0	2	0	238
13864	4	0	2	228	0	234
13865	1	0	0	234	0	235
13866	228	1	1	6	0	236
13867	235	0	0	0	0	235
13868	229	2	0	0	0	231
13869	234	0	0	0	0	234
13870	5	1	222	1	0	229
13871	220	0	4	2	0	226
13872	225	0	0	2	0	227
13873	229	0	0	1	0	230
13874	7	0	0	222	0	229
13875	218	0	0	5	0	223
13876	5	217	1	1	0	224
13877	2	4	1	216	0	223
13878	1	0	1	223	0	225
13879	2	0	218	4	0	224
13880	2	0	4	215	0	221
13881	2	217	0	3	0	222
13882	214	5	0	1	0	220
13883	5	213	1	1	0	220
13884	213	6	0	2	0	221
13885	4	0	1	215	0	220
13886	208	0	0	8	0	216
13887	3	208	1	1	0	213
13888	210	4	0	1	0	215
13889	210	2	0	0	0	212
13890	6	0	1	206	0	213
13891	0	1	2	210	0	213
13892	2	1	204	4	0	211
13893	2	1	3	204	0	210
13894	2	0	0	210	0	212
13895	1	2	203	6	0	212
13896	1	0	4	206	0	211
13897	1	1	201	6	0	209
13898	202	0	5	3	0	210
13899	5	0	0	205	0	210
13900	0	0	203	6	0	209
13901	200	0	6	3	0	209
13902	5	1	0	203	0	209
13903	2	0	204	4	0	210
13904	204	1	5	2	0	212
13905	5	0	2	201	0	208
13906	1	0	1	204	0	206
13907	201	0	0	5	0	206
13908	4	1	1	196	0	202
13909	2	0	2	197	0	201
13910	2	0	0	199	0	201
13911	0	194	2	6	0	202
13912	185	4	0	4	0	193
13913	191	0	3	1	0	195
13914	4	0	1	186	0	191
13915	184	1	0	8	0	193
13916	188	0	2	3	0	193
13917	183	2	0	2	0	187
13918	158	0	1	2	0	161
13919	177	1	1	2	0	181
13920	5	0	163	3	0	171
13921	3	0	162	2	0	167
13922	157	0	3	1	0	161
13923	7	153	0	1	0	161
13924	1	3	1	146	0	151
13925	3	1	148	3	0	155
13926	1	1	150	1	0	153
13927	2	0	3	147	0	152
13928	144	0	1	3	0	148
13929	1	1	0	142	0	144
13930	1	1	140	2	0	144
13931	143	0	1	1	0	145
13932	1	2	1	138	0	142
13933	3	0	0	141	0	144
13934	2	0	0	141	0	143
13935	1	0	0	138	0	139
13936	3	1	135	0	0	139
13937	4	0	0	136	0	140
13938	139	0	0	2	0	141
13939	2	1	131	1	0	135
13940	135	1	1	1	0	138
13941	137	0	1	2	0	140
13942	138	0	2	1	0	141
13943	134	0	1	1	0	136
13944	1	135	0	1	0	137
13945	1	107	1	0	0	109
13946	2	109	1	0	0	112
13947	101	3	2	1	0	107
13948	2	0	89	1	0	92
13949	42	2	2	0	0	46
13950	0	0	0	39	0	39
13951	37	0	0	0	0	37
13952	0	0	0	37	0	37
13953	37	0	0	0	0	37
13954	0	0	0	37	0	37
13955	0	0	0	38	0	38
13956	36	0	0	0	0	36
13957	0	44	0	0	0	44
13958	0	0	42	0	0	42
13959	0	41	0	0	0	41
13960	0	0	39	0	0	39
13961	0	0	0	34	0	34
13962	36	0	0	0	0	36
13963	0	0	0	36	0	36
13964	36	0	0	0	0	36
13965	0	37	0	0	0	37
13966	0	0	38	0	0	38
13967	0	34	0	1	0	35
13968	0	38	0	0	0	38
13969	34	0	0	0	0	34
13970	33	0	0	0	0	33
13971	0	35	0	0	0	35
13972	0	0	0	33	0	33
13973	0	0	0	34	0	34
13974	34	0	0	0	0	34
13975	0	0	34	0	0	34
13976	0	0	33	0	0	33
13977	0	0	0	34	0	34
13978	0	0	34	0	0	34
13979	32	0	0	0	0	32
13980	35	0	0	0	0	35
13981	1	33	0	0	0	34
13982	0	1	34	0	0	35
13983	0	0	1	36	0	37
13984	0	0	40	1	0	41
13985	0	0	1	42	0	43
13986	44	0	0	1	0	45
13987	1	43	0	0	0	44
13988	0	1	44	0	0	45
13989	0	45	1	0	0	46
13990	0	48	0	0	0	48
13991	49	1	0	0	0	50
13992	50	0	0	0	0	50
13993	1	0	50	0	0	51
13994	0	52	1	0	0	53
13995	0	1	0	53	0	54
13996	1	0	0	52	0	53
13997	0	0	0	53	0	53
13998	0	0	53	1	0	54
13999	0	0	1	52	0	53
14000	0	0	0	53	0	53
14001	55	0	0	1	0	56
14002	56	0	0	0	0	56
14003	54	0	0	0	0	54
14004	54	0	0	0	0	54
14005	54	0	0	0	0	54
14006	1	51	0	0	0	52
14007	53	1	0	0	0	54
14008	1	0	53	0	0	54
14009	0	0	1	52	0	53
14010	53	0	0	1	0	54
14011	1	55	0	0	0	56
14012	54	1	0	0	0	55
14013	57	0	0	0	0	57
14014	1	0	0	57	0	58
14015	0	0	0	58	0	58
14016	0	71	0	1	0	72
14017	0	1	0	73	0	74
14018	0	0	73	0	0	73
14019	0	0	1	74	0	75
14020	0	0	73	1	0	74
14021	71	0	1	0	0	72
14022	1	0	0	75	0	76
14023	0	0	78	1	0	79
14024	0	78	1	0	0	79
14025	0	77	0	0	0	77
14026	74	1	0	0	0	75
14027	1	0	0	75	0	76
14028	0	0	81	1	0	82
14029	0	83	1	0	0	84
14030	0	1	82	0	0	83
14031	82	0	1	0	0	83
14032	86	0	0	0	0	86
14033	87	0	0	0	0	87
14034	1	0	0	88	0	89
14035	0	0	88	1	0	89
14036	0	86	1	0	0	87
14037	0	1	0	90	0	91
14038	1	0	86	0	0	87
14039	0	0	83	0	0	83
14040	0	0	1	89	0	90
14041	90	0	0	1	0	91
14042	1	0	0	90	0	91
14043	0	0	0	95	0	95
14044	0	0	95	1	0	96
14045	0	0	1	97	0	98
14046	0	0	0	96	0	96
14047	0	0	97	1	0	98
14048	0	0	95	0	0	95
14049	0	0	0	92	0	92
14050	1	0	98	1	0	100
14051	0	0	1	99	0	100
14052	98	0	0	1	0	99
14053	1	104	0	0	0	105
14054	0	1	0	107	0	108
14055	0	0	105	1	0	106
14056	96	0	1	0	0	97
14057	1	97	0	0	0	98
14058	99	1	0	0	0	100
14059	1	0	0	100	0	101
14060	0	0	0	104	0	104
14061	107	0	0	1	0	108
14062	1	0	109	0	0	110
14063	109	0	1	0	0	110
14064	1	0	0	111	0	112
14065	110	0	0	1	0	111
14066	111	0	0	0	0	111
14067	1	0	0	114	0	115
14068	0	114	0	1	0	115
14069	113	1	0	0	0	114
14070	116	0	0	0	0	116
14071	1	0	117	0	0	118
14072	116	0	1	0	0	117
14073	1	0	0	117	0	118
14074	0	115	0	0	0	115
14075	0	1	0	119	0	120
14076	0	117	0	1	0	118
14077	119	1	0	0	0	120
14078	121	0	0	0	0	121
14079	0	0	0	130	0	130
14080	0	0	129	0	0	129
14081	0	0	125	0	0	125
14082	0	0	0	132	0	132
14083	129	0	0	0	0	129
14084	137	0	0	0	0	137
14085	0	142	0	0	0	142
14086	0	0	0	142	0	142
14087	0	0	144	0	0	144
14088	0	0	145	0	0	145
14089	0	0	0	168	0	168
14090	178	0	0	0	0	178
14091	0	0	0	181	0	181
14092	1	0	180	0	0	181
14093	179	0	0	1	0	180
14094	0	0	1	183	0	184
14095	1	0	1	181	0	183
14096	1	0	0	178	0	179
14097	0	181	0	2	0	183
14098	0	0	183	2	0	185
14099	0	1	183	1	0	185
14100	0	1	1	184	0	186
14101	0	0	185	0	0	185
14102	186	0	1	1	0	188
14103	0	0	1	186	0	187
14104	1	0	1	188	0	190
14105	1	0	0	188	0	189
14106	0	190	0	2	0	192
14107	189	0	0	2	0	191
14108	0	1	0	187	0	188
14109	192	1	0	0	0	193
14110	1	191	0	1	0	193
14111	192	0	0	2	0	194
14112	191	1	0	1	0	193
14113	189	1	0	2	0	192
14114	2	187	1	0	0	190
14115	3	186	0	0	0	189
14116	172	1	0	1	0	174
14117	0	175	0	1	0	176
14118	1	0	174	1	0	176
14119	1	170	0	1	0	172
14120	0	174	2	0	0	176
14121	174	1	2	0	0	177
14122	0	2	172	1	0	175
14123	1	1	169	0	0	171
14124	2	0	1	167	0	170
14125	172	0	3	1	0	176
14126	0	0	176	2	0	178
14127	1	0	0	178	0	179
14128	1	1	172	0	0	174
14129	1	0	168	1	0	170
14130	165	0	1	1	0	167
14131	2	1	167	0	0	170
14132	2	1	1	165	0	169
14133	2	0	1	166	0	169
14134	0	163	1	1	0	165
14135	1	165	1	2	0	169
14136	0	2	0	163	0	165
14137	0	4	165	0	0	169
14138	2	1	0	167	0	170
14139	1	1	1	168	0	171
14140	0	1	174	1	0	176
14141	0	1	0	172	0	173
14142	171	1	2	1	0	175
14143	1	0	170	1	0	172
14144	171	0	1	2	0	174
14145	1	0	2	171	0	174
14146	1	0	1	172	0	174
14147	3	175	1	2	0	181
14148	1	0	2	179	0	182
14149	0	1	2	181	0	184
14150	179	1	1	3	0	184
14151	1	0	1	181	0	183
14152	4	1	0	179	0	184
14153	175	1	1	2	0	179
14154	0	1	1	177	0	179
14155	1	0	1	172	0	174
14156	1	172	3	1	0	177
14157	169	1	1	3	0	174
14158	2	1	1	173	0	177
14159	2	1	1	175	0	179
14160	2	0	167	5	0	174
14161	1	0	0	167	0	168
14162	1	0	3	164	0	168
14163	164	1	1	4	0	170
14164	163	0	0	5	0	168
14165	2	2	0	163	0	167
14166	5	1	162	0	0	168
14167	3	161	1	2	0	167
14168	3	159	2	2	0	166
14169	4	3	3	157	0	167
14170	162	2	0	2	0	166
14171	1	3	1	164	0	169
14172	171	1	0	2	0	174
14173	2	1	1	174	0	178
14174	1	3	1	172	0	177
14175	170	0	1	2	0	173
14176	167	3	0	4	0	174
14177	3	167	0	2	0	172
14178	3	169	1	2	0	175
14179	3	1	2	161	0	167
14180	0	3	1	161	0	165
14181	2	1	157	2	0	162
14182	151	0	2	3	0	156
14183	1	152	2	2	0	157
14184	1	143	2	1	0	147
14185	138	2	4	0	0	144
14186	3	2	138	0	0	143
14187	3	2	128	1	0	134
14188	2	0	130	1	0	133
14189	0	110	2	1	0	113
14190	0	0	2	96	0	98
14191	0	1	0	93	0	94
14192	0	0	0	94	0	94
14193	91	0	1	0	0	92
14194	89	0	0	1	0	90
14195	0	89	0	1	0	90
14196	0	0	1	94	0	95
14197	0	0	93	1	0	94
14198	1	93	0	0	0	94
14199	95	0	1	1	0	97
14200	1	0	96	0	0	97
14201	91	0	0	0	0	91
14202	0	0	93	0	0	93
14203	0	0	0	91	0	91
14204	0	93	0	0	0	93
14205	92	0	0	0	0	92
14206	0	91	0	0	0	91
14207	91	0	0	0	0	91
14208	0	0	0	92	0	92
14209	0	0	92	0	0	92
14210	0	0	0	97	0	97
14211	0	0	0	102	0	102
14212	0	0	104	0	0	104
14213	101	0	0	0	0	101
14214	0	106	0	0	0	106
14215	106	0	0	0	0	106
14216	0	107	0	0	0	107
14217	0	0	0	111	0	111
14218	0	0	111	0	0	111
14219	135	0	0	0	0	135
14220	0	138	0	0	0	138
14221	0	0	0	141	0	141
14222	0	0	0	144	0	144
14223	155	0	1	1	0	157
14224	168	0	0	0	0	168
14225	2	171	0	0	0	173
14226	179	2	0	0	0	181
14227	183	1	0	0	0	184
14228	179	0	0	1	0	180
14229	4	0	179	0	0	183
14230	1	174	4	2	0	181
14231	0	185	0	0	0	185
14232	0	3	0	179	0	182
14233	0	1	0	180	0	181
14234	178	0	0	4	0	182
14235	5	179	0	0	0	184
14236	180	6	0	0	0	186
14237	6	0	0	179	0	185
14238	1	1	0	183	0	185
14239	178	0	0	3	0	181
14240	174	0	2	0	0	176
14241	4	0	170	0	0	174
14242	0	1	4	172	0	177
14243	0	1	168	6	0	175
14244	0	1	169	2	0	172
14245	2	0	173	0	0	175
14246	166	2	4	1	0	173
14247	6	0	1	166	0	173
14248	1	0	0	165	0	166
14249	0	1	0	171	0	172
14250	3	0	164	4	0	171
14251	2	0	4	168	0	174
14252	0	0	2	175	0	177
14253	171	0	1	6	0	178
14254	174	0	2	0	0	176
14255	179	1	2	0	0	182
14256	177	0	2	2	0	181
14257	6	0	0	175	0	181
14258	175	0	0	4	0	179
14259	5	0	0	175	0	180
14260	0	1	166	6	0	173
14261	171	0	6	0	0	177
14262	5	173	0	2	0	180
14263	1	4	0	174	0	179
14264	2	0	1	174	0	177
14265	2	173	0	4	0	179
14266	171	3	0	0	0	174
14267	6	167	0	1	0	174
14268	0	4	167	3	0	174
14269	3	0	170	0	0	173
14270	164	1	4	3	0	172
14271	166	0	2	1	0	169
14272	5	0	155	1	0	161
14273	156	2	4	1	0	163
14274	5	0	157	2	0	164
14275	156	0	4	3	0	163
14276	4	2	158	0	0	164
14277	1	0	158	1	0	160
14278	0	3	5	150	0	158
14279	1	0	3	152	0	156
14280	152	0	3	5	0	160
14281	157	0	0	0	0	157
14282	154	1	0	2	0	157
14283	155	0	2	0	0	157
14284	5	152	0	2	0	159
14285	0	3	2	152	0	157
14286	3	153	0	5	0	161
14287	1	3	2	153	0	159
14288	1	0	3	153	0	157
14289	1	0	0	155	0	156
14290	1	0	149	6	0	156
14291	148	0	5	1	0	154
14292	4	143	1	1	0	149
14293	3	151	0	0	0	154
14294	1	4	148	1	0	154
14295	0	1	5	146	0	152
14296	1	0	0	148	0	149
14297	143	2	1	4	0	150
14298	4	0	0	146	0	150
14299	0	0	0	148	0	148
14300	1	1	0	146	0	148
14301	2	0	1	144	0	147
14302	143	1	0	4	0	148
14303	143	1	1	0	0	145
14304	148	1	1	1	0	151
14305	7	0	0	144	0	151
14306	145	0	0	6	0	151
14307	4	0	2	153	0	159
14308	3	0	0	156	0	159
14309	0	1	147	5	0	153
14310	1	0	146	2	0	149
14311	0	0	140	2	0	142
14312	138	1	4	1	0	144
14313	6	0	0	134	0	140
14314	1	137	0	2	0	140
14315	136	4	1	0	0	141
14316	4	0	135	1	0	140
14317	128	0	4	0	0	132
14318	5	121	0	1	0	127
14319	92	3	1	1	0	97
14320	5	0	1	90	0	96
14321	87	0	2	4	0	93
14322	5	82	1	0	0	88
14323	1	82	1	0	0	84
14324	64	2	1	0	0	67
14325	2	66	0	1	0	69
14326	0	51	0	1	0	52
14327	0	49	0	0	0	49
14328	49	0	1	0	0	50
14329	47	0	0	0	0	47
14330	48	0	0	0	0	48
14331	0	0	0	49	0	49
14332	0	0	0	49	0	49
14333	0	0	47	0	0	47
14334	0	0	0	49	0	49
14335	0	0	47	0	0	47
14336	0	0	0	48	0	48
14337	0	0	0	48	0	48
14338	48	0	0	0	0	48
14339	47	0	0	0	0	47
14340	0	48	0	0	0	48
14341	0	0	0	46	0	46
14342	0	0	45	0	0	45
14343	0	0	0	46	0	46
14344	0	0	0	49	0	49
14345	0	0	0	50	0	50
14346	0	0	47	0	0	47
14347	0	0	49	0	0	49
14348	49	0	0	0	0	49
14349	0	0	0	51	0	51
14350	0	0	49	0	0	49
14351	46	0	0	1	0	47
14352	0	48	0	0	0	48
14353	47	0	0	0	0	47
14354	0	0	48	0	0	48
14355	43	0	0	0	0	43
14356	0	0	0	45	0	45
14357	0	0	45	0	0	45
14358	0	43	0	0	0	43
14359	45	0	0	0	0	45
14360	0	0	0	45	0	45
14361	0	0	0	45	0	45
14362	0	45	0	0	0	45
14363	0	0	0	45	0	45
14364	0	0	44	0	0	44
14365	0	43	0	0	0	43
14366	45	0	0	0	0	45
14367	0	0	0	45	0	45
14368	0	0	0	45	0	45
14369	0	0	46	0	0	46
14370	0	0	0	45	0	45
14371	0	0	48	0	0	48
14372	0	49	0	0	0	49
14373	47	0	0	0	0	47
14374	47	0	0	0	0	47
14375	47	0	0	0	0	47
14376	0	51	0	0	0	51
14377	0	0	0	51	0	51
14378	0	0	0	51	0	51
14379	0	0	0	49	0	49
14380	51	0	0	0	0	51
14381	50	0	0	0	0	50
14382	1	0	0	50	0	51
14383	0	0	54	0	0	54
14384	0	0	0	54	0	54
14385	0	0	0	54	0	54
14386	0	0	0	50	0	50
14387	0	0	0	49	0	49
14388	51	0	0	0	0	51
14389	0	0	0	52	0	52
14390	0	0	0	51	0	51
14391	0	52	0	0	0	52
14392	0	0	0	59	0	59
14393	0	62	0	0	0	62
14394	0	0	0	63	0	63
14395	63	0	0	0	0	63
14396	0	62	0	0	0	62
14397	62	0	0	0	0	62
14398	0	0	62	0	0	62
14399	0	0	0	63	0	63
14400	0	0	63	0	0	63
14401	0	0	0	66	0	66
14402	0	1	0	64	0	65
14403	0	68	0	0	0	68
14404	0	66	0	0	0	66
14405	0	66	0	0	0	66
14406	67	0	0	0	0	67
14407	0	59	0	0	0	59
14408	0	57	0	0	0	57
14409	1	0	0	56	0	57
14410	59	0	0	0	0	59
14411	0	56	0	0	0	56
14412	59	0	0	0	0	59
14413	59	0	0	0	0	59
14414	0	0	65	0	0	65
14415	0	0	0	65	0	65
14416	0	0	0	63	0	63
14417	0	0	0	64	0	64
14418	0	0	0	64	0	64
14419	0	0	64	0	0	64
14420	0	0	60	0	0	60
14421	64	0	0	0	0	64
14422	0	62	0	0	0	62
14423	0	65	0	0	0	65
14424	66	0	0	0	0	66
14425	0	64	0	0	0	64
14426	0	0	0	68	0	68
14427	68	0	0	0	0	68
14428	0	0	69	0	0	69
14429	0	0	0	69	0	69
14430	0	0	70	0	0	70
14431	68	0	0	0	0	68
14432	0	1	68	0	0	69
14433	71	0	0	1	0	72
14434	72	0	0	0	0	72
14435	74	0	0	0	0	74
14436	75	0	0	0	0	75
14437	76	0	0	0	0	76
14438	1	0	0	76	0	77
14439	82	0	0	1	0	83
14440	1	0	0	85	0	86
14441	0	0	0	86	0	86
14442	0	0	0	87	0	87
14443	0	0	87	1	0	88
14444	0	0	1	82	0	83
14445	0	0	0	84	0	84
14446	0	0	83	1	0	84
14447	81	0	0	0	0	81
14448	1	0	0	83	0	84
14449	0	0	82	1	0	83
14450	0	0	84	0	0	84
14451	0	0	1	81	0	82
14452	0	1	81	1	0	83
14453	0	0	0	82	0	82
14454	0	0	0	80	0	80
14455	0	80	0	1	0	81
14456	0	81	0	0	0	81
14457	85	1	0	0	0	86
14458	1	0	0	85	0	86
14459	0	0	0	84	0	84
14460	0	0	0	86	0	86
14461	0	0	84	1	0	85
14462	0	0	1	83	0	84
14463	83	0	0	2	0	85
14464	1	0	96	0	0	97
14465	0	0	1	99	0	100
14466	0	0	0	101	0	101
14467	0	0	0	102	0	102
14468	0	108	0	1	0	109
14469	109	2	0	0	0	111
14470	119	0	0	0	0	119
14471	1	126	0	0	0	127
14472	0	2	0	133	0	135
14473	0	0	133	2	0	135
14474	0	0	130	0	0	130
14475	137	0	2	0	0	139
14476	2	0	0	139	0	141
14477	149	0	0	2	0	151
14478	2	149	0	1	0	152
14479	0	160	0	0	0	160
14480	157	2	0	0	0	159
14481	2	162	0	0	0	164
14482	0	2	0	162	0	164
14483	0	0	0	161	0	161
14484	0	167	0	1	0	168
14485	170	2	0	0	0	172
14486	2	0	171	0	0	173
14487	171	0	1	0	0	172
14488	1	0	177	0	0	178
14489	167	0	2	0	0	169
14490	2	0	175	0	0	177
14491	0	174	2	0	0	176
14492	1	2	0	168	0	171
14493	165	0	1	2	0	168
14494	2	0	166	0	0	168
14495	0	0	170	0	0	170
14496	0	0	2	169	0	171
14497	0	0	172	2	0	174
14498	0	0	2	169	0	171
14499	0	0	0	174	0	174
14500	0	0	172	2	0	174
14501	0	0	2	166	0	168
14502	170	0	0	2	0	172
14503	2	167	0	0	0	169
14504	170	2	0	0	0	172
14505	2	0	0	168	0	170
14506	169	0	0	2	0	171
14507	174	0	0	0	0	174
14508	2	0	0	180	0	182
14509	0	182	0	2	0	184
14510	183	2	0	0	0	185
14511	2	0	181	0	0	183
14512	0	0	177	0	0	177
14513	181	0	2	0	0	183
14514	2	0	0	176	0	178
14515	0	0	179	2	0	181
14516	0	1	1	178	0	180
14517	178	0	0	2	0	180
14518	183	0	0	0	0	183
14519	183	0	0	0	0	183
14520	2	188	0	0	0	190
14521	0	2	0	189	0	191
14522	0	0	0	192	0	192
14523	190	0	0	2	0	192
14524	2	189	0	0	0	191
14525	188	2	0	0	0	190
14526	2	0	0	187	0	189
14527	187	0	0	2	0	189
14528	2	1	181	0	0	184
14529	0	186	2	0	0	188
14530	0	2	0	189	0	191
14531	0	196	0	1	0	197
14532	1	1	0	200	0	202
14533	200	0	0	1	0	201
14534	1	0	198	0	0	199
14535	191	0	1	0	0	192
14536	1	215	0	0	0	216
14537	0	1	0	217	0	218
14538	0	0	0	216	0	216
14539	212	0	0	1	0	213
14540	1	1	211	0	0	213
14541	0	0	1	213	0	214
14542	0	0	0	212	0	212
14543	0	0	0	213	0	213
14544	0	0	0	210	0	210
14545	212	0	0	1	0	213
14546	210	0	0	1	0	211
14547	1	0	216	0	0	217
14548	0	0	218	0	0	218
14549	225	0	1	2	0	228
14550	230	0	0	0	0	230
14551	1	0	0	231	0	232
14552	1	0	0	231	0	232
14553	231	0	0	2	0	233
14554	1	236	0	0	0	237
14555	0	1	0	237	0	238
14556	0	0	0	239	0	239
14557	0	0	235	1	0	236
14558	0	0	1	235	0	236
14559	0	0	233	1	0	234
14560	0	0	1	237	0	238
14561	236	0	0	2	0	238
14562	1	0	0	238	0	239
14563	0	0	236	1	0	237
14564	0	227	2	0	0	229
14565	0	2	0	227	0	229
14566	0	1	229	1	0	231
14567	0	233	1	0	0	234
14568	0	0	0	226	0	226
14569	1	0	219	0	0	220
14570	198	0	0	0	0	198
14571	0	218	0	0	0	218
14572	0	212	0	0	0	212
14573	0	215	1	0	0	216
14574	2	2	0	208	0	212
14575	0	0	210	2	0	212
14576	0	214	2	0	0	216
14577	0	5	0	202	0	207
14578	207	0	0	2	0	209
14579	2	0	0	279	0	281
14580	0	0	325	4	0	329
14581	0	325	4	0	0	329
14582	320	5	0	0	0	325
14583	5	323	0	0	0	328
14584	0	5	316	1	0	322
14585	0	313	5	0	0	318
14586	1	6	0	311	0	318
14587	1	1	309	5	0	316
14588	0	304	6	0	0	310
14589	1	7	1	301	0	310
14590	1	2	1	302	0	306
14591	0	307	1	5	0	313
14592	0	5	1	306	0	312
14593	0	2	307	5	0	314
14594	0	1	306	2	0	309
14595	0	1	6	301	0	308
14596	301	2	0	7	0	310
14597	302	1	0	2	0	305
14598	6	1	1	294	0	302
14599	0	295	1	5	0	301
14600	0	5	1	298	0	304
14601	295	0	2	7	0	304
14602	6	0	1	294	0	301
14603	2	0	0	300	0	302
14604	294	1	0	6	0	301
14605	6	288	0	2	0	296
14606	2	7	0	287	0	296
14607	287	1	0	7	0	295
14608	6	1	274	3	0	284
14609	278	0	6	2	0	286
14610	7	2	0	275	0	284
14611	276	1	0	8	0	285
14612	284	1	1	1	0	287
14613	273	2	1	3	0	279
14614	7	278	1	1	0	287
14615	2	4	276	1	0	283
14616	2	276	7	1	0	286
14617	275	5	0	3	0	283
14618	6	273	2	1	0	282
14619	2	4	1	272	0	279
14620	266	1	1	6	0	274
14621	7	265	1	0	0	273
14622	2	6	263	0	0	271
14623	1	2	6	260	0	269
14624	0	2	260	6	0	268
14625	2	259	5	2	0	268
14626	2	7	0	262	0	271
14627	1	1	1	269	0	272
14628	1	2	1	269	0	273
14629	1	1	3	257	0	262
14630	0	254	3	8	0	265
14631	247	6	1	3	0	257
14632	6	1	245	2	0	254
14633	0	0	6	248	0	254
14634	246	0	0	9	0	255
14635	5	1	242	5	0	253
14636	2	229	6	2	0	239
14637	3	5	1	228	0	237
14638	1	1	229	6	0	237
14639	2	227	7	1	0	237
14640	217	5	3	2	0	227
14641	6	225	2	1	0	234
14642	3	6	1	221	0	231
14643	0	1	2	230	0	233
14644	220	1	2	7	0	230
14645	6	223	1	3	0	233
14646	2	8	1	226	0	237
14647	218	2	0	7	0	227
14648	216	1	0	4	0	221
14649	7	209	1	2	0	219
14650	212	8	0	2	0	222
14651	215	2	0	3	0	220
14652	8	1	0	212	0	221
14653	1	1	208	7	0	217
14654	3	0	5	203	0	211
14655	2	2	0	211	0	215
14656	5	1	203	4	0	213
14657	3	195	6	1	0	205
14658	2	5	1	203	0	211
14659	2	0	1	211	0	214
14660	0	0	2	209	0	211
14661	0	2	2	202	0	206
14662	1	200	1	7	0	209
14663	200	7	2	2	0	211
14664	203	2	1	3	0	209
14665	198	1	0	2	0	201
14666	5	195	0	4	0	204
14667	0	6	1	192	0	199
14668	1	1	190	8	0	200
14669	3	1	5	188	0	197
14670	3	192	0	5	0	200
14671	180	4	0	2	0	186
14672	182	1	0	3	0	186
14673	178	1	1	2	0	182
14674	3	174	0	3	0	180
14675	1	164	1	1	0	167
14676	3	173	1	1	0	178
14677	2	4	165	1	0	172
14678	2	3	147	2	0	154
14679	9	20	3	54	0	86
14680	33	0	2	0	0	35
14681	31	0	0	0	0	31
14682	0	0	0	32	0	32
14683	0	0	0	34	0	34
14684	0	0	0	34	0	34
14685	0	0	0	34	0	34
14686	35	0	0	0	0	35
14687	35	0	0	0	0	35
14688	0	38	0	0	0	38
14689	38	0	0	0	0	38
14690	38	0	0	0	0	38
14691	39	0	0	0	0	39
14692	0	0	38	0	0	38
14693	38	0	0	0	0	38
14694	0	38	0	0	0	38
14695	0	0	0	40	0	40
14696	0	0	0	41	0	41
14697	0	42	0	0	0	42
14698	0	0	0	43	0	43
14699	43	0	0	0	0	43
14700	0	0	0	43	0	43
14701	0	0	43	0	0	43
14702	41	0	0	0	0	41
14703	0	42	0	0	0	42
14704	0	0	0	44	0	44
14705	0	0	0	44	0	44
14706	0	0	0	43	0	43
14707	0	0	44	0	0	44
14708	0	43	0	0	0	43
14709	0	0	0	44	0	44
14710	0	0	44	0	0	44
14711	0	0	0	44	0	44
14712	0	0	44	0	0	44
14713	0	0	0	43	0	43
14714	0	40	0	0	0	40
14715	0	0	0	40	0	40
14716	40	0	0	0	0	40
14717	39	0	0	0	0	39
14718	0	0	39	0	0	39
14719	0	0	35	0	0	35
14720	0	0	40	0	0	40
14721	0	0	0	40	0	40
14722	0	0	0	44	0	44
14723	0	0	0	44	0	44
14724	0	45	0	0	0	45
14725	0	0	0	45	0	45
14726	0	0	0	48	0	48
14727	0	0	0	48	0	48
14728	47	1	0	0	0	48
14729	46	0	0	0	0	46
14730	0	0	47	1	0	48
14731	0	0	47	1	0	48
14732	45	0	0	0	0	45
14733	48	0	0	0	0	48
14734	0	0	50	0	0	50
14735	0	0	50	0	0	50
14736	47	0	0	1	0	48
14737	48	0	0	0	0	48
14738	0	0	50	0	0	50
14739	0	0	0	49	0	49
14740	1	1	0	48	0	50
14741	2	55	0	0	0	57
14742	1	0	0	55	0	56
14743	0	0	60	1	0	61
14744	0	0	0	60	0	60
14745	0	1	0	60	0	61
14746	0	1	60	1	0	62
14747	56	0	1	1	0	58
14748	59	0	0	1	0	60
14749	0	0	0	59	0	59
14750	1	0	1	58	0	60
14751	59	0	0	0	0	59
14752	59	0	0	1	0	60
14753	57	0	0	0	0	57
14754	58	0	0	2	0	60
14755	1	58	0	0	0	59
14756	58	0	0	0	0	58
14757	1	57	0	0	0	58
14758	1	0	0	58	0	59
14759	0	0	0	54	0	54
14760	1	57	0	0	0	58
14761	0	1	0	57	0	58
14762	0	0	0	56	0	56
14763	0	55	0	1	0	56
14764	0	1	0	56	0	57
14765	0	0	0	58	0	58
14766	0	0	0	57	0	57
14767	0	1	57	0	0	58
14768	0	57	0	1	0	58
14769	0	0	0	54	0	54
14770	0	55	0	1	0	56
14771	53	0	2	1	0	56
14772	0	1	56	0	0	57
14773	0	0	54	1	0	55
14774	49	0	0	1	0	50
14775	3	0	0	49	0	52
14776	0	0	49	0	0	49
14777	0	0	47	1	0	48
14778	1	1	1	45	0	48
14779	47	0	0	1	0	48
14780	47	0	1	0	0	48
14781	0	0	1	46	0	47
14782	0	0	45	2	0	47
14783	0	46	0	1	0	47
14784	1	1	0	45	0	47
14785	0	0	46	1	0	47
14786	0	44	2	0	0	46
14787	0	1	0	47	0	48
14788	41	0	0	3	0	44
14789	0	0	1	40	0	41
14790	1	42	0	0	0	43
14791	43	0	0	1	0	44
14792	1	0	43	1	0	45
14793	0	43	0	2	0	45
14794	1	1	44	0	0	46
14795	44	0	0	1	0	45
14796	1	0	1	42	0	44
14797	1	0	0	40	0	41
14798	40	1	1	0	0	42
14799	2	0	0	38	0	40
14800	0	0	39	0	0	39
14801	40	0	0	2	0	42
14802	1	37	0	1	0	39
14803	0	1	0	41	0	42
14804	40	0	1	1	0	42
14805	1	40	0	1	0	42
14806	0	2	0	40	0	42
14807	41	0	0	2	0	43
14808	1	0	0	41	0	42
14809	0	40	0	1	0	41
14810	0	0	38	1	0	39
14811	1	1	0	38	0	40
14812	0	1	0	39	0	40
14813	39	2	0	0	0	41
14814	1	0	1	39	0	41
14815	38	0	1	1	0	40
14816	38	0	1	1	0	40
14817	2	0	0	37	0	39
14818	0	37	0	2	0	39
14819	2	0	1	37	0	40
14820	34	0	1	1	0	36
14821	0	33	0	2	0	35
14822	1	33	0	0	0	34
14823	34	0	0	0	0	34
14824	32	0	0	1	0	33
14825	0	31	0	0	0	31
14826	31	1	0	0	0	32
14827	32	0	0	1	0	33
14828	0	0	1	33	0	34
14829	0	1	33	0	0	34
14830	0	0	1	34	0	35
14831	1	0	34	1	0	36
14832	0	0	1	34	0	35
14833	0	1	32	1	0	34
14834	33	0	1	0	0	34
14835	1	0	0	32	0	33
14836	33	0	0	1	0	34
14837	1	0	0	33	0	34
14838	0	42	0	1	0	43
14839	42	1	0	0	0	43
14840	1	0	43	0	0	44
14841	37	0	1	0	0	38
14842	1	36	0	0	0	37
14843	34	1	0	0	0	35
14844	35	0	0	0	0	35
14845	1	35	0	0	0	36
14846	0	1	0	35	0	36
14847	35	0	0	1	0	36
14848	1	35	0	0	0	36
14849	1	1	0	34	0	36
14850	36	0	0	1	0	37
14851	1	0	0	36	0	37
14852	0	0	0	37	0	37
14853	0	0	0	38	0	38
14854	0	0	37	1	0	38
14855	0	0	1	35	0	36
14856	36	0	0	1	0	37
14857	1	0	36	0	0	37
14858	0	0	0	37	0	37
14859	0	0	0	38	0	38
14860	0	0	37	1	0	38
14861	37	0	1	0	0	38
14862	37	0	0	0	0	37
14863	1	0	35	0	0	36
14864	0	0	0	37	0	37
14865	0	0	0	37	0	37
14866	0	0	37	1	0	38
14867	0	0	0	39	0	39
14868	0	0	0	38	0	38
14869	0	0	37	1	0	38
14870	38	0	1	0	0	39
14871	1	0	0	40	0	41
14872	40	0	0	1	0	41
14873	40	0	0	0	0	40
14874	1	0	38	0	0	39
14875	1	0	1	38	0	40
14876	39	0	0	1	0	40
14877	1	39	0	0	0	40
14878	0	1	0	39	0	40
14879	0	0	0	40	0	40
14880	0	0	0	42	0	42
14881	0	0	41	1	0	42
14882	37	0	1	0	0	38
14883	1	0	0	41	0	42
14884	0	0	0	42	0	42
14885	0	1	39	1	0	41
14886	0	0	1	39	0	40
14887	0	0	0	41	0	41
14888	40	0	0	2	0	42
14889	1	39	0	0	0	40
14890	0	1	39	0	0	40
14891	38	0	1	0	0	39
14892	1	0	0	40	0	41
14893	0	0	40	1	0	41
14894	0	0	41	0	0	41
14895	0	0	1	41	0	42
14896	0	0	42	1	0	43
14897	0	0	41	0	0	41
14898	0	40	1	0	0	41
14899	0	1	0	43	0	44
14900	0	0	42	1	0	43
14901	0	0	1	40	0	41
14902	43	0	0	1	0	44
14903	1	0	0	46	0	47
14904	0	0	0	50	0	50
14905	49	0	0	1	0	50
14906	47	0	0	1	0	48
14907	1	0	0	54	0	55
14908	0	0	55	1	0	56
14909	0	54	1	0	0	55
14910	0	1	0	55	0	56
14911	57	0	0	1	0	58
14912	56	0	0	0	0	56
14913	1	51	0	0	0	52
14914	0	55	0	0	0	55
14915	57	1	0	0	0	58
14916	58	0	0	0	0	58
14917	1	0	58	0	0	59
14918	0	0	1	54	0	55
14919	0	58	0	1	0	59
14920	59	1	0	0	0	60
14921	1	0	0	59	0	60
14922	0	55	0	1	0	56
14923	0	1	57	0	0	58
14924	0	0	1	58	0	59
14925	0	57	0	1	0	58
14926	60	1	0	0	0	61
14927	60	0	0	0	0	60
14928	1	59	0	0	0	60
14929	60	0	0	1	0	61
14930	60	0	0	0	0	60
14931	0	61	0	0	0	61
14932	0	60	0	0	0	60
14933	0	2	0	59	0	61
14934	57	0	0	0	0	57
14935	0	0	60	0	0	60
14936	54	0	0	0	0	54
14937	0	58	0	0	0	58
14938	51	0	0	0	0	51
14939	52	0	0	0	0	52
14940	54	0	0	0	0	54
14941	1	0	0	53	0	54
14942	0	53	0	0	0	53
14943	54	0	0	0	0	54
14944	0	0	55	0	0	55
14945	0	51	0	0	0	51
14946	0	0	0	55	0	55
14947	0	0	55	0	0	55
14948	0	0	55	0	0	55
14949	0	0	0	57	0	57
14950	0	1	0	57	0	58
14951	0	0	0	57	0	57
14952	0	0	0	57	0	57
14953	0	57	0	0	0	57
14954	0	56	0	1	0	57
14955	60	0	0	0	0	60
14956	0	0	0	62	0	62
14957	0	0	0	61	0	61
14958	0	0	0	61	0	61
14959	63	0	0	0	0	63
14960	62	0	0	0	0	62
14961	0	0	0	63	0	63
14962	63	0	0	0	0	63
14963	62	0	0	0	0	62
14964	63	0	0	0	0	63
14965	0	0	0	63	0	63
14966	0	0	61	0	0	61
14967	0	0	57	0	0	57
14968	0	0	61	0	0	61
14969	0	0	65	0	0	65
14970	0	0	0	67	0	67
14971	65	0	0	1	0	66
14972	65	0	0	0	0	65
14973	0	0	65	0	0	65
14974	0	0	68	0	0	68
14975	0	73	0	0	0	73
14976	0	0	0	76	0	76
14977	81	0	0	0	0	81
14978	0	0	80	0	0	80
14979	75	0	1	0	0	76
14980	0	85	0	0	0	85
14981	0	0	0	86	0	86
14982	0	0	0	90	0	90
14983	0	0	0	89	0	89
14984	91	0	0	0	0	91
14985	0	0	0	93	0	93
14986	0	0	0	93	0	93
14987	93	0	0	0	0	93
14988	0	0	0	92	0	92
14989	0	0	93	1	0	94
14990	92	0	0	0	0	92
14991	0	0	0	95	0	95
14992	0	0	1	90	0	91
14993	1	96	0	0	0	97
14994	93	0	0	1	0	94
14995	94	0	0	1	0	95
14996	0	1	0	94	0	95
14997	1	0	92	0	0	93
14998	92	0	0	0	0	92
14999	0	0	95	1	0	96
15000	0	0	1	94	0	95
15001	1	0	0	96	0	97
15002	100	0	1	1	0	102
15003	0	0	0	106	0	106
15004	0	0	102	1	0	103
15005	103	0	0	0	0	103
15006	0	0	113	1	0	114
15007	0	0	110	0	0	110
15008	114	0	0	0	0	114
15009	0	0	1	121	0	122
15010	0	123	1	0	0	124
15011	124	0	0	0	0	124
15012	123	0	0	1	0	124
15013	0	1	121	0	0	122
15014	118	0	0	0	0	118
15015	1	0	0	123	0	124
15016	0	0	125	0	0	125
15017	1	125	0	0	0	126
15018	123	0	0	1	0	124
15019	0	128	1	1	0	130
15020	0	1	0	130	0	131
15021	1	0	0	128	0	129
15022	0	0	0	128	0	128
15023	0	0	0	126	0	126
15024	0	125	1	1	0	127
15025	0	0	123	1	0	124
15026	0	127	0	1	0	128
15027	127	1	0	0	0	128
15028	0	0	0	126	0	126
15029	125	1	0	0	0	126
15030	1	0	0	126	0	127
15031	129	0	0	1	0	130
15032	1	127	0	0	0	128
15033	133	0	0	1	0	134
15034	132	0	0	0	0	132
15035	130	1	0	0	0	131
15036	131	0	0	0	0	131
15037	1	128	0	0	0	129
15038	1	0	130	0	0	131
15039	1	0	0	128	0	129
15040	129	1	0	0	0	130
15041	128	0	0	0	0	128
15042	0	0	0	133	0	133
15043	1	0	137	0	0	138
15044	1	0	0	136	0	137
15045	0	141	0	1	0	142
15046	140	0	0	0	0	140
15047	0	0	0	140	0	140
15048	0	136	0	0	0	136
15049	1	138	0	0	0	139
15050	0	145	0	1	0	146
15051	0	0	0	152	0	152
15052	153	0	0	0	0	153
15053	0	160	0	0	0	160
15054	0	0	0	165	0	165
15055	158	0	0	2	0	160
15056	0	1	0	157	0	158
15057	159	0	0	2	0	161
15058	160	0	0	0	0	160
15059	0	174	0	1	0	175
15060	1	0	0	170	0	171
15061	1	172	0	0	0	173
15062	174	1	0	1	0	176
15063	174	0	0	1	0	175
15064	174	1	0	1	0	176
15065	1	0	0	174	0	175
15066	1	0	175	0	0	176
15067	169	0	0	0	0	169
15068	174	0	0	1	0	175
15069	0	0	1	170	0	171
15070	1	175	0	0	0	176
15071	1	0	0	175	0	176
15072	0	0	0	177	0	177
15073	174	1	0	0	0	175
15074	171	0	0	1	0	172
15075	0	0	167	1	0	168
15076	1	0	0	161	0	162
15077	162	0	0	1	0	163
15078	0	0	0	164	0	164
15079	0	0	162	1	0	163
15080	0	157	0	0	0	157
15081	0	164	0	1	0	165
15082	182	0	0	0	0	182
15083	0	0	0	192	0	192
15084	0	0	0	223	0	223
15085	229	0	0	1	0	230
15086	1	0	226	0	0	227
15087	0	0	1	225	0	226
15088	0	0	227	1	0	228
15089	0	230	1	0	0	231
15090	233	1	0	0	0	234
15091	231	0	0	3	0	234
15092	234	0	0	1	0	235
15093	1	0	230	1	0	232
15094	234	0	2	0	0	236
15095	238	0	1	1	0	240
15096	1	0	1	238	0	240
15097	210	1	2	2	0	215
15098	2	1	236	0	0	239
15099	232	0	1	0	0	233
15100	3	0	237	0	0	240
15101	1	236	2	0	0	239
15102	2	3	1	227	0	233
15103	2	233	0	0	0	235
15104	1	1	232	1	0	235
15105	0	231	1	1	0	233
15106	221	1	0	0	0	222
15107	2	216	1	0	0	219
15108	1	217	1	0	0	219
15109	0	2	209	0	0	211
15110	0	1	1	210	0	212
15111	213	0	0	0	0	213
15112	1	2	208	0	0	211
15113	0	210	2	0	0	212
15114	0	2	0	212	0	214
15115	0	1	212	1	0	214
15116	0	2	209	0	0	211
15117	0	1	2	209	0	212
15118	0	0	210	2	0	212
15119	1	0	1	203	0	205
15120	1	203	1	1	0	206
15121	0	2	1	202	0	205
15122	0	200	0	2	0	202
15123	0	1	1	203	0	205
15124	200	0	2	2	0	204
15125	1	0	1	199	0	201
15126	0	195	1	2	0	198
15127	0	1	1	201	0	203
15128	0	1	200	2	0	203
15129	0	1	1	204	0	206
15130	202	1	0	1	0	204
15131	1	0	197	1	0	199
15132	1	0	1	198	0	200
15133	194	0	0	3	0	197
15134	1	196	0	1	0	198
15135	0	2	0	199	0	201
15136	197	0	1	2	0	200
15137	1	0	2	201	0	204
15138	1	0	196	3	0	200
15139	189	0	3	1	0	193
15140	1	192	2	1	0	196
15141	2	189	0	1	0	192
15142	190	3	0	0	0	193
15143	188	0	0	1	0	189
15144	2	0	1	181	0	184
15145	177	0	0	5	0	182
15146	3	0	178	1	0	182
15147	177	0	2	2	0	181
15148	2	182	0	2	0	186
15149	178	3	2	0	0	183
15150	2	2	177	1	0	182
15151	3	0	1	177	0	181
15152	1	1	1	179	0	182
15153	3	1	0	166	0	170
15154	2	166	2	1	0	171
15155	171	1	1	1	0	174
15156	5	2	1	162	0	170
15157	2	171	1	2	0	176
15158	182	2	2	0	0	186
15159	166	1	2	1	0	170
15160	168	0	1	3	0	172
15161	169	0	2	3	0	174
15162	163	2	1	0	0	166
15163	4	1	1	166	0	172
15164	1	2	1	166	0	170
15165	162	2	1	2	0	167
15166	2	2	2	163	0	169
15167	4	1	1	160	0	166
15168	2	1	161	2	0	166
15169	160	3	2	0	0	165
15170	163	0	1	1	0	165
15171	164	3	0	2	0	169
15172	2	1	1	166	0	170
15173	1	170	2	2	0	175
15174	184	2	0	3	0	189
15175	185	1	0	2	0	188
15176	1	2	2	198	0	203
15177	193	2	3	1	0	199
15178	3	2	164	4	0	173
15179	3	195	3	0	0	201
15180	1	198	2	1	0	202
15181	2	3	193	2	0	200
15182	1	165	3	1	0	170
15183	1	162	1	2	0	166
15184	130	0	1	0	0	131
15185	0	127	0	0	0	127
15186	0	0	0	130	0	130
15187	134	0	0	0	0	134
15188	0	0	131	0	0	131
15189	130	0	0	0	0	130
15190	0	0	134	0	0	134
15191	0	0	134	0	0	134
15192	140	0	0	0	0	140
15193	0	0	138	0	0	138
15194	0	133	0	0	0	133
15195	0	0	0	136	0	136
15196	138	0	0	0	0	138
15197	0	135	0	0	0	135
15198	2	0	0	139	0	141
15199	0	0	137	0	0	137
15200	0	0	0	136	0	136
15201	134	0	0	0	0	134
15202	0	0	130	0	0	130
15203	1	1	0	131	0	133
15204	131	1	0	0	0	132
15205	136	0	1	0	0	137
15206	0	1	0	134	0	135
15207	1	1	0	133	0	135
15208	1	0	146	0	0	147
15209	0	1	148	0	0	149
15210	146	0	0	1	0	147
15211	150	0	0	0	0	150
15212	0	150	1	0	0	151
15213	150	0	0	0	0	150
15214	152	0	1	2	0	155
15215	0	0	167	0	0	167
15216	1	169	0	0	0	170
15217	170	0	0	0	0	170
15218	174	1	0	0	0	175
15219	178	0	0	2	0	180
15220	1	0	0	179	0	180
15221	0	0	0	176	0	176
15222	0	178	0	1	0	179
15223	0	0	1	180	0	181
15224	181	0	0	1	0	182
15225	1	0	0	178	0	179
15226	0	0	179	0	0	179
15227	0	0	176	1	0	177
15228	1	0	0	178	0	179
15229	1	0	179	0	0	180
15230	0	0	171	1	0	172
15231	0	0	0	180	0	180
15232	1	0	1	181	0	183
15233	0	0	187	0	0	187
15234	1	0	176	0	0	177
15235	1	183	0	0	0	184
15236	185	1	0	0	0	186
15237	1	191	0	0	0	192
15238	194	0	0	0	0	194
15239	190	0	1	1	0	192
15240	0	195	1	1	0	197
15241	198	0	0	0	0	198
15242	1	0	0	195	0	196
15243	1	0	193	0	0	194
15244	0	0	0	192	0	192
15245	0	0	0	193	0	193
15246	190	1	0	0	0	191
15247	189	0	0	1	0	190
15248	189	0	0	0	0	189
15249	187	0	0	1	0	188
15250	178	0	1	0	0	179
15251	0	177	1	0	0	178
15252	0	0	0	184	0	184
15253	1	0	182	2	0	185
15254	1	0	1	183	0	185
15255	1	0	0	183	0	184
15256	1	0	0	189	0	190
15257	204	0	1	0	0	205
15258	0	0	1	199	0	200
15259	199	1	0	2	0	202
15260	1	0	211	0	0	212
15261	0	1	1	264	0	266
15262	2	0	267	2	0	271
15263	268	0	1	1	0	270
15264	2	1	0	270	0	273
15265	1	0	272	2	0	275
15266	2	0	1	276	0	279
15267	274	0	2	1	0	277
15268	1	0	271	1	0	273
15269	279	0	2	1	0	282
15270	279	0	0	0	0	279
15271	279	0	0	1	0	280
15272	266	1	1	0	0	268
15273	2	267	0	1	0	270
15274	1	250	0	0	0	251
15275	0	248	1	0	0	249
15276	2	1	1	227	0	231
15277	1	235	0	1	0	237
15278	234	1	0	0	0	235
15279	2	225	0	1	0	228
15280	0	233	1	0	0	234
15281	1	1	0	231	0	233
15282	0	1	0	234	0	235
15283	229	0	0	3	0	232
15284	1	1	0	231	0	233
15285	1	0	232	1	0	234
15286	1	1	218	0	0	220
15287	0	1	220	1	0	222
15288	0	0	2	219	0	221
15289	0	0	0	233	0	233
15290	2	0	224	1	0	227
15291	0	0	216	1	0	217
15292	1	0	223	0	0	224
15293	232	0	1	0	0	233
15294	2	0	1	235	0	238
15295	1	0	0	236	0	237
15296	233	0	0	3	0	236
15297	2	1	1	236	0	240
15298	0	236	1	2	0	239
15299	0	238	1	1	0	240
15300	1	3	0	241	0	245
15301	242	0	1	3	0	246
15302	241	0	0	2	0	243
15303	242	1	0	1	0	244
15304	2	0	0	245	0	247
15305	2	0	239	3	0	244
15306	1	1	2	240	0	244
15307	0	0	236	4	0	240
15308	224	1	3	0	0	228
15309	3	0	1	225	0	229
15310	224	0	1	2	0	227
15311	3	0	224	2	0	229
15312	214	1	3	1	0	219
15313	2	0	224	2	0	228
15314	0	210	5	0	0	215
15315	1	208	1	1	0	211
15316	211	2	0	1	0	214
15317	4	0	0	210	0	214
15318	0	0	208	4	0	212
15319	3	204	2	0	0	209
15320	0	204	2	1	0	207
15321	1	4	0	203	0	208
15322	204	2	0	2	0	208
15323	208	0	0	1	0	209
15324	3	207	0	1	0	211
15325	208	2	1	0	0	211
15326	3	1	0	207	0	211
15327	0	1	206	3	0	210
15328	0	206	3	2	0	211
15329	1	3	0	205	0	209
15330	0	0	1	205	0	206
15331	202	1	0	2	0	205
15332	4	0	195	1	0	200
15333	194	1	2	1	0	198
15334	198	0	2	0	0	200
15335	3	1	0	196	0	200
15336	1	0	2	195	0	198
15337	189	1	0	3	0	193
15338	3	1	0	190	0	194
15339	1	0	185	3	0	189
15340	2	0	188	1	0	191
15341	1	186	4	0	0	191
15342	1	194	0	1	0	196
15343	1	2	0	188	0	191
15344	1	188	0	4	0	193
15345	193	2	0	2	0	197
15346	3	193	0	0	0	196
15347	0	4	0	198	0	202
15348	1	0	1	200	0	202
15349	0	1	193	3	0	197
15350	0	0	3	195	0	198
15351	0	1	0	198	0	199
15352	0	200	0	4	0	204
15353	0	3	0	203	0	206
15354	2	0	0	203	0	205
15355	0	1	201	3	0	205
15356	1	198	2	2	0	203
15357	1	9	1	171	0	182
15358	0	182	1	2	0	185
15359	0	1	179	2	0	182
15360	1	166	1	1	0	169
15361	110	2	5	1	0	118
15362	106	1	0	2	0	109
15363	109	0	0	1	0	110
15364	2	106	1	0	0	109
15365	106	1	0	0	0	107
15366	1	1	0	101	0	103
15367	101	1	0	1	0	103
15368	1	99	1	1	0	102
15369	101	1	0	0	0	102
15370	104	1	0	0	0	105
15371	3	101	0	0	0	104
15372	2	0	101	0	0	103
15373	0	2	0	117	0	119
15374	1	0	127	0	0	128
15375	0	0	0	137	0	137
15376	1	0	1	139	0	141
15377	0	1	142	2	0	145
15378	1	0	1	143	0	145
15379	144	0	1	1	0	146
15380	1	0	144	1	0	146
15381	1	145	2	1	0	149
15382	1	1	1	145	0	148
15383	0	1	1	148	0	150
15384	0	1	145	2	0	148
15385	1	2	1	140	0	144
15386	0	141	2	2	0	145
15387	139	0	1	2	0	142
15388	2	141	0	1	0	144
15389	136	2	0	0	0	138
15390	1	134	1	0	0	136
15391	1	137	0	1	0	139
15392	1	2	128	0	0	131
15393	0	5	1	123	0	129
15394	0	1	0	122	0	123
15395	0	0	1	125	0	126
15396	0	127	0	4	0	131
15397	0	2	0	130	0	132
15398	118	1	1	3	0	123
15399	2	1	0	125	0	128
15400	123	0	0	4	0	127
15401	3	0	120	2	0	125
15402	123	0	2	2	0	127
15403	5	0	2	120	0	127
15404	2	0	2	123	0	127
15405	120	1	0	3	0	124
15406	2	0	118	4	0	124
15407	2	113	2	2	0	119
15408	1	2	3	120	0	126
15409	115	2	1	3	0	121
15410	119	1	0	2	0	122
15411	5	0	0	119	0	124
15412	3	1	118	2	0	124
15413	114	0	2	1	0	117
15414	2	1	117	1	0	121
15415	2	1	2	114	0	119
15416	1	0	117	2	0	120
15417	0	0	3	114	0	117
15418	0	0	115	4	0	119
15419	0	113	3	3	0	119
15420	0	3	2	109	0	114
15421	0	112	1	2	0	115
15422	114	2	0	1	0	117
15423	115	2	0	2	0	119
15424	5	1	110	2	0	118
15425	3	0	3	112	0	118
15426	115	0	2	2	0	119
15427	2	0	1	115	0	118
15428	3	0	1	115	0	119
15429	2	0	112	5	0	119
15430	108	0	2	4	0	114
15431	2	1	115	1	0	119
15432	2	0	3	115	0	120
15433	3	0	115	2	0	120
15434	115	0	4	2	0	121
15435	116	1	1	2	0	120
15436	118	0	2	1	0	121
15437	6	0	0	117	0	123
15438	3	0	117	2	0	122
15439	1	0	117	4	0	122
15440	0	1	4	110	0	115
15441	1	114	3	3	0	121
15442	109	3	2	2	0	116
15443	3	3	0	109	0	115
15444	2	2	108	3	0	115
15445	1	0	2	111	0	114
15446	1	0	108	3	0	112
15447	1	0	3	111	0	115
15448	0	0	110	4	0	114
15449	0	0	110	4	0	114
15450	1	108	4	1	0	114
15451	0	2	110	2	0	114
15452	0	2	100	1	0	103
15453	0	1	4	96	0	101
15454	2	0	2	97	0	101
15455	0	99	3	3	0	105
15456	102	2	0	3	0	107
15457	2	98	1	1	0	102
15458	2	2	0	101	0	105
15459	103	1	0	2	0	106
15460	3	1	1	99	0	104
15461	100	0	0	3	0	103
15462	3	0	1	101	0	105
15463	2	0	104	2	0	108
15464	1	0	2	107	0	110
15465	1	1	1	109	0	112
15466	107	0	1	4	0	112
15467	109	0	0	4	0	113
15468	109	0	2	0	0	111
15469	4	106	1	2	0	113
15470	2	107	2	0	0	111
15471	106	2	0	3	0	111
15472	3	2	107	0	0	112
15473	2	0	95	0	0	97
15474	1	2	6	81	0	90
15475	0	0	84	1	0	85
15476	1	0	76	1	0	78
15477	66	0	4	0	0	70
15478	71	0	1	1	0	73
15479	2	71	1	0	0	74
15480	1	69	0	1	0	71
15481	0	2	1	64	0	67
15482	0	69	0	0	0	69
15483	71	2	0	1	0	74
15484	2	2	0	72	0	76
15485	2	73	0	1	0	76
15486	75	1	0	1	0	77
15487	2	1	75	0	0	78
15488	1	0	71	1	0	73
15489	72	0	3	0	0	75
15490	2	0	69	1	0	72
15491	70	0	1	1	0	72
15492	2	0	2	70	0	74
15493	2	0	70	0	0	72
15494	0	70	2	1	0	73
15495	0	71	1	1	0	73
15496	64	2	1	0	0	67
15497	2	67	0	0	0	69
15498	67	0	0	1	0	68
15499	71	0	0	0	0	71
15500	1	67	0	1	0	69
15501	0	1	0	68	0	69
15502	1	0	68	1	0	70
15503	0	71	1	0	0	72
15504	0	3	0	74	0	77
15505	0	0	0	79	0	79
15506	77	0	0	1	0	78
15507	2	0	0	78	0	80
15508	0	0	76	2	0	78
15509	0	77	2	0	0	79
15510	0	2	0	78	0	80
15511	75	0	0	3	0	78
15512	81	0	0	0	0	81
15513	1	0	0	79	0	80
15514	83	0	0	1	0	84
15515	2	0	83	0	0	85
15516	1	0	2	81	0	84
15517	0	0	82	2	0	84
15518	0	0	2	87	0	89
15519	0	0	0	90	0	90
15520	0	0	0	91	0	91
15521	0	0	0	90	0	90
15522	0	0	0	92	0	92
15523	88	0	0	3	0	91
15524	92	0	0	0	0	92
15525	2	90	0	0	0	92
15526	90	2	0	0	0	92
15527	1	0	0	89	0	90
15528	0	0	0	94	0	94
15529	0	0	0	92	0	92
15530	0	0	93	2	0	95
15531	0	2	1	89	0	92
15532	0	94	0	2	0	96
15533	92	2	0	0	0	94
15534	93	0	0	0	0	93
15535	1	0	89	0	0	90
15536	0	91	2	0	0	93
15537	0	2	0	90	0	92
15538	1	0	89	2	0	92
15539	0	0	2	88	0	90
15540	0	91	0	2	0	93
15541	91	2	0	0	0	93
15542	2	92	0	0	0	94
15543	0	2	92	0	0	94
15544	0	1	94	0	0	95
15545	0	94	2	0	0	96
15546	0	91	0	0	0	91
15547	93	2	0	0	0	95
15548	95	0	0	0	0	95
15549	2	0	0	95	0	97
15550	0	0	96	3	0	99
15551	1	1	2	96	0	100
15552	1	0	0	97	0	98
15553	93	0	1	4	0	98
15554	97	0	0	1	0	98
15555	2	0	0	99	0	101
15556	0	0	98	2	0	100
15557	1	99	2	1	0	103
15558	97	2	0	1	0	100
15559	3	100	0	0	0	103
15560	1	2	1	105	0	109
15561	0	0	0	112	0	112
15562	0	1	1	110	0	112
15563	0	0	0	104	0	104
15564	101	0	1	3	0	105
15565	2	0	0	102	0	104
15566	0	101	0	3	0	104
15567	1	2	0	101	0	104
15568	100	1	0	0	0	101
15569	3	96	1	0	0	100
15570	0	3	1	95	0	99
15571	0	1	95	2	0	98
15572	95	1	2	1	0	99
15573	3	0	0	91	0	94
15574	1	0	90	2	0	93
15575	0	0	92	1	0	93
15576	0	1	3	89	0	93
15577	87	1	0	3	0	91
15578	93	0	0	1	0	94
15579	3	91	0	0	0	94
15580	94	2	1	0	0	97
15581	95	1	0	1	0	97
15582	91	0	1	1	0	93
15583	89	1	1	0	0	91
15584	2	0	0	89	0	91
15585	0	2	0	89	0	91
15586	1	0	88	2	0	91
15587	0	85	1	1	0	87
15588	0	87	1	1	0	89
15589	0	1	88	1	0	90
15590	88	1	1	0	0	90
15591	0	1	0	86	0	87
15592	88	1	0	1	0	90
15593	89	0	0	1	0	90
15594	2	0	84	1	0	87
15595	1	1	2	85	0	89
15596	85	0	0	3	0	88
15597	1	0	0	82	0	83
15598	2	0	82	1	0	85
15599	1	0	0	80	0	81
15600	0	82	1	1	0	84
15601	0	82	2	0	0	84
15602	0	2	81	1	0	84
15603	2	75	0	1	0	78
15604	71	0	0	1	0	72
15605	69	1	0	0	0	70
15606	1	0	0	69	0	70
15607	1	0	0	67	0	68
15608	1	0	0	67	0	68
15609	69	0	0	0	0	69
15610	0	68	0	1	0	69
15611	67	0	0	1	0	68
15612	64	0	1	0	0	65
15613	0	66	0	0	0	66
15614	61	1	0	0	0	62
15615	0	61	1	0	0	62
15616	60	0	0	0	0	60
15617	0	0	61	1	0	62
15618	55	0	0	0	0	55
15619	1	54	0	0	0	55
15620	1	0	2	51	0	54
15621	0	0	0	56	0	56
15622	1	0	0	53	0	54
15623	56	0	0	2	0	58
15624	0	0	1	57	0	58
15625	1	0	54	0	0	55
15626	54	0	0	1	0	55
15627	0	1	55	0	0	56
15628	0	0	0	55	0	55
15629	0	0	51	0	0	51
15630	0	1	0	53	0	54
15631	0	53	0	1	0	54
15632	0	0	1	51	0	52
15633	1	52	0	0	0	53
15634	0	0	0	53	0	53
15635	52	0	1	0	0	53
15636	0	0	1	57	0	58
15637	56	0	0	1	0	57
15638	1	0	57	0	0	58
15639	57	0	0	0	0	57
15640	54	1	0	0	0	55
15641	56	0	0	0	0	56
15642	1	0	0	55	0	56
15643	57	0	0	0	0	57
15644	1	0	52	0	0	53
15645	51	0	0	1	0	52
15646	0	0	52	1	0	53
15647	50	0	1	0	0	51
15648	0	1	0	51	0	52
15649	0	1	61	0	0	62
15650	0	0	1	59	0	60
15651	1	0	0	58	0	59
15652	0	0	59	1	0	60
15653	57	0	0	0	0	57
15654	1	60	0	0	0	61
15655	58	0	1	1	0	60
15656	0	57	0	2	0	59
15657	57	0	0	0	0	57
15658	0	0	55	2	0	57
15659	50	0	2	0	0	52
15660	1	50	0	0	0	51
15661	0	0	1	45	0	46
15662	0	0	0	50	0	50
15663	0	0	1	48	0	49
15664	0	0	50	0	0	50
15665	0	1	0	48	0	49
15666	0	0	53	0	0	53
15667	59	1	0	0	0	60
15668	60	0	0	1	0	61
15669	1	0	0	61	0	62
15670	0	1	63	1	0	65
15671	66	0	0	0	0	66
15672	0	0	85	0	0	85
15673	1	0	1	85	0	87
15674	1	0	0	84	0	85
15675	1	0	0	90	0	91
15676	0	0	0	91	0	91
15677	88	0	0	1	0	89
15678	1	88	1	0	0	90
15679	1	1	87	0	0	89
15680	0	83	0	0	0	83
15681	85	1	0	1	0	87
15682	2	0	0	83	0	85
15683	84	0	1	1	0	86
15684	1	0	0	85	0	86
15685	0	0	0	85	0	85
15686	0	0	1	82	0	83
15687	1	0	81	1	0	83
15688	0	82	1	0	0	83
15689	1	1	82	0	0	84
15690	1	1	1	80	0	83
15691	79	0	0	2	0	81
15692	82	0	1	0	0	83
15693	84	0	0	0	0	84
15694	1	83	0	0	0	84
15695	82	1	1	0	0	84
15696	1	0	0	86	0	87
15697	0	0	0	86	0	86
15698	0	0	1	85	0	86
15699	0	82	0	3	0	85
15700	1	1	0	79	0	81
15701	1	83	0	1	0	85
15702	86	1	0	0	0	87
15703	86	1	0	2	0	89
15704	2	0	1	85	0	88
15705	1	0	82	2	0	85
15706	84	0	2	0	0	86
15707	1	0	0	87	0	88
15708	0	0	83	3	0	86
15709	80	0	1	2	0	83
15710	1	0	1	86	0	88
15711	86	1	0	1	0	88
15712	1	84	1	3	0	89
15713	0	1	0	84	0	85
15714	1	84	0	0	0	85
15715	2	1	0	85	0	88
15716	1	87	0	2	0	90
15717	1	2	0	88	0	91
15718	1	0	91	2	0	94
15719	82	0	2	2	0	86
15720	1	91	1	2	0	95
15721	1	1	86	1	0	89
15722	89	1	1	0	0	91
15723	2	0	0	88	0	90
15724	0	1	88	2	0	91
15725	2	87	1	1	0	91
15726	1	1	2	86	0	90
15727	0	0	88	4	0	92
15728	0	0	3	87	0	90
15729	2	0	0	92	0	94
15730	0	0	92	3	0	95
15731	2	0	2	93	0	97
15732	1	1	105	1	0	108
15733	1	0	2	106	0	109
15734	1	0	113	1	0	115
15735	1	0	1	115	0	117
15736	0	0	0	112	0	112
15737	2	1	0	109	0	112
15738	0	109	0	4	0	113
15739	109	2	0	2	0	113
15740	113	1	0	1	0	115
15741	1	0	3	114	0	118
15742	114	2	0	1	0	117
15743	2	1	115	0	0	118
15744	0	116	2	2	0	120
15745	121	1	0	0	0	122
15746	2	124	0	2	0	128
15747	1	1	0	126	0	128
15748	0	2	0	129	0	131
15749	118	0	1	2	0	121
15750	1	1	0	116	0	118
15751	0	0	117	3	0	120
15752	0	117	1	3	0	121
15753	118	1	0	0	0	119
15754	1	0	0	117	0	118
15755	0	118	1	2	0	121
15756	1	2	0	118	0	121
15757	2	119	0	1	0	122
15758	123	1	0	3	0	127
15759	123	0	1	2	0	126
15760	2	0	122	2	0	126
15761	0	2	124	1	0	127
15762	1	0	2	123	0	126
15763	2	128	0	1	0	131
15764	0	1	0	131	0	132
15765	131	0	0	1	0	132
15766	1	0	128	0	0	129
15767	0	1	1	122	0	124
15768	1	0	121	1	0	123
15769	0	1	114	0	0	115
15770	0	128	1	1	0	130
15771	1	3	0	125	0	129
15772	108	0	0	0	0	108
15773	0	0	109	0	0	109
15774	0	108	0	0	0	108
15775	107	0	0	0	0	107
15776	0	0	0	107	0	107
15777	112	0	0	1	0	113
15778	120	0	0	0	0	120
15779	119	0	0	0	0	119
15780	0	0	127	0	0	127
15781	123	0	0	0	0	123
15782	126	0	0	0	0	126
15783	0	129	0	0	0	129
15784	1	0	0	132	0	133
15785	0	0	0	132	0	132
15786	0	0	0	131	0	131
15787	133	0	0	0	0	133
15788	127	0	0	0	0	127
15789	0	0	131	0	0	131
15790	0	0	0	130	0	130
15791	0	131	0	0	0	131
15792	135	0	0	0	0	135
15793	0	0	134	0	0	134
15794	0	0	0	132	0	132
15795	0	0	0	133	0	133
15796	0	134	0	0	0	134
15797	0	0	0	137	0	137
15798	0	0	0	133	0	133
15799	0	0	0	136	0	136
15800	132	0	0	0	0	132
15801	0	0	0	134	0	134
15802	0	0	0	133	0	133
15803	135	0	0	0	0	135
15804	0	0	0	135	0	135
15805	0	153	0	0	0	153
15806	158	0	0	0	0	158
15807	158	0	0	0	0	158
15808	162	0	0	0	0	162
15809	180	0	0	0	0	180
15810	1	196	1	0	0	198
15811	219	1	0	0	0	220
15812	221	0	0	0	0	221
15813	1	0	0	219	0	220
15814	0	2	217	1	0	220
15815	1	1	2	216	0	220
15816	1	0	0	216	0	217
15817	0	0	0	216	0	216
15818	0	0	1	212	0	213
15819	1	0	0	216	0	217
15820	212	0	0	2	0	214
15821	2	0	0	211	0	213
15822	2	0	210	2	0	214
15823	0	2	1	210	0	213
15824	3	207	0	2	0	212
15825	2	1	0	212	0	215
15826	0	0	209	3	0	212
15827	191	0	3	2	0	196
15828	206	0	0	3	0	209
15829	1	2	217	3	0	223
15830	1	220	2	2	0	225
15831	221	1	0	3	0	225
15832	212	0	0	4	0	216
15833	214	0	1	0	0	215
15834	203	2	0	2	0	207
15835	2	0	2	202	0	206
15836	2	0	201	3	0	206
15837	2	2	1	206	0	211
15838	2	0	1	209	0	212
15839	0	1	211	3	0	215
15840	3	0	203	1	0	207
15841	204	0	1	2	0	207
15842	1	202	2	2	0	207
15843	0	3	2	208	0	213
15844	3	0	203	1	0	207
15845	196	0	1	2	0	199
15846	3	1	195	1	0	200
15847	197	0	1	3	0	201
15848	1	195	1	3	0	200
15849	3	1	2	195	0	201
15850	0	0	196	4	0	200
15851	191	0	2	2	0	195
15852	3	193	2	1	0	199
15853	1	198	2	0	0	201
15854	2	2	1	197	0	202
15855	2	1	1	202	0	206
15856	207	2	0	3	0	212
15857	4	205	2	0	0	211
15858	3	1	2	210	0	216
15859	210	0	2	4	0	216
15860	216	0	2	0	0	218
15861	211	4	0	0	0	215
15862	2	0	219	5	0	226
15863	1	0	227	1	0	229
15864	238	0	4	2	0	244
15865	4	238	1	0	0	243
15866	0	240	0	2	0	242
15867	0	2	0	229	0	231
15868	2	240	2	3	0	247
15869	247	2	1	0	0	250
15870	2	2	1	234	0	239
15871	2	1	236	3	0	242
15872	244	1	1	1	0	247
15873	243	0	1	1	0	245
15874	5	0	1	236	0	242
15875	2	1	4	234	0	241
15876	3	2	2	236	0	243
15877	4	3	0	232	0	239
15878	1	2	219	5	0	227
15879	0	224	3	3	0	230
15880	2	1	1	209	0	213
15881	0	222	0	4	0	226
15882	2	2	1	210	0	215
15883	1	213	0	6	0	220
15884	214	1	2	4	0	221
15885	214	1	0	2	0	217
15886	4	213	2	2	0	221
15887	215	2	1	4	0	222
15888	4	0	1	216	0	221
15889	214	2	0	6	0	222
15890	3	212	0	4	0	219
15891	209	2	3	1	0	215
15892	208	3	2	2	0	215
15893	6	0	0	212	0	218
15894	2	4	210	3	0	219
15895	2	209	4	2	0	217
15896	4	3	0	209	0	216
15897	212	1	1	1	0	215
15898	6	0	208	2	0	216
15899	1	3	1	208	0	213
15900	3	1	1	212	0	217
15901	210	0	0	7	0	217
15902	214	1	4	0	0	219
15903	206	4	0	2	0	212
15904	3	207	0	5	0	215
15905	193	2	1	1	0	197
15906	3	0	187	3	0	193
15907	3	1	184	0	0	188
15908	1	3	177	2	0	183
15909	4	10	0	151	0	165
15910	0	0	146	1	0	147
15911	122	0	0	1	0	123
15912	0	0	1	123	0	124
15913	1	1	121	0	0	123
15914	122	1	0	1	0	124
15915	1	1	0	121	0	123
15916	1	0	0	123	0	124
15917	124	1	0	1	0	126
15918	1	0	0	123	0	124
15919	1	1	126	0	0	128
15920	0	1	0	124	0	125
15921	2	0	127	0	0	129
15922	0	0	1	129	0	130
15923	127	0	0	1	0	128
15924	0	124	0	1	0	125
15925	2	126	0	0	0	128
15926	2	0	0	125	0	127
15927	1	0	0	124	0	125
15928	0	124	1	1	0	126
15929	1	115	0	0	0	116
15930	0	0	1	114	0	115
15931	1	0	1	112	0	114
15932	112	0	2	0	0	114
15933	0	112	0	2	0	114
15934	0	114	0	1	0	115
15935	2	113	0	0	0	115
15936	115	0	0	1	0	116
15937	1	0	108	0	0	109
15938	110	1	0	0	0	111
15939	1	0	0	112	0	113
15940	0	107	1	1	0	109
15941	1	113	1	0	0	115
15942	110	0	1	1	0	112
15943	0	0	1	107	0	108
15944	0	116	1	1	0	118
15945	118	1	1	0	0	120
15946	122	0	0	2	0	124
15947	3	0	122	0	0	125
15948	122	0	2	0	0	124
15949	125	1	0	1	0	127
15950	2	0	0	122	0	124
15951	1	118	0	2	0	121
15952	0	120	0	5	0	125
15953	0	3	1	118	0	122
15954	116	0	0	4	0	120
15955	1	0	104	1	0	106
15956	1	0	106	0	0	107
15957	2	0	102	0	0	104
15958	0	0	93	0	0	93
15959	2	89	2	0	0	93
15960	1	89	1	0	0	91
15961	2	2	82	0	0	86
15962	1	1	74	0	0	76
15963	0	63	1	1	0	65
15964	0	2	0	54	0	56
15965	0	0	56	2	0	58
15966	0	0	2	51	0	53
15967	1	0	0	56	0	57
15968	0	0	0	57	0	57
15969	0	0	0	60	0	60
15970	0	0	57	2	0	59
15971	0	0	2	55	0	57
15972	55	0	0	2	0	57
15973	2	0	54	0	0	56
15974	56	0	2	0	0	58
15975	2	0	0	56	0	58
15976	0	0	57	2	0	59
15977	58	0	2	0	0	60
15978	2	0	0	58	0	60
15979	59	0	0	2	0	61
15980	2	0	0	58	0	60
15981	0	59	0	1	0	60
15982	0	2	61	0	0	63
15983	0	0	2	61	0	63
15984	64	0	0	2	0	66
15985	66	0	0	0	0	66
15986	66	0	0	0	0	66
15987	62	0	0	0	0	62
15988	64	0	0	0	0	64
15989	2	60	1	0	0	63
15990	62	2	0	0	0	64
15991	2	0	62	0	0	64
15992	62	0	2	0	0	64
15993	2	0	0	61	0	63
15994	0	0	60	1	0	61
15995	0	0	62	0	0	62
15996	0	0	2	61	0	63
15997	61	0	0	2	0	63
15998	2	59	0	0	0	61
15999	58	2	0	0	0	60
16000	2	59	0	0	0	61
16001	0	2	0	63	0	65
16002	0	1	0	64	0	65
16003	64	0	0	2	0	66
16004	2	0	0	65	0	67
16005	1	0	64	2	0	67
16006	62	0	2	0	0	64
16007	3	0	0	66	0	69
16008	0	0	0	66	0	66
16009	0	1	64	2	0	67
16010	64	1	2	0	0	67
16011	71	0	0	0	0	71
16012	1	66	0	1	0	68
16013	0	2	66	0	0	68
16014	1	0	71	0	0	72
16015	1	0	2	73	0	76
16016	0	0	1	73	0	74
16017	1	71	1	2	0	75
16018	1	2	72	0	0	75
16019	0	0	2	70	0	72
16020	0	1	75	2	0	78
16021	0	1	2	70	0	73
16022	0	73	0	3	0	76
16023	0	2	0	77	0	79
16024	0	0	1	76	0	77
16025	0	0	1	78	0	79
16026	76	0	1	2	0	79
16027	2	0	77	0	0	79
16028	0	78	1	0	0	79
16029	0	3	0	80	0	83
16030	83	0	1	2	0	86
16031	2	0	1	84	0	87
16032	84	1	0	2	0	87
16033	2	0	83	0	0	85
16034	83	0	2	0	0	85
16035	2	0	0	84	0	86
16036	0	0	85	2	0	87
16037	0	83	2	0	0	85
16038	0	2	0	85	0	87
16039	0	0	0	85	0	85
16040	82	0	0	2	0	84
16041	2	83	0	0	0	85
16042	0	83	0	0	0	83
16043	0	86	0	0	0	86
16044	73	1	0	0	0	74
16045	1	77	0	0	0	78
16046	1	0	0	72	0	73
16047	0	0	0	71	0	71
16048	70	0	0	0	0	70
16049	0	69	0	0	0	69
16050	0	0	0	72	0	72
16051	74	0	0	0	0	74
16052	74	0	0	0	0	74
16053	74	0	0	0	0	74
16054	0	73	1	0	0	74
16055	72	0	0	0	0	72
16056	0	0	0	72	0	72
16057	0	72	1	0	0	73
16058	0	74	0	0	0	74
16059	0	0	0	76	0	76
16060	73	0	0	1	0	74
16061	76	0	0	0	0	76
16062	0	1	0	77	0	78
16063	0	80	0	0	0	80
16064	79	1	0	0	0	80
16065	1	0	79	0	0	80
16066	0	1	76	0	0	77
16067	77	0	0	1	0	78
16068	0	0	76	1	0	77
16069	1	0	0	75	0	76
16070	75	1	0	0	0	76
16071	0	0	0	80	0	80
16072	1	0	80	0	0	81
16073	1	84	0	0	0	85
16074	1	0	0	84	0	85
16075	0	1	83	0	0	84
16076	85	0	0	0	0	85
16077	0	0	0	86	0	86
16078	0	0	86	0	0	86
16079	0	1	0	81	0	82
16080	0	81	0	1	0	82
16081	1	0	0	85	0	86
16082	1	0	0	84	0	85
16083	0	0	0	85	0	85
16084	0	83	0	0	0	83
16085	84	0	0	0	0	84
16086	0	0	0	84	0	84
16087	0	0	1	85	0	86
16088	1	0	0	85	0	86
16089	0	0	87	0	0	87
16090	0	0	0	87	0	87
16091	86	0	0	0	0	86
16092	0	85	0	1	0	86
16093	0	0	1	88	0	89
16094	0	1	0	88	0	89
16095	87	0	0	1	0	88
16096	0	87	0	0	0	87
16097	88	0	0	0	0	88
16098	90	0	0	1	0	91
16099	0	0	1	90	0	91
16100	90	0	0	1	0	91
16101	0	89	0	0	0	89
16102	89	0	0	1	0	90
16103	0	0	0	87	0	87
16104	98	0	0	1	0	99
16105	98	1	0	0	0	99
16106	1	0	95	0	0	96
16107	96	0	0	2	0	98
16108	102	0	0	1	0	103
16109	112	0	0	2	0	114
16110	0	0	116	0	0	116
16111	0	113	0	1	0	114
16112	0	0	0	116	0	116
16113	116	1	0	1	0	118
16114	0	111	1	1	0	113
16115	109	1	0	1	0	111
16116	1	0	0	110	0	111
16117	1	1	112	0	0	114
16118	118	1	0	0	0	119
16119	2	0	0	118	0	120
16120	0	0	118	2	0	120
16121	118	0	1	0	0	119
16122	1	1	117	0	0	119
16123	1	0	0	121	0	122
16124	0	0	1	129	0	130
16125	128	0	0	1	0	129
16126	131	0	1	0	0	132
16127	1	129	1	1	0	132
16128	130	1	0	1	0	132
16129	3	0	124	0	0	127
16130	2	0	123	0	0	125
16131	123	1	1	0	0	125
16132	2	126	0	0	0	128
16133	121	1	1	0	0	123
16134	1	119	0	0	0	120
16135	122	1	0	0	0	123
16136	1	1	0	119	0	121
16137	1	1	119	1	0	122
16138	1	1	2	115	0	119
16139	1	0	0	118	0	119
16140	119	0	0	2	0	121
16141	1	0	118	0	0	119
16142	114	0	1	1	0	116
16143	1	115	0	1	0	117
16144	116	1	0	0	0	117
16145	1	0	1	116	0	118
16146	1	0	112	1	0	114
16147	0	1	1	116	0	118
16148	117	0	0	1	0	118
16149	1	0	0	116	0	117
16150	0	0	1	113	0	114
16151	0	108	0	2	0	110
16152	1	1	0	111	0	113
16153	0	0	110	2	0	112
16154	0	0	1	110	0	111
16155	0	1	0	112	0	113
16156	111	0	0	3	0	114
16157	1	0	1	111	0	113
16158	0	0	105	2	0	107
16159	0	110	1	1	0	112
16160	1	1	0	110	0	112
16161	0	0	1	114	0	115
16162	108	1	1	2	0	112
16163	1	106	0	1	0	108
16164	0	1	0	108	0	109
16165	101	1	0	3	0	105
16166	105	0	0	1	0	106
16167	1	1	0	105	0	107
16168	0	0	109	2	0	111
16169	109	0	1	0	0	110
16170	2	0	0	114	0	116
16171	112	0	1	2	0	115
16172	112	0	1	0	0	113
16173	2	106	1	0	0	109
16174	105	1	0	2	0	108
16175	2	102	0	2	0	106
16176	2	1	1	106	0	110
16177	2	1	0	108	0	111
16178	1	107	1	1	0	110
16179	107	2	0	1	0	110
16180	106	0	1	2	0	109
16181	2	0	104	1	0	107
16182	2	1	105	0	0	108
16183	1	2	1	104	0	108
16184	106	0	0	1	0	107
16185	1	1	2	103	0	107
16186	1	0	2	109	0	112
16187	1	0	107	3	0	111
16188	1	1	107	0	0	109
16189	1	0	106	2	0	109
16190	105	1	1	2	0	109
16191	108	0	0	0	0	108
16192	1	99	2	1	0	103
16193	1	101	2	0	0	104
16194	1	2	0	104	0	107
16195	2	0	103	1	0	106
16196	103	0	1	1	0	105
16197	1	1	111	0	0	113
16198	2	0	1	107	0	110
16199	0	1	1	111	0	113
16200	2	0	0	110	0	112
16201	0	0	1	112	0	113
16202	109	0	1	2	0	112
16203	1	0	0	117	0	118
16204	1	0	105	2	0	108
16205	100	0	1	3	0	104
16206	2	0	104	2	0	108
16207	1	1	100	1	0	103
16208	0	100	2	2	0	104
16209	1	2	2	85	0	90
16210	85	0	0	2	0	87
16211	1	0	0	87	0	88
16212	1	0	87	1	0	89
16213	0	0	1	87	0	88
16214	87	0	0	1	0	88
16215	1	86	0	0	0	87
16216	86	1	0	1	0	88
16217	1	81	0	1	0	83
16218	79	1	0	0	0	80
16219	1	76	1	0	0	78
16220	0	76	0	0	0	76
16221	0	1	74	0	0	75
16222	0	75	1	0	0	76
16223	65	1	3	0	0	69
16224	1	0	0	64	0	65
16225	65	0	0	1	0	66
16226	1	64	0	0	0	65
16227	64	1	0	0	0	65
16228	1	0	64	0	0	65
16229	0	0	1	64	0	65
16230	0	71	0	1	0	72
16231	0	1	0	72	0	73
16232	0	0	0	73	0	73
16233	83	0	0	1	0	84
16234	1	84	0	0	0	85
16235	86	1	0	0	0	87
16236	1	0	87	0	0	88
16237	0	0	88	0	0	88
16238	0	89	1	0	0	90
16239	0	2	0	88	0	90
16240	0	0	89	2	0	91
16241	0	0	2	87	0	89
16242	0	0	0	91	0	91
16243	0	0	87	2	0	89
16244	0	0	89	0	0	89
16245	0	0	90	0	0	90
16246	0	0	88	0	0	88
16247	0	89	1	0	0	90
16248	0	2	0	89	0	91
16249	0	0	0	91	0	91
16250	0	0	89	2	0	91
16251	0	0	2	86	0	88
16252	0	0	88	2	0	90
16253	0	0	2	92	0	94
16254	0	1	0	93	0	94
16255	0	92	0	2	0	94
16256	0	2	0	92	0	94
16257	0	0	0	93	0	93
16258	0	0	0	93	0	93
16259	0	0	89	2	0	91
16260	0	89	1	0	0	90
16261	90	2	0	0	0	92
16262	92	0	0	1	0	93
16263	2	0	0	91	0	93
16264	0	0	0	93	0	93
16265	0	91	0	2	0	93
16266	92	2	0	0	0	94
16267	2	92	0	0	0	94
16268	84	2	0	0	0	86
16269	2	0	85	0	0	87
16270	82	0	2	0	0	84
16271	2	90	0	0	0	92
16272	0	2	0	91	0	93
16273	0	0	0	91	0	91
16274	0	92	0	2	0	94
16275	91	2	0	0	0	93
16276	2	1	0	94	0	97
16277	0	0	0	98	0	98
16278	97	0	0	4	0	101
16279	105	0	0	1	0	106
16280	4	0	101	0	0	105
16281	104	0	3	0	0	107
16282	3	0	1	105	0	109
16283	1	0	105	3	0	109
16284	0	0	3	105	0	108
16285	0	0	102	3	0	105
16286	0	0	102	2	0	104
16287	0	0	4	104	0	108
16288	0	1	104	3	0	108
16289	1	107	3	1	0	112
16290	0	3	0	106	0	109
16291	1	1	0	112	0	114
16292	0	0	110	4	0	114
16293	1	110	3	1	0	115
16294	112	4	1	0	0	117
16295	3	0	0	114	0	117
16296	111	0	0	4	0	115
16297	3	106	0	1	0	110
16298	1	4	110	0	0	115
16299	0	1	4	106	0	111
16300	110	0	1	5	0	116
16301	5	0	110	1	0	116
16302	104	0	4	1	0	109
16303	4	103	2	0	0	109
16304	1	108	0	0	0	109
16305	104	4	0	1	0	109
16306	4	1	1	102	0	108
16307	2	0	0	106	0	108
16308	0	102	1	6	0	109
16309	0	4	1	106	0	111
16310	0	0	0	108	0	108
16311	102	0	1	5	0	108
16312	4	1	0	102	0	107
16313	1	0	103	5	0	109
16314	0	0	4	105	0	109
16315	0	0	1	109	0	110
16316	0	1	104	5	0	110
16317	1	0	3	104	0	108
16318	107	0	0	5	0	112
16319	113	0	0	1	0	114
16320	114	1	0	0	0	115
16321	5	0	1	109	0	115
16322	1	0	105	4	0	110
16323	1	108	3	1	0	113
16324	0	2	2	108	0	112
16325	0	1	107	3	0	111
16326	0	1	3	107	0	111
16327	0	1	0	108	0	109
16328	107	0	0	4	0	111
16329	3	108	0	2	0	113
16330	1	3	100	1	0	105
16331	103	2	3	0	0	108
16332	2	103	1	1	0	107
16333	1	96	0	0	0	97
16334	95	4	0	0	0	99
16335	3	1	0	93	0	97
16336	1	0	106	2	0	109
16337	0	0	2	105	0	107
16338	0	103	0	2	0	105
16339	104	2	0	1	0	107
16340	2	1	0	109	0	112
16341	111	0	0	2	0	113
16342	2	0	0	111	0	113
16343	1	114	0	1	0	116
16344	114	2	0	1	0	117
16345	114	1	0	0	0	115
16346	3	113	0	1	0	117
16347	114	3	0	0	0	117
16348	4	1	0	113	0	118
16349	1	112	0	3	0	116
16350	115	3	0	1	0	119
16351	3	117	0	0	0	120
16352	116	3	0	0	0	119
16353	3	0	0	119	0	122
16354	121	0	0	3	0	124
16355	122	0	0	1	0	123
16356	124	0	0	0	0	124
16357	3	0	1	120	0	124
16358	1	0	0	125	0	126
16359	120	0	0	5	0	125
16360	3	0	117	1	0	121
16361	1	0	3	117	0	121
16362	0	123	1	3	0	127
16363	0	2	0	122	0	124
16364	0	1	0	126	0	127
16365	0	0	123	4	0	127
16366	0	0	3	136	0	139
16367	0	148	1	3	0	152
16368	0	3	0	155	0	158
16369	0	1	169	3	0	173
16370	0	0	3	176	0	179
16371	0	0	1	179	0	180
16372	174	0	0	5	0	179
16373	172	0	0	3	0	175
16374	5	0	0	174	0	179
16375	1	167	0	3	0	171
16376	0	168	0	0	0	168
16377	0	3	170	0	0	173
16378	1	2	2	166	0	171
16379	160	0	2	2	0	164
16380	2	0	0	167	0	169
16381	1	0	164	2	0	167
16382	1	0	2	165	0	168
16383	0	0	1	167	0	168
16384	0	0	0	166	0	166
16385	0	0	161	3	0	164
16386	0	160	2	1	0	163
16387	157	2	1	1	0	161
16388	159	1	0	0	0	160
16389	3	0	0	154	0	157
16390	1	0	154	2	0	157
16391	0	152	1	1	0	154
16392	1	2	1	154	0	158
16393	0	156	0	3	0	159
16394	0	153	0	1	0	154
16395	151	3	0	0	0	154
16396	2	1	152	0	0	155
16397	1	0	153	1	0	155
16398	0	0	1	150	0	151
16399	0	0	1	152	0	153
16400	0	0	152	2	0	154
16401	1	0	1	151	0	153
16402	0	0	151	2	0	153
16403	146	0	1	1	0	148
16404	2	0	1	150	0	153
16405	1	0	165	2	0	168
16406	1	1	1	156	0	159
16407	0	174	1	1	0	176
16408	171	0	0	1	0	172
16409	1	168	0	1	0	170
16410	171	1	0	0	0	172
16411	1	1	165	1	0	168
16412	168	0	2	0	0	170
16413	1	0	1	170	0	172
16414	1	0	171	2	0	174
16415	0	0	1	170	0	171
16416	0	0	167	1	0	168
16417	164	1	0	1	0	166
16418	2	167	1	0	0	170
16419	2	1	0	160	0	163
16420	0	166	1	2	0	169
16421	165	0	0	2	0	167
16422	167	2	0	1	0	170
16423	3	168	0	0	0	171
16424	2	2	0	171	0	175
16425	0	2	0	169	0	171
16426	1	1	0	173	0	175
16427	170	2	1	2	0	175
16428	1	169	2	3	0	175
16429	2	1	1	168	0	172
16430	2	1	1	168	0	172
16431	163	0	1	4	0	168
16432	2	0	161	2	0	165
16433	2	1	160	2	0	165
16434	155	0	2	3	0	160
16435	1	0	157	2	0	160
16436	1	1	144	0	0	146
16437	1	2	2	143	0	148
16438	144	1	1	3	0	149
16439	3	0	1	145	0	149
16440	1	1	140	3	0	145
16441	134	0	3	2	0	139
16442	2	1	138	0	0	141
16443	3	139	0	0	0	142
16444	0	0	1	148	0	149
16445	148	3	2	1	0	154
16446	1	2	0	151	0	154
16447	3	0	2	146	0	151
16448	154	0	1	2	0	157
16449	1	0	0	155	0	156
16450	2	0	1	159	0	162
16451	1	2	159	1	0	163
16452	1	0	0	157	0	158
16453	156	1	2	1	0	160
16454	155	2	0	2	0	159
16455	157	0	1	2	0	160
16456	1	1	2	155	0	159
16457	2	154	1	1	0	158
16458	156	1	0	2	0	159
16459	1	158	0	1	0	160
16460	158	1	0	2	0	161
16461	1	1	0	160	0	162
16462	160	0	2	1	0	163
16463	161	0	1	1	0	163
16464	160	0	1	2	0	163
16465	1	154	2	0	0	157
16466	1	143	0	2	0	146
16467	129	0	1	0	0	130
16468	1	129	0	0	0	130
16469	1	112	0	0	0	113
16470	2	104	0	0	0	106
16471	105	0	0	0	0	105
16472	1	0	0	102	0	103
16473	0	0	0	103	0	103
16474	107	0	0	0	0	107
16475	0	0	112	0	0	112
16476	0	0	0	129	0	129
16477	1	0	0	128	0	129
16478	0	0	1	134	0	135
16479	0	0	0	147	0	147
16480	0	149	0	1	0	150
16481	0	184	0	1	0	185
16482	190	1	0	1	0	192
16483	1	2	0	188	0	191
16484	1	2	0	195	0	198
16485	2	0	193	2	0	197
16486	0	0	1	200	0	201
16487	0	0	199	3	0	202
16488	0	0	3	201	0	204
16489	0	0	208	3	0	211
16490	0	208	3	1	0	212
16491	0	1	1	209	0	211
16492	202	1	2	1	0	206
16493	202	2	0	1	0	205
16494	2	0	0	206	0	208
16495	3	0	203	1	0	207
16496	2	0	201	1	0	204
16497	199	0	2	2	0	203
16498	1	201	3	0	0	205
16499	203	1	2	1	0	207
16500	201	1	0	0	0	202
16501	2	2	196	0	0	200
16502	3	0	2	197	0	202
16503	2	1	1	197	0	201
16504	0	0	2	203	0	205
16505	1	0	0	189	0	190
16506	1	0	0	190	0	191
16507	0	0	179	5	0	184
16508	0	0	182	3	0	185
16509	0	0	3	183	0	186
16510	1	0	3	181	0	185
16511	0	1	2	181	0	184
16512	180	0	0	5	0	185
16513	3	0	0	180	0	183
16514	176	2	1	3	0	182
16515	5	0	0	182	0	187
16516	183	0	0	6	0	189
16517	182	0	0	5	0	187
16518	181	0	2	4	0	187
16519	184	0	0	3	0	187
16520	181	1	3	0	0	185
16521	4	0	0	181	0	185
16522	178	0	2	2	0	182
16523	3	176	0	2	0	181
16524	175	1	0	4	0	180
16525	6	1	0	172	0	179
16526	3	2	176	2	0	183
16527	3	0	1	179	0	183
16528	0	0	178	4	0	182
16529	1	0	5	178	0	184
16530	2	0	1	181	0	184
16531	1	2	178	2	0	183
16532	3	0	178	4	0	185
16533	4	1	2	179	0	186
16534	179	0	5	2	0	186
16535	2	0	180	5	0	187
16536	1	183	3	4	0	191
16537	3	1	185	4	0	193
16538	185	1	5	3	0	194
16539	1	2	1	189	0	193
16540	186	0	4	3	0	193
16541	185	1	3	1	0	190
16542	2	0	1	190	0	193
16543	4	0	182	5	0	191
16544	4	0	1	182	0	187
16545	2	0	2	179	0	183
16546	176	1	3	5	0	185
16547	4	176	2	3	0	185
16548	3	1	1	175	0	180
16549	3	3	172	2	0	180
16550	174	2	2	1	0	179
16551	5	166	1	2	0	174
16552	4	1	3	171	0	179
16553	5	1	0	170	0	176
16554	1	2	0	174	0	177
16555	166	0	1	7	0	174
16556	167	2	1	3	0	173
16557	3	0	0	171	0	174
16558	3	0	167	5	0	175
16559	2	164	5	1	0	172
16560	167	2	1	5	0	175
16561	168	2	4	2	0	176
16562	2	2	1	170	0	175
16563	5	0	0	171	0	176
16564	2	0	169	4	0	175
16565	2	168	3	5	0	178
16566	172	1	1	5	0	179
16567	173	1	2	2	0	178
16568	4	172	3	0	0	179
16569	174	4	0	0	0	178
16570	4	1	2	170	0	177
16571	5	1	173	1	0	180
16572	2	1	1	176	0	180
16573	4	0	170	4	0	178
16574	167	1	2	1	0	171
16575	2	162	1	4	0	169
16576	3	2	3	143	0	151
16577	2	0	145	3	0	150
16578	0	2	131	5	0	138
16579	125	0	3	2	0	130
16580	3	124	2	2	0	131
16581	85	2	2	2	0	91
16582	82	0	0	1	0	83
16583	80	0	1	1	0	82
16584	0	2	1	77	0	80
16585	1	1	79	1	0	82
16586	0	78	1	1	0	80
16587	1	3	2	72	0	78
16588	0	1	74	1	0	76
16589	1	0	69	0	0	70
16590	1	1	0	68	0	70
16591	1	1	68	0	0	70
16592	67	0	0	1	0	68
16593	1	0	1	68	0	70
16594	0	0	0	71	0	71
16595	69	0	0	0	0	69
16596	0	69	0	0	0	69
16597	72	0	0	1	0	73
16598	1	0	1	72	0	74
16599	1	0	1	77	0	79
16600	0	0	0	79	0	79
16601	0	0	2	76	0	78
16602	75	0	0	0	0	75
16603	0	0	76	1	0	77
16604	0	71	0	1	0	72
16605	1	0	1	75	0	77
16606	75	1	0	1	0	77
16607	74	0	1	0	0	75
16608	1	79	0	1	0	81
16609	78	0	1	2	0	81
16610	0	80	0	2	0	82
16611	1	86	0	1	0	88
16612	1	1	0	88	0	90
16613	1	0	89	0	0	90
16614	0	1	0	90	0	91
16615	86	0	0	2	0	88
16616	0	85	0	1	0	86
16617	1	0	0	89	0	90
16618	1	1	103	0	0	105
16619	107	0	0	0	0	107
16620	105	2	0	0	0	107
16621	108	1	0	2	0	111
16622	0	0	109	0	0	109
16623	108	0	0	0	0	108
16624	0	110	0	0	0	110
16625	2	0	0	110	0	112
16626	0	111	0	0	0	111
16627	113	0	0	0	0	113
16628	112	0	0	1	0	113
16629	0	0	116	0	0	116
16630	0	114	0	1	0	115
16631	1	0	0	115	0	116
16632	0	1	0	116	0	117
16633	0	0	0	116	0	116
16634	1	0	1	117	0	119
16635	1	0	0	122	0	123
16636	1	0	117	0	0	118
16637	1	111	0	0	0	112
16638	113	0	1	0	0	114
16639	1	0	114	0	0	115
16640	0	118	0	0	0	118
16641	118	0	0	1	0	119
16642	0	1	121	0	0	122
16643	122	0	0	0	0	122
16644	122	0	0	0	0	122
16645	118	0	1	0	0	119
16646	0	123	0	0	0	123
16647	0	0	119	1	0	120
16648	0	121	0	1	0	122
16649	0	1	0	109	0	110
16650	0	118	0	1	0	119
16651	122	0	0	1	0	123
16652	128	0	1	0	0	129
16653	127	1	0	0	0	128
16654	1	0	125	1	0	127
16655	0	131	1	0	0	132
16656	0	1	0	145	0	146
16657	163	0	0	0	0	163
16658	1	162	1	0	0	164
16659	1	1	0	161	0	163
16660	0	0	164	1	0	165
16661	170	1	1	0	0	172
16662	1	0	173	1	0	175
16663	0	0	183	0	0	183
16664	176	0	2	0	0	178
16665	2	0	177	0	0	179
16666	174	0	3	0	0	177
16667	3	171	0	0	0	174
16668	177	2	1	0	0	180
16669	2	0	0	176	0	178
16670	0	1	0	178	0	179
16671	2	0	0	176	0	178
16672	175	1	0	3	0	179
16673	176	0	0	1	0	177
16674	176	0	1	1	0	178
16675	4	171	0	0	0	175
16676	1	2	1	174	0	178
16677	1	0	175	2	0	178
16678	2	2	2	172	0	178
16679	0	169	1	3	0	173
16680	1	2	1	173	0	177
16681	0	1	0	171	0	172
16682	166	1	0	2	0	169
16683	2	0	0	167	0	169
16684	0	0	164	4	0	168
16685	1	0	161	1	0	163
16686	1	0	2	159	0	162
16687	162	0	1	2	0	165
16688	3	0	1	160	0	164
16689	0	1	1	164	0	166
16690	2	0	161	3	0	166
16691	0	157	4	1	0	162
16692	1	2	1	161	0	165
16693	159	0	1	2	0	162
16694	2	157	1	1	0	161
16695	1	2	0	159	0	162
16696	2	1	157	2	0	162
16697	1	1	2	154	0	158
16698	153	0	2	4	0	159
16699	2	147	2	1	0	152
16700	0	2	150	3	0	155
16701	2	1	2	146	0	151
16702	1	1	150	2	0	154
16703	150	0	3	1	0	154
16704	148	2	1	1	0	152
16705	2	2	146	3	0	153
16706	1	0	3	146	0	150
16707	4	0	146	2	0	152
16708	1	139	4	0	0	144
16709	0	2	2	144	0	148
16710	1	0	141	3	0	145
16711	2	1	3	132	0	138
16712	1	133	1	4	0	139
16713	1	4	2	131	0	138
16714	1	1	135	3	0	140
16715	130	1	2	4	0	137
16716	4	130	1	3	0	138
16717	131	3	1	3	0	138
16718	5	0	118	3	0	126
16719	119	1	5	0	0	125
16720	6	1	118	0	0	125
16721	118	1	5	1	0	125
16722	123	2	1	1	0	127
16723	3	1	1	121	0	126
16724	1	0	3	121	0	125
16725	120	1	1	4	0	126
16726	2	119	0	3	0	124
16727	117	3	0	4	0	124
16728	5	1	1	113	0	120
16729	2	118	1	5	0	126
16730	1	4	1	124	0	130
16731	2	0	3	125	0	130
16732	2	1	2	125	0	130
16733	4	121	0	5	0	130
16734	118	4	2	2	0	126
16735	4	0	0	123	0	127
16736	1	1	121	4	0	127
16737	1	2	123	2	0	128
16738	0	3	120	4	0	127
16739	121	0	5	1	0	127
16740	120	2	1	2	0	125
16741	5	2	116	1	0	124
16742	1	0	4	113	0	118
16743	1	1	2	111	0	115
16744	2	0	111	5	0	118
16745	2	3	111	3	0	119
16746	2	1	4	113	0	120
16747	113	0	3	6	0	122
16748	118	0	2	1	0	121
16749	116	0	3	2	0	121
16750	7	110	1	0	0	118
16751	3	114	2	1	0	120
16752	2	3	2	106	0	113
16753	107	2	0	5	0	114
16754	5	2	103	1	0	111
16755	95	1	4	2	0	102
16756	3	88	1	2	0	94
16757	0	71	0	0	0	71
16758	68	2	0	0	0	70
16759	2	64	2	0	0	68
16760	0	64	0	0	0	64
16761	54	3	0	3	0	60
16762	2	54	0	1	0	57
16763	0	1	0	48	0	49
16764	1	0	0	49	0	50
16765	49	0	0	1	0	50
16766	51	0	0	0	0	51
16767	1	51	0	0	0	52
16768	0	51	0	0	0	51
16769	0	1	52	0	0	53
16770	51	0	1	1	0	53
16771	56	0	0	0	0	56
16772	56	0	0	0	0	56
16773	1	0	0	55	0	56
16774	0	0	0	56	0	56
16775	55	0	0	1	0	56
16776	1	0	0	55	0	56
16777	0	0	56	1	0	57
16778	0	0	1	56	0	57
16779	0	59	0	1	0	60
16780	0	1	0	59	0	60
16781	0	0	0	62	0	62
16782	0	0	0	61	0	61
16783	58	0	0	1	0	59
16784	1	62	0	0	0	63
16785	0	1	0	64	0	65
16786	0	0	63	1	0	64
16787	0	0	65	0	0	65
16788	0	0	1	64	0	65
16789	0	0	0	64	0	64
16790	62	0	0	1	0	63
16791	1	0	0	61	0	62
16792	0	62	0	1	0	63
16793	0	1	66	0	0	67
16794	0	0	1	65	0	66
16795	0	0	70	1	0	71
16796	0	0	1	70	0	71
16797	70	0	0	2	0	72
16798	71	0	0	0	0	71
16799	1	73	0	0	0	74
16800	0	1	0	74	0	75
16801	75	0	0	1	0	76
16802	74	0	0	0	0	74
16803	78	0	0	0	0	78
16804	77	0	0	0	0	77
16805	77	0	0	0	0	77
16806	0	76	0	0	0	76
16807	77	1	0	0	0	78
16808	1	0	77	0	0	78
16809	0	1	1	76	0	78
16810	78	0	0	1	0	79
16811	78	0	0	0	0	78
16812	78	0	0	0	0	78
16813	1	0	85	0	0	86
16814	0	0	1	82	0	83
16815	85	0	0	1	0	86
16816	1	87	0	0	0	88
16817	91	1	0	0	0	92
16818	89	0	0	0	0	89
16819	88	0	0	0	0	88
16820	1	0	0	89	0	90
16821	90	0	0	2	0	92
16822	2	0	95	0	0	97
16823	1	0	91	0	0	92
16824	94	0	2	0	0	96
16825	2	0	93	0	0	95
16826	91	0	1	0	0	92
16827	1	0	92	0	0	93
16828	0	0	1	93	0	94
16829	85	0	0	1	0	86
16830	1	85	0	0	0	86
16831	86	1	0	0	0	87
16832	1	86	0	0	0	87
16833	0	91	0	0	0	91
16834	0	1	0	91	0	92
16835	0	0	0	92	0	92
16836	0	0	0	91	0	91
16837	0	0	88	1	0	89
16838	88	0	1	0	0	89
16839	89	0	0	0	0	89
16840	91	0	0	0	0	91
16841	93	0	0	0	0	93
16842	95	0	0	0	0	95
16843	1	0	90	0	0	91
16844	0	0	93	0	0	93
16845	0	0	1	92	0	93
16846	0	0	92	1	0	93
16847	97	0	1	0	0	98
16848	2	102	0	0	0	104
16849	0	2	0	108	0	110
16850	106	0	0	2	0	108
16851	2	0	0	111	0	113
16852	0	0	113	2	0	115
16853	0	0	118	0	0	118
16854	0	0	1	121	0	122
16855	0	0	120	2	0	122
16856	119	0	2	0	0	121
16857	2	0	0	122	0	124
16858	0	0	124	2	0	126
16859	0	117	2	0	0	119
16860	0	2	0	125	0	127
16861	0	0	129	1	0	130
16862	0	0	1	126	0	127
16863	0	0	0	126	0	126
16864	0	0	130	2	0	132
16865	0	0	2	128	0	130
16866	1	0	0	127	0	128
16867	0	0	0	126	0	126
16868	123	0	0	2	0	125
16869	2	122	0	0	0	124
16870	0	126	0	0	0	126
16871	0	2	122	0	0	124
16872	118	0	2	0	0	120
16873	2	1	117	0	0	120
16874	0	0	120	0	0	120
16875	0	0	2	115	0	117
16876	118	0	0	2	0	120
16877	2	119	0	0	0	121
16878	116	2	0	0	0	118
16879	115	0	0	0	0	115
16880	1	119	0	0	0	120
16881	117	2	0	0	0	119
16882	116	0	0	0	0	116
16883	2	117	0	0	0	119
16884	0	2	0	117	0	119
16885	0	0	0	122	0	122
16886	120	0	0	2	0	122
16887	2	121	0	0	0	123
16888	127	1	0	0	0	128
16889	128	1	0	0	0	129
16890	137	0	0	0	0	137
16891	3	0	0	137	0	140
16892	1	0	0	140	0	141
16893	133	0	0	3	0	136
16894	141	0	0	1	0	142
16895	139	1	0	0	0	140
16896	4	0	0	143	0	147
16897	2	0	142	3	0	147
16898	1	0	3	145	0	149
16899	0	0	1	155	0	156
16900	0	0	153	5	0	158
16901	0	0	172	1	0	173
16902	1	0	4	171	0	176
16903	1	0	172	3	0	176
16904	173	0	3	4	0	180
16905	3	0	2	175	0	180
16906	1	0	0	181	0	182
16907	183	0	0	4	0	187
16908	3	0	1	184	0	188
16909	1	0	1	186	0	188
16910	1	0	0	186	0	187
16911	0	0	1	187	0	188
16912	1	0	182	4	0	187
16913	0	0	3	174	0	177
16914	0	0	172	4	0	176
16915	1	172	4	1	0	178
16916	0	3	1	168	0	172
16917	0	1	162	4	0	167
16918	162	0	4	2	0	168
16919	3	163	1	3	0	170
16920	160	2	2	1	0	165
16921	4	1	0	157	0	162
16922	1	156	1	4	0	162
16923	157	3	0	2	0	162
16924	2	156	0	2	0	160
16925	157	2	1	2	0	162
16926	3	1	1	155	0	160
16927	157	1	0	4	0	162
16928	2	155	1	2	0	160
16929	158	3	1	1	0	163
16930	2	2	158	2	0	164
16931	2	0	4	157	0	163
16932	158	2	1	2	0	163
16933	160	1	0	2	0	163
16934	4	0	1	159	0	164
16935	3	0	155	3	0	161
16936	0	149	2	1	0	152
16937	3	158	1	0	0	162
16938	163	4	1	1	0	169
16939	3	2	0	164	0	169
16940	3	0	0	167	0	170
16941	164	1	1	3	0	169
16942	164	1	0	2	0	167
16943	4	0	161	2	0	167
16944	2	2	4	157	0	165
16945	1	1	162	3	0	167
16946	3	159	2	1	0	165
16947	152	1	2	2	0	157
16948	1	148	1	3	0	153
16949	3	150	0	1	0	154
16950	2	3	0	150	0	155
16951	144	2	1	3	0	150
16952	2	142	1	3	0	148
16953	141	2	2	1	0	146
16954	1	142	0	2	0	145
16955	4	1	1	143	0	149
16956	143	2	1	2	0	148
16957	2	1	146	2	0	151
16958	2	0	2	150	0	154
16959	3	0	144	2	0	149
16960	1	143	2	1	0	147
16961	2	144	1	2	0	149
16962	141	4	1	2	0	148
16963	1	142	0	4	0	147
16964	148	1	0	2	0	151
16965	145	4	1	0	0	150
16966	3	2	140	2	0	147
16967	145	0	1	2	0	148
16968	3	3	146	0	0	152
16969	1	146	1	2	0	150
16970	147	1	1	0	0	149
16971	2	149	1	0	0	152
16972	2	1	0	149	0	152
16973	150	1	1	1	0	153
16974	2	1	2	148	0	153
16975	2	2	148	3	0	155
16976	2	0	3	150	0	155
16977	0	3	1	149	0	153
16978	154	2	0	2	0	158
16979	4	1	148	2	0	155
16980	153	2	2	2	0	159
16981	161	1	1	1	0	164
16982	5	1	1	163	0	170
16983	2	2	2	164	0	170
16984	161	0	1	5	0	167
16985	2	160	1	3	0	166
16986	3	2	2	162	0	169
16987	2	1	157	3	0	163
16988	0	1	152	2	0	155
16989	1	161	2	1	0	165
16990	1	3	2	151	0	157
16991	2	0	0	154	0	156
16992	150	0	1	2	0	153
16993	1	1	1	150	0	153
16994	142	0	0	2	0	144
16995	4	138	0	0	0	142
16996	0	140	2	2	0	144
16997	2	138	0	4	0	144
16998	142	0	3	0	0	145
16999	121	0	2	1	0	124
17000	0	122	0	1	0	123
17001	103	0	0	1	0	104
17002	0	100	0	1	0	101
17003	1	0	0	101	0	102
17004	0	103	0	1	0	104
17005	102	0	0	0	0	102
17006	101	1	0	0	0	102
17007	0	1	0	98	0	99
17008	97	1	0	0	0	98
17009	1	0	0	97	0	98
17010	1	101	0	0	0	102
17011	0	1	0	102	0	103
17012	1	101	0	0	0	102
17013	102	1	0	0	0	103
17014	0	0	99	1	0	100
17015	97	1	0	0	0	98
17016	1	0	0	101	0	102
17017	1	0	104	0	0	105
17018	104	0	0	1	0	105
17019	1	0	109	0	0	110
17020	0	0	0	105	0	105
17021	0	1	0	111	0	112
17022	0	0	1	108	0	109
17023	0	1	0	109	0	110
17024	1	108	0	1	0	110
17025	0	0	1	115	0	116
17026	114	0	0	3	0	117
17027	2	1	112	1	0	116
17028	0	117	2	1	0	120
17029	118	1	0	0	0	119
17030	125	1	2	0	0	128
17031	1	2	0	144	0	147
17032	1	1	146	2	0	150
17033	2	0	1	147	0	150
17034	0	0	0	160	0	160
17035	0	2	156	1	0	159
17036	1	160	1	2	0	164
17037	163	2	0	2	0	167
17038	160	1	2	1	0	164
17039	164	4	0	0	0	168
17040	7	0	0	160	0	167
17041	6	0	0	161	0	167
17042	162	0	0	5	0	167
17043	3	0	1	161	0	165
17044	1	167	0	6	0	174
17045	170	1	0	2	0	173
17046	170	1	1	2	0	174
17047	181	4	0	0	0	185
17048	185	0	0	0	0	185
17049	6	0	172	0	0	178
17050	5	0	172	0	0	177
17051	2	1	4	173	0	180
17052	0	0	4	175	0	179
17053	2	0	175	3	0	180
17054	0	0	173	4	0	177
17055	0	0	4	170	0	174
17056	170	0	2	4	0	176
17057	4	0	2	162	0	168
17058	2	0	164	6	0	172
17059	4	164	3	1	0	172
17060	165	3	1	3	0	172
17061	167	1	4	0	0	172
17062	169	2	1	1	0	173
17063	171	1	0	2	0	174
17064	7	0	163	1	0	171
17065	4	0	4	163	0	171
17066	167	0	2	5	0	174
17067	4	0	2	168	0	174
17068	2	0	0	168	0	170
17069	2	161	0	6	0	169
17070	0	3	2	166	0	171
17071	164	3	0	5	0	172
17072	4	164	0	1	0	169
17073	164	3	0	2	0	169
17074	5	163	0	0	0	168
17075	2	5	0	159	0	166
17076	2	160	0	4	0	166
17077	2	165	0	2	0	169
17078	160	4	1	3	0	168
17079	3	4	159	1	0	167
17080	3	2	155	1	0	161
17081	3	0	151	0	0	154
17082	143	0	6	2	0	151
17083	5	144	3	0	0	152
17084	1	146	2	1	0	150
17085	140	4	0	1	0	145
17086	3	138	1	1	0	143
17087	1	141	1	1	0	144
17088	2	5	0	138	0	145
17089	1	3	135	3	0	142
17090	2	2	138	2	0	144
17091	0	1	5	139	0	145
17092	136	0	4	4	0	144
17093	5	133	3	1	0	142
17094	4	3	0	139	0	146
17095	3	2	137	4	0	146
17096	2	3	127	2	0	134
17097	2	0	4	130	0	136
17098	127	1	3	5	0	136
17099	132	1	2	1	0	136
17100	5	0	128	4	0	137
17101	130	1	4	0	0	135
17102	7	0	132	1	0	140
17103	3	0	4	129	0	136
17104	4	130	2	2	0	138
17105	131	4	4	1	0	140
17106	3	1	1	132	0	137
17107	2	2	2	131	0	137
17108	1	0	2	135	0	138
17109	0	0	2	135	0	137
17110	1	0	126	7	0	134
17111	3	125	3	3	0	134
17112	1	3	2	130	0	136
17113	128	1	3	3	0	135
17114	4	3	1	128	0	136
17115	2	0	1	129	0	132
17116	3	2	123	5	0	133
17117	2	0	116	4	0	122
17118	2	116	4	4	0	126
17119	1	119	4	2	0	126
17120	1	5	1	118	0	125
17121	116	2	1	3	0	122
17122	4	1	114	3	0	122
17123	2	116	3	2	0	123
17124	2	4	1	114	0	121
17125	1	107	1	2	0	111
17126	1	4	0	106	0	111
17127	0	106	0	4	0	110
17128	2	3	0	100	0	105
17129	97	3	1	3	0	104
17130	3	91	0	1	0	95
17131	1	6	0	66	0	73
17132	68	1	0	3	0	72
17133	3	63	0	1	0	67
17134	1	50	1	1	0	53
17135	1	53	0	0	0	54
17136	4	2	1	43	0	50
17137	0	1	0	41	0	42
17138	0	42	0	2	0	44
17139	0	2	0	42	0	44
17140	0	0	41	2	0	43
17141	1	44	1	0	0	46
17142	0	3	0	42	0	45
17143	0	42	0	2	0	44
17144	1	1	40	0	0	42
17145	0	43	1	0	0	44
17146	32	0	0	0	0	32
17147	0	0	0	32	0	32
17148	31	0	0	0	0	31
17149	0	0	31	0	0	31
17150	0	0	0	34	0	34
17151	0	0	35	0	0	35
17152	0	0	0	36	0	36
17153	39	0	0	0	0	39
17154	0	0	0	40	0	40
17155	39	0	0	0	0	39
17156	0	41	0	0	0	41
17157	40	0	0	0	0	40
17158	0	0	44	0	0	44
17159	0	46	0	0	0	46
17160	0	0	0	49	0	49
17161	0	0	0	53	0	53
17162	0	1	51	0	0	52
17163	0	54	0	0	0	54
17164	0	0	0	52	0	52
17165	0	52	0	0	0	52
17166	0	0	0	53	0	53
17167	0	53	0	0	0	53
17168	53	0	0	0	0	53
17169	0	0	0	60	0	60
17170	0	0	59	0	0	59
17171	0	59	0	0	0	59
17172	0	63	0	0	0	63
17173	0	0	59	0	0	59
17174	0	63	0	0	0	63
17175	0	0	0	59	0	59
17176	0	0	57	0	0	57
17177	0	0	0	59	0	59
17178	0	1	0	61	0	62
17179	0	0	59	0	0	59
17180	59	0	0	0	0	59
17181	0	0	0	60	0	60
17182	0	0	64	0	0	64
17183	0	65	0	0	0	65
17184	68	0	0	0	0	68
17185	0	67	0	0	0	67
17186	0	0	0	71	0	71
17187	71	0	0	0	0	71
17188	0	0	0	71	0	71
17189	0	0	71	0	0	71
17190	0	0	1	72	0	73
17191	0	0	71	1	0	72
17192	70	0	1	0	0	71
17193	1	0	72	0	0	73
17194	72	0	1	0	0	73
17195	76	0	0	0	0	76
17196	1	0	75	0	0	76
17197	0	0	72	0	0	72
17198	0	71	1	0	0	72
17199	75	1	0	0	0	76
17200	1	0	0	81	0	82
17201	0	0	0	81	0	81
17202	87	0	0	1	0	88
17203	88	0	0	0	0	88
17204	86	0	0	0	0	86
17205	88	0	0	0	0	88
17206	1	0	0	89	0	90
17207	89	0	0	1	0	90
17208	1	0	0	89	0	90
17209	0	0	0	92	0	92
17210	0	0	0	92	0	92
17211	0	0	91	1	0	92
17212	0	90	1	0	0	91
17213	0	95	0	0	0	95
17214	0	1	0	94	0	95
17215	94	0	0	1	0	95
17216	1	0	0	94	0	95
17217	93	0	0	1	0	94
17218	1	0	105	0	0	106
17219	102	0	1	0	0	103
17220	1	0	0	108	0	109
17221	111	0	0	2	0	113
17222	111	0	0	0	0	111
17223	112	0	0	0	0	112
17224	1	0	0	112	0	113
17225	0	0	108	1	0	109
17226	0	0	1	112	0	113
17227	115	0	0	1	0	116
17228	1	0	120	0	0	121
17229	0	0	1	137	0	138
17230	142	0	0	3	0	145
17231	1	1	144	0	0	146
17232	150	0	1	0	0	151
17233	155	0	0	3	0	158
17234	1	0	0	161	0	162
17235	0	0	0	164	0	164
17236	161	0	0	1	0	162
17237	1	0	0	166	0	167
17238	168	0	0	2	0	170
17239	1	173	0	0	0	174
17240	0	178	0	1	0	179
17241	1	1	0	174	0	176
17242	0	1	174	1	0	176
17243	0	175	1	0	0	176
17244	173	1	0	1	0	175
17245	1	167	1	0	0	169
17246	0	2	170	0	0	172
17247	2	0	2	166	0	170
17248	0	1	172	1	0	174
17249	0	176	1	0	0	177
17250	0	1	0	176	0	177
17251	0	173	1	1	0	175
17252	0	2	175	0	0	177
17253	0	0	1	172	0	173
17254	0	1	172	1	0	174
17255	0	0	2	171	0	173
17256	170	0	0	3	0	173
17257	1	0	169	0	0	170
17258	163	0	1	2	0	166
17259	2	0	163	0	0	165
17260	0	0	2	161	0	163
17261	1	0	172	1	0	174
17262	0	0	2	174	0	176
17263	0	0	0	177	0	177
17264	0	0	1	173	0	174
17265	0	0	0	175	0	175
17266	0	0	185	2	0	187
17267	182	0	1	2	0	185
17268	1	0	0	192	0	193
17269	191	0	1	1	0	193
17270	202	0	0	0	0	202
17271	203	0	0	1	0	204
17272	2	0	0	206	0	208
17273	1	1	0	216	0	218
17274	1	248	0	0	0	249
17275	270	2	0	1	0	273
17276	288	1	0	2	0	291
17277	294	1	0	1	0	296
17278	6	0	296	0	0	302
17279	4	0	2	297	0	303
17280	4	0	297	2	0	303
17281	290	0	5	1	0	296
17282	299	0	1	3	0	303
17283	3	0	3	301	0	307
17284	4	0	0	300	0	304
17285	3	305	0	3	0	311
17286	307	2	0	4	0	313
17287	309	1	0	2	0	312
17288	3	307	0	0	0	310
17289	309	1	0	0	0	310
17290	4	1	0	312	0	317
17291	1	2	0	313	0	316
17292	314	0	0	3	0	317
17293	1	0	311	4	0	316
17294	312	0	1	3	0	316
17295	316	0	1	0	0	317
17296	2	314	1	0	0	317
17297	320	1	0	0	0	321
17298	4	1	314	0	0	319
17299	1	3	1	316	0	321
17300	315	0	1	1	0	317
17301	1	0	3	315	0	319
17302	0	0	307	4	0	311
17303	2	0	1	303	0	306
17304	1	336	1	4	0	342
17305	0	1	2	346	0	349
17306	0	1	0	347	0	348
17307	0	3	0	342	0	345
17308	0	0	0	346	0	346
17309	0	0	340	5	0	345
17310	0	0	1	344	0	345
17311	342	1	1	4	0	348
17312	2	340	3	1	0	346
17313	3	1	0	353	0	357
17314	4	1	355	1	0	361
17315	0	3	2	357	0	362
17316	352	1	1	5	0	359
17317	354	0	4	2	0	360
17318	341	0	0	3	0	344
17319	7	0	0	345	0	352
17320	4	0	345	2	0	351
17321	3	342	1	3	0	349
17322	351	2	1	3	0	357
17323	3	1	3	349	0	356
17324	3	3	0	351	0	357
17325	3	1	350	3	0	357
17326	1	350	1	4	0	356
17327	0	355	1	3	0	359
17328	1	1	2	346	0	350
17329	2	3	334	1	0	340
17330	316	5	1	1	0	323
17331	3	0	327	3	0	333
17332	320	0	4	1	0	325
17333	4	329	1	1	0	335
17334	3	1	330	0	0	334
17335	325	1	3	0	0	329
17336	2	331	1	1	0	335
17337	347	1	4	0	0	352
17338	2	2	344	1	0	349
17339	2	347	2	0	0	351
17340	348	1	1	2	0	352
17341	1	1	346	1	0	349
17342	341	1	1	2	0	345
17343	3	0	1	347	0	351
17344	348	0	2	1	0	351
17345	3	0	0	350	0	353
17346	349	1	1	3	0	354
17347	3	0	357	2	0	362
17348	2	0	1	365	0	368
17349	2	1	2	355	0	360
17350	1	0	362	4	0	367
17351	0	0	3	360	0	363
17352	0	315	6	6	0	327
17353	2	1	2	386	0	391
17354	2	3	0	411	0	416
17355	2	2	0	450	0	454
17356	0	0	451	7	0	458
17357	464	1	5	6	0	476
17358	6	2	1	490	0	499
17359	4	0	499	6	0	509
17360	495	0	6	4	0	505
17361	495	0	2	6	0	503
17362	508	1	4	0	0	513
17363	12	2	0	505	0	519
17364	6	1	0	558	0	565
17365	2	1	1	545	0	549
17366	2	543	1	15	0	561
17367	540	8	1	8	0	557
17368	547	5	1	3	0	556
17369	16	3	1	535	0	555
17370	8	1	530	11	0	550
17371	4	0	535	6	0	545
17372	3	513	12	3	0	531
17373	1	525	5	2	0	533
17374	473	18	6	4	0	501
17375	8	470	0	3	0	481
17376	458	7	2	2	0	469
17377	458	3	1	1	0	463
17378	459	1	1	2	0	463
17379	8	1	3	447	0	459
17380	6	1	0	479	0	486
17381	483	2	0	12	0	497
17382	12	0	1	495	0	508
17383	5	1	498	9	0	513
17384	503	0	8	3	0	514
17385	11	0	3	497	0	511
17386	4	1	0	501	0	506
17387	4	0	0	512	0	516
17388	1	0	502	13	0	516
17389	474	1	8	5	0	488
17390	10	0	493	2	0	505
17391	5	0	11	495	0	511
17392	1	2	496	11	0	510
17393	2	1	9	481	0	493
17394	3	0	4	495	0	502
17395	1	2	498	13	0	514
17396	2	1	11	477	0	491
17397	3	502	4	9	0	518
17398	506	9	2	4	0	521
17399	511	4	0	4	0	519
17400	12	0	2	506	0	520
17401	6	1	505	9	0	521
17402	1	492	9	7	0	509
17403	1	513	6	2	0	522
17404	481	12	1	2	0	496
17405	9	6	470	4	0	489
17406	472	0	9	5	0	486
17407	11	1	5	472	0	489
17408	4	1	1	487	0	493
17409	469	2	2	13	0	486
17410	12	474	1	4	0	491
17411	4	8	475	3	0	490
17412	2	3	9	472	0	486
17413	1	2	473	11	0	487
17414	1	466	8	7	0	482
17415	3	9	5	463	0	480
17416	463	5	1	15	0	484
17417	471	1	3	9	0	484
17418	16	1	458	1	0	476
17419	5	460	9	5	0	479
17420	451	10	4	6	0	471
17421	13	459	3	2	0	477
17422	8	12	1	451	0	472
17423	451	4	1	11	0	467
17424	11	0	2	454	0	467
17425	8	2	438	11	0	459
17426	2	2	9	442	0	455
17427	1	4	442	11	0	458
17428	5	0	8	443	0	456
17429	442	3	4	9	0	458
17430	11	439	2	8	0	460
17431	443	9	6	3	0	461
17432	11	3	2	438	0	454
17433	4	3	4	438	0	449
17434	0	3	415	18	0	436
17435	3	1	436	6	0	446
17436	2	436	10	1	0	449
17437	5	9	422	1	0	437
17438	402	5	8	5	0	420
17439	13	407	5	1	0	426
17440	6	406	1	8	0	421
17441	1	423	2	5	0	431
17442	3	16	2	413	0	434
17443	3	4	418	12	0	437
17444	1	415	15	6	0	437
17445	4	11	6	400	0	421
17446	2	417	2	12	0	433
17447	397	13	1	8	0	419
17448	412	5	0	6	0	423
17449	16	1	3	400	0	420
17450	7	2	1	400	0	410
17451	382	3	4	15	0	404
17452	11	372	1	7	0	391
17453	2	374	2	3	0	381
17454	2	12	1	342	0	357
17455	3	3	304	8	0	318
17456	1	295	9	6	0	311
17457	266	8	6	2	0	282
17458	8	263	0	2	0	273
17459	3	258	1	1	0	263
17460	246	8	1	2	0	257
17461	7	245	2	2	0	256
17462	0	10	238	1	0	249
17463	2	232	7	1	0	242
17464	185	5	3	1	0	194
17465	4	188	0	2	0	194
17466	186	3	4	1	0	194
17467	3	0	2	187	0	192
17468	0	1	1	190	0	192
17469	2	0	187	4	0	193
17470	1	185	3	1	0	190
17471	1	6	0	181	0	188
17472	181	0	0	4	0	185
17473	182	1	1	0	0	184
17474	3	182	1	0	0	186
17475	0	4	0	184	0	188
17476	182	1	0	4	0	187
17477	187	2	0	0	0	189
17478	6	0	179	1	0	186
17479	1	2	178	1	0	182
17480	0	0	161	0	0	161
17481	1	151	3	1	0	156
17482	134	2	2	1	0	139
17483	2	128	0	0	0	130
17484	125	2	0	0	0	127
17485	2	136	0	1	0	139
17486	1	2	0	142	0	145
17487	145	1	0	3	0	149
17488	1	1	147	1	0	150
17489	148	0	2	2	0	152
17490	151	0	1	0	0	152
17491	4	159	0	0	0	163
17492	1	164	0	0	0	165
17493	166	2	0	1	0	169
17494	3	1	170	0	0	174
17495	167	0	3	0	0	170
17496	165	0	2	0	0	167
17497	3	0	1	164	0	168
17498	165	0	1	2	0	168
17499	2	1	0	172	0	175
17500	2	0	0	174	0	176
17501	0	1	0	170	0	171
17502	1	163	0	4	0	168
17503	168	3	0	2	0	173
17504	166	1	0	2	0	169
17505	4	0	0	169	0	173
17506	1	0	1	167	0	169
17507	1	164	0	3	0	168
17508	165	2	0	1	0	168
17509	2	2	161	0	0	165
17510	1	1	2	164	0	168
17511	1	0	161	2	0	164
17512	0	0	3	160	0	163
17513	1	0	163	2	0	166
17514	1	0	2	160	0	163
17515	165	0	1	3	0	169
17516	3	0	174	1	0	178
17517	174	0	2	1	0	177
17518	2	183	1	1	0	187
17519	1	2	0	185	0	188
17520	0	2	0	188	0	190
17521	188	0	0	2	0	190
17522	3	0	0	202	0	205
17523	1	0	199	3	0	203
17524	203	0	2	1	0	206
17525	213	1	1	0	0	215
17526	214	0	0	0	0	214
17527	213	0	1	0	0	214
17528	2	208	0	1	0	211
17529	1	2	1	208	0	212
17530	206	1	0	3	0	210
17531	2	0	1	206	0	209
17532	200	0	0	3	0	203
17533	3	0	198	1	0	202
17534	1	0	199	0	0	200
17535	0	0	2	206	0	208
17536	0	200	1	1	0	202
17537	1	211	0	1	0	213
17538	207	3	0	1	0	211
17539	2	1	210	0	0	213
17540	210	0	0	0	0	210
17541	0	212	1	0	0	213
17542	217	0	0	0	0	217
17543	0	1	0	215	0	216
17544	1	2	216	0	0	219
17545	0	0	0	215	0	215
17546	0	0	1	212	0	213
17547	0	213	0	1	0	214
17548	0	214	0	1	0	215
17549	0	1	0	213	0	214
17550	0	218	0	0	0	218
17551	0	0	218	0	0	218
17552	0	0	213	0	0	213
17553	212	0	1	0	0	213
17554	215	0	1	0	0	216
17555	1	215	0	0	0	216
17556	1	0	0	212	0	213
17557	0	1	0	210	0	211
17558	0	0	215	0	0	215
17559	0	0	0	200	0	200
17560	0	205	1	0	0	206
17561	0	0	206	1	0	207
17562	0	1	206	0	0	207
17563	0	200	1	0	0	201
17564	0	0	204	0	0	204
17565	0	1	0	207	0	208
17566	0	0	1	190	0	191
17567	0	1	207	1	0	209
17568	0	0	0	200	0	200
17569	0	199	1	0	0	200
17570	0	209	0	1	0	210
17571	0	0	0	214	0	214
17572	0	1	223	0	0	224
17573	0	219	0	1	0	220
17574	0	2	1	222	0	225
17575	0	1	218	0	0	219
17576	211	0	0	0	0	211
17577	213	0	0	0	0	213
17578	217	0	0	0	0	217
17579	0	0	0	208	0	208
17580	0	0	0	210	0	210
17581	0	1	214	0	0	215
17582	0	0	0	210	0	210
17583	1	0	0	215	0	216
17584	0	0	219	0	0	219
17585	190	0	0	0	0	190
17586	0	196	0	0	0	196
17587	193	0	0	0	0	193
17588	0	191	0	0	0	191
17589	0	0	0	192	0	192
17590	0	0	195	0	0	195
17591	0	0	0	180	0	180
17592	0	0	185	0	0	185
17593	167	0	1	0	0	168
17594	0	0	176	0	0	176
17595	0	0	0	173	0	173
17596	0	0	176	0	0	176
17597	0	179	0	0	0	179
17598	1	0	0	186	0	187
17599	0	0	0	186	0	186
17600	0	0	0	189	0	189
17601	0	0	193	0	0	193
17602	0	0	191	0	0	191
17603	0	0	0	194	0	194
17604	0	0	0	240	0	240
17605	0	0	0	260	0	260
17606	274	0	0	3	0	277
17607	2	0	0	285	0	287
17608	1	0	305	3	0	309
17609	319	0	2	2	0	323
17610	3	0	1	329	0	333
17611	337	0	2	3	0	342
17612	347	0	1	1	0	349
17613	4	0	0	349	0	353
17614	350	0	0	5	0	355
17615	351	0	0	3	0	354
17616	5	0	343	3	0	351
17617	4	343	3	1	0	351
17618	3	3	2	335	0	343
17619	1	1	2	341	0	345
17620	338	3	0	6	0	347
17621	336	0	0	4	0	340
17622	330	0	0	3	0	333
17623	8	0	323	1	0	332
17624	5	323	3	0	0	331
17625	323	3	1	1	0	328
17626	3	323	4	0	0	330
17627	322	7	0	0	0	329
17628	6	1	0	327	0	334
17629	322	3	0	4	0	329
17630	329	0	0	1	0	330
17631	323	0	0	3	0	326
17632	8	0	330	0	0	338
17633	327	0	4	0	0	331
17634	6	332	1	0	0	339
17635	330	3	3	0	0	336
17636	331	2	0	0	0	333
17637	330	2	0	0	0	332
17638	7	0	0	325	0	332
17639	5	323	0	3	0	331
17640	325	3	0	1	0	329
17641	4	1	316	5	0	326
17642	1	321	4	0	0	326
17643	3	3	1	296	0	303
17644	0	312	2	3	0	317
17645	311	6	0	1	0	318
17646	321	1	0	3	0	325
17647	6	2	0	317	0	325
17648	4	0	313	5	0	322
17649	3	313	5	1	0	322
17650	2	5	1	282	0	290
17651	0	2	4	325	0	331
17652	0	3	0	333	0	336
17653	327	0	0	10	0	337
17654	328	1	0	2	0	331
17655	333	0	0	3	0	336
17656	336	0	0	1	0	337
17657	8	0	0	330	0	338
17658	4	0	334	6	0	344
17659	6	1	5	335	0	347
17660	1	0	2	346	0	349
17661	1	1	4	343	0	349
17662	3	0	0	347	0	350
17663	335	0	0	13	0	348
17664	8	0	2	337	0	347
17665	338	0	1	8	0	347
17666	345	0	0	4	0	349
17667	9	0	335	5	0	349
17668	7	1	335	0	0	343
17669	4	0	340	3	0	347
17670	4	3	9	334	0	350
17671	4	0	334	6	0	344
17672	1	1	9	327	0	338
17673	3	2	1	323	0	329
17674	325	0	3	9	0	337
17675	9	0	0	322	0	331
17676	4	323	2	11	0	340
17677	339	7	1	1	0	348
17678	10	335	1	3	0	349
17679	3	8	342	1	0	354
17680	6	345	7	1	0	359
17681	345	10	2	1	0	358
17682	9	3	3	341	0	356
17683	5	4	337	7	0	353
17684	343	0	6	3	0	352
17685	9	0	4	339	0	352
17686	5	3	343	6	0	357
17687	7	1	6	346	0	360
17688	3	2	3	351	0	359
17689	3	0	4	350	0	357
17690	4	346	0	7	0	357
17691	351	7	0	6	0	364
17692	9	2	1	345	0	357
17693	5	358	1	6	0	370
17694	6	6	1	354	0	367
17695	0	5	349	12	0	366
17696	3	356	6	5	0	370
17697	352	7	3	4	0	366
17698	353	3	4	1	0	361
17699	11	4	0	340	0	355
17700	6	2	0	346	0	354
17701	341	1	2	9	0	353
17702	338	1	1	4	0	344
17703	8	334	0	7	0	349
17704	291	4	2	2	0	299
17705	5	0	266	1	0	272
17706	2	1	250	2	0	255
17707	2	245	4	1	0	252
17708	0	240	0	2	0	242
17709	219	4	2	0	0	225
17710	5	212	1	2	0	220
17711	213	3	1	0	0	217
17712	208	0	1	0	0	209
17713	207	0	1	0	0	208
17714	3	0	0	202	0	205
17715	202	0	1	3	0	206
17716	3	0	201	0	0	204
17717	0	0	203	1	0	204
17718	1	206	3	0	0	210
17719	0	3	214	0	0	217
17720	1	1	3	211	0	216
17721	1	0	218	3	0	222
17722	1	1	208	0	0	210
17723	0	0	4	213	0	217
17724	212	1	0	3	0	216
17725	217	0	0	0	0	217
17726	3	0	224	1	0	228
17727	223	0	4	0	0	227
17728	4	0	227	0	0	231
17729	230	0	3	1	0	234
17730	238	0	1	0	0	239
17731	3	0	0	236	0	239
17732	0	0	0	235	0	235
17733	0	230	0	5	0	235
17734	1	234	0	0	0	235
17735	2	3	0	230	0	235
17736	0	1	0	232	0	233
17737	228	1	0	3	0	232
17738	3	223	1	0	0	227
17739	224	3	1	0	0	228
17740	3	226	1	0	0	230
17741	1	4	221	0	0	226
17742	1	0	3	224	0	228
17743	228	1	0	4	0	233
17744	246	0	0	1	0	247
17745	5	245	0	0	0	250
17746	2	259	0	0	0	261
17747	0	265	0	1	0	266
17748	4	2	0	278	0	284
17749	0	0	288	4	0	292
17750	0	288	4	0	0	292
17751	1	4	0	291	0	296
17752	0	0	1	300	0	301
17753	0	0	299	4	0	303
17754	0	0	298	0	0	298
17755	296	0	2	0	0	298
17756	3	0	298	1	0	302
17757	297	0	3	2	0	302
17758	292	0	0	0	0	292
17759	289	0	1	0	0	290
17760	293	1	0	0	0	294
17761	3	0	286	2	0	291
17762	1	288	3	1	0	293
17763	1	4	1	290	0	296
17764	0	0	294	5	0	299
17765	1	0	3	290	0	294
17766	0	271	4	3	0	278
17767	1	4	1	292	0	298
17768	1	0	0	297	0	298
17769	1	0	0	286	0	287
17770	292	0	0	3	0	295
17771	4	1	1	288	0	294
17772	1	1	0	290	0	292
17773	1	0	0	288	0	289
17774	0	278	3	3	0	284
17775	276	3	0	2	0	281
17776	3	270	0	1	0	274
17777	1	267	1	3	0	272
17778	0	4	0	271	0	275
17779	0	2	0	262	0	264
17780	259	1	0	5	0	265
17781	4	0	0	262	0	266
17782	257	0	2	6	0	265
17783	312	1	0	1	0	314
17784	4	1	0	307	0	312
17785	1	0	0	308	0	309
17786	0	314	1	5	0	320
17787	324	4	1	0	0	329
17788	6	332	0	1	0	339
17789	327	6	1	3	0	337
17790	7	2	323	0	0	332
17791	323	1	4	2	0	330
17792	329	1	0	3	0	333
17793	9	0	0	320	0	329
17794	0	2	323	7	0	332
17795	4	317	5	1	0	327
17796	1	7	1	322	0	331
17797	3	0	321	8	0	332
17798	2	2	8	319	0	331
17799	320	1	1	6	0	328
17800	9	1	316	1	0	327
17801	2	317	6	2	0	327
17802	3	320	5	1	0	329
17803	3	8	2	290	0	303
17804	4	318	1	4	0	327
17805	320	5	3	2	0	330
17806	323	0	3	5	0	331
17807	327	3	0	0	0	330
17808	6	3	309	3	0	321
17809	313	2	7	2	0	324
17810	5	3	3	315	0	326
17811	2	2	1	317	0	322
17812	4	4	1	316	0	325
17813	4	1	2	318	0	325
17814	2	2	313	8	0	325
17815	5	2	314	1	0	322
17816	0	1	309	5	0	315
17817	299	1	4	2	0	306
17818	7	302	2	5	0	316
17819	5	6	0	297	0	308
17820	287	0	2	9	0	298
17821	7	286	2	3	0	298
17822	2	294	3	3	0	302
17823	289	6	2	3	0	300
17824	289	2	2	4	0	297
17825	6	287	1	4	0	298
17826	1	8	2	268	0	279
17827	2	274	2	9	0	287
17828	273	8	2	1	0	284
17829	275	2	1	3	0	281
17830	270	3	0	3	0	276
17831	7	260	0	3	0	270
17832	7	6	0	261	0	274
17833	4	4	256	7	0	271
17834	4	1	5	261	0	271
17835	2	5	1	264	0	272
17836	7	1	257	6	0	271
17837	263	4	4	0	0	271
17838	9	1	0	262	0	272
17839	1	3	3	254	0	261
17840	3	258	0	10	0	271
17841	259	6	2	3	0	270
17842	7	0	2	257	0	266
17843	2	249	1	9	0	261
17844	234	5	2	2	0	243
17845	6	231	1	4	0	242
17846	213	5	2	3	0	223
17847	8	0	211	4	0	223
17848	2	2	182	2	0	188
17849	3	1	169	1	0	174
17850	1	178	2	3	0	184
17851	0	6	4	151	0	161
17852	2	159	1	3	0	165
17853	165	5	1	0	0	171
17854	5	0	162	1	0	168
17855	163	1	6	0	0	170
17856	167	1	2	0	0	170
17857	4	1	1	162	0	168
17858	163	3	0	3	0	169
17859	4	0	1	169	0	174
17860	0	2	169	3	0	174
17861	167	0	3	0	0	170
17862	3	163	2	0	0	168
17863	3	3	0	163	0	169
17864	164	1	0	3	0	168
17865	5	0	0	161	0	166
17866	2	1	163	3	0	169
17867	2	0	3	161	0	166
17868	1	161	2	3	0	167
17869	165	3	0	2	0	170
17870	5	2	0	160	0	167
17871	160	0	0	8	0	168
17872	5	0	1	160	0	166
17873	1	0	0	166	0	167
17874	0	162	2	2	0	166
17875	161	3	0	2	0	166
17876	4	168	0	1	0	173
17877	3	2	0	159	0	164
17878	0	165	1	5	0	171
17879	166	2	0	2	0	170
17880	163	1	0	2	0	166
17881	166	0	0	2	0	168
17882	2	160	0	1	0	163
17883	1	108	0	1	0	110
17884	106	3	0	0	0	109
17885	2	108	1	1	0	112
17886	2	4	2	92	0	100
17887	3	0	86	1	0	90
17888	81	0	0	0	0	81
17889	78	0	0	0	0	78
17890	81	0	0	0	0	81
17891	0	81	0	0	0	81
17892	77	0	0	0	0	77
17893	0	0	83	0	0	83
17894	0	80	0	0	0	80
17895	0	2	0	74	0	76
17896	0	68	0	0	0	68
17897	68	0	0	0	0	68
17898	0	69	0	0	0	69
17899	0	0	0	71	0	71
17900	0	71	0	0	0	71
17901	0	0	0	75	0	75
17902	0	0	0	71	0	71
17903	0	0	71	0	0	71
17904	1	0	0	68	0	69
17905	66	0	0	0	0	66
17906	64	0	0	0	0	64
17907	0	0	0	65	0	65
17908	0	0	65	0	0	65
17909	0	0	0	65	0	65
17910	64	0	0	0	0	64
17911	72	0	0	0	0	72
17912	73	0	0	0	0	73
17913	0	81	0	0	0	81
17914	83	0	0	0	0	83
17915	0	0	86	0	0	86
17916	90	0	0	0	0	90
17917	0	0	0	96	0	96
17918	0	0	0	95	0	95
17919	0	0	0	94	0	94
17920	94	0	0	0	0	94
17921	92	0	0	0	0	92
17922	0	0	0	94	0	94
17923	0	0	100	0	0	100
17924	0	0	0	95	0	95
17925	0	0	0	97	0	97
17926	0	0	97	0	0	97
17927	0	99	0	0	0	99
17928	0	0	0	103	0	103
17929	102	0	0	0	0	102
17930	0	0	0	104	0	104
17931	0	0	0	103	0	103
17932	103	0	0	0	0	103
17933	0	107	0	0	0	107
17934	0	110	0	0	0	110
17935	110	0	0	0	0	110
17936	0	0	109	0	0	109
17937	110	0	0	0	0	110
17938	0	0	116	0	0	116
17939	0	118	0	0	0	118
17940	117	0	0	1	0	118
17941	120	0	0	0	0	120
17942	122	0	0	0	0	122
17943	122	0	0	0	0	122
17944	0	0	122	0	0	122
17945	0	0	0	117	0	117
17946	119	0	0	1	0	120
17947	0	0	126	0	0	126
17948	0	0	130	0	0	130
17949	0	133	0	0	0	133
17950	132	0	0	0	0	132
17951	0	0	0	133	0	133
17952	129	0	0	0	0	129
17953	0	135	0	0	0	135
17954	0	0	0	142	0	142
17955	1	0	0	139	0	140
17956	0	0	0	153	0	153
17957	0	0	154	0	0	154
17958	0	159	0	0	0	159
17959	173	0	0	0	0	173
17960	0	0	0	176	0	176
17961	175	0	0	0	0	175
17962	175	0	0	0	0	175
17963	0	0	0	172	0	172
17964	0	0	180	0	0	180
17965	0	0	0	179	0	179
17966	0	172	0	1	0	173
17967	0	0	0	176	0	176
17968	0	0	181	0	0	181
17969	181	0	0	0	0	181
17970	1	0	0	182	0	183
17971	184	0	0	1	0	185
17972	1	0	185	0	0	186
17973	177	0	0	1	0	178
17974	0	0	183	1	0	184
17975	178	0	1	0	0	179
17976	0	176	0	1	0	177
17977	0	184	0	0	0	184
17978	0	0	0	179	0	179
17979	1	0	1	176	0	178
17980	1	0	0	183	0	184
17981	182	0	0	1	0	183
17982	1	0	0	185	0	186
17983	0	0	187	0	0	187
17984	177	0	0	1	0	178
17985	0	194	1	0	0	195
17986	194	0	0	0	0	194
17987	191	1	0	0	0	192
17988	0	1	192	0	0	193
17989	0	0	0	192	0	192
17990	0	0	0	199	0	199
17991	0	0	200	2	0	202
17992	1	201	1	0	0	203
17993	198	1	0	1	0	200
17994	200	0	1	0	0	201
17995	2	0	0	204	0	206
17996	1	1	0	205	0	207
17997	2	0	0	207	0	209
17998	207	0	0	1	0	208
17999	1	213	1	0	0	215
18000	215	1	0	1	0	217
18001	212	0	0	1	0	213
18002	1	0	225	0	0	226
18003	0	1	1	217	0	219
18004	1	226	0	1	0	228
18005	1	1	0	230	0	232
18006	0	0	0	237	0	237
18007	0	0	243	2	0	245
18008	265	0	2	2	0	269
18009	289	0	0	0	0	289
18010	293	1	0	0	0	294
18011	3	0	0	285	0	288
18012	2	0	1	279	0	282
18013	1	271	1	3	0	276
18014	0	281	0	1	0	282
18015	277	2	0	2	0	281
18016	2	274	1	2	0	279
18017	2	2	271	1	0	276
18018	0	2	3	272	0	277
18019	280	0	1	2	0	283
18020	3	1	279	1	0	284
18021	3	0	273	0	0	276
18022	281	0	4	2	0	287
18023	281	0	1	2	0	284
18024	3	2	1	277	0	283
18025	1	3	279	2	0	285
18026	3	0	2	277	0	282
18027	1	1	280	3	0	285
18028	0	0	280	3	0	283
18029	1	283	4	1	0	289
18030	287	2	1	2	0	292
18031	290	1	3	0	0	294
18032	4	289	2	0	0	295
18033	2	4	0	292	0	298
18034	3	2	0	286	0	291
18035	2	0	0	290	0	292
18036	283	1	2	5	0	291
18037	2	284	0	4	0	290
18038	282	2	1	2	0	287
18039	278	1	2	1	0	282
18040	4	2	275	0	0	281
18041	3	280	2	0	0	285
18042	2	2	1	276	0	281
18043	1	2	274	3	0	280
18044	273	0	2	4	0	279
18045	276	1	1	2	0	280
18046	277	0	0	2	0	279
18047	265	1	1	0	0	267
18048	5	1	0	259	0	265
18049	4	0	256	2	0	262
18050	2	0	3	261	0	266
18051	259	0	1	3	0	263
18052	260	2	0	2	0	264
18053	3	256	1	2	0	262
18054	246	1	1	2	0	250
18055	4	1	247	0	0	252
18056	2	0	238	0	0	240
18057	243	2	3	0	0	248
18058	5	239	1	0	0	245
18059	1	3	1	215	0	220
18060	0	221	1	2	0	224
18061	1	2	0	222	0	225
18062	0	1	0	224	0	225
18063	0	0	0	226	0	226
18064	217	1	0	3	0	221
18065	221	0	0	2	0	223
18066	221	0	0	1	0	222
18067	3	0	214	1	0	218
18068	211	0	2	0	0	213
18069	3	0	1	212	0	216
18070	2	0	0	222	0	224
18071	1	0	220	2	0	223
18072	1	0	2	260	0	263
18073	270	0	1	4	0	275
18074	2	0	266	3	0	271
18075	2	0	4	268	0	274
18076	267	0	1	5	0	273
18077	270	0	0	2	0	272
18078	6	0	270	1	0	277
18079	4	1	267	3	0	275
18080	5	0	6	275	0	286
18081	280	0	4	5	0	289
18082	283	1	0	4	0	288
18083	9	1	1	272	0	283
18084	4	285	0	6	0	295
18085	283	4	3	1	0	291
18086	4	288	4	3	0	299
18087	3	3	0	293	0	299
18088	4	2	286	3	0	295
18089	3	0	280	2	0	285
18090	0	1	286	1	0	288
18091	2	2	4	284	0	292
18092	4	1	3	285	0	293
18093	282	2	0	6	0	290
18094	2	279	3	3	0	287
18095	279	2	3	2	0	286
18096	1	2	3	271	0	277
18097	3	267	3	3	0	276
18098	0	277	0	4	0	281
18099	3	3	0	281	0	287
18100	280	3	0	3	0	286
18101	3	285	1	2	0	291
18102	267	3	0	1	0	271
18103	2	269	0	5	0	276
18104	267	3	0	2	0	272
18105	2	5	264	1	0	272
18106	4	1	259	3	0	267
18107	4	255	3	0	0	262
18108	227	4	3	2	0	236
18109	3	216	1	0	0	220
18110	2	201	1	0	0	204
18111	3	2	0	216	0	221
18112	215	0	3	1	0	219
18113	2	218	2	5	0	227
18114	219	3	0	1	0	223
18115	1	221	0	0	0	222
18116	215	4	0	0	0	219
18117	1	214	0	2	0	217
18118	3	213	0	3	0	219
18119	2	3	2	211	0	218
18120	1	215	1	0	0	217
18121	213	1	1	1	0	216
18122	3	3	210	0	0	216
18123	4	1	1	210	0	216
18124	1	3	214	1	0	219
18125	0	3	1	213	0	217
18126	2	1	1	212	0	216
18127	2	2	200	2	0	206
18128	193	1	2	3	0	199
18129	1	199	3	1	0	204
18130	196	1	1	3	0	201
18131	2	196	2	3	0	203
18132	1	2	0	197	0	200
18133	192	1	2	3	0	198
18134	194	1	3	1	0	199
18135	198	1	1	0	0	200
18136	3	2	1	195	0	201
18137	3	2	1	193	0	199
18138	1	198	0	3	0	202
18139	197	1	0	3	0	201
18140	203	2	0	1	0	206
18141	200	1	1	1	0	203
18142	202	0	1	1	0	204
18143	1	196	0	4	0	201
18144	1	3	0	203	0	207
18145	4	2	196	1	0	203
18146	198	3	1	2	0	204
18147	207	0	1	0	0	208
18148	4	2	202	1	0	209
18149	4	2	201	0	0	207
18150	0	3	3	202	0	208
18151	0	1	3	205	0	209
18152	3	0	2	204	0	209
18153	202	0	1	2	0	205
18154	4	1	1	200	0	206
18155	1	1	195	1	0	198
18156	1	0	3	200	0	204
18157	0	0	191	5	0	196
18158	0	1	3	200	0	204
18159	3	1	1	210	0	215
18160	3	2	208	4	0	217
18161	204	1	3	3	0	211
18162	2	213	2	1	0	218
18163	210	3	1	4	0	218
18164	4	0	2	216	0	222
18165	217	3	0	5	0	225
18166	5	218	1	4	0	228
18167	3	236	2	2	0	243
18168	2	8	0	261	0	271
18169	1	7	273	4	0	285
18170	4	2	260	4	0	270
18171	2	263	5	4	0	274
18172	213	4	4	0	0	221
18173	4	1	2	211	0	218
18174	209	1	1	3	0	214
18175	5	210	0	2	0	217
18176	2	211	1	1	0	215
18177	2	5	0	211	0	218
18178	208	3	0	4	0	215
18179	208	2	1	1	0	212
18180	5	0	201	2	0	208
18181	3	1	201	0	0	205
18182	196	0	6	0	0	202
18183	3	195	3	0	0	201
18184	189	3	2	1	0	195
18185	6	1	0	188	0	195
18186	3	2	183	2	0	190
18187	184	1	3	1	0	189
18188	3	182	1	3	0	189
18189	1	187	2	1	0	191
18190	6	4	0	181	0	191
18191	180	3	0	4	0	187
18192	2	2	2	181	0	187
18193	182	0	2	6	0	190
18194	6	1	185	1	0	193
18195	186	1	3	1	0	191
18196	192	0	1	1	0	194
18197	5	0	184	0	0	189
18198	182	1	4	0	0	187
18199	5	178	1	0	0	184
18200	1	4	3	180	0	188
18201	3	178	1	3	0	185
18202	176	5	1	3	0	185
18203	4	2	1	174	0	181
18204	2	171	1	4	0	178
18205	4	3	0	170	0	177
18206	1	180	1	6	0	188
18207	2	6	1	179	0	188
18208	181	2	0	6	0	189
18209	3	2	3	180	0	188
18210	4	0	176	6	0	186
18211	171	1	3	2	0	177
18212	3	1	2	173	0	179
18213	2	1	164	4	0	171
18214	5	1	159	1	0	166
18215	1	1	167	4	0	173
18216	2	1	5	167	0	175
18217	0	0	3	175	0	178
18218	1	2	3	174	0	180
18219	2	1	0	177	0	180
18220	169	1	1	7	0	178
18221	170	1	0	4	0	175
18222	174	1	2	3	0	180
18223	177	1	0	1	0	179
18224	5	1	0	171	0	177
18225	5	0	171	4	0	180
18226	174	0	4	2	0	180
18227	176	1	2	2	0	181
18228	5	1	2	173	0	181
18229	3	2	1	176	0	182
18230	176	0	0	6	0	182
18231	5	1	1	175	0	182
18232	2	169	1	7	0	179
18233	175	5	1	1	0	182
18234	181	1	0	1	0	183
18235	5	3	174	3	0	185
18236	5	1	4	177	0	187
18237	2	1	3	182	0	188
18238	176	2	3	3	0	184
18239	180	0	0	6	0	186
18240	6	0	0	177	0	183
18241	4	1	176	6	0	187
18242	3	0	175	3	0	181
18243	3	0	5	179	0	187
18244	2	1	3	181	0	187
18245	180	1	2	4	0	187
18246	6	172	1	3	0	182
18247	1	172	2	4	0	179
18248	2	178	1	2	0	183
18249	2	6	0	173	0	181
18250	170	1	0	4	0	175
18251	171	3	0	3	0	177
18252	4	168	1	5	0	178
18253	177	3	1	0	0	181
18254	7	1	1	172	0	181
18255	3	3	178	3	0	187
18256	3	0	4	177	0	184
18257	4	0	2	178	0	184
18258	1	1	2	174	0	178
18259	159	1	1	5	0	166
18260	3	0	0	161	0	164
18261	2	157	0	6	0	165
18262	156	1	0	2	0	159
18263	2	155	0	2	0	159
18264	1	145	1	0	0	147
18265	1	146	1	1	0	149
18266	1	2	129	2	0	134
18267	0	126	1	1	0	128
18268	0	1	93	0	0	94
18269	84	0	1	0	0	85
18270	88	0	0	0	0	88
18271	0	0	92	0	0	92
18272	92	0	0	0	0	92
18273	95	0	0	0	0	95
18274	0	0	96	0	0	96
18275	0	98	0	1	0	99
18276	0	0	0	102	0	102
18277	105	0	0	0	0	105
18278	1	0	0	101	0	102
18279	108	0	0	0	0	108
18280	110	0	0	0	0	110
18281	0	0	110	1	0	111
18282	111	0	1	0	0	112
18283	1	114	2	0	0	117
18284	116	0	0	1	0	117
18285	0	0	0	118	0	118
18286	0	0	114	1	0	115
18287	1	0	0	115	0	116
18288	116	0	0	1	0	117
18289	0	113	0	0	0	113
18290	1	0	113	0	0	114
18291	1	0	0	115	0	116
18292	0	0	120	0	0	120
18293	0	124	0	0	0	124
18294	120	0	0	1	0	121
18295	1	0	0	121	0	122
18296	1	0	123	0	0	124
18297	0	0	117	1	0	118
18298	127	0	2	0	0	129
18299	1	0	1	129	0	131
18300	0	0	0	130	0	130
18301	0	0	129	3	0	132
18302	0	0	130	0	0	130
18303	0	131	1	0	0	132
18304	0	2	0	138	0	140
18305	0	1	0	139	0	140
18306	0	128	1	3	0	132
18307	1	2	126	0	0	129
18308	128	0	2	0	0	130
18309	2	0	0	130	0	132
18310	1	0	128	2	0	131
18311	0	0	2	127	0	129
18312	0	129	0	2	0	131
18313	0	2	135	1	0	138
18314	134	0	2	1	0	137
18315	2	0	138	1	0	141
18316	1	0	137	0	0	138
18317	0	0	136	1	0	137
18318	0	0	151	0	0	151
18319	0	0	2	157	0	159
18320	0	0	165	2	0	167
18321	0	2	2	159	0	163
18322	0	165	0	2	0	167
18323	182	2	1	0	0	185
18324	2	0	0	186	0	188
18325	1	0	185	2	0	188
18326	0	187	2	1	0	190
18327	0	2	1	190	0	193
18328	190	1	0	2	0	193
18329	2	190	0	1	0	193
18330	1	2	0	193	0	196
18331	194	1	0	2	0	197
18332	2	0	189	1	0	192
18333	192	0	2	0	0	194
18334	2	0	186	0	0	188
18335	186	0	2	0	0	188
18336	187	0	1	0	0	188
18337	3	0	183	0	0	186
18338	1	186	2	0	0	189
18339	1	2	1	180	0	184
18340	0	1	189	2	0	192
18341	0	0	2	185	0	187
18342	0	0	1	187	0	188
18343	0	0	187	3	0	190
18344	0	0	185	1	0	186
18345	0	0	3	189	0	192
18346	189	0	1	2	0	192
18347	2	183	0	1	0	186
18348	1	189	0	0	0	190
18349	188	4	0	1	0	193
18350	190	2	0	0	0	192
18351	4	0	0	190	0	194
18352	2	0	0	190	0	192
18353	0	0	0	193	0	193
18354	186	0	0	4	0	190
18355	2	177	0	2	0	181
18356	2	184	0	0	0	186
18357	0	4	0	185	0	189
18358	0	2	0	186	0	188
18359	0	0	0	187	0	187
18360	183	0	0	4	0	187
18361	2	184	0	2	0	188
18362	190	2	0	0	0	192
18363	2	2	190	0	0	194
18364	2	196	3	0	0	201
18365	0	3	2	197	0	202
18366	197	2	0	3	0	202
18367	3	0	198	2	0	203
18368	2	0	199	0	0	201
18369	0	0	5	199	0	204
18370	0	0	2	199	0	201
18371	0	0	0	198	0	198
18372	2	1	0	193	0	196
18373	1	0	0	195	0	196
18374	0	187	1	5	0	193
18375	0	4	1	186	0	191
18376	183	3	0	4	0	190
18377	3	183	0	3	0	189
18378	185	4	0	0	0	189
18379	3	3	171	1	0	178
18380	3	0	170	1	0	174
18381	1	0	5	180	0	186
18382	1	0	217	5	0	223
18383	1	0	8	218	0	227
18384	1	0	3	219	0	223
18385	222	0	0	9	0	231
18386	228	0	1	2	0	231
18387	9	222	1	0	0	232
18388	3	235	0	1	0	239
18389	0	8	2	230	0	240
18390	230	3	1	9	0	243
18391	6	0	229	5	0	240
18392	3	0	8	229	0	240
18393	0	0	5	228	0	233
18394	0	0	223	9	0	232
18395	1	219	6	3	0	229
18396	1	8	2	217	0	228
18397	0	3	217	7	0	227
18398	1	1	6	217	0	225
18399	212	0	2	7	0	221
18400	6	211	0	3	0	220
18401	1	217	0	4	0	222
18402	2	7	1	214	0	224
18403	209	2	0	7	0	218
18404	6	203	0	2	0	211
18405	210	7	2	1	0	220
18406	6	2	209	2	0	219
18407	3	1	211	4	0	219
18408	1	0	9	207	0	217
18409	2	0	3	221	0	226
18410	213	2	1	10	0	226
18411	7	2	2	216	0	227
18412	5	0	211	8	0	224
18413	2	2	6	212	0	222
18414	2	1	4	211	0	218
18415	2	1	199	11	0	213
18416	200	2	6	6	0	214
18417	7	1	8	201	0	217
18418	191	1	1	9	0	202
18419	7	171	1	6	0	185
18420	173	6	3	2	0	184
18421	5	174	0	3	0	182
18422	4	175	1	4	0	184
18423	0	10	2	153	0	165
18424	148	5	0	6	0	159
18425	148	0	1	3	0	152
18426	7	1	1	143	0	152
18427	142	2	1	6	0	151
18428	145	0	0	4	0	149
18429	8	2	1	143	0	154
18430	138	1	1	7	0	147
18431	7	137	0	5	0	149
18432	139	6	2	1	0	148
18433	7	4	135	1	0	147
18434	145	0	6	2	0	153
18435	5	0	6	147	0	158
18436	4	0	1	153	0	158
18437	0	0	0	156	0	156
18438	2	1	2	151	0	156
18439	2	0	0	155	0	157
18440	0	137	1	10	0	148
18441	1	146	2	3	0	152
18442	142	7	0	2	0	151
18443	6	1	140	3	0	150
18444	145	1	6	0	0	152
18445	7	1	141	1	0	150
18446	4	0	5	141	0	150
18447	3	1	1	145	0	150
18448	144	2	0	5	0	151
18449	6	1	143	4	0	154
18450	4	2	5	142	0	153
18451	2	2	155	6	0	165
18452	2	164	4	4	0	174
18453	4	5	2	166	0	177
18454	167	2	0	8	0	177
18455	174	0	0	4	0	178
18456	170	0	0	1	0	171
18457	9	169	0	2	0	180
18458	2	174	0	3	0	179
18459	163	8	1	2	0	174
18460	8	171	0	1	0	180
18461	2	172	1	1	0	176
18462	2	6	167	1	0	176
18463	1	161	6	1	0	169
18464	1	163	1	2	0	167
18465	1	6	0	162	0	169
18466	0	1	160	7	0	168
18467	1	0	160	2	0	163
18468	155	1	7	1	0	164
18469	5	2	155	1	0	163
18470	160	1	5	2	0	168
18471	7	0	3	163	0	173
18472	3	163	2	4	0	172
18473	169	4	1	4	0	178
18474	183	1	2	1	0	187
18475	7	1	0	179	0	187
18476	2	0	0	186	0	188
18477	2	1	1	187	0	191
18478	180	1	1	7	0	189
18479	182	0	1	2	0	185
18480	185	2	0	0	0	187
18481	4	168	0	1	0	173
18482	134	1	0	0	0	135
18483	1	132	0	0	0	133
18484	1	135	0	0	0	136
18485	1	2	0	128	0	131
18486	0	128	0	1	0	129
18487	122	1	0	2	0	125
18488	1	1	1	121	0	124
18489	121	0	0	1	0	122
18490	0	117	0	1	0	118
18491	1	126	0	0	0	127
18492	130	0	0	1	0	131
18493	1	133	0	0	0	134
18494	2	1	1	132	0	136
18495	0	1	0	134	0	135
18496	136	0	0	2	0	138
18497	2	0	0	140	0	142
18498	1	0	149	1	0	151
18499	1	0	2	149	0	152
18500	150	1	1	2	0	154
18501	2	147	0	2	0	151
18502	156	2	0	1	0	159
18503	159	1	0	0	0	160
18504	161	0	0	1	0	162
18505	2	0	168	0	0	170
18506	0	0	155	1	0	156
18507	158	0	2	1	0	161
18508	3	164	0	0	0	167
18509	1	2	0	162	0	165
18510	2	0	0	160	0	162
18511	2	158	0	2	0	162
18512	1	162	1	0	0	164
18513	0	2	2	168	0	172
18514	1	0	1	166	0	168
18515	1	1	168	2	0	172
18516	0	2	156	1	0	159
18517	159	0	2	2	0	163
18518	169	1	0	1	0	171
18519	2	2	0	166	0	170
18520	1	1	166	3	0	171
18521	0	0	2	167	0	169
18522	166	0	1	3	0	170
18523	2	0	166	0	0	168
18524	1	0	4	170	0	175
18525	3	0	173	2	0	178
18526	1	176	2	1	0	180
18527	0	2	173	2	0	177
18528	0	1	3	173	0	177
18529	173	0	0	3	0	176
18530	3	2	1	171	0	177
18531	172	0	1	5	0	178
18532	173	0	1	3	0	177
18533	172	1	2	0	0	175
18534	2	1	170	1	0	174
18535	169	0	3	1	0	173
18536	4	0	0	170	0	174
18537	2	0	0	170	0	172
18538	1	1	169	3	0	174
18539	3	0	2	170	0	175
18540	174	0	0	2	0	176
18541	3	171	2	0	0	176
18542	174	2	2	0	0	178
18543	178	0	2	1	0	181
18544	176	0	0	2	0	178
18545	2	1	2	177	0	182
18546	0	0	179	4	0	183
18547	2	0	2	189	0	193
18548	1	2	0	190	0	193
18549	187	2	0	2	0	191
18550	186	0	0	0	0	186
18551	5	0	168	1	0	174
18552	1	0	2	169	0	172
18553	1	0	174	2	0	177
18554	181	0	2	2	0	185
18555	2	190	0	3	0	195
18556	195	1	1	2	0	199
18557	3	197	1	1	0	202
18558	200	1	1	1	0	203
18559	2	201	1	3	0	207
18560	1	1	1	200	0	203
18561	2	0	1	201	0	204
18562	202	1	1	1	0	205
18563	199	2	0	1	0	202
18564	201	1	1	0	0	203
18565	193	1	0	2	0	196
18566	200	1	0	1	0	202
18567	2	1	0	196	0	199
18568	2	192	0	3	0	197
18569	2	1	1	194	0	198
18570	3	192	0	1	0	196
18571	2	1	1	189	0	193
18572	4	188	0	1	0	193
18573	2	2	0	187	0	191
18574	2	0	180	2	0	184
18575	177	2	2	1	0	182
18576	2	180	0	2	0	184
18577	179	2	0	1	0	182
18578	1	2	176	2	0	181
18579	177	1	1	2	0	181
18580	3	1	185	1	0	190
18581	2	0	2	189	0	193
18582	2	198	1	2	0	203
18583	4	2	197	0	0	203
18584	2	1	1	199	0	203
18585	192	0	1	3	0	196
18586	2	2	1	197	0	202
18587	2	0	2	201	0	205
18588	0	1	2	201	0	204
18589	1	1	198	4	0	204
18590	0	2	3	196	0	201
18591	2	190	1	3	0	196
18592	1	1	2	184	0	188
18593	1	0	1	187	0	189
18594	186	2	0	3	0	191
18595	2	1	1	191	0	195
18596	0	0	195	4	0	199
18597	1	0	189	1	0	191
18598	1	0	183	1	0	185
18599	0	183	0	3	0	186
18600	181	1	1	1	0	184
18601	0	182	2	0	0	184
18602	175	0	0	1	0	176
18603	0	2	0	173	0	175
18604	1	0	176	1	0	178
18605	0	1	164	1	0	166
18606	2	172	0	0	0	174
18607	0	1	1	174	0	176
18608	0	0	2	175	0	177
18609	0	1	1	175	0	177
18610	1	1	174	0	0	176
18611	169	2	1	1	0	173
18612	1	0	173	2	0	176
18613	0	2	0	167	0	169
18614	2	0	0	168	0	170
18615	2	0	164	2	0	168
18616	160	0	2	1	0	163
18617	1	166	1	1	0	169
18618	174	1	0	1	0	176
18619	0	0	1	172	0	173
18620	1	170	0	2	0	173
18621	0	0	0	177	0	177
18622	175	1	2	0	0	178
18623	2	0	0	174	0	176
18624	0	4	166	0	0	170
18625	166	0	1	3	0	170
18626	165	0	1	3	0	169
18627	2	1	166	1	0	170
18628	1	1	1	169	0	172
18629	173	0	0	0	0	173
18630	2	0	0	170	0	172
18631	1	0	3	167	0	171
18632	1	1	1	168	0	171
18633	2	1	0	167	0	170
18634	1	0	164	2	0	167
18635	0	0	1	167	0	168
18636	2	0	165	2	0	169
18637	165	0	0	3	0	168
18638	166	0	1	2	0	169
18639	161	0	2	3	0	166
18640	162	0	2	3	0	167
18641	2	1	2	159	0	164
18642	158	0	1	3	0	162
18643	1	2	157	1	0	161
18644	2	0	155	2	0	159
18645	156	0	0	4	0	160
18646	3	150	2	0	0	155
18647	1	144	1	3	0	149
18648	0	1	1	143	0	145
18649	4	0	141	1	0	146
18650	138	0	3	0	0	141
18651	1	2	144	1	0	148
18652	3	140	1	1	0	145
18653	0	2	134	1	0	137
18654	3	129	1	0	0	133
18655	113	2	2	2	0	119
18656	0	109	1	1	0	111
18657	2	102	1	0	0	105
18658	1	2	1	102	0	106
18659	1	3	98	0	0	102
18660	0	1	1	98	0	100
18661	0	1	1	101	0	103
18662	2	1	98	1	0	102
18663	0	1	2	98	0	101
18664	1	100	0	1	0	102
18665	0	0	0	100	0	100
18666	97	1	2	0	0	100
18667	2	0	0	100	0	102
18668	1	1	100	1	0	103
18669	0	1	2	100	0	103
18670	1	0	94	2	0	97
18671	97	1	1	1	0	100
18672	0	0	1	98	0	99
18673	98	0	0	3	0	101
18674	0	1	96	2	0	99
18675	96	0	1	2	0	99
18676	0	98	1	2	0	101
18677	1	0	98	1	0	100
18678	3	0	2	97	0	102
18679	2	1	98	1	0	102
18680	3	94	0	0	0	97
18681	1	96	2	1	0	100
18682	83	1	0	0	0	84
18683	0	87	0	1	0	88
18684	88	0	0	0	0	88
18685	0	0	0	89	0	89
18686	0	0	90	0	0	90
18687	1	92	0	1	0	94
18688	1	1	0	94	0	96
18689	1	0	1	97	0	99
18690	0	1	0	99	0	100
18691	2	0	0	97	0	99
18692	0	93	1	2	0	96
18693	0	97	1	1	0	99
18694	95	1	0	1	0	97
18695	0	90	0	2	0	92
18696	0	0	1	89	0	90
18697	0	0	86	2	0	88
18698	0	87	1	1	0	89
18699	1	2	0	85	0	88
18700	1	1	0	85	0	87
18701	1	86	0	1	0	88
18702	84	2	0	0	0	86
18703	1	0	83	2	0	86
18704	78	0	1	0	0	79
18705	1	78	1	0	0	80
18706	71	1	1	0	0	73
18707	2	71	0	0	0	73
18708	0	2	0	74	0	76
18709	0	1	0	74	0	75
18710	70	0	0	2	0	72
18711	1	0	1	71	0	73
18712	1	0	77	1	0	79
18713	0	76	2	0	0	78
18714	0	78	0	0	0	78
18715	0	1	0	76	0	77
18716	0	0	77	1	0	78
18717	0	0	1	75	0	76
18718	0	0	0	73	0	73
18719	0	0	71	1	0	72
18720	0	0	73	0	0	73
18721	0	75	1	0	0	76
18722	75	1	0	0	0	76
18723	1	0	0	75	0	76
18724	0	73	0	1	0	74
18725	74	1	0	0	0	75
18726	1	0	0	73	0	74
18727	0	0	0	70	0	70
18728	0	70	0	1	0	71
18729	0	1	0	68	0	69
18730	67	0	0	1	0	68
18731	1	0	0	68	0	69
18732	0	0	0	70	0	70
18733	0	0	69	1	0	70
18734	0	0	65	0	0	65
18735	67	0	1	0	0	68
18736	1	0	0	65	0	66
18737	0	0	0	67	0	67
18738	0	0	0	66	0	66
18739	0	0	64	1	0	65
18740	66	0	1	0	0	67
18741	1	0	0	66	0	67
18742	0	0	0	66	0	66
18743	66	0	0	1	0	67
18744	1	66	0	0	0	67
18745	0	1	65	0	0	66
18746	0	0	1	65	0	66
18747	0	64	0	2	0	66
18748	0	1	0	66	0	67
18749	66	0	0	1	0	67
18750	1	0	0	65	0	66
18751	63	0	0	1	0	64
18752	60	0	0	0	0	60
18753	1	0	0	59	0	60
18754	0	55	0	1	0	56
18755	0	59	0	0	0	59
18756	0	1	58	0	0	59
18757	1	0	1	54	0	56
18758	0	0	0	58	0	58
18759	0	0	0	59	0	59
18760	58	0	0	1	0	59
18761	1	0	0	57	0	58
18762	0	0	57	1	0	58
18763	56	0	1	0	0	57
18764	1	0	0	58	0	59
18765	0	0	0	58	0	58
18766	0	0	58	1	0	59
18767	57	0	1	0	0	58
18768	1	0	0	54	0	55
18769	0	0	57	1	0	58
18770	0	0	1	55	0	56
18771	0	0	0	57	0	57
18772	0	57	0	1	0	58
18773	56	1	0	0	0	57
18774	56	0	0	0	0	56
18775	1	56	0	0	0	57
18776	54	1	0	0	0	55
18777	57	0	0	0	0	57
18778	1	0	0	55	0	56
18779	0	0	52	1	0	53
18780	0	0	48	0	0	48
18781	0	0	44	0	0	44
18782	0	0	48	0	0	48
18783	0	2	1	41	0	44
18784	0	0	0	47	0	47
18785	0	0	0	44	0	44
18786	0	0	0	43	0	43
18787	40	0	0	1	0	41
18788	1	41	0	0	0	42
18789	42	1	0	0	0	43
18790	1	0	45	0	0	46
18791	0	0	47	0	0	47
18792	0	0	1	49	0	50
18793	51	0	0	1	0	52
18794	50	0	0	0	0	50
18795	1	50	0	0	0	51
18796	0	51	0	0	0	51
18797	0	1	0	50	0	51
18798	53	0	0	1	0	54
18799	1	53	0	0	0	54
18800	54	1	0	0	0	55
18801	58	0	0	0	0	58
18802	57	0	0	0	0	57
18803	1	0	55	0	0	56
18804	0	56	1	0	0	57
18805	56	1	0	0	0	57
18806	56	0	0	0	0	56
18807	1	54	0	0	0	55
18808	0	54	0	0	0	54
18809	53	1	0	0	0	54
18810	1	0	0	54	0	55
18811	0	0	54	1	0	55
18812	50	0	1	0	0	51
18813	1	0	0	51	0	52
18814	0	51	0	2	0	53
18815	0	1	0	52	0	53
18816	0	0	53	1	0	54
18817	0	0	1	51	0	52
18818	54	0	0	1	0	55
18819	1	0	0	54	0	55
18820	0	0	0	53	0	53
18821	0	0	56	1	0	57
18822	0	0	1	54	0	55
18823	0	55	0	1	0	56
18824	56	1	0	0	0	57
18825	57	0	0	0	0	57
18826	1	0	58	0	0	59
18827	0	0	1	57	0	58
18828	0	57	0	2	0	59
18829	0	60	0	0	0	60
18830	59	1	0	0	0	60
18831	1	0	0	58	0	59
18832	0	0	57	1	0	58
18833	0	0	61	0	0	61
18834	0	0	1	60	0	61
18835	62	0	0	1	0	63
18836	63	0	0	0	0	63
18837	1	0	0	69	0	70
18838	0	0	69	1	0	70
18839	0	72	1	0	0	73
18840	71	1	0	0	0	72
18841	1	72	0	0	0	73
18842	73	1	0	0	0	74
18843	1	0	0	73	0	74
18844	0	0	71	1	0	72
18845	0	0	1	70	0	71
18846	73	0	0	1	0	74
18847	1	0	72	0	0	73
18848	0	70	1	0	0	71
18849	0	1	0	73	0	74
18850	72	0	0	1	0	73
18851	1	0	73	0	0	74
18852	0	0	1	74	0	75
18853	0	0	0	77	0	77
18854	0	0	76	1	0	77
18855	0	0	1	75	0	76
18856	0	0	76	1	0	77
18857	73	0	1	0	0	74
18858	1	0	0	77	0	78
18859	0	0	85	1	0	86
18860	0	87	2	0	0	89
18861	88	3	0	0	0	91
18862	106	0	0	0	0	106
18863	3	0	0	122	0	125
18864	0	128	0	4	0	132
18865	131	4	0	0	0	135
18866	4	0	0	128	0	132
18867	0	0	132	4	0	136
18868	127	0	4	1	0	132
18869	4	131	0	0	0	135
18870	0	4	0	133	0	137
18871	132	0	0	4	0	136
18872	4	0	130	0	0	134
18873	0	0	134	0	0	134
18874	0	0	4	129	0	133
18875	0	0	130	4	0	134
18876	0	0	4	129	0	133
18877	0	127	0	4	0	131
18878	0	4	0	137	0	141
18879	135	0	0	4	0	139
18880	4	0	138	0	0	142
18881	0	141	4	0	0	145
18882	1	3	0	141	0	145
18883	2	1	146	4	0	153
18884	1	1	4	140	0	146
18885	0	144	1	5	0	150
18886	0	151	2	0	0	153
18887	147	4	0	0	0	151
18888	4	149	0	0	0	153
18889	0	4	140	0	0	144
18890	140	0	4	0	0	144
18891	4	0	139	0	0	143
18892	0	0	5	132	0	137
18893	0	1	137	5	0	143
18894	0	140	4	1	0	145
18895	0	4	0	143	0	147
18896	1	1	0	143	0	145
18897	0	0	0	145	0	145
18898	1	0	143	3	0	147
18899	2	0	3	141	0	146
18900	0	1	0	146	0	147
18901	141	0	0	5	0	146
18902	146	0	1	0	0	147
18903	3	0	144	1	0	148
18904	0	139	4	0	0	143
18905	0	3	141	1	0	145
18906	0	0	4	142	0	146
18907	0	1	144	4	0	149
18908	0	1	4	142	0	147
18909	1	0	0	148	0	149
18910	1	0	144	3	0	148
18911	137	0	4	1	0	142
18912	3	154	1	1	0	159
18913	0	5	0	155	0	160
18914	1	0	160	4	0	165
18915	0	0	164	3	0	167
18916	158	1	3	2	0	164
18917	3	161	0	0	0	164
18918	0	4	0	161	0	165
18919	161	0	0	6	0	167
18920	6	0	1	160	0	167
18921	2	0	1	163	0	166
18922	0	1	164	3	0	168
18923	162	1	3	1	0	167
18924	163	0	3	2	0	168
18925	3	1	0	164	0	168
18926	161	1	1	5	0	168
18927	3	1	0	166	0	170
18928	1	156	0	5	0	162
18929	1	164	3	0	0	168
18930	1	4	1	167	0	173
18931	166	1	1	5	0	173
18932	4	0	1	168	0	173
18933	170	0	1	4	0	175
18934	169	0	2	1	0	172
18935	4	3	0	171	0	178
18936	1	1	1	170	0	173
18937	1	1	167	5	0	174
18938	1	0	176	0	0	177
18939	2	1	3	171	0	177
18940	0	0	185	6	0	191
18941	183	0	5	2	0	190
18942	5	0	1	204	0	210
18943	1	4	211	3	0	219
18944	209	1	3	3	0	216
18945	224	0	1	0	0	225
18946	3	232	3	1	0	239
18947	2	4	1	245	0	252
18948	1	2	252	5	0	260
18949	252	0	4	2	0	258
18950	258	0	0	1	0	259
18951	4	0	258	1	0	263
18952	262	2	4	1	0	269
18953	4	1	1	265	0	271
18954	1	0	2	267	0	270
18955	265	0	0	6	0	271
18956	260	0	3	0	0	263
18957	4	0	2	263	0	269
18958	1	0	266	7	0	274
18959	1	253	5	1	0	260
18960	3	2	262	1	0	268
18961	1	1	263	1	0	266
18962	2	251	2	1	0	256
18963	1	1	5	224	0	231
18964	0	0	1	226	0	227
18965	0	1	227	1	0	229
18966	0	0	3	219	0	222
18967	223	0	0	1	0	224
18968	1	1	229	1	0	232
18969	232	0	2	1	0	235
18970	233	1	0	1	0	235
18971	237	0	1	1	0	239
18972	2	1	234	1	0	238
18973	2	0	235	1	0	238
18974	0	0	3	238	0	241
18975	2	0	0	235	0	237
18976	2	238	2	1	0	243
18977	243	1	1	1	0	246
18978	238	0	1	0	0	239
18979	1	236	2	1	0	240
18980	233	1	0	3	0	237
18981	2	226	1	2	0	231
18982	230	2	0	1	0	233
18983	4	0	0	223	0	227
18984	2	0	227	1	0	230
18985	0	3	217	2	0	222
18986	2	0	2	226	0	230
18987	0	2	2	228	0	232
18988	2	1	223	1	0	227
18989	1	0	2	219	0	222
18990	2	1	1	215	0	219
18991	218	0	3	2	0	223
18992	222	0	1	2	0	225
18993	220	0	1	2	0	223
18994	1	0	217	1	0	219
18995	2	221	1	1	0	225
18996	2	1	1	224	0	228
18997	3	0	229	1	0	233
18998	2	228	1	0	0	231
18999	226	1	1	0	0	228
19000	1	1	2	230	0	234
19001	0	0	1	229	0	230
19002	227	1	0	4	0	232
19003	2	0	2	230	0	234
19004	1	2	1	232	0	236
19005	236	1	0	2	0	239
19006	2	0	228	2	0	232
19007	0	231	2	1	0	234
19008	235	1	0	1	0	237
19009	1	1	234	3	0	239
19010	235	0	1	1	0	237
19011	3	242	1	1	0	247
19012	236	1	2	1	0	240
19013	234	1	2	0	0	237
19014	227	1	0	1	0	229
19015	1	0	1	229	0	231
19016	0	0	2	224	0	226
19017	1	226	0	2	0	229
19018	3	227	0	1	0	231
19019	3	234	0	1	0	238
19020	238	1	1	1	0	241
19021	2	1	234	1	0	238
19022	0	0	2	238	0	240
19023	0	1	1	238	0	240
19024	1	236	0	2	0	239
19025	1	2	1	237	0	241
19026	1	2	0	231	0	234
19027	1	234	1	1	0	237
19028	236	1	0	2	0	239
19029	1	242	0	3	0	246
19030	1	2	235	1	0	239
19031	232	0	1	3	0	236
19032	1	235	1	3	0	240
19033	233	2	0	0	0	235
19034	4	0	1	232	0	237
19035	1	2	1	230	0	234
19036	2	0	229	1	0	232
19037	1	1	230	0	0	232
19038	2	1	1	222	0	226
19039	228	1	0	1	0	230
19040	210	0	0	0	0	210
19041	2	217	0	0	0	219
19042	1	209	0	0	0	210
19043	0	201	0	1	0	202
19044	0	6	4	193	0	203
19045	192	0	1	2	0	195
19046	188	0	0	0	0	188
19047	179	0	0	0	0	179
19048	2	0	172	0	0	174
19049	0	226	2	0	0	228
19050	0	2	0	258	0	260
19051	265	0	0	2	0	267
19052	3	0	0	269	0	272
19053	1	0	0	284	0	285
19054	279	0	0	5	0	284
19055	295	0	0	1	0	296
19056	5	0	291	0	0	296
19057	2	0	5	297	0	304
19058	0	0	295	5	0	300
19059	0	0	5	295	0	300
19060	0	0	292	5	0	297
19061	1	0	4	293	0	298
19062	287	0	2	6	0	295
19063	5	286	0	4	0	295
19064	2	301	0	0	0	303
19065	0	5	0	269	0	274
19066	0	293	0	4	0	297
19067	294	4	0	2	0	300
19068	287	2	0	0	0	289
19069	6	4	278	0	0	288
19070	2	287	4	0	0	293
19071	0	4	2	282	0	288
19072	2	2	278	3	0	285
19073	274	0	3	6	0	283
19074	4	0	2	279	0	285
19075	4	0	277	4	0	285
19076	2	0	4	279	0	285
19077	279	0	3	4	0	286
19078	4	0	273	5	0	282
19079	276	0	5	2	0	283
19080	281	0	2	3	0	286
19081	8	0	2	275	0	285
19082	2	0	279	6	0	287
19083	2	0	270	2	0	274
19084	265	1	6	0	0	272
19085	271	2	2	2	0	277
19086	6	1	270	1	0	278
19087	2	2	3	273	0	280
19088	3	0	2	276	0	281
19089	1	275	0	6	0	282
19090	0	5	2	278	0	285
19091	278	4	0	5	0	287
19092	4	1	0	281	0	286
19093	2	0	280	5	0	287
19094	276	0	4	3	0	283
19095	6	0	3	269	0	278
19096	3	1	266	4	0	274
19097	0	264	5	4	0	273
19098	263	4	3	3	0	273
19099	5	264	2	0	0	271
19100	263	4	0	3	0	270
19101	6	2	257	0	0	265
19102	2	253	4	4	0	263
19103	1	262	2	0	0	265
19104	0	5	3	255	0	263
19105	2	2	0	256	0	260
19106	3	0	253	8	0	264
19107	0	1	6	257	0	264
19108	255	0	3	6	0	264
19109	6	0	251	3	0	260
19110	3	1	6	245	0	255
19111	1	0	245	6	0	252
19112	242	0	5	4	0	251
19113	4	244	2	4	0	254
19114	251	4	3	0	0	258
19115	254	3	0	2	0	259
19116	256	0	0	4	0	260
19117	7	1	244	1	0	253
19118	3	247	4	1	0	255
19119	2	4	4	237	0	247
19120	2	4	0	248	0	254
19121	259	0	0	7	0	266
19122	6	0	3	257	0	266
19123	255	3	1	4	0	263
19124	254	3	2	2	0	261
19125	257	1	0	3	0	261
19126	261	0	1	1	0	263
19127	7	0	3	249	0	259
19128	249	0	0	8	0	257
19129	6	1	241	2	0	250
19130	244	1	6	2	0	253
19131	247	0	2	5	0	254
19132	7	0	240	1	0	248
19133	238	0	3	2	0	243
19134	250	2	2	0	0	254
19135	9	0	1	244	0	254
19136	3	0	0	250	0	253
19137	242	1	3	7	0	253
19138	5	1	2	243	0	251
19139	3	3	0	233	0	239
19140	1	229	1	7	0	238
19141	2	2	0	232	0	236
19142	221	2	0	4	0	227
19143	3	2	1	222	0	228
19144	4	2	0	218	0	224
19145	3	214	0	6	0	223
19146	3	3	0	214	0	220
19147	5	2	2	213	0	222
19148	205	0	0	10	0	215
19149	6	0	0	149	0	155
19150	1	1	114	2	0	118
19151	1	102	3	2	0	108
19152	0	95	1	1	0	97
19153	85	1	0	0	0	86
19154	2	91	0	0	0	93
19155	78	1	0	1	0	80
19156	1	78	0	0	0	79
19157	74	0	0	1	0	75
19158	1	0	0	73	0	74
19159	0	0	1	74	0	75
19160	1	69	0	1	0	71
19161	1	0	0	74	0	75
19162	0	0	75	0	0	75
19163	74	0	0	0	0	74
19164	1	72	0	1	0	74
19165	76	0	0	2	0	78
19166	76	0	0	2	0	78
19167	76	0	0	2	0	78
19168	1	0	0	78	0	79
19169	1	0	0	78	0	79
19170	1	77	0	0	0	78
19171	77	0	0	1	0	78
19172	1	74	0	1	0	76
19173	76	0	0	1	0	77
19174	0	0	79	1	0	80
19175	82	0	0	0	0	82
19176	1	0	0	83	0	84
19177	0	0	79	1	0	80
19178	3	0	80	0	0	83
19179	1	0	0	83	0	84
19180	0	0	82	1	0	83
19181	0	0	0	82	0	82
19182	78	1	0	1	0	80
19183	1	0	1	80	0	82
19184	0	1	77	2	0	80
19185	2	77	0	0	0	79
19186	0	76	0	2	0	78
19187	1	0	1	71	0	73
19188	70	1	1	2	0	74
19189	0	1	0	74	0	75
19190	0	1	0	72	0	73
19191	1	0	0	75	0	76
19192	0	0	0	72	0	72
19193	2	0	70	1	0	73
19194	0	1	69	2	0	72
19195	73	0	1	1	0	75
19196	71	1	1	0	0	73
19197	1	1	1	70	0	73
19198	1	0	0	68	0	69
19199	1	1	72	1	0	75
19200	1	71	0	1	0	73
19201	73	1	0	1	0	75
19202	73	1	0	0	0	74
19203	1	1	0	72	0	74
19204	1	0	73	0	0	74
19205	2	1	0	70	0	73
19206	0	70	0	3	0	73
19207	0	0	73	0	0	73
19208	72	0	1	1	0	74
19209	0	2	0	74	0	76
19210	74	0	2	0	0	76
19211	2	0	71	1	0	74
19212	73	0	0	1	0	74
19213	1	0	0	74	0	75
19214	70	0	2	0	0	72
19215	1	1	0	68	0	70
19216	1	63	0	1	0	65
19217	1	69	0	1	0	71
19218	2	0	0	69	0	71
19219	0	3	62	1	0	66
19220	0	61	0	1	0	62
19221	0	1	0	53	0	54
19222	50	0	1	0	0	51
19223	51	1	0	0	0	52
19224	0	0	0	50	0	50
19225	0	0	0	50	0	50
19226	1	50	0	0	0	51
19227	0	50	0	1	0	51
19228	52	0	0	1	0	53
19229	0	0	0	51	0	51
19230	0	1	0	50	0	51
19231	1	0	54	0	0	55
19232	0	0	0	54	0	54
19233	0	0	0	51	0	51
19234	0	0	1	52	0	53
19235	0	0	55	1	0	56
19236	0	0	0	57	0	57
19237	56	0	0	1	0	57
19238	0	0	56	0	0	56
19239	56	0	0	1	0	57
19240	1	0	0	56	0	57
19241	0	0	1	56	0	57
19242	0	0	0	57	0	57
19243	0	0	54	1	0	55
19244	52	0	0	2	0	54
19245	0	54	0	1	0	55
19246	53	0	1	0	0	54
19247	1	52	0	0	0	53
19248	0	1	0	53	0	54
19249	54	0	0	0	0	54
19250	0	1	52	0	0	53
19251	53	0	0	1	0	54
19252	1	0	53	0	0	54
19253	0	0	1	52	0	53
19254	1	0	50	0	0	51
19255	0	51	1	0	0	52
19256	0	0	0	48	0	48
19257	44	0	1	0	0	45
19258	0	0	0	44	0	44
19259	0	44	0	1	0	45
19260	1	0	0	44	0	45
19261	44	0	0	1	0	45
19262	43	1	0	0	0	44
19263	0	43	0	1	0	44
19264	1	43	0	0	0	44
19265	1	0	0	43	0	44
19266	0	1	0	43	0	44
19267	43	0	0	0	0	43
19268	40	0	0	1	0	41
19269	0	41	0	1	0	42
19270	1	0	0	42	0	43
19271	1	0	0	42	0	43
19272	0	1	42	0	0	43
19273	0	42	0	1	0	43
19274	0	38	0	1	0	39
19275	0	0	0	37	0	37
19276	0	0	37	0	0	37
19277	0	0	38	0	0	38
19278	0	0	0	37	0	37
19279	0	0	0	35	0	35
19280	0	0	35	0	0	35
19281	0	0	0	35	0	35
19282	0	0	35	0	0	35
19283	38	0	0	0	0	38
19284	0	0	0	40	0	40
19285	0	0	40	0	0	40
19286	0	0	41	0	0	41
19287	0	0	0	43	0	43
19288	2	0	45	0	0	47
19289	0	0	49	0	0	49
19290	0	48	0	0	0	48
19291	49	0	0	0	0	49
19292	0	0	49	0	0	49
19293	0	0	0	49	0	49
19294	0	0	0	49	0	49
19295	0	0	0	49	0	49
19296	0	0	49	0	0	49
19297	0	0	0	48	0	48
19298	47	0	0	0	0	47
19299	0	0	0	46	0	46
19300	0	0	47	0	0	47
19301	0	0	0	47	0	47
19302	47	0	0	0	0	47
19303	46	0	0	0	0	46
19304	47	0	0	0	0	47
19305	0	0	0	48	0	48
19306	48	0	0	1	0	49
19307	49	0	0	0	0	49
19308	49	0	0	0	0	49
19309	0	49	0	0	0	49
19310	49	0	0	0	0	49
19311	0	0	0	49	0	49
19312	0	0	48	0	0	48
19313	0	47	0	0	0	47
19314	47	0	0	0	0	47
19315	1	0	0	47	0	48
19316	0	0	0	47	0	47
19317	0	49	0	0	0	49
19318	0	48	0	0	0	48
19319	47	0	0	0	0	47
19320	0	47	0	0	0	47
19321	43	0	0	1	0	44
19322	0	42	0	0	0	42
19323	44	0	0	0	0	44
19324	0	47	0	0	0	47
19325	0	49	0	0	0	49
19326	49	0	0	0	0	49
19327	0	0	48	0	0	48
19328	0	48	0	0	0	48
19329	0	0	1	47	0	48
19330	0	0	0	46	0	46
19331	0	0	0	43	0	43
19332	0	0	0	44	0	44
19333	0	0	43	0	0	43
19334	44	0	0	0	0	44
19335	0	0	0	41	0	41
19336	41	0	0	0	0	41
19337	42	0	0	0	0	42
19338	44	0	0	0	0	44
19339	44	0	0	0	0	44
19340	0	1	44	0	0	45
19341	0	0	0	44	0	44
19342	0	0	45	0	0	45
19343	0	47	0	0	0	47
19344	0	0	0	49	0	49
19345	0	0	0	49	0	49
19346	0	0	0	50	0	50
19347	0	0	0	48	0	48
19348	0	0	48	0	0	48
19349	0	0	0	47	0	47
19350	0	0	0	48	0	48
19351	48	0	0	0	0	48
19352	52	0	0	0	0	52
19353	0	0	0	55	0	55
19354	0	0	0	54	0	54
19355	0	0	0	53	0	53
19356	54	0	0	0	0	54
19357	54	0	0	0	0	54
19358	53	0	0	0	0	53
19359	54	0	0	0	0	54
19360	0	54	0	0	0	54
19361	54	0	0	0	0	54
19362	55	0	0	0	0	55
19363	0	0	0	55	0	55
19364	0	0	0	54	0	54
19365	55	0	0	0	0	55
19366	0	55	0	0	0	55
19367	0	56	0	0	0	56
19368	58	0	0	0	0	58
19369	1	0	0	56	0	57
19370	0	0	0	56	0	56
19371	0	0	0	57	0	57
19372	0	0	0	55	0	55
19373	0	0	0	54	0	54
19374	0	54	0	0	0	54
19375	0	0	0	51	0	51
19376	51	0	0	0	0	51
19377	0	0	0	49	0	49
19378	0	0	0	51	0	51
19379	50	0	0	0	0	50
19380	0	50	0	0	0	50
19381	0	0	0	49	0	49
19382	0	49	0	0	0	49
19383	0	0	0	49	0	49
19384	0	0	48	0	0	48
19385	47	0	0	0	0	47
19386	0	47	0	0	0	47
19387	43	0	0	0	0	43
19388	0	1	40	0	0	41
19389	0	0	0	38	0	38
19390	0	37	0	0	0	37
19391	0	38	0	0	0	38
19392	39	0	0	0	0	39
19393	1	0	0	39	0	40
19394	0	0	42	0	0	42
19395	0	0	0	43	0	43
19396	0	0	41	0	0	41
19397	39	1	0	0	0	40
19398	0	0	42	1	0	43
19399	0	0	0	39	0	39
19400	0	45	0	1	0	46
19401	0	0	0	45	0	45
19402	0	45	1	0	0	46
19403	44	0	0	1	0	45
19404	0	0	0	49	0	49
19405	1	0	49	0	0	50
19406	1	0	48	0	0	49
19407	48	0	0	1	0	49
19408	49	0	0	1	0	50
19409	47	0	0	2	0	49
19410	48	0	0	0	0	48
19411	1	49	0	0	0	50
19412	51	0	0	0	0	51
19413	51	0	0	0	0	51
19414	0	1	49	0	0	50
19415	1	0	0	50	0	51
19416	50	0	0	0	0	50
19417	0	0	49	1	0	50
19418	0	0	0	51	0	51
19419	1	0	50	0	0	51
19420	0	0	0	49	0	49
19421	0	52	0	0	0	52
19422	53	0	0	0	0	53
19423	0	0	52	1	0	53
19424	47	0	0	1	0	48
19425	0	0	0	50	0	50
19426	48	0	0	1	0	49
19427	0	0	0	50	0	50
19428	55	0	0	0	0	55
19429	0	1	56	1	0	58
19430	59	0	0	0	0	59
19431	0	0	0	60	0	60
19432	0	0	0	60	0	60
19433	60	0	0	0	0	60
19434	0	1	0	59	0	60
19435	0	0	62	0	0	62
19436	0	2	0	59	0	61
19437	59	0	0	1	0	60
19438	0	57	1	0	0	58
19439	0	57	0	0	0	57
19440	57	0	0	0	0	57
19441	0	67	0	0	0	67
19442	0	1	0	62	0	63
19443	64	0	0	0	0	64
19444	65	0	0	0	0	65
19445	63	0	0	0	0	63
19446	0	0	61	0	0	61
19447	0	0	0	62	0	62
19448	0	66	0	0	0	66
19449	0	0	0	66	0	66
19450	0	0	68	0	0	68
19451	0	63	0	0	0	63
19452	0	1	0	63	0	64
19453	62	0	0	0	0	62
19454	0	64	0	0	0	64
19455	0	0	67	0	0	67
19456	0	0	1	70	0	71
19457	0	0	71	2	0	73
19458	0	0	2	70	0	72
19459	72	0	0	2	0	74
19460	2	0	0	74	0	76
19461	75	0	0	2	0	77
19462	78	0	0	0	0	78
19463	2	75	0	0	0	77
19464	75	2	0	1	0	78
19465	1	71	0	0	0	72
19466	0	2	78	0	0	80
19467	0	0	2	77	0	79
19468	0	0	0	88	0	88
19469	0	0	86	2	0	88
19470	0	87	2	0	0	89
19471	87	2	0	0	0	89
19472	91	0	0	1	0	92
19473	2	0	1	92	0	95
19474	0	1	0	91	0	92
19475	1	0	0	94	0	95
19476	93	0	0	2	0	95
19477	3	0	90	1	0	94
19478	0	0	93	1	0	94
19479	0	0	1	94	0	95
19480	0	0	93	2	0	95
19481	0	0	96	0	0	96
19482	0	0	3	94	0	97
19483	0	0	97	3	0	100
19484	0	97	3	0	0	100
19485	0	2	1	96	0	99
19486	0	0	101	3	0	104
19487	1	0	2	95	0	98
19488	0	97	0	2	0	99
19489	0	2	0	100	0	102
19490	0	0	100	2	0	102
19491	0	0	2	97	0	99
19492	97	1	0	3	0	101
19493	2	0	100	1	0	103
19494	96	0	3	0	0	99
19495	3	97	0	1	0	101
19496	100	3	0	0	0	103
19497	3	0	1	99	0	103
19498	1	101	0	3	0	105
19499	105	4	0	0	0	109
19500	4	0	0	107	0	111
19501	0	0	106	4	0	110
19502	0	107	3	0	0	110
19503	1	3	0	108	0	112
19504	104	0	0	4	0	108
19505	107	0	1	0	0	108
19506	3	1	0	105	0	109
19507	0	0	103	4	0	107
19508	103	0	3	0	0	106
19509	4	0	106	0	0	110
19510	0	0	3	107	0	110
19511	105	0	1	4	0	110
19512	4	107	0	0	0	111
19513	109	3	1	0	0	113
19514	3	0	107	1	0	111
19515	110	0	3	0	0	113
19516	3	1	0	111	0	115
19517	1	0	0	113	0	114
19518	0	0	109	3	0	112
19519	1	0	3	108	0	112
19520	108	0	0	4	0	112
19521	3	0	0	109	0	112
19522	0	111	1	3	0	115
19523	0	3	0	115	0	118
19524	1	108	0	3	0	112
19525	0	3	111	1	0	115
19526	110	1	3	0	0	114
19527	2	0	0	112	0	114
19528	0	1	106	3	0	110
19529	0	107	4	0	0	111
19530	1	3	0	105	0	109
19531	0	0	0	110	0	110
19532	108	0	1	3	0	112
19533	3	1	0	107	0	111
19534	107	0	0	4	0	111
19535	107	0	0	1	0	108
19536	4	103	0	0	0	107
19537	106	3	0	1	0	110
19538	5	0	0	110	0	115
19539	1	1	112	3	0	117
19540	115	1	3	0	0	119
19541	4	0	0	106	0	110
19542	0	0	106	4	0	110
19543	103	0	4	1	0	108
19544	4	0	0	104	0	108
19545	0	101	2	4	0	107
19546	1	3	1	103	0	108
19547	1	104	0	3	0	108
19548	104	4	0	1	0	109
19549	3	1	105	0	0	109
19550	0	103	4	1	0	108
19551	2	4	0	103	0	109
19552	1	0	102	4	0	107
19553	0	1	99	0	0	100
19554	0	100	3	1	0	104
19555	1	1	1	96	0	99
19556	2	0	2	96	0	100
19557	1	2	1	115	0	119
19558	119	1	0	4	0	124
19559	2	0	135	1	0	138
19560	2	136	3	2	0	143
19561	1	2	2	139	0	144
19562	1	1	1	143	0	146
19563	1	1	141	3	0	146
19564	1	2	2	144	0	149
19565	1	0	143	4	0	148
19566	0	0	138	2	0	140
19567	2	1	136	1	0	140
19568	0	0	3	135	0	138
19569	1	0	2	136	0	139
19570	0	0	1	136	0	137
19571	132	0	0	6	0	138
19572	3	131	0	2	0	136
19573	138	2	0	2	0	142
19574	138	2	0	0	0	140
19575	138	1	0	1	0	140
19576	3	143	0	0	0	146
19577	143	1	1	0	0	145
19578	143	1	0	0	0	144
19579	3	0	0	138	0	141
19580	2	0	2	140	0	144
19581	1	2	0	142	0	145
19582	1	0	138	6	0	145
19583	136	0	2	4	0	142
19584	3	0	2	138	0	143
19585	135	0	1	5	0	141
19586	4	133	2	1	0	140
19587	3	2	1	134	0	140
19588	1	2	1	136	0	140
19589	133	1	0	5	0	139
19590	2	1	0	134	0	137
19591	130	0	1	5	0	136
19592	135	0	0	2	0	137
19593	4	127	0	3	0	134
19594	3	131	1	1	0	136
19595	3	4	0	128	0	135
19596	2	130	0	2	0	134
19597	0	4	0	131	0	135
19598	1	3	124	2	0	130
19599	1	1	123	1	0	126
19600	118	1	1	2	0	122
19601	120	0	2	2	0	124
19602	2	120	2	1	0	125
19603	122	1	2	0	0	125
19604	4	118	0	2	0	124
19605	3	1	0	123	0	127
19606	2	2	1	121	0	126
19607	1	3	0	121	0	125
19608	1	1	0	122	0	124
19609	119	0	0	5	0	124
19610	2	119	0	3	0	124
19611	120	1	0	4	0	125
19612	121	1	1	1	0	124
19613	4	1	116	0	0	121
19614	120	2	2	0	0	124
19615	3	114	1	3	0	121
19616	1	1	1	117	0	120
19617	1	2	0	115	0	118
19618	2	116	0	3	0	121
19619	116	3	1	2	0	122
19620	1	1	115	2	0	119
19621	115	1	1	2	0	119
19622	6	1	111	0	0	118
19623	2	2	3	111	0	118
19624	2	2	2	113	0	119
19625	2	1	1	113	0	117
19626	112	0	1	7	0	120
19627	1	0	112	5	0	118
19628	111	0	1	5	0	117
19629	113	0	3	2	0	118
19630	116	0	3	1	0	120
19631	112	1	4	1	0	118
19632	6	0	0	113	0	119
19633	4	1	110	2	0	117
19634	2	0	3	114	0	119
19635	4	0	113	2	0	119
19636	1	2	109	3	0	115
19637	2	108	3	4	0	117
19638	3	1	1	106	0	111
19639	3	1	1	104	0	109
19640	1	4	1	100	0	106
19641	3	1	1	103	0	108
19642	106	0	0	4	0	110
19643	103	1	1	4	0	109
19644	2	1	0	103	0	106
19645	2	0	101	4	0	107
19646	2	0	3	102	0	107
19647	4	0	1	105	0	110
19648	1	0	105	6	0	112
19649	3	1	3	103	0	110
19650	102	2	2	2	0	108
19651	102	1	0	4	0	107
19652	106	0	1	4	0	111
19653	5	0	0	104	0	109
19654	99	1	1	5	0	106
19655	100	0	0	5	0	105
19656	7	0	102	1	0	110
19657	2	0	84	2	0	88
19658	2	0	80	1	0	83
19659	62	0	1	0	0	63
19660	1	61	1	0	0	63
19661	58	1	3	0	0	62
19662	0	70	1	1	0	72
19663	1	1	2	69	0	73
19664	0	1	0	72	0	73
19665	1	0	1	70	0	72
19666	0	1	69	0	0	70
19667	70	0	0	0	0	70
19668	1	0	0	72	0	73
19669	0	1	73	1	0	75
19670	1	0	71	0	0	72
19671	76	0	0	0	0	76
19672	0	77	0	1	0	78
19673	73	0	1	1	0	75
19674	74	0	0	1	0	75
19675	1	74	0	1	0	76
19676	74	1	0	0	0	75
19677	1	1	74	0	0	76
19678	1	0	70	0	0	71
19679	2	0	73	0	0	75
19680	0	0	1	75	0	76
19681	1	0	74	0	0	75
19682	74	0	0	0	0	74
19683	75	0	0	0	0	75
19684	0	0	74	0	0	74
19685	0	0	0	75	0	75
19686	76	0	0	0	0	76
19687	0	90	0	0	0	90
19688	0	89	0	0	0	89
19689	90	0	0	1	0	91
19690	0	0	92	0	0	92
19691	0	0	0	93	0	93
19692	0	0	0	93	0	93
19693	0	0	0	93	0	93
19694	0	95	0	0	0	95
19695	0	0	0	87	0	87
19696	99	0	0	0	0	99
19697	0	0	0	102	0	102
19698	0	103	0	0	0	103
19699	108	0	0	0	0	108
19700	0	0	0	109	0	109
19701	0	0	0	111	0	111
19702	111	0	0	0	0	111
19703	109	0	0	0	0	109
19704	0	0	0	110	0	110
19705	111	0	0	0	0	111
19706	111	0	0	0	0	111
19707	0	112	0	0	0	112
19708	113	0	0	0	0	113
19709	0	112	0	0	0	112
19710	0	0	0	112	0	112
19711	0	0	118	0	0	118
19712	0	0	0	117	0	117
19713	0	0	0	116	0	116
19714	0	0	0	119	0	119
19715	121	0	0	1	0	122
19716	0	121	0	0	0	121
19717	129	1	0	0	0	130
19718	0	141	0	1	0	142
19719	144	0	0	0	0	144
19720	144	0	0	1	0	145
19721	142	0	0	0	0	142
19722	145	0	0	0	0	145
19723	0	0	144	1	0	145
19724	0	0	0	147	0	147
19725	2	0	0	149	0	151
19726	1	0	154	0	0	155
19727	151	0	0	2	0	153
19728	1	0	0	158	0	159
19729	1	0	157	0	0	158
19730	1	1	148	0	0	150
19731	1	0	0	156	0	157
19732	0	0	155	0	0	155
19733	0	0	0	155	0	155
19734	1	0	1	154	0	156
19735	0	0	152	1	0	153
19736	150	0	0	1	0	151
19737	0	0	0	155	0	155
19738	1	0	161	0	0	162
19739	0	1	1	162	0	164
19740	164	0	0	1	0	165
19741	0	1	164	0	0	165
19742	159	0	0	2	0	161
19743	168	0	0	2	0	170
19744	1	0	1	167	0	169
19745	2	0	0	163	0	165
19746	0	0	167	1	0	168
19747	0	0	1	166	0	167
19748	0	0	0	153	0	153
19749	1	0	1	167	0	169
19750	1	0	166	0	0	167
19751	164	0	0	3	0	167
19752	171	0	1	2	0	174
19753	174	0	0	1	0	175
19754	179	1	0	2	0	182
19755	1	0	2	180	0	183
19756	179	1	0	2	0	182
19757	176	0	0	4	0	180
19758	164	0	1	1	0	166
19759	183	0	1	0	0	184
19760	1	181	1	2	0	185
19761	181	0	0	1	0	182
19762	174	0	0	1	0	175
19763	3	174	0	0	0	177
19764	174	1	0	1	0	176
19765	3	1	0	173	0	177
19766	3	0	0	176	0	179
19767	175	0	0	2	0	177
19768	2	170	0	1	0	173
19769	1	170	1	0	0	172
19770	1	0	0	173	0	174
19771	2	0	170	3	0	175
19772	0	1	1	173	0	175
19773	1	0	2	174	0	177
19774	169	0	0	2	0	171
19775	171	0	0	2	0	173
19776	3	0	1	168	0	172
19777	1	1	165	1	0	168
19778	0	1	1	167	0	169
19779	173	0	1	2	0	176
19780	2	0	178	1	0	181
19781	1	185	1	2	0	189
19782	188	1	1	1	0	191
19783	4	2	0	188	0	194
19784	1	0	0	193	0	194
19785	1	0	1	193	0	195
19786	0	1	192	3	0	196
19787	169	0	2	1	0	172
19788	3	0	177	1	0	181
19789	1	174	3	1	0	179
19790	2	4	0	176	0	182
19791	1	0	0	178	0	179
19792	0	0	0	192	0	192
19793	0	0	190	5	0	195
19794	0	0	190	3	0	193
19795	3	0	192	1	0	196
19796	3	192	2	2	0	199
19797	0	2	4	189	0	195
19798	191	1	1	2	0	195
19799	207	0	0	3	0	210
19800	3	0	219	2	0	224
19801	1	222	1	4	0	228
19802	0	2	224	2	0	228
19803	1	226	3	0	0	230
19804	227	2	3	0	0	232
19805	226	2	0	1	0	229
19806	2	225	1	2	0	230
19807	226	2	0	1	0	229
19808	4	0	0	224	0	228
19809	0	0	3	225	0	228
19810	224	2	0	2	0	228
19811	218	0	2	0	0	220
19812	219	2	0	1	0	222
19813	3	210	0	2	0	215
19814	2	219	1	0	0	222
19815	218	4	3	1	0	226
19816	4	1	217	1	0	223
19817	1	0	2	216	0	219
19818	201	1	1	5	0	208
19819	4	197	0	1	0	202
19820	3	206	0	1	0	210
19821	209	2	1	0	0	212
19822	3	2	201	0	0	206
19823	201	2	3	1	0	207
19824	4	1	192	0	0	197
19825	1	0	193	1	0	195
19826	1	4	2	190	0	197
19827	1	0	197	3	0	201
19828	190	1	2	1	0	194
19829	195	1	1	0	0	197
19830	197	0	1	0	0	198
19831	193	1	1	1	0	196
19832	2	0	0	193	0	195
19833	191	0	1	2	0	194
19834	3	188	1	2	0	194
19835	0	2	1	191	0	194
19836	0	195	1	2	0	198
19837	197	1	1	0	0	199
19838	194	1	0	0	0	195
19839	3	0	0	186	0	189
19840	190	0	0	2	0	192
19841	187	1	0	1	0	189
19842	3	0	0	187	0	190
19843	0	1	0	191	0	192
19844	0	0	0	190	0	190
19845	1	2	188	2	0	193
19846	3	0	179	0	0	182
19847	2	0	181	1	0	184
19848	0	1	2	186	0	189
19849	1	1	181	3	0	186
19850	2	0	3	184	0	189
19851	1	0	190	3	0	194
19852	0	0	185	2	0	187
19853	179	0	2	1	0	182
19854	1	174	1	1	0	177
19855	173	3	1	2	0	179
19856	3	0	1	172	0	176
19857	0	0	2	170	0	172
19858	1	0	168	2	0	171
19859	0	165	4	1	0	170
19860	1	3	2	169	0	175
19861	0	0	170	4	0	174
19862	2	164	2	0	0	168
19863	2	2	0	164	0	168
19864	166	0	1	1	0	168
19865	163	1	1	2	0	167
19866	2	1	0	164	0	167
19867	162	1	2	3	0	168
19868	3	164	0	0	0	167
19869	2	2	0	164	0	168
19870	0	0	169	2	0	171
19871	1	3	1	166	0	171
19872	2	0	167	3	0	172
19873	166	0	1	3	0	170
19874	3	0	0	168	0	171
19875	3	169	0	2	0	174
19876	3	1	0	169	0	173
19877	1	1	172	2	0	176
19878	0	3	168	2	0	173
19879	1	1	164	1	0	167
19880	149	0	4	0	0	153
19881	0	148	1	0	0	149
19882	1	0	0	149	0	150
19883	148	0	0	1	0	149
19884	0	148	0	0	0	148
19885	161	1	0	2	0	164
19886	166	0	0	1	0	167
19887	171	0	1	0	0	172
19888	171	0	0	1	0	172
19889	0	0	167	0	0	167
19890	165	0	1	1	0	167
19891	0	0	167	1	0	168
19892	155	0	1	0	0	156
19893	0	1	0	155	0	156
19894	1	0	151	0	0	152
19895	1	151	0	0	0	152
19896	2	10	0	131	0	143
19897	0	137	0	1	0	138
19898	1	145	0	0	0	146
19899	124	1	1	0	0	126
19900	0	0	115	0	0	115
19901	0	109	0	0	0	109
19902	110	0	0	0	0	110
19903	0	114	0	0	0	114
19904	116	0	0	0	0	116
19905	0	0	0	115	0	115
19906	113	0	0	0	0	113
19907	0	0	0	114	0	114
19908	115	0	0	0	0	115
19909	0	0	0	113	0	113
19910	0	117	0	0	0	117
19911	0	0	0	121	0	121
19912	118	0	0	0	0	118
19913	0	120	0	0	0	120
19914	0	0	0	116	0	116
19915	116	0	0	0	0	116
19916	0	0	0	112	0	112
19917	0	0	0	115	0	115
19918	0	0	120	0	0	120
19919	0	0	113	0	0	113
19920	0	0	0	112	0	112
19921	0	0	121	0	0	121
19922	0	0	0	121	0	121
19923	0	0	0	110	0	110
19924	0	0	0	123	0	123
19925	0	0	127	0	0	127
19926	0	0	0	125	0	125
19927	0	0	0	123	0	123
19928	0	127	0	0	0	127
19929	0	0	0	131	0	131
19930	129	0	0	0	0	129
19931	0	0	0	129	0	129
19932	0	0	157	0	0	157
19933	152	0	2	0	0	154
19934	2	170	1	1	0	174
19935	1	3	1	169	0	174
19936	1	1	175	3	0	180
19937	168	1	2	2	0	173
19938	2	170	1	1	0	174
19939	176	3	0	0	0	179
19940	4	1	0	175	0	180
19941	174	1	0	3	0	178
19942	4	0	171	1	0	176
19943	1	171	3	1	0	176
19944	1	187	1	0	0	189
19945	185	4	1	0	0	190
19946	189	2	0	0	0	191
19947	4	0	181	0	0	185
19948	180	0	3	0	0	183
19949	190	0	0	0	0	190
19950	188	0	1	1	0	190
19951	5	179	0	0	0	184
19952	2	185	0	0	0	187
19953	186	4	0	0	0	190
19954	193	2	0	1	0	196
19955	4	196	0	0	0	200
19956	1	3	0	198	0	202
19957	1	0	198	3	0	202
19958	197	1	2	1	0	201
19959	198	1	1	1	0	201
19960	207	0	3	0	0	210
19961	5	204	0	0	0	209
19962	2	5	216	0	0	223
19963	219	2	3	1	0	225
19964	4	1	2	224	0	231
19965	2	0	1	226	0	229
19966	2	1	0	228	0	231
19967	1	0	225	6	0	232
19968	0	0	4	223	0	227
19969	1	0	225	5	0	231
19970	0	220	6	1	0	227
19971	217	4	1	1	0	223
19972	3	220	3	0	0	226
19973	2	231	0	0	0	233
19974	230	5	0	0	0	235
19975	4	233	2	0	0	239
19976	3	4	0	230	0	237
19977	2	231	1	3	0	237
19978	233	5	0	1	0	239
19979	3	235	0	1	0	239
19980	1	5	0	236	0	242
19981	2	2	238	4	0	246
19982	1	1	4	241	0	247
19983	0	245	1	4	0	250
19984	0	3	1	248	0	252
19985	0	1	0	238	0	239
19986	2	1	0	230	0	233
19987	1	0	0	237	0	238
19988	1	0	0	235	0	236
19989	0	0	0	237	0	237
19990	0	0	236	6	0	242
19991	225	0	4	2	0	231
19992	4	0	1	240	0	245
19993	1	0	241	5	0	247
19994	1	0	240	2	0	243
19995	0	0	6	246	0	252
19996	248	0	2	5	0	255
19997	4	0	243	1	0	248
19998	240	1	4	1	0	246
19999	7	0	253	0	0	260
20000	1	2	5	252	0	260
20001	1	1	1	260	0	263
20002	1	0	256	5	0	262
20003	247	1	3	1	0	252
20004	4	0	1	251	0	256
20005	1	0	254	4	0	259
20006	2	0	265	1	0	268
20007	1	1	4	255	0	261
20008	1	261	2	3	0	267
20009	263	4	3	1	0	271
20010	264	1	0	4	0	269
20011	5	3	265	0	0	273
20012	3	0	4	265	0	272
20013	264	1	1	7	0	273
20014	4	0	261	3	0	268
20015	253	0	5	2	0	260
20016	5	259	1	5	0	270
20017	1	3	3	266	0	273
20018	1	1	3	269	0	274
20019	272	1	0	7	0	280
20020	5	1	0	275	0	281
20021	2	0	2	271	0	275
20022	3	0	1	270	0	274
20023	261	0	1	8	0	270
20024	5	0	261	4	0	270
20025	262	0	5	3	0	270
20026	266	0	3	1	0	270
20027	270	0	3	0	0	273
20028	7	0	1	260	0	268
20029	2	2	262	8	0	274
20030	2	253	6	2	0	263
20031	2	262	2	2	0	268
20032	1	244	0	1	0	246
20033	1	3	243	1	0	248
20034	1	0	3	303	0	307
20035	310	0	0	5	0	315
20036	340	0	2	1	0	343
20037	6	0	0	344	0	350
20038	3	0	341	5	0	349
20039	2	0	341	0	0	343
20040	0	1	4	344	0	349
20041	0	0	349	6	0	355
20042	0	2	4	357	0	363
20043	2	1	0	351	0	354
20044	1	348	0	4	0	353
20045	2	4	2	350	0	358
20046	1	0	0	360	0	361
20047	357	0	1	5	0	363
20048	5	0	4	351	0	360
20049	2	0	1	361	0	364
20050	348	1	2	5	0	356
20051	6	351	2	3	0	362
20052	355	5	0	4	0	364
20053	6	1	351	1	0	359
20054	343	2	5	3	0	353
20055	352	1	0	3	0	356
20056	5	3	338	2	0	348
20057	3	0	336	2	0	341
20058	1	0	6	341	0	348
20059	341	0	0	6	0	347
20060	7	1	331	2	0	341
20061	2	1	7	331	0	341
20062	2	0	321	6	0	329
20063	2	1	7	316	0	326
20064	4	1	1	322	0	328
20065	317	0	1	7	0	325
20066	317	2	4	3	0	326
20067	323	1	3	2	0	329
20068	5	1	317	4	0	327
20069	2	0	322	2	0	326
20070	4	0	4	320	0	328
20071	3	0	1	322	0	326
20072	2	0	3	326	0	331
20073	316	0	2	8	0	326
20074	7	312	3	2	0	324
20075	305	5	3	2	0	315
20076	304	0	1	3	0	308
20077	7	301	2	0	0	310
20078	3	305	3	0	0	311
20079	303	5	3	1	0	312
20080	5	0	2	298	0	305
20081	2	288	2	7	0	299
20082	5	6	1	296	0	308
20083	4	3	292	7	0	306
20084	1	2	5	297	0	305
20085	298	0	5	7	0	310
20086	4	2	291	4	0	301
20087	2	2	291	4	0	299
20088	5	4	6	285	0	300
20089	2	290	1	9	0	302
20090	3	296	1	4	0	304
20091	2	301	3	2	0	308
20092	291	4	3	6	0	304
20093	295	0	2	6	0	303
20094	286	1	1	5	0	293
20095	6	289	2	5	0	302
20096	295	7	3	3	0	308
20097	301	2	3	2	0	308
20098	8	2	294	3	0	307
20099	5	287	6	1	0	299
20100	1	8	2	287	0	298
20101	289	2	0	7	0	298
20102	12	1	283	2	0	298
20103	3	2	7	278	0	290
20104	2	283	2	7	0	294
20105	3	5	2	285	0	295
20106	7	0	2	280	0	289
20107	282	1	4	7	0	294
20108	285	1	4	3	0	293
20109	4	2	6	279	0	291
20110	3	0	276	11	0	290
20111	5	1	276	4	0	286
20112	279	1	7	1	0	288
20113	9	2	276	2	0	289
20114	3	1	7	265	0	276
20115	3	267	5	6	0	281
20116	267	3	3	3	0	276
20117	10	270	0	4	0	284
20118	273	5	3	4	0	285
20119	8	0	1	276	0	285
20120	2	1	5	274	0	282
20121	270	3	3	5	0	281
20122	281	2	1	3	0	287
20123	10	1	1	273	0	285
20124	2	3	2	275	0	282
20125	3	2	267	5	0	277
20126	4	3	265	2	0	274
20127	260	2	4	4	0	270
20128	5	2	264	7	0	278
20129	263	0	4	6	0	273
20130	267	0	3	2	0	272
20131	8	0	258	3	0	269
20132	4	244	4	2	0	254
20133	1	247	4	2	0	254
20134	2	1	181	1	0	185
20135	9	9	7	147	0	172
20136	133	2	3	4	0	142
20137	130	1	0	0	0	131
20138	151	1	0	0	0	152
20139	179	0	2	0	0	181
20140	183	0	0	1	0	184
20141	3	192	0	0	0	195
20142	187	2	0	0	0	189
20143	2	186	0	0	0	188
20144	186	1	0	0	0	187
20145	2	0	182	0	0	184
20146	1	0	1	180	0	182
20147	0	0	0	176	0	176
20148	0	177	0	1	0	178
20149	177	1	0	0	0	178
20150	177	0	0	0	0	177
20151	1	0	0	173	0	174
20152	1	0	0	173	0	174
20153	174	0	0	1	0	175
20154	1	0	0	173	0	174
20155	0	0	0	172	0	172
20156	173	0	0	1	0	174
20157	1	0	0	171	0	172
20158	172	0	0	1	0	173
20159	173	0	0	0	0	173
20160	1	0	172	0	0	173
20161	170	0	1	0	0	171
20162	171	0	0	0	0	171
20163	171	0	0	0	0	171
20164	1	0	167	0	0	168
20165	0	0	1	169	0	170
20166	0	0	0	167	0	167
20167	0	0	165	1	0	166
20168	160	0	1	0	0	161
20169	1	0	0	158	0	159
20170	0	0	154	1	0	155
20171	0	0	160	0	0	160
20172	0	0	1	156	0	157
20173	0	0	161	1	0	162
20174	0	0	1	160	0	161
20175	0	0	0	159	0	159
20176	0	0	160	1	0	161
20177	0	0	1	158	0	159
20178	0	159	0	1	0	160
20179	0	160	0	1	0	161
20180	163	2	0	0	0	165
20181	161	1	0	0	0	162
20182	2	160	1	0	0	163
20183	161	1	0	0	0	162
20184	161	1	0	0	0	162
20185	2	0	0	158	0	160
20186	1	0	0	158	0	159
20187	158	0	0	2	0	160
20188	1	156	0	1	0	158
20189	1	150	0	0	0	151
20190	1	2	0	146	0	149
20191	0	1	144	1	0	146
20192	143	0	1	1	0	145
20193	142	0	1	0	0	143
20194	137	0	0	0	0	137
20195	2	138	0	0	0	140
20196	1	1	0	135	0	137
20197	0	1	0	134	0	135
20198	131	0	0	2	0	133
20199	1	130	0	2	0	133
20200	2	1	0	128	0	131
20201	1	1	0	129	0	131
20202	1	0	0	131	0	132
20203	128	1	0	2	0	131
20204	2	127	0	1	0	130
20205	1	2	0	126	0	129
20206	1	129	0	0	0	130
20207	123	1	1	1	0	126
20208	1	1	122	1	0	125
20209	119	0	1	1	0	121
20210	1	0	119	0	0	120
20211	1	1	1	112	0	115
20212	114	0	1	1	0	116
20213	1	0	107	2	0	110
20214	108	0	1	1	0	110
20215	110	0	1	0	0	111
20216	112	0	0	1	0	113
20217	2	0	0	109	0	111
20218	2	0	0	107	0	109
20219	0	0	0	109	0	109
20220	108	0	0	2	0	110
20221	2	109	0	1	0	112
20222	106	1	1	0	0	108
20223	108	1	0	0	0	109
20224	3	0	105	0	0	108
20225	105	0	1	0	0	106
20226	105	0	2	0	0	107
20227	2	0	0	103	0	105
20228	1	0	0	108	0	109
20229	0	0	1	107	0	108
20230	106	0	0	2	0	108
20231	103	0	0	2	0	105
20232	101	0	1	0	0	102
20233	2	97	0	0	0	99
20234	1	85	0	1	0	87
20235	0	88	1	0	0	89
20236	86	2	1	1	0	90
20237	1	1	85	1	0	88
20238	2	0	64	0	0	66
20239	34	0	1	0	0	35
20240	0	0	37	0	0	37
20241	1	0	0	25	0	26
20242	0	23	1	0	0	24
20243	27	0	0	1	0	28
20244	28	1	0	0	0	29
20245	29	0	0	0	0	29
20246	1	0	0	33	0	34
20247	1	0	36	0	0	37
20248	0	0	33	1	0	34
20249	35	0	1	0	0	36
20250	36	0	1	0	0	37
20251	37	0	0	0	0	37
20252	1	0	0	36	0	37
20253	1	0	0	35	0	36
20254	0	0	35	1	0	36
20255	38	0	0	1	0	39
20256	0	0	1	39	0	40
20257	1	0	0	38	0	39
20258	0	0	0	39	0	39
20259	0	38	0	1	0	39
20260	0	0	0	40	0	40
20261	0	1	0	37	0	38
20262	38	0	0	1	0	39
20263	0	0	38	1	0	39
20264	37	0	0	0	0	37
20265	40	0	1	0	0	41
20266	1	0	0	40	0	41
20267	1	0	0	38	0	39
20268	39	0	0	1	0	40
20269	0	0	40	1	0	41
20270	1	40	0	0	0	41
20271	0	0	1	40	0	41
20272	40	1	0	0	0	41
20273	0	0	0	39	0	39
20274	1	0	36	0	0	37
20275	0	0	37	1	0	38
20276	37	0	1	0	0	38
20277	0	0	0	36	0	36
20278	0	0	35	0	0	35
20279	37	0	0	0	0	37
20280	39	0	0	0	0	39
20281	0	0	0	38	0	38
20282	0	0	0	38	0	38
20283	0	39	0	0	0	39
20284	43	0	0	0	0	43
20285	0	0	0	43	0	43
20286	0	0	0	44	0	44
20287	0	0	43	0	0	43
20288	41	0	0	0	0	41
20289	42	0	0	0	0	42
20290	0	41	0	0	0	41
20291	0	0	40	0	0	40
20292	0	0	41	0	0	41
20293	0	0	0	42	0	42
20294	45	0	0	1	0	46
20295	0	0	0	45	0	45
20296	50	0	0	1	0	51
20297	48	0	0	0	0	48
20298	50	0	0	0	0	50
20299	0	0	0	51	0	51
20300	0	0	0	48	0	48
20301	52	0	0	0	0	52
20302	0	0	54	0	0	54
20303	53	0	0	0	0	53
20304	50	0	0	1	0	51
20305	0	0	56	0	0	56
20306	0	0	54	0	0	54
20307	0	54	0	0	0	54
20308	0	0	0	57	0	57
20309	56	0	0	0	0	56
20310	0	0	0	54	0	54
20311	0	0	57	0	0	57
20312	0	57	0	0	0	57
20313	0	60	0	0	0	60
20314	0	0	0	64	0	64
20315	0	0	0	62	0	62
20316	0	61	0	0	0	61
20317	0	0	61	0	0	61
20318	60	0	0	0	0	60
20319	63	0	0	0	0	63
20320	0	61	0	0	0	61
20321	60	0	0	0	0	60
20322	0	0	0	60	0	60
20323	59	0	0	1	0	60
20324	0	0	0	60	0	60
20325	0	61	0	0	0	61
20326	0	0	62	0	0	62
20327	0	0	0	70	0	70
20328	0	0	0	70	0	70
20329	0	0	0	72	0	72
20330	71	0	0	1	0	72
20331	1	0	0	73	0	74
20332	0	0	85	1	0	86
20333	0	0	87	0	0	87
20334	89	0	1	0	0	90
20335	1	0	92	0	0	93
20336	95	0	1	1	0	97
20337	1	0	0	101	0	102
20338	0	0	0	100	0	100
20339	0	0	0	105	0	105
20340	0	0	0	98	0	98
20341	99	0	0	2	0	101
20342	1	0	97	1	0	99
20343	0	0	0	100	0	100
20344	0	99	0	1	0	100
20345	100	1	0	0	0	101
20346	1	0	0	96	0	97
20347	94	0	0	2	0	96
20348	1	0	94	0	0	95
20349	1	0	1	94	0	96
20350	0	94	0	0	0	94
20351	94	1	0	1	0	96
20352	1	0	96	0	0	97
20353	0	0	1	93	0	94
20354	0	0	0	97	0	97
20355	93	0	0	2	0	95
20356	1	0	93	0	0	94
20357	0	0	96	0	0	96
20358	0	0	1	93	0	94
20359	0	0	94	1	0	95
20360	0	0	94	0	0	94
20361	0	0	1	93	0	94
20362	0	0	0	94	0	94
20363	0	0	0	96	0	96
20364	94	0	0	2	0	96
20365	1	98	0	0	0	99
20366	96	1	0	0	0	97
20367	1	0	0	97	0	98
20368	0	95	0	1	0	96
20369	0	1	0	99	0	100
20370	97	0	0	1	0	98
20371	1	102	0	0	0	103
20372	0	1	0	105	0	106
20373	0	0	102	1	0	103
20374	103	0	1	0	0	104
20375	1	0	0	107	0	108
20376	0	0	0	107	0	107
20377	0	0	105	1	0	106
20378	1	0	106	0	0	107
20379	101	0	2	1	0	104
20380	2	101	0	0	0	103
20381	0	1	0	102	0	103
20382	102	0	0	2	0	104
20383	1	0	101	0	0	102
20384	0	100	1	1	0	102
20385	2	1	0	98	0	101
20386	100	0	1	3	0	104
20387	99	0	0	2	0	101
20388	100	1	0	2	0	103
20389	2	97	0	1	0	100
20390	1	1	100	1	0	103
20391	2	0	2	100	0	104
20392	0	0	2	91	0	93
20393	1	0	0	102	0	103
20394	1	1	0	99	0	101
20395	96	0	0	3	0	99
20396	94	0	0	1	0	95
20397	1	0	93	2	0	96
20398	1	0	93	2	0	96
20399	92	1	1	0	0	94
20400	94	0	1	1	0	96
20401	1	1	2	89	0	93
20402	1	83	0	4	0	88
20403	81	1	1	2	0	85
20404	3	78	2	0	0	83
20405	0	81	2	2	0	85
20406	0	2	1	86	0	89
20407	2	1	0	86	0	89
20408	1	0	1	86	0	88
20409	1	1	1	85	0	88
20410	1	0	85	2	0	88
20411	83	0	1	4	0	88
20412	85	1	0	1	0	87
20413	3	0	1	82	0	86
20414	0	1	2	83	0	86
20415	83	1	0	3	0	87
20416	1	0	82	3	0	86
20417	85	1	3	0	0	89
20418	85	0	1	2	0	88
20419	2	0	84	2	0	88
20420	86	1	1	3	0	91
20421	2	0	2	86	0	90
20422	0	1	2	88	0	91
20423	2	0	0	87	0	89
20424	0	1	0	89	0	90
20425	85	1	0	4	0	90
20426	2	0	0	82	0	84
20427	2	1	2	71	0	76
20428	2	73	0	0	0	75
20429	0	72	0	1	0	73
20430	2	1	0	71	0	74
20431	71	0	0	1	0	72
20432	2	0	1	59	0	62
20433	0	3	53	0	0	56
20434	0	0	51	2	0	53
20435	53	0	1	0	0	54
20436	1	46	0	0	0	47
20437	42	0	0	1	0	43
20438	0	0	42	1	0	43
20439	0	0	0	38	0	38
20440	38	0	0	0	0	38
20441	0	39	0	0	0	39
20442	37	0	0	0	0	37
20443	0	1	44	0	0	45
20444	0	0	0	47	0	47
20445	0	2	0	46	0	48
20446	48	0	0	0	0	48
20447	50	0	0	0	0	50
20448	52	0	0	0	0	52
20449	52	0	0	0	0	52
20450	53	0	0	0	0	53
20451	0	54	0	0	0	54
20452	0	0	0	55	0	55
20453	57	0	0	0	0	57
20454	0	0	0	57	0	57
20455	0	0	0	57	0	57
20456	0	0	0	57	0	57
20457	0	58	0	0	0	58
20458	58	0	0	0	0	58
20459	0	0	0	59	0	59
20460	58	0	0	0	0	58
20461	58	0	0	0	0	58
20462	0	60	0	0	0	60
20463	62	0	0	0	0	62
20464	0	0	60	0	0	60
20465	57	0	0	0	0	57
20466	0	0	0	59	0	59
20467	0	0	61	0	0	61
20468	0	61	0	0	0	61
20469	0	0	60	0	0	60
20470	0	60	0	0	0	60
20471	53	2	1	0	0	56
20472	52	0	0	0	0	52
20473	54	0	0	0	0	54
20474	0	54	0	0	0	54
20475	55	0	0	0	0	55
20476	0	0	56	0	0	56
20477	0	0	55	0	0	55
20478	0	0	0	58	0	58
20479	0	0	0	58	0	58
20480	0	58	0	0	0	58
20481	58	0	0	0	0	58
20482	0	0	0	59	0	59
20483	0	59	0	0	0	59
20484	0	0	0	59	0	59
20485	58	0	0	1	0	59
20486	58	0	0	1	0	59
20487	0	0	56	0	0	56
20488	0	0	0	57	0	57
20489	0	0	58	0	0	58
20490	0	0	0	58	0	58
20491	0	0	59	0	0	59
20492	0	0	0	59	0	59
20493	0	0	59	0	0	59
20494	0	0	0	60	0	60
20495	0	0	60	0	0	60
20496	0	0	0	60	0	60
20497	0	0	0	63	0	63
20498	0	65	0	0	0	65
20499	0	0	0	67	0	67
20500	0	0	67	0	0	67
20501	0	0	0	65	0	65
20502	0	0	0	67	0	67
20503	68	0	0	0	0	68
20504	0	0	0	67	0	67
20505	0	0	0	64	0	64
20506	0	0	59	0	0	59
20507	64	0	0	0	0	64
20508	0	0	0	63	0	63
20509	0	0	0	64	0	64
20510	0	0	0	65	0	65
20511	66	0	0	0	0	66
20512	0	0	0	66	0	66
20513	0	0	0	66	0	66
20514	67	0	0	0	0	67
20515	0	67	0	0	0	67
20516	0	0	0	64	0	64
20517	0	0	0	64	0	64
20518	0	0	64	0	0	64
20519	57	0	0	0	0	57
20520	0	0	0	63	0	63
20521	0	0	60	0	0	60
20522	60	0	0	0	0	60
20523	0	0	0	60	0	60
20524	0	0	0	62	0	62
20525	0	0	0	61	0	61
20526	0	0	0	62	0	62
20527	0	0	62	0	0	62
20528	0	0	0	64	0	64
20529	0	0	0	82	0	82
20530	0	0	99	1	0	100
20531	102	0	2	0	0	104
20532	108	0	1	0	0	109
20533	109	0	0	0	0	109
20534	3	0	1	106	0	110
20535	111	0	0	2	0	113
20536	114	0	0	1	0	115
20537	5	0	0	115	0	120
20538	116	0	0	3	0	119
20539	117	0	0	2	0	119
20540	119	0	0	0	0	119
20541	115	0	0	2	0	117
20542	5	0	0	112	0	117
20543	4	102	0	2	0	108
20544	2	104	0	2	0	108
20545	2	106	0	0	0	108
20546	108	3	0	1	0	112
20547	109	2	0	1	0	112
20548	4	2	105	0	0	111
20549	104	2	2	1	0	109
20550	3	2	1	107	0	113
20551	3	0	0	107	0	110
20552	1	1	0	108	0	110
20553	105	0	1	3	0	109
20554	3	0	0	103	0	106
20555	1	102	0	4	0	107
20556	1	2	0	106	0	109
20557	1	1	100	4	0	106
20558	1	0	2	104	0	107
20559	101	1	1	4	0	107
20560	3	1	100	2	0	106
20561	1	0	3	100	0	104
20562	0	1	2	103	0	106
20563	1	0	0	104	0	105
20564	1	99	2	3	0	105
20565	0	2	1	103	0	106
20566	102	1	0	4	0	107
20567	101	0	1	3	0	105
20568	3	1	98	2	0	104
20569	1	1	97	2	0	101
20570	1	0	3	100	0	104
20571	2	1	1	99	0	103
20572	1	0	102	4	0	107
20573	1	0	4	98	0	103
20574	1	100	1	2	0	104
20575	102	2	1	2	0	107
20576	102	1	1	1	0	105
20577	102	0	1	1	0	104
20578	3	1	98	2	0	104
20579	2	1	3	102	0	108
20580	3	0	101	3	0	107
20581	102	1	2	1	0	106
20582	4	99	2	0	0	105
20583	2	2	1	99	0	104
20584	99	1	1	3	0	104
20585	3	0	1	101	0	105
20586	2	1	0	106	0	109
20587	0	0	103	4	0	107
20588	104	0	2	2	0	108
20589	3	100	1	1	0	105
20590	1	3	0	104	0	108
20591	103	1	1	3	0	108
20592	3	0	1	104	0	108
20593	102	1	0	3	0	106
20594	2	103	1	2	0	108
20595	107	1	0	1	0	109
20596	3	1	104	1	0	109
20597	105	0	3	2	0	110
20598	102	1	1	0	0	104
20599	102	1	0	1	0	104
20600	5	0	0	99	0	104
20601	2	1	1	97	0	101
20602	2	0	0	101	0	103
20603	2	97	1	3	0	103
20604	98	2	0	2	0	102
20605	3	1	0	100	0	104
20606	2	0	0	101	0	103
20607	0	1	0	102	0	103
20608	98	1	0	4	0	103
20609	3	0	0	99	0	102
20610	1	1	95	4	0	101
20611	1	92	2	5	0	100
20612	1	2	1	98	0	102
20613	1	1	0	99	0	101
20614	0	0	1	101	0	102
20615	1	1	96	3	0	101
20616	0	1	98	3	0	102
20617	0	0	3	98	0	101
20618	0	1	98	4	0	103
20619	0	0	3	102	0	105
20620	99	0	3	2	0	104
20621	102	0	0	3	0	105
20622	102	0	2	1	0	105
20623	3	1	100	1	0	105
20624	100	0	2	2	0	104
20625	3	0	2	102	0	107
20626	3	0	99	3	0	105
20627	3	0	102	1	0	106
20628	2	104	4	0	0	110
20629	2	87	2	1	0	92
20630	63	0	2	0	0	65
20631	1	0	1	59	0	61
20632	0	0	60	1	0	61
20633	0	0	1	61	0	62
20634	61	0	0	2	0	63
20635	0	0	62	0	0	62
20636	61	0	1	0	0	62
20637	69	0	0	0	0	69
20638	69	0	0	0	0	69
20639	1	69	0	0	0	70
20640	71	1	0	0	0	72
20641	1	0	0	74	0	75
20642	0	0	0	73	0	73
20643	0	0	0	75	0	75
20644	0	0	0	74	0	74
20645	73	0	0	1	0	74
20646	0	71	0	0	0	71
20647	0	69	0	0	0	69
20648	0	66	0	0	0	66
20649	68	1	0	0	0	69
20650	66	0	0	0	0	66
20651	67	0	0	0	0	67
20652	65	0	0	0	0	65
20653	2	0	0	66	0	68
20654	0	0	0	68	0	68
20655	67	0	0	1	0	68
20656	1	65	0	0	0	66
20657	66	1	0	0	0	67
20658	69	0	0	0	0	69
20659	0	0	0	67	0	67
20660	0	67	0	1	0	68
20661	0	2	0	69	0	71
20662	68	0	0	2	0	70
20663	2	0	69	0	0	71
20664	1	0	1	57	0	59
20665	0	61	1	2	0	64
20666	60	2	0	0	0	62
20667	64	0	0	0	0	64
20668	2	0	61	0	0	63
20669	0	64	2	0	0	66
20670	0	2	68	0	0	70
20671	0	0	2	72	0	74
20672	0	0	71	2	0	73
20673	0	0	68	0	0	68
20674	0	68	2	0	0	70
20675	70	2	0	0	0	72
20676	70	0	0	0	0	70
20677	1	72	0	0	0	73
20678	0	73	0	0	0	73
20679	0	2	71	0	0	73
20680	0	0	70	0	0	70
20681	0	0	71	0	0	71
20682	0	0	2	67	0	69
20683	0	0	70	2	0	72
20684	0	0	1	70	0	71
20685	0	0	0	69	0	69
20686	0	0	66	2	0	68
20687	0	66	2	0	0	68
20688	0	2	0	69	0	71
20689	68	0	0	2	0	70
20690	2	0	0	68	0	70
20691	0	0	70	2	0	72
20692	0	68	2	0	0	70
20693	0	73	0	0	0	73
20694	0	2	0	68	0	70
20695	67	0	0	2	0	69
20696	67	0	0	0	0	67
20697	1	0	0	65	0	66
20698	0	67	0	2	0	69
20699	0	2	0	71	0	73
20700	0	0	0	72	0	72
20701	0	0	0	74	0	74
20702	75	0	0	1	0	76
20703	2	78	0	0	0	80
20704	78	2	0	0	0	80
20705	80	0	0	0	0	80
20706	81	0	0	0	0	81
20707	82	0	0	0	0	82
20708	3	0	0	77	0	80
20709	1	0	82	2	0	85
20710	1	80	1	0	0	82
20711	83	1	0	1	0	85
20712	87	0	0	0	0	87
20713	86	1	0	0	0	87
20714	3	0	81	0	0	84
20715	80	0	2	1	0	83
20716	86	0	0	0	0	86
20717	2	0	0	84	0	86
20718	1	0	79	2	0	82
20719	1	80	1	0	0	82
20720	0	2	0	82	0	84
20721	80	0	1	2	0	83
20722	2	1	0	80	0	83
20723	1	0	0	84	0	85
20724	85	1	0	2	0	88
20725	3	0	85	1	0	89
20726	87	0	1	1	0	89
20727	87	0	0	0	0	87
20728	84	0	1	0	0	85
20729	80	0	0	1	0	81
20730	2	0	79	0	0	81
20731	1	1	1	78	0	81
20732	2	0	81	1	0	84
20733	1	0	2	77	0	80
20734	1	0	80	2	0	83
20735	73	0	2	1	0	76
20736	2	75	1	1	0	79
20737	1	73	1	0	0	75
20738	2	1	0	78	0	81
20739	1	1	1	78	0	81
20740	1	78	0	1	0	80
20741	76	1	0	1	0	78
20742	85	0	0	1	0	86
20743	88	1	1	1	0	91
20744	92	0	0	1	0	93
20745	4	0	1	89	0	94
20746	2	0	1	93	0	96
20747	101	0	0	1	0	102
20748	3	0	1	97	0	101
20749	2	0	94	3	0	99
20750	2	0	95	0	0	97
20751	0	0	3	97	0	100
20752	0	0	97	3	0	100
20753	93	1	4	0	0	98
20754	2	0	0	96	0	98
20755	94	0	2	2	0	98
20756	4	0	92	0	0	96
20757	0	1	2	95	0	98
20758	2	1	94	2	0	99
20759	0	93	4	1	0	98
20760	92	2	0	1	0	95
20761	94	1	1	0	0	96
20762	3	93	0	0	0	96
20763	93	1	0	1	0	95
20764	3	0	1	90	0	94
20765	1	1	0	93	0	95
20766	90	0	1	2	0	93
20767	1	89	0	3	0	93
20768	1	89	1	1	0	92
20769	2	1	0	90	0	93
20770	84	2	1	1	0	88
20771	82	2	1	0	0	85
20772	80	0	0	3	0	83
20773	2	0	79	1	0	82
20774	2	1	78	0	0	81
20775	2	79	1	1	0	83
20776	80	1	1	0	0	82
20777	2	0	2	75	0	79
20778	76	1	0	1	0	78
20779	76	0	1	1	0	78
20780	1	0	0	78	0	79
20781	2	0	77	1	0	80
20782	79	0	1	1	0	81
20783	1	1	1	78	0	81
20784	1	0	79	1	0	81
20785	78	0	1	2	0	81
20786	77	0	1	1	0	79
20787	3	0	1	76	0	80
20788	1	1	74	2	0	78
20789	2	1	1	73	0	77
20790	0	73	0	3	0	76
20791	1	1	74	0	0	76
20792	1	73	2	1	0	77
20793	74	3	0	0	0	77
20794	75	0	2	0	0	77
20795	74	1	1	0	0	76
20796	73	2	0	0	0	75
20797	4	0	0	72	0	76
20798	71	0	0	2	0	73
20799	3	0	0	67	0	70
20800	67	0	0	2	0	69
20801	2	68	0	1	0	71
20802	0	1	0	63	0	64
20803	1	63	0	1	0	65
20804	62	1	1	0	0	64
20805	62	0	0	1	0	63
20806	1	61	1	0	0	63
20807	0	2	0	61	0	63
20808	1	0	63	1	0	65
20809	1	0	1	60	0	62
20810	0	1	61	1	0	63
20811	1	1	1	56	0	59
20812	0	55	0	2	0	57
20813	56	1	0	1	0	58
20814	58	0	0	0	0	58
20815	1	1	0	55	0	57
20816	60	1	0	2	0	63
20817	1	0	0	62	0	63
20818	1	0	0	61	0	62
20819	1	0	0	61	0	62
20820	61	0	0	2	0	63
20821	62	0	1	0	0	63
20822	63	0	1	0	0	64
20823	1	60	0	0	0	61
20824	58	1	0	0	0	59
20825	1	54	0	1	0	56
20826	56	1	0	0	0	57
20827	2	0	0	55	0	57
20828	0	0	0	57	0	57
20829	54	0	1	1	0	56
20830	57	0	0	0	0	57
20831	1	55	0	1	0	57
20832	53	1	0	0	0	54
20833	2	0	0	53	0	55
20834	1	0	0	54	0	55
20835	53	0	0	2	0	55
20836	1	0	51	0	0	52
20837	0	47	1	0	0	48
20838	0	2	0	43	0	45
20839	0	0	43	1	0	44
20840	0	5	1	38	0	44
20841	42	0	0	1	0	43
20842	2	34	0	1	0	37
20843	2	31	0	0	0	33
20844	1	29	0	0	0	30
20845	0	4	0	22	0	26
20846	23	1	1	1	0	26
20847	0	0	0	23	0	23
20848	24	0	0	0	0	24
20849	22	1	0	1	0	24
20850	1	0	0	22	0	23
20851	23	1	0	0	0	24
20852	1	0	0	22	0	23
20853	2	0	23	0	0	25
20854	23	1	0	1	0	25
20855	0	0	27	1	0	28
20856	23	0	2	0	0	25
20857	2	0	25	0	0	27
20858	1	0	2	24	0	27
20859	0	0	1	25	0	26
20860	24	0	0	3	0	27
20861	2	0	0	27	0	29
20862	27	0	0	2	0	29
20863	2	27	0	1	0	30
20864	29	2	0	0	0	31
20865	2	1	0	28	0	31
20866	1	0	0	30	0	31
20867	0	0	0	31	0	31
20868	0	0	0	31	0	31
20869	0	0	30	3	0	33
20870	0	0	32	1	0	33
20871	0	0	3	32	0	35
20872	0	0	33	2	0	35
20873	0	31	2	1	0	34
20874	0	2	1	32	0	35
20875	0	1	31	2	0	34
20876	0	0	32	1	0	33
20877	0	0	3	31	0	34
20878	1	0	1	32	0	34
20879	1	31	0	2	0	34
20880	0	2	0	31	0	33
20881	0	1	30	2	0	33
20882	30	0	2	1	0	33
20883	2	0	1	30	0	33
20884	31	0	0	2	0	33
20885	32	0	0	1	0	33
20886	33	0	0	0	0	33
20887	3	0	30	0	0	33
20888	0	0	31	0	0	31
20889	27	0	2	1	0	30
20890	2	0	31	0	0	33
20891	1	0	2	30	0	33
20892	0	0	1	31	0	32
20893	0	0	28	3	0	31
20894	0	28	1	1	0	30
20895	27	2	1	0	0	30
20896	2	29	0	0	0	31
20897	1	30	0	0	0	31
20898	31	3	0	0	0	34
20899	2	1	30	0	0	33
20900	1	0	32	0	0	33
20901	0	0	3	28	0	31
20902	29	0	1	2	0	32
20903	2	29	0	1	0	32
20904	30	2	0	0	0	32
20905	2	1	29	0	0	32
20906	1	28	2	0	0	31
20907	0	2	1	30	0	33
20908	0	1	28	2	0	31
20909	0	1	0	28	0	29
20910	0	0	1	25	0	26
20911	0	0	0	31	0	31
20912	0	0	0	31	0	31
20913	28	0	0	3	0	31
20914	30	0	0	1	0	31
20915	3	0	28	0	0	31
20916	28	0	3	0	0	31
20917	2	27	1	0	0	30
20918	28	1	1	0	0	30
20919	2	1	27	1	0	31
20920	1	0	2	27	0	30
20921	1	0	28	2	0	31
20922	0	0	31	2	0	33
20923	1	0	3	26	0	30
20924	0	1	1	28	0	30
20925	1	0	28	2	0	31
20926	0	28	2	2	0	32
20927	0	30	1	1	0	32
20928	0	3	0	28	0	31
20929	27	1	0	4	0	32
20930	2	28	1	1	0	32
20931	1	2	29	0	0	32
20932	0	1	29	1	0	31
20933	0	0	31	0	0	31
20934	0	0	3	26	0	29
20935	26	0	1	3	0	30
20936	2	27	1	1	0	31
20937	1	2	28	0	0	31
20938	0	28	2	1	0	31
20939	0	2	1	27	0	30
20940	0	1	26	2	0	29
20941	0	26	2	0	0	28
20942	0	2	1	26	0	29
20943	1	0	0	28	0	29
20944	0	0	28	3	0	31
20945	1	0	3	28	0	32
20946	1	27	0	2	0	30
20947	2	2	28	0	0	32
20948	28	1	3	0	0	32
20949	3	0	1	28	0	32
20950	0	0	1	30	0	31
20951	0	29	1	2	0	32
20952	27	2	0	2	0	31
20953	2	0	27	1	0	30
20954	23	0	3	1	0	27
20955	0	0	0	25	0	25
20956	0	26	0	0	0	26
20957	0	0	0	27	0	27
20958	1	0	0	26	0	27
20959	27	0	0	0	0	27
20960	26	0	1	0	0	27
20961	1	0	0	24	0	25
20962	0	1	24	0	0	25
20963	22	0	0	0	0	22
20964	0	23	1	0	0	24
20965	0	0	0	24	0	24
20966	0	0	1	23	0	24
20967	0	0	1	23	0	24
20968	0	0	23	1	0	24
20969	0	0	0	21	0	21
20970	0	19	1	0	0	20
20971	0	0	1	19	0	20
20972	0	20	0	0	0	20
20973	0	0	0	20	0	20
20974	1	0	19	0	0	20
20975	17	1	0	0	0	18
20976	0	0	1	20	0	21
20977	0	0	25	0	0	25
20978	0	23	1	0	0	24
20979	24	0	0	1	0	25
20980	0	0	24	0	0	24
20981	24	1	0	0	0	25
20982	0	0	1	25	0	26
20983	0	1	0	25	0	26
20984	0	25	0	0	0	25
20985	25	0	1	0	0	26
20986	26	1	0	0	0	27
20987	0	29	0	0	0	29
20988	0	0	0	30	0	30
20989	0	0	1	29	0	30
20990	0	0	0	29	0	29
20991	0	1	27	0	0	28
20992	27	0	1	0	0	28
20993	1	0	0	28	0	29
20994	0	0	0	30	0	30
20995	0	0	28	0	0	28
20996	0	1	28	0	0	29
20997	1	0	0	30	0	31
20998	0	0	30	0	0	30
20999	29	0	0	0	0	29
21000	0	0	0	27	0	27
21001	0	0	0	28	0	28
21002	0	0	30	0	0	30
21003	0	0	0	31	0	31
21004	0	0	32	0	0	32
21005	0	31	0	0	0	31
21006	30	0	0	0	0	30
21007	31	0	0	0	0	31
21008	0	31	0	0	0	31
21009	0	0	0	32	0	32
21010	0	0	33	0	0	33
21011	0	0	0	33	0	33
21012	33	0	0	0	0	33
21013	0	33	0	0	0	33
21014	33	0	0	0	0	33
21015	0	0	0	33	0	33
21016	30	0	0	0	0	30
21017	0	29	0	0	0	29
21018	30	0	0	0	0	30
21019	0	0	29	0	0	29
21020	0	32	0	0	0	32
21021	0	0	0	32	0	32
21022	32	0	0	0	0	32
21023	33	0	0	0	0	33
21024	0	0	0	33	0	33
21025	33	0	0	0	0	33
21026	32	0	0	0	0	32
21027	33	0	0	0	0	33
21028	0	0	0	33	0	33
21029	0	0	31	1	0	32
21030	0	0	29	0	0	29
21031	0	0	32	0	0	32
21032	31	0	0	0	0	31
21033	0	0	0	33	0	33
21034	0	36	0	0	0	36
21035	0	0	0	36	0	36
21036	0	36	0	0	0	36
21037	37	0	0	0	0	37
21038	0	0	0	38	0	38
21039	0	0	0	41	0	41
21040	41	0	0	1	0	42
21041	1	0	0	42	0	43
21042	0	0	0	44	0	44
21043	42	0	0	1	0	43
21044	1	0	42	0	0	43
21045	0	0	1	42	0	43
21046	0	0	42	1	0	43
21047	41	0	1	0	0	42
21048	1	0	0	41	0	42
21049	40	0	0	1	0	41
21050	1	0	0	43	0	44
21051	0	0	46	1	0	47
21052	1	0	1	46	0	48
21053	48	0	0	1	0	49
21054	1	53	0	0	0	54
21055	0	1	53	0	0	54
21056	48	0	1	0	0	49
21057	1	53	0	0	0	54
21058	0	54	0	0	0	54
21059	0	60	0	0	0	60
21060	0	1	0	67	0	68
21061	67	0	0	1	0	68
21062	66	0	0	0	0	66
21063	1	0	65	0	0	66
21064	69	0	1	0	0	70
21065	1	69	0	0	0	70
21066	0	1	0	70	0	71
21067	70	0	0	1	0	71
21068	72	0	0	0	0	72
21069	72	0	0	0	0	72
21070	69	0	0	0	0	69
21071	74	0	0	0	0	74
21072	2	0	0	72	0	74
21073	0	0	73	1	0	74
21074	0	0	1	74	0	75
21075	0	0	0	75	0	75
21076	73	0	0	1	0	74
21077	1	68	0	0	0	69
21078	67	1	0	0	0	68
21079	71	0	0	0	0	71
21080	75	0	0	0	0	75
21081	74	0	0	0	0	74
21082	2	0	72	0	0	74
21083	73	0	2	0	0	75
21084	74	0	0	0	0	74
21085	64	0	0	1	0	65
21086	75	0	0	0	0	75
21087	2	0	0	68	0	70
21088	0	0	70	2	0	72
21089	68	0	2	0	0	70
21090	2	68	0	0	0	70
21091	1	2	0	69	0	72
21092	0	69	0	2	0	71
21093	0	2	0	72	0	74
21094	71	0	0	2	0	73
21095	74	0	0	0	0	74
21096	73	0	0	0	0	73
21097	2	0	70	0	0	72
21098	70	0	2	0	0	72
21099	2	0	70	0	0	72
21100	0	0	70	0	0	70
21101	0	0	75	0	0	75
21102	1	0	2	67	0	70
21103	0	0	0	70	0	70
21104	0	0	0	71	0	71
21105	0	0	0	69	0	69
21106	0	0	0	69	0	69
21107	0	0	0	65	0	65
21108	0	68	0	2	0	70
21109	67	2	0	0	0	69
21110	1	72	0	0	0	73
21111	0	2	0	72	0	74
21112	0	0	0	73	0	73
21113	72	0	0	2	0	74
21114	2	72	0	0	0	74
21115	73	2	0	0	0	75
21116	2	0	0	73	0	75
21117	0	0	0	75	0	75
21118	0	0	0	75	0	75
21119	0	0	78	2	0	80
21120	0	0	2	76	0	78
21121	0	0	75	2	0	77
21122	0	0	77	0	0	77
21123	0	0	83	0	0	83
21124	0	0	2	86	0	88
21125	0	0	0	89	0	89
21126	0	0	0	90	0	90
21127	89	0	0	2	0	91
21128	2	0	0	93	0	95
21129	91	0	0	3	0	94
21130	3	92	0	0	0	95
21131	103	3	0	0	0	106
21132	109	0	0	0	0	109
21133	3	107	0	0	0	110
21134	106	3	0	0	0	109
21135	106	0	1	0	0	107
21136	107	0	0	0	0	107
21137	106	0	0	1	0	107
21138	4	0	99	0	0	103
21139	0	102	1	0	0	103
21140	1	2	0	99	0	102
21141	101	0	0	2	0	103
21142	2	0	100	0	0	102
21143	0	96	2	0	0	98
21144	0	2	0	97	0	99
21145	0	100	0	2	0	102
21146	0	2	0	101	0	103
21147	0	0	0	103	0	103
21148	0	0	101	2	0	103
21149	0	0	99	1	0	100
21150	94	0	2	0	0	96
21151	2	0	98	0	0	100
21152	0	0	95	0	0	95
21153	0	0	2	97	0	99
21154	0	0	0	91	0	91
21155	0	91	0	3	0	94
21156	0	101	0	1	0	102
21157	0	3	100	0	0	103
21158	0	2	2	101	0	105
21159	0	1	99	3	0	103
21160	0	0	90	1	0	91
21161	0	88	4	1	0	93
21162	0	3	2	88	0	93
21163	87	1	3	3	0	94
21164	3	1	0	90	0	94
21165	90	0	0	4	0	94
21166	91	0	0	1	0	92
21167	93	0	0	1	0	94
21168	5	0	87	0	0	92
21169	89	0	3	0	0	92
21170	4	0	1	91	0	96
21171	90	0	1	3	0	94
21172	93	0	0	1	0	94
21173	3	87	0	1	0	91
21174	90	3	0	0	0	93
21175	4	1	88	0	0	93
21176	88	1	3	0	0	92
21177	94	0	1	0	0	95
21178	3	87	1	0	0	91
21179	89	2	0	0	0	91
21180	3	1	0	87	0	91
21181	1	1	0	90	0	92
21182	1	88	0	3	0	92
21183	0	1	0	91	0	92
21184	0	1	0	92	0	93
21185	0	0	91	3	0	94
21186	0	0	91	2	0	93
21187	89	0	3	1	0	93
21188	91	0	1	1	0	93
21189	3	0	1	92	0	96
21190	2	0	93	2	0	97
21191	1	92	2	1	0	96
21192	1	2	1	95	0	99
21193	0	1	95	2	0	98
21194	95	1	2	1	0	99
21195	2	0	1	102	0	105
21196	1	104	1	2	0	108
21197	1	2	0	107	0	110
21198	0	1	0	111	0	112
21199	0	1	0	112	0	113
21200	107	0	0	4	0	111
21201	2	0	0	109	0	111
21202	109	0	0	3	0	112
21203	111	0	0	1	0	112
21204	3	0	105	1	0	109
21205	2	104	2	0	0	108
21206	1	2	1	104	0	108
21207	0	108	1	2	0	111
21208	109	3	0	1	0	113
21209	2	0	0	111	0	113
21210	1	1	107	2	0	111
21211	1	0	108	0	0	109
21212	0	0	113	1	0	114
21213	109	0	4	0	0	113
21214	2	109	2	0	0	113
21215	108	2	1	0	0	111
21216	3	109	0	0	0	112
21217	1	3	0	110	0	114
21218	2	1	0	110	0	113
21219	0	106	0	3	0	109
21220	0	2	103	2	0	107
21221	0	107	2	1	0	110
21222	104	2	1	0	0	107
21223	2	1	1	93	0	97
21224	1	1	91	2	0	95
21225	1	0	88	1	0	90
21226	0	0	3	93	0	96
21227	0	0	92	2	0	94
21228	0	0	88	1	0	89
21229	87	0	2	1	0	90
21230	1	87	2	0	0	90
21231	80	1	1	0	0	82
21232	2	1	77	0	0	80
21233	1	71	1	0	0	73
21234	1	73	1	0	0	75
21235	0	2	1	73	0	76
21236	0	2	0	78	0	80
21237	0	2	0	79	0	81
21238	0	0	78	5	0	83
21239	0	0	1	82	0	83
21240	0	0	2	81	0	83
21241	79	0	1	3	0	83
21242	1	78	0	4	0	83
21243	3	1	0	79	0	83
21244	80	2	0	1	0	83
21245	78	1	1	2	0	82
21246	3	1	0	79	0	83
21247	3	0	78	2	0	83
21248	1	1	1	79	0	82
21249	1	0	80	2	0	83
21250	77	0	2	4	0	83
21251	82	0	3	1	0	86
21252	4	0	2	84	0	90
21253	2	0	84	2	0	88
21254	2	88	2	1	0	93
21255	0	3	89	1	0	93
21256	1	1	2	81	0	85
21257	0	84	1	2	0	87
21258	81	1	0	3	0	85
21259	1	1	0	80	0	82
21260	1	82	0	1	0	84
21261	82	1	1	1	0	85
21262	1	2	0	81	0	84
21263	3	78	0	1	0	82
21264	0	1	0	82	0	83
21265	0	1	81	1	0	83
21266	79	0	3	1	0	83
21267	78	0	1	1	0	80
21268	3	0	74	0	0	77
21269	1	78	2	0	0	81
21270	76	1	1	0	0	78
21271	1	3	0	75	0	79
21272	2	0	0	77	0	79
21273	0	0	1	78	0	79
21274	1	2	0	77	0	80
21275	0	1	1	76	0	78
21276	73	1	1	3	0	78
21277	74	0	0	3	0	77
21278	2	0	0	76	0	78
21279	2	0	2	73	0	77
21280	0	1	73	3	0	77
21281	0	0	70	4	0	74
21282	69	0	2	0	0	71
21283	2	1	1	68	0	72
21284	2	0	68	3	0	73
21285	1	1	1	69	0	72
21286	71	0	1	2	0	74
21287	70	0	2	2	0	74
21288	2	0	1	68	0	71
21289	2	1	0	70	0	73
21290	67	0	1	3	0	71
21291	2	0	1	67	0	70
21292	2	67	0	2	0	71
21293	0	1	2	67	0	70
21294	0	1	1	65	0	67
21295	0	1	56	3	0	60
21296	2	0	54	1	0	57
21297	0	56	2	0	0	58
21298	49	2	1	1	0	53
21299	49	1	0	0	0	50
21300	51	0	0	0	0	51
21301	2	50	0	1	0	53
21302	1	48	1	1	0	51
21303	46	2	1	1	0	50
21304	1	50	1	0	0	52
21305	3	1	48	0	0	52
21306	1	50	2	0	0	53
21307	0	2	48	1	0	51
21308	42	1	1	1	0	45
21309	45	0	1	1	0	47
21310	2	46	0	0	0	48
21311	47	1	0	1	0	49
21312	48	1	0	0	0	49
21313	50	0	0	1	0	51
21314	3	0	0	46	0	49
21315	49	0	0	2	0	51
21316	2	0	44	2	0	48
21317	47	0	2	0	0	49
21318	2	0	2	48	0	52
21319	1	0	47	2	0	50
21320	1	0	48	1	0	50
21321	0	0	2	47	0	49
21322	0	0	2	49	0	51
21323	47	0	0	4	0	51
21324	3	0	0	48	0	51
21325	2	0	47	2	0	51
21326	0	0	2	47	0	49
21327	0	45	1	3	0	49
21328	48	2	0	1	0	51
21329	2	1	0	48	0	51
21330	1	1	43	2	0	47
21331	0	46	2	2	0	50
21332	45	2	1	1	0	49
21333	2	1	1	45	0	49
21334	1	0	44	2	0	47
21335	0	45	2	1	0	48
21336	40	2	0	0	0	42
21337	39	0	0	0	0	39
21338	40	0	0	0	0	40
21339	2	0	0	39	0	41
21340	0	0	0	41	0	41
21341	39	0	0	2	0	41
21342	2	38	0	0	0	40
21343	41	2	0	0	0	43
21344	2	0	0	41	0	43
21345	41	0	0	2	0	43
21346	2	0	0	39	0	41
21347	0	0	0	42	0	42
21348	0	0	0	42	0	42
21349	0	0	0	42	0	42
21350	0	0	35	2	0	37
21351	0	0	34	0	0	34
21352	29	0	1	0	0	30
21353	1	0	29	0	0	30
21354	0	0	25	0	0	25
21355	23	0	1	0	0	24
21356	24	0	0	0	0	24
21357	1	1	0	26	0	28
21358	26	0	0	1	0	27
21359	1	26	0	0	0	27
21360	27	1	0	0	0	28
21361	28	0	0	0	0	28
21362	29	0	0	0	0	29
21363	1	0	0	28	0	29
21364	0	28	0	1	0	29
21365	0	30	0	0	0	30
21366	29	1	0	0	0	30
21367	30	0	0	0	0	30
21368	1	0	0	29	0	30
21369	0	0	0	29	0	29
21370	0	29	0	1	0	30
21371	30	1	0	0	0	31
21372	1	0	28	0	0	29
21373	0	0	1	29	0	30
21374	0	0	0	30	0	30
21375	0	0	29	1	0	30
21376	0	0	1	30	0	31
21377	0	25	0	1	0	26
21378	0	1	0	30	0	31
21379	0	0	0	30	0	30
21380	0	30	0	1	0	31
21381	0	33	0	0	0	33
21382	0	1	0	32	0	33
21383	30	0	0	2	0	32
21384	1	0	0	31	0	32
21385	0	0	0	32	0	32
21386	0	29	0	1	0	30
21387	0	1	0	29	0	30
21388	0	0	0	30	0	30
21389	0	0	0	30	0	30
21390	31	0	0	1	0	32
21391	1	0	0	31	0	32
21392	0	0	0	30	0	30
21393	0	0	0	30	0	30
21394	0	0	28	1	0	29
21395	27	0	1	0	0	28
21396	1	28	0	0	0	29
21397	30	1	0	0	0	31
21398	1	0	0	31	0	32
21399	0	0	31	1	0	32
21400	31	0	1	0	0	32
21401	1	0	40	0	0	41
21402	0	0	1	43	0	44
21403	43	0	0	1	0	44
21404	41	0	0	1	0	42
21405	44	0	0	0	0	44
21406	1	0	0	44	0	45
21407	0	0	0	46	0	46
21408	0	0	0	46	0	46
21409	0	43	0	1	0	44
21410	0	42	0	0	0	42
21411	0	42	0	0	0	42
21412	0	42	0	0	0	42
21413	0	0	0	44	0	44
21414	0	0	0	45	0	45
21415	45	0	0	0	0	45
21416	44	0	0	0	0	44
21417	45	0	0	0	0	45
21418	0	0	0	44	0	44
21419	0	0	0	44	0	44
21420	43	0	0	0	0	43
21421	43	0	0	0	0	43
21422	0	0	44	0	0	44
21423	0	0	40	0	0	40
21424	0	0	41	0	0	41
21425	0	0	45	0	0	45
21426	0	0	0	46	0	46
21427	46	0	0	0	0	46
21428	0	45	0	0	0	45
21429	0	0	0	46	0	46
21430	0	0	45	0	0	45
21431	0	45	0	0	0	45
21432	0	0	0	48	0	48
21433	0	0	49	0	0	49
21434	0	0	0	51	0	51
21435	0	0	0	51	0	51
21436	53	0	0	0	0	53
21437	0	0	0	52	0	52
21438	0	0	52	0	0	52
21439	0	0	0	51	0	51
21440	0	55	0	0	0	55
21441	0	0	0	56	0	56
21442	0	0	0	60	0	60
21443	0	0	0	59	0	59
21444	60	0	0	1	0	61
21445	63	0	0	0	0	63
21446	67	0	0	0	0	67
21447	65	0	0	0	0	65
21448	0	0	67	0	0	67
21449	65	0	0	0	0	65
21450	67	0	0	0	0	67
21451	0	0	70	0	0	70
21452	0	0	74	0	0	74
21453	0	0	0	76	0	76
21454	0	75	0	0	0	75
21455	78	0	0	0	0	78
21456	81	0	0	0	0	81
21457	86	0	0	0	0	86
21458	0	0	0	87	0	87
21459	0	94	0	0	0	94
21460	99	0	0	0	0	99
21461	101	0	0	0	0	101
21462	0	0	0	102	0	102
21463	0	0	96	0	0	96
21464	101	0	0	1	0	102
21465	0	0	0	104	0	104
21466	104	0	0	0	0	104
21467	0	0	0	106	0	106
21468	1	0	107	0	0	108
21469	117	0	0	0	0	117
21470	0	0	0	118	0	118
21471	0	0	0	120	0	120
21472	1	0	0	120	0	121
21473	0	0	0	120	0	120
21474	121	0	0	0	0	121
21475	0	0	0	119	0	119
21476	0	118	0	0	0	118
21477	0	0	0	124	0	124
21478	0	124	1	2	0	127
21479	0	0	0	129	0	129
21480	0	0	0	131	0	131
21481	0	128	0	0	0	128
21482	0	0	0	132	0	132
21483	0	0	0	131	0	131
21484	129	0	0	0	0	129
21485	0	0	133	0	0	133
21486	0	0	0	143	0	143
21487	141	0	0	0	0	141
21488	142	0	0	0	0	142
21489	148	0	0	0	0	148
21490	0	0	144	0	0	144
21491	0	0	140	0	0	140
21492	0	0	0	152	0	152
21493	153	0	0	0	0	153
21494	0	0	148	0	0	148
21495	148	0	0	0	0	148
21496	0	154	0	0	0	154
21497	0	0	0	166	0	166
21498	0	0	0	169	0	169
21499	178	0	0	0	0	178
21500	0	0	0	181	0	181
21501	174	0	0	0	0	174
21502	181	0	0	0	0	181
21503	0	0	0	180	0	180
21504	0	0	0	182	0	182
21505	182	0	0	1	0	183
21506	0	0	193	0	0	193
21507	201	0	0	0	0	201
21508	0	0	211	0	0	211
21509	215	0	0	1	0	216
21510	238	0	0	1	0	239
21511	237	0	0	0	0	237
21512	232	0	0	1	0	233
21513	0	239	0	0	0	239
21514	245	0	0	0	0	245
21515	247	0	0	0	0	247
21516	0	260	0	0	0	260
21517	266	0	0	0	0	266
21518	0	0	259	0	0	259
21519	258	0	0	1	0	259
21520	1	0	262	0	0	263
21521	1	0	1	265	0	267
21522	0	0	0	269	0	269
21523	0	0	274	1	0	275
21524	0	0	0	272	0	272
21525	2	2	1	198	0	203
21526	279	0	1	1	0	281
21527	1	0	0	283	0	284
21528	0	0	0	288	0	288
21529	0	0	0	290	0	290
21530	0	282	0	2	0	284
21531	0	2	0	289	0	291
21532	289	0	0	2	0	291
21533	2	0	289	0	0	291
21534	1	0	2	290	0	293
21535	0	0	293	3	0	296
21536	292	0	3	1	0	296
21537	3	0	0	303	0	306
21538	0	0	393	3	0	396
21539	0	0	5	392	0	397
21540	0	0	1	396	0	397
21541	0	399	1	6	0	406
21542	0	4	3	405	0	412
21543	0	1	0	447	0	448
21544	0	1	437	10	0	448
21545	0	3	5	434	0	442
21546	0	0	1	446	0	447
21547	438	1	1	14	0	454
21548	438	0	3	5	0	446
21549	6	435	1	6	0	448
21550	441	6	1	4	0	452
21551	444	1	0	2	0	447
21552	11	458	0	2	0	471
21553	6	9	0	457	0	472
21554	468	2	0	6	0	476
21555	467	3	0	3	0	473
21556	456	3	0	3	0	462
21557	10	444	0	3	0	457
21558	5	8	449	1	0	463
21559	461	1	6	3	0	471
21560	467	1	1	1	0	470
21561	9	472	2	0	0	483
21562	467	7	3	1	0	478
21563	475	3	1	1	0	480
21564	12	1	0	465	0	478
21565	7	3	469	6	0	485
21566	6	3	6	473	0	488
21567	5	1	1	479	0	486
21568	5	0	1	478	0	484
21569	3	0	462	10	0	475
21570	2	0	6	459	0	467
21571	2	1	2	474	0	479
21572	2	0	1	478	0	481
21573	2	0	3	472	0	477
21574	2	1	1	474	0	478
21575	1	464	1	11	0	477
21576	3	6	0	475	0	484
21577	3	1	1	481	0	486
21578	1	1	468	14	0	484
21579	1	2	5	497	0	505
21580	2	1	2	501	0	506
21581	0	2	1	526	0	529
21582	0	0	5	528	0	533
21583	526	0	4	18	0	548
21584	9	0	1	537	0	547
21585	3	2	0	539	0	544
21586	3	1	507	19	0	530
21587	4	497	9	12	0	522
21588	1	520	3	11	0	535
21589	506	11	3	6	0	526
21590	9	510	5	8	0	532
21591	3	11	0	509	0	523
21592	499	7	2	11	0	519
21593	15	5	502	4	0	526
21594	4	7	9	505	0	525
21595	4	501	3	15	0	523
21596	6	11	2	503	0	522
21597	2	499	2	13	0	516
21598	3	10	1	503	0	517
21599	490	6	1	13	0	510
21600	13	2	495	9	0	519
21601	5	8	11	488	0	512
21602	1	498	4	17	0	520
21603	496	11	4	7	0	518
21604	14	6	490	4	0	514
21605	7	2	10	489	0	508
21606	4	7	472	12	0	495
21607	9	2	11	462	0	484
21608	5	2	455	14	0	476
21609	3	3	11	455	0	472
21610	0	0	12	444	0	456
21611	430	2	2	22	0	456
21612	439	1	6	9	0	455
21613	17	1	1	427	0	446
21614	5	412	4	17	0	438
21615	6	10	1	427	0	444
21616	9	4	0	419	0	432
21617	399	1	3	18	0	421
21618	13	403	1	9	0	426
21619	401	12	0	11	0	424
21620	407	7	1	6	0	421
21621	15	389	2	6	0	412
21622	5	408	1	9	0	423
21623	391	13	3	4	0	411
21624	15	6	384	7	0	412
21625	389	2	8	8	0	407
21626	394	6	4	6	0	410
21627	16	384	1	9	0	410
21628	9	10	4	365	0	388
21629	9	378	3	16	0	406
21630	381	11	2	7	0	401
21631	387	9	2	7	0	405
21632	14	6	2	377	0	399
21633	6	13	1	377	0	397
21634	367	3	0	17	0	387
21635	15	372	1	4	0	392
21636	10	361	2	10	0	383
21637	8	353	0	10	0	371
21638	2	246	2	5	0	255
21639	3	250	1	7	0	261
21640	6	10	2	242	0	260
21641	1	5	232	10	0	248
21642	2	238	5	5	0	250
21643	196	7	3	2	0	208
21644	7	3	0	200	0	210
21645	197	2	2	5	0	206
21646	7	194	1	4	0	206
21647	197	4	3	2	0	206
21648	6	196	0	4	0	206
21649	4	6	3	190	0	203
21650	193	3	1	7	0	204
21651	194	0	4	2	0	200
21652	6	1	1	196	0	204
21653	1	0	2	200	0	203
21654	3	188	1	8	0	200
21655	3	4	1	197	0	205
21656	2	3	0	198	0	203
21657	2	4	0	195	0	201
21658	2	187	0	9	0	198
21659	176	6	0	6	0	188
21660	6	177	0	4	0	187
21661	166	7	1	3	0	177
21662	7	166	0	3	0	176
21663	6	4	163	1	0	174
21664	2	5	3	162	0	172
21665	4	3	161	4	0	172
21666	4	3	162	3	0	172
21667	2	3	9	160	0	174
21668	4	2	161	5	0	172
21669	3	1	5	162	0	171
21670	3	2	3	165	0	173
21671	3	0	2	165	0	170
21672	159	3	1	7	0	170
21673	6	1	1	162	0	170
21674	4	3	0	162	0	169
21675	154	1	0	11	0	166
21676	7	155	0	5	0	167
21677	6	146	0	3	0	155
21678	1	154	0	4	0	159
21679	3	10	0	113	0	126
21680	1	2	118	3	0	124
21681	94	0	1	2	0	97
21682	2	93	1	0	0	96
21683	78	2	1	0	0	81
21684	81	0	0	1	0	82
21685	83	0	1	0	0	84
21686	1	0	83	0	0	84
21687	0	1	1	84	0	86
21688	1	0	1	85	0	87
21689	0	0	1	85	0	86
21690	1	0	0	85	0	86
21691	1	84	0	2	0	87
21692	83	2	0	0	0	85
21693	1	0	78	1	0	80
21694	76	1	1	1	0	79
21695	3	0	0	75	0	78
21696	0	75	0	1	0	76
21697	0	75	0	1	0	76
21698	1	3	0	69	0	73
21699	1	71	0	2	0	74
21700	59	1	1	0	0	61
21701	1	0	59	0	0	60
21702	0	1	0	55	0	56
21703	1	0	0	55	0	56
21704	1	0	0	55	0	56
21705	1	0	0	54	0	55
21706	55	0	1	0	0	56
21707	1	6	0	53	0	60
21708	76	0	0	1	0	77
21709	0	0	0	77	0	77
21710	0	0	0	78	0	78
21711	0	81	0	0	0	81
21712	88	0	0	0	0	88
21713	86	0	1	0	0	87
21714	0	89	0	0	0	89
21715	0	0	0	83	0	83
21716	0	85	0	0	0	85
21717	85	0	0	0	0	85
21718	0	0	84	1	0	85
21719	0	1	82	0	0	83
21720	82	0	0	0	0	82
21721	0	81	1	0	0	82
21722	0	0	0	82	0	82
21723	0	0	0	81	0	81
21724	0	0	81	1	0	82
21725	0	0	0	81	0	81
21726	1	0	0	81	0	82
21727	0	79	0	0	0	79
21728	1	0	0	78	0	79
21729	0	0	0	77	0	77
21730	75	0	0	1	0	76
21731	0	76	0	1	0	77
21732	0	77	0	1	0	78
21733	0	0	0	77	0	77
21734	1	0	0	76	0	77
21735	0	1	0	76	0	77
21736	1	73	0	1	0	75
21737	1	0	0	75	0	76
21738	0	2	0	72	0	74
21739	0	1	0	75	0	76
21740	0	2	0	74	0	76
21741	1	74	0	1	0	76
21742	0	79	1	0	0	80
21743	77	0	1	0	0	78
21744	77	1	0	0	0	78
21745	2	1	0	76	0	79
21746	1	0	82	1	0	84
21747	1	0	0	81	0	82
21748	0	0	2	81	0	83
21749	81	0	0	2	0	83
21750	0	89	0	2	0	91
21751	0	1	0	91	0	92
21752	1	0	0	89	0	90
21753	0	2	86	1	0	89
21754	2	0	88	0	0	90
21755	1	1	1	87	0	90
21756	1	1	0	86	0	88
21757	0	87	0	2	0	89
21758	0	90	0	1	0	91
21759	86	1	0	1	0	88
21760	0	1	0	89	0	90
21761	0	1	89	1	0	91
21762	1	89	0	0	0	90
21763	0	0	1	90	0	91
21764	89	0	0	2	0	91
21765	0	0	0	87	0	87
21766	85	1	0	1	0	87
21767	1	84	0	1	0	86
21768	83	0	0	0	0	83
21769	0	0	0	84	0	84
21770	0	0	88	0	0	88
21771	1	0	0	84	0	85
21772	0	87	0	1	0	88
21773	2	0	0	87	0	89
21774	0	91	0	0	0	91
21775	0	0	0	89	0	89
21776	0	0	86	1	0	87
21777	0	1	83	0	0	84
21778	0	0	86	0	0	86
21779	83	0	0	1	0	84
21780	0	85	0	1	0	86
21781	0	86	0	0	0	86
21782	84	1	0	0	0	85
21783	85	0	0	0	0	85
21784	1	0	0	84	0	85
21785	0	0	84	0	0	84
21786	0	1	81	0	0	82
21787	0	0	0	81	0	81
21788	83	0	0	0	0	83
21789	0	81	0	2	0	83
21790	2	0	0	84	0	86
21791	84	2	0	0	0	86
21792	86	0	0	0	0	86
21793	0	0	79	2	0	81
21794	81	0	2	0	0	83
21795	0	0	83	1	0	84
21796	0	2	85	0	0	87
21797	0	0	0	86	0	86
21798	0	2	0	84	0	86
21799	0	0	0	88	0	88
21800	0	0	89	0	0	89
21801	85	0	2	0	0	87
21802	0	0	2	85	0	87
21803	87	0	0	0	0	87
21804	84	2	0	0	0	86
21805	0	86	0	0	0	86
21806	1	84	0	0	0	85
21807	2	79	0	0	0	81
21808	1	1	0	64	0	66
21809	0	0	67	0	0	67
21810	0	0	1	62	0	63
21811	0	61	1	1	0	63
21812	1	61	0	0	0	62
21813	0	1	0	61	0	62
21814	63	0	0	1	0	64
21815	1	63	0	0	0	64
21816	1	63	0	0	0	64
21817	67	0	1	0	0	68
21818	1	0	0	67	0	68
21819	0	0	1	66	0	67
21820	0	0	1	67	0	68
21821	66	0	0	1	0	67
21822	65	0	0	1	0	66
21823	0	0	0	66	0	66
21824	1	0	66	0	0	67
21825	66	0	0	0	0	66
21826	0	0	0	66	0	66
21827	0	0	64	0	0	64
21828	1	0	64	0	0	65
21829	0	1	0	68	0	69
21830	1	1	67	1	0	70
21831	0	2	1	75	0	78
21832	0	0	1	77	0	78
21833	1	0	1	80	0	82
21834	79	1	0	1	0	81
21835	1	1	0	80	0	82
21836	1	1	0	80	0	82
21837	0	0	1	81	0	82
21838	1	0	2	79	0	82
21839	0	1	79	2	0	82
21840	0	77	1	1	0	79
21841	2	1	0	77	0	80
21842	0	1	1	76	0	78
21843	1	76	0	2	0	79
21844	1	76	0	2	0	79
21845	78	1	0	0	0	79
21846	3	69	0	1	0	73
21847	0	2	1	71	0	74
21848	0	1	73	1	0	75
21849	70	1	1	1	0	73
21850	2	0	64	2	0	68
21851	64	1	3	0	0	68
21852	64	0	1	2	0	67
21853	2	1	65	1	0	69
21854	1	1	2	59	0	63
21855	0	61	1	2	0	64
21856	2	1	0	67	0	70
21857	67	1	1	2	0	71
21858	71	1	0	0	0	72
21859	2	69	0	2	0	73
21860	69	1	0	3	0	73
21861	1	0	0	68	0	69
21862	66	0	1	3	0	70
21863	68	0	1	0	0	69
21864	2	0	0	65	0	67
21865	65	0	0	2	0	67
21866	62	0	1	0	0	63
21867	2	1	64	0	0	67
21868	63	1	1	1	0	66
21869	1	1	62	0	0	64
21870	0	0	59	0	0	59
21871	0	60	1	1	0	62
21872	0	1	1	60	0	62
21873	0	0	60	2	0	62
21874	0	0	63	1	0	64
21875	65	0	1	1	0	67
21876	2	0	0	65	0	67
21877	0	0	0	68	0	68
21878	0	0	0	69	0	69
21879	0	0	0	69	0	69
21880	0	0	0	69	0	69
21881	0	0	67	1	0	68
21882	0	0	69	0	0	69
21883	0	0	1	68	0	69
21884	68	0	0	1	0	69
21885	1	68	0	0	0	69
21886	0	1	0	67	0	68
21887	67	0	0	1	0	68
21888	1	67	0	0	0	68
21889	0	1	0	66	0	67
21890	0	0	0	65	0	65
21891	0	0	0	65	0	65
21892	64	0	0	1	0	65
21893	1	0	63	0	0	64
21894	65	0	1	0	0	66
21895	1	0	0	64	0	65
21896	0	0	0	60	0	60
21897	0	63	0	1	0	64
21898	0	1	62	0	0	63
21899	63	0	1	0	0	64
21900	63	0	0	0	0	63
21901	1	0	60	0	0	61
21902	60	0	1	0	0	61
21903	1	60	0	0	0	61
21904	0	65	0	0	0	65
21905	0	65	0	0	0	65
21906	63	1	1	0	0	65
21907	1	0	63	0	0	64
21908	0	2	1	58	0	61
21909	0	59	0	1	0	60
21910	0	66	0	0	0	66
21911	0	66	0	0	0	66
21912	1	1	0	54	0	56
21913	59	0	0	1	0	60
21914	1	59	0	0	0	60
21915	0	1	0	59	0	60
21916	0	0	0	60	0	60
21917	55	0	0	1	0	56
21918	1	0	0	54	0	55
21919	0	0	0	56	0	56
21920	0	0	55	1	0	56
21921	0	0	1	53	0	54
21922	0	0	0	57	0	57
21923	56	0	0	1	0	57
21924	57	0	0	0	0	57
21925	1	0	0	56	0	57
21926	56	0	0	1	0	57
21927	55	0	0	0	0	55
21928	1	54	0	0	0	55
21929	0	0	51	0	0	51
21930	0	53	0	0	0	53
21931	1	1	2	41	0	45
21932	40	0	0	0	0	40
21933	0	40	0	0	0	40
21934	0	0	0	40	0	40
21935	40	0	0	0	0	40
21936	40	0	0	0	0	40
21937	0	0	0	40	0	40
21938	0	0	41	0	0	41
21939	0	0	0	40	0	40
21940	0	0	0	44	0	44
21941	0	0	44	0	0	44
21942	0	0	0	45	0	45
21943	0	0	0	44	0	44
21944	45	0	0	0	0	45
21945	0	0	0	44	0	44
21946	0	0	0	44	0	44
21947	43	0	0	0	0	43
21948	43	0	0	0	0	43
21949	43	0	0	0	0	43
21950	0	0	44	0	0	44
21951	0	0	0	44	0	44
21952	0	43	0	0	0	43
21953	0	0	0	45	0	45
21954	0	0	44	0	0	44
21955	0	0	0	42	0	42
21956	0	0	43	0	0	43
21957	40	0	1	0	0	41
21958	41	0	0	0	0	41
21959	0	0	0	43	0	43
21960	0	0	0	43	0	43
21961	0	0	0	44	0	44
21962	0	46	0	0	0	46
21963	46	0	0	0	0	46
21964	47	0	0	0	0	47
21965	0	0	0	47	0	47
21966	0	0	0	47	0	47
21967	0	0	0	47	0	47
21968	0	0	0	46	0	46
21969	0	0	46	0	0	46
21970	0	0	0	47	0	47
21971	43	0	0	0	0	43
21972	43	0	0	0	0	43
21973	0	0	0	41	0	41
21974	0	0	40	0	0	40
21975	37	0	0	0	0	37
21976	0	0	0	40	0	40
21977	0	42	0	0	0	42
21978	0	45	0	0	0	45
21979	52	0	0	0	0	52
21980	0	0	0	57	0	57
21981	0	0	0	61	0	61
21982	0	0	0	63	0	63
21983	0	0	0	64	0	64
21984	0	0	0	64	0	64
21985	0	0	62	0	0	62
21986	0	0	62	0	0	62
21987	0	0	63	0	0	63
21988	0	0	0	63	0	63
21989	0	0	66	0	0	66
21990	0	0	0	66	0	66
21991	0	0	0	66	0	66
21992	0	0	0	66	0	66
21993	66	0	0	0	0	66
21994	0	1	0	65	0	66
21995	0	0	0	66	0	66
21996	66	0	0	0	0	66
21997	0	66	0	0	0	66
21998	0	63	0	1	0	64
21999	64	1	1	1	0	67
22000	0	68	0	1	0	69
22001	68	0	1	0	0	69
22002	69	1	0	1	0	71
22003	71	0	0	0	0	71
22004	67	0	0	1	0	68
22005	67	0	0	1	0	68
22006	1	68	0	1	0	70
22007	69	1	0	1	0	71
22008	70	1	0	0	0	71
22009	2	75	0	1	0	78
22010	78	0	0	2	0	80
22011	80	1	0	1	0	82
22012	89	0	1	0	0	90
22013	96	0	1	1	0	98
22014	3	0	103	1	0	107
22015	1	0	4	106	0	111
22016	1	0	2	109	0	112
22017	1	0	107	7	0	115
22018	0	1	106	4	0	111
22019	107	0	6	0	0	113
22020	5	0	2	112	0	119
22021	2	0	110	6	0	118
22022	1	1	113	2	0	117
22023	111	2	6	0	0	119
22024	114	1	2	0	0	117
22025	116	0	0	0	0	116
22026	6	1	111	1	0	119
22027	3	0	4	112	0	119
22028	1	0	112	5	0	118
22029	111	0	4	3	0	118
22030	5	0	114	0	0	119
22031	4	0	4	112	0	120
22032	2	1	3	117	0	123
22033	1	113	1	7	0	122
22034	112	4	0	4	0	120
22035	4	3	111	2	0	120
22036	114	0	5	1	0	120
22037	5	0	116	1	0	122
22038	6	0	4	112	0	122
22039	1	0	2	118	0	121
22040	0	0	2	117	0	119
22041	108	0	1	8	0	117
22042	5	1	0	110	0	116
22043	4	1	1	109	0	115
22044	1	106	1	7	0	115
22045	1	4	1	110	0	116
22046	107	3	0	6	0	116
22047	6	0	108	3	0	117
22048	5	0	6	106	0	117
22049	2	0	109	5	0	116
22050	2	104	4	5	0	115
22051	1	5	107	1	0	114
22052	102	4	4	0	0	110
22053	109	0	3	1	0	113
22054	7	0	1	105	0	113
22055	108	0	1	5	0	114
22056	104	0	3	3	0	110
22057	7	0	1	103	0	111
22058	5	0	0	108	0	113
22059	1	1	99	8	0	109
22060	2	98	6	3	0	109
22061	95	4	2	1	0	102
22062	6	97	1	1	0	105
22063	5	5	1	94	0	105
22064	1	2	1	99	0	103
22065	1	0	1	100	0	102
22066	0	0	1	102	0	103
22067	1	0	94	7	0	102
22068	93	0	4	4	0	101
22069	97	1	5	0	0	103
22070	8	1	1	94	0	104
22071	95	0	1	6	0	102
22072	6	1	0	97	0	104
22073	4	0	93	6	0	103
22074	1	0	5	97	0	103
22075	3	90	4	4	0	101
22076	0	4	1	93	0	98
22077	0	89	1	6	0	96
22078	1	5	0	86	0	92
22079	0	81	0	6	0	87
22080	77	4	0	2	0	83
22081	6	4	71	1	0	82
22082	4	68	4	3	0	79
22083	0	70	4	1	0	75
22084	0	7	0	69	0	76
22085	1	3	1	72	0	77
22086	1	0	2	74	0	77
22087	2	0	0	74	0	76
22088	0	65	0	8	0	73
22089	1	5	0	69	0	75
22090	2	2	1	69	0	74
22091	66	0	0	8	0	74
22092	5	0	1	69	0	75
22093	3	0	64	6	0	73
22094	1	2	64	3	0	70
22095	63	0	7	1	0	71
22096	4	64	2	1	0	71
22097	2	63	0	1	0	66
22098	0	7	1	65	0	73
22099	1	3	0	68	0	72
22100	1	0	63	7	0	71
22101	61	0	5	2	0	68
22102	65	1	2	1	0	69
22103	6	0	67	2	0	75
22104	2	0	70	3	0	75
22105	68	0	6	2	0	76
22106	73	0	3	2	0	78
22107	77	0	1	0	0	78
22108	77	0	0	1	0	78
22109	6	64	0	2	0	72
22110	56	3	1	1	0	61
22111	4	3	50	2	0	59
22112	2	0	45	1	0	48
22113	0	0	46	0	0	46
22114	0	0	4	28	0	32
22115	27	0	2	1	0	30
22116	26	0	0	1	0	27
22117	1	0	0	27	0	28
22118	1	0	0	25	0	26
22119	0	0	0	28	0	28
22120	0	26	0	0	0	26
22121	26	0	0	1	0	27
22122	27	1	0	0	0	28
22123	28	0	0	0	0	28
22124	27	0	0	0	0	27
22125	26	0	0	1	0	27
22126	1	0	0	26	0	27
22127	1	26	0	0	0	27
22128	0	0	0	26	0	26
22129	0	1	0	24	0	25
22130	25	0	0	1	0	26
22131	0	0	24	1	0	25
22132	1	0	28	0	0	29
22133	0	0	27	0	0	27
22134	26	0	0	0	0	26
22135	27	0	0	0	0	27
22136	0	0	0	28	0	28
22137	0	0	0	28	0	28
22138	0	0	0	28	0	28
22139	0	0	28	0	0	28
22140	0	0	0	28	0	28
22141	0	0	30	0	0	30
22142	0	0	0	31	0	31
22143	0	0	0	31	0	31
22144	0	0	0	32	0	32
22145	32	0	0	0	0	32
22146	33	0	0	0	0	33
22147	0	0	35	0	0	35
22148	35	0	0	0	0	35
22149	34	0	0	0	0	34
22150	0	0	0	34	0	34
22151	36	0	0	0	0	36
22152	0	0	0	37	0	37
22153	0	0	0	37	0	37
22154	0	0	36	0	0	36
22155	36	0	0	0	0	36
22156	0	0	0	36	0	36
22157	0	0	38	0	0	38
22158	0	0	40	0	0	40
22159	0	0	0	41	0	41
22160	0	0	0	41	0	41
22161	42	0	0	0	0	42
22162	0	0	0	47	0	47
22163	0	0	0	47	0	47
22164	0	0	0	48	0	48
22165	1	0	0	46	0	47
22166	51	0	0	0	0	51
22167	51	0	0	1	0	52
22168	50	0	0	1	0	51
22169	55	0	0	0	0	55
22170	0	1	0	58	0	59
22171	58	0	0	0	0	58
22172	0	0	0	61	0	61
22173	61	0	0	0	0	61
22174	0	0	0	60	0	60
22175	0	0	0	61	0	61
22176	0	64	0	0	0	64
22177	0	0	0	64	0	64
22178	63	0	0	0	0	63
22179	62	0	0	0	0	62
22180	0	0	65	0	0	65
22181	0	61	1	1	0	63
22182	64	0	0	0	0	64
22183	1	64	0	0	0	65
22184	66	0	0	0	0	66
22185	1	73	0	0	0	74
22186	0	0	73	1	0	74
22187	1	67	1	0	0	69
22188	0	72	0	1	0	73
22189	2	0	0	73	0	75
22190	73	0	0	1	0	74
22191	0	0	0	74	0	74
22192	1	1	0	72	0	74
22193	73	0	0	1	0	74
22194	77	0	0	0	0	77
22195	1	0	0	75	0	76
22196	0	0	1	74	0	75
22197	0	1	0	73	0	74
22198	73	0	0	0	0	73
22199	0	1	77	0	0	78
22200	1	0	0	78	0	79
22201	0	1	82	0	0	83
22202	0	82	2	0	0	84
22203	0	1	75	0	0	76
22204	0	1	0	73	0	74
22205	0	0	73	1	0	74
22206	72	0	0	0	0	72
22207	1	0	0	72	0	73
22208	1	76	0	1	0	78
22209	1	0	0	75	0	76
22210	2	75	0	0	0	77
22211	0	75	0	3	0	78
22212	0	79	0	2	0	81
22213	0	0	0	78	0	78
22214	1	77	0	1	0	79
22215	78	0	1	0	0	79
22216	1	0	73	1	0	75
22217	0	0	77	0	0	77
22218	0	2	74	0	0	76
22219	1	0	1	75	0	77
22220	0	0	0	76	0	76
22221	1	0	1	73	0	75
22222	0	1	0	73	0	74
22223	1	0	1	74	0	76
22224	0	78	0	0	0	78
22225	0	1	73	1	0	75
22226	0	1	77	1	0	79
22227	1	78	0	0	0	79
22228	0	1	0	80	0	81
22229	0	0	0	80	0	80
22230	1	1	0	76	0	78
22231	82	0	0	0	0	82
22232	0	0	77	1	0	78
22233	77	0	1	1	0	79
22234	80	0	1	1	0	82
22235	1	80	0	1	0	82
22236	0	80	1	1	0	82
22237	82	0	0	3	0	85
22238	0	0	1	85	0	86
22239	0	0	0	87	0	87
22240	0	1	90	0	0	91
22241	0	0	85	1	0	86
22242	0	0	2	88	0	90
22243	92	1	0	0	0	93
22244	0	0	102	2	0	104
22245	100	1	0	1	0	102
22246	0	0	0	109	0	109
22247	1	1	0	105	0	107
22248	0	1	1	111	0	113
22249	1	1	110	1	0	113
22250	1	109	1	1	0	112
22251	0	116	1	0	0	117
22252	112	2	0	1	0	115
22253	116	0	1	0	0	117
22254	1	0	1	117	0	119
22255	115	0	1	2	0	118
22256	1	0	118	1	0	120
22257	0	0	110	1	0	111
22258	0	0	1	116	0	117
22259	113	0	0	3	0	116
22260	1	0	1	113	0	115
22261	1	1	0	114	0	116
22262	109	0	1	3	0	113
22263	110	0	1	1	0	112
22264	1	115	0	1	0	117
22265	117	1	0	1	0	119
22266	1	0	0	117	0	118
22267	0	117	0	1	0	118
22268	115	1	0	1	0	117
22269	1	113	1	0	0	115
22270	1	1	0	110	0	112
22271	111	0	0	1	0	112
22272	1	0	109	0	0	110
22273	0	1	107	0	0	108
22274	0	0	1	109	0	110
22275	0	0	0	111	0	111
22276	0	0	0	108	0	108
22277	0	111	0	1	0	112
22278	112	1	0	0	0	113
22279	112	0	0	0	0	112
22280	110	0	0	1	0	111
22281	1	120	0	0	0	121
22282	0	1	0	128	0	129
22283	0	0	0	126	0	126
22284	0	0	0	127	0	127
22285	115	0	0	1	0	116
22286	1	120	0	0	0	121
22287	0	1	0	120	0	121
22288	0	0	0	120	0	120
22289	0	0	119	1	0	120
22290	0	121	1	0	0	122
22291	1	1	0	120	0	122
22292	0	0	0	122	0	122
22293	0	0	0	122	0	122
22294	117	0	0	2	0	119
22295	1	116	0	1	0	118
22296	119	1	0	0	0	120
22297	1	0	0	119	0	120
22298	119	0	0	1	0	120
22299	1	0	115	0	0	116
22300	113	0	1	0	0	114
22301	108	0	0	0	0	108
22302	1	0	109	0	0	110
22303	0	0	1	110	0	111
22304	0	0	0	111	0	111
22305	112	0	0	1	0	113
22306	0	0	0	112	0	112
22307	0	0	0	109	0	109
22308	0	0	0	109	0	109
22309	0	0	108	1	0	109
22310	105	0	1	0	0	106
22311	1	109	0	0	0	110
22312	0	1	0	106	0	107
22313	0	107	0	1	0	108
22314	0	112	0	0	0	112
22315	0	1	0	113	0	114
22316	0	0	112	1	0	113
22317	0	0	114	0	0	114
22318	1	0	1	113	0	115
22319	0	0	115	1	0	116
22320	117	0	1	0	0	118
22321	1	0	0	117	0	118
22322	0	0	0	121	0	121
22323	0	122	0	1	0	123
22324	0	1	0	118	0	119
22325	0	0	0	117	0	117
22326	0	116	0	1	0	117
22327	0	1	0	116	0	117
22328	0	0	0	116	0	116
22329	0	117	0	1	0	118
22330	118	1	0	0	0	119
22331	1	0	114	0	0	115
22332	0	0	114	0	0	114
22333	0	1	3	112	0	116
22334	0	0	0	116	0	116
22335	0	0	114	1	0	115
22336	0	0	115	0	0	115
22337	106	0	0	0	0	106
22338	1	111	0	0	0	112
22339	108	1	0	0	0	109
22340	1	0	111	0	0	112
22341	0	110	1	0	0	111
22342	0	1	0	109	0	110
22343	0	0	107	1	0	108
22344	0	0	97	1	0	98
22345	1	0	1	101	0	103
22346	0	0	99	1	0	100
22347	1	98	0	0	0	99
22348	0	1	0	94	0	95
22349	0	0	94	1	0	95
22350	0	93	0	1	0	94
22351	94	0	1	1	0	96
22352	0	0	92	0	0	92
22353	0	93	0	1	0	94
22354	2	0	0	91	0	93
22355	0	0	1	92	0	93
22356	92	1	0	0	0	93
22357	0	1	0	91	0	92
22358	1	0	0	89	0	90
22359	88	0	0	1	0	89
22360	1	0	0	89	0	90
22361	0	0	87	1	0	88
22362	2	0	0	86	0	88
22363	1	0	86	1	0	88
22364	0	0	82	0	0	82
22365	0	0	76	1	0	77
22366	0	0	1	78	0	79
22367	1	0	1	77	0	79
22368	77	0	1	1	0	79
22369	0	0	0	75	0	75
22370	0	81	0	2	0	83
22371	1	0	1	84	0	86
22372	1	0	0	87	0	88
22373	0	88	0	0	0	88
22374	87	0	0	1	0	88
22375	80	1	0	1	0	82
22376	0	83	0	0	0	83
22377	1	81	0	1	0	83
22378	1	5	1	78	0	85
22379	81	1	1	0	0	83
22380	0	1	78	0	0	79
22381	0	0	71	1	0	72
22382	69	0	0	0	0	69
22383	0	67	1	0	0	68
22384	0	1	1	69	0	71
22385	1	0	0	66	0	67
22386	0	1	0	67	0	68
22387	1	0	0	70	0	71
22388	0	67	0	2	0	69
22389	0	0	0	68	0	68
22390	67	0	0	1	0	68
22391	0	1	0	71	0	72
22392	0	0	0	70	0	70
22393	71	0	0	1	0	72
22394	69	0	1	1	0	71
22395	70	0	0	1	0	71
22396	71	0	1	0	0	72
22397	1	0	0	71	0	72
22398	72	0	1	1	0	74
22399	2	1	0	71	0	74
22400	71	0	0	2	0	73
22401	71	1	0	0	0	72
22402	0	1	0	73	0	74
22403	0	0	72	2	0	74
22404	74	1	0	1	0	76
22405	75	0	0	1	0	76
22406	78	0	1	1	0	80
22407	77	1	0	1	0	79
22408	2	1	0	77	0	80
22409	1	0	83	2	0	86
22410	2	0	82	0	0	84
22411	77	0	1	2	0	80
22412	78	0	3	0	0	81
22413	1	78	2	0	0	81
22414	1	76	0	0	0	77
22415	75	0	0	3	0	78
22416	0	1	0	77	0	78
22417	1	1	0	81	0	83
22418	81	0	0	2	0	83
22419	0	82	1	1	0	84
22420	81	0	0	3	0	84
22421	1	0	82	1	0	84
22422	81	2	0	0	0	83
22423	2	0	0	80	0	82
22424	2	0	82	0	0	84
22425	1	83	0	1	0	85
22426	1	1	0	86	0	88
22427	1	0	91	1	0	93
22428	1	1	0	91	0	93
22429	95	0	1	1	0	97
22430	0	0	95	1	0	96
22431	95	0	0	1	0	96
22432	2	97	0	0	0	99
22433	0	0	1	99	0	100
22434	1	0	101	1	0	103
22435	0	1	0	103	0	104
22436	1	0	104	2	0	107
22437	1	103	1	0	0	105
22438	101	0	0	2	0	103
22439	1	103	1	1	0	106
22440	0	0	1	106	0	107
22441	1	0	1	106	0	108
22442	2	1	105	0	0	108
22443	103	0	0	1	0	104
22444	1	103	0	1	0	105
22445	1	95	0	0	0	96
22446	1	101	0	1	0	103
22447	2	0	0	99	0	101
22448	0	96	0	2	0	98
22449	1	0	0	95	0	96
22450	0	97	0	0	0	97
22451	1	0	0	95	0	96
22452	0	96	1	0	0	97
22453	98	0	0	0	0	98
22454	0	0	98	0	0	98
22455	100	0	0	0	0	100
22456	101	0	0	0	0	101
22457	99	0	0	1	0	100
22458	0	101	0	0	0	101
22459	102	0	0	0	0	102
22460	103	0	0	0	0	103
22461	102	0	0	0	0	102
22462	1	0	99	0	0	100
22463	0	0	0	101	0	101
22464	0	0	103	0	0	103
22465	0	0	0	104	0	104
22466	105	0	0	0	0	105
22467	0	106	0	0	0	106
22468	0	0	119	1	0	120
22469	0	0	0	119	0	119
22470	0	0	0	123	0	123
22471	0	0	138	0	0	138
22472	132	0	1	0	0	133
22473	137	0	0	0	0	137
22474	139	0	0	1	0	140
22475	1	0	0	138	0	139
22476	0	137	0	2	0	139
22477	0	148	0	0	0	148
22478	0	1	0	148	0	149
22479	0	0	0	144	0	144
22480	0	146	0	1	0	147
22481	146	1	0	0	0	147
22482	1	146	0	0	0	147
22483	0	1	0	145	0	146
22484	0	0	146	1	0	147
22485	0	0	1	143	0	144
22486	145	0	0	1	0	146
22487	1	0	143	0	0	144
22488	143	0	1	0	0	144
22489	146	0	0	0	0	146
22490	148	0	0	0	0	148
22491	144	0	0	0	0	144
22492	144	0	0	0	0	144
22493	1	0	143	0	0	144
22494	0	0	142	0	0	142
22495	160	0	1	0	0	161
22496	167	0	0	0	0	167
22497	0	0	0	174	0	174
22498	0	171	0	1	0	172
22499	0	1	0	172	0	173
22500	178	0	0	1	0	179
22501	2	0	0	176	0	178
22502	0	176	0	2	0	178
22503	176	2	0	1	0	179
22504	171	0	0	1	0	172
22505	171	0	0	1	0	172
22506	2	166	0	0	0	168
22507	0	2	0	170	0	172
22508	0	0	0	172	0	172
22509	0	162	0	2	0	164
22510	0	2	0	164	0	166
22511	164	0	0	2	0	166
22512	166	0	0	0	0	166
22513	2	160	0	0	0	162
22514	0	2	0	164	0	166
22515	0	0	0	164	0	164
22516	0	0	0	164	0	164
22517	154	0	0	2	0	156
22518	2	0	155	0	0	157
22519	145	0	2	0	0	147
22520	2	2	146	0	0	150
22521	0	0	2	149	0	151
22522	0	149	0	1	0	150
22523	0	155	0	0	0	155
22524	148	2	0	0	0	150
22525	152	0	0	1	0	153
22526	2	147	0	0	0	149
22527	0	143	0	1	0	144
22528	144	2	2	0	0	148
22529	146	0	0	1	0	147
22530	3	149	0	0	0	152
22531	151	3	0	0	0	154
22532	3	0	148	0	0	151
22533	147	0	2	0	0	149
22534	145	1	0	0	0	146
22535	3	0	0	143	0	146
22536	0	142	0	4	0	146
22537	0	4	0	142	0	146
22538	143	0	0	4	0	147
22539	3	0	0	140	0	143
22540	1	0	0	140	0	141
22541	0	1	143	3	0	147
22542	0	0	3	143	0	146
22543	0	0	0	148	0	148
22544	141	0	0	4	0	145
22545	4	0	143	0	0	147
22546	145	0	4	0	0	149
22547	4	0	0	146	0	150
22548	0	0	1	148	0	149
22549	0	0	0	150	0	150
22550	0	146	0	3	0	149
22551	0	144	0	0	0	144
22552	1	3	0	142	0	146
22553	141	0	0	3	0	144
22554	143	1	0	0	0	144
22555	3	1	0	139	0	143
22556	140	0	0	3	0	143
22557	4	0	0	139	0	143
22558	0	1	0	141	0	142
22559	137	0	0	3	0	140
22560	3	141	1	0	0	145
22561	142	3	0	1	0	146
22562	144	0	0	1	0	145
22563	144	0	0	1	0	145
22564	2	142	0	0	0	144
22565	0	3	0	140	0	143
22566	1	0	0	143	0	144
22567	0	0	135	4	0	139
22568	0	0	2	125	0	127
22569	0	0	124	3	0	127
22570	0	113	3	1	0	117
22571	0	97	0	2	0	99
22572	1	99	0	0	0	100
22573	1	3	1	101	0	106
22574	1	0	0	103	0	104
22575	0	0	0	103	0	103
22576	0	0	0	104	0	104
22577	0	0	97	3	0	100
22578	0	1	122	0	0	123
22579	0	1	2	122	0	125
22580	0	0	124	3	0	127
22581	123	0	1	0	0	124
22582	129	0	0	0	0	129
22583	1	0	124	1	0	126
22584	1	0	2	124	0	127
22585	0	0	0	129	0	129
22586	0	0	0	131	0	131
22587	0	0	0	131	0	131
22588	1	1	0	131	0	133
22589	104	0	0	2	0	106
22590	130	0	0	0	0	130
22591	3	126	0	0	0	129
22592	0	3	129	0	0	132
22593	0	127	1	1	0	129
22594	0	130	0	2	0	132
22595	111	2	1	0	0	114
22596	2	106	0	1	0	109
22597	0	102	0	0	0	102
22598	100	2	0	0	0	102
22599	2	0	106	0	0	108
22600	99	0	1	0	0	100
22601	1	0	0	102	0	103
22602	0	0	0	102	0	102
22603	0	0	0	104	0	104
22604	0	0	102	1	0	103
22605	0	103	0	0	0	103
22606	102	1	0	0	0	103
22607	1	0	0	101	0	102
22608	0	105	0	1	0	106
22609	0	1	0	105	0	106
22610	0	0	105	1	0	106
22611	0	0	1	106	0	107
22612	0	0	1	107	0	108
22613	1	0	0	105	0	106
22614	106	0	0	1	0	107
22615	1	0	1	104	0	106
22616	0	0	105	2	0	107
22617	0	106	0	1	0	107
22618	0	0	0	107	0	107
22619	0	0	0	108	0	108
22620	0	0	103	2	0	105
22621	0	0	100	0	0	100
22622	102	0	2	0	0	104
22623	96	1	0	1	0	98
22624	1	96	2	0	0	99
22625	99	2	0	0	0	101
22626	1	1	94	0	0	96
22627	1	0	91	0	0	92
22628	91	1	2	1	0	95
22629	91	1	0	1	0	93
22630	1	0	83	1	0	85
22631	80	0	1	1	0	82
22632	1	0	82	1	0	84
22633	83	0	0	1	0	84
22634	84	0	1	1	0	86
22635	0	1	0	82	0	83
22636	0	89	2	1	0	92
22637	75	2	1	1	0	79
22638	2	1	87	0	0	90
22639	0	85	0	2	0	87
22640	84	2	1	0	0	87
22641	77	2	0	1	0	80
22642	1	78	1	1	0	81
22643	0	0	1	80	0	81
22644	0	0	76	1	0	77
22645	0	0	1	78	0	79
22646	2	0	74	2	0	78
22647	2	0	0	75	0	77
22648	0	1	2	74	0	77
22649	1	2	73	0	0	76
22650	0	75	1	1	0	77
22651	0	0	1	77	0	78
22652	2	1	59	0	0	62
22653	74	0	2	1	0	77
22654	1	0	3	74	0	78
22655	3	0	0	75	0	78
22656	74	1	1	1	0	77
22657	2	1	0	74	0	77
22658	3	0	1	74	0	78
22659	0	76	2	2	0	80
22660	1	1	2	72	0	76
22661	3	1	71	0	0	75
22662	0	0	2	72	0	74
22663	1	71	1	0	0	73
22664	2	69	2	0	0	73
22665	2	0	2	69	0	73
22666	72	1	0	0	0	73
22667	2	0	0	71	0	73
22668	69	1	1	0	0	71
22669	2	1	0	70	0	73
22670	69	0	3	0	0	72
22671	73	1	2	1	0	77
22672	2	1	0	71	0	74
22673	3	6	1	60	0	70
22674	1	66	1	0	0	68
22675	1	65	0	2	0	68
22676	0	0	64	1	0	65
22677	2	63	1	1	0	67
22678	36	0	1	3	0	40
22679	0	0	1	36	0	37
22680	1	34	0	1	0	36
22681	34	0	0	2	0	36
22682	0	0	1	35	0	36
22683	0	2	0	34	0	36
22684	0	0	0	36	0	36
22685	0	0	2	36	0	38
22686	1	35	0	1	0	37
22687	0	36	0	1	0	37
22688	36	1	0	1	0	38
22689	1	38	0	1	0	40
22690	1	0	0	39	0	40
22691	0	0	0	37	0	37
22692	1	1	0	36	0	38
22693	0	0	0	38	0	38
22694	36	0	1	0	0	37
22695	36	0	0	1	0	37
22696	0	1	37	1	0	39
22697	0	1	0	40	0	41
22698	0	0	38	1	0	39
22699	1	1	0	35	0	37
22700	0	0	1	36	0	37
22701	40	1	0	0	0	41
22702	2	0	0	40	0	42
22703	1	0	37	2	0	40
22704	1	1	36	0	0	38
22705	38	0	1	1	0	40
22706	1	0	37	2	0	40
22707	0	1	1	35	0	37
22708	0	1	38	2	0	41
22709	0	0	2	38	0	40
22710	0	37	0	1	0	38
22711	1	1	0	37	0	39
22712	0	37	0	2	0	39
22713	0	38	0	0	0	38
22714	0	1	0	37	0	38
22715	36	0	0	2	0	38
22716	1	36	0	0	0	37
22717	0	1	0	34	0	35
22718	35	0	0	1	0	36
22719	36	0	0	0	0	36
22720	36	0	0	0	0	36
22721	1	0	0	34	0	35
22722	0	0	0	36	0	36
22723	35	0	0	1	0	36
22724	36	0	0	0	0	36
22725	39	0	0	0	0	39
22726	1	0	0	38	0	39
22727	0	0	37	1	0	38
22728	38	0	1	0	0	39
22729	1	0	0	38	0	39
22730	0	36	0	1	0	37
22731	0	1	0	35	0	36
22732	0	38	0	1	0	39
22733	0	1	0	39	0	40
22734	0	0	39	1	0	40
22735	0	36	1	0	0	37
22736	0	1	0	34	0	35
22737	0	0	0	34	0	34
22738	0	0	0	35	0	35
22739	37	0	0	1	0	38
22740	1	36	0	0	0	37
22741	0	1	0	37	0	38
22742	39	0	0	1	0	40
22743	39	0	0	0	0	39
22744	1	0	0	39	0	40
22745	0	0	37	1	0	38
22746	0	0	1	40	0	41
22747	0	39	0	1	0	40
22748	0	1	0	40	0	41
22749	40	0	0	1	0	41
22750	1	0	0	44	0	45
22751	0	0	45	1	0	46
22752	0	51	1	0	0	52
22753	52	1	0	0	0	53
22754	1	0	53	0	0	54
22755	52	0	1	0	0	53
22756	1	0	0	52	0	53
22757	0	0	0	55	0	55
22758	0	54	0	1	0	55
22759	53	1	0	0	0	54
22760	1	0	0	54	0	55
22761	0	0	0	57	0	57
22762	0	0	0	59	0	59
22763	0	0	60	1	0	61
22764	0	0	1	58	0	59
22765	60	0	0	1	0	61
22766	61	0	0	0	0	61
22767	1	0	0	59	0	60
22768	0	0	0	61	0	61
22769	60	0	0	1	0	61
22770	1	0	59	0	0	60
22771	56	0	1	0	0	57
22772	1	0	56	0	0	57
22773	0	0	57	0	0	57
22774	0	0	1	57	0	58
22775	0	0	56	1	0	57
22776	58	0	1	0	0	59
22777	1	0	0	56	0	57
22778	0	0	56	1	0	57
22779	55	0	1	1	0	57
22780	57	0	0	0	0	57
22781	1	0	64	0	0	65
22782	0	0	1	62	0	63
22783	0	66	0	1	0	67
22784	68	1	0	0	0	69
22785	1	0	65	0	0	66
22786	61	2	1	0	0	64
22787	1	64	0	0	0	65
22788	64	1	0	0	0	65
22789	69	0	0	0	0	69
22790	70	0	0	1	0	71
22791	1	0	0	71	0	72
22792	0	72	0	1	0	73
22793	0	1	72	0	0	73
22794	0	74	2	0	0	76
22795	0	1	0	75	0	76
22796	0	73	0	1	0	74
22797	0	73	0	0	0	73
22798	73	1	0	0	0	74
22799	1	0	70	0	0	71
22800	0	0	77	0	0	77
22801	0	0	76	0	0	76
22802	0	75	0	0	0	75
22803	78	0	0	0	0	78
22804	79	0	0	0	0	79
22805	77	0	0	1	0	78
22806	0	77	1	0	0	78
22807	0	0	0	78	0	78
22808	0	1	76	0	0	77
22809	0	0	74	1	0	75
22810	77	0	0	0	0	77
22811	79	0	0	1	0	80
22812	79	0	0	0	0	79
22813	0	1	78	0	0	79
22814	79	0	0	0	0	79
22815	0	0	1	80	0	81
22816	1	0	0	79	0	80
22817	0	0	84	1	0	85
22818	0	85	0	0	0	85
22819	0	1	0	86	0	87
22820	1	0	83	0	0	84
22821	82	0	0	1	0	83
22822	0	0	0	87	0	87
22823	0	0	0	87	0	87
22824	87	0	1	0	0	88
22825	0	0	0	85	0	85
22826	85	0	0	0	0	85
22827	85	0	0	0	0	85
22828	0	0	0	84	0	84
22829	0	0	0	84	0	84
22830	86	0	0	0	0	86
22831	0	0	1	87	0	88
22832	90	0	0	0	0	90
22833	89	0	0	1	0	90
22834	89	0	1	1	0	91
22835	0	0	0	92	0	92
22836	0	0	1	87	0	88
22837	87	0	0	0	0	87
22838	0	85	0	1	0	86
22839	0	82	1	0	0	83
22840	84	0	0	0	0	84
22841	1	1	86	0	0	88
22842	85	0	0	0	0	85
22843	0	0	0	90	0	90
22844	0	0	89	0	0	89
22845	95	0	0	1	0	96
22846	0	0	0	99	0	99
22847	0	0	0	102	0	102
22848	0	0	0	105	0	105
22849	0	0	0	104	0	104
22850	101	0	0	0	0	101
22851	0	99	0	0	0	99
22852	92	0	0	0	0	92
22853	0	0	92	0	0	92
22854	0	0	88	0	0	88
22855	0	94	0	0	0	94
22856	0	0	0	95	0	95
22857	0	0	93	0	0	93
22858	0	87	0	0	0	87
22859	0	0	91	0	0	91
22860	0	0	0	90	0	90
22861	0	0	0	89	0	89
22862	89	0	0	0	0	89
22863	0	0	0	86	0	86
22864	87	0	0	0	0	87
22865	0	0	87	0	0	87
22866	0	86	0	0	0	86
22867	0	0	0	93	0	93
22868	0	0	0	98	0	98
22869	0	0	101	0	0	101
22870	0	0	99	0	0	99
22871	101	0	0	0	0	101
22872	105	0	0	0	0	105
22873	0	0	0	106	0	106
22874	0	0	0	105	0	105
22875	0	107	0	0	0	107
22876	0	0	0	105	0	105
22877	111	0	0	1	0	112
22878	112	0	0	0	0	112
22879	0	115	0	0	0	115
22880	117	0	0	0	0	117
22881	114	0	0	0	0	114
22882	0	0	0	124	0	124
22883	0	125	0	1	0	126
22884	0	1	0	124	0	125
22885	0	0	0	131	0	131
22886	0	0	125	1	0	126
22887	128	0	1	0	0	129
22888	1	0	0	139	0	140
22889	0	0	0	142	0	142
22890	0	163	0	5	0	168
22891	0	4	0	170	0	174
22892	172	0	0	4	0	176
22893	188	0	0	0	0	188
22894	4	0	180	0	0	184
22895	1	0	182	0	0	183
22896	2	0	4	184	0	190
22897	1	0	1	189	0	191
22898	0	0	187	5	0	192
22899	0	0	192	1	0	193
22900	1	0	5	177	0	183
22901	0	0	183	5	0	188
22902	0	0	188	0	0	188
22903	0	0	5	183	0	188
22904	189	0	1	5	0	195
22905	193	0	1	0	0	194
22906	5	0	0	194	0	199
22907	1	0	0	197	0	198
22908	189	0	0	5	0	194
22909	5	0	0	190	0	195
22910	186	0	0	6	0	192
22911	192	0	0	0	0	192
22912	4	0	0	191	0	195
22913	1	0	0	193	0	194
22914	186	0	0	5	0	191
22915	5	184	0	1	0	190
22916	0	193	0	1	0	194
22917	1	5	0	180	0	186
22918	0	1	182	4	0	187
22919	0	0	4	180	0	184
22920	183	0	0	6	0	189
22921	5	0	1	181	0	187
22922	185	0	0	6	0	191
22923	6	0	187	0	0	193
22924	186	0	5	1	0	192
22925	6	0	0	191	0	197
22926	0	0	1	195	0	196
22927	1	0	199	5	0	205
22928	0	0	5	198	0	203
22929	1	0	0	205	0	206
22930	0	0	1	209	0	210
22931	204	0	0	5	0	209
22932	5	0	201	1	0	207
22933	0	0	199	1	0	200
22934	201	0	5	0	0	206
22935	208	0	1	0	0	209
22936	5	0	208	0	0	213
22937	1	0	4	202	0	207
22938	1	210	0	5	0	216
22939	0	4	1	209	0	214
22940	210	0	0	5	0	215
22941	214	1	0	1	0	216
22942	6	0	0	207	0	213
22943	2	205	0	3	0	210
22944	1	4	1	204	0	210
22945	1	198	1	6	0	206
22946	202	6	0	1	0	209
22947	200	0	1	2	0	203
22948	201	1	2	0	0	204
22949	5	193	1	1	0	200
22950	1	197	0	2	0	200
22951	1	9	2	197	0	209
22952	0	1	2	199	0	202
22953	0	1	0	204	0	205
22954	1	0	0	203	0	204
22955	1	0	199	6	0	206
22956	193	0	5	3	0	201
22957	6	0	203	2	0	211
22958	211	0	6	0	0	217
22959	7	0	214	2	0	223
22960	217	0	5	1	0	223
22961	7	0	218	0	0	225
22962	212	0	6	2	0	220
22963	8	0	0	217	0	225
22964	222	0	1	5	0	228
22965	5	1	0	231	0	237
22966	0	1	0	238	0	239
22967	2	0	0	229	0	231
22968	0	223	1	6	0	230
22969	215	5	0	3	0	223
22970	220	0	0	2	0	222
22971	4	215	1	1	0	221
22972	2	4	0	216	0	222
22973	2	0	218	4	0	224
22974	213	1	5	1	0	220
22975	221	0	0	2	0	223
22976	220	0	1	1	0	222
22977	7	0	1	205	0	213
22978	0	206	0	6	0	212
22979	1	5	0	208	0	214
22980	205	0	0	7	0	212
22981	6	1	0	200	0	207
22982	0	194	1	5	0	200
22983	191	4	1	1	0	197
22984	6	0	190	1	0	197
22985	1	1	195	0	0	197
22986	1	192	6	0	0	199
22987	1	193	1	2	0	197
22988	4	4	184	0	0	192
22989	2	1	178	1	0	182
22990	2	4	1	145	0	152
22991	148	0	0	1	0	149
22992	1	0	149	0	0	150
22993	0	138	1	2	0	141
22994	143	1	0	0	0	144
22995	1	143	0	0	0	144
22996	141	0	0	1	0	142
22997	0	141	0	0	0	141
22998	0	142	0	0	0	142
22999	0	0	0	144	0	144
23000	0	0	0	145	0	145
23001	0	0	140	0	0	140
23002	0	0	0	136	0	136
23003	138	0	0	0	0	138
23004	140	0	0	0	0	140
23005	0	0	0	140	0	140
23006	0	0	133	0	0	133
23007	0	0	132	0	0	132
23008	0	0	0	131	0	131
23009	0	0	134	0	0	134
23010	0	0	0	132	0	132
23011	0	0	0	129	0	129
23012	0	0	138	0	0	138
23013	139	0	0	0	0	139
23014	139	0	0	0	0	139
23015	0	0	140	0	0	140
23016	0	0	141	0	0	141
23017	0	0	0	144	0	144
23018	0	0	0	154	0	154
23019	0	0	0	160	0	160
23020	0	0	0	161	0	161
23021	162	0	0	1	0	163
23022	166	0	0	0	0	166
23023	1	0	0	175	0	176
23024	0	0	0	193	0	193
23025	0	0	202	1	0	203
23026	0	0	2	212	0	214
23027	0	0	0	225	0	225
23028	234	0	0	2	0	236
23029	2	246	0	0	0	248
23030	1	2	0	241	0	244
23031	0	1	0	244	0	245
23032	0	1	0	242	0	243
23033	0	225	0	3	0	228
23034	0	238	0	1	0	239
23035	0	1	0	235	0	236
23036	1	1	0	235	0	237
23037	0	0	0	237	0	237
23038	226	0	0	3	0	229
23039	2	231	1	1	0	235
23040	231	2	0	1	0	234
23041	235	1	0	1	0	237
23042	6	0	0	230	0	236
23043	2	228	0	2	0	232
23044	231	2	0	3	0	236
23045	2	0	0	233	0	235
23046	227	0	1	2	0	230
23047	2	0	0	231	0	233
23048	1	1	224	3	0	229
23049	1	0	231	1	0	233
23050	0	1	3	229	0	233
23051	0	0	1	232	0	233
23052	0	0	0	230	0	230
23053	0	226	0	3	0	229
23054	0	233	0	1	0	234
23055	229	3	0	1	0	233
23056	226	1	0	3	0	230
23057	3	223	0	1	0	227
23058	1	216	0	1	0	218
23059	1	219	0	0	0	220
23060	211	3	0	0	0	214
23061	3	211	0	0	0	214
23062	2	2	0	213	0	217
23063	210	1	0	3	0	214
23064	212	1	0	2	0	215
23065	4	0	0	202	0	206
23066	1	0	196	3	0	200
23067	1	1	198	1	0	201
23068	0	1	3	200	0	204
23069	0	0	204	3	0	207
23070	0	0	3	203	0	206
23071	0	0	1	203	0	204
23072	1	0	199	4	0	204
23073	0	1	200	2	0	203
23074	2	1	3	194	0	200
23075	1	1	1	205	0	208
23076	202	0	0	5	0	207
23077	3	201	0	1	0	205
23078	2	206	0	0	0	208
23079	201	4	0	2	0	207
23080	205	2	0	0	0	207
23081	5	197	0	1	0	203
23082	1	201	1	0	0	203
23083	196	2	1	2	0	201
23084	3	1	0	198	0	202
23085	189	0	0	4	0	193
23086	2	187	0	3	0	192
23087	186	4	1	0	0	191
23088	2	2	184	1	0	189
23089	186	0	2	2	0	190
23090	3	1	183	1	0	188
23091	2	1	2	182	0	187
23092	180	2	1	3	0	186
23093	3	1	174	1	0	179
23094	3	0	3	177	0	183
23095	175	1	1	4	0	181
23096	2	1	178	3	0	184
23097	4	0	2	174	0	180
23098	176	1	1	3	0	181
23099	3	172	0	2	0	177
23100	2	2	1	175	0	180
23101	1	1	2	172	0	176
23102	0	1	0	172	0	173
23103	0	170	1	4	0	175
23104	1	2	0	178	0	181
23105	0	0	0	185	0	185
23106	1	1	1	181	0	184
23107	0	2	1	186	0	189
23108	2	0	180	4	0	186
23109	183	0	3	2	0	188
23110	187	0	1	0	0	188
23111	3	182	0	0	0	185
23112	1	4	0	177	0	182
23113	1	1	0	179	0	181
23114	1	173	0	3	0	177
23115	0	3	0	177	0	180
23116	175	2	0	2	0	179
23117	3	169	0	1	0	173
23118	165	1	0	2	0	168
23119	2	1	1	162	0	166
23120	1	1	161	1	0	164
23121	1	162	1	1	0	165
23122	152	1	4	0	0	157
23123	2	140	0	1	0	143
23124	1	120	1	2	0	124
23125	105	0	2	0	0	107
23126	0	1	102	0	0	103
23127	1	85	1	1	0	88
23128	70	2	2	2	0	76
23129	57	0	0	0	0	57
23130	0	58	0	0	0	58
23131	0	0	0	58	0	58
23132	0	0	59	0	0	59
23133	0	0	0	59	0	59
23134	0	0	0	57	0	57
23135	0	0	0	60	0	60
23136	0	0	61	0	0	61
23137	0	0	0	61	0	61
23138	0	0	61	0	0	61
23139	0	0	56	0	0	56
23140	55	0	0	0	0	55
23141	0	59	0	0	0	59
23142	0	59	0	0	0	59
23143	1	0	0	60	0	61
23144	67	0	0	0	0	67
23145	70	0	0	0	0	70
23146	68	0	0	0	0	68
23147	68	0	0	0	0	68
23148	70	0	0	0	0	70
23149	0	0	68	0	0	68
23150	0	0	0	66	0	66
23151	0	63	0	0	0	63
23152	0	0	0	66	0	66
23153	66	0	0	0	0	66
23154	0	67	0	0	0	67
23155	0	0	0	68	0	68
23156	68	0	0	0	0	68
23157	70	0	0	0	0	70
23158	0	0	0	70	0	70
23159	0	0	0	68	0	68
23160	0	0	0	68	0	68
23161	0	0	68	0	0	68
23162	0	0	67	1	0	68
23163	0	0	0	69	0	69
23164	0	0	0	69	0	69
23165	68	0	0	1	0	69
23166	68	0	1	0	0	69
23167	71	0	0	0	0	71
23168	72	0	0	0	0	72
23169	68	1	0	0	0	69
23170	0	66	0	1	0	67
23171	68	0	0	1	0	69
23172	68	1	0	0	0	69
23173	67	0	0	1	0	68
23174	2	0	0	66	0	68
23175	0	1	63	0	0	64
23176	1	0	0	65	0	66
23177	0	0	68	1	0	69
23178	0	0	1	67	0	68
23179	0	70	0	0	0	70
23180	73	0	0	0	0	73
23181	76	1	0	0	0	77
23182	0	1	0	79	0	80
23183	1	0	0	82	0	83
23184	0	0	1	81	0	82
23185	0	90	0	0	0	90
23186	89	0	0	0	0	89
23187	88	0	0	0	0	88
23188	0	86	0	0	0	86
23189	0	0	0	88	0	88
23190	0	0	1	86	0	87
23191	0	88	0	1	0	89
23192	89	0	0	1	0	90
23193	88	0	0	1	0	89
23194	0	0	1	90	0	91
23195	0	0	91	1	0	92
23196	1	1	86	0	0	88
23197	0	0	1	94	0	95
23198	2	0	0	95	0	97
23199	0	1	0	97	0	98
23200	98	1	0	0	0	99
23201	98	0	0	1	0	99
23202	1	114	0	0	0	115
23203	111	0	0	2	0	113
23204	0	0	113	0	0	113
23205	0	0	113	0	0	113
23206	0	115	1	0	0	116
23207	110	1	0	0	0	111
23208	1	108	0	0	0	109
23209	106	1	0	0	0	107
23210	1	0	105	0	0	106
23211	0	1	108	0	0	109
23212	0	0	1	106	0	107
23213	0	0	108	1	0	109
23214	0	0	1	110	0	111
23215	0	0	0	109	0	109
23216	0	117	0	1	0	118
23217	0	1	0	116	0	117
23218	0	0	0	120	0	120
23219	120	0	0	1	0	121
23220	1	119	0	0	0	120
23221	1	1	0	122	0	124
23222	1	0	123	2	0	126
23223	117	0	1	1	0	119
23224	1	1	124	0	0	126
23225	1	0	1	125	0	127
23226	1	131	0	1	0	133
23227	0	3	0	130	0	133
23228	132	0	0	2	0	134
23229	134	0	0	1	0	135
23230	2	134	0	0	0	136
23231	144	2	0	1	0	147
23232	152	0	0	0	0	152
23233	151	0	0	1	0	152
23234	153	0	1	1	0	155
23235	147	0	3	1	0	151
23236	2	0	145	1	0	148
23237	0	0	2	151	0	153
23238	0	0	0	151	0	151
23239	1	0	0	151	0	152
23240	1	151	0	2	0	154
23241	0	3	0	151	0	154
23242	1	0	151	2	0	154
23243	0	149	3	0	0	152
23244	0	142	1	0	0	143
23245	0	3	0	144	0	147
23246	1	0	0	145	0	146
23247	1	1	0	143	0	145
23248	1	138	0	4	0	143
23249	0	144	1	0	0	145
23250	141	2	1	0	0	144
23251	142	0	0	1	0	143
23252	2	141	1	0	0	144
23253	140	2	0	1	0	143
23254	149	0	0	1	0	150
23255	2	0	0	149	0	151
23256	0	0	0	156	0	156
23257	0	0	0	156	0	156
23258	1	0	150	2	0	153
23259	0	1	157	0	0	158
23260	0	163	2	1	0	166
23261	166	2	1	1	0	170
23262	3	0	169	0	0	172
23263	167	0	3	0	0	170
23264	2	0	179	1	0	182
23265	181	0	2	0	0	183
23266	2	185	1	1	0	189
23267	186	2	0	0	0	188
23268	3	1	0	185	0	189
23269	1	1	0	191	0	193
23270	1	0	202	3	0	206
23271	1	200	2	1	0	204
23272	1	2	1	202	0	206
23273	1	1	202	2	0	206
23274	198	0	2	1	0	201
23275	2	201	2	0	0	205
23276	198	2	0	1	0	201
23277	2	195	0	3	0	200
23278	1	2	0	196	0	199
23279	194	2	0	2	0	198
23280	2	195	0	2	0	199
23281	1	2	1	195	0	199
23282	0	2	191	2	0	195
23283	185	0	2	1	0	188
23284	2	0	1	185	0	188
23285	1	0	179	2	0	182
23286	0	181	2	1	0	184
23287	1	2	1	182	0	186
23288	0	2	181	2	0	185
23289	1	0	2	179	0	182
23290	0	180	1	3	0	184
23291	0	182	0	2	0	184
23292	0	3	181	0	0	184
23293	0	2	2	179	0	183
23294	0	0	185	3	0	188
23295	177	0	3	1	0	181
23296	3	0	1	178	0	182
23297	1	176	0	1	0	178
23298	1	181	0	1	0	183
23299	174	4	0	0	0	178
23300	2	180	0	1	0	183
23301	178	2	0	0	0	180
23302	2	2	160	0	0	164
23303	160	0	2	1	0	163
23304	1	157	2	0	0	160
23305	159	1	0	0	0	160
23306	1	155	0	1	0	157
23307	2	1	1	152	0	156
23308	0	2	0	156	0	158
23309	0	0	157	3	0	160
23310	148	0	2	1	0	151
23311	1	0	152	2	0	155
23312	155	1	1	1	0	158
23313	1	1	1	151	0	154
23314	2	0	1	154	0	157
23315	0	159	0	3	0	162
23316	0	1	1	164	0	166
23317	1	1	0	168	0	170
23318	0	0	172	3	0	175
23319	167	1	1	1	0	170
23320	1	170	1	0	0	172
23321	172	1	0	0	0	173
23322	1	2	0	169	0	172
23323	2	0	0	170	0	172
23324	166	0	1	2	0	169
23325	2	167	0	1	0	170
23326	161	1	0	1	0	163
23327	1	161	0	0	0	162
23328	1	160	0	0	0	161
23329	154	1	2	1	0	158
23330	1	1	1	155	0	158
23331	1	0	154	0	0	155
23332	1	1	0	148	0	150
23333	0	0	2	145	0	147
23334	1	145	0	1	0	147
23335	0	0	0	151	0	151
23336	0	1	0	150	0	151
23337	0	1	0	150	0	151
23338	1	0	0	153	0	154
23339	0	0	152	3	0	155
23340	0	0	160	1	0	161
23341	1	0	2	164	0	167
23342	0	1	160	1	0	162
23343	1	0	162	1	0	164
23344	0	0	2	162	0	164
23345	1	0	168	1	0	170
23346	1	0	1	166	0	168
23347	1	177	2	0	0	180
23348	185	0	0	2	0	187
23349	1	3	194	0	0	198
23350	2	1	1	191	0	195
23351	1	0	195	1	0	197
23352	1	0	1	210	0	212
23353	0	0	2	209	0	211
23354	203	0	0	5	0	208
23355	3	0	0	207	0	210
23356	200	1	0	4	0	205
23357	201	0	0	3	0	204
23358	6	202	0	1	0	209
23359	203	4	0	1	0	208
23360	4	198	0	0	0	202
23361	1	198	1	0	0	200
23362	196	4	1	0	0	201
23363	4	1	197	1	0	203
23364	1	0	192	0	0	193
23365	186	0	6	0	0	192
23366	189	0	2	0	0	191
23367	6	189	0	0	0	195
23368	188	5	0	0	0	193
23369	189	1	0	0	0	190
23370	177	0	0	1	0	178
23371	7	0	0	172	0	179
23372	172	0	0	5	0	177
23373	4	178	0	2	0	184
23374	1	4	0	180	0	185
23375	1	1	0	185	0	187
23376	0	183	0	5	0	188
23377	0	5	0	183	0	188
23378	181	1	0	5	0	187
23379	183	0	0	1	0	184
23380	6	175	0	0	0	181
23381	1	181	0	0	0	182
23382	177	6	0	0	0	183
23383	5	1	175	0	0	181
23384	1	0	186	0	0	187
23385	0	0	5	181	0	186
23386	1	0	1	185	0	187
23387	0	0	183	6	0	189
23388	1	177	5	1	0	184
23389	0	6	1	172	0	179
23390	1	1	182	5	0	189
23391	0	0	5	180	0	185
23392	0	0	1	184	0	185
23393	1	178	0	4	0	183
23394	0	6	0	178	0	184
23395	2	1	0	181	0	184
23396	1	1	0	183	0	185
23397	175	0	0	6	0	181
23398	6	0	0	176	0	182
23399	1	177	0	5	0	183
23400	180	5	1	2	0	188
23401	5	0	175	1	0	181
23402	1	0	179	1	0	181
23403	178	1	6	0	0	185
23404	5	0	1	179	0	185
23405	1	0	177	6	0	184
23406	0	0	4	181	0	185
23407	0	0	0	188	0	188
23408	182	0	1	6	0	189
23409	186	0	1	1	0	188
23410	6	184	0	1	0	191
23411	1	5	0	187	0	193
23412	0	1	193	5	0	199
23413	0	208	4	2	0	214
23414	204	5	2	0	0	211
23415	5	213	0	1	0	219
23416	205	5	0	0	0	210
23417	5	1	203	0	0	209
23418	205	0	5	0	0	210
23419	212	0	1	0	0	213
23420	6	0	221	1	0	228
23421	1	0	5	218	0	224
23422	0	226	1	4	0	231
23423	0	239	0	2	0	241
23424	0	238	0	0	0	238
23425	0	6	0	227	0	233
23426	0	2	233	6	0	241
23427	0	0	5	236	0	241
23428	0	0	1	235	0	236
23429	1	0	235	7	0	243
23430	0	235	5	2	0	242
23431	0	5	1	235	0	241
23432	240	1	0	5	0	246
23433	5	0	0	236	0	241
23434	2	0	0	238	0	240
23435	0	232	0	7	0	239
23436	235	5	0	3	0	243
23437	5	2	0	242	0	249
23438	2	0	241	4	0	247
23439	0	242	4	2	0	248
23440	234	5	2	0	0	241
23441	4	2	232	0	0	238
23442	236	0	5	0	0	241
23443	4	0	1	234	0	239
23444	2	235	0	4	0	241
23445	229	3	0	1	0	233
23446	232	1	0	0	0	233
23447	5	235	0	0	0	240
23448	0	4	0	228	0	232
23449	0	1	0	223	0	224
23450	218	0	0	4	0	222
23451	4	221	0	1	0	226
23452	1	3	0	206	0	210
23453	0	205	0	2	0	207
23454	0	204	0	1	0	205
23455	2	1	0	201	0	204
23456	198	1	1	1	0	201
23457	1	199	0	1	0	201
23458	1	1	0	199	0	201
23459	0	1	0	200	0	201
23460	0	0	203	2	0	205
23461	1	0	193	1	0	195
23462	0	196	2	1	0	199
23463	0	1	198	0	0	199
23464	0	1	0	196	0	197
23465	0	0	203	0	0	203
23466	0	0	0	208	0	208
23467	0	0	1	206	0	207
23468	0	0	0	210	0	210
23469	206	0	0	2	0	208
23470	0	0	0	208	0	208
23471	1	0	0	206	0	207
23472	1	207	0	2	0	210
23473	0	1	0	201	0	202
23474	205	1	0	2	0	208
23475	0	216	0	1	0	217
23476	218	0	0	1	0	219
23477	1	1	218	0	0	220
23478	1	1	227	0	0	229
23479	1	0	1	236	0	238
23480	0	0	2	238	0	240
23481	0	237	1	6	0	244
23482	0	0	0	232	0	232
23483	239	1	0	1	0	241
23484	233	1	0	2	0	236
23485	3	0	0	242	0	245
23486	2	0	250	2	0	254
23487	1	0	1	263	0	265
23488	0	0	1	268	0	269
23489	0	0	1	270	0	271
23490	0	0	0	270	0	270
23491	0	0	0	268	0	268
23492	0	264	0	5	0	269
23493	263	2	0	3	0	268
23494	261	1	0	2	0	264
23495	266	1	0	0	0	267
23496	5	271	0	0	0	276
23497	272	2	0	0	0	274
23498	3	271	0	0	0	274
23499	0	3	265	0	0	268
23500	1	2	2	263	0	268
23501	0	1	270	2	0	273
23502	0	274	3	2	0	279
23503	272	2	1	1	0	276
23504	2	2	282	0	0	286
23505	2	1	304	0	0	307
23506	1	309	5	0	0	315
23507	0	4	3	310	0	317
23508	0	2	335	4	0	341
23509	0	1	4	326	0	331
23510	0	0	3	358	0	361
23511	0	1	1	383	0	385
23512	400	0	0	10	0	410
23513	394	0	1	2	0	397
23514	9	0	0	397	0	406
23515	393	0	0	7	0	400
23516	8	1	388	3	0	400
23517	4	0	385	1	0	390
23518	3	1	395	1	0	400
23519	1	0	397	1	0	399
23520	1	380	9	2	0	392
23521	2	7	6	381	0	396
23522	1	2	385	6	0	394
23523	359	1	8	3	0	371
23524	376	0	3	2	0	381
23525	7	366	3	1	0	377
23526	367	7	2	1	0	377
23527	9	1	1	363	0	374
23528	3	1	374	6	0	384
23529	2	2	6	369	0	379
23530	2	383	1	8	0	394
23531	377	5	1	4	0	387
23532	387	1	1	2	0	391
23533	8	383	1	2	0	394
23534	383	6	0	2	0	391
23535	389	2	0	0	0	391
23536	9	381	1	1	0	392
23537	3	7	1	370	0	381
23538	2	374	1	7	0	384
23539	375	8	1	1	0	385
23540	9	3	0	374	0	386
23541	371	2	0	9	0	382
23542	7	2	1	373	0	383
23543	4	1	368	7	0	380
23544	371	0	5	2	0	378
23545	7	1	368	2	0	378
23546	3	0	7	373	0	383
23547	1	1	365	8	0	375
23548	2	0	9	367	0	378
23549	1	0	365	9	0	375
23550	363	1	8	2	0	374
23551	6	365	2	2	0	375
23552	365	6	3	1	0	375
23553	8	2	1	368	0	379
23554	370	1	2	6	0	379
23555	9	369	0	2	0	380
23556	2	366	1	1	0	370
23557	2	386	0	1	0	389
23558	388	8	1	2	0	399
23559	10	3	0	386	0	399
23560	2	3	0	390	0	395
23561	3	3	384	7	0	397
23562	2	1	388	3	0	394
23563	2	1	8	398	0	409
23564	1	1	403	7	0	412
23565	1	401	8	2	0	412
23566	401	6	5	1	0	413
23567	6	3	405	2	0	416
23568	1	0	406	5	0	412
23569	1	1	9	402	0	413
23570	412	1	1	5	0	419
23571	6	2	2	409	0	419
23572	406	1	0	7	0	414
23573	6	0	4	411	0	421
23574	3	1	415	8	0	427
23575	2	416	7	3	0	428
23576	1	4	418	3	0	426
23577	2	423	4	1	0	430
23578	3	7	2	405	0	417
23579	404	1	2	7	0	414
23580	7	2	403	2	0	414
23581	3	1	8	403	0	415
23582	1	2	1	412	0	416
23583	413	1	2	8	0	424
23584	7	1	2	411	0	421
23585	0	412	3	7	0	422
23586	400	7	0	6	0	413
23587	6	1	396	3	0	406
23588	388	0	6	3	0	397
23589	7	395	1	3	0	406
23590	2	8	1	395	0	406
23591	4	395	0	5	0	404
23592	402	5	1	1	0	409
23593	6	2	399	3	0	410
23594	389	1	5	5	0	400
23595	6	404	0	3	0	413
23596	3	5	2	400	0	410
23597	400	0	1	8	0	409
23598	404	2	1	0	0	407
23599	7	1	0	403	0	411
23600	0	2	0	402	0	404
23601	4	400	0	7	0	411
23602	2	6	2	401	0	411
23603	2	453	0	7	0	462
23604	0	484	1	2	0	487
23605	2	5	0	454	0	461
23606	1	476	1	6	0	484
23607	2	6	471	1	0	480
23608	4	4	478	1	0	487
23609	1	486	5	1	0	493
23610	3	6	483	1	0	493
23611	0	0	472	0	0	472
23612	0	1	440	0	0	441
23613	0	434	5	0	0	439
23614	419	4	3	0	0	426
23615	4	417	0	1	0	422
23616	0	5	420	0	0	425
23617	0	0	5	414	0	419
23618	407	0	0	5	0	412
23619	5	1	400	0	0	406
23620	1	0	6	395	0	402
23621	0	0	398	5	0	403
23622	0	1	4	391	0	396
23623	388	1	1	4	0	394
23624	5	1	395	0	0	401
23625	0	393	5	1	0	399
23626	0	7	0	385	0	392
23627	402	0	1	4	0	407
23628	6	2	390	0	0	398
23629	1	1	7	374	0	383
23630	0	378	2	5	0	385
23631	380	6	2	1	0	389
23632	399	1	4	0	0	404
23633	7	2	1	391	0	401
23634	2	385	4	5	0	396
23635	0	405	1	2	0	408
23636	414	7	2	0	0	423
23637	6	3	3	409	0	421
23638	3	410	2	5	0	420
23639	407	8	1	3	0	419
23640	9	1	1	412	0	423
23641	1	2	3	415	0	421
23642	1	0	394	10	0	405
23643	1	402	7	3	0	413
23644	2	408	3	1	0	414
23645	1	9	2	408	0	420
23646	411	1	1	8	0	421
23647	7	408	1	1	0	417
23648	404	7	2	2	0	415
23649	8	401	0	2	0	411
23650	2	7	2	406	0	417
23651	406	3	1	7	0	417
23652	8	0	1	405	0	414
23653	3	0	404	8	0	415
23654	1	3	7	395	0	406
23655	0	397	1	7	0	405
23656	396	9	1	1	0	407
23657	7	387	1	2	0	397
23658	4	6	1	379	0	390
23659	2	3	0	387	0	392
23660	1	2	378	8	0	389
23661	1	0	375	4	0	380
23662	1	2	7	371	0	381
23663	1	2	369	9	0	381
23664	2	370	7	2	0	381
23665	356	7	1	4	0	368
23666	7	3	362	1	0	373
23667	353	3	6	5	0	367
23668	363	2	2	0	0	367
23669	364	3	1	2	0	370
23670	360	3	0	2	0	365
23671	9	2	1	355	0	367
23672	3	0	0	357	0	360
23673	2	348	1	8	0	359
23674	340	5	3	4	0	352
23675	7	5	328	0	0	340
23676	2	1	7	329	0	339
23677	2	3	2	330	0	337
23678	3	1	326	8	0	338
23679	1	328	7	2	0	338
23680	2	7	2	322	0	333
23681	2	5	1	331	0	339
23682	325	0	1	10	0	336
23683	7	317	2	6	0	332
23684	1	5	1	323	0	330
23685	1	315	4	8	0	328
23686	2	9	2	323	0	336
23687	317	3	1	7	0	328
23688	325	2	2	3	0	332
23689	11	0	1	313	0	325
23690	312	2	1	9	0	324
23691	317	0	1	4	0	322
23692	9	313	3	1	0	326
23693	2	8	1	304	0	315
23694	4	311	0	5	0	320
23695	3	6	2	303	0	314
23696	303	3	1	7	0	314
23697	7	2	1	305	0	315
23698	3	2	2	305	0	312
23699	3	3	301	8	0	315
23700	3	289	6	5	0	303
23701	3	300	1	4	0	308
23702	291	6	1	4	0	302
23703	8	4	2	226	0	240
23704	203	1	1	3	0	208
23705	3	196	0	3	0	202
23706	1	177	1	0	0	179
23707	0	187	0	0	0	187
23708	147	6	4	0	0	157
23709	3	142	1	0	0	146
23710	135	3	3	1	0	142
23711	131	1	0	0	0	132
23712	138	0	0	0	0	138
23713	3	0	1	148	0	152
23714	1	0	0	154	0	155
23715	0	1	0	156	0	157
23716	2	1	0	151	0	154
23717	148	2	0	2	0	152
23718	2	149	1	3	0	155
23719	1	2	0	154	0	157
23720	155	1	1	4	0	161
23721	2	0	1	155	0	158
23722	1	1	0	158	0	160
23723	155	1	1	2	0	159
23724	1	1	151	4	0	157
23725	4	1	1	151	0	157
23726	1	1	151	0	0	153
23727	1	1	0	150	0	152
23728	2	1	1	148	0	152
23729	147	0	1	3	0	151
23730	2	144	1	2	0	149
23731	1	144	1	1	0	147
23732	134	0	0	4	0	138
23733	1	142	1	1	0	145
23734	146	1	0	0	0	147
23735	1	1	144	0	0	146
23736	121	1	1	0	0	123
23737	129	0	0	0	0	129
23738	131	1	0	0	0	132
23739	2	0	0	131	0	133
23740	1	0	1	129	0	131
23741	1	130	0	1	0	132
23742	2	0	0	127	0	129
23743	127	1	0	0	0	128
23744	1	133	0	1	0	135
23745	0	129	0	2	0	131
23746	134	1	0	1	0	136
23747	0	0	134	1	0	135
23748	1	0	0	132	0	133
23749	0	1	138	0	0	139
23750	0	1	0	135	0	136
23751	1	140	0	0	0	141
23752	0	0	1	145	0	146
23753	139	0	0	1	0	140
23754	0	0	1	139	0	140
23755	0	0	143	1	0	144
23756	138	1	0	0	0	139
23757	0	143	0	1	0	144
23758	1	146	0	0	0	147
23759	152	0	0	2	0	154
23760	168	0	1	0	0	169
23761	3	0	168	0	0	171
23762	166	1	3	0	0	170
23763	3	170	0	0	0	173
23764	170	3	0	0	0	173
23765	4	0	0	171	0	175
23766	0	160	1	3	0	164
23767	164	3	0	0	0	167
23768	3	1	168	0	0	172
23769	1	0	3	171	0	175
23770	176	0	0	3	0	179
23771	3	1	174	0	0	178
23772	173	0	3	1	0	177
23773	3	0	1	174	0	178
23774	0	0	0	179	0	179
23775	1	0	181	3	0	185
23776	0	0	3	182	0	185
23777	181	0	1	3	0	185
23778	4	176	0	1	0	181
23779	180	4	0	1	0	185
23780	182	1	1	0	0	184
23781	4	0	0	179	0	183
23782	2	0	178	2	0	182
23783	0	1	5	174	0	180
23784	180	0	0	3	0	183
23785	4	175	0	1	0	180
23786	177	3	0	0	0	180
23787	3	0	1	177	0	181
23788	0	1	0	179	0	180
23789	2	0	0	177	0	179
23790	0	1	174	3	0	178
23791	1	0	3	180	0	184
23792	1	0	182	4	0	187
23793	1	0	182	1	0	184
23794	0	0	3	202	0	205
23795	0	0	204	5	0	209
23796	221	0	4	2	0	227
23797	5	0	2	235	0	242
23798	0	0	1	240	0	241
23799	1	236	0	5	0	242
23800	237	6	1	1	0	245
23801	255	0	0	0	0	255
23802	5	252	0	1	0	258
23803	0	5	0	256	0	261
23804	2	1	257	3	0	263
23805	252	0	5	2	0	259
23806	261	0	0	2	0	263
23807	5	3	0	248	0	256
23808	2	0	244	6	0	252
23809	1	245	6	1	0	253
23810	235	6	0	1	0	242
23811	6	0	237	2	0	245
23812	0	232	6	1	0	239
23813	221	6	0	1	0	228
23814	227	0	0	1	0	228
23815	5	0	0	220	0	225
23816	0	220	1	6	0	227
23817	0	6	1	228	0	235
23818	2	0	0	235	0	237
23819	1	0	1	230	0	232
23820	0	1	0	232	0	233
23821	1	1	228	6	0	236
23822	4	0	6	225	0	235
23823	1	0	0	233	0	234
23824	0	2	232	6	0	240
23825	0	232	5	2	0	239
23826	233	6	1	1	0	241
23827	238	0	0	1	0	239
23828	7	0	0	235	0	242
23829	235	0	1	7	0	243
23830	6	0	1	237	0	244
23831	0	1	237	7	0	245
23832	2	0	243	0	0	245
23833	0	231	8	0	0	239
23834	230	6	0	0	0	236
23835	8	0	242	0	0	250
23836	1	0	7	247	0	255
23837	1	0	1	265	0	267
23838	1	1	0	264	0	266
23839	1	0	1	264	0	266
23840	0	0	1	266	0	267
23841	0	2	259	11	0	272
23842	2	1	9	257	0	269
23843	256	0	1	10	0	267
23844	10	248	0	2	0	260
23845	246	10	0	3	0	259
23846	9	241	1	2	0	253
23847	245	10	1	2	0	258
23848	262	0	0	1	0	263
23849	12	0	1	245	0	258
23850	0	0	1	257	0	258
23851	245	1	1	10	0	257
23852	250	2	0	1	0	253
23853	251	0	2	0	0	253
23854	9	236	2	4	0	251
23855	2	247	0	1	0	250
23856	3	9	240	0	0	252
23857	1	0	9	236	0	246
23858	0	0	227	11	0	238
23859	1	227	9	1	0	238
23860	1	8	0	212	0	221
23861	2	0	0	218	0	220
23862	0	1	0	216	0	217
23863	207	0	1	8	0	216
23864	211	1	1	2	0	215
23865	7	206	0	3	0	216
23866	0	6	2	211	0	219
23867	0	2	209	6	0	217
23868	1	1	208	2	0	212
23869	206	0	6	2	0	214
23870	207	0	0	3	0	210
23871	9	0	0	202	0	211
23872	203	0	0	8	0	211
23873	5	1	202	1	0	209
23874	0	198	8	1	0	207
23875	1	7	2	193	0	203
23876	1	1	200	6	0	208
23877	2	1	7	196	0	206
23878	2	0	0	201	0	203
23879	2	0	195	8	0	205
23880	194	0	6	3	0	203
23881	202	0	1	3	0	206
23882	5	208	0	4	0	217
23883	212	6	1	4	0	223
23884	220	0	3	3	0	226
23885	9	0	217	4	0	230
23886	210	1	8	1	0	220
23887	8	228	3	1	0	240
23888	230	8	0	2	0	240
23889	241	3	1	0	0	245
23890	245	2	0	0	0	247
23891	235	0	0	2	0	237
23892	239	0	0	3	0	242
23893	9	226	1	3	0	239
23894	216	6	0	0	0	222
23895	8	205	1	1	0	215
23896	2	181	1	0	0	184
23897	0	186	0	0	0	186
23898	181	7	1	0	0	189
23899	187	1	2	0	0	190
23900	6	0	181	1	0	188
23901	171	0	9	1	0	181
23902	172	0	1	1	0	174
23903	5	0	172	1	0	178
23904	1	0	6	175	0	182
23905	3	0	1	172	0	176
23906	2	0	0	182	0	184
23907	1	1	0	182	0	184
23908	1	0	0	184	0	185
23909	0	1	178	7	0	186
23910	1	177	6	1	0	185
23911	176	4	2	0	0	182
23912	7	173	0	1	0	181
23913	176	5	1	0	0	182
23914	180	1	0	1	0	182
23915	8	1	175	1	0	185
23916	3	0	5	164	0	172
23917	0	164	1	4	0	169
23918	165	5	0	3	0	173
23919	173	1	2	0	0	176
23920	171	0	0	3	0	174
23921	4	168	1	0	0	173
23922	172	5	1	0	0	178
23923	176	2	0	2	0	180
23924	175	1	0	1	0	177
23925	4	2	0	167	0	173
23926	4	0	0	168	0	172
23927	3	0	0	171	0	174
23928	165	1	1	5	0	172
23929	6	168	0	2	0	176
23930	171	5	1	0	0	177
23931	168	1	1	0	0	170
23932	166	0	0	2	0	168
23933	166	0	0	1	0	167
23934	6	157	1	1	0	165
23935	141	2	0	1	0	144
23936	2	139	1	1	0	143
23937	2	128	1	0	0	131
23938	130	2	0	0	0	132
23939	2	124	0	0	0	126
23940	1	129	0	0	0	130
23941	128	2	0	2	0	132
23942	132	1	0	0	0	133
23943	1	0	1	128	0	130
23944	1	0	0	130	0	131
23945	132	1	0	4	0	137
23946	136	0	0	2	0	138
23947	134	0	0	0	0	134
23948	3	0	136	0	0	139
23949	140	1	1	0	0	142
23950	2	0	1	138	0	141
23951	3	0	0	142	0	145
23952	1	0	0	144	0	145
23953	0	0	1	144	0	145
23954	0	0	138	2	0	140
23955	0	0	143	2	0	145
23956	1	0	2	141	0	144
23957	0	1	140	1	0	142
23958	1	0	137	1	0	139
23959	1	0	2	145	0	148
23960	1	0	1	144	0	146
23961	1	0	0	147	0	148
23962	0	1	0	146	0	147
23963	148	0	0	2	0	150
23964	152	0	0	2	0	154
23965	2	1	0	148	0	151
23966	2	0	0	149	0	151
23967	0	1	0	149	0	150
23968	0	1	0	147	0	148
23969	1	0	0	148	0	149
23970	1	147	0	2	0	150
23971	147	1	0	2	0	150
23972	1	149	0	1	0	151
23973	150	1	0	0	0	151
23974	149	1	0	0	0	150
23975	150	0	0	0	0	150
23976	2	0	0	142	0	144
23977	144	0	0	2	0	146
23978	1	0	0	144	0	145
23979	1	0	0	145	0	146
23980	146	0	0	3	0	149
23981	1	145	0	2	0	148
23982	1	137	0	0	0	138
23983	133	0	1	0	0	134
23984	0	0	132	0	0	132
23985	129	0	0	0	0	129
23986	1	0	0	129	0	130
23987	0	117	0	0	0	117
23988	0	118	0	0	0	118
23989	118	1	0	0	0	119
23990	0	1	0	121	0	122
23991	1	127	0	0	0	128
23992	125	0	1	2	0	128
23993	123	1	0	0	0	124
23994	127	0	0	0	0	127
23995	127	0	0	0	0	127
23996	1	124	0	0	0	125
23997	1	115	0	0	0	116
23998	118	1	0	0	0	119
23999	119	1	0	0	0	120
24000	1	0	120	0	0	121
24001	1	119	0	0	0	120
24002	119	0	1	0	0	120
24003	125	1	0	0	0	126
24004	1	0	125	0	0	126
24005	129	0	0	1	0	130
24006	0	1	132	0	0	133
24007	2	0	144	0	0	146
24008	0	0	3	143	0	146
24009	0	145	1	1	0	147
24010	156	1	0	2	0	159
24011	1	2	0	157	0	160
24012	2	0	0	156	0	158
24013	0	0	0	158	0	158
24014	154	0	0	3	0	157
24015	1	0	0	154	0	155
24016	2	0	0	155	0	157
24017	0	0	157	3	0	160
24018	164	0	1	2	0	167
24019	163	0	2	1	0	166
24020	3	0	160	0	0	163
24021	162	0	1	0	0	163
24022	1	0	2	158	0	161
24023	2	157	0	0	0	159
24024	0	1	0	161	0	162
24025	158	2	0	1	0	161
24026	1	159	0	2	0	162
24027	2	1	0	158	0	161
24028	0	1	0	158	0	159
24029	0	0	0	160	0	160
24030	0	0	0	158	0	158
24031	0	160	0	3	0	163
24032	161	1	0	2	0	164
24033	161	2	0	0	0	163
24034	3	166	0	0	0	169
24035	185	2	0	0	0	187
24036	192	2	0	0	0	194
24037	191	0	0	1	0	192
24038	6	0	189	0	0	195
24039	3	0	5	188	0	196
24040	1	0	184	5	0	190
24041	189	0	3	2	0	194
24042	5	186	3	0	0	194
24043	187	5	0	1	0	193
24044	4	191	1	0	0	196
24045	3	4	0	186	0	193
24046	0	3	0	189	0	192
24047	1	0	183	7	0	191
24048	0	185	5	2	0	192
24049	182	5	2	1	0	190
24050	5	2	182	1	0	190
24051	184	0	6	0	0	190
24052	6	1	1	181	0	189
24053	3	0	182	5	0	190
24054	0	182	6	2	0	190
24055	1	4	2	176	0	183
24056	0	2	177	6	0	185
24057	0	0	175	2	0	177
24058	0	174	7	0	0	181
24059	0	5	2	170	0	177
24060	0	2	1	169	0	172
24061	0	168	1	8	0	177
24062	169	6	0	1	0	176
24063	5	2	0	169	0	176
24064	2	163	0	5	0	170
24065	166	5	0	2	0	173
24066	166	2	0	0	0	168
24067	168	0	0	1	0	169
24068	7	165	0	0	0	172
24069	167	4	0	0	0	171
24070	170	1	0	0	0	171
24071	8	0	0	163	0	171
24072	165	1	0	5	0	171
24073	6	0	0	169	0	175
24074	3	0	165	5	0	173
24075	0	0	174	3	0	177
24076	1	0	7	169	0	177
24077	0	0	168	6	0	174
24078	165	0	6	1	0	172
24079	5	0	3	166	0	174
24080	2	0	0	172	0	174
24081	0	0	168	7	0	175
24082	1	163	5	2	0	171
24083	0	174	2	1	0	177
24084	0	6	0	171	0	177
24085	0	2	1	172	0	175
24086	0	1	165	7	0	173
24087	0	1	171	1	0	173
24088	0	0	5	169	0	174
24089	0	0	161	6	0	167
24090	160	0	6	2	0	168
24091	5	1	2	158	0	166
24092	163	0	0	6	0	169
24093	5	0	0	163	0	168
24094	2	0	0	167	0	169
24095	0	0	163	7	0	170
24096	1	167	5	1	0	174
24097	0	5	0	168	0	173
24098	0	1	167	6	0	174
24099	0	161	6	1	0	168
24100	0	5	1	166	0	172
24101	167	0	0	7	0	174
24102	5	0	168	1	0	174
24103	163	1	5	0	0	169
24104	5	0	157	1	0	163
24105	148	0	5	0	0	153
24106	5	148	1	0	0	154
24107	1	139	0	0	0	140
24108	0	4	1	130	0	135
24109	0	131	0	4	0	135
24110	129	5	0	1	0	135
24111	4	0	0	131	0	135
24112	0	0	0	134	0	134
24113	0	0	0	134	0	134
24114	1	0	129	4	0	134
24115	0	0	4	131	0	135
24116	0	0	126	4	0	130
24117	0	125	4	1	0	130
24118	113	4	1	0	0	118
24119	4	115	0	1	0	120
24120	118	4	0	0	0	122
24121	120	1	0	0	0	121
24122	122	0	0	0	0	122
24123	119	1	0	0	0	120
24124	5	0	112	0	0	117
24125	1	0	2	112	0	115
24126	1	0	0	116	0	117
24127	1	0	0	118	0	119
24128	104	0	1	4	0	109
24129	115	0	0	1	0	116
24130	4	111	0	1	0	116
24131	0	4	112	1	0	117
24132	1	0	113	0	0	114
24133	1	110	4	0	0	115
24134	0	107	0	0	0	107
24135	0	1	3	81	0	85
24136	0	0	0	79	0	79
24137	80	0	0	0	0	80
24138	0	84	0	0	0	84
24139	0	0	0	84	0	84
24140	0	0	84	0	0	84
24141	0	0	0	87	0	87
24142	0	0	0	88	0	88
24143	0	0	0	90	0	90
24144	0	0	0	87	0	87
24145	0	0	87	0	0	87
24146	0	84	0	0	0	84
24147	0	85	0	0	0	85
24148	83	0	0	0	0	83
24149	0	78	0	0	0	78
24150	0	79	0	0	0	79
24151	1	0	0	84	0	85
24152	0	0	0	85	0	85
24153	0	0	0	86	0	86
24154	0	0	85	0	0	85
24155	0	86	0	0	0	86
24156	0	0	0	85	0	85
24157	0	86	1	0	0	87
24158	87	1	0	0	0	88
24159	0	86	0	1	0	87
24160	87	0	0	0	0	87
24161	0	0	86	0	0	86
24162	90	0	0	0	0	90
24163	0	0	1	91	0	92
24164	1	0	89	0	0	90
24165	88	1	0	0	0	89
24166	89	1	0	0	0	90
24167	89	0	0	1	0	90
24168	0	1	0	88	0	89
24169	1	0	90	0	0	91
24170	93	0	0	1	0	94
24171	0	0	0	93	0	93
24172	0	0	0	92	0	92
24173	0	0	98	0	0	98
24174	0	97	0	1	0	98
24175	0	0	1	94	0	95
24176	0	98	0	0	0	98
24177	98	0	0	0	0	98
24178	99	1	0	0	0	100
24179	2	0	0	97	0	99
24180	98	0	0	1	0	99
24181	1	97	0	0	0	98
24182	94	0	0	0	0	94
24183	0	97	1	0	0	98
24184	0	0	0	98	0	98
24185	0	0	0	98	0	98
24186	0	98	0	1	0	99
24187	1	0	0	96	0	97
24188	1	0	95	0	0	96
24189	0	92	0	0	0	92
24190	86	0	1	0	0	87
24191	0	90	1	0	0	91
24192	0	0	0	87	0	87
24193	0	0	86	0	0	86
24194	0	0	0	88	0	88
24195	0	0	0	88	0	88
24196	83	0	0	0	0	83
24197	0	0	86	0	0	86
24198	0	86	0	0	0	86
24199	0	0	92	0	0	92
24200	0	0	87	0	0	87
24201	1	0	84	0	0	85
24202	1	3	0	82	0	86
24203	89	0	0	0	0	89
24204	0	86	0	0	0	86
24205	89	0	0	0	0	89
24206	89	0	0	0	0	89
24207	1	0	0	85	0	86
24208	0	91	0	0	0	91
24209	89	0	0	1	0	90
24210	0	94	0	0	0	94
24211	0	0	0	93	0	93
24212	0	0	0	93	0	93
24213	0	96	0	0	0	96
24214	0	0	0	96	0	96
24215	0	0	94	0	0	94
24216	0	0	91	0	0	91
24217	0	0	0	98	0	98
24218	0	0	0	97	0	97
24219	0	0	97	0	0	97
24220	0	0	95	0	0	95
24221	88	0	0	0	0	88
24222	0	93	0	0	0	93
24223	0	107	0	0	0	107
24224	0	0	0	106	0	106
24225	0	0	0	104	0	104
24226	0	0	0	105	0	105
24227	0	0	104	0	0	104
24228	0	0	102	0	0	102
24229	0	0	0	109	0	109
24230	0	0	106	0	0	106
24231	0	106	0	0	0	106
24232	105	0	0	0	0	105
24233	0	0	104	0	0	104
24234	0	0	104	0	0	104
24235	0	0	0	107	0	107
24236	0	0	113	0	0	113
24237	0	114	0	0	0	114
24238	0	0	0	115	0	115
24239	0	0	118	0	0	118
24240	0	112	0	1	0	113
24241	113	0	1	0	0	114
24242	0	0	0	113	0	113
24243	1	0	0	112	0	113
24244	113	0	0	1	0	114
24245	0	111	0	1	0	112
24246	112	0	0	0	0	112
24247	112	1	0	0	0	113
24248	115	0	0	0	0	115
24249	1	0	0	113	0	114
24250	113	0	0	0	0	113
24251	0	103	0	1	0	104
24252	1	108	0	0	0	109
24253	110	1	0	0	0	111
24254	1	1	0	110	0	112
24255	1	0	0	110	0	111
24256	0	0	0	113	0	113
24257	0	0	105	2	0	107
24258	0	108	1	1	0	110
24259	0	0	1	108	0	109
24260	110	1	0	1	0	112
24261	1	0	0	114	0	115
24262	1	0	110	1	0	112
24263	0	111	1	1	0	113
24264	112	1	1	0	0	114
24265	109	1	0	0	0	110
24266	116	0	0	0	0	116
24267	2	0	0	114	0	116
24268	1	0	121	1	0	123
24269	0	0	128	1	0	129
24270	0	135	3	0	0	138
24271	0	2	1	133	0	136
24272	2	1	0	136	0	139
24273	127	0	0	3	0	130
24274	2	0	0	128	0	130
24275	132	0	0	2	0	134
24276	3	0	129	1	0	133
24277	1	0	130	0	0	131
24278	0	0	4	132	0	136
24279	0	0	1	135	0	136
24280	0	0	0	139	0	139
24281	141	0	0	4	0	145
24282	145	0	0	2	0	147
24283	5	0	0	143	0	148
24284	1	1	141	4	0	147
24285	0	0	151	2	0	153
24286	0	0	5	151	0	156
24287	152	0	1	4	0	157
24288	4	0	0	151	0	155
24289	4	0	0	152	0	156
24290	0	0	151	5	0	156
24291	0	0	157	1	0	158
24292	150	0	5	2	0	157
24293	5	0	150	1	0	156
24294	2	0	5	144	0	151
24295	1	0	2	147	0	150
24296	144	0	0	6	0	150
24297	4	143	0	3	0	150
24298	137	4	3	1	0	145
24299	5	134	1	0	0	140
24300	134	4	0	1	0	139
24301	5	1	129	1	0	136
24302	122	0	5	1	0	128
24303	127	0	2	1	0	130
24304	5	0	1	124	0	130
24305	2	0	126	4	0	132
24306	1	0	4	124	0	129
24307	0	0	2	127	0	129
24308	0	117	1	5	0	123
24309	0	4	1	121	0	126
24310	2	116	0	4	0	122
24311	0	5	1	120	0	126
24312	119	1	0	6	0	126
24313	5	1	0	119	0	125
24314	3	0	117	5	0	125
24315	116	1	5	1	0	123
24316	7	0	117	0	0	124
24317	118	1	4	0	0	123
24318	123	0	1	1	0	125
24319	6	118	2	0	0	126
24320	1	128	0	1	0	130
24321	123	5	1	1	0	130
24322	127	2	0	1	0	130
24323	119	0	2	1	0	122
24324	121	2	0	1	0	124
24325	121	0	0	1	0	122
24326	7	1	0	117	0	125
24327	3	0	0	122	0	125
24328	0	1	116	7	0	124
24329	115	0	5	2	0	122
24330	6	0	2	112	0	120
24331	3	0	1	119	0	123
24332	1	0	113	7	0	121
24333	1	112	5	2	0	120
24334	0	116	2	1	0	119
24335	112	5	0	0	0	117
24336	115	1	0	0	0	116
24337	8	104	0	1	0	113
24338	1	107	1	0	0	109
24339	101	6	1	0	0	108
24340	112	0	0	2	0	114
24341	8	0	0	108	0	116
24342	1	0	0	110	0	111
24343	2	0	0	110	0	112
24344	106	0	1	8	0	115
24345	114	0	1	2	0	117
24346	7	0	2	107	0	116
24347	114	0	1	6	0	121
24348	5	1	112	2	0	120
24349	1	0	5	114	0	120
24350	2	0	113	5	0	120
24351	0	115	5	0	0	120
24352	1	6	0	112	0	119
24353	113	1	0	4	0	118
24354	7	0	0	110	0	117
24355	0	1	1	114	0	116
24356	1	1	110	4	0	116
24357	2	0	110	1	0	113
24358	2	108	4	1	0	115
24359	111	4	1	1	0	117
24360	113	0	0	4	0	117
24361	111	0	0	3	0	114
24362	111	0	1	0	0	112
24363	5	0	0	107	0	112
24364	0	1	1	108	0	110
24365	1	108	0	5	0	114
24366	109	4	1	1	0	115
24367	108	0	1	2	0	111
24368	5	0	94	0	0	99
24369	83	0	4	0	0	87
24370	4	80	0	2	0	86
24371	1	7	0	78	0	86
24372	0	82	0	4	0	86
24373	84	3	0	1	0	88
24374	4	82	0	0	0	86
24375	1	4	0	78	0	83
24376	1	0	0	81	0	82
24377	0	0	0	81	0	81
24378	0	76	0	2	0	78
24379	0	3	1	78	0	82
24380	1	0	0	76	0	77
24381	0	65	0	3	0	68
24382	0	67	0	1	0	68
24383	61	2	1	0	0	64
24384	2	62	0	0	0	64
24385	54	3	0	1	0	58
24386	3	0	53	0	0	56
24387	1	52	2	0	0	55
24388	54	3	0	0	0	57
24389	57	1	0	0	0	58
24390	3	0	56	0	0	59
24391	2	0	2	52	0	56
24392	0	0	55	3	0	58
24393	0	53	2	0	0	55
24394	54	2	0	2	0	58
24395	2	54	0	0	0	56
24396	1	1	0	54	0	56
24397	0	0	0	56	0	56
24398	1	0	53	2	0	56
24399	1	0	57	0	0	58
24400	54	0	1	1	0	56
24401	55	0	1	1	0	57
24402	56	1	1	0	0	58
24403	54	1	0	2	0	57
24404	3	55	0	0	0	58
24405	1	2	0	53	0	56
24406	1	0	0	56	0	57
24407	0	56	1	1	0	58
24408	56	3	1	0	0	60
24409	58	1	0	0	0	59
24410	4	0	58	0	0	62
24411	58	0	0	1	0	59
24412	1	0	0	56	0	57
24413	2	0	55	1	0	58
24414	1	2	0	53	0	56
24415	1	0	57	1	0	59
24416	0	0	54	1	0	55
24417	1	0	1	53	0	55
24418	1	49	1	1	0	52
24419	48	1	0	1	0	50
24420	49	0	1	0	0	50
24421	1	53	0	1	0	55
24422	0	53	0	1	0	54
24423	59	0	0	0	0	59
24424	58	0	0	1	0	59
24425	58	0	0	1	0	59
24426	58	0	1	0	0	59
24427	1	0	0	59	0	60
24428	0	0	59	1	0	60
24429	0	57	1	0	0	58
24430	58	1	0	0	0	59
24431	1	57	0	0	0	58
24432	60	1	0	0	0	61
24433	61	0	0	0	0	61
24434	1	0	63	0	0	64
24435	0	63	1	0	0	64
24436	0	0	0	68	0	68
24437	0	0	0	67	0	67
24438	0	0	0	65	0	65
24439	67	0	0	0	0	67
24440	60	0	0	0	0	60
24441	57	0	0	0	0	57
24442	0	60	0	0	0	60
24443	60	0	0	1	0	61
24444	0	60	0	0	0	60
24445	0	0	57	0	0	57
24446	0	63	0	0	0	63
24447	0	1	0	56	0	57
24448	0	0	0	61	0	61
24449	0	0	60	0	0	60
24450	0	0	0	57	0	57
24451	0	0	0	61	0	61
24452	59	0	0	0	0	59
24453	58	0	0	1	0	59
24454	59	0	0	0	0	59
24455	0	61	0	0	0	61
24456	61	0	0	0	0	61
24457	60	0	0	0	0	60
24458	0	63	0	0	0	63
24459	0	0	0	65	0	65
24460	0	0	0	64	0	64
24461	66	0	0	0	0	66
24462	0	0	67	0	0	67
24463	0	67	0	0	0	67
24464	0	0	0	65	0	65
24465	0	63	0	0	0	63
24466	0	62	0	0	0	62
24467	62	0	0	0	0	62
24468	61	0	0	0	0	61
24469	0	0	0	61	0	61
24470	0	0	0	61	0	61
24471	0	0	0	60	0	60
24472	0	0	0	61	0	61
24473	0	0	60	0	0	60
24474	0	0	58	0	0	58
24475	0	0	0	58	0	58
24476	0	0	61	0	0	61
24477	0	60	0	0	0	60
24478	59	0	0	0	0	59
24479	60	0	0	0	0	60
24480	0	0	0	60	0	60
24481	0	0	0	60	0	60
24482	0	0	0	60	0	60
24483	0	61	0	0	0	61
24484	61	0	0	0	0	61
24485	63	0	0	0	0	63
24486	0	0	64	0	0	64
24487	0	0	0	73	0	73
24488	0	0	74	1	0	75
24489	0	0	1	82	0	83
24490	0	0	0	81	0	81
24491	0	0	0	81	0	81
24492	0	0	0	79	0	79
24493	80	0	0	1	0	81
24494	80	0	0	0	0	80
24495	80	0	0	0	0	80
24496	1	0	0	79	0	80
24497	0	0	78	1	0	79
24498	79	0	1	0	0	80
24499	1	0	0	79	0	80
24500	79	0	0	1	0	80
24501	1	0	0	78	0	79
24502	0	76	0	1	0	77
24503	0	80	0	0	0	80
24504	0	1	0	78	0	79
24505	0	0	0	80	0	80
24506	0	0	0	80	0	80
24507	0	77	0	1	0	78
24508	77	1	0	0	0	78
24509	1	76	0	0	0	77
24510	0	1	76	0	0	77
24511	0	0	1	78	0	79
24512	0	84	0	1	0	85
24513	0	1	0	84	0	85
24514	0	0	0	86	0	86
24515	0	0	84	1	0	85
24516	84	0	1	0	0	85
24517	1	84	0	0	0	85
24518	85	1	0	0	0	86
24519	85	0	0	0	0	85
24520	86	0	0	0	0	86
24521	1	4	75	0	0	80
24522	0	0	1	77	0	78
24523	0	0	0	74	0	74
24524	0	0	73	1	0	74
24525	71	0	1	0	0	72
24526	1	0	72	0	0	73
24527	0	0	71	0	0	71
24528	0	77	1	0	0	78
24529	0	1	0	79	0	80
24530	0	0	79	1	0	80
24531	78	0	1	0	0	79
24532	78	0	0	1	0	79
24533	1	0	80	0	0	81
24534	0	0	1	81	0	82
24535	0	0	81	1	0	82
24536	0	76	1	0	0	77
24537	79	1	0	0	0	80
24538	80	0	0	0	0	80
24539	79	0	0	0	0	79
24540	1	0	0	78	0	79
24541	0	0	0	80	0	80
24542	0	0	77	1	0	78
24543	77	0	1	0	0	78
24544	1	0	0	76	0	77
24545	75	0	0	1	0	76
24546	1	0	72	0	0	73
24547	0	0	74	0	0	74
24548	0	0	1	69	0	70
24549	0	0	0	71	0	71
24550	0	0	70	2	0	72
24551	69	0	2	0	0	71
24552	2	0	0	72	0	74
24553	0	76	0	2	0	78
24554	78	2	0	0	0	80
24555	2	76	0	0	0	78
24556	76	2	0	0	0	78
24557	2	0	82	0	0	84
24558	0	0	81	0	0	81
24559	0	81	2	0	0	83
24560	78	2	2	1	0	83
24561	2	0	78	0	0	80
24562	76	0	2	0	0	78
24563	2	77	0	0	0	79
24564	0	2	0	77	0	79
24565	0	0	0	78	0	78
24566	0	79	0	2	0	81
24567	83	2	0	0	0	85
24568	86	0	0	0	0	86
24569	86	0	0	0	0	86
24570	2	0	83	0	0	85
24571	0	0	2	84	0	86
24572	0	0	0	86	0	86
24573	0	0	0	87	0	87
24574	0	0	85	2	0	87
24575	0	83	2	0	0	85
24576	84	2	0	0	0	86
24577	2	0	84	0	0	86
24578	83	0	2	0	0	85
24579	2	83	0	0	0	85
24580	85	2	0	0	0	87
24581	2	0	0	85	0	87
24582	85	0	0	2	0	87
24583	2	0	0	84	0	86
24584	0	0	88	2	0	90
24585	0	1	2	85	0	88
24586	0	0	86	2	0	88
24587	73	0	1	0	0	74
24588	1	74	0	0	0	75
24589	0	1	0	67	0	68
24590	0	69	0	1	0	70
24591	67	1	0	0	0	68
24592	69	0	0	0	0	69
24593	1	68	0	0	0	69
24594	69	1	0	0	0	70
24595	74	0	0	1	0	75
24596	2	0	0	70	0	72
24597	0	0	0	78	0	78
24598	84	0	0	1	0	85
24599	88	0	0	0	0	88
24600	1	0	0	87	0	88
24601	0	0	0	90	0	90
24602	91	0	0	1	0	92
24603	1	0	94	0	0	95
24604	91	0	1	0	0	92
24605	1	0	92	0	0	93
24606	0	92	1	0	0	93
24607	0	1	0	92	0	93
24608	0	0	96	1	0	97
24609	0	99	2	0	0	101
24610	99	1	0	0	0	100
24611	1	0	97	0	0	98
24612	91	0	1	0	0	92
24613	95	0	0	1	0	96
24614	97	0	0	0	0	97
24615	1	0	0	94	0	95
24616	0	99	1	1	0	101
24617	97	1	0	0	0	98
24618	1	0	98	0	0	99
24619	95	0	1	0	0	96
24620	1	0	97	0	0	98
24621	0	93	1	0	0	94
24622	0	1	0	96	0	97
24623	0	0	0	94	0	94
24624	0	94	0	1	0	95
24625	0	1	0	91	0	92
24626	0	0	95	1	0	96
24627	0	97	1	0	0	98
24628	0	1	0	95	0	96
24629	93	0	0	1	0	94
24630	98	0	0	0	0	98
24631	1	0	0	101	0	102
24632	1	104	0	1	0	106
24633	0	1	0	103	0	104
24634	1	0	0	102	0	103
24635	0	0	98	1	0	99
24636	0	100	1	0	0	101
24637	0	1	0	101	0	102
24638	0	0	100	1	0	101
24639	0	103	1	0	0	104
24640	1	1	0	103	0	105
24641	104	0	0	1	0	105
24642	1	109	1	0	0	111
24643	1	1	0	110	0	112
24644	112	0	1	1	0	114
24645	115	0	0	0	0	115
24646	115	0	0	1	0	116
24647	115	0	0	0	0	115
24648	1	0	0	114	0	115
24649	0	0	117	0	0	117
24650	1	0	0	116	0	117
24651	0	122	0	0	0	122
24652	120	0	0	0	0	120
24653	0	0	113	0	0	113
24654	114	0	0	0	0	114
24655	0	0	115	0	0	115
24656	0	0	0	117	0	117
24657	0	0	115	0	0	115
24658	1	0	0	114	0	115
24659	0	2	110	0	0	112
24660	1	0	0	114	0	115
24661	114	0	0	0	0	114
24662	0	124	0	0	0	124
24663	0	0	0	124	0	124
24664	0	0	0	123	0	123
24665	0	4	122	0	0	126
24666	0	0	124	0	0	124
24667	121	0	0	0	0	121
24668	0	125	0	0	0	125
24669	124	0	0	0	0	124
24670	126	0	0	0	0	126
24671	0	0	0	124	0	124
24672	0	122	0	0	0	122
24673	127	0	0	0	0	127
24674	130	0	0	0	0	130
24675	130	0	0	0	0	130
24676	130	0	0	0	0	130
24677	129	0	0	0	0	129
24678	0	0	129	0	0	129
24679	125	0	0	0	0	125
24680	0	0	129	0	0	129
24681	0	0	0	128	0	128
24682	1	0	0	129	0	130
24683	0	0	134	0	0	134
24684	129	0	0	0	0	129
24685	0	0	0	134	0	134
24686	0	0	0	138	0	138
24687	1	0	0	137	0	138
24688	0	0	0	138	0	138
24689	0	0	0	138	0	138
24690	0	0	137	0	0	137
24691	0	0	0	134	0	134
24692	0	0	137	0	0	137
24693	0	0	137	0	0	137
24694	137	0	0	0	0	137
24695	141	0	0	0	0	141
24696	150	0	9	0	0	159
24697	0	0	161	0	0	161
24698	0	0	158	0	0	158
24699	0	1	161	0	0	162
24700	0	166	0	0	0	166
24701	0	1	0	164	0	165
24702	169	0	0	0	0	169
24703	2	0	0	178	0	180
24704	0	181	0	2	0	183
24705	182	3	0	0	0	185
24706	3	0	0	179	0	182
24707	0	181	0	3	0	184
24708	1	3	0	179	0	183
24709	1	0	0	179	0	180
24710	173	0	0	3	0	176
24711	2	0	0	176	0	178
24712	0	0	177	3	0	180
24713	0	0	3	174	0	177
24714	0	170	0	3	0	173
24715	0	175	0	0	0	175
24716	0	3	0	167	0	170
24717	0	0	0	171	0	171
24718	0	169	0	3	0	172
24719	0	166	0	0	0	166
24720	0	178	0	0	0	178
24721	0	3	0	169	0	172
24722	0	176	0	2	0	178
24723	175	3	0	0	0	178
24724	3	0	176	0	0	179
24725	0	0	3	176	0	179
24726	0	183	0	2	0	185
24727	182	3	0	0	0	185
24728	3	0	180	0	0	183
24729	0	180	3	0	0	183
24730	179	3	0	0	0	182
24731	3	175	0	0	0	178
24732	0	180	0	0	0	180
24733	1	3	1	173	0	178
24734	0	177	0	3	0	180
24735	174	3	0	0	0	177
24736	3	0	0	175	0	178
24737	0	0	174	3	0	177
24738	0	0	171	0	0	171
24739	0	0	3	169	0	172
24740	2	0	168	3	0	173
24741	0	0	3	172	0	175
24742	165	0	0	3	0	168
24743	4	0	165	0	0	169
24744	0	0	3	165	0	168
24745	0	163	1	2	0	166
24746	0	3	0	166	0	169
24747	0	0	0	167	0	167
24748	0	164	0	4	0	168
24749	0	3	0	161	0	164
24750	0	0	0	165	0	165
24751	0	0	160	3	0	163
24752	0	157	4	1	0	162
24753	158	3	0	2	0	163
24754	3	0	0	162	0	165
24755	0	0	159	4	0	163
24756	0	0	2	157	0	159
24757	0	0	159	3	0	162
24758	158	0	3	1	0	162
24759	2	157	1	0	0	160
24760	0	3	1	157	0	161
24761	1	0	0	160	0	161
24762	156	0	0	3	0	159
24763	3	0	0	155	0	158
24764	0	0	153	3	0	156
24765	1	0	4	146	0	151
24766	0	147	1	3	0	151
24767	0	154	0	0	0	154
24768	0	149	1	1	0	151
24769	2	3	1	150	0	156
24770	0	1	150	4	0	155
24771	0	153	3	1	0	157
24772	151	3	0	0	0	154
24773	3	154	0	2	0	159
24774	154	5	0	0	0	159
24775	155	0	0	1	0	156
24776	3	0	153	2	0	158
24777	154	1	3	0	0	158
24778	162	0	0	2	0	164
24779	160	0	0	1	0	161
24780	159	0	0	1	0	160
24781	3	2	160	1	0	166
24782	159	1	4	0	0	164
24783	161	0	0	3	0	164
24784	4	163	1	1	0	169
24785	0	4	0	156	0	160
24786	1	0	0	159	0	160
24787	0	150	0	4	0	154
24788	155	4	0	0	0	159
24789	2	156	0	0	0	158
24790	154	4	0	1	0	159
24791	156	0	0	0	0	156
24792	3	155	0	0	0	158
24793	1	3	0	156	0	160
24794	0	0	155	3	0	158
24795	1	146	3	1	0	151
24796	0	4	0	131	0	135
24797	1	133	0	3	0	137
24798	0	136	0	0	0	136
24799	1	4	0	127	0	132
24800	0	0	121	3	0	124
24801	0	119	3	0	0	122
24802	0	118	0	0	0	118
24803	96	0	0	1	0	97
24804	0	0	0	101	0	101
24805	0	0	0	102	0	102
24806	0	0	0	105	0	105
24807	0	0	109	0	0	109
24808	0	0	0	109	0	109
24809	0	111	0	0	0	111
24810	114	0	0	0	0	114
24811	0	0	0	111	0	111
24812	0	0	111	0	0	111
24813	114	0	0	0	0	114
24814	0	0	0	118	0	118
24815	0	0	132	0	0	132
24816	0	0	132	0	0	132
24817	134	0	0	0	0	134
24818	143	0	0	0	0	143
24819	145	0	0	0	0	145
24820	141	0	0	1	0	142
24821	0	0	143	0	0	143
24822	0	145	0	0	0	145
24823	143	0	0	0	0	143
24824	0	136	0	0	0	136
24825	141	0	0	0	0	141
24826	0	142	1	0	0	143
24827	0	0	0	143	0	143
24828	0	0	0	141	0	141
24829	1	0	0	139	0	140
24830	0	139	0	0	0	139
24831	0	140	0	0	0	140
24832	1	0	0	136	0	137
24833	0	135	0	0	0	135
24834	0	0	135	0	0	135
24835	2	0	0	137	0	139
24836	0	0	139	0	0	139
24837	139	0	0	0	0	139
24838	138	0	0	0	0	138
24839	0	0	139	0	0	139
24840	0	0	136	0	0	136
24841	1	0	0	134	0	135
24842	0	0	138	0	0	138
24843	0	0	0	132	0	132
24844	0	132	0	0	0	132
24845	0	0	0	138	0	138
24846	0	0	0	140	0	140
24847	0	0	0	139	0	139
24848	0	0	136	0	0	136
24849	0	0	0	138	0	138
24850	1	0	0	135	0	136
24851	0	0	0	137	0	137
24852	0	138	0	0	0	138
24853	137	0	0	0	0	137
24854	136	0	0	0	0	136
24855	135	0	0	0	0	135
24856	0	0	0	135	0	135
24857	0	0	133	0	0	133
24858	0	0	133	1	0	134
24859	0	136	1	0	0	137
24860	134	1	0	0	0	135
24861	0	135	0	0	0	135
24862	134	0	0	0	0	134
24863	0	134	0	1	0	135
24864	135	0	0	1	0	136
24865	0	140	0	1	0	141
24866	0	0	1	142	0	143
24867	0	0	139	1	0	140
24868	0	1	140	0	0	141
24869	1	1	0	137	0	139
24870	0	0	0	137	0	137
24871	0	0	1	138	0	139
24872	1	0	136	0	0	137
24873	0	0	0	135	0	135
24874	134	0	1	0	0	135
24875	134	0	1	0	0	135
24876	1	132	0	0	0	133
24877	127	0	0	1	0	128
24878	1	126	0	0	0	127
24879	127	0	0	0	0	127
24880	127	0	0	0	0	127
24881	120	1	1	0	0	122
24882	2	0	125	0	0	127
24883	1	1	117	0	0	119
24884	123	0	0	0	0	123
24885	125	1	0	0	0	126
24886	1	0	0	127	0	128
24887	0	0	0	137	0	137
24888	0	1	0	138	0	139
24889	2	0	0	136	0	138
24890	0	2	0	145	0	147
24891	144	0	0	2	0	146
24892	2	2	0	141	0	145
24893	1	0	143	1	0	145
24894	140	0	0	2	0	142
24895	142	0	1	2	0	145
24896	2	144	0	0	0	146
24897	1	140	0	0	0	141
24898	134	1	1	3	0	139
24899	1	138	0	0	0	139
24900	132	0	1	4	0	137
24901	139	0	0	1	0	140
24902	138	0	1	0	0	139
24903	2	0	0	137	0	139
24904	1	138	0	0	0	139
24905	136	1	1	0	0	138
24906	1	0	1	132	0	134
24907	1	0	0	125	0	126
24908	121	0	1	1	0	123
24909	2	120	0	0	0	122
24910	0	2	0	121	0	123
24911	120	0	0	2	0	122
24912	1	119	0	1	0	121
24913	118	1	0	1	0	120
24914	1	0	116	0	0	117
24915	104	0	1	0	0	105
24916	1	104	0	0	0	105
24917	106	1	0	0	0	107
24918	103	0	0	0	0	103
24919	1	109	0	0	0	110
24920	108	1	0	1	0	110
24921	1	106	0	0	0	107
24922	113	1	0	0	0	114
24923	2	0	0	114	0	116
24924	1	0	0	114	0	115
24925	0	0	0	112	0	112
24926	0	1	105	1	0	107
24927	1	0	1	107	0	109
24928	0	0	108	2	0	110
24929	0	0	1	108	0	109
24930	1	109	0	1	0	111
24931	0	2	0	111	0	113
24932	0	0	113	2	0	115
24933	1	0	117	0	0	118
24934	0	0	1	119	0	120
24935	116	0	0	1	0	117
24936	116	0	0	0	0	116
24937	2	114	0	0	0	116
24938	0	2	0	115	0	117
24939	1	0	122	1	0	124
24940	0	0	1	125	0	126
24941	0	1	127	1	0	129
24942	125	0	1	0	0	126
24943	1	1	0	128	0	130
24944	1	1	126	1	0	129
24945	0	0	1	127	0	128
24946	1	0	0	128	0	129
24947	0	0	130	2	0	132
24948	0	0	2	123	0	125
24949	124	0	0	2	0	126
24950	124	0	1	0	0	125
24951	1	0	0	132	0	133
24952	133	1	0	1	0	135
24953	1	0	138	1	0	140
24954	0	0	139	0	0	139
24955	139	0	1	1	0	141
24956	143	0	0	1	0	144
24957	2	0	0	141	0	143
24958	1	0	0	143	0	144
24959	0	1	143	1	0	145
24960	0	0	1	141	0	142
24961	0	140	1	1	0	142
24962	140	1	0	2	0	143
24963	153	0	1	0	0	154
24964	1	150	0	0	0	151
24965	147	1	0	1	0	149
24966	145	0	1	0	0	146
24967	1	149	0	1	0	151
24968	143	1	0	2	0	146
24969	0	149	1	0	0	150
24970	149	1	0	1	0	151
24971	2	0	149	0	0	151
24972	0	0	1	147	0	148
24973	0	0	0	154	0	154
24974	1	0	0	156	0	157
24975	154	0	1	1	0	156
24976	1	0	1	166	0	168
24977	3	0	165	0	0	168
24978	163	0	1	0	0	164
24979	1	0	0	164	0	165
24980	0	163	1	2	0	166
24981	0	170	1	0	0	171
24982	0	1	0	169	0	170
24983	1	1	0	166	0	168
24984	1	0	0	167	0	168
24985	1	0	166	0	0	167
24986	1	159	0	0	0	160
24987	151	0	0	1	0	152
24988	147	1	0	1	0	149
24989	0	156	1	0	0	157
24990	1	148	0	0	0	149
24991	0	1	0	148	0	149
24992	1	0	143	1	0	145
24993	143	0	2	0	0	145
24994	145	1	0	1	0	147
24995	1	0	0	146	0	147
24996	1	0	0	146	0	147
24997	141	1	0	0	0	142
24998	0	2	137	1	0	140
24999	136	0	1	1	0	138
25000	1	136	1	0	0	138
25001	1	0	0	132	0	133
25002	1	127	0	1	0	129
25003	131	0	0	1	0	132
25004	0	0	0	128	0	128
25005	1	0	0	132	0	133
25006	0	133	1	0	0	134
25007	133	0	0	0	0	133
25008	134	1	0	0	0	135
25009	0	0	133	1	0	134
25010	0	1	124	0	0	125
25011	128	0	0	0	0	128
25012	0	0	127	1	0	128
25013	0	0	135	0	0	135
25014	127	1	0	0	0	128
25015	1	0	146	0	0	147
25016	1	0	1	147	0	149
25017	0	0	1	149	0	150
25018	159	0	1	1	0	161
25019	2	0	163	0	0	165
25020	172	0	3	0	0	175
25021	2	0	1	171	0	174
25022	170	0	0	2	0	172
25023	169	0	1	1	0	171
25024	172	0	0	1	0	173
25025	2	0	0	171	0	173
25026	173	0	0	2	0	175
25027	1	1	1	171	0	174
25028	2	0	0	171	0	173
25029	1	0	0	172	0	173
25030	1	1	0	171	0	173
25031	168	0	0	2	0	170
25032	170	1	0	0	0	171
25033	3	0	164	1	0	168
25034	164	0	4	0	0	168
25035	166	0	1	2	0	169
25036	4	0	0	167	0	171
25037	0	166	1	5	0	172
25038	168	3	1	1	0	173
25039	4	0	0	157	0	161
25040	157	0	2	3	0	162
25041	4	153	1	1	0	159
25042	157	2	0	2	0	161
25043	5	1	0	155	0	161
25044	0	152	1	3	0	156
25045	156	4	0	1	0	161
25046	3	154	0	2	0	159
25047	1	156	0	3	0	160
25048	158	2	1	0	0	161
25049	4	2	157	0	0	163
25050	159	0	3	1	0	163
25051	5	0	0	156	0	161
25052	0	1	156	4	0	161
25053	1	1	3	151	0	156
25054	0	1	0	152	0	153
25055	0	1	147	4	0	152
25056	150	0	3	0	0	153
25057	4	0	1	148	0	153
25058	2	0	1	149	0	152
25059	1	0	0	150	0	151
25060	147	0	1	3	0	151
25061	3	0	146	2	0	151
25062	1	1	146	1	0	149
25063	1	0	3	135	0	139
25064	1	0	131	4	0	136
25065	135	0	3	1	0	139
25066	2	135	1	1	0	139
25067	134	3	0	1	0	138
25068	4	0	0	130	0	134
25069	1	132	0	3	0	136
25070	2	4	0	129	0	135
25071	1	133	0	4	0	138
25072	1	5	1	133	0	140
25073	3	0	131	3	0	137
25074	0	0	128	1	0	129
25075	1	127	4	1	0	133
25076	115	3	0	2	0	120
25077	3	0	1	118	0	122
25078	1	0	0	120	0	121
25079	116	0	0	3	0	119
25080	114	0	2	1	0	117
25081	6	0	0	109	0	115
25082	1	0	109	4	0	114
25083	0	110	3	1	0	114
25084	0	4	0	110	0	114
25085	2	0	0	109	0	111
25086	0	110	1	3	0	114
25087	114	3	1	0	0	118
25088	3	1	112	1	0	117
25089	1	0	4	105	0	110
25090	1	0	0	108	0	109
25091	0	2	104	3	0	109
25092	2	0	3	105	0	110
25093	107	1	0	4	0	112
25094	109	2	0	0	0	111
25095	107	0	0	1	0	108
25096	3	108	1	1	0	113
25097	111	3	1	1	0	116
25098	4	0	1	111	0	116
25099	0	0	2	113	0	115
25100	0	113	0	6	0	119
25101	128	4	0	2	0	134
25102	134	0	1	1	0	136
25103	137	0	1	1	0	139
25104	134	0	1	2	0	137
25105	133	0	0	2	0	135
25106	4	0	127	2	0	133
25107	130	0	5	0	0	135
25108	130	2	1	0	0	133
25109	127	0	0	1	0	128
25110	4	0	0	125	0	129
25111	1	0	1	126	0	128
25112	0	0	126	4	0	130
25113	111	2	3	0	0	116
25114	4	117	0	1	0	122
25115	0	100	1	0	0	101
25116	0	3	93	0	0	96
25117	0	90	2	0	0	92
25118	1	83	0	0	0	84
25119	1	5	0	64	0	70
25120	0	66	0	1	0	67
25121	67	2	0	0	0	69
25122	68	0	0	0	0	68
25123	2	0	0	65	0	67
25124	0	0	66	2	0	68
25125	65	1	2	0	0	68
25126	2	0	64	1	0	67
25127	0	0	67	1	0	68
25128	0	3	2	60	0	65
25129	1	0	0	65	0	66
25130	0	0	65	2	0	67
25131	0	62	1	1	0	64
25132	0	68	0	1	0	69
25133	64	1	3	0	0	68
25134	65	0	0	1	0	66
25135	2	0	66	0	0	68
25136	65	0	1	0	0	66
25137	64	0	0	0	0	64
25138	1	1	0	60	0	62
25139	2	0	0	62	0	64
25140	1	0	0	63	0	64
25141	61	0	0	2	0	63
25142	62	1	0	0	0	63
25143	62	0	0	0	0	62
25144	2	0	0	61	0	63
25145	1	0	60	0	0	61
25146	61	0	1	0	0	62
25147	61	0	0	0	0	61
25148	1	0	1	59	0	61
25149	1	60	0	1	0	62
25150	1	1	0	59	0	61
25151	1	63	0	1	0	65
25152	0	1	0	61	0	62
25153	0	61	0	2	0	63
25154	62	0	0	0	0	62
25155	1	0	0	60	0	61
25156	0	61	0	1	0	62
25157	1	2	59	0	0	62
25158	61	0	1	0	0	62
25159	2	0	0	61	0	63
25160	1	61	0	1	0	63
25161	1	1	0	60	0	62
25162	0	56	1	0	0	57
25163	1	61	0	0	0	62
25164	62	1	0	0	0	63
25165	63	0	0	0	0	63
25166	1	0	62	1	0	64
25167	63	0	0	1	0	64
25168	61	1	1	0	0	63
25169	2	61	0	0	0	63
25170	1	2	0	61	0	64
25171	0	1	0	61	0	62
25172	0	0	60	1	0	61
25173	0	1	55	0	0	56
25174	59	1	1	0	0	61
25175	60	0	0	1	0	61
25176	61	1	0	0	0	62
25177	2	0	58	0	0	60
25178	1	0	1	56	0	58
25179	57	0	0	2	0	59
25180	1	0	1	57	0	59
25181	1	0	55	1	0	57
25182	57	0	2	0	0	59
25183	1	0	61	0	0	62
25184	0	59	1	1	0	61
25185	59	1	0	1	0	61
25186	1	0	58	0	0	59
25187	1	1	1	56	0	59
25188	57	1	0	1	0	59
25189	2	0	0	56	0	58
25190	58	0	0	1	0	59
25191	1	0	1	57	0	59
25192	59	0	0	1	0	60
25193	59	0	0	0	0	59
25194	58	0	0	1	0	59
25195	57	0	0	1	0	58
25196	1	0	0	59	0	60
25197	1	0	53	1	0	55
25198	1	0	53	0	0	54
25199	1	55	1	0	0	57
25200	0	49	0	1	0	50
25201	34	1	1	0	0	36
25202	0	0	1	33	0	34
25203	0	0	32	0	0	32
25204	0	0	34	0	0	34
25205	0	0	0	34	0	34
25206	34	0	0	0	0	34
25207	0	36	0	0	0	36
25208	38	0	0	0	0	38
25209	0	0	0	41	0	41
25210	0	0	0	40	0	40
25211	0	0	0	41	0	41
25212	0	0	38	0	0	38
25213	0	0	37	0	0	37
25214	0	39	0	0	0	39
25215	0	0	0	41	0	41
25216	41	0	0	0	0	41
25217	0	0	40	0	0	40
25218	0	0	42	0	0	42
25219	0	0	0	45	0	45
25220	0	0	0	47	0	47
25221	0	0	0	48	0	48
25222	0	0	0	52	0	52
25223	54	0	0	0	0	54
25224	0	0	0	52	0	52
25225	54	0	0	0	0	54
25226	0	0	59	0	0	59
25227	0	58	0	0	0	58
25228	1	0	0	57	0	58
25229	0	0	63	0	0	63
25230	0	0	70	0	0	70
25231	0	71	0	0	0	71
25232	0	0	0	69	0	69
25233	0	0	0	67	0	67
25234	0	0	67	0	0	67
25235	68	0	0	0	0	68
25236	0	0	0	67	0	67
25237	0	0	0	67	0	67
25238	0	0	67	0	0	67
25239	0	68	0	0	0	68
25240	0	72	0	0	0	72
25241	74	0	0	0	0	74
25242	0	0	0	75	0	75
25243	80	0	0	0	0	80
25244	0	0	80	0	0	80
25245	0	0	0	78	0	78
25246	80	0	0	0	0	80
25247	80	0	0	0	0	80
25248	0	0	0	81	0	81
25249	0	0	82	0	0	82
25250	0	0	80	0	0	80
25251	0	0	0	79	0	79
25252	0	0	78	0	0	78
25253	79	0	0	0	0	79
25254	0	77	0	0	0	77
25255	77	0	1	0	0	78
25256	78	0	0	0	0	78
25257	0	0	0	78	0	78
25258	0	0	0	77	0	77
25259	79	0	0	0	0	79
25260	0	0	0	78	0	78
25261	0	0	79	0	0	79
25262	0	80	0	0	0	80
25263	0	0	0	79	0	79
25264	0	0	0	77	0	77
25265	0	0	0	78	0	78
25266	0	0	77	0	0	77
25267	0	75	0	0	0	75
25268	0	0	0	76	0	76
25269	0	0	76	0	0	76
25270	0	0	0	77	0	77
25271	78	0	0	0	0	78
25272	0	0	0	80	0	80
25273	0	0	81	0	0	81
25274	81	0	0	0	0	81
25275	0	80	0	0	0	80
25276	0	80	0	0	0	80
25277	83	0	0	0	0	83
25278	0	0	83	0	0	83
25279	0	0	0	79	0	79
25280	0	0	0	83	0	83
25281	0	0	84	0	0	84
25282	0	84	0	0	0	84
25283	0	0	0	71	0	71
25284	0	0	81	0	0	81
25285	0	0	0	78	0	78
25286	80	0	0	0	0	80
25287	0	0	80	0	0	80
25288	0	0	0	80	0	80
25289	0	0	0	77	0	77
25290	0	0	78	0	0	78
25291	0	0	0	79	0	79
25292	0	68	1	0	0	69
25293	0	0	0	73	0	73
25294	0	76	0	0	0	76
25295	75	0	0	0	0	75
25296	74	0	0	0	0	74
25297	0	0	74	0	0	74
25298	0	0	77	0	0	77
25299	0	0	75	0	0	75
25300	0	75	0	0	0	75
25301	0	0	0	78	0	78
25302	0	0	79	0	0	79
25303	0	0	0	78	0	78
25304	0	0	0	77	0	77
25305	0	0	80	0	0	80
25306	0	0	0	79	0	79
25307	0	0	0	77	0	77
25308	0	80	0	0	0	80
25309	0	0	0	77	0	77
25310	0	0	0	78	0	78
25311	0	0	82	0	0	82
25312	0	0	0	81	0	81
25313	0	0	82	0	0	82
25314	0	0	79	0	0	79
25315	79	0	0	0	0	79
25316	0	1	0	78	0	79
25317	0	79	0	0	0	79
25318	0	76	0	0	0	76
25319	0	0	0	75	0	75
25320	0	0	75	0	0	75
25321	0	74	0	0	0	74
25322	0	1	0	69	0	70
25323	0	0	76	0	0	76
25324	0	77	0	0	0	77
25325	79	0	0	0	0	79
25326	75	0	0	0	0	75
25327	76	0	0	1	0	77
25328	0	0	0	84	0	84
25329	0	0	0	81	0	81
25330	0	0	0	77	0	77
25331	0	0	75	0	0	75
25332	79	0	0	0	0	79
25333	0	0	0	79	0	79
25334	0	0	78	0	0	78
25335	80	0	0	0	0	80
25336	82	0	0	0	0	82
25337	0	0	72	0	0	72
25338	87	0	0	1	0	88
25339	0	90	0	0	0	90
25340	0	0	87	0	0	87
25341	83	0	0	0	0	83
25342	0	85	0	0	0	85
25343	1	0	0	79	0	80
25344	0	83	0	0	0	83
25345	0	0	0	85	0	85
25346	0	0	83	0	0	83
25347	79	0	0	0	0	79
25348	0	0	83	0	0	83
25349	0	80	0	0	0	80
25350	0	82	0	0	0	82
25351	81	0	0	0	0	81
25352	0	0	79	0	0	79
25353	0	0	0	79	0	79
25354	0	0	82	0	0	82
25355	0	80	1	0	0	81
25356	0	0	0	80	0	80
25357	0	82	0	0	0	82
25358	84	0	0	0	0	84
25359	84	0	0	0	0	84
25360	84	0	0	0	0	84
25361	0	0	82	0	0	82
25362	0	0	84	0	0	84
25363	81	0	0	0	0	81
25364	0	0	85	0	0	85
25365	0	0	0	82	0	82
25366	0	84	0	0	0	84
25367	86	0	0	0	0	86
25368	84	0	0	0	0	84
25369	86	0	0	0	0	86
25370	0	0	0	86	0	86
25371	1	0	0	85	0	86
25372	84	0	0	0	0	84
25373	0	84	0	0	0	84
25374	83	0	0	0	0	83
25375	0	0	0	83	0	83
25376	0	0	0	84	0	84
25377	82	0	0	0	0	82
25378	0	81	0	0	0	81
25379	82	0	0	0	0	82
25380	0	82	0	0	0	82
25381	83	0	0	0	0	83
25382	0	0	0	99	0	99
25383	101	0	0	1	0	102
25384	110	0	0	0	0	110
25385	129	0	0	0	0	129
25386	2	132	0	0	0	134
25387	0	3	129	0	0	132
25388	132	0	3	0	0	135
25389	134	0	0	0	0	134
25390	2	134	0	0	0	136
25391	0	3	0	134	0	137
25392	0	0	0	138	0	138
25393	134	0	0	4	0	138
25394	4	0	0	134	0	138
25395	0	0	136	5	0	141
25396	0	0	137	0	0	137
25397	136	0	5	0	0	141
25398	5	0	0	135	0	140
25399	1	0	0	138	0	139
25400	0	0	0	140	0	140
25401	0	1	134	5	0	140
25402	1	0	5	132	0	138
25403	0	0	0	140	0	140
25404	0	0	0	140	0	140
25405	136	0	0	7	0	143
25406	7	0	0	137	0	144
25407	2	1	134	6	0	143
25408	139	1	7	1	0	148
25409	7	0	143	0	0	150
25410	150	0	6	0	0	156
25411	145	1	0	0	0	146
25412	6	0	0	149	0	155
25413	0	150	0	7	0	157
25414	0	6	0	157	0	163
25415	1	0	1	159	0	161
25416	0	155	1	4	0	160
25417	159	4	2	1	0	166
25418	6	158	1	3	0	168
25419	162	6	0	1	0	169
25420	166	0	0	3	0	169
25421	6	1	1	165	0	173
25422	1	0	2	161	0	164
25423	1	1	153	7	0	162
25424	3	0	154	2	0	159
25425	148	2	5	2	0	157
25426	155	0	0	3	0	158
25427	7	143	0	2	0	152
25428	1	6	1	144	0	152
25429	1	0	149	7	0	157
25430	1	1	9	151	0	162
25431	150	1	3	6	0	160
25432	154	1	0	0	0	155
25433	8	149	0	2	0	159
25434	1	8	0	149	0	158
25435	0	1	0	158	0	159
25436	1	0	2	155	0	158
25437	0	1	143	9	0	153
25438	135	0	7	1	0	143
25439	142	1	0	0	0	143
25440	8	2	136	0	0	146
25441	2	138	6	2	0	148
25442	136	5	1	3	0	145
25443	140	0	2	3	0	145
25444	6	0	134	2	0	142
25445	3	0	143	0	0	146
25446	4	0	6	136	0	146
25447	2	1	139	6	0	148
25448	137	3	6	1	0	147
25449	145	1	0	3	0	149
25450	146	0	1	2	0	149
25451	6	1	3	134	0	144
25452	3	140	0	7	0	150
25453	141	6	0	1	0	148
25454	148	1	3	0	0	152
25455	9	1	140	1	0	151
25456	4	0	141	3	0	148
25457	132	0	5	4	0	141
25458	6	1	3	137	0	147
25459	1	1	139	7	0	148
25460	4	137	6	2	0	149
25461	3	7	2	136	0	148
25462	135	2	2	6	0	145
25463	8	138	0	1	0	147
25464	5	6	1	137	0	149
25465	2	132	1	9	0	144
25466	0	142	3	1	0	146
25467	2	7	1	142	0	152
25468	1	0	2	143	0	146
25469	2	136	3	6	0	147
25470	141	7	1	1	0	150
25471	10	0	138	2	0	150
25472	138	2	7	2	0	149
25473	7	2	0	140	0	149
25474	2	1	1	145	0	149
25475	2	0	1	149	0	152
25476	3	2	1	142	0	148
25477	3	1	141	6	0	151
25478	2	1	8	141	0	152
25479	2	0	1	147	0	150
25480	0	152	2	8	0	162
25481	0	6	158	4	0	168
25482	0	160	8	2	0	170
25483	3	6	164	2	0	175
25484	4	160	5	0	0	169
25485	1	4	2	140	0	147
25486	139	1	0	5	0	145
25487	3	144	0	1	0	148
25488	1	2	1	147	0	151
25489	0	1	146	3	0	150
25490	0	146	5	1	0	152
25491	144	2	0	1	0	147
25492	148	0	1	1	0	150
25493	4	147	0	0	0	151
25494	1	2	144	0	0	147
25495	145	0	1	1	0	147
25496	1	0	1	146	0	148
25497	142	2	0	1	0	145
25498	3	151	1	0	0	155
25499	2	156	0	0	0	158
25500	0	2	156	0	0	158
25501	161	0	3	1	0	165
25502	2	0	0	166	0	168
25503	162	0	0	2	0	164
25504	1	165	1	0	0	167
25505	163	3	0	0	0	166
25506	166	2	0	1	0	169
25507	3	0	169	0	0	172
25508	2	163	1	0	0	166
25509	0	162	1	1	0	164
25510	2	3	0	143	0	148
25511	0	149	1	1	0	151
25512	145	1	0	0	0	146
25513	2	146	0	0	0	148
25514	1	1	0	139	0	141
25515	0	142	0	1	0	143
25516	0	139	0	0	0	139
25517	0	141	0	0	0	141
25518	0	2	0	140	0	142
25519	0	1	0	142	0	143
25520	0	0	1	139	0	140
25521	0	136	0	2	0	138
25522	0	1	137	1	0	139
25523	1	1	136	0	0	138
25524	134	1	2	0	0	137
25525	1	0	1	138	0	140
25526	2	0	137	1	0	140
25527	0	0	137	3	0	140
25528	1	138	1	0	0	140
25529	0	2	1	133	0	136
25530	0	2	0	135	0	137
25531	134	0	1	1	0	136
25532	2	0	0	135	0	137
25533	1	0	0	133	0	134
25534	1	0	133	2	0	136
25535	1	1	1	134	0	137
25536	2	0	1	140	0	143
25537	1	0	137	2	0	140
25538	0	0	136	1	0	137
25539	0	140	2	0	0	142
25540	0	2	140	0	0	142
25541	0	1	1	138	0	140
25542	0	1	1	132	0	134
25543	1	0	140	2	0	143
25544	0	137	1	1	0	139
25545	132	1	0	1	0	134
25546	1	135	0	0	0	136
25547	1	2	0	136	0	139
25548	0	2	0	138	0	140
25549	0	134	0	2	0	136
25550	0	1	0	138	0	139
25551	0	1	0	137	0	138
25552	0	1	132	2	0	135
25553	0	130	2	1	0	133
25554	0	1	2	131	0	134
25555	1	1	131	1	0	134
25556	0	0	1	133	0	134
25557	0	0	2	132	0	134
25558	1	0	1	133	0	135
25559	0	1	0	133	0	134
25560	0	0	0	132	0	132
25561	0	131	0	3	0	134
25562	131	1	0	1	0	133
25563	1	1	127	0	0	129
25564	122	0	1	1	0	124
25565	1	0	134	0	0	135
25566	1	137	1	1	0	140
25567	0	1	134	1	0	136
25568	0	134	2	0	0	136
25569	0	1	2	130	0	133
25570	0	2	0	130	0	132
25571	0	133	1	2	0	136
25572	0	134	0	2	0	136
25573	138	1	0	1	0	140
25574	140	1	1	0	0	142
25575	139	1	0	1	0	141
25576	141	0	0	0	0	141
25577	3	1	0	136	0	140
25578	1	132	0	2	0	135
25579	134	1	0	1	0	136
25580	1	2	0	121	0	124
25581	115	0	0	2	0	117
25582	111	0	0	2	0	113
25583	2	100	1	0	0	103
25584	1	96	0	0	0	97
25585	0	98	0	1	0	99
25586	2	5	1	93	0	101
25587	0	100	0	1	0	101
25588	97	1	0	1	0	99
25589	99	1	0	0	0	100
25590	99	0	0	1	0	100
25591	98	0	0	0	0	98
25592	99	0	0	0	0	99
25593	1	0	105	0	0	106
25594	106	0	0	0	0	106
25595	0	0	104	0	0	104
25596	106	0	0	0	0	106
25597	0	0	1	107	0	108
25598	1	0	105	1	0	107
25599	0	1	109	1	0	111
25600	0	121	1	1	0	123
25601	116	1	2	0	0	119
25602	125	1	0	0	0	126
25603	2	139	0	0	0	141
25604	0	1	0	155	0	156
25605	168	0	0	1	0	169
25606	2	0	174	0	0	176
25607	0	171	3	0	0	174
25608	167	3	0	0	0	170
25609	3	173	0	0	0	176
25610	1	3	0	169	0	173
25611	0	173	0	3	0	176
25612	1	3	0	169	0	173
25613	0	171	0	3	0	174
25614	0	173	0	0	0	173
25615	170	3	0	0	0	173
25616	175	0	0	1	0	176
25617	3	0	175	0	0	178
25618	0	0	177	0	0	177
25619	0	1	171	0	0	172
25620	1	0	3	178	0	182
25621	1	0	179	3	0	183
25622	0	1	3	179	0	183
25623	0	0	0	179	0	179
25624	1	176	0	3	0	180
25625	178	4	0	1	0	183
25626	3	179	0	0	0	182
25627	1	3	0	187	0	191
25628	0	1	0	189	0	190
25629	0	0	0	189	0	189
25630	0	1	186	3	0	190
25631	0	0	3	187	0	190
25632	1	1	0	193	0	195
25633	0	1	0	193	0	194
25634	1	0	189	3	0	193
25635	1	188	3	0	0	192
25636	185	2	1	0	0	188
25637	189	0	1	0	0	190
25638	3	189	1	0	0	193
25639	0	3	0	190	0	193
25640	0	0	1	196	0	197
25641	0	0	192	4	0	196
25642	0	192	3	0	0	195
25643	0	4	0	192	0	196
25644	1	0	192	3	0	196
25645	0	1	3	189	0	193
25646	0	0	0	191	0	191
25647	0	0	194	4	0	198
25648	0	0	3	194	0	197
25649	0	0	1	193	0	194
25650	0	0	198	4	0	202
25651	1	0	3	198	0	202
25652	0	0	0	200	0	200
25653	0	0	1	202	0	203
25654	0	1	204	3	0	208
25655	2	0	3	200	0	205
25656	201	0	0	3	0	204
25657	202	1	0	0	0	203
25658	3	200	2	0	0	205
25659	202	3	0	1	0	206
25660	3	0	213	0	0	216
25661	0	0	3	219	0	222
25662	0	0	0	220	0	220
25663	0	0	1	221	0	222
25664	214	0	0	4	0	218
25665	3	213	0	1	0	217
25666	0	3	0	209	0	212
25667	0	211	0	4	0	215
25668	212	3	0	1	0	216
25669	3	208	1	0	0	212
25670	207	2	0	2	0	211
25671	3	205	0	1	0	209
25672	0	209	0	1	0	210
25673	0	3	1	209	0	213
25674	0	0	0	212	0	212
25675	1	0	0	209	0	210
25676	1	0	0	208	0	209
25677	0	1	206	3	0	210
25678	1	205	3	0	0	209
25679	0	3	1	198	0	202
25680	0	200	0	4	0	204
25681	0	3	202	1	0	206
25682	0	0	3	196	0	199
25683	1	0	0	205	0	206
25684	0	1	201	3	0	205
25685	0	195	3	0	0	198
25686	0	4	0	193	0	197
25687	1	0	191	3	0	195
25688	0	193	3	0	0	196
25689	1	3	0	190	0	194
25690	0	1	189	3	0	193
25691	0	1	193	0	0	194
25692	0	190	3	1	0	194
25693	0	204	0	1	0	205
25694	0	4	0	205	0	209
25695	0	0	0	217	0	217
25696	0	0	212	6	0	218
25697	206	0	6	0	0	212
25698	207	0	0	0	0	207
25699	6	0	197	0	0	203
25700	0	192	5	0	0	197
25701	0	197	0	0	0	197
25702	0	194	0	0	0	194
25703	0	154	1	0	0	155
25704	5	4	0	168	0	177
25705	0	0	2	189	0	191
25706	0	0	0	191	0	191
25707	0	0	0	198	0	198
25708	0	191	0	7	0	198
25709	0	6	0	188	0	194
25710	0	188	0	7	0	195
25711	0	6	0	194	0	200
25712	196	1	0	7	0	204
25713	6	0	0	197	0	203
25714	1	199	0	6	0	206
25715	0	6	0	199	0	205
25716	0	3	0	204	0	207
25717	0	0	0	208	0	208
25718	196	0	0	8	0	204
25719	7	0	0	200	0	207
25720	0	0	196	7	0	203
25721	0	197	6	1	0	204
25722	0	7	1	200	0	208
25723	0	3	0	206	0	209
25724	1	1	0	209	0	211
25725	200	0	0	9	0	209
25726	6	0	194	3	0	203
25727	1	1	6	186	0	194
25728	0	192	1	8	0	201
25729	0	7	0	195	0	202
25730	186	1	0	8	0	195
25731	7	193	0	1	0	201
25732	1	6	0	191	0	198
25733	1	1	1	195	0	198
25734	0	185	0	7	0	192
25735	0	7	0	187	0	194
25736	0	1	0	194	0	195
25737	0	0	181	9	0	190
25738	1	181	6	2	0	190
25739	185	6	2	1	0	194
25740	6	1	180	3	0	190
25741	178	1	7	1	0	187
25742	7	1	177	1	0	186
25743	3	0	7	180	0	190
25744	179	1	1	8	0	189
25745	6	0	0	183	0	189
25746	184	0	0	9	0	193
25747	185	1	1	3	0	190
25748	182	1	1	3	0	187
25749	7	178	0	2	0	187
25750	1	6	1	179	0	187
25751	2	3	0	181	0	186
25752	1	1	1	185	0	188
25753	1	0	176	10	0	187
25754	1	1	8	176	0	186
25755	174	2	2	9	0	187
25756	183	1	0	4	0	188
25757	8	1	174	3	0	186
25758	178	0	7	3	0	188
25759	182	2	2	1	0	187
25760	9	1	0	165	0	175
25761	161	0	2	8	0	171
25762	166	3	0	2	0	171
25763	8	0	2	162	0	172
25764	162	1	0	10	0	173
25765	166	0	1	3	0	170
25766	8	2	2	158	0	170
25767	4	0	144	8	0	156
25768	158	0	8	3	0	169
25769	9	1	158	2	0	170
25770	2	1	165	1	0	169
25771	2	158	7	4	0	171
25772	4	6	1	155	0	166
25773	2	1	0	166	0	169
25774	2	0	2	163	0	167
25775	3	2	156	8	0	169
25776	3	0	160	4	0	167
25777	2	158	7	3	0	170
25778	2	6	3	157	0	168
25779	1	2	1	166	0	170
25780	2	0	1	168	0	171
25781	3	0	159	7	0	169
25782	4	155	7	2	0	168
25783	2	6	4	157	0	169
25784	2	1	157	8	0	168
25785	4	0	164	2	0	170
25786	157	0	8	3	0	168
25787	164	0	2	2	0	168
25788	162	1	1	1	0	165
25789	10	2	1	151	0	164
25790	3	2	152	5	0	162
25791	1	150	6	4	0	161
25792	1	159	1	3	0	164
25793	1	4	135	3	0	143
25794	2	5	6	124	0	137
25795	0	0	3	122	0	125
25796	2	115	2	6	0	125
25797	1	117	3	2	0	123
25798	118	4	3	1	0	126
25799	123	3	0	1	0	127
25800	117	0	0	3	0	120
25801	117	0	2	1	0	120
25802	107	0	2	2	0	111
25803	6	106	2	0	0	114
25804	1	74	1	2	0	78
25805	1	58	0	1	0	60
25806	50	2	0	3	0	55
25807	0	1	3	47	0	51
25808	0	2	0	45	0	47
25809	44	1	1	1	0	47
25810	0	45	2	0	0	47
25811	0	0	1	45	0	46
25812	1	0	1	45	0	47
25813	1	0	1	43	0	45
25814	44	1	0	0	0	45
25815	2	0	0	43	0	45
25816	2	0	42	0	0	44
25817	41	1	0	0	0	42
25818	1	1	0	40	0	42
25819	0	0	39	0	0	39
25820	0	39	0	1	0	40
25821	0	43	0	1	0	44
25822	38	0	3	0	0	41
25823	39	1	0	0	0	40
25824	1	39	0	0	0	40
25825	0	0	0	41	0	41
25826	42	0	0	1	0	43
25827	0	0	0	48	0	48
25828	0	0	0	50	0	50
25829	0	0	0	51	0	51
25830	0	0	0	50	0	50
25831	0	50	0	0	0	50
25832	0	0	0	50	0	50
25833	0	0	0	50	0	50
25834	0	0	0	48	0	48
25835	0	0	48	0	0	48
25836	0	49	0	0	0	49
25837	0	0	0	49	0	49
25838	0	0	48	0	0	48
25839	0	0	44	0	0	44
25840	0	46	0	0	0	46
25841	46	0	0	0	0	46
25842	0	0	0	47	0	47
25843	47	0	0	0	0	47
25844	0	47	0	0	0	47
25845	0	0	0	47	0	47
25846	45	0	0	0	0	45
25847	45	0	0	0	0	45
25848	0	0	0	45	0	45
25849	0	0	0	45	0	45
25850	0	0	42	0	0	42
25851	0	0	0	43	0	43
25852	0	0	0	41	0	41
25853	43	0	0	0	0	43
25854	0	44	0	0	0	44
25855	0	0	41	0	0	41
25856	40	0	0	0	0	40
25857	0	41	0	0	0	41
25858	0	0	0	40	0	40
25859	41	0	0	0	0	41
25860	0	0	0	40	0	40
25861	0	0	0	41	0	41
25862	0	0	41	0	0	41
25863	0	0	0	41	0	41
25864	41	0	0	0	0	41
25865	0	0	0	41	0	41
25866	41	0	0	0	0	41
25867	1	40	0	0	0	41
25868	0	42	0	0	0	42
25869	0	0	0	41	0	41
25870	0	0	0	43	0	43
25871	42	0	0	0	0	42
25872	0	42	0	0	0	42
25873	42	0	0	0	0	42
25874	41	0	0	0	0	41
25875	0	0	0	42	0	42
25876	42	0	0	0	0	42
25877	0	0	40	0	0	40
25878	0	0	0	40	0	40
25879	0	0	40	0	0	40
25880	0	0	0	40	0	40
25881	39	0	0	0	0	39
25882	40	0	0	0	0	40
25883	0	39	0	0	0	39
25884	0	0	0	39	0	39
25885	0	0	0	39	0	39
25886	0	41	0	0	0	41
25887	0	0	0	42	0	42
25888	0	0	0	42	0	42
25889	0	43	0	0	0	43
25890	40	0	0	0	0	40
25891	41	0	0	0	0	41
25892	0	0	0	41	0	41
25893	0	0	0	41	0	41
25894	0	0	41	0	0	41
25895	0	0	0	41	0	41
25896	0	40	0	0	0	40
25897	43	0	0	0	0	43
25898	0	0	0	41	0	41
25899	0	0	0	41	0	41
25900	41	0	0	0	0	41
25901	0	42	0	0	0	42
25902	0	0	0	44	0	44
25903	0	0	0	42	0	42
25904	0	44	0	0	0	44
25905	44	0	0	0	0	44
25906	0	0	44	0	0	44
25907	0	0	43	0	0	43
25908	0	0	0	45	0	45
25909	0	0	45	0	0	45
25910	45	0	0	0	0	45
25911	0	0	0	45	0	45
25912	0	0	45	0	0	45
25913	0	0	41	0	0	41
25914	0	44	0	0	0	44
25915	45	0	0	0	0	45
25916	0	44	0	0	0	44
25917	45	0	0	0	0	45
25918	46	0	0	0	0	46
25919	0	42	0	0	0	42
25920	42	0	0	0	0	42
25921	39	0	0	0	0	39
25922	0	0	38	0	0	38
25923	0	2	0	33	0	35
25924	0	35	0	0	0	35
25925	0	34	0	0	0	34
25926	1	1	0	29	0	31
25927	24	0	1	0	0	25
25928	0	0	0	23	0	23
25929	0	0	0	22	0	22
25930	0	0	0	22	0	22
25931	0	22	0	0	0	22
25932	0	0	0	26	0	26
25933	0	0	29	1	0	30
25934	31	0	1	0	0	32
25935	30	0	0	0	0	30
25936	1	29	0	0	0	30
25937	33	1	0	0	0	34
25938	1	0	0	34	0	35
25939	0	0	34	1	0	35
25940	34	0	0	0	0	34
25941	1	34	0	0	0	35
25942	0	1	0	35	0	36
25943	36	0	0	1	0	37
25944	1	35	0	0	0	36
25945	0	36	0	0	0	36
25946	34	1	0	0	0	35
25947	1	0	32	0	0	33
25948	33	0	1	0	0	34
25949	1	0	0	33	0	34
25950	0	0	0	34	0	34
25951	0	0	33	1	0	34
25952	0	0	36	0	0	36
25953	0	0	1	34	0	35
25954	0	0	34	1	0	35
25955	0	0	36	0	0	36
25956	0	0	0	34	0	34
25957	0	0	0	33	0	33
25958	34	0	0	1	0	35
25959	1	0	0	34	0	35
25960	34	0	0	1	0	35
25961	1	34	0	0	0	35
25962	0	1	0	34	0	35
25963	0	0	34	0	0	34
25964	33	0	1	0	0	34
25965	33	0	0	0	0	33
25966	34	0	0	0	0	34
25967	33	0	0	0	0	33
25968	33	0	0	0	0	33
25969	1	0	0	32	0	33
25970	0	0	31	1	0	32
25971	0	0	33	0	0	33
25972	0	0	36	0	0	36
25973	33	0	1	0	0	34
25974	37	0	0	0	0	37
25975	1	0	0	35	0	36
25976	0	38	0	1	0	39
25977	0	1	0	38	0	39
25978	0	0	37	1	0	38
25979	0	0	37	0	0	37
25980	36	0	1	0	0	37
25981	1	0	38	0	0	39
25982	0	0	1	36	0	37
25983	40	0	0	1	0	41
25984	37	0	0	0	0	37
25985	38	0	0	0	0	38
25986	40	0	1	0	0	41
25987	1	0	39	0	0	40
25988	38	0	1	0	0	39
25989	1	39	0	0	0	40
25990	0	0	0	39	0	39
25991	0	0	38	1	0	39
25992	0	0	1	40	0	41
25993	0	0	40	1	0	41
25994	0	0	1	40	0	41
25995	0	0	0	41	0	41
25996	0	0	39	1	0	40
25997	0	0	1	37	0	38
25998	38	0	0	1	0	39
25999	1	0	0	38	0	39
26000	0	0	0	39	0	39
26001	36	0	0	1	0	37
26002	1	38	0	0	0	39
26003	37	1	0	0	0	38
26004	0	38	0	0	0	38
26005	38	1	0	0	0	39
26006	0	0	39	0	0	39
26007	0	0	1	38	0	39
26008	0	0	0	39	0	39
26009	38	0	0	1	0	39
26010	1	37	0	0	0	38
26011	0	1	0	36	0	37
26012	0	0	0	40	0	40
26013	0	39	0	1	0	40
26014	38	1	0	0	0	39
26015	1	37	0	0	0	38
26016	0	1	0	38	0	39
26017	0	0	0	37	0	37
26018	0	39	0	1	0	40
26019	39	1	0	0	0	40
26020	1	0	39	0	0	40
26021	38	0	1	0	0	39
26022	1	38	0	0	0	39
26023	0	1	0	39	0	40
26024	39	0	0	1	0	40
26025	1	0	0	39	0	40
26026	0	0	0	39	0	39
26027	40	0	0	1	0	41
26028	1	38	0	0	0	39
26029	1	40	0	0	0	41
26030	39	1	1	0	0	41
26031	2	0	38	0	0	40
26032	0	37	0	0	0	37
26033	0	1	0	32	0	33
26034	0	0	40	0	0	40
26035	0	0	0	39	0	39
26036	40	0	1	0	0	41
26037	0	37	0	1	0	38
26038	0	0	0	36	0	36
26039	0	36	1	0	0	37
26040	36	0	0	1	0	37
26041	37	0	0	0	0	37
26042	0	36	0	1	0	37
26043	0	0	0	38	0	38
26044	1	36	0	0	0	37
26045	38	1	0	0	0	39
26046	39	0	0	0	0	39
26047	0	0	0	38	0	38
26048	1	0	0	38	0	39
26049	0	0	39	0	0	39
26050	37	0	0	1	0	38
26051	0	0	34	0	0	34
26052	1	0	0	37	0	38
26053	37	1	0	0	0	38
26054	0	37	0	1	0	38
26055	37	0	0	2	0	39
26056	0	1	36	0	0	37
26057	39	0	0	0	0	39
26058	0	40	0	0	0	40
26059	39	0	0	1	0	40
26060	0	40	0	1	0	41
26061	0	0	0	41	0	41
26062	1	0	41	0	0	42
26063	0	0	41	0	0	41
26064	0	0	0	41	0	41
26065	0	1	42	0	0	43
26066	0	0	0	43	0	43
26067	1	0	0	41	0	42
26068	0	0	42	1	0	43
26069	39	0	0	1	0	40
26070	41	0	0	0	0	41
26071	0	40	0	0	0	40
26072	39	1	0	0	0	40
26073	1	0	0	39	0	40
26074	0	0	41	0	0	41
26075	0	1	0	40	0	41
26076	0	0	0	38	0	38
26077	38	0	1	0	0	39
26078	0	37	0	1	0	38
26079	1	38	0	0	0	39
26080	0	1	0	38	0	39
26081	0	0	0	39	0	39
26082	0	40	0	0	0	40
26083	1	0	0	38	0	39
26084	1	0	0	38	0	39
26085	0	39	0	0	0	39
26086	37	0	0	1	0	38
26087	0	0	0	36	0	36
26088	0	35	0	0	0	35
26089	0	1	0	37	0	38
26090	37	0	0	0	0	37
26091	0	42	0	0	0	42
26092	42	0	0	0	0	42
26093	41	0	0	0	0	41
26094	0	0	0	42	0	42
26095	42	0	0	0	0	42
26096	41	0	0	0	0	41
26097	41	0	0	0	0	41
26098	42	0	0	0	0	42
26099	0	0	0	43	0	43
26100	1	0	0	43	0	44
26101	0	0	44	0	0	44
26102	1	0	0	42	0	43
26103	0	0	0	41	0	41
26104	0	0	42	0	0	42
26105	42	0	0	0	0	42
26106	1	0	0	40	0	41
26107	0	0	42	0	0	42
26108	43	0	0	0	0	43
26109	0	0	45	0	0	45
26110	0	40	0	0	0	40
26111	0	45	0	0	0	45
26112	0	0	0	47	0	47
26113	0	0	52	0	0	52
26114	53	0	0	0	0	53
26115	56	0	0	0	0	56
26116	0	0	56	0	0	56
26117	56	0	0	0	0	56
26118	52	0	0	0	0	52
26119	0	55	0	0	0	55
26120	54	0	0	0	0	54
26121	0	0	0	55	0	55
26122	0	0	54	0	0	54
26123	0	0	0	53	0	53
26124	0	55	2	0	0	57
26125	1	58	0	0	0	59
26126	57	0	0	0	0	57
26127	57	1	0	0	0	58
26128	55	1	0	0	0	56
26129	0	0	0	57	0	57
26130	0	0	1	54	0	55
26131	1	56	0	0	0	57
26132	56	0	0	0	0	56
26133	0	55	0	0	0	55
26134	49	0	0	0	0	49
26135	1	48	0	0	0	49
26136	48	1	0	0	0	49
26137	48	0	0	0	0	48
26138	0	0	0	50	0	50
26139	0	48	2	0	0	50
26140	0	0	47	1	0	48
26141	49	1	0	0	0	50
26142	0	50	0	0	0	50
26143	1	0	49	0	0	50
26144	1	0	49	0	0	50
26145	2	0	0	50	0	52
26146	0	0	0	51	0	51
26147	0	52	0	1	0	53
26148	53	1	0	0	0	54
26149	1	0	0	55	0	56
26150	0	57	0	0	0	57
26151	1	64	0	0	0	65
26152	0	2	59	0	0	61
26153	1	0	63	0	0	64
26154	64	0	0	0	0	64
26155	0	0	59	1	0	60
26156	0	1	0	59	0	60
26157	0	0	0	61	0	61
26158	1	0	63	0	0	64
26159	0	1	0	61	0	62
26160	0	0	0	58	0	58
26161	62	0	1	0	0	63
26162	61	0	0	1	0	62
26163	0	0	0	62	0	62
26164	0	63	0	0	0	63
26165	1	66	0	0	0	67
26166	67	0	0	1	0	68
26167	0	0	66	0	0	66
26168	0	1	0	67	0	68
26169	72	0	1	0	0	73
26170	71	0	1	0	0	72
26171	1	0	0	72	0	73
26172	0	0	74	0	0	74
26173	0	0	62	1	0	63
26174	71	0	0	1	0	72
26175	75	0	1	1	0	77
26176	0	76	0	1	0	77
26177	1	84	0	2	0	87
26178	86	0	2	1	0	89
26179	92	1	1	0	0	94
26180	2	0	0	94	0	96
26181	2	0	1	93	0	96
26182	1	0	2	94	0	97
26183	98	0	0	0	0	98
26184	3	1	1	96	0	101
26185	1	2	101	1	0	105
26186	102	0	0	1	0	103
26187	1	0	1	103	0	105
26188	0	1	105	2	0	108
26189	104	0	0	0	0	104
26190	97	2	2	1	0	102
26191	2	109	1	0	0	112
26192	3	113	0	1	0	117
26193	2	2	108	0	0	112
26194	111	2	0	1	0	114
26195	2	116	0	2	0	120
26196	2	2	116	1	0	121
26197	116	1	0	1	0	118
26198	1	127	0	1	0	129
26199	1	1	123	1	0	126
26200	123	2	0	0	0	125
26201	2	123	0	1	0	126
26202	2	1	1	126	0	130
26203	127	0	0	1	0	128
26204	0	129	0	2	0	131
26205	0	3	1	125	0	129
26206	126	0	1	0	0	127
26207	0	0	126	0	0	126
26208	0	128	1	0	0	129
26209	0	0	127	0	0	127
26210	0	0	1	131	0	132
26211	0	0	129	1	0	130
26212	0	127	0	0	0	127
26213	1	124	0	0	0	125
26214	0	0	0	126	0	126
26215	1	0	0	121	0	122
26216	0	0	0	126	0	126
26217	0	0	133	0	0	133
26218	0	0	0	132	0	132
26219	129	0	0	0	0	129
26220	130	0	0	0	0	130
26221	0	0	130	0	0	130
26222	0	135	0	0	0	135
26223	135	0	0	0	0	135
26224	0	135	0	0	0	135
26225	137	0	0	0	0	137
26226	136	0	0	1	0	137
26227	0	0	133	0	0	133
26228	0	135	0	0	0	135
26229	0	0	0	140	0	140
26230	0	0	139	0	0	139
26231	129	0	1	0	0	130
26232	1	0	0	137	0	138
26233	0	0	138	0	0	138
26234	133	0	0	2	0	135
26235	0	0	140	0	0	140
26236	0	0	0	143	0	143
26237	154	0	0	0	0	154
26238	0	158	0	0	0	158
26239	0	0	165	0	0	165
26240	163	0	0	0	0	163
26241	176	0	0	1	0	177
26242	0	185	0	0	0	185
26243	0	0	0	186	0	186
26244	0	0	0	184	0	184
26245	183	0	0	0	0	183
26246	0	0	0	183	0	183
26247	0	0	186	0	0	186
26248	0	0	0	183	0	183
26249	185	0	0	1	0	186
26250	0	176	0	0	0	176
26251	0	0	0	177	0	177
26252	0	174	0	1	0	175
26253	180	0	0	0	0	180
26254	0	0	0	195	0	195
26255	0	0	0	200	0	200
26256	0	206	0	1	0	207
26257	0	1	204	0	0	205
26258	0	0	1	201	0	202
26259	1	0	1	204	0	206
26260	1	1	0	203	0	205
26261	0	202	1	2	0	205
26262	0	1	205	1	0	207
26263	0	1	200	1	0	202
26264	199	0	2	1	0	202
26265	207	1	0	1	0	209
26266	2	0	204	0	0	206
26267	203	0	2	0	0	205
26268	2	0	214	0	0	216
26269	202	0	1	2	0	205
26270	1	214	2	0	0	217
26271	218	1	0	1	0	220
26272	1	1	221	1	0	224
26273	2	0	227	1	0	230
26274	0	1	2	240	0	243
26275	242	1	2	1	0	246
26276	1	245	2	2	0	250
26277	2	1	271	0	0	274
26278	1	2	1	273	0	277
26279	2	0	1	267	0	270
26280	268	1	1	4	0	274
26281	268	0	1	2	0	271
26282	3	0	1	270	0	274
26283	271	0	0	2	0	273
26284	2	1	258	2	0	263
26285	4	0	1	263	0	268
26286	1	0	3	260	0	264
26287	262	0	1	3	0	266
26288	260	0	1	3	0	264
26289	4	0	0	260	0	264
26290	261	0	0	2	0	263
26291	2	2	248	2	0	254
26292	3	244	1	0	0	248
26293	0	1	245	2	0	248
26294	0	2	1	243	0	246
26295	240	0	3	2	0	245
26296	1	237	0	3	0	241
26297	3	1	1	238	0	243
26298	0	2	1	235	0	238
26299	1	234	0	4	0	239
26300	0	3	0	238	0	241
26301	1	2	1	235	0	239
26302	2	0	0	238	0	240
26303	1	2	0	236	0	239
26304	1	1	1	231	0	234
26305	0	228	0	6	0	234
26306	0	3	0	236	0	239
26307	2	2	2	232	0	238
26308	1	0	227	6	0	234
26309	1	229	2	4	0	236
26310	2	1	2	228	0	233
26311	2	2	1	228	0	233
26312	0	2	1	233	0	236
26313	1	224	1	5	0	231
26314	1	2	221	6	0	230
26315	2	2	1	232	0	237
26316	2	0	228	6	0	236
26317	4	1	222	4	0	231
26318	1	1	3	226	0	231
26319	223	2	3	3	0	231
26320	2	0	4	226	0	232
26321	2	0	2	225	0	229
26322	1	223	1	7	0	232
26323	3	3	1	223	0	230
26324	2	2	4	221	0	229
26325	1	0	223	6	0	230
26326	3	217	1	2	0	223
26327	1	2	4	220	0	227
26328	222	2	1	4	0	229
26329	2	1	220	4	0	227
26330	2	1	3	221	0	227
26331	3	0	1	220	0	224
26332	216	3	1	4	0	224
26333	3	214	1	5	0	223
26334	216	1	1	6	0	224
26335	2	212	2	1	0	217
26336	3	3	0	208	0	214
26337	202	3	0	7	0	212
26338	3	0	202	6	0	211
26339	2	193	3	3	0	201
26340	0	195	2	5	0	202
26341	180	5	1	3	0	189
26342	3	2	1	178	0	184
26343	2	172	1	3	0	178
26344	0	181	3	4	0	188
26345	2	5	2	179	0	188
26346	2	2	2	179	0	185
26347	175	3	1	6	0	185
26348	1	175	1	6	0	183
26349	3	4	1	179	0	187
26350	1	2	180	5	0	188
26351	2	182	1	6	0	191
26352	0	3	179	1	0	183
26353	0	176	3	3	0	182
26354	4	6	2	159	0	171
26355	3	1	1	153	0	158
26356	0	154	0	3	0	157
26357	0	0	155	5	0	160
26358	157	3	0	2	0	162
26359	1	0	2	159	0	162
26360	1	1	1	159	0	162
26361	2	0	160	3	0	165
26362	1	3	0	160	0	164
26363	0	1	158	4	0	163
26364	4	0	1	158	0	163
26365	0	1	163	2	0	166
26366	0	169	1	4	0	174
26367	1	1	169	4	0	175
26368	3	1	2	164	0	170
26369	165	4	2	1	0	172
26370	1	162	1	2	0	166
26371	3	4	1	155	0	163
26372	1	1	156	4	0	162
26373	2	153	1	2	0	158
26374	2	4	2	133	0	141
26375	0	3	136	3	0	142
26376	0	128	1	1	0	130
26377	97	2	3	1	0	103
26378	94	0	1	0	0	95
26379	1	1	0	91	0	93
26380	92	0	0	1	0	93
26381	2	0	0	90	0	92
26382	1	0	0	94	0	95
26383	1	0	95	1	0	97
26384	0	0	1	92	0	93
26385	0	0	0	94	0	94
26386	92	0	0	1	0	93
26387	92	0	0	1	0	93
26388	1	91	0	1	0	93
26389	1	1	95	0	0	97
26390	1	0	1	95	0	97
26391	1	1	92	1	0	95
26392	92	1	2	0	0	95
26393	1	0	93	2	0	96
26394	0	0	2	95	0	97
26395	1	96	0	0	0	97
26396	0	2	0	96	0	98
26397	0	0	1	97	0	98
26398	0	1	102	1	0	104
26399	1	0	1	100	0	102
26400	100	0	0	2	0	102
26401	101	0	1	2	0	104
26402	101	0	0	1	0	102
26403	99	0	0	1	0	100
26404	2	98	0	1	0	101
26405	1	99	1	0	0	101
26406	1	1	0	95	0	97
26407	0	1	0	100	0	101
26408	1	98	0	1	0	100
26409	1	1	0	100	0	102
26410	0	1	0	101	0	102
26411	1	1	1	98	0	101
26412	0	0	0	101	0	101
26413	0	0	1	101	0	102
26414	98	0	0	2	0	100
26415	1	95	1	1	0	98
26416	0	1	94	1	0	96
26417	1	0	1	90	0	92
26418	0	1	0	95	0	96
26419	0	0	1	93	0	94
26420	90	0	2	2	0	94
26421	1	89	0	3	0	93
26422	1	1	0	94	0	96
26423	2	98	0	1	0	101
26424	1	2	1	95	0	99
26425	1	95	0	2	0	98
26426	0	2	98	0	0	100
26427	0	1	1	107	0	109
26428	0	1	124	2	0	127
26429	0	1	3	124	0	128
26430	0	0	0	136	0	136
26431	135	0	2	5	0	142
26432	133	0	0	2	0	135
26433	136	0	0	3	0	139
26434	139	0	1	1	0	141
26435	136	1	0	1	0	138
26436	7	0	0	132	0	139
26437	2	136	0	4	0	142
26438	1	3	1	135	0	140
26439	1	0	129	6	0	136
26440	130	0	4	2	0	136
26441	136	0	0	4	0	140
26442	4	0	2	132	0	138
26443	1	1	0	134	0	136
26444	1	125	0	6	0	132
26445	1	5	0	133	0	139
26446	2	0	0	131	0	133
26447	0	127	0	9	0	136
26448	0	3	1	130	0	134
26449	124	0	0	7	0	131
26450	4	0	128	0	0	132
26451	122	0	4	3	0	129
26452	5	0	120	1	0	126
26453	1	0	5	119	0	125
26454	3	1	0	121	0	125
26455	1	115	1	5	0	122
26456	1	121	0	2	0	124
26457	2	4	1	112	0	119
26458	0	0	115	6	0	121
26459	110	1	4	0	0	115
26460	5	0	0	111	0	116
26461	0	114	1	4	0	119
26462	1	4	0	109	0	114
26463	1	0	0	109	0	110
26464	0	106	0	3	0	109
26465	0	4	0	100	0	104
26466	0	0	89	3	0	92
26467	0	0	91	0	0	91
26468	0	0	2	85	0	87
26469	0	89	0	4	0	93
26470	0	4	0	84	0	88
26471	87	0	0	3	0	90
26472	87	0	0	0	0	87
26473	86	0	0	0	0	86
26474	3	85	0	0	0	88
26475	0	3	83	0	0	86
26476	81	0	3	0	0	84
26477	84	0	0	0	0	84
26478	3	81	0	0	0	84
26479	0	2	0	82	0	84
26480	82	0	0	3	0	85
26481	84	0	0	0	0	84
26482	84	0	0	0	0	84
26483	3	0	0	78	0	81
26484	78	0	0	3	0	81
26485	3	0	0	78	0	81
26486	0	0	0	80	0	80
26487	77	0	0	3	0	80
26488	3	0	0	76	0	79
26489	73	1	0	3	0	77
26490	3	0	0	75	0	78
26491	0	1	0	77	0	78
26492	75	0	0	3	0	78
26493	2	1	74	0	0	77
26494	0	0	3	72	0	75
26495	0	0	0	78	0	78
26496	1	0	1	75	0	77
26497	1	0	0	75	0	76
26498	1	0	0	69	0	70
26499	2	64	0	3	0	69
26500	2	3	0	67	0	72
26501	1	0	67	4	0	72
26502	1	1	3	67	0	72
26503	1	0	0	71	0	72
26504	0	0	1	71	0	72
26505	1	0	66	3	0	70
26506	1	0	67	1	0	69
26507	67	0	3	1	0	71
26508	71	0	0	0	0	71
26509	4	70	0	0	0	74
26510	0	3	0	73	0	76
26511	0	0	0	75	0	75
26512	0	1	0	74	0	75
26513	72	0	0	5	0	77
26514	76	0	0	0	0	76
26515	2	1	1	72	0	76
26516	1	0	0	77	0	78
26517	1	0	1	75	0	77
26518	0	0	0	75	0	75
26519	72	0	0	4	0	76
26520	3	0	71	0	0	74
26521	0	63	3	0	0	66
26522	0	61	0	1	0	62
26523	58	3	1	0	0	62
26524	3	3	1	53	0	60
26525	0	0	53	3	0	56
26526	0	1	50	0	0	51
26527	0	42	3	1	0	46
26528	22	2	1	1	0	26
26529	2	1	22	0	0	25
26530	15	0	0	0	0	15
26531	0	0	0	15	0	15
26532	1	0	0	14	0	15
26533	0	14	0	1	0	15
26534	1	15	0	0	0	16
26535	15	0	0	1	0	16
26536	14	0	0	1	0	15
26537	1	12	0	0	0	13
26538	0	0	12	1	0	13
26539	1	0	12	0	0	13
26540	0	0	0	14	0	14
26541	14	0	0	1	0	15
26542	1	15	0	0	0	16
26543	0	0	1	15	0	16
26544	15	0	0	1	0	16
26545	0	0	0	16	0	16
26546	0	0	0	16	0	16
26547	15	0	0	1	0	16
26548	0	18	0	1	0	19
26549	0	22	0	0	0	22
26550	0	0	22	1	0	23
26551	0	0	1	23	0	24
26552	0	0	0	24	0	24
26553	0	0	23	1	0	24
26554	23	0	0	1	0	24
26555	23	0	1	0	0	24
26556	0	0	24	0	0	24
26557	25	0	0	0	0	25
26558	1	0	34	0	0	35
26559	0	38	0	0	0	38
26560	0	0	0	39	0	39
26561	0	0	0	43	0	43
26562	42	0	0	1	0	43
26563	43	0	0	0	0	43
26564	43	0	0	0	0	43
26565	43	0	0	1	0	44
26566	42	0	0	1	0	43
26567	0	0	42	1	0	43
26568	0	43	0	1	0	44
26569	1	0	0	44	0	45
26570	0	42	1	0	0	43
26571	0	45	0	0	0	45
26572	0	1	0	43	0	44
26573	1	0	0	43	0	44
26574	0	0	42	0	0	42
26575	43	0	1	0	0	44
26576	45	0	1	0	0	46
26577	0	45	0	0	0	45
26578	45	0	0	0	0	45
26579	45	0	1	0	0	46
26580	1	0	0	44	0	45
26581	0	0	45	0	0	45
26582	0	0	44	0	0	44
26583	43	0	0	0	0	43
26584	44	0	0	0	0	44
26585	0	45	0	0	0	45
26586	0	46	0	0	0	46
26587	0	0	0	49	0	49
26588	49	0	0	0	0	49
26589	0	0	55	0	0	55
26590	0	0	0	57	0	57
26591	59	0	0	0	0	59
26592	57	0	0	0	0	57
26593	0	0	0	63	0	63
26594	63	0	0	0	0	63
26595	0	0	61	0	0	61
26596	0	0	68	0	0	68
26597	0	0	0	67	0	67
26598	0	0	0	71	0	71
26599	0	0	0	70	0	70
26600	0	70	0	0	0	70
26601	0	72	0	0	0	72
26602	0	0	0	73	0	73
26603	76	0	0	0	0	76
26604	1	0	0	78	0	79
26605	0	0	0	78	0	78
26606	0	79	0	0	0	79
26607	0	81	0	0	0	81
26608	0	0	0	83	0	83
26609	0	0	0	80	0	80
26610	80	0	0	0	0	80
26611	0	80	0	0	0	80
26612	81	0	0	0	0	81
26613	0	0	0	82	0	82
26614	0	0	80	0	0	80
26615	0	0	75	0	0	75
26616	85	0	0	0	0	85
26617	0	0	0	92	0	92
26618	0	0	0	90	0	90
26619	0	0	0	92	0	92
26620	0	0	90	0	0	90
26621	0	0	0	93	0	93
26622	0	92	0	0	0	92
26623	0	0	0	96	0	96
26624	0	0	0	96	0	96
26625	0	99	0	0	0	99
26626	0	1	0	103	0	104
26627	107	0	0	2	0	109
26628	2	109	0	0	0	111
26629	116	2	0	0	0	118
26630	117	0	0	0	0	117
26631	2	0	0	119	0	121
26632	0	0	0	117	0	117
26633	0	0	0	121	0	121
26634	0	0	112	2	0	114
26635	0	116	2	0	0	118
26636	0	118	0	0	0	118
26637	0	2	0	118	0	120
26638	118	0	0	2	0	120
26639	2	0	0	117	0	119
26640	0	0	116	2	0	118
26641	0	113	2	0	0	115
26642	0	116	1	0	0	117
26643	118	2	0	1	0	121
26644	118	0	0	0	0	118
26645	2	127	0	0	0	129
26646	128	2	0	0	0	130
26647	2	0	126	0	0	128
26648	1	0	125	0	0	126
26649	126	0	2	0	0	128
26650	134	0	0	0	0	134
26651	2	0	0	135	0	137
26652	135	0	0	2	0	137
26653	2	1	130	0	0	133
26654	0	0	137	0	0	137
26655	1	0	2	154	0	157
26656	0	0	0	170	0	170
26657	1	0	0	170	0	171
26658	0	0	0	167	0	167
26659	0	0	0	179	0	179
26660	0	0	167	6	0	173
26661	0	0	5	168	0	173
26662	169	0	0	6	0	175
26663	5	0	1	167	0	173
26664	167	0	0	8	0	175
26665	6	0	0	168	0	174
26666	171	0	1	6	0	178
26667	180	0	0	1	0	181
26668	6	0	0	173	0	179
26669	1	0	0	181	0	182
26670	175	0	1	6	0	182
26671	180	0	0	3	0	183
26672	7	0	178	1	0	186
26673	2	0	4	183	0	189
26674	3	0	0	186	0	189
26675	179	1	1	8	0	189
26676	189	0	0	1	0	190
26677	8	0	0	182	0	190
26678	1	0	1	186	0	188
26679	1	0	0	189	0	190
26680	0	0	0	186	0	186
26681	2	174	1	7	0	184
26682	1	182	1	1	0	185
26683	0	6	0	182	0	188
26684	0	177	0	7	0	184
26685	2	6	0	180	0	188
26686	3	0	178	7	0	188
26687	0	3	175	1	0	179
26688	0	175	6	3	0	184
26689	2	5	1	172	0	180
26690	1	1	168	6	0	176
26691	1	2	4	169	0	176
26692	0	2	1	175	0	178
26693	166	0	2	6	0	174
26694	4	1	1	169	0	175
26695	0	0	172	8	0	180
26696	2	0	175	0	0	177
26697	1	171	4	2	0	178
26698	0	183	1	2	0	186
26699	184	5	1	1	0	191
26700	5	0	186	2	0	193
26701	0	1	6	188	0	195
26702	189	0	1	7	0	197
26703	186	1	1	2	0	190
26704	5	187	0	3	0	195
26705	2	5	1	181	0	189
26706	1	0	2	192	0	195
26707	0	1	1	194	0	196
26708	190	0	0	7	0	197
26709	8	0	183	1	0	192
26710	0	186	8	2	0	196
26711	2	5	0	188	0	195
26712	1	0	1	197	0	199
26713	2	1	183	7	0	193
26714	2	1	5	185	0	193
26715	0	0	1	193	0	194
26716	0	1	2	185	0	188
26717	1	0	0	183	0	184
26718	3	0	174	7	0	184
26719	0	0	6	175	0	181
26720	2	1	174	7	0	184
26721	0	173	5	4	0	182
26722	2	5	0	174	0	181
26723	2	0	1	178	0	181
26724	0	1	173	7	0	181
26725	0	168	4	6	0	178
26726	1	3	1	168	0	173
26727	1	0	162	3	0	166
26728	0	163	4	1	0	168
26729	0	2	0	162	0	164
26730	0	0	160	4	0	164
26731	1	3	3	152	0	159
26732	1	0	0	157	0	158
26733	1	0	1	160	0	162
26734	155	1	1	5	0	162
26735	3	153	0	3	0	159
26736	158	3	1	3	0	165
26737	4	1	159	0	0	164
26738	165	3	2	2	0	172
26739	182	0	0	4	0	186
26740	4	0	2	179	0	185
26741	183	1	0	6	0	190
26742	187	0	1	0	0	188
26743	191	0	2	2	0	195
26744	6	1	0	190	0	197
26745	2	0	0	185	0	187
26746	2	0	180	4	0	186
26747	1	0	174	2	0	177
26748	178	0	2	2	0	182
26749	5	2	1	177	0	185
26750	0	178	0	3	0	181
26751	184	2	0	1	0	187
26752	4	179	1	0	0	184
26753	1	186	1	0	0	188
26754	2	2	183	1	0	188
26755	0	0	188	2	0	190
26756	0	3	1	181	0	185
26757	1	0	193	1	0	195
26758	1	0	175	0	0	176
26759	168	0	0	1	0	169
26760	173	0	0	1	0	174
26761	0	0	0	179	0	179
26762	0	0	0	183	0	183
26763	0	0	188	0	0	188
26764	0	192	0	0	0	192
26765	0	0	0	189	0	189
26766	199	0	0	2	0	201
26767	0	0	0	202	0	202
26768	0	206	0	0	0	206
26769	0	0	212	0	0	212
26770	0	216	1	0	0	217
26771	217	0	0	0	0	217
26772	210	0	0	0	0	210
26773	0	0	0	211	0	211
26774	0	0	219	0	0	219
26775	0	0	211	0	0	211
26776	0	216	1	0	0	217
26777	0	1	0	213	0	214
26778	0	0	0	222	0	222
26779	0	0	220	1	0	221
26780	1	0	1	210	0	212
26781	0	230	0	1	0	231
26782	0	1	0	232	0	233
26783	0	0	0	231	0	231
26784	0	0	229	1	0	230
26785	0	1	1	225	0	227
26786	228	0	0	1	0	229
26787	1	0	223	0	0	224
26788	0	0	221	0	0	221
26789	0	228	3	0	0	231
26790	2	2	0	235	0	239
26791	0	0	0	244	0	244
26792	0	1	238	2	0	241
26793	227	0	3	0	0	230
26794	2	1	0	241	0	244
26795	1	0	237	2	0	240
26796	1	0	2	230	0	233
26797	0	0	236	3	0	239
26798	0	0	232	1	0	233
26799	0	238	3	0	0	241
26800	0	3	1	226	0	230
26801	0	233	0	2	0	235
26802	228	2	0	1	0	231
26803	3	0	234	0	0	237
26804	0	229	2	2	0	233
26805	0	3	1	227	0	231
26806	228	0	1	2	0	231
26807	2	228	0	1	0	231
26808	1	2	1	227	0	231
26809	0	0	0	229	0	229
26810	1	229	1	1	0	232
26811	231	2	1	1	0	235
26812	2	1	1	256	0	260
26813	0	1	0	272	0	273
26814	0	0	274	5	0	279
26815	0	278	3	1	0	282
26816	1	2	2	288	0	293
26817	2	2	0	317	0	321
26818	0	317	2	4	0	323
26819	0	3	2	319	0	324
26820	1	1	1	335	0	338
26821	3	0	1	340	0	344
26822	1	336	1	4	0	342
26823	337	3	3	0	0	343
26824	3	0	341	2	0	346
26825	324	3	2	3	0	332
26826	3	346	1	2	0	352
26827	0	2	1	348	0	351
26828	2	1	342	2	0	347
26829	1	0	3	337	0	341
26830	3	2	0	341	0	346
26831	0	1	1	345	0	347
26832	0	1	344	5	0	350
26833	1	339	4	1	0	345
26834	0	3	344	1	0	348
26835	2	347	2	0	0	351
26836	0	2	351	3	0	356
26837	2	1	3	352	0	358
26838	337	2	1	4	0	344
26839	2	347	0	2	0	351
26840	0	4	348	4	0	356
26841	0	346	4	2	0	352
26842	0	5	356	0	0	361
26843	0	1	3	353	0	357
26844	1	0	1	345	0	347
26845	0	346	1	6	0	353
26846	0	362	1	0	0	363
26847	360	3	1	2	0	366
26848	4	1	2	364	0	371
26849	1	1	366	4	0	372
26850	3	3	5	362	0	373
26851	1	1	364	7	0	373
26852	0	0	372	2	0	374
26853	0	2	4	362	0	368
26854	1	366	0	6	0	373
26855	351	4	2	3	0	360
26856	5	1	2	349	0	357
26857	0	3	0	344	0	347
26858	0	346	2	5	0	353
26859	347	6	1	1	0	355
26860	348	0	3	3	0	354
26861	6	0	0	339	0	345
26862	1	342	0	5	0	348
26863	0	355	2	1	0	358
26864	353	6	3	0	0	362
26865	4	2	350	2	0	358
26866	343	1	5	4	0	353
26867	346	0	0	3	0	349
26868	341	0	1	1	0	343
26869	4	333	0	0	0	337
26870	0	6	1	341	0	348
26871	342	1	0	4	0	347
26872	341	0	2	1	0	344
26873	3	339	1	3	0	346
26874	347	3	0	3	0	353
26875	3	1	1	351	0	356
26876	0	1	2	356	0	359
26877	0	353	0	5	0	358
26878	1	4	0	365	0	370
26879	1	0	0	366	0	367
26880	0	364	0	7	0	371
26881	3	3	0	349	0	355
26882	0	364	1	3	0	368
26883	363	3	0	0	0	366
26884	359	1	0	2	0	362
26885	2	356	1	4	0	363
26886	0	4	362	0	0	366
26887	0	3	3	361	0	367
26888	1	1	360	2	0	364
26889	0	352	3	2	0	357
26890	1	347	1	1	0	350
26891	344	2	0	3	0	349
26892	3	351	1	0	0	355
26893	1	2	0	344	0	347
26894	0	341	1	2	0	344
26895	1	350	0	1	0	352
26896	352	3	0	2	0	357
26897	1	2	0	352	0	355
26898	1	0	349	2	0	352
26899	0	1	338	2	0	341
26900	1	349	3	2	0	355
26901	353	3	0	3	0	359
26902	2	356	1	1	0	360
26903	0	3	0	368	0	371
26904	362	2	0	2	0	366
26905	4	1	0	366	0	371
26906	0	1	1	365	0	367
26907	1	361	1	3	0	366
26908	3	2	0	370	0	375
26909	0	2	372	2	0	376
26910	370	0	5	0	0	375
26911	4	381	1	2	0	388
26912	0	386	2	0	0	388
26913	367	4	0	1	0	372
26914	4	1	369	1	0	375
26915	360	0	4	0	0	364
26916	3	401	0	0	0	404
26917	0	446	0	0	0	446
26918	0	8	442	0	0	450
26919	0	449	6	0	0	455
26920	2	12	2	412	0	428
26921	0	0	1	430	0	431
26922	0	423	0	6	0	429
26923	0	7	0	430	0	437
26924	428	1	0	9	0	438
26925	7	1	424	1	0	433
26926	417	0	7	1	0	425
26927	428	0	1	0	0	429
26928	430	0	1	0	0	431
26929	10	0	420	0	0	430
26930	2	1	8	419	0	430
26931	2	0	423	8	0	433
26932	419	0	9	2	0	430
26933	421	0	2	2	0	425
26934	10	424	1	0	0	435
26935	4	8	0	423	0	435
26936	1	430	1	7	0	439
26937	0	9	428	2	0	439
26938	0	2	6	427	0	435
26939	417	1	2	10	0	430
26940	428	1	1	2	0	432
26941	9	0	0	413	0	422
26942	4	402	0	8	0	414
26943	1	7	411	2	0	421
26944	1	3	404	0	0	408
26945	391	1	9	0	0	401
26946	8	0	402	0	0	410
26947	3	397	8	0	0	408
26948	3	6	2	397	0	408
26949	0	3	396	6	0	405
26950	2	1	7	390	0	400
26951	1	1	390	7	0	399
26952	369	1	7	4	0	381
26953	6	0	2	386	0	394
26954	2	383	1	6	0	392
26955	1	388	1	3	0	393
26956	3	8	0	380	0	391
26957	1	3	1	379	0	384
26958	2	375	0	8	0	385
26959	1	6	370	2	0	379
26960	1	2	6	377	0	386
26961	0	0	378	6	0	384
26962	0	1	366	3	0	370
26963	341	1	9	2	0	353
26964	8	353	4	0	0	365
26965	356	7	2	0	0	365
26966	7	5	0	344	0	356
26967	2	344	1	8	0	355
26968	1	8	0	358	0	367
26969	0	3	2	356	0	361
26970	2	342	0	11	0	355
26971	4	5	340	4	0	353
26972	2	1	7	342	0	352
26973	344	3	2	9	0	358
26974	8	1	2	330	0	341
26975	4	0	1	329	0	334
26976	3	1	319	9	0	332
26977	2	315	8	5	0	330
26978	1	6	4	313	0	324
26979	0	3	311	8	0	322
26980	2	2	305	3	0	312
26981	300	3	9	2	0	314
26982	5	299	5	2	0	311
26983	302	9	2	0	0	313
26984	8	297	1	3	0	309
26985	3	305	0	3	0	311
26986	297	11	1	1	0	310
26987	9	5	0	292	0	306
26988	4	301	1	7	0	313
26989	2	9	1	306	0	318
26990	305	3	2	9	0	319
26991	8	2	306	4	0	320
26992	4	1	299	3	0	307
26993	301	0	12	3	0	316
26994	9	298	5	1	0	313
26995	3	8	296	1	0	308
26996	4	298	7	1	0	310
26997	4	7	3	293	0	307
26998	1	4	296	6	0	307
26999	2	2	7	294	0	305
27000	1	2	286	9	0	298
27001	281	2	9	3	0	295
27002	7	283	3	2	0	295
27003	275	6	3	2	0	286
27004	11	3	0	279	0	293
27005	3	287	0	8	0	298
27006	288	7	1	5	0	301
27007	283	3	1	3	0	290
27008	9	2	291	0	0	302
27009	4	1	287	2	0	294
27010	264	0	10	2	0	276
27011	5	263	5	0	0	273
27012	5	243	1	1	0	250
27013	3	13	4	229	0	249
27014	1	5	235	4	0	245
27015	0	223	4	3	0	230
27016	0	187	2	1	0	190
27017	5	3	1	112	0	121
27018	114	1	2	1	0	118
27019	111	1	0	1	0	113
27020	113	0	0	1	0	114
27021	2	0	111	0	0	113
27022	113	0	1	0	0	114
27023	117	0	1	0	0	118
27024	119	0	0	0	0	119
27025	1	1	0	115	0	117
27026	1	114	1	0	0	116
27027	122	0	0	1	0	123
27028	0	123	0	1	0	124
27029	0	0	1	121	0	122
27030	0	0	123	1	0	124
27031	0	0	1	121	0	122
27032	1	0	0	120	0	121
27033	1	1	122	0	0	124
27034	1	120	0	0	0	121
27035	0	0	0	118	0	118
27036	112	1	0	0	0	113
27037	1	114	0	0	0	115
27038	112	0	0	0	0	112
27039	0	0	0	110	0	110
27040	0	108	0	0	0	108
27041	104	1	0	1	0	106
27042	1	111	0	0	0	112
27043	1	0	110	0	0	111
27044	109	0	1	0	0	110
27045	114	0	1	0	0	115
27046	2	114	0	0	0	116
27047	0	2	111	0	0	113
27048	0	111	1	0	0	112
27049	1	1	0	91	0	93
27050	0	0	1	114	0	115
27051	0	0	0	115	0	115
27052	0	114	0	1	0	115
27053	0	1	0	113	0	114
27054	2	0	0	114	0	116
27055	114	0	0	1	0	115
27056	1	0	0	113	0	114
27057	0	0	1	118	0	119
27058	118	0	0	1	0	119
27059	2	116	0	0	0	118
27060	117	1	0	0	0	118
27061	116	0	0	1	0	117
27062	117	0	0	0	0	117
27063	2	0	0	115	0	117
27064	0	1	0	118	0	119
27065	0	0	117	2	0	119
27066	0	0	115	0	0	115
27067	1	0	117	1	0	119
27068	109	0	1	2	0	112
27069	1	1	112	0	0	114
27070	1	111	1	0	0	113
27071	1	1	0	113	0	115
27072	1	0	1	113	0	115
27073	0	116	0	1	0	117
27074	1	0	121	0	0	122
27075	0	123	1	1	0	125
27076	122	3	0	0	0	125
27077	2	0	123	1	0	126
27078	0	124	2	0	0	126
27079	0	1	123	0	0	124
27080	0	1	1	121	0	123
27081	1	0	122	2	0	125
27082	1	1	1	119	0	122
27083	120	1	0	0	0	121
27084	2	1	120	1	0	124
27085	0	119	2	2	0	123
27086	121	1	0	2	0	124
27087	2	0	124	1	0	127
27088	1	1	119	1	0	122
27089	0	0	1	120	0	121
27090	1	1	117	2	0	121
27091	115	0	1	1	0	117
27092	1	112	0	2	0	115
27093	1	2	0	118	0	121
27094	1	122	1	2	0	126
27095	121	2	0	1	0	124
27096	3	0	121	1	0	125
27097	2	0	125	0	0	127
27098	1	1	1	125	0	128
27099	0	0	0	132	0	132
27100	1	0	1	132	0	134
27101	0	1	1	131	0	133
27102	1	0	139	1	0	141
27103	1	134	2	0	0	137
27104	1	1	1	125	0	128
27105	0	1	117	1	0	119
27106	0	115	1	1	0	117
27107	115	1	0	0	0	116
27108	2	1	0	109	0	112
27109	108	0	1	1	0	110
27110	0	107	0	0	0	107
27111	107	1	0	0	0	108
27112	1	0	115	0	0	116
27113	0	1	1	112	0	114
27114	0	110	1	1	0	112
27115	0	1	109	1	0	111
27116	0	111	2	0	0	113
27117	0	1	0	91	0	92
27118	107	0	0	1	0	108
27119	0	106	1	0	0	107
27120	106	2	0	0	0	108
27121	2	0	106	0	0	108
27122	1	0	104	0	0	105
27123	101	0	2	0	0	103
27124	1	0	0	101	0	102
27125	0	0	1	100	0	101
27126	1	0	100	1	0	102
27127	0	1	95	0	0	96
27128	0	99	1	1	0	101
27129	98	2	1	0	0	101
27130	97	0	1	1	0	99
27131	1	97	1	0	0	99
27132	1	1	1	105	0	108
27133	104	0	0	2	0	106
27134	2	0	0	102	0	104
27135	103	0	0	2	0	105
27136	105	0	0	1	0	106
27137	109	0	0	0	0	109
27138	1	1	0	107	0	109
27139	0	0	0	110	0	110
27140	107	0	0	1	0	108
27141	107	1	0	0	0	108
27142	108	0	0	0	0	108
27143	1	101	0	1	0	103
27144	100	0	0	0	0	100
27145	0	99	0	0	0	99
27146	99	0	0	0	0	99
27147	0	0	103	0	0	103
27148	99	0	0	0	0	99
27149	0	98	0	0	0	98
27150	0	96	0	0	0	96
27151	100	0	0	0	0	100
27152	0	0	0	101	0	101
27153	0	0	0	102	0	102
27154	0	103	0	0	0	103
27155	0	110	0	0	0	110
27156	111	0	0	0	0	111
27157	0	0	116	0	0	116
27158	0	0	0	123	0	123
27159	124	0	0	0	0	124
27160	1	0	124	0	0	125
27161	0	134	0	1	0	135
27162	149	1	1	0	0	151
27163	1	1	149	2	0	153
27164	0	0	1	156	0	157
27165	1	0	163	0	0	164
27166	159	1	1	0	0	161
27167	2	159	0	2	0	163
27168	164	1	0	1	0	166
27169	166	0	0	0	0	166
27170	1	2	0	163	0	166
27171	165	0	0	2	0	167
27172	1	0	1	167	0	169
27173	0	0	0	167	0	167
27174	0	1	157	1	0	159
27175	0	158	2	3	0	163
27176	1	2	0	163	0	166
27177	0	0	1	163	0	164
27178	2	0	0	161	0	163
27179	0	0	159	1	0	160
27180	2	163	1	0	0	166
27181	0	2	1	164	0	167
27182	1	0	1	165	0	167
27183	2	0	160	1	0	163
27184	0	0	1	159	0	160
27185	164	0	0	2	0	166
27186	1	162	1	1	0	165
27187	158	1	1	1	0	161
27188	1	1	164	0	0	166
27189	1	1	1	168	0	171
27190	170	0	0	2	0	172
27191	167	1	0	1	0	169
27192	1	0	170	2	0	173
27193	1	0	2	163	0	166
27194	0	0	167	2	0	169
27195	163	0	1	1	0	165
27196	2	168	0	1	0	171
27197	166	1	1	0	0	168
27198	164	0	0	2	0	166
27199	2	166	0	1	0	169
27200	165	2	0	0	0	167
27201	2	0	169	0	0	171
27202	161	0	1	0	0	162
27203	1	0	0	162	0	163
27204	1	0	167	2	0	170
27205	1	0	1	164	0	166
27206	0	0	1	168	0	169
27207	0	0	0	170	0	170
27208	0	170	1	1	0	172
27209	172	1	0	0	0	173
27210	1	1	0	169	0	171
27211	1	172	0	1	0	174
27212	1	1	0	166	0	168
27213	1	167	1	2	0	171
27214	2	1	167	0	0	170
27215	0	1	1	169	0	171
27216	2	0	0	170	0	172
27217	2	0	167	2	0	171
27218	160	2	2	1	0	165
27219	2	166	0	1	0	169
27220	1	1	1	169	0	172
27221	1	0	0	168	0	169
27222	1	1	0	170	0	172
27223	1	168	1	2	0	172
27224	168	1	0	3	0	172
27225	1	1	170	0	0	172
27226	1	1	164	1	0	167
27227	0	2	2	165	0	169
27228	1	0	1	167	0	169
27229	164	0	0	3	0	167
27230	2	163	1	1	0	167
27231	0	2	1	163	0	166
27232	157	1	0	2	0	160
27233	2	1	1	155	0	159
27234	157	0	1	4	0	162
27235	2	0	154	3	0	159
27236	1	164	1	1	0	167
27237	166	3	0	1	0	170
27238	3	1	169	0	0	173
27239	164	0	2	1	0	167
27240	1	0	166	3	0	170
27241	165	0	0	3	0	168
27242	2	1	0	169	0	172
27243	168	0	2	0	0	170
27244	2	2	1	166	0	171
27245	0	0	2	170	0	172
27246	168	0	0	3	0	171
27247	1	167	1	3	0	172
27248	2	1	0	172	0	175
27249	172	1	1	1	0	175
27250	172	3	0	1	0	176
27251	4	0	0	176	0	180
27252	0	0	3	178	0	181
27253	184	0	0	2	0	186
27254	1	0	2	183	0	186
27255	3	1	1	182	0	187
27256	180	0	1	3	0	184
27257	2	0	1	170	0	173
27258	1	0	164	3	0	168
27259	162	1	1	2	0	166
27260	2	1	165	0	0	168
27261	1	1	153	2	0	157
27262	138	0	1	0	0	139
27263	0	133	0	1	0	134
27264	0	0	2	135	0	137
27265	1	0	0	127	0	128
27266	0	1	0	133	0	134
27267	0	0	0	137	0	137
27268	130	0	0	2	0	132
27269	141	0	0	0	0	141
27270	145	0	0	1	0	146
27271	2	0	154	1	0	157
27272	2	0	1	162	0	165
27273	0	0	2	164	0	166
27274	0	0	0	166	0	166
27275	1	157	0	3	0	161
27276	0	157	0	3	0	160
27277	163	3	2	0	0	168
27278	2	3	0	165	0	170
27279	2	0	1	170	0	173
27280	0	0	1	174	0	175
27281	1	1	173	3	0	178
27282	0	2	166	4	0	172
27283	171	0	4	1	0	176
27284	174	0	3	2	0	179
27285	5	0	0	173	0	178
27286	3	173	0	3	0	179
27287	3	1	1	176	0	181
27288	1	3	0	168	0	172
27289	2	0	162	4	0	168
27290	175	0	2	2	0	179
27291	1	0	2	177	0	180
27292	3	1	0	175	0	179
27293	174	0	0	4	0	178
27294	1	181	0	4	0	186
27295	188	1	1	0	0	190
27296	2	3	0	183	0	188
27297	3	177	0	2	0	182
27298	176	1	0	3	0	180
27299	2	3	0	180	0	185
27300	181	1	0	1	0	183
27301	174	0	0	3	0	177
27302	175	0	0	1	0	176
27303	4	172	1	0	0	177
27304	4	166	0	0	0	170
27305	0	4	0	164	0	168
27306	1	168	0	1	0	170
27307	170	1	0	3	0	174
27308	1	2	0	169	0	172
27309	172	1	0	1	0	174
27310	170	1	0	3	0	174
27311	5	0	0	165	0	170
27312	3	1	1	172	0	177
27313	172	0	2	5	0	179
27314	174	0	0	5	0	179
27315	178	0	0	1	0	179
27316	183	0	0	1	0	184
27317	183	2	0	1	0	186
27318	4	1	0	180	0	185
27319	5	0	0	180	0	185
27320	1	0	1	186	0	188
27321	182	0	0	4	0	186
27322	2	0	0	179	0	181
27323	4	172	1	2	0	179
27324	1	1	1	179	0	182
27325	174	4	0	2	0	180
27326	174	0	0	4	0	178
27327	5	0	175	2	0	182
27328	3	2	1	173	0	179
27329	1	179	3	2	0	185
27330	177	1	0	5	0	183
27331	4	180	1	0	0	185
27332	6	1	0	178	0	185
27333	177	3	1	3	0	184
27334	179	1	0	5	0	185
27335	5	180	0	0	0	185
27336	3	2	0	173	0	178
27337	3	3	169	2	0	177
27338	160	1	0	5	0	166
27339	3	1	167	2	0	173
27340	172	0	1	3	0	176
27341	167	1	3	2	0	173
27342	6	1	0	167	0	174
27343	173	2	1	2	0	178
27344	174	2	0	2	0	178
27345	179	2	1	1	0	183
27346	5	1	0	180	0	186
27347	179	1	0	5	0	185
27348	3	1	0	180	0	184
27349	5	0	2	181	0	188
27350	3	177	1	6	0	187
27351	4	1	0	177	0	182
27352	4	175	0	4	0	183
27353	170	1	0	7	0	178
27354	166	5	0	2	0	173
27355	5	0	0	167	0	172
27356	6	1	1	162	0	170
27357	164	0	1	6	0	171
27358	5	1	159	3	0	168
27359	165	0	1	4	0	170
27360	3	1	3	163	0	170
27361	5	1	156	4	0	166
27362	154	2	1	4	0	161
27363	158	0	2	3	0	163
27364	5	2	157	2	0	166
27365	166	2	1	1	0	170
27366	3	1	162	3	0	169
27367	6	157	0	2	0	165
27368	168	0	5	1	0	174
27369	163	1	1	1	0	166
27370	2	159	2	3	0	166
27371	2	147	1	1	0	151
27372	146	2	0	0	0	148
27373	142	1	0	4	0	147
27374	2	1	0	150	0	153
27375	2	0	151	0	0	153
27376	1	1	142	0	0	144
27377	148	0	1	1	0	150
27378	1	0	153	0	0	154
27379	148	0	2	0	0	150
27380	0	0	2	146	0	148
27381	1	0	0	147	0	148
27382	1	0	150	0	0	151
27383	152	0	0	1	0	153
27384	1	0	0	152	0	153
27385	1	0	0	161	0	162
27386	164	0	0	1	0	165
27387	166	0	0	1	0	167
27388	169	0	0	0	0	169
27389	0	174	0	1	0	175
27390	0	0	161	0	0	161
27391	164	0	0	0	0	164
27392	164	0	0	0	0	164
27393	0	158	0	0	0	158
27394	148	0	0	0	0	148
27395	0	0	0	147	0	147
27396	0	0	151	0	0	151
27397	153	0	0	0	0	153
27398	155	0	1	1	0	157
27399	153	0	0	0	0	153
27400	154	0	0	0	0	154
27401	0	0	0	154	0	154
27402	0	0	0	149	0	149
27403	154	0	0	0	0	154
27404	0	0	0	155	0	155
27405	0	0	0	155	0	155
27406	0	151	0	0	0	151
27407	0	0	0	155	0	155
27408	0	0	0	155	0	155
27409	0	0	0	152	0	152
27410	0	0	0	155	0	155
27411	0	155	0	0	0	155
27412	0	0	0	151	0	151
27413	0	0	0	149	0	149
27414	0	0	145	0	0	145
27415	0	0	139	0	0	139
27416	0	144	0	0	0	144
27417	176	0	0	0	0	176
27418	0	174	0	0	0	174
27419	0	0	0	186	0	186
27420	0	0	203	0	0	203
27421	216	0	0	0	0	216
27422	2	0	0	224	0	226
27423	222	0	0	2	0	224
27424	227	0	0	1	0	228
27425	3	225	0	0	0	228
27426	227	2	0	0	0	229
27427	2	226	0	2	0	230
27428	1	2	0	230	0	233
27429	0	230	0	3	0	233
27430	0	3	232	1	0	236
27431	0	233	3	0	0	236
27432	1	3	1	228	0	233
27433	233	1	0	3	0	237
27434	4	231	0	1	0	236
27435	1	3	0	231	0	235
27436	0	1	0	237	0	238
27437	0	0	230	5	0	235
27438	0	0	4	233	0	237
27439	0	0	232	4	0	236
27440	228	0	4	1	0	233
27441	5	0	235	0	0	240
27442	1	236	5	0	0	242
27443	0	5	1	233	0	239
27444	0	1	0	234	0	235
27445	0	0	0	233	0	233
27446	224	0	0	6	0	230
27447	5	0	0	223	0	228
27448	2	223	0	5	0	230
27449	220	6	0	1	0	227
27450	4	216	0	1	0	221
27451	1	5	1	217	0	224
27452	216	1	0	5	0	222
27453	5	210	1	2	0	218
27454	2	215	0	0	0	217
27455	213	6	0	0	0	219
27456	218	2	0	1	0	221
27457	7	0	214	0	0	221
27458	219	1	5	0	0	225
27459	5	0	216	2	0	223
27460	2	1	5	217	0	225
27461	1	0	220	5	0	226
27462	1	2	5	217	0	225
27463	1	0	222	6	0	229
27464	0	1	5	214	0	220
27465	0	1	1	223	0	225
27466	215	1	0	7	0	223
27467	5	0	214	2	0	221
27468	205	1	6	0	0	212
27469	5	0	209	2	0	216
27470	2	0	211	1	0	214
27471	1	2	6	199	0	208
27472	202	0	3	6	0	211
27473	5	204	0	2	0	211
27474	195	5	1	2	0	203
27475	197	1	0	2	0	200
27476	6	189	1	2	0	198
27477	193	5	0	1	0	199
27478	5	1	188	1	0	195
27479	1	2	6	190	0	199
27480	190	0	1	7	0	198
27481	5	190	0	2	0	197
27482	2	4	0	187	0	193
27483	2	0	1	187	0	190
27484	0	2	0	189	0	191
27485	1	2	0	190	0	193
27486	184	0	0	7	0	191
27487	186	0	0	2	0	188
27488	190	0	1	1	0	192
27489	183	0	0	1	0	184
27490	5	2	182	0	0	189
27491	182	1	5	1	0	189
27492	185	1	2	0	0	188
27493	7	176	0	2	0	185
27494	2	189	2	0	0	193
27495	1	7	0	181	0	189
27496	0	2	1	181	0	184
27497	2	0	177	7	0	186
27498	1	179	7	1	0	188
27499	1	5	2	176	0	184
27500	1	182	2	5	0	190
27501	0	5	2	188	0	195
27502	0	1	0	196	0	197
27503	2	202	1	6	0	211
27504	1	6	1	201	0	209
27505	2	1	205	5	0	213
27506	0	0	206	2	0	208
27507	197	1	6	1	0	205
27508	203	0	1	1	0	205
27509	7	199	2	0	0	208
27510	200	6	0	2	0	208
27511	7	1	1	200	0	209
27512	200	1	1	5	0	207
27513	5	198	0	3	0	206
27514	2	4	196	1	0	203
27515	190	2	7	1	0	200
27516	6	0	201	2	0	209
27517	2	0	172	0	0	174
27518	0	2	170	0	0	172
27519	1	165	6	0	0	172
27520	136	7	8	0	0	151
27521	129	0	2	2	0	133
27522	4	0	0	126	0	130
27523	0	1	0	129	0	130
27524	0	132	0	3	0	135
27525	129	3	0	1	0	133
27526	3	133	0	2	0	138
27527	0	132	0	1	0	133
27528	124	2	0	0	0	126
27529	2	0	0	129	0	131
27530	0	0	0	125	0	125
27531	0	0	0	130	0	130
27532	0	128	0	2	0	130
27533	125	1	0	0	0	126
27534	1	0	0	124	0	125
27535	0	121	0	1	0	122
27536	0	120	0	0	0	120
27537	0	1	1	117	0	119
27538	0	121	0	1	0	122
27539	0	1	0	120	0	121
27540	116	0	0	0	0	116
27541	0	0	116	0	0	116
27542	0	120	0	0	0	120
27543	0	0	0	122	0	122
27544	0	0	120	0	0	120
27545	118	0	0	0	0	118
27546	0	0	0	123	0	123
27547	123	0	0	0	0	123
27548	121	0	0	0	0	121
27549	0	131	0	0	0	131
27550	132	0	0	0	0	132
27551	131	0	0	0	0	131
27552	128	0	0	0	0	128
27553	0	0	0	130	0	130
27554	0	0	0	131	0	131
27555	0	0	0	131	0	131
27556	0	0	131	0	0	131
27557	0	129	0	0	0	129
27558	124	0	0	0	0	124
27559	0	122	0	0	0	122
27560	0	0	0	125	0	125
27561	0	0	122	0	0	122
27562	117	0	0	0	0	117
27563	0	126	1	0	0	127
27564	0	0	0	127	0	127
27565	0	0	0	124	0	124
27566	0	0	124	0	0	124
27567	0	121	0	0	0	121
27568	0	0	0	123	0	123
27569	0	0	0	122	0	122
27570	0	0	0	120	0	120
27571	118	0	0	0	0	118
27572	0	0	119	0	0	119
27573	0	117	0	0	0	117
27574	112	0	0	0	0	112
27575	0	111	0	0	0	111
27576	0	0	0	114	0	114
27577	0	112	0	0	0	112
27578	110	0	0	0	0	110
27579	111	0	0	0	0	111
27580	0	0	0	114	0	114
27581	0	0	0	112	0	112
27582	0	0	0	121	0	121
27583	0	0	121	0	0	121
27584	0	127	0	0	0	127
27585	0	0	0	155	0	155
27586	0	0	0	160	0	160
27587	0	0	0	166	0	166
27588	0	0	0	162	0	162
27589	0	0	165	0	0	165
27590	0	172	0	0	0	172
27591	0	0	0	175	0	175
27592	0	0	0	185	0	185
27593	0	0	184	0	0	184
27594	0	0	0	179	0	179
27595	0	177	0	0	0	177
27596	0	180	0	0	0	180
27597	0	0	0	183	0	183
27598	0	0	179	0	0	179
27599	171	0	0	0	0	171
27600	0	176	0	0	0	176
27601	0	0	176	0	0	176
27602	0	0	167	0	0	167
27603	0	159	0	0	0	159
27604	0	0	160	0	0	160
27605	0	2	0	156	0	158
27606	157	0	0	1	0	158
27607	156	0	0	1	0	157
27608	154	0	0	1	0	155
27609	156	0	0	1	0	157
27610	0	158	0	0	0	158
27611	158	1	0	0	0	159
27612	0	160	0	1	0	161
27613	0	1	158	1	0	160
27614	0	0	2	155	0	157
27615	0	161	0	2	0	163
27616	0	1	0	156	0	157
27617	155	1	0	2	0	158
27618	1	0	0	153	0	154
27619	0	154	1	1	0	156
27620	156	1	0	0	0	157
27621	1	1	151	0	0	153
27622	0	0	2	152	0	154
27623	0	0	1	152	0	153
27624	147	1	0	1	0	149
27625	1	146	1	0	0	148
27626	0	1	141	1	0	143
27627	1	0	1	142	0	144
27628	1	0	141	1	0	143
27629	1	137	1	0	0	139
27630	1	138	0	0	0	139
27631	137	2	0	1	0	140
27632	2	0	140	0	0	142
27633	141	1	1	0	0	143
27634	1	0	1	138	0	140
27635	0	140	0	2	0	142
27636	141	2	0	0	0	143
27637	1	1	143	1	0	146
27638	1	0	2	139	0	142
27639	0	0	0	146	0	146
27640	0	2	0	141	0	143
27641	1	141	0	2	0	144
27642	139	1	1	0	0	141
27643	1	134	0	2	0	137
27644	0	141	0	1	0	142
27645	2	1	0	139	0	142
27646	140	1	1	1	0	143
27647	139	0	1	1	0	141
27648	140	0	0	2	0	142
27649	1	130	1	0	0	132
27650	0	2	0	130	0	132
27651	0	1	130	1	0	132
27652	1	0	1	131	0	133
27653	0	0	2	127	0	129
27654	1	129	0	1	0	131
27655	130	2	0	1	0	133
27656	2	1	0	129	0	132
27657	1	132	0	1	0	134
27658	131	1	1	1	0	134
27659	1	0	128	2	0	131
27660	122	1	1	1	0	125
27661	2	129	0	1	0	132
27662	128	2	1	0	0	131
27663	125	0	0	2	0	127
27664	1	2	125	1	0	129
27665	127	1	1	0	0	129
27666	1	1	128	1	0	131
27667	1	0	131	0	0	132
27668	131	1	1	1	0	134
27669	135	1	0	0	0	136
27670	1	1	133	1	0	136
27671	1	0	1	135	0	137
27672	1	0	1	130	0	132
27673	1	137	0	2	0	140
27674	134	2	0	1	0	137
27675	136	1	0	2	0	139
27676	2	0	138	0	0	140
27677	137	0	1	2	0	140
27678	133	1	0	1	0	135
27679	2	141	0	0	0	143
27680	1	2	1	138	0	142
27681	1	0	0	138	0	139
27682	0	2	0	130	0	132
27683	127	0	0	1	0	128
27684	2	121	1	0	0	124
27685	1	2	0	89	0	92
27686	0	87	0	1	0	88
27687	1	2	0	80	0	83
27688	1	83	0	1	0	85
27689	0	84	1	0	0	85
27690	75	1	0	0	0	76
27691	78	0	2	1	0	81
27692	1	0	1	72	0	74
27693	1	0	0	73	0	74
27694	1	0	0	73	0	74
27695	0	0	1	72	0	73
27696	0	0	0	72	0	72
27697	0	70	0	2	0	72
27698	1	2	0	66	0	69
27699	1	0	0	66	0	67
27700	66	0	0	1	0	67
27701	2	0	1	64	0	67
27702	1	0	0	65	0	66
27703	1	0	70	1	0	72
27704	0	1	1	68	0	70
27705	1	0	0	69	0	70
27706	0	0	74	2	0	76
27707	0	81	1	1	0	83
27708	0	1	83	0	0	84
27709	0	1	85	0	0	86
27710	0	85	1	1	0	87
27711	83	2	1	0	0	86
27712	84	0	0	0	0	84
27713	0	0	0	84	0	84
27714	83	0	0	1	0	84
27715	0	0	86	0	0	86
27716	0	0	0	93	0	93
27717	0	0	105	0	0	105
27718	0	0	0	102	0	102
27719	0	0	0	99	0	99
27720	0	0	0	103	0	103
27721	104	0	0	2	0	106
27722	0	0	0	110	0	110
27723	109	0	0	0	0	109
27724	109	0	0	0	0	109
27725	0	110	0	0	0	110
27726	110	0	0	0	0	110
27727	0	112	0	0	0	112
27728	0	0	0	113	0	113
27729	0	0	0	115	0	115
27730	1	0	0	117	0	118
27731	0	0	118	0	0	118
27732	0	118	0	0	0	118
27733	1	0	0	116	0	117
27734	0	0	0	117	0	117
27735	0	117	0	0	0	117
27736	117	0	0	1	0	118
27737	0	116	0	0	0	116
27738	115	0	0	0	0	115
27739	0	116	1	0	0	117
27740	0	0	0	112	0	112
27741	0	118	0	0	0	118
27742	119	0	0	0	0	119
27743	119	0	0	0	0	119
27744	121	0	0	1	0	122
27745	121	0	0	1	0	122
27746	0	0	122	0	0	122
27747	119	0	0	1	0	120
27748	122	0	0	0	0	122
27749	122	0	0	1	0	123
27750	0	0	126	0	0	126
27751	125	0	0	0	0	125
27752	0	127	0	0	0	127
27753	128	0	0	0	0	128
27754	0	0	139	0	0	139
27755	137	0	0	0	0	137
27756	140	0	0	0	0	140
27757	0	0	0	140	0	140
27758	0	0	143	0	0	143
27759	143	0	0	0	0	143
27760	1	0	0	146	0	147
27761	1	0	0	150	0	151
27762	1	0	153	0	0	154
27763	148	0	0	0	0	148
27764	152	0	0	0	0	152
27765	0	157	0	0	0	157
27766	0	0	0	155	0	155
27767	0	0	0	153	0	153
27768	0	0	0	154	0	154
27769	0	155	0	0	0	155
27770	152	0	0	0	0	152
27771	0	0	0	152	0	152
27772	0	0	0	152	0	152
27773	150	0	0	1	0	151
27774	149	0	0	0	0	149
27775	0	0	0	154	0	154
27776	0	0	0	153	0	153
27777	0	0	150	0	0	150
27778	145	0	0	0	0	145
27779	0	148	0	0	0	148
27780	0	0	0	148	0	148
27781	0	0	0	152	0	152
27782	0	162	0	1	0	163
27783	0	1	0	161	0	162
27784	180	1	0	1	0	182
27785	1	0	0	226	0	227
27786	2	0	0	228	0	230
27787	0	0	0	229	0	229
27788	0	1	231	2	0	234
27789	0	0	1	235	0	236
27790	0	0	234	1	0	235
27791	0	227	1	1	0	229
27792	0	1	1	225	0	227
27793	0	1	0	225	0	226
27794	1	0	0	229	0	230
27795	0	0	0	230	0	230
27796	0	0	0	232	0	232
27797	228	0	0	2	0	230
27798	1	0	225	1	0	227
27799	1	226	1	0	0	228
27800	0	230	1	0	0	231
27801	0	2	0	231	0	233
27802	0	1	0	233	0	234
27803	0	0	0	231	0	231
27804	0	233	0	2	0	235
27805	0	1	0	233	0	234
27806	0	2	229	1	0	232
27807	0	224	1	2	0	227
27808	0	2	1	225	0	228
27809	223	1	0	3	0	227
27810	0	0	0	224	0	224
27811	2	0	0	225	0	227
27812	0	221	0	2	0	223
27813	0	226	0	1	0	227
27814	3	2	0	224	0	229
27815	0	1	0	223	0	224
27816	0	0	214	2	0	216
27817	0	1	1	205	0	207
27818	1	2	1	209	0	213
27819	0	0	0	211	0	211
27820	0	0	0	212	0	212
27821	210	0	0	2	0	212
27822	207	0	0	1	0	208
27823	2	0	0	207	0	209
27824	1	0	0	210	0	211
27825	210	0	0	3	0	213
27826	2	1	0	216	0	219
27827	1	0	234	2	0	237
27828	0	236	2	1	0	239
27829	0	2	2	236	0	240
27830	0	1	0	237	0	238
27831	235	0	0	3	0	238
27832	2	0	0	234	0	236
27833	1	0	0	240	0	241
27834	241	0	0	4	0	245
27835	2	0	0	248	0	250
27836	1	245	1	2	0	249
27837	0	3	0	249	0	252
27838	0	1	0	254	0	255
27839	0	0	0	252	0	252
27840	1	0	0	254	0	255
27841	0	1	244	4	0	249
27842	0	0	251	2	0	253
27843	1	0	2	245	0	248
27844	0	0	1	243	0	244
27845	0	246	0	3	0	249
27846	0	2	0	243	0	245
27847	0	245	0	3	0	248
27848	248	2	0	2	0	252
27849	2	259	0	2	0	263
27850	1	2	1	271	0	275
27851	0	1	1	277	0	279
27852	0	0	275	4	0	279
27853	270	0	2	4	0	276
27854	261	1	1	0	0	263
27855	3	266	0	0	0	269
27856	1	3	0	263	0	267
27857	1	1	281	2	0	285
27858	0	283	2	0	0	285
27859	283	2	1	1	0	287
27860	282	1	0	2	0	285
27861	3	0	273	0	0	276
27862	276	0	2	0	0	278
27863	3	0	1	274	0	278
27864	1	276	0	2	0	279
27865	272	2	0	1	0	275
27866	2	1	1	272	0	276
27867	273	1	0	2	0	276
27868	283	0	0	1	0	284
27869	4	0	0	282	0	286
27870	1	0	291	2	0	294
27871	296	0	2	1	0	299
27872	298	0	1	1	0	300
27873	300	1	0	0	0	301
27874	4	301	0	0	0	305
27875	1	2	0	298	0	301
27876	1	1	0	309	0	311
27877	1	0	309	3	0	313
27878	1	0	1	308	0	310
27879	0	305	2	2	0	309
27880	307	1	0	1	0	309
27881	2	302	0	0	0	304
27882	3	1	295	0	0	299
27883	0	300	1	0	0	301
27884	0	294	1	2	0	297
27885	4	2	0	245	0	251
27886	245	1	1	1	0	248
27887	248	0	0	2	0	250
27888	244	1	0	1	0	246
27889	3	252	0	0	0	255
27890	1	2	248	0	0	251
27891	247	1	2	1	0	251
27892	252	1	1	0	0	254
27893	2	250	0	0	0	252
27894	259	1	0	1	0	261
27895	2	1	0	258	0	261
27896	2	0	272	1	0	275
27897	272	0	1	2	0	275
27898	270	1	1	0	0	272
27899	279	0	1	0	0	280
27900	3	0	0	277	0	280
27901	2	0	0	281	0	283
27902	1	1	0	296	0	298
27903	1	302	1	3	0	307
27904	0	2	0	327	0	329
27905	0	2	1	344	0	347
27906	1	0	340	4	0	345
27907	1	0	1	346	0	348
27908	1	0	3	348	0	352
27909	0	0	0	349	0	349
27910	0	0	0	350	0	350
27911	0	344	0	7	0	351
27912	0	4	0	346	0	350
27913	0	3	0	348	0	351
27914	341	0	0	6	0	347
27915	3	0	342	3	0	348
27916	3	0	341	1	0	345
27917	341	0	4	1	0	346
27918	344	0	3	1	0	348
27919	6	0	0	336	0	342
27920	3	340	0	3	0	346
27921	341	3	0	4	0	348
27922	3	3	0	337	0	343
27923	4	347	0	3	0	354
27924	348	2	1	3	0	354
27925	1	348	0	0	0	349
27926	339	2	0	0	0	341
27927	317	3	0	0	0	320
27928	4	311	1	0	0	316
27929	3	1	0	316	0	320
27930	0	2	313	1	0	316
27931	0	0	2	308	0	310
27932	304	0	3	2	0	309
27933	2	0	300	3	0	305
27934	3	295	2	0	0	300
27935	0	2	3	288	0	293
27936	0	3	292	2	0	297
27937	0	290	1	3	0	294
27938	292	3	4	1	0	300
27939	2	3	0	295	0	300
27940	3	0	0	291	0	294
27941	0	0	1	298	0	299
27942	0	292	0	7	0	299
27943	289	2	0	3	0	294
27944	2	290	0	2	0	294
27945	3	289	0	3	0	295
27946	295	5	0	0	0	300
27947	294	2	1	2	0	299
27948	4	0	288	1	0	293
27949	283	0	2	0	0	285
27950	267	0	4	0	0	271
27951	4	1	1	267	0	273
27952	4	1	264	3	0	272
27953	1	0	2	269	0	272
27954	267	0	3	5	0	275
27955	2	2	267	4	0	275
27956	5	0	1	302	0	308
27957	1	1	3	341	0	346
27958	1	1	0	371	0	373
27959	374	1	0	8	0	383
27960	5	372	0	5	0	382
27961	374	5	0	2	0	381
27962	7	3	366	0	0	376
27963	3	1	6	365	0	375
27964	1	373	4	6	0	384
27965	375	5	2	4	0	386
27966	6	4	0	376	0	386
27967	4	0	377	7	0	388
27968	0	1	6	370	0	377
27969	365	2	3	5	0	375
27970	6	345	0	7	0	358
27971	3	7	1	333	0	344
27972	1	350	0	6	0	357
27973	344	4	0	5	0	353
27974	347	4	1	1	0	353
27975	9	340	0	1	0	350
27976	339	7	0	1	0	347
27977	5	7	0	328	0	340
27978	4	333	1	5	0	343
27979	331	6	0	4	0	341
27980	335	3	1	0	0	339
27981	10	326	0	0	0	336
27982	5	329	0	0	0	334
27983	324	6	1	2	0	333
27984	6	1	2	322	0	331
27985	324	1	0	8	0	333
27986	6	0	0	325	0	331
27987	2	0	318	6	0	326
27988	0	0	4	324	0	328
27989	311	0	2	6	0	319
27990	5	1	309	3	0	318
27991	4	0	5	308	0	317
27992	1	1	2	318	0	322
27993	1	0	313	8	0	322
27994	307	0	6	2	0	315
27995	6	0	2	309	0	317
27996	3	1	292	5	0	301
27997	289	0	5	3	0	297
27998	6	293	2	2	0	303
27999	2	293	1	0	0	296
28000	1	296	0	1	0	298
28001	1	6	289	1	0	297
28002	1	10	3	266	0	280
28003	1	1	256	5	0	263
28004	0	2	4	227	0	233
28005	1	225	0	3	0	229
28006	0	224	0	0	0	224
28007	0	5	0	221	0	226
28008	217	0	1	3	0	221
28009	4	0	0	219	0	223
28010	1	0	0	218	0	219
28011	0	220	0	3	0	223
28012	220	2	0	0	0	222
28013	3	221	0	0	0	224
28014	1	4	0	218	0	223
28015	0	0	1	219	0	220
28016	0	217	0	4	0	221
28017	0	4	0	219	0	223
28018	220	0	0	3	0	223
28019	3	0	0	220	0	223
28020	0	0	1	223	0	224
28021	0	219	0	6	0	225
28022	2	3	0	222	0	227
28023	214	2	0	3	0	219
28024	216	0	0	1	0	217
28025	219	2	1	0	0	222
28026	5	0	0	218	0	223
28027	1	1	213	4	0	219
28028	2	1	212	0	0	215
28029	1	4	2	215	0	222
28030	218	0	1	3	0	222
28031	3	1	1	220	0	225
28032	222	0	2	4	0	228
28033	4	2	0	228	0	234
28034	3	1	0	232	0	236
28035	226	4	0	3	0	233
28036	5	0	225	2	0	232
28037	226	2	3	2	0	233
28038	6	1	222	0	0	229
28039	3	0	3	219	0	225
28040	220	2	1	5	0	228
28041	5	1	223	1	0	230
28042	3	0	222	2	0	227
28043	222	2	4	1	0	229
28044	4	2	223	1	0	230
28045	3	220	4	1	0	228
28046	1	5	0	228	0	234
28047	235	2	0	6	0	243
28048	7	0	239	2	0	248
28049	234	0	2	3	0	239
28050	246	1	1	0	0	248
28051	241	1	0	3	0	245
28052	242	1	2	0	0	245
28053	5	2	1	234	0	242
28054	3	234	1	4	0	242
28055	226	3	2	2	0	233
28056	3	0	201	2	0	206
28057	1	140	1	3	0	145
28058	111	0	5	1	0	117
28059	1	109	0	0	0	110
28060	0	111	0	1	0	112
28061	4	0	1	106	0	111
28062	0	0	2	109	0	111
28063	1	0	0	107	0	108
28064	115	0	0	0	0	115
28065	123	0	0	0	0	123
28066	0	0	0	129	0	129
28067	0	0	0	144	0	144
28068	0	0	162	0	0	162
28069	158	0	0	1	0	159
28070	162	0	0	0	0	162
28071	0	0	0	163	0	163
28072	0	0	0	165	0	165
28073	0	0	166	0	0	166
28074	1	0	0	165	0	166
28075	0	0	172	0	0	172
28076	0	171	0	0	0	171
28077	0	0	171	0	0	171
28078	0	0	0	167	0	167
28079	0	1	169	0	0	170
28080	0	0	169	0	0	169
28081	167	0	0	0	0	167
28082	0	0	0	180	0	180
28083	0	0	177	0	0	177
28084	168	0	0	0	0	168
28085	0	0	178	0	0	178
28086	0	1	197	0	0	198
28087	0	202	0	2	0	204
28088	0	0	0	203	0	203
28089	0	0	205	0	0	205
28090	0	0	201	0	0	201
28091	0	0	0	202	0	202
28092	0	0	0	199	0	199
28093	0	201	0	0	0	201
28094	0	0	0	200	0	200
28095	199	0	0	1	0	200
28096	202	0	0	0	0	202
28097	201	0	0	0	0	201
28098	0	0	0	202	0	202
28099	0	203	0	0	0	203
28100	205	0	0	0	0	205
28101	0	207	0	0	0	207
28102	0	200	0	0	0	200
28103	0	204	0	0	0	204
28104	205	0	0	0	0	205
28105	0	0	0	201	0	201
28106	0	0	0	203	0	203
28107	0	200	0	0	0	200
28108	205	0	0	0	0	205
28109	0	0	202	0	0	202
28110	0	0	0	203	0	203
28111	201	0	0	0	0	201
28112	0	207	0	0	0	207
28113	210	0	0	0	0	210
28114	0	0	0	220	0	220
28115	0	224	0	0	0	224
28116	0	0	224	0	0	224
28117	224	0	0	0	0	224
28118	1	0	0	223	0	224
28119	226	0	0	0	0	226
28120	0	0	0	223	0	223
28121	0	224	0	0	0	224
28122	0	0	229	0	0	229
28123	0	0	226	0	0	226
28124	0	0	0	231	0	231
28125	234	0	0	0	0	234
28126	234	0	0	0	0	234
28127	1	0	0	233	0	234
28128	0	0	0	235	0	235
28129	238	0	0	0	0	238
28130	0	2	0	240	0	242
28131	241	0	0	0	0	241
28132	0	243	0	0	0	243
28133	237	0	0	0	0	237
28134	0	0	247	0	0	247
28135	0	0	0	248	0	248
28136	0	0	0	248	0	248
28137	0	0	1	251	0	252
28138	0	253	0	0	0	253
28139	0	238	0	0	0	238
28140	0	0	0	250	0	250
28141	0	0	247	0	0	247
28142	0	0	0	247	0	247
28143	0	0	0	246	0	246
28144	0	11	0	237	0	248
28145	243	0	0	0	0	243
28146	1	235	0	1	0	237
28147	0	248	0	0	0	248
28148	0	0	0	245	0	245
28149	0	0	0	245	0	245
28150	0	0	0	245	0	245
28151	0	0	0	246	0	246
28152	246	0	0	0	0	246
28153	0	245	0	0	0	245
28154	246	0	0	0	0	246
28155	256	0	0	0	0	256
28156	0	0	0	254	0	254
28157	0	0	0	256	0	256
28158	257	0	0	0	0	257
28159	253	0	0	0	0	253
28160	0	0	0	252	0	252
28161	1	0	0	254	0	255
28162	0	0	257	0	0	257
28163	0	247	0	1	0	248
28164	0	252	0	0	0	252
28165	247	0	0	1	0	248
28166	1	0	247	0	0	248
28167	0	0	217	0	0	217
28168	207	0	1	1	0	209
28169	214	0	0	0	0	214
28170	1	225	0	0	0	226
28171	0	236	0	0	0	236
28172	0	1	0	238	0	239
28173	239	0	0	1	0	240
28174	244	0	0	0	0	244
28175	244	0	0	1	0	245
28176	1	0	0	241	0	242
28177	0	0	0	241	0	241
28178	0	0	239	1	0	240
28179	0	0	225	0	0	225
28180	0	0	243	0	0	243
28181	0	4	1	245	0	250
28182	239	0	0	2	0	241
28183	1	0	245	0	0	246
28184	1	1	2	244	0	248
28185	1	254	0	2	0	257
28186	1	2	0	250	0	253
28187	0	0	0	256	0	256
28188	0	0	259	2	0	261
28189	2	0	2	260	0	264
28190	294	0	0	3	0	297
28191	1	0	316	1	0	318
28192	1	0	2	323	0	326
28193	0	0	332	2	0	334
28194	0	336	2	1	0	339
28195	0	3	335	0	0	338
28196	2	1	2	322	0	327
28197	1	0	2	333	0	336
28198	0	0	335	4	0	339
28199	1	0	2	333	0	336
28200	1	0	1	334	0	336
28201	0	334	0	3	0	337
28202	0	2	340	1	0	343
28203	1	1	2	339	0	343
28204	1	0	1	343	0	345
28205	2	343	0	3	0	348
28206	1	4	1	342	0	348
28207	346	1	0	5	0	352
28208	3	0	1	345	0	349
28209	1	1	352	2	0	356
28210	350	0	4	1	0	355
28211	379	0	2	1	0	382
28212	3	0	388	2	0	393
28213	381	0	3	0	0	384
28214	2	392	2	0	0	396
28215	3	2	0	399	0	404
28216	1	3	0	449	0	453
28217	0	0	1	443	0	444
28218	1	0	0	460	0	461
28219	0	0	0	453	0	453
28220	449	1	0	7	0	457
28221	4	1	438	1	0	444
28222	441	0	5	2	0	448
28223	3	0	439	4	0	446
28224	2	0	5	441	0	448
28225	446	1	2	3	0	452
28226	5	0	1	430	0	436
28227	2	442	2	5	0	451
28228	449	4	1	4	0	458
28229	3	2	2	461	0	468
28230	2	1	430	6	0	439
28231	449	0	3	6	0	458
28232	4	487	2	1	0	494
28233	2	4	494	4	0	504
28234	1	1	4	481	0	487
28235	2	0	2	482	0	486
28236	2	479	2	6	0	489
28237	3	5	480	2	0	490
28238	2	1	8	478	0	489
28239	2	0	489	7	0	498
28240	3	1	5	488	0	497
28241	0	1	1	490	0	492
28242	0	1	487	6	0	494
28243	2	0	4	491	0	497
28244	0	3	6	438	0	447
28245	2	0	0	502	0	504
28246	1	0	0	508	0	509
28247	491	1	2	6	0	500
28248	6	0	488	3	0	497
28249	508	1	3	2	0	514
28250	5	0	4	524	0	533
28251	6	1	0	527	0	534
28252	3	0	3	525	0	531
28253	0	526	1	9	0	536
28254	529	7	2	1	0	539
28255	6	2	0	565	0	573
28256	1	561	4	7	0	573
28257	1	5	2	568	0	576
28258	577	2	0	8	0	587
28259	583	2	2	3	0	590
28260	578	0	2	6	0	586
28261	6	572	1	6	0	585
28262	2	7	582	5	0	596
28263	573	4	7	3	0	587
28264	582	0	2	4	0	588
28265	5	588	2	6	0	601
28266	583	7	3	1	0	594
28267	575	1	1	7	0	584
28268	587	1	2	4	0	594
28269	8	599	2	4	0	613
28270	3	5	1	597	0	606
28271	600	2	1	9	0	612
28272	614	0	1	8	0	623
28273	612	1	1	4	0	618
28274	615	2	1	3	0	621
28275	10	2	3	602	0	617
28276	8	1	609	6	0	624
28277	5	0	7	596	0	608
28278	4	601	1	7	0	613
28279	3	6	1	616	0	626
28280	4	3	610	8	0	625
28281	610	0	6	3	0	619
28282	7	5	1	614	0	627
28283	612	3	0	5	0	620
28284	620	1	1	3	0	625
28285	10	1	2	611	0	624
28286	8	1	613	4	0	626
28287	6	2	584	5	0	597
28288	580	4	8	1	0	593
28289	9	582	3	2	0	596
28290	3	557	2	3	0	565
28291	4	558	2	1	0	565
28292	1	580	2	5	0	588
28293	565	3	9	4	0	581
28294	564	2	2	3	0	571
28295	562	3	0	4	0	569
28296	567	1	2	3	0	573
28297	6	2	3	564	0	575
28298	5	553	0	6	0	564
28299	552	2	2	4	0	560
28300	8	1	563	2	0	574
28301	5	560	4	4	0	573
28302	2	5	563	3	0	573
28303	553	2	6	4	0	565
28304	569	2	1	2	0	574
28305	565	2	2	3	0	572
28306	6	2	1	561	0	570
28307	1	2	558	5	0	566
28308	3	560	3	2	0	568
28309	546	3	1	2	0	552
28310	7	540	1	2	0	550
28311	3	527	0	3	0	533
28312	3	520	3	4	0	530
28313	2	523	1	1	0	527
28314	2	5	505	3	0	515
28315	4	504	8	1	0	517
28316	464	2	2	1	0	469
28317	5	0	1	463	0	469
28318	1	3	0	464	0	468
28319	461	1	1	4	0	467
28320	5	456	1	0	0	462
28321	2	3	470	1	0	476
28322	1	2	3	465	0	471
28323	2	2	0	470	0	474
28324	2	1	1	465	0	469
28325	1	3	467	2	0	473
28326	2	3	471	0	0	476
28327	0	0	4	468	0	472
28328	1	3	466	3	0	473
28329	4	0	440	0	0	444
28330	417	1	2	1	0	421
28331	4	437	2	1	0	444
28332	1	405	0	0	0	406
28333	0	415	0	3	0	418
28334	1	2	1	411	0	415
28335	1	415	1	3	0	420
28336	423	1	1	3	0	428
28337	2	2	434	2	0	440
28338	446	0	5	2	0	453
28339	3	0	2	454	0	459
28340	3	0	0	460	0	463
28341	1	467	1	3	0	472
28342	470	3	2	0	0	475
28343	465	1	2	1	0	469
28344	2	486	0	3	0	491
28345	2	4	0	476	0	482
28346	1	2	487	2	0	492
28347	3	1	487	0	0	491
28348	1	496	2	1	0	500
28349	486	4	2	2	0	494
28350	3	1	477	0	0	481
28351	0	2	2	473	0	477
28352	484	0	1	3	0	488
28353	486	0	1	1	0	488
28354	3	599	1	0	0	603
28355	1	631	1	0	0	633
28356	633	7	0	0	0	640
28357	6	2	641	0	0	649
28358	620	3	6	1	0	630
28359	631	0	1	1	0	633
28360	9	0	1	627	0	637
28361	3	0	650	6	0	659
28362	2	0	642	1	0	645
28363	636	0	7	3	0	646
28364	6	1	651	0	0	658
28365	621	0	8	0	0	629
28366	641	2	2	1	0	646
28367	7	636	2	0	0	645
28368	4	7	630	0	0	641
28369	2	631	8	0	0	641
28370	624	7	2	0	0	633
28371	10	2	608	0	0	620
28372	4	2	6	597	0	609
28373	1	0	609	6	0	616
28374	1	1	599	1	0	602
28375	2	0	598	2	0	602
28376	0	0	594	1	0	595
28377	2	586	9	0	0	597
28378	2	9	580	0	0	591
28379	0	582	8	0	0	590
28380	0	7	577	0	0	584
28381	575	2	7	1	0	585
28382	9	1	1	563	0	574
28383	1	590	3	4	0	598
28384	576	6	0	2	0	584
28385	561	1	2	2	0	566
28386	554	1	2	1	0	558
28387	569	0	3	1	0	573
28388	9	561	2	2	0	574
28389	545	7	0	2	0	554
28390	564	1	2	2	0	569
28391	6	533	0	0	0	539
28392	3	7	514	0	0	524
28393	5	1	6	501	0	513
28394	0	525	1	7	0	533
28395	0	7	528	2	0	537
28396	2	2	530	1	0	535
28397	2	529	9	0	0	540
28398	1	525	3	0	0	529
28399	3	530	0	0	0	533
28400	1	526	1	1	0	529
28401	528	7	1	1	0	537
28402	536	2	1	1	0	540
28403	9	2	534	0	0	545
28404	3	1	541	0	0	545
28405	3	2	9	535	0	549
28406	1	3	2	536	0	542
28407	1	0	3	546	0	550
28408	540	0	3	8	0	551
28409	9	537	0	4	0	550
28410	2	545	0	2	0	549
28411	1	546	1	1	0	549
28412	532	13	4	0	0	549
28413	553	3	2	0	0	558
28414	14	1	1	540	0	556
28415	555	0	4	8	0	567
28416	557	0	2	2	0	561
28417	12	3	1	548	0	564
28418	549	3	2	12	0	566
28419	12	537	2	3	0	554
28420	7	9	2	545	0	563
28421	5	3	538	9	0	555
28422	3	534	10	4	0	551
28423	3	11	540	3	0	557
28424	3	3	13	516	0	535
28425	2	539	5	9	0	555
28426	4	9	5	539	0	557
28427	3	5	3	543	0	554
28428	6	3	534	11	0	554
28429	4	2	574	5	0	585
28430	5	1	13	570	0	589
28431	4	4	8	548	0	564
28432	1	569	7	13	0	590
28433	550	13	4	3	0	570
28434	11	554	4	2	0	571
28435	6	563	4	2	0	575
28436	4	11	548	5	0	568
28437	3	542	10	1	0	556
28438	1	10	10	515	0	536
28439	1	518	6	9	0	534
28440	4	12	5	500	0	521
28441	2	517	5	10	0	534
28442	514	12	2	4	0	532
28443	10	515	3	4	0	532
28444	7	13	3	465	0	488
28445	8	488	2	9	0	507
28446	481	13	1	3	0	498
28447	480	5	0	2	0	487
28448	13	465	5	1	0	484
28449	455	10	0	2	0	467
28450	10	8	2	440	0	460
28451	6	5	440	8	0	459
28452	3	3	441	5	0	452
28453	2	436	9	1	0	448
28454	299	3	4	1	0	307
28455	291	2	1	1	0	295
28456	5	1	286	1	0	293
28457	1	0	282	1	0	284
28458	274	0	6	2	0	282
28459	274	2	1	6	0	283
28460	5	0	269	2	0	276
28461	249	1	5	1	0	256
28462	5	245	3	2	0	255
28463	1	264	1	0	0	266
28464	0	7	1	254	0	262
28465	1	1	1	265	0	268
28466	262	3	0	5	0	270
28467	260	1	0	1	0	262
28468	259	3	1	0	0	263
28469	4	1	0	249	0	254
28470	1	1	1	255	0	258
28471	1	239	0	4	0	244
28472	0	243	0	2	0	245
28473	0	248	0	1	0	249
28474	1	5	0	234	0	240
28475	1	246	0	4	0	251
28476	2	4	241	2	0	249
28477	230	3	5	0	0	238
28478	6	0	241	0	0	247
28479	2	1	233	1	0	237
28480	236	1	6	0	0	243
28481	5	234	2	0	0	241
28482	235	6	0	1	0	242
28483	240	1	1	0	0	242
28484	6	0	229	1	0	236
28485	1	1	240	0	0	242
28486	1	232	7	2	0	242
28487	2	6	242	0	0	250
28488	2	1	4	250	0	257
28489	3	0	3	232	0	238
28490	2	243	1	5	0	251
28491	1	256	1	1	0	259
28492	254	5	0	0	0	259
28493	265	1	0	1	0	267
28494	4	1	1	255	0	261
28495	3	1	0	259	0	263
28496	253	1	0	5	0	259
28497	255	1	0	3	0	259
28498	6	247	0	2	0	255
28499	247	4	0	1	0	252
28500	6	233	0	0	0	239
28501	2	239	0	1	0	242
28502	239	4	0	1	0	244
28503	238	2	1	1	0	242
28504	4	1	0	238	0	243
28505	235	1	0	4	0	240
28506	4	0	236	1	0	241
28507	1	238	3	0	0	242
28508	238	3	2	0	0	243
28509	5	1	239	0	0	245
28510	1	3	3	220	0	227
28511	0	224	3	2	0	229
28512	1	233	0	0	0	234
28513	230	3	0	1	0	234
28514	4	1	224	0	0	229
28515	216	0	1	1	0	218
28516	1	0	2	216	0	219
28517	1	0	215	1	0	217
28518	213	2	1	1	0	217
28519	1	231	2	0	0	234
28520	0	238	0	1	0	239
28521	240	1	1	0	0	242
28522	239	1	0	0	0	240
28523	245	1	0	0	0	246
28524	2	0	0	245	0	247
28525	1	0	0	248	0	249
28526	0	0	242	2	0	244
28527	0	0	236	1	0	237
28528	1	247	1	1	0	250
28529	0	1	0	214	0	215
28530	211	0	2	2	0	215
28531	1	208	0	1	0	210
28532	0	1	0	211	0	212
28533	206	0	0	1	0	207
28534	1	212	0	0	0	213
28535	0	224	0	0	0	224
28536	0	1	222	0	0	223
28537	223	0	1	0	0	224
28538	225	0	0	1	0	226
28539	1	0	225	0	0	226
28540	216	0	1	0	0	217
28541	1	0	222	0	0	223
28542	0	215	1	0	0	216
28543	0	6	0	214	0	220
28544	219	0	0	1	0	220
28545	1	217	0	0	0	218
28546	0	219	0	0	0	219
28547	215	1	0	0	0	216
28548	1	1	229	0	0	231
28549	216	0	1	0	0	217
28550	1	225	2	0	0	228
28551	0	1	221	0	0	222
28552	224	0	1	0	0	225
28553	231	0	0	1	0	232
28554	0	0	0	233	0	233
28555	0	1	0	238	0	239
28556	0	240	0	0	0	240
28557	1	0	236	0	0	237
28558	1	0	0	240	0	241
28559	0	0	251	1	0	252
28560	0	0	258	1	0	259
28561	1	0	1	275	0	277
28562	1	0	281	1	0	283
28563	0	2	263	0	0	265
28564	1	1	1	264	0	267
28565	0	0	269	1	0	270
28566	259	1	1	0	0	261
28567	3	267	0	0	0	270
28568	1	2	278	0	0	281
28569	0	0	314	1	0	315
28570	1	0	2	309	0	312
28571	322	0	1	2	0	325
28572	323	1	0	0	0	324
28573	325	0	0	0	0	325
28574	324	0	1	0	0	325
28575	2	0	0	314	0	316
28576	0	0	324	2	0	326
28577	332	1	2	1	0	336
28578	336	0	0	0	0	336
28579	334	0	1	0	0	335
28580	3	0	330	0	0	333
28581	323	0	2	1	0	326
28582	3	0	1	341	0	345
28583	1	342	0	4	0	347
28584	0	5	0	346	0	351
28585	0	349	0	2	0	351
28586	355	3	0	1	0	359
28587	3	0	360	0	0	363
28588	1	0	2	351	0	354
28589	0	358	1	3	0	362
28590	0	364	0	0	0	364
28591	359	2	0	1	0	362
28592	361	0	0	0	0	361
28593	3	0	350	0	0	353
28594	350	0	3	1	0	354
28595	3	0	0	352	0	355
28596	0	0	362	3	0	365
28597	0	0	361	0	0	361
28598	0	0	3	364	0	367
28599	389	0	0	3	0	392
28600	4	0	0	384	0	388
28601	0	0	0	393	0	393
28602	0	0	0	390	0	390
28603	1	387	0	4	0	392
28604	0	4	0	391	0	395
28605	390	0	0	5	0	395
28606	3	382	0	1	0	386
28607	0	5	0	383	0	388
28608	384	0	0	5	0	389
28609	4	380	0	0	0	384
28610	0	390	0	0	0	390
28611	0	3	0	387	0	390
28612	375	0	0	4	0	379
28613	4	1	377	0	0	382
28614	0	1	373	0	0	374
28615	374	0	4	1	0	379
28616	395	0	0	2	0	397
28617	4	403	1	0	0	408
28618	0	4	1	391	0	396
28619	1	0	394	4	0	399
28620	2	0	381	0	0	383
28621	0	1	407	0	0	408
28622	0	404	3	3	0	410
28623	0	406	1	0	0	407
28624	404	4	1	1	0	410
28625	4	0	407	0	0	411
28626	398	1	3	1	0	403
28627	410	1	0	0	0	411
28628	5	0	416	0	0	421
28629	0	420	5	1	0	426
28630	1	4	0	422	0	427
28631	1	0	431	4	0	436
28632	0	1	423	0	0	424
28633	425	1	4	1	0	431
28634	5	424	0	1	0	430
28635	1	4	2	409	0	416
28636	1	0	1	408	0	410
28637	2	414	0	4	0	420
28638	0	428	1	0	0	429
28639	0	431	0	1	0	432
28640	0	5	0	438	0	443
28641	464	1	1	5	0	471
28642	5	0	0	467	0	472
28643	1	1	465	5	0	472
28644	1	1	470	1	0	473
28645	2	0	6	471	0	479
28646	1	0	467	6	0	474
28647	1	470	5	0	0	476
28648	0	6	2	486	0	494
28649	518	2	0	6	0	526
28650	517	0	1	3	0	521
28651	7	525	1	0	0	533
28652	523	6	1	2	0	532
28653	532	0	1	0	0	533
28654	532	1	1	1	0	535
28655	8	1	487	2	0	498
28656	511	1	5	1	0	518
28657	7	514	0	2	0	523
28658	1	8	511	2	0	522
28659	1	1	507	0	0	509
28660	1	495	7	1	0	504
28661	482	11	2	0	0	495
28662	9	1	1	466	0	477
28663	1	476	1	6	0	484
28664	482	6	1	1	0	490
28665	7	1	0	486	0	494
28666	485	1	1	7	0	494
28667	5	5	0	488	0	498
28668	1	0	488	7	0	496
28669	2	1	451	1	0	455
28670	1	1	454	1	0	457
28671	3	1	6	445	0	455
28672	1	0	2	454	0	457
28673	0	1	456	5	0	462
28674	2	446	7	0	0	455
28675	453	6	1	3	0	463
28676	446	0	1	3	0	450
28677	7	460	1	1	0	469
28678	2	9	2	464	0	477
28679	2	1	479	6	0	488
28680	478	2	7	1	0	488
28681	9	2	482	2	0	495
28682	3	0	455	2	0	460
28683	2	2	466	2	0	472
28684	465	1	6	0	0	472
28685	7	5	456	2	0	470
28686	5	445	11	1	0	462
28687	1	454	8	1	0	464
28688	3	8	4	436	0	451
28689	4	2	6	441	0	453
28690	5	3	439	9	0	456
28691	434	4	7	2	0	447
28692	446	2	1	3	0	452
28693	10	1	3	440	0	454
28694	447	4	2	6	0	459
28695	9	440	2	3	0	454
28696	431	6	3	2	0	442
28697	7	421	4	6	0	438
28698	4	427	4	2	0	437
28699	418	4	2	6	0	430
28700	410	3	4	2	0	419
28701	418	1	4	3	0	426
28702	424	2	3	3	0	432
28703	6	2	405	3	0	416
28704	409	2	5	2	0	418
28705	7	4	3	398	0	412
28706	2	412	2	10	0	426
28707	412	7	5	0	0	424
28708	7	410	0	7	0	424
28709	416	5	6	2	0	429
28710	7	0	6	418	0	431
28711	2	2	6	422	0	432
28712	6	0	408	6	0	420
28713	4	1	416	1	0	422
28714	4	421	6	3	0	434
28715	406	9	3	3	0	421
28716	9	407	2	2	0	420
28717	3	392	3	2	0	400
28718	4	403	2	1	0	410
28719	8	5	394	1	0	408
28720	4	391	7	4	0	406
28721	367	5	1	4	0	377
28722	365	0	4	1	0	370
28723	6	3	3	354	0	366
28724	4	346	5	4	0	359
28725	2	355	1	3	0	361
28726	2	5	2	351	0	360
28727	3	1	357	5	0	366
28728	3	343	6	0	0	352
28729	3	13	0	326	0	342
28730	319	1	0	7	0	327
28731	324	1	1	3	0	329
28732	7	331	0	1	0	339
28733	329	4	2	3	0	338
28734	331	2	1	1	0	335
28735	8	1	2	322	0	333
28736	1	3	311	5	0	320
28737	3	323	4	2	0	332
28738	2	6	0	313	0	321
28739	3	0	312	4	0	319
28740	0	298	4	1	0	303
28741	266	3	1	0	0	270
28742	270	1	0	2	0	273
28743	5	1	1	270	0	277
28744	1	268	2	4	0	275
28745	0	4	269	1	0	274
28746	5	1	2	267	0	275
28747	1	1	266	3	0	271
28748	1	243	4	1	0	249
28749	2	3	2	205	0	212
28750	202	1	1	2	0	206
28751	3	205	1	1	0	210
28752	201	3	4	0	0	208
28753	203	1	0	0	0	204
28754	4	205	0	0	0	209
28755	0	1	1	209	0	211
28756	2	0	2	205	0	209
28757	1	199	0	2	0	202
28758	1	204	0	1	0	206
28759	1	2	1	192	0	196
28760	1	199	0	1	0	201
28761	203	2	0	0	0	205
28762	200	0	0	1	0	201
28763	2	1	198	2	0	203
28764	1	2	192	0	0	195
28765	188	0	4	0	0	192
28766	195	1	0	1	0	197
28767	3	200	1	0	0	204
28768	198	5	0	0	0	203
28769	198	1	1	1	0	201
28770	4	194	0	0	0	198
28771	197	3	1	1	0	202
28772	3	3	0	234	0	240
28773	3	0	0	243	0	246
28774	1	2	266	2	0	271
28775	1	252	4	2	0	259
28776	0	260	0	2	0	262
28777	240	6	1	2	0	249
28778	237	1	0	1	0	239
28779	224	0	2	2	0	228
28780	236	2	0	0	0	238
28781	3	0	230	1	0	234
28782	1	0	232	0	0	233
28783	1	234	3	0	0	238
28784	0	3	1	232	0	236
28785	3	0	0	227	0	230
28786	2	235	0	2	0	239
28787	1	4	0	227	0	232
28788	226	0	1	3	0	230
28789	3	223	0	5	0	231
28790	0	4	229	1	0	234
28791	1	233	3	1	0	238
28792	234	4	0	2	0	240
28793	4	0	229	1	0	234
28794	231	0	4	0	0	235
28795	235	2	0	0	0	237
28796	5	1	234	0	0	240
28797	3	0	238	0	0	241
28798	1	1	236	0	0	238
28799	220	0	2	1	0	223
28800	3	0	234	1	0	238
28801	0	230	4	0	0	234
28802	224	5	0	0	0	229
28803	3	0	228	2	0	233
28804	217	1	3	2	0	223
28805	4	1	222	0	0	227
28806	2	0	233	1	0	236
28807	1	231	4	0	0	236
28808	0	4	237	0	0	241
28809	1	0	231	0	0	232
28810	1	215	2	0	0	218
28811	225	4	0	0	0	229
28812	4	0	225	0	0	229
28813	2	0	3	216	0	221
28814	1	229	0	3	0	233
28815	229	3	1	0	0	233
28816	226	0	1	1	0	228
28817	3	0	225	2	0	230
28818	1	216	5	0	0	222
28819	0	222	1	0	0	223
28820	0	6	0	215	0	221
28821	2	214	0	1	0	217
28822	3	3	0	213	0	219
28823	3	0	0	222	0	225
28824	2	227	1	3	0	233
28825	0	2	1	220	0	223
28826	0	229	2	3	0	234
28827	0	4	219	2	0	225
28828	0	0	3	220	0	223
28829	1	1	1	222	0	225
28830	2	222	0	2	0	226
28831	0	227	1	2	0	230
28832	4	3	0	218	0	225
28833	0	221	2	3	0	226
28834	221	3	3	1	0	228
28835	5	3	0	218	0	226
28836	2	218	1	4	0	225
28837	213	4	3	1	0	221
28838	5	213	0	0	0	218
28839	2	3	210	2	0	217
28840	1	1	4	209	0	215
28841	207	2	2	5	0	216
28842	4	0	216	1	0	221
28843	3	2	2	212	0	219
28844	1	208	2	5	0	216
28845	0	3	208	0	0	211
28846	3	210	3	0	0	216
28847	201	3	2	1	0	207
28848	206	0	2	1	0	209
28849	4	200	3	0	0	207
28850	199	3	1	0	0	203
28851	4	1	196	1	0	202
28852	0	1	5	191	0	197
28853	1	1	2	190	0	194
28854	2	189	1	3	0	195
28855	203	3	2	0	0	208
28856	208	0	1	0	0	209
28857	4	1	205	0	0	210
28858	205	1	5	0	0	211
28859	211	0	0	1	0	212
28860	212	0	2	0	0	214
28861	3	0	4	205	0	212
28862	1	2	0	209	0	212
28863	1	208	1	2	0	212
28864	205	2	3	0	0	210
28865	205	3	0	1	0	209
28866	4	203	0	1	0	208
28867	0	3	1	191	0	195
28868	1	194	0	3	0	198
28869	1	203	0	0	0	204
28870	202	4	0	0	0	206
28871	3	2	196	1	0	202
28872	0	0	151	1	0	152
28873	0	148	3	0	0	151
28874	123	1	1	1	0	126
28875	1	0	125	1	0	127
28876	0	130	2	0	0	132
28877	120	1	0	0	0	121
28878	1	0	125	0	0	126
28879	2	0	2	124	0	128
28880	131	0	0	2	0	133
28881	2	0	134	0	0	136
28882	1	0	138	0	0	139
28883	0	0	139	0	0	139
28884	0	0	142	0	0	142
28885	138	0	2	0	0	140
28886	147	0	1	1	0	149
28887	2	148	0	0	0	150
28888	1	1	0	154	0	156
28889	0	1	0	155	0	156
28890	0	146	0	2	0	148
28891	0	1	0	150	0	151
28892	0	159	0	1	0	160
28893	0	158	0	0	0	158
28894	0	2	0	157	0	159
28895	0	0	162	1	0	163
28896	1	160	1	0	0	162
28897	1	1	1	156	0	159
28898	158	1	0	1	0	160
28899	1	0	159	1	0	161
28900	154	0	1	0	0	155
28901	162	0	1	0	0	163
28902	2	0	0	163	0	165
28903	1	0	176	1	0	178
28904	0	0	174	1	0	175
28905	0	185	2	0	0	187
28906	1	2	1	174	0	178
28907	0	1	179	2	0	182
28908	1	0	182	0	0	183
28909	0	183	4	0	0	187
28910	183	2	1	0	0	186
28911	187	1	0	0	0	188
28912	4	0	0	208	0	212
28913	1	0	212	5	0	218
28914	0	0	211	1	0	212
28915	0	214	6	0	0	220
28916	0	5	215	1	0	221
28917	0	1	215	0	0	216
28918	1	0	7	211	0	219
28919	0	1	218	5	0	224
28920	216	0	6	2	0	224
28921	6	1	1	217	0	225
28922	2	0	221	5	0	228
28923	1	226	6	1	0	234
28924	0	5	1	222	0	228
28925	0	2	227	5	0	234
28926	0	234	7	1	0	242
28927	0	6	2	225	0	233
28928	0	237	1	4	0	242
28929	1	5	2	232	0	240
28930	1	1	0	236	0	238
28931	1	0	234	6	0	241
28932	1	230	6	1	0	238
28933	1	6	1	233	0	241
28934	0	1	1	237	0	239
28935	0	1	1	242	0	244
28936	0	1	235	7	0	243
28937	1	233	6	0	0	240
28938	1	7	1	235	0	244
28939	0	1	235	7	0	243
28940	0	234	5	2	0	241
28941	0	5	2	237	0	244
28942	0	2	240	6	0	248
28943	0	240	6	2	0	248
28944	0	6	1	237	0	244
28945	1	2	0	247	0	250
28946	0	0	254	6	0	260
28947	244	1	5	3	0	253
28948	5	254	3	2	0	264
28949	256	7	2	0	0	265
28950	5	2	258	1	0	266
28951	261	0	6	2	0	269
28952	5	1	3	268	0	277
28953	1	1	2	276	0	280
28954	0	1	270	8	0	279
28955	254	1	6	2	0	263
28956	258	0	3	2	0	263
28957	6	260	0	2	0	268
28958	1	271	2	1	0	275
28959	266	7	1	1	0	275
28960	5	3	267	1	0	276
28961	3	278	6	1	0	288
28962	0	4	2	282	0	288
28963	1	1	1	284	0	287
28964	1	1	281	7	0	290
28965	277	1	6	4	0	288
28966	7	0	288	1	0	296
28967	292	1	6	1	0	300
28968	8	2	313	0	0	323
28969	3	312	6	2	0	323
28970	309	7	3	3	0	322
28971	314	3	1	3	0	321
28972	322	0	2	1	0	325
28973	318	1	0	3	0	322
28974	8	0	1	314	0	323
28975	3	1	315	6	0	325
28976	1	1	8	307	0	317
28977	2	316	2	5	0	325
28978	0	5	2	309	0	316
28979	1	4	313	5	0	323
28980	1	0	321	3	0	325
28981	1	2	7	314	0	324
28982	316	0	2	5	0	323
28983	313	0	0	2	0	315
28984	316	1	0	2	0	319
28985	8	0	316	0	0	324
28986	1	1	320	2	0	324
28987	2	319	8	0	0	329
28988	1	319	1	3	0	324
28989	317	8	1	2	0	328
28990	319	1	2	1	0	323
28991	8	326	1	2	0	337
28992	325	6	1	0	0	332
28993	326	2	0	0	0	328
28994	8	328	0	0	0	336
28995	328	6	1	1	0	336
28996	329	1	3	1	0	334
28997	7	329	0	0	0	336
28998	331	7	0	2	0	340
28999	331	2	0	2	0	335
29000	9	1	337	0	0	347
29001	4	1	333	0	0	338
29002	2	327	8	0	0	337
29003	1	331	2	0	0	334
29004	323	7	2	0	0	332
29005	318	3	2	0	0	323
29006	318	0	0	1	0	319
29007	8	317	0	0	0	325
29008	3	5	0	321	0	329
29009	2	1	329	4	0	336
29010	2	1	4	324	0	331
29011	0	326	2	3	0	331
29012	308	2	0	1	0	311
29013	3	304	0	0	0	307
29014	1	3	0	314	0	318
29015	336	1	1	3	0	341
29016	336	0	0	1	0	337
29017	3	0	352	0	0	355
29018	351	0	4	1	0	356
29019	363	0	1	0	0	364
29020	363	1	0	1	0	365
29021	5	0	0	358	0	363
29022	2	362	0	3	0	367
29023	1	3	0	367	0	371
29024	0	2	380	3	0	385
29025	0	375	3	2	0	380
29026	1	3	1	371	0	376
29027	0	1	380	3	0	384
29028	0	384	3	1	0	388
29029	0	3	1	374	0	378
29030	0	1	382	3	0	386
29031	355	0	4	1	0	360
29032	3	0	386	0	0	389
29033	1	0	386	0	0	387
29034	0	391	4	0	0	395
29035	0	3	1	396	0	400
29036	1	1	0	388	0	390
29037	0	385	1	3	0	389
29038	0	3	0	399	0	402
29039	402	1	0	3	0	406
29040	404	0	0	1	0	405
29041	4	0	407	0	0	411
29042	410	0	3	1	0	414
29043	417	0	1	0	0	418
29044	4	0	416	0	0	420
29045	1	418	3	0	0	422
29046	0	413	1	0	0	414
29047	0	3	0	400	0	403
29048	0	408	0	3	0	411
29049	0	3	394	2	0	399
29050	0	1	388	1	0	390
29051	0	410	4	0	0	414
29052	409	4	1	0	0	414
29053	416	1	0	0	0	417
29054	416	0	0	1	0	417
29055	417	0	0	0	0	417
29056	401	1	0	0	0	402
29057	5	406	0	0	0	411
29058	1	5	398	0	0	404
29059	0	1	4	394	0	399
29060	393	0	1	4	0	398
29061	4	382	0	1	0	387
29062	1	4	0	384	0	389
29063	0	1	381	3	0	385
29064	0	372	3	1	0	376
29065	0	384	1	0	0	385
29066	375	3	0	0	0	378
29067	2	368	0	0	0	370
29068	0	3	0	346	0	349
29069	342	0	0	4	0	346
29070	346	0	0	0	0	346
29071	344	0	0	1	0	345
29072	3	0	337	0	0	340
29073	0	337	3	0	0	340
29074	348	3	0	0	0	351
29075	3	0	0	339	0	342
29076	345	0	0	4	0	349
29077	4	332	0	2	0	338
29078	358	4	0	0	0	362
29079	384	0	0	0	0	384
29080	4	0	0	372	0	376
29081	0	0	391	5	0	396
29082	0	0	4	390	0	394
29083	396	0	0	5	0	401
29084	398	0	0	3	0	401
29085	5	385	1	0	0	391
29086	380	4	0	1	0	385
29087	5	380	0	0	0	385
29088	383	4	0	0	0	387
29089	378	2	0	1	0	381
29090	5	1	378	0	0	384
29091	0	381	3	0	0	384
29092	1	4	0	382	0	387
29093	0	0	0	386	0	386
29094	1	0	2	376	0	379
29095	0	383	0	4	0	387
29096	0	5	381	1	0	387
29097	0	0	386	1	0	387
29098	0	456	4	1	0	461
29099	457	7	0	0	0	464
29100	8	0	450	0	0	458
29101	451	0	8	0	0	459
29102	5	452	0	0	0	457
29103	1	6	458	0	0	465
29104	1	0	7	456	0	464
29105	1	0	463	6	0	470
29106	0	1	483	0	0	484
29107	0	0	7	458	0	465
29108	0	457	1	7	0	465
29109	0	472	2	0	0	474
29110	465	6	0	1	0	472
29111	6	0	462	1	0	469
29112	455	1	6	0	0	462
29113	461	1	0	0	0	462
29114	7	458	0	0	0	465
29115	431	6	1	0	0	438
29116	438	0	0	0	0	438
29117	409	0	2	0	0	411
29118	6	405	0	0	0	411
29119	1	385	0	0	0	386
29120	1	399	0	3	0	403
29121	398	4	1	2	0	405
29122	399	0	0	1	0	400
29123	5	1	394	0	0	400
29124	0	1	378	0	0	379
29125	379	0	6	1	0	386
29126	389	0	0	0	0	389
29127	388	0	0	0	0	388
29128	4	0	1	380	0	385
29129	2	0	0	379	0	381
29130	2	0	0	380	0	382
29131	1	0	0	378	0	379
29132	0	0	364	6	0	370
29133	0	0	369	1	0	370
29134	0	0	363	1	0	364
29135	0	0	360	1	0	361
29136	358	0	6	1	0	365
29137	5	362	0	0	0	367
29138	2	369	1	0	0	372
29139	362	5	2	0	0	369
29140	7	0	358	0	0	365
29141	0	1	346	0	0	347
29142	343	1	5	0	0	349
29143	350	0	0	0	0	350
29144	4	349	1	0	0	354
29145	0	5	1	343	0	349
29146	348	0	0	5	0	353
29147	356	0	0	0	0	356
29148	5	3	0	350	0	358
29149	0	363	0	5	0	368
29150	369	4	0	0	0	373
29151	5	0	354	0	0	359
29152	353	0	4	1	0	358
29153	4	356	0	0	0	360
29154	360	4	0	0	0	364
29155	358	0	2	0	0	360
29156	5	0	362	0	0	367
29157	2	2	359	0	0	363
29158	362	0	6	0	0	368
29159	369	0	0	1	0	370
29160	4	375	2	0	0	381
29161	1	4	3	378	0	386
29162	1	1	376	6	0	384
29163	374	0	5	1	0	380
29164	4	2	2	374	0	382
29165	2	1	0	382	0	385
29166	373	1	2	5	0	381
29167	6	400	2	0	0	408
29168	401	4	0	3	0	408
29169	401	2	2	1	0	406
29170	409	0	2	0	0	411
29171	6	397	0	5	0	408
29172	401	4	1	0	0	406
29173	6	3	1	396	0	406
29174	4	0	0	397	0	401
29175	0	3	394	3	0	400
29176	4	2	394	0	0	400
29177	3	393	3	1	0	400
29178	1	399	2	3	0	405
29179	4	2	366	1	0	373
29180	3	381	4	0	0	388
29181	372	4	2	0	0	378
29182	380	2	1	0	0	383
29183	385	2	0	0	0	387
29184	4	2	1	372	0	379
29185	3	3	0	382	0	388
29186	2	1	401	4	0	408
29187	2	407	2	1	0	412
29188	396	2	2	2	0	402
29189	5	400	1	2	0	408
29190	404	2	2	1	0	409
29191	403	1	2	1	0	407
29192	5	2	1	399	0	407
29193	3	1	1	398	0	403
29194	4	2	0	409	0	415
29195	2	2	402	4	0	410
29196	2	383	3	1	0	389
29197	3	379	1	3	0	386
29198	1	301	0	2	0	304
29199	0	302	1	2	0	305
29200	0	307	1	1	0	309
29201	298	2	0	2	0	302
29202	0	2	309	0	0	311
29203	0	309	1	0	0	310
29204	0	2	303	0	0	305
29205	1	310	0	0	0	311
29206	4	4	1	255	0	264
29207	1	0	1	299	0	301
29208	1	302	0	1	0	304
29209	302	0	2	1	0	305
29210	0	1	305	0	0	306
29211	0	311	0	1	0	312
29212	1	1	319	1	0	322
29213	1	2	0	319	0	322
29214	3	0	0	308	0	311
29215	1	313	2	0	0	316
29216	1	1	0	320	0	322
29217	0	0	2	321	0	323
29218	0	323	0	2	0	325
29219	0	0	322	1	0	323
29220	0	2	324	1	0	327
29221	316	1	1	3	0	321
29222	327	2	0	1	0	330
29223	0	2	0	316	0	318
29224	0	1	322	0	0	323
29225	1	1	1	312	0	315
29226	1	337	2	0	0	340
29227	1	2	343	0	0	346
29228	1	339	1	1	0	342
29229	1	1	344	0	0	346
29230	0	343	0	2	0	345
29231	345	1	1	1	0	348
29232	0	1	1	344	0	346
29233	1	2	0	339	0	342
29234	0	0	346	0	0	346
29235	0	3	325	0	0	328
29236	1	341	1	0	0	343
29237	339	1	0	2	0	342
29238	0	0	0	343	0	343
29239	0	1	351	1	0	353
29240	0	0	338	3	0	341
29241	341	1	1	2	0	345
29242	342	1	1	1	0	345
29243	0	1	356	1	0	358
29244	1	1	3	344	0	349
29245	1	351	1	1	0	354
29246	356	1	1	0	0	358
29247	1	346	2	1	0	350
29248	340	1	1	0	0	342
29249	2	335	0	2	0	339
29250	1	334	1	2	0	338
29251	2	0	0	336	0	338
29252	0	2	0	340	0	342
29253	3	343	0	1	0	347
29254	0	2	335	1	0	338
29255	0	2	332	1	0	335
29256	1	0	334	1	0	336
29257	320	3	0	2	0	325
29258	334	1	0	1	0	336
29259	1	348	1	1	0	351
29260	1	2	344	2	0	349
29261	1	1	3	353	0	358
29262	0	0	361	4	0	365
29263	2	0	373	2	0	377
29264	1	2	3	401	0	407
29265	2	1	3	431	0	437
29266	1	2	467	9	0	479
29267	453	2	9	5	0	469
29268	9	480	4	2	0	495
29269	4	509	2	1	0	516
29270	1	13	2	505	0	521
29271	515	5	1	10	0	531
29272	12	516	3	4	0	535
29273	517	13	1	1	0	532
29274	13	516	1	1	0	531
29275	529	14	0	1	0	544
29276	13	4	521	3	0	541
29277	4	2	534	2	0	542
29278	3	4	15	512	0	534
29279	2	1	522	12	0	537
29280	2	497	15	3	0	517
29281	2	492	3	1	0	498
29282	489	16	4	2	0	511
29283	14	4	1	473	0	492
29284	3	487	1	13	0	504
29285	498	12	1	3	0	514
29286	478	6	0	3	0	487
29287	494	2	0	1	0	497
29288	18	0	1	481	0	500
29289	5	1	1	495	0	502
29290	2	1	480	17	0	500
29291	1	0	486	4	0	491
29292	473	1	16	1	0	491
29293	16	1	4	475	0	496
29294	6	0	479	14	0	499
29295	477	0	14	7	0	498
29296	12	500	7	1	0	520
29297	507	14	2	1	0	524
29298	517	5	0	3	0	525
29299	519	1	1	3	0	524
29300	19	0	492	1	0	512
29301	497	2	13	0	0	512
29302	16	1	5	482	0	504
29303	7	475	3	12	0	497
29304	5	497	2	4	0	508
29305	490	17	1	5	0	513
29306	500	5	3	2	0	510
29307	505	2	1	1	0	509
29308	17	3	1	482	0	503
29309	9	2	0	495	0	506
29310	3	1	0	485	0	489
29311	3	470	1	19	0	493
29312	468	13	1	8	0	490
29313	480	5	0	1	0	486
29314	484	1	0	5	0	490
29315	19	1	464	3	0	487
29316	476	1	13	2	0	492
29317	16	1	5	457	0	479
29318	9	461	2	10	0	482
29319	456	13	0	5	0	474
29320	457	5	1	3	0	466
29321	18	1	457	0	0	476
29322	9	0	13	450	0	472
29323	2	459	3	14	0	478
29324	465	14	1	4	0	484
29325	18	3	0	469	0	490
29326	7	1	0	474	0	482
29327	1	0	3	471	0	475
29328	2	2	0	482	0	486
29329	2	1	462	20	0	485
29330	2	464	12	6	0	484
29331	2	14	5	465	0	486
29332	3	4	463	12	0	482
29333	465	1	15	8	0	489
29334	479	0	9	4	0	492
29335	18	5	2	468	0	493
29336	470	2	2	18	0	492
29337	492	2	0	6	0	500
29338	20	3	480	3	0	506
29339	11	473	13	1	0	498
29340	479	15	4	4	0	502
29341	20	5	2	477	0	504
29342	493	3	3	14	0	513
29343	19	0	2	484	0	505
29344	5	2	2	499	0	508
29345	3	2	476	20	0	501
29346	464	0	14	9	0	487
29347	13	474	5	4	0	496
29348	7	13	472	4	0	496
29349	2	473	18	5	0	498
29350	469	16	7	3	0	495
29351	17	7	4	467	0	495
29352	474	1	0	18	0	493
29353	19	467	2	9	0	497
29354	478	14	1	4	0	497
29355	488	5	2	3	0	498
29356	488	2	2	3	0	495
29357	484	1	4	2	0	491
29358	23	471	0	2	0	496
29359	462	14	2	2	0	480
29360	17	5	2	459	0	483
29361	11	3	0	452	0	466
29362	7	415	1	17	0	440
29363	5	420	1	7	0	433
29364	5	401	1	3	0	410
29365	360	12	2	4	0	378
29366	7	327	0	2	0	336
29367	5	293	2	1	0	301
29368	289	8	5	3	0	305
29369	282	1	1	0	0	284
29370	5	283	1	2	0	291
29371	274	3	0	1	0	278
29372	4	2	269	1	0	276
29373	272	1	3	1	0	277
29374	6	1	267	1	0	275
29375	4	252	3	0	0	259
29376	2	258	1	0	0	261
29377	4	10	3	237	0	254
29378	244	1	0	3	0	248
29379	249	1	0	2	0	252
29380	254	0	0	1	0	255
29381	251	1	2	2	0	256
29382	246	0	0	0	0	246
29383	4	2	241	0	0	247
29384	2	1	244	0	0	247
29385	240	2	3	1	0	246
29386	3	258	1	0	0	262
29387	254	2	0	0	0	256
29388	267	2	0	0	0	269
29389	278	1	0	0	0	279
29390	281	0	0	1	0	282
29391	279	1	1	0	0	281
29392	3	0	275	1	0	279
29393	286	0	3	1	0	290
29394	293	1	0	1	0	295
29395	1	1	283	0	0	285
29396	261	2	1	2	0	266
29397	274	1	0	2	0	277
29398	2	0	294	1	0	297
29399	3	0	291	0	0	294
29400	3	295	1	0	0	299
29401	2	1	0	296	0	299
29402	2	0	295	1	0	298
29403	303	0	2	0	0	305
29404	2	0	2	311	0	315
29405	0	2	321	1	0	324
29406	323	0	1	0	0	324
29407	322	1	4	1	0	328
29408	327	0	0	0	0	327
29409	2	337	0	2	0	341
29410	2	1	1	342	0	346
29411	1	345	2	1	0	349
29412	352	1	0	0	0	353
29413	349	1	1	1	0	352
29414	2	0	346	0	0	348
29415	0	345	1	0	0	346
29416	1	345	0	0	0	346
29417	0	2	0	343	0	345
29418	1	0	0	344	0	345
29419	344	1	0	2	0	347
29420	3	343	0	0	0	346
29421	1	343	0	0	0	344
29422	2	2	336	0	0	340
29423	0	345	2	0	0	347
29424	336	3	0	2	0	341
29425	3	0	337	0	0	340
29426	322	0	2	0	0	324
29427	2	0	321	0	0	323
29428	307	0	2	0	0	309
29429	3	330	0	3	0	336
29430	343	3	1	0	0	347
29431	3	0	350	0	0	353
29432	350	0	4	2	0	356
29433	353	0	0	0	0	353
29434	3	0	364	0	0	367
29435	370	0	2	0	0	372
29436	371	0	0	0	0	371
29437	364	0	0	2	0	366
29438	3	360	0	0	0	363
29439	369	2	0	0	0	371
29440	2	1	366	0	0	369
29441	2	375	2	1	0	380
29442	373	2	2	0	0	377
29443	373	1	0	0	0	374
29444	380	0	0	0	0	380
29445	3	377	1	0	0	381
29446	2	2	0	443	0	447
29447	1	1	444	4	0	450
29448	1	0	5	441	0	447
29449	0	1	454	5	0	460
29450	450	0	5	2	0	457
29451	5	464	2	0	0	471
29452	2	6	0	453	0	461
29453	0	461	0	5	0	466
29454	2	5	1	467	0	475
29455	2	1	0	470	0	473
29456	0	477	0	6	0	483
29457	1	5	0	480	0	486
29458	0	2	1	504	0	507
29459	0	509	0	7	0	516
29460	0	526	0	2	0	528
29461	1	5	0	518	0	524
29462	1	2	517	5	0	525
29463	0	521	6	3	0	530
29464	0	8	1	521	0	530
29465	1	2	536	7	0	546
29466	1	535	6	3	0	545
29467	536	7	2	1	0	546
29468	6	2	526	1	0	535
29469	524	1	6	3	0	534
29470	7	1	3	526	0	537
29471	1	2	1	531	0	535
29472	3	0	1	532	0	536
29473	0	0	523	8	0	531
29474	1	2	519	2	0	524
29475	513	0	5	3	0	521
29476	5	1	3	516	0	525
29477	1	1	523	7	0	532
29478	516	0	6	4	0	526
29479	6	1	4	519	0	530
29480	4	0	1	518	0	523
29481	1	0	1	517	0	519
29482	1	518	1	9	0	529
29483	0	8	0	515	0	523
29484	0	501	1	9	0	511
29485	0	517	2	2	0	521
29486	501	8	0	3	0	512
29487	488	3	0	4	0	495
29488	492	2	2	1	0	497
29489	7	480	0	1	0	488
29490	471	6	0	3	0	480
29491	483	2	1	1	0	487
29492	8	1	0	470	0	479
29493	3	1	0	476	0	480
29494	1	1	461	9	0	472
29495	0	467	6	3	0	476
29496	459	8	2	2	0	471
29497	456	1	2	4	0	463
29498	6	443	0	2	0	451
29499	439	6	2	1	0	448
29500	439	3	1	3	0	446
29501	12	1	1	430	0	444
29502	4	431	0	7	0	442
29503	1	441	0	4	0	446
29504	427	7	0	5	0	439
29505	7	4	2	413	0	426
29506	1	2	415	8	0	426
29507	413	1	5	3	0	422
29508	8	3	416	2	0	429
29509	3	403	7	1	0	414
29510	401	6	2	2	0	411
29511	8	2	398	1	0	409
29512	3	3	5	403	0	414
29513	2	1	419	7	0	429
29514	2	426	8	1	0	437
29515	1	6	2	429	0	438
29516	1	2	428	8	0	439
29517	417	3	8	2	0	430
29518	6	433	2	2	0	443
29519	3	7	2	427	0	439
29520	4	432	1	6	0	443
29521	429	8	1	2	0	440
29522	436	2	1	2	0	441
29523	8	423	0	3	0	434
29524	2	5	1	421	0	429
29525	1	427	1	5	0	434
29526	423	7	2	2	0	434
29527	7	2	422	2	0	433
29528	3	2	411	2	0	418
29529	2	417	7	0	0	426
29530	2	413	2	1	0	418
29531	2	5	2	394	0	403
29532	392	3	1	6	0	402
29533	403	1	1	3	0	408
29534	385	2	2	2	0	391
29535	7	401	1	3	0	412
29536	2	5	1	399	0	407
29537	1	404	0	5	0	410
29538	403	5	1	2	0	411
29539	8	0	1	391	0	400
29540	1	2	393	4	0	400
29541	2	381	4	1	0	388
29542	384	5	0	2	0	391
29543	6	0	370	0	0	376
29544	373	1	4	3	0	381
29545	5	372	2	2	0	381
29546	0	315	1	0	0	316
29547	310	1	0	0	0	311
29548	1	318	1	0	0	320
29549	303	2	0	0	0	305
29550	2	297	0	0	0	299
29551	297	1	0	0	0	298
29552	292	0	0	1	0	293
29553	1	1	304	0	0	306
29554	1	0	292	0	0	293
29555	1	300	1	0	0	302
29556	292	1	2	0	0	295
29557	1	0	282	0	0	283
29558	246	0	4	0	0	250
29559	3	0	0	252	0	255
29560	0	0	261	1	0	262
29561	2	0	250	0	0	252
29562	0	0	256	1	0	257
29563	0	256	2	0	0	258
29564	0	4	3	248	0	255
29565	242	0	0	1	0	243
29566	0	0	0	241	0	241
29567	241	0	0	2	0	243
29568	1	0	0	243	0	244
29569	252	0	0	0	0	252
29570	259	0	0	0	0	259
29571	297	0	0	1	0	298
29572	1	304	0	0	0	305
29573	0	1	316	0	0	317
29574	0	0	1	316	0	317
29575	4	2	5	194	0	205
29576	0	0	0	325	0	325
29577	1	1	0	326	0	328
29578	0	320	1	1	0	322
29579	0	1	314	1	0	316
29580	0	323	1	1	0	325
29581	3	1	0	305	0	309
29582	1	2	0	325	0	328
29583	0	0	0	331	0	331
29584	1	0	0	331	0	332
29585	0	327	0	2	0	329
29586	0	327	0	1	0	328
29587	0	1	327	0	0	328
29588	1	0	0	327	0	328
29589	0	0	1	326	0	327
29590	0	0	0	335	0	335
29591	339	0	0	2	0	341
29592	1	341	0	1	0	343
29593	1	1	332	0	0	334
29594	335	1	4	0	0	340
29595	1	0	1	339	0	341
29596	345	0	0	2	0	347
29597	2	0	0	348	0	350
29598	347	0	0	5	0	352
29599	1	0	0	355	0	356
29600	355	0	0	1	0	356
29601	1	0	366	1	0	368
29602	1	0	1	355	0	357
29603	0	364	1	1	0	366
29604	0	1	0	382	0	383
29605	380	1	0	0	0	381
29606	1	379	0	1	0	381
29607	1	1	0	394	0	396
29608	0	388	0	1	0	389
29609	1	1	0	397	0	399
29610	0	1	0	393	0	394
29611	0	0	389	2	0	391
29612	2	0	1	385	0	388
29613	0	0	378	1	0	379
29614	0	371	0	1	0	372
29615	367	2	1	0	0	370
29616	2	1	367	0	0	370
29617	362	0	1	2	0	365
29618	379	0	1	0	0	380
29619	5	0	0	380	0	385
29620	0	1	401	3	0	405
29621	384	0	4	1	0	389
29622	405	0	0	2	0	407
29623	5	0	0	406	0	411
29624	1	0	1	403	0	405
29625	1	412	0	5	0	418
29626	1	5	1	410	0	417
29627	0	413	1	5	0	419
29628	0	5	414	2	0	421
29629	0	2	3	400	0	405
29630	397	0	2	8	0	407
29631	401	1	0	5	0	407
29632	4	405	1	1	0	411
29633	1	6	0	406	0	413
29634	407	2	1	4	0	414
29635	4	383	1	2	0	390
29636	382	5	0	3	0	390
29637	6	1	0	398	0	405
29638	415	1	0	6	0	422
29639	5	2	462	1	0	470
29640	2	471	6	1	0	480
29641	468	5	2	1	0	476
29642	7	480	3	1	0	491
29643	484	7	1	1	0	493
29644	492	3	0	2	0	497
29645	10	1	480	1	0	492
29646	5	2	5	478	0	490
29647	491	0	2	9	0	502
29648	9	1	478	2	0	490
29649	490	0	8	4	0	502
29650	9	1	2	490	0	502
29651	3	2	486	8	0	499
29652	5	0	6	485	0	496
29653	475	1	4	7	0	487
29654	6	2	485	5	0	498
29655	3	2	7	486	0	498
29656	2	1	3	495	0	501
29657	496	0	1	10	0	507
29658	496	1	2	4	0	503
29659	8	496	1	4	0	509
29660	3	7	3	484	0	497
29661	4	3	1	494	0	502
29662	3	2	0	495	0	500
29663	481	1	2	9	0	493
29664	486	0	1	7	0	494
29665	10	1	1	479	0	491
29666	5	479	1	7	0	492
29667	4	8	1	479	0	492
29668	4	474	3	6	0	487
29669	468	5	1	6	0	480
29670	8	455	0	3	0	466
29671	421	7	0	3	0	431
29672	7	4	2	413	0	426
29673	408	1	1	7	0	417
29674	10	2	419	3	0	434
29675	4	426	5	1	0	436
29676	418	7	4	3	0	432
29677	425	4	1	3	0	433
29678	9	2	1	420	0	432
29679	2	423	1	8	0	434
29680	4	8	0	436	0	448
29681	2	1	3	437	0	443
29682	2	3	0	436	0	441
29683	436	1	2	7	0	446
29684	435	2	1	4	0	442
29685	9	1	1	427	0	438
29686	3	439	0	7	0	449
29687	440	5	0	4	0	449
29688	7	3	430	2	0	442
29689	4	1	4	437	0	446
29690	4	2	437	7	0	450
29691	5	0	5	434	0	444
29692	1	1	456	8	0	466
29693	3	3	5	450	0	461
29694	451	0	3	8	0	462
29695	445	3	3	2	0	453
29696	7	438	1	4	0	450
29697	453	5	1	2	0	461
29698	9	1	2	452	0	464
29699	3	1	1	449	0	454
29700	448	1	1	9	0	459
29701	6	1	447	3	0	457
29702	3	1	440	5	0	449
29703	7	1	443	2	0	453
29704	436	0	7	1	0	444
29705	5	0	451	4	0	460
29706	3	1	440	2	0	446
29707	426	0	8	5	0	439
29708	8	445	1	3	0	457
29709	2	5	2	456	0	465
29710	2	2	2	463	0	469
29711	3	0	475	8	0	486
29712	465	3	5	5	0	478
29713	473	1	1	3	0	478
29714	454	1	2	2	0	459
29715	4	0	472	2	0	478
29716	462	1	5	3	0	471
29717	5	0	459	1	0	465
29718	3	446	3	4	0	456
29719	2	450	2	1	0	455
29720	430	5	1	1	0	437
29721	6	422	0	1	0	429
29722	3	435	0	2	0	440
29723	430	5	0	4	0	439
29724	3	437	1	1	0	442
29725	440	3	0	2	0	445
29726	3	1	1	447	0	452
29727	4	1	0	446	0	451
29728	1	1	1	449	0	452
29729	1	2	1	444	0	448
29730	1	442	2	4	0	449
29731	455	3	0	2	0	460
29732	4	481	1	1	0	487
29733	2	520	2	4	0	528
29734	4	7	539	0	0	550
29735	535	2	8	3	0	548
29736	10	3	572	2	0	587
29737	4	1	588	3	0	596
29738	2	575	11	3	0	591
29739	0	567	0	0	0	567
29740	583	9	4	0	0	596
29741	8	599	1	0	0	608
29742	0	8	596	0	0	604
29743	0	594	7	0	0	601
29744	1	6	598	0	0	605
29745	1	0	595	0	0	596
29746	579	3	10	0	0	592
29747	9	3	595	0	0	607
29748	1	2	9	581	0	593
29749	578	3	3	8	0	592
29750	10	578	2	0	0	590
29751	1	11	586	0	0	598
29752	579	0	12	2	0	593
29753	9	1	2	576	0	588
29754	2	552	2	6	0	562
29755	0	7	570	1	0	578
29756	564	0	9	2	0	575
29757	9	1	564	1	0	575
29758	1	3	9	557	0	570
29759	2	1	561	8	0	572
29760	3	1	8	553	0	565
29761	559	2	1	10	0	572
29762	9	565	2	0	0	576
29763	574	8	3	2	0	587
29764	10	2	572	1	0	585
29765	1	1	12	588	0	602
29766	1	3	584	10	0	598
29767	579	1	12	1	0	593
29768	593	0	2	4	0	599
29769	9	583	3	1	0	596
29770	590	9	3	2	0	604
29771	596	1	2	1	0	600
29772	10	1	2	587	0	600
29773	4	2	587	8	0	601
29774	1	563	13	2	0	579
29775	7	7	2	567	0	583
29776	576	1	1	10	0	588
29777	9	4	566	1	0	580
29778	5	2	559	1	0	567
29779	5	3	552	3	0	563
29780	545	2	7	3	0	557
29781	11	4	554	2	0	571
29782	545	5	11	2	0	563
29783	10	3	532	3	0	548
29784	4	541	13	0	0	558
29785	4	8	6	539	0	557
29786	4	2	541	8	0	555
29787	3	528	14	4	0	549
29788	5	541	3	4	0	553
29789	7	9	5	532	0	553
29790	529	0	6	10	0	545
29791	14	2	6	526	0	548
29792	507	4	2	11	0	524
29793	8	4	2	513	0	527
29794	4	4	510	9	0	527
29795	3	6	509	4	0	522
29796	506	3	13	3	0	525
29797	507	2	5	6	0	520
29798	11	2	501	6	0	520
29799	477	1	15	5	0	498
29800	16	0	493	3	0	512
29801	6	469	10	2	0	487
29802	7	475	7	0	0	489
29803	8	468	6	3	0	485
29804	7	8	5	461	0	481
29805	454	2	8	12	0	476
29806	461	3	8	2	0	474
29807	15	5	3	447	0	470
29808	6	5	425	12	0	448
29809	6	5	13	424	0	448
29810	7	4	427	10	0	448
29811	5	6	11	407	0	429
29812	409	1	5	13	0	428
29813	415	4	5	3	0	427
29814	409	2	4	7	0	422
29815	411	0	5	7	0	423
29816	15	2	5	402	0	424
29817	2	2	8	410	0	422
29818	398	0	9	10	0	417
29819	411	2	5	3	0	421
29820	16	2	5	395	0	418
29821	7	2	4	405	0	418
29822	8	1	4	392	0	405
29823	8	2	2	391	0	403
29824	386	4	0	15	0	405
29825	16	2	370	6	0	394
29826	7	2	13	367	0	389
29827	366	4	2	15	0	387
29828	11	2	360	7	0	380
29829	8	2	9	366	0	385
29830	5	0	360	18	0	383
29831	6	348	11	7	0	372
29832	8	9	3	311	0	331
29833	279	2	5	9	0	295
29834	7	10	4	244	0	265
29835	8	239	6	4	0	257
29836	5	209	4	5	0	223
29837	5	175	3	3	0	186
29838	9	159	2	1	0	171
29839	96	11	10	7	0	124
29840	1	3	1	73	0	78
29841	0	0	57	2	0	59
29842	0	0	1	51	0	52
29843	0	0	49	2	0	51
29844	52	0	0	0	0	52
29845	1	0	1	48	0	50
29846	1	0	0	51	0	52
29847	1	0	0	50	0	51
29848	1	0	1	50	0	52
29849	50	0	0	2	0	52
29850	51	0	1	0	0	52
29851	1	1	0	47	0	49
29852	47	0	0	2	0	49
29853	1	0	47	1	0	49
29854	0	46	0	2	0	48
29855	0	0	0	47	0	47
29856	0	0	0	45	0	45
29857	0	45	1	0	0	46
29858	0	0	0	42	0	42
29859	2	0	0	41	0	43
29860	42	0	1	0	0	43
29861	0	0	37	1	0	38
29862	0	0	35	0	0	35
29863	30	1	0	0	0	31
29864	0	0	30	1	0	31
29865	13	0	2	0	0	15
29866	11	0	0	0	0	11
29867	0	0	0	9	0	9
29868	0	0	9	0	0	9
29869	8	0	0	0	0	8
29870	0	7	0	0	0	7
29871	8	0	0	0	0	8
29872	21	0	0	0	0	21
29873	62	0	1	0	0	63
29874	199	0	0	0	0	199
29875	195	0	0	0	0	195
29876	204	0	0	0	0	204
29877	219	0	0	0	0	219
29878	216	0	0	0	0	216
29879	215	0	0	0	0	215
29880	219	0	0	0	0	219
29881	217	0	0	0	0	217
29882	213	0	0	0	0	213
29883	206	0	0	0	0	206
29884	125	0	0	0	0	125
29885	78	0	0	0	0	78
29886	175	0	0	0	0	175
29887	216	0	0	0	0	216
29888	212	0	0	0	0	212
29889	189	0	0	0	0	189
29890	201	0	0	0	0	201
29891	220	0	0	0	0	220
29892	220	0	0	0	0	220
29893	221	0	0	0	0	221
29894	219	0	0	0	0	219
29895	218	0	0	0	0	218
29896	220	0	0	0	0	220
29897	215	0	0	0	0	215
29898	219	0	0	0	0	219
29899	214	0	1	0	0	215
29900	211	0	0	0	0	211
29901	204	0	0	0	0	204
29902	179	0	0	0	0	179
29903	162	0	22	0	0	184
