Pos	A	C	G	T	Other	Total
1	0	0	0	0	0	0
2	0	0	0	0	0	0
3	0	0	0	1	0	1
4	13	0	0	1	0	14
5	34	0	0	0	0	34
6	48	0	0	0	0	48
7	0	0	89	0	0	89
8	0	0	101	0	0	101
9	0	0	0	125	0	125
10	0	0	0	130	0	130
11	0	0	0	140	0	140
12	412	0	0	24	0	436
13	3	0	0	1022	0	1025
14	2173	0	1	97	0	2271
15	6	3709	2	1	0	3718
16	6	7860	2	20	0	7888
17	128	14	2	23117	0	23261
18	51	7	3	25565	0	25626
19	23	34665	25	46	0	34759
20	14	38473	13	73	0	38573
21	13	44038	13	137	0	44201
22	46493	37	84	286	0	46900
23	55	37	47767	29	0	47888
24	57	32	47943	18	0	48050
25	35	12	17	51813	0	51877
26	55623	5	8	272	0	55908
27	56020	5	5	101	0	56131
28	30	56733	23	58	0	56844
29	64822	35	5	496	0	65358
30	69426	27	15	408	0	69876
31	71398	9	12	139	0	71558
32	59	72672	27	92	0	72850
33	19	74486	24	108	0	74637
34	76446	45	4	212	0	76707
35	76985	15	5	134	0	77139
36	45	78890	23	124	0	79082
37	25	83230	16	134	0	83405
38	83108	46	7	102	0	83263
39	83082	16	10	72	0	83180
40	49	84294	23	115	0	84481
41	65	66	6	86133	0	86270
42	45	29	4	86932	0	87010
43	45	25	13	87051	0	87134
44	26	87217	35	189	0	87467
45	193	127	84398	51	0	84769
46	76042	70	73	107	0	76292
47	90	39	32	87685	0	87846
48	56	88236	29	135	0	88456
49	46	88	21	88952	0	89107
50	54	89022	42	221	0	89339
51	42	101	23	89476	0	89642
52	59	70	26	89897	0	90052
53	113	92	90021	138	0	90364
54	50	46	69	88448	0	88613
55	89058	39	73	144	0	89314
56	137	85	89315	106	0	89643
57	85325	33	112	131	0	85601
58	109	49	61	90481	0	90700
59	55	91038	73	177	0	91343
60	52	133	39	91836	0	92060
61	112	108	91347	143	0	91710
62	43	64	102	89633	0	89842
63	36	37	57	92259	0	92389
64	60	93215	44	241	0	93560
65	96	107	28	93675	0	93906
66	197	93114	47	323	0	93681
67	54	130	24	93903	0	94111
68	92773	58	36	164	0	93031
69	90543	44	68	141	0	90796
70	91985	56	47	183	0	92271
71	323	93957	61	185	0	94526
72	175	230	91538	61	0	92004
73	88771	54	149	118	0	89092
74	95818	44	49	92	0	96003
75	227	98709	65	188	0	99189
76	101	256	35	80954	0	81346
77	82	89	34	81804	0	82009
78	61	59	33	75203	0	75356
79	75561	38	37	565	0	76201
80	75254	44	31	251	0	75580
81	75082	38	36	135	0	75291
82	76156	38	36	137	0	76367
83	556	54	34	74889	0	75533
84	190	75338	49	507	0	76084
85	124	380	27	77418	0	77949
86	164	219	77448	494	0	78325
87	91	59	476	78936	0	79562
88	136	83	81037	661	0	81917
89	63	48	616	79787	0	80514
90	148	86	83161	718	0	84113
91	148	68	82989	232	0	83437
92	57	85526	773	366	0	86722
93	115	769	224	88860	0	89968
94	199	213	92146	746	0	93304
95	79	123	770	88755	0	89727
96	53	92790	229	843	0	93915
97	92577	750	102	239	0	93668
98	693	96303	82	270	0	97348
99	214	810	76	93577	0	94677
100	112	96622	100	806	0	97640
101	160	878	92464	222	0	93724
102	243	265	93741	182	0	94431
103	76	95074	921	376	0	96447
104	104	783	223	95866	0	96976
105	445	276	96133	812	0	97666
106	102	95740	805	497	0	97144
107	95890	786	225	202	0	97103
108	834	217	150	95290	0	96491
109	388	166	98450	825	0	99829
110	128	98709	814	428	0	100079
111	121	859	231	98697	0	99908
112	98	234	140	99912	0	100384
113	93221	150	132	1087	0	94590
114	895	141	97968	350	0	99354
115	245	128	814	96078	0	97265
116	256	130	95497	923	0	96806
117	95	87282	902	518	0	88797
118	83931	837	313	229	0	85310
119	742	81927	208	301	0	83178
120	254	917	135	77144	0	78450
121	153	77445	149	880	0	78627
122	74142	894	129	327	0	75492
123	794	75725	156	338	0	77013
124	362	944	72924	188	0	74418
125	153	73612	859	270	0	74894
126	70813	911	278	223	0	72225
127	971	345	72107	172	0	73595
128	288	232	884	71898	0	73302
129	68983	163	302	967	0	70415
130	933	186	185	66163	0	67467
131	66378	158	186	1087	0	67809
132	66623	168	173	421	0	67385
133	1190	180	158	65875	0	67403
134	448	181	148	66092	0	66869
135	64400	156	147	1289	0	65992
136	64116	190	158	491	0	64955
137	1253	183	141	62111	0	63688
138	62162	176	219	1108	0	63665
139	62512	174	174	481	0	63341
140	1223	62452	213	394	0	64282
141	459	974	210	62569	0	64212
142	62964	357	219	1195	0	64735
143	63737	265	195	491	0	64688
144	1226	205	233	62947	0	64611
145	430	237	205	64304	0	65176
146	62824	192	217	1292	0	64525
147	1052	63451	239	612	0	65354
148	409	1014	221	63181	0	64825
149	396	428	63197	1092	0	65113
150	302	285	1012	60895	0	62494
151	241	62730	369	1230	0	64570
152	300	1020	62396	499	0	64215
153	289	350	1048	60913	0	62600
154	237	270	419	61758	0	62684
155	330	246	62802	1298	0	64676
156	57040	246	1055	615	0	58956
157	1051	63876	443	519	0	65889
158	63597	1051	332	413	0	65393
159	1220	417	63384	381	0	65402
160	517	302	64699	379	0	65897
161	61518	268	1168	370	0	63324
162	1076	64644	415	440	0	66575
163	63771	1015	271	393	0	65450
164	1094	64463	250	447	0	66254
165	581	1155	63913	344	0	65993
166	62482	398	988	342	0	64210
167	1171	356	65492	334	0	67353
168	455	271	1010	64181	0	65917
169	64579	236	390	1132	0	66337
170	64292	210	283	501	0	65286
171	1201	63952	236	469	0	65858
172	533	1960	219	61063	0	63775
173	346	62685	215	1007	0	64253
174	390	945	60840	473	0	62648
175	441	1091	857	54825	0	57214
176	248	55986	337	823	0	57394
177	279	757	224	53358	0	54618
178	47725	212	176	819	0	48932
179	679	161	114	51946	0	52900
180	248	52257	140	738	0	53383
181	264	559	115	52653	0	53591
182	229	205	157	52426	0	53017
183	220	52675	141	781	0	53817
184	307	639	148	52497	0	53591
185	391	190	51526	675	0	52782
186	214	50885	560	403	0	52062
187	46596	394	164	195	0	47349
188	545	154	47627	160	0	48486
189	314	135	47006	162	0	47617
190	197	45736	433	198	0	46564
191	558	553	306	43131	0	44548
192	276	107	42239	334	0	42956
193	162	37942	293	191	0	38588
194	165	209	126	37247	0	37747
195	141	104	69	37842	0	38156
196	36577	77	51	303	0	37008
197	272	37106	66	267	0	37711
198	169	241	34214	136	0	34760
199	149	135	35105	125	0	35514
200	104	96	243	34470	0	34913
201	113	100	115	43179	0	43507
202	96	141	81	43427	0	43745
203	105	54534	78	976	0	55693
204	182	1022	57039	378	0	58621
205	127	581	1046	58239	0	59993
206	83	63925	593	1332	0	65933
207	91	66041	212	709	0	67053
208	205	2032	69727	255	0	72219
209	83	803	1754	68867	0	71507
210	164	289	77006	1906	0	79365
211	102	200	2056	75134	0	77492
212	112	153	995	78582	0	79842
213	325	142	76957	2775	0	80199
214	96	76942	2038	1310	0	80386
215	75405	1937	1036	458	0	78836
216	2027	965	77391	280	0	80663
217	882	77510	2055	385	0	80832
218	290	80026	1027	304	0	81647
219	356	2863	76935	184	0	80338
220	75049	1204	2180	176	0	78609
221	2099	584	1078	66106	0	69867
222	943	77940	478	1645	0	81006
223	77590	2180	290	823	0	80883
224	2154	1134	296	71568	0	75152
225	997	76572	299	2070	0	79938
226	77338	2210	309	1038	0	80895
227	2191	1138	75690	507	0	79526
228	991	76173	2180	463	0	79807
229	73474	2184	1228	412	0	77298
230	1945	75561	549	493	0	78548
231	74303	2421	421	312	0	77457
232	2203	1345	385	69866	0	73799
233	1034	72497	506	2016	0	76053
234	414	2210	452	73631	0	76707
235	72212	1206	502	2425	0	76345
236	2115	610	71941	1371	0	76037
237	1128	510	73741	738	0	76117
238	563	476	3068	69748	0	73855
239	429	545	1460	72235	0	74669
240	463	515	751	70215	0	71944
241	366	69574	624	3132	0	73696
242	456	2327	68858	1369	0	73010
243	421	1422	2279	64281	0	68403
244	432	66768	1349	2225	0	70774
245	496	69221	687	1309	0	71713
246	573	3033	68542	632	0	72780
247	626	1568	70184	450	0	72828
248	613	940	71499	469	0	73521
249	608	783	3193	67044	0	71628
250	587	730	69946	2224	0	73487
251	592	679	2606	67837	0	71714
252	643	639	69797	2436	0	73515
253	64041	677	2645	1320	0	68683
254	2374	70344	1421	777	0	74916
255	1329	75709	718	733	0	78489
256	873	3373	78103	653	0	83002
257	75981	1700	2671	681	0	81033
258	79506	933	1388	678	0	82505
259	80099	795	860	721	0	82475
260	3782	712	76399	720	0	81613
261	1659	618	78739	803	0	81819
262	761	660	3805	75657	0	80883
263	76690	597	1894	3088	0	82269
264	77845	748	1126	1850	0	81569
265	3457	755	75715	1117	0	81044
266	75394	799	3175	991	0	80359
267	2868	900	1923	74281	0	79972
268	1458	944	76286	3038	0	81726
269	755	916	77802	1732	0	81205
270	72702	962	4247	1260	0	79171
271	2679	890	77246	998	0	81813
272	73780	763	3852	1122	0	79517
273	2967	796	76528	1071	0	81362
274	1524	72688	3883	1172	0	79267
275	966	77048	2384	1026	0	81424
276	966	3686	1653	73900	0	80205
277	832	1986	1551	77679	0	82048
278	990	1282	75808	3750	0	81830
279	1023	1271	3563	71221	0	77078
280	1075	72373	2379	2992	0	78819
281	1272	75464	1523	1669	0	79928
282	1398	77704	1294	982	0	81378
283	1410	4131	1288	73782	0	80611
284	1509	2078	74981	2792	0	81360
285	1398	1230	76373	1648	0	80649
286	1292	1223	4310	72905	0	79730
287	1498	983	2228	74538	0	79247
288	1579	854	1557	67070	0	71060
289	1542	73453	1367	3600	0	79962
290	74146	2916	1276	1828	0	80166
291	73837	1815	1171	1172	0	77995
292	4149	73533	1269	1162	0	80113
293	2344	3110	74472	1016	0	80942
294	74408	1840	3404	948	0	80600
295	3608	1098	76366	947	0	82019
296	75127	931	3695	898	0	80651
297	76457	1003	2333	980	0	80773
298	76466	1063	1584	1082	0	80195
299	74877	888	1371	1329	0	78465
300	3982	73443	1433	1467	0	80325
301	63516	2422	1168	1334	0	68440
302	2616	64823	1252	1414	0	70105
303	51074	1958	855	856	0	54743
304	1890	49831	865	881	0	53467
305	828	1534	44004	493	0	46859
306	531	4452	1573	35936	0	42492
307	394	40239	955	1307	0	42895
308	348	37708	628	709	0	39393
309	33521	1340	1424	994	0	37279
310	29571	302	329	287	0	30489
311	912	30386	309	258	0	31865
312	418	668	316	28148	0	29550
313	348	31504	316	625	0	32793
314	31801	696	333	263	0	33093
315	924	274	31818	209	0	33225
316	503	226	826	30301	0	31856
317	443	150	444	30687	0	31724
318	432	145	362	31053	0	31992
319	403	197	30556	796	0	31952
320	392	30355	816	299	0	31862
321	409	31417	362	218	0	32406
322	423	811	338	31363	0	32935
323	450	364	32253	684	0	33751
324	388	307	891	31472	0	33058
325	387	336	434	32435	0	33592
326	379	337	368	32207	0	33291
327	404	338	263	32375	0	33380
328	31460	312	309	934	0	33015
329	800	32166	343	469	0	33778
330	32034	800	394	361	0	33589
331	854	405	32136	352	0	33747
332	447	394	32553	284	0	33678
333	427	389	798	30246	0	31860
334	333	354	392	30330	0	31409
335	268	32853	362	836	0	34319
336	317	792	32962	432	0	34503
337	259	33355	872	541	0	35027
338	303	758	33662	352	0	35075
339	29859	351	856	414	0	31480
340	758	33734	369	422	0	35283
341	421	842	33997	344	0	35604
342	407	438	789	32862	0	34496
343	364	430	33993	826	0	35613
344	286	33930	811	453	0	35480
345	336	821	368	32581	0	34106
346	301	33801	307	949	0	35358
347	384	816	33968	454	0	35622
348	380	409	757	33090	0	34636
349	33295	346	259	870	0	34770
350	857	33297	260	416	0	34830
351	515	845	32593	275	0	34228
352	387	915	781	30565	0	32648
353	337	361	32363	761	0	33822
354	287	303	29003	296	0	29889
355	213	25502	662	234	0	26611
356	155	280	202	21247	0	21884
357	53	133	87	21270	0	21543
358	62	170	63	21257	0	21552
359	58	69	21993	293	0	22413
360	53	60	21651	105	0	21869
361	18480	60	298	120	0	18958
362	223	58	21347	69	0	21697
363	19299	51	269	71	0	19690
364	223	21126	87	86	0	21522
365	82	219	86	20241	0	20628
366	45	21758	60	249	0	22112
367	34	22485	71	136	0	22726
368	59	263	21806	79	0	22207
369	32	142	239	21082	0	21495
370	70	80	22008	256	0	22414
371	48	94	20801	89	0	21032
372	19898	67	285	130	0	20380
373	264	60	21731	85	0	22140
374	74	55	21604	109	0	21842
375	19887	47	288	119	0	20341
376	206	63	21366	108	0	21743
377	81	73	22208	101	0	22463
378	56	67	265	20527	0	20915
379	41	22254	129	229	0	22653
380	52	236	101	22267	0	22656
381	37	104	103	22198	0	22442
382	22386	57	102	347	0	22892
383	217	82	97	21689	0	22085
384	83	22686	105	274	0	23148
385	22361	233	92	153	0	22839
386	229	125	22497	108	0	22959
387	20486	100	268	123	0	20977
388	260	93	23764	85	0	24202
389	117	94	24206	81	0	24498
390	49	24794	393	112	0	25348
391	24986	273	213	114	0	25586
392	232	25869	133	171	0	26405
393	118	315	25984	106	0	26523
394	89	147	331	23173	0	23740
395	49	26542	194	305	0	27090
396	26622	325	133	121	0	27201
397	26383	121	131	92	0	26727
398	339	26851	116	89	0	27395
399	27162	320	145	72	0	27699
400	304	143	113	26292	0	26852
401	98	27271	159	345	0	27873
402	63	326	130	28028	0	28547
403	45	159	142	29473	0	29819
404	30072	115	124	450	0	30761
405	29442	92	134	160	0	29828
406	29289	89	139	113	0	29630
407	457	99	29475	85	0	30116
408	27943	65	398	92	0	28498
409	385	101	187	29600	0	30273
410	136	80	29930	368	0	30514
411	164	74	28293	142	0	28673
412	68	28451	468	138	0	29125
413	25788	272	246	61	0	26367
414	252	27133	112	101	0	27598
415	111	263	50	26944	0	27368
416	79	76	53	27619	0	27827
417	70	44	28079	293	0	28486
418	57	41	287	25713	0	26098
419	74	46	28232	255	0	28607
420	65	46	27354	104	0	27569
421	48	28091	325	58	0	28522
422	57	174	129	27144	0	27504
423	34	70	36	26907	0	27047
424	26826	30	28	218	0	27102
425	201	31	27089	81	0	27402
426	77	24	186	27257	0	27544
427	27492	20	81	273	0	27866
428	215	20	28031	88	0	28354
429	26146	35	208	75	0	26464
430	27930	21	81	42	0	28074
431	278	46	29086	43	0	29453
432	107	39	214	27743	0	28103
433	73	24	73	28925	0	29095
434	75	46	30100	248	0	30469
435	28163	19	229	131	0	28542
436	30271	26	97	69	0	30463
437	29334	41	81	65	0	29521
438	29702	35	70	65	0	29872
439	29293	40	146	58	0	29537
440	283	65	28890	62	0	29300
441	122	60	30214	62	0	30458
442	71	30552	274	107	0	31004
443	85	220	30808	80	0	31193
444	94	126	235	29364	0	29819
445	105	107	132	24556	0	24900
446	80	40	88	30656	0	30864
447	90	49	67	30955	0	31161
448	98	40	30973	292	0	31403
449	100	30290	242	157	0	30789
450	112	32077	114	125	0	32428
451	94	268	88	30398	0	30848
452	86	32196	70	235	0	32587
453	31914	224	106	130	0	32374
454	31291	86	77	113	0	31567
455	318	33423	74	143	0	33958
456	165	202	112	33150	0	33629
457	115	88	84	34075	0	34362
458	128	61	34013	326	0	34528
459	28966	45	299	179	0	29489
460	33873	65	150	89	0	34177
461	343	35238	115	169	0	35865
462	35042	274	92	129	0	35537
463	380	121	36212	104	0	36817
464	187	36341	320	127	0	36975
465	144	37874	149	125	0	38292
466	147	37706	104	111	0	38068
467	144	419	87	37069	0	37719
468	37086	124	99	397	0	37706
469	419	70	102	37790	0	38381
470	207	63	39561	432	0	40263
471	141	59	447	38793	0	39440
472	171	83	41334	473	0	42061
473	144	60	482	38967	0	39653
474	183	117	182	37613	0	38095
475	118	41113	129	488	0	41848
476	41843	430	129	223	0	42625
477	457	157	133	39967	0	40714
478	180	41676	122	470	0	42448
479	41720	442	116	196	0	42474
480	38332	165	142	140	0	38779
481	41548	132	100	153	0	41933
482	525	41719	120	217	0	42581
483	197	452	41963	173	0	42785
484	146	136	463	41751	0	42496
485	145	215	193	40947	0	41500
486	109	42362	139	569	0	43179
487	173	431	41983	229	0	42816
488	144	153	41367	144	0	41808
489	38205	85	501	145	0	38936
490	489	334	179	39871	0	40873
491	217	84	42024	425	0	42750
492	130	43079	419	196	0	43824
493	185	427	144	39902	0	40658
494	117	43749	134	393	0	44393
495	120	412	43084	157	0	43773
496	39181	138	447	182	0	39948
497	42621	101	163	162	0	43047
498	482	43692	113	206	0	44493
499	204	370	88	43439	0	44101
500	214	146	43641	428	0	44429
501	146	43092	402	189	0	43829
502	41519	407	126	143	0	42195
503	339	41315	87	126	0	41867
504	127	41509	69	109	0	41814
505	120	453	77	40245	0	40895
506	76	41333	71	347	0	41827
507	40994	338	72	139	0	41543
508	357	140	64	40896	0	41457
509	125	88	40068	339	0	40620
510	99	82	39473	111	0	39765
511	72	89	338	39317	0	39816
512	70	40414	104	363	0	40951
513	40504	325	119	102	0	41050
514	325	114	60	39321	0	39820
515	121	88	40008	322	0	40539
516	83	82	298	39249	0	39712
517	81	77	100	40066	0	40324
518	39456	82	78	375	0	39991
519	348	98	60	38515	0	39021
520	130	95	39346	319	0	39890
521	95	115	38567	120	0	38897
522	95	89	402	38655	0	39241
523	83	86	173	39290	0	39632
524	101	101	39745	391	0	40338
525	32810	115	355	187	0	33467
526	348	129	39224	129	0	39830
527	120	38848	344	139	0	39451
528	154	348	114	39317	0	39933
529	129	133	39532	329	0	40123
530	108	96	39135	142	0	39481
531	81	128	363	37071	0	37643
532	37579	91	172	379	0	38221
533	330	101	38805	165	0	39401
534	109	37542	333	173	0	38157
535	38252	328	125	133	0	38838
536	362	122	38635	129	0	39248
537	35777	100	363	124	0	36364
538	38313	77	144	126	0	38660
539	345	39328	121	146	0	39940
540	168	342	116	36078	0	36704
541	93	38760	89	330	0	39272
542	108	361	37556	123	0	38148
543	35566	145	376	144	0	36231
544	38742	110	142	154	0	39148
545	424	115	39308	113	0	39960
546	189	109	39109	121	0	39528
547	96	40161	439	144	0	40840
548	40857	378	185	112	0	41532
549	411	146	131	40030	0	40718
550	172	109	107	38150	0	38538
551	88	40174	129	430	0	40821
552	39305	360	144	154	0	39963
553	424	131	40337	162	0	41054
554	139	144	392	43731	0	44406
555	44916	99	175	569	0	45759
556	602	45876	136	316	0	46930
557	203	626	53469	113	0	54411
558	139	196	54858	116	0	55309
559	143	248	1051	50698	0	52140
560	85	54313	263	860	0	55521
561	200	846	55281	185	0	56512
562	86	273	938	53662	0	54959
563	55476	102	270	909	0	56757
564	916	92	56759	223	0	57990
565	240	148	1019	55803	0	57210
566	198	69	58083	959	0	59309
567	116	78	59112	227	0	59533
568	144	458	1114	56307	0	58023
569	87	68	58583	990	0	59728
570	46884	59	1024	302	0	48269
571	900	46	56840	97	0	57883
572	50763	36	931	84	0	51814
573	836	54989	268	93	0	56186
574	55025	836	139	121	0	56121
575	834	57672	108	92	0	58706
576	186	894	70	57360	0	58510
577	104	194	77	60056	0	60431
578	116	106	59124	1060	0	60406
579	87	69	59764	273	0	60193
580	80	70	1118	59277	0	60545
581	111	49	60553	988	0	61701
582	81	128	1053	55823	0	57085
583	67	58847	339	910	0	60163
584	113	61307	250	281	0	61951
585	86	1115	207	59380	0	60788
586	95	327	198	60797	0	61417
587	120	148	60102	1126	0	61496
588	91	146	1037	57144	0	58418
589	106	58885	352	1018	0	60361
590	104	59557	282	328	0	60271
591	108	59450	222	333	0	60113
592	153	1123	215	53406	0	54897
593	85	56198	288	989	0	57560
594	55227	959	240	327	0	56753
595	968	256	292	55057	0	56573
596	317	140	55421	1024	0	56902
597	169	126	1129	54215	0	55639
598	190	129	56095	1086	0	57500
599	195	173	56411	340	0	57119
600	169	156	56893	282	0	57500
601	171	55380	1287	390	0	57228
602	191	1034	56495	261	0	57981
603	55244	297	1200	285	0	57026
604	57007	215	450	268	0	57940
605	57549	186	382	316	0	58433
606	1166	166	333	56643	0	58308
607	56151	173	401	1155	0	57880
608	984	55605	404	474	0	57467
609	288	58805	338	425	0	59856
610	57754	1177	395	337	0	59663
611	1058	421	59053	339	0	60871
612	321	316	1157	57919	0	59713
613	231	312	60221	1146	0	61910
614	207	264	60798	530	0	61799
615	152	59823	1326	458	0	61759
616	162	1166	587	56395	0	58310
617	184	454	390	60340	0	61368
618	58919	331	417	1333	0	61000
619	988	59957	415	706	0	62066
620	352	61585	419	510	0	62866
621	436	1296	60681	464	0	62877
622	248	61797	1299	415	0	63759
623	60037	1243	659	397	0	62336
624	60321	492	613	464	0	61890
625	1206	416	62016	447	0	64085
626	411	427	62445	490	0	63773
627	270	418	1653	58101	0	60442
628	294	387	844	59037	0	60562
629	286	60658	675	1472	0	63091
630	366	1226	566	60377	0	62535
631	363	468	687	59935	0	61453
632	360	60378	577	1540	0	62855
633	381	1183	609	59968	0	62141
634	323	481	699	58458	0	59961
635	277	58545	619	1567	0	61008
636	400	1180	58372	652	0	60604
637	407	518	1499	59278	0	61702
638	59413	438	726	1390	0	61967
639	59087	421	660	546	0	60714
640	1450	505	58476	434	0	60865
641	56556	536	1333	457	0	58882
642	58266	539	550	486	0	59841
643	1286	58136	506	645	0	60573
644	519	1249	56776	598	0	59142
645	349	569	57626	606	0	59150
646	343	468	1540	58030	0	60381
647	59783	386	804	1370	0	62343
648	62618	401	677	592	0	64288
649	1368	448	582	65001	0	67399
650	70352	442	489	1540	0	72823
651	72150	551	487	594	0	73782
652	70241	481	524	577	0	71823
653	1615	478	71475	568	0	74136
654	519	377	69718	442	0	71056
655	65427	281	1337	457	0	67502
656	1121	288	67743	431	0	69583
657	262	60263	810	329	0	61664
658	439	832	573	58397	0	60241
659	213	234	61850	629	0	62926
660	168	154	60675	201	0	61198
661	223	482	914	56535	0	58154
662	142	127	60109	631	0	61009
663	143	92	58565	216	0	59016
664	106	53605	723	165	0	54599
665	93	57177	194	130	0	57594
666	55534	635	202	88	0	56459
667	536	155	73	55004	0	55768
668	55122	75	128	484	0	55809
669	567	79	55940	127	0	56713
670	175	55	538	54199	0	54967
671	109	81	151	56130	0	56471
672	53026	67	100	616	0	53809
673	500	55509	104	271	0	56384
674	232	513	53455	88	0	54288
675	280	136	53964	91	0	54471
676	86	54261	592	184	0	55123
677	92	448	53116	61	0	53717
678	78	53292	504	102	0	53976
679	60	51901	173	101	0	52235
680	155	550	48753	55	0	49513
681	45097	118	480	56	0	45751
682	445	65	124	50808	0	51442
683	144	53097	99	517	0	53857
684	100	405	100	52005	0	52610
685	52212	99	90	421	0	52822
686	52927	54	95	137	0	53213
687	52696	50	100	106	0	52952
688	520	45	52073	72	0	52710
689	147	86	477	49298	0	50008
690	62	53220	175	412	0	53869
691	54889	416	135	220	0	55660
692	436	124	112	54881	0	55553
693	138	117	99	55377	0	55731
694	92	72	99	56549	0	56812
695	91	75	54387	522	0	55075
696	46680	68	488	255	0	47491
697	451	55036	144	147	0	55778
698	169	442	90	54417	0	55118
699	121	108	95	55095	0	55419
700	52608	76	134	543	0	53361
701	526	81	53910	183	0	54700
702	236	67	55421	80	0	55804
703	148	53645	600	133	0	54526
704	127	495	55668	91	0	56381
705	46786	162	703	115	0	47766
706	497	55872	248	187	0	56804
707	203	550	56307	104	0	57164
708	47110	193	745	118	0	48166
709	585	132	58280	138	0	59135
710	232	57914	632	206	0	58984
711	198	564	232	57762	0	58756
712	183	211	176	59196	0	59766
713	197	128	57867	669	0	58861
714	200	87	57422	256	0	57965
715	200	56764	729	193	0	57886
716	54996	572	312	171	0	56051
717	587	58515	228	215	0	59545
718	266	650	190	57234	0	58340
719	247	222	57663	655	0	58787
720	49804	169	758	257	0	50988
721	645	94	360	55647	0	56746
722	215	56118	308	653	0	57294
723	133	58280	296	298	0	59007
724	162	724	241	57194	0	58321
725	163	307	211	58291	0	58972
726	56150	186	220	745	0	57301
727	613	183	231	58043	0	59070
728	246	160	58201	728	0	59335
729	54873	134	753	338	0	56098
730	58849	163	339	260	0	59611
731	725	192	59376	196	0	60489
732	55506	193	767	193	0	56659
733	704	217	265	60847	0	62033
734	266	210	217	61811	0	62504
735	220	187	211	62153	0	62771
736	221	192	215	59940	0	60568
737	181	61370	217	847	0	62615
738	62137	693	237	299	0	63366
739	64077	304	214	264	0	64859
740	898	243	67107	231	0	68479
741	66196	185	792	246	0	67419
742	70322	194	336	210	0	71062
743	71382	212	265	182	0	72041
744	74186	180	218	231	0	74815
745	1112	73208	196	291	0	74807
746	409	1144	143	70896	0	72592
747	282	274	71701	866	0	73123
748	233	182	68447	263	0	69125
749	58497	632	1477	323	0	60929
750	60643	122	589	127	0	61481
751	705	58932	95	122	0	59854
752	59279	567	57	106	0	60009
753	642	59746	70	101	0	60559
754	211	620	56	58479	0	59366
755	60003	156	123	675	0	60957
756	59334	168	66	193	0	59761
757	58989	54	43	126	0	59212
758	731	58501	67	103	0	59402
759	58377	561	61	129	0	59128
760	667	154	70	58322	0	59213
761	59109	86	100	589	0	59884
762	706	78	58071	193	0	59048
763	237	59156	582	209	0	60184
764	59260	570	159	82	0	60071
765	668	171	59718	72	0	60629
766	246	159	604	58532	0	59541
767	221	70	61173	583	0	62047
768	173	87	60933	178	0	61371
769	188	65	679	58797	0	59729
770	199	100	62222	590	0	63111
771	158	99	629	60891	0	61777
772	183	77	182	62238	0	62680
773	61713	83	118	722	0	62636
774	667	63187	138	316	0	64308
775	238	65528	125	184	0	66075
776	208	67296	126	160	0	67790
777	487	810	65809	120	0	67226
778	241	305	665	65181	0	66392
779	149	138	68234	727	0	69248
780	61916	93	788	258	0	63055
781	66459	89	239	169	0	66956
782	824	68082	176	245	0	69327
783	327	712	110	65873	0	67022
784	210	69043	113	661	0	70027
785	68982	715	165	228	0	70090
786	761	273	96	68567	0	69697
787	342	164	69979	764	0	71249
788	238	69267	685	323	0	70513
789	296	700	70121	185	0	71302
790	221	238	744	68509	0	69712
791	225	187	69409	753	0	70574
792	63096	119	784	327	0	64326
793	867	151	70819	183	0	72020
794	326	70976	787	222	0	72311
795	234	732	310	70035	0	71311
796	220	273	219	71957	0	72669
797	71505	167	184	867	0	72723
798	71013	132	204	340	0	71689
799	891	71174	206	341	0	72612
800	447	710	70709	172	0	72038
801	328	302	70017	173	0	70820
802	67749	212	901	206	0	69068
803	855	175	71674	217	0	72921
804	388	201	69733	225	0	70547
805	332	181	70885	186	0	71584
806	333	181	70684	182	0	71380
807	253	71313	878	243	0	72687
808	71485	729	409	252	0	72875
809	834	327	242	69089	0	70492
810	69611	197	235	689	0	70732
811	816	69559	252	373	0	71000
812	69423	729	238	259	0	70649
813	823	73302	259	257	0	74641
814	386	773	274	72595	0	74028
815	280	77215	284	727	0	78506
816	334	849	75664	297	0	77144
817	282	78511	865	261	0	79919
818	283	828	365	83089	0	84565
819	83239	337	303	881	0	84760
820	949	258	253	83219	0	84679
821	414	269	84059	955	0	85697
822	353	242	949	79721	0	81265
823	238	84457	407	959	0	86061
824	337	935	84131	362	0	85765
825	78568	360	1023	277	0	80228
826	986	293	433	86487	0	88199
827	86562	259	313	1032	0	88166
828	85568	225	323	447	0	86563
829	1083	87126	329	425	0	88963
830	86479	949	292	294	0	88014
831	86084	388	317	286	0	87075
832	1095	87082	316	320	0	88813
833	416	976	349	86754	0	88495
834	350	407	325	85688	0	86770
835	213	86912	338	1123	0	88586
836	286	1036	318	87992	0	89632
837	287	414	87650	1055	0	89406
838	354	511	1045	85234	0	87144
839	331	267	85729	1028	0	87355
840	395	243	80325	380	0	81343
841	234	80032	1031	361	0	81658
842	243	80169	387	296	0	81095
843	344	81292	318	267	0	82221
844	455	930	361	76439	0	78185
845	206	307	77591	631	0	78735
846	71993	172	699	285	0	73149
847	705	136	262	78055	0	79158
848	259	145	78472	644	0	79520
849	221	181	77927	279	0	78608
850	152	78877	782	252	0	80063
851	184	871	286	77561	0	78902
852	76433	277	197	638	0	77545
853	609	76811	186	407	0	78013
854	201	77311	191	266	0	77969
855	161	77072	199	240	0	77672
856	153	811	210	76021	0	77195
857	136	79334	201	747	0	80418
858	154	767	195	84585	0	85701
859	146	288	197	86677	0	87308
860	191	221	85257	1066	0	86735
861	67681	199	1109	638	0	69627
862	970	221	87571	210	0	88972
863	291	252	986	85678	0	87207
864	285	195	88626	995	0	90101
865	145	87568	1063	459	0	89235
866	87610	1048	493	311	0	89462
867	1051	348	241	85190	0	86830
868	293	228	222	86639	0	87382
869	86822	164	205	1170	0	88361
870	86278	194	192	418	0	87082
871	88191	170	190	318	0	88869
872	1194	237	87287	230	0	88948
873	77807	198	965	248	0	79218
874	938	85641	301	250	0	87130
875	267	85879	198	263	0	86607
876	214	1106	198	82016	0	83534
877	173	371	135	79061	0	79740
878	157	81803	149	1128	0	83237
879	188	965	175	81156	0	82484
880	77607	304	175	1079	0	79165
881	980	236	80810	382	0	82408
882	293	80725	964	372	0	82354
883	75302	978	315	284	0	76879
884	833	78677	279	353	0	80142
885	300	1082	78299	269	0	79950
886	234	421	973	76152	0	77780
887	278	325	78225	1027	0	79855
888	216	76964	1020	492	0	78692
889	200	988	326	76691	0	78205
890	264	344	76979	1005	0	78592
891	299	308	77217	386	0	78210
892	262	295	1078	74673	0	76308
893	76109	240	408	1004	0	77761
894	75878	253	270	414	0	76815
895	76381	261	215	324	0	77181
896	1166	293	77426	310	0	79195
897	378	77545	967	385	0	79275
898	270	999	361	76900	0	78530
899	259	431	274	72973	0	73937
900	231	77613	267	1129	0	79240
901	76537	1010	260	501	0	78308
902	991	411	247	77760	0	79409
903	413	336	77509	1110	0	79368
904	311	77751	1023	568	0	79653
905	73803	1021	432	434	0	75690
906	955	76418	373	507	0	78253
907	392	1059	390	74705	0	76546
908	362	467	349	75555	0	76733
909	320	398	421	74679	0	75818
910	345	406	75072	1326	0	77149
911	396	358	1087	69853	0	71694
912	312	72980	571	1207	0	75070
913	398	71175	430	749	0	72752
914	576	1115	68177	485	0	70353
915	63583	473	1080	536	0	65672
916	66852	367	521	522	0	68262
917	1127	66475	439	564	0	68605
918	61151	862	431	437	0	62881
919	60745	392	292	475	0	61904
920	1074	63637	382	541	0	65634
921	715	911	343	64097	0	66066
922	550	474	66737	1016	0	68777
923	584	441	63859	555	0	65439
924	63210	487	1190	557	0	65444
925	1110	66787	500	558	0	68955
926	576	1103	367	66214	0	68260
927	465	581	331	66948	0	68325
928	528	454	325	66735	0	68042
929	64673	421	374	1356	0	66824
930	1294	482	344	65119	0	67239
931	699	428	360	65202	0	66689
932	562	489	63225	1224	0	65500
933	56877	418	1039	653	0	58987
934	1064	62815	528	618	0	65025
935	61792	1087	396	443	0	63718
936	1042	61418	382	536	0	63378
937	525	1080	455	59379	0	61439
938	61616	531	408	1029	0	63584
939	61877	463	413	608	0	63361
940	1107	452	61774	455	0	63788
941	61230	414	1092	547	0	63283
942	1100	460	63992	458	0	66010
943	569	409	62573	413	0	63964
944	461	468	62808	443	0	64180
945	467	410	68325	409	0	69611
946	404	386	1489	69025	0	71304
947	505	385	71252	1355	0	73497
948	415	371	1443	70471	0	72700
949	70972	424	589	1476	0	73461
950	1331	457	481	70610	0	72879
951	67370	386	449	1540	0	69745
952	1241	70157	468	762	0	72628
953	586	1423	403	69864	0	72276
954	629	565	66365	1573	0	69132
955	449	71877	1247	788	0	74361
956	565	1798	582	70160	0	73105
957	530	478	70998	1436	0	73442
958	273	68364	1161	542	0	70340
959	268	68478	379	469	0	69594
960	601	1299	66509	305	0	68714
961	293	745	1232	63348	0	65618
962	345	272	64610	1152	0	66379
963	59654	93	1170	345	0	61262
964	62359	101	327	180	0	62967
965	1172	61807	196	233	0	63408
966	61873	985	131	150	0	63139
967	1080	407	98	61919	0	63504
968	359	191	61593	1064	0	63207
969	57669	135	1119	412	0	59335
970	1099	88	60477	266	0	61930
971	293	59701	1060	198	0	61252
972	60973	1020	324	142	0	62459
973	1100	291	137	60547	0	62075
974	341	149	61544	1027	0	63061
975	60248	89	1072	330	0	61739
976	61044	100	356	173	0	61673
977	61255	100	200	131	0	61686
978	1336	97	121	60298	0	61852
979	397	84	113	61720	0	62314
980	220	104	61072	1326	0	62722
981	152	60318	1107	448	0	62025
982	173	1054	344	58906	0	60477
983	158	299	201	61582	0	62240
984	180	171	61017	1322	0	62690
985	204	114	61075	433	0	61826
986	171	137	1381	60178	0	61867
987	58660	108	482	1153	0	60403
988	1058	60294	244	506	0	62102
989	59618	1121	189	253	0	61181
990	1149	59919	205	357	0	61630
991	427	1165	59545	208	0	61345
992	280	379	61135	208	0	62002
993	58037	198	1513	219	0	59967
994	65189	167	523	229	0	66108
995	1605	65040	310	370	0	67325
996	610	1342	63786	312	0	66050
997	353	412	1509	62567	0	64841
998	321	254	539	60781	0	61895
999	303	63386	363	1788	0	65840
1000	301	1400	275	63663	0	65639
1001	308	504	64146	1578	0	66536
1002	61728	309	1560	581	0	64178
1003	63917	230	564	426	0	65137
1004	63804	240	400	310	0	64754
1005	64907	253	326	304	0	65790
1006	2007	223	62965	306	0	65501
1007	62144	229	1596	283	0	64252
1008	1833	223	63212	260	0	65528
1009	732	62420	1723	341	0	65216
1010	494	1457	745	62533	0	65229
1011	63714	538	477	1505	0	66234
1012	1613	304	474	65815	0	68206
1013	750	262	66357	1719	0	69088
1014	65214	258	1749	657	0	67878
1015	67353	273	721	547	0	68894
1016	2096	211	492	66092	0	68891
1017	847	250	401	67545	0	69043
1018	662	314	66085	2084	0	69145
1019	483	66370	1707	964	0	69524
1020	63765	1571	721	535	0	66592
1021	1767	621	61573	357	0	64318
1022	57900	370	1605	379	0	60254
1023	1782	59799	739	369	0	62689
1024	58198	1459	474	277	0	60408
1025	1785	57587	420	352	0	60144
1026	851	58815	415	407	0	60488
1027	687	1874	455	56923	0	59939
1028	567	674	392	59036	0	60669
1029	538	405	388	59420	0	60751
1030	490	316	377	60033	0	61216
1031	487	330	58228	2047	0	61092
1032	56666	276	1588	904	0	59434
1033	59492	242	719	604	0	61057
1034	60650	225	503	538	0	61916
1035	2226	224	432	58630	0	61512
1036	1071	238	375	60015	0	61699
1037	59308	235	412	1922	0	61877
1038	60068	254	397	807	0	61526
1039	60025	262	393	519	0	61199
1040	2121	327	408	57031	0	59887
1041	993	422	379	56336	0	58130
1042	666	268	54856	1757	0	57547
1043	556	262	54600	745	0	56163
1044	525	53274	1727	542	0	56068
1045	44655	1747	1562	928	0	48892
1046	44130	378	652	383	0	45543
1047	44620	244	265	428	0	45557
1048	1400	192	45053	354	0	46999
1049	44304	173	991	410	0	45878
1050	45915	165	447	353	0	46880
1051	46449	187	327	323	0	47286
1052	1522	129	266	45234	0	47151
1053	794	142	272	45729	0	46937
1054	632	155	269	45770	0	46826
1055	468	173	42632	1300	0	44573
1056	37665	160	894	580	0	39299
1057	1109	40824	422	374	0	42729
1058	35494	668	176	207	0	36545
1059	853	35049	156	237	0	36295
1060	402	35821	141	300	0	36664
1061	419	831	240	35242	0	36732
1062	380	370	211	34296	0	35257
1063	260	34729	160	836	0	35985
1064	34436	638	137	374	0	35585
1065	34609	266	120	314	0	35309
1066	906	172	161	33915	0	35154
1067	498	100	34286	760	0	35644
1068	388	94	33646	389	0	34517
1069	362	119	35150	269	0	35900
1070	405	115	34724	223	0	35467
1071	32235	229	959	175	0	33598
1072	33100	103	321	198	0	33722
1073	862	67	197	32174	0	33300
1074	455	85	32382	682	0	33604
1075	361	143	586	32023	0	33113
1076	276	33573	281	650	0	34780
1077	313	37458	179	309	0	38259
1078	37843	672	204	324	0	39043
1079	38171	334	122	225	0	38852
1080	38583	183	139	283	0	39188
1081	826	142	144	38095	0	39207
1082	428	146	123	38796	0	39493
1083	361	127	166	39009	0	39663
1084	403	99	93	38992	0	39587
1085	367	87	38273	921	0	39648
1086	295	62	539	38063	0	38959
1087	39712	74	275	764	0	40825
1088	671	71	218	39692	0	40652
1089	364	102	177	40265	0	40908
1090	357	227	174	39713	0	40471
1091	295	39132	163	839	0	40429
1092	263	38997	122	424	0	39806
1093	229	39688	141	351	0	40409
1094	167	438	116	34924	0	35645
1095	198	130	78	35237	0	35643
1096	35137	92	60	432	0	35721
1097	34994	74	55	207	0	35330
1098	35437	66	71	180	0	35754
1099	459	74	73	35400	0	36006
1100	221	66	66	35063	0	35416
1101	183	35565	69	421	0	36238
1102	191	36674	45	228	0	37138
1103	36348	311	50	159	0	36868
1104	449	122	47	35991	0	36609
1105	36200	51	80	401	0	36732
1106	37240	42	72	238	0	37592
1107	419	44	87	36581	0	37131
1108	182	38735	83	379	0	39379
1109	39255	312	91	206	0	39864
1110	39997	109	50	209	0	40365
1111	437	102	41354	127	0	42020
1112	38083	40	195	110	0	38428
1113	242	39363	96	92	0	39793
1114	92	174	33	40452	0	40751
1115	44595	55	28	423	0	45101
1116	303	75	17	45023	0	45418
1117	129	37	14	44856	0	45036
1118	59	45205	20	374	0	45658
1119	44647	246	22	135	0	45050
1120	44749	86	22	83	0	44940
1121	338	45324	38	94	0	45794
1122	123	48112	36	72	0	48343
1123	47859	301	20	103	0	48283
1124	47360	99	39	68	0	47566
1125	326	91	46951	69	0	47437
1126	156	49	45893	76	0	46174
1127	97	61	48233	47	0	48438
1128	73	35	312	47665	0	48085
1129	77	57	94	49267	0	49495
1130	56	42	49103	310	0	49511
1131	47161	36	250	179	0	47626
1132	50493	29	76	99	0	50697
1133	50617	22	41	82	0	50762
1134	49738	29	41	83	0	49891
1135	399	47	54047	43	0	54536
1136	53482	28	256	155	0	53921
1137	56103	22	114	158	0	56397
1138	55897	28	48	90	0	56063
1139	55793	34	31	93	0	55951
1140	55305	32	75	78	0	55490
1141	405	63	57197	80	0	57745
1142	165	57169	265	91	0	57690
1143	128	241	84	57997	0	58450
1144	94	86	56	58486	0	58722
1145	107	79	57898	344	0	58428
1146	52712	44	268	182	0	53206
1147	333	65	81	56929	0	57408
1148	174	69	57660	293	0	58196
1149	146	89	55697	129	0	56061
1150	89	59360	337	143	0	59929
1151	127	278	114	60524	0	61043
1152	94	115	72	60902	0	61183
1153	90	69	55	60666	0	60880
1154	60761	40	60	400	0	61261
1155	312	46	59	60585	0	61002
1156	169	58	60460	345	0	61032
1157	146	83	57965	179	0	58373
1158	133	90	62772	129	0	63124
1159	143	85	345	62690	0	63263
1160	64919	66	121	356	0	65462
1161	350	83	65602	136	0	66171
1162	63409	51	291	137	0	63888
1163	72985	39	159	441	0	73624
1164	440	56	93	74675	0	75264
1165	230	52	87	75331	0	75700
1166	138	76237	93	535	0	77003
1167	214	298	75023	164	0	75699
1168	70933	116	335	196	0	71580
1169	382	77	132	77292	0	77883
1170	186	77363	102	398	0	78049
1171	158	341	80	78205	0	78784
1172	189	134	78372	378	0	79073
1173	155	136	335	76226	0	76852
1174	117	77591	165	449	0	78322
1175	138	316	103	77033	0	77590
1176	76555	102	94	437	0	77188
1177	370	74	93	74539	0	75076
1178	176	73605	104	434	0	74319
1179	136	74662	105	281	0	75184
1180	71184	337	87	205	0	71813
1181	419	188	74600	121	0	75328
1182	193	96	311	73876	0	74476
1183	151	71	134	76971	0	77327
1184	149	91	78060	449	0	78749
1185	122	78184	382	511	0	79199
1186	217	355	78695	156	0	79423
1187	130	273	387	75803	0	76593
1188	123	81246	163	359	0	81891
1189	82671	290	104	280	0	83345
1190	331	82950	112	209	0	83602
1191	138	84195	96	234	0	84663
1192	85045	314	144	201	0	85704
1193	85097	138	108	322	0	85665
1194	87051	98	73	184	0	87406
1195	411	62	69	86839	0	87381
1196	221	66	86946	358	0	87591
1197	82789	51	332	236	0	83408
1198	89685	80	146	180	0	90091
1199	442	65	106	92554	0	93167
1200	224	89	93726	469	0	94508
1201	98	93012	410	320	0	93840
1202	92669	389	133	207	0	93398
1203	95809	103	84	362	0	96358
1204	432	98136	109	221	0	98898
1205	140	100523	95	192	0	100950
1206	99678	461	115	165	0	100419
1207	98613	138	71	153	0	98975
1208	97554	95	98	130	0	97877
1209	488	72	66	96794	0	97420
1210	251	90	100061	447	0	100849
1211	128	74	402	96265	0	96869
1212	191	105	98487	516	0	99299
1213	86	97533	420	301	0	98340
1214	88	98106	132	247	0	98573
1215	186	356	78	92941	0	93561
1216	115	88	71	95348	0	95622
1217	99	91	47	93867	0	94104
1218	55	95934	62	553	0	96604
1219	94612	330	69	158	0	95169
1220	92566	100	60	140	0	92866
1221	345	97036	68	252	0	97701
1222	143	366	54	93841	0	94404
1223	151	95203	59	408	0	95821
1224	129	429	37	94518	0	95113
1225	103	95699	65	479	0	96346
1226	95705	346	79	221	0	96351
1227	389	139	62	94316	0	94906
1228	185	139	94168	375	0	94867
1229	90020	92	361	202	0	90675
1230	93308	92	106	170	0	93676
1231	495	136	93867	142	0	94640
1232	221	106	334	92179	0	92840
1233	212	164	95720	370	0	96466
1234	132	116	327	94604	0	95179
1235	172	148	92375	461	0	93156
1236	84966	122	403	221	0	85712
1237	415	127	97	90070	0	90709
1238	163	91584	103	475	0	92325
1239	93407	421	85	217	0	94130
1240	446	170	68	94600	0	95284
1241	177	135	68	94016	0	94396
1242	222	148	93645	498	0	94513
1243	171	103	433	95655	0	96362
1244	247	137	100711	634	0	101729
1245	266	160	103894	217	0	104537
1246	195	120	721	106103	0	107139
1247	252	155	115992	731	0	117130
1248	110809	120	1002	336	0	112267
1249	134119	119	260	219	0	134717
1250	133044	199	161	231	0	133635
1251	1885	147123	140	398	0	149546
1252	587	1937	126	147545	0	150195
1253	386	737	138	135537	0	136798
1254	247	152194	157	1960	0	154558
1255	149618	1923	204	589	0	152334
1256	1979	508	121	148188	0	150796
1257	632	300	155467	2021	0	158420
1258	502	270	148803	658	0	150233
1259	233	147362	2340	699	0	150634
1260	148985	1925	624	340	0	151874
1261	2152	546	149490	303	0	152491
1262	131572	306	2202	351	0	134431
1263	1940	132980	660	578	0	136158
1264	627	1781	141529	318	0	144255
1265	468	520	140996	242	0	142226
1266	410	312	142753	267	0	143742
1267	304	136942	2511	458	0	140215
1268	509	2073	139160	258	0	142000
1269	132078	491	2151	315	0	135035
1270	2018	318	581	136892	0	139809
1271	554	236	328	141810	0	142928
1272	376	219	242	142309	0	143146
1273	317	236	231	143259	0	144043
1274	366	270	141729	2578	0	144943
1275	330	220	2097	138779	0	141426
1276	298	208	600	141313	0	142419
1277	139871	178	410	2505	0	142964
1278	141883	199	339	843	0	143264
1279	137798	187	351	556	0	138892
1280	2585	313	139985	452	0	143335
1281	757	143611	2221	552	0	147141
1282	468	149181	707	536	0	150892
1283	132560	2706	456	421	0	136143
1284	2020	144027	445	518	0	147010
1285	753	2472	350	142182	0	145757
1286	567	690	354	145796	0	147407
1287	539	492	143525	2796	0	147352
1288	371	139044	2491	1189	0	143095
1289	507	2366	139171	595	0	142639
1290	132406	690	2635	513	0	136244
1291	139603	419	828	502	0	141352
1292	2822	313	581	138312	0	142028
1293	910	303	533	137297	0	139043
1294	583	333	554	137514	0	138984
1295	684	284	492	138517	0	139977
1296	615	347	137599	3152	0	141713
1297	677	540	2657	134494	0	138368
1298	518	345	137044	2796	0	140703
1299	550	335	133554	994	0	135433
1300	394	132332	3032	849	0	136607
1301	131745	2474	1160	652	0	136031
1302	2473	136599	725	707	0	140504
1303	911	2858	633	128340	0	132742
1304	648	836	138308	2660	0	142452
1305	129470	501	3030	1009	0	134010
1306	2961	521	136827	707	0	141016
1307	133939	478	3177	679	0	138273
1308	136716	406	1247	698	0	139067
1309	3396	453	891	139789	0	144529
1310	1290	485	752	137620	0	140147
1311	909	514	746	139301	0	141470
1312	849	569	135820	3809	0	141047
1313	128511	482	3287	1506	0	133786
1314	3216	133461	1294	1174	0	139145
1315	1417	2989	938	130850	0	136194
1316	134930	992	911	3266	0	140099
1317	137055	826	877	1356	0	140114
1318	136905	783	807	1146	0	139641
1319	4262	865	133193	1169	0	139489
1320	132770	922	3333	1293	0	138318
1321	135860	1064	1359	1334	0	139617
1322	4005	815	129523	1442	0	135785
1323	1661	888	138727	1206	0	142482
1324	1266	983	4326	134519	0	141094
1325	1335	678	138719	3716	0	144448
1326	960	133418	4531	1740	0	140649
1327	1064	139890	2333	1018	0	144305
1328	132984	3920	1672	910	0	139486
1329	3669	138218	1417	1056	0	144360
1330	1864	3506	1402	137970	0	144742
1331	131446	1298	1535	3762	0	138041
1332	3445	137896	1460	1878	0	144679
1333	1263	3626	1541	136326	0	142756
1334	1016	1264	1689	139707	0	143676
1335	1029	941	136270	4571	0	142811
1336	1085	832	3987	134403	0	140307
1337	1150	877	136224	4512	0	142763
1338	1286	528	136073	2296	0	140183
1339	1326	572	4055	130291	0	136244
1340	1125	583	1475	134137	0	137320
1341	130657	566	1175	5040	0	137438
1342	3620	141436	1084	2802	0	148942
1343	1688	3570	995	135643	0	141896
1344	1491	2326	1025	137531	0	142373
1345	128567	693	787	4989	0	135036
1346	4082	126104	879	2258	0	133323
1347	1818	119182	820	1312	0	123132
1348	1189	111500	851	1053	0	114593
1349	662	98208	777	779	0	100426
1350	82805	2546	2982	566	0	88899
1351	80932	692	788	494	0	82906
1352	77756	477	335	430	0	78998
1353	77686	344	276	465	0	78771
1354	2431	352	292	75397	0	78472
1355	806	381	74345	2048	0	77580
1356	500	73685	1997	814	0	76996
1357	523	1909	650	72053	0	75135
1358	555	587	72660	2020	0	75822
1359	542	401	2007	71207	0	74157
1360	510	281	649	73019	0	74459
1361	490	336	71858	2387	0	75071
1362	409	365	2017	70736	0	73527
1363	454	353	656	71777	0	73240
1364	71428	362	492	2451	0	74733
1365	71654	395	410	916	0	73375
1366	71373	362	370	694	0	72799
1367	71084	368	356	655	0	72463
1368	2561	414	381	68555	0	71911
1369	1020	372	328	70124	0	71844
1370	765	465	308	70470	0	72008
1371	68276	393	374	2683	0	71726
1372	2300	389	356	68836	0	71881
1373	1098	342	348	69971	0	71759
1374	819	407	66780	2593	0	70599
1375	756	493	2036	63199	0	66484
1376	663	64463	712	2300	0	68138
1377	664	67876	472	1152	0	70164
1378	64458	2173	410	784	0	67825
1379	2285	708	63845	775	0	67613
1380	907	60849	1825	731	0	64312
1381	59001	1803	894	639	0	62337
1382	1978	633	376	59267	0	62254
1383	848	438	59043	2112	0	62441
1384	692	695	1770	54844	0	58001
1385	530	59779	626	2061	0	62996
1386	58152	1814	455	927	0	61348
1387	1902	61024	419	806	0	64151
1388	60822	1887	355	741	0	63805
1389	62066	620	374	698	0	63758
1390	2368	429	330	60427	0	63554
1391	897	400	333	58264	0	59894
1392	658	60196	360	2342	0	63556
1393	60664	1808	383	1018	0	63873
1394	2114	723	60220	751	0	63808
1395	58319	467	1760	708	0	61254
1396	58587	420	510	801	0	60318
1397	2240	334	56222	752	0	59548
1398	839	517	1598	53903	0	56857
1399	54285	343	639	2062	0	57329
1400	1868	385	54132	1010	0	57395
1401	795	408	52450	775	0	54428
1402	47370	442	1911	685	0	50408
1403	1740	47808	647	678	0	50873
1404	712	44933	350	535	0	46530
1405	779	1773	382	42820	0	45754
1406	632	619	43199	1473	0	45923
1407	41129	471	1385	682	0	43667
1408	1553	403	42270	535	0	44761
1409	665	38879	1263	506	0	41313
1410	38582	1347	510	481	0	40920
1411	1446	559	322	38398	0	40725
1412	38893	322	280	1501	0	40996
1413	1512	321	38573	696	0	41102
1414	691	385	1278	36341	0	38695
1415	513	38831	448	1315	0	41107
1416	487	1410	341	37609	0	39847
1417	560	596	312	39047	0	40515
1418	640	386	38426	1595	0	41047
1419	650	36943	1269	714	0	39576
1420	613	37561	532	530	0	39236
1421	701	1253	35442	521	0	37917
1422	32604	477	1299	495	0	34875
1423	34231	254	544	461	0	35490
1424	1594	409	325	32849	0	35177
1425	31293	208	359	1159	0	33019
1426	1242	29911	346	612	0	32111
1427	564	31717	310	547	0	33138
1428	31308	1155	438	518	0	33419
1429	1261	505	346	31136	0	33248
1430	31604	227	290	1243	0	33364
1431	32149	251	285	621	0	33306
1432	1443	313	254	30370	0	32380
1433	712	274	30324	1176	0	32486
1434	29826	274	1122	481	0	31703
1435	30888	277	418	353	0	31936
1436	1488	323	326	28759	0	30896
1437	598	29577	340	1166	0	31681
1438	505	1153	281	29797	0	31736
1439	485	410	29610	1212	0	31717
1440	519	279	29660	590	0	31048
1441	454	28803	1345	500	0	31102
1442	527	595	438	16895	0	18455
1443	170	184	158	17346	0	17858
1444	194	129	17395	486	0	18204
1445	16572	105	440	205	0	17322
1446	17794	110	195	159	0	18258
1447	17753	105	141	152	0	18151
1448	17609	130	111	154	0	18004
1449	589	16886	138	168	0	17781
1450	254	17610	154	157	0	18175
1451	17672	504	107	156	0	18439
1452	581	205	142	17930	0	18858
1453	281	145	139	17972	0	18537
1454	224	18169	110	569	0	19072
1455	207	498	124	18352	0	19181
1456	228	213	130	17822	0	18393
1457	222	17893	131	608	0	18854
1458	234	504	17973	270	0	18981
1459	227	225	482	18043	0	18977
1460	18144	165	196	547	0	19052
1461	18146	145	160	259	0	18710
1462	690	121	17803	158	0	18772
1463	350	121	17791	180	0	18442
1464	311	116	17763	159	0	18349
1465	250	187	562	16842	0	17841
1466	230	127	17391	530	0	18278
1467	265	140	17407	213	0	18025
1468	247	243	572	15629	0	16691
1469	217	17193	200	523	0	18133
1470	276	465	17356	236	0	18333
1471	170	17601	497	187	0	18455
1472	17031	488	220	180	0	17919
1473	466	17173	176	214	0	18029
1474	242	466	143	16754	0	17605
1475	16776	152	151	503	0	17582
1476	514	122	145	16721	0	17502
1477	272	150	129	17043	0	17594
1478	228	118	17028	515	0	17889
1479	196	16182	448	271	0	17097
1480	191	16826	190	205	0	17412
1481	211	439	165	15581	0	16396
1482	159	190	131	15817	0	16297
1483	160	133	159	15559	0	16011
1484	183	113	15033	476	0	15805
1485	124	98	14302	233	0	14757
1486	12695	106	381	186	0	13368
1487	314	75	13098	114	0	13601
1488	128	78	12819	94	0	13119
1489	70	12112	324	110	0	12616
1490	69	315	118	12137	0	12639
1491	112	91	12520	316	0	13039
1492	93	64	312	11960	0	12429
1493	91	40	12699	330	0	13160
1494	65	46	328	12568	0	13007
1495	92	54	13730	330	0	14206
1496	72	62	332	13423	0	13889
1497	70	51	123	13333	0	13577
1498	60	14070	95	346	0	14571
1499	61	290	87	13872	0	14310
1500	45	14224	102	333	0	14704
1501	52	317	100	14330	0	14799
1502	53	118	89	14548	0	14808
1503	14059	79	76	397	0	14611
1504	285	72	89	14173	0	14619
1505	100	74	14088	377	0	14639
1506	89	75	310	13959	0	14433
1507	76	55	113	14330	0	14574
1508	83	49	14078	408	0	14618
1509	82	81	13986	178	0	14327
1510	55	76	366	13307	0	13804
1511	52	73	143	14024	0	14292
1512	75	70	14043	405	0	14593
1513	55	13372	341	214	0	13982
1514	34	14061	158	174	0	14427
1515	13637	323	121	150	0	14231
1516	310	116	109	13935	0	14470
1517	14222	72	124	400	0	14818
1518	13870	72	148	150	0	14240
1519	307	14254	132	155	0	14848
1520	14300	308	113	141	0	14862
1521	14466	120	112	132	0	14830
1522	340	94	14370	137	0	14941
1523	113	67	342	14196	0	14718
1524	82	62	14788	380	0	15312
1525	56	81	396	14734	0	15267
1526	61	54	14877	397	0	15389
1527	53	13734	332	182	0	14301
1528	48	13853	203	152	0	14256
1529	92	316	127	13205	0	13740
1530	13206	74	84	289	0	13653
1531	213	65	81	13215	0	13574
1532	66	51	81	13437	0	13635
1533	51	56	13514	304	0	13925
1534	56	53	13492	160	0	13761
1535	53	58	13476	115	0	13702
1536	55	47	305	13044	0	13451
1537	45	55	132	12506	0	12738
1538	41	13265	104	287	0	13697
1539	37	13668	95	218	0	14018
1540	13060	251	106	128	0	13545
1541	190	13370	89	154	0	13803
1542	63	218	13069	118	0	13468
1543	40	63	257	12744	0	13104
1544	45	60	13621	290	0	14016
1545	34	13703	258	166	0	14161
1546	49	324	112	13577	0	14062
1547	12977	62	93	256	0	13388
1548	193	45	13476	107	0	13821
1549	44	13615	231	129	0	14019
1550	52	194	13635	97	0	13978
1551	27	13436	218	95	0	13776
1552	107	214	120	12909	0	13350
1553	12905	42	63	186	0	13196
1554	12695	34	48	84	0	12861
1555	147	12724	54	92	0	13017
1556	12781	154	56	82	0	13073
1557	151	44	56	12758	0	13009
1558	12827	46	64	213	0	13150
1559	175	42	13084	92	0	13393
1560	58	41	13108	84	0	13291
1561	51	49	218	12229	0	12547
1562	45	39	76	13626	0	13786
1563	53	48	13481	243	0	13825
1564	40	48	208	13281	0	13577
1565	13500	38	67	259	0	13864
1566	13379	38	74	95	0	13586
1567	206	13187	49	96	0	13538
1568	58	13255	63	83	0	13459
1569	12827	222	51	81	0	13181
1570	203	61	49	12709	0	13022
1571	12657	38	74	221	0	12990
1572	190	12709	63	90	0	13052
1573	12717	195	63	78	0	13053
1574	207	59	12522	77	0	12865
1575	68	39	12612	61	0	12780
1576	50	64	211	12316	0	12641
1577	39	56	12853	208	0	13156
1578	44	47	224	12199	0	12514
1579	46	47	55	12386	0	12534
1580	66	44	13105	213	0	13428
1581	52	58	207	12785	0	13102
1582	47	52	55	13695	0	13849
1583	56	42	14152	232	0	14482
1584	55	42	14151	61	0	14309
1585	13587	35	242	64	0	13928
1586	229	40	14665	54	0	14988
1587	14906	66	353	44	0	15369
1588	16451	27	46	54	0	16578
1589	344	27	16799	47	0	17217
1590	83	30	17179	28	0	17320
1591	61	24	390	16325	0	16800
1592	37	36	81	15998	0	16152
1593	29	16774	62	274	0	17139
1594	19	17396	51	99	0	17565
1595	29	307	16354	60	0	16750
1596	15422	60	315	63	0	15860
1597	16369	36	74	58	0	16537
1598	330	25	16076	40	0	16471
1599	84	23	16278	38	0	16423
1600	52	16	321	15612	0	16001
1601	35	16748	88	266	0	17137
1602	50	282	44	16747	0	17123
1603	34	55	35	17238	0	17362
1604	17064	42	34	320	0	17460
1605	17036	24	44	77	0	17181
1606	334	31	22	17918	0	18305
1607	96	21	18009	303	0	18429
1608	16745	24	309	87	0	17165
1609	280	18551	71	71	0	18973
1610	18718	280	56	42	0	19096
1611	18325	51	48	48	0	18472
1612	290	18574	51	68	0	18983
1613	82	19103	56	63	0	19304
1614	60	316	52	18831	0	19259
1615	43	72	43	18961	0	19119
1616	39	19011	49	325	0	19424
1617	47	298	48	18748	0	19141
1618	58	63	47	19075	0	19243
1619	62	56	18818	352	0	19288
1620	18066	30	313	116	0	18525
1621	19227	32	78	79	0	19416
1622	19386	32	73	62	0	19553
1623	390	27	58	18896	0	19371
1624	18700	22	67	316	0	19105
1625	315	18633	74	106	0	19128
1626	107	341	56	17414	0	17918
1627	76	18345	57	286	0	18764
1628	49	19099	74	97	0	19319
1629	19180	304	128	88	0	19700
1630	19291	73	52	75	0	19491
1631	19164	43	62	63	0	19332
1632	19144	33	67	63	0	19307
1633	19036	40	51	71	0	19198
1634	393	44	19207	44	0	19688
1635	18843	46	314	85	0	19288
1636	364	53	20004	59	0	20480
1637	19185	43	329	77	0	19634
1638	19794	38	99	76	0	20007
1639	19546	38	87	76	0	19747
1640	392	60	21084	67	0	21603
1641	146	123	320	19666	0	20255
1642	95	21698	119	271	0	22183
1643	21965	288	90	93	0	22436
1644	21542	92	82	87	0	21803
1645	373	22006	85	87	0	22551
1646	22369	296	73	79	0	22817
1647	385	86	84	21484	0	22039
1648	143	22480	73	296	0	22992
1649	22467	283	69	124	0	22943
1650	22389	96	69	98	0	22652
1651	380	82	77	22303	0	22842
1652	22537	53	97	363	0	23050
1653	369	66	75	22657	0	23167
1654	163	74	76	22941	0	23254
1655	184	84	22935	357	0	23560
1656	165	56	324	22329	0	22874
1657	155	70	95	23046	0	23366
1658	141	85	23176	352	0	23754
1659	129	87	23119	131	0	23466
1660	113	64	318	23270	0	23765
1661	121	68	23732	312	0	24233
1662	21423	72	285	132	0	21912
1663	315	24206	94	114	0	24729
1664	138	260	70	24882	0	25350
1665	115	83	54	25380	0	25632
1666	122	71	49	25431	0	25673
1667	25289	51	36	340	0	25716
1668	25087	56	46	129	0	25318
1669	25532	56	39	129	0	25756
1670	371	25685	45	115	0	26216
1671	175	266	36	25907	0	26384
1672	161	88	27	26117	0	26393
1673	25961	85	24	308	0	26378
1674	25786	77	26	112	0	26001
1675	363	71	41	25867	0	26342
1676	155	77	25921	294	0	26447
1677	25108	69	247	149	0	25573
1678	26327	55	65	116	0	26563
1679	374	53	26646	93	0	27166
1680	24077	43	252	97	0	24469
1681	342	55	26829	80	0	27306
1682	26202	28	259	138	0	26627
1683	320	133	93	27583	0	28129
1684	126	29036	75	287	0	29524
1685	191	222	29597	75	0	30085
1686	103	29681	278	88	0	30150
1687	76	29155	74	87	0	29392
1688	29901	210	109	253	0	30473
1689	160	52	60	29707	0	29979
1690	45	16	12	29475	0	29548
1691	30824	11	13	232	0	31080
1692	143	14	15	31238	0	31410
1693	40	29	17	31319	0	31405
1694	46	17	20	31414	0	31497
1695	33	17	17	31212	0	31279
1696	50	23	31475	157	0	31705
1697	52	39	30433	60	0	30584
1698	33	30965	133	62	0	31193
1699	31515	114	31	118	0	31778
1700	143	28	24	32243	0	32438
1701	48	31943	34	171	0	32196
1702	57	212	26	33847	0	34142
1703	46	30	26	34125	0	34227
1704	51	24	19	34181	0	34275
1705	48	140	19	34312	0	34519
1706	36	24	19	34018	0	34097
1707	40	33549	28	203	0	33820
1708	44	118	21	34039	0	34222
1709	69	40	33136	152	0	33397
1710	34	33333	120	109	0	33596
1711	35	122	23	33787	0	33967
1712	40	34	25	33634	0	33733
1713	29	33297	27	186	0	33539
1714	42	33883	24	100	0	34049
1715	33166	121	21	59	0	33367
1716	117	33202	35	79	0	33433
1717	32915	109	41	84	0	33149
1718	32484	26	37	68	0	32615
1719	171	34	35016	64	0	35285
1720	73	41	138	32155	0	32407
1721	73	28	35623	155	0	35879
1722	41	36570	127	94	0	36832
1723	47	191	37	35670	0	35945
1724	34	52	28	37129	0	37243
1725	31	40	30	37227	0	37328
1726	43	31	24	37424	0	37522
1727	80	43	37705	204	0	38032
1728	63	28	157	37068	0	37316
1729	76	48	38251	199	0	38574
1730	84	57	37402	76	0	37619
1731	34319	24	183	164	0	34690
1732	38413	22	47	83	0	38565
1733	38895	23	25	78	0	39021
1734	172	38281	41	103	0	38597
1735	56	165	26	38787	0	39034
1736	94	54	39864	205	0	40217
1737	70	29	167	39101	0	39367
1738	103	64	41372	196	0	41735
1739	39388	33	161	136	0	39718
1740	40486	35	55	72	0	40648
1741	40452	43	45	89	0	40629
1742	231	69	39639	74	0	40013
1743	92	46	39920	60	0	40118
1744	45	83	164	40089	0	40381
1745	43	34	54	41347	0	41478
1746	34	34	32	41951	0	42051
1747	66	35	42048	207	0	42356
1748	58	81	39102	86	0	39327
1749	39306	38	188	97	0	39629
1750	179	22	49	43206	0	43456
1751	53	20	35	43627	0	43735
1752	44259	25	26	254	0	44564
1753	171	43	20	44120	0	44354
1754	47110	24	29	372	0	47535
1755	48461	37	35	229	0	48762
1756	47515	41	36	134	0	47726
1757	233	34	49533	80	0	49880
1758	51	48999	179	129	0	49358
1759	50778	167	45	152	0	51142
1760	195	36	39	50785	0	51055
1761	60	34	28	50528	0	50650
1762	33	51283	39	294	0	51649
1763	50632	179	33	122	0	50966
1764	50200	47	20	126	0	50393
1765	50858	29	38	91	0	51016
1766	197	51608	55	98	0	51958
1767	54221	176	35	183	0	54615
1768	54241	49	57	115	0	54462
1769	54232	34	31	106	0	54403
1770	229	45	30	53190	0	53494
1771	78	26	34	54207	0	54345
1772	97	66	55840	230	0	56233
1773	53	35	173	53891	0	54152
1774	52	27	49	55831	0	55959
1775	83	47	55798	224	0	56152
1776	51696	29	178	109	0	52012
1777	55900	26	50	102	0	56078
1778	233	44	44	55250	0	55571
1779	75	55156	45	254	0	55530
1780	70	55795	43	154	0	56062
1781	58	290	32	54984	0	55364
1782	89	62	53394	216	0	53761
1783	111	101	149	50933	0	51294
1784	88	62	52993	167	0	53310
1785	99	63	53837	58	0	54057
1786	38	21	122	54966	0	55147
1787	56233	20	42	156	0	56451
1788	54561	17	38	114	0	54730
1789	155	22	20	57168	0	57365
1790	80	31	27	58301	0	58439
1791	64	18	25	57879	0	57986
1792	50	27	32	57605	0	57714
1793	57797	16	45	219	0	58077
1794	56673	29	32	125	0	56859
1795	57084	25	42	103	0	57254
1796	165	63	57473	60	0	57761
1797	76	26	107	56895	0	57104
1798	49	31	46	58783	0	58909
1799	58463	23	29	168	0	58683
1800	120	58085	39	98	0	58342
1801	58358	101	26	126	0	58611
1802	57667	39	30	89	0	57825
1803	57297	43	31	78	0	57449
1804	57335	19	45	67	0	57466
1805	240	54	59416	32	0	59742
1806	138	75	56174	46	0	56433
1807	60725	30	150	134	0	61039
1808	62830	18	53	80	0	62981
1809	62086	26	41	92	0	62245
1810	63130	17	50	79	0	63276
1811	272	58	67979	73	0	68382
1812	107	71171	279	116	0	71673
1813	142	349	87	76319	0	76897
1814	81469	131	42	692	0	82334
1815	83581	49	24	251	0	83905
1816	88847	34	55	162	0	89098
1817	90192	39	38	115	0	90384
1818	90377	44	43	99	0	90563
1819	86677	45	237	93	0	87052
1820	1115	82	83016	80	0	84293
1821	446	60	84816	56	0	85378
1822	237	89	824	82834	0	83984
1823	249	69	86124	733	0	87175
1824	147	84568	744	374	0	85833
1825	142	87423	324	187	0	88076
1826	142	980	138	87533	0	88793
1827	210	315	90769	714	0	92008
1828	160	160	87300	291	0	87911
1829	85740	101	937	174	0	86952
1830	98133	80	337	131	0	98681
1831	1259	73	155	99356	0	100843
1832	101030	51	117	1138	0	102336
1833	1216	68	107	100720	0	102111
1834	407	70	85	101395	0	101957
1835	288	75	103213	1432	0	105008
1836	231	96	99757	473	0	100557
1837	160	49	1431	99168	0	100808
1838	254	78	100054	1211	0	101597
1839	93285	43	1238	511	0	95077
1840	101068	53	396	270	0	101787
1841	1480	103499	222	296	0	105497
1842	104427	1127	173	207	0	105934
1843	1476	379	102812	142	0	104809
1844	100627	123	1282	144	0	102176
1845	103758	69	438	196	0	104461
1846	104328	82	229	169	0	104808
1847	1810	94	167	98974	0	101045
1848	641	102529	238	1226	0	104634
1849	103377	1207	199	411	0	105194
1850	103559	373	192	272	0	104396
1851	1737	182	208	103493	0	105620
1852	103631	119	200	1432	0	105382
1853	1577	105706	208	671	0	108162
1854	675	1399	177	103791	0	106042
1855	521	485	102697	1538	0	105241
1856	88386	220	1558	702	0	90866
1857	1703	149	101972	375	0	104199
1858	735	175	1628	99959	0	102497
1859	443	101234	630	1570	0	103877
1860	418	110476	362	647	0	111903
1861	454	2069	259	108886	0	111668
1862	430	116531	308	1968	0	119237
1863	464	2207	284	143705	0	146660
1864	459	705	264	150610	0	152038
1865	492	374	291	152661	0	153818
1866	145385	269	277	4073	0	150004
1867	3447	224	251	147242	0	151164
1868	1349	254	145209	3634	0	150446
1869	829	145057	3166	1302	0	150354
1870	143451	3164	846	624	0	148085
1871	3663	846	397	144057	0	148963
1872	1352	432	322	146904	0	149010
1873	875	330	322	149213	0	150740
1874	910	321	144669	4251	0	150151
1875	633	145081	3378	1561	0	150653
1876	145110	3314	1004	857	0	150285
1877	3653	1036	577	133170	0	138436
1878	1150	146287	511	3314	0	151262
1879	145802	3439	495	1351	0	151087
1880	3707	1045	145231	861	0	150844
1881	141389	571	3607	748	0	146315
1882	3999	515	148054	668	0	153236
1883	1481	531	148229	688	0	150929
1884	875	145183	4174	987	0	151219
1885	799	3507	1237	140668	0	146211
1886	991	1059	142258	3839	0	148147
1887	661	137901	3799	1785	0	144146
1888	701	3436	1276	132170	0	137583
1889	599	136619	826	3795	0	141839
1890	723	3619	136659	1384	0	142385
1891	677	1173	3669	134704	0	140223
1892	837	760	137966	4122	0	143685
1893	700	631	3831	135520	0	140682
1894	751	590	1297	140130	0	142768
1895	929	609	136636	4679	0	142853
1896	826	563	3877	135827	0	141093
1897	132108	543	1398	4370	0	138419
1898	3767	133979	947	2208	0	140901
1899	1637	3661	133854	1454	0	140606
1900	130976	1295	3785	1294	0	137350
1901	4193	878	1371	126446	0	132888
1902	1654	133524	993	3997	0	140168
1903	134580	3740	909	1796	0	141025
1904	136890	1417	790	1358	0	140455
1905	4743	1028	770	130128	0	136669
1906	1824	826	727	133422	0	136799
1907	1156	786	794	133725	0	136461
1908	1039	911	762	130576	0	133288
1909	912	128714	861	5419	0	135906
1910	1355	5475	888	117609	0	125327
1911	872	121107	855	4298	0	127132
1912	923	120256	869	2283	0	124331
1913	749	116435	917	1768	0	119869
1914	1340	4269	106976	1417	0	114002
1915	809	110318	3638	1561	0	116326
1916	100922	3705	1958	1719	0	108304
1917	3189	102887	918	2030	0	109024
1918	1364	3479	918	92130	0	97891
1919	1021	102976	1008	4162	0	109167
1920	1042	3629	965	101257	0	106893
1921	1055	1638	1038	105397	0	109128
1922	1040	1297	102071	4701	0	109109
1923	97556	1280	3530	2391	0	104757
1924	102399	1226	1405	2038	0	107068
1925	100071	1122	1183	1973	0	104349
1926	3922	98564	1194	2350	0	106030
1927	1524	3530	1204	96033	0	102291
1928	1451	1662	95061	4393	0	102567
1929	1074	94522	3764	2406	0	101766
1930	1278	3987	1570	73351	0	80186
1931	1109	85279	1224	3191	0	90803
1932	84497	3334	1138	1682	0	90651
1933	86389	1540	1107	1439	0	90475
1934	86826	1235	1260	1315	0	90636
1935	85327	1031	1472	1290	0	89120
1936	3685	1020	1437	82363	0	88505
1937	1424	1161	1363	81023	0	84971
1938	990	82414	1454	3737	0	88595
1939	1013	3308	1102	83147	0	88570
1940	884	1533	81374	3878	0	87669
1941	708	1337	3124	79485	0	84654
1942	754	1320	78695	3745	0	84514
1943	705	77013	3227	2270	0	83215
1944	760	3196	77955	1690	0	83601
1945	708	1538	3536	77150	0	82932
1946	729	1192	78368	3835	0	84124
1947	732	1087	3339	77470	0	82628
1948	850	1132	1486	78632	0	82100
1949	1055	1010	1200	78326	0	81591
1950	1166	1066	1076	78090	0	81398
1951	74580	1142	873	3871	0	80466
1952	2973	75387	845	2042	0	81247
1953	72491	3048	914	1623	0	78076
1954	2937	1478	71739	1536	0	77690
1955	70309	1170	2571	1549	0	75599
1956	72689	1038	969	1540	0	76236
1957	3679	1106	69830	1463	0	76078
1958	2245	914	68250	1464	0	72873
1959	1297	66189	2761	1630	0	71877
1960	866	61173	944	1652	0	64635
1961	1581	2678	55187	1749	0	61195
1962	797	47028	2045	1936	0	51806
1963	1217	2105	898	20222	0	24442
1964	18375	194	428	465	0	19462
1965	338	110	65	18048	0	18561
1966	18224	116	63	401	0	18804
1967	18320	121	69	187	0	18697
1968	365	18517	77	225	0	19184
1969	18341	297	55	156	0	18849
1970	18368	145	37	144	0	18694
1971	365	124	37	17767	0	18293
1972	17969	85	45	370	0	18469
1973	286	18107	56	171	0	18620
1974	120	278	43	18062	0	18503
1975	18059	120	54	338	0	18571
1976	271	127	18083	142	0	18623
1977	17520	85	226	104	0	17935
1978	300	110	99	18089	0	18598
1979	116	79	18122	222	0	18539
1980	82	78	17770	106	0	18036
1981	16904	147	344	84	0	17479
1982	16744	48	122	88	0	17002
1983	202	31	39	16612	0	16884
1984	83	27	18	16861	0	16989
1985	45	33	14	16610	0	16702
1986	32	16911	40	231	0	17214
1987	16811	175	27	88	0	17101
1988	177	16918	22	76	0	17193
1989	16845	170	43	51	0	17109
1990	214	61	16708	38	0	17021
1991	83	23	167	16838	0	17111
1992	17357	26	49	208	0	17640
1993	200	30	34	17340	0	17604
1994	77	30	44	17054	0	17205
1995	44	16999	37	231	0	17311
1996	16964	172	39	79	0	17254
1997	170	17778	38	71	0	18057
1998	71	187	35	17678	0	17971
1999	51	58	17400	207	0	17716
2000	15019	14	208	108	0	15349
2001	213	25	17227	58	0	17523
2002	15387	21	179	69	0	15656
2003	204	17072	82	62	0	17420
2004	68	223	24	16093	0	16408
2005	65	16907	24	198	0	17194
2006	17015	208	39	74	0	17336
2007	240	76	32	16954	0	17302
2008	97	33	30	17403	0	17563
2009	78	37	16865	243	0	17223
2010	14943	39	199	123	0	15304
2011	230	22	71	17134	0	17457
2012	84	36	16915	230	0	17265
2013	59	16714	231	101	0	17105
2014	54	206	56	16827	0	17143
2015	16971	54	50	240	0	17315
2016	221	43	40	16994	0	17298
2017	99	34	17135	232	0	17500
2018	17646	24	207	90	0	17967
2019	269	35	62	18354	0	18720
2020	101	48	20730	261	0	21140
2021	85	30	315	20845	0	21275
2022	65	55	88	20460	0	20668
2023	72	21582	57	404	0	22115
2024	21069	357	29	155	0	21610
2025	363	21596	30	108	0	22097
2026	21571	375	39	86	0	22071
2027	402	98	42	20922	0	21464
2028	115	21634	39	360	0	22148
2029	112	368	31	21647	0	22158
2030	76	103	21313	404	0	21896
2031	20161	75	354	127	0	20717
2032	384	37	95	20800	0	21316
2033	131	34	69	20759	0	20993
2034	92	40	46	20933	0	21111
2035	87	43	20308	478	0	20916
2036	91	50	20179	171	0	20491
2037	59	20310	419	137	0	20925
2038	60	345	126	19707	0	20238
2039	19632	91	64	342	0	20129
2040	316	20001	46	176	0	20539
2041	123	323	43	20631	0	21120
2042	20923	94	41	347	0	21405
2043	20759	76	47	136	0	21018
2044	414	20858	45	117	0	21434
2045	22430	352	37	98	0	22917
2046	25356	120	41	90	0	25607
2047	562	74	27	25945	0	26608
2048	166	26413	57	562	0	27198
2049	108	487	38	27116	0	27749
2050	26603	157	43	599	0	27402
2051	548	92	27127	211	0	27978
2052	218	52	517	26999	0	27786
2053	125	73	168	27515	0	27881
2054	118	71	27043	684	0	27916
2055	85	82	524	27001	0	27692
2056	27017	73	169	661	0	27920
2057	26033	70	111	279	0	26493
2058	661	72	78	26841	0	27652
2059	250	71	26751	650	0	27722
2060	184	69	25799	275	0	26327
2061	115	26163	639	230	0	27147
2062	106	27035	232	211	0	27584
2063	155	634	174	25762	0	26725
2064	25461	200	94	584	0	26339
2065	518	25915	81	254	0	26768
2066	25468	509	87	191	0	26255
2067	569	199	89	25425	0	26282
2068	211	132	79	25634	0	26056
2069	24657	93	71	707	0	25528
2070	563	24994	73	324	0	25954
2071	25157	535	78	221	0	25991
2072	620	206	24373	171	0	25370
2073	251	135	24130	174	0	24690
2074	162	129	626	23228	0	24145
2075	147	94	23973	610	0	24824
2076	153	103	23649	247	0	24152
2077	127	126	629	21923	0	22805
2078	141	91	23138	582	0	23952
2079	129	71	594	22264	0	23058
2080	138	77	224	22692	0	23131
2081	139	87	23258	735	0	24219
2082	123	88	569	22537	0	23317
2083	134	91	241	22193	0	22659
2084	122	22475	178	723	0	23498
2085	22453	520	139	333	0	23445
2086	565	206	22586	269	0	23626
2087	220	124	553	22305	0	23202
2088	157	104	247	23065	0	23573
2089	158	104	22396	744	0	23402
2090	20400	105	554	373	0	21432
2091	552	22286	227	316	0	23381
2092	245	527	162	22043	0	22977
2093	162	202	155	21839	0	22358
2094	170	22200	145	730	0	23245
2095	168	533	22063	334	0	23098
2096	121	22506	575	304	0	23506
2097	21706	572	239	235	0	22752
2098	537	242	21890	202	0	22871
2099	262	163	529	21444	0	22398
2100	205	153	22101	597	0	23056
2101	198	125	22019	340	0	22682
2102	164	21747	625	280	0	22816
2103	185	492	294	20841	0	21812
2104	21181	229	211	566	0	22187
2105	21284	157	171	312	0	21924
2106	595	21408	206	262	0	22471
2107	261	472	165	21721	0	22619
2108	21643	218	182	610	0	22653
2109	21895	146	178	343	0	22562
2110	636	21780	177	301	0	22894
2111	22086	450	184	269	0	22989
2112	569	213	177	21282	0	22241
2113	266	22248	180	603	0	23297
2114	210	550	177	22588	0	23525
2115	197	233	171	22728	0	23329
2116	194	263	173	22837	0	23467
2117	173	158	22191	735	0	23257
2118	178	146	20556	359	0	21239
2119	126	20698	578	253	0	21655
2120	18120	335	229	197	0	18881
2121	331	17978	140	226	0	18675
2122	214	313	137	17551	0	18215
2123	131	160	18295	397	0	18983
2124	96	123	351	17720	0	18290
2125	114	110	198	18502	0	18924
2126	103	141	128	18717	0	19089
2127	18420	123	119	441	0	19103
2128	331	103	142	18547	0	19123
2129	175	111	19611	397	0	20294
2130	18419	98	346	270	0	19133
2131	19205	81	211	221	0	19718
2132	19668	70	159	198	0	20095
2133	19736	64	134	194	0	20128
2134	19720	75	131	176	0	20102
2135	398	19558	138	197	0	20291
2136	194	286	108	18698	0	19286
2137	153	19474	136	366	0	20129
2138	19390	300	118	223	0	20031
2139	19352	142	102	190	0	19786
2140	18613	116	129	149	0	19007
2141	397	18390	105	176	0	19068
2142	186	18280	125	153	0	18744
2143	145	18545	95	154	0	18939
2144	218	347	17979	149	0	18693
2145	456	1001	316	14540	0	16313
2146	55	13370	82	116	0	13623
2147	18	12397	56	34	0	12505
2148	11	41	11	12284	0	12347
2149	13	19	12	12280	0	12324
2150	12	16	12356	57	0	12441
2151	11737	14	40	59	0	11850
2152	41	10	16	13051	0	13118
2153	22	6	12	13077	0	13117
2154	19	12	13033	63	0	13127
2155	16	23	12428	32	0	12499
2156	11	13520	55	22	0	13608
2157	15	59	21	13696	0	13791
2158	21	16	9	13833	0	13879
2159	15	17	13502	59	0	13593
2160	12145	10	42	38	0	12235
2161	13479	12	20	25	0	13536
2162	68	14	13845	15	0	13942
2163	13550	10	49	36	0	13645
2164	61	17	14135	17	0	14230
2165	13964	9	47	18	0	14038
2166	14355	6	31	22	0	14414
2167	68	19	14780	16	0	14883
2168	26	6	43	14501	0	14576
2169	16	8	17	15301	0	15342
2170	18	8	8	15686	0	15720
2171	15593	10	13	70	0	15686
2172	15399	9	15	32	0	15455
2173	84	15	16039	14	0	16152
2174	40	18	15121	19	0	15198
2175	16118	16	84	53	0	16271
2176	16660	10	28	33	0	16731
2177	97	22	16417	26	0	16562
2178	42	16	16265	25	0	16348
2179	23	7	84	16389	0	16503
2180	35	14	17082	87	0	17218
2181	29	17	74	16011	0	16131
2182	17176	6	49	98	0	17329
2183	108	11	18179	34	0	18332
2184	16926	12	128	43	0	17109
2185	146	13	20752	25	0	20936
2186	50	9	166	20410	0	20635
2187	32	11	45	21552	0	21640
2188	36	13	21	21579	0	21649
2189	25	21958	25	233	0	22241
2190	27	178	28	21451	0	21684
2191	36	30	22	22042	0	22130
2192	21757	12	25	224	0	22018
2193	210	14	21565	48	0	21837
2194	19958	12	202	43	0	20215
2195	201	16	21408	30	0	21655
2196	18276	10	209	60	0	18555
2197	197	20948	54	72	0	21271
2198	71	172	21116	23	0	21382
2199	43	32	20956	30	0	21061
2200	37	54	221	19502	0	19814
2201	26	4	49	21200	0	21279
2202	30	23	21683	222	0	21958
2203	50	25	21883	42	0	22000
2204	47	21	23994	29	0	24091
2205	24494	6	230	81	0	24811
2206	25402	6	71	62	0	25541
2207	25500	5	43	43	0	25591
2208	237	4	39	24996	0	25276
2209	56	9	41	25463	0	25569
2210	60	19	26850	243	0	27172
2211	32	13	203	26052	0	26300
2212	38	17	59	26808	0	26922
2213	26785	11	40	279	0	27115
2214	26364	11	29	126	0	26530
2215	27130	23	45	94	0	27292
2216	266	21	30	27001	0	27318
2217	73	25	46	27124	0	27268
2218	61	20	50	27181	0	27312
2219	26957	13	63	258	0	27291
2220	242	20	59	26020	0	26341
2221	74	26771	65	217	0	27127
2222	67	195	52	25939	0	26253
2223	43	26078	74	241	0	26436
2224	26152	183	67	71	0	26473
2225	25035	43	76	74	0	25228
2226	212	25927	85	104	0	26328
2227	76	26505	75	78	0	26734
2228	75	256	72	26265	0	26668
2229	64	61	25580	224	0	25929
2230	71	19	258	24381	0	24729
2231	105	53	25798	256	0	26212
2232	71	25883	232	171	0	26357
2233	81	195	87	26082	0	26445
2234	78	53	53	26410	0	26594
2235	91	32	27435	282	0	27840
2236	87	23	248	26590	0	26948
2237	88	36	27741	266	0	28131
2238	26890	16	266	153	0	27325
2239	28035	17	67	127	0	28246
2240	28311	23	50	120	0	28504
2241	288	32	49	27955	0	28324
2242	112	25	64	28213	0	28414
2243	84	53	28847	335	0	29319
2244	107	53	245	27294	0	27699
2245	103	28496	87	361	0	29047
2246	113	250	28488	128	0	28979
2247	157	82	27877	103	0	28219
2248	84	87	268	25676	0	26115
2249	108	72	28671	274	0	29125
2250	103	75	28351	126	0	28655
2251	25820	65	263	170	0	26318
2252	229	30670	92	155	0	31146
2253	31737	209	79	198	0	32223
2254	31735	62	78	152	0	32027
2255	32214	52	97	151	0	32514
2256	258	39	93	32019	0	32409
2257	121	37	85	32637	0	32880
2258	114	49	32749	265	0	33177
2259	116	43	237	31533	0	31929
2260	73	33098	116	291	0	33578
2261	33030	189	110	139	0	33468
2262	217	33089	123	153	0	33582
2263	86	33369	110	151	0	33716
2264	104	242	95	33218	0	33659
2265	136	69	33770	256	0	34231
2266	123	47	241	32928	0	33339
2267	125	41	33716	269	0	34151
2268	86	33287	245	170	0	33788
2269	33418	179	98	132	0	33827
2270	33613	46	102	138	0	33899
2271	34233	39	82	193	0	34547
2272	291	59	36063	117	0	36530
2273	129	94	33603	123	0	33949
2274	35687	29	224	175	0	36115
2275	36956	32	98	146	0	37232
2276	37322	42	66	137	0	37567
2277	275	34	51	36826	0	37186
2278	129	36	45	37410	0	37620
2279	37516	38	44	267	0	37865
2280	36795	41	70	145	0	37051
2281	278	64	38181	138	0	38661
2282	121	74	35808	105	0	36108
2283	35709	34	143	148	0	36034
2284	201	52	37143	95	0	37491
2285	34236	35	109	92	0	34472
2286	109	49	35628	59	0	35845
2287	51	78	51	34033	0	34213
2288	61	42	36915	61	0	37079
2289	46	23	40	37096	0	37205
2290	41	19	20	37779	0	37859
2291	29	39063	35	117	0	39244
2292	39092	36	26	80	0	39234
2293	68	59	39774	38	0	39939
2294	36666	25	55	88	0	36834
2295	54	40468	38	78	0	40638
2296	42264	43	24	137	0	42468
2297	70	23	23	42100	0	42216
2298	47	18	31	42388	0	42484
2299	24	43870	38	155	0	44087
2300	46	87	21	45319	0	45473
2301	51	62	26	45388	0	45527
2302	47	42	20	45553	0	45662
2303	43895	25	34	195	0	44149
2304	41382	33	23	90	0	41528
2305	181	61	41580	67	0	41889
2306	50	42155	146	116	0	42467
2307	62	151	46	43216	0	43475
2308	48	49	28	44702	0	44827
2309	63	65	44879	210	0	45217
2310	47	76	193	42975	0	43291
2311	44123	13	50	256	0	44442
2312	44343	26	43	118	0	44530
2313	44835	29	31	106	0	45001
2314	283	23	40	45775	0	46121
2315	48649	25	35	443	0	49152
2316	48653	34	35	163	0	48885
2317	49464	32	28	135	0	49659
2318	275	30	38	49544	0	49887
2319	109	32	28	50254	0	50423
2320	80	32	32	50437	0	50581
2321	74	36	35	49946	0	50091
2322	71	19	41	50007	0	50138
2323	130	63	49149	301	0	49643
2324	96	51	48550	135	0	48832
2325	56	48105	261	161	0	48583
2326	69	204	71	49872	0	50216
2327	66	61	48	50273	0	50448
2328	64	57	32	50496	0	50649
2329	93	41	49931	344	0	50409
2330	79	28	239	48783	0	49129
2331	74	52	50173	323	0	50622
2332	78	16	247	49003	0	49344
2333	199	68	52953	323	0	53543
2334	49	52650	303	334	0	53336
2335	70	296	91	52770	0	53227
2336	112	118	52063	324	0	52617
2337	43543	80	333	228	0	44184
2338	265	52941	112	186	0	53504
2339	112	269	53	53596	0	54030
2340	55	53795	59	396	0	54305
2341	54	340	51	54202	0	54647
2342	54390	77	38	426	0	54931
2343	328	54	54	53695	0	54131
2344	111	54224	78	422	0	54835
2345	54414	301	59	202	0	54976
2346	314	98	49	55872	0	56333
2347	132	125	33	56984	0	57274
2348	57772	33	65	595	0	58465
2349	453	38	51	63062	0	63604
2350	183	47	53	80464	0	80747
2351	186	76	82643	1509	0	84414
2352	153	79	82030	397	0	82659
2353	89	47	1726	81259	0	83121
2354	155	71	82594	1513	0	84333
2355	166	89	80701	427	0	81383
2356	74726	38	1815	285	0	76864
2357	1618	89	83058	218	0	84983
2358	393	83307	1587	298	0	85585
2359	227	1466	387	83624	0	85704
2360	85867	331	176	1537	0	87911
2361	87189	127	109	462	0	87887
2362	86169	65	122	272	0	86628
2363	1913	86194	101	304	0	88512
2364	548	1524	131	84580	0	86783
2365	229	388	96	87141	0	87854
2366	84345	143	138	1965	0	86591
2367	85859	81	124	661	0	86725
2368	86192	84	143	373	0	86792
2369	2074	92	86292	291	0	88749
2370	548	85600	1745	381	0	88274
2371	284	96277	572	397	0	97530
2372	264	2284	392	93040	0	95980
2373	197	735	263	97072	0	98267
2374	263	251	96493	2715	0	99722
2375	92488	151	2261	930	0	95830
2376	98065	154	835	436	0	99490
2377	2720	182	371	96564	0	99837
2378	948	176	209	98186	0	99519
2379	527	136	162	98848	0	99673
2380	97064	149	247	2941	0	100401
2381	2457	180	95240	1002	0	98879
2382	964	204	95866	532	0	97566
2383	474	182	2721	93460	0	96837
2384	360	182	94894	2435	0	97871
2385	91695	129	2369	998	0	95191
2386	94754	120	806	561	0	96241
2387	95431	139	406	378	0	96354
2388	2974	91542	381	498	0	95395
2389	91489	2226	303	388	0	94406
2390	2463	831	250	90296	0	93840
2391	869	393	311	91159	0	92732
2392	515	184	319	93118	0	94136
2393	434	185	89801	3173	0	93593
2394	478	242	2381	85103	0	88204
2395	485	88867	869	2542	0	92763
2396	85687	2111	436	1078	0	89312
2397	2245	88174	353	1101	0	91873
2398	1148	2328	86691	696	0	90863
2399	616	87368	2414	712	0	91110
2400	84318	2288	1158	613	0	88377
2401	2259	85581	812	686	0	89338
2402	988	2352	690	74003	0	78033
2403	598	85284	635	2145	0	88662
2404	85014	2280	575	924	0	88793
2405	86007	793	572	595	0	87967
2406	83605	495	687	551	0	85338
2407	3230	410	84005	515	0	88160
2408	1349	438	83537	516	0	85840
2409	874	380	83003	684	0	84941
2410	80964	410	3141	730	0	85245
2411	2619	508	1258	80572	0	84957
2412	1259	341	720	82361	0	84681
2413	835	419	80410	3064	0	84728
2414	690	463	2433	79830	0	83416
2415	76545	415	1031	2767	0	80758
2416	2677	77002	661	1315	0	81655
2417	78220	2291	553	792	0	81856
2418	2955	1077	76980	576	0	81588
2419	77220	718	2407	612	0	80957
2420	79106	631	1030	674	0	81441
2421	79460	614	635	717	0	81426
2422	3417	580	76554	739	0	81290
2423	1725	485	2338	76082	0	80630
2424	1299	379	77278	2497	0	81453
2425	1145	354	2575	76880	0	80954
2426	1079	422	77772	2605	0	81878
2427	952	407	2615	76022	0	79996
2428	866	347	1131	79027	0	81371
2429	77541	305	736	3198	0	81780
2430	78250	302	631	1495	0	80678
2431	79018	266	656	1044	0	80984
2432	3373	275	729	73412	0	77789
2433	1415	70380	696	2641	0	75132
2434	960	74835	572	1410	0	77777
2435	73706	2613	548	932	0	77799
2436	2909	1034	72737	680	0	77360
2437	72954	547	2461	624	0	76586
2438	2998	432	73082	652	0	77164
2439	74105	399	2505	777	0	77786
2440	74855	343	1127	746	0	77071
2441	3209	361	74427	769	0	78766
2442	74442	254	2461	913	0	78070
2443	75769	357	1180	778	0	78084
2444	75618	358	814	701	0	77491
2445	3317	75172	672	818	0	79979
2446	1637	2993	733	72443	0	77806
2447	1012	910	73263	2471	0	77656
2448	1003	500	73428	1185	0	76116
2449	847	66359	2562	825	0	70593
2450	622	49173	778	399	0	50972
2451	1028	1157	934	43704	0	46823
2452	42854	458	320	975	0	44607
2453	980	43855	232	642	0	45709
2454	639	900	209	42435	0	44183
2455	471	44162	178	901	0	45712
2456	42835	926	214	466	0	44441
2457	1070	480	226	42749	0	44525
2458	618	285	42164	911	0	43978
2459	450	41339	889	524	0	43202
2460	331	41738	494	331	0	42894
2461	364	1093	315	37737	0	39509
2462	318	40590	241	767	0	41916
2463	326	918	235	40183	0	41662
2464	40490	447	184	993	0	42114
2465	40885	297	167	506	0	41855
2466	41666	198	204	300	0	42368
2467	41847	187	215	239	0	42488
2468	1340	219	41349	222	0	43130
2469	656	39546	832	245	0	41279
2470	377	39529	458	234	0	40598
2471	156	32354	141	117	0	32768
2472	124	31987	168	119	0	32398
2473	30050	591	551	141	0	31333
2474	29444	147	111	126	0	29828
2475	29700	57	54	103	0	29914
2476	29784	38	56	92	0	29970
2477	519	56	28963	55	0	29593
2478	30509	41	346	104	0	31000
2479	31489	36	138	79	0	31742
2480	31646	43	66	74	0	31829
2481	510	45	34	31046	0	31635
2482	212	54	36	31563	0	31865
2483	31707	44	31	498	0	32280
2484	419	71	35	31116	0	31641
2485	185	31165	55	432	0	31837
2486	122	336	47	31766	0	32271
2487	99	143	51	31571	0	31864
2488	104	31763	45	473	0	32385
2489	103	340	47	31663	0	32153
2490	83	149	60	31957	0	32249
2491	31236	78	44	466	0	31824
2492	412	67	29924	186	0	30589
2493	29550	77	361	104	0	30092
2494	425	86	30271	71	0	30853
2495	218	75	29442	80	0	29815
2496	131	77	29932	63	0	30203
2497	28984	75	487	101	0	29647
2498	425	74	31136	78	0	31713
2499	30173	98	431	95	0	30797
2500	31274	57	158	100	0	31589
2501	31326	52	57	84	0	31519
2502	460	31181	57	88	0	31786
2503	31111	339	48	91	0	31589
2504	352	31735	55	87	0	32229
2505	205	367	44	31933	0	32549
2506	104	200	35	31836	0	32175
2507	71	31974	56	442	0	32543
2508	96	32290	40	228	0	32654
2509	117	33052	46	127	0	33342
2510	32422	431	40	83	0	32976
2511	382	33086	54	121	0	33643
2512	33256	365	47	72	0	33740
2513	426	192	32049	58	0	32725
2514	31948	98	348	75	0	32469
2515	33369	93	149	68	0	33679
2516	509	107	32264	55	0	32935
2517	240	86	340	31923	0	32589
2518	176	99	33235	364	0	33874
2519	153	69	334	32695	0	33251
2520	158	47	153	33410	0	33768
2521	33458	59	82	474	0	34073
2522	33332	73	66	209	0	33680
2523	509	33126	63	174	0	33872
2524	33651	361	66	97	0	34175
2525	454	191	32974	69	0	33688
2526	32801	96	358	113	0	33368
2527	485	97	34254	87	0	34923
2528	257	134	33918	78	0	34387
2529	34490	81	521	105	0	35197
2530	35957	75	198	88	0	36318
2531	619	91	36402	77	0	37189
2532	300	88	437	34398	0	35223
2533	178	80	182	36795	0	37235
2534	180	99	36169	549	0	36997
2535	163	88	440	34289	0	34980
2536	166	35264	207	477	0	36114
2537	193	452	90	36540	0	37275
2538	174	233	94	36638	0	37139
2539	196	139	35367	528	0	36230
2540	31682	88	452	279	0	32501
2541	34786	91	212	150	0	35239
2542	34458	66	121	130	0	34775
2543	34053	63	112	121	0	34349
2544	698	33353	115	154	0	34320
2545	369	375	101	32015	0	32860
2546	303	184	31766	442	0	32695
2547	248	117	31352	214	0	31931
2548	221	100	527	30220	0	31068
2549	176	90	31344	495	0	32105
2550	29943	54	460	269	0	30726
2551	477	93	188	31404	0	32162
2552	220	83	115	31739	0	32157
2553	152	76	104	31732	0	32064
2554	31035	80	96	590	0	31801
2555	463	30923	99	373	0	31858
2556	30914	381	104	207	0	31606
2557	30865	163	105	153	0	31286
2558	572	30327	140	138	0	31177
2559	267	30487	134	152	0	31040
2560	30958	428	155	110	0	31651
2561	487	152	169	30786	0	31594
2562	261	76	175	31052	0	31564
2563	32155	69	146	463	0	32833
2564	529	58	31966	180	0	32733
2565	31324	53	474	132	0	31983
2566	32099	70	178	100	0	32447
2567	593	33149	135	144	0	34021
2568	35588	387	89	87	0	36151
2569	35502	155	64	126	0	35847
2570	646	40144	92	156	0	41038
2571	186	41247	59	135	0	41627
2572	204	723	101	39881	0	40909
2573	40085	196	34	662	0	40977
2574	644	41413	50	246	0	42353
2575	180	720	43	42087	0	43030
2576	42403	154	41	788	0	43386
2577	834	101	42017	195	0	43147
2578	229	60	757	41527	0	42573
2579	147	61	42101	792	0	43101
2580	40066	37	870	242	0	41215
2581	42407	39	227	159	0	42832
2582	927	54	42044	124	0	43149
2583	246	41505	797	187	0	42735
2584	184	713	204	42063	0	43164
2585	146	173	42540	767	0	43626
2586	103	90	790	42009	0	42992
2587	100	66	202	43712	0	44080
2588	113	84	43028	953	0	44178
2589	39046	51	835	323	0	40255
2590	43063	55	213	180	0	43511
2591	996	80	43267	133	0	44476
2592	299	43442	820	238	0	44799
2593	196	843	225	40895	0	42159
2594	138	42760	130	772	0	43800
2595	110	44011	96	251	0	44468
2596	43168	948	133	180	0	44429
2597	848	259	64	43435	0	44606
2598	270	124	66	43387	0	43847
2599	185	111	43302	966	0	44564
2600	147	101	42896	305	0	43449
2601	152	62	970	41932	0	43116
2602	153	66	277	43528	0	44024
2603	165	124	42968	996	0	44253
2604	141	118	43137	313	0	43709
2605	131	119	1005	42391	0	43646
2606	42802	105	281	936	0	44124
2607	868	43223	192	380	0	44663
2608	42931	883	126	231	0	44171
2609	1012	43106	105	218	0	44441
2610	322	43963	141	213	0	44639
2611	42835	1045	142	180	0	44202
2612	993	318	43215	150	0	44676
2613	348	195	929	42781	0	44253
2614	255	141	283	44442	0	45121
2615	202	110	203	47601	0	48116
2616	218	137	47643	1250	0	49248
2617	191	118	1068	47615	0	48992
2618	48375	109	366	1210	0	50060
2619	1142	125	225	49527	0	51019
2620	354	127	164	52714	0	53359
2621	52237	121	186	1419	0	53963
2622	51195	150	151	468	0	51964
2623	1345	51362	167	489	0	53363
2624	458	1134	52295	263	0	54150
2625	347	301	51906	225	0	52779
2626	268	214	52245	253	0	52980
2627	172	49933	1467	317	0	51889
2628	326	1161	510	47935	0	49932
2629	247	324	260	49784	0	50615
2630	49054	173	234	1410	0	50871
2631	1165	177	206	48403	0	49951
2632	382	155	48210	1295	0	50042
2633	264	143	1212	47962	0	49581
2634	241	140	393	48628	0	49402
2635	283	168	47857	1462	0	49770
2636	198	47026	1247	666	0	49137
2637	249	1146	446	40278	0	42119
2638	205	46426	347	1167	0	48145
2639	253	1186	46576	452	0	48467
2640	45642	354	1267	343	0	47606
2641	47049	243	405	350	0	48047
2642	47213	212	333	331	0	48089
2643	1472	217	316	44450	0	46455
2644	490	46615	322	1266	0	48693
2645	46481	1178	278	470	0	48407
2646	47283	372	294	406	0	48355
2647	46639	255	257	406	0	47557
2648	1500	217	45986	369	0	48072
2649	44132	196	1224	345	0	45897
2650	1306	45554	413	423	0	47696
2651	44753	1130	357	325	0	46565
2652	1226	45462	318	419	0	47425
2653	45582	1216	294	412	0	47504
2654	1324	373	45743	367	0	47807
2655	45175	245	1261	336	0	47017
2656	46577	215	429	321	0	47542
2657	44604	190	315	314	0	45423
2658	46932	195	306	270	0	47703
2659	1584	207	45593	288	0	47672
2660	636	221	1205	44733	0	46795
2661	44544	206	415	1272	0	46437
2662	1306	44669	293	525	0	46793
2663	527	1170	219	43549	0	45465
2664	377	332	43247	1253	0	45209
2665	427	509	1221	42581	0	44738
2666	381	229	42959	1273	0	44842
2667	301	40766	1232	618	0	42917
2668	284	38181	466	374	0	39305
2669	340	37849	331	356	0	38876
2670	429	1076	368	32045	0	33918
2671	265	288	192	31978	0	32723
2672	274	195	31166	837	0	32472
2673	250	30266	677	358	0	31551
2674	28025	584	205	200	0	29014
2675	660	27452	172	171	0	28455
2676	253	27685	169	195	0	28302
2677	494	677	205	26423	0	27799
2678	26397	202	193	551	0	27343
2679	26605	161	147	241	0	27154
2680	679	130	148	26128	0	27085
2681	25879	136	115	643	0	26773
2682	612	121	133	25812	0	26678
2683	241	121	25464	653	0	26479
2684	25130	118	578	291	0	26117
2685	677	166	221	24979	0	26043
2686	228	141	24608	615	0	25592
2687	200	148	24417	250	0	25015
2688	193	233	606	24035	0	25067
2689	24522	160	227	600	0	25509
2690	24475	152	152	234	0	25013
2691	635	24246	151	219	0	25251
2692	24661	557	141	182	0	25541
2693	24736	196	151	168	0	25251
2694	24782	151	106	152	0	25191
2695	702	24876	108	191	0	25877
2696	24897	525	107	190	0	25719
2697	25380	155	110	162	0	25807
2698	750	117	96	24843	0	25806
2699	24026	93	115	547	0	24781
2700	607	23930	123	208	0	24868
2701	268	24561	116	189	0	25134
2702	253	561	132	24022	0	24968
2703	259	207	144	23796	0	24406
2704	212	24215	121	548	0	25096
2705	23789	519	109	161	0	24578
2706	601	23437	113	163	0	24314
2707	22917	459	96	122	0	23594
2708	582	23330	86	119	0	24117
2709	307	497	82	21594	0	22480
2710	284	23663	62	398	0	24407
2711	23647	505	271	145	0	24568
2712	23449	166	162	158	0	23935
2713	23152	163	100	134	0	23549
2714	581	143	21954	119	0	22797
2715	216	130	19360	97	0	19803
2716	137	18323	345	131	0	18936
2717	176	287	17791	99	0	18353
2718	137	165	16766	87	0	17155
2719	137	372	335	12893	0	13737
2720	55	49	13379	146	0	13629
2721	36	13249	124	87	0	13496
2722	13136	137	42	43	0	13358
2723	132	13076	29	37	0	13274
2724	48	13279	28	52	0	13407
2725	13526	154	19	61	0	13760
2726	13593	48	18	65	0	13724
2727	145	14087	16	44	0	14292
2728	14316	137	19	42	0	14514
2729	14272	48	22	34	0	14376
2730	14286	36	17	35	0	14374
2731	178	34	13887	31	0	14130
2732	69	45	13788	27	0	13929
2733	64	39	149	13954	0	14206
2734	49	22	42	14547	0	14660
2735	14542	22	34	170	0	14768
2736	160	14364	31	67	0	14622
2737	68	165	31	14737	0	15001
2738	54	55	22	14978	0	15109
2739	52	31	28	15141	0	15252
2740	53	35	26	15174	0	15288
2741	62	37	15117	214	0	15430
2742	66	32	15217	70	0	15385
2743	57	33	210	15327	0	15627
2744	60	42	15771	189	0	16062
2745	14903	34	212	80	0	15229
2746	239	22	65	15892	0	16218
2747	85	33	16010	197	0	16325
2748	14451	23	206	78	0	14758
2749	214	15818	60	57	0	16149
2750	15664	182	31	33	0	15910
2751	206	16360	26	62	0	16654
2752	77	188	26	16018	0	16309
2753	62	67	16285	176	0	16590
2754	63	30	185	15440	0	15718
2755	51	49	15634	207	0	15941
2756	15195	30	193	66	0	15484
2757	224	39	53	15996	0	16312
2758	16092	24	42	212	0	16370
2759	222	34	16047	70	0	16373
2760	16513	31	183	49	0	16776
2761	17890	13	71	42	0	18016
2762	281	27	18098	35	0	18441
2763	85	14	217	17818	0	18134
2764	38	17	18460	214	0	18729
2765	33	18436	219	72	0	18760
2766	18446	220	63	61	0	18790
2767	18426	48	62	37	0	18573
2768	267	27	18467	35	0	18796
2769	99	31	18546	20	0	18696
2770	42	20	242	18123	0	18427
2771	32	19	66	18889	0	19006
2772	18852	19	30	248	0	19149
2773	200	18976	42	79	0	19297
2774	19339	193	31	72	0	19635
2775	19392	58	28	37	0	19515
2776	258	28	18919	31	0	19236
2777	18304	14	209	37	0	18564
2778	240	23	19112	32	0	19407
2779	80	11	215	19212	0	19518
2780	52	22	20514	209	0	20797
2781	45	18	220	20169	0	20452
2782	52	30	20631	208	0	20921
2783	19866	14	201	81	0	20162
2784	20466	13	73	41	0	20593
2785	238	22	50	20422	0	20732
2786	20913	12	46	245	0	21216
2787	228	24	36	21159	0	21447
2788	79	21699	47	241	0	22066
2789	21657	175	34	81	0	21947
2790	206	21648	45	70	0	21969
2791	84	182	29	21864	0	22159
2792	51	51	47	21452	0	21601
2793	60	23	45	21388	0	21516
2794	59	21	32	21222	0	21334
2795	55	34	20603	247	0	20939
2796	18350	20	190	126	0	18686
2797	20160	27	68	62	0	20317
2798	240	20239	51	59	0	20589
2799	85	165	29	20311	0	20590
2800	61	53	46	20528	0	20688
2801	67	35	20056	228	0	20386
2802	19028	28	219	113	0	19388
2803	199	12	80	20009	0	20300
2804	89	38	19888	183	0	20198
2805	19511	22	186	129	0	19848
2806	20242	16	78	59	0	20395
2807	20276	19	49	72	0	20416
2808	249	26	19897	50	0	20222
2809	97	22	18906	43	0	19068
2810	18633	32	230	56	0	18951
2811	191	17	104	19239	0	19551
2812	94	20	31	19648	0	19793
2813	63	26	19614	208	0	19911
2814	18496	26	166	93	0	18781
2815	185	18	55	19888	0	20146
2816	20634	14	46	219	0	20913
2817	20758	11	32	89	0	20890
2818	20724	21	47	72	0	20864
2819	254	32	21414	55	0	21755
2820	84	35	183	21244	0	21546
2821	21553	12	88	224	0	21877
2822	198	22269	52	90	0	22609
2823	84	162	28	22421	0	22695
2824	54	49	28	22668	0	22799
2825	22270	19	27	239	0	22555
2826	21902	18	34	97	0	22051
2827	245	20	32	21767	0	22064
2828	111	27	21653	187	0	21978
2829	20924	20	204	86	0	21234
2830	223	33	22227	39	0	22522
2831	22289	9	185	56	0	22539
2832	22872	16	71	60	0	23019
2833	259	18	23092	35	0	23404
2834	107	67	214	22940	0	23328
2835	82	21	24508	239	0	24850
2836	64	26087	244	99	0	26494
2837	75	285	66	24667	0	25093
2838	51	26665	47	250	0	27013
2839	62	278	24	26882	0	27246
2840	67	60	27338	309	0	27774
2841	39	27606	293	142	0	28080
2842	47	28398	91	101	0	28637
2843	138	463	69	28170	0	28840
2844	28548	104	27	331	0	29010
2845	334	38	27	31268	0	31667
2846	31642	18	28	412	0	32100
2847	425	32388	42	173	0	33028
2848	35661	423	21	69	0	36174
2849	596	109	37505	51	0	38261
2850	144	37	518	36778	0	37477
2851	65	36	118	37018	0	37237
2852	84	41	37051	635	0	37811
2853	34607	29	534	169	0	35339
2854	36294	33	128	85	0	36540
2855	600	36883	51	106	0	37640
2856	203	556	49	33454	0	34262
2857	71	36296	57	492	0	36916
2858	81	520	36540	136	0	37277
2859	87	136	36897	69	0	37189
2860	114	305	639	35089	0	36147
2861	35176	33	151	524	0	35884
2862	484	34711	59	208	0	35462
2863	34839	482	46	67	0	35434
2864	575	123	34283	58	0	35039
2865	34206	54	493	80	0	34833
2866	35599	44	117	58	0	35818
2867	662	41	35161	48	0	35912
2868	171	41	515	34085	0	34812
2869	35260	37	130	551	0	35978
2870	35432	36	68	156	0	35692
2871	35396	44	54	78	0	35572
2872	648	45	52	34711	0	35456
2873	195	59	34640	534	0	35428
2874	33595	45	553	181	0	34374
2875	591	71	35457	95	0	36214
2876	204	44	559	34910	0	35717
2877	122	64	161	34184	0	34531
2878	107	35224	96	682	0	36109
2879	154	512	35243	181	0	36090
2880	101	33982	574	119	0	34776
2881	162	34544	165	149	0	35020
2882	118	695	130	34078	0	35021
2883	143	160	34248	576	0	35127
2884	124	81	559	33765	0	34529
2885	152	73	34486	589	0	35300
2886	113	81	578	33717	0	34489
2887	127	69	183	33998	0	34377
2888	147	91	32895	672	0	33805
2889	119	56	605	32107	0	32887
2890	127	82	33227	632	0	34068
2891	149	80	32876	236	0	33341
2892	134	32642	681	183	0	33640
2893	32849	560	215	137	0	33761
2894	660	177	32904	114	0	33855
2895	30487	133	621	147	0	31388
2896	644	96	215	32883	0	33838
2897	256	115	32791	616	0	33778
2898	152	32599	651	338	0	33740
2899	146	584	239	32726	0	33695
2900	181	214	32876	627	0	33898
2901	176	173	632	30541	0	31522
2902	157	32757	250	606	0	33770
2903	33086	590	188	227	0	34091
2904	652	215	147	33295	0	34309
2905	33365	138	147	681	0	34331
2906	33719	112	171	269	0	34271
2907	34024	119	142	228	0	34513
2908	34024	100	156	222	0	34502
2909	33316	117	179	186	0	33798
2910	754	32606	153	261	0	33774
2911	321	590	173	32802	0	33886
2912	211	201	192	33293	0	33897
2913	253	109	151	33327	0	33840
2914	259	127	32323	765	0	33474
2915	212	31995	668	354	0	33229
2916	33210	613	253	212	0	34288
2917	33536	231	223	198	0	34188
2918	811	33148	241	240	0	34440
2919	291	33478	204	261	0	34234
2920	32786	731	197	210	0	33924
2921	754	237	32229	198	0	33418
2922	338	195	701	31151	0	32385
2923	31692	142	339	717	0	32890
2924	735	132	193	30703	0	31763
2925	265	31435	203	691	0	32594
2926	212	659	184	31661	0	32716
2927	207	186	31654	733	0	32780
2928	30438	139	715	281	0	31573
2929	32325	120	246	219	0	32910
2930	882	115	174	31077	0	32248
2931	415	108	157	31563	0	32243
2932	30296	108	178	783	0	31365
2933	737	30339	191	297	0	31564
2934	368	566	158	29586	0	30678
2935	356	189	148	29662	0	30355
2936	27091	72	149	719	0	28031
2937	621	27886	114	339	0	28960
2938	27439	477	125	178	0	28219
2939	620	27419	131	215	0	28385
2940	230	27877	115	200	0	28422
2941	26832	543	158	149	0	27682
2942	540	27171	132	158	0	28001
2943	265	945	315	25917	0	27442
2944	148	157	25927	562	0	26794
2945	110	82	22827	143	0	23162
2946	83	78	22355	94	0	22610
2947	69	21736	452	80	0	22337
2948	17999	280	423	63	0	18765
2949	256	80	47	16765	0	17148
2950	75	31	34	17271	0	17411
2951	55	31	16910	295	0	17291
2952	15953	37	253	104	0	16347
2953	268	26	70	17360	0	17724
2954	89	27	32	17573	0	17721
2955	41	23	33	17431	0	17528
2956	16695	29	41	324	0	17089
2957	265	42	16479	104	0	16890
2958	16111	43	252	63	0	16469
2959	275	52	74	16561	0	16962
2960	134	31	16563	269	0	16997
2961	15712	37	257	112	0	16118
2962	309	44	16595	55	0	17003
2963	131	75	250	15880	0	16336
2964	68	52	16583	274	0	16977
2965	83	32	16069	110	0	16294
2966	14801	39	343	66	0	15249
2967	276	36	15803	64	0	16179
2968	108	31	280	15307	0	15726
2969	15507	42	114	268	0	15931
2970	271	33	72	15496	0	15872
2971	111	38	15472	275	0	15896
2972	79	49	15664	110	0	15902
2973	67	15521	307	71	0	15966
2974	71	254	88	15319	0	15732
2975	14851	74	61	283	0	15269
2976	264	14629	65	133	0	15091
2977	14762	249	75	79	0	15165
2978	274	93	49	14619	0	15035
2979	14485	51	60	287	0	14883
2980	306	14395	52	139	0	14892
2981	128	247	67	14303	0	14745
2982	14421	86	80	267	0	14854
2983	285	14488	58	125	0	14956
2984	116	261	82	14493	0	14952
2985	88	80	62	14482	0	14712
2986	14513	41	74	316	0	14944
2987	281	43	77	14559	0	14960
2988	130	27	69	14818	0	15044
2989	86	28	101	15042	0	15257
2990	92	34	14403	357	0	14886
2991	13866	31	297	161	0	14355
2992	302	35	118	17213	0	17668
2993	136	31	18347	372	0	18886
2994	17772	28	403	182	0	18385
2995	411	46	18884	115	0	19456
2996	150	21	424	18010	0	18605
2997	94	18526	165	393	0	19178
2998	93	363	94	18948	0	19498
2999	100	98	18933	444	0	19575
3000	110	76	19421	163	0	19770
3001	105	73	469	19247	0	19894
3002	94	58	19259	448	0	19859
3003	18223	40	429	198	0	18890
3004	444	57	18960	104	0	19565
3005	140	74	427	18181	0	18822
3006	108	48	139	18788	0	19083
3007	80	67	89	18636	0	18872
3008	18378	53	66	551	0	19048
3009	18543	56	90	216	0	18905
3010	18738	40	79	159	0	19016
3011	524	54	64	18419	0	19061
3012	168	52	76	18790	0	19086
3013	130	37	18196	541	0	18904
3014	114	36	18368	207	0	18725
3015	103	18207	508	142	0	18960
3016	161	383	168	15926	0	16638
3017	88	83	90	15037	0	15298
3018	79	15992	75	367	0	16513
3019	15889	297	85	143	0	16414
3020	314	16048	73	134	0	16569
3021	15983	320	71	95	0	16469
3022	341	137	82	15804	0	16364
3023	15980	33	88	364	0	16465
3024	342	38	96	16015	0	16491
3025	129	43	15786	362	0	16320
3026	73	25	362	15897	0	16357
3027	15681	26	122	378	0	16207
3028	347	37	77	15809	0	16270
3029	121	28	74	15912	0	16135
3030	102	30	15766	430	0	16328
3031	83	21	347	15854	0	16305
3032	78	24	113	15609	0	15824
3033	81	15655	68	445	0	16249
3034	91	281	64	15830	0	16266
3035	100	80	75	16142	0	16397
3036	150	41	60	15835	0	16086
3037	43	15009	59	433	0	15544
3038	78	252	52	14291	0	14673
3039	13552	66	47	320	0	13985
3040	271	13478	42	146	0	13937
3041	59	12920	41	81	0	13101
3042	45	12648	29	76	0	12798
3043	44	357	66	11304	0	11771
3044	67	11888	70	241	0	12266
3045	49	12110	114	107	0	12380
3046	11930	216	99	69	0	12314
3047	229	70	11632	81	0	12012
3048	11388	39	259	97	0	11783
3049	220	42	106	11721	0	12089
3050	50	38	11782	271	0	12141
3051	11342	30	286	138	0	11796
3052	237	32	11540	102	0	11911
3053	99	23	11467	97	0	11686
3054	11620	20	330	103	0	12073
3055	244	22	147	11820	0	12233
3056	98	18	11983	329	0	12428
3057	11922	16	279	190	0	12407
3058	12312	26	97	157	0	12592
3059	343	22	12288	143	0	12796
3060	12380	21	247	137	0	12785
3061	12718	19	112	140	0	12989
3062	322	16	12309	155	0	12802
3063	12275	32	282	132	0	12721
3064	12525	29	117	150	0	12821
3065	289	49	12340	128	0	12806
3066	107	64	13072	128	0	13371
3067	88	60	292	12967	0	13407
3068	65	74	13210	321	0	13670
3069	12977	65	264	157	0	13463
3070	281	94	75	13113	0	13563
3071	146	75	50	13375	0	13646
3072	114	75	13024	340	0	13553
3073	124	75	242	12771	0	13212
3074	106	48	12959	360	0	13473
3075	12932	49	272	172	0	13425
3076	13235	45	82	156	0	13518
3077	335	42	13127	131	0	13635
3078	12973	43	260	144	0	13420
3079	13399	34	73	169	0	13675
3080	317	24	13387	169	0	13897
3081	13419	37	261	191	0	13908
3082	13797	30	104	188	0	14119
3083	290	58	13595	163	0	14106
3084	13229	46	241	201	0	13717
3085	273	63	13852	184	0	14372
3086	84	65	249	13655	0	14053
3087	75	78	55	13837	0	14045
3088	62	67	46	14000	0	14175
3089	79	70	13587	394	0	14130
3090	12274	90	242	189	0	12795
3091	275	92	12962	141	0	13470
3092	57	10303	157	94	0	10611
3093	32	9509	54	61	0	9656
3094	8626	112	120	45	0	8903
3095	119	38	45	8685	0	8887
3096	31	8957	20	133	0	9141
3097	8638	81	21	38	0	8778
3098	8440	14	15	33	0	8502
3099	101	8865	14	38	0	9018
3100	40	85	23	8025	0	8173
3101	29	8465	18	89	0	8601
3102	8577	87	24	25	0	8713
3103	8631	19	21	24	0	8695
3104	103	23	17	8417	0	8560
3105	8479	13	18	89	0	8599
3106	90	10	25	8465	0	8590
3107	38	20	8377	85	0	8520
3108	8150	10	93	32	0	8285
3109	107	17	8509	21	0	8654
3110	33	13	86	8178	0	8310
3111	8346	9	31	92	0	8478
3112	93	13	27	8390	0	8523
3113	49	6	8454	80	0	8589
3114	29	12	8143	23	0	8207
3115	34	39	84	8077	0	8234
3116	8227	12	24	90	0	8353
3117	83	8353	31	32	0	8499
3118	34	74	21	8330	0	8459
3119	33	22	8365	62	0	8482
3120	8071	10	84	36	0	8201
3121	8593	27	20	28	0	8668
3122	96	20	8554	11	0	8681
3123	8295	6	69	27	0	8397
3124	92	9	24	8754	0	8879
3125	37	18	8715	68	0	8838
3126	8487	5	81	26	0	8599
3127	92	20	27	8590	0	8729
3128	39	10	18	8404	0	8471
3129	8511	9	13	88	0	8621
3130	75	8306	26	34	0	8441
3131	33	8383	18	22	0	8456
3132	8360	67	19	22	0	8468
3133	7853	18	21	22	0	7914
3134	100	9	8346	10	0	8465
3135	25	10	8027	24	0	8086
3136	18	12	88	8003	0	8121
3137	8404	4	31	61	0	8500
3138	8281	3	11	35	0	8330
3139	8343	3	9	24	0	8379
3140	68	8343	15	23	0	8449
3141	25	8514	9	26	0	8574
3142	21	63	21	8816	0	8921
3143	37	20	16	8802	0	8875
3144	34	12	13	9119	0	9178
3145	20	14	9206	79	0	9319
3146	30	13	8303	33	0	8379
3147	8772	7	87	30	0	8896
3148	9278	4	34	22	0	9338
3149	107	4	19	9223	0	9353
3150	45	10	13	9119	0	9187
3151	30	12	15	9437	0	9494
3152	36	21	9131	85	0	9273
3153	22	19	8958	36	0	9035
3154	19	13	74	9086	0	9192
3155	40	9	9330	91	0	9470
3156	20	9068	82	47	0	9217
3157	15	9243	40	21	0	9319
3158	9054	78	24	18	0	9174
3159	83	9028	13	30	0	9154
3160	53	66	10	9034	0	9163
3161	29	30	9	9087	0	9155
3162	38	9527	11	115	0	9691
3163	21	95	16	9698	0	9830
3164	51	47	9347	105	0	9550
3165	22	9557	94	70	0	9743
3166	15	76	33	8948	0	9072
3167	26	46	8914	87	0	9073
3168	15	8756	80	55	0	8906
3169	28	81	44	8455	0	8608
3170	25	8885	15	68	0	8993
3171	24	70	10	8848	0	8952
3172	21	37	11	8442	0	8511
3173	17	8730	17	95	0	8859
3174	8357	65	22	42	0	8486
3175	8157	41	28	25	0	8251
3176	93	8513	21	39	0	8666
3177	45	8672	20	31	0	8768
3178	22	110	20	8498	0	8650
3179	23	46	8445	72	0	8586
3180	7909	31	72	44	0	8056
3181	8144	16	32	30	0	8222
3182	96	15	8138	32	0	8281
3183	7831	16	74	29	0	7950
3184	8179	21	31	31	0	8262
3185	106	23	7904	21	0	8054
3186	7548	11	76	28	0	7663
3187	92	17	8232	27	0	8368
3188	35	8275	74	29	0	8413
3189	8339	71	40	26	0	8476
3190	8310	35	16	35	0	8396
3191	103	14	8286	21	0	8424
3192	8268	18	75	22	0	8383
3193	8475	23	33	52	0	8583
3194	99	17	8448	30	0	8594
3195	8398	24	74	22	0	8518
3196	8761	23	32	35	0	8851
3197	114	18	8629	26	0	8787
3198	8658	27	69	28	0	8782
3199	74	25	38	8473	0	8610
3200	37	26	23	8524	0	8610
3201	28	29	8530	99	0	8686
3202	36	14	8446	57	0	8553
3203	27	16	100	8554	0	8697
3204	29	35	40	8656	0	8760
3205	9201	15	23	101	0	9340
3206	104	20	9095	37	0	9256
3207	9152	18	89	26	0	9285
3208	108	24	42	9489	0	9663
3209	49	18	9524	98	0	9689
3210	9976	16	101	80	0	10173
3211	111	17	50	10650	0	10828
3212	60	15	10853	99	0	11027
3213	10487	16	125	47	0	10675
3214	155	8	44	10839	0	11046
3215	10902	5	30	123	0	11060
3216	125	26	11432	40	0	11623
3217	67	16	121	10591	0	10795
3218	32	11905	51	117	0	12105
3219	12061	118	29	66	0	12274
3220	11879	27	17	31	0	11954
3221	157	12312	33	51	0	12553
3222	12436	120	43	42	0	12641
3223	12381	37	20	23	0	12461
3224	12233	20	22	21	0	12296
3225	173	12207	39	27	0	12446
3226	70	123	12	12329	0	12534
3227	37	43	12428	149	0	12657
3228	34	17	132	12209	0	12392
3229	41	14	45	12520	0	12620
3230	27	15	12515	177	0	12734
3231	43	17	12302	65	0	12427
3232	54	14	167	11394	0	11629
3233	36	12533	57	123	0	12749
3234	12549	119	47	61	0	12776
3235	12342	38	28	31	0	12439
3236	165	12813	20	33	0	13031
3237	12813	133	28	44	0	13018
3238	12722	36	22	32	0	12812
3239	168	13	12836	31	0	13048
3240	12101	18	134	38	0	12291
3241	160	12836	42	56	0	13094
3242	70	115	12555	29	0	12769
3243	60	41	12321	19	0	12441
3244	32	12269	144	58	0	12503
3245	12098	112	55	27	0	12292
3246	152	38	12171	15	0	12376
3247	58	19	118	11917	0	12112
3248	37	21	12320	134	0	12512
3249	11399	25	129	45	0	11598
3250	154	24	14020	40	0	14238
3251	71	23	13858	41	0	13993
3252	13404	30	156	34	0	13624
3253	142	14358	51	30	0	14581
3254	14543	125	32	45	0	14745
3255	14718	37	42	65	0	14862
3256	168	24	23	14433	0	14648
3257	54	15884	27	129	0	16094
3258	15980	114	29	73	0	16196
3259	150	54	16147	20	0	16371
3260	15384	25	140	36	0	15585
3261	135	16203	56	31	0	16425
3262	15753	111	24	28	0	15916
3263	15667	28	27	30	0	15752
3264	146	15929	30	33	0	16138
3265	80	112	20	15847	0	16059
3266	15917	27	28	108	0	16080
3267	116	15845	41	43	0	16045
3268	56	120	30	15904	0	16110
3269	16219	26	28	135	0	16408
3270	121	25	28	16945	0	17119
3271	51	24	39	16737	0	16851
3272	39	17048	44	142	0	17273
3273	16962	119	29	64	0	17174
3274	17326	39	33	59	0	17457
3275	17458	22	40	45	0	17565
3276	168	18074	36	46	0	18324
3277	18280	137	30	43	0	18490
3278	18329	37	22	41	0	18429
3279	176	33	36	18013	0	18258
3280	73	34	33	18257	0	18397
3281	119	35	18173	160	0	18487
3282	61	36	139	17820	0	18056
3283	68	32	45	18101	0	18246
3284	68	30	18213	158	0	18469
3285	15452	35	161	98	0	15746
3286	178	41	18219	39	0	18477
3287	97	48	18516	39	0	18700
3288	63	57	154	18303	0	18577
3289	70	27	49	18557	0	18703
3290	52	19063	65	160	0	19340
3291	19153	133	29	55	0	19370
3292	18570	45	34	40	0	18689
3293	175	19056	27	52	0	19310
3294	86	20345	30	69	0	20530
3295	76	204	28	19684	0	19992
3296	53	21081	39	173	0	21346
3297	21114	211	34	54	0	21413
3298	21042	54	25	48	0	21169
3299	260	50	24	20734	0	21068
3300	88	32	33	21154	0	21307
3301	21055	24	22	244	0	21345
3302	256	39	20435	67	0	20797
3303	20336	29	216	60	0	20641
3304	285	28	20467	41	0	20821
3305	19938	33	210	39	0	20220
3306	239	47	49	20372	0	20707
3307	82	32	20934	202	0	21250
3308	75	22	20321	70	0	20488
3309	19746	97	283	53	0	20179
3310	20063	35	89	70	0	20257
3311	220	20797	37	57	0	21111
3312	68	165	21	21508	0	21762
3313	38	81	22	22060	0	22201
3314	21838	29	17	263	0	22147
3315	235	21794	26	109	0	22164
3316	21246	211	12	69	0	21538
3317	219	21194	17	47	0	21477
3318	53	20947	15	40	0	21055
3319	20893	219	15	36	0	21163
3320	233	56	20392	24	0	20705
3321	67	33	194	20018	0	20312
3322	34	20	51	20498	0	20603
3323	47	17	20490	247	0	20801
3324	18	20	192	19955	0	20185
3325	33	26	39	19303	0	19401
3326	22	20379	21	235	0	20657
3327	20257	197	26	74	0	20554
3328	233	61	20347	40	0	20681
3329	19028	18	199	39	0	19284
3330	208	20330	46	55	0	20639
3331	58	197	24	20499	0	20778
3332	21186	43	19	271	0	21519
3333	220	23	22	21206	0	21471
3334	65	27	17	21364	0	21473
3335	55	26	21245	257	0	21583
3336	19469	16	213	88	0	19786
3337	21008	18	49	70	0	21145
3338	270	25	21082	43	0	21420
3339	89	28	209	20695	0	21021
3340	74	22	21134	219	0	21449
3341	20389	15	233	89	0	20726
3342	21698	22	58	63	0	21841
3343	257	15	29	21550	0	21851
3344	21545	15	32	226	0	21818
3345	250	29	22941	82	0	23302
3346	76	24	208	22795	0	23103
3347	60	20	63	23324	0	23467
3348	39	27	30	23634	0	23730
3349	37	26	15	23656	0	23734
3350	21656	26	14	276	0	21972
3351	235	28	21235	90	0	21588
3352	78	18	199	21363	0	21658
3353	66	22	21156	240	0	21484
3354	48	30	20692	93	0	20863
3355	28	23	244	20551	0	20846
3356	47	15	67	21078	0	21207
3357	19974	19	31	260	0	20284
3358	235	26	25	20054	0	20340
3359	93	24	26	20228	0	20371
3360	46	31	33	20428	0	20538
3361	20280	27	21	308	0	20636
3362	20251	19	26	104	0	20400
3363	20405	22	31	61	0	20519
3364	20296	25	25	60	0	20406
3365	283	21766	36	66	0	22151
3366	97	266	26	21883	0	22272
3367	54	71	30	22246	0	22401
3368	22746	36	32	369	0	23183
3369	320	24019	45	177	0	24561
3370	107	347	24	25269	0	25747
3371	80	83	27189	392	0	27744
3372	28483	36	474	152	0	29145
3373	542	30885	113	107	0	31647
3374	32275	545	56	56	0	32932
3375	33099	112	38	52	0	33301
3376	767	44	27	32618	0	33456
3377	217	35	32838	680	0	33770
3378	85	23	617	33474	0	34199
3379	33827	17	140	738	0	34722
3380	675	13	56	33721	0	34465
3381	33758	22	30	703	0	34513
3382	702	33418	48	224	0	34392
3383	34779	632	30	147	0	35588
3384	763	140	36	34905	0	35844
3385	192	65	47	36694	0	36998
3386	37521	33	47	825	0	38426
3387	37263	20	38	231	0	37552
3388	37485	23	28	104	0	37640
3389	37315	24	27	101	0	37467
3390	37208	31	33	66	0	37338
3391	883	27	35	36373	0	37318
3392	262	37	35913	721	0	36933
3393	118	35642	653	267	0	36680
3394	34676	614	191	155	0	35636
3395	713	133	34001	76	0	34923
3396	32996	63	619	95	0	33773
3397	690	33653	179	102	0	34624
3398	34190	593	87	98	0	34968
3399	723	147	41	34057	0	34968
3400	245	80	52	34587	0	34964
3401	217	46	34356	775	0	35394
3402	146	44	609	33768	0	34567
3403	150	49	35044	705	0	35948
3404	177	58	34642	242	0	35119
3405	34756	61	723	181	0	35721
3406	36203	64	195	155	0	36617
3407	877	59	34977	157	0	36070
3408	34192	66	616	162	0	35036
3409	35311	63	174	162	0	35710
3410	910	55	34593	168	0	35726
3411	325	34207	603	189	0	35324
3412	424	630	177	35226	0	36457
3413	36255	151	87	708	0	37201
3414	37160	88	69	277	0	37594
3415	37203	69	88	191	0	37551
3416	37030	68	76	158	0	37332
3417	36815	81	141	150	0	37187
3418	938	81	36157	138	0	37314
3419	455	120	36732	118	0	37425
3420	367	136	654	36691	0	37848
3421	37682	104	235	705	0	38726
3422	37989	106	133	293	0	38521
3423	38172	87	121	262	0	38642
3424	37506	61	134	262	0	37963
3425	884	37321	155	275	0	38635
3426	413	39373	140	293	0	40219
3427	39517	636	151	256	0	40560
3428	39773	199	144	290	0	40406
3429	927	39541	170	277	0	40915
3430	40157	596	146	239	0	41138
3431	959	181	39788	239	0	41167
3432	487	120	626	39196	0	40429
3433	509	105	39949	701	0	41264
3434	487	113	39770	290	0	40660
3435	465	101	702	39648	0	40916
3436	461	95	269	41155	0	41980
3437	514	112	41541	773	0	42940
3438	462	85	654	40065	0	41266
3439	426	108	264	41900	0	42698
3440	41338	117	213	764	0	42432
3441	41602	117	190	306	0	42215
3442	1048	106	210	41344	0	42708
3443	552	140	41512	723	0	42927
3444	463	41317	700	457	0	42937
3445	40729	612	313	296	0	41950
3446	980	180	42493	252	0	43905
3447	472	41771	716	257	0	43216
3448	437	43544	295	282	0	44558
3449	43705	639	275	229	0	44848
3450	44126	185	222	217	0	44750
3451	966	152	252	43352	0	44722
3452	563	136	45980	685	0	47364
3453	500	92	749	45917	0	47258
3454	443	97	325	46820	0	47685
3455	432	128	271	47123	0	47954
3456	46421	103	224	837	0	47585
3457	922	45784	267	342	0	47315
3458	442	48310	257	292	0	49301
3459	438	742	209	47430	0	48819
3460	416	230	216	48707	0	49569
3461	48167	153	212	858	0	49390
3462	46697	118	211	351	0	47377
3463	47939	89	193	259	0	48480
3464	1059	47329	240	283	0	48911
3465	46276	559	202	222	0	47259
3466	873	326	240	45644	0	47083
3467	513	113	45270	668	0	46564
3468	472	124	42273	278	0	43147
3469	40792	122	657	239	0	41810
3470	685	88	40917	146	0	41836
3471	337	108	37865	146	0	38456
3472	33719	65	362	123	0	34269
3473	353	53	34713	99	0	35218
3474	147	61	33624	70	0	33902
3475	138	254	211	31440	0	32043
3476	101	59	34162	137	0	34459
3477	70	54	129	32372	0	32625
3478	64	58	60	33470	0	33652
3479	105	62	34486	163	0	34816
3480	54	34816	125	104	0	35099
3481	34798	98	116	103	0	35115
3482	171	48	35938	57	0	36214
3483	70	52	35310	53	0	35485
3484	28812	55	191	86	0	29144
3485	183	35	33964	33	0	34215
3486	50	33203	114	73	0	33440
3487	50	33442	87	90	0	33669
3488	56	127	69	34162	0	34414
3489	34	58	37	34078	0	34207
3490	35067	18	30	215	0	35330
3491	34622	24	33	94	0	34773
3492	34938	24	29	69	0	35060
3493	139	25	38	34880	0	35082
3494	35317	25	33	158	0	35533
3495	34533	30	64	77	0	34704
3496	170	28	35362	47	0	35607
3497	83	38	34226	42	0	34389
3498	50	35596	153	85	0	35884
3499	39	111	48	35942	0	36140
3500	36103	41	45	144	0	36333
3501	106	35497	45	119	0	35767
3502	54	116	30	36097	0	36297
3503	35733	43	34	156	0	35966
3504	34921	23	34	70	0	35048
3505	136	35687	34	101	0	35958
3506	35398	117	24	78	0	35617
3507	35319	53	37	96	0	35505
3508	184	25	32	35289	0	35530
3509	98	72	35889	145	0	36204
3510	48	35327	130	150	0	35655
3511	53	35736	59	102	0	35950
3512	34263	131	31	64	0	34489
3513	143	62	40	33850	0	34095
3514	104	49	34120	133	0	34406
3515	40	34164	112	135	0	34451
3516	34050	120	44	82	0	34296
3517	34328	38	36	47	0	34449
3518	193	73	35017	58	0	35341
3519	91	38	129	33359	0	33617
3520	64	39	51	36016	0	36170
3521	72	46	39920	187	0	40225
3522	39338	28	304	118	0	39788
3523	50026	32	91	80	0	50229
3524	685	38	65	57567	0	58355
3525	179	59490	69	986	0	60724
3526	128	971	46	62536	0	63681
3527	104	282	62253	1158	0	63797
3528	59855	118	1106	343	0	61422
3529	1145	91	276	63556	0	65068
3530	375	71	63630	1128	0	65204
3531	59392	52	1147	361	0	60952
3532	1154	55	286	62920	0	64415
3533	342	43	146	63464	0	63995
3534	62153	43	106	1377	0	63679
3535	1127	62769	123	502	0	64521
3536	62423	1082	90	210	0	63805
3537	1288	278	60	62010	0	63636
3538	61832	132	107	1219	0	63290
3539	1312	105	61502	407	0	63326
3540	418	61703	1137	323	0	63581
3541	216	1147	320	62524	0	64207
3542	62468	333	169	1226	0	64196
3543	1210	62535	153	517	0	64415
3544	441	1206	138	63115	0	64900
3545	63416	315	109	1324	0	65164
3546	62346	159	158	502	0	63165
3547	1636	117	122	60965	0	62840
3548	617	110	60807	1415	0	62949
3549	350	141	60564	586	0	61641
3550	58958	122	1539	400	0	61019
3551	1405	60232	443	378	0	62458
3552	523	59719	251	309	0	60802
3553	57640	1439	223	280	0	59582
3554	1386	59527	182	386	0	61481
3555	573	1335	189	58979	0	61076
3556	405	438	182	60843	0	61868
3557	59748	287	170	1653	0	61858
3558	58796	211	168	699	0	59874
3559	58963	198	137	410	0	59708
3560	1806	262	56977	358	0	59403
3561	766	202	1230	56839	0	59037
3562	566	172	57564	1454	0	59756
3563	476	178	57453	618	0	58725
3564	468	166	58798	421	0	59853
3565	363	183	1754	56223	0	58523
3566	413	215	58343	1425	0	60396
3567	462	231	59093	552	0	60338
3568	362	294	1655	57038	0	59349
3569	58035	233	606	1459	0	60333
3570	1585	248	58542	621	0	60996
3571	659	238	1411	56775	0	59083
3572	473	211	498	59666	0	60848
3573	437	227	59537	1765	0	61966
3574	440	199	1422	58088	0	60149
3575	541	212	60044	1592	0	62389
3576	450	224	1507	57923	0	60104
3577	397	234	579	59277	0	60487
3578	406	206	412	59451	0	60475
3579	382	219	406	59212	0	60219
3580	56805	184	427	1954	0	59370
3581	57333	182	425	828	0	58768
3582	1814	211	56658	574	0	59257
3583	759	55345	1596	799	0	58499
3584	573	1270	56935	456	0	59234
3585	479	408	57184	508	0	58579
3586	54321	221	1860	470	0	56872
3587	1474	56465	825	612	0	59376
3588	56641	1324	591	509	0	59065
3589	1567	57565	569	522	0	60223
3590	57198	1426	535	457	0	59616
3591	58668	454	495	547	0	60164
3592	1865	284	515	56432	0	59096
3593	665	57495	472	1780	0	60412
3594	480	1330	417	57976	0	60203
3595	422	447	407	59452	0	60728
3596	464	274	58137	2060	0	60935
3597	457	58022	1603	1008	0	61090
3598	449	1376	695	58079	0	60599
3599	57926	442	569	1760	0	60697
3600	60147	264	504	800	0	61715
3601	60533	171	533	588	0	61825
3602	1925	59534	459	643	0	62561
3603	60247	1493	422	524	0	62686
3604	1746	63755	387	622	0	66510
3605	808	1725	396	65222	0	68151
3606	631	606	65064	1853	0	68154
3607	558	328	1781	62869	0	65536
3608	459	65099	733	1907	0	68198
3609	448	1675	456	64629	0	67208
3610	451	640	396	64793	0	66280
3611	398	65549	405	2256	0	68608
3612	65516	1751	381	894	0	68542
3613	1857	674	355	65263	0	68149
3614	775	422	64548	1976	0	67721
3615	561	306	1794	64368	0	67029
3616	531	284	668	66536	0	68019
3617	513	290	65779	2306	0	68888
3618	529	406	1788	60235	0	62958
3619	443	64270	671	2137	0	67521
3620	603	1779	64164	800	0	67346
3621	951	644	61034	551	0	63180
3622	323	57429	1938	600	0	60290
3623	232	50592	688	422	0	51934
3624	194	42226	337	281	0	43038
3625	38614	1010	979	212	0	40815
3626	36827	240	190	142	0	37399
3627	36478	118	82	135	0	36813
3628	838	87	94	35924	0	36943
3629	295	79	35526	723	0	36623
3630	127	97	687	34995	0	35906
3631	128	102	224	35742	0	36196
3632	35377	101	146	856	0	36480
3633	35399	80	88	325	0	35892
3634	813	35417	118	237	0	36585
3635	35419	682	78	158	0	36337
3636	35767	202	82	175	0	36226
3637	36091	144	105	172	0	36512
3638	918	111	35154	155	0	36338
3639	302	105	35046	150	0	35603
3640	173	143	803	34033	0	35152
3641	158	109	34642	710	0	35619
3642	32700	110	689	255	0	33754
3643	34018	106	235	199	0	34558
3644	789	106	33093	99	0	34087
3645	31644	101	568	116	0	32429
3646	652	32549	221	158	0	33580
3647	32744	600	146	122	0	33612
3648	685	193	98	32264	0	33240
3649	270	139	65	31062	0	31536
3650	163	32286	76	710	0	33235
3651	32113	591	78	241	0	33023
3652	32153	217	76	146	0	32592
3653	736	32115	108	138	0	33097
3654	308	596	86	30830	0	31820
3655	196	215	94	30756	0	31261
3656	142	31042	118	756	0	32058
3657	166	618	93	30802	0	31679
3658	168	239	113	31545	0	32065
3659	30787	150	123	773	0	31833
3660	30845	134	109	315	0	31403
3661	806	174	30586	212	0	31778
3662	29919	123	628	190	0	30860
3663	724	159	30552	178	0	31613
3664	336	172	625	29634	0	30767
3665	233	130	29903	707	0	30973
3666	182	29435	641	371	0	30629
3667	221	608	293	28897	0	30019
3668	216	217	153	29625	0	30211
3669	29000	152	132	743	0	30027
3670	670	113	100	28705	0	29588
3671	331	139	28376	667	0	29513
3672	27757	131	611	277	0	28776
3673	28314	127	297	198	0	28936
3674	28690	152	158	171	0	29171
3675	28333	156	114	173	0	28776
3676	800	155	137	29344	0	30436
3677	361	128	123	30657	0	31269
3678	300	129	117	32325	0	32871
3679	271	138	111	32861	0	33381
3680	31980	114	161	967	0	33222
3681	32267	91	152	363	0	32873
3682	997	104	141	28481	0	29723
3683	381	30653	137	830	0	32001
3684	30828	683	190	313	0	32014
3685	909	269	30582	239	0	31999
3686	351	30931	736	230	0	32248
3687	28975	679	275	184	0	30113
3688	784	29793	168	191	0	30936
3689	414	718	29617	135	0	30884
3690	29463	238	701	140	0	30542
3691	29677	143	253	133	0	30206
3692	971	132	28934	146	0	30183
3693	426	110	701	29127	0	30364
3694	320	69	246	28958	0	29593
3695	256	29336	154	905	0	30651
3696	255	676	151	29144	0	30226
3697	28046	183	123	841	0	29193
3698	800	28571	116	363	0	29850
3699	387	626	74	26990	0	28077
3700	278	213	94	27484	0	28069
3701	252	139	26512	801	0	27704
3702	225	26498	629	316	0	27668
3703	24286	642	171	254	0	25353
3704	578	21048	96	148	0	21870
3705	162	19895	109	119	0	20285
3706	19455	494	237	127	0	20313
3707	540	126	83	18774	0	19523
3708	176	74	67	19285	0	19602
3709	18838	63	46	534	0	19481
3710	498	57	47	19012	0	19614
3711	197	49	49	19423	0	19718
3712	19413	50	42	569	0	20074
3713	533	66	45	18658	0	19302
3714	194	19161	49	509	0	19913
3715	19158	427	43	204	0	19832
3716	494	125	18461	173	0	19253
3717	165	17663	409	153	0	18390
3718	152	455	97	17284	0	17988
3719	128	128	17036	397	0	17689
3720	126	91	17115	142	0	17474
3721	168	541	412	15744	0	16865
3722	15751	44	139	383	0	16317
3723	345	45	39	15613	0	16042
3724	129	30	64	15989	0	16212
3725	77	44	39	16098	0	16258
3726	100	43	35	16066	0	16244
3727	74	60	30	16222	0	16386
3728	82	44	15535	436	0	16097
3729	94	52	15432	150	0	15728
3730	69	46	342	15400	0	15857
3731	78	46	15455	350	0	15929
3732	58	15355	314	194	0	15921
3733	62	303	105	15449	0	15919
3734	86	120	15114	334	0	15654
3735	13169	68	311	175	0	13723
3736	315	14816	101	123	0	15355
3737	114	14688	55	129	0	14986
3738	95	14947	55	121	0	15218
3739	99	365	49	14721	0	15234
3740	14700	121	43	367	0	15231
3741	325	75	34	14731	0	15165
3742	14326	70	160	389	0	14945
3743	322	14308	42	190	0	14862
3744	14668	323	44	151	0	15186
3745	371	123	53	14677	0	15224
3746	163	91	46	14623	0	14923
3747	98	14529	74	408	0	15109
3748	101	317	60	14729	0	15207
3749	86	116	58	14922	0	15182
3750	86	79	68	14870	0	15103
3751	14524	74	66	449	0	15113
3752	14487	60	66	207	0	14820
3753	387	90	14397	152	0	15026
3754	14174	62	303	154	0	14693
3755	355	91	14706	140	0	15292
3756	153	72	318	14459	0	15002
3757	99	58	125	14977	0	15259
3758	92	61	79	15235	0	15467
3759	73	74	14837	452	0	15436
3760	69	79	322	14657	0	15127
3761	89	84	15082	414	0	15669
3762	61	74	323	15102	0	15560
3763	15198	76	123	426	0	15823
3764	321	81	15260	213	0	15875
3765	15179	72	315	175	0	15741
3766	326	75	113	15764	0	16278
3767	15718	59	86	395	0	16258
3768	320	15652	79	206	0	16257
3769	133	311	66	15912	0	16422
3770	117	131	16734	371	0	17353
3771	123	94	297	16580	0	17094
3772	96	148	114	16414	0	16772
3773	88	16633	79	439	0	17239
3774	111	287	16472	227	0	17097
3775	70	16360	293	191	0	16914
3776	14379	226	139	159	0	14903
3777	193	14609	57	135	0	14994
3778	12882	152	114	87	0	13235
3779	12715	53	58	75	0	12901
3780	12627	27	43	55	0	12752
3781	215	33	31	12692	0	12971
3782	96	21	12870	191	0	13178
3783	50	24	171	12388	0	12633
3784	33	12957	68	183	0	13241
3785	37	156	32	13049	0	13274
3786	12759	57	42	197	0	13055
3787	143	12920	39	122	0	13224
3788	66	170	26	12457	0	12719
3789	42	59	25	12594	0	12720
3790	12384	24	25	217	0	12650
3791	163	32	12326	91	0	12612
3792	70	11939	157	82	0	12248
3793	52	139	56	11791	0	12038
3794	38	53	11706	124	0	11921
3795	31	54	112	10990	0	11187
3796	50	11571	57	123	0	11801
3797	62	100	29	11851	0	12042
3798	26	47	22	11732	0	11827
3799	17	28	24	11718	0	11787
3800	28	29	11479	158	0	11694
3801	10465	25	111	85	0	10686
3802	110	18	61	12372	0	12561
3803	13475	29	19	167	0	13690
3804	13801	30	21	98	0	13950
3805	14024	30	17	45	0	14116
3806	13993	28	12	55	0	14088
3807	14310	21	24	51	0	14406
3808	235	26	23	13926	0	14210
3809	91	13850	24	190	0	14155
3810	48	154	12	13661	0	13875
3811	36	13659	24	177	0	13896
3812	30	149	12	13237	0	13428
3813	13098	41	26	159	0	13324
3814	162	22	11	13016	0	13211
3815	58	14	12857	151	0	13080
3816	11894	11	136	64	0	12105
3817	143	13041	44	45	0	13273
3818	13203	138	25	42	0	13408
3819	13114	44	13	30	0	13201
3820	12652	22	7	25	0	12706
3821	170	12870	10	47	0	13097
3822	69	124	10	13044	0	13247
3823	34	42	12	13223	0	13311
3824	38	22	12891	166	0	13117
3825	36	18	131	11998	0	12183
3826	26	15	43	12671	0	12755
3827	32	13	18	12759	0	12822
3828	28	12887	20	171	0	13106
3829	12919	146	16	54	0	13135
3830	12421	53	10	42	0	12526
3831	190	35	13021	37	0	13283
3832	64	12886	127	52	0	13129
3833	46	131	46	13250	0	13473
3834	40	45	17	13389	0	13491
3835	41	24	20	13508	0	13593
3836	42	27	14	13569	0	13652
3837	51	19	12	13615	0	13697
3838	49	32	13100	205	0	13386
3839	41	28	12117	90	0	12276
3840	13158	29	192	68	0	13447
3841	14111	33	53	47	0	14244
3842	14143	23	31	53	0	14250
3843	229	28	18	14118	0	14393
3844	92	21	13837	206	0	14156
3845	13619	19	178	77	0	13893
3846	14207	26	67	111	0	14411
3847	247	25	13810	44	0	14126
3848	13641	26	189	49	0	13905
3849	235	37	15084	49	0	15405
3850	109	23	193	15017	0	15342
3851	61	29	15267	213	0	15570
3852	14597	30	197	101	0	14925
3853	15414	22	74	79	0	15589
3854	15458	19	34	62	0	15573
3855	15158	18	32	76	0	15284
3856	275	16	15619	56	0	15966
3857	112	15482	178	80	0	15852
3858	15876	174	77	60	0	16187
3859	15873	62	38	57	0	16030
3860	272	45	16163	46	0	16526
3861	115	23	207	15139	0	15484
3862	73	31	72	16037	0	16213
3863	65	31	15726	261	0	16083
3864	14452	30	213	106	0	14801
3865	15718	21	64	89	0	15892
3866	249	15665	38	98	0	16050
3867	16267	195	41	98	0	16601
3868	16433	57	45	78	0	16613
3869	16321	19	54	56	0	16450
3870	15529	25	47	53	0	15654
3871	331	32	15085	35	0	15483
3872	14242	21	198	41	0	14502
3873	290	69	70	14471	0	14900
3874	125	15050	46	216	0	15437
3875	102	202	14768	74	0	15146
3876	80	14950	210	92	0	15332
3877	94	252	95	14322	0	14763
3878	77	49	14554	185	0	14865
3879	13266	26	188	81	0	13561
3880	201	20	14515	44	0	14780
3881	14186	19	181	40	0	14426
3882	213	14	71	14346	0	14644
3883	113	15	41	14341	0	14510
3884	78	14197	50	227	0	14552
3885	74	14710	37	80	0	14901
3886	83	205	24	14935	0	15247
3887	14805	64	33	193	0	15095
3888	14645	29	32	69	0	14775
3889	14623	28	30	44	0	14725
3890	248	29	14782	46	0	15105
3891	14324	19	180	60	0	14583
3892	221	21	15134	37	0	15413
3893	109	21	14413	45	0	14588
3894	14533	16	218	34	0	14801
3895	15274	14	88	49	0	15425
3896	251	24	15312	32	0	15619
3897	110	19	179	14796	0	15104
3898	86	21	69	15714	0	15890
3899	15802	14	43	222	0	16081
3900	15446	21	45	90	0	15602
3901	242	29	16965	59	0	17295
3902	86	16385	180	58	0	16709
3903	61	15761	59	39	0	15920
3904	15270	115	135	48	0	15568
3905	171	45	29	15249	0	15494
3906	64	15	23	15463	0	15565
3907	52	15	26	15773	0	15866
3908	12777	33	29	157	0	12996
3909	147	29	29	15743	0	15948
3910	15960	11	24	134	0	16129
3911	16567	10	33	52	0	16662
3912	208	18010	28	66	0	18312
3913	91	133	31	20240	0	20495
3914	73	37	20435	200	0	20745
3915	19405	22	211	82	0	19720
3916	20348	21	79	51	0	20499
3917	20500	16	35	43	0	20594
3918	302	33	21195	35	0	21565
3919	125	20	213	21053	0	21411
3920	21591	16	96	212	0	21915
3921	20956	18	36	84	0	21094
3922	20776	12	29	53	0	20870
3923	300	20869	40	68	0	21277
3924	127	21862	24	65	0	22078
3925	97	280	27	22194	0	22598
3926	69	90	24	21950	0	22133
3927	65	22183	22	282	0	22552
3928	22166	220	21	99	0	22506
3929	272	97	22729	54	0	23152
3930	120	32	211	22524	0	22887
3931	79	26	86	22551	0	22742
3932	90	27	22436	273	0	22826
3933	20662	25	225	111	0	21023
3934	22779	19	96	55	0	22949
3935	301	22555	49	64	0	22969
3936	22632	215	42	51	0	22940
3937	277	89	23588	53	0	24007
3938	23395	27	230	86	0	23738
3939	303	29	24288	45	0	24665
3940	23303	92	254	48	0	23697
3941	24127	23	89	59	0	24298
3942	24137	19	81	59	0	24296
3943	23885	19	34	69	0	24007
3944	307	23984	47	53	0	24391
3945	24635	197	41	77	0	24950
3946	25169	76	38	65	0	25348
3947	328	48	25123	67	0	25566
3948	24672	33	204	61	0	24970
3949	261	34	66	24910	0	25271
3950	153	34	24811	229	0	25227
3951	24415	30	214	82	0	24741
3952	281	47	90	25191	0	25609
3953	25926	39	42	279	0	26286
3954	27667	38	28	243	0	27976
3955	314	49	29522	66	0	29951
3956	29007	19	216	71	0	29313
3957	29948	32	85	59	0	30124
3958	30017	30	49	45	0	30141
3959	30427	39	42	62	0	30570
3960	348	23	56	29390	0	29817
3961	164	29937	55	250	0	30406
3962	30040	219	49	113	0	30421
3963	29971	96	40	48	0	30155
3964	30299	39	34	47	0	30419
3965	382	52	30086	41	0	30561
3966	173	30178	253	65	0	30669
3967	127	229	105	30244	0	30705
3968	134	75	54	30523	0	30786
3969	152	40	31555	295	0	32042
3970	156	28	293	30845	0	31322
3971	159	46	31960	315	0	32480
3972	140	29	310	31288	0	31767
3973	133	23	120	32185	0	32461
3974	141	56	32741	370	0	33308
3975	30419	31	310	157	0	30917
3976	33260	33	113	125	0	33531
3977	448	51	33967	65	0	34531
3978	32620	38	309	108	0	33075
3979	34071	42	139	97	0	34349
3980	471	40	35033	69	0	35613
3981	244	36	302	34039	0	34621
3982	168	39	127	35239	0	35573
3983	35206	27	85	368	0	35686
3984	404	36052	77	189	0	36722
3985	34693	300	88	117	0	35198
3986	35584	97	52	89	0	35822
3987	470	37251	72	91	0	37884
3988	37486	307	62	81	0	37936
3989	37303	115	56	83	0	37557
3990	447	37390	69	97	0	38003
3991	231	322	63	37195	0	37811
3992	171	38153	73	344	0	38741
3993	173	336	79	38134	0	38722
3994	195	127	38028	343	0	38693
3995	187	77	37408	138	0	37810
3996	36102	51	431	147	0	36731
3997	38021	40	181	99	0	38341
3998	552	63	38329	83	0	39027
3999	37436	30	392	97	0	37955
4000	38907	39	155	118	0	39219
4001	37893	27	103	97	0	38120
4002	521	38857	99	104	0	39581
4003	267	319	78	39482	0	40146
4004	39695	128	80	379	0	40282
4005	39003	59	88	179	0	39329
4006	560	60	40013	91	0	40724
4007	269	37	336	39119	0	39761
4008	176	100	161	39631	0	40068
4009	153	40001	88	436	0	40678
4010	149	41898	90	203	0	42340
4011	164	744	68	39538	0	40514
4012	123	40497	82	394	0	41096
4013	38573	296	52	131	0	39052
4014	333	40385	63	172	0	40953
4015	40989	355	54	109	0	41507
4016	489	123	41636	58	0	42306
4017	41842	78	446	77	0	42443
4018	44245	41	134	97	0	44517
4019	44031	31	66	78	0	44206
4020	43102	37	59	71	0	43269
4021	633	43516	55	108	0	44312
4022	267	455	49	43894	0	44665
4023	147	172	39	44446	0	44804
4024	148	84	43714	620	0	44566
4025	115	50	460	42399	0	43024
4026	107	59	157	43911	0	44234
4027	43793	50	77	653	0	44573
4028	520	44402	63	284	0	45269
4029	245	485	57	44401	0	45188
4030	136	189	52	45259	0	45636
4031	106	101	54	45514	0	45775
4032	45176	63	57	726	0	46022
4033	580	57	62	45262	0	45961
4034	45654	48	72	653	0	46427
4035	651	47	83	45665	0	46446
4036	291	49	60	46516	0	46916
4037	215	68	44116	695	0	45094
4038	39038	75	543	314	0	39970
4039	626	44362	199	152	0	45339
4040	45725	512	106	160	0	46503
4041	653	184	73	45241	0	46151
4042	321	92	49	46008	0	46470
4043	46652	74	63	732	0	47521
4044	46852	69	50	309	0	47280
4045	861	82	44	49495	0	50482
4046	348	83	50214	722	0	51367
4047	230	102	50234	288	0	50854
4048	144	53143	785	238	0	54310
4049	53871	748	315	168	0	55102
4050	53139	236	114	186	0	53675
4051	1023	120	80	52861	0	54084
4052	339	56044	65	864	0	57312
4053	233	808	55	55781	0	56877
4054	159	273	47	53335	0	53814
4055	136	51821	73	1078	0	53108
4056	51511	801	73	359	0	52744
4057	920	334	101	50751	0	52106
4058	321	53321	78	924	0	54644
4059	236	55622	73	320	0	56251
4060	55035	920	82	219	0	56256
4061	1011	293	54711	167	0	56182
4062	54222	136	829	161	0	55348
4063	1054	127	230	55364	0	56775
4064	376	153	104	54748	0	55381
4065	259	55687	94	1152	0	57192
4066	230	972	119	55892	0	57213
4067	363	281	56025	985	0	57654
4068	208	55580	827	486	0	57101
4069	225	56442	242	284	0	57193
4070	54595	945	128	242	0	55910
4071	880	55842	127	247	0	57096
4072	354	881	86	55420	0	56741
4073	282	55778	91	968	0	57119
4074	289	866	88	55824	0	57067
4075	265	293	74	56408	0	57040
4076	257	190	54536	1222	0	56205
4077	258	149	827	53487	0	54721
4078	244	175	252	54967	0	55638
4079	53545	156	181	1201	0	55083
4080	1022	174	53414	496	0	55106
4081	450	199	819	53906	0	55374
4082	365	192	54195	1129	0	55881
4083	52115	165	908	537	0	53725
4084	1024	55187	289	499	0	56999
4085	57495	961	162	481	0	59099
4086	1178	348	134	58488	0	60148
4087	502	246	122	58891	0	59761
4088	421	262	57722	1467	0	59872
4089	50855	219	1025	732	0	52831
4090	1113	58308	323	558	0	60302
4091	53767	1156	171	519	0	55613
4092	1249	416	166	56556	0	58387
4093	538	58199	169	1259	0	60165
4094	57282	1148	185	599	0	59214
4095	1162	58773	169	466	0	60570
4096	479	1158	161	58527	0	60325
4097	368	398	153	59350	0	60269
4098	364	335	210	58470	0	59379
4099	329	57665	196	1604	0	59794
4100	304	1149	199	57878	0	59530
4101	354	460	163	58855	0	59832
4102	56578	382	173	1539	0	58672
4103	56843	311	198	674	0	58026
4104	56907	351	157	460	0	57875
4105	1528	338	56250	496	0	58612
4106	55631	370	1048	470	0	57519
4107	57117	365	368	487	0	58337
4108	56362	336	215	547	0	57460
4109	1480	374	54151	510	0	56515
4110	52922	326	964	500	0	54712
4111	1320	336	329	54783	0	56768
4112	588	297	53731	1303	0	55919
4113	367	53732	1072	649	0	55820
4114	426	1618	337	49949	0	52330
4115	309	51050	286	1104	0	52749
4116	341	51568	240	530	0	52679
4117	48609	983	323	388	0	50303
4118	923	341	154	48467	0	49885
4119	48626	242	181	1000	0	50049
4120	925	258	141	48727	0	50051
4121	48606	270	141	995	0	50012
4122	947	243	126	48601	0	49917
4123	48613	291	138	995	0	50037
4124	988	258	46948	412	0	48606
4125	375	265	781	47291	0	48712
4126	340	270	47858	960	0	49428
4127	338	291	46280	427	0	47336
4128	318	244	47405	387	0	48354
4129	273	326	886	45779	0	47264
4130	300	203	46600	1043	0	48146
4131	45398	185	782	484	0	46849
4132	855	190	240	46622	0	47907
4133	388	200	48077	1055	0	49720
4134	301	137	773	47602	0	48813
4135	294	165	254	48463	0	49176
4136	345	186	50372	1052	0	51955
4137	390	157	783	49615	0	50945
4138	383	150	297	48994	0	49824
4139	370	50912	209	986	0	52477
4140	50691	695	202	441	0	52029
4141	50885	222	201	340	0	51648
4142	1073	212	49533	354	0	51172
4143	47768	138	729	306	0	48941
4144	903	151	47694	340	0	49088
4145	368	127	45021	255	0	45771
4146	307	146	44979	265	0	45697
4147	311	1108	795	41174	0	43388
4148	203	142	42708	637	0	43690
4149	163	179	432	41242	0	42016
4150	161	80	170	42150	0	42561
4151	158	85	130	41501	0	41874
4152	185	70	94	41133	0	41482
4153	40700	96	93	557	0	41446
4154	40249	78	88	291	0	40706
4155	530	41272	98	327	0	42227
4156	278	372	107	41587	0	42344
4157	258	151	42300	526	0	43235
4158	175	41999	481	310	0	42965
4159	220	578	216	43263	0	44277
4160	192	153	44023	604	0	44972
4161	163	81	569	42536	0	43349
4162	173	104	43762	622	0	44661
4163	184	89	43321	263	0	43857
4164	145	79	673	43592	0	44489
4165	166	74	248	44281	0	44769
4166	44005	48	148	773	0	44974
4167	602	61	118	43505	0	44286
4168	42844	61	125	699	0	43729
4169	576	42696	113	337	0	43722
4170	216	44023	131	232	0	44602
4171	193	626	94	44416	0	45329
4172	44503	156	100	634	0	45393
4173	605	44855	127	286	0	45873
4174	297	519	128	45585	0	46529
4175	47486	148	119	672	0	48425
4176	47980	84	133	289	0	48486
4177	47725	70	147	174	0	48116
4178	47735	46	147	171	0	48099
4179	48218	42	160	184	0	48604
4180	751	74	46844	181	0	47850
4181	249	62	46172	156	0	46639
4182	113	46060	651	203	0	47027
4183	241	742	324	45349	0	46656
4184	146	164	46741	564	0	47615
4185	131	144	44833	157	0	45265
4186	126	158	562	44003	0	44849
4187	117	61	47839	515	0	48532
4188	163	60	47532	166	0	47921
4189	57	61547	606	160	0	62370
4190	61140	878	193	118	0	62329
4191	832	68173	120	148	0	69273
4192	232	1171	83	66830	0	68316
4193	70503	192	88	1097	0	71880
4194	1128	72376	125	357	0	73986
4195	256	1202	113	70980	0	72551
4196	133	215	72725	1176	0	74249
4197	72076	93	1209	261	0	73639
4198	74843	69	260	161	0	75333
4199	75335	65	124	142	0	75666
4200	1477	53	99	74795	0	76424
4201	365	105	75506	1315	0	77291
4202	122	75056	1271	427	0	76876
4203	172	1294	252	73917	0	75635
4204	75086	239	138	1271	0	76734
4205	1403	131	75427	288	0	77249
4206	313	72983	1332	229	0	74857
4207	211	1230	75782	158	0	77381
4208	73803	247	1345	147	0	75542
4209	77737	119	288	146	0	78290
4210	77705	97	143	128	0	78073
4211	1614	129	75109	130	0	76982
4212	378	74485	1300	217	0	76380
4213	250	1290	310	73396	0	75246
4214	204	257	163	75361	0	75985
4215	193	150	163	74898	0	75404
4216	231	132	74053	1523	0	75939
4217	70412	126	1422	429	0	72389
4218	1470	178	74804	220	0	76672
4219	74856	106	1393	266	0	76621
4220	77214	127	384	213	0	77938
4221	77307	169	213	208	0	77897
4222	75936	197	236	209	0	76578
4223	1764	211	75377	190	0	77542
4224	563	189	1424	73800	0	75976
4225	418	269	74243	1436	0	76366
4226	347	72864	1392	549	0	75152
4227	329	76005	447	364	0	77145
4228	75204	1612	305	314	0	77435
4229	73622	489	289	328	0	74728
4230	1702	75759	308	447	0	78216
4231	76542	1494	246	365	0	78647
4232	1831	486	70620	332	0	73269
4233	72821	267	1353	396	0	74837
4234	1727	75449	501	423	0	78100
4235	77291	1542	314	341	0	79488
4236	75831	493	320	300	0	76944
4237	2117	327	279	73189	0	75912
4238	827	288	341	75094	0	76550
4239	73512	338	425	1799	0	76074
4240	1809	333	386	73845	0	76373
4241	74083	327	387	1717	0	76514
4242	2001	309	374	73856	0	76540
4243	73634	278	471	1715	0	76098
4244	72845	339	419	564	0	74167
4245	2065	71787	494	422	0	74768
4246	911	73673	546	392	0	75522
4247	70108	1811	437	427	0	72783
4248	1858	71627	529	493	0	74507
4249	846	1728	523	70188	0	73285
4250	751	604	486	71907	0	73748
4251	68535	440	450	1976	0	71401
4252	1876	69804	520	825	0	73025
4253	891	69264	541	669	0	71365
4254	785	69693	587	618	0	71683
4255	1005	1891	66907	530	0	70333
4256	1025	694	68011	451	0	70181
4257	1050	576	68251	516	0	70393
4258	1045	1278	1904	56219	0	60446
4259	957	64250	679	1459	0	67345
4260	64851	1541	479	671	0	67542
4261	2028	549	63874	604	0	67055
4262	1097	404	64110	605	0	66216
4263	1001	388	65274	490	0	67153
4264	1032	426	1800	63114	0	66372
4265	967	422	685	64971	0	67045
4266	1059	398	546	65250	0	67253
4267	64641	416	496	1640	0	67193
4268	64920	527	508	570	0	66525
4269	64927	459	471	524	0	66381
4270	2217	404	587	62646	0	65854
4271	1052	455	61336	1495	0	64338
4272	892	588	62576	530	0	64586
4273	950	402	1706	61368	0	64426
4274	1049	403	630	61650	0	63732
4275	60145	390	475	1643	0	62653
4276	2010	59421	411	744	0	62586
4277	59566	1390	448	520	0	61924
4278	1944	59122	413	669	0	62148
4279	1052	1446	360	58865	0	61723
4280	920	483	58673	1760	0	61836
4281	899	423	1425	58424	0	61171
4282	59158	347	501	1748	0	61754
4283	2011	335	58318	750	0	61414
4284	56213	387	1380	478	0	58458
4285	2085	336	56122	440	0	58983
4286	1232	437	54782	356	0	56807
4287	50268	341	1499	493	0	52601
4288	1841	344	51223	445	0	53853
4289	604	187	36545	220	0	37556
4290	697	34560	1320	301	0	36878
4291	28715	684	1346	394	0	31139
4292	26986	131	223	114	0	27454
4293	26689	59	99	124	0	26971
4294	373	69	25378	97	0	25917
4295	24187	60	275	92	0	24614
4296	307	25290	94	100	0	25791
4297	24594	251	48	96	0	24989
4298	320	106	24571	79	0	25076
4299	179	156	204	22998	0	23537
4300	111	66	23343	211	0	23731
4301	61	22866	230	108	0	23265
4302	54	151	86	22055	0	22346
4303	71	59	82	22491	0	22703
4304	22877	30	31	219	0	23157
4305	22659	30	40	85	0	22814
4306	22493	36	54	67	0	22650
4307	22418	40	36	62	0	22556
4308	22108	31	38	53	0	22230
4309	222	43	22057	52	0	22374
4310	106	31	164	21575	0	21876
4311	69	43	22758	176	0	23046
4312	66	25	185	22839	0	23115
4313	23264	39	73	219	0	23595
4314	23547	29	62	80	0	23718
4315	23515	29	53	49	0	23646
4316	23687	39	57	61	0	23844
4317	265	45	24494	61	0	24865
4318	99	36	217	23840	0	24192
4319	79	40	24372	257	0	24748
4320	57	24731	226	169	0	25183
4321	71	25122	95	94	0	25382
4322	89	306	56	24809	0	25260
4323	78	74	48	26416	0	26616
4324	77	36	57	27538	0	27708
4325	78	21	55	28513	0	28667
4326	28019	23	65	436	0	28543
4327	354	27879	58	242	0	28533
4328	27392	323	45	73	0	27833
4329	394	88	50	27233	0	27765
4330	133	66	33	26265	0	26497
4331	79	27076	33	408	0	27596
4332	85	333	32	27075	0	27525
4333	26872	86	31	365	0	27354
4334	363	25873	41	151	0	26428
4335	113	25167	35	91	0	25406
4336	24921	366	43	53	0	25383
4337	343	94	32	24882	0	25351
4338	100	24989	42	368	0	25499
4339	143	347	46	25236	0	25772
4340	25231	82	54	402	0	25769
4341	343	38	24	25072	0	25477
4342	111	24	24	25541	0	25700
4343	25095	22	28	415	0	25560
4344	359	40	25	24856	0	25280
4345	130	24927	35	382	0	25474
4346	94	310	29	24811	0	25244
4347	63	24747	32	400	0	25242
4348	61	324	36	24866	0	25287
4349	24713	79	26	372	0	25190
4350	24749	41	38	132	0	24960
4351	414	36	37	24900	0	25387
4352	149	56	24347	359	0	24911
4353	23412	36	343	139	0	23930
4354	393	50	24244	88	0	24775
4355	23716	34	346	89	0	24185
4356	24305	38	79	69	0	24491
4357	446	32	23472	69	0	24019
4358	134	23102	329	96	0	23661
4359	23304	353	72	71	0	23800
4360	23517	88	36	88	0	23729
4361	437	69	24018	58	0	24582
4362	23721	54	310	95	0	24180
4363	23500	41	89	97	0	23727
4364	23152	49	53	86	0	23340
4365	416	40	19	23258	0	23733
4366	146	47	23	23482	0	23698
4367	100	23591	31	438	0	24160
4368	93	321	19	24034	0	24467
4369	87	105	17	24383	0	24592
4370	93	69	23455	433	0	24050
4371	95	55	22455	180	0	22785
4372	20734	51	376	120	0	21281
4373	22276	60	104	95	0	22535
4374	424	22309	52	109	0	22894
4375	152	352	28	22429	0	22961
4376	116	127	22953	410	0	23606
4377	94	79	328	23216	0	23717
4378	98	51	95	24094	0	24338
4379	108	60	48	24349	0	24565
4380	101	24355	43	555	0	25054
4381	128	401	39	24763	0	25331
4382	120	149	25	25227	0	25521
4383	120	73	24572	570	0	25335
4384	124	73	24725	210	0	25132
4385	23029	76	468	168	0	23741
4386	24604	78	133	133	0	24948
4387	518	77	58	26361	0	27014
4388	201	67	46	25775	0	26089
4389	130	84	48	26316	0	26578
4390	143	73	25099	705	0	26020
4391	126	24592	489	330	0	25537
4392	119	510	24876	171	0	25676
4393	24329	145	550	149	0	25173
4394	613	96	25168	122	0	25999
4395	24770	65	562	125	0	25522
4396	25015	70	142	134	0	25361
4397	25478	49	85	143	0	25755
4398	700	76	60	24739	0	25575
4399	236	77	24831	619	0	25763
4400	139	25239	537	252	0	26167
4401	171	513	145	25186	0	26015
4402	159	145	83	26013	0	26400
4403	165	83	26690	694	0	27632
4404	130	26291	589	298	0	27308
4405	27599	585	172	154	0	28510
4406	681	28518	113	185	0	29497
4407	31101	690	74	135	0	32000
4408	875	154	103	31474	0	32606
4409	331	97	32243	833	0	33504
4410	155	32399	854	288	0	33696
4411	32745	810	276	195	0	34026
4412	918	172	32729	110	0	33929
4413	32398	112	896	125	0	33531
4414	33290	56	212	112	0	33670
4415	1066	68	32780	105	0	34019
4416	32042	66	861	124	0	33093
4417	32414	41	235	111	0	32801
4418	31700	60	128	111	0	31999
4419	997	31003	120	147	0	32267
4420	29835	797	77	109	0	30818
4421	856	30184	97	139	0	31276
4422	304	770	30086	98	0	31258
4423	130	29703	778	134	0	30745
4424	28150	756	338	108	0	29352
4425	28592	134	83	77	0	28886
4426	28818	66	79	87	0	29050
4427	845	62	75	27699	0	28681
4428	215	51	65	28762	0	29093
4429	27578	55	66	807	0	28506
4430	28336	64	74	182	0	28656
4431	839	67	90	27535	0	28531
4432	251	64	27580	690	0	28585
4433	133	26588	704	190	0	27615
4434	140	27746	165	113	0	28164
4435	152	760	117	27076	0	28105
4436	196	152	27225	679	0	28252
4437	148	98	690	25140	0	26076
4438	150	26610	170	650	0	27580
4439	151	665	93	26521	0	27430
4440	147	173	26646	719	0	27685
4441	147	106	676	26469	0	27398
4442	165	86	27949	746	0	28946
4443	141	103	750	27557	0	28551
4444	196	104	28770	773	0	29843
4445	203	107	28941	180	0	29431
4446	27327	111	814	136	0	28388
4447	29110	92	219	135	0	29556
4448	29297	95	148	125	0	29665
4449	895	28752	132	140	0	29919
4450	338	703	129	29191	0	30361
4451	28779	176	150	719	0	29824
4452	29729	118	127	187	0	30161
4453	29418	109	135	153	0	29815
4454	939	120	29112	147	0	30318
4455	335	27637	737	194	0	28903
4456	285	29680	244	164	0	30373
4457	29099	792	155	118	0	30164
4458	866	247	140	28924	0	30177
4459	29014	174	166	735	0	30089
4460	902	158	28700	205	0	29965
4461	354	157	736	27926	0	29173
4462	311	149	249	28712	0	29421
4463	306	166	182	27225	0	27879
4464	329	28181	197	778	0	29485
4465	28229	758	162	223	0	29372
4466	28405	214	162	197	0	28978
4467	932	27998	186	192	0	29308
4468	437	727	167	27696	0	29027
4469	27919	214	156	745	0	29034
4470	949	155	148	27711	0	28963
4471	27782	142	177	790	0	28891
4472	892	27681	167	306	0	29046
4473	27621	783	134	191	0	28729
4474	942	293	27224	173	0	28632
4475	376	27391	751	223	0	28741
4476	330	752	27106	190	0	28378
4477	458	625	776	25957	0	27816
4478	26350	204	229	754	0	27537
4479	26693	134	193	252	0	27272
4480	26380	132	178	213	0	26903
4481	948	93	162	25532	0	26735
4482	25741	102	146	738	0	26727
4483	860	99	151	25445	0	26555
4484	25410	116	216	748	0	26490
4485	26020	130	191	269	0	26610
4486	926	164	25620	215	0	26925
4487	316	133	23848	147	0	24444
4488	225	146	23804	168	0	24343
4489	195	177	647	22630	0	23649
4490	23094	94	353	605	0	24146
4491	647	104	145	23214	0	24110
4492	287	96	96	23972	0	24451
4493	24838	84	126	726	0	25774
4494	24918	83	99	283	0	25383
4495	25033	103	117	195	0	25448
4496	25140	76	116	193	0	25525
4497	736	74	109	24594	0	25513
4498	24395	63	121	599	0	25178
4499	626	24189	148	204	0	25167
4500	23829	501	117	187	0	24634
4501	23972	157	128	183	0	24440
4502	636	122	22532	147	0	23437
4503	20930	109	438	123	0	21600
4504	541	63	21034	109	0	21747
4505	190	40	19150	97	0	19477
4506	158	65	18962	98	0	19283
4507	210	458	329	15155	0	16152
4508	55	31	15633	154	0	15873
4509	71	58	137	14240	0	14506
4510	41	22	14926	119	0	15108
4511	49	27	16173	51	0	16300
4512	47	31	111	15339	0	15528
4513	69	25	38	16449	0	16581
4514	50	16	16944	120	0	17130
4515	15932	16	102	60	0	16110
4516	123	16	29	17086	0	17254
4517	55	13	15	17182	0	17265
4518	17169	9	17	140	0	17335
4519	129	24	10	17412	0	17575
4520	74	16	17424	119	0	17633
4521	50	18	16733	48	0	16849
4522	43	12	112	16438	0	16605
4523	55	20	17212	108	0	17395
4524	35	17776	107	52	0	17970
4525	38	92	36	17855	0	18021
4526	17949	19	23	102	0	18093
4527	112	19	17986	39	0	18156
4528	17244	9	103	74	0	17430
4529	113	6	30	18744	0	18893
4530	45	7	18	19042	0	19112
4531	29	8	16	19171	0	19224
4532	23	7	21	19171	0	19222
4533	18860	7	15	144	0	19026
4534	125	20258	24	61	0	20468
4535	45	148	15	20634	0	20842
4536	37	39	17	20768	0	20861
4537	33	14	14	20788	0	20849
4538	31	11	10	20825	0	20877
4539	20494	15	21	217	0	20747
4540	164	20460	26	123	0	20773
4541	20194	140	27	44	0	20405
4542	159	19170	35	68	0	19432
4543	53	19398	28	67	0	19546
4544	18605	171	30	43	0	18849
4545	191	52	19024	36	0	19303
4546	75	44	164	18915	0	19198
4547	19527	17	56	210	0	19810
4548	19802	17	31	109	0	19959
4549	19465	25	31	86	0	19607
4550	20475	12	23	61	0	20571
4551	190	21438	38	58	0	21724
4552	21739	194	18	63	0	22014
4553	22402	49	25	49	0	22525
4554	262	24176	37	61	0	24536
4555	81	311	24	25358	0	25774
4556	53	80	25583	375	0	26091
4557	34	26	354	25400	0	25814
4558	24930	21	99	419	0	25469
4559	386	27	26429	123	0	26965
4560	92	26109	368	137	0	26706
4561	81	366	27154	64	0	27665
4562	50	139	378	24672	0	25239
4563	37	26787	91	347	0	27262
4564	26831	364	56	107	0	27358
4565	362	27390	32	99	0	27883
4566	100	386	39	27069	0	27594
4567	55	99	21	27829	0	28004
4568	27273	41	27	452	0	27793
4569	387	43	24	26543	0	26997
4570	108	27322	31	373	0	27834
4571	27177	366	22	152	0	27717
4572	27284	98	17	87	0	27486
4573	441	27655	19	88	0	28203
4574	27563	375	25	72	0	28035
4575	398	27414	29	73	0	27914
4576	27170	398	19	74	0	27661
4577	397	27398	33	107	0	27935
4578	132	388	47	25917	0	26484
4579	80	100	33	27788	0	28001
4580	27135	58	32	454	0	27679
4581	27743	55	46	139	0	27983
4582	462	27492	38	159	0	28151
4583	169	414	26739	70	0	27392
4584	27264	115	386	104	0	27869
4585	443	72	97	27552	0	28164
4586	143	28062	47	395	0	28647
4587	124	410	35	28220	0	28789
4588	28336	111	42	450	0	28939
4589	28559	74	29	168	0	28830
4590	28832	65	42	140	0	29079
4591	558	53	27	28363	0	29001
4592	175	85	28569	426	0	29255
4593	26374	74	391	183	0	27022
4594	27658	70	107	104	0	27939
4595	27857	79	63	101	0	28100
4596	512	27548	36	129	0	28225
4597	183	424	49	27512	0	28168
4598	93	28401	47	465	0	29006
4599	118	468	42	28454	0	29082
4600	139	123	44	28945	0	29251
4601	138	115	29812	582	0	30647
4602	123	86	435	32236	0	32880
4603	142	84	102	33518	0	33846
4604	33073	101	70	686	0	33930
4605	611	33489	45	278	0	34423
4606	33608	608	54	126	0	34396
4607	35009	189	41	114	0	35353
4608	785	140	41	34795	0	35761
4609	344	106	35608	654	0	36712
4610	179	34784	565	240	0	35768
4611	158	34636	170	151	0	35115
4612	33134	721	107	112	0	34074
4613	687	34497	71	167	0	35422
4614	227	625	70	33851	0	34773
4615	188	206	74	35186	0	35654
4616	176	151	34349	759	0	35435
4617	185	137	34277	261	0	34860
4618	137	34195	707	172	0	35211
4619	176	653	189	34152	0	35170
4620	34137	228	89	664	0	35118
4621	641	164	79	34584	0	35468
4622	263	137	35224	707	0	36331
4623	177	111	616	34634	0	35538
4624	33338	133	191	743	0	34405
4625	33876	126	99	266	0	34367
4626	762	33795	79	231	0	34867
4627	33835	642	59	150	0	34686
4628	694	33659	77	176	0	34606
4629	33644	667	74	135	0	34520
4630	744	252	50	32823	0	33869
4631	299	179	32890	633	0	34001
4632	244	144	32534	229	0	33151
4633	195	33392	670	171	0	34428
4634	256	585	198	32151	0	33190
4635	171	208	80	33246	0	33705
4636	32794	133	71	745	0	33743
4637	33322	109	80	266	0	33777
4638	33842	113	69	218	0	34242
4639	790	128	49	33252	0	34219
4640	333	119	52	34090	0	34594
4641	235	133	58	34397	0	34823
4642	228	123	33601	730	0	34682
4643	231	139	33253	260	0	33883
4644	31776	133	663	217	0	32789
4645	33485	120	207	204	0	34016
4646	780	139	33295	174	0	34388
4647	31636	125	567	200	0	32528
4648	32323	120	247	209	0	32899
4649	750	111	31837	177	0	32875
4650	302	31547	601	209	0	32659
4651	237	667	209	30687	0	31800
4652	264	197	31670	594	0	32725
4653	170	32612	546	298	0	33626
4654	182	729	171	28720	0	29802
4655	135	30182	116	500	0	30933
4656	160	457	29145	229	0	29991
4657	169	203	29936	160	0	30468
4658	167	250	586	29454	0	30457
4659	29892	103	399	517	0	30911
4660	562	116	88	29898	0	30664
4661	29446	124	85	582	0	30237
4662	581	115	100	29657	0	30453
4663	273	114	29648	557	0	30592
4664	28007	98	521	277	0	28903
4665	558	112	29721	184	0	30575
4666	29260	105	540	193	0	30098
4667	567	113	233	28963	0	29876
4668	226	30175	185	558	0	31144
4669	205	504	116	29950	0	30775
4670	160	31185	112	598	0	32055
4671	206	502	126	28984	0	29818
4672	170	31199	130	549	0	32048
4673	30633	512	110	293	0	31548
4674	31008	203	115	216	0	31542
4675	30726	129	126	201	0	31182
4676	745	97	30603	171	0	31616
4677	342	107	543	30151	0	31143
4678	286	104	31204	550	0	32144
4679	210	30066	576	315	0	31167
4680	217	31216	246	215	0	31894
4681	30384	570	192	132	0	31278
4682	606	242	30464	135	0	31447
4683	265	30040	568	178	0	31051
4684	219	509	288	30645	0	31661
4685	30843	225	192	577	0	31837
4686	520	31511	153	341	0	32525
4687	31979	547	136	200	0	32862
4688	631	240	32040	191	0	33102
4689	286	142	568	32352	0	33348
4690	195	116	237	33515	0	34063
4691	187	84	191	34463	0	34925
4692	184	34392	158	836	0	35570
4693	210	622	139	33962	0	34933
4694	254	238	35152	730	0	36374
4695	185	117	651	34501	0	35454
4696	209	93	298	35581	0	36181
4697	187	86	188	34843	0	35304
4698	205	34544	166	820	0	35735
4699	229	583	156	34632	0	35600
4700	300	239	154	34367	0	35060
4701	165	32555	141	768	0	33629
4702	29391	437	104	237	0	30169
4703	431	29869	100	169	0	30569
4704	161	29797	89	152	0	30199
4705	180	633	131	29233	0	30177
4706	129	184	29002	452	0	29767
4707	25305	93	435	192	0	26025
4708	404	68	148	28064	0	28684
4709	161	61	27723	447	0	28392
4710	79	27790	408	291	0	28568
4711	73	414	153	28128	0	28768
4712	116	162	28482	484	0	29244
4713	102	122	397	27451	0	28072
4714	95	88	153	27882	0	28218
4715	27119	56	88	553	0	27816
4716	379	27211	76	304	0	27970
4717	27028	382	68	157	0	27635
4718	458	154	27346	113	0	28071
4719	174	27596	405	127	0	28302
4720	159	403	27746	87	0	28395
4721	88	244	405	27986	0	28723
4722	28027	91	195	431	0	28744
4723	380	87	82	27733	0	28282
4724	27890	59	93	470	0	28512
4725	28296	59	72	208	0	28635
4726	530	65	57	28607	0	29259
4727	253	72	30197	454	0	30976
4728	128	79	31274	207	0	31688
4729	95	74	514	31679	0	32362
4730	83	81	216	32654	0	33034
4731	32246	69	98	616	0	33029
4732	449	89	76	32178	0	32792
4733	193	32081	85	550	0	32909
4734	123	447	63	32474	0	33107
4735	99	189	62	32773	0	33123
4736	31863	114	56	649	0	32682
4737	434	32411	71	303	0	33219
4738	192	482	71	32716	0	33461
4739	126	184	48	32658	0	33016
4740	76	32462	95	673	0	33306
4741	96	490	66	32952	0	33604
4742	75	202	64	32658	0	32999
4743	74	32237	68	728	0	33107
4744	88	482	68	32578	0	33216
4745	63	210	68	32214	0	32555
4746	71	31882	105	693	0	32751
4747	69	513	72	32317	0	32971
4748	31896	200	53	664	0	32813
4749	31971	102	70	358	0	32501
4750	31802	131	58	232	0	32223
4751	31712	111	55	216	0	32094
4752	607	30572	63	270	0	31512
4753	28772	441	47	171	0	29431
4754	450	28409	58	210	0	29127
4755	186	28359	55	189	0	28789
4756	141	508	121	28020	0	28790
4757	90	201	28129	478	0	28898
4758	26672	88	365	243	0	27368
4759	28169	104	120	179	0	28572
4760	484	112	29226	167	0	29989
4761	28310	66	363	187	0	28926
4762	29913	89	133	156	0	30291
4763	444	29239	59	217	0	29959
4764	32761	367	76	341	0	33545
4765	445	151	68	32824	0	33488
4766	207	104	51	32846	0	33208
4767	142	79	66	32967	0	33254
4768	118	95	68	32813	0	33094
4769	32548	84	50	582	0	33264
4770	410	87	66	32161	0	32724
4771	201	98	65	32477	0	32841
4772	161	106	31653	528	0	32448
4773	27994	99	358	327	0	28778
4774	31701	84	131	198	0	32114
4775	31700	78	84	196	0	32058
4776	514	31285	86	204	0	32089
4777	208	32014	83	203	0	32508
4778	31691	443	54	210	0	32398
4779	440	179	67	31688	0	32374
4780	218	32662	61	505	0	33446
4781	163	407	45	32264	0	32879
4782	121	32547	53	543	0	33264
4783	32261	408	46	280	0	32995
4784	423	32767	63	257	0	33510
4785	208	441	40	32212	0	32901
4786	180	161	84	32827	0	33252
4787	183	123	33356	540	0	34202
4788	161	35049	379	309	0	35898
4789	167	585	181	36234	0	37167
4790	174	233	37182	667	0	38256
4791	177	172	37974	285	0	38608
4792	138	123	749	38014	0	39024
4793	140	80	262	38096	0	38578
4794	108	37080	118	947	0	38253
4795	142	38854	68	421	0	39485
4796	108	869	59	38687	0	39723
4797	38538	333	51	765	0	39687
4798	750	158	50	39892	0	40850
4799	40408	112	35	867	0	41422
4800	41216	99	40	368	0	41723
4801	41633	96	51	223	0	42003
4802	1081	110	41547	169	0	42907
4803	40803	87	678	184	0	41752
4804	870	90	278	41787	0	43025
4805	415	89	124	42338	0	42966
4806	254	117	41473	1013	0	42857
4807	184	120	41514	431	0	42249
4808	167	151	882	39977	0	41177
4809	120	39960	357	783	0	41220
4810	116	41213	143	387	0	41859
4811	128	890	78	40928	0	42024
4812	40524	329	83	808	0	41744
4813	749	152	67	40879	0	41847
4814	326	88	71	40696	0	41181
4815	176	41072	64	1002	0	42314
4816	142	697	57	41591	0	42487
4817	173	307	41902	863	0	43245
4818	159	174	40520	397	0	41250
4819	38399	85	909	274	0	39667
4820	705	41091	350	218	0	42364
4821	40939	688	147	184	0	41958
4822	41327	278	108	175	0	41888
4823	953	162	88	38218	0	39421
4824	391	40797	104	708	0	42000
4825	254	730	78	40974	0	42036
4826	41001	285	94	822	0	42202
4827	739	39984	91	423	0	41237
4828	38479	692	74	242	0	39487
4829	712	38849	88	213	0	39862
4830	38931	731	78	165	0	39905
4831	38905	286	83	200	0	39474
4832	864	38280	100	188	0	39432
4833	374	642	81	38423	0	39520
4834	38514	275	92	711	0	39592
4835	719	179	37429	351	0	38678
4836	336	118	37476	219	0	38149
4837	242	326	793	36589	0	37950
4838	37418	93	328	700	0	38539
4839	675	100	155	37284	0	38214
4840	37570	102	98	770	0	38540
4841	775	114	38481	353	0	39723
4842	38278	105	624	259	0	39266
4843	40509	95	284	223	0	41111
4844	877	90	154	39928	0	41049
4845	426	93	108	40374	0	41001
4846	265	111	113	40321	0	40810
4847	175	40358	134	950	0	41617
4848	199	615	105	40326	0	41245
4849	183	288	131	41048	0	41650
4850	40374	152	130	938	0	41594
4851	40411	119	125	513	0	41168
4852	901	137	39820	310	0	41168
4853	39095	134	650	274	0	40153
4854	809	140	40062	235	0	41246
4855	37231	141	751	297	0	38420
4856	803	120	39567	304	0	40794
4857	421	162	38891	271	0	39745
4858	279	226	880	37714	0	39099
4859	247	143	38639	810	0	39839
4860	36642	152	722	493	0	38009
4861	725	149	326	38598	0	39798
4862	38936	182	201	778	0	40097
4863	39173	175	116	452	0	39916
4864	36442	141	127	302	0	37012
4865	35737	126	134	270	0	36267
4866	1062	112	35394	288	0	36856
4867	568	115	619	35190	0	36492
4868	422	126	36101	741	0	37390
4869	313	105	713	35668	0	36799
4870	35636	97	361	795	0	36889
4871	748	125	230	36075	0	37178
4872	36247	135	176	843	0	37401
4873	784	142	157	36528	0	37611
4874	417	129	171	37117	0	37834
4875	36642	145	146	931	0	37864
4876	709	36542	163	514	0	37928
4877	36329	653	129	318	0	37429
4878	777	36371	122	302	0	37572
4879	405	681	119	36684	0	37889
4880	36304	311	129	716	0	37460
4881	762	174	36099	439	0	37474
4882	442	147	601	36358	0	37548
4883	36445	131	304	734	0	37614
4884	37407	117	197	403	0	38124
4885	1046	124	151	36437	0	37758
4886	530	37542	159	774	0	39005
4887	307	36842	132	414	0	37695
4888	350	1306	100	33515	0	35271
4889	33579	251	88	513	0	34431
4890	545	32270	53	300	0	33168
4891	173	30603	29	150	0	30955
4892	29210	425	67	70	0	29772
4893	329	29578	26	109	0	30042
4894	30198	351	131	83	0	30763
4895	440	128	44	30193	0	30805
4896	194	85	19	30012	0	30310
4897	60	30122	27	479	0	30688
4898	52	29896	17	189	0	30154
4899	28084	411	20	72	0	28587
4900	326	29500	26	85	0	29937
4901	111	31789	23	84	0	32007
4902	237	602	58	31138	0	32035
4903	31866	205	21	499	0	32591
4904	519	92	33950	183	0	34744
4905	33424	44	607	94	0	34169
4906	674	33	255	36617	0	37579
4907	332	46	37609	720	0	38707
4908	143	48	38527	336	0	39054
4909	63	29	1024	38417	0	39533
4910	96	52	39654	784	0	40586
4911	38472	25	878	358	0	39733
4912	40141	35	356	150	0	40682
4913	1117	46	40103	84	0	41350
4914	435	35	839	39139	0	40448
4915	178	26	363	40327	0	40894
4916	40154	39	141	1127	0	41461
4917	850	66	78	37647	0	38641
4918	376	38875	92	879	0	40222
4919	38712	797	58	364	0	39931
4920	841	38835	62	206	0	39944
4921	369	40450	77	174	0	41070
4922	206	1089	71	39212	0	40578
4923	127	421	55	39714	0	40317
4924	132	182	54	40240	0	40608
4925	132	123	38634	1215	0	40104
4926	34655	120	828	546	0	36149
4927	846	37799	360	258	0	39263
4928	38427	871	125	178	0	39601
4929	38926	383	85	159	0	39553
4930	1243	191	80	37910	0	39424
4931	519	38253	61	942	0	39775
4932	274	864	75	38895	0	40108
4933	184	391	81	39837	0	40493
4934	39468	205	60	1274	0	41007
4935	39737	139	92	574	0	40542
4936	1292	136	39100	259	0	40787
4937	39068	149	823	222	0	40262
4938	1069	40008	373	206	0	41656
4939	39924	933	150	195	0	41202
4940	1028	42048	108	280	0	43464
4941	512	1074	105	40571	0	42262
4942	320	500	76	40430	0	41326
4943	215	40272	101	1357	0	41945
4944	274	1009	98	40929	0	42310
4945	254	482	101	41610	0	42447
4946	229	284	111	40474	0	41098
4947	202	40091	131	1438	0	41862
4948	240	1039	123	40402	0	41804
4949	223	488	109	40837	0	41657
4950	226	292	124	41369	0	42011
4951	278	235	39555	1524	0	41592
4952	37008	208	995	766	0	38977
4953	1108	263	40009	404	0	41784
4954	38916	207	1093	360	0	40576
4955	1228	194	40136	370	0	41928
4956	39312	190	1136	311	0	40949
4957	40619	199	494	334	0	41646
4958	1523	229	40254	342	0	42348
4959	754	200	1080	39467	0	41501
4960	426	246	39738	1155	0	41565
4961	37412	194	1136	708	0	39450
4962	1232	204	41336	459	0	43231
4963	659	216	41001	415	0	42291
4964	39512	212	1421	389	0	41534
4965	1197	40734	683	398	0	43012
4966	683	1055	367	41003	0	43108
4967	41737	539	270	1250	0	43796
4968	1298	294	292	41708	0	43592
4969	686	206	275	42876	0	44043
4970	41845	222	271	1614	0	43952
4971	42182	221	275	851	0	43529
4972	1631	210	41524	530	0	43895
4973	838	236	41934	459	0	43467
4974	536	202	1459	41451	0	43648
4975	472	207	42674	1331	0	44684
4976	420	220	1226	41830	0	43696
4977	396	189	647	42603	0	43835
4978	441	189	368	43699	0	44697
4979	41867	201	238	1773	0	44079
4980	1249	42672	303	901	0	45125
4981	42875	1046	217	628	0	44766
4982	42803	575	212	568	0	44158
4983	1547	42588	225	568	0	44928
4984	41732	995	162	510	0	43399
4985	1242	537	41184	462	0	43425
4986	630	311	904	40346	0	42191
4987	40830	249	414	1164	0	42657
4988	1082	273	40546	645	0	42546
4989	39121	212	869	466	0	40668
4990	1080	42082	445	396	0	44003
4991	46778	830	279	357	0	48244
4992	47031	393	228	345	0	47997
4993	1596	47942	246	330	0	50114
4994	49245	1020	184	358	0	50807
4995	1458	532	210	49041	0	51241
4996	811	329	167	50268	0	51575
4997	49329	176	183	1568	0	51256
4998	45946	211	170	820	0	47147
4999	1544	48983	171	591	0	51289
5000	778	48990	170	463	0	50401
5001	412	1335	122	44143	0	46012
5002	316	45949	166	941	0	47372
5003	315	47247	123	535	0	48220
5004	42994	954	208	279	0	44435
5005	760	44070	131	272	0	45233
5006	41321	718	115	163	0	42317
5007	720	43051	89	207	0	44067
5008	492	680	42482	178	0	43832
5009	209	43502	513	193	0	44417
5010	42099	895	490	194	0	43678
5011	41308	246	144	147	0	41845
5012	755	166	41535	103	0	42559
5013	375	90	495	39609	0	40569
5014	221	66	255	42151	0	42693
5015	187	94	41995	672	0	42948
5016	155	68	519	40221	0	40963
5017	160	69	42151	632	0	43012
5018	146	90	40722	317	0	41275
5019	39433	53	668	217	0	40371
5020	535	41490	326	185	0	42536
5021	41313	476	185	98	0	42072
5022	621	249	103	41437	0	42410
5023	361	169	42227	499	0	43256
5024	250	117	492	39613	0	40472
5025	160	42362	244	525	0	43291
5026	42764	500	148	228	0	43640
5027	42681	243	107	175	0	43206
5028	739	165	56	42875	0	43835
5029	388	121	42359	522	0	43390
5030	39547	73	486	288	0	40394
5031	596	41995	215	194	0	43000
5032	42067	510	127	120	0	42824
5033	745	285	79	41568	0	42677
5034	41844	177	109	529	0	42659
5035	737	156	57	41285	0	42235
5036	425	156	41408	616	0	42605
5037	288	131	40207	386	0	41012
5038	37990	94	607	341	0	39032
5039	573	41801	318	252	0	42944
5040	41397	446	290	184	0	42317
5041	41363	276	89	147	0	41875
5042	588	41924	73	133	0	42718
5043	41576	534	54	138	0	42302
5044	657	371	44286	124	0	45438
5045	341	275	397	44334	0	45347
5046	278	223	187	45017	0	45705
5047	226	193	118	45730	0	46267
5048	227	199	44990	658	0	46074
5049	229	186	44890	343	0	45648
5050	164	183	635	44032	0	45014
5051	167	44913	356	513	0	45949
5052	178	46687	192	281	0	47338
5053	46728	638	114	219	0	47699
5054	46581	333	139	198	0	47251
5055	642	48731	154	244	0	49771
5056	358	525	106	49565	0	50554
5057	231	301	140	50173	0	50845
5058	50652	212	158	782	0	51804
5059	643	132	166	51906	0	52847
5060	357	170	192	52017	0	52736
5061	326	161	171	52173	0	52831
5062	325	194	49060	796	0	50375
5063	301	228	46242	450	0	47221
5064	47669	122	688	343	0	48822
5065	617	95	401	51214	0	52327
5066	378	150	51336	683	0	52547
5067	293	224	49969	364	0	50850
5068	47677	186	777	374	0	49014
5069	840	199	56012	233	0	57284
5070	394	57302	791	306	0	58793
5071	277	752	365	61662	0	63056
5072	347	401	61756	822	0	63326
5073	60105	285	842	387	0	61619
5074	1018	204	349	65156	0	66727
5075	528	180	64661	1021	0	66390
5076	336	134	987	64869	0	66326
5077	257	139	430	66005	0	66831
5078	66095	113	297	1323	0	67828
5079	1041	66716	271	663	0	68691
5080	591	934	202	65658	0	67385
5081	66959	400	168	1079	0	68606
5082	67331	218	172	577	0	68298
5083	67983	135	140	377	0	68635
5084	68692	158	182	321	0	69353
5085	1561	135	197	67280	0	69173
5086	67526	91	223	1114	0	68954
5087	67201	83	230	543	0	68057
5088	64899	91	180	434	0	65604
5089	64904	108	244	353	0	65609
5090	1344	62249	245	362	0	64200
5091	269	57794	85	151	0	58299
5092	159	868	75	56302	0	57404
5093	112	56568	79	667	0	57426
5094	55825	631	104	283	0	56843
5095	685	261	78	55490	0	56514
5096	55428	75	43	705	0	56251
5097	55564	48	63	363	0	56038
5098	833	56	59	57281	0	58229
5099	297	70	50	56736	0	57153
5100	117	56946	94	841	0	57998
5101	57070	571	64	301	0	58006
5102	666	56836	79	177	0	57758
5103	57080	623	85	172	0	57960
5104	732	223	59	57273	0	58287
5105	335	108	56937	710	0	58090
5106	55776	68	642	292	0	56778
5107	54313	86	244	219	0	54862
5108	920	101	54018	152	0	55191
5109	385	128	53830	131	0	54474
5110	220	85	774	51985	0	53064
5111	56622	73	231	811	0	57737
5112	59408	91	93	365	0	59957
5113	61957	100	76	240	0	62373
5114	62014	71	93	210	0	62388
5115	1061	61079	90	253	0	62483
5116	63102	790	82	288	0	64262
5117	985	234	85	63025	0	64329
5118	453	128	91	64387	0	65059
5119	336	88	75	66174	0	66673
5120	271	113	91	66772	0	67247
5121	65365	132	103	1135	0	66735
5122	1011	98	81	68796	0	69986
5123	476	132	67636	1104	0	69348
5124	314	106	912	69492	0	70824
5125	283	95	327	70511	0	71216
5126	331	87	129	70208	0	70755
5127	337	78	122	69663	0	70200
5128	67718	104	129	1392	0	69343
5129	1154	68093	102	588	0	69937
5130	494	69026	131	333	0	69984
5131	385	1248	108	67764	0	69505
5132	67883	407	105	1135	0	69530
5133	69286	180	136	482	0	70084
5134	1471	132	120	69438	0	71161
5135	692	185	68062	1160	0	70099
5136	66810	149	997	557	0	68513
5137	1318	147	318	70681	0	72464
5138	652	154	70646	1254	0	72706
5139	65564	146	1090	612	0	67412
5140	1321	70387	373	448	0	72529
5141	78986	1097	150	353	0	80586
5142	1894	82407	174	387	0	84862
5143	881	1811	109	82092	0	84893
5144	528	84028	140	2003	0	86699
5145	470	2148	82	86763	0	89463
5146	81900	783	98	2371	0	85152
5147	1974	84089	130	1242	0	87435
5148	1066	1962	84423	550	0	88001
5149	595	877	1842	84748	0	88062
5150	515	350	85772	2227	0	88864
5151	511	223	2105	83154	0	85993
5152	467	214	749	86705	0	88135
5153	501	155	84422	2761	0	87839
5154	74583	172	2066	1346	0	78167
5155	2244	173	83276	636	0	86329
5156	1100	153	82332	491	0	84076
5157	540	81913	2557	566	0	85576
5158	542	1895	924	81472	0	84833
5159	411	791	375	82573	0	84150
5160	339	436	244	82408	0	83427
5161	420	272	186	83911	0	84789
5162	405	235	80873	3027	0	84540
5163	73400	224	2027	1386	0	77037
5164	2228	178	81232	787	0	84425
5165	1005	149	2044	79347	0	82545
5166	78186	137	832	2213	0	81368
5167	2024	78984	437	1328	0	82773
5168	965	2143	267	76880	0	80255
5169	73564	758	279	2056	0	76657
5170	1950	71875	227	1059	0	75111
5171	812	71960	192	566	0	73530
5172	69617	2199	201	407	0	72424
5173	1750	70637	194	392	0	72973
5174	68000	1842	231	353	0	70426
5175	1777	69547	202	407	0	71933
5176	69817	1839	179	404	0	72239
5177	70228	705	165	362	0	71460
5178	2235	70646	209	344	0	73434
5179	923	1751	197	69962	0	72833
5180	549	733	69079	1858	0	72219
5181	67159	380	1704	887	0	70130
5182	1854	285	662	67681	0	70482
5183	779	66613	356	1930	0	69678
5184	419	69159	278	941	0	70797
5185	333	2099	232	68615	0	71279
5186	67786	815	227	1985	0	70813
5187	1777	416	68308	929	0	71430
5188	822	249	1702	69003	0	71776
5189	444	206	719	70266	0	71635
5190	314	205	430	71427	0	72376
5191	324	193	293	69355	0	70165
5192	249	68247	299	2608	0	71403
5193	303	1725	243	69681	0	71952
5194	355	810	68034	2170	0	71369
5195	333	502	68046	1037	0	69918
5196	378	397	69045	640	0	70460
5197	334	353	2365	66679	0	69731
5198	65362	337	1005	1950	0	68654
5199	1902	370	65928	966	0	69166
5200	960	338	67115	598	0	69011
5201	555	343	2353	64621	0	67872
5202	65581	311	1039	2014	0	68945
5203	1833	65354	617	1167	0	68971
5204	65399	1862	406	772	0	68439
5205	2097	882	353	64756	0	68088
5206	1077	558	65486	1990	0	69111
5207	654	626	1843	61017	0	64140
5208	530	65430	922	2014	0	68896
5209	67610	1980	558	920	0	71068
5210	2035	962	67463	829	0	71289
5211	848	65909	1838	715	0	69310
5212	63659	2006	1052	699	0	67416
5213	2167	894	525	63614	0	67200
5214	1000	496	440	65015	0	66951
5215	64504	364	445	2650	0	67963
5216	65603	287	487	1291	0	67668
5217	67549	302	502	788	0	69141
5218	2969	331	412	63320	0	67032
5219	1258	63222	362	2301	0	67143
5220	63321	1896	358	1192	0	66767
5221	2088	63704	344	900	0	67036
5222	60719	2036	338	574	0	63667
5223	2093	59674	432	489	0	62688
5224	1028	2011	300	58458	0	61797
5225	59328	939	292	2013	0	62572
5226	60333	564	226	1073	0	62196
5227	60957	400	206	751	0	62314
5228	61385	367	210	580	0	62542
5229	61306	311	211	521	0	62349
5230	2881	384	58840	439	0	62544
5231	1341	378	1788	58170	0	61677
5232	798	357	59576	1873	0	62604
5233	690	326	59643	917	0	61576
5234	57884	379	2431	551	0	61245
5235	59397	339	1023	476	0	61235
5236	59546	402	508	356	0	60812
5237	2897	414	307	56411	0	60029
5238	55970	359	270	1877	0	58476
5239	2269	55332	291	1010	0	58902
5240	1165	56118	277	672	0	58232
5241	524	48327	143	356	0	49350
5242	42818	1366	294	242	0	44720
5243	1047	43903	188	316	0	45454
5244	42067	898	231	200	0	43396
5245	41472	388	111	200	0	42171
5246	1329	211	40999	209	0	42748
5247	682	142	870	39807	0	41501
5248	446	136	363	42336	0	43281
5249	42100	112	206	1178	0	43596
5250	42315	112	148	553	0	43128
5251	1384	127	125	41725	0	43361
5252	650	148	41365	1005	0	43168
5253	462	165	41851	504	0	42982
5254	399	137	1131	41691	0	43358
5255	423	131	434	41880	0	42868
5256	352	179	175	42751	0	43457
5257	40938	157	126	1292	0	42513
5258	41080	176	128	541	0	41925
5259	1358	40843	146	321	0	42668
5260	695	960	101	40548	0	42304
5261	476	459	122	40447	0	41504
5262	408	41072	146	1225	0	42851
5263	425	952	148	41268	0	42793
5264	41233	426	162	1113	0	42934
5265	1211	198	207	41052	0	42668
5266	705	149	192	41752	0	42798
5267	40609	155	133	1356	0	42253
5268	40739	154	157	656	0	41706
5269	41095	164	167	424	0	41850
5270	1713	377	201	39491	0	41782
5271	859	173	38074	993	0	40099
5272	561	231	37920	521	0	39233
5273	544	198	37536	349	0	38627
5274	425	36006	1145	393	0	37969
5275	34693	895	753	329	0	36670
5276	1121	416	34119	301	0	35957
5277	32771	220	777	289	0	34057
5278	1092	168	417	33055	0	34732
5279	33686	186	228	982	0	35082
5280	34194	142	177	596	0	35109
5281	1230	34267	168	390	0	36055
5282	35024	715	144	379	0	36262
5283	34927	340	172	397	0	35836
5284	1239	34813	208	432	0	36692
5285	695	717	240	35641	0	37293
5286	556	373	35559	925	0	37413
5287	482	192	762	34632	0	36068
5288	440	190	391	35556	0	36577
5289	35132	173	205	1246	0	36756
5290	1117	171	191	34462	0	35941
5291	638	35664	188	1026	0	37516
5292	460	872	166	35179	0	36677
5293	373	480	159	36490	0	37502
5294	504	284	35251	1229	0	37268
5295	468	35008	799	696	0	36971
5296	516	36176	389	432	0	37513
5297	34364	1048	226	402	0	36040
5298	1037	36084	224	515	0	37860
5299	657	875	254	35813	0	37599
5300	564	443	36030	1033	0	38070
5301	464	36295	892	637	0	38288
5302	36361	829	480	458	0	38128
5303	1079	462	323	36270	0	38134
5304	680	241	289	37323	0	38533
5305	482	209	36631	1291	0	38613
5306	448	218	922	35191	0	36779
5307	437	196	480	36646	0	37759
5308	35367	207	300	1369	0	37243
5309	32955	148	196	727	0	34026
5310	1247	32406	182	696	0	34531
5311	30192	665	138	425	0	31420
5312	885	30022	128	419	0	31454
5313	487	898	144	26999	0	28528
5314	344	28235	166	721	0	29466
5315	314	28905	145	475	0	29839
5316	27309	696	284	386	0	28675
5317	26438	283	151	355	0	27227
5318	687	26131	112	316	0	27246
5319	26304	450	146	294	0	27194
5320	26282	227	125	288	0	26922
5321	27002	138	139	322	0	27601
5322	694	144	121	27089	0	28048
5323	27183	158	138	571	0	28050
5324	602	181	26271	342	0	27396
5325	25446	157	440	283	0	26326
5326	615	164	26883	251	0	27913
5327	384	162	498	26522	0	27566
5328	274	187	217	27693	0	28371
5329	262	178	27485	646	0	28571
5330	25563	159	444	382	0	26548
5331	27237	144	231	261	0	27873
5332	691	141	28472	271	0	29575
5333	366	142	460	27739	0	28707
5334	292	130	232	28604	0	29258
5335	283	112	134	29101	0	29630
5336	28490	110	130	741	0	29471
5337	28657	129	139	400	0	29325
5338	755	128	141	26917	0	27941
5339	321	26251	106	537	0	27215
5340	189	25974	107	296	0	26566
5341	24320	422	87	196	0	25025
5342	429	24711	88	193	0	25421
5343	190	23752	68	135	0	24145
5344	163	296	49	21199	0	21707
5345	119	89	21153	249	0	21610
5346	77	20913	187	145	0	21322
5347	138	297	62	20485	0	20982
5348	63	20720	49	214	0	21046
5349	102	173	36	20461	0	20772
5350	20398	72	45	207	0	20722
5351	172	20695	36	105	0	21008
5352	20730	165	36	83	0	21014
5353	20184	71	23	80	0	20358
5354	223	63	19731	51	0	20068
5355	19235	60	155	72	0	19522
5356	208	63	40	20171	0	20482
5357	92	52	20479	167	0	20790
5358	59	20550	143	100	0	20852
5359	54	173	34	20433	0	20694
5360	45	41	27	20626	0	20739
5361	20368	40	20	165	0	20593
5362	167	36	20	20364	0	20587
5363	81	31	14	20488	0	20614
5364	20252	44	33	167	0	20496
5365	148	20188	34	114	0	20484
5366	19930	152	27	72	0	20181
5367	160	70	19795	51	0	20076
5368	17916	46	137	84	0	18183
5369	184	49	20584	49	0	20866
5370	86	20681	142	64	0	20973
5371	20984	138	48	60	0	21230
5372	20349	47	56	57	0	20509
5373	194	65	20377	53	0	20689
5374	110	49	20457	63	0	20679
5375	116	57	21239	44	0	21456
5376	68	21903	197	85	0	22253
5377	78	176	47	22122	0	22423
5378	81	85	24582	180	0	24928
5379	85	48	23732	66	0	23931
5380	63	52	323	23378	0	23816
5381	89	45	24067	285	0	24486
5382	22821	44	297	129	0	23291
5383	28356	41	104	90	0	28591
5384	569	43	27922	61	0	28595
5385	210	27720	460	113	0	28503
5386	119	435	157	27408	0	28119
5387	140	149	27785	468	0	28542
5388	75	27938	452	201	0	28666
5389	140	482	163	27706	0	28491
5390	27473	143	85	463	0	28164
5391	26730	59	53	159	0	27001
5392	516	27652	72	112	0	28352
5393	207	499	55	27687	0	28448
5394	98	147	70	28018	0	28333
5395	68	86	55	28012	0	28221
5396	76	51	36	28146	0	28309
5397	75	46	27513	611	0	28245
5398	103	65	435	27062	0	27665
5399	73	65	26862	512	0	27512
5400	39	26416	453	242	0	27150
5401	25778	409	165	125	0	26477
5402	381	27243	81	133	0	27838
5403	157	441	43	27362	0	28003
5404	147	162	41	27572	0	27922
5405	27104	75	44	558	0	27781
5406	397	51	50	26811	0	27309
5407	143	26698	50	486	0	27377
5408	80	387	42	27289	0	27798
5409	78	139	52	27446	0	27715
5410	26815	87	45	557	0	27504
5411	431	62	26014	231	0	26738
5412	148	25814	364	140	0	26466
5413	73	26665	129	112	0	26979
5414	54	474	50	25890	0	26468
5415	25545	167	28	393	0	26133
5416	350	25414	36	238	0	26038
5417	150	370	29	25724	0	26273
5418	105	153	25304	413	0	25975
5419	71	82	375	25307	0	25835
5420	25669	54	132	450	0	26305
5421	24938	60	70	201	0	25269
5422	475	61	39	24929	0	25504
5423	25279	49	45	453	0	25826
5424	24943	46	62	196	0	25247
5425	515	74	24849	102	0	25540
5426	23553	57	392	97	0	24099
5427	404	24494	147	122	0	25167
5428	24732	370	74	100	0	25276
5429	464	177	24105	68	0	24814
5430	181	73	386	24182	0	24822
5431	24987	42	177	440	0	25646
5432	449	66	23236	216	0	23967
5433	203	54	23535	128	0	23920
5434	122	57	539	22846	0	23564
5435	85	63	23924	462	0	24534
5436	23369	38	503	207	0	24117
5437	469	74	24258	99	0	24900
5438	206	56	496	24457	0	25215
5439	131	54	209	25549	0	25943
5440	26194	73	128	653	0	27048
5441	562	67	26399	275	0	27303
5442	248	47	27801	131	0	28227
5443	131	40	741	29233	0	30145
5444	124	63	29849	659	0	30695
5445	28956	50	719	256	0	29981
5446	659	51	284	29119	0	30113
5447	277	51	29856	673	0	30857
5448	161	51	703	29510	0	30425
5449	162	55	263	30503	0	30983
5450	30261	62	157	863	0	31343
5451	711	80	30260	331	0	31382
5452	29002	82	703	212	0	29999
5453	793	76	31051	163	0	32083
5454	30192	69	781	153	0	31195
5455	31159	79	293	133	0	31664
5456	30915	62	149	200	0	31326
5457	901	29906	140	208	0	31155
5458	30406	626	100	163	0	31295
5459	30589	211	89	191	0	31080
5460	919	99	92	30056	0	31166
5461	361	44	30078	760	0	31243
5462	28994	54	712	347	0	30107
5463	755	55	31008	217	0	32035
5464	334	63	751	30007	0	31155
5465	211	63	285	31454	0	32013
5466	30886	60	198	908	0	32052
5467	713	31617	138	412	0	32880
5468	329	652	110	31354	0	32445
5469	243	223	131	31727	0	32324
5470	148	123	31226	929	0	32426
5471	155	65	700	30858	0	31778
5472	189	65	286	31795	0	32335
5473	227	40	145	30231	0	30643
5474	137	30328	154	883	0	31502
5475	29704	600	122	324	0	30750
5476	29587	199	131	239	0	30156
5477	861	29620	98	211	0	30790
5478	27024	535	99	139	0	27797
5479	710	178	93	28200	0	29181
5480	316	100	29830	623	0	30869
5481	145	30146	632	294	0	31217
5482	122	30949	245	208	0	31524
5483	28026	446	207	100	0	28779
5484	29447	109	94	93	0	29743
5485	585	47	66	29711	0	30409
5486	190	42	69	30414	0	30715
5487	136	30	65	30483	0	30714
5488	29666	25	74	643	0	30408
5489	561	30	29525	200	0	30316
5490	29116	26	528	143	0	29813
5491	584	27	160	29812	0	30583
5492	204	48	118	29360	0	29730
5493	145	29585	91	647	0	30468
5494	123	460	99	30172	0	30854
5495	139	114	83	30702	0	31038
5496	169	80	30586	650	0	31485
5497	134	30550	536	267	0	31487
5498	31261	479	173	205	0	32118
5499	30823	122	127	167	0	31239
5500	31778	72	100	140	0	32090
5501	31814	59	108	168	0	32149
5502	712	73	30487	137	0	31409
5503	29921	53	537	138	0	30649
5504	648	58	31019	149	0	31874
5505	270	49	563	29871	0	30753
5506	186	31246	202	592	0	32226
5507	205	487	136	31448	0	32276
5508	193	129	110	31975	0	32407
5509	199	138	31504	663	0	32504
5510	29394	69	550	356	0	30369
5511	31053	72	198	236	0	31559
5512	682	30698	146	247	0	31773
5513	277	504	31126	217	0	32124
5514	215	159	548	30991	0	31913
5515	214	118	31536	630	0	32498
5516	230	114	31172	266	0	31782
5517	261	90	627	30829	0	31807
5518	264	112	31095	632	0	32103
5519	241	95	555	30853	0	31744
5520	278	97	32071	680	0	33126
5521	249	105	578	31924	0	32856
5522	32553	90	184	742	0	33569
5523	32620	82	167	323	0	33192
5524	32363	91	95	298	0	32847
5525	32115	85	130	255	0	32585
5526	721	32353	140	288	0	33502
5527	328	535	111	32058	0	33032
5528	270	181	132	32636	0	33219
5529	244	160	32088	772	0	33264
5530	228	158	553	31465	0	32404
5531	190	143	31780	718	0	32831
5532	161	118	31052	340	0	31671
5533	29599	87	615	318	0	30619
5534	565	32085	259	266	0	33175
5535	32149	496	161	221	0	33027
5536	32058	186	130	212	0	32586
5537	681	32738	142	245	0	33806
5538	32604	437	117	266	0	33424
5539	633	173	32682	171	0	33659
5540	246	32394	461	256	0	33357
5541	32258	386	224	211	0	33079
5542	520	130	31251	177	0	32078
5543	28762	92	341	147	0	29342
5544	366	30282	132	164	0	30944
5545	30198	304	119	162	0	30783
5546	29896	83	79	153	0	30211
5547	379	29738	101	157	0	30375
5548	146	29744	102	128	0	30120
5549	135	30626	99	128	0	30988
5550	139	332	122	30664	0	31257
5551	94	90	108	30939	0	31231
5552	30943	62	132	405	0	31542
5553	30076	62	141	208	0	30487
5554	380	64	30359	155	0	30958
5555	160	53	29635	119	0	29967
5556	139	55	30618	119	0	30931
5557	129	39	419	30240	0	30827
5558	172	65	31228	376	0	31841
5559	142	40	369	30866	0	31417
5560	31416	46	113	404	0	31979
5561	435	57	31735	119	0	32346
5562	30559	57	363	150	0	31129
5563	31624	58	126	116	0	31924
5564	424	75	32261	122	0	32882
5565	125	33008	374	178	0	33685
5566	112	319	150	33580	0	34161
5567	120	106	33483	418	0	34127
5568	115	76	416	32923	0	33530
5569	106	62	167	35937	0	36272
5570	35259	47	127	465	0	35898
5571	482	74	102	35278	0	35936
5572	198	87	35408	454	0	36147
5573	167	84	428	35195	0	35874
5574	35887	70	149	467	0	36573
5575	481	36217	118	199	0	37015
5576	36372	422	139	110	0	37043
5577	540	241	154	36244	0	37179
5578	225	103	36676	429	0	37433
5579	215	85	35434	134	0	35868
5580	220	61	34704	109	0	35094
5581	75	33484	469	106	0	34134
5582	32542	396	402	104	0	33444
5583	347	31783	103	96	0	32329
5584	29991	266	79	63	0	30399
5585	269	30077	33	73	0	30452
5586	71	272	31	30179	0	30553
5587	48	59	34	30617	0	30758
5588	46	33	25	30484	0	30588
5589	35	30464	48	362	0	30909
5590	63	285	31	32187	0	32566
5591	55	63	31	36491	0	36640
5592	38498	40	59	522	0	39119
5593	579	40	41	40611	0	41271
5594	132	48	42629	639	0	43448
5595	41388	34	675	151	0	42248
5596	43047	37	139	103	0	43326
5597	777	43459	82	132	0	44450
5598	43674	683	55	77	0	44489
5599	44399	144	46	89	0	44678
5600	864	73	52	43746	0	44735
5601	248	56	68	44820	0	45192
5602	163	43	34	45847	0	46087
5603	45399	46	54	955	0	46454
5604	45710	59	58	251	0	46078
5605	982	60	45265	120	0	46427
5606	44417	42	829	118	0	45406
5607	45371	40	184	114	0	45709
5608	45565	55	105	132	0	45857
5609	993	70	44343	123	0	45529
5610	317	55	44718	92	0	45182
5611	174	41	938	44437	0	45590
5612	166	70	45546	866	0	46648
5613	155	49	856	44305	0	45365
5614	231	90	225	40352	0	40898
5615	141	45266	147	876	0	46430
5616	45417	772	138	263	0	46590
5617	938	202	46058	205	0	47403
5618	45803	115	876	171	0	46965
5619	1036	95	240	47119	0	48490
5620	46015	85	150	943	0	47193
5621	1011	45872	123	369	0	47375
5622	318	47590	116	325	0	48349
5623	278	1044	99	47059	0	48480
5624	226	236	113	48011	0	48586
5625	284	121	47109	1165	0	48679
5626	285	91	931	46704	0	48011
5627	45779	77	294	1088	0	47238
5628	1039	45998	191	461	0	47689
5629	479	895	46069	238	0	47681
5630	342	244	1007	45754	0	47347
5631	342	126	46651	1020	0	48139
5632	283	80	1066	45808	0	47237
5633	254	95	47102	1107	0	48558
5634	260	110	46241	383	0	46994
5635	289	100	1129	45540	0	47058
5636	46299	143	385	1105	0	47932
5637	45994	129	211	373	0	46707
5638	45088	127	195	263	0	45673
5639	1202	44596	188	310	0	46296
5640	44971	925	149	254	0	46299
5641	44824	245	167	280	0	45516
5642	1277	164	43737	275	0	45453
5643	445	43376	933	349	0	45103
5644	403	1033	313	42902	0	44651
5645	43169	276	199	1064	0	44708
5646	1027	43290	222	467	0	45006
5647	44614	923	227	342	0	46106
5648	45083	258	174	313	0	45828
5649	44515	203	213	268	0	45199
5650	44199	183	188	268	0	44838
5651	1258	152	197	43040	0	44647
5652	43612	130	195	1116	0	45053
5653	1144	127	206	42701	0	44178
5654	408	42574	235	1135	0	44352
5655	333	869	229	43170	0	44601
5656	42830	227	232	1104	0	44393
5657	1113	134	42914	479	0	44640
5658	508	113	982	42753	0	44356
5659	42674	98	312	1079	0	44163
5660	1157	42384	248	478	0	44267
5661	42526	920	215	286	0	43947
5662	43319	242	222	273	0	44056
5663	1226	43527	220	330	0	45303
5664	43029	906	256	249	0	44440
5665	1168	279	41642	243	0	43332
5666	508	176	41188	268	0	42140
5667	39606	190	1048	321	0	41165
5668	1104	166	41293	270	0	42833
5669	532	184	835	37448	0	38999
5670	429	39445	287	804	0	40965
5671	39582	799	230	286	0	40897
5672	1021	39183	179	288	0	40671
5673	498	40597	203	301	0	41599
5674	469	911	150	41720	0	43250
5675	375	240	158	42191	0	42964
5676	330	192	169	42004	0	42695
5677	345	140	166	41887	0	42538
5678	306	157	40758	1022	0	42243
5679	288	154	776	39563	0	40781
5680	338	130	244	40619	0	41331
5681	39749	166	202	964	0	41081
5682	918	181	181	39818	0	41098
5683	439	150	39201	872	0	40662
5684	37364	137	777	339	0	38617
5685	986	185	241	39027	0	40439
5686	486	156	40662	818	0	42122
5687	363	251	805	39111	0	40530
5688	331	40678	288	763	0	42060
5689	40376	738	232	318	0	41664
5690	905	213	39364	219	0	40701
5691	276	34527	578	187	0	35568
5692	32319	423	348	167	0	33257
5693	395	30010	132	128	0	30665
5694	145	28344	93	190	0	28772
5695	27872	323	210	84	0	28489
5696	304	27403	91	90	0	27888
5697	130	27466	52	138	0	27786
5698	186	340	100	26899	0	27525
5699	149	81	26847	235	0	27312
5700	106	27709	220	116	0	28151
5701	124	279	66	26831	0	27300
5702	82	26781	38	220	0	27121
5703	26399	164	61	95	0	26719
5704	204	58	26032	105	0	26399
5705	85	106	170	26100	0	26461
5706	27267	44	73	215	0	27599
5707	178	35	36	27421	0	27670
5708	90	43	27369	221	0	27723
5709	25404	31	164	112	0	25711
5710	27353	32	55	94	0	27534
5711	212	29001	52	67	0	29332
5712	91	167	31	29068	0	29357
5713	75	63	34	29608	0	29780
5714	29535	42	40	194	0	29811
5715	28788	51	38	77	0	28954
5716	228	62	29807	41	0	30138
5717	81	29057	162	60	0	29360
5718	29172	129	38	50	0	29389
5719	150	33	26	29036	0	29245
5720	66	25	29863	134	0	30088
5721	41	61	28499	50	0	28651
5722	73	281	112	28320	0	28786
5723	29408	11	20	95	0	29534
5724	76	29011	22	67	0	29176
5725	31643	64	20	125	0	31852
5726	74	23	11	32180	0	32288
5727	31	14	5	32507	0	32557
5728	31	18	11	32885	0	32945
5729	32669	14	22	108	0	32813
5730	71	33256	24	43	0	33394
5731	38	64	13	33755	0	33870
5732	20	24	14	33708	0	33766
5733	35	19	33576	89	0	33719
5734	28	11	77	32222	0	32338
5735	33	48	33935	77	0	34093
5736	17	32843	69	70	0	32999
5737	19	71	8	33402	0	33500
5738	32516	14	20	76	0	32626
5739	61	19	32773	14	0	32867
5740	25	8	48	32631	0	32712
5741	18	20	32830	63	0	32931
5742	29733	3	59	59	0	29854
5743	65	28	33475	21	0	33589
5744	24	35	44	31878	0	31981
5745	32865	6	8	70	0	32949
5746	73	29381	50	61	0	29565
5747	31345	54	11	24	0	31434
5748	68	29813	26	63	0	29970
5749	39	54	14	31722	0	31829
5750	33	32	31401	71	0	31537
5751	40	36	30533	35	0	30644
5752	18	14	76	31087	0	31195
5753	32478	9	21	123	0	32631
5754	31556	18	20	50	0	31644
5755	87	13	14	31790	0	31904
5756	29	10	19	32803	0	32861
5757	31766	19	23	85	0	31893
5758	77	30953	25	62	0	31117
5759	23	33100	15	76	0	33214
5760	32917	82	19	46	0	33064
5761	106	50	31985	29	0	32170
5762	60	12	79	31057	0	31208
5763	36	24	32876	102	0	33038
5764	37	10	87	31625	0	31759
5765	45	24	33619	90	0	33778
5766	42	40	32762	41	0	32885
5767	33	30	88	33144	0	33295
5768	19	32388	41	118	0	32566
5769	34429	81	15	48	0	34573
5770	93	34289	15	55	0	34452
5771	37	106	18	34770	0	34931
5772	34987	27	22	133	0	35169
5773	115	23	20	35876	0	36034
5774	35910	14	15	175	0	36114
5775	35642	18	32	60	0	35752
5776	36073	26	20	43	0	36162
5777	117	34850	25	60	0	35052
5778	36893	101	17	70	0	37081
5779	112	85	15	37194	0	37406
5780	38809	20	33	194	0	39056
5781	147	13	29	39666	0	39855
5782	39796	12	26	221	0	40055
5783	40303	22	28	80	0	40433
5784	222	39722	36	109	0	40089
5785	76	193	21	44511	0	44801
5786	58	71	13	44437	0	44579
5787	32	47080	35	423	0	47570
5788	41	378	20	48650	0	49089
5789	48003	146	55	471	0	48675
5790	49905	48	22	267	0	50242
5791	49577	31	45	118	0	49771
5792	643	60	51275	70	0	52048
5793	51933	26	455	132	0	52546
5794	55118	28	185	80	0	55411
5795	55549	22	66	103	0	55740
5796	715	55042	54	116	0	55927
5797	289	477	37	56065	0	56868
5798	116	215	33	57143	0	57507
5799	82	81	29	57010	0	57202
5800	107	61	54882	791	0	55841
5801	85	43	518	55216	0	55862
5802	55574	32	235	664	0	56505
5803	567	35	81	56580	0	57263
5804	299	31	48	58289	0	58667
5805	187	55	57245	803	0	58290
5806	88	55948	581	374	0	56991
5807	58555	571	229	187	0	59542
5808	638	241	65	58556	0	59500
5809	58387	76	61	682	0	59206
5810	692	76	57610	306	0	58684
5811	53593	39	583	228	0	54443
5812	661	58785	267	198	0	59911
5813	356	577	58341	122	0	59396
5814	214	227	58815	98	0	59354
5815	128	131	790	55892	0	56941
5816	167	72	61006	631	0	61876
5817	109	60951	624	383	0	62067
5818	138	545	243	61395	0	62321
5819	116	245	103	62600	0	63064
5820	118	100	62	62892	0	63172
5821	61375	64	73	875	0	62387
5822	599	61795	92	463	0	62949
5823	328	563	52	62824	0	63767
5824	174	293	48	63769	0	64284
5825	61714	109	65	899	0	62787
5826	647	61696	68	484	0	62895
5827	62528	587	68	281	0	63464
5828	62328	276	71	209	0	62884
5829	61752	116	82	250	0	62200
5830	971	91	61249	175	0	62486
5831	482	79	581	58956	0	60098
5832	295	61120	291	708	0	62414
5833	220	62673	149	423	0	63465
5834	232	843	87	60299	0	61461
5835	184	62338	124	697	0	63343
5836	64233	659	117	531	0	65540
5837	710	363	63499	266	0	64838
5838	61706	148	631	297	0	62782
5839	65292	120	309	294	0	66015
5840	978	134	144	65303	0	66559
5841	65800	127	116	767	0	66810
5842	796	68453	157	558	0	69964
5843	70288	662	127	418	0	71495
5844	70341	350	158	343	0	71192
5845	76141	230	159	378	0	76908
5846	1412	161	76432	276	0	78281
5847	778	190	76784	312	0	78064
5848	507	174	1233	76448	0	78362
5849	394	76828	585	1103	0	78910
5850	377	79188	272	676	0	80513
5851	328	1288	206	78125	0	79947
5852	78643	607	186	1200	0	80636
5853	1057	295	192	78618	0	80162
5854	598	198	215	80205	0	81216
5855	79085	185	187	1583	0	81040
5856	1090	78866	228	1116	0	81300
5857	721	997	78439	572	0	80729
5858	533	587	76702	426	0	78248
5859	79519	276	1353	435	0	81583
5860	1149	259	621	78696	0	80725
5861	767	215	81231	1165	0	83378
5862	424	198	1030	78867	0	80519
5863	414	205	530	80394	0	81543
5864	348	208	325	81814	0	82695
5865	395	225	183	79520	0	80323
5866	323	78343	246	1676	0	80588
5867	345	984	248	79537	0	81114
5868	78783	540	282	1284	0	80889
5869	1053	78270	315	856	0	80494
5870	80139	1011	252	658	0	82060
5871	81069	617	211	486	0	82383
5872	81438	359	253	479	0	82529
5873	1632	308	78461	401	0	80802
5874	78436	278	1011	480	0	80205
5875	81333	258	560	386	0	82537
5876	81233	254	326	401	0	82214
5877	81361	185	231	429	0	82206
5878	1571	79792	269	505	0	82137
5879	79672	1019	241	375	0	81307
5880	1375	642	78450	346	0	80813
5881	756	375	890	76892	0	78913
5882	585	225	510	79146	0	80466
5883	80213	183	314	1378	0	82088
5884	1123	79325	251	847	0	81546
5885	76583	806	160	400	0	77949
5886	1007	77112	184	440	0	78743
5887	75420	773	112	340	0	76645
5888	74476	347	106	237	0	75166
5889	981	83110	144	339	0	84574
5890	83942	868	113	206	0	85129
5891	87140	398	184	189	0	87911
5892	1416	83094	163	279	0	84952
5893	545	85614	168	243	0	86570
5894	90739	1253	333	204	0	92529
5895	1504	508	101	92428	0	94541
5896	93674	282	94	1435	0	95485
5897	96910	192	91	615	0	97808
5898	98708	130	66	395	0	99299
5899	98151	116	88	276	0	98631
5900	2060	95208	153	336	0	97757
5901	758	98150	158	445	0	99511
5902	98800	1717	146	240	0	100903
5903	1687	723	98015	149	0	100574
5904	749	415	1476	95736	0	98376
5905	385	204	621	99342	0	100552
5906	97343	158	286	1972	0	99759
5907	1519	97105	169	1050	0	99843
5908	714	1465	156	97385	0	99720
5909	398	627	108	100258	0	101391
5910	98719	268	96	2263	0	101346
5911	1699	213	94	99332	0	101338
5912	99050	192	120	1932	0	101294
5913	99213	211	123	777	0	100324
5914	99303	191	126	498	0	100118
5915	2428	187	135	97703	0	100453
5916	1046	192	114	98102	0	99454
5917	717	194	104548	2166	0	107625
5918	568	224	102520	881	0	104193
5919	102642	157	2682	498	0	105979
5920	2256	141	1016	106900	0	110313
5921	1215	177	114506	2243	0	118141
5922	717	217	115249	976	0	117159
5923	499	207	3207	114255	0	118168
5924	639	235	115108	2556	0	118538
5925	514	300	2687	112861	0	116362
5926	481	213	1076	115507	0	117277
5927	522	219	114837	3452	0	119030
5928	548	184	2468	114278	0	117478
5929	516	191	1076	115634	0	117417
5930	580	179	392	118162	0	119313
5931	622	291	114654	3784	0	119351
5932	621	249	2442	116406	0	119718
5933	116260	238	1031	2990	0	120519
5934	2854	115704	467	1616	0	120641
5935	118196	2578	275	677	0	121726
5936	3389	1206	115330	397	0	120322
5937	115924	481	2615	433	0	119453
5938	118394	315	1186	399	0	120294
5939	117800	331	552	407	0	119090
5940	4112	363	343	114484	0	119302
5941	1972	304	354	117250	0	119880
5942	1037	263	109631	3862	0	114793
5943	102627	205	2723	1753	0	107308
5944	3187	106505	1302	988	0	111982
5945	1274	100910	542	738	0	103464
5946	721	103577	399	684	0	105381
5947	874	3285	481	98724	0	103364
5948	98150	1148	399	2646	0	102343
5949	98865	419	402	1404	0	101090
5950	3508	276	96874	845	0	101503
5951	1568	259	2491	96092	0	100410
5952	840	267	1093	98195	0	100395
5953	733	318	95935	3552	0	100538
5954	682	316	94903	1657	0	97558
5955	92296	254	3318	998	0	96866
5956	2653	94338	1372	990	0	99353
5957	95640	2314	694	825	0	99473
5958	96560	1021	528	750	0	98859
5959	3671	449	473	93425	0	98018
5960	1800	273	415	96358	0	98846
5961	93208	294	445	3605	0	97552
5962	2981	264	473	93415	0	97133
5963	1559	263	520	94823	0	97165
5964	92961	220	575	3698	0	97454
5965	2990	237	520	93392	0	97139
5966	94071	200	543	3187	0	98001
5967	95079	234	597	1774	0	97684
5968	3638	295	92558	1121	0	97612
5969	93065	287	2727	974	0	97053
5970	93592	263	1437	967	0	96259
5971	93094	263	833	988	0	95178
5972	3823	290	85568	984	0	90665
5973	87809	270	2637	964	0	91680
5974	2958	87725	1350	1253	0	93286
5975	89640	2275	784	1076	0	93775
5976	91001	950	743	1053	0	93747
5977	3705	359	677	88826	0	93567
5978	1895	228	604	89600	0	92327
5979	1050	89122	656	3912	0	94740
5980	1022	2391	590	89681	0	93684
5981	1070	1062	621	91864	0	94617
5982	89345	456	639	3952	0	94392
5983	3207	335	615	88553	0	92710
5984	1924	290	506	89592	0	92312
5985	1273	341	569	88042	0	90225
5986	1035	84477	643	4047	0	90202
5987	82417	2326	664	2005	0	87412
5988	3112	83406	695	1378	0	88591
5989	74573	2253	604	913	0	78343
5990	2966	969	71660	856	0	76451
5991	67359	442	2257	848	0	70906
5992	2788	297	68125	913	0	72123
5993	1545	65064	2271	904	0	69784
5994	59487	1830	2162	686	0	64165
5995	58065	859	670	678	0	60272
5996	2589	55665	411	745	0	59410
5997	1337	55068	387	707	0	57499
5998	52575	1891	420	654	0	55540
5999	53247	828	350	594	0	55019
6000	2482	332	277	51756	0	54847
6001	1336	341	291	53398	0	55366
6002	933	311	51408	2285	0	54937
6003	49718	304	1459	1177	0	52658
6004	2028	265	721	49312	0	52326
6005	1204	50294	407	1806	0	53711
6006	879	1419	218	50526	0	53042
6007	788	701	194	51120	0	52803
6008	720	395	49080	2310	0	52505
6009	747	358	1390	49437	0	51932
6010	48260	274	683	1896	0	51113
6011	1788	47000	341	1144	0	50273
6012	1040	47506	276	631	0	49453
6013	47079	1846	243	441	0	49609
6014	47504	844	289	489	0	49126
6015	47355	431	224	441	0	48451
6016	2371	44992	284	474	0	48121
6017	756	38349	201	349	0	39655
6018	39889	1166	273	280	0	41608
6019	40103	536	343	303	0	41285
6020	1548	37988	167	334	0	40037
6021	264	30189	68	145	0	30666
6022	29107	699	217	129	0	30152
6023	722	199	54	28684	0	29659
6024	29123	103	37	643	0	29906
6025	722	135	37	28260	0	29154
6026	257	29550	50	640	0	30497
6027	171	29784	47	225	0	30227
6028	30637	734	92	125	0	31588
6029	31580	248	73	115	0	32016
6030	31584	104	56	123	0	31867
6031	896	31089	57	167	0	32209
6032	301	638	29050	71	0	30060
6033	104	29360	573	97	0	30134
6034	28609	747	254	89	0	29699
6035	27863	156	66	67	0	28152
6036	709	93	27019	108	0	27929
6037	198	26586	520	75	0	27379
6038	131	568	157	26627	0	27483
6039	114	160	43	25334	0	25651
6040	97	25553	38	601	0	26289
6041	163	575	25831	137	0	26706
6042	25963	159	530	84	0	26736
6043	622	101	122	26739	0	27584
6044	26867	96	42	583	0	27588
6045	27178	85	50	181	0	27494
6046	730	92	46	28067	0	28935
6047	254	92	44	30225	0	30615
6048	161	96	40	30690	0	30987
6049	134	109	40	30919	0	31202
6050	29919	108	45	944	0	31016
6051	30363	89	46	294	0	30792
6052	1009	93	29974	156	0	31232
6053	327	114	710	29948	0	31099
6054	183	108	217	30910	0	31418
6055	193	127	83	31126	0	31529
6056	206	119	29893	998	0	31216
6057	203	95	724	29711	0	30733
6058	29490	92	224	814	0	30620
6059	823	101	87	29737	0	30748
6060	324	142	29487	896	0	30849
6061	195	112	744	29729	0	30780
6062	191	118	29999	872	0	31180
6063	30251	96	753	361	0	31461
6064	876	110	231	30646	0	31863
6065	30851	116	115	846	0	31928
6066	30726	110	73	358	0	31267
6067	1038	120	72	30294	0	31524
6068	31137	97	71	954	0	32259
6069	926	118	85	30021	0	31150
6070	401	32065	90	874	0	33430
6071	33345	796	69	321	0	34531
6072	33603	277	82	207	0	34169
6073	33650	157	76	197	0	34080
6074	1150	114	76	33073	0	34413
6075	409	115	79	33517	0	34120
6076	255	125	77	33861	0	34318
6077	277	129	32079	1161	0	33646
6078	289	31464	800	477	0	33030
6079	262	814	227	31046	0	32349
6080	270	272	30783	875	0	32200
6081	30104	121	756	402	0	31383
6082	912	86	246	30933	0	32177
6083	418	112	30661	900	0	32091
6084	31032	97	792	484	0	32405
6085	915	98	272	31999	0	33284
6086	425	87	112	32584	0	33208
6087	275	86	112	32957	0	33430
6088	32469	104	126	1119	0	33818
6089	32961	82	113	490	0	33646
6090	32445	80	129	304	0	32958
6091	1028	30896	130	325	0	32379
6092	355	31864	143	302	0	32664
6093	31809	810	139	268	0	33026
6094	920	238	31657	302	0	33117
6095	407	109	732	30994	0	32242
6096	308	70	257	32050	0	32685
6097	31292	63	123	1039	0	32517
6098	30763	69	86	457	0	31375
6099	949	30820	113	384	0	32266
6100	391	668	112	31276	0	32447
6101	323	204	30989	890	0	32406
6102	332	94	31257	442	0	32125
6103	276	58	847	31455	0	32636
6104	235	73	281	32621	0	33210
6105	31636	68	134	1129	0	32967
6106	865	74	111	32324	0	33374
6107	33244	52	164	1042	0	34502
6108	33475	58	153	497	0	34183
6109	991	80	33577	399	0	35047
6110	32961	56	702	354	0	34073
6111	33692	51	281	318	0	34342
6112	33892	61	169	348	0	34470
6113	990	33222	167	375	0	34754
6114	360	33635	175	354	0	34524
6115	313	815	141	33270	0	34539
6116	290	184	32866	943	0	34283
6117	265	31442	636	470	0	32813
6118	361	593	233	29166	0	30353
6119	240	165	146	28290	0	28841
6120	268	28707	90	684	0	29749
6121	28970	447	93	327	0	29837
6122	29151	171	117	246	0	29685
6123	774	99	29460	245	0	30578
6124	28587	47	462	265	0	29361
6125	619	66	28644	221	0	29550
6126	26086	72	467	218	0	26843
6127	600	86	27923	216	0	28825
6128	300	26983	435	173	0	27891
6129	320	321	278	25955	0	26874
6130	199	132	107	26513	0	26951
6131	26376	58	81	548	0	27063
6132	26461	34	114	266	0	26875
6133	26188	69	74	213	0	26544
6134	498	63	26775	208	0	27544
6135	261	53	350	26641	0	27305
6136	192	61	171	27671	0	28095
6137	27521	53	94	558	0	28226
6138	448	27773	107	295	0	28623
6139	29550	306	83	279	0	30218
6140	465	149	88	30138	0	30840
6141	306	79	69	31299	0	31753
6142	223	63	47	31490	0	31823
6143	181	75	65	31566	0	31887
6144	201	160	61	31382	0	31804
6145	173	30635	78	542	0	31428
6146	127	29689	57	255	0	30128
6147	54	28316	42	99	0	28511
6148	101	193	27	28250	0	28571
6149	95	56	27678	142	0	27971
6150	24299	39	143	98	0	24579
6151	161	28810	56	67	0	29094
6152	79	127	35	28966	0	29207
6153	68	37	36	29238	0	29379
6154	29617	33	33	199	0	29882
6155	28908	27	33	87	0	29055
6156	28628	31	24	88	0	28771
6157	210	27	24	30461	0	30722
6158	108	16	30968	180	0	31272
6159	89	41	31956	85	0	32171
6160	80	18	164	32413	0	32675
6161	94	24	32785	190	0	33093
6162	30742	28	176	89	0	31035
6163	208	27	42	32270	0	32547
6164	98	37	32683	189	0	33007
6165	84	31	158	31876	0	32149
6166	77	40	33639	199	0	33955
6167	88	32	35191	92	0	35403
6168	118	113	210	36864	0	37305
6169	60	48	39257	269	0	39634
6170	63	52	37910	117	0	38142
6171	33	34053	427	92	0	34605
6172	83	332	139	38495	0	39049
6173	39741	90	47	414	0	40292
6174	300	44	23	39768	0	40135
6175	110	20	18	41198	0	41346
6176	71	31	40313	430	0	40845
6177	33850	17	347	239	0	34453
6178	317	17	95	41271	0	41700
6179	112	11	45	42171	0	42339
6180	40652	13	22	442	0	41129
6181	329	16	15	41784	0	42144
6182	41427	9	28	409	0	41873
6183	41658	14	22	151	0	41845
6184	41371	10	18	111	0	41510
6185	424	40083	29	94	0	40630
6186	41198	299	27	67	0	41591
6187	335	40861	27	84	0	41307
6188	128	339	30	40971	0	41468
6189	41661	106	24	353	0	42144
6190	325	41215	33	207	0	41780
6191	41696	337	25	85	0	42143
6192	359	41297	46	123	0	41825
6193	40431	366	29	47	0	40873
6194	369	40512	43	94	0	41018
6195	138	41875	37	80	0	42130
6196	88	44086	35	95	0	44304
6197	57	461	35	42378	0	42931
6198	48	44667	32	395	0	45142
6199	63	382	30	44180	0	44655
6200	43	124	34	44740	0	44941
6201	55	72	25	44574	0	44726
6202	58	39	23	44483	0	44603
6203	42717	28	37	538	0	43320
6204	43841	39	27	228	0	44135
6205	530	54	42860	110	0	43554
6206	44392	34	409	165	0	45000
6207	47272	39	136	98	0	47545
6208	48737	46	90	94	0	48967
6209	741	63	47181	71	0	48056
6210	270	85	47317	54	0	47726
6211	45763	47	693	106	0	46609
6212	714	65	49712	102	0	50593
6213	209	51722	671	168	0	52770
6214	153	690	181	52637	0	53661
6215	54056	184	103	767	0	55110
6216	54343	91	65	252	0	54751
6217	54690	59	61	171	0	54981
6218	972	52	72	53698	0	54794
6219	309	52	59	55489	0	55909
6220	185	77	55719	947	0	56928
6221	130	44	735	55576	0	56485
6222	122	51	217	57681	0	58071
6223	56422	57	120	971	0	57570
6224	808	56659	110	396	0	57973
6225	57803	770	72	207	0	58852
6226	883	210	68	57771	0	58932
6227	57044	119	94	874	0	58131
6228	56946	77	84	308	0	57415
6229	54415	89	74	232	0	54810
6230	997	55323	83	215	0	56618
6231	329	56927	97	221	0	57574
6232	198	949	94	56979	0	58220
6233	57307	252	102	894	0	58555
6234	857	133	106	56266	0	57362
6235	314	95	79	57539	0	58027
6236	255	111	56794	1040	0	58200
6237	201	97	777	56127	0	57202
6238	213	100	214	57126	0	57653
6239	201	81	134	56558	0	56974
6240	232	108	55299	1120	0	56759
6241	275	125	53926	422	0	54748
6242	197	54264	920	353	0	55734
6243	54704	793	310	220	0	56027
6244	948	254	153	54888	0	56243
6245	418	158	55504	886	0	56966
6246	310	131	785	54439	0	55665
6247	303	105	240	58954	0	59602
6248	58196	110	167	1110	0	59583
6249	58330	100	140	448	0	59018
6250	1081	58124	140	313	0	59658
6251	57928	809	138	236	0	59111
6252	57749	251	137	225	0	58362
6253	1168	179	131	57058	0	58536
6254	521	165	57036	920	0	58642
6255	309	57205	786	450	0	58750
6256	57625	817	274	309	0	59025
6257	58631	252	167	298	0	59348
6258	1100	59485	141	328	0	61054
6259	501	853	106	60992	0	62452
6260	63407	253	109	1133	0	64902
6261	63791	154	128	481	0	64554
6262	1286	138	151	63740	0	65315
6263	65401	122	183	1190	0	66896
6264	68193	119	138	487	0	68937
6265	68587	131	181	366	0	69265
6266	1591	174	69261	307	0	71333
6267	534	67628	1114	388	0	69664
6268	376	68408	288	353	0	69425
6269	65402	1138	212	290	0	67042
6270	1192	66170	160	341	0	67863
6271	490	1070	65699	284	0	67543
6272	370	288	1044	65427	0	67129
6273	65891	182	257	1238	0	67568
6274	1274	147	140	65847	0	67408
6275	66544	138	130	1294	0	68106
6276	66819	133	158	455	0	67565
6277	66396	139	156	406	0	67097
6278	1383	65393	177	388	0	67341
6279	444	69639	161	393	0	70637
6280	69743	1177	142	351	0	71413
6281	69561	312	111	330	0	70314
6282	69729	192	143	295	0	70359
6283	1425	173	153	68636	0	70387
6284	68125	153	155	1296	0	69729
6285	1262	66924	178	553	0	68917
6286	469	69840	139	411	0	70859
6287	417	1194	128	69029	0	70768
6288	445	310	68336	1268	0	70359
6289	429	260	67571	415	0	68675
6290	416	179	1161	67770	0	69526
6291	423	220	68925	1206	0	70774
6292	412	197	1082	68410	0	70101
6293	69765	197	278	1250	0	71490
6294	1346	204	170	69337	0	71057
6295	68736	176	160	1235	0	70307
6296	1283	67190	207	484	0	69164
6297	630	1159	68457	326	0	70572
6298	456	342	1047	66150	0	67995
6299	436	241	254	70071	0	71002
6300	473	219	69906	1407	0	72005
6301	448	204	1065	66466	0	68183
6302	415	71140	305	1212	0	73072
6303	531	1103	177	71701	0	73512
6304	495	323	139	72664	0	73621
6305	538	237	154	75116	0	76045
6306	547	194	73246	1529	0	75516
6307	455	218	68222	439	0	69334
6308	61365	152	1282	375	0	63174
6309	1310	184	67017	242	0	68753
6310	420	67058	1081	286	0	68845
6311	67392	941	322	236	0	68891
6312	1077	68101	186	250	0	69614
6313	66153	901	299	242	0	67595
6314	66209	257	216	210	0	66892
6315	65580	190	124	236	0	66130
6316	66117	163	207	233	0	66720
6317	1105	64291	130	302	0	65828
6318	422	65428	140	260	0	66250
6319	65539	979	138	205	0	66861
6320	1099	318	63727	210	0	65354
6321	448	195	830	61990	0	63463
6322	341	162	267	64707	0	65477
6323	340	175	63808	1035	0	65358
6324	56864	171	881	412	0	58328
6325	64142	166	295	262	0	64865
6326	63170	211	185	236	0	63802
6327	1179	62503	172	291	0	64145
6328	65421	920	196	352	0	66889
6329	1102	362	220	62444	0	64128
6330	450	69370	235	981	0	71036
6331	71096	1081	220	379	0	72776
6332	71277	410	185	314	0	72186
6333	76014	296	195	294	0	76799
6334	1762	249	173	74516	0	76700
6335	737	247	175	75066	0	76225
6336	456	73124	190	1641	0	75411
6337	590	1235	73958	605	0	76388
6338	471	442	1217	73824	0	75954
6339	451	259	461	74962	0	76133
6340	434	211	276	77824	0	78745
6341	430	228	75585	1776	0	78019
6342	71632	233	1308	733	0	73906
6343	1510	235	454	77076	0	79275
6344	699	262	77760	1440	0	80161
6345	494	199	1359	76718	0	78770
6346	78693	177	516	1604	0	80990
6347	1555	79076	350	719	0	81700
6348	696	1455	237	81297	0	83685
6349	503	539	81292	1606	0	83940
6350	73958	321	1530	702	0	76511
6351	80624	198	558	493	0	81873
6352	1957	270	81094	397	0	83718
6353	833	333	1537	73000	0	75703
6354	448	79572	613	1418	0	82051
6355	80801	1465	397	611	0	83274
6356	1715	504	79196	444	0	81859
6357	75166	286	1587	477	0	77516
6358	1829	219	76919	359	0	79326
6359	887	194	73087	291	0	74459
6360	68484	173	1666	333	0	70656
6361	1386	72551	643	485	0	75065
6362	763	1260	71758	342	0	74123
6363	403	71059	1297	497	0	73256
6364	631	1271	69051	328	0	71281
6365	260	69864	1224	298	0	71646
6366	67122	1194	687	358	0	69361
6367	1146	400	66354	267	0	68167
6368	534	256	66502	242	0	67534
6369	392	161	65555	245	0	66353
6370	62647	206	1432	206	0	64491
6371	65430	133	588	198	0	66349
6372	1237	117	308	63284	0	64946
6373	622	136	67389	957	0	69104
6374	350	132	67194	462	0	68138
6375	65648	120	1297	330	0	67395
6376	1071	122	594	68559	0	70346
6377	68392	114	342	1019	0	69867
6378	69084	101	266	437	0	69888
6379	1397	123	216	64797	0	66533
6380	648	65840	242	1024	0	67754
6381	427	924	263	66696	0	68310
6382	308	388	232	67874	0	68802
6383	356	283	66781	1288	0	68708
6384	300	65302	1071	685	0	67358
6385	285	67827	522	396	0	69030
6386	295	1202	379	65392	0	67268
6387	278	536	66336	965	0	68115
6388	228	65620	1128	594	0	67570
6389	303	1011	65337	303	0	66954
6390	62613	417	1222	314	0	64566
6391	66601	260	618	264	0	67743
6392	1370	210	65783	246	0	67609
6393	64047	166	1197	267	0	65677
6394	1268	185	588	66314	0	68355
6395	600	70480	445	1011	0	72536
6396	479	986	383	71534	0	73382
6397	69221	409	344	1134	0	71108
6398	69907	247	325	549	0	71028
6399	69793	187	336	373	0	70689
6400	69243	169	287	294	0	69993
6401	1492	67271	370	362	0	69495
6402	652	68779	321	311	0	70063
6403	67822	1141	328	262	0	69553
6404	1218	501	68307	252	0	70278
6405	633	880	985	65559	0	68057
6406	376	72393	659	994	0	74422
6407	376	1060	392	70137	0	71965
6408	248	73317	338	1140	0	75043
6409	284	1227	311	73315	0	75137
6410	308	486	73038	1166	0	74998
6411	68814	303	1265	535	0	70917
6412	73373	212	580	304	0	74469
6413	1460	256	73230	195	0	75141
6414	70814	222	1260	214	0	72510
6415	74056	200	548	211	0	75015
6416	1516	202	72667	180	0	74565
6417	738	207	1259	68991	0	71195
6418	72815	142	619	1106	0	74682
6419	1327	177	72432	464	0	74400
6420	625	189	1225	68721	0	70760
6421	438	183	75429	1125	0	77175
6422	392	204	73863	466	0	74925
6423	71154	172	1511	358	0	73195
6424	77358	172	646	232	0	78408
6425	77093	163	352	249	0	77857
6426	79809	162	293	251	0	80515
6427	1763	225	241	74887	0	77116
6428	700	74156	257	1255	0	76368
6429	446	77190	269	540	0	78445
6430	394	1237	230	71974	0	73835
6431	71721	410	237	1029	0	73397
6432	1120	70736	226	483	0	72565
6433	334	70039	159	245	0	70777
6434	68906	962	170	158	0	70196
6435	983	326	162	67784	0	69255
6436	69419	149	217	895	0	70680
6437	1016	68057	139	375	0	69587
6438	69934	851	161	214	0	71160
6439	1070	257	71270	148	0	72745
6440	80381	174	1106	163	0	81824
6441	84859	172	280	164	0	85475
6442	86485	129	171	196	0	86981
6443	1881	163	78454	139	0	80637
6444	81941	180	1216	188	0	83525
6445	1518	82138	357	204	0	84217
6446	502	1280	82079	119	0	83980
6447	335	523	1383	76934	0	79175
6448	258	232	451	77265	0	78206
6449	179	79378	203	1505	0	81265
6450	245	1222	135	80171	0	81773
6451	236	307	111	81621	0	82275
6452	228	154	77529	1540	0	79451
6453	69011	80	1356	607	0	71054
6454	1422	99	79709	239	0	81469
6455	461	84	1419	77040	0	79004
6456	294	116	80927	1329	0	82666
6457	223	67	1466	79210	0	80966
6458	82627	73	441	1435	0	84576
6459	86046	84	245	412	0	86787
6460	1789	81	172	84906	0	86948
6461	630	95	87963	1470	0	90158
6462	320	92	1448	86846	0	88706
6463	324	98	87697	1547	0	89666
6464	81741	117	1551	489	0	83898
6465	87514	154	408	284	0	88360
6466	86918	150	215	232	0	87515
6467	84516	168	133	235	0	85052
6468	1821	80799	165	320	0	83105
6469	646	1474	152	82928	0	85200
6470	81472	442	166	1529	0	83609
6471	1576	80773	184	544	0	83077
6472	578	83663	205	411	0	84857
6473	499	1719	75980	220	0	78418
6474	76715	466	1533	211	0	78925
6475	80661	220	506	208	0	81595
6476	2033	182	77659	187	0	80061
6477	838	117	1568	74605	0	77128
6478	547	98	523	80169	0	81337
6479	489	128	79268	1793	0	81678
6480	441	114	1650	76894	0	79099
6481	77627	103	682	1636	0	80048
6482	1781	129	77045	539	0	79494
6483	717	159	78578	307	0	79761
6484	74460	139	1888	325	0	76812
6485	1797	175	78115	263	0	80350
6486	75120	163	1705	311	0	77299
6487	1787	76189	536	467	0	78979
6488	77925	1536	307	323	0	80091
6489	1833	491	242	76442	0	79008
6490	730	294	236	78698	0	79958
6491	76973	246	251	1886	0	79356
6492	1775	242	241	77276	0	79534
6493	77665	208	259	1779	0	79911
6494	1793	77072	251	710	0	79826
6495	764	1544	231	74336	0	76875
6496	556	498	212	77277	0	78543
6497	74121	271	231	1889	0	76512
6498	76110	238	262	665	0	77275
6499	76186	217	273	435	0	77111
6500	2137	72220	323	445	0	75125
6501	899	74756	287	419	0	76361
6502	73979	1698	298	307	0	76282
6503	2001	533	71193	266	0	73993
6504	819	71166	1535	357	0	73877
6505	66902	1419	1258	392	0	69971
6506	65323	360	513	234	0	66430
6507	64664	192	224	203	0	65283
6508	1727	130	220	60642	0	62719
6509	63507	137	250	1347	0	65241
6510	63403	137	214	469	0	64223
6511	1722	150	198	59610	0	61680
6512	61671	120	215	1320	0	63326
6513	1449	157	58068	500	0	60174
6514	609	138	1193	59348	0	61288
6515	362	166	457	61453	0	62438
6516	321	111	312	62546	0	63290
6517	60191	107	195	1696	0	62189
6518	63057	106	246	622	0	64031
6519	63142	146	246	395	0	63929
6520	63159	88	231	329	0	63807
6521	60805	90	240	372	0	61507
6522	1695	84	265	56640	0	58684
6523	790	93	195	59495	0	60573
6524	57509	95	249	1480	0	59333
6525	1352	55475	223	605	0	57655
6526	56343	1028	212	304	0	57887
6527	1427	291	52415	265	0	54398
6528	57661	142	1072	244	0	59119
6529	62750	101	394	244	0	63489
6530	1725	110	67186	251	0	69272
6531	70451	95	1488	197	0	72231
6532	1769	142	72543	231	0	74685
6533	792	116	77601	143	0	78652
6534	511	200	1966	74835	0	77512
6535	416	135	665	81542	0	82758
6536	496	100	80883	1924	0	83403
6537	451	85	81656	687	0	82879
6538	254	77499	1929	443	0	80125
6539	225	77185	597	273	0	78280
6540	64503	1436	597	142	0	66678
6541	1033	67965	190	147	0	69335
6542	65181	1057	162	108	0	66508
6543	1062	64653	117	122	0	65954
6544	64347	1006	115	71	0	65539
6545	1101	339	61298	86	0	62824
6546	61932	145	957	87	0	63121
6547	1113	132	290	60704	0	62239
6548	365	62600	145	915	0	64025
6549	230	929	143	63411	0	64713
6550	62969	279	58	1017	0	64323
6551	64172	130	67	318	0	64687
6552	1313	130	53	61562	0	63058
6553	422	73	61799	945	0	63239
6554	259	56	62012	310	0	62637
6555	127	61783	1146	198	0	63254
6556	161	1194	383	60877	0	62615
6557	138	263	61082	926	0	62409
6558	91	55553	934	299	0	56877
6559	232	1142	320	55349	0	57043
6560	125	239	157	56452	0	56973
6561	52678	103	87	1024	0	53892
6562	821	64	57	52879	0	53821
6563	284	58	52476	920	0	53738
6564	133	42	833	51855	0	52863
6565	49445	51	281	945	0	50722
6566	856	66	51326	317	0	52565
6567	49068	48	835	186	0	50137
6568	908	51264	297	102	0	52571
6569	52460	801	151	93	0	53505
6570	53077	277	101	75	0	53530
6571	1128	129	82	50120	0	51459
6572	405	72	69	51841	0	52387
6573	197	50749	90	1073	0	52109
6574	139	806	83	51975	0	53003
6575	49548	269	79	960	0	50856
6576	880	152	50285	332	0	51649
6577	345	90	817	49620	0	50872
6578	176	50038	287	855	0	51356
6579	151	826	138	50610	0	51725
6580	115	290	90	51869	0	52364
6581	49430	159	83	1060	0	50732
6582	873	49942	81	405	0	51301
6583	340	824	107	50359	0	51630
6584	49458	269	110	924	0	50761
6585	883	162	91	49773	0	50909
6586	318	107	104	51068	0	51597
6587	49501	87	92	1235	0	50915
6588	50545	78	90	466	0	51179
6589	1138	94	49833	253	0	51318
6590	49208	91	877	207	0	50383
6591	50936	97	312	184	0	51529
6592	50948	100	191	160	0	51399
6593	1201	47842	146	184	0	49373
6594	473	48856	125	170	0	49624
6595	262	1065	170	48004	0	49501
6596	48068	384	213	877	0	49542
6597	48822	215	107	370	0	49514
6598	1157	139	100	47190	0	48586
6599	493	146	47876	913	0	49428
6600	47773	119	797	420	0	49109
6601	50046	116	297	301	0	50760
6602	1158	107	161	48139	0	49565
6603	506	88	106	49613	0	50313
6604	48757	102	99	1124	0	50082
6605	946	113	108	48191	0	49358
6606	399	48429	130	1001	0	49959
6607	290	801	97	49635	0	50823
6608	48514	292	82	1009	0	49897
6609	924	181	48440	468	0	50013
6610	46846	114	831	322	0	48113
6611	1001	125	48470	235	0	49831
6612	432	90	872	47940	0	49334
6613	48745	74	345	982	0	50146
6614	929	86	191	48706	0	49912
6615	384	80	121	49681	0	50266
6616	47962	93	130	1186	0	49371
6617	949	80	47988	520	0	49537
6618	438	78	49482	318	0	50316
6619	266	80	1033	48485	0	49864
6620	241	81	368	50364	0	51054
6621	215	88	193	50780	0	51276
6622	223	72	49879	1215	0	51389
6623	48014	71	834	549	0	49468
6624	50898	70	297	338	0	51603
6625	51168	84	151	266	0	51669
6626	50811	77	114	227	0	51229
6627	1218	48915	116	264	0	50513
6628	509	48570	105	233	0	49417
6629	272	45275	84	203	0	45834
6630	297	840	89	34361	0	35587
6631	313	170	94	33742	0	34319
6632	128	47	31053	386	0	31614
6633	90	25840	201	139	0	26270
6634	456	188	88	21764	0	22496
6635	20689	48	43	156	0	20936
6636	87	21201	30	150	0	21468
6637	83	126	30	20494	0	20733
6638	47	21288	27	123	0	21485
6639	21845	74	22	82	0	22023
6640	123	92	31	21625	0	21871
6641	75	40	21456	126	0	21697
6642	57	35	21322	57	0	21471
6643	39	154	202	21892	0	22287
6644	40	20	52	22173	0	22285
6645	47	13	28	22883	0	22971
6646	22686	21	30	203	0	22940
6647	165	31	22379	81	0	22656
6648	72	22071	131	66	0	22340
6649	42	121	39	21951	0	22153
6650	53	64	21866	144	0	22127
6651	27	21806	125	115	0	22073
6652	53	234	84	22179	0	22550
6653	52	53	22293	135	0	22533
6654	26	20	119	21640	0	21805
6655	28	17	45	22233	0	22323
6656	22462	12	22	163	0	22659
6657	22229	12	17	73	0	22331
6658	163	14	16	22294	0	22487
6659	22363	7	17	158	0	22545
6660	158	37	22793	67	0	23055
6661	57	25	131	22972	0	23185
6662	42	22	23724	165	0	23953
6663	29	16	140	23882	0	24067
6664	22	23977	56	221	0	24276
6665	17	24533	28	82	0	24660
6666	17	25095	24	44	0	25180
6667	96	229	15	25344	0	25684
6668	20	55	18	28396	0	28489
6669	50	30	28219	292	0	28591
6670	35	43	29310	65	0	29453
6671	28	33	30431	57	0	30549
6672	31369	16	375	38	0	31798
6673	346	15	76	33333	0	33770
6674	34147	11	25	401	0	34584
6675	415	35684	26	109	0	36234
6676	86	504	18	35896	0	36504
6677	36938	123	20	502	0	37583
6678	514	60	18	37186	0	37778
6679	37069	28	18	591	0	37706
6680	590	50	37547	175	0	38362
6681	143	38250	490	120	0	39003
6682	90	503	130	38592	0	39315
6683	38629	121	60	562	0	39372
6684	39144	76	41	183	0	39444
6685	629	35	36	39083	0	39783
6686	192	28	38	39674	0	39932
6687	38385	21	48	686	0	39140
6688	558	20	70	38175	0	38823
6689	191	30	38089	654	0	38964
6690	115	38037	543	229	0	38924
6691	69	525	168	38523	0	39285
6692	38319	148	86	599	0	39152
6693	38666	87	62	203	0	39018
6694	708	79	39585	157	0	40529
6695	247	38778	582	164	0	39771
6696	135	40763	164	220	0	41282
6697	110	756	99	40403	0	41368
6698	119	209	66	41760	0	42154
6699	91	118	76	41086	0	41371
6700	122	85	67	40780	0	41054
6701	93	40141	73	912	0	41219
6702	142	633	81	40350	0	41206
6703	143	196	75	41319	0	41733
6704	40483	98	76	929	0	41586
6705	40300	80	58	373	0	40811
6706	825	40246	80	325	0	41476
6707	40866	642	78	229	0	41815
6708	41184	203	88	211	0	41686
6709	41253	132	71	229	0	41685
6710	954	96	40185	201	0	41436
6711	377	94	650	39920	0	41041
6712	237	88	230	41562	0	42117
6713	210	113	40324	917	0	41564
6714	179	101	681	39749	0	40710
6715	167	93	242	39853	0	40355
6716	39779	109	144	957	0	40989
6717	769	140	39658	429	0	40996
6718	310	113	668	38543	0	39634
6719	38176	107	207	890	0	39380
6720	731	38348	145	467	0	39691
6721	38482	677	104	344	0	39607
6722	37976	246	92	302	0	38616
6723	909	37469	96	324	0	38798
6724	397	718	65	37626	0	38806
6725	37640	258	81	853	0	38832
6726	834	37542	102	474	0	38952
6727	393	733	92	37672	0	38890
6728	36975	263	93	840	0	38171
6729	36653	161	124	399	0	37337
6730	946	36319	125	367	0	37757
6731	36749	684	129	299	0	37861
6732	870	268	122	36672	0	37932
6733	36741	169	111	914	0	37935
6734	903	148	36166	445	0	37662
6735	394	107	702	36185	0	37388
6736	313	110	274	36615	0	37312
6737	35741	106	179	1034	0	37060
6738	822	35099	162	515	0	36598
6739	34075	692	157	356	0	35280
6740	857	34075	126	360	0	35418
6741	459	701	32601	304	0	34065
6742	368	268	32571	280	0	33487
6743	399	365	794	31537	0	33095
6744	318	196	32086	841	0	33441
6745	286	163	681	31750	0	32880
6746	286	150	218	31885	0	32539
6747	317	143	136	32762	0	33358
6748	32434	151	101	1013	0	33699
6749	32430	173	96	459	0	33158
6750	33069	166	94	379	0	33708
6751	1075	32847	97	355	0	34374
6752	533	35271	98	345	0	36247
6753	443	913	36962	290	0	38608
6754	336	361	861	37471	0	39029
6755	334	219	37735	1103	0	39391
6756	289	189	959	37433	0	38870
6757	326	163	359	38380	0	39228
6758	288	159	227	38581	0	39255
6759	304	165	36881	1435	0	38785
6760	275	151	927	36808	0	38161
6761	36140	145	389	1227	0	37901
6762	993	35363	255	615	0	37226
6763	499	877	175	35553	0	37104
6764	35192	372	157	1094	0	36815
6765	35126	235	160	546	0	36067
6766	1292	161	129	33904	0	35486
6767	745	121	132	33466	0	34464
6768	30241	103	124	1218	0	31686
6769	1049	87	103	30225	0	31464
6770	27352	85	104	1020	0	28561
6771	981	77	87	26910	0	28055
6772	426	83	24813	900	0	26222
6773	282	23255	558	484	0	24579
6774	224	23697	267	296	0	24484
6775	274	663	358	21162	0	22457
6776	368	253	219	21531	0	22371
6777	20684	113	88	701	0	21586
6778	495	86	70	20927	0	21578
6779	246	72	52	21057	0	21427
6780	161	54	58	19422	0	19695
6781	122	18817	60	777	0	19776
6782	118	431	56	19457	0	20062
6783	140	186	64	19552	0	19942
6784	109	112	61	19579	0	19861
6785	18018	73	93	790	0	18974
6786	463	18477	72	436	0	19448
6787	267	446	56	18825	0	19594
6788	161	209	50	19085	0	19505
6789	151	127	60	19408	0	19746
6790	18418	77	59	776	0	19330
6791	544	69	55	18583	0	19251
6792	313	60	57	18585	0	19015
6793	141	45	17328	764	0	18278
6794	94	16494	393	423	0	17404
6795	96	485	172	16666	0	17419
6796	15897	166	103	532	0	16698
6797	391	16446	53	332	0	17222
6798	15893	346	54	198	0	16491
6799	16022	183	49	166	0	16420
6800	515	97	38	15859	0	16509
6801	252	73	41	16283	0	16649
6802	149	63	16266	596	0	17074
6803	99	51	364	16653	0	17167
6804	107	51	16903	547	0	17608
6805	96	40	420	17191	0	17747
6806	16206	32	185	598	0	17021
6807	395	17006	119	359	0	17879
6808	192	392	81	17972	0	18637
6809	136	178	74	18278	0	18666
6810	86	111	67	18286	0	18550
6811	105	61	76	18447	0	18689
6812	17561	62	72	724	0	18419
6813	408	17449	74	447	0	18378
6814	229	376	53	18300	0	18958
6815	18194	180	64	609	0	19047
6816	461	111	17957	401	0	18930
6817	17663	77	386	290	0	18416
6818	18365	76	180	247	0	18868
6819	581	81	17985	255	0	18902
6820	335	80	405	18100	0	18920
6821	18682	69	204	578	0	19533
6822	458	19243	126	383	0	20210
6823	20027	400	79	313	0	20819
6824	20089	189	73	262	0	20613
6825	20189	114	62	256	0	20621
6826	667	77	28	19855	0	20627
6827	365	69	38	20815	0	21287
6828	209	23243	58	735	0	24245
6829	208	485	56	23948	0	24697
6830	23894	241	55	730	0	24920
6831	552	148	23703	430	0	24833
6832	22998	96	467	330	0	23891
6833	24659	101	207	263	0	25230
6834	742	74	111	23777	0	24704
6835	385	59	56	24763	0	25263
6836	24504	55	63	830	0	25452
6837	24381	61	46	449	0	24937
6838	23907	76	53	338	0	24374
6839	761	67	23953	287	0	25068
6840	362	23851	431	262	0	24906
6841	24087	478	209	221	0	24995
6842	585	231	104	23678	0	24598
6843	327	23973	71	631	0	25002
6844	220	498	51	24164	0	24933
6845	23974	225	60	679	0	24938
6846	565	164	62	24247	0	25038
6847	360	95	24202	718	0	25375
6848	177	23673	421	443	0	24714
6849	148	24400	190	296	0	25034
6850	168	526	22898	197	0	23789
6851	19602	477	584	252	0	20915
6852	338	20764	182	155	0	21439
6853	211	285	97	17754	0	18347
6854	17702	63	40	197	0	18002
6855	201	17627	30	89	0	17947
6856	94	179	22	17818	0	18113
6857	17844	63	25	211	0	18143
6858	201	36	28	17732	0	17997
6859	17861	25	12	233	0	18131
6860	240	26	18006	98	0	18370
6861	94	18323	166	81	0	18664
6862	19149	179	66	92	0	19486
6863	18898	76	33	57	0	19064
6864	18823	45	30	67	0	18965
6865	297	35	18477	53	0	18862
6866	17813	26	186	72	0	18097
6867	18909	34	57	58	0	19058
6868	259	38	40	18793	0	19130
6869	18942	24	26	225	0	19217
6870	233	18671	43	109	0	19056
6871	110	182	30	18939	0	19261
6872	101	94	18949	195	0	19339
6873	63	64	188	18643	0	18958
6874	71	40	76	19319	0	19506
6875	19111	57	42	274	0	19484
6876	18947	46	25	140	0	19158
6877	282	42	18780	105	0	19209
6878	18153	48	174	71	0	18446
6879	272	41	18803	57	0	19173
6880	154	25	198	18604	0	18981
6881	105	54	19034	226	0	19419
6882	94	45	200	18422	0	18761
6883	84	18873	89	233	0	19279
6884	120	205	19293	96	0	19714
6885	119	88	19690	66	0	19963
6886	100	58	284	16980	0	17422
6887	20063	44	101	227	0	20435
6888	20037	44	63	104	0	20248
6889	20225	27	33	112	0	20397
6890	341	46	33	19751	0	20171
6891	171	32	22	20257	0	20482
6892	137	27	33	20360	0	20557
6893	112	38	34	20326	0	20510
6894	89	43	19654	316	0	20102
6895	76	59	212	19290	0	19637
6896	80	19418	95	271	0	19864
6897	83	215	65	19532	0	19895
6898	19505	76	59	266	0	19906
6899	293	66	19612	111	0	20082
6900	17422	38	241	129	0	17830
6901	303	33	20337	80	0	20753
6902	145	47	20231	57	0	20480
6903	77	19935	323	113	0	20448
6904	117	273	146	18951	0	19487
6905	86	106	84	19276	0	19552
6906	67	19400	92	357	0	19916
6907	21271	313	56	136	0	21776
6908	381	133	59	22539	0	23112
6909	188	55	38	24859	0	25140
6910	120	40	45	26159	0	26364
6911	28449	28	43	694	0	29214
6912	30572	31	57	253	0	30913
6913	813	41	34	30249	0	31137
6914	253	34	45	30666	0	30998
6915	29616	27	72	873	0	30588
6916	679	46	37	29884	0	30646
6917	222	38	47	30464	0	30771
6918	143	29	48	30810	0	31030
6919	110	37	29425	887	0	30459
6920	27473	27	655	335	0	28490
6921	29139	23	187	188	0	29537
6922	877	30	27955	131	0	28993
6923	340	199	628	25193	0	26360
6924	161	27447	193	662	0	28463
6925	26681	597	98	245	0	27621
6926	636	27198	77	218	0	28129
6927	182	26256	79	205	0	26722
6928	153	633	67	24166	0	25019
6929	23804	148	49	674	0	24675
6930	24600	54	43	240	0	24937
6931	708	30	43	24010	0	24791
6932	228	36	48	24399	0	24711
6933	155	37	39	24304	0	24535
6934	138	50	40	24218	0	24446
6935	124	58	43	23510	0	23735
6936	102	23006	34	787	0	23929
6937	104	549	29	23591	0	24273
6938	23131	130	54	708	0	24023
6939	23753	72	37	296	0	24158
6940	23759	52	46	213	0	24070
6941	745	22975	67	241	0	24028
6942	283	574	64	23090	0	24011
6943	189	164	23048	695	0	24096
6944	22424	94	545	334	0	23397
6945	648	125	138	22946	0	23857
6946	22882	92	68	699	0	23741
6947	22433	98	39	303	0	22873
6948	22518	70	24	204	0	22816
6949	775	82	41	21762	0	22660
6950	21770	71	39	656	0	22536
6951	698	69	32	21818	0	22617
6952	295	49	53	22270	0	22667
6953	21739	45	59	805	0	22648
6954	653	67	48	21955	0	22723
6955	21603	59	43	752	0	22457
6956	21952	63	42	332	0	22389
6957	798	85	23	21575	0	22481
6958	327	61	35	22152	0	22575
6959	255	67	37	22245	0	22604
6960	231	64	20784	827	0	21906
6961	263	45	20965	370	0	21643
6962	200	49	624	20345	0	21218
6963	208	67	151	20858	0	21284
6964	178	66	78	20987	0	21309
6965	212	47	59	20877	0	21195
6966	207	74	71	21081	0	21433
6967	20162	47	60	882	0	21151
6968	698	19972	79	442	0	21191
6969	334	537	67	20369	0	21307
6970	20437	132	81	779	0	21429
6971	696	90	79	20404	0	21269
6972	280	76	65	20775	0	21196
6973	20058	63	75	907	0	21103
6974	20371	64	58	425	0	20918
6975	815	59	19813	340	0	21027
6976	356	62	533	20001	0	20952
6977	294	63	20004	780	0	21141
6978	238	69	552	20132	0	20991
6979	226	64	166	20382	0	20838
6980	222	43	85	20701	0	21051
6981	196	54	19663	942	0	20855
6982	150	19177	558	505	0	20390
6983	200	20103	186	318	0	20807
6984	195	623	106	19532	0	20456
6985	19145	154	85	810	0	20194
6986	668	83	18930	395	0	20076
6987	276	63	19818	338	0	20495
6988	191	65	675	19436	0	20367
6989	181	65	196	19288	0	19730
6990	163	19934	135	814	0	21046
6991	167	580	98	19960	0	20805
6992	157	170	97	20731	0	21155
6993	187	99	75	21028	0	21389
6994	20377	79	82	903	0	21441
6995	20590	67	73	403	0	21133
6996	787	69	108	20310	0	21274
6997	304	20205	120	799	0	21428
6998	208	531	104	20291	0	21134
6999	19668	154	80	829	0	20731
7000	614	20084	103	422	0	21223
7001	275	533	71	18335	0	19214
7002	136	18654	67	712	0	19569
7003	18514	516	63	345	0	19438
7004	17745	157	111	236	0	18249
7005	626	18243	89	228	0	19186
7006	203	18077	71	213	0	18564
7007	236	469	16322	209	0	17236
7008	107	14837	413	178	0	15535
7009	193	584	163	12328	0	13268
7010	75	96	11914	342	0	12427
7011	35	8622	159	79	0	8895
7012	58	81	55	7151	0	7345
7013	11	21	12	7268	0	7312
7014	12	7	11	7301	0	7331
7015	7055	7	11	113	0	7186
7016	85	7	6897	43	0	7032
7017	27	11	6888	40	0	6966
7018	6	10	100	6845	0	6961
7019	21	16	7686	101	0	7824
7020	14	8	84	7756	0	7862
7021	3	10	31	7751	0	7795
7022	16	9	10	8037	0	8072
7023	11	10	16	8093	0	8130
7024	7883	13	12	115	0	8023
7025	7827	15	4	51	0	7897
7026	100	12	7	7989	0	8108
7027	39	23	8764	100	0	8926
7028	26	17	81	8703	0	8827
7029	18	8742	28	101	0	8889
7030	16	86	13	8788	0	8903
7031	8729	22	24	107	0	8882
7032	9037	20	14	50	0	9121
7033	99	20	13	9133	0	9265
7034	36	12	9	9203	0	9260
7035	20	16	9	9297	0	9342
7036	8989	14	15	116	0	9134
7037	95	16	9080	51	0	9242
7038	50	21	8913	40	0	9024
7039	14	8796	97	41	0	8948
7040	8997	79	33	37	0	9146
7041	98	45	18	9073	0	9234
7042	37	14	9628	107	0	9786
7043	16	9491	87	53	0	9647
7044	23	9910	29	39	0	10001
7045	27	81	15	9978	0	10101
7046	24	37	15	10462	0	10538
7047	12	10484	14	116	0	10626
7048	19	71	15	10701	0	10806
7049	14	31	14	10776	0	10835
7050	10615	20	9	120	0	10764
7051	75	10674	9	71	0	10829
7052	41	79	11	10685	0	10816
7053	38	37	10665	99	0	10839
7054	25	23	77	10529	0	10654
7055	10792	24	29	114	0	10959
7056	76	11072	13	60	0	11221
7057	36	86	17	11331	0	11470
7058	23	38	11285	101	0	11447
7059	64	33	11993	55	0	12145
7060	31	18	105	12346	0	12500
7061	27	22	31	12952	0	13032
7062	13122	15	26	133	0	13296
7063	99	13673	22	73	0	13867
7064	13977	114	22	77	0	14190
7065	136	48	14331	38	0	14553
7066	13369	29	128	52	0	13578
7067	142	27	14933	38	0	15140
7068	14108	26	143	55	0	14332
7069	14923	17	61	49	0	15050
7070	199	33	16824	56	0	17112
7071	75	29	16740	53	0	16897
7072	26	16822	184	61	0	17093
7073	32	136	67	17487	0	17722
7074	18033	53	31	211	0	18328
7075	141	27	29	18464	0	18661
7076	60	22	24	18956	0	19062
7077	38	26	22	19032	0	19118
7078	36	25	18821	219	0	19101
7079	16086	18	150	148	0	16402
7080	18475	19	67	69	0	18630
7081	197	19598	46	71	0	19912
7082	82	140	24	19506	0	19752
7083	44	20269	35	162	0	20510
7084	45	164	21	20597	0	20827
7085	20491	54	34	236	0	20815
7086	180	20776	41	96	0	21093
7087	73	156	21	20328	0	20578
7088	20183	48	30	188	0	20449
7089	19990	29	32	77	0	20128
7090	216	27	25	19832	0	20100
7091	93	27	20302	178	0	20600
7092	54	142	157	19476	0	19829
7093	46	20684	60	173	0	20963
7094	20483	145	33	80	0	20741
7095	153	20801	30	71	0	21055
7096	65	153	21	20692	0	20931
7097	21318	48	24	205	0	21595
7098	179	29	26	22599	0	22833
7099	64	30	25	22861	0	22980
7100	65	28	23470	202	0	23765
7101	37	23308	150	107	0	23602
7102	23095	148	60	59	0	23362
7103	21629	69	38	73	0	21809
7104	150	23355	29	56	0	23590
7105	71	24018	28	42	0	24159
7106	71	152	23	23752	0	23998
7107	23552	53	29	144	0	23778
7108	136	23744	29	81	0	23990
7109	70	128	18	23834	0	24050
7110	49	58	23752	145	0	24004
7111	42	29	126	23378	0	23575
7112	24134	19	50	158	0	24361
7113	128	24558	37	86	0	24809
7114	69	129	19	25362	0	25579
7115	62	61	25018	148	0	25289
7116	63	55	25018	85	0	25221
7117	52	23	157	25165	0	25397
7118	42	27	64	26209	0	26342
7119	30	26043	43	186	0	26302
7120	46	150	18	26175	0	26389
7121	26333	62	26	183	0	26604
7122	168	41	14	26494	0	26717
7123	26566	37	31	192	0	26826
7124	170	26758	38	98	0	27064
7125	101	27819	36	79	0	28035
7126	81	188	45	28535	0	28849
7127	74	66	37	28130	0	28307
7128	89	71	28330	240	0	28730
7129	70	40	176	27625	0	27911
7130	28129	33	85	221	0	28468
7131	228	58	28243	110	0	28639
7132	112	53	167	27987	0	28319
7133	115	92	30542	237	0	30986
7134	75	46	209	30391	0	30721
7135	74	50	84	30923	0	31131
7136	70	41	57	31559	0	31727
7137	96	65	31667	285	0	32113
7138	67	54	187	30550	0	30858
7139	62	31999	96	251	0	32408
7140	68	213	43	32562	0	32886
7141	57	79	41	32582	0	32759
7142	31874	71	23	322	0	32290
7143	225	62	31765	159	0	32211
7144	111	63	185	31444	0	31803
7145	103	53	32055	269	0	32480
7146	78	82	31269	157	0	31586
7147	75	54	238	32524	0	32891
7148	81	62	81	33249	0	33473
7149	61	80	37	34576	0	34754
7150	34130	43	37	359	0	34569
7151	261	82	34322	161	0	34826
7152	33608	68	218	223	0	34117
7153	263	56	85	37042	0	37446
7154	136	64	56	38054	0	38310
7155	75	40594	75	419	0	41163
7156	70	237	60	41538	0	41905
7157	82	85	56	41559	0	41782
7158	112	72	45	41699	0	41928
7159	38728	36	48	355	0	39167
7160	265	58	38912	159	0	39394
7161	33266	44	197	175	0	33682
7162	213	39117	84	152	0	39566
7163	38637	178	75	118	0	39008
7164	171	38457	43	131	0	38802
7165	65	38567	52	141	0	38825
7166	105	241	24	38561	0	38931
7167	39045	52	47	240	0	39384
7168	151	26	21	38932	0	39130
7169	66	38933	38	210	0	39247
7170	34	40158	38	115	0	40345
7171	43	212	27	40353	0	40635
7172	27	80	23	40156	0	40286
7173	37	40759	28	291	0	41115
7174	47	203	29	41793	0	42072
7175	40	82	34	41990	0	42146
7176	38	40	30	42454	0	42562
7177	41569	34	57	415	0	42075
7178	260	55	41928	137	0	42380
7179	40069	43	229	211	0	40552
7180	43725	25	73	139	0	43962
7181	43360	32	41	102	0	43535
7182	281	43210	53	131	0	43675
7183	112	234	37	43248	0	43631
7184	43219	79	36	290	0	43624
7185	261	61	35	43763	0	44120
7186	43960	37	35	290	0	44322
7187	226	46158	48	217	0	46649
7188	47851	192	65	212	0	48320
7189	48521	82	35	145	0	48783
7190	48809	48	41	150	0	49048
7191	291	51	37	48126	0	48505
7192	147	49	33	49895	0	50124
7193	50287	36	29	362	0	50714
7194	220	50034	47	212	0	50513
7195	96	50206	32	161	0	50495
7196	51952	231	39	180	0	52402
7197	242	88	52	51507	0	51889
7198	129	63	32	51587	0	51811
7199	82	54	29	52518	0	52683
7200	74	51465	51	377	0	51967
7201	51303	235	32	204	0	51774
7202	259	115	26	52108	0	52508
7203	116	53171	32	335	0	53654
7204	130	325	25	55584	0	56064
7205	95	108	31	56044	0	56278
7206	88	73	29	55987	0	56177
7207	58	62	38	56318	0	56476
7208	55537	45	28	428	0	56038
7209	54731	51	24	225	0	55031
7210	55759	51	26	215	0	56051
7211	366	56	24	56064	0	56510
7212	240	98	54569	327	0	55234
7213	190	107	50388	173	0	50858
7214	167	97	52359	160	0	52783
7215	55687	64	328	213	0	56292
7216	280	51	101	56961	0	57393
7217	160	42	60	56941	0	57203
7218	127	55	37	57460	0	57679
7219	56390	68	39	391	0	56888
7220	55643	55	61	235	0	55994
7221	342	58662	43	169	0	59216
7222	166	240	29	59493	0	59928
7223	195	141	58230	333	0	58899
7224	94	59548	213	226	0	60081
7225	111	284	93	60130	0	60618
7226	123	147	42	60196	0	60508
7227	134	79	30	59673	0	59916
7228	111	76	29	58382	0	58598
7229	156	91	57705	376	0	58328
7230	180	99	54907	237	0	55423
7231	99	58108	264	259	0	58730
7232	104	213	92	59195	0	59604
7233	107	97	54	57619	0	57877
7234	55944	68	54	390	0	56456
7235	317	113	56804	184	0	57418
7236	138	60	221	56105	0	56524
7237	114	52	89	58241	0	58496
7238	232	82	58758	368	0	59440
7239	77	58191	222	262	0	58752
7240	58741	232	100	210	0	59283
7241	321	142	57624	147	0	58234
7242	55276	69	202	190	0	55737
7243	356	90	59435	159	0	60040
7244	172	49	211	59035	0	59467
7245	178	89	60115	316	0	60698
7246	198	112	59940	214	0	60464
7247	119	51	287	59837	0	60294
7248	120	86	148	56667	0	57021
7249	98	47	81	63033	0	63259
7250	111	52	63	62076	0	62302
7251	88	56	76	61507	0	61727
7252	163	113	60312	384	0	60972
7253	172	100	56504	245	0	57021
7254	87	59571	291	213	0	60162
7255	59001	247	116	188	0	59552
7256	294	154	75	59355	0	59878
7257	59659	58	51	427	0	60195
7258	323	54	65	59368	0	59810
7259	60627	44	95	573	0	61339
7260	359	50	73	61502	0	61984
7261	169	49	64	62016	0	62298
7262	105	63002	94	480	0	63681
7263	103	307	60	64789	0	65259
7264	77	117	80	64935	0	65209
7265	96	106	77	64562	0	64841
7266	104	55	83	64183	0	64425
7267	65	62548	84	570	0	63267
7268	62500	275	61	285	0	63121
7269	295	62315	96	220	0	62926
7270	93	315	45	60807	0	61260
7271	59588	71	38	371	0	60068
7272	378	100	57369	148	0	57995
7273	180	74	56862	149	0	57265
7274	159	120	384	55011	0	55674
7275	75	85	115	58579	0	58854
7276	55	48	80	58498	0	58681
7277	51	52	67	56717	0	56887
7278	58	40	55	57116	0	57269
7279	48	55596	68	362	0	56074
7280	71	224	59	56518	0	56872
7281	55617	49	74	359	0	56099
7282	248	42	53	56378	0	56721
7283	144	66	57302	345	0	57857
7284	74	35	308	55953	0	56370
7285	55817	34	121	431	0	56403
7286	294	58303	86	267	0	58950
7287	137	318	41	61434	0	61930
7288	82	123	40	64829	0	65074
7289	136	91	63597	767	0	64591
7290	184	102	89400	337	0	90023
7291	107804	55	1709	252	0	109820
7292	2620	103	433	112037	0	115193
7293	780	85	251	116206	0	117322
7294	576	100	122418	3616	0	126710
7295	462	124	123578	1331	0	125495
7296	127	123165	3823	895	0	128010
7297	162	3109	1233	121325	0	125829
7298	495	856	122312	3079	0	126742
7299	92	123225	3319	1104	0	127740
7300	123311	3239	975	615	0	128140
7301	126976	931	532	407	0	128846
7302	4017	547	276	120457	0	125297
7303	1299	123636	195	3307	0	128437
7304	123048	3254	212	1035	0	127549
7305	3661	1134	327	107134	0	112256
7306	1342	573	120036	2739	0	124690
7307	645	121587	3261	1022	0	126515
7308	120058	3332	971	653	0	125014
7309	122363	1019	524	494	0	124400
7310	4018	549	331	121243	0	126141
7311	1405	345	260	124918	0	126928
7312	853	264	119817	4375	0	125309
7313	463	241	3286	121175	0	125165
7314	421	192	1003	119808	0	121424
7315	313	191	609	121645	0	122758
7316	327	229	414	122230	0	123200
7317	388	210	324	116701	0	117623
7318	298	116592	401	4865	0	122156
7319	116528	3283	338	1950	0	122099
7320	3703	1054	116021	1360	0	122138
7321	1174	114094	3462	1034	0	119764
7322	762	3457	1167	116304	0	121690
7323	114679	1120	794	3916	0	120509
7324	3614	694	588	115593	0	120489
7325	1305	493	560	116593	0	118951
7326	929	454	533	117904	0	119820
7327	693	387	552	118935	0	120567
7328	805	443	112847	5372	0	119467
7329	599	112837	3632	2589	0	119657
7330	113205	3488	1306	1750	0	119749
7331	3966	1255	113262	1245	0	119728
7332	1380	830	3914	113598	0	119722
7333	113444	605	1456	4200	0	119705
7334	3818	113423	1026	1950	0	120217
7335	113964	3724	770	1442	0	119900
7336	4441	1429	651	110719	0	117240
7337	1856	907	622	116293	0	119678
7338	1262	698	570	115312	0	117842
7339	957	595	564	116754	0	118870
7340	110223	651	580	5694	0	117148
7341	4014	613	581	111876	0	117084
7342	1627	517	598	115845	0	118587
7343	108725	509	618	5520	0	115372
7344	4237	631	107017	2669	0	114554
7345	1784	522	3687	108569	0	114562
7346	105084	497	1426	4782	0	111789
7347	107219	545	1004	2342	0	111110
7348	4888	510	806	104485	0	110689
7349	2073	528	771	104714	0	108086
7350	1327	100522	845	5537	0	108231
7351	1100	3737	639	103561	0	109037
7352	1094	1225	624	105739	0	108682
7353	1024	836	99373	6032	0	107265
7354	919	706	99784	3181	0	104590
7355	788	97864	4473	2451	0	105576
7356	1076	3667	1843	96357	0	102943
7357	859	1413	1378	101511	0	105161
7358	98101	1036	1143	5485	0	105765
7359	4128	852	951	98522	0	104453
7360	1977	744	96250	5364	0	104335
7361	1551	725	3846	98170	0	104292
7362	1147	698	95044	5623	0	102512
7363	1192	800	96993	2836	0	101821
7364	1021	721	4993	91825	0	98560
7365	960	807	2087	97756	0	101610
7366	94824	854	1260	5591	0	102529
7367	97663	704	862	3030	0	102259
7368	5094	611	879	95875	0	102459
7369	96641	678	589	5194	0	103102
7370	99323	613	634	2717	0	103287
7371	5406	693	605	95939	0	102643
7372	2480	647	649	99817	0	103593
7373	95837	681	640	5787	0	102945
7374	97838	494	630	3263	0	102225
7375	5103	435	598	94338	0	100474
7376	2351	93271	745	5351	0	101718
7377	1722	3539	494	96241	0	101996
7378	1357	1108	467	99872	0	102804
7379	1204	746	93774	6454	0	102178
7380	939	511	3702	97818	0	102970
7381	91060	475	1476	5926	0	98937
7382	3849	93677	1115	3268	0	101909
7383	93960	3445	699	2586	0	100690
7384	95737	1169	631	2371	0	99908
7385	96699	922	544	2136	0	100301
7386	5678	1369	610	90451	0	98108
7387	2891	677	83394	4626	0	91588
7388	2246	654	81053	2347	0	86300
7389	1161	79086	4070	2254	0	86571
7390	624	51806	1104	1193	0	54727
7391	353	28371	403	385	0	29512
7392	329	26939	723	377	0	28368
7393	1065	781	24265	413	0	26524
7394	14526	836	1516	286	0	17164
7395	286	129	86	14386	0	14887
7396	88	23	26	14251	0	14388
7397	70	34	29	14022	0	14155
7398	58	14033	28	304	0	14423
7399	13617	212	47	108	0	13984
7400	247	50	13683	86	0	14066
7401	53	12479	201	79	0	12812
7402	58	171	92	12732	0	13053
7403	12695	42	35	209	0	12981
7404	207	23	26	12726	0	12982
7405	74	27	12487	225	0	12813
7406	62	27	12325	76	0	12490
7407	53	21	187	12319	0	12580
7408	36	12	51	12578	0	12677
7409	12328	14	31	226	0	12599
7410	206	14	12198	86	0	12504
7411	11801	14	179	66	0	12060
7412	12197	22	43	61	0	12323
7413	215	19	26	12146	0	12406
7414	84	24	12426	197	0	12731
7415	53	30	169	12373	0	12625
7416	12530	14	53	218	0	12815
7417	190	12549	49	73	0	12861
7418	12749	177	31	67	0	13024
7419	195	49	18	12796	0	13058
7420	62	13400	30	242	0	13734
7421	62	202	25	13649	0	13938
7422	45	52	23	13909	0	14029
7423	41	13837	34	262	0	14174
7424	65	226	35	14133	0	14459
7425	56	57	24	14492	0	14629
7426	46	28	28	14958	0	15060
7427	69	41	14748	318	0	15176
7428	39	14748	263	140	0	15190
7429	15009	252	69	79	0	15409
7430	279	88	54	15092	0	15513
7431	73	16233	40	296	0	16642
7432	17345	280	40	133	0	17798
7433	331	75	35	17387	0	17828
7434	119	46	34	17635	0	17834
7435	86	32	24	17366	0	17508
7436	79	40	24	17074	0	17217
7437	16716	36	18	432	0	17202
7438	361	36	41	16844	0	17282
7439	119	33	30	17138	0	17320
7440	16819	40	35	423	0	17317
7441	349	34	35	16926	0	17344
7442	124	57	16741	404	0	17326
7443	75	49	315	16863	0	17302
7444	16542	48	90	394	0	17074
7445	343	51	47	16686	0	17127
7446	104	46	16756	402	0	17308
7447	74	52	16376	153	0	16655
7448	16545	27	374	132	0	17078
7449	17497	35	124	117	0	17773
7450	17570	39	67	98	0	17774
7451	17576	41	53	93	0	17763
7452	457	54	17331	73	0	17915
7453	161	42	335	17095	0	17633
7454	134	34	81	17866	0	18115
7455	17427	29	67	440	0	17963
7456	364	53	53	17589	0	18059
7457	119	36	17410	412	0	17977
7458	76	52	317	17300	0	17745
7459	84	25	17448	405	0	17962
7460	45	17348	347	213	0	17953
7461	17607	340	125	142	0	18214
7462	336	77	61	17493	0	17967
7463	106	53	17166	404	0	17729
7464	91	40	329	17242	0	17702
7465	84	38	101	18129	0	18352
7466	91	36	18015	466	0	18608
7467	74	31	373	18015	0	18493
7468	17983	33	114	453	0	18583
7469	399	40	17452	190	0	18081
7470	16394	43	337	145	0	16919
7471	394	16814	100	144	0	17452
7472	163	298	16707	136	0	17304
7473	118	106	16792	130	0	17146
7474	120	316	445	13602	0	14483
7475	74	51	108	15149	0	15382
7476	71	39	15273	391	0	15774
7477	81	34	282	15122	0	15519
7478	15440	19	96	399	0	15954
7479	15567	26	80	177	0	15850
7480	357	33	46	15265	0	15701
7481	137	29	57	15190	0	15413
7482	97	15436	55	404	0	15992
7483	15437	264	50	237	0	15988
7484	323	73	58	15921	0	16375
7485	125	16295	74	388	0	16882
7486	16464	256	61	206	0	16987
7487	16399	77	65	166	0	16707
7488	383	16842	66	204	0	17495
7489	175	275	62	17037	0	17549
7490	129	79	74	16976	0	17258
7491	128	56	16446	455	0	17085
7492	119	33	323	16192	0	16667
7493	16223	41	126	437	0	16827
7494	379	25	101	16148	0	16653
7495	164	27	15782	442	0	16415
7496	15469	28	355	220	0	16072
7497	353	25	155	15893	0	16426
7498	182	34	15758	392	0	16366
7499	142	20	337	15716	0	16215
7500	125	31	16008	425	0	16589
7501	139	23	364	15922	0	16448
7502	152	22	141	16307	0	16622
7503	15980	27	110	450	0	16567
7504	349	15977	109	273	0	16708
7505	16364	279	100	184	0	16927
7506	16377	70	102	156	0	16705
7507	16470	56	86	174	0	16786
7508	443	16211	79	197	0	16930
7509	215	291	16178	130	0	16814
7510	138	104	343	16231	0	16816
7511	16509	61	166	393	0	17129
7512	16658	53	111	190	0	17012
7513	452	40	96	16083	0	16671
7514	16224	52	102	405	0	16783
7515	388	53	16046	196	0	16683
7516	15625	29	376	171	0	16201
7517	400	33	16016	179	0	16628
7518	173	15705	362	181	0	16421
7519	15609	257	171	174	0	16211
7520	14987	70	117	159	0	15333
7521	365	15124	106	146	0	15741
7522	14996	237	136	149	0	15518
7523	14639	75	94	117	0	14925
7524	325	79	14379	128	0	14911
7525	13494	41	268	111	0	13914
7526	291	38	13850	110	0	14289
7527	120	117	230	12363	0	12830
7528	95	13154	102	239	0	13590
7529	104	176	13060	129	0	13469
7530	11599	265	320	200	0	12384
7531	11557	60	116	190	0	11923
7532	207	27	41	10744	0	11019
7533	103	30	10889	168	0	11190
7534	66	31	150	10835	0	11082
7535	10955	19	70	166	0	11210
7536	177	11360	41	94	0	11672
7537	11344	127	26	73	0	11570
7538	11386	44	27	59	0	11516
7539	184	11294	34	62	0	11574
7540	88	122	30	11378	0	11618
7541	11746	48	33	159	0	11986
7542	171	22	41	11790	0	12024
7543	91	29	40	12411	0	12571
7544	87	36	12570	171	0	12864
7545	70	24	141	12403	0	12638
7546	78	27	43	12627	0	12775
7547	12475	26	20	191	0	12712
7548	12527	30	36	62	0	12655
7549	215	21	37	12503	0	12776
7550	116	27	12176	183	0	12502
7551	79	34	11892	78	0	12083
7552	58	36	179	11885	0	12158
7553	85	25	12347	162	0	12619
7554	62	38	159	12173	0	12432
7555	68	37	59	12094	0	12258
7556	12365	21	51	195	0	12632
7557	190	21	12334	78	0	12623
7558	11873	19	158	67	0	12117
7559	12091	14	68	68	0	12241
7560	186	28	11896	68	0	12178
7561	100	20	11907	50	0	12077
7562	78	290	153	11221	0	11742
7563	49	11474	61	127	0	11711
7564	89	11852	26	74	0	12041
7565	109	141	36	11155	0	11441
7566	50	40	21	10927	0	11038
7567	48	14	23	11149	0	11234
7568	48	12	19	11195	0	11274
7569	10833	21	21	117	0	10992
7570	101	15	30	10883	0	11029
7571	53	17	10844	107	0	11021
7572	42	13	85	10567	0	10707
7573	41	10591	39	95	0	10766
7574	48	72	24	10677	0	10821
7575	10575	24	18	102	0	10719
7576	113	9	31	10687	0	10840
7577	52	9	10752	106	0	10919
7578	33	10431	101	57	0	10622
7579	30	67	47	10633	0	10777
7580	10597	26	26	106	0	10755
7581	10493	16	26	50	0	10585
7582	142	12	17	10613	0	10784
7583	71	11	9992	89	0	10163
7584	52	21	9371	41	0	9485
7585	9367	3	116	44	0	9530
7586	119	10	9994	26	0	10149
7587	45	19	9803	26	0	9893
7588	13	43	103	9134	0	9293
7589	9861	8	32	83	0	9984
7590	9744	7	12	47	0	9810
7591	9712	4	21	23	0	9760
7592	101	8	10530	17	0	10656
7593	46	10	10569	22	0	10647
7594	4	11039	101	27	0	11171
7595	27	65	39	11079	0	11210
7596	13	47	16	11158	0	11234
7597	20	9	17	10881	0	10927
7598	15	8	19	11143	0	11185
7599	31	13	11176	93	0	11313
7600	21	11358	68	63	0	11510
7601	12351	56	34	38	0	12479
7602	14595	36	16	26	0	14673
7603	14736	9	20	22	0	14787
7604	204	15214	18	36	0	15472
7605	50	176	9	15076	0	15311
7606	16029	55	7	205	0	16296
7607	202	16799	16	96	0	17113
7608	16678	214	6	42	0	16940
7609	227	16764	11	51	0	17053
7610	16918	228	16	18	0	17180
7611	16950	62	16	26	0	17054
7612	277	20	15	17150	0	17462
7613	80	31	11	17930	0	18052
7614	61	17	17731	299	0	18108
7615	40	11	17301	123	0	17475
7616	17577	9	312	44	0	17942
7617	18071	8	96	45	0	18220
7618	331	6	36	17856	0	18229
7619	117	16	21	18140	0	18294
7620	67	23	17771	363	0	18224
7621	42	15	259	17358	0	17674
7622	52	22	17474	305	0	17853
7623	46	16	275	17458	0	17795
7624	42	28	87	17926	0	18083
7625	17698	20	36	369	0	18123
7626	17445	27	30	118	0	17620
7627	379	35	21	17419	0	17854
7628	134	32	15	17675	0	17856
7629	106	29	17311	384	0	17830
7630	66	37	274	17346	0	17723
7631	84	36	17448	351	0	17919
7632	16983	26	315	136	0	17460
7633	338	28	113	17552	0	18031
7634	17457	25	58	341	0	17881
7635	329	17330	54	172	0	17885
7636	17206	275	50	123	0	17654
7637	346	100	57	16982	0	17485
7638	167	37	51	16970	0	17225
7639	91	16982	48	401	0	17522
7640	95	293	39	17293	0	17720
7641	99	104	16886	353	0	17442
7642	95	55	301	16775	0	17226
7643	88	30	16374	361	0	16853
7644	71	15822	318	195	0	16406
7645	79	252	121	16095	0	16547
7646	93	87	15965	341	0	16486
7647	95	44	15839	161	0	16139
7648	108	73	350	15564	0	16095
7649	15593	24	121	358	0	16096
7650	327	24	15557	172	0	16080
7651	130	34	310	15514	0	15988
7652	15786	27	132	363	0	16308
7653	317	15584	89	179	0	16169
7654	16491	273	63	210	0	17037
7655	336	94	88	16592	0	17110
7656	183	62	39	16623	0	16907
7657	116	56	49	16910	0	17131
7658	16663	46	48	456	0	17213
7659	342	41	63	16784	0	17230
7660	162	35	61	17111	0	17369
7661	16299	51	65	455	0	16870
7662	374	54	16350	192	0	16970
7663	152	51	310	16403	0	16916
7664	111	54	16331	397	0	16893
7665	15866	55	338	202	0	16461
7666	365	60	147	16404	0	16976
7667	196	52	16526	382	0	17156
7668	15824	68	338	210	0	16440
7669	16390	53	140	168	0	16751
7670	450	66	17005	174	0	17695
7671	213	53	327	16864	0	17457
7672	135	59	149	17284	0	17627
7673	128	51	17631	484	0	18294
7674	109	17427	373	274	0	18183
7675	153	300	18025	194	0	18672
7676	17204	109	343	187	0	17843
7677	392	75	18736	192	0	19395
7678	17899	35	346	240	0	18520
7679	390	42	18818	186	0	19436
7680	18145	21	374	200	0	18740
7681	353	19175	192	236	0	19956
7682	197	253	119	19049	0	19618
7683	144	92	125	19815	0	20176
7684	148	47	19751	496	0	20442
7685	137	38	346	18693	0	19214
7686	125	19433	166	426	0	20150
7687	19202	262	114	254	0	19832
7688	331	19270	123	223	0	19947
7689	176	291	103	19580	0	20150
7690	19622	89	106	469	0	20286
7691	396	19696	116	250	0	20458
7692	19189	298	106	205	0	19798
7693	408	115	19652	190	0	20365
7694	212	59	364	19698	0	20333
7695	142	46	186	19953	0	20327
7696	131	40	132	20377	0	20680
7697	20107	35	139	537	0	20818
7698	20289	56	116	235	0	20696
7699	20267	61	108	186	0	20622
7700	19812	46	136	152	0	20146
7701	455	42	18570	138	0	19205
7702	15444	49	221	89	0	15803
7703	243	15960	100	92	0	16395
7704	104	15803	55	69	0	16031
7705	15594	180	473	104	0	16351
7706	15271	71	168	105	0	15615
7707	182	13	23	14647	0	14865
7708	14947	6	29	175	0	15157
7709	14796	10	24	64	0	14894
7710	16211	7	29	84	0	16331
7711	237	16	16	16086	0	16355
7712	70	15986	36	176	0	16268
7713	36	16000	27	48	0	16111
7714	39	161	36	15897	0	16133
7715	15732	43	24	144	0	15943
7716	123	15908	21	56	0	16108
7717	43	115	15	15813	0	15986
7718	50	39	15738	129	0	15956
7719	14090	21	122	49	0	14282
7720	143	16049	35	45	0	16272
7721	38	16418	27	51	0	16534
7722	16122	131	9	42	0	16304
7723	149	42	16333	28	0	16552
7724	54	15	123	16002	0	16194
7725	32	16520	32	130	0	16714
7726	29	125	15	16638	0	16807
7727	39	28	10	16592	0	16669
7728	42	16240	22	146	0	16450
7729	42	124	19	17183	0	17368
7730	50	41	15	17248	0	17354
7731	17027	30	13	149	0	17219
7732	138	17018	20	75	0	17251
7733	17037	140	13	40	0	17230
7734	153	47	9	16782	0	16991
7735	50	17264	16	152	0	17482
7736	86	149	17005	47	0	17287
7737	51	67	134	17034	0	17286
7738	59	24	29	17908	0	18020
7739	59	30	18010	190	0	18289
7740	16447	27	171	67	0	16712
7741	180	31	41	19916	0	20168
7742	19749	24	33	280	0	20086
7743	278	44	19556	71	0	19949
7744	84	43	233	19619	0	19979
7745	71	38	20628	272	0	21009
7746	58	66	260	20591	0	20975
7747	52	31	67	21344	0	21494
7748	21075	25	53	338	0	21491
7749	262	21477	25	140	0	21904
7750	21504	287	18	82	0	21891
7751	331	92	21522	50	0	21995
7752	104	45	272	21374	0	21795
7753	76	48	21993	292	0	22409
7754	18762	35	325	138	0	19260
7755	21331	23	80	83	0	21517
7756	345	48	21470	65	0	21928
7757	20767	29	281	81	0	21158
7758	21755	31	87	68	0	21941
7759	361	30	45	21525	0	21961
7760	148	36	21379	315	0	21878
7761	84	53	21944	145	0	22226
7762	71	38	351	21862	0	22322
7763	71	39	121	21685	0	21916
7764	91	21648	62	381	0	22182
7765	56	22167	63	224	0	22510
7766	22097	343	46	117	0	22603
7767	353	104	65	22040	0	22562
7768	130	22117	68	356	0	22671
7769	97	22741	72	168	0	23078
7770	21076	349	61	122	0	21608
7771	361	115	54	21794	0	22324
7772	141	22060	65	385	0	22651
7773	119	311	78	21798	0	22306
7774	103	120	61	21798	0	22082
7775	113	74	59	21643	0	21889
7776	20963	45	80	437	0	21525
7777	357	20672	71	206	0	21306
7778	170	318	81	20651	0	21220
7779	140	110	87	20783	0	21120
7780	133	66	77	20996	0	21272
7781	133	74	19922	450	0	20579
7782	18614	71	354	201	0	19240
7783	386	49	142	19869	0	20446
7784	19374	61	125	398	0	19958
7785	19406	64	100	186	0	19756
7786	19498	68	91	180	0	19837
7787	465	76	19357	160	0	20058
7788	184	19247	351	146	0	19928
7789	137	309	128	18913	0	19487
7790	128	131	18964	378	0	19601
7791	121	117	18663	199	0	19100
7792	156	123	368	17544	0	18191
7793	79	17764	147	363	0	18353
7794	17902	294	84	212	0	18492
7795	18073	124	83	171	0	18451
7796	18111	95	60	194	0	18460
7797	18166	74	59	162	0	18461
7798	411	95	17900	144	0	18550
7799	17411	80	291	164	0	17946
7800	367	18008	140	152	0	18667
7801	159	285	93	18215	0	18752
7802	146	113	93	18592	0	18944
7803	18430	69	101	429	0	19029
7804	390	61	74	18373	0	18898
7805	197	61	17778	384	0	18420
7806	16912	61	324	224	0	17521
7807	17639	50	129	199	0	18017
7808	17516	61	130	173	0	17880
7809	440	80	17265	159	0	17944
7810	15474	57	304	144	0	15979
7811	327	16008	150	158	0	16643
7812	16227	232	126	161	0	16746
7813	333	127	94	15879	0	16433
7814	157	92	96	16020	0	16365
7815	132	15842	83	353	0	16410
7816	124	263	68	15798	0	16253
7817	105	15889	80	324	0	16398
7818	144	285	84	15748	0	16261
7819	127	15721	73	320	0	16241
7820	140	269	53	15665	0	16127
7821	121	15798	70	313	0	16302
7822	194	290	55	16185	0	16724
7823	124	16812	67	364	0	17367
7824	18001	313	48	193	0	18555
7825	427	130	63	18474	0	19094
7826	201	87	63	18973	0	19324
7827	152	73	56	20054	0	20335
7828	151	61	45	20338	0	20595
7829	125	78	20143	655	0	21001
7830	134	62	452	20400	0	21048
7831	141	60	161	20880	0	21242
7832	20327	59	81	626	0	21093
7833	20002	62	67	240	0	20371
7834	621	20428	65	254	0	21368
7835	300	457	51	20482	0	21290
7836	197	155	51	22079	0	22482
7837	22486	97	69	672	0	23324
7838	637	80	21805	249	0	22771
7839	21009	65	524	164	0	21762
7840	602	22070	173	175	0	23020
7841	20250	437	55	68	0	20810
7842	20105	125	35	73	0	20338
7843	535	19875	33	89	0	20532
7844	148	20601	40	83	0	20872
7845	148	595	73	19341	0	20157
7846	57	141	19240	464	0	19902
7847	18551	45	433	151	0	19180
7848	451	42	19028	75	0	19596
7849	18195	21	425	54	0	18695
7850	462	28	18629	67	0	19186
7851	132	18258	421	116	0	18927
7852	70	405	97	18448	0	19020
7853	17971	103	40	444	0	18558
7854	18248	45	42	137	0	18472
7855	535	21	33	18110	0	18699
7856	18870	31	31	437	0	19369
7857	18954	37	27	138	0	19156
7858	580	18558	28	93	0	19259
7859	18663	459	17	52	0	19191
7860	508	18774	23	84	0	19389
7861	150	471	23	18733	0	19377
7862	18733	118	35	490	0	19376
7863	19271	55	37	144	0	19507
7864	19374	32	30	75	0	19511
7865	636	38	18979	56	0	19709
7866	195	50	19359	48	0	19652
7867	105	43	577	19147	0	19872
7868	85	45	154	20360	0	20644
7869	68	21620	63	644	0	22395
7870	21657	554	46	185	0	22442
7871	628	171	49	21710	0	22558
7872	231	71	40	22395	0	22737
7873	155	56	22184	739	0	23134
7874	108	21727	578	274	0	22687
7875	117	22641	172	123	0	23053
7876	114	712	59	22433	0	23318
7877	22163	231	41	638	0	23073
7878	633	102	47	22112	0	22894
7879	257	80	41	22936	0	23314
7880	22405	73	43	778	0	23299
7881	22882	54	64	282	0	23282
7882	820	59	65	22556	0	23500
7883	296	76	22401	676	0	23449
7884	170	56	599	22623	0	23448
7885	153	67	205	23189	0	23614
7886	22698	77	87	826	0	23688
7887	705	52	63	22862	0	23682
7888	22926	62	71	746	0	23805
7889	773	70	23002	301	0	24146
7890	312	74	637	23504	0	24527
7891	187	81	212	24194	0	24674
7892	186	82	95	24517	0	24880
7893	175	89	69	24309	0	24642
7894	174	92	83	24316	0	24665
7895	157	98	23333	1000	0	24588
7896	22739	79	676	406	0	23900
7897	794	80	233	23382	0	24489
7898	347	75	23154	825	0	24401
7899	241	79	23480	357	0	24157
7900	200	90	844	23028	0	24162
7901	23039	83	238	832	0	24192
7902	23349	99	141	357	0	23946
7903	23753	109	116	244	0	24222
7904	979	97	95	21553	0	22724
7905	394	22820	113	805	0	24132
7906	23382	656	142	345	0	24525
7907	23961	234	116	247	0	24558
7908	23955	146	104	250	0	24455
7909	23775	113	95	224	0	24207
7910	1023	112	94	22953	0	24182
7911	427	105	22685	871	0	24088
7912	274	106	710	22747	0	23837
7913	281	117	22715	892	0	24005
7914	22481	74	749	438	0	23742
7915	23178	50	294	299	0	23821
7916	978	63	22432	278	0	23751
7917	22105	60	757	303	0	23225
7918	23373	53	299	301	0	24026
7919	1011	69	159	22299	0	23538
7920	426	22870	125	857	0	24278
7921	22879	635	133	414	0	24061
7922	897	509	130	21231	0	22767
7923	374	21095	112	787	0	22368
7924	301	574	93	20415	0	21383
7925	259	162	20262	714	0	21397
7926	226	20369	553	375	0	21523
7927	19309	514	246	278	0	20347
7928	19172	194	227	241	0	19834
7929	18666	63	106	216	0	19051
7930	18788	54	115	219	0	19176
7931	681	129	106	17575	0	18491
7932	309	18004	108	559	0	18980
7933	17721	396	114	245	0	18476
7934	611	133	17584	187	0	18515
7935	293	17063	475	233	0	18064
7936	204	365	15665	182	0	16416
7937	182	119	376	13889	0	14566
7938	159	14069	148	371	0	14747
7939	159	305	97	14765	0	15326
7940	197	120	15602	397	0	16316
7941	185	59	345	15162	0	15751
7942	164	50	134	15768	0	16116
7943	161	67	92	16106	0	16426
7944	15297	51	93	477	0	15918
7945	400	15525	91	267	0	16283
7946	238	297	71	15720	0	16326
7947	15314	102	86	409	0	15911
7948	404	15527	88	271	0	16290
7949	15609	308	89	167	0	16173
7950	448	123	15778	156	0	16505
7951	250	92	334	14948	0	15624
7952	201	15706	153	347	0	16407
7953	15652	306	108	164	0	16230
7954	458	131	15474	131	0	16194
7955	241	14895	343	150	0	15629
7956	185	277	110	14458	0	15030
7957	167	135	86	14711	0	15099
7958	14379	83	73	394	0	14929
7959	380	78	85	14335	0	14878
7960	199	66	14038	355	0	14658
7961	161	77	268	13509	0	14015
7962	164	70	14009	324	0	14567
7963	160	136	273	12691	0	13260
7964	153	13775	134	296	0	14358
7965	13511	270	115	172	0	14068
7966	13034	98	91	118	0	13341
7967	334	12555	78	108	0	13075
7968	102	11322	53	65	0	11542
7969	233	149	65	10346	0	10793
7970	10359	30	30	144	0	10563
7971	162	52	36	10212	0	10462
7972	10107	35	24	137	0	10303
7973	142	9796	20	57	0	10015
7974	67	108	18	9946	0	10139
7975	53	43	10018	123	0	10237
7976	70	37	99	9755	0	9961
7977	55	35	36	10115	0	10241
7978	10225	32	22	162	0	10441
7979	122	10486	27	51	0	10686
7980	50	128	23	10562	0	10763
7981	10351	31	28	127	0	10537
7982	144	31	10438	38	0	10651
7983	9977	17	101	66	0	10161
7984	132	69	25	10555	0	10781
7985	50	10896	22	102	0	11070
7986	10788	95	34	51	0	10968
7987	132	32	11098	30	0	11292
7988	52	25	10940	24	0	11041
7989	34	10946	94	43	0	11117
7990	10366	46	117	33	0	10562
7991	63	13	4	10517	0	10597
7992	14	3	7	10642	0	10666
7993	10621	5	8	76	0	10710
7994	76	7	10738	22	0	10843
7995	24	3	69	10720	0	10816
7996	24	8	11802	77	0	11911
7997	14	5	75	11529	0	11623
7998	7	12124	26	82	0	12239
7999	10	74	7	12398	0	12489
8000	17	21	12166	77	0	12281
8001	11321	9	82	35	0	11447
8002	83	10	27	12387	0	12507
8003	41	9	12588	79	0	12717
8004	4	7	88	12122	0	12221
8005	18	9	27	12436	0	12490
8006	20	23	12273	108	0	12424
8007	23	16	12370	37	0	12446
8008	9	5	104	12500	0	12618
8009	12	6	12815	98	0	12931
8010	11910	4	94	39	0	12047
8011	85	9	32	12834	0	12960
8012	12688	6	18	96	0	12808
8013	98	12	12697	41	0	12848
8014	46	18	93	12765	0	12922
8015	26	10	14334	104	0	14474
8016	12	14097	110	54	0	14273
8017	30	94	14349	21	0	14494
8018	17	41	13588	18	0	13664
8019	12735	7	126	26	0	12894
8020	13809	11	35	19	0	13874
8021	136	13	14525	24	0	14698
8022	45	20	114	13129	0	13308
8023	15	5	39	14856	0	14915
8024	38	5	15064	125	0	15232
8025	10	14363	113	67	0	14553
8026	14038	109	50	29	0	14226
8027	116	42	15006	18	0	15182
8028	43	8	106	14926	0	15083
8029	20	10	41	15576	0	15647
8030	15903	8	18	169	0	16098
8031	16053	6	15	68	0	16142
8032	16159	9	15	40	0	16223
8033	16291	7	18	31	0	16347
8034	158	10	19	16091	0	16278
8035	68	15	17695	130	0	17908
8036	26	7	132	17494	0	17659
8037	31	10	49	18097	0	18187
8038	24	6	26	18720	0	18776
8039	31	13	18540	175	0	18759
8040	16629	12	153	78	0	16872
8041	160	17	47	18324	0	18548
8042	78	21	19281	176	0	19556
8043	34	19916	158	98	0	20206
8044	34	144	71	20432	0	20681
8045	32	54	33	20644	0	20763
8046	20336	20	57	220	0	20633
8047	173	21177	34	113	0	21497
8048	80	158	21209	52	0	21499
8049	45	53	167	20869	0	21134
8050	37	25	64	21230	0	21356
8051	21062	13	44	216	0	21335
8052	20829	15	34	99	0	20977
8053	214	18	33	21458	0	21723
8054	21469	8	29	192	0	21698
8055	181	21454	39	133	0	21807
8056	112	164	23202	53	0	23531
8057	50	49	181	22992	0	23272
8058	31	23	75	23917	0	24046
8059	28	13	46	23964	0	24051
8060	31	13	41	23607	0	23692
8061	37	23704	34	247	0	24022
8062	23499	163	33	129	0	23824
8063	193	58	33	23873	0	24157
8064	81	25546	41	235	0	25903
8065	25726	157	35	104	0	26022
8066	25341	54	32	65	0	25492
8067	224	26615	37	77	0	26953
8068	105	200	31	27379	0	27715
8069	56	56	41	27677	0	27830
8070	46	26	38	27405	0	27515
8071	47	15	31	27640	0	27733
8072	27642	19	30	266	0	27957
8073	27759	21	41	128	0	27949
8074	269	28685	39	117	0	29110
8075	128	221	28665	60	0	29074
8076	52	75	241	28638	0	29006
8077	29324	31	93	252	0	29700
8078	255	28822	54	144	0	29275
8079	84	29093	38	87	0	29302
8080	29604	277	25	87	0	29993
8081	29606	84	26	64	0	29780
8082	345	42	32	29352	0	29771
8083	143	37	30545	290	0	31015
8084	97	66	30379	118	0	30660
8085	32094	53	325	148	0	32620
8086	33612	30	104	99	0	33845
8087	33234	25	49	82	0	33390
8088	33192	35	37	83	0	33347
8089	33156	33	29	78	0	33296
8090	346	33750	43	85	0	34224
8091	158	304	43	32780	0	33285
8092	72	35259	33	272	0	35636
8093	35647	284	78	142	0	36151
8094	35246	80	36	131	0	35493
8095	34974	57	35	83	0	35149
8096	34754	37	22	73	0	34886
8097	298	34723	37	104	0	35162
8098	34594	216	23	99	0	34932
8099	250	34794	36	96	0	35176
8100	111	237	43	34921	0	35312
8101	34704	62	41	265	0	35072
8102	275	72	35446	98	0	35891
8103	103	34	211	34626	0	34974
8104	83	48	64	36167	0	36362
8105	99	39	36086	295	0	36519
8106	63	36129	222	161	0	36575
8107	36203	233	68	110	0	36614
8108	35613	78	44	79	0	35814
8109	271	35833	44	130	0	36278
8110	122	228	39	36027	0	36416
8111	223	99	37118	259	0	37699
8112	93	38725	222	165	0	39205
8113	37990	236	132	116	0	38474
8114	289	116	38475	54	0	38934
8115	33780	77	218	83	0	34158
8116	36980	47	66	88	0	37181
8117	316	59	38807	74	0	39256
8118	122	38934	228	125	0	39409
8119	120	253	67	39351	0	39791
8120	107	87	39768	230	0	40192
8121	36463	63	213	132	0	36871
8122	39135	33	60	99	0	39327
8123	289	39392	43	178	0	39902
8124	138	203	41	39360	0	39742
8125	100	98	30	40239	0	40467
8126	148	88	40408	255	0	40899
8127	81	40684	199	154	0	41118
8128	42631	210	72	248	0	43161
8129	42922	86	51	116	0	43175
8130	43429	76	31	163	0	43699
8131	317	73	43220	65	0	43675
8132	41954	56	184	83	0	42277
8133	43888	58	74	96	0	44116
8134	281	62	37	44097	0	44477
8135	160	63	42847	196	0	43266
8136	110	47	188	42234	0	42579
8137	127	61	43502	222	0	43912
8138	102	78	188	42014	0	42382
8139	75	43049	92	243	0	43459
8140	72	45560	56	130	0	45818
8141	95	215	48	45767	0	46125
8142	86	92	44	44508	0	44730
8143	43932	52	30	290	0	44304
8144	228	58	44021	87	0	44394
8145	41649	46	176	124	0	41995
8146	202	44741	74	115	0	45132
8147	44670	187	64	92	0	45013
8148	44477	75	38	74	0	44664
8149	258	61	34	44488	0	44841
8150	158	70	46360	194	0	46782
8151	117	46	177	46122	0	46462
8152	82	48573	87	233	0	48975
8153	85	226	59	48747	0	49117
8154	87	96	40	49036	0	49259
8155	48292	49	47	321	0	48709
8156	273	50	52	46711	0	47086
8157	127	46400	59	319	0	46905
8158	92	242	36	47232	0	47602
8159	47029	96	43	280	0	47448
8160	239	47597	46	204	0	48086
8161	120	258	53	48554	0	48985
8162	95	122	39	48696	0	48952
8163	97	55	38	50652	0	50842
8164	88	51	41	49834	0	50014
8165	49791	45	50	499	0	50385
8166	406	66	54	50661	0	51187
8167	171	65	40	51430	0	51706
8168	104	80	48	51343	0	51575
8169	87	52431	60	691	0	53269
8170	51980	502	113	233	0	52828
8171	606	183	52214	117	0	53120
8172	182	51451	517	256	0	52406
8173	50642	471	211	108	0	51432
8174	560	176	52046	105	0	52887
8175	169	51848	470	167	0	52654
8176	130	629	195	50318	0	51272
8177	57	52170	115	531	0	52873
8178	109	471	51530	171	0	52281
8179	173	200	51741	124	0	52238
8180	55	52089	551	174	0	52869
8181	52148	431	188	135	0	52902
8182	52106	153	91	117	0	52467
8183	555	112	50264	88	0	51019
8184	222	94	47045	85	0	47446
8185	134	98	48681	73	0	48986
8186	84	59	593	47674	0	48410
8187	63	49	207	48453	0	48772
8188	70	60	108	49671	0	49909
8189	114	69	50570	675	0	51428
8190	81	63	482	48367	0	48993
8191	79	69	179	49975	0	50302
8192	117	89	49325	624	0	50155
8193	45056	80	550	308	0	45994
8194	548	53	196	51086	0	51883
8195	218	57	127	50357	0	50759
8196	114	51686	100	751	0	52651
8197	51800	540	177	299	0	52816
8198	643	228	51435	156	0	52462
8199	50362	115	612	145	0	51234
8200	646	94	244	51425	0	52409
8201	314	112	52276	655	0	53357
8202	170	81	640	51504	0	52395
8203	52049	85	276	771	0	53181
8204	655	102	51752	298	0	52807
8205	50263	80	656	236	0	51235
8206	51846	78	280	192	0	52396
8207	52129	80	176	177	0	52562
8208	852	51376	167	232	0	52627
8209	371	609	139	52865	0	53984
8210	53755	235	142	737	0	54869
8211	53043	132	147	298	0	53620
8212	53879	99	138	228	0	54344
8213	1009	138	52065	166	0	53378
8214	53950	104	746	200	0	55000
8215	912	86	303	58072	0	59373
8216	410	122	57845	977	0	59354
8217	241	90	936	60313	0	61580
8218	214	88	337	61482	0	62121
8219	224	121	61796	1486	0	63627
8220	204	58	1179	61448	0	62889
8221	182	77	459	64786	0	65504
8222	218	96	72580	1667	0	74561
8223	75749	65	1672	706	0	78192
8224	84159	84	644	401	0	85288
8225	2348	72	402	87082	0	89904
8226	987	102	86471	2116	0	89676
8227	659	83	2065	83119	0	85926
8228	429	84015	724	2406	0	87574
8229	448	1911	449	82965	0	85773
8230	354	600	341	85555	0	86850
8231	84177	332	292	2831	0	87632
8232	84035	204	292	1267	0	85798
8233	85581	194	244	891	0	86910
8234	2938	199	278	83262	0	86677
8235	1262	174	199	85759	0	87394
8236	865	188	82758	2946	0	86757
8237	693	161	2112	78274	0	81240
8238	628	82155	765	2668	0	86216
8239	81867	1946	521	1145	0	85479
8240	2275	80372	441	1425	0	84513
8241	81492	2199	356	829	0	84876
8242	2530	800	373	74564	0	78267
8243	1029	79579	442	2426	0	83476
8244	80038	2156	367	1092	0	83653
8245	80830	832	314	905	0	82881
8246	2911	576	345	78046	0	81878
8247	1344	79105	402	2594	0	83445
8248	952	2222	343	79664	0	83181
8249	892	856	78592	2764	0	83104
8250	75283	533	2228	1297	0	79341
8251	2537	76963	867	1134	0	81501
8252	75923	2168	573	831	0	79495
8253	2670	850	482	75713	0	79715
8254	76999	569	464	2685	0	80717
8255	2894	456	77966	1298	0	82614
8256	79200	358	2360	1114	0	83032
8257	80796	372	953	880	0	83001
8258	3588	362	79137	963	0	84050
8259	1846	363	2463	77815	0	82487
8260	1454	279	1079	80140	0	82952
8261	77014	364	784	3443	0	81605
8262	2928	77020	661	1928	0	82537
8263	1441	2452	556	75564	0	80013
8264	1238	948	74907	2999	0	80092
8265	1147	645	74514	1613	0	77919
8266	1107	72634	2670	1452	0	77863
8267	1391	2223	72346	1113	0	77073
8268	69307	1043	2636	1131	0	74117
8269	2622	705	1094	68598	0	73019
8270	70444	518	891	2672	0	74525
8271	2720	593	69916	1435	0	74664
8272	1426	590	2328	68916	0	73260
8273	1122	661	1048	70997	0	73828
8274	1135	709	68849	2998	0	73691
8275	1154	610	2309	68972	0	73045
8276	68255	636	991	2900	0	72782
8277	69536	564	760	1592	0	72452
8278	3328	524	641	67966	0	72459
8279	68109	505	588	2867	0	72069
8280	68495	486	596	1541	0	71118
8281	3350	66406	579	1520	0	71855
8282	1852	2178	638	66702	0	71370
8283	67424	875	623	2761	0	71683
8284	3034	707	621	67483	0	71845
8285	66280	582	642	2963	0	70467
8286	3208	601	596	65761	0	70166
8287	1934	552	66223	3049	0	71758
8288	1582	66112	2363	1755	0	71812
8289	1585	2282	1117	52840	0	57824
8290	1342	65051	887	2564	0	69844
8291	63091	2385	937	1404	0	67817
8292	2758	62570	876	1378	0	67582
8293	1563	63301	836	1294	0	66994
8294	1357	2728	793	61487	0	66365
8295	61396	1317	723	2756	0	66192
8296	2764	944	621	61466	0	65795
8297	61265	779	635	2971	0	65650
8298	60918	760	690	1688	0	64056
8299	3008	60942	740	1434	0	66124
8300	61965	2247	802	1243	0	66257
8301	62321	1061	815	1089	0	65286
8302	62431	756	791	1106	0	65084
8303	3590	703	59345	1026	0	64664
8304	2219	598	2212	58382	0	63411
8305	1748	615	1041	60719	0	64123
8306	1622	505	59135	3043	0	64305
8307	59122	493	2283	1741	0	63639
8308	61362	443	1090	1483	0	64378
8309	60863	434	868	1277	0	63442
8310	58544	442	739	1224	0	60949
8311	3496	56602	665	1400	0	62163
8312	56394	1904	570	1122	0	59990
8313	3509	765	498	55344	0	60116
8314	1997	686	52061	2402	0	57146
8315	49005	514	1746	1238	0	52503
8316	2746	49667	793	1129	0	54335
8317	44678	1642	499	886	0	47705
8318	2417	44596	418	893	0	48324
8319	1393	42926	443	870	0	45632
8320	1178	42291	452	893	0	44814
8321	1209	40738	601	974	0	43522
8322	1201	1474	30941	643	0	34259
8323	1100	2546	1251	22802	0	27699
8324	407	277	20035	792	0	21511
8325	14895	147	466	286	0	15794
8326	501	15367	173	239	0	16280
8327	249	15743	130	252	0	16374
8328	220	491	120	15110	0	15941
8329	251	207	101	15507	0	16066
8330	215	193	15100	501	0	16009
8331	197	194	15079	221	0	15691
8332	225	151	433	14735	0	15544
8333	243	118	14846	455	0	15662
8334	250	14709	420	247	0	15626
8335	283	392	146	14501	0	15322
8336	303	147	112	15522	0	16084
8337	320	127	15240	497	0	16184
8338	312	85	358	15058	0	15813
8339	15310	80	151	502	0	16043
8340	546	91	157	15013	0	15807
8341	276	81	139	15190	0	15686
8342	229	130	14776	587	0	15722
8343	13776	80	408	297	0	14561
8344	555	15012	171	239	0	15977
8345	365	370	91	14864	0	15690
8346	349	145	14789	418	0	15701
8347	284	168	340	14674	0	15466
8348	14786	130	127	464	0	15507
8349	595	152	14854	193	0	15794
8350	315	184	356	14722	0	15577
8351	268	110	15142	480	0	16000
8352	229	15096	402	256	0	15983
8353	247	413	14934	165	0	15759
8354	202	14592	386	149	0	15329
8355	203	274	12252	129	0	12858
8356	100	146	272	10242	0	10760
8357	55	11408	92	216	0	11771
8358	11089	209	60	81	0	11439
8359	221	87	29	11139	0	11476
8360	11307	74	37	207	0	11625
8361	246	49	32	11630	0	11957
8362	108	54	24	11824	0	12010
8363	11741	46	37	255	0	12079
8364	11878	27	56	110	0	12071
8365	311	34	32	12418	0	12795
8366	128	39	12787	260	0	13214
8367	100	12510	243	103	0	12956
8368	101	243	12722	61	0	13127
8369	79	12891	239	47	0	13256
8370	12597	239	99	68	0	13003
8371	260	73	12414	47	0	12794
8372	130	42	12288	50	0	12510
8373	45	39	280	11683	0	12047
8374	12102	26	83	232	0	12443
8375	245	27	12652	92	0	13016
8376	97	13321	232	62	0	13712
8377	13701	200	77	55	0	14033
8378	14012	79	33	68	0	14192
8379	14164	40	39	66	0	14309
8380	14188	38	41	57	0	14324
8381	14036	43	40	52	0	14171
8382	287	27	14006	51	0	14371
8383	99	156	207	12917	0	13379
8384	54	13992	90	197	0	14333
8385	13966	199	56	85	0	14306
8386	193	14125	43	56	0	14417
8387	13023	141	29	63	0	13256
8388	12889	44	33	32	0	12998
8389	164	12844	37	37	0	13082
8390	13059	140	35	54	0	13288
8391	168	47	29	13016	0	13260
8392	68	23	34	13240	0	13365
8393	55	26	12962	188	0	13231
8394	36	13194	169	88	0	13487
8395	46	152	64	13160	0	13422
8396	42	69	47	13321	0	13479
8397	41	34	31	13457	0	13563
8398	37	35	12916	213	0	13201
8399	11568	27	163	93	0	11851
8400	188	25	67	12938	0	13218
8401	13124	28	43	180	0	13375
8402	210	19	33	13144	0	13406
8403	78	34	13599	191	0	13902
8404	69	41	13410	84	0	13604
8405	12434	27	236	69	0	12766
8406	13609	46	68	45	0	13768
8407	219	13340	50	51	0	13660
8408	114	175	13460	28	0	13777
8409	68	62	166	13131	0	13427
8410	73	42	74	12799	0	12988
8411	14188	35	46	234	0	14503
8412	14161	30	36	102	0	14329
8413	14214	33	41	70	0	14358
8414	227	42	14053	45	0	14367
8415	14028	28	174	73	0	14303
8416	204	34	69	14510	0	14817
8417	103	25	36	14780	0	14944
8418	77	34	38	14807	0	14956
8419	62	14689	43	223	0	15017
8420	14522	160	40	80	0	14802
8421	193	62	39	14674	0	14968
8422	107	45	14596	201	0	14949
8423	68	31	184	14151	0	14434
8424	56	14651	83	207	0	14997
8425	14817	175	54	87	0	15133
8426	214	68	41	14714	0	15037
8427	82	42	46	14637	0	14807
8428	94	41	14785	218	0	15138
8429	80	26	176	14290	0	14572
8430	66	14879	74	199	0	15218
8431	81	171	45	15055	0	15352
8432	88	64	15133	203	0	15488
8433	13114	41	179	116	0	13450
8434	14592	23	92	72	0	14779
8435	223	15171	44	70	0	15508
8436	14808	144	35	59	0	15046
8437	15054	53	37	54	0	15198
8438	201	14939	39	67	0	15246
8439	108	141	59	15088	0	15396
8440	15377	52	59	188	0	15676
8441	172	15984	43	97	0	16296
8442	113	175	16039	46	0	16373
8443	15563	60	227	83	0	15933
8444	16640	32	72	54	0	16798
8445	16669	27	64	59	0	16819
8446	16738	40	20	54	0	16852
8447	232	17064	30	79	0	17405
8448	17370	175	20	47	0	17612
8449	17688	47	32	59	0	17826
8450	17752	26	31	56	0	17865
8451	268	21	32	17678	0	17999
8452	17706	27	29	219	0	17981
8453	197	18407	34	93	0	18731
8454	106	206	19226	97	0	19635
8455	56	66	241	19761	0	20124
8456	20027	23	61	305	0	20416
8457	316	33	20207	77	0	20633
8458	96	27	259	20036	0	20418
8459	73	28	20156	291	0	20548
8460	49	20028	272	149	0	20498
8461	55	275	56	19736	0	20122
8462	88	57	19982	285	0	20412
8463	45	19978	263	70	0	20356
8464	89	354	68	19629	0	20140
8465	19925	55	57	298	0	20335
8466	19870	17	17	95	0	19999
8467	20115	24	28	36	0	20203
8468	19980	15	28	39	0	20062
8469	19838	13	25	50	0	19926
8470	290	21	19747	30	0	20088
8471	19427	17	239	41	0	19724
8472	20269	15	52	48	0	20384
8473	267	20	43	20106	0	20436
8474	20243	30	19	246	0	20538
8475	19396	28	22	70	0	19516
8476	260	18965	41	72	0	19338
8477	82	236	17	19046	0	19381
8478	50	48	18	19320	0	19436
8479	19000	15	15	273	0	19303
8480	279	18975	28	72	0	19354
8481	83	19403	32	46	0	19564
8482	79	271	18	19681	0	20049
8483	88	42	26	19940	0	20096
8484	61	22	27	19765	0	19875
8485	65	17	20	19996	0	20098
8486	19394	21	22	322	0	19759
8487	19245	20	20	91	0	19376
8488	357	23	19485	51	0	19916
8489	114	20	259	18899	0	19292
8490	69	37	41	19564	0	19711
8491	73	27	19232	333	0	19665
8492	17824	28	270	95	0	18217
8493	307	19132	51	103	0	19593
8494	19227	259	35	51	0	19572
8495	307	65	19	19151	0	19542
8496	89	34	19394	293	0	19810
8497	71	24	263	19585	0	19943
8498	82	25	20801	311	0	21219
8499	52	21146	270	139	0	21607
8500	20811	269	45	106	0	21231
8501	20801	58	34	76	0	20969
8502	284	20979	44	73	0	21380
8503	78	248	25	20479	0	20830
8504	20293	48	31	296	0	20668
8505	283	20199	56	86	0	20624
8506	103	258	31	20346	0	20738
8507	20568	56	35	295	0	20954
8508	312	30	20250	82	0	20674
8509	19521	27	267	94	0	19909
8510	285	20535	82	72	0	20974
8511	20560	237	52	85	0	20934
8512	20489	54	54	62	0	20659
8513	326	63	20258	62	0	20709
8514	118	45	254	19139	0	19556
8515	94	45	63	20491	0	20693
8516	89	62	20450	314	0	20915
8517	73	53	250	19566	0	19942
8518	100	38	63	20036	0	20237
8519	20508	58	34	309	0	20909
8520	20564	48	36	111	0	20759
8521	343	27	48	20248	0	20666
8522	129	48	20444	293	0	20914
8523	106	41	271	20342	0	20760
8524	109	44	68	20792	0	21013
8525	134	36	20998	319	0	21487
8526	121	35	272	21106	0	21534
8527	21127	27	70	330	0	21554
8528	21029	29	41	128	0	21227
8529	315	21026	59	114	0	21514
8530	21481	265	44	132	0	21922
8531	21459	52	37	105	0	21653
8532	324	21424	44	120	0	21912
8533	21868	256	29	92	0	22245
8534	21862	63	43	88	0	22056
8535	22638	29	42	100	0	22809
8536	345	43	22024	109	0	22521
8537	21620	27	281	109	0	22037
8538	343	24	62	22565	0	22994
8539	22516	36	61	344	0	22957
8540	336	52	22246	128	0	22762
8541	127	21681	291	114	0	22213
8542	21669	265	81	93	0	22108
8543	297	22142	42	95	0	22576
8544	127	263	27	21712	0	22129
8545	96	86	31	22332	0	22545
8546	22264	53	41	325	0	22683
8547	21809	36	49	132	0	22026
8548	397	45	21611	88	0	22141
8549	147	38	20148	85	0	20418
8550	96	30	20657	54	0	20837
8551	82	204	334	19974	0	20594
8552	84	36	20529	280	0	20929
8553	75	35	19418	103	0	19631
8554	185	382	262	17848	0	18677
8555	19195	12	128	297	0	19632
8556	19275	18	21	93	0	19407
8557	19406	11	22	67	0	19506
8558	19404	14	16	28	0	19462
8559	206	10	13	19420	0	19649
8560	86	10	15	19681	0	19792
8561	59	23	20635	197	0	20914
8562	33	12	179	20037	0	20261
8563	36	12	84	20447	0	20579
8564	20992	15	36	276	0	21319
8565	20646	18	30	115	0	20809
8566	269	15	22	20580	0	20886
8567	20793	27	28	225	0	21073
8568	20987	18	28	96	0	21129
8569	282	16	24	21023	0	21345
8570	118	24	23	21056	0	21221
8571	82	20	20865	296	0	21263
8572	69	40	20350	128	0	20587
8573	53	44	282	20751	0	21130
8574	47	17	124	21364	0	21552
8575	58	21	21263	282	0	21624
8576	19967	12	222	140	0	20341
8577	20621	13	96	75	0	20805
8578	331	18	20579	57	0	20985
8579	145	20472	223	74	0	20914
8580	20827	167	120	68	0	21182
8581	237	85	22011	55	0	22388
8582	117	57	195	21443	0	21812
8583	107	43	107	22415	0	22672
8584	23260	15	69	317	0	23661
8585	24284	25	48	220	0	24577
8586	301	12	50	24463	0	24826
8587	157	20	45	25805	0	26027
8588	25987	18	46	331	0	26382
8589	25909	16	43	163	0	26131
8590	25696	23	53	107	0	25879
8591	396	18	26147	81	0	26642
8592	177	16	282	26005	0	26480
8593	105	16	129	26884	0	27134
8594	26601	11	90	383	0	27085
8595	297	26950	69	227	0	27543
8596	29423	240	64	123	0	29850
8597	407	29721	83	132	0	30343
8598	192	392	41	30356	0	30981
8599	143	106	59	30921	0	31229
8600	130	58	30764	568	0	31520
8601	94	34	467	30601	0	31196
8602	129	29	30779	551	0	31488
8603	102	30	509	30797	0	31438
8604	110	29	165	30821	0	31125
8605	97	29997	112	700	0	30906
8606	115	31224	84	289	0	31712
8607	135	571	67	30674	0	31447
8608	123	136	60	31373	0	31692
8609	128	60	69	31540	0	31797
8610	99	45	81	32028	0	32253
8611	119	36	65	32386	0	32606
8612	127	43	31624	705	0	32499
8613	126	34	523	31368	0	32051
8614	101	37	155	32329	0	32622
8615	117	39	31006	707	0	31869
8616	115	30686	518	386	0	31705
8617	107	476	169	31252	0	32004
8618	144	151	31077	614	0	31986
8619	96	31602	551	286	0	32535
8620	112	501	173	32095	0	32881
8621	32630	146	106	648	0	33530
8622	545	81	103	32476	0	33205
8623	223	61	70	32931	0	33285
8624	154	53	88	33289	0	33584
8625	125	57	90	32129	0	32401
8626	91	31513	89	813	0	32506
8627	109	502	94	32173	0	32878
8628	33087	150	105	809	0	34151
8629	554	102	93	33808	0	34557
8630	204	72	85	33636	0	33997
8631	145	71	98	34139	0	34453
8632	32813	72	94	838	0	33817
8633	33176	68	73	439	0	33756
8634	741	84	96	33363	0	34284
8635	32180	78	77	728	0	33063
8636	32113	73	75	365	0	32626
8637	634	32370	87	379	0	33470
8638	31893	469	88	275	0	32725
8639	535	32195	102	301	0	33133
8640	162	32294	100	301	0	32857
8641	155	534	138	32514	0	33341
8642	134	173	33073	638	0	34018
8643	122	138	470	32092	0	32822
8644	124	109	177	32411	0	32821
8645	101	32593	125	689	0	33508
8646	32219	479	92	353	0	33143
8647	502	167	77	32460	0	33206
8648	202	152	34536	654	0	35544
8649	133	118	448	34076	0	34775
8650	98	35179	145	687	0	36109
8651	35403	461	100	384	0	36348
8652	495	160	91	35734	0	36480
8653	203	144	36036	708	0	37091
8654	159	118	455	35497	0	36229
8655	146	35018	170	679	0	36013
8656	155	508	89	35528	0	36280
8657	36625	171	116	766	0	37678
8658	37426	154	102	425	0	38107
8659	37365	100	102	423	0	37990
8660	693	37864	114	400	0	39071
8661	37230	571	97	337	0	38235
8662	649	189	89	37492	0	38419
8663	36923	133	127	808	0	37991
8664	591	37443	90	487	0	38611
8665	238	609	115	37855	0	38817
8666	157	246	37945	804	0	39152
8667	34265	187	558	454	0	35464
8668	573	38006	182	374	0	39135
8669	198	628	104	38071	0	39001
8670	123	190	105	38988	0	39406
8671	111	160	93	38400	0	38764
8672	113	129	74	37046	0	37362
8673	116	37480	97	938	0	38631
8674	37774	582	93	406	0	38855
8675	37843	206	84	338	0	38471
8676	724	141	38360	325	0	39550
8677	258	139	534	38214	0	39145
8678	212	122	38629	770	0	39733
8679	37452	141	567	415	0	38575
8680	38814	132	162	312	0	39420
8681	37360	125	108	325	0	37918
8682	745	126	85	35789	0	36745
8683	289	35976	72	869	0	37206
8684	36029	562	70	358	0	37019
8685	672	241	56	35497	0	36466
8686	35290	120	108	796	0	36314
8687	649	140	33808	315	0	34912
8688	307	112	33013	251	0	33683
8689	33598	129	511	259	0	34497
8690	650	119	146	33881	0	34796
8691	33506	87	96	614	0	34303
8692	576	33501	83	322	0	34482
8693	33820	483	82	248	0	34633
8694	33975	188	113	276	0	34552
8695	663	152	33341	220	0	34376
8696	220	94	29581	116	0	30011
8697	150	29944	377	135	0	30606
8698	369	398	252	29063	0	30082
8699	29357	147	185	348	0	30037
8700	310	52	33	29457	0	29852
8701	152	44	37	30424	0	30657
8702	141	60	29744	347	0	30292
8703	28102	52	236	162	0	28552
8704	325	122	89	30697	0	31233
8705	187	69	30369	272	0	30897
8706	136	57	29679	137	0	30009
8707	103	181	293	29888	0	30465
8708	120	71	30433	288	0	30912
8709	120	78	30061	138	0	30397
8710	104	91	254	26289	0	26738
8711	114	44	30851	260	0	31269
8712	109	77	236	29309	0	29731
8713	73	29870	117	292	0	30352
8714	31125	201	40	162	0	31528
8715	252	31915	65	137	0	32369
8716	127	267	43	31459	0	31896
8717	86	32741	50	305	0	33182
8718	130	309	33517	128	0	34084
8719	102	109	345	38357	0	38913
8720	142	82	46553	675	0	47452
8721	44130	50	883	215	0	45278
8722	891	49182	266	190	0	50529
8723	49711	915	124	93	0	50843
8724	1038	263	87	48615	0	50003
8725	49279	134	126	950	0	50489
8726	1126	87	49241	299	0	50753
8727	361	49585	955	213	0	51114
8728	48664	947	273	144	0	50028
8729	1061	326	160	44198	0	45745
8730	358	48512	113	904	0	49887
8731	238	994	86	49350	0	50668
8732	49431	296	99	1057	0	50883
8733	974	53857	120	481	0	55432
8734	54157	1170	84	200	0	55611
8735	1318	363	52906	146	0	54733
8736	51997	153	1226	125	0	53501
8737	1330	112	354	53132	0	54928
8738	51974	76	165	1253	0	53468
8739	1259	52825	157	418	0	54659
8740	405	1177	125	53023	0	54730
8741	236	331	108	54470	0	55145
8742	227	174	51799	1524	0	53724
8743	195	113	1214	50894	0	52416
8744	175	115	344	53098	0	53732
8745	187	97	179	52960	0	53423
8746	147	124	124	53416	0	53811
8747	190	80	52264	1626	0	54160
8748	138	49347	1257	593	0	51335
8749	178	1214	378	49692	0	51462
8750	49388	347	202	1354	0	51291
8751	49705	163	180	455	0	50503
8752	1492	49885	144	409	0	51930
8753	49529	1242	165	236	0	51172
8754	50130	360	164	212	0	50866
8755	49409	205	165	218	0	49997
8756	1617	48568	148	277	0	50610
8757	47336	1174	133	187	0	48830
8758	1387	359	115	45909	0	47770
8759	498	201	46087	1265	0	48051
8760	278	45667	1154	457	0	47556
8761	277	1227	428	45651	0	47583
8762	212	335	45189	1244	0	46980
8763	43433	203	1133	444	0	45213
8764	1173	141	306	45343	0	46963
8765	443	146	159	46180	0	46928
8766	282	147	127	45583	0	46139
8767	240	140	110	46040	0	46530
8768	213	123	44173	1549	0	46058
8769	39460	144	1116	616	0	41336
8770	1194	43753	329	370	0	45646
8771	43773	1130	163	252	0	45318
8772	1263	44297	133	287	0	45980
8773	44462	1232	136	233	0	46063
8774	1342	369	123	44032	0	45866
8775	517	238	44079	1252	0	46086
8776	393	195	44571	483	0	45642
8777	275	189	1367	43374	0	45205
8778	272	187	427	44345	0	45231
8779	250	184	243	45102	0	45779
8780	43396	155	180	1593	0	45324
8781	1270	202	43996	655	0	46123
8782	516	166	1186	40120	0	41988
8783	332	43869	367	1254	0	45822
8784	43682	1172	239	531	0	45624
8785	1321	431	43662	405	0	45819
8786	547	42898	1181	467	0	45093
8787	432	1204	43582	325	0	45543
8788	391	463	1259	43176	0	45289
8789	379	304	43789	1325	0	45797
8790	422	228	44318	527	0	45495
8791	360	233	1421	43402	0	45416
8792	352	245	43955	1374	0	45926
8793	367	200	44609	603	0	45779
8794	308	185	1494	42447	0	44434
8795	43003	200	514	1437	0	45154
8796	1318	194	43148	655	0	45315
8797	480	199	1261	41750	0	43690
8798	341	187	465	43888	0	44881
8799	42653	167	318	1692	0	44830
8800	1311	205	286	42920	0	44722
8801	42024	163	264	1521	0	43972
8802	1404	41683	234	748	0	44069
8803	581	1204	230	42264	0	44279
8804	42209	397	235	1452	0	44293
8805	42789	253	251	644	0	43937
8806	1632	195	231	42014	0	44072
8807	641	191	42017	1474	0	44323
8808	39546	215	1263	639	0	41663
8809	1325	41891	478	520	0	44214
8810	41399	1201	307	474	0	43381
8811	41666	383	285	459	0	42793
8812	41783	239	284	442	0	42748
8813	1658	189	40638	424	0	42909
8814	602	40257	1299	452	0	42610
8815	430	1437	433	39194	0	41494
8816	465	693	354	40022	0	41534
8817	409	228	38966	1573	0	41176
8818	313	36017	1153	711	0	38194
8819	258	30030	334	382	0	31004
8820	177	24023	165	213	0	24578
8821	21634	535	999	165	0	23333
8822	600	154	131	20575	0	21460
8823	196	84	83	20930	0	21293
8824	137	90	20708	505	0	21440
8825	19131	75	411	189	0	19806
8826	418	82	134	20367	0	21001
8827	184	200	120	20557	0	21061
8828	171	55	20289	489	0	21004
8829	103	20032	405	256	0	20796
8830	171	457	153	19977	0	20758
8831	120	101	19712	439	0	20372
8832	73	17524	306	205	0	18108
8833	14444	145	66	85	0	14740
8834	155	45	15275	60	0	15535
8835	65	56	109	14162	0	14392
8836	42	14999	40	123	0	15204
8837	15013	97	49	47	0	15206
8838	126	41	27	14975	0	15169
8839	15079	25	50	112	0	15266
8840	15066	24	26	60	0	15176
8841	126	15249	22	62	0	15459
8842	15352	96	27	52	0	15527
8843	15785	22	30	69	0	15906
8844	131	35	16001	40	0	16207
8845	15644	23	103	60	0	15830
8846	128	34	16106	32	0	16300
8847	15692	18	81	31	0	15822
8848	15928	14	26	37	0	16005
8849	126	15	16304	31	0	16476
8850	43	14	86	15832	0	15975
8851	37	20	16658	81	0	16796
8852	30	25	15782	44	0	15881
8853	48	38	17027	52	0	17165
8854	51	25	79	16498	0	16653
8855	17	11	25	18176	0	18229
8856	22	10	19	18306	0	18357
8857	19	10	19	18885	0	18933
8858	35	20	19291	160	0	19506
8859	24	12	136	18498	0	18670
8860	24	18796	40	197	0	19057
8861	43	146	19926	53	0	20168
8862	21	38	154	19182	0	19395
8863	63	43	20353	180	0	20639
8864	33	20119	176	81	0	20409
8865	17	20325	51	52	0	20445
8866	28	198	27	20330	0	20583
8867	40	52	20372	178	0	20642
8868	34	36	20544	69	0	20683
8869	25	22	206	20434	0	20687
8870	32	13	64	20651	0	20760
8871	19	13	26	21075	0	21133
8872	42	22	20908	225	0	21197
8873	21	20791	186	127	0	21125
8874	24	21674	60	62	0	21820
8875	26	248	28	21608	0	21910
8876	42	60	21277	195	0	21574
8877	57	25	21603	87	0	21772
8878	17	22543	221	64	0	22845
8879	22500	205	76	49	0	22830
8880	190	23267	45	56	0	23558
8881	69	211	23806	61	0	24147
8882	23483	61	273	56	0	23873
8883	254	35	84	24841	0	25214
8884	25483	33	57	319	0	25892
8885	274	30	31	25457	0	25792
8886	84	26	40	25917	0	26067
8887	25729	26	50	367	0	26172
8888	299	26767	39	199	0	27304
8889	99	305	26579	99	0	27082
8890	38	27211	319	70	0	27638
8891	26751	329	115	50	0	27245
8892	301	26900	47	67	0	27315
8893	26712	336	28	65	0	27141
8894	26709	108	34	51	0	26902
8895	380	27132	45	76	0	27633
8896	117	349	42	26787	0	27295
8897	26642	107	46	339	0	27134
8898	26895	60	36	121	0	27112
8899	447	38	41	26416	0	26942
8900	142	58	26159	329	0	26688
8901	73	52	26231	122	0	26478
8902	48	52	411	26351	0	26862
8903	59	67	26272	347	0	26745
8904	24375	57	342	154	0	24928
8905	318	26014	124	153	0	26609
8906	129	328	50	26412	0	26919
8907	69	108	55	26556	0	26788
8908	46	57	50	26674	0	26827
8909	38	54	53	26365	0	26510
8910	64	49	35	26679	0	26827
8911	65	61	26234	447	0	26807
8912	37	26309	345	215	0	26906
8913	26447	342	118	88	0	26995
8914	350	119	62	26175	0	26706
8915	110	74	52	26564	0	26800
8916	65	54	52	26485	0	26656
8917	62	26400	61	483	0	27006
8918	57	374	45	27006	0	27482
8919	67	123	64	27412	0	27666
8920	26586	60	60	482	0	27188
8921	361	26132	58	206	0	26757
8922	114	26608	59	139	0	26920
8923	80	446	56	26573	0	27155
8924	26233	135	66	439	0	26873
8925	401	77	26556	169	0	27203
8926	24503	63	395	159	0	25120
8927	409	73	27720	96	0	28298
8928	142	63	399	27374	0	27978
8929	78	66	127	28272	0	28543
8930	77	63	69	28111	0	28320
8931	62	78	54	28044	0	28238
8932	76	63	60	28133	0	28332
8933	27379	56	70	509	0	28014
8934	417	68	27226	224	0	27935
8935	141	100	381	27600	0	28222
8936	99	75	28816	453	0	29443
8937	67	28963	405	256	0	29691
8938	28667	370	139	171	0	29347
8939	431	135	30046	133	0	30745
8940	165	93	393	30213	0	30864
8941	105	75	133	31571	0	31884
8942	82	75	31688	623	0	32468
8943	101	84	31943	228	0	32356
8944	91	78	559	30330	0	31058
8945	31742	60	159	565	0	32526
8946	31893	65	92	232	0	32282
8947	547	31823	87	179	0	32636
8948	32158	476	62	162	0	32858
8949	523	145	75	30819	0	31562
8950	170	32913	80	561	0	33724
8951	124	463	67	33058	0	33712
8952	146	166	33439	537	0	34288
8953	114	96	472	31890	0	32572
8954	193	64	151	32973	0	33381
8955	31620	53	81	630	0	32384
8956	458	31578	77	273	0	32386
8957	30924	433	74	147	0	31578
8958	438	30901	72	152	0	31563
8959	29312	399	82	108	0	29901
8960	408	29806	52	145	0	30411
8961	176	29955	52	150	0	30333
8962	29992	441	71	149	0	30653
8963	463	194	71	28237	0	28965
8964	136	29583	63	431	0	30213
8965	30006	357	120	218	0	30701
8966	29843	117	70	144	0	30174
8967	30444	73	50	155	0	30722
8968	29847	50	74	112	0	30083
8969	437	30168	70	174	0	30849
8970	152	365	60	30484	0	31061
8971	115	123	70	31260	0	31568
8972	31292	75	60	513	0	31940
8973	407	74	61	30821	0	31363
8974	30540	60	61	453	0	31114
8975	410	78	29868	192	0	30548
8976	28447	66	344	227	0	29084
8977	409	66	29895	140	0	30510
8978	179	191	361	29046	0	29777
8979	29352	70	112	414	0	29948
8980	381	28896	91	234	0	29602
8981	27933	280	65	123	0	28401
8982	336	28193	50	117	0	28696
8983	127	295	38	29070	0	29530
8984	102	99	28234	320	0	28755
8985	24802	183	286	173	0	25444
8986	274	28290	83	103	0	28750
8987	126	316	78	27846	0	28366
8988	86	60	43	27503	0	27692
8989	73	58	37	27401	0	27569
8990	87	70	27290	289	0	27736
8991	79	27180	227	179	0	27665
8992	27123	219	70	87	0	27499
8993	27045	74	45	92	0	27256
8994	274	27073	47	84	0	27478
8995	27910	229	36	148	0	28323
8996	255	111	40	27704	0	28110
8997	96	27866	48	265	0	28275
8998	27884	243	38	121	0	28286
8999	271	86	27098	98	0	27553
9000	91	27434	231	102	0	27858
9001	120	238	89	27957	0	28404
9002	95	92	40	28238	0	28465
9003	97	72	27763	272	0	28204
9004	85	64	228	26333	0	26710
9005	118	77	27758	237	0	28190
9006	103	62	223	27176	0	27564
9007	95	59	68	27937	0	28159
9008	88	64	44	28016	0	28212
9009	82	62	41	28180	0	28365
9010	101	65	27774	302	0	28242
9011	115	87	29513	129	0	29844
9012	89	32658	360	178	0	33285
9013	95	422	130	34653	0	35300
9014	194	160	36016	472	0	36842
9015	69	35552	487	275	0	36383
9016	125	556	147	36705	0	37533
9017	82	200	38444	552	0	39278
9018	34546	82	563	236	0	35427
9019	39911	39	174	106	0	40230
9020	727	73	84	39726	0	40610
9021	272	141	39782	642	0	40837
9022	126	101	602	39503	0	40332
9023	39386	57	196	691	0	40330
9024	604	40756	100	297	0	41757
9025	41425	624	55	170	0	42274
9026	41744	219	62	136	0	42161
9027	790	84	60	40165	0	41099
9028	286	64	55	40893	0	41298
9029	150	61	44	41082	0	41337
9030	109	67	73	40805	0	41054
9031	125	56	64	41136	0	41381
9032	40347	61	53	888	0	41349
9033	40693	65	38	351	0	41147
9034	40509	67	118	181	0	40875
9035	900	108	38949	160	0	40117
9036	37697	69	603	195	0	38564
9037	716	103	232	38467	0	39518
9038	307	99	38123	786	0	39315
9039	157	36982	665	435	0	38239
9040	136	734	340	36446	0	37656
9041	167	213	146	35773	0	36299
9042	182	36416	145	774	0	37517
9043	222	549	100	37304	0	38175
9044	246	193	37052	733	0	38224
9045	179	104	37443	386	0	38112
9046	187	66	869	37545	0	38667
9047	37252	98	313	801	0	38464
9048	37126	103	142	406	0	37777
9049	951	136	37142	241	0	38470
9050	413	34684	654	283	0	36034
9051	251	36409	281	299	0	37240
9052	34281	780	135	361	0	35557
9053	713	284	35147	362	0	36506
9054	326	136	657	34876	0	35995
9055	34914	104	275	871	0	36164
9056	766	34446	156	490	0	35858
9057	433	35557	113	350	0	36453
9058	34987	755	155	254	0	36151
9059	860	298	143	35201	0	36502
9060	37516	115	147	858	0	38636
9061	918	103	187	42519	0	43727
9062	456	126	160	43936	0	44678
9063	330	144	43800	1248	0	45522
9064	233	156	897	44887	0	46173
9065	255	175	360	45933	0	46723
9066	45463	146	222	1463	0	47294
9067	1038	169	187	46409	0	47803
9068	495	183	46102	1285	0	48065
9069	45006	120	1088	707	0	46921
9070	1087	145	507	46364	0	48103
9071	45821	124	285	1277	0	47507
9072	1233	44018	252	764	0	46267
9073	599	46508	280	496	0	47883
9074	45963	1265	250	369	0	47847
9075	46429	559	222	409	0	47619
9076	1495	309	229	45936	0	47969
9077	739	300	45566	1229	0	47834
9078	487	196	1118	46320	0	48121
9079	44928	224	503	1357	0	47012
9080	1203	45589	315	769	0	47876
9081	694	1108	224	45571	0	47597
9082	45878	555	225	1282	0	47940
9083	1324	367	44980	742	0	47413
9084	44622	200	1085	628	0	46535
9085	44929	188	490	591	0	46198
9086	1512	207	45122	583	0	47424
9087	820	193	46115	578	0	47706
9088	565	187	1426	43742	0	45920
9089	545	173	623	43599	0	44940
9090	467	46347	336	1612	0	48762
9091	485	1076	302	46910	0	48773
9092	538	492	47442	1479	0	49951
9093	489	287	1240	47517	0	49533
9094	523	207	550	50130	0	51410
9095	541	226	48008	1769	0	50544
9096	456	47702	1222	1022	0	50402
9097	436	1164	614	47664	0	49878
9098	491	550	362	49224	0	50627
9099	48540	308	277	1818	0	50943
9100	1410	260	329	48380	0	50379
9101	741	291	48178	1639	0	50849
9102	47075	250	1295	898	0	49518
9103	48783	277	635	686	0	50381
9104	49192	281	380	645	0	50498
9105	1840	277	47384	583	0	50084
9106	887	279	1295	46426	0	48887
9107	650	211	707	48008	0	49576
9108	620	223	518	48525	0	49886
9109	46193	243	401	1885	0	48722
9110	1425	46428	435	1237	0	49525
9111	751	999	43123	695	0	45568
9112	468	41550	1064	654	0	43736
9113	407	39991	530	535	0	41463
9114	433	39123	357	489	0	40402
9115	592	1255	606	37968	0	40421
9116	411	458	37455	1123	0	39447
9117	32350	344	864	698	0	34256
9118	870	36060	494	620	0	38044
9119	33866	700	281	424	0	35271
9120	812	35628	231	508	0	37179
9121	35539	755	268	440	0	37002
9122	906	36222	259	429	0	37816
9123	560	856	36545	407	0	38368
9124	420	409	781	35776	0	37386
9125	365	310	398	37724	0	38797
9126	37386	221	304	1200	0	39111
9127	956	223	242	40551	0	41972
9128	538	260	40439	1244	0	42481
9129	468	192	994	40721	0	42375
9130	416	246	40632	1273	0	42567
9131	361	40070	1090	744	0	42265
9132	386	995	513	36534	0	38428
9133	354	40728	361	1103	0	42546
9134	40499	1010	316	590	0	42415
9135	1092	448	295	40561	0	42396
9136	579	331	40594	1182	0	42686
9137	443	236	40291	666	0	41636
9138	38917	247	1262	489	0	40915
9139	1087	246	562	39797	0	41692
9140	538	290	39661	1125	0	41614
9141	416	327	38894	602	0	40239
9142	261	39115	1253	510	0	41139
9143	314	1083	650	34543	0	36590
9144	271	38075	382	1041	0	39769
9145	249	963	299	38031	0	39542
9146	38003	415	331	1110	0	39859
9147	935	323	327	38232	0	39817
9148	474	263	275	39347	0	40359
9149	38924	273	267	1287	0	40751
9150	985	256	308	41298	0	42847
9151	514	284	285	39969	0	41052
9152	365	41989	292	1363	0	44009
9153	41962	1020	283	715	0	43980
9154	42753	471	257	525	0	44006
9155	1300	332	265	42166	0	44063
9156	624	226	302	42634	0	43786
9157	408	276	295	41798	0	42777
9158	293	40390	324	1583	0	42590
9159	324	42150	325	819	0	43618
9160	573	1275	261	39021	0	41130
9161	33052	298	165	879	0	34394
9162	32253	172	166	394	0	32985
9163	810	31672	171	341	0	32994
9164	29097	667	141	185	0	30090
9165	631	29528	119	237	0	30515
9166	209	29636	125	243	0	30213
9167	495	771	234	28503	0	30003
9168	27766	204	143	658	0	28771
9169	582	27252	118	315	0	28267
9170	197	27978	142	229	0	28546
9171	163	656	97	27657	0	28573
9172	153	192	96	28224	0	28665
9173	132	155	27472	744	0	28503
9174	26259	134	584	318	0	27295
9175	27057	154	181	241	0	27633
9176	690	161	27427	230	0	28508
9177	258	155	27422	244	0	28079
9178	159	162	648	27415	0	28384
9179	157	152	180	28023	0	28512
9180	165	27465	116	795	0	28541
9181	150	655	109	27871	0	28785
9182	185	247	27340	813	0	28585
9183	178	172	600	26893	0	27843
9184	184	166	195	27487	0	28032
9185	26719	161	146	842	0	27868
9186	668	167	26303	395	0	27533
9187	25042	174	639	311	0	26166
9188	684	182	25498	314	0	26678
9189	233	185	619	24441	0	25478
9190	223	191	24606	726	0	25746
9191	178	179	24668	371	0	25396
9192	194	338	712	23509	0	24753
9193	22815	200	392	816	0	24223
9194	22034	137	207	379	0	22757
9195	652	22391	174	324	0	23541
9196	22282	565	177	292	0	23316
9197	21874	252	177	252	0	22555
9198	661	22006	187	280	0	23134
9199	269	599	158	22309	0	23335
9200	198	232	176	22854	0	23460
9201	171	184	152	22636	0	23143
9202	180	162	144	22906	0	23392
9203	193	174	22091	849	0	23307
9204	20910	153	604	411	0	22078
9205	633	133	224	22096	0	23086
9206	284	144	194	21734	0	22356
9207	224	22091	163	831	0	23309
9208	251	631	96	22568	0	23546
9209	222	239	22677	829	0	23967
9210	21228	198	618	432	0	22476
9211	719	186	22856	361	0	24122
9212	294	172	536	22124	0	23126
9213	21950	143	163	789	0	23045
9214	630	22409	104	449	0	23592
9215	331	575	86	23240	0	24232
9216	253	256	23168	760	0	24437
9217	213	202	529	23324	0	24268
9218	23171	183	175	771	0	24300
9219	703	181	23185	341	0	24410
9220	317	165	22623	275	0	23380
9221	223	22210	631	286	0	23350
9222	20987	593	188	243	0	22011
9223	584	21024	106	286	0	22000
9224	262	601	20302	217	0	21382
9225	162	195	19548	174	0	20079
9226	159	18994	523	226	0	19902
9227	15464	336	198	112	0	16110
9228	317	15665	124	129	0	16235
9229	96	309	86	15365	0	15856
9230	63	83	96	15832	0	16074
9231	84	57	15646	398	0	16185
9232	91	49	320	15531	0	15991
9233	77	52	15828	377	0	16334
9234	15393	51	348	145	0	15937
9235	15949	42	126	112	0	16229
9236	16023	54	88	123	0	16288
9237	402	48	15621	119	0	16190
9238	15530	52	345	101	0	16028
9239	358	41	100	14657	0	15156
9240	111	15596	106	347	0	16160
9241	15677	290	108	147	0	16222
9242	352	74	15462	101	0	15989
9243	14819	40	359	88	0	15306
9244	15080	32	145	99	0	15356
9245	380	58	14590	95	0	15123
9246	135	14492	321	83	0	15031
9247	118	383	151	14419	0	15071
9248	94	80	14357	308	0	14839
9249	104	68	13902	93	0	14167
9250	75	441	237	11125	0	11878
9251	54	31	11225	189	0	11499
9252	49	44	170	10577	0	10840
9253	44	14	63	10484	0	10605
9254	42	21	44	10770	0	10877
9255	50	33	10660	178	0	10921
9256	41	36	163	10527	0	10767
9257	47	27	10674	179	0	10927
9258	41	24	186	10779	0	11030
9259	11042	20	71	190	0	11323
9260	178	28	52	11011	0	11269
9261	54	11485	42	205	0	11786
9262	50	193	36	11843	0	12122
9263	11803	58	38	216	0	12115
9264	201	11923	54	87	0	12265
9265	77	192	44	12003	0	12316
9266	11999	48	55	225	0	12327
9267	219	41	12226	89	0	12575
9268	77	27	229	12066	0	12399
9269	66	40	12479	231	0	12816
9270	62	40	12415	80	0	12597
9271	61	49	250	12070	0	12430
9272	12301	34	95	206	0	12636
9273	217	25	12157	80	0	12479
9274	11830	34	216	69	0	12149
9275	243	48	93	12272	0	12656
9276	82	32	12422	213	0	12749
9277	59	34	12112	75	0	12280
9278	69	35	12110	72	0	12286
9279	39	98	251	11443	0	11831
9280	11897	32	158	199	0	12286
9281	175	11890	71	90	0	12226
9282	83	166	64	11713	0	12026
9283	56	50	51	12191	0	12348
9284	12111	26	52	224	0	12413
9285	12093	21	55	87	0	12256
9286	206	12093	68	64	0	12431
9287	12263	165	48	66	0	12542
9288	12204	48	53	52	0	12357
9289	230	29	57	12148	0	12464
9290	96	28	12291	187	0	12602
9291	12056	27	192	83	0	12358
9292	213	32	72	12501	0	12818
9293	89	23	37	12647	0	12796
9294	12434	30	39	240	0	12743
9295	199	29	42	12034	0	12304
9296	91	22	36	12242	0	12391
9297	12032	15	53	244	0	12344
9298	204	12518	51	105	0	12878
9299	12380	161	56	64	0	12661
9300	209	47	12339	67	0	12662
9301	12140	21	202	59	0	12422
9302	208	13	67	12299	0	12587
9303	74	12611	57	196	0	12938
9304	56	167	54	12819	0	13096
9305	56	43	47	12880	0	13026
9306	69	14	45	12834	0	12962
9307	12484	27	47	226	0	12784
9308	179	12212	34	106	0	12531
9309	66	12126	34	72	0	12298
9310	11825	153	36	52	0	12066
9311	170	49	12238	51	0	12508
9312	80	24	12024	41	0	12169
9313	11257	53	272	51	0	11633
9314	168	21	11886	73	0	12148
9315	59	6	115	11086	0	11266
9316	28	17	44	11167	0	11256
9317	33	8	25	11572	0	11638
9318	34	9	16	11295	0	11354
9319	26	11170	33	165	0	11394
9320	28	108	29	11378	0	11543
9321	42	44	11170	132	0	11388
9322	36	16	132	11008	0	11192
9323	32	18	10972	141	0	11163
9324	48	23	10798	57	0	10926
9325	28	12	159	10909	0	11108
9326	47	37	11158	149	0	11391
9327	31	10	135	10987	0	11163
9328	11050	12	62	157	0	11281
9329	148	23	11191	74	0	11436
9330	10505	13	131	46	0	10695
9331	146	15	59	11119	0	11339
9332	68	23	11116	150	0	11357
9333	42	10986	139	98	0	11265
9334	62	124	63	11382	0	11631
9335	43	40	11802	157	0	12042
9336	40	17	148	11714	0	11919
9337	12079	11	64	171	0	12325
9338	12196	22	27	90	0	12335
9339	12500	20	32	64	0	12616
9340	198	21	37	12600	0	12856
9341	74	19	27	12858	0	12978
9342	59	14	30	13155	0	13258
9343	13341	16	31	214	0	13602
9344	192	13681	35	92	0	14000
9345	73	169	28	13940	0	14210
9346	45	62	31	14190	0	14328
9347	13902	28	23	287	0	14240
9348	212	14274	33	120	0	14639
9349	94	211	28	14899	0	15232
9350	15037	57	32	290	0	15416
9351	15040	26	27	110	0	15203
9352	325	24	25	14894	0	15268
9353	14995	23	36	292	0	15346
9354	297	22	30	15005	0	15354
9355	96	31	15488	307	0	15922
9356	70	23	265	15556	0	15914
9357	56	23	72	16009	0	16160
9358	73	17	39	16044	0	16173
9359	15188	25	45	336	0	15594
9360	262	15287	27	129	0	15705
9361	14582	228	30	67	0	14907
9362	233	14575	38	69	0	14915
9363	68	15241	23	59	0	15391
9364	14950	254	55	52	0	15311
9365	231	15247	22	61	0	15561
9366	85	247	15	15185	0	15532
9367	15064	58	31	247	0	15400
9368	15031	24	15	88	0	15158
9369	261	24	21	15021	0	15327
9370	79	22	22	14749	0	14872
9371	51	15055	18	283	0	15407
9372	15224	227	19	104	0	15574
9373	14669	60	19	74	0	14822
9374	248	15752	23	74	0	16097
9375	68	15973	28	88	0	16157
9376	55	298	24	15863	0	16240
9377	15830	61	16	310	0	16217
9378	287	42	25	15742	0	16096
9379	91	30	21	16183	0	16325
9380	70	40	15783	347	0	16240
9381	63	34	15875	106	0	16078
9382	62	45	291	15688	0	16086
9383	57	44	15867	325	0	16293
9384	46	15808	285	127	0	16266
9385	72	278	52	16017	0	16419
9386	48	69	26	16377	0	16520
9387	55	43	25	16430	0	16553
9388	61	39	16284	368	0	16752
9389	70	40	15676	129	0	15915
9390	14884	24	301	111	0	15320
9391	287	16078	66	91	0	16522
9392	16074	289	35	75	0	16473
9393	325	70	37	15922	0	16354
9394	16324	49	23	333	0	16729
9395	313	45	23	15889	0	16270
9396	85	16616	32	306	0	17039
9397	16739	275	23	117	0	17154
9398	317	75	16047	90	0	16529
9399	97	15985	264	81	0	16427
9400	16079	274	61	102	0	16516
9401	303	67	38	15514	0	15922
9402	86	15528	35	309	0	15958
9403	88	290	25	16180	0	16583
9404	16000	80	30	364	0	16474
9405	331	59	33	16103	0	16526
9406	15951	46	37	370	0	16404
9407	343	58	15829	125	0	16355
9408	112	75	276	15754	0	16217
9409	15750	42	65	357	0	16214
9410	344	55	15566	139	0	16104
9411	116	14977	296	120	0	15509
9412	82	326	70	14952	0	15430
9413	94	95	14819	342	0	15350
9414	77	74	15034	137	0	15322
9415	87	97	320	14929	0	15433
9416	82	54	15112	361	0	15609
9417	96	67	15087	136	0	15386
9418	94	53	317	14649	0	15113
9419	15075	49	87	356	0	15567
9420	326	55	52	15023	0	15456
9421	112	57	50	15563	0	15782
9422	85	75	15572	382	0	16114
9423	94	65	301	16047	0	16507
9424	16502	53	82	406	0	17043
9425	333	60	16528	147	0	17068
9426	101	16582	302	121	0	17106
9427	83	316	75	16921	0	17395
9428	16934	85	53	368	0	17440
9429	344	75	66	16537	0	17022
9430	98	16986	65	364	0	17513
9431	97	311	17354	124	0	17886
9432	92	94	313	17889	0	18388
9433	18914	71	97	368	0	19450
9434	385	63	18885	149	0	19482
9435	144	46	369	19395	0	19954
9436	20116	45	103	467	0	20731
9437	20854	52	81	167	0	21154
9438	491	21201	85	140	0	21917
9439	20911	417	65	129	0	21522
9440	493	111	75	21103	0	21782
9441	130	83	21526	480	0	22219
9442	97	20836	430	193	0	21556
9443	72	21609	125	133	0	21939
9444	104	530	144	20770	0	21548
9445	94	102	107	21443	0	21746
9446	80	60	20620	449	0	21209
9447	58	20381	411	173	0	21023
9448	53	20758	117	116	0	21044
9449	92	438	86	19772	0	20388
9450	19348	87	57	349	0	19841
9451	305	19436	43	142	0	19926
9452	116	311	30	19847	0	20304
9453	20346	83	48	392	0	20869
9454	326	49	51	20575	0	21001
9455	104	40	47	20353	0	20544
9456	77	39	50	20495	0	20661
9457	72	45	48	20489	0	20654
9458	19906	49	53	424	0	20432
9459	356	58	34	20223	0	20671
9460	97	48	19642	374	0	20161
9461	18694	93	357	141	0	19285
9462	347	70	19399	102	0	19918
9463	127	51	19924	88	0	20190
9464	70	60	375	19795	0	20300
9465	68	55	135	20030	0	20288
9466	67	48	63	20542	0	20720
9467	20227	49	45	421	0	20742
9468	362	53	20065	145	0	20625
9469	19604	39	330	137	0	20110
9470	20516	51	90	109	0	20766
9471	390	56	21048	108	0	21602
9472	20046	39	320	145	0	20550
9473	378	46	20966	107	0	21497
9474	95	21419	290	131	0	21935
9475	154	311	127	21705	0	22297
9476	63	73	65	22004	0	22205
9477	74	64	52	21841	0	22031
9478	59	43	50	21835	0	21987
9479	66	47	21671	388	0	22172
9480	75	48	21419	165	0	21707
9481	70	38	316	21652	0	22076
9482	70	52	22055	320	0	22497
9483	20726	35	291	182	0	21234
9484	22362	46	103	145	0	22656
9485	326	38	76	22173	0	22613
9486	22112	39	63	314	0	22528
9487	310	22773	66	190	0	23339
9488	22729	266	77	136	0	23208
9489	351	100	22977	101	0	23529
9490	122	59	287	22452	0	22920
9491	91	23416	102	334	0	23943
9492	23737	254	91	165	0	24247
9493	299	99	76	23969	0	24443
9494	126	68	23734	345	0	24273
9495	82	41	290	23413	0	23826
9496	23365	46	119	368	0	23898
9497	325	67	24069	178	0	24639
9498	140	50	307	24012	0	24509
9499	124	40	144	24725	0	25033
9500	139	62	24450	400	0	25051
9501	104	23934	339	185	0	24562
9502	110	22962	142	182	0	23396
9503	119	328	82	24850	0	25379
9504	99	109	82	25662	0	25952
9505	118	98	56	26055	0	26327
9506	25091	69	90	473	0	25723
9507	25248	58	70	222	0	25598
9508	400	70	100	25663	0	26233
9509	25498	65	91	409	0	26063
9510	362	25829	88	230	0	26509
9511	144	358	79	26632	0	27213
9512	109	113	76	26948	0	27246
9513	102	88	70	27115	0	27375
9514	25622	61	84	509	0	26276
9515	339	25486	82	264	0	26171
9516	147	305	87	26167	0	26706
9517	26012	103	82	463	0	26660
9518	366	72	77	26177	0	26692
9519	153	48	126	26080	0	26407
9520	131	25307	87	487	0	26012
9521	117	26243	80	266	0	26706
9522	129	357	81	25972	0	26539
9523	139	126	90	25727	0	26082
9524	24688	57	87	500	0	25332
9525	372	48	91	24945	0	25456
9526	190	59	24507	453	0	25209
9527	127	63	336	24144	0	24670
9528	108	24244	140	436	0	24928
9529	24994	324	99	257	0	25674
9530	397	101	97	24882	0	25477
9531	186	62	78	24415	0	24741
9532	125	24341	85	486	0	25037
9533	23474	249	58	206	0	23987
9534	315	25126	67	166	0	25674
9535	167	303	68	25162	0	25700
9536	133	93	24762	322	0	25310
9537	119	217	241	23419	0	23996
9538	23427	34	83	284	0	23828
9539	225	23688	37	148	0	24098
9540	75	233	34	23652	0	23994
9541	45	23455	35	262	0	23797
9542	61	233	15	23903	0	24212
9543	62	89	23477	300	0	23928
9544	71	102	214	23251	0	23638
9545	54	40	65	23501	0	23660
9546	48	43	39	23902	0	24032
9547	22893	35	30	331	0	23289
9548	22900	44	33	147	0	23124
9549	251	23321	26	130	0	23728
9550	23186	218	31	108	0	23543
9551	228	23097	19	122	0	23466
9552	85	23657	34	111	0	23887
9553	22860	262	24	105	0	23251
9554	274	112	22122	94	0	22602
9555	82	62	201	22259	0	22604
9556	77	44	61	23182	0	23364
9557	63	52	26	23803	0	23944
9558	22931	43	28	366	0	23368
9559	242	23243	34	200	0	23719
9560	113	292	16	23198	0	23619
9561	78	23489	34	299	0	23900
9562	24203	303	31	159	0	24696
9563	293	109	29	24680	0	25111
9564	122	77	33	29904	0	30136
9565	63	32706	32	627	0	33428
9566	74	496	24	34847	0	35441
9567	61	246	27	35313	0	35647
9568	33408	123	29	909	0	34469
9569	554	33082	29	529	0	34194
9570	239	34200	38	264	0	34741
9571	129	778	25	33639	0	34571
9572	150	322	32270	674	0	33416
9573	108	170	31995	374	0	32647
9574	80	153	745	32174	0	33152
9575	97	127	31682	711	0	32617
9576	71	108	643	32082	0	32904
9577	83	71	304	31717	0	32175
9578	67	66	132	33220	0	33485
9579	31653	68	104	991	0	32816
9580	601	78	69	32350	0	33098
9581	309	88	64	31876	0	32337
9582	128	31227	60	960	0	32375
9583	137	585	49	32707	0	33478
9584	126	306	31287	833	0	32552
9585	94	155	569	32041	0	32859
9586	99	151	252	32747	0	33249
9587	30657	134	106	1014	0	31911
9588	610	130	87	31349	0	32176
9589	290	120	92	31002	0	31504
9590	167	102	75	31362	0	31706
9591	28517	99	72	1115	0	29803
9592	606	29635	83	584	0	30908
9593	292	672	86	30215	0	31265
9594	153	340	72	30797	0	31362
9595	159	193	29455	1070	0	30877
9596	138	144	610	29832	0	30724
9597	27816	141	297	952	0	29206
9598	612	28360	155	617	0	29744
9599	327	647	115	28269	0	29358
9600	170	363	114	28944	0	29591
9601	192	179	27782	1124	0	29277
9602	26046	163	612	681	0	27502
9603	605	27430	320	532	0	28887
9604	27233	652	159	470	0	28514
9605	635	374	157	27799	0	28965
9606	359	207	146	28125	0	28837
9607	239	211	117	28351	0	28918
9608	216	189	119	28544	0	29068
9609	27309	197	122	1203	0	28831
9610	650	170	116	26825	0	27761
9611	327	25953	181	1115	0	27576
9612	179	580	202	26876	0	27837
9613	190	270	178	27543	0	28181
9614	26273	181	163	1231	0	27848
9615	640	26242	124	783	0	27789
9616	387	607	89	27318	0	28401
9617	26538	364	109	1086	0	28097
9618	27043	200	99	808	0	28150
9619	896	174	95	27260	0	28425
9620	483	226	26352	1017	0	28078
9621	26226	204	565	772	0	27767
9622	687	181	319	27231	0	28418
9623	402	161	26754	1076	0	28393
9624	237	122	675	27520	0	28554
9625	263	148	370	27539	0	28320
9626	296	153	187	26889	0	27525
9627	224	26875	161	1310	0	28570
9628	210	613	145	28008	0	28976
9629	187	332	124	28121	0	28764
9630	222	186	120	28330	0	28858
9631	247	231	119	28152	0	28749
9632	236	224	90	27746	0	28296
9633	282	241	115	27725	0	28363
9634	24237	209	156	1363	0	25965
9635	615	141	23513	940	0	25209
9636	356	22946	560	708	0	24570
9637	22989	551	311	561	0	24412
9638	594	23162	176	585	0	24517
9639	22927	617	197	520	0	24261
9640	728	329	228	22813	0	24098
9641	22841	175	170	919	0	24105
9642	723	161	164	22947	0	23995
9643	484	151	119	21853	0	22607
9644	288	22001	84	1132	0	23505
9645	22283	484	94	832	0	23693
9646	635	292	22302	710	0	23939
9647	400	148	484	22988	0	24020
9648	296	135	22730	983	0	24144
9649	277	152	22049	741	0	23219
9650	22068	187	665	599	0	23519
9651	590	143	345	22731	0	23809
9652	397	120	22283	985	0	23785
9653	274	129	22836	723	0	23962
9654	248	122	690	22662	0	23722
9655	283	158	332	23402	0	24175
9656	22944	129	180	1030	0	24283
9657	660	114	154	23175	0	24103
9658	428	120	23210	991	0	24749
9659	311	124	510	23405	0	24350
9660	313	254	301	22724	0	23592
9661	250	23271	178	977	0	24676
9662	22316	445	164	694	0	23619
9663	483	21804	155	573	0	23015
9664	16515	212	77	314	0	17118
9665	158	12982	48	126	0	13314
9666	43	12026	35	64	0	12168
9667	128	113	79	11784	0	12104
9668	38	42	57	11761	0	11898
9669	57	70	18	11651	0	11796
9670	11116	15	16	98	0	11245
9671	76	31	11222	61	0	11390
9672	30	14	48	11083	0	11175
9673	10716	17	22	81	0	10836
9674	53	10950	20	81	0	11104
9675	39	10941	23	58	0	11061
9676	38	68	19	11151	0	11276
9677	27	26	39	11244	0	11336
9678	22	18	17	11267	0	11324
9679	25	11607	18	101	0	11751
9680	20	57	16	11683	0	11776
9681	37	40	11519	94	0	11690
9682	22	22	10550	48	0	10642
9683	10392	19	43	47	0	10501
9684	71	11	22	11360	0	11464
9685	11447	9	32	71	0	11559
9686	11349	10	11	40	0	11410
9687	46	11517	24	49	0	11636
9688	11664	39	13	45	0	11761
9689	12030	21	16	67	0	12134
9690	64	19	13	11980	0	12076
9691	43	9	7	12440	0	12499
9692	37	21	12963	63	0	13084
9693	18	13312	38	49	0	13417
9694	21	31	20	13063	0	13135
9695	17	25	13	13553	0	13608
9696	13662	18	8	66	0	13754
9697	36	13	19	13592	0	13660
9698	13860	9	21	72	0	13962
9699	59	11	9	14257	0	14336
9700	26	14559	11	104	0	14700
9701	15029	81	14	75	0	15199
9702	103	21	11	16891	0	17026
9703	41	17	16	18363	0	18437
9704	33	11	21	19476	0	19541
9705	37	27	19307	326	0	19697
9706	28	19	254	19433	0	19734
9707	19981	16	84	343	0	20424
9708	279	15	33	20859	0	21186
9709	109	10	16	23808	0	23943
9710	53	19	19	23547	0	23638
9711	27	23580	27	566	0	24200
9712	31	24642	18	190	0	24881
9713	24052	537	13	77	0	24679
9714	459	24453	42	72	0	25026
9715	24290	486	21	49	0	24846
9716	24387	110	6	47	0	24550
9717	24363	46	18	80	0	24507
9718	640	36	24190	41	0	24907
9719	137	24687	455	42	0	25321
9720	24875	469	92	64	0	25500
9721	479	113	32	25247	0	25871
9722	133	44	14	25768	0	25959
9723	57	26	15	25498	0	25596
9724	40	24741	23	601	0	25405
9725	46	458	18	25160	0	25682
9726	24908	105	10	566	0	25589
9727	476	37	9	24675	0	25197
9728	124	22	22	25270	0	25438
9729	72	38	24545	670	0	25325
9730	67	59	25192	229	0	25547
9731	43	36	572	25273	0	25924
9732	51	35	150	25625	0	25861
9733	51	25655	72	670	0	26448
9734	77	486	45	25973	0	26581
9735	77	134	42	26392	0	26645
9736	57	65	33	26658	0	26813
9737	25559	61	34	708	0	26362
9738	546	81	26054	233	0	26914
9739	171	86	473	26513	0	27243
9740	26758	89	119	577	0	27543
9741	27008	91	55	210	0	27364
9742	679	79	44	26639	0	27441
9743	250	78	35	27280	0	27643
9744	26577	93	40	702	0	27412
9745	563	26623	61	264	0	27511
9746	227	27168	58	193	0	27646
9747	183	635	49	26986	0	27853
9748	27360	197	49	652	0	28258
9749	27834	99	37	324	0	28294
9750	27601	81	48	239	0	27969
9751	714	92	27699	220	0	28725
9752	25652	116	530	228	0	26526
9753	636	122	27260	203	0	28221
9754	26003	84	525	250	0	26862
9755	582	27145	165	258	0	28150
9756	243	542	27234	233	0	28252
9757	173	189	544	26666	0	27572
9758	163	117	27441	707	0	28428
9759	137	101	581	26663	0	27482
9760	26839	99	170	769	0	27877
9761	613	100	27661	401	0	28775
9762	233	88	552	27235	0	28108
9763	163	29561	220	787	0	30731
9764	152	542	143	30447	0	31284
9765	167	182	99	30505	0	30953
9766	201	150	97	30367	0	30815
9767	30008	117	66	893	0	31084
9768	30081	106	77	469	0	30733
9769	751	124	76	30248	0	31199
9770	368	131	29739	807	0	31045
9771	279	152	29273	384	0	30088
9772	240	137	691	29900	0	30968
9773	290	180	31521	738	0	32729
9774	268	142	587	31325	0	32322
9775	280	140	192	31201	0	31813
9776	293	117	129	31880	0	32419
9777	258	30760	140	882	0	32040
9778	264	32129	145	385	0	32923
9779	242	674	140	32089	0	33145
9780	242	257	126	32337	0	32962
9781	253	141	121	32440	0	32955
9782	31383	120	140	868	0	32511
9783	723	116	31963	419	0	33221
9784	342	119	600	31948	0	33009
9785	32049	97	268	755	0	33169
9786	644	32404	182	463	0	33693
9787	282	572	158	33320	0	34332
9788	218	202	176	33917	0	34513
9789	184	138	158	33432	0	33912
9790	183	92	160	33509	0	33944
9791	191	99	32335	952	0	33577
9792	29235	104	622	509	0	30470
9793	31689	83	249	442	0	32463
9794	795	99	31783	332	0	33009
9795	30186	89	605	394	0	31274
9796	31918	91	251	344	0	32604
9797	787	101	32354	335	0	33577
9798	279	33089	633	358	0	34359
9799	279	645	252	32943	0	34119
9800	248	161	34160	715	0	35284
9801	214	33246	567	504	0	34531
9802	241	400	31638	294	0	32573
9803	128	30478	445	218	0	31269
9804	173	326	214	29443	0	30156
9805	147	87	29574	339	0	30147
9806	122	98	334	28256	0	28810
9807	154	47	29970	356	0	30527
9808	59	29506	301	227	0	30093
9809	26718	79	106	67	0	26970
9810	52	26733	26	60	0	26871
9811	48	28367	23	100	0	28538
9812	214	132	65	28456	0	28867
9813	10	27	40	28827	0	28904
9814	18	10	12	28860	0	28900
9815	17	5	6	28810	0	28838
9816	19	10	14	29081	0	29124
9817	36	35	31023	70	0	31164
9818	22	8	43	30149	0	30222
9819	23	13	17	31699	0	31752
9820	31940	9	10	125	0	32084
9821	31834	10	8	63	0	31915
9822	32153	10	16	63	0	32242
9823	95	10	6	32438	0	32549
9824	35388	10	11	178	0	35587
9825	38103	17	21	179	0	38320
9826	38967	9	18	76	0	39070
9827	291	23	38858	23	0	39195
9828	37514	11	225	45	0	37795
9829	39530	10	40	82	0	39662
9830	39860	8	26	61	0	39955
9831	295	11	14	39648	0	39968
9832	81	30	40430	280	0	40821
9833	35	18	242	39768	0	40063
9834	41542	11	59	361	0	41973
9835	268	15	26	41983	0	42292
9836	59	43979	23	279	0	44340
9837	43	241	8	45313	0	45605
9838	45112	42	14	317	0	45485
9839	45294	25	14	124	0	45457
9840	44774	9	13	66	0	44862
9841	375	45	46314	51	0	46785
9842	98	15	303	45078	0	45494
9843	57	12	55	47782	0	47906
9844	103	29	47928	369	0	48429
9845	36	46645	322	226	0	47229
9846	100	314	47331	54	0	47799
9847	43	48	319	46784	0	47194
9848	47640	33	85	352	0	48110
9849	372	53	49700	105	0	50230
9850	121	34	321	49219	0	49695
9851	112	44	49934	350	0	50440
9852	47520	21	359	154	0	48054
9853	356	21	70	50873	0	51320
9854	150	56	53657	355	0	54218
9855	101	27	339	52656	0	53123
9856	138	50	54965	415	0	55568
9857	79	54899	381	208	0	55567
9858	116	332	79	55364	0	55891
9859	56337	77	122	458	0	56994
9860	424	39	67	57107	0	57637
9861	162	27	63	56395	0	56647
9862	56313	14	78	460	0	56865
9863	403	53716	71	222	0	54412
9864	152	55341	62	159	0	55714
9865	124	440	70	55430	0	56064
9866	88	55749	78	446	0	56361
9867	124	339	43	56178	0	56684
9868	125	69	55	56413	0	56662
9869	56252	68	55	496	0	56871
9870	419	56085	63	334	0	56901
9871	261	361	55491	151	0	56264
9872	129	57472	375	181	0	58157
9873	56732	359	104	153	0	57348
9874	57475	75	100	172	0	57822
9875	503	91	74	56952	0	57620
9876	58676	52	79	502	0	59309
9877	486	51	91	58395	0	59023
9878	58732	74	84	551	0	59441
9879	59547	45	97	229	0	59918
9880	572	68	95	61717	0	62452
9881	62654	49	108	574	0	63385
9882	605	82	62429	199	0	63315
9883	60586	41	466	240	0	61333
9884	544	66	158	62994	0	63762
9885	64006	45	125	517	0	64693
9886	537	64979	125	285	0	65926
9887	280	417	139	64989	0	65825
9888	217	106	133	65360	0	65816
9889	64632	67	130	608	0	65437
9890	619	108	64948	283	0	65958
9891	253	64562	480	300	0	65595
9892	253	435	167	65614	0	66469
9893	231	66494	144	539	0	67408
9894	232	466	106	67564	0	68368
9895	251	137	114	66882	0	67384
9896	205	120	115	67615	0	68055
9897	66748	133	106	717	0	67704
9898	546	123	95	65885	0	66649
9899	66435	132	112	682	0	67361
9900	66008	117	108	371	0	66604
9901	640	96	110	66521	0	67367
9902	66441	80	135	666	0	67322
9903	65056	105	107	349	0	65617
9904	664	122	66057	258	0	67101
9905	282	125	492	63857	0	64756
9906	67005	117	182	602	0	67906
9907	542	66556	159	373	0	67630
9908	67917	442	126	369	0	68854
9909	67915	152	145	266	0	68478
9910	698	135	66076	254	0	67163
9911	308	93	525	62214	0	63140
9912	69893	96	196	813	0	70998
9913	664	111	134	71322	0	72231
9914	305	88	130	74142	0	74665
9915	243	107	121	74927	0	75398
9916	244	90	146	79011	0	79491
9917	78552	89	117	1016	0	79774
9918	1010	147	81120	402	0	82679
9919	381	153	892	83979	0	85405
9920	339	119	93892	1155	0	95505
9921	293	158	97886	473	0	98810
9922	95506	90	2146	391	0	98133
9923	2039	155	103994	284	0	106472
9924	659	100921	1915	299	0	103794
9925	101857	1723	946	304	0	104830
9926	102595	566	245	197	0	103603
9927	2342	201	137	98160	0	100840
9928	911	118	102223	1725	0	104977
9929	426	125	101463	599	0	102613
9930	100605	82	2296	375	0	103358
9931	1952	129	787	105465	0	108333
9932	105525	47	293	1872	0	107737
9933	1948	108088	213	863	0	111112
9934	108249	1805	173	342	0	110569
9935	107457	638	154	228	0	108477
9936	2485	106208	155	285	0	109133
9937	912	1815	133	106450	0	109310
9938	106202	635	138	1940	0	108915
9939	2145	266	106476	772	0	109659
9940	798	106882	1997	440	0	110117
9941	461	1904	755	105907	0	109027
9942	106231	643	366	1998	0	109238
9943	1991	107303	287	861	0	110442
9944	108660	1949	203	440	0	111252
9945	2380	823	107153	235	0	110591
9946	104715	325	2056	315	0	107411
9947	2440	251	108231	232	0	111154
9948	104641	153	2284	274	0	107352
9949	105663	143	894	270	0	106970
9950	2914	180	104574	324	0	107992
9951	1134	104707	2157	456	0	108454
9952	688	2008	884	103124	0	106704
9953	655	786	105040	2180	0	108661
9954	525	102614	2207	1037	0	106383
9955	555	2091	963	101604	0	105213
9956	580	834	614	103707	0	105735
9957	649	459	101669	2799	0	105576
9958	674	282	2338	98224	0	101518
9959	660	284	1153	102101	0	104198
9960	670	341	100723	2895	0	104629
9961	659	350	2433	95497	0	98939
9962	643	100115	1239	2428	0	104425
9963	100906	2187	800	1077	0	104970
9964	2594	940	735	97718	0	101987
9965	1346	101093	864	2355	0	105658
9966	1160	2283	856	93121	0	97420
9967	1043	102828	889	2180	0	106940
9968	1379	2453	101387	1033	0	106252
9969	971	102753	2648	757	0	107129
9970	101943	2568	1258	627	0	106396
9971	102379	1087	891	647	0	105004
9972	103516	717	853	760	0	105846
9973	3665	587	105327	820	0	110399
9974	1943	552	104800	753	0	108048
9975	1304	107731	3476	798	0	113309
9976	1312	2764	1581	99600	0	105257
9977	1239	110216	1010	2596	0	115061
9978	1432	3177	794	93513	0	98916
9979	1281	110057	837	2470	0	114645
9980	109246	3053	838	1237	0	114374
9981	116968	1563	855	904	0	120290
9982	4379	1014	827	119745	0	125965
9983	2337	759	119555	3481	0	126132
9984	114102	788	3564	1636	0	120090
9985	3858	120259	1770	1174	0	127061
9986	2026	3399	1244	117509	0	124178
9987	1745	1665	986	113122	0	117518
9988	1375	120266	944	3954	0	126539
9989	120244	3566	1029	1772	0	126611
9990	4288	1733	119329	980	0	126330
9991	2338	1172	3618	118742	0	125870
9992	119612	906	1812	3553	0	125883
9993	118597	871	1327	1761	0	122556
9994	5024	118447	1043	1345	0	125859
9995	2300	3616	1071	112867	0	119854
9996	1366	119894	1132	3552	0	125944
9997	121207	3855	1169	1907	0	128138
9998	3897	1851	121100	1494	0	128342
9999	2089	1424	122216	1123	0	126852
10000	1488	1089	4314	118501	0	125392
10001	1238	1038	1999	116973	0	121248
10002	1163	120205	1440	4434	0	127242
10003	1191	3693	1113	120808	0	126805
10004	1246	1740	119315	4248	0	126549
10005	115818	1222	3803	2065	0	122908
10006	3780	1166	1743	120145	0	126834
10007	1961	1211	119026	4015	0	126213
10008	1493	1240	3621	118777	0	125131
10009	1198	1084	1781	115331	0	119394
10010	949	119106	1332	4633	0	126020
10011	1176	3763	1019	118355	0	124313
10012	1099	1863	1029	117186	0	121177
10013	1225	1368	1090	116731	0	120414
10014	108628	1042	994	4773	0	115437
10015	3642	107844	951	2347	0	114784
10016	1908	107109	835	1482	0	111334
10017	101729	3597	818	1102	0	107246
10018	96427	1497	861	1058	0	99843
10019	3415	94445	959	1010	0	99829
10020	1152	86506	672	702	0	89032
10021	74857	2131	404	515	0	77907
10022	1742	75531	314	576	0	78163
10023	660	74419	312	527	0	75918
10024	71886	1961	687	484	0	75018
10025	1661	72412	291	451	0	74815
10026	71389	1739	328	488	0	73944
10027	71211	698	345	464	0	72718
10028	69930	543	319	445	0	71237
10029	2075	69419	321	516	0	72331
10030	845	69902	287	528	0	71562
10031	617	1944	237	66282	0	69080
10032	499	69075	259	1599	0	71432
10033	567	1865	224	68594	0	71250
10034	68793	749	291	1874	0	71707
10035	1769	578	284	67148	0	69779
10036	796	67533	283	1877	0	70489
10037	65817	1634	283	837	0	68571
10038	1724	66351	313	688	0	69076
10039	807	68129	268	652	0	69856
10040	744	2370	256	63682	0	67052
10041	492	66242	249	1646	0	68629
10042	65244	1767	320	731	0	68062
10043	1678	793	64158	589	0	67218
10044	744	63755	1507	658	0	66664
10045	577	1583	593	63993	0	66746
10046	529	784	64050	1763	0	67126
10047	509	582	1473	62459	0	65023
10048	471	487	599	64455	0	66012
10049	485	519	459	64847	0	66310
10050	524	475	355	64384	0	65738
10051	613	459	62611	2278	0	65961
10052	400	62090	1546	1295	0	65331
10053	61784	1612	647	934	0	64977
10054	1641	786	61179	785	0	64391
10055	60069	667	1471	809	0	63016
10056	1794	551	61935	781	0	65061
10057	867	532	1625	61216	0	64240
10058	804	570	61719	1804	0	64897
10059	649	569	63428	891	0	65537
10060	549	600	1842	61715	0	64706
10061	608	582	740	62185	0	64115
10062	571	595	488	63995	0	65649
10063	520	630	378	63623	0	65151
10064	62154	588	390	2273	0	65405
10065	1698	584	62345	1164	0	65791
10066	61793	606	1473	927	0	64799
10067	62501	613	575	783	0	64472
10068	62499	595	418	782	0	64294
10069	62371	664	276	689	0	64000
10070	62655	576	216	720	0	64167
10071	2407	595	243	60540	0	63785
10072	1192	645	58913	1693	0	62443
10073	857	544	55521	845	0	57767
10074	717	55720	1492	699	0	58628
10075	51869	1618	836	565	0	54888
10076	1418	977	451	49822	0	52668
10077	684	1094	238	48854	0	50870
10078	573	49620	192	1513	0	51898
10079	514	49645	214	814	0	51187
10080	492	48649	166	564	0	49871
10081	39215	1309	252	469	0	41245
10082	660	909	112	33693	0	35374
10083	246	33695	102	601	0	34644
10084	175	533	77	33645	0	34430
10085	201	273	33437	534	0	34445
10086	244	177	34749	239	0	35409
10087	239	172	504	37009	0	37924
10088	39024	187	188	676	0	40075
10089	41321	187	94	248	0	41850
10090	41328	173	77	208	0	41786
10091	975	207	41513	174	0	42869
10092	369	223	688	40288	0	41568
10093	254	210	248	42625	0	43337
10094	283	221	41417	889	0	42810
10095	37352	207	771	410	0	38740
10096	897	203	41538	288	0	42926
10097	305	175	40234	218	0	40932
10098	198	147	41130	200	0	41675
10099	185	132	901	38628	0	39846
10100	161	103	344	40205	0	40813
10101	158	133	41509	908	0	42708
10102	137	112	749	41011	0	42009
10103	41702	66	355	893	0	43016
10104	751	100	222	42658	0	43731
10105	317	105	43658	890	0	44970
10106	210	97	46265	413	0	46985
10107	164	108	964	44548	0	45784
10108	47278	80	382	898	0	48638
10109	902	50947	259	410	0	52518
10110	52519	917	224	309	0	53969
10111	53118	319	272	258	0	53967
10112	1442	146	54502	253	0	56343
10113	559	103	1156	53721	0	55539
10114	55059	69	561	1256	0	56945
10115	53309	73	343	617	0	54342
10116	1356	54941	292	425	0	57014
10117	589	951	318	54829	0	56687
10118	357	330	273	56571	0	57531
10119	298	142	55514	1474	0	57428
10120	282	63	1172	53811	0	55328
10121	356	72	55760	1307	0	57495
10122	351	81	55434	608	0	56474
10123	336	96	1437	53455	0	55324
10124	53643	59	693	1188	0	55583
10125	1143	53003	395	684	0	55225
10126	52996	959	331	373	0	54659
10127	52851	373	287	362	0	53873
10128	1422	53317	305	391	0	55435
10129	679	974	274	50758	0	52685
10130	50908	397	240	1041	0	52586
10131	1190	51602	239	538	0	53569
10132	49899	956	233	362	0	51450
10133	1124	49679	250	277	0	51330
10134	507	897	224	47604	0	49232
10135	401	336	192	49199	0	50128
10136	47897	187	181	1213	0	49478
10137	46807	169	215	521	0	47712
10138	1235	47915	220	548	0	49918
10139	551	847	47170	344	0	48912
10140	331	326	46887	403	0	47947
10141	261	186	1253	43971	0	45671
10142	247	47324	642	1003	0	49216
10143	315	830	404	47820	0	49369
10144	323	316	368	48064	0	49071
10145	308	191	341	48547	0	49387
10146	352	178	47811	1361	0	49702
10147	384	181	47670	667	0	48902
10148	354	48500	1263	464	0	50581
10149	416	923	569	47476	0	49384
10150	449	428	352	50028	0	51257
10151	474	300	49118	1289	0	51181
10152	41581	243	1102	759	0	43685
10153	1206	251	559	49302	0	51318
10154	673	261	49349	1150	0	51433
10155	44686	231	1110	720	0	46747
10156	1135	48803	533	614	0	51085
10157	778	954	50026	482	0	52240
10158	542	466	1138	49254	0	51400
10159	49462	361	638	1228	0	51689
10160	1180	256	50611	684	0	52731
10161	574	251	1223	49863	0	51911
10162	463	206	699	51305	0	52673
10163	424	234	461	54420	0	55539
10164	54431	267	430	1618	0	56746
10165	1217	53437	427	1021	0	56102
10166	643	1100	401	53958	0	56102
10167	516	497	54800	1430	0	57243
10168	389	397	1316	51636	0	53738
10169	428	53484	706	1466	0	56084
10170	423	56214	453	807	0	57897
10171	55022	1436	378	691	0	57527
10172	55702	592	371	611	0	57276
10173	1671	410	55121	534	0	57736
10174	52996	348	1272	518	0	55134
10175	1420	55038	632	557	0	57647
10176	55757	1271	405	575	0	58008
10177	1488	629	341	55521	0	57979
10178	900	467	56777	1400	0	59544
10179	676	383	1285	55897	0	58241
10180	590	327	56964	1515	0	59396
10181	54135	321	1421	885	0	56762
10182	1389	273	710	56019	0	58391
10183	654	58695	455	1503	0	61307
10184	585	1340	335	59547	0	61807
10185	572	677	59148	1586	0	61983
10186	401	58000	1273	1030	0	60704
10187	53556	1133	644	694	0	56027
10188	953	53133	448	502	0	55036
10189	429	51845	351	431	0	53056
10190	347	1130	282	49360	0	51119
10191	234	50942	271	976	0	52423
10192	305	1015	239	51377	0	52936
10193	371	462	50929	1021	0	52783
10194	45073	361	856	510	0	46800
10195	49567	230	399	380	0	50576
10196	1125	250	50046	314	0	51735
10197	46350	246	823	304	0	47723
10198	911	48783	409	319	0	50422
10199	48997	768	323	295	0	50383
10200	943	389	225	48275	0	49832
10201	514	264	49261	889	0	50928
10202	284	50330	827	531	0	51972
10203	281	726	419	49951	0	51377
10204	260	350	226	50496	0	51332
10205	47949	216	178	1046	0	49389
10206	44803	173	202	541	0	45719
10207	855	45584	245	353	0	47037
10208	284	42886	181	212	0	43563
10209	139	40524	85	153	0	40901
10210	243	510	159	38732	0	39644
10211	38283	110	211	375	0	38979
10212	37026	76	49	125	0	37276
10213	383	67	43	36702	0	37195
10214	137	63	42	36880	0	37122
10215	36577	59	55	388	0	37079
10216	345	59	40	37139	0	37583
10217	130	76	37782	364	0	38352
10218	36387	61	348	200	0	36996
10219	37617	74	90	140	0	37921
10220	431	99	38707	89	0	39326
10221	38647	77	304	173	0	39201
10222	380	88	106	40699	0	41273
10223	129	99	79	40753	0	41060
10224	112	83	77	41147	0	41419
10225	39876	103	80	458	0	40517
10226	362	41829	92	239	0	42522
10227	158	375	56	41789	0	42378
10228	120	41262	77	395	0	41854
10229	40867	367	70	166	0	41470
10230	412	136	80	41396	0	42024
10231	192	104	69	42037	0	42402
10232	144	42368	83	490	0	43085
10233	194	403	41149	176	0	41922
10234	160	153	351	41860	0	42524
10235	41982	100	140	430	0	42652
10236	46367	81	101	192	0	46741
10237	838	122	49730	143	0	50833
10238	267	108	814	49715	0	50904
10239	154	52171	256	874	0	53455
10240	133	887	117	53264	0	54401
10241	53006	277	85	1004	0	54372
10242	53243	142	82	337	0	53804
10243	1140	114	75	52055	0	53384
10244	318	52078	93	966	0	53455
10245	55584	925	73	385	0	56967
10246	1004	313	46	57018	0	58381
10247	57307	173	64	1089	0	58633
10248	60579	143	82	502	0	61306
10249	1216	125	62	60675	0	62078
10250	382	125	70	61312	0	61889
10251	211	96	88	62560	0	62955
10252	177	62189	100	1363	0	63829
10253	198	1045	75	63108	0	64426
10254	221	283	85	63563	0	64152
10255	265	152	61414	1361	0	63192
10256	237	138	60459	445	0	61279
10257	182	112	1234	60098	0	61626
10258	59639	98	338	1161	0	61236
10259	1040	60016	158	564	0	61778
10260	58832	1032	125	259	0	60248
10261	1251	321	59511	258	0	61341
10262	475	189	57787	263	0	58714
10263	185	58075	1156	283	0	59699
10264	336	907	483	57661	0	59387
10265	237	286	57789	911	0	59223
10266	212	145	59154	345	0	59856
10267	173	163	1018	58016	0	59370
10268	58466	61	332	967	0	59826
10269	58479	80	113	363	0	59035
10270	1087	83	71	57835	0	59076
10271	417	124	62467	944	0	63952
10272	204	97	842	62873	0	64016
10273	208	75	279	61456	0	62018
10274	137	63759	148	1059	0	65103
10275	63418	825	120	399	0	64762
10276	63232	263	124	262	0	63881
10277	1073	64187	115	274	0	65649
10278	432	890	93	60419	0	61834
10279	192	63066	124	969	0	64351
10280	62842	876	201	390	0	64309
10281	1000	317	61370	241	0	62928
10282	402	210	59648	255	0	60515
10283	245	147	59905	230	0	60527
10284	186	148	1142	58647	0	60123
10285	176	96	376	59845	0	60493
10286	59308	93	171	1195	0	60767
10287	934	107	138	59282	0	60461
10288	424	120	140	61486	0	62170
10289	296	156	64138	1216	0	65806
10290	269	147	62104	495	0	63015
10291	60012	129	1157	360	0	61658
10292	922	63818	380	340	0	65460
10293	64448	878	163	338	0	65827
10294	1039	286	170	64397	0	65892
10295	453	167	168	63830	0	64618
10296	246	63845	181	1219	0	65491
10297	259	930	159	64373	0	65721
10298	63493	299	183	1153	0	65128
10299	1020	222	176	63766	0	65184
10300	550	209	63916	1103	0	65778
10301	314	62676	975	652	0	64617
10302	62178	917	367	433	0	63895
10303	63765	366	244	455	0	64830
10304	63616	231	206	423	0	64476
10305	64012	194	174	412	0	64792
10306	1304	180	205	62941	0	64630
10307	536	176	226	64466	0	65404
10308	456	183	63789	1342	0	65770
10309	341	164	1010	62986	0	64501
10310	458	190	63481	1278	0	65407
10311	343	199	1001	63047	0	64590
10312	62862	173	371	1301	0	64707
10313	1040	65410	280	700	0	67430
10314	481	951	259	65889	0	67580
10315	318	384	266	67663	0	68631
10316	65891	185	272	1452	0	67800
10317	63626	184	307	727	0	64844
10318	1270	222	64744	499	0	66735
10319	471	64686	1079	509	0	66745
10320	344	965	434	63614	0	65357
10321	338	374	328	64431	0	65471
10322	63038	225	308	1368	0	64939
10323	62308	166	405	622	0	63501
10324	1352	211	63639	455	0	65657
10325	554	223	63508	400	0	64685
10326	323	214	1327	61283	0	63147
10327	352	174	535	63589	0	64650
10328	410	196	62616	1358	0	64580
10329	59495	178	1137	571	0	61381
10330	1212	213	461	62746	0	64632
10331	62089	159	314	1203	0	63765
10332	1065	61447	279	793	0	63584
10333	63176	972	389	497	0	65034
10334	1300	359	69073	422	0	71154
10335	549	68407	1144	571	0	70671
10336	260	65808	338	303	0	66709
10337	61017	728	775	290	0	62810
10338	59496	194	131	208	0	60029
10339	678	178	100	58603	0	59559
10340	234	59322	126	633	0	60315
10341	138	60935	123	315	0	61511
10342	158	694	100	60847	0	61799
10343	61381	179	112	657	0	62329
10344	61485	113	88	338	0	62024
10345	714	117	58819	150	0	59800
10346	55212	58	461	156	0	55887
10347	529	61312	171	180	0	62192
10348	62208	559	88	128	0	62983
10349	758	78072	90	205	0	79125
10350	195	85657	97	190	0	86139
10351	253	2187	151	94315	0	96906
10352	100945	588	170	2283	0	103986
10353	103162	220	52	771	0	104205
10354	3235	140	100834	379	0	104588
10355	1111	78	2391	100866	0	104446
10356	101608	63	720	2578	0	104969
10357	2597	66	347	103025	0	106035
10358	103454	70	170	2826	0	106520
10359	104645	99	112	923	0	105779
10360	3373	136	103276	489	0	107274
10361	1246	71	2427	100646	0	104390
10362	647	77	734	104253	0	105711
10363	361	77	364	105147	0	105949
10364	314	139	101018	3484	0	104955
10365	222	107	2506	100969	0	103804
10366	234	155	794	96549	0	97732
10367	150	99528	421	3247	0	103346
10368	552	2517	98263	1176	0	102508
10369	191	100817	2500	759	0	104267
10370	99549	2806	737	375	0	103467
10371	2691	915	461	94181	0	98248
10372	1015	511	226	91386	0	93138
10373	599	95195	227	3148	0	99169
10374	94261	2572	183	1153	0	98169
10375	95557	829	155	707	0	97248
10376	3389	94195	207	621	0	98412
10377	1348	97278	226	500	0	99352
10378	95485	3180	238	405	0	99308
10379	3043	1165	94828	384	0	99420
10380	1232	635	95130	438	0	97435
10381	90893	412	3281	458	0	95044
10382	2691	94925	1212	598	0	99426
10383	95621	2653	632	558	0	99464
10384	3194	1078	95625	560	0	100457
10385	93103	641	2701	631	0	97076
10386	3173	97767	1044	674	0	102658
10387	1455	2832	641	97780	0	102708
10388	1074	964	460	99347	0	101845
10389	841	581	402	96022	0	97846
10390	847	430	372	96871	0	98520
10391	810	395	346	92809	0	94360
10392	802	93237	380	4036	0	98455
10393	93694	2666	447	1814	0	98621
10394	3254	1103	92713	1196	0	98266
10395	1597	673	2737	93534	0	98541
10396	1131	529	94239	3361	0	99260
10397	874	464	3189	93382	0	97909
10398	792	416	1338	96018	0	98564
10399	92981	431	959	4073	0	98444
10400	3163	540	92803	1959	0	98465
10401	1419	92362	2959	1381	0	98121
10402	1070	2944	1251	92200	0	97465
10403	912	1305	808	96058	0	99083
10404	939	967	94301	3856	0	100063
10405	865	755	2875	93804	0	98299
10406	851	700	1141	97178	0	99870
10407	91178	680	748	4232	0	96838
10408	3065	93882	601	2222	0	99770
10409	94593	3084	489	1453	0	99619
10410	96514	1437	460	1178	0	99589
10411	4124	1104	480	93772	0	99480
10412	2185	906	93491	3247	0	99829
10413	1565	796	94303	1561	0	98225
10414	1199	778	3776	91750	0	97503
10415	1161	739	1736	88978	0	92614
10416	1050	92599	1184	3960	0	98793
10417	91912	2971	913	1937	0	97733
10418	3373	91338	921	1582	0	97214
10419	1843	94308	783	1399	0	98333
10420	93144	3692	689	1314	0	98839
10421	3476	1632	733	91213	0	97054
10422	1713	95969	737	3722	0	102141
10423	1315	3136	675	97434	0	102560
10424	1060	1318	94756	4297	0	101431
10425	1000	975	95788	2393	0	100156
10426	965	727	3639	94927	0	100258
10427	959	708	96364	3975	0	102006
10428	939	727	3493	95336	0	100495
10429	841	659	1668	97088	0	100256
10430	848	662	1241	99216	0	101967
10431	94188	639	966	4737	0	100530
10432	2941	92724	985	2702	0	99352
10433	1330	95795	839	1953	0	99917
10434	88399	3482	749	1453	0	94083
10435	89815	1641	651	1344	0	93451
10436	3719	1168	596	88172	0	93655
10437	1824	1032	88597	3389	0	94842
10438	1235	864	2860	88831	0	93790
10439	1056	836	89440	3756	0	95088
10440	885	88838	3122	2182	0	95027
10441	981	2913	1325	89590	0	94809
10442	89543	1313	984	3473	0	95313
10443	3269	1035	801	89830	0	94935
10444	1681	758	87833	3411	0	93683
10445	83566	690	3190	1783	0	89229
10446	3349	654	88187	1371	0	93561
10447	1812	581	86257	1149	0	89799
10448	978	81727	3400	1285	0	87390
10449	521	66119	1212	729	0	68581
10450	562	61416	1028	702	0	63708
10451	46167	1128	1698	1027	0	50020
10452	42978	94	153	218	0	43443
10453	227	42	44	44121	0	44434
10454	85	41	43	44698	0	44867
10455	67	32	25	45730	0	45854
10456	44	46234	44	289	0	46611
10457	46389	173	42	146	0	46750
10458	168	46344	57	126	0	46695
10459	57	218	45	46700	0	47020
10460	46175	61	38	288	0	46562
10461	203	43	40	45917	0	46203
10462	79	48	38	46908	0	47073
10463	47051	46	33	308	0	47438
10464	45465	50	62	143	0	45720
10465	300	76	46503	85	0	46964
10466	144	86	45245	56	0	45531
10467	139	67	47666	74	0	47946
10468	72	47	259	47171	0	47549
10469	50	48	92	48549	0	48739
10470	51	48841	59	307	0	49258
10471	49949	227	55	179	0	50410
10472	256	82	41	50582	0	50961
10473	85	65	61	51117	0	51328
10474	73	52100	52	329	0	52554
10475	76	55190	49	191	0	55506
10476	88	315	39	56298	0	56740
10477	83	118	50	62363	0	62614
10478	62549	74	66	721	0	63410
10479	61862	59	53	266	0	62240
10480	680	72	45	62384	0	63181
10481	266	98	62230	623	0	63217
10482	194	88	60109	206	0	60597
10483	104	70	676	61316	0	62166
10484	102	58	192	60818	0	61170
10485	69	61007	129	779	0	61984
10486	59394	581	78	249	0	60302
10487	645	145	65	59482	0	60337
10488	240	117	59950	670	0	60977
10489	160	82	621	60308	0	61171
10490	178	93	60761	741	0	61773
10491	177	98	61146	254	0	61675
10492	101	202	755	61761	0	62819
10493	62128	58	233	746	0	63165
10494	669	96	62362	273	0	63400
10495	183	82	610	60466	0	61341
10496	247	106	66939	712	0	68004
10497	135	70	653	66386	0	67244
10498	121	71	181	67591	0	67964
10499	196	73	67105	840	0	68214
10500	215	95	64907	340	0	65557
10501	146	70	778	61000	0	61994
10502	125	52	262	66877	0	67316
10503	120	70	197	67208	0	67595
10504	104	59	142	66411	0	66716
10505	65463	60	127	920	0	66570
10506	65523	77	127	376	0	66103
10507	734	65699	159	325	0	66917
10508	66105	622	126	273	0	67126
10509	721	181	161	66359	0	67422
10510	66711	101	188	837	0	67837
10511	792	97	65734	354	0	66977
10512	65167	64	772	350	0	66353
10513	772	82	278	66733	0	67865
10514	260	75	200	69701	0	70236
10515	69044	60	187	1056	0	70347
10516	858	83	147	74695	0	75783
10517	337	128	78723	1285	0	80473
10518	76069	67	1130	585	0	77851
10519	1141	80522	471	472	0	82606
10520	395	1062	233	85205	0	86895
10521	321	337	91363	1514	0	93535
10522	183	142	1485	89676	0	91486
10523	272	142	90723	1784	0	92921
10524	228	96	1572	90575	0	92471
10525	184	92094	536	1944	0	94758
10526	248	1540	261	92620	0	94669
10527	211	96565	247	1934	0	98957
10528	287	1803	225	94444	0	96759
10529	260	459	201	102177	0	103097
10530	302	196	223	102700	0	103421
10531	380	111	268	102398	0	103157
10532	350	113	263	103107	0	103833
10533	420	182	99389	2701	0	102692
10534	256	100	2023	99018	0	101397
10535	210	134	750	101134	0	102228
10536	99368	124	465	2711	0	102668
10537	1930	99093	364	1289	0	102676
10538	99268	2012	288	727	0	102295
10539	2218	587	281	99819	0	102905
10540	849	295	99247	2556	0	102947
10541	322	99739	2194	1223	0	103478
10542	97369	1995	786	816	0	100966
10543	2049	99196	515	846	0	102606
10544	592	102301	443	826	0	104162
10545	100175	2432	350	773	0	103730
10546	2206	775	319	106724	0	110024
10547	106480	304	342	2912	0	110038
10548	2496	234	381	104831	0	107942
10549	917	219	104651	3060	0	108847
10550	521	249	103243	1372	0	105385
10551	97449	230	2984	1044	0	101707
10552	103596	238	1021	843	0	105698
10553	2976	258	532	100461	0	104227
10554	993	236	407	102650	0	104286
10555	97886	268	366	3486	0	102006
10556	2400	97280	368	1589	0	101637
10557	880	100461	314	1154	0	102809
10558	98575	2795	337	821	0	102528
10559	98789	907	357	774	0	100827
10560	3060	98286	408	779	0	102533
10561	1175	2526	326	98530	0	102557
10562	809	890	97659	2876	0	102234
10563	669	478	97452	1255	0	99854
10564	93486	343	3114	916	0	97859
10565	2761	382	97430	840	0	101413
10566	1146	361	2555	93593	0	97655
10567	753	385	852	92339	0	94329
10568	593	94469	513	3310	0	98885
10569	93929	2433	449	1430	0	98241
10570	2869	857	449	93954	0	98129
10571	1295	588	92255	2902	0	97040
10572	686	91888	2484	1740	0	96798
10573	626	2710	975	91859	0	96170
10574	695	918	90984	2909	0	95506
10575	863	597	89028	1353	0	91841
10576	564	86674	3015	1257	0	91510
10577	79572	2128	937	777	0	83414
10578	2111	81232	608	984	0	84935
10579	80886	2234	529	836	0	84485
10580	2360	938	79659	878	0	83835
10581	75823	539	2167	920	0	79449
10582	2235	79626	928	962	0	83751
10583	984	2158	541	79517	0	83200
10584	638	905	480	82559	0	84582
10585	80647	533	554	3130	0	84864
10586	2335	479	80461	1575	0	84850
10587	79046	554	2280	1118	0	82998
10588	81375	499	940	1019	0	83833
10589	2843	561	78731	960	0	83095
10590	1227	561	80078	964	0	82830
10591	783	635	2627	76957	0	81002
10592	78259	516	1065	2759	0	82599
10593	78569	585	655	1392	0	81201
10594	2802	78580	611	1113	0	83106
10595	1243	2271	534	79554	0	83602
10596	880	1069	508	76856	0	79313
10597	891	664	496	77656	0	79707
10598	872	536	494	78648	0	80550
10599	76287	584	578	3144	0	80593
10600	2692	592	525	77538	0	81347
10601	1377	617	76920	2747	0	81661
10602	1022	605	76971	1192	0	79790
10603	72139	586	2840	866	0	76431
10604	2793	74934	1171	855	0	79753
10605	1360	78294	784	822	0	81260
10606	1050	3011	664	76585	0	81310
10607	1049	1074	609	78805	0	81537
10608	980	671	620	78474	0	80745
10609	942	658	602	79385	0	81587
10610	1021	635	76612	3158	0	81426
10611	1096	546	2301	75657	0	79600
10612	1057	606	1017	76926	0	79606
10613	931	576	73741	3040	0	78288
10614	67263	431	2451	1476	0	71621
10615	2460	71686	1228	1151	0	76525
10616	65647	1833	730	871	0	69081
10617	2203	646	62596	698	0	66143
10618	1093	402	60828	656	0	62979
10619	721	59114	2177	659	0	62671
10620	52555	2526	3277	851	0	59209
10621	49027	676	483	519	0	50705
10622	48632	318	293	427	0	49670
10623	1610	47221	334	521	0	49686
10624	45518	1120	279	363	0	47280
10625	1345	459	45139	330	0	47273
10626	503	44436	1138	437	0	46514
10627	41516	943	482	332	0	43273
10628	1013	42401	334	363	0	44111
10629	40259	907	243	281	0	41690
10630	39919	298	262	252	0	40731
10631	1155	175	40119	243	0	41692
10632	461	40182	933	273	0	41849
10633	39588	826	372	261	0	41047
10634	964	318	39653	243	0	41178
10635	389	39703	905	367	0	41364
10636	324	845	406	38778	0	40353
10637	255	287	38804	813	0	40159
10638	252	186	38135	361	0	38934
10639	289	258	846	37290	0	38683
10640	36802	120	385	807	0	38114
10641	775	36806	195	518	0	38294
10642	351	669	36826	223	0	38069
10643	280	268	36152	156	0	36856
10644	33066	170	824	176	0	34236
10645	672	36061	374	189	0	37296
10646	29400	302	251	72	0	30025
10647	330	29666	43	62	0	30101
10648	30312	295	133	104	0	30844
10649	29813	86	63	51	0	30013
10650	371	29631	54	72	0	30128
10651	133	314	54	29960	0	30461
10652	31504	100	54	365	0	32023
10653	373	55	60	32040	0	32528
10654	119	59	73	34862	0	35113
10655	34560	37	80	480	0	35157
10656	420	34660	82	216	0	35378
10657	35325	428	56	94	0	35903
10658	501	141	35288	69	0	35999
10659	129	84	469	35346	0	36028
10660	103	65	119	35665	0	35952
10661	35350	47	86	542	0	36025
10662	35328	74	63	157	0	35622
10663	530	70	64	35254	0	35918
10664	203	83	35984	489	0	36759
10665	128	64	429	35588	0	36209
10666	116	70	115	36391	0	36692
10667	105	72	89	36605	0	36871
10668	116	71	72	36602	0	36861
10669	35914	80	66	578	0	36638
10670	547	79	36032	200	0	36858
10671	169	36332	470	165	0	37136
10672	147	467	123	36065	0	36802
10673	131	156	90	37530	0	37907
10674	195	108	37459	579	0	38341
10675	139	84	36966	229	0	37418
10676	135	68	538	37723	0	38464
10677	127	65	185	38251	0	38628
10678	182	93	37932	651	0	38858
10679	168	82	558	37504	0	38312
10680	38289	88	158	656	0	39191
10681	617	39642	130	283	0	40672
10682	297	584	39252	198	0	40331
10683	164	39266	629	222	0	40281
10684	168	619	168	39633	0	40588
10685	197	167	39731	675	0	40770
10686	161	39510	608	355	0	40634
10687	163	543	189	39645	0	40540
10688	200	164	40370	633	0	41367
10689	145	112	596	39413	0	40266
10690	144	129	170	40548	0	40991
10691	40364	82	156	751	0	41353
10692	629	78	126	40402	0	41235
10693	40849	80	113	748	0	41790
10694	39283	83	136	326	0	39828
10695	39541	114	143	269	0	40067
10696	803	101	117	39067	0	40088
10697	271	94	38930	705	0	40000
10698	198	92	38219	309	0	38818
10699	37498	98	705	310	0	38611
10700	628	101	39086	237	0	40052
10701	36041	63	611	223	0	36938
10702	549	38177	252	264	0	39242
10703	38259	484	161	233	0	39137
10704	629	133	38904	215	0	39881
10705	254	147	40153	224	0	40778
10706	147	116	640	39635	0	40538
10707	163	58	42506	728	0	43455
10708	211	84	43322	296	0	43913
10709	136	66	782	45413	0	46397
10710	133	88	263	48122	0	48606
10711	149	94	163	49127	0	49533
10712	110	49962	165	1310	0	51547
10713	181	921	158	47295	0	48555
10714	111	50895	182	986	0	52174
10715	50455	966	168	416	0	52005
10716	51303	317	173	329	0	52122
10717	1179	187	194	49227	0	50787
10718	428	50074	201	1107	0	51810
10719	286	894	50866	452	0	52498
10720	50429	304	1147	367	0	52247
10721	1083	154	415	51661	0	53313
10722	450	103	257	52038	0	52848
10723	292	101	190	53395	0	53978
10724	51198	99	203	1497	0	52997
10725	1104	50379	223	610	0	52316
10726	398	51989	217	433	0	53037
10727	49328	1212	206	261	0	51007
10728	1034	50660	216	287	0	52197
10729	50451	1101	193	292	0	52037
10730	50463	355	203	294	0	51315
10731	1291	50460	239	307	0	52297
10732	507	1030	237	48977	0	50751
10733	266	50469	208	1211	0	52154
10734	236	1108	198	50219	0	51761
10735	215	372	174	53093	0	53854
10736	52753	227	195	1605	0	54780
10737	54254	174	207	701	0	55336
10738	1615	181	202	54208	0	56206
10739	682	208	53245	1449	0	55584
10740	50086	160	1335	694	0	52275
10741	1294	52688	569	518	0	55069
10742	560	1214	333	52630	0	54737
10743	410	487	242	53841	0	54980
10744	314	331	229	54451	0	55325
10745	51520	247	196	1937	0	53900
10746	51376	259	205	890	0	52730
10747	1654	49575	234	557	0	52020
10748	732	50786	245	433	0	52196
10749	487	1563	216	50192	0	52458
10750	414	742	198	51466	0	52820
10751	372	376	50677	1750	0	53175
10752	388	263	1283	49200	0	51134
10753	360	295	48862	1558	0	51075
10754	324	207	46081	710	0	47322
10755	317	45464	1449	535	0	47765
10756	413	1185	644	45721	0	47963
10757	45900	480	274	1416	0	48070
10758	1327	319	196	45700	0	47542
10759	715	272	45262	1428	0	47677
10760	43384	318	1158	695	0	45555
10761	44997	254	487	477	0	46215
10762	1719	257	44448	405	0	46829
10763	820	264	1151	45114	0	47349
10764	44751	225	480	1410	0	46866
10765	1408	45661	298	747	0	48114
10766	46448	1309	248	558	0	48563
10767	47762	571	242	462	0	49037
10768	1757	414	226	46571	0	48968
10769	806	265	185	48687	0	49943
10770	47806	267	249	1893	0	50215
10771	1512	243	249	48394	0	50398
10772	757	293	47958	1734	0	50742
10773	45347	263	1322	891	0	47823
10774	46623	269	541	627	0	48060
10775	1695	46272	325	654	0	48946
10776	745	47360	224	573	0	48902
10777	525	1684	198	44636	0	47043
10778	391	46703	206	1501	0	48801
10779	473	1542	258	46512	0	48785
10780	45687	575	182	1616	0	48060
10781	44549	376	227	794	0	45946
10782	1638	44264	224	592	0	46718
10783	43425	1272	210	484	0	45391
10784	1438	44051	211	520	0	46220
10785	43936	1319	222	520	0	45997
10786	44423	549	276	516	0	45764
10787	1700	369	42890	531	0	45490
10788	41678	272	1234	467	0	43651
10789	1548	41779	556	452	0	44335
10790	733	43537	302	530	0	45102
10791	43199	1472	270	496	0	45437
10792	1642	654	201	42926	0	45423
10793	864	431	42862	1386	0	45543
10794	628	357	1195	42476	0	44656
10795	586	352	474	43899	0	45311
10796	535	285	42395	1817	0	45032
10797	39063	306	1220	914	0	41503
10798	1525	41466	496	684	0	44171
10799	41103	1276	312	509	0	43200
10800	1623	596	254	40182	0	42655
10801	40199	378	261	1405	0	42243
10802	1609	39863	211	791	0	42474
10803	913	1331	198	40061	0	42503
10804	39541	555	209	1502	0	41807
10805	1549	343	37406	815	0	40113
10806	766	286	35356	571	0	36979
10807	32339	320	1458	486	0	34603
10808	1361	33007	556	435	0	35359
10809	496	28744	247	313	0	29800
10810	915	1173	425	25722	0	28235
10811	356	26756	142	848	0	28102
10812	382	845	225	26433	0	27885
10813	442	351	172	27312	0	28277
10814	340	234	194	26742	0	27510
10815	317	26129	230	993	0	27669
10816	391	721	155	25947	0	27214
10817	358	387	25019	844	0	26608
10818	364	24514	650	430	0	25958
10819	368	690	242	21776	0	23076
10820	311	23340	205	645	0	24501
10821	23110	632	247	350	0	24339
10822	23127	300	152	298	0	23877
10823	23085	216	169	260	0	23730
10824	903	23342	191	266	0	24702
10825	512	612	164	23167	0	24455
10826	434	347	22661	605	0	24047
10827	397	280	22357	340	0	23374
10828	21354	344	646	285	0	22629
10829	22036	231	310	275	0	22852
10830	784	228	165	22695	0	23872
10831	467	219	136	23562	0	24384
10832	377	203	23295	907	0	24782
10833	276	22627	613	521	0	24037
10834	335	23238	322	377	0	24272
10835	318	546	20994	244	0	22102
10836	339	429	520	19165	0	20453
10837	195	194	183	18311	0	18883
10838	197	159	89	19672	0	20117
10839	209	151	85	19796	0	20241
10840	19497	173	95	486	0	20251
10841	521	139	18858	194	0	19712
10842	18569	165	357	141	0	19232
10843	513	145	142	18915	0	19715
10844	18894	176	97	414	0	19581
10845	458	152	106	18964	0	19680
10846	260	166	19054	443	0	19923
10847	188	183	378	19058	0	19807
10848	195	147	19632	436	0	20410
10849	169	151	361	18933	0	19614
10850	177	128	19627	436	0	20368
10851	124	19328	334	259	0	20045
10852	159	311	155	19234	0	19859
10853	144	175	81	18766	0	19166
10854	122	19419	106	405	0	20052
10855	19823	323	73	228	0	20447
10856	351	158	86	19720	0	20315
10857	183	123	99	19654	0	20059
10858	19794	94	92	508	0	20488
10859	19798	94	89	247	0	20228
10860	20553	111	109	178	0	20951
10861	20615	87	92	167	0	20961
10862	496	104	19706	172	0	20478
10863	19101	99	345	160	0	19705
10864	19962	96	137	180	0	20375
10865	460	78	105	18716	0	19359
10866	241	119	94	18486	0	18940
10867	17708	66	69	432	0	18275
10868	319	17497	70	236	0	18122
10869	161	253	56	16865	0	17335
10870	98	114	17419	301	0	17932
10871	62	17224	227	151	0	17664
10872	16857	216	174	99	0	17346
10873	16832	104	87	71	0	17094
10874	16680	39	33	51	0	16803
10875	16819	31	40	57	0	16947
10876	264	29	30	16353	0	16676
10877	121	39	16367	223	0	16750
10878	62	48	17572	121	0	17803
10879	54	28	319	18792	0	19193
10880	20064	19	111	320	0	20514
10881	341	25	37	20063	0	20466
10882	171	23	20295	358	0	20847
10883	20247	18	340	176	0	20781
10884	20519	22	112	94	0	20747
10885	455	21	55	20724	0	21255
10886	170	37	21654	359	0	22220
10887	102	28	22189	135	0	22454
10888	20918	23	426	102	0	21469
10889	346	21848	136	121	0	22451
10890	144	328	22116	57	0	22645
10891	69	102	334	21890	0	22395
10892	22120	28	106	392	0	22646
10893	337	21619	88	157	0	22201
10894	119	22023	50	79	0	22271
10895	21948	388	34	73	0	22443
10896	367	104	37	21964	0	22472
10897	23709	33	43	436	0	24221
10898	409	30	46	24297	0	24782
10899	153	23	41	24681	0	24898
10900	116	31	24654	475	0	25276
10901	99	48	23556	142	0	23845
10902	120	33	24902	79	0	25134
10903	83	24	492	24555	0	25154
10904	25263	25	139	443	0	25870
10905	485	33	25491	146	0	26155
10906	171	31	438	25430	0	26070
10907	138	31	26143	464	0	26776
10908	93	26480	455	190	0	27218
10909	103	444	153	26779	0	27479
10910	102	112	73	27126	0	27413
10911	103	45	73	27383	0	27604
10912	26909	31	73	617	0	27630
10913	493	25	90	26793	0	27401
10914	164	37	95	27226	0	27522
10915	26934	40	88	611	0	27673
10916	513	43	26590	214	0	27360
10917	26329	45	480	110	0	26964
10918	26892	50	173	92	0	27207
10919	612	49	26600	90	0	27351
10920	25158	55	471	124	0	25808
10921	530	52	158	26395	0	27135
10922	206	48	27614	463	0	28331
10923	27195	28	500	213	0	27936
10924	28174	30	151	165	0	28520
10925	601	37	94	28268	0	29000
10926	212	26	87	28631	0	28956
10927	135	22	82	28939	0	29178
10928	28132	23	86	623	0	28864
10929	483	28480	113	262	0	29338
10930	27575	377	86	167	0	28205
10931	466	26616	80	151	0	27313
10932	169	26790	96	139	0	27194
10933	112	462	164	27027	0	27765
10934	99	111	102	27437	0	27749
10935	133	49	71	27268	0	27521
10936	109	45	91	27514	0	27759
10937	119	50	26703	571	0	27443
10938	25192	28	448	254	0	25922
10939	442	43	162	27075	0	27722
10940	212	59	27502	467	0	28240
10941	128	66	432	27354	0	27980
10942	144	45	159	28128	0	28476
10943	176	56	29345	583	0	30160
10944	146	67	438	29156	0	29807
10945	129	56	155	29849	0	30189
10946	29399	54	100	627	0	30180
10947	501	60	29797	227	0	30585
10948	28004	44	458	192	0	28698
10949	480	30153	188	197	0	31018
10950	29973	396	117	205	0	30691
10951	29496	110	108	179	0	29893
10952	581	66	117	29426	0	30190
10953	219	51	29476	548	0	30294
10954	140	31097	494	267	0	31998
10955	146	449	172	29617	0	30384
10956	117	32481	109	490	0	33197
10957	32394	448	162	225	0	33229
10958	513	124	31998	179	0	32814
10959	191	72	31662	163	0	32088
10960	115	62	537	31241	0	31955
10961	150	65	32603	589	0	33407
10962	150	73	483	32511	0	33217
10963	130	63	142	33010	0	33345
10964	32988	44	102	690	0	33824
10965	536	33254	93	307	0	34190
10966	199	474	99	33751	0	34523
10967	173	101	98	34344	0	34716
10968	135	71	115	33853	0	34174
10969	133	33521	122	675	0	34451
10970	142	33988	122	237	0	34489
10971	33263	541	118	186	0	34108
10972	33425	127	120	210	0	33882
10973	33259	54	94	212	0	33619
10974	655	71	32958	185	0	33869
10975	228	145	508	32552	0	33433
10976	175	77	32882	635	0	33769
10977	122	32722	517	332	0	33693
10978	31158	475	179	278	0	32090
10979	505	118	30736	174	0	31533
10980	149	100	368	29739	0	30356
10981	138	59	30678	417	0	31292
10982	29476	47	384	237	0	30144
10983	31156	50	133	203	0	31542
10984	31294	49	95	158	0	31596
10985	30666	54	80	155	0	30955
10986	445	75	31380	131	0	32031
10987	30033	58	336	136	0	30563
10988	31003	53	111	127	0	31294
10989	414	30754	91	162	0	31421
10990	30640	293	77	122	0	31132
10991	31072	79	86	155	0	31392
10992	413	76	86	29682	0	30257
10993	152	31465	81	344	0	32042
10994	32845	316	66	164	0	33391
10995	35073	101	78	153	0	35405
10996	601	82	40031	181	0	40895
10997	186	65	40327	95	0	40673
10998	142	56	41324	75	0	41597
10999	99	241	892	40157	0	41389
11000	40375	52	286	754	0	41467
11001	730	40579	160	305	0	41774
11002	39819	658	86	149	0	40712
11003	729	40395	86	146	0	41356
11004	39426	714	82	98	0	40320
11005	716	39607	83	113	0	40519
11006	241	40387	65	98	0	40791
11007	38477	747	49	117	0	39390
11008	633	39510	75	118	0	40336
11009	245	673	55	39518	0	40491
11010	237	205	39871	619	0	40932
11011	151	132	39960	196	0	40439
11012	106	64	787	39303	0	40260
11013	97	64	272	40923	0	41356
11014	151	80	40305	816	0	41352
11015	115	65	670	39805	0	40655
11016	122	70	197	41178	0	41567
11017	40547	61	133	829	0	41570
11018	680	40729	124	393	0	41926
11019	245	680	126	38290	0	39341
11020	135	41051	148	682	0	42016
11021	40570	730	103	264	0	41667
11022	747	40830	91	202	0	41870
11023	40844	763	82	106	0	41795
11024	40799	239	83	108	0	41229
11025	883	194	101	39836	0	41014
11026	362	132	109	40410	0	41013
11027	241	142	130	40720	0	41233
11028	162	160	133	40768	0	41223
11029	175	172	39324	937	0	40608
11030	35821	145	696	402	0	37064
11031	750	39259	248	288	0	40545
11032	336	730	162	39993	0	41221
11033	232	252	189	39885	0	40558
11034	185	40282	172	906	0	41545
11035	39850	755	158	365	0	41128
11036	767	40557	162	285	0	41771
11037	341	825	148	40673	0	41987
11038	252	288	121	41712	0	42373
11039	245	228	85	41868	0	42426
11040	238	207	113	41429	0	41987
11041	40292	162	119	1022	0	41595
11042	855	200	40217	443	0	41715
11043	377	175	774	38975	0	40301
11044	280	169	328	39575	0	40352
11045	197	184	276	39767	0	40424
11046	257	146	211	39610	0	40224
11047	37988	125	178	1133	0	39424
11048	919	179	38501	493	0	40092
11049	399	227	747	36169	0	37542
11050	293	36471	282	870	0	37916
11051	203	38129	220	408	0	38960
11052	37512	893	109	322	0	38836
11053	883	451	37689	214	0	39237
11054	34725	307	661	237	0	35930
11055	926	239	36019	232	0	37416
11056	319	207	677	34422	0	35625
11057	35041	145	245	832	0	36263
11058	635	35869	254	475	0	37233
11059	304	669	221	33633	0	34827
11060	216	35755	199	804	0	36974
11061	35587	715	161	433	0	36896
11062	35783	250	187	397	0	36617
11063	874	186	145	35787	0	36992
11064	377	155	35152	896	0	36580
11065	325	189	34970	474	0	35958
11066	213	263	764	34346	0	35586
11067	215	35829	281	823	0	37148
11068	216	830	141	36629	0	37816
11069	242	357	82	36146	0	36827
11070	225	296	83	36399	0	37003
11071	259	216	35586	1030	0	37091
11072	234	160	652	35748	0	36794
11073	169	168	256	36107	0	36700
11074	153	35477	200	1222	0	37052
11075	128	768	154	34171	0	35221
11076	144	249	148	37425	0	37966
11077	157	132	189	37685	0	38163
11078	206	92	160	37621	0	38079
11079	186	145	148	37051	0	37530
11080	151	148	201	36796	0	37296
11081	165	181	102	36163	0	36611
11082	173	235	139	35472	0	36019
11083	242	222	33528	1198	0	35190
11084	239	234	603	34074	0	35150
11085	33643	169	247	984	0	35043
11086	782	146	159	33188	0	34275
11087	381	137	33987	998	0	35503
11088	32942	140	688	579	0	34349
11089	34843	137	248	424	0	35652
11090	34746	156	204	376	0	35482
11091	34707	122	133	410	0	35372
11092	1006	102	113	34929	0	36150
11093	417	84	34215	1043	0	35759
11094	236	32796	640	583	0	34255
11095	156	31060	323	422	0	31961
11096	339	635	700	24303	0	25977
11097	139	80	290	24718	0	25227
11098	34	44	24	24694	0	24796
11099	34	40	24	25161	0	25259
11100	34	35	23	27722	0	27814
11101	29471	31	22	493	0	30017
11102	457	29894	35	193	0	30579
11103	120	31029	36	134	0	31319
11104	77	720	39	31460	0	32296
11105	55	155	33	32215	0	32458
11106	53	61	23	32207	0	32344
11107	57	40	26	32157	0	32280
11108	70	39	30492	817	0	31418
11109	40	29962	565	313	0	30880
11110	56	579	127	30203	0	30965
11111	29518	135	58	633	0	30344
11112	558	68	48	29888	0	30562
11113	164	53	29726	685	0	30628
11114	103	71	28890	242	0	29306
11115	84	44	29759	174	0	30061
11116	48	90	670	28790	0	29598
11117	30089	38	228	679	0	31034
11118	550	47	79	30252	0	30928
11119	146	45	49	31328	0	31568
11120	30665	46	47	790	0	31548
11121	595	39	45	31207	0	31886
11122	172	38	71	31677	0	31958
11123	123	48	32233	771	0	33175
11124	69	32330	610	329	0	33338
11125	88	634	157	33523	0	34402
11126	33199	140	81	731	0	34151
11127	641	74	58	33694	0	34467
11128	242	63	33675	787	0	34767
11129	117	46	623	33356	0	34142
11130	78	33781	194	801	0	34854
11131	81	638	97	34367	0	35183
11132	102	178	33618	795	0	34693
11133	76	35716	647	415	0	36854
11134	100	793	187	36386	0	37466
11135	88	263	132	40115	0	40598
11136	80	98	87	41070	0	41335
11137	67	77	96	41661	0	41901
11138	122	76	40120	1280	0	41598
11139	72	40188	886	543	0	41689
11140	40510	867	272	316	0	41965
11141	41122	257	134	252	0	41765
11142	1077	149	95	40612	0	41933
11143	357	79	40151	1048	0	41635
11144	38686	69	911	438	0	40104
11145	945	62	280	40768	0	42055
11146	312	83	41756	1104	0	43255
11147	195	66	970	41767	0	42998
11148	108	77	274	42192	0	42651
11149	135	64	147	42907	0	43253
11150	125	76	42918	1363	0	44482
11151	156	95	935	40085	0	41271
11152	115	43089	309	1113	0	44626
11153	43421	915	148	440	0	44924
11154	43793	276	120	343	0	44532
11155	43755	166	136	283	0	44340
11156	1172	43009	119	356	0	44656
11157	43064	926	120	359	0	44469
11158	1020	277	121	42409	0	43827
11159	42280	148	147	1170	0	43745
11160	42245	121	166	533	0	43065
11161	1237	154	40927	344	0	42662
11162	393	40883	971	389	0	42636
11163	40818	935	312	330	0	42395
11164	1008	306	185	40748	0	42247
11165	403	196	40387	1123	0	42109
11166	217	40442	981	564	0	42204
11167	39621	934	334	376	0	41265
11168	983	310	180	39985	0	41458
11169	387	168	166	40775	0	41496
11170	247	130	149	40614	0	41140
11171	199	39759	173	1399	0	41530
11172	242	947	157	39966	0	41312
11173	182	39482	196	1339	0	41199
11174	223	962	153	40059	0	41397
11175	231	348	39466	1262	0	41307
11176	262	195	978	39756	0	41191
11177	227	157	361	40743	0	41488
11178	261	137	237	41220	0	41855
11179	272	159	39761	1469	0	41661
11180	227	130	1021	39816	0	41194
11181	266	128	361	41200	0	41955
11182	256	133	261	41441	0	42091
11183	227	156	235	41310	0	41928
11184	230	143	249	41679	0	42301
11185	273	199	40099	1478	0	42049
11186	315	146	975	40043	0	41479
11187	269	151	361	39991	0	40772
11188	37740	142	228	1482	0	39592
11189	1040	37510	201	774	0	39525
11190	492	38890	232	574	0	40188
11191	341	1150	208	38627	0	40326
11192	346	379	190	38114	0	39029
11193	277	36827	198	1481	0	38783
11194	327	950	197	36735	0	38209
11195	261	36781	210	1340	0	38592
11196	393	965	211	36609	0	38178
11197	343	421	167	36495	0	37426
11198	283	247	34650	1309	0	36489
11199	281	33714	884	739	0	35618
11200	243	32704	314	502	0	33763
11201	27726	767	279	343	0	29115
11202	543	28561	175	318	0	29597
11203	294	559	103	28045	0	29001
11204	222	260	27092	729	0	28303
11205	221	204	516	26846	0	27787
11206	26561	154	214	743	0	27672
11207	634	171	26989	390	0	28184
11208	279	27694	519	342	0	28834
11209	228	529	218	26492	0	27467
11210	146	239	154	28795	0	29334
11211	28532	148	165	878	0	29723
11212	561	133	117	28930	0	29741
11213	250	105	120	29195	0	29670
11214	134	133	111	29188	0	29566
11215	152	124	108	29184	0	29568
11216	28056	108	121	904	0	29189
11217	27916	143	99	525	0	28683
11218	659	122	95	28142	0	29018
11219	27386	120	124	761	0	28391
11220	542	112	105	27022	0	27781
11221	261	132	26116	771	0	27280
11222	184	120	25261	500	0	26065
11223	175	358	559	23215	0	24307
11224	107	24239	220	672	0	25238
11225	145	468	96	24145	0	24854
11226	23779	192	78	676	0	24725
11227	430	145	94	24063	0	24732
11228	23174	104	77	707	0	24062
11229	446	99	77	23941	0	24563
11230	195	122	24219	650	0	25186
11231	99	23746	415	395	0	24655
11232	79	24582	158	377	0	25196
11233	128	611	70	21584	0	22393
11234	90	121	21397	465	0	22073
11235	16	17906	151	143	0	18216
11236	109	221	69	17083	0	17482
11237	16781	21	23	132	0	16957
11238	78	21	17002	72	0	17173
11239	30	30	66	16843	0	16969
11240	29	14	20	17599	0	17662
11241	31	28	17412	104	0	17575
11242	30	32	16364	65	0	16491
11243	28	25	17772	56	0	17881
11244	24	30	95	17521	0	17670
11245	31	22	18452	81	0	18586
11246	15814	16	86	67	0	15983
11247	101	16	22	18679	0	18818
11248	77	34	22654	132	0	22897
11249	16	23120	114	129	0	23379
11250	40	127	23038	33	0	23238
11251	20	59	119	22907	0	23105
11252	24076	16	42	217	0	24351
11253	151	18	16	24725	0	24910
11254	49	24	16	25189	0	25278
11255	27228	13	28	266	0	27535
11256	248	21	13	27812	0	28094
11257	73	21	28601	300	0	28995
11258	27645	15	285	92	0	28037
11259	279	29351	75	75	0	29780
11260	29805	283	23	72	0	30183
11261	320	67	15	29944	0	30346
11262	90	33	29809	321	0	30253
11263	69	37	29888	96	0	30090
11264	24	26	392	29798	0	30240
11265	34	16	78	30023	0	30151
11266	60	23	30341	337	0	30761
11267	46	26	29123	108	0	29303
11268	29903	21	347	64	0	30335
11269	320	22	89	30613	0	31044
11270	30793	10	64	331	0	31198
11271	324	26	43	30689	0	31082
11272	121	50	32169	357	0	32697
11273	79	46	33856	107	0	34088
11274	66	31	401	34085	0	34583
11275	53	20	117	35239	0	35429
11276	52	29	36314	448	0	36843
11277	34340	27	412	165	0	34944
11278	455	22	101	37609	0	38187
11279	39103	13	91	493	0	39700
11280	495	44589	77	211	0	45372
11281	129	642	50	45788	0	46609
11282	45916	123	57	746	0	46842
11283	753	62	46544	204	0	47563
11284	172	36	730	46535	0	47473
11285	92	50	188	47082	0	47412
11286	89	35	104	47950	0	48178
11287	97	52	47316	935	0	48400
11288	90	53	776	45661	0	46580
11289	77	47336	233	812	0	48458
11290	86	683	121	47997	0	48887
11291	112	131	47559	834	0	48636
11292	125	74	47677	233	0	48109
11293	93	44	868	47194	0	48199
11294	100	42	234	48011	0	48387
11295	95	39	151	48794	0	49079
11296	83	45	131	49212	0	49471
11297	48391	39	129	1000	0	49559
11298	47841	45	120	320	0	48326
11299	930	38	47799	212	0	48979
11300	228	48793	820	223	0	50064
11301	150	735	200	49952	0	51037
11302	51445	150	143	995	0	52733
11303	49617	86	144	334	0	50181
11304	51808	37	139	232	0	52216
11305	51794	49	141	212	0	52196
11306	968	74	51078	234	0	52354
11307	48423	52	847	253	0	49575
11308	850	49939	272	285	0	51346
11309	245	747	188	50732	0	51912
11310	243	152	50934	940	0	52269
11311	168	91	851	49784	0	50894
11312	210	95	50847	990	0	52142
11313	183	81	898	50404	0	51566
11314	209	78	268	52007	0	52562
11315	51504	68	200	1081	0	52853
11316	890	76	190	51567	0	52723
11317	311	114	52319	1047	0	53791
11318	210	73	922	53048	0	54253
11319	52951	82	328	1104	0	54465
11320	925	79	263	53733	0	55000
11321	379	88	53559	1120	0	55146
11322	204	52617	978	521	0	54320
11323	54616	789	332	491	0	56228
11324	958	186	271	51733	0	53148
11325	311	55674	243	1019	0	57247
11326	55160	791	264	490	0	56705
11327	1027	202	55171	426	0	56826
11328	322	54151	980	465	0	55918
11329	252	810	366	55416	0	56844
11330	275	213	55011	1066	0	56565
11331	237	147	952	52797	0	54133
11332	53701	101	360	1163	0	55325
11333	999	117	53822	525	0	55463
11334	413	105	929	53183	0	54630
11335	372	129	54514	1135	0	56150
11336	314	106	1015	53268	0	54703
11337	323	153	323	55528	0	56327
11338	54402	117	243	1307	0	56069
11339	985	54851	288	577	0	56701
11340	385	836	269	55580	0	57070
11341	54893	222	268	1180	0	56563
11342	54654	145	295	559	0	55653
11343	1112	207	283	53234	0	54836
11344	383	53487	267	1120	0	55257
11345	249	55233	273	575	0	56330
11346	294	966	306	53900	0	55466
11347	277	288	264	54293	0	55122
11348	49680	137	229	1230	0	51276
11349	934	111	252	49671	0	50968
11350	336	115	48040	1081	0	49572
11351	43056	93	834	554	0	44537
11352	801	46446	309	493	0	48049
11353	45728	715	236	434	0	47113
11354	1038	170	46786	355	0	48349
11355	312	46674	680	356	0	48022
11356	47003	722	474	311	0	48510
11357	46627	179	289	231	0	47326
11358	866	135	46591	214	0	47806
11359	44660	124	684	214	0	45682
11360	46506	93	239	210	0	47048
11361	761	46353	162	286	0	47562
11362	326	655	133	47467	0	48581
11363	270	181	46679	779	0	47909
11364	213	136	714	46910	0	47973
11365	235	135	48648	824	0	49842
11366	181	118	769	47307	0	48375
11367	48484	117	264	875	0	49740
11368	776	71	148	49688	0	50683
11369	270	80	54294	902	0	55546
11370	53652	77	927	385	0	55041
11371	1056	59	254	56427	0	57796
11372	317	94	55175	1036	0	56622
11373	50851	58	1021	418	0	52348
11374	1064	129	276	53601	0	55070
11375	344	112	52976	1030	0	54462
11376	257	104	51773	371	0	52505
11377	193	345	943	49844	0	51325
11378	215	94	52017	886	0	53212
11379	136	49087	832	371	0	50426
11380	282	648	212	43688	0	44830
11381	43520	133	106	556	0	44315
11382	545	62	44033	134	0	44774
11383	190	49	43320	87	0	43646
11384	39329	23	638	105	0	40095
11385	549	32	43691	55	0	44327
11386	40209	36	588	91	0	40924
11387	554	32	43364	69	0	44019
11388	179	32	547	42089	0	42847
11389	126	35	43848	509	0	44518
11390	92	40	552	42391	0	43075
11391	98	39	44814	551	0	45502
11392	92	42	43926	172	0	44232
11393	38687	24	636	150	0	39497
11394	483	44333	223	131	0	45170
11395	44883	451	139	92	0	45565
11396	521	45379	120	92	0	46112
11397	184	487	115	45372	0	46158
11398	148	144	106	46408	0	46806
11399	45871	73	109	626	0	46679
11400	515	71	124	45020	0	45730
11401	218	49	44989	591	0	45847
11402	42144	32	575	224	0	42975
11403	43756	32	245	146	0	44179
11404	647	42	178	43680	0	44547
11405	256	57	44497	571	0	45381
11406	158	49	613	43269	0	44089
11407	89	44682	237	603	0	45611
11408	117	498	169	44908	0	45692
11409	129	149	130	45822	0	46230
11410	133	130	44595	698	0	45556
11411	37164	58	625	328	0	38175
11412	565	43826	231	268	0	44890
11413	43589	509	186	168	0	44452
11414	579	44466	175	177	0	45397
11415	247	562	151	43602	0	44562
11416	144	44473	168	671	0	45456
11417	165	568	42967	271	0	43971
11418	136	169	610	41053	0	41968
11419	172	95	276	42766	0	43309
11420	150	64	211	43708	0	44133
11421	42756	54	204	776	0	43790
11422	622	70	196	42840	0	43728
11423	41785	61	225	724	0	42795
11424	42066	80	190	321	0	42657
11425	41260	72	225	296	0	41853
11426	821	109	41373	248	0	42551
11427	377	108	700	41269	0	42454
11428	229	76	343	44059	0	44707
11429	192	93	331	45113	0	45729
11430	47028	89	319	979	0	48415
11431	845	98	269	47335	0	48547
11432	354	92	303	48472	0	49221
11433	50498	125	303	1108	0	52034
11434	1024	87	301	51751	0	53163
11435	465	117	53394	1143	0	55119
11436	335	134	53778	447	0	54694
11437	282	109	1318	53768	0	55477
11438	53320	97	494	1163	0	55074
11439	50798	77	425	471	0	51771
11440	1315	84	322	52185	0	53906
11441	535	105	52381	1158	0	54179
11442	302	51858	1175	519	0	53854
11443	286	924	481	53040	0	54731
11444	276	264	333	53839	0	54712
11445	276	163	314	53834	0	54587
11446	52762	119	305	1394	0	54580
11447	1173	131	53073	576	0	54953
11448	52369	141	1137	391	0	54038
11449	1233	123	421	51394	0	53171
11450	478	53246	290	1150	0	55164
11451	53587	969	234	519	0	55309
11452	52739	287	217	433	0	53676
11453	1425	185	55766	384	0	57760
11454	523	53176	1109	479	0	55287
11455	328	52942	426	381	0	54077
11456	51725	1091	259	372	0	53447
11457	1160	308	205	52078	0	53751
11458	467	165	183	52332	0	53147
11459	330	141	224	51704	0	52399
11460	254	49884	185	1551	0	51874
11461	252	51668	185	623	0	52728
11462	50161	1100	171	448	0	51880
11463	1241	336	142	49806	0	51525
11464	438	164	53432	1172	0	55206
11465	296	139	1216	55961	0	57612
11466	310	180	62669	1525	0	64684
11467	356	168	63345	566	0	64435
11468	313	175	63317	376	0	64181
11469	166	56694	1827	268	0	58955
11470	418	1535	918	52026	0	54897
11471	140	55556	373	1242	0	57311
11472	216	1419	161	53398	0	55194
11473	143	425	145	56633	0	57346
11474	55496	214	118	1740	0	57568
11475	1344	113	116	55770	0	57343
11476	55132	112	83	1566	0	56893
11477	55774	66	94	621	0	56555
11478	1701	82	110	52876	0	54769
11479	602	54041	143	1385	0	56171
11480	354	1276	108	53101	0	54839
11481	219	54138	147	1475	0	55979
11482	224	1380	117	54314	0	56035
11483	230	449	53728	1624	0	56031
11484	189	222	1307	53931	0	55649
11485	216	145	457	55652	0	56470
11486	52653	124	256	1868	0	54901
11487	1314	53862	265	798	0	56239
11488	535	1317	203	54040	0	56095
11489	362	449	162	53551	0	54524
11490	269	53066	247	1835	0	55417
11491	272	1369	189	53414	0	55244
11492	51557	523	182	1705	0	53967
11493	52858	294	187	740	0	54079
11494	1693	51948	182	553	0	54376
11495	635	1424	153	52076	0	54288
11496	50308	475	158	1682	0	52623
11497	1394	51806	157	814	0	54171
11498	623	1445	177	48571	0	50816
11499	375	51340	235	1564	0	53514
11500	51039	1470	273	692	0	53474
11501	1547	545	50482	506	0	53080
11502	663	367	50676	451	0	52157
11503	450	248	1721	50325	0	52744
11504	412	256	51393	1594	0	53655
11505	293	223	1608	50234	0	52358
11506	50291	249	643	1682	0	52865
11507	1469	269	51946	795	0	54479
11508	599	288	1400	51756	0	54043
11509	406	271	529	53974	0	55180
11510	52581	267	289	1991	0	55128
11511	1438	53590	231	987	0	56246
11512	53922	1419	166	704	0	56211
11513	53868	591	155	561	0	55175
11514	1835	52331	182	598	0	54946
11515	750	1379	183	53346	0	55658
11516	553	610	52316	1617	0	55096
11517	387	413	1354	51867	0	54021
11518	296	53503	568	1660	0	56027
11519	53896	1475	371	810	0	56552
11520	1419	623	333	54382	0	56757
11521	569	477	55485	1698	0	58229
11522	354	326	1417	55879	0	57976
11523	296	338	565	57589	0	58788
11524	314	333	322	58056	0	59025
11525	271	306	248	58266	0	59091
11526	368	276	259	56808	0	57711
11527	340	311	54664	2292	0	57607
11528	532	263	52833	1095	0	54723
11529	324	50863	1577	816	0	53580
11530	294	51134	562	565	0	52555
11531	49747	1376	406	474	0	52003
11532	1305	536	49673	440	0	51954
11533	45160	413	1225	388	0	47186
11534	1166	257	45165	383	0	46971
11535	477	217	43132	312	0	44138
11536	285	181	1243	41695	0	43404
11537	43831	197	621	1133	0	45782
11538	946	199	282	44445	0	45872
11539	419	234	158	45502	0	46313
11540	306	198	48825	1421	0	50750
11541	201	167	899	49223	0	50490
11542	212	137	343	50416	0	51108
11543	227	116	214	50295	0	50852
11544	270	121	147	50247	0	50785
11545	266	120	109	50515	0	51010
11546	48751	142	92	1485	0	50470
11547	994	160	90	49011	0	50255
11548	431	169	47679	1286	0	49565
11549	270	204	847	47798	0	49119
11550	226	181	47645	1218	0	49270
11551	178	228	996	47086	0	48488
11552	197	140	48945	1195	0	50477
11553	144	244	1033	45963	0	47384
11554	152	129	426	48621	0	49328
11555	166	131	47681	1251	0	49229
11556	42133	126	932	691	0	43882
11557	870	155	48344	421	0	49790
11558	423	192	932	48352	0	49899
11559	49819	93	436	1069	0	51417
11560	909	128	244	50016	0	51297
11561	457	120	151	50824	0	51552
11562	357	100	50482	1267	0	52206
11563	199	49315	801	734	0	51049
11564	104	45783	276	393	0	46556
11565	104	43906	236	315	0	44561
11566	673	195	562	36005	0	37435
11567	36446	35	74	189	0	36744
11568	111	28	26	36434	0	36599
11569	49	26	34	36851	0	36960
11570	30	21	28	37149	0	37228
11571	42	14	25	37025	0	37106
11572	24	36732	43	179	0	36978
11573	48	106	27	37419	0	37600
11574	26	38	32	37389	0	37485
11575	19	37041	25	219	0	37304
11576	37971	111	21	118	0	38221
11577	123	41	23	37877	0	38064
11578	37563	20	33	171	0	37787
11579	37434	24	23	88	0	37569
11580	144	38551	34	90	0	38819
11581	74	113	16	41454	0	41657
11582	45	63	40768	139	0	41015
11583	52	45	39864	60	0	40021
11584	64	131	121	40512	0	40828
11585	41674	13	70	170	0	41927
11586	42416	13	27	121	0	42577
11587	136	16	25	42866	0	43043
11588	43295	14	25	197	0	43531
11589	117	42802	44	119	0	43082
11590	43059	100	28	76	0	43263
11591	129	45854	42	87	0	46112
11592	58	121	26	47206	0	47411
11593	61	77	19	47403	0	47560
11594	24	47386	34	197	0	47641
11595	47064	113	69	92	0	47338
11596	156	77	46134	66	0	46433
11597	65	35	114	46431	0	46645
11598	66	47	47661	134	0	47908
11599	39	37	121	46886	0	47083
11600	48110	23	50	176	0	48359
11601	154	23	21	48015	0	48213
11602	47751	25	33	187	0	47996
11603	47348	31	36	113	0	47528
11604	154	23	34	46857	0	47068
11605	80	41	46791	164	0	47076
11606	46	48695	125	132	0	48998
11607	51	114	42	48179	0	48386
11608	47300	45	24	203	0	47572
11609	167	71	47388	86	0	47712
11610	80	47	109	47554	0	47790
11611	53	37	40	48243	0	48373
11612	46	32	39	48772	0	48889
11613	48151	42	45	220	0	48458
11614	120	32	31	47880	0	48063
11615	73	28	34	48549	0	48684
11616	76	46	48068	180	0	48370
11617	55	27	148	47848	0	48078
11618	73	25	61	49382	0	49541
11619	59	30	56	49989	0	50134
11620	52	49302	49	271	0	49674
11621	76	169	29	48431	0	48705
11622	55	57	36	48198	0	48346
11623	45557	31	38	257	0	45883
11624	206	58	46040	109	0	46413
11625	116	70	44120	96	0	44402
11626	55	46074	177	107	0	46413
11627	63	163	60	47772	0	48058
11628	47529	52	75	257	0	47913
11629	170	41	38	47095	0	47344
11630	87	26	33	47879	0	48025
11631	48	25	32	48150	0	48255
11632	47	21	31	47481	0	47580
11633	52	34	31	47469	0	47586
11634	79	56	46523	247	0	46905
11635	45	24	141	46638	0	46848
11636	46843	30	50	232	0	47155
11637	151	45815	40	168	0	46174
11638	75	138	30	46492	0	46735
11639	46	72	27	46422	0	46567
11640	97	51	43383	249	0	43780
11641	64	31	155	42434	0	42684
11642	40	24	59	46307	0	46430
11643	46444	24	33	353	0	46854
11644	265	48179	43	207	0	48694
11645	120	295	38	49083	0	49536
11646	74	94	44	49774	0	49986
11647	63	102	38	49958	0	50161
11648	96	56	49929	499	0	50580
11649	105	58	47870	243	0	48276
11650	48	49362	448	186	0	50044
11651	45	51599	164	180	0	51988
11652	83	445	106	50144	0	50778
11653	42	49803	84	503	0	50432
11654	62	540	40	55199	0	55841
11655	46	194	45	61025	0	61310
11656	54	96	37	65085	0	65272
11657	41	62	36	75201	0	75340
11658	96	78	74321	1636	0	76131
11659	40	63	1141	74714	0	75958
11660	58	42	503	75866	0	76469
11661	54	37	234	77868	0	78193
11662	73714	47	136	2081	0	75978
11663	1171	77233	123	1066	0	79593
11664	621	1337	93	69148	0	71199
11665	219	77529	102	1380	0	79230
11666	74118	1462	65	725	0	76370
11667	62379	790	111	512	0	63792
11668	1385	76946	58	455	0	78844
11669	567	79333	65	359	0	80324
11670	475	2000	75221	265	0	77961
11671	198	78915	1294	240	0	80647
11672	179	1683	548	77504	0	79914
11673	77080	770	240	1495	0	79585
11674	1301	79532	172	826	0	81831
11675	602	1548	150	80035	0	82335
11676	289	764	145	81541	0	82739
11677	179	400	131	83255	0	83965
11678	79755	269	150	2417	0	82591
11679	1537	267	80357	1204	0	83365
11680	75182	210	1411	757	0	77560
11681	1635	77641	653	631	0	80560
11682	764	1598	280	78529	0	81171
11683	448	762	77453	1761	0	80424
11684	70693	411	1564	970	0	73638
11685	1580	77364	695	585	0	80224
11686	808	1655	327	74804	0	77594
11687	419	77066	234	1666	0	79385
11688	287	1812	232	77351	0	79682
11689	261	898	194	79141	0	80494
11690	251	557	76926	2382	0	80116
11691	282	444	74128	1175	0	76029
11692	211	355	2094	73818	0	76478
11693	269	319	75231	2057	0	77876
11694	186	304	1807	74230	0	76527
11695	245	242	834	74900	0	76221
11696	206	268	503	77347	0	78324
11697	74842	189	368	2765	0	78164
11698	1646	260	320	76121	0	78347
11699	804	228	75987	2379	0	79398
11700	74280	209	1671	1377	0	77537
11701	1737	288	823	77076	0	79924
11702	927	280	459	78725	0	80391
11703	75883	341	414	2646	0	79284
11704	1716	78531	367	1609	0	82223
11705	908	1735	300	79456	0	82399
11706	539	842	302	79461	0	81144
11707	77001	562	319	2846	0	80728
11708	1787	447	77264	1630	0	81128
11709	880	433	1673	76331	0	79317
11710	511	380	883	77711	0	79485
11711	469	384	531	75073	0	76457
11712	354	75699	478	2977	0	79508
11713	422	1780	406	77044	0	79652
11714	75068	900	388	2618	0	78974
11715	1702	75850	378	1763	0	79693
11716	73921	1847	374	1243	0	77385
11717	1926	75797	400	1107	0	79230
11718	75567	2017	341	1062	0	78987
11719	2128	1062	74491	987	0	78668
11720	1179	776	74534	926	0	77415
11721	73007	580	2236	931	0	76754
11722	2009	557	75938	954	0	79458
11723	1154	479	1975	74374	0	77982
11724	765	469	1050	73666	0	75950
11725	660	436	709	77393	0	79198
11726	75565	440	589	2952	0	79546
11727	1941	415	74531	1757	0	78644
11728	73488	395	1860	1313	0	77056
11729	2021	417	969	77749	0	81156
11730	77834	394	610	2557	0	81395
11731	2244	448	492	78579	0	81763
11732	80182	454	478	2583	0	83697
11733	2370	543	383	85130	0	88426
11734	1307	483	86498	2864	0	91152
11735	86063	495	2100	1624	0	90282
11736	89916	402	1008	1183	0	92509
11737	3096	432	692	88897	0	93117
11738	1483	441	628	85187	0	87739
11739	938	89204	641	3186	0	93969
11740	84941	2075	632	1731	0	89379
11741	2362	87839	543	1412	0	92156
11742	84284	2133	659	1171	0	88247
11743	2470	955	84789	1020	0	89234
11744	1305	565	85159	1023	0	88052
11745	948	357	84416	977	0	86698
11746	78740	379	2953	911	0	82983
11747	2352	83654	1300	960	0	88266
11748	1319	1923	756	81969	0	85967
11749	80151	847	627	2426	0	84051
11750	2237	83256	541	1532	0	87566
11751	1212	3191	493	76649	0	81545
11752	814	80594	583	2312	0	84303
11753	733	78306	506	1368	0	80913
11754	672	77525	450	929	0	79576
11755	66864	2012	807	874	0	70557
11756	1534	67340	330	745	0	69949
11757	446	56089	295	431	0	57261
11758	417	55051	311	367	0	56146
11759	53955	1047	556	340	0	55898
11760	54011	289	307	314	0	54921
11761	1239	246	52289	322	0	54096
11762	50156	129	902	324	0	51511
11763	52276	148	285	332	0	53041
11764	1167	148	169	51251	0	52735
11765	52247	145	194	1019	0	53605
11766	1120	192	51197	361	0	52870
11767	450	54511	876	307	0	56144
11768	54259	963	310	276	0	55808
11769	1118	373	193	55741	0	57425
11770	56398	210	145	1044	0	57797
11771	1191	222	54099	379	0	55891
11772	53517	169	917	262	0	54865
11773	1171	156	300	55507	0	57134
11774	460	156	55266	1021	0	56903
11775	258	53192	965	409	0	54824
11776	237	55748	305	287	0	56577
11777	274	1273	232	52560	0	54339
11778	237	352	142	50102	0	50833
11779	155	54091	105	976	0	55327
11780	54023	903	87	251	0	55264
11781	53798	251	73	151	0	54273
11782	52478	130	114	132	0	52854
11783	1171	54266	98	209	0	55744
11784	464	895	97	48616	0	50072
11785	214	54127	98	811	0	55250
11786	54200	918	93	234	0	55445
11787	53441	277	78	173	0	53969
11788	1135	53118	88	158	0	54499
11789	53566	887	72	146	0	54671
11790	1018	264	67	53315	0	54664
11791	340	153	99	53685	0	54277
11792	54023	146	127	1091	0	55387
11793	52510	174	120	303	0	53107
11794	52728	134	107	189	0	53158
11795	1199	149	121	51990	0	53459
11796	397	154	127	53195	0	53873
11797	260	201	52272	1114	0	53847
11798	273	185	928	51152	0	52538
11799	243	209	273	51301	0	52026
11800	324	242	50278	1086	0	51930
11801	295	256	48919	339	0	49809
11802	266	222	50641	222	0	51351
11803	242	222	1160	49160	0	50784
11804	339	287	48762	977	0	50365
11805	293	279	960	47868	0	49400
11806	275	288	323	49511	0	50397
11807	329	269	49015	1154	0	50767
11808	313	311	49273	386	0	50283
11809	260	309	1105	47780	0	49454
11810	346	315	51872	1027	0	53560
11811	398	286	51737	348	0	52769
11812	302	50833	1132	265	0	52532
11813	52446	1088	353	211	0	54098
11814	52773	412	189	203	0	53577
11815	52489	306	195	203	0	53193
11816	1331	51981	143	298	0	53753
11817	551	53249	144	278	0	54222
11818	405	1188	186	52505	0	54284
11819	394	416	191	52485	0	53486
11820	411	267	51420	1266	0	53364
11821	388	231	1016	50955	0	52590
11822	51488	216	364	1165	0	53233
11823	1240	212	241	46677	0	48370
11824	524	51132	243	1090	0	52989
11825	52483	1027	220	436	0	54166
11826	52802	368	223	323	0	53716
11827	53462	253	208	335	0	54258
11828	1462	251	52528	304	0	54545
11829	522	399	939	51516	0	53376
11830	55356	186	381	1240	0	57163
11831	1352	180	56642	496	0	58670
11832	488	54257	1131	384	0	56260
11833	331	51645	307	282	0	52565
11834	46123	1074	367	226	0	47790
11835	909	46903	202	245	0	48259
11836	415	836	164	45439	0	46854
11837	240	239	46403	887	0	47769
11838	285	164	814	45711	0	46974
11839	46019	109	259	923	0	47310
11840	857	45888	156	400	0	47301
11841	45475	801	126	239	0	46641
11842	941	256	45551	204	0	46952
11843	358	245	816	42494	0	43913
11844	191	46848	286	824	0	48149
11845	230	942	181	46809	0	48162
11846	47219	215	167	899	0	48500
11847	47821	113	147	338	0	48419
11848	47623	101	158	219	0	48101
11849	47858	116	154	206	0	48334
11850	1010	118	149	46133	0	47410
11851	358	123	47447	897	0	48825
11852	230	137	821	44985	0	46173
11853	169	47323	289	860	0	48641
11854	47628	743	234	324	0	48929
11855	875	219	47236	234	0	48564
11856	45025	113	810	240	0	46188
11857	828	122	312	46589	0	47851
11858	334	122	48147	862	0	49465
11859	226	91	818	47474	0	48609
11860	48308	81	315	920	0	49624
11861	48529	122	201	320	0	49172
11862	48531	126	178	257	0	49092
11863	1021	145	47935	206	0	49307
11864	405	202	798	46351	0	47756
11865	285	139	48624	844	0	49892
11866	217	47999	816	370	0	49402
11867	44982	647	243	250	0	46122
11868	665	44327	178	223	0	45393
11869	41923	532	194	143	0	42792
11870	649	195	121	39999	0	40964
11871	221	41741	122	480	0	42564
11872	41951	529	114	202	0	42796
11873	627	162	42062	141	0	42992
11874	217	107	491	41198	0	42013
11875	42075	93	164	571	0	42903
11876	616	92	42123	207	0	43038
11877	278	87	505	40562	0	41432
11878	240	41676	181	529	0	42626
11879	231	530	126	42244	0	43131
11880	215	213	102	42684	0	43214
11881	41315	151	112	618	0	42196
11882	575	42094	109	304	0	43082
11883	273	538	109	40575	0	41495
11884	201	41877	122	551	0	42751
11885	205	592	137	41167	0	42101
11886	213	42710	143	538	0	43604
11887	42018	556	149	231	0	42954
11888	666	220	42698	194	0	43778
11889	278	140	546	42394	0	43358
11890	234	105	229	43194	0	43762
11891	218	112	129	43463	0	43922
11892	241	133	120	43018	0	43512
11893	300	144	42479	685	0	43608
11894	262	43509	549	402	0	44722
11895	43778	531	179	263	0	44751
11896	43871	196	161	239	0	44467
11897	616	44338	144	299	0	45397
11898	44511	563	123	237	0	45434
11899	44146	222	143	217	0	44728
11900	695	45685	127	219	0	46726
11901	370	611	105	43811	0	44897
11902	241	46106	148	516	0	47011
11903	45709	565	157	261	0	46692
11904	647	193	44893	245	0	45978
11905	40868	138	585	282	0	41873
11906	683	144	45904	254	0	46985
11907	316	114	575	45227	0	46232
11908	45874	113	196	633	0	46816
11909	717	114	45249	277	0	46357
11910	41650	119	587	232	0	42588
11911	43750	98	222	277	0	44347
11912	724	197	142	42952	0	44015
11913	320	44061	122	621	0	45124
11914	44799	590	102	278	0	45769
11915	696	257	94	43937	0	44984
11916	314	44067	116	601	0	45098
11917	43931	568	131	271	0	44901
11918	630	246	110	44245	0	45231
11919	279	46387	150	627	0	47443
11920	230	562	127	47683	0	48602
11921	47866	187	139	693	0	48885
11922	47641	142	132	303	0	48218
11923	47885	117	160	243	0	48405
11924	722	116	153	46581	0	47572
11925	322	149	122	47198	0	47791
11926	272	147	47404	683	0	48506
11927	277	221	551	46524	0	47573
11928	288	180	49032	690	0	50190
11929	228	137	44926	233	0	45524
11930	108	73	42994	102	0	43277
11931	64	44789	353	133	0	45339
11932	168	420	259	41523	0	42370
11933	44	48260	85	270	0	48659
11934	49334	408	87	124	0	49953
11935	49166	96	67	100	0	49429
11936	481	75	46	51355	0	51957
11937	183	74	53428	526	0	54211
11938	100	58	632	52663	0	53453
11939	131	90	54804	735	0	55760
11940	106	79	649	51634	0	52468
11941	73	54666	164	692	0	55595
11942	75	55942	79	241	0	56337
11943	53868	725	68	135	0	54796
11944	742	191	54219	102	0	55254
11945	195	84	662	53115	0	54056
11946	126	67	157	54551	0	54901
11947	54667	62	94	868	0	55691
11948	680	55301	109	358	0	56448
11949	55035	690	76	158	0	55959
11950	706	56329	103	161	0	57299
11951	55109	711	99	145	0	56064
11952	55837	200	96	199	0	56332
11953	837	117	96	56052	0	57102
11954	276	132	56280	784	0	57472
11955	52595	100	763	251	0	53709
11956	748	56809	226	232	0	58015
11957	57257	750	122	188	0	58317
11958	804	222	90	55401	0	56517
11959	266	160	80	54963	0	55469
11960	180	55728	126	885	0	56919
11961	179	746	133	54292	0	55350
11962	164	56312	109	796	0	57381
11963	198	750	90	55671	0	56709
11964	181	230	77	55445	0	55933
11965	53133	137	106	900	0	54276
11966	844	151	54117	260	0	55372
11967	269	53611	709	219	0	54808
11968	232	760	207	53915	0	55114
11969	54862	209	160	844	0	56075
11970	55436	123	133	324	0	56016
11971	55465	125	131	265	0	55986
11972	1011	180	54772	196	0	56159
11973	54123	156	837	204	0	55320
11974	913	165	236	55346	0	56660
11975	54445	147	146	972	0	55710
11976	894	54408	131	357	0	55790
11977	310	828	125	55031	0	56294
11978	54410	267	121	930	0	55728
11979	900	56407	134	403	0	57844
11980	352	932	115	56857	0	58256
11981	343	291	57459	953	0	59046
11982	55743	205	894	410	0	57252
11983	60580	201	297	292	0	61370
11984	1335	194	61212	254	0	62995
11985	435	59986	1029	331	0	61781
11986	305	62401	288	282	0	63276
11987	302	1231	217	61331	0	63081
11988	294	382	156	60881	0	61713
11989	311	254	169	62053	0	62787
11990	356	217	62939	1387	0	64899
11991	60139	212	1111	560	0	62022
11992	65666	229	357	423	0	66675
11993	67278	221	204	375	0	68078
11994	67629	244	169	326	0	68368
11995	68657	253	196	364	0	69470
11996	69463	233	223	368	0	70287
11997	1734	225	264	72264	0	74487
11998	646	262	72335	1606	0	74849
11999	488	290	73314	568	0	74660
12000	389	304	1613	72309	0	74615
12001	471	322	423	72698	0	73914
12002	504	306	251	70560	0	71621
12003	475	73605	219	1820	0	76119
12004	73178	1547	199	663	0	75587
12005	1731	76087	258	568	0	78644
12006	662	1646	234	74945	0	77487
12007	72931	452	248	1753	0	75384
12008	1721	74740	245	707	0	77413
12009	720	1643	208	75262	0	77833
12010	566	547	177	77079	0	78369
12011	528	352	182	76541	0	77603
12012	423	75365	251	2139	0	78178
12013	472	1633	206	76757	0	79068
12014	471	553	76039	2021	0	79084
12015	527	363	1775	76654	0	79319
12016	489	309	417	78701	0	79916
12017	543	308	249	82681	0	83781
12018	523	386	203	84224	0	85336
12019	610	369	81054	2672	0	84705
12020	496	81337	1948	1121	0	84902
12021	566	2026	537	81348	0	84477
12022	494	617	354	85304	0	86769
12023	551	394	298	81342	0	82585
12024	452	81281	372	2803	0	84908
12025	473	85716	311	1230	0	87730
12026	83135	2463	266	912	0	86776
12027	2338	744	198	81431	0	84711
12028	910	494	81087	2494	0	84985
12029	525	80709	1964	1199	0	84397
12030	78443	2076	758	743	0	82020
12031	2312	681	78154	652	0	81799
12032	883	440	78030	665	0	80018
12033	553	343	77119	607	0	78622
12034	446	838	2385	73215	0	76884
12035	515	321	74963	2157	0	77956
12036	302	71558	2071	981	0	74912
12037	264	1655	729	68563	0	71211
12038	339	529	70371	1865	0	73104
12039	279	388	1813	68144	0	70624
12040	67872	301	691	2097	0	70961
12041	1737	300	68347	946	0	71330
12042	65007	286	1828	731	0	67852
12043	1823	70233	656	695	0	73407
12044	70048	1719	483	608	0	72858
12045	1942	625	415	69742	0	72724
12046	70397	404	396	2020	0	73217
12047	70709	335	439	887	0	72370
12048	68609	376	393	726	0	70104
12049	2171	70660	426	720	0	73977
12050	70551	1685	424	680	0	73340
12051	71095	584	481	645	0	72805
12052	2350	423	69988	573	0	73334
12053	964	69924	1800	668	0	73356
12054	716	1802	719	69407	0	72644
12055	597	707	510	70982	0	72796
12056	597	477	393	71812	0	73279
12057	574	412	70022	2489	0	73497
12058	575	360	1832	69213	0	71980
12059	537	393	70616	2305	0	73851
12060	68701	373	2000	1149	0	72223
12061	71710	385	756	956	0	73807
12062	2320	383	71255	830	0	74788
12063	69563	400	1899	780	0	72642
12064	72546	386	790	802	0	74524
12065	73014	344	629	742	0	74729
12066	2495	376	531	70944	0	74346
12067	1132	393	72094	2114	0	75733
12068	775	72466	1893	1109	0	76243
12069	774	1843	748	71824	0	75189
12070	786	723	73438	2092	0	77039
12071	662	506	71527	1069	0	73764
12072	66783	481	2104	901	0	70269
12073	1776	72919	956	911	0	76562
12074	73646	1708	583	926	0	76863
12075	73976	661	581	851	0	76069
12076	2023	74461	687	828	0	77999
12077	73784	1635	683	772	0	76874
12078	2086	709	75793	717	0	79305
12079	1165	471	74949	691	0	77276
12080	974	381	74767	622	0	76744
12081	722	72115	2118	628	0	75583
12082	69714	1493	1113	481	0	72801
12083	69471	553	727	534	0	71285
12084	1918	67822	719	500	0	70959
12085	931	70512	642	575	0	72660
12086	733	1661	594	69005	0	71993
12087	643	798	551	70405	0	72397
12088	69949	532	488	1808	0	72777
12089	1615	70642	558	862	0	73677
12090	68748	1485	532	649	0	71414
12091	66948	593	528	571	0	68640
12092	1869	532	67266	521	0	70188
12093	1015	66221	1388	484	0	69108
12094	1060	1467	697	65152	0	68376
12095	64384	625	537	1160	0	66706
12096	1833	431	472	62856	0	65592
12097	59718	295	519	1075	0	61607
12098	1381	316	58597	502	0	60796
12099	777	57202	1171	439	0	59589
12100	649	58861	560	434	0	60504
12101	747	1477	581	53686	0	56491
12102	577	58820	432	819	0	60648
12103	58294	1084	496	521	0	60395
12104	1114	607	56971	364	0	59056
12105	52980	502	885	418	0	54785
12106	1133	390	57824	399	0	59746
12107	712	354	903	56826	0	58795
12108	668	373	438	57976	0	59455
12109	651	309	414	58516	0	59890
12110	57288	269	359	1047	0	58963
12111	1152	247	58420	516	0	60335
12112	672	283	858	57245	0	59058
12113	567	306	426	57127	0	58426
12114	529	56654	350	1106	0	58639
12115	522	56681	276	596	0	58075
12116	539	58025	331	418	0	59313
12117	443	959	260	53292	0	54954
12118	326	478	173	51358	0	52335
12119	172	50234	116	430	0	50952
12120	136	50531	134	232	0	51033
12121	49447	259	203	201	0	50110
12122	301	209	84	49166	0	49760
12123	100	49013	56	202	0	49371
12124	49852	150	55	105	0	50162
12125	217	76	68	50398	0	50759
12126	55670	46	49	211	0	55976
12127	404	50	64	56599	0	57117
12128	178	84	57547	382	0	58191
12129	81	58247	335	218	0	58881
12130	55775	351	93	150	0	56369
12131	420	120	57974	79	0	58593
12132	91	58261	342	147	0	58841
12133	162	327	63	59095	0	59647
12134	68	73	74	59425	0	59640
12135	56	37	26	58535	0	58654
12136	55	32	24	58565	0	58676
12137	77	48	58184	381	0	58690
12138	34	57766	292	184	0	58276
12139	49	316	53	57810	0	58228
12140	54879	82	44	329	0	55334
12141	262	57835	44	294	0	58435
12142	77	293	47	60901	0	61318
12143	130	94	60401	435	0	61060
12144	44	61320	453	252	0	62069
12145	281	541	141	53182	0	54145
12146	37	62361	58	320	0	62776
12147	62977	502	35	125	0	63639
12148	62901	123	18	105	0	63147
12149	681	88	61203	38	0	62010
12150	58433	36	502	137	0	59108
12151	61642	46	127	118	0	61933
12152	687	92	60062	59	0	60900
12153	173	60417	521	135	0	61246
12154	112	511	118	61220	0	61961
12155	67	143	61	62183	0	62454
12156	61799	60	57	666	0	62582
12157	559	52	57	61019	0	61687
12158	188	63	62179	574	0	63004
12159	57451	44	589	214	0	58298
12160	697	74	60394	111	0	61276
12161	151	60642	611	206	0	61610
12162	58404	580	154	120	0	59258
12163	629	184	60141	69	0	61023
12164	235	103	58082	104	0	58524
12165	112	59283	649	181	0	60225
12166	71	637	175	60022	0	60905
12167	135	192	58759	621	0	59707
12168	93	89	620	52487	0	53289
12169	67	71	169	58592	0	58899
12170	112	86	56999	725	0	57922
12171	69	56495	622	295	0	57481
12172	79	587	179	57395	0	58240
12173	56089	148	100	629	0	56966
12174	55227	99	85	206	0	55617
12175	691	86	64	55247	0	56088
12176	226	91	54563	668	0	55548
12177	185	123	56195	200	0	56703
12178	109	68	730	54972	0	55879
12179	120	112	54538	683	0	55453
12180	51774	79	678	256	0	52787
12181	722	71	180	55378	0	56351
12182	242	54	126	56168	0	56590
12183	128	56336	150	878	0	57492
12184	128	729	92	57713	0	58662
12185	144	221	55513	749	0	56627
12186	51143	129	716	302	0	52290
12187	55464	82	187	211	0	55944
12188	862	108	56195	159	0	57324
12189	293	94	730	59983	0	61100
12190	165	69	221	62984	0	63439
12191	162	98	62619	1177	0	64056
12192	169	119	966	62810	0	64064
12193	151	81	285	64389	0	64906
12194	129	65864	199	1244	0	67436
12195	185	1064	133	67668	0	69050
12196	172	286	121	69550	0	70129
12197	69784	132	178	1464	0	71558
12198	72366	159	165	462	0	73152
12199	73599	103	135	301	0	74138
12200	72977	103	169	227	0	73476
12201	72396	110	186	243	0	72935
12202	1643	128	69882	261	0	71914
12203	520	102	1290	68883	0	70795
12204	293	99	387	71552	0	72331
12205	241	127	70227	1610	0	72205
12206	66292	108	1305	564	0	68269
12207	69786	100	408	309	0	70603
12208	1636	152	67616	235	0	69639
12209	68138	81	1261	353	0	69833
12210	70606	104	420	255	0	71385
12211	1712	136	69457	240	0	71545
12212	612	170	1399	65813	0	67994
12213	344	72247	473	1386	0	74450
12214	320	1295	268	74435	0	76318
12215	283	341	217	75514	0	76355
12216	290	169	209	75134	0	75802
12217	291	143	73253	1748	0	75435
12218	69489	90	1461	635	0	71675
12219	73693	108	481	335	0	74617
12220	1761	106	265	72565	0	74697
12221	609	124	71335	1553	0	73621
12222	321	188	1480	70351	0	72340
12223	279	116	72883	1652	0	74930
12224	313	88	73551	626	0	74578
12225	247	72942	1734	441	0	75364
12226	458	1208	541	67628	0	69835
12227	67688	286	279	1311	0	69564
12228	66137	127	176	477	0	66917
12229	67376	86	213	319	0	67994
12230	1595	75	199	65404	0	67273
12231	509	69781	171	1377	0	71838
12232	329	1305	166	71200	0	73000
12233	260	339	74378	1573	0	76550
12234	78132	148	1484	598	0	80362
12235	85124	88	423	423	0	86058
12236	2091	99	265	84903	0	87358
12237	685	105	187	86352	0	87329
12238	437	85	179	87272	0	87973
12239	330	92	84490	2385	0	87297
12240	72618	117	1902	927	0	75564
12241	1884	82332	559	621	0	85396
12242	474	80286	315	412	0	81487
12243	437	1630	79725	296	0	82088
12244	312	506	1687	77568	0	80073
12245	270	193	79742	1791	0	81996
12246	74431	162	1729	550	0	76872
12247	1770	125	395	77494	0	79784
12248	565	115	77105	1664	0	79449
12249	378	79005	1534	837	0	81754
12250	77703	1480	469	423	0	80075
12251	1834	355	81087	353	0	83629
12252	558	79562	1660	434	0	82214
12253	405	82477	443	396	0	83721
12254	81809	1739	342	341	0	84231
12255	1727	442	231	82049	0	84449
12256	594	245	84534	1810	0	87183
12257	370	84438	1693	751	0	87252
12258	84337	1589	517	408	0	86851
12259	84818	374	289	369	0	85850
12260	1922	83890	321	431	0	86564
12261	719	1641	85473	334	0	88167
12262	441	422	1742	85461	0	88066
12263	86160	252	550	1836	0	88798
12264	87010	170	415	610	0	88205
12265	2162	191	85777	449	0	88579
12266	758	195	1749	82948	0	85650
12267	507	176	545	87001	0	88229
12268	436	193	86909	2067	0	89605
12269	453	229	86044	650	0	87376
12270	86042	215	2041	489	0	88787
12271	89334	209	670	385	0	90598
12272	89671	233	411	412	0	90727
12273	89957	228	453	389	0	91027
12274	2239	217	87307	415	0	90178
12275	86734	201	1862	423	0	89220
12276	2132	176	607	86607	0	89522
12277	787	236	88029	1845	0	90897
12278	611	254	88379	712	0	89956
12279	489	87454	2025	715	0	90683
12280	478	1631	700	85484	0	88293
12281	501	513	87074	1742	0	89830
12282	82911	353	1813	676	0	85753
12283	2001	371	659	73180	0	76211
12284	670	86515	569	1439	0	89193
12285	87230	1620	486	617	0	89953
12286	88115	435	489	556	0	89595
12287	2214	312	87219	445	0	90190
12288	891	85550	1836	577	0	88854
12289	629	1388	640	81433	0	84090
12290	80687	455	458	1561	0	83161
12291	1761	370	406	79917	0	82454
12292	722	277	78048	1510	0	80557
12293	69350	314	1489	547	0	71700
12294	1466	75822	591	450	0	78329
12295	531	72986	419	402	0	74338
12296	442	75345	404	407	0	76598
12297	72986	1405	1113	400	0	75904
12298	71864	379	500	313	0	73056
12299	72401	276	381	263	0	73321
12300	1507	226	304	70749	0	72786
12301	648	241	72072	1202	0	74163
12302	491	220	1245	72035	0	73991
12303	72967	254	428	1232	0	74881
12304	1383	282	342	72879	0	74886
12305	74808	219	317	1300	0	76644
12306	75295	251	373	438	0	76357
12307	74062	247	377	372	0	75058
12308	1374	73766	371	460	0	75971
12309	73510	1111	366	316	0	75303
12310	1430	342	72770	246	0	74788
12311	644	295	72327	241	0	73507
12312	536	70730	1274	278	0	72818
12313	765	1032	653	66982	0	69432
12314	67159	285	297	990	0	68731
12315	1273	192	66699	318	0	68482
12316	63165	163	1122	291	0	64741
12317	1244	153	401	64771	0	66569
12318	447	66836	379	1041	0	68703
12319	356	957	348	67556	0	69217
12320	369	296	67485	1086	0	69236
12321	62180	213	1137	445	0	63975
12322	1254	179	68041	314	0	69788
12323	582	162	65590	230	0	66564
12324	62075	161	1076	204	0	63516
12325	1144	63312	391	259	0	65106
12326	64870	905	273	204	0	66252
12327	65374	247	268	218	0	66107
12328	1285	226	63819	201	0	65531
12329	61521	162	1141	222	0	63046
12330	1091	170	62810	305	0	64376
12331	426	139	59084	202	0	59851
12332	456	154	59104	251	0	59965
12333	239	54489	935	267	0	55930
12334	47104	857	1471	204	0	49636
12335	45700	192	220	160	0	46272
12336	45385	54	67	108	0	45614
12337	45325	26	88	114	0	45553
12338	476	59	45010	56	0	45601
12339	184	40	340	44232	0	44796
12340	138	53	124	45753	0	46068
12341	45228	51	84	424	0	45787
12342	392	45012	85	188	0	45677
12343	149	344	83	44603	0	45179
12344	44261	96	79	346	0	44782
12345	393	79	44825	99	0	45396
12346	157	74	335	43716	0	44282
12347	148	79	45431	357	0	46015
12348	106	44866	386	191	0	45549
12349	215	506	185	42147	0	43053
12350	41842	130	82	338	0	42392
12351	367	58	85	42105	0	42615
12352	202	56	42376	351	0	42985
12353	93	41991	343	207	0	42634
12354	41212	296	118	111	0	41737
12355	379	95	41158	59	0	41691
12356	38046	56	345	71	0	38518
12357	369	40149	117	110	0	40745
12358	40336	338	111	70	0	40855
12359	40787	96	50	103	0	41036
12360	475	53	50	40949	0	41527
12361	195	52	40788	412	0	41447
12362	95	41055	402	183	0	41735
12363	98	386	162	42931	0	43577
12364	81	115	76	44087	0	44359
12365	81	56	64	46905	0	47106
12366	107	59	52	48833	0	49051
12367	84	55361	61	816	0	56322
12368	57609	696	44	219	0	58568
12369	824	57694	74	188	0	58780
12370	254	894	75	60020	0	61243
12371	60787	224	75	888	0	61974
12372	933	101	64	61107	0	62205
12373	313	98	60858	993	0	62262
12374	160	60776	909	384	0	62229
12375	159	902	230	60511	0	61802
12376	163	270	103	61991	0	62527
12377	59119	124	75	1124	0	60442
12378	995	92	58843	349	0	60279
12379	57506	81	931	219	0	58737
12380	58680	79	309	170	0	59238
12381	58620	106	137	148	0	59011
12382	1240	141	57829	171	0	59381
12383	431	113	934	56450	0	57928
12384	242	145	266	57386	0	58039
12385	214	107	57800	1252	0	59373
12386	197	138	58651	413	0	59399
12387	58344	121	1191	254	0	59910
12388	1086	114	388	59599	0	61187
12389	60539	92	173	1147	0	61951
12390	62065	116	167	406	0	62754
12391	1370	85	131	61361	0	62947
12392	529	118	64619	1184	0	66450
12393	61217	140	1199	522	0	63078
12394	1294	131	393	65515	0	67333
12395	566	132	65759	1286	0	67743
12396	363	65017	1184	654	0	67218
12397	64506	1144	422	317	0	66389
12398	1282	65666	260	343	0	67551
12399	661	1335	212	56753	0	58961
12400	380	66021	230	1141	0	67772
12401	64395	1233	258	506	0	66392
12402	64639	374	229	391	0	65633
12403	1524	64407	235	481	0	66647
12404	64186	1158	255	357	0	65956
12405	63279	410	243	355	0	64287
12406	1607	62488	220	404	0	64719
12407	62870	1179	229	385	0	64663
12408	1496	394	209	62106	0	64205
12409	709	245	243	63348	0	64545
12410	62858	168	255	1520	0	64801
12411	1543	173	249	57933	0	59898
12412	695	61518	246	1315	0	63774
12413	61611	1220	243	503	0	63577
12414	61204	433	257	393	0	62287
12415	1548	61566	261	450	0	63825
12416	61870	1232	238	367	0	63707
12417	62508	469	286	331	0	63594
12418	1787	278	238	60785	0	63088
12419	901	280	60884	1384	0	63449
12420	618	60641	1236	721	0	63216
12421	61389	1251	453	411	0	63504
12422	62013	477	240	426	0	63156
12423	1905	324	60237	415	0	62881
12424	60372	263	1231	410	0	62276
12425	1676	308	59476	410	0	61870
12426	58976	305	1296	373	0	60950
12427	1622	408	456	59141	0	61627
12428	810	334	59170	1438	0	61752
12429	696	389	59782	609	0	61476
12430	661	506	1442	57722	0	60331
12431	583	375	528	58111	0	59597
12432	669	377	56987	1519	0	59552
12433	747	319	1190	56305	0	58561
12434	749	411	57531	1359	0	60050
12435	721	366	1279	56730	0	59096
12436	814	327	507	55637	0	57285
12437	722	56202	396	1545	0	58865
12438	733	56375	386	766	0	58260
12439	676	58254	354	672	0	59956
12440	730	1519	295	56996	0	59540
12441	749	561	340	58347	0	59997
12442	687	354	57019	1723	0	59783
12443	54385	340	1321	815	0	56861
12444	57680	289	587	594	0	59150
12445	1927	56367	405	572	0	59271
12446	56748	1230	367	473	0	58818
12447	1735	519	383	55872	0	58509
12448	56978	350	441	1438	0	59207
12449	57649	319	393	728	0	59089
12450	1970	336	367	56314	0	58987
12451	54221	395	446	1419	0	56481
12452	1514	53883	407	802	0	56606
12453	886	55170	398	544	0	56998
12454	760	1504	412	51602	0	54278
12455	727	54934	377	1317	0	57355
12456	756	1284	336	52859	0	55235
12457	796	578	309	54316	0	55999
12458	53313	368	315	1454	0	55450
12459	1481	52628	356	817	0	55282
12460	51615	1117	347	540	0	53619
12461	50468	478	362	510	0	51818
12462	1537	50976	358	575	0	53446
12463	49519	1061	305	536	0	51421
12464	1414	474	48470	500	0	50858
12465	631	45639	959	554	0	47783
12466	42323	856	465	545	0	44189
12467	948	322	38108	318	0	39696
12468	367	33900	588	280	0	35135
12469	399	34965	436	276	0	36076
12470	31715	537	521	211	0	32984
12471	31404	255	116	163	0	31938
12472	31199	154	108	177	0	31638
12473	625	31366	137	174	0	32302
12474	330	457	93	31696	0	32576
12475	31762	196	126	492	0	32576
12476	31754	136	148	275	0	32313
12477	609	150	116	31166	0	32041
12478	337	140	31992	485	0	32954
12479	244	167	31994	237	0	32642
12480	232	130	528	31663	0	32553
12481	238	104	239	32701	0	33282
12482	243	117	32947	582	0	33889
12483	242	102	457	30938	0	31739
12484	206	32759	236	526	0	33727
12485	31958	377	163	260	0	32758
12486	573	230	143	31028	0	31974
12487	29871	90	124	431	0	30516
12488	404	30515	128	288	0	31335
12489	226	31062	116	232	0	31636
12490	30101	337	98	202	0	30738
12491	361	145	29440	168	0	30114
12492	24604	197	226	109	0	25136
12493	243	26317	149	108	0	26817
12494	116	126	69	24323	0	24634
12495	24327	63	25	167	0	24582
12496	147	52	42	24059	0	24300
12497	25144	35	45	226	0	25450
12498	24651	24	44	115	0	24834
12499	173	25888	39	89	0	26189
12500	25396	92	19	58	0	25565
12501	105	25141	29	71	0	25346
12502	25247	102	53	34	0	25436
12503	141	74	16	25332	0	25563
12504	26010	40	7	124	0	26181
12505	125	30	17	26568	0	26740
12506	28029	35	20	195	0	28279
12507	28656	36	12	114	0	28818
12508	28796	33	11	57	0	28897
12509	28879	21	12	59	0	28971
12510	28944	19	21	37	0	29021
12511	160	30	18	29010	0	29218
12512	28746	26	16	113	0	28901
12513	107	28282	27	104	0	28520
12514	79	98	28482	45	0	28704
12515	48	72	82	27420	0	27622
12516	73	40	29196	107	0	29416
12517	43	32	88	28988	0	29151
12518	56	37	30189	129	0	30411
12519	28565	20	128	78	0	28791
12520	167	25	43	30125	0	30360
12521	83	40	30253	127	0	30503
12522	62	37	30965	66	0	31130
12523	56	100	151	31182	0	31489
12524	34613	29	75	241	0	34958
12525	176	36394	39	115	0	36724
12526	36626	183	17	78	0	36904
12527	36403	79	22	50	0	36554
12528	242	36759	28	91	0	37120
12529	38823	191	12	153	0	39179
12530	221	78	20	39350	0	39669
12531	100	40	27	39465	0	39632
12532	62	27	24	39820	0	39933
12533	39674	22	19	260	0	39975
12534	203	40152	24	134	0	40513
12535	118	234	16	40526	0	40894
12536	75	121	28	40809	0	41033
12537	40514	36	37	366	0	40953
12538	267	30	19	40302	0	40618
12539	142	41	40716	304	0	41203
12540	66	42273	276	167	0	42782
12541	42318	342	105	81	0	42846
12542	394	141	51	41399	0	41985
12543	157	43637	32	364	0	44190
12544	43225	348	47	123	0	43743
12545	437	134	43164	72	0	43807
12546	131	43283	358	82	0	43854
12547	43782	367	112	61	0	44322
12548	364	136	63	43033	0	43596
12549	131	57	45	43364	0	43597
12550	102	46	43215	483	0	43846
12551	74	45	353	41513	0	41985
12552	103	53	46415	414	0	46985
12553	110	60	44414	158	0	44742
12554	101	66	46404	86	0	46657
12555	44758	28	526	109	0	45421
12556	46067	34	164	103	0	46368
12557	47910	44	65	78	0	48097
12558	498	42	50	47039	0	47629
12559	186	47974	49	372	0	48581
12560	106	48961	47	153	0	49267
12561	49389	431	27	145	0	49992
12562	49520	180	73	117	0	49890
12563	444	50151	38	107	0	50740
12564	49377	333	79	74	0	49863
12565	415	137	49022	87	0	49661
12566	187	81	48643	55	0	48966
12567	97	45	430	44347	0	44919
12568	66	38	140	49058	0	49302
12569	109	47	49111	428	0	49695
12570	72	31	352	47073	0	47528
12571	48515	20	138	416	0	49089
12572	383	39	48502	151	0	49075
12573	45750	41	369	96	0	46256
12574	428	35	135	48431	0	49029
12575	218	58	50227	378	0	50881
12576	98	50820	380	182	0	51480
12577	51195	344	132	107	0	51778
12578	413	140	49855	108	0	50516
12579	48205	71	410	61	0	48747
12580	429	49	135	49628	0	50241
12581	49640	43	84	414	0	50181
12582	446	80	53049	151	0	53726
12583	185	67	384	53169	0	53805
12584	55854	32	142	492	0	56520
12585	57117	41	106	261	0	57525
12586	59053	46	74	156	0	59329
12587	59476	36	71	111	0	59694
12588	599	46	94	57596	0	58335
12589	228	49	72	57700	0	58049
12590	198	56	58650	602	0	59506
12591	129	51	467	57678	0	58325
12592	139	51	154	58264	0	58608
12593	103	60284	125	613	0	61125
12594	60654	538	75	217	0	61484
12595	61761	160	69	160	0	62150
12596	703	64830	83	152	0	65768
12597	253	704	81	63632	0	64670
12598	165	189	63	64859	0	65276
12599	62489	84	67	927	0	63567
12600	834	86	66256	299	0	67475
12601	282	55	745	66646	0	67728
12602	192	65	67993	831	0	69081
12603	64076	56	800	331	0	65263
12604	67754	55	240	188	0	68237
12605	68105	46	129	169	0	68449
12606	1028	54	100	65888	0	67070
12607	350	68	84	66186	0	66688
12608	66012	51	91	984	0	67138
12609	898	78	65528	303	0	66807
12610	285	66	756	65304	0	66411
12611	65861	69	227	864	0	67021
12612	839	60	146	66087	0	67132
12613	360	94	70574	868	0	71896
12614	259	96	69037	293	0	69685
12615	65465	77	934	243	0	66719
12616	822	70344	275	247	0	71688
12617	71978	710	134	283	0	73105
12618	72751	174	102	244	0	73271
12619	953	127	124	72836	0	74040
12620	350	109	115	72623	0	73197
12621	200	72914	135	955	0	74204
12622	72329	693	103	358	0	73483
12623	820	74047	118	245	0	75230
12624	281	73746	99	216	0	74342
12625	214	788	103	71590	0	72695
12626	71458	182	87	764	0	72491
12627	72829	110	67	312	0	73318
12628	910	63	72	71793	0	72838
12629	311	56	65	70331	0	70763
12630	225	70	88	70269	0	70652
12631	68899	55	99	950	0	70003
12632	840	74	69704	329	0	70947
12633	280	69537	712	260	0	70789
12634	69325	594	202	231	0	70352
12635	758	218	128	68899	0	70003
12636	341	97	69662	728	0	70828
12637	299	97	69446	293	0	70135
12638	218	70074	767	265	0	71324
12639	198	71591	215	254	0	72258
12640	317	653	199	69361	0	70530
12641	148	68252	114	623	0	69137
12642	203	539	106	69671	0	70519
12643	168	166	94	70311	0	70739
12644	69780	98	73	751	0	70702
12645	621	108	89	69954	0	70772
12646	290	78	71	70587	0	71026
12647	269	130	69986	695	0	71080
12648	220	92	552	70401	0	71265
12649	71020	89	159	788	0	72056
12650	71287	94	101	313	0	71795
12651	743	74886	106	310	0	76045
12652	72393	631	123	272	0	73419
12653	891	210	72067	262	0	73430
12654	298	73076	677	270	0	74321
12655	251	722	188	74038	0	75199
12656	232	191	133	74885	0	75441
12657	258	145	128	74273	0	74804
12658	74668	113	161	930	0	75872
12659	68855	125	195	382	0	69557
12660	927	154	73124	272	0	74477
12661	363	154	72430	258	0	73205
12662	407	185	72803	278	0	73673
12663	267	73720	803	339	0	75129
12664	246	74848	221	329	0	75644
12665	74804	789	145	296	0	76034
12666	73825	197	138	349	0	74509
12667	918	137	136	75669	0	76860
12668	315	143	169	74271	0	74898
12669	260	76346	122	1049	0	77777
12670	273	735	132	77712	0	78852
12671	327	236	76739	949	0	78251
12672	227	77140	813	549	0	78729
12673	277	763	220	77902	0	79162
12674	316	253	79749	900	0	81218
12675	315	270	778	72252	0	73615
12676	258	77598	215	849	0	78920
12677	80225	814	169	403	0	81611
12678	80096	250	127	343	0	80816
12679	82074	183	132	356	0	82745
12680	1069	209	131	82441	0	83850
12681	371	199	130	83331	0	84031
12682	82726	199	158	1131	0	84214
12683	1087	82066	147	498	0	83798
12684	83085	930	175	396	0	84586
12685	1161	310	85751	279	0	87501
12686	86299	146	1142	273	0	87860
12687	88739	158	362	327	0	89586
12688	1507	182	160	86718	0	88567
12689	90187	152	158	1332	0	91829
12690	90355	199	182	523	0	91259
12691	1629	184	205	91304	0	93322
12692	532	194	90728	1370	0	92824
12693	82708	186	1278	553	0	84725
12694	1337	202	90471	335	0	92345
12695	412	92494	1225	404	0	94535
12696	391	1071	458	92628	0	94548
12697	224	287	201	94947	0	95659
12698	100465	186	166	1421	0	102238
12699	1415	177	101540	468	0	103600
12700	400	285	1343	92176	0	94204
12701	235	100397	397	1338	0	102367
12702	206	98006	248	524	0	98984
12703	263	1638	194	100391	0	102486
12704	371	404	99524	1472	0	101771
12705	285	241	1392	99649	0	101567
12706	253	257	406	98720	0	99636
12707	307	285	95812	1690	0	98094
12708	251	100477	1296	713	0	102737
12709	94328	1464	364	406	0	96562
12710	1413	100700	232	500	0	102845
12711	535	1499	221	98164	0	100419
12712	93580	420	220	1542	0	95762
12713	1412	94374	308	655	0	96749
12714	588	1397	95571	377	0	97933
12715	90358	452	1488	434	0	92732
12716	1475	96740	523	368	0	99106
12717	96709	1447	282	354	0	98792
12718	1735	487	94847	374	0	97443
12719	91850	274	1488	417	0	94029
12720	1687	309	410	92438	0	94844
12721	719	316	94853	1618	0	97506
12722	523	311	1414	89975	0	92223
12723	440	91444	530	1672	0	94086
12724	538	1439	308	93739	0	96024
12725	463	461	321	93736	0	94981
12726	582	323	91893	1837	0	94635
12727	512	382	1461	91363	0	93718
12728	611	487	79386	1770	0	82254
12729	569	92222	1294	924	0	95009
12730	560	1576	462	91831	0	94429
12731	788	572	93464	1703	0	96527
12732	624	92972	1568	862	0	96026
12733	670	95530	552	811	0	97563
12734	800	1801	93932	604	0	97137
12735	814	593	93513	689	0	95609
12736	687	364	1838	91934	0	94823
12737	92364	375	615	1910	0	95264
12738	2005	92117	417	977	0	95516
12739	926	1768	408	90518	0	93620
12740	90652	578	385	1909	0	93524
12741	2129	91653	417	909	0	95108
12742	91500	1648	347	729	0	94224
12743	2175	93138	453	828	0	96594
12744	93990	1671	448	731	0	96840
12745	94215	615	436	772	0	96038
12746	94554	505	494	746	0	96299
12747	2601	98961	534	863	0	102959
12748	1332	1953	529	99546	0	103360
12749	1266	705	97821	2353	0	102145
12750	1025	97685	2113	1309	0	102132
12751	1149	1974	833	94588	0	98544
12752	1274	727	721	95434	0	98156
12753	1069	574	92304	2390	0	96337
12754	1069	90094	2071	1235	0	94469
12755	89043	1860	855	862	0	92620
12756	2414	89048	611	986	0	93059
12757	1152	1849	584	89106	0	92691
12758	922	699	88961	2340	0	92922
12759	83155	538	2119	1122	0	86934
12760	2090	650	860	89940	0	93540
12761	786	586	88687	2417	0	92476
12762	81711	675	2175	1124	0	85685
12763	1999	86232	814	1063	0	90108
12764	86470	2025	777	936	0	90208
12765	86815	1001	516	1102	0	89434
12766	2127	660	545	86526	0	89858
12767	886	719	85724	2344	0	89673
12768	663	85217	2013	1170	0	89063
12769	539	2149	84778	870	0	88336
12770	393	1116	1932	82267	0	85708
12771	522	976	798	85865	0	88161
12772	83298	761	675	2471	0	87205
12773	1909	654	83642	1312	0	87517
12774	742	81272	2140	885	0	85039
12775	651	2084	751	80480	0	83966
12776	574	968	499	82537	0	84578
12777	79877	721	569	2081	0	83248
12778	1954	81018	438	930	0	84340
12779	879	1849	373	77763	0	80864
12780	74964	822	377	1907	0	78070
12781	1692	75711	480	878	0	78761
12782	73213	1629	304	436	0	75582
12783	73007	638	460	351	0	74456
12784	1914	71853	451	593	0	74811
12785	64277	1248	243	266	0	66034
12786	1306	65123	294	345	0	67068
12787	64828	1218	238	329	0	66613
12788	64898	314	307	296	0	65815
12789	1368	63630	231	438	0	65667
12790	60588	1069	152	256	0	62065
12791	62030	295	190	276	0	62791
12792	61615	229	175	309	0	62328
12793	1342	235	60134	277	0	61988
12794	408	225	56370	258	0	57261
12795	269	179	56773	212	0	57433
12796	55780	272	1512	247	0	57811
12797	1155	153	55525	242	0	57075
12798	384	118	48406	164	0	49072
12799	326	247	961	43899	0	45433
12800	45248	119	312	811	0	46490
12801	906	138	45695	269	0	47008
12802	353	164	47981	190	0	48688
12803	232	132	995	46082	0	47441
12804	216	121	272	47899	0	48508
12805	211	133	152	48415	0	48911
12806	222	165	47576	1018	0	48981
12807	216	159	828	47056	0	48259
12808	46654	151	255	896	0	47956
12809	908	47316	167	402	0	48793
12810	406	868	97	47709	0	49080
12811	307	327	109	48698	0	49441
12812	277	198	49009	1012	0	50496
12813	217	47776	885	393	0	49271
12814	47472	926	336	194	0	48928
12815	947	48216	198	304	0	49665
12816	393	939	189	48679	0	50200
12817	295	311	48620	961	0	50187
12818	271	175	989	50513	0	51948
12819	224	148	404	52118	0	52894
12820	52518	130	298	1269	0	54215
12821	1148	135	260	50459	0	52002
12822	394	52186	294	1215	0	54089
12823	262	55156	259	445	0	56122
12824	343	1244	54988	278	0	56853
12825	53799	322	1250	255	0	55626
12826	1220	212	404	55655	0	57491
12827	423	138	281	56088	0	56930
12828	382	136	237	56791	0	57546
12829	56681	128	221	1513	0	58543
12830	1232	57645	245	621	0	59743
12831	57294	1143	287	379	0	59103
12832	1352	344	55412	282	0	57390
12833	453	231	55103	277	0	56064
12834	55514	154	1412	339	0	57419
12835	1278	169	569	56748	0	58764
12836	452	163	289	58248	0	59152
12837	297	196	314	58740	0	59547
12838	253	188	57966	1540	0	59947
12839	57000	131	1281	614	0	59026
12840	58736	152	439	419	0	59746
12841	57077	182	334	403	0	57996
12842	1568	309	294	55681	0	57852
12843	556	208	55052	1399	0	57215
12844	422	210	54287	578	0	55497
12845	367	255	56104	483	0	57209
12846	295	53837	1418	464	0	56014
12847	702	960	634	48644	0	50940
12848	48511	269	299	992	0	50071
12849	887	191	48814	420	0	50312
12850	48617	127	900	437	0	50081
12851	974	140	316	49699	0	51129
12852	395	175	227	49073	0	49870
12853	292	48495	250	1160	0	50197
12854	291	49826	266	511	0	50894
12855	261	51255	286	384	0	52186
12856	358	1005	271	50731	0	52365
12857	50692	279	303	1004	0	52278
12858	50943	171	243	548	0	51905
12859	1097	152	50267	460	0	51976
12860	48940	125	964	417	0	50446
12861	1023	103	49983	419	0	51528
12862	477	137	973	49346	0	50933
12863	410	148	49931	1049	0	51538
12864	48934	143	1015	490	0	50582
12865	1033	168	422	50128	0	51751
12866	443	188	52194	939	0	53764
12867	326	172	50482	482	0	51462
12868	48707	147	1136	450	0	50440
12869	51229	150	474	443	0	52296
12870	1018	51979	343	480	0	53820
12871	456	789	299	52625	0	54169
12872	399	281	52651	1025	0	54356
12873	422	221	52150	503	0	53296
12874	391	278	1015	51871	0	53555
12875	52304	217	518	1075	0	54114
12876	905	52303	344	553	0	54105
12877	422	833	286	52856	0	54397
12878	52713	340	255	1063	0	54371
12879	961	241	227	52017	0	53446
12880	476	52761	282	1078	0	54597
12881	415	769	317	53421	0	54922
12882	52730	276	314	969	0	54289
12883	1094	238	300	52901	0	54533
12884	52773	145	322	1086	0	54326
12885	967	53381	371	594	0	55313
12886	53272	769	396	449	0	54886
12887	1025	278	51890	436	0	53629
12888	49697	234	956	433	0	51320
12889	52330	199	453	443	0	53425
12890	1081	52676	377	424	0	54558
12891	534	811	370	51396	0	53111
12892	444	269	51508	838	0	53059
12893	448	178	49857	447	0	50930
12894	46922	457	965	556	0	48900
12895	46515	243	392	393	0	47543
12896	727	47113	279	410	0	48529
12897	387	47816	282	325	0	48810
12898	46868	648	284	274	0	48074
12899	719	46750	272	303	0	48044
12900	368	48107	275	315	0	49065
12901	358	563	234	47367	0	48522
12902	307	174	206	46166	0	46853
12903	304	153	46072	842	0	47371
12904	293	108	595	45719	0	46715
12905	45671	106	298	762	0	46837
12906	775	152	45998	349	0	47274
12907	473	186	46455	285	0	47399
12908	407	144	681	44742	0	45974
12909	382	129	325	47166	0	48002
12910	342	133	291	46918	0	47684
12911	344	126	46435	676	0	47581
12912	265	160	643	44106	0	45174
12913	296	186	320	46099	0	46901
12914	45113	139	242	622	0	46116
12915	534	44861	261	335	0	45991
12916	44355	394	204	218	0	45171
12917	619	150	44514	215	0	45498
12918	38233	102	336	152	0	38823
12919	350	42608	181	207	0	43346
12920	38723	158	73	65	0	39019
12921	154	38729	43	105	0	39031
12922	36402	137	121	89	0	36749
12923	98	35110	35	52	0	35295
12924	72	34803	73	71	0	35019
12925	145	111	113	34590	0	34959
12926	34969	34	61	97	0	35161
12927	34732	20	12	42	0	34806
12928	34900	20	22	49	0	34991
12929	129	29	34858	28	0	35044
12930	54	33	34073	28	0	34188
12931	34	20	97	34606	0	34757
12932	17	35994	35	107	0	36153
12933	25	36569	23	52	0	36669
12934	28	162	15	34686	0	34891
12935	34917	28	23	107	0	35075
12936	34751	28	17	44	0	34840
12937	34909	15	17	45	0	34986
12938	141	29	34547	27	0	34744
12939	46	20	109	34768	0	34943
12940	46	27	35544	131	0	35748
12941	35390	17	124	53	0	35584
12942	36054	9	31	33	0	36127
12943	168	36	35686	34	0	35924
12944	43	20	112	35968	0	36143
12945	35843	20	26	215	0	36104
12946	129	22	24	37327	0	37502
12947	37	19	24	37757	0	37837
12948	39	31	17	41274	0	41361
12949	43377	43	19	332	0	43771
12950	350	25	15	47411	0	47801
12951	47176	26	18	476	0	47696
12952	435	51832	24	143	0	52434
12953	104	466	19	56377	0	56966
12954	63	98	17	56470	0	56648
12955	64	55	23	53911	0	54053
12956	55262	24	28	663	0	55977
12957	596	32	25	54770	0	55423
12958	202	69	24	48771	0	49066
12959	56344	32	28	571	0	56975
12960	56625	27	29	173	0	56854
12961	56184	32	47	96	0	56359
12962	748	39	55367	56	0	56210
12963	216	53	51406	60	0	51735
12964	53977	23	589	71	0	54660
12965	608	29	144	55127	0	55908
12966	198	46	63	49222	0	49529
12967	54786	28	53	673	0	55540
12968	54331	27	39	202	0	54599
12969	51146	38	42	106	0	51332
12970	694	52000	42	119	0	52855
12971	53096	529	42	62	0	53729
12972	50008	114	48	78	0	50248
12973	648	51755	45	92	0	52540
12974	194	50433	44	95	0	50766
12975	187	621	46	45078	0	45932
12976	53303	117	36	488	0	53944
12977	53264	52	42	156	0	53514
12978	52096	46	44	123	0	52309
12979	766	33	40	50996	0	51835
12980	51829	32	55	607	0	52523
12981	719	34	51577	215	0	52545
12982	50154	32	598	148	0	50932
12983	711	52	52320	102	0	53185
12984	243	51	49547	145	0	49986
12985	144	87	629	49809	0	50669
12986	49028	38	183	701	0	49950
12987	630	49	85	49937	0	50701
12988	213	51	51274	710	0	52248
12989	208	65	49700	301	0	50274
12990	170	72	644	49592	0	50478
12991	47154	88	155	728	0	48125
12992	659	49278	104	337	0	50378
12993	302	531	84	50184	0	51101
12994	288	136	73	50424	0	50921
12995	306	61	51556	828	0	52751
12996	318	55	49743	356	0	50472
12997	301	54	699	50569	0	51623
12998	50800	42	221	869	0	51932
12999	894	107	49853	377	0	51231
13000	383	87	589	50345	0	51404
13001	389	72	179	51067	0	51707
13002	347	88	111	50543	0	51089
13003	49925	83	104	1080	0	51192
13004	927	142	41772	628	0	43469
13005	446	49599	489	693	0	51227
13006	526	655	105	50340	0	51626
13007	581	214	49374	1120	0	51289
13008	572	48870	683	760	0	50885
13009	657	50180	248	689	0	51774
13010	49879	789	244	591	0	51503
13011	1227	49893	151	725	0	51996
13012	50427	769	162	808	0	52166
13013	1279	272	49447	915	0	51913
13014	862	207	743	50015	0	51827
13015	49820	139	302	1484	0	51745
13016	1427	50008	236	1136	0	52807
13017	972	763	49710	1026	0	52471
13018	1141	278	778	43641	0	45838
13019	1149	49708	303	1241	0	52401
13020	1099	845	295	50836	0	53075
13021	50580	353	374	1372	0	52679
13022	1611	51065	404	897	0	53977
13023	51810	819	369	768	0	53766
13024	52262	297	321	738	0	53618
13025	1939	248	51371	704	0	54262
13026	1354	53248	1009	639	0	56250
13027	1312	1018	418	55350	0	58098
13028	1363	372	57167	1225	0	60127
13029	1299	335	61331	570	0	63535
13030	1214	495	1500	61572	0	64781
13031	64000	276	676	1349	0	66301
13032	63206	320	424	595	0	64545
13033	2222	351	314	63145	0	66032
13034	1226	384	63199	1610	0	66419
13035	1059	63528	1373	755	0	66715
13036	64704	1353	532	512	0	67101
13037	64549	512	350	465	0	65876
13038	2192	64299	350	496	0	67337
13039	64929	1364	330	419	0	67042
13040	2016	502	63465	467	0	66450
13041	62815	271	1494	446	0	65026
13042	61873	256	772	469	0	63370
13043	1845	236	63218	488	0	65787
13044	900	225	1628	61346	0	64099
13045	821	119	61726	1621	0	64287
13046	672	59538	1649	842	0	62701
13047	532	60571	865	737	0	62705
13048	576	1739	566	54383	0	57264
13049	411	229	53742	1287	0	55669
13050	228	48812	1065	519	0	50624
13051	210	47333	434	314	0	48291
13052	40615	933	376	189	0	42113
13053	40642	157	64	98	0	40961
13054	760	66	52	40688	0	41566
13055	201	68	57	39485	0	39811
13056	84	41103	58	731	0	41976
13057	40164	638	50	168	0	41020
13058	40627	149	52	95	0	40923
13059	739	40728	67	172	0	41706
13060	185	657	47	40706	0	41595
13061	134	178	40435	669	0	41416
13062	98	76	639	40323	0	41136
13063	40652	84	177	720	0	41633
13064	677	68	71	40915	0	41731
13065	242	61	74	41920	0	42297
13066	41569	58	56	852	0	42535
13067	738	62	75	40111	0	40986
13068	200	40530	67	755	0	41552
13069	138	663	64	41480	0	42345
13070	148	153	56	42127	0	42484
13071	110	83	77	40527	0	40797
13072	97	41130	102	839	0	42168
13073	124	706	80	41081	0	41991
13074	147	204	40613	753	0	41717
13075	145	101	709	40257	0	41212
13076	156	130	40325	770	0	41381
13077	129	39899	736	314	0	41078
13078	145	803	231	40609	0	41788
13079	180	193	106	41110	0	41589
13080	175	111	137	41350	0	41773
13081	151	117	139	41060	0	41467
13082	205	125	40109	964	0	41403
13083	182	39821	747	396	0	41146
13084	229	752	229	40448	0	41658
13085	244	272	41048	830	0	42394
13086	218	157	816	40939	0	42130
13087	41182	154	341	888	0	42565
13088	950	152	40236	328	0	41666
13089	39536	135	801	220	0	40692
13090	948	149	269	40644	0	42010
13091	459	154	40757	904	0	42274
13092	299	40122	889	488	0	41798
13093	292	839	302	40116	0	41549
13094	322	316	41207	904	0	42749
13095	253	40553	921	418	0	42145
13096	284	893	312	40655	0	42144
13097	40747	341	203	944	0	42235
13098	41399	230	238	367	0	42234
13099	41919	231	207	267	0	42624
13100	1177	209	41051	301	0	42738
13101	493	41531	939	251	0	43214
13102	327	955	339	41430	0	43051
13103	269	367	222	43809	0	44667
13104	44251	236	229	1122	0	45838
13105	1032	45726	227	432	0	47417
13106	46127	1047	145	331	0	47650
13107	46085	381	195	340	0	47001
13108	46699	292	183	331	0	47505
13109	1273	261	45786	320	0	47640
13110	45430	223	1048	304	0	47005
13111	1180	239	292	46088	0	47799
13112	438	228	183	46559	0	47408
13113	45468	199	189	1371	0	47227
13114	1110	209	135	44571	0	46025
13115	385	44795	141	1272	0	46593
13116	270	1059	130	44103	0	45562
13117	43266	363	102	1244	0	44975
13118	1122	243	42898	574	0	44837
13119	355	42477	969	429	0	44230
13120	249	963	260	42168	0	43640
13121	42012	318	156	1144	0	43630
13122	1022	156	41654	542	0	43374
13123	426	837	984	40428	0	42675
13124	410	209	40806	1190	0	42615
13125	405	147	39796	536	0	40884
13126	280	134	38123	373	0	38910
13127	246	102	36933	334	0	37615
13128	241	140	34704	267	0	35352
13129	27637	632	1293	182	0	29744
13130	461	28282	195	148	0	29086
13131	26852	363	125	93	0	27433
13132	26814	89	55	96	0	27054
13133	457	26746	66	83	0	27352
13134	128	27293	67	95	0	27583
13135	27110	378	87	85	0	27660
13136	27024	104	48	107	0	27283
13137	445	66	49	25658	0	26218
13138	141	26686	62	361	0	27250
13139	26842	340	37	122	0	27341
13140	364	26714	61	120	0	27259
13141	141	372	44	26845	0	27402
13142	27019	83	72	382	0	27556
13143	27169	60	54	162	0	27445
13144	445	67	57	26993	0	27562
13145	170	44	40	27372	0	27626
13146	129	58	26982	431	0	27600
13147	107	42	366	26138	0	26653
13148	120	58	27138	407	0	27723
13149	114	44	380	25882	0	26420
13150	94	51	113	26722	0	26980
13151	26468	43	93	441	0	27045
13152	26217	42	84	161	0	26504
13153	447	43	26080	121	0	26691
13154	25071	54	378	95	0	25598
13155	423	50	137	26008	0	26618
13156	171	66	26623	392	0	27252
13157	149	58	390	26151	0	26748
13158	140	55	134	28129	0	28458
13159	144	76	28307	468	0	28995
13160	142	50	421	28395	0	29008
13161	164	60	29670	484	0	30378
13162	144	74	485	30448	0	31151
13163	32729	59	157	545	0	33490
13164	593	33777	123	290	0	34783
13165	33817	564	80	143	0	34604
13166	629	35116	79	144	0	35968
13167	34227	614	72	111	0	35024
13168	634	34812	79	139	0	35664
13169	33895	608	86	134	0	34723
13170	649	34806	75	159	0	35689
13171	257	639	94	34770	0	35760
13172	214	222	34920	609	0	35965
13173	204	124	34605	227	0	35160
13174	154	115	698	34249	0	35216
13175	34175	86	239	625	0	35125
13176	627	34976	142	345	0	36090
13177	275	574	119	35068	0	36036
13178	226	206	35142	679	0	36253
13179	169	122	35861	290	0	36442
13180	165	170	757	32653	0	33745
13181	124	35771	264	658	0	36817
13182	35286	585	163	264	0	36298
13183	702	220	37050	164	0	38136
13184	302	141	36572	150	0	37165
13185	150	37020	735	160	0	38065
13186	36634	684	373	168	0	37859
13187	36961	194	175	133	0	37463
13188	752	106	132	36313	0	37303
13189	37463	90	138	610	0	38301
13190	36732	72	147	238	0	37189
13191	742	37405	136	174	0	38457
13192	37293	567	165	130	0	38155
13193	718	221	38971	107	0	40017
13194	304	122	603	37849	0	38878
13195	200	114	245	38507	0	39066
13196	38088	96	146	731	0	39061
13197	605	38395	129	406	0	39535
13198	37704	541	112	149	0	38506
13199	616	40196	104	173	0	41089
13200	243	40231	104	173	0	40751
13201	237	625	39525	100	0	40487
13202	220	283	38815	122	0	39440
13203	34937	271	629	134	0	35971
13204	36327	205	253	115	0	36900
13205	540	102	35862	79	0	36583
13206	228	35142	365	104	0	35839
13207	118	36096	165	92	0	36471
13208	35574	443	136	69	0	36222
13209	35428	183	80	66	0	35757
13210	494	106	67	35928	0	36595
13211	36779	71	80	396	0	37326
13212	401	79	87	36431	0	36998
13213	230	72	36805	370	0	37477
13214	148	93	34966	190	0	35397
13215	35107	62	439	152	0	35760
13216	392	97	179	35895	0	36563
13217	219	40083	103	346	0	40751
13218	40874	346	94	193	0	41507
13219	40482	164	102	132	0	40880
13220	526	108	41160	123	0	41917
13221	39983	87	378	105	0	40553
13222	42315	92	194	108	0	42709
13223	538	88	117	41608	0	42351
13224	244	42398	126	401	0	43169
13225	173	44291	117	214	0	44795
13226	175	527	93	44404	0	45199
13227	165	237	83	43585	0	44070
13228	190	150	83	44119	0	44542
13229	212	124	43631	579	0	44546
13230	207	118	42061	244	0	42630
13231	177	140	544	41806	0	42667
13232	229	139	43510	458	0	44336
13233	194	147	42917	206	0	43464
13234	153	109	586	41128	0	41976
13235	291	129	46015	478	0	46913
13236	137	45717	514	298	0	46666
13237	48119	476	249	224	0	49068
13238	536	223	158	47485	0	48402
13239	266	48629	144	498	0	49537
13240	290	492	49938	227	0	50947
13241	166	227	539	47736	0	48668
13242	188	137	52160	537	0	53022
13243	179	87	588	50845	0	51699
13244	179	81	261	53395	0	53916
13245	193	125	55616	758	0	56692
13246	175	134	601	52768	0	53678
13247	157	55352	311	646	0	56466
13248	175	615	155	56686	0	57631
13249	223	273	56836	651	0	57983
13250	157	154	624	54938	0	55873
13251	54674	98	279	719	0	55770
13252	635	56746	179	451	0	58011
13253	315	618	137	57185	0	58255
13254	293	292	59037	638	0	60260
13255	159	58000	635	443	0	59237
13256	155	59174	279	232	0	59840
13257	293	776	57175	167	0	58411
13258	180	324	592	54336	0	55432
13259	209	217	281	55412	0	56119
13260	224	86	55913	791	0	57014
13261	115	54404	547	388	0	55454
13262	103	55101	242	197	0	55643
13263	51949	467	115	104	0	52635
13264	338	52431	75	116	0	52960
13265	52154	358	68	116	0	52696
13266	389	153	56	50279	0	50877
13267	52897	80	66	542	0	53585
13268	388	79	53476	196	0	54139
13269	50524	49	366	142	0	51081
13270	440	139	162	54310	0	55051
13271	175	55427	100	428	0	56130
13272	56029	381	66	220	0	56696
13273	429	314	66	55919	0	56728
13274	175	57992	72	437	0	58676
13275	107	60896	80	239	0	61322
13276	59990	452	61	190	0	60693
13277	61065	175	63	94	0	61397
13278	61484	100	53	116	0	61753
13279	500	61	60	59247	0	59868
13280	177	59639	85	419	0	60320
13281	100	61060	71	269	0	61500
13282	77	470	61	60790	0	61398
13283	59915	185	56	467	0	60623
13284	58268	97	72	231	0	58668
13285	58138	59	79	144	0	58420
13286	566	104	58952	103	0	59725
13287	262	125	57264	106	0	57757
13288	60982	56	508	160	0	61706
13289	399	72	189	61944	0	62604
13290	191	74	86	62634	0	62985
13291	125	71	59	62419	0	62674
13292	85	75	62	62937	0	63159
13293	137	82	61546	585	0	62350
13294	89	73	441	59322	0	59925
13295	130	112	60993	484	0	61719
13296	53669	75	431	317	0	54492
13297	403	61429	213	230	0	62275
13298	225	400	118	63116	0	63859
13299	123	202	102	62097	0	62524
13300	61582	132	88	601	0	62403
13301	60296	112	90	293	0	60791
13302	59805	87	96	203	0	60191
13303	59580	103	127	178	0	59988
13304	649	126	61158	135	0	62068
13305	333	139	59419	148	0	60039
13306	160	99	517	59656	0	60432
13307	61550	79	254	510	0	62393
13308	59814	97	138	320	0	60369
13309	601	147	60896	230	0	61874
13310	263	86	432	58171	0	58952
13311	60086	87	202	509	0	60884
13312	465	87	120	60084	0	60756
13313	293	115	61837	530	0	62775
13314	164	118	431	60106	0	60819
13315	61940	114	225	556	0	62835
13316	467	66739	138	351	0	67695
13317	65577	423	87	245	0	66332
13318	66383	197	90	263	0	66933
13319	65577	117	108	191	0	65993
13320	645	115	83	65915	0	66758
13321	65662	112	93	468	0	66335
13322	472	69098	123	304	0	69997
13323	233	70905	104	250	0	71492
13324	188	874	79	69995	0	71136
13325	70279	320	77	652	0	71328
13326	651	73946	111	390	0	75098
13327	85455	725	75	229	0	86484
13328	88714	322	68	204	0	89308
13329	1628	94855	94	261	0	96838
13330	586	1451	74	95187	0	97298
13331	306	475	71	97660	0	98512
13332	312	213	98399	1890	0	100814
13333	303	122	1471	93510	0	95406
13334	320	158	98407	1694	0	100579
13335	211	95574	1542	778	0	98105
13336	279	1547	495	97193	0	99514
13337	94075	450	231	1663	0	96419
13338	94302	189	170	704	0	95365
13339	1972	207	154	95277	0	97610
13340	663	178	94175	1655	0	96671
13341	82322	131	1524	791	0	84768
13342	1495	91542	522	470	0	94029
13343	523	91777	267	357	0	92924
13344	333	93087	174	353	0	93947
13345	362	1997	265	88766	0	91390
13346	367	580	91233	1462	0	93642
13347	253	314	1381	88604	0	90552
13348	319	221	91807	1548	0	93895
13349	269	229	90495	530	0	91523
13350	268	214	92817	344	0	93643
13351	224	213	1869	84974	0	87280
13352	203	193	590	92127	0	93113
13353	158	177	332	93478	0	94145
13354	171	180	256	92035	0	92642
13355	91653	140	252	1938	0	93983
13356	1352	91239	292	870	0	93753
13357	90706	1367	263	481	0	92817
13358	1478	93155	259	440	0	95332
13359	520	1507	229	92732	0	94988
13360	295	498	201	96780	0	97774
13361	96080	276	165	1964	0	98485
13362	96166	226	136	810	0	97338
13363	97159	231	146	478	0	98014
13364	96683	207	128	433	0	97451
13365	96499	207	112	380	0	97198
13366	1975	96127	153	416	0	98671
13367	93150	1490	120	317	0	95077
13368	1649	93221	151	380	0	95401
13369	91873	1521	172	343	0	93909
13370	1801	511	91884	290	0	94486
13371	758	323	1353	88180	0	90614
13372	518	93560	439	1427	0	95944
13373	480	1451	224	93185	0	95340
13374	561	651	91862	1544	0	94618
13375	420	402	1400	88056	0	90278
13376	86762	291	507	1739	0	89299
13377	1503	88627	335	946	0	91411
13378	584	90384	288	695	0	91951
13379	593	1796	90677	535	0	93601
13380	402	703	1529	86195	0	88829
13381	339	92667	576	1697	0	95279
13382	379	1580	366	93965	0	96290
13383	419	707	93544	1817	0	96487
13384	320	91680	1673	1364	0	95037
13385	483	1608	92047	590	0	94728
13386	565	734	91087	525	0	92911
13387	406	502	1836	88380	0	91124
13388	90928	424	774	1742	0	93868
13389	1703	422	477	91372	0	93974
13390	834	447	92525	1853	0	95659
13391	489	446	1729	91967	0	94631
13392	441	525	97221	1966	0	100153
13393	493	468	95433	928	0	97322
13394	93178	434	2323	773	0	96708
13395	100946	422	934	712	0	103014
13396	100603	399	710	712	0	102424
13397	2209	344	100287	724	0	103564
13398	856	345	101180	693	0	103074
13399	526	296	2264	96973	0	100059
13400	464	321	969	101124	0	102878
13401	99905	291	661	2326	0	103183
13402	1857	293	565	99824	0	102539
13403	887	334	101302	2135	0	104658
13404	632	379	99440	1048	0	101499
13405	549	100266	2111	938	0	103864
13406	570	1781	779	101618	0	104748
13407	731	676	103817	1957	0	107181
13408	567	452	1902	99817	0	102738
13409	102263	358	827	2167	0	105615
13410	1997	397	104974	999	0	108367
13411	925	342	1875	103376	0	106518
13412	693	351	763	106286	0	108093
13413	756	361	103914	2329	0	107360
13414	711	358	1917	99907	0	102893
13415	748	336	103078	2164	0	106326
13416	93325	378	1943	976	0	96622
13417	2064	364	756	95066	0	98250
13418	858	96997	598	1983	0	100436
13419	96907	1735	436	930	0	100008
13420	95383	701	436	649	0	97169
13421	2222	96471	452	829	0	99974
13422	1368	6171	561	83902	0	92002
13423	546	90678	395	1556	0	93175
13424	493	91325	370	803	0	92991
13425	1321	1974	85874	491	0	89660
13426	504	84129	1575	678	0	86886
13427	603	1045	70836	447	0	72931
13428	55630	505	671	179	0	56985
13429	58095	73	203	148	0	58519
13430	423	62134	98	189	0	62844
13431	154	62515	108	148	0	62925
13432	90	63636	97	130	0	63953
13433	64379	456	82	110	0	65027
13434	470	122	114	65556	0	66262
13435	201	89	71308	537	0	72135
13436	75	72054	536	238	0	72903
13437	78	507	143	74055	0	74783
13438	107	184	105	69745	0	70141
13439	73	84813	78	718	0	85682
13440	91642	841	86	223	0	92792
13441	1138	184	93564	146	0	95032
13442	289	185	1117	108709	0	110300
13443	104	129340	267	1808	0	131519
13444	128386	2108	144	354	0	130992
13445	2289	443	127989	223	0	130944
13446	361	125979	2172	319	0	128831
13447	223	2187	383	126397	0	129190
13448	303	409	126666	2166	0	129544
13449	119868	176	2286	434	0	122764
13450	2215	116	409	124293	0	127033
13451	592	158	124917	2244	0	127911
13452	201	124433	2246	764	0	127644
13453	120184	2205	413	255	0	123057
13454	2004	124748	256	332	0	127340
13455	124632	2267	174	183	0	127256
13456	125391	459	168	267	0	126285
13457	2562	257	161	119622	0	122602
13458	532	117336	233	2293	0	120394
13459	439	2118	120249	524	0	123330
13460	198	429	2245	119619	0	122491
13461	256	302	531	114494	0	115583
13462	238	183	260	120898	0	121579
13463	257	161	210	121283	0	121911
13464	237	164	195	121230	0	121826
13465	118899	207	213	2718	0	122037
13466	118233	177	208	676	0	119294
13467	113501	205	251	398	0	114355
13468	2480	111782	309	507	0	115078
13469	726	2138	117016	336	0	120216
13470	449	506	118708	333	0	119996
13471	371	357	119187	284	0	120199
13472	300	285	2775	111683	0	115043
13473	284	272	684	116252	0	117492
13474	317	300	366	116599	0	117582
13475	390	307	115170	2817	0	118684
13476	298	111518	2441	1422	0	115679
13477	424	2313	114693	530	0	117960
13478	422	622	116228	442	0	117714
13479	358	400	2770	111439	0	114967
13480	482	376	114410	2481	0	117749
13481	385	348	2603	110916	0	114252
13482	111655	368	716	2626	0	115365
13483	111970	361	513	736	0	113580
13484	2927	354	110779	541	0	114601
13485	837	446	2508	108373	0	112164
13486	698	424	110960	2617	0	114699
13487	416	110369	2698	1090	0	114573
13488	109783	2560	789	596	0	113728
13489	2732	761	110335	606	0	114434
13490	755	107321	2667	689	0	111432
13491	525	108125	804	669	0	110123
13492	541	105685	637	753	0	107616
13493	658	2838	101433	613	0	105542
13494	671	1135	2594	93090	0	97490
13495	582	99577	889	2429	0	103477
13496	640	2607	666	98602	0	102515
13497	669	842	636	100683	0	102830
13498	96810	616	606	3012	0	101044
13499	2478	97759	764	1358	0	102359
13500	95275	2514	596	871	0	99256
13501	2578	95760	628	982	0	99948
13502	846	98355	627	961	0	100789
13503	1047	2789	95907	835	0	100578
13504	691	1096	2705	94383	0	98875
13505	719	745	95556	2763	0	99783
13506	695	92721	2672	1896	0	97984
13507	809	2472	93677	968	0	97926
13508	967	785	94774	900	0	97426
13509	685	93499	2925	1020	0	98129
13510	89401	2544	1094	882	0	93921
13511	2447	91947	903	1097	0	96394
13512	91449	2652	977	1045	0	96123
13513	2654	844	92163	1062	0	96723
13514	1002	584	93411	996	0	95993
13515	622	91611	3137	1044	0	96414
13516	89513	2500	1101	1010	0	94124
13517	2538	91032	1015	971	0	95556
13518	967	2545	927	91255	0	95694
13519	91535	858	927	2661	0	95981
13520	2615	738	92029	1061	0	96443
13521	871	630	3016	91835	0	96352
13522	90722	652	1196	2721	0	95291
13523	2598	91279	981	1244	0	96102
13524	910	2588	839	91512	0	95849
13525	762	753	91658	2982	0	96155
13526	90039	624	2886	1161	0	94710
13527	2529	628	1137	91353	0	95647
13528	726	647	90586	2802	0	94761
13529	604	541	2914	86504	0	90563
13530	484	89518	1138	3001	0	94141
13531	719	2488	89867	1233	0	94307
13532	826	802	2652	86379	0	90659
13533	83983	598	1036	2653	0	88270
13534	2891	612	773	81779	0	86055
13535	75650	562	739	2341	0	79292
13536	2331	75980	779	939	0	80029
13537	73485	2329	999	623	0	77436
13538	2251	886	72961	612	0	76710
13539	810	585	63135	459	0	64989
13540	501	471	54873	414	0	56259
13541	456	50804	2928	523	0	54711
13542	1522	506	3764	14937	0	20729
13543	68	93	211	14926	0	15298
13544	46	53	60	14884	0	15043
13545	37	49	50	15078	0	15214
13546	43	49	14840	217	0	15149
13547	13171	42	200	107	0	13520
13548	183	14948	69	80	0	15280
13549	14404	173	58	52	0	14687
13550	186	57	39	14630	0	14912
13551	67	15033	46	174	0	15320
13552	66	204	37	15161	0	15468
13553	15015	64	50	176	0	15305
13554	148	15634	46	85	0	15913
13555	15416	190	38	66	0	15710
13556	15318	66	38	50	0	15472
13557	193	51	39	15476	0	15759
13558	69	43	15625	182	0	15919
13559	14872	43	161	75	0	15151
13560	162	44	64	15855	0	16125
13561	16066	40	47	185	0	16338
13562	16572	38	42	65	0	16717
13563	16491	40	35	67	0	16633
13564	219	42	16668	42	0	16971
13565	78	55	178	16115	0	16426
13566	16311	34	65	190	0	16600
13567	194	38	17018	90	0	17340
13568	62	17263	183	61	0	17569
13569	71	367	72	16252	0	16762
13570	53	56	16983	159	0	17251
13571	55	46	16824	99	0	17024
13572	42	70	192	16670	0	16974
13573	72	25	71	17200	0	17368
13574	30	23	51	17264	0	17368
13575	32	27	35	17011	0	17105
13576	59	39	16891	184	0	17173
13577	36	17112	155	87	0	17390
13578	41	144	48	17455	0	17688
13579	17416	38	48	186	0	17688
13580	17054	33	32	78	0	17197
13581	17221	26	24	72	0	17343
13582	187	53	32	17166	0	17438
13583	74	39	53	17029	0	17195
13584	38	16436	28	176	0	16678
13585	33	16733	28	92	0	16886
13586	81	151	23	16190	0	16445
13587	15962	64	31	154	0	16211
13588	15768	30	37	63	0	15898
13589	15550	10	20	56	0	15636
13590	15699	13	20	33	0	15765
13591	15682	21	22	44	0	15769
13592	128	15798	22	52	0	16000
13593	44	95	22	15906	0	16067
13594	16366	31	20	146	0	16563
13595	16264	26	21	67	0	16378
13596	129	13	20	16125	0	16287
13597	56	15	18	16369	0	16458
13598	49	24	16602	131	0	16806
13599	40	14	100	15915	0	16069
13600	44	11	30	16629	0	16714
13601	48	22	16987	138	0	17195
13602	50	20	93	16420	0	16583
13603	38	17123	33	164	0	17358
13604	46	106	16936	63	0	17151
13605	35	17176	105	57	0	17373
13606	37	119	31	16934	0	17121
13607	50	32	23	16923	0	17028
13608	29	16954	30	122	0	17135
13609	33	17092	20	75	0	17220
13610	17184	82	22	76	0	17364
13611	16976	37	19	59	0	17091
13612	112	39	16812	44	0	17007
13613	16936	25	81	87	0	17129
13614	17959	8	37	91	0	18095
13615	17979	10	24	52	0	18065
13616	17739	21	183	57	0	18000
13617	149	29	17344	63	0	17585
13618	80	35	16437	39	0	16591
13619	17477	15	117	42	0	17651
13620	92	18190	46	66	0	18394
13621	53	75	18067	44	0	18239
13622	17973	23	104	51	0	18151
13623	18192	21	31	35	0	18279
13624	111	30	18031	38	0	18210
13625	17568	21	99	38	0	17726
13626	123	16	42	19636	0	19817
13627	52	31	20283	121	0	20487
13628	18289	22	117	70	0	18498
13629	105	20268	38	73	0	20484
13630	20671	87	27	90	0	20875
13631	22471	30	35	177	0	22713
13632	127	27	32	22528	0	22714
13633	61	25	33	22608	0	22727
13634	55	23	23	23039	0	23140
13635	22981	27	19	158	0	23185
13636	23993	15	20	118	0	24146
13637	175	21	23	24130	0	24349
13638	91	16	23	23726	0	23856
13639	66	32	23238	197	0	23533
13640	21832	23	130	139	0	22124
13641	164	25	44	24276	0	24509
13642	69	35	21	24235	0	24360
13643	51	24145	35	261	0	24492
13644	73	159	16	24198	0	24446
13645	62	60	12	24287	0	24421
13646	23575	36	9	236	0	23856
13647	192	24461	16	132	0	24801
13648	100	159	11	24906	0	25176
13649	83	57	11	24893	0	25044
13650	69	37	13	25232	0	25351
13651	74	44	24754	256	0	25128
13652	70	31	168	24377	0	24646
13653	24207	28	65	252	0	24552
13654	220	41	24480	123	0	24864
13655	101	17	196	24787	0	25101
13656	65	20	76	25471	0	25632
13657	25480	16	43	330	0	25869
13658	24857	26	46	138	0	25067
13659	275	44	25269	81	0	25669
13660	23527	34	195	120	0	23876
13661	254	44	25478	70	0	25846
13662	25258	27	204	86	0	25575
13663	264	28454	78	101	0	28897
13664	29008	230	24	98	0	29360
13665	281	29520	30	100	0	29931
13666	30260	270	20	121	0	30671
13667	292	31197	30	98	0	31617
13668	112	274	25	31868	0	32279
13669	57	91	35	32080	0	32263
13670	53	39	26	31923	0	32041
13671	52	31357	32	453	0	31894
13672	61	287	27	31467	0	31842
13673	39	31791	41	369	0	32240
13674	70	301	25	32110	0	32506
13675	32462	91	27	355	0	32935
13676	31865	41	35	146	0	32087
13677	397	32018	35	144	0	32594
13678	130	323	34	32190	0	32677
13679	31749	100	40	355	0	32244
13680	357	32452	47	172	0	33028
13681	124	32943	35	112	0	33214
13682	32865	399	27	79	0	33370
13683	32933	135	28	70	0	33166
13684	432	32911	42	120	0	33505
13685	32979	357	20	84	0	33440
13686	406	137	30	33124	0	33697
13687	188	91	34717	377	0	35373
13688	34437	68	367	204	0	35076
13689	35188	57	110	135	0	35490
13690	527	63	35456	92	0	36138
13691	35195	59	367	181	0	35802
13692	36892	65	115	147	0	37219
13693	37729	55	52	137	0	37973
13694	516	37308	43	135	0	38002
13695	37965	412	30	139	0	38546
13696	38126	161	31	134	0	38452
13697	558	102	32	38047	0	38739
13698	268	83	39	38608	0	38998
13699	137	78	30	39165	0	39410
13700	38889	86	34	601	0	39610
13701	478	84	36	38488	0	39086
13702	38748	87	32	570	0	39437
13703	38959	93	36	281	0	39369
13704	610	93	36	38703	0	39442
13705	273	107	35	39972	0	40387
13706	181	88	50	40431	0	40750
13707	40038	93	36	658	0	40825
13708	545	40128	47	300	0	41020
13709	268	484	37	40795	0	41584
13710	186	213	43	41483	0	41925
13711	41009	119	60	696	0	41884
13712	41081	113	39	323	0	41556
13713	731	144	40128	182	0	41185
13714	345	128	39910	205	0	40588
13715	42421	99	639	196	0	43355
13716	740	127	201	43857	0	44925
13717	330	122	86	51397	0	51935
13718	289	109	51303	1158	0	52859
13719	258	177	883	48361	0	49679
13720	210	51204	249	1012	0	52675
13721	212	52916	136	418	0	53682
13722	51186	1093	79	285	0	52643
13723	1110	357	51134	224	0	52825
13724	399	52784	809	285	0	54277
13725	323	948	216	53253	0	54740
13726	293	319	52907	1044	0	54563
13727	271	193	905	51246	0	52615
13728	297	106	247	52746	0	53396
13729	300	124	52465	1218	0	54107
13730	224	52441	921	544	0	54130
13731	281	939	267	50928	0	52415
13732	51422	293	147	1038	0	52900
13733	51688	175	115	413	0	52391
13734	51552	126	90	273	0	52041
13735	1285	50939	124	301	0	52649
13736	49962	923	109	262	0	51256
13737	1097	319	104	50483	0	52003
13738	451	178	50248	1024	0	51901
13739	48379	144	914	414	0	49851
13740	1008	50293	295	354	0	51950
13741	395	881	147	49815	0	51238
13742	286	274	150	49512	0	50222
13743	248	49715	154	1199	0	51316
13744	288	965	133	50487	0	51873
13745	300	297	142	51269	0	52008
13746	292	223	152	51885	0	52552
13747	50209	203	215	1296	0	51923
13748	49829	177	184	602	0	50792
13749	1241	254	49948	435	0	51878
13750	473	251	975	49535	0	51234
13751	412	233	329	51125	0	52099
13752	310	232	318	51529	0	52389
13753	50299	257	242	1406	0	52204
13754	1104	271	49305	634	0	51314
13755	48208	210	1036	462	0	49916
13756	50201	226	353	479	0	51259
13757	1286	167	281	49361	0	51095
13758	49588	190	327	1192	0	51297
13759	1205	237	49161	630	0	51233
13760	47200	200	968	550	0	48918
13761	1166	52398	395	721	0	54680
13762	607	973	51736	382	0	53698
13763	444	370	51724	430	0	52968
13764	444	593	1122	49994	0	52153
13765	436	232	51158	1155	0	52981
13766	48724	212	1075	622	0	50633
13767	1032	49191	402	545	0	51170
13768	49420	928	262	482	0	51092
13769	1087	429	185	50064	0	51765
13770	538	226	50114	1224	0	52102
13771	393	230	50503	695	0	51821
13772	329	317	1112	50507	0	52265
13773	51123	168	432	1362	0	53085
13774	1000	50480	297	779	0	52556
13775	464	52265	189	686	0	53604
13776	51413	1012	227	583	0	53235
13777	1102	52077	222	525	0	53926
13778	52221	956	269	510	0	53956
13779	1210	370	230	51983	0	53793
13780	51598	195	251	1170	0	53214
13781	1172	174	273	51765	0	53384
13782	52089	179	271	1215	0	53754
13783	1152	165	302	51168	0	52787
13784	599	51179	307	1174	0	53259
13785	51244	832	271	587	0	52934
13786	1036	50965	319	638	0	52958
13787	674	900	48910	365	0	50849
13788	445	381	1003	45437	0	47266
13789	403	49917	457	964	0	51741
13790	48931	919	322	404	0	50576
13791	47934	401	340	339	0	49014
13792	1212	48005	329	429	0	49975
13793	533	909	47509	435	0	49386
13794	410	346	1015	45504	0	47275
13795	363	47444	475	1008	0	49290
13796	342	907	366	47752	0	49367
13797	491	349	324	48398	0	49562
13798	47385	304	241	1223	0	49153
13799	1054	47102	314	581	0	49051
13800	595	889	239	47816	0	49539
13801	47905	432	226	1048	0	49611
13802	48039	274	256	525	0	49094
13803	47631	322	247	443	0	48643
13804	1378	294	243	46735	0	48650
13805	46083	249	230	1021	0	47583
13806	1058	46007	274	592	0	47931
13807	45709	873	211	416	0	47209
13808	1039	46733	176	480	0	48428
13809	46620	893	230	365	0	48108
13810	46522	362	165	412	0	47461
13811	1188	431	244	45294	0	47157
13812	655	225	46833	991	0	48704
13813	501	309	46163	525	0	47498
13814	425	46085	849	427	0	47786
13815	44219	802	471	352	0	45844
13816	877	343	43610	221	0	45051
13817	32118	123	293	131	0	32665
13818	321	34749	145	125	0	35340
13819	196	36458	77	101	0	36832
13820	139	380	46	37315	0	37880
13821	123	39416	57	340	0	39936
13822	155	410	39584	193	0	40342
13823	159	197	400	37846	0	38602
13824	119	41511	142	455	0	42227
13825	126	547	60	41808	0	42541
13826	41548	193	58	582	0	42381
13827	525	145	65	41700	0	42435
13828	282	118	42185	607	0	43192
13829	129	42397	529	257	0	43312
13830	114	601	175	42149	0	43039
13831	143	227	112	42786	0	43268
13832	133	141	70	43519	0	43863
13833	42052	123	83	750	0	43008
13834	42027	81	84	321	0	42513
13835	780	117	42639	192	0	43728
13836	356	140	42046	127	0	42669
13837	138	42339	705	232	0	43414
13838	42971	588	223	169	0	43951
13839	634	229	110	43097	0	44070
13840	245	155	82	43741	0	44223
13841	186	113	59	43892	0	44250
13842	167	107	31	44152	0	44457
13843	217	114	42187	821	0	43339
13844	39495	85	583	379	0	40542
13845	676	98	198	47696	0	48668
13846	355	102	47512	880	0	48849
13847	46838	121	856	369	0	48184
13848	52501	95	341	230	0	53167
13849	1388	126	58740	151	0	60405
13850	693	118	60889	133	0	61833
13851	296	122	1470	59264	0	61152
13852	60774	106	475	1285	0	62640
13853	61677	77	247	462	0	62463
13854	1576	130	169	58953	0	60828
13855	568	110	162	61770	0	62610
13856	351	112	60901	1597	0	62961
13857	214	230	1285	59593	0	61322
13858	281	118	60610	1463	0	62472
13859	56050	135	1331	563	0	58079
13860	1285	60571	466	435	0	62757
13861	57178	1157	231	209	0	58775
13862	1290	57029	150	290	0	58759
13863	56662	1265	246	184	0	58357
13864	1418	385	105	55215	0	57123
13865	496	198	127	56276	0	57097
13866	56395	91	110	1523	0	58119
13867	56795	97	110	533	0	57535
13868	57283	81	108	330	0	57802
13869	57498	89	121	216	0	57924
13870	1819	71	55662	223	0	57775
13871	55114	66	1247	263	0	56690
13872	56814	79	402	226	0	57521
13873	56352	55	209	228	0	56844
13874	1798	74	166	54888	0	56926
13875	52642	68	194	1369	0	54273
13876	1435	53560	200	529	0	55724
13877	589	1191	165	54154	0	56099
13878	443	361	175	55428	0	56407
13879	388	235	53931	1709	0	56263
13880	360	130	1304	51336	0	53130
13881	308	53952	501	1524	0	56285
13882	53198	1250	288	626	0	55362
13883	1369	54013	262	593	0	56237
13884	54162	1365	237	390	0	56154
13885	1674	487	180	54124	0	56465
13886	53365	228	221	1508	0	55322
13887	1619	53058	235	704	0	55616
13888	53777	1297	232	459	0	55765
13889	54417	434	249	378	0	55478
13890	1887	263	250	52937	0	55337
13891	916	173	222	54564	0	55875
13892	704	173	53108	1806	0	55791
13893	583	168	1335	52853	0	54939
13894	528	175	455	54340	0	55498
13895	574	162	52851	1886	0	55473
13896	480	133	1402	52956	0	54971
13897	504	133	52698	1789	0	55124
13898	51476	130	1512	777	0	53895
13899	1663	159	583	52457	0	54862
13900	887	209	51663	1575	0	54334
13901	50727	180	1438	645	0	52990
13902	1760	176	545	52105	0	54586
13903	945	172	52950	1615	0	55682
13904	51978	175	1428	774	0	54355
13905	1806	172	554	53376	0	55908
13906	975	157	328	54317	0	55777
13907	53945	164	259	1989	0	56357
13908	1831	161	285	53055	0	55332
13909	890	159	301	54002	0	55352
13910	740	172	299	51159	0	52370
13911	655	51874	310	1999	0	54838
13912	50782	1334	305	909	0	53330
13913	51524	505	287	684	0	53000
13914	2158	300	276	50281	0	53015
13915	50832	264	245	1752	0	53093
13916	51424	216	272	916	0	52828
13917	51765	189	303	737	0	52994
13918	48852	223	324	638	0	50037
13919	50108	178	418	679	0	51383
13920	2254	214	45832	554	0	48854
13921	1092	220	44123	546	0	45981
13922	42840	188	1529	517	0	45074
13923	1657	43255	629	619	0	46160
13924	829	1044	394	41639	0	43906
13925	672	393	41620	1428	0	44113
13926	645	259	41784	667	0	43355
13927	701	614	1351	41014	0	43680
13928	41474	280	903	1483	0	44140
13929	1485	218	339	41983	0	44025
13930	770	214	42032	1475	0	44491
13931	42866	126	1098	846	0	44936
13932	1455	143	470	44068	0	46136
13933	813	90	302	44823	0	46028
13934	637	123	262	45305	0	46327
13935	639	96	222	44488	0	45445
13936	639	133	43058	1695	0	45525
13937	647	116	1111	43222	0	45096
13938	43385	91	489	1497	0	45462
13939	1449	140	42691	746	0	45026
13940	42009	150	1113	615	0	43887
13941	43879	130	462	526	0	44997
13942	43462	157	313	508	0	44440
13943	42893	127	250	559	0	43829
13944	1625	42125	253	615	0	44618
13945	570	37357	190	355	0	38472
13946	425	38419	180	430	0	39454
13947	35447	1141	749	602	0	37939
13948	908	227	33051	391	0	34577
13949	24324	304	719	212	0	25559
13950	574	53	116	23754	0	24497
13951	23829	30	79	328	0	24266
13952	334	20	56	23877	0	24287
13953	23880	19	62	382	0	24343
13954	356	24	45	23871	0	24296
13955	171	28	53	24755	0	25007
13956	19435	34	94	472	0	20035
13957	346	26924	58	205	0	27533
13958	169	230	26878	139	0	27416
13959	143	26490	266	134	0	27033
13960	130	205	25136	80	0	25551
13961	119	179	208	23215	0	23721
13962	24518	27	132	191	0	24868
13963	177	15	52	24210	0	24454
13964	23711	16	44	210	0	23981
13965	218	26296	45	155	0	26714
13966	209	153	27063	79	0	27504
13967	77	27343	155	94	0	27669
13968	68	27506	57	78	0	27709
13969	26238	127	121	68	0	26554
13970	25533	34	41	55	0	25663
13971	145	26384	34	71	0	26634
13972	63	104	22	26474	0	26663
13973	57	24	23	26557	0	26661
13974	26518	15	31	164	0	26728
13975	156	31	26729	68	0	26984
13976	80	39	25822	53	0	25994
13977	90	22	131	25794	0	26037
13978	67	28	26803	159	0	27057
13979	24185	29	136	90	0	24440
13980	26443	21	46	63	0	26573
13981	166	26582	39	116	0	26903
13982	112	130	27463	57	0	27762
13983	72	74	144	26975	0	27265
13984	88	37	29448	160	0	29733
13985	75	36	140	28721	0	28972
13986	28945	32	45	199	0	29221
13987	167	30492	60	167	0	30886
13988	136	168	31855	71	0	32230
13989	66	32545	171	103	0	32885
13990	61	33651	74	81	0	33867
13991	33270	170	46	107	0	33593
13992	31694	59	40	118	0	31911
13993	261	55	33431	91	0	33838
13994	99	34606	182	153	0	35040
13995	102	201	70	34862	0	35235
13996	71	73	53	34920	0	35117
13997	89	30	54	34707	0	34880
13998	96	55	35443	287	0	35881
13999	89	47	178	34541	0	34855
14000	88	33	80	36221	0	36422
14001	36742	44	46	303	0	37135
14002	36358	50	58	169	0	36635
14003	36374	56	49	156	0	36635
14004	35771	41	58	99	0	35969
14005	35846	45	43	105	0	36039
14006	267	35908	71	115	0	36361
14007	35450	157	44	72	0	35723
14008	249	93	35664	53	0	36059
14009	116	84	151	35224	0	35575
14010	36134	56	75	181	0	36446
14011	185	36302	41	123	0	36651
14012	36781	162	44	86	0	37073
14013	37482	79	46	129	0	37736
14014	211	55	46	37774	0	38086
14015	111	47	58	38126	0	38342
14016	85	40728	57	251	0	41121
14017	96	183	55	41501	0	41835
14018	106	103	42710	227	0	43146
14019	112	42	211	42616	0	42981
14020	95	59	43341	280	0	43775
14021	37600	61	263	197	0	38121
14022	301	52	81	43909	0	44343
14023	150	54	44946	276	0	45426
14024	67	44076	272	213	0	44628
14025	53	45096	101	119	0	45369
14026	44559	280	67	134	0	45040
14027	271	98	57	44351	0	44777
14028	121	62	47067	253	0	47503
14029	37	46220	226	284	0	46767
14030	82	225	46512	58	0	46877
14031	44248	65	213	89	0	44615
14032	45185	22	78	63	0	45348
14033	45879	25	27	46	0	45977
14034	276	21	32	46169	0	46498
14035	128	46	46402	235	0	46811
14036	36	46894	225	171	0	47326
14037	59	205	79	48083	0	48426
14038	70	94	46745	243	0	47152
14039	70	56	45279	107	0	45512
14040	49	26	268	46774	0	47117
14041	47896	26	83	269	0	48274
14042	221	19	52	47896	0	48188
14043	126	32	35	49017	0	49210
14044	78	49	49782	296	0	50205
14045	65	32	233	48786	0	49116
14046	59	33	84	49615	0	49791
14047	79	77	50468	303	0	50927
14048	87	63	49573	121	0	49844
14049	47	42	283	49491	0	49863
14050	116	78	51250	253	0	51697
14051	58	39	254	50481	0	50832
14052	51039	42	130	268	0	51479
14053	232	52799	69	284	0	53384
14054	130	244	58	53797	0	54229
14055	103	121	52828	266	0	53318
14056	42962	62	279	264	0	43567
14057	236	50215	125	138	0	50714
14058	50837	233	56	134	0	51260
14059	259	85	67	50635	0	51046
14060	114	40	78	50722	0	50954
14061	51671	33	88	422	0	52214
14062	282	50	52115	142	0	52589
14063	49865	35	268	139	0	50307
14064	288	50	125	52460	0	52923
14065	50718	41	68	322	0	51149
14066	50302	40	85	193	0	50620
14067	357	48	90	50076	0	50571
14068	131	52227	83	353	0	52794
14069	53877	285	93	179	0	54434
14070	53749	98	78	136	0	54061
14071	483	89	54236	107	0	54915
14072	52482	58	387	121	0	53048
14073	432	63	146	53913	0	54554
14074	161	54935	121	425	0	55642
14075	169	390	70	53229	0	53858
14076	83	54920	118	384	0	55505
14077	54595	389	77	164	0	55225
14078	55010	137	76	145	0	55368
14079	549	74	65	58718	0	59406
14080	236	77	58718	603	0	59634
14081	164	89	57866	232	0	58351
14082	115	58	698	59703	0	60574
14083	60070	49	284	703	0	61106
14084	63307	43	124	258	0	63732
14085	893	64709	127	235	0	65964
14086	350	776	93	65076	0	66295
14087	211	278	66552	879	0	67920
14088	188	135	68688	379	0	69390
14089	171	208	1265	73002	0	74646
14090	79044	67	428	1360	0	80899
14091	1435	67	156	80501	0	82159
14092	453	91	79936	1542	0	82022
14093	78240	55	1510	516	0	80321
14094	1461	68	402	79186	0	81117
14095	457	64	205	80899	0	81625
14096	231	77	152	77864	0	78324
14097	144	78248	152	1826	0	80370
14098	249	1328	79384	549	0	81510
14099	174	353	80633	253	0	81413
14100	177	146	1787	79805	0	81915
14101	218	121	80261	1593	0	82193
14102	77411	76	1619	518	0	79624
14103	1559	88	467	78946	0	81060
14104	489	88	241	79268	0	80086
14105	259	104	175	78295	0	78833
14106	172	79331	225	1930	0	81658
14107	80464	1461	184	625	0	82734
14108	1596	408	156	80012	0	82172
14109	79293	174	244	1661	0	81372
14110	1619	80022	178	674	0	82493
14111	79822	1515	174	401	0	81912
14112	79182	394	181	330	0	80087
14113	78925	176	187	347	0	79635
14114	1954	77250	242	415	0	79861
14115	626	78763	205	405	0	79999
14116	73605	1767	172	367	0	75911
14117	1557	74906	237	416	0	77116
14118	603	1563	73441	312	0	75919
14119	301	71635	1533	442	0	73911
14120	276	73895	529	442	0	75142
14121	72934	1685	323	295	0	75237
14122	1590	522	72103	324	0	74539
14123	613	289	71457	318	0	72677
14124	400	187	1775	69427	0	71789
14125	71166	195	596	1615	0	73572
14126	1655	187	71829	608	0	74279
14127	601	186	1537	70788	0	73112
14128	418	214	69308	1653	0	71593
14129	341	250	68397	641	0	69629
14130	65260	213	1793	479	0	67745
14131	1672	262	68287	319	0	70540
14132	660	231	1612	66100	0	68603
14133	444	242	578	66617	0	67881
14134	374	66366	435	1816	0	68991
14135	404	68633	370	767	0	70174
14136	418	1770	318	66884	0	69390
14137	431	590	66823	1701	0	69545
14138	419	400	1550	66278	0	68647
14139	362	329	590	67974	0	69255
14140	382	309	67915	1994	0	70600
14141	399	241	1643	67889	0	70172
14142	68403	288	726	1905	0	71322
14143	1731	285	67918	779	0	70713
14144	66523	257	1750	604	0	69134
14145	1864	250	747	66768	0	69629
14146	829	238	502	68391	0	69960
14147	555	68934	468	2196	0	72153
14148	483	1688	481	69583	0	72235
14149	499	605	442	71827	0	73373
14150	70440	396	495	2362	0	73693
14151	1808	371	535	70745	0	73459
14152	772	349	500	72137	0	73758
14153	68354	386	555	2434	0	71729
14154	1853	346	601	68976	0	71776
14155	808	318	594	65434	0	67154
14156	497	68273	644	2326	0	71740
14157	68396	1661	546	1158	0	71761
14158	1923	604	467	68654	0	71648
14159	810	420	448	70364	0	72042
14160	620	377	68349	2586	0	71932
14161	568	330	1808	67270	0	69976
14162	515	353	775	69176	0	70819
14163	66466	339	488	2509	0	69802
14164	66879	366	446	1160	0	68851
14165	2222	393	457	66566	0	69638
14166	960	362	65591	2065	0	68978
14167	584	63599	1821	1002	0	67006
14168	531	65171	765	832	0	67299
14169	762	2044	493	62966	0	66265
14170	62961	683	421	2012	0	66077
14171	1798	439	343	63602	0	66182
14172	63989	440	258	2086	0	66773
14173	1843	377	302	64870	0	67392
14174	800	372	322	65746	0	67240
14175	63631	382	306	2256	0	66575
14176	63162	372	356	1008	0	64898
14177	2118	63816	344	758	0	67036
14178	898	66125	322	777	0	68122
14179	573	1751	303	59646	0	62273
14180	513	678	279	61354	0	62824
14181	517	309	59646	1882	0	62354
14182	53521	289	1461	845	0	56116
14183	1393	57447	570	712	0	60122
14184	353	53900	309	507	0	55069
14185	51646	1122	443	510	0	53721
14186	1245	312	51778	422	0	53757
14187	504	199	49849	374	0	50926
14188	409	248	45890	304	0	46851
14189	185	40502	794	305	0	41786
14190	301	359	443	34791	0	35894
14191	113	101	97	34700	0	35011
14192	107	64	59	35047	0	35277
14193	33919	75	61	442	0	34497
14194	33360	81	52	198	0	33691
14195	371	34017	66	226	0	34680
14196	151	298	59	34569	0	35077
14197	247	120	34815	378	0	35560
14198	107	34954	315	276	0	35652
14199	34226	328	141	183	0	34878
14200	374	150	34454	149	0	35127
14201	30464	90	269	193	0	31016
14202	361	80	34286	180	0	34907
14203	175	148	301	32633	0	33257
14204	90	34372	131	377	0	34970
14205	34510	312	66	232	0	35120
14206	310	34965	55	248	0	35578
14207	34230	310	62	191	0	34793
14208	338	126	59	34001	0	34524
14209	227	98	35032	394	0	35751
14210	170	77	280	35867	0	36394
14211	136	100	108	40186	0	40530
14212	156	109	40079	655	0	40999
14213	36504	97	545	307	0	37453
14214	541	41024	162	280	0	42007
14215	40634	537	72	206	0	41449
14216	569	41559	99	255	0	42482
14217	245	573	85	43007	0	43910
14218	186	167	42849	712	0	43914
14219	49731	101	625	327	0	50784
14220	954	53324	161	263	0	54702
14221	370	1001	90	51854	0	53315
14222	205	333	82	54831	0	55451
14223	57677	182	81	1229	0	59169
14224	60737	129	97	457	0	61420
14225	1473	62420	114	322	0	64329
14226	67564	1275	82	237	0	69158
14227	68126	379	111	237	0	68853
14228	69487	174	96	211	0	69968
14229	2157	161	68619	201	0	71138
14230	745	67697	1476	310	0	70228
14231	333	71118	526	272	0	72249
14232	325	1977	188	64540	0	67030
14233	269	714	143	69407	0	70533
14234	68919	284	159	1876	0	71238
14235	1601	68873	149	800	0	71423
14236	69221	1659	106	319	0	71305
14237	1739	668	116	67770	0	70293
14238	706	311	144	69730	0	70891
14239	68068	196	152	2059	0	70475
14240	67816	216	144	744	0	68920
14241	2213	260	66501	322	0	69296
14242	909	290	1538	65699	0	68436
14243	484	207	65519	1647	0	67857
14244	357	234	65421	680	0	66692
14245	351	237	66109	324	0	67021
14246	62145	287	2217	280	0	64929
14247	1659	225	738	61685	0	64307
14248	738	172	281	61693	0	62884
14249	413	167	202	64016	0	64798
14250	336	176	62370	2065	0	64947
14251	352	179	1519	61468	0	63518
14252	401	200	606	63320	0	64527
14253	62310	198	267	1998	0	64773
14254	62971	202	206	826	0	64205
14255	64156	206	182	455	0	64999
14256	64049	192	190	385	0	64816
14257	2402	226	214	61746	0	64588
14258	62374	259	217	1787	0	64637
14259	2018	276	216	62405	0	64915
14260	1148	268	60397	1854	0	63667
14261	59615	279	1546	907	0	62347
14262	2032	60781	698	584	0	64095
14263	1126	1649	349	59791	0	62915
14264	781	901	276	58832	0	60790
14265	628	61285	311	2153	0	64377
14266	60030	1748	284	978	0	63040
14267	1969	59295	294	942	0	62500
14268	1143	1758	59948	567	0	63416
14269	808	784	60723	596	0	62911
14270	58838	456	2184	580	0	62058
14271	61092	399	883	612	0	62986
14272	2492	402	59054	589	0	62537
14273	58697	318	1731	610	0	61356
14274	2261	317	58864	624	0	62066
14275	58662	303	1900	598	0	61463
14276	2329	408	58762	660	0	62159
14277	1346	345	59654	707	0	62052
14278	938	404	2368	52907	0	56617
14279	851	370	1105	57703	0	60029
14280	57634	327	676	2435	0	61072
14281	58356	398	521	1306	0	60581
14282	59069	331	534	826	0	60760
14283	58648	378	467	846	0	60339
14284	2893	56368	546	874	0	60681
14285	1622	1689	542	53722	0	57575
14286	1190	56512	582	2066	0	60350
14287	1181	1805	597	56689	0	60272
14288	1177	855	513	56893	0	59438
14289	1230	562	524	56945	0	59261
14290	1249	484	54487	2796	0	59016
14291	51775	438	1943	1545	0	55701
14292	2466	52231	1044	1148	0	56889
14293	1459	54990	684	1173	0	58306
14294	1336	2155	54625	984	0	59100
14295	1164	981	1930	53815	0	57890
14296	1129	562	1087	55353	0	58131
14297	54126	429	776	2750	0	58081
14298	2391	500	666	53884	0	57441
14299	1499	470	777	54681	0	57427
14300	1174	455	719	55270	0	57618
14301	1130	403	823	55724	0	58080
14302	53786	283	828	2815	0	57712
14303	54496	327	880	1524	0	57227
14304	55269	287	845	1057	0	57458
14305	3021	235	847	53923	0	58026
14306	54133	262	930	2463	0	57788
14307	2589	233	834	54516	0	58172
14308	1654	281	908	56421	0	59264
14309	1351	249	53680	2782	0	58062
14310	1167	219	52412	1534	0	55332
14311	1154	196	49528	950	0	51828
14312	47258	214	2523	942	0	50937
14313	2202	376	1419	42159	0	46156
14314	1490	46106	716	1999	0	50311
14315	47086	1314	641	1328	0	50369
14316	2352	590	46045	964	0	49951
14317	43435	291	1542	848	0	46116
14318	2151	42147	1005	753	0	46056
14319	33202	847	438	516	0	35003
14320	1521	488	325	32600	0	34934
14321	32101	203	260	1193	0	33757
14322	1330	30855	304	809	0	33298
14323	848	29992	352	545	0	31737
14324	24940	822	272	378	0	26412
14325	779	25233	261	415	0	26688
14326	276	18668	136	170	0	19250
14327	247	18822	256	204	0	19529
14328	17179	432	567	139	0	18317
14329	16261	123	137	75	0	16596
14330	16278	76	59	73	0	16486
14331	359	55	48	16031	0	16493
14332	159	49	46	16331	0	16585
14333	112	61	16008	347	0	16528
14334	118	45	229	15880	0	16272
14335	121	53	16479	313	0	16966
14336	115	42	264	16235	0	16656
14337	110	47	97	16736	0	16990
14338	16485	47	79	349	0	16960
14339	16246	51	56	175	0	16528
14340	345	16332	58	160	0	16895
14341	175	255	65	16317	0	16812
14342	135	117	17132	285	0	17669
14343	114	81	257	16909	0	17361
14344	110	65	102	17226	0	17503
14345	115	72	72	17384	0	17643
14346	122	77	17138	339	0	17676
14347	112	60	16133	169	0	16474
14348	16277	47	305	140	0	16769
14349	288	82	145	17107	0	17622
14350	150	51	17132	302	0	17635
14351	16025	39	246	179	0	16489
14352	297	17523	110	170	0	18100
14353	17732	229	86	123	0	18170
14354	314	140	18306	89	0	18849
14355	17625	77	210	134	0	18046
14356	269	63	104	18011	0	18447
14357	161	69	18609	246	0	19085
14358	101	18496	224	156	0	18977
14359	18445	225	119	133	0	18922
14360	235	122	86	18309	0	18752
14361	122	76	64	18319	0	18581
14362	108	18933	67	285	0	19393
14363	79	201	78	19012	0	19370
14364	134	83	18942	254	0	19413
14365	91	18824	225	179	0	19319
14366	18947	196	103	111	0	19357
14367	228	109	75	18747	0	19159
14368	122	70	53	18747	0	18992
14369	142	59	18574	253	0	19028
14370	106	74	198	18275	0	18653
14371	203	84	19507	230	0	20024
14372	106	19591	206	149	0	20052
14373	19418	197	166	122	0	19903
14374	19358	101	68	94	0	19621
14375	19316	83	91	95	0	19585
14376	272	20519	63	114	0	20968
14377	165	176	66	20479	0	20886
14378	122	105	76	20507	0	20810
14379	91	75	57	20208	0	20431
14380	20306	55	75	289	0	20725
14381	20060	54	47	170	0	20331
14382	259	52	65	20125	0	20501
14383	150	67	22037	248	0	22502
14384	104	58	190	21986	0	22338
14385	95	61	102	22435	0	22693
14386	91	44	89	22290	0	22514
14387	93	47	76	22323	0	22539
14388	22419	57	59	342	0	22877
14389	225	56	63	22777	0	23121
14390	108	54	70	22724	0	22956
14391	106	23017	64	300	0	23487
14392	90	202	53	23369	0	23714
14393	87	23926	56	324	0	24393
14394	85	269	60	23839	0	24253
14395	23673	96	63	326	0	24158
14396	246	23903	59	239	0	24447
14397	23430	238	58	152	0	23878
14398	315	87	24227	134	0	24763
14399	133	67	245	23831	0	24276
14400	122	74	24980	331	0	25507
14401	91	30	271	24837	0	25229
14402	81	63	123	24769	0	25036
14403	77	25139	86	369	0	25671
14404	81	25786	70	209	0	26146
14405	56	26422	48	143	0	26669
14406	25940	202	49	135	0	26326
14407	191	25379	50	116	0	25736
14408	53	24894	30	79	0	25056
14409	247	183	44	25018	0	25492
14410	25301	38	25	176	0	25540
14411	134	27311	27	82	0	27554
14412	27853	133	21	130	0	28137
14413	27718	46	18	83	0	27865
14414	195	56	28934	60	0	29245
14415	87	55	129	27918	0	28189
14416	46	32	38	29787	0	29903
14417	44	26	29	29975	0	30074
14418	40	28	53	29405	0	29526
14419	43	56	28583	206	0	28888
14420	64	61	25055	79	0	25259
14421	25578	24	152	89	0	25843
14422	134	28229	33	80	0	28476
14423	40	28466	19	76	0	28601
14424	28570	139	19	70	0	28798
14425	131	28368	22	52	0	28573
14426	37	134	46	28965	0	29182
14427	29009	40	22	174	0	29245
14428	153	60	28745	49	0	29007
14429	52	33	126	28894	0	29105
14430	75	35	29472	156	0	29738
14431	27916	29	143	78	0	28166
14432	195	43	31959	52	0	32249
14433	31857	35	308	114	0	32314
14434	33727	29	60	126	0	33942
14435	33761	29	31	91	0	33912
14436	33793	30	25	85	0	33933
14437	33884	31	45	63	0	34023
14438	219	43	31	33865	0	34158
14439	35257	31	38	244	0	35570
14440	165	45	42	35354	0	35606
14441	111	26	23	35458	0	35618
14442	62	59	33	35503	0	35657
14443	83	58	35588	241	0	35970
14444	64	35	143	34703	0	34945
14445	61	42	54	36301	0	36458
14446	72	59	35314	237	0	35682
14447	30955	42	169	158	0	31324
14448	173	40	63	36213	0	36489
14449	114	47	36324	201	0	36686
14450	80	47	35224	108	0	35459
14451	60	31	171	35228	0	35490
14452	82	43	36328	216	0	36669
14453	108	63	159	36587	0	36917
14454	81	23	78	36739	0	36921
14455	42	36704	54	253	0	37053
14456	40	37256	49	141	0	37486
14457	37526	179	36	129	0	37870
14458	156	74	32	37744	0	38006
14459	94	37	29	37269	0	37429
14460	57	40	36	38251	0	38384
14461	98	49	38792	236	0	39175
14462	67	32	163	37645	0	37907
14463	38204	38	102	227	0	38571
14464	218	71	39535	106	0	39930
14465	113	35	170	40320	0	40638
14466	65	43	84	40959	0	41151
14467	70	35	50	41153	0	41308
14468	54	43352	65	340	0	43811
14469	43653	265	51	155	0	44124
14470	44737	83	43	108	0	44971
14471	411	46548	56	109	0	47124
14472	142	328	75	49486	0	50031
14473	115	109	49548	465	0	50237
14474	108	96	48197	166	0	48567
14475	49144	38	592	115	0	49889
14476	572	43	163	51325	0	52103
14477	53903	16	115	589	0	54623
14478	675	55671	87	298	0	56731
14479	204	56743	63	218	0	57228
14480	55885	833	43	122	0	56883
14481	691	58573	72	150	0	59486
14482	226	755	51	59278	0	60310
14483	151	243	42	56568	0	57004
14484	74	60314	67	886	0	61341
14485	60802	757	71	316	0	61946
14486	841	241	61235	136	0	62453
14487	57401	108	809	180	0	58498
14488	924	80	62026	95	0	63125
14489	55741	72	873	182	0	56868
14490	976	77	63149	105	0	64307
14491	279	61898	949	156	0	63282
14492	169	824	331	62488	0	63812
14493	61924	204	170	888	0	63186
14494	902	127	61493	251	0	62773
14495	319	82	61881	136	0	62418
14496	202	85	1012	59538	0	60837
14497	138	72	62666	858	0	63734
14498	104	58	912	60791	0	61865
14499	108	57	267	61729	0	62161
14500	137	74	62177	1114	0	63502
14501	104	83	873	61108	0	62168
14502	63043	53	351	988	0	64435
14503	829	63134	171	430	0	64564
14504	63951	831	132	232	0	65146
14505	915	246	102	62534	0	63797
14506	62864	107	97	912	0	63980
14507	64362	83	118	389	0	64952
14508	1117	104	117	63188	0	64526
14509	371	65099	138	895	0	66503
14510	65582	815	171	359	0	66927
14511	973	290	62987	200	0	64450
14512	382	157	62406	189	0	63134
14513	61244	96	1067	173	0	62580
14514	927	114	398	61943	0	63382
14515	417	115	62626	907	0	64065
14516	216	111	901	62315	0	63543
14517	62911	96	344	1024	0	64375
14518	64246	120	183	438	0	64987
14519	63862	102	186	258	0	64408
14520	1132	65740	186	258	0	67316
14521	427	878	122	66265	0	67692
14522	290	320	116	66664	0	67390
14523	66049	184	132	1123	0	67488
14524	940	66012	150	507	0	67609
14525	65791	874	126	284	0	67075
14526	1018	337	123	65198	0	66676
14527	64892	199	141	944	0	66176
14528	1041	223	63373	383	0	65020
14529	432	63911	896	314	0	65553
14530	359	938	343	60977	0	62617
14531	241	65548	233	856	0	66878
14532	286	925	160	63279	0	64650
14533	62581	310	191	982	0	64064
14534	1021	232	60792	371	0	62416
14535	58962	145	930	294	0	60331
14536	1017	62896	383	314	0	64610
14537	454	883	251	63792	0	65380
14538	310	331	213	64845	0	65699
14539	62700	208	211	1180	0	64299
14540	1081	211	62540	434	0	64266
14541	466	141	940	63060	0	64607
14542	350	154	395	63440	0	64339
14543	303	166	249	63170	0	63888
14544	312	154	224	63631	0	64321
14545	62201	161	240	1247	0	63849
14546	61881	167	210	551	0	62809
14547	1227	182	61948	339	0	63696
14548	524	252	59475	325	0	60576
14549	61760	158	1106	364	0	63388
14550	63789	130	414	366	0	64699
14551	1203	166	255	62907	0	64531
14552	523	139	241	63253	0	64156
14553	61799	128	223	1204	0	63354
14554	1058	61428	271	559	0	63316
14555	498	837	248	61785	0	63368
14556	354	274	220	62743	0	63591
14557	381	186	60985	1302	0	62854
14558	351	131	936	60564	0	61982
14559	370	159	61720	1151	0	63400
14560	329	146	982	61359	0	62816
14561	60518	124	369	1193	0	62204
14562	1095	144	231	60907	0	62377
14563	500	150	60439	1150	0	62239
14564	340	57054	965	625	0	58984
14565	380	909	353	59867	0	61509
14566	444	292	60121	1095	0	61952
14567	302	59909	950	681	0	61842
14568	384	926	302	58652	0	60264
14569	341	324	57936	978	0	59579
14570	43980	199	852	558	0	45589
14571	817	55773	331	406	0	57327
14572	333	53558	183	304	0	54378
14573	238	54350	144	272	0	55004
14574	389	1051	193	51789	0	53422
14575	297	273	53274	747	0	54591
14576	169	53097	700	432	0	54398
14577	338	1131	290	50771	0	52530
14578	53141	192	137	662	0	54132
14579	737	101	81	72149	0	73068
14580	480	119	85428	1547	0	87574
14581	185	86092	1680	625	0	88582
14582	81672	1744	385	305	0	84106
14583	1621	85256	228	367	0	87472
14584	749	1892	81495	204	0	84340
14585	213	83068	1688	303	0	85272
14586	348	2045	518	81008	0	83919
14587	279	571	80739	1707	0	83296
14588	179	80575	1792	583	0	83129
14589	236	1892	474	78015	0	80617
14590	221	645	354	76959	0	78179
14591	111	79318	293	1892	0	81614
14592	90	1914	261	79888	0	82153
14593	153	636	79307	1961	0	82057
14594	143	513	80479	615	0	81750
14595	103	395	2039	79302	0	81839
14596	78788	311	639	2021	0	81759
14597	78967	341	343	724	0	80375
14598	1951	366	247	75683	0	78247
14599	535	77833	367	2057	0	80792
14600	302	1849	481	78015	0	80647
14601	76565	615	511	2093	0	79784
14602	1848	470	405	76110	0	78833
14603	772	396	310	77779	0	79257
14604	75250	454	251	2291	0	78246
14605	1881	74997	342	984	0	78204
14606	614	2071	321	74109	0	77115
14607	74217	739	286	2147	0	77389
14608	1975	516	72709	987	0	76187
14609	71946	382	1831	855	0	75014
14610	2070	399	514	73332	0	76315
14611	73131	401	346	2354	0	76232
14612	73975	486	275	1058	0	75794
14613	70420	419	345	821	0	72005
14614	2289	71511	503	786	0	75089
14615	1067	1855	70805	585	0	74312
14616	741	71991	1983	749	0	75464
14617	70282	1951	613	669	0	73515
14618	2316	70891	406	686	0	74299
14619	1101	2056	297	70777	0	74231
14620	67971	874	307	2098	0	71250
14621	2158	68862	363	1016	0	72399
14622	944	2259	68651	731	0	72585
14623	786	877	1910	68819	0	72392
14624	678	790	68832	2329	0	72629
14625	608	68917	2064	1579	0	73168
14626	734	2306	644	66737	0	70421
14627	643	994	498	68885	0	71020
14628	636	751	495	69322	0	71204
14629	656	572	614	65821	0	67663
14630	649	67643	626	2639	0	71557
14631	66899	2135	571	1340	0	70945
14632	2267	928	67114	1228	0	71537
14633	991	790	2292	67279	0	71352
14634	66633	859	912	2557	0	70961
14635	2538	977	66639	1274	0	71428
14636	1085	65723	2312	1062	0	70182
14637	831	2819	1052	64064	0	68766
14638	893	1412	65479	2375	0	70159
14639	660	66087	2386	1499	0	70632
14640	61957	2485	1104	1341	0	66887
14641	2174	65281	960	1226	0	69641
14642	984	2785	720	63234	0	67723
14643	712	1334	701	66890	0	69637
14644	63772	1246	716	3223	0	68957
14645	2148	64712	905	1933	0	69698
14646	977	2559	1141	65344	0	70021
14647	63452	1271	1242	2838	0	68803
14648	62947	1040	928	1760	0	66675
14649	2862	62918	695	1715	0	68190
14650	63694	2520	488	1403	0	68105
14651	64893	1388	459	1360	0	68100
14652	2930	1365	482	63268	0	68045
14653	1485	1184	62587	3018	0	68274
14654	1392	932	2239	62319	0	66882
14655	1269	814	927	64038	0	67048
14656	1260	799	61313	3464	0	66836
14657	1296	60921	2220	1825	0	66262
14658	1221	2676	780	61089	0	65766
14659	1031	1254	782	62924	0	65991
14660	1130	893	886	63066	0	65975
14661	1189	769	976	60410	0	63344
14662	1144	61020	921	3307	0	66392
14663	61953	2290	647	1941	0	66831
14664	62552	960	428	1798	0	65738
14665	61141	784	329	1547	0	63801
14666	3336	58362	375	1576	0	63649
14667	1589	2572	425	58654	0	63240
14668	1164	1418	58345	2927	0	63854
14669	1266	1423	2173	54709	0	59571
14670	1501	58892	781	2553	0	63727
14671	57099	2469	503	1260	0	61331
14672	57665	1216	378	1330	0	60589
14673	56318	950	450	1267	0	58985
14674	2839	55549	758	1184	0	60330
14675	1192	53891	978	1231	0	57292
14676	910	54740	989	1368	0	58007
14677	1171	2410	53345	1131	0	58057
14678	1137	1907	48217	1253	0	52514
14679	1837	6864	1524	21492	0	31717
14680	14712	144	728	324	0	15908
14681	14403	49	48	118	0	14618
14682	263	43	33	14790	0	15129
14683	87	54	34	14824	0	14999
14684	52	60	40	14969	0	15121
14685	52	63	32	15121	0	15268
14686	15221	41	33	287	0	15582
14687	15439	70	30	100	0	15639
14688	285	15954	36	94	0	16369
14689	16393	273	30	117	0	16813
14690	16698	92	45	99	0	16934
14691	16757	63	40	86	0	16946
14692	338	79	15625	84	0	16126
14693	15613	69	200	82	0	15964
14694	279	16656	81	96	0	17112
14695	130	254	42	17191	0	17617
14696	87	82	42	17087	0	17298
14697	81	17024	45	348	0	17498
14698	92	285	31	17543	0	17951
14699	17353	85	44	362	0	17844
14700	320	53	41	17530	0	17944
14701	121	61	17254	349	0	17785
14702	16111	55	277	146	0	16589
14703	323	17803	69	118	0	18313
14704	138	279	41	17954	0	18412
14705	97	105	37	18172	0	18411
14706	106	59	24	18229	0	18418
14707	114	68	17825	405	0	18412
14708	100	17381	276	207	0	17964
14709	115	276	69	17645	0	18105
14710	117	111	17249	315	0	17792
14711	105	63	261	16854	0	17283
14712	104	70	16906	322	0	17402
14713	105	141	258	15858	0	16362
14714	71	16409	96	305	0	16881
14715	79	291	42	16157	0	16569
14716	16149	85	45	308	0	16587
14717	16186	61	48	128	0	16423
14718	365	57	16076	103	0	16601
14719	126	61	15279	86	0	15552
14720	88	55	16713	83	0	16939
14721	52	72	285	16766	0	17175
14722	67	44	86	17868	0	18065
14723	58	54	61	17931	0	18104
14724	54	18232	46	399	0	18731
14725	70	312	49	18127	0	18558
14726	63	102	44	18715	0	18924
14727	57	69	51	19368	0	19545
14728	19093	61	43	449	0	19646
14729	19169	72	60	182	0	19483
14730	414	50	19339	125	0	19928
14731	147	52	18819	125	0	19143
14732	18802	43	397	115	0	19357
14733	19750	49	161	104	0	20064
14734	444	59	20404	102	0	21009
14735	171	46	19939	117	0	20273
14736	19765	41	445	114	0	20365
14737	20374	46	133	124	0	20677
14738	471	53	20527	113	0	21164
14739	167	56	365	20151	0	20739
14740	90	52	146	20314	0	20602
14741	97	21535	85	489	0	22206
14742	122	379	57	21880	0	22438
14743	127	112	22916	470	0	23625
14744	89	64	460	22702	0	23315
14745	108	36	179	23274	0	23597
14746	108	51	22783	595	0	23537
14747	21390	59	461	242	0	22152
14748	23099	34	178	168	0	23479
14749	573	47	101	22527	0	23248
14750	224	61	78	23017	0	23380
14751	22855	37	111	600	0	23603
14752	22836	44	100	239	0	23219
14753	22354	47	104	162	0	22667
14754	22787	45	104	145	0	23081
14755	576	22348	104	176	0	23204
14756	21672	411	90	179	0	22352
14757	471	22133	107	167	0	22878
14758	200	434	85	22058	0	22777
14759	124	139	109	21783	0	22155
14760	109	21562	113	614	0	22398
14761	121	424	86	21827	0	22458
14762	129	119	89	21418	0	21755
14763	122	21282	131	621	0	22156
14764	123	432	111	21500	0	22166
14765	142	132	114	21774	0	22162
14766	142	89	101	21854	0	22186
14767	161	67	21193	648	0	22069
14768	146	20515	464	302	0	21427
14769	181	486	187	18924	0	19778
14770	139	20662	146	472	0	21419
14771	20425	401	176	212	0	21214
14772	501	152	20244	170	0	21067
14773	238	81	19840	174	0	20333
14774	18777	85	529	170	0	19561
14775	468	171	173	19178	0	19990
14776	206	46	18737	435	0	19424
14777	153	67	18479	186	0	18885
14778	148	166	423	17769	0	18506
14779	17608	51	166	404	0	18229
14780	17620	61	67	183	0	17931
14781	467	57	63	17358	0	17945
14782	185	55	17219	411	0	17870
14783	115	17814	353	246	0	18528
14784	135	331	127	17698	0	18291
14785	142	137	17840	408	0	18527
14786	101	17556	348	252	0	18257
14787	120	320	136	17140	0	17716
14788	17189	114	74	394	0	17771
14789	341	86	65	16240	0	16732
14790	150	16517	94	401	0	17162
14791	16464	294	86	203	0	17047
14792	349	130	17106	161	0	17746
14793	155	16843	319	192	0	17509
14794	119	323	16806	139	0	17387
14795	15883	114	316	131	0	16444
14796	326	76	143	15819	0	16364
14797	166	58	91	16584	0	16899
14798	16558	39	105	401	0	17103
14799	328	49	104	16577	0	17058
14800	177	55	16489	345	0	17066
14801	15233	50	327	206	0	15816
14802	317	16373	150	166	0	17006
14803	174	268	106	15858	0	16406
14804	15724	97	80	366	0	16267
14805	333	15605	81	199	0	16218
14806	181	291	91	16007	0	16570
14807	15890	143	72	351	0	16456
14808	328	71	72	15638	0	16109
14809	135	15845	83	362	0	16425
14810	124	304	15903	186	0	16517
14811	97	116	294	16255	0	16762
14812	121	103	119	16320	0	16663
14813	16541	49	73	442	0	17105
14814	338	73	57	16636	0	17104
14815	16684	79	64	364	0	17191
14816	16652	77	82	179	0	16990
14817	392	79	50	16057	0	16578
14818	172	16535	64	366	0	17137
14819	149	308	70	15981	0	16508
14820	14968	127	45	346	0	15486
14821	301	15233	54	199	0	15787
14822	113	15605	40	107	0	15865
14823	15395	277	42	131	0	15845
14824	15609	90	57	88	0	15844
14825	291	15790	56	104	0	16241
14826	15707	275	90	84	0	16156
14827	15485	89	44	79	0	15697
14828	306	54	44	15484	0	15888
14829	105	50	16119	276	0	16550
14830	72	82	241	15982	0	16377
14831	72	43	16615	305	0	17035
14832	87	77	268	16507	0	16939
14833	81	38	16688	333	0	17140
14834	15445	18	266	109	0	15838
14835	263	30	81	15825	0	16199
14836	16432	21	55	281	0	16789
14837	270	117	40	15745	0	16172
14838	109	16854	26	285	0	17274
14839	17149	225	29	125	0	17528
14840	265	85	16634	71	0	17055
14841	15124	44	183	49	0	15400
14842	194	15849	72	45	0	16160
14843	14610	152	26	20	0	14808
14844	14605	44	18	21	0	14688
14845	190	14911	16	42	0	15159
14846	67	165	13	15509	0	15754
14847	15384	51	9	195	0	15639
14848	190	15650	17	76	0	15933
14849	68	186	12	16017	0	16283
14850	16091	60	17	214	0	16382
14851	215	23	15	16352	0	16605
14852	75	27	14	16447	0	16563
14853	47	22	27	16468	0	16564
14854	48	23	16121	261	0	16453
14855	46	20	190	15895	0	16151
14856	16092	28	57	234	0	16411
14857	219	27	16300	79	0	16625
14858	82	16	196	16242	0	16536
14859	51	22	55	16612	0	16740
14860	43	20	16400	261	0	16724
14861	15499	18	195	101	0	15813
14862	16799	16	65	53	0	16933
14863	273	28	16915	42	0	17258
14864	82	20	210	16408	0	16720
14865	61	9	72	17294	0	17436
14866	55	30	18172	288	0	18545
14867	37	15	215	18286	0	18553
14868	52	7	69	18789	0	18917
14869	55	22	19085	303	0	19465
14870	18134	15	250	124	0	18523
14871	281	13	77	19418	0	19789
14872	19375	25	47	296	0	19743
14873	19458	19	26	117	0	19620
14874	349	25	19532	95	0	20001
14875	126	12	274	19228	0	19640
14876	19558	26	80	337	0	20001
14877	299	20170	43	197	0	20709
14878	109	270	48	21050	0	21477
14879	75	64	46	21579	0	21764
14880	60	31	36	21844	0	21971
14881	85	28	21482	424	0	22019
14882	18852	28	348	165	0	19393
14883	327	14	96	20641	0	21078
14884	119	11	56	20963	0	21149
14885	82	24	20801	426	0	21333
14886	73	20	332	20557	0	20982
14887	79	26	90	21107	0	21302
14888	20509	21	78	438	0	21046
14889	338	20577	52	208	0	21175
14890	133	296	20834	132	0	21395
14891	20525	73	345	105	0	21048
14892	357	31	110	20429	0	20927
14893	144	24	20932	382	0	21482
14894	103	31	21284	148	0	21566
14895	92	25	386	21489	0	21992
14896	89	30	22342	390	0	22851
14897	107	28	22524	176	0	22835
14898	81	21249	396	140	0	21866
14899	83	315	131	22963	0	23492
14900	130	80	23132	370	0	23712
14901	94	41	336	22580	0	23051
14902	24231	34	114	466	0	24845
14903	361	31	83	24361	0	24836
14904	134	34	73	25048	0	25289
14905	24029	25	70	482	0	24606
14906	24421	19	83	221	0	24744
14907	420	40	81	25973	0	26514
14908	150	35	26678	436	0	27299
14909	94	26360	394	221	0	27069
14910	89	353	134	26740	0	27316
14911	26451	75	86	474	0	27086
14912	26582	29	99	197	0	26907
14913	460	26454	89	158	0	27161
14914	147	27238	76	161	0	27622
14915	26996	382	100	141	0	27619
14916	27041	96	80	136	0	27353
14917	478	58	28222	162	0	28920
14918	168	60	393	26813	0	27434
14919	86	28737	166	451	0	29440
14920	29400	342	90	240	0	30072
14921	441	129	95	28571	0	29236
14922	163	28365	119	473	0	29120
14923	140	360	28483	201	0	29184
14924	117	189	394	26417	0	27117
14925	87	29734	152	406	0	30379
14926	29432	340	120	201	0	30093
14927	29558	98	67	156	0	29879
14928	409	29552	73	156	0	30190
14929	28503	313	81	151	0	29048
14930	28361	81	66	142	0	28650
14931	373	28124	80	133	0	28710
14932	149	28645	70	167	0	29031
14933	139	408	100	27918	0	28565
14934	27992	83	71	377	0	28523
14935	330	61	28990	167	0	29548
14936	26666	55	321	137	0	27179
14937	323	29020	107	139	0	29589
14938	28981	280	80	148	0	29489
14939	29250	88	98	107	0	29543
14940	29456	51	76	134	0	29717
14941	401	61	66	28273	0	28801
14942	123	29239	90	360	0	29812
14943	29283	302	71	145	0	29801
14944	357	103	29252	154	0	29866
14945	126	29691	343	123	0	30283
14946	125	267	83	30262	0	30737
14947	98	92	29611	322	0	30123
14948	87	67	30014	105	0	30273
14949	97	68	304	29215	0	29684
14950	100	55	73	31033	0	31261
14951	83	43	74	31181	0	31381
14952	89	42	61	30718	0	30910
14953	76	30245	64	362	0	30747
14954	84	31197	51	128	0	31460
14955	31256	326	54	110	0	31746
14956	345	99	48	31372	0	31864
14957	138	78	47	31481	0	31744
14958	87	77	57	31972	0	32193
14959	31198	68	45	392	0	31703
14960	31783	66	49	116	0	32014
14961	399	63	45	31589	0	32096
14962	32026	68	45	351	0	32490
14963	32052	54	55	134	0	32295
14964	32614	70	32	127	0	32843
14965	448	67	50	31683	0	32248
14966	163	60	30451	280	0	30954
14967	105	81	29248	89	0	29523
14968	91	73	30589	72	0	30825
14969	102	36	31301	65	0	31504
14970	82	99	293	30502	0	30976
14971	31188	51	107	227	0	31573
14972	30789	42	60	88	0	30979
14973	288	61	31144	69	0	31562
14974	119	70	31414	74	0	31677
14975	74	33358	246	61	0	33739
14976	66	269	74	33830	0	34239
14977	33784	72	43	237	0	34136
14978	226	55	33697	81	0	34059
14979	31817	52	181	71	0	32121
14980	205	35240	69	63	0	35577
14981	78	187	32	35823	0	36120
14982	56	65	22	36958	0	37101
14983	56	49	28	37091	0	37224
14984	37012	34	27	325	0	37398
14985	273	32	21	37075	0	37401
14986	104	44	24	37266	0	37438
14987	37135	32	38	310	0	37515
14988	252	42	25	36771	0	37090
14989	132	59	37628	278	0	38097
14990	36464	31	244	157	0	36896
14991	285	46	57	38269	0	38657
14992	106	43	58	37764	0	37971
14993	83	37980	49	290	0	38402
14994	38290	246	39	116	0	38691
14995	38498	79	35	94	0	38706
14996	359	108	35	37786	0	38288
14997	152	57	37785	285	0	38279
14998	34541	43	276	138	0	34998
14999	331	37	38228	88	0	38684
15000	102	31	292	37586	0	38011
15001	89	42	96	38897	0	39124
15002	38349	39	49	401	0	38838
15003	371	23	42	40971	0	41407
15004	144	26	41394	352	0	41916
15005	39547	31	351	144	0	40073
15006	369	51	44028	109	0	44557
15007	142	49	43505	80	0	43776
15008	44502	18	494	151	0	45165
15009	485	61	145	47402	0	48093
15010	120	49882	57	385	0	50444
15011	50239	395	61	134	0	50829
15012	50055	81	47	83	0	50266
15013	519	48	49931	70	0	50568
15014	49056	34	416	94	0	49600
15015	480	131	104	50973	0	51688
15016	193	40	53018	454	0	53705
15017	82	51855	433	217	0	52587
15018	51262	432	134	116	0	51944
15019	404	53099	65	151	0	53719
15020	177	420	68	53337	0	54002
15021	88	123	43	53968	0	54222
15022	86	37	38	54301	0	54462
15023	63	42	50	53032	0	53187
15024	66	53706	52	580	0	54404
15025	127	371	51786	177	0	52461
15026	48	52704	407	174	0	53333
15027	52575	394	111	97	0	53177
15028	429	121	51	52555	0	53156
15029	52762	45	63	429	0	53299
15030	443	49	51	53044	0	53587
15031	55755	29	69	573	0	56426
15032	444	57276	76	218	0	58014
15033	59319	390	58	188	0	59955
15034	59805	112	66	158	0	60141
15035	58731	52	46	110	0	58939
15036	59523	38	38	126	0	59725
15037	530	59850	66	137	0	60583
15038	251	396	60160	86	0	60893
15039	149	137	393	60192	0	60871
15040	60564	80	162	455	0	61261
15041	61157	50	76	159	0	61442
15042	526	47	59	61925	0	62557
15043	218	68	64193	467	0	64946
15044	140	57	446	62407	0	63050
15045	122	64446	159	485	0	65212
15046	64666	449	81	230	0	65426
15047	521	162	70	64332	0	65085
15048	198	63753	78	529	0	64558
15049	127	66946	80	247	0	67400
15050	105	67928	81	170	0	68284
15051	114	673	77	68051	0	68915
15052	68088	189	61	585	0	68923
15053	553	69241	75	276	0	70145
15054	239	546	71	70366	0	71222
15055	70176	168	61	633	0	71038
15056	617	101	78	70363	0	71159
15057	70378	89	55	666	0	71188
15058	70491	80	59	250	0	70880
15059	740	74212	89	199	0	75240
15060	357	572	73	71128	0	72130
15061	193	74975	100	522	0	75790
15062	74604	600	98	201	0	75503
15063	74695	191	79	201	0	75166
15064	75741	127	79	197	0	76144
15065	808	93	99	75158	0	76158
15066	352	110	74849	668	0	75979
15067	72085	98	573	276	0	73032
15068	75420	90	205	229	0	75944
15069	805	122	104	73511	0	74542
15070	360	77041	91	622	0	78114
15071	285	621	81	77447	0	78434
15072	225	258	96	78694	0	79273
15073	78290	166	101	772	0	79329
15074	76960	147	87	326	0	77520
15075	842	184	75124	224	0	76374
15076	360	149	577	74493	0	75579
15077	75459	138	195	700	0	76492
15078	744	211	109	76581	0	77645
15079	389	165	77447	758	0	78759
15080	234	74174	626	441	0	75475
15081	222	77486	203	297	0	78208
15082	84154	693	148	289	0	85284
15083	892	257	72	88310	0	89531
15084	379	179	64	99656	0	100278
15085	98739	168	91	1512	0	100510
15086	1447	200	99871	504	0	102022
15087	513	152	1241	98616	0	100522
15088	481	196	101137	1363	0	103177
15089	308	101501	1331	546	0	103686
15090	105661	1263	355	438	0	107717
15091	107142	408	185	272	0	108007
15092	107543	241	126	246	0	108156
15093	1843	221	104721	234	0	107019
15094	103541	134	1277	299	0	105251
15095	107495	129	348	255	0	108227
15096	1812	181	214	106107	0	108314
15097	97940	170	401	1461	0	99972
15098	1396	171	106208	472	0	108247
15099	99857	181	1288	439	0	101765
15100	1674	205	105297	259	0	107435
15101	642	108331	1315	460	0	110748
15102	539	2087	484	98605	0	101715
15103	423	107956	275	1113	0	109767
15104	509	1342	105992	395	0	108238
15105	344	107836	1274	416	0	109870
15106	101224	1274	377	233	0	103108
15107	1217	102235	267	298	0	104017
15108	452	100425	198	341	0	101416
15109	563	1310	96854	183	0	98910
15110	338	509	1163	94612	0	96622
15111	96887	297	412	1228	0	98824
15112	1254	263	97020	474	0	99011
15113	523	97636	1191	401	0	99751
15114	440	1130	435	95883	0	97888
15115	438	448	98375	1301	0	100562
15116	529	313	96288	489	0	97619
15117	427	272	1553	95667	0	97919
15118	461	236	97225	1418	0	99340
15119	463	333	1539	86397	0	88732
15120	399	94130	646	1152	0	96327
15121	594	1223	425	91552	0	93794
15122	614	94540	385	1257	0	96796
15123	725	1302	302	94566	0	96895
15124	93152	434	438	1356	0	95380
15125	1650	326	364	92625	0	94965
15126	925	93475	355	1420	0	96175
15127	671	1195	403	95253	0	97522
15128	726	456	94339	1462	0	96983
15129	665	376	1432	93691	0	96164
15130	93953	302	741	1471	0	96467
15131	1658	365	91239	627	0	93889
15132	824	504	1512	89159	0	91999
15133	88314	406	608	1474	0	90802
15134	1570	87930	563	805	0	90868
15135	894	1516	578	86894	0	89882
15136	88578	722	580	1455	0	91335
15137	1793	609	536	87452	0	90390
15138	925	622	86762	1481	0	89790
15139	81908	710	1549	790	0	84957
15140	1605	87065	969	639	0	90278
15141	775	88086	777	727	0	90365
15142	88480	1641	695	581	0	91397
15143	86233	812	759	512	0	88316
15144	1816	859	642	84134	0	87451
15145	85514	685	675	1550	0	88424
15146	1707	695	85187	824	0	88413
15147	82832	597	1743	894	0	86066
15148	1623	84420	971	1031	0	88045
15149	84622	1398	974	930	0	87924
15150	1903	763	85391	930	0	88987
15151	1259	813	1749	84751	0	88572
15152	945	711	1282	86136	0	89074
15153	993	833	1103	79592	0	82521
15154	966	84433	1039	1851	0	88289
15155	85225	1549	810	1096	0	88680
15156	2301	836	920	77286	0	81343
15157	1528	80316	890	1626	0	84360
15158	88092	1412	930	1162	0	91596
15159	83919	803	1115	1014	0	86851
15160	85602	779	886	1115	0	88382
15161	85336	730	838	1159	0	88063
15162	83664	696	987	1145	0	86492
15163	2097	807	996	83107	0	87007
15164	1413	914	1025	82937	0	86289
15165	82032	982	976	2011	0	86001
15166	1623	1140	962	82269	0	85994
15167	1228	1277	849	82165	0	85519
15168	906	1203	78341	2183	0	82633
15169	77789	1293	1917	1295	0	82294
15170	80302	1121	1301	1225	0	83949
15171	80633	1457	987	1064	0	84141
15172	2123	1360	1069	72589	0	77141
15173	1278	78385	915	1887	0	82465
15174	84454	1845	1086	1328	0	88713
15175	82663	1144	1181	1574	0	86562
15176	2443	904	1014	87547	0	91908
15177	87801	926	1253	2346	0	92326
15178	2541	1728	74743	1718	0	80730
15179	1381	89793	1912	1679	0	94765
15180	1408	92229	1282	1794	0	96713
15181	1887	2308	89011	1663	0	94869
15182	867	81174	2202	1583	0	85826
15183	1007	77458	1169	1833	0	81467
15184	65247	1185	1438	1012	0	68882
15185	1050	65060	593	1015	0	67718
15186	850	1194	472	65125	0	67641
15187	66287	622	427	1556	0	68892
15188	1304	505	63226	1068	0	66103
15189	61627	612	757	1122	0	64118
15190	1237	644	61435	958	0	64274
15191	741	380	60675	978	0	62774
15192	58421	314	1038	918	0	60691
15193	1082	301	62145	869	0	64397
15194	740	61226	848	620	0	63434
15195	564	744	596	61255	0	63159
15196	61032	373	293	1051	0	62749
15197	1104	59441	277	619	0	61441
15198	616	839	301	59897	0	61653
15199	715	415	58924	1027	0	61081
15200	817	321	643	58323	0	60104
15201	56635	290	417	1041	0	58383
15202	1188	220	55636	567	0	57611
15203	932	321	693	54487	0	56433
15204	55533	484	325	910	0	57252
15205	56796	352	313	538	0	57999
15206	1489	267	228	56328	0	58312
15207	853	317	167	56902	0	58239
15208	716	277	57541	1007	0	59541
15209	789	194	55816	467	0	57266
15210	55564	165	920	408	0	57057
15211	58936	205	312	383	0	59836
15212	1165	58653	236	308	0	60362
15213	58593	617	252	176	0	59638
15214	60046	253	262	333	0	60894
15215	1060	264	64127	436	0	65887
15216	496	65650	742	470	0	67358
15217	67094	703	290	253	0	68340
15218	66963	244	158	155	0	67520
15219	67865	163	100	135	0	68263
15220	992	136	78	66415	0	67621
15221	402	103	72	66968	0	67545
15222	220	67080	76	880	0	68256
15223	193	719	82	68096	0	69090
15224	67342	227	88	846	0	68503
15225	827	140	75	67743	0	68785
15226	340	134	67507	857	0	68838
15227	274	124	65768	306	0	66472
15228	204	70	888	65712	0	66874
15229	254	104	67437	851	0	68646
15230	208	112	66949	342	0	67611
15231	182	90	991	61803	0	63066
15232	164	104	367	67702	0	68337
15233	207	115	68170	962	0	69454
15234	328	139	67574	350	0	68391
15235	186	68061	999	291	0	69537
15236	68552	850	368	178	0	69948
15237	864	70324	232	198	0	71618
15238	69998	888	193	205	0	71284
15239	71086	319	146	182	0	71733
15240	1034	71823	159	299	0	73315
15241	71953	937	141	140	0	73171
15242	1104	328	126	71072	0	72630
15243	481	183	72740	1009	0	74413
15244	334	142	964	70493	0	71933
15245	263	116	312	73799	0	74490
15246	70291	102	234	1210	0	71837
15247	70578	100	219	436	0	71333
15248	71091	90	176	286	0	71643
15249	70727	115	169	225	0	71236
15250	67136	98	163	225	0	67622
15251	1251	65265	202	275	0	66993
15252	479	901	151	66855	0	68386
15253	358	296	67696	1007	0	69357
15254	274	190	1034	66883	0	68381
15255	287	130	349	68763	0	69529
15256	259	105	241	71291	0	71896
15257	74406	101	210	1337	0	76054
15258	1383	104	183	74268	0	75938
15259	75215	108	191	1492	0	77006
15260	1573	133	76885	533	0	79124
15261	569	118	1373	90012	0	92072
15262	446	138	93741	2023	0	96348
15263	91717	96	1984	612	0	94409
15264	2073	124	521	93677	0	96395
15265	693	122	95524	2048	0	98387
15266	434	119	2045	95059	0	97657
15267	95559	131	673	2281	0	98644
15268	2147	149	97472	712	0	100480
15269	95940	81	1985	559	0	98565
15270	100244	89	631	412	0	101376
15271	98810	102	424	415	0	99751
15272	96378	101	368	427	0	97274
15273	2476	95008	413	531	0	98428
15274	811	91891	338	406	0	93446
15275	599	91650	329	462	0	93040
15276	551	3182	368	79004	0	83105
15277	367	82755	332	1514	0	84968
15278	80534	1519	246	440	0	82739
15279	1555	79771	302	391	0	82019
15280	565	82074	220	429	0	83288
15281	450	1718	271	80772	0	83211
15282	431	600	234	82791	0	84056
15283	80800	282	221	1905	0	83208
15284	1714	262	258	81380	0	83614
15285	698	253	79777	1800	0	82528
15286	603	259	77044	627	0	78533
15287	538	215	79099	489	0	80341
15288	589	196	1811	75486	0	78082
15289	566	196	511	82750	0	84023
15290	591	267	80749	1991	0	83598
15291	617	329	79606	726	0	81278
15292	529	312	81833	465	0	83139
15293	79663	312	2138	452	0	82565
15294	1911	389	685	82051	0	85036
15295	671	318	426	83668	0	85083
15296	82803	374	383	2270	0	85830
15297	1919	308	418	81340	0	83985
15298	719	82375	350	2095	0	85539
15299	487	85672	352	979	0	87490
15300	499	2025	272	84427	0	87223
15301	84502	604	350	2081	0	87537
15302	85043	324	354	893	0	86614
15303	85749	240	397	714	0	87100
15304	2360	239	462	84233	0	87294
15305	921	225	82677	2161	0	85984
15306	607	214	1991	82436	0	85248
15307	593	200	82689	2163	0	85645
15308	77959	182	2085	934	0	81160
15309	2032	230	844	80368	0	83474
15310	79067	199	636	2097	0	81999
15311	2156	205	79612	1005	0	82978
15312	73617	237	1982	707	0	76543
15313	2323	209	82350	650	0	85532
15314	983	78064	1915	701	0	81663
15315	819	77584	702	603	0	79708
15316	74429	2011	573	604	0	77617
15317	2031	707	329	74160	0	77227
15318	903	458	75378	1890	0	78629
15319	655	74588	1694	860	0	77797
15320	573	76933	648	650	0	78804
15321	625	2039	424	75891	0	78979
15322	76097	649	419	1956	0	79121
15323	76494	359	394	897	0	78144
15324	2172	76095	481	727	0	79475
15325	76187	1741	447	653	0	79028
15326	1993	652	490	75786	0	78921
15327	991	419	75652	2019	0	79081
15328	666	76171	1874	1048	0	79759
15329	729	1688	844	76083	0	79344
15330	644	644	585	77545	0	79418
15331	76260	446	492	2224	0	79422
15332	2081	347	75801	911	0	79140
15333	74085	376	1839	670	0	76970
15334	76517	380	785	577	0	78259
15335	2378	422	507	74663	0	77970
15336	1120	403	401	76830	0	78754
15337	74775	431	455	2221	0	77882
15338	2105	525	426	74579	0	77635
15339	929	537	74191	1996	0	77653
15340	645	460	73046	869	0	75020
15341	552	71922	1842	769	0	75085
15342	615	76508	677	697	0	78497
15343	579	2069	464	69002	0	72114
15344	559	73291	385	1734	0	75969
15345	73049	1795	347	885	0	76076
15346	1662	74871	445	776	0	77754
15347	763	1822	340	74104	0	77029
15348	579	677	348	76437	0	78041
15349	532	492	74908	2278	0	78210
15350	523	310	1804	73841	0	76478
15351	535	322	814	75899	0	77570
15352	512	76643	586	2264	0	80005
15353	564	1643	488	76035	0	78730
15354	543	535	464	78386	0	79928
15355	729	397	76351	2387	0	79864
15356	482	75058	1904	1217	0	78661
15357	474	4542	669	63752	0	69437
15358	357	69285	491	1594	0	71727
15359	481	1353	66403	760	0	68997
15360	350	64918	1398	635	0	67301
15361	49764	1441	818	560	0	52583
15362	47605	293	271	190	0	48359
15363	47516	177	112	130	0	47935
15364	838	47697	107	138	0	48780
15365	47253	632	82	135	0	48102
15366	710	292	70	46709	0	47781
15367	45505	157	88	671	0	46421
15368	682	44795	83	358	0	45918
15369	44373	633	61	200	0	45267
15370	46095	265	66	206	0	46632
15371	821	47016	103	283	0	48223
15372	417	704	47176	138	0	48435
15373	167	316	701	50872	0	52056
15374	198	185	55547	861	0	56791
15375	142	132	956	56523	0	57753
15376	129	119	336	60852	0	61436
15377	144	141	61500	1343	0	63128
15378	152	121	1072	61398	0	62743
15379	62059	124	398	1285	0	63866
15380	1177	133	62410	476	0	64196
15381	374	62512	1130	326	0	64342
15382	227	1151	360	61181	0	62919
15383	170	387	164	63801	0	64522
15384	187	218	62895	1427	0	64727
15385	189	211	1352	58163	0	59915
15386	145	62560	376	1196	0	64277
15387	59544	1125	195	482	0	61346
15388	952	61442	156	300	0	62850
15389	57149	1021	105	181	0	58456
15390	916	58583	115	217	0	59831
15391	261	60665	140	191	0	61257
15392	205	1188	57163	180	0	58736
15393	131	425	1032	56908	0	58496
15394	113	157	313	57670	0	58253
15395	138	120	176	58493	0	58927
15396	112	61534	150	1333	0	63129
15397	125	1127	156	62113	0	63521
15398	61613	318	145	1373	0	63449
15399	1174	163	166	62085	0	63588
15400	61557	126	196	1420	0	63299
15401	1288	186	62317	522	0	64313
15402	60592	156	1245	389	0	62382
15403	1250	195	388	62207	0	64040
15404	417	195	233	65222	0	66067
15405	65376	199	229	1620	0	67424
15406	1296	231	66156	619	0	68302
15407	389	65710	1286	430	0	67815
15408	266	1334	382	65291	0	67273
15409	66331	458	240	1358	0	68387
15410	67020	335	186	532	0	68073
15411	1554	354	159	65631	0	67698
15412	531	309	66436	1405	0	68681
15413	61847	314	1320	569	0	64050
15414	1336	307	64210	449	0	66302
15415	535	249	1356	63054	0	65194
15416	289	265	64085	1555	0	66194
15417	296	335	1309	62775	0	64715
15418	283	216	61755	1594	0	63848
15419	300	61732	1289	762	0	64083
15420	503	1305	421	51137	0	53366
15421	268	61773	283	1230	0	63554
15422	62473	1242	238	532	0	64485
15423	62813	377	260	445	0	63895
15424	1586	295	61649	397	0	63927
15425	657	194	1252	61007	0	63110
15426	61832	224	463	1495	0	64014
15427	1440	226	325	61749	0	63740
15428	611	226	263	61723	0	62823
15429	477	233	60834	1675	0	63219
15430	56649	239	1395	781	0	59064
15431	1484	274	60859	601	0	63218
15432	661	196	1439	59494	0	61790
15433	566	188	60873	1594	0	63221
15434	59951	215	1503	776	0	62445
15435	61110	169	660	685	0	62624
15436	60475	273	569	520	0	61837
15437	1709	239	458	58990	0	61396
15438	696	237	59190	1613	0	61736
15439	480	315	59811	802	0	61408
15440	527	374	1664	52335	0	54900
15441	420	58281	712	1492	0	60905
15442	55988	1264	525	799	0	58576
15443	1582	603	359	56026	0	58570
15444	748	381	56580	1566	0	59275
15445	698	346	1332	56868	0	59244
15446	667	277	59058	1578	0	61580
15447	711	344	1460	58414	0	60929
15448	654	235	60112	1728	0	62729
15449	637	253	59761	969	0	61620
15450	569	57368	1678	1057	0	60672
15451	594	1148	58355	757	0	60854
15452	698	446	58480	755	0	60379
15453	719	416	1826	45845	0	48806
15454	711	284	829	47739	0	49563
15455	670	55544	605	1564	0	58383
15456	55166	1096	643	716	0	57621
15457	1636	55289	618	694	0	58237
15458	910	1225	611	54523	0	57269
15459	55310	471	703	1485	0	57969
15460	1622	253	584	55151	0	57610
15461	55343	235	737	1646	0	57961
15462	1604	241	675	56335	0	58855
15463	789	275	56581	1807	0	59452
15464	655	316	1561	56408	0	58940
15465	635	296	815	57041	0	58787
15466	56738	287	793	1769	0	59587
15467	56668	225	830	1060	0	58783
15468	54743	216	889	829	0	56677
15469	1625	54528	1012	823	0	57988
15470	665	53923	849	894	0	56331
15471	52251	1201	947	742	0	55141
15472	1302	517	53875	721	0	56415
15473	655	351	50565	647	0	52218
15474	798	1609	1663	42804	0	46874
15475	521	244	44577	1064	0	46406
15476	515	141	41495	588	0	42739
15477	37777	215	1261	584	0	39837
15478	37532	213	618	494	0	38857
15479	995	39427	413	531	0	41366
15480	504	40124	459	568	0	41655
15481	554	814	473	29509	0	31350
15482	427	39410	531	773	0	41141
15483	39926	625	512	572	0	41635
15484	866	282	468	34752	0	36368
15485	489	39148	453	854	0	40944
15486	40050	609	433	526	0	41618
15487	949	324	40372	430	0	42075
15488	582	204	39779	463	0	41028
15489	38573	162	1036	483	0	40254
15490	850	164	38561	484	0	40059
15491	35938	106	930	475	0	37449
15492	803	154	543	38743	0	40243
15493	453	233	38794	804	0	40284
15494	366	38028	877	500	0	39771
15495	358	38925	613	403	0	40299
15496	34126	445	539	322	0	35432
15497	475	34649	488	354	0	35966
15498	32385	326	389	297	0	33397
15499	32254	94	413	224	0	32985
15500	485	32304	360	200	0	33349
15501	247	384	299	31755	0	32685
15502	205	177	32501	405	0	33288
15503	132	34016	556	162	0	34866
15504	122	1367	247	33006	0	34742
15505	128	198	249	34917	0	35492
15506	33626	38	49	455	0	34168
15507	392	36	43	33363	0	33834
15508	120	48	33368	442	0	33978
15509	47	33233	421	217	0	33918
15510	45	390	116	33533	0	34084
15511	33941	84	155	430	0	34610
15512	34695	52	91	187	0	35025
15513	506	49	137	34684	0	35376
15514	36046	39	163	456	0	36704
15515	558	92	36644	154	0	37448
15516	175	55	623	36222	0	37075
15517	103	70	37435	569	0	38177
15518	85	69	570	40157	0	40881
15519	95	56	184	40380	0	40715
15520	81	114	92	40818	0	41105
15521	129	64	57	40458	0	40708
15522	102	101	46	40846	0	41095
15523	39777	72	49	944	0	40842
15524	40178	41	32	314	0	40565
15525	790	40119	62	255	0	41226
15526	40282	637	67	194	0	41180
15527	742	174	62	40429	0	41407
15528	227	74	107	41087	0	41495
15529	217	54	65	40881	0	41217
15530	171	64	41024	980	0	42239
15531	234	78	688	37821	0	38821
15532	183	40670	187	738	0	41778
15533	40288	696	108	257	0	41349
15534	40093	235	111	163	0	40602
15535	891	164	39903	137	0	41095
15536	317	40022	708	227	0	41274
15537	215	702	261	39830	0	41008
15538	153	197	40799	756	0	41905
15539	168	123	746	36683	0	37720
15540	122	39845	322	757	0	41046
15541	38312	688	198	261	0	39459
15542	752	39228	135	291	0	40406
15543	329	737	39274	158	0	40498
15544	357	311	39171	199	0	40038
15545	156	38344	812	178	0	39490
15546	111	37120	216	188	0	37635
15547	35689	739	211	185	0	36824
15548	35861	233	76	173	0	36343
15549	791	135	99	35554	0	36579
15550	294	110	35769	736	0	36909
15551	190	124	633	35018	0	35965
15552	162	109	186	35913	0	36370
15553	35064	90	110	859	0	36123
15554	34165	102	124	339	0	34730
15555	810	111	102	36403	0	37426
15556	290	85	36709	844	0	37928
15557	164	36747	693	406	0	38010
15558	36468	706	219	253	0	37646
15559	741	37731	129	291	0	38892
15560	324	775	103	37766	0	38968
15561	202	298	114	39428	0	40042
15562	151	142	138	39089	0	39520
15563	154	125	126	38316	0	38721
15564	37195	128	138	1100	0	38561
15565	827	142	86	37096	0	38151
15566	343	36706	99	971	0	38119
15567	214	760	126	37130	0	38230
15568	35932	248	109	1012	0	37301
15569	775	36427	169	473	0	37844
15570	346	760	113	36586	0	37805
15571	239	320	35733	980	0	37272
15572	34499	177	775	472	0	35923
15573	916	146	263	35627	0	36952
15574	380	150	35064	979	0	36573
15575	296	142	34913	440	0	35791
15576	366	284	943	34399	0	35992
15577	34375	164	389	991	0	35919
15578	34646	160	194	470	0	35470
15579	991	35659	167	405	0	37222
15580	35372	742	117	401	0	36632
15581	35484	258	155	377	0	36274
15582	35333	155	183	364	0	36035
15583	35226	143	164	390	0	35923
15584	1034	191	161	34367	0	35753
15585	449	195	122	35076	0	35842
15586	322	161	33803	1123	0	35409
15587	252	32350	736	597	0	33935
15588	211	33702	272	468	0	34653
15589	267	850	32744	415	0	34276
15590	31545	292	760	343	0	32940
15591	852	199	255	32485	0	33791
15592	32864	195	151	896	0	34106
15593	32784	151	157	436	0	33528
15594	984	194	32180	340	0	33698
15595	435	155	721	31684	0	32995
15596	31988	154	310	874	0	33326
15597	831	159	191	32014	0	33195
15598	418	219	32343	894	0	33874
15599	337	769	735	29976	0	31817
15600	299	33054	305	778	0	34436
15601	269	33986	197	424	0	34876
15602	419	770	32198	308	0	33695
15603	221	30643	686	260	0	31810
15604	28229	609	375	385	0	29598
15605	27617	210	159	196	0	28182
15606	664	126	113	27280	0	28183
15607	307	115	101	27791	0	28314
15608	221	104	115	28243	0	28683
15609	27650	115	85	679	0	28529
15610	596	27616	89	340	0	28641
15611	26977	446	70	187	0	27680
15612	26320	168	89	151	0	26728
15613	630	26638	96	182	0	27546
15614	24511	359	62	151	0	25083
15615	433	24770	74	142	0	25419
15616	24783	369	77	169	0	25398
15617	461	147	24623	173	0	25404
15618	20099	151	396	124	0	20770
15619	277	21799	122	126	0	22324
15620	189	322	149	21660	0	22320
15621	107	81	36	22509	0	22733
15622	111	55	28	22914	0	23108
15623	23116	42	35	405	0	23598
15624	313	50	45	23421	0	23829
15625	169	53	22881	349	0	23452
15626	21961	57	262	206	0	22486
15627	333	72	22772	113	0	23290
15628	146	71	288	22509	0	23014
15629	165	75	23557	326	0	24123
15630	80	91	283	22584	0	23038
15631	80	23580	139	337	0	24136
15632	73	274	88	23119	0	23554
15633	90	23508	65	290	0	23953
15634	104	275	55	23651	0	24085
15635	23594	112	52	337	0	24095
15636	337	50	39	24682	0	25108
15637	24672	44	41	339	0	25096
15638	355	62	23614	159	0	24190
15639	23539	49	249	111	0	23948
15640	24484	61	102	90	0	24737
15641	24339	60	49	68	0	24516
15642	422	56	42	24339	0	24859
15643	24167	57	52	300	0	24576
15644	364	66	23490	133	0	24053
15645	23160	58	270	113	0	23601
15646	347	58	23685	96	0	24186
15647	23157	41	296	94	0	23588
15648	343	48	116	24068	0	24575
15649	193	63	24737	310	0	25303
15650	132	44	280	24409	0	24865
15651	125	59	129	25058	0	25371
15652	101	33	24781	414	0	25329
15653	21826	41	291	226	0	22384
15654	294	25471	126	171	0	26062
15655	24552	201	78	112	0	24943
15656	255	24558	53	84	0	24950
15657	23948	226	95	71	0	24340
15658	231	74	23722	76	0	24103
15659	20707	115	285	74	0	21181
15660	156	22707	74	84	0	23021
15661	106	112	42	22415	0	22675
15662	42	35	40	22849	0	22966
15663	49	18	24	22989	0	23080
15664	54	22	23018	169	0	23263
15665	41	12	133	22367	0	22553
15666	55	20	23908	157	0	24140
15667	24138	12	144	72	0	24366
15668	25794	11	64	92	0	25961
15669	234	12	29	26469	0	26744
15670	86	25	26939	203	0	27253
15671	24763	20	199	113	0	25095
15672	280	31	32985	53	0	33349
15673	85	40	305	32172	0	32602
15674	60	14	80	33951	0	34105
15675	47	25	38	34809	0	34919
15676	50	38	41	35269	0	35398
15677	34159	19	40	457	0	34675
15678	358	34994	46	173	0	35571
15679	179	346	33594	74	0	34193
15680	68	34045	360	91	0	34564
15681	34088	357	85	71	0	34601
15682	393	89	48	34110	0	34640
15683	34470	32	57	423	0	34982
15684	395	31	41	34693	0	35160
15685	122	31	52	34672	0	34877
15686	86	31	41	35023	0	35181
15687	90	24	34347	487	0	34948
15688	65	33945	372	253	0	34635
15689	135	357	34661	102	0	35255
15690	86	74	398	34556	0	35114
15691	35233	50	122	450	0	35855
15692	35151	36	70	208	0	35465
15693	35101	40	61	143	0	35345
15694	456	35422	61	126	0	36065
15695	36543	349	51	168	0	37111
15696	427	108	50	36736	0	37321
15697	161	59	57	37030	0	37307
15698	88	56	65	36647	0	36856
15699	96	37131	57	529	0	37813
15700	138	374	74	34257	0	34843
15701	86	36140	61	417	0	36704
15702	36019	381	75	196	0	36671
15703	35989	115	61	176	0	36341
15704	515	45	66	36380	0	37006
15705	204	61	35793	467	0	36525
15706	34410	54	412	222	0	35098
15707	445	69	128	36298	0	36940
15708	179	68	36400	485	0	37132
15709	33909	49	401	281	0	34640
15710	471	57	122	36787	0	37437
15711	36497	51	70	493	0	37111
15712	429	36414	94	240	0	37177
15713	198	408	57	35769	0	36432
15714	142	37447	67	504	0	38160
15715	159	438	73	37558	0	38228
15716	130	37860	74	486	0	38550
15717	165	409	68	38058	0	38700
15718	118	146	37714	459	0	38437
15719	29474	82	377	310	0	30243
15720	391	37329	107	228	0	38055
15721	228	333	36444	193	0	37198
15722	34634	106	340	175	0	35255
15723	405	61	113	36743	0	37322
15724	194	73	36875	404	0	37546
15725	125	37465	361	263	0	38214
15726	93	337	110	38041	0	38581
15727	178	115	38515	406	0	39214
15728	119	68	298	37960	0	38445
15729	124	99	98	38713	0	39034
15730	172	104	39426	470	0	40172
15731	136	117	346	38954	0	39553
15732	154	112	40219	435	0	40920
15733	121	131	363	39846	0	40461
15734	152	108	42474	491	0	43225
15735	138	88	363	42392	0	42981
15736	164	61	121	42623	0	42969
15737	169	106	106	41908	0	42289
15738	153	42118	109	585	0	42965
15739	42157	379	111	293	0	42940
15740	42134	127	154	247	0	42662
15741	490	105	120	42907	0	43622
15742	42846	86	154	543	0	43629
15743	427	110	42908	297	0	43742
15744	186	43633	377	291	0	44487
15745	43848	350	148	282	0	44628
15746	396	44567	137	271	0	45371
15747	208	402	100	44765	0	45475
15748	147	192	117	45272	0	45728
15749	43669	114	126	569	0	44478
15750	409	125	97	43834	0	44465
15751	237	105	43759	512	0	44613
15752	161	43458	370	352	0	44341
15753	43500	368	138	248	0	44254
15754	409	168	102	43018	0	43697
15755	208	44482	111	557	0	45358
15756	208	427	106	43438	0	44179
15757	133	45179	156	523	0	45991
15758	45298	432	125	302	0	46157
15759	44781	172	154	247	0	45354
15760	544	141	44604	237	0	45526
15761	286	119	44087	213	0	44705
15762	204	102	455	43617	0	44378
15763	172	45333	182	491	0	46178
15764	169	372	132	45897	0	46570
15765	45482	159	103	555	0	46299
15766	423	129	44280	264	0	45096
15767	204	79	308	41940	0	42531
15768	170	77	42640	377	0	43264
15769	168	87	41015	250	0	41520
15770	102	43328	410	188	0	44028
15771	578	648	213	41679	0	43118
15772	37624	108	105	221	0	38058
15773	198	54	37944	102	0	38298
15774	70	37200	142	104	0	37516
15775	36728	77	59	78	0	36942
15776	91	53	47	36682	0	36873
15777	37914	31	28	204	0	38177
15778	37945	48	31	144	0	38168
15779	38093	19	28	125	0	38265
15780	160	46	40084	60	0	40350
15781	37381	25	98	77	0	37581
15782	40294	17	49	98	0	40458
15783	128	41781	52	83	0	42044
15784	74	105	30	42187	0	42396
15785	66	56	25	42059	0	42206
15786	47	40	33	42365	0	42485
15787	42240	37	36	204	0	42517
15788	40724	25	33	120	0	40902
15789	194	70	41487	53	0	41804
15790	93	26	120	40903	0	41142
15791	47	41488	69	178	0	41782
15792	41729	125	52	101	0	42007
15793	185	84	41519	59	0	41847
15794	84	27	126	40431	0	40668
15795	47	32	55	40983	0	41117
15796	32	41175	63	198	0	41468
15797	49	137	31	41392	0	41609
15798	42	77	31	40893	0	41043
15799	52	37	28	41288	0	41405
15800	41060	27	32	213	0	41332
15801	156	30	30	40806	0	41022
15802	80	31	25	40982	0	41118
15803	41558	31	21	283	0	41893
15804	192	30	34	41257	0	41513
15805	90	47271	48	224	0	47633
15806	49625	405	34	126	0	50190
15807	51662	171	29	173	0	52035
15808	53317	70	38	99	0	53524
15809	58882	41	33	122	0	59078
15810	1019	64012	53	122	0	65206
15811	72718	994	25	101	0	73838
15812	73641	273	36	103	0	74053
15813	1649	116	28	72803	0	74596
15814	491	85	72148	1396	0	74120
15815	219	45	1305	71838	0	73407
15816	159	50	304	72723	0	73236
15817	114	50	108	72172	0	72444
15818	113	45	94	72280	0	72532
15819	120	42	37	72959	0	73158
15820	70331	36	79	1809	0	72255
15821	1441	65	41	70930	0	72477
15822	432	66	71769	1562	0	73829
15823	226	44	1338	69437	0	71045
15824	140	71214	338	1505	0	73197
15825	134	1352	151	71351	0	72988
15826	138	337	71393	1546	0	73414
15827	62805	143	1415	566	0	64929
15828	68259	83	348	300	0	68990
15829	1820	66	71702	210	0	73798
15830	488	71230	1387	252	0	73357
15831	72503	1412	411	216	0	74542
15832	73215	354	151	193	0	73913
15833	73258	172	100	179	0	73709
15834	71571	92	84	170	0	71917
15835	2085	109	69	69407	0	71670
15836	801	169	70095	1537	0	72602
15837	575	126	1438	69909	0	72048
15838	470	131	365	72481	0	73447
15839	438	161	71443	1984	0	74026
15840	442	198	71046	733	0	72419
15841	68633	148	1818	566	0	71165
15842	1783	70721	606	630	0	73740
15843	807	1489	316	71266	0	73878
15844	567	384	70250	2083	0	73284
15845	65824	185	1712	1125	0	68846
15846	1843	151	69953	904	0	72851
15847	67122	122	1713	968	0	69925
15848	1787	69740	603	963	0	73093
15849	736	1545	343	70555	0	73179
15850	636	516	69674	2180	0	73006
15851	65402	260	1694	1099	0	68455
15852	1855	68942	716	839	0	72352
15853	792	72614	479	725	0	74610
15854	677	1964	440	70440	0	73521
15855	559	762	438	74095	0	75854
15856	75833	466	436	2348	0	79083
15857	2290	75356	443	1035	0	79124
15858	1201	1838	418	76694	0	80151
15859	76492	560	421	2212	0	79685
15860	79254	358	415	992	0	81019
15861	81447	327	442	800	0	83016
15862	3095	329	81673	734	0	85831
15863	1457	282	82958	814	0	85511
15864	85902	220	2487	838	0	89447
15865	2779	87686	979	932	0	92376
15866	1088	90065	747	1118	0	93018
15867	940	2703	673	83031	0	87347
15868	631	88189	680	2792	0	92292
15869	88376	2481	668	1256	0	92781
15870	2711	759	714	87898	0	92082
15871	1246	553	87717	2770	0	92286
15872	86948	402	2698	1141	0	91189
15873	89256	447	1006	835	0	91544
15874	3287	476	760	87491	0	92014
15875	1427	402	735	89291	0	91855
15876	1183	394	734	89916	0	92227
15877	1068	480	594	89317	0	91459
15878	1079	561	84564	3338	0	89542
15879	981	84279	2562	1488	0	89310
15880	1067	2566	910	73252	0	77795
15881	844	83832	812	2686	0	88174
15882	1003	2741	706	72182	0	76632
15883	789	82117	581	2689	0	86176
15884	81318	2768	584	1271	0	85941
15885	82226	1004	541	1080	0	84851
15886	3322	81406	624	1084	0	86436
15887	82167	2568	559	907	0	86201
15888	3311	1012	632	81342	0	86297
15889	80958	775	654	2781	0	85168
15890	3270	80908	629	1261	0	86068
15891	81542	2640	716	849	0	85747
15892	83349	1014	754	687	0	85804
15893	3535	774	779	80265	0	85353
15894	1625	846	80530	2709	0	85710
15895	1186	79829	2692	1206	0	84913
15896	1068	2792	956	80174	0	84990
15897	80381	1324	763	2837	0	85305
15898	3110	1055	79670	1342	0	85177
15899	1479	865	2530	78326	0	83200
15900	1291	793	921	80589	0	83594
15901	80327	630	683	3351	0	84991
15902	81548	647	662	1654	0	84511
15903	79919	615	671	1349	0	82554
15904	3553	77714	687	1274	0	83228
15905	72504	2249	533	1191	0	76477
15906	2680	811	68616	1190	0	73297
15907	1151	665	67146	1160	0	70122
15908	939	615	66251	1042	0	68847
15909	1153	3730	2785	54345	0	62013
15910	649	489	53404	1699	0	56241
15911	44591	358	1085	552	0	46586
15912	1242	338	318	45308	0	47206
15913	627	339	46189	1247	0	48402
15914	46243	374	967	663	0	48247
15915	1311	289	351	46810	0	48761
15916	668	345	259	48002	0	49274
15917	47650	330	229	1361	0	49570
15918	1320	360	251	48499	0	50430
15919	627	403	48642	1288	0	50960
15920	564	340	1079	49108	0	51091
15921	619	346	49555	1274	0	51794
15922	582	342	1144	48595	0	50663
15923	47439	321	401	1325	0	49486
15924	1364	46838	340	662	0	49204
15925	740	48384	288	542	0	49954
15926	622	1219	270	47258	0	49369
15927	610	439	311	46552	0	47912
15928	516	46538	283	1428	0	48765
15929	555	46016	320	673	0	47564
15930	544	1128	368	44604	0	46644
15931	490	391	384	45158	0	46423
15932	43107	263	376	1462	0	45208
15933	1229	42900	344	760	0	45233
15934	604	43074	351	598	0	44627
15935	501	44162	358	546	0	45567
15936	42254	1137	423	479	0	44293
15937	1247	418	41974	480	0	44119
15938	40674	265	1177	518	0	42634
15939	1245	219	468	40393	0	42325
15940	535	39523	375	1263	0	41696
15941	489	41883	309	605	0	43286
15942	41032	1078	287	553	0	42950
15943	1232	379	368	38080	0	40059
15944	479	42403	323	1223	0	44428
15945	43074	1028	354	614	0	45070
15946	43605	344	349	540	0	44838
15947	1342	343	42773	471	0	44929
15948	42351	307	1095	508	0	44261
15949	43325	306	377	499	0	44507
15950	1355	284	307	40811	0	42757
15951	500	41244	286	1304	0	43334
15952	420	42491	285	655	0	43851
15953	446	1458	228	40346	0	42478
15954	39088	406	301	1220	0	41015
15955	1092	314	38086	556	0	40048
15956	414	275	34785	343	0	35817
15957	623	284	33929	318	0	35154
15958	558	231	33727	334	0	34850
15959	264	33026	941	361	0	34592
15960	282	32097	414	362	0	33155
15961	462	830	29242	235	0	30769
15962	329	412	28073	272	0	29086
15963	151	25061	666	287	0	26165
15964	143	274	194	20114	0	20725
15965	59	79	21650	240	0	22028
15966	40	39	248	20855	0	21182
15967	29	32	68	22299	0	22428
15968	29	38	39	22799	0	22905
15969	39	31	19	24191	0	24280
15970	50	31	23900	385	0	24366
15971	45	25	321	22960	0	23351
15972	23430	29	93	351	0	23903
15973	357	34	23071	106	0	23568
15974	23046	35	332	96	0	23509
15975	372	33	89	23744	0	24238
15976	119	41	24194	345	0	24699
15977	23775	43	348	115	0	24281
15978	375	49	98	24299	0	24821
15979	24536	36	58	405	0	25035
15980	405	71	43	23451	0	23970
15981	109	24052	58	408	0	24627
15982	129	338	25069	137	0	25673
15983	61	101	377	24835	0	25374
15984	25485	55	118	387	0	26045
15985	25662	44	64	140	0	25910
15986	25654	59	69	102	0	25884
15987	25455	46	67	93	0	25661
15988	24684	54	60	87	0	24885
15989	409	25056	61	90	0	25616
15990	25179	400	78	81	0	25738
15991	401	113	24885	92	0	25491
15992	24716	67	383	109	0	25275
15993	418	90	174	20472	0	21154
15994	128	97	24955	271	0	25451
15995	97	72	24943	126	0	25238
15996	74	69	449	24503	0	25095
15997	24883	65	133	408	0	25489
15998	399	24744	90	197	0	25430
15999	24469	399	76	111	0	25055
16000	426	24951	65	120	0	25562
16001	182	400	85	25250	0	25917
16002	142	128	93	25930	0	26293
16003	25647	89	85	482	0	26303
16004	445	67	90	25763	0	26365
16005	218	88	25734	453	0	26493
16006	25251	83	406	207	0	25947
16007	462	70	156	26130	0	26818
16008	206	71	96	26295	0	26668
16009	154	73	26073	524	0	26824
16010	24141	58	431	194	0	24824
16011	25783	72	181	120	0	26156
16012	521	25779	134	160	0	26594
16013	228	374	24875	96	0	25573
16014	177	116	24019	88	0	24400
16015	150	175	481	23257	0	24063
16016	151	124	177	22839	0	23291
16017	107	23409	134	460	0	24110
16018	156	332	22664	139	0	23291
16019	117	95	387	21760	0	22359
16020	130	68	22661	369	0	23228
16021	90	50	384	21025	0	21549
16022	86	21997	167	349	0	22599
16023	99	331	116	22359	0	22905
16024	97	93	117	22551	0	22858
16025	110	70	108	22433	0	22721
16026	22121	47	109	448	0	22725
16027	374	69	22060	192	0	22695
16028	136	22952	366	178	0	23632
16029	109	341	145	24136	0	24731
16030	24755	109	117	471	0	25452
16031	448	70	100	25177	0	25795
16032	25378	41	107	537	0	26063
16033	535	45	25760	233	0	26573
16034	25234	36	476	178	0	25924
16035	540	51	173	26627	0	27391
16036	250	61	26770	539	0	27620
16037	162	26657	486	244	0	27549
16038	193	456	175	26340	0	27164
16039	171	123	110	26983	0	27387
16040	26178	65	98	591	0	26932
16041	510	26113	120	249	0	26992
16042	208	25712	108	186	0	26214
16043	142	26263	120	157	0	26682
16044	23825	481	95	151	0	24552
16045	467	24222	98	112	0	24899
16046	175	391	106	23631	0	24303
16047	161	131	73	24115	0	24480
16048	23714	94	57	505	0	24370
16049	424	23661	71	221	0	24377
16050	164	400	62	23995	0	24621
16051	24316	129	68	446	0	24959
16052	24284	68	88	184	0	24624
16053	24084	66	77	119	0	24346
16054	499	24010	79	142	0	24730
16055	23115	325	69	125	0	23634
16056	380	208	56	22423	0	23067
16057	144	22281	49	388	0	22862
16058	126	23109	54	170	0	23459
16059	167	396	47	22850	0	23460
16060	22798	135	91	363	0	23387
16061	23117	84	73	198	0	23472
16062	414	71	57	22087	0	22629
16063	153	22261	48	382	0	22844
16064	22331	300	99	192	0	22922
16065	384	130	21470	109	0	22093
16066	172	78	20877	99	0	21226
16067	20073	76	360	125	0	20634
16068	324	68	20339	81	0	20812
16069	108	51	251	18328	0	18738
16070	18602	25	107	263	0	18997
16071	251	61	50	18940	0	19302
16072	124	30	19001	279	0	19434
16073	68	19132	243	162	0	19605
16074	75	229	79	19267	0	19650
16075	73	99	19071	261	0	19504
16076	17463	66	219	141	0	17889
16077	234	44	80	18845	0	19203
16078	119	55	18908	260	0	19342
16079	85	33	233	18431	0	18782
16080	75	18611	82	280	0	19048
16081	76	235	50	19321	0	19682
16082	72	99	31	18993	0	19195
16083	63	65	45	18633	0	18806
16084	70	18652	35	329	0	19086
16085	18905	227	45	159	0	19336
16086	259	86	40	19108	0	19493
16087	100	72	43	19370	0	19585
16088	86	71	38	19527	0	19722
16089	81	80	19164	346	0	19671
16090	80	51	224	19181	0	19536
16091	19204	63	79	331	0	19677
16092	277	19464	52	159	0	19952
16093	107	293	33	19803	0	20236
16094	96	123	32	20032	0	20283
16095	19651	109	17	360	0	20137
16096	291	19735	36	206	0	20268
16097	20091	301	31	141	0	20564
16098	20556	116	28	119	0	20819
16099	376	93	30	20265	0	20764
16100	20367	57	31	328	0	20783
16101	351	19682	29	176	0	20238
16102	19819	283	27	129	0	20258
16103	369	122	38	20237	0	20766
16104	22328	80	37	372	0	22817
16105	23062	65	42	142	0	23311
16106	484	92	22523	109	0	23208
16107	22926	64	302	114	0	23406
16108	23682	61	83	112	0	23938
16109	25103	64	51	109	0	25327
16110	631	88	26054	89	0	26862
16111	200	26249	523	112	0	27084
16112	140	536	133	26328	0	27137
16113	26362	153	75	566	0	27156
16114	570	26077	60	213	0	26920
16115	26014	540	58	118	0	26730
16116	634	152	49	26312	0	27147
16117	241	84	26415	591	0	27331
16118	26778	47	574	205	0	27604
16119	628	58	165	27796	0	28647
16120	237	52	27790	620	0	28699
16121	27667	41	620	246	0	28574
16122	703	53	28841	125	0	29722
16123	237	56	641	29502	0	30436
16124	142	46	204	31342	0	31734
16125	31106	54	98	883	0	32141
16126	31039	44	71	300	0	31454
16127	866	31209	69	241	0	32385
16128	30994	639	99	154	0	31886
16129	776	151	29583	92	0	30602
16130	221	103	29774	74	0	30172
16131	28514	126	747	89	0	29476
16132	659	29433	229	104	0	30425
16133	28417	555	86	60	0	29118
16134	642	28610	83	84	0	29419
16135	28268	576	45	79	0	28968
16136	644	160	72	27788	0	28664
16137	307	70	28720	594	0	29691
16138	160	45	574	28561	0	29340
16139	140	39	186	29814	0	30179
16140	29269	39	88	769	0	30165
16141	663	47	29002	241	0	29953
16142	28102	41	580	149	0	28872
16143	653	28741	181	127	0	29702
16144	29012	590	93	75	0	29770
16145	686	172	84	28601	0	29543
16146	281	124	28750	619	0	29774
16147	196	75	597	28676	0	29544
16148	28931	58	218	678	0	29885
16149	700	68	118	29022	0	29908
16150	316	72	112	28684	0	29184
16151	201	28134	108	773	0	29216
16152	206	552	89	28633	0	29480
16153	178	175	28401	726	0	29480
16154	202	80	625	28278	0	29185
16155	201	81	223	29082	0	29587
16156	28396	64	149	812	0	29421
16157	727	74	133	28248	0	29182
16158	335	87	28016	744	0	29182
16159	270	28095	646	312	0	29323
16160	265	627	236	27957	0	29085
16161	263	214	145	28496	0	29118
16162	28472	148	149	760	0	29529
16163	765	27938	147	322	0	29172
16164	345	633	134	28376	0	29488
16165	27942	211	160	729	0	29042
16166	28556	133	140	307	0	29136
16167	880	137	127	28380	0	29524
16168	406	108	28607	792	0	29913
16169	28196	117	672	361	0	29346
16170	823	122	270	29857	0	31072
16171	30133	92	182	892	0	31299
16172	30259	93	190	353	0	30895
16173	935	29344	160	323	0	30762
16174	29143	626	164	261	0	30194
16175	857	29772	179	243	0	31051
16176	405	683	159	29672	0	30919
16177	328	259	174	29008	0	29769
16178	285	29593	159	836	0	30873
16179	29847	660	160	406	0	31073
16180	29652	243	173	320	0	30388
16181	964	176	28897	260	0	30297
16182	439	168	28705	263	0	29575
16183	313	122	784	28786	0	30005
16184	29202	120	301	844	0	30467
16185	827	110	192	29214	0	30343
16186	389	122	190	30032	0	30733
16187	326	120	30151	941	0	31538
16188	322	138	29976	426	0	30862
16189	284	126	30502	351	0	31263
16190	28490	168	848	329	0	29835
16191	29837	121	320	301	0	30579
16192	876	29261	200	302	0	30639
16193	410	30214	159	327	0	31110
16194	323	863	147	29963	0	31296
16195	304	280	30022	822	0	31428
16196	28894	168	683	429	0	30174
16197	824	138	31165	343	0	32470
16198	361	117	701	30543	0	31722
16199	284	109	285	31611	0	32289
16200	281	97	171	31795	0	32344
16201	269	103	172	32349	0	32893
16202	31702	107	145	997	0	32951
16203	906	143	121	31351	0	32521
16204	336	109	29724	828	0	30997
16205	26557	68	622	457	0	27704
16206	707	79	28938	280	0	30004
16207	322	95	28935	251	0	29603
16208	235	28786	720	232	0	29973
16209	440	433	315	25565	0	26753
16210	25470	134	161	413	0	26178
16211	386	78	72	25669	0	26205
16212	183	84	25967	433	0	26667
16213	142	52	336	25988	0	26518
16214	25784	56	165	417	0	26422
16215	362	26083	79	324	0	26848
16216	25497	291	78	170	0	26036
16217	382	25676	64	144	0	26266
16218	25529	288	71	213	0	26101
16219	306	25818	54	138	0	26316
16220	144	25969	52	124	0	26289
16221	209	292	24894	76	0	25471
16222	94	24791	288	95	0	25268
16223	22718	170	99	40	0	23027
16224	142	83	32	22288	0	22545
16225	22453	33	21	156	0	22663
16226	152	22997	28	86	0	23263
16227	22514	151	24	49	0	22738
16228	187	60	22801	52	0	23100
16229	71	27	158	22414	0	22670
16230	55	23416	63	177	0	23711
16231	51	157	40	24336	0	24584
16232	37	62	38	24501	0	24638
16233	27921	39	23	269	0	28252
16234	336	28460	35	132	0	28963
16235	28435	357	55	85	0	28932
16236	436	155	29106	47	0	29744
16237	198	79	27978	54	0	28309
16238	83	28237	526	88	0	28934
16239	49	364	197	28237	0	28847
16240	103	150	28625	377	0	29255
16241	45	70	411	26568	0	27094
16242	53	37	166	29207	0	29463
16243	78	35	29089	527	0	29729
16244	76	35	28454	242	0	28807
16245	60	33	29601	102	0	29796
16246	82	46	29587	63	0	29778
16247	54	30421	566	103	0	31144
16248	74	416	225	30464	0	31179
16249	57	199	95	31290	0	31641
16250	93	82	30830	592	0	31597
16251	42	50	436	30132	0	30660
16252	83	61	32392	511	0	33047
16253	61	39	473	31809	0	32382
16254	54	44	204	31865	0	32167
16255	53	32379	105	627	0	33164
16256	54	443	65	32696	0	33258
16257	78	189	61	32644	0	32972
16258	57	96	58	32889	0	33100
16259	117	71	32052	683	0	32923
16260	55	32119	445	343	0	32962
16261	31973	456	204	153	0	32786
16262	31989	196	107	98	0	32390
16263	586	103	68	31854	0	32611
16264	265	74	73	31326	0	31738
16265	111	32575	86	593	0	33365
16266	32283	433	85	264	0	33065
16267	436	32933	103	169	0	33641
16268	32071	475	80	118	0	32744
16269	501	213	31725	93	0	32532
16270	29009	110	467	116	0	29702
16271	459	31770	236	118	0	32583
16272	192	425	121	31899	0	32637
16273	106	215	97	31618	0	32036
16274	57	32187	102	604	0	32950
16275	32051	433	92	287	0	32863
16276	452	207	88	32548	0	33295
16277	211	102	98	33326	0	33737
16278	33368	69	86	684	0	34207
16279	33415	53	104	330	0	33902
16280	653	95	33363	172	0	34283
16281	33007	56	493	148	0	33704
16282	525	78	246	34064	0	34913
16283	256	66	34198	553	0	35073
16284	118	67	512	33485	0	34182
16285	107	70	34267	597	0	35041
16286	91	95	34268	285	0	34739
16287	79	109	669	33561	0	34418
16288	89	83	34789	555	0	35516
16289	66	35264	575	402	0	36307
16290	92	490	260	35226	0	36068
16291	93	245	154	36520	0	37012
16292	120	132	36346	739	0	37337
16293	85	36232	535	420	0	37272
16294	35792	543	249	246	0	36830
16295	546	254	139	36680	0	37619
16296	36713	133	150	608	0	37604
16297	587	36074	124	429	0	37214
16298	362	554	36577	199	0	37692
16299	183	267	586	35970	0	37006
16300	35955	158	332	649	0	37094
16301	593	113	36597	398	0	37701
16302	33309	118	622	285	0	34334
16303	606	36293	358	231	0	37488
16304	267	36676	206	238	0	37387
16305	36362	606	220	215	0	37403
16306	526	284	249	36032	0	37091
16307	253	155	201	35836	0	36445
16308	132	36776	190	772	0	37870
16309	109	479	177	37710	0	38475
16310	90	256	190	37883	0	38419
16311	36992	134	133	832	0	38091
16312	492	76	175	37046	0	37789
16313	258	110	37031	674	0	38073
16314	147	69	605	36661	0	37482
16315	101	97	347	38442	0	38987
16316	116	131	38312	821	0	39380
16317	112	128	494	37904	0	38638
16318	37441	97	280	773	0	38591
16319	36337	97	191	472	0	37097
16320	36775	98	151	330	0	37354
16321	726	101	132	36843	0	37802
16322	367	115	37350	665	0	38497
16323	186	37933	500	472	0	39091
16324	209	520	241	38304	0	39274
16325	221	290	38986	618	0	40115
16326	207	168	471	37986	0	38832
16327	143	129	248	39221	0	39741
16328	38024	110	180	715	0	39029
16329	521	39937	142	499	0	41099
16330	358	539	38970	225	0	40092
16331	34525	260	472	193	0	35450
16332	506	38892	266	280	0	39944
16333	159	35770	104	133	0	36166
16334	36349	301	212	128	0	36990
16335	336	129	65	36785	0	37315
16336	182	113	40775	375	0	41445
16337	108	93	310	39758	0	40269
16338	69	41254	142	384	0	41849
16339	41634	319	69	196	0	42218
16340	361	135	54	42243	0	42793
16341	43218	58	59	423	0	43758
16342	378	52	52	42447	0	42929
16343	153	44208	55	426	0	44842
16344	44807	366	63	173	0	45409
16345	43768	118	66	136	0	44088
16346	492	44623	79	152	0	45346
16347	43777	380	75	123	0	44355
16348	408	153	64	42837	0	43462
16349	153	43404	63	427	0	44047
16350	43853	376	47	180	0	44456
16351	417	44270	61	125	0	44873
16352	43622	371	51	158	0	44202
16353	398	139	68	43484	0	44089
16354	44139	76	40	469	0	44724
16355	44336	78	43	197	0	44654
16356	44118	72	56	132	0	44378
16357	505	68	46	44024	0	44643
16358	193	83	42	44912	0	45230
16359	44008	66	41	524	0	44639
16360	488	102	44888	193	0	45671
16361	192	78	381	44471	0	45122
16362	143	46050	137	478	0	46808
16363	110	457	65	46482	0	47114
16364	128	155	48	46702	0	47033
16365	155	119	46108	591	0	46973
16366	150	110	414	48803	0	49477
16367	153	53514	154	687	0	54508
16368	151	796	72	55234	0	56253
16369	209	311	60934	910	0	62364
16370	152	183	1022	60762	0	62119
16371	176	135	412	63331	0	64054
16372	61777	93	135	1538	0	63543
16373	61642	93	75	644	0	62454
16374	1538	100	69	60590	0	62297
16375	623	60710	82	1228	0	62643
16376	263	61692	81	584	0	62620
16377	529	1398	60295	251	0	62473
16378	237	643	1068	60110	0	62058
16379	60395	186	445	1221	0	62247
16380	1136	139	177	61353	0	62805
16381	527	136	61976	1315	0	63954
16382	241	101	1117	61218	0	62677
16383	236	93	451	62303	0	63083
16384	195	100	168	63483	0	63946
16385	246	121	61578	1679	0	63624
16386	177	61361	1085	795	0	63418
16387	60392	1115	424	381	0	62312
16388	59486	471	189	295	0	60441
16389	1525	222	108	59312	0	61167
16390	656	198	59531	1229	0	61614
16391	279	59585	1103	665	0	61632
16392	275	1235	458	54856	0	56824
16393	194	59577	217	1067	0	61055
16394	183	61082	140	546	0	61951
16395	59064	1446	226	328	0	61064
16396	1230	578	59978	265	0	62051
16397	608	275	59999	261	0	61143
16398	328	230	1406	57983	0	59947
16399	265	170	574	60609	0	61618
16400	303	181	60644	1517	0	62645
16401	231	189	1129	58310	0	59859
16402	321	186	60264	1348	0	62119
16403	54500	157	1215	710	0	56582
16404	1200	165	524	59432	0	61321
16405	634	181	61146	1310	0	63271
16406	344	259	1113	56245	0	57961
16407	288	62567	534	1225	0	64614
16408	61997	1149	238	671	0	64055
16409	1158	62396	217	490	0	64261
16410	62725	1178	231	452	0	64586
16411	1334	575	61617	425	0	63951
16412	60673	272	1153	406	0	62504
16413	1332	224	514	62284	0	64354
16414	682	262	62571	1361	0	64876
16415	410	204	1190	61337	0	63141
16416	323	221	61000	1549	0	63093
16417	55560	222	1257	870	0	57909
16418	1254	60867	605	606	0	63332
16419	675	1197	357	56075	0	58304
16420	371	61716	301	1255	0	63643
16421	60890	1268	283	785	0	63226
16422	60423	584	300	595	0	61902
16423	1536	60737	320	636	0	63229
16424	716	1260	271	60349	0	62596
16425	455	620	262	60725	0	62062
16426	368	317	246	60993	0	61924
16427	59161	285	312	1934	0	61692
16428	1174	59228	348	1120	0	61870
16429	615	1227	322	57801	0	59965
16430	362	616	375	58725	0	60078
16431	56718	356	358	1968	0	59400
16432	1344	299	55945	1034	0	58622
16433	739	303	55474	783	0	57299
16434	52524	227	1577	721	0	55049
16435	1317	262	54538	627	0	56744
16436	717	299	50030	521	0	51567
16437	477	401	1567	47762	0	50207
16438	49600	251	784	1280	0	51915
16439	1213	310	433	49133	0	51089
16440	690	275	48844	1374	0	51183
16441	45502	250	1244	811	0	47807
16442	1265	288	47813	555	0	49921
16443	640	47675	1252	514	0	50081
16444	414	1114	760	48463	0	50751
16445	49107	559	417	1313	0	51396
16446	1040	278	381	49293	0	50992
16447	567	237	400	50107	0	51311
16448	50364	178	311	1598	0	52451
16449	1106	180	314	50718	0	52318
16450	630	191	366	51963	0	53150
16451	427	209	50968	1605	0	53209
16452	306	221	1027	50770	0	52324
16453	51069	217	623	1331	0	53240
16454	50823	253	354	799	0	52229
16455	51261	248	326	485	0	52320
16456	1545	264	332	48799	0	50940
16457	735	49865	307	1135	0	52042
16458	49848	957	318	647	0	51770
16459	1051	50576	330	507	0	52464
16460	49804	1044	297	370	0	51515
16461	1167	520	266	49645	0	51598
16462	49012	241	290	1085	0	50628
16463	49025	188	315	676	0	50204
16464	48775	151	337	454	0	49717
16465	1354	48075	312	426	0	50167
16466	486	44606	225	368	0	45685
16467	40346	556	160	217	0	41279
16468	514	40905	163	245	0	41827
16469	97	35248	60	113	0	35518
16470	63	34501	82	81	0	34727
16471	33844	196	350	130	0	34520
16472	144	94	26	33503	0	33767
16473	89	46	20	34177	0	34332
16474	34252	20	27	231	0	34530
16475	188	49	35003	107	0	35347
16476	101	15	165	41048	0	41329
16477	57	24	69	42373	0	42523
16478	59	25	45	46782	0	46911
16479	49	48	17	48355	0	48469
16480	36	48825	49	1018	0	49928
16481	29	58654	37	370	0	59090
16482	58458	1235	50	167	0	59910
16483	1088	454	26	59268	0	60836
16484	389	159	24	60802	0	61374
16485	236	95	59396	1624	0	61351
16486	89	41	1142	59769	0	61041
16487	139	63	60893	1410	0	62505
16488	68	40	1330	60916	0	62354
16489	143	51	64258	1440	0	65892
16490	43	63304	1451	615	0	65413
16491	87	1277	477	63484	0	65325
16492	64434	431	180	1357	0	66402
16493	63920	159	84	527	0	64690
16494	1714	60	63	63576	0	65413
16495	650	66	63847	1477	0	66040
16496	286	67	63855	560	0	64768
16497	59178	50	1795	301	0	61324
16498	1302	62757	640	268	0	64967
16499	63941	1337	208	163	0	65649
16500	63898	460	110	167	0	64635
16501	1853	229	62703	195	0	64980
16502	693	92	1410	61128	0	63323
16503	299	77	496	64167	0	65039
16504	179	76	236	65801	0	66292
16505	155	84	132	64045	0	64416
16506	131	83	163	63619	0	63996
16507	191	113	59938	2185	0	62427
16508	196	115	60163	892	0	61366
16509	200	94	1886	59561	0	61741
16510	192	110	675	61337	0	62314
16511	209	125	284	62081	0	62699
16512	60403	125	209	2239	0	62976
16513	1593	168	185	60536	0	62482
16514	60690	133	187	1914	0	62924
16515	1775	138	189	61796	0	63898
16516	62444	112	236	2007	0	64799
16517	63618	130	222	927	0	64897
16518	63025	123	285	532	0	63965
16519	63104	125	217	465	0	63911
16520	62899	102	245	467	0	63713
16521	2344	139	231	61301	0	64015
16522	60925	140	231	1898	0	63194
16523	1840	60619	264	1000	0	63723
16524	60798	1532	274	582	0	63186
16525	1905	579	287	61719	0	64490
16526	852	297	61104	1944	0	64197
16527	538	191	1724	61477	0	63930
16528	457	167	62023	2119	0	64766
16529	422	159	1857	60969	0	63407
16530	403	133	746	63495	0	64777
16531	480	139	62069	2442	0	65130
16532	456	182	62311	1162	0	64111
16533	398	160	2221	61262	0	64041
16534	61218	160	888	2120	0	64386
16535	1936	166	61460	1090	0	64652
16536	872	60636	1813	968	0	64289
16537	674	1576	63093	709	0	66052
16538	61072	580	2013	692	0	64357
16539	1972	260	866	62233	0	65331
16540	63182	186	526	2191	0	66085
16541	63965	165	387	1120	0	65637
16542	2414	170	347	63261	0	66192
16543	1196	169	61776	2227	0	65368
16544	718	148	1821	61172	0	63859
16545	648	127	807	61972	0	63554
16546	59197	128	512	2754	0	62591
16547	1972	60474	430	1484	0	64360
16548	985	1604	387	61186	0	64162
16549	809	614	60037	2231	0	63691
16550	56514	312	1878	1235	0	59939
16551	2131	58921	852	895	0	62799
16552	1098	1616	560	59470	0	62744
16553	827	582	410	60164	0	61983
16554	650	307	412	61659	0	63028
16555	58999	174	416	2785	0	62374
16556	60475	158	423	1361	0	62417
16557	2652	158	423	59907	0	63140
16558	1278	186	59280	2342	0	63086
16559	729	59016	1892	1442	0	63079
16560	59445	1649	881	883	0	62858
16561	61277	572	553	802	0	63204
16562	2626	287	456	59423	0	62792
16563	1228	154	464	61946	0	63792
16564	766	166	60666	2823	0	64421
16565	597	60706	1978	1479	0	64760
16566	61775	1711	915	934	0	65335
16567	60383	655	544	754	0	62336
16568	2467	60288	495	799	0	64049
16569	60030	1695	415	713	0	62853
16570	2294	591	379	59473	0	62737
16571	1125	312	58947	2313	0	62697
16572	813	172	1849	59463	0	62297
16573	726	178	59143	2470	0	62517
16574	56655	162	2007	1221	0	60045
16575	2041	57469	889	936	0	61335
16576	943	1627	421	50926	0	53917
16577	694	459	51168	1772	0	54093
16578	570	276	48182	801	0	49829
16579	43147	392	1509	594	0	45642
16580	1280	43695	698	532	0	46205
16581	34761	659	632	318	0	36370
16582	34019	175	349	309	0	34852
16583	34039	113	151	269	0	34572
16584	903	196	189	33123	0	34411
16585	402	116	33321	744	0	34583
16586	262	32822	594	304	0	33982
16587	316	744	239	32803	0	34102
16588	242	172	33109	686	0	34209
16589	213	129	29817	213	0	30372
16590	149	109	510	29107	0	29875
16591	142	61	29191	531	0	29925
16592	26468	59	474	225	0	27226
16593	466	68	166	29021	0	29721
16594	208	52	124	29826	0	30210
16595	29531	77	120	537	0	30265
16596	459	29023	126	289	0	29897
16597	30333	401	112	248	0	31094
16598	489	141	114	30122	0	30866
16599	227	92	77	30420	0	30816
16600	190	80	100	30485	0	30855
16601	189	76	93	29811	0	30169
16602	28981	73	92	575	0	29721
16603	512	74	29096	258	0	29940
16604	184	28638	417	203	0	29442
16605	150	396	145	28941	0	29632
16606	28482	115	116	460	0	29173
16607	28533	89	107	216	0	28945
16608	444	28963	119	227	0	29753
16609	28205	341	108	146	0	28800
16610	397	28615	111	135	0	29258
16611	157	29993	87	158	0	30395
16612	174	442	97	29872	0	30585
16613	164	144	30123	433	0	30864
16614	146	127	350	29170	0	29793
16615	29028	76	170	456	0	29730
16616	374	28625	102	231	0	29332
16617	169	360	79	28823	0	29431
16618	158	127	31737	463	0	32485
16619	31194	80	366	224	0	31864
16620	33184	74	125	201	0	33584
16621	33234	66	112	167	0	33579
16622	450	80	32158	136	0	32824
16623	30740	76	353	132	0	31301
16624	386	32306	141	166	0	32999
16625	207	302	110	30992	0	31611
16626	133	32306	85	340	0	32864
16627	32520	304	65	177	0	33066
16628	31084	130	90	132	0	31436
16629	420	109	32521	107	0	33157
16630	148	32694	307	192	0	33341
16631	161	284	137	32803	0	33385
16632	107	142	93	33006	0	33348
16633	108	68	82	32829	0	33087
16634	116	63	78	33802	0	34059
16635	114	66	86	34517	0	34783
16636	133	81	33144	496	0	33854
16637	102	32785	438	321	0	33646
16638	32503	341	146	125	0	33115
16639	475	148	33440	105	0	34168
16640	187	34038	394	160	0	34779
16641	34328	372	124	103	0	34927
16642	454	148	35650	116	0	36368
16643	34077	84	414	130	0	34705
16644	34839	90	135	144	0	35208
16645	34128	74	88	126	0	34416
16646	493	35647	98	175	0	36413
16647	287	452	34779	100	0	35618
16648	118	35868	424	149	0	36559
16649	171	453	163	30395	0	31182
16650	107	35782	90	413	0	36392
16651	35658	412	84	154	0	36308
16652	36741	133	68	132	0	37074
16653	36043	89	58	144	0	36334
16654	643	92	36936	120	0	37791
16655	206	38847	487	158	0	39698
16656	160	543	126	42369	0	43198
16657	46605	139	76	631	0	47451
16658	759	46534	108	240	0	47641
16659	245	767	59	46432	0	47503
16660	190	249	47616	779	0	48834
16661	46158	111	833	250	0	47352
16662	968	92	49662	120	0	50842
16663	343	97	50627	89	0	51156
16664	46157	64	1144	112	0	47477
16665	965	94	48969	77	0	50105
16666	45822	73	911	78	0	46884
16667	900	47346	292	104	0	48642
16668	48669	829	158	143	0	49799
16669	940	249	86	48939	0	50214
16670	313	115	85	49727	0	50240
16671	170	48	74	50255	0	50547
16672	49390	56	78	1144	0	50668
16673	49163	57	72	363	0	49655
16674	48630	69	68	158	0	48925
16675	1158	48277	77	130	0	49642
16676	386	826	72	48904	0	50188
16677	212	283	48310	920	0	49725
16678	151	140	853	46054	0	47198
16679	121	46860	293	1008	0	48282
16680	161	857	125	46773	0	47916
16681	160	290	79	47668	0	48197
16682	47053	131	90	1127	0	48401
16683	960	114	83	47454	0	48611
16684	406	107	47347	994	0	48854
16685	257	121	46767	352	0	47497
16686	195	122	1120	46898	0	48335
16687	46414	96	420	964	0	47894
16688	997	90	205	46127	0	47419
16689	448	131	149	47655	0	48383
16690	324	100	47291	1171	0	48886
16691	207	46852	996	477	0	48532
16692	225	910	394	47191	0	48720
16693	46393	313	241	982	0	47929
16694	982	46702	191	460	0	48335
16695	428	911	159	46992	0	48490
16696	351	335	47093	999	0	48778
16697	250	169	940	45851	0	47210
16698	45305	122	361	1118	0	46906
16699	975	45099	222	542	0	46838
16700	512	890	46152	319	0	47873
16701	308	335	961	44788	0	46392
16702	303	212	46839	1033	0	48387
16703	44690	169	1052	501	0	46412
16704	46075	133	403	334	0	46945
16705	1293	178	46612	264	0	48347
16706	564	139	1002	45315	0	47020
16707	365	165	47323	1104	0	48957
16708	283	46556	1096	671	0	48606
16709	312	963	463	47045	0	48783
16710	330	365	47173	1086	0	48954
16711	322	276	1047	43465	0	45110
16712	300	45739	522	1074	0	47635
16713	323	935	306	46003	0	47567
16714	284	378	45801	1140	0	47603
16715	42974	202	1078	564	0	44818
16716	1060	45505	475	475	0	47515
16717	46249	961	296	437	0	47943
16718	1162	386	43959	379	0	45886
16719	42466	243	1048	424	0	44181
16720	1237	192	43561	382	0	45372
16721	42675	200	1124	400	0	44399
16722	44605	209	490	395	0	45699
16723	1315	193	328	43725	0	45561
16724	599	200	314	44795	0	45908
16725	44084	206	265	1411	0	45966
16726	1132	44543	318	727	0	46720
16727	45027	997	332	484	0	46840
16728	1204	391	331	43926	0	45852
16729	576	44566	367	1231	0	46740
16730	423	961	378	45860	0	47622
16731	437	360	310	46468	0	47575
16732	389	228	347	45618	0	46582
16733	350	45534	312	1550	0	47746
16734	44601	940	266	696	0	46503
16735	1126	393	252	44798	0	46569
16736	527	229	44267	1248	0	46271
16737	406	201	43419	701	0	44727
16738	337	227	43909	511	0	44984
16739	42270	183	1243	507	0	44203
16740	43288	193	562	468	0	44511
16741	1291	208	42770	423	0	44692
16742	537	213	938	39429	0	41117
16743	339	193	496	41367	0	42395
16744	266	196	42563	1277	0	44302
16745	304	185	42431	643	0	43563
16746	295	209	1151	42165	0	43820
16747	42223	156	517	1083	0	43979
16748	41215	145	365	602	0	42327
16749	41314	143	308	430	0	42195
16750	1186	41214	310	422	0	43132
16751	552	42093	300	391	0	43336
16752	364	888	297	41002	0	42551
16753	40586	338	281	942	0	42147
16754	874	193	39941	512	0	41520
16755	34810	184	732	409	0	36135
16756	653	34175	328	309	0	35465
16757	209	30109	137	144	0	30599
16758	29121	477	156	133	0	29887
16759	388	29438	121	170	0	30117
16760	153	28192	112	133	0	28590
16761	27032	497	425	251	0	28205
16762	248	27429	102	116	0	27895
16763	79	177	32	26246	0	26534
16764	54	104	37	26359	0	26554
16765	26173	39	37	247	0	26496
16766	25805	30	49	103	0	25987
16767	234	26504	37	86	0	26861
16768	88	26462	32	78	0	26660
16769	85	208	25454	65	0	25812
16770	25560	90	176	96	0	25922
16771	27272	54	65	71	0	27462
16772	27747	35	43	74	0	27899
16773	273	31	35	28031	0	28370
16774	115	33	37	29281	0	29466
16775	29623	39	45	295	0	30002
16776	271	42	33	29617	0	29963
16777	104	46	30037	290	0	30477
16778	84	35	255	29568	0	29942
16779	64	30786	83	302	0	31235
16780	55	273	43	31157	0	31528
16781	58	95	42	31708	0	31903
16782	67	42	36	31869	0	32014
16783	30987	35	30	404	0	31456
16784	297	31256	47	177	0	31777
16785	107	293	39	31531	0	31970
16786	79	103	31422	327	0	31931
16787	80	80	30159	141	0	30460
16788	68	44	356	30430	0	30898
16789	94	44	93	30861	0	31092
16790	30295	43	52	380	0	30770
16791	339	38	39	29338	0	29754
16792	113	29669	43	457	0	30282
16793	125	313	30705	126	0	31269
16794	80	98	314	30918	0	31410
16795	101	60	31928	356	0	32445
16796	68	63	330	31448	0	31909
16797	31575	31	106	363	0	32075
16798	31794	37	64	165	0	32060
16799	384	32006	61	114	0	32565
16800	154	309	43	31323	0	31829
16801	32612	96	58	366	0	33132
16802	32463	57	57	154	0	32731
16803	32793	57	61	112	0	33023
16804	32812	36	59	81	0	32988
16805	32422	48	57	82	0	32609
16806	382	31966	61	114	0	32523
16807	31760	280	47	78	0	32165
16808	377	104	31378	63	0	31922
16809	129	61	275	31113	0	31578
16810	31976	44	85	312	0	32417
16811	31765	52	61	106	0	31984
16812	31519	47	36	82	0	31684
16813	406	45	31637	97	0	32185
16814	157	38	276	31502	0	31973
16815	32919	29	84	333	0	33365
16816	320	33103	41	155	0	33619
16817	34221	311	38	165	0	34735
16818	33411	83	42	94	0	33630
16819	33524	58	39	90	0	33711
16820	381	61	41	33957	0	34440
16821	34716	47	32	374	0	35169
16822	380	61	35242	144	0	35827
16823	146	79	34943	102	0	35270
16824	34619	40	332	128	0	35119
16825	365	49	36031	73	0	36518
16826	32526	40	274	112	0	32952
16827	341	55	35119	68	0	35583
16828	128	70	259	34034	0	34491
16829	34146	17	105	310	0	34578
16830	267	34483	60	162	0	34972
16831	34523	230	41	99	0	34893
16832	255	34501	39	100	0	34895
16833	95	36243	37	102	0	36477
16834	123	265	44	36552	0	36984
16835	47	73	46	36619	0	36785
16836	66	35	41	36544	0	36686
16837	81	37	36137	319	0	36574
16838	33765	22	245	168	0	34200
16839	37366	27	76	112	0	37581
16840	37536	31	42	89	0	37698
16841	37625	30	37	101	0	37793
16842	37246	30	200	79	0	37555
16843	433	49	36446	84	0	37012
16844	184	49	36277	65	0	36575
16845	133	23	316	36844	0	37316
16846	120	42	38032	327	0	38521
16847	36189	48	325	140	0	36702
16848	392	39978	97	112	0	40579
16849	148	371	54	42240	0	42813
16850	42674	97	58	486	0	43315
16851	533	43	55	43236	0	43867
16852	231	47	44399	491	0	45168
16853	183	47	44458	165	0	44853
16854	119	41	575	45643	0	46378
16855	127	69	46174	546	0	46916
16856	43612	31	523	185	0	44351
16857	554	68	153	46053	0	46828
16858	247	65	46398	542	0	47252
16859	156	46463	505	270	0	47394
16860	145	465	151	47836	0	48597
16861	189	140	48106	569	0	49004
16862	131	69	531	46222	0	46953
16863	134	31	174	47732	0	48071
16864	145	55	48354	677	0	49231
16865	141	24	568	47702	0	48435
16866	133	30	185	47697	0	48045
16867	140	33	94	48231	0	48498
16868	47019	34	64	695	0	47812
16869	559	47395	89	292	0	48335
16870	206	48075	78	162	0	48521
16871	169	638	46431	75	0	47313
16872	43127	170	539	145	0	43981
16873	551	75	46114	81	0	46821
16874	237	49	45234	91	0	45611
16875	111	109	558	43977	0	44755
16876	45008	23	213	469	0	45713
16877	434	45763	95	300	0	46592
16878	45735	400	114	149	0	46398
16879	44984	129	67	114	0	45294
16880	524	46041	64	136	0	46765
16881	45811	400	99	110	0	46420
16882	45336	134	74	91	0	45635
16883	480	46924	87	131	0	47622
16884	218	456	69	47270	0	48013
16885	119	142	95	48217	0	48573
16886	49478	45	71	540	0	50134
16887	454	50611	72	233	0	51370
16888	51821	458	62	149	0	52490
16889	52017	154	55	125	0	52351
16890	54451	69	66	181	0	54767
16891	698	50	83	54230	0	55061
16892	239	47	66	55503	0	55855
16893	55059	44	57	716	0	55876
16894	55695	50	67	243	0	56055
16895	55845	54	90	154	0	56143
16896	783	40	78	57803	0	58704
16897	266	71	58526	763	0	59626
16898	143	58	734	59164	0	60099
16899	122	57	242	64177	0	64598
16900	171	74	63577	1074	0	64896
16901	174	94	69079	328	0	69675
16902	153	73	1340	69878	0	71444
16903	191	79	70838	1267	0	72375
16904	70375	59	1272	585	0	72291
16905	1200	59	424	72754	0	74437
16906	434	60	188	74059	0	74741
16907	73821	65	133	1645	0	75664
16908	1263	69	119	74122	0	75573
16909	503	64	101	74931	0	75599
16910	255	57	107	75694	0	76113
16911	185	80	108	75917	0	76290
16912	223	98	73834	1722	0	75877
16913	184	59	1200	73515	0	74958
16914	264	110	72274	1447	0	74095
16915	163	72696	1279	893	0	75031
16916	179	1199	427	72505	0	74310
16917	261	402	71426	1389	0	73478
16918	64529	155	1271	644	0	66599
16919	1263	71004	489	388	0	73144
16920	71150	1181	225	314	0	72870
16921	1411	397	183	67477	0	69468
16922	487	69129	179	1307	0	71102
16923	68870	1204	191	543	0	70808
16924	1313	69626	170	385	0	71494
16925	69895	1294	146	330	0	71665
16926	1423	455	172	68833	0	70883
16927	69833	189	145	1370	0	71537
16928	1374	70657	171	708	0	72910
16929	70555	1247	180	391	0	72373
16930	1529	429	69825	355	0	72138
16931	605	205	1268	69996	0	72074
16932	69248	114	475	1470	0	71307
16933	69803	133	240	722	0	70898
16934	1735	139	205	68534	0	70613
16935	717	141	69017	1534	0	71409
16936	380	66729	1336	719	0	69164
16937	315	69988	506	499	0	71308
16938	70039	1496	341	485	0	72361
16939	1438	491	236	69301	0	71466
16940	620	208	248	70631	0	71707
16941	69292	153	238	1831	0	71514
16942	68322	180	278	775	0	69555
16943	1793	173	69715	477	0	72158
16944	788	174	1303	69175	0	71440
16945	499	167	69255	1578	0	71499
16946	384	68653	1312	834	0	71183
16947	64916	1165	526	576	0	67183
16948	1159	66770	312	586	0	68827
16949	542	66437	257	540	0	67776
16950	506	1409	280	65243	0	67438
16951	63487	451	285	1421	0	65644
16952	1202	64074	287	808	0	66371
16953	62820	1131	305	596	0	64852
16954	1225	62600	320	543	0	64688
16955	579	1189	265	63010	0	65043
16956	62066	435	304	1450	0	64255
16957	1318	305	63762	787	0	66172
16958	681	330	1147	63041	0	65199
16959	640	256	63306	1479	0	65681
16960	479	60691	1180	901	0	63251
16961	379	63484	491	723	0	65077
16962	61290	1283	371	643	0	63587
16963	1163	63056	298	677	0	65194
16964	62923	1162	340	607	0	65032
16965	63628	513	307	641	0	65089
16966	1535	363	62891	553	0	65342
16967	60940	317	1194	584	0	63035
16968	1455	343	64262	485	0	66545
16969	689	64014	1235	559	0	66497
16970	63926	1180	553	506	0	66165
16971	1382	64311	340	541	0	66574
16972	740	1271	265	64454	0	66730
16973	64340	552	262	1382	0	66536
16974	1448	403	253	64134	0	66238
16975	794	379	65104	1480	0	67757
16976	548	404	1154	64125	0	66231
16977	549	361	499	65707	0	67116
16978	64132	410	311	1666	0	66519
16979	1495	397	64222	796	0	66910
16980	64195	394	1182	532	0	66303
16981	66932	349	505	466	0	68252
16982	1816	345	350	65845	0	68356
16983	929	348	281	66403	0	67961
16984	64880	332	288	1631	0	67131
16985	1537	65964	298	776	0	68575
16986	933	1310	268	64595	0	67106
16987	644	597	63130	1305	0	65676
16988	567	468	60844	667	0	62546
16989	518	62680	1373	481	0	65052
16990	617	1246	539	59544	0	61946
16991	533	626	370	60473	0	62002
16992	59294	372	210	1459	0	61335
16993	1403	375	209	58456	0	60443
16994	56331	294	222	1223	0	58070
16995	1255	55867	224	738	0	58084
16996	530	55379	201	465	0	56575
16997	414	56388	236	377	0	57415
16998	54044	1052	447	421	0	55964
16999	49975	386	319	290	0	50970
17000	1003	49635	155	304	0	51097
17001	42560	326	114	111	0	43111
17002	349	42089	60	127	0	42625
17003	182	415	53	40332	0	40982
17004	112	40915	38	341	0	41406
17005	40758	357	94	146	0	41355
17006	40756	135	61	136	0	41088
17007	434	106	48	39552	0	40140
17008	39772	82	50	364	0	40268
17009	376	92	53	39325	0	39846
17010	177	40163	63	371	0	40774
17011	148	385	69	39892	0	40494
17012	117	40137	58	367	0	40679
17013	40228	321	66	172	0	40787
17014	381	151	38815	115	0	39462
17015	37155	108	267	99	0	37629
17016	320	78	87	39142	0	39627
17017	194	91	38729	307	0	39321
17018	37088	64	270	177	0	37599
17019	358	85	40458	102	0	41003
17020	152	65	290	39436	0	39943
17021	135	76	114	40783	0	41108
17022	125	84	57	40708	0	40974
17023	107	86	60	41055	0	41308
17024	100	41645	72	477	0	42294
17025	143	380	65	43816	0	44404
17026	43884	148	54	496	0	44582
17027	513	106	43651	200	0	44470
17028	191	46086	445	176	0	46898
17029	47194	544	172	119	0	48029
17030	50477	274	82	140	0	50973
17031	858	115	65	56595	0	57633
17032	426	99	56923	947	0	58395
17033	194	98	878	56075	0	57245
17034	150	102	402	59797	0	60451
17035	256	78	59454	1426	0	61214
17036	150	61907	1038	660	0	63755
17037	63797	1177	489	248	0	65711
17038	63525	521	136	242	0	64424
17039	64794	195	108	208	0	65305
17040	1835	97	109	63169	0	65210
17041	760	136	90	66346	0	67332
17042	66969	86	94	1852	0	69001
17043	1541	108	105	60574	0	62328
17044	698	64675	94	1469	0	66936
17045	67662	1330	87	669	0	69748
17046	70292	571	96	347	0	71306
17047	73123	225	79	279	0	73706
17048	73493	155	118	272	0	74038
17049	2551	161	70115	227	0	73054
17050	1099	147	70802	230	0	72278
17051	542	145	2127	68475	0	71289
17052	441	132	763	71346	0	72682
17053	433	144	70327	2260	0	73164
17054	400	150	71117	878	0	72545
17055	385	123	2171	69414	0	72093
17056	69815	119	865	1779	0	72578
17057	1850	112	394	68405	0	70761
17058	997	109	69069	1981	0	72156
17059	492	69694	1743	987	0	72916
17060	70279	1584	787	546	0	73196
17061	71482	658	419	432	0	72991
17062	72142	256	360	455	0	73213
17063	71761	189	324	407	0	72681
17064	2664	204	68495	404	0	71767
17065	1168	157	1773	68125	0	71223
17066	68572	180	857	1882	0	71491
17067	2108	162	429	68664	0	71363
17068	1176	198	369	64227	0	65970
17069	766	66756	349	2341	0	70212
17070	736	1655	299	67608	0	70298
17071	66102	692	391	2068	0	69253
17072	2010	67016	373	1138	0	70537
17073	65813	1705	313	642	0	68473
17074	2125	66863	332	697	0	70017
17075	1261	1802	330	58923	0	62316
17076	782	63613	379	1823	0	66597
17077	694	66349	382	1075	0	68500
17078	64999	2161	479	720	0	68359
17079	2232	929	64115	715	0	67991
17080	1191	473	63149	696	0	65509
17081	797	446	62847	595	0	64685
17082	56926	468	2371	666	0	60431
17083	1987	60963	1072	688	0	64710
17084	1228	62971	571	660	0	65430
17085	58265	2216	465	577	0	61523
17086	2141	59573	479	674	0	62867
17087	1280	61304	507	720	0	63811
17088	947	2347	450	61090	0	64834
17089	932	1067	60719	2148	0	64866
17090	955	672	61659	1308	0	64594
17091	913	590	2360	61049	0	64912
17092	59689	562	1163	2165	0	63579
17093	2290	61212	764	1239	0	65505
17094	1562	1955	574	61752	0	65843
17095	1342	1037	61354	2135	0	65868
17096	1177	701	60913	1301	0	64092
17097	1057	612	2475	60015	0	64159
17098	60137	579	1249	2316	0	64281
17099	61313	614	778	1411	0	64116
17100	3054	597	59695	1002	0	64348
17101	59607	507	2151	941	0	63206
17102	2770	560	60544	826	0	64700
17103	1815	484	2264	53755	0	58318
17104	1332	59646	1345	2069	0	64392
17105	61179	1910	924	1148	0	65161
17106	2588	1009	897	60993	0	65487
17107	1707	610	874	61703	0	64894
17108	1356	545	854	63203	0	65958
17109	1252	462	867	63431	0	66012
17110	1193	496	60302	3022	0	65013
17111	1258	59649	2311	1705	0	64923
17112	1176	1877	1453	60532	0	65038
17113	59981	941	1046	2453	0	64421
17114	2488	611	887	60803	0	64789
17115	1574	611	905	61917	0	65007
17116	1254	630	59849	2996	0	64729
17117	1271	630	59302	1666	0	62869
17118	1132	58457	2710	1297	0	63596
17119	1047	59739	1478	1233	0	63497
17120	1083	2422	922	58412	0	62839
17121	58387	1180	833	2433	0	62833
17122	2415	843	58002	1503	0	62763
17123	1507	58149	2024	1198	0	62878
17124	1370	1907	1137	52881	0	57295
17125	944	55891	705	2103	0	59643
17126	959	1962	642	51532	0	55095
17127	820	54531	679	2084	0	58114
17128	898	1832	557	51299	0	54586
17129	49156	1033	507	1941	0	52637
17130	1669	46068	445	1138	0	49320
17131	673	1736	312	38904	0	41625
17132	37486	624	411	1218	0	39739
17133	1103	38272	371	771	0	40517
17134	487	34525	288	518	0	35818
17135	422	34834	307	467	0	36030
17136	613	962	463	30974	0	33012
17137	268	431	254	30349	0	31302
17138	179	30423	176	797	0	31575
17139	262	767	196	30271	0	31496
17140	275	427	30020	647	0	31369
17141	190	29728	523	321	0	30762
17142	173	1912	214	26059	0	28358
17143	167	28211	190	469	0	29037
17144	276	456	25889	193	0	26814
17145	105	25991	408	140	0	26644
17146	21220	391	221	142	0	21974
17147	125	51	31	21229	0	21436
17148	20980	17	51	141	0	21189
17149	119	38	21105	63	0	21325
17150	45	36	112	21056	0	21249
17151	41	41	21837	118	0	22037
17152	29	28	110	21634	0	21801
17153	22966	32	28	181	0	23207
17154	118	32	25	23001	0	23176
17155	23313	25	21	168	0	23527
17156	99	24187	33	106	0	24425
17157	23586	114	21	69	0	23790
17158	135	61	25094	61	0	25351
17159	47	25940	101	81	0	26169
17160	39	107	31	26139	0	26316
17161	45	42	19	26173	0	26279
17162	39	57	25749	152	0	25997
17163	18	26037	108	130	0	26293
17164	27	104	35	26150	0	26316
17165	15	26546	21	130	0	26712
17166	27	116	9	26057	0	26209
17167	19	26365	27	113	0	26524
17168	25643	100	24	36	0	25803
17169	140	50	17	26454	0	26661
17170	85	38	26854	92	0	27069
17171	29	27491	90	95	0	27705
17172	17	28377	33	90	0	28517
17173	131	126	27492	28	0	27777
17174	12	28225	111	61	0	28409
17175	24	79	22	28062	0	28187
17176	42	44	28668	71	0	28825
17177	21	20	63	27876	0	27980
17178	14	15	26	29214	0	29269
17179	22	14	29186	101	0	29323
17180	25952	21	83	99	0	26155
17181	79	12	31	29600	0	29722
17182	69	41	32114	86	0	32310
17183	25	32825	80	102	0	33032
17184	33161	77	35	59	0	33332
17185	77	32933	23	67	0	33100
17186	36	101	15	33131	0	33283
17187	32843	28	23	135	0	33029
17188	87	22	20	32688	0	32817
17189	71	48	34133	95	0	34347
17190	33	21	85	33605	0	33744
17191	44	37	34058	108	0	34247
17192	32094	24	100	86	0	32304
17193	116	42	34392	41	0	34591
17194	33938	43	101	104	0	34186
17195	34376	29	36	84	0	34525
17196	131	33	35322	57	0	35543
17197	87	47	33852	48	0	34034
17198	39	35713	114	58	0	35924
17199	36693	97	41	84	0	36915
17200	112	47	34	37361	0	37554
17201	51	30	33	37588	0	37702
17202	40838	34	19	380	0	41271
17203	41266	17	39	123	0	41445
17204	41427	28	24	104	0	41583
17205	41532	20	22	90	0	41664
17206	127	32	35	41064	0	41258
17207	41546	30	18	176	0	41770
17208	120	35	38	41829	0	42022
17209	54	32	22	41693	0	41801
17210	44	24	27	42104	0	42199
17211	58	41	41263	171	0	41533
17212	35	40979	126	123	0	41263
17213	32	41640	63	99	0	41834
17214	40	137	49	41963	0	42189
17215	41900	52	31	152	0	42135
17216	115	38	29	41616	0	41798
17217	41503	40	42	153	0	41738
17218	158	62	43055	91	0	43366
17219	40698	27	120	102	0	40947
17220	143	51	61	43866	0	44121
17221	44888	38	48	217	0	45191
17222	44224	45	31	119	0	44419
17223	44702	34	41	139	0	44916
17224	159	48	38	44793	0	45038
17225	98	61	44788	157	0	45104
17226	69	31	131	44106	0	44337
17227	45393	28	71	191	0	45683
17228	216	87	49556	79	0	49938
17229	92	41	176	51345	0	51654
17230	53674	30	76	276	0	54056
17231	276	84	54197	116	0	54673
17232	55319	36	245	165	0	55765
17233	58554	37	94	153	0	58838
17234	366	26	61	59128	0	59581
17235	131	41	38	60054	0	60264
17236	60219	30	39	471	0	60759
17237	371	43	49	61654	0	62117
17238	61138	28	63	529	0	61758
17239	405	62066	71	282	0	62824
17240	141	62718	54	151	0	63064
17241	109	579	39	62519	0	63246
17242	151	182	63247	476	0	64056
17243	46	63924	466	233	0	64669
17244	62799	439	156	144	0	63538
17245	407	63201	86	184	0	63878
17246	224	496	62496	69	0	63285
17247	130	131	448	60719	0	61428
17248	162	86	64288	520	0	65056
17249	56	65315	469	316	0	66156
17250	101	444	142	64670	0	65357
17251	60	64591	99	475	0	65225
17252	183	434	63958	178	0	64753
17253	77	135	444	61744	0	62400
17254	116	111	64294	458	0	64979
17255	91	45	452	62635	0	63223
17256	63229	42	166	530	0	63967
17257	492	97	62084	208	0	62881
17258	56756	42	467	171	0	57436
17259	532	74	60113	98	0	60817
17260	191	54	477	59014	0	59736
17261	143	72	62859	527	0	63601
17262	97	67	479	62249	0	62892
17263	83	76	212	63149	0	63520
17264	98	60	85	62941	0	63184
17265	90	61	86	63232	0	63469
17266	128	101	66035	677	0	66941
17267	60911	55	485	424	0	61875
17268	501	67	163	70728	0	71459
17269	70759	44	121	583	0	71507
17270	72208	58	73	260	0	72599
17271	73273	59	94	215	0	73641
17272	774	84	70	74170	0	75098
17273	290	60	87	74570	0	75007
17274	130	84831	99	841	0	85901
17275	93835	1027	106	286	0	95254
17276	99007	364	93	205	0	99669
17277	99015	165	106	227	0	99513
17278	2164	136	99666	206	0	102172
17279	828	121	1451	98447	0	100847
17280	436	105	99823	1564	0	101928
17281	97025	88	1626	678	0	99417
17282	98662	73	642	388	0	99765
17283	2050	111	267	96864	0	99292
17284	883	109	183	91455	0	92630
17285	352	98804	152	1873	0	101181
17286	99317	1450	147	744	0	101658
17287	99089	558	154	376	0	100177
17288	2080	98643	160	392	0	101275
17289	98547	1473	193	255	0	100468
17290	1807	600	153	97929	0	100489
17291	789	239	178	99563	0	100769
17292	99490	164	158	2111	0	101923
17293	1768	168	98869	815	0	101620
17294	97218	123	1481	473	0	99295
17295	99014	123	609	381	0	100127
17296	2090	97912	304	429	0	100735
17297	99640	1499	213	287	0	101639
17298	2052	656	97926	243	0	100877
17299	1035	294	1539	97524	0	100392
17300	97676	178	673	1653	0	100180
17301	1908	179	376	97609	0	100072
17302	973	173	94461	1866	0	97473
17303	588	130	1676	90335	0	92729
17304	466	98667	813	1866	0	101812
17305	575	1536	394	100810	0	103315
17306	540	626	259	102775	0	104200
17307	485	325	208	102385	0	103403
17308	451	270	187	102920	0	103828
17309	530	298	100487	2518	0	103833
17310	537	241	1598	100868	0	103244
17311	100119	231	698	2061	0	103109
17312	1882	99938	387	1178	0	103385
17313	1033	1650	228	102242	0	105153
17314	803	720	102956	1955	0	106434
17315	587	357	1647	102893	0	105484
17316	104096	203	781	2107	0	107187
17317	103464	193	459	1114	0	105230
17318	101852	182	344	679	0	103057
17319	2860	227	278	101567	0	104932
17320	1572	263	101742	1898	0	105475
17321	974	100723	1792	1180	0	104669
17322	101451	1592	955	785	0	104783
17323	2115	757	495	100835	0	104202
17324	1281	406	427	102113	0	104227
17325	986	275	101545	2576	0	105382
17326	851	99509	1792	1478	0	103630
17327	786	102862	886	968	0	105502
17328	908	2708	497	96566	0	100679
17329	898	918	95044	2090	0	98950
17330	88107	488	1741	1399	0	91735
17331	2264	438	92438	903	0	96043
17332	84942	339	1744	880	0	87905
17333	2178	92352	958	976	0	96464
17334	1405	1553	91798	789	0	95545
17335	87292	757	1624	807	0	90480
17336	2124	91463	862	813	0	95262
17337	93387	1519	551	814	0	96271
17338	2334	819	92745	639	0	96537
17339	1447	92975	1500	854	0	96776
17340	94328	1523	782	672	0	97305
17341	2331	811	91981	716	0	95839
17342	91377	474	1597	685	0	94133
17343	2226	378	872	92023	0	95499
17344	93208	392	650	1798	0	96048
17345	2178	377	541	92955	0	96051
17346	92897	361	509	2063	0	95830
17347	2133	389	92707	1374	0	96603
17348	1158	372	1666	92886	0	96082
17349	895	405	886	93834	0	96020
17350	777	475	93304	2506	0	97062
17351	719	459	1612	91719	0	94509
17352	649	88931	964	2261	0	92805
17353	684	1501	651	100379	0	103215
17354	735	735	543	106753	0	108766
17355	798	502	453	116313	0	118066
17356	908	487	114680	3225	0	119300
17357	108463	363	2301	1793	0	112920
17358	2700	377	1070	122558	0	126705
17359	1457	378	125553	3062	0	130450
17360	121163	354	2771	1557	0	125845
17361	127178	363	1190	1026	0	129757
17362	130559	370	716	955	0	132600
17363	4028	418	551	128976	0	133973
17364	1789	403	551	143178	0	145921
17365	1145	444	563	135480	0	137632
17366	810	139037	591	4590	0	145028
17367	137921	3215	612	2044	0	143792
17368	137371	1126	544	1367	0	140408
17369	4535	571	615	134904	0	140625
17370	2085	402	132560	3816	0	138863
17371	1444	402	133525	1734	0	137105
17372	721	128459	4253	1274	0	134707
17373	640	132575	1597	1086	0	135898
17374	117031	4017	1583	1258	0	123889
17375	2485	114646	353	510	0	117994
17376	110921	2251	278	259	0	113709
17377	111323	584	139	265	0	112311
17378	110799	233	153	224	0	111409
17379	2988	150	112	109702	0	112952
17380	930	138	135	117273	0	118476
17381	118526	123	134	3005	0	121788
17382	2642	159	104	121115	0	124020
17383	935	147	120495	2890	0	124467
17384	119732	121	2565	903	0	123321
17385	2826	235	669	119773	0	123503
17386	948	198	269	122613	0	124028
17387	526	186	180	124448	0	125340
17388	508	213	120364	3523	0	124608
17389	109308	162	2802	1209	0	113481
17390	3012	208	119934	550	0	123704
17391	1012	206	2853	118173	0	122244
17392	659	289	120747	2929	0	124624
17393	510	222	2935	117007	0	120674
17394	526	255	841	120792	0	122414
17395	628	242	122965	3524	0	127359
17396	713	265	2883	108427	0	112288
17397	517	122519	899	2801	0	126736
17398	121886	2708	428	1014	0	126036
17399	123944	768	313	725	0	125750
17400	3753	340	296	122659	0	127048
17401	1422	274	124223	3275	0	129194
17402	691	120372	2944	1410	0	125417
17403	588	126013	962	939	0	128502
17404	119213	3281	517	770	0	123781
17405	3272	979	117481	678	0	122410
17406	116589	396	2969	775	0	120729
17407	3306	250	1058	117494	0	122108
17408	1251	284	612	120511	0	122658
17409	114924	272	517	3928	0	119641
17410	3070	115813	555	1917	0	121355
17411	1358	2860	118213	1009	0	123440
17412	883	872	3102	113676	0	118533
17413	906	453	118764	3521	0	123644
17414	788	117137	3392	1532	0	122849
17415	791	2826	1167	117938	0	122722
17416	117901	878	768	3590	0	123137
17417	119207	480	689	1582	0	121958
17418	4091	469	117897	1197	0	123654
17419	1592	117711	3193	1172	0	123668
17420	116281	2948	1212	1014	0	121455
17421	3420	118441	815	1069	0	123745
17422	1619	3246	644	116836	0	122345
17423	117155	1049	702	3507	0	122413
17424	3627	648	628	118069	0	122972
17425	1654	551	116729	3787	0	122721
17426	1205	545	3191	117370	0	122311
17427	1143	632	117974	3903	0	123652
17428	1186	558	3411	116277	0	121432
17429	117138	539	1376	3836	0	122889
17430	3564	117888	942	1878	0	124272
17431	118367	3127	823	1402	0	123719
17432	3723	1173	800	117359	0	123055
17433	1597	806	753	119974	0	123130
17434	1261	786	116567	4387	0	123001
17435	1237	745	118964	1876	0	122822
17436	1244	117745	3965	1668	0	124622
17437	1372	3260	116720	1148	0	122500
17438	106392	1189	3691	1239	0	112511
17439	3619	115257	1514	1425	0	121815
17440	1618	119323	1100	1323	0	123364
17441	1235	120879	881	1263	0	124258
17442	1254	4270	778	117606	0	123908
17443	1322	1550	119746	3944	0	126562
17444	1139	121066	3614	2146	0	127965
17445	1310	3397	1485	109751	0	115943
17446	1066	122304	1014	3761	0	128145
17447	120225	3416	923	1934	0	126498
17448	122798	1173	888	1646	0	126505
17449	4311	857	970	119984	0	126122
17450	1866	650	1024	121624	0	125164
17451	115062	585	1117	4636	0	121400
17452	3486	113776	1051	2289	0	120602
17453	1478	115994	1036	1538	0	120046
17454	1510	4082	835	105968	0	112395
17455	858	1117	99390	3149	0	104514
17456	705	97947	2751	1538	0	102941
17457	91007	2431	1425	939	0	95802
17458	2265	90009	865	868	0	94007
17459	914	89933	702	844	0	92393
17460	84887	2493	1002	665	0	89047
17461	2011	88433	516	837	0	91797
17462	1179	2185	84820	671	0	88855
17463	571	85941	2076	704	0	89292
17464	72646	1503	1010	430	0	75589
17465	1136	73063	392	460	0	75051
17466	72082	1318	492	357	0	74249
17467	1343	592	309	71379	0	73623
17468	601	429	259	73751	0	75040
17469	526	431	73816	1439	0	76212
17470	382	74365	1143	720	0	76610
17471	383	1243	407	75400	0	77433
17472	74702	542	317	1320	0	76881
17473	74307	361	313	567	0	75548
17474	1325	75361	307	520	0	77513
17475	555	1221	277	75192	0	77245
17476	75189	547	277	1295	0	77308
17477	75179	454	346	611	0	76590
17478	1471	441	72932	401	0	75245
17479	674	404	68375	303	0	69756
17480	427	347	68111	260	0	69145
17481	180	66487	1015	327	0	68009
17482	63438	733	707	161	0	65039
17483	711	63436	174	199	0	64520
17484	62863	791	234	184	0	64072
17485	704	66862	125	155	0	67846
17486	303	741	102	68466	0	69612
17487	68672	259	127	697	0	69755
17488	692	208	69217	256	0	70373
17489	66551	173	637	168	0	67529
17490	70196	166	235	149	0	70746
17491	792	71469	115	189	0	72565
17492	261	73581	102	187	0	74131
17493	75207	761	139	204	0	76311
17494	748	313	78060	142	0	79263
17495	73807	320	668	196	0	74991
17496	76223	195	236	153	0	76807
17497	757	130	104	75366	0	76357
17498	77331	146	73	643	0	78193
17499	700	175	80	79119	0	80074
17500	290	132	91	81382	0	81895
17501	193	147	94	79634	0	80068
17502	142	79783	135	763	0	80823
17503	80135	592	88	286	0	81101
17504	80791	220	115	197	0	81323
17505	756	163	104	80637	0	81660
17506	332	128	110	79821	0	80391
17507	197	80357	134	738	0	81426
17508	80099	628	169	280	0	81176
17509	705	309	78872	186	0	80072
17510	326	203	572	79627	0	80728
17511	263	214	79014	617	0	80108
17512	229	142	585	78198	0	79154
17513	283	205	79360	662	0	80510
17514	239	171	605	76703	0	77718
17515	77228	154	242	680	0	78304
17516	771	202	78821	260	0	80054
17517	74261	122	611	258	0	75252
17518	737	81542	266	258	0	82803
17519	347	626	181	82847	0	84001
17520	293	325	152	83743	0	84513
17521	85599	190	157	875	0	86821
17522	811	186	130	88689	0	89816
17523	435	240	91267	669	0	92611
17524	86022	176	609	448	0	87255
17525	91819	147	213	333	0	92512
17526	92002	185	134	270	0	92591
17527	91661	142	178	279	0	92260
17528	885	90899	145	354	0	92283
17529	451	552	110	91327	0	92440
17530	91195	217	136	663	0	92211
17531	725	187	114	90041	0	91067
17532	88927	113	205	624	0	89869
17533	705	179	87172	296	0	88352
17534	406	149	86308	214	0	87077
17535	295	855	564	80347	0	82061
17536	249	85673	247	610	0	86779
17537	212	88249	172	420	0	89053
17538	86073	526	160	403	0	87162
17539	551	183	86648	258	0	87640
17540	75638	116	454	335	0	76543
17541	496	85655	207	314	0	86672
17542	85678	357	152	209	0	86396
17543	510	142	120	83882	0	84654
17544	337	156	85655	476	0	86624
17545	275	144	382	83863	0	84664
17546	232	136	153	84720	0	85241
17547	221	84765	144	619	0	85749
17548	239	87702	144	361	0	88446
17549	239	426	177	86809	0	87651
17550	255	88243	144	597	0	89239
17551	321	468	84610	302	0	85701
17552	278	274	82570	256	0	83378
17553	75338	144	488	328	0	76298
17554	85875	129	177	228	0	86409
17555	541	84807	165	346	0	85859
17556	314	439	135	84494	0	85382
17557	262	206	122	85330	0	85920
17558	301	192	84892	618	0	86003
17559	246	118	450	79756	0	80570
17560	204	84114	226	700	0	85244
17561	246	472	80126	264	0	81108
17562	263	208	79746	225	0	80442
17563	236	77674	545	381	0	78836
17564	360	503	79627	226	0	80716
17565	253	195	442	77899	0	78789
17566	250	171	195	75586	0	76202
17567	239	178	82101	567	0	83085
17568	245	185	429	78507	0	79366
17569	202	79243	204	613	0	80262
17570	199	82410	210	392	0	83211
17571	246	529	127	81222	0	82124
17572	360	189	81913	566	0	83028
17573	180	83616	520	417	0	84733
17574	320	681	204	83604	0	84809
17575	237	189	81973	476	0	82875
17576	73663	127	392	325	0	74507
17577	82548	110	131	186	0	82975
17578	82531	90	119	192	0	82932
17579	453	102	101	80019	0	80675
17580	193	91	122	81684	0	82090
17581	204	123	83731	524	0	84582
17582	168	112	432	81627	0	82339
17583	178	128	171	85244	0	85721
17584	149	126	83972	475	0	84722
17585	64444	111	491	386	0	65432
17586	405	78000	150	244	0	78799
17587	78237	384	125	155	0	78901
17588	391	77546	102	212	0	78251
17589	181	475	86	77804	0	78546
17590	174	216	77589	433	0	78412
17591	132	154	415	73281	0	73982
17592	130	119	74665	471	0	75385
17593	56049	114	523	330	0	57016
17594	380	114	69693	111	0	70298
17595	116	78	385	65028	0	65607
17596	148	99	69391	406	0	70044
17597	99	70204	425	273	0	71001
17598	140	425	151	73872	0	74588
17599	132	103	90	74261	0	74586
17600	113	67	83	75894	0	76157
17601	150	73	75131	723	0	76077
17602	128	121	77196	250	0	77695
17603	116	68	706	76378	0	77268
17604	94	58	245	95436	0	95833
17605	135	88	147	104780	0	105150
17606	107733	62	150	2062	0	110007
17607	1626	77	112	112871	0	114686
17608	779	117	119802	1906	0	122604
17609	125433	103	2033	868	0	128437
17610	2409	98	758	132323	0	135588
17611	138673	77	359	2583	0	141692
17612	141961	65	203	1139	0	143368
17613	3524	87	221	140894	0	144726
17614	141510	64	224	2816	0	144614
17615	142878	67	212	1213	0	144370
17616	3717	101	139918	530	0	144266
17617	1339	141067	2659	546	0	145611
17618	631	2540	1023	133566	0	137760
17619	402	928	392	142208	0	143930
17620	140411	320	219	3606	0	144556
17621	139745	138	225	1482	0	141590
17622	139019	123	218	803	0	140163
17623	4061	146	130910	561	0	135678
17624	1529	132351	2797	710	0	137387
17625	131809	2596	1144	493	0	136042
17626	2948	133783	540	620	0	137891
17627	134436	2864	315	565	0	138180
17628	3315	1054	289	133497	0	138155
17629	134208	405	258	3017	0	137888
17630	135608	223	246	1410	0	137487
17631	136423	167	280	794	0	137664
17632	4430	246	134837	572	0	140085
17633	134658	209	2777	659	0	138303
17634	3549	135620	1153	825	0	141147
17635	139107	2738	512	690	0	143047
17636	140952	1116	335	776	0	143179
17637	143756	455	375	732	0	145318
17638	4813	326	403	134167	0	139709
17639	2169	138437	442	3202	0	144250
17640	139140	2916	488	1398	0	143942
17641	3995	1248	138403	850	0	144496
17642	2125	139524	2972	938	0	145559
17643	1756	3119	1205	120315	0	126395
17644	1413	138226	591	2656	0	142886
17645	138264	3262	443	1244	0	143213
17646	142670	1392	452	799	0	145313
17647	4975	738	405	139658	0	145776
17648	2562	542	137593	3558	0	144255
17649	1638	138200	3162	1897	0	144897
17650	1780	3270	1537	118521	0	125108
17651	1515	1446	802	138555	0	142318
17652	1540	733	613	144725	0	147611
17653	143394	565	558	4604	0	149121
17654	145536	623	491	2054	0	148704
17655	146398	577	532	1182	0	148689
17656	147559	684	503	923	0	149669
17657	5697	600	520	143100	0	149917
17658	2893	683	145134	3924	0	152634
17659	2115	639	3308	146504	0	152566
17660	1954	598	1436	147354	0	151342
17661	2129	657	709	148434	0	151929
17662	2215	563	671	149859	0	153308
17663	146051	607	776	5323	0	152757
17664	5021	595	866	146458	0	152940
17665	146586	598	771	4598	0	152553
17666	148464	649	885	2514	0	152512
17667	6384	626	142991	1936	0	151937
17668	3837	625	143203	1726	0	149391
17669	3128	636	146864	1777	0	152405
17670	2959	727	4693	141158	0	149537
17671	2822	774	145210	4255	0	153061
17672	2631	818	3929	140800	0	148178
17673	2490	916	1899	143938	0	149243
17674	143924	857	1077	5601	0	151459
17675	5559	833	907	138650	0	145949
17676	3734	145055	968	4718	0	154475
17677	146210	3518	1034	2593	0	153355
17678	5275	148437	1119	2302	0	157133
17679	3730	4063	148884	1820	0	158497
17680	2804	150813	3774	1891	0	159282
17681	148231	4136	2076	1684	0	156127
17682	5600	2073	1061	147413	0	156147
17683	3857	1295	146411	4417	0	155980
17684	146013	1069	3789	2472	0	153343
17685	5924	1069	1907	147108	0	156008
17686	3996	1076	147675	4297	0	157044
17687	3117	931	3889	148323	0	156260
17688	2945	930	2104	149399	0	155378
17689	2959	966	1206	147459	0	152590
17690	2925	147870	1114	5351	0	157260
17691	150634	3652	1061	2659	0	158006
17692	5751	1931	949	145334	0	153965
17693	3647	148987	962	4531	0	158127
17694	2852	4132	765	150573	0	158322
17695	3019	2270	148647	4608	0	158544
17696	2619	149745	3856	2841	0	159061
17697	148108	4009	2038	2009	0	156164
17698	148543	2205	1227	1682	0	153657
17699	5836	1487	1015	141949	0	150287
17700	3384	1234	1095	145421	0	151134
17701	143767	1073	1118	5078	0	151036
17702	139053	1005	1166	2855	0	144079
17703	5294	140129	1261	2238	0	148922
17704	121431	2773	1045	1430	0	126679
17705	3738	1140	112981	1124	0	118983
17706	2095	674	110718	1161	0	114648
17707	1102	106267	2775	1274	0	111418
17708	815	101900	1341	1083	0	105139
17709	88066	1670	2247	679	0	92662
17710	1350	88821	562	665	0	91398
17711	84272	1059	468	527	0	86326
17712	82837	396	244	449	0	83926
17713	81823	254	266	466	0	82809
17714	1434	226	231	80458	0	82349
17715	81304	187	302	1180	0	82973
17716	1304	233	79263	597	0	81397
17717	710	231	79807	444	0	81192
17718	479	79669	1221	656	0	82025
17719	499	931	80420	460	0	82310
17720	444	366	1139	75994	0	77943
17721	462	258	80997	1225	0	82942
17722	455	260	79824	621	0	81160
17723	431	237	1229	78780	0	80677
17724	80109	231	527	1203	0	82070
17725	80172	233	348	645	0	81398
17726	1435	261	83003	434	0	85133
17727	79494	245	1067	514	0	81320
17728	1249	243	84243	408	0	86143
17729	82031	234	1114	438	0	83817
17730	86454	202	507	517	0	87680
17731	1406	186	426	85421	0	87439
17732	682	250	329	81788	0	83049
17733	452	81669	363	1435	0	83919
17734	461	83621	371	708	0	85161
17735	490	1127	344	81607	0	83568
17736	524	502	336	82034	0	83396
17737	78051	257	233	1152	0	79693
17738	975	78359	317	618	0	80269
17739	77307	889	249	421	0	78866
17740	937	78484	281	449	0	80151
17741	571	1004	76956	289	0	78820
17742	448	463	894	76528	0	78333
17743	77024	278	459	991	0	78752
17744	81443	212	214	469	0	82338
17745	1347	83839	251	436	0	85873
17746	583	87122	210	374	0	88289
17747	317	88503	258	382	0	89460
17748	448	1726	204	95930	0	98308
17749	488	564	97987	1507	0	100546
17750	282	97628	1503	655	0	100068
17751	394	1584	491	96673	0	99142
17752	202	423	261	99089	0	99975
17753	314	216	97965	1761	0	100256
17754	314	231	97519	558	0	98622
17755	92703	178	1808	333	0	95022
17756	1622	174	99313	251	0	101360
17757	96727	192	1492	243	0	98654
17758	95988	162	518	194	0	96862
17759	95885	162	291	229	0	96567
17760	95774	162	216	242	0	96394
17761	1976	199	92571	266	0	95012
17762	649	93536	1435	325	0	95945
17763	423	1446	495	94062	0	96426
17764	412	566	93723	1499	0	96200
17765	325	260	1504	90142	0	92231
17766	318	90215	636	1561	0	92730
17767	372	1467	329	95196	0	97364
17768	400	497	252	95900	0	97049
17769	389	301	220	95259	0	96169
17770	92936	245	274	1980	0	95435
17771	1654	272	276	93382	0	95584
17772	735	261	273	94075	0	95344
17773	437	264	333	92310	0	93344
17774	321	89858	399	2009	0	92587
17775	88394	1526	339	714	0	90973
17776	1586	85261	344	540	0	87731
17777	577	86439	334	446	0	87796
17778	460	1736	447	85831	0	88474
17779	426	604	300	86620	0	87950
17780	85162	289	324	1901	0	87676
17781	1665	245	323	86129	0	88362
17782	86693	197	317	1783	0	88990
17783	103141	223	344	725	0	104433
17784	2789	252	330	102345	0	105716
17785	1134	284	311	99674	0	101403
17786	475	104606	378	2982	0	108441
17787	106293	2412	293	1217	0	110215
17788	2520	110422	354	932	0	114228
17789	111074	2706	425	555	0	114760
17790	2915	1152	109628	589	0	114284
17791	107829	488	2535	616	0	111468
17792	113184	375	1017	616	0	115192
17793	3518	365	450	110179	0	114512
17794	1462	361	110549	2960	0	115332
17795	706	111207	2710	1693	0	116316
17796	655	2927	1093	113039	0	117714
17797	773	1182	113136	3243	0	118334
17798	652	635	2808	112377	0	116472
17799	110275	450	1148	3273	0	115146
17800	3239	342	110898	1507	0	115986
17801	1331	108977	2979	939	0	114226
17802	816	113580	1202	834	0	116432
17803	969	3726	575	91451	0	96721
17804	648	111700	483	2580	0	115411
17805	111164	3079	423	1116	0	115782
17806	111784	1239	413	831	0	114267
17807	112210	641	420	720	0	113991
17808	4052	627	106676	715	0	112070
17809	107726	519	2866	802	0	111913
17810	3277	607	1162	106810	0	111856
17811	1485	579	550	108884	0	111498
17812	885	512	483	109185	0	111065
17813	790	574	970	109830	0	112164
17814	939	588	106502	4227	0	112256
17815	873	603	107418	1971	0	110865
17816	905	531	106761	1272	0	109469
17817	99054	535	3930	1115	0	104634
17818	3224	102631	1563	1279	0	108697
17819	1676	2928	788	101454	0	106846
17820	101617	1304	578	3452	0	106951
17821	3286	102583	605	1890	0	108364
17822	1684	106315	659	1111	0	109769
17823	103747	3751	590	949	0	109037
17824	104959	1504	603	953	0	108019
17825	4017	104501	681	1038	0	110237
17826	1988	3176	479	94032	0	99675
17827	1180	101650	524	3180	0	106534
17828	100551	3155	528	1619	0	105853
17829	101091	1442	519	1195	0	104247
17830	99693	890	471	1048	0	102102
17831	4154	97047	511	1279	0	102991
17832	1847	3112	463	98509	0	103931
17833	1252	1450	97443	3629	0	103774
17834	1236	900	2850	97034	0	102020
17835	1113	780	1197	100586	0	103676
17836	1144	821	96565	4206	0	102736
17837	94234	676	2947	2029	0	99886
17838	3514	784	1311	96734	0	102343
17839	1921	730	740	94557	0	97948
17840	1237	95759	674	3974	0	101644
17841	95312	3130	584	1871	0	100897
17842	3533	1554	635	91401	0	97123
17843	1823	93778	641	3458	0	99700
17844	87755	2799	576	1686	0	92816
17845	2943	87299	625	1281	0	92148
17846	81848	2640	678	886	0	86052
17847	3148	1179	80691	895	0	85913
17848	1331	736	70466	681	0	73214
17849	907	540	68400	593	0	70440
17850	716	67371	2810	710	0	71607
17851	1050	2222	1557	56271	0	61100
17852	725	64674	599	1785	0	67783
17853	64428	2153	488	934	0	68003
17854	2242	1115	64686	571	0	68614
17855	62887	623	2079	551	0	66140
17856	65045	595	1050	505	0	67195
17857	2749	503	562	63355	0	67169
17858	64293	478	490	2087	0	67348
17859	2476	467	442	64051	0	67436
17860	1187	562	63456	2191	0	67396
17861	61706	573	1981	1078	0	65338
17862	2169	63065	1001	748	0	66983
17863	1237	2017	590	63501	0	67345
17864	63842	958	399	2072	0	67271
17865	2294	626	372	63942	0	67234
17866	1236	479	62445	2289	0	66449
17867	835	457	1979	60966	0	64237
17868	684	62518	1025	2193	0	66420
17869	62537	2014	547	1047	0	66145
17870	2240	1000	405	62329	0	65974
17871	63122	551	411	2192	0	66276
17872	2400	441	352	63158	0	66351
17873	1238	426	366	60992	0	63022
17874	754	62205	457	2621	0	66037
17875	61258	1970	396	1133	0	64757
17876	2205	64061	356	854	0	67476
17877	1211	2111	350	57351	0	61023
17878	655	60892	320	2034	0	63901
17879	60163	2015	269	1088	0	63535
17880	60058	959	387	694	0	62098
17881	59555	556	321	625	0	61057
17882	2638	57409	411	632	0	61090
17883	468	41475	203	242	0	42388
17884	40013	1010	162	245	0	41430
17885	942	40970	180	283	0	42375
17886	619	1395	269	37483	0	39766
17887	371	296	36365	835	0	37867
17888	31745	152	591	322	0	32810
17889	33677	97	166	178	0	34118
17890	33180	119	85	154	0	33538
17891	663	33092	71	171	0	33997
17892	31813	486	47	143	0	32489
17893	618	180	32954	137	0	33889
17894	180	32005	417	136	0	32738
17895	153	757	131	29035	0	30076
17896	63	29393	72	215	0	29743
17897	27558	222	42	88	0	27910
17898	198	28588	42	74	0	28902
17899	75	182	35	28416	0	28708
17900	54	28730	25	215	0	29024
17901	59	196	22	29196	0	29473
17902	64	74	74	28319	0	28531
17903	89	54	28466	223	0	28832
17904	50	46	190	27370	0	27656
17905	27401	38	71	236	0	27746
17906	27180	47	47	96	0	27370
17907	258	36	36	27430	0	27760
17908	127	57	27324	208	0	27716
17909	75	43	191	26748	0	27057
17910	26883	47	68	245	0	27243
17911	28443	49	30	203	0	28725
17912	28876	38	34	103	0	29051
17913	262	30529	49	110	0	30950
17914	31001	191	46	92	0	31330
17915	257	107	30324	78	0	30766
17916	32788	63	212	211	0	33274
17917	280	57	65	34587	0	34989
17918	109	61	39	34876	0	35085
17919	105	58	40	35288	0	35491
17920	34346	71	31	342	0	34790
17921	33456	59	36	151	0	33702
17922	340	51	36	33850	0	34277
17923	195	74	35112	284	0	35665
17924	116	45	233	34870	0	35264
17925	126	52	75	34952	0	35205
17926	106	62	34748	354	0	35270
17927	78	34937	255	199	0	35469
17928	117	248	76	35785	0	36226
17929	35999	97	53	327	0	36476
17930	309	83	35	36157	0	36584
17931	132	63	33	36639	0	36867
17932	36732	57	35	387	0	37211
17933	310	36426	56	204	0	36996
17934	155	37258	44	141	0	37598
17935	36512	349	50	129	0	37040
17936	328	159	36725	79	0	37291
17937	33406	92	277	160	0	33935
17938	401	85	38822	79	0	39387
17939	153	39328	296	123	0	39900
17940	39739	289	84	121	0	40233
17941	39900	102	57	127	0	40186
17942	39946	81	37	112	0	40176
17943	40196	63	39	109	0	40407
17944	429	84	40022	85	0	40620
17945	178	56	274	39033	0	39541
17946	40006	62	127	348	0	40543
17947	369	76	42309	153	0	42907
17948	208	72	42088	117	0	42485
17949	111	42177	327	99	0	42714
17950	42563	240	144	113	0	43060
17951	297	91	67	42087	0	42542
17952	42818	56	64	298	0	43236
17953	394	44065	50	162	0	44671
17954	139	248	36	47926	0	48349
17955	95	76	38	48281	0	48490
17956	95	60	24	49679	0	49858
17957	125	56	50490	544	0	51215
17958	67	51349	429	326	0	52171
17959	56086	427	147	149	0	56809
17960	621	176	79	56365	0	57241
17961	56334	74	69	648	0	57125
17962	55513	50	51	292	0	55906
17963	825	40	36	55917	0	56818
17964	365	58	57541	644	0	58608
17965	155	44	598	56583	0	57380
17966	89	57584	232	719	0	58624
17967	92	573	86	58672	0	59423
17968	119	223	58255	690	0	59287
17969	56643	78	591	304	0	57616
17970	659	45	243	59157	0	60104
17971	58497	45	136	698	0	59376
17972	756	77	58355	274	0	59462
17973	54460	51	620	194	0	55325
17974	735	74	58820	115	0	59744
17975	54302	49	626	133	0	55110
17976	654	57077	263	159	0	58153
17977	266	59195	110	219	0	59790
17978	161	741	68	58819	0	59789
17979	102	275	64	57725	0	58166
17980	122	118	59	59320	0	59619
17981	58890	66	60	840	0	59856
17982	642	69	51	59755	0	60517
17983	313	60	59919	715	0	61007
17984	55718	55	592	407	0	56772
17985	612	60390	254	272	0	61528
17986	60908	567	137	205	0	61817
17987	59071	231	104	152	0	59558
17988	902	130	60160	147	0	61339
17989	410	86	616	58735	0	59847
17990	219	66	276	63287	0	63848
17991	235	88	64344	908	0	65575
17992	144	63764	682	456	0	65046
17993	63174	662	270	231	0	64337
17994	63563	265	129	236	0	64193
17995	896	124	113	64682	0	65815
17996	392	82	95	65545	0	66114
17997	221	94	110	68659	0	69084
17998	66811	94	89	1153	0	68147
17999	848	68948	130	503	0	70429
18000	69339	811	129	294	0	70573
18001	68750	294	100	241	0	69385
18002	1200	173	72229	203	0	73805
18003	491	179	949	69020	0	70639
18004	282	74084	388	1036	0	75790
18005	227	990	158	74964	0	76339
18006	260	483	132	78006	0	78881
18007	262	171	79639	1441	0	81513
18008	79941	135	1126	631	0	81833
18009	90674	92	453	364	0	91583
18010	93453	113	223	326	0	94115
18011	2017	135	188	92332	0	94672
18012	739	151	166	88412	0	89468
18013	376	90572	187	1985	0	93120
18014	290	94230	223	779	0	95522
18015	91565	1931	165	413	0	94074
18016	1692	89516	271	468	0	91947
18017	778	1680	90022	361	0	92841
18018	440	530	1638	90251	0	92859
18019	91856	241	647	1829	0	94573
18020	1924	198	91487	762	0	94371
18021	853	215	91324	402	0	92794
18022	91255	173	2135	395	0	93958
18023	91934	215	706	361	0	93216
18024	2275	227	310	90405	0	93217
18025	992	261	91059	1896	0	94208
18026	553	201	1726	90627	0	93107
18027	552	290	91727	1999	0	94568
18028	578	233	92711	871	0	94393
18029	431	93013	2145	717	0	96306
18030	93657	1695	808	474	0	96634
18031	93373	614	431	459	0	94877
18032	2294	93005	360	535	0	96194
18033	968	1804	344	92333	0	95449
18034	645	669	306	93801	0	95421
18035	518	349	334	95468	0	96669
18036	93325	230	357	2389	0	96301
18037	1928	92873	348	1193	0	96342
18038	91564	1687	369	613	0	94233
18039	91815	681	353	531	0	93380
18040	2455	416	89405	472	0	92748
18041	999	89580	1819	503	0	92901
18042	716	1855	716	90017	0	93304
18043	654	738	90666	1877	0	93935
18044	87550	427	1867	953	0	90797
18045	91575	288	763	657	0	93283
18046	91793	269	437	554	0	93053
18047	90121	234	426	530	0	91311
18048	2601	270	408	87460	0	90739
18049	1185	314	87445	1899	0	90843
18050	855	262	1784	86864	0	89765
18051	87655	316	761	2057	0	90789
18052	87273	272	483	985	0	89013
18053	2336	85649	416	734	0	89135
18054	83097	1577	405	521	0	85600
18055	2090	648	82707	422	0	85867
18056	1000	407	81912	374	0	83693
18057	77363	355	2077	410	0	80205
18058	1966	79766	756	474	0	82962
18059	893	1348	435	72304	0	74980
18060	586	75615	294	1380	0	77875
18061	506	1331	253	76316	0	78406
18062	499	524	265	76838	0	78126
18063	553	323	244	79024	0	80144
18064	76607	316	259	1857	0	79039
18065	77516	347	265	686	0	78814
18066	76937	331	317	443	0	78028
18067	2024	324	75354	379	0	78081
18068	72079	306	1521	454	0	74360
18069	1744	265	703	76947	0	79659
18070	908	227	450	80098	0	81683
18071	760	267	79377	1853	0	82257
18072	659	269	1579	84151	0	86658
18073	88298	240	660	2003	0	91201
18074	2266	262	88178	825	0	91531
18075	899	200	1892	88441	0	91432
18076	89043	195	758	2061	0	92057
18077	88643	240	500	816	0	90199
18078	2548	242	89134	563	0	92487
18079	1148	289	90609	454	0	92500
18080	721	298	2235	90277	0	93531
18081	92184	290	752	2083	0	95309
18082	93163	275	468	844	0	94750
18083	2524	306	419	85616	0	88865
18084	1037	91859	401	2005	0	95302
18085	91154	1768	404	858	0	94184
18086	2142	93305	429	725	0	96601
18087	978	1857	384	93530	0	96749
18088	830	598	92491	2083	0	96002
18089	737	309	91270	835	0	93151
18090	746	265	92323	517	0	93851
18091	729	223	2388	87344	0	90684
18092	670	201	857	90372	0	92100
18093	89068	231	516	2323	0	92138
18094	2156	88487	459	1047	0	92149
18095	88916	1715	393	640	0	91664
18096	2379	596	367	83194	0	86536
18097	983	86478	369	1828	0	89658
18098	685	89643	386	786	0	91500
18099	695	2027	339	87234	0	90295
18100	86788	589	332	1956	0	89665
18101	1968	87736	419	885	0	91008
18102	82292	1502	367	514	0	84675
18103	1799	84817	327	622	0	87565
18104	82854	1557	534	385	0	85330
18105	2008	537	81814	367	0	84726
18106	975	344	80457	339	0	82115
18107	499	78384	1804	402	0	81089
18108	70277	1729	1450	431	0	73887
18109	1103	66897	323	318	0	68641
18110	405	63237	231	247	0	64120
18111	643	1196	231	63028	0	65098
18112	63171	307	198	922	0	64598
18113	982	64152	169	403	0	65706
18114	62047	792	170	209	0	63218
18115	891	62253	169	223	0	63536
18116	60383	784	118	164	0	61449
18117	833	60904	114	225	0	62076
18118	303	62364	127	198	0	62992
18119	213	1006	142	59231	0	60592
18120	167	61421	104	749	0	62441
18121	60056	749	106	229	0	61140
18122	797	298	59856	170	0	61121
18123	258	152	725	59548	0	60683
18124	221	134	61823	796	0	62974
18125	169	142	790	59757	0	60858
18126	200	107	260	61993	0	62560
18127	202	134	58241	917	0	59494
18128	48491	128	793	486	0	49898
18129	844	56981	320	289	0	58434
18130	57508	742	178	237	0	58665
18131	882	58937	157	268	0	60244
18132	403	799	146	58508	0	59856
18133	58660	286	177	797	0	59920
18134	58856	213	203	309	0	59581
18135	59441	165	197	286	0	60089
18136	1048	184	171	57854	0	59257
18137	499	200	147	58502	0	59348
18138	368	61315	163	940	0	62786
18139	62015	828	190	410	0	63443
18140	62700	345	189	260	0	63494
18141	62502	237	218	245	0	63202
18142	61939	232	234	228	0	62633
18143	1050	60177	262	286	0	61775
18144	390	801	274	61204	0	62669
18145	348	361	60144	859	0	61712
18146	58281	279	857	380	0	59797
18147	62681	236	259	325	0	63501
18148	1128	298	61020	238	0	62684
18149	522	319	61169	222	0	62232
18150	351	313	967	60692	0	62323
18151	324	297	288	64115	0	65024
18152	293	307	184	64625	0	65409
18153	62720	340	162	1145	0	64367
18154	1022	335	157	63507	0	65021
18155	462	310	62276	1058	0	64106
18156	347	289	899	62615	0	64150
18157	327	296	64612	1059	0	66294
18158	338	248	1010	62177	0	63773
18159	292	274	332	68396	0	69294
18160	341	261	68655	1218	0	70475
18161	59713	255	1111	560	0	61639
18162	1090	69652	341	384	0	71467
18163	69976	1233	195	241	0	71645
18164	1335	539	124	72707	0	74705
18165	72131	391	160	1330	0	74012
18166	1422	77614	144	551	0	79731
18167	552	83172	134	397	0	84255
18168	491	2377	142	87484	0	90494
18169	426	780	91662	1857	0	94725
18170	420	472	89477	562	0	90931
18171	304	90308	2247	530	0	93389
18172	80454	1743	740	250	0	83187
18173	1566	556	316	80627	0	83065
18174	79297	269	212	1602	0	81380
18175	1640	79251	198	614	0	81703
18176	564	81935	189	443	0	83131
18177	459	2075	168	80569	0	83271
18178	80703	694	118	1639	0	83154
18179	81200	368	94	600	0	82262
18180	2132	253	80162	376	0	82923
18181	820	232	78726	261	0	80039
18182	76227	214	1882	195	0	78518
18183	1651	78908	652	279	0	81490
18184	78356	1550	389	221	0	80516
18185	1888	524	207	77445	0	80064
18186	705	374	76582	1550	0	79211
18187	70990	267	1606	576	0	73439
18188	1582	75068	609	422	0	77681
18189	589	77159	409	281	0	78438
18190	524	1899	217	75559	0	78199
18191	76712	684	239	1623	0	79258
18192	1621	366	235	77013	0	79235
18193	78995	277	244	1804	0	81320
18194	1868	326	77515	610	0	80319
18195	75346	362	1432	414	0	77554
18196	79247	283	443	364	0	80337
18197	2213	255	76226	370	0	79064
18198	72140	234	1541	323	0	74238
18199	1941	75392	629	360	0	78322
18200	847	1563	430	73164	0	76004
18201	615	76188	364	1496	0	78663
18202	76791	1695	289	530	0	79305
18203	1885	625	315	74177	0	77002
18204	833	74829	346	1597	0	77605
18205	595	1652	321	74669	0	77237
18206	500	75493	260	1804	0	78057
18207	475	1814	185	76379	0	78853
18208	75692	772	221	1853	0	78538
18209	1761	496	245	75971	0	78473
18210	825	419	75007	1921	0	78172
18211	71957	354	1575	895	0	74781
18212	1828	374	554	75351	0	78107
18213	886	362	74053	1839	0	77140
18214	693	346	72140	829	0	74008
18215	713	323	75669	598	0	77303
18216	579	283	2222	71821	0	74905
18217	645	274	919	76673	0	78511
18218	575	309	625	76441	0	77950
18219	523	321	510	77353	0	78707
18220	76246	326	448	2368	0	79388
18221	77622	353	510	1019	0	79504
18222	78169	316	421	773	0	79679
18223	79189	448	336	700	0	80673
18224	2490	415	277	76953	0	80135
18225	1195	438	79604	1992	0	83229
18226	77844	370	1600	993	0	80807
18227	82289	407	589	771	0	84056
18228	2515	491	407	80231	0	83644
18229	1164	429	386	82807	0	84786
18230	82822	400	405	2325	0	85952
18231	2251	345	382	77432	0	80410
18232	1078	79133	522	2125	0	82858
18233	80770	1647	592	984	0	83993
18234	79493	701	577	832	0	81603
18235	2548	542	81655	700	0	85445
18236	1236	467	1861	80289	0	83853
18237	926	460	807	83656	0	85849
18238	82050	421	610	2479	0	85560
18239	82593	415	526	1186	0	84720
18240	2665	398	355	81784	0	85202
18241	1415	513	81660	2199	0	85787
18242	1118	356	81773	1150	0	84397
18243	942	329	2074	81574	0	84919
18244	985	388	875	83671	0	85919
18245	81103	308	604	2424	0	84439
18246	2322	80380	585	1283	0	84570
18247	1204	80732	547	901	0	83384
18248	991	82774	549	749	0	85063
18249	951	2127	621	80630	0	84329
18250	80472	761	564	2003	0	83800
18251	79913	561	341	1016	0	81831
18252	2308	80625	332	892	0	84157
18253	81084	1784	272	736	0	83876
18254	2246	777	289	80430	0	83742
18255	1064	585	81761	2047	0	85457
18256	947	451	1546	79525	0	82469
18257	982	365	581	81473	0	83401
18258	1033	351	435	81306	0	83125
18259	77015	258	354	2376	0	80003
18260	1924	377	356	73338	0	75995
18261	1034	73989	396	2104	0	77523
18262	71472	1279	629	1041	0	74421
18263	1720	71202	401	853	0	74176
18264	727	69108	362	738	0	70935
18265	611	70167	394	631	0	71803
18266	635	1055	61725	469	0	63884
18267	290	59795	1075	463	0	61623
18268	434	628	51241	299	0	52602
18269	44725	161	479	210	0	45575
18270	47647	46	107	201	0	48001
18271	330	61	49863	106	0	50360
18272	46824	100	250	228	0	47402
18273	51545	42	67	169	0	51823
18274	361	73	52098	119	0	52651
18275	129	54125	222	151	0	54627
18276	138	260	71	54550	0	55019
18277	55060	67	55	359	0	55541
18278	310	59	55	54414	0	54838
18279	57504	60	48	452	0	58064
18280	56379	60	82	172	0	56693
18281	327	75	57041	124	0	57567
18282	55035	68	224	157	0	55484
18283	279	59002	69	159	0	59509
18284	59540	259	45	143	0	59987
18285	324	84	46	59486	0	59940
18286	205	89	59791	311	0	60396
18287	148	89	236	58190	0	58663
18288	58974	76	83	344	0	59477
18289	298	59454	72	315	0	60139
18290	192	287	59274	176	0	59929
18291	149	120	254	55383	0	55906
18292	243	111	60021	351	0	60726
18293	102	60248	277	204	0	60831
18294	59740	262	131	184	0	60317
18295	318	92	74	59717	0	60201
18296	182	113	60600	335	0	61230
18297	163	136	57669	166	0	58134
18298	58137	98	287	189	0	58711
18299	355	124	98	61339	0	61916
18300	167	137	102	61741	0	62147
18301	181	122	62980	373	0	63656
18302	208	136	62035	153	0	62532
18303	168	64340	351	213	0	65072
18304	181	323	114	64920	0	65538
18305	207	128	94	63457	0	63886
18306	151	64766	119	401	0	65437
18307	213	369	63274	157	0	64013
18308	56488	147	346	205	0	57186
18309	410	81	129	65045	0	65665
18310	210	113	66725	397	0	67445
18311	172	119	346	61783	0	62420
18312	190	65881	135	420	0	66626
18313	261	406	64654	164	0	65485
18314	58380	186	399	205	0	59170
18315	476	159	65968	176	0	66779
18316	220	147	64574	140	0	65081
18317	209	136	63362	146	0	63853
18318	189	133	69044	108	0	69474
18319	165	164	523	65332	0	66184
18320	240	127	74056	529	0	74952
18321	163	132	589	69059	0	69943
18322	102	73803	204	619	0	74728
18323	78170	561	130	200	0	79061
18324	816	152	96	78666	0	79730
18325	303	114	77741	829	0	78987
18326	125	77602	829	351	0	78907
18327	197	759	216	77830	0	79002
18328	77113	205	154	856	0	78328
18329	737	78499	123	263	0	79622
18330	265	774	107	79094	0	80240
18331	79944	190	137	815	0	81086
18332	861	142	79258	210	0	80471
18333	76462	91	801	202	0	77556
18334	933	104	80947	108	0	82092
18335	74310	113	812	178	0	75413
18336	76755	52	247	153	0	77207
18337	929	85	76701	127	0	77842
18338	217	75696	718	212	0	76843
18339	203	675	267	74924	0	76069
18340	188	185	77453	732	0	78558
18341	117	199	727	72285	0	73328
18342	128	93	213	76202	0	76636
18343	169	90	77190	858	0	78307
18344	149	99	76431	246	0	76925
18345	114	88	899	75772	0	76873
18346	77984	58	265	820	0	79127
18347	739	77347	169	345	0	78600
18348	225	78725	122	233	0	79305
18349	78802	808	144	169	0	79923
18350	79810	214	123	271	0	80418
18351	920	103	126	80126	0	81275
18352	280	93	138	81027	0	81538
18353	148	109	110	82340	0	82707
18354	79716	91	117	961	0	80885
18355	754	77967	166	375	0	79262
18356	250	80423	177	265	0	81115
18357	210	856	152	79815	0	81033
18358	155	256	166	80919	0	81496
18359	167	140	150	81497	0	81954
18360	80215	112	151	1063	0	81541
18361	795	81516	180	581	0	83072
18362	82623	814	156	250	0	83843
18363	965	305	82290	231	0	83791
18364	338	83466	917	284	0	85005
18365	218	922	322	82859	0	84321
18366	82371	305	202	1022	0	83900
18367	1069	207	83420	371	0	85067
18368	442	177	83340	246	0	84205
18369	292	136	1214	81474	0	83116
18370	212	152	402	84403	0	85169
18371	202	146	200	83310	0	83858
18372	215	132	214	81278	0	81839
18373	231	178	191	80102	0	80702
18374	203	79160	204	1373	0	80940
18375	255	931	194	79389	0	80769
18376	77878	359	203	1198	0	79638
18377	966	79390	248	683	0	81287
18378	77628	973	260	397	0	79258
18379	1146	443	76460	340	0	78389
18380	498	253	77268	366	0	78385
18381	317	222	1259	79135	0	80933
18382	346	232	103024	1271	0	104873
18383	328	187	1873	100378	0	102766
18384	276	196	797	102590	0	103859
18385	104253	197	394	2550	0	107394
18386	101123	192	307	1057	0	102679
18387	2558	107366	360	584	0	110868
18388	981	112437	268	471	0	114157
18389	469	2753	258	109809	0	113289
18390	110850	1014	273	2393	0	114530
18391	2317	476	112526	1033	0	116352
18392	974	281	2294	111189	0	114738
18393	568	278	929	113174	0	114949
18394	435	300	111523	3171	0	115429
18395	315	110847	2355	1591	0	115108
18396	366	2275	960	111212	0	114813
18397	462	904	112698	2690	0	116754
18398	368	421	2321	111363	0	114473
18399	105219	299	967	2757	0	109242
18400	2164	107845	541	1376	0	111926
18401	940	110524	393	788	0	112645
18402	576	2955	334	108424	0	112289
18403	105495	1060	351	2593	0	109499
18404	2271	107184	400	1386	0	111241
18405	108014	2286	430	926	0	111656
18406	2605	1021	107595	799	0	112020
18407	1190	580	111026	804	0	113600
18408	730	467	3186	102754	0	107137
18409	634	430	1209	112832	0	115105
18410	109914	483	576	3454	0	114427
18411	2899	517	390	109156	0	112962
18412	1435	572	109472	2982	0	114461
18413	794	715	2478	106418	0	110405
18414	730	606	1079	111644	0	114059
18415	734	480	107463	3669	0	112346
18416	99323	523	2639	1855	0	104340
18417	2710	473	1349	107256	0	111788
18418	102172	375	753	3121	0	106421
18419	2429	99093	699	1803	0	104024
18420	96556	2290	691	1133	0	100670
18421	2324	96846	589	1221	0	100980
18422	1079	98374	675	1162	0	101290
18423	1048	2880	756	90552	0	95236
18424	90838	1237	681	2449	0	95205
18425	91663	738	403	1352	0	94156
18426	2701	726	418	90346	0	94191
18427	90909	633	452	2450	0	94444
18428	90609	544	422	1508	0	93083
18429	3032	568	468	89676	0	93744
18430	86944	580	513	2394	0	90431
18431	2514	88769	600	1517	0	93400
18432	89128	2133	711	1000	0	92972
18433	2484	1160	89127	1028	0	93799
18434	89556	577	2134	1199	0	93466
18435	2632	376	1181	90626	0	94815
18436	1397	331	786	93357	0	95871
18437	834	349	749	93549	0	95481
18438	757	558	756	93602	0	95673
18439	661	507	694	91236	0	93098
18440	719	86600	766	3543	0	91628
18441	790	91544	716	2027	0	95077
18442	90537	2556	609	1358	0	95060
18443	2595	1323	89715	1131	0	94764
18444	87255	936	2173	1060	0	91424
18445	2745	956	89939	1069	0	94709
18446	1600	832	2332	87277	0	92041
18447	1156	987	985	91523	0	94651
18448	87959	808	577	3359	0	92703
18449	2983	722	89173	1756	0	94634
18450	2010	706	2095	88829	0	93640
18451	1519	640	92649	2803	0	97611
18452	1272	94669	2386	1855	0	100182
18453	1393	2317	1115	96494	0	101319
18454	96192	1129	650	3024	0	100995
18455	94077	722	620	1805	0	97224
18456	96136	669	602	1406	0	98813
18457	3541	96548	685	1356	0	102130
18458	1800	100087	812	1402	0	104101
18459	87467	2874	885	1417	0	92643
18460	2593	98159	646	1621	0	103019
18461	1378	98525	631	1743	0	102277
18462	1178	2877	95006	1643	0	100704
18463	936	94960	2138	1566	0	99600
18464	837	96229	1166	1307	0	99539
18465	987	3108	642	94463	0	99200
18466	957	1631	94963	2665	0	100216
18467	1063	1047	92849	1477	0	96436
18468	87596	696	2949	1198	0	92439
18469	2815	639	93914	1063	0	98431
18470	94035	511	2554	1110	0	98210
18471	2938	571	1350	91718	0	96577
18472	1749	95754	778	2875	0	101156
18473	98820	2214	665	1707	0	103406
18474	102079	1175	724	1313	0	105291
18475	3411	644	729	101059	0	105843
18476	1854	540	740	102301	0	105435
18477	1454	574	692	103082	0	105802
18478	99969	526	550	3748	0	104793
18479	98801	479	520	1943	0	101743
18480	99663	590	389	1280	0	101922
18481	3541	93109	406	1196	0	98252
18482	71951	1172	227	424	0	73774
18483	1420	71598	221	443	0	73682
18484	756	72052	190	482	0	73480
18485	705	2341	640	65860	0	69546
18486	487	68219	179	1013	0	69898
18487	64195	905	179	431	0	65710
18488	954	440	90	63233	0	64717
18489	61537	218	77	823	0	62655
18490	817	60597	113	432	0	61959
18491	358	63197	101	256	0	63912
18492	63208	851	108	210	0	64377
18493	813	65261	125	241	0	66440
18494	387	765	140	65779	0	67071
18495	419	307	158	66574	0	67458
18496	66179	188	109	963	0	67439
18497	855	172	104	66650	0	67781
18498	476	159	68228	903	0	69766
18499	272	164	819	68271	0	69526
18500	69973	163	310	1015	0	71461
18501	976	72108	172	466	0	73722
18502	75221	990	152	314	0	76677
18503	74871	380	136	246	0	75633
18504	75466	255	105	296	0	76122
18505	1497	237	74234	204	0	76172
18506	590	247	71503	175	0	72515
18507	68095	162	1184	184	0	69625
18508	1070	72553	427	272	0	74322
18509	409	1036	197	72903	0	74545
18510	229	388	163	72068	0	72848
18511	187	70547	164	1266	0	72164
18512	228	73140	139	523	0	74030
18513	245	1257	149	73009	0	74660
18514	250	430	126	74007	0	74813
18515	298	281	71702	1285	0	73566
18516	300	292	68189	491	0	69272
18517	68311	219	1287	305	0	70122
18518	73895	177	423	259	0	74754
18519	1416	207	208	73217	0	75048
18520	601	234	73520	1198	0	75553
18521	365	193	1093	72498	0	74149
18522	72171	223	396	1283	0	74073
18523	1311	263	72780	555	0	74909
18524	581	229	1098	72830	0	74738
18525	400	283	74252	1202	0	76137
18526	341	72629	1201	633	0	74804
18527	466	1165	73578	305	0	75514
18528	411	565	1232	71839	0	74047
18529	73874	295	570	1191	0	75930
18530	1229	232	303	75018	0	76782
18531	75844	224	200	1353	0	77621
18532	76620	215	221	577	0	77633
18533	74694	219	185	416	0	75514
18534	1605	266	72304	378	0	74553
18535	72810	213	1121	388	0	74532
18536	1410	214	471	74331	0	76426
18537	704	194	275	75003	0	76176
18538	463	242	74249	1483	0	76437
18539	360	256	1142	73799	0	75557
18540	75139	199	452	1402	0	77192
18541	1227	75726	257	696	0	77906
18542	77659	1089	199	450	0	79397
18543	78593	421	164	430	0	79608
18544	79254	271	184	401	0	80110
18545	1681	232	168	77477	0	79558
18546	773	212	78715	1423	0	81123
18547	520	171	1207	79977	0	81875
18548	448	180	497	82325	0	83450
18549	81270	197	380	1687	0	83534
18550	78569	175	260	743	0	79747
18551	1804	215	76854	422	0	79295
18552	740	247	1267	75252	0	77506
18553	496	195	77191	1508	0	79390
18554	76468	168	1504	690	0	78830
18555	1626	87112	555	561	0	89854
18556	86289	1502	380	334	0	88505
18557	1726	89281	300	431	0	91738
18558	87855	1618	251	316	0	90040
18559	1824	88932	250	369	0	91375
18560	715	1683	297	87832	0	90527
18561	522	495	217	91420	0	92654
18562	90765	235	205	2159	0	93364
18563	91097	161	223	820	0	92301
18564	91276	152	222	467	0	92117
18565	89442	140	221	362	0	90165
18566	89996	143	225	313	0	90677
18567	2276	194	230	86190	0	88890
18568	891	87688	253	1766	0	90598
18569	627	1600	221	84527	0	86975
18570	465	85929	218	1801	0	88413
18571	496	1685	222	82624	0	85027
18572	420	84475	235	1812	0	86942
18573	571	1695	203	83500	0	85969
18574	526	508	80793	1895	0	83722
18575	74570	274	1611	713	0	77168
18576	1801	80548	520	545	0	83414
18577	81057	1516	300	358	0	83231
18578	1942	517	80150	387	0	82996
18579	77184	275	1629	415	0	79503
18580	1992	227	83676	374	0	86269
18581	804	326	1739	81783	0	84652
18582	533	89412	605	1905	0	92455
18583	583	1897	91778	680	0	94938
18584	500	629	2011	91430	0	94570
18585	89922	372	699	2249	0	93242
18586	2192	239	375	93303	0	96109
18587	999	225	260	94598	0	96082
18588	708	230	234	95945	0	97117
18589	603	277	92824	2803	0	96507
18590	633	237	2041	89404	0	92315
18591	501	89952	740	2415	0	93608
18592	576	1961	351	89377	0	92265
18593	584	712	244	90594	0	92134
18594	88313	383	210	2598	0	91504
18595	2375	373	193	90764	0	93705
18596	1047	276	92989	2379	0	96691
18597	737	266	92611	932	0	94546
18598	576	256	91875	649	0	93356
18599	471	89974	2711	595	0	93751
18600	87087	2198	1217	519	0	91021
18601	2088	87414	500	467	0	90469
18602	85578	2076	386	402	0	88442
18603	2271	741	262	84352	0	87626
18604	1011	479	86262	2047	0	89799
18605	706	310	84829	922	0	86767
18606	422	87117	2444	652	0	90635
18607	516	2050	848	85980	0	89394
18608	393	822	428	87592	0	89235
18609	398	521	308	89612	0	90839
18610	399	391	87759	2897	0	91446
18611	79328	333	2171	1280	0	83112
18612	2313	321	88021	761	0	91416
18613	1038	335	2267	84480	0	88120
18614	664	359	853	89299	0	91175
18615	588	318	87295	2909	0	91110
18616	80445	283	2234	1332	0	84294
18617	2265	86974	1011	917	0	91167
18618	87035	2168	553	627	0	90383
18619	2472	882	436	80791	0	84581
18620	995	86623	435	2236	0	90289
18621	711	2238	371	87739	0	91059
18622	87022	885	385	2611	0	90903
18623	2382	562	409	86946	0	90299
18624	1028	441	85468	2686	0	89623
18625	82867	449	2255	1236	0	86807
18626	86166	368	892	1030	0	88456
18627	2913	406	84664	792	0	88775
18628	1281	343	2286	83972	0	87882
18629	85810	338	1016	2619	0	89783
18630	2492	343	619	84329	0	87783
18631	1147	305	555	83848	0	85855
18632	749	351	568	84440	0	86108
18633	625	390	521	84818	0	86354
18634	576	386	81947	3261	0	86170
18635	560	399	2349	81474	0	84782
18636	527	431	81396	2914	0	85268
18637	78672	405	2584	1427	0	83088
18638	82122	395	1136	1045	0	84698
18639	82006	428	774	883	0	84091
18640	81559	396	617	953	0	83525
18641	3178	353	672	78415	0	82618
18642	77293	353	685	2655	0	80986
18643	2614	347	76449	1406	0	80816
18644	1271	342	76582	951	0	79146
18645	71294	286	2800	961	0	75341
18646	2201	72517	1340	975	0	77033
18647	994	72339	834	1096	0	75263
18648	895	2429	752	70510	0	74586
18649	678	886	71159	2363	0	75086
18650	66154	507	2225	1429	0	70315
18651	2283	438	71005	1065	0	74791
18652	1046	66920	2091	1101	0	71158
18653	898	1675	66762	953	0	70288
18654	536	61822	2007	914	0	65279
18655	53143	1799	1363	737	0	57042
18656	1488	53483	674	712	0	56357
18657	776	51453	441	653	0	53323
18658	587	1581	464	50749	0	53381
18659	593	670	50079	1593	0	52935
18660	531	356	1406	48470	0	50763
18661	512	252	710	50069	0	51543
18662	513	236	48887	1939	0	51575
18663	480	217	1542	45142	0	47381
18664	529	47697	820	1538	0	50584
18665	486	1276	557	48899	0	51218
18666	48676	554	501	1632	0	51363
18667	1476	352	443	49265	0	51536
18668	868	285	48674	1705	0	51532
18669	634	301	1446	49117	0	51498
18670	546	322	48822	1724	0	51414
18671	47503	300	1575	900	0	50278
18672	1514	270	779	48936	0	51499
18673	49198	299	572	1657	0	51726
18674	1616	296	49116	951	0	51979
18675	45301	262	1510	698	0	47771
18676	1570	49160	782	680	0	52192
18677	880	1225	49504	561	0	52170
18678	667	1093	1528	47845	0	51133
18679	579	369	49971	1498	0	52417
18680	449	46472	1431	933	0	49285
18681	464	49010	758	630	0	50862
18682	39419	1080	419	475	0	41393
18683	1005	42345	293	465	0	44108
18684	42041	953	359	379	0	43732
18685	1147	423	283	42447	0	44300
18686	541	232	42044	1093	0	43910
18687	344	42787	1057	567	0	44755
18688	404	1100	471	42234	0	44209
18689	322	401	299	44507	0	45529
18690	374	269	254	45636	0	46533
18691	356	261	261	44028	0	44906
18692	326	43018	294	1385	0	45023
18693	299	45302	303	631	0	46535
18694	41491	1082	292	395	0	43260
18695	913	41393	257	364	0	42927
18696	355	878	220	38783	0	40236
18697	280	306	38659	867	0	40112
18698	183	38680	801	420	0	40084
18699	233	790	303	37477	0	38803
18700	260	477	162	36302	0	37201
18701	194	37617	182	890	0	38883
18702	36392	788	183	333	0	37696
18703	768	296	36806	246	0	38116
18704	33029	195	694	216	0	34134
18705	665	35877	309	198	0	37049
18706	31652	651	100	133	0	32536
18707	570	33370	102	165	0	34207
18708	241	696	102	34948	0	35987
18709	171	285	75	35801	0	36332
18710	34621	161	111	857	0	35750
18711	658	171	84	35182	0	36095
18712	280	178	34839	740	0	36037
18713	139	33773	624	369	0	34905
18714	107	34337	209	197	0	34850
18715	150	825	132	33707	0	34814
18716	135	332	33949	674	0	35090
18717	134	253	596	33170	0	34153
18718	99	156	193	34195	0	34643
18719	111	160	33334	837	0	34442
18720	125	169	32705	365	0	33364
18721	77	33320	695	261	0	34353
18722	33014	643	233	230	0	34120
18723	646	290	138	31884	0	32958
18724	201	32360	105	677	0	33343
18725	32944	649	109	329	0	34031
18726	598	328	96	32951	0	33973
18727	244	189	100	32716	0	33249
18728	115	32309	100	875	0	33399
18729	125	699	117	32058	0	32999
18730	32140	306	98	780	0	33324
18731	608	233	111	32585	0	33537
18732	288	197	112	33161	0	33758
18733	192	219	32198	868	0	33477
18734	157	243	30984	416	0	31800
18735	31306	200	734	338	0	32578
18736	629	208	269	32006	0	33112
18737	269	228	131	32357	0	32985
18738	192	219	139	32901	0	33451
18739	191	234	31919	961	0	33305
18740	31085	215	667	473	0	32440
18741	692	215	295	32094	0	33296
18742	318	186	204	32891	0	33599
18743	31636	233	179	963	0	33011
18744	673	31633	212	557	0	33075
18745	352	703	31573	405	0	33033
18746	214	428	701	29826	0	31169
18747	213	31398	309	870	0	32790
18748	233	700	210	31931	0	33074
18749	31300	361	206	904	0	32771
18750	701	300	190	31526	0	32717
18751	30718	254	166	970	0	32108
18752	30849	274	174	566	0	31863
18753	852	242	173	29717	0	30984
18754	347	29715	219	942	0	31223
18755	214	30973	224	583	0	31994
18756	276	830	30426	455	0	31987
18757	206	361	733	29460	0	30760
18758	235	264	374	31237	0	32110
18759	247	265	211	31834	0	32557
18760	30815	263	157	1125	0	32360
18761	781	220	153	31291	0	32445
18762	401	229	31164	1016	0	32810
18763	30766	202	682	651	0	32301
18764	801	212	311	32594	0	33918
18765	396	207	226	33620	0	34449
18766	265	252	32768	1154	0	34439
18767	31060	243	733	649	0	32685
18768	785	213	320	33323	0	34641
18769	398	212	33779	1066	0	35455
18770	262	206	747	33556	0	34771
18771	324	164	422	29670	0	30580
18772	268	33974	305	1051	0	35598
18773	33724	661	256	608	0	35249
18774	33380	306	217	585	0	34488
18775	900	33310	243	568	0	35021
18776	32704	653	238	502	0	34097
18777	32024	300	219	495	0	33038
18778	959	204	186	31951	0	33300
18779	422	204	30855	983	0	32464
18780	305	169	29270	583	0	30327
18781	237	155	28229	403	0	29024
18782	238	188	28661	393	0	29480
18783	269	509	781	25289	0	26848
18784	159	95	319	26752	0	27325
18785	194	107	173	26587	0	27061
18786	240	113	148	27447	0	27948
18787	26779	57	162	830	0	27828
18788	578	27379	159	494	0	28610
18789	27210	402	172	345	0	28129
18790	563	176	27147	245	0	28131
18791	283	90	28203	251	0	28827
18792	137	192	568	28612	0	29509
18793	29161	76	371	635	0	30243
18794	26346	66	159	361	0	26932
18795	570	28977	135	293	0	29975
18796	237	29578	97	250	0	30162
18797	173	562	81	29393	0	30209
18798	29344	185	86	478	0	30093
18799	444	29791	86	284	0	30605
18800	30196	384	100	235	0	30915
18801	30250	181	99	236	0	30766
18802	30439	89	76	238	0	30842
18803	575	62	31249	166	0	32052
18804	256	31441	415	168	0	32280
18805	31064	326	217	147	0	31754
18806	30731	138	112	167	0	31148
18807	473	29993	74	159	0	30699
18808	113	28614	39	80	0	28846
18809	28502	289	58	62	0	28911
18810	275	111	22	28476	0	28884
18811	146	72	28914	241	0	29373
18812	27452	42	234	135	0	27863
18813	269	47	88	29196	0	29600
18814	115	30760	46	274	0	31195
18815	87	263	42	31484	0	31876
18816	105	109	32008	269	0	32491
18817	70	63	259	31545	0	31937
18818	33414	57	100	359	0	33930
18819	305	52	56	33764	0	34177
18820	145	47	40	34078	0	34310
18821	123	61	36349	381	0	36914
18822	107	52	275	34612	0	35046
18823	73	36505	108	344	0	37030
18824	36577	292	87	143	0	37099
18825	34779	113	62	109	0	35063
18826	394	70	36838	76	0	37378
18827	173	58	290	35317	0	35838
18828	94	36557	118	302	0	37071
18829	88	37386	79	182	0	37735
18830	36864	343	77	89	0	37373
18831	334	121	56	37421	0	37932
18832	156	111	37396	322	0	37985
18833	122	87	36827	148	0	37184
18834	97	53	377	37386	0	37913
18835	37359	54	148	347	0	37908
18836	37046	54	96	163	0	37359
18837	417	85	71	38838	0	39411
18838	193	79	39710	351	0	40333
18839	105	39744	308	223	0	40380
18840	39789	301	120	104	0	40314
18841	321	40191	82	146	0	40740
18842	40353	306	72	118	0	40849
18843	335	135	68	40337	0	40875
18844	189	108	40337	358	0	40992
18845	147	76	299	39320	0	39842
18846	40092	63	139	398	0	40692
18847	366	87	40708	180	0	41341
18848	172	40936	326	170	0	41604
18849	143	315	129	41322	0	41909
18850	41221	146	103	378	0	41848
18851	391	115	41262	177	0	41945
18852	204	92	329	41796	0	42421
18853	163	68	143	42951	0	43325
18854	154	98	43077	431	0	43760
18855	148	85	345	41735	0	42313
18856	153	114	43036	390	0	43693
18857	39487	107	360	236	0	40190
18858	402	89	153	44891	0	45535
18859	258	126	47759	397	0	48540
18860	140	48205	406	280	0	49031
18861	49800	398	157	196	0	50551
18862	53706	160	111	222	0	54199
18863	646	155	119	58056	0	58976
18864	262	60882	116	750	0	62010
18865	61463	806	96	271	0	62636
18866	914	207	93	61243	0	62457
18867	265	153	61440	886	0	62744
18868	58030	100	827	296	0	59253
18869	862	60552	241	233	0	61888
18870	272	813	138	61159	0	62382
18871	61326	187	122	879	0	62514
18872	912	160	60615	270	0	61957
18873	292	148	61385	175	0	62000
18874	217	102	965	57712	0	58996
18875	184	117	62638	856	0	63795
18876	174	86	914	59378	0	60552
18877	124	61759	295	913	0	63091
18878	144	832	201	63749	0	64926
18879	62563	199	120	1001	0	63883
18880	915	150	63467	358	0	64890
18881	247	64172	890	371	0	65680
18882	212	857	243	63943	0	65255
18883	184	218	66477	924	0	67803
18884	180	288	867	61941	0	63276
18885	134	64930	297	936	0	66297
18886	103	67182	170	372	0	67827
18887	64346	858	166	234	0	65604
18888	735	66115	135	333	0	67318
18889	244	774	63297	135	0	64450
18890	56152	243	834	229	0	57458
18891	775	136	64585	98	0	65594
18892	221	71	762	58270	0	59324
18893	189	102	65112	726	0	66129
18894	108	64643	742	324	0	65817
18895	212	704	181	65221	0	66318
18896	117	167	131	65290	0	65705
18897	124	114	106	64173	0	64517
18898	135	112	64521	882	0	65650
18899	118	100	726	62160	0	63104
18900	101	103	185	64752	0	65141
18901	62867	84	146	883	0	63980
18902	62370	59	131	362	0	62922
18903	826	115	63503	179	0	64623
18904	258	62465	758	294	0	63775
18905	205	731	63732	143	0	64811
18906	142	173	761	63088	0	64164
18907	176	135	65399	749	0	66459
18908	116	111	800	63594	0	64621
18909	115	88	263	66151	0	66617
18910	134	117	65575	878	0	66704
18911	57012	91	813	343	0	58259
18912	735	66653	250	323	0	67961
18913	228	767	182	66663	0	67840
18914	204	220	68610	771	0	69805
18915	176	162	65809	261	0	66408
18916	63175	174	880	281	0	64510
18917	716	67631	286	263	0	68896
18918	204	727	163	67542	0	68636
18919	68825	167	179	871	0	70042
18920	802	149	139	68919	0	70009
18921	302	172	115	69475	0	70064
18922	175	169	69512	949	0	70805
18923	63908	115	838	418	0	65279
18924	70079	134	254	258	0	70725
18925	903	109	236	70192	0	71440
18926	69780	97	152	934	0	70963
18927	889	121	187	69452	0	70649
18928	240	68674	172	1007	0	70093
18929	209	71349	169	523	0	72250
18930	186	981	175	71766	0	73108
18931	70419	221	191	944	0	71775
18932	828	158	162	70734	0	71882
18933	71704	159	141	991	0	72995
18934	71998	129	165	376	0	72668
18935	1030	94	157	71764	0	73045
18936	351	115	147	73606	0	74219
18937	244	153	71457	1061	0	72915
18938	234	162	72453	366	0	73215
18939	191	109	1076	72300	0	73676
18940	187	166	77132	1063	0	78548
18941	74704	128	1108	459	0	76399
18942	1007	86	380	81772	0	83245
18943	339	139	86357	1177	0	88012
18944	84138	116	1315	533	0	86102
18945	93055	97	438	365	0	93955
18946	1788	96890	286	387	0	99351
18947	639	1478	212	98186	0	100515
18948	366	489	101223	1628	0	103706
18949	99467	228	1673	672	0	102040
18950	104479	153	596	395	0	105623
18951	2048	184	103804	363	0	106399
18952	103024	124	1643	370	0	105161
18953	1830	140	575	102676	0	105221
18954	673	287	322	104883	0	106165
18955	103822	130	256	1986	0	106194
18956	103787	123	248	760	0	104918
18957	2143	426	372	102813	0	105754
18958	855	138	103368	1728	0	106089
18959	415	98871	1643	1097	0	102026
18960	561	1417	100524	483	0	102985
18961	482	495	99776	419	0	101172
18962	348	95920	2025	449	0	98742
18963	548	1242	816	86221	0	88827
18964	314	411	439	88690	0	89854
18965	372	261	88106	1399	0	90138
18966	351	163	1201	86329	0	88044
18967	88340	126	560	1399	0	90425
18968	1336	182	89134	618	0	91270
18969	88145	132	1289	456	0	90022
18970	91031	102	619	396	0	92148
18971	91430	113	428	376	0	92347
18972	2009	169	89384	336	0	91898
18973	1005	182	89292	341	0	90820
18974	665	138	1617	87891	0	90311
18975	623	220	722	83277	0	84842
18976	507	89719	467	1533	0	92226
18977	89688	1162	434	711	0	91995
18978	88525	448	480	480	0	89933
18979	1686	89089	469	644	0	91888
18980	89043	1162	414	475	0	91094
18981	1481	87961	448	604	0	90494
18982	88652	1283	431	469	0	90835
18983	1551	532	396	85807	0	88286
18984	872	338	87339	1478	0	90027
18985	568	295	86292	716	0	87871
18986	563	228	1723	84575	0	87089
18987	523	232	844	86423	0	88022
18988	587	244	85284	1665	0	87780
18989	532	231	1509	82553	0	84825
18990	516	217	835	85848	0	87416
18991	83882	175	632	1728	0	86417
18992	84415	208	526	930	0	86079
18993	83141	215	474	641	0	84471
18994	1934	219	81630	525	0	84308
18995	992	82016	1488	627	0	85123
18996	796	1235	711	82281	0	85023
18997	866	521	85039	1326	0	87752
18998	713	85405	1445	685	0	88248
18999	86347	1300	724	540	0	88911
19000	1687	576	526	86068	0	88857
19001	950	376	532	87772	0	89630
19002	86804	315	514	1798	0	89431
19003	1603	306	498	86415	0	88822
19004	938	342	496	87291	0	89067
19005	86676	290	520	1982	0	89468
19006	1748	323	85872	1029	0	88972
19007	915	84966	1532	868	0	88281
19008	85227	1288	782	647	0	87944
19009	1763	639	86268	732	0	89402
19010	83086	372	1562	737	0	85757
19011	1742	87628	955	723	0	91048
19012	86375	1327	673	674	0	89049
19013	86298	596	607	664	0	88165
19014	83705	368	623	659	0	85355
19015	2120	387	593	81722	0	84822
19016	1105	491	579	81421	0	83596
19017	819	81392	593	2055	0	84859
19018	769	82821	657	1168	0	85415
19019	863	83222	547	829	0	85461
19020	81780	1554	486	776	0	84596
19021	1761	644	80355	711	0	83471
19022	1087	413	1345	79605	0	82450
19023	792	346	715	79060	0	80913
19024	672	80471	555	1838	0	83536
19025	777	1326	505	80314	0	82922
19026	693	686	560	79283	0	81222
19027	643	81281	499	1866	0	84289
19028	79382	1390	537	909	0	82218
19029	1515	81579	467	929	0	84490
19030	1028	1399	79058	614	0	82099
19031	77313	651	1342	675	0	79981
19032	1597	81074	632	783	0	84086
19033	78739	1260	452	666	0	81117
19034	1714	635	428	78994	0	81771
19035	1087	451	432	79274	0	81244
19036	892	446	78579	1615	0	81532
19037	855	464	77796	732	0	79847
19038	778	792	1498	76252	0	79320
19039	75909	368	670	1341	0	78288
19040	72610	340	471	648	0	74069
19041	1584	75257	379	639	0	77859
19042	639	73018	313	493	0	74463
19043	433	70258	255	392	0	71338
19044	1405	2104	1053	64641	0	69203
19045	63461	287	1201	872	0	65821
19046	63080	124	65	308	0	63577
19047	62779	95	80	165	0	63119
19048	1009	118	61294	118	0	62539
19049	310	75033	724	213	0	76280
19050	203	873	252	84325	0	85653
19051	85439	245	88	1171	0	86943
19052	1247	119	78	86213	0	87657
19053	341	93	74	90532	0	91040
19054	90307	98	92	1608	0	92105
19055	96667	111	78	472	0	97328
19056	1958	120	98176	227	0	100481
19057	640	105	1633	97604	0	99982
19058	352	119	97317	1720	0	99508
19059	249	144	1708	96774	0	98875
19060	334	117	96364	1831	0	98646
19061	246	188	1710	95644	0	97788
19062	91787	97	534	1853	0	94271
19063	1610	94072	244	818	0	96744
19064	590	98213	144	449	0	99396
19065	468	2259	131	81988	0	84846
19066	187	98216	170	1482	0	100055
19067	97357	1783	127	476	0	99743
19068	94942	562	149	322	0	95975
19069	2186	250	94215	255	0	96906
19070	681	93304	1735	373	0	96093
19071	369	1639	514	94704	0	97226
19072	311	523	95292	1721	0	97847
19073	92183	223	1825	613	0	94844
19074	1818	217	543	94516	0	97094
19075	706	210	95240	1801	0	97957
19076	324	183	1740	94845	0	97092
19077	94785	162	677	1902	0	97526
19078	1878	207	94516	705	0	97306
19079	92663	187	1762	338	0	94950
19080	95381	183	594	285	0	96443
19081	2318	209	288	92874	0	95689
19082	859	220	94133	1859	0	97071
19083	489	214	93552	725	0	94980
19084	90501	160	2268	447	0	93376
19085	93738	150	778	376	0	95042
19086	2472	199	92660	418	0	95749
19087	971	175	1892	90497	0	93535
19088	581	173	739	86475	0	87968
19089	397	92673	448	2233	0	95751
19090	443	1799	337	92902	0	95481
19091	92543	578	383	2188	0	95692
19092	2092	228	337	92910	0	95567
19093	915	230	92087	2207	0	95439
19094	87322	200	2023	956	0	90501
19095	2163	218	791	89872	0	93044
19096	1001	328	90259	2077	0	93665
19097	511	88152	2023	1121	0	91807
19098	83982	1858	777	703	0	87320
19099	2018	88276	514	789	0	91597
19100	87412	1946	454	648	0	90460
19101	2374	746	86884	670	0	90674
19102	1101	84453	2083	718	0	88355
19103	753	88158	849	683	0	90443
19104	642	2350	608	84554	0	88154
19105	657	857	511	87355	0	89380
19106	728	441	85983	2704	0	89856
19107	725	321	2106	85829	0	88981
19108	84551	314	1152	2414	0	88431
19109	2326	354	83848	1253	0	87781
19110	1141	416	2276	82953	0	86786
19111	808	506	82890	2455	0	86659
19112	78181	490	2386	1295	0	82352
19113	2246	82471	1101	1145	0	86963
19114	82651	2129	759	1039	0	86578
19115	84546	875	665	999	0	87085
19116	85335	581	669	904	0	87489
19117	3140	578	81785	882	0	86385
19118	1466	81699	2353	923	0	86441
19119	1082	2132	1163	80320	0	84697
19120	933	910	950	85414	0	88207
19121	87103	517	851	3092	0	91563
19122	2749	474	891	87710	0	91824
19123	87937	430	981	2983	0	92331
19124	88614	510	1124	1462	0	91710
19125	89475	505	818	1115	0	91913
19126	89210	538	957	948	0	91653
19127	3530	534	758	86323	0	91145
19128	86653	575	740	2790	0	90758
19129	3120	552	84384	1387	0	89443
19130	84424	561	2652	1017	0	88654
19131	87019	483	1229	829	0	89560
19132	3683	554	83152	1260	0	88649
19133	84362	511	2667	803	0	88343
19134	86846	470	1356	799	0	89471
19135	3459	413	934	83847	0	88653
19136	1735	380	930	85797	0	88842
19137	83463	932	1003	3170	0	88568
19138	3128	349	826	83606	0	87909
19139	1856	327	786	81650	0	84619
19140	1258	79675	871	3294	0	85098
19141	1263	1868	781	78628	0	82540
19142	76763	631	795	2671	0	80860
19143	2884	429	689	76049	0	80051
19144	1456	326	732	73997	0	76511
19145	1174	71652	782	2906	0	76514
19146	1279	1721	721	68851	0	72572
19147	1367	683	686	68952	0	71688
19148	65551	382	692	2419	0	69044
19149	2259	998	407	48585	0	52249
19150	767	145	40914	1438	0	43264
19151	437	37760	1143	686	0	40026
19152	347	37149	491	424	0	38411
19153	33914	1134	367	301	0	35716
19154	1131	34670	224	351	0	36376
19155	27551	628	567	238	0	28984
19156	761	27250	74	193	0	28278
19157	27374	592	80	170	0	28216
19158	725	159	53	27757	0	28694
19159	296	121	51	28112	0	28580
19160	194	28165	65	808	0	29232
19161	222	649	56	28793	0	29720
19162	209	193	28640	724	0	29766
19163	27086	113	594	302	0	28095
19164	718	30030	165	237	0	31150
19165	29167	637	97	155	0	30056
19166	29315	191	61	139	0	29706
19167	29604	123	60	129	0	29916
19168	941	81	43	28663	0	29728
19169	356	75	48	28385	0	28864
19170	212	28724	55	844	0	29835
19171	28315	667	39	307	0	29328
19172	711	28698	42	295	0	29746
19173	28879	685	55	148	0	29767
19174	810	213	29107	181	0	30311
19175	29810	115	660	185	0	30770
19176	875	89	190	30187	0	31341
19177	348	93	30266	851	0	31558
19178	254	114	30672	298	0	31338
19179	212	74	903	30221	0	31410
19180	230	91	30511	849	0	31681
19181	205	112	823	30116	0	31256
19182	28583	82	253	903	0	29821
19183	893	87	131	29407	0	30518
19184	399	89	28998	910	0	30396
19185	248	28302	770	385	0	29705
19186	216	28884	238	252	0	29590
19187	202	956	173	28020	0	29351
19188	28009	285	123	835	0	29252
19189	858	151	63	28134	0	29206
19190	377	116	73	28749	0	29315
19191	299	126	79	28941	0	29445
19192	225	114	80	29222	0	29641
19193	239	117	28487	1041	0	29884
19194	246	120	28255	438	0	29059
19195	27818	92	895	326	0	29131
19196	28899	97	318	263	0	29577
19197	979	115	165	28405	0	29664
19198	435	121	124	29097	0	29777
19199	346	103	28348	1038	0	29835
19200	220	28456	781	491	0	29948
19201	28396	742	270	301	0	29709
19202	28991	271	156	251	0	29669
19203	1023	174	91	28541	0	29829
19204	427	154	28623	941	0	30145
19205	298	145	738	26633	0	27814
19206	219	28435	263	914	0	29831
19207	285	775	28508	384	0	29952
19208	27970	312	758	319	0	29359
19209	905	161	278	28984	0	30328
19210	29195	148	216	956	0	30515
19211	925	160	28485	422	0	29992
19212	28486	140	804	363	0	29793
19213	935	145	323	28681	0	30084
19214	28415	152	262	951	0	29780
19215	930	138	191	27233	0	28492
19216	402	26838	210	907	0	28357
19217	315	27968	163	451	0	28897
19218	407	966	171	26919	0	28463
19219	279	302	25899	849	0	27329
19220	198	25235	703	422	0	26558
19221	339	538	331	21948	0	23156
19222	21229	224	219	567	0	22239
19223	21451	129	96	354	0	22030
19224	668	114	122	21423	0	22327
19225	321	110	143	21142	0	21716
19226	201	20639	151	711	0	21702
19227	225	21665	132	367	0	22389
19228	21157	573	158	299	0	22187
19229	556	232	128	21236	0	22152
19230	289	130	149	21531	0	22099
19231	197	95	21044	780	0	22116
19232	199	102	530	20848	0	21679
19233	199	97	269	21046	0	21611
19234	187	121	189	21313	0	21810
19235	232	90	21076	768	0	22166
19236	196	106	541	21232	0	22075
19237	21020	105	269	716	0	22110
19238	532	117	20830	386	0	21865
19239	21517	111	550	380	0	22558
19240	584	115	280	22204	0	23183
19241	314	87	183	22986	0	23570
19242	229	81	161	23803	0	24274
19243	206	76	22963	829	0	24074
19244	21516	85	571	482	0	22654
19245	571	23979	314	340	0	25204
19246	24048	498	210	285	0	25041
19247	625	24475	170	282	0	25552
19248	308	580	165	24501	0	25554
19249	24718	217	121	745	0	25801
19250	656	148	24241	400	0	25445
19251	23189	98	559	331	0	24177
19252	647	102	24560	267	0	25576
19253	310	109	590	23868	0	24877
19254	237	123	23923	621	0	24904
19255	179	23430	573	413	0	24595
19256	304	520	305	22116	0	23245
19257	21724	204	129	631	0	22688
19258	507	102	126	20879	0	21614
19259	206	20848	100	576	0	21730
19260	180	435	100	20878	0	21593
19261	20260	211	88	514	0	21073
19262	19822	96	97	278	0	20293
19263	544	19664	109	224	0	20541
19264	159	18046	61	106	0	18372
19265	134	338	56	17649	0	18177
19266	108	107	120	17871	0	18206
19267	17439	76	67	396	0	17978
19268	17169	63	40	172	0	17444
19269	358	17468	69	123	0	18018
19270	154	344	48	17006	0	17552
19271	123	103	49	17373	0	17648
19272	119	69	17191	375	0	17754
19273	80	17049	295	232	0	17656
19274	93	16636	117	129	0	16975
19275	65	273	35	15460	0	15833
19276	70	80	15501	210	0	15861
19277	57	66	15534	87	0	15744
19278	49	52	220	15480	0	15801
19279	47	30	106	15909	0	16092
19280	71	40	15870	272	0	16253
19281	45	33	206	15835	0	16119
19282	48	50	16288	264	0	16650
19283	16479	26	230	122	0	16857
19284	276	45	73	16990	0	17384
19285	106	35	17617	293	0	18051
19286	89	53	17614	109	0	17865
19287	59	50	326	18946	0	19381
19288	59	47	20989	374	0	21469
19289	112	38	21762	154	0	22066
19290	44	20809	439	148	0	21440
19291	21718	353	129	98	0	22298
19292	412	105	22468	67	0	23052
19293	126	71	389	21608	0	22194
19294	77	49	122	22851	0	23099
19295	61	44	80	23317	0	23502
19296	60	50	22751	542	0	23403
19297	58	38	397	22246	0	22739
19298	22190	41	141	480	0	22852
19299	404	46	92	22191	0	22733
19300	151	44	22291	472	0	22958
19301	81	39	423	22079	0	22622
19302	22182	33	156	503	0	22874
19303	22610	36	102	200	0	22948
19304	22452	38	84	132	0	22706
19305	537	32	84	22071	0	22724
19306	22235	52	68	478	0	22833
19307	22307	31	87	188	0	22613
19308	22154	41	69	132	0	22396
19309	523	21574	94	137	0	22328
19310	21788	387	77	110	0	22362
19311	470	124	87	21646	0	22327
19312	182	89	21628	466	0	22365
19313	109	21637	443	227	0	22416
19314	21575	393	164	165	0	22297
19315	429	140	116	21637	0	22322
19316	175	84	96	20734	0	21089
19317	107	21334	88	557	0	22086
19318	80	22059	107	251	0	22497
19319	20708	479	81	168	0	21436
19320	431	21134	90	153	0	21808
19321	20442	428	104	116	0	21090
19322	446	20601	78	152	0	21277
19323	20090	432	76	127	0	20725
19324	461	20495	94	155	0	21205
19325	174	21148	99	141	0	21562
19326	20777	470	68	129	0	21444
19327	482	163	20358	128	0	21131
19328	183	20966	430	128	0	21707
19329	140	402	169	20862	0	21573
19330	122	134	106	21740	0	22102
19331	121	88	73	21578	0	21860
19332	133	63	90	21941	0	22227
19333	131	70	21671	595	0	22467
19334	20890	65	432	258	0	21645
19335	504	57	154	22411	0	23126
19336	22695	58	133	521	0	23407
19337	23703	63	97	219	0	24082
19338	24029	65	97	162	0	24353
19339	23264	72	86	150	0	23572
19340	672	87	22751	142	0	23652
19341	252	106	533	21965	0	22856
19342	176	90	22228	590	0	23084
19343	140	22124	595	237	0	23096
19344	167	556	321	20770	0	21814
19345	172	149	125	21573	0	22019
19346	111	98	106	21504	0	21819
19347	105	62	115	21376	0	21658
19348	122	70	20820	684	0	21696
19349	114	63	508	20727	0	21412
19350	128	85	219	21383	0	21815
19351	21106	67	146	667	0	21986
19352	22049	75	122	313	0	22559
19353	713	72	123	22459	0	23367
19354	288	71	150	22650	0	23159
19355	178	67	130	23039	0	23414
19356	22510	77	122	849	0	23558
19357	23180	71	113	370	0	23734
19358	22940	60	152	239	0	23391
19359	22924	67	112	236	0	23339
19360	766	22778	98	231	0	23873
19361	23195	541	101	218	0	24055
19362	23442	162	93	222	0	23919
19363	804	92	72	22758	0	23726
19364	381	85	82	23111	0	23659
19365	22422	61	88	794	0	23365
19366	695	22053	101	349	0	23198
19367	347	22964	68	275	0	23654
19368	23122	660	64	205	0	24051
19369	726	212	59	23244	0	24241
19370	367	99	62	23763	0	24291
19371	265	103	45	24122	0	24535
19372	264	107	51	23948	0	24370
19373	245	95	63	23441	0	23844
19374	240	22859	63	790	0	23952
19375	204	562	48	22827	0	23641
19376	22624	213	43	672	0	23552
19377	657	122	48	22347	0	23174
19378	289	125	49	22649	0	23112
19379	21957	123	47	709	0	22836
19380	589	21968	67	367	0	22991
19381	275	619	65	21428	0	22387
19382	182	21660	69	604	0	22515
19383	186	764	50	20657	0	21657
19384	174	193	20344	543	0	21254
19385	18064	157	412	281	0	18914
19386	457	19525	125	209	0	20316
19387	17694	359	49	121	0	18223
19388	417	119	16761	124	0	17421
19389	139	165	303	14745	0	15352
19390	95	15366	98	346	0	15905
19391	85	15865	63	159	0	16172
19392	15075	336	96	103	0	15610
19393	335	96	52	15035	0	15518
19394	143	37	15672	356	0	16208
19395	104	34	276	15700	0	16114
19396	96	38	15875	370	0	16379
19397	14730	31	300	175	0	15236
19398	349	33	16063	128	0	16573
19399	137	40	289	15431	0	15897
19400	95	16455	87	387	0	17024
19401	111	300	50	15879	0	16340
19402	91	16543	38	355	0	17027
19403	16823	291	42	171	0	17327
19404	378	85	32	17306	0	17801
19405	173	56	17596	408	0	18233
19406	131	56	17050	187	0	17424
19407	16799	61	330	172	0	17362
19408	18364	55	85	160	0	18664
19409	18241	48	41	160	0	18490
19410	18072	44	34	154	0	18304
19411	420	17895	41	171	0	18527
19412	18228	317	37	141	0	18723
19413	18324	119	31	145	0	18619
19414	458	72	18012	147	0	18689
19415	204	62	284	17551	0	18101
19416	18161	58	77	432	0	18728
19417	407	60	17770	236	0	18473
19418	181	64	291	17594	0	18130
19419	145	73	18582	441	0	19241
19420	133	82	298	17577	0	18090
19421	138	18874	90	378	0	19480
19422	19040	322	53	194	0	19609
19423	387	122	18520	161	0	19190
19424	18074	92	298	146	0	18610
19425	395	72	85	18626	0	19178
19426	18826	66	45	415	0	19352
19427	394	81	35	18710	0	19220
19428	19654	77	46	504	0	20281
19429	410	68	19089	204	0	19771
19430	19711	85	303	197	0	20296
19431	389	70	93	20336	0	20888
19432	203	76	60	20504	0	20843
19433	19887	62	44	444	0	20437
19434	376	73	50	19833	0	20332
19435	152	72	19332	393	0	19949
19436	138	91	258	18943	0	19430
19437	17878	31	92	319	0	18320
19438	240	17876	67	149	0	18332
19439	90	17862	45	106	0	18103
19440	17456	224	44	69	0	17793
19441	239	18466	52	91	0	18848
19442	127	182	62	18102	0	18473
19443	18434	71	65	218	0	18788
19444	18259	55	17	100	0	18431
19445	18168	45	15	60	0	18288
19446	235	43	18289	62	0	18629
19447	86	78	157	17725	0	18046
19448	45	18441	88	174	0	18748
19449	63	162	66	18428	0	18719
19450	89	61	18780	164	0	19094
19451	52	18073	168	94	0	18387
19452	102	283	38	17569	0	17992
19453	16839	20	39	88	0	16986
19454	73	17139	14	54	0	17280
19455	53	79	17527	26	0	17685
19456	32	29	111	16988	0	17160
19457	33	21	17666	118	0	17838
19458	27	32	101	16806	0	16966
19459	17880	15	50	129	0	18074
19460	119	6	16	17823	0	17964
19461	18041	12	13	130	0	18196
19462	18175	22	21	72	0	18290
19463	122	18678	22	36	0	18858
19464	19012	100	11	33	0	19156
19465	112	18840	26	41	0	19019
19466	73	101	18866	31	0	19071
19467	57	32	106	18450	0	18645
19468	35	18	26	20330	0	20409
19469	58	19	19718	151	0	19946
19470	24	19671	132	67	0	19894
19471	19989	123	44	36	0	20192
19472	20389	28	17	64	0	20498
19473	177	16	24	20656	0	20873
19474	48	13	25	20766	0	20852
19475	39	11	13	21195	0	21258
19476	20847	7	21	189	0	21064
19477	164	21	20370	42	0	20597
19478	64	26	20456	38	0	20584
19479	43	14	161	20564	0	20782
19480	58	21	20901	157	0	21137
19481	50	33	20822	60	0	20965
19482	24	24	160	19632	0	19840
19483	72	15	21276	170	0	21533
19484	30	21163	148	144	0	21485
19485	34	148	46	21628	0	21856
19486	69	42	22157	168	0	22436
19487	39	17	144	21532	0	21732
19488	24	21398	55	166	0	21643
19489	22	138	26	21765	0	21951
19490	54	59	22237	171	0	22521
19491	40	24	140	21188	0	21392
19492	21172	23	50	189	0	21434
19493	170	24	21753	53	0	22000
19494	19571	25	142	67	0	19805
19495	160	21716	36	54	0	21966
19496	21980	139	40	56	0	22215
19497	154	63	29	22071	0	22317
19498	50	22050	28	197	0	22325
19499	22821	147	40	97	0	23105
19500	189	54	26	23011	0	23280
19501	83	32	23435	244	0	23794
19502	35	23675	214	92	0	24016
19503	57	207	74	23903	0	24241
19504	23705	41	29	233	0	24008
19505	22995	28	29	81	0	23133
19506	244	27	22	23117	0	23410
19507	81	31	23037	245	0	23394
19508	20618	15	222	110	0	20965
19509	231	33	23028	50	0	23342
19510	60	26	220	22809	0	23115
19511	23642	16	52	258	0	23968
19512	214	23413	63	120	0	23810
19513	23701	203	37	82	0	24023
19514	247	53	23216	58	0	23574
19515	23271	25	234	87	0	23617
19516	237	30	67	24051	0	24385
19517	78	23	49	24831	0	24981
19518	82	21	25017	262	0	25382
19519	52	39	210	24011	0	24312
19520	24879	27	55	291	0	25252
19521	231	22	62	24693	0	25008
19522	73	25313	46	272	0	25704
19523	57	216	44	25236	0	25553
19524	46	25461	56	307	0	25870
19525	82	246	24976	91	0	25395
19526	22833	52	238	102	0	23225
19527	250	36	60	25704	0	26050
19528	95	52	24912	264	0	25323
19529	62	24847	227	125	0	25261
19530	69	229	80	24650	0	25028
19531	57	79	62	24892	0	25090
19532	24748	51	55	301	0	25155
19533	249	42	41	25211	0	25543
19534	25373	51	49	294	0	25767
19535	25515	32	49	115	0	25711
19536	280	25787	59	95	0	26221
19537	26239	256	40	91	0	26626
19538	325	57	44	28915	0	29341
19539	110	53	29155	395	0	29713
19540	28604	28	397	138	0	29167
19541	385	35	75	28869	0	29364
19542	135	42	28796	395	0	29368
19543	26655	49	370	150	0	27224
19544	403	43	84	28774	0	29304
19545	118	29674	79	399	0	30270
19546	95	366	75	28739	0	29275
19547	81	29495	68	394	0	30038
19548	29093	389	63	137	0	29682
19549	439	108	29935	112	0	30594
19550	134	29548	383	144	0	30209
19551	102	401	91	29998	0	30592
19552	117	98	30012	415	0	30642
19553	105	84	29037	133	0	29359
19554	71	30010	422	148	0	30651
19555	171	387	123	29642	0	30323
19556	92	82	74	30345	0	30593
19557	88	87	56	37382	0	37613
19558	38131	50	78	718	0	38977
19559	737	67	41915	204	0	42923
19560	139	42260	838	188	0	43425
19561	145	834	161	41842	0	42982
19562	102	194	110	43820	0	44226
19563	109	114	42933	1009	0	44165
19564	123	95	865	42411	0	43494
19565	157	56	42759	970	0	43942
19566	133	70	41644	234	0	42081
19567	161	74	42111	173	0	42519
19568	122	72	966	39783	0	40943
19569	97	65	234	41538	0	41934
19570	96	53	141	42780	0	43070
19571	41960	51	120	1007	0	43138
19572	851	41901	98	330	0	43180
19573	43067	845	85	248	0	44245
19574	43619	167	101	184	0	44071
19575	44025	114	86	144	0	44369
19576	992	44697	99	222	0	46010
19577	45148	878	130	152	0	46308
19578	45944	182	78	164	0	46368
19579	1032	142	104	44932	0	46210
19580	330	121	100	45688	0	46239
19581	183	101	127	46752	0	47163
19582	160	115	45392	1179	0	46846
19583	43185	84	944	396	0	44609
19584	952	89	271	45605	0	46917
19585	44768	81	238	1050	0	46137
19586	977	44874	181	365	0	46397
19587	260	888	198	45292	0	46638
19588	190	207	169	46426	0	46992
19589	45519	147	174	1207	0	47047
19590	1006	102	132	45669	0	46909
19591	45278	101	147	1182	0	46708
19592	45426	122	139	391	0	46078
19593	1134	44494	111	358	0	46097
19594	372	46047	138	298	0	46855
19595	326	1234	144	44114	0	45818
19596	204	45416	152	1040	0	46812
19597	249	1027	150	45681	0	47107
19598	222	260	45100	1112	0	46694
19599	216	172	43354	362	0	44104
19600	40868	156	1037	391	0	42452
19601	43393	86	328	303	0	44110
19602	1032	43220	248	357	0	44857
19603	43118	918	190	306	0	44532
19604	952	45584	189	374	0	47099
19605	309	979	193	46084	0	47565
19606	231	228	219	46926	0	47604
19607	179	175	194	46590	0	47138
19608	186	139	233	47179	0	47737
19609	46164	97	240	1272	0	47773
19610	937	46057	242	623	0	47859
19611	46021	893	215	414	0	47543
19612	46400	233	194	402	0	47229
19613	1224	202	45607	359	0	47392
19614	43845	195	913	347	0	45300
19615	1089	44876	269	345	0	46579
19616	440	1017	213	45184	0	46854
19617	382	322	163	43936	0	44803
19618	327	44572	209	1173	0	46281
19619	44962	990	237	506	0	46695
19620	1204	271	43814	391	0	45680
19621	42447	191	1026	451	0	44115
19622	1271	172	44372	505	0	46320
19623	597	178	1069	43954	0	45798
19624	468	246	380	45518	0	46612
19625	377	273	344	46058	0	47052
19626	45707	301	229	1639	0	47876
19627	1178	253	46443	836	0	48710
19628	45745	231	1069	755	0	47800
19629	47626	231	470	650	0	48977
19630	47318	181	421	638	0	48558
19631	47337	180	443	513	0	48473
19632	1423	209	417	46435	0	48484
19633	638	179	46422	1362	0	48601
19634	573	260	1000	45510	0	47343
19635	544	202	46300	1399	0	48445
19636	532	299	44810	627	0	46268
19637	502	45303	966	611	0	47382
19638	658	959	282	42205	0	44104
19639	602	387	158	43314	0	44461
19640	593	321	147	40544	0	41605
19641	600	276	162	43472	0	44510
19642	42923	269	188	1085	0	44465
19643	42921	167	152	518	0	43758
19644	1273	177	145	42337	0	43932
19645	623	197	41584	1311	0	43715
19646	447	171	800	42062	0	43480
19647	405	198	282	43222	0	44107
19648	475	165	42133	1306	0	44079
19649	465	187	807	41319	0	42778
19650	42158	236	228	1226	0	43848
19651	42341	224	172	596	0	43333
19652	42625	261	148	577	0	43611
19653	1256	240	141	41949	0	43586
19654	41646	162	152	1123	0	43083
19655	40966	192	211	526	0	41895
19656	1260	139	40164	492	0	42055
19657	396	108	31149	198	0	31851
19658	304	111	31309	178	0	31902
19659	26938	51	275	102	0	27366
19660	229	28293	87	108	0	28717
19661	28173	170	79	91	0	28513
19662	228	30827	45	92	0	31192
19663	124	168	69	30810	0	31171
19664	89	52	42	31141	0	31324
19665	68	44	53	31240	0	31405
19666	101	46	30782	269	0	31198
19667	27441	27	225	157	0	27850
19668	256	50	87	30676	0	31069
19669	132	51	30545	201	0	30929
19670	101	62	28399	111	0	28673
19671	27441	29	216	124	0	27810
19672	200	30461	89	116	0	30866
19673	29922	152	47	87	0	30208
19674	29461	55	46	100	0	29662
19675	216	29415	57	81	0	29769
19676	28630	142	73	76	0	28921
19677	202	78	29357	71	0	29708
19678	110	47	28189	56	0	28402
19679	74	49	29727	74	0	29924
19680	51	109	191	29098	0	29449
19681	63	22	30159	159	0	30403
19682	28171	25	143	78	0	28417
19683	29450	7	49	74	0	29580
19684	211	49	30094	56	0	30410
19685	93	31	139	29282	0	29545
19686	30161	12	70	175	0	30418
19687	157	32290	51	108	0	32606
19688	63	32985	60	103	0	33211
19689	33353	165	34	99	0	33651
19690	163	87	33447	43	0	33740
19691	70	196	109	32078	0	32453
19692	44	19	71	33216	0	33350
19693	44	16	30	33596	0	33686
19694	26	33669	26	168	0	33889
19695	25	122	13	33933	0	34093
19696	35748	39	16	198	0	36001
19697	183	37	30	36550	0	36800
19698	60	37119	33	257	0	37469
19699	37670	217	28	127	0	38042
19700	242	79	20	38271	0	38612
19701	91	35	20	40067	0	40213
19702	40767	26	20	323	0	41136
19703	40502	24	23	117	0	40666
19704	339	10	19	40329	0	40697
19705	41012	12	26	357	0	41407
19706	40658	12	30	112	0	40812
19707	376	41658	27	99	0	42160
19708	41804	333	26	54	0	42217
19709	350	41492	33	65	0	41940
19710	124	338	18	41933	0	42413
19711	101	104	42682	356	0	43243
19712	62	45	333	42104	0	42544
19713	54	24	74	43137	0	43289
19714	45	26	35	44548	0	44654
19715	44074	31	30	505	0	44640
19716	384	44113	31	245	0	44773
19717	45463	361	26	107	0	45957
19718	444	46833	40	149	0	47466
19719	48026	422	22	116	0	48586
19720	48118	106	27	70	0	48321
19721	48045	62	33	77	0	48217
19722	47513	31	33	75	0	47652
19723	596	50	46581	64	0	47291
19724	195	40	435	46287	0	46957
19725	113	42	92	49434	0	49681
19726	120	62	47848	626	0	48656
19727	45084	51	506	203	0	45844
19728	550	35	111	47664	0	48360
19729	182	89	46974	561	0	47806
19730	163	69	46036	161	0	46429
19731	109	42	620	47416	0	48187
19732	158	60	49707	587	0	50512
19733	121	39	551	48315	0	49026
19734	111	41	133	49484	0	49769
19735	158	71	48170	666	0	49065
19736	43545	74	549	267	0	44435
19737	596	60	135	48411	0	49202
19738	246	69	48607	615	0	49537
19739	166	59	545	48528	0	49298
19740	48899	49	164	678	0	49790
19741	657	50	48467	216	0	49390
19742	46014	50	559	217	0	46840
19743	49859	40	163	163	0	50225
19744	743	51	112	49612	0	50518
19745	266	58	64	49388	0	49776
19746	222	89	49270	712	0	50293
19747	169	84	583	48835	0	49671
19748	159	66	154	47680	0	48059
19749	122	91	127	49891	0	50231
19750	174	71	48424	776	0	49445
19751	46043	59	587	320	0	47009
19752	48581	60	188	254	0	49083
19753	49524	69	114	244	0	49951
19754	50475	86	96	226	0	50883
19755	813	93	93	50530	0	51529
19756	50307	93	91	701	0	51192
19757	50130	77	95	287	0	50589
19758	46517	101	126	271	0	47015
19759	50041	47	121	229	0	50438
19760	821	49714	144	242	0	50921
19761	50494	566	125	223	0	51408
19762	49491	134	116	231	0	49972
19763	853	49496	134	242	0	50725
19764	49695	667	115	247	0	50724
19765	882	152	141	49949	0	51124
19766	324	103	121	50518	0	51066
19767	49697	59	133	912	0	50801
19768	771	49166	164	416	0	50517
19769	296	49572	148	312	0	50328
19770	293	792	134	50156	0	51375
19771	252	173	50337	807	0	51569
19772	222	83	720	48725	0	49750
19773	231	55	212	50884	0	51382
19774	49899	53	171	902	0	51025
19775	50146	40	143	348	0	50677
19776	913	44	135	50169	0	51261
19777	359	75	49859	823	0	51116
19778	294	50	765	50109	0	51218
19779	51167	44	241	905	0	52357
19780	921	83	53867	315	0	55186
19781	330	54112	861	337	0	55640
19782	56293	762	248	279	0	57582
19783	981	145	170	56202	0	57498
19784	341	84	144	56469	0	57038
19785	257	68	143	58034	0	58502
19786	245	58	56639	1138	0	58080
19787	47252	51	923	528	0	48754
19788	1026	70	53641	286	0	55023
19789	363	52949	928	316	0	54556
19790	313	795	270	53410	0	54788
19791	315	166	183	54314	0	54978
19792	294	96	136	57666	0	58192
19793	297	77	56905	1297	0	58576
19794	310	77	55765	427	0	56579
19795	284	72	57610	314	0	58280
19796	236	57236	1137	327	0	58936
19797	376	929	468	56750	0	58523
19798	58856	207	286	1029	0	60378
19799	63401	119	168	332	0	64020
19800	1503	96	67729	304	0	69632
19801	477	68186	1272	408	0	70343
19802	475	1184	68099	247	0	70005
19803	217	70998	1297	357	0	72869
19804	69575	1457	565	260	0	71857
19805	69078	356	285	215	0	69934
19806	1479	69210	149	302	0	71140
19807	69447	1195	164	225	0	71031
19808	1426	312	124	68705	0	70567
19809	480	174	129	69892	0	70675
19810	69632	126	141	1494	0	71393
19811	67505	107	136	471	0	68219
19812	67280	114	102	342	0	67838
19813	1563	66791	158	337	0	68849
19814	484	69204	148	367	0	70203
19815	68478	1365	156	250	0	70249
19816	1439	371	68191	242	0	70243
19817	464	462	1201	66385	0	68512
19818	65143	190	339	1256	0	66928
19819	1298	64287	251	421	0	66257
19820	461	66908	191	325	0	67885
19821	67018	1308	221	226	0	68773
19822	1364	405	65651	220	0	67640
19823	63604	330	1215	178	0	65327
19824	1468	203	64847	171	0	66689
19825	475	196	64947	149	0	65767
19826	394	255	1316	63176	0	65141
19827	330	198	66562	1100	0	68190
19828	64697	180	1216	386	0	66479
19829	68029	137	417	329	0	68912
19830	68131	169	262	266	0	68828
19831	67437	170	205	236	0	68048
19832	1585	160	221	65500	0	67466
19833	65709	195	234	1157	0	67295
19834	1414	66103	238	446	0	68201
19835	626	1172	203	61920	0	63921
19836	438	67694	230	1114	0	69476
19837	69658	1191	195	453	0	71497
19838	69603	372	207	341	0	70523
19839	1494	314	227	69318	0	71353
19840	70047	276	228	1221	0	71772
19841	70499	275	277	418	0	71469
19842	1590	237	244	69989	0	72060
19843	698	252	251	70445	0	71646
19844	616	228	249	71344	0	72437
19845	579	241	69252	1506	0	71578
19846	527	260	67129	544	0	68460
19847	521	295	69001	403	0	70220
19848	493	270	1462	67657	0	69882
19849	576	259	70398	1275	0	72508
19850	600	234	1374	68345	0	70553
19851	602	248	75031	1405	0	77286
19852	537	268	73178	525	0	74508
19853	68188	322	1517	458	0	70485
19854	1415	73083	639	431	0	75568
19855	73729	1250	474	390	0	75843
19856	1572	433	395	73228	0	75628
19857	815	343	342	74509	0	76009
19858	787	362	74540	1415	0	77104
19859	548	74336	1293	772	0	76949
19860	641	1281	470	75301	0	77693
19861	599	473	76274	1318	0	78664
19862	553	74975	1257	578	0	77363
19863	651	1194	626	74668	0	77139
19864	74463	407	502	1215	0	76587
19865	74249	383	364	533	0	75529
19866	1576	329	402	74385	0	76692
19867	74596	325	381	1222	0	76524
19868	1521	74967	392	582	0	77462
19869	797	1167	349	75651	0	77964
19870	817	458	77191	1225	0	79691
19871	699	403	1239	75918	0	78259
19872	732	326	77524	1445	0	80027
19873	73278	362	1326	647	0	75613
19874	1654	326	468	76361	0	78809
19875	837	78153	394	1414	0	80798
19876	781	1426	302	79932	0	82441
19877	741	414	79158	1557	0	81870
19878	697	375	77678	703	0	79453
19879	629	377	76568	469	0	78043
19880	69794	483	1694	376	0	72347
19881	1308	74594	599	454	0	76955
19882	645	1069	478	72872	0	75064
19883	73646	367	417	1215	0	75645
19884	1198	73782	450	647	0	76077
19885	76541	1032	386	614	0	78573
19886	77054	415	474	411	0	78354
19887	77972	332	343	533	0	79180
19888	79214	275	434	343	0	80266
19889	1558	251	77725	363	0	79897
19890	74309	135	1253	434	0	76131
19891	1369	146	77562	419	0	79496
19892	64646	157	1220	367	0	66390
19893	1256	261	505	74555	0	76577
19894	613	139	73729	933	0	75414
19895	519	72366	904	511	0	74300
19896	679	3585	498	67131	0	71893
19897	420	71144	294	774	0	72632
19898	359	71379	275	505	0	72518
19899	61501	594	353	407	0	62855
19900	566	175	60890	169	0	61800
19901	153	59416	382	151	0	60102
19902	57705	347	309	91	0	58452
19903	282	59325	92	132	0	59831
19904	59623	241	59	104	0	60027
19905	299	95	59	58903	0	59356
19906	59589	56	54	269	0	59968
19907	281	59	55	58536	0	58931
19908	59386	30	62	331	0	59809
19909	284	62	44	59091	0	59481
19910	123	61956	56	315	0	62450
19911	92	256	61	63048	0	63457
19912	62715	97	58	291	0	63161
19913	256	62625	68	148	0	63097
19914	128	257	51	62519	0	62955
19915	63266	95	72	358	0	63791
19916	296	81	65	63777	0	64219
19917	125	67	69	63613	0	63874
19918	138	90	64308	331	0	64867
19919	129	94	62344	154	0	62721
19920	126	67	287	61794	0	62274
19921	134	111	66781	315	0	67341
19922	97	65	262	65865	0	66289
19923	126	70	115	63580	0	63891
19924	101	77	72	67371	0	67621
19925	134	131	67411	359	0	68035
19926	119	81	251	64022	0	64473
19927	94	76	92	65635	0	65897
19928	104	66576	84	413	0	67177
19929	94	280	90	66942	0	67406
19930	66561	94	91	339	0	67085
19931	318	62	78	67294	0	67752
19932	188	88	76739	353	0	77368
19933	68166	81	661	266	0	69174
19934	674	80762	256	230	0	81922
19935	268	763	130	81468	0	82629
19936	265	284	80061	797	0	81407
19937	71889	141	800	382	0	73212
19938	785	79650	277	339	0	81051
19939	79688	773	177	178	0	80816
19940	881	259	111	79035	0	80286
19941	78312	152	125	813	0	79402
19942	969	107	79083	323	0	80482
19943	313	78312	779	288	0	79692
19944	227	85126	267	209	0	85829
19945	85552	903	205	224	0	86884
19946	85182	324	97	169	0	85772
19947	1033	199	84957	104	0	86293
19948	80257	98	825	143	0	81323
19949	84806	95	267	189	0	85357
19950	85155	80	163	180	0	85578
19951	1036	81626	115	208	0	82985
19952	417	83092	82	206	0	83797
19953	82787	930	85	151	0	83953
19954	82613	353	95	166	0	83227
19955	956	84640	83	250	0	85929
19956	425	790	71	85032	0	86318
19957	282	301	85423	797	0	86803
19958	82772	164	791	438	0	84165
19959	84108	128	325	390	0	84951
19960	88984	99	175	252	0	89510
19961	1009	88219	106	250	0	89584
19962	440	803	89180	161	0	90584
19963	89482	289	786	226	0	90783
19964	863	180	302	92713	0	94058
19965	377	134	175	93271	0	93957
19966	297	121	72	95210	0	95700
19967	231	135	94097	1135	0	95598
19968	229	117	770	90792	0	91908
19969	240	203	93624	1018	0	95085
19970	157	91242	811	534	0	92744
19971	89472	702	270	232	0	90676
19972	687	90819	169	249	0	91924
19973	304	92357	115	240	0	93016
19974	91484	836	187	188	0	92695
19975	714	93703	103	234	0	94754
19976	344	819	80	91919	0	93162
19977	225	92871	96	726	0	93918
19978	92280	774	98	273	0	93425
19979	726	93082	95	305	0	94208
19980	375	832	80	94184	0	95471
19981	321	365	93017	829	0	94532
19982	186	240	733	92707	0	93866
19983	148	95149	330	1132	0	96759
19984	175	882	214	96501	0	97772
19985	204	378	99	95467	0	96148
19986	204	215	110	95473	0	96002
19987	215	136	107	96559	0	97017
19988	219	163	120	97183	0	97685
19989	247	153	142	97836	0	98378
19990	274	227	96239	1292	0	98032
19991	88989	175	1099	684	0	90947
19992	1172	170	444	103031	0	104817
19993	604	208	102694	1359	0	104865
19994	433	253	101598	614	0	102898
19995	303	217	1647	102716	0	104883
19996	104292	217	705	1387	0	106601
19997	1473	261	102375	635	0	104744
19998	99069	181	1397	464	0	101111
19999	1676	290	105087	270	0	107323
20000	819	289	1479	103370	0	105957
20001	574	236	633	107714	0	109157
20002	483	331	106362	1694	0	108870
20003	96203	273	1399	875	0	98750
20004	1499	252	606	104147	0	106504
20005	851	265	104403	1487	0	107006
20006	679	275	103941	682	0	105577
20007	570	253	1772	95765	0	98360
20008	390	104454	837	1303	0	106984
20009	105984	1348	466	646	0	108444
20010	104110	600	343	456	0	105509
20011	2027	486	104741	336	0	107590
20012	962	303	1441	100474	0	103180
20013	104515	264	664	1558	0	107001
20014	1680	252	104875	787	0	107594
20015	99593	181	1516	669	0	101959
20016	1703	103317	782	604	0	106406
20017	818	1352	528	105397	0	108095
20018	610	552	381	106597	0	108140
20019	108974	339	377	2067	0	111757
20020	1652	275	356	109089	0	111372
20021	796	238	372	107454	0	108860
20022	582	197	340	108447	0	109566
20023	105445	219	388	2441	0	108493
20024	1687	266	105338	1201	0	108492
20025	103237	212	1658	854	0	105961
20026	105851	228	764	633	0	107476
20027	106766	260	505	607	0	108138
20028	2320	280	422	105004	0	108026
20029	1172	340	107448	1871	0	110831
20030	661	105467	1757	1024	0	108909
20031	449	107641	822	867	0	109779
20032	365	101108	485	628	0	102586
20033	612	1537	101674	478	0	104301
20034	476	980	1539	117245	0	120240
20035	122194	268	570	2423	0	125455
20036	131115	167	355	1162	0	132799
20037	3087	127	290	137995	0	141499
20038	1275	166	138384	2787	0	142612
20039	714	212	137846	1243	0	140015
20040	428	150	3248	138351	0	142177
20041	446	190	139889	2965	0	143490
20042	449	114	2941	139680	0	143184
20043	461	172	1162	134392	0	136187
20044	354	138107	733	3635	0	142829
20045	549	2509	459	139736	0	143253
20046	561	838	438	145306	0	147143
20047	141672	443	455	3993	0	146563
20048	3042	237	425	142926	0	146630
20049	1279	230	423	143922	0	145854
20050	139139	188	467	3977	0	143771
20051	2927	139169	626	1848	0	144570
20052	141595	2591	573	1040	0	145799
20053	3409	985	139534	791	0	144719
20054	137896	472	3028	850	0	142246
20055	138494	283	1358	822	0	140957
20056	3969	293	136639	761	0	141662
20057	1766	321	135354	815	0	138256
20058	1164	356	3886	129730	0	135136
20059	130356	229	1735	3314	0	135634
20060	3203	214	129783	1641	0	134841
20061	1441	201	3457	128941	0	134040
20062	1109	251	128188	3533	0	133081
20063	840	261	3528	124984	0	129613
20064	814	288	1615	127317	0	130034
20065	127160	282	977	4448	0	132867
20066	127885	326	742	2284	0	131237
20067	129380	384	695	1626	0	132085
20068	4471	370	128132	1564	0	134537
20069	2097	390	127940	1455	0	131882
20070	1432	413	4046	125557	0	131448
20071	1162	418	1878	127782	0	131240
20072	1170	444	1357	130138	0	133109
20073	123730	401	1074	4754	0	129959
20074	3490	125334	1047	2807	0	132678
20075	123613	2907	1070	1727	0	129317
20076	119805	1158	999	1589	0	123551
20077	4250	121166	981	1648	0	128045
20078	2211	123589	1037	1566	0	128403
20079	119298	3410	1055	1761	0	125524
20080	3616	1406	994	114649	0	120665
20081	2280	117933	955	4472	0	125640
20082	2320	2864	849	119560	0	125593
20083	2205	1204	117238	4484	0	125131
20084	1819	740	3677	117632	0	123868
20085	116299	536	2727	4719	0	124281
20086	3995	467	116095	2839	0	123396
20087	2327	474	115337	2491	0	120629
20088	2007	1972	5116	98557	0	107652
20089	1622	106560	2777	4635	0	115594
20090	1516	108606	1838	3249	0	115209
20091	1493	110902	1584	2984	0	116963
20092	106408	3396	1474	3004	0	114282
20093	106927	1301	1301	2864	0	112393
20094	102103	737	1283	2810	0	106933
20095	4278	102426	1298	3273	0	111275
20096	104620	2433	1370	2803	0	111226
20097	104237	1314	1227	2574	0	109352
20098	4952	1277	101706	2339	0	110274
20099	3293	98789	3626	1968	0	107676
20100	2800	2880	2446	99061	0	107187
20101	99600	1384	1930	4078	0	106992
20102	4679	943	98697	2682	0	107001
20103	2633	665	4188	93882	0	101368
20104	2125	97055	2812	4811	0	106803
20105	2194	2666	2169	96630	0	103659
20106	2435	1313	1846	99048	0	104642
20107	98767	1009	1904	5227	0	106907
20108	99169	1113	1974	3394	0	105650
20109	4741	1102	1955	97668	0	105466
20110	2998	1154	96354	4681	0	105187
20111	2701	1179	95921	3207	0	103008
20112	96199	1158	3905	2539	0	103801
20113	5541	943	96467	2209	0	105160
20114	3954	1063	3854	81099	0	89970
20115	2982	91257	2844	3408	0	100491
20116	91320	2678	2553	2476	0	99027
20117	4045	91069	2410	2632	0	100156
20118	92340	2833	2075	2876	0	100124
20119	4302	1317	1773	91610	0	99002
20120	3101	1318	1754	91976	0	98149
20121	91826	1542	1540	4395	0	99303
20122	93404	1443	1376	2492	0	98715
20123	5523	1502	1600	90636	0	99261
20124	3611	1830	1464	91147	0	98052
20125	2866	1808	89229	4062	0	97965
20126	2585	1592	88851	2687	0	95715
20127	87691	1430	3772	2664	0	95557
20128	4104	1504	85540	2571	0	93719
20129	85163	1258	3333	2598	0	92352
20130	87254	1061	2423	2421	0	93159
20131	4826	1023	83694	2370	0	91913
20132	3256	79810	3399	1911	0	88376
20133	2674	80824	2635	1470	0	87603
20134	1674	1592	60860	845	0	64971
20135	2542	5700	3011	48945	0	60198
20136	43787	1232	2235	2171	0	49425
20137	42061	339	275	520	0	43195
20138	47153	304	252	484	0	48193
20139	57187	238	233	480	0	58138
20140	57355	251	236	454	0	58296
20141	1672	59471	340	473	0	61956
20142	56748	1258	225	284	0	58515
20143	1487	57066	277	290	0	59120
20144	55223	1212	224	138	0	56797
20145	1325	307	53284	81	0	54997
20146	378	129	1025	50941	0	52473
20147	264	68	191	47724	0	48247
20148	142	50975	102	1115	0	52334
20149	51263	1023	62	244	0	52592
20150	51969	245	51	133	0	52398
20151	1240	147	50	50392	0	51829
20152	354	75	67	51755	0	52251
20153	50809	58	59	1232	0	52158
20154	1088	54	48	50879	0	52069
20155	280	81	44	51872	0	52277
20156	50948	57	41	1232	0	52278
20157	1177	61	42	50893	0	52173
20158	51102	46	43	1184	0	52375
20159	51794	37	39	347	0	52217
20160	1335	65	50745	190	0	52335
20161	50759	36	1015	199	0	52009
20162	50776	66	223	151	0	51216
20163	50899	47	101	150	0	51197
20164	1421	75	48685	142	0	50323
20165	500	56	1022	46993	0	48571
20166	338	49	239	49364	0	49990
20167	268	76	48315	1238	0	49897
20168	46522	74	1094	332	0	48022
20169	1245	58	263	46787	0	48353
20170	462	70	46525	1088	0	48145
20171	324	80	47276	310	0	47990
20172	272	61	1253	46787	0	48373
20173	281	83	47491	1202	0	49057
20174	257	72	1185	46773	0	48287
20175	312	77	321	47954	0	48664
20176	308	93	47220	1391	0	49012
20177	301	128	1138	43070	0	44637
20178	264	45383	331	1193	0	47171
20179	251	48008	214	471	0	48944
20180	46813	1240	193	249	0	48495
20181	46641	309	177	247	0	47374
20182	1378	46669	175	366	0	48588
20183	46783	1105	158	253	0	48299
20184	47481	326	152	241	0	48200
20185	1583	238	125	46089	0	48035
20186	599	231	133	47511	0	48474
20187	45724	210	120	1400	0	47454
20188	1372	45310	150	562	0	47394
20189	621	46543	160	397	0	47721
20190	587	1391	185	45881	0	48044
20191	514	374	46145	1332	0	48365
20192	44526	212	1154	590	0	46482
20193	46004	189	320	470	0	46983
20194	44353	197	177	389	0	45116
20195	1748	44822	199	377	0	47146
20196	837	1207	169	43457	0	45670
20197	707	373	165	45794	0	47039
20198	44438	263	242	1534	0	46477
20199	1580	44293	211	729	0	46813
20200	847	1209	196	43974	0	46226
20201	814	413	204	45115	0	46546
20202	803	322	174	45369	0	46668
20203	44041	267	227	1676	0	46211
20204	1738	43801	242	824	0	46605
20205	951	1420	264	40566	0	43201
20206	806	43705	254	1466	0	46231
20207	43526	1303	319	702	0	45850
20208	1706	437	42963	716	0	45822
20209	42072	297	1317	757	0	44443
20210	1622	253	42105	800	0	44780
20211	951	546	1262	40195	0	42954
20212	40474	249	507	1552	0	42782
20213	1673	232	40059	767	0	42731
20214	40160	170	1228	731	0	42289
20215	41215	178	497	723	0	42613
20216	41390	142	402	697	0	42631
20217	1871	122	370	39688	0	42051
20218	880	139	374	40384	0	41777
20219	781	131	314	40972	0	42198
20220	39275	125	330	1794	0	41524
20221	1615	39568	412	916	0	42511
20222	39718	990	333	662	0	41703
20223	40623	308	416	535	0	41882
20224	1728	243	39243	500	0	41714
20225	39074	209	1210	522	0	41015
20226	40628	190	495	552	0	41865
20227	1682	195	484	39501	0	41862
20228	793	210	425	40267	0	41695
20229	642	203	414	40476	0	41735
20230	38903	194	435	1620	0	41152
20231	38805	197	423	803	0	40228
20232	36784	208	397	625	0	38014
20233	1387	34917	387	607	0	37298
20234	457	32314	413	468	0	33652
20235	354	32684	351	517	0	33906
20236	32002	981	471	553	0	34007
20237	1085	283	31374	584	0	33326
20238	421	189	25662	438	0	26710
20239	14905	64	418	159	0	15546
20240	302	49	15412	141	0	15904
20241	37	19	52	11155	0	11263
20242	26	11547	29	63	0	11665
20243	11800	55	34	40	0	11929
20244	11804	15	14	36	0	11869
20245	11829	12	15	27	0	11883
20246	98	12	16	12722	0	12848
20247	50	21	13158	67	0	13296
20248	36	23	12484	36	0	12579
20249	12856	9	60	35	0	12960
20250	13333	12	39	22	0	13406
20251	13148	22	10	32	0	13212
20252	90	24	11	13224	0	13349
20253	42	14	14	13353	0	13423
20254	34	20	13294	71	0	13419
20255	12836	16	56	63	0	12971
20256	71	13	17	13760	0	13861
20257	32	17	13	13696	0	13758
20258	35	11	8	13624	0	13678
20259	26	13579	20	78	0	13703
20260	35	54	16	13560	0	13665
20261	31	21	10	13560	0	13622
20262	13369	12	9	73	0	13463
20263	77	25	13165	25	0	13292
20264	12594	14	60	34	0	12702
20265	13473	12	19	45	0	13549
20266	85	8	7	13367	0	13467
20267	40	11	11	13391	0	13453
20268	13305	14	17	77	0	13413
20269	74	12	13083	31	0	13200
20270	32	13054	56	59	0	13201
20271	40	47	15	13009	0	13111
20272	12915	16	23	64	0	13018
20273	69	7	11	12523	0	12610
20274	38	14	12457	55	0	12564
20275	45	24	12318	35	0	12422
20276	12424	20	78	49	0	12571
20277	87	16	25	13233	0	13361
20278	30	22	13141	75	0	13268
20279	12637	12	38	66	0	12753
20280	13748	10	30	79	0	13867
20281	75	16	15	13768	0	13874
20282	42	13	11	13782	0	13848
20283	17	13816	23	58	0	13914
20284	14255	30	11	89	0	14385
20285	52	19	18	14345	0	14434
20286	38	28	7	14561	0	14634
20287	31	17	14660	47	0	14755
20288	13407	9	33	49	0	13498
20289	14435	6	22	32	0	14495
20290	44	14301	20	78	0	14443
20291	36	31	13862	15	0	13944
20292	34	14	13844	13	0	13905
20293	17	34	20	13674	0	13745
20294	14501	29	12	75	0	14617
20295	34	11	16	14450	0	14511
20296	15285	10	12	84	0	15391
20297	15350	6	8	44	0	15408
20298	15522	14	10	49	0	15595
20299	41	10	10	15744	0	15805
20300	26	11	8	15808	0	15853
20301	15964	5	6	52	0	16027
20302	40	20	16263	13	0	16336
20303	14717	12	28	29	0	14786
20304	15245	7	10	40	0	15302
20305	33	14	16109	12	0	16168
20306	28	28	15960	25	0	16041
20307	12	16029	27	33	0	16101
20308	39	36	20	16222	0	16317
20309	14189	31	38	71	0	14329
20310	16	11	8	16216	0	16251
20311	36	20	16604	23	0	16683
20312	7	16368	10	50	0	16435
20313	11	16384	8	33	0	16436
20314	28	18	5	16742	0	16793
20315	8	11	5	16447	0	16471
20316	4	16380	7	45	0	16436
20317	13	22	16065	16	0	16116
20318	14731	12	21	35	0	14799
20319	16539	3	6	23	0	16571
20320	16	16582	14	48	0	16660
20321	16152	12	8	15	0	16187
20322	16	11	5	15820	0	15852
20323	15724	2	7	29	0	15762
20324	17	3	8	15537	0	15565
20325	6	16446	7	44	0	16503
20326	25	43	16208	25	0	16301
20327	10	8	34	17610	0	17662
20328	14	8	11	17745	0	17778
20329	11	9	8	18883	0	18911
20330	19416	8	7	118	0	19549
20331	123	7	6	19493	0	19629
20332	41	15	21040	137	0	21233
20333	31	27	21692	31	0	21781
20334	22059	7	198	32	0	22296
20335	220	14	22993	20	0	23247
20336	22503	8	217	26	0	22754
20337	224	11	25	25592	0	25852
20338	52	10	17	26310	0	26389
20339	44	7	11	27929	0	27991
20340	27	10	18	27759	0	27814
20341	27321	2	24	404	0	27751
20342	382	16	27577	99	0	28074
20343	81	6	355	26614	0	27056
20344	32	27991	64	376	0	28463
20345	27876	360	28	80	0	28344
20346	370	58	9	27145	0	27582
20347	26735	25	15	400	0	27175
20348	419	24	26709	80	0	27232
20349	87	23	371	25301	0	25782
20350	54	26507	74	382	0	27017
20351	26749	360	42	84	0	27235
20352	421	59	26696	61	0	27237
20353	87	36	391	26023	0	26537
20354	59	10	72	26860	0	27001
20355	26458	16	60	473	0	27007
20356	414	16	26423	124	0	26977
20357	127	29	26813	79	0	27048
20358	74	15	460	26329	0	26878
20359	59	23	26787	420	0	27289
20360	74	27	27064	125	0	27290
20361	59	18	490	26328	0	26895
20362	70	25	119	26794	0	27008
20363	60	20	78	28031	0	28189
20364	27686	14	62	529	0	28291
20365	430	27878	89	211	0	28608
20366	27982	409	67	128	0	28586
20367	501	79	63	27711	0	28354
20368	114	28418	79	504	0	29115
20369	110	452	50	29126	0	29738
20370	30066	84	54	574	0	30778
20371	521	31680	61	254	0	32516
20372	148	551	66	32665	0	33430
20373	154	113	32723	669	0	33659
20374	31907	78	621	239	0	32845
20375	638	44	168	32462	0	33312
20376	187	53	115	32963	0	33318
20377	168	57	32250	759	0	33234
20378	145	60	32131	294	0	32630
20379	30854	48	715	223	0	31840
20380	672	31319	224	182	0	32397
20381	195	592	160	31255	0	32202
20382	31549	134	103	711	0	32497
20383	705	105	31697	240	0	32747
20384	216	31332	677	229	0	32454
20385	155	597	219	31413	0	32384
20386	31472	148	151	764	0	32535
20387	31410	108	129	324	0	31971
20388	31689	71	137	252	0	32149
20389	771	30954	159	282	0	32166
20390	287	607	31255	210	0	32359
20391	194	134	683	31317	0	32328
20392	166	123	235	30130	0	30654
20393	162	83	172	31769	0	32186
20394	163	74	151	31718	0	32106
20395	31074	73	172	894	0	32213
20396	30521	87	191	359	0	31158
20397	831	98	30132	295	0	31356
20398	307	113	29960	278	0	30658
20399	29168	81	778	269	0	30296
20400	30196	90	278	270	0	30834
20401	827	103	209	28543	0	29682
20402	300	29622	189	790	0	30901
20403	29303	637	155	327	0	30422
20404	729	29139	157	342	0	30367
20405	299	29517	174	280	0	30270
20406	253	737	168	29505	0	30663
20407	227	237	145	30171	0	30780
20408	216	175	160	30198	0	30749
20409	222	113	164	30258	0	30757
20410	221	139	29266	931	0	30557
20411	28290	114	695	405	0	29504
20412	29473	103	239	335	0	30150
20413	849	137	199	28356	0	29541
20414	384	118	164	28829	0	29495
20415	28514	105	202	877	0	29698
20416	778	130	28169	362	0	29439
20417	28333	111	694	333	0	29471
20418	29123	101	249	303	0	29776
20419	892	128	28460	269	0	29749
20420	28857	108	702	312	0	29979
20421	837	118	263	29365	0	30583
20422	329	112	232	29864	0	30537
20423	299	120	205	30015	0	30639
20424	337	124	155	29945	0	30561
20425	28414	104	157	936	0	29611
20426	865	110	180	28051	0	29206
20427	337	86	159	26523	0	27105
20428	244	25367	161	828	0	26600
20429	195	25782	140	384	0	26501
20430	236	604	118	24950	0	25908
20431	24702	161	115	708	0	25686
20432	766	132	101	23047	0	24046
20433	253	90	21741	590	0	22674
20434	220	88	20492	227	0	21027
20435	19785	85	552	220	0	20642
20436	520	20438	223	214	0	21395
20437	18016	365	206	142	0	18729
20438	503	120	17939	145	0	18707
20439	321	411	394	16107	0	17233
20440	16096	45	140	348	0	16629
20441	341	15986	107	185	0	16619
20442	15753	242	101	141	0	16237
20443	355	88	17149	131	0	17723
20444	150	76	271	16802	0	17299
20445	124	32	110	17417	0	17683
20446	17678	77	90	392	0	18237
20447	17626	68	85	164	0	17943
20448	18107	66	48	149	0	18370
20449	18144	66	41	114	0	18365
20450	18194	72	66	110	0	18442
20451	339	18097	71	140	0	18647
20452	176	231	61	18350	0	18818
20453	18628	81	55	344	0	19108
20454	334	67	40	18568	0	19009
20455	185	48	44	18632	0	18909
20456	170	50	56	18601	0	18877
20457	123	18188	74	338	0	18723
20458	18339	239	57	181	0	18816
20459	291	83	65	18296	0	18735
20460	17866	46	69	360	0	18341
20461	17613	27	40	206	0	17886
20462	336	17362	44	207	0	17949
20463	17410	202	56	111	0	17779
20464	340	66	17003	87	0	17496
20465	16614	73	262	72	0	17021
20466	338	142	214	16728	0	17422
20467	159	33	17382	239	0	17813
20468	128	17256	202	236	0	17822
20469	171	198	17042	109	0	17520
20470	55	15583	129	67	0	15834
20471	14170	190	209	114	0	14683
20472	14292	16	35	82	0	14425
20473	14074	17	13	31	0	14135
20474	41	14295	13	38	0	14387
20475	14195	29	15	28	0	14267
20476	54	14	14295	12	0	14375
20477	22	19	14588	14	0	14643
20478	19	12	24	14172	0	14227
20479	30	15	11	15176	0	15232
20480	3	15274	8	67	0	15352
20481	15508	33	7	20	0	15568
20482	39	13	17	15564	0	15633
20483	6	15745	15	58	0	15824
20484	15	64	4	16164	0	16247
20485	16187	11	6	74	0	16278
20486	15779	3	5	36	0	15823
20487	79	18	15346	24	0	15467
20488	35	6	51	15398	0	15490
20489	35	20	15605	63	0	15723
20490	9	10	53	15674	0	15746
20491	35	24	15835	74	0	15968
20492	14	12	68	15654	0	15748
20493	29	16	15963	73	0	16081
20494	11	15	67	15760	0	15853
20495	36	19	16400	80	0	16535
20496	20	10	77	16203	0	16310
20497	18	11	29	16574	0	16632
20498	11	17261	24	118	0	17414
20499	16	74	11	17757	0	17858
20500	28	40	17488	81	0	17637
20501	15	17	73	17286	0	17391
20502	20	12	31	17546	0	17609
20503	17610	6	17	115	0	17748
20504	83	15	15	17860	0	17973
20505	35	20	17	17798	0	17870
20506	28	31	17286	118	0	17463
20507	16533	17	84	93	0	16727
20508	83	19	34	18040	0	18176
20509	35	11	27	18084	0	18157
20510	26	14	11	18268	0	18319
20511	18209	13	23	122	0	18367
20512	83	17	16	18343	0	18459
20513	33	9	21	18469	0	18532
20514	18313	5	18	129	0	18465
20515	80	18287	23	88	0	18478
20516	41	83	19	18097	0	18240
20517	20	41	14	18313	0	18388
20518	38	47	17780	133	0	17998
20519	13942	15	95	115	0	14167
20520	89	13	31	17556	0	17689
20521	41	25	16950	114	0	17130
20522	16787	11	85	98	0	16981
20523	101	9	30	18142	0	18282
20524	46	13	20	18460	0	18539
20525	31	15	19	18572	0	18637
20526	25	9	20	19087	0	19141
20527	30	28	20685	160	0	20903
20528	35	10	152	20962	0	21159
20529	30	14	45	26309	0	26398
20530	56	29	30635	464	0	31184
20531	30914	8	607	166	0	31695
20532	32922	10	187	83	0	33202
20533	33042	15	74	56	0	33187
20534	921	13	36	32443	0	33413
20535	32873	19	34	691	0	33617
20536	33364	21	25	268	0	33678
20537	908	20	26	33163	0	34117
20538	33556	10	73	752	0	34391
20539	33671	12	24	267	0	33974
20540	33778	18	26	145	0	33967
20541	33991	9	24	79	0	34103
20542	953	14	21	32596	0	33584
20543	306	31485	39	741	0	32571
20544	144	32124	49	292	0	32609
20545	77	32678	36	167	0	32958
20546	31531	910	47	93	0	32581
20547	32314	287	25	93	0	32719
20548	946	109	31780	71	0	32906
20549	31984	47	694	98	0	32823
20550	809	33	228	32988	0	34058
20551	284	20	92	33306	0	33702
20552	175	23	46	33797	0	34041
20553	32529	29	73	1026	0	33657
20554	775	22	26	32630	0	33453
20555	297	32142	43	887	0	33369
20556	197	714	32	32836	0	33779
20557	179	237	33441	864	0	34721
20558	131	95	712	33477	0	34415
20559	33629	53	224	894	0	34800
20560	860	48	33753	315	0	34976
20561	337	34	743	33618	0	34732
20562	220	41	253	33498	0	34012
20563	159	49	107	34036	0	34351
20564	142	33959	76	1055	0	35232
20565	150	736	65	34467	0	35418
20566	34147	222	41	895	0	35305
20567	33703	113	58	378	0	34252
20568	1100	81	33168	221	0	34570
20569	453	74	33571	151	0	34249
20570	257	69	946	33117	0	34389
20571	198	56	311	34375	0	34940
20572	212	65	33949	1076	0	35302
20573	222	72	814	31507	0	32615
20574	178	33842	281	848	0	35149
20575	34816	792	117	357	0	36082
20576	34882	255	80	238	0	35455
20577	34447	118	77	183	0	34825
20578	1221	82	34000	183	0	35486
20579	495	44	803	33842	0	35184
20580	290	60	33984	927	0	35261
20581	32449	48	891	410	0	33798
20582	899	33533	315	290	0	35037
20583	402	801	148	33271	0	34622
20584	33446	262	83	957	0	34748
20585	919	151	73	33366	0	34509
20586	419	92	77	34489	0	35077
20587	300	102	33619	1119	0	35140
20588	31034	81	840	516	0	32471
20589	977	33589	317	316	0	35199
20590	473	770	178	33818	0	35239
20591	33720	258	143	942	0	35063
20592	1016	154	99	33856	0	35125
20593	33654	86	93	1054	0	34887
20594	1009	33754	93	542	0	35398
20595	34167	799	90	373	0	35429
20596	1110	309	34351	228	0	35998
20597	33966	158	859	260	0	35243
20598	34589	102	368	225	0	35284
20599	34772	100	221	245	0	35338
20600	1330	102	176	33627	0	35235
20601	654	126	123	33624	0	34527
20602	397	146	109	33961	0	34613
20603	336	33343	94	1259	0	35032
20604	33601	833	96	547	0	35077
20605	1096	278	107	33522	0	35003
20606	568	160	117	34015	0	34860
20607	402	106	133	34160	0	34801
20608	33123	105	132	1265	0	34625
20609	1047	101	122	33412	0	34682
20610	480	119	32727	1142	0	34468
20611	290	32848	863	591	0	34592
20612	243	888	286	33505	0	34922
20613	240	390	175	34073	0	34878
20614	272	230	133	34594	0	35229
20615	297	151	33219	1291	0	34958
20616	340	122	33259	564	0	34285
20617	299	69	1112	33457	0	34937
20618	323	72	34932	1075	0	36402
20619	281	76	964	35182	0	36503
20620	35628	85	355	1240	0	37308
20621	36716	121	220	645	0	37702
20622	36624	119	135	487	0	37365
20623	1331	142	35093	339	0	36905
20624	34005	129	898	343	0	35375
20625	1191	123	368	35156	0	36838
20626	488	77	34819	1065	0	36449
20627	378	86	33724	465	0	34653
20628	245	32727	1108	469	0	34549
20629	155	28421	316	280	0	29172
20630	22910	426	561	133	0	24030
20631	340	98	89	22380	0	22907
20632	101	39	22985	336	0	23461
20633	61	45	248	23092	0	23446
20634	23433	27	74	340	0	23874
20635	293	24	24960	124	0	25401
20636	24501	22	308	134	0	24965
20637	26446	29	75	96	0	26646
20638	26271	16	46	81	0	26414
20639	403	26171	42	105	0	26721
20640	26818	332	41	119	0	27310
20641	400	74	50	26951	0	27475
20642	150	41	47	26983	0	27221
20643	95	26	40	27283	0	27444
20644	100	27	44	27096	0	27267
20645	26292	20	48	478	0	26838
20646	373	25970	64	203	0	26610
20647	103	25466	45	112	0	25726
20648	75	25891	46	100	0	26112
20649	25522	384	98	91	0	26095
20650	25566	98	36	83	0	25783
20651	25521	42	42	79	0	25684
20652	25369	30	43	66	0	25508
20653	448	29	32	25211	0	25720
20654	152	25	41	25530	0	25748
20655	25273	18	43	424	0	25758
20656	359	25184	40	157	0	25740
20657	24387	317	42	86	0	24832
20658	24787	87	32	95	0	25001
20659	418	54	42	24205	0	24719
20660	159	24461	48	360	0	25028
20661	93	350	29	25114	0	25586
20662	24594	85	39	406	0	25124
20663	409	82	25068	134	0	25693
20664	140	62	334	23907	0	24443
20665	74	25023	101	365	0	25563
20666	24819	342	92	130	0	25383
20667	24221	87	37	107	0	24452
20668	470	57	24842	69	0	25438
20669	151	24031	345	141	0	24668
20670	171	314	24358	68	0	24911
20671	94	125	338	23142	0	23699
20672	96	53	23696	338	0	24183
20673	105	36	23240	114	0	23495
20674	74	22959	351	112	0	23496
20675	22861	281	109	58	0	23309
20676	22800	81	44	90	0	23015
20677	369	23360	41	113	0	23883
20678	135	23334	40	104	0	23613
20679	127	355	21997	75	0	22554
20680	98	123	22170	78	0	22469
20681	100	69	22739	78	0	22986
20682	96	64	376	22257	0	22793
20683	118	51	22822	336	0	23327
20684	95	52	314	21745	0	22206
20685	85	63	95	22069	0	22312
20686	140	62	22312	370	0	22884
20687	100	22021	302	161	0	22584
20688	130	298	89	21935	0	22452
20689	21476	97	57	333	0	21963
20690	368	66	33	21895	0	22362
20691	185	70	22015	347	0	22617
20692	127	21762	306	191	0	22386
20693	141	22845	84	144	0	23214
20694	118	429	79	22108	0	22734
20695	22027	121	59	337	0	22544
20696	21847	104	51	152	0	22154
20697	446	74	51	21260	0	21831
20698	205	22494	53	355	0	23107
20699	159	342	43	22808	0	23352
20700	145	118	44	23684	0	23991
20701	127	107	52	23748	0	24034
20702	24986	75	44	493	0	25598
20703	484	25172	66	218	0	25940
20704	25542	436	69	156	0	26203
20705	26058	151	65	112	0	26386
20706	25976	102	66	118	0	26262
20707	26653	77	56	120	0	26906
20708	661	136	66	25870	0	26733
20709	271	95	26196	535	0	27097
20710	152	26328	493	247	0	27220
20711	26699	508	217	152	0	27576
20712	27275	161	89	123	0	27648
20713	27694	108	72	99	0	27973
20714	706	87	26845	99	0	27737
20715	26483	92	504	79	0	27158
20716	27287	69	181	98	0	27635
20717	656	108	88	26848	0	27700
20718	275	81	25640	503	0	26499
20719	159	25197	493	210	0	26059
20720	157	495	173	24956	0	25781
20721	24607	141	130	529	0	25407
20722	510	93	80	24563	0	25246
20723	183	72	74	25520	0	25849
20724	26086	63	77	618	0	26844
20725	576	73	25754	225	0	26628
20726	25804	90	524	146	0	26564
20727	25735	67	189	106	0	26097
20728	25695	61	127	101	0	25984
20729	25689	61	94	90	0	25934
20730	730	79	24966	107	0	25882
20731	275	87	513	24551	0	25426
20732	173	71	24918	511	0	25673
20733	121	115	564	24001	0	24801
20734	120	57	24204	582	0	24963
20735	21301	61	527	198	0	22087
20736	490	21364	196	161	0	22211
20737	195	21711	83	106	0	22095
20738	179	516	54	23344	0	24093
20739	114	202	48	23783	0	24147
20740	89	25536	53	685	0	26363
20741	25883	585	39	220	0	26727
20742	27335	177	40	92	0	27644
20743	28406	79	46	70	0	28601
20744	29733	42	38	65	0	29878
20745	1003	35	39	29098	0	30175
20746	340	39	42	30442	0	30863
20747	30222	34	54	970	0	31280
20748	858	34	49	30105	0	31046
20749	335	72	29530	867	0	30804
20750	222	56	29852	273	0	30403
20751	169	30	948	29849	0	30996
20752	172	49	29994	815	0	31030
20753	29329	46	853	270	0	30498
20754	859	31	260	29762	0	30912
20755	29997	39	142	842	0	31020
20756	936	53	30200	310	0	31499
20757	344	56	833	30056	0	31289
20758	236	58	30678	843	0	31815
20759	172	30452	894	343	0	31861
20760	30044	802	338	209	0	31393
20761	30248	253	147	156	0	30804
20762	1026	29595	99	216	0	30936
20763	29389	773	79	167	0	30408
20764	983	241	78	28977	0	30279
20765	405	114	90	29687	0	30296
20766	28933	62	100	1038	0	30133
20767	911	28415	109	429	0	29864
20768	402	29197	111	272	0	29982
20769	294	988	101	28479	0	29862
20770	28337	305	98	876	0	29616
20771	29165	126	107	340	0	29738
20772	29191	83	185	212	0	29671
20773	1243	81	28362	177	0	29863
20774	495	85	28419	188	0	29187
20775	304	28110	1013	228	0	29655
20776	28241	822	361	183	0	29607
20777	1028	280	173	27745	0	29226
20778	28163	168	140	892	0	29363
20779	28630	101	125	348	0	29204
20780	1238	106	137	27849	0	29330
20781	587	83	28027	958	0	29655
20782	27992	82	861	408	0	29343
20783	1054	95	312	28034	0	29495
20784	490	108	28155	997	0	29750
20785	27736	98	876	444	0	29154
20786	28534	82	364	324	0	29304
20787	1201	84	240	27959	0	29484
20788	564	91	27973	1002	0	29630
20789	414	110	889	26433	0	27846
20790	310	27987	381	1046	0	29724
20791	448	838	28398	387	0	30071
20792	326	28793	938	316	0	30373
20793	28501	863	367	265	0	29996
20794	29084	276	280	228	0	29868
20795	29167	167	185	246	0	29765
20796	29030	121	218	232	0	29601
20797	1393	134	174	27791	0	29492
20798	27159	123	186	946	0	28414
20799	1169	109	163	26573	0	28014
20800	25614	105	169	993	0	26881
20801	1022	25497	173	508	0	27200
20802	476	736	163	23044	0	24419
20803	347	23747	151	758	0	25003
20804	23755	745	132	374	0	25006
20805	23754	272	137	257	0	24420
20806	1021	23189	151	234	0	24595
20807	486	707	112	22865	0	24170
20808	398	249	22587	782	0	24016
20809	297	195	705	22355	0	23552
20810	342	141	22476	786	0	23745
20811	370	174	722	19892	0	21158
20812	307	21654	295	661	0	22917
20813	21655	630	188	338	0	22811
20814	21964	230	137	215	0	22546
20815	957	159	113	21375	0	22604
20816	22501	96	130	779	0	23506
20817	891	112	161	22538	0	23702
20818	443	111	131	23032	0	23717
20819	301	115	135	23384	0	23935
20820	22952	112	143	911	0	24118
20821	23338	103	106	442	0	23989
20822	23457	103	100	283	0	23943
20823	954	22243	120	259	0	23576
20824	21572	566	132	188	0	22458
20825	745	21266	120	234	0	22365
20826	21608	599	141	166	0	22514
20827	744	218	112	21147	0	22221
20828	405	172	119	21810	0	22506
20829	21421	133	85	729	0	22368
20830	21518	115	91	301	0	22025
20831	844	21051	103	237	0	22235
20832	21160	557	86	185	0	21988
20833	763	173	69	20662	0	21667
20834	379	137	76	21224	0	21816
20835	20750	96	73	745	0	21664
20836	752	132	20736	317	0	21937
20837	331	19959	495	264	0	21049
20838	395	384	134	17504	0	18417
20839	186	114	16047	351	0	16698
20840	201	417	275	14892	0	15785
20841	15047	45	114	367	0	15573
20842	306	14048	70	158	0	14582
20843	123	12963	40	121	0	13247
20844	78	12055	36	72	0	12241
20845	220	370	168	11059	0	11817
20846	11063	35	271	149	0	11518
20847	112	21	15	10964	0	11112
20848	11046	25	14	110	0	11195
20849	11063	18	16	58	0	11155
20850	126	18	13	11003	0	11160
20851	11225	20	8	112	0	11365
20852	126	19	8	11312	0	11465
20853	61	25	11275	119	0	11480
20854	10789	18	97	62	0	10966
20855	142	17	12309	48	0	12516
20856	11456	18	105	36	0	11615
20857	139	19	12065	41	0	12264
20858	46	15	89	11281	0	11431
20859	29	17	19	11703	0	11768
20860	11865	12	17	129	0	12023
20861	118	23	9	12099	0	12249
20862	12137	12	10	139	0	12298
20863	110	12167	18	42	0	12337
20864	12499	104	14	77	0	12694
20865	125	30	12	12707	0	12874
20866	52	18	8	12848	0	12926
20867	28	26	10	12946	0	13010
20868	39	18	8	12903	0	12968
20869	40	19	12608	154	0	12821
20870	33	19	12514	60	0	12626
20871	59	12	127	12580	0	12778
20872	49	20	12894	139	0	13102
20873	36	12559	125	68	0	12788
20874	36	106	25	12713	0	12880
20875	49	28	12997	149	0	13223
20876	48	24	12717	51	0	12840
20877	44	34	130	12901	0	13109
20878	38	14	36	12967	0	13055
20879	21	13293	29	158	0	13501
20880	21	134	17	13494	0	13666
20881	36	33	13404	165	0	13638
20882	12648	20	163	60	0	12891
20883	164	15	49	13767	0	13995
20884	13820	14	29	212	0	14075
20885	13799	15	35	62	0	13911
20886	14022	13	51	69	0	14155
20887	214	21	14150	65	0	14450
20888	80	23	13875	29	0	14007
20889	12384	22	194	70	0	12670
20890	205	21	13988	53	0	14267
20891	71	38	178	12956	0	13243
20892	41	15	51	13440	0	13547
20893	61	14	13472	219	0	13766
20894	41	13455	182	95	0	13773
20895	13418	160	51	69	0	13698
20896	172	13511	40	71	0	13794
20897	60	14024	48	67	0	14199
20898	14043	177	53	59	0	14332
20899	208	46	14952	62	0	15268
20900	73	30	15053	55	0	15211
20901	59	32	237	14485	0	14813
20902	14839	22	81	214	0	15156
20903	197	14911	88	111	0	15307
20904	15052	192	55	77	0	15376
20905	234	58	15220	81	0	15593
20906	72	16494	226	72	0	16864
20907	62	243	79	16944	0	17328
20908	60	71	17506	285	0	17922
20909	48	53	274	17330	0	17705
20910	76	51	88	16818	0	17033
20911	70	32	52	17826	0	17980
20912	68	38	70	17708	0	17884
20913	17424	37	62	340	0	17863
20914	17171	25	61	138	0	17395
20915	348	28	17523	70	0	17969
20916	16251	36	295	89	0	16671
20917	297	16541	122	111	0	17071
20918	16541	238	88	85	0	16952
20919	295	85	16705	84	0	17169
20920	118	65	271	16317	0	16771
20921	60	43	16878	286	0	17267
20922	86	43	16836	129	0	17094
20923	72	55	331	16264	0	16722
20924	64	37	125	16704	0	16930
20925	70	52	16620	359	0	17101
20926	91	16128	290	151	0	16660
20927	72	16510	130	99	0	16811
20928	72	329	87	16426	0	16914
20929	15952	84	59	333	0	16428
20930	273	16736	90	175	0	17274
20931	136	275	16893	84	0	17388
20932	90	92	16733	95	0	17010
20933	95	63	16980	98	0	17236
20934	70	57	368	16033	0	16528
20935	16537	49	147	331	0	17064
20936	296	16253	113	162	0	16824
20937	153	293	16126	106	0	16678
20938	78	16184	344	124	0	16730
20939	66	307	138	16157	0	16668
20940	99	92	16307	356	0	16854
20941	75	16432	340	164	0	17011
20942	88	301	143	16199	0	16731
20943	77	109	113	16880	0	17179
20944	96	81	17374	365	0	17916
20945	103	67	341	16129	0	16640
20946	90	17042	151	329	0	17612
20947	122	298	16934	131	0	17485
20948	16363	123	339	106	0	16931
20949	320	86	153	17001	0	17560
20950	121	83	145	16659	0	17008
20951	91	17008	109	380	0	17588
20952	16766	288	133	159	0	17346
20953	312	105	16621	113	0	17151
20954	15970	73	322	145	0	16510
20955	296	134	109	15614	0	16153
20956	104	15744	90	312	0	16250
20957	73	254	121	15667	0	16115
20958	60	105	83	16191	0	16439
20959	15967	64	87	322	0	16440
20960	15884	61	87	158	0	16190
20961	306	43	69	15967	0	16385
20962	108	65	15823	291	0	16287
20963	14458	64	278	154	0	14954
20964	242	15936	127	117	0	16422
20965	118	251	90	15880	0	16339
20966	84	91	74	16422	0	16671
20967	85	66	79	16531	0	16761
20968	76	72	16255	368	0	16771
20969	69	57	317	15661	0	16104
20970	75	16267	168	317	0	16827
20971	72	267	80	15633	0	16052
20972	59	16144	84	310	0	16597
20973	68	286	74	16173	0	16601
20974	67	95	16041	327	0	16530
20975	14372	59	299	155	0	14885
20976	296	55	117	15698	0	16166
20977	123	47	15585	301	0	16056
20978	56	15480	274	171	0	15981
20979	15302	249	140	97	0	15788
20980	269	98	15190	120	0	15677
20981	14354	69	283	94	0	14800
20982	261	41	104	14920	0	15326
20983	102	39	69	14651	0	14861
20984	44	14939	58	246	0	15287
20985	14830	186	81	105	0	15202
20986	14473	83	63	68	0	14687
20987	241	15060	45	106	0	15452
20988	88	223	54	15345	0	15710
20989	37	88	62	15443	0	15630
20990	27	55	47	15406	0	15535
20991	38	44	15079	291	0	15452
20992	14156	34	234	134	0	14558
20993	204	59	87	15061	0	15411
20994	78	59	51	15265	0	15453
20995	51	51	14808	305	0	15215
20996	50	60	14732	135	0	14977
20997	56	96	272	14840	0	15264
20998	54	43	15134	263	0	15494
20999	13496	29	217	125	0	13867
21000	215	31	94	14393	0	14733
21001	90	33	46	14758	0	14927
21002	46	32	15243	277	0	15598
21003	35	56	199	15132	0	15422
21004	62	44	15468	237	0	15811
21005	42	14935	207	122	0	15306
21006	13437	169	125	48	0	13779
21007	13149	49	54	49	0	13301
21008	162	13014	17	67	0	13260
21009	58	151	27	13159	0	13395
21010	39	52	13321	150	0	13562
21011	33	31	139	13174	0	13377
21012	13188	14	55	164	0	13421
21013	130	13370	36	83	0	13619
21014	13311	131	24	51	0	13517
21015	147	42	30	13296	0	13515
21016	13308	29	20	156	0	13513
21017	143	13311	20	93	0	13567
21018	13384	133	24	48	0	13589
21019	162	59	12878	49	0	13148
21020	55	13051	143	60	0	13309
21021	40	108	52	12821	0	13021
21022	13619	43	55	161	0	13878
21023	13763	18	18	84	0	13883
21024	165	22	22	13804	0	14013
21025	14106	13	18	162	0	14299
21026	13998	21	16	82	0	14117
21027	14282	16	19	87	0	14404
21028	173	24	31	14094	0	14322
21029	67	23	14276	163	0	14529
21030	37	27	13503	66	0	13633
21031	43	28	13841	42	0	13954
21032	13595	35	172	42	0	13844
21033	150	21	51	13939	0	14161
21034	50	14267	32	174	0	14523
21035	44	131	30	13866	0	14071
21036	37	14666	33	151	0	14887
21037	14958	134	32	87	0	15211
21038	173	51	28	14985	0	15237
21039	70	33	21	15527	0	15651
21040	15663	25	27	225	0	15940
21041	189	20	29	15737	0	15975
21042	71	21	35	16122	0	16249
21043	16334	19	44	235	0	16632
21044	218	29	16451	95	0	16793
21045	88	23	229	16380	0	16720
21046	63	24	16443	261	0	16791
21047	16041	31	231	99	0	16402
21048	246	19	68	16739	0	17072
21049	16809	28	44	237	0	17118
21050	263	20	33	17120	0	17436
21051	105	43	17551	268	0	17967
21052	69	38	227	17738	0	18072
21053	17889	25	84	277	0	18275
21054	244	18301	53	186	0	18784
21055	114	225	18092	80	0	18511
21056	17058	70	240	63	0	17431
21057	259	18188	92	75	0	18614
21058	96	18491	45	77	0	18709
21059	85	20135	37	78	0	20335
21060	67	324	29	21704	0	22124
21061	22377	68	88	347	0	22880
21062	22978	30	45	100	0	23153
21063	416	34	22625	67	0	23142
21064	22041	19	326	51	0	22437
21065	363	22088	81	80	0	22612
21066	129	302	51	22084	0	22566
21067	23661	63	49	377	0	24150
21068	23947	42	48	107	0	24144
21069	24093	32	35	80	0	24240
21070	23784	32	45	56	0	23917
21071	23976	43	43	64	0	24126
21072	414	40	31	23735	0	24220
21073	138	60	23716	355	0	24269
21074	110	33	320	23930	0	24393
21075	112	48	62	24164	0	24386
21076	24270	32	47	402	0	24751
21077	399	23615	39	177	0	24230
21078	24109	324	43	94	0	24570
21079	24420	58	51	113	0	24642
21080	25152	49	53	166	0	25420
21081	25823	39	46	128	0	26036
21082	473	49	25461	93	0	26076
21083	25474	36	336	102	0	25948
21084	26205	47	77	90	0	26419
21085	24222	37	76	103	0	24438
21086	26085	29	51	77	0	26242
21087	510	28	56	25230	0	25824
21088	200	41	24558	374	0	25173
21089	24211	26	351	145	0	24733
21090	423	24808	114	134	0	25479
21091	198	319	65	23988	0	24570
21092	163	25137	80	385	0	25765
21093	153	340	53	25538	0	26084
21094	25880	85	56	408	0	26429
21095	25933	78	65	120	0	26196
21096	26024	73	67	113	0	26277
21097	532	68	24886	88	0	25574
21098	24517	58	337	88	0	25000
21099	452	61	24612	108	0	25233
21100	238	64	24649	90	0	25041
21101	204	82	24973	90	0	25349
21102	206	83	377	23360	0	24026
21103	203	48	127	24371	0	24749
21104	191	35	73	24526	0	24825
21105	172	49	78	24638	0	24937
21106	177	65	69	24427	0	24738
21107	159	60	85	23967	0	24271
21108	156	24414	73	409	0	25052
21109	23834	335	63	165	0	24397
21110	400	24456	79	160	0	25095
21111	205	349	56	24714	0	25324
21112	179	93	57	25179	0	25508
21113	24757	74	57	428	0	25316
21114	439	24738	84	194	0	25455
21115	24851	345	76	133	0	25405
21116	511	99	81	24695	0	25386
21117	251	93	97	24792	0	25233
21118	240	71	96	24971	0	25378
21119	226	79	24550	453	0	25308
21120	236	71	351	24380	0	25038
21121	262	86	24189	429	0	24966
21122	230	61	23564	199	0	24054
21123	259	64	25043	161	0	25527
21124	242	78	398	24523	0	25241
21125	225	62	124	25496	0	25907
21126	214	64	77	25930	0	26285
21127	25763	77	87	493	0	26420
21128	490	72	76	26497	0	27135
21129	26761	74	100	496	0	27431
21130	561	26881	88	226	0	27756
21131	27972	386	78	216	0	28652
21132	29123	98	76	222	0	29519
21133	579	30115	98	181	0	30973
21134	30467	396	57	192	0	31112
21135	30488	107	109	173	0	30877
21136	30311	71	100	169	0	30651
21137	30501	44	90	128	0	30763
21138	685	63	29936	108	0	30792
21139	290	29426	439	142	0	30297
21140	282	450	140	29310	0	30182
21141	29179	112	122	485	0	29898
21142	504	52	29038	210	0	29804
21143	202	28437	408	183	0	29230
21144	199	351	94	26887	0	27531
21145	172	28321	71	415	0	28979
21146	197	371	62	28301	0	28931
21147	159	140	53	28667	0	29019
21148	234	81	28613	413	0	29341
21149	200	94	27885	143	0	28322
21150	25261	64	416	160	0	25901
21151	481	59	27846	98	0	28484
21152	222	70	27580	94	0	27966
21153	224	71	420	26403	0	27118
21154	183	53	140	25949	0	26325
21155	139	26899	139	428	0	27605
21156	155	29013	123	199	0	29490
21157	147	394	28953	166	0	29660
21158	233	328	508	28982	0	30051
21159	120	99	28700	438	0	29357
21160	69	61	25873	133	0	26136
21161	51	25621	374	88	0	26134
21162	131	326	162	24802	0	25421
21163	25107	100	62	279	0	25548
21164	294	61	46	25113	0	25514
21165	25493	31	34	329	0	25887
21166	25240	29	38	131	0	25438
21167	24936	34	52	110	0	25132
21168	404	44	24774	58	0	25280
21169	24308	39	294	68	0	24709
21170	341	39	105	25021	0	25506
21171	25450	25	65	325	0	25865
21172	25387	30	58	137	0	25612
21173	352	25023	71	87	0	25533
21174	24980	282	32	79	0	25373
21175	353	105	25122	48	0	25628
21176	24184	51	290	63	0	24588
21177	25036	40	107	53	0	25236
21178	342	24989	72	72	0	25475
21179	24936	285	45	44	0	25310
21180	338	93	51	23794	0	24276
21181	145	77	46	23679	0	23947
21182	89	23654	72	370	0	24185
21183	94	265	45	23945	0	24349
21184	77	110	47	24162	0	24396
21185	93	60	23949	374	0	24476
21186	117	60	23548	137	0	23862
21187	22031	42	360	115	0	22548
21188	23783	43	144	67	0	24037
21189	390	40	72	23969	0	24471
21190	197	46	24155	310	0	24708
21191	116	23914	335	137	0	24502
21192	103	315	114	23826	0	24358
21193	90	107	24128	322	0	24647
21194	22255	79	345	163	0	22842
21195	368	54	110	24334	0	24866
21196	150	25186	85	348	0	25769
21197	123	331	80	25459	0	25993
21198	78	144	83	25992	0	26297
21199	109	65	75	26140	0	26389
21200	25342	59	86	488	0	25975
21201	414	49	72	25428	0	25963
21202	25497	51	70	441	0	26059
21203	25504	56	64	175	0	25799
21204	553	54	25380	142	0	26129
21205	213	25604	423	142	0	26382
21206	196	426	157	22530	0	23309
21207	114	26676	110	377	0	27277
21208	27144	440	102	166	0	27852
21209	500	144	91	27046	0	27781
21210	235	95	27103	475	0	27908
21211	168	69	26949	193	0	27379
21212	139	84	27137	116	0	27476
21213	25869	49	573	121	0	26612
21214	496	27105	209	138	0	27948
21215	26793	463	103	102	0	27461
21216	544	27273	94	111	0	28022
21217	246	486	70	27019	0	27821
21218	196	162	78	26599	0	27035
21219	150	27450	86	594	0	28280
21220	211	477	27488	226	0	28402
21221	121	27888	469	175	0	28653
21222	27096	478	159	150	0	27883
21223	508	177	98	26045	0	26828
21224	218	105	25833	489	0	26645
21225	161	77	25864	198	0	26300
21226	174	147	548	25271	0	26140
21227	160	69	25445	453	0	26127
21228	160	80	24560	178	0	24978
21229	22447	101	501	149	0	23198
21230	418	23595	198	150	0	24361
21231	22604	360	91	107	0	23162
21232	459	153	22762	121	0	23495
21233	199	21627	400	125	0	22351
21234	133	22372	156	127	0	22788
21235	185	515	151	21797	0	22648
21236	101	155	105	22506	0	22867
21237	112	83	71	23041	0	23307
21238	105	85	22527	565	0	23282
21239	122	63	397	22495	0	23077
21240	111	67	156	23136	0	23470
21241	22833	60	85	529	0	23507
21242	450	22555	57	261	0	23323
21243	193	414	74	22855	0	23536
21244	22794	177	79	479	0	23529
21245	22615	85	91	211	0	23002
21246	556	87	69	22481	0	23193
21247	228	88	22687	466	0	23469
21248	127	70	440	22578	0	23215
21249	101	71	22779	541	0	23492
21250	23125	55	478	223	0	23881
21251	25458	69	216	146	0	25889
21252	648	122	123	26754	0	27647
21253	248	80	27436	565	0	28329
21254	147	28866	573	344	0	29930
21255	153	603	29449	131	0	30336
21256	130	329	608	24734	0	25801
21257	55	27986	198	505	0	28744
21258	26830	497	66	133	0	27526
21259	512	137	47	25541	0	26237
21260	121	26579	69	508	0	27277
21261	27023	493	70	156	0	27742
21262	527	119	72	26662	0	27380
21263	138	27148	66	557	0	27909
21264	92	506	70	27506	0	28174
21265	85	133	27186	561	0	27965
21266	25779	75	528	159	0	26541
21267	26917	65	127	118	0	27227
21268	633	59	26355	92	0	27139
21269	159	26319	517	113	0	27108
21270	26516	513	151	121	0	27301
21271	541	149	85	26304	0	27079
21272	154	79	61	26814	0	27108
21273	94	62	56	27043	0	27255
21274	79	58	55	27011	0	27203
21275	79	64	72	26733	0	26948
21276	26090	66	58	655	0	26869
21277	26730	44	72	228	0	27074
21278	632	60	67	26355	0	27114
21279	194	61	75	26866	0	27196
21280	125	61	26193	654	0	27033
21281	104	53	26097	215	0	26469
21282	25309	62	602	128	0	26101
21283	573	68	157	25923	0	26721
21284	207	59	25771	583	0	26620
21285	117	73	529	25557	0	26276
21286	25910	56	167	630	0	26763
21287	26563	62	104	231	0	26960
21288	661	70	93	26008	0	26832
21289	205	57	65	26490	0	26817
21290	26446	55	90	712	0	27303
21291	570	65	66	26102	0	26803
21292	178	26766	89	630	0	27663
21293	149	554	79	26412	0	27194
21294	148	174	71	26642	0	27035
21295	123	78	26122	651	0	26974
21296	143	57	25335	227	0	25762
21297	101	25732	568	192	0	26593
21298	25111	493	200	138	0	25942
21299	24962	126	119	135	0	25342
21300	25288	73	61	133	0	25555
21301	588	24773	90	163	0	25614
21302	184	25397	86	176	0	25843
21303	24633	532	84	132	0	25381
21304	489	25556	68	203	0	26316
21305	183	491	24961	176	0	25811
21306	138	25418	486	167	0	26209
21307	143	447	24754	176	0	25520
21308	23432	149	445	135	0	24161
21309	24734	88	155	134	0	25111
21310	515	24734	79	168	0	25496
21311	25286	436	87	153	0	25962
21312	27082	139	72	138	0	27431
21313	27295	96	81	165	0	27637
21314	684	120	88	26705	0	27597
21315	27278	95	81	602	0	28056
21316	641	108	26585	243	0	27577
21317	26582	85	544	154	0	27365
21318	660	93	174	27283	0	28210
21319	294	93	27263	583	0	28233
21320	212	97	27660	257	0	28226
21321	210	102	624	27321	0	28257
21322	177	87	220	28301	0	28785
21323	28213	105	134	714	0	29166
21324	606	83	94	28228	0	29011
21325	265	92	28228	687	0	29272
21326	193	65	557	27108	0	27923
21327	167	28916	183	676	0	29942
21328	29176	513	127	298	0	30114
21329	668	151	122	29051	0	29992
21330	294	113	28856	628	0	29891
21331	209	28809	550	291	0	29859
21332	27584	478	209	212	0	28483
21333	582	169	138	28393	0	29282
21334	300	84	28694	584	0	29662
21335	171	28350	513	270	0	29304
21336	28166	441	217	216	0	29040
21337	28189	133	109	187	0	28618
21338	28193	73	115	157	0	28538
21339	634	74	67	27690	0	28465
21340	294	61	89	28307	0	28751
21341	28073	63	74	589	0	28799
21342	529	27705	89	301	0	28624
21343	28190	423	77	217	0	28907
21344	553	124	92	27972	0	28741
21345	28884	91	80	580	0	29635
21346	552	67	90	28734	0	29443
21347	233	63	116	29046	0	29458
21348	218	85	101	29240	0	29644
21349	279	79	103	29129	0	29590
21350	194	52	27310	564	0	28120
21351	156	80	24985	222	0	25443
21352	20999	47	358	197	0	21601
21353	351	42	24187	133	0	24713
21354	128	44	21600	92	0	21864
21355	20079	39	339	88	0	20545
21356	21510	25	219	64	0	21818
21357	307	42	75	23400	0	23824
21358	24006	30	83	231	0	24350
21359	251	24414	52	113	0	24830
21360	24783	181	37	100	0	25101
21361	24571	77	39	80	0	24767
21362	25390	51	36	130	0	25607
21363	302	51	33	25200	0	25586
21364	164	25124	32	224	0	25544
21365	122	25762	35	121	0	26040
21366	25628	218	38	87	0	25971
21367	25704	103	40	87	0	25934
21368	292	56	26	25216	0	25590
21369	121	41	46	25362	0	25570
21370	95	25423	49	261	0	25828
21371	25096	183	42	130	0	25451
21372	245	74	25449	119	0	25887
21373	126	41	188	24834	0	25189
21374	108	34	113	25667	0	25922
21375	82	45	25939	285	0	26351
21376	90	31	201	24607	0	24929
21377	84	22875	92	288	0	23339
21378	95	187	62	26263	0	26607
21379	84	70	43	26032	0	26229
21380	76	25246	49	293	0	25664
21381	100	26586	51	150	0	26887
21382	64	226	35	26331	0	26656
21383	26123	84	42	269	0	26518
21384	210	62	47	26292	0	26611
21385	127	46	45	26652	0	26870
21386	89	27457	59	267	0	27872
21387	89	191	60	28076	0	28416
21388	83	69	34	27997	0	28183
21389	86	47	37	28110	0	28280
21390	27494	45	31	331	0	27901
21391	244	30	30	27684	0	27988
21392	131	43	34	27497	0	27705
21393	92	32	29	27707	0	27860
21394	124	45	26773	284	0	27226
21395	23085	47	167	197	0	23496
21396	216	26535	82	126	0	26959
21397	26829	162	42	100	0	27133
21398	238	100	32	26634	0	27004
21399	134	48	26275	214	0	26671
21400	23087	51	175	161	0	23474
21401	251	61	30354	108	0	30774
21402	121	48	183	29643	0	29995
21403	31787	30	92	222	0	32131
21404	31080	28	56	126	0	31290
21405	32007	25	52	148	0	32232
21406	272	35	34	31643	0	31984
21407	151	30	27	32236	0	32444
21408	100	52	32	32334	0	32518
21409	85	31316	22	297	0	31720
21410	60	31522	22	172	0	31776
21411	58	31354	39	121	0	31572
21412	23	31246	14	48	0	31331
21413	30	64	25	31211	0	31330
21414	25	44	6	31257	0	31332
21415	30703	7	16	81	0	30807
21416	30003	12	14	38	0	30067
21417	31023	7	7	66	0	31103
21418	70	18	7	30677	0	30772
21419	34	10	12	31288	0	31344
21420	30555	15	11	102	0	30683
21421	29358	15	47	67	0	29487
21422	86	26	29629	38	0	29779
21423	57	42	28292	27	0	28418
21424	41	39	29457	19	0	29556
21425	61	27	31103	23	0	31214
21426	22	14	54	30162	0	30252
21427	30877	12	23	63	0	30975
21428	43	30650	29	100	0	30822
21429	36	39	10	31322	0	31407
21430	82	50	31321	63	0	31516
21431	26	32479	44	122	0	32671
21432	20	37	18	33284	0	33359
21433	68	30	32961	65	0	33124
21434	19	16	30	32045	0	32110
21435	20	25	27	33180	0	33252
21436	33142	14	16	110	0	33282
21437	42	14	21	33553	0	33630
21438	63	24	33795	63	0	33945
21439	26	24	36	33202	0	33288
21440	24	35879	38	71	0	36012
21441	39	36	19	37526	0	37620
21442	23	27	22	37880	0	37952
21443	23	17	13	37638	0	37691
21444	37836	13	15	110	0	37974
21445	37410	17	12	115	0	37554
21446	38124	5	14	125	0	38268
21447	37994	11	17	78	0	38100
21448	113	33	37895	27	0	38068
21449	36350	17	45	53	0	36465
21450	38212	14	39	71	0	38336
21451	103	43	38008	38	0	38192
21452	86	51	40780	35	0	40952
21453	43	54	50	40315	0	40462
21454	26	41513	50	66	0	41655
21455	42629	31	14	113	0	42787
21456	43453	21	22	140	0	43636
21457	43199	13	13	201	0	43426
21458	79	14	19	42652	0	42764
21459	53	45142	27	115	0	45337
21460	47125	41	22	177	0	47365
21461	47428	28	23	149	0	47628
21462	78	19	20	46834	0	46951
21463	103	28	46352	91	0	46574
21464	45536	22	53	131	0	45742
21465	75	15	37	48756	0	48883
21466	49642	16	36	139	0	49833
21467	78	13	16	50676	0	50783
21468	97	48	50971	87	0	51203
21469	53522	19	53	292	0	53886
21470	84	25	33	56325	0	56467
21471	55	30	28	56533	0	56646
21472	39	19	18	56666	0	56742
21473	29	20	18	56638	0	56705
21474	57119	17	12	145	0	57293
21475	65	24	13	56797	0	56899
21476	44	57006	45	138	0	57233
21477	38	111	19	57970	0	58138
21478	38	58220	27	173	0	58458
21479	48	115	20	59154	0	59337
21480	52	53	21	59578	0	59704
21481	31	59342	42	228	0	59643
21482	44	114	21	60195	0	60374
21483	41	53	20	60013	0	60127
21484	59174	21	16	229	0	59440
21485	214	70	60699	104	0	61087
21486	73	31	145	61017	0	61266
21487	61674	20	56	229	0	61979
21488	60854	29	34	119	0	61036
21489	61211	39	28	110	0	61388
21490	323	56	61743	67	0	62189
21491	181	74	61737	68	0	62060
21492	86	70	247	62605	0	63008
21493	64850	25	96	275	0	65246
21494	279	79	64128	107	0	64593
21495	61004	32	228	120	0	61384
21496	214	65462	90	129	0	65895
21497	125	199	33	68844	0	69201
21498	77	103	22	70317	0	70519
21499	70796	46	41	378	0	71261
21500	229	64	20	71471	0	71784
21501	68530	38	31	360	0	68959
21502	69654	28	21	266	0	69969
21503	290	29	22	69158	0	69499
21504	122	32	31	69691	0	69876
21505	69390	33	41	413	0	69877
21506	356	82	72974	130	0	73542
21507	70718	42	240	282	0	71282
21508	355	92	77059	74	0	77580
21509	76813	33	241	272	0	77359
21510	83228	27	106	368	0	83729
21511	82752	33	70	148	0	83003
21512	81259	35	59	128	0	81481
21513	332	81503	69	193	0	82097
21514	83920	249	37	213	0	84419
21515	83921	110	53	159	0	84243
21516	352	87698	73	184	0	88307
21517	88618	250	51	242	0	89161
21518	441	158	87206	88	0	87893
21519	85215	52	284	177	0	85728
21520	455	132	88385	112	0	89084
21521	179	43	316	88167	0	88705
21522	163	30	113	90292	0	90598
21523	227	103	90517	428	0	91275
21524	139	46	323	89245	0	89753
21525	165	155	199	80069	0	80588
21526	93903	40	73	572	0	94588
21527	417	55	86	94461	0	95019
21528	232	45	71	94917	0	95265
21529	162	47	79	95152	0	95440
21530	138	93517	97	661	0	94413
21531	168	388	48	94098	0	94702
21532	93275	152	56	554	0	94037
21533	599	139	94919	260	0	95917
21534	273	77	486	96075	0	96911
21535	265	109	96602	637	0	97613
21536	92215	70	547	326	0	93158
21537	689	68	218	102162	0	103137
21538	404	143	131313	945	0	132805
21539	219	59	2215	131577	0	134070
21540	258	77	1174	131421	0	132930
21541	185	132242	608	3505	0	136540
21542	191	2210	286	136890	0	139577
21543	202	1129	173	146253	0	147757
21544	344	618	143740	4143	0	148845
21545	248	261	2711	143075	0	146295
21546	227	141	1288	146731	0	148387
21547	142354	98	639	4248	0	147339
21548	140913	97	347	2068	0	143425
21549	3827	142454	233	1259	0	147773
21550	144579	2688	210	666	0	148143
21551	144279	1279	231	569	0	146358
21552	4139	152368	262	663	0	157432
21553	2032	2922	162	151926	0	157042
21554	153537	1356	196	3116	0	158205
21555	153989	659	202	1711	0	156561
21556	151594	340	204	1034	0	153172
21557	4592	148574	307	846	0	154319
21558	2484	2853	151193	570	0	157100
21559	152521	1311	2924	642	0	157398
21560	155627	777	1350	606	0	158360
21561	4638	156352	747	805	0	162542
21562	157806	3417	393	631	0	162247
21563	160371	1507	298	671	0	162847
21564	5223	827	303	157354	0	163707
21565	2659	626	157840	3795	0	164920
21566	1439	342	3421	160194	0	165396
21567	1096	312	1575	162532	0	165515
21568	980	372	817	164302	0	166471
21569	940	450	155660	5683	0	162733
21570	874	390	3556	154261	0	159081
21571	854	303	1668	159639	0	162464
21572	812	344	839	160804	0	162799
21573	830	355	582	161389	0	163156
21574	849	349	411	160520	0	162129
21575	788	157212	425	6781	0	165206
21576	769	3541	388	160938	0	165636
21577	677	1612	495	166915	0	169699
21578	806	941	160913	6077	0	168737
21579	817	525	3828	174117	0	179287
21580	814	402	1691	177893	0	180800
21581	820	434	971	183952	0	186177
21582	847	445	739	188055	0	190086
21583	179465	404	632	8167	0	188668
21584	5383	478	457	184674	0	190992
21585	2675	618	389	187977	0	191659
21586	1886	767	177600	7741	0	187994
21587	1280	172902	4602	4515	0	183299
21588	945	182755	2339	3085	0	189124
21589	176314	5933	1579	2354	0	186180
21590	4747	180474	1058	2548	0	188827
21591	2472	5413	671	178603	0	187159
21592	176863	2427	590	6646	0	186526
21593	5625	1513	177060	4055	0	188253
21594	2780	1064	4954	176200	0	184998
21595	1811	179068	2476	6905	0	190260
21596	1386	5081	1358	175097	0	182922
21597	975	179423	956	7392	0	188746
21598	1183	5735	727	180386	0	188031
21599	176401	2791	639	7442	0	187273
21600	6147	1763	178911	4452	0	191273
21601	3199	1277	5316	170741	0	180533
21602	2045	177618	2693	7156	0	189512
21603	176799	5457	1679	4217	0	188152
21604	6340	2655	175140	3498	0	187633
21605	3256	1709	5382	173763	0	184110
21606	2365	1326	169962	7428	0	181081
21607	2074	949	6056	170033	0	179112
21608	1812	1078	166181	8027	0	177098
21609	1431	1051	6394	161500	0	170376
21610	1250	1066	3215	166266	0	171797
21611	159043	1133	1852	9177	0	171205
21612	163584	1123	1247	5040	0	170994
21613	7998	1333	1073	156658	0	167062
21614	4041	157388	1090	7466	0	169985
21615	2628	5810	885	158284	0	167607
21616	1890	2762	999	160259	0	165910
21617	150386	1677	1259	9573	0	162895
21618	5736	152337	1174	6132	0	165379
21619	152324	5859	1022	4228	0	163433
21620	152529	3162	963	3635	0	160289
21621	7681	146862	1091	3739	0	159373
21622	3764	155141	1005	3857	0	163767
21623	149842	7135	1099	3871	0	161947
21624	6638	3379	146678	4093	0	160788
21625	147036	2035	5769	4068	0	158908
21626	149113	1690	2900	3830	0	157533
21627	8375	144264	1891	3804	0	158334
21628	4752	5926	1533	126393	0	138604
21629	2589	144589	1608	7810	0	156596
21630	143493	6681	1749	5102	0	157025
21631	147132	3591	1757	4124	0	156604
21632	8283	2561	1446	141233	0	153523
21633	4359	2309	1328	146503	0	154499
21634	135065	1901	1082	9964	0	148012
21635	6695	136505	1178	6398	0	150776
21636	4058	135807	1162	5017	0	146044
21637	2921	133831	1468	3905	0	142125
21638	1498	98241	1039	2845	0	103623
21639	1351	100598	984	2920	0	105853
21640	1952	5934	1297	95629	0	104812
21641	1635	2704	92222	5257	0	101818
21642	1678	92646	3397	3119	0	100840
21643	83613	3995	1551	2200	0	91359
21644	4153	2144	1126	83168	0	90591
21645	82620	1685	1046	4293	0	89644
21646	4043	82558	1077	2752	0	90430
21647	82250	3743	1194	2061	0	89248
21648	4173	82647	1357	1990	0	90167
21649	2560	3821	1308	82952	0	90641
21650	82879	1954	1177	4379	0	90389
21651	85049	1473	1261	2745	0	90528
21652	4565	1362	1121	83739	0	90787
21653	2521	1365	1097	84212	0	89195
21654	2092	81691	905	5268	0	89956
21655	2088	3587	747	82962	0	89384
21656	2213	1987	659	84277	0	89136
21657	2220	1862	563	82672	0	87317
21658	1800	77944	700	5487	0	85931
21659	71466	3228	558	2895	0	78147
21660	3365	73281	622	2343	0	79611
21661	70487	3401	573	1905	0	76366
21662	3696	71078	595	1717	0	77086
21663	2634	3393	67761	1524	0	75312
21664	2117	2115	2488	67822	0	74542
21665	1975	1643	66439	3076	0	73133
21666	1784	1524	66449	1697	0	71454
21667	1761	1576	3167	64317	0	70821
21668	1879	1232	64869	3086	0	71066
21669	1863	1213	2855	63183	0	69114
21670	2031	1127	1378	64784	0	69320
21671	1928	1179	880	66193	0	70180
21672	63921	1302	682	4023	0	69928
21673	3546	1245	500	64040	0	69331
21674	2493	1222	431	64414	0	68560
21675	59425	1031	321	3983	0	64760
21676	3420	58330	383	2524	0	64657
21677	2068	55100	251	1848	0	59267
21678	1776	55305	298	1554	0	58933
21679	1156	3971	272	40547	0	45946
21680	894	1017	40645	1858	0	44414
21681	32582	983	1306	950	0	35821
21682	1314	34239	467	579	0	36599
21683	31811	1198	301	450	0	33760
21684	32172	650	180	314	0	33316
21685	32289	548	157	291	0	33285
21686	1439	546	31420	339	0	33744
21687	797	549	795	31324	0	33465
21688	663	493	372	32375	0	33903
21689	685	395	252	32657	0	33989
21690	665	329	215	31434	0	32643
21691	591	31293	208	1340	0	33432
21692	30235	886	201	741	0	32063
21693	942	506	28223	459	0	30130
21694	26271	300	595	385	0	27551
21695	940	532	223	24868	0	26563
21696	518	24756	114	839	0	26227
21697	381	25692	85	553	0	26711
21698	444	1600	134	22658	0	24836
21699	275	23637	131	695	0	24738
21700	20079	411	103	262	0	20855
21701	379	188	19362	160	0	20089
21702	155	170	278	18465	0	19068
21703	99	109	142	19071	0	19421
21704	108	103	64	19405	0	19680
21705	102	100	74	19402	0	19678
21706	19073	96	67	378	0	19614
21707	292	19970	68	212	0	20542
21708	22107	299	72	161	0	22639
21709	424	141	57	22479	0	23101
21710	189	109	56	22787	0	23141
21711	121	24092	58	577	0	24848
21712	24612	421	63	294	0	25390
21713	24779	177	61	188	0	25205
21714	625	25042	66	182	0	25915
21715	248	495	42	22172	0	22957
21716	121	24002	47	482	0	24652
21717	23603	515	64	208	0	24390
21718	563	196	23674	126	0	24559
21719	232	111	23214	116	0	23673
21720	21052	80	562	109	0	21803
21721	425	22661	191	142	0	23419
21722	165	471	92	22479	0	23207
21723	112	188	55	23014	0	23369
21724	118	103	22601	629	0	23451
21725	68	77	457	22468	0	23070
21726	86	60	164	22775	0	23085
21727	72	22291	84	624	0	23071
21728	75	489	58	22301	0	22923
21729	74	164	46	22641	0	22925
21730	21637	107	58	638	0	22440
21731	451	21400	78	275	0	22204
21732	185	21807	56	196	0	22244
21733	109	551	60	21667	0	22387
21734	71	212	45	22106	0	22434
21735	81	106	46	21952	0	22185
21736	72	21364	42	660	0	22138
21737	94	446	27	21960	0	22527
21738	88	197	33	21965	0	22283
21739	87	115	31	22159	0	22392
21740	110	84	45	21682	0	21921
21741	102	20606	57	686	0	21451
21742	87	22396	49	302	0	22834
21743	21783	610	53	177	0	22623
21744	22069	233	48	163	0	22513
21745	662	151	38	21967	0	22818
21746	290	109	22083	598	0	23080
21747	145	105	510	22256	0	23016
21748	114	144	169	22257	0	22684
21749	21305	135	91	719	0	22250
21750	582	21960	75	325	0	22942
21751	265	541	61	21983	0	22850
21752	186	226	59	22431	0	22902
21753	153	182	21740	735	0	22810
21754	173	144	21799	345	0	22461
21755	121	124	621	21460	0	22326
21756	128	140	256	20634	0	21158
21757	114	20999	151	740	0	22004
21758	104	21683	97	384	0	22268
21759	21213	670	79	249	0	22211
21760	592	269	94	21612	0	22567
21761	234	176	21359	646	0	22415
21762	145	21271	486	367	0	22269
21763	102	532	187	21646	0	22467
21764	21354	251	114	678	0	22397
21765	518	200	60	21697	0	22475
21766	21132	145	60	718	0	22055
21767	544	21596	67	432	0	22639
21768	20942	576	52	300	0	21870
21769	598	287	41	21490	0	22416
21770	266	231	22605	682	0	23784
21771	169	179	553	21781	0	22682
21772	135	23277	201	744	0	24357
21773	143	719	125	22671	0	23658
21774	117	24081	74	835	0	25107
21775	140	755	87	25078	0	26060
21776	159	286	24249	972	0	25666
21777	164	222	24182	530	0	25098
21778	149	179	24371	452	0	25151
21779	23184	188	846	385	0	24603
21780	678	23835	321	355	0	25189
21781	294	24866	163	357	0	25680
21782	23978	831	119	324	0	25252
21783	24162	378	128	319	0	24987
21784	839	283	127	23758	0	25007
21785	367	180	23756	943	0	25246
21786	300	186	23147	452	0	24085
21787	187	167	842	22858	0	24054
21788	22717	187	347	897	0	24148
21789	691	22920	183	514	0	24308
21790	260	742	122	23171	0	24295
21791	22842	320	157	955	0	24274
21792	23166	187	151	558	0	24062
21793	830	155	22902	490	0	24377
21794	21567	193	721	406	0	22887
21795	795	234	23067	343	0	24439
21796	348	211	23639	376	0	24574
21797	283	197	805	22403	0	23688
21798	206	193	345	23176	0	23920
21799	171	202	242	23698	0	24313
21800	205	253	22769	1094	0	24321
21801	22215	202	697	597	0	23711
21802	779	194	277	23582	0	24832
21803	22883	193	226	1006	0	24308
21804	22811	214	155	523	0	23703
21805	881	23119	187	513	0	24700
21806	399	24003	243	367	0	25012
21807	252	23538	220	391	0	24401
21808	212	809	178	20509	0	21708
21809	183	283	20413	664	0	21543
21810	194	918	587	17927	0	19626
21811	151	18826	234	551	0	19762
21812	153	18675	165	238	0	19231
21813	140	553	104	17839	0	18636
21814	17519	178	116	503	0	18316
21815	466	17358	133	221	0	18178
21816	185	17756	128	168	0	18237
21817	17864	485	87	197	0	18633
21818	468	174	99	17952	0	18693
21819	194	127	110	18085	0	18516
21820	179	92	91	18482	0	18844
21821	17762	68	99	595	0	18524
21822	18032	74	96	249	0	18451
21823	574	70	147	17886	0	18677
21824	261	78	17420	512	0	18271
21825	17084	73	492	229	0	17878
21826	491	76	193	17756	0	18516
21827	222	87	17451	549	0	18309
21828	171	94	17544	247	0	18056
21829	136	79	561	17781	0	18557
21830	159	76	18914	577	0	19726
21831	148	88	524	20204	0	20964
21832	138	118	186	20709	0	21151
21833	158	114	163	21637	0	22072
21834	21048	137	142	757	0	22084
21835	596	154	112	21307	0	22169
21836	244	140	126	21723	0	22233
21837	200	161	123	21787	0	22271
21838	129	170	127	21895	0	22321
21839	138	180	20782	823	0	21923
21840	142	20789	569	402	0	21902
21841	129	562	204	20400	0	21295
21842	153	244	173	19560	0	20130
21843	137	19474	166	653	0	20430
21844	128	20559	134	340	0	21161
21845	20078	624	115	228	0	21045
21846	542	19669	133	202	0	20546
21847	254	532	97	19465	0	20348
21848	253	185	19568	606	0	20612
21849	18573	155	499	287	0	19514
21850	595	108	18988	267	0	19958
21851	18501	62	548	253	0	19364
21852	19070	71	224	235	0	19600
21853	663	64	19040	268	0	20035
21854	310	64	552	17827	0	18753
21855	235	18807	231	645	0	19918
21856	159	461	198	19579	0	20397
21857	19940	134	173	717	0	20964
21858	20257	101	176	326	0	20860
21859	641	20015	176	339	0	21171
21860	20107	483	157	303	0	21050
21861	609	152	143	19686	0	20590
21862	19586	106	155	743	0	20590
21863	20120	97	133	415	0	20765
21864	671	116	102	19986	0	20875
21865	19935	119	99	787	0	20940
21866	19867	85	107	455	0	20514
21867	639	124	19544	322	0	20629
21868	18997	152	485	324	0	19958
21869	611	152	19293	255	0	20311
21870	198	129	17811	229	0	18367
21871	133	18409	523	250	0	19315
21872	120	412	194	17423	0	18149
21873	122	180	18124	415	0	18841
21874	97	116	17601	182	0	17996
21875	17612	91	370	186	0	18259
21876	343	79	130	17997	0	18549
21877	143	77	99	18787	0	19106
21878	101	79	72	19096	0	19348
21879	97	88	51	19066	0	19302
21880	92	95	48	19273	0	19508
21881	136	88	18727	492	0	19443
21882	157	73	18686	217	0	19133
21883	124	70	402	18841	0	19437
21884	18730	61	139	410	0	19340
21885	368	18584	103	223	0	19278
21886	192	319	80	18625	0	19216
21887	18667	84	70	433	0	19254
21888	393	18741	89	239	0	19462
21889	215	320	81	18856	0	19472
21890	164	105	96	19208	0	19573
21891	147	56	92	19265	0	19560
21892	18902	54	96	513	0	19565
21893	399	50	18572	271	0	19292
21894	18200	45	368	210	0	18823
21895	413	57	146	18848	0	19464
21896	186	41	111	18134	0	18472
21897	123	18382	131	512	0	19148
21898	134	319	18498	232	0	19183
21899	17519	110	355	254	0	18238
21900	18540	58	160	230	0	18988
21901	442	88	18371	214	0	19115
21902	16991	54	352	225	0	17622
21903	391	18376	164	214	0	19145
21904	176	18695	117	181	0	19169
21905	123	18499	106	169	0	18897
21906	17656	384	103	146	0	18289
21907	367	148	17785	155	0	18455
21908	194	163	300	16687	0	17344
21909	81	16810	135	326	0	17352
21910	88	17078	75	178	0	17419
21911	87	16988	95	125	0	17295
21912	201	385	64	14475	0	15125
21913	16194	107	56	305	0	16662
21914	277	16385	57	182	0	16901
21915	142	235	47	16478	0	16902
21916	105	84	43	16762	0	16994
21917	16128	48	79	349	0	16604
21918	310	49	58	16166	0	16583
21919	133	38	56	16600	0	16827
21920	122	48	16526	359	0	17055
21921	107	61	250	16462	0	16880
21922	111	47	120	17090	0	17368
21923	16841	41	61	341	0	17284
21924	16747	51	54	157	0	17009
21925	358	52	52	16875	0	17337
21926	16478	55	56	325	0	16914
21927	16373	105	47	160	0	16685
21928	305	16815	77	121	0	17318
21929	160	236	16296	79	0	16771
21930	118	15454	251	95	0	15918
21931	146	359	139	13908	0	14552
21932	13568	72	97	186	0	13923
21933	130	13466	33	139	0	13768
21934	70	125	27	13468	0	13690
21935	13381	51	25	154	0	13611
21936	13231	33	34	88	0	13386
21937	154	25	35	13242	0	13456
21938	70	29	14103	176	0	14378
21939	39	23	116	14303	0	14481
21940	43	30	54	14785	0	14912
21941	49	46	14687	204	0	14986
21942	34	27	119	14477	0	14657
21943	38	21	54	14850	0	14963
21944	15263	26	24	213	0	15526
21945	141	31	19	15409	0	15600
21946	70	19	26	15522	0	15637
21947	15278	30	19	199	0	15526
21948	14786	20	21	102	0	14929
21949	14891	27	29	58	0	15005
21950	206	40	14787	53	0	15086
21951	67	34	128	14379	0	14608
21952	39	15001	57	179	0	15276
21953	61	160	19	15343	0	15583
21954	70	60	15772	148	0	16050
21955	74	68	123	14757	0	15022
21956	55	37	15526	148	0	15766
21957	14293	19	135	66	0	14513
21958	14957	16	72	37	0	15082
21959	146	11	19	15458	0	15634
21960	53	12	14	15660	0	15739
21961	36	17	13	15642	0	15708
21962	26	16282	17	153	0	16478
21963	16193	91	16	92	0	16392
21964	16498	48	15	69	0	16630
21965	139	21	8	16322	0	16490
21966	66	17	8	16385	0	16476
21967	40	12	12	16516	0	16580
21968	29	16	15	16483	0	16543
21969	35	20	16217	155	0	16427
21970	39	24	96	16132	0	16291
21971	15638	13	49	133	0	15833
21972	15375	16	23	72	0	15486
21973	130	20	19	14861	0	15030
21974	67	27	14452	119	0	14665
21975	13511	14	93	79	0	13697
21976	114	38	44	14282	0	14478
21977	54	14085	29	128	0	14296
21978	25	14727	18	65	0	14835
21979	15011	102	24	104	0	15241
21980	111	32	9	15464	0	15616
21981	47	20	7	15724	0	15798
21982	32	9	10	16283	0	16334
21983	22	11	9	16490	0	16532
21984	21	7	14	17135	0	17177
21985	33	15	16986	221	0	17255
21986	35	21	16640	86	0	16782
21987	35	14	16733	47	0	16829
21988	22	8	192	16437	0	16659
21989	48	18	17195	190	0	17451
21990	26	4	175	17044	0	17249
21991	37	8	56	17239	0	17340
21992	25	10	33	17849	0	17917
21993	17845	10	23	266	0	18144
21994	184	15	23	18098	0	18320
21995	87	31	17	18455	0	18590
21996	18232	7	30	257	0	18526
21997	187	18727	32	118	0	19064
21998	69	19460	25	84	0	19638
21999	19516	256	17	75	0	19864
22000	220	20233	17	62	0	20532
22001	20208	223	26	76	0	20533
22002	20314	70	32	63	0	20479
22003	20374	30	16	65	0	20485
22004	20308	11	11	56	0	20386
22005	20275	17	21	40	0	20353
22006	285	20147	31	69	0	20532
22007	20139	220	19	53	0	20431
22008	20278	68	23	51	0	20420
22009	294	20811	33	57	0	21195
22010	23436	226	17	70	0	23749
22011	24076	82	19	41	0	24218
22012	26690	36	8	48	0	26782
22013	27715	30	21	55	0	27821
22014	731	31	29772	43	0	30577
22015	241	36	589	31144	0	32010
22016	118	30	161	32517	0	32826
22017	103	44	32150	824	0	33121
22018	103	48	31543	255	0	31949
22019	31133	31	853	105	0	32122
22020	720	29	233	32184	0	33166
22021	259	44	32685	686	0	33674
22022	171	49	32475	215	0	32910
22023	31685	34	870	108	0	32697
22024	33019	39	245	78	0	33381
22025	33047	24	101	59	0	33231
22026	989	36	32508	85	0	33618
22027	331	20	689	32125	0	33165
22028	208	37	33026	716	0	33987
22029	31873	29	774	232	0	32908
22030	825	69	33771	130	0	34795
22031	286	29	804	32651	0	33770
22032	222	39	224	31892	0	32377
22033	109	34024	152	817	0	35102
22034	34476	711	92	271	0	35550
22035	849	192	34338	124	0	35503
22036	33684	86	793	95	0	34658
22037	935	56	35623	95	0	36709
22038	330	35	871	33864	0	35100
22039	216	28	285	34956	0	35485
22040	197	34	183	35192	0	35606
22041	34461	25	138	1026	0	35650
22042	926	39	118	34158	0	35241
22043	376	26	147	34386	0	34935
22044	236	33638	166	1007	0	35047
22045	185	712	186	34114	0	35197
22046	33102	185	184	925	0	34396
22047	959	92	33739	326	0	35116
22048	425	47	853	33266	0	34591
22049	321	54	33874	909	0	35158
22050	260	32705	958	446	0	34369
22051	288	738	33735	278	0	35039
22052	32814	233	1002	257	0	34306
22053	34170	94	422	223	0	34909
22054	1067	65	368	33164	0	34664
22055	33727	48	292	970	0	35037
22056	34108	50	315	426	0	34899
22057	1133	56	283	33637	0	35109
22058	545	57	319	34564	0	35485
22059	395	59	34118	1122	0	35694
22060	382	33578	974	468	0	35402
22061	33490	785	416	296	0	34987
22062	1041	33078	299	294	0	34712
22063	511	840	294	32886	0	34531
22064	440	249	270	33438	0	34397
22065	379	128	297	33512	0	34316
22066	339	81	322	33632	0	34374
22067	303	111	32551	1238	0	34203
22068	30852	99	1031	582	0	32564
22069	33069	114	426	447	0	34056
22070	1175	108	319	32460	0	34062
22071	32681	108	281	1080	0	34150
22072	1110	117	277	32825	0	34329
22073	568	125	32751	1115	0	34559
22074	407	117	985	31816	0	33325
22075	394	32185	450	1112	0	34141
22076	370	755	359	31402	0	32886
22077	338	32277	273	1119	0	34007
22078	358	842	270	30279	0	31749
22079	302	31550	256	1130	0	33238
22080	30508	847	265	605	0	32225
22081	1015	311	30853	526	0	32705
22082	468	29644	930	484	0	31526
22083	380	30650	387	462	0	31879
22084	400	956	425	29305	0	31086
22085	339	292	300	29974	0	30905
22086	332	198	330	29987	0	30847
22087	346	142	303	30042	0	30833
22088	359	29135	326	1176	0	30996
22089	335	744	280	29030	0	30389
22090	353	253	281	29464	0	30351
22091	28435	181	271	1153	0	30040
22092	1040	143	203	29097	0	30483
22093	502	122	28712	1124	0	30460
22094	434	145	27969	585	0	29133
22095	26041	131	878	577	0	27627
22096	810	27813	376	529	0	29528
22097	396	28370	219	455	0	29440
22098	387	878	273	26975	0	28513
22099	254	356	168	27662	0	28440
22100	256	239	26366	1033	0	27894
22101	24431	216	719	577	0	25943
22102	26237	177	263	507	0	27184
22103	899	167	27508	491	0	29065
22104	390	130	27294	455	0	28269
22105	26783	137	845	459	0	28224
22106	28438	121	315	428	0	29302
22107	28484	140	202	410	0	29236
22108	28274	130	177	390	0	28971
22109	959	26789	155	414	0	28317
22110	24428	553	147	297	0	25425
22111	675	158	23218	332	0	24383
22112	213	108	20791	197	0	21309
22113	175	92	21275	212	0	21754
22114	302	1397	568	16096	0	18363
22115	16443	31	152	164	0	16790
22116	16395	27	22	80	0	16524
22117	130	25	34	16334	0	16523
22118	51	25	26	16224	0	16326
22119	44	31	20	16449	0	16544
22120	42	17488	29	166	0	17725
22121	17986	123	21	133	0	18263
22122	18014	35	17	102	0	18168
22123	18208	28	16	74	0	18326
22124	18252	17	28	66	0	18363
22125	18265	16	30	78	0	18389
22126	154	17	29	17917	0	18117
22127	66	17849	25	160	0	18100
22128	79	111	16	17477	0	17683
22129	53	69	14	17216	0	17352
22130	16764	27	26	131	0	16948
22131	114	21	16503	66	0	16704
22132	44	32	15790	35	0	15901
22133	31	36	15810	33	0	15910
22134	16335	9	96	66	0	16506
22135	17101	21	167	43	0	17332
22136	92	20	21	17586	0	17719
22137	26	15	13	17145	0	17199
22138	27	14	11	17541	0	17593
22139	38	18	17494	104	0	17654
22140	23	15	79	16960	0	17077
22141	37	32	18265	103	0	18437
22142	24	12	83	18121	0	18240
22143	23	12	35	18337	0	18407
22144	20	11	20	18760	0	18811
22145	18730	31	14	120	0	18895
22146	18639	11	18	72	0	18740
22147	130	21	18714	41	0	18906
22148	18287	10	77	44	0	18418
22149	18724	12	33	37	0	18806
22150	117	9	27	18830	0	18983
22151	19098	7	29	128	0	19262
22152	103	10	29	19368	0	19510
22153	52	30	19	19494	0	19595
22154	55	17	19192	149	0	19413
22155	17336	10	115	89	0	17550
22156	117	9	34	19002	0	19162
22157	63	16	19211	123	0	19413
22158	59	19	19759	76	0	19913
22159	37	4	116	19226	0	19383
22160	22	12	42	19680	0	19756
22161	19850	3	25	155	0	20033
22162	109	6	16	20025	0	20156
22163	43	6	23	20189	0	20261
22164	58	8	18	20375	0	20459
22165	43	5	26	21796	0	21870
22166	22557	6	30	266	0	22859
22167	22552	11	30	110	0	22703
22168	23201	6	20	81	0	23308
22169	23519	7	31	83	0	23640
22170	324	9	24	24583	0	24940
22171	25070	7	25	295	0	25397
22172	307	6	20	25064	0	25397
22173	25214	7	36	330	0	25587
22174	343	5	30	25103	0	25481
22175	157	8	30	24613	0	24808
22176	91	24985	37	384	0	25497
22177	56	275	25	25053	0	25409
22178	24712	91	18	361	0	25182
22179	24025	45	25	180	0	24275
22180	424	29	24767	111	0	25331
22181	162	24974	295	111	0	25542
22182	24910	264	113	89	0	25376
22183	315	25566	67	81	0	26029
22184	25241	300	54	89	0	25684
22185	335	26468	47	110	0	26960
22186	186	304	26514	87	0	27091
22187	110	27057	308	97	0	27572
22188	72	27486	132	108	0	27798
22189	76	402	55	27745	0	28278
22190	28010	127	27	421	0	28585
22191	347	41	26	28148	0	28562
22192	178	37	22	28075	0	28312
22193	27621	19	31	528	0	28199
22194	28090	27	30	280	0	28427
22195	472	31	29	28205	0	28737
22196	221	22	43	28385	0	28671
22197	150	25	30	28449	0	28654
22198	27663	20	50	513	0	28246
22199	414	44	27824	226	0	28508
22200	220	58	318	27638	0	28234
22201	149	53	28585	439	0	29226
22202	88	27991	367	298	0	28744
22203	174	338	27002	129	0	27643
22204	95	146	367	26658	0	27266
22205	145	70	26916	438	0	27569
22206	25521	70	367	230	0	26188
22207	403	64	140	26684	0	27291
22208	209	27378	91	501	0	28179
22209	183	348	56	27323	0	27910
22210	157	27347	73	432	0	28009
22211	155	27532	58	259	0	28004
22212	141	27511	69	185	0	27906
22213	157	461	40	24989	0	25647
22214	122	26014	59	434	0	26629
22215	25738	375	49	246	0	26408
22216	441	156	24972	190	0	25759
22217	249	119	24805	177	0	25350
22218	183	100	25485	173	0	25941
22219	161	71	443	25645	0	26320
22220	163	66	175	24648	0	25052
22221	212	79	103	24353	0	24747
22222	214	100	82	24445	0	24841
22223	221	76	169	23782	0	24248
22224	235	24389	85	571	0	25280
22225	226	376	24006	307	0	24915
22226	234	207	23955	243	0	24639
22227	188	24659	443	264	0	25554
22228	214	385	180	24876	0	25655
22229	180	208	114	25201	0	25703
22230	177	154	90	25405	0	25826
22231	24936	136	101	612	0	25785
22232	490	129	24475	394	0	25488
22233	23654	118	345	275	0	24392
22234	24101	128	175	260	0	24664
22235	564	23573	137	249	0	24523
22236	307	23981	104	215	0	24607
22237	24158	471	138	204	0	24971
22238	464	264	94	24137	0	24959
22239	280	156	88	25347	0	25871
22240	239	183	26085	587	0	27094
22241	202	172	25821	338	0	26533
22242	160	168	541	26485	0	27354
22243	26725	195	241	528	0	27689
22244	528	186	28069	318	0	29101
22245	28508	170	524	264	0	29466
22246	576	178	230	29655	0	30639
22247	297	154	130	31108	0	31689
22248	208	135	128	32452	0	32923
22249	224	143	31952	861	0	33180
22250	167	31375	557	465	0	32564
22251	158	32973	240	327	0	33698
22252	32534	674	124	267	0	33599
22253	33106	257	120	251	0	33734
22254	759	136	118	33310	0	34323
22255	33500	98	140	768	0	34506
22256	728	99	32800	354	0	33981
22257	301	110	32568	283	0	33262
22258	152	86	783	31752	0	32773
22259	32757	110	330	792	0	33989
22260	654	83	205	33293	0	34235
22261	249	93	188	34320	0	34850
22262	33576	91	167	924	0	34758
22263	33934	120	163	387	0	34604
22264	815	35602	157	301	0	36875
22265	34557	641	147	223	0	35568
22266	685	233	127	33188	0	34233
22267	205	34087	113	708	0	35113
22268	33687	617	114	217	0	34635
22269	622	34246	150	207	0	35225
22270	221	590	70	33555	0	34436
22271	33239	127	82	604	0	34052
22272	623	86	32980	160	0	33849
22273	180	77	32967	111	0	33335
22274	163	94	613	31917	0	32787
22275	103	45	135	33365	0	33648
22276	93	52	79	32336	0	32560
22277	90	34476	71	595	0	35232
22278	35488	550	79	222	0	36339
22279	35628	146	61	164	0	35999
22280	35554	79	38	163	0	35834
22281	736	37920	60	159	0	38875
22282	229	644	69	41510	0	42452
22283	151	158	73	42100	0	42482
22284	143	118	67	42497	0	42825
22285	39774	82	66	992	0	40914
22286	748	40342	73	308	0	41471
22287	252	742	54	40576	0	41624
22288	170	179	58	41177	0	41584
22289	175	124	39637	953	0	40889
22290	156	39681	743	334	0	40914
22291	156	755	190	39747	0	40848
22292	160	169	96	40266	0	40691
22293	168	111	71	40427	0	40777
22294	38934	78	85	1017	0	40114
22295	814	39001	92	406	0	40313
22296	39315	793	65	276	0	40449
22297	909	207	77	39053	0	40246
22298	39360	137	93	928	0	40518
22299	927	175	38636	355	0	40093
22300	38353	106	762	331	0	39552
22301	39774	110	211	299	0	40394
22302	1026	150	39673	231	0	41080
22303	336	165	738	39607	0	40846
22304	251	139	190	40806	0	41386
22305	41113	141	147	1152	0	42553
22306	914	131	147	41686	0	42878
22307	361	132	125	42122	0	42740
22308	274	141	122	42162	0	42699
22309	274	145	40800	1148	0	42367
22310	36685	136	828	503	0	38152
22311	968	41937	257	354	0	43516
22312	389	882	146	40884	0	42301
22313	325	41704	125	1046	0	43200
22314	305	43673	158	457	0	44593
22315	290	1051	145	43507	0	44993
22316	329	332	43447	1177	0	45285
22317	353	224	43722	512	0	44811
22318	320	170	1040	44008	0	45538
22319	341	197	44215	1192	0	45945
22320	42636	188	917	555	0	44296
22321	1106	186	293	45509	0	47094
22322	430	181	179	46166	0	46956
22323	308	46352	153	1402	0	48215
22324	291	986	155	46630	0	48062
22325	280	326	170	46237	0	47013
22326	247	45692	196	1350	0	47485
22327	318	957	154	46623	0	48052
22328	298	325	154	46350	0	47127
22329	284	45994	195	1347	0	47820
22330	45768	977	176	607	0	47528
22331	1151	332	45789	480	0	47752
22332	502	251	45319	424	0	46496
22333	393	324	1062	44854	0	46633
22334	310	215	330	46390	0	47245
22335	324	243	45564	1369	0	47500
22336	318	250	44674	656	0	45898
22337	39365	211	1084	577	0	41237
22338	997	44486	373	550	0	46406
22339	43490	942	222	482	0	45136
22340	1089	275	43109	522	0	44995
22341	342	42865	970	547	0	44724
22342	307	1106	370	43776	0	45559
22343	299	353	45150	1197	0	46999
22344	226	224	43984	568	0	45002
22345	267	299	1042	45182	0	46790
22346	279	200	45999	1304	0	47782
22347	222	45024	1085	623	0	46954
22348	220	1019	343	44493	0	46075
22349	396	332	44781	1178	0	46687
22350	209	45259	1027	581	0	47076
22351	44978	1028	349	449	0	46804
22352	1102	355	44677	363	0	46497
22353	369	45182	1027	396	0	46974
22354	284	986	415	44665	0	46350
22355	213	368	266	46664	0	47511
22356	46013	227	258	1346	0	47844
22357	1065	156	231	45820	0	47272
22358	400	128	238	46300	0	47066
22359	44771	179	266	1371	0	46587
22360	997	182	199	44423	0	45801
22361	427	129	43739	1222	0	45517
22362	261	195	981	43345	0	44782
22363	237	156	43770	1236	0	45399
22364	201	152	41705	560	0	42618
22365	234	177	43212	340	0	43963
22366	249	187	1131	40306	0	41873
22367	153	134	412	42887	0	43586
22368	42403	160	242	1119	0	43924
22369	849	139	218	40803	0	42009
22370	313	43990	213	1047	0	45563
22371	192	860	236	45152	0	46440
22372	188	292	227	44165	0	44872
22373	121	44902	280	1184	0	46487
22374	44306	812	251	558	0	45927
22375	43317	306	203	429	0	44255
22376	935	44005	258	434	0	45632
22377	293	43999	252	326	0	44870
22378	260	1474	238	41983	0	43955
22379	42190	347	334	959	0	43830
22380	812	264	41912	431	0	43419
22381	372	228	38510	317	0	39427
22382	34018	133	746	204	0	35101
22383	559	36922	342	193	0	38016
22384	263	619	201	36883	0	37966
22385	148	241	191	37454	0	38034
22386	120	136	163	37977	0	38396
22387	130	103	156	37491	0	37880
22388	83	37136	172	858	0	38249
22389	126	556	124	37793	0	38599
22390	37443	237	112	787	0	38579
22391	603	166	124	37829	0	38722
22392	260	106	119	38416	0	38901
22393	38133	88	133	913	0	39267
22394	38260	123	128	421	0	38932
22395	38796	114	127	281	0	39318
22396	39079	83	143	276	0	39581
22397	821	76	150	38684	0	39731
22398	38724	96	136	715	0	39671
22399	651	76	146	38571	0	39444
22400	38250	76	156	756	0	39238
22401	38261	88	147	374	0	38870
22402	823	82	131	37874	0	38910
22403	367	96	38065	718	0	39246
22404	37429	100	605	431	0	38565
22405	38867	105	310	285	0	39567
22406	38761	109	177	273	0	39320
22407	38883	106	154	264	0	39407
22408	848	102	129	38829	0	39908
22409	366	126	38984	700	0	40176
22410	239	137	37457	387	0	38220
22411	36728	128	748	305	0	37909
22412	38888	96	333	231	0	39548
22413	735	38623	207	275	0	39840
22414	322	38586	166	212	0	39286
22415	38903	613	169	257	0	39942
22416	582	249	166	37979	0	38976
22417	336	149	131	38904	0	39520
22418	38495	107	118	821	0	39541
22419	557	38801	102	455	0	39915
22420	39545	500	84	336	0	40465
22421	655	248	38499	279	0	39681
22422	37594	110	499	289	0	38492
22423	604	116	187	38291	0	39198
22424	388	70	39035	702	0	40195
22425	208	39246	525	444	0	40423
22426	267	477	231	40443	0	41418
22427	274	205	42818	649	0	43946
22428	248	65	603	42359	0	43275
22429	43664	56	315	799	0	44834
22430	732	73	43294	418	0	44517
22431	41261	63	675	277	0	42276
22432	757	43838	299	274	0	45168
22433	400	581	196	44402	0	45579
22434	355	307	46029	699	0	47390
22435	233	159	632	45452	0	46476
22436	290	116	46766	779	0	47951
22437	216	46076	656	484	0	47432
22438	45579	591	242	273	0	46685
22439	703	47513	156	273	0	48645
22440	354	631	115	46535	0	47635
22441	265	336	121	47312	0	48034
22442	217	153	45516	829	0	46715
22443	35677	126	563	417	0	36783
22444	607	43090	266	448	0	44411
22445	210	40073	91	149	0	40523
22446	140	40411	68	160	0	40779
22447	153	631	188	38689	0	39661
22448	110	39419	81	344	0	39954
22449	152	370	79	38308	0	38909
22450	88	38619	59	345	0	39111
22451	96	358	62	37440	0	37956
22452	82	38362	53	333	0	38830
22453	37942	279	107	149	0	38477
22454	326	127	37609	103	0	38165
22455	35585	108	290	114	0	36097
22456	37485	53	107	107	0	37752
22457	38245	67	71	97	0	38480
22458	380	38200	66	104	0	38750
22459	38721	247	76	98	0	39142
22460	38579	111	67	75	0	38832
22461	39144	76	70	70	0	39360
22462	461	84	38630	57	0	39232
22463	205	67	303	38383	0	38958
22464	135	65	39890	346	0	40436
22465	116	49	340	38339	0	38844
22466	38748	50	160	388	0	39346
22467	355	38862	107	252	0	39576
22468	211	379	43743	114	0	44447
22469	115	153	530	43774	0	44572
22470	91	92	183	46942	0	47308
22471	118	101	53580	801	0	54600
22472	51643	80	1006	266	0	52995
22473	55125	75	260	139	0	55599
22474	56173	68	122	113	0	56476
22475	1351	76	79	54787	0	56293
22476	363	53962	101	1119	0	55545
22477	206	57074	90	359	0	57729
22478	148	1242	80	55773	0	57243
22479	185	335	83	54902	0	55505
22480	108	55688	94	1284	0	57174
22481	55139	1069	66	331	0	56605
22482	1087	55413	95	228	0	56823
22483	319	1133	70	54347	0	55869
22484	224	293	54208	1116	0	55841
22485	135	171	1101	53466	0	54873
22486	54150	110	289	1204	0	55753
22487	1176	118	53822	327	0	55443
22488	53599	96	1140	215	0	55050
22489	55838	98	343	175	0	56454
22490	56331	96	148	186	0	56761
22491	56166	110	123	212	0	56611
22492	57600	107	294	172	0	58173
22493	1551	125	55093	156	0	56925
22494	551	139	55303	150	0	56143
22495	58433	107	1428	160	0	60128
22496	61131	131	377	141	0	61780
22497	1755	140	167	61194	0	63256
22498	527	62670	176	1466	0	64839
22499	283	1480	142	64013	0	65918
22500	64618	494	82	1592	0	66786
22501	1649	217	102	60635	0	62603
22502	567	64466	106	1498	0	66637
22503	64467	1499	119	531	0	66616
22504	64053	490	142	274	0	64959
22505	63149	250	119	258	0	63776
22506	1944	62663	176	260	0	65043
22507	749	1481	167	62235	0	64632
22508	489	453	127	61767	0	62836
22509	388	60970	145	1850	0	63353
22510	373	1507	159	61403	0	63442
22511	60706	486	125	1677	0	62994
22512	60935	224	133	613	0	61905
22513	2029	59690	173	380	0	62272
22514	849	1507	167	59389	0	61912
22515	534	496	212	60573	0	61815
22516	509	254	219	61464	0	62446
22517	58952	213	262	2115	0	61542
22518	1865	242	58166	826	0	61099
22519	56489	227	1555	536	0	58807
22520	2026	273	57453	466	0	60218
22521	963	348	1587	53002	0	55900
22522	721	55305	529	1686	0	58241
22523	653	58602	303	780	0	60338
22524	56348	2009	214	636	0	59207
22525	56138	771	178	580	0	57667
22526	2118	54348	222	630	0	57318
22527	848	54001	225	622	0	55696
22528	53769	1916	274	470	0	56429
22529	54477	769	217	581	0	56044
22530	2124	54825	256	615	0	57820
22531	56271	1707	263	564	0	58805
22532	2079	710	54885	518	0	58192
22533	55401	449	1549	534	0	57933
22534	55214	406	553	570	0	56743
22535	2382	380	385	52900	0	56047
22536	1226	52721	327	1829	0	56103
22537	1067	1628	278	54263	0	57236
22538	54023	626	292	1894	0	56835
22539	2383	401	279	52682	0	55745
22540	1316	357	327	54190	0	56190
22541	1036	458	52957	2166	0	56617
22542	972	385	1639	53334	0	56330
22543	854	395	672	55227	0	57148
22544	54226	434	387	2265	0	57312
22545	2133	501	53577	1004	0	57215
22546	54098	514	1603	748	0	56963
22547	2226	531	513	54120	0	57390
22548	1196	517	299	55120	0	57132
22549	936	507	264	53529	0	55236
22550	945	52174	257	2245	0	55621
22551	1000	54222	285	971	0	56478
22552	1026	2019	282	52887	0	56214
22553	52917	773	299	1895	0	55884
22554	54110	514	288	848	0	55760
22555	2669	477	245	52709	0	56100
22556	52936	426	237	1957	0	55556
22557	2371	437	278	52049	0	55135
22558	1251	518	232	53446	0	55447
22559	50578	451	258	2358	0	53645
22560	2197	52298	267	1226	0	55988
22561	52177	1756	224	831	0	54988
22562	52887	754	249	887	0	54777
22563	50806	476	270	877	0	52429
22564	2364	49830	280	836	0	53310
22565	1198	1809	253	50105	0	53365
22566	1024	802	300	51448	0	53574
22567	859	487	48973	2347	0	52666
22568	858	767	1366	43859	0	46850
22569	810	368	41809	1719	0	44706
22570	677	38085	1157	860	0	40779
22571	388	30555	405	460	0	31808
22572	443	30682	190	431	0	31746
22573	721	1011	464	30150	0	32346
22574	478	392	154	30721	0	31745
22575	259	290	96	30550	0	31195
22576	271	235	81	30830	0	31417
22577	290	194	30256	1093	0	31833
22578	294	209	35618	629	0	36750
22579	341	208	958	36706	0	38213
22580	354	153	37996	1074	0	39577
22581	37437	152	865	570	0	39024
22582	38580	159	311	438	0	39488
22583	1205	187	38236	447	0	40075
22584	565	137	839	38393	0	39934
22585	402	178	313	39575	0	40468
22586	390	181	191	39869	0	40631
22587	424	172	159	39308	0	40063
22588	437	179	188	39910	0	40714
22589	32988	217	182	1322	0	34709
22590	37287	190	161	664	0	38302
22591	1122	37699	155	645	0	39621
22592	529	822	35920	378	0	37649
22593	334	35613	798	435	0	37180
22594	251	35957	323	434	0	36965
22595	32531	733	191	315	0	33770
22596	676	32277	125	363	0	33441
22597	208	29555	89	234	0	30086
22598	28999	560	216	184	0	29959
22599	554	169	28551	196	0	29470
22600	27545	105	475	208	0	28333
22601	555	71	161	28438	0	29225
22602	205	95	121	27783	0	28204
22603	155	83	102	28079	0	28419
22604	174	69	27293	687	0	28223
22605	136	27415	494	330	0	28375
22606	27468	467	157	272	0	28364
22607	504	151	108	27481	0	28244
22608	150	27989	100	701	0	28940
22609	114	500	122	29119	0	29855
22610	173	172	29182	667	0	30194
22611	172	155	552	29032	0	29911
22612	188	133	188	29986	0	30495
22613	165	132	124	30153	0	30574
22614	29695	142	110	750	0	30697
22615	591	146	116	29857	0	30710
22616	234	140	29689	770	0	30833
22617	173	29498	552	478	0	30701
22618	196	562	188	29696	0	30642
22619	196	207	171	30193	0	30767
22620	247	141	29578	782	0	30748
22621	201	126	29039	362	0	29728
22622	28328	147	789	300	0	29564
22623	28305	164	266	342	0	29077
22624	682	28560	260	337	0	29839
22625	28584	548	190	301	0	29623
22626	690	223	28446	297	0	29656
22627	301	138	28218	310	0	28967
22628	27438	145	627	377	0	28587
22629	26909	103	230	421	0	27663
22630	585	110	25986	405	0	27086
22631	25025	85	510	390	0	26010
22632	582	101	25618	351	0	26652
22633	25282	117	554	252	0	26205
22634	25927	174	208	257	0	26566
22635	655	261	142	24524	0	25582
22636	251	27849	212	543	0	28855
22637	24126	667	226	251	0	25270
22638	512	333	28079	181	0	29105
22639	298	28432	530	217	0	29477
22640	28344	652	208	240	0	29444
22641	27060	274	172	263	0	27769
22642	665	27433	204	317	0	28619
22643	334	504	266	27499	0	28603
22644	302	197	27134	694	0	28327
22645	256	137	577	27221	0	28191
22646	242	175	27232	756	0	28405
22647	207	184	621	26834	0	27846
22648	196	170	355	27387	0	28108
22649	235	214	26938	717	0	28104
22650	267	26867	607	406	0	28147
22651	277	544	244	26773	0	27838
22652	264	267	24404	709	0	25644
22653	26263	181	534	410	0	27388
22654	616	154	289	27459	0	28518
22655	301	126	246	27862	0	28535
22656	27175	175	194	810	0	28354
22657	665	136	162	26894	0	27857
22658	392	157	185	26343	0	27077
22659	288	27221	238	714	0	28461
22660	292	543	273	26723	0	27831
22661	247	289	26628	663	0	27827
22662	271	175	602	25114	0	26162
22663	245	25934	300	700	0	27179
22664	248	26533	319	379	0	27479
22665	237	603	298	26432	0	27570
22666	26546	243	247	615	0	27651
22667	663	197	247	26549	0	27656
22668	26640	234	233	633	0	27740
22669	701	167	260	26771	0	27899
22670	26708	152	297	648	0	27805
22671	27418	143	314	417	0	28292
22672	851	218	256	26967	0	28292
22673	471	689	305	26262	0	27727
22674	360	26071	297	762	0	27490
22675	347	26951	259	421	0	27978
22676	407	504	26511	375	0	27797
22677	327	25930	566	373	0	27196
22678	19764	447	501	230	0	20942
22679	456	197	154	19093	0	19900
22680	161	18530	120	331	0	19142
22681	19130	229	98	231	0	19688
22682	311	135	96	19036	0	19578
22683	198	60	100	18741	0	19099
22684	142	77	106	19194	0	19519
22685	138	123	120	19042	0	19423
22686	137	19128	117	384	0	19766
22687	144	20266	107	200	0	20717
22688	20719	278	112	156	0	21265
22689	376	21127	96	135	0	21734
22690	161	315	111	21064	0	21651
22691	148	158	73	21269	0	21648
22692	166	76	71	21337	0	21650
22693	123	92	72	21479	0	21766
22694	21027	83	76	430	0	21616
22695	21371	56	94	213	0	21734
22696	477	64	21268	130	0	21939
22697	200	62	356	21356	0	21974
22698	181	73	22058	434	0	22746
22699	152	71	367	21898	0	22488
22700	131	86	174	22431	0	22822
22701	22349	85	97	548	0	23079
22702	416	79	97	22398	0	22990
22703	191	80	22411	481	0	23163
22704	131	92	21502	232	0	21957
22705	21434	88	444	217	0	22183
22706	409	82	22616	174	0	23281
22707	184	104	341	21536	0	22165
22708	114	57	22490	448	0	23109
22709	84	119	332	21550	0	22085
22710	50	22020	155	459	0	22684
22711	87	299	88	21797	0	22271
22712	50	22028	79	387	0	22544
22713	51	22193	63	215	0	22522
22714	69	368	64	21710	0	22211
22715	21672	119	40	371	0	22202
22716	267	22164	61	187	0	22679
22717	107	307	31	22404	0	22849
22718	22524	115	35	362	0	23036
22719	22810	55	30	218	0	23113
22720	23300	50	25	150	0	23525
22721	399	54	44	22870	0	23367
22722	156	54	45	23291	0	23546
22723	23426	48	48	428	0	23950
22724	23402	39	42	214	0	23697
22725	23799	50	37	156	0	24042
22726	405	50	43	23481	0	23979
22727	156	64	22914	334	0	23468
22728	22098	56	254	163	0	22571
22729	317	113	102	22651	0	23183
22730	161	23385	57	350	0	23953
22731	140	345	48	23105	0	23638
22732	76	23206	42	378	0	23702
22733	112	301	37	23575	0	24025
22734	99	111	22780	370	0	23360
22735	79	22580	251	211	0	23121
22736	112	240	112	21009	0	21473
22737	90	88	46	21084	0	21308
22738	79	64	47	21029	0	21219
22739	21287	44	36	396	0	21763
22740	308	21723	56	213	0	22300
22741	144	304	34	22126	0	22608
22742	22382	118	52	395	0	22947
22743	22365	62	41	204	0	22672
22744	440	42	50	22624	0	23156
22745	191	78	23271	404	0	23944
22746	100	47	354	22687	0	23188
22747	90	23340	143	426	0	23999
22748	96	353	75	23822	0	24346
22749	23550	125	60	484	0	24219
22750	391	85	61	24917	0	25454
22751	186	69	25668	483	0	26406
22752	91	27048	365	299	0	27803
22753	27590	416	143	164	0	28313
22754	457	172	27660	155	0	28444
22755	27570	84	441	178	0	28273
22756	485	52	159	29150	0	29846
22757	197	65	87	29195	0	29544
22758	109	29549	75	608	0	30341
22759	30451	405	65	285	0	31206
22760	503	145	75	30962	0	31685
22761	235	77	59	31679	0	32050
22762	145	61	74	32441	0	32721
22763	133	53	32083	697	0	32966
22764	111	47	475	32072	0	32705
22765	32550	55	187	615	0	33407
22766	33377	45	91	323	0	33836
22767	618	49	81	33143	0	33891
22768	230	67	83	33643	0	34023
22769	32999	68	86	669	0	33822
22770	535	80	32650	285	0	33550
22771	31874	65	506	213	0	32658
22772	564	102	32138	157	0	32961
22773	237	85	32435	170	0	32927
22774	152	93	560	31814	0	32619
22775	149	91	33314	554	0	34108
22776	32615	62	483	313	0	33473
22777	526	72	163	34267	0	35028
22778	241	71	34497	536	0	35345
22779	32966	59	445	314	0	33784
22780	34434	61	169	203	0	34867
22781	661	75	35872	179	0	36787
22782	293	126	429	33595	0	34443
22783	188	36499	187	519	0	37393
22784	36949	426	95	288	0	37758
22785	598	159	37722	200	0	38679
22786	34407	113	485	213	0	35218
22787	489	37111	186	209	0	37995
22788	36175	342	145	162	0	36824
22789	36375	118	79	169	0	36741
22790	36822	74	73	177	0	37146
22791	522	68	70	36673	0	37333
22792	204	37381	97	494	0	38176
22793	211	374	36566	216	0	37367
22794	129	37752	401	190	0	38472
22795	169	418	145	35048	0	35780
22796	115	37117	120	400	0	37752
22797	90	37612	111	234	0	38047
22798	36282	378	145	163	0	36968
22799	365	156	36033	140	0	36694
22800	209	113	37377	127	0	37826
22801	229	63	37331	136	0	37759
22802	116	38161	387	177	0	38841
22803	38305	284	154	192	0	38935
22804	38238	126	74	171	0	38609
22805	37997	83	72	135	0	38287
22806	427	37915	74	176	0	38592
22807	200	320	76	38994	0	39590
22808	159	119	38797	396	0	39471
22809	158	150	38299	202	0	38809
22810	39385	89	382	223	0	40079
22811	40726	83	174	178	0	41161
22812	40701	60	110	189	0	41060
22813	487	70	40281	212	0	41050
22814	39447	69	343	217	0	40076
22815	436	77	147	40645	0	41305
22816	237	79	136	40611	0	41063
22817	257	122	42130	505	0	43014
22818	197	42299	357	342	0	43195
22819	189	293	190	42821	0	43493
22820	200	141	42102	479	0	42922
22821	38468	91	410	334	0	39303
22822	448	91	232	42633	0	43404
22823	279	69	174	42797	0	43319
22824	42471	49	145	541	0	43206
22825	479	40	144	42573	0	43236
22826	42439	45	127	540	0	43151
22827	42397	53	175	326	0	42951
22828	548	64	175	42563	0	43350
22829	321	53	208	42913	0	43495
22830	42657	67	185	567	0	43476
22831	479	81	212	43537	0	44309
22832	44085	63	232	481	0	44861
22833	43862	78	180	328	0	44448
22834	43877	69	187	248	0	44381
22835	634	74	179	43613	0	44500
22836	362	69	185	44043	0	44659
22837	44164	58	198	463	0	44883
22838	473	43523	208	278	0	44482
22839	235	42644	192	166	0	43237
22840	42543	248	168	129	0	43088
22841	374	121	41584	127	0	42206
22842	41103	94	322	123	0	41642
22843	412	68	143	43752	0	44375
22844	234	98	44102	249	0	44683
22845	43444	63	288	204	0	43999
22846	364	87	93	45144	0	45688
22847	241	79	87	46263	0	46670
22848	237	67	85	46966	0	47355
22849	225	95	74	46981	0	47375
22850	45911	68	110	293	0	46382
22851	230	44897	106	213	0	45446
22852	42181	150	119	112	0	42562
22853	224	82	42596	76	0	42978
22854	158	59	41142	52	0	41411
22855	99	43309	121	93	0	43622
22856	125	270	172	42641	0	43208
22857	75	74	42567	137	0	42853
22858	48	40326	99	225	0	40698
22859	86	92	40453	64	0	40695
22860	28	16	61	39862	0	39967
22861	27	28	9	40512	0	40576
22862	40586	10	31	105	0	40732
22863	52	13	18	39893	0	39976
22864	39745	19	44	88	0	39896
22865	75	30	39901	39	0	40045
22866	27	40119	58	102	0	40306
22867	58	56	19	42086	0	42219
22868	59	54	15	44529	0	44657
22869	57	31	45057	55	0	45200
22870	66	58	42236	33	0	42393
22871	40828	18	57	86	0	40989
22872	45486	22	23	103	0	45634
22873	55	20	21	45204	0	45300
22874	26	19	14	45292	0	45351
22875	19	44598	28	99	0	44744
22876	43	68	14	45983	0	46108
22877	46601	20	15	119	0	46755
22878	46631	15	18	81	0	46745
22879	115	47808	26	84	0	48033
22880	48533	123	10	90	0	48756
22881	47341	35	20	77	0	47473
22882	205	24	14	50226	0	50469
22883	63	51219	29	284	0	51595
22884	51	263	16	51875	0	52205
22885	54	63	15	51830	0	51962
22886	65	68	50933	344	0	51410
22887	48947	22	304	124	0	49397
22888	411	20	52	55454	0	55937
22889	120	19	40	58508	0	58687
22890	53	67499	45	747	0	68344
22891	52	861	26	71831	0	72770
22892	73011	173	33	1088	0	74305
22893	76760	94	53	270	0	77177
22894	1417	86	76763	160	0	78426
22895	369	79	76877	110	0	77435
22896	194	56	1393	77070	0	78713
22897	143	28	294	80926	0	81391
22898	174	53	80175	1469	0	81871
22899	169	65	80324	363	0	80921
22900	111	46	1514	76091	0	77762
22901	137	50	80452	1393	0	82032
22902	119	91	80586	354	0	81150
22903	99	52	1558	77336	0	79045
22904	80357	32	404	1370	0	82163
22905	81777	39	223	415	0	82454
22906	1562	62	157	80752	0	82533
22907	411	62	134	82199	0	82806
22908	80504	42	118	1611	0	82275
22909	1411	41	90	79766	0	81308
22910	79392	47	109	1512	0	81060
22911	79465	58	135	476	0	80134
22912	1583	68	110	79035	0	80796
22913	451	99	120	80617	0	81287
22914	77755	68	144	1693	0	79660
22915	1411	78279	186	653	0	80529
22916	448	79600	183	570	0	80801
22917	348	1527	212	76976	0	79063
22918	344	382	76557	1535	0	78818
22919	229	183	1424	75864	0	77700
22920	76245	134	422	1651	0	78452
22921	1419	102	311	76487	0	78319
22922	76804	86	262	1700	0	78852
22923	1563	140	76809	758	0	79270
22924	75066	94	1515	590	0	77265
22925	1573	100	499	77621	0	79793
22926	555	76	308	79764	0	80703
22927	479	121	82022	1806	0	84428
22928	411	114	1446	81074	0	83045
22929	325	113	439	83334	0	84211
22930	347	160	286	84942	0	85735
22931	82530	171	287	2079	0	85067
22932	1674	172	82826	887	0	85559
22933	770	147	82432	624	0	83973
22934	80435	117	1751	587	0	82890
22935	83056	96	671	616	0	84439
22936	1945	151	83770	610	0	86476
22937	804	164	1613	79333	0	81914
22938	524	83866	683	1795	0	86868
22939	532	1373	569	85472	0	87946
22940	85061	356	569	1938	0	87924
22941	86030	234	641	946	0	87851
22942	1831	204	562	84370	0	86967
22943	800	84084	598	2125	0	87607
22944	691	1342	578	79920	0	82531
22945	697	83009	573	2053	0	86332
22946	83452	1374	607	1066	0	86499
22947	81927	371	587	943	0	83828
22948	81323	230	644	934	0	83131
22949	2036	79352	664	1027	0	83079
22950	1001	81987	647	973	0	84608
22951	827	1693	580	82025	0	85125
22952	756	434	532	83250	0	84972
22953	698	269	538	82847	0	84352
22954	820	255	505	83617	0	85197
22955	806	292	79990	2538	0	83626
22956	74868	282	1702	1416	0	78268
22957	2124	285	81389	1094	0	84892
22958	80868	244	1829	1152	0	84093
22959	2207	305	84103	1084	0	87699
22960	82771	237	1869	1092	0	85969
22961	2302	328	85507	1025	0	89162
22962	82031	282	1934	1037	0	85284
22963	2319	256	826	86046	0	89447
22964	86971	256	672	2377	0	90276
22965	2252	260	549	87878	0	90939
22966	1203	304	522	88619	0	90648
22967	895	269	539	84940	0	86643
22968	787	82790	526	2681	0	86784
22969	82299	1552	486	1476	0	85813
22970	82289	564	470	1172	0	84495
22971	2361	82665	503	1256	0	86785
22972	1245	1600	461	83255	0	86561
22973	1044	600	81859	2263	0	85766
22974	79782	327	1791	1279	0	83179
22975	83083	260	771	1152	0	85266
22976	81748	251	597	1079	0	83675
22977	2478	229	521	77767	0	80995
22978	1124	78002	604	2153	0	81883
22979	956	1487	509	78197	0	81149
22980	77561	483	522	2223	0	80789
22981	2247	299	498	73737	0	76781
22982	917	72691	554	1962	0	76124
22983	70828	1370	600	976	0	73774
22984	1908	552	71621	760	0	74841
22985	1366	399	71486	696	0	73947
22986	895	70687	1806	761	0	74149
22987	810	69575	738	684	0	71807
22988	1430	1511	65107	611	0	68659
22989	1278	664	60911	560	0	63413
22990	875	3224	1107	46599	0	51805
22991	48434	173	467	655	0	49729
22992	637	131	48015	316	0	49099
22993	257	44460	361	196	0	45274
22994	44814	307	346	175	0	45642
22995	323	44369	81	172	0	44945
22996	42465	239	40	105	0	42849
22997	251	42508	55	124	0	42938
22998	144	43241	53	132	0	43570
22999	120	314	73	42947	0	43454
23000	123	145	131	42978	0	43377
23001	123	87	41013	264	0	41487
23002	104	51	200	39852	0	40207
23003	40618	51	104	269	0	41042
23004	40648	46	48	164	0	40906
23005	293	51	39	39832	0	40215
23006	198	65	39302	244	0	39809
23007	122	89	38648	156	0	39015
23008	70	44	279	38745	0	39138
23009	101	93	39966	244	0	40404
23010	67	51	257	39054	0	39429
23011	68	46	135	39364	0	39613
23012	100	70	43640	274	0	44084
23013	39303	59	364	198	0	39924
23014	43546	58	212	113	0	43929
23015	501	46	44442	72	0	45061
23016	266	71	45072	83	0	45492
23017	129	44	641	45071	0	45885
23018	90	59	262	50847	0	51258
23019	102	63	120	52001	0	52286
23020	89	80	77	52709	0	52955
23021	51857	60	71	901	0	52889
23022	55199	58	83	370	0	55710
23023	984	71	72	59067	0	60194
23024	377	65	81	62814	0	63337
23025	212	80	67284	1267	0	68843
23026	136	56	1237	69063	0	70492
23027	129	41	498	72876	0	73544
23028	72475	57	186	2068	0	74786
23029	1585	78935	117	917	0	81554
23030	576	1725	89	78496	0	80886
23031	240	551	87	80291	0	81169
23032	171	198	97	78103	0	78569
23033	115	72756	145	2628	0	75644
23034	103	78740	123	982	0	79948
23035	144	2199	113	76761	0	79217
23036	165	691	113	76943	0	77912
23037	165	265	99	78754	0	79283
23038	73202	131	113	2710	0	76156
23039	1751	75103	116	1135	0	78105
23040	75628	1843	108	514	0	78093
23041	77255	639	96	395	0	78385
23042	2446	301	102	73165	0	76014
23043	828	73636	123	2160	0	76747
23044	73427	1926	108	913	0	76374
23045	1973	721	83	74257	0	77034
23046	74741	326	138	2281	0	77486
23047	2082	233	118	75987	0	78420
23048	793	231	75725	2408	0	79157
23049	437	235	77397	1085	0	79154
23050	266	228	2407	75373	0	78274
23051	282	235	832	76811	0	78160
23052	325	264	301	74659	0	75549
23053	325	73759	208	2891	0	77183
23054	328	78355	175	1269	0	80127
23055	75475	2492	148	762	0	78877
23056	74082	943	155	659	0	75839
23057	2441	74344	165	818	0	77768
23058	830	73488	146	674	0	75138
23059	472	75388	134	752	0	76746
23060	69697	2506	174	627	0	73004
23061	1873	72105	164	711	0	74853
23062	807	2074	163	71997	0	75041
23063	71327	762	185	2245	0	74519
23064	71782	434	178	1085	0	73479
23065	2505	352	169	69391	0	72417
23066	1050	365	68627	2288	0	72330
23067	616	383	69753	1082	0	71834
23068	490	344	2281	68983	0	72098
23069	497	401	70895	2309	0	74102
23070	483	382	1994	69510	0	72369
23071	500	351	723	71270	0	72844
23072	467	405	70321	2800	0	73993
23073	461	399	71221	1305	0	73386
23074	456	416	2446	69176	0	72494
23075	454	388	898	72907	0	74647
23076	69838	444	462	2956	0	73700
23077	2062	69721	342	1601	0	73726
23078	853	73317	309	1187	0	75666
23079	70182	2565	296	964	0	74007
23080	72142	1114	291	927	0	74474
23081	2598	70788	347	1098	0	74831
23082	1089	73048	364	1082	0	75583
23083	71730	2590	291	1064	0	75675
23084	2266	1164	309	71348	0	75087
23085	69856	722	349	2715	0	73642
23086	2325	70403	377	1736	0	74841
23087	71107	2191	340	1292	0	74930
23088	2545	972	70214	1178	0	74909
23089	69069	637	2008	1228	0	72942
23090	2534	595	70499	1180	0	74808
23091	1309	558	2167	69335	0	73369
23092	68677	586	936	2872	0	73071
23093	2429	573	67688	1700	0	72390
23094	1163	658	2123	68425	0	72369
23095	67954	634	935	2935	0	72458
23096	2452	733	67783	1710	0	72678
23097	1276	712	2047	68663	0	72698
23098	66824	746	868	2925	0	71363
23099	2266	67386	555	1800	0	72007
23100	1226	2343	434	68227	0	72230
23101	919	1280	387	69542	0	72128
23102	907	958	350	68247	0	70462
23103	863	68792	390	3212	0	73257
23104	978	2420	351	70342	0	74091
23105	981	1236	346	71559	0	74122
23106	1074	877	390	72096	0	74437
23107	1143	755	381	73987	0	76266
23108	1201	749	71094	3251	0	76295
23109	67490	733	2196	1668	0	72087
23110	71046	602	954	1154	0	73756
23111	3190	70606	661	1085	0	75542
23112	1357	2181	492	67259	0	71289
23113	1014	980	507	67020	0	69521
23114	799	67036	634	3113	0	71582
23115	793	1875	597	66923	0	70188
23116	63829	819	684	2616	0	67948
23117	1904	62983	709	1559	0	67155
23118	59936	1734	630	997	0	63297
23119	1954	785	562	59691	0	62992
23120	928	505	59176	2342	0	62951
23121	538	59253	1749	1359	0	62899
23122	53531	1753	1045	891	0	57220
23123	1531	51273	392	614	0	53810
23124	673	50122	307	519	0	51621
23125	42330	1115	562	423	0	44430
23126	1052	451	41934	347	0	43784
23127	296	37384	639	271	0	38590
23128	31079	1272	1646	520	0	34517
23129	27930	220	274	124	0	28548
23130	314	28319	56	99	0	28788
23131	155	276	65	29211	0	29707
23132	97	133	30101	290	0	30621
23133	64	100	243	29576	0	29983
23134	72	52	100	29993	0	30217
23135	82	46	57	31250	0	31435
23136	76	83	31408	365	0	31932
23137	89	64	245	30080	0	30478
23138	89	72	31294	329	0	31784
23139	93	88	29777	152	0	30110
23140	25681	81	313	135	0	26210
23141	259	30546	125	97	0	31027
23142	112	30948	69	105	0	31234
23143	94	327	38	31757	0	32216
23144	34773	117	33	426	0	35349
23145	35045	75	48	156	0	35324
23146	34334	65	41	125	0	34565
23147	34451	59	47	90	0	34647
23148	32949	53	59	67	0	33128
23149	376	78	32300	75	0	32829
23150	169	62	254	31797	0	32282
23151	90	32483	115	307	0	32995
23152	59	289	56	32958	0	33362
23153	33035	138	32	332	0	33537
23154	302	32746	62	180	0	33290
23155	153	282	61	33259	0	33755
23156	33522	138	40	335	0	34035
23157	34372	70	59	233	0	34734
23158	380	55	78	34053	0	34566
23159	176	62	61	33675	0	33974
23160	102	65	49	34212	0	34428
23161	95	76	33625	447	0	34243
23162	129	66	33804	199	0	34198
23163	96	65	357	34493	0	35011
23164	107	77	143	35284	0	35611
23165	35088	57	64	432	0	35641
23166	34812	69	48	204	0	35133
23167	35472	78	46	175	0	35771
23168	36769	60	52	201	0	37082
23169	35799	77	40	153	0	36069
23170	405	36705	76	159	0	37345
23171	37832	308	72	190	0	38402
23172	38024	141	60	172	0	38397
23173	37783	96	57	143	0	38079
23174	485	75	61	38880	0	39501
23175	261	74	38725	445	0	39505
23176	168	85	368	39172	0	39793
23177	186	106	42516	492	0	43300
23178	164	74	407	40066	0	40711
23179	121	42899	147	454	0	43621
23180	43094	417	64	221	0	43796
23181	44538	162	61	214	0	44975
23182	581	83	53	45507	0	46224
23183	259	65	48	47813	0	48185
23184	155	55	66	47469	0	47745
23185	140	48750	67	568	0	49525
23186	48650	407	58	241	0	49356
23187	48355	144	63	153	0	48715
23188	580	49229	82	175	0	50066
23189	232	427	58	49920	0	50637
23190	169	172	53	48249	0	48643
23191	132	50190	69	560	0	50951
23192	50530	445	57	225	0	51257
23193	50138	158	67	156	0	50519
23194	613	85	63	50171	0	50932
23195	293	77	50528	520	0	51418
23196	242	92	49182	218	0	49734
23197	164	70	560	51891	0	52685
23198	157	58	174	52059	0	52448
23199	153	60	80	53189	0	53482
23200	52964	49	81	731	0	53825
23201	52943	74	94	282	0	53393
23202	709	55748	89	288	0	56834
23203	56090	494	173	238	0	56995
23204	686	181	56681	138	0	57686
23205	318	101	56634	152	0	57205
23206	159	58936	682	223	0	60000
23207	56802	517	363	174	0	57856
23208	485	57340	80	160	0	58065
23209	57193	464	137	120	0	57914
23210	573	181	57177	118	0	58049
23211	246	118	56167	146	0	56677
23212	176	71	556	54908	0	55711
23213	204	106	59104	551	0	59965
23214	142	72	476	59785	0	60475
23215	139	96	179	56815	0	57229
23216	121	60836	89	689	0	61735
23217	124	497	81	61250	0	61952
23218	145	160	65	61964	0	62334
23219	62739	100	65	685	0	63589
23220	561	62825	89	316	0	63791
23221	268	529	55	64376	0	65228
23222	208	192	64336	654	0	65390
23223	55605	105	616	387	0	56713
23224	680	106	63946	213	0	64945
23225	264	124	598	61364	0	62350
23226	159	66289	222	679	0	67349
23227	161	698	112	64777	0	65748
23228	67729	223	100	779	0	68831
23229	66863	124	100	327	0	67414
23230	1001	69433	118	266	0	70818
23231	71734	792	94	310	0	72930
23232	72273	284	91	337	0	72985
23233	73433	156	112	235	0	73936
23234	73906	108	107	222	0	74343
23235	70044	138	126	235	0	70543
23236	1070	149	71764	161	0	73144
23237	401	137	825	71239	0	72602
23238	276	121	301	72467	0	73165
23239	226	164	185	70971	0	71546
23240	220	72596	188	1088	0	74092
23241	249	830	164	72650	0	73893
23242	270	337	71917	976	0	73500
23243	195	71172	831	520	0	72718
23244	206	69997	336	397	0	70936
23245	259	947	259	69628	0	71093
23246	223	328	141	69745	0	70437
23247	234	183	166	67828	0	68411
23248	220	67933	185	1189	0	69527
23249	203	69288	180	505	0	70176
23250	68938	974	136	379	0	70427
23251	68208	365	164	284	0	69021
23252	1047	69315	168	348	0	70878
23253	70861	865	171	340	0	72237
23254	72238	366	201	503	0	73308
23255	1129	224	225	73494	0	75072
23256	516	209	218	75420	0	76363
23257	365	202	209	75254	0	76030
23258	400	243	75338	1183	0	77164
23259	434	263	74733	530	0	75960
23260	393	78937	1175	480	0	80985
23261	80814	1013	453	353	0	82633
23262	1329	447	81609	331	0	83716
23263	79672	272	1239	412	0	81595
23264	1472	279	86194	347	0	88292
23265	83158	271	1372	347	0	85148
23266	1448	89821	534	466	0	92269
23267	88233	1341	335	432	0	90341
23268	1507	540	314	88409	0	90770
23269	690	326	277	90479	0	91772
23270	613	365	87620	1811	0	90409
23271	415	91490	1217	970	0	94092
23272	442	1529	468	92342	0	94781
23273	498	604	91463	1559	0	94124
23274	80250	376	1397	764	0	82787
23275	1334	90478	528	610	0	92950
23276	88519	1258	328	469	0	90574
23277	1323	86901	261	553	0	89038
23278	594	1380	218	86927	0	89119
23279	85447	508	246	1440	0	87641
23280	1310	86353	287	744	0	88694
23281	650	1275	244	86570	0	88739
23282	538	594	84816	1461	0	87409
23283	77369	390	1184	658	0	79601
23284	1457	350	414	83898	0	86119
23285	786	322	82888	1412	0	85408
23286	545	82805	1168	846	0	85364
23287	496	1309	441	82948	0	85194
23288	553	568	82965	1414	0	85500
23289	501	423	1222	77574	0	79720
23290	487	83116	513	1343	0	85459
23291	490	84671	291	777	0	86229
23292	788	1514	82965	408	0	85675
23293	522	690	1229	81885	0	84326
23294	495	369	84081	1413	0	86358
23295	79467	330	1295	671	0	81763
23296	1524	491	489	79656	0	82160
23297	631	80206	288	1296	0	82421
23298	442	83961	233	646	0	85282
23299	81292	1418	247	464	0	83421
23300	1207	83957	261	529	0	85954
23301	82715	1243	317	498	0	84773
23302	1371	565	81268	348	0	83552
23303	74077	322	1092	356	0	75847
23304	1181	79168	439	408	0	81196
23305	78348	1142	286	340	0	80116
23306	1161	78547	221	332	0	80261
23307	488	1214	179	77850	0	79731
23308	295	588	192	80029	0	81104
23309	343	346	78568	1431	0	80688
23310	72595	333	1107	665	0	74700
23311	1245	328	79406	387	0	81366
23312	78116	315	1257	313	0	80001
23313	1356	278	450	79064	0	81148
23314	558	286	288	79794	0	80926
23315	373	81815	296	1638	0	84122
23316	350	1439	232	84333	0	86354
23317	390	594	261	86623	0	87868
23318	412	373	84854	1836	0	87475
23319	75181	315	1405	856	0	77757
23320	1444	83029	609	503	0	85585
23321	82238	1345	344	374	0	84301
23322	1485	593	267	81918	0	84263
23323	633	385	251	83784	0	85053
23324	81879	238	306	1809	0	84232
23325	1439	83602	308	916	0	86265
23326	79393	1307	239	381	0	81320
23327	1406	79490	256	363	0	81515
23328	536	79426	198	308	0	80468
23329	78362	1534	457	256	0	80609
23330	1363	584	260	76105	0	78312
23331	616	320	75645	1332	0	77913
23332	376	282	1201	73858	0	75717
23333	311	267	460	73851	0	74889
23334	280	74248	272	1633	0	76433
23335	290	1340	180	75230	0	77040
23336	272	562	162	76014	0	77010
23337	254	334	224	76615	0	77427
23338	261	311	178	77898	0	78648
23339	273	324	76189	1893	0	78679
23340	295	320	77894	784	0	79293
23341	301	340	1714	78907	0	81262
23342	371	320	79661	1696	0	82048
23343	394	307	79601	706	0	81008
23344	343	323	1802	78302	0	80770
23345	399	341	82172	1701	0	84613
23346	397	402	1583	74956	0	77338
23347	281	82868	604	1635	0	85388
23348	85046	1577	351	737	0	87711
23349	1777	653	91578	502	0	94510
23350	682	414	1806	90216	0	93118
23351	511	335	94136	1995	0	96977
23352	345	351	1901	98009	0	100606
23353	350	417	687	102083	0	103537
23354	99418	318	448	2743	0	102927
23355	2202	310	341	101565	0	104418
23356	97195	296	331	2636	0	100458
23357	98984	297	341	1151	0	100773
23358	2675	98188	313	842	0	102018
23359	95350	2123	317	598	0	98388
23360	2213	94209	346	669	0	97437
23361	743	96338	363	659	0	98103
23362	92729	2445	504	583	0	96261
23363	2284	871	91995	548	0	95698
23364	829	449	89414	430	0	91122
23365	84512	471	2847	463	0	88293
23366	86469	277	934	462	0	88142
23367	2258	86822	486	460	0	90026
23368	88895	1806	365	472	0	91538
23369	89142	702	344	584	0	90772
23370	87720	389	358	502	0	88969
23371	2523	248	301	85776	0	88848
23372	84260	262	342	2126	0	86990
23373	2055	86663	377	1058	0	90153
23374	967	1751	329	88873	0	91920
23375	634	678	359	88958	0	90629
23376	564	88638	382	2588	0	92172
23377	556	1837	346	90015	0	92754
23378	87872	781	371	2334	0	91358
23379	89012	486	375	1147	0	91020
23380	2566	86426	365	883	0	90240
23381	1167	89156	392	703	0	91418
23382	88077	2303	352	649	0	91381
23383	2350	954	87348	629	0	91281
23384	1302	569	88323	606	0	90800
23385	949	486	2495	84190	0	88120
23386	825	493	959	88443	0	90720
23387	990	508	86805	2497	0	90800
23388	869	84175	2039	1261	0	88344
23389	896	2055	909	82824	0	86684
23390	1029	949	86783	2179	0	90940
23391	912	628	2036	85139	0	88715
23392	854	595	977	84620	0	87046
23393	823	88637	635	2642	0	92737
23394	876	2106	497	87721	0	91200
23395	901	1035	509	89120	0	91565
23396	889	681	480	90469	0	92519
23397	88173	587	480	2842	0	92082
23398	2535	584	452	84078	0	87649
23399	1379	87431	464	2407	0	91681
23400	87074	2067	532	1234	0	90907
23401	2586	1041	84720	966	0	89313
23402	1470	690	83938	869	0	86967
23403	82599	560	2451	925	0	86535
23404	2460	598	1066	85301	0	89425
23405	1444	575	86937	2383	0	91339
23406	1005	589	2132	85521	0	89247
23407	897	615	1057	88443	0	91012
23408	86600	607	739	2956	0	90902
23409	85763	613	698	1600	0	88674
23410	2757	86990	661	1378	0	91786
23411	1568	2101	608	85657	0	89934
23412	1263	1027	85683	2429	0	90402
23413	937	89102	1980	1532	0	93551
23414	87202	1962	960	1210	0	91334
23415	2165	89277	692	1082	0	93216
23416	87063	1900	618	942	0	90523
23417	2323	946	86680	847	0	90796
23418	83415	709	1789	945	0	86858
23419	88475	684	860	853	0	90872
23420	2622	740	90526	878	0	94766
23421	1357	768	1991	85846	0	89962
23422	1048	90597	911	2283	0	94839
23423	985	93590	701	1247	0	96523
23424	920	94518	609	1063	0	97110
23425	1045	2570	561	90955	0	95131
23426	1068	1016	92099	2216	0	96399
23427	994	808	1781	90431	0	94014
23428	944	690	765	94469	0	96868
23429	1045	608	93029	2496	0	97178
23430	905	93160	1894	1316	0	97275
23431	922	1897	865	92195	0	95879
23432	92627	897	626	2260	0	96410
23433	2173	695	595	92725	0	96188
23434	1143	640	547	92229	0	94559
23435	943	92418	498	2613	0	96472
23436	92576	1914	538	1364	0	96392
23437	2289	928	480	95042	0	98739
23438	1268	669	94449	2250	0	98636
23439	872	94010	1759	1421	0	98062
23440	91552	1780	862	942	0	95136
23441	1967	978	92137	774	0	95856
23442	88698	735	1743	794	0	91970
23443	1959	663	904	89226	0	92752
23444	873	91897	731	1770	0	95271
23445	90280	1648	601	1002	0	93531
23446	89597	848	602	888	0	91935
23447	1951	91342	585	821	0	94699
23448	1089	1532	531	88083	0	91235
23449	588	700	408	84680	0	86376
23450	81198	442	439	1652	0	83731
23451	1272	81613	509	1071	0	84465
23452	545	1144	290	74915	0	76894
23453	274	73854	286	1029	0	75443
23454	234	73281	228	531	0	74274
23455	462	894	252	70639	0	72247
23456	69922	332	242	733	0	71229
23457	600	70854	179	446	0	72079
23458	309	614	159	70603	0	71685
23459	200	327	126	71166	0	71819
23460	276	217	69994	768	0	71255
23461	293	230	66515	331	0	67369
23462	206	69230	645	353	0	70434
23463	299	600	67436	273	0	68608
23464	250	303	615	66750	0	67918
23465	286	226	69759	637	0	70908
23466	220	203	536	68113	0	69072
23467	222	212	195	70088	0	70717
23468	179	184	142	70122	0	70627
23469	67974	176	138	841	0	69129
23470	614	192	126	67982	0	68914
23471	296	208	123	67673	0	68300
23472	215	67716	149	749	0	68829
23473	181	640	122	66722	0	67665
23474	66574	279	121	839	0	67813
23475	541	68478	144	426	0	69589
23476	68582	642	127	410	0	69761
23477	704	337	68221	285	0	69547
23478	365	306	69418	290	0	70379
23479	219	260	673	70678	0	71830
23480	181	221	282	72891	0	73575
23481	182	73286	203	982	0	74653
23482	206	807	190	72460	0	73663
23483	72342	310	154	910	0	73716
23484	71634	257	162	455	0	72508
23485	838	216	189	73364	0	74607
23486	421	273	78250	900	0	79844
23487	242	230	763	78791	0	80026
23488	228	242	277	82455	0	83202
23489	197	232	209	83281	0	83919
23490	178	218	199	81613	0	82208
23491	205	249	164	79853	0	80471
23492	143	80472	191	1241	0	82047
23493	78825	877	208	616	0	80526
23494	80052	314	197	479	0	81042
23495	80396	245	199	468	0	81308
23496	1055	81955	208	525	0	83743
23497	80715	961	170	437	0	82283
23498	947	81189	187	486	0	82809
23499	457	988	79933	463	0	81841
23500	289	376	915	77583	0	79163
23501	355	304	81268	1184	0	83111
23502	246	81650	962	682	0	83540
23503	80693	995	380	519	0	82587
23504	1109	402	83563	458	0	85532
23505	526	305	87993	458	0	89282
23506	279	90807	1418	507	0	93011
23507	341	1284	574	92100	0	94299
23508	421	564	98056	1456	0	100497
23509	330	375	1396	96611	0	98712
23510	293	225	572	108879	0	109969
23511	306	210	340	118152	0	119008
23512	124602	211	216	2745	0	127774
23513	124394	210	207	1064	0	125875
23514	2836	252	202	123559	0	126849
23515	124753	153	332	2648	0	127886
23516	2748	199	123748	1072	0	127767
23517	1000	226	123481	612	0	125319
23518	650	194	125338	520	0	126702
23519	612	175	125892	570	0	127249
23520	410	121600	2841	696	0	125547
23521	761	2221	1013	117593	0	121588
23522	645	542	122948	2207	0	126342
23523	113692	298	2351	847	0	117188
23524	121211	215	848	523	0	122797
23525	2594	121961	702	540	0	125797
23526	121111	2092	686	410	0	124299
23527	2424	636	686	120959	0	124705
23528	943	459	123989	2332	0	127723
23529	585	369	2554	112573	0	116081
23530	401	125059	1015	2231	0	128706
23531	123489	2227	591	877	0	127184
23532	123290	727	445	693	0	125155
23533	2755	124692	433	672	0	128552
23534	126094	2242	380	549	0	129265
23535	124141	773	386	515	0	125815
23536	2990	125151	449	671	0	129261
23537	1257	2347	449	118653	0	122706
23538	768	122486	459	2459	0	126172
23539	123482	2461	483	1060	0	127486
23540	2654	1106	496	122373	0	126629
23541	122232	627	557	2504	0	125920
23542	2911	549	418	122401	0	126279
23543	1345	626	120760	2604	0	125335
23544	116723	519	2448	1067	0	120757
23545	2989	625	121349	742	0	125705
23546	1404	521	2553	119204	0	123682
23547	1061	581	119938	2658	0	124238
23548	923	519	2638	119129	0	123209
23549	940	554	120107	2878	0	124479
23550	113531	418	2822	1319	0	118090
23551	2749	119692	1155	1075	0	124671
23552	119619	2319	889	875	0	123702
23553	2968	897	771	119332	0	123968
23554	116971	554	791	2764	0	121080
23555	2788	119173	898	1323	0	124182
23556	1259	119610	892	935	0	122696
23557	995	123927	842	876	0	126640
23558	122667	3005	777	987	0	127436
23559	2856	1232	719	122096	0	126903
23560	1411	748	669	125148	0	127976
23561	1166	772	122154	3187	0	127279
23562	1201	730	122059	1391	0	125381
23563	1124	773	2821	122073	0	126791
23564	1221	766	124592	2855	0	129434
23565	1050	123185	2740	1561	0	128536
23566	122207	2700	1419	1137	0	127463
23567	3091	1170	124123	1024	0	129408
23568	1592	877	125064	964	0	128497
23569	1136	690	3360	121075	0	126261
23570	125108	538	1670	3022	0	130338
23571	3004	547	1253	125118	0	129922
23572	124532	573	1276	3180	0	129561
23573	3136	622	1202	125471	0	130431
23574	1673	618	126723	3037	0	132051
23575	1238	124102	3200	1644	0	130184
23576	1331	2660	126455	1124	0	131570
23577	1092	126199	3202	1172	0	131665
23578	1262	3093	1675	123030	0	129060
23579	122011	1042	1157	2958	0	127168
23580	3068	769	122694	1568	0	128099
23581	1662	665	2712	120793	0	125832
23582	1308	658	1301	125129	0	128396
23583	124838	620	1052	3345	0	129855
23584	2990	731	1050	120227	0	124998
23585	1340	124664	1116	2834	0	129954
23586	119779	2688	1048	1387	0	124902
23587	3042	1237	118304	1014	0	123597
23588	112357	965	2611	959	0	116892
23589	2926	117507	1153	1020	0	122606
23590	1622	2773	770	108798	0	113963
23591	1330	118352	690	2500	0	122872
23592	117635	2556	686	1358	0	122235
23593	3062	1195	117822	1130	0	123209
23594	113198	1061	2366	1082	0	117707
23595	2897	118641	1084	1028	0	123650
23596	1501	2465	765	118494	0	123225
23597	119443	1061	762	2636	0	123902
23598	120881	834	769	1276	0	123760
23599	3145	724	769	119591	0	124229
23600	1580	802	760	120302	0	123444
23601	1094	119645	874	3042	0	124655
23602	1171	2615	733	118099	0	122618
23603	1029	134262	795	2854	0	138940
23604	1038	141278	820	1490	0	144626
23605	1133	4242	762	124599	0	130736
23606	904	130255	695	2906	0	134760
23607	1289	2518	133759	1119	0	138685
23608	1683	985	136386	1024	0	140078
23609	824	133564	3111	1598	0	139097
23610	879	2404	133151	601	0	137035
23611	649	857	129937	594	0	132037
23612	517	393	119052	307	0	120269
23613	211	116572	2468	474	0	119725
23614	111477	2054	1253	351	0	115135
23615	1574	111582	322	396	0	113874
23616	660	1856	112036	139	0	114691
23617	277	575	1753	108954	0	111559
23618	109929	261	573	1758	0	112521
23619	1779	212	110014	522	0	112527
23620	568	150	1804	107799	0	110321
23621	334	213	111444	1722	0	113713
23622	218	158	1918	107949	0	110243
23623	107628	151	668	1896	0	110343
23624	1812	188	109796	658	0	112454
23625	575	110493	1864	418	0	113350
23626	330	1838	625	106617	0	109410
23627	110884	592	327	1812	0	113615
23628	1881	349	109826	563	0	112619
23629	682	295	1952	98291	0	101220
23630	290	109215	752	1606	0	111863
23631	109695	1859	394	550	0	112498
23632	111840	624	382	359	0	113205
23633	2418	388	374	108911	0	112091
23634	781	114536	336	2054	0	117707
23635	410	118641	341	828	0	120220
23636	119237	2619	341	431	0	122628
23637	2287	984	351	114446	0	118068
23638	730	119770	390	2220	0	123110
23639	117637	2293	363	786	0	121079
23640	2273	804	369	120759	0	124205
23641	787	442	404	123414	0	125047
23642	565	426	115179	2898	0	119068
23643	326	120744	2159	1285	0	124514
23644	382	125790	822	672	0	127666
23645	385	2819	526	123241	0	126971
23646	123018	985	420	2385	0	126808
23647	2263	124153	430	996	0	127842
23648	122940	2434	373	521	0	126268
23649	2503	123693	405	522	0	127123
23650	939	2594	389	122399	0	126321
23651	123152	965	339	2381	0	126837
23652	2470	634	360	123624	0	127088
23653	1043	537	123905	2626	0	128111
23654	628	519	2396	116234	0	119777
23655	422	122576	947	2555	0	126500
23656	119786	2610	563	931	0	123890
23657	2420	121454	496	726	0	125096
23658	951	2695	472	115584	0	119702
23659	612	1073	465	121264	0	123414
23660	577	734	118383	2944	0	122638
23661	523	687	119343	1195	0	121748
23662	509	727	3080	116459	0	120775
23663	634	654	117889	2562	0	121739
23664	445	116544	2739	1231	0	120959
23665	116508	2619	1147	807	0	121081
23666	2601	1230	119916	644	0	124391
23667	115397	865	2620	673	0	119555
23668	121419	742	1160	666	0	123987
23669	120861	739	795	677	0	123072
23670	121150	739	709	680	0	123278
23671	3286	746	714	118080	0	122826
23672	1436	692	751	115269	0	118148
23673	813	117547	826	3128	0	122314
23674	114314	2660	906	1337	0	119217
23675	2756	1257	113905	890	0	118808
23676	1236	889	2769	110835	0	115729
23677	875	813	1424	113359	0	116471
23678	818	754	111324	3252	0	116148
23679	747	111654	2857	1553	0	116811
23680	762	2742	1306	107400	0	112210
23681	902	1247	905	113798	0	116852
23682	110258	913	744	3257	0	115172
23683	2663	110644	663	1720	0	115690
23684	1404	2631	652	107897	0	112584
23685	972	109426	688	2892	0	113978
23686	936	2746	693	111001	0	115376
23687	109495	1173	617	3100	0	114385
23688	110860	872	621	1510	0	113863
23689	3344	713	644	109352	0	114053
23690	108686	724	542	3046	0	112998
23691	108503	755	613	1473	0	111344
23692	3291	108359	598	1195	0	113443
23693	1678	2701	490	103010	0	107879
23694	1097	107170	601	2832	0	111700
23695	1052	2835	474	106752	0	111113
23696	105402	1363	483	3020	0	110268
23697	2846	1074	451	105220	0	109591
23698	1522	905	418	107460	0	110305
23699	1237	950	104195	3417	0	109799
23700	1068	100206	2228	1836	0	105338
23701	1039	104958	870	1269	0	108136
23702	100357	3043	561	1380	0	105341
23703	2507	1591	364	83951	0	88413
23704	78066	672	297	2065	0	81100
23705	2007	76029	316	1287	0	79639
23706	942	72910	302	861	0	75015
23707	680	75955	231	790	0	77656
23708	64893	1551	1305	685	0	68434
23709	1159	66122	318	531	0	68130
23710	62518	934	701	564	0	64717
23711	61200	343	174	411	0	62128
23712	62690	246	148	381	0	63465
23713	1029	212	155	65385	0	66781
23714	435	202	153	67468	0	68258
23715	340	169	138	68106	0	68753
23716	283	224	147	67949	0	68603
23717	66624	174	149	1327	0	68274
23718	1021	66184	169	590	0	67964
23719	459	936	130	66599	0	68124
23720	67211	319	151	1145	0	68826
23721	1046	208	131	66159	0	67544
23722	477	176	121	66932	0	67706
23723	65733	174	142	1282	0	67331
23724	1105	220	64763	556	0	66644
23725	451	197	839	64361	0	65848
23726	374	186	65960	1054	0	67574
23727	317	154	887	64387	0	65745
23728	296	296	285	65147	0	66024
23729	63099	140	167	1204	0	64610
23730	935	62446	167	557	0	64105
23731	355	62125	114	408	0	63002
23732	59353	761	109	284	0	60507
23733	714	61210	105	284	0	62313
23734	60947	578	140	355	0	62020
23735	881	215	59793	199	0	61088
23736	54743	92	380	165	0	55380
23737	56874	56	112	139	0	57181
23738	57108	48	56	162	0	57374
23739	531	65	37	55555	0	56188
23740	189	62	39	56051	0	56341
23741	90	55949	69	566	0	56674
23742	113	596	49	55324	0	56082
23743	54675	124	41	526	0	55366
23744	427	54920	52	245	0	55644
23745	111	54924	56	181	0	55272
23746	53800	437	45	128	0	54410
23747	441	165	53479	87	0	54172
23748	169	94	379	51738	0	52380
23749	138	129	54144	411	0	54822
23750	87	55	366	52637	0	53145
23751	77	54506	100	424	0	55107
23752	87	369	50	55393	0	55899
23753	54121	91	46	457	0	54715
23754	405	62	37	54211	0	54715
23755	170	89	56085	434	0	56778
23756	49783	65	438	256	0	50542
23757	482	57551	148	187	0	58368
23758	173	61312	61	175	0	61721
23759	63303	566	37	214	0	64120
23760	66734	197	50	169	0	67150
23761	938	129	67365	106	0	68538
23762	63269	93	760	160	0	64282
23763	819	67856	223	214	0	69112
23764	68722	760	90	171	0	69743
23765	876	249	49	65398	0	66572
23766	270	63673	70	815	0	64828
23767	64355	740	66	312	0	65473
23768	960	280	64102	154	0	65496
23769	316	134	773	63957	0	65180
23770	66103	98	211	959	0	67371
23771	946	147	65387	337	0	66817
23772	65054	110	814	258	0	66236
23773	914	117	232	65679	0	66942
23774	351	106	126	66979	0	67562
23775	281	143	66781	1072	0	68277
23776	190	85	835	65765	0	66875
23777	67062	82	265	1042	0	68451
23778	846	66521	153	459	0	67979
23779	67057	837	83	295	0	68272
23780	67616	280	81	245	0	68222
23781	1103	170	88	66731	0	68092
23782	430	164	68351	989	0	69934
23783	298	148	854	67388	0	68688
23784	68513	121	286	1033	0	69953
23785	932	68069	175	491	0	69667
23786	69737	872	125	302	0	71036
23787	1072	288	110	69306	0	70776
23788	426	159	112	70723	0	71420
23789	293	115	138	71381	0	71927
23790	264	148	69715	1274	0	71401
23791	232	159	921	69986	0	71298
23792	312	184	70427	1072	0	71995
23793	313	217	70437	412	0	71379
23794	256	176	1163	77607	0	79202
23795	347	200	79296	1364	0	81207
23796	84471	180	1393	702	0	86746
23797	1769	142	511	90532	0	92954
23798	863	141	298	88783	0	90085
23799	388	92240	255	2324	0	95207
23800	92994	1735	203	965	0	95897
23801	96287	772	183	579	0	97821
23802	2507	97834	198	508	0	101047
23803	1089	1842	164	98218	0	101313
23804	609	846	99010	1921	0	102386
23805	94296	319	1853	1018	0	97486
23806	100807	223	800	520	0	102350
23807	2698	266	373	95426	0	98763
23808	1247	263	93562	2001	0	97073
23809	555	92356	1872	1124	0	95907
23810	90625	1884	858	517	0	93884
23811	2284	813	91618	417	0	95132
23812	941	90932	1956	421	0	94250
23813	87439	1636	902	343	0	90320
23814	88004	706	353	377	0	89440
23815	2359	301	264	85982	0	88906
23816	1026	88676	280	1707	0	91689
23817	607	1741	208	92581	0	95137
23818	446	706	247	93750	0	95149
23819	390	367	236	93410	0	94403
23820	427	270	207	94078	0	94982
23821	512	221	91520	2711	0	94964
23822	448	255	1742	91697	0	94142
23823	419	290	797	94205	0	95711
23824	530	271	92354	2635	0	95790
23825	378	92209	1848	1378	0	95813
23826	92235	1828	825	734	0	95622
23827	93151	811	432	605	0	94999
23828	2563	361	372	92754	0	96050
23829	93406	264	369	2093	0	96132
23830	2256	273	293	94251	0	97073
23831	1238	260	95699	2334	0	99531
23832	845	308	95249	1301	0	97703
23833	543	94331	2552	926	0	98352
23834	93322	1875	1118	711	0	97026
23835	2350	965	99813	685	0	103813
23836	1216	475	2275	90868	0	94834
23837	776	386	1110	103988	0	106260
23838	640	313	568	106997	0	108518
23839	642	279	466	107214	0	108601
23840	654	348	429	107538	0	108969
23841	662	382	103408	3994	0	108446
23842	721	295	2461	104100	0	107577
23843	102696	387	1247	3215	0	107545
23844	2650	102090	674	2017	0	107431
23845	101821	2444	546	1075	0	105886
23846	2801	103262	535	984	0	107582
23847	103530	2704	472	892	0	107598
23848	106499	1272	508	900	0	109179
23849	3782	598	545	103080	0	108005
23850	1864	454	424	106304	0	109046
23851	103427	454	435	3830	0	108146
23852	101732	431	541	1941	0	104645
23853	102753	482	471	1248	0	104954
23854	3626	99408	513	1133	0	104680
23855	1719	101053	511	1096	0	104379
23856	1093	3079	98344	977	0	103493
23857	916	1780	2429	94735	0	99860
23858	844	713	95153	2984	0	99694
23859	679	92551	2568	1978	0	97776
23860	685	2211	1285	87529	0	91710
23861	624	1150	581	88667	0	91022
23862	662	582	474	90979	0	92697
23863	87906	472	445	3465	0	92288
23864	87838	429	424	1938	0	90629
23865	3077	87579	512	1326	0	92494
23866	1583	2034	508	88039	0	92164
23867	956	1161	87863	2619	0	92599
23868	869	640	85602	1568	0	88679
23869	85081	577	2929	1035	0	89622
23870	87856	455	1392	949	0	90652
23871	3169	420	694	86241	0	90524
23872	87437	378	573	2658	0	91046
23873	2635	455	85641	1739	0	90470
23874	1506	84969	2221	1387	0	90083
23875	889	2087	1302	85120	0	89398
23876	814	1142	87460	2677	0	92093
23877	704	638	2312	87154	0	90808
23878	771	459	1272	89400	0	91902
23879	762	507	88452	3554	0	93275
23880	82510	458	2218	2170	0	87356
23881	89437	424	1233	1495	0	92589
23882	3035	93360	665	1516	0	98576
23883	95903	2294	582	1284	0	100063
23884	98894	1239	532	1210	0	101875
23885	3801	655	97623	1154	0	103233
23886	94815	540	2493	1131	0	98979
23887	3241	101659	1388	1157	0	107445
23888	103597	2622	667	946	0	107832
23889	106813	1341	566	889	0	109609
23890	108961	816	473	864	0	111114
23891	106662	553	505	908	0	108628
23892	107184	560	475	987	0	109206
23893	4311	104843	563	1213	0	110930
23894	96983	2327	474	858	0	100642
23895	2895	96505	489	982	0	100871
23896	1134	85158	336	606	0	87234
23897	708	89728	429	628	0	91493
23898	87619	2425	936	566	0	91546
23899	87740	962	342	467	0	89511
23900	2752	482	86683	431	0	90348
23901	88211	377	1874	491	0	90953
23902	90197	333	827	517	0	91874
23903	3088	321	89476	479	0	93364
23904	1372	252	2224	87118	0	90966
23905	838	295	868	89458	0	91459
23906	706	311	403	92106	0	93526
23907	690	352	263	93528	0	94833
23908	761	267	303	93802	0	95133
23909	700	342	90382	3179	0	94603
23910	670	90260	2281	1456	0	94667
23911	87781	2286	904	626	0	91597
23912	2502	89305	482	617	0	92906
23913	89771	2407	337	458	0	92973
23914	89627	978	329	461	0	91395
23915	3343	528	86945	424	0	91240
23916	1503	457	2213	76564	0	80737
23917	795	83782	969	2154	0	87700
23918	84756	2211	498	956	0	88421
23919	86068	864	397	669	0	87998
23920	86262	462	373	484	0	87581
23921	3201	85587	362	597	0	89747
23922	86601	2235	328	449	0	89613
23923	87687	913	281	440	0	89321
23924	87654	521	250	418	0	88843
23925	3489	365	302	83501	0	87657
23926	1599	404	285	85929	0	88217
23927	1151	411	277	87421	0	89260
23928	84250	446	271	2933	0	87900
23929	2756	85358	298	1186	0	89598
23930	85424	2186	244	566	0	88420
23931	84325	886	287	381	0	85879
23932	82574	506	300	360	0	83740
23933	81696	432	239	342	0	82709
23934	3470	78951	310	503	0	83234
23935	71731	1914	194	260	0	74099
23936	2546	71021	228	393	0	74188
23937	1175	70118	178	360	0	71831
23938	68493	2044	175	312	0	71024
23939	2111	67340	171	390	0	70012
23940	1158	70144	142	356	0	71800
23941	69597	2039	313	290	0	72239
23942	70352	836	141	277	0	71606
23943	2454	584	149	67301	0	70488
23944	1285	497	133	69754	0	71669
23945	70190	474	135	2056	0	72855
23946	72448	465	179	808	0	73900
23947	71928	477	194	462	0	73061
23948	2678	467	68404	321	0	71870
23949	70502	468	1564	418	0	72952
23950	2329	466	567	70234	0	73596
23951	1305	418	298	71776	0	73797
23952	979	451	262	72162	0	73854
23953	933	407	232	73027	0	74599
23954	912	417	69735	2300	0	73364
23955	918	429	70721	979	0	73047
23956	876	414	1928	70436	0	73654
23957	893	463	70875	1988	0	74219
23958	929	456	71669	984	0	74038
23959	970	416	2061	69713	0	73160
23960	981	416	765	73638	0	75800
23961	931	416	485	74566	0	76398
23962	919	523	372	74852	0	76666
23963	73572	423	338	2509	0	76842
23964	76161	442	376	1244	0	78223
23965	2764	376	386	74200	0	77726
23966	1505	402	342	75234	0	77483
23967	1147	417	383	75490	0	77437
23968	1056	384	386	75202	0	77028
23969	1063	419	340	73847	0	75669
23970	1025	72964	379	2766	0	77134
23971	72707	1832	357	1324	0	76220
23972	2306	73931	314	1125	0	77676
23973	74273	1949	295	972	0	77489
23974	75270	858	300	943	0	77371
23975	75532	606	241	896	0	77275
23976	3052	520	270	71187	0	75029
23977	71578	517	266	2131	0	74492
23978	2751	510	204	70184	0	73649
23979	1668	700	215	70584	0	73167
23980	69445	522	227	2371	0	72565
23981	2592	67559	228	1201	0	71580
23982	1313	64100	165	781	0	66359
23983	62202	1635	184	629	0	64650
23984	2036	674	60124	542	0	63376
23985	54724	522	1247	584	0	57077
23986	2280	596	446	56377	0	59699
23987	1098	53135	209	1339	0	55781
23988	866	54690	147	710	0	56413
23989	53119	1364	114	649	0	55246
23990	1601	775	100	51517	0	53993
23991	801	54080	117	1221	0	56219
23992	53207	953	156	629	0	54945
23993	53309	434	85	495	0	54323
23994	53415	327	81	462	0	54285
23995	53364	310	85	442	0	54201
23996	1513	50721	112	427	0	52773
23997	557	49425	84	300	0	50366
23998	49362	803	53	259	0	50477
23999	50919	363	129	300	0	51711
24000	1203	261	49194	228	0	50886
24001	336	46426	491	223	0	47476
24002	45781	457	214	129	0	46581
24003	47936	149	45	103	0	48233
24004	730	146	48470	91	0	49437
24005	46487	121	604	143	0	47355
24006	767	92	50825	81	0	51765
24007	207	69	55056	76	0	55408
24008	153	160	839	48545	0	49697
24009	85	53709	246	748	0	54788
24010	56035	770	86	275	0	57166
24011	831	220	38	56084	0	57173
24012	268	89	44	57012	0	57413
24013	150	59	48	57941	0	58198
24014	56460	56	50	1100	0	57666
24015	857	50	41	56907	0	57855
24016	307	42	42	59074	0	59465
24017	203	68	58352	1028	0	59651
24018	55470	55	871	414	0	56810
24019	59747	69	211	192	0	60219
24020	1231	89	59388	122	0	60830
24021	56473	59	989	115	0	57636
24022	1089	63	272	56110	0	57534
24023	334	57860	126	1016	0	59336
24024	209	971	79	58411	0	59670
24025	56898	246	87	1067	0	58298
24026	991	58309	99	384	0	59783
24027	367	972	70	58823	0	60232
24028	233	250	78	60075	0	60636
24029	185	135	86	59954	0	60360
24030	210	102	82	55594	0	55988
24031	169	59693	97	1247	0	61206
24032	59932	1041	73	401	0	61447
24033	60650	285	91	289	0	61315
24034	1346	62449	93	331	0	64219
24035	67468	1152	78	217	0	68915
24036	69810	339	83	214	0	70446
24037	69132	154	97	220	0	69603
24038	1989	113	66598	235	0	68935
24039	723	119	1427	66047	0	68316
24040	370	132	66344	1542	0	68388
24041	63874	114	1500	565	0	66053
24042	1569	66513	480	401	0	68963
24043	64532	1425	229	245	0	66431
24044	1607	66767	170	313	0	68857
24045	675	1524	162	62781	0	65142
24046	478	471	166	65094	0	66209
24047	402	282	65110	1845	0	67639
24048	313	65768	1560	831	0	68472
24049	64849	1561	597	394	0	67401
24050	1830	542	65221	288	0	67881
24051	63940	298	1592	337	0	66167
24052	1848	226	551	64874	0	67499
24053	906	230	65337	1754	0	68227
24054	471	64763	1658	879	0	67771
24055	450	1591	553	64909	0	67503
24056	462	589	65596	1754	0	68401
24057	556	359	65869	716	0	67500
24058	477	63783	1994	542	0	66796
24059	564	1596	700	62116	0	64976
24060	550	571	377	60020	0	61518
24061	489	62436	331	1980	0	65236
24062	62523	1597	311	768	0	65199
24063	1867	624	344	59982	0	62817
24064	873	61067	359	1763	0	64062
24065	62138	1593	371	838	0	64940
24066	62278	646	375	567	0	63866
24067	63086	408	371	554	0	64419
24068	2303	61663	357	615	0	64938
24069	62949	1706	344	574	0	65573
24070	63645	723	351	618	0	65337
24071	2377	473	332	61542	0	64724
24072	62286	373	326	2025	0	65010
24073	2128	467	272	62385	0	65252
24074	1100	374	61628	2141	0	65243
24075	831	343	63145	1057	0	65376
24076	698	391	2107	62597	0	65793
24077	740	375	63545	2135	0	66795
24078	60400	484	1906	1097	0	63887
24079	2165	352	813	63894	0	67224
24080	1120	345	493	65588	0	67546
24081	828	416	63644	2462	0	67350
24082	655	61801	1882	1223	0	65561
24083	746	65149	784	845	0	67524
24084	712	2172	532	61723	0	65139
24085	718	870	431	64185	0	66204
24086	679	595	62232	2355	0	65861
24087	698	547	63865	1087	0	66197
24088	709	503	2128	62884	0	66224
24089	764	454	62590	2220	0	66028
24090	60509	528	1926	989	0	63952
24091	2229	524	725	62213	0	65691
24092	62630	519	495	2157	0	65801
24093	2267	495	416	62233	0	65411
24094	1134	468	436	64218	0	66256
24095	910	469	62078	2481	0	65938
24096	747	62540	1936	1208	0	66431
24097	839	1886	849	62405	0	65979
24098	749	820	62395	2090	0	66054
24099	679	59918	1890	1040	0	63527
24100	779	1836	888	60253	0	63756
24101	60659	732	545	1936	0	63872
24102	1987	437	60702	990	0	64116
24103	55241	299	1805	708	0	58053
24104	1881	327	56217	552	0	58977
24105	49031	248	1665	485	0	51429
24106	1542	51738	790	518	0	54588
24107	544	48507	431	437	0	49919
24108	478	1697	372	44794	0	47341
24109	259	47107	344	1207	0	48917
24110	45887	1180	336	705	0	48108
24111	1123	486	318	46389	0	48316
24112	478	319	300	47419	0	48516
24113	313	236	291	47976	0	48816
24114	297	239	46038	1582	0	48156
24115	288	250	1188	45745	0	47471
24116	420	228	45262	1373	0	47283
24117	262	43984	1247	736	0	46229
24118	41151	918	473	424	0	42966
24119	1002	43446	312	387	0	45147
24120	44401	936	278	466	0	46081
24121	45125	403	234	393	0	46155
24122	45282	239	245	408	0	46174
24123	44645	197	261	403	0	45506
24124	1303	225	42851	368	0	44747
24125	529	207	1015	42261	0	44012
24126	336	210	491	43594	0	44631
24127	319	213	348	44100	0	44980
24128	40883	222	271	1331	0	42707
24129	41392	192	263	667	0	42514
24130	1224	42676	263	553	0	44716
24131	601	814	41193	340	0	42948
24132	553	297	41509	320	0	42679
24133	307	40649	1101	403	0	42460
24134	252	40278	463	386	0	41379
24135	855	838	764	33050	0	35507
24136	195	193	151	33063	0	33602
24137	32980	132	131	604	0	33847
24138	451	33117	154	334	0	34056
24139	237	438	130	34108	0	34913
24140	203	185	35200	517	0	36105
24141	163	113	477	36224	0	36977
24142	150	96	248	37269	0	37763
24143	170	87	174	37523	0	37954
24144	169	84	126	37307	0	37686
24145	209	104	36071	673	0	37057
24146	157	34935	500	390	0	35982
24147	138	35686	216	222	0	36262
24148	33467	449	140	176	0	34232
24149	390	34174	133	159	0	34856
24150	188	35909	117	153	0	36367
24151	202	463	124	35194	0	35983
24152	152	192	103	35812	0	36259
24153	164	116	124	35784	0	36188
24154	194	118	35603	514	0	36429
24155	137	35167	387	328	0	36019
24156	151	381	170	34339	0	35041
24157	132	35634	142	419	0	36327
24158	35230	368	98	239	0	35935
24159	381	35402	118	228	0	36129
24160	35161	393	128	184	0	35866
24161	418	168	34345	186	0	35117
24162	34155	148	387	197	0	34887
24163	404	160	156	35225	0	35945
24164	215	157	35718	422	0	36512
24165	34006	131	356	242	0	34735
24166	35542	138	133	171	0	35984
24167	35601	124	116	175	0	36016
24168	481	138	101	34595	0	35315
24169	236	117	35115	465	0	35933
24170	32975	116	406	272	0	33769
24171	423	124	160	36006	0	36713
24172	208	128	123	36404	0	36863
24173	199	145	36476	502	0	37322
24174	150	36356	321	281	0	37108
24175	160	448	134	34937	0	35679
24176	142	36357	108	354	0	36961
24177	35353	366	177	181	0	36077
24178	35339	139	86	171	0	35735
24179	429	98	86	34683	0	35296
24180	34722	96	83	393	0	35294
24181	351	34508	75	228	0	35162
24182	34278	298	71	172	0	34819
24183	363	34660	81	152	0	35256
24184	208	312	84	34705	0	35309
24185	152	207	87	34274	0	34720
24186	129	34820	82	389	0	35420
24187	124	352	89	34509	0	35074
24188	172	115	33955	398	0	34640
24189	99	33014	288	229	0	33630
24190	31085	228	89	129	0	31531
24191	227	31643	75	144	0	32089
24192	103	286	58	31267	0	31714
24193	120	108	31338	263	0	31829
24194	89	96	207	31326	0	31718
24195	88	77	60	32227	0	32452
24196	30632	58	66	364	0	31120
24197	296	69	31588	155	0	32108
24198	101	31578	241	227	0	32147
24199	118	301	33487	102	0	34008
24200	109	105	33604	107	0	33925
24201	102	81	33341	98	0	33622
24202	172	318	395	30910	0	31795
24203	33934	47	185	345	0	34511
24204	298	33947	60	152	0	34457
24205	34878	323	38	106	0	35345
24206	35993	101	39	177	0	36310
24207	383	68	28	34841	0	35320
24208	91	36059	27	352	0	36529
24209	35256	328	40	129	0	35753
24210	290	36022	45	114	0	36471
24211	95	354	33	35275	0	35757
24212	79	103	32	37101	0	37315
24213	52	37044	55	437	0	37588
24214	62	345	41	37223	0	37671
24215	100	109	35952	379	0	36540
24216	79	98	36425	102	0	36704
24217	62	46	362	36400	0	36870
24218	49	54	98	37374	0	37575
24219	89	59	35442	386	0	35976
24220	81	58	34522	129	0	34790
24221	30574	62	404	110	0	31150
24222	359	34189	98	103	0	34749
24223	111	36553	77	148	0	36889
24224	103	404	68	34696	0	35271
24225	74	114	57	35264	0	35509
24226	86	70	42	35976	0	36174
24227	113	65	35330	414	0	35922
24228	107	60	34880	141	0	35188
24229	78	61	382	35589	0	36110
24230	116	83	35672	376	0	36247
24231	60	34885	381	252	0	35578
24232	34799	350	208	123	0	35480
24233	415	111	34801	101	0	35428
24234	163	79	34888	109	0	35239
24235	115	94	419	34316	0	34944
24236	123	85	38849	449	0	39506
24237	102	39504	470	239	0	40315
24238	134	511	139	40561	0	41345
24239	155	152	40326	567	0	41200
24240	81	39062	512	203	0	39858
24241	38287	503	149	182	0	39121
24242	466	147	87	38087	0	38787
24243	140	126	74	38653	0	38993
24244	38417	82	75	553	0	39127
24245	469	38305	64	278	0	39116
24246	38762	474	67	179	0	39482
24247	38867	146	74	116	0	39203
24248	38905	110	73	105	0	39193
24249	598	73	74	37960	0	38705
24250	36871	62	93	513	0	37539
24251	507	35521	110	191	0	36329
24252	158	37000	102	165	0	37425
24253	37384	566	109	134	0	38193
24254	529	182	86	37939	0	38736
24255	177	117	85	38363	0	38742
24256	119	111	70	38670	0	38970
24257	126	105	37149	691	0	38071
24258	87	37190	533	290	0	38100
24259	88	542	175	38247	0	39052
24260	38187	166	124	635	0	39112
24261	549	132	123	38331	0	39135
24262	215	126	38237	638	0	39216
24263	110	38105	581	286	0	39082
24264	38647	535	210	216	0	39608
24265	38771	186	180	176	0	39313
24266	38689	148	144	164	0	39145
24267	711	105	156	38450	0	39422
24268	294	122	39176	598	0	40190
24269	229	110	41263	268	0	41870
24270	138	42363	787	225	0	43513
24271	158	764	257	42508	0	43687
24272	130	228	159	43441	0	43958
24273	41585	134	135	884	0	42738
24274	737	145	105	42232	0	43219
24275	43008	134	109	860	0	44111
24276	877	123	42438	321	0	43759
24277	339	106	43051	261	0	43757
24278	221	91	875	42229	0	43416
24279	191	89	270	43427	0	43977
24280	165	96	194	44603	0	45058
24281	45502	89	153	1013	0	46757
24282	47911	102	136	392	0	48541
24283	1113	127	117	48155	0	49512
24284	399	110	47486	1050	0	49045
24285	283	105	48429	381	0	49198
24286	201	107	1154	48025	0	49487
24287	49310	82	383	1130	0	50905
24288	989	101	231	48649	0	49970
24289	338	119	189	49935	0	50581
24290	240	129	49238	1304	0	50911
24291	245	104	48982	489	0	49820
24292	46457	106	1238	308	0	48109
24293	1081	119	48771	281	0	50252
24294	435	89	1051	46626	0	48201
24295	283	89	371	48047	0	48790
24296	47571	78	215	1207	0	49071
24297	1036	46962	209	509	0	48716
24298	46293	921	190	352	0	47756
24299	999	44752	115	287	0	46153
24300	43723	853	143	253	0	44972
24301	1015	310	42970	235	0	44530
24302	38771	221	1146	229	0	40367
24303	40911	87	303	175	0	41476
24304	1074	170	182	40502	0	41928
24305	455	67	40500	889	0	41911
24306	254	69	817	38506	0	39646
24307	203	77	305	38839	0	39424
24308	187	38616	206	1078	0	40087
24309	194	766	145	37497	0	38602
24310	192	38245	147	979	0	39563
24311	217	789	133	38196	0	39335
24312	37662	262	142	969	0	39035
24313	909	133	135	37847	0	39024
24314	399	94	37604	978	0	39075
24315	36644	105	836	461	0	38046
24316	948	91	38611	333	0	39983
24317	38066	83	919	293	0	39361
24318	39346	74	352	303	0	40075
24319	1154	38562	271	428	0	40415
24320	444	40992	231	269	0	41936
24321	40649	1015	199	256	0	42119
24322	41837	323	201	282	0	42643
24323	40951	153	183	272	0	41559
24324	40845	109	181	307	0	41442
24325	41031	89	153	303	0	41576
24326	1289	100	178	39860	0	41427
24327	574	100	161	40960	0	41795
24328	364	134	40301	1185	0	41984
24329	38892	107	1016	471	0	40486
24330	1089	109	360	39601	0	41159
24331	464	162	239	40682	0	41547
24332	382	112	40373	1266	0	42133
24333	353	39176	1004	583	0	41116
24334	351	40614	390	420	0	41775
24335	39141	1056	359	469	0	41025
24336	36269	376	246	262	0	37153
24337	1124	34276	233	277	0	35910
24338	425	34440	179	261	0	35305
24339	34251	888	195	265	0	35599
24340	35363	250	161	309	0	36083
24341	1073	151	160	34483	0	35867
24342	466	95	157	35090	0	35808
24343	341	100	173	35966	0	36580
24344	34998	98	167	1129	0	36392
24345	35444	129	175	470	0	36218
24346	1077	132	164	35593	0	36966
24347	36517	110	179	986	0	37792
24348	1116	131	36818	439	0	38504
24349	491	134	881	36951	0	38457
24350	396	130	36951	1010	0	38487
24351	292	36453	937	471	0	38153
24352	343	877	449	36260	0	37929
24353	36028	259	299	938	0	37524
24354	1015	151	154	35831	0	37151
24355	478	126	150	36438	0	37192
24356	372	131	35745	1106	0	37354
24357	399	148	36232	468	0	37247
24358	406	36484	972	353	0	38215
24359	36608	833	319	263	0	38023
24360	37169	294	173	239	0	37875
24361	37007	181	149	236	0	37573
24362	37219	174	118	279	0	37790
24363	1278	121	126	36346	0	37871
24364	592	142	136	35491	0	36361
24365	412	36933	117	1075	0	38537
24366	36991	812	183	433	0	38419
24367	37083	266	153	331	0	37833
24368	1154	184	35332	227	0	36897
24369	30268	120	680	169	0	31237
24370	867	31847	261	194	0	33169
24371	459	1003	126	30225	0	31813
24372	285	31834	104	689	0	32912
24373	31385	761	125	331	0	32602
24374	808	31642	96	218	0	32764
24375	368	671	111	30531	0	31681
24376	244	271	72	31042	0	31629
24377	251	134	64	30366	0	30815
24378	230	29939	83	905	0	31157
24379	277	874	88	29856	0	31095
24380	355	485	116	29049	0	30005
24381	158	26925	82	755	0	27920
24382	148	25896	82	283	0	26409
24383	24250	499	50	171	0	24970
24384	507	24648	67	178	0	25400
24385	23549	430	68	147	0	24194
24386	523	176	23151	102	0	23952
24387	205	22900	389	129	0	23623
24388	22781	417	164	141	0	23503
24389	22794	134	56	131	0	23115
24390	533	116	22624	113	0	23386
24391	258	91	360	21917	0	22626
24392	196	80	22994	424	0	23694
24393	135	22677	394	222	0	23428
24394	22271	428	157	166	0	23022
24395	411	22253	100	151	0	22915
24396	177	401	57	21993	0	22628
24397	176	145	46	22499	0	22866
24398	147	97	22219	482	0	22945
24399	150	103	21782	216	0	22251
24400	20656	70	448	187	0	21361
24401	22089	84	127	135	0	22435
24402	22114	85	89	128	0	22416
24403	22012	65	81	136	0	22294
24404	508	22090	100	126	0	22824
24405	229	407	56	21933	0	22625
24406	197	136	60	22063	0	22456
24407	148	22700	71	492	0	23411
24408	23030	400	74	216	0	23720
24409	23210	142	64	173	0	23589
24410	526	120	23045	137	0	23828
24411	22963	94	419	129	0	23605
24412	512	93	156	23176	0	23937
24413	240	105	23145	431	0	23921
24414	227	151	402	22738	0	23518
24415	172	87	23561	493	0	24313
24416	140	104	22722	174	0	23140
24417	145	292	422	21096	0	21955
24418	93	21928	181	360	0	22562
24419	21695	356	102	153	0	22306
24420	20886	124	73	110	0	21193
24421	419	22646	65	157	0	23287
24422	168	23260	69	107	0	23604
24423	23896	373	57	159	0	24485
24424	24192	142	64	94	0	24492
24425	24200	108	59	80	0	24447
24426	24238	72	48	86	0	24444
24427	497	66	38	24341	0	24942
24428	209	68	24080	330	0	24687
24429	131	24187	296	173	0	24787
24430	23842	308	125	106	0	24381
24431	306	25023	62	117	0	25508
24432	24476	300	53	75	0	24904
24433	24449	112	35	65	0	24661
24434	404	89	25210	60	0	25763
24435	155	26598	267	79	0	27099
24436	121	350	94	26556	0	27121
24437	87	107	59	27005	0	27258
24438	75	87	43	26630	0	26835
24439	26249	63	34	373	0	26719
24440	25155	59	41	150	0	25405
24441	25448	58	59	120	0	25685
24442	361	25719	56	185	0	26321
24443	25150	254	30	74	0	25508
24444	276	25543	49	118	0	25986
24445	128	277	25317	83	0	25805
24446	77	25308	232	100	0	25717
24447	179	374	192	23690	0	24435
24448	44	52	37	23447	0	23580
24449	77	42	23356	181	0	23656
24450	56	33	164	22399	0	22652
24451	53	34	47	23349	0	23483
24452	23558	37	41	225	0	23861
24453	23164	30	28	83	0	23305
24454	23488	34	39	56	0	23617
24455	220	23836	52	63	0	24171
24456	23744	171	27	60	0	24002
24457	22813	52	29	59	0	22953
24458	208	23684	46	93	0	24031
24459	118	173	39	23448	0	23778
24460	86	66	35	23677	0	23864
24461	23389	51	39	230	0	23709
24462	227	54	23123	100	0	23504
24463	82	22574	180	110	0	22946
24464	90	273	50	21525	0	21938
24465	67	21792	32	159	0	22050
24466	71	22667	22	78	0	22838
24467	22529	170	65	53	0	22817
24468	22359	59	26	52	0	22496
24469	192	57	29	22707	0	22985
24470	91	42	31	22486	0	22650
24471	70	40	23	22565	0	22698
24472	58	40	37	22419	0	22554
24473	70	53	21948	187	0	22258
24474	64	66	20849	81	0	21060
24475	83	40	153	22008	0	22284
24476	102	63	23706	177	0	24048
24477	73	24059	170	93	0	24395
24478	24303	167	42	72	0	24584
24479	24501	58	45	77	0	24681
24480	221	49	30	24795	0	25095
24481	101	45	26	25011	0	25183
24482	85	39	29	25102	0	25255
24483	61	25519	57	235	0	25872
24484	25732	176	40	105	0	26053
24485	25515	79	32	101	0	25727
24486	265	73	25673	61	0	26072
24487	106	44	183	26711	0	27044
24488	122	72	28443	297	0	28934
24489	73	52	255	31028	0	31408
24490	74	55	60	31386	0	31575
24491	88	52	49	31610	0	31799
24492	83	57	36	32178	0	32354
24493	32333	43	35	576	0	32987
24494	32707	43	40	229	0	33019
24495	33613	52	38	136	0	33839
24496	658	50	36	33598	0	34342
24497	268	74	33273	499	0	34114
24498	31649	48	451	217	0	32365
24499	542	58	161	33683	0	34444
24500	33780	57	70	526	0	34433
24501	543	73	39	33607	0	34262
24502	217	33146	55	551	0	33969
24503	132	34787	41	267	0	35227
24504	127	535	59	34649	0	35370
24505	120	189	38	34614	0	34961
24506	118	73	41	34463	0	34695
24507	86	34174	47	672	0	34979
24508	33447	472	37	248	0	34204
24509	489	33859	50	211	0	34609
24510	210	478	33724	132	0	34544
24511	100	175	484	32843	0	33602
24512	68	34823	155	564	0	35610
24513	99	522	84	34558	0	35263
24514	95	188	42	34828	0	35153
24515	115	103	34382	728	0	35328
24516	30651	55	528	341	0	31575
24517	535	34820	167	245	0	35767
24518	35173	491	74	187	0	35925
24519	35803	166	54	172	0	36195
24520	35904	78	58	170	0	36210
24521	790	73	33796	144	0	34803
24522	310	57	549	32689	0	33605
24523	201	69	179	33338	0	33787
24524	170	79	32642	757	0	33648
24525	28823	70	583	355	0	29831
24526	654	86	32923	221	0	33884
24527	274	85	32258	193	0	32810
24528	140	32431	654	240	0	33465
24529	156	573	229	31980	0	32938
24530	159	198	32643	609	0	33609
24531	29617	101	527	305	0	30550
24532	30997	81	208	187	0	31473
24533	706	94	31509	147	0	32456
24534	256	108	537	30829	0	31730
24535	195	92	31653	590	0	32530
24536	110	31828	569	325	0	32832
24537	33234	522	208	234	0	34198
24538	33782	199	115	192	0	34288
24539	33868	112	95	183	0	34258
24540	778	90	107	33460	0	34435
24541	290	91	98	34455	0	34934
24542	195	94	33889	807	0	34985
24543	32359	73	616	312	0	33360
24544	688	94	195	33830	0	34807
24545	33583	72	145	697	0	34497
24546	735	65	33885	335	0	35020
24547	326	91	34984	209	0	35610
24548	228	64	768	32844	0	33904
24549	186	64	292	35162	0	35704
24550	223	96	34861	812	0	35992
24551	32879	74	689	364	0	34006
24552	736	92	311	33045	0	34184
24553	298	35516	215	675	0	36704
24554	35496	606	205	332	0	36639
24555	669	36410	179	264	0	37522
24556	36296	655	167	245	0	37363
24557	832	235	36913	215	0	38195
24558	427	116	36184	191	0	36918
24559	213	36716	806	254	0	37989
24560	36625	651	328	188	0	37792
24561	769	252	36550	169	0	37740
24562	34541	126	707	163	0	35537
24563	786	36498	293	201	0	37778
24564	367	627	193	36687	0	37874
24565	244	238	191	35530	0	36203
24566	187	36825	181	812	0	38005
24567	38067	636	184	353	0	39240
24568	38810	220	159	227	0	39416
24569	39483	127	177	216	0	40003
24570	1020	148	39618	162	0	40948
24571	407	112	722	38962	0	40203
24572	251	110	304	40114	0	40779
24573	233	78	225	40857	0	41393
24574	241	91	40105	951	0	41388
24575	216	39065	768	526	0	40575
24576	37476	677	313	227	0	38693
24577	825	254	38267	187	0	39533
24578	36503	140	790	171	0	37604
24579	773	38121	317	214	0	39425
24580	38215	712	232	177	0	39336
24581	837	312	191	37744	0	39084
24582	38436	150	222	763	0	39571
24583	883	135	174	38302	0	39494
24584	423	117	39247	727	0	40514
24585	322	280	752	38399	0	39753
24586	262	145	38704	739	0	39850
24587	34187	113	721	314	0	35335
24588	674	36359	313	240	0	37586
24589	298	528	146	31384	0	32356
24590	176	34213	157	427	0	34973
24591	33812	449	182	177	0	34620
24592	33389	160	168	142	0	33859
24593	535	33465	126	139	0	34265
24594	33126	388	157	133	0	33804
24595	33661	121	132	138	0	34052
24596	456	83	75	33008	0	33622
24597	189	72	104	33649	0	34014
24598	34695	79	93	460	0	35327
24599	34962	79	85	151	0	35277
24600	536	80	96	34322	0	35034
24601	238	66	85	37238	0	37627
24602	37769	67	111	580	0	38527
24603	619	94	37452	173	0	38338
24604	35073	69	532	166	0	35840
24605	620	89	36937	158	0	37804
24606	221	36454	551	162	0	37388
24607	175	491	198	35982	0	36846
24608	229	141	37629	509	0	38508
24609	155	38975	549	223	0	39902
24610	38787	507	200	216	0	39710
24611	573	173	39365	106	0	40217
24612	37625	106	488	134	0	38353
24613	39714	97	173	135	0	40119
24614	39987	95	97	174	0	40353
24615	686	114	77	36655	0	37532
24616	259	40584	114	433	0	41390
24617	40249	446	90	216	0	41001
24618	585	145	40477	125	0	41332
24619	36477	87	480	181	0	37225
24620	555	74	40283	142	0	41054
24621	218	39761	448	240	0	40667
24622	179	425	159	40001	0	40764
24623	153	187	123	39534	0	39997
24624	180	40037	121	608	0	40946
24625	157	450	146	40607	0	41360
24626	201	180	40545	496	0	41422
24627	173	40816	471	240	0	41700
24628	200	488	177	40130	0	40995
24629	40127	179	98	508	0	40912
24630	41616	123	90	206	0	42035
24631	716	88	93	42035	0	42932
24632	280	43691	114	596	0	44681
24633	239	537	107	43501	0	44384
24634	231	182	103	43232	0	43748
24635	261	105	40724	734	0	41824
24636	211	41646	524	363	0	42744
24637	222	513	176	40904	0	41815
24638	228	172	40497	549	0	41446
24639	140	40269	514	283	0	41206
24640	174	510	207	40326	0	41217
24641	40517	179	179	520	0	41395
24642	569	41520	114	262	0	42465
24643	284	522	77	41523	0	42406
24644	42629	191	86	589	0	43495
24645	42700	134	92	270	0	43196
24646	42733	104	77	202	0	43116
24647	42026	95	96	173	0	42390
24648	699	138	97	41526	0	42460
24649	331	99	42296	553	0	43279
24650	238	138	493	40116	0	40985
24651	177	41918	208	561	0	42864
24652	42533	479	137	270	0	43419
24653	596	219	41076	151	0	42042
24654	38930	106	476	139	0	39651
24655	567	128	40312	140	0	41147
24656	239	94	460	39472	0	40265
24657	244	121	40800	483	0	41648
24658	196	131	458	39602	0	40387
24659	220	119	40580	518	0	41437
24660	180	93	479	39511	0	40263
24661	40265	107	144	566	0	41082
24662	528	42451	131	293	0	43403
24663	269	477	108	42484	0	43338
24664	238	179	120	42791	0	43328
24665	252	126	43732	593	0	44703
24666	240	107	42381	236	0	42964
24667	39279	100	589	237	0	40205
24668	518	41917	236	206	0	42877
24669	41383	386	115	147	0	42031
24670	41843	154	153	187	0	42337
24671	550	129	113	40057	0	40849
24672	230	42218	142	437	0	43027
24673	43142	400	105	275	0	43922
24674	43453	156	116	194	0	43919
24675	44109	105	89	217	0	44520
24676	43972	107	102	143	0	44324
24677	43409	68	114	178	0	43769
24678	603	99	42552	122	0	43376
24679	41965	93	436	124	0	42618
24680	557	83	42788	141	0	43569
24681	253	97	437	41701	0	42488
24682	182	75	164	43437	0	43858
24683	181	92	42960	550	0	43783
24684	40592	80	438	258	0	41368
24685	496	75	169	43401	0	44141
24686	228	98	128	44046	0	44500
24687	167	93	88	44340	0	44688
24688	174	70	93	43917	0	44254
24689	166	86	87	44411	0	44750
24690	189	107	44498	667	0	45461
24691	148	87	493	43758	0	44486
24692	180	94	44805	614	0	45693
24693	194	100	43987	259	0	44540
24694	43227	84	687	216	0	44214
24695	45722	78	280	180	0	46260
24696	48750	61	166	188	0	49165
24697	1054	89	50477	167	0	51787
24698	387	77	51045	157	0	51666
24699	241	87	52193	178	0	52699
24700	162	53309	1159	270	0	54900
24701	431	1065	657	51371	0	53524
24702	54442	276	186	899	0	55803
24703	958	114	104	56438	0	57614
24704	365	58338	114	1080	0	59897
24705	58937	979	135	414	0	60465
24706	1088	335	99	57871	0	59393
24707	395	59547	136	1127	0	61205
24708	222	1008	104	59874	0	61208
24709	177	372	127	59573	0	60249
24710	57833	115	132	1408	0	59488
24711	1104	90	136	57958	0	59288
24712	463	103	57424	1173	0	59163
24713	269	91	1064	56004	0	57428
24714	187	55632	397	1184	0	57400
24715	224	57541	207	578	0	58550
24716	157	1294	146	55074	0	56671
24717	163	425	165	54235	0	54988
24718	157	54615	156	1398	0	56326
24719	168	55564	158	547	0	56437
24720	153	56235	141	332	0	56861
24721	238	1472	113	49942	0	51765
24722	156	55117	171	1106	0	56550
24723	54454	1179	135	479	0	56247
24724	1178	460	55533	326	0	57497
24725	468	319	1078	52382	0	54247
24726	231	55770	399	1190	0	57590
24727	55021	1153	197	516	0	56887
24728	1269	461	55164	343	0	57237
24729	451	55334	1109	401	0	57295
24730	53251	1136	417	313	0	55117
24731	1000	53022	247	307	0	54576
24732	395	54090	189	335	0	55009
24733	292	1522	177	51799	0	53790
24734	190	53728	156	1105	0	55179
24735	52840	1149	163	504	0	54656
24736	1074	487	125	52700	0	54386
24737	466	291	52550	1172	0	54479
24738	291	311	52513	546	0	53661
24739	208	305	1161	52027	0	53701
24740	250	282	53313	1180	0	55025
24741	211	266	1049	53079	0	54605
24742	51829	269	376	1274	0	53748
24743	1139	271	52384	546	0	54340
24744	464	225	1017	50308	0	52014
24745	238	51470	441	1162	0	53311
24746	210	1100	238	51993	0	53541
24747	248	479	206	51902	0	52835
24748	240	52835	222	1411	0	54708
24749	263	1123	241	53413	0	55040
24750	203	521	273	54141	0	55138
24751	246	396	53085	1425	0	55152
24752	155	52581	1095	755	0	54586
24753	52511	1227	425	495	0	54658
24754	1085	564	254	53038	0	54941
24755	517	394	53985	1294	0	56190
24756	260	363	1086	53187	0	54896
24757	279	388	53334	1332	0	55333
24758	50014	342	1159	704	0	52219
24759	1035	53394	531	539	0	55499
24760	524	1225	325	53487	0	55561
24761	390	634	258	55140	0	56422
24762	51967	376	316	1538	0	54197
24763	1188	381	288	52672	0	54529
24764	574	393	52237	1407	0	54611
24765	342	406	1133	49375	0	51256
24766	271	49847	544	1407	0	52069
24767	247	51881	353	811	0	53292
24768	254	52592	266	687	0	53799
24769	291	1621	241	51027	0	53180
24770	337	729	50261	1456	0	52783
24771	203	50423	1123	836	0	52585
24772	48753	1350	453	579	0	51135
24773	1039	50376	289	632	0	52336
24774	50460	1370	254	583	0	52667
24775	50733	606	267	555	0	52161
24776	1325	453	49518	562	0	51858
24777	50226	404	1181	567	0	52378
24778	53156	423	494	620	0	54693
24779	53471	422	304	526	0	54723
24780	53587	422	318	497	0	54824
24781	1463	449	52827	502	0	55241
24782	51246	402	1130	458	0	53236
24783	53270	463	536	443	0	54712
24784	1337	54067	300	445	0	56149
24785	578	1284	186	52714	0	54762
24786	369	677	258	52838	0	54142
24787	346	53755	233	1402	0	55736
24788	52601	1221	247	621	0	54690
24789	1105	53334	360	456	0	55255
24790	51748	1200	320	337	0	53605
24791	51798	544	225	383	0	52950
24792	1306	52754	284	424	0	54768
24793	595	1102	251	52746	0	54694
24794	514	435	52918	1174	0	55041
24795	371	51520	1048	625	0	53564
24796	426	1357	409	46241	0	48433
24797	261	47909	257	787	0	49214
24798	226	50637	194	459	0	51516
24799	352	1222	333	47754	0	49661
24800	356	348	49140	902	0	50746
24801	168	47369	830	417	0	48784
24802	156	46639	331	251	0	47377
24803	40430	745	156	118	0	41449
24804	499	267	62	42316	0	43144
24805	205	209	30	42577	0	43021
24806	78	86	39	43858	0	44061
24807	111	91	43501	882	0	44585
24808	93	63	609	43456	0	44221
24809	46	45725	232	747	0	46750
24810	47969	693	98	263	0	49023
24811	775	260	47	47954	0	49036
24812	311	146	47715	797	0	48969
24813	47398	68	776	315	0	48557
24814	884	79	256	49758	0	50977
24815	370	78	53025	894	0	54367
24816	156	92	53547	336	0	54131
24817	52709	67	1173	143	0	54092
24818	56680	66	359	153	0	57258
24819	56587	67	126	113	0	56893
24820	57372	62	98	135	0	57667
24821	1445	88	56460	104	0	58097
24822	456	57207	989	146	0	58798
24823	56781	1037	336	110	0	58264
24824	1022	56958	124	167	0	58271
24825	55757	1092	107	119	0	57075
24826	1056	57181	91	165	0	58493
24827	421	1097	75	56621	0	58214
24828	169	407	90	57288	0	57954
24829	155	170	92	56315	0	56732
24830	157	55580	100	1464	0	57301
24831	131	57232	112	562	0	58037
24832	166	1329	107	53173	0	54775
24833	157	55149	127	1106	0	56539
24834	220	1123	54923	396	0	56662
24835	171	445	1054	54532	0	56202
24836	208	239	55571	1148	0	57166
24837	53280	179	1143	491	0	55093
24838	55434	163	464	265	0	56326
24839	1452	210	55103	240	0	57005
24840	577	214	54779	259	0	55829
24841	291	222	1379	53641	0	55533
24842	309	221	54588	1199	0	56317
24843	246	260	1167	50537	0	52210
24844	214	52014	512	1172	0	53912
24845	256	1254	236	54225	0	55971
24846	232	567	200	54999	0	55998
24847	239	343	181	55467	0	56230
24848	268	333	53009	1613	0	55223
24849	243	256	1211	51743	0	53453
24850	244	330	512	51920	0	53006
24851	306	321	302	49527	0	50456
24852	255	52547	260	1471	0	54533
24853	52774	1202	242	649	0	54867
24854	53012	546	228	538	0	54324
24855	52567	306	285	452	0	53610
24856	1577	302	294	51101	0	53274
24857	693	294	51383	1354	0	53724
24858	672	305	51109	716	0	52802
24859	385	51183	1498	586	0	53652
24860	49665	1196	614	541	0	52016
24861	1206	50962	428	548	0	53144
24862	51001	1228	378	463	0	53070
24863	1287	51033	352	527	0	53199
24864	49974	1284	397	446	0	52101
24865	1304	52239	427	482	0	54452
24866	730	1294	378	52321	0	54723
24867	595	661	51892	1437	0	54585
24868	606	408	52375	796	0	54185
24869	578	385	1604	51326	0	53893
24870	556	375	791	52233	0	53955
24871	571	372	482	53441	0	54866
24872	618	415	52178	1760	0	54971
24873	571	339	1299	51246	0	53455
24874	50119	398	692	1575	0	52784
24875	50870	356	494	879	0	52599
24876	1670	50480	448	684	0	53282
24877	49308	1284	416	573	0	51581
24878	1505	48802	363	609	0	51279
24879	48629	1380	385	570	0	50964
24880	49271	738	449	525	0	50983
24881	48445	519	465	558	0	49987
24882	1804	499	47970	514	0	50787
24883	935	462	47698	520	0	49615
24884	46429	409	1661	544	0	49043
24885	48418	407	866	517	0	50208
24886	1919	403	507	47166	0	49995
24887	1126	378	377	49359	0	51240
24888	734	403	473	50245	0	51855
24889	567	428	495	50938	0	52428
24890	528	455	497	52388	0	53868
24891	50369	518	466	1960	0	53313
24892	1530	496	345	50542	0	52913
24893	786	563	49497	1683	0	52529
24894	47051	445	1355	1036	0	49887
24895	48961	364	701	837	0	50863
24896	1649	48899	456	834	0	51838
24897	665	49346	377	752	0	51140
24898	44135	1170	362	445	0	46112
24899	986	45851	337	443	0	47617
24900	44291	1014	417	373	0	46095
24901	46845	401	401	446	0	48093
24902	47272	202	322	432	0	48228
24903	1506	183	326	44320	0	46335
24904	590	45550	298	1203	0	47641
24905	45832	936	269	635	0	47672
24906	1230	372	284	45489	0	47375
24907	660	179	227	44847	0	45913
24908	41856	114	216	1400	0	43586
24909	922	41264	248	678	0	43112
24910	387	797	121	40105	0	41410
24911	40085	344	147	990	0	41566
24912	863	40815	113	582	0	42373
24913	40851	739	64	333	0	41987
24914	896	295	38871	252	0	40314
24915	36726	105	602	207	0	37640
24916	772	38493	209	217	0	39691
24917	37018	614	222	160	0	38014
24918	36488	233	45	119	0	36885
24919	794	37282	40	134	0	38250
24920	36986	582	34	103	0	37705
24921	649	36441	48	124	0	37262
24922	37217	611	32	158	0	38018
24923	714	249	40	37134	0	38137
24924	326	129	25	37560	0	38040
24925	201	101	35	38051	0	38388
24926	170	122	36329	813	0	37434
24927	179	111	546	36210	0	37046
24928	216	106	36514	668	0	37504
24929	165	113	592	35478	0	36348
24930	180	36263	206	668	0	37317
24931	200	633	71	36747	0	37651
24932	218	290	36751	690	0	37949
24933	222	157	37408	266	0	38053
24934	190	118	732	37104	0	38144
24935	37020	110	242	692	0	38064
24936	37244	105	94	321	0	37764
24937	846	37275	89	280	0	38490
24938	399	654	70	37741	0	38864
24939	272	276	38600	720	0	39868
24940	214	129	627	38505	0	39475
24941	228	134	38735	737	0	39834
24942	36961	130	676	372	0	38139
24943	764	137	235	38866	0	40002
24944	432	164	38215	736	0	39547
24945	263	150	625	38116	0	39154
24946	257	125	269	39029	0	39680
24947	287	144	38448	930	0	39809
24948	232	142	638	38204	0	39216
24949	38353	145	267	824	0	39589
24950	38816	142	155	393	0	39506
24951	927	137	122	38910	0	40096
24952	39223	148	143	817	0	40331
24953	866	167	39619	408	0	41060
24954	490	143	39265	284	0	40182
24955	39447	128	890	268	0	40733
24956	40908	117	372	283	0	41680
24957	969	145	164	39751	0	41029
24958	450	157	159	40644	0	41410
24959	358	120	39882	1023	0	41383
24960	278	163	718	36227	0	37386
24961	281	40213	364	796	0	41654
24962	40880	692	212	432	0	42216
24963	43510	303	177	308	0	44298
24964	1047	43960	178	374	0	45559
24965	42234	789	195	282	0	43500
24966	42164	285	185	299	0	42933
24967	1062	42912	231	316	0	44521
24968	42758	782	184	329	0	44053
24969	913	43286	224	304	0	44727
24970	43470	841	200	302	0	44813
24971	1038	355	43038	307	0	44738
24972	498	195	875	42923	0	44491
24973	356	141	351	44550	0	45398
24974	287	155	249	46557	0	47248
24975	45840	127	181	1310	0	47458
24976	1050	128	197	47860	0	49235
24977	539	120	47459	1180	0	49298
24978	47307	143	1022	555	0	49027
24979	1126	123	382	47266	0	48897
24980	485	46749	303	1197	0	48734
24981	337	48871	243	588	0	50039
24982	337	1155	223	47677	0	49392
24983	342	406	235	47865	0	48848
24984	358	180	222	48514	0	49274
24985	354	133	46573	1409	0	48469
24986	299	45911	1021	704	0	47935
24987	44600	869	441	394	0	46304
24988	43529	357	267	324	0	44477
24989	1161	43371	210	345	0	45087
24990	439	43552	195	335	0	44521
24991	541	1163	337	42287	0	44328
24992	261	300	42395	962	0	43918
24993	40494	235	860	455	0	42044
24994	42060	129	329	372	0	42890
24995	1006	91	221	41469	0	42787
24996	423	108	182	41614	0	42327
24997	40009	93	148	1039	0	41289
24998	891	112	39706	456	0	41165
24999	37790	119	746	353	0	39008
25000	832	38959	302	315	0	40408
25001	286	556	123	34968	0	35933
25002	200	35850	125	671	0	36846
25003	36217	560	144	318	0	37239
25004	648	167	132	35429	0	36376
25005	292	136	110	34877	0	35415
25006	240	35326	119	696	0	36381
25007	35554	521	122	278	0	36475
25008	35608	173	131	235	0	36147
25009	691	165	34997	218	0	36071
25010	274	131	33049	206	0	33660
25011	32844	103	566	160	0	33673
25012	636	99	33325	182	0	34242
25013	249	119	31691	151	0	32210
25014	31278	120	632	203	0	32233
25015	560	85	35318	173	0	36136
25016	219	91	726	34934	0	35970
25017	179	64	301	36307	0	36851
25018	37698	60	163	1021	0	38942
25019	955	120	38315	433	0	39823
25020	39850	84	937	229	0	41100
25021	1163	115	362	39603	0	41243
25022	40009	102	201	1059	0	41371
25023	40553	104	123	441	0	41221
25024	40767	88	107	299	0	41261
25025	1543	117	68	39809	0	41537
25026	40377	92	83	1119	0	41671
25027	1387	106	67	40161	0	41721
25028	634	97	120	40753	0	41604
25029	434	95	129	41005	0	41663
25030	372	107	105	41197	0	41781
25031	40132	89	140	1535	0	41896
25032	40548	106	136	676	0	41466
25033	1540	129	39914	405	0	41988
25034	40264	90	1104	322	0	41780
25035	41380	78	445	345	0	42248
25036	1544	89	242	39499	0	41374
25037	709	39761	167	1274	0	41911
25038	40352	1032	166	563	0	42113
25039	1341	397	140	39094	0	40972
25040	38829	186	192	1231	0	40438
25041	1395	38579	181	606	0	40761
25042	39315	1042	164	364	0	40885
25043	1431	405	145	37720	0	39701
25044	658	37921	119	1220	0	39918
25045	38500	1095	128	600	0	40323
25046	1235	38239	148	532	0	40154
25047	605	40091	156	491	0	41343
25048	39916	1326	166	415	0	41823
25049	1306	557	39241	424	0	41528
25050	39383	284	1071	338	0	41076
25051	1555	213	457	39178	0	41403
25052	813	159	39439	1182	0	41593
25053	627	146	1160	38182	0	40115
25054	564	175	473	39759	0	40971
25055	586	165	38480	1633	0	40864
25056	38071	143	1161	768	0	40143
25057	1547	95	471	38842	0	40955
25058	835	103	262	39661	0	40861
25059	664	107	179	39563	0	40513
25060	38744	138	206	1916	0	41004
25061	1468	138	37843	973	0	40422
25062	777	111	37851	677	0	39416
25063	523	157	1262	34558	0	36500
25064	512	103	34800	1255	0	36670
25065	33679	89	1152	673	0	35593
25066	1262	34171	562	509	0	36504
25067	34045	930	356	361	0	35692
25068	1451	394	211	32232	0	34288
25069	718	33116	243	1155	0	35232
25070	624	1185	186	32725	0	34720
25071	523	33704	206	1192	0	35625
25072	544	1097	159	34045	0	35845
25073	511	510	33108	1315	0	35444
25074	504	360	31709	660	0	33233
25075	459	31511	1167	576	0	33713
25076	29472	896	497	435	0	31300
25077	1054	489	227	28725	0	30495
25078	676	292	173	29315	0	30456
25079	29093	247	185	1207	0	30732
25080	29408	225	180	657	0	30470
25081	1357	166	222	28899	0	30644
25082	797	160	28293	1065	0	30315
25083	570	28159	902	639	0	30270
25084	479	831	481	28100	0	29891
25085	437	437	376	27465	0	28715
25086	425	28772	219	1237	0	30653
25087	29095	863	211	717	0	30886
25088	1109	453	28935	489	0	30986
25089	636	297	882	28624	0	30439
25090	490	200	416	29165	0	30271
25091	322	207	28442	1499	0	30470
25092	389	192	918	28824	0	30323
25093	29391	187	511	1258	0	31347
25094	29540	192	405	686	0	30823
25095	29879	165	298	568	0	30910
25096	1375	28952	293	522	0	31142
25097	31051	867	296	419	0	32633
25098	1321	485	225	30733	0	32764
25099	725	324	235	29990	0	31274
25100	556	34206	250	1283	0	36295
25101	37487	1088	233	715	0	39523
25102	39881	557	239	516	0	41193
25103	40374	355	215	471	0	41415
25104	41227	297	201	513	0	42238
25105	41365	248	221	473	0	42307
25106	1859	244	39985	402	0	42490
25107	40669	268	1277	377	0	42591
25108	41494	247	539	424	0	42704
25109	40991	184	413	425	0	42013
25110	1909	162	272	39765	0	42108
25111	930	198	271	40552	0	41951
25112	738	129	39222	1653	0	41742
25113	33216	194	1243	839	0	35492
25114	1256	37999	624	668	0	40547
25115	488	34493	286	372	0	35639
25116	400	836	33959	281	0	35476
25117	284	33792	806	299	0	35181
25118	237	32907	266	275	0	33685
25119	448	1296	463	27255	0	29462
25120	125	29300	105	493	0	30023
25121	29224	577	59	179	0	30039
25122	28868	161	67	161	0	29257
25123	647	129	57	28488	0	29321
25124	256	70	28394	555	0	29275
25125	27430	92	546	198	0	28266
25126	634	83	28490	176	0	29383
25127	264	69	28894	116	0	29343
25128	194	53	604	26885	0	27736
25129	150	56	219	28482	0	28907
25130	197	55	28659	640	0	29551
25131	133	27891	534	275	0	28833
25132	130	30157	178	228	0	30693
25133	29456	599	154	160	0	30369
25134	29781	190	57	133	0	30161
25135	693	98	29140	87	0	30018
25136	28532	75	474	89	0	29170
25137	31098	68	119	172	0	31457
25138	638	93	118	30241	0	31090
25139	289	54	56	31153	0	31552
25140	202	68	66	31505	0	31841
25141	31168	79	65	615	0	31927
25142	31568	67	53	229	0	31917
25143	31929	47	64	162	0	32202
25144	794	45	68	31792	0	32699
25145	409	48	31303	517	0	32277
25146	30797	56	499	182	0	31534
25147	31211	73	161	133	0	31578
25148	742	81	149	30202	0	31174
25149	381	31059	80	549	0	32069
25150	299	504	77	30824	0	31704
25151	242	31546	71	581	0	32440
25152	209	595	83	30562	0	31449
25153	216	31765	125	594	0	32700
25154	31294	509	91	170	0	32064
25155	644	204	83	31109	0	32040
25156	268	31491	91	517	0	32367
25157	245	515	31199	172	0	32131
25158	29841	186	539	169	0	30735
25159	592	200	171	30957	0	31920
25160	238	31235	123	535	0	32131
25161	241	534	72	30210	0	31057
25162	200	30669	99	531	0	31499
25163	212	32219	107	203	0	32741
25164	31971	547	119	207	0	32844
25165	32182	221	134	134	0	32671
25166	646	156	32235	117	0	33154
25167	31649	115	541	115	0	32420
25168	32341	119	205	123	0	32788
25169	598	32029	174	160	0	32961
25170	295	498	98	32050	0	32941
25171	238	177	110	32305	0	32830
25172	195	163	31711	562	0	32631
25173	235	150	30821	201	0	31407
25174	31138	93	557	157	0	31945
25175	32327	81	229	120	0	32757
25176	32276	41	186	128	0	32631
25177	690	66	31479	114	0	32349
25178	300	61	519	30967	0	31847
25179	31592	62	171	556	0	32381
25180	571	68	116	31446	0	32201
25181	222	83	31115	598	0	32018
25182	29188	93	479	215	0	29975
25183	632	109	32125	157	0	33023
25184	277	31767	483	147	0	32674
25185	32165	451	144	150	0	32910
25186	592	139	31880	134	0	32745
25187	279	126	479	31286	0	32170
25188	31981	59	167	512	0	32719
25189	571	90	86	31915	0	32662
25190	32402	92	61	612	0	33167
25191	559	86	68	32318	0	33031
25192	33182	99	55	678	0	34014
25193	33055	101	67	240	0	33463
25194	32838	100	78	181	0	33197
25195	32727	102	65	134	0	33028
25196	718	139	123	31949	0	32929
25197	271	103	30931	466	0	31771
25198	216	89	30742	161	0	31208
25199	152	30411	504	196	0	31263
25200	117	27170	151	117	0	27555
25201	23448	224	657	99	0	24428
25202	138	68	38	22291	0	22535
25203	50	22	22537	143	0	22752
25204	50	35	22971	50	0	23106
25205	51	68	139	23110	0	23368
25206	23410	11	29	124	0	23574
25207	111	23569	26	83	0	23789
25208	25089	106	15	84	0	25294
25209	125	32	13	25376	0	25546
25210	40	15	18	25430	0	25503
25211	27	13	19	25403	0	25462
25212	18	26	25266	136	0	25446
25213	39	30	24836	44	0	24949
25214	29	24991	129	50	0	25199
25215	30	114	36	25805	0	25985
25216	25167	26	22	144	0	25359
25217	131	28	24707	49	0	24915
25218	48	38	24866	37	0	24989
25219	31	16	138	25042	0	25227
25220	25	18	35	26225	0	26303
25221	33	22	24	26352	0	26431
25222	31	16	30	29012	0	29089
25223	29343	17	24	289	0	29673
25224	268	25	28	29835	0	30156
25225	29821	10	30	302	0	30163
25226	315	35	30406	79	0	30835
25227	59	30462	341	104	0	30966
25228	48	271	47	30654	0	31020
25229	58	52	31261	280	0	31651
25230	79	38	30908	85	0	31110
25231	41	31954	300	107	0	32402
25232	62	243	73	30819	0	31197
25233	50	49	53	31149	0	31301
25234	36	43	31372	299	0	31750
25235	29167	30	295	105	0	29597
25236	280	27	69	31564	0	31940
25237	63	29	55	30799	0	30946
25238	60	49	31564	339	0	32012
25239	47	31632	323	136	0	32138
25240	37	34529	76	127	0	34769
25241	34854	421	58	89	0	35422
25242	425	98	51	34992	0	35566
25243	37355	60	111	471	0	37997
25244	603	42	37439	148	0	38232
25245	190	39	542	37241	0	38012
25246	37352	31	167	577	0	38127
25247	37676	37	83	194	0	37990
25248	690	37	54	37238	0	38019
25249	213	25	37456	586	0	38280
25250	115	48	38248	193	0	38604
25251	79	40	678	37793	0	38590
25252	79	35	38668	587	0	39369
25253	35953	21	585	224	0	36783
25254	563	38171	210	183	0	39127
25255	38771	519	119	118	0	39527
25256	39118	163	75	180	0	39536
25257	723	71	81	39349	0	40224
25258	240	66	104	39918	0	40328
25259	39820	80	81	736	0	40717
25260	583	59	82	39868	0	40592
25261	234	61	39833	677	0	40805
25262	130	39969	611	277	0	40987
25263	102	570	211	39750	0	40633
25264	99	200	117	39776	0	40192
25265	106	81	101	40121	0	40409
25266	124	67	39183	820	0	40194
25267	152	38952	578	392	0	40074
25268	107	542	256	39551	0	40456
25269	127	170	39641	713	0	40651
25270	136	124	624	39432	0	40316
25271	39624	97	234	723	0	40678
25272	643	105	145	40488	0	41381
25273	273	90	40271	687	0	41321
25274	38852	79	637	371	0	39939
25275	649	41205	260	307	0	42421
25276	249	42409	217	264	0	43139
25277	42952	654	158	268	0	44032
25278	700	263	44516	182	0	45661
25279	351	111	622	43536	0	44620
25280	247	74	277	45272	0	45870
25281	184	110	45359	837	0	46490
25282	156	45386	677	485	0	46704
25283	192	582	287	43113	0	44174
25284	208	208	44939	745	0	46100
25285	177	126	714	44258	0	45275
25286	44467	151	337	770	0	45725
25287	712	141	46165	394	0	47412
25288	332	124	653	45983	0	47092
25289	235	97	295	46996	0	47623
25290	241	154	46020	942	0	47357
25291	248	156	689	42814	0	43907
25292	193	43970	326	912	0	45401
25293	277	650	247	40660	0	41834
25294	183	45529	248	724	0	46684
25295	45391	639	212	414	0	46656
25296	43909	256	222	390	0	44777
25297	829	134	44609	372	0	45944
25298	371	160	44203	353	0	45087
25299	285	172	44167	326	0	44950
25300	232	44073	877	406	0	45588
25301	233	631	435	45045	0	46344
25302	273	244	46404	769	0	47690
25303	275	171	770	44537	0	45753
25304	215	166	366	45419	0	46166
25305	290	113	45786	937	0	47126
25306	307	158	725	45142	0	46332
25307	257	197	365	44867	0	45686
25308	273	44697	309	959	0	46238
25309	301	642	265	44991	0	46199
25310	261	294	271	45847	0	46673
25311	260	184	45524	1045	0	47013
25312	253	192	719	44507	0	45671
25313	264	161	45844	977	0	47246
25314	202	207	44851	560	0	45820
25315	43025	172	899	499	0	44595
25316	685	227	456	42939	0	44307
25317	284	45744	328	976	0	47332
25318	242	46441	333	609	0	47625
25319	249	891	356	46226	0	47722
25320	244	344	46150	993	0	47731
25321	202	46212	826	698	0	47938
25322	276	682	380	43987	0	45325
25323	230	269	45724	727	0	46950
25324	181	45837	586	485	0	47089
25325	47788	538	327	371	0	49024
25326	47289	258	280	336	0	48163
25327	47370	161	192	462	0	48185
25328	656	203	219	50375	0	51453
25329	296	182	235	50336	0	51049
25330	195	138	212	50001	0	50546
25331	156	151	49632	907	0	50846
25332	47665	180	659	554	0	49058
25333	679	130	366	47988	0	49163
25334	302	159	49417	704	0	50582
25335	48500	167	709	498	0	49874
25336	50322	137	413	407	0	51279
25337	797	220	45259	339	0	46615
25338	47645	134	609	398	0	48786
25339	601	51040	362	433	0	52436
25340	231	412	48938	252	0	49833
25341	45945	253	635	292	0	47125
25342	428	48311	277	342	0	49358
25343	108	259	127	45202	0	45696
25344	51	45812	121	340	0	46324
25345	90	302	79	46319	0	46790
25346	83	113	46327	351	0	46874
25347	39148	55	434	245	0	39882
25348	355	79	46296	165	0	46895
25349	94	45198	321	183	0	45796
25350	43	45577	126	189	0	45935
25351	44717	309	95	127	0	45248
25352	300	111	44424	104	0	44939
25353	87	46	300	43170	0	43603
25354	102	67	44673	309	0	45151
25355	47	45078	300	215	0	45640
25356	167	294	138	41035	0	41634
25357	40	44899	93	307	0	45339
25358	45784	284	79	189	0	46336
25359	45834	96	233	119	0	46282
25360	45688	61	62	100	0	45911
25361	377	83	45575	78	0	46113
25362	117	84	44092	69	0	44362
25363	43284	41	380	113	0	43818
25364	347	55	46774	76	0	47252
25365	130	48	348	43163	0	43689
25366	47	46113	137	362	0	46659
25367	47215	324	93	146	0	47778
25368	47054	93	70	119	0	47336
25369	48267	50	77	142	0	48536
25370	408	66	68	48391	0	48933
25371	134	63	62	48918	0	49177
25372	48283	48	71	468	0	48870
25373	357	47965	81	189	0	48592
25374	47307	337	60	110	0	47814
25375	380	104	61	46398	0	46943
25376	132	42	44	46346	0	46564
25377	45150	44	38	436	0	45668
25378	355	44053	58	174	0	44640
25379	44173	341	79	117	0	44710
25380	379	44625	64	152	0	45220
25381	44169	356	54	76	0	44655
25382	384	104	50	51319	0	51857
25383	51587	52	77	386	0	52102
25384	54081	55	43	162	0	54341
25385	60232	45	37	80	0	60394
25386	762	63110	64	141	0	64077
25387	208	734	61625	79	0	62646
25388	60712	158	754	89	0	61713
25389	62953	82	154	71	0	63260
25390	877	63051	98	95	0	64121
25391	247	752	62	63585	0	64646
25392	141	175	51	64210	0	64577
25393	63765	89	69	920	0	64843
25394	881	76	44	64628	0	65629
25395	288	84	65164	835	0	66371
25396	197	107	64070	235	0	64609
25397	64697	73	935	190	0	65895
25398	868	63	230	66426	0	67587
25399	273	69	111	67390	0	67843
25400	185	54	77	68270	0	68586
25401	205	66	68905	1030	0	70206
25402	158	57	844	67332	0	68391
25403	175	72	210	69620	0	70077
25404	146	101	135	70315	0	70697
25405	68623	68	101	1094	0	69886
25406	1043	71	76	69020	0	70210
25407	342	107	70723	1027	0	72199
25408	71149	108	984	390	0	72631
25409	1160	132	75005	225	0	76522
25410	74618	116	1095	204	0	76033
25411	70137	162	338	224	0	70861
25412	1391	128	136	77470	0	79125
25413	442	79536	153	1312	0	81443
25414	332	1116	109	80653	0	82210
25415	271	343	134	79343	0	80091
25416	216	82457	206	1510	0	84389
25417	80710	1109	211	465	0	82495
25418	1204	81240	238	417	0	83099
25419	81189	1155	265	305	0	82914
25420	81249	299	137	367	0	82052
25421	1469	159	150	80605	0	82383
25422	482	161	147	81113	0	81903
25423	339	105	78730	1591	0	80765
25424	256	136	76174	642	0	77208
25425	73141	167	1344	484	0	75136
25426	76234	77	383	406	0	77100
25427	1424	73573	245	516	0	75758
25428	587	1031	204	72458	0	74280
25429	481	264	75802	1224	0	77771
25430	404	597	1219	75356	0	77576
25431	74856	169	567	1388	0	76980
25432	72585	97	269	468	0	73419
25433	1376	73422	173	418	0	75389
25434	527	1058	123	73148	0	74856
25435	374	357	117	73776	0	74624
25436	289	273	124	73460	0	74146
25437	342	253	70721	1531	0	72847
25438	60299	222	1077	724	0	62322
25439	68573	233	305	449	0	69560
25440	1627	248	69925	381	0	72181
25441	681	69539	1137	397	0	71754
25442	69748	1101	386	399	0	71634
25443	70045	321	269	456	0	71091
25444	1567	216	68553	477	0	70813
25445	657	222	71098	461	0	72438
25446	493	242	1398	69608	0	71741
25447	527	207	71299	1238	0	73271
25448	68956	210	1286	545	0	70997
25449	71278	220	471	402	0	72371
25450	72159	252	320	462	0	73193
25451	1597	243	275	66456	0	68571
25452	697	73651	295	1320	0	75963
25453	75223	1044	319	697	0	77283
25454	74483	361	339	566	0	75749
25455	1684	310	74115	559	0	76668
25456	787	274	72405	529	0	73995
25457	65524	236	1378	611	0	67749
25458	1504	210	482	73079	0	75275
25459	798	224	73186	1447	0	75655
25460	620	72836	1257	749	0	75462
25461	676	1127	557	72752	0	75112
25462	71938	406	458	1310	0	74112
25463	1478	73970	382	683	0	76513
25464	753	1136	366	71813	0	74068
25465	619	72191	474	1365	0	74649
25466	604	74314	424	716	0	76058
25467	673	1216	414	73884	0	76187
25468	579	476	460	73584	0	75099
25469	564	74501	410	1576	0	77051
25470	73493	1158	357	760	0	75768
25471	1676	482	74007	560	0	76725
25472	70674	369	1210	611	0	72864
25473	1672	351	493	75223	0	77739
25474	889	297	397	76156	0	77739
25475	747	338	382	76736	0	78203
25476	669	271	526	76307	0	77773
25477	740	322	76266	1515	0	78843
25478	773	259	1363	75426	0	77821
25479	718	301	642	75034	0	76695
25480	654	79665	490	1649	0	82458
25481	715	1276	80750	824	0	83565
25482	492	82762	1396	853	0	85503
25483	726	1436	83805	644	0	86611
25484	506	83973	1360	619	0	86458
25485	1061	1337	658	74476	0	77532
25486	74115	358	325	977	0	75775
25487	1116	75539	297	656	0	77608
25488	562	1048	292	76646	0	78548
25489	553	387	77322	1131	0	79393
25490	409	78826	1127	565	0	80927
25491	78194	1051	493	425	0	80163
25492	77516	444	395	388	0	78743
25493	1295	78814	344	439	0	80892
25494	632	1059	76876	316	0	78883
25495	72761	426	1084	322	0	74593
25496	1234	327	421	78283	0	80265
25497	77013	273	362	1197	0	78845
25498	1189	79591	307	640	0	81727
25499	529	81618	295	526	0	82968
25500	553	1307	79578	393	0	81831
25501	75902	495	1154	383	0	77934
25502	1314	483	475	80048	0	82320
25503	80092	271	373	1149	0	81885
25504	1157	81159	309	526	0	83151
25505	80724	1049	310	426	0	82509
25506	80536	463	385	385	0	81769
25507	1388	351	80888	362	0	82989
25508	508	77145	945	293	0	78891
25509	362	78366	408	315	0	79451
25510	325	1307	301	71227	0	73160
25511	231	73875	172	877	0	75155
25512	71668	902	142	344	0	73056
25513	775	72306	142	317	0	73540
25514	303	909	100	69961	0	71273
25515	240	70622	111	759	0	71732
25516	220	69331	143	314	0	70008
25517	237	70794	129	258	0	71418
25518	364	997	198	69861	0	71420
25519	240	363	138	70703	0	71444
25520	229	305	116	69864	0	70514
25521	238	68756	130	922	0	70046
25522	300	785	68157	339	0	69581
25523	260	389	67833	225	0	68707
25524	64816	307	798	180	0	66101
25525	801	287	282	68353	0	69723
25526	359	303	69577	737	0	70976
25527	336	345	69983	297	0	70961
25528	233	71830	798	270	0	73131
25529	232	882	307	67811	0	69232
25530	203	427	192	69410	0	70232
25531	68700	352	124	922	0	70098
25532	776	322	113	68600	0	69811
25533	329	294	149	68937	0	69709
25534	323	316	70540	946	0	72125
25535	224	304	732	69337	0	70597
25536	205	319	278	72886	0	73688
25537	258	314	72607	968	0	74147
25538	248	311	72515	437	0	73511
25539	209	72157	922	391	0	73679
25540	288	915	71216	287	0	72706
25541	217	433	843	69455	0	70948
25542	225	428	397	62480	0	63530
25543	382	339	71925	981	0	73627
25544	186	71566	800	544	0	73096
25545	67303	891	373	435	0	69002
25546	719	69450	320	453	0	70942
25547	324	952	253	69341	0	70870
25548	267	499	220	70286	0	71272
25549	183	70344	326	1243	0	72096
25550	214	921	315	69932	0	71382
25551	221	467	273	70445	0	71406
25552	299	398	66449	1150	0	68296
25553	195	65470	914	1063	0	67642
25554	224	933	431	66411	0	67999
25555	267	501	66067	1002	0	67837
25556	234	399	911	65041	0	66585
25557	269	365	422	65998	0	67054
25558	279	301	347	66799	0	67726
25559	246	345	320	66385	0	67296
25560	274	366	307	64686	0	65633
25561	256	65999	308	1206	0	67769
25562	64206	902	360	672	0	66140
25563	846	464	64201	549	0	66060
25564	55691	419	927	601	0	57638
25565	880	402	66807	487	0	68576
25566	306	69781	962	631	0	71680
25567	395	1009	68690	486	0	70580
25568	205	69901	1031	592	0	71729
25569	249	1101	463	65398	0	67211
25570	238	507	377	65115	0	66237
25571	219	68504	307	1238	0	70268
25572	197	71377	275	784	0	72633
25573	70761	1214	273	607	0	72855
25574	72279	560	289	604	0	73732
25575	72525	373	264	548	0	73710
25576	73588	342	279	579	0	74788
25577	1190	363	268	71486	0	73307
25578	426	72620	275	1105	0	74426
25579	71572	1012	290	657	0	73531
25580	904	464	255	68842	0	70465
25581	66360	296	261	963	0	67880
25582	63480	238	264	530	0	64512
25583	820	62466	233	397	0	63916
25584	275	60206	185	349	0	61015
25585	170	62604	186	315	0	63275
25586	177	1232	304	57852	0	59565
25587	98	61765	153	598	0	62614
25588	60739	483	215	367	0	61804
25589	61999	236	102	328	0	62665
25590	61570	109	110	273	0	62062
25591	63029	122	116	248	0	63515
25592	63928	127	121	227	0	64403
25593	734	140	66394	173	0	67441
25594	66028	105	713	180	0	67026
25595	803	164	67285	208	0	68460
25596	65270	91	733	180	0	66274
25597	770	118	239	65621	0	66748
25598	416	127	65255	726	0	66524
25599	202	139	67468	290	0	68099
25600	115	71188	878	248	0	72429
25601	71166	825	357	175	0	72523
25602	72906	288	163	142	0	73499
25603	1128	81148	112	236	0	82624
25604	349	1231	80	92381	0	94041
25605	100278	396	104	1775	0	102553
25606	2118	233	102008	593	0	104952
25607	662	102450	1864	358	0	105334
25608	97611	1972	569	200	0	100352
25609	1862	102019	231	217	0	104329
25610	712	2191	140	93082	0	96125
25611	322	102287	124	1723	0	104456
25612	298	2370	96	94477	0	97241
25613	212	99897	154	1956	0	102219
25614	170	103763	121	629	0	104683
25615	99894	2442	105	334	0	102775
25616	101647	848	132	266	0	102893
25617	2613	414	101258	208	0	104493
25618	1028	307	101118	143	0	102596
25619	535	268	102117	148	0	103068
25620	318	250	2594	99440	0	102602
25621	426	254	102284	2076	0	105040
25622	300	288	2212	100428	0	103228
25623	284	267	805	101256	0	102612
25624	275	102328	390	2542	0	105535
25625	100220	2086	252	957	0	103515
25626	2048	102808	273	517	0	105646
25627	853	2373	257	103976	0	107459
25628	528	891	249	105339	0	107007
25629	466	528	237	106019	0	107250
25630	587	495	103953	2841	0	107876
25631	509	436	2176	103321	0	106442
25632	484	504	817	105361	0	107166
25633	519	492	411	106935	0	108357
25634	692	588	101621	2933	0	105834
25635	469	101579	2156	1331	0	105535
25636	100406	2423	769	766	0	104364
25637	95815	1081	445	694	0	98035
25638	2626	101665	417	656	0	105364
25639	1116	2496	416	100258	0	104286
25640	782	1166	378	103808	0	106134
25641	896	715	101332	2876	0	105819
25642	618	101016	2339	1405	0	105378
25643	571	2413	1089	101793	0	105866
25644	669	1051	102430	2542	0	106692
25645	541	751	2434	101157	0	104883
25646	591	652	1043	102907	0	105193
25647	740	676	101772	3169	0	106357
25648	686	670	2366	100389	0	104111
25649	661	668	1024	102206	0	104559
25650	761	750	102348	3181	0	107040
25651	615	819	2446	102061	0	105941
25652	573	690	1115	102640	0	105018
25653	523	652	768	104897	0	106840
25654	589	648	102638	3614	0	107489
25655	558	658	2579	102705	0	106500
25656	101256	597	1184	3288	0	106325
25657	101923	585	856	1715	0	105079
25658	2891	101996	833	1404	0	107124
25659	103231	2447	787	1237	0	107702
25660	2796	1164	106255	1119	0	111334
25661	1305	781	2582	106255	0	110923
25662	880	691	1241	106807	0	109619
25663	660	779	876	109823	0	112138
25664	104183	674	663	3806	0	109326
25665	2228	104532	706	2581	0	110047
25666	976	2435	640	96856	0	100907
25667	629	101731	662	2980	0	106002
25668	99043	2537	644	1744	0	103968
25669	2204	100979	736	1458	0	105377
25670	98053	2490	672	1404	0	102619
25671	2244	98182	755	1473	0	102654
25672	945	99026	754	1515	0	102240
25673	717	3014	866	96769	0	101366
25674	533	1169	741	98291	0	100734
25675	580	846	748	98136	0	100310
25676	536	748	645	98017	0	99946
25677	680	825	94747	3636	0	99888
25678	579	94389	2293	2143	0	99404
25679	519	2411	1018	88930	0	92878
25680	481	93809	861	2910	0	98061
25681	769	2492	93354	1752	0	98367
25682	600	1060	2334	92411	0	96405
25683	601	863	1114	96639	0	99217
25684	755	632	94100	3489	0	98976
25685	528	91797	2488	2253	0	97066
25686	490	2191	1308	91603	0	95592
25687	725	895	90932	3261	0	95813
25688	388	90247	2493	2244	0	95372
25689	551	2503	1113	88465	0	92632
25690	597	1120	88212	3103	0	93032
25691	623	858	86980	1807	0	90268
25692	497	84529	2529	1597	0	89152
25693	603	90088	1062	1270	0	93023
25694	547	2844	878	89678	0	93947
25695	614	1282	569	97235	0	99700
25696	584	887	95457	3461	0	100389
25697	89021	757	2362	1963	0	94103
25698	92900	654	1042	1544	0	96140
25699	2926	618	91259	1348	0	96151
25700	1083	87153	2307	1310	0	91853
25701	617	87935	946	1204	0	90702
25702	463	84662	718	1063	0	86906
25703	579	74759	772	1026	0	77136
25704	1680	3206	1044	65217	0	71147
25705	244	324	165	73659	0	74392
25706	85	198	65	73953	0	74301
25707	65	149	64	74482	0	74760
25708	63	74320	100	2272	0	76755
25709	86	1633	76	74158	0	75953
25710	62	74332	98	1912	0	76404
25711	66	1770	79	75899	0	77814
25712	73839	602	91	1948	0	76480
25713	1599	318	93	74764	0	76774
25714	590	73647	128	1997	0	76362
25715	338	1590	129	76289	0	78346
25716	224	627	108	78295	0	79254
25717	154	382	119	78918	0	79573
25718	74669	260	113	2765	0	77807
25719	1686	319	107	78041	0	80153
25720	708	380	75096	2280	0	78464
25721	291	76616	1649	1118	0	79674
25722	212	1918	586	79070	0	81786
25723	234	776	248	81319	0	82577
25724	219	470	128	82495	0	83312
25725	77934	377	119	3019	0	81449
25726	1947	388	77448	1359	0	81142
25727	710	335	1764	73676	0	76485
25728	307	75917	617	2506	0	79347
25729	315	2069	242	77032	0	79658
25730	71288	790	150	2721	0	74949
25731	1778	75060	179	1419	0	78436
25732	649	2103	170	75131	0	78053
25733	364	914	129	75523	0	76930
25734	236	73685	117	3286	0	77324
25735	290	2030	106	75729	0	78155
25736	364	876	162	77149	0	78551
25737	428	563	73468	3215	0	77674
25738	216	73015	1886	1871	0	76988
25739	73141	2166	709	1352	0	77368
25740	2151	982	72610	1285	0	77028
25741	71299	569	1974	1235	0	75077
25742	2353	566	72385	1226	0	76530
25743	970	480	2148	72901	0	76499
25744	72023	512	839	3071	0	76445
25745	2175	577	439	73711	0	76902
25746	73510	498	311	3267	0	77586
25747	73946	567	298	1942	0	76753
25748	72494	589	377	1494	0	74954
25749	2852	71004	371	1485	0	75712
25750	1320	2273	305	70779	0	74677
25751	779	1037	365	73126	0	75307
25752	670	701	335	73356	0	75062
25753	628	612	70139	3785	0	75164
25754	650	600	2216	71309	0	74775
25755	70195	607	972	3310	0	75084
25756	71907	578	570	2067	0	75122
25757	3049	562	69578	1607	0	74796
25758	70536	604	2179	1386	0	74705
25759	71729	635	1044	1328	0	74736
25760	3133	659	660	66219	0	70671
25761	66013	682	503	3316	0	70514
25762	67017	719	484	2066	0	70286
25763	3251	643	503	65969	0	70366
25764	66031	592	588	3266	0	70477
25765	66486	660	593	1991	0	69730
25766	3355	704	579	65198	0	69836
25767	1845	697	61408	3228	0	67178
25768	62712	707	2268	1982	0	67669
25769	2916	634	64359	1726	0	69635
25770	1802	569	64444	1584	0	68399
25771	1309	62579	2853	1676	0	68417
25772	1324	2206	1241	62401	0	67172
25773	1288	1074	721	64261	0	67344
25774	1301	634	600	65148	0	67683
25775	1469	542	62584	3945	0	68540
25776	1433	497	63209	2297	0	67436
25777	1349	62189	2807	1779	0	68124
25778	1389	2239	1264	60045	0	64937
25779	1355	917	827	63253	0	66352
25780	1371	588	719	64688	0	67366
25781	1525	476	61426	3807	0	67234
25782	1320	60528	2462	2379	0	66689
25783	1400	2179	1140	60285	0	65004
25784	1460	943	61740	3259	0	67402
25785	1461	533	62658	2159	0	66811
25786	61489	438	3107	1591	0	66625
25787	62079	434	1625	1463	0	65601
25788	63482	515	964	1502	0	66463
25789	3710	479	805	58538	0	63532
25790	2059	462	60125	3131	0	65777
25791	1449	58715	2490	2230	0	64884
25792	1382	61490	1435	1747	0	66054
25793	1470	2339	53396	1266	0	58471
25794	1491	2046	2515	46712	0	52764
25795	1142	764	1409	42557	0	45872
25796	1006	42760	1024	2544	0	47334
25797	986	44791	849	1567	0	48193
25798	43604	1961	825	1113	0	47503
25799	44760	851	710	1088	0	47409
25800	45145	459	713	1131	0	47448
25801	44417	464	753	1052	0	46686
25802	41671	668	704	1122	0	44165
25803	2536	39539	791	1081	0	43947
25804	890	29539	618	781	0	31828
25805	507	22762	459	564	0	24292
25806	19768	742	1268	540	0	22318
25807	1132	532	425	18320	0	20409
25808	463	153	265	17953	0	18834
25809	17325	134	329	761	0	18549
25810	652	17269	334	468	0	18723
25811	446	481	274	17489	0	18690
25812	394	205	322	17872	0	18793
25813	423	161	322	17969	0	18875
25814	16924	120	301	718	0	18063
25815	806	174	284	16900	0	18164
25816	437	181	15875	563	0	17056
25817	15265	158	509	352	0	16284
25818	683	167	242	15293	0	16385
25819	377	133	14954	534	0	15998
25820	305	14766	475	349	0	15895
25821	204	13411	221	186	0	14022
25822	11816	338	415	200	0	12769
25823	11396	109	127	166	0	11798
25824	237	11699	76	86	0	12098
25825	152	166	40	12253	0	12611
25826	12565	52	33	260	0	12910
25827	219	27	39	13643	0	13928
25828	130	25	32	14213	0	14400
25829	82	29	44	14362	0	14517
25830	53	36	51	14066	0	14206
25831	57	13897	55	352	0	14361
25832	54	218	48	14234	0	14554
25833	46	85	48	14303	0	14482
25834	69	53	45	14452	0	14619
25835	72	36	13781	365	0	14254
25836	44	13781	255	174	0	14254
25837	68	294	102	13825	0	14289
25838	57	103	13788	275	0	14223
25839	72	64	13256	124	0	13516
25840	31	13519	292	107	0	13949
25841	13259	217	111	69	0	13656
25842	206	85	77	13484	0	13852
25843	13352	60	32	239	0	13683
25844	227	13490	32	136	0	13885
25845	94	232	35	13582	0	13943
25846	12917	92	27	264	0	13300
25847	13205	61	26	134	0	13426
25848	287	38	29	13155	0	13509
25849	139	27	24	13219	0	13409
25850	66	39	12993	334	0	13432
25851	42	28	231	13011	0	13312
25852	58	57	94	13363	0	13572
25853	12800	41	51	320	0	13212
25854	239	12877	25	190	0	13331
25855	121	212	12678	109	0	13120
25856	12194	94	202	89	0	12579
25857	219	12684	83	108	0	13094
25858	98	212	57	12612	0	12979
25859	12488	96	31	267	0	12882
25860	217	62	27	12462	0	12768
25861	107	38	25	12634	0	12804
25862	70	35	12368	331	0	12804
25863	46	52	198	12478	0	12774
25864	12413	40	86	318	0	12857
25865	225	39	48	12591	0	12903
25866	12299	36	34	316	0	12685
25867	233	12112	47	195	0	12587
25868	103	12512	45	158	0	12818
25869	78	282	39	12366	0	12765
25870	60	132	31	12528	0	12751
25871	12068	64	39	355	0	12526
25872	228	12078	35	219	0	12560
25873	12243	236	34	150	0	12663
25874	12340	107	39	131	0	12617
25875	306	81	34	12152	0	12573
25876	12241	52	36	306	0	12635
25877	268	58	11620	183	0	12129
25878	136	48	230	11754	0	12168
25879	99	56	11878	301	0	12334
25880	95	55	240	11992	0	12382
25881	11874	55	107	358	0	12394
25882	11950	50	69	201	0	12270
25883	313	11972	56	170	0	12511
25884	158	235	52	12005	0	12450
25885	133	99	50	12004	0	12286
25886	95	12169	41	386	0	12691
25887	92	241	43	12440	0	12816
25888	105	119	53	12233	0	12510
25889	90	12104	50	397	0	12641
25890	11611	236	41	252	0	12140
25891	11645	113	43	198	0	11999
25892	338	87	52	11561	0	12038
25893	169	81	45	11721	0	12016
25894	130	66	11426	390	0	12012
25895	102	61	217	11124	0	11504
25896	99	11398	96	349	0	11942
25897	11495	233	63	229	0	12020
25898	279	108	47	11521	0	11955
25899	143	94	49	11452	0	11738
25900	10930	64	58	392	0	11444
25901	264	10945	54	236	0	11499
25902	168	229	45	11291	0	11733
25903	144	115	43	11112	0	11414
25904	113	11129	53	380	0	11675
25905	11197	247	76	204	0	11724
25906	299	132	11048	163	0	11642
25907	162	88	11163	164	0	11577
25908	142	64	276	11114	0	11596
25909	112	64	11114	326	0	11616
25910	10745	73	247	196	0	11261
25911	307	74	102	11171	0	11654
25912	175	64	11239	326	0	11804
25913	174	62	11164	186	0	11586
25914	99	11249	264	198	0	11810
25915	11102	218	138	165	0	11623
25916	259	11282	89	164	0	11794
25917	11246	218	79	167	0	11710
25918	11202	101	73	159	0	11535
25919	287	10920	51	144	0	11402
25920	10888	201	37	115	0	11241
25921	10761	97	55	129	0	11042
25922	285	78	10539	140	0	11042
25923	198	552	179	9410	0	10339
25924	87	9362	72	206	0	9727
25925	56	8812	43	104	0	9015
25926	248	294	47	7844	0	8433
25927	7251	58	48	204	0	7561
25928	69	18	14	7018	0	7119
25929	46	10	11	7328	0	7395
25930	29	14	11	7480	0	7534
25931	23	7976	12	115	0	8126
25932	22	90	15	8551	0	8678
25933	16	37	9344	119	0	9516
25934	8748	24	121	48	0	8941
25935	9610	16	36	37	0	9699
25936	155	9425	18	26	0	9624
25937	9511	134	6	30	0	9681
25938	148	40	7	9637	0	9832
25939	49	23	9581	138	0	9791
25940	9133	12	125	45	0	9315
25941	125	9636	38	52	0	9851
25942	35	132	11	9560	0	9738
25943	9835	27	6	152	0	10020
25944	137	9889	9	47	0	10082
25945	40	10130	9	31	0	10210
25946	10108	148	12	17	0	10285
25947	138	35	9807	20	0	10000
25948	9817	24	131	25	0	9997
25949	149	20	23	9925	0	10117
25950	36	14	20	10050	0	10120
25951	43	21	9979	163	0	10206
25952	31	21	9963	43	0	10058
25953	26	16	161	10008	0	10211
25954	37	18	9867	150	0	10072
25955	34	24	10026	42	0	10126
25956	26	17	157	9682	0	9882
25957	29	17	39	10050	0	10135
25958	9997	17	24	179	0	10217
25959	160	20	25	9968	0	10173
25960	10018	19	21	164	0	10222
25961	164	9929	19	61	0	10173
25962	45	153	26	10046	0	10270
25963	47	41	10360	146	0	10594
25964	10046	38	139	57	0	10280
25965	10611	30	42	34	0	10717
25966	10640	21	33	31	0	10725
25967	10447	20	28	38	0	10533
25968	10397	15	22	34	0	10468
25969	192	29	26	10149	0	10396
25970	73	23	10085	174	0	10355
25971	53	14	10089	66	0	10222
25972	34	27	10238	42	0	10341
25973	9797	24	199	41	0	10061
25974	10368	16	66	41	0	10491
25975	190	23	52	9931	0	10196
25976	74	10452	38	169	0	10733
25977	49	146	35	10641	0	10871
25978	58	41	10587	173	0	10859
25979	56	31	10504	70	0	10661
25980	9851	18	199	65	0	10133
25981	190	23	11087	51	0	11351
25982	74	22	173	11025	0	11294
25983	11613	17	63	221	0	11914
25984	11573	22	38	73	0	11706
25985	11952	21	29	45	0	12047
25986	11867	14	35	49	0	11965
25987	241	21	11524	46	0	11832
25988	11199	14	175	37	0	11425
25989	202	11627	67	51	0	11947
25990	85	152	45	11756	0	12038
25991	81	47	11809	170	0	12107
25992	66	20	193	11577	0	11856
25993	89	20	12061	193	0	12363
25994	66	31	186	11807	0	12090
25995	63	25	64	12083	0	12235
25996	69	20	11927	218	0	12234
25997	55	18	178	11767	0	12018
25998	12005	20	81	207	0	12313
25999	195	85	61	12029	0	12370
26000	74	34	39	12375	0	12522
26001	12181	17	52	222	0	12472
26002	204	12332	58	80	0	12674
26003	12389	167	34	66	0	12656
26004	214	12527	47	60	0	12848
26005	12810	167	56	64	0	13097
26006	232	47	12934	44	0	13257
26007	100	25	175	12739	0	13039
26008	78	17	68	13055	0	13218
26009	12852	20	62	212	0	13146
26010	192	12829	61	97	0	13179
26011	77	148	59	12787	0	13071
26012	65	44	53	12698	0	12860
26013	48	12447	62	225	0	12782
26014	12324	151	54	92	0	12621
26015	180	12427	49	118	0	12774
26016	88	148	34	12214	0	12484
26017	72	42	49	12083	0	12246
26018	55	12129	30	217	0	12431
26019	12017	154	30	103	0	12304
26020	197	53	11938	64	0	12252
26021	11534	32	179	65	0	11810
26022	202	12037	56	73	0	12368
26023	83	158	42	12082	0	12365
26024	12194	44	45	181	0	12464
26025	210	35	36	12148	0	12429
26026	99	32	29	12291	0	12451
26027	12318	16	34	231	0	12599
26028	177	12251	38	112	0	12578
26029	83	12455	43	68	0	12649
26030	12148	148	52	61	0	12409
26031	161	53	12162	61	0	12437
26032	76	11772	122	45	0	12015
26033	109	139	129	11075	0	11452
26034	44	37	12740	91	0	12912
26035	30	55	120	12318	0	12523
26036	12630	12	60	140	0	12842
26037	134	13065	26	102	0	13327
26038	85	132	19	12376	0	12612
26039	32	13122	17	118	0	13289
26040	13100	129	20	56	0	13305
26041	13406	63	16	54	0	13539
26042	200	13944	12	32	0	14188
26043	92	154	12	13910	0	14168
26044	31	14560	13	154	0	14758
26045	14821	185	16	79	0	15101
26046	15020	94	15	39	0	15168
26047	263	26	20	14873	0	15182
26048	104	30	10	15170	0	15314
26049	52	24	14790	268	0	15134
26050	13571	19	190	137	0	13917
26051	223	28	14811	48	0	15110
26052	95	24	201	14562	0	14882
26053	14575	15	93	212	0	14895
26054	215	15033	26	116	0	15390
26055	14676	201	33	52	0	14962
26056	215	94	14472	43	0	14824
26057	13918	37	167	39	0	14161
26058	221	15045	78	42	0	15386
26059	15011	195	23	46	0	15275
26060	227	15518	29	56	0	15830
26061	110	208	21	15413	0	15752
26062	60	100	15199	212	0	15571
26063	73	50	14720	97	0	14940
26064	42	36	268	14657	0	15003
26065	67	35	14996	224	0	15322
26066	53	35	211	14820	0	15119
26067	34	36	102	14964	0	15136
26068	44	29	15329	301	0	15703
26069	12794	38	228	149	0	13209
26070	15191	29	106	57	0	15383
26071	271	15083	37	74	0	15465
26072	15103	185	31	44	0	15363
26073	222	107	25	15033	0	15387
26074	113	40	15644	214	0	16011
26075	60	39	201	15418	0	15718
26076	52	26	98	15718	0	15894
26077	15428	23	33	283	0	15767
26078	205	15376	46	123	0	15750
26079	106	15612	27	73	0	15818
26080	61	252	26	15492	0	15831
26081	58	102	36	15116	0	15312
26082	50	15144	27	254	0	15475
26083	45	187	22	14853	0	15107
26084	39	107	26	14677	0	14849
26085	35	14560	35	308	0	14938
26086	14534	178	29	121	0	14862
26087	188	87	41	14508	0	14824
26088	87	14870	32	232	0	15221
26089	67	189	29	14861	0	15146
26090	14719	108	22	203	0	15052
26091	206	14916	36	119	0	15277
26092	15198	210	26	77	0	15511
26093	15233	96	21	78	0	15428
26094	284	70	16	15466	0	15836
26095	16220	61	20	254	0	16555
26096	16423	47	38	151	0	16659
26097	16533	43	26	79	0	16681
26098	16478	34	30	75	0	16617
26099	307	34	30	16318	0	16689
26100	145	31	19	16683	0	16878
26101	76	51	16572	296	0	16995
26102	71	35	187	16527	0	16820
26103	76	33	87	16910	0	17106
26104	75	46	16511	301	0	16933
26105	15383	36	201	161	0	15781
26106	249	38	100	16768	0	17155
26107	150	46	16970	256	0	17422
26108	15625	40	233	148	0	16046
26109	277	43	17899	93	0	18312
26110	148	18338	251	84	0	18821
26111	91	19221	132	79	0	19523
26112	88	315	45	20052	0	20500
26113	72	125	22231	300	0	22728
26114	21848	53	328	162	0	22391
26115	23425	43	137	122	0	23727
26116	442	47	23404	99	0	23992
26117	22888	30	343	112	0	23373
26118	23787	33	145	77	0	24042
26119	442	23805	65	98	0	24410
26120	23939	312	77	63	0	24391
26121	388	122	48	23778	0	24336
26122	198	58	24094	336	0	24686
26123	108	85	322	23155	0	23670
26124	77	24562	132	342	0	25113
26125	64	25195	63	168	0	25490
26126	24918	385	74	99	0	25476
26127	24739	127	64	93	0	25023
26128	24538	75	63	91	0	24767
26129	459	61	60	24515	0	25095
26130	199	101	54	24092	0	24446
26131	113	24199	59	418	0	24789
26132	24000	332	53	183	0	24568
26133	369	24499	59	129	0	25056
26134	22578	261	41	79	0	22959
26135	297	22823	51	71	0	23242
26136	22538	262	44	55	0	22899
26137	22418	86	57	88	0	22649
26138	365	134	46	21847	0	22392
26139	174	22784	50	252	0	23260
26140	152	242	22311	109	0	22814
26141	20119	84	263	127	0	20593
26142	253	21702	78	125	0	22158
26143	134	225	21503	56	0	21918
26144	86	93	22258	51	0	22488
26145	84	59	205	21112	0	21460
26146	71	51	60	21036	0	21218
26147	59	22150	33	222	0	22464
26148	22974	197	15	117	0	23303
26149	222	87	15	22958	0	23282
26150	111	24419	27	190	0	24747
26151	93	26372	25	100	0	26590
26152	107	220	25922	49	0	26298
26153	81	101	26130	51	0	26363
26154	24837	55	202	52	0	25146
26155	234	64	26545	42	0	26885
26156	115	58	178	25832	0	26183
26157	89	65	58	27192	0	27404
26158	91	68	27475	256	0	27890
26159	89	56	184	26693	0	27022
26160	83	55	65	26873	0	27076
26161	26235	50	52	234	0	26571
26162	27019	59	71	90	0	27239
26163	242	53	64	27019	0	27378
26164	88	27075	67	224	0	27454
26165	73	28242	68	113	0	28496
26166	28125	220	64	81	0	28490
26167	234	90	28054	70	0	28448
26168	98	55	209	27685	0	28047
26169	28664	71	85	247	0	29067
26170	28831	64	65	138	0	29098
26171	267	71	62	28837	0	29237
26172	140	87	29082	260	0	29569
26173	128	97	27433	109	0	27767
26174	26452	84	283	120	0	26939
26175	28814	84	123	84	0	29105
26176	299	28993	107	200	0	29599
26177	145	29971	119	133	0	30368
26178	30505	273	104	133	0	31015
26179	30975	109	78	161	0	31323
26180	352	121	96	31627	0	32196
26181	211	62	84	32360	0	32717
26182	188	53	83	32589	0	32913
26183	32395	79	87	327	0	32888
26184	332	111	71	32618	0	33132
26185	228	109	33210	281	0	33828
26186	31958	101	263	160	0	32482
26187	307	107	106	33451	0	33971
26188	212	119	34159	263	0	34753
26189	31820	108	247	147	0	32322
26190	33022	103	115	128	0	33368
26191	316	35739	100	146	0	36301
26192	173	36449	85	129	0	36836
26193	242	302	35514	95	0	36153
26194	33759	134	237	134	0	34264
26195	310	36334	98	170	0	36912
26196	216	288	35600	80	0	36184
26197	32550	129	260	143	0	33082
26198	329	37999	92	212	0	38632
26199	208	312	37450	120	0	38090
26200	34617	157	249	126	0	35149
26201	346	37886	94	140	0	38466
26202	162	272	49	37455	0	37938
26203	37490	122	63	297	0	37972
26204	297	37929	86	202	0	38514
26205	149	280	79	37791	0	38299
26206	37168	89	91	325	0	37673
26207	281	63	37824	137	0	38305
26208	112	37723	273	168	0	38276
26209	254	237	37008	87	0	37586
26210	112	188	240	36089	0	36629
26211	88	58	36563	242	0	36951
26212	54	35400	212	134	0	35800
26213	53	33831	92	81	0	34057
26214	123	185	66	33006	0	33380
26215	33	35	15	32088	0	32171
26216	24	27	16	32702	0	32769
26217	65	29	33595	128	0	33817
26218	26	14	112	33393	0	33545
26219	33305	10	49	165	0	33529
26220	32573	23	25	67	0	32688
26221	208	38	34107	50	0	34403
26222	42	33999	130	54	0	34225
26223	33815	119	33	40	0	34007
26224	126	33769	28	47	0	33970
26225	33766	123	26	59	0	33974
26226	33739	30	23	51	0	33843
26227	157	42	33508	43	0	33750
26228	40	34228	131	106	0	34505
26229	61	123	33	34528	0	34745
26230	68	52	34508	137	0	34765
26231	31751	39	154	81	0	32025
26232	147	24	39	34357	0	34567
26233	79	34	34048	139	0	34300
26234	31795	23	163	67	0	32048
26235	236	34	35322	74	0	35666
26236	58	23	177	35196	0	35454
26237	37523	20	45	217	0	37805
26238	188	38721	30	124	0	39063
26239	100	195	39157	48	0	39500
26240	37753	50	207	76	0	38086
26241	42635	43	58	49	0	42785
26242	346	44207	46	75	0	44674
26243	118	323	23	44324	0	44788
26244	54	96	35	43963	0	44148
26245	43433	43	23	426	0	43925
26246	361	26	24	43649	0	44060
26247	129	45	44000	399	0	44573
26248	74	38	345	43067	0	43524
26249	42678	37	107	399	0	43221
26250	369	42488	63	251	0	43171
26251	134	430	27	40388	0	40979
26252	54	41423	46	370	0	41893
26253	41505	421	38	114	0	42078
26254	415	113	32	44376	0	44936
26255	121	66	34	45460	0	45681
26256	66	45571	40	692	0	46369
26257	110	568	44330	197	0	45205
26258	64	170	556	43874	0	44664
26259	60	70	159	44919	0	45208
26260	81	34	72	44466	0	44653
26261	35	44435	62	713	0	45245
26262	121	553	44426	207	0	45307
26263	111	172	45099	90	0	45472
26264	43542	77	700	111	0	44430
26265	45742	51	206	96	0	46095
26266	816	68	46149	59	0	47092
26267	44732	42	627	113	0	45514
26268	736	61	47241	102	0	48140
26269	44580	39	684	120	0	45423
26270	647	47118	193	181	0	48139
26271	47682	645	134	103	0	48564
26272	784	183	48113	109	0	49189
26273	279	109	48857	120	0	49365
26274	131	68	821	51269	0	52289
26275	53332	77	239	997	0	54645
26276	960	56674	129	406	0	58169
26277	391	1061	62555	205	0	64212
26278	193	249	1345	62928	0	64715
26279	132	115	309	65444	0	66000
26280	64153	76	151	1631	0	66011
26281	64517	95	96	405	0	65113
26282	1645	105	89	63822	0	65661
26283	64034	79	127	1505	0	65745
26284	1578	113	63029	425	0	65145
26285	433	82	1398	61884	0	63797
26286	263	107	329	63978	0	64677
26287	62763	82	197	1723	0	64765
26288	62493	101	156	488	0	63238
26289	1752	104	130	61703	0	63689
26290	61399	79	137	1557	0	63172
26291	1613	131	60043	453	0	62240
26292	419	59324	1500	334	0	61577
26293	352	1381	59563	244	0	61540
26294	274	385	1508	59350	0	61517
26295	58154	180	423	1549	0	60306
26296	1480	58528	237	606	0	60851
26297	472	1422	191	57870	0	59955
26298	298	392	223	56856	0	57769
26299	229	56741	230	1796	0	58996
26300	284	1534	216	57413	0	59447
26301	318	347	239	58526	0	59430
26302	348	183	217	58601	0	59349
26303	378	127	177	58528	0	59210
26304	389	127	206	57339	0	58061
26305	361	55626	292	1960	0	58239
26306	358	1410	236	56543	0	58547
26307	389	341	247	57205	0	58182
26308	472	228	54761	1976	0	57437
26309	391	54344	1577	833	0	57145
26310	410	1459	465	54759	0	57093
26311	450	375	300	55256	0	56381
26312	489	233	302	54709	0	55733
26313	425	53464	327	2114	0	56330
26314	519	1448	53856	852	0	56675
26315	515	424	1603	54801	0	57343
26316	530	270	54653	1919	0	57372
26317	553	252	54395	851	0	56051
26318	432	243	1823	53918	0	56416
26319	54293	213	580	2017	0	57103
26320	1759	254	337	54348	0	56698
26321	642	232	274	53880	0	55028
26322	487	54356	305	2225	0	57373
26323	516	1493	297	55564	0	57870
26324	441	472	295	56828	0	58036
26325	484	285	55660	2344	0	58773
26326	396	55431	1604	1165	0	58596
26327	451	1547	552	56343	0	58893
26328	54792	537	421	2067	0	57817
26329	1682	419	55217	973	0	58291
26330	563	353	1633	55410	0	57959
26331	437	328	572	56800	0	58137
26332	54575	343	399	2366	0	57683
26333	1656	54806	339	1246	0	58047
26334	53398	1593	301	1072	0	56364
26335	1593	53391	334	1111	0	56429
26336	525	1592	333	53208	0	55658
26337	52048	537	353	2225	0	55163
26338	1640	400	51710	1248	0	54998
26339	567	50400	1596	1161	0	53724
26340	470	51533	652	1113	0	53768
26341	46796	1572	507	944	0	49819
26342	1489	562	386	45015	0	47452
26343	557	45099	364	2005	0	48025
26344	399	47072	347	1185	0	49003
26345	429	1544	299	46588	0	48860
26346	415	587	302	47729	0	49033
26347	45333	422	322	2211	0	48288
26348	1426	45508	377	1222	0	48533
26349	551	1496	474	45846	0	48367
26350	419	522	45103	1925	0	47969
26351	366	44977	1471	1193	0	48007
26352	502	1307	44459	978	0	47246
26353	394	44118	1461	987	0	46960
26354	592	1488	789	41235	0	44104
26355	436	472	279	40039	0	41226
26356	378	40607	251	1774	0	43010
26357	378	1251	40546	995	0	43170
26358	39691	537	1153	872	0	42253
26359	1146	487	417	41644	0	43694
26360	370	436	353	42879	0	44038
26361	340	459	41900	1815	0	44514
26362	321	449	1217	42103	0	44090
26363	287	497	41921	1743	0	44448
26364	319	491	1176	42032	0	44018
26365	318	436	42568	1716	0	45038
26366	231	42721	1189	1215	0	45356
26367	335	1338	43663	894	0	46230
26368	296	641	1159	43882	0	45978
26369	43104	479	356	1741	0	45680
26370	1175	42636	271	1080	0	45162
26371	470	1489	309	42341	0	44609
26372	379	625	41698	1520	0	44222
26373	238	42070	1264	868	0	44440
26374	279	1209	414	37163	0	39065
26375	235	435	37195	1011	0	38876
26376	115	33043	772	438	0	34368
26377	25538	836	614	395	0	27383
26378	24039	166	144	125	0	24474
26379	344	63	28	24135	0	24570
26380	24173	49	42	318	0	24582
26381	291	45	38	23964	0	24338
26382	108	44	37	24613	0	24802
26383	66	69	25274	370	0	25779
26384	43	52	269	24823	0	25187
26385	53	44	93	25425	0	25615
26386	24827	47	60	382	0	25316
26387	24346	42	55	162	0	24605
26388	318	24796	47	131	0	25292
26389	152	278	24968	87	0	25485
26390	68	129	279	24825	0	25301
26391	70	94	24480	308	0	24952
26392	22471	58	288	146	0	22963
26393	312	64	24259	103	0	24738
26394	125	54	256	23455	0	23890
26395	64	24096	120	290	0	24570
26396	57	265	93	24086	0	24501
26397	36	122	70	24229	0	24457
26398	86	69	25024	370	0	25549
26399	58	61	270	24822	0	25211
26400	24974	38	117	360	0	25489
26401	24946	38	99	189	0	25272
26402	24939	42	58	148	0	25187
26403	25135	43	71	138	0	25387
26404	323	24691	93	147	0	25254
26405	110	25179	96	146	0	25531
26406	96	293	73	24402	0	24864
26407	92	113	101	25218	0	25524
26408	73	24579	64	399	0	25115
26409	90	247	81	25429	0	25847
26410	85	119	77	25544	0	25825
26411	91	98	71	25519	0	25779
26412	87	66	118	25475	0	25746
26413	95	81	95	25596	0	25867
26414	24632	79	111	443	0	25265
26415	306	24598	102	282	0	25288
26416	197	282	23998	203	0	24680
26417	111	148	296	24235	0	24790
26418	98	120	169	24400	0	24787
26419	99	102	115	24379	0	24695
26420	23864	99	137	475	0	24575
26421	306	26567	105	381	0	27359
26422	220	450	109	26183	0	26962
26423	171	27787	94	634	0	28686
26424	186	636	106	26777	0	27705
26425	158	26862	97	723	0	27840
26426	194	636	28779	346	0	29955
26427	145	225	714	30622	0	31706
26428	137	145	36282	951	0	37515
26429	136	124	1006	36116	0	37382
26430	157	181	310	39249	0	39897
26431	39034	116	178	1400	0	40728
26432	39669	96	132	569	0	40466
26433	40194	132	138	357	0	40821
26434	39927	126	124	323	0	40500
26435	39848	113	157	302	0	40420
26436	1373	109	165	37461	0	39108
26437	450	38635	143	1237	0	40465
26438	289	1087	150	38658	0	40184
26439	245	342	37880	1313	0	39780
26440	37004	194	1070	483	0	38751
26441	38693	148	305	359	0	39505
26442	1342	127	187	38468	0	40124
26443	493	108	132	37945	0	38678
26444	279	37174	127	1490	0	39070
26445	256	1032	106	38289	0	39683
26446	264	323	112	37779	0	38478
26447	246	37309	135	1521	0	39211
26448	246	1065	115	38397	0	39823
26449	36790	353	129	1355	0	38627
26450	1190	236	36982	597	0	39005
26451	35528	165	1079	497	0	37269
26452	1267	199	36879	364	0	38709
26453	461	155	1139	36207	0	37962
26454	336	149	371	34769	0	35625
26455	283	35219	238	1467	0	37207
26456	276	37061	159	699	0	38195
26457	317	1341	161	35412	0	37231
26458	326	439	35601	1352	0	37718
26459	33761	197	1078	591	0	35627
26460	1244	156	343	34492	0	36235
26461	478	34607	263	1297	0	36645
26462	387	1067	132	34950	0	36536
26463	350	387	113	34475	0	35325
26464	340	33706	115	1492	0	35653
26465	452	1047	118	32639	0	34256
26466	345	284	30588	1179	0	32396
26467	331	180	30221	432	0	31164
26468	255	221	983	28957	0	30416
26469	160	30994	285	1023	0	32462
26470	209	914	162	30824	0	32109
26471	31287	274	115	1084	0	32760
26472	32015	155	113	448	0	32731
26473	30858	144	100	343	0	31445
26474	1090	30267	103	356	0	31816
26475	371	901	30111	329	0	31712
26476	29527	305	929	310	0	31071
26477	30900	231	266	324	0	31721
26478	1087	30016	230	347	0	31680
26479	372	926	149	30100	0	31547
26480	30375	316	156	1086	0	31933
26481	30933	218	177	456	0	31784
26482	31070	192	179	375	0	31816
26483	1229	152	226	29149	0	30756
26484	29745	135	204	1228	0	31312
26485	1159	170	193	29683	0	31205
26486	517	179	156	30598	0	31450
26487	29705	218	169	1366	0	31458
26488	1194	206	169	29716	0	31285
26489	29445	223	210	1312	0	31190
26490	1253	231	182	29580	0	31246
26491	566	239	172	30617	0	31594
26492	29466	259	181	1477	0	31383
26493	1312	226	29144	718	0	31400
26494	669	221	991	29840	0	31721
26495	586	265	333	30526	0	31710
26496	506	205	266	30139	0	31116
26497	479	226	204	30691	0	31600
26498	464	245	211	29038	0	29958
26499	460	28247	192	1573	0	30472
26500	487	1025	209	28877	0	30598
26501	572	389	28357	1372	0	30690
26502	589	279	954	28806	0	30628
26503	619	219	300	29275	0	30413
26504	539	268	197	30079	0	31083
26505	450	285	28644	1590	0	30969
26506	416	276	28695	820	0	30207
26507	27544	285	1177	655	0	29661
26508	28933	269	416	588	0	30206
26509	1378	29518	285	614	0	31795
26510	693	1034	197	30424	0	32348
26511	478	423	200	32011	0	33112
26512	404	295	226	32727	0	33652
26513	31513	237	255	1635	0	33640
26514	32321	245	224	863	0	33653
26515	1329	246	200	32140	0	33915
26516	555	314	168	32674	0	33711
26517	399	288	192	32920	0	33799
26518	404	248	220	32895	0	33767
26519	31011	227	298	1649	0	33185
26520	1153	197	30453	887	0	32690
26521	423	26193	844	684	0	28144
26522	254	25936	299	528	0	27017
26523	24536	743	173	500	0	25952
26524	761	714	287	23958	0	25720
26525	316	225	24006	904	0	25451
26526	234	178	21510	439	0	22361
26527	174	21536	565	412	0	22687
26528	15810	164	323	135	0	16432
26529	192	52	15510	95	0	15849
26530	12214	54	110	60	0	12438
26531	98	20	23	13537	0	13678
26532	36	14	6	13696	0	13752
26533	19	13608	17	128	0	13772
26534	11	14038	15	53	0	14117
26535	13969	59	5	43	0	14076
26536	13930	26	14	29	0	13999
26537	72	14103	16	58	0	14249
26538	27	67	13308	25	0	13427
26539	32	37	13555	29	0	13653
26540	10	38	68	13906	0	14022
26541	14641	13	27	69	0	14750
26542	67	14361	18	62	0	14508
26543	21	54	11	14972	0	15058
26544	15125	21	9	95	0	15250
26545	68	26	7	15212	0	15313
26546	34	8	7	15740	0	15789
26547	15574	1	8	110	0	15693
26548	66	15737	5	73	0	15881
26549	40	16618	9	39	0	16706
26550	39	111	16596	20	0	16766
26551	16	42	67	17004	0	17129
26552	23	12	35	17246	0	17316
26553	16	16	17573	104	0	17709
26554	13572	12	91	119	0	13794
26555	15961	6	60	49	0	16076
26556	110	14	17185	36	0	17345
26557	13660	21	92	62	0	13835
26558	103	22	17964	18	0	18107
26559	55	19083	85	37	0	19260
26560	37	85	36	20007	0	20165
26561	19	40	22	20629	0	20710
26562	20550	17	13	133	0	20713
26563	20560	14	11	84	0	20669
26564	20462	8	13	43	0	20526
26565	20473	12	12	35	0	20532
26566	20399	13	25	44	0	20481
26567	125	23	19828	29	0	20005
26568	50	20190	75	72	0	20387
26569	28	74	42	20404	0	20548
26570	21	20674	22	106	0	20823
26571	21	20860	17	47	0	20945
26572	20	99	17	20459	0	20595
26573	21	43	12	20573	0	20649
26574	43	30	20394	100	0	20567
26575	18238	23	82	73	0	18416
26576	20490	19	41	44	0	20594
26577	93	20400	26	45	0	20564
26578	20652	73	25	44	0	20794
26579	21262	30	19	71	0	21382
26580	124	35	16	21045	0	21220
26581	66	25	22143	79	0	22313
26582	53	31	21835	53	0	21972
26583	21739	14	102	45	0	21900
26584	22431	12	46	37	0	22526
26585	102	22011	34	44	0	22191
26586	51	22984	21	49	0	23105
26587	35	105	12	23651	0	23803
26588	23600	44	14	104	0	23762
26589	113	45	23610	49	0	23817
26590	53	19	96	23936	0	24104
26591	24973	10	41	148	0	25172
26592	24942	17	34	59	0	25052
26593	132	25	14	25477	0	25648
26594	25741	15	29	117	0	25902
26595	132	38	24454	48	0	24672
26596	79	45	26373	37	0	26534
26597	58	14	124	25955	0	26151
26598	20	32	49	27937	0	28038
26599	30	23	30	27880	0	27963
26600	29	27348	38	160	0	27575
26601	39	27993	23	86	0	28141
26602	38	144	15	28109	0	28306
26603	28080	46	31	148	0	28305
26604	118	28	16	28409	0	28571
26605	54	14	18	28441	0	28527
26606	42	28148	31	147	0	28368
26607	36	29196	27	107	0	29366
26608	40	123	19	29305	0	29487
26609	47	67	18	28231	0	28363
26610	27649	26	16	141	0	27832
26611	103	27183	24	99	0	27409
26612	27407	103	17	66	0	27593
26613	120	39	31	27476	0	27666
26614	65	44	26926	125	0	27160
26615	57	50	25931	76	0	26114
26616	26560	30	141	85	0	26816
26617	119	23	47	28925	0	29114
26618	55	25	26	29077	0	29183
26619	48	20	15	29409	0	29492
26620	46	30	29695	163	0	29934
26621	45	32	109	29736	0	29922
26622	35	30105	51	194	0	30385
26623	39	126	28	31160	0	31353
26624	36	48	21	31024	0	31129
26625	45	31250	23	196	0	31514
26626	31	174	18	31977	0	32200
26627	30952	55	33	199	0	31239
26628	175	30989	29	107	0	31300
26629	32180	183	25	78	0	32466
26630	32212	74	43	64	0	32393
26631	281	51	20	32081	0	32433
26632	106	29	18	31927	0	32080
26633	58	19	28	32673	0	32778
26634	72	34	31125	340	0	31571
26635	38	30737	219	216	0	31210
26636	37	31958	72	120	0	32187
26637	36	272	38	31505	0	31851
26638	30996	71	18	249	0	31334
26639	222	41	31	30495	0	30789
26640	114	45	31146	268	0	31573
26641	48	30534	201	142	0	30925
26642	41	31437	67	83	0	31628
26643	31260	213	34	91	0	31598
26644	31377	68	37	81	0	31563
26645	237	33724	40	92	0	34093
26646	34325	195	64	76	0	34660
26647	287	90	32875	44	0	33296
26648	109	77	32191	54	0	32431
26649	33432	28	273	85	0	33818
26650	34480	28	89	79	0	34676
26651	293	38	28	34225	0	34584
26652	34314	31	32	300	0	34677
26653	329	37	34029	97	0	34492
26654	137	50	36123	91	0	36401
26655	88	42	340	42640	0	43110
26656	63	23	94	49242	0	49422
26657	58	23	46	51172	0	51299
26658	53	25	36	53217	0	53331
26659	55	29	32	56445	0	56561
26660	100	44	54718	1252	0	56114
26661	65	51	822	54603	0	55541
26662	54747	48	254	1134	0	56183
26663	881	38	134	55345	0	56398
26664	54895	27	69	1171	0	56162
26665	1001	45	72	55285	0	56403
26666	55977	55	87	1248	0	57367
26667	57858	42	82	528	0	58510
26668	1180	56	81	57051	0	58368
26669	510	54	80	58217	0	58861
26670	57188	48	77	1306	0	58619
26671	57166	52	69	600	0	57887
26672	1325	75	57458	369	0	59227
26673	595	49	879	57506	0	59029
26674	369	38	279	59673	0	60359
26675	58789	57	166	1326	0	60338
26676	59501	68	86	599	0	60254
26677	1324	40	93	59640	0	61097
26678	570	38	119	60568	0	61295
26679	341	48	135	60530	0	61054
26680	248	60	116	59718	0	60142
26681	251	56373	126	1792	0	58542
26682	217	58122	128	815	0	59282
26683	249	1041	118	57683	0	59091
26684	199	57456	134	1344	0	59133
26685	240	955	126	58670	0	59991
26686	264	302	57371	1510	0	59447
26687	267	255	55758	829	0	57109
26688	194	57537	1099	793	0	59623
26689	249	986	421	57416	0	59072
26690	313	368	57427	1407	0	59515
26691	284	261	1027	56065	0	57637
26692	304	193	388	58462	0	59347
26693	56695	130	343	1672	0	58840
26694	1177	177	221	57939	0	59514
26695	648	135	58633	1533	0	60949
26696	553	128	58236	842	0	59759
26697	444	57421	1259	770	0	59894
26698	432	61378	520	735	0	63065
26699	61996	1060	344	783	0	64183
26700	1345	381	65968	714	0	68408
26701	725	202	1069	65814	0	67810
26702	66494	116	447	1505	0	68562
26703	65962	140	348	891	0	67341
26704	1431	67078	270	819	0	69598
26705	759	988	253	67413	0	69413
26706	565	382	261	69544	0	70752
26707	462	294	226	69379	0	70361
26708	67448	210	194	1933	0	69785
26709	1274	224	67154	1125	0	69777
26710	607	68554	1045	983	0	71189
26711	494	1057	456	69172	0	71179
26712	389	488	319	70439	0	71635
26713	432	394	69577	1842	0	72245
26714	366	259	1085	69132	0	70842
26715	367	263	506	71038	0	72174
26716	373	241	406	70915	0	71935
26717	346	262	357	70754	0	71719
26718	406	278	68660	2105	0	71449
26719	369	267	1248	68591	0	70475
26720	358	265	69719	1976	0	72318
26721	325	68932	1314	1355	0	71926
26722	399	986	590	69457	0	71432
26723	438	457	473	70921	0	72289
26724	507	311	69128	2019	0	71965
26725	411	68246	1154	1572	0	71383
26726	531	1099	620	68190	0	70440
26727	593	472	68763	1630	0	71458
26728	485	68433	1108	1249	0	71275
26729	480	997	579	68859	0	70915
26730	594	468	68810	1566	0	71438
26731	554	376	1068	68278	0	70276
26732	533	263	560	69419	0	70775
26733	468	283	448	71021	0	72220
26734	69379	327	334	1815	0	71855
26735	1176	69054	350	1270	0	71850
26736	69324	1018	334	976	0	71652
26737	1238	490	69267	1006	0	72001
26738	70632	320	1069	1195	0	73216
26739	74898	270	524	1074	0	76766
26740	1303	319	425	74357	0	76404
26741	75849	345	348	1709	0	78251
26742	76535	298	336	1194	0	78363
26743	77811	335	318	1167	0	79631
26744	1449	304	341	77328	0	79422
26745	760	318	335	75939	0	77352
26746	471	281	73512	1685	0	75949
26747	376	276	71039	1116	0	72807
26748	69462	233	1205	950	0	71850
26749	966	523	656	71968	0	74113
26750	421	73910	542	1365	0	76238
26751	73595	877	480	941	0	75893
26752	853	73871	402	880	0	76006
26753	412	73824	429	888	0	75553
26754	644	1009	70330	799	0	72782
26755	335	369	69594	466	0	70764
26756	364	1205	927	65042	0	67538
26757	181	154	69388	495	0	70218
26758	171	138	64314	252	0	64875
26759	58819	28	155	181	0	59183
26760	63129	38	51	171	0	63389
26761	119	46	47	64042	0	64254
26762	96	45	37	65435	0	65613
26763	133	53	66496	167	0	66849
26764	45	67316	118	172	0	67651
26765	59	124	56	67740	0	67979
26766	68938	39	50	306	0	69333
26767	129	41	39	69637	0	69846
26768	63	70386	52	245	0	70746
26769	184	167	69646	135	0	70132
26770	40	71649	131	148	0	71968
26771	71735	139	58	103	0	72035
26772	69993	57	45	133	0	70228
26773	193	45	28	69654	0	69920
26774	157	57	71439	164	0	71817
26775	153	63	68979	131	0	69326
26776	51	71457	222	119	0	71849
26777	70	218	118	69969	0	70375
26778	60	105	54	71936	0	72155
26779	133	85	71617	226	0	72061
26780	73	43	163	69822	0	70101
26781	41	74292	97	334	0	74764
26782	69	263	45	74752	0	75129
26783	56	100	49	75033	0	75238
26784	122	105	74966	415	0	75608
26785	80	36	313	73051	0	73480
26786	72758	33	211	436	0	73438
26787	425	53	75836	142	0	76456
26788	214	58	76056	117	0	76445
26789	48	76589	506	122	0	77265
26790	75	425	188	78118	0	78806
26791	49	164	74	81862	0	82149
26792	140	87	80969	671	0	81867
26793	73820	52	582	288	0	74742
26794	564	39	194	80746	0	81543
26795	269	84	79951	578	0	80882
26796	103	51	586	76372	0	77112
26797	148	115	79967	630	0	80860
26798	184	81	77709	263	0	78237
26799	44	77197	755	166	0	78162
26800	76	583	241	71922	0	72822
26801	34	74801	121	628	0	75584
26802	72726	609	77	231	0	73643
26803	675	237	74235	148	0	75295
26804	188	73314	620	189	0	74311
26805	94	615	222	73070	0	74001
26806	72041	201	106	673	0	73021
26807	525	73036	106	432	0	74099
26808	193	612	94	73281	0	74180
26809	94	226	89	73082	0	73491
26810	56	74112	91	829	0	75088
26811	73944	673	101	340	0	75058
26812	665	247	98	84178	0	85188
26813	239	101	114	88552	0	89006
26814	263	121	86959	1632	0	88975
26815	70	91009	1306	715	0	93100
26816	66	1405	504	91755	0	93730
26817	92	492	219	99611	0	100414
26818	85	102128	139	2083	0	104435
26819	121	1837	132	102938	0	105028
26820	101	661	133	106480	0	107375
26821	113	247	126	106333	0	106819
26822	77	106226	172	2799	0	109274
26823	104719	1957	155	899	0	107730
26824	2116	676	106134	400	0	109326
26825	100389	254	2081	336	0	103060
26826	2114	105782	776	375	0	109047
26827	724	2020	333	105289	0	108366
26828	421	787	105991	2210	0	109409
26829	189	356	2134	104929	0	107608
26830	160	189	759	106712	0	107820
26831	170	209	355	108813	0	109547
26832	262	246	105782	2957	0	109247
26833	147	104739	2154	1685	0	108725
26834	268	2082	106303	660	0	109313
26835	118	107473	2367	671	0	110629
26836	374	2324	108599	504	0	111801
26837	146	933	2372	107314	0	110765
26838	103860	480	861	2644	0	107845
26839	1962	107443	426	1468	0	111299
26840	877	2305	107836	865	0	111883
26841	308	107440	2291	836	0	110875
26842	425	2491	108150	724	0	111790
26843	294	1026	2426	103988	0	107734
26844	361	624	946	101206	0	103137
26845	317	105332	663	3045	0	109357
26846	317	109835	494	1503	0	112149
26847	108488	2985	482	1007	0	112962
26848	2351	1268	532	109555	0	113706
26849	1036	770	110121	3008	0	114935
26850	558	571	2530	109452	0	113111
26851	524	616	111334	3320	0	115794
26852	496	635	112582	1660	0	115373
26853	386	615	3261	105473	0	109735
26854	393	109222	1326	2918	0	113859
26855	104433	2726	801	1674	0	109634
26856	2496	1229	698	103662	0	108085
26857	1002	852	731	101568	0	104153
26858	484	104172	696	3531	0	108883
26859	102741	2775	654	1687	0	107857
26860	104035	1315	711	1200	0	107261
26861	3096	858	762	99187	0	103903
26862	1197	100420	825	3003	0	105445
26863	562	106744	858	1714	0	109878
26864	104041	3333	749	1322	0	109445
26865	2590	1511	104441	1090	0	109632
26866	100107	1011	2844	1099	0	105061
26867	102334	897	1395	1085	0	105711
26868	101803	847	868	1194	0	104712
26869	3092	100727	858	1343	0	106020
26870	1203	2867	803	102143	0	107016
26871	101988	1330	811	3221	0	107350
26872	102689	958	814	1795	0	106256
26873	2935	102278	1010	1383	0	107606
26874	103048	2880	753	1250	0	107931
26875	2708	1420	786	104755	0	109669
26876	1214	968	829	104621	0	107632
26877	740	103994	766	3770	0	109270
26878	687	2899	750	105874	0	110210
26879	763	1413	724	106855	0	109755
26880	664	105893	793	3840	0	111190
26881	829	2706	687	99799	0	104021
26882	578	104418	812	3334	0	109142
26883	104092	2843	812	1791	0	109538
26884	100957	1514	839	1275	0	104585
26885	2967	102485	696	1534	0	107682
26886	1483	2668	101243	1206	0	106600
26887	939	1718	2419	100548	0	105624
26888	1113	1059	100252	2856	0	105280
26889	853	97605	2533	1968	0	102959
26890	868	99926	1189	1327	0	103310
26891	93833	2831	779	913	0	98356
26892	2505	97151	728	893	0	101277
26893	1563	2520	648	92762	0	97493
26894	1038	95080	787	2294	0	99199
26895	997	97929	487	1446	0	100859
26896	95954	2793	534	1090	0	100371
26897	2469	1395	501	95596	0	99961
26898	1389	948	95151	2594	0	100082
26899	1047	903	94455	1602	0	98007
26900	846	95722	2483	1251	0	100302
26901	94535	2513	1074	960	0	99082
26902	2301	96812	722	990	0	100825
26903	1225	2749	571	97603	0	102148
26904	97415	1438	645	2590	0	102088
26905	2661	962	526	99074	0	103223
26906	1390	956	568	99324	0	102238
26907	1027	99084	565	3187	0	103863
26908	940	2559	495	100300	0	104294
26909	817	1481	100275	2744	0	105317
26910	96002	999	2387	1444	0	100832
26911	2530	103418	974	1121	0	108043
26912	899	101806	463	732	0	103900
26913	96186	2157	299	534	0	99176
26914	2186	935	97098	517	0	100736
26915	89555	779	1882	475	0	92691
26916	1823	104116	685	610	0	107234
26917	379	110362	319	364	0	111424
26918	563	2534	109216	248	0	112561
26919	234	112206	2181	333	0	114954
26920	325	2275	755	102715	0	106070
26921	215	578	185	103390	0	104368
26922	123	106634	99	2200	0	109056
26923	180	2000	64	106290	0	108534
26924	107578	566	106	2048	0	110298
26925	2126	264	106830	550	0	109770
26926	105497	197	1976	291	0	107961
26927	110080	167	497	254	0	110998
26928	109273	184	184	202	0	109843
26929	2657	235	108754	144	0	111790
26930	728	192	2014	106711	0	109645
26931	431	230	109003	2120	0	111784
26932	103759	176	2194	624	0	106753
26933	104056	213	567	335	0	105171
26934	2363	107115	277	295	0	110050
26935	737	2156	144	104557	0	107594
26936	304	107858	178	2103	0	110443
26937	432	2286	108684	657	0	112059
26938	279	792	2214	107457	0	110742
26939	107479	384	623	2352	0	110838
26940	108707	255	292	668	0	109922
26941	2819	308	200	99607	0	102934
26942	810	102305	269	2137	0	105521
26943	567	2220	105711	595	0	109093
26944	388	731	107622	358	0	109099
26945	97835	365	2839	357	0	101396
26946	2521	358	106419	296	0	109594
26947	786	104701	2430	537	0	108454
26948	459	2301	710	103369	0	106839
26949	504	809	105870	2219	0	109402
26950	371	429	2386	102028	0	105214
26951	458	345	104620	2481	0	107904
26952	93823	310	2608	866	0	97607
26953	2478	355	850	98598	0	102281
26954	882	100516	475	2383	0	104256
26955	511	103546	375	930	0	105362
26956	521	2924	393	100509	0	104347
26957	511	922	396	99343	0	101172
26958	473	98908	473	2864	0	102718
26959	688	2390	99781	923	0	103782
26960	560	810	2497	99153	0	103020
26961	629	556	101915	2438	0	105538
26962	526	462	100339	905	0	102232
26963	89716	452	2995	612	0	93775
26964	2521	95363	1064	617	0	99565
26965	95133	2540	620	456	0	98749
26966	2710	1079	530	90724	0	95043
26967	999	94940	603	2551	0	99093
26968	715	2694	625	95949	0	99983
26969	577	1156	652	96244	0	98629
26970	634	94785	682	3140	0	99241
26971	784	2791	94372	1186	0	99133
26972	757	1093	2582	94881	0	99313
26973	94441	776	1137	2908	0	99262
26974	2797	729	751	94066	0	98343
26975	1234	639	768	94515	0	97156
26976	1024	686	91992	3381	0	97083
26977	843	91008	2897	1420	0	96168
26978	955	2712	1220	90210	0	95097
26979	976	1198	91094	2799	0	96067
26980	905	962	90961	1283	0	94111
26981	84803	893	3469	1079	0	90244
26982	2744	89314	1498	1230	0	94786
26983	87947	2770	1101	964	0	92782
26984	2929	88336	936	1068	0	93269
26985	1425	90815	847	1109	0	94196
26986	88525	3412	845	1019	0	93801
26987	3030	1351	844	85070	0	90295
26988	1425	88451	1027	2907	0	93810
26989	1162	2682	916	89972	0	94732
26990	89019	1055	904	3166	0	94144
26991	3303	806	90008	1442	0	95559
26992	1648	708	89955	1064	0	93375
26993	83241	724	3460	1095	0	88520
26994	2897	87682	1667	1077	0	93323
26995	1470	2688	88116	920	0	93194
26996	1094	87642	3105	1046	0	92887
26997	1055	2909	1452	86447	0	91863
26998	991	1290	88365	2943	0	93589
26999	791	1000	2986	87188	0	91965
27000	799	860	87190	3364	0	92213
27001	80956	830	3213	1580	0	86579
27002	2756	86020	1474	1277	0	91527
27003	84697	2676	1060	1050	0	89483
27004	2927	1302	938	77398	0	82565
27005	1126	89427	967	2798	0	94318
27006	89541	2967	1015	1337	0	94860
27007	90243	1275	1104	1081	0	93703
27008	3197	888	89614	1183	0	94882
27009	1286	819	88775	955	0	91835
27010	76979	770	3217	827	0	81793
27011	2280	80417	1571	958	0	85226
27012	761	77043	982	841	0	79627
27013	1429	3668	1300	71896	0	78293
27014	692	919	72808	2192	0	76611
27015	606	69322	2182	991	0	73101
27016	439	62159	879	650	0	64127
27017	1373	1157	558	43558	0	46646
27018	45093	303	270	812	0	46478
27019	45564	226	153	304	0	46247
27020	45856	157	146	253	0	46412
27021	906	223	45534	192	0	46855
27022	44053	169	719	199	0	45140
27023	45709	165	268	211	0	46353
27024	46351	157	172	203	0	46883
27025	949	183	156	43968	0	45256
27026	305	45468	154	724	0	46651
27027	44878	719	139	277	0	46013
27028	719	45156	167	187	0	46229
27029	233	717	136	44392	0	45478
27030	190	234	45486	751	0	46661
27031	153	185	744	44553	0	45635
27032	188	124	249	45775	0	46336
27033	194	140	45617	831	0	46782
27034	149	44990	697	317	0	46153
27035	167	602	177	42065	0	43011
27036	41218	181	162	595	0	42156
27037	551	40988	97	219	0	41855
27038	40286	517	80	145	0	41028
27039	590	229	88	38942	0	39849
27040	196	40449	80	495	0	41220
27041	40137	493	105	163	0	40898
27042	564	40758	97	168	0	41587
27043	235	488	39653	75	0	40451
27044	39429	258	535	83	0	40305
27045	40677	192	126	91	0	41086
27046	647	41446	89	120	0	42302
27047	256	560	40125	63	0	41004
27048	92	42258	527	104	0	42981
27049	146	803	205	33660	0	34814
27050	117	189	81	43007	0	43394
27051	106	137	41	42730	0	43014
27052	103	42861	42	786	0	43792
27053	124	633	51	42895	0	43703
27054	140	177	65	43429	0	43811
27055	42339	131	55	736	0	43261
27056	691	74	69	42103	0	42937
27057	255	57	63	43070	0	43445
27058	42117	75	46	811	0	43049
27059	685	42810	48	298	0	43841
27060	43220	637	56	160	0	44073
27061	43179	233	50	118	0	43580
27062	43173	142	89	144	0	43548
27063	857	115	87	42457	0	43516
27064	309	115	73	43693	0	44190
27065	219	115	42676	817	0	43827
27066	178	134	42206	288	0	42806
27067	186	132	42344	196	0	42858
27068	37741	110	865	180	0	38896
27069	804	160	41146	149	0	42259
27070	267	41611	745	246	0	42869
27071	246	746	206	40878	0	42076
27072	213	302	162	38803	0	39480
27073	250	42101	118	732	0	43201
27074	303	774	42410	268	0	43755
27075	207	42903	717	240	0	44067
27076	42390	792	250	173	0	43605
27077	860	309	43049	199	0	44417
27078	358	42502	733	269	0	43862
27079	320	765	43224	185	0	44494
27080	251	307	773	42363	0	43694
27081	242	250	43511	792	0	44795
27082	228	193	785	41588	0	42794
27083	43004	174	266	968	0	44412
27084	894	204	43320	378	0	44796
27085	339	43349	734	380	0	44802
27086	43538	807	255	323	0	44923
27087	881	281	44527	305	0	45994
27088	385	256	44532	315	0	45488
27089	292	148	853	43180	0	44473
27090	314	162	44281	943	0	45700
27091	40891	199	795	456	0	42341
27092	856	43568	275	388	0	45087
27093	444	802	206	42097	0	43549
27094	320	45451	163	837	0	46771
27095	45926	871	240	451	0	47488
27096	978	352	45632	342	0	47304
27097	455	272	47222	307	0	48256
27098	326	227	1036	45724	0	47313
27099	255	211	424	47233	0	48123
27100	263	324	299	47732	0	48618
27101	270	198	294	48301	0	49063
27102	293	256	48401	1157	0	50107
27103	253	47229	977	636	0	49095
27104	291	776	320	43795	0	45182
27105	229	322	42204	738	0	43493
27106	165	41712	735	384	0	42996
27107	41399	685	353	269	0	42706
27108	837	295	187	41324	0	42643
27109	40602	180	160	778	0	41720
27110	681	40890	151	399	0	42121
27111	40458	666	185	290	0	41599
27112	773	294	42262	224	0	43553
27113	343	340	704	38968	0	40355
27114	228	41923	312	638	0	43101
27115	246	658	41222	350	0	42476
27116	176	41425	698	297	0	42596
27117	176	892	363	34219	0	35650
27118	39479	233	198	654	0	40564
27119	594	39463	218	338	0	40613
27120	39216	560	222	227	0	40225
27121	667	254	39154	214	0	40289
27122	335	155	38549	229	0	39268
27123	37901	127	770	212	0	39010
27124	589	174	368	38610	0	39741
27125	290	171	251	39226	0	39938
27126	249	150	41384	697	0	42480
27127	176	164	40217	302	0	40859
27128	168	41606	761	246	0	42781
27129	40339	607	384	230	0	41560
27130	39158	218	225	165	0	39766
27131	586	38963	169	210	0	39928
27132	259	489	194	39933	0	40875
27133	40768	219	198	624	0	41809
27134	496	143	174	40820	0	41633
27135	41491	100	202	617	0	42410
27136	41768	129	188	299	0	42384
27137	42994	126	172	273	0	43565
27138	650	133	174	41948	0	42905
27139	285	145	159	43857	0	44446
27140	42781	110	165	733	0	43789
27141	42594	125	157	327	0	43203
27142	42412	136	174	182	0	42904
27143	691	42028	183	206	0	43108
27144	39749	405	128	115	0	40397
27145	417	39618	132	172	0	40339
27146	38883	412	117	155	0	39567
27147	480	151	39013	143	0	39787
27148	32824	146	505	180	0	33655
27149	325	36488	149	131	0	37093
27150	116	36391	117	124	0	36748
27151	36577	292	90	118	0	37077
27152	278	120	66	36440	0	36904
27153	136	60	61	37521	0	37778
27154	81	37820	99	378	0	38378
27155	73	39956	97	173	0	40299
27156	40876	359	65	114	0	41414
27157	406	139	42129	77	0	42751
27158	155	89	347	43681	0	44272
27159	44757	58	117	437	0	45369
27160	497	89	44937	162	0	45685
27161	177	48851	442	153	0	49623
27162	51771	566	134	109	0	52580
27163	790	154	53175	105	0	54224
27164	230	91	772	54827	0	55920
27165	157	103	57506	893	0	58659
27166	52712	76	911	274	0	53973
27167	895	57507	262	692	0	59356
27168	58561	888	109	140	0	59698
27169	58339	206	59	112	0	58716
27170	1053	121	52	57881	0	59107
27171	58366	71	58	977	0	59472
27172	981	84	77	58675	0	59817
27173	273	83	58	59437	0	59851
27174	182	92	57519	1069	0	58862
27175	140	57545	850	340	0	58875
27176	182	837	192	58197	0	59408
27177	94	225	115	58436	0	58870
27178	102	119	63	58899	0	59183
27179	158	104	57813	1072	0	59147
27180	115	57252	890	361	0	58618
27181	134	853	198	58090	0	59275
27182	130	193	101	58765	0	59189
27183	154	100	57948	1048	0	59250
27184	119	103	857	56539	0	57618
27185	57174	56	237	959	0	58426
27186	883	57816	107	326	0	59132
27187	57153	865	80	161	0	58259
27188	1047	241	56963	123	0	58374
27189	291	150	864	56498	0	57803
27190	57661	86	208	965	0	58920
27191	57366	87	114	282	0	57849
27192	1105	99	58414	146	0	59764
27193	363	125	889	56713	0	58090
27194	219	83	57619	940	0	58861
27195	53344	86	893	333	0	54656
27196	863	57239	285	272	0	58659
27197	57296	878	150	242	0	58566
27198	57154	240	139	162	0	57695
27199	1016	58055	189	223	0	59483
27200	58624	870	160	214	0	59868
27201	1025	232	58342	180	0	59779
27202	56599	123	910	222	0	57854
27203	993	151	282	58227	0	59653
27204	437	159	60676	948	0	62220
27205	352	112	951	59984	0	61399
27206	292	144	313	60960	0	61709
27207	335	135	244	60058	0	60772
27208	345	60683	227	1161	0	62416
27209	60849	893	218	535	0	62495
27210	1088	285	225	60350	0	61948
27211	457	60747	236	1131	0	62571
27212	376	942	248	57914	0	59480
27213	350	59299	238	1268	0	61155
27214	533	972	59013	532	0	61050
27215	362	311	1005	58289	0	59967
27216	329	250	376	60597	0	61552
27217	377	254	59702	1354	0	61687
27218	52162	251	1084	772	0	54269
27219	1033	59552	421	654	0	61660
27220	533	1016	357	59725	0	61631
27221	453	348	330	58383	0	59514
27222	428	297	321	57817	0	58863
27223	449	58906	333	1428	0	61116
27224	58022	1034	431	771	0	60258
27225	1176	398	58822	703	0	61099
27226	587	307	56300	599	0	57793
27227	475	279	1200	55593	0	57547
27228	444	264	488	57473	0	58669
27229	56714	252	403	1534	0	58903
27230	1155	56380	421	864	0	58820
27231	574	1038	447	57145	0	59204
27232	56306	429	388	1414	0	58537
27233	1282	362	371	55232	0	57247
27234	55660	271	409	1413	0	57753
27235	1370	339	53999	711	0	56419
27236	671	55231	1146	686	0	57734
27237	55391	1062	522	579	0	57554
27238	1380	456	55182	537	0	57555
27239	53309	300	1172	593	0	55374
27240	1382	304	54056	530	0	56272
27241	54083	279	1155	589	0	56106
27242	1385	278	458	54668	0	56789
27243	55358	284	445	1281	0	57368
27244	1301	295	369	55031	0	56996
27245	641	273	340	55971	0	57225
27246	55130	266	377	1485	0	57258
27247	1264	55041	372	727	0	57404
27248	609	1087	325	56102	0	58123
27249	57120	425	338	1435	0	59318
27250	58891	369	332	726	0	60318
27251	1364	368	303	58383	0	60418
27252	677	341	302	60390	0	61710
27253	60664	340	345	1548	0	62897
27254	1539	320	271	61765	0	63895
27255	673	296	297	61438	0	62704
27256	59363	281	319	1515	0	61478
27257	1429	219	301	57568	0	59517
27258	422	169	54581	1358	0	56530
27259	50458	147	1053	618	0	52276
27260	1095	182	53946	460	0	55683
27261	335	153	49116	292	0	49896
27262	44037	391	1215	228	0	45871
27263	605	45324	309	222	0	46460
27264	259	430	216	42735	0	43640
27265	142	91	171	42849	0	43253
27266	101	62	25	45528	0	45716
27267	71	50	32	46478	0	46631
27268	46649	35	39	685	0	47408
27269	48837	30	28	234	0	49129
27270	50929	27	37	173	0	51166
27271	910	34	56177	97	0	57218
27272	245	40	982	59197	0	60464
27273	155	27	302	60679	0	61163
27274	116	33	140	58843	0	59132
27275	101	57472	100	1639	0	59312
27276	84	60658	66	676	0	61484
27277	60568	1456	47	315	0	62386
27278	1277	485	49	60936	0	62747
27279	483	207	54	65200	0	65944
27280	261	90	55	66851	0	67257
27281	209	87	64424	2004	0	66724
27282	207	98	63434	712	0	64451
27283	62327	66	1811	389	0	64593
27284	66169	51	597	268	0	67085
27285	1898	61	279	63569	0	65807
27286	679	64815	164	1560	0	67218
27287	381	1414	129	64780	0	66704
27288	238	437	113	66205	0	66993
27289	250	199	64101	1959	0	66509
27290	62577	102	1447	840	0	64966
27291	1623	88	473	67168	0	69352
27292	624	70	240	66665	0	67599
27293	64493	64	179	2158	0	66894
27294	1646	66426	173	968	0	69213
27295	67699	1621	111	531	0	69962
27296	2005	590	101	65862	0	68558
27297	691	65486	108	1801	0	68086
27298	66181	1684	136	727	0	68728
27299	1787	590	114	65850	0	68341
27300	65128	269	99	1961	0	67457
27301	64695	133	120	869	0	65817
27302	64366	123	129	560	0	65178
27303	2367	62426	173	493	0	65459
27304	899	61836	193	455	0	63383
27305	556	2077	177	59093	0	61903
27306	386	61065	149	1858	0	63458
27307	61604	1829	125	818	0	64376
27308	1907	622	163	61573	0	64265
27309	61531	348	174	1969	0	64022
27310	62900	207	184	921	0	64212
27311	2424	159	183	60948	0	63714
27312	1052	155	186	63554	0	64947
27313	62528	197	182	2568	0	65475
27314	63431	248	146	1141	0	64966
27315	65090	240	160	759	0	66249
27316	65357	235	141	684	0	66417
27317	66075	233	109	640	0	67057
27318	2791	244	119	63910	0	67064
27319	1159	255	136	65340	0	66890
27320	772	295	158	66174	0	67399
27321	64066	239	167	2762	0	67234
27322	2285	216	130	62928	0	65559
27323	1061	63053	166	2416	0	66696
27324	779	1808	142	64513	0	67242
27325	63133	753	186	2372	0	66444
27326	64112	486	206	1065	0	65869
27327	2729	370	62088	770	0	65957
27328	1330	394	1748	59039	0	62511
27329	850	62031	657	2100	0	65638
27330	62477	1839	295	1152	0	65763
27331	2139	63261	195	970	0	66565
27332	1137	1989	188	63444	0	66758
27333	64349	749	195	2230	0	67523
27334	64907	433	253	1107	0	66700
27335	2807	63477	163	964	0	67411
27336	1444	1889	139	62820	0	66292
27337	1063	762	62414	2269	0	66508
27338	60527	460	1765	1219	0	63971
27339	2481	365	62548	877	0	66271
27340	62704	302	1965	813	0	65784
27341	64446	298	671	835	0	66250
27342	2923	373	299	62922	0	66517
27343	64191	354	144	2469	0	67158
27344	65572	376	145	1310	0	67403
27345	66180	401	150	875	0	67606
27346	3252	375	153	63583	0	67363
27347	63837	342	162	2366	0	66707
27348	2696	332	164	63091	0	66283
27349	1370	336	224	62759	0	64689
27350	982	61407	254	2735	0	65378
27351	1034	1852	197	57573	0	60656
27352	899	59505	169	2192	0	62765
27353	58077	1862	101	994	0	61034
27354	57825	758	77	757	0	59417
27355	2667	478	96	56087	0	59328
27356	1351	310	110	57221	0	58992
27357	56058	284	146	2482	0	58970
27358	2280	292	54350	1220	0	58142
27359	55600	252	1529	785	0	58166
27360	2562	255	568	54590	0	57975
27361	1289	265	52260	1987	0	55801
27362	52142	263	1519	1024	0	54948
27363	54243	244	567	811	0	55865
27364	2677	256	52482	657	0	56072
27365	52377	225	1544	660	0	54806
27366	2353	217	50909	571	0	54050
27367	1255	50252	1528	599	0	53634
27368	50098	1425	948	619	0	53090
27369	48978	635	405	570	0	50588
27370	2103	45834	207	472	0	48616
27371	830	40832	256	394	0	42312
27372	37000	856	404	333	0	38593
27373	37141	303	115	260	0	37819
27374	1206	216	79	37304	0	38805
27375	550	144	36477	808	0	37979
27376	394	149	35214	362	0	36119
27377	35522	126	753	287	0	36688
27378	910	133	36013	247	0	37303
27379	32638	310	862	226	0	34036
27380	747	106	232	32256	0	33341
27381	383	66	122	32813	0	33384
27382	323	72	32983	694	0	34072
27383	32642	53	495	354	0	33544
27384	641	61	228	33508	0	34438
27385	373	60	138	36061	0	36632
27386	35280	46	93	723	0	36142
27387	35195	55	102	379	0	35731
27388	35283	72	84	253	0	35692
27389	789	35610	100	274	0	36773
27390	356	410	33626	158	0	34550
27391	32766	141	380	153	0	33440
27392	33802	77	182	142	0	34203
27393	549	33162	108	160	0	33979
27394	31066	258	187	104	0	31615
27395	386	81	25	30658	0	31150
27396	193	89	31541	290	0	32113
27397	30912	61	300	191	0	31464
27398	31906	48	130	179	0	32263
27399	32145	57	79	92	0	32373
27400	32144	63	46	88	0	32341
27401	388	44	48	31945	0	32425
27402	204	29	54	32212	0	32499
27403	32199	32	58	353	0	32642
27404	326	32	53	32131	0	32542
27405	178	31	73	32039	0	32321
27406	141	31635	78	366	0	32220
27407	140	252	58	32017	0	32467
27408	127	85	69	32206	0	32487
27409	150	56	51	32272	0	32529
27410	144	53	42	32255	0	32494
27411	119	31768	54	403	0	32344
27412	140	254	46	31451	0	31891
27413	137	156	46	30719	0	31058
27414	134	79	30302	349	0	30864
27415	124	56	28636	153	0	28969
27416	75	29459	289	142	0	29965
27417	34880	209	147	100	0	35336
27418	409	35940	57	140	0	36546
27419	141	425	55	38005	0	38626
27420	131	120	40286	513	0	41050
27421	42128	68	544	232	0	42972
27422	616	54	135	44621	0	45426
27423	44704	44	88	639	0	45475
27424	44911	35	47	222	0	45215
27425	697	45080	59	190	0	46026
27426	44934	578	48	94	0	45654
27427	618	46663	65	134	0	47480
27428	208	727	30	47054	0	48019
27429	102	47799	71	710	0	48682
27430	160	669	47101	227	0	48157
27431	92	48092	662	173	0	49019
27432	120	732	164	47222	0	48238
27433	46881	167	91	651	0	47790
27434	632	48274	70	306	0	49282
27435	204	681	33	48324	0	49242
27436	117	228	26	49471	0	49842
27437	122	130	49181	903	0	50336
27438	115	64	736	48709	0	49624
27439	157	72	49261	847	0	50337
27440	45888	46	801	327	0	47062
27441	881	65	49889	168	0	51003
27442	317	49941	782	193	0	51233
27443	244	778	211	49586	0	50819
27444	224	248	99	49479	0	50050
27445	160	179	80	50315	0	50734
27446	50030	115	68	1033	0	51246
27447	864	143	89	48388	0	49484
27448	269	49433	83	906	0	50691
27449	48331	849	84	317	0	49581
27450	824	48170	86	245	0	49325
27451	302	914	68	47991	0	49275
27452	47921	313	64	930	0	49228
27453	891	47603	107	429	0	49030
27454	280	49542	85	322	0	50229
27455	49134	955	144	274	0	50507
27456	49675	305	129	260	0	50369
27457	1052	189	48961	237	0	50439
27458	49614	143	886	234	0	50877
27459	1034	174	51276	229	0	52713
27460	406	167	980	51321	0	52874
27461	279	196	51811	1082	0	53368
27462	212	164	1001	51656	0	53033
27463	244	211	52001	1218	0	53674
27464	212	161	981	50457	0	51811
27465	242	159	306	52288	0	52995
27466	51140	186	191	1277	0	52794
27467	1069	223	50655	489	0	52436
27468	48057	212	981	381	0	49631
27469	1154	215	50266	328	0	51963
27470	417	228	50888	292	0	51825
27471	274	323	1079	49642	0	51318
27472	50331	199	333	1102	0	51965
27473	1013	50722	229	478	0	52442
27474	49805	986	160	347	0	51298
27475	49826	346	193	275	0	50640
27476	1253	49544	219	332	0	51348
27477	49681	982	240	259	0	51162
27478	1211	399	50711	245	0	52566
27479	467	216	1031	50740	0	52454
27480	50828	178	400	1136	0	52542
27481	1062	51420	290	559	0	53331
27482	428	961	233	50672	0	52294
27483	322	316	234	51570	0	52442
27484	284	247	228	51775	0	52534
27485	325	180	208	52259	0	52972
27486	51128	204	274	1332	0	52938
27487	51863	179	272	633	0	52947
27488	52473	150	290	460	0	53373
27489	51774	172	274	401	0	52621
27490	1413	229	51044	367	0	53053
27491	50183	206	1023	330	0	51742
27492	51788	228	397	320	0	52733
27493	1410	50958	286	338	0	52992
27494	610	52108	272	359	0	53349
27495	499	1172	250	51223	0	53144
27496	404	392	276	51383	0	52455
27497	401	314	50436	1258	0	52409
27498	353	51502	1082	631	0	53568
27499	375	1024	416	50134	0	51949
27500	323	51934	312	1189	0	53758
27501	347	2704	221	51048	0	54320
27502	343	369	218	52741	0	53671
27503	337	54636	270	1436	0	56679
27504	391	1049	224	55248	0	56912
27505	463	334	55406	1302	0	57505
27506	459	229	55324	588	0	56600
27507	52784	169	1350	421	0	54724
27508	56439	160	502	390	0	57491
27509	1463	55798	356	414	0	58031
27510	56295	1047	259	334	0	57935
27511	1416	413	251	55896	0	57976
27512	55814	301	207	1228	0	57550
27513	1297	55938	227	706	0	58168
27514	748	1077	55020	436	0	57281
27515	53554	371	1299	455	0	55679
27516	1363	331	57883	391	0	59968
27517	546	209	51509	266	0	52530
27518	429	249	51053	288	0	52019
27519	271	49365	978	299	0	50913
27520	45944	1042	1178	385	0	48549
27521	44688	278	230	307	0	45503
27522	784	172	186	43605	0	44747
27523	399	148	155	43234	0	43936
27524	266	45187	170	780	0	46403
27525	45450	558	186	415	0	46609
27526	693	46054	188	236	0	47171
27527	319	44911	195	257	0	45682
27528	44244	552	207	236	0	45239
27529	664	215	173	43599	0	44651
27530	311	138	152	43955	0	44556
27531	266	127	128	44120	0	44641
27532	202	43707	145	686	0	44740
27533	42991	451	100	261	0	43803
27534	624	271	125	42177	0	43197
27535	252	41423	117	502	0	42294
27536	177	41428	126	231	0	41962
27537	192	470	113	39888	0	40663
27538	158	40573	117	460	0	41308
27539	228	459	96	40274	0	41057
27540	39205	172	100	481	0	39958
27541	453	156	38731	211	0	39551
27542	204	39652	357	203	0	40416
27543	204	383	136	40214	0	40937
27544	181	176	40981	399	0	41737
27545	38717	119	410	201	0	39447
27546	564	164	148	41184	0	42060
27547	40996	81	101	522	0	41700
27548	41174	89	100	242	0	41605
27549	564	43235	84	143	0	44026
27550	43816	405	76	133	0	44430
27551	43592	184	71	153	0	44000
27552	43564	109	146	164	0	43983
27553	553	110	76	42499	0	43238
27554	244	101	65	42532	0	42942
27555	168	95	84	43060	0	43407
27556	172	162	42238	577	0	43149
27557	115	41888	390	303	0	42696
27558	40650	340	144	150	0	41284
27559	345	40377	67	145	0	40934
27560	136	308	32	39858	0	40334
27561	138	141	39395	325	0	39999
27562	34619	92	287	204	0	35202
27563	305	39818	112	108	0	40343
27564	154	286	51	39511	0	40002
27565	94	110	43	39504	0	39751
27566	117	115	39066	372	0	39670
27567	83	39167	276	202	0	39728
27568	78	287	102	39444	0	39911
27569	86	124	46	39577	0	39833
27570	83	85	45	38601	0	38814
27571	36824	67	56	429	0	37376
27572	339	109	37420	158	0	38026
27573	159	37403	280	132	0	37974
27574	37123	272	121	101	0	37617
27575	276	37816	63	114	0	38269
27576	151	347	48	36973	0	37519
27577	80	37979	63	311	0	38433
27578	36200	285	49	161	0	36695
27579	36858	143	40	141	0	37182
27580	405	96	46	38170	0	38717
27581	187	63	51	38603	0	38904
27582	113	87	38	40765	0	41003
27583	133	82	41208	573	0	41996
27584	93	43140	465	256	0	43954
27585	110	555	162	51250	0	52077
27586	95	198	76	52850	0	53219
27587	111	83	49	53662	0	53905
27588	106	85	61	53596	0	53848
27589	168	129	52365	1282	0	53944
27590	94	55844	870	588	0	57396
27591	114	1062	301	57690	0	59167
27592	104	414	125	63047	0	63690
27593	128	228	61912	1634	0	63902
27594	108	135	1188	58553	0	59984
27595	95	60206	463	1372	0	62136
27596	101	62543	203	652	0	63499
27597	111	1599	104	61155	0	62969
27598	175	563	59400	1383	0	61521
27599	52360	249	1227	796	0	54632
27600	1124	58567	518	594	0	60803
27601	442	1261	58407	341	0	60451
27602	258	536	59063	336	0	60193
27603	115	57284	1574	363	0	59336
27604	294	1231	58428	242	0	60195
27605	188	788	1384	56720	0	59080
27606	56927	290	589	1239	0	59045
27607	57732	185	337	559	0	58813
27608	57644	204	211	367	0	58426
27609	58732	186	253	215	0	59386
27610	1615	60009	168	335	0	62127
27611	59364	1276	178	297	0	61115
27612	1441	60727	219	423	0	62810
27613	709	1418	59928	282	0	62337
27614	388	574	1338	56561	0	58861
27615	265	60988	593	1347	0	63193
27616	234	1449	296	58528	0	60507
27617	57011	702	216	1577	0	59506
27618	1329	333	260	54690	0	56612
27619	529	58291	229	1634	0	60683
27620	58536	1376	252	767	0	60931
27621	1434	613	58530	574	0	61151
27622	681	410	1362	57789	0	60242
27623	358	305	602	58689	0	59954
27624	56039	341	346	1907	0	58633
27625	1393	56211	327	1033	0	58964
27626	623	1487	55719	596	0	58425
27627	427	668	1415	55857	0	58367
27628	344	458	56505	1671	0	58978
27629	280	54714	1523	1064	0	57581
27630	261	56927	662	796	0	58646
27631	55797	1778	437	690	0	58702
27632	1460	895	55821	654	0	58830
27633	56187	554	1629	682	0	59052
27634	1538	482	838	54136	0	56994
27635	633	56841	627	1588	0	59689
27636	56508	1629	471	934	0	59542
27637	1547	791	57573	794	0	60705
27638	873	576	1555	56710	0	59714
27639	558	494	828	57553	0	59433
27640	524	645	545	56045	0	57759
27641	501	57029	556	2158	0	60244
27642	54579	1739	540	1057	0	57915
27643	1555	55380	491	904	0	58330
27644	790	56256	555	748	0	58349
27645	624	1929	532	55493	0	58578
27646	55201	1026	609	1755	0	58591
27647	55173	740	549	1031	0	57493
27648	54803	792	534	817	0	56946
27649	1957	52590	534	858	0	55939
27650	1069	1653	537	52565	0	55824
27651	855	1018	52828	1765	0	56466
27652	822	699	1597	52313	0	55431
27653	746	589	945	50967	0	53247
27654	727	52895	626	2079	0	56327
27655	52870	1751	563	1285	0	56469
27656	1730	1069	575	51034	0	54408
27657	992	53268	593	1885	0	56738
27658	53246	1806	619	1092	0	56763
27659	1878	1045	53041	895	0	56859
27660	51747	809	1557	863	0	54976
27661	1898	53747	883	888	0	57416
27662	54021	1843	580	761	0	57205
27663	54686	1149	545	650	0	57030
27664	2120	975	53819	667	0	57581
27665	53762	856	1688	603	0	56909
27666	1995	684	55952	749	0	59380
27667	1179	729	56391	704	0	59003
27668	54723	748	1930	614	0	58015
27669	56419	672	1002	676	0	58769
27670	2356	756	56454	592	0	60158
27671	1285	617	1811	55090	0	58803
27672	972	641	1107	53893	0	56613
27673	901	58074	711	2048	0	61734
27674	58065	1713	679	1064	0	61521
27675	59239	1009	435	854	0	61537
27676	2493	784	58588	668	0	62533
27677	58556	679	1588	736	0	61559
27678	59907	766	835	712	0	62220
27679	2353	59337	638	794	0	63122
27680	1193	1847	560	57446	0	61046
27681	1173	1010	570	57913	0	60666
27682	967	731	448	56452	0	58598
27683	53337	609	586	1775	0	56307
27684	1609	51601	415	1125	0	54750
27685	739	1100	318	42017	0	44174
27686	588	42555	248	912	0	44303
27687	485	1815	250	39114	0	41664
27688	474	40461	230	795	0	41960
27689	430	41377	285	524	0	42616
27690	36085	782	519	451	0	37837
27691	35523	273	437	425	0	36658
27692	435	105	98	32509	0	33147
27693	172	77	93	33010	0	33352
27694	161	71	74	33170	0	33476
27695	120	72	83	33198	0	33473
27696	110	80	86	32943	0	33219
27697	123	32734	56	421	0	33334
27698	138	318	74	33145	0	33675
27699	151	145	54	33490	0	33840
27700	32211	93	71	396	0	32771
27701	428	72	70	32792	0	33362
27702	205	78	57	32811	0	33151
27703	178	97	33228	422	0	33925
27704	127	106	296	32173	0	32702
27705	128	145	115	33536	0	33924
27706	174	73	34228	479	0	34954
27707	108	35281	341	331	0	36061
27708	135	354	35731	205	0	36425
27709	133	104	35159	115	0	35511
27710	64	33724	295	109	0	34192
27711	34250	237	151	112	0	34750
27712	33972	53	43	90	0	34158
27713	267	42	20	33250	0	33579
27714	33917	28	31	288	0	34264
27715	304	53	35262	95	0	35714
27716	95	23	258	35596	0	35972
27717	111	71	40187	318	0	40687
27718	61	30	265	40177	0	40533
27719	68	47	87	40720	0	40922
27720	59	41	43	41145	0	41288
27721	40502	36	32	469	0	41039
27722	299	32	29	41256	0	41616
27723	41009	42	31	405	0	41487
27724	41326	37	37	182	0	41582
27725	334	41418	54	169	0	41975
27726	41438	301	34	155	0	41928
27727	309	43390	53	134	0	43886
27728	119	313	60	42450	0	42942
27729	97	98	38	43506	0	43739
27730	97	75	47	43785	0	44004
27731	127	85	42982	503	0	43697
27732	83	42874	332	281	0	43570
27733	110	392	112	40328	0	40942
27734	141	147	79	40650	0	41017
27735	76	42917	62	433	0	43488
27736	42760	363	70	186	0	43379
27737	378	41913	64	244	0	42599
27738	41307	408	38	154	0	41907
27739	397	42690	70	241	0	43398
27740	183	435	36	41156	0	41810
27741	98	43247	62	472	0	43879
27742	43884	382	57	281	0	44604
27743	44400	131	59	233	0	44823
27744	44521	112	78	276	0	44987
27745	44510	89	72	245	0	44916
27746	517	128	44976	207	0	45828
27747	45042	80	345	236	0	45703
27748	46348	91	123	254	0	46816
27749	46398	112	77	236	0	46823
27750	527	123	45911	211	0	46772
27751	45143	106	351	250	0	45850
27752	435	46826	118	293	0	47672
27753	47385	366	129	251	0	48131
27754	516	209	51146	252	0	52123
27755	50708	132	394	277	0	51511
27756	51934	128	155	243	0	52460
27757	499	111	100	51661	0	52371
27758	287	135	51384	489	0	52295
27759	50998	91	374	363	0	51826
27760	454	110	139	52715	0	53418
27761	252	82	140	54052	0	54526
27762	244	117	54227	547	0	55135
27763	49795	101	393	340	0	50629
27764	53769	67	161	237	0	54234
27765	472	54221	138	244	0	55075
27766	283	389	102	53455	0	54229
27767	211	154	143	53659	0	54167
27768	216	132	106	53035	0	53489
27769	197	54051	152	556	0	54956
27770	53315	402	111	310	0	54138
27771	495	167	105	53199	0	53966
27772	284	117	74	53564	0	54039
27773	51890	78	90	564	0	52622
27774	51428	79	112	328	0	51947
27775	573	103	138	52250	0	53064
27776	332	123	111	51534	0	52100
27777	247	134	49882	590	0	50853
27778	46069	105	394	352	0	46920
27779	522	50349	142	278	0	51291
27780	268	436	100	52892	0	53696
27781	246	148	81	54231	0	54706
27782	214	56983	100	852	0	58149
27783	232	784	89	58470	0	59575
27784	62946	382	86	1043	0	64457
27785	1209	212	74	74602	0	76097
27786	541	121	66	77245	0	77973
27787	350	145	55	79031	0	79581
27788	314	187	75862	2915	0	79278
27789	238	92	1657	77300	0	79287
27790	306	127	75418	2344	0	78195
27791	202	73800	1852	1283	0	77137
27792	230	1598	937	74615	0	77380
27793	213	771	384	76294	0	77662
27794	191	341	185	77450	0	78167
27795	199	176	171	77738	0	78284
27796	212	143	149	78691	0	79195
27797	73672	104	139	3152	0	77067
27798	1790	164	74393	1519	0	77866
27799	889	72900	1648	873	0	76310
27800	433	77347	811	620	0	79211
27801	254	2329	371	75982	0	78936
27802	242	1066	193	77901	0	79402
27803	213	467	161	76905	0	77746
27804	170	75152	145	2948	0	78415
27805	239	1709	108	76781	0	78837
27806	246	874	73579	2429	0	77128
27807	141	72368	1635	1414	0	75558
27808	193	1823	809	73462	0	76287
27809	71449	905	390	2210	0	74954
27810	1649	417	203	73233	0	75502
27811	883	315	205	72658	0	74061
27812	432	68386	172	2912	0	71902
27813	329	73726	199	1688	0	75942
27814	346	2221	212	73244	0	76023
27815	235	1068	144	73934	0	75381
27816	267	545	71134	3115	0	75061
27817	215	402	1647	68912	0	71176
27818	177	296	955	70135	0	71563
27819	214	325	539	69436	0	70514
27820	214	318	386	70818	0	71736
27821	67068	344	389	3596	0	71397
27822	68371	304	302	2277	0	71254
27823	2553	296	287	69258	0	72394
27824	1273	256	266	72165	0	73960
27825	69078	243	298	3956	0	73575
27826	2063	270	314	72373	0	75020
27827	1192	311	69874	3716	0	75093
27828	591	69791	2052	2594	0	75028
27829	455	1937	1285	71903	0	75580
27830	398	1192	805	74081	0	76476
27831	71409	808	519	3977	0	76713
27832	1868	629	484	74130	0	77111
27833	1041	620	301	76211	0	78173
27834	73577	464	306	4399	0	78746
27835	2066	538	331	74590	0	77525
27836	1211	73540	336	3820	0	78907
27837	739	2132	430	78423	0	81724
27838	579	1329	462	81466	0	83836
27839	606	922	430	81287	0	83245
27840	409	780	481	81982	0	83652
27841	454	894	76861	4654	0	82863
27842	417	779	76751	3190	0	81137
27843	329	712	2846	77670	0	81557
27844	320	745	1398	76242	0	78705
27845	279	75864	823	4664	0	81630
27846	399	2426	634	73833	0	77292
27847	418	74617	675	4027	0	79737
27848	72573	2538	620	2864	0	78595
27849	2191	76592	532	2470	0	81785
27850	1331	2725	433	78618	0	83107
27851	838	1579	318	81271	0	84006
27852	683	1077	76379	4877	0	83016
27853	71979	770	2159	3389	0	78297
27854	72493	807	1204	2667	0	77171
27855	2929	72041	789	2669	0	78428
27856	1660	2317	693	70091	0	74761
27857	1157	1352	73776	3802	0	80087
27858	677	75061	2432	2985	0	81155
27859	74070	2454	1284	2545	0	80353
27860	75136	1388	683	2364	0	79571
27861	3525	765	70831	2330	0	77451
27862	71844	600	2095	2269	0	76808
27863	3097	618	1116	71120	0	75951
27864	1835	71587	695	3829	0	77946
27865	71822	2325	514	2835	0	77496
27866	2727	1472	555	72352	0	77106
27867	72248	952	523	3830	0	77553
27868	74497	797	516	2991	0	78801
27869	3346	754	487	73718	0	78305
27870	1877	668	72457	4201	0	79203
27871	72294	528	2187	3217	0	78226
27872	75744	589	1231	2526	0	80090
27873	75543	547	799	2198	0	79087
27874	3590	75555	626	2325	0	82096
27875	1942	2369	475	76050	0	80836
27876	1302	1456	382	80244	0	83384
27877	963	957	76433	4796	0	83149
27878	876	826	2231	75187	0	79120
27879	708	75122	1310	4168	0	81308
27880	70885	2202	736	2718	0	76541
27881	2234	72322	670	2207	0	77433
27882	1327	2042	69147	1614	0	74130
27883	686	69849	2142	1775	0	74452
27884	558	66793	1093	1152	0	69596
27885	770	1042	849	52845	0	55506
27886	52732	352	303	941	0	54328
27887	52469	210	152	482	0	53313
27888	51735	175	132	393	0	52435
27889	927	52637	143	432	0	54139
27890	468	739	51540	317	0	53064
27891	51514	337	672	321	0	52844
27892	53590	194	283	331	0	54398
27893	958	52699	217	384	0	54258
27894	53911	746	156	320	0	55133
27895	915	346	143	53917	0	55321
27896	464	264	56165	926	0	57819
27897	55878	207	789	518	0	57392
27898	57148	206	306	405	0	58065
27899	58518	189	193	335	0	59235
27900	1183	206	145	57319	0	58853
27901	525	227	157	60297	0	61206
27902	369	187	139	62974	0	63669
27903	298	63514	163	1417	0	65392
27904	346	1049	161	68383	0	69939
27905	367	409	127	72506	0	73409
27906	390	289	71766	1650	0	74095
27907	337	232	1267	71767	0	73603
27908	351	196	409	73750	0	74706
27909	294	229	253	73451	0	74227
27910	346	224	201	72399	0	73170
27911	337	72240	194	1852	0	74623
27912	389	1359	178	72779	0	74705
27913	422	458	190	72738	0	73808
27914	70815	282	219	1848	0	73164
27915	1559	242	70767	731	0	73299
27916	683	256	69314	488	0	70741
27917	67417	233	1597	459	0	69706
27918	70484	212	1005	450	0	72151
27919	1873	360	256	60428	0	62917
27920	694	69891	239	1280	0	72104
27921	70219	1332	207	617	0	72375
27922	1634	476	220	67582	0	69912
27923	634	70190	238	1465	0	72527
27924	68853	1185	182	581	0	70801
27925	1364	69478	188	489	0	71519
27926	68239	1265	182	356	0	70042
27927	66273	404	130	410	0	67217
27928	1530	64984	153	459	0	67126
27929	627	1159	147	64814	0	66747
27930	502	424	64252	1368	0	66546
27931	343	364	1125	63182	0	65014
27932	63385	239	369	1437	0	65430
27933	1334	264	62404	662	0	64664
27934	506	62036	1134	667	0	64343
27935	421	1390	365	61549	0	63725
27936	488	478	60549	1342	0	62857
27937	249	59519	1125	732	0	61625
27938	58742	1133	479	508	0	60862
27939	1156	409	256	59049	0	60870
27940	464	229	178	59756	0	60627
27941	350	221	226	57967	0	58764
27942	266	58743	223	1473	0	60705
27943	58630	1073	166	664	0	60533
27944	1154	58198	220	529	0	60101
27945	462	59753	175	499	0	60889
27946	59485	1224	153	423	0	61285
27947	59713	445	175	378	0	60711
27948	1406	335	57972	374	0	60087
27949	55964	291	1008	369	0	57632
27950	56253	292	351	314	0	57210
27951	1469	257	219	54923	0	56868
27952	695	298	54622	1184	0	56799
27953	484	256	1011	54471	0	56222
27954	55348	223	363	1299	0	57233
27955	1342	248	56183	605	0	58378
27956	597	235	1131	60197	0	62160
27957	477	199	395	65826	0	66897
27958	437	262	238	71583	0	72520
27959	70293	235	213	2320	0	73061
27960	1858	71440	267	1101	0	74666
27961	71830	1853	203	641	0	74527
27962	2124	534	71874	618	0	75150
27963	694	339	1849	68748	0	71630
27964	437	72619	515	2105	0	75676
27965	73078	1860	278	857	0	76073
27966	2063	542	275	73333	0	76213
27967	712	388	72129	2230	0	75459
27968	497	290	1785	71544	0	74116
27969	69470	295	581	2217	0	72563
27970	1921	69702	333	1054	0	73010
27971	707	1983	254	62125	0	65069
27972	438	69041	245	1910	0	71634
27973	68208	1849	232	777	0	71066
27974	67637	550	272	582	0	69041
27975	2135	66969	281	601	0	69986
27976	66097	1736	217	455	0	68505
27977	2008	552	190	62213	0	64963
27978	648	65379	224	1843	0	68094
27979	65453	1785	215	602	0	68055
27980	66352	521	202	479	0	67554
27981	2223	63919	252	486	0	66880
27982	774	65137	247	419	0	66577
27983	63411	1947	228	351	0	65937
27984	1971	565	193	63253	0	65982
27985	63855	354	229	1806	0	66244
27986	2008	367	168	63843	0	66386
27987	832	338	63267	1853	0	66290
27988	548	313	1631	63978	0	66470
27989	63049	322	393	2000	0	65764
27990	2008	380	64009	655	0	67052
27991	728	291	1713	63272	0	66004
27992	557	264	450	66173	0	67444
27993	488	315	64547	2168	0	67518
27994	61175	255	1746	753	0	63929
27995	1944	269	487	64004	0	66704
27996	674	270	61010	1979	0	63933
27997	55256	293	1753	732	0	58034
27998	1736	60340	568	575	0	63219
27999	566	60779	324	639	0	62308
28000	495	61495	318	553	0	62861
28001	583	1760	57307	438	0	60088
28002	554	994	1483	53701	0	56732
28003	390	319	54304	1661	0	56674
28004	379	1374	1324	46574	0	49651
28005	198	46214	328	1388	0	48128
28006	240	46127	179	426	0	46972
28007	389	1304	229	44852	0	46774
28008	45228	356	220	1259	0	47063
28009	1157	229	126	45741	0	47253
28010	339	185	124	45799	0	46447
28011	274	45655	108	1339	0	47376
28012	44774	1117	106	428	0	46425
28013	1121	45659	137	375	0	47292
28014	404	1187	134	46139	0	47864
28015	342	338	134	46202	0	47016
28016	276	45899	143	1458	0	47776
28017	308	1185	126	46561	0	48180
28018	46033	368	141	1443	0	47985
28019	1355	418	102	46107	0	47982
28020	616	407	141	45891	0	47055
28021	564	45614	206	1414	0	47798
28022	454	1254	224	46310	0	48242
28023	44662	458	196	1419	0	46735
28024	45949	428	180	578	0	47135
28025	46567	379	154	491	0	47591
28026	1617	350	193	45739	0	47899
28027	688	318	45114	1504	0	47624
28028	570	330	45375	663	0	46938
28029	523	341	1321	45673	0	47858
28030	46219	419	305	1454	0	48397
28031	1451	403	200	46346	0	48400
28032	47350	414	192	1512	0	49468
28033	1631	351	163	47688	0	49833
28034	711	360	204	48670	0	49945
28035	48126	371	200	1535	0	50232
28036	1617	362	46716	622	0	49317
28037	46633	395	1165	513	0	48706
28038	1566	397	47128	453	0	49544
28039	736	329	1177	46609	0	48851
28040	47515	320	411	1439	0	49685
28041	1579	373	48637	494	0	51083
28042	647	424	48981	408	0	50460
28043	46997	321	1423	483	0	49224
28044	1546	313	49069	549	0	51477
28045	639	48846	1330	565	0	51380
28046	466	1256	438	51376	0	53536
28047	54900	401	378	1793	0	57472
28048	1426	299	56016	731	0	58472
28049	55668	226	1420	588	0	57902
28050	57868	224	546	553	0	59191
28051	57970	222	388	637	0	59217
28052	57789	255	340	629	0	59013
28053	1668	504	371	55106	0	57649
28054	623	56103	336	1582	0	58644
28055	54635	1183	412	812	0	57042
28056	1312	290	49892	496	0	51990
28057	303	41925	727	322	0	43277
28058	38049	432	336	171	0	38988
28059	443	36487	150	161	0	37241
28060	193	38602	89	151	0	39035
28061	685	473	323	37634	0	39115
28062	129	137	129	38154	0	38549
28063	104	63	71	38351	0	38589
28064	38569	44	95	478	0	39186
28065	39345	48	73	254	0	39720
28066	545	47	66	41265	0	41923
28067	215	54	79	43582	0	43930
28068	161	58	44861	652	0	45732
28069	42504	51	595	260	0	43410
28070	45773	38	172	165	0	46148
28071	735	48	107	45722	0	46612
28072	268	44	78	46281	0	46671
28073	209	57	45889	765	0	46920
28074	135	86	627	44854	0	45702
28075	159	53	47171	721	0	48104
28076	142	46799	701	443	0	48085
28077	194	577	47816	181	0	48768
28078	154	249	672	45655	0	46730
28079	171	93	48924	663	0	49851
28080	127	92	47304	240	0	47763
28081	47094	65	820	160	0	48139
28082	708	72	277	50912	0	51969
28083	284	86	51387	711	0	52468
28084	46054	54	792	298	0	47198
28085	793	79	51780	179	0	52831
28086	357	92	57004	201	0	57654
28087	160	58496	875	332	0	59863
28088	176	623	228	58406	0	59433
28089	190	189	58551	708	0	59638
28090	227	134	57159	236	0	57756
28091	165	98	801	56701	0	57765
28092	158	63	277	56716	0	57214
28093	165	58507	194	831	0	59697
28094	164	718	154	58795	0	59831
28095	60088	188	128	879	0	61283
28096	59852	105	141	354	0	60452
28097	60930	75	159	312	0	61476
28098	923	88	164	59476	0	60651
28099	335	61351	190	863	0	62739
28100	61116	678	155	349	0	62298
28101	701	61940	183	306	0	63130
28102	277	61733	211	285	0	62506
28103	209	62058	196	275	0	62738
28104	61882	783	238	265	0	63168
28105	747	236	200	61534	0	62717
28106	289	162	205	61492	0	62148
28107	188	62509	203	915	0	63815
28108	60681	706	234	393	0	62014
28109	799	261	61111	238	0	62409
28110	290	147	806	61268	0	62511
28111	61739	118	333	807	0	62997
28112	755	64560	276	407	0	65998
28113	68289	692	220	468	0	69669
28114	839	281	227	69152	0	70499
28115	304	71685	261	833	0	73083
28116	316	758	69927	319	0	71320
28117	68090	223	784	302	0	69399
28118	782	181	314	72670	0	73947
28119	73505	156	233	902	0	74796
28120	840	169	208	73053	0	74270
28121	336	73489	244	968	0	75037
28122	339	748	75443	372	0	76902
28123	354	308	75206	301	0	76169
28124	246	420	842	75374	0	76882
28125	77207	161	377	839	0	78584
28126	77278	163	223	375	0	78039
28127	884	129	211	76520	0	77744
28128	394	151	182	77322	0	78049
28129	78108	153	220	939	0	79420
28130	821	172	188	78216	0	79397
28131	78834	157	233	960	0	80184
28132	812	78276	260	512	0	79860
28133	77006	727	250	359	0	78342
28134	925	326	80525	329	0	82105
28135	416	238	846	79670	0	81170
28136	367	177	347	82149	0	83040
28137	321	161	322	82083	0	82887
28138	316	80532	294	1140	0	82282
28139	321	79822	292	651	0	81086
28140	295	845	251	80790	0	82181
28141	273	348	79680	1036	0	81337
28142	254	247	819	79086	0	80406
28143	250	183	396	81143	0	81972
28144	236	80395	329	1064	0	82024
28145	78667	739	305	441	0	80152
28146	717	78476	294	461	0	79948
28147	340	78637	295	393	0	79665
28148	328	958	286	77573	0	79145
28149	355	259	308	78404	0	79326
28150	368	212	226	77927	0	78733
28151	317	217	206	78808	0	79548
28152	77149	180	256	1002	0	78587
28153	729	78055	281	525	0	79590
28154	78560	699	268	416	0	79943
28155	80808	294	288	451	0	81841
28156	843	251	208	80177	0	81479
28157	354	256	161	81482	0	82253
28158	80855	184	177	1011	0	82227
28159	80186	224	202	581	0	81193
28160	904	222	120	80417	0	81663
28161	483	224	84	81038	0	81829
28162	443	256	81373	943	0	83015
28163	356	79722	634	587	0	81299
28164	344	83500	191	484	0	84519
28165	79999	632	185	327	0	81143
28166	739	322	82071	251	0	83383
28167	284	203	76959	216	0	77662
28168	71072	145	531	229	0	71977
28169	77321	89	200	190	0	77800
28170	402	84834	94	232	0	85562
28171	184	88984	70	210	0	89448
28172	184	475	49	89683	0	90391
28173	93617	141	44	617	0	94419
28174	93882	87	56	306	0	94331
28175	94428	110	60	360	0	94958
28176	471	120	59	93407	0	94057
28177	226	107	52	94789	0	95174
28178	221	134	93890	479	0	94724
28179	191	142	88463	232	0	89028
28180	194	124	93465	188	0	93971
28181	203	836	358	90830	0	92227
28182	90833	57	199	347	0	91436
28183	355	104	94550	212	0	95221
28184	152	63	248	92877	0	93340
28185	114	97396	122	394	0	98026
28186	125	269	65	94602	0	95061
28187	99	110	45	95010	0	95264
28188	164	116	98219	497	0	98996
28189	86	78	405	96055	0	96624
28190	101970	46	169	522	0	102707
28191	746	118	107419	204	0	108487
28192	297	80	664	106104	0	107145
28193	214	100	110596	774	0	111684
28194	109	110580	785	518	0	111992
28195	335	750	110808	251	0	112144
28196	128	328	829	105493	0	106778
28197	119	177	288	112057	0	112641
28198	206	137	116617	1038	0	117998
28199	115	102	822	111729	0	112768
28200	143	110	325	113471	0	114049
28201	92	114252	194	1146	0	115684
28202	229	815	115052	492	0	116588
28203	118	286	856	112910	0	114170
28204	132	161	339	115495	0	116127
28205	91	117376	217	1214	0	118898
28206	120	966	118	118511	0	119715
28207	118933	299	135	1041	0	120408
28208	895	175	113	118963	0	120146
28209	406	127	121083	1086	0	122702
28210	114955	81	992	602	0	116630
28211	126794	100	390	396	0	127680
28212	1527	165	130445	219	0	132356
28213	120772	109	1224	457	0	122562
28214	1307	130988	586	422	0	133303
28215	562	1269	266	133577	0	135674
28216	291	513	203	147632	0	148639
28217	199	230	159	148095	0	148683
28218	185	126	159	149562	0	150032
28219	192	113	179	150296	0	150780
28220	147421	88	170	2710	0	150389
28221	1966	160	146489	1023	0	149638
28222	137353	121	1938	659	0	140071
28223	2172	145	144070	479	0	146866
28224	798	125	2042	142362	0	145327
28225	144085	128	787	2214	0	147214
28226	2074	176	437	141129	0	143816
28227	840	145622	350	2278	0	149090
28228	150352	1762	391	1090	0	153595
28229	2167	670	374	157586	0	160797
28230	958	362	155944	2222	0	159486
28231	140137	191	1997	1184	0	143509
28232	2052	162799	839	918	0	166608
28233	1014	1987	167719	581	0	171301
28234	594	753	2206	163597	0	167150
28235	476	370	905	162641	0	164392
28236	402	165064	505	3024	0	168995
28237	570	2090	164367	1302	0	168329
28238	427	746	2155	162420	0	165748
28239	519	483	172029	2647	0	175678
28240	349	346	2377	168106	0	171178
28241	371	241	964	172357	0	173933
28242	570	287	173231	3284	0	177372
28243	498	273	2372	170438	0	173581
28244	561	356	1236	156204	0	158357
28245	533	241	696	182327	0	183797
28246	531	223	668	183596	0	185018
28247	176674	242	618	3890	0	181424
28248	2722	327	176165	1848	0	181062
28249	178445	323	2695	1513	0	182976
28250	2932	380	1278	190506	0	195096
28251	1307	302	852	194057	0	196518
28252	831	309	674	191679	0	193493
28253	607	191431	722	4327	0	197087
28254	193177	2814	629	2188	0	198808
28255	2892	1110	651	201755	0	206408
28256	1254	204444	737	3554	0	209989
28257	810	2598	645	206944	0	210997
28258	208819	1023	732	4056	0	214630
28259	206407	656	651	2172	0	209886
28260	206746	600	749	1585	0	209680
28261	3612	208243	830	1671	0	214356
28262	1662	2679	210026	1561	0	215928
28263	204220	1104	2908	1696	0	209928
28264	215815	651	1317	1645	0	219428
28265	3630	216338	974	1622	0	222564
28266	215592	2721	634	1529	0	220476
28267	214844	1109	678	1522	0	218153
28268	216554	640	598	1525	0	219317
28269	3939	226543	764	1667	0	232913
28270	1957	2674	731	226300	0	231662
28271	231646	1112	662	4024	0	237444
28272	234491	740	597	2189	0	238017
28273	232497	555	582	1775	0	235409
28274	233071	539	546	1621	0	235777
28275	4435	572	560	228496	0	234063
28276	2135	716	230139	3859	0	236849
28277	1596	571	2962	224743	0	229872
28278	1239	232381	1293	4214	0	239127
28279	1432	2959	795	239533	0	244719
28280	1481	1280	238997	4211	0	245969
28281	231826	712	3332	2343	0	238213
28282	4109	590	1373	244952	0	251024
28283	243011	567	928	4270	0	248776
28284	246357	690	817	2545	0	250409
28285	4835	667	789	251816	0	258107
28286	2593	635	256394	4128	0	263750
28287	2205	691	237934	1979	0	242809
28288	219005	812	3975	1713	0	225505
28289	3893	248475	1582	1658	0	255608
28290	1929	247217	828	1377	0	251351
28291	1602	251745	697	1405	0	255449
28292	1451	259633	660	1369	0	263113
28293	251103	4071	1365	1324	0	257863
28294	253401	1293	705	1202	0	256601
28295	252575	783	515	1086	0	254959
28296	253584	768	483	1198	0	256033
28297	4109	809	541	245410	0	250869
28298	1937	247946	589	3317	0	253789
28299	247036	2701	772	1578	0	252087
28300	3691	1238	249184	1119	0	255232
28301	1874	250739	2667	1829	0	257109
28302	1747	2648	249619	1122	0	255136
28303	240138	1022	2869	1251	0	245280
28304	252835	701	1212	1231	0	255979
28305	253283	772	758	1264	0	256077
28306	4221	686	636	250586	0	256129
28307	2461	623	255632	3074	0	261790
28308	1551	254320	2673	2175	0	260719
28309	245333	2667	1150	1237	0	250387
28310	3264	250726	823	1474	0	256287
28311	1801	245677	465	1744	0	249687
28312	1578	246512	480	1116	0	249686
28313	1425	245583	573	1221	0	248802
28314	1703	2784	226456	855	0	231798
28315	1324	238584	2311	1092	0	243311
28316	221459	1824	778	824	0	224885
28317	2034	791	389	223612	0	226826
28318	1108	623	343	227496	0	229570
28319	225987	547	424	1934	0	228892
28320	2018	224034	451	1202	0	227705
28321	1544	1735	225817	724	0	229820
28322	1150	756	1466	222636	0	226008
28323	1092	568	634	231876	0	234170
28324	1139	557	475	233863	0	236034
28325	1151	606	231383	1977	0	235117
28326	1151	712	230056	891	0	232810
28327	1180	597	1777	227868	0	231422
28328	1138	660	231771	1617	0	235186
28329	1087	673	217730	683	0	220173
28330	172791	693	1939	801	0	176224
28331	1867	219202	766	1362	0	223197
28332	998	215680	458	648	0	217784
28333	1154	222464	442	786	0	224846
28334	1129	2037	424	212883	0	216473
28335	889	225678	439	1463	0	228469
28336	225965	1612	632	747	0	228956
28337	2050	815	229986	582	0	233433
28338	226514	578	1833	688	0	229613
28339	2212	639	737	236042	0	239630
28340	1081	681	524	238535	0	240821
28341	809	249544	569	2475	0	253397
28342	248605	2320	563	1066	0	252554
28343	247130	1036	703	719	0	249588
28344	3297	267292	554	959	0	272102
28345	1467	3113	373	260642	0	265595
28346	1055	1265	267003	2912	0	272235
28347	1063	772	268490	1287	0	271612
28348	675	272455	3954	1299	0	278383
28349	271897	3481	1740	981	0	278099
28350	3916	1338	277176	417	0	282847
28351	1663	707	3534	265994	0	271898
28352	277758	503	1537	3364	0	283162
28353	280459	477	669	1442	0	283047
28354	4708	344604	665	820	0	350797
28355	1802	360320	607	941	0	363670
28356	360176	7515	574	518	0	368783
28357	6890	2467	361532	443	0	371332
28358	355189	1124	6551	489	0	363353
28359	363657	808	2069	549	0	367083
28360	8395	759	940	358253	0	368347
28361	2970	748	370382	6603	0	380703
28362	1570	753	367363	1982	0	371668
28363	345264	560	8814	1023	0	355661
28364	7780	830	369252	636	0	378498
28365	340973	798	7676	711	0	350158
28366	359129	663	2510	614	0	362916
28367	8522	359153	1464	1191	0	370330
28368	3741	6895	362145	529	0	373310
28369	1776	353969	7418	897	0	364060
28370	346585	7248	2716	811	0	357360
28371	7730	2835	347239	632	0	358436
28372	3236	1604	7480	324718	0	337038
28373	2378	1021	348071	6665	0	358135
28374	2071	1016	351062	2215	0	356364
28375	2421	877	351785	944	0	356027
28376	2353	897	349191	824	0	353265
28377	1752	333290	10114	1620	0	346776
28378	2292	7499	336606	829	0	347226
28379	1990	330645	8521	1382	0	342538
28380	2795	7541	329574	799	0	340709
28381	318497	2728	9326	705	0	331256
28382	9536	1680	3771	270988	0	285975
28383	3931	329776	2769	5302	0	341778
28384	323343	7453	2721	2268	0	335785
28385	323824	3108	3294	1193	0	331419
28386	315085	2139	2899	1054	0	321177
28387	315653	1603	3191	810	0	321257
28388	10138	316621	3516	1112	0	331387
28389	311052	7535	2617	1167	0	322371
28390	311894	3361	3183	1150	0	319588
28391	9932	303447	3300	1712	0	318391
28392	4567	7982	299254	966	0	312769
28393	3325	4085	9253	275716	0	292379
28394	3231	298543	5291	6566	0	313631
28395	3198	8034	303989	2536	0	317757
28396	3687	3749	308020	1630	0	317086
28397	3185	298553	11924	1494	0	315156
28398	3332	305730	5799	1528	0	316389
28399	3153	317444	4581	1478	0	326656
28400	3426	318270	3818	1292	0	326806
28401	304065	11458	3962	954	0	320439
28402	309582	5468	3864	1177	0	320091
28403	12557	3829	313967	1386	0	331739
28404	6594	3337	320378	1231	0	331540
28405	5196	3145	12058	299993	0	320392
28406	4687	3008	6461	311463	0	325619
28407	4903	3561	4284	316546	0	329294
28408	308566	3362	4377	9841	0	326146
28409	11190	313216	4539	4153	0	333098
28410	6649	327996	4397	2420	0	341462
28411	5447	334954	4888	1863	0	347152
28412	321920	12853	4466	1572	0	340811
28413	329135	6191	4852	1557	0	341735
28414	14404	4986	4296	320385	0	344071
28415	331495	4334	5240	8528	0	349597
28416	334603	4428	4896	3754	0	347681
28417	14966	4564	4675	326343	0	350548
28418	326271	4993	5051	9481	0	345796
28419	13465	325039	5744	4499	0	348747
28420	8143	11462	6598	324591	0	350794
28421	6920	6824	322598	9351	0	345693
28422	6474	320796	13647	4700	0	345617
28423	7204	12514	323731	3179	0	346628
28424	6892	7029	14026	281272	0	309219
28425	6971	324234	9239	8712	0	349156
28426	7769	11481	7726	313949	0	340925
28427	6508	6670	8038	326433	0	347649
28428	7170	5083	324376	12008	0	348637
28429	6923	4639	341689	5270	0	358521
28430	6398	4911	15925	327808	0	355042
28431	6477	5216	9682	292068	0	313443
28432	6618	335255	7848	10974	0	360695
28433	311213	13311	6343	4652	0	335519
28434	13631	327750	7041	3738	0	352160
28435	7869	333270	6364	3466	0	350969
28436	6605	15102	314115	3563	0	339385
28437	5002	316333	13337	4198	0	338870
28438	5463	12628	9476	272087	0	299654
28439	5366	308909	7268	9630	0	331173
28440	5223	12402	6588	278521	0	302734
28441	4064	298323	6928	9980	0	319295
28442	287321	12570	5979	4644	0	310514
28443	10974	295309	6310	3883	0	316476
28444	5480	11721	5302	243211	0	265714
28445	4656	274290	5111	7990	0	292047
28446	268210	11691	4811	3578	0	288290
28447	265553	7037	3532	3052	0	279174
28448	12325	264599	3479	2869	0	283272
28449	252637	10691	2378	2366	0	268072
28450	11168	9341	2413	238802	0	261724
28451	6169	4691	245129	8105	0	264094
28452	5469	4430	249360	3583	0	262842
28453	4921	243762	9899	3703	0	262285
28454	164740	4515	4078	1399	0	174732
28455	162417	1721	1037	1079	0	166254
28456	4266	1321	158916	994	0	165497
28457	1665	1140	156220	971	0	159996
28458	144309	1197	3759	892	0	150157
28459	152665	1028	1345	979	0	156017
28460	3729	1147	149108	936	0	154920
28461	134349	1144	3135	823	0	139451
28462	3139	141056	1290	942	0	146427
28463	1141	145204	763	1008	0	148116
28464	1059	3887	852	138556	0	144354
28465	820	1703	741	142805	0	146069
28466	140419	1190	743	3609	0	145961
28467	140538	1134	811	1361	0	143844
28468	140149	1082	792	1150	0	143173
28469	3662	1122	723	137959	0	143466
28470	1580	1153	655	136426	0	139814
28471	1122	133458	707	3462	0	138749
28472	1022	137968	826	1548	0	141364
28473	916	141080	741	1156	0	143893
28474	1148	4077	648	124045	0	129918
28475	1048	134255	689	2850	0	138842
28476	1173	3555	128587	1198	0	134513
28477	118898	1687	2772	1061	0	124418
28478	3298	1555	132251	907	0	138011
28479	1577	1380	131905	885	0	135747
28480	121383	1338	3251	943	0	126915
28481	3309	130995	1186	1012	0	136502
28482	131798	3296	811	958	0	136863
28483	132808	1661	765	1122	0	136356
28484	3929	1374	132000	896	0	138199
28485	1932	1283	133974	853	0	138042
28486	1438	132937	3422	1155	0	138952
28487	1461	3425	133924	962	0	139772
28488	1408	1810	3264	130813	0	137295
28489	1318	1445	1531	118963	0	123257
28490	1158	133968	1279	3189	0	139594
28491	1200	138945	1131	1380	0	142656
28492	135263	4104	959	1176	0	141502
28493	140389	1998	971	1214	0	144572
28494	3928	1618	1020	138234	0	144800
28495	1842	1426	1065	141943	0	146276
28496	137066	1198	1070	3582	0	142916
28497	137666	1302	1116	1433	0	141517
28498	3832	139510	1139	1324	0	145805
28499	128601	3094	933	733	0	133361
28500	3252	125226	770	750	0	129998
28501	1510	130118	718	677	0	133023
28502	127384	3290	650	761	0	132085
28503	126917	1570	822	767	0	130076
28504	3560	1227	721	123719	0	129227
28505	123763	1093	638	2476	0	127970
28506	3314	1025	121990	936	0	127265
28507	1694	123058	2329	977	0	128058
28508	119810	2524	958	1012	0	124304
28509	2951	1106	120142	836	0	125035
28510	1285	2075	2152	101104	0	106616
28511	1081	108362	870	1626	0	111939
28512	1097	111076	706	698	0	113577
28513	109668	2156	1020	607	0	113451
28514	2484	912	107337	511	0	111244
28515	98400	614	1991	321	0	101326
28516	2481	567	708	101281	0	105037
28517	1153	487	101212	1509	0	104361
28518	95010	492	1787	777	0	98066
28519	2071	103611	731	476	0	106889
28520	860	107629	673	426	0	109588
28521	107520	1865	624	452	0	110461
28522	107495	750	411	518	0	109174
28523	108974	594	313	632	0	110513
28524	2267	662	322	104570	0	107821
28525	1178	572	374	106858	0	108982
28526	974	445	105457	1614	0	108490
28527	792	463	103341	726	0	105322
28528	674	102907	1498	732	0	105811
28529	536	1734	541	91205	0	94016
28530	90107	335	279	749	0	91470
28531	779	89712	202	704	0	91397
28532	379	864	160	90324	0	91727
28533	89410	382	189	775	0	90756
28534	821	90164	185	388	0	91558
28535	481	93504	165	272	0	94422
28536	536	857	86155	204	0	87752
28537	84444	339	784	284	0	85851
28538	91175	265	320	260	0	92020
28539	844	296	89531	231	0	90902
28540	79601	200	663	237	0	80701
28541	714	244	88936	140	0	90034
28542	298	87213	559	178	0	88248
28543	525	755	294	85634	0	87208
28544	84287	266	271	520	0	85344
28545	570	85028	180	246	0	86024
28546	242	84989	163	248	0	85642
28547	80328	423	116	159	0	81026
28548	484	242	83421	143	0	84290
28549	78249	160	358	219	0	78986
28550	394	86321	172	188	0	87075
28551	294	390	80123	90	0	80897
28552	79103	128	326	107	0	79664
28553	83965	108	125	95	0	84293
28554	417	92	80	81445	0	82034
28555	179	100	96	84195	0	84570
28556	132	84083	90	406	0	84711
28557	183	374	82431	179	0	83167
28558	147	122	312	82395	0	82976
28559	226	123	89448	470	0	90267
28560	172	177	90121	193	0	90663
28561	155	108	513	92875	0	93651
28562	175	99	98020	715	0	99009
28563	220	119	96303	202	0	96844
28564	141	118	794	88076	0	89129
28565	161	111	96148	658	0	97078
28566	81745	99	779	259	0	82882
28567	672	92672	238	338	0	93920
28568	319	664	95303	139	0	96425
28569	314	226	101570	120	0	102230
28570	127	174	816	94857	0	95974
28571	104403	91	282	721	0	105497
28572	104261	83	153	228	0	104725
28573	103969	85	139	140	0	104333
28574	104402	92	138	146	0	104778
28575	847	81	127	100457	0	101512
28576	358	113	104301	699	0	105471
28577	101760	83	752	291	0	102886
28578	106453	94	223	197	0	106967
28579	106881	88	176	150	0	107295
28580	914	100	103538	140	0	104692
28581	93609	112	798	151	0	94670
28582	773	146	300	106444	0	107663
28583	252	109293	248	784	0	110577
28584	257	776	208	104449	0	105690
28585	165	107373	219	831	0	108588
28586	106359	730	234	282	0	107605
28587	924	218	108545	271	0	109958
28588	269	164	923	102179	0	103535
28589	155	107884	382	817	0	109238
28590	132	110553	281	311	0	111277
28591	109390	879	294	164	0	110727
28592	108836	227	278	175	0	109516
28593	1105	190	103112	144	0	104551
28594	102012	120	955	137	0	103224
28595	1002	110	338	104115	0	105565
28596	474	134	109496	896	0	111000
28597	478	118	108452	282	0	109330
28598	370	100	1045	109700	0	111215
28599	118133	78	305	1198	0	119714
28600	1300	87	202	117345	0	118934
28601	546	102	180	117943	0	118771
28602	390	82	243	116166	0	116881
28603	332	119088	228	1362	0	121010
28604	386	1037	226	120275	0	121924
28605	115007	310	212	1235	0	116764
28606	1228	118739	236	517	0	120720
28607	516	1149	187	119606	0	121458
28608	117528	375	212	1313	0	119428
28609	1212	118206	244	545	0	120207
28610	400	120027	266	376	0	121069
28611	318	1545	216	118285	0	120364
28612	115625	452	231	1372	0	117680
28613	1400	322	116735	474	0	118931
28614	597	242	115890	308	0	117037
28615	114880	213	1666	304	0	117063
28616	121632	216	579	275	0	122702
28617	1781	126427	393	369	0	128970
28618	719	1432	338	121423	0	123912
28619	559	454	124226	1477	0	126716
28620	509	243	122312	577	0	123641
28621	501	211	132093	474	0	133279
28622	346	131098	2236	520	0	134200
28623	303	132046	796	569	0	133714
28624	130959	1864	452	494	0	133769
28625	1985	556	132470	390	0	135401
28626	126240	287	1817	490	0	128834
28627	131414	208	607	504	0	132733
28628	2325	305	135408	509	0	138547
28629	755	138882	1808	551	0	141996
28630	608	1981	661	136424	0	139674
28631	593	674	141554	1865	0	144686
28632	564	459	137655	641	0	139319
28633	125696	383	2249	484	0	128812
28634	1983	139739	700	527	0	142949
28635	825	1988	418	133618	0	136849
28636	551	730	411	130167	0	131859
28637	461	136601	402	2189	0	139653
28638	579	140065	446	825	0	141915
28639	575	141448	516	553	0	143092
28640	586	2453	416	143205	0	146660
28641	146193	768	405	2188	0	149554
28642	2399	481	435	148607	0	151922
28643	974	457	149785	2484	0	153700
28644	631	442	150120	858	0	152051
28645	503	476	2880	149024	0	152883
28646	665	434	151758	2437	0	155294
28647	489	151886	2656	1058	0	156089
28648	605	2471	908	156502	0	160486
28649	166761	804	636	2683	0	170884
28650	165288	525	491	945	0	167249
28651	3418	169761	526	708	0	174413
28652	172831	3010	501	726	0	177068
28653	174938	877	483	654	0	176952
28654	175033	524	537	720	0	176814
28655	3867	662	164891	575	0	169995
28656	160927	489	2955	720	0	165091
28657	3161	167459	1015	897	0	172532
28658	1081	2932	168845	540	0	173398
28659	870	876	168696	567	0	171009
28660	583	167169	3477	785	0	172014
28661	161588	3151	1463	485	0	166687
28662	2992	967	714	153388	0	158061
28663	911	158198	487	2780	0	162376
28664	160284	2782	461	893	0	164420
28665	2933	1031	484	160531	0	164979
28666	161518	512	578	3177	0	165785
28667	3092	486	477	163992	0	168047
28668	1132	572	162655	3102	0	167461
28669	732	607	159939	1076	0	162354
28670	791	627	161568	632	0	163618
28671	703	619	3530	150298	0	155150
28672	689	616	1124	162026	0	164455
28673	824	632	160745	3477	0	165678
28674	766	159762	3160	1290	0	164978
28675	162859	3099	1088	704	0	167750
28676	160681	1037	821	541	0	163080
28677	3769	164264	872	733	0	169638
28678	1468	3414	769	164007	0	169658
28679	1155	1114	170366	3258	0	175893
28680	162364	645	3900	1126	0	168035
28681	3775	649	172006	777	0	177207
28682	1470	680	168284	502	0	170936
28683	1127	673	168056	514	0	170370
28684	156823	711	4450	629	0	162613
28685	3838	721	165656	519	0	170734
28686	1409	160812	3737	681	0	166639
28687	1164	166875	1493	644	0	170176
28688	1062	3808	1097	157934	0	163901
28689	957	1324	931	162376	0	165588
28690	1302	816	161344	3635	0	167097
28691	150038	689	3647	1278	0	155652
28692	162987	692	1403	769	0	165851
28693	4114	1073	1076	161407	0	167670
28694	161094	546	1031	3230	0	165901
28695	3592	161447	1026	1372	0	167437
28696	157341	3404	911	851	0	162507
28697	3572	156279	947	1314	0	162112
28698	1243	157342	919	920	0	160424
28699	151454	3506	931	720	0	156611
28700	153099	1108	872	749	0	155828
28701	155330	690	911	638	0	157569
28702	156318	606	945	669	0	158538
28703	4067	778	148781	666	0	154292
28704	142153	625	3476	674	0	146928
28705	3637	686	1394	140683	0	146400
28706	1418	147563	1045	2894	0	152920
28707	145696	3064	967	1030	0	150757
28708	3332	147192	951	867	0	152342
28709	147154	3135	878	742	0	151909
28710	3615	1044	888	145927	0	151474
28711	1538	708	912	149859	0	153017
28712	1237	756	148370	3490	0	153853
28713	1411	788	148084	1150	0	151433
28714	1156	147936	3572	1190	0	153854
28715	139450	2947	1344	877	0	144618
28716	3301	141762	941	852	0	146856
28717	1484	140138	823	905	0	143350
28718	1365	144637	784	792	0	147578
28719	1903	3358	136846	539	0	142646
28720	1308	140555	2905	622	0	145390
28721	129263	3042	1296	594	0	134195
28722	130219	1025	820	490	0	132554
28723	3410	852	740	124010	0	129012
28724	1462	127256	725	2511	0	131954
28725	1201	129914	805	960	0	132880
28726	1239	3061	680	126810	0	131790
28727	1389	1152	127857	2566	0	132964
28728	1196	124346	2666	1011	0	129219
28729	1301	2795	1001	120690	0	125787
28730	118012	1079	802	2531	0	122424
28731	118480	895	744	938	0	121057
28732	3023	121674	707	894	0	126298
28733	121404	2758	730	750	0	125642
28734	122453	1078	826	663	0	125020
28735	3324	960	871	118304	0	123459
28736	1549	900	118568	2464	0	123481
28737	1179	119905	2650	1204	0	124938
28738	1129	3120	1138	117822	0	123209
28739	1117	1276	118063	2265	0	122721
28740	1048	114635	2396	864	0	118943
28741	108275	2551	1183	633	0	112642
28742	109316	1115	682	567	0	111680
28743	2703	1121	588	105064	0	109476
28744	1309	109108	616	1938	0	112971
28745	1168	2303	107610	832	0	111913
28746	1159	1493	2039	104200	0	108891
28747	1034	988	107939	2019	0	111980
28748	853	100411	1867	913	0	104044
28749	1760	2184	1128	87473	0	92545
28750	86462	747	497	1314	0	89020
28751	1461	86460	458	678	0	89057
28752	84609	1476	341	509	0	86935
28753	82779	779	335	448	0	84341
28754	1721	85954	319	507	0	88501
28755	985	1467	370	84957	0	87779
28756	846	956	295	84109	0	86206
28757	749	83103	372	1438	0	85662
28758	652	85533	408	728	0	87321
28759	744	1606	366	78017	0	80733
28760	706	82795	340	1100	0	84941
28761	81793	1426	353	497	0	84069
28762	80909	787	331	432	0	82459
28763	1595	706	80735	401	0	83437
28764	905	648	79725	391	0	81669
28765	75136	557	1203	473	0	77369
28766	80404	608	530	419	0	81961
28767	1338	82842	452	467	0	85099
28768	81950	1337	408	449	0	84144
28769	81418	703	340	378	0	82839
28770	1506	80125	255	425	0	82311
28771	80545	1276	264	477	0	82562
28772	1417	869	280	92230	0	94796
28773	746	806	312	96538	0	98402
28774	742	600	103270	1744	0	106356
28775	462	100650	1572	788	0	103472
28776	404	104395	438	488	0	105725
28777	98352	2707	803	845	0	102707
28778	98863	589	300	440	0	100192
28779	98023	302	165	301	0	98791
28780	99737	273	233	298	0	100541
28781	1701	296	98556	218	0	100771
28782	477	354	98856	231	0	99918
28783	308	99706	1537	318	0	101869
28784	321	1510	411	98607	0	100849
28785	366	576	236	92879	0	94057
28786	381	100751	165	1306	0	102603
28787	453	1557	164	97864	0	100038
28788	96227	445	213	1403	0	98288
28789	1548	98787	294	450	0	101079
28790	652	1530	101315	256	0	103753
28791	378	103449	1449	359	0	105635
28792	102260	1469	446	315	0	104490
28793	1552	559	102183	293	0	104587
28794	98028	382	1486	347	0	100243
28795	103336	325	424	302	0	104387
28796	1760	419	102404	280	0	104863
28797	606	345	102513	244	0	103708
28798	479	381	101492	206	0	102558
28799	89530	355	1751	234	0	91870
28800	1674	277	101214	298	0	103463
28801	616	99439	1470	377	0	101902
28802	99062	1370	537	186	0	101155
28803	1566	443	99720	141	0	101870
28804	93461	280	1554	203	0	95498
28805	1627	273	100035	198	0	102133
28806	729	310	103710	171	0	104920
28807	505	103535	1741	374	0	106155
28808	509	1470	104546	215	0	106740
28809	751	488	102907	226	0	104372
28810	474	92638	1854	542	0	95508
28811	97770	1493	688	248	0	100199
28812	1729	527	101222	212	0	103690
28813	689	452	1712	86089	0	88942
28814	553	101927	694	1170	0	104344
28815	98783	1546	603	449	0	101381
28816	99379	605	582	378	0	100944
28817	1938	462	100717	283	0	103400
28818	760	97548	1782	339	0	100429
28819	597	101164	879	347	0	102987
28820	678	1908	700	94079	0	97365
28821	671	98828	647	1258	0	101404
28822	804	1845	605	90698	0	93952
28823	885	1089	550	98583	0	101107
28824	843	101257	734	1729	0	104563
28825	859	1731	723	97836	0	101149
28826	811	100494	771	1551	0	103627
28827	837	1908	95716	670	0	99131
28828	707	1056	1948	95132	0	98843
28829	761	948	930	95838	0	98477
28830	810	98538	793	1861	0	102002
28831	942	101616	714	785	0	104057
28832	886	2196	729	92915	0	96726
28833	745	98728	945	1622	0	102040
28834	94455	2144	858	706	0	98163
28835	2016	1034	877	94948	0	98875
28836	925	98782	1004	1684	0	102395
28837	95767	2023	850	744	0	99384
28838	2021	96321	942	634	0	99918
28839	1158	2046	93124	616	0	96944
28840	991	1049	2197	91769	0	96006
28841	93258	1021	1219	1657	0	97155
28842	2229	754	96071	723	0	99777
28843	1012	1022	2336	87892	0	92262
28844	1095	94633	1225	1523	0	98476
28845	1124	2031	92079	645	0	95879
28846	1001	95498	2303	472	0	99274
28847	91336	1939	1284	452	0	95011
28848	92831	980	1425	399	0	95635
28849	2198	93088	1378	472	0	97136
28850	92391	1982	1329	450	0	96152
28851	2111	1027	91539	419	0	95096
28852	945	856	2553	86785	0	91139
28853	818	1096	1341	86311	0	89566
28854	1049	91641	1190	1541	0	95421
28855	96710	1984	1321	822	0	100837
28856	101324	1112	1046	643	0	104125
28857	2156	1055	101215	377	0	104803
28858	98899	876	2270	464	0	102509
28859	102915	976	1180	451	0	105522
28860	103419	866	1182	539	0	106006
28861	2272	1002	920	98772	0	102966
28862	1047	1056	961	99852	0	102916
28863	979	101886	847	1826	0	105538
28864	99043	2202	992	692	0	102929
28865	98171	985	783	794	0	100733
28866	1997	99258	724	718	0	102697
28867	926	2272	700	93897	0	97795
28868	829	97719	515	1732	0	100795
28869	647	101229	671	775	0	103322
28870	95228	2234	870	762	0	99094
28871	1786	1317	95849	841	0	99793
28872	497	602	81707	372	0	83178
28873	363	80369	1068	414	0	82214
28874	68576	703	718	229	0	70226
28875	634	375	70366	178	0	71553
28876	240	63788	617	352	0	64997
28877	63954	372	191	129	0	64646
28878	397	169	62419	101	0	63086
28879	122	124	364	57940	0	58550
28880	65516	118	120	404	0	66158
28881	499	132	65298	141	0	66070
28882	206	133	69349	103	0	69791
28883	165	134	71636	108	0	72043
28884	126	125	71520	82	0	71853
28885	61588	157	638	142	0	62525
28886	73902	96	114	74	0	74186
28887	495	74648	86	147	0	75376
28888	123	524	49	76916	0	77612
28889	86	175	42	79355	0	79658
28890	69	78398	54	735	0	79256
28891	94	760	47	77019	0	77920
28892	65	81277	59	695	0	82096
28893	74	82459	51	253	0	82837
28894	79	1006	69	80182	0	81336
28895	109	306	80864	825	0	82104
28896	67	81634	824	351	0	82876
28897	84	854	244	80945	0	82127
28898	82000	261	121	817	0	83199
28899	926	127	82219	251	0	83523
28900	79186	92	920	108	0	80306
28901	83754	82	282	89	0	84207
28902	1172	98	121	84802	0	86193
28903	377	79	91297	1023	0	92776
28904	246	118	91974	281	0	92619
28905	126	96289	1486	214	0	98115
28906	227	1354	460	93225	0	95266
28907	147	361	95941	1284	0	97733
28908	176	184	98088	379	0	98827
28909	111	97923	1732	385	0	100151
28910	98547	1400	534	128	0	100609
28911	99513	419	242	136	0	100310
28912	1705	220	184	103607	0	105716
28913	643	161	109333	1683	0	111820
28914	330	144	111036	662	0	112172
28915	213	112297	2406	656	0	115572
28916	282	1676	115056	203	0	117217
28917	316	654	115360	189	0	116519
28918	173	396	2606	100767	0	103942
28919	184	221	115400	1863	0	117668
28920	104205	174	2225	709	0	107313
28921	1801	185	900	114826	0	117712
28922	803	233	119455	1925	0	122416
28923	290	119443	2031	870	0	122634
28924	254	1852	842	119715	0	122663
28925	354	808	121638	1883	0	124683
28926	180	123980	2139	907	0	127206
28927	219	2053	897	118823	0	121992
28928	205	127376	516	1877	0	129974
28929	212	2170	466	126743	0	129591
28930	204	829	407	128501	0	129941
28931	280	437	126443	2681	0	129841
28932	209	127604	2291	1131	0	131235
28933	214	2139	1000	127272	0	130625
28934	210	825	636	127788	0	129459
28935	227	471	539	130887	0	132124
28936	288	363	127344	2867	0	130862
28937	237	125944	2375	1375	0	129931
28938	248	2145	1128	126792	0	130313
28939	414	942	126619	2280	0	130255
28940	237	126087	2422	1376	0	130122
28941	252	2249	1164	125862	0	129527
28942	391	994	129381	2318	0	133084
28943	213	128965	2479	1345	0	133002
28944	272	2313	1195	125241	0	129021
28945	281	1053	680	131463	0	133477
28946	340	595	134628	2938	0	138501
28947	118346	555	2634	1448	0	122983
28948	1932	134903	1253	955	0	139043
28949	135522	2275	862	774	0	139433
28950	2280	1105	136179	741	0	140305
28951	133618	641	2656	846	0	137761
28952	2313	611	1326	132413	0	136663
28953	912	586	894	141244	0	143636
28954	537	570	139544	2997	0	143648
28955	123865	558	2753	1428	0	128604
28956	130998	566	1363	1004	0	133931
28957	2604	131342	923	1041	0	135910
28958	970	136711	936	879	0	139496
28959	135308	2936	858	825	0	139927
28960	2319	1330	136273	880	0	140802
28961	988	143381	2826	921	0	148116
28962	612	2489	1433	144288	0	148822
28963	520	1143	971	148348	0	150982
28964	566	729	147485	3079	0	151859
28965	137012	657	2829	1585	0	142083
28966	2494	593	150855	1022	0	154964
28967	144852	598	3085	916	0	149451
28968	2681	651	156265	872	0	160469
28969	1072	156346	3161	998	0	161577
28970	158650	2594	1687	896	0	163827
28971	159692	1247	1178	912	0	163029
28972	158542	753	1019	933	0	161247
28973	159540	688	1036	870	0	162134
28974	3355	697	956	156730	0	161738
28975	1435	750	158398	2845	0	163428
28976	803	834	2982	151476	0	156095
28977	643	158849	1586	2846	0	163924
28978	632	2511	1154	159662	0	163959
28979	651	1325	159450	2870	0	164296
28980	677	808	159708	1523	0	162716
28981	645	920	3388	155137	0	160090
28982	155006	630	1857	2829	0	160322
28983	153278	613	1160	1450	0	156501
28984	153601	656	1049	1028	0	156334
28985	3186	715	155229	984	0	160114
28986	1521	596	155239	965	0	158321
28987	820	154231	3179	1051	0	159281
28988	670	154729	1537	1009	0	157945
28989	149691	2576	1428	814	0	154509
28990	149212	1231	788	851	0	152082
28991	2450	156490	758	956	0	160654
28992	154400	1944	674	739	0	157757
28993	153224	993	598	728	0	155543
28994	2348	155006	648	873	0	158875
28995	157179	1962	566	813	0	160520
28996	155577	1039	658	741	0	158015
28997	2422	158636	634	810	0	162502
28998	159283	1888	725	679	0	162575
28999	157377	943	706	712	0	159738
29000	2652	780	159092	689	0	163213
29001	1418	530	157215	558	0	159721
29002	732	155407	2246	617	0	159002
29003	616	156692	1071	565	0	158944
29004	153389	2085	1538	591	0	157603
29005	149074	848	537	444	0	150903
29006	146413	404	458	356	0	147631
29007	1878	147998	458	461	0	150795
29008	933	1216	376	147053	0	149578
29009	753	705	148657	1164	0	151279
29010	622	1126	1304	140974	0	144026
29011	575	149005	703	1228	0	151511
29012	142963	817	342	355	0	144477
29013	966	140660	224	310	0	142160
29014	503	839	179	138050	0	139571
29015	145958	309	232	996	0	147495
29016	144378	212	243	359	0	145192
29017	1380	254	145977	174	0	147785
29018	145075	221	1002	225	0	146523
29019	154997	198	389	192	0	155776
29020	156262	196	274	285	0	157017
29021	1645	308	290	149263	0	151506
29022	699	152070	254	1224	0	154247
29023	495	1236	218	154686	0	156635
29024	534	569	156732	1268	0	159103
29025	467	159593	1432	696	0	162188
29026	435	1376	469	155422	0	157702
29027	458	535	156862	1312	0	159167
29028	394	155659	1398	601	0	158052
29029	486	1522	467	149989	0	152464
29030	521	564	156222	1257	0	158564
29031	127612	360	1620	783	0	130375
29032	1682	297	157716	316	0	160011
29033	805	352	156966	244	0	158367
29034	508	158846	1721	392	0	161467
29035	538	1546	588	158359	0	161031
29036	552	752	322	148959	0	150585
29037	473	158118	353	1535	0	160479
29038	539	1550	287	157444	0	159820
29039	160871	544	264	1648	0	163327
29040	161657	333	356	571	0	162917
29041	2118	370	160461	322	0	163271
29042	153681	293	1565	348	0	155887
29043	163858	330	549	335	0	165072
29044	2121	404	163437	318	0	166280
29045	819	163667	1627	397	0	166510
29046	574	164001	588	403	0	165566
29047	711	2175	386	138731	0	142003
29048	576	159814	327	1344	0	162061
29049	725	1807	152503	414	0	155449
29050	809	764	154106	267	0	155946
29051	580	157067	1935	372	0	159954
29052	157532	1741	647	296	0	160216
29053	159991	682	423	316	0	161412
29054	161032	519	297	336	0	162184
29055	160618	462	267	332	0	161679
29056	155251	433	290	289	0	156263
29057	2093	153892	391	393	0	156769
29058	980	1848	152257	234	0	155319
29059	754	649	1655	151082	0	154140
29060	147490	438	650	1632	0	150210
29061	1782	147020	383	825	0	150010
29062	859	1832	351	144234	0	147276
29063	717	645	144990	1563	0	147915
29064	528	141661	1718	685	0	144592
29065	422	145526	604	480	0	147032
29066	138293	2148	702	635	0	141778
29067	1498	139217	394	375	0	141484
29068	674	1508	261	132873	0	135316
29069	133578	519	230	1423	0	135750
29070	133227	363	199	465	0	134254
29071	134105	261	235	284	0	134885
29072	1980	315	130466	212	0	132973
29073	707	132359	1409	305	0	134780
29074	135328	1507	466	319	0	137620
29075	1602	587	265	133007	0	135461
29076	135288	368	281	1465	0	137402
29077	1672	133318	270	731	0	135991
29078	141309	1595	232	306	0	143442
29079	154527	621	215	348	0	155711
29080	2685	407	248	150826	0	154166
29081	1095	421	159099	2357	0	162972
29082	727	319	2439	160843	0	164328
29083	161077	288	786	2610	0	164761
29084	162132	367	412	798	0	163709
29085	3185	159601	383	551	0	163720
29086	153554	2468	315	367	0	156704
29087	2737	156857	327	462	0	160383
29088	156793	2604	298	436	0	160131
29089	155682	880	348	440	0	157350
29090	3140	623	154663	433	0	158859
29091	1006	154575	2515	537	0	158633
29092	717	2634	861	154276	0	158488
29093	561	879	444	157260	0	159144
29094	599	627	403	148206	0	149835
29095	529	152781	392	3110	0	156812
29096	617	2652	152095	877	0	156241
29097	787	927	155537	479	0	157730
29098	514	186087	3191	807	0	190599
29099	186476	3642	985	451	0	191554
29100	3910	1221	185824	442	0	191397
29101	177409	670	3784	471	0	182334
29102	3938	181698	1237	663	0	187536
29103	1594	3781	183938	425	0	189738
29104	964	1292	3669	181006	0	186931
29105	904	721	187782	3810	0	193217
29106	927	637	192461	1160	0	195185
29107	1181	581	4511	162625	0	168898
29108	848	184561	1466	3150	0	190025
29109	837	191243	765	1103	0	193948
29110	187964	4436	587	554	0	193541
29111	4239	1425	187446	448	0	193558
29112	185105	825	3881	658	0	190469
29113	189909	632	1373	543	0	192457
29114	4454	190605	771	586	0	196416
29115	183540	3691	481	418	0	188130
29116	185294	1197	452	386	0	187329
29117	177625	804	422	388	0	179239
29118	4638	174733	444	549	0	180364
29119	1474	164639	461	455	0	167029
29120	921	171346	428	412	0	173107
29121	169777	3970	1163	357	0	175267
29122	170519	1327	659	399	0	172904
29123	4240	731	167051	302	0	172324
29124	1492	602	162321	239	0	164654
29125	161154	465	3615	375	0	165609
29126	166339	393	1110	371	0	168213
29127	167725	399	676	508	0	169308
29128	3998	364	531	162379	0	167272
29129	1408	395	469	166668	0	168940
29130	896	486	448	168534	0	170364
29131	774	524	552	169503	0	171353
29132	848	499	164621	3767	0	169735
29133	901	470	163082	1217	0	165670
29134	968	422	162997	644	0	165031
29135	940	530	161204	417	0	163091
29136	155979	508	3773	397	0	160657
29137	3384	160634	1260	524	0	165802
29138	1475	166288	792	531	0	169086
29139	163446	3534	694	423	0	168097
29140	3646	1306	162767	465	0	168184
29141	1521	879	158929	515	0	161844
29142	153792	794	4007	695	0	159288
29143	160697	525	1521	615	0	163358
29144	3933	161530	917	738	0	167118
29145	1834	2928	768	160627	0	166157
29146	163302	1108	642	2939	0	167991
29147	167224	907	537	1063	0	169731
29148	4365	777	509	160512	0	166163
29149	1962	168945	545	2861	0	174313
29150	169590	3210	548	1015	0	174363
29151	3881	1244	167449	704	0	173278
29152	162869	837	3351	644	0	167701
29153	3641	167770	1280	719	0	173410
29154	169180	3305	935	734	0	174154
29155	169072	1196	919	723	0	171910
29156	4089	854	168573	706	0	174222
29157	1662	839	167312	629	0	170442
29158	163633	728	4220	593	0	169174
29159	170468	759	1734	578	0	173539
29160	3990	172352	1124	623	0	178089
29161	1876	3356	979	172718	0	178929
29162	1370	1201	172335	3041	0	177947
29163	167794	831	3593	1036	0	173254
29164	3820	779	1508	172412	0	178519
29165	1783	638	1146	176019	0	179586
29166	173774	644	990	3762	0	179170
29167	3590	178580	1015	1605	0	184790
29168	180213	3172	1025	937	0	185347
29169	181134	1163	846	760	0	183903
29170	182345	1007	811	615	0	184778
29171	4439	180009	767	624	0	185839
29172	181208	3422	702	510	0	185842
29173	4169	1344	871	179435	0	185819
29174	2147	969	833	180339	0	184288
29175	2240	697	179580	3619	0	186136
29176	2053	790	177918	1163	0	181924
29177	1567	177924	3693	850	0	184034
29178	1408	179440	1346	568	0	182762
29179	1832	2794	162333	282	0	167241
29180	1040	166201	2556	489	0	170286
29181	162001	2945	1294	929	0	167169
29182	163376	824	434	406	0	165040
29183	164250	571	361	446	0	165628
29184	3265	450	434	154508	0	158657
29185	1429	306	482	162490	0	164707
29186	1332	371	163473	2717	0	167893
29187	745	161936	2338	1214	0	166233
29188	160375	2300	798	596	0	164069
29189	2483	162606	623	496	0	166208
29190	162336	2453	488	367	0	165644
29191	162690	774	431	408	0	164303
29192	3234	535	444	156634	0	160847
29193	1448	418	485	160955	0	163306
29194	1135	456	393	164107	0	166091
29195	1280	372	157037	2904	0	161593
29196	771	154801	2263	1575	0	159410
29197	668	155537	888	984	0	158077
29198	258	121845	196	336	0	122635
29199	285	121491	260	336	0	122372
29200	280	121900	242	307	0	122729
29201	104592	1213	490	260	0	106555
29202	1102	446	114094	130	0	115772
29203	454	115747	852	372	0	117425
29204	452	953	108572	206	0	110183
29205	296	115507	831	346	0	116980
29206	442	1260	378	93869	0	95949
29207	323	422	193	107390	0	108328
29208	273	112399	199	989	0	113860
29209	108475	845	256	429	0	110005
29210	966	442	107135	241	0	108784
29211	416	110847	806	445	0	112514
29212	416	987	106991	221	0	108615
29213	342	403	858	105953	0	107556
29214	354	349	315	101908	0	102926
29215	340	107622	223	946	0	109131
29216	386	894	187	107932	0	109399
29217	372	400	163	108091	0	109026
29218	309	108028	244	1207	0	109788
29219	351	939	104588	474	0	106352
29220	351	504	105167	331	0	106353
29221	97417	379	1025	332	0	99153
29222	107066	364	372	237	0	108039
29223	1061	363	248	103697	0	105369
29224	538	373	104245	881	0	106037
29225	405	360	819	98716	0	100300
29226	359	106491	358	1063	0	108271
29227	422	964	105434	540	0	107360
29228	253	104584	873	520	0	106230
29229	412	1040	103361	324	0	105137
29230	240	104632	891	373	0	106136
29231	103509	1046	368	276	0	105199
29232	855	573	256	101675	0	103359
29233	399	466	226	101603	0	102694
29234	433	469	102524	950	0	104376
29235	491	421	100018	453	0	101383
29236	325	102034	984	478	0	103821
29237	101642	1002	450	417	0	103511
29238	879	543	346	98879	0	100647
29239	439	476	102924	860	0	104699
29240	340	503	99002	449	0	100294
29241	86650	436	1087	447	0	88620
29242	95266	476	416	340	0	96498
29243	1093	460	98442	288	0	100283
29244	509	658	865	91469	0	93501
29245	350	98093	438	876	0	99757
29246	97320	933	341	468	0	99062
29247	835	96948	311	537	0	98631
29248	91961	748	247	327	0	93283
29249	680	92853	257	378	0	94168
29250	311	94372	224	423	0	95330
29251	352	876	252	93317	0	94797
29252	257	466	265	93709	0	94697
29253	212	94172	259	898	0	95541
29254	308	862	89685	344	0	91199
29255	362	485	90070	243	0	91160
29256	307	388	91072	257	0	92024
29257	83653	331	799	305	0	85088
29258	90504	305	299	336	0	91444
29259	675	95657	291	448	0	97071
29260	389	969	94170	327	0	95855
29261	190	533	870	93630	0	95223
29262	231	440	100796	944	0	102411
29263	242	463	103507	423	0	104635
29264	201	422	1344	111680	0	113647
29265	216	430	558	120918	0	122122
29266	257	403	132866	2239	0	135765
29267	124873	353	2157	1101	0	128484
29268	2147	141239	1015	811	0	145212
29269	982	149085	622	523	0	151212
29270	605	3588	370	141364	0	145927
29271	147478	1519	374	2322	0	151693
29272	2581	152075	400	1275	0	156331
29273	149608	3053	305	642	0	153608
29274	2936	153426	314	600	0	157276
29275	159621	3335	404	488	0	163848
29276	3692	1576	159129	413	0	164810
29277	1779	966	162586	365	0	165696
29278	1030	1006	4024	155504	0	161564
29279	789	666	157756	3036	0	162247
29280	526	150313	3579	1467	0	155885
29281	442	153223	1639	752	0	156056
29282	150702	3991	1019	464	0	156176
29283	3133	1815	634	141084	0	146666
29284	1279	152100	571	2913	0	156863
29285	154371	3319	479	1204	0	159373
29286	151662	1614	427	642	0	154345
29287	155706	952	362	447	0	157467
29288	4831	614	319	151738	0	157502
29289	2185	585	342	155095	0	158207
29290	1370	558	154094	4294	0	160316
29291	1018	527	153788	1859	0	157192
29292	149846	397	4429	1021	0	155693
29293	3631	459	1870	149497	0	155457
29294	1857	498	151688	3474	0	157517
29295	147387	457	3614	1678	0	153136
29296	3560	155805	1826	1138	0	162329
29297	157459	3366	1116	706	0	162647
29298	159573	1572	756	715	0	162616
29299	160323	852	695	741	0	162611
29300	5556	650	154464	589	0	161259
29301	152693	566	3555	525	0	157339
29302	4764	550	1619	143110	0	150043
29303	2397	146122	1074	3190	0	152783
29304	1703	156578	792	1572	0	160645
29305	155234	4251	760	927	0	161172
29306	156669	1885	692	659	0	159905
29307	157886	1043	652	698	0	160279
29308	5763	782	572	151680	0	158797
29309	2797	814	560	154246	0	158417
29310	2032	758	587	145033	0	148410
29311	1601	152175	519	4869	0	159164
29312	151366	3682	599	2128	0	157775
29313	153766	1796	550	1360	0	157472
29314	156514	1121	562	1136	0	159333
29315	5997	886	153661	1225	0	161769
29316	156437	961	3715	1030	0	162143
29317	5410	937	1719	143310	0	151376
29318	2911	153901	1121	3596	0	161529
29319	153869	3966	764	1635	0	160234
29320	154373	1857	807	1212	0	158249
29321	6155	1319	154109	870	0	162453
29322	3292	962	3933	148033	0	156220
29323	2240	154796	1944	4023	0	163003
29324	158054	4136	1159	2020	0	165369
29325	5178	2052	912	157357	0	165499
29326	3005	1473	911	158528	0	163917
29327	2247	1069	859	161552	0	165727
29328	1844	1105	890	166966	0	170805
29329	2010	1093	161748	6358	0	171209
29330	1777	161719	4325	3490	0	171311
29331	1898	4670	2010	161400	0	169978
29332	1960	2290	164221	5157	0	173628
29333	161078	1711	4463	2771	0	170023
29334	167859	1372	2221	1951	0	173403
29335	6480	1282	1538	165428	0	174728
29336	167161	1312	1256	5129	0	174858
29337	171361	1220	1217	2875	0	176673
29338	7174	1317	168191	1912	0	178594
29339	4043	167186	4626	1686	0	177541
29340	168779	4626	2228	1587	0	177220
29341	6059	2196	1643	168472	0	178370
29342	171615	1375	1494	5101	0	179585
29343	6315	1109	1507	168302	0	177233
29344	3536	1190	1334	173147	0	179207
29345	2951	1205	167449	6403	0	178008
29346	151204	1213	4738	3556	0	160711
29347	5719	168235	2218	2762	0	178934
29348	3656	4701	168051	2072	0	178480
29349	2843	168991	4620	2058	0	178512
29350	167055	5039	2258	1712	0	176064
29351	6374	2284	1438	164844	0	174940
29352	164153	1416	1222	5235	0	172026
29353	6248	164588	1234	3078	0	175148
29354	168621	4699	1174	2200	0	176694
29355	172129	2238	1190	1877	0	177434
29356	173104	1441	1155	1718	0	177418
29357	170865	1085	1134	1618	0	174702
29358	7786	166508	1253	1760	0	177307
29359	164269	4297	1065	1421	0	171052
29360	6851	2220	1005	160307	0	170383
29361	4296	1914	880	156573	0	163663
29362	3367	148261	758	5612	0	157998
29363	3000	149281	804	2700	0	155785
29364	2672	144131	719	1547	0	149069
29365	130862	4508	867	1349	0	137586
29366	3983	119565	572	1265	0	125385
29367	1783	109109	640	882	0	112414
29368	106269	2711	1725	866	0	111571
29369	101938	951	403	752	0	104044
29370	3063	102258	436	802	0	106559
29371	100137	2128	358	677	0	103300
29372	2852	855	95931	569	0	100207
29373	93441	680	1823	605	0	96549
29374	2777	677	94871	645	0	98970
29375	1161	85420	1482	539	0	88602
29376	933	86936	590	554	0	89013
29377	2700	2172	787	80254	0	85913
29378	83239	582	349	1588	0	85758
29379	84945	437	219	758	0	86359
29380	85881	403	229	699	0	87212
29381	85588	388	289	624	0	86889
29382	83827	445	482	628	0	85382
29383	1833	502	81075	595	0	84005
29384	925	504	78512	546	0	80487
29385	79790	463	1372	591	0	82216
29386	1619	82107	508	583	0	84817
29387	80350	1151	453	482	0	82436
29388	82352	442	315	495	0	83604
29389	84209	348	261	525	0	85343
29390	83924	361	297	493	0	85075
29391	83761	411	319	496	0	84987
29392	1797	450	82693	497	0	85437
29393	83887	432	1091	629	0	86039
29394	85751	401	443	630	0	87225
29395	1744	464	83462	617	0	86287
29396	78353	446	1015	703	0	80517
29397	81807	485	531	635	0	83458
29398	1891	458	85455	568	0	88372
29399	1130	496	84901	527	0	87054
29400	1073	86127	1317	528	0	89045
29401	1103	1250	570	85445	0	88368
29402	1138	581	86629	1132	0	89480
29403	85124	493	1134	652	0	87403
29404	1817	523	465	90998	0	93803
29405	1216	567	92796	1178	0	95757
29406	90168	479	1172	551	0	92370
29407	94001	527	415	446	0	95389
29408	94384	487	314	439	0	95624
29409	1996	96821	264	622	0	99703
29410	1329	1282	278	92412	0	95301
29411	1092	96647	337	1239	0	99315
29412	97037	1313	445	585	0	99380
29413	95823	622	465	554	0	97464
29414	1843	598	94491	415	0	97347
29415	807	90584	1062	325	0	92778
29416	706	91012	395	263	0	92376
29417	844	1253	343	88503	0	90943
29418	806	592	232	90047	0	91677
29419	88697	479	185	977	0	90338
29420	1551	89440	154	489	0	91634
29421	944	89189	168	336	0	90637
29422	1395	1111	86894	218	0	89618
29423	912	89965	845	261	0	91983
29424	88445	1000	410	259	0	90114
29425	1532	514	86507	207	0	88760
29426	70660	325	863	311	0	72159
29427	1094	314	81834	203	0	83445
29428	63246	202	636	256	0	64340
29429	711	81822	175	186	0	82894
29430	84556	667	160	135	0	85518
29431	1013	296	87558	86	0	88953
29432	86060	226	858	230	0	87374
29433	88311	153	242	142	0	88848
29434	1120	204	90736	66	0	92126
29435	89118	145	745	140	0	90148
29436	93840	137	214	92	0	94283
29437	91231	142	146	101	0	91620
29438	1079	90054	130	217	0	91480
29439	91587	807	142	155	0	92691
29440	1162	302	94407	84	0	95955
29441	387	98612	860	202	0	100061
29442	100042	890	318	156	0	101406
29443	98535	234	217	114	0	99100
29444	98981	152	122	105	0	99360
29445	1185	99183	132	233	0	100733
29446	442	1024	104	113991	0	115561
29447	390	297	113839	1472	0	115998
29448	270	178	1554	112946	0	114948
29449	344	181	116926	1612	0	119063
29450	107100	198	1737	462	0	109497
29451	1743	117802	511	268	0	120324
29452	662	1685	223	113902	0	116472
29453	355	118825	197	1580	0	120957
29454	298	1817	167	119108	0	121390
29455	346	548	150	117631	0	118675
29456	286	122026	210	2185	0	124707
29457	407	1982	152	122197	0	124738
29458	352	667	163	126461	0	127643
29459	339	128150	220	2491	0	131200
29460	342	131781	236	843	0	133202
29461	375	2651	204	130293	0	133523
29462	549	771	129708	2270	0	133298
29463	434	131959	2199	912	0	135504
29464	479	2391	620	130869	0	134359
29465	748	746	136503	2392	0	140389
29466	416	138060	2497	860	0	141833
29467	136944	2596	724	467	0	140731
29468	2787	888	136651	421	0	140747
29469	132357	505	2604	501	0	135967
29470	2771	408	766	135911	0	139856
29471	894	453	400	138378	0	140125
29472	643	464	316	138944	0	140367
29473	534	517	136990	3265	0	141306
29474	588	503	136705	1016	0	138812
29475	124313	513	3164	722	0	128712
29476	2752	510	924	136241	0	140427
29477	1064	478	138605	2897	0	143044
29478	132802	518	2781	1088	0	137189
29479	2858	485	908	137327	0	141578
29480	1135	555	535	139241	0	141466
29481	718	583	478	136397	0	138176
29482	632	139412	492	3455	0	143991
29483	686	2884	441	131450	0	135461
29484	569	136766	522	2862	0	140719
29485	566	142028	505	1250	0	144349
29486	139512	3280	550	886	0	144228
29487	137182	1167	629	824	0	139802
29488	140281	747	464	822	0	142314
29489	3362	137599	591	903	0	142455
29490	136981	2946	573	818	0	141318
29491	138785	1080	511	924	0	141300
29492	3497	713	667	134684	0	139561
29493	1260	710	657	137384	0	140011
29494	951	645	134188	3756	0	139540
29495	701	137322	2942	1692	0	142657
29496	135477	2887	1133	1173	0	140670
29497	134596	1208	778	1016	0	137598
29498	3232	133824	776	1186	0	139018
29499	133207	2982	696	1135	0	138020
29500	132975	1154	592	1248	0	135969
29501	3357	858	689	127941	0	132845
29502	1353	130059	723	3188	0	135323
29503	918	134214	708	1666	0	137506
29504	130762	3224	686	1472	0	136144
29505	3121	1381	602	129346	0	134450
29506	1262	1074	128494	3366	0	134196
29507	121862	894	2878	1778	0	127412
29508	3173	966	131280	1326	0	136745
29509	1257	129058	2836	1343	0	134494
29510	127693	2890	1187	1412	0	133182
29511	3093	1393	129211	1347	0	135044
29512	1347	1222	2846	130027	0	135442
29513	1152	978	135386	3508	0	141024
29514	919	136184	3019	2087	0	142209
29515	1156	3103	1244	136056	0	141559
29516	1143	1483	135564	3516	0	141706
29517	122082	1075	2872	2015	0	128044
29518	2969	138976	1131	1673	0	144749
29519	1461	3197	834	131820	0	137312
29520	1082	139734	847	3335	0	144998
29521	137359	3314	841	1666	0	143180
29522	136564	1528	654	1690	0	140436
29523	3358	138055	879	1724	0	144016
29524	1581	3237	790	133804	0	139412
29525	1144	139100	752	3348	0	144344
29526	136653	3190	1091	1767	0	142701
29527	3338	1543	136756	1410	0	143047
29528	1676	1279	135488	1329	0	139772
29529	1182	133817	3110	1398	0	139507
29530	1133	133846	1378	1170	0	137527
29531	1091	3289	927	129098	0	134405
29532	128369	1341	811	2793	0	133314
29533	128707	885	936	1355	0	131883
29534	125346	784	773	1094	0	127997
29535	3460	129853	801	1269	0	135383
29536	1690	2468	733	124984	0	129875
29537	1285	129335	706	2849	0	134175
29538	129199	2531	919	1521	0	134170
29539	3082	1090	780	127571	0	132523
29540	1577	768	124879	2801	0	130025
29541	1059	122441	2374	1608	0	127482
29542	119235	2383	1073	1012	0	123703
29543	2824	1143	119854	746	0	124567
29544	113959	914	2043	1067	0	117983
29545	2622	119163	861	1122	0	123768
29546	848	106480	353	565	0	108246
29547	103099	1647	344	486	0	105576
29548	1522	106190	288	535	0	108535
29549	102967	1364	269	443	0	105043
29550	1403	104183	290	393	0	106269
29551	103617	1340	397	441	0	105795
29552	103900	535	388	354	0	105177
29553	1639	545	105646	309	0	108139
29554	748	508	103353	248	0	104857
29555	499	104350	1091	359	0	106299
29556	102027	975	684	319	0	104005
29557	1041	458	99470	274	0	101243
29558	92758	281	749	238	0	94026
29559	804	447	306	93388	0	94945
29560	404	216	95616	521	0	96757
29561	294	240	91822	220	0	92576
29562	315	234	96768	215	0	97532
29563	173	97362	519	159	0	98213
29564	910	1508	669	93460	0	96547
29565	91561	89	42	289	0	91981
29566	203	54	24	92317	0	92598
29567	93118	36	40	234	0	93428
29568	229	51	34	93326	0	93640
29569	94420	40	41	411	0	94912
29570	96800	49	54	290	0	97193
29571	105384	42	35	169	0	105630
29572	589	108174	50	183	0	108996
29573	357	592	109369	76	0	110394
29574	154	231	560	109426	0	110371
29575	309	507	402	80162	0	81380
29576	106	106	88	113570	0	113870
29577	103	67	62	111008	0	111240
29578	98	110141	69	1074	0	111382
29579	210	691	105981	432	0	107314
29580	81	110365	660	249	0	111355
29581	123	764	283	106447	0	107617
29582	125	365	117	110666	0	111273
29583	115	164	65	111482	0	111826
29584	135	109	71	110639	0	110954
29585	96	108417	97	1097	0	109707
29586	91	108444	117	503	0	109155
29587	282	956	104998	228	0	106464
29588	133	391	703	106342	0	107569
29589	117	182	300	109074	0	109673
29590	113	146	136	111158	0	111553
29591	111060	147	92	1198	0	112497
29592	815	112363	117	666	0	113961
29593	483	870	110373	241	0	111967
29594	109659	328	783	233	0	111003
29595	863	192	321	112357	0	113733
29596	115036	151	160	1050	0	116397
29597	954	159	98	115271	0	116482
29598	116512	154	128	1065	0	117859
29599	940	154	142	115883	0	117119
29600	114991	146	153	1015	0	116305
29601	1096	197	119895	475	0	121663
29602	513	146	812	117038	0	118509
29603	295	122516	384	942	0	124137
29604	249	909	190	123588	0	124936
29605	122639	427	160	1065	0	124291
29606	974	124102	220	620	0	125916
29607	502	1044	147	127875	0	129568
29608	271	126770	179	1328	0	128548
29609	233	1259	142	127890	0	129524
29610	243	496	128	128788	0	129655
29611	315	321	125758	1665	0	128059
29612	265	217	1224	121450	0	123156
29613	279	259	120677	1423	0	122638
29614	193	118271	1334	1001	0	120799
29615	118171	1220	498	463	0	120352
29616	1340	498	118684	383	0	120905
29617	113056	279	1297	469	0	115101
29618	122627	226	471	507	0	123831
29619	1686	220	315	123486	0	125707
29620	704	291	130217	1560	0	132772
29621	124108	217	1685	850	0	126860
29622	136055	192	650	640	0	137537
29623	2117	188	322	132534	0	135161
29624	862	214	217	133924	0	135217
29625	422	136408	235	2349	0	139414
29626	366	1836	234	134248	0	136684
29627	279	136937	272	2092	0	139580
29628	377	1866	134462	888	0	137593
29629	313	702	1598	134861	0	137474
29630	132774	327	711	2002	0	135814
29631	134288	268	280	1010	0	135846
29632	2065	135277	222	874	0	138438
29633	862	1766	220	136863	0	139711
29634	137691	709	238	1937	0	140575
29635	1746	133718	261	1113	0	136838
29636	134394	1815	211	704	0	137124
29637	1973	727	194	139508	0	142402
29638	146458	410	212	2231	0	149311
29639	2478	458	158312	1110	0	162358
29640	880	161487	2560	903	0	165830
29641	158541	2709	893	626	0	162769
29642	2536	165046	492	845	0	168919
29643	168255	2773	314	729	0	172071
29644	171278	907	266	776	0	173227
29645	3640	583	171174	662	0	176059
29646	1297	398	2809	166818	0	171322
29647	174645	401	886	3183	0	179115
29648	3190	421	173009	1190	0	177810
29649	169600	365	2956	796	0	173717
29650	3281	375	862	174335	0	178853
29651	1247	432	173093	3285	0	178057
29652	704	361	2916	170476	0	174457
29653	168800	390	964	3475	0	173629
29654	3309	526	174294	1207	0	179336
29655	1263	453	2877	174272	0	178865
29656	801	420	1012	178254	0	180487
29657	178072	316	571	3901	0	182860
29658	175256	348	421	1526	0	177551
29659	3751	181665	506	1084	0	187006
29660	1605	3040	461	180574	0	185680
29661	1100	1055	484	181986	0	184625
29662	973	629	493	179990	0	182085
29663	177007	489	540	3998	0	182034
29664	177349	552	608	1617	0	180126
29665	4384	657	450	173479	0	178970
29666	1894	175296	479	3520	0	181189
29667	1441	3315	510	165374	0	170640
29668	1236	176424	645	3348	0	181653
29669	172923	3153	586	1544	0	178206
29670	3687	169590	785	1283	0	175345
29671	161321	2803	694	899	0	165717
29672	3600	1013	619	158272	0	163504
29673	157099	652	639	3110	0	161500
29674	3749	619	155399	1443	0	161210
29675	1680	160345	2803	1305	0	166133
29676	161015	2727	1466	1089	0	166297
29677	162272	883	860	1201	0	165216
29678	3870	619	720	154526	0	159735
29679	1773	159018	811	3317	0	164919
29680	1586	2699	739	165168	0	170192
29681	1461	938	775	165943	0	169117
29682	1552	761	760	165796	0	168869
29683	164390	742	788	4064	0	169984
29684	165564	819	700	2013	0	169096
29685	4349	768	635	157225	0	162977
29686	2287	163106	692	3663	0	169748
29687	165827	2667	807	1947	0	171248
29688	4074	1168	163743	1733	0	170718
29689	2398	879	2777	165012	0	171066
29690	1995	966	166668	3800	0	173429
29691	1789	1047	2949	165432	0	171217
29692	1883	1047	167743	4074	0	174747
29693	1891	983	3116	166220	0	172210
29694	168093	1068	1353	4103	0	174617
29695	167460	1198	883	2109	0	171650
29696	4936	163683	897	1841	0	171357
29697	167299	3244	851	1803	0	173197
29698	4539	1522	902	165506	0	172469
29699	2750	1257	978	166523	0	171508
29700	166951	1110	1847	4403	0	174311
29701	4784	1245	163931	2432	0	172392
29702	3103	1288	164491	2112	0	170994
29703	2626	1343	164034	2235	0	170238
29704	156352	1049	3613	2470	0	163484
29705	4772	1006	167379	2517	0	175674
29706	3106	1038	161313	2654	0	168111
29707	151545	1022	3528	2360	0	158455
29708	4322	163847	1640	2394	0	172203
29709	2841	2859	1277	166291	0	173268
29710	2556	1609	1032	169516	0	174713
29711	2589	1216	171067	4548	0	179420
29712	168289	1106	2992	2959	0	175346
29713	173647	936	1547	2823	0	178953
29714	169056	980	1342	2914	0	174292
29715	4540	974	172434	2846	0	180794
29716	164754	853	3044	3022	0	171673
29717	4520	1119	164362	2689	0	172690
29718	2976	166356	2622	3023	0	174977
29719	2792	169137	1293	2569	0	175791
29720	160490	2884	1054	2540	0	166968
29721	3533	158620	1044	2570	0	165767
29722	2176	160445	866	2840	0	166327
29723	157298	2876	1037	2496	0	163707
29724	3582	158807	986	2639	0	166014
29725	156821	2605	925	2253	0	162604
29726	4146	1267	940	161401	0	167754
29727	2705	1305	1025	163947	0	168982
29728	2258	1351	1055	164917	0	169581
29729	2191	1468	1101	158699	0	163459
29730	2206	161780	1224	3937	0	169147
29731	163828	2747	1109	2202	0	169886
29732	3879	178875	1175	2187	0	186116
29733	2412	180556	1250	2585	0	186803
29734	2464	3425	189932	1920	0	197741
29735	176234	1263	3865	2188	0	183550
29736	4731	1135	202008	1685	0	209559
29737	3051	899	202483	1490	0	207923
29738	1795	202796	3866	1597	0	210054
29739	821	201336	989	1138	0	204284
29740	192316	3459	1200	715	0	197690
29741	3075	202615	791	1199	0	207680
29742	1329	2995	212359	726	0	217409
29743	666	190778	3498	832	0	195774
29744	812	2741	210669	450	0	214672
29745	581	690	206391	323	0	207985
29746	192469	412	3858	331	0	197070
29747	3190	273	204349	320	0	208132
29748	719	220	3153	195473	0	199565
29749	192042	189	882	2869	0	195982
29750	2665	191210	587	1498	0	195960
29751	878	2657	199869	458	0	203862
29752	194172	582	3009	316	0	198079
29753	3000	423	910	177454	0	181787
29754	718	173678	677	2764	0	177837
29755	542	2457	191367	614	0	194980
29756	182665	561	3047	368	0	186641
29757	3057	357	192154	305	0	195873
29758	840	187	3114	185526	0	189667
29759	584	275	187264	2984	0	191107
29760	385	216	3122	183737	0	187460
29761	181119	182	871	3089	0	185261
29762	2766	186390	577	1193	0	190926
29763	188375	2834	353	422	0	191984
29764	3279	711	189271	285	0	193546
29765	895	414	3142	182502	0	186953
29766	590	338	191336	2924	0	195188
29767	186231	254	3395	745	0	190625
29768	188460	255	870	377	0	189962
29769	3515	191098	572	615	0	195800
29770	193386	3080	451	276	0	197193
29771	193910	780	440	249	0	195379
29772	3850	449	378	187281	0	191958
29773	1272	333	191360	3103	0	196068
29774	580	179894	3352	1202	0	185028
29775	572	3020	809	178622	0	183023
29776	181812	707	583	2970	0	186072
29777	3270	455	185284	757	0	189766
29778	912	377	186816	424	0	188529
29779	645	405	182877	305	0	184232
29780	173524	321	3957	297	0	178099
29781	3364	358	180311	335	0	184368
29782	172402	302	3634	255	0	176593
29783	3494	470	163925	288	0	168177
29784	907	176104	3206	608	0	180825
29785	699	3243	917	174031	0	178890
29786	629	912	176054	3033	0	180628
29787	490	171933	3491	977	0	176891
29788	469	176457	1126	604	0	178656
29789	640	3857	731	172301	0	177529
29790	171239	1173	633	3082	0	176127
29791	3278	829	542	171050	0	175699
29792	167046	707	634	3301	0	171688
29793	3519	797	594	167413	0	172323
29794	1160	682	167815	3329	0	172986
29795	903	620	169062	961	0	171546
29796	161461	544	4443	626	0	167074
29797	166162	567	1771	454	0	168954
29798	4135	732	163350	467	0	168684
29799	156987	747	4059	403	0	162196
29800	3944	895	161293	432	0	166564
29801	1462	155395	4182	525	0	161564
29802	1063	156309	1826	548	0	159746
29803	972	153444	1621	627	0	156664
29804	1005	4418	1449	148937	0	155809
29805	148497	1671	1356	3238	0	154762
29806	150405	1259	1426	926	0	154016
29807	4339	1175	1293	147675	0	154482
29808	1799	1148	142086	3407	0	148440
29809	1233	1023	4321	139468	0	146045
29810	1188	819	140243	3658	0	145908
29811	1189	771	4781	135205	0	141946
29812	134683	566	2382	3811	0	141442
29813	137109	577	1817	1372	0	140875
29814	136868	568	1723	1037	0	140196
29815	136511	556	1443	956	0	139466
29816	4919	577	1447	130517	0	137460
29817	2002	648	1390	134143	0	138183
29818	131767	667	1304	4168	0	137906
29819	134353	679	1252	1470	0	137754
29820	4772	689	1211	130665	0	137337
29821	2116	724	1235	132948	0	137023
29822	1782	638	1109	130974	0	134503
29823	1578	716	1263	131556	0	135113
29824	127992	582	1387	4534	0	134495
29825	4135	472	126913	1882	0	133402
29826	1844	475	3901	121657	0	127877
29827	120782	505	1705	3911	0	126903
29828	4165	604	119760	1622	0	126151
29829	2246	619	3781	119092	0	125738
29830	1877	576	119495	3619	0	125567
29831	1553	112587	4030	1481	0	119651
29832	1882	2758	1667	95715	0	102022
29833	88748	777	1294	2651	0	93470
29834	2959	1935	1009	75008	0	80911
29835	1491	75369	732	2334	0	79926
29836	1155	68414	641	767	0	70977
29837	864	54335	376	515	0	56090
29838	726	49570	546	482	0	51324
29839	25520	3371	4012	1972	0	34875
29840	1520	1017	706	17534	0	20777
29841	187	74	14770	417	0	15448
29842	137	71	372	13759	0	14339
29843	152	43	13765	391	0	14351
29844	13642	33	342	163	0	14180
29845	455	38	120	13478	0	14091
29846	229	42	85	13699	0	14055
29847	171	43	85	13605	0	13904
29848	141	57	67	13719	0	13984
29849	13365	62	58	435	0	13920
29850	13601	47	46	200	0	13894
29851	449	39	53	13238	0	13779
29852	12990	40	55	419	0	13504
29853	363	46	12757	214	0	13380
29854	138	12567	308	196	0	13209
29855	139	283	101	12472	0	12995
29856	123	59	89	12104	0	12375
29857	121	12281	79	445	0	12926
29858	136	256	86	12099	0	12577
29859	124	429	85	11874	0	12512
29860	11814	31	127	399	0	12371
29861	314	34	11171	166	0	11685
29862	121	44	10205	111	0	10481
29863	9716	39	312	113	0	10180
29864	289	41	9187	108	0	9625
29865	4543	33	363	50	0	4989
29866	3961	18	58	29	0	4066
29867	191	44	53	3051	0	3339
29868	50	6	2474	70	0	2600
29869	1923	29	55	36	0	2043
29870	51	1907	31	27	0	2016
29871	891	137	167	30	0	1225
29872	544	42	114	82	0	782
29873	222	2	33	4	0	261
29874	113	14	0	1	0	128
29875	85	28	0	2	0	115
29876	96	1	0	2	0	99
29877	95	0	0	1	0	96
29878	88	0	0	2	0	90
29879	70	0	1	0	0	71
29880	64	0	0	1	0	65
29881	51	1	0	2	0	54
29882	42	4	0	1	0	47
29883	26	15	2	1	0	44
29884	24	2	0	1	0	27
29885	20	2	1	0	0	23
29886	17	1	2	0	0	20
29887	15	0	1	1	0	17
29888	11	0	5	0	0	16
29889	7	0	3	0	0	10
29890	4	0	3	0	0	7
29891	2	0	1	0	0	3
29892	2	0	0	0	0	2
29893	2	0	0	0	0	2
29894	2	0	0	0	0	2
29895	2	0	0	0	0	2
29896	2	0	0	0	0	2
29897	2	0	0	0	0	2
29898	2	0	0	0	0	2
29899	2	0	0	0	0	2
29900	2	0	0	0	0	2
29901	2	0	0	0	0	2
29902	2	0	0	0	0	2
29903	2	0	0	0	0	2
