Pos	A	C	G	T	Other	Total
1	0	0	0	0	0	0
2	0	0	0	1	0	1
3	0	0	0	5	0	5
4	5	0	0	0	0	5
5	5	0	0	0	0	5
6	9	0	0	0	0	9
7	0	0	9	0	0	9
8	0	0	9	0	0	9
9	0	0	0	9	0	9
10	0	0	0	8	0	8
11	0	0	0	19	0	19
12	43	0	0	2	0	45
13	0	0	0	95	0	95
14	206	0	0	7	0	213
15	0	355	0	0	0	355
16	0	716	1	1	0	718
17	9	2	0	1846	0	1857
18	2	0	0	2005	0	2007
19	1	2709	0	2	0	2712
20	1	3013	0	2	0	3016
21	0	3359	0	22	0	3381
22	3597	1	1	26	0	3625
23	2	0	3698	1	0	3701
24	1	3	3617	1	0	3622
25	3	2	1	3897	0	3903
26	4211	1	0	23	0	4235
27	4272	0	0	9	0	4281
28	1	4293	1	6	0	4301
29	4989	1	1	35	0	5026
30	5342	0	1	30	0	5373
31	5458	0	0	10	0	5468
32	2	5520	1	0	0	5523
33	0	5675	1	5	0	5681
34	5848	1	0	17	0	5866
35	5880	0	0	8	0	5888
36	2	5930	1	6	0	5939
37	1	6388	0	2	0	6391
38	6460	2	0	11	0	6473
39	6437	0	0	5	0	6442
40	2	6483	1	4	0	6490
41	1	1	0	6735	0	6737
42	1	1	1	6744	0	6747
43	7	0	0	6672	0	6679
44	1	6653	0	8	0	6662
45	3	4	6581	2	0	6590
46	6170	1	7	10	0	6188
47	4	0	0	6836	0	6840
48	2	6832	0	13	0	6847
49	2	4	0	6967	0	6973
50	0	6896	1	6	0	6903
51	3	8	2	6985	0	6998
52	1	1	0	7076	0	7078
53	6	2	7141	6	0	7155
54	3	1	9	6980	0	6993
55	7130	1	0	13	0	7144
56	9	2	7041	1	0	7053
57	6837	1	8	10	0	6856
58	8	0	1	7235	0	7244
59	0	7264	1	12	0	7277
60	1	7	0	7382	0	7390
61	2	4	7354	7	0	7367
62	4	1	7	7171	0	7183
63	2	0	2	7383	0	7387
64	0	7417	4	9	0	7430
65	2	8	5	7505	0	7520
66	10	7425	2	11	0	7448
67	1	10	0	7541	0	7552
68	7517	1	0	18	0	7536
69	7342	3	2	6	0	7353
70	7364	0	0	14	0	7378
71	17	7409	1	8	0	7435
72	15	19	7353	2	0	7389
73	7193	3	16	12	0	7224
74	7637	3	6	7	0	7653
75	27	7906	2	6	0	7941
76	10	43	0	7037	0	7090
77	10	11	1	7182	0	7204
78	5	7	0	6613	0	6625
79	6691	4	4	86	0	6785
80	6766	1	0	31	0	6798
81	6792	3	1	22	0	6818
82	6873	2	1	16	0	6892
83	86	2	0	6815	0	6903
84	33	6784	2	60	0	6879
85	18	52	0	6978	0	7048
86	20	15	6962	75	0	7072
87	12	6	68	7146	0	7232
88	8	6	7329	99	0	7442
89	9	4	95	7282	0	7390
90	5	4	7496	105	0	7610
91	5	4	7399	40	0	7448
92	4	7738	125	27	0	7894
93	4	106	30	7980	0	8120
94	7	29	8255	107	0	8398
95	12	13	119	8037	0	8181
96	7	8250	40	116	0	8413
97	8294	117	13	43	0	8467
98	109	8591	11	30	0	8741
99	36	124	13	8456	0	8629
100	19	8671	7	106	0	8803
101	14	127	8416	32	0	8589
102	14	50	8337	20	0	8421
103	3	8466	142	32	0	8643
104	5	117	55	8651	0	8828
105	11	38	8697	128	0	8874
106	6	8628	126	48	0	8808
107	8655	122	50	28	0	8855
108	124	46	25	8695	0	8890
109	44	25	8958	121	0	9148
110	24	8976	118	39	0	9157
111	14	130	37	9085	0	9266
112	10	47	25	9115	0	9197
113	8897	29	16	166	0	9108
114	119	20	8897	57	0	9093
115	39	16	127	8774	0	8956
116	19	26	8601	138	0	8784
117	13	7921	139	55	0	8128
118	7621	129	50	34	0	7834
119	107	7450	30	25	0	7612
120	37	133	24	7101	0	7295
121	18	7157	24	109	0	7308
122	6922	136	25	46	0	7129
123	124	6965	14	28	0	7131
124	45	151	6735	26	0	6957
125	27	6803	120	25	0	6975
126	6637	146	46	34	0	6863
127	128	62	6818	23	0	7031
128	51	29	134	6800	0	7014
129	6537	28	58	136	0	6759
130	145	24	36	6344	0	6549
131	6439	24	26	166	0	6655
132	6521	25	25	70	0	6641
133	190	22	23	6410	0	6645
134	77	23	20	6507	0	6627
135	6331	23	18	200	0	6572
136	6327	21	17	83	0	6448
137	196	34	16	6105	0	6351
138	6146	23	14	176	0	6359
139	6204	23	13	77	0	6317
140	199	6092	27	39	0	6357
141	86	158	20	6140	0	6404
142	6136	51	25	170	0	6382
143	6303	38	23	85	0	6449
144	207	26	19	6175	0	6427
145	90	23	23	6305	0	6441
146	6160	21	18	212	0	6411
147	168	6171	20	99	0	6458
148	79	153	15	6139	0	6386
149	50	58	6090	164	0	6362
150	44	42	150	5947	0	6183
151	37	6005	55	173	0	6270
152	49	147	5982	75	0	6253
153	44	55	158	5903	0	6160
154	46	31	61	5728	0	5866
155	41	28	6010	205	0	6284
156	5653	25	145	92	0	5915
157	164	6006	54	64	0	6288
158	6103	150	34	52	0	6339
159	192	59	5980	47	0	6278
160	81	39	6041	58	0	6219
161	5792	30	184	56	0	6062
162	178	6034	67	43	0	6322
163	5951	153	40	55	0	6199
164	166	6061	30	56	0	6313
165	80	165	6077	47	0	6369
166	5906	67	150	49	0	6172
167	179	44	6177	41	0	6441
168	82	36	156	6068	0	6342
169	6067	27	61	178	0	6333
170	6090	25	43	80	0	6238
171	196	5986	29	66	0	6277
172	88	256	28	5729	0	6101
173	53	5870	26	156	0	6105
174	62	150	5777	58	0	6047
175	45	120	136	5176	0	5477
176	39	5264	48	118	0	5469
177	47	123	38	5115	0	5323
178	4846	44	33	118	0	5041
179	114	23	21	4925	0	5083
180	47	4944	26	110	0	5127
181	36	91	18	5016	0	5161
182	41	54	14	4976	0	5085
183	38	4949	32	110	0	5129
184	47	99	18	5011	0	5175
185	38	40	4883	107	0	5068
186	41	4795	90	48	0	4974
187	4451	74	34	25	0	4584
188	87	35	4512	23	0	4657
189	46	27	4379	23	0	4475
190	35	4322	74	22	0	4453
191	62	86	54	4060	0	4262
192	28	33	3960	48	0	4069
193	28	3312	63	34	0	3437
194	42	42	21	3541	0	3646
195	30	19	16	3623	0	3688
196	3524	13	15	54	0	3606
197	53	3570	9	24	0	3656
198	27	44	3287	18	0	3376
199	18	31	3321	19	0	3389
200	20	20	44	3221	0	3305
201	16	16	22	3906	0	3960
202	14	16	17	3947	0	3994
203	15	4687	10	111	0	4823
204	13	122	4851	55	0	5041
205	25	66	116	4975	0	5182
206	19	5253	64	143	0	5479
207	8	5621	25	78	0	5732
208	6	215	5865	35	0	6121
209	18	89	193	5699	0	5999
210	12	41	6415	206	0	6674
211	11	30	232	6294	0	6567
212	13	24	107	6542	0	6686
213	22	26	6349	309	0	6706
214	17	6320	232	130	0	6699
215	6257	230	115	68	0	6670
216	215	109	6356	41	0	6721
217	101	6269	254	38	0	6662
218	44	6624	123	37	0	6828
219	31	311	6387	44	0	6773
220	6161	141	263	49	0	6614
221	246	92	128	5680	0	6146
222	102	6369	75	198	0	6744
223	6354	247	69	112	0	6782
224	256	148	59	6003	0	6466
225	113	6270	59	252	0	6694
226	6328	269	53	138	0	6788
227	255	142	6091	62	0	6550
228	115	6149	254	64	0	6582
229	5906	262	123	50	0	6341
230	238	6016	82	45	0	6381
231	5855	286	59	38	0	6238
232	252	172	44	5518	0	5986
233	128	5706	62	214	0	6110
234	81	261	66	5759	0	6167
235	5685	139	54	282	0	6160
236	230	81	5570	162	0	6043
237	130	86	5736	74	0	6026
238	88	67	310	5507	0	5972
239	71	72	152	5660	0	5955
240	80	77	101	5497	0	5755
241	59	5442	78	331	0	5910
242	55	276	5355	165	0	5851
243	72	153	258	5027	0	5510
244	66	5167	140	224	0	5597
245	72	5525	77	131	0	5805
246	70	314	5388	88	0	5860
247	66	184	5419	83	0	5752
248	51	127	5580	87	0	5845
249	72	97	340	5317	0	5826
250	80	72	5525	255	0	5932
251	52	83	313	5461	0	5909
252	56	89	5528	291	0	5964
253	5189	84	293	169	0	5735
254	262	5476	168	114	0	6020
255	135	6066	92	84	0	6377
256	90	383	6218	75	0	6766
257	6055	186	342	95	0	6678
258	6390	123	171	87	0	6771
259	6491	103	104	91	0	6789
260	431	91	6042	78	0	6642
261	204	66	6350	81	0	6701
262	110	70	455	6118	0	6753
263	6178	75	232	362	0	6847
264	6343	83	158	196	0	6780
265	431	87	6048	139	0	6705
266	6127	94	383	116	0	6720
267	372	86	234	6001	0	6693
268	202	114	6173	342	0	6831
269	98	112	6364	211	0	6785
270	5945	98	499	135	0	6677
271	345	88	6313	116	0	6862
272	6150	77	449	131	0	6807
273	395	66	6390	104	0	6955
274	207	5990	441	109	0	6747
275	118	6444	289	107	0	6958
276	118	410	215	6094	0	6837
277	132	202	191	6521	0	7046
278	133	144	6285	458	0	7020
279	129	106	437	6087	0	6759
280	129	5883	291	364	0	6667
281	134	6173	185	213	0	6705
282	142	6541	171	123	0	6977
283	178	461	174	6140	0	6953
284	172	233	6192	340	0	6937
285	123	170	6416	189	0	6898
286	154	134	493	6141	0	6922
287	155	100	265	6333	0	6853
288	148	120	197	5910	0	6375
289	164	6161	144	434	0	6903
290	6167	360	138	243	0	6908
291	6229	201	126	178	0	6734
292	475	6103	157	138	0	6873
293	255	375	6272	128	0	7030
294	6290	230	393	126	0	7039
295	422	142	6441	107	0	7112
296	6337	130	438	114	0	7019
297	6525	109	246	145	0	7025
298	6591	102	206	141	0	7040
299	6438	104	168	144	0	6854
300	477	6285	152	174	0	7088
301	5573	304	101	166	0	6144
302	340	5666	126	158	0	6290
303	4753	244	100	101	0	5198
304	276	4663	106	83	0	5128
305	143	211	4180	47	0	4581
306	91	452	185	3478	0	4206
307	70	3817	126	170	0	4183
308	63	3645	71	83	0	3862
309	3280	190	146	99	0	3715
310	2988	56	36	40	0	3120
311	155	3063	26	30	0	3274
312	60	112	29	2968	0	3169
313	55	3253	27	97	0	3432
314	3303	122	19	43	0	3487
315	133	54	3272	22	0	3481
316	60	40	123	3160	0	3383
317	36	20	56	3238	0	3350
318	37	18	36	3299	0	3390
319	40	19	3198	135	0	3392
320	35	3100	124	49	0	3308
321	45	3274	56	25	0	3400
322	53	140	24	3274	0	3491
323	40	54	3379	108	0	3581
324	33	37	120	3318	0	3508
325	31	31	53	3470	0	3585
326	31	27	30	3456	0	3544
327	39	29	29	3466	0	3563
328	3317	30	28	155	0	3530
329	118	3354	35	57	0	3564
330	3379	129	33	40	0	3581
331	124	62	3351	39	0	3576
332	52	42	3399	29	0	3522
333	54	35	144	3223	0	3456
334	42	25	61	3316	0	3444
335	30	3387	34	139	0	3590
336	25	118	3397	71	0	3611
337	28	3451	112	56	0	3647
338	30	113	3495	36	0	3674
339	3254	45	119	39	0	3457
340	111	3537	46	36	0	3730
341	54	122	3545	35	0	3756
342	39	57	115	3456	0	3667
343	25	34	3569	114	0	3742
344	26	3536	118	55	0	3735
345	28	131	40	3455	0	3654
346	29	3516	25	120	0	3690
347	40	115	3536	54	0	3745
348	33	50	107	3468	0	3658
349	3503	40	35	121	0	3699
350	119	3465	21	58	0	3663
351	52	118	3388	31	0	3589
352	39	129	90	3117	0	3375
353	32	32	3332	97	0	3493
354	29	24	3004	46	0	3103
355	11	2752	74	25	0	2862
356	5	34	12	2440	0	2491
357	6	6	2	2480	0	2494
358	5	10	1	2421	0	2437
359	4	4	2478	33	0	2519
360	1	6	2449	7	0	2463
361	2237	2	28	8	0	2275
362	29	5	2415	1	0	2450
363	2238	4	24	2	0	2268
364	23	2435	11	6	0	2475
365	6	25	4	2353	0	2388
366	3	2466	8	26	0	2503
367	1	2559	4	10	0	2574
368	3	35	2460	9	0	2507
369	4	10	29	2412	0	2455
370	3	5	2478	27	0	2513
371	2	5	2294	11	0	2312
372	2268	3	32	8	0	2311
373	26	4	2370	8	0	2408
374	5	5	2316	4	0	2330
375	2216	1	32	12	0	2261
376	27	3	2309	8	0	2347
377	10	8	2399	2	0	2419
378	3	6	34	2256	0	2299
379	3	2410	9	29	0	2451
380	4	28	7	2440	0	2479
381	6	6	5	2371	0	2388
382	2437	4	6	37	0	2484
383	24	9	9	2417	0	2459
384	9	2463	6	37	0	2515
385	2435	27	10	13	0	2485
386	28	13	2435	7	0	2483
387	2312	3	36	9	0	2360
388	32	11	2585	7	0	2635
389	12	3	2715	9	0	2739
390	4	2850	41	11	0	2906
391	2890	37	14	7	0	2948
392	34	2999	12	6	0	3051
393	12	36	2979	8	0	3035
394	9	16	46	2759	0	2830
395	6	3059	21	33	0	3119
396	3079	39	12	15	0	3145
397	3069	24	6	9	0	3108
398	53	3081	13	4	0	3151
399	3154	46	14	7	0	3221
400	50	16	13	3027	0	3106
401	20	3105	14	48	0	3187
402	5	55	14	3188	0	3262
403	13	20	11	3380	0	3424
404	3425	11	13	64	0	3513
405	3368	9	12	25	0	3414
406	3382	12	7	13	0	3414
407	69	11	3327	11	0	3418
408	3258	8	50	9	0	3325
409	62	32	21	3372	0	3487
410	29	9	3402	52	0	3492
411	19	12	3170	26	0	3227
412	9	3215	55	14	0	3293
413	2994	44	31	8	0	3077
414	44	3101	11	9	0	3165
415	20	41	12	3106	0	3179
416	14	15	7	3150	0	3186
417	13	8	3195	48	0	3264
418	14	4	48	3022	0	3088
419	9	6	3219	47	0	3281
420	10	6	3085	24	0	3125
421	5	3249	53	17	0	3324
422	8	35	26	3178	0	3247
423	7	18	8	3124	0	3157
424	3122	9	11	46	0	3188
425	40	7	3094	23	0	3164
426	16	7	39	3181	0	3243
427	3229	7	20	43	0	3299
428	39	5	3270	25	0	3339
429	3173	8	36	16	0	3233
430	3323	5	27	12	0	3367
431	57	6	3330	15	0	3408
432	31	7	41	3252	0	3331
433	19	13	21	3326	0	3379
434	26	4	3460	55	0	3545
435	3352	3	46	35	0	3436
436	3477	7	29	10	0	3523
437	3400	7	19	19	0	3445
438	3435	9	24	15	0	3483
439	3386	11	27	11	0	3435
440	81	28	2979	20	0	3108
441	35	13	3434	23	0	3505
442	24	3476	53	16	0	3569
443	21	42	3501	19	0	3583
444	22	26	46	3470	0	3564
445	52	20	59	2488	0	2619
446	36	13	20	3529	0	3598
447	29	13	16	3581	0	3639
448	31	13	3578	66	0	3688
449	38	3469	50	29	0	3586
450	27	3613	27	23	0	3690
451	22	64	20	3566	0	3672
452	22	3748	17	69	0	3856
453	3751	57	19	40	0	3867
454	3765	24	17	32	0	3838
455	84	3968	15	27	0	4094
456	46	46	23	3965	0	4080
457	35	31	22	4105	0	4193
458	33	10	4120	82	0	4245
459	3802	12	61	47	0	3922
460	4166	13	47	26	0	4252
461	87	4251	22	25	0	4385
462	4358	68	22	25	0	4473
463	88	31	4432	26	0	4577
464	49	4320	65	30	0	4464
465	39	4512	23	30	0	4604
466	32	4529	30	24	0	4615
467	32	88	30	4483	0	4633
468	4438	36	22	88	0	4584
469	89	19	37	4516	0	4661
470	43	21	4682	91	0	4837
471	37	25	98	4658	0	4818
472	36	18	4855	117	0	5026
473	36	13	112	4660	0	4821
474	34	27	51	4565	0	4677
475	25	4802	32	124	0	4983
476	4911	99	27	66	0	5103
477	109	36	38	4731	0	4914
478	45	4861	26	111	0	5043
479	4882	94	24	57	0	5057
480	4166	53	42	51	0	4312
481	4925	35	36	43	0	5039
482	116	4900	26	57	0	5099
483	47	95	4930	43	0	5115
484	46	33	107	4859	0	5045
485	44	42	42	4650	0	4778
486	43	4837	34	123	0	5037
487	40	101	4831	44	0	5016
488	42	28	4761	33	0	4864
489	4488	32	103	32	0	4655
490	104	31	38	4524	0	4697
491	35	21	4744	93	0	4893
492	26	4813	90	37	0	4966
493	31	92	24	4592	0	4739
494	25	4888	27	75	0	5015
495	19	92	4793	34	0	4938
496	4514	25	91	31	0	4661
497	4793	18	35	27	0	4873
498	109	4789	29	18	0	4945
499	38	88	10	4771	0	4907
500	26	24	4788	84	0	4922
501	20	4699	83	27	0	4829
502	4640	89	22	26	0	4777
503	81	4444	19	26	0	4570
504	24	4547	15	9	0	4595
505	20	87	10	4437	0	4554
506	14	4497	5	73	0	4589
507	4487	85	10	20	0	4602
508	74	26	20	4439	0	4559
509	26	10	4317	74	0	4427
510	10	15	4210	18	0	4253
511	8	20	76	4284	0	4388
512	11	4378	22	68	0	4479
513	4409	73	19	19	0	4520
514	70	24	6	4331	0	4431
515	25	13	4391	77	0	4506
516	14	18	70	4339	0	4441
517	16	17	18	4412	0	4463
518	4369	12	10	87	0	4478
519	67	13	19	4278	0	4377
520	27	15	4205	70	0	4317
521	19	10	4068	35	0	4132
522	9	20	76	4180	0	4285
523	15	10	24	4209	0	4258
524	8	11	4263	87	0	4369
525	3737	11	75	40	0	3863
526	74	9	4201	24	0	4308
527	25	4153	77	16	0	4271
528	22	68	27	4223	0	4340
529	14	22	4239	73	0	4348
530	15	16	4122	28	0	4181
531	9	13	86	4055	0	4163
532	4164	12	23	79	0	4278
533	67	12	4258	30	0	4367
534	23	4169	69	16	0	4277
535	4251	67	22	27	0	4367
536	71	20	4337	21	0	4449
537	4085	17	73	22	0	4197
538	4310	9	26	22	0	4367
539	80	4446	22	20	0	4568
540	25	65	24	4222	0	4336
541	17	4294	15	64	0	4390
542	23	74	4252	21	0	4370
543	4200	27	76	19	0	4322
544	4428	22	23	18	0	4491
545	95	15	4414	15	0	4539
546	37	9	4253	16	0	4315
547	22	4445	86	20	0	4573
548	4553	85	25	18	0	4681
549	87	29	24	4516	0	4656
550	33	15	22	4369	0	4439
551	22	4484	17	75	0	4598
552	4415	74	19	29	0	4537
553	87	25	4502	22	0	4636
554	32	20	80	4819	0	4951
555	4785	16	28	104	0	4933
556	118	4841	26	39	0	5024
557	37	117	5424	15	0	5593
558	22	36	5575	11	0	5644
559	23	51	184	5259	0	5517
560	9	5557	44	148	0	5758
561	9	166	5570	29	0	5774
562	17	35	173	5352	0	5577
563	5506	14	34	184	0	5738
564	181	11	5652	30	0	5874
565	38	18	202	5547	0	5805
566	23	8	5766	200	0	5997
567	16	9	5952	35	0	6012
568	11	35	249	5785	0	6080
569	17	16	5967	196	0	6196
570	4987	15	195	51	0	5248
571	176	12	5774	17	0	5979
572	5220	10	193	21	0	5444
573	173	5586	52	17	0	5828
574	5808	175	25	35	0	6043
575	174	6015	28	12	0	6229
576	40	175	31	5979	0	6225
577	30	37	18	6281	0	6366
578	29	18	6062	204	0	6313
579	15	14	6092	59	0	6180
580	12	9	223	6139	0	6383
581	12	20	6224	191	0	6447
582	19	11	220	5947	0	6197
583	14	5994	67	189	0	6264
584	20	6399	42	50	0	6511
585	28	216	35	6223	0	6502
586	22	53	36	6380	0	6491
587	21	35	6211	220	0	6487
588	27	27	189	6016	0	6259
589	18	5948	61	202	0	6229
590	13	6089	44	66	0	6212
591	11	6149	38	50	0	6248
592	15	209	37	5680	0	5941
593	13	5791	40	189	0	6033
594	5696	190	44	56	0	5986
595	180	54	35	5676	0	5945
596	52	28	5695	199	0	5974
597	35	31	194	5580	0	5840
598	18	39	5781	214	0	6052
599	20	31	5772	63	0	5886
600	16	26	5852	57	0	5951
601	14	5721	221	59	0	6015
602	19	202	5868	38	0	6127
603	5756	52	219	47	0	6074
604	5971	49	65	40	0	6125
605	6069	34	49	41	0	6193
606	220	38	50	5904	0	6212
607	5907	25	45	223	0	6200
608	195	5710	57	64	0	6026
609	58	6195	43	65	0	6361
610	6090	199	55	72	0	6416
611	189	61	6199	53	0	6502
612	58	60	216	6055	0	6389
613	49	40	6236	202	0	6527
614	32	42	6291	74	0	6439
615	34	6251	236	63	0	6584
616	47	215	95	5779	0	6136
617	31	67	65	6442	0	6605
618	6258	52	53	235	0	6598
619	200	6262	44	96	0	6602
620	64	6545	52	80	0	6741
621	61	221	6403	60	0	6745
622	44	6531	216	49	0	6840
623	6373	229	90	47	0	6739
624	6415	86	79	61	0	6641
625	224	58	6543	55	0	6880
626	69	48	6618	69	0	6804
627	50	49	289	6152	0	6540
628	50	50	124	6278	0	6502
629	41	6294	100	243	0	6678
630	48	224	74	6301	0	6647
631	51	75	64	6398	0	6588
632	59	6324	65	247	0	6695
633	63	211	68	6369	0	6711
634	41	85	67	6237	0	6430
635	45	6107	80	253	0	6485
636	48	202	6129	96	0	6475
637	47	66	247	6240	0	6600
638	6303	63	93	245	0	6704
639	6230	48	103	75	0	6456
640	247	55	6047	62	0	6411
641	5791	62	228	74	0	6155
642	6154	68	69	78	0	6369
643	233	6071	57	85	0	6446
644	75	215	5846	70	0	6206
645	43	79	5962	95	0	6179
646	42	86	225	6266	0	6619
647	6360	58	100	236	0	6754
648	6789	50	87	93	0	7019
649	245	50	65	7230	0	7590
650	7943	59	58	282	0	8342
651	8381	61	59	103	0	8604
652	8146	59	53	100	0	8358
653	336	62	7982	74	0	8454
654	106	46	8014	61	0	8227
655	7712	25	256	80	0	8073
656	234	28	7955	56	0	8273
657	51	7355	153	30	0	7589
658	67	165	83	7206	0	7521
659	30	42	7432	135	0	7639
660	25	26	7318	52	0	7421
661	30	47	165	7071	0	7313
662	18	9	7351	133	0	7511
663	25	8	7064	52	0	7149
664	21	6460	149	29	0	6659
665	11	7031	55	19	0	7116
666	7094	125	30	12	0	7261
667	116	47	21	6953	0	7137
668	6990	17	17	101	0	7125
669	118	11	6953	40	0	7122
670	50	8	117	6779	0	6954
671	26	7	42	7056	0	7131
672	6887	11	25	148	0	7071
673	100	6923	23	63	0	7109
674	58	111	6321	31	0	6521
675	21	38	6580	18	0	6657
676	19	6702	141	8	0	6870
677	25	110	6562	15	0	6712
678	14	6581	114	11	0	6720
679	17	6358	52	10	0	6437
680	19	129	6389	14	0	6551
681	6066	59	115	10	0	6250
682	119	20	52	6460	0	6651
683	47	6619	28	95	0	6789
684	24	87	20	6697	0	6828
685	6642	36	20	111	0	6809
686	6743	23	16	54	0	6836
687	6735	9	21	31	0	6796
688	148	13	6636	14	0	6811
689	62	18	104	6408	0	6592
690	23	6657	58	98	0	6836
691	6969	101	30	47	0	7147
692	114	51	16	6997	0	7178
693	55	20	37	6823	0	6935
694	36	22	14	7192	0	7264
695	35	19	6922	155	0	7131
696	6320	10	115	75	0	6520
697	123	6902	52	36	0	7113
698	73	104	28	6891	0	7096
699	55	46	20	7002	0	7123
700	6852	23	26	151	0	7052
701	133	14	6551	68	0	6766
702	73	22	6846	36	0	6977
703	47	6695	161	21	0	6924
704	26	108	6972	21	0	7127
705	6359	54	149	47	0	6609
706	109	6962	77	38	0	7186
707	60	133	7009	27	0	7229
708	6349	52	143	48	0	6592
709	132	38	7152	33	0	7355
710	65	7118	150	29	0	7362
711	40	125	87	7122	0	7374
712	46	65	55	7281	0	7447
713	47	47	7113	164	0	7371
714	46	29	6904	76	0	7055
715	51	6932	173	56	0	7212
716	6813	136	77	45	0	7071
717	132	7052	67	51	0	7302
718	75	134	42	7034	0	7285
719	48	68	6984	144	0	7244
720	6351	49	155	83	0	6638
721	154	37	85	6842	0	7118
722	65	6659	74	146	0	6944
723	36	7115	78	68	0	7297
724	38	178	56	7065	0	7337
725	36	83	61	7186	0	7366
726	7063	61	53	174	0	7351
727	129	61	41	7231	0	7462
728	73	44	7190	169	0	7476
729	6970	27	151	89	0	7237
730	7282	42	84	68	0	7476
731	186	43	7341	61	0	7631
732	7185	36	168	61	0	7450
733	182	34	72	7566	0	7854
734	101	43	37	7669	0	7850
735	70	41	57	7693	0	7861
736	74	35	46	7418	0	7573
737	49	7497	45	219	0	7810
738	7657	164	51	93	0	7965
739	7820	77	42	70	0	8009
740	222	53	7766	81	0	8122
741	8104	41	180	93	0	8418
742	8712	39	76	71	0	8898
743	8869	43	59	64	0	9035
744	9217	43	56	49	0	9365
745	298	9039	44	67	0	9448
746	122	218	33	8723	0	9096
747	86	84	8729	210	0	9109
748	82	57	8267	83	0	8489
749	7104	98	315	97	0	7614
750	7097	79	110	26	0	7312
751	173	6812	33	24	0	7042
752	6831	112	35	24	0	7002
753	146	6830	24	16	0	7016
754	71	118	38	6763	0	6990
755	6956	44	16	125	0	7141
756	6918	37	10	50	0	7015
757	6894	20	11	34	0	6959
758	174	6784	14	25	0	6997
759	6815	121	15	32	0	6983
760	145	51	22	6815	0	7033
761	6951	22	29	122	0	7124
762	163	24	6708	42	0	6937
763	82	6834	109	38	0	7063
764	6860	113	42	24	0	7039
765	141	55	6894	29	0	7119
766	83	29	117	6813	0	7042
767	56	26	6980	122	0	7184
768	55	34	6882	47	0	7018
769	65	23	145	6805	0	7038
770	56	26	7108	120	0	7310
771	49	17	138	6984	0	7188
772	48	22	60	7088	0	7218
773	7162	14	44	153	0	7373
774	146	7175	28	81	0	7430
775	79	7363	31	39	0	7512
776	64	7549	34	32	0	7679
777	48	181	7416	42	0	7687
778	64	65	140	7262	0	7531
779	44	43	7614	138	0	7839
780	6937	38	152	67	0	7194
781	7431	35	72	45	0	7583
782	165	7544	69	33	0	7811
783	78	131	38	7386	0	7633
784	56	7560	56	147	0	7819
785	7618	145	36	74	0	7873
786	179	53	27	7600	0	7859
787	85	66	7510	145	0	7806
788	66	7391	135	64	0	7656
789	44	178	7543	56	0	7821
790	58	63	152	7355	0	7628
791	49	44	7438	165	0	7696
792	7025	30	164	88	0	7307
793	179	41	7515	54	0	7789
794	85	7528	185	30	0	7828
795	79	154	56	7523	0	7812
796	57	65	70	7705	0	7897
797	7584	48	40	208	0	7880
798	7659	42	56	95	0	7852
799	209	7534	47	58	0	7848
800	108	149	7464	62	0	7783
801	74	77	7403	57	0	7611
802	7289	66	183	47	0	7585
803	190	41	7548	52	0	7831
804	100	45	7307	49	0	7501
805	77	47	7359	40	0	7523
806	67	39	7338	35	0	7479
807	70	7343	210	51	0	7674
808	7424	155	123	47	0	7749
809	183	75	76	7245	0	7579
810	7259	49	65	167	0	7540
811	207	7177	60	58	0	7502
812	7212	172	51	72	0	7507
813	198	7433	56	50	0	7737
814	100	178	68	7352	0	7698
815	95	7700	59	159	0	8013
816	94	181	7526	60	0	7861
817	93	7810	191	45	0	8139
818	76	198	115	8458	0	8847
819	8542	100	81	199	0	8922
820	216	81	85	8503	0	8885
821	109	65	8484	223	0	8881
822	114	54	207	8143	0	8518
823	78	8430	105	216	0	8829
824	90	212	8435	88	0	8825
825	8326	101	204	81	0	8712
826	229	67	109	8685	0	9090
827	8424	66	74	236	0	8800
828	8550	64	79	107	0	8800
829	236	8607	84	88	0	9015
830	8315	211	86	72	0	8684
831	8640	101	79	83	0	8903
832	247	8602	73	70	0	8992
833	128	189	69	8569	0	8955
834	85	90	77	8539	0	8791
835	61	8572	81	243	0	8957
836	64	204	67	8801	0	9136
837	57	92	8667	227	0	9043
838	74	92	205	8508	0	8879
839	85	47	8495	232	0	8859
840	60	62	7712	93	0	7927
841	46	7703	185	74	0	8008
842	46	7575	85	45	0	7751
843	44	7816	56	43	0	7959
844	68	162	33	7384	0	7647
845	37	54	7424	136	0	7651
846	7036	37	146	50	0	7269
847	137	26	59	7518	0	7740
848	47	39	7487	134	0	7707
849	33	38	7336	56	0	7463
850	28	7560	161	36	0	7785
851	35	143	55	7491	0	7724
852	7339	43	50	137	0	7569
853	124	7272	43	53	0	7492
854	52	7305	44	39	0	7440
855	30	7338	41	40	0	7449
856	32	169	54	7185	0	7440
857	27	7526	38	136	0	7727
858	25	160	40	8012	0	8237
859	27	63	34	8231	0	8355
860	27	53	7978	216	0	8274
861	7029	53	187	106	0	7375
862	186	43	8144	51	0	8424
863	51	55	206	8022	0	8334
864	33	32	8191	211	0	8467
865	31	8054	199	66	0	8350
866	8028	205	73	65	0	8371
867	200	90	40	7800	0	8130
868	50	45	43	8145	0	8283
869	7952	34	36	228	0	8250
870	7787	36	46	84	0	7953
871	8030	35	24	60	0	8149
872	227	39	7825	35	0	8126
873	7334	27	172	56	0	7589
874	188	7568	52	41	0	7849
875	64	7696	31	34	0	7825
876	49	189	26	7440	0	7704
877	52	74	28	7280	0	7434
878	34	7327	23	209	0	7593
879	41	172	29	7361	0	7603
880	7218	72	24	188	0	7502
881	178	37	7278	76	0	7569
882	53	7255	162	54	0	7524
883	6962	177	42	51	0	7232
884	161	7195	33	51	0	7440
885	64	172	7129	50	0	7415
886	51	80	161	7066	0	7358
887	23	47	7194	180	0	7444
888	41	7102	182	59	0	7384
889	38	174	56	7092	0	7360
890	23	79	7040	186	0	7328
891	41	40	7045	74	0	7200
892	39	41	185	7023	0	7288
893	7004	39	87	190	0	7320
894	7117	35	40	75	0	7267
895	7119	34	42	55	0	7250
896	218	37	7165	36	0	7456
897	74	7132	173	45	0	7424
898	41	176	61	7108	0	7386
899	52	66	38	7014	0	7170
900	47	7183	41	202	0	7473
901	7145	185	29	81	0	7440
902	178	63	40	7268	0	7549
903	67	53	7263	191	0	7574
904	38	7240	188	87	0	7553
905	7030	181	69	73	0	7353
906	168	7214	59	58	0	7499
907	65	189	49	7093	0	7396
908	66	68	44	7162	0	7340
909	72	36	66	7182	0	7356
910	47	53	7062	222	0	7384
911	55	46	184	6800	0	7085
912	50	6772	76	193	0	7091
913	54	6829	49	89	0	7021
914	63	195	6526	70	0	6854
915	5911	63	163	100	0	6237
916	6512	52	71	68	0	6703
917	200	6429	38	68	0	6735
918	5743	135	70	44	0	5992
919	5767	60	28	54	0	5909
920	182	5908	43	44	0	6177
921	81	155	32	6002	0	6270
922	62	70	6279	169	0	6580
923	37	63	5991	79	0	6170
924	6125	55	163	73	0	6416
925	160	6257	64	54	0	6535
926	71	171	39	6277	0	6558
927	52	67	44	6362	0	6525
928	46	56	47	6370	0	6519
929	6218	46	54	204	0	6522
930	194	53	35	6248	0	6530
931	86	56	43	6225	0	6410
932	65	42	5903	201	0	6211
933	5421	38	153	89	0	5701
934	161	5829	68	73	0	6131
935	5738	151	48	54	0	5991
936	156	5664	40	65	0	5925
937	57	162	41	5671	0	5931
938	5673	58	63	167	0	5961
939	5798	44	41	82	0	5965
940	182	42	5608	65	0	5897
941	5779	41	136	43	0	5999
942	181	38	5897	57	0	6173
943	78	39	5648	49	0	5814
944	78	39	5709	39	0	5865
945	43	47	6184	58	0	6332
946	49	46	219	6239	0	6553
947	43	44	6353	189	0	6629
948	38	48	206	6263	0	6555
949	6288	39	70	216	0	6613
950	187	37	63	6288	0	6575
951	6135	43	52	225	0	6455
952	200	6162	43	105	0	6510
953	82	208	44	6226	0	6560
954	71	75	6129	207	0	6482
955	44	6338	184	122	0	6688
956	54	212	67	6274	0	6607
957	29	58	6280	224	0	6591
958	25	5980	175	70	0	6250
959	27	6145	53	62	0	6287
960	37	182	6094	32	0	6345
961	36	72	172	5831	0	6111
962	25	35	5932	151	0	6143
963	5584	19	172	50	0	5825
964	5868	12	65	40	0	5985
965	189	5790	37	16	0	6032
966	5848	154	18	19	0	6039
967	180	39	29	5821	0	6069
968	58	33	5748	160	0	5999
969	5445	15	160	53	0	5673
970	162	14	5659	46	0	5881
971	56	5634	174	16	0	5880
972	5779	158	44	29	0	6010
973	171	36	42	5740	0	5989
974	52	29	5781	163	0	6025
975	5642	19	166	42	0	5869
976	5760	19	45	41	0	5865
977	5861	10	41	28	0	5940
978	208	25	21	5721	0	5975
979	83	14	26	5893	0	6016
980	53	11	5777	205	0	6046
981	31	5700	175	74	0	5980
982	41	155	48	5620	0	5864
983	33	33	53	5917	0	6036
984	27	43	5751	199	0	6020
985	35	26	5750	90	0	5901
986	35	24	193	5741	0	5993
987	5605	16	78	200	0	5899
988	166	5691	53	65	0	5975
989	5723	161	39	65	0	5988
990	200	5733	35	38	0	6006
991	69	183	5704	41	0	5997
992	59	54	5830	37	0	5980
993	5528	51	216	48	0	5843
994	6320	31	81	40	0	6472
995	218	6285	62	45	0	6610
996	109	184	6089	43	0	6425
997	72	76	206	6033	0	6387
998	54	59	91	5886	0	6090
999	49	6082	76	242	0	6449
1000	46	194	48	6182	0	6470
1001	54	91	6184	232	0	6561
1002	5968	76	200	104	0	6348
1003	6182	51	106	89	0	6428
1004	6075	42	88	63	0	6268
1005	6353	37	57	58	0	6505
1006	309	32	6062	52	0	6455
1007	6045	27	213	51	0	6336
1008	282	35	6089	37	0	6443
1009	140	6002	245	48	0	6435
1010	114	199	109	6101	0	6523
1011	6170	78	90	210	0	6548
1012	231	69	59	6445	0	6804
1013	105	37	6452	280	0	6874
1014	6444	42	255	105	0	6846
1015	6739	37	117	105	0	6998
1016	316	43	97	6530	0	6986
1017	159	31	54	6778	0	7022
1018	138	25	6494	301	0	6958
1019	89	6583	228	151	0	7051
1020	6410	221	112	109	0	6852
1021	264	95	6091	65	0	6515
1022	5831	75	218	58	0	6182
1023	276	6025	111	64	0	6476
1024	5995	214	78	63	0	6350
1025	287	5778	70	57	0	6192
1026	132	5945	68	35	0	6180
1027	123	265	56	5867	0	6311
1028	80	123	64	6074	0	6341
1029	83	74	48	6134	0	6339
1030	67	62	63	6143	0	6335
1031	85	48	5880	319	0	6332
1032	5760	48	200	151	0	6159
1033	6067	50	98	95	0	6310
1034	6236	45	77	100	0	6458
1035	337	28	61	6006	0	6432
1036	167	34	54	6171	0	6426
1037	6114	30	57	294	0	6495
1038	6180	52	58	138	0	6428
1039	6277	39	37	108	0	6461
1040	324	45	52	5966	0	6387
1041	166	44	56	5914	0	6180
1042	130	24	5583	274	0	6011
1043	99	35	5475	158	0	5767
1044	104	5534	223	94	0	5955
1045	4917	218	139	88	0	5362
1046	4967	59	78	63	0	5167
1047	4957	48	48	66	0	5119
1048	217	21	4995	86	0	5319
1049	4992	32	146	69	0	5239
1050	5174	17	79	61	0	5331
1051	5206	34	60	45	0	5345
1052	262	17	41	5003	0	5323
1053	156	20	30	5016	0	5222
1054	130	14	25	5062	0	5231
1055	75	27	4477	213	0	4792
1056	4259	20	99	119	0	4497
1057	169	4496	58	68	0	4791
1058	4077	87	38	36	0	4238
1059	144	4018	17	42	0	4221
1060	84	4102	19	52	0	4257
1061	76	114	45	4072	0	4307
1062	56	72	52	3988	0	4168
1063	48	3988	34	111	0	4181
1064	3929	101	17	70	0	4117
1065	3972	55	14	46	0	4087
1066	140	36	15	3866	0	4057
1067	90	30	3875	100	0	4095
1068	62	18	3748	71	0	3899
1069	60	13	3882	54	0	4009
1070	61	21	3864	34	0	3980
1071	3768	27	126	32	0	3953
1072	3824	10	65	40	0	3939
1073	128	8	41	3760	0	3937
1074	78	12	3723	99	0	3912
1075	62	25	104	3793	0	3984
1076	56	3857	58	95	0	4066
1077	58	4282	30	59	0	4429
1078	4331	124	18	59	0	4532
1079	4367	67	17	31	0	4482
1080	4431	47	19	43	0	4540
1081	151	36	21	4308	0	4516
1082	91	20	13	4454	0	4578
1083	58	34	15	4438	0	4545
1084	51	29	17	4386	0	4483
1085	55	16	4345	143	0	4559
1086	57	13	77	4354	0	4501
1087	4560	14	50	113	0	4737
1088	106	6	46	4594	0	4752
1089	68	8	41	4713	0	4830
1090	59	27	31	4648	0	4765
1091	49	4402	21	159	0	4631
1092	49	4430	22	81	0	4582
1093	35	4513	13	72	0	4633
1094	34	82	12	4046	0	4174
1095	22	27	14	4112	0	4175
1096	4083	17	10	86	0	4196
1097	4077	17	9	33	0	4136
1098	4134	14	9	29	0	4186
1099	89	9	6	4082	0	4186
1100	39	8	14	4090	0	4151
1101	37	3994	8	77	0	4116
1102	33	4163	3	36	0	4235
1103	4174	74	4	41	0	4293
1104	76	20	8	4168	0	4272
1105	4188	11	13	80	0	4292
1106	4302	15	13	35	0	4365
1107	89	10	10	4224	0	4333
1108	42	4436	6	69	0	4553
1109	4499	59	8	44	0	4610
1110	4590	11	5	40	0	4646
1111	76	16	4749	25	0	4866
1112	4414	17	38	24	0	4493
1113	55	4575	13	9	0	4652
1114	21	35	10	4673	0	4739
1115	5216	15	7	76	0	5314
1116	54	10	4	5235	0	5303
1117	33	13	2	5263	0	5311
1118	21	5257	2	61	0	5341
1119	5263	41	0	36	0	5340
1120	5269	22	1	22	0	5314
1121	60	5194	3	13	0	5270
1122	31	5504	2	12	0	5549
1123	5488	49	10	14	0	5561
1124	5448	24	4	8	0	5484
1125	59	18	5274	10	0	5361
1126	35	8	4938	14	0	4995
1127	29	7	5322	11	0	5369
1128	11	7	57	5465	0	5540
1129	8	8	26	5552	0	5594
1130	15	8	5570	51	0	5644
1131	5319	10	43	35	0	5407
1132	5710	7	19	27	0	5763
1133	5760	7	14	12	0	5793
1134	5653	5	8	16	0	5682
1135	70	9	6124	11	0	6214
1136	6079	9	38	19	0	6145
1137	6160	12	31	19	0	6222
1138	6133	5	16	20	0	6174
1139	6247	8	12	17	0	6284
1140	6216	7	17	11	0	6251
1141	80	8	6330	14	0	6432
1142	42	6304	41	15	0	6402
1143	39	40	24	6233	0	6336
1144	26	17	16	6496	0	6555
1145	22	20	6459	57	0	6558
1146	5801	8	44	47	0	5900
1147	65	9	17	6294	0	6385
1148	40	6	6385	49	0	6480
1149	38	10	5940	33	0	6021
1150	26	6409	56	21	0	6512
1151	28	42	25	6574	0	6669
1152	32	18	21	6646	0	6717
1153	19	23	15	6510	0	6567
1154	6641	12	14	71	0	6738
1155	58	9	13	6602	0	6682
1156	26	8	6501	76	0	6611
1157	42	13	5783	46	0	5884
1158	35	11	6649	29	0	6724
1159	33	9	70	6793	0	6905
1160	7029	15	38	65	0	7147
1161	67	11	7072	22	0	7172
1162	6801	10	57	33	0	6901
1163	7856	3	32	57	0	7948
1164	78	9	28	7972	0	8087
1165	49	11	13	7996	0	8069
1166	41	7932	15	72	0	8060
1167	35	47	7975	38	0	8095
1168	7679	20	52	43	0	7794
1169	69	18	23	8194	0	8304
1170	38	8164	26	58	0	8286
1171	43	56	17	8284	0	8400
1172	36	21	8287	75	0	8419
1173	33	26	58	8002	0	8119
1174	26	8177	32	76	0	8311
1175	39	42	31	8131	0	8243
1176	8058	16	18	79	0	8171
1177	60	26	22	7849	0	7957
1178	35	7653	19	74	0	7781
1179	34	7883	23	34	0	7974
1180	7630	54	20	52	0	7756
1181	64	33	7904	30	0	8031
1182	35	31	62	7745	0	7873
1183	52	18	25	8031	0	8126
1184	32	13	8136	75	0	8256
1185	24	8068	61	49	0	8202
1186	26	43	8126	36	0	8231
1187	22	42	60	7883	0	8007
1188	19	8151	26	46	0	8242
1189	8339	31	30	50	0	8450
1190	43	8265	16	33	0	8357
1191	22	8420	15	19	0	8476
1192	8598	41	16	28	0	8683
1193	8710	28	15	45	0	8798
1194	8851	23	17	20	0	8911
1195	61	3	19	8862	0	8945
1196	33	6	8873	46	0	8958
1197	8500	11	51	37	0	8599
1198	9195	13	19	35	0	9262
1199	71	6	27	9522	0	9626
1200	37	10	9554	66	0	9667
1201	28	9406	62	27	0	9523
1202	9398	60	15	33	0	9506
1203	9735	22	22	46	0	9825
1204	70	9834	16	19	0	9939
1205	35	10093	7	21	0	10156
1206	10074	72	9	21	0	10176
1207	10019	30	7	27	0	10083
1208	9874	19	22	23	0	9938
1209	95	10	14	9805	0	9924
1210	47	6	9940	73	0	10066
1211	31	14	67	9492	0	9604
1212	20	9	9692	87	0	9808
1213	5	9415	87	38	0	9545
1214	15	9560	30	26	0	9631
1215	24	61	15	8824	0	8924
1216	15	12	7	9019	0	9053
1217	11	16	7	8801	0	8835
1218	7	9042	9	60	0	9118
1219	8963	57	8	22	0	9050
1220	8866	13	6	16	0	8901
1221	64	9119	4	19	0	9206
1222	26	66	5	8914	0	9011
1223	22	8910	5	52	0	8989
1224	26	61	6	8884	0	8977
1225	18	8935	10	62	0	9025
1226	8961	65	4	23	0	9053
1227	68	19	6	8841	0	8934
1228	20	12	8749	61	0	8842
1229	8379	12	55	32	0	8478
1230	8631	8	15	32	0	8686
1231	59	19	8626	16	0	8720
1232	24	22	55	8563	0	8664
1233	28	16	8725	68	0	8837
1234	21	15	63	8710	0	8809
1235	10	18	8294	84	0	8406
1236	7758	20	62	38	0	7878
1237	70	17	14	8160	0	8261
1238	27	8188	14	64	0	8293
1239	8491	71	13	26	0	8601
1240	77	32	6	8563	0	8678
1241	24	26	9	8490	0	8549
1242	31	20	8407	80	0	8538
1243	25	20	63	8649	0	8757
1244	22	27	8963	102	0	9114
1245	25	18	9075	41	0	9159
1246	24	14	110	9563	0	9711
1247	32	13	10334	98	0	10477
1248	9968	13	136	63	0	10180
1249	12013	17	44	37	0	12111
1250	12811	16	28	31	0	12886
1251	323	13693	19	31	0	14066
1252	123	263	20	13806	0	14212
1253	73	102	17	13418	0	13610
1254	40	14096	22	320	0	14478
1255	14046	279	21	128	0	14474
1256	297	117	15	14066	0	14495
1257	114	65	14237	312	0	14728
1258	83	41	13544	137	0	13805
1259	35	13596	344	106	0	14081
1260	13751	274	141	64	0	14230
1261	319	97	13665	55	0	14136
1262	12862	71	307	66	0	13306
1263	322	12659	149	62	0	13192
1264	135	276	12915	40	0	13366
1265	102	113	12291	45	0	12551
1266	77	61	13081	43	0	13262
1267	66	12689	403	45	0	13203
1268	78	297	12912	33	0	13320
1269	12612	108	350	56	0	13126
1270	313	82	164	12203	0	12762
1271	124	50	109	13162	0	13445
1272	76	54	56	13383	0	13569
1273	64	51	60	13452	0	13627
1274	75	34	13181	434	0	13724
1275	63	31	309	13160	0	13563
1276	71	33	132	13417	0	13653
1277	13040	40	103	423	0	13606
1278	13364	42	73	214	0	13693
1279	12471	64	90	141	0	12766
1280	416	45	12818	89	0	13368
1281	180	13117	306	96	0	13699
1282	109	13937	155	86	0	14287
1283	12925	427	97	79	0	13528
1284	328	13642	89	67	0	14126
1285	162	387	89	13480	0	14118
1286	99	175	84	13862	0	14220
1287	87	112	13515	439	0	14153
1288	74	13256	381	205	0	13916
1289	66	368	13031	127	0	13592
1290	12620	139	398	127	0	13284
1291	13472	90	163	114	0	13839
1292	460	62	144	13213	0	13879
1293	205	59	97	13173	0	13534
1294	117	57	106	13250	0	13530
1295	110	58	85	13303	0	13556
1296	100	48	12954	529	0	13631
1297	116	70	355	12819	0	13360
1298	75	54	12857	460	0	13446
1299	78	47	12276	245	0	12646
1300	68	12364	431	187	0	13050
1301	12427	337	212	137	0	13113
1302	340	12857	129	130	0	13456
1303	191	391	106	12414	0	13102
1304	99	156	13033	402	0	13690
1305	12474	105	425	216	0	13220
1306	406	76	12936	136	0	13554
1307	12915	77	442	103	0	13537
1308	13256	67	194	115	0	13632
1309	532	62	165	13283	0	14042
1310	269	72	112	13328	0	13781
1311	164	83	119	13599	0	13965
1312	138	79	12995	581	0	13793
1313	12544	86	432	286	0	13348
1314	461	12856	199	212	0	13728
1315	250	403	140	13010	0	13803
1316	13007	194	110	531	0	13842
1317	13342	119	142	260	0	13863
1318	13502	104	121	188	0	13915
1319	676	134	12703	171	0	13684
1320	13075	132	454	189	0	13850
1321	13364	162	203	210	0	13939
1322	640	132	11572	264	0	12608
1323	342	99	13475	212	0	14128
1324	228	136	614	13303	0	14281
1325	224	91	13656	524	0	14495
1326	164	12809	671	286	0	13930
1327	158	13703	411	156	0	14428
1328	13164	576	303	122	0	14165
1329	531	13689	208	135	0	14563
1330	332	524	221	13563	0	14640
1331	12945	246	216	522	0	13929
1332	543	13617	177	272	0	14609
1333	221	543	207	13534	0	14505
1334	179	229	254	13899	0	14561
1335	163	160	13386	705	0	14414
1336	187	113	595	13422	0	14317
1337	179	152	13369	653	0	14353
1338	198	75	13420	407	0	14100
1339	219	71	595	13080	0	13965
1340	150	70	289	13524	0	14033
1341	13081	66	178	813	0	14138
1342	527	14179	179	414	0	15299
1343	255	521	179	13939	0	14894
1344	224	368	158	14192	0	14942
1345	13336	145	98	779	0	14358
1346	624	12819	94	396	0	13933
1347	314	12225	98	224	0	12861
1348	200	11631	99	192	0	12122
1349	109	10482	87	127	0	10805
1350	8512	398	382	84	0	9376
1351	8453	150	61	80	0	8744
1352	8298	81	38	71	0	8488
1353	8348	66	45	69	0	8528
1354	385	69	32	8015	0	8501
1355	159	55	7888	299	0	8401
1356	107	7783	274	117	0	8281
1357	96	288	98	7743	0	8225
1358	87	107	7755	314	0	8263
1359	96	71	271	7752	0	8190
1360	78	62	122	7929	0	8191
1361	77	64	7652	387	0	8180
1362	65	66	288	7645	0	8064
1363	67	77	158	7204	0	7506
1364	7685	55	71	402	0	8213
1365	7630	65	55	184	0	7934
1366	7604	55	70	115	0	7844
1367	7637	48	50	127	0	7862
1368	397	50	69	7327	0	7843
1369	193	46	50	7444	0	7733
1370	138	68	49	7534	0	7789
1371	7234	51	49	447	0	7781
1372	354	49	51	7282	0	7736
1373	154	51	55	7454	0	7714
1374	140	53	6939	429	0	7561
1375	128	69	288	6795	0	7280
1376	121	6566	120	365	0	7172
1377	109	7153	59	191	0	7512
1378	6834	327	42	154	0	7357
1379	341	120	6763	127	0	7351
1380	164	6581	263	103	0	7111
1381	6318	255	136	110	0	6819
1382	292	96	63	6328	0	6779
1383	145	84	6278	308	0	6815
1384	100	102	247	6110	0	6559
1385	90	6386	112	296	0	6884
1386	6319	268	75	157	0	6819
1387	265	6500	60	171	0	6996
1388	6405	283	68	103	0	6859
1389	6656	111	50	108	0	6925
1390	346	96	35	6499	0	6976
1391	160	73	46	6378	0	6657
1392	123	6428	48	359	0	6958
1393	6514	265	51	163	0	6993
1394	314	123	6392	108	0	6937
1395	6333	76	225	112	0	6746
1396	6405	59	86	109	0	6659
1397	356	59	6062	103	0	6580
1398	144	80	234	5857	0	6315
1399	5916	58	101	300	0	6375
1400	294	52	5842	148	0	6336
1401	131	67	5680	119	0	5997
1402	5278	51	273	89	0	5691
1403	274	5228	109	94	0	5705
1404	122	5033	70	76	0	5301
1405	143	278	68	4794	0	5283
1406	93	125	4783	221	0	5222
1407	4596	85	200	119	0	5000
1408	248	43	4677	81	0	5049
1409	119	4408	194	66	0	4787
1410	4452	188	99	62	0	4801
1411	211	92	68	4410	0	4781
1412	4462	59	51	220	0	4792
1413	243	37	4349	117	0	4746
1414	113	50	188	4185	0	4536
1415	87	4383	101	185	0	4756
1416	89	186	76	4311	0	4662
1417	72	122	38	4505	0	4737
1418	82	88	4365	231	0	4766
1419	100	4174	185	132	0	4591
1420	94	4232	91	104	0	4521
1421	89	194	4076	81	0	4440
1422	3745	88	181	70	0	4084
1423	3924	58	79	75	0	4136
1424	227	36	75	3783	0	4121
1425	3622	37	54	176	0	3889
1426	188	3417	41	94	0	3740
1427	84	3630	60	67	0	3841
1428	3615	168	44	87	0	3914
1429	181	76	34	3643	0	3934
1430	3712	41	45	176	0	3974
1431	3808	35	29	124	0	3996
1432	198	44	45	3614	0	3901
1433	107	56	3569	162	0	3894
1434	3561	60	127	80	0	3828
1435	3669	34	81	55	0	3839
1436	229	54	44	3442	0	3769
1437	144	3478	35	149	0	3806
1438	75	135	45	3514	0	3769
1439	88	65	3442	165	0	3760
1440	83	48	3376	108	0	3615
1441	58	3357	163	90	0	3668
1442	100	110	66	1993	0	2269
1443	19	23	14	2053	0	2109
1444	19	13	2004	64	0	2100
1445	1905	8	50	27	0	1990
1446	2053	12	27	22	0	2114
1447	2010	8	12	20	0	2050
1448	2032	13	14	16	0	2075
1449	75	1950	14	11	0	2050
1450	33	2033	13	15	0	2094
1451	2124	66	12	15	0	2217
1452	76	24	8	2159	0	2267
1453	28	19	18	2189	0	2254
1454	24	2181	7	74	0	2286
1455	18	64	7	2209	0	2298
1456	20	22	14	2136	0	2192
1457	23	2123	12	82	0	2240
1458	28	68	2144	29	0	2269
1459	30	34	55	2161	0	2280
1460	2152	25	26	71	0	2274
1461	2187	18	16	34	0	2255
1462	91	18	2100	20	0	2229
1463	51	9	2045	23	0	2128
1464	27	20	2090	21	0	2158
1465	38	24	75	2033	0	2170
1466	18	15	2071	76	0	2180
1467	19	19	2030	42	0	2110
1468	23	37	78	1932	0	2070
1469	13	2076	31	82	0	2202
1470	23	59	2072	34	0	2188
1471	17	2092	70	23	0	2202
1472	2042	57	28	31	0	2158
1473	65	2087	20	28	0	2200
1474	37	61	30	2036	0	2164
1475	2055	20	25	58	0	2158
1476	60	16	25	2048	0	2149
1477	33	20	23	2098	0	2174
1478	37	8	2057	83	0	2185
1479	22	1887	66	43	0	2018
1480	24	2015	31	26	0	2096
1481	14	71	19	1960	0	2064
1482	15	20	26	1942	0	2003
1483	12	28	21	1889	0	1950
1484	23	17	1811	56	0	1907
1485	17	19	1683	30	0	1749
1486	1534	12	43	28	0	1617
1487	39	11	1600	16	0	1666
1488	24	2	1621	26	0	1673
1489	17	1543	43	20	0	1623
1490	5	49	29	1563	0	1646
1491	6	17	1565	35	0	1623
1492	7	15	39	1501	0	1562
1493	5	13	1595	46	0	1659
1494	6	9	42	1594	0	1651
1495	6	7	1692	54	0	1759
1496	9	7	44	1667	0	1727
1497	8	8	24	1676	0	1716
1498	10	1725	18	49	0	1802
1499	13	27	18	1755	0	1813
1500	6	1767	18	45	0	1836
1501	4	42	16	1812	0	1874
1502	4	19	13	1845	0	1881
1503	1772	16	13	53	0	1854
1504	36	10	11	1778	0	1835
1505	9	6	1772	55	0	1842
1506	7	8	43	1745	0	1803
1507	8	6	20	1785	0	1819
1508	9	3	1726	59	0	1797
1509	7	4	1698	39	0	1748
1510	10	12	48	1645	0	1715
1511	8	10	23	1720	0	1761
1512	8	14	1698	54	0	1774
1513	7	1620	46	30	0	1703
1514	5	1720	17	37	0	1779
1515	1686	44	11	29	0	1770
1516	41	18	16	1731	0	1806
1517	1794	12	20	60	0	1886
1518	1754	16	8	32	0	1810
1519	42	1780	13	31	0	1866
1520	1804	37	15	34	0	1890
1521	1824	16	18	26	0	1884
1522	50	14	1791	21	0	1876
1523	17	15	39	1781	0	1852
1524	17	10	1821	51	0	1899
1525	14	15	51	1814	0	1894
1526	10	15	1855	48	0	1928
1527	13	1757	43	26	0	1839
1528	10	1819	26	28	0	1883
1529	15	33	20	1780	0	1848
1530	1733	12	14	45	0	1804
1531	37	15	12	1693	0	1757
1532	18	19	13	1710	0	1760
1533	16	9	1721	49	0	1795
1534	14	5	1718	28	0	1765
1535	9	5	1747	28	0	1789
1536	7	5	57	1711	0	1780
1537	5	11	23	1725	0	1764
1538	8	1740	26	46	0	1820
1539	6	1833	17	20	0	1876
1540	1786	51	9	25	0	1871
1541	38	1827	8	24	0	1897
1542	12	45	1775	24	0	1856
1543	9	22	37	1792	0	1860
1544	14	8	1919	54	0	1995
1545	11	1925	49	24	0	2009
1546	7	56	27	1949	0	2039
1547	1928	8	18	48	0	2002
1548	32	10	1974	19	0	2035
1549	7	2017	35	24	0	2083
1550	5	37	2044	13	0	2099
1551	8	1949	38	12	0	2007
1552	12	57	13	1849	0	1931
1553	1912	7	8	35	0	1962
1554	1910	4	9	13	0	1936
1555	29	1884	11	6	0	1930
1556	1906	30	5	12	0	1953
1557	32	9	6	1906	0	1953
1558	1907	4	9	36	0	1956
1559	33	9	1901	13	0	1956
1560	11	7	1906	9	0	1933
1561	8	7	35	1823	0	1873
1562	5	11	14	1985	0	2015
1563	8	5	1968	41	0	2022
1564	6	4	36	1919	0	1965
1565	1962	9	13	34	0	2018
1566	1963	8	5	26	0	2002
1567	37	1917	12	23	0	1989
1568	21	1944	8	13	0	1986
1569	1871	36	9	16	0	1932
1570	35	12	8	1836	0	1891
1571	1812	5	16	37	0	1870
1572	30	1814	9	13	0	1866
1573	1831	30	9	17	0	1887
1574	39	7	1797	13	0	1856
1575	14	7	1765	14	0	1800
1576	13	17	38	1738	0	1806
1577	13	8	1801	30	0	1852
1578	7	8	34	1773	0	1822
1579	13	10	11	1678	0	1712
1580	9	4	1851	37	0	1901
1581	9	6	35	1852	0	1902
1582	8	6	9	1963	0	1986
1583	11	6	2060	50	0	2127
1584	14	4	2021	16	0	2055
1585	1976	6	53	16	0	2051
1586	48	11	2078	8	0	2145
1587	2195	9	48	9	0	2261
1588	2410	6	13	13	0	2442
1589	65	10	2443	2	0	2520
1590	22	5	2560	10	0	2597
1591	18	21	71	2463	0	2573
1592	18	3	23	2427	0	2471
1593	6	2440	22	62	0	2530
1594	11	2541	26	25	0	2603
1595	5	59	2454	26	0	2544
1596	2323	16	65	28	0	2432
1597	2452	9	26	17	0	2504
1598	68	16	2413	9	0	2506
1599	28	9	2416	10	0	2463
1600	18	11	69	2319	0	2417
1601	23	2424	31	44	0	2522
1602	21	53	19	2454	0	2547
1603	12	15	28	2491	0	2546
1604	2491	9	22	72	0	2594
1605	2501	12	13	34	0	2560
1606	78	12	4	2573	0	2667
1607	30	9	2568	66	0	2673
1608	2454	12	62	29	0	2557
1609	72	2617	32	11	0	2732
1610	2652	53	15	21	0	2741
1611	2639	17	18	17	0	2691
1612	70	2618	21	15	0	2724
1613	25	2729	18	13	0	2785
1614	24	69	11	2699	0	2803
1615	31	28	8	2709	0	2776
1616	17	2685	13	79	0	2794
1617	19	65	12	2663	0	2759
1618	23	22	15	2708	0	2768
1619	16	15	2656	86	0	2773
1620	2560	14	66	49	0	2689
1621	2719	10	34	28	0	2791
1622	2765	11	13	25	0	2814
1623	94	13	11	2696	0	2814
1624	2653	5	19	70	0	2747
1625	82	2621	17	24	0	2744
1626	42	60	11	2473	0	2586
1627	24	2512	14	61	0	2611
1628	24	2680	11	34	0	2749
1629	2666	71	4	26	0	2767
1630	2679	35	14	16	0	2744
1631	2679	19	10	18	0	2726
1632	2684	21	6	19	0	2730
1633	2689	13	18	16	0	2736
1634	99	17	2701	4	0	2821
1635	2696	17	54	24	0	2791
1636	90	9	2820	12	0	2931
1637	2696	9	65	18	0	2788
1638	2760	9	27	18	0	2814
1639	2720	15	20	22	0	2777
1640	85	7	2860	21	0	2973
1641	39	18	61	2725	0	2843
1642	40	2911	23	53	0	3027
1643	2963	57	15	19	0	3054
1644	2926	18	14	18	0	2976
1645	97	2920	14	13	0	3044
1646	3001	64	20	12	0	3097
1647	84	25	19	2891	0	3019
1648	43	2987	22	55	0	3107
1649	2972	62	9	25	0	3068
1650	3004	34	12	20	0	3070
1651	98	18	7	2959	0	3082
1652	3006	18	21	67	0	3112
1653	91	17	15	2995	0	3118
1654	42	15	22	3027	0	3106
1655	35	10	2978	92	0	3115
1656	44	22	62	2908	0	3036
1657	45	21	20	2986	0	3072
1658	40	12	3007	84	0	3143
1659	41	14	3007	34	0	3096
1660	33	17	68	3059	0	3177
1661	24	16	3079	83	0	3202
1662	2890	15	72	40	0	3017
1663	67	3197	29	32	0	3325
1664	34	65	14	3238	0	3351
1665	25	24	17	3326	0	3392
1666	32	13	17	3257	0	3319
1667	3315	19	10	80	0	3424
1668	3326	14	12	36	0	3388
1669	3365	15	12	31	0	3423
1670	87	3407	9	35	0	3538
1671	50	59	11	3461	0	3581
1672	36	24	8	3521	0	3589
1673	3497	16	11	80	0	3604
1674	3500	18	7	37	0	3562
1675	85	23	10	3480	0	3598
1676	43	21	3433	77	0	3574
1677	3384	18	58	39	0	3499
1678	3521	8	20	33	0	3582
1679	95	15	3577	31	0	3718
1680	3348	7	64	29	0	3448
1681	84	7	3603	24	0	3718
1682	3553	5	51	24	0	3633
1683	73	40	26	3635	0	3774
1684	49	3780	19	56	0	3904
1685	36	42	3882	30	0	3990
1686	31	3874	56	16	0	3977
1687	26	3588	20	14	0	3648
1688	3851	50	24	31	0	3956
1689	36	12	6	3815	0	3869
1690	13	2	3	3693	0	3711
1691	3930	2	1	50	0	3983
1692	26	5	3	3943	0	3977
1693	13	2	2	3885	0	3902
1694	5	4	2	3904	0	3915
1695	4	5	3	3877	0	3889
1696	9	3	3918	38	0	3968
1697	7	10	3735	19	0	3771
1698	7	3865	35	10	0	3917
1699	3982	29	11	13	0	4035
1700	32	15	0	4032	0	4079
1701	14	3993	8	30	0	4045
1702	15	34	2	4258	0	4309
1703	7	10	3	4303	0	4323
1704	17	3	4	4256	0	4280
1705	10	1	6	4337	0	4354
1706	9	4	6	4300	0	4319
1707	6	4257	4	44	0	4311
1708	9	26	3	4319	0	4357
1709	9	10	4227	36	0	4282
1710	4	4229	29	17	0	4279
1711	7	28	12	4287	0	4334
1712	9	11	0	4279	0	4299
1713	7	4190	3	45	0	4245
1714	6	4255	7	16	0	4284
1715	4244	35	2	17	0	4298
1716	23	4212	4	22	0	4261
1717	4215	23	3	15	0	4256
1718	4180	9	10	18	0	4217
1719	27	8	4429	14	0	4478
1720	15	8	21	4193	0	4237
1721	8	6	4511	33	0	4558
1722	5	4561	26	16	0	4608
1723	13	41	11	4127	0	4192
1724	6	13	5	4547	0	4571
1725	6	5	4	4641	0	4656
1726	5	8	3	4683	0	4699
1727	7	12	4764	35	0	4818
1728	10	5	26	4698	0	4739
1729	10	15	4809	32	0	4866
1730	13	9	4691	14	0	4727
1731	4497	4	26	33	0	4560
1732	4901	2	15	19	0	4937
1733	4930	2	9	22	0	4963
1734	29	4827	8	19	0	4883
1735	8	26	9	4931	0	4974
1736	9	13	5099	31	0	5152
1737	12	5	28	4984	0	5029
1738	9	3	5310	36	0	5358
1739	5197	4	26	32	0	5259
1740	5247	4	15	15	0	5281
1741	5248	4	5	17	0	5274
1742	36	5	5094	12	0	5147
1743	15	10	5037	9	0	5071
1744	14	13	42	5239	0	5308
1745	15	5	18	4912	0	4950
1746	16	5	4	5406	0	5431
1747	11	8	5377	35	0	5431
1748	12	8	4851	18	0	4889
1749	5170	5	38	16	0	5229
1750	30	0	13	5477	0	5520
1751	9	0	12	5455	0	5476
1752	5620	3	11	47	0	5681
1753	36	5	5	5641	0	5687
1754	5982	1	4	59	0	6046
1755	6132	4	7	26	0	6169
1756	6096	3	13	22	0	6134
1757	41	4	6266	13	0	6324
1758	15	6190	30	24	0	6259
1759	6468	30	10	34	0	6542
1760	41	8	12	6494	0	6555
1761	19	3	16	6441	0	6479
1762	16	6444	8	38	0	6506
1763	6440	32	6	17	0	6495
1764	6466	7	5	25	0	6503
1765	6540	6	4	19	0	6569
1766	46	6615	5	21	0	6687
1767	7003	38	4	38	0	7083
1768	7034	10	3	26	0	7073
1769	7038	5	9	15	0	7067
1770	60	5	8	6885	0	6958
1771	29	8	7	6942	0	6986
1772	20	8	7123	53	0	7204
1773	19	4	34	6914	0	6971
1774	17	4	10	6882	0	6913
1775	14	10	7149	39	0	7212
1776	6780	7	32	23	0	6842
1777	7232	3	8	20	0	7263
1778	57	15	7	7162	0	7241
1779	17	7039	6	38	0	7100
1780	14	7099	6	16	0	7135
1781	15	42	6	7060	0	7123
1782	20	13	6906	39	0	6978
1783	14	3	33	6606	0	6656
1784	6	5	6830	36	0	6877
1785	6	2	6726	12	0	6746
1786	10	3	27	6967	0	7007
1787	7084	4	4	35	0	7127
1788	6890	2	3	15	0	6910
1789	30	8	3	7059	0	7100
1790	14	1	5	6987	0	7007
1791	3	2	2	7093	0	7100
1792	7	3	3	6994	0	7007
1793	7126	3	3	36	0	7168
1794	7051	0	3	13	0	7067
1795	7019	1	3	15	0	7038
1796	30	5	7016	5	0	7056
1797	15	9	22	6902	0	6948
1798	11	1	2	7129	0	7143
1799	7069	2	1	33	0	7105
1800	25	6954	1	10	0	6990
1801	7008	24	3	13	0	7048
1802	6936	4	3	14	0	6957
1803	6914	1	6	12	0	6933
1804	6854	1	3	27	0	6885
1805	39	4	6954	7	0	7004
1806	18	4	6380	10	0	6412
1807	7128	3	27	21	0	7179
1808	7348	1	7	17	0	7373
1809	7310	2	2	12	0	7326
1810	7343	4	2	13	0	7362
1811	51	2	7831	7	0	7891
1812	9	8047	59	13	0	8128
1813	13	68	18	8593	0	8692
1814	9132	15	8	119	0	9274
1815	9308	10	5	34	0	9357
1816	9880	4	8	20	0	9912
1817	9994	11	7	27	0	10039
1818	10172	5	8	22	0	10207
1819	9758	4	2	23	0	9787
1820	208	12	8900	40	0	9160
1821	89	4	9334	12	0	9439
1822	77	11	142	9268	0	9498
1823	70	4	9559	124	0	9757
1824	54	9191	154	33	0	9432
1825	55	9335	47	34	0	9471
1826	52	143	45	9724	0	9964
1827	53	44	9966	141	0	10204
1828	40	45	9392	48	0	9525
1829	9403	25	182	47	0	9657
1830	10616	25	88	39	0	10768
1831	220	19	48	10747	0	11034
1832	10951	21	43	196	0	11211
1833	240	22	37	10878	0	11177
1834	90	14	38	10937	0	11079
1835	69	6	11035	260	0	11370
1836	60	9	10475	114	0	10658
1837	61	12	250	10535	0	10858
1838	47	19	10561	221	0	10848
1839	9899	14	230	119	0	10262
1840	10661	10	90	95	0	10856
1841	255	10706	80	57	0	11098
1842	10893	189	55	66	0	11203
1843	273	49	10672	38	0	11032
1844	10441	39	232	45	0	10757
1845	10881	15	95	39	0	11030
1846	11010	19	59	53	0	11141
1847	357	14	44	10484	0	10899
1848	160	10643	46	192	0	11041
1849	10854	204	49	68	0	11175
1850	10937	68	48	67	0	11120
1851	329	50	46	10885	0	11310
1852	10868	22	47	269	0	11206
1853	326	10929	40	108	0	11403
1854	153	232	28	10775	0	11188
1855	136	78	10457	266	0	10937
1856	9472	60	263	137	0	9932
1857	310	36	10390	85	0	10821
1858	151	42	281	10203	0	10677
1859	142	10068	101	272	0	10583
1860	113	11023	83	114	0	11333
1861	128	323	49	11009	0	11509
1862	111	10799	87	287	0	11284
1863	117	370	59	14898	0	15444
1864	106	121	77	15745	0	16049
1865	121	98	55	16046	0	16320
1866	15219	74	51	727	0	16071
1867	586	79	37	15242	0	15944
1868	211	70	14804	701	0	15786
1869	194	14838	500	270	0	15802
1870	14973	519	138	220	0	15850
1871	651	146	99	14943	0	15839
1872	258	109	84	15215	0	15666
1873	220	104	79	15429	0	15832
1874	169	100	14633	782	0	15684
1875	164	14666	540	330	0	15700
1876	14797	564	181	277	0	15819
1877	632	188	140	14080	0	15040
1878	212	14987	113	641	0	15953
1879	14948	595	118	296	0	15957
1880	619	226	14831	242	0	15918
1881	14716	161	609	197	0	15683
1882	685	161	15028	160	0	16034
1883	295	148	15141	160	0	15744
1884	239	14905	663	207	0	16014
1885	196	589	265	14436	0	15486
1886	184	178	14569	680	0	15611
1887	155	14036	685	291	0	15167
1888	153	587	298	13666	0	14704
1889	132	14057	235	616	0	15040
1890	147	624	14119	297	0	15187
1891	128	251	634	14024	0	15037
1892	137	208	14145	734	0	15224
1893	140	167	675	14109	0	15091
1894	137	142	277	14686	0	15242
1895	138	143	14100	822	0	15203
1896	153	145	685	14198	0	15181
1897	13514	105	296	807	0	14722
1898	594	13864	203	429	0	15090
1899	271	588	13874	377	0	15110
1900	13751	221	657	325	0	14954
1901	728	185	277	13081	0	14271
1902	328	13824	228	681	0	15061
1903	14066	633	236	346	0	15281
1904	14525	265	203	279	0	15272
1905	820	247	162	13688	0	14917
1906	378	178	171	14187	0	14914
1907	293	184	150	14256	0	14883
1908	240	173	160	13932	0	14505
1909	208	13337	180	955	0	14680
1910	253	845	184	12788	0	14070
1911	214	12569	133	823	0	13739
1912	176	12534	151	508	0	13369
1913	139	12447	163	392	0	13141
1914	170	726	11414	350	0	12660
1915	161	11830	570	369	0	12930
1916	10886	649	256	345	0	12136
1917	554	11041	186	381	0	12162
1918	256	613	217	9998	0	11084
1919	183	11113	186	688	0	12170
1920	236	656	171	10984	0	12047
1921	199	317	203	11468	0	12187
1922	193	274	10934	786	0	12187
1923	10580	298	547	446	0	11871
1924	11000	244	219	434	0	11897
1925	10923	224	220	397	0	11764
1926	647	10641	224	414	0	11926
1927	309	559	217	10574	0	11659
1928	263	271	10280	759	0	11573
1929	216	10207	579	456	0	11458
1930	275	662	250	8591	0	9778
1931	235	9500	225	546	0	10506
1932	9501	562	202	316	0	10581
1933	9735	297	196	248	0	10476
1934	9868	224	247	239	0	10578
1935	9845	194	250	219	0	10508
1936	645	214	228	9357	0	10444
1937	278	230	218	9362	0	10088
1938	255	9458	208	590	0	10511
1939	241	561	157	9656	0	10615
1940	191	261	9351	681	0	10484
1941	143	252	481	9392	0	10268
1942	130	225	9126	692	0	10173
1943	132	8982	516	453	0	10083
1944	118	521	9135	345	0	10119
1945	128	279	571	9118	0	10096
1946	113	204	9182	686	0	10185
1947	137	205	607	9099	0	10048
1948	143	213	269	9386	0	10011
1949	164	193	258	9368	0	9983
1950	176	232	211	9326	0	9945
1951	8838	206	183	690	0	9917
1952	510	8958	152	405	0	10025
1953	8711	519	162	348	0	9740
1954	526	282	8380	324	0	9512
1955	8486	211	391	344	0	9432
1956	8896	192	187	324	0	9599
1957	626	187	8405	320	0	9538
1958	439	157	8318	287	0	9201
1959	307	7946	436	319	0	9008
1960	224	7655	189	301	0	8369
1961	266	465	6996	297	0	8024
1962	179	6371	326	270	0	7146
1963	213	261	109	3136	0	3719
1964	2885	36	74	87	0	3082
1965	73	25	21	2859	0	2978
1966	2909	23	17	82	0	3031
1967	2906	24	11	39	0	2980
1968	69	2952	24	39	0	3084
1969	2960	69	12	27	0	3068
1970	2994	25	8	29	0	3056
1971	86	33	4	2944	0	3067
1972	2998	22	4	88	0	3112
1973	83	2980	7	37	0	3107
1974	36	59	4	3030	0	3129
1975	3013	27	9	76	0	3125
1976	80	24	2974	26	0	3104
1977	2931	12	48	31	0	3022
1978	70	22	15	3006	0	3113
1979	34	15	2997	52	0	3098
1980	25	18	2891	18	0	2952
1981	2803	18	68	28	0	2917
1982	2846	4	41	23	0	2914
1983	53	8	21	2780	0	2862
1984	34	3	6	2828	0	2871
1985	21	8	9	2820	0	2858
1986	12	2807	11	60	0	2890
1987	2823	42	13	25	0	2903
1988	56	2824	8	16	0	2904
1989	2845	54	5	13	0	2917
1990	58	10	2801	19	0	2888
1991	21	13	46	2825	0	2905
1992	2907	8	12	58	0	2985
1993	57	13	6	2885	0	2961
1994	29	9	9	2863	0	2910
1995	13	2786	6	60	0	2865
1996	2846	47	2	30	0	2925
1997	48	2942	13	21	0	3024
1998	13	58	9	2996	0	3076
1999	27	7	2964	56	0	3054
2000	2597	20	57	24	0	2698
2001	65	5	2865	28	0	2963
2002	2635	12	67	17	0	2731
2003	68	2904	10	18	0	3000
2004	15	66	14	2767	0	2862
2005	21	2861	5	76	0	2963
2006	2894	71	15	20	0	3000
2007	75	22	3	2911	0	3011
2008	25	11	14	2978	0	3028
2009	27	14	2857	68	0	2966
2010	2663	14	55	35	0	2767
2011	73	3	21	2909	0	3006
2012	21	13	2835	72	0	2941
2013	28	2827	66	22	0	2943
2014	21	59	13	2876	0	2969
2015	2857	16	14	81	0	2968
2016	69	20	10	2884	0	2983
2017	29	12	2895	84	0	3020
2018	3054	7	62	33	0	3156
2019	95	2	23	3092	0	3212
2020	27	9	3402	97	0	3535
2021	25	8	111	3415	0	3559
2022	28	6	28	3455	0	3517
2023	14	3481	23	133	0	3651
2024	3455	102	20	49	0	3626
2025	112	3480	9	34	0	3635
2026	3498	116	5	38	0	3657
2027	129	33	17	3389	0	3568
2028	43	3486	7	117	0	3653
2029	33	106	11	3477	0	3627
2030	20	40	3370	125	0	3555
2031	3201	27	101	44	0	3373
2032	111	24	30	3254	0	3419
2033	38	13	24	3271	0	3346
2034	40	9	8	3331	0	3388
2035	15	22	3113	161	0	3311
2036	27	12	3091	66	0	3196
2037	14	3144	131	47	0	3336
2038	14	107	41	2954	0	3116
2039	2940	26	24	116	0	3106
2040	107	2981	14	45	0	3147
2041	35	109	13	3113	0	3270
2042	3125	28	16	119	0	3288
2043	3153	20	9	49	0	3231
2044	129	3099	12	28	0	3268
2045	3274	108	10	25	0	3417
2046	3640	37	8	29	0	3714
2047	161	30	6	3680	0	3877
2048	55	3669	11	157	0	3892
2049	36	138	15	3800	0	3989
2050	3741	40	8	178	0	3967
2051	163	25	3754	62	0	4004
2052	63	25	142	3761	0	3991
2053	56	24	44	3881	0	4005
2054	34	22	3749	207	0	4012
2055	37	23	139	3789	0	3988
2056	3745	25	49	197	0	4016
2057	3597	25	39	95	0	3756
2058	168	27	39	3745	0	3979
2059	71	12	3691	194	0	3968
2060	56	18	3629	105	0	3808
2061	37	3519	177	94	0	3827
2062	30	3751	78	73	0	3932
2063	52	144	45	3570	0	3811
2064	3509	53	36	153	0	3751
2065	136	3544	33	77	0	3790
2066	3496	144	37	60	0	3737
2067	159	48	36	3512	0	3755
2068	55	41	27	3562	0	3685
2069	3359	51	24	181	0	3615
2070	157	3422	20	91	0	3690
2071	3472	141	16	60	0	3689
2072	178	66	3312	39	0	3595
2073	73	40	3346	52	0	3511
2074	68	27	165	3228	0	3488
2075	41	31	3293	174	0	3539
2076	46	27	3273	78	0	3424
2077	41	40	150	3087	0	3318
2078	59	31	3211	152	0	3453
2079	50	20	160	3129	0	3359
2080	38	20	82	3209	0	3349
2081	31	17	3209	199	0	3456
2082	19	22	161	3140	0	3342
2083	42	20	86	3089	0	3237
2084	25	3072	58	200	0	3355
2085	3091	127	49	90	0	3357
2086	142	47	3088	92	0	3369
2087	48	34	144	3111	0	3337
2088	40	19	82	3211	0	3352
2089	30	30	3078	207	0	3345
2090	2892	24	143	109	0	3168
2091	134	3034	59	86	0	3313
2092	71	130	47	3030	0	3278
2093	51	48	48	3099	0	3246
2094	34	3038	51	196	0	3319
2095	40	135	3020	113	0	3308
2096	34	3070	154	95	0	3353
2097	2999	133	68	63	0	3263
2098	136	71	2966	59	0	3232
2099	59	53	140	2941	0	3193
2100	47	25	2978	164	0	3214
2101	31	58	2963	97	0	3149
2102	41	2915	167	66	0	3189
2103	38	133	77	2786	0	3034
2104	2844	53	47	140	0	3084
2105	2883	36	65	65	0	3049
2106	131	2838	52	73	0	3094
2107	60	110	55	2900	0	3125
2108	2848	57	61	144	0	3110
2109	2963	46	45	78	0	3132
2110	145	2933	43	60	0	3181
2111	3028	114	32	69	0	3243
2112	152	48	33	2968	0	3201
2113	67	2995	35	136	0	3233
2114	56	122	39	3061	0	3278
2115	58	52	38	3128	0	3276
2116	64	70	27	3082	0	3243
2117	47	35	2971	177	0	3230
2118	58	38	2676	69	0	2841
2119	45	2751	115	60	0	2971
2120	2365	88	43	45	0	2541
2121	68	2369	24	55	0	2516
2122	35	59	29	2358	0	2481
2123	31	25	2427	93	0	2576
2124	17	31	78	2369	0	2495
2125	22	24	47	2421	0	2514
2126	17	23	27	2508	0	2575
2127	2435	31	23	87	0	2576
2128	72	30	18	2444	0	2564
2129	21	27	2657	92	0	2797
2130	2501	17	81	56	0	2655
2131	2586	17	43	56	0	2702
2132	2705	14	28	58	0	2805
2133	2705	16	22	64	0	2807
2134	2708	8	24	50	0	2790
2135	85	2636	27	40	0	2788
2136	36	61	25	2570	0	2692
2137	40	2623	25	65	0	2753
2138	2676	64	12	47	0	2799
2139	2666	20	14	43	0	2743
2140	2577	28	14	33	0	2652
2141	94	2456	13	20	0	2583
2142	43	2451	15	20	0	2529
2143	38	2488	11	26	0	2563
2144	49	72	2434	19	0	2574
2145	73	156	49	1994	0	2272
2146	21	1832	9	24	0	1886
2147	2	1757	1	7	0	1767
2148	6	11	9	1779	0	1805
2149	5	6	0	1786	0	1797
2150	5	3	1804	10	0	1822
2151	1715	1	6	9	0	1731
2152	12	1	1	1861	0	1875
2153	7	1	1	1867	0	1876
2154	3	3	1829	10	0	1845
2155	4	2	1699	12	0	1717
2156	3	1872	11	2	0	1888
2157	5	10	4	1906	0	1925
2158	4	4	2	1936	0	1946
2159	3	0	1905	10	0	1918
2160	1760	2	10	7	0	1779
2161	1893	3	4	4	0	1904
2162	13	4	1939	4	0	1960
2163	1858	1	9	10	0	1878
2164	12	1	1958	2	0	1973
2165	1929	2	10	0	0	1941
2166	1984	2	11	3	0	2000
2167	21	2	2029	2	0	2054
2168	7	0	9	1992	0	2008
2169	8	2	9	1916	0	1935
2170	6	1	1	2166	0	2174
2171	2164	2	1	18	0	2185
2172	2120	2	0	10	0	2132
2173	18	2	2217	2	0	2239
2174	10	1	2136	2	0	2149
2175	2252	2	22	11	0	2287
2176	2329	1	11	5	0	2346
2177	23	2	2267	4	0	2296
2178	9	1	2219	3	0	2232
2179	5	1	21	2294	0	2321
2180	6	3	2358	16	0	2383
2181	6	0	19	2243	0	2268
2182	2431	0	14	17	0	2462
2183	21	3	2611	13	0	2648
2184	2502	0	32	9	0	2543
2185	39	2	2972	4	0	3017
2186	15	1	40	2939	0	2995
2187	4	1	13	3112	0	3130
2188	5	0	5	3135	0	3145
2189	4	3148	3	52	0	3207
2190	10	42	7	2839	0	2898
2191	7	11	6	3189	0	3213
2192	3159	3	4	54	0	3220
2193	48	0	3116	15	0	3179
2194	2922	0	45	12	0	2979
2195	47	2	3106	4	0	3159
2196	2775	1	46	12	0	2834
2197	46	3091	14	6	0	3157
2198	16	38	3050	5	0	3109
2199	9	11	3023	10	0	3053
2200	15	9	59	2684	0	2767
2201	10	0	21	3080	0	3111
2202	10	1	3150	50	0	3211
2203	6	2	3042	20	0	3070
2204	8	1	3426	17	0	3452
2205	3596	4	51	13	0	3664
2206	3726	3	20	13	0	3762
2207	3734	4	7	12	0	3757
2208	63	0	7	3667	0	3737
2209	19	0	11	3701	0	3731
2210	12	1	3885	53	0	3951
2211	16	0	47	3702	0	3765
2212	22	3	31	3517	0	3573
2213	3903	4	9	67	0	3983
2214	3860	4	11	24	0	3899
2215	4000	3	11	17	0	4031
2216	61	2	9	3983	0	4055
2217	23	2	7	3993	0	4025
2218	10	4	10	4025	0	4049
2219	3976	0	12	63	0	4051
2220	55	3	15	3903	0	3976
2221	26	3932	12	39	0	4009
2222	22	40	12	3875	0	3949
2223	21	3854	10	42	0	3927
2224	3884	44	15	25	0	3968
2225	3776	13	14	21	0	3824
2226	52	3822	10	24	0	3908
2227	23	3937	18	21	0	3999
2228	17	50	17	3896	0	3980
2229	16	16	3757	49	0	3838
2230	18	5	49	3598	0	3670
2231	21	11	3774	52	0	3858
2232	20	3756	47	34	0	3857
2233	15	46	20	3823	0	3904
2234	15	14	13	3905	0	3947
2235	11	7	4060	71	0	4149
2236	21	6	51	3980	0	4058
2237	15	9	4124	65	0	4213
2238	4018	5	50	40	0	4113
2239	4181	9	25	22	0	4237
2240	4261	7	12	21	0	4301
2241	74	8	9	4182	0	4273
2242	32	7	13	4224	0	4276
2243	18	6	4286	79	0	4389
2244	18	10	50	4116	0	4194
2245	14	4146	28	67	0	4255
2246	18	39	4242	36	0	4335
2247	15	18	4160	30	0	4223
2248	23	14	59	3782	0	3878
2249	21	7	4235	75	0	4338
2250	21	11	4111	34	0	4177
2251	3900	13	61	35	0	4009
2252	55	4527	26	28	0	4636
2253	4730	48	14	48	0	4840
2254	4754	13	19	23	0	4809
2255	4794	9	25	21	0	4849
2256	68	6	17	4764	0	4855
2257	23	10	22	4834	0	4889
2258	18	10	4836	76	0	4940
2259	18	14	54	4682	0	4768
2260	15	4789	36	64	0	4904
2261	4892	48	28	34	0	5002
2262	54	4820	22	32	0	4928
2263	29	4922	21	21	0	4993
2264	23	51	32	4935	0	5041
2265	32	13	4984	63	0	5092
2266	29	10	61	4867	0	4967
2267	29	8	4899	64	0	5000
2268	27	4857	46	32	0	4962
2269	4897	42	26	44	0	5009
2270	4892	13	14	33	0	4952
2271	5006	7	18	46	0	5077
2272	63	9	5245	29	0	5346
2273	21	7	4874	40	0	4942
2274	5122	10	54	29	0	5215
2275	5368	4	17	32	0	5421
2276	5396	15	13	24	0	5448
2277	61	13	11	5334	0	5419
2278	21	5	8	5431	0	5465
2279	5422	13	16	62	0	5513
2280	5353	6	7	28	0	5394
2281	62	10	5509	22	0	5603
2282	21	10	5215	18	0	5264
2283	5036	9	30	21	0	5096
2284	35	4	5336	16	0	5391
2285	4858	4	17	16	0	4895
2286	24	2	5037	7	0	5070
2287	3	11	13	4817	0	4844
2288	5	3	5198	9	0	5215
2289	6	2	7	5127	0	5142
2290	5	1	5	5258	0	5269
2291	2	5331	2	11	0	5346
2292	5405	6	4	6	0	5421
2293	10	6	5472	4	0	5492
2294	5131	2	7	14	0	5154
2295	10	5584	1	5	0	5600
2296	5829	7	4	14	0	5854
2297	12	1	5	5768	0	5786
2298	6	0	5	5856	0	5867
2299	8	6083	3	14	0	6108
2300	9	10	3	6379	0	6401
2301	8	8	2	6333	0	6351
2302	3	5	3	6403	0	6414
2303	6275	2	2	44	0	6323
2304	5812	2	4	26	0	5844
2305	40	2	5748	18	0	5808
2306	19	5794	24	5	0	5842
2307	11	21	16	5952	0	6000
2308	11	10	8	6123	0	6152
2309	3	6	6174	48	0	6231
2310	15	3	35	5818	0	5871
2311	5995	3	14	46	0	6058
2312	5973	0	9	32	0	6014
2313	6073	5	11	19	0	6108
2314	61	4	2	6135	0	6202
2315	6393	2	3	69	0	6467
2316	6364	4	5	38	0	6411
2317	6495	1	8	20	0	6524
2318	61	1	5	6446	0	6513
2319	38	2	3	6494	0	6537
2320	25	3	4	6516	0	6548
2321	20	4	5	6311	0	6340
2322	12	5	4	6335	0	6356
2323	12	2	6361	67	0	6442
2324	15	2	6192	31	0	6240
2325	7	6193	49	22	0	6271
2326	8	37	20	6395	0	6460
2327	9	13	10	6417	0	6449
2328	15	7	7	6463	0	6492
2329	12	6	6378	68	0	6464
2330	11	4	41	6263	0	6319
2331	10	3	6348	57	0	6418
2332	6	5	45	6220	0	6276
2333	12	8	6631	54	0	6705
2334	4	6575	46	40	0	6665
2335	7	38	25	6535	0	6605
2336	11	17	6423	54	0	6505
2337	5575	10	49	59	0	5693
2338	43	6449	25	23	0	6540
2339	28	46	12	6586	0	6672
2340	9	6583	12	54	0	6658
2341	10	52	12	6565	0	6639
2342	6657	26	8	68	0	6759
2343	49	11	10	6614	0	6684
2344	29	6604	13	60	0	6706
2345	6613	49	8	33	0	6703
2346	57	25	6	6774	0	6862
2347	27	16	5	6859	0	6907
2348	6999	9	6	104	0	7118
2349	89	6	5	7543	0	7643
2350	50	6	2	9451	0	9509
2351	21	10	9723	305	0	10059
2352	23	9	9533	107	0	9672
2353	23	4	353	9472	0	9852
2354	18	5	9611	313	0	9947
2355	13	5	9449	125	0	9592
2356	8825	4	396	88	0	9313
2357	300	3	9608	48	0	9959
2358	97	9544	341	51	0	10033
2359	71	268	122	9543	0	10004
2360	9777	87	87	314	0	10265
2361	10014	43	51	125	0	10233
2362	10035	27	46	80	0	10188
2363	416	9856	40	62	0	10374
2364	158	289	44	9829	0	10320
2365	81	95	48	10180	0	10404
2366	9203	71	71	419	0	9764
2367	9972	33	49	186	0	10240
2368	10082	25	50	124	0	10281
2369	440	27	9903	71	0	10441
2370	201	9631	344	79	0	10255
2371	127	11139	137	55	0	11458
2372	76	460	106	10716	0	11358
2373	76	188	56	11421	0	11741
2374	78	86	11202	582	0	11948
2375	10864	57	448	235	0	11604
2376	11599	47	170	138	0	11954
2377	594	63	90	11233	0	11980
2378	262	60	60	11557	0	11939
2379	160	29	51	11762	0	12002
2380	11334	26	37	663	0	12060
2381	541	36	10909	281	0	11767
2382	267	37	11094	188	0	11586
2383	150	39	566	10877	0	11632
2384	98	53	10969	512	0	11632
2385	10550	56	500	275	0	11381
2386	10875	35	242	187	0	11339
2387	11217	22	148	155	0	11542
2388	666	10470	119	129	0	11384
2389	10692	419	112	101	0	11324
2390	604	175	82	10438	0	11299
2391	291	105	66	10720	0	11182
2392	180	48	77	10952	0	11257
2393	141	46	10248	746	0	11181
2394	147	51	479	10056	0	10733
2395	145	10067	235	565	0	11012
2396	9869	422	182	315	0	10788
2397	475	10146	123	259	0	11003
2398	247	481	9878	196	0	10802
2399	208	9902	501	151	0	10762
2400	9520	510	208	134	0	10372
2401	529	9610	153	131	0	10423
2402	281	514	122	8503	0	9420
2403	167	9609	114	451	0	10341
2404	9522	500	94	255	0	10371
2405	9805	212	94	209	0	10320
2406	9101	145	118	195	0	9559
2407	666	114	9404	152	0	10336
2408	310	100	9496	144	0	10050
2409	245	124	9445	140	0	9954
2410	9301	98	655	146	0	10200
2411	570	122	317	9161	0	10170
2412	300	113	199	9539	0	10151
2413	221	112	9086	602	0	10021
2414	198	117	492	9193	0	10000
2415	8657	129	230	590	0	9606
2416	546	8780	145	355	0	9826
2417	9011	488	138	247	0	9884
2418	634	224	8793	166	0	9817
2419	9016	163	483	153	0	9815
2420	9343	116	249	157	0	9865
2421	9411	128	177	148	0	9864
2422	751	93	8827	133	0	9804
2423	411	95	519	8783	0	9808
2424	337	78	8895	505	0	9815
2425	284	83	533	8961	0	9861
2426	235	94	8994	578	0	9901
2427	205	90	568	8964	0	9827
2428	177	115	303	9334	0	9929
2429	9010	65	188	718	0	9981
2430	9232	81	159	356	0	9828
2431	9459	68	160	252	0	9939
2432	758	62	153	8694	0	9667
2433	418	7862	155	515	0	8950
2434	307	8769	123	294	0	9493
2435	8710	515	111	239	0	9575
2436	571	255	8504	185	0	9515
2437	8598	150	491	189	0	9428
2438	607	114	8480	192	0	9393
2439	8758	97	562	175	0	9592
2440	8382	96	283	190	0	8951
2441	687	85	8685	170	0	9627
2442	8857	63	513	184	0	9617
2443	9044	83	239	172	0	9538
2444	9169	72	191	129	0	9561
2445	790	8760	125	153	0	9828
2446	424	493	161	8631	0	9709
2447	291	203	8609	506	0	9609
2448	255	135	8692	281	0	9363
2449	238	7871	508	188	0	8805
2450	138	6226	203	109	0	6676
2451	203	215	180	5559	0	6157
2452	5452	90	88	239	0	5869
2453	256	5557	86	121	0	6020
2454	174	200	55	5475	0	5904
2455	158	5644	62	179	0	6043
2456	5619	201	52	118	0	5990
2457	264	147	39	5491	0	5941
2458	172	80	5440	212	0	5904
2459	110	5244	185	138	0	5677
2460	106	5372	129	93	0	5700
2461	98	249	90	4902	0	5339
2462	97	5240	72	164	0	5573
2463	76	223	71	5165	0	5535
2464	5126	132	46	205	0	5509
2465	5152	99	51	121	0	5423
2466	5416	66	49	86	0	5617
2467	5456	68	47	71	0	5642
2468	298	53	5219	66	0	5636
2469	180	5007	155	56	0	5398
2470	114	5062	97	44	0	5317
2471	53	4191	17	27	0	4288
2472	45	4040	26	5	0	4116
2473	3881	63	44	22	0	4010
2474	3842	24	11	7	0	3884
2475	3933	8	3	15	0	3959
2476	3935	7	5	8	0	3955
2477	74	10	3921	3	0	4008
2478	4082	3	52	19	0	4156
2479	4258	6	16	4	0	4284
2480	4313	6	8	9	0	4336
2481	80	4	1	4223	0	4308
2482	27	11	7	4267	0	4312
2483	4297	4	3	65	0	4369
2484	63	5	5	4255	0	4328
2485	34	4218	1	52	0	4305
2486	19	53	3	4329	0	4404
2487	14	18	4	4326	0	4362
2488	14	4336	8	66	0	4424
2489	12	50	8	4387	0	4457
2490	23	20	5	4387	0	4435
2491	4332	8	5	75	0	4420
2492	59	11	4182	31	0	4283
2493	4120	12	48	18	0	4198
2494	65	5	4210	22	0	4302
2495	38	11	4037	11	0	4097
2496	22	10	4184	15	0	4231
2497	4105	7	71	18	0	4201
2498	60	15	4398	10	0	4483
2499	4298	10	60	20	0	4388
2500	4464	13	22	22	0	4521
2501	4497	5	20	12	0	4534
2502	66	4467	10	12	0	4555
2503	4513	47	6	7	0	4573
2504	60	4596	9	10	0	4675
2505	32	54	13	4634	0	4733
2506	21	28	9	4638	0	4696
2507	27	4573	8	60	0	4668
2508	24	4583	12	24	0	4643
2509	24	4731	7	13	0	4775
2510	4637	59	5	17	0	4718
2511	57	4764	11	16	0	4848
2512	4762	53	4	16	0	4835
2513	69	32	4649	6	0	4756
2514	4642	24	42	11	0	4719
2515	4790	14	22	15	0	4841
2516	73	16	4674	8	0	4771
2517	43	12	44	4615	0	4714
2518	21	11	4711	54	0	4797
2519	26	13	49	4629	0	4717
2520	23	16	26	4659	0	4724
2521	4726	10	12	73	0	4821
2522	4728	8	8	35	0	4779
2523	76	4703	14	11	0	4804
2524	4769	52	12	28	0	4861
2525	80	25	4734	14	0	4853
2526	4636	9	63	20	0	4728
2527	84	10	4844	20	0	4958
2528	50	16	4800	12	0	4878
2529	4931	9	74	23	0	5037
2530	5069	17	38	22	0	5146
2531	94	10	5151	18	0	5273
2532	42	10	69	4827	0	4948
2533	30	14	30	5171	0	5245
2534	36	9	5106	85	0	5236
2535	28	15	71	4920	0	5034
2536	33	4754	33	61	0	4881
2537	28	66	23	5163	0	5280
2538	36	26	25	5091	0	5178
2539	34	22	4887	80	0	5023
2540	4453	13	66	42	0	4574
2541	4816	6	53	19	0	4894
2542	4847	9	22	19	0	4897
2543	4784	11	16	16	0	4827
2544	113	4675	26	10	0	4824
2545	52	56	19	4552	0	4679
2546	43	25	4465	79	0	4612
2547	32	20	4444	36	0	4532
2548	29	14	82	4291	0	4416
2549	27	21	4450	77	0	4575
2550	4229	12	61	43	0	4345
2551	65	15	28	4400	0	4508
2552	40	11	22	4392	0	4465
2553	32	13	17	4404	0	4466
2554	4320	8	18	99	0	4445
2555	76	4304	18	45	0	4443
2556	4288	58	22	21	0	4389
2557	4333	29	10	24	0	4396
2558	91	4162	21	24	0	4298
2559	50	4260	26	19	0	4355
2560	4359	71	36	18	0	4484
2561	87	28	22	4335	0	4472
2562	44	20	31	4282	0	4377
2563	4461	9	25	83	0	4578
2564	90	9	4359	44	0	4502
2565	4277	14	65	37	0	4393
2566	4425	11	34	29	0	4499
2567	105	4541	20	19	0	4685
2568	4902	74	19	18	0	5013
2569	4835	40	11	29	0	4915
2570	132	5436	12	16	0	5596
2571	51	5680	11	12	0	5754
2572	45	142	15	5471	0	5673
2573	5608	61	10	112	0	5791
2574	128	5799	5	47	0	5979
2575	48	129	4	5919	0	6100
2576	6002	41	11	138	0	6192
2577	146	28	5875	50	0	6099
2578	69	18	124	5750	0	5961
2579	43	18	5810	142	0	6013
2580	5536	18	142	59	0	5755
2581	5874	15	57	45	0	5991
2582	201	8	5781	23	0	6013
2583	91	5725	149	15	0	5980
2584	57	140	50	5775	0	6022
2585	30	67	5853	139	0	6089
2586	31	36	146	5814	0	6027
2587	31	25	56	5985	0	6097
2588	23	19	5887	199	0	6128
2589	5611	22	148	99	0	5880
2590	5935	5	64	65	0	6069
2591	200	14	5907	36	0	6157
2592	84	5876	163	34	0	6157
2593	67	148	62	5631	0	5908
2594	47	5731	53	136	0	5967
2595	41	5926	37	68	0	6072
2596	5858	195	28	43	0	6124
2597	162	75	30	5880	0	6147
2598	68	51	25	5899	0	6043
2599	52	19	5777	221	0	6069
2600	37	23	5719	97	0	5876
2601	29	22	197	5623	0	5871
2602	43	18	81	5790	0	5932
2603	44	24	5679	203	0	5950
2604	35	25	5681	97	0	5838
2605	39	22	212	5568	0	5841
2606	5596	22	101	190	0	5909
2607	154	5672	51	86	0	5963
2608	5620	176	34	71	0	5901
2609	195	5589	37	36	0	5857
2610	93	5779	25	40	0	5937
2611	5568	196	27	56	0	5847
2612	186	89	5603	44	0	5922
2613	78	50	182	5537	0	5847
2614	66	30	80	5660	0	5836
2615	43	31	63	6080	0	6217
2616	37	37	5920	276	0	6270
2617	43	21	206	5981	0	6251
2618	6097	33	95	230	0	6455
2619	212	32	60	6265	0	6569
2620	103	29	41	6617	0	6790
2621	6489	36	35	292	0	6852
2622	6494	34	37	133	0	6698
2623	266	6360	32	95	0	6753
2624	114	218	6449	52	0	6833
2625	100	84	6354	49	0	6587
2626	75	42	6423	56	0	6596
2627	38	6132	285	69	0	6524
2628	56	204	140	5913	0	6313
2629	44	74	66	6194	0	6378
2630	6044	45	63	268	0	6420
2631	204	38	48	6044	0	6334
2632	104	23	5985	262	0	6374
2633	74	33	216	6021	0	6344
2634	52	28	87	6177	0	6344
2635	65	34	5929	302	0	6330
2636	59	5870	222	126	0	6277
2637	63	201	81	5370	0	5715
2638	38	5933	85	211	0	6267
2639	41	236	5948	93	0	6318
2640	5867	90	241	78	0	6276
2641	6044	64	110	73	0	6291
2642	6114	47	67	88	0	6316
2643	288	41	55	5821	0	6205
2644	134	5915	63	226	0	6338
2645	5897	208	52	126	0	6283
2646	6083	86	52	111	0	6332
2647	6092	54	60	84	0	6290
2648	297	44	5880	79	0	6300
2649	5766	36	222	83	0	6107
2650	251	5856	93	68	0	6268
2651	5778	210	68	74	0	6130
2652	241	5902	65	56	0	6264
2653	5918	235	56	71	0	6280
2654	256	93	5887	65	0	6301
2655	5895	51	223	64	0	6233
2656	6093	53	86	62	0	6294
2657	4975	58	77	98	0	5208
2658	6146	61	50	66	0	6323
2659	331	51	5869	51	0	6302
2660	149	40	199	5813	0	6201
2661	5828	26	101	218	0	6173
2662	253	5781	65	107	0	6206
2663	127	192	66	5691	0	6076
2664	102	79	5630	225	0	6036
2665	91	108	207	5611	0	6017
2666	84	51	5600	229	0	5964
2667	84	5277	211	108	0	5680
2668	60	4921	96	78	0	5155
2669	69	5016	61	61	0	5207
2670	77	210	41	4216	0	4544
2671	74	54	27	4187	0	4342
2672	50	35	4034	149	0	4268
2673	54	3796	100	60	0	4010
2674	3483	105	48	50	0	3686
2675	110	3347	30	30	0	3517
2676	43	3400	28	19	0	3490
2677	69	119	25	3267	0	3480
2678	3243	37	31	111	0	3422
2679	3321	22	28	41	0	3412
2680	114	20	28	3247	0	3409
2681	3227	25	17	111	0	3380
2682	115	19	20	3217	0	3371
2683	47	32	3152	108	0	3339
2684	3136	25	91	52	0	3304
2685	104	34	35	3109	0	3282
2686	39	14	3021	103	0	3177
2687	37	23	3002	38	0	3100
2688	39	26	102	2964	0	3131
2689	3030	34	34	100	0	3198
2690	3051	24	28	37	0	3140
2691	93	3091	20	32	0	3236
2692	3178	82	16	35	0	3311
2693	3196	38	12	25	0	3271
2694	3232	29	13	25	0	3299
2695	117	3219	25	25	0	3386
2696	3265	76	12	32	0	3385
2697	3307	30	14	29	0	3380
2698	119	19	17	3225	0	3380
2699	3181	24	17	78	0	3300
2700	109	3070	14	37	0	3230
2701	46	3198	27	20	0	3291
2702	43	82	18	3190	0	3333
2703	36	34	19	3225	0	3314
2704	37	3253	13	93	0	3396
2705	3253	74	20	32	0	3379
2706	89	3179	13	22	0	3303
2707	3131	76	7	16	0	3230
2708	88	3219	15	14	0	3336
2709	42	73	16	3155	0	3286
2710	40	3382	6	61	0	3489
2711	3392	77	20	26	0	3515
2712	3376	29	22	21	0	3448
2713	3346	18	25	22	0	3411
2714	90	16	3193	19	0	3318
2715	36	11	3002	12	0	3061
2716	23	2986	56	6	0	3071
2717	14	57	2914	11	0	2996
2718	19	13	2780	7	0	2819
2719	27	44	45	2331	0	2447
2720	6	5	2492	29	0	2532
2721	5	2463	23	8	0	2499
2722	2458	24	3	8	0	2493
2723	24	2431	4	4	0	2463
2724	6	2472	5	4	0	2487
2725	2565	27	10	13	0	2615
2726	2579	7	5	10	0	2601
2727	24	2631	3	4	0	2662
2728	2658	24	5	3	0	2690
2729	2660	8	5	6	0	2679
2730	2653	5	2	11	0	2671
2731	36	3	2558	2	0	2599
2732	8	7	2506	3	0	2524
2733	5	11	26	2541	0	2583
2734	10	4	7	2550	0	2571
2735	2657	6	2	32	0	2697
2736	25	2609	4	8	0	2646
2737	8	32	3	2658	0	2701
2738	7	10	3	2669	0	2689
2739	8	5	3	2684	0	2700
2740	5	2	2	2659	0	2668
2741	7	3	2665	27	0	2702
2742	2	4	2578	12	0	2596
2743	6	1	30	2728	0	2765
2744	7	2	2783	26	0	2818
2745	2631	3	30	13	0	2677
2746	31	2	9	2802	0	2844
2747	9	2	2780	33	0	2824
2748	2498	1	31	22	0	2552
2749	32	2737	7	6	0	2782
2750	2763	25	4	5	0	2797
2751	30	2894	3	9	0	2936
2752	13	29	3	2899	0	2944
2753	4	7	2931	27	0	2969
2754	12	2	26	2779	0	2819
2755	3	5	2779	32	0	2819
2756	2737	2	29	13	0	2781
2757	30	3	9	2840	0	2882
2758	2861	2	7	39	0	2909
2759	35	2	2871	8	0	2916
2760	2873	6	25	12	0	2916
2761	3132	5	14	8	0	3159
2762	49	3	3175	3	0	3230
2763	17	3	34	3151	0	3205
2764	8	3	3243	38	0	3292
2765	12	3249	34	12	0	3307
2766	3257	37	19	13	0	3326
2767	3247	10	6	6	0	3269
2768	44	5	3279	5	0	3333
2769	16	4	3212	8	0	3240
2770	11	2	46	3176	0	3235
2771	12	4	13	3269	0	3298
2772	3338	0	9	40	0	3387
2773	36	3327	10	11	0	3384
2774	3415	30	8	14	0	3467
2775	3397	10	6	9	0	3422
2776	43	4	3334	5	0	3386
2777	3160	4	32	8	0	3204
2778	42	2	3340	2	0	3386
2779	23	5	34	3367	0	3429
2780	12	2	3561	34	0	3609
2781	16	2	34	3496	0	3548
2782	13	5	3552	31	0	3601
2783	3403	3	33	13	0	3452
2784	3560	2	20	6	0	3588
2785	40	3	11	3548	0	3602
2786	3641	2	16	36	0	3695
2787	37	2	12	3712	0	3763
2788	17	3774	9	35	0	3835
2789	3790	25	10	18	0	3843
2790	35	3787	9	9	0	3840
2791	19	38	5	3773	0	3835
2792	20	9	3	3716	0	3748
2793	12	3	10	3683	0	3708
2794	14	6	7	3636	0	3663
2795	14	5	3549	43	0	3611
2796	3190	5	29	40	0	3264
2797	3497	2	13	16	0	3528
2798	38	3544	7	15	0	3604
2799	15	31	9	3594	0	3649
2800	18	11	5	3635	0	3669
2801	16	5	3550	45	0	3616
2802	3358	5	31	22	0	3416
2803	37	4	15	3589	0	3645
2804	16	6	3546	40	0	3608
2805	3500	5	30	33	0	3568
2806	3614	6	14	16	0	3650
2807	3627	8	8	13	0	3656
2808	47	3	3473	14	0	3537
2809	23	2	3231	15	0	3271
2810	3279	3	32	15	0	3329
2811	35	2	17	3379	0	3433
2812	18	5	17	3411	0	3451
2813	16	1	3428	37	0	3482
2814	3230	2	28	24	0	3284
2815	37	5	13	3456	0	3511
2816	3550	2	10	54	0	3616
2817	3554	0	6	27	0	3587
2818	3561	1	12	10	0	3584
2819	48	4	3625	11	0	3688
2820	27	1	37	3587	0	3652
2821	3669	2	19	60	0	3750
2822	62	3787	7	15	0	3871
2823	47	37	6	3885	0	3975
2824	35	14	4	3878	0	3931
2825	3789	1	27	57	0	3874
2826	3792	5	9	38	0	3844
2827	77	5	6	3745	0	3833
2828	27	19	3717	53	0	3816
2829	3568	2	41	44	0	3655
2830	57	6	3749	29	0	3841
2831	3771	3	39	16	0	3829
2832	3836	3	17	15	0	3871
2833	67	4	3825	30	0	3926
2834	27	4	64	3800	0	3895
2835	38	1	4037	52	0	4128
2836	18	4314	66	23	0	4421
2837	34	64	24	4236	0	4358
2838	29	4414	11	70	0	4524
2839	17	70	29	4547	0	4663
2840	16	20	4651	85	0	4772
2841	13	4582	99	35	0	4729
2842	10	4817	26	12	0	4865
2843	27	116	2	4837	0	4982
2844	4855	42	10	95	0	5002
2845	95	6	9	5357	0	5467
2846	5499	8	21	118	0	5646
2847	127	5631	8	33	0	5799
2848	6189	154	8	20	0	6371
2849	169	31	6419	30	0	6649
2850	65	12	155	6269	0	6501
2851	18	13	39	6337	0	6407
2852	35	7	6280	195	0	6517
2853	5970	29	167	54	0	6220
2854	6338	10	40	26	0	6414
2855	198	6235	32	20	0	6485
2856	53	175	16	5814	0	6058
2857	31	6188	15	156	0	6390
2858	27	159	6111	40	0	6337
2859	43	51	6217	23	0	6334
2860	51	80	184	5949	0	6264
2861	5963	35	46	161	0	6205
2862	160	5840	18	67	0	6085
2863	5891	174	21	21	0	6107
2864	166	44	5798	19	0	6027
2865	5775	10	188	31	0	6004
2866	6029	23	39	39	0	6130
2867	224	19	5844	25	0	6112
2868	62	35	171	5774	0	6042
2869	5918	22	42	175	0	6157
2870	6017	8	45	44	0	6114
2871	6033	19	29	23	0	6104
2872	231	11	17	5818	0	6077
2873	66	14	5752	174	0	6006
2874	5637	10	173	74	0	5894
2875	227	8	5835	24	0	6094
2876	100	9	182	5671	0	5962
2877	77	16	47	5707	0	5847
2878	45	5823	31	196	0	6095
2879	44	171	5803	53	0	6071
2880	54	5514	187	35	0	5790
2881	36	5792	70	44	0	5942
2882	36	199	42	5668	0	5945
2883	44	57	5654	206	0	5961
2884	44	53	176	5642	0	5915
2885	41	35	5734	191	0	6001
2886	36	43	188	5575	0	5842
2887	46	43	60	5673	0	5822
2888	34	38	5391	240	0	5703
2889	39	21	223	5325	0	5608
2890	35	28	5383	232	0	5678
2891	35	19	5360	85	0	5499
2892	43	5316	222	72	0	5653
2893	5338	183	77	80	0	5678
2894	202	55	5366	45	0	5668
2895	5180	35	204	65	0	5484
2896	219	33	93	5377	0	5722
2897	72	29	5394	199	0	5694
2898	47	5328	190	89	0	5654
2899	67	187	81	5309	0	5644
2900	45	52	5380	205	0	5682
2901	62	31	209	5028	0	5330
2902	51	5310	76	198	0	5635
2903	5349	198	73	79	0	5699
2904	213	84	51	5345	0	5693
2905	5266	35	56	235	0	5592
2906	5403	38	73	80	0	5594
2907	5427	33	49	78	0	5587
2908	5455	55	56	61	0	5627
2909	5381	37	47	60	0	5525
2910	246	5168	46	83	0	5543
2911	121	180	46	5183	0	5530
2912	90	53	44	5313	0	5500
2913	94	38	48	5323	0	5503
2914	90	38	5080	236	0	5444
2915	79	5022	191	106	0	5398
2916	5239	184	89	65	0	5577
2917	5341	55	49	76	0	5521
2918	248	5165	57	71	0	5541
2919	101	5322	49	68	0	5540
2920	5220	219	56	68	0	5563
2921	237	88	5129	44	0	5498
2922	105	101	196	4892	0	5294
2923	4935	42	86	211	0	5274
2924	216	51	59	4805	0	5131
2925	84	4851	53	215	0	5203
2926	64	183	58	4927	0	5232
2927	54	63	4920	229	0	5266
2928	4768	47	205	106	0	5126
2929	5076	41	79	69	0	5265
2930	240	33	56	4873	0	5202
2931	109	38	51	4991	0	5189
2932	4761	32	45	235	0	5073
2933	222	4702	58	90	0	5072
2934	111	166	33	4678	0	4988
2935	100	56	42	4768	0	4966
2936	4252	28	40	209	0	4529
2937	176	4275	29	112	0	4592
2938	4219	147	32	70	0	4468
2939	201	4070	27	63	0	4361
2940	86	4207	28	48	0	4369
2941	4017	189	32	52	0	4290
2942	180	4080	38	51	0	4349
2943	89	224	42	3922	0	4277
2944	54	60	3939	164	0	4217
2945	41	34	3426	63	0	3564
2946	28	28	3242	37	0	3335
2947	18	3094	159	34	0	3305
2948	2463	94	102	6	0	2665
2949	69	31	31	2289	0	2420
2950	30	15	17	2347	0	2409
2951	22	14	2276	85	0	2397
2952	2256	9	62	50	0	2377
2953	74	1	27	2367	0	2469
2954	26	3	20	2399	0	2448
2955	14	8	14	2388	0	2424
2956	2291	3	10	107	0	2411
2957	75	4	2220	49	0	2348
2958	2240	6	63	35	0	2344
2959	86	5	24	2261	0	2376
2960	44	8	2246	74	0	2372
2961	2192	11	72	32	0	2307
2962	87	5	2296	20	0	2408
2963	43	12	81	2243	0	2379
2964	23	13	2304	78	0	2418
2965	24	4	2239	36	0	2303
2966	2124	9	97	20	0	2250
2967	66	5	2192	22	0	2285
2968	39	9	86	2111	0	2245
2969	2118	8	43	69	0	2238
2970	78	6	29	2159	0	2272
2971	38	8	2144	80	0	2270
2972	19	8	2186	42	0	2255
2973	18	2178	88	33	0	2317
2974	22	58	42	2127	0	2249
2975	2078	27	36	67	0	2208
2976	63	2060	21	43	0	2187
2977	2097	66	13	28	0	2204
2978	69	37	10	2058	0	2174
2979	2064	13	8	75	0	2160
2980	73	2021	8	43	0	2145
2981	41	61	16	2009	0	2127
2982	2022	31	10	69	0	2132
2983	73	2015	5	46	0	2139
2984	40	68	10	2010	0	2128
2985	29	36	8	2044	0	2117
2986	2041	21	16	88	0	2166
2987	68	15	16	2052	0	2151
2988	42	10	15	2085	0	2152
2989	24	7	19	2135	0	2185
2990	27	11	2017	104	0	2159
2991	1972	5	69	60	0	2106
2992	67	8	42	2369	0	2486
2993	39	8	2470	107	0	2624
2994	2391	11	107	52	0	2561
2995	108	5	2555	33	0	2701
2996	51	10	114	2432	0	2607
2997	29	2505	49	104	0	2687
2998	25	86	30	2592	0	2733
2999	29	30	2571	119	0	2749
3000	18	18	2672	56	0	2764
3001	26	13	134	2639	0	2812
3002	17	12	2640	130	0	2799
3003	2540	8	124	51	0	2723
3004	111	13	2599	28	0	2751
3005	44	11	123	2492	0	2670
3006	30	6	49	2613	0	2698
3007	26	14	38	2627	0	2705
3008	2532	4	28	158	0	2722
3009	2589	8	20	72	0	2689
3010	2654	10	26	47	0	2737
3011	149	6	16	2574	0	2745
3012	65	11	23	2652	0	2751
3013	46	5	2489	150	0	2690
3014	30	5	2542	63	0	2640
3015	23	2479	127	51	0	2680
3016	23	95	36	2138	0	2292
3017	12	23	24	2135	0	2194
3018	20	2120	13	97	0	2250
3019	2121	72	23	46	0	2262
3020	84	2132	15	28	0	2259
3021	2109	82	15	31	0	2237
3022	90	21	12	2119	0	2242
3023	2113	19	15	84	0	2231
3024	90	9	17	2134	0	2250
3025	38	12	2065	92	0	2207
3026	17	15	82	2112	0	2226
3027	2063	3	31	101	0	2198
3028	86	10	19	2107	0	2222
3029	37	5	16	2129	0	2187
3030	16	11	2111	117	0	2255
3031	22	5	81	2153	0	2261
3032	19	2	27	2146	0	2194
3033	15	2093	23	106	0	2237
3034	13	62	18	2131	0	2224
3035	14	19	15	2199	0	2247
3036	18	14	11	2204	0	2247
3037	18	2035	7	114	0	2174
3038	24	68	8	1999	0	2099
3039	1910	16	6	87	0	2019
3040	66	1847	11	41	0	1965
3041	15	1769	8	29	0	1821
3042	20	1760	13	15	0	1808
3043	9	96	16	1613	0	1734
3044	8	1596	14	65	0	1683
3045	13	1696	18	33	0	1760
3046	1672	51	25	25	0	1773
3047	70	15	1645	19	0	1749
3048	1633	19	70	18	0	1740
3049	58	15	17	1718	0	1808
3050	14	16	1702	76	0	1808
3051	1643	9	70	39	0	1761
3052	57	12	1664	26	0	1759
3053	14	6	1675	33	0	1728
3054	1659	7	85	36	0	1787
3055	70	9	51	1697	0	1827
3056	33	10	1729	81	0	1853
3057	1692	7	82	45	0	1826
3058	1780	8	28	55	0	1871
3059	76	11	1777	52	0	1916
3060	1816	8	66	41	0	1931
3061	1920	3	26	32	0	1981
3062	100	6	1806	32	0	1944
3063	1818	6	64	44	0	1932
3064	1873	4	30	51	0	1958
3065	84	5	1791	39	0	1919
3066	29	15	1945	36	0	2025
3067	29	11	79	1929	0	2048
3068	19	21	1916	98	0	2054
3069	1909	17	70	47	0	2043
3070	77	21	20	1913	0	2031
3071	41	26	21	1946	0	2034
3072	40	22	1871	85	0	2018
3073	34	21	65	1860	0	1980
3074	29	15	1868	104	0	2016
3075	1879	16	69	49	0	2013
3076	1949	14	27	49	0	2039
3077	80	12	1895	50	0	2037
3078	1899	15	77	40	0	2031
3079	2003	12	18	54	0	2087
3080	95	16	1916	46	0	2073
3081	1933	9	70	55	0	2067
3082	1969	11	30	59	0	2069
3083	85	12	1953	47	0	2097
3084	1921	13	66	60	0	2060
3085	78	13	1954	50	0	2095
3086	30	16	69	1951	0	2066
3087	31	15	29	1978	0	2053
3088	22	15	22	2050	0	2109
3089	22	22	1925	110	0	2079
3090	1822	19	60	57	0	1958
3091	73	23	1880	53	0	2029
3092	30	1481	31	19	0	1561
3093	14	1435	15	15	0	1479
3094	1400	24	29	16	0	1469
3095	34	12	6	1336	0	1388
3096	14	1364	6	25	0	1409
3097	1312	16	9	10	0	1347
3098	1310	1	6	11	0	1328
3099	24	1362	9	5	0	1400
3100	11	17	7	1288	0	1323
3101	10	1327	6	14	0	1357
3102	1351	17	4	7	0	1379
3103	1360	3	8	7	0	1378
3104	21	4	5	1326	0	1356
3105	1346	1	2	27	0	1376
3106	23	3	7	1333	0	1366
3107	11	3	1313	21	0	1348
3108	1285	0	17	10	0	1312
3109	21	4	1321	5	0	1351
3110	10	8	17	1268	0	1303
3111	1304	5	4	23	0	1336
3112	19	2	11	1322	0	1354
3113	15	1	1322	21	0	1359
3114	8	4	1273	7	0	1292
3115	11	11	29	1286	0	1337
3116	1299	1	21	32	0	1353
3117	23	1334	4	9	0	1370
3118	4	15	12	1363	0	1394
3119	7	3	1357	21	0	1388
3120	1340	3	20	9	0	1372
3121	1402	1	11	4	0	1418
3122	26	1	1360	4	0	1391
3123	1352	2	19	4	0	1377
3124	22	0	8	1404	0	1434
3125	10	4	1400	16	0	1430
3126	1374	2	19	5	0	1400
3127	23	1	7	1388	0	1419
3128	10	5	4	1322	0	1341
3129	1366	1	5	20	0	1392
3130	18	1269	5	5	0	1297
3131	8	1299	4	4	0	1315
3132	1315	12	3	7	0	1337
3133	1282	1	7	9	0	1299
3134	18	3	1318	8	0	1347
3135	6	2	1275	5	0	1288
3136	6	2	14	1312	0	1334
3137	1354	1	10	17	0	1382
3138	1334	2	6	5	0	1347
3139	1349	2	6	6	0	1363
3140	15	1313	3	4	0	1335
3141	7	1331	3	5	0	1346
3142	9	13	3	1390	0	1415
3143	10	3	5	1358	0	1376
3144	6	3	5	1394	0	1408
3145	9	3	1457	17	0	1486
3146	12	1	1307	11	0	1331
3147	1420	2	22	6	0	1450
3148	1455	4	6	9	0	1474
3149	27	3	7	1427	0	1464
3150	15	1	8	1405	0	1429
3151	12	2	3	1456	0	1473
3152	6	2	1404	24	0	1436
3153	4	1	1363	14	0	1382
3154	5	7	17	1380	0	1409
3155	5	0	1456	20	0	1481
3156	4	1367	21	9	0	1401
3157	11	1415	9	7	0	1442
3158	1405	13	5	9	0	1432
3159	11	1344	3	5	0	1363
3160	7	17	3	1366	0	1393
3161	5	7	4	1371	0	1387
3162	3	1446	2	17	0	1468
3163	7	15	4	1480	0	1506
3164	7	11	1447	19	0	1484
3165	6	1452	19	12	0	1489
3166	8	16	9	1398	0	1431
3167	3	7	1407	17	0	1434
3168	4	1395	17	8	0	1424
3169	3	14	9	1377	0	1403
3170	2	1404	5	16	0	1427
3171	3	16	3	1427	0	1449
3172	4	9	1	1364	0	1378
3173	0	1384	2	25	0	1411
3174	1353	18	1	14	0	1386
3175	1318	9	3	5	0	1335
3176	22	1325	4	4	0	1355
3177	9	1365	5	2	0	1381
3178	7	24	3	1368	0	1402
3179	5	11	1344	21	0	1381
3180	1298	5	20	8	0	1331
3181	1338	2	7	9	0	1356
3182	26	5	1345	5	0	1381
3183	1314	4	20	4	0	1342
3184	1378	2	9	5	0	1394
3185	24	2	1338	6	0	1370
3186	1278	5	18	6	0	1307
3187	21	1	1402	5	0	1429
3188	11	1382	18	5	0	1416
3189	1436	16	8	6	0	1466
3190	1434	8	5	3	0	1450
3191	28	5	1412	4	0	1449
3192	1411	4	17	5	0	1437
3193	1481	4	6	9	0	1500
3194	28	2	1442	6	0	1478
3195	1483	4	18	6	0	1511
3196	1515	2	11	7	0	1535
3197	25	1	1499	6	0	1531
3198	1522	4	22	1	0	1549
3199	22	5	8	1454	0	1489
3200	10	5	7	1464	0	1486
3201	5	7	1431	25	0	1468
3202	3	4	1378	14	0	1399
3203	6	3	24	1426	0	1459
3204	5	3	11	1459	0	1478
3205	1549	4	5	27	0	1585
3206	24	4	1523	10	0	1561
3207	1533	5	23	8	0	1569
3208	29	5	10	1638	0	1682
3209	15	4	1643	27	0	1689
3210	1765	5	30	17	0	1817
3211	29	5	11	1870	0	1915
3212	15	2	1870	31	0	1918
3213	1813	2	29	15	0	1859
3214	35	2	12	1890	0	1939
3215	1933	0	12	33	0	1978
3216	36	4	2076	13	0	2129
3217	18	0	35	1912	0	1965
3218	11	2076	14	29	0	2130
3219	2116	33	7	15	0	2171
3220	2081	11	4	5	0	2101
3221	43	2144	5	7	0	2199
3222	2213	40	5	6	0	2264
3223	2238	12	3	6	0	2259
3224	2208	5	7	6	0	2226
3225	58	2145	5	2	0	2210
3226	21	40	2	2179	0	2242
3227	10	10	2216	41	0	2277
3228	15	4	38	2153	0	2210
3229	5	2	16	2173	0	2196
3230	6	1	2206	52	0	2265
3231	6	4	2196	19	0	2225
3232	11	1	52	2064	0	2128
3233	8	2214	23	25	0	2270
3234	2259	42	9	14	0	2324
3235	2206	12	5	15	0	2238
3236	47	2306	5	14	0	2372
3237	2332	40	4	8	0	2384
3238	2352	14	2	7	0	2375
3239	56	8	2339	2	0	2405
3240	2221	4	37	9	0	2271
3241	49	2383	11	8	0	2451
3242	19	41	2338	1	0	2399
3243	15	11	2247	3	0	2276
3244	9	2288	45	5	0	2347
3245	2274	36	15	4	0	2329
3246	38	13	2314	5	0	2370
3247	13	3	38	2306	0	2360
3248	8	3	2336	35	0	2382
3249	2165	4	37	21	0	2227
3250	41	1	2757	10	0	2809
3251	16	6	2685	5	0	2712
3252	2662	2	47	11	0	2722
3253	43	2833	11	7	0	2894
3254	2932	35	7	7	0	2981
3255	2981	10	7	8	0	3006
3256	51	6	3	2904	0	2964
3257	17	3273	4	37	0	3331
3258	3329	34	6	14	0	3383
3259	44	14	3348	8	0	3414
3260	3219	8	31	12	0	3270
3261	41	3388	12	6	0	3447
3262	3343	35	11	3	0	3392
3263	3337	6	10	6	0	3359
3264	41	3407	3	4	0	3455
3265	10	35	7	3434	0	3486
3266	3447	4	8	32	0	3491
3267	33	3398	5	12	0	3448
3268	9	34	5	3416	0	3464
3269	3451	5	7	38	0	3501
3270	38	4	7	3557	0	3606
3271	13	9	4	3527	0	3553
3272	6	3582	7	43	0	3638
3273	3554	40	3	15	0	3612
3274	3611	8	8	14	0	3641
3275	3686	6	3	7	0	3702
3276	58	3751	5	2	0	3816
3277	3805	42	9	8	0	3864
3278	3856	7	5	2	0	3870
3279	57	10	6	3769	0	3842
3280	24	3	2	3803	0	3832
3281	18	9	3812	47	0	3886
3282	13	5	42	3658	0	3718
3283	17	8	11	3554	0	3590
3284	11	6	3806	46	0	3869
3285	3331	7	45	23	0	3406
3286	51	5	3780	9	0	3845
3287	17	11	3807	3	0	3838
3288	18	6	46	3836	0	3906
3289	12	3	10	3908	0	3933
3290	12	3975	9	51	0	4047
3291	3992	43	5	20	0	4060
3292	3919	11	6	9	0	3945
3293	55	3952	8	6	0	4021
3294	23	4199	4	9	0	4235
3295	18	59	5	4162	0	4244
3296	12	4309	2	49	0	4372
3297	4315	60	6	11	0	4392
3298	4328	17	5	13	0	4363
3299	72	10	6	4269	0	4357
3300	27	8	3	4317	0	4355
3301	4323	3	4	70	0	4400
3302	69	4	4221	19	0	4313
3303	4137	5	54	19	0	4215
3304	66	9	4207	9	0	4291
3305	4155	3	56	12	0	4226
3306	70	10	13	4251	0	4344
3307	20	3	4349	59	0	4431
3308	16	2	4182	18	0	4218
3309	4100	26	59	16	0	4201
3310	4148	4	27	10	0	4189
3311	58	4219	10	7	0	4294
3312	24	43	8	4455	0	4530
3313	12	13	5	4561	0	4591
3314	4523	8	3	75	0	4609
3315	59	4468	5	23	0	4555
3316	4337	53	4	17	0	4411
3317	63	4287	4	7	0	4361
3318	19	4301	6	19	0	4345
3319	4335	55	3	9	0	4402
3320	56	23	4284	4	0	4367
3321	24	8	44	4216	0	4292
3322	16	6	15	4255	0	4292
3323	10	6	4292	63	0	4371
3324	8	5	51	4211	0	4275
3325	37	5	29	3605	0	3676
3326	7	4298	9	55	0	4369
3327	4285	50	4	20	0	4359
3328	49	16	4318	10	0	4393
3329	4065	7	45	16	0	4133
3330	54	4326	19	7	0	4406
3331	17	48	9	4375	0	4449
3332	4490	19	5	62	0	4576
3333	55	11	3	4479	0	4548
3334	29	4	2	4516	0	4551
3335	12	8	4479	67	0	4566
3336	4128	2	52	37	0	4219
3337	4445	6	16	16	0	4483
3338	71	11	4398	8	0	4488
3339	34	2	49	4362	0	4447
3340	19	4	4405	52	0	4480
3341	4255	4	56	34	0	4349
3342	4500	7	22	16	0	4545
3343	70	1	16	4474	0	4561
3344	4503	1	5	62	0	4571
3345	66	2	4743	28	0	4839
3346	25	4	58	4644	0	4731
3347	21	0	28	4631	0	4680
3348	9	1	15	4835	0	4860
3349	18	4	3	4791	0	4816
3350	4348	6	6	85	0	4445
3351	58	4	4263	34	0	4359
3352	32	3	52	4273	0	4360
3353	21	4	4209	61	0	4295
3354	11	4	4121	29	0	4165
3355	7	4	64	4094	0	4169
3356	10	4	28	4141	0	4183
3357	3893	5	12	78	0	3988
3358	60	5	9	3886	0	3960
3359	28	3	10	3919	0	3960
3360	17	2	7	4009	0	4035
3361	3926	4	10	86	0	4026
3362	3951	1	7	37	0	3996
3363	3963	5	9	27	0	4004
3364	3884	5	7	20	0	3916
3365	79	4141	7	16	0	4243
3366	37	66	7	4172	0	4282
3367	22	32	7	4241	0	4302
3368	4301	12	6	117	0	4436
3369	89	4542	9	61	0	4701
3370	41	89	3	4819	0	4952
3371	24	36	5200	110	0	5370
3372	5464	16	122	62	0	5664
3373	176	5858	48	23	0	6105
3374	6182	170	16	26	0	6394
3375	6422	45	17	19	0	6503
3376	265	21	13	6185	0	6484
3377	86	17	6180	216	0	6499
3378	40	6	201	6347	0	6594
3379	6378	14	58	233	0	6683
3380	225	12	24	6409	0	6670
3381	6379	17	19	233	0	6648
3382	245	6260	7	94	0	6606
3383	6570	202	11	58	0	6841
3384	245	63	16	6574	0	6898
3385	104	31	16	7119	0	7270
3386	7080	19	7	296	0	7402
3387	7144	10	7	120	0	7281
3388	7175	12	14	65	0	7266
3389	7164	18	10	42	0	7234
3390	7143	20	9	35	0	7207
3391	319	7	16	6855	0	7197
3392	117	16	6626	251	0	7010
3393	73	6680	186	100	0	7039
3394	6567	197	62	57	0	6883
3395	258	61	6387	43	0	6749
3396	6326	26	196	35	0	6583
3397	276	6361	59	31	0	6727
3398	6563	195	38	44	0	6840
3399	279	69	28	6455	0	6831
3400	131	37	19	6653	0	6840
3401	83	27	6508	291	0	6909
3402	77	14	214	6485	0	6790
3403	66	28	6669	241	0	7004
3404	82	22	6696	94	0	6894
3405	6663	20	261	72	0	7016
3406	6999	22	83	76	0	7180
3407	302	30	6695	63	0	7090
3408	6604	19	216	67	0	6906
3409	6915	20	77	68	0	7080
3410	319	29	6633	65	0	7046
3411	145	6590	227	63	0	7025
3412	133	205	93	6858	0	7289
3413	7072	58	52	245	0	7427
3414	7278	48	55	94	0	7475
3415	7323	26	33	67	0	7449
3416	7355	25	39	59	0	7478
3417	7304	20	45	59	0	7428
3418	338	39	6981	47	0	7405
3419	179	33	7146	69	0	7427
3420	146	37	248	7147	0	7578
3421	7329	35	97	250	0	7711
3422	7527	26	60	104	0	7717
3423	7486	32	41	92	0	7651
3424	7192	36	47	76	0	7351
3425	336	6973	57	87	0	7453
3426	206	7508	50	91	0	7855
3427	7441	231	49	106	0	7827
3428	7610	80	57	92	0	7839
3429	351	7451	56	70	0	7928
3430	7634	208	41	69	0	7952
3431	357	75	7464	67	0	7963
3432	202	53	208	7348	0	7811
3433	174	51	7361	237	0	7823
3434	179	50	7362	98	0	7689
3435	167	32	267	7321	0	7787
3436	157	43	104	7501	0	7805
3437	178	33	7623	272	0	8106
3438	159	36	231	7321	0	7747
3439	158	40	102	7750	0	8050
3440	7719	45	79	292	0	8135
3441	7812	32	74	138	0	8056
3442	361	32	78	7696	0	8167
3443	191	42	7634	266	0	8133
3444	148	7637	256	109	0	8150
3445	7570	207	125	106	0	8008
3446	304	76	7759	110	0	8249
3447	186	7396	246	91	0	7919
3448	153	7957	125	86	0	8321
3449	8018	225	81	97	0	8421
3450	8203	87	86	86	0	8462
3451	360	53	89	7947	0	8449
3452	194	46	8377	246	0	8863
3453	165	30	267	8374	0	8836
3454	135	53	136	8451	0	8775
3455	153	38	99	8652	0	8942
3456	8514	40	83	307	0	8944
3457	358	8221	68	135	0	8782
3458	202	8727	84	85	0	9098
3459	150	257	77	8474	0	8958
3460	143	96	73	8843	0	9155
3461	8677	59	73	342	0	9151
3462	8587	48	78	153	0	8866
3463	8696	40	51	143	0	8930
3464	397	8461	60	83	0	9001
3465	8364	206	55	68	0	8693
3466	336	123	56	8171	0	8686
3467	170	48	8064	252	0	8534
3468	165	38	7420	108	0	7731
3469	7304	24	218	88	0	7634
3470	222	17	7284	57	0	7580
3471	107	14	6688	47	0	6856
3472	5896	12	97	46	0	6051
3473	101	13	6102	24	0	6240
3474	48	11	5824	14	0	5897
3475	49	37	59	5517	0	5662
3476	26	4	5974	37	0	6041
3477	25	2	55	5634	0	5716
3478	32	10	20	5511	0	5573
3479	17	7	5955	46	0	6025
3480	18	5958	46	23	0	6045
3481	5991	36	20	37	0	6084
3482	47	16	6194	11	0	6268
3483	26	8	6000	13	0	6047
3484	5019	4	53	35	0	5111
3485	46	9	5678	5	0	5738
3486	23	5493	41	6	0	5563
3487	26	4800	36	9	0	4871
3488	10	40	21	5618	0	5689
3489	7	18	19	5498	0	5542
3490	5772	11	4	65	0	5852
3491	5688	4	12	33	0	5737
3492	5739	6	7	27	0	5779
3493	57	8	5	5732	0	5802
3494	5809	8	9	52	0	5878
3495	5688	6	7	33	0	5734
3496	63	5	5740	12	0	5820
3497	40	4	5458	7	0	5509
3498	19	5751	52	10	0	5832
3499	19	34	17	5852	0	5922
3500	5878	15	20	38	0	5951
3501	39	5746	10	20	0	5815
3502	14	38	12	5893	0	5957
3503	5780	16	18	51	0	5865
3504	5650	18	6	27	0	5701
3505	54	5744	4	20	0	5822
3506	5755	36	12	12	0	5815
3507	5765	22	8	26	0	5821
3508	66	9	5	5732	0	5812
3509	44	3	5802	41	0	5890
3510	27	5575	37	19	0	5658
3511	13	5679	19	18	0	5729
3512	5401	38	14	8	0	5461
3513	52	21	6	5276	0	5355
3514	25	10	5290	40	0	5365
3515	14	5215	40	19	0	5288
3516	5255	44	20	20	0	5339
3517	5294	19	14	20	0	5347
3518	58	8	5319	8	0	5393
3519	29	6	35	5076	0	5146
3520	13	7	24	5446	0	5490
3521	18	8	6001	54	0	6081
3522	6029	6	70	36	0	6141
3523	7775	5	28	32	0	7840
3524	207	3	21	8998	0	9229
3525	76	9288	13	242	0	9619
3526	37	251	9	9853	0	10150
3527	34	97	9728	318	0	10177
3528	9552	53	283	140	0	10028
3529	309	24	108	10045	0	10486
3530	129	26	9904	326	0	10385
3531	9500	28	310	156	0	9994
3532	318	14	134	9880	0	10346
3533	152	22	89	9992	0	10255
3534	9752	14	50	427	0	10243
3535	303	9735	51	223	0	10312
3536	9815	285	62	121	0	10283
3537	411	114	36	9711	0	10272
3538	9747	65	35	376	0	10223
3539	412	32	9557	177	0	10178
3540	205	9554	294	117	0	10170
3541	129	312	121	9785	0	10347
3542	9755	129	74	387	0	10345
3543	357	9755	59	189	0	10360
3544	194	334	43	9926	0	10497
3545	9956	141	57	382	0	10536
3546	9982	92	46	199	0	10319
3547	511	59	38	9701	0	10309
3548	260	57	9489	415	0	10221
3549	165	77	9416	231	0	9889
3550	9308	64	415	201	0	9988
3551	422	9180	194	127	0	9923
3552	233	9257	110	110	0	9710
3553	9075	410	81	129	0	9695
3554	419	9173	98	112	0	9802
3555	228	375	92	9159	0	9854
3556	181	165	65	9553	0	9964
3557	9253	133	65	502	0	9953
3558	9200	88	62	254	0	9604
3559	9321	100	46	158	0	9625
3560	578	106	8684	130	0	9498
3561	300	91	327	8831	0	9549
3562	240	73	8805	427	0	9545
3563	214	71	8720	221	0	9226
3564	176	65	9057	175	0	9473
3565	150	62	532	8805	0	9549
3566	150	70	8997	434	0	9651
3567	151	80	9237	232	0	9700
3568	145	78	536	8964	0	9723
3569	9073	65	288	433	0	9859
3570	460	68	9100	244	0	9872
3571	245	48	446	8920	0	9659
3572	174	53	270	9283	0	9780
3573	130	48	9161	581	0	9920
3574	158	48	443	9153	0	9802
3575	177	63	9183	494	0	9917
3576	146	80	484	8924	0	9634
3577	147	79	228	9215	0	9669
3578	144	66	177	9307	0	9694
3579	125	67	160	9290	0	9642
3580	8697	58	141	678	0	9574
3581	8839	55	153	382	0	9429
3582	550	50	8443	270	0	9313
3583	290	8209	419	252	0	9170
3584	212	323	8613	210	0	9358
3585	176	123	8668	205	0	9172
3586	8320	85	548	202	0	9155
3587	463	8460	311	188	0	9422
3588	8550	357	258	181	0	9346
3589	454	8661	214	166	0	9495
3590	8672	410	216	162	0	9460
3591	9003	184	221	141	0	9549
3592	577	147	178	8500	0	9402
3593	303	8640	146	463	0	9552
3594	231	397	135	8795	0	9558
3595	174	188	126	9119	0	9607
3596	181	120	8648	633	0	9582
3597	195	8679	420	368	0	9662
3598	186	381	232	8892	0	9691
3599	8417	191	170	522	0	9300
3600	9074	113	169	331	0	9687
3601	9230	81	163	265	0	9739
3602	561	8814	177	223	0	9775
3603	9064	413	138	245	0	9860
3604	540	9377	137	216	0	10270
3605	292	477	126	9627	0	10522
3606	257	206	9476	505	0	10444
3607	209	143	472	9307	0	10131
3608	200	9417	258	511	0	10386
3609	193	440	187	9538	0	10358
3610	159	215	139	9715	0	10228
3611	157	9578	135	623	0	10493
3612	9647	460	132	326	0	10565
3613	502	243	104	9669	0	10518
3614	233	190	9382	571	0	10376
3615	213	135	449	9581	0	10378
3616	187	115	203	9999	0	10504
3617	168	116	9488	701	0	10473
3618	180	128	448	9138	0	9894
3619	139	9319	208	629	0	10295
3620	181	455	9277	332	0	10245
3621	235	199	8860	258	0	9552
3622	117	8168	495	205	0	8985
3623	85	7064	217	143	0	7509
3624	48	5775	104	96	0	6023
3625	5144	231	178	73	0	5626
3626	4970	56	38	43	0	5107
3627	4915	42	27	53	0	5037
3628	204	24	22	4800	0	5050
3629	62	21	4744	161	0	4988
3630	36	29	152	4756	0	4973
3631	24	37	46	4873	0	4980
3632	4735	22	44	196	0	4997
3633	4788	31	28	76	0	4923
3634	170	4790	20	48	0	5028
3635	4821	153	14	36	0	5024
3636	4901	51	20	44	0	5016
3637	5015	44	17	35	0	5111
3638	212	21	4788	36	0	5057
3639	82	19	4769	28	0	4898
3640	52	39	153	4693	0	4937
3641	34	18	4709	150	0	4911
3642	4453	24	141	71	0	4689
3643	4631	14	51	56	0	4752
3644	180	23	4426	19	0	4648
3645	4276	19	110	32	0	4437
3646	136	4339	47	20	0	4542
3647	4392	116	27	22	0	4557
3648	153	40	15	4335	0	4543
3649	74	39	12	4175	0	4300
3650	51	4306	24	123	0	4504
3651	4290	114	24	58	0	4486
3652	4311	41	22	46	0	4420
3653	145	4291	32	28	0	4496
3654	70	123	17	4189	0	4399
3655	49	48	14	4204	0	4315
3656	37	4221	28	139	0	4425
3657	50	110	13	4223	0	4396
3658	32	67	19	4336	0	4454
3659	4228	45	14	143	0	4430
3660	4283	16	13	82	0	4394
3661	154	28	4172	54	0	4408
3662	4093	29	112	50	0	4284
3663	153	23	4132	44	0	4352
3664	68	35	131	4042	0	4276
3665	52	24	4066	131	0	4273
3666	27	4029	118	71	0	4245
3667	39	111	48	3886	0	4084
3668	40	47	27	3981	0	4095
3669	3885	33	23	146	0	4087
3670	124	23	16	3830	0	3993
3671	61	19	3669	133	0	3882
3672	3709	15	104	56	0	3884
3673	3789	24	52	40	0	3905
3674	3852	28	36	25	0	3941
3675	3825	18	30	37	0	3910
3676	163	18	24	3939	0	4144
3677	80	22	27	4125	0	4254
3678	51	30	19	4341	0	4441
3679	44	16	22	4441	0	4523
3680	4238	19	22	218	0	4497
3681	4333	13	15	89	0	4450
3682	202	7	18	4032	0	4259
3683	91	4080	35	150	0	4356
3684	4164	137	17	72	0	4390
3685	184	44	4080	56	0	4364
3686	78	4103	154	37	0	4372
3687	3956	138	35	44	0	4173
3688	163	3959	40	30	0	4192
3689	69	148	3923	33	0	4173
3690	3947	44	136	45	0	4172
3691	4003	43	40	41	0	4127
3692	203	27	3880	32	0	4142
3693	99	12	146	3937	0	4194
3694	79	16	46	3897	0	4038
3695	64	3904	46	163	0	4177
3696	59	140	24	3943	0	4166
3697	3784	52	32	167	0	4035
3698	174	3856	22	62	0	4114
3699	65	130	17	3688	0	3900
3700	55	59	15	3759	0	3888
3701	42	35	3597	170	0	3844
3702	39	3615	118	81	0	3853
3703	3329	139	33	69	0	3570
3704	119	2870	20	47	0	3056
3705	37	2818	16	28	0	2899
3706	2741	120	23	19	0	2903
3707	115	39	10	2678	0	2842
3708	37	35	9	2761	0	2842
3709	2710	19	12	121	0	2862
3710	124	12	9	2735	0	2880
3711	39	17	10	2853	0	2919
3712	2831	12	12	144	0	2999
3713	129	15	4	2766	0	2914
3714	35	2768	13	132	0	2948
3715	2803	110	10	51	0	2974
3716	132	28	2676	41	0	2877
3717	46	2589	101	33	0	2769
3718	39	133	26	2526	0	2724
3719	28	21	2504	122	0	2675
3720	26	25	2516	41	0	2608
3721	20	83	96	2302	0	2501
3722	2338	18	29	105	0	2490
3723	94	7	19	2327	0	2447
3724	24	14	18	2411	0	2467
3725	24	14	8	2441	0	2487
3726	31	7	12	2444	0	2494
3727	13	21	10	2457	0	2501
3728	20	17	2291	119	0	2447
3729	22	9	2279	47	0	2357
3730	9	13	93	2306	0	2421
3731	18	11	2274	96	0	2399
3732	25	2287	98	37	0	2447
3733	9	74	40	2334	0	2457
3734	15	25	2250	104	0	2394
3735	2053	18	79	50	0	2200
3736	69	2145	27	42	0	2283
3737	21	2083	17	33	0	2154
3738	29	2144	15	27	0	2215
3739	16	92	16	2095	0	2219
3740	2087	36	11	93	0	2227
3741	69	17	11	2101	0	2198
3742	2010	18	50	92	0	2170
3743	78	2034	9	39	0	2160
3744	2065	75	7	34	0	2181
3745	89	29	12	2073	0	2203
3746	27	29	10	2104	0	2170
3747	24	2052	3	97	0	2176
3748	23	72	10	2112	0	2217
3749	17	24	10	2181	0	2232
3750	17	21	3	2184	0	2225
3751	2077	19	11	113	0	2220
3752	1985	19	8	55	0	2067
3753	86	11	2066	44	0	2207
3754	2063	15	76	30	0	2184
3755	98	21	2081	25	0	2225
3756	39	12	80	2064	0	2195
3757	28	18	34	2134	0	2214
3758	22	18	17	2185	0	2242
3759	15	10	2073	114	0	2212
3760	15	14	76	2091	0	2196
3761	13	15	2111	106	0	2245
3762	18	17	74	2141	0	2250
3763	2108	11	28	102	0	2249
3764	73	16	2089	52	0	2230
3765	2057	8	71	50	0	2186
3766	85	7	26	2113	0	2231
3767	2100	8	21	100	0	2229
3768	85	2080	20	47	0	2232
3769	35	70	18	2135	0	2258
3770	22	18	2180	101	0	2321
3771	22	21	74	2209	0	2326
3772	23	42	36	2152	0	2253
3773	11	2157	20	107	0	2295
3774	23	69	2144	43	0	2279
3775	14	2140	73	43	0	2270
3776	1892	47	31	30	0	2000
3777	50	1968	15	25	0	2058
3778	1755	43	45	17	0	1860
3779	1735	14	13	20	0	1782
3780	1772	7	6	20	0	1805
3781	54	11	13	1759	0	1837
3782	17	5	1735	52	0	1809
3783	8	10	40	1701	0	1759
3784	11	1725	14	47	0	1797
3785	8	39	11	1745	0	1803
3786	1700	13	10	54	0	1777
3787	47	1704	11	23	0	1785
3788	18	44	7	1661	0	1730
3789	15	15	7	1705	0	1742
3790	1679	11	8	53	0	1751
3791	48	12	1668	22	0	1750
3792	20	1609	47	24	0	1700
3793	10	35	12	1525	0	1582
3794	12	14	1528	45	0	1599
3795	9	8	38	1467	0	1522
3796	7	1506	13	48	0	1574
3797	11	35	11	1575	0	1632
3798	3	13	5	1586	0	1607
3799	3	7	6	1558	0	1574
3800	8	3	1531	47	0	1589
3801	1487	8	32	17	0	1544
3802	37	6	13	1637	0	1693
3803	1796	2	6	47	0	1851
3804	1856	6	5	17	0	1884
3805	1896	5	5	16	0	1922
3806	1863	8	5	12	0	1888
3807	1922	5	5	18	0	1950
3808	52	2	10	1862	0	1926
3809	13	1851	5	53	0	1922
3810	7	40	3	1818	0	1868
3811	7	1803	4	46	0	1860
3812	7	34	5	1713	0	1759
3813	1698	8	2	43	0	1751
3814	37	4	5	1689	0	1735
3815	21	2	1659	37	0	1719
3816	1593	3	30	14	0	1640
3817	35	1681	7	10	0	1733
3818	1724	30	4	10	0	1768
3819	1728	10	4	8	0	1750
3820	1674	3	1	16	0	1694
3821	39	1727	3	8	0	1777
3822	12	33	0	1735	0	1780
3823	9	11	2	1757	0	1779
3824	12	4	1692	43	0	1751
3825	11	4	31	1615	0	1661
3826	13	6	11	1611	0	1641
3827	14	5	3	1693	0	1715
3828	12	1699	1	42	0	1754
3829	1718	31	3	13	0	1765
3830	1660	12	3	14	0	1689
3831	43	10	1691	9	0	1753
3832	16	1687	25	14	0	1742
3833	15	30	11	1727	0	1783
3834	11	12	3	1755	0	1781
3835	12	8	5	1732	0	1757
3836	11	4	4	1765	0	1784
3837	8	4	3	1810	0	1825
3838	11	11	1752	48	0	1822
3839	7	10	1660	23	0	1700
3840	1775	8	34	15	0	1832
3841	1889	5	12	13	0	1919
3842	1893	9	8	13	0	1923
3843	60	8	3	1902	0	1973
3844	22	3	1889	51	0	1965
3845	1851	5	40	29	0	1925
3846	1930	5	10	18	0	1963
3847	50	6	1874	14	0	1944
3848	1834	7	38	15	0	1894
3849	51	6	2039	18	0	2114
3850	24	6	46	2044	0	2120
3851	22	3	2078	51	0	2154
3852	1989	9	45	20	0	2063
3853	2069	4	15	20	0	2108
3854	2099	3	5	15	0	2122
3855	2101	3	9	20	0	2133
3856	56	7	2167	15	0	2245
3857	23	2167	42	16	0	2248
3858	2217	42	18	13	0	2290
3859	2243	12	13	13	0	2281
3860	68	8	2228	11	0	2315
3861	25	4	47	2166	0	2242
3862	21	3	21	2268	0	2313
3863	17	5	2239	59	0	2320
3864	2097	5	48	28	0	2178
3865	2268	3	15	17	0	2303
3866	64	2260	19	10	0	2353
3867	2325	46	7	19	0	2397
3868	2291	16	12	10	0	2329
3869	2332	2	14	11	0	2359
3870	2258	4	9	15	0	2286
3871	76	3	2169	9	0	2257
3872	2147	4	43	19	0	2213
3873	62	23	20	2122	0	2227
3874	27	2171	14	43	0	2255
3875	25	44	2143	21	0	2233
3876	25	2164	43	8	0	2240
3877	30	41	17	2055	0	2143
3878	12	9	2090	37	0	2148
3879	1947	7	31	16	0	2001
3880	42	0	2069	11	0	2122
3881	2029	2	31	12	0	2074
3882	37	5	17	2040	0	2099
3883	24	5	7	2031	0	2067
3884	23	2008	4	40	0	2075
3885	18	2088	9	13	0	2128
3886	17	37	10	2158	0	2222
3887	2160	17	3	33	0	2213
3888	2156	6	12	15	0	2189
3889	2170	1	4	9	0	2184
3890	50	1	2167	15	0	2233
3891	2098	6	36	9	0	2149
3892	40	3	2250	6	0	2299
3893	20	7	2150	9	0	2186
3894	2170	5	42	7	0	2224
3895	2267	6	14	3	0	2290
3896	45	6	2205	3	0	2259
3897	23	4	29	2132	0	2188
3898	13	3	14	2259	0	2289
3899	2277	3	7	36	0	2323
3900	2243	1	11	15	0	2270
3901	47	8	2327	5	0	2387
3902	16	2250	24	8	0	2298
3903	10	2177	11	12	0	2210
3904	2187	26	4	3	0	2220
3905	28	10	4	2155	0	2197
3906	14	2	5	2179	0	2200
3907	13	1	5	2222	0	2241
3908	2168	1	3	29	0	2201
3909	32	4	5	2206	0	2247
3910	2224	3	7	24	0	2258
3911	2263	3	5	11	0	2282
3912	39	2448	6	2	0	2495
3913	21	22	8	2677	0	2728
3914	14	10	2683	32	0	2739
3915	2617	4	36	21	0	2678
3916	2712	3	13	11	0	2739
3917	2703	0	10	11	0	2724
3918	51	1	2750	7	0	2809
3919	24	5	34	2735	0	2798
3920	2806	4	15	34	0	2859
3921	2681	6	8	15	0	2710
3922	2697	6	4	11	0	2718
3923	53	2623	7	5	0	2688
3924	24	2745	3	13	0	2785
3925	17	37	4	2841	0	2899
3926	11	14	10	2816	0	2851
3927	15	2810	2	39	0	2866
3928	2834	40	3	21	0	2898
3929	41	15	2885	11	0	2952
3930	20	8	33	2911	0	2972
3931	18	5	11	2904	0	2938
3932	16	7	2879	45	0	2947
3933	2723	4	34	14	0	2775
3934	2937	5	16	10	0	2968
3935	46	2864	10	10	0	2930
3936	2903	31	3	11	0	2948
3937	46	26	3024	7	0	3103
3938	3054	6	40	19	0	3119
3939	62	4	3151	6	0	3223
3940	3105	6	36	9	0	3156
3941	3202	1	16	11	0	3230
3942	3190	1	14	13	0	3218
3943	3133	5	11	11	0	3160
3944	49	3144	7	10	0	3210
3945	3272	27	7	9	0	3315
3946	3367	12	7	13	0	3399
3947	54	14	3371	12	0	3451
3948	3395	6	32	10	0	3443
3949	50	5	14	3351	0	3420
3950	25	1	3375	40	0	3441
3951	3386	2	36	16	0	3440
3952	50	7	13	3479	0	3549
3953	3571	5	10	41	0	3627
3954	3810	7	6	46	0	3869
3955	58	10	3947	19	0	4034
3956	3894	10	34	9	0	3947
3957	4021	5	12	11	0	4049
3958	4034	4	16	9	0	4063
3959	4082	6	9	12	0	4109
3960	68	4	11	3955	0	4038
3961	34	3953	11	38	0	4036
3962	3804	38	8	26	0	3876
3963	4034	12	10	19	0	4075
3964	4057	11	9	9	0	4086
3965	81	5	3999	8	0	4093
3966	39	4022	47	4	0	4112
3967	38	44	13	4102	0	4197
3968	25	9	19	4160	0	4213
3969	29	11	4328	54	0	4422
3970	30	3	57	4323	0	4413
3971	29	6	4409	73	0	4517
3972	27	4	70	4375	0	4476
3973	25	9	11	4476	0	4521
3974	24	7	4566	75	0	4672
3975	4378	9	61	36	0	4484
3976	4644	6	19	21	0	4690
3977	90	5	4703	10	0	4808
3978	4616	6	69	15	0	4706
3979	4777	6	25	13	0	4821
3980	87	5	4852	14	0	4958
3981	41	5	74	4757	0	4877
3982	37	2	21	4902	0	4962
3983	4952	2	27	76	0	5057
3984	80	4996	11	39	0	5126
3985	4556	78	19	39	0	4692
3986	5053	13	16	13	0	5095
3987	93	5178	12	16	0	5299
3988	5248	63	17	5	0	5333
3989	5278	14	11	17	0	5320
3990	100	5175	13	8	0	5296
3991	55	65	9	5246	0	5375
3992	44	5271	13	71	0	5399
3993	31	81	11	5345	0	5468
3994	34	20	5317	90	0	5461
3995	41	18	5201	28	0	5288
3996	5162	9	91	30	0	5292
3997	5413	10	35	21	0	5479
3998	106	7	5408	16	0	5537
3999	5327	10	82	20	0	5439
4000	5566	4	29	17	0	5616
4001	5453	7	22	22	0	5504
4002	122	5496	16	20	0	5654
4003	53	76	14	5647	0	5790
4004	5656	23	11	84	0	5774
4005	5617	18	13	30	0	5678
4006	112	9	5672	20	0	5813
4007	55	5	82	5589	0	5731
4008	47	9	26	5700	0	5782
4009	21	5622	32	85	0	5760
4010	30	5893	11	44	0	5978
4011	29	139	18	5679	0	5865
4012	27	5743	12	80	0	5862
4013	5594	79	9	19	0	5701
4014	86	5797	12	19	0	5914
4015	5930	86	8	13	0	6037
4016	112	28	5905	5	0	6050
4017	6099	11	98	27	0	6235
4018	6439	8	21	11	0	6479
4019	6458	6	16	13	0	6493
4020	6362	8	14	11	0	6395
4021	146	6200	10	7	0	6363
4022	57	101	13	6352	0	6523
4023	50	28	3	6313	0	6394
4024	29	27	6294	130	0	6480
4025	38	12	103	6118	0	6271
4026	33	15	27	6298	0	6373
4027	6328	12	18	135	0	6493
4028	117	6404	17	48	0	6586
4029	49	115	6	6419	0	6589
4030	37	29	17	6579	0	6662
4031	26	28	12	6643	0	6709
4032	6550	15	20	170	0	6755
4033	137	14	11	6593	0	6755
4034	6632	14	16	162	0	6824
4035	147	14	20	6609	0	6790
4036	50	15	13	6760	0	6838
4037	48	8	6316	167	0	6539
4038	5893	14	134	71	0	6112
4039	157	6316	39	47	0	6559
4040	6538	125	23	44	0	6730
4041	164	26	16	6467	0	6673
4042	71	23	13	6604	0	6711
4043	6619	10	16	175	0	6820
4044	6733	17	11	66	0	6827
4045	189	14	7	6884	0	7094
4046	70	15	6854	174	0	7113
4047	38	15	6684	70	0	6807
4048	34	7107	165	56	0	7362
4049	7202	171	70	41	0	7484
4050	7279	45	31	48	0	7403
4051	223	24	14	7191	0	7452
4052	63	7276	13	207	0	7559
4053	61	193	10	7290	0	7554
4054	54	47	8	7053	0	7162
4055	35	6686	14	246	0	6981
4056	6742	197	20	81	0	7040
4057	218	53	18	6828	0	7117
4058	77	6802	10	212	0	7101
4059	51	7288	19	65	0	7423
4060	7235	220	16	44	0	7515
4061	220	60	7147	50	0	7477
4062	7217	59	186	29	0	7491
4063	238	38	57	7309	0	7642
4064	95	33	25	7387	0	7540
4065	59	7337	34	228	0	7658
4066	82	212	19	7280	0	7593
4067	44	64	7333	239	0	7680
4068	59	7119	194	103	0	7475
4069	48	7318	57	48	0	7471
4070	7128	212	22	60	0	7422
4071	188	7194	32	39	0	7453
4072	85	196	20	7183	0	7484
4073	45	7227	19	201	0	7492
4074	50	199	11	7243	0	7503
4075	49	85	9	7394	0	7537
4076	38	36	7075	288	0	7437
4077	34	64	179	6981	0	7258
4078	39	45	58	7244	0	7386
4079	7050	34	28	288	0	7400
4080	209	44	7010	106	0	7369
4081	96	45	174	7116	0	7431
4082	59	37	7078	255	0	7429
4083	6911	40	198	120	0	7269
4084	221	7180	78	94	0	7573
4085	7521	193	42	124	0	7880
4086	246	70	58	7763	0	8137
4087	124	49	27	7815	0	8015
4088	76	67	7559	314	0	8016
4089	6939	49	223	157	0	7368
4090	245	7651	70	120	0	8086
4091	7613	233	34	131	0	8011
4092	266	86	50	7595	0	7997
4093	130	7693	35	254	0	8112
4094	7690	245	20	136	0	8091
4095	264	7969	34	82	0	8349
4096	116	240	21	8017	0	8394
4097	70	107	30	8173	0	8380
4098	83	66	38	8071	0	8258
4099	73	7789	38	322	0	8222
4100	68	237	31	7979	0	8315
4101	76	111	36	8115	0	8338
4102	7720	80	25	361	0	8186
4103	7856	78	23	183	0	8140
4104	7876	62	25	139	0	8102
4105	314	73	7668	116	0	8171
4106	7756	54	228	116	0	8154
4107	8064	71	79	91	0	8305
4108	7771	87	40	95	0	7993
4109	319	88	7369	99	0	7875
4110	7539	62	185	108	0	7894
4111	294	61	66	7760	0	8181
4112	153	73	7589	278	0	8093
4113	99	7519	226	147	0	7991
4114	96	290	79	7234	0	7699
4115	64	7133	42	259	0	7498
4116	66	7375	52	127	0	7620
4117	6933	247	46	100	0	7326
4118	219	92	30	6947	0	7288
4119	6999	49	33	222	0	7303
4120	242	47	29	6983	0	7301
4121	7025	30	28	220	0	7303
4122	239	32	34	7000	0	7305
4123	7019	38	33	228	0	7318
4124	241	43	6682	108	0	7074
4125	143	53	174	6725	0	7095
4126	82	41	6806	229	0	7158
4127	88	46	6449	107	0	6690
4128	62	41	6731	82	0	6916
4129	61	66	210	6583	0	6920
4130	55	46	6691	208	0	7000
4131	6502	55	180	112	0	6849
4132	196	41	74	6679	0	6990
4133	92	48	6953	220	0	7313
4134	66	44	167	6932	0	7209
4135	83	34	64	7117	0	7298
4136	63	24	7310	265	0	7662
4137	60	29	179	7220	0	7488
4138	78	27	65	7182	0	7352
4139	60	7228	53	234	0	7575
4140	7265	152	39	126	0	7582
4141	7357	55	52	79	0	7543
4142	251	24	7060	85	0	7420
4143	6895	36	184	72	0	7187
4144	214	18	6777	60	0	7069
4145	98	19	6338	48	0	6503
4146	60	13	6476	56	0	6605
4147	75	150	195	6105	0	6525
4148	46	11	6358	123	0	6538
4149	45	20	98	6114	0	6277
4150	33	9	57	6082	0	6181
4151	28	12	43	6162	0	6245
4152	31	15	24	6191	0	6261
4153	6030	14	29	152	0	6225
4154	6055	16	31	82	0	6184
4155	123	6149	20	60	0	6352
4156	61	84	18	6255	0	6418
4157	42	45	6383	106	0	6576
4158	52	6416	104	47	0	6619
4159	39	107	54	6605	0	6805
4160	40	30	6677	131	0	6878
4161	33	29	128	6375	0	6565
4162	23	16	6519	137	0	6695
4163	25	6	6439	66	0	6536
4164	17	14	150	6576	0	6757
4165	27	9	69	6605	0	6710
4166	6626	8	51	174	0	6859
4167	115	5	27	6593	0	6740
4168	6468	8	29	163	0	6668
4169	124	6321	20	98	0	6563
4170	52	6567	22	62	0	6703
4171	59	132	15	6706	0	6912
4172	6714	60	22	123	0	6919
4173	117	6762	21	67	0	6967
4174	48	111	28	6946	0	7133
4175	7026	45	30	148	0	7249
4176	7114	38	20	64	0	7236
4177	6912	23	31	63	0	7029
4178	6919	9	33	48	0	7009
4179	7195	14	21	44	0	7274
4180	170	10	6920	38	0	7138
4181	70	11	6750	36	0	6867
4182	44	6830	119	44	0	7037
4183	47	113	63	6828	0	7051
4184	22	37	7062	104	0	7225
4185	32	27	6769	37	0	6865
4186	14	29	112	6628	0	6783
4187	13	12	7130	93	0	7248
4188	13	15	6975	53	0	7056
4189	14	9105	129	34	0	9282
4190	9109	217	52	32	0	9410
4191	202	10011	34	35	0	10282
4192	57	252	24	10234	0	10567
4193	10365	53	35	258	0	10711
4194	253	10534	34	68	0	10889
4195	61	252	28	10370	0	10711
4196	56	61	10413	267	0	10797
4197	10311	46	259	76	0	10692
4198	10759	24	54	62	0	10899
4199	10982	15	45	44	0	11086
4200	354	23	24	10725	0	11126
4201	99	36	10792	285	0	11212
4202	64	10754	269	78	0	11165
4203	49	264	55	10945	0	11313
4204	10901	60	52	282	0	11295
4205	314	52	10766	63	0	11195
4206	87	10464	265	58	0	10874
4207	72	260	10783	34	0	11149
4208	10452	67	299	41	0	10859
4209	11179	56	75	37	0	11347
4210	11221	24	48	42	0	11335
4211	380	33	10738	24	0	11175
4212	108	10525	291	37	0	10961
4213	72	275	92	10631	0	11070
4214	53	60	83	10935	0	11131
4215	54	40	59	11033	0	11186
4216	54	43	10565	358	0	11020
4217	10263	18	298	148	0	10727
4218	316	34	10709	75	0	11134
4219	10710	37	319	64	0	11130
4220	11109	36	89	64	0	11298
4221	11176	41	62	54	0	11333
4222	11023	39	42	63	0	11167
4223	399	54	10794	37	0	11284
4224	166	46	304	10720	0	11236
4225	116	61	10624	308	0	11109
4226	114	10270	302	106	0	10792
4227	92	10928	86	90	0	11196
4228	10766	339	75	83	0	11263
4229	10569	126	57	73	0	10825
4230	360	10893	78	81	0	11412
4231	11018	330	62	80	0	11490
4232	418	121	9488	83	0	10110
4233	10472	86	239	67	0	10864
4234	399	10876	95	66	0	11436
4235	11186	327	86	72	0	11671
4236	11086	106	79	59	0	11330
4237	486	86	67	10675	0	11314
4238	212	58	78	10999	0	11347
4239	10809	68	94	401	0	11372
4240	416	76	79	10827	0	11398
4241	10847	71	81	397	0	11396
4242	469	64	76	10826	0	11435
4243	10678	65	85	401	0	11229
4244	10769	66	77	136	0	11048
4245	475	10296	99	105	0	10975
4246	214	10868	78	96	0	11256
4247	10442	385	84	89	0	11000
4248	411	10711	75	83	0	11280
4249	184	391	90	10534	0	11199
4250	193	124	95	10839	0	11251
4251	10385	108	91	436	0	11020
4252	404	10410	88	194	0	11096
4253	218	10237	91	140	0	10686
4254	196	10540	95	114	0	10945
4255	202	421	10138	122	0	10883
4256	206	131	10153	123	0	10613
4257	204	120	10227	106	0	10657
4258	202	260	380	8853	0	9695
4259	167	9722	149	320	0	10358
4260	9811	344	97	143	0	10395
4261	437	132	9613	128	0	10310
4262	218	110	9580	102	0	10010
4263	200	95	9890	94	0	10279
4264	194	82	413	9564	0	10253
4265	190	96	150	9785	0	10221
4266	177	109	97	9935	0	10318
4267	9777	87	89	397	0	10350
4268	9851	92	99	134	0	10176
4269	9999	93	110	103	0	10305
4270	474	91	102	9549	0	10216
4271	196	67	9340	336	0	9939
4272	173	100	9550	122	0	9945
4273	177	80	355	9383	0	9995
4274	194	63	130	9457	0	9844
4275	9223	64	112	377	0	9776
4276	418	9117	80	163	0	9778
4277	9164	290	84	142	0	9680
4278	407	9067	89	140	0	9703
4279	206	319	70	9077	0	9672
4280	174	106	9006	379	0	9665
4281	197	99	304	8976	0	9576
4282	9110	73	103	370	0	9656
4283	405	69	8894	159	0	9527
4284	8649	62	295	131	0	9137
4285	440	60	8613	95	0	9208
4286	235	79	8426	92	0	8832
4287	7932	70	324	96	0	8422
4288	383	66	8084	93	0	8626
4289	105	23	5894	44	0	6066
4290	122	5752	186	40	0	6100
4291	4984	142	156	57	0	5339
4292	4752	44	34	27	0	4857
4293	4757	21	13	19	0	4810
4294	90	20	4526	20	0	4656
4295	4375	10	71	23	0	4479
4296	82	4525	27	20	0	4654
4297	4492	67	19	19	0	4597
4298	87	22	4484	20	0	4613
4299	48	32	70	4256	0	4406
4300	18	13	4287	60	0	4378
4301	26	4209	71	20	0	4326
4302	22	39	42	4045	0	4148
4303	21	9	10	4113	0	4153
4304	4195	6	19	58	0	4278
4305	4136	4	14	23	0	4177
4306	4131	4	9	14	0	4158
4307	4114	7	5	12	0	4138
4308	4069	3	7	9	0	4088
4309	67	6	4047	8	0	4128
4310	32	2	52	3960	0	4046
4311	18	9	4189	49	0	4265
4312	15	5	52	4210	0	4282
4313	4301	4	17	65	0	4387
4314	4386	6	9	30	0	4431
4315	4409	7	13	11	0	4440
4316	4420	7	12	14	0	4453
4317	84	8	4553	6	0	4651
4318	21	5	56	4445	0	4527
4319	21	3	4472	63	0	4559
4320	21	4500	66	21	0	4608
4321	23	4469	23	17	0	4532
4322	25	72	20	4331	0	4448
4323	23	26	14	4911	0	4974
4324	22	12	18	4928	0	4980
4325	16	10	14	5362	0	5402
4326	5262	7	12	129	0	5410
4327	91	5230	17	57	0	5395
4328	5136	81	10	30	0	5257
4329	109	28	8	5134	0	5279
4330	53	19	6	5037	0	5115
4331	31	5113	13	110	0	5267
4332	35	86	9	5115	0	5245
4333	5061	31	12	109	0	5213
4334	100	4756	8	48	0	4912
4335	33	4675	9	32	0	4749
4336	4652	93	5	29	0	4779
4337	92	38	7	4649	0	4786
4338	40	4636	7	97	0	4780
4339	27	92	6	4718	0	4843
4340	4732	35	7	108	0	4882
4341	100	22	9	4697	0	4828
4342	43	22	6	4768	0	4839
4343	4697	18	10	123	0	4848
4344	93	23	6	4659	0	4781
4345	39	4678	4	109	0	4830
4346	32	83	4	4674	0	4793
4347	24	4643	6	115	0	4788
4348	24	94	6	4688	0	4812
4349	4647	30	6	119	0	4802
4350	4712	21	8	49	0	4790
4351	118	21	4	4688	0	4831
4352	53	16	4599	105	0	4773
4353	4467	21	83	54	0	4625
4354	95	18	4593	42	0	4748
4355	4527	21	93	38	0	4679
4356	4618	13	26	34	0	4691
4357	122	20	4469	29	0	4640
4358	53	4432	80	26	0	4591
4359	4432	84	35	36	0	4587
4360	4493	33	18	32	0	4576
4361	116	22	4591	23	0	4752
4362	4520	10	79	26	0	4635
4363	4493	10	32	28	0	4563
4364	4516	15	21	22	0	4574
4365	129	9	12	4431	0	4581
4366	59	7	15	4479	0	4560
4367	37	4456	12	108	0	4613
4368	38	85	12	4543	0	4678
4369	38	29	10	4537	0	4614
4370	30	19	4419	117	0	4585
4371	25	19	4237	56	0	4337
4372	4032	14	94	49	0	4189
4373	4280	11	34	34	0	4359
4374	109	4230	19	35	0	4393
4375	52	86	12	4277	0	4427
4376	34	34	4421	95	0	4584
4377	32	16	95	4392	0	4535
4378	34	12	40	4397	0	4483
4379	33	14	21	4642	0	4710
4380	28	4604	19	145	0	4796
4381	30	104	9	4706	0	4849
4382	29	46	9	4815	0	4899
4383	31	26	4668	139	0	4864
4384	26	18	4680	70	0	4794
4385	4492	13	131	50	0	4686
4386	4720	14	47	40	0	4821
4387	143	16	19	4957	0	5135
4388	57	14	16	4909	0	4996
4389	32	15	22	5051	0	5120
4390	29	11	4721	194	0	4955
4391	29	4607	129	92	0	4857
4392	32	127	4667	58	0	4884
4393	4571	49	144	47	0	4811
4394	146	26	4686	43	0	4901
4395	4628	18	146	44	0	4836
4396	4562	19	55	37	0	4673
4397	4756	14	33	39	0	4842
4398	188	20	27	4599	0	4834
4399	74	15	4591	148	0	4828
4400	52	4597	140	68	0	4857
4401	45	124	57	4495	0	4721
4402	39	51	32	4661	0	4783
4403	30	20	4810	178	0	5038
4404	34	4693	152	78	0	4957
4405	4835	147	64	53	0	5099
4406	171	5072	40	39	0	5322
4407	5440	189	27	49	0	5705
4408	227	78	33	5446	0	5784
4409	92	29	5570	216	0	5907
4410	57	5600	227	82	0	5966
4411	5677	231	67	64	0	6039
4412	262	82	5676	43	0	6063
4413	5657	64	226	38	0	5985
4414	5827	22	84	48	0	5981
4415	301	26	5610	54	0	5991
4416	5541	32	250	23	0	5846
4417	5629	38	90	32	0	5789
4418	5567	21	65	25	0	5678
4419	327	5332	58	19	0	5736
4420	5202	212	29	23	0	5466
4421	282	5180	37	18	0	5517
4422	112	215	5168	22	0	5517
4423	103	5085	187	27	0	5402
4424	4727	214	100	31	0	5072
4425	4823	70	40	16	0	4949
4426	4895	54	27	20	0	4996
4427	279	25	24	4642	0	4970
4428	95	39	28	4833	0	4995
4429	4531	34	44	227	0	4836
4430	4800	37	17	73	0	4927
4431	274	23	17	4617	0	4931
4432	129	18	4569	180	0	4896
4433	76	4355	169	74	0	4674
4434	49	4685	62	65	0	4861
4435	60	209	29	4557	0	4855
4436	65	67	4614	174	0	4920
4437	56	48	169	4386	0	4659
4438	52	4518	68	197	0	4835
4439	53	177	52	4572	0	4854
4440	54	79	4517	193	0	4843
4441	38	61	174	4576	0	4849
4442	45	23	4820	224	0	5112
4443	50	31	210	4766	0	5057
4444	50	39	4934	225	0	5248
4445	42	48	4938	89	0	5117
4446	4731	28	244	68	0	5071
4447	4967	32	106	38	0	5143
4448	5017	36	60	48	0	5161
4449	262	4841	63	41	0	5207
4450	122	173	48	4954	0	5297
4451	4711	63	62	206	0	5042
4452	5091	51	48	75	0	5265
4453	5057	31	30	69	0	5187
4454	279	33	4919	38	0	5269
4455	134	4610	190	42	0	4976
4456	94	5089	75	35	0	5293
4457	4948	206	63	64	0	5281
4458	241	82	47	4899	0	5269
4459	4952	53	44	188	0	5237
4460	261	42	4843	66	0	5212
4461	117	42	196	4779	0	5134
4462	90	57	72	4946	0	5165
4463	95	52	50	4812	0	5009
4464	86	4908	39	237	0	5270
4465	4864	188	48	115	0	5215
4466	4998	79	47	62	0	5186
4467	263	4885	60	50	0	5258
4468	119	192	38	4862	0	5211
4469	4878	77	49	217	0	5221
4470	228	63	37	4903	0	5231
4471	4867	53	31	218	0	5169
4472	261	4828	29	86	0	5204
4473	4878	203	26	62	0	5169
4474	259	91	4713	59	0	5122
4475	127	4718	184	62	0	5091
4476	106	188	4659	57	0	5010
4477	95	148	197	4561	0	5001
4478	4546	60	71	183	0	4860
4479	4665	49	55	56	0	4825
4480	4628	39	31	55	0	4753
4481	265	48	50	4385	0	4748
4482	4446	51	39	197	0	4733
4483	239	31	47	4416	0	4733
4484	4412	26	21	244	0	4703
4485	4561	28	37	90	0	4716
4486	266	27	4406	79	0	4778
4487	120	20	4110	48	0	4298
4488	69	20	4109	58	0	4256
4489	73	44	168	3942	0	4227
4490	4027	24	83	162	0	4296
4491	188	20	40	4061	0	4309
4492	96	22	36	4178	0	4332
4493	4276	23	48	201	0	4548
4494	4364	17	49	80	0	4510
4495	4394	11	39	72	0	4516
4496	4457	10	25	55	0	4547
4497	197	16	27	4337	0	4577
4498	4296	25	24	161	0	4506
4499	176	4233	27	74	0	4510
4500	4332	130	20	49	0	4531
4501	4379	36	29	51	0	4495
4502	216	27	4107	30	0	4380
4503	3807	14	110	41	0	3972
4504	162	10	3796	37	0	4005
4505	62	5	3515	26	0	3608
4506	51	13	3510	25	0	3599
4507	43	90	56	2941	0	3130
4508	21	11	3051	39	0	3122
4509	18	20	33	2842	0	2913
4510	14	4	2970	32	0	3020
4511	15	4	3103	13	0	3135
4512	21	3	24	2985	0	3033
4513	14	2	9	3126	0	3151
4514	12	1	3291	25	0	3329
4515	3165	4	22	15	0	3206
4516	34	1	11	3289	0	3335
4517	15	0	7	3343	0	3365
4518	3354	2	4	31	0	3391
4519	28	2	8	3414	0	3452
4520	10	1	3375	33	0	3419
4521	13	1	3179	15	0	3208
4522	12	8	29	3202	0	3251
4523	6	1	3303	26	0	3336
4524	6	3361	32	10	0	3409
4525	11	19	11	3282	0	3323
4526	3365	8	10	29	0	3412
4527	24	2	3376	14	0	3416
4528	3253	1	24	14	0	3292
4529	24	0	15	3473	0	3512
4530	18	0	8	3517	0	3543
4531	7	2	6	3525	0	3540
4532	7	1	6	3504	0	3518
4533	3525	1	6	40	0	3572
4534	26	3797	9	21	0	3853
4535	17	37	6	3895	0	3955
4536	14	11	3	3890	0	3918
4537	10	6	5	3888	0	3909
4538	12	2	7	3877	0	3898
4539	3814	2	3	74	0	3893
4540	40	3798	7	34	0	3879
4541	3777	36	11	8	0	3832
4542	39	3493	4	17	0	3553
4543	15	3598	8	8	0	3629
4544	3503	51	4	8	0	3566
4545	40	14	3586	11	0	3651
4546	18	4	45	3573	0	3640
4547	3657	1	19	52	0	3729
4548	3715	0	8	28	0	3751
4549	3177	30	12	41	0	3260
4550	3790	2	8	20	0	3820
4551	55	3968	2	23	0	4048
4552	4013	52	5	17	0	4087
4553	4115	17	2	20	0	4154
4554	67	4271	3	15	0	4356
4555	25	64	4	4422	0	4515
4556	9	17	4410	85	0	4521
4557	12	7	77	4385	0	4481
4558	4330	7	22	97	0	4456
4559	81	5	4474	30	0	4590
4560	23	4370	81	20	0	4494
4561	16	84	4515	12	0	4627
4562	10	22	87	4204	0	4323
4563	9	4333	27	73	0	4442
4564	4353	79	9	36	0	4477
4565	84	4408	6	20	0	4518
4566	24	86	5	4411	0	4526
4567	15	21	4	4561	0	4601
4568	4459	10	8	104	0	4581
4569	96	8	6	4345	0	4455
4570	33	4393	5	84	0	4515
4571	4392	84	8	37	0	4521
4572	4432	25	5	25	0	4487
4573	105	4459	6	22	0	4592
4574	4447	92	6	13	0	4558
4575	87	4412	9	21	0	4529
4576	4371	92	11	23	0	4497
4577	100	4425	8	24	0	4557
4578	40	91	7	4224	0	4362
4579	28	28	11	4503	0	4570
4580	4414	25	9	106	0	4554
4581	4477	12	14	38	0	4541
4582	109	4466	8	24	0	4607
4583	43	95	4385	14	0	4537
4584	4488	31	86	17	0	4622
4585	109	18	26	4526	0	4679
4586	32	4537	18	105	0	4692
4587	37	89	3	4614	0	4743
4588	4616	27	5	102	0	4750
4589	4678	24	8	36	0	4746
4590	4702	19	6	31	0	4758
4591	134	17	9	4620	0	4780
4592	58	12	4557	100	0	4727
4593	4303	24	86	40	0	4453
4594	4378	30	22	21	0	4451
4595	4469	23	15	20	0	4527
4596	123	4358	14	19	0	4514
4597	44	88	11	4372	0	4515
4598	34	4478	7	102	0	4621
4599	28	109	14	4514	0	4665
4600	40	37	6	4585	0	4668
4601	28	21	4729	131	0	4909
4602	28	21	118	5072	0	5239
4603	29	21	28	5301	0	5379
4604	5261	15	19	172	0	5467
4605	160	5294	7	57	0	5518
4606	5311	167	4	30	0	5512
4607	5636	47	8	32	0	5723
4608	214	29	7	5487	0	5737
4609	86	22	5478	173	0	5759
4610	51	5244	156	51	0	5502
4611	41	5308	42	33	0	5424
4612	5133	190	30	27	0	5380
4613	164	5261	17	34	0	5476
4614	70	174	14	5089	0	5347
4615	40	52	9	5319	0	5420
4616	35	40	5104	203	0	5382
4617	33	29	5158	58	0	5278
4618	31	5088	177	39	0	5335
4619	35	170	48	5110	0	5363
4620	5075	51	23	170	0	5319
4621	169	38	14	5198	0	5419
4622	60	21	5253	188	0	5522
4623	44	32	162	5196	0	5434
4624	5094	25	38	192	0	5349
4625	5153	25	31	63	0	5272
4626	194	5112	17	45	0	5368
4627	5061	172	14	44	0	5291
4628	193	5105	17	31	0	5346
4629	5105	183	12	34	0	5334
4630	194	62	15	5019	0	5290
4631	61	35	4942	186	0	5224
4632	53	30	4843	52	0	4978
4633	36	4925	178	39	0	5178
4634	62	158	69	4601	0	4890
4635	33	44	22	4831	0	4930
4636	4756	19	16	189	0	4980
4637	4849	28	11	62	0	4950
4638	4936	23	12	50	0	5021
4639	196	35	14	4831	0	5076
4640	80	25	8	4985	0	5098
4641	55	26	11	5042	0	5134
4642	38	24	4876	194	0	5132
4643	34	30	4820	70	0	4954
4644	4742	24	172	45	0	4983
4645	4776	28	46	45	0	4895
4646	183	24	4764	34	0	5005
4647	4662	27	153	38	0	4880
4648	4632	28	42	46	0	4748
4649	170	16	4573	44	0	4803
4650	69	4534	150	42	0	4795
4651	38	129	51	4429	0	4647
4652	41	39	4495	152	0	4727
4653	44	4650	131	60	0	4885
4654	47	149	32	4257	0	4485
4655	43	4449	20	124	0	4636
4656	35	135	4338	60	0	4568
4657	39	38	4407	40	0	4524
4658	43	66	153	4333	0	4595
4659	4382	24	63	149	0	4618
4660	142	24	38	4356	0	4560
4661	4345	33	16	141	0	4535
4662	148	24	17	4351	0	4540
4663	61	21	4301	146	0	4529
4664	4155	23	133	63	0	4374
4665	141	19	4293	40	0	4493
4666	4290	27	136	41	0	4494
4667	155	20	52	4210	0	4437
4668	49	4260	33	149	0	4491
4669	43	133	26	4292	0	4494
4670	32	4422	31	148	0	4633
4671	51	129	29	4267	0	4476
4672	46	4443	27	136	0	4652
4673	4421	136	30	66	0	4653
4674	4515	40	21	55	0	4631
4675	4486	24	26	48	0	4584
4676	182	22	4341	32	0	4577
4677	77	27	131	4351	0	4586
4678	55	22	4430	147	0	4654
4679	48	4222	147	55	0	4472
4680	48	4445	59	41	0	4593
4681	4331	143	40	35	0	4549
4682	139	58	4347	39	0	4583
4683	62	4298	136	27	0	4523
4684	41	131	48	4361	0	4581
4685	4316	56	45	153	0	4570
4686	131	4388	34	65	0	4618
4687	4469	148	22	45	0	4684
4688	171	54	4418	40	0	4683
4689	70	33	144	4510	0	4757
4690	53	22	58	4667	0	4800
4691	46	18	38	4790	0	4892
4692	42	4724	37	192	0	4995
4693	53	153	44	4515	0	4765
4694	38	50	4807	182	0	5077
4695	46	26	159	4747	0	4978
4696	38	27	68	4887	0	5020
4697	39	30	47	4839	0	4955
4698	44	4668	26	200	0	4938
4699	41	144	33	4663	0	4881
4700	48	56	30	4706	0	4840
4701	26	4361	17	194	0	4598
4702	3954	104	12	69	0	4139
4703	94	3933	18	43	0	4088
4704	41	3946	18	33	0	4038
4705	46	142	13	3845	0	4046
4706	21	38	3822	101	0	3982
4707	3421	32	85	43	0	3581
4708	89	13	28	3666	0	3796
4709	36	17	3614	86	0	3753
4710	11	3614	82	51	0	3758
4711	19	85	32	3628	0	3764
4712	11	30	3722	95	0	3858
4713	26	24	84	3582	0	3716
4714	19	15	25	3644	0	3703
4715	3560	16	18	101	0	3695
4716	79	3581	13	47	0	3720
4717	3551	82	16	26	0	3675
4718	89	27	3567	24	0	3707
4719	29	3586	81	15	0	3711
4720	24	85	3604	11	0	3724
4721	8	63	84	3582	0	3737
4722	3559	20	36	83	0	3698
4723	71	11	21	3564	0	3667
4724	3557	10	8	103	0	3678
4725	3647	7	17	35	0	3706
4726	105	10	6	3626	0	3747
4727	40	8	3802	92	0	3942
4728	25	10	3921	39	0	3995
4729	17	10	105	4019	0	4151
4730	12	6	41	4144	0	4203
4731	4065	8	25	122	0	4220
4732	95	9	12	4082	0	4198
4733	34	3996	19	104	0	4153
4734	28	89	8	4090	0	4215
4735	21	30	11	4173	0	4235
4736	4067	18	8	140	0	4233
4737	97	4112	10	55	0	4274
4738	31	98	10	4146	0	4285
4739	23	31	12	4154	0	4220
4740	9	4046	10	147	0	4212
4741	17	89	10	4137	0	4253
4742	14	35	11	4122	0	4182
4743	11	3997	7	146	0	4161
4744	14	106	7	4067	0	4194
4745	13	28	11	4079	0	4131
4746	13	3971	15	136	0	4135
4747	11	109	7	4062	0	4189
4748	3983	38	11	140	0	4172
4749	4057	29	2	71	0	4159
4750	3960	25	9	46	0	4040
4751	3980	17	9	53	0	4059
4752	143	3788	7	46	0	3984
4753	3546	88	5	35	0	3674
4754	105	3455	8	26	0	3594
4755	33	3506	10	24	0	3573
4756	27	108	16	3457	0	3608
4757	14	36	3463	100	0	3613
4758	3332	21	82	45	0	3480
4759	3520	19	25	31	0	3595
4760	109	18	3596	37	0	3760
4761	3547	9	80	32	0	3668
4762	3759	19	21	27	0	3826
4763	126	3603	15	23	0	3767
4764	4003	92	10	42	0	4147
4765	108	33	9	3982	0	4132
4766	45	22	12	4052	0	4131
4767	35	20	11	4094	0	4160
4768	24	26	8	4079	0	4137
4769	3977	13	8	140	0	4138
4770	102	10	11	3927	0	4050
4771	43	12	10	3987	0	4052
4772	32	15	3839	128	0	4014
4773	3453	21	80	69	0	3623
4774	3858	15	27	41	0	3941
4775	3883	13	14	36	0	3946
4776	123	3760	12	31	0	3926
4777	46	3888	8	37	0	3979
4778	3841	100	5	37	0	3983
4779	111	40	11	3818	0	3980
4780	44	3917	8	108	0	4077
4781	39	99	2	3920	0	4060
4782	17	3943	10	116	0	4086
4783	3917	96	8	50	0	4071
4784	97	3980	11	64	0	4152
4785	47	107	8	3932	0	4094
4786	40	27	9	3982	0	4058
4787	35	35	4059	117	0	4246
4788	39	4256	84	45	0	4424
4789	42	124	21	4368	0	4555
4790	26	42	4485	117	0	4670
4791	24	28	4598	42	0	4692
4792	27	18	130	4636	0	4811
4793	22	10	41	4701	0	4774
4794	25	4475	17	164	0	4681
4795	17	4747	18	57	0	4839
4796	16	152	13	4726	0	4907
4797	4711	45	10	154	0	4920
4798	123	31	8	4979	0	5141
4799	5007	28	12	168	0	5215
4800	5219	22	8	66	0	5315
4801	5305	16	14	51	0	5386
4802	184	20	5236	38	0	5478
4803	5162	16	123	43	0	5344
4804	161	20	37	5234	0	5452
4805	73	20	23	5293	0	5409
4806	44	13	5184	174	0	5415
4807	34	13	5204	72	0	5323
4808	34	20	145	5024	0	5223
4809	27	4901	48	144	0	5120
4810	26	5166	22	60	0	5274
4811	46	138	18	5110	0	5312
4812	5030	44	23	146	0	5243
4813	136	24	14	5084	0	5258
4814	48	20	9	5066	0	5143
4815	43	5040	14	152	0	5249
4816	33	125	27	5085	0	5270
4817	41	42	5114	152	0	5349
4818	23	22	4894	83	0	5022
4819	4855	21	137	58	0	5071
4820	115	5049	54	46	0	5264
4821	5075	129	37	42	0	5283
4822	5195	45	26	42	0	5308
4823	155	38	26	4891	0	5110
4824	56	5093	18	124	0	5291
4825	43	135	8	5166	0	5352
4826	5197	46	9	143	0	5395
4827	133	5079	16	66	0	5294
4828	4905	110	13	47	0	5075
4829	122	4874	14	36	0	5046
4830	4941	123	6	45	0	5115
4831	4979	41	20	31	0	5071
4832	140	4875	24	19	0	5058
4833	67	110	15	4881	0	5073
4834	4893	52	8	115	0	5068
4835	139	22	4675	39	0	4875
4836	66	22	4667	25	0	4780
4837	44	48	119	4640	0	4851
4838	4750	21	37	122	0	4930
4839	111	16	16	4739	0	4882
4840	4741	20	24	115	0	4900
4841	124	25	4808	43	0	5000
4842	4847	19	102	47	0	5015
4843	5148	19	34	39	0	5240
4844	155	18	20	5013	0	5206
4845	72	19	16	5108	0	5215
4846	49	18	17	5087	0	5171
4847	46	5027	18	141	0	5232
4848	42	102	16	5055	0	5215
4849	29	32	19	5209	0	5289
4850	5091	17	22	155	0	5285
4851	5131	10	23	80	0	5244
4852	148	18	5031	42	0	5239
4853	4954	16	100	48	0	5118
4854	139	19	5046	49	0	5253
4855	4729	15	114	47	0	4905
4856	144	16	4950	29	0	5139
4857	68	19	4885	37	0	5009
4858	48	25	108	4833	0	5014
4859	39	24	4870	126	0	5059
4860	4709	13	105	74	0	4901
4861	112	18	53	5009	0	5192
4862	5090	18	35	129	0	5272
4863	5187	10	24	73	0	5294
4864	4912	21	29	37	0	4999
4865	4878	15	20	32	0	4945
4866	158	9	4805	34	0	5006
4867	88	13	106	4798	0	5005
4868	58	10	4891	112	0	5071
4869	54	10	112	4874	0	5050
4870	4905	16	55	118	0	5094
4871	106	8	44	4940	0	5098
4872	4986	13	28	135	0	5162
4873	121	14	34	5007	0	5176
4874	68	13	18	5114	0	5213
4875	5043	18	16	150	0	5227
4876	131	4976	22	59	0	5188
4877	4968	96	19	50	0	5133
4878	125	4948	17	49	0	5139
4879	65	109	18	5031	0	5223
4880	4948	35	23	119	0	5125
4881	120	27	4917	65	0	5129
4882	56	24	98	4961	0	5139
4883	4971	18	34	136	0	5159
4884	5046	16	22	69	0	5153
4885	161	16	16	4969	0	5162
4886	73	4958	19	126	0	5176
4887	51	4941	17	60	0	5069
4888	73	191	16	4567	0	4847
4889	4678	40	13	95	0	4826
4890	93	4423	8	43	0	4567
4891	35	4158	12	21	0	4226
4892	4090	72	18	22	0	4202
4893	66	4071	10	11	0	4158
4894	4202	63	17	19	0	4301
4895	74	21	11	4138	0	4244
4896	31	13	5	4185	0	4234
4897	32	4053	5	70	0	4160
4898	22	3999	3	41	0	4065
4899	3763	58	2	28	0	3851
4900	52	3844	5	14	0	3915
4901	17	4118	2	12	0	4149
4902	29	87	8	4094	0	4218
4903	4197	36	0	81	0	4314
4904	82	28	4389	22	0	4521
4905	4377	11	93	22	0	4503
4906	109	7	31	4800	0	4947
4907	41	7	4842	112	0	5002
4908	29	8	4938	45	0	5020
4909	20	7	148	5044	0	5219
4910	17	12	5221	122	0	5372
4911	5166	12	153	58	0	5389
4912	5335	3	59	49	0	5446
4913	170	8	5297	28	0	5503
4914	74	5	149	5197	0	5425
4915	49	15	64	5269	0	5397
4916	5358	6	47	193	0	5604
4917	154	4	39	5089	0	5286
4918	65	5155	45	163	0	5428
4919	5273	123	26	76	0	5498
4920	157	5125	28	61	0	5371
4921	67	5388	30	39	0	5524
4922	53	169	31	5243	0	5496
4923	46	73	16	5344	0	5479
4924	32	51	19	5412	0	5514
4925	46	29	5131	200	0	5406
4926	4714	27	132	110	0	4983
4927	134	4919	59	95	0	5207
4928	5071	148	37	62	0	5318
4929	5180	65	27	64	0	5336
4930	216	55	15	5031	0	5317
4931	92	5026	18	178	0	5314
4932	68	160	19	5191	0	5438
4933	60	60	20	5308	0	5448
4934	5276	60	19	221	0	5576
4935	5283	43	23	114	0	5463
4936	199	32	5078	87	0	5396
4937	5236	30	117	77	0	5460
4938	206	5361	40	58	0	5665
4939	5415	157	49	48	0	5669
4940	205	5727	17	53	0	6002
4941	99	206	11	5592	0	5908
4942	87	89	11	5584	0	5771
4943	71	5583	19	211	0	5884
4944	61	178	16	5758	0	6013
4945	59	90	12	5846	0	6007
4946	55	54	20	5770	0	5899
4947	58	5578	14	257	0	5907
4948	54	175	19	5708	0	5956
4949	61	82	14	5794	0	5951
4950	38	72	22	5856	0	5988
4951	54	53	5524	273	0	5904
4952	5321	59	161	151	0	5692
4953	198	46	5522	123	0	5889
4954	5489	48	186	100	0	5823
4955	221	31	5618	92	0	5962
4956	5561	30	192	99	0	5882
4957	5755	47	81	73	0	5956
4958	240	34	5639	84	0	5997
4959	124	32	179	5579	0	5914
4960	97	38	5257	209	0	5601
4961	5220	41	190	100	0	5551
4962	209	36	5609	100	0	5954
4963	101	34	5568	89	0	5792
4964	5502	29	224	71	0	5826
4965	210	5574	131	59	0	5974
4966	131	164	75	5618	0	5988
4967	5703	72	84	195	0	6054
4968	231	50	47	5720	0	6048
4969	101	49	76	5874	0	6100
4970	5756	26	54	251	0	6087
4971	5823	32	50	137	0	6042
4972	253	27	5670	98	0	6048
4973	147	29	5700	107	0	5983
4974	118	24	236	5721	0	6099
4975	98	26	5833	224	0	6181
4976	76	24	240	5800	0	6140
4977	75	33	127	5776	0	6011
4978	101	20	84	6006	0	6211
4979	5729	38	63	297	0	6127
4980	216	5839	57	159	0	6271
4981	5867	171	50	141	0	6229
4982	5929	78	53	124	0	6184
4983	267	5810	39	134	0	6250
4984	5756	168	57	113	0	6094
4985	244	73	5657	96	0	6070
4986	113	72	160	5649	0	5994
4987	5755	55	86	210	0	6106
4988	210	54	5466	126	0	5856
4989	5436	43	154	100	0	5733
4990	200	5787	60	109	0	6156
4991	6521	137	53	90	0	6801
4992	6586	62	53	100	0	6801
4993	295	6601	57	62	0	7015
4994	6819	191	45	75	0	7130
4995	288	89	59	6811	0	7247
4996	198	61	41	6994	0	7294
4997	6879	58	46	261	0	7244
4998	6740	30	42	156	0	6968
4999	312	6749	43	106	0	7210
5000	139	6810	40	89	0	7078
5001	115	232	25	6281	0	6653
5002	79	6348	33	167	0	6627
5003	76	6594	29	100	0	6799
5004	6145	175	42	74	0	6436
5005	178	6215	30	55	0	6478
5006	5862	146	26	32	0	6066
5007	159	6047	20	40	0	6266
5008	97	140	5938	35	0	6210
5009	61	5985	101	43	0	6190
5010	5861	171	60	58	0	6150
5011	5814	51	32	41	0	5938
5012	157	45	5777	22	0	6001
5013	91	30	112	5518	0	5751
5014	65	24	50	5901	0	6040
5015	47	17	5829	137	0	6030
5016	36	24	112	5629	0	5801
5017	30	18	5795	143	0	5986
5018	25	19	5619	76	0	5739
5019	5565	21	130	65	0	5781
5020	121	5707	63	41	0	5932
5021	5735	108	48	29	0	5920
5022	143	50	26	5770	0	5989
5023	80	42	5847	111	0	6080
5024	69	33	105	5577	0	5784
5025	43	5837	55	107	0	6042
5026	5952	94	44	51	0	6141
5027	5976	42	33	43	0	6094
5028	151	41	24	5961	0	6177
5029	81	25	5844	122	0	6072
5030	5617	27	97	53	0	5794
5031	142	5810	32	44	0	6028
5032	5868	109	36	29	0	6042
5033	161	54	30	5774	0	6019
5034	5799	46	17	115	0	5977
5035	167	44	17	5732	0	5960
5036	90	39	5708	129	0	5966
5037	77	27	5448	83	0	5635
5038	5399	20	124	87	0	5630
5039	138	5703	59	54	0	5954
5040	5539	92	47	31	0	5709
5041	5563	51	16	29	0	5659
5042	117	5600	15	37	0	5769
5043	5543	107	14	22	0	5686
5044	129	57	5734	32	0	5952
5045	68	54	82	5751	0	5955
5046	49	50	38	5813	0	5950
5047	68	27	22	5991	0	6108
5048	44	44	5854	124	0	6066
5049	52	30	5808	67	0	5957
5050	38	47	102	5811	0	5998
5051	37	5767	63	83	0	5950
5052	37	6094	28	49	0	6208
5053	6100	111	42	33	0	6286
5054	6074	55	21	38	0	6188
5055	119	6241	33	43	0	6436
5056	61	93	25	6374	0	6553
5057	42	52	30	6447	0	6571
5058	6466	40	45	128	0	6679
5059	105	31	19	6577	0	6732
5060	71	29	35	6509	0	6644
5061	62	36	37	6578	0	6713
5062	66	30	6089	132	0	6317
5063	43	40	5628	92	0	5803
5064	5981	26	108	67	0	6182
5065	104	16	69	6372	0	6561
5066	57	19	6351	128	0	6555
5067	46	26	6108	80	0	6260
5068	6151	33	130	63	0	6377
5069	134	19	6996	49	0	7198
5070	71	7054	149	42	0	7316
5071	60	107	78	7683	0	7928
5072	43	61	7635	141	0	7880
5073	7522	41	146	76	0	7785
5074	162	39	75	8108	0	8384
5075	102	19	8044	173	0	8338
5076	56	18	176	8132	0	8382
5077	69	18	80	8262	0	8429
5078	8235	16	61	263	0	8575
5079	177	8250	67	113	0	8607
5080	98	160	40	8302	0	8600
5081	8338	72	33	187	0	8630
5082	8445	55	30	91	0	8621
5083	8507	32	18	73	0	8630
5084	8638	25	24	63	0	8750
5085	291	24	29	8434	0	8778
5086	8301	17	29	197	0	8544
5087	8385	15	39	105	0	8544
5088	8016	23	23	106	0	8168
5089	8179	22	28	75	0	8304
5090	288	7645	30	62	0	8025
5091	92	7115	7	19	0	7233
5092	49	145	11	7021	0	7226
5093	35	6942	10	109	0	7096
5094	6898	117	12	55	0	7082
5095	132	81	6	6841	0	7060
5096	6854	23	8	113	0	6998
5097	6915	17	4	66	0	7002
5098	171	6	6	7062	0	7245
5099	84	8	9	6969	0	7070
5100	43	6989	6	156	0	7194
5101	7051	95	6	80	0	7232
5102	119	6973	11	41	0	7144
5103	7064	116	5	25	0	7210
5104	142	56	7	7097	0	7302
5105	73	26	7052	111	0	7262
5106	6928	18	101	61	0	7108
5107	6754	6	50	42	0	6852
5108	166	13	6624	28	0	6831
5109	90	20	6655	18	0	6783
5110	67	11	137	6475	0	6690
5111	6990	14	63	129	0	7196
5112	7320	17	28	72	0	7437
5113	7449	27	13	55	0	7544
5114	7561	22	9	33	0	7625
5115	217	7388	16	30	0	7651
5116	7725	139	17	37	0	7918
5117	198	49	10	7613	0	7870
5118	101	27	17	7676	0	7821
5119	65	19	15	7927	0	8026
5120	65	15	13	8061	0	8154
5121	7901	19	11	248	0	8179
5122	182	8	15	8239	0	8444
5123	93	19	8007	218	0	8337
5124	85	17	155	8207	0	8464
5125	81	9	74	8374	0	8538
5126	67	15	38	8363	0	8483
5127	59	11	32	8336	0	8438
5128	8005	16	29	286	0	8336
5129	186	7868	26	142	0	8222
5130	113	8035	18	94	0	8260
5131	74	208	30	8006	0	8318
5132	7882	95	27	202	0	8206
5133	8146	50	21	128	0	8345
5134	259	26	14	8184	0	8483
5135	139	24	7847	216	0	8226
5136	7907	26	160	124	0	8217
5137	227	26	79	8270	0	8602
5138	106	35	8210	236	0	8587
5139	7801	22	179	137	0	8139
5140	225	8135	74	111	0	8545
5141	9077	169	39	89	0	9374
5142	338	9421	30	56	0	9845
5143	174	309	19	9354	0	9856
5144	118	9651	22	307	0	10098
5145	101	347	24	10006	0	10478
5146	9472	147	18	382	0	10019
5147	322	9707	28	190	0	10247
5148	167	310	9606	136	0	10219
5149	110	160	286	9705	0	10261
5150	91	98	9740	341	0	10270
5151	80	61	347	9532	0	10020
5152	75	39	149	9969	0	10232
5153	80	48	9612	449	0	10189
5154	8749	39	314	293	0	9395
5155	342	36	9387	152	0	9917
5156	165	40	9336	113	0	9654
5157	118	9314	411	104	0	9947
5158	83	297	207	9303	0	9890
5159	67	144	118	9551	0	9880
5160	83	94	70	9293	0	9540
5161	55	71	55	9751	0	9932
5162	65	42	9202	528	0	9837
5163	8659	51	300	323	0	9333
5164	323	39	9333	198	0	9893
5165	160	31	352	9169	0	9712
5166	9035	34	151	389	0	9609
5167	316	9092	129	220	0	9757
5168	181	316	69	8946	0	9512
5169	8403	122	74	349	0	8948
5170	309	8066	71	181	0	8627
5171	152	8112	42	154	0	8460
5172	7897	329	58	110	0	8394
5173	289	8025	45	90	0	8449
5174	7622	328	38	90	0	8078
5175	298	7776	44	90	0	8208
5176	7791	325	49	73	0	8238
5177	7958	142	33	80	0	8213
5178	366	7923	44	61	0	8394
5179	202	289	33	7800	0	8324
5180	160	140	7623	265	0	8188
5181	7554	123	244	143	0	8064
5182	296	87	116	7577	0	8076
5183	170	7237	81	293	0	7781
5184	107	7652	53	173	0	7985
5185	87	306	48	7671	0	8112
5186	7579	160	43	316	0	8098
5187	279	124	7541	168	0	8112
5188	169	71	251	7677	0	8168
5189	111	80	130	7876	0	8197
5190	96	60	91	8031	0	8278
5191	76	53	60	7820	0	8009
5192	67	7525	51	438	0	8081
5193	68	255	42	7835	0	8200
5194	64	135	7548	385	0	8132
5195	75	116	7508	208	0	7907
5196	57	77	7620	173	0	7927
5197	68	85	375	7448	0	7976
5198	7256	73	195	312	0	7836
5199	280	69	7276	188	0	7813
5200	165	46	7393	147	0	7751
5201	121	55	357	7162	0	7695
5202	7177	58	206	338	0	7779
5203	267	7210	142	193	0	7812
5204	7234	267	99	170	0	7770
5205	336	139	86	7210	0	7771
5206	180	130	7258	322	0	7890
5207	139	131	269	7004	0	7543
5208	111	7299	148	315	0	7873
5209	7560	307	109	188	0	8164
5210	320	148	7500	152	0	8120
5211	146	7467	262	133	0	8008
5212	7282	286	149	129	0	7846
5213	326	137	119	7305	0	7887
5214	170	107	77	7500	0	7854
5215	7417	74	82	382	0	7955
5216	7546	55	68	233	0	7902
5217	7861	79	81	153	0	8174
5218	464	57	77	7372	0	7970
5219	224	7334	62	339	0	7959
5220	7407	286	50	198	0	7941
5221	341	7380	55	179	0	7955
5222	7102	317	58	103	0	7580
5223	369	6982	61	74	0	7486
5224	181	312	63	6910	0	7466
5225	6947	152	43	320	0	7462
5226	7116	117	33	163	0	7429
5227	7195	93	28	147	0	7463
5228	7302	72	28	108	0	7510
5229	7284	69	40	97	0	7490
5230	463	66	6871	89	0	7489
5231	271	57	251	6914	0	7493
5232	189	56	6955	290	0	7490
5233	161	49	6984	159	0	7353
5234	6860	56	354	100	0	7370
5235	7066	63	169	86	0	7384
5236	7097	50	113	63	0	7323
5237	463	61	56	6668	0	7248
5238	6684	56	67	279	0	7086
5239	385	6512	51	156	0	7104
5240	230	6643	48	120	0	7041
5241	116	6060	34	67	0	6277
5242	5465	202	50	51	0	5768
5243	200	5569	28	44	0	5841
5244	5333	157	33	30	0	5553
5245	5286	71	13	29	0	5399
5246	222	30	5150	34	0	5436
5247	103	43	140	5032	0	5318
5248	94	26	56	5360	0	5536
5249	5295	35	30	197	0	5557
5250	5396	27	30	76	0	5529
5251	232	40	15	5271	0	5558
5252	117	23	5151	177	0	5468
5253	104	25	5191	78	0	5398
5254	77	26	181	5245	0	5529
5255	80	22	67	5267	0	5436
5256	76	28	41	5446	0	5591
5257	5165	24	28	232	0	5449
5258	5304	23	26	92	0	5445
5259	228	5174	20	66	0	5488
5260	124	159	22	5197	0	5502
5261	96	66	31	5236	0	5429
5262	83	5216	28	205	0	5532
5263	71	167	27	5267	0	5532
5264	5233	59	28	212	0	5532
5265	205	34	28	5208	0	5475
5266	122	28	27	5328	0	5505
5267	5169	33	20	232	0	5454
5268	5245	20	23	104	0	5392
5269	5265	26	25	78	0	5394
5270	281	41	25	5060	0	5407
5271	125	29	4824	185	0	5163
5272	92	24	4802	99	0	5017
5273	77	22	4783	68	0	4950
5274	71	4642	179	58	0	4950
5275	4589	151	90	50	0	4880
5276	196	55	4464	50	0	4765
5277	4404	28	137	41	0	4610
5278	184	25	55	4367	0	4631
5279	3922	38	45	173	0	4178
5280	4458	26	32	92	0	4608
5281	191	4447	37	59	0	4734
5282	4547	138	29	51	0	4765
5283	4594	57	22	56	0	4729
5284	208	4477	32	52	0	4769
5285	128	139	31	4597	0	4895
5286	83	54	4592	165	0	4894
5287	69	32	131	4506	0	4738
5288	78	20	56	4649	0	4803
5289	4593	29	29	203	0	4854
5290	195	24	33	4543	0	4795
5291	101	4616	23	183	0	4923
5292	72	154	31	4597	0	4854
5293	62	58	34	4770	0	4924
5294	63	41	4574	221	0	4899
5295	63	4505	148	121	0	4837
5296	63	4733	63	84	0	4943
5297	4527	177	32	77	0	4813
5298	169	4732	27	79	0	5007
5299	107	171	20	4693	0	4991
5300	79	76	4734	184	0	5073
5301	67	4760	151	103	0	5081
5302	4751	167	73	65	0	5056
5303	173	80	51	4743	0	5047
5304	92	43	43	4872	0	5050
5305	67	29	4783	222	0	5101
5306	62	43	154	4622	0	4881
5307	68	30	61	4795	0	4954
5308	4620	28	47	230	0	4925
5309	4379	23	27	106	0	4535
5310	216	4254	24	78	0	4572
5311	3942	123	29	73	0	4167
5312	162	3811	22	59	0	4054
5313	67	159	22	3551	0	3799
5314	49	3587	12	135	0	3783
5315	56	3715	22	61	0	3854
5316	3420	126	44	66	0	3656
5317	3355	43	25	49	0	3472
5318	120	3294	18	40	0	3472
5319	3312	92	21	34	0	3459
5320	3318	39	13	38	0	3408
5321	3405	17	17	43	0	3482
5322	117	27	18	3381	0	3543
5323	3395	25	13	109	0	3542
5324	107	28	3238	50	0	3423
5325	3204	25	81	51	0	3361
5326	108	16	3312	45	0	3481
5327	69	20	86	3376	0	3551
5328	42	32	27	3490	0	3591
5329	50	29	3400	112	0	3591
5330	3268	24	87	50	0	3429
5331	3430	26	29	42	0	3527
5332	123	27	3498	41	0	3689
5333	63	18	83	3416	0	3580
5334	43	18	42	3422	0	3525
5335	40	16	24	3591	0	3671
5336	3473	15	25	125	0	3638
5337	3528	14	25	64	0	3631
5338	132	13	24	3282	0	3451
5339	50	3181	13	82	0	3326
5340	37	3099	12	45	0	3193
5341	2926	71	13	29	0	3039
5342	80	2939	17	20	0	3056
5343	35	2819	6	34	0	2894
5344	26	52	10	2529	0	2617
5345	19	27	2556	40	0	2642
5346	18	2517	31	30	0	2596
5347	17	50	26	2500	0	2593
5348	15	2457	12	40	0	2524
5349	32	33	3	2468	0	2536
5350	2490	14	6	36	0	2546
5351	36	2530	4	23	0	2593
5352	2550	31	4	19	0	2604
5353	2501	15	8	18	0	2542
5354	44	7	2398	13	0	2462
5355	2379	7	31	12	0	2429
5356	37	23	10	2451	0	2521
5357	18	8	2493	33	0	2552
5358	5	2471	25	16	0	2517
5359	16	29	11	2415	0	2471
5360	14	14	7	2464	0	2499
5361	2455	11	5	34	0	2505
5362	26	5	5	2461	0	2497
5363	21	3	8	2481	0	2513
5364	2483	10	4	44	0	2541
5365	27	2453	3	19	0	2502
5366	2444	30	3	9	0	2486
5367	32	13	2389	12	0	2446
5368	2247	6	23	18	0	2294
5369	32	12	2536	5	0	2585
5370	21	2625	24	6	0	2676
5371	2642	31	10	10	0	2693
5372	2540	17	9	7	0	2573
5373	39	9	2597	12	0	2657
5374	17	6	2642	13	0	2678
5375	8	9	2720	8	0	2745
5376	12	2802	46	10	0	2870
5377	13	45	11	2828	0	2897
5378	10	17	3075	50	0	3152
5379	19	5	2989	16	0	3029
5380	16	7	69	3035	0	3127
5381	17	3	3131	59	0	3210
5382	3059	7	55	36	0	3157
5383	3587	10	25	6	0	3628
5384	106	8	3534	6	0	3654
5385	36	3499	89	7	0	3631
5386	24	74	29	3502	0	3629
5387	9	27	3594	81	0	3711
5388	10	3512	86	31	0	3639
5389	27	78	29	3475	0	3609
5390	3501	21	11	79	0	3612
5391	3515	10	8	26	0	3559
5392	84	3584	8	21	0	3697
5393	32	72	6	3624	0	3734
5394	18	31	10	3657	0	3716
5395	18	15	9	3574	0	3616
5396	10	10	10	3639	0	3669
5397	10	9	3574	106	0	3699
5398	11	8	73	3485	0	3577
5399	4	8	3503	83	0	3598
5400	5	3408	74	27	0	3514
5401	3383	66	22	24	0	3495
5402	62	3558	15	15	0	3650
5403	26	71	7	3585	0	3689
5404	14	23	8	3598	0	3643
5405	3526	13	4	97	0	3640
5406	68	5	4	3557	0	3634
5407	22	3495	8	75	0	3600
5408	13	62	4	3635	0	3714
5409	6	19	8	3665	0	3698
5410	3589	14	7	94	0	3704
5411	67	9	3497	34	0	3607
5412	26	3481	56	19	0	3582
5413	17	3613	16	15	0	3661
5414	11	77	20	3559	0	3667
5415	3517	23	3	71	0	3614
5416	56	3505	3	33	0	3597
5417	21	64	4	3581	0	3670
5418	15	25	3523	73	0	3636
5419	7	18	64	3492	0	3581
5420	3564	12	16	80	0	3672
5421	3554	7	16	35	0	3612
5422	82	10	7	3498	0	3597
5423	3553	9	6	77	0	3645
5424	3514	13	7	30	0	3564
5425	83	9	3513	24	0	3629
5426	3365	9	60	23	0	3457
5427	77	3472	20	15	0	3584
5428	3521	68	16	17	0	3622
5429	76	25	3443	15	0	3559
5430	36	14	63	3514	0	3627
5431	3609	8	23	75	0	3715
5432	77	10	3439	30	0	3556
5433	35	6	3524	26	0	3591
5434	29	10	88	3440	0	3567
5435	24	10	3587	81	0	3702
5436	3510	5	87	33	0	3635
5437	80	7	3665	23	0	3775
5438	32	8	89	3695	0	3824
5439	28	9	34	3822	0	3893
5440	3891	9	26	110	0	4036
5441	94	9	3960	56	0	4119
5442	37	7	4163	36	0	4243
5443	29	7	134	4385	0	4555
5444	19	8	4465	121	0	4613
5445	4258	11	137	44	0	4450
5446	121	7	44	4383	0	4555
5447	47	4	4412	125	0	4588
5448	46	6	120	4376	0	4548
5449	24	9	47	4491	0	4571
5450	4438	3	35	165	0	4641
5451	120	6	4410	72	0	4608
5452	4222	10	116	45	0	4393
5453	140	5	4611	29	0	4785
5454	4502	4	141	41	0	4688
5455	4641	7	57	27	0	4732
5456	4678	7	31	33	0	4749
5457	156	4499	35	22	0	4712
5458	4580	104	21	29	0	4734
5459	4642	42	21	36	0	4741
5460	160	23	18	4571	0	4772
5461	77	5	4544	134	0	4760
5462	4331	5	130	63	0	4529
5463	139	4	4675	43	0	4861
5464	61	9	142	4576	0	4788
5465	50	10	53	4772	0	4885
5466	4707	13	31	168	0	4919
5467	141	4778	25	78	0	5022
5468	69	110	17	4724	0	4920
5469	47	41	23	4779	0	4890
5470	35	26	4673	155	0	4889
5471	35	11	126	4563	0	4735
5472	40	6	47	4778	0	4871
5473	37	10	43	4665	0	4755
5474	37	4519	24	153	0	4733
5475	4462	100	21	67	0	4650
5476	4517	39	23	50	0	4629
5477	137	4507	14	39	0	4697
5478	4297	90	18	39	0	4444
5479	127	36	26	4407	0	4596
5480	49	23	4563	115	0	4750
5481	37	4481	107	58	0	4683
5482	32	4665	39	48	0	4784
5483	4512	100	44	22	0	4678
5484	4813	35	31	18	0	4897
5485	128	17	12	4810	0	4967
5486	54	7	12	4934	0	5007
5487	30	7	15	4922	0	4974
5488	4785	6	14	155	0	4960
5489	116	8	4725	68	0	4917
5490	4726	11	114	37	0	4888
5491	129	9	39	4794	0	4971
5492	58	8	25	4728	0	4819
5493	41	4746	19	133	0	4939
5494	35	100	19	4888	0	5042
5495	32	35	19	4990	0	5076
5496	45	17	4895	147	0	5104
5497	33	4915	110	72	0	5130
5498	5080	106	51	51	0	5288
5499	4929	46	29	49	0	5053
5500	5163	22	18	44	0	5247
5501	5174	12	22	35	0	5243
5502	169	12	4911	27	0	5119
5503	4817	15	108	45	0	4985
5504	148	12	4970	34	0	5164
5505	70	10	120	4817	0	5017
5506	54	4975	49	121	0	5199
5507	40	112	24	5039	0	5215
5508	37	42	27	5169	0	5275
5509	48	26	5077	153	0	5304
5510	4828	21	125	84	0	5058
5511	5027	22	50	66	0	5165
5512	156	4976	44	50	0	5226
5513	77	107	5015	48	0	5247
5514	56	47	112	5037	0	5252
5515	54	29	5060	144	0	5287
5516	53	21	4935	81	0	5090
5517	44	35	143	5015	0	5237
5518	46	23	5046	144	0	5259
5519	57	19	129	5001	0	5206
5520	60	21	5155	146	0	5382
5521	49	20	136	5117	0	5322
5522	5178	19	53	168	0	5418
5523	5228	18	44	100	0	5390
5524	5222	33	22	64	0	5341
5525	5143	28	30	75	0	5276
5526	189	5132	40	50	0	5411
5527	97	116	36	5143	0	5392
5528	65	50	38	5258	0	5411
5529	51	25	5087	193	0	5356
5530	52	18	121	4967	0	5158
5531	46	27	5017	160	0	5250
5532	39	37	4752	81	0	4909
5533	4615	19	150	71	0	4855
5534	137	5005	64	67	0	5273
5535	5081	116	41	56	0	5294
5536	5100	47	28	65	0	5240
5537	170	5091	24	70	0	5355
5538	5078	99	39	68	0	5284
5539	141	33	5070	51	0	5295
5540	73	5021	109	42	0	5245
5541	5000	85	51	41	0	5177
5542	116	35	4784	36	0	4971
5543	4517	24	82	43	0	4666
5544	87	4727	25	52	0	4891
5545	4762	77	20	45	0	4904
5546	4751	32	30	35	0	4848
5547	113	4665	29	39	0	4846
5548	44	4630	29	36	0	4739
5549	41	4796	21	25	0	4883
5550	30	99	27	4816	0	4972
5551	39	33	26	4841	0	4939
5552	4876	15	34	105	0	5030
5553	4671	12	32	53	0	4768
5554	105	18	4677	33	0	4833
5555	51	18	4431	35	0	4535
5556	38	19	4640	38	0	4735
5557	30	12	113	4647	0	4802
5558	34	13	4757	105	0	4909
5559	45	17	98	4653	0	4813
5560	4754	17	40	107	0	4918
5561	117	14	4764	40	0	4935
5562	4719	15	92	29	0	4855
5563	4734	27	31	34	0	4826
5564	116	27	4795	28	0	4966
5565	53	4845	98	36	0	5032
5566	40	79	53	4853	0	5025
5567	26	41	4940	102	0	5109
5568	34	21	120	4732	0	4907
5569	38	12	52	5339	0	5441
5570	5217	17	48	134	0	5416
5571	115	23	35	5218	0	5391
5572	67	11	5221	116	0	5415
5573	45	23	119	5189	0	5376
5574	5276	25	44	123	0	5468
5575	125	5261	32	49	0	5467
5576	5293	98	30	35	0	5456
5577	132	52	34	5271	0	5489
5578	75	27	5271	105	0	5478
5579	52	20	5029	51	0	5152
5580	50	14	4975	32	0	5071
5581	20	4804	118	32	0	4974
5582	4673	109	84	39	0	4905
5583	90	4546	28	22	0	4686
5584	4254	66	17	12	0	4349
5585	63	4227	7	6	0	4303
5586	24	66	8	4265	0	4363
5587	13	21	5	4337	0	4376
5588	9	12	8	4335	0	4364
5589	6	4259	6	83	0	4354
5590	13	68	5	4532	0	4618
5591	9	21	5	5258	0	5293
5592	5526	10	3	129	0	5668
5593	124	10	6	5814	0	5954
5594	34	10	6024	134	0	6202
5595	5883	9	134	38	0	6064
5596	6123	8	35	31	0	6197
5597	167	6157	23	19	0	6366
5598	6195	138	8	17	0	6358
5599	6387	42	6	14	0	6449
5600	197	18	11	6240	0	6466
5601	70	11	15	6409	0	6505
5602	55	5	12	6600	0	6672
5603	6481	10	5	217	0	6713
5604	6596	21	8	77	0	6702
5605	227	14	6415	37	0	6693
5606	6330	2	147	40	0	6519
5607	6536	10	45	50	0	6641
5608	6526	5	24	45	0	6600
5609	228	6	6196	44	0	6474
5610	106	8	6291	25	0	6430
5611	66	8	198	6318	0	6590
5612	56	4	6445	170	0	6675
5613	61	10	176	6271	0	6518
5614	79	11	71	5773	0	5934
5615	57	6378	46	186	0	6667
5616	6443	150	48	80	0	6721
5617	192	55	6453	48	0	6748
5618	6533	24	180	49	0	6786
5619	225	22	76	6667	0	6990
5620	6544	17	42	212	0	6815
5621	225	6388	27	103	0	6743
5622	99	6774	31	63	0	6967
5623	91	220	32	6642	0	6985
5624	76	66	31	6834	0	7007
5625	71	43	6629	262	0	7005
5626	81	20	186	6660	0	6947
5627	6391	22	77	255	0	6745
5628	216	6486	52	93	0	6847
5629	115	193	6497	79	0	6884
5630	89	63	210	6497	0	6859
5631	72	40	6607	238	0	6957
5632	71	34	238	6576	0	6919
5633	75	28	6653	253	0	7009
5634	78	24	6490	114	0	6706
5635	60	52	267	6394	0	6773
5636	6523	27	112	249	0	6911
5637	6530	24	78	116	0	6748
5638	6384	40	65	84	0	6573
5639	279	6296	57	82	0	6714
5640	6446	186	59	76	0	6767
5641	6447	69	70	59	0	6645
5642	269	47	6221	89	0	6626
5643	145	6161	203	73	0	6582
5644	114	202	84	6167	0	6567
5645	6162	68	68	213	0	6511
5646	226	6150	50	117	0	6543
5647	6352	197	48	90	0	6687
5648	6454	73	50	84	0	6661
5649	6400	57	66	65	0	6588
5650	6408	60	51	77	0	6596
5651	294	45	52	6194	0	6585
5652	6280	41	53	228	0	6602
5653	265	55	50	6130	0	6500
5654	135	6016	54	237	0	6442
5655	113	171	48	6206	0	6538
5656	6201	55	56	236	0	6548
5657	249	40	6117	131	0	6537
5658	147	27	198	6206	0	6578
5659	6145	32	85	245	0	6507
5660	254	6054	67	131	0	6506
5661	6139	198	55	80	0	6472
5662	6207	77	67	84	0	6435
5663	292	6226	51	78	0	6647
5664	6221	188	67	72	0	6548
5665	271	63	5909	83	0	6326
5666	148	53	5869	68	0	6138
5667	5747	59	218	69	0	6093
5668	287	45	5855	59	0	6246
5669	149	49	176	5322	0	5696
5670	138	5467	68	143	0	5816
5671	5607	163	52	83	0	5905
5672	247	5402	50	55	0	5754
5673	136	5291	66	49	0	5542
5674	123	196	45	5677	0	6041
5675	94	67	58	5768	0	5987
5676	88	50	38	5716	0	5892
5677	95	54	39	5728	0	5916
5678	84	45	5516	235	0	5880
5679	93	58	149	5460	0	5760
5680	82	56	62	5643	0	5843
5681	5544	41	45	225	0	5855
5682	197	36	45	5550	0	5828
5683	101	35	5400	208	0	5744
5684	5299	35	146	108	0	5588
5685	196	47	74	5426	0	5743
5686	107	49	5569	200	0	5925
5687	104	46	148	5407	0	5705
5688	87	5558	83	160	0	5888
5689	5585	131	54	104	0	5874
5690	184	60	5358	59	0	5661
5691	99	4598	115	38	0	4850
5692	4290	85	73	48	0	4496
5693	79	3911	34	31	0	4055
5694	42	3706	19	44	0	3811
5695	3644	70	56	22	0	3792
5696	63	3554	26	22	0	3665
5697	26	3580	18	13	0	3637
5698	53	51	32	3498	0	3634
5699	31	11	3462	45	0	3549
5700	17	3543	41	21	0	3622
5701	24	34	8	3478	0	3544
5702	17	3400	8	35	0	3460
5703	3397	33	4	15	0	3449
5704	36	13	3327	14	0	3390
5705	11	9	24	3328	0	3372
5706	3458	8	10	39	0	3515
5707	34	2	3	3510	0	3549
5708	12	9	3459	31	0	3511
5709	3231	6	27	25	0	3289
5710	3520	4	13	22	0	3559
5711	39	3628	12	8	0	3687
5712	23	26	5	3680	0	3734
5713	15	13	5	3798	0	3831
5714	3837	11	5	39	0	3892
5715	3726	6	7	16	0	3755
5716	44	11	3792	7	0	3854
5717	16	3713	26	11	0	3766
5718	3755	28	3	5	0	3791
5719	25	17	5	3738	0	3785
5720	9	6	3819	25	0	3859
5721	8	6	3563	10	0	3587
5722	2	14	17	3633	0	3666
5723	3762	3	4	19	0	3788
5724	16	3714	3	5	0	3738
5725	4118	14	4	17	0	4153
5726	18	3	3	4162	0	4186
5727	5	3	0	4207	0	4215
5728	7	1	1	4249	0	4258
5729	4253	5	1	19	0	4278
5730	17	4280	1	8	0	4306
5731	5	19	2	4370	0	4396
5732	7	4	2	4350	0	4363
5733	4	3	4319	18	0	4344
5734	2	4	17	4178	0	4201
5735	5	1	4363	18	0	4387
5736	5	4248	14	6	0	4273
5737	5	13	5	4333	0	4356
5738	4266	1	5	19	0	4291
5739	16	4	4205	3	0	4228
5740	2	0	15	4218	0	4235
5741	5	2	4241	15	0	4263
5742	3913	1	15	9	0	3938
5743	28	3	4257	5	0	4293
5744	5	3	17	4082	0	4107
5745	4243	2	2	19	0	4266
5746	19	3755	7	6	0	3787
5747	4050	15	1	4	0	4070
5748	21	3748	8	7	0	3784
5749	2	18	1	4149	0	4170
5750	7	1	4081	17	0	4106
5751	7	6	3909	10	0	3932
5752	7	2	15	4009	0	4033
5753	4209	2	4	21	0	4236
5754	4107	3	5	11	0	4126
5755	22	1	2	4115	0	4140
5756	7	1	3	4205	0	4216
5757	4126	0	4	24	0	4154
5758	18	3951	3	9	0	3981
5759	4	4201	2	5	0	4212
5760	4305	21	1	10	0	4337
5761	29	5	4218	6	0	4258
5762	11	5	26	4171	0	4213
5763	12	1	4175	28	0	4216
5764	9	2	27	4082	0	4120
5765	3	4	4137	30	0	4174
5766	7	4	4059	17	0	4087
5767	10	5	24	4207	0	4246
5768	5	4002	15	22	0	4044
5769	4293	25	14	10	0	4342
5770	23	4269	10	8	0	4310
5771	8	30	4	4375	0	4417
5772	4415	3	6	30	0	4454
5773	24	11	5	4499	0	4539
5774	4489	2	6	35	0	4532
5775	4481	4	4	14	0	4503
5776	4525	2	0	17	0	4544
5777	37	4396	3	7	0	4443
5778	4608	27	2	12	0	4649
5779	39	5	3	4656	0	4703
5780	4814	7	5	38	0	4864
5781	39	5	4	4878	0	4926
5782	4884	6	4	47	0	4941
5783	4986	3	4	12	0	5005
5784	38	4937	7	17	0	4999
5785	28	33	1	5381	0	5443
5786	17	7	6	5313	0	5343
5787	9	5639	4	57	0	5709
5788	4	66	8	5916	0	5994
5789	5858	17	2	88	0	5965
5790	6088	12	7	38	0	6145
5791	5959	8	4	25	0	5996
5792	101	6	6200	12	0	6319
5793	6311	6	75	27	0	6419
5794	6650	4	22	16	0	6692
5795	6766	8	15	10	0	6799
5796	123	6690	7	13	0	6833
5797	47	78	8	6800	0	6933
5798	38	26	5	6887	0	6956
5799	25	18	5	6798	0	6846
5800	23	13	6618	120	0	6774
5801	19	12	80	6651	0	6762
5802	6742	6	25	121	0	6894
5803	95	4	25	6787	0	6911
5804	39	6	7	7069	0	7121
5805	33	3	6905	134	0	7075
5806	21	6846	99	64	0	7030
5807	7071	99	29	42	0	7241
5808	119	39	16	7080	0	7254
5809	7096	20	12	135	0	7263
5810	129	11	6982	47	0	7169
5811	6532	12	111	46	0	6701
5812	141	7052	34	27	0	7254
5813	54	99	6997	29	0	7179
5814	44	38	6954	20	0	7056
5815	34	36	142	6630	0	6842
5816	30	14	7109	108	0	7261
5817	16	7083	125	44	0	7268
5818	23	97	48	6975	0	7143
5819	23	29	32	7182	0	7266
5820	18	24	12	7229	0	7283
5821	7059	13	21	144	0	7237
5822	97	7097	16	70	0	7280
5823	44	97	17	7224	0	7382
5824	32	40	17	7274	0	7363
5825	6943	25	17	147	0	7132
5826	115	6905	15	76	0	7111
5827	7071	112	14	51	0	7248
5828	7066	35	13	52	0	7166
5829	7043	31	10	54	0	7138
5830	173	20	6952	26	0	7171
5831	80	29	103	6791	0	7003
5832	69	6881	43	112	0	7105
5833	56	7088	27	58	0	7229
5834	67	139	16	6905	0	7127
5835	46	6959	32	103	0	7140
5836	7387	122	16	86	0	7611
5837	135	64	7378	52	0	7629
5838	7196	39	101	56	0	7392
5839	7592	26	42	58	0	7718
5840	151	33	26	7556	0	7766
5841	7604	21	22	141	0	7788
5842	148	8025	22	73	0	8268
5843	8116	114	23	74	0	8327
5844	8178	50	23	54	0	8305
5845	8902	40	20	62	0	9024
5846	230	27	8902	41	0	9200
5847	118	47	8972	47	0	9184
5848	104	18	181	8995	0	9298
5849	69	8814	92	163	0	9138
5850	69	9198	60	76	0	9403
5851	62	189	42	9132	0	9425
5852	9223	89	31	194	0	9537
5853	183	58	35	9218	0	9494
5854	81	41	35	9400	0	9557
5855	9249	35	41	236	0	9561
5856	168	9224	38	133	0	9563
5857	94	153	9230	90	0	9567
5858	85	63	9052	85	0	9285
5859	9233	68	183	83	0	9567
5860	182	35	100	9148	0	9465
5861	95	42	9423	185	0	9745
5862	82	28	164	9214	0	9488
5863	61	42	80	9190	0	9373
5864	71	37	49	9542	0	9699
5865	56	28	39	9379	0	9502
5866	57	9173	33	251	0	9514
5867	49	157	41	9396	0	9643
5868	9288	69	42	223	0	9622
5869	184	9189	38	101	0	9512
5870	9446	174	47	100	0	9767
5871	9636	73	48	88	0	9845
5872	9653	61	38	79	0	9831
5873	242	54	9226	62	0	9584
5874	9179	52	152	66	0	9449
5875	9567	42	63	71	0	9743
5876	9271	42	46	80	0	9439
5877	9470	34	36	66	0	9606
5878	256	9345	34	65	0	9700
5879	9330	169	17	60	0	9576
5880	224	78	9281	37	0	9620
5881	112	55	153	9100	0	9420
5882	125	29	53	9256	0	9463
5883	9392	41	41	195	0	9669
5884	204	9247	27	99	0	9577
5885	8950	135	20	59	0	9164
5886	185	8966	25	46	0	9222
5887	8651	129	25	40	0	8845
5888	8576	47	16	38	0	8677
5889	166	9208	12	23	0	9409
5890	9243	141	13	23	0	9420
5891	9615	53	19	24	0	9711
5892	220	8924	22	23	0	9189
5893	94	9237	16	22	0	9369
5894	9782	178	42	31	0	10033
5895	256	73	15	9860	0	10204
5896	9901	61	4	217	0	10183
5897	10291	40	9	77	0	10417
5898	10499	29	9	60	0	10597
5899	10510	17	11	35	0	10573
5900	343	10018	8	36	0	10405
5901	151	10419	9	28	0	10607
5902	10464	270	17	36	0	10787
5903	287	125	10345	22	0	10779
5904	124	71	213	10088	0	10496
5905	86	52	80	10444	0	10662
5906	10281	37	53	284	0	10655
5907	230	10213	22	142	0	10607
5908	117	232	22	10174	0	10545
5909	86	92	11	10552	0	10741
5910	10398	59	18	322	0	10797
5911	273	44	13	10476	0	10806
5912	10437	35	14	330	0	10816
5913	10528	33	17	143	0	10721
5914	10616	43	13	83	0	10755
5915	403	27	14	10342	0	10786
5916	199	29	17	10473	0	10718
5917	152	24	11004	333	0	11513
5918	100	31	10904	169	0	11204
5919	11026	26	381	119	0	11552
5920	355	30	185	11433	0	12003
5921	189	28	12255	349	0	12821
5922	134	24	12370	181	0	12709
5923	98	25	487	12378	0	12988
5924	89	35	12605	438	0	13167
5925	92	38	493	12409	0	13032
5926	114	32	208	12590	0	12944
5927	99	19	12495	597	0	13210
5928	83	29	442	12551	0	13105
5929	109	30	251	12124	0	12514
5930	104	21	136	13010	0	13271
5931	101	38	12403	673	0	13215
5932	108	30	422	12785	0	13345
5933	12593	37	196	609	0	13435
5934	451	12605	158	312	0	13526
5935	12804	389	99	250	0	13542
5936	543	181	12455	159	0	13338
5937	12564	109	428	164	0	13265
5938	12889	60	235	130	0	13314
5939	12933	70	163	140	0	13306
5940	727	62	94	12492	0	13375
5941	369	71	101	12809	0	13350
5942	268	41	11674	639	0	12622
5943	11216	33	450	370	0	12069
5944	555	11292	225	232	0	12304
5945	275	10778	134	167	0	11354
5946	220	11224	93	154	0	11691
5947	190	557	106	10683	0	11536
5948	10569	227	87	473	0	11356
5949	10780	130	114	259	0	11283
5950	609	66	10350	211	0	11236
5951	328	93	395	10373	0	11189
5952	245	84	197	10714	0	11240
5953	164	100	10325	592	0	11181
5954	163	69	9978	380	0	10590
5955	10007	53	520	265	0	10845
5956	493	10151	264	185	0	11093
5957	10385	379	190	189	0	11143
5958	10629	182	121	189	0	11121
5959	611	120	109	10258	0	11098
5960	373	63	117	10582	0	11135
5961	10197	70	118	608	0	10993
5962	549	61	99	10257	0	10966
5963	308	87	103	10468	0	10966
5964	10203	65	101	642	0	11011
5965	534	51	109	10331	0	11025
5966	10321	43	105	607	0	11076
5967	10531	40	121	357	0	11049
5968	636	55	9989	267	0	10947
5969	10108	63	410	247	0	10828
5970	10302	43	244	251	0	10840
5971	10274	45	208	203	0	10730
5972	710	86	7758	256	0	8810
5973	9721	55	336	203	0	10315
5974	605	9572	191	186	0	10554
5975	9990	350	165	219	0	10724
5976	10244	149	123	219	0	10735
5977	672	94	128	9871	0	10765
5978	456	46	104	9955	0	10561
5979	297	9801	115	627	0	10840
5980	250	368	99	10066	0	10783
5981	232	199	108	10329	0	10868
5982	10043	115	98	681	0	10937
5983	589	65	86	10087	0	10827
5984	381	79	80	10245	0	10785
5985	302	61	88	10167	0	10618
5986	225	9549	81	718	0	10573
5987	9491	389	87	425	0	10392
5988	564	9463	94	306	0	10427
5989	8852	385	96	208	0	9541
5990	554	177	8387	218	0	9336
5991	8100	127	323	197	0	8747
5992	503	76	8105	183	0	8867
5993	300	7853	362	167	0	8682
5994	7437	292	258	138	0	8125
5995	7277	166	133	120	0	7696
5996	481	6866	67	132	0	7546
5997	273	7002	91	121	0	7487
5998	6766	331	69	110	0	7276
5999	6930	162	72	106	0	7270
6000	430	111	56	6659	0	7256
6001	279	80	43	6906	0	7308
6002	212	70	6577	381	0	7240
6003	6437	77	250	223	0	6987
6004	354	75	117	6412	0	6958
6005	238	6407	89	299	0	7033
6006	194	242	43	6502	0	6981
6007	147	122	37	6698	0	7004
6008	148	86	6288	395	0	6917
6009	133	62	237	6445	0	6877
6010	6252	67	108	365	0	6792
6011	305	6031	69	208	0	6613
6012	186	6162	43	171	0	6562
6013	6141	284	59	116	0	6600
6014	6202	153	36	128	0	6519
6015	6216	93	54	106	0	6469
6016	436	5787	43	85	0	6351
6017	173	5319	30	44	0	5566
6018	5656	217	40	47	0	5960
6019	5763	122	28	51	0	5964
6020	309	5379	30	40	0	5758
6021	68	4606	12	21	0	4707
6022	4460	126	48	24	0	4658
6023	134	60	4	4342	0	4540
6024	4383	31	3	116	0	4533
6025	140	28	5	4296	0	4469
6026	58	4335	8	123	0	4524
6027	43	4432	10	45	0	4530
6028	4598	142	8	27	0	4775
6029	4605	50	16	26	0	4697
6030	4747	38	6	29	0	4820
6031	189	4641	4	26	0	4860
6032	65	134	4317	16	0	4532
6033	34	4407	114	17	0	4572
6034	4291	143	32	9	0	4475
6035	4186	55	14	21	0	4276
6036	157	25	4114	11	0	4307
6037	58	4035	115	8	0	4216
6038	56	131	32	4007	0	4226
6039	34	37	18	3959	0	4048
6040	25	3596	20	126	0	3767
6041	29	130	3863	26	0	4048
6042	3954	32	121	23	0	4130
6043	149	28	29	4025	0	4231
6044	4081	24	18	127	0	4250
6045	4180	27	18	33	0	4258
6046	172	31	12	4246	0	4461
6047	63	32	9	4480	0	4584
6048	54	25	12	4572	0	4663
6049	41	34	14	4623	0	4712
6050	4432	30	14	196	0	4672
6051	4534	21	18	78	0	4651
6052	202	25	4440	52	0	4719
6053	85	22	141	4510	0	4758
6054	60	19	41	4634	0	4754
6055	44	27	25	4704	0	4800
6056	27	28	4491	219	0	4765
6057	44	18	148	4472	0	4682
6058	4403	12	41	192	0	4648
6059	184	12	26	4430	0	4652
6060	78	18	4359	191	0	4646
6061	57	15	150	4408	0	4630
6062	43	17	4410	205	0	4675
6063	4433	19	159	88	0	4699
6064	184	24	46	4515	0	4769
6065	4512	15	46	189	0	4762
6066	4558	14	26	87	0	4685
6067	215	13	22	4450	0	4700
6068	4569	19	23	210	0	4821
6069	201	26	29	4456	0	4712
6070	81	4647	32	192	0	4952
6071	4881	151	27	90	0	5149
6072	4952	46	26	69	0	5093
6073	4999	29	17	67	0	5112
6074	264	22	22	4833	0	5141
6075	114	17	23	4873	0	5027
6076	74	25	22	4963	0	5084
6077	59	17	4614	273	0	4963
6078	62	4537	160	117	0	4876
6079	72	163	52	4522	0	4809
6080	69	58	4460	197	0	4784
6081	4423	26	153	94	0	4696
6082	214	19	54	4482	0	4769
6083	96	22	4388	223	0	4729
6084	4452	16	163	115	0	4746
6085	195	18	52	4570	0	4835
6086	81	17	41	4634	0	4773
6087	79	19	25	4733	0	4856
6088	4606	16	29	256	0	4907
6089	4670	17	35	128	0	4850
6090	4598	19	34	96	0	4747
6091	233	4287	36	86	0	4642
6092	100	4479	34	69	0	4682
6093	4505	170	37	69	0	4781
6094	201	60	4399	75	0	4735
6095	90	23	152	4374	0	4639
6096	78	29	55	4534	0	4696
6097	4404	11	34	223	0	4672
6098	4327	17	31	118	0	4493
6099	215	4268	29	79	0	4591
6100	106	142	20	4364	0	4632
6101	82	47	4284	188	0	4601
6102	79	29	4352	103	0	4563
6103	65	18	169	4374	0	4626
6104	65	15	61	4596	0	4737
6105	4458	11	37	247	0	4753
6106	189	26	28	4531	0	4774
6107	4682	30	28	227	0	4967
6108	4717	30	28	107	0	4882
6109	212	27	4599	78	0	4916
6110	4735	16	143	82	0	4976
6111	4871	13	57	86	0	5027
6112	4893	12	45	85	0	5035
6113	232	4698	42	83	0	5055
6114	94	4811	24	88	0	5017
6115	87	184	26	4758	0	5055
6116	65	47	4718	205	0	5035
6117	59	4469	139	95	0	4762
6118	59	125	60	4095	0	4339
6119	56	30	29	4003	0	4118
6120	55	3985	24	127	0	4191
6121	4061	98	19	68	0	4246
6122	4111	42	18	52	0	4223
6123	159	20	4068	43	0	4290
6124	3902	7	86	69	0	4064
6125	131	16	3967	41	0	4155
6126	3636	6	85	50	0	3777
6127	123	17	3755	33	0	3928
6128	63	3541	66	30	0	3700
6129	43	56	35	3397	0	3531
6130	36	22	22	3437	0	3517
6131	3481	15	17	82	0	3595
6132	3487	5	14	48	0	3554
6133	3452	10	8	37	0	3507
6134	89	7	3478	33	0	3607
6135	45	9	56	3472	0	3582
6136	35	8	23	3590	0	3656
6137	3584	5	24	78	0	3691
6138	65	3573	15	39	0	3692
6139	3741	51	7	45	0	3844
6140	76	24	14	3862	0	3976
6141	45	22	7	3975	0	4049
6142	27	10	12	4001	0	4050
6143	21	6	6	4030	0	4063
6144	28	10	11	4007	0	4056
6145	23	3829	9	100	0	3961
6146	13	3657	4	42	0	3716
6147	12	3555	4	17	0	3588
6148	15	47	5	3581	0	3648
6149	10	14	3504	32	0	3560
6150	3157	10	29	25	0	3221
6151	32	3608	15	14	0	3669
6152	32	31	8	3580	0	3651
6153	13	6	10	3607	0	3636
6154	3663	8	3	48	0	3722
6155	3597	3	4	24	0	3628
6156	3659	5	3	19	0	3686
6157	55	4	2	3951	0	4012
6158	26	2	3975	48	0	4051
6159	17	4	4033	20	0	4074
6160	13	2	51	4113	0	4179
6161	13	5	4119	46	0	4183
6162	3869	4	49	16	0	3938
6163	44	2	13	4070	0	4129
6164	11	4	4092	49	0	4156
6165	18	6	39	3950	0	4013
6166	10	5	4188	48	0	4251
6167	9	4	4334	18	0	4365
6168	9	3	52	4482	0	4546
6169	3	2	4723	58	0	4786
6170	7	2	4431	28	0	4468
6171	5	4258	78	16	0	4357
6172	18	60	38	4448	0	4564
6173	4804	21	15	73	0	4913
6174	54	14	4	4707	0	4779
6175	19	6	4	4926	0	4955
6176	15	3	4872	80	0	4970
6177	4526	1	57	46	0	4630
6178	63	1	22	5002	0	5088
6179	21	4	19	5114	0	5158
6180	5005	3	6	88	0	5102
6181	59	3	5	5073	0	5140
6182	5119	7	4	93	0	5223
6183	5110	3	2	44	0	5159
6184	5065	0	7	29	0	5101
6185	94	4932	10	16	0	5052
6186	5056	57	8	20	0	5141
6187	75	5032	9	14	0	5130
6188	31	68	9	5083	0	5191
6189	5131	25	4	68	0	5228
6190	70	5072	6	34	0	5182
6191	5168	57	6	22	0	5253
6192	77	5100	8	15	0	5200
6193	5058	72	8	11	0	5149
6194	82	4953	9	10	0	5054
6195	31	5108	9	7	0	5155
6196	23	5396	5	15	0	5439
6197	11	90	5	5220	0	5326
6198	12	5392	7	59	0	5470
6199	14	83	4	5405	0	5506
6200	13	35	4	5443	0	5495
6201	21	24	3	5422	0	5470
6202	21	12	3	5468	0	5504
6203	5424	16	3	121	0	5564
6204	5430	9	3	55	0	5497
6205	96	10	5397	31	0	5534
6206	5513	13	65	35	0	5626
6207	5820	6	24	31	0	5881
6208	6112	6	15	24	0	6157
6209	147	7	5992	28	0	6174
6210	56	10	6013	21	0	6100
6211	5922	8	134	29	0	6093
6212	150	11	6248	16	0	6425
6213	53	6545	133	17	0	6748
6214	36	140	39	6647	0	6862
6215	6841	35	23	146	0	7045
6216	6893	30	13	55	0	6991
6217	6986	14	21	35	0	7056
6218	188	15	16	6884	0	7103
6219	74	13	12	7043	0	7142
6220	41	14	7023	184	0	7262
6221	35	11	141	6987	0	7174
6222	39	17	37	7223	0	7316
6223	7153	12	26	194	0	7385
6224	162	7176	16	68	0	7422
6225	7300	147	15	48	0	7510
6226	183	47	10	7319	0	7559
6227	7246	28	21	180	0	7475
6228	7236	17	13	67	0	7333
6229	7071	19	15	67	0	7172
6230	201	6958	13	44	0	7216
6231	76	7210	12	40	0	7338
6232	63	165	14	7265	0	7507
6233	7289	57	19	175	0	7540
6234	182	32	20	7161	0	7395
6235	69	27	16	7302	0	7414
6236	64	27	7150	208	0	7449
6237	48	29	145	7070	0	7292
6238	47	24	45	7159	0	7275
6239	49	23	32	7169	0	7273
6240	59	16	6956	228	0	7259
6241	49	16	6755	99	0	6919
6242	40	6838	174	74	0	7126
6243	6893	154	52	67	0	7166
6244	189	40	41	6973	0	7243
6245	83	29	6989	177	0	7278
6246	64	23	147	6911	0	7145
6247	59	13	44	7524	0	7640
6248	7384	18	39	220	0	7661
6249	7393	20	38	89	0	7540
6250	199	7335	31	76	0	7641
6251	7314	152	43	61	0	7570
6252	7359	45	38	51	0	7493
6253	212	48	39	7252	0	7551
6254	107	38	7191	179	0	7515
6255	73	7223	152	86	0	7534
6256	7207	157	54	78	0	7496
6257	7236	61	25	52	0	7374
6258	222	7303	25	61	0	7611
6259	115	155	20	7691	0	7981
6260	7966	51	29	227	0	8273
6261	8138	39	21	98	0	8296
6262	251	29	21	8126	0	8427
6263	7927	41	26	250	0	8244
6264	8663	22	15	119	0	8819
6265	8730	28	28	88	0	8874
6266	307	30	8658	64	0	9059
6267	134	8310	193	81	0	8718
6268	103	8709	47	76	0	8935
6269	8373	205	62	56	0	8696
6270	241	8373	29	57	0	8700
6271	105	211	8359	54	0	8729
6272	91	54	196	8367	0	8708
6273	8377	50	51	220	0	8698
6274	244	37	46	8364	0	8691
6275	8377	38	20	263	0	8698
6276	8488	38	20	89	0	8635
6277	8454	33	31	85	0	8603
6278	291	8083	36	74	0	8484
6279	107	8677	30	67	0	8881
6280	8678	224	33	85	0	9020
6281	8559	72	30	81	0	8742
6282	8723	45	42	68	0	8878
6283	293	47	34	8544	0	8918
6284	8511	37	24	253	0	8825
6285	278	8251	33	82	0	8644
6286	111	8639	38	82	0	8870
6287	100	232	26	8523	0	8881
6288	89	81	8384	255	0	8809
6289	111	44	8292	84	0	8531
6290	95	34	218	8418	0	8765
6291	100	39	8469	235	0	8843
6292	101	50	202	8503	0	8856
6293	8614	54	52	240	0	8960
6294	271	46	41	8575	0	8933
6295	8488	44	39	258	0	8829
6296	272	8281	32	92	0	8677
6297	114	210	8408	77	0	8809
6298	121	66	212	8149	0	8548
6299	74	72	63	8597	0	8806
6300	77	57	8477	259	0	8870
6301	86	47	200	8158	0	8491
6302	90	8396	71	232	0	8789
6303	76	215	59	8672	0	9022
6304	91	67	41	8823	0	9022
6305	100	42	28	9062	0	9232
6306	102	24	8800	316	0	9242
6307	84	35	8281	115	0	8515
6308	7545	33	242	97	0	7917
6309	246	28	7805	58	0	8137
6310	80	7863	219	40	0	8202
6311	7865	177	65	54	0	8161
6312	204	7947	44	50	0	8245
6313	7779	191	51	39	0	8060
6314	7866	50	34	45	0	7995
6315	7763	37	31	55	0	7886
6316	7798	29	27	40	0	7894
6317	236	7471	30	29	0	7766
6318	85	7721	23	34	0	7863
6319	7719	197	20	39	0	7975
6320	199	78	7509	29	0	7815
6321	87	45	173	7366	0	7671
6322	77	36	42	7674	0	7829
6323	59	25	7575	204	0	7863
6324	6920	31	170	77	0	7198
6325	7598	29	41	47	0	7715
6326	7537	41	37	32	0	7647
6327	238	7395	24	35	0	7692
6328	7776	169	36	36	0	8017
6329	234	54	30	7523	0	7841
6330	84	8003	42	167	0	8296
6331	8284	213	39	73	0	8609
6332	8446	77	24	64	0	8611
6333	8969	45	32	38	0	9084
6334	331	43	24	8781	0	9179
6335	150	38	25	8810	0	9023
6336	103	8579	24	276	0	8982
6337	98	217	8644	117	0	9076
6338	79	85	218	8531	0	8913
6339	88	49	92	8526	0	8755
6340	86	37	52	9095	0	9270
6341	71	49	8870	316	0	9306
6342	8551	35	230	142	0	8958
6343	274	33	83	9008	0	9398
6344	114	42	8991	279	0	9426
6345	95	28	240	8854	0	9217
6346	9039	33	92	293	0	9457
6347	280	9012	57	125	0	9474
6348	126	258	41	9233	0	9658
6349	81	93	9190	295	0	9659
6350	8663	48	258	140	0	9109
6351	9239	37	111	101	0	9488
6352	352	34	9190	67	0	9643
6353	168	46	264	8535	0	9013
6354	82	9050	105	246	0	9483
6355	9185	250	73	113	0	9621
6356	297	87	8976	88	0	9448
6357	8692	55	276	99	0	9122
6358	304	51	8780	60	0	9195
6359	145	43	8186	70	0	8444
6360	7777	35	268	58	0	8138
6361	246	8192	127	63	0	8628
6362	140	210	8068	62	0	8480
6363	89	7867	215	61	0	8232
6364	83	202	7742	50	0	8077
6365	61	7780	219	52	0	8112
6366	7340	203	117	67	0	7727
6367	191	82	7229	53	0	7555
6368	110	45	7098	36	0	7289
6369	61	26	7016	56	0	7159
6370	6818	28	251	35	0	7132
6371	7028	34	95	42	0	7199
6372	215	27	61	6833	0	7136
6373	98	29	7145	164	0	7436
6374	62	27	7056	88	0	7233
6375	7008	30	223	52	0	7313
6376	189	36	110	7203	0	7538
6377	7237	17	61	179	0	7494
6378	7272	24	64	79	0	7439
6379	266	16	56	6865	0	7203
6380	115	6921	66	164	0	7266
6381	85	147	55	7024	0	7311
6382	68	77	47	7146	0	7338
6383	73	42	6984	230	0	7329
6384	67	6718	185	104	0	7074
6385	49	7020	107	60	0	7236
6386	71	206	75	6849	0	7201
6387	63	92	6901	173	0	7229
6388	60	6824	189	96	0	7169
6389	53	177	6900	57	0	7187
6390	6627	79	216	45	0	6967
6391	6988	49	116	47	0	7200
6392	248	42	6884	43	0	7217
6393	6756	39	219	47	0	7061
6394	221	36	112	6923	0	7292
6395	119	7287	70	169	0	7645
6396	67	178	78	7428	0	7751
6397	7166	77	68	197	0	7508
6398	7304	36	68	99	0	7507
6399	7337	32	62	57	0	7488
6400	7303	33	61	54	0	7451
6401	272	7039	63	46	0	7420
6402	126	7130	69	44	0	7369
6403	7114	192	48	61	0	7415
6404	209	87	7126	74	0	7496
6405	123	129	159	7081	0	7492
6406	69	7529	101	163	0	7862
6407	65	169	54	7457	0	7745
6408	56	7691	53	165	0	7965
6409	55	189	49	7762	0	8055
6410	59	89	7714	190	0	8052
6411	7432	46	201	107	0	7786
6412	7768	40	105	56	0	7969
6413	244	52	7628	38	0	7962
6414	7459	50	198	44	0	7751
6415	7683	36	114	39	0	7872
6416	264	40	7551	46	0	7901
6417	136	42	210	7261	0	7649
6418	7537	29	125	190	0	7881
6419	237	35	7479	89	0	7840
6420	135	30	194	7208	0	7567
6421	79	28	7640	189	0	7936
6422	73	33	7453	108	0	7667
6423	7432	28	262	60	0	7782
6424	7845	38	114	47	0	8044
6425	7919	29	62	46	0	8056
6426	8151	35	58	30	0	8274
6427	330	27	48	7769	0	8174
6428	156	7327	55	188	0	7726
6429	85	7635	56	97	0	7873
6430	55	215	35	7315	0	7620
6431	7305	62	41	179	0	7587
6432	203	7068	36	81	0	7388
6433	66	6958	20	37	0	7081
6434	6888	180	34	29	0	7131
6435	194	63	23	6900	0	7180
6436	6991	29	18	176	0	7214
6437	181	6976	20	58	0	7235
6438	7147	152	23	44	0	7366
6439	215	52	7317	31	0	7615
6440	8226	47	172	27	0	8472
6441	8640	28	54	25	0	8747
6442	8965	18	26	34	0	9043
6443	326	36	7775	32	0	8169
6444	8572	26	164	26	0	8788
6445	292	8627	63	35	0	9017
6446	120	215	8672	20	0	9027
6447	93	95	249	8122	0	8559
6448	82	37	76	8101	0	8296
6449	57	8275	41	250	0	8623
6450	50	203	40	8364	0	8657
6451	52	81	30	8552	0	8715
6452	44	43	8205	298	0	8590
6453	7580	36	226	118	0	7960
6454	245	17	8312	71	0	8645
6455	106	13	256	8187	0	8562
6456	61	25	8428	244	0	8758
6457	44	24	268	8388	0	8724
6458	8609	13	102	287	0	9011
6459	8925	10	59	121	0	9115
6460	324	16	53	8825	0	9218
6461	132	15	8943	291	0	9381
6462	79	16	267	9030	0	9392
6463	66	13	8885	306	0	9270
6464	8501	12	271	133	0	8917
6465	9024	21	103	84	0	9232
6466	8767	24	59	75	0	8925
6467	8896	28	52	59	0	9035
6468	377	8480	34	63	0	8954
6469	161	245	37	8664	0	9107
6470	8474	101	42	289	0	8906
6471	316	8370	39	135	0	8860
6472	132	8768	47	74	0	9021
6473	102	296	8090	75	0	8563
6474	8136	100	273	46	0	8555
6475	8551	66	93	53	0	8763
6476	377	50	8167	36	0	8630
6477	181	25	280	8031	0	8517
6478	138	30	99	8427	0	8694
6479	102	43	8230	330	0	8705
6480	87	28	302	8085	0	8502
6481	8165	19	141	324	0	8649
6482	345	20	7977	131	0	8473
6483	161	21	8249	72	0	8503
6484	8031	22	351	89	0	8493
6485	351	22	8273	71	0	8717
6486	8104	19	341	65	0	8529
6487	360	8128	133	72	0	8693
6488	8369	265	86	74	0	8794
6489	334	94	77	8229	0	8734
6490	164	69	68	8465	0	8766
6491	8284	55	55	361	0	8755
6492	333	52	53	8311	0	8749
6493	8317	51	63	336	0	8767
6494	338	8223	48	154	0	8763
6495	191	277	58	7888	0	8414
6496	136	94	49	8251	0	8530
6497	8032	73	44	365	0	8514
6498	8101	67	52	166	0	8386
6499	8097	39	48	128	0	8312
6500	424	7547	43	109	0	8123
6501	221	7911	44	73	0	8249
6502	7851	303	50	66	0	8270
6503	359	112	7501	77	0	8049
6504	204	7498	260	56	0	8018
6505	6929	246	173	53	0	7401
6506	6766	76	88	52	0	6982
6507	6775	59	54	59	0	6947
6508	336	44	36	6439	0	6855
6509	6617	39	42	230	0	6928
6510	6654	43	32	91	0	6820
6511	333	40	30	6322	0	6725
6512	6437	39	36	249	0	6761
6513	312	38	6109	84	0	6543
6514	150	43	208	6258	0	6659
6515	108	41	81	6434	0	6664
6516	109	29	62	6620	0	6820
6517	6393	41	48	297	0	6779
6518	6640	21	33	165	0	6859
6519	6688	30	48	124	0	6890
6520	6677	19	42	102	0	6840
6521	6511	24	38	80	0	6653
6522	340	9	53	6126	0	6528
6523	193	15	40	6296	0	6544
6524	6117	25	61	265	0	6468
6525	271	5957	40	137	0	6405
6526	6043	166	49	95	0	6353
6527	294	50	5704	86	0	6134
6528	6156	38	176	59	0	6429
6529	6545	34	66	58	0	6703
6530	310	34	6698	67	0	7109
6531	7030	26	228	57	0	7341
6532	337	21	7157	56	0	7571
6533	182	18	7558	47	0	7805
6534	169	51	339	7463	0	8022
6535	134	25	150	7944	0	8253
6536	113	19	7802	341	0	8275
6537	104	21	7806	168	0	8099
6538	65	7313	316	135	0	7829
6539	86	7414	156	87	0	7743
6540	6212	258	141	47	0	6658
6541	215	6607	63	41	0	6926
6542	6319	207	56	47	0	6629
6543	209	6236	42	35	0	6522
6544	6225	197	42	34	0	6498
6545	215	98	5911	24	0	6248
6546	5984	66	173	33	0	6256
6547	226	54	86	5859	0	6225
6548	124	6007	53	145	0	6329
6549	86	172	45	6140	0	6443
6550	6081	86	28	186	0	6381
6551	6251	61	30	90	0	6432
6552	255	46	33	6015	0	6349
6553	144	29	5980	181	0	6334
6554	88	32	5820	95	0	6035
6555	75	5941	209	59	0	6284
6556	59	201	94	5957	0	6311
6557	53	74	5928	170	0	6225
6558	49	5543	162	74	0	5828
6559	58	162	86	5643	0	5949
6560	29	72	56	5783	0	5940
6561	5332	35	49	206	0	5622
6562	148	37	35	5377	0	5597
6563	73	30	5290	194	0	5587
6564	40	28	155	5273	0	5496
6565	5127	24	81	195	0	5427
6566	153	28	5160	114	0	5455
6567	5102	18	144	89	0	5353
6568	171	5307	82	58	0	5618
6569	5532	136	56	52	0	5776
6570	5597	76	46	41	0	5760
6571	226	40	41	5349	0	5656
6572	130	25	38	5434	0	5627
6573	79	5294	42	205	0	5620
6574	67	133	30	5544	0	5774
6575	5376	79	32	200	0	5687
6576	172	53	5305	107	0	5637
6577	114	40	134	5283	0	5571
6578	75	5309	72	163	0	5619
6579	58	151	41	5504	0	5754
6580	52	83	36	5589	0	5760
6581	5416	56	34	228	0	5734
6582	167	5367	20	124	0	5678
6583	100	152	20	5433	0	5705
6584	5357	77	34	197	0	5665
6585	181	56	26	5415	0	5678
6586	96	47	25	5564	0	5732
6587	5481	31	18	267	0	5797
6588	5449	30	16	152	0	5647
6589	229	27	5342	111	0	5709
6590	5311	27	140	89	0	5567
6591	5506	19	70	66	0	5661
6592	5534	25	46	60	0	5665
6593	240	5111	44	58	0	5453
6594	144	5274	40	47	0	5505
6595	114	174	23	5268	0	5579
6596	5279	99	42	157	0	5577
6597	5382	67	28	96	0	5573
6598	243	46	20	5256	0	5565
6599	139	38	5265	178	0	5620
6600	5353	25	130	108	0	5616
6601	5784	44	69	85	0	5982
6602	239	29	45	5608	0	5921
6603	139	29	43	5721	0	5932
6604	5714	26	30	214	0	5984
6605	207	25	23	5630	0	5885
6606	132	5617	30	213	0	5992
6607	99	133	29	5873	0	6134
6608	5868	76	24	193	0	6161
6609	189	55	5738	116	0	6098
6610	5514	39	125	111	0	5789
6611	207	27	5754	88	0	6076
6612	127	24	151	5797	0	6099
6613	5874	31	84	187	0	6176
6614	183	25	51	5864	0	6123
6615	123	20	44	5945	0	6132
6616	5822	22	39	241	0	6124
6617	184	17	5715	154	0	6070
6618	123	24	5851	106	0	6104
6619	89	17	178	5971	0	6255
6620	76	15	106	6210	0	6407
6621	65	18	73	6283	0	6439
6622	54	24	6070	255	0	6403
6623	5860	11	136	174	0	6181
6624	6316	12	79	115	0	6522
6625	6366	14	65	97	0	6542
6626	6341	14	44	83	0	6482
6627	251	5964	44	66	0	6325
6628	157	5955	25	82	0	6219
6629	95	5833	27	66	0	6021
6630	70	129	29	5007	0	5235
6631	68	27	20	5048	0	5163
6632	45	7	4761	78	0	4891
6633	25	4319	33	26	0	4403
6634	33	16	8	4053	0	4110
6635	3992	16	8	25	0	4041
6636	15	4016	8	14	0	4053
6637	8	11	6	4020	0	4045
6638	9	4086	5	18	0	4118
6639	4193	15	4	20	0	4232
6640	20	4	3	4084	0	4111
6641	9	4	3940	20	0	3973
6642	12	6	3836	11	0	3865
6643	10	2	22	3942	0	3976
6644	8	5	15	3907	0	3935
6645	7	2	6	4145	0	4160
6646	4095	5	4	50	0	4154
6647	27	6	4063	15	0	4111
6648	11	3994	23	10	0	4038
6649	9	22	8	4018	0	4057
6650	7	8	4021	21	0	4057
6651	1	3997	21	24	0	4043
6652	7	39	5	4151	0	4202
6653	4	5	4137	25	0	4171
6654	2	2	22	4073	0	4099
6655	5	2	8	4128	0	4143
6656	4225	0	5	30	0	4260
6657	4195	2	5	12	0	4214
6658	29	1	2	4159	0	4191
6659	4147	0	1	35	0	4183
6660	31	3	4195	11	0	4240
6661	9	2	34	4248	0	4293
6662	9	4	4364	35	0	4412
6663	3	2	37	4433	0	4475
6664	4	4338	10	41	0	4393
6665	4	4396	7	20	0	4427
6666	5	4485	5	7	0	4502
6667	11	41	5	4474	0	4531
6668	2	11	2	5077	0	5092
6669	3	4	5023	65	0	5095
6670	7	7	5039	25	0	5078
6671	5	6	5409	17	0	5437
6672	5820	3	77	14	0	5914
6673	83	4	18	6123	0	6228
6674	6347	1	9	100	0	6457
6675	108	6599	7	20	0	6734
6676	30	124	4	6773	0	6931
6677	6879	36	11	130	0	7056
6678	137	13	13	6892	0	7055
6679	6888	9	3	152	0	7052
6680	148	12	6893	64	0	7117
6681	59	6985	129	18	0	7191
6682	20	140	46	7114	0	7320
6683	7064	47	16	153	0	7280
6684	7237	14	18	57	0	7326
6685	180	12	9	7201	0	7402
6686	62	5	7	7323	0	7397
6687	7118	0	18	190	0	7326
6688	151	33	14	7002	0	7200
6689	50	1	7025	177	0	7253
6690	34	6943	145	58	0	7180
6691	23	133	50	7122	0	7328
6692	7103	44	21	156	0	7324
6693	7077	17	25	72	0	7191
6694	208	22	7146	33	0	7409
6695	80	6821	145	51	0	7097
6696	43	7370	50	51	0	7514
6697	51	190	17	7333	0	7591
6698	30	62	24	7451	0	7567
6699	34	36	18	7397	0	7485
6700	42	27	9	7375	0	7453
6701	30	7073	16	235	0	7354
6702	39	164	19	7218	0	7440
6703	31	66	13	7402	0	7512
6704	7170	25	14	268	0	7477
6705	7155	25	15	106	0	7301
6706	224	7117	12	81	0	7434
6707	7274	156	21	73	0	7524
6708	7353	70	15	45	0	7483
6709	7389	33	14	66	0	7502
6710	243	23	7074	66	0	7406
6711	113	23	161	7069	0	7366
6712	71	23	61	7317	0	7472
6713	46	29	7065	241	0	7381
6714	41	31	173	6973	0	7218
6715	61	26	66	6645	0	6798
6716	6996	22	24	272	0	7314
6717	193	30	6924	106	0	7253
6718	79	24	178	6787	0	7068
6719	6658	29	58	229	0	6974
6720	197	6652	42	111	0	7002
6721	6676	173	20	89	0	6958
6722	6628	69	15	87	0	6799
6723	247	6439	18	73	0	6777
6724	109	191	15	6529	0	6844
6725	6505	69	13	223	0	6810
6726	217	6480	22	98	0	6817
6727	97	190	18	6528	0	6833
6728	6455	70	18	216	0	6759
6729	6499	39	19	109	0	6666
6730	251	6324	26	70	0	6671
6731	6421	183	25	87	0	6716
6732	248	62	24	6400	0	6734
6733	6425	55	21	217	0	6718
6734	233	29	6266	121	0	6649
6735	116	18	178	6331	0	6643
6736	81	31	65	6430	0	6607
6737	6211	33	37	275	0	6556
6738	219	6088	49	133	0	6489
6739	6005	183	27	103	0	6318
6740	237	5966	19	96	0	6318
6741	116	182	5818	63	0	6179
6742	90	72	5829	74	0	6065
6743	95	91	212	5758	0	6156
6744	73	52	5823	200	0	6148
6745	74	51	172	5829	0	6126
6746	77	31	74	5784	0	5966
6747	64	39	33	6102	0	6238
6748	6058	38	36	274	0	6406
6749	6018	29	26	134	0	6207
6750	6159	34	17	101	0	6311
6751	285	5866	25	80	0	6256
6752	137	6390	14	91	0	6632
6753	110	245	6746	78	0	7179
6754	88	86	234	6878	0	7286
6755	86	58	6893	288	0	7325
6756	73	53	254	6887	0	7267
6757	86	31	113	7072	0	7302
6758	64	46	55	7169	0	7334
6759	57	40	6772	390	0	7259
6760	75	27	253	6788	0	7143
6761	6651	41	107	348	0	7147
6762	268	6491	72	181	0	7012
6763	134	229	54	6664	0	7081
6764	6578	100	47	334	0	7059
6765	6705	58	57	167	0	6987
6766	354	46	52	6471	0	6923
6767	162	40	45	6474	0	6721
6768	5871	31	39	352	0	6293
6769	302	32	37	5839	0	6210
6770	5354	21	19	307	0	5701
6771	277	26	18	5169	0	5490
6772	127	12	4627	279	0	5045
6773	88	4253	168	154	0	4663
6774	78	4364	69	90	0	4601
6775	88	156	92	4053	0	4389
6776	58	56	61	4099	0	4274
6777	3922	30	21	195	0	4168
6778	151	28	31	3953	0	4163
6779	53	26	16	4039	0	4134
6780	45	27	9	3818	0	3899
6781	35	3624	24	209	0	3892
6782	40	128	11	3791	0	3970
6783	38	32	13	3848	0	3931
6784	42	26	9	3843	0	3920
6785	3537	18	15	245	0	3815
6786	134	3563	23	121	0	3841
6787	50	133	10	3714	0	3907
6788	30	55	14	3804	0	3903
6789	38	30	12	3832	0	3912
6790	3610	30	11	228	0	3879
6791	159	14	11	3679	0	3863
6792	63	23	4	3746	0	3836
6793	40	19	3414	219	0	3692
6794	31	3282	104	120	0	3537
6795	23	129	31	3460	0	3643
6796	3238	29	17	187	0	3471
6797	120	3251	13	108	0	3492
6798	3222	114	8	86	0	3430
6799	3332	36	12	62	0	3442
6800	147	42	10	3230	0	3429
6801	57	26	11	3379	0	3473
6802	55	21	3306	170	0	3552
6803	38	30	108	3378	0	3554
6804	43	15	3368	175	0	3601
6805	45	11	122	3472	0	3650
6806	3252	14	42	185	0	3493
6807	120	3330	38	97	0	3585
6808	46	114	30	3589	0	3779
6809	26	46	16	3669	0	3757
6810	30	26	26	3643	0	3725
6811	22	30	17	3678	0	3747
6812	3537	15	16	204	0	3772
6813	134	3492	16	102	0	3744
6814	49	121	18	3724	0	3912
6815	3654	38	12	194	0	3898
6816	141	31	3553	105	0	3830
6817	3533	19	109	112	0	3773
6818	3700	10	46	75	0	3831
6819	165	28	3570	79	0	3842
6820	85	15	120	3682	0	3902
6821	3761	24	56	158	0	3999
6822	142	3816	31	102	0	4091
6823	3974	115	26	74	0	4189
6824	4044	47	18	63	0	4172
6825	4077	28	21	57	0	4183
6826	205	17	14	3915	0	4151
6827	120	18	10	4096	0	4244
6828	60	4350	16	193	0	4619
6829	76	138	8	4518	0	4740
6830	4537	55	16	195	0	4803
6831	187	22	4417	99	0	4725
6832	4377	26	131	69	0	4603
6833	4701	24	55	69	0	4849
6834	203	31	25	4548	0	4807
6835	97	21	19	4712	0	4849
6836	4655	25	19	214	0	4913
6837	4723	12	22	102	0	4859
6838	4332	19	21	82	0	4454
6839	202	10	4517	72	0	4801
6840	99	4528	127	69	0	4823
6841	4643	136	43	76	0	4898
6842	193	58	18	4604	0	4873
6843	89	4630	11	185	0	4915
6844	79	150	18	4673	0	4920
6845	4660	62	24	161	0	4907
6846	178	41	15	4674	0	4908
6847	112	27	4606	167	0	4912
6848	44	4402	105	106	0	4657
6849	41	4604	30	69	0	4744
6850	51	125	4366	60	0	4602
6851	3916	110	139	76	0	4241
6852	92	3997	42	48	0	4179
6853	59	81	19	3425	0	3584
6854	3399	22	9	48	0	3478
6855	41	3356	10	22	0	3429
6856	23	36	6	3412	0	3477
6857	3428	18	9	45	0	3500
6858	45	9	6	3401	0	3461
6859	3435	7	3	50	0	3495
6860	49	13	3469	22	0	3553
6861	19	3502	32	21	0	3574
6862	3668	48	12	23	0	3751
6863	3615	15	6	30	0	3666
6864	3614	9	7	17	0	3647
6865	66	11	3427	14	0	3518
6866	3432	11	33	17	0	3493
6867	3598	8	15	12	0	3633
6868	58	6	7	3598	0	3669
6869	3611	8	4	38	0	3661
6870	48	3535	12	22	0	3617
6871	33	38	9	3573	0	3653
6872	26	18	3601	40	0	3685
6873	20	10	40	3548	0	3618
6874	22	9	19	3636	0	3686
6875	3648	11	9	54	0	3722
6876	3632	15	3	30	0	3680
6877	61	7	3585	21	0	3674
6878	3496	7	33	22	0	3558
6879	57	6	3546	19	0	3628
6880	39	4	36	3574	0	3653
6881	26	7	3602	50	0	3685
6882	16	8	44	3575	0	3643
6883	26	3567	19	40	0	3652
6884	20	37	3623	23	0	3703
6885	22	20	3688	17	0	3747
6886	28	13	83	3006	0	3130
6887	3734	8	26	54	0	3822
6888	3763	7	13	24	0	3807
6889	3808	10	17	18	0	3853
6890	75	8	10	3741	0	3834
6891	35	10	13	3805	0	3863
6892	27	6	8	3800	0	3841
6893	27	6	12	3780	0	3825
6894	22	17	3706	72	0	3817
6895	22	11	45	3646	0	3724
6896	18	3619	24	68	0	3729
6897	26	47	9	3719	0	3801
6898	3707	19	15	65	0	3806
6899	68	7	3677	35	0	3787
6900	3380	8	54	35	0	3477
6901	60	10	3716	23	0	3809
6902	35	8	3634	18	0	3695
6903	18	3626	72	19	0	3735
6904	35	63	34	3295	0	3427
6905	20	14	18	3646	0	3698
6906	21	3091	47	76	0	3235
6907	3943	71	17	27	0	4058
6908	84	30	9	4134	0	4257
6909	50	9	6	4658	0	4723
6910	27	12	8	4909	0	4956
6911	5415	7	9	179	0	5610
6912	5953	7	7	69	0	6036
6913	219	6	9	5790	0	6024
6914	69	2	9	5915	0	5995
6915	5695	7	9	251	0	5962
6916	197	7	6	5768	0	5978
6917	80	6	10	5896	0	5992
6918	61	6	9	5959	0	6035
6919	49	6	5608	278	0	5941
6920	5366	6	171	128	0	5671
6921	5672	3	46	91	0	5812
6922	264	7	5338	81	0	5690
6923	113	9	166	5063	0	5351
6924	66	5268	55	231	0	5620
6925	5243	162	38	124	0	5567
6926	202	5257	31	94	0	5584
6927	88	5115	32	76	0	5311
6928	75	194	38	4869	0	5176
6929	4774	57	41	231	0	5103
6930	4959	37	30	94	0	5120
6931	257	33	25	4828	0	5143
6932	104	40	26	4929	0	5099
6933	82	39	19	4940	0	5080
6934	65	46	16	4890	0	5017
6935	69	44	8	4820	0	4941
6936	78	4572	7	252	0	4909
6937	69	180	14	4730	0	4993
6938	4626	55	14	282	0	4977
6939	4761	32	9	168	0	4970
6940	4727	20	18	138	0	4903
6941	250	4478	16	140	0	4884
6942	109	173	11	4586	0	4879
6943	68	61	4517	281	0	4927
6944	4470	39	157	155	0	4821
6945	234	54	47	4538	0	4873
6946	4526	38	30	238	0	4832
6947	4491	48	20	123	0	4682
6948	4544	38	20	90	0	4692
6949	275	41	31	4306	0	4653
6950	4362	32	22	225	0	4641
6951	254	44	27	4334	0	4659
6952	129	34	23	4488	0	4674
6953	4317	25	24	288	0	4654
6954	256	27	19	4388	0	4690
6955	4357	24	15	268	0	4664
6956	4478	24	5	143	0	4650
6957	281	34	5	4325	0	4645
6958	154	14	9	4477	0	4654
6959	138	19	5	4531	0	4693
6960	113	13	4062	322	0	4510
6961	111	19	4116	186	0	4432
6962	106	13	179	4093	0	4391
6963	111	17	62	4205	0	4395
6964	94	14	36	4249	0	4393
6965	109	15	17	4240	0	4381
6966	91	23	36	4295	0	4445
6967	3995	16	36	330	0	4377
6968	220	3917	40	182	0	4359
6969	121	157	36	4092	0	4406
6970	4060	46	45	288	0	4439
6971	233	33	37	4120	0	4423
6972	108	24	31	4209	0	4372
6973	3976	15	18	329	0	4338
6974	4063	31	10	191	0	4295
6975	264	23	3808	161	0	4256
6976	142	28	156	3949	0	4275
6977	117	21	3834	292	0	4264
6978	98	23	165	3980	0	4266
6979	101	16	55	4043	0	4215
6980	102	15	32	4103	0	4252
6981	88	11	3796	341	0	4236
6982	87	3577	171	202	0	4037
6983	86	3887	75	146	0	4194
6984	73	185	48	3844	0	4150
6985	3748	49	59	275	0	4131
6986	202	28	3683	182	0	4095
6987	79	24	3828	156	0	4087
6988	76	30	209	3784	0	4099
6989	65	43	79	3740	0	3927
6990	48	3715	56	302	0	4121
6991	62	179	52	3794	0	4087
6992	60	70	55	4024	0	4209
6993	60	51	54	4110	0	4275
6994	3842	39	40	308	0	4229
6995	3951	28	39	170	0	4188
6996	225	25	53	3888	0	4191
6997	101	3780	43	277	0	4201
6998	70	161	38	3937	0	4206
6999	3721	55	23	300	0	4099
7000	198	3792	29	170	0	4189
7001	92	153	21	3535	0	3801
7002	63	3577	37	246	0	3923
7003	3570	163	16	146	0	3895
7004	3365	74	39	127	0	3605
7005	205	3469	31	104	0	3809
7006	91	3485	29	105	0	3710
7007	56	164	3172	94	0	3486
7008	43	2968	106	79	0	3196
7009	48	135	46	2390	0	2619
7010	36	60	2264	107	0	2467
7011	1	1526	32	33	0	1592
7012	10	19	3	1186	0	1218
7013	1	5	1	1222	0	1229
7014	1	1	0	1229	0	1231
7015	1187	0	2	24	0	1213
7016	17	2	1149	4	0	1172
7017	3	0	1148	14	0	1165
7018	4	1	21	1152	0	1178
7019	3	1	1238	20	0	1262
7020	2	1	20	1248	0	1271
7021	2	2	5	1169	0	1178
7022	2	1	1	1270	0	1274
7023	3	0	1	1274	0	1278
7024	1257	2	1	24	0	1284
7025	1245	2	0	8	0	1255
7026	22	0	3	1270	0	1295
7027	6	3	1348	21	0	1378
7028	6	1	17	1372	0	1396
7029	3	1341	5	19	0	1368
7030	2	21	1	1352	0	1376
7031	1346	6	1	23	0	1376
7032	1372	4	3	9	0	1388
7033	22	2	2	1383	0	1409
7034	7	4	1	1394	0	1406
7035	3	2	4	1397	0	1406
7036	1369	0	3	29	0	1401
7037	19	3	1362	11	0	1395
7038	5	3	1352	8	0	1368
7039	4	1338	24	6	0	1372
7040	1349	19	8	5	0	1381
7041	20	4	4	1395	0	1423
7042	4	3	1437	24	0	1468
7043	6	1362	21	6	0	1395
7044	5	1423	2	8	0	1438
7045	2	24	3	1439	0	1468
7046	0	9	6	1468	0	1483
7047	3	1441	2	25	0	1471
7048	4	23	1	1497	0	1525
7049	4	4	2	1500	0	1510
7050	1483	4	3	31	0	1521
7051	21	1470	2	12	0	1505
7052	4	24	1	1468	0	1497
7053	2	6	1441	29	0	1478
7054	6	3	18	1446	0	1473
7055	1465	2	6	23	0	1496
7056	22	1471	7	7	0	1507
7057	4	16	4	1505	0	1529
7058	4	6	1491	24	0	1525
7059	5	4	1552	10	0	1571
7060	2	2	24	1605	0	1633
7061	1	3	9	1658	0	1671
7062	1657	5	5	30	0	1697
7063	21	1719	2	10	0	1752
7064	1729	23	3	9	0	1764
7065	29	4	1745	8	0	1786
7066	1702	7	25	6	0	1740
7067	32	7	1845	4	0	1888
7068	1808	6	33	7	0	1854
7069	1901	3	7	8	0	1919
7070	38	2	1942	7	0	1989
7071	14	1	1918	7	0	1940
7072	5	1903	38	3	0	1949
7073	7	29	7	2030	0	2073
7074	2035	5	7	39	0	2086
7075	28	5	6	2090	0	2129
7076	9	3	5	2133	0	2150
7077	4	3	5	2160	0	2172
7078	4	2	2131	46	0	2183
7079	1963	3	29	14	0	2009
7080	2134	3	8	10	0	2155
7081	37	2174	6	15	0	2232
7082	9	33	6	2184	0	2232
7083	7	2239	4	42	0	2292
7084	6	41	2	2296	0	2345
7085	2272	9	1	46	0	2328
7086	40	2238	4	16	0	2298
7087	12	42	2	2234	0	2290
7088	2214	10	4	40	0	2268
7089	2248	7	3	15	0	2273
7090	51	5	1	2180	0	2237
7091	16	4	2175	41	0	2236
7092	11	22	34	2052	0	2119
7093	6	2149	12	36	0	2203
7094	2177	33	8	14	0	2232
7095	37	2187	4	7	0	2235
7096	11	35	2	2176	0	2224
7097	2214	9	3	46	0	2272
7098	39	5	5	2302	0	2351
7099	12	6	4	2327	0	2349
7100	6	6	2283	45	0	2340
7101	6	2274	36	17	0	2333
7102	2248	36	6	8	0	2298
7103	2089	19	7	22	0	2137
7104	34	2195	2	6	0	2237
7105	11	2232	2	8	0	2253
7106	8	33	3	2230	0	2274
7107	2207	13	2	27	0	2249
7108	31	2205	1	15	0	2252
7109	10	30	2	2270	0	2312
7110	7	11	2262	30	0	2310
7111	6	7	25	2243	0	2281
7112	2304	4	7	34	0	2349
7113	31	2320	4	13	0	2368
7114	8	31	3	2417	0	2459
7115	8	9	2384	35	0	2436
7116	8	10	2353	13	0	2384
7117	8	2	32	2450	0	2492
7118	4	2	14	2483	0	2503
7119	2	2434	7	41	0	2484
7120	5	30	2	2476	0	2513
7121	2493	11	4	30	0	2538
7122	31	8	2	2517	0	2558
7123	2509	6	4	40	0	2559
7124	35	2487	6	14	0	2542
7125	13	2604	6	14	0	2637
7126	12	41	3	2694	0	2750
7127	9	15	11	2630	0	2665
7128	5	6	2625	42	0	2678
7129	9	8	33	2543	0	2593
7130	2604	5	11	42	0	2662
7131	39	5	2598	16	0	2658
7132	17	5	31	2653	0	2706
7133	8	11	2828	40	0	2887
7134	8	3	39	2836	0	2886
7135	15	3	14	2846	0	2878
7136	6	4	10	2930	0	2950
7137	7	4	2926	56	0	2993
7138	9	9	36	2829	0	2883
7139	7	2891	13	51	0	2962
7140	12	34	9	2983	0	3038
7141	6	14	8	2951	0	2979
7142	2908	8	7	59	0	2982
7143	42	9	2847	24	0	2922
7144	14	10	39	2879	0	2942
7145	12	5	2838	53	0	2908
7146	8	9	2734	20	0	2771
7147	5	9	45	2886	0	2945
7148	17	4	23	2796	0	2840
7149	11	10	5	3024	0	3050
7150	2962	10	7	63	0	3042
7151	45	8	2920	27	0	3000
7152	3028	10	39	33	0	3110
7153	45	5	14	3267	0	3331
7154	15	6	12	3349	0	3382
7155	16	3594	8	64	0	3682
7156	8	38	10	3722	0	3778
7157	14	17	7	3722	0	3760
7158	17	9	8	3732	0	3766
7159	3546	7	7	64	0	3624
7160	44	4	3433	31	0	3512
7161	3196	8	39	27	0	3270
7162	41	3484	14	25	0	3564
7163	3438	37	7	20	0	3502
7164	36	3425	8	18	0	3487
7165	9	3463	5	23	0	3500
7166	23	34	9	3490	0	3556
7167	3523	12	11	44	0	3590
7168	35	6	5	3518	0	3564
7169	13	3455	7	49	0	3524
7170	11	3697	7	16	0	3731
7171	13	41	10	3743	0	3807
7172	7	14	9	3707	0	3737
7173	5	3693	10	58	0	3766
7174	9	42	3	3901	0	3955
7175	9	11	5	3917	0	3942
7176	9	13	6	3965	0	3993
7177	3960	10	2	67	0	4039
7178	46	13	3910	25	0	3994
7179	3854	9	42	43	0	3948
7180	4101	11	6	21	0	4139
7181	4085	5	11	22	0	4123
7182	55	4055	4	13	0	4127
7183	12	36	3	4035	0	4086
7184	4064	7	5	42	0	4118
7185	37	8	2	4122	0	4169
7186	4158	2	4	47	0	4211
7187	36	4394	5	16	0	4451
7188	4586	31	3	27	0	4647
7189	4663	7	6	15	0	4691
7190	4683	9	6	13	0	4711
7191	46	7	4	4639	0	4696
7192	20	3	2	4842	0	4867
7193	4859	4	4	52	0	4919
7194	39	4788	2	23	0	4852
7195	15	4805	2	11	0	4833
7196	5012	33	7	19	0	5071
7197	40	11	0	5012	0	5063
7198	15	8	4	5033	0	5060
7199	18	4	7	5185	0	5214
7200	5	5120	2	64	0	5191
7201	5137	44	3	27	0	5211
7202	56	11	3	5188	0	5258
7203	12	5231	3	51	0	5297
7204	20	38	2	5489	0	5549
7205	15	11	3	5485	0	5514
7206	16	13	0	5467	0	5496
7207	13	7	3	5521	0	5544
7208	5483	10	1	64	0	5558
7209	5429	10	3	28	0	5470
7210	5483	4	1	32	0	5520
7211	67	4	1	5535	0	5607
7212	24	7	5433	60	0	5524
7213	29	8	4922	32	0	4991
7214	24	6	5119	20	0	5169
7215	5484	10	48	26	0	5568
7216	51	5	14	5625	0	5695
7217	16	3	14	5580	0	5613
7218	17	8	6	5676	0	5707
7219	5633	4	4	71	0	5712
7220	5574	3	3	32	0	5612
7221	56	5853	3	27	0	5939
7222	23	46	3	5955	0	6027
7223	20	10	5843	57	0	5930
7224	11	5896	37	17	0	5961
7225	14	52	11	5966	0	6043
7226	14	14	13	5955	0	5996
7227	8	13	0	5875	0	5896
7228	6	4	3	5733	0	5746
7229	13	7	5733	64	0	5817
7230	10	13	5381	30	0	5434
7231	10	5758	43	23	0	5834
7232	10	33	18	5867	0	5928
7233	12	11	11	5745	0	5779
7234	5656	15	3	53	0	5727
7235	47	1	5683	26	0	5757
7236	17	4	38	5644	0	5703
7237	22	5	16	5854	0	5897
7238	10	4	5970	54	0	6038
7239	8	5907	38	28	0	5981
7240	6002	38	11	32	0	6083
7241	42	11	5972	15	0	6040
7242	5748	14	40	25	0	5827
7243	54	4	6199	16	0	6273
7244	14	5	54	6265	0	6338
7245	21	9	6236	45	0	6311
7246	14	5	6234	21	0	6274
7247	15	3	42	6395	0	6455
7248	73	31	104	4828	0	5036
7249	9	8	11	6654	0	6682
7250	12	2	10	6426	0	6450
7251	14	17	8	6395	0	6434
7252	7	8	6408	64	0	6487
7253	9	4	5926	44	0	5983
7254	8	6358	46	26	0	6438
7255	6277	38	22	25	0	6362
7256	51	21	13	6337	0	6422
7257	6372	14	10	68	0	6464
7258	63	2	11	6351	0	6427
7259	6517	5	12	92	0	6626
7260	69	7	8	6563	0	6647
7261	21	1	6	6635	0	6663
7262	15	6629	5	78	0	6727
7263	15	48	7	6845	0	6915
7264	10	16	5	6834	0	6865
7265	17	9	3	6747	0	6776
7266	4	5	11	6755	0	6775
7267	10	6554	9	81	0	6654
7268	6597	49	9	38	0	6693
7269	50	6550	5	30	0	6635
7270	11	44	6	6412	0	6473
7271	6307	8	10	60	0	6385
7272	45	12	6152	21	0	6230
7273	24	8	6029	12	0	6073
7274	20	17	50	5931	0	6018
7275	8	9	16	6216	0	6249
7276	7	1	9	6211	0	6228
7277	17	8	13	5682	0	5720
7278	7	0	7	6021	0	6035
7279	5	5866	12	55	0	5938
7280	4	39	3	6004	0	6050
7281	5961	11	3	62	0	6037
7282	43	9	4	6011	0	6067
7283	12	3	6068	54	0	6137
7284	8	3	40	5954	0	6005
7285	5927	3	12	64	0	6006
7286	45	6110	12	26	0	6193
7287	20	46	5	6341	0	6412
7288	11	14	6	6596	0	6627
7289	14	10	6430	109	0	6563
7290	11	7	8382	31	0	8431
7291	10487	2	218	23	0	10730
7292	326	8	70	10617	0	11021
7293	122	1	60	11142	0	11325
7294	84	5	11529	463	0	12081
7295	69	5	11649	225	0	11948
7296	29	11619	492	164	0	12304
7297	26	384	218	11566	0	12194
7298	21	123	11605	387	0	12136
7299	7	11525	451	159	0	12142
7300	11512	426	186	121	0	12245
7301	12088	151	146	87	0	12472
7302	529	117	94	11497	0	12237
7303	235	11790	68	428	0	12521
7304	11736	432	74	179	0	12421
7305	506	186	58	11070	0	11820
7306	196	142	11531	433	0	12302
7307	161	11640	427	185	0	12413
7308	11547	449	162	143	0	12301
7309	12005	184	123	130	0	12442
7310	588	143	101	11687	0	12519
7311	284	109	58	12065	0	12516
7312	202	72	11540	586	0	12400
7313	147	71	432	11758	0	12408
7314	126	47	173	11323	0	11669
7315	99	55	131	11925	0	12210
7316	83	51	84	11954	0	12172
7317	90	41	61	11624	0	11816
7318	68	11323	66	746	0	12203
7319	11358	434	49	415	0	12256
7320	456	162	11238	306	0	12162
7321	190	11105	434	233	0	11962
7322	144	452	181	11340	0	12117
7323	11294	170	132	564	0	12160
7324	454	139	94	11486	0	12173
7325	187	96	71	11730	0	12084
7326	146	64	71	11852	0	12133
7327	112	72	83	11907	0	12174
7328	119	66	11102	814	0	12101
7329	100	11086	441	461	0	12088
7330	11224	460	161	375	0	12220
7331	487	181	11143	265	0	12076
7332	203	144	528	11281	0	12156
7333	11189	118	204	599	0	12110
7334	501	11183	171	323	0	12178
7335	11353	487	144	283	0	12267
7336	634	228	127	10509	0	11498
7337	300	162	98	11665	0	12225
7338	233	143	83	11556	0	12015
7339	182	82	71	11738	0	12073
7340	10971	94	91	847	0	12003
7341	532	94	66	11263	0	11955
7342	260	74	60	11656	0	12050
7343	10770	68	79	803	0	11720
7344	569	82	10490	458	0	11599
7345	273	69	430	10896	0	11668
7346	10443	66	164	692	0	11365
7347	10721	49	136	384	0	11290
7348	651	50	121	10374	0	11196
7349	358	56	90	10466	0	10970
7350	272	9779	76	750	0	10877
7351	200	427	79	10281	0	10987
7352	157	173	55	10483	0	10868
7353	140	132	9521	853	0	10646
7354	121	80	9574	521	0	10296
7355	107	9413	531	430	0	10481
7356	150	434	256	9472	0	10312
7357	117	179	229	10007	0	10532
7358	9525	162	141	765	0	10593
7359	486	114	118	9689	0	10407
7360	240	88	9244	745	0	10317
7361	211	96	463	9625	0	10395
7362	148	86	9077	761	0	10072
7363	140	81	9320	434	0	9975
7364	115	83	641	9110	0	9949
7365	100	77	335	9655	0	10167
7366	9133	100	226	745	0	10204
7367	9520	69	161	468	0	10218
7368	613	59	147	9449	0	10268
7369	9462	63	118	749	0	10392
7370	9851	40	118	398	0	10407
7371	700	82	97	9553	0	10432
7372	395	59	93	9967	0	10514
7373	9556	55	98	771	0	10480
7374	9731	42	84	480	0	10337
7375	704	27	76	9464	0	10271
7376	390	9146	93	697	0	10326
7377	335	410	57	9560	0	10362
7378	249	152	40	9981	0	10422
7379	207	114	9105	854	0	10280
7380	190	77	415	9743	0	10425
7381	8897	52	189	861	0	9999
7382	482	9250	151	458	0	10341
7383	9360	438	98	368	0	10264
7384	9465	164	73	349	0	10051
7385	9764	150	57	284	0	10255
7386	801	172	83	9039	0	10095
7387	541	83	8215	597	0	9436
7388	386	83	8087	361	0	8917
7389	240	7950	507	346	0	9043
7390	129	5948	160	168	0	6405
7391	65	3833	49	73	0	4020
7392	73	3691	74	83	0	3921
7393	120	137	3386	62	0	3705
7394	2551	93	167	43	0	2854
7395	68	22	15	2571	0	2676
7396	26	9	5	2536	0	2576
7397	30	4	2	2571	0	2607
7398	14	2501	6	62	0	2583
7399	2432	42	9	26	0	2509
7400	47	9	2459	20	0	2535
7401	8	2279	37	12	0	2336
7402	12	30	29	2299	0	2370
7403	2291	11	10	32	0	2344
7404	31	16	4	2290	0	2341
7405	8	17	2237	30	0	2292
7406	12	7	2159	13	0	2191
7407	9	3	33	2244	0	2289
7408	9	3	10	2254	0	2276
7409	2220	2	5	51	0	2278
7410	30	5	2206	18	0	2259
7411	2147	8	33	11	0	2199
7412	2236	7	11	5	0	2259
7413	42	5	13	2240	0	2300
7414	16	7	2282	37	0	2342
7415	10	8	29	2286	0	2333
7416	2314	1	11	45	0	2371
7417	38	2300	10	16	0	2364
7418	2348	32	10	15	0	2405
7419	39	6	9	2364	0	2418
7420	8	2457	6	51	0	2522
7421	11	43	4	2503	0	2561
7422	18	7	8	2565	0	2598
7423	14	2497	10	62	0	2583
7424	15	49	9	2575	0	2648
7425	16	12	4	2655	0	2687
7426	14	7	8	2718	0	2747
7427	5	7	2715	78	0	2805
7428	10	2674	58	35	0	2777
7429	2753	60	19	21	0	2853
7430	70	22	9	2865	0	2966
7431	24	3079	5	70	0	3178
7432	3306	73	4	33	0	3416
7433	88	18	6	3326	0	3438
7434	23	18	4	3402	0	3447
7435	16	15	5	3332	0	3368
7436	12	12	2	3298	0	3324
7437	3208	10	4	120	0	3342
7438	91	5	3	3251	0	3350
7439	19	4	10	3324	0	3357
7440	3221	15	5	119	0	3360
7441	99	10	5	3250	0	3364
7442	25	10	3180	124	0	3339
7443	20	17	86	3224	0	3347
7444	3146	8	17	111	0	3282
7445	94	5	8	3184	0	3291
7446	28	12	3164	110	0	3314
7447	24	5	3112	59	0	3200
7448	3201	3	92	46	0	3342
7449	3385	6	24	42	0	3457
7450	3429	3	20	41	0	3493
7451	3453	5	15	33	0	3506
7452	127	5	3383	23	0	3538
7453	43	4	91	3373	0	3511
7454	35	4	26	3483	0	3548
7455	3429	2	19	128	0	3578
7456	104	5	18	3488	0	3615
7457	35	6	3446	119	0	3606
7458	27	7	93	3451	0	3578
7459	23	4	3464	117	0	3608
7460	23	3436	99	38	0	3596
7461	3572	84	33	31	0	3720
7462	113	18	22	3566	0	3719
7463	44	12	3481	111	0	3648
7464	27	8	102	3514	0	3651
7465	23	8	26	3743	0	3800
7466	23	8	3660	147	0	3838
7467	27	4	109	3694	0	3834
7468	3665	10	27	159	0	3861
7469	122	9	3371	55	0	3557
7470	3399	7	100	56	0	3562
7471	123	3440	37	49	0	3649
7472	38	95	3434	39	0	3606
7473	27	27	3504	39	0	3597
7474	39	48	130	2894	0	3111
7475	19	12	37	3265	0	3333
7476	15	6	3283	126	0	3430
7477	21	10	106	3268	0	3405
7478	3284	8	35	128	0	3455
7479	3349	7	28	55	0	3439
7480	126	8	22	3254	0	3410
7481	41	6	17	3289	0	3353
7482	36	3250	16	130	0	3432
7483	3308	87	19	64	0	3478
7484	106	20	18	3313	0	3457
7485	38	3360	23	130	0	3551
7486	3416	97	19	61	0	3593
7487	3506	23	17	58	0	3604
7488	119	3497	18	52	0	3686
7489	60	103	21	3468	0	3652
7490	53	28	10	3533	0	3624
7491	46	22	3355	138	0	3561
7492	31	18	105	3377	0	3531
7493	3361	12	37	157	0	3567
7494	122	10	22	3393	0	3547
7495	45	11	3329	146	0	3531
7496	3304	8	108	78	0	3498
7497	132	11	37	3371	0	3551
7498	58	7	3312	137	0	3514
7499	43	9	115	3341	0	3508
7500	49	9	3336	138	0	3532
7501	36	7	118	3348	0	3509
7502	38	10	46	3475	0	3569
7503	3335	7	47	162	0	3551
7504	115	3310	40	78	0	3543
7505	3337	101	29	67	0	3534
7506	3377	24	38	56	0	3495
7507	3438	15	30	62	0	3545
7508	154	3328	33	34	0	3549
7509	62	104	3305	44	0	3515
7510	58	27	116	3318	0	3519
7511	3379	23	35	128	0	3565
7512	3457	15	38	52	0	3562
7513	148	15	34	3327	0	3524
7514	3325	16	23	147	0	3511
7515	143	8	3267	62	0	3480
7516	3210	14	108	57	0	3389
7517	139	13	3241	40	0	3433
7518	55	3134	107	50	0	3346
7519	3170	93	37	27	0	3327
7520	3058	28	37	39	0	3162
7521	125	3015	31	35	0	3206
7522	2965	92	34	34	0	3125
7523	2963	23	28	33	0	3047
7524	137	16	2851	33	0	3037
7525	2739	20	93	35	0	2887
7526	120	14	2713	25	0	2872
7527	43	58	81	2478	0	2660
7528	46	2587	27	76	0	2736
7529	37	68	2581	27	0	2713
7530	2287	64	104	59	0	2514
7531	2220	19	19	34	0	2292
7532	75	13	18	2015	0	2121
7533	32	8	2016	57	0	2113
7534	26	7	56	1979	0	2068
7535	1985	5	19	60	0	2069
7536	59	2000	13	18	0	2090
7537	1999	44	19	22	0	2084
7538	2043	14	11	16	0	2084
7539	66	1998	11	14	0	2089
7540	32	46	9	2006	0	2093
7541	2048	18	11	57	0	2134
7542	70	9	9	2063	0	2151
7543	26	10	9	2206	0	2251
7544	22	9	2231	66	0	2328
7545	21	6	48	2236	0	2311
7546	28	5	14	2259	0	2306
7547	2219	5	15	80	0	2319
7548	2287	6	10	22	0	2325
7549	75	12	14	2227	0	2328
7550	26	7	2143	78	0	2254
7551	26	6	2107	26	0	2165
7552	25	6	61	2114	0	2206
7553	22	8	2195	69	0	2294
7554	24	12	60	2166	0	2262
7555	22	3	24	2161	0	2210
7556	2171	8	20	65	0	2264
7557	55	7	2122	38	0	2222
7558	2085	3	63	19	0	2170
7559	2139	6	20	23	0	2188
7560	75	4	2038	26	0	2143
7561	32	5	2025	10	0	2072
7562	20	41	55	1928	0	2044
7563	24	1874	27	53	0	1978
7564	26	1963	21	16	0	2026
7565	34	38	20	1816	0	1908
7566	15	10	13	1753	0	1791
7567	13	6	9	1851	0	1879
7568	11	7	17	1836	0	1871
7569	1768	5	9	49	0	1831
7570	38	5	12	1777	0	1832
7571	23	9	1738	44	0	1814
7572	20	6	34	1713	0	1773
7573	14	1677	16	46	0	1753
7574	11	32	16	1708	0	1767
7575	1705	8	9	51	0	1773
7576	38	8	9	1693	0	1748
7577	18	10	1682	41	0	1751
7578	13	1672	33	27	0	1745
7579	15	28	15	1720	0	1778
7580	1703	5	5	49	0	1762
7581	1731	9	9	23	0	1772
7582	47	1	16	1728	0	1792
7583	23	6	1663	44	0	1736
7584	14	3	1564	26	0	1607
7585	1578	2	45	22	0	1647
7586	41	8	1645	12	0	1706
7587	13	3	1635	25	0	1676
7588	20	4	34	1567	0	1625
7589	1647	5	19	33	0	1704
7590	1646	4	9	20	0	1679
7591	1641	8	12	11	0	1672
7592	39	7	1698	14	0	1758
7593	26	1	1692	11	0	1730
7594	14	1780	34	13	0	1841
7595	6	25	19	1768	0	1818
7596	8	7	13	1806	0	1834
7597	18	3	15	1697	0	1733
7598	14	3	7	1809	0	1833
7599	14	2	1791	39	0	1846
7600	16	1815	31	16	0	1878
7601	1945	23	14	20	0	2002
7602	2203	12	11	15	0	2241
7603	2261	1	14	18	0	2294
7604	68	2294	10	14	0	2386
7605	19	55	11	2347	0	2432
7606	2472	19	12	59	0	2562
7607	64	2573	10	33	0	2680
7608	2540	60	7	21	0	2628
7609	67	2563	11	15	0	2656
7610	2577	63	10	17	0	2667
7611	2607	22	7	14	0	2650
7612	87	13	12	2588	0	2700
7613	35	12	10	2754	0	2811
7614	25	10	2670	87	0	2792
7615	27	12	2592	37	0	2668
7616	2639	10	87	22	0	2758
7617	2750	16	34	16	0	2816
7618	95	5	17	2695	0	2812
7619	41	6	11	2743	0	2801
7620	16	9	2681	106	0	2812
7621	28	10	69	2660	0	2767
7622	27	12	2664	85	0	2788
7623	19	9	79	2657	0	2764
7624	26	7	28	2752	0	2813
7625	2688	11	18	108	0	2825
7626	2716	5	11	58	0	2790
7627	100	6	17	2685	0	2808
7628	42	4	23	2730	0	2799
7629	27	8	2640	108	0	2783
7630	32	9	73	2684	0	2798
7631	34	9	2667	98	0	2808
7632	2601	10	79	60	0	2750
7633	93	7	40	2700	0	2840
7634	2699	13	22	99	0	2833
7635	87	2675	22	57	0	2841
7636	2701	70	26	33	0	2830
7637	96	27	15	2689	0	2827
7638	54	11	14	2686	0	2765
7639	43	2634	21	108	0	2806
7640	36	76	16	2697	0	2825
7641	33	25	2634	109	0	2801
7642	35	15	81	2636	0	2767
7643	26	10	2533	100	0	2669
7644	21	2397	77	56	0	2551
7645	20	58	40	2456	0	2574
7646	25	27	2419	89	0	2560
7647	26	5	2375	42	0	2448
7648	16	23	82	2346	0	2467
7649	2324	11	45	83	0	2463
7650	71	11	2325	38	0	2445
7651	34	3	72	2312	0	2421
7652	2329	3	35	82	0	2449
7653	67	2232	15	50	0	2364
7654	2379	61	18	38	0	2496
7655	71	23	18	2386	0	2498
7656	33	9	14	2419	0	2475
7657	27	10	22	2431	0	2490
7658	2359	12	12	105	0	2488
7659	75	5	8	2422	0	2510
7660	36	9	18	2498	0	2561
7661	2373	7	18	95	0	2493
7662	72	6	2340	64	0	2482
7663	42	4	63	2385	0	2494
7664	23	11	2353	81	0	2468
7665	2293	9	70	53	0	2425
7666	80	7	31	2351	0	2469
7667	33	15	2355	82	0	2485
7668	2311	8	67	45	0	2431
7669	2384	10	33	39	0	2466
7670	93	10	2476	37	0	2616
7671	40	12	67	2447	0	2566
7672	35	7	37	2531	0	2610
7673	19	10	2517	110	0	2656
7674	22	2509	68	59	0	2658
7675	26	65	2560	27	0	2678
7676	2443	21	85	35	0	2584
7677	72	11	2606	42	0	2731
7678	2488	8	89	38	0	2623
7679	94	11	2571	24	0	2700
7680	2492	6	76	33	0	2607
7681	80	2600	50	33	0	2763
7682	45	56	32	2576	0	2709
7683	47	20	18	2660	0	2745
7684	26	8	2660	99	0	2793
7685	23	10	60	2565	0	2658
7686	27	2579	33	93	0	2732
7687	2519	54	24	49	0	2646
7688	69	2494	19	52	0	2634
7689	33	62	31	2564	0	2690
7690	2560	17	20	91	0	2688
7691	69	2570	26	46	0	2711
7692	2527	62	16	41	0	2646
7693	81	25	2571	27	0	2704
7694	54	10	68	2559	0	2691
7695	34	14	38	2580	0	2666
7696	24	13	23	2672	0	2732
7697	2608	9	21	110	0	2748
7698	2627	5	31	53	0	2716
7699	2643	12	20	35	0	2710
7700	2639	13	22	37	0	2711
7701	105	7	2407	29	0	2548
7702	2062	9	45	18	0	2134
7703	59	2080	24	16	0	2179
7704	25	2075	13	10	0	2123
7705	2069	45	59	13	0	2186
7706	2014	9	20	17	0	2060
7707	33	6	6	1893	0	1938
7708	1935	6	3	31	0	1975
7709	1933	1	4	15	0	1953
7710	2129	4	6	9	0	2148
7711	47	3	4	2121	0	2175
7712	17	2073	7	32	0	2129
7713	10	2073	4	10	0	2097
7714	12	34	4	2104	0	2154
7715	2060	10	0	34	0	2104
7716	35	2088	5	9	0	2137
7717	12	30	0	2114	0	2156
7718	12	5	2097	32	0	2146
7719	1948	3	38	13	0	2002
7720	36	2097	5	8	0	2146
7721	12	2166	2	8	0	2188
7722	2122	30	5	9	0	2166
7723	38	4	2142	9	0	2193
7724	11	0	30	2096	0	2137
7725	9	2158	6	28	0	2201
7726	14	29	8	2169	0	2220
7727	12	8	8	2163	0	2191
7728	15	1888	4	36	0	1943
7729	9	28	3	2204	0	2244
7730	10	13	3	2222	0	2248
7731	2206	6	3	35	0	2250
7732	38	2170	3	11	0	2222
7733	2171	33	5	11	0	2220
7734	37	14	0	2150	0	2201
7735	10	2153	6	35	0	2204
7736	12	31	2182	7	0	2232
7737	10	9	37	2164	0	2220
7738	11	7	8	2257	0	2283
7739	6	9	2291	39	0	2345
7740	2194	3	33	18	0	2248
7741	36	8	11	2595	0	2650
7742	2619	12	2	49	0	2682
7743	52	10	2529	19	0	2610
7744	16	7	50	2569	0	2642
7745	15	6	2713	60	0	2794
7746	7	15	55	2717	0	2794
7747	12	9	12	2804	0	2837
7748	2750	12	10	68	0	2840
7749	57	2768	3	31	0	2859
7750	2765	56	8	18	0	2847
7751	64	17	2768	13	0	2862
7752	21	9	56	2771	0	2857
7753	16	16	2841	62	0	2935
7754	2460	5	62	27	0	2554
7755	2778	8	12	23	0	2821
7756	70	7	2760	17	0	2854
7757	2728	6	59	13	0	2806
7758	2872	9	20	19	0	2920
7759	73	5	13	2823	0	2914
7760	32	7	2747	64	0	2850
7761	18	8	2834	29	0	2889
7762	11	7	63	2866	0	2947
7763	22	5	25	2811	0	2863
7764	18	2789	17	70	0	2894
7765	15	2891	15	38	0	2959
7766	2885	68	12	28	0	2993
7767	71	27	10	2835	0	2943
7768	30	2768	15	69	0	2882
7769	19	2918	14	33	0	2984
7770	2779	70	15	24	0	2888
7771	65	24	15	2796	0	2900
7772	34	2816	15	73	0	2938
7773	23	61	17	2794	0	2895
7774	22	20	13	2803	0	2858
7775	25	11	17	2783	0	2836
7776	2752	6	10	95	0	2863
7777	77	2735	17	28	0	2857
7778	32	66	19	2757	0	2874
7779	30	19	19	2787	0	2855
7780	24	12	19	2808	0	2863
7781	16	10	2670	89	0	2785
7782	2536	10	65	48	0	2659
7783	70	13	30	2686	0	2799
7784	2617	7	19	83	0	2726
7785	2640	10	18	36	0	2704
7786	2627	18	15	27	0	2687
7787	91	14	2595	23	0	2723
7788	40	2604	66	25	0	2735
7789	31	70	24	2554	0	2679
7790	18	34	2556	68	0	2676
7791	26	25	2463	37	0	2551
7792	17	26	66	2386	0	2495
7793	16	2404	25	71	0	2516
7794	2440	58	18	38	0	2554
7795	2468	20	11	34	0	2533
7796	2497	18	12	36	0	2563
7797	2485	18	7	28	0	2538
7798	79	18	2436	35	0	2568
7799	2399	14	57	29	0	2499
7800	69	2463	23	30	0	2585
7801	24	57	17	2526	0	2624
7802	25	22	18	2571	0	2636
7803	2541	13	18	81	0	2653
7804	80	8	6	2538	0	2632
7805	35	9	2474	67	0	2585
7806	2360	13	58	31	0	2462
7807	2476	4	24	33	0	2537
7808	2459	6	24	24	0	2513
7809	85	13	2397	20	0	2515
7810	2167	9	55	19	0	2250
7811	67	2209	20	20	0	2316
7812	2207	43	31	27	0	2308
7813	56	19	17	2195	0	2287
7814	24	17	15	2204	0	2260
7815	23	2168	11	56	0	2258
7816	19	41	12	2149	0	2221
7817	17	2168	8	50	0	2243
7818	28	53	8	2144	0	2233
7819	24	2132	8	57	0	2221
7820	18	51	10	2146	0	2225
7821	21	2167	6	52	0	2246
7822	22	56	8	2221	0	2307
7823	17	2236	11	61	0	2325
7824	2465	55	7	28	0	2555
7825	80	19	6	2541	0	2646
7826	31	22	7	2607	0	2667
7827	30	9	12	2759	0	2810
7828	26	8	5	2818	0	2857
7829	18	12	2769	114	0	2913
7830	24	7	84	2787	0	2902
7831	23	6	25	2876	0	2930
7832	2802	10	14	110	0	2936
7833	2802	9	11	41	0	2863
7834	108	2794	8	39	0	2949
7835	48	78	8	2823	0	2957
7836	33	20	11	3024	0	3088
7837	3066	21	9	121	0	3217
7838	114	13	2878	48	0	3053
7839	2873	12	86	31	0	3002
7840	103	2946	24	25	0	3098
7841	2673	70	11	18	0	2772
7842	2677	20	5	13	0	2715
7843	91	2639	4	14	0	2748
7844	24	2731	8	14	0	2777
7845	16	89	21	2538	0	2664
7846	10	25	2506	77	0	2618
7847	2417	11	64	27	0	2519
7848	80	6	2482	14	0	2582
7849	2402	6	73	10	0	2491
7850	80	8	2451	7	0	2546
7851	23	2438	67	13	0	2541
7852	16	61	21	2433	0	2531
7853	2370	18	10	70	0	2468
7854	2438	8	12	22	0	2480
7855	90	11	6	2395	0	2502
7856	2494	6	7	75	0	2582
7857	2555	7	6	20	0	2588
7858	87	2461	9	8	0	2565
7859	2475	72	1	11	0	2559
7860	83	2503	8	7	0	2601
7861	33	69	6	2456	0	2564
7862	2398	18	5	78	0	2499
7863	2511	10	7	19	0	2547
7864	2540	8	6	11	0	2565
7865	93	6	2457	8	0	2564
7866	32	11	2489	5	0	2537
7867	19	7	85	2507	0	2618
7868	20	6	24	2641	0	2691
7869	20	2751	10	109	0	2890
7870	2765	85	5	40	0	2895
7871	101	26	5	2747	0	2879
7872	38	13	5	2829	0	2885
7873	23	7	2745	116	0	2891
7874	19	2665	84	40	0	2808
7875	17	2823	25	28	0	2893
7876	18	110	11	2782	0	2921
7877	2696	36	9	106	0	2847
7878	101	17	6	2708	0	2832
7879	41	14	6	2805	0	2866
7880	2727	13	10	121	0	2871
7881	2798	12	8	49	0	2867
7882	131	6	8	2748	0	2893
7883	50	8	2705	113	0	2876
7884	32	6	93	2763	0	2894
7885	23	12	34	2828	0	2897
7886	2768	11	17	145	0	2941
7887	109	7	10	2793	0	2919
7888	2794	6	9	136	0	2945
7889	121	12	2818	55	0	3006
7890	50	12	97	2912	0	3071
7891	25	12	34	3031	0	3102
7892	33	7	14	3065	0	3119
7893	38	7	10	3043	0	3098
7894	26	17	11	2993	0	3047
7895	24	21	2841	155	0	3041
7896	2804	13	101	76	0	2994
7897	118	9	34	2879	0	3040
7898	57	10	2787	133	0	2987
7899	35	13	2850	67	0	2965
7900	35	15	119	2815	0	2984
7901	2785	11	56	127	0	2979
7902	2841	15	25	66	0	2947
7903	2930	13	27	46	0	3016
7904	154	13	21	2723	0	2911
7905	65	2769	26	119	0	2979
7906	2850	99	25	58	0	3032
7907	2928	39	13	52	0	3032
7908	2960	26	15	44	0	3045
7909	2960	18	20	35	0	3033
7910	153	18	16	2851	0	3038
7911	71	21	2786	132	0	3010
7912	59	12	107	2826	0	3004
7913	54	20	2805	132	0	3011
7914	2792	12	112	64	0	2980
7915	2896	13	44	57	0	3010
7916	157	9	2787	48	0	3001
7917	2774	12	105	45	0	2936
7918	2885	14	50	54	0	3003
7919	165	12	24	2762	0	2963
7920	83	2767	18	131	0	2999
7921	2823	97	23	61	0	3004
7922	140	54	19	2666	0	2879
7923	76	2646	15	117	0	2854
7924	52	84	12	2524	0	2672
7925	40	31	2450	108	0	2629
7926	51	2459	74	56	0	2640
7927	2303	64	46	61	0	2474
7928	2326	35	24	44	0	2429
7929	2269	9	20	34	0	2332
7930	2305	8	19	39	0	2371
7931	92	22	22	2194	0	2330
7932	61	2201	16	75	0	2353
7933	2074	61	22	61	0	2218
7934	93	24	2174	31	0	2322
7935	60	2091	60	32	0	2243
7936	34	37	1947	36	0	2054
7937	31	26	53	1764	0	1874
7938	24	1600	37	53	0	1714
7939	24	39	21	1825	0	1909
7940	24	24	1909	62	0	2019
7941	28	16	47	1880	0	1971
7942	26	4	28	1987	0	2045
7943	22	12	12	2038	0	2084
7944	1934	9	16	69	0	2028
7945	62	1933	17	45	0	2057
7946	38	35	14	1967	0	2054
7947	1919	17	15	68	0	2019
7948	54	1954	19	43	0	2070
7949	1974	43	12	32	0	2061
7950	71	23	1982	29	0	2105
7951	40	15	43	1900	0	1998
7952	37	1979	31	43	0	2090
7953	1987	46	21	30	0	2084
7954	74	18	1967	24	0	2083
7955	45	1838	44	24	0	1951
7956	40	41	19	1841	0	1941
7957	29	21	23	1863	0	1936
7958	1844	16	14	57	0	1931
7959	52	13	16	1834	0	1915
7960	35	15	1779	47	0	1876
7961	39	10	34	1739	0	1822
7962	23	6	1838	52	0	1919
7963	32	14	38	1705	0	1789
7964	22	1781	17	50	0	1870
7965	1801	30	23	27	0	1881
7966	1781	16	10	27	0	1834
7967	55	1704	16	11	0	1786
7968	17	1558	3	16	0	1594
7969	8	14	16	1533	0	1571
7970	1532	5	6	19	0	1562
7971	22	3	4	1527	0	1556
7972	1521	7	7	17	0	1552
7973	21	1484	1	4	0	1510
7974	7	14	5	1536	0	1562
7975	12	2	1584	18	0	1616
7976	14	7	13	1549	0	1583
7977	11	3	2	1600	0	1616
7978	1630	8	5	16	0	1659
7979	17	1652	3	8	0	1680
7980	8	8	3	1700	0	1719
7981	1686	7	2	23	0	1718
7982	16	7	1683	8	0	1714
7983	1660	0	12	10	0	1682
7984	15	11	4	1705	0	1735
7985	6	1745	2	14	0	1767
7986	1739	9	5	6	0	1759
7987	18	1	1761	3	0	1783
7988	13	6	1700	5	0	1724
7989	10	1698	20	5	0	1733
7990	1653	7	9	2	0	1671
7991	8	1	1	1649	0	1659
7992	3	2	2	1645	0	1652
7993	1692	0	1	18	0	1711
7994	19	2	1680	4	0	1705
7995	8	1	17	1713	0	1739
7996	1	0	1814	21	0	1836
7997	0	0	24	1793	0	1817
7998	2	1816	5	20	0	1843
7999	3	23	3	1894	0	1923
8000	0	4	1871	26	0	1901
8001	1820	2	27	10	0	1859
8002	24	3	4	1901	0	1932
8003	6	1	1911	27	0	1945
8004	4	1	22	1858	0	1885
8005	1	1	7	1924	0	1933
8006	1	2	1884	34	0	1921
8007	3	1	1883	9	0	1896
8008	3	2	32	1967	0	2004
8009	0	0	1967	31	0	1998
8010	1913	0	31	8	0	1952
8011	31	1	8	1991	0	2031
8012	1976	2	4	35	0	2017
8013	36	1	1960	8	0	2005
8014	7	2	31	1990	0	2030
8015	7	2	2139	28	0	2176
8016	3	2110	33	14	0	2160
8017	5	29	2146	6	0	2186
8018	5	8	2062	3	0	2078
8019	2023	2	37	9	0	2071
8020	2120	1	12	3	0	2136
8021	34	2	2184	4	0	2224
8022	12	1	33	2043	0	2089
8023	7	1	10	2097	0	2115
8024	6	0	2203	32	0	2241
8025	3	2115	30	14	0	2162
8026	2089	29	9	8	0	2135
8027	34	6	2215	3	0	2258
8028	8	6	33	2192	0	2239
8029	6	1	9	2257	0	2273
8030	2328	3	6	35	0	2372
8031	2346	2	6	12	0	2366
8032	2338	1	5	8	0	2352
8033	2356	2	5	5	0	2368
8034	40	3	2	2308	0	2353
8035	16	1	2562	29	0	2608
8036	12	1	32	2543	0	2588
8037	3	1	10	2598	0	2612
8038	3	1	9	2745	0	2758
8039	7	2	2707	47	0	2763
8040	2515	2	40	20	0	2577
8041	47	2	12	2705	0	2766
8042	12	3	2764	47	0	2826
8043	10	2813	44	15	0	2882
8044	6	39	17	2907	0	2969
8045	8	11	15	2941	0	2975
8046	2885	4	6	63	0	2958
8047	47	2929	6	27	0	3009
8048	13	46	2941	15	0	3015
8049	13	9	51	2880	0	2953
8050	10	8	11	2940	0	2969
8051	2903	2	12	59	0	2976
8052	2886	4	11	24	0	2925
8053	57	4	9	2947	0	3017
8054	2944	1	4	65	0	3014
8055	59	2891	5	21	0	2976
8056	19	45	3109	14	0	3187
8057	17	14	50	3081	0	3162
8058	7	5	17	3255	0	3284
8059	7	2	13	3251	0	3273
8060	10	6	6	3174	0	3196
8061	9	3144	7	65	0	3225
8062	3127	47	11	26	0	3211
8063	53	10	8	3174	0	3245
8064	20	3309	6	50	0	3385
8065	3363	48	8	18	0	3437
8066	3345	10	11	18	0	3384
8067	57	3416	6	16	0	3495
8068	22	47	5	3503	0	3577
8069	12	11	8	3526	0	3557
8070	13	13	8	3385	0	3419
8071	12	10	7	3519	0	3548
8072	3558	3	2	72	0	3635
8073	3570	4	2	31	0	3607
8074	68	3615	4	26	0	3713
8075	28	60	3576	21	0	3685
8076	21	14	64	3625	0	3724
8077	3685	8	16	68	0	3777
8078	68	3556	10	24	0	3658
8079	17	3606	6	21	0	3650
8080	3675	71	5	11	0	3762
8081	3732	18	4	15	0	3769
8082	93	10	2	3705	0	3810
8083	31	4	3776	79	0	3890
8084	19	13	3787	32	0	3851
8085	4093	10	81	30	0	4214
8086	4354	2	19	24	0	4399
8087	4340	6	13	12	0	4371
8088	4302	12	8	12	0	4334
8089	4300	7	12	9	0	4328
8090	100	4308	6	10	0	4424
8091	36	73	8	4271	0	4388
8092	16	4524	7	74	0	4621
8093	4615	64	4	19	0	4702
8094	4559	19	5	20	0	4603
8095	4564	13	5	14	0	4596
8096	4559	5	3	13	0	4580
8097	69	4468	8	17	0	4562
8098	4478	48	7	9	0	4542
8099	60	4456	6	11	0	4533
8100	24	61	1	4527	0	4613
8101	4480	12	1	54	0	4547
8102	59	17	4542	13	0	4631
8103	27	9	48	4423	0	4507
8104	25	4	11	4583	0	4623
8105	11	8	4586	63	0	4668
8106	7	4514	49	26	0	4596
8107	4524	48	18	20	0	4610
8108	4522	15	9	16	0	4562
8109	68	4511	3	13	0	4595
8110	26	45	4	4532	0	4607
8111	25	21	4707	44	0	4797
8112	20	4847	47	17	0	4931
8113	4798	49	10	38	0	4895
8114	61	16	4852	11	0	4940
8115	4289	14	48	18	0	4369
8116	4685	12	13	6	0	4716
8117	63	9	4857	17	0	4946
8118	27	4811	43	17	0	4898
8119	34	50	13	4698	0	4795
8120	20	18	4946	46	0	5030
8121	4559	14	49	23	0	4645
8122	4882	7	15	19	0	4923
8123	63	4892	12	11	0	4978
8124	24	53	8	4890	0	4975
8125	24	15	8	4993	0	5040
8126	21	11	4993	57	0	5082
8127	20	4986	44	23	0	5073
8128	5216	52	11	41	0	5320
8129	5261	20	14	15	0	5310
8130	5303	17	8	15	0	5343
8131	75	7	5254	8	0	5344
8132	5065	9	45	25	0	5144
8133	5381	10	15	10	0	5416
8134	70	13	12	5360	0	5455
8135	32	6	5168	43	0	5249
8136	29	7	40	5052	0	5128
8137	21	7	5172	47	0	5247
8138	18	10	42	4946	0	5016
8139	11	5002	14	41	0	5068
8140	9	5352	12	13	0	5386
8141	8	40	8	5447	0	5503
8142	9	14	8	5208	0	5239
8143	5244	13	4	52	0	5313
8144	44	7	5230	13	0	5294
8145	4935	6	30	18	0	4989
8146	40	5257	9	8	0	5314
8147	5316	38	6	9	0	5369
8148	5307	13	6	9	0	5335
8149	46	10	5	5291	0	5352
8150	25	6	5456	34	0	5521
8151	16	5	34	5423	0	5478
8152	13	5702	14	38	0	5767
8153	15	34	12	5781	0	5842
8154	15	21	4	5818	0	5858
8155	5750	11	6	64	0	5831
8156	43	3	5	5623	0	5674
8157	29	5501	8	41	0	5579
8158	15	47	12	5616	0	5690
8159	5658	14	6	50	0	5728
8160	45	5694	3	25	0	5767
8161	26	49	5	5859	0	5939
8162	22	24	5	5833	0	5884
8163	12	12	1	6094	0	6119
8164	18	8	10	5898	0	5934
8165	6002	9	3	91	0	6105
8166	66	12	4	6133	0	6215
8167	31	6	5	6201	0	6243
8168	21	6	8	6367	0	6402
8169	16	6441	1	115	0	6573
8170	6361	99	3	52	0	6515
8171	116	34	6427	28	0	6605
8172	34	6340	95	31	0	6500
8173	6129	103	41	21	0	6294
8174	96	27	6366	13	0	6502
8175	28	6389	85	16	0	6518
8176	25	93	28	6301	0	6447
8177	15	6430	18	81	0	6544
8178	10	91	6386	33	0	6520
8179	21	32	6343	26	0	6422
8180	5	6434	100	24	0	6563
8181	6459	89	39	24	0	6611
8182	6449	28	26	25	0	6528
8183	101	24	6159	12	0	6296
8184	41	14	5644	15	0	5714
8185	29	6	5919	4	0	5958
8186	13	15	109	5784	0	5921
8187	16	8	39	5735	0	5798
8188	9	4	25	5999	0	6037
8189	8	12	6102	114	0	6236
8190	11	9	95	5766	0	5881
8191	15	12	25	6063	0	6115
8192	12	7	5916	120	0	6055
8193	5640	7	102	55	0	5804
8194	104	9	24	6100	0	6237
8195	34	10	24	6048	0	6116
8196	29	6172	12	115	0	6328
8197	6165	91	24	50	0	6330
8198	97	33	6146	33	0	6309
8199	6023	25	101	21	0	6170
8200	118	11	34	6190	0	6353
8201	40	14	6249	110	0	6413
8202	32	12	105	6126	0	6275
8203	6170	12	44	141	0	6367
8204	107	9	6186	48	0	6350
8205	6034	8	120	46	0	6208
8206	6223	19	37	38	0	6317
8207	6286	6	30	24	0	6346
8208	141	6154	25	42	0	6362
8209	64	95	17	6284	0	6460
8210	6367	33	26	113	0	6539
8211	6298	24	24	44	0	6390
8212	6401	12	20	36	0	6469
8213	163	7	6160	28	0	6358
8214	6370	15	119	31	0	6535
8215	165	8	55	6824	0	7052
8216	67	11	6788	169	0	7035
8217	49	8	173	6987	0	7217
8218	40	11	58	7131	0	7240
8219	39	8	7246	241	0	7534
8220	32	10	192	7265	0	7499
8221	33	5	73	7526	0	7637
8222	20	19	8499	270	0	8808
8223	8938	8	278	113	0	9337
8224	9942	3	122	83	0	10150
8225	427	5	89	10196	0	10717
8226	219	11	10123	356	0	10709
8227	155	6	362	9852	0	10375
8228	102	9820	147	429	0	10498
8229	119	308	98	9909	0	10434
8230	81	115	84	10250	0	10530
8231	9912	77	70	559	0	10618
8232	9976	56	76	316	0	10424
8233	10273	41	64	226	0	10604
8234	560	76	39	9987	0	10662
8235	282	45	54	10322	0	10703
8236	228	23	9765	580	0	10596
8237	195	27	353	9610	0	10185
8238	175	9667	162	503	0	10507
8239	9809	334	105	303	0	10551
8240	453	9542	83	250	0	10328
8241	9697	404	63	234	0	10398
8242	503	183	98	9105	0	9889
8243	243	9413	74	455	0	10185
8244	9525	438	46	250	0	10259
8245	9740	189	66	185	0	10180
8246	568	145	50	9374	0	10137
8247	306	9434	40	463	0	10243
8248	245	401	60	9553	0	10259
8249	185	197	9297	529	0	10208
8250	9113	149	378	269	0	9909
8251	493	9215	134	252	0	10094
8252	9105	416	132	192	0	9845
8253	518	189	93	9058	0	9858
8254	9208	153	66	494	0	9921
8255	551	106	9125	245	0	10027
8256	9404	93	418	212	0	10127
8257	9595	109	171	167	0	10042
8258	699	78	9282	173	0	10232
8259	401	76	445	9196	0	10118
8260	327	74	200	9452	0	10053
8261	9102	66	175	602	0	9945
8262	569	8929	140	340	0	9978
8263	332	414	95	8853	0	9694
8264	252	176	8630	553	0	9611
8265	225	117	8640	337	0	9319
8266	214	8414	469	281	0	9378
8267	232	399	8445	231	0	9307
8268	8032	203	510	211	0	8956
8269	469	148	246	7887	0	8750
8270	8158	116	196	472	0	8942
8271	494	116	8038	233	0	8881
8272	283	111	426	8074	0	8894
8273	239	131	235	8291	0	8896
8274	243	88	7911	534	0	8776
8275	203	97	426	8009	0	8735
8276	7779	88	210	561	0	8638
8277	8098	88	196	297	0	8679
8278	581	83	149	7883	0	8696
8279	7846	71	119	577	0	8613
8280	8000	64	131	310	0	8505
8281	601	7496	122	298	0	8517
8282	388	360	105	7682	0	8535
8283	7845	153	92	501	0	8591
8284	570	129	111	7807	0	8617
8285	7733	111	85	553	0	8482
8286	597	104	103	7635	0	8439
8287	408	87	7500	541	0	8536
8288	297	7469	369	359	0	8494
8289	333	375	169	6677	0	7554
8290	269	7385	162	501	0	8317
8291	7288	404	157	318	0	8167
8292	511	7069	110	286	0	7976
8293	277	7207	154	238	0	7876
8294	260	507	110	7031	0	7908
8295	7027	276	103	512	0	7918
8296	503	222	98	7071	0	7894
8297	7006	200	105	536	0	7847
8298	7054	181	87	336	0	7658
8299	568	6965	86	260	0	7879
8300	7122	416	121	234	0	7893
8301	7272	219	94	228	0	7813
8302	7358	170	109	208	0	7845
8303	700	145	6680	176	0	7701
8304	456	139	366	6709	0	7670
8305	393	115	154	7034	0	7696
8306	331	95	6462	538	0	7426
8307	6803	97	374	306	0	7580
8308	7079	90	194	305	0	7668
8309	7089	89	193	227	0	7598
8310	6874	68	146	268	0	7356
8311	681	6387	100	242	0	7410
8312	6539	318	108	184	0	7149
8313	646	138	106	6270	0	7160
8314	456	146	5568	413	0	6583
8315	5728	92	267	250	0	6337
8316	564	5645	134	199	0	6542
8317	5349	308	131	166	0	5954
8318	527	5083	100	130	0	5840
8319	313	4899	74	168	0	5454
8320	271	4869	98	159	0	5397
8321	260	4790	89	158	0	5297
8322	175	272	3537	105	0	4089
8323	146	304	194	2634	0	3278
8324	74	38	2327	139	0	2578
8325	1766	20	75	38	0	1899
8326	72	1789	26	38	0	1925
8327	42	1864	14	30	0	1950
8328	36	81	14	1766	0	1897
8329	37	39	8	1810	0	1894
8330	32	33	1742	77	0	1884
8331	17	31	1750	43	0	1841
8332	26	20	71	1743	0	1860
8333	29	14	1751	72	0	1866
8334	28	1716	64	36	0	1844
8335	46	56	26	1649	0	1777
8336	37	25	12	1841	0	1915
8337	37	18	1783	74	0	1912
8338	36	16	56	1766	0	1874
8339	1781	6	23	71	0	1881
8340	70	4	19	1791	0	1884
8341	25	12	26	1791	0	1854
8342	27	4	1742	93	0	1866
8343	1662	14	59	47	0	1782
8344	80	1760	25	22	0	1887
8345	55	49	9	1757	0	1870
8346	43	24	1741	56	0	1864
8347	44	12	48	1742	0	1846
8348	1748	20	19	59	0	1846
8349	71	19	1759	31	0	1880
8350	43	11	48	1759	0	1861
8351	27	14	1830	65	0	1936
8352	35	1831	57	32	0	1955
8353	45	61	1828	16	0	1950
8354	24	1819	50	15	0	1908
8355	7	35	1555	19	0	1616
8356	5	12	33	1410	0	1460
8357	5	1489	15	24	0	1533
8358	1467	23	5	11	0	1506
8359	24	11	6	1473	0	1514
8360	1506	8	2	23	0	1539
8361	25	13	3	1560	0	1601
8362	9	8	4	1609	0	1630
8363	1599	4	3	29	0	1635
8364	1649	3	5	12	0	1669
8365	33	2	4	1739	0	1778
8366	12	3	1802	25	0	1842
8367	11	1785	17	10	0	1823
8368	8	18	1779	10	0	1815
8369	8	1829	22	5	0	1864
8370	1793	17	13	4	0	1827
8371	22	8	1761	8	0	1799
8372	8	5	1738	5	0	1756
8373	12	6	18	1706	0	1742
8374	1762	3	10	24	0	1799
8375	20	3	1819	10	0	1852
8376	10	1903	20	9	0	1942
8377	1986	15	7	6	0	2014
8378	1992	6	6	5	0	2009
8379	2008	5	5	9	0	2027
8380	2022	6	3	3	0	2034
8381	1998	3	6	6	0	2013
8382	27	6	1975	7	0	2015
8383	14	6	22	1874	0	1916
8384	12	1893	9	17	0	1931
8385	1984	19	7	6	0	2016
8386	23	1994	2	3	0	2022
8387	1862	16	2	4	0	1884
8388	1864	4	2	7	0	1877
8389	22	1850	5	3	0	1880
8390	1872	17	8	10	0	1907
8391	19	5	4	1872	0	1900
8392	6	4	3	1893	0	1906
8393	7	5	1838	17	0	1867
8394	6	1864	15	8	0	1893
8395	10	19	2	1892	0	1923
8396	10	4	3	1914	0	1931
8397	8	3	3	1910	0	1924
8398	6	4	1865	22	0	1897
8399	1741	3	16	18	0	1778
8400	20	2	6	1889	0	1917
8401	1899	4	5	23	0	1931
8402	21	2	5	1893	0	1921
8403	8	8	1967	21	0	2004
8404	12	2	1952	10	0	1976
8405	1904	2	21	13	0	1940
8406	2023	2	16	12	0	2053
8407	19	1980	12	9	0	2020
8408	11	15	1979	3	0	2008
8409	10	4	19	1909	0	1942
8410	20	20	24	1443	0	1507
8411	2045	7	8	19	0	2079
8412	2058	2	9	10	0	2079
8413	2047	3	7	11	0	2068
8414	26	6	2043	5	0	2080
8415	2092	3	14	24	0	2133
8416	26	3	6	2126	0	2161
8417	8	4	7	2122	0	2141
8418	12	5	7	2130	0	2154
8419	14	2079	3	21	0	2117
8420	2075	13	6	12	0	2106
8421	22	4	1	2077	0	2104
8422	12	8	2065	16	0	2101
8423	11	5	19	2019	0	2054
8424	8	2054	7	22	0	2091
8425	2076	14	11	14	0	2115
8426	19	9	4	2068	0	2100
8427	10	9	5	2034	0	2058
8428	13	8	2097	18	0	2136
8429	12	3	18	2088	0	2121
8430	12	2097	8	23	0	2140
8431	11	15	9	2154	0	2189
8432	8	9	2135	26	0	2178
8433	1888	8	13	23	0	1932
8434	2061	4	8	11	0	2084
8435	19	2108	9	11	0	2147
8436	2072	15	9	11	0	2107
8437	2107	7	2	12	0	2128
8438	23	2124	5	8	0	2160
8439	12	26	5	2163	0	2206
8440	2227	2	5	22	0	2256
8441	20	2272	6	5	0	2303
8442	5	20	2256	13	0	2294
8443	2251	5	16	18	0	2290
8444	2345	8	3	14	0	2370
8445	2374	6	10	10	0	2400
8446	2365	6	8	6	0	2385
8447	39	2461	2	3	0	2505
8448	2489	21	2	12	0	2524
8449	2532	4	3	8	0	2547
8450	2516	9	4	8	0	2537
8451	41	4	6	2546	0	2597
8452	2534	1	5	25	0	2565
8453	37	2687	0	9	0	2733
8454	21	26	2861	14	0	2922
8455	12	9	33	2945	0	2999
8456	2991	10	13	37	0	3051
8457	40	5	2991	10	0	3046
8458	24	2	36	2979	0	3041
8459	15	4	2966	41	0	3026
8460	11	2974	44	14	0	3043
8461	3	47	15	2932	0	2997
8462	4	12	2946	42	0	3004
8463	3	2903	41	13	0	2960
8464	9	44	9	2905	0	2967
8465	2871	13	9	50	0	2943
8466	2861	8	7	13	0	2889
8467	2888	5	1	12	0	2906
8468	2873	0	3	8	0	2884
8469	2872	1	2	6	0	2881
8470	62	1	2887	5	0	2955
8471	2881	3	33	11	0	2928
8472	2983	3	13	3	0	3002
8473	56	0	8	2962	0	3026
8474	2977	1	8	43	0	3029
8475	2897	1	2	14	0	2914
8476	57	2817	2	11	0	2887
8477	21	41	3	2858	0	2923
8478	17	14	2	2907	0	2940
8479	2883	8	0	58	0	2949
8480	46	2881	4	21	0	2952
8481	21	2926	4	16	0	2967
8482	12	58	2	2993	0	3065
8483	12	20	4	3014	0	3050
8484	8	24	2	2930	0	2964
8485	5	7	5	3050	0	3067
8486	2953	3	2	71	0	3029
8487	2938	3	1	35	0	2977
8488	55	4	2969	18	0	3046
8489	30	0	41	2884	0	2955
8490	23	3	14	2993	0	3033
8491	14	3	2944	59	0	3020
8492	2804	2	45	34	0	2885
8493	46	2934	17	19	0	3016
8494	2931	44	10	11	0	2996
8495	55	15	8	2929	0	3007
8496	24	9	2991	50	0	3074
8497	15	7	50	2986	0	3058
8498	10	3	3102	54	0	3169
8499	7	3107	51	26	0	3191
8500	3053	43	19	12	0	3127
8501	3087	23	7	13	0	3130
8502	58	3090	7	8	0	3163
8503	26	49	5	2992	0	3072
8504	2959	19	3	42	0	3023
8505	53	2943	3	24	0	3023
8506	26	45	3	2967	0	3041
8507	3007	18	1	55	0	3081
8508	51	13	2968	19	0	3051
8509	2915	6	45	12	0	2978
8510	56	3019	16	9	0	3100
8511	3050	43	11	8	0	3112
8512	3037	14	6	12	0	3069
8513	72	8	2983	5	0	3068
8514	31	10	45	2855	0	2941
8515	21	4	18	2976	0	3019
8516	13	3	2967	60	0	3043
8517	6	5	50	2886	0	2947
8518	15	2	22	2754	0	2793
8519	2986	6	9	70	0	3071
8520	2998	4	10	30	0	3042
8521	60	3	2	2973	0	3038
8522	29	3	2972	55	0	3059
8523	16	4	44	2981	0	3045
8524	13	3	18	3022	0	3056
8525	11	2	3059	67	0	3139
8526	15	2	51	3060	0	3128
8527	3057	2	22	57	0	3138
8528	3002	5	9	31	0	3047
8529	55	2966	10	17	0	3048
8530	3071	47	6	22	0	3146
8531	3065	16	5	15	0	3101
8532	66	3096	6	10	0	3178
8533	3145	55	0	11	0	3211
8534	3159	21	3	6	0	3189
8535	3249	8	4	8	0	3269
8536	83	8	3090	10	0	3191
8537	3103	4	53	8	0	3168
8538	67	5	16	3189	0	3277
8539	3183	2	8	59	0	3252
8540	68	5	3146	18	0	3237
8541	33	3039	51	12	0	3135
8542	3055	55	21	14	0	3145
8543	66	3188	7	13	0	3274
8544	26	56	5	3198	0	3285
8545	27	25	6	3271	0	3329
8546	3257	9	8	75	0	3349
8547	3175	15	7	36	0	3233
8548	90	4	3113	14	0	3221
8549	34	11	2890	12	0	2947
8550	19	8	2993	10	0	3030
8551	14	29	73	2922	0	3038
8552	12	3	2973	59	0	3047
8553	15	8	2759	32	0	2814
8554	33	71	67	2556	0	2727
8555	2781	0	35	59	0	2875
8556	2839	0	17	20	0	2876
8557	2850	1	13	12	0	2876
8558	2839	4	9	14	0	2866
8559	60	2	10	2821	0	2893
8560	24	2	7	2848	0	2881
8561	12	5	2909	54	0	2980
8562	17	3	44	2854	0	2918
8563	26	2	25	2662	0	2715
8564	2980	1	7	61	0	3049
8565	3014	1	7	24	0	3046
8566	62	1	4	2981	0	3048
8567	3016	0	7	63	0	3086
8568	3045	2	10	28	0	3085
8569	71	0	8	3032	0	3111
8570	31	3	6	2994	0	3034
8571	23	3	2915	75	0	3016
8572	18	5	2813	34	0	2870
8573	13	5	62	2922	0	3002
8574	15	3	21	3015	0	3054
8575	15	1	3001	69	0	3086
8576	2800	2	51	38	0	2891
8577	2892	0	23	27	0	2942
8578	63	0	2865	17	0	2945
8579	25	2831	54	15	0	2925
8580	2886	40	23	19	0	2968
8581	51	14	3032	15	0	3112
8582	28	9	53	2955	0	3045
8583	24	4	21	3085	0	3134
8584	3158	2	11	71	0	3242
8585	3321	4	12	27	0	3364
8586	64	5	4	3360	0	3433
8587	35	2	7	3552	0	3596
8588	3554	1	11	72	0	3638
8589	3596	1	8	33	0	3638
8590	3574	1	5	19	0	3599
8591	81	1	3579	13	0	3674
8592	35	2	51	3562	0	3650
8593	17	1	22	3683	0	3723
8594	3657	2	10	78	0	3747
8595	67	3643	9	31	0	3750
8596	3937	48	6	20	0	4011
8597	92	4004	7	12	0	4115
8598	39	78	9	4160	0	4286
8599	16	20	7	4274	0	4317
8600	18	6	4183	124	0	4331
8601	15	14	86	4178	0	4293
8602	18	7	4205	112	0	4342
8603	22	10	95	4228	0	4355
8604	13	7	33	4259	0	4312
8605	14	4041	14	134	0	4203
8606	19	4278	19	44	0	4360
8607	24	102	10	4138	0	4274
8608	14	26	20	4305	0	4365
8609	16	17	16	4335	0	4384
8610	25	8	12	4405	0	4450
8611	17	16	13	4453	0	4499
8612	18	18	4323	152	0	4511
8613	10	16	107	4292	0	4425
8614	14	5	33	4454	0	4506
8615	16	9	4254	153	0	4432
8616	13	4183	112	63	0	4371
8617	12	90	31	4317	0	4450
8618	17	23	4286	132	0	4458
8619	15	4271	110	56	0	4452
8620	15	105	35	4341	0	4496
8621	4438	28	26	129	0	4621
8622	108	21	20	4418	0	4567
8623	40	16	8	4517	0	4581
8624	19	13	19	4572	0	4623
8625	20	17	17	4451	0	4505
8626	11	4290	14	173	0	4488
8627	26	97	10	4452	0	4585
8628	4610	32	12	157	0	4811
8629	109	12	18	4691	0	4830
8630	36	16	14	4682	0	4748
8631	24	6	16	4759	0	4805
8632	4513	12	20	156	0	4701
8633	4557	20	15	81	0	4673
8634	137	18	12	4589	0	4756
8635	4332	20	13	134	0	4499
8636	4466	11	6	77	0	4560
8637	118	4482	3	57	0	4660
8638	4402	86	10	59	0	4557
8639	98	4402	6	46	0	4552
8640	34	4479	10	44	0	4567
8641	14	101	15	4537	0	4667
8642	31	29	4531	111	0	4702
8643	19	16	85	4330	0	4450
8644	19	20	24	4395	0	4458
8645	15	4391	18	121	0	4545
8646	4381	88	13	51	0	4533
8647	95	26	5	4400	0	4526
8648	36	16	4658	110	0	4820
8649	25	26	78	4592	0	4721
8650	24	4704	23	108	0	4859
8651	4780	87	16	54	0	4937
8652	98	28	13	4815	0	4954
8653	28	19	4791	120	0	4958
8654	24	29	81	4743	0	4877
8655	17	4569	23	110	0	4719
8656	14	85	18	4668	0	4785
8657	4731	26	14	119	0	4890
8658	4783	20	13	69	0	4885
8659	4815	24	9	52	0	4900
8660	111	4800	11	59	0	4981
8661	4804	88	18	49	0	4959
8662	98	23	13	4840	0	4974
8663	4758	13	18	118	0	4907
8664	95	4816	10	68	0	4989
8665	45	92	10	4846	0	4993
8666	23	32	4877	113	0	5045
8667	4468	20	94	54	0	4636
8668	96	4881	22	48	0	5047
8669	33	95	10	4925	0	5063
8670	14	40	6	5028	0	5088
8671	31	18	7	4895	0	4951
8672	26	15	9	4812	0	4862
8673	25	4840	17	118	0	5000
8674	4910	101	4	69	0	5084
8675	4912	29	12	50	0	5003
8676	111	16	4968	51	0	5146
8677	52	19	87	4978	0	5136
8678	22	30	5013	118	0	5183
8679	4871	15	89	71	0	5046
8680	5032	16	41	45	0	5134
8681	4890	17	13	45	0	4965
8682	118	25	11	4721	0	4875
8683	33	4683	9	116	0	4841
8684	4752	87	10	65	0	4914
8685	103	21	9	4698	0	4831
8686	4604	15	13	115	0	4747
8687	95	27	4325	49	0	4496
8688	56	13	4203	36	0	4308
8689	4387	14	80	27	0	4508
8690	98	9	31	4401	0	4539
8691	4351	11	11	109	0	4482
8692	85	4300	23	46	0	4454
8693	4380	76	13	24	0	4493
8694	4448	22	10	22	0	4502
8695	116	10	4322	30	0	4478
8696	33	7	3817	24	0	3881
8697	17	3917	53	13	0	4000
8698	56	36	40	3783	0	3915
8699	3786	21	22	51	0	3880
8700	47	3	5	3750	0	3805
8701	20	4	11	3857	0	3892
8702	7	7	3737	45	0	3796
8703	3620	6	32	25	0	3683
8704	46	17	12	3874	0	3949
8705	23	2	3783	45	0	3853
8706	20	13	3693	17	0	3743
8707	18	31	42	3812	0	3903
8708	18	5	3829	43	0	3895
8709	15	4	3773	24	0	3816
8710	15	12	37	3419	0	3483
8711	11	11	3841	35	0	3898
8712	11	7	31	3710	0	3759
8713	17	3646	17	35	0	3715
8714	3890	25	5	26	0	3946
8715	32	3929	12	19	0	3992
8716	16	37	14	3928	0	3995
8717	16	3962	4	51	0	4033
8718	9	37	4133	24	0	4203
8719	11	17	59	4858	0	4945
8720	12	9	5947	103	0	6071
8721	5825	6	153	58	0	6042
8722	155	6397	59	18	0	6629
8723	6475	161	38	10	0	6684
8724	192	58	23	6432	0	6705
8725	6488	30	25	172	0	6715
8726	209	24	6384	69	0	6686
8727	87	6403	167	34	0	6691
8728	6319	181	64	29	0	6593
8729	210	69	33	6080	0	6392
8730	94	6281	18	175	0	6568
8731	59	196	28	6441	0	6724
8732	6511	85	32	212	0	6840
8733	212	7065	27	95	0	7399
8734	7113	242	24	57	0	7436
8735	277	97	6888	47	0	7309
8736	6852	54	232	44	0	7182
8737	288	48	73	6962	0	7371
8738	6958	39	45	258	0	7300
8739	278	6920	38	99	0	7335
8740	134	237	38	6933	0	7342
8741	84	97	27	7118	0	7326
8742	86	54	6746	305	0	7191
8743	57	50	216	6732	0	7055
8744	60	43	72	6969	0	7144
8745	40	40	48	7006	0	7134
8746	66	30	34	7033	0	7163
8747	52	28	6794	356	0	7230
8748	62	6410	233	156	0	6861
8749	46	222	94	6585	0	6947
8750	6436	87	47	302	0	6872
8751	6548	46	46	148	0	6788
8752	287	6518	43	100	0	6948
8753	6497	250	30	88	0	6865
8754	6586	93	43	78	0	6800
8755	6529	57	28	92	0	6706
8756	334	6363	38	91	0	6826
8757	6326	226	33	70	0	6655
8758	289	121	31	6109	0	6550
8759	141	48	6038	261	0	6488
8760	97	6065	215	120	0	6497
8761	95	231	83	6064	0	6473
8762	65	102	6010	252	0	6429
8763	5921	63	228	123	0	6335
8764	263	57	84	6010	0	6414
8765	130	38	62	6124	0	6354
8766	97	57	43	6058	0	6255
8767	87	47	37	6123	0	6294
8768	82	41	5734	348	0	6205
8769	5492	41	219	163	0	5915
8770	265	5731	78	117	0	6191
8771	5738	237	53	93	0	6121
8772	275	5806	47	74	0	6202
8773	5846	243	44	76	0	6209
8774	290	99	54	5763	0	6206
8775	144	76	5646	256	0	6122
8776	95	60	5715	143	0	6013
8777	95	52	268	5634	0	6049
8778	66	51	117	5777	0	6011
8779	81	37	67	5896	0	6081
8780	5591	39	65	371	0	6066
8781	265	32	5615	180	0	6092
8782	125	45	234	5355	0	5759
8783	94	5634	93	280	0	6101
8784	5613	237	62	151	0	6063
8785	266	94	5528	123	0	6011
8786	139	5472	245	96	0	5952
8787	94	242	5575	87	0	5998
8788	89	113	258	5594	0	6054
8789	86	76	5562	289	0	6013
8790	101	49	5681	149	0	5980
8791	67	57	320	5607	0	6051
8792	79	57	5594	301	0	6031
8793	80	42	5726	154	0	6002
8794	68	45	325	5561	0	5999
8795	5527	48	159	297	0	6031
8796	269	40	5563	155	0	6027
8797	117	56	288	5474	0	5935
8798	88	45	143	5690	0	5966
8799	5513	47	96	347	0	6003
8800	274	50	92	5600	0	6016
8801	5450	37	91	331	0	5909
8802	285	5373	81	174	0	5913
8803	133	225	73	5537	0	5968
8804	5438	75	74	339	0	5926
8805	5619	54	71	174	0	5918
8806	329	54	76	5506	0	5965
8807	157	37	5390	326	0	5910
8808	5275	42	257	170	0	5744
8809	297	5433	113	126	0	5969
8810	5204	239	69	142	0	5654
8811	5572	86	64	116	0	5838
8812	5655	52	65	117	0	5889
8813	366	52	5319	119	0	5856
8814	185	5258	230	95	0	5768
8815	154	265	115	5189	0	5723
8816	150	130	67	5416	0	5763
8817	103	73	5150	320	0	5646
8818	97	4850	218	165	0	5330
8819	54	4012	73	101	0	4240
8820	43	3167	46	49	0	3305
8821	2857	102	157	49	0	3165
8822	114	36	21	2717	0	2888
8823	32	22	22	2774	0	2850
8824	29	17	2746	102	0	2894
8825	2602	14	73	42	0	2731
8826	90	17	28	2735	0	2870
8827	46	45	19	2762	0	2872
8828	34	13	2681	104	0	2832
8829	19	2665	77	44	0	2805
8830	31	79	33	2680	0	2823
8831	14	24	2626	77	0	2741
8832	9	2362	53	35	0	2459
8833	1925	23	14	12	0	1974
8834	23	8	2034	7	0	2072
8835	13	5	19	1944	0	1981
8836	4	2010	12	19	0	2045
8837	2029	16	9	11	0	2065
8838	20	7	2	2019	0	2048
8839	2026	5	3	18	0	2052
8840	2031	2	1	11	0	2045
8841	25	2024	0	9	0	2058
8842	2067	18	2	7	0	2094
8843	2134	6	1	13	0	2154
8844	24	5	2165	5	0	2199
8845	2142	3	19	4	0	2168
8846	21	5	2175	6	0	2207
8847	2132	4	26	5	0	2167
8848	2168	3	5	5	0	2181
8849	25	4	2278	3	0	2310
8850	15	2	19	2229	0	2265
8851	4	1	2306	18	0	2329
8852	7	4	2104	9	0	2124
8853	7	6	2279	6	0	2298
8854	6	5	24	2248	0	2283
8855	7	0	9	2499	0	2515
8856	4	1	4	2526	0	2535
8857	3	3	3	2581	0	2590
8858	3	3	2629	31	0	2666
8859	5	4	25	2545	0	2579
8860	2	2485	10	30	0	2527
8861	5	25	2738	12	0	2780
8862	3	10	27	2660	0	2700
8863	20	6	2802	28	0	2856
8864	4	2710	31	13	0	2758
8865	4	2832	11	5	0	2852
8866	6	38	6	2804	0	2854
8867	2	12	2808	36	0	2858
8868	3	6	2777	16	0	2802
8869	3	5	44	2788	0	2840
8870	6	4	14	2813	0	2837
8871	3	0	10	2910	0	2923
8872	4	2	2884	40	0	2930
8873	4	2859	38	18	0	2919
8874	3	2981	12	14	0	3010
8875	4	34	6	3041	0	3085
8876	3	13	2950	31	0	2997
8877	7	10	2921	13	0	2951
8878	6	3069	41	7	0	3123
8879	3056	33	18	12	0	3119
8880	34	3144	8	9	0	3195
8881	14	41	3271	6	0	3332
8882	3278	11	41	8	0	3338
8883	40	7	13	3407	0	3467
8884	3502	2	9	50	0	3563
8885	48	6	2	3524	0	3580
8886	15	7	7	3594	0	3623
8887	3587	4	2	60	0	3653
8888	46	3661	6	22	0	3735
8889	16	50	3645	9	0	3720
8890	11	3712	46	7	0	3776
8891	3686	49	20	16	0	3771
8892	55	3673	7	8	0	3743
8893	3686	50	8	9	0	3753
8894	3691	18	13	5	0	3727
8895	58	3685	4	21	0	3768
8896	25	50	7	3647	0	3729
8897	3628	20	16	52	0	3716
8898	3681	8	8	25	0	3722
8899	68	5	9	3636	0	3718
8900	27	13	3548	53	0	3641
8901	12	9	3523	29	0	3573
8902	10	12	60	3616	0	3698
8903	8	4	3572	50	0	3634
8904	3387	4	52	27	0	3470
8905	43	3573	27	12	0	3655
8906	24	41	11	3639	0	3715
8907	5	16	4	3645	0	3670
8908	9	2	15	3567	0	3593
8909	7	8	6	3471	0	3492
8910	5	10	5	3570	0	3590
8911	8	9	3543	67	0	3627
8912	4	3514	50	27	0	3595
8913	3556	43	26	14	0	3639
8914	47	25	8	3551	0	3631
8915	24	7	6	3568	0	3605
8916	5	11	8	3579	0	3603
8917	9	3570	8	72	0	3659
8918	14	49	7	3631	0	3701
8919	6	25	4	3678	0	3713
8920	3558	6	4	78	0	3646
8921	50	3386	12	35	0	3483
8922	22	3458	7	17	0	3504
8923	10	58	6	3509	0	3583
8924	3431	23	9	59	0	3522
8925	58	7	3462	27	0	3554
8926	3245	13	46	25	0	3329
8927	55	10	3564	22	0	3651
8928	26	9	49	3525	0	3609
8929	16	10	17	3587	0	3630
8930	10	7	8	3555	0	3580
8931	11	10	2	3551	0	3574
8932	16	6	10	3429	0	3461
8933	3502	8	3	76	0	3589
8934	58	6	3428	33	0	3525
8935	24	5	53	3487	0	3569
8936	17	12	3624	57	0	3710
8937	13	3628	51	36	0	3728
8938	3639	49	22	31	0	3741
8939	56	21	3813	16	0	3906
8940	25	6	53	3861	0	3945
8941	16	11	23	3905	0	3955
8942	9	6	3934	88	0	4037
8943	14	9	3867	44	0	3934
8944	20	8	89	3588	0	3705
8945	3906	14	23	80	0	4023
8946	3930	7	14	42	0	3993
8947	85	3882	14	22	0	4003
8948	3977	62	17	16	0	4072
8949	70	27	13	3754	0	3864
8950	37	3947	9	73	0	4066
8951	14	62	11	4018	0	4105
8952	12	29	4044	81	0	4166
8953	16	11	61	3888	0	3976
8954	25	7	26	4065	0	4123
8955	3852	8	13	86	0	3959
8956	62	3839	8	47	0	3956
8957	3793	60	12	17	0	3882
8958	59	3820	14	15	0	3908
8959	3679	65	5	20	0	3769
8960	73	3673	13	15	0	3774
8961	29	3683	5	19	0	3736
8962	3672	73	18	25	0	3788
8963	63	30	20	3536	0	3649
8964	27	3604	9	63	0	3703
8965	3695	54	8	43	0	3800
8966	3708	21	14	27	0	3770
8967	3787	13	12	17	0	3829
8968	3720	11	7	21	0	3759
8969	76	3768	7	27	0	3878
8970	36	48	9	3814	0	3907
8971	11	31	6	3882	0	3930
8972	3881	11	6	78	0	3976
8973	59	11	6	3812	0	3888
8974	3807	13	5	73	0	3898
8975	59	13	3697	33	0	3802
8976	3604	15	50	37	0	3706
8977	64	8	3717	20	0	3809
8978	24	6	50	3666	0	3746
8979	3709	14	15	64	0	3802
8980	57	3622	13	27	0	3719
8981	3488	44	14	14	0	3560
8982	49	3400	4	16	0	3469
8983	32	42	5	3644	0	3723
8984	9	18	3515	45	0	3587
8985	3181	17	44	38	0	3280
8986	42	3480	16	13	0	3551
8987	22	43	2	3482	0	3549
8988	10	17	5	3396	0	3428
8989	14	4	5	3376	0	3399
8990	17	6	3355	46	0	3424
8991	14	3324	31	19	0	3388
8992	3359	30	15	11	0	3415
8993	3377	14	6	9	0	3406
8994	56	3359	1	18	0	3434
8995	3480	37	5	16	0	3538
8996	48	11	5	3469	0	3533
8997	16	3484	5	33	0	3538
8998	3471	35	1	23	0	3530
8999	44	11	3399	13	0	3467
9000	18	3400	35	11	0	3464
9001	10	36	11	3458	0	3515
9002	10	16	4	3511	0	3541
9003	19	8	3425	44	0	3496
9004	13	11	34	3264	0	3322
9005	15	10	3363	38	0	3426
9006	12	13	35	3322	0	3382
9007	11	7	9	3399	0	3426
9008	13	10	6	3406	0	3435
9009	16	11	7	3449	0	3483
9010	14	7	3388	45	0	3454
9011	10	8	3505	25	0	3548
9012	7	3943	61	19	0	4030
9013	15	59	24	4276	0	4374
9014	13	25	4439	73	0	4550
9015	8	4399	77	34	0	4518
9016	17	78	29	4568	0	4692
9017	14	31	4690	89	0	4824
9018	4423	15	91	37	0	4566
9019	4913	8	32	21	0	4974
9020	115	10	17	4896	0	5038
9021	43	11	4900	101	0	5055
9022	26	6	91	4838	0	4961
9023	4861	16	31	110	0	5018
9024	95	4987	16	45	0	5143
9025	5090	89	22	29	0	5230
9026	5194	34	12	22	0	5262
9027	133	20	10	4973	0	5136
9028	51	13	9	5057	0	5130
9029	35	12	12	5110	0	5169
9030	22	12	10	5098	0	5142
9031	22	7	11	5049	0	5089
9032	5001	14	18	141	0	5174
9033	5098	9	7	66	0	5180
9034	5068	12	18	36	0	5134
9035	144	13	4800	30	0	4987
9036	4775	9	79	31	0	4894
9037	121	8	31	4804	0	4964
9038	44	7	4780	109	0	4940
9039	28	4652	90	59	0	4829
9040	31	94	37	4601	0	4763
9041	27	36	22	4682	0	4767
9042	27	4681	14	114	0	4836
9043	29	88	17	4849	0	4983
9044	26	26	4791	127	0	4970
9045	24	23	4866	52	0	4965
9046	29	8	122	4880	0	5039
9047	4875	16	51	118	0	5060
9048	4836	15	28	62	0	4941
9049	138	10	4790	46	0	4984
9050	61	4466	100	47	0	4674
9051	39	4667	44	48	0	4798
9052	4486	114	30	40	0	4670
9053	123	40	4531	37	0	4731
9054	50	25	102	4496	0	4673
9055	4473	17	50	125	0	4665
9056	123	4359	23	57	0	4562
9057	49	4526	26	47	0	4648
9058	4472	116	16	41	0	4645
9059	114	52	16	4481	0	4663
9060	4691	24	10	125	0	4850
9061	132	18	25	5279	0	5454
9062	61	17	22	5449	0	5549
9063	41	15	5365	199	0	5620
9064	46	15	131	5565	0	5757
9065	30	20	52	5704	0	5806
9066	5634	21	32	218	0	5905
9067	156	20	28	5754	0	5958
9068	68	18	5677	201	0	5964
9069	5557	19	152	99	0	5827
9070	171	13	58	5703	0	5945
9071	5667	11	44	199	0	5921
9072	176	5373	44	93	0	5686
9073	84	5704	35	71	0	5894
9074	5594	190	30	72	0	5886
9075	5703	82	34	43	0	5862
9076	215	41	27	5546	0	5829
9077	110	29	5464	173	0	5776
9078	78	26	156	5572	0	5832
9079	5441	34	73	199	0	5747
9080	179	5431	45	96	0	5751
9081	98	164	36	5497	0	5795
9082	5404	70	28	200	0	5702
9083	211	41	5147	91	0	5490
9084	5242	44	154	82	0	5522
9085	4934	43	66	93	0	5136
9086	231	23	5227	59	0	5540
9087	120	23	5307	67	0	5517
9088	100	19	205	5147	0	5471
9089	68	26	87	5300	0	5481
9090	76	5382	54	220	0	5732
9091	62	163	47	5492	0	5764
9092	56	65	5485	237	0	5843
9093	73	39	167	5589	0	5868
9094	60	33	74	5890	0	6057
9095	60	16	5583	276	0	5935
9096	51	5573	197	127	0	5948
9097	52	175	80	5667	0	5974
9098	53	73	48	5837	0	6011
9099	5697	41	38	270	0	6046
9100	191	42	42	5741	0	6016
9101	95	26	5606	250	0	5977
9102	5494	25	174	146	0	5839
9103	5766	30	78	93	0	5967
9104	5830	31	59	88	0	6008
9105	277	27	5540	79	0	5923
9106	145	28	187	5542	0	5902
9107	90	35	104	5684	0	5913
9108	80	33	60	5775	0	5948
9109	5451	16	49	303	0	5819
9110	209	5441	56	162	0	5868
9111	99	153	5100	101	0	5453
9112	70	4828	145	85	0	5128
9113	67	4596	73	65	0	4801
9114	45	4584	49	69	0	4747
9115	85	187	66	4406	0	4744
9116	56	79	4313	165	0	4613
9117	3886	57	140	101	0	4184
9118	141	4156	63	69	0	4429
9119	3990	123	41	58	0	4212
9120	141	4126	33	59	0	4359
9121	4168	133	34	58	0	4393
9122	148	4271	29	53	0	4501
9123	97	137	4297	40	0	4571
9124	62	69	132	4232	0	4495
9125	51	44	67	4409	0	4571
9126	4314	34	40	185	0	4573
9127	152	34	33	4657	0	4876
9128	74	32	4583	199	0	4888
9129	62	29	139	4672	0	4902
9130	58	41	4651	182	0	4932
9131	36	4592	156	107	0	4891
9132	53	150	79	4313	0	4595
9133	44	4654	46	154	0	4898
9134	4651	164	40	87	0	4942
9135	165	82	38	4640	0	4925
9136	75	45	4609	181	0	4910
9137	61	45	4572	81	0	4759
9138	4514	48	176	78	0	4816
9139	157	33	91	4567	0	4848
9140	92	34	4500	170	0	4796
9141	64	41	4346	97	0	4548
9142	50	4380	186	60	0	4676
9143	49	159	92	3972	0	4272
9144	23	4280	63	144	0	4510
9145	30	150	36	4205	0	4421
9146	4246	60	44	175	0	4525
9147	138	44	32	4277	0	4491
9148	66	29	37	4385	0	4517
9149	4309	31	40	204	0	4584
9150	150	23	43	4540	0	4756
9151	73	39	26	4453	0	4591
9152	44	4588	36	197	0	4865
9153	4647	149	33	101	0	4930
9154	4784	69	33	70	0	4956
9155	188	43	28	4727	0	4986
9156	83	30	28	4816	0	4957
9157	65	25	35	4748	0	4873
9158	52	4427	27	219	0	4725
9159	47	4661	28	120	0	4856
9160	72	166	24	4459	0	4721
9161	3648	47	27	125	0	3847
9162	3705	26	20	52	0	3803
9163	118	3566	20	59	0	3763
9164	3313	93	16	36	0	3458
9165	94	3262	9	43	0	3408
9166	39	3319	10	44	0	3412
9167	94	96	18	3156	0	3364
9168	3127	45	15	96	0	3283
9169	88	2986	7	53	0	3134
9170	31	3132	6	36	0	3205
9171	24	99	10	3136	0	3269
9172	19	34	11	3231	0	3295
9173	21	30	3120	108	0	3279
9174	3058	22	80	48	0	3208
9175	3071	26	20	37	0	3154
9176	99	20	3153	36	0	3308
9177	45	28	3140	34	0	3247
9178	39	29	86	3206	0	3360
9179	18	30	25	3311	0	3384
9180	30	3269	15	112	0	3426
9181	18	92	13	3356	0	3479
9182	24	47	3289	112	0	3472
9183	24	33	81	3298	0	3436
9184	34	17	28	3358	0	3437
9185	3259	22	24	125	0	3430
9186	109	23	3221	69	0	3422
9187	3128	15	94	54	0	3291
9188	111	23	3175	43	0	3352
9189	36	20	101	3060	0	3217
9190	31	30	3044	102	0	3207
9191	13	22	3082	60	0	3177
9192	31	42	97	2994	0	3164
9193	2812	21	90	108	0	3031
9194	2781	22	27	60	0	2890
9195	95	2876	25	45	0	3041
9196	2824	74	33	33	0	2964
9197	2813	26	31	40	0	2910
9198	94	2798	34	28	0	2954
9199	48	70	29	2856	0	3003
9200	23	33	36	2928	0	3020
9201	28	21	27	2905	0	2981
9202	16	22	27	2936	0	3001
9203	21	21	2839	122	0	3003
9204	2755	20	79	50	0	2904
9205	96	17	28	2859	0	3000
9206	41	15	25	2840	0	2921
9207	34	2847	21	112	0	3014
9208	35	72	16	2930	0	3053
9209	30	36	2835	110	0	3011
9210	2754	19	79	62	0	2914
9211	89	22	2934	51	0	3096
9212	44	18	79	2892	0	3033
9213	2872	11	34	108	0	3025
9214	87	2924	20	66	0	3097
9215	41	73	17	3092	0	3223
9216	28	32	3071	106	0	3237
9217	19	31	74	3104	0	3228
9218	3081	19	24	107	0	3231
9219	90	19	3078	50	0	3237
9220	35	18	3004	41	0	3098
9221	32	2965	89	30	0	3116
9222	2847	81	35	31	0	2994
9223	82	2808	23	27	0	2940
9224	35	81	2697	34	0	2847
9225	22	28	2627	29	0	2706
9226	22	2593	80	35	0	2730
9227	2253	61	33	14	0	2361
9228	58	2257	23	18	0	2356
9229	15	52	13	2229	0	2309
9230	17	21	12	2284	0	2334
9231	13	13	2266	64	0	2356
9232	18	12	56	2246	0	2332
9233	11	7	2341	54	0	2413
9234	2242	13	58	24	0	2337
9235	2339	9	25	19	0	2392
9236	2352	12	17	16	0	2397
9237	59	14	2249	18	0	2340
9238	2252	16	54	23	0	2345
9239	58	8	20	2196	0	2282
9240	20	2248	20	57	0	2345
9241	2210	42	17	38	0	2307
9242	57	13	2141	16	0	2227
9243	2173	8	51	14	0	2246
9244	2206	4	22	11	0	2243
9245	63	6	2159	11	0	2239
9246	31	2161	53	19	0	2264
9247	24	48	22	2173	0	2267
9248	16	17	2176	52	0	2261
9249	16	5	2119	22	0	2162
9250	19	41	55	1840	0	1955
9251	13	6	1857	38	0	1914
9252	9	2	40	1769	0	1820
9253	11	4	20	1667	0	1702
9254	11	5	9	1810	0	1835
9255	5	7	1778	43	0	1833
9256	7	5	37	1767	0	1816
9257	7	4	1792	39	0	1842
9258	5	12	37	1792	0	1846
9259	1834	3	16	40	0	1893
9260	35	5	10	1846	0	1896
9261	10	1887	8	38	0	1943
9262	5	37	3	1964	0	2009
9263	1961	7	7	40	0	2015
9264	35	1983	6	25	0	2049
9265	13	41	10	2019	0	2083
9266	1990	11	7	51	0	2059
9267	48	5	1979	15	0	2047
9268	16	7	41	1987	0	2051
9269	12	3	2009	49	0	2073
9270	13	6	1963	19	0	2001
9271	12	3	50	1949	0	2014
9272	1976	4	18	45	0	2043
9273	47	8	1930	17	0	2002
9274	1897	3	48	13	0	1961
9275	50	8	17	1926	0	2001
9276	22	6	1915	45	0	1988
9277	11	3	1899	11	0	1924
9278	8	4	1901	12	0	1925
9279	13	8	45	1820	0	1886
9280	1852	5	31	39	0	1927
9281	36	1849	11	10	0	1906
9282	10	34	12	1838	0	1894
9283	7	9	7	1891	0	1914
9284	1877	4	8	50	0	1939
9285	1897	4	11	19	0	1931
9286	43	1868	14	9	0	1934
9287	1896	36	11	12	0	1955
9288	1925	8	5	13	0	1951
9289	53	6	9	1891	0	1959
9290	12	6	1895	41	0	1954
9291	1873	2	51	17	0	1943
9292	46	4	13	1930	0	1993
9293	17	3	5	1934	0	1959
9294	1901	6	6	50	0	1963
9295	44	6	6	1793	0	1849
9296	21	3	2	1842	0	1868
9297	1790	2	5	49	0	1846
9298	39	1824	8	15	0	1886
9299	1811	29	8	10	0	1858
9300	40	11	1807	14	0	1872
9301	1783	1	39	16	0	1839
9302	45	3	15	1787	0	1850
9303	15	1840	12	39	0	1906
9304	13	28	9	1866	0	1916
9305	11	5	7	1877	0	1900
9306	12	11	7	1904	0	1934
9307	1848	4	8	58	0	1918
9308	41	1797	9	19	0	1866
9309	11	1818	8	18	0	1855
9310	1773	31	6	21	0	1831
9311	46	9	1810	12	0	1877
9312	17	13	1817	8	0	1855
9313	1783	12	48	14	0	1857
9314	37	4	1800	8	0	1849
9315	15	4	33	1664	0	1716
9316	19	1	15	1542	0	1577
9317	5	11	9	1705	0	1730
9318	11	3	6	1737	0	1757
9319	11	1641	5	47	0	1704
9320	5	29	5	1753	0	1792
9321	14	6	1691	42	0	1753
9322	9	11	30	1675	0	1725
9323	8	11	1640	39	0	1698
9324	17	8	1626	10	0	1661
9325	9	4	42	1660	0	1715
9326	8	4	1693	34	0	1739
9327	15	2	35	1669	0	1721
9328	1691	5	19	39	0	1754
9329	35	4	1706	19	0	1764
9330	1634	2	29	24	0	1689
9331	40	4	9	1681	0	1734
9332	20	3	1677	42	0	1742
9333	16	1635	28	16	0	1695
9334	9	35	10	1689	0	1743
9335	14	4	1768	38	0	1824
9336	3	9	35	1767	0	1814
9337	1790	1	22	45	0	1858
9338	1830	6	21	15	0	1872
9339	1886	9	6	27	0	1928
9340	47	2	11	1913	0	1973
9341	18	5	12	1950	0	1985
9342	22	0	4	1994	0	2020
9343	2019	4	13	52	0	2088
9344	47	2070	9	23	0	2149
9345	23	35	8	2110	0	2176
9346	17	12	16	2150	0	2195
9347	2092	14	10	55	0	2171
9348	44	2135	10	36	0	2225
9349	16	40	13	2270	0	2339
9350	2269	17	9	60	0	2355
9351	2276	9	7	35	0	2327
9352	76	2	6	2241	0	2325
9353	2251	5	3	52	0	2311
9354	57	7	7	2254	0	2325
9355	30	7	2240	63	0	2340
9356	23	5	43	2268	0	2339
9357	10	7	23	2316	0	2356
9358	20	8	17	2324	0	2369
9359	2222	5	9	82	0	2318
9360	45	2194	8	41	0	2288
9361	2146	39	2	32	0	2219
9362	53	2096	4	12	0	2165
9363	16	2166	3	22	0	2207
9364	2154	50	9	14	0	2227
9365	45	2183	4	13	0	2245
9366	20	45	3	2197	0	2265
9367	2183	14	2	46	0	2245
9368	2194	14	2	26	0	2236
9369	49	3	11	2179	0	2242
9370	25	3	3	2162	0	2193
9371	14	2166	3	64	0	2247
9372	2245	35	2	41	0	2323
9373	2177	12	0	18	0	2207
9374	48	2238	1	16	0	2303
9375	33	2284	5	12	0	2334
9376	17	51	2	2302	0	2372
9377	2302	30	4	47	0	2383
9378	55	17	2	2276	0	2350
9379	21	11	0	2336	0	2368
9380	17	10	2235	60	0	2322
9381	19	4	2231	35	0	2289
9382	20	6	44	2264	0	2334
9383	13	7	2272	50	0	2342
9384	10	2282	42	28	0	2362
9385	3	45	14	2301	0	2363
9386	16	18	12	2331	0	2377
9387	18	19	2	2338	0	2377
9388	10	11	2306	66	0	2393
9389	11	10	2218	34	0	2273
9390	2220	8	44	29	0	2301
9391	42	2273	22	15	0	2352
9392	2264	31	14	11	0	2320
9393	51	20	1	2250	0	2322
9394	2300	13	4	50	0	2367
9395	52	7	5	2292	0	2356
9396	19	2322	4	48	0	2393
9397	2343	29	10	24	0	2406
9398	38	19	2291	22	0	2370
9399	22	2297	32	11	0	2362
9400	2292	39	18	14	0	2363
9401	44	13	14	2262	0	2333
9402	18	2253	3	42	0	2316
9403	20	32	7	2326	0	2385
9404	2288	21	4	48	0	2361
9405	39	22	5	2301	0	2367
9406	2299	5	1	57	0	2362
9407	56	9	2257	23	0	2345
9408	21	11	34	2262	0	2328
9409	2254	4	17	44	0	2319
9410	45	7	2201	28	0	2281
9411	23	2144	30	25	0	2222
9412	29	41	15	2067	0	2152
9413	15	18	2087	43	0	2163
9414	15	23	2078	25	0	2141
9415	18	17	41	2063	0	2139
9416	13	11	2079	33	0	2136
9417	6	7	2043	30	0	2086
9418	13	13	45	1977	0	2048
9419	2030	4	31	39	0	2104
9420	34	7	17	2045	0	2103
9421	21	8	4	2097	0	2130
9422	20	6	2079	48	0	2153
9423	9	5	36	2138	0	2188
9424	2200	5	18	59	0	2282
9425	38	7	2204	24	0	2273
9426	24	2226	35	26	0	2311
9427	19	34	22	2289	0	2364
9428	2296	21	23	46	0	2386
9429	38	16	7	2305	0	2366
9430	21	2307	8	51	0	2387
9431	24	33	2419	23	0	2499
9432	5	18	35	2457	0	2515
9433	2615	18	20	38	0	2691
9434	46	2	2596	32	0	2676
9435	30	11	37	2702	0	2780
9436	2768	5	25	56	0	2854
9437	2939	3	16	43	0	3001
9438	82	2945	10	25	0	3062
9439	2945	59	8	13	0	3025
9440	78	36	11	2910	0	3035
9441	34	17	3000	69	0	3120
9442	28	2882	57	37	0	3004
9443	9	2991	37	34	0	3071
9444	11	91	19	2912	0	3033
9445	12	46	9	2982	0	3049
9446	10	18	2891	82	0	3001
9447	10	2829	60	43	0	2942
9448	19	2865	31	26	0	2941
9449	15	78	16	2780	0	2889
9450	2736	26	18	54	0	2834
9451	45	2758	7	31	0	2841
9452	30	49	6	2804	0	2889
9453	2948	23	8	64	0	3043
9454	50	20	8	2992	0	3070
9455	31	10	14	2952	0	3007
9456	18	10	11	2992	0	3031
9457	16	13	10	3007	0	3046
9458	2970	16	6	84	0	3076
9459	55	14	7	2985	0	3061
9460	27	12	2886	64	0	2989
9461	2820	11	52	46	0	2929
9462	55	16	2853	24	0	2948
9463	20	17	2928	25	0	2990
9464	22	13	61	2955	0	3051
9465	17	7	32	3022	0	3078
9466	12	13	14	3078	0	3117
9467	3025	13	12	78	0	3128
9468	55	9	2975	47	0	3086
9469	2914	12	51	39	0	3016
9470	3014	5	24	33	0	3076
9471	72	6	2982	27	0	3087
9472	2919	9	45	32	0	3005
9473	65	7	2996	31	0	3099
9474	33	3085	52	24	0	3194
9475	24	47	34	3091	0	3196
9476	17	19	16	3181	0	3233
9477	14	12	17	3143	0	3186
9478	11	7	19	3117	0	3154
9479	16	10	3104	77	0	3207
9480	13	7	3103	43	0	3166
9481	13	9	65	3091	0	3178
9482	18	7	3142	58	0	3225
9483	2983	6	64	36	0	3089
9484	3189	13	28	32	0	3262
9485	69	10	16	3147	0	3242
9486	3167	2	15	60	0	3244
9487	62	3240	14	36	0	3352
9488	3242	47	12	29	0	3330
9489	58	27	3258	22	0	3365
9490	37	9	42	3198	0	3286
9491	22	3275	27	62	0	3386
9492	3381	44	18	44	0	3487
9493	48	16	15	3427	0	3506
9494	28	13	3402	59	0	3502
9495	23	5	52	3354	0	3434
9496	3339	3	32	74	0	3448
9497	55	5	3413	39	0	3512
9498	40	6	50	3394	0	3490
9499	26	4	30	3478	0	3538
9500	26	6	3423	80	0	3535
9501	29	3326	50	39	0	3444
9502	42	2531	51	42	0	2666
9503	33	60	19	3492	0	3604
9504	29	25	20	3601	0	3675
9505	18	19	18	3670	0	3725
9506	3604	15	16	88	0	3723
9507	3607	17	12	48	0	3684
9508	70	19	14	3627	0	3730
9509	3628	16	21	75	0	3740
9510	56	3607	18	50	0	3731
9511	33	52	13	3754	0	3852
9512	23	28	16	3792	0	3859
9513	19	12	19	3830	0	3880
9514	3636	13	17	99	0	3765
9515	60	3608	19	48	0	3735
9516	36	59	10	3715	0	3820
9517	3689	29	11	76	0	3805
9518	56	13	16	3745	0	3830
9519	38	6	16	3704	0	3764
9520	25	3519	8	95	0	3647
9521	26	3677	12	59	0	3774
9522	26	63	8	3705	0	3802
9523	28	25	12	3682	0	3747
9524	3530	12	11	96	0	3649
9525	69	10	15	3549	0	3643
9526	40	13	3473	77	0	3603
9527	27	16	58	3419	0	3520
9528	16	3382	33	76	0	3507
9529	3484	52	15	56	0	3607
9530	67	26	15	3502	0	3610
9531	36	9	11	3401	0	3457
9532	21	3328	8	86	0	3443
9533	3223	41	11	36	0	3311
9534	54	3421	13	23	0	3511
9535	24	51	13	3409	0	3497
9536	19	12	3439	62	0	3532
9537	20	14	46	3208	0	3288
9538	3264	2	18	53	0	3337
9539	43	3302	4	15	0	3364
9540	14	37	2	3290	0	3343
9541	8	3146	4	48	0	3206
9542	15	40	6	3256	0	3317
9543	8	17	3203	53	0	3281
9544	7	16	44	3130	0	3197
9545	3	10	9	3197	0	3219
9546	9	5	4	3240	0	3258
9547	3090	5	6	65	0	3166
9548	3158	12	2	31	0	3203
9549	52	3144	4	19	0	3219
9550	3161	48	8	19	0	3236
9551	45	3134	6	26	0	3211
9552	19	3234	2	17	0	3272
9553	3040	64	2	18	0	3124
9554	51	22	2997	21	0	3091
9555	13	9	44	3030	0	3096
9556	10	8	11	3101	0	3130
9557	10	7	8	3156	0	3181
9558	3033	7	3	73	0	3116
9559	57	2976	7	32	0	3072
9560	23	54	3	3064	0	3144
9561	17	3010	7	58	0	3092
9562	3198	62	3	22	0	3285
9563	65	31	2	3158	0	3256
9564	34	14	4	3710	0	3762
9565	11	4069	4	121	0	4205
9566	13	97	5	4311	0	4426
9567	16	34	4	4391	0	4445
9568	4217	17	7	142	0	4383
9569	101	4110	7	66	0	4284
9570	30	4308	4	55	0	4397
9571	28	117	3	4216	0	4364
9572	17	53	4066	115	0	4251
9573	19	33	4051	51	0	4154
9574	12	27	112	4049	0	4200
9575	13	22	4059	127	0	4221
9576	19	23	115	4060	0	4217
9577	21	23	43	3903	0	3990
9578	13	12	26	4235	0	4286
9579	4087	19	18	170	0	4294
9580	105	16	14	4160	0	4295
9581	37	15	5	4194	0	4251
9582	35	4038	13	153	0	4239
9583	21	112	18	4219	0	4370
9584	10	58	4075	149	0	4292
9585	11	30	101	4153	0	4295
9586	23	17	50	4248	0	4338
9587	3995	10	39	167	0	4211
9588	99	24	17	4067	0	4207
9589	37	36	22	4041	0	4136
9590	32	13	10	4122	0	4177
9591	3781	6	11	198	0	3996
9592	103	3839	8	101	0	4051
9593	46	105	4	3911	0	4066
9594	31	43	7	3973	0	4054
9595	17	30	3782	166	0	3995
9596	11	27	104	3848	0	3990
9597	3582	12	41	169	0	3804
9598	106	3678	33	76	0	3893
9599	40	103	12	3687	0	3842
9600	27	45	11	3796	0	3879
9601	26	26	3590	174	0	3816
9602	3408	14	95	102	0	3619
9603	101	3546	35	74	0	3756
9604	3469	102	23	66	0	3660
9605	117	41	14	3512	0	3684
9606	31	45	18	3579	0	3673
9607	37	16	13	3613	0	3679
9608	22	21	24	3639	0	3706
9609	3475	24	24	171	0	3694
9610	102	19	9	3425	0	3555
9611	47	3323	18	159	0	3547
9612	33	100	22	3415	0	3570
9613	26	29	11	3547	0	3613
9614	3377	33	17	177	0	3604
9615	116	3345	24	81	0	3566
9616	52	109	9	3463	0	3633
9617	3377	42	9	164	0	3592
9618	3460	33	14	92	0	3599
9619	127	16	14	3470	0	3627
9620	53	19	3318	168	0	3558
9621	3301	19	91	97	0	3508
9622	123	30	27	3414	0	3594
9623	55	15	3401	159	0	3630
9624	37	12	98	3499	0	3646
9625	39	24	40	3473	0	3576
9626	35	23	24	3455	0	3537
9627	33	3411	18	181	0	3643
9628	39	104	14	3566	0	3723
9629	35	39	13	3605	0	3692
9630	26	24	18	3598	0	3666
9631	43	18	19	3564	0	3644
9632	37	22	11	3558	0	3628
9633	47	22	17	3562	0	3648
9634	3137	20	25	177	0	3359
9635	90	18	3022	112	0	3242
9636	37	2899	76	91	0	3103
9637	2890	77	27	66	0	3060
9638	83	2888	24	69	0	3064
9639	2824	88	25	62	0	2999
9640	106	35	18	2839	0	2998
9641	2864	31	15	122	0	3032
9642	100	18	17	2883	0	3018
9643	48	18	8	2806	0	2880
9644	39	2769	11	144	0	2963
9645	2796	73	12	88	0	2969
9646	86	30	2787	82	0	2985
9647	43	30	71	2879	0	3023
9648	51	15	2861	115	0	3042
9649	25	27	2772	77	0	2901
9650	2801	19	85	77	0	2982
9651	84	29	40	2874	0	3027
9652	47	14	2823	118	0	3002
9653	44	11	2868	77	0	3000
9654	36	11	87	2903	0	3037
9655	30	20	36	2983	0	3069
9656	2940	12	29	135	0	3116
9657	91	11	16	2990	0	3108
9658	43	14	3003	123	0	3183
9659	40	10	77	3014	0	3141
9660	24	31	37	2978	0	3070
9661	37	2966	24	110	0	3137
9662	2880	56	21	87	0	3044
9663	71	2828	18	61	0	2978
9664	2303	27	16	39	0	2385
9665	16	1831	5	18	0	1870
9666	8	1711	5	10	0	1734
9667	32	14	9	1681	0	1736
9668	8	10	12	1679	0	1709
9669	5	11	6	1659	0	1681
9670	1604	0	3	16	0	1623
9671	9	1	1615	16	0	1641
9672	7	3	7	1583	0	1600
9673	1558	1	5	13	0	1577
9674	9	1558	2	8	0	1577
9675	11	1531	2	6	0	1550
9676	13	13	6	1543	0	1575
9677	2	4	3	1551	0	1560
9678	2	6	5	1545	0	1558
9679	3	1545	2	13	0	1563
9680	1	5	2	1567	0	1575
9681	4	6	1549	7	0	1566
9682	1	4	1418	5	0	1428
9683	1448	0	4	9	0	1461
9684	5	1	4	1521	0	1531
9685	1517	5	0	8	0	1530
9686	1501	0	2	10	0	1513
9687	4	1507	4	5	0	1520
9688	1526	2	0	6	0	1534
9689	1570	2	0	12	0	1584
9690	5	1	3	1567	0	1576
9691	7	1	1	1603	0	1612
9692	3	1	1714	8	0	1726
9693	1	1722	5	4	0	1732
9694	18	8	4	1519	0	1549
9695	0	4	1	1770	0	1775
9696	1757	1	1	10	0	1769
9697	5	0	0	1755	0	1760
9698	1781	2	0	6	0	1789
9699	9	0	0	1827	0	1836
9700	4	1824	0	13	0	1841
9701	1916	11	0	9	0	1936
9702	11	3	0	2255	0	2269
9703	5	2	2	2454	0	2463
9704	3	2	0	2628	0	2633
9705	1	0	2616	50	0	2667
9706	3	0	41	2689	0	2733
9707	2740	0	14	55	0	2809
9708	43	0	5	2890	0	2938
9709	16	0	4	3215	0	3235
9710	6	0	3	3246	0	3255
9711	5	3154	3	104	0	3266
9712	2	3327	4	38	0	3371
9713	3300	93	4	16	0	3413
9714	67	3367	1	18	0	3453
9715	3388	77	0	14	0	3479
9716	3386	37	1	10	0	3434
9717	3389	9	3	15	0	3416
9718	111	6	3314	13	0	3444
9719	42	3421	72	9	0	3544
9720	3489	79	30	15	0	3613
9721	86	35	7	3503	0	3631
9722	40	14	2	3552	0	3608
9723	17	7	4	3554	0	3582
9724	15	3436	1	103	0	3555
9725	19	69	2	3512	0	3602
9726	3473	34	7	87	0	3601
9727	82	29	2	3401	0	3514
9728	46	9	3	3447	0	3505
9729	15	10	3336	120	0	3481
9730	9	6	3445	58	0	3518
9731	14	4	99	3449	0	3566
9732	13	6	37	3502	0	3558
9733	7	3489	16	123	0	3635
9734	16	75	12	3512	0	3615
9735	11	39	6	3581	0	3637
9736	12	13	6	3646	0	3677
9737	3510	8	9	142	0	3669
9738	81	18	3549	61	0	3709
9739	45	12	75	3623	0	3755
9740	3603	15	35	101	0	3754
9741	3618	13	10	58	0	3699
9742	117	13	7	3577	0	3714
9743	48	12	7	3672	0	3739
9744	3546	8	7	132	0	3693
9745	93	3497	9	56	0	3655
9746	48	3611	18	32	0	3709
9747	21	110	6	3643	0	3780
9748	3647	46	5	107	0	3805
9749	3721	15	5	66	0	3807
9750	3671	14	7	51	0	3743
9751	127	12	3666	37	0	3842
9752	3528	18	78	34	0	3658
9753	104	15	3591	23	0	3733
9754	3496	14	87	32	0	3629
9755	91	3553	38	36	0	3718
9756	55	82	3578	38	0	3753
9757	34	40	89	3574	0	3737
9758	22	13	3625	110	0	3770
9759	26	12	90	3639	0	3767
9760	3613	18	41	120	0	3792
9761	95	18	3720	61	0	3894
9762	50	11	84	3689	0	3834
9763	22	3919	49	112	0	4102
9764	33	78	20	4128	0	4259
9765	33	34	18	4117	0	4202
9766	28	20	25	3978	0	4051
9767	4057	15	17	155	0	4244
9768	4120	16	17	72	0	4225
9769	126	15	14	4090	0	4245
9770	63	24	3988	116	0	4191
9771	31	25	3889	73	0	4018
9772	37	17	112	4046	0	4212
9773	39	25	4199	114	0	4377
9774	35	19	87	4195	0	4336
9775	50	11	53	4019	0	4133
9776	45	15	20	4274	0	4354
9777	42	4036	24	153	0	4255
9778	41	3974	27	76	0	4118
9779	39	108	22	4298	0	4467
9780	30	48	18	4330	0	4426
9781	26	22	22	4345	0	4415
9782	4226	22	22	149	0	4419
9783	106	23	4298	84	0	4511
9784	57	11	94	4338	0	4500
9785	4347	15	54	122	0	4538
9786	96	4333	32	80	0	4541
9787	56	89	22	4464	0	4631
9788	28	43	24	4543	0	4638
9789	26	17	27	4487	0	4557
9790	21	14	15	4500	0	4550
9791	23	14	4319	168	0	4524
9792	4039	13	90	94	0	4236
9793	4263	10	44	66	0	4383
9794	119	21	4264	53	0	4457
9795	4191	9	88	66	0	4354
9796	4316	15	46	54	0	4431
9797	132	8	4296	56	0	4492
9798	58	4411	90	57	0	4616
9799	37	81	62	4443	0	4623
9800	36	37	4538	112	0	4723
9801	39	4417	86	70	0	4612
9802	30	63	4158	43	0	4294
9803	23	3974	50	41	0	4088
9804	23	67	36	3842	0	3968
9805	14	23	3868	60	0	3965
9806	28	18	45	3693	0	3784
9807	15	5	3860	56	0	3936
9808	13	3720	37	38	0	3808
9809	3487	10	8	5	0	3510
9810	14	3395	4	3	0	3416
9811	5	3682	3	6	0	3696
9812	25	19	34	3691	0	3769
9813	3	1	0	3705	0	3709
9814	1	0	0	3664	0	3665
9815	4	0	2	3568	0	3574
9816	3	1	1	3684	0	3689
9817	3	1	4069	14	0	4087
9818	4	0	14	3963	0	3981
9819	2	3	3	4088	0	4096
9820	4163	0	4	20	0	4187
9821	4192	3	2	5	0	4202
9822	4234	1	0	4	0	4239
9823	30	1	3	4267	0	4301
9824	4702	2	2	33	0	4739
9825	5178	2	2	31	0	5213
9826	5318	2	3	8	0	5331
9827	85	2	5257	4	0	5348
9828	5148	3	72	9	0	5232
9829	5418	3	14	16	0	5451
9830	5408	1	10	13	0	5432
9831	97	1	3	5371	0	5472
9832	29	3	5444	72	0	5548
9833	22	2	69	5379	0	5472
9834	5554	3	16	91	0	5664
9835	86	2	11	5613	0	5712
9836	23	5871	6	75	0	5975
9837	25	67	5	6050	0	6147
9838	6018	12	5	92	0	6127
9839	6117	10	5	29	0	6161
9840	6072	1	4	27	0	6104
9841	108	2	6254	9	0	6373
9842	42	3	80	6104	0	6229
9843	22	4	17	6417	0	6460
9844	11	3	6398	98	0	6510
9845	11	6204	75	38	0	6328
9846	18	74	6294	24	0	6410
9847	21	18	86	6324	0	6449
9848	6373	11	20	88	0	6492
9849	91	4	6537	26	0	6658
9850	35	2	79	6529	0	6645
9851	32	2	6554	78	0	6666
9852	6390	6	87	33	0	6516
9853	91	4	26	6687	0	6808
9854	24	10	7013	92	0	7139
9855	39	5	85	6860	0	6989
9856	19	6	7052	97	0	7174
9857	16	7085	92	26	0	7219
9858	15	80	29	7123	0	7247
9859	7222	14	22	99	0	7357
9860	88	15	10	7275	0	7388
9861	32	5	18	7161	0	7216
9862	7140	4	16	118	0	7278
9863	87	6699	19	44	0	6849
9864	34	6923	11	35	0	7003
9865	31	82	9	6947	0	7069
9866	19	6928	14	84	0	7045
9867	11	89	12	7046	0	7158
9868	20	18	10	7081	0	7129
9869	7041	15	8	117	0	7181
9870	91	6990	6	49	0	7136
9871	34	79	6934	36	0	7083
9872	26	7194	77	32	0	7329
9873	7160	85	24	31	0	7300
9874	7325	23	16	29	0	7393
9875	114	22	8	7226	0	7370
9876	7387	15	13	109	0	7524
9877	105	14	11	7370	0	7500
9878	7389	9	12	131	0	7541
9879	7532	14	11	47	0	7604
9880	132	14	14	7753	0	7913
9881	7809	15	17	117	0	7958
9882	136	9	7841	37	0	8023
9883	7601	6	90	47	0	7744
9884	137	5	30	7825	0	7997
9885	7913	8	28	116	0	8065
9886	132	7950	18	43	0	8143
9887	63	90	15	7983	0	8151
9888	65	19	19	8055	0	8158
9889	7994	17	18	134	0	8163
9890	130	7	7945	65	0	8147
9891	65	7796	98	53	0	8012
9892	68	89	31	7967	0	8155
9893	43	7981	26	109	0	8159
9894	46	103	25	8115	0	8289
9895	45	39	18	7975	0	8077
9896	54	22	15	8179	0	8270
9897	8116	23	19	164	0	8322
9898	131	21	15	8011	0	8178
9899	8043	24	27	145	0	8239
9900	8034	24	14	94	0	8166
9901	151	17	20	8009	0	8197
9902	8009	20	24	137	0	8190
9903	7913	19	19	81	0	8032
9904	144	16	7947	66	0	8173
9905	63	13	105	7694	0	7875
9906	7974	24	48	123	0	8169
9907	115	7909	44	72	0	8140
9908	8095	96	25	68	0	8284
9909	8113	27	22	55	0	8217
9910	152	27	7923	51	0	8153
9911	73	12	114	7431	0	7630
9912	8162	14	44	155	0	8375
9913	134	13	34	8343	0	8524
9914	80	18	35	8476	0	8609
9915	65	21	24	8626	0	8736
9916	49	19	29	8989	0	9086
9917	8777	14	22	215	0	9028
9918	180	21	9016	92	0	9309
9919	94	19	157	9252	0	9522
9920	57	22	9895	197	0	10171
9921	63	15	10094	105	0	10277
9922	10028	18	300	95	0	10441
9923	273	9	10841	68	0	11191
9924	123	10382	269	50	0	10824
9925	10291	205	165	53	0	10714
9926	10432	106	55	36	0	10629
9927	328	46	27	10196	0	10597
9928	172	16	10342	216	0	10746
9929	88	16	10116	132	0	10352
9930	10335	12	308	88	0	10743
9931	252	21	160	10683	0	11116
9932	10766	14	79	251	0	11110
9933	305	10899	46	145	0	11395
9934	11008	215	39	81	0	11343
9935	10987	112	43	62	0	11204
9936	354	10725	41	47	0	11167
9937	208	249	33	10740	0	11230
9938	10707	123	32	266	0	11128
9939	305	67	10645	143	0	11160
9940	159	10718	259	91	0	11227
9941	125	255	143	10708	0	11231
9942	10724	119	87	271	0	11201
9943	299	10848	52	150	0	11349
9944	10987	270	44	121	0	11422
9945	366	147	10804	53	0	11370
9946	10691	77	281	57	0	11106
9947	383	54	10892	53	0	11382
9948	10707	43	330	72	0	11152
9949	10712	36	160	59	0	10967
9950	446	35	10598	51	0	11130
9951	252	10574	300	49	0	11175
9952	158	281	160	10148	0	10747
9953	116	146	10726	277	0	11265
9954	99	10435	317	151	0	11002
9955	132	285	165	10138	0	10720
9956	105	153	114	10635	0	11007
9957	102	96	10323	405	0	10926
9958	113	62	319	10002	0	10496
9959	101	57	192	10423	0	10773
9960	106	41	10240	429	0	10816
9961	118	57	327	9834	0	10336
9962	93	10179	203	349	0	10824
9963	10307	282	142	197	0	10928
9964	332	169	132	10035	0	10668
9965	220	10317	122	327	0	10986
9966	179	313	109	9802	0	10403
9967	145	10578	115	328	0	11166
9968	129	365	10410	184	0	11088
9969	125	10663	336	137	0	11261
9970	10498	366	212	120	0	11196
9971	10583	189	153	120	0	11045
9972	10777	134	117	134	0	11162
9973	511	81	10803	107	0	11502
9974	309	95	10714	102	0	11220
9975	211	11188	496	107	0	12002
9976	182	372	279	10681	0	11514
9977	179	11527	157	340	0	12203
9978	208	460	130	10350	0	11148
9979	180	11490	118	368	0	12156
9980	11398	479	114	224	0	12215
9981	12426	252	105	193	0	12976
9982	618	206	101	12719	0	13644
9983	384	137	12531	476	0	13528
9984	12292	131	450	281	0	13154
9985	531	12734	274	196	0	13735
9986	339	457	208	12527	0	13531
9987	275	267	148	12384	0	13074
9988	208	12897	140	558	0	13803
9989	12957	487	137	330	0	13911
9990	541	318	12759	185	0	13803
9991	352	227	478	12820	0	13877
9992	12914	169	248	500	0	13831
9993	12911	154	208	290	0	13563
9994	700	12776	143	232	0	13851
9995	416	491	163	12363	0	13433
9996	273	13014	156	464	0	13907
9997	13184	563	140	298	0	14185
9998	566	299	13064	234	0	14163
9999	342	232	13120	184	0	13878
10000	266	191	612	12847	0	13916
10001	193	158	340	12812	0	13503
10002	163	13022	243	631	0	14059
10003	165	505	176	13176	0	14022
10004	162	278	12954	610	0	14004
10005	12771	201	506	362	0	13840
10006	502	159	274	13209	0	14144
10007	279	170	13094	588	0	14131
10008	232	172	494	13065	0	13963
10009	174	154	291	12826	0	13445
10010	155	12973	220	668	0	14016
10011	158	507	159	13088	0	13912
10012	159	291	145	12964	0	13559
10013	174	227	145	12971	0	13517
10014	11989	143	135	769	0	13036
10015	480	11711	132	426	0	12749
10016	263	11911	111	302	0	12587
10017	11437	532	123	202	0	12294
10018	11079	275	112	204	0	11670
10019	529	10634	115	165	0	11443
10020	247	10238	69	124	0	10678
10021	9275	350	47	103	0	9775
10022	309	9130	45	76	0	9560
10023	137	9163	36	78	0	9414
10024	8892	337	69	88	0	9386
10025	266	8993	38	85	0	9382
10026	8915	323	38	78	0	9354
10027	8816	145	37	73	0	9071
10028	8854	131	45	70	0	9100
10029	376	8592	42	80	0	9090
10030	194	8751	34	65	0	9044
10031	147	316	28	8368	0	8859
10032	115	8423	30	250	0	8818
10033	99	314	32	8700	0	9145
10034	8780	168	16	309	0	9273
10035	277	125	39	8646	0	9087
10036	140	8618	46	300	0	9104
10037	8537	270	39	160	0	9006
10038	297	8411	41	118	0	8867
10039	153	8755	24	111	0	9043
10040	138	406	32	8310	0	8886
10041	96	8584	34	239	0	8953
10042	8491	304	47	113	0	8955
10043	256	155	8280	110	0	8801
10044	139	8308	217	110	0	8774
10045	119	268	112	8363	0	8862
10046	101	158	8342	278	0	8879
10047	94	134	237	8192	0	8657
10048	85	118	113	8446	0	8762
10049	83	95	83	8577	0	8838
10050	83	95	80	8497	0	8755
10051	86	82	8176	401	0	8745
10052	87	8136	247	242	0	8712
10053	8087	274	121	193	0	8675
10054	263	144	7977	171	0	8555
10055	7935	116	239	139	0	8429
10056	291	110	8106	129	0	8636
10057	172	100	280	8089	0	8641
10058	142	93	8099	299	0	8633
10059	127	96	8257	166	0	8646
10060	115	91	334	8187	0	8727
10061	101	95	205	7702	0	8103
10062	89	107	124	8468	0	8788
10063	88	103	86	8439	0	8716
10064	8258	94	87	407	0	8846
10065	277	91	8180	248	0	8796
10066	8202	82	252	209	0	8745
10067	8336	85	119	158	0	8698
10068	8308	90	92	149	0	8639
10069	8296	85	80	130	0	8591
10070	8354	91	54	136	0	8635
10071	439	86	46	8059	0	8630
10072	241	86	7612	299	0	8238
10073	178	91	7247	183	0	7699
10074	143	7428	220	164	0	7955
10075	6903	233	136	104	0	7376
10076	226	135	74	6732	0	7167
10077	131	153	41	6557	0	6882
10078	116	6569	31	245	0	6961
10079	118	6540	36	136	0	6830
10080	110	6517	32	99	0	6758
10081	5534	208	45	79	0	5866
10082	122	133	28	4901	0	5184
10083	46	4859	14	104	0	5023
10084	35	99	12	4865	0	5011
10085	41	49	4811	103	0	5004
10086	36	35	4950	55	0	5076
10087	47	30	104	5340	0	5521
10088	5497	33	43	134	0	5707
10089	5974	30	30	55	0	6089
10090	6006	28	17	40	0	6091
10091	200	34	5913	37	0	6184
10092	86	32	123	5864	0	6105
10093	64	39	65	6112	0	6280
10094	50	33	5863	186	0	6132
10095	5466	32	155	104	0	5757
10096	175	27	5916	71	0	6189
10097	69	25	5745	50	0	5889
10098	41	22	5901	35	0	5999
10099	48	22	188	5642	0	5900
10100	34	16	94	5852	0	5996
10101	25	19	5935	193	0	6172
10102	32	16	153	5945	0	6146
10103	5976	10	84	189	0	6259
10104	151	19	54	6146	0	6370
10105	81	11	6133	185	0	6410
10106	38	9	6403	113	0	6563
10107	50	23	213	6244	0	6530
10108	6508	16	106	200	0	6830
10109	176	6919	74	106	0	7275
10110	7194	175	72	77	0	7518
10111	7335	91	52	83	0	7561
10112	306	44	7296	75	0	7721
10113	175	22	210	7301	0	7708
10114	7442	12	138	249	0	7841
10115	7350	16	102	147	0	7615
10116	309	7319	83	93	0	7804
10117	170	182	72	7367	0	7791
10118	114	98	64	7655	0	7931
10119	82	52	7351	310	0	7795
10120	69	26	224	7257	0	7576
10121	68	23	7345	295	0	7731
10122	76	16	7261	173	0	7526
10123	71	14	305	7233	0	7623
10124	7162	19	185	263	0	7629
10125	221	6997	105	187	0	7510
10126	7004	181	77	112	0	7374
10127	7026	105	66	102	0	7299
10128	324	7003	59	95	0	7481
10129	189	192	56	6807	0	7244
10130	6816	114	59	210	0	7199
10131	246	6814	66	137	0	7263
10132	6789	198	58	104	0	7149
10133	279	6584	57	63	0	6983
10134	170	214	47	6379	0	6810
10135	130	114	31	6604	0	6879
10136	6397	72	40	284	0	6793
10137	6312	73	39	183	0	6607
10138	299	6314	31	133	0	6777
10139	171	180	6164	94	0	6609
10140	97	102	6162	83	0	6444
10141	75	79	275	5824	0	6253
10142	64	6148	174	204	0	6590
10143	63	178	111	6368	0	6720
10144	72	102	81	6294	0	6549
10145	91	65	52	6322	0	6530
10146	77	63	6205	305	0	6650
10147	77	36	6040	201	0	6354
10148	85	6257	264	123	0	6729
10149	67	185	162	6287	0	6701
10150	82	117	87	6584	0	6870
10151	103	88	6392	277	0	6860
10152	5802	85	186	198	0	6271
10153	226	61	130	6496	0	6913
10154	143	50	6463	248	0	6904
10155	6065	39	210	210	0	6524
10156	228	6364	129	148	0	6869
10157	180	185	6589	113	0	7067
10158	142	130	220	6518	0	7010
10159	6539	82	150	249	0	7020
10160	224	67	6615	169	0	7075
10161	143	45	255	6625	0	7068
10162	109	49	156	6613	0	6927
10163	99	53	98	7276	0	7526
10164	7191	51	94	381	0	7717
10165	232	6929	86	244	0	7491
10166	147	220	76	7157	0	7600
10167	118	124	7197	296	0	7735
10168	91	95	251	7004	0	7441
10169	70	6837	160	306	0	7373
10170	76	7378	97	233	0	7784
10171	7190	283	88	180	0	7741
10172	7377	151	81	141	0	7750
10173	363	123	7140	114	0	7740
10174	7040	70	252	116	0	7478
10175	293	7159	171	107	0	7730
10176	7414	250	109	113	0	7886
10177	312	149	67	7366	0	7894
10178	201	116	7451	272	0	8040
10179	163	90	247	7453	0	7953
10180	143	63	7466	333	0	8005
10181	7279	63	303	218	0	7863
10182	266	63	185	7489	0	8003
10183	169	7770	100	327	0	8366
10184	150	265	92	8017	0	8524
10185	111	155	7935	353	0	8554
10186	90	7697	238	227	0	8252
10187	7226	241	140	173	0	7780
10188	200	7054	121	123	0	7498
10189	120	6939	71	92	0	7222
10190	77	266	45	6685	0	7073
10191	58	6786	50	192	0	7086
10192	77	216	35	6901	0	7229
10193	65	119	6717	243	0	7144
10194	6251	68	177	143	0	6639
10195	6683	67	101	100	0	6951
10196	266	72	6635	58	0	7031
10197	6338	60	163	66	0	6627
10198	208	6512	108	76	0	6904
10199	6703	168	66	62	0	6999
10200	210	116	57	6548	0	6931
10201	140	69	6570	172	0	6951
10202	85	6684	166	130	0	7065
10203	84	172	109	6706	0	7071
10204	49	87	53	6873	0	7062
10205	6554	69	44	243	0	6910
10206	6256	41	45	149	0	6491
10207	218	6112	47	94	0	6471
10208	101	5803	26	51	0	5981
10209	40	5626	14	27	0	5707
10210	45	124	17	5472	0	5658
10211	5423	42	13	103	0	5581
10212	5371	20	10	41	0	5442
10213	105	25	10	5297	0	5437
10214	44	15	11	5351	0	5421
10215	5283	16	12	113	0	5424
10216	97	18	9	5398	0	5522
10217	44	17	5387	101	0	5549
10218	5267	19	76	53	0	5415
10219	5460	22	19	31	0	5532
10220	120	21	5508	23	0	5672
10221	5596	18	81	23	0	5718
10222	113	18	24	5749	0	5904
10223	48	20	17	5738	0	5823
10224	33	16	15	5815	0	5879
10225	5694	11	14	127	0	5846
10226	99	5757	16	60	0	5932
10227	56	80	18	5850	0	6004
10228	40	5658	13	88	0	5799
10229	5708	96	14	45	0	5863
10230	110	33	15	5756	0	5914
10231	51	24	14	5780	0	5869
10232	38	5726	12	139	0	5915
10233	34	103	5627	59	0	5823
10234	29	43	93	5737	0	5902
10235	5808	24	30	121	0	5983
10236	6367	19	23	61	0	6470
10237	185	25	6702	45	0	6957
10238	73	23	166	6879	0	7141
10239	47	7070	58	172	0	7347
10240	35	180	25	7312	0	7552
10241	7241	60	25	221	0	7547
10242	7303	39	20	89	0	7451
10243	249	24	21	7104	0	7398
10244	91	7062	24	210	0	7387
10245	7607	186	11	91	0	7895
10246	223	75	10	7793	0	8101
10247	7765	45	16	232	0	8058
10248	8156	34	15	103	0	8308
10249	274	27	9	8086	0	8396
10250	100	21	21	8197	0	8339
10251	77	19	18	8341	0	8455
10252	60	8157	10	297	0	8524
10253	55	205	10	8353	0	8623
10254	44	76	17	8454	0	8591
10255	63	42	8014	292	0	8411
10256	48	44	7840	131	0	8063
10257	40	31	238	7901	0	8210
10258	7829	26	74	269	0	8198
10259	206	7861	48	107	0	8222
10260	7735	207	26	96	0	8064
10261	254	73	7771	68	0	8166
10262	112	38	7538	73	0	7761
10263	58	7589	233	60	0	7940
10264	55	178	95	7561	0	7889
10265	40	65	7543	198	0	7846
10266	30	42	7640	91	0	7803
10267	40	36	215	7531	0	7822
10268	7583	18	73	213	0	7887
10269	7663	14	51	93	0	7821
10270	228	24	33	7507	0	7792
10271	98	22	7968	214	0	8302
10272	60	24	177	8016	0	8277
10273	47	22	66	7946	0	8081
10274	36	8048	40	228	0	8352
10275	8086	170	40	107	0	8403
10276	8044	54	32	76	0	8206
10277	227	8057	28	65	0	8377
10278	106	182	25	7713	0	8026
10279	59	7938	28	194	0	8219
10280	7930	184	28	86	0	8228
10281	205	71	7761	68	0	8105
10282	100	45	7427	55	0	7627
10283	65	38	7341	49	0	7493
10284	60	30	191	7298	0	7579
10285	33	24	83	7409	0	7549
10286	7344	19	52	207	0	7622
10287	170	18	31	7364	0	7583
10288	74	26	27	7546	0	7673
10289	60	27	7660	216	0	7963
10290	54	20	7395	120	0	7589
10291	7363	25	199	91	0	7678
10292	166	7612	83	69	0	7930
10293	7822	157	58	73	0	8110
10294	208	64	38	7790	0	8100
10295	94	43	45	7786	0	7968
10296	73	7652	46	215	0	7986
10297	58	158	50	7791	0	8057
10298	7613	64	37	227	0	7941
10299	187	58	38	7652	0	7935
10300	96	50	7611	220	0	7977
10301	71	7402	171	127	0	7771
10302	7375	156	72	112	0	7715
10303	7585	69	57	93	0	7804
10304	7566	55	45	89	0	7755
10305	7648	34	32	89	0	7803
10306	257	33	36	7470	0	7796
10307	135	40	42	7632	0	7849
10308	101	40	7385	251	0	7777
10309	89	29	157	7462	0	7737
10310	67	42	7432	240	0	7781
10311	71	38	173	7460	0	7742
10312	7403	33	82	244	0	7762
10313	184	7549	60	154	0	7947
10314	94	162	52	7704	0	8012
10315	79	67	49	7894	0	8089
10316	7699	54	58	257	0	8068
10317	7493	37	60	146	0	7736
10318	236	37	7424	113	0	7810
10319	109	7450	179	103	0	7841
10320	92	160	98	7430	0	7780
10321	62	67	72	7556	0	7757
10322	7373	53	78	244	0	7748
10323	7392	41	75	152	0	7660
10324	245	22	7383	116	0	7766
10325	119	40	7294	84	0	7537
10326	91	42	226	7129	0	7488
10327	78	34	94	7424	0	7630
10328	70	31	7270	235	0	7606
10329	6941	32	203	139	0	7315
10330	217	38	86	7310	0	7651
10331	7184	28	68	220	0	7500
10332	201	7103	65	116	0	7485
10333	7327	164	46	128	0	7665
10334	216	62	7746	100	0	8124
10335	111	7523	174	93	0	7901
10336	66	7289	50	65	0	7470
10337	6710	111	132	56	0	7009
10338	6541	33	38	32	0	6644
10339	110	19	16	6467	0	6612
10340	40	6377	23	78	0	6518
10341	39	6574	15	36	0	6664
10342	32	85	14	6644	0	6775
10343	6634	38	13	94	0	6779
10344	6674	25	13	55	0	6767
10345	106	19	6228	32	0	6385
10346	5877	9	55	24	0	5965
10347	74	6581	24	15	0	6694
10348	6794	100	13	25	0	6932
10349	146	8240	12	16	0	8414
10350	36	9258	15	13	0	9322
10351	35	330	22	10310	0	10697
10352	11004	132	9	335	0	11480
10353	11351	75	6	149	0	11581
10354	512	34	10930	120	0	11596
10355	277	17	339	10996	0	11629
10356	11194	11	146	400	0	11751
10357	456	12	114	11266	0	11848
10358	11365	17	51	484	0	11917
10359	11594	14	47	219	0	11874
10360	581	20	11133	166	0	11900
10361	325	8	370	10903	0	11606
10362	210	18	152	11349	0	11729
10363	143	21	115	11501	0	11780
10364	80	11	10857	647	0	11595
10365	70	16	389	10940	0	11415
10366	90	14	161	10613	0	10878
10367	52	10555	150	585	0	11342
10368	51	361	10434	338	0	11184
10369	52	10783	381	210	0	11426
10370	10649	477	163	155	0	11444
10371	416	215	132	10145	0	10908
10372	225	161	76	9878	0	10340
10373	168	10185	66	497	0	10916
10374	10134	409	44	303	0	10890
10375	10422	176	39	212	0	10849
10376	552	9952	37	157	0	10698
10377	313	10514	40	96	0	10963
10378	10389	524	32	100	0	11045
10379	506	260	10054	84	0	10904
10380	254	208	10103	83	0	10648
10381	9793	127	517	84	0	10521
10382	454	10183	277	76	0	10990
10383	10312	416	192	84	0	11004
10384	527	218	10064	92	0	10901
10385	10241	166	401	98	0	10906
10386	565	10529	190	86	0	11370
10387	297	431	162	10565	0	11455
10388	261	195	92	10837	0	11385
10389	205	178	99	10056	0	10538
10390	164	114	62	10681	0	11021
10391	156	87	69	10320	0	10632
10392	137	10135	59	733	0	11064
10393	10230	403	69	434	0	11136
10394	481	200	10077	307	0	11065
10395	273	172	398	10307	0	11150
10396	236	120	10315	522	0	11193
10397	167	93	531	10354	0	11145
10398	154	56	263	10729	0	11202
10399	10239	80	224	701	0	11244
10400	472	68	10146	430	0	11116
10401	248	10083	464	309	0	11104
10402	211	414	230	10298	0	11153
10403	161	217	181	10691	0	11250
10404	134	190	10319	643	0	11286
10405	109	154	434	10443	0	11140
10406	126	130	206	10884	0	11346
10407	10076	84	204	722	0	11086
10408	425	10344	110	461	0	11340
10409	10380	457	85	332	0	11254
10410	10706	241	71	266	0	11284
10411	667	205	82	10358	0	11312
10412	421	148	10217	490	0	11276
10413	300	126	10350	279	0	11055
10414	231	108	578	10147	0	11064
10415	183	111	334	9867	0	10495
10416	146	10161	248	614	0	11169
10417	10142	426	181	366	0	11115
10418	488	9984	133	322	0	10927
10419	272	10523	118	225	0	11138
10420	10347	630	82	199	0	11258
10421	556	360	85	10122	0	11123
10422	331	10609	99	534	0	11573
10423	244	522	105	10709	0	11580
10424	171	268	10333	677	0	11449
10425	167	193	10474	417	0	11251
10426	134	149	566	10595	0	11444
10427	121	109	10609	610	0	11449
10428	133	91	572	10604	0	11400
10429	107	108	314	10667	0	11196
10430	109	91	253	11077	0	11530
10431	10269	88	185	844	0	11386
10432	448	9896	145	517	0	11006
10433	230	10517	125	422	0	11294
10434	9833	543	99	314	0	10789
10435	10191	329	115	217	0	10852
10436	602	257	72	9898	0	10829
10437	349	177	9812	522	0	10860
10438	273	134	434	9975	0	10816
10439	199	126	9845	623	0	10793
10440	142	9818	518	387	0	10865
10441	126	425	247	10096	0	10894
10442	9973	214	201	585	0	10973
10443	507	205	149	10169	0	11030
10444	277	138	9704	599	0	10718
10445	9573	131	458	354	0	10516
10446	536	93	9908	294	0	10831
10447	326	93	9662	184	0	10265
10448	242	8982	508	199	0	9931
10449	110	7449	232	132	0	7923
10450	115	6967	154	97	0	7333
10451	5188	176	212	126	0	5702
10452	4876	19	17	25	0	4937
10453	59	7	5	4960	0	5031
10454	19	11	17	4959	0	5006
10455	14	3	12	5084	0	5113
10456	8	5035	12	55	0	5110
10457	5090	52	6	30	0	5178
10458	45	5053	8	19	0	5125
10459	25	50	5	5089	0	5169
10460	5036	22	7	56	0	5121
10461	50	8	6	5000	0	5064
10462	24	10	5	5065	0	5104
10463	5084	7	8	70	0	5169
10464	4959	11	7	33	0	5010
10465	64	7	5038	19	0	5128
10466	21	19	4946	13	0	4999
10467	16	13	5154	20	0	5203
10468	23	7	61	5076	0	5167
10469	14	7	16	5180	0	5217
10470	9	5198	13	64	0	5284
10471	5297	47	5	35	0	5384
10472	64	14	5	5376	0	5459
10473	20	12	13	5426	0	5471
10474	18	5434	17	72	0	5541
10475	9	5808	17	26	0	5860
10476	10	71	5	5926	0	6012
10477	12	27	9	6600	0	6648
10478	6554	13	5	140	0	6712
10479	6578	9	8	49	0	6644
10480	140	9	5	6513	0	6667
10481	54	5	6409	124	0	6592
10482	31	12	6197	44	0	6284
10483	23	10	129	6321	0	6483
10484	9	7	51	6207	0	6274
10485	11	6167	20	149	0	6347
10486	6011	98	13	62	0	6184
10487	116	38	12	6053	0	6219
10488	44	16	6072	118	0	6250
10489	20	11	113	6138	0	6282
10490	21	9	6113	126	0	6269
10491	20	10	6098	55	0	6183
10492	10	32	140	6192	0	6374
10493	6200	16	50	133	0	6399
10494	106	7	6166	54	0	6333
10495	46	5	111	6056	0	6218
10496	34	5	6567	119	0	6725
10497	17	10	115	6498	0	6640
10498	21	4	58	6511	0	6594
10499	10	2	6478	153	0	6643
10500	18	6	6225	75	0	6324
10501	39	6	155	5761	0	5961
10502	26	10	55	6383	0	6474
10503	14	12	38	6446	0	6510
10504	12	10	35	6340	0	6397
10505	6272	5	23	164	0	6464
10506	6299	8	25	88	0	6420
10507	121	6245	35	55	0	6456
10508	6334	94	31	45	0	6504
10509	123	27	27	6350	0	6527
10510	6395	16	16	145	0	6572
10511	119	14	6296	73	0	6502
10512	6324	14	115	61	0	6514
10513	144	9	51	6402	0	6606
10514	60	10	29	6661	0	6760
10515	6568	10	28	168	0	6774
10516	137	6	26	7067	0	7236
10517	61	10	7382	183	0	7636
10518	7275	5	163	103	0	7546
10519	163	7656	73	71	0	7963
10520	76	138	37	7958	0	8209
10521	48	52	8671	208	0	8979
10522	44	38	202	8556	0	8840
10523	42	19	8649	249	0	8959
10524	36	15	231	8601	0	8883
10525	24	8694	79	256	0	9053
10526	31	191	67	8725	0	9014
10527	39	9111	44	245	0	9439
10528	55	246	58	8656	0	9015
10529	34	73	36	9683	0	9826
10530	45	50	46	9703	0	9844
10531	41	27	28	9737	0	9833
10532	44	25	41	9781	0	9891
10533	39	15	9387	405	0	9846
10534	36	34	248	9372	0	9690
10535	36	15	107	9592	0	9750
10536	9355	33	82	369	0	9839
10537	214	9368	41	216	0	9839
10538	9388	235	63	145	0	9831
10539	275	78	34	9473	0	9860
10540	105	56	9373	328	0	9862
10541	73	9379	236	181	0	9869
10542	9233	248	103	144	0	9728
10543	255	9103	70	142	0	9570
10544	76	9519	66	112	0	9773
10545	9285	289	52	113	0	9739
10546	254	122	35	9891	0	10302
10547	9845	67	45	343	0	10300
10548	303	54	47	9715	0	10119
10549	129	38	9618	377	0	10162
10550	87	45	9552	185	0	9869
10551	9201	34	332	176	0	9743
10552	9732	41	154	118	0	10045
10553	351	42	95	9470	0	9958
10554	177	44	61	9684	0	9966
10555	9090	58	49	422	0	9619
10556	289	9024	55	220	0	9588
10557	130	9405	43	180	0	9758
10558	9266	309	47	139	0	9761
10559	9426	138	58	116	0	9738
10560	362	9378	55	106	0	9901
10561	178	299	42	9395	0	9914
10562	135	113	9279	347	0	9874
10563	117	91	9309	168	0	9685
10564	9051	79	342	138	0	9610
10565	337	49	9322	132	0	9840
10566	164	54	316	9038	0	9572
10567	115	62	142	8891	0	9210
10568	109	9026	94	381	0	9610
10569	9078	302	71	194	0	9645
10570	336	122	68	9047	0	9573
10571	164	95	8800	348	0	9407
10572	126	8891	279	188	0	9484
10573	115	354	108	8830	0	9407
10574	91	131	8759	331	0	9312
10575	84	100	8398	173	0	8755
10576	85	8314	321	160	0	8880
10577	7565	238	139	95	0	8037
10578	222	7803	92	100	0	8217
10579	7808	255	69	98	0	8230
10580	250	105	7677	112	0	8144
10581	7487	90	235	99	0	7911
10582	265	7766	112	87	0	8230
10583	126	248	79	7810	0	8263
10584	98	105	76	8100	0	8379
10585	7912	89	70	324	0	8395
10586	261	73	7853	176	0	8363
10587	7726	78	244	136	0	8184
10588	7956	73	107	109	0	8245
10589	292	86	7662	93	0	8133
10590	170	70	7762	101	0	8103
10591	125	74	283	7536	0	8018
10592	7702	64	140	281	0	8187
10593	7721	73	104	162	0	8060
10594	316	7799	90	111	0	8316
10595	174	254	65	7917	0	8410
10596	146	94	59	7717	0	8016
10597	118	84	73	7792	0	8067
10598	108	66	68	7944	0	8186
10599	7727	71	64	348	0	8210
10600	291	58	63	7895	0	8307
10601	159	72	7823	301	0	8355
10602	142	59	7689	166	0	8056
10603	7434	67	301	144	0	7946
10604	312	7560	142	107	0	8121
10605	140	7939	104	101	0	8284
10606	170	266	89	7861	0	8386
10607	104	128	83	8052	0	8367
10608	114	95	80	7913	0	8202
10609	111	79	54	8149	0	8393
10610	99	51	7870	399	0	8419
10611	105	63	249	7866	0	8283
10612	127	54	99	7956	0	8236
10613	87	62	7574	326	0	8049
10614	7024	53	268	205	0	7550
10615	266	7422	127	167	0	7982
10616	6960	204	96	122	0	7382
10617	236	74	6752	97	0	7159
10618	102	47	6499	98	0	6746
10619	88	6416	235	81	0	6820
10620	5788	248	398	113	0	6547
10621	5316	88	59	85	0	5548
10622	5397	40	33	66	0	5536
10623	173	5273	33	58	0	5537
10624	5203	123	44	52	0	5422
10625	146	53	5282	51	0	5532
10626	66	5259	121	59	0	5505
10627	5009	105	59	52	0	5225
10628	121	5138	35	52	0	5346
10629	4923	109	37	31	0	5100
10630	4778	42	38	38	0	4896
10631	120	25	4891	31	0	5067
10632	60	4920	105	25	0	5110
10633	4847	96	45	34	0	5022
10634	114	35	4901	31	0	5081
10635	55	4884	97	43	0	5079
10636	62	95	43	4782	0	4982
10637	34	41	4797	92	0	4964
10638	43	24	4667	49	0	4783
10639	42	41	108	4688	0	4879
10640	4603	25	53	101	0	4782
10641	96	4622	26	47	0	4791
10642	47	83	4584	31	0	4745
10643	44	39	4479	24	0	4586
10644	4288	20	107	25	0	4440
10645	78	4607	53	21	0	4759
10646	3993	42	18	11	0	4064
10647	42	3976	7	14	0	4039
10648	4019	39	9	16	0	4083
10649	3922	19	6	11	0	3958
10650	58	3869	7	8	0	3942
10651	22	42	14	3924	0	4002
10652	4108	21	10	51	0	4190
10653	62	6	6	4193	0	4267
10654	18	11	10	4473	0	4512
10655	4490	12	10	92	0	4604
10656	82	4468	11	30	0	4591
10657	4566	77	7	23	0	4673
10658	85	29	4577	13	0	4704
10659	30	12	83	4618	0	4743
10660	22	11	30	4575	0	4638
10661	4573	10	15	100	0	4698
10662	4581	17	11	35	0	4644
10663	103	15	10	4555	0	4683
10664	38	14	4642	84	0	4778
10665	25	16	77	4608	0	4726
10666	26	10	22	4677	0	4735
10667	17	14	9	4730	0	4770
10668	18	11	11	4725	0	4765
10669	4634	16	14	106	0	4770
10670	95	11	4605	41	0	4752
10671	36	4620	86	32	0	4774
10672	28	83	27	4604	0	4742
10673	28	26	12	4745	0	4811
10674	27	26	4688	105	0	4846
10675	39	8	4612	32	0	4691
10676	13	22	94	4692	0	4821
10677	27	10	36	4772	0	4845
10678	20	15	4650	113	0	4798
10679	30	12	90	4610	0	4742
10680	4739	12	28	117	0	4896
10681	116	4817	23	44	0	5000
10682	46	100	4725	32	0	4903
10683	27	4780	107	36	0	4950
10684	26	106	41	4828	0	5001
10685	26	35	4794	129	0	4984
10686	36	4770	103	52	0	4961
10687	30	93	45	4821	0	4989
10688	24	36	4873	114	0	5047
10689	29	18	100	4837	0	4984
10690	28	18	36	4889	0	4971
10691	4857	27	21	139	0	5044
10692	120	9	26	4896	0	5051
10693	4911	17	27	135	0	5090
10694	4674	20	24	71	0	4789
10695	4716	14	25	53	0	4808
10696	146	17	24	4608	0	4795
10697	38	11	4495	138	0	4682
10698	32	20	4407	63	0	4522
10699	4500	13	121	51	0	4685
10700	110	21	4543	44	0	4718
10701	4356	13	96	48	0	4513
10702	103	4468	42	45	0	4658
10703	4522	89	25	47	0	4683
10704	120	23	4589	41	0	4773
10705	44	20	4717	43	0	4824
10706	41	17	118	4775	0	4951
10707	29	13	4987	152	0	5181
10708	32	8	5097	51	0	5188
10709	31	16	153	5297	0	5497
10710	24	18	47	5569	0	5658
10711	27	15	40	5786	0	5868
10712	24	5686	36	210	0	5956
10713	33	146	41	5577	0	5797
10714	22	5880	42	174	0	6118
10715	5857	186	21	74	0	6138
10716	6045	47	44	73	0	6209
10717	210	39	41	5711	0	6001
10718	70	5737	33	210	0	6050
10719	49	159	5920	88	0	6216
10720	5939	50	193	72	0	6254
10721	194	34	70	6004	0	6302
10722	72	20	53	6144	0	6289
10723	61	27	27	6257	0	6372
10724	5957	16	39	265	0	6277
10725	202	5634	30	106	0	5972
10726	60	5945	42	90	0	6137
10727	5696	215	34	55	0	6000
10728	188	5803	41	51	0	6083
10729	5818	202	40	52	0	6112
10730	5911	67	25	60	0	6063
10731	225	5772	29	61	0	6087
10732	98	199	37	5593	0	5927
10733	66	5755	36	192	0	6049
10734	49	226	32	5758	0	6065
10735	61	67	27	6250	0	6405
10736	6141	70	34	279	0	6524
10737	6493	49	33	125	0	6700
10738	280	50	33	6357	0	6720
10739	117	49	6251	267	0	6684
10740	6098	45	215	128	0	6486
10741	238	6255	68	97	0	6658
10742	114	224	46	6305	0	6689
10743	105	76	37	6524	0	6742
10744	77	58	38	6591	0	6764
10745	6197	50	29	336	0	6612
10746	6310	50	33	152	0	6545
10747	293	5905	43	120	0	6361
10748	110	6176	48	106	0	6440
10749	128	263	33	6071	0	6495
10750	89	106	36	6287	0	6518
10751	86	73	6066	331	0	6556
10752	90	61	213	5987	0	6351
10753	78	57	5809	306	0	6250
10754	64	54	5467	139	0	5724
10755	76	5457	223	111	0	5867
10756	77	213	96	5483	0	5869
10757	5489	92	59	258	0	5898
10758	229	60	41	5477	0	5807
10759	100	38	5395	271	0	5804
10760	5273	56	200	120	0	5649
10761	5481	56	80	96	0	5713
10762	265	54	5314	96	0	5729
10763	111	61	200	5459	0	5831
10764	5327	51	82	253	0	5713
10765	253	5385	49	141	0	5828
10766	5500	210	50	112	0	5872
10767	5717	79	50	96	0	5942
10768	284	79	53	5555	0	5971
10769	150	49	54	5814	0	6067
10770	5702	60	43	297	0	6102
10771	274	46	47	5742	0	6109
10772	130	46	5662	305	0	6143
10773	5556	43	215	150	0	5964
10774	5700	40	83	118	0	5941
10775	286	5416	63	106	0	5871
10776	152	5681	34	101	0	5968
10777	112	271	36	5455	0	5874
10778	76	5607	40	259	0	5982
10779	100	242	38	5682	0	6062
10780	5548	89	27	262	0	5926
10781	5499	63	38	138	0	5738
10782	284	5376	42	105	0	5807
10783	5346	225	26	92	0	5689
10784	248	5368	35	85	0	5736
10785	5352	244	33	89	0	5718
10786	5530	101	28	88	0	5747
10787	279	76	5273	100	0	5728
10788	5266	62	196	88	0	5612
10789	294	5125	71	83	0	5573
10790	148	5396	51	71	0	5666
10791	5350	258	44	76	0	5728
10792	274	109	37	5347	0	5767
10793	149	82	5286	230	0	5747
10794	126	88	181	5331	0	5726
10795	131	75	63	5517	0	5786
10796	120	63	5273	262	0	5718
10797	5092	68	199	131	0	5490
10798	271	5210	69	111	0	5661
10799	5163	202	59	82	0	5506
10800	259	85	47	5051	0	5442
10801	5079	67	33	231	0	5410
10802	251	5026	47	119	0	5443
10803	130	214	44	5071	0	5459
10804	5024	89	30	239	0	5382
10805	251	61	4767	124	0	5203
10806	126	48	4428	95	0	4697
10807	4226	54	194	93	0	4567
10808	208	4172	84	72	0	4536
10809	89	3779	50	63	0	3981
10810	157	151	69	3455	0	3832
10811	79	3515	43	139	0	3776
10812	95	139	50	3505	0	3789
10813	64	47	36	3682	0	3829
10814	76	53	36	3581	0	3746
10815	54	3517	37	145	0	3753
10816	52	111	36	3480	0	3679
10817	67	64	3382	125	0	3638
10818	37	3285	84	70	0	3476
10819	49	119	33	3024	0	3225
10820	54	3056	23	108	0	3241
10821	3057	100	32	60	0	3249
10822	3066	46	36	56	0	3204
10823	3080	35	24	54	0	3193
10824	114	3154	21	45	0	3334
10825	64	87	25	3154	0	3330
10826	52	53	3068	98	0	3271
10827	61	41	3002	46	0	3150
10828	2875	45	73	42	0	3035
10829	2998	25	32	47	0	3102
10830	109	23	23	3032	0	3187
10831	44	33	23	3156	0	3256
10832	42	20	3204	130	0	3396
10833	40	3144	88	56	0	3328
10834	37	3130	40	45	0	3252
10835	34	82	2852	39	0	3007
10836	36	62	67	2585	0	2750
10837	23	23	35	2184	0	2265
10838	7	5	8	2648	0	2668
10839	18	10	6	2612	0	2646
10840	2589	8	9	69	0	2675
10841	53	9	2485	26	0	2573
10842	2452	9	46	9	0	2516
10843	52	10	20	2507	0	2589
10844	2531	13	7	50	0	2601
10845	59	9	6	2533	0	2607
10846	29	12	2556	55	0	2652
10847	19	5	47	2580	0	2651
10848	8	10	2698	58	0	2774
10849	13	9	43	2647	0	2712
10850	9	10	2777	52	0	2848
10851	7	2766	47	23	0	2843
10852	8	40	19	2782	0	2849
10853	7	19	10	2771	0	2807
10854	4	2793	2	52	0	2851
10855	2876	43	5	23	0	2947
10856	51	19	6	2848	0	2924
10857	21	9	4	2838	0	2872
10858	2833	9	1	71	0	2914
10859	2878	6	5	27	0	2916
10860	2963	5	6	17	0	2991
10861	2963	3	5	9	0	2980
10862	63	10	2825	9	0	2907
10863	2764	4	37	15	0	2820
10864	2868	2	14	13	0	2897
10865	64	2	10	2743	0	2819
10866	17	7	6	2743	0	2773
10867	2700	5	4	50	0	2759
10868	50	2643	4	17	0	2714
10869	17	33	11	2560	0	2621
10870	16	9	2678	36	0	2739
10871	11	2623	25	19	0	2678
10872	2599	29	13	24	0	2665
10873	2645	9	5	15	0	2674
10874	2670	7	1	7	0	2685
10875	2674	12	3	5	0	2694
10876	45	1	6	2607	0	2659
10877	21	3	2581	35	0	2640
10878	10	15	2700	12	0	2737
10879	16	2	54	2896	0	2968
10880	3110	2	17	52	0	3181
10881	73	2	6	3118	0	3199
10882	30	2	3117	71	0	3220
10883	3090	2	58	39	0	3189
10884	3185	3	28	20	0	3236
10885	78	2	16	3189	0	3285
10886	29	4	3298	68	0	3399
10887	21	1	3311	21	0	3354
10888	3166	2	75	25	0	3268
10889	58	3317	30	11	0	3416
10890	36	50	3357	11	0	3454
10891	17	18	55	3328	0	3418
10892	3327	5	27	77	0	3436
10893	67	3232	22	26	0	3347
10894	26	3315	15	21	0	3377
10895	3287	72	18	13	0	3390
10896	67	28	12	3284	0	3391
10897	3493	7	17	69	0	3586
10898	76	5	5	3552	0	3638
10899	38	11	12	3621	0	3682
10900	20	14	3582	85	0	3701
10901	31	13	3331	37	0	3412
10902	26	11	3581	18	0	3636
10903	17	8	93	3566	0	3684
10904	3601	8	30	86	0	3725
10905	95	2	3623	39	0	3759
10906	37	8	77	3625	0	3747
10907	28	9	3700	79	0	3816
10908	26	3723	85	40	0	3874
10909	23	67	38	3866	0	3994
10910	28	21	22	3864	0	3935
10911	22	7	27	3886	0	3942
10912	3820	5	27	120	0	3972
10913	84	9	26	3818	0	3937
10914	40	12	30	3864	0	3946
10915	3793	16	38	110	0	3957
10916	89	9	3732	71	0	3901
10917	3713	6	90	44	0	3853
10918	3766	12	36	36	0	3850
10919	121	7	3747	29	0	3904
10920	3664	10	86	44	0	3804
10921	99	19	36	3807	0	3961
10922	69	8	3863	90	0	4030
10923	3828	5	85	71	0	3989
10924	3895	2	34	49	0	3980
10925	128	7	23	3877	0	4035
10926	49	6	33	3922	0	4010
10927	44	3	28	3962	0	4037
10928	3856	3	23	134	0	4016
10929	102	3848	39	52	0	4041
10930	3830	61	24	33	0	3948
10931	102	3622	21	48	0	3793
10932	44	3584	39	40	0	3707
10933	42	74	23	3665	0	3804
10934	33	27	29	3703	0	3792
10935	37	12	25	3647	0	3721
10936	38	17	17	3695	0	3767
10937	44	13	3586	106	0	3749
10938	3465	21	62	74	0	3622
10939	80	20	37	3658	0	3795
10940	49	12	3671	108	0	3840
10941	38	19	68	3693	0	3818
10942	39	21	35	3781	0	3876
10943	39	18	3879	124	0	4060
10944	41	17	79	3857	0	3994
10945	45	18	27	3849	0	3939
10946	3859	15	25	133	0	4032
10947	89	7	3876	71	0	4043
10948	3658	6	78	74	0	3816
10949	82	3864	50	57	0	4053
10950	3856	61	41	51	0	4009
10951	3811	23	28	62	0	3924
10952	107	12	32	3791	0	3942
10953	60	14	3766	94	0	3934
10954	36	3881	92	66	0	4075
10955	38	77	31	3755	0	3901
10956	34	4101	22	89	0	4246
10957	4115	85	27	60	0	4287
10958	107	22	4039	65	0	4233
10959	47	22	3981	49	0	4099
10960	40	17	116	3954	0	4127
10961	35	20	4154	111	0	4320
10962	35	21	96	4119	0	4271
10963	43	12	42	4138	0	4235
10964	4297	24	31	122	0	4474
10965	108	4278	24	82	0	4492
10966	37	84	36	4390	0	4547
10967	36	33	31	4468	0	4568
10968	22	20	37	4387	0	4466
10969	28	4242	35	139	0	4444
10970	46	4316	26	66	0	4454
10971	4218	104	39	53	0	4414
10972	4279	29	33	54	0	4395
10973	4270	20	26	58	0	4374
10974	128	18	4142	54	0	4342
10975	55	61	92	4095	0	4303
10976	44	24	4136	124	0	4328
10977	36	4138	85	76	0	4335
10978	3941	86	35	47	0	4109
10979	84	33	3893	35	0	4045
10980	41	16	51	3706	0	3814
10981	28	11	3815	69	0	3923
10982	3700	11	70	42	0	3823
10983	3910	15	19	36	0	3980
10984	3911	15	19	27	0	3972
10985	3860	7	16	19	0	3902
10986	82	13	3951	18	0	4064
10987	3813	8	59	23	0	3903
10988	3894	9	28	22	0	3953
10989	74	3845	24	25	0	3968
10990	3861	50	20	18	0	3949
10991	3910	21	19	20	0	3970
10992	78	12	13	3792	0	3895
10993	40	3940	21	55	0	4056
10994	4125	56	13	34	0	4228
10995	4457	22	13	29	0	4521
10996	108	15	5090	20	0	5233
10997	52	11	5126	21	0	5210
10998	33	11	5324	15	0	5383
10999	37	24	154	5170	0	5385
11000	5236	10	74	115	0	5435
11001	117	5265	30	52	0	5464
11002	5204	104	25	29	0	5362
11003	137	5261	25	19	0	5442
11004	5227	118	21	21	0	5387
11005	128	5125	19	23	0	5295
11006	65	5298	12	14	0	5389
11007	5118	136	21	26	0	5301
11008	113	5297	13	10	0	5433
11009	58	127	12	5279	0	5476
11010	48	50	5295	95	0	5488
11011	31	32	5338	42	0	5443
11012	19	21	129	5253	0	5422
11013	22	17	65	5404	0	5508
11014	17	30	5413	141	0	5601
11015	29	19	108	5308	0	5464
11016	27	21	48	5467	0	5563
11017	5421	14	39	146	0	5620
11018	105	5400	28	76	0	5609
11019	52	109	22	5165	0	5348
11020	39	5529	29	107	0	5704
11021	5502	130	20	68	0	5720
11022	108	5549	17	45	0	5719
11023	5580	128	27	21	0	5756
11024	5608	60	21	25	0	5714
11025	155	38	21	5461	0	5675
11026	83	30	21	5485	0	5619
11027	46	32	22	5599	0	5699
11028	46	29	24	5604	0	5703
11029	37	30	5353	183	0	5603
11030	4963	29	108	94	0	5194
11031	121	5352	46	59	0	5578
11032	73	115	34	5453	0	5675
11033	46	58	23	5497	0	5624
11034	41	5473	16	167	0	5697
11035	5464	126	37	80	0	5707
11036	123	5550	23	52	0	5748
11037	77	138	19	5623	0	5857
11038	56	67	20	5736	0	5879
11039	50	36	12	5791	0	5889
11040	28	43	19	5739	0	5829
11041	5619	30	11	199	0	5859
11042	140	33	5578	87	0	5838
11043	78	29	123	5442	0	5672
11044	49	28	67	5504	0	5648
11045	35	25	54	5618	0	5732
11046	34	25	35	5584	0	5678
11047	5368	21	24	217	0	5630
11048	155	25	5402	108	0	5690
11049	90	34	117	5144	0	5385
11050	58	5081	54	154	0	5347
11051	43	5428	38	88	0	5597
11052	5339	158	17	73	0	5587
11053	134	76	5294	55	0	5559
11054	5004	53	104	55	0	5216
11055	151	43	5242	30	0	5466
11056	77	33	96	4998	0	5204
11057	5082	32	53	144	0	5311
11058	104	5133	53	80	0	5370
11059	61	94	47	4949	0	5151
11060	46	4854	32	121	0	5053
11061	5078	107	37	72	0	5294
11062	5105	57	38	64	0	5264
11063	148	38	25	5050	0	5261
11064	73	35	4934	137	0	5179
11065	64	34	4901	87	0	5086
11066	51	43	125	4863	0	5082
11067	39	4946	55	113	0	5153
11068	37	121	33	5180	0	5371
11069	39	67	16	4960	0	5082
11070	38	52	20	4919	0	5029
11071	44	39	5034	156	0	5273
11072	35	21	98	5011	0	5165
11073	29	25	54	5080	0	5188
11074	24	4975	37	213	0	5249
11075	14	93	25	4992	0	5124
11076	20	40	20	5297	0	5377
11077	21	23	37	5357	0	5438
11078	28	19	30	5320	0	5397
11079	32	23	17	5258	0	5330
11080	17	41	13	5287	0	5358
11081	28	25	11	5208	0	5272
11082	29	38	13	5110	0	5190
11083	35	33	4816	191	0	5075
11084	33	36	96	4895	0	5060
11085	4858	21	48	186	0	5113
11086	120	13	26	4828	0	4987
11087	61	18	4821	173	0	5073
11088	4686	15	99	124	0	4924
11089	4963	16	51	81	0	5111
11090	4944	18	43	72	0	5077
11091	4956	19	24	72	0	5071
11092	167	20	22	5013	0	5222
11093	76	11	4898	166	0	5151
11094	51	4681	96	107	0	4935
11095	29	4306	44	72	0	4451
11096	56	106	109	3589	0	3860
11097	8	14	20	3763	0	3805
11098	14	6	5	3652	0	3677
11099	7	5	6	3834	0	3852
11100	7	3	3	4275	0	4288
11101	4601	5	3	115	0	4724
11102	101	4632	5	39	0	4777
11103	31	4868	5	22	0	4926
11104	25	141	4	4896	0	5066
11105	12	47	3	5038	0	5100
11106	10	19	1	5039	0	5069
11107	11	6	6	5016	0	5039
11108	7	7	4764	193	0	4971
11109	21	4656	118	75	0	4870
11110	10	119	36	4733	0	4898
11111	4625	43	19	138	0	4825
11112	125	23	4	4695	0	4847
11113	41	13	4621	164	0	4839
11114	22	14	4434	79	0	4549
11115	11	19	4704	63	0	4797
11116	8	21	168	4570	0	4767
11117	4793	16	57	164	0	5030
11118	120	8	22	4873	0	5023
11119	53	10	17	5037	0	5117
11120	4827	13	15	196	0	5051
11121	128	14	24	4940	0	5106
11122	50	8	28	5031	0	5117
11123	31	4	5157	184	0	5376
11124	16	5136	133	94	0	5379
11125	22	123	50	5356	0	5551
11126	5286	37	39	157	0	5519
11127	128	22	19	5346	0	5515
11128	62	6	5358	182	0	5608
11129	41	13	133	5294	0	5481
11130	16	5333	46	195	0	5590
11131	25	125	38	5452	0	5640
11132	18	50	5398	180	0	5646
11133	20	5757	136	92	0	6005
11134	28	156	50	5927	0	6161
11135	30	57	31	6647	0	6765
11136	20	36	23	6795	0	6874
11137	22	16	20	6824	0	6882
11138	21	17	6526	308	0	6872
11139	11	6500	200	128	0	6839
11140	6535	192	64	96	0	6887
11141	6766	65	51	56	0	6938
11142	238	46	19	6651	0	6954
11143	78	23	6589	264	0	6954
11144	6426	15	212	106	0	6759
11145	203	20	73	6710	0	7006
11146	60	22	6889	247	0	7218
11147	53	21	215	6917	0	7206
11148	36	19	66	7014	0	7135
11149	35	12	47	7143	0	7237
11150	42	19	7157	320	0	7538
11151	47	21	214	6809	0	7091
11152	50	7122	69	247	0	7488
11153	7169	199	52	119	0	7539
11154	7248	67	41	93	0	7449
11155	7273	42	32	87	0	7434
11156	278	7074	37	81	0	7470
11157	7130	208	31	93	0	7462
11158	240	60	41	7064	0	7405
11159	7043	39	36	276	0	7394
11160	7129	30	27	130	0	7316
11161	264	24	6853	102	0	7243
11162	111	6863	215	73	0	7262
11163	6917	209	71	64	0	7261
11164	229	76	59	6872	0	7236
11165	101	57	6786	254	0	7198
11166	85	6797	213	118	0	7213
11167	6774	206	71	106	0	7157
11168	252	74	56	6825	0	7207
11169	106	57	39	6989	0	7191
11170	92	38	27	6973	0	7130
11171	73	6742	26	315	0	7156
11172	65	211	33	6850	0	7159
11173	57	6639	44	338	0	7078
11174	54	229	44	6866	0	7193
11175	60	87	6820	272	0	7239
11176	56	55	212	6885	0	7208
11177	58	36	77	7031	0	7202
11178	57	30	62	7164	0	7313
11179	41	45	6843	354	0	7283
11180	40	40	215	6847	0	7142
11181	55	35	88	7122	0	7300
11182	44	45	58	7199	0	7346
11183	55	33	52	7170	0	7310
11184	55	37	44	7242	0	7378
11185	57	40	6921	363	0	7381
11186	48	41	196	6948	0	7233
11187	56	29	92	7028	0	7205
11188	6616	35	62	354	0	7067
11189	216	6518	39	195	0	6968
11190	108	6787	43	146	0	7084
11191	83	239	44	6756	0	7122
11192	54	97	39	6767	0	6957
11193	50	6452	58	335	0	6895
11194	50	199	50	6529	0	6828
11195	49	6460	40	306	0	6855
11196	84	216	38	6486	0	6824
11197	66	80	34	6472	0	6652
11198	49	76	6121	291	0	6537
11199	48	5888	169	187	0	6292
11200	44	5737	54	115	0	5950
11201	4950	158	71	78	0	5257
11202	114	5079	33	62	0	5288
11203	69	125	14	4980	0	5188
11204	53	45	4839	159	0	5096
11205	46	45	111	4809	0	5011
11206	4765	26	43	168	0	5002
11207	121	36	4826	72	0	5055
11208	41	4961	102	76	0	5180
11209	70	112	52	4326	0	4560
11210	31	42	33	5177	0	5283
11211	5169	31	33	174	0	5407
11212	114	27	27	5247	0	5415
11213	51	24	25	5333	0	5433
11214	36	28	21	5344	0	5429
11215	24	33	19	5317	0	5393
11216	5165	23	22	185	0	5395
11217	5064	28	19	109	0	5220
11218	138	27	15	5109	0	5289
11219	4999	21	21	164	0	5205
11220	122	20	18	4978	0	5138
11221	37	31	4767	166	0	5001
11222	42	25	4569	83	0	4719
11223	36	40	104	4317	0	4497
11224	24	4398	40	156	0	4618
11225	33	100	22	4430	0	4585
11226	4368	31	16	156	0	4571
11227	87	33	20	4452	0	4592
11228	4297	16	17	172	0	4502
11229	111	23	18	4408	0	4560
11230	33	20	4407	146	0	4606
11231	34	4286	92	76	0	4488
11232	23	4449	24	85	0	4581
11233	32	128	14	3954	0	4128
11234	17	28	3988	103	0	4136
11235	4	3354	20	23	0	3401
11236	21	26	12	3272	0	3331
11237	3223	8	9	32	0	3272
11238	13	12	3228	17	0	3270
11239	9	4	13	3219	0	3245
11240	4	3	6	3313	0	3326
11241	2	4	3281	25	0	3312
11242	4	4	3007	23	0	3038
11243	0	1	3252	12	0	3265
11244	2	7	24	3299	0	3332
11245	1	1	3404	21	0	3427
11246	3095	2	29	19	0	3145
11247	30	2	9	3449	0	3490
11248	18	1	4014	36	0	4069
11249	6	4106	42	26	0	4180
11250	5	38	4038	14	0	4095
11251	4	14	53	3998	0	4069
11252	4120	7	20	61	0	4208
11253	53	1	9	4215	0	4278
11254	18	4	6	4310	0	4338
11255	4536	3	2	77	0	4618
11256	73	2	4	4667	0	4746
11257	21	0	4757	93	0	4871
11258	4632	3	80	30	0	4745
11259	80	4847	24	16	0	4967
11260	4934	81	7	11	0	5033
11261	93	22	2	4960	0	5077
11262	22	11	4899	90	0	5022
11263	12	3	4933	35	0	4983
11264	11	13	114	4935	0	5073
11265	8	10	36	4927	0	4981
11266	11	1	4941	99	0	5052
11267	8	4	4725	38	0	4775
11268	4874	3	113	15	0	5005
11269	88	2	34	4979	0	5103
11270	5014	1	12	93	0	5120
11271	99	2	8	4994	0	5103
11272	29	2	5215	98	0	5344
11273	15	6	5394	29	0	5444
11274	18	2	118	5465	0	5603
11275	8	5	37	5565	0	5615
11276	14	3	5649	132	0	5798
11277	5482	2	111	54	0	5649
11278	122	1	37	5855	0	6015
11279	6179	3	21	128	0	6331
11280	143	7019	9	47	0	7218
11281	37	163	7	7224	0	7431
11282	7238	48	13	192	0	7491
11283	198	17	7232	64	0	7511
11284	65	5	178	7254	0	7502
11285	35	4	59	7364	0	7462
11286	22	9	33	7615	0	7679
11287	17	8	7406	262	0	7693
11288	25	12	199	7221	0	7457
11289	17	7374	69	217	0	7677
11290	19	187	34	7544	0	7784
11291	19	45	7431	227	0	7722
11292	12	20	7503	89	0	7624
11293	19	10	253	7436	0	7718
11294	20	8	75	7611	0	7714
11295	19	10	44	7763	0	7836
11296	18	8	32	7800	0	7858
11297	7580	7	33	280	0	7900
11298	7600	3	29	111	0	7743
11299	255	1	7448	56	0	7760
11300	83	7525	203	52	0	7863
11301	39	174	66	7808	0	8087
11302	8000	52	44	253	0	8349
11303	7131	46	49	129	0	7355
11304	8190	16	27	66	0	8299
11305	8255	15	27	57	0	8354
11306	280	12	8002	57	0	8351
11307	7693	10	214	53	0	7970
11308	225	7704	80	45	0	8054
11309	84	194	47	7877	0	8202
11310	59	55	7905	236	0	8255
11311	36	30	227	7801	0	8094
11312	38	15	7853	261	0	8167
11313	51	19	211	7846	0	8127
11314	37	14	84	8104	0	8239
11315	7924	11	62	292	0	8289
11316	221	22	39	7990	0	8272
11317	88	19	8034	287	0	8428
11318	57	15	230	8179	0	8481
11319	8177	12	93	306	0	8588
11320	233	16	61	8263	0	8573
11321	93	11	8187	282	0	8573
11322	56	8037	235	139	0	8467
11323	8286	202	100	114	0	8702
11324	245	75	66	8019	0	8405
11325	103	8441	45	240	0	8829
11326	8420	210	46	135	0	8811
11327	252	69	8359	81	0	8761
11328	108	8263	226	72	0	8669
11329	74	203	93	8506	0	8876
11330	59	63	8422	263	0	8807
11331	63	44	229	8189	0	8525
11332	8284	22	94	305	0	8705
11333	244	23	8196	134	0	8597
11334	112	29	240	8149	0	8530
11335	81	25	8293	265	0	8664
11336	68	16	260	8210	0	8554
11337	54	30	111	8460	0	8655
11338	8207	31	67	316	0	8621
11339	247	8225	45	169	0	8686
11340	106	203	59	8433	0	8801
11341	8359	62	66	288	0	8775
11342	8424	34	44	159	0	8661
11343	292	38	55	8198	0	8583
11344	118	7971	60	268	0	8417
11345	59	8275	59	140	0	8533
11346	59	244	49	8091	0	8443
11347	62	75	47	8100	0	8284
11348	7395	43	48	291	0	7777
11349	222	26	47	7349	0	7644
11350	87	26	7044	240	0	7397
11351	6609	23	172	129	0	6933
11352	186	6856	68	107	0	7217
11353	6864	159	53	90	0	7166
11354	219	57	6991	77	0	7344
11355	83	7049	156	70	0	7358
11356	6956	162	101	71	0	7290
11357	6987	54	71	60	0	7172
11358	203	32	6948	53	0	7236
11359	6706	24	155	45	0	6930
11360	6972	20	54	55	0	7101
11361	206	6922	39	42	0	7209
11362	88	153	31	7048	0	7320
11363	67	50	6939	184	0	7240
11364	62	30	163	7138	0	7393
11365	48	29	7248	200	0	7525
11366	43	30	185	7093	0	7351
11367	7245	23	61	218	0	7547
11368	205	17	45	7471	0	7738
11369	65	16	8185	235	0	8501
11370	8292	16	242	91	0	8641
11371	278	11	84	8605	0	8978
11372	88	16	8356	283	0	8743
11373	7928	14	260	116	0	8318
11374	278	26	85	8179	0	8568
11375	92	13	8006	295	0	8406
11376	72	18	7854	98	0	8042
11377	49	119	280	7628	0	8076
11378	38	15	7943	258	0	8254
11379	43	7403	252	100	0	7798
11380	57	196	69	6563	0	6885
11381	6552	32	48	182	0	6814
11382	170	18	6585	48	0	6821
11383	52	8	6528	49	0	6637
11384	6147	9	211	37	0	6404
11385	176	15	6564	25	0	6780
11386	6142	7	194	39	0	6382
11387	190	7	6464	30	0	6691
11388	63	4	203	6317	0	6587
11389	42	4	6521	175	0	6742
11390	47	6	200	6347	0	6600
11391	25	7	6617	180	0	6829
11392	46	6	6408	64	0	6524
11393	5967	1	227	57	0	6252
11394	163	6400	88	37	0	6688
11395	6500	149	63	29	0	6741
11396	177	6551	43	34	0	6805
11397	64	161	52	6602	0	6879
11398	46	43	63	6843	0	6995
11399	6756	21	42	198	0	7017
11400	180	26	51	6635	0	6892
11401	79	10	6547	200	0	6836
11402	6178	22	185	74	0	6459
11403	6426	9	77	70	0	6582
11404	217	9	67	6344	0	6637
11405	88	13	6412	191	0	6704
11406	61	11	180	6318	0	6570
11407	36	6332	90	196	0	6654
11408	46	153	58	6426	0	6683
11409	50	49	43	6633	0	6775
11410	41	32	6389	234	0	6696
11411	5781	21	185	106	0	6093
11412	182	6269	66	76	0	6593
11413	6223	173	54	65	0	6515
11414	197	6346	50	63	0	6656
11415	96	176	35	6233	0	6540
11416	57	6399	53	191	0	6700
11417	58	174	6211	72	0	6515
11418	46	62	187	5923	0	6218
11419	60	39	74	6031	0	6204
11420	39	35	67	6354	0	6495
11421	6121	17	62	267	0	6467
11422	190	32	58	6163	0	6443
11423	5998	32	68	221	0	6319
11424	6136	32	38	112	0	6318
11425	6006	35	52	90	0	6183
11426	256	22	5894	89	0	6261
11427	118	29	205	5906	0	6258
11428	85	26	83	6287	0	6481
11429	78	30	77	6409	0	6594
11430	6443	27	71	291	0	6832
11431	239	25	62	6473	0	6799
11432	95	23	74	6741	0	6933
11433	6885	23	80	301	0	7289
11434	261	19	83	7080	0	7443
11435	110	30	7152	319	0	7611
11436	104	24	7274	138	0	7540
11437	94	23	306	7294	0	7717
11438	7207	20	130	327	0	7684
11439	7124	14	127	141	0	7406
11440	328	20	93	7063	0	7504
11441	147	16	7031	306	0	7500
11442	116	6880	294	128	0	7418
11443	87	231	126	7101	0	7545
11444	88	58	91	7321	0	7558
11445	94	55	84	7351	0	7584
11446	7147	28	78	378	0	7631
11447	284	32	7152	179	0	7647
11448	7083	39	285	143	0	7550
11449	328	21	105	7016	0	7470
11450	126	7124	82	328	0	7660
11451	7240	241	74	131	0	7686
11452	7247	63	73	143	0	7526
11453	349	60	7336	120	0	7865
11454	168	6782	286	111	0	7347
11455	115	7012	87	124	0	7338
11456	6892	270	102	115	0	7379
11457	308	91	68	6945	0	7412
11458	136	71	45	7053	0	7305
11459	130	46	62	7005	0	7243
11460	86	6549	50	364	0	7049
11461	78	6934	44	168	0	7224
11462	6765	270	41	154	0	7230
11463	310	94	35	6760	0	7199
11464	114	54	7032	302	0	7502
11465	89	41	274	7405	0	7809
11466	75	55	8175	367	0	8672
11467	100	60	8256	139	0	8555
11468	90	49	8265	128	0	8532
11469	49	7093	348	39	0	7529
11470	76	237	201	6554	0	7068
11471	25	6814	117	234	0	7190
11472	36	258	72	6331	0	6697
11473	19	92	51	6955	0	7117
11474	6804	93	32	315	0	7244
11475	226	41	30	6938	0	7235
11476	6748	50	21	322	0	7141
11477	6934	16	24	156	0	7130
11478	298	23	24	6568	0	6913
11479	151	6513	36	258	0	6958
11480	107	208	38	6437	0	6790
11481	82	6513	37	264	0	6896
11482	58	272	21	6591	0	6942
11483	45	102	6469	321	0	6937
11484	46	93	229	6532	0	6900
11485	39	41	75	6793	0	6948
11486	6354	50	81	352	0	6837
11487	218	6455	47	202	0	6922
11488	101	229	41	6531	0	6902
11489	105	79	23	6509	0	6716
11490	77	6321	50	318	0	6766
11491	59	227	21	6481	0	6788
11492	5811	119	30	354	0	6314
11493	6366	89	31	180	0	6666
11494	273	6192	24	141	0	6630
11495	155	235	30	6260	0	6680
11496	6015	82	35	310	0	6442
11497	253	6186	30	144	0	6613
11498	134	251	16	5899	0	6300
11499	111	6065	33	273	0	6482
11500	6054	286	32	138	0	6510
11501	251	119	5962	132	0	6464
11502	112	115	6025	107	0	6359
11503	109	66	268	5976	0	6419
11504	74	74	6047	280	0	6475
11505	80	33	305	5940	0	6358
11506	5886	55	143	315	0	6399
11507	251	64	6046	144	0	6505
11508	105	47	255	6119	0	6526
11509	110	55	124	6257	0	6546
11510	6058	49	86	369	0	6562
11511	250	6128	68	202	0	6648
11512	6153	239	49	175	0	6616
11513	6308	94	30	141	0	6573
11514	329	6000	51	92	0	6472
11515	180	241	42	6106	0	6569
11516	147	121	5991	267	0	6526
11517	110	95	229	5932	0	6366
11518	65	6002	98	317	0	6482
11519	6139	266	82	146	0	6633
11520	252	118	77	6220	0	6667
11521	106	116	6239	307	0	6768
11522	105	77	225	6410	0	6817
11523	82	75	112	6618	0	6887
11524	71	54	87	6690	0	6902
11525	67	69	56	6715	0	6907
11526	88	55	54	6564	0	6761
11527	59	71	6142	448	0	6720
11528	66	44	5991	279	0	6380
11529	56	5494	270	208	0	6028
11530	40	5855	121	163	0	6179
11531	5726	236	97	123	0	6182
11532	229	124	5721	82	0	6156
11533	5236	95	224	94	0	5649
11534	231	66	5181	71	0	5549
11535	107	45	5015	73	0	5240
11536	90	37	215	4865	0	5207
11537	5024	44	145	194	0	5407
11538	190	34	83	5106	0	5413
11539	87	28	74	5235	0	5424
11540	74	28	5500	256	0	5858
11541	65	24	166	5605	0	5860
11542	44	27	97	5633	0	5801
11543	39	24	64	5786	0	5913
11544	61	28	45	5729	0	5863
11545	52	17	45	5763	0	5877
11546	5513	22	29	319	0	5883
11547	168	17	38	5618	0	5841
11548	75	24	5354	283	0	5736
11549	74	39	131	5486	0	5730
11550	69	24	5365	256	0	5714
11551	62	36	177	5411	0	5686
11552	29	24	5528	257	0	5838
11553	34	52	196	5253	0	5535
11554	21	16	116	5573	0	5726
11555	20	14	5409	251	0	5694
11556	4954	22	167	178	0	5321
11557	144	23	5446	115	0	5728
11558	86	16	168	5520	0	5790
11559	5581	11	110	188	0	5890
11560	153	7	84	5640	0	5884
11561	97	9	51	5743	0	5900
11562	69	10	5609	237	0	5925
11563	58	5337	124	173	0	5692
11564	38	4885	58	107	0	5088
11565	18	4722	36	92	0	4868
11566	116	27	69	3711	0	3923
11567	3801	5	17	25	0	3848
11568	15	2	2	3789	0	3808
11569	7	1	5	3830	0	3843
11570	4	0	1	3870	0	3875
11571	3	1	0	3830	0	3834
11572	1	3803	3	24	0	3831
11573	1	15	4	3895	0	3915
11574	4	5	2	3865	0	3876
11575	0	3907	2	24	0	3933
11576	3971	19	0	10	0	4000
11577	19	5	0	3981	0	4005
11578	3984	1	1	24	0	4010
11579	3981	2	0	13	0	3996
11580	23	4122	2	4	0	4151
11581	8	17	0	4450	0	4475
11582	5	7	4381	21	0	4414
11583	3	2	4294	6	0	4305
11584	1	0	22	4335	0	4358
11585	4493	0	13	31	0	4537
11586	4592	1	4	15	0	4612
11587	25	0	1	4699	0	4725
11588	4724	1	0	38	0	4763
11589	23	4681	2	13	0	4719
11590	4704	22	5	7	0	4738
11591	23	4946	9	3	0	4981
11592	10	26	1	5083	0	5120
11593	7	13	2	5077	0	5099
11594	9	5050	2	29	0	5090
11595	5005	22	57	20	0	5104
11596	32	11	4991	7	0	5041
11597	10	5	27	4980	0	5022
11598	5	8	5128	23	0	5164
11599	13	3	21	5045	0	5082
11600	5215	3	7	32	0	5257
11601	31	4	1	5173	0	5209
11602	5171	3	8	34	0	5216
11603	5124	4	9	18	0	5155
11604	39	4	4	5114	0	5161
11605	15	9	5100	37	0	5161
11606	6	5365	20	27	0	5418
11607	11	21	9	5356	0	5397
11608	5237	10	4	46	0	5297
11609	38	8	5189	12	0	5247
11610	20	8	24	5159	0	5211
11611	12	4	14	5178	0	5208
11612	11	3	9	5301	0	5324
11613	5274	7	9	41	0	5331
11614	35	4	4	5156	0	5199
11615	11	6	8	5286	0	5311
11616	16	4	5267	37	0	5324
11617	15	4	30	5203	0	5252
11618	8	3	17	5339	0	5367
11619	15	2	8	5458	0	5483
11620	7	5389	16	39	0	5451
11621	9	22	5	5303	0	5339
11622	22	7	5	5247	0	5281
11623	5126	6	9	54	0	5195
11624	36	10	4991	30	0	5067
11625	16	7	4695	32	0	4750
11626	10	5064	28	18	0	5120
11627	14	30	21	5201	0	5266
11628	5184	7	2	36	0	5229
11629	33	4	6	5129	0	5172
11630	19	2	8	5124	0	5153
11631	5	5	7	5228	0	5245
11632	7	5	5	5086	0	5103
11633	6	3	2	5086	0	5097
11634	8	7	5017	38	0	5070
11635	9	3	26	4969	0	5007
11636	5043	3	17	49	0	5112
11637	36	4901	4	22	0	4963
11638	12	23	11	5008	0	5054
11639	8	6	8	4970	0	4992
11640	8	10	4672	40	0	4730
11641	10	6	27	4522	0	4565
11642	14	5	10	4823	0	4852
11643	4935	3	7	60	0	5005
11644	37	5018	1	32	0	5088
11645	17	30	4	5136	0	5187
11646	8	15	6	5183	0	5212
11647	13	5	10	5191	0	5219
11648	7	6	5170	76	0	5259
11649	11	4	4837	47	0	4899
11650	12	5039	58	26	0	5135
11651	13	5259	19	17	0	5308
11652	7	57	6	5230	0	5300
11653	9	4920	22	84	0	5035
11654	9	67	8	5654	0	5738
11655	5	32	14	6220	0	6271
11656	5	9	10	6606	0	6630
11657	11	10	8	7447	0	7476
11658	14	16	7390	199	0	7619
11659	11	16	130	7426	0	7583
11660	3	11	63	7531	0	7608
11661	7	5	33	7735	0	7780
11662	7374	7	29	277	0	7687
11663	135	7468	39	156	0	7798
11664	84	149	26	7183	0	7442
11665	35	7570	28	210	0	7843
11666	7321	178	21	158	0	7678
11667	6516	106	15	145	0	6782
11668	159	7424	13	127	0	7723
11669	94	7713	12	122	0	7941
11670	54	248	7448	100	0	7850
11671	43	7748	149	105	0	8045
11672	51	220	95	7660	0	8026
11673	7722	124	48	231	0	8125
11674	180	7906	25	147	0	8258
11675	93	233	32	7959	0	8317
11676	75	151	25	8061	0	8312
11677	55	115	36	8221	0	8427
11678	7951	100	32	325	0	8408
11679	196	100	7873	193	0	8362
11680	7561	68	166	144	0	7939
11681	245	7680	73	111	0	8109
11682	124	247	45	7741	0	8157
11683	85	151	7585	258	0	8079
11684	7193	94	213	171	0	7671
11685	233	7592	105	100	0	8030
11686	132	239	69	7376	0	7816
11687	121	7570	50	229	0	7970
11688	83	275	40	7689	0	8087
11689	52	158	41	7893	0	8144
11690	53	88	7614	347	0	8102
11691	59	74	7332	213	0	7678
11692	79	86	243	7422	0	7830
11693	62	64	7502	292	0	7920
11694	72	77	234	7463	0	7846
11695	49	80	135	7350	0	7614
11696	34	45	97	7817	0	7993
11697	7474	39	121	386	0	8020
11698	227	44	107	7597	0	7975
11699	118	66	7480	345	0	8009
11700	7424	54	221	251	0	7950
11701	217	68	111	7731	0	8127
11702	118	56	71	7907	0	8152
11703	7589	31	82	427	0	8129
11704	237	7729	102	246	0	8314
11705	144	205	105	7913	0	8367
11706	86	105	88	7854	0	8133
11707	7570	76	82	386	0	8114
11708	232	64	7508	289	0	8093
11709	129	51	209	7626	0	8015
11710	114	57	121	7726	0	8018
11711	107	62	88	7544	0	7801
11712	78	7437	70	422	0	8007
11713	74	199	93	7711	0	8077
11714	7467	97	77	366	0	8007
11715	235	7420	55	291	0	8001
11716	7302	222	49	266	0	7839
11717	282	7465	36	207	0	7990
11718	7521	266	55	186	0	8028
11719	272	149	7365	191	0	7977
11720	168	111	7347	185	0	7811
11721	7397	84	256	169	0	7906
11722	276	105	7543	133	0	8057
11723	183	71	246	7466	0	7966
11724	140	99	142	6910	0	7291
11725	105	73	101	7796	0	8075
11726	7524	73	114	380	0	8091
11727	257	75	7413	231	0	7976
11728	7402	55	244	195	0	7896
11729	277	80	145	7833	0	8335
11730	7830	63	95	373	0	8361
11731	326	74	66	7957	0	8423
11732	8131	72	97	359	0	8659
11733	349	53	105	8747	0	9254
11734	202	52	9022	357	0	9633
11735	9035	53	298	225	0	9611
11736	9461	49	160	192	0	9862
11737	441	47	98	9396	0	9982
11738	232	46	94	9219	0	9591
11739	177	9279	99	460	0	10015
11740	9155	252	116	257	0	9780
11741	377	9262	117	192	0	9948
11742	9061	283	85	165	0	9594
11743	385	131	8924	197	0	9637
11744	224	78	8878	208	0	9388
11745	161	73	8680	209	0	9123
11746	8623	61	382	158	0	9224
11747	385	8793	195	123	0	9496
11748	228	266	146	8742	0	9382
11749	8659	120	107	325	0	9211
11750	365	8739	106	223	0	9433
11751	209	415	95	8340	0	9059
11752	145	8377	78	349	0	8949
11753	144	8103	64	201	0	8512
11754	130	8247	51	144	0	8572
11755	7226	341	105	124	0	7796
11756	275	7184	42	91	0	7592
11757	93	6102	36	64	0	6295
11758	52	6160	51	56	0	6319
11759	6093	197	45	44	0	6379
11760	6183	70	50	34	0	6337
11761	207	43	5918	42	0	6210
11762	5759	39	146	50	0	5994
11763	6024	34	48	42	0	6148
11764	182	36	33	5839	0	6090
11765	5905	33	21	168	0	6127
11766	191	39	5818	60	0	6108
11767	74	6153	146	35	0	6408
11768	6125	175	42	54	0	6396
11769	195	84	28	6268	0	6575
11770	6304	34	17	172	0	6527
11771	193	41	6026	56	0	6316
11772	6015	33	138	42	0	6228
11773	203	46	45	6120	0	6414
11774	91	25	6107	144	0	6367
11775	53	5821	155	64	0	6093
11776	57	6195	58	35	0	6345
11777	34	187	30	5983	0	6234
11778	80	63	23	5909	0	6075
11779	38	6042	11	163	0	6254
11780	6063	155	16	60	0	6294
11781	6062	50	17	35	0	6164
11782	6065	41	20	22	0	6148
11783	204	6066	9	29	0	6308
11784	90	133	14	5785	0	6022
11785	47	6116	19	116	0	6298
11786	6093	151	20	38	0	6302
11787	6032	54	20	28	0	6134
11788	194	5905	13	30	0	6142
11789	6019	149	13	28	0	6209
11790	170	54	19	5993	0	6236
11791	78	44	16	6052	0	6190
11792	6062	35	20	190	0	6307
11793	5987	25	16	79	0	6107
11794	6089	39	13	40	0	6181
11795	216	24	10	5914	0	6164
11796	100	25	16	6079	0	6220
11797	61	35	5892	185	0	6173
11798	61	38	133	5830	0	6062
11799	53	41	48	5884	0	6026
11800	54	39	5669	181	0	5943
11801	50	33	5432	82	0	5597
11802	51	22	5760	44	0	5877
11803	45	36	187	5626	0	5894
11804	51	32	5601	155	0	5839
11805	46	39	156	5510	0	5751
11806	47	42	63	5664	0	5816
11807	47	38	5581	198	0	5864
11808	53	42	5598	86	0	5779
11809	39	46	170	5516	0	5771
11810	39	44	5840	169	0	6092
11811	38	54	5798	76	0	5966
11812	46	5789	187	50	0	6072
11813	5958	156	76	37	0	6227
11814	6025	74	44	41	0	6184
11815	6038	53	35	39	0	6165
11816	212	5857	30	35	0	6134
11817	100	6005	37	42	0	6184
11818	87	181	33	5962	0	6263
11819	80	64	37	5960	0	6141
11820	61	48	5833	196	0	6138
11821	69	27	144	5807	0	6047
11822	5857	26	68	201	0	6152
11823	174	24	43	5580	0	5821
11824	84	5775	41	172	0	6072
11825	5977	154	36	79	0	6246
11826	6080	63	32	46	0	6221
11827	6123	40	31	49	0	6243
11828	234	34	5934	43	0	6245
11829	96	93	129	5912	0	6230
11830	6369	21	81	188	0	6659
11831	215	27	6610	76	0	6928
11832	73	6274	202	55	0	6604
11833	50	6049	49	36	0	6184
11834	5419	171	36	29	0	5655
11835	151	5446	27	30	0	5654
11836	57	154	24	5297	0	5532
11837	27	47	5330	150	0	5554
11838	39	29	141	5238	0	5447
11839	5225	28	49	152	0	5454
11840	138	5200	28	51	0	5417
11841	5208	133	25	29	0	5395
11842	148	43	5198	29	0	5418
11843	61	31	129	4951	0	5172
11844	29	5350	38	127	0	5544
11845	31	136	26	5441	0	5634
11846	5505	40	39	154	0	5738
11847	5608	27	17	58	0	5710
11848	5610	26	14	36	0	5686
11849	5653	17	19	37	0	5726
11850	181	15	24	5425	0	5645
11851	67	21	5563	146	0	5797
11852	53	16	123	5382	0	5574
11853	41	5534	45	131	0	5751
11854	5638	123	28	58	0	5847
11855	142	40	5580	34	0	5796
11856	5430	26	138	38	0	5632
11857	147	24	44	5599	0	5814
11858	56	23	5793	139	0	6011
11859	48	10	130	5698	0	5886
11860	5812	10	49	146	0	6017
11861	5880	12	23	63	0	5978
11862	5883	13	29	42	0	5967
11863	171	16	5781	39	0	6007
11864	82	22	119	5717	0	5940
11865	56	16	5925	130	0	6127
11866	44	5884	130	43	0	6101
11867	5574	136	48	33	0	5791
11868	133	5484	35	34	0	5686
11869	5344	110	22	21	0	5497
11870	115	29	18	5189	0	5351
11871	37	5281	13	110	0	5441
11872	5375	105	13	34	0	5527
11873	123	31	5384	22	0	5560
11874	45	20	103	5331	0	5499
11875	5434	10	26	121	0	5591
11876	121	14	5387	30	0	5552
11877	35	19	106	5211	0	5371
11878	42	5092	39	104	0	5277
11879	40	108	27	5387	0	5562
11880	44	35	17	5449	0	5545
11881	5337	35	13	126	0	5511
11882	125	5325	13	45	0	5508
11883	40	101	22	5201	0	5364
11884	37	5284	20	126	0	5467
11885	36	123	26	5250	0	5435
11886	36	5395	14	107	0	5552
11887	5342	118	17	33	0	5510
11888	134	36	5463	37	0	5670
11889	54	33	114	5370	0	5571
11890	33	24	36	5455	0	5548
11891	31	20	30	5502	0	5583
11892	31	22	27	5399	0	5479
11893	47	22	5303	162	0	5534
11894	49	5399	102	54	0	5604
11895	5435	108	25	44	0	5612
11896	5504	35	34	40	0	5613
11897	128	5455	19	42	0	5644
11898	5530	129	15	44	0	5718
11899	5548	30	26	41	0	5645
11900	147	5626	18	34	0	5825
11901	62	120	18	5525	0	5725
11902	55	5689	27	109	0	5880
11903	5659	112	21	55	0	5847
11904	128	43	5571	44	0	5786
11905	5195	26	111	61	0	5393
11906	129	23	5648	37	0	5837
11907	58	24	116	5575	0	5773
11908	5661	21	37	115	0	5834
11909	145	30	5537	42	0	5754
11910	5197	14	113	41	0	5365
11911	5440	20	39	52	0	5551
11912	156	22	26	5337	0	5541
11913	57	5434	30	108	0	5629
11914	5541	115	17	43	0	5716
11915	138	45	18	5496	0	5697
11916	60	5397	15	130	0	5602
11917	5437	112	22	45	0	5616
11918	138	34	21	5465	0	5658
11919	46	5618	30	115	0	5809
11920	41	111	26	5853	0	6031
11921	5896	26	25	137	0	6084
11922	5874	29	27	59	0	5989
11923	5889	27	12	37	0	5965
11924	142	22	26	5702	0	5892
11925	68	29	15	5727	0	5839
11926	45	23	5728	133	0	5929
11927	45	39	104	5688	0	5876
11928	39	28	5985	140	0	6192
11929	40	17	5406	49	0	5512
11930	13	3	5022	20	0	5058
11931	14	5239	57	19	0	5329
11932	29	49	74	5038	0	5190
11933	7	5664	9	38	0	5718
11934	5846	63	10	23	0	5942
11935	5863	28	13	17	0	5921
11936	94	9	6	6032	0	6141
11937	36	7	6230	79	0	6352
11938	15	3	80	6197	0	6295
11939	11	7	6378	91	0	6487
11940	15	2	82	6191	0	6290
11941	11	6256	34	85	0	6386
11942	6	6499	11	43	0	6559
11943	6379	116	8	16	0	6519
11944	104	42	6385	12	0	6543
11945	47	18	89	6314	0	6468
11946	22	10	32	6422	0	6486
11947	6403	9	13	120	0	6545
11948	87	6447	11	57	0	6602
11949	6461	87	11	34	0	6593
11950	88	6585	14	22	0	6709
11951	6466	97	10	19	0	6592
11952	6583	37	9	22	0	6651
11953	128	18	11	6570	0	6727
11954	46	20	6579	100	0	6745
11955	6267	9	99	51	0	6426
11956	97	6603	44	28	0	6772
11957	6733	101	23	19	0	6876
11958	107	45	8	6489	0	6649
11959	54	17	11	6416	0	6498
11960	24	6453	12	117	0	6606
11961	31	94	7	6342	0	6474
11962	22	6434	15	96	0	6567
11963	23	101	11	6427	0	6562
11964	25	39	19	6382	0	6465
11965	6154	15	7	139	0	6315
11966	100	20	6119	51	0	6290
11967	56	6050	88	30	0	6224
11968	32	100	37	6198	0	6367
11969	6273	38	23	118	0	6452
11970	6406	23	18	55	0	6502
11971	6279	13	16	47	0	6355
11972	170	20	6214	30	0	6434
11973	6226	22	115	42	0	6405
11974	133	20	48	6324	0	6525
11975	6264	26	19	124	0	6433
11976	124	6155	17	64	0	6360
11977	68	128	16	6262	0	6474
11978	6191	43	18	142	0	6394
11979	134	6343	22	60	0	6559
11980	67	129	15	6432	0	6643
11981	41	58	6271	138	0	6508
11982	6489	32	128	73	0	6722
11983	6905	29	45	33	0	7012
11984	216	18	6721	42	0	6997
11985	88	6495	138	36	0	6757
11986	48	6873	61	38	0	7020
11987	56	177	55	6815	0	7103
11988	54	70	34	6528	0	6686
11989	36	34	28	6872	0	6970
11990	40	30	6812	221	0	7103
11991	6692	40	160	98	0	6990
11992	7200	38	52	61	0	7351
11993	7429	29	39	62	0	7559
11994	7466	38	35	46	0	7585
11995	7485	35	20	66	0	7606
11996	7619	32	35	44	0	7730
11997	273	37	34	7839	0	8183
11998	116	38	7672	226	0	8052
11999	73	40	7862	116	0	8091
12000	72	33	247	7788	0	8140
12001	80	38	84	7792	0	7994
12002	82	43	46	7744	0	7915
12003	72	7823	42	278	0	8215
12004	7938	218	32	114	0	8302
12005	265	8151	35	84	0	8535
12006	131	247	26	8077	0	8481
12007	7978	93	31	272	0	8374
12008	286	8016	37	114	0	8453
12009	111	255	29	8081	0	8476
12010	97	94	27	8278	0	8496
12011	68	78	29	8274	0	8449
12012	66	8009	18	376	0	8469
12013	62	272	27	8169	0	8530
12014	80	88	8068	340	0	8576
12015	67	77	265	8219	0	8628
12016	85	44	87	8451	0	8667
12017	64	67	42	8977	0	9150
12018	76	44	28	9205	0	9353
12019	78	51	8815	452	0	9396
12020	80	8769	302	226	0	9377
12021	61	341	106	8983	0	9491
12022	65	108	65	9372	0	9610
12023	63	67	59	9154	0	9343
12024	88	8589	60	490	0	9227
12025	72	9296	50	243	0	9661
12026	9026	410	41	184	0	9661
12027	358	142	32	8903	0	9435
12028	139	116	8583	415	0	9253
12029	88	8659	296	208	0	9251
12030	8470	334	117	152	0	9073
12031	342	118	8254	137	0	8851
12032	146	82	8257	142	0	8627
12033	85	73	8143	121	0	8422
12034	73	114	396	7738	0	8321
12035	64	69	7857	343	0	8333
12036	58	7466	352	168	0	8044
12037	49	297	167	7281	0	7794
12038	44	100	7388	343	0	7875
12039	39	81	327	7217	0	7664
12040	7096	84	149	369	0	7698
12041	271	77	7168	192	0	7708
12042	6958	48	312	183	0	7501
12043	302	7313	142	154	0	7911
12044	7321	306	107	119	0	7853
12045	358	124	97	7293	0	7872
12046	7357	88	82	329	0	7856
12047	7431	77	91	157	0	7756
12048	7211	76	73	153	0	7513
12049	394	7289	90	123	0	7896
12050	7349	290	81	119	0	7839
12051	7514	98	96	112	0	7820
12052	421	93	7219	87	0	7820
12053	197	7179	315	97	0	7788
12054	164	304	131	7171	0	7770
12055	134	135	107	7427	0	7803
12056	139	88	86	7496	0	7809
12057	104	90	7130	423	0	7747
12058	114	80	312	7205	0	7711
12059	95	71	7158	430	0	7754
12060	7071	55	347	229	0	7702
12061	7451	68	152	181	0	7852
12062	411	60	7295	144	0	7910
12063	7285	65	335	146	0	7831
12064	7596	67	156	139	0	7958
12065	7748	58	112	120	0	8038
12066	494	48	104	7400	0	8046
12067	267	59	7483	355	0	8164
12068	215	7501	319	158	0	8193
12069	202	304	131	7475	0	8112
12070	163	113	7558	369	0	8203
12071	131	105	7232	198	0	7666
12072	7073	92	346	175	0	7686
12073	306	7607	191	142	0	8246
12074	7725	295	140	170	0	8330
12075	7872	114	123	168	0	8277
12076	380	7753	130	154	0	8417
12077	7767	293	123	138	0	8321
12078	393	138	7932	122	0	8585
12079	234	100	7785	105	0	8224
12080	223	75	7814	107	0	8219
12081	181	7596	359	81	0	8217
12082	7435	252	225	83	0	7995
12083	7509	102	156	93	0	7860
12084	352	7120	151	81	0	7704
12085	214	7545	112	103	0	7974
12086	174	287	110	7373	0	7944
12087	137	164	110	7538	0	7949
12088	7457	121	93	336	0	8007
12089	275	7497	107	173	0	8052
12090	7464	271	95	135	0	7965
12091	7346	136	89	124	0	7695
12092	349	101	7179	98	0	7727
12093	233	6992	203	89	0	7517
12094	216	262	119	6975	0	7572
12095	6983	130	95	208	0	7416
12096	332	78	88	6806	0	7304
12097	6555	77	106	191	0	6929
12098	266	75	6356	108	0	6805
12099	184	6114	209	84	0	6591
12100	132	6372	128	71	0	6703
12101	147	210	93	6098	0	6548
12102	138	6404	78	159	0	6779
12103	6448	205	74	93	0	6820
12104	215	125	6244	86	0	6670
12105	5944	106	162	92	0	6304
12106	192	89	6397	86	0	6764
12107	138	85	156	6294	0	6673
12108	138	79	99	6341	0	6657
12109	156	54	85	6478	0	6773
12110	6480	61	82	185	0	6808
12111	233	72	6451	98	0	6854
12112	150	40	155	6415	0	6760
12113	127	68	88	6450	0	6733
12114	107	6228	67	201	0	6603
12115	115	6168	45	138	0	6466
12116	104	6365	72	100	0	6641
12117	76	161	32	5983	0	6252
12118	77	99	37	5629	0	5842
12119	27	5405	13	49	0	5494
12120	20	5445	20	36	0	5521
12121	5413	38	23	33	0	5507
12122	41	24	11	5442	0	5518
12123	22	5390	7	30	0	5449
12124	5538	34	6	16	0	5594
12125	39	13	2	5656	0	5710
12126	6207	3	14	32	0	6256
12127	62	9	5	6315	0	6391
12128	22	8	6452	53	0	6535
12129	17	6400	48	29	0	6494
12130	6281	47	18	30	0	6376
12131	60	20	6477	16	0	6573
12132	26	6458	45	17	0	6546
12133	24	46	22	6536	0	6628
12134	7	22	5	6623	0	6657
12135	11	11	1	6401	0	6424
12136	14	7	8	6213	0	6242
12137	7	8	6539	54	0	6608
12138	8	6438	37	24	0	6507
12139	10	41	12	6518	0	6581
12140	6393	15	8	48	0	6464
12141	36	6472	16	21	0	6545
12142	12	43	6	6842	0	6903
12143	19	19	6702	59	0	6799
12144	6	6713	57	23	0	6799
12145	30	58	26	6232	0	6346
12146	7	6981	14	38	0	7040
12147	7058	80	6	21	0	7165
12148	7062	27	2	16	0	7107
12149	95	21	6814	17	0	6947
12150	6643	10	68	19	0	6740
12151	6920	11	25	12	0	6968
12152	97	7	6712	11	0	6827
12153	46	6797	75	14	0	6932
12154	34	77	26	6775	0	6912
12155	15	23	19	7089	0	7146
12156	7022	16	11	107	0	7156
12157	69	17	12	7004	0	7102
12158	34	6	7025	92	0	7157
12159	6612	14	72	40	0	6738
12160	94	7	6822	22	0	6945
12161	41	6871	79	19	0	7010
12162	6701	73	34	16	0	6824
12163	91	36	6796	13	0	6936
12164	49	20	6484	7	0	6560
12165	27	6674	94	9	0	6804
12166	13	83	41	6852	0	6989
12167	17	34	6695	79	0	6825
12168	27	23	97	5773	0	5920
12169	19	14	32	6559	0	6624
12170	19	9	6478	109	0	6615
12171	10	6406	93	55	0	6564
12172	16	77	37	6468	0	6598
12173	6272	33	32	84	0	6421
12174	6210	28	18	48	0	6304
12175	108	18	14	6227	0	6367
12176	48	9	6190	92	0	6339
12177	35	11	6282	38	0	6366
12178	18	16	114	6174	0	6322
12179	14	16	6198	97	0	6325
12180	5933	18	110	51	0	6112
12181	106	11	36	6281	0	6434
12182	44	3	28	6328	0	6403
12183	31	6333	28	128	0	6520
12184	21	96	17	6500	0	6634
12185	15	37	6257	122	0	6431
12186	5853	29	98	62	0	6042
12187	6229	18	35	40	0	6322
12188	131	8	6280	36	0	6455
12189	59	11	114	6584	0	6768
12190	43	12	42	6827	0	6924
12191	20	11	6820	190	0	7041
12192	21	8	154	6816	0	6999
12193	39	14	59	6816	0	6928
12194	25	7181	43	196	0	7445
12195	24	150	24	7407	0	7605
12196	28	46	19	7624	0	7717
12197	7648	39	23	243	0	7953
12198	7860	20	27	104	0	8011
12199	8026	15	21	72	0	8134
12200	7946	7	20	52	0	8025
12201	7902	9	26	37	0	7974
12202	270	19	7506	39	0	7834
12203	102	15	185	7480	0	7782
12204	66	13	64	7761	0	7904
12205	48	18	7599	253	0	7918
12206	7179	5	193	120	0	7497
12207	7510	20	71	68	0	7669
12208	249	18	6918	55	0	7240
12209	7309	14	161	62	0	7546
12210	7609	14	68	39	0	7730
12211	266	14	7411	30	0	7721
12212	128	16	195	7205	0	7544
12213	90	7578	78	191	0	7937
12214	69	190	49	8051	0	8359
12215	57	53	38	8129	0	8277
12216	41	41	37	8088	0	8207
12217	37	25	7873	308	0	8243
12218	7592	10	213	132	0	7947
12219	8001	12	69	82	0	8164
12220	281	8	55	7854	0	8198
12221	113	8	7712	233	0	8066
12222	89	27	212	7650	0	7978
12223	59	13	7797	276	0	8145
12224	38	10	7924	107	0	8079
12225	36	7885	271	87	0	8279
12226	38	183	88	7456	0	7765
12227	7379	43	68	223	0	7713
12228	7189	33	36	85	0	7343
12229	7344	16	35	75	0	7470
12230	277	14	36	7172	0	7499
12231	117	7641	20	219	0	7997
12232	81	204	30	7852	0	8167
12233	52	57	8147	274	0	8530
12234	8620	45	252	102	0	9019
12235	9553	26	65	86	0	9730
12236	357	17	61	9424	0	9859
12237	131	15	44	9632	0	9822
12238	94	21	31	9777	0	9923
12239	69	15	9323	418	0	9825
12240	8425	12	284	206	0	8927
12241	338	8997	94	114	0	9543
12242	98	9071	61	77	0	9307
12243	93	288	9031	59	0	9471
12244	74	113	288	8805	0	9280
12245	51	56	8958	304	0	9369
12246	8537	30	302	111	0	8980
12247	304	28	91	8738	0	9161
12248	114	27	8727	296	0	9164
12249	98	8903	280	113	0	9394
12250	8918	255	82	104	0	9359
12251	317	69	9132	72	0	9590
12252	122	8816	289	73	0	9300
12253	86	9314	99	70	0	9569
12254	9206	315	83	73	0	9677
12255	323	113	49	9178	0	9663
12256	116	66	9409	317	0	9908
12257	92	9411	309	110	0	9922
12258	9386	288	95	97	0	9866
12259	9609	90	70	78	0	9847
12260	362	9445	71	58	0	9936
12261	139	301	9582	86	0	10108
12262	99	97	301	9632	0	10129
12263	9673	80	121	317	0	10191
12264	9807	48	86	139	0	10080
12265	392	34	9562	102	0	10090
12266	161	53	321	9388	0	9923
12267	135	45	102	9821	0	10103
12268	114	32	9627	378	0	10151
12269	73	48	9522	153	0	9796
12270	9539	52	378	114	0	10083
12271	9940	44	155	89	0	10228
12272	10073	50	89	92	0	10304
12273	10113	36	112	74	0	10335
12274	454	53	9607	76	0	10190
12275	9724	45	308	92	0	10169
12276	447	20	117	9643	0	10227
12277	191	44	9819	351	0	10405
12278	155	46	9867	157	0	10225
12279	115	9764	371	144	0	10394
12280	114	284	145	9674	0	10217
12281	98	102	9851	303	0	10354
12282	9431	96	353	136	0	10016
12283	363	86	148	8645	0	9242
12284	174	9752	100	261	0	10287
12285	9908	293	114	137	0	10452
12286	10056	87	133	126	0	10402
12287	401	81	9839	104	0	10425
12288	228	9625	317	87	0	10257
12289	152	264	132	9378	0	9926
12290	9374	112	118	273	0	9877
12291	329	106	101	9233	0	9769
12292	165	80	9028	303	0	9576
12293	8044	52	268	131	0	8495
12294	281	8568	121	93	0	9063
12295	130	8213	101	75	0	8519
12296	120	8813	81	73	0	9087
12297	8657	264	121	98	0	9140
12298	8627	110	97	63	0	8897
12299	8733	79	86	38	0	8936
12300	347	60	38	8507	0	8952
12301	172	46	8529	221	0	8968
12302	137	71	232	8553	0	8993
12303	8654	38	127	257	0	9076
12304	281	50	83	8746	0	9160
12305	8891	45	64	269	0	9269
12306	8937	33	68	130	0	9168
12307	8710	32	97	92	0	8931
12308	286	8721	83	94	0	9184
12309	8769	214	71	92	0	9146
12310	305	70	8634	56	0	9065
12311	168	54	8654	45	0	8921
12312	134	8417	261	40	0	8852
12313	160	196	117	8064	0	8537
12314	8086	82	66	210	0	8444
12315	303	53	7938	66	0	8360
12316	7784	39	225	65	0	8113
12317	269	30	110	7747	0	8156
12318	136	7954	88	216	0	8394
12319	89	199	93	8198	0	8579
12320	99	76	8148	224	0	8547
12321	7616	63	226	119	0	8024
12322	247	57	8206	88	0	8598
12323	154	28	7951	57	0	8190
12324	7565	39	228	55	0	7887
12325	234	7674	95	56	0	8059
12326	7904	203	68	43	0	8218
12327	8047	68	68	58	0	8241
12328	297	53	7741	45	0	8136
12329	7544	46	223	59	0	7872
12330	243	50	7644	56	0	7993
12331	123	27	7073	71	0	7294
12332	110	23	7081	60	0	7274
12333	83	6703	186	47	0	7019
12334	5880	115	216	49	0	6260
12335	5728	51	40	23	0	5842
12336	5688	11	23	19	0	5741
12337	5693	14	24	16	0	5747
12338	103	13	5635	21	0	5772
12339	52	11	76	5560	0	5699
12340	30	9	47	5623	0	5709
12341	5712	10	16	90	0	5828
12342	80	5655	17	41	0	5793
12343	48	56	21	5618	0	5743
12344	5591	23	19	62	0	5695
12345	77	15	5657	30	0	5779
12346	53	16	68	5497	0	5634
12347	35	13	5672	72	0	5792
12348	35	5553	66	44	0	5698
12349	45	67	37	5292	0	5441
12350	5272	33	19	59	0	5383
12351	76	14	23	5311	0	5424
12352	48	12	5298	58	0	5416
12353	23	5270	67	35	0	5395
12354	5177	56	33	18	0	5284
12355	69	33	5205	12	0	5319
12356	4952	7	61	20	0	5040
12357	67	5180	28	13	0	5288
12358	5238	57	28	27	0	5350
12359	5297	28	12	18	0	5355
12360	90	10	6	5305	0	5411
12361	45	8	5300	63	0	5416
12362	13	5314	62	34	0	5423
12363	22	70	28	5589	0	5709
12364	24	27	14	5671	0	5736
12365	23	8	17	6100	0	6148
12366	22	9	16	6386	0	6433
12367	14	7218	21	153	0	7406
12368	7622	132	12	65	0	7831
12369	152	7659	17	29	0	7857
12370	63	160	19	8057	0	8299
12371	8123	65	9	183	0	8380
12372	199	29	13	8145	0	8386
12373	91	14	8052	208	0	8365
12374	41	8031	179	100	0	8351
12375	43	178	77	8101	0	8399
12376	34	84	34	8377	0	8529
12377	7887	44	21	273	0	8225
12378	204	31	7785	132	0	8152
12379	7699	22	175	99	0	7995
12380	7896	27	74	73	0	8070
12381	7950	32	39	55	0	8076
12382	284	42	7694	49	0	8069
12383	132	38	190	7610	0	7970
12384	79	39	76	7719	0	7913
12385	74	25	7659	298	0	8056
12386	64	29	7707	133	0	7933
12387	7750	32	268	85	0	8135
12388	235	25	117	7914	0	8291
12389	8050	27	58	265	0	8400
12390	8290	16	47	143	0	8496
12391	321	36	54	8170	0	8581
12392	160	21	8561	265	0	9007
12393	8321	15	250	149	0	8735
12394	310	22	105	8753	0	9190
12395	164	13	8732	274	0	9183
12396	118	8588	261	133	0	9100
12397	8513	223	120	105	0	8961
12398	290	8632	81	91	0	9094
12399	184	254	58	7834	0	8330
12400	118	8718	64	249	0	9149
12401	8447	261	68	150	0	8926
12402	8680	108	63	117	0	8968
12403	360	8546	57	112	0	9075
12404	8576	245	59	104	0	8984
12405	8501	116	71	109	0	8797
12406	379	8295	57	93	0	8824
12407	8447	249	46	92	0	8834
12408	350	110	57	8273	0	8790
12409	203	86	67	8466	0	8822
12410	8372	54	67	343	0	8836
12411	356	62	51	7826	0	8295
12412	210	8135	56	266	0	8667
12413	8099	263	58	160	0	8580
12414	8175	134	53	127	0	8489
12415	370	8177	49	98	0	8694
12416	8285	271	55	82	0	8693
12417	8425	137	61	88	0	8711
12418	429	86	50	8081	0	8646
12419	250	72	7969	280	0	8571
12420	200	7978	238	152	0	8568
12421	8141	272	107	132	0	8652
12422	8240	124	54	122	0	8540
12423	417	93	7882	100	0	8492
12424	8042	67	254	115	0	8478
12425	387	90	7785	97	0	8359
12426	7874	89	267	115	0	8345
12427	399	78	120	7843	0	8440
12428	230	96	7785	284	0	8395
12429	179	102	7884	154	0	8319
12430	166	109	308	7713	0	8296
12431	173	94	121	7803	0	8191
12432	182	74	7522	352	0	8130
12433	171	89	278	7507	0	8045
12434	180	95	7640	313	0	8228
12435	200	84	284	7563	0	8131
12436	194	76	141	7537	0	7948
12437	199	7272	93	340	0	7904
12438	155	7301	101	180	0	7737
12439	162	7685	93	155	0	8095
12440	167	326	87	7558	0	8138
12441	153	137	83	7807	0	8180
12442	133	91	7471	403	0	8098
12443	7253	71	291	217	0	7832
12444	7618	69	144	175	0	8006
12445	404	7341	99	159	0	8003
12446	7493	250	97	142	0	7982
12447	368	135	102	7381	0	7986
12448	7536	84	99	323	0	8042
12449	7697	69	88	204	0	8058
12450	399	82	84	7468	0	8033
12451	7162	87	104	310	0	7663
12452	344	7007	92	171	0	7614
12453	219	7260	75	137	0	7691
12454	175	312	76	6801	0	7364
12455	163	7244	94	260	0	7761
12456	164	290	77	7042	0	7573
12457	171	125	68	7234	0	7598
12458	7011	98	67	346	0	7522
12459	340	6874	78	188	0	7480
12460	6790	256	79	152	0	7277
12461	6700	128	82	128	0	7038
12462	354	6724	58	115	0	7251
12463	6595	251	55	143	0	7044
12464	318	123	6339	122	0	6902
12465	144	6024	216	107	0	6491
12466	5670	198	89	99	0	6056
12467	219	73	4891	80	0	5263
12468	95	4319	137	60	0	4611
12469	76	4483	102	54	0	4715
12470	4078	136	62	28	0	4304
12471	4047	61	15	29	0	4152
12472	4091	28	14	29	0	4162
12473	144	3982	15	33	0	4174
12474	76	97	14	4064	0	4251
12475	4074	53	19	109	0	4255
12476	4105	34	19	60	0	4218
12477	155	22	14	4031	0	4222
12478	74	29	4000	102	0	4205
12479	54	31	3983	48	0	4116
12480	53	27	113	4010	0	4203
12481	56	18	54	4075	0	4203
12482	44	22	4064	125	0	4255
12483	44	30	103	3884	0	4061
12484	41	4004	50	103	0	4198
12485	3957	87	37	56	0	4137
12486	124	43	26	3898	0	4091
12487	3750	26	26	90	0	3892
12488	93	3728	25	64	0	3910
12489	59	3862	19	30	0	3970
12490	3741	72	21	34	0	3868
12491	81	27	3674	33	0	3815
12492	3055	41	68	20	0	3184
12493	54	3196	33	20	0	3303
12494	19	36	15	2941	0	3011
12495	2911	10	13	50	0	2984
12496	34	5	17	2894	0	2950
12497	2969	7	4	46	0	3026
12498	2889	15	6	28	0	2938
12499	45	3019	7	19	0	3090
12500	2976	29	3	16	0	3024
12501	33	2954	5	10	0	3002
12502	2989	35	2	7	0	3033
12503	37	14	3	2978	0	3032
12504	3027	9	3	34	0	3073
12505	40	5	6	3095	0	3146
12506	3253	9	1	38	0	3301
12507	3303	10	0	24	0	3337
12508	3330	2	0	17	0	3349
12509	3341	1	4	14	0	3360
12510	3345	4	1	14	0	3364
12511	57	4	0	3382	0	3443
12512	3336	8	2	35	0	3381
12513	39	3279	3	10	0	3331
12514	21	31	3302	3	0	3357
12515	14	16	22	3267	0	3319
12516	12	2	3385	37	0	3436
12517	10	2	29	3452	0	3493
12518	13	6	3535	41	0	3595
12519	3404	4	30	22	0	3460
12520	46	3	8	3539	0	3596
12521	21	2	3528	25	0	3576
12522	16	3	3572	12	0	3603
12523	15	3	37	3642	0	3697
12524	4109	3	14	40	0	4166
12525	43	4312	5	23	0	4383
12526	4350	51	6	15	0	4422
12527	4363	21	7	5	0	4396
12528	69	4308	9	11	0	4397
12529	4541	49	3	21	0	4614
12530	60	21	7	4546	0	4634
12531	24	7	4	4575	0	4610
12532	15	3	6	4616	0	4640
12533	4596	8	0	75	0	4679
12534	52	4549	5	28	0	4634
12535	22	57	7	4651	0	4737
12536	8	21	9	4719	0	4757
12537	4673	5	1	89	0	4768
12538	72	4	2	4640	0	4718
12539	21	19	4764	68	0	4872
12540	16	4953	70	37	0	5076
12541	5063	82	23	18	0	5186
12542	104	32	5	4900	0	5041
12543	37	5147	5	73	0	5262
12544	5149	87	8	35	0	5279
12545	95	31	5064	24	0	5214
12546	38	5113	83	17	0	5251
12547	5203	90	31	12	0	5336
12548	93	41	10	5129	0	5273
12549	35	14	6	5196	0	5251
12550	17	6	5135	122	0	5280
12551	20	8	83	5049	0	5160
12552	18	5	5576	106	0	5705
12553	10	4	5235	51	0	5300
12554	8	9	5618	26	0	5661
12555	5602	9	118	19	0	5748
12556	5720	5	35	21	0	5781
12557	5896	10	21	12	0	5939
12558	129	9	14	5727	0	5879
12559	50	5745	11	76	0	5882
12560	28	5965	6	33	0	6032
12561	6046	114	5	17	0	6182
12562	6048	44	4	23	0	6119
12563	103	6039	7	16	0	6165
12564	5980	81	9	14	0	6084
12565	99	32	5831	5	0	5967
12566	37	15	5814	14	0	5880
12567	19	8	108	5494	0	5629
12568	9	10	47	5995	0	6061
12569	13	3	5963	108	0	6087
12570	16	6	85	5786	0	5893
12571	5904	4	34	95	0	6037
12572	89	6	5856	34	0	5985
12573	5732	8	84	26	0	5850
12574	98	10	32	5964	0	6104
12575	45	5	6215	86	0	6351
12576	29	6321	87	35	0	6472
12577	6388	85	37	25	0	6535
12578	95	32	6284	10	0	6421
12579	6169	16	89	16	0	6290
12580	105	7	41	6263	0	6416
12581	6287	9	21	92	0	6409
12582	109	8	6569	35	0	6721
12583	45	9	93	6607	0	6754
12584	6877	6	37	96	0	7016
12585	7030	7	18	51	0	7106
12586	7262	4	11	23	0	7300
12587	7361	12	17	19	0	7409
12588	158	5	12	7072	0	7247
12589	57	8	10	7102	0	7177
12590	33	15	7110	134	0	7292
12591	37	12	104	7041	0	7194
12592	45	8	46	6832	0	6931
12593	18	7291	25	137	0	7471
12594	7359	113	13	60	0	7545
12595	7583	33	12	33	0	7661
12596	155	7780	13	26	0	7974
12597	56	138	18	7832	0	8044
12598	36	38	10	7984	0	8068
12599	7700	19	16	185	0	7920
12600	171	11	8030	66	0	8278
12601	67	9	145	8115	0	8336
12602	44	15	8234	168	0	8461
12603	7934	10	164	71	0	8179
12604	8361	7	53	43	0	8464
12605	8415	10	31	35	0	8491
12606	222	11	20	8140	0	8393
12607	82	11	12	8168	0	8273
12608	8139	17	19	208	0	8383
12609	199	15	8044	66	0	8324
12610	67	19	144	8055	0	8285
12611	8068	18	41	184	0	8311
12612	180	15	34	8102	0	8331
12613	62	11	8496	195	0	8764
12614	49	19	8174	67	0	8309
12615	8070	11	182	59	0	8322
12616	172	8431	70	40	0	8713
12617	8595	143	42	50	0	8830
12618	8758	33	34	35	0	8860
12619	208	13	24	8671	0	8916
12620	85	18	25	8630	0	8758
12621	61	8535	21	189	0	8806
12622	8503	146	20	70	0	8739
12623	178	8557	14	55	0	8804
12624	60	8428	20	32	0	8540
12625	49	137	13	8200	0	8399
12626	8210	37	12	146	0	8405
12627	8344	22	21	57	0	8444
12628	166	12	15	8207	0	8400
12629	71	7	20	8086	0	8184
12630	45	13	19	8117	0	8194
12631	7989	7	20	182	0	8198
12632	148	17	7969	64	0	8198
12633	65	7961	127	43	0	8196
12634	7930	116	29	38	0	8113
12635	156	29	21	7880	0	8086
12636	55	19	7905	143	0	8122
12637	50	15	7696	55	0	7816
12638	41	7789	131	48	0	8009
12639	41	7981	42	28	0	8092
12640	59	133	28	7625	0	7845
12641	29	6826	30	111	0	6996
12642	42	108	6	7421	0	7577
12643	29	21	13	7633	0	7696
12644	7648	18	16	131	0	7813
12645	115	15	11	7640	0	7781
12646	35	11	7	7755	0	7808
12647	40	10	7616	123	0	7789
12648	26	8	105	7668	0	7807
12649	7722	7	26	129	0	7884
12650	7802	17	27	39	0	7885
12651	124	7972	19	46	0	8161
12652	7727	116	17	33	0	7893
12653	153	37	7689	31	0	7910
12654	50	7687	127	39	0	7903
12655	36	137	36	7772	0	7981
12656	37	35	25	8019	0	8116
12657	24	36	21	8066	0	8147
12658	7947	24	17	193	0	8181
12659	7515	20	27	81	0	7643
12660	166	27	7683	49	0	7925
12661	75	12	7503	54	0	7644
12662	55	20	7620	46	0	7741
12663	40	7632	163	42	0	7877
12664	39	7907	51	55	0	8052
12665	7883	158	25	43	0	8109
12666	7945	46	19	46	0	8056
12667	180	31	19	7993	0	8223
12668	85	16	24	7837	0	7962
12669	34	7939	31	188	0	8192
12670	40	143	18	8112	0	8313
12671	36	54	8011	160	0	8261
12672	30	8030	148	76	0	8284
12673	34	144	50	8111	0	8339
12674	44	43	8296	153	0	8536
12675	42	42	138	7664	0	7886
12676	27	7888	48	156	0	8119
12677	8153	146	25	75	0	8399
12678	8206	53	31	37	0	8327
12679	8447	34	14	71	0	8566
12680	198	35	24	8387	0	8644
12681	90	34	16	8636	0	8776
12682	8412	24	16	241	0	8693
12683	185	8420	25	81	0	8711
12684	8554	174	19	71	0	8818
12685	196	68	8870	37	0	9171
12686	8829	22	185	36	0	9072
12687	9192	20	68	40	0	9320
12688	268	29	23	9019	0	9339
12689	9201	16	21	216	0	9454
12690	9465	14	18	103	0	9600
12691	288	21	23	9337	0	9669
12692	109	22	9186	217	0	9534
12693	8610	20	189	115	0	8934
12694	220	17	9345	43	0	9625
12695	93	9473	196	36	0	9798
12696	65	167	73	9461	0	9766
12697	30	65	30	9832	0	9957
12698	10532	26	18	258	0	10834
12699	255	21	10672	97	0	11045
12700	95	13	242	10010	0	10360
12701	38	10374	91	230	0	10733
12702	41	10528	38	82	0	10689
12703	44	291	24	10570	0	10929
12704	41	102	10479	260	0	10882
12705	34	40	242	10406	0	10722
12706	44	20	82	10454	0	10600
12707	42	24	10124	327	0	10517
12708	22	10343	239	121	0	10725
12709	10012	252	76	69	0	10409
12710	241	10419	35	49	0	10744
12711	94	261	36	10357	0	10748
12712	9852	92	39	281	0	10264
12713	229	9852	37	119	0	10237
12714	88	251	9785	62	0	10186
12715	9450	96	238	56	0	9840
12716	240	10038	88	53	0	10419
12717	10029	257	38	48	0	10372
12718	306	89	9657	36	0	10088
12719	9660	39	246	45	0	9990
12720	279	45	90	9756	0	10170
12721	114	30	9718	276	0	10138
12722	70	41	254	9299	0	9664
12723	53	9432	94	258	0	9837
12724	64	249	46	9631	0	9990
12725	45	98	33	9770	0	9946
12726	53	43	9397	342	0	9835
12727	62	37	264	9428	0	9791
12728	67	74	7984	315	0	8440
12729	57	9407	195	129	0	9788
12730	62	258	86	9434	0	9840
12731	63	96	9501	288	0	9948
12732	47	9297	270	136	0	9750
12733	56	9851	103	85	0	10095
12734	66	324	9687	59	0	10136
12735	63	126	9731	56	0	9976
12736	59	71	343	9508	0	9981
12737	9472	35	123	306	0	9936
12738	296	9498	57	139	0	9990
12739	144	281	43	9313	0	9781
12740	9336	95	51	303	0	9785
12741	301	9532	43	131	0	10007
12742	9409	291	53	85	0	9838
12743	307	9668	53	82	0	10110
12744	9720	307	58	80	0	10165
12745	9734	112	41	84	0	9971
12746	9903	65	46	78	0	10092
12747	411	10207	57	75	0	10750
12748	174	312	42	10272	0	10800
12749	111	117	10082	350	0	10660
12750	101	10052	307	154	0	10614
12751	120	339	118	9721	0	10298
12752	107	118	73	9908	0	10206
12753	84	91	9496	373	0	10044
12754	88	9272	279	175	0	9814
12755	9172	277	126	98	0	9673
12756	302	9220	75	99	0	9696
12757	139	309	56	9127	0	9631
12758	102	110	9151	339	0	9702
12759	8780	78	299	153	0	9310
12760	320	75	124	9218	0	9737
12761	123	58	9107	329	0	9617
12762	8583	62	303	168	0	9116
12763	290	8941	104	120	0	9455
12764	8931	302	108	99	0	9440
12765	9119	135	55	99	0	9408
12766	352	97	52	8942	0	9443
12767	136	69	8833	331	0	9369
12768	109	8761	289	147	0	9306
12769	57	323	8800	91	0	9271
12770	75	135	314	8520	0	9044
12771	74	102	124	8987	0	9287
12772	8709	84	81	385	0	9259
12773	280	69	8610	195	0	9154
12774	123	8431	312	98	0	8964
12775	95	297	123	8425	0	8940
12776	70	138	76	8740	0	9024
12777	8268	83	68	375	0	8794
12778	306	8411	48	165	0	8930
12779	133	281	64	8170	0	8648
12780	7715	143	53	302	0	8213
12781	251	7927	43	154	0	8375
12782	7698	262	36	101	0	8097
12783	7738	107	53	57	0	7955
12784	311	7488	62	66	0	7927
12785	6675	224	41	45	0	6985
12786	255	6790	23	56	0	7124
12787	6725	245	44	52	0	7066
12788	6762	61	43	44	0	6910
12789	270	6678	23	57	0	7028
12790	6373	224	28	35	0	6660
12791	6589	68	26	41	0	6724
12792	6602	67	18	54	0	6741
12793	290	39	6349	32	0	6710
12794	110	43	5974	46	0	6173
12795	66	41	5958	34	0	6099
12796	5803	41	276	28	0	6148
12797	213	40	5615	40	0	5908
12798	75	25	4849	22	0	4971
12799	57	50	149	4299	0	4555
12800	4394	19	64	120	0	4597
12801	142	18	4410	37	0	4607
12802	62	36	4628	50	0	4776
12803	61	20	152	4538	0	4771
12804	42	21	71	4664	0	4798
12805	43	24	50	4766	0	4883
12806	55	21	4626	172	0	4874
12807	39	22	140	4648	0	4849
12808	4593	25	60	156	0	4834
12809	145	4642	42	62	0	4891
12810	59	133	26	4659	0	4877
12811	66	43	28	4813	0	4950
12812	32	47	4728	160	0	4967
12813	35	4643	128	80	0	4886
12814	4669	132	39	56	0	4896
12815	146	4745	44	44	0	4979
12816	66	153	37	4758	0	5014
12817	48	59	4760	161	0	5028
12818	43	46	150	5080	0	5319
12819	49	28	69	5216	0	5362
12820	5258	25	57	199	0	5539
12821	168	27	43	5112	0	5350
12822	68	5109	41	200	0	5418
12823	61	5579	45	68	0	5753
12824	44	186	5568	67	0	5865
12825	5533	65	192	51	0	5841
12826	194	57	61	5663	0	5975
12827	68	20	56	5784	0	5928
12828	59	31	47	5856	0	5993
12829	5769	23	39	258	0	6089
12830	169	5903	59	119	0	6250
12831	5918	167	35	86	0	6206
12832	212	50	5674	54	0	5990
12833	61	48	5656	66	0	5831
12834	5909	21	207	67	0	6204
12835	198	28	75	6004	0	6305
12836	58	43	62	6158	0	6321
12837	62	32	38	6214	0	6346
12838	43	27	6096	245	0	6411
12839	6009	24	178	119	0	6330
12840	6202	25	60	90	0	6377
12841	6049	26	54	74	0	6203
12842	238	39	36	5908	0	6221
12843	100	31	5735	198	0	6064
12844	80	27	5653	83	0	5843
12845	48	33	5902	88	0	6071
12846	52	5716	194	67	0	6029
12847	61	143	83	5211	0	5498
12848	5189	36	48	154	0	5427
12849	133	26	5211	65	0	5435
12850	5296	15	141	69	0	5521
12851	152	24	48	5406	0	5630
12852	65	26	30	5417	0	5538
12853	44	5195	38	175	0	5452
12854	53	5294	35	75	0	5457
12855	41	5500	36	67	0	5644
12856	49	145	47	5515	0	5756
12857	5470	46	30	166	0	5712
12858	5553	32	29	76	0	5690
12859	166	22	5393	59	0	5640
12860	5340	17	157	70	0	5584
12861	171	21	5400	53	0	5645
12862	68	19	157	5387	0	5631
12863	62	19	5391	155	0	5627
12864	5341	20	156	67	0	5584
12865	146	26	59	5494	0	5725
12866	62	19	5648	158	0	5887
12867	61	25	5452	59	0	5597
12868	5489	16	149	68	0	5722
12869	5722	27	64	62	0	5875
12870	150	5731	58	57	0	5996
12871	64	118	54	5774	0	6010
12872	58	38	5749	142	0	5987
12873	54	30	5678	73	0	5835
12874	42	37	140	5691	0	5910
12875	5807	20	57	148	0	6032
12876	129	5772	50	57	0	6008
12877	51	119	44	5867	0	6081
12878	5871	46	28	142	0	6087
12879	141	32	28	5848	0	6049
12880	54	5847	36	138	0	6075
12881	62	103	40	5998	0	6203
12882	5941	34	42	142	0	6159
12883	150	26	29	5956	0	6161
12884	6031	23	33	155	0	6242
12885	137	6132	43	76	0	6388
12886	6170	107	49	55	0	6381
12887	154	28	6029	45	0	6256
12888	5805	35	141	49	0	6030
12889	6167	22	50	56	0	6295
12890	151	6145	49	47	0	6392
12891	62	148	46	6073	0	6329
12892	57	35	6076	122	0	6290
12893	54	48	5846	57	0	6005
12894	5644	63	129	52	0	5888
12895	5606	17	47	55	0	5725
12896	115	5645	40	42	0	5842
12897	58	5820	31	42	0	5951
12898	5764	92	37	44	0	5937
12899	111	5723	35	32	0	5901
12900	53	5889	29	38	0	6009
12901	51	95	33	5865	0	6044
12902	34	32	30	5711	0	5807
12903	40	29	5740	106	0	5915
12904	42	20	82	5641	0	5785
12905	5652	13	33	109	0	5807
12906	102	24	5629	52	0	5807
12907	65	20	5513	39	0	5637
12908	52	29	102	5426	0	5609
12909	47	17	40	5712	0	5816
12910	53	16	29	5750	0	5848
12911	47	20	5605	99	0	5771
12912	32	24	85	5420	0	5561
12913	42	16	43	5644	0	5745
12914	5555	18	30	93	0	5696
12915	77	5511	27	35	0	5650
12916	5487	69	16	35	0	5607
12917	90	27	5468	22	0	5607
12918	4794	10	54	21	0	4879
12919	60	5251	30	16	0	5357
12920	4979	32	14	7	0	5032
12921	38	4931	6	9	0	4984
12922	4685	27	7	9	0	4728
12923	23	4593	4	6	0	4626
12924	6	4560	2	10	0	4578
12925	18	20	7	4585	0	4630
12926	4621	7	4	25	0	4657
12927	4583	4	5	13	0	4605
12928	4637	3	2	6	0	4648
12929	31	3	4505	3	0	4542
12930	9	8	4480	4	0	4501
12931	5	5	31	4562	0	4603
12932	5	4604	7	28	0	4644
12933	2	4757	5	9	0	4773
12934	12	33	2	4530	0	4577
12935	4485	9	0	27	0	4521
12936	4509	4	2	9	0	4524
12937	4525	6	4	10	0	4545
12938	45	1	4518	2	0	4566
12939	15	3	29	4609	0	4656
12940	11	5	4676	30	0	4722
12941	4617	4	34	19	0	4674
12942	4742	4	17	10	0	4773
12943	59	2	4770	10	0	4841
12944	21	7	36	4745	0	4809
12945	4763	7	13	49	0	4832
12946	46	5	4	4843	0	4898
12947	25	7	3	4892	0	4927
12948	17	10	5	5077	0	5109
12949	5539	4	2	75	0	5620
12950	75	5	8	5930	0	6018
12951	6180	3	6	115	0	6304
12952	129	6714	11	43	0	6897
12953	49	127	6	6997	0	7179
12954	23	39	6	7098	0	7166
12955	20	23	10	7108	0	7161
12956	6911	8	7	213	0	7139
12957	153	8	7	6932	0	7100
12958	59	8	11	7003	0	7081
12959	6943	11	4	207	0	7165
12960	7029	6	5	88	0	7128
12961	7058	7	4	55	0	7124
12962	226	4	6736	36	0	7002
12963	94	9	6573	26	0	6702
12964	6856	4	170	37	0	7067
12965	178	4	57	6860	0	7099
12966	81	12	26	6706	0	6825
12967	6727	16	12	218	0	6973
12968	6593	7	13	103	0	6716
12969	6542	10	15	72	0	6639
12970	204	6428	8	62	0	6702
12971	6548	141	9	41	0	6739
12972	6481	42	7	57	0	6587
12973	214	6317	10	37	0	6578
12974	98	6476	11	24	0	6609
12975	91	153	7	6500	0	6751
12976	6677	55	14	154	0	6900
12977	6739	24	24	61	0	6848
12978	6738	12	19	39	0	6808
12979	236	8	13	6547	0	6804
12980	6580	9	11	194	0	6794
12981	213	10	6432	81	0	6736
12982	6384	16	150	54	0	6604
12983	231	9	6484	36	0	6760
12984	101	20	6314	29	0	6464
12985	62	24	170	6140	0	6396
12986	6231	15	65	169	0	6480
12987	183	20	36	6230	0	6469
12988	78	25	6193	204	0	6500
12989	61	19	6176	88	0	6344
12990	58	16	182	6095	0	6351
12991	6050	11	59	197	0	6317
12992	195	6080	43	84	0	6402
12993	111	141	22	6182	0	6456
12994	97	44	25	6363	0	6529
12995	73	33	6251	217	0	6574
12996	59	19	6194	112	0	6384
12997	75	13	212	6249	0	6549
12998	6245	14	98	210	0	6567
12999	200	16	6203	115	0	6534
13000	114	16	162	6135	0	6427
13001	106	18	67	6159	0	6350
13002	76	7	52	6364	0	6499
13003	6057	19	49	270	0	6395
13004	229	24	5523	136	0	5912
13005	122	5996	123	109	0	6350
13006	96	158	50	6146	0	6450
13007	66	71	6099	228	0	6464
13008	83	5880	166	119	0	6248
13009	87	6234	70	105	0	6496
13010	6136	191	66	81	0	6474
13011	198	6191	47	81	0	6517
13012	6282	178	31	96	0	6587
13013	253	66	6126	76	0	6521
13014	125	44	187	6209	0	6565
13015	6165	38	73	244	0	6520
13016	234	6219	50	153	0	6656
13017	137	175	6206	111	0	6629
13018	136	80	200	5609	0	6025
13019	98	6287	82	185	0	6652
13020	108	189	47	6481	0	6825
13021	6328	71	79	234	0	6712
13022	211	6541	65	114	0	6931
13023	6642	204	45	81	0	6972
13024	6733	81	39	103	0	6956
13025	325	62	6568	64	0	7019
13026	160	6797	217	66	0	7240
13027	147	232	88	7075	0	7542
13028	102	77	7311	270	0	7760
13029	93	63	8003	109	0	8268
13030	99	56	360	8075	0	8590
13031	8359	33	145	337	0	8874
13032	8544	30	83	138	0	8795
13033	418	44	53	8346	0	8861
13034	159	32	8359	367	0	8917
13035	125	8345	316	140	0	8926
13036	8495	309	100	103	0	9007
13037	8654	107	74	77	0	8912
13038	417	8520	45	73	0	9055
13039	8651	323	53	70	0	9097
13040	403	102	8370	56	0	8931
13041	8354	77	320	53	0	8804
13042	8250	54	127	79	0	8510
13043	410	37	8367	53	0	8867
13044	166	31	343	8227	0	8767
13045	147	22	8257	330	0	8756
13046	108	7920	352	123	0	8503
13047	77	8223	134	116	0	8550
13048	94	388	93	7506	0	8081
13049	55	115	7544	292	0	8006
13050	45	6862	240	87	0	7234
13051	40	6900	79	57	0	7076
13052	6020	264	50	30	0	6364
13053	6184	68	29	23	0	6304
13054	212	37	29	6110	0	6388
13055	82	28	21	6040	0	6171
13056	59	6131	11	203	0	6404
13057	6084	183	34	65	0	6366
13058	6246	38	18	66	0	6368
13059	214	6113	32	37	0	6396
13060	68	209	11	6191	0	6479
13061	42	64	6186	193	0	6485
13062	33	32	182	6215	0	6462
13063	6208	28	58	217	0	6511
13064	205	38	29	6237	0	6509
13065	58	40	22	6448	0	6568
13066	6382	16	13	256	0	6667
13067	244	9	20	6169	0	6442
13068	66	6283	14	223	0	6586
13069	46	180	17	6405	0	6648
13070	45	63	19	6554	0	6681
13071	58	37	18	6387	0	6500
13072	48	6328	11	246	0	6633
13073	32	207	26	6273	0	6538
13074	19	55	6186	256	0	6516
13075	34	31	211	6158	0	6434
13076	25	31	6091	250	0	6397
13077	46	6038	199	85	0	6368
13078	36	194	63	6188	0	6481
13079	34	45	40	6345	0	6464
13080	54	38	32	6314	0	6438
13081	33	29	31	6274	0	6367
13082	25	51	6068	271	0	6415
13083	25	5961	195	130	0	6311
13084	33	190	55	6184	0	6462
13085	31	59	6178	262	0	6530
13086	39	62	214	6216	0	6531
13087	6262	39	67	259	0	6627
13088	218	28	6011	93	0	6350
13089	6074	31	208	88	0	6401
13090	240	30	82	6222	0	6574
13091	105	51	6220	228	0	6604
13092	67	6125	200	114	0	6506
13093	63	208	72	6180	0	6523
13094	57	72	6290	247	0	6666
13095	52	6213	224	104	0	6593
13096	56	219	86	6232	0	6593
13097	6196	94	59	246	0	6595
13098	6446	57	53	103	0	6659
13099	6518	43	55	83	0	6699
13100	294	42	6270	87	0	6693
13101	151	6360	207	54	0	6772
13102	88	227	93	6406	0	6814
13103	74	73	61	6820	0	7028
13104	6723	50	54	302	0	7129
13105	246	6857	60	106	0	7269
13106	6846	275	33	88	0	7242
13107	6892	92	28	97	0	7109
13108	7089	55	58	86	0	7288
13109	320	71	6828	67	0	7286
13110	6928	56	247	89	0	7320
13111	332	51	65	7010	0	7458
13112	147	39	49	7144	0	7379
13113	7001	32	38	330	0	7401
13114	273	44	56	6827	0	7200
13115	92	6843	31	304	0	7270
13116	75	246	27	6788	0	7136
13117	6602	65	23	332	0	7022
13118	281	57	6434	121	0	6893
13119	80	6437	222	106	0	6845
13120	81	236	59	6405	0	6781
13121	6386	64	42	285	0	6777
13122	281	42	6320	101	0	6744
13123	89	123	251	6243	0	6706
13124	100	28	6186	291	0	6605
13125	82	20	6019	139	0	6260
13126	76	25	5819	101	0	6021
13127	73	27	5725	65	0	5890
13128	46	30	5452	72	0	5600
13129	4449	87	208	43	0	4787
13130	96	4520	46	36	0	4698
13131	4262	68	39	24	0	4393
13132	4243	27	25	21	0	4316
13133	87	4233	18	21	0	4359
13134	36	4329	18	17	0	4400
13135	4314	81	20	17	0	4432
13136	4319	24	15	22	0	4380
13137	93	13	15	4172	0	4293
13138	40	4223	18	65	0	4346
13139	4278	63	18	38	0	4397
13140	72	4239	18	20	0	4349
13141	30	77	14	4273	0	4394
13142	4337	21	12	77	0	4447
13143	4359	21	16	31	0	4427
13144	96	17	11	4328	0	4452
13145	40	20	16	4334	0	4410
13146	34	12	4267	85	0	4398
13147	26	20	70	4216	0	4332
13148	28	10	4320	86	0	4444
13149	31	7	77	4158	0	4273
13150	32	10	24	4266	0	4332
13151	4225	16	21	100	0	4362
13152	4203	10	13	46	0	4272
13153	103	15	4149	19	0	4286
13154	4062	9	76	38	0	4185
13155	89	15	27	4147	0	4278
13156	41	11	4216	82	0	4350
13157	37	12	72	4138	0	4259
13158	28	11	28	4478	0	4545
13159	37	16	4454	101	0	4608
13160	28	8	85	4486	0	4607
13161	34	12	4719	100	0	4865
13162	23	13	107	4900	0	5043
13163	5202	15	37	133	0	5387
13164	128	5280	27	48	0	5483
13165	5459	111	15	60	0	5645
13166	145	5557	27	26	0	5755
13167	5477	133	18	28	0	5656
13168	144	5508	15	29	0	5696
13169	5450	138	20	24	0	5632
13170	144	5496	17	31	0	5688
13171	72	138	17	5526	0	5753
13172	47	57	5492	129	0	5725
13173	30	41	5408	55	0	5534
13174	43	29	152	5350	0	5574
13175	5406	31	62	138	0	5637
13176	141	5505	38	59	0	5743
13177	67	130	18	5543	0	5758
13178	39	66	5542	148	0	5795
13179	34	40	5622	73	0	5769
13180	38	37	168	5281	0	5524
13181	31	5646	74	134	0	5885
13182	5653	134	40	73	0	5900
13183	141	59	5825	36	0	6061
13184	61	36	5625	37	0	5759
13185	43	5746	174	40	0	6003
13186	5765	136	95	21	0	6017
13187	5813	63	35	36	0	5947
13188	182	31	31	5722	0	5966
13189	5845	28	32	135	0	6040
13190	5777	20	30	73	0	5900
13191	172	5837	34	33	0	6076
13192	5854	133	28	22	0	6037
13193	167	64	5952	16	0	6199
13194	87	38	127	5771	0	6023
13195	51	25	63	5837	0	5976
13196	5780	22	40	175	0	6017
13197	142	5729	29	84	0	5984
13198	5681	125	26	51	0	5883
13199	151	5895	15	30	0	6091
13200	76	5943	20	27	0	6066
13201	57	163	5760	22	0	6002
13202	32	86	5609	35	0	5762
13203	5332	53	149	24	0	5558
13204	5556	33	65	28	0	5682
13205	136	22	5373	22	0	5553
13206	83	5099	91	18	0	5291
13207	48	5317	44	17	0	5426
13208	5301	121	35	21	0	5478
13209	5276	65	27	12	0	5380
13210	126	41	20	5253	0	5440
13211	5396	28	17	92	0	5533
13212	124	12	21	5327	0	5484
13213	58	16	5335	105	0	5514
13214	48	23	5063	60	0	5194
13215	5163	22	115	47	0	5347
13216	107	31	64	5128	0	5330
13217	60	5567	33	75	0	5735
13218	5672	94	24	53	0	5843
13219	5674	49	29	31	0	5783
13220	145	29	5619	28	0	5821
13221	5604	25	95	31	0	5755
13222	5834	35	50	19	0	5938
13223	155	24	37	5693	0	5909
13224	75	5638	42	92	0	5847
13225	56	5744	30	45	0	5875
13226	61	144	13	6002	0	6220
13227	55	71	24	5819	0	5969
13228	50	48	25	5987	0	6110
13229	59	28	5873	165	0	6125
13230	63	31	5653	81	0	5828
13231	44	38	153	5706	0	5941
13232	52	38	5823	115	0	6028
13233	60	46	5680	53	0	5839
13234	49	33	151	5538	0	5771
13235	49	30	5987	125	0	6191
13236	41	5873	150	73	0	6137
13237	6165	126	70	77	0	6438
13238	148	59	63	6065	0	6335
13239	76	6115	54	124	0	6369
13240	57	134	6328	69	0	6588
13241	54	65	148	6252	0	6519
13242	44	44	6595	147	0	6830
13243	38	39	161	6480	0	6718
13244	52	28	82	6821	0	6983
13245	54	17	7018	195	0	7284
13246	42	27	160	6767	0	6996
13247	45	6764	93	174	0	7076
13248	51	153	61	7105	0	7370
13249	58	71	7073	177	0	7379
13250	45	56	159	7008	0	7268
13251	6934	38	90	189	0	7251
13252	176	7028	47	112	0	7363
13253	96	145	56	7168	0	7465
13254	65	80	7255	173	0	7573
13255	60	6970	144	88	0	7262
13256	53	7220	85	63	0	7421
13257	37	180	7096	59	0	7372
13258	38	99	153	6770	0	7060
13259	55	59	85	6727	0	6926
13260	51	37	6822	192	0	7102
13261	29	6328	141	120	0	6618
13262	42	6464	69	75	0	6650
13263	6049	111	32	34	0	6226
13264	90	6117	18	29	0	6254
13265	6049	100	15	26	0	6190
13266	90	52	13	5887	0	6042
13267	6204	25	11	117	0	6357
13268	89	13	6154	57	0	6313
13269	6044	12	91	43	0	6190
13270	96	22	47	6256	0	6421
13271	52	6343	36	90	0	6521
13272	6445	86	29	59	0	6619
13273	99	65	19	6467	0	6650
13274	51	6526	27	100	0	6704
13275	22	6968	21	54	0	7065
13276	6936	119	21	39	0	7115
13277	6992	49	26	32	0	7099
13278	7074	31	14	26	0	7145
13279	121	24	16	6741	0	6902
13280	52	6561	21	98	0	6732
13281	28	6803	18	49	0	6898
13282	28	118	19	6810	0	6975
13283	6717	49	14	109	0	6889
13284	6393	43	19	68	0	6523
13285	6664	28	18	28	0	6738
13286	135	17	6530	33	0	6715
13287	67	22	6484	43	0	6616
13288	6978	18	120	29	0	7145
13289	121	20	54	6923	0	7118
13290	62	23	22	7019	0	7126
13291	29	27	27	6822	0	6905
13292	33	31	16	6968	0	7048
13293	36	21	6745	160	0	6962
13294	27	26	92	6676	0	6821
13295	24	22	6728	131	0	6905
13296	6185	20	107	84	0	6396
13297	107	6777	57	49	0	6990
13298	68	99	41	6997	0	7205
13299	35	52	29	6888	0	7004
13300	6833	39	23	158	0	7053
13301	6806	37	29	83	0	6955
13302	6820	35	25	59	0	6939
13303	6798	35	19	56	0	6908
13304	163	26	6727	40	0	6956
13305	96	27	6606	42	0	6771
13306	55	29	139	6716	0	6939
13307	6823	28	69	118	0	7038
13308	6790	32	37	82	0	6941
13309	143	26	6734	56	0	6959
13310	69	23	105	6625	0	6822
13311	6688	19	51	145	0	6903
13312	120	25	40	6731	0	6916
13313	79	30	6824	124	0	7057
13314	53	34	112	6728	0	6927
13315	6853	28	61	149	0	7091
13316	117	7406	44	81	0	7648
13317	7360	108	32	74	0	7574
13318	7387	60	28	71	0	7546
13319	7477	32	15	69	0	7593
13320	172	31	27	7371	0	7601
13321	7310	32	21	124	0	7487
13322	136	7511	25	68	0	7740
13323	95	7774	26	50	0	7945
13324	58	158	29	7619	0	7864
13325	7637	69	28	141	0	7875
13326	141	7892	21	77	0	8131
13327	9280	147	17	48	0	9492
13328	9689	77	21	41	0	9828
13329	328	10047	16	40	0	10431
13330	140	250	22	10180	0	10592
13331	102	109	14	10477	0	10702
13332	107	55	10332	325	0	10819
13333	100	61	233	10147	0	10541
13334	89	48	10322	315	0	10774
13335	71	10014	243	175	0	10503
13336	69	246	124	10275	0	10714
13337	9820	121	61	323	0	10325
13338	10087	39	68	180	0	10374
13339	334	56	60	10038	0	10488
13340	132	49	9798	300	0	10279
13341	9063	47	233	193	0	9536
13342	294	9288	118	88	0	9788
13343	136	9253	38	110	0	9537
13344	115	9520	52	90	0	9777
13345	114	280	48	9058	0	9500
13346	88	112	9264	239	0	9703
13347	62	80	222	9183	0	9547
13348	55	86	9293	235	0	9669
13349	53	70	9121	117	0	9361
13350	41	72	9359	74	0	9546
13351	44	59	304	8790	0	9197
13352	43	50	133	9383	0	9609
13353	26	30	110	9504	0	9670
13354	33	26	113	9194	0	9366
13355	9211	14	90	361	0	9676
13356	204	9139	94	168	0	9605
13357	9174	206	76	135	0	9591
13358	226	9326	57	135	0	9744
13359	102	224	40	9421	0	9787
13360	66	104	26	9744	0	9940
13361	9506	74	19	355	0	9954
13362	9713	59	21	159	0	9952
13363	9814	63	24	110	0	10011
13364	9726	60	26	106	0	9918
13365	9661	48	22	106	0	9837
13366	363	9435	23	84	0	9905
13367	9166	220	18	88	0	9492
13368	324	9140	9	69	0	9542
13369	9172	226	11	48	0	9457
13370	327	106	8975	41	0	9449
13371	196	68	195	8760	0	9219
13372	136	9125	68	200	0	9529
13373	132	247	50	9064	0	9493
13374	99	123	8965	221	0	9408
13375	103	72	226	8509	0	8910
13376	8420	93	94	276	0	8883
13377	228	8435	61	177	0	8901
13378	98	8726	69	131	0	9024
13379	92	282	8796	115	0	9285
13380	79	143	243	8518	0	8983
13381	58	8871	113	280	0	9322
13382	66	275	74	9124	0	9539
13383	63	132	9074	293	0	9562
13384	56	8796	251	172	0	9275
13385	56	270	8922	115	0	9363
13386	55	151	8797	108	0	9111
13387	68	80	310	8736	0	9194
13388	8877	95	118	264	0	9354
13389	261	97	96	8992	0	9446
13390	109	81	9012	292	0	9494
13391	67	90	302	9199	0	9658
13392	82	77	9627	314	0	10100
13393	73	67	9525	176	0	9841
13394	9452	67	361	152	0	10032
13395	10223	61	170	147	0	10601
13396	10307	42	140	157	0	10646
13397	330	37	10042	133	0	10542
13398	150	35	10060	126	0	10371
13399	122	29	387	9731	0	10269
13400	129	29	215	10050	0	10423
13401	10041	33	136	366	0	10576
13402	354	47	119	10011	0	10531
13403	166	44	10013	361	0	10584
13404	119	42	9673	208	0	10042
13405	92	9844	356	175	0	10467
13406	113	255	136	10114	0	10618
13407	109	118	10247	366	0	10840
13408	119	74	339	10093	0	10625
13409	10190	82	159	350	0	10781
13410	308	72	10320	193	0	10893
13411	139	55	364	10223	0	10781
13412	119	54	165	10569	0	10907
13413	118	52	10174	418	0	10762
13414	129	32	342	10028	0	10531
13415	117	37	10094	378	0	10626
13416	9231	40	334	236	0	9841
13417	318	46	188	9363	0	9915
13418	132	9404	126	353	0	10015
13419	9465	284	99	216	0	10064
13420	9548	104	111	156	0	9919
13421	378	9340	114	150	0	9982
13422	241	727	101	8214	0	9283
13423	127	8701	82	251	0	9161
13424	125	8858	59	146	0	9188
13425	171	331	8370	115	0	8987
13426	139	8221	243	113	0	8716
13427	85	164	6795	58	0	7102
13428	5642	78	111	35	0	5866
13429	5807	21	36	28	0	5892
13430	95	5873	28	20	0	6016
13431	35	5926	23	17	0	6001
13432	25	6002	19	23	0	6069
13433	6135	105	24	13	0	6277
13434	124	39	20	6266	0	6449
13435	45	28	6696	113	0	6882
13436	18	6622	124	42	0	6806
13437	19	133	37	6798	0	6987
13438	19	42	19	6705	0	6785
13439	18	7678	29	133	0	7858
13440	8305	178	21	48	0	8552
13441	224	43	8510	30	0	8807
13442	87	33	225	10347	0	10692
13443	32	11715	53	286	0	12086
13444	11694	376	31	102	0	12203
13445	388	114	11638	42	0	12182
13446	122	11394	368	52	0	11936
13447	72	393	107	11469	0	12041
13448	33	124	11460	379	0	11996
13449	11102	59	403	133	0	11697
13450	390	53	124	11300	0	11867
13451	129	41	11317	404	0	11891
13452	67	11262	410	141	0	11880
13453	11020	406	130	76	0	11632
13454	374	11330	78	60	0	11842
13455	11322	429	65	48	0	11864
13456	11623	165	33	45	0	11866
13457	516	91	34	11083	0	11724
13458	178	10818	53	387	0	11436
13459	107	387	11023	124	0	11641
13460	89	146	410	11013	0	11658
13461	118	119	215	9732	0	10184
13462	72	47	96	11293	0	11508
13463	78	46	73	11315	0	11512
13464	66	50	60	11414	0	11590
13465	10952	53	74	582	0	11661
13466	10565	57	63	229	0	10914
13467	10741	73	37	151	0	11002
13468	527	10514	36	119	0	11196
13469	196	411	10773	87	0	11467
13470	144	132	10862	101	0	11239
13471	105	86	11114	99	0	11404
13472	81	72	567	10534	0	11254
13473	68	76	213	10970	0	11327
13474	74	45	126	11154	0	11399
13475	59	53	10633	601	0	11346
13476	57	10401	439	288	0	11185
13477	79	395	10554	183	0	11211
13478	78	151	10796	145	0	11170
13479	103	100	522	10431	0	11156
13480	107	91	10719	456	0	11373
13481	110	65	523	10502	0	11200
13482	10325	101	225	513	0	11164
13483	10568	92	160	208	0	11028
13484	550	56	10211	163	0	10980
13485	230	57	494	10183	0	10964
13486	149	79	10233	507	0	10968
13487	91	10281	497	239	0	11108
13488	10267	463	207	168	0	11105
13489	482	192	10277	126	0	11077
13490	218	9831	492	136	0	10677
13491	133	9945	227	134	0	10439
13492	112	9950	182	126	0	10370
13493	114	561	9303	129	0	10107
13494	127	292	451	8611	0	9481
13495	128	9060	220	431	0	9839
13496	149	457	163	8987	0	9756
13497	156	198	125	9353	0	9832
13498	8795	171	136	598	0	9700
13499	428	8913	149	301	0	9791
13500	8780	427	134	229	0	9570
13501	502	8563	138	181	0	9384
13502	227	9077	121	158	0	9583
13503	158	536	8745	167	0	9606
13504	131	305	463	8612	0	9511
13505	139	211	8679	464	0	9493
13506	153	8508	482	244	0	9387
13507	160	446	8550	199	0	9355
13508	166	209	8621	188	0	9184
13509	145	8567	526	207	0	9445
13510	8192	481	270	184	0	9127
13511	424	8468	199	192	0	9283
13512	8454	503	181	202	0	9340
13513	484	231	8406	233	0	9354
13514	200	139	8587	237	0	9163
13515	142	8351	559	241	0	9293
13516	8214	455	249	232	0	9150
13517	461	8326	205	193	0	9185
13518	271	458	185	8315	0	9229
13519	8470	223	168	458	0	9319
13520	475	190	8410	221	0	9296
13521	200	158	560	8470	0	9388
13522	8395	127	295	475	0	9292
13523	464	8388	236	247	0	9335
13524	217	470	183	8491	0	9361
13525	165	197	8384	549	0	9295
13526	8321	152	497	293	0	9263
13527	435	152	272	8484	0	9343
13528	172	153	8412	491	0	9228
13529	131	135	519	8138	0	8923
13530	113	8244	280	525	0	9162
13531	109	426	8347	300	0	9182
13532	156	202	462	8278	0	9098
13533	7934	131	248	489	0	8802
13534	488	116	171	7852	0	8627
13535	7278	105	160	412	0	7955
13536	419	7277	165	239	0	8100
13537	7226	380	164	188	0	7958
13538	397	197	7087	152	0	7833
13539	189	147	6229	117	0	6682
13540	139	93	5468	89	0	5789
13541	99	5151	465	74	0	5789
13542	130	86	340	1952	0	2508
13543	25	15	47	1892	0	1979
13544	9	12	15	1839	0	1875
13545	6	9	8	1904	0	1927
13546	6	11	1897	43	0	1957
13547	1765	13	35	20	0	1833
13548	32	1912	18	13	0	1975
13549	1886	29	13	8	0	1936
13550	32	17	6	1884	0	1939
13551	12	1928	2	26	0	1968
13552	7	32	10	1977	0	2026
13553	1941	14	7	41	0	2003
13554	29	2041	5	12	0	2087
13555	2014	26	7	21	0	2068
13556	2011	14	5	14	0	2044
13557	36	15	5	2043	0	2099
13558	14	7	2004	27	0	2052
13559	1968	4	30	13	0	2015
13560	25	8	10	2122	0	2165
13561	2145	7	6	32	0	2190
13562	2163	9	6	9	0	2187
13563	2153	4	6	15	0	2178
13564	43	6	2161	4	0	2214
13565	18	8	28	2095	0	2149
13566	2120	6	8	29	0	2163
13567	33	5	2175	11	0	2224
13568	13	2212	29	9	0	2263
13569	17	44	13	1970	0	2044
13570	8	9	2156	22	0	2195
13571	7	10	2079	12	0	2108
13572	16	10	25	2054	0	2105
13573	4	1	12	2167	0	2184
13574	7	3	8	2174	0	2192
13575	6	3	5	2138	0	2152
13576	4	3	2138	29	0	2174
13577	6	2114	21	16	0	2157
13578	12	18	10	2189	0	2229
13579	2235	8	10	23	0	2276
13580	2160	6	5	16	0	2187
13581	2207	3	8	11	0	2229
13582	28	1	4	2207	0	2240
13583	14	9	2	2176	0	2201
13584	8	2070	6	23	0	2107
13585	4	2167	4	9	0	2184
13586	3	35	5	2122	0	2165
13587	2123	2	2	22	0	2149
13588	2110	5	2	6	0	2123
13589	2098	1	1	8	0	2108
13590	2085	1	1	7	0	2094
13591	2089	0	2	6	0	2097
13592	11	2108	0	6	0	2125
13593	6	9	2	2178	0	2195
13594	2260	2	1	18	0	2281
13595	2290	4	1	9	0	2304
13596	13	2	4	2261	0	2280
13597	9	2	1	2275	0	2287
13598	7	2	2321	12	0	2342
13599	7	2	9	2199	0	2217
13600	5	3	1	2267	0	2276
13601	4	2	2439	11	0	2456
13602	6	6	8	2367	0	2387
13603	7	2472	1	10	0	2490
13604	10	8	2464	5	0	2487
13605	2	2520	9	4	0	2535
13606	3	6	3	2490	0	2502
13607	2	4	3	2528	0	2537
13608	2	2516	2	12	0	2532
13609	4	2546	2	6	0	2558
13610	2609	6	0	14	0	2629
13611	2597	2	2	8	0	2609
13612	8	3	2618	4	0	2633
13613	2633	0	6	14	0	2653
13614	2815	0	2	12	0	2829
13615	2821	1	3	7	0	2832
13616	2800	3	4	7	0	2814
13617	12	2	2750	4	0	2768
13618	12	6	2571	3	0	2592
13619	2844	0	9	5	0	2858
13620	8	2927	6	9	0	2950
13621	3	7	2937	7	0	2954
13622	2906	1	7	6	0	2920
13623	2972	2	2	5	0	2981
13624	14	3	2937	2	0	2956
13625	2926	1	12	2	0	2941
13626	20	1	4	3282	0	3307
13627	9	3	3384	16	0	3412
13628	3048	1	14	17	0	3080
13629	15	3362	6	6	0	3389
13630	3499	16	4	6	0	3525
13631	3865	3	1	34	0	3903
13632	19	1	3	3882	0	3905
13633	6	1	2	3831	0	3840
13634	3	0	0	3979	0	3982
13635	3980	1	2	28	0	4011
13636	4132	0	5	12	0	4149
13637	25	3	2	4123	0	4153
13638	11	2	1	4095	0	4109
13639	6	1	4024	29	0	4060
13640	3785	1	16	20	0	3822
13641	20	1	13	4142	0	4176
13642	17	0	2	4134	0	4153
13643	6	4098	7	36	0	4147
13644	7	18	1	4177	0	4203
13645	6	11	0	4148	0	4165
13646	4113	6	1	45	0	4165
13647	21	4177	2	23	0	4223
13648	20	34	2	4272	0	4328
13649	13	13	0	4260	0	4286
13650	7	5	0	4292	0	4304
13651	6	4	4241	44	0	4295
13652	2	4	19	4143	0	4168
13653	4155	2	16	42	0	4215
13654	29	3	4147	20	0	4199
13655	22	1	25	4215	0	4263
13656	8	2	16	4286	0	4312
13657	4309	1	8	55	0	4373
13658	4234	0	3	32	0	4269
13659	47	4	4271	13	0	4335
13660	3948	0	28	25	0	4001
13661	34	5	4281	9	0	4329
13662	4281	3	28	15	0	4327
13663	35	4702	21	10	0	4768
13664	4868	31	10	19	0	4928
13665	50	4900	3	6	0	4959
13666	5095	46	1	12	0	5154
13667	53	5156	5	9	0	5223
13668	29	57	7	5300	0	5393
13669	19	30	2	5292	0	5343
13670	17	12	7	5303	0	5339
13671	10	5182	1	90	0	5283
13672	18	51	3	5263	0	5335
13673	6	5253	7	70	0	5336
13674	8	59	4	5351	0	5422
13675	5311	24	5	74	0	5414
13676	5259	20	2	40	0	5321
13677	74	5233	3	26	0	5336
13678	39	52	4	5343	0	5438
13679	5252	30	6	67	0	5355
13680	63	5282	5	45	0	5395
13681	32	5317	5	27	0	5381
13682	5365	80	2	20	0	5467
13683	5380	43	4	18	0	5445
13684	82	5358	2	15	0	5457
13685	5369	65	2	12	0	5448
13686	71	47	6	5375	0	5499
13687	44	23	5555	61	0	5683
13688	5455	8	55	46	0	5564
13689	5580	17	25	25	0	5647
13690	99	21	5621	15	0	5756
13691	5656	9	59	40	0	5764
13692	5837	13	29	28	0	5907
13693	6033	10	20	25	0	6088
13694	118	5918	8	17	0	6061
13695	6048	66	10	18	0	6142
13696	6086	36	10	19	0	6151
13697	111	22	7	6053	0	6193
13698	73	6	5	6118	0	6202
13699	35	19	9	6226	0	6289
13700	6224	15	2	123	0	6364
13701	98	10	4	6110	0	6222
13702	6147	12	3	107	0	6269
13703	6224	21	2	67	0	6314
13704	121	4	4	6181	0	6310
13705	65	12	4	6301	0	6382
13706	46	8	8	6423	0	6485
13707	6371	14	3	144	0	6532
13708	103	6340	5	68	0	6516
13709	60	80	9	6500	0	6649
13710	37	41	2	6685	0	6765
13711	6597	23	6	146	0	6772
13712	6623	16	3	83	0	6725
13713	148	17	6431	53	0	6649
13714	73	16	6318	49	0	6456
13715	6867	14	131	52	0	7064
13716	152	15	49	7033	0	7249
13717	82	16	32	8083	0	8213
13718	57	13	8051	254	0	8375
13719	46	19	191	7813	0	8069
13720	52	7839	51	226	0	8168
13721	44	8281	31	79	0	8435
13722	8013	232	21	64	0	8330
13723	208	84	7961	50	0	8303
13724	77	8200	166	42	0	8485
13725	64	210	55	8308	0	8637
13726	48	68	8222	201	0	8539
13727	38	53	207	7922	0	8220
13728	43	27	61	8098	0	8229
13729	42	25	8058	256	0	8381
13730	36	7992	190	101	0	8319
13731	37	190	59	7720	0	8006
13732	7767	53	56	228	0	8104
13733	7847	37	29	79	0	7992
13734	7919	24	20	64	0	8027
13735	273	7691	27	53	0	8044
13736	7623	186	24	47	0	7880
13737	248	67	18	7641	0	7974
13738	97	44	7587	218	0	7946
13739	7417	37	175	74	0	7703
13740	226	7697	53	76	0	8052
13741	81	187	39	7703	0	8010
13742	76	57	27	7745	0	7905
13743	41	7573	25	251	0	7890
13744	42	205	29	7842	0	8118
13745	46	60	34	7935	0	8075
13746	49	55	18	8113	0	8235
13747	7802	40	27	292	0	8161
13748	7780	31	33	125	0	7969
13749	249	40	7796	96	0	8181
13750	92	47	196	7808	0	8143
13751	75	30	63	8108	0	8276
13752	66	27	48	8193	0	8334
13753	7951	40	46	287	0	8324
13754	226	42	7687	128	0	8083
13755	7554	24	190	118	0	7886
13756	7997	22	65	87	0	8171
13757	275	33	45	7917	0	8270
13758	7978	20	34	257	0	8289
13759	271	31	7725	94	0	8121
13760	7564	33	181	100	0	7878
13761	276	8446	55	83	0	8860
13762	115	209	8329	48	0	8701
13763	93	62	8403	69	0	8627
13764	73	54	245	8213	0	8585
13765	62	49	8369	235	0	8715
13766	7899	51	237	110	0	8297
13767	214	8039	73	101	0	8427
13768	8110	212	59	85	0	8466
13769	255	64	37	8210	0	8566
13770	97	54	8147	243	0	8541
13771	59	40	8096	128	0	8323
13772	60	40	237	8182	0	8519
13773	8266	28	90	268	0	8652
13774	224	8049	58	124	0	8455
13775	88	8460	34	115	0	8697
13776	8368	226	62	107	0	8763
13777	234	8491	47	87	0	8859
13778	8523	218	36	73	0	8850
13779	261	91	41	8442	0	8835
13780	8466	49	41	231	0	8787
13781	265	41	57	8443	0	8806
13782	8498	44	37	254	0	8833
13783	267	38	28	8407	0	8740
13784	100	8294	66	260	0	8720
13785	8367	185	65	111	0	8728
13786	240	8288	45	112	0	8685
13787	108	223	7942	72	0	8345
13788	94	92	208	7604	0	7998
13789	85	8106	78	201	0	8470
13790	7730	217	57	95	0	8099
13791	7839	81	43	70	0	8033
13792	268	7771	54	68	0	8161
13793	103	212	7666	63	0	8044
13794	89	62	194	7423	0	7768
13795	85	7396	81	215	0	7777
13796	56	203	72	7724	0	8055
13797	82	79	54	7826	0	8041
13798	7617	64	33	258	0	7972
13799	221	7548	27	111	0	7907
13800	105	188	40	7665	0	7998
13801	7652	82	41	241	0	8016
13802	7710	68	22	109	0	7909
13803	7584	48	33	88	0	7753
13804	290	40	36	7454	0	7820
13805	7379	48	23	214	0	7664
13806	251	7298	43	88	0	7680
13807	7266	186	42	71	0	7565
13808	231	7310	24	96	0	7661
13809	7327	188	30	83	0	7628
13810	7295	56	31	84	0	7466
13811	244	92	25	7093	0	7454
13812	132	39	7123	168	0	7462
13813	92	45	6819	89	0	7045
13814	84	7009	173	52	0	7318
13815	6717	163	76	54	0	7010
13816	195	65	6594	40	0	6894
13817	5116	23	60	23	0	5222
13818	64	5281	24	14	0	5383
13819	37	5472	10	13	0	5532
13820	33	65	12	5707	0	5817
13821	24	5836	4	57	0	5921
13822	23	75	6003	27	0	6128
13823	33	37	66	5760	0	5896
13824	24	6146	24	84	0	6278
13825	16	98	20	6256	0	6390
13826	6222	33	16	106	0	6377
13827	102	37	10	6220	0	6369
13828	42	31	6320	114	0	6507
13829	36	6348	97	50	0	6531
13830	29	129	37	6361	0	6556
13831	22	45	35	6477	0	6579
13832	25	40	27	6598	0	6690
13833	6385	42	18	164	0	6609
13834	6328	28	17	86	0	6459
13835	150	16	6279	60	0	6505
13836	63	34	6216	44	0	6357
13837	46	6283	132	40	0	6501
13838	6386	118	55	46	0	6605
13839	130	46	43	6375	0	6594
13840	48	38	33	6427	0	6546
13841	51	28	21	6432	0	6532
13842	48	20	13	6478	0	6559
13843	45	25	6190	181	0	6441
13844	5917	25	115	99	0	6156
13845	145	22	39	6971	0	7177
13846	79	21	6919	193	0	7212
13847	7020	29	171	89	0	7309
13848	7961	9	70	68	0	8108
13849	269	28	8776	58	0	9131
13850	135	20	9218	45	0	9418
13851	92	18	344	8990	0	9444
13852	9136	13	144	310	0	9603
13853	9382	13	82	127	0	9604
13854	400	15	56	8944	0	9415
13855	158	14	64	9320	0	9556
13856	98	19	9147	371	0	9635
13857	64	30	303	8972	0	9369
13858	94	17	8950	340	0	9401
13859	8460	23	309	164	0	8956
13860	300	8808	137	119	0	9364
13861	8297	252	68	85	0	8702
13862	319	8280	68	59	0	8726
13863	8221	289	56	76	0	8642
13864	339	105	58	7998	0	8500
13865	168	53	36	8272	0	8529
13866	8094	58	39	378	0	8569
13867	8281	32	26	164	0	8503
13868	8257	47	29	101	0	8434
13869	8369	27	30	62	0	8488
13870	444	35	7872	79	0	8430
13871	7921	26	289	74	0	8310
13872	8213	30	98	64	0	8405
13873	8283	17	58	57	0	8415
13874	491	21	36	7888	0	8436
13875	7686	15	48	329	0	8078
13876	403	7593	79	136	0	8211
13877	237	259	44	7686	0	8226
13878	186	87	49	7952	0	8274
13879	166	50	7570	398	0	8184
13880	136	36	306	7427	0	7905
13881	142	7528	135	370	0	8175
13882	7500	290	86	200	0	8076
13883	372	7584	81	169	0	8206
13884	7698	314	47	165	0	8224
13885	411	131	84	7622	0	8248
13886	7543	72	63	403	0	8081
13887	374	7471	67	204	0	8116
13888	7633	297	70	136	0	8136
13889	7806	167	53	115	0	8141
13890	499	91	48	7527	0	8165
13891	257	80	54	7808	0	8199
13892	222	80	7401	438	0	8141
13893	174	84	287	7540	0	8085
13894	190	50	105	7748	0	8093
13895	176	59	7393	480	0	8108
13896	184	43	315	7544	0	8086
13897	156	44	7373	444	0	8017
13898	7386	28	358	212	0	7984
13899	421	38	148	7399	0	8006
13900	242	30	7244	402	0	7918
13901	7293	28	338	222	0	7881
13902	437	35	150	7369	0	7991
13903	232	40	7409	403	0	8084
13904	7467	31	324	229	0	8051
13905	412	33	153	7518	0	8116
13906	207	47	129	7701	0	8084
13907	7601	39	69	502	0	8211
13908	408	52	80	7574	0	8114
13909	233	36	98	7773	0	8140
13910	193	54	67	7503	0	7817
13911	173	7298	65	514	0	8050
13912	7200	306	63	295	0	7864
13913	7486	135	63	178	0	7862
13914	503	89	40	7268	0	7900
13915	7332	53	49	448	0	7882
13916	7419	57	42	256	0	7774
13917	7523	76	44	194	0	7837
13918	5863	94	70	219	0	6246
13919	7328	52	61	159	0	7600
13920	503	38	6472	185	0	7198
13921	278	36	6323	159	0	6796
13922	6246	37	349	138	0	6770
13923	406	6117	149	159	0	6831
13924	210	233	95	6016	0	6554
13925	172	91	5890	335	0	6488
13926	133	42	5981	198	0	6354
13927	137	95	383	5813	0	6428
13928	5845	53	215	329	0	6442
13929	329	52	97	5961	0	6439
13930	194	41	5867	343	0	6445
13931	6093	21	277	198	0	6589
13932	321	29	160	6161	0	6671
13933	195	18	99	6382	0	6694
13934	177	22	65	6490	0	6754
13935	117	21	55	6470	0	6663
13936	138	23	6056	431	0	6648
13937	147	29	235	6185	0	6596
13938	6098	24	107	393	0	6622
13939	309	22	5841	262	0	6434
13940	5965	25	238	198	0	6426
13941	6229	41	133	162	0	6565
13942	6264	25	90	131	0	6510
13943	6219	22	46	162	0	6449
13944	443	5847	51	130	0	6471
13945	192	5104	47	95	0	5438
13946	152	5343	49	80	0	5624
13947	4764	263	197	118	0	5342
13948	226	55	4291	82	0	4654
13949	3125	38	125	31	0	3319
13950	91	19	46	2990	0	3146
13951	2995	3	21	74	0	3093
13952	76	2	16	2978	0	3072
13953	2978	4	10	84	0	3076
13954	77	4	12	2969	0	3062
13955	33	1	13	3093	0	3140
13956	2829	5	10	93	0	2937
13957	74	3223	16	46	0	3359
13958	39	56	3274	28	0	3397
13959	32	3205	52	25	0	3314
13960	24	51	3092	23	0	3190
13961	22	51	41	2895	0	3009
13962	3034	11	35	47	0	3127
13963	43	14	10	2989	0	3056
13964	2954	3	14	53	0	3024
13965	47	3165	11	29	0	3252
13966	31	29	3236	24	0	3320
13967	30	3262	30	15	0	3337
13968	25	3303	14	20	0	3362
13969	3161	31	16	12	0	3220
13970	3087	13	12	8	0	3120
13971	35	3109	2	9	0	3155
13972	20	23	6	3167	0	3216
13973	15	16	2	3147	0	3180
13974	3149	6	6	39	0	3200
13975	27	7	3151	20	0	3205
13976	16	7	3077	12	0	3112
13977	12	2	34	3145	0	3193
13978	16	2	3220	33	0	3271
13979	2996	2	29	24	0	3051
13980	3218	4	15	13	0	3250
13981	37	3219	9	9	0	3274
13982	18	30	3309	7	0	3364
13983	20	12	27	3267	0	3326
13984	18	8	3486	31	0	3543
13985	12	9	30	3436	0	3487
13986	3494	9	13	41	0	3557
13987	36	3553	6	22	0	3617
13988	15	32	3653	15	0	3715
13989	14	3656	30	11	0	3711
13990	13	3839	14	10	0	3876
13991	3856	37	12	13	0	3918
13992	3764	13	11	20	0	3808
13993	51	7	3836	14	0	3908
13994	21	3923	34	17	0	3995
13995	19	45	16	3997	0	4077
13996	17	14	15	3990	0	4036
13997	10	13	6	3957	0	3986
13998	21	11	4070	47	0	4149
13999	17	11	33	3976	0	4037
14000	18	5	21	4191	0	4235
14001	4231	9	7	58	0	4305
14002	4203	11	11	27	0	4252
14003	4158	8	12	33	0	4211
14004	4089	9	8	21	0	4127
14005	4113	13	8	20	0	4154
14006	53	4119	13	11	0	4196
14007	3987	29	9	12	0	4037
14008	39	16	3983	10	0	4048
14009	21	10	30	3898	0	3959
14010	4011	14	6	27	0	4058
14011	38	4025	7	13	0	4083
14012	4090	23	8	20	0	4141
14013	4166	12	7	33	0	4218
14014	31	10	11	4197	0	4249
14015	17	9	4	4165	0	4195
14016	13	4398	10	32	0	4453
14017	19	25	5	4524	0	4573
14018	19	10	4661	31	0	4721
14019	25	4	30	4683	0	4742
14020	16	9	4757	36	0	4818
14021	4421	5	36	29	0	4491
14022	46	7	13	4809	0	4875
14023	18	7	4926	41	0	4992
14024	12	4746	46	14	0	4818
14025	16	4904	6	16	0	4942
14026	4873	34	14	16	0	4937
14027	41	13	6	4878	0	4938
14028	10	12	5054	25	0	5101
14029	11	4864	31	12	0	4918
14030	19	28	4905	12	0	4964
14031	4675	13	32	18	0	4738
14032	4821	9	8	9	0	4847
14033	4846	8	16	8	0	4878
14034	36	4	11	4859	0	4910
14035	14	8	4874	33	0	4929
14036	13	4870	33	10	0	4926
14037	10	23	10	4962	0	5005
14038	9	6	4889	32	0	4936
14039	15	11	4633	10	0	4669
14040	10	15	30	4852	0	4907
14041	4999	7	15	31	0	5052
14042	31	9	14	4980	0	5034
14043	10	5	13	5049	0	5077
14044	11	6	5111	32	0	5160
14045	12	9	34	5010	0	5065
14046	16	4	12	5015	0	5047
14047	11	4	5132	42	0	5189
14048	9	5	4977	21	0	5012
14049	12	5	31	5059	0	5107
14050	7	5	5179	40	0	5231
14051	11	3	40	5143	0	5197
14052	5240	6	17	45	0	5308
14053	25	5395	17	29	0	5466
14054	14	26	18	5514	0	5572
14055	14	7	5390	45	0	5456
14056	4709	10	34	43	0	4796
14057	32	5070	15	22	0	5139
14058	5172	26	19	27	0	5244
14059	35	10	16	5177	0	5238
14060	18	12	16	5124	0	5170
14061	5344	9	11	54	0	5418
14062	36	5	5347	27	0	5415
14063	5202	6	43	29	0	5280
14064	39	9	18	5435	0	5501
14065	5248	4	19	51	0	5322
14066	5235	8	18	28	0	5289
14067	49	6	8	5262	0	5325
14068	21	5403	20	65	0	5509
14069	5578	34	17	24	0	5653
14070	5561	16	10	34	0	5621
14071	64	14	5640	18	0	5736
14072	5551	10	47	18	0	5626
14073	75	13	15	5661	0	5764
14074	34	5738	21	57	0	5850
14075	31	48	14	5606	0	5699
14076	26	5717	14	58	0	5815
14077	5751	58	11	25	0	5845
14078	5767	20	18	27	0	5832
14079	75	15	12	6158	0	6260
14080	40	10	6175	84	0	6309
14081	39	21	5981	35	0	6076
14082	37	11	84	6313	0	6445
14083	6391	8	41	101	0	6541
14084	6752	9	37	51	0	6849
14085	115	6864	27	42	0	7048
14086	75	97	17	6966	0	7155
14087	44	48	7116	125	0	7333
14088	26	36	7277	65	0	7404
14089	27	40	190	7880	0	8137
14090	8465	15	85	217	0	8782
14091	233	5	45	8666	0	8949
14092	88	10	8506	262	0	8866
14093	8456	8	232	115	0	8811
14094	246	10	84	8587	0	8927
14095	101	13	60	8745	0	8919
14096	67	7	38	8698	0	8810
14097	50	8489	34	319	0	8892
14098	47	211	8425	140	0	8823
14099	34	74	8600	108	0	8816
14100	44	40	296	8578	0	8958
14101	27	25	8618	267	0	8937
14102	8360	22	293	127	0	8802
14103	255	10	119	8552	0	8936
14104	98	16	72	8689	0	8875
14105	75	15	51	8617	0	8758
14106	53	8514	54	347	0	8968
14107	8739	226	45	187	0	9197
14108	258	80	51	8776	0	9165
14109	8708	49	44	309	0	9110
14110	262	8697	37	176	0	9172
14111	8742	252	44	111	0	9149
14112	8485	96	38	97	0	8716
14113	8686	65	42	92	0	8885
14114	369	8272	40	83	0	8764
14115	167	8518	37	84	0	8806
14116	8200	295	36	74	0	8605
14117	295	8283	34	70	0	8682
14118	138	278	8022	81	0	8519
14119	93	7762	216	80	0	8151
14120	75	8155	100	61	0	8391
14121	8053	302	55	52	0	8462
14122	282	143	7880	45	0	8350
14123	152	80	7784	55	0	8071
14124	105	78	302	7681	0	8166
14125	7948	65	138	253	0	8404
14126	284	40	7920	124	0	8368
14127	144	56	258	7870	0	8328
14128	92	62	7643	271	0	8068
14129	65	71	7481	134	0	7751
14130	7374	57	317	93	0	7841
14131	283	48	7685	69	0	8085
14132	149	48	295	7450	0	7942
14133	89	54	157	7475	0	7775
14134	82	7388	107	305	0	7882
14135	96	7739	75	142	0	8052
14136	82	297	85	7470	0	7934
14137	81	127	7574	282	0	8064
14138	70	77	277	7531	0	7955
14139	68	66	134	7791	0	8059
14140	64	57	7736	365	0	8222
14141	52	43	302	7767	0	8164
14142	7800	41	144	366	0	8351
14143	273	50	7776	171	0	8270
14144	7710	47	300	126	0	8183
14145	316	41	155	7747	0	8259
14146	161	31	119	8040	0	8351
14147	111	7979	87	422	0	8599
14148	89	277	81	8113	0	8560
14149	80	121	68	8512	0	8781
14150	8200	82	101	464	0	8847
14151	310	46	90	8329	0	8775
14152	146	57	103	8500	0	8806
14153	7995	44	86	469	0	8594
14154	322	48	92	8186	0	8648
14155	172	49	93	7900	0	8214
14156	112	7967	77	445	0	8601
14157	8023	298	91	238	0	8650
14158	349	121	79	8108	0	8657
14159	162	83	62	8366	0	8673
14160	131	70	7937	474	0	8612
14161	84	69	282	7946	0	8381
14162	92	76	140	8194	0	8502
14163	7734	52	95	514	0	8395
14164	7912	61	70	285	0	8328
14165	432	64	79	7870	0	8445
14166	194	63	7542	409	0	8208
14167	159	7178	270	218	0	7825
14168	121	7513	144	156	0	7934
14169	112	323	93	7481	0	8009
14170	7442	153	78	364	0	8037
14171	302	119	65	7505	0	7991
14172	7566	74	25	374	0	8039
14173	324	60	47	7656	0	8087
14174	179	53	53	7726	0	8011
14175	7396	66	69	414	0	7945
14176	7393	56	48	243	0	7740
14177	396	7301	38	154	0	7889
14178	189	7729	39	117	0	8074
14179	131	311	37	7052	0	7531
14180	96	139	50	7256	0	7541
14181	84	78	6906	335	0	7403
14182	6173	74	223	180	0	6650
14183	242	6599	98	146	0	7085
14184	95	6367	56	111	0	6629
14185	6072	228	86	87	0	6473
14186	221	64	6033	92	0	6410
14187	118	46	5752	62	0	5978
14188	68	38	5359	89	0	5554
14189	37	4767	121	50	0	4975
14190	67	56	69	4185	0	4377
14191	24	20	10	4179	0	4233
14192	15	27	5	4201	0	4248
14193	4062	19	9	78	0	4168
14194	4040	4	7	54	0	4105
14195	67	4051	10	31	0	4159
14196	30	54	19	4156	0	4259
14197	28	25	4200	56	0	4309
14198	11	4215	45	32	0	4303
14199	4098	64	19	33	0	4214
14200	73	18	4168	20	0	4279
14201	3669	10	63	31	0	3773
14202	58	8	4117	20	0	4203
14203	30	20	58	3955	0	4063
14204	22	4105	16	59	0	4202
14205	4135	50	11	43	0	4239
14206	54	4146	12	36	0	4248
14207	4036	57	10	32	0	4135
14208	74	30	3	3996	0	4103
14209	37	20	4098	62	0	4217
14210	24	16	54	4213	0	4307
14211	17	10	22	4742	0	4791
14212	14	7	4716	117	0	4854
14213	4469	18	93	55	0	4635
14214	112	4819	29	30	0	4990
14215	4834	96	18	28	0	4976
14216	127	4891	9	27	0	5054
14217	34	111	18	5139	0	5302
14218	22	37	5066	137	0	5262
14219	5918	24	120	44	0	6106
14220	163	6192	32	45	0	6432
14221	67	167	16	6152	0	6402
14222	56	63	18	6444	0	6581
14223	6748	42	8	226	0	7024
14224	7161	20	23	91	0	7295
14225	253	7242	16	59	0	7570
14226	7813	207	11	36	0	8067
14227	7957	66	29	46	0	8098
14228	8157	46	18	43	0	8264
14229	344	35	7969	27	0	8375
14230	156	7728	209	38	0	8131
14231	76	8218	76	38	0	8408
14232	76	289	45	7688	0	8098
14233	70	113	27	8029	0	8239
14234	7964	59	27	292	0	8342
14235	245	7951	31	120	0	8347
14236	8048	259	15	79	0	8401
14237	268	114	16	7893	0	8291
14238	128	57	14	8172	0	8371
14239	7897	44	17	329	0	8287
14240	7896	46	16	131	0	8089
14241	339	49	7585	80	0	8053
14242	173	31	211	7541	0	7956
14243	87	18	7429	264	0	7798
14244	71	28	7356	128	0	7583
14245	69	36	7527	64	0	7696
14246	7160	39	297	38	0	7534
14247	229	22	138	7048	0	7437
14248	113	15	72	7129	0	7329
14249	74	18	60	7314	0	7466
14250	53	26	7114	301	0	7494
14251	47	26	228	7099	0	7400
14252	63	20	92	7302	0	7477
14253	7067	20	56	318	0	7461
14254	7211	11	27	160	0	7409
14255	7312	27	30	100	0	7469
14256	7325	20	46	70	0	7461
14257	352	26	38	7049	0	7465
14258	7143	35	23	277	0	7478
14259	315	27	36	7107	0	7485
14260	187	31	6675	282	0	7175
14261	6907	32	198	130	0	7267
14262	305	6902	81	87	0	7375
14263	165	220	48	6845	0	7278
14264	146	108	43	6884	0	7181
14265	101	6938	43	294	0	7376
14266	6927	223	48	160	0	7358
14267	281	6884	36	96	0	7297
14268	146	264	6761	83	0	7254
14269	101	123	6853	101	0	7178
14270	6720	75	273	101	0	7169
14271	6986	55	138	94	0	7273
14272	362	53	6690	74	0	7179
14273	6749	62	238	75	0	7124
14274	340	46	6757	69	0	7212
14275	6776	35	274	88	0	7173
14276	351	37	6727	76	0	7191
14277	199	45	6897	85	0	7226
14278	142	50	336	6429	0	6957
14279	116	38	175	6608	0	6937
14280	6707	40	126	342	0	7215
14281	6666	33	84	177	0	6960
14282	6645	45	97	130	0	6917
14283	6939	41	93	93	0	7166
14284	400	6555	68	129	0	7152
14285	232	207	54	6482	0	6975
14286	187	6624	68	277	0	7156
14287	159	234	68	6701	0	7162
14288	152	103	82	6718	0	7055
14289	148	77	70	6806	0	7101
14290	130	66	6479	394	0	7069
14291	6348	46	234	234	0	6862
14292	316	6230	131	146	0	6823
14293	200	6542	80	141	0	6963
14294	165	280	6538	150	0	7133
14295	140	142	245	6543	0	7070
14296	132	76	141	6631	0	6980
14297	6498	57	102	368	0	7025
14298	318	67	77	6507	0	6969
14299	181	72	80	6677	0	7010
14300	152	63	81	6717	0	7013
14301	150	44	75	6837	0	7106
14302	6485	42	90	408	0	7025
14303	6650	38	75	219	0	6982
14304	6710	47	85	168	0	7010
14305	384	38	97	6581	0	7100
14306	6645	39	79	335	0	7098
14307	338	46	94	6724	0	7202
14308	239	30	92	6962	0	7323
14309	175	30	6550	387	0	7142
14310	165	25	6359	220	0	6769
14311	133	25	6045	152	0	6355
14312	5913	37	310	122	0	6382
14313	272	43	162	5472	0	5949
14314	173	5789	117	241	0	6320
14315	5943	167	110	163	0	6383
14316	275	77	5775	138	0	6265
14317	5504	51	211	107	0	5873
14318	314	5326	125	86	0	5851
14319	4428	116	59	67	0	4670
14320	216	52	38	4384	0	4690
14321	4343	26	48	159	0	4576
14322	195	4096	44	83	0	4418
14323	110	3938	36	74	0	4158
14324	3457	110	49	58	0	3674
14325	128	3419	29	51	0	3627
14326	37	2682	16	25	0	2760
14327	59	2687	23	24	0	2793
14328	2484	61	75	15	0	2635
14329	2409	27	4	12	0	2452
14330	2442	18	5	8	0	2473
14331	61	9	5	2383	0	2458
14332	27	12	4	2429	0	2472
14333	21	11	2380	50	0	2462
14334	17	12	36	2382	0	2447
14335	20	6	2441	44	0	2511
14336	20	6	37	2422	0	2485
14337	19	7	20	2471	0	2517
14338	2427	9	10	64	0	2510
14339	2402	8	12	34	0	2456
14340	56	2387	12	20	0	2475
14341	29	35	12	2421	0	2497
14342	19	17	2469	42	0	2547
14343	19	15	37	2466	0	2537
14344	16	9	21	2487	0	2533
14345	22	8	9	2516	0	2555
14346	19	6	2408	60	0	2493
14347	12	10	2311	35	0	2368
14348	2389	5	50	26	0	2470
14349	45	5	26	2489	0	2565
14350	25	2	2477	50	0	2554
14351	2357	6	42	34	0	2439
14352	41	2563	20	24	0	2648
14353	2603	40	15	23	0	2681
14354	53	18	2696	17	0	2784
14355	2626	10	38	18	0	2692
14356	45	9	25	2705	0	2784
14357	25	11	2756	42	0	2834
14358	23	2736	41	20	0	2820
14359	2770	34	22	18	0	2844
14360	51	15	13	2746	0	2825
14361	23	16	13	2739	0	2791
14362	17	2764	14	52	0	2847
14363	14	29	12	2819	0	2874
14364	16	21	2776	40	0	2853
14365	10	2766	35	31	0	2842
14366	2796	35	24	21	0	2876
14367	41	18	10	2763	0	2832
14368	24	16	7	2773	0	2820
14369	22	11	2751	47	0	2831
14370	12	17	31	2756	0	2816
14371	18	22	2861	38	0	2939
14372	12	2891	37	26	0	2966
14373	2840	38	25	22	0	2925
14374	2822	17	13	18	0	2870
14375	2827	9	10	20	0	2866
14376	49	2959	11	20	0	3039
14377	27	33	9	2927	0	2996
14378	21	19	12	2936	0	2988
14379	26	17	24	2468	0	2535
14380	2883	9	9	60	0	2961
14381	2865	6	10	34	0	2915
14382	47	6	8	2862	0	2923
14383	23	10	3159	46	0	3238
14384	17	9	34	3131	0	3191
14385	18	6	19	3162	0	3205
14386	20	4	10	3148	0	3182
14387	18	6	7	3154	0	3185
14388	3180	10	9	63	0	3262
14389	37	8	13	3219	0	3277
14390	23	5	9	3241	0	3278
14391	10	3249	8	63	0	3330
14392	14	33	5	3353	0	3405
14393	14	3391	8	62	0	3475
14394	15	46	4	3375	0	3440
14395	3329	21	12	55	0	3417
14396	47	3371	9	28	0	3455
14397	3348	44	10	28	0	3430
14398	53	21	3426	22	0	3522
14399	28	13	48	3348	0	3437
14400	26	9	3491	60	0	3586
14401	21	6	49	3466	0	3542
14402	12	15	22	3484	0	3533
14403	13	3390	18	79	0	3500
14404	13	3521	11	44	0	3589
14405	9	3628	9	24	0	3670
14406	3562	45	13	24	0	3644
14407	40	3436	2	11	0	3489
14408	17	3444	0	9	0	3470
14409	27	36	5	3455	0	3523
14410	3463	12	2	42	0	3519
14411	27	3618	8	14	0	3667
14412	3650	28	3	23	0	3704
14413	3638	10	6	17	0	3671
14414	38	8	3723	17	0	3786
14415	18	8	28	3613	0	3667
14416	7	7	9	3818	0	3841
14417	10	4	3	3828	0	3845
14418	4	12	4	3753	0	3773
14419	5	10	3623	40	0	3678
14420	7	5	3259	26	0	3297
14421	3358	9	27	20	0	3414
14422	29	3571	9	15	0	3624
14423	15	3643	4	5	0	3667
14424	3695	32	1	10	0	3738
14425	27	3656	6	5	0	3694
14426	12	29	5	3751	0	3797
14427	3746	11	3	37	0	3797
14428	30	5	3720	13	0	3768
14429	8	3	24	3766	0	3801
14430	10	5	3806	31	0	3852
14431	3685	7	26	20	0	3738
14432	40	5	4125	14	0	4184
14433	4164	14	33	11	0	4222
14434	4377	3	9	26	0	4415
14435	4377	7	8	11	0	4403
14436	4375	12	5	14	0	4406
14437	4411	7	1	17	0	4436
14438	51	7	5	4376	0	4439
14439	4557	10	6	49	0	4622
14440	50	4	9	4579	0	4642
14441	17	4	9	4586	0	4616
14442	7	3	12	4670	0	4692
14443	10	8	4605	56	0	4679
14444	8	5	43	4475	0	4531
14445	9	10	14	4674	0	4707
14446	13	6	4576	50	0	4645
14447	4143	11	36	28	0	4218
14448	45	12	15	4664	0	4736
14449	23	5	4677	49	0	4754
14450	18	10	4502	10	0	4540
14451	11	11	41	4513	0	4576
14452	17	4	4702	45	0	4768
14453	20	9	39	4686	0	4754
14454	13	3	22	4620	0	4658
14455	12	4607	9	56	0	4684
14456	8	4706	6	23	0	4743
14457	4756	41	7	20	0	4824
14458	39	12	8	4803	0	4862
14459	20	7	11	4727	0	4765
14460	10	5	13	4881	0	4909
14461	19	2	4917	53	0	4991
14462	13	7	39	4727	0	4786
14463	4860	7	16	49	0	4932
14464	45	6	4956	27	0	5034
14465	20	5	41	5054	0	5120
14466	7	9	12	5056	0	5084
14467	17	4	5	5199	0	5225
14468	8	5372	9	50	0	5439
14469	5418	54	6	28	0	5506
14470	5612	21	5	26	0	5664
14471	97	5733	12	12	0	5854
14472	34	68	11	6096	0	6209
14473	19	23	6085	94	0	6221
14474	24	14	5807	45	0	5890
14475	6053	10	122	25	0	6210
14476	113	14	45	6263	0	6435
14477	6558	4	32	111	0	6705
14478	130	6618	14	59	0	6821
14479	60	6815	11	32	0	6918
14480	6781	164	15	29	0	6989
14481	129	7100	18	24	0	7271
14482	59	145	10	7188	0	7402
14483	44	58	9	6907	0	7018
14484	23	7270	12	154	0	7459
14485	7347	141	8	65	0	7561
14486	146	70	7401	38	0	7655
14487	7073	42	129	39	0	7283
14488	183	30	7529	25	0	7767
14489	6861	24	165	39	0	7089
14490	182	17	7552	26	0	7777
14491	80	7419	162	32	0	7693
14492	51	147	68	7528	0	7794
14493	7473	55	41	152	0	7721
14494	157	34	7367	58	0	7616
14495	80	24	7434	27	0	7565
14496	52	18	199	7191	0	7460
14497	37	14	7454	151	0	7656
14498	31	14	174	7223	0	7442
14499	29	18	85	7112	0	7244
14500	34	11	7353	211	0	7609
14501	30	8	173	7196	0	7407
14502	7433	9	84	180	0	7706
14503	134	7330	55	89	0	7608
14504	7484	140	35	57	0	7716
14505	156	59	35	7342	0	7592
14506	7365	28	22	178	0	7593
14507	7478	24	34	106	0	7642
14508	217	21	29	7353	0	7620
14509	97	7514	22	176	0	7809
14510	7589	150	27	75	0	7841
14511	185	70	7305	54	0	7614
14512	100	31	7260	46	0	7437
14513	7149	33	191	52	0	7425
14514	194	19	80	7233	0	7526
14515	96	16	7303	161	0	7576
14516	55	26	164	7244	0	7489
14517	7349	24	72	175	0	7620
14518	7558	21	48	105	0	7732
14519	7543	17	47	45	0	7652
14520	221	7609	40	46	0	7916
14521	111	142	33	7760	0	8046
14522	70	63	34	7796	0	7963
14523	7707	38	39	220	0	8004
14524	169	7682	32	114	0	7997
14525	7737	145	24	70	0	7976
14526	206	65	28	7649	0	7948
14527	7623	39	29	183	0	7874
14528	198	41	7310	89	0	7638
14529	100	7396	149	72	0	7717
14530	106	165	78	7145	0	7494
14531	71	7531	42	140	0	7784
14532	72	169	37	7308	0	7586
14533	7243	79	33	181	0	7536
14534	184	46	6986	100	0	7316
14535	6778	41	156	69	0	7044
14536	181	7180	89	47	0	7497
14537	104	165	42	7387	0	7698
14538	69	76	40	7543	0	7728
14539	7282	56	29	219	0	7586
14540	189	33	7169	116	0	7507
14541	104	36	157	7249	0	7546
14542	78	29	81	7255	0	7443
14543	76	30	56	7308	0	7470
14544	54	37	44	7348	0	7483
14545	7171	23	40	254	0	7488
14546	7131	32	32	146	0	7341
14547	228	20	7030	90	0	7368
14548	124	34	6712	82	0	6952
14549	7106	28	186	85	0	7405
14550	7414	23	98	92	0	7627
14551	224	19	55	7302	0	7600
14552	130	23	54	7281	0	7488
14553	7149	22	53	216	0	7440
14554	182	6982	48	132	0	7344
14555	123	119	48	7104	0	7394
14556	88	57	42	7250	0	7437
14557	85	34	7011	222	0	7352
14558	80	31	150	6960	0	7221
14559	60	31	7093	219	0	7403
14560	73	19	163	7076	0	7331
14561	6945	31	81	214	0	7271
14562	176	28	58	7002	0	7264
14563	104	24	6891	216	0	7235
14564	72	6539	151	136	0	6898
14565	72	140	82	6848	0	7142
14566	67	60	6826	195	0	7148
14567	54	6813	160	126	0	7153
14568	73	141	80	6739	0	7033
14569	51	57	6659	167	0	6934
14570	5463	28	135	131	0	5757
14571	131	6294	65	71	0	6561
14572	62	6003	49	60	0	6174
14573	45	6177	42	64	0	6328
14574	58	165	37	5984	0	6244
14575	41	55	6207	121	0	6424
14576	32	6164	114	63	0	6373
14577	44	177	44	5967	0	6232
14578	6323	35	33	125	0	6516
14579	124	30	23	8415	0	8592
14580	83	15	9845	266	0	10209
14581	41	9813	312	100	0	10266
14582	9581	327	91	68	0	10067
14583	329	9798	50	71	0	10248
14584	98	367	9337	55	0	9857
14585	47	9448	339	51	0	9885
14586	73	403	135	9177	0	9788
14587	49	171	9222	307	0	9749
14588	54	9141	364	92	0	9651
14589	73	418	132	8920	0	9543
14590	52	190	96	8996	0	9334
14591	27	9068	106	407	0	9608
14592	18	412	102	9103	0	9635
14593	21	197	9007	424	0	9649
14594	34	141	9218	202	0	9595
14595	28	140	413	9084	0	9665
14596	8962	118	170	438	0	9688
14597	9143	113	112	229	0	9597
14598	372	108	104	8814	0	9398
14599	123	8943	129	414	0	9609
14600	90	359	132	9031	0	9612
14601	8866	130	122	449	0	9567
14602	391	86	82	8973	0	9532
14603	199	105	50	9167	0	9521
14604	8824	87	40	542	0	9493
14605	388	8737	63	274	0	9462
14606	157	384	62	8818	0	9421
14607	8688	146	49	509	0	9392
14608	434	95	8437	266	0	9232
14609	8489	78	325	215	0	9107
14610	442	79	111	8654	0	9286
14611	8642	109	67	459	0	9277
14612	8733	91	66	242	0	9132
14613	8145	96	69	203	0	8513
14614	491	8351	81	167	0	9090
14615	271	337	8253	157	0	9018
14616	245	8407	346	135	0	9133
14617	8369	375	120	139	0	9003
14618	482	8317	71	136	0	9006
14619	298	402	67	8312	0	9079
14620	8084	206	79	381	0	8750
14621	449	8160	78	157	0	8844
14622	208	454	8085	127	0	8874
14623	180	228	369	8093	0	8870
14624	198	176	8097	408	0	8879
14625	162	8183	378	234	0	8957
14626	138	451	161	8038	0	8788
14627	132	205	130	8376	0	8843
14628	107	179	119	8453	0	8858
14629	125	141	130	8064	0	8460
14630	86	8052	118	546	0	8802
14631	7899	439	106	310	0	8754
14632	402	203	7876	258	0	8739
14633	160	161	377	8083	0	8781
14634	7939	135	149	545	0	8768
14635	436	110	7880	318	0	8744
14636	186	7731	426	228	0	8571
14637	153	457	187	7596	0	8393
14638	161	208	7702	466	0	8537
14639	132	7776	442	275	0	8625
14640	7449	430	212	250	0	8341
14641	409	7769	140	225	0	8543
14642	182	496	147	7661	0	8486
14643	143	263	119	8057	0	8582
14644	7637	203	147	565	0	8552
14645	420	7728	151	305	0	8604
14646	220	492	132	7801	0	8645
14647	7549	261	157	506	0	8473
14648	7640	257	112	284	0	8293
14649	518	7474	95	300	0	8387
14650	7521	500	110	250	0	8381
14651	7791	295	77	225	0	8388
14652	589	225	89	7460	0	8363
14653	293	211	7279	526	0	8309
14654	291	183	389	7369	0	8232
14655	255	173	154	7613	0	8195
14656	237	168	7110	606	0	8121
14657	240	7072	402	330	0	8044
14658	208	423	158	7181	0	7970
14659	183	201	152	7507	0	8043
14660	178	124	174	7572	0	8048
14661	152	132	158	7276	0	7718
14662	181	7076	132	651	0	8040
14663	7181	430	120	383	0	8114
14664	7303	198	86	338	0	7925
14665	7288	158	78	336	0	7860
14666	530	6821	72	378	0	7801
14667	273	452	60	6950	0	7735
14668	218	225	6683	585	0	7711
14669	247	217	352	6656	0	7472
14670	257	6854	121	513	0	7745
14671	6741	431	91	285	0	7548
14672	6866	224	67	254	0	7411
14673	6752	178	80	232	0	7242
14674	539	6431	109	223	0	7302
14675	283	6208	131	214	0	6836
14676	254	6497	101	197	0	7049
14677	302	457	6083	160	0	7002
14678	281	334	5631	163	0	6409
14679	260	757	243	2653	0	3913
14680	1943	35	76	75	0	2129
14681	1917	8	13	21	0	1959
14682	61	14	11	1950	0	2036
14683	24	8	14	1925	0	1971
14684	14	18	8	2016	0	2056
14685	13	13	6	2031	0	2063
14686	2019	13	13	74	0	2119
14687	2101	15	7	30	0	2153
14688	63	2130	7	26	0	2226
14689	2119	64	9	26	0	2218
14690	2175	28	6	17	0	2226
14691	2222	16	3	20	0	2261
14692	74	28	1827	21	0	1950
14693	2104	13	49	18	0	2184
14694	76	2139	13	20	0	2248
14695	38	64	9	2205	0	2316
14696	27	25	9	2228	0	2289
14697	29	2130	10	79	0	2248
14698	23	67	11	2241	0	2342
14699	2212	17	13	91	0	2333
14700	71	18	6	2249	0	2344
14701	32	13	2188	84	0	2317
14702	2093	12	64	31	0	2200
14703	79	2207	15	23	0	2324
14704	31	72	14	2213	0	2330
14705	29	27	8	2264	0	2328
14706	29	20	6	2283	0	2338
14707	25	16	2192	88	0	2321
14708	25	2149	64	39	0	2277
14709	27	68	13	2171	0	2279
14710	29	21	2108	82	0	2240
14711	31	13	71	2100	0	2215
14712	25	19	2084	86	0	2214
14713	27	33	64	2010	0	2134
14714	24	2025	20	77	0	2146
14715	21	57	9	2032	0	2119
14716	1998	24	14	82	0	2118
14717	2029	20	10	29	0	2088
14718	83	19	1964	31	0	2097
14719	39	8	1860	19	0	1926
14720	24	14	2077	12	0	2127
14721	18	12	57	2042	0	2129
14722	11	12	27	2150	0	2200
14723	11	9	18	2208	0	2246
14724	11	2210	12	91	0	2324
14725	17	65	15	2176	0	2273
14726	18	21	10	2321	0	2370
14727	15	17	10	2414	0	2456
14728	2360	13	10	96	0	2479
14729	2360	7	9	47	0	2423
14730	83	13	2338	34	0	2468
14731	26	12	2310	31	0	2379
14732	2305	6	78	26	0	2415
14733	2433	10	28	24	0	2495
14734	92	15	2504	17	0	2628
14735	41	7	2439	22	0	2509
14736	2407	11	83	14	0	2515
14737	2491	4	30	21	0	2546
14738	76	7	2502	17	0	2602
14739	31	5	71	2452	0	2559
14740	21	8	28	2478	0	2535
14741	21	2558	12	81	0	2672
14742	12	71	14	2622	0	2719
14743	12	20	2733	97	0	2862
14744	16	13	77	2779	0	2885
14745	21	15	27	2828	0	2891
14746	18	0	2746	110	0	2874
14747	2635	8	94	36	0	2773
14748	2820	4	27	39	0	2890
14749	102	4	22	2737	0	2865
14750	40	7	24	2812	0	2883
14751	2756	7	21	105	0	2889
14752	2765	5	14	47	0	2831
14753	2471	12	14	53	0	2550
14754	2810	11	16	30	0	2867
14755	104	2699	22	26	0	2851
14756	2701	71	17	21	0	2810
14757	91	2704	9	31	0	2835
14758	35	82	19	2705	0	2841
14759	29	23	14	2719	0	2785
14760	29	2634	18	107	0	2788
14761	18	84	12	2691	0	2805
14762	17	16	14	2695	0	2742
14763	27	2644	20	105	0	2796
14764	31	77	13	2661	0	2782
14765	28	20	15	2722	0	2785
14766	26	14	19	2736	0	2795
14767	25	16	2627	111	0	2779
14768	24	2536	77	54	0	2691
14769	27	77	24	2366	0	2494
14770	18	2522	23	91	0	2654
14771	2475	81	20	38	0	2614
14772	86	35	2406	28	0	2555
14773	41	15	2360	28	0	2444
14774	2268	21	85	26	0	2400
14775	81	14	39	2322	0	2456
14776	26	8	2274	61	0	2369
14777	29	10	2203	27	0	2269
14778	19	17	62	2157	0	2255
14779	2128	5	30	78	0	2241
14780	2158	11	22	33	0	2224
14781	67	9	15	2143	0	2234
14782	34	6	2084	73	0	2197
14783	27	2151	51	25	0	2254
14784	25	44	18	2155	0	2242
14785	15	22	2144	64	0	2245
14786	13	2122	61	34	0	2230
14787	12	46	17	2065	0	2140
14788	2065	13	16	64	0	2158
14789	50	14	18	2004	0	2086
14790	17	2066	15	63	0	2161
14791	2051	44	11	32	0	2138
14792	60	17	2134	27	0	2238
14793	22	2071	48	34	0	2175
14794	24	44	2110	20	0	2198
14795	2005	19	50	25	0	2099
14796	51	12	18	1962	0	2043
14797	25	6	24	2064	0	2119
14798	2060	9	12	63	0	2144
14799	53	7	14	2059	0	2133
14800	25	11	2010	57	0	2103
14801	1961	5	41	33	0	2040
14802	50	2047	27	21	0	2145
14803	24	45	20	2026	0	2115
14804	2034	10	19	52	0	2115
14805	53	1999	12	22	0	2086
14806	24	46	12	2089	0	2171
14807	2065	18	14	55	0	2152
14808	52	20	8	2065	0	2145
14809	18	2038	9	68	0	2133
14810	23	45	2084	35	0	2187
14811	16	19	44	2136	0	2215
14812	18	15	28	2046	0	2107
14813	2193	14	13	68	0	2288
14814	49	10	13	2203	0	2275
14815	2192	11	13	64	0	2280
14816	2225	11	7	35	0	2278
14817	65	6	12	2162	0	2245
14818	29	2193	2	57	0	2281
14819	29	44	5	2173	0	2251
14820	1962	16	8	60	0	2046
14821	48	2014	10	23	0	2095
14822	15	2099	7	13	0	2134
14823	2064	39	6	16	0	2125
14824	2093	17	5	11	0	2126
14825	53	2088	6	17	0	2164
14826	2058	52	35	19	0	2164
14827	2075	9	7	10	0	2101
14828	50	8	2	2060	0	2120
14829	14	8	2116	57	0	2195
14830	16	6	55	2113	0	2190
14831	5	9	2210	67	0	2291
14832	15	8	53	2212	0	2288
14833	12	4	2251	62	0	2329
14834	2094	6	52	18	0	2170
14835	51	6	16	2160	0	2233
14836	2282	1	12	55	0	2350
14837	65	14	7	2227	0	2313
14838	20	2250	6	57	0	2333
14839	2293	49	7	29	0	2378
14840	64	17	2193	16	0	2290
14841	2102	9	32	15	0	2158
14842	62	2197	14	13	0	2286
14843	2059	40	17	6	0	2122
14844	2094	9	5	13	0	2121
14845	50	2085	5	8	0	2148
14846	19	46	6	2173	0	2244
14847	2189	15	6	50	0	2260
14848	64	2184	3	15	0	2266
14849	15	51	4	2233	0	2303
14850	2251	14	4	59	0	2328
14851	62	15	3	2240	0	2320
14852	25	7	6	2230	0	2268
14853	18	5	4	2288	0	2315
14854	17	14	2185	66	0	2282
14855	14	9	51	2177	0	2251
14856	2217	2	11	68	0	2298
14857	67	12	2209	17	0	2305
14858	19	7	54	2256	0	2336
14859	25	5	13	2301	0	2344
14860	15	8	2243	77	0	2343
14861	2141	6	60	30	0	2237
14862	2348	5	12	29	0	2394
14863	73	9	2315	20	0	2417
14864	26	2	57	2288	0	2373
14865	23	5	15	2390	0	2433
14866	14	8	2497	72	0	2591
14867	17	3	59	2516	0	2595
14868	28	2	16	2528	0	2574
14869	14	5	2619	85	0	2723
14870	2512	6	67	41	0	2626
14871	72	4	17	2695	0	2788
14872	2674	5	25	85	0	2789
14873	2743	3	16	39	0	2801
14874	92	8	2723	32	0	2855
14875	37	4	76	2694	0	2811
14876	2756	1	20	98	0	2875
14877	79	2764	17	46	0	2906
14878	25	64	27	2883	0	2999
14879	36	13	13	2936	0	2998
14880	21	10	14	3008	0	3053
14881	15	4	2919	113	0	3051
14882	2676	5	76	55	0	2812
14883	89	4	30	2851	0	2974
14884	32	4	22	2898	0	2956
14885	35	3	2805	112	0	2955
14886	21	8	83	2786	0	2898
14887	15	4	32	2900	0	2951
14888	2796	5	20	113	0	2934
14889	92	2750	17	53	0	2912
14890	31	71	2742	39	0	2883
14891	2723	17	77	39	0	2856
14892	78	14	30	2707	0	2829
14893	36	10	2769	101	0	2916
14894	36	10	2864	33	0	2943
14895	22	10	96	2879	0	3007
14896	19	4	2926	117	0	3066
14897	27	6	2918	42	0	2993
14898	17	2844	105	39	0	3005
14899	15	68	45	3090	0	3218
14900	32	19	3108	97	0	3256
14901	20	17	89	3015	0	3141
14902	3236	9	37	108	0	3390
14903	85	8	33	3268	0	3394
14904	28	8	20	3380	0	3436
14905	3279	8	18	117	0	3422
14906	3291	6	32	48	0	3377
14907	97	11	23	3407	0	3538
14908	43	1	3447	124	0	3615
14909	33	3394	91	40	0	3558
14910	24	81	36	3458	0	3599
14911	3442	20	23	113	0	3598
14912	3446	13	22	54	0	3535
14913	100	3309	27	45	0	3481
14914	51	3471	25	34	0	3581
14915	3450	88	22	42	0	3602
14916	3493	33	16	47	0	3589
14917	107	21	3655	35	0	3818
14918	49	22	98	3532	0	3701
14919	34	3678	29	111	0	3852
14920	3875	77	24	55	0	4031
14921	98	35	30	3821	0	3984
14922	45	3724	19	96	0	3884
14923	38	83	3757	50	0	3928
14924	34	38	82	3565	0	3719
14925	20	3912	41	82	0	4055
14926	3914	70	26	45	0	4055
14927	3909	26	11	47	0	3993
14928	91	3903	13	37	0	4044
14929	3863	67	16	23	0	3969
14930	3857	25	14	32	0	3928
14931	83	3725	13	28	0	3849
14932	41	3818	16	25	0	3900
14933	50	71	17	3791	0	3929
14934	3808	30	17	67	0	3922
14935	66	19	3888	33	0	4006
14936	3680	13	50	32	0	3775
14937	55	3867	24	22	0	3968
14938	3912	49	25	28	0	4014
14939	3961	20	10	20	0	4011
14940	3955	19	12	18	0	4004
14941	75	16	10	3846	0	3947
14942	39	3861	12	60	0	3972
14943	3877	52	15	26	0	3970
14944	64	25	3897	21	0	4007
14945	23	3893	52	25	0	3993
14946	28	54	24	4026	0	4132
14947	16	18	3920	52	0	4006
14948	12	14	3913	26	0	3965
14949	21	15	50	3841	0	3927
14950	20	14	24	4100	0	4158
14951	16	6	24	4168	0	4214
14952	15	3	24	4046	0	4088
14953	15	3940	8	72	0	4035
14954	16	4123	10	39	0	4188
14955	4164	51	11	33	0	4259
14956	51	30	12	4189	0	4282
14957	31	24	8	4202	0	4265
14958	24	10	13	4286	0	4333
14959	4212	8	13	75	0	4308
14960	4235	14	10	31	0	4290
14961	61	10	5	4236	0	4312
14962	4269	12	4	68	0	4353
14963	4286	12	4	29	0	4331
14964	4402	7	7	25	0	4441
14965	68	11	10	4299	0	4388
14966	32	19	4071	37	0	4159
14967	34	16	3748	24	0	3822
14968	33	3	3890	25	0	3951
14969	15	8	4097	13	0	4133
14970	20	31	45	4053	0	4149
14971	4098	9	30	36	0	4173
14972	4040	11	11	17	0	4079
14973	46	6	4044	14	0	4110
14974	28	3	3965	13	0	4009
14975	13	4479	36	10	0	4538
14976	16	28	15	4534	0	4593
14977	4565	11	14	28	0	4618
14978	28	11	4502	13	0	4554
14979	4304	7	21	15	0	4347
14980	27	4657	11	11	0	4706
14981	16	20	6	4856	0	4898
14982	10	7	5	4998	0	5020
14983	16	8	5	4825	0	4854
14984	5061	6	4	39	0	5110
14985	37	2	5	5047	0	5091
14986	12	6	6	5113	0	5137
14987	5094	4	3	50	0	5151
14988	40	3	4	5072	0	5119
14989	19	1	5256	41	0	5317
14990	5102	3	33	24	0	5162
14991	43	3	11	5300	0	5357
14992	20	2	4	5242	0	5268
14993	14	5230	6	45	0	5295
14994	5253	27	3	25	0	5308
14995	5325	16	4	21	0	5366
14996	51	9	1	5246	0	5307
14997	17	5	5228	42	0	5292
14998	4841	2	37	25	0	4905
14999	47	5	5202	13	0	5267
15000	23	1	39	5123	0	5186
15001	15	3	19	5365	0	5402
15002	5313	3	6	56	0	5378
15003	46	2	9	5477	0	5534
15004	17	3	5483	53	0	5556
15005	5261	4	49	24	0	5338
15006	52	2	5852	16	0	5922
15007	24	2	5803	14	0	5843
15008	5887	1	75	25	0	5988
15009	76	4	27	6161	0	6268
15010	29	6372	20	44	0	6465
15011	6473	52	23	29	0	6577
15012	6486	18	15	13	0	6532
15013	90	5	6417	15	0	6527
15014	6357	10	60	13	0	6440
15015	79	5	19	6643	0	6746
15016	41	5	6802	60	0	6908
15017	21	6545	73	32	0	6671
15018	6539	53	32	17	0	6641
15019	65	6669	12	16	0	6762
15020	41	54	19	6641	0	6755
15021	12	28	11	6689	0	6740
15022	23	8	8	6683	0	6722
15023	19	12	7	6469	0	6507
15024	13	6539	12	81	0	6645
15025	12	56	6302	39	0	6409
15026	10	6423	59	35	0	6527
15027	6467	54	23	21	0	6565
15028	58	27	9	6506	0	6600
15029	6540	14	11	61	0	6626
15030	69	19	8	6546	0	6642
15031	6751	10	9	76	0	6846
15032	65	6812	7	41	0	6925
15033	7040	52	9	35	0	7136
15034	7049	21	4	31	0	7105
15035	6916	9	7	23	0	6955
15036	6968	14	12	18	0	7012
15037	90	6931	7	15	0	7043
15038	49	58	6931	14	0	7052
15039	31	26	58	6916	0	7031
15040	7000	7	21	76	0	7104
15041	7114	11	5	37	0	7167
15042	85	13	13	7144	0	7255
15043	38	9	7345	83	0	7475
15044	35	11	72	7140	0	7258
15045	31	7355	26	85	0	7497
15046	7417	72	13	35	0	7537
15047	85	33	11	7452	0	7581
15048	43	7267	17	92	0	7419
15049	18	7698	8	55	0	7779
15050	20	7909	9	27	0	7965
15051	32	118	6	8022	0	8178
15052	8039	38	6	103	0	8186
15053	100	8091	14	35	0	8240
15054	55	102	7	8183	0	8347
15055	8129	38	10	107	0	8284
15056	109	16	13	8169	0	8307
15057	8152	21	7	112	0	8292
15058	8170	12	9	57	0	8248
15059	138	8554	2	29	0	8723
15060	77	101	10	8272	0	8460
15061	41	8676	7	93	0	8817
15062	8632	105	13	47	0	8797
15063	8608	45	13	23	0	8689
15064	8716	30	8	42	0	8796
15065	146	19	26	8709	0	8900
15066	60	31	8593	118	0	8802
15067	8337	21	96	53	0	8507
15068	8708	27	35	26	0	8796
15069	155	23	5	8528	0	8711
15070	55	8693	20	113	0	8881
15071	50	112	12	8774	0	8948
15072	46	54	14	8903	0	9017
15073	8850	34	15	148	0	9047
15074	8732	23	13	71	0	8839
15075	169	32	8256	40	0	8497
15076	73	28	109	8243	0	8453
15077	8416	22	40	139	0	8617
15078	158	28	12	8408	0	8606
15079	73	22	8439	149	0	8683
15080	46	7949	109	86	0	8190
15081	41	8319	39	46	0	8445
15082	8889	139	13	56	0	9097
15083	154	67	24	9511	0	9756
15084	78	31	18	10624	0	10751
15085	10625	30	19	284	0	10958
15086	256	35	10534	103	0	10928
15087	109	24	214	10631	0	10978
15088	78	24	10694	277	0	11073
15089	65	10734	234	119	0	11152
15090	11000	226	99	78	0	11403
15091	11290	78	54	81	0	11503
15092	11501	56	48	59	0	11664
15093	360	53	11066	62	0	11541
15094	11276	47	228	60	0	11611
15095	11660	31	94	46	0	11831
15096	400	33	52	11476	0	11961
15097	9445	68	101	303	0	9917
15098	267	34	11156	115	0	11572
15099	11093	35	223	74	0	11425
15100	331	27	11192	70	0	11620
15101	183	11465	246	66	0	11960
15102	149	307	126	10487	0	11069
15103	122	11524	71	203	0	11920
15104	136	245	11236	79	0	11696
15105	92	11460	243	67	0	11862
15106	10787	275	86	82	0	11230
15107	238	10695	64	54	0	11051
15108	111	10734	61	38	0	10944
15109	98	274	10432	36	0	10840
15110	95	126	220	10248	0	10689
15111	10476	91	84	229	0	10880
15112	249	86	10426	93	0	10854
15113	128	10479	245	71	0	10923
15114	96	225	99	10465	0	10885
15115	86	103	10520	246	0	10955
15116	83	71	10310	105	0	10569
15117	61	83	294	10392	0	10830
15118	90	61	10548	257	0	10956
15119	91	52	287	9657	0	10087
15120	72	9982	139	234	0	10427
15121	67	223	116	10065	0	10471
15122	69	10269	89	240	0	10667
15123	79	248	73	10347	0	10747
15124	10136	114	78	285	0	10613
15125	260	86	68	10091	0	10505
15126	116	10036	72	279	0	10503
15127	93	253	71	10399	0	10816
15128	91	104	10211	296	0	10702
15129	78	82	243	10270	0	10673
15130	10294	74	101	310	0	10779
15131	252	67	9946	168	0	10433
15132	113	65	283	9904	0	10365
15133	9709	58	122	300	0	10189
15134	277	9673	86	148	0	10184
15135	144	253	97	9708	0	10202
15136	9783	121	58	297	0	10259
15137	316	77	83	9818	0	10294
15138	155	70	9772	317	0	10314
15139	9431	72	239	178	0	9920
15140	289	9708	129	112	0	10238
15141	149	9929	80	137	0	10295
15142	9949	269	108	106	0	10432
15143	9857	133	99	102	0	10191
15144	324	94	74	9719	0	10211
15145	9788	91	85	256	0	10220
15146	311	91	9435	136	0	9973
15147	9377	80	235	108	0	9800
15148	274	9532	127	111	0	10044
15149	9488	227	91	117	0	9923
15150	311	120	9394	76	0	9901
15151	185	101	245	9370	0	9901
15152	163	86	112	9533	0	9894
15153	148	92	111	8915	0	9266
15154	121	9348	109	257	0	9835
15155	9484	227	94	150	0	9955
15156	303	102	78	8774	0	9257
15157	177	8984	97	245	0	9503
15158	9721	218	97	155	0	10191
15159	9336	109	98	123	0	9666
15160	9515	90	106	127	0	9838
15161	9495	106	80	127	0	9808
15162	9364	102	73	115	0	9654
15163	339	92	78	9192	0	9701
15164	223	85	75	9189	0	9572
15165	9060	94	76	297	0	9527
15166	306	84	72	9084	0	9546
15167	170	118	67	9152	0	9507
15168	138	121	8515	350	0	9124
15169	8692	108	222	189	0	9211
15170	9026	90	114	185	0	9415
15171	9152	105	74	167	0	9498
15172	335	91	95	8351	0	8872
15173	196	8723	96	230	0	9245
15174	9620	220	89	177	0	10106
15175	9237	110	86	172	0	9605
15176	360	86	92	10278	0	10816
15177	10276	77	99	328	0	10780
15178	452	171	7764	245	0	8632
15179	223	10300	210	187	0	10920
15180	176	10705	128	183	0	11192
15181	226	338	10351	159	0	11074
15182	123	9550	260	148	0	10081
15183	115	9130	136	146	0	9527
15184	8035	166	109	78	0	8388
15185	150	7925	44	81	0	8200
15186	116	149	40	8027	0	8332
15187	8139	103	29	167	0	8438
15188	167	71	7877	108	0	8223
15189	7677	59	102	100	0	7938
15190	189	69	7665	76	0	7999
15191	130	37	7455	80	0	7702
15192	7150	45	152	68	0	7415
15193	146	44	7470	71	0	7731
15194	102	7227	118	56	0	7503
15195	92	99	110	7132	0	7433
15196	7178	77	49	112	0	7416
15197	130	7034	28	83	0	7275
15198	103	102	37	7107	0	7349
15199	78	82	7043	111	0	7314
15200	76	44	90	7033	0	7243
15201	6829	38	76	134	0	7077
15202	141	34	6742	81	0	6998
15203	123	26	94	6644	0	6887
15204	6748	34	78	125	0	6985
15205	6881	21	54	114	0	7070
15206	198	25	31	6797	0	7051
15207	132	33	40	6839	0	7044
15208	85	40	6942	162	0	7229
15209	79	23	6686	106	0	6894
15210	6743	17	139	67	0	6966
15211	7065	27	77	48	0	7217
15212	168	6940	49	55	0	7212
15213	6978	80	43	28	0	7129
15214	7064	59	24	43	0	7190
15215	185	34	7355	35	0	7609
15216	107	7467	115	32	0	7721
15217	7593	112	65	34	0	7804
15218	7598	56	41	17	0	7712
15219	7753	34	22	18	0	7827
15220	196	27	19	7572	0	7814
15221	121	21	16	7602	0	7760
15222	64	7517	20	147	0	7748
15223	49	110	16	7719	0	7894
15224	7676	60	9	140	0	7885
15225	143	42	7	7732	0	7924
15226	88	24	7567	152	0	7831
15227	59	23	7402	86	0	7570
15228	46	10	163	7542	0	7761
15229	44	12	7702	134	0	7892
15230	39	20	7542	88	0	7689
15231	41	8	182	7451	0	7682
15232	39	13	93	7731	0	7876
15233	35	8	7756	178	0	7977
15234	34	9	7642	102	0	7787
15235	29	7757	183	71	0	8040
15236	7819	119	113	43	0	8094
15237	132	7979	55	41	0	8207
15238	7878	134	37	36	0	8085
15239	8002	65	33	35	0	8135
15240	170	7972	30	29	0	8201
15241	8059	135	32	27	0	8253
15242	172	74	22	7915	0	8183
15243	100	39	8004	127	0	8270
15244	68	27	136	7841	0	8072
15245	38	26	70	8135	0	8269
15246	7682	18	44	197	0	7941
15247	7795	14	33	102	0	7944
15248	7834	16	34	58	0	7942
15249	7835	24	22	42	0	7923
15250	7490	17	19	44	0	7570
15251	226	7234	26	33	0	7519
15252	128	122	15	7443	0	7708
15253	70	61	7495	159	0	7785
15254	51	37	138	7448	0	7674
15255	58	21	76	7505	0	7660
15256	43	17	36	7953	0	8049
15257	8365	13	32	229	0	8639
15258	209	13	30	8389	0	8641
15259	8602	12	28	241	0	8883
15260	253	16	8855	108	0	9232
15261	127	14	202	10441	0	10784
15262	84	14	10781	318	0	11197
15263	10700	17	319	150	0	11186
15264	336	12	119	10916	0	11383
15265	132	20	10942	330	0	11424
15266	106	25	319	11000	0	11450
15267	11030	15	147	397	0	11589
15268	345	12	10979	167	0	11503
15269	11031	17	306	129	0	11483
15270	11518	19	132	88	0	11757
15271	11451	13	96	84	0	11644
15272	11325	6	66	83	0	11480
15273	474	10836	53	76	0	11439
15274	191	10247	59	60	0	10557
15275	157	10030	51	59	0	10297
15276	103	449	44	8906	0	9502
15277	76	9260	44	236	0	9616
15278	9103	275	43	82	0	9503
15279	267	8806	33	63	0	9169
15280	95	9167	36	43	0	9341
15281	90	296	29	9071	0	9486
15282	72	113	29	9337	0	9551
15283	9114	78	40	309	0	9541
15284	294	59	35	9171	0	9559
15285	117	53	8891	315	0	9376
15286	96	42	8469	125	0	8732
15287	78	41	8819	100	0	9038
15288	97	29	315	8592	0	9033
15289	91	35	123	9224	0	9473
15290	95	38	8894	322	0	9349
15291	87	41	8672	151	0	8951
15292	85	45	9086	90	0	9306
15293	9057	47	352	72	0	9528
15294	289	55	135	9223	0	9702
15295	103	60	94	9417	0	9674
15296	9301	57	72	357	0	9787
15297	290	58	64	9209	0	9621
15298	116	9019	57	330	0	9522
15299	100	9567	42	158	0	9867
15300	72	311	45	9533	0	9961
15301	9467	124	49	334	0	9974
15302	9554	69	46	170	0	9839
15303	9669	41	55	141	0	9906
15304	378	38	55	9489	0	9960
15305	161	35	9261	337	0	9794
15306	126	23	284	9335	0	9768
15307	88	24	9241	369	0	9722
15308	8833	36	347	135	0	9351
15309	315	35	139	9076	0	9565
15310	8770	19	128	357	0	9274
15311	333	22	8932	164	0	9451
15312	8330	19	326	150	0	8825
15313	378	22	9078	99	0	9577
15314	184	8453	312	105	0	9054
15315	146	8702	115	106	0	9069
15316	8489	297	100	117	0	9003
15317	337	119	57	8385	0	8898
15318	164	87	8425	279	0	8955
15319	126	8169	248	131	0	8674
15320	95	8633	107	92	0	8927
15321	106	328	78	8508	0	9020
15322	8585	133	45	305	0	9068
15323	8640	95	64	141	0	8940
15324	349	8547	55	122	0	9073
15325	8600	291	65	103	0	9059
15326	339	107	70	8559	0	9075
15327	142	93	8435	314	0	8984
15328	140	8465	277	158	0	9040
15329	108	265	133	8504	0	9010
15330	102	112	105	8654	0	8973
15331	8466	73	83	373	0	8995
15332	321	50	8355	176	0	8902
15333	8297	54	295	133	0	8779
15334	8548	58	132	96	0	8834
15335	360	60	115	8315	0	8850
15336	180	65	78	8495	0	8818
15337	8194	70	75	351	0	8690
15338	324	71	56	8199	0	8650
15339	150	58	7967	363	0	8538
15340	123	57	7889	154	0	8223
15341	108	7636	306	133	0	8183
15342	98	8234	138	112	0	8582
15343	118	302	73	7589	0	8082
15344	103	7833	55	278	0	8269
15345	7882	301	62	155	0	8400
15346	301	8028	58	134	0	8521
15347	152	310	48	8008	0	8518
15348	99	136	57	8277	0	8569
15349	80	112	7992	351	0	8535
15350	82	72	279	8003	0	8436
15351	100	61	110	8175	0	8446
15352	94	8156	94	366	0	8710
15353	94	259	68	8231	0	8652
15354	104	101	73	8451	0	8729
15355	118	63	8131	390	0	8702
15356	64	7878	289	227	0	8458
15357	67	597	114	6804	0	7582
15358	69	7285	61	258	0	7673
15359	58	229	6910	145	0	7342
15360	52	6596	209	123	0	6980
15361	4883	167	127	49	0	5226
15362	4675	50	41	17	0	4783
15363	4670	43	14	23	0	4750
15364	105	4671	19	26	0	4821
15365	4678	94	12	22	0	4806
15366	99	55	14	4583	0	4751
15367	4436	38	9	85	0	4568
15368	103	4328	6	50	0	4487
15369	4315	90	14	37	0	4456
15370	4438	45	10	36	0	4529
15371	118	4491	10	24	0	4643
15372	65	101	4497	25	0	4688
15373	44	45	94	4924	0	5107
15374	39	33	5204	130	0	5406
15375	31	21	147	5387	0	5586
15376	28	20	48	5760	0	5856
15377	31	18	5779	206	0	6034
15378	17	22	170	5800	0	6009
15379	5841	19	63	204	0	6127
15380	173	18	5805	88	0	6084
15381	56	5749	186	57	0	6048
15382	50	165	59	5621	0	5895
15383	50	53	35	5941	0	6079
15384	35	33	5770	227	0	6065
15385	39	32	168	5516	0	5755
15386	30	5699	61	201	0	5991
15387	5532	165	44	105	0	5846
15388	159	5628	38	53	0	5878
15389	5296	176	15	48	0	5535
15390	159	5323	23	28	0	5533
15391	55	5523	18	34	0	5630
15392	32	200	5270	33	0	5535
15393	50	79	160	5221	0	5510
15394	19	46	48	5178	0	5291
15395	23	38	28	5369	0	5458
15396	14	5596	33	225	0	5868
15397	22	183	18	5680	0	5903
15398	5678	69	25	237	0	6009
15399	184	41	20	5757	0	6002
15400	5717	40	21	242	0	6020
15401	217	23	5673	136	0	6049
15402	5712	30	195	74	0	6011
15403	221	26	84	5761	0	6092
15404	118	36	51	6067	0	6272
15405	5971	30	52	284	0	6337
15406	220	36	5916	145	0	6317
15407	83	5930	199	103	0	6315
15408	72	189	75	6136	0	6472
15409	6073	87	57	241	0	6458
15410	6237	56	47	116	0	6456
15411	266	67	25	6167	0	6525
15412	133	49	6066	236	0	6484
15413	5802	55	197	120	0	6174
15414	242	49	5960	94	0	6345
15415	117	42	229	5880	0	6268
15416	70	38	5934	244	0	6286
15417	68	52	225	5896	0	6241
15418	47	30	5772	271	0	6120
15419	59	5813	211	148	0	6231
15420	56	195	113	5324	0	5688
15421	59	5854	52	219	0	6184
15422	5903	206	63	106	0	6278
15423	6040	98	40	95	0	6273
15424	265	69	5811	89	0	6234
15425	154	45	200	5792	0	6191
15426	5923	34	101	223	0	6281
15427	242	37	72	5871	0	6222
15428	126	34	64	5966	0	6190
15429	88	41	5677	309	0	6115
15430	5524	27	208	158	0	5917
15431	228	30	5804	144	0	6206
15432	135	29	226	5751	0	6141
15433	101	30	5806	242	0	6179
15434	5681	31	226	154	0	6092
15435	5820	32	139	118	0	6109
15436	5900	29	93	120	0	6142
15437	305	31	95	5689	0	6120
15438	170	41	5598	228	0	6037
15439	111	34	5715	147	0	6007
15440	98	44	258	5366	0	5766
15441	68	5600	159	235	0	6062
15442	5541	177	113	145	0	5976
15443	230	91	78	5602	0	6001
15444	120	79	5563	239	0	6001
15445	116	65	196	5649	0	6026
15446	107	47	5804	270	0	6228
15447	99	38	240	5906	0	6283
15448	98	33	5954	262	0	6347
15449	86	25	5895	181	0	6187
15450	69	5715	291	156	0	6231
15451	90	168	5777	136	0	6171
15452	79	78	5889	118	0	6164
15453	106	67	273	4781	0	5227
15454	86	48	160	5252	0	5546
15455	90	5519	116	259	0	5984
15456	5580	148	113	147	0	5988
15457	206	5535	93	116	0	5950
15458	149	185	76	5530	0	5940
15459	5579	89	84	219	0	5971
15460	223	52	74	5596	0	5945
15461	5627	42	91	249	0	6009
15462	241	26	83	5688	0	6038
15463	127	31	5700	251	0	6109
15464	74	36	208	5750	0	6068
15465	88	38	138	5908	0	6172
15466	5786	39	89	300	0	6214
15467	5781	40	89	176	0	6086
15468	5735	26	99	139	0	5999
15469	269	5514	106	101	0	5990
15470	137	5549	96	105	0	5887
15471	5505	182	94	111	0	5892
15472	178	93	5591	93	0	5955
15473	111	59	5216	81	0	5467
15474	101	210	193	4752	0	5256
15475	49	33	4841	136	0	5059
15476	50	24	4577	89	0	4740
15477	4256	35	155	80	0	4526
15478	4386	18	95	50	0	4549
15479	134	4349	42	58	0	4583
15480	91	4534	57	38	0	4720
15481	69	106	43	3980	0	4198
15482	46	4528	38	97	0	4709
15483	4609	95	42	72	0	4818
15484	110	52	43	4421	0	4626
15485	74	4615	40	98	0	4827
15486	4729	82	39	74	0	4924
15487	113	61	4697	55	0	4926
15488	84	40	4596	48	0	4768
15489	4566	29	137	44	0	4776
15490	106	21	4546	54	0	4727
15491	4349	13	101	56	0	4519
15492	111	28	74	4531	0	4744
15493	73	15	4542	85	0	4715
15494	64	4371	93	65	0	4593
15495	43	4498	71	41	0	4653
15496	4066	64	35	29	0	4194
15497	45	4151	28	21	0	4245
15498	3934	51	20	13	0	4018
15499	3911	19	14	15	0	3959
15500	60	3885	19	15	0	3979
15501	23	42	18	3893	0	3976
15502	18	21	3983	47	0	4069
15503	13	4142	62	17	0	4234
15504	22	90	24	4101	0	4237
15505	10	30	19	4537	0	4596
15506	4469	9	9	86	0	4573
15507	75	8	9	4426	0	4518
15508	18	9	4385	96	0	4508
15509	13	4366	82	32	0	4493
15510	15	86	25	4445	0	4571
15511	4454	20	18	91	0	4583
15512	4636	17	14	37	0	4704
15513	97	13	16	4626	0	4752
15514	4723	11	19	99	0	4852
15515	106	13	4741	34	0	4894
15516	40	6	99	4721	0	4866
15517	28	18	4784	99	0	4929
15518	27	10	101	5165	0	5303
15519	27	8	33	5122	0	5190
15520	29	13	29	5139	0	5210
15521	21	4	20	5154	0	5199
15522	16	8	25	5108	0	5157
15523	4989	14	16	200	0	5219
15524	5091	5	8	95	0	5199
15525	157	5025	17	63	0	5262
15526	5135	122	13	55	0	5325
15527	156	33	8	5157	0	5354
15528	61	24	10	5249	0	5344
15529	55	19	16	5193	0	5283
15530	41	15	5208	206	0	5470
15531	47	10	147	4914	0	5118
15532	31	5119	37	192	0	5379
15533	5160	136	34	89	0	5419
15534	5211	31	19	84	0	5345
15535	178	25	5065	73	0	5341
15536	63	5065	141	77	0	5346
15537	54	142	36	5162	0	5394
15538	56	38	5244	173	0	5511
15539	48	38	150	4823	0	5059
15540	48	5058	41	158	0	5305
15541	4958	153	34	69	0	5214
15542	157	5047	23	70	0	5297
15543	52	156	4998	69	0	5275
15544	54	54	4974	58	0	5140
15545	33	4860	156	66	0	5115
15546	32	4918	52	46	0	5048
15547	4711	163	51	49	0	4974
15548	4799	64	32	44	0	4939
15549	177	44	33	4732	0	4986
15550	64	46	4740	152	0	5002
15551	56	34	148	4696	0	4934
15552	39	30	59	4774	0	4902
15553	4652	29	40	201	0	4922
15554	4619	42	32	84	0	4777
15555	184	25	33	4780	0	5022
15556	70	36	4867	172	0	5145
15557	46	4877	153	80	0	5156
15558	4880	159	58	59	0	5156
15559	161	5053	45	45	0	5304
15560	58	190	30	5191	0	5469
15561	65	59	28	5483	0	5635
15562	69	47	28	5459	0	5603
15563	50	40	24	5363	0	5477
15564	5176	37	42	241	0	5496
15565	179	27	28	5169	0	5403
15566	64	5062	23	244	0	5393
15567	60	162	19	5177	0	5418
15568	4966	48	23	231	0	5268
15569	178	5001	20	117	0	5316
15570	62	165	34	5029	0	5290
15571	57	61	4883	214	0	5215
15572	4804	42	151	92	0	5089
15573	204	42	45	4884	0	5175
15574	76	38	4772	208	0	5094
15575	53	42	4731	100	0	4926
15576	52	31	192	4745	0	5020
15577	4700	30	72	235	0	5037
15578	4798	26	50	115	0	4989
15579	194	4909	31	112	0	5246
15580	4918	168	23	86	0	5195
15581	5024	50	22	101	0	5197
15582	4999	33	30	85	0	5147
15583	4940	43	35	73	0	5091
15584	236	39	25	4779	0	5079
15585	111	45	30	4883	0	5069
15586	94	31	4569	212	0	4906
15587	61	4298	149	115	0	4623
15588	57	4514	58	105	0	4734
15589	58	158	4512	79	0	4807
15590	4463	72	163	82	0	4780
15591	189	36	61	4574	0	4860
15592	4612	34	41	186	0	4873
15593	4668	45	34	74	0	4821
15594	217	42	4430	72	0	4761
15595	98	37	162	4449	0	4746
15596	4552	32	47	176	0	4807
15597	202	38	36	4508	0	4784
15598	94	22	4474	196	0	4786
15599	79	101	152	4289	0	4621
15600	57	4538	61	189	0	4845
15601	72	4727	48	73	0	4920
15602	57	169	4491	64	0	4781
15603	46	4355	147	47	0	4595
15604	4120	147	52	62	0	4381
15605	4008	32	35	37	0	4112
15606	122	24	38	3894	0	4078
15607	59	16	22	3981	0	4078
15608	53	19	18	4015	0	4105
15609	3880	16	21	129	0	4046
15610	105	3882	19	60	0	4066
15611	3816	86	10	52	0	3964
15612	3787	30	19	34	0	3870
15613	124	3742	17	33	0	3916
15614	3552	77	15	20	0	3664
15615	92	3559	8	35	0	3694
15616	3586	87	12	31	0	3716
15617	95	29	3509	37	0	3670
15618	3022	9	67	23	0	3121
15619	51	3165	16	19	0	3251
15620	37	52	25	3201	0	3315
15621	19	16	6	3325	0	3366
15622	20	8	9	3342	0	3379
15623	3417	5	4	85	0	3511
15624	70	6	7	3493	0	3576
15625	28	4	3391	74	0	3497
15626	3286	10	64	36	0	3396
15627	78	8	3379	23	0	3488
15628	23	17	66	3354	0	3460
15629	26	8	3442	79	0	3555
15630	9	16	70	3297	0	3392
15631	16	3390	20	73	0	3499
15632	18	64	17	3328	0	3427
15633	16	3389	12	68	0	3485
15634	20	68	11	3437	0	3536
15635	3414	16	19	80	0	3529
15636	74	14	17	3508	0	3613
15637	3520	9	8	85	0	3622
15638	84	9	3353	22	0	3468
15639	3376	11	61	24	0	3472
15640	3467	14	14	23	0	3518
15641	3487	9	11	21	0	3528
15642	104	12	5	3439	0	3560
15643	3379	10	10	73	0	3472
15644	91	12	3260	24	0	3387
15645	3238	3	65	29	0	3335
15646	83	10	3279	20	0	3392
15647	3272	6	71	14	0	3363
15648	83	11	20	3354	0	3468
15649	35	13	3444	68	0	3560
15650	31	6	74	3440	0	3551
15651	28	8	18	3517	0	3571
15652	23	6	3486	89	0	3604
15653	3224	5	72	41	0	3342
15654	78	3534	21	28	0	3661
15655	3477	59	20	22	0	3578
15656	68	3356	14	26	0	3464
15657	3295	56	12	18	0	3381
15658	65	16	3246	17	0	3344
15659	2874	37	70	29	0	3010
15660	47	2975	17	16	0	3055
15661	27	37	13	2871	0	2948
15662	9	7	8	2959	0	2983
15663	13	5	3	2954	0	2975
15664	8	7	2981	52	0	3048
15665	16	6	44	2908	0	2974
15666	2	5	3144	54	0	3205
15667	3244	1	48	16	0	3309
15668	3576	4	11	16	0	3607
15669	75	4	7	3610	0	3696
15670	13	5	3676	76	0	3770
15671	3554	2	66	23	0	3645
15672	84	4	4530	14	0	4632
15673	26	3	96	4412	0	4537
15674	14	4	24	4650	0	4692
15675	21	1	9	4809	0	4840
15676	14	8	13	4864	0	4899
15677	4647	4	10	135	0	4796
15678	108	4676	11	43	0	4838
15679	37	100	4458	25	0	4620
15680	14	4512	107	22	0	4655
15681	4588	107	22	16	0	4733
15682	120	24	12	4597	0	4753
15683	4599	9	14	130	0	4752
15684	119	10	15	4612	0	4756
15685	38	5	11	4675	0	4729
15686	22	7	14	4735	0	4778
15687	27	6	4596	152	0	4781
15688	22	4479	113	54	0	4668
15689	21	110	4610	37	0	4778
15690	20	22	124	4632	0	4798
15691	4711	14	32	138	0	4895
15692	4698	15	17	50	0	4780
15693	4775	14	17	37	0	4843
15694	134	4703	26	36	0	4899
15695	4899	114	14	37	0	5064
15696	140	28	16	4893	0	5077
15697	45	14	15	4994	0	5068
15698	30	16	23	4998	0	5067
15699	29	4946	21	152	0	5148
15700	35	114	13	4671	0	4833
15701	30	4838	20	129	0	5017
15702	4824	119	19	49	0	5011
15703	4919	35	23	35	0	5012
15704	151	15	19	4893	0	5078
15705	55	20	4756	143	0	4974
15706	4729	15	114	65	0	4923
15707	142	13	33	4929	0	5117
15708	47	17	4869	139	0	5072
15709	4660	19	122	67	0	4868
15710	140	13	33	4953	0	5139
15711	4885	21	20	159	0	5085
15712	133	4843	19	68	0	5063
15713	45	124	19	4868	0	5056
15714	45	4990	17	140	0	5192
15715	38	119	19	5066	0	5242
15716	33	5105	19	153	0	5310
15717	39	118	17	5224	0	5398
15718	39	31	5165	139	0	5374
15719	4227	22	105	107	0	4461
15720	120	5085	44	48	0	5297
15721	45	96	4965	45	0	5151
15722	4843	24	104	51	0	5022
15723	126	14	30	5038	0	5208
15724	50	16	4993	109	0	5168
15725	27	4992	90	51	0	5160
15726	39	89	32	5121	0	5281
15727	23	34	5142	114	0	5313
15728	28	33	95	5072	0	5228
15729	26	24	21	5224	0	5295
15730	31	17	5287	134	0	5469
15731	24	25	85	5242	0	5376
15732	30	24	5378	119	0	5551
15733	34	15	103	5386	0	5538
15734	37	25	5589	121	0	5772
15735	30	29	94	5577	0	5730
15736	35	19	51	5613	0	5718
15737	42	23	19	5599	0	5683
15738	19	5553	30	137	0	5739
15739	5590	95	32	63	0	5780
15740	5647	35	20	59	0	5761
15741	115	19	31	5711	0	5876
15742	5730	17	28	129	0	5904
15743	109	21	5699	65	0	5894
15744	36	5787	97	66	0	5986
15745	5836	89	46	56	0	6027
15746	100	5875	27	51	0	6053
15747	47	97	22	5984	0	6150
15748	25	44	23	6035	0	6127
15749	5793	29	28	125	0	5975
15750	107	30	10	5739	0	5886
15751	50	18	5693	131	0	5892
15752	42	5633	90	63	0	5828
15753	5710	103	30	48	0	5891
15754	109	36	25	5634	0	5804
15755	51	5725	32	106	0	5914
15756	40	104	14	5680	0	5838
15757	37	5836	25	98	0	5996
15758	5851	110	33	55	0	6049
15759	5870	41	21	51	0	5983
15760	136	21	5722	61	0	5940
15761	46	30	5687	44	0	5807
15762	46	13	105	5675	0	5839
15763	36	5818	40	105	0	5999
15764	36	80	29	5946	0	6091
15765	5868	29	30	118	0	6045
15766	88	24	5652	61	0	5825
15767	38	36	67	5347	0	5488
15768	25	15	5326	82	0	5448
15769	20	18	4991	49	0	5078
15770	16	5324	78	28	0	5446
15771	107	120	48	5021	0	5296
15772	4493	12	25	42	0	4572
15773	23	4	4538	10	0	4575
15774	11	4409	17	9	0	4446
15775	4397	12	7	6	0	4422
15776	15	6	5	4430	0	4456
15777	4558	4	2	36	0	4600
15778	4515	6	0	23	0	4544
15779	4472	1	9	15	0	4497
15780	24	4	4726	4	0	4758
15781	4396	0	14	16	0	4426
15782	4711	1	9	11	0	4732
15783	23	4841	8	4	0	4876
15784	11	29	4	4914	0	4958
15785	10	8	3	4825	0	4846
15786	5	6	1	4935	0	4947
15787	4901	5	3	30	0	4939
15788	4696	3	0	23	0	4722
15789	33	2	4788	8	0	4831
15790	18	2	17	4769	0	4806
15791	10	4742	11	17	0	4780
15792	4812	17	6	13	0	4848
15793	20	11	4816	4	0	4851
15794	17	4	21	4634	0	4676
15795	8	6	12	4714	0	4740
15796	8	4702	6	24	0	4740
15797	11	20	4	4739	0	4774
15798	24	13	10	4348	0	4395
15799	3	8	10	4677	0	4698
15800	4666	2	3	32	0	4703
15801	21	3	6	4616	0	4646
15802	14	4	5	4629	0	4652
15803	4659	2	5	42	0	4708
15804	19	5	5	4686	0	4715
15805	19	5201	7	29	0	5256
15806	5457	38	4	21	0	5520
15807	5656	32	2	31	0	5721
15808	5820	7	4	18	0	5849
15809	6516	4	4	19	0	6543
15810	164	7019	5	30	0	7218
15811	8075	139	5	15	0	8234
15812	8263	54	6	20	0	8343
15813	301	36	1	8035	0	8373
15814	107	21	7833	233	0	8194
15815	72	15	223	7838	0	8148
15816	49	5	59	7962	0	8075
15817	33	5	30	7873	0	7941
15818	29	9	25	7904	0	7967
15819	29	5	12	7988	0	8034
15820	7597	5	11	358	0	7971
15821	249	3	7	7718	0	7977
15822	91	7	7629	309	0	8036
15823	56	6	227	7456	0	7745
15824	45	7526	65	279	0	7915
15825	35	219	33	7644	0	7931
15826	24	62	7566	296	0	7948
15827	6826	33	231	146	0	7236
15828	7412	26	66	83	0	7587
15829	308	16	7564	70	0	7958
15830	112	7468	235	48	0	7863
15831	7642	217	74	63	0	7996
15832	7759	73	41	46	0	7919
15833	7841	41	31	50	0	7963
15834	7683	35	22	40	0	7780
15835	385	22	20	7298	0	7725
15836	183	25	7303	258	0	7769
15837	136	23	238	7323	0	7720
15838	102	23	72	7622	0	7819
15839	86	18	7388	345	0	7837
15840	73	34	7364	154	0	7625
15841	7156	17	313	116	0	7602
15842	304	7316	116	110	0	7846
15843	135	239	80	7361	0	7815
15844	95	63	7232	328	0	7718
15845	6897	47	277	176	0	7397
15846	299	33	7185	152	0	7669
15847	7008	22	291	149	0	7470
15848	321	7144	119	145	0	7729
15849	151	241	85	7259	0	7736
15850	112	75	7114	344	0	7645
15851	6769	74	268	167	0	7278
15852	310	6986	112	120	0	7528
15853	159	7422	93	108	0	7782
15854	124	316	77	7355	0	7872
15855	118	132	65	7702	0	8017
15856	7870	93	75	397	0	8435
15857	357	7822	76	180	0	8435
15858	209	291	62	8017	0	8579
15859	7870	112	56	406	0	8444
15860	8309	80	70	191	0	8650
15861	8438	82	69	142	0	8731
15862	498	44	8199	168	0	8909
15863	265	38	8375	150	0	8828
15864	8783	34	397	158	0	9372
15865	438	8734	163	166	0	9501
15866	202	9053	133	172	0	9560
15867	160	409	118	8460	0	9147
15868	134	8872	93	422	0	9521
15869	8904	410	110	205	0	9629
15870	421	178	112	8885	0	9596
15871	219	124	8772	440	0	9555
15872	8804	102	387	221	0	9514
15873	9160	91	179	147	0	9577
15874	570	89	130	8821	0	9610
15875	295	80	132	9051	0	9558
15876	241	78	117	9161	0	9597
15877	212	92	100	9069	0	9473
15878	198	90	8405	587	0	9280
15879	175	8354	375	318	0	9222
15880	172	384	174	7793	0	8523
15881	173	8392	134	457	0	9156
15882	183	432	103	7700	0	8418
15883	143	8254	98	444	0	8939
15884	8190	446	81	296	0	9013
15885	8356	200	93	243	0	8892
15886	524	8176	97	217	0	9014
15887	8337	412	103	176	0	9028
15888	537	183	118	8220	0	9058
15889	8169	156	87	474	0	8886
15890	501	8144	121	216	0	8982
15891	8276	421	94	167	0	8958
15892	8545	185	109	143	0	8982
15893	604	169	103	8078	0	8954
15894	324	137	8081	443	0	8985
15895	236	8054	389	199	0	8878
15896	225	438	147	8190	0	9000
15897	8219	221	133	481	0	9054
15898	491	185	8033	243	0	8952
15899	276	168	377	7971	0	8792
15900	235	138	141	8356	0	8870
15901	8179	98	118	574	0	8969
15902	8314	113	104	315	0	8846
15903	8241	104	102	250	0	8697
15904	596	7876	92	226	0	8790
15905	7508	352	82	222	0	8164
15906	492	142	6988	189	0	7811
15907	237	130	6790	176	0	7333
15908	186	112	6800	158	0	7256
15909	202	469	389	5524	0	6584
15910	122	72	5371	272	0	5837
15911	4384	70	136	88	0	4678
15912	175	44	59	4449	0	4727
15913	103	50	4492	161	0	4806
15914	4663	42	141	101	0	4947
15915	197	46	71	4668	0	4982
15916	110	50	45	4861	0	5066
15917	4818	34	51	188	0	5091
15918	195	38	52	4932	0	5217
15919	105	39	4951	184	0	5279
15920	91	31	168	5011	0	5301
15921	85	41	5020	181	0	5327
15922	75	37	173	4951	0	5236
15923	4873	39	74	193	0	5179
15924	185	4724	53	118	0	5080
15925	101	4942	57	102	0	5202
15926	89	165	50	4884	0	5188
15927	87	73	47	4921	0	5128
15928	74	4707	49	214	0	5044
15929	87	4714	47	122	0	4970
15930	75	148	56	4644	0	4923
15931	68	69	52	4706	0	4895
15932	4494	44	48	229	0	4815
15933	167	4394	53	125	0	4739
15934	97	4381	48	102	0	4628
15935	76	4656	41	84	0	4857
15936	4448	178	58	83	0	4767
15937	155	95	4450	76	0	4776
15938	4371	61	156	84	0	4672
15939	164	39	69	4422	0	4694
15940	89	4263	60	176	0	4588
15941	63	4556	43	108	0	4770
15942	4494	171	35	86	0	4786
15943	170	69	35	4333	0	4607
15944	94	4826	39	160	0	5119
15945	4936	161	44	102	0	5243
15946	5013	81	43	85	0	5222
15947	196	60	4861	84	0	5201
15948	4864	49	137	68	0	5118
15949	5053	46	65	65	0	5229
15950	200	50	43	4872	0	5165
15951	78	4719	54	175	0	5026
15952	90	4922	22	100	0	5134
15953	67	200	35	4820	0	5122
15954	4594	79	29	171	0	4873
15955	176	61	4261	83	0	4581
15956	76	48	4060	72	0	4256
15957	87	39	3927	51	0	4104
15958	73	41	4025	39	0	4178
15959	41	3976	132	45	0	4194
15960	43	3988	42	52	0	4125
15961	54	136	3693	23	0	3906
15962	41	65	3652	41	0	3799
15963	23	3286	72	33	0	3414
15964	8	41	16	2996	0	3061
15965	5	11	3187	36	0	3239
15966	8	9	44	3044	0	3105
15967	3	4	13	3315	0	3335
15968	2	4	8	3404	0	3418
15969	4	6	3	3607	0	3620
15970	4	4	3551	77	0	3636
15971	6	3	64	3423	0	3496
15972	3505	4	8	72	0	3589
15973	63	2	3455	20	0	3540
15974	3496	5	71	13	0	3585
15975	79	5	13	3634	0	3731
15976	16	5	3678	68	0	3767
15977	3612	6	68	24	0	3710
15978	74	5	13	3718	0	3810
15979	3732	6	16	77	0	3831
15980	71	4	15	3657	0	3747
15981	16	3658	13	74	0	3761
15982	14	58	3791	25	0	3888
15983	13	14	63	3812	0	3902
15984	3875	14	15	80	0	3984
15985	3885	21	18	22	0	3946
15986	3914	10	14	26	0	3964
15987	3895	8	7	28	0	3938
15988	3819	11	13	22	0	3865
15989	77	3829	7	15	0	3928
15990	3854	76	7	19	0	3956
15991	73	21	3790	22	0	3906
15992	3793	16	68	19	0	3896
15993	86	19	15	3614	0	3734
15994	28	10	3737	60	0	3835
15995	21	12	3710	22	0	3765
15996	20	21	73	3679	0	3793
15997	3813	14	25	71	0	3923
15998	73	3734	26	30	0	3863
15999	3760	67	14	26	0	3867
16000	75	3766	20	24	0	3885
16001	34	82	12	3964	0	4092
16002	35	23	10	4042	0	4110
16003	4026	14	19	91	0	4150
16004	87	15	14	4018	0	4134
16005	33	18	4006	91	0	4148
16006	3992	9	79	30	0	4110
16007	93	12	24	4097	0	4226
16008	39	7	14	4124	0	4184
16009	41	15	4093	84	0	4233
16010	3768	9	94	45	0	3916
16011	4093	11	29	37	0	4170
16012	101	4075	22	23	0	4221
16013	30	66	3996	24	0	4116
16014	31	17	3925	21	0	3994
16015	31	32	76	3860	0	3999
16016	25	21	27	3819	0	3892
16017	19	3917	21	77	0	4034
16018	23	61	3839	19	0	3942
16019	19	13	70	3698	0	3800
16020	20	8	3848	65	0	3941
16021	23	8	68	3691	0	3790
16022	13	3806	19	65	0	3903
16023	20	55	20	3887	0	3982
16024	13	11	25	3887	0	3936
16025	21	11	17	3826	0	3875
16026	3834	9	13	83	0	3939
16027	71	9	3800	31	0	3911
16028	20	3971	62	27	0	4080
16029	15	67	27	4274	0	4383
16030	4393	21	25	73	0	4512
16031	89	11	13	4472	0	4585
16032	4502	12	14	99	0	4627
16033	98	9	4529	38	0	4674
16034	4470	9	80	34	0	4593
16035	101	11	32	4679	0	4823
16036	45	4	4662	99	0	4810
16037	22	4638	92	50	0	4802
16038	28	95	33	4577	0	4733
16039	28	22	22	4712	0	4784
16040	4609	15	16	123	0	4763
16041	109	4566	15	51	0	4741
16042	33	4460	22	27	0	4542
16043	30	4616	16	33	0	4695
16044	4222	97	17	33	0	4369
16045	92	4223	19	19	0	4353
16046	45	83	9	4212	0	4349
16047	28	28	13	4275	0	4344
16048	4209	14	26	109	0	4358
16049	86	4168	12	49	0	4315
16050	44	79	12	4254	0	4389
16051	4301	30	22	98	0	4451
16052	4315	23	10	46	0	4394
16053	4321	12	14	40	0	4387
16054	102	4257	16	28	0	4403
16055	4214	76	11	26	0	4327
16056	89	32	5	4139	0	4265
16057	38	4072	10	83	0	4203
16058	18	4174	12	47	0	4251
16059	31	79	8	4154	0	4272
16060	4083	28	10	89	0	4210
16061	4151	11	14	42	0	4218
16062	100	9	11	3977	0	4097
16063	42	3983	10	75	0	4110
16064	4013	71	9	37	0	4130
16065	78	32	3869	30	0	4009
16066	39	19	3785	22	0	3865
16067	3678	16	76	28	0	3798
16068	79	12	3708	26	0	3825
16069	38	12	44	3451	0	3545
16070	3505	7	27	51	0	3590
16071	52	5	10	3590	0	3657
16072	27	15	3565	49	0	3656
16073	19	3600	41	24	0	3684
16074	9	44	22	3685	0	3760
16075	16	24	3654	50	0	3744
16076	3457	10	46	31	0	3544
16077	54	6	24	3650	0	3734
16078	24	14	3653	54	0	3745
16079	29	9	49	3550	0	3637
16080	11	3565	25	55	0	3656
16081	18	50	15	3711	0	3794
16082	11	29	4	3670	0	3714
16083	10	8	13	3537	0	3568
16084	11	3545	10	73	0	3639
16085	3627	49	4	31	0	3711
16086	51	21	8	3645	0	3725
16087	24	10	17	3667	0	3718
16088	16	14	4	3729	0	3763
16089	15	8	3688	80	0	3791
16090	15	8	58	3691	0	3772
16091	3709	9	16	69	0	3803
16092	54	3757	11	38	0	3860
16093	24	61	11	3818	0	3914
16094	19	33	6	3851	0	3909
16095	3779	12	7	90	0	3888
16096	63	3792	9	45	0	3909
16097	3857	55	7	38	0	3957
16098	3962	30	9	21	0	4022
16099	92	16	7	3901	0	4016
16100	3913	8	8	79	0	4008
16101	68	3716	5	39	0	3828
16102	3758	61	9	32	0	3860
16103	81	23	10	3848	0	3962
16104	4230	16	8	77	0	4331
16105	4434	18	4	38	0	4494
16106	130	15	4157	24	0	4326
16107	4390	16	69	24	0	4499
16108	4575	13	15	29	0	4632
16109	4766	16	9	33	0	4824
16110	146	14	4983	20	0	5163
16111	63	5031	120	15	0	5229
16112	38	134	45	5081	0	5298
16113	5057	47	24	144	0	5272
16114	149	4977	15	55	0	5196
16115	5005	143	9	39	0	5196
16116	168	54	13	5034	0	5269
16117	82	29	4995	140	0	5246
16118	5114	14	129	71	0	5328
16119	171	21	53	5292	0	5537
16120	84	21	5259	153	0	5517
16121	5218	12	147	74	0	5451
16122	181	11	5364	35	0	5591
16123	85	17	168	5531	0	5801
16124	52	13	70	5885	0	6020
16125	5794	8	42	237	0	6081
16126	5828	11	27	105	0	5971
16127	247	5731	12	64	0	6054
16128	5745	162	31	46	0	5984
16129	213	59	5383	19	0	5674
16130	88	37	5320	22	0	5467
16131	5197	25	196	30	0	5448
16132	187	5284	90	22	0	5583
16133	5139	146	61	18	0	5364
16134	182	5173	28	16	0	5399
16135	5161	170	20	19	0	5370
16136	196	62	24	5031	0	5313
16137	102	36	5073	147	0	5358
16138	67	31	153	5059	0	5310
16139	49	17	52	5268	0	5386
16140	5135	13	49	218	0	5415
16141	176	23	5078	85	0	5362
16142	4992	11	159	74	0	5236
16143	198	5002	63	44	0	5307
16144	5091	158	44	30	0	5323
16145	208	56	34	4990	0	5288
16146	100	41	4979	168	0	5288
16147	66	32	162	5022	0	5282
16148	5032	17	68	191	0	5308
16149	181	18	48	5064	0	5311
16150	83	21	49	5012	0	5165
16151	77	4777	17	230	0	5101
16152	55	153	34	4930	0	5172
16153	51	50	4814	214	0	5129
16154	50	39	156	4865	0	5110
16155	54	38	63	5017	0	5172
16156	4858	17	47	250	0	5172
16157	177	26	42	4882	0	5127
16158	100	22	4767	214	0	5103
16159	78	4780	167	103	0	5128
16160	62	164	74	4840	0	5140
16161	55	57	54	4975	0	5141
16162	4842	48	41	230	0	5161
16163	194	4761	28	123	0	5106
16164	86	170	30	4886	0	5172
16165	4713	72	26	196	0	5007
16166	4928	57	26	109	0	5120
16167	234	31	42	4886	0	5193
16168	127	18	4822	227	0	5194
16169	4868	21	172	121	0	5182
16170	221	29	72	5046	0	5368
16171	5001	31	49	219	0	5300
16172	5102	30	38	113	0	5283
16173	248	4862	39	90	0	5239
16174	4852	157	36	68	0	5113
16175	222	4819	34	68	0	5143
16176	120	181	36	4780	0	5117
16177	94	77	21	4782	0	4974
16178	77	4763	29	230	0	5099
16179	4830	174	32	121	0	5157
16180	4881	72	26	103	0	5082
16181	237	58	4627	73	0	4995
16182	121	47	4651	83	0	4902
16183	110	36	200	4689	0	5035
16184	4733	33	81	214	0	5061
16185	198	26	71	4734	0	5029
16186	125	27	47	4894	0	5093
16187	89	29	4725	262	0	5105
16188	78	35	4727	134	0	4974
16189	73	30	4811	112	0	5026
16190	4599	33	233	91	0	4956
16191	4752	31	123	76	0	4982
16192	234	4524	72	70	0	4900
16193	125	4713	42	65	0	4945
16194	110	177	36	4686	0	5009
16195	86	100	4633	179	0	4998
16196	4555	68	162	105	0	4890
16197	190	42	4794	104	0	5130
16198	108	27	189	4732	0	5056
16199	90	22	86	4892	0	5090
16200	73	28	71	4941	0	5113
16201	77	32	49	5014	0	5172
16202	4831	29	44	274	0	5178
16203	224	31	39	4810	0	5104
16204	99	29	4457	204	0	4789
16205	4093	23	137	123	0	4376
16206	167	20	4230	87	0	4504
16207	92	28	4135	61	0	4316
16208	77	4075	169	57	0	4378
16209	79	96	92	3547	0	3814
16210	3501	27	64	90	0	3682
16211	101	28	17	3511	0	3657
16212	46	16	3509	113	0	3684
16213	37	15	82	3546	0	3680
16214	3484	7	41	120	0	3652
16215	79	3541	32	72	0	3724
16216	3473	71	24	53	0	3621
16217	103	3449	18	41	0	3611
16218	3326	75	20	45	0	3466
16219	93	3259	18	20	0	3390
16220	36	3310	21	26	0	3393
16221	39	75	3234	19	0	3367
16222	40	3208	62	22	0	3332
16223	2872	49	28	10	0	2959
16224	48	17	11	2811	0	2887
16225	2818	14	3	41	0	2876
16226	41	2874	4	21	0	2940
16227	2864	34	5	13	0	2916
16228	48	14	2917	10	0	2989
16229	16	12	44	2873	0	2945
16230	15	2966	14	39	0	3034
16231	8	38	14	3080	0	3140
16232	8	14	10	3095	0	3127
16233	3521	12	4	51	0	3588
16234	56	3565	6	25	0	3652
16235	3673	63	6	17	0	3759
16236	92	28	3709	11	0	3840
16237	31	24	3537	6	0	3598
16238	29	3633	86	15	0	3763
16239	18	67	43	3673	0	3801
16240	14	21	3720	72	0	3827
16241	22	30	77	3456	0	3585
16242	19	13	27	3767	0	3826
16243	16	14	3662	94	0	3786
16244	17	8	3613	50	0	3688
16245	20	14	3737	31	0	3802
16246	21	11	3768	27	0	3827
16247	13	3844	116	23	0	3996
16248	9	79	62	3816	0	3966
16249	10	31	37	3978	0	4056
16250	13	24	3916	109	0	4062
16251	14	12	89	3850	0	3965
16252	11	12	4134	107	0	4264
16253	11	9	102	4064	0	4186
16254	12	10	51	4089	0	4162
16255	9	4144	40	100	0	4293
16256	15	75	22	4190	0	4302
16257	10	37	32	4149	0	4228
16258	21	33	14	4204	0	4272
16259	8	19	4092	148	0	4267
16260	13	4074	76	76	0	4239
16261	4084	80	43	62	0	4269
16262	4118	37	34	47	0	4236
16263	103	31	19	4085	0	4238
16264	47	15	23	4029	0	4114
16265	31	4131	10	113	0	4285
16266	4086	88	11	70	0	4255
16267	87	4161	12	58	0	4318
16268	4053	88	23	41	0	4205
16269	96	37	3987	33	0	4153
16270	3797	41	78	27	0	3943
16271	99	3922	39	21	0	4081
16272	46	85	26	3989	0	4146
16273	47	32	26	3963	0	4068
16274	19	3957	16	106	0	4098
16275	4038	87	10	60	0	4195
16276	83	45	22	4130	0	4280
16277	42	30	18	4258	0	4348
16278	4211	27	25	122	0	4385
16279	4291	20	18	66	0	4395
16280	131	19	4202	42	0	4394
16281	4255	16	96	47	0	4414
16282	117	21	35	4345	0	4518
16283	64	13	4323	112	0	4512
16284	47	17	98	4295	0	4457
16285	33	12	4262	126	0	4433
16286	27	20	4259	57	0	4363
16287	27	10	128	4252	0	4417
16288	15	28	4311	108	0	4462
16289	28	4304	118	72	0	4522
16290	21	87	66	4304	0	4478
16291	22	30	55	4532	0	4639
16292	16	34	4506	143	0	4699
16293	15	4431	112	87	0	4645
16294	4457	96	60	72	0	4685
16295	96	45	43	4586	0	4770
16296	4551	37	34	131	0	4753
16297	119	4425	31	68	0	4643
16298	45	118	4454	57	0	4674
16299	57	48	115	4419	0	4639
16300	4402	51	61	127	0	4641
16301	119	28	4438	71	0	4656
16302	4221	24	127	58	0	4430
16303	135	4283	59	53	0	4530
16304	42	4376	47	43	0	4508
16305	4373	101	34	48	0	4556
16306	99	45	46	4376	0	4566
16307	52	44	36	4337	0	4469
16308	37	4408	31	132	0	4608
16309	21	96	28	4496	0	4641
16310	27	40	33	4511	0	4611
16311	4415	33	23	155	0	4626
16312	96	19	18	4425	0	4558
16313	41	27	4376	133	0	4577
16314	43	21	94	4386	0	4544
16315	25	23	43	4544	0	4635
16316	33	17	4466	134	0	4650
16317	17	27	91	4504	0	4639
16318	4436	15	44	155	0	4650
16319	4386	17	39	93	0	4535
16320	4397	11	30	75	0	4513
16321	128	19	29	4374	0	4550
16322	75	22	4323	117	0	4537
16323	57	4340	82	72	0	4551
16324	46	79	37	4447	0	4609
16325	37	51	4420	104	0	4612
16326	32	44	87	4321	0	4484
16327	30	24	47	4412	0	4513
16328	4228	19	25	145	0	4417
16329	90	4357	32	78	0	4557
16330	47	94	4230	49	0	4420
16331	3909	37	75	57	0	4078
16332	103	4135	45	40	0	4323
16333	34	3726	22	20	0	3802
16334	3796	67	35	26	0	3924
16335	66	33	19	3785	0	3903
16336	38	16	4139	72	0	4265
16337	27	13	64	4050	0	4154
16338	17	4157	23	70	0	4267
16339	4202	72	19	32	0	4325
16340	73	28	15	4214	0	4330
16341	4292	11	10	96	0	4409
16342	81	15	8	4220	0	4324
16343	31	4374	12	73	0	4490
16344	4484	71	12	43	0	4610
16345	4485	23	11	43	0	4562
16346	99	4502	13	26	0	4640
16347	4451	80	15	31	0	4577
16348	96	34	9	4359	0	4498
16349	43	4373	11	76	0	4503
16350	4394	85	5	42	0	4526
16351	93	4423	6	24	0	4546
16352	4314	89	3	25	0	4431
16353	94	30	5	4307	0	4436
16354	4368	20	9	89	0	4486
16355	4392	14	6	41	0	4453
16356	4426	21	8	31	0	4486
16357	115	13	6	4367	0	4501
16358	44	13	1	4464	0	4522
16359	4400	16	5	101	0	4522
16360	100	16	4418	40	0	4574
16361	40	14	75	4393	0	4522
16362	34	4469	19	92	0	4614
16363	25	85	13	4548	0	4671
16364	32	30	8	4583	0	4653
16365	33	20	4520	106	0	4679
16366	34	13	78	4797	0	4922
16367	19	5068	22	123	0	5232
16368	26	109	17	5271	0	5423
16369	26	56	5730	137	0	5949
16370	23	34	135	5765	0	5957
16371	25	21	64	6011	0	6121
16372	5826	20	23	226	0	6095
16373	5870	12	17	111	0	6010
16374	221	19	8	5774	0	6022
16375	117	5570	14	160	0	5861
16376	62	5777	10	95	0	5944
16377	43	180	5644	62	0	5929
16378	33	113	127	5633	0	5906
16379	5666	32	87	161	0	5946
16380	142	36	39	5707	0	5924
16381	89	23	5676	182	0	5970
16382	47	19	132	5680	0	5878
16383	51	28	68	5788	0	5935
16384	40	20	35	5939	0	6034
16385	27	22	5735	244	0	6028
16386	31	5755	138	114	0	6038
16387	5711	134	73	82	0	6000
16388	5770	72	43	61	0	5946
16389	195	36	24	5634	0	5889
16390	111	31	5553	160	0	5855
16391	59	5541	129	114	0	5843
16392	59	136	87	5293	0	5575
16393	31	5471	35	150	0	5687
16394	30	5679	26	99	0	5834
16395	5522	191	27	64	0	5804
16396	147	103	5536	45	0	5831
16397	96	52	5489	43	0	5680
16398	72	42	177	5474	0	5765
16399	55	36	91	5678	0	5860
16400	38	26	5715	205	0	5984
16401	29	36	149	5580	0	5794
16402	34	45	5683	174	0	5936
16403	5276	23	146	139	0	5584
16404	134	34	97	5587	0	5852
16405	103	27	5718	165	0	6013
16406	69	28	139	5404	0	5640
16407	39	5854	102	157	0	6152
16408	5842	118	50	134	0	6144
16409	124	5889	47	86	0	6146
16410	5954	140	33	88	0	6215
16411	157	85	5815	60	0	6117
16412	5850	50	133	67	0	6100
16413	152	39	96	5941	0	6228
16414	114	40	5951	155	0	6260
16415	62	33	139	5939	0	6173
16416	56	25	5849	180	0	6110
16417	5371	34	144	138	0	5687
16418	139	5782	95	86	0	6102
16419	122	122	53	5489	0	5786
16420	56	5911	50	151	0	6168
16421	5868	140	53	115	0	6176
16422	5893	93	51	91	0	6128
16423	206	5891	43	78	0	6218
16424	116	134	51	5931	0	6232
16425	86	90	38	5988	0	6202
16426	66	60	27	6034	0	6187
16427	5830	52	50	249	0	6181
16428	138	5848	39	162	0	6187
16429	91	153	45	5786	0	6075
16430	63	94	38	5913	0	6108
16431	5758	67	36	247	0	6108
16432	170	33	5614	148	0	5965
16433	110	43	5488	127	0	5768
16434	5349	30	175	103	0	5657
16435	141	26	5465	96	0	5728
16436	88	33	4967	86	0	5174
16437	61	31	180	4909	0	5181
16438	5030	27	113	127	0	5297
16439	119	40	64	5035	0	5258
16440	105	22	4998	153	0	5278
16441	4680	27	122	132	0	4961
16442	137	23	4943	78	0	5181
16443	88	4867	141	53	0	5149
16444	62	111	129	4928	0	5230
16445	4952	84	49	114	0	5199
16446	92	35	50	4950	0	5127
16447	83	31	57	4969	0	5140
16448	5062	14	37	196	0	5309
16449	117	13	49	5120	0	5299
16450	83	22	30	5237	0	5372
16451	35	21	5144	188	0	5388
16452	53	20	89	5137	0	5299
16453	5182	14	92	155	0	5443
16454	5163	28	42	115	0	5348
16455	5201	18	42	70	0	5331
16456	180	21	24	5051	0	5276
16457	114	5030	29	131	0	5304
16458	5108	80	39	90	0	5317
16459	111	5178	29	62	0	5380
16460	5155	102	29	56	0	5342
16461	134	78	25	5140	0	5377
16462	5155	34	42	98	0	5329
16463	5049	20	28	105	0	5202
16464	5130	14	33	47	0	5224
16465	169	4979	20	52	0	5220
16466	64	4718	27	41	0	4850
16467	4480	62	24	31	0	4597
16468	64	4523	18	24	0	4629
16469	23	3967	5	9	0	4004
16470	7	3877	2	3	0	3889
16471	3883	22	16	10	0	3931
16472	19	11	1	3836	0	3867
16473	9	5	1	3851	0	3866
16474	3882	5	0	23	0	3910
16475	27	4	3959	5	0	3995
16476	8	0	19	4416	0	4443
16477	6	3	3	4435	0	4447
16478	7	1	1	4954	0	4963
16479	8	2	4	5086	0	5100
16480	3	5079	3	132	0	5217
16481	1	6203	1	56	0	6261
16482	6323	149	0	33	0	6505
16483	141	66	0	6312	0	6519
16484	64	40	1	6468	0	6573
16485	29	17	6293	200	0	6539
16486	20	8	143	6350	0	6521
16487	15	9	6393	198	0	6615
16488	10	11	170	6412	0	6603
16489	15	3	6707	196	0	6921
16490	7	6619	188	102	0	6916
16491	7	154	82	6741	0	6984
16492	6731	70	41	200	0	7042
16493	6806	33	23	94	0	6956
16494	240	19	21	6711	0	6991
16495	98	19	6682	207	0	7006
16496	58	15	6602	95	0	6770
16497	6300	14	237	63	0	6614
16498	172	6542	100	48	0	6862
16499	6680	167	53	43	0	6943
16500	6677	72	34	31	0	6814
16501	255	39	6510	36	0	6840
16502	122	22	186	6377	0	6707
16503	73	18	103	6513	0	6707
16504	52	20	45	6902	0	7019
16505	39	19	32	6591	0	6681
16506	53	18	28	6426	0	6525
16507	44	9	6170	317	0	6540
16508	38	11	6213	166	0	6428
16509	36	14	259	6233	0	6542
16510	30	12	126	6418	0	6586
16511	36	10	64	6574	0	6684
16512	6277	25	44	323	0	6669
16513	216	21	31	6347	0	6615
16514	6355	12	27	266	0	6660
16515	251	13	37	6522	0	6823
16516	6601	9	27	308	0	6945
16517	6785	6	30	169	0	6990
16518	6753	9	28	118	0	6908
16519	6784	12	23	98	0	6917
16520	6771	10	32	85	0	6898
16521	337	12	34	6528	0	6911
16522	6555	10	40	251	0	6856
16523	259	6430	32	143	0	6864
16524	6565	199	19	107	0	6890
16525	283	82	17	6601	0	6983
16526	150	40	6493	261	0	6944
16527	100	19	206	6659	0	6984
16528	86	14	6645	297	0	7042
16529	72	13	248	6636	0	6969
16530	71	18	112	6869	0	7070
16531	74	20	6625	345	0	7064
16532	80	16	6601	179	0	6876
16533	76	20	308	6614	0	7018
16534	6627	15	128	291	0	7061
16535	250	12	6599	185	0	7046
16536	141	6587	243	125	0	7096
16537	83	198	6908	103	0	7292
16538	6840	79	259	98	0	7276
16539	262	46	131	6924	0	7363
16540	7009	29	95	291	0	7424
16541	7139	20	59	173	0	7391
16542	344	21	63	6993	0	7421
16543	176	25	6773	304	0	7278
16544	116	20	230	6806	0	7172
16545	105	19	127	6943	0	7194
16546	6611	15	83	395	0	7104
16547	261	6692	73	215	0	7241
16548	150	213	61	6801	0	7225
16549	108	79	6644	321	0	7152
16550	6390	50	254	177	0	6871
16551	258	6556	139	125	0	7078
16552	151	218	81	6676	0	7126
16553	109	91	68	6790	0	7058
16554	90	55	55	6935	0	7135
16555	6641	37	39	403	0	7120
16556	6844	28	47	222	0	7141
16557	354	22	78	6778	0	7232
16558	178	33	6659	328	0	7198
16559	121	6580	239	203	0	7143
16560	6660	218	117	126	0	7121
16561	6834	111	66	122	0	7133
16562	370	53	62	6633	0	7118
16563	192	31	66	6872	0	7161
16564	128	29	6760	397	0	7314
16565	93	6756	246	212	0	7307
16566	6937	228	117	160	0	7442
16567	6803	103	69	133	0	7108
16568	329	6796	61	115	0	7301
16569	6876	238	59	96	0	7269
16570	330	105	45	6790	0	7270
16571	166	53	6674	322	0	7215
16572	133	42	250	6810	0	7235
16573	87	49	6711	342	0	7189
16574	6502	26	270	181	0	6979
16575	300	6556	119	127	0	7102
16576	129	222	58	6133	0	6542
16577	95	79	6041	271	0	6486
16578	77	41	5814	119	0	6051
16579	5366	55	221	116	0	5758
16580	197	5432	106	67	0	5802
16581	4495	101	73	42	0	4711
16582	4390	53	39	37	0	4519
16583	4425	18	38	48	0	4529
16584	155	28	16	4325	0	4524
16585	76	22	4314	123	0	4535
16586	62	4280	100	57	0	4499
16587	57	101	72	4344	0	4574
16588	51	44	4336	114	0	4545
16589	38	28	3992	39	0	4097
16590	35	30	91	4028	0	4184
16591	30	11	4007	99	0	4147
16592	3737	10	92	51	0	3890
16593	85	12	47	3967	0	4111
16594	44	11	24	4126	0	4205
16595	4085	19	27	102	0	4233
16596	84	4055	25	52	0	4216
16597	4316	65	29	57	0	4467
16598	85	24	30	4299	0	4438
16599	49	27	23	4350	0	4449
16600	42	22	22	4378	0	4464
16601	41	17	18	4286	0	4362
16602	4203	13	23	107	0	4346
16603	96	14	4132	63	0	4305
16604	48	4093	77	41	0	4259
16605	33	70	33	4203	0	4339
16606	3983	42	26	98	0	4149
16607	4143	20	24	58	0	4245
16608	99	4132	29	45	0	4305
16609	4049	67	20	28	0	4164
16610	85	4023	21	29	0	4158
16611	52	4169	18	30	0	4269
16612	35	79	25	4202	0	4341
16613	30	30	4171	88	0	4319
16614	33	40	63	4054	0	4190
16615	4003	24	28	84	0	4139
16616	80	3886	12	41	0	4019
16617	31	69	14	3923	0	4037
16618	27	25	4145	85	0	4282
16619	4071	19	73	51	0	4214
16620	4292	12	27	39	0	4370
16621	4341	12	16	33	0	4402
16622	100	21	4132	17	0	4270
16623	3964	15	61	19	0	4059
16624	85	4085	24	19	0	4213
16625	45	65	13	3975	0	4098
16626	35	4078	17	68	0	4198
16627	4107	68	13	33	0	4221
16628	3893	30	15	28	0	3966
16629	76	24	4054	26	0	4180
16630	36	4040	60	25	0	4161
16631	25	67	24	4079	0	4195
16632	24	28	16	4126	0	4194
16633	26	15	25	4068	0	4134
16634	27	16	22	4112	0	4177
16635	23	12	15	4293	0	4343
16636	30	14	4055	104	0	4203
16637	23	3974	73	43	0	4113
16638	3948	82	30	36	0	4096
16639	103	28	4076	20	0	4227
16640	42	4141	87	23	0	4293
16641	4183	83	28	36	0	4330
16642	99	28	4387	30	0	4544
16643	4241	20	109	30	0	4400
16644	4286	24	28	28	0	4366
16645	4423	22	23	24	0	4492
16646	112	4348	19	27	0	4506
16647	50	93	4270	32	0	4445
16648	41	4367	98	20	0	4526
16649	57	103	49	3677	0	3886
16650	38	4388	20	67	0	4513
16651	4353	92	26	34	0	4505
16652	4527	36	17	34	0	4614
16653	4426	36	19	28	0	4509
16654	131	25	4476	24	0	4656
16655	48	4607	110	29	0	4794
16656	49	112	34	5014	0	5209
16657	5406	45	18	125	0	5594
16658	170	5336	18	42	0	5566
16659	73	158	21	5392	0	5644
16660	55	57	5510	149	0	5771
16661	5505	43	151	56	0	5755
16662	188	24	5864	48	0	6124
16663	88	28	5970	31	0	6117
16664	5548	17	212	31	0	5808
16665	204	23	5741	23	0	5991
16666	5423	17	193	17	0	5650
16667	181	5486	88	15	0	5770
16668	5743	155	46	25	0	5969
16669	192	60	37	5710	0	5999
16670	102	31	42	5626	0	5801
16671	56	25	34	5885	0	6000
16672	5741	16	36	239	0	6032
16673	5763	12	33	99	0	5907
16674	5834	21	23	50	0	5928
16675	250	5575	31	35	0	5891
16676	110	157	23	5659	0	5949
16677	74	59	5589	180	0	5902
16678	59	30	166	5414	0	5669
16679	55	5385	66	198	0	5704
16680	54	168	33	5441	0	5696
16681	61	59	27	5572	0	5719
16682	5495	34	28	235	0	5792
16683	196	33	20	5513	0	5762
16684	89	34	5460	221	0	5804
16685	72	28	5355	112	0	5567
16686	63	26	214	5455	0	5758
16687	5377	27	109	221	0	5734
16688	189	40	52	5409	0	5690
16689	106	21	41	5632	0	5800
16690	69	17	5449	253	0	5788
16691	65	5371	174	129	0	5739
16692	50	164	89	5558	0	5861
16693	5408	59	74	219	0	5760
16694	191	5372	58	117	0	5738
16695	109	171	41	5462	0	5783
16696	79	83	5403	216	0	5781
16697	56	60	191	5267	0	5574
16698	5116	41	81	248	0	5486
16699	185	5078	53	151	0	5467
16700	111	170	5151	104	0	5536
16701	76	80	175	5143	0	5474
16702	65	51	5271	225	0	5612
16703	5143	47	209	114	0	5513
16704	5322	45	91	95	0	5553
16705	241	38	5236	87	0	5602
16706	131	39	194	5208	0	5572
16707	83	64	5324	202	0	5673
16708	60	5214	225	130	0	5629
16709	67	171	132	5332	0	5702
16710	70	80	5313	239	0	5702
16711	76	64	211	5044	0	5395
16712	69	5211	126	211	0	5617
16713	70	171	89	5341	0	5671
16714	60	74	5261	241	0	5636
16715	5014	62	221	138	0	5435
16716	202	5253	108	111	0	5674
16717	5389	176	91	88	0	5744
16718	220	84	5171	95	0	5570
16719	5122	63	197	96	0	5478
16720	220	51	5205	75	0	5551
16721	5139	56	202	88	0	5485
16722	5404	41	114	89	0	5648
16723	271	41	80	5247	0	5639
16724	150	62	57	5460	0	5729
16725	5373	46	55	270	0	5744
16726	224	5352	70	153	0	5799
16727	5476	178	76	106	0	5836
16728	255	88	65	5386	0	5794
16729	139	5430	69	227	0	5865
16730	113	170	61	5670	0	6014
16731	102	76	69	5822	0	6069
16732	84	61	64	5761	0	5970
16733	88	5588	52	310	0	6038
16734	5529	181	45	153	0	5908
16735	216	85	45	5569	0	5915
16736	107	56	5390	246	0	5799
16737	85	46	5254	151	0	5536
16738	65	53	5329	129	0	5576
16739	5301	42	215	86	0	5644
16740	5402	42	114	93	0	5651
16741	212	44	5237	103	0	5596
16742	127	34	175	4826	0	5162
16743	82	38	97	5056	0	5273
16744	62	36	5182	236	0	5516
16745	56	34	5179	132	0	5401
16746	52	29	212	5232	0	5525
16747	5284	26	109	189	0	5608
16748	5139	35	75	122	0	5371
16749	5202	24	70	92	0	5388
16750	224	4994	71	78	0	5367
16751	105	5214	64	73	0	5456
16752	84	156	52	5158	0	5450
16753	5132	71	56	176	0	5435
16754	171	49	4993	112	0	5325
16755	4565	36	130	91	0	4822
16756	150	4380	70	59	0	4659
16757	52	4093	28	36	0	4209
16758	4000	100	32	37	0	4169
16759	93	3969	27	31	0	4120
16760	38	3843	22	34	0	3937
16761	3759	86	82	73	0	4000
16762	56	3831	8	13	0	3908
16763	15	38	9	3809	0	3871
16764	13	12	9	3838	0	3872
16765	3814	8	5	54	0	3881
16766	3793	7	9	20	0	3829
16767	50	3889	6	14	0	3959
16768	15	3910	9	13	0	3947
16769	17	43	3865	11	0	3936
16770	3899	26	56	9	0	3990
16771	4153	9	9	16	0	4187
16772	4282	3	6	15	0	4306
16773	60	7	9	4332	0	4408
16774	25	7	9	4538	0	4579
16775	4658	6	6	67	0	4737
16776	74	10	4	4701	0	4789
16777	23	5	4759	81	0	4868
16778	24	18	64	4648	0	4754
16779	10	4843	19	89	0	4961
16780	20	70	11	4927	0	5028
16781	16	19	7	4991	0	5033
16782	11	13	7	5008	0	5039
16783	4901	9	4	103	0	5017
16784	63	4872	8	37	0	4980
16785	20	70	6	5007	0	5103
16786	15	25	5021	79	0	5140
16787	16	19	4710	29	0	4774
16788	17	8	83	4860	0	4968
16789	11	10	25	4954	0	5000
16790	4852	8	14	98	0	4972
16791	80	5	13	4787	0	4885
16792	22	4781	11	97	0	4911
16793	23	71	4920	34	0	5048
16794	22	29	69	4946	0	5066
16795	20	13	5094	85	0	5212
16796	14	11	86	5059	0	5170
16797	5082	12	28	93	0	5215
16798	5131	10	18	39	0	5198
16799	97	5043	11	25	0	5176
16800	35	70	6	5118	0	5229
16801	5244	21	15	89	0	5369
16802	5300	12	15	41	0	5368
16803	5361	10	6	34	0	5411
16804	5351	12	17	23	0	5403
16805	5330	4	12	25	0	5371
16806	108	5213	11	22	0	5354
16807	5261	71	7	14	0	5353
16808	98	18	5214	13	0	5343
16809	35	14	72	5240	0	5361
16810	5355	11	15	83	0	5464
16811	5337	14	9	31	0	5391
16812	5290	11	9	27	0	5337
16813	103	4	5211	23	0	5341
16814	34	13	76	5286	0	5409
16815	5431	10	20	87	0	5548
16816	78	5391	18	32	0	5519
16817	5577	73	13	31	0	5694
16818	5492	22	5	28	0	5547
16819	5481	23	6	20	0	5530
16820	111	18	7	5517	0	5653
16821	5588	12	7	92	0	5699
16822	115	12	5521	32	0	5680
16823	37	10	5441	37	0	5525
16824	5459	6	87	37	0	5589
16825	102	10	5638	17	0	5767
16826	5252	8	78	21	0	5359
16827	93	7	5519	14	0	5633
16828	25	5	80	5398	0	5508
16829	5359	6	21	82	0	5468
16830	80	5242	22	24	0	5368
16831	5358	63	8	33	0	5462
16832	86	5183	9	15	0	5293
16833	31	5540	5	17	0	5593
16834	28	71	5	5654	0	5758
16835	15	26	15	5639	0	5695
16836	14	17	9	5617	0	5657
16837	21	8	5515	92	0	5636
16838	5265	8	62	51	0	5386
16839	5689	7	17	33	0	5746
16840	5737	8	13	28	0	5786
16841	5776	8	7	25	0	5816
16842	5760	9	10	25	0	5804
16843	116	8	5318	21	0	5463
16844	59	2	5396	25	0	5482
16845	43	6	84	5542	0	5675
16846	30	9	5483	81	0	5603
16847	5505	7	77	34	0	5623
16848	99	5816	23	33	0	5971
16849	37	82	29	6256	0	6404
16850	6334	23	12	112	0	6481
16851	135	17	14	6334	0	6500
16852	53	11	6404	124	0	6592
16853	48	14	6298	44	0	6404
16854	38	6	138	6519	0	6701
16855	44	4	6530	120	0	6698
16856	6250	10	132	52	0	6444
16857	124	7	46	6533	0	6710
16858	49	11	6527	126	0	6713
16859	46	6465	117	49	0	6677
16860	38	105	43	6661	0	6847
16861	35	31	6716	122	0	6904
16862	28	20	125	6388	0	6561
16863	32	5	48	6524	0	6609
16864	21	15	6551	165	0	6752
16865	39	10	135	6482	0	6666
16866	38	15	64	6310	0	6427
16867	27	8	37	6539	0	6611
16868	6290	9	23	185	0	6507
16869	149	6128	26	75	0	6378
16870	52	6368	23	58	0	6501
16871	44	135	6155	39	0	6373
16872	5807	49	108	36	0	6000
16873	130	27	5938	19	0	6114
16874	40	16	5829	21	0	5906
16875	36	44	112	5603	0	5795
16876	5685	8	50	105	0	5848
16877	101	5655	34	39	0	5829
16878	5678	83	23	46	0	5830
16879	5629	25	17	35	0	5706
16880	114	5710	15	34	0	5873
16881	5730	85	33	24	0	5872
16882	5682	32	15	20	0	5749
16883	115	5778	19	19	0	5931
16884	51	95	17	5827	0	5990
16885	75	28	15	5911	0	6029
16886	5989	26	15	116	0	6146
16887	107	6144	25	43	0	6319
16888	6276	116	16	35	0	6443
16889	6329	36	13	35	0	6413
16890	6723	22	22	42	0	6809
16891	177	16	15	6563	0	6771
16892	79	14	9	6759	0	6861
16893	6592	13	19	158	0	6782
16894	6789	13	11	72	0	6885
16895	6867	9	9	52	0	6937
16896	198	13	14	7039	0	7264
16897	78	12	7040	174	0	7304
16898	49	20	148	7122	0	7339
16899	40	13	50	7722	0	7825
16900	36	13	7578	216	0	7843
16901	30	11	8434	100	0	8575
16902	33	9	254	8561	0	8857
16903	28	9	8624	243	0	8904
16904	8614	10	245	137	0	9006
16905	227	13	123	8781	0	9144
16906	117	15	70	9007	0	9209
16907	9036	10	28	335	0	9409
16908	239	15	43	9089	0	9386
16909	133	13	38	9167	0	9351
16910	81	7	34	9296	0	9418
16911	60	9	34	9330	0	9433
16912	51	22	8887	384	0	9344
16913	39	9	223	9034	0	9305
16914	53	10	8711	330	0	9104
16915	48	8792	243	194	0	9277
16916	38	219	105	8864	0	9226
16917	51	90	8703	286	0	9130
16918	8192	47	245	189	0	8673
16919	236	8594	139	131	0	9100
16920	8722	225	80	98	0	9125
16921	277	97	59	8427	0	8860
16922	133	8445	63	259	0	8900
16923	8504	226	47	158	0	8935
16924	267	8582	37	117	0	9003
16925	8675	248	49	92	0	9064
16926	287	125	39	8546	0	8997
16927	8636	80	31	297	0	9044
16928	289	8648	37	172	0	9146
16929	8706	247	42	113	0	9108
16930	302	116	8500	100	0	9018
16931	171	76	241	8584	0	9072
16932	8498	54	133	287	0	8972
16933	8617	44	67	184	0	8912
16934	382	27	65	8424	0	8898
16935	179	43	8372	320	0	8914
16936	135	7873	234	188	0	8430
16937	100	8506	126	141	0	8873
16938	8548	294	97	126	0	9065
16939	290	137	53	8454	0	8934
16940	172	77	52	8644	0	8945
16941	8468	54	66	393	0	8981
16942	8499	41	65	225	0	8830
16943	374	42	8357	159	0	8932
16944	196	67	250	8394	0	8907
16945	139	44	8253	333	0	8769
16946	121	8222	268	212	0	8823
16947	7790	222	131	172	0	8315
16948	274	7883	88	143	0	8388
16949	163	7869	59	122	0	8213
16950	131	275	62	7791	0	8259
16951	7536	136	68	302	0	8042
16952	222	7589	63	202	0	8076
16953	7518	228	77	138	0	7961
16954	256	7453	66	129	0	7904
16955	183	217	71	7531	0	8002
16956	7485	150	68	276	0	7979
16957	254	97	7515	202	0	8068
16958	174	77	216	7585	0	8052
16959	149	67	7438	283	0	7937
16960	124	6975	223	217	0	7539
16961	117	7404	117	169	0	7807
16962	7109	272	88	158	0	7627
16963	252	7367	66	142	0	7827
16964	7376	234	82	157	0	7849
16965	7484	166	84	149	0	7883
16966	323	111	7203	132	0	7769
16967	7231	98	220	139	0	7688
16968	291	101	7382	118	0	7892
16969	212	7329	221	127	0	7889
16970	7367	237	151	96	0	7851
16971	290	7325	95	121	0	7831
16972	204	241	80	7413	0	7938
16973	7445	145	96	258	0	7944
16974	323	117	57	7390	0	7887
16975	208	96	7389	299	0	7992
16976	150	102	205	7410	0	7867
16977	147	101	124	7563	0	7935
16978	7387	126	72	344	0	7929
16979	289	94	7243	213	0	7839
16980	7267	106	226	147	0	7746
16981	7625	77	128	146	0	7976
16982	357	88	110	7490	0	8045
16983	279	82	74	7554	0	7989
16984	7394	88	74	351	0	7907
16985	339	7321	71	206	0	7937
16986	234	209	84	7194	0	7721
16987	173	151	6881	243	0	7448
16988	169	107	6570	162	0	7008
16989	129	6897	226	127	0	7379
16990	134	218	124	6528	0	7004
16991	106	146	68	6674	0	6994
16992	6521	107	52	280	0	6960
16993	248	87	58	6466	0	6859
16994	6169	67	60	232	0	6528
16995	238	5945	75	167	0	6425
16996	154	5793	58	122	0	6127
16997	134	6022	41	99	0	6296
16998	5847	183	72	119	0	6221
16999	5325	105	79	96	0	5605
17000	212	5211	44	102	0	5569
17001	4158	50	30	19	0	4257
17002	60	4071	12	19	0	4162
17003	37	54	11	3973	0	4075
17004	14	3952	12	51	0	4029
17005	3951	57	10	31	0	4049
17006	3934	23	5	19	0	3981
17007	68	27	8	3756	0	3859
17008	3752	14	3	54	0	3823
17009	66	21	10	3681	0	3778
17010	32	3752	9	59	0	3852
17011	26	74	13	3752	0	3865
17012	35	3767	3	47	0	3852
17013	3727	51	10	25	0	3813
17014	55	22	3601	24	0	3702
17015	3489	16	33	22	0	3560
17016	54	15	9	3608	0	3686
17017	24	27	3577	40	0	3668
17018	3435	16	34	36	0	3521
17019	48	21	3683	19	0	3771
17020	29	13	38	3534	0	3614
17021	33	11	18	3606	0	3668
17022	29	13	10	3556	0	3608
17023	25	9	11	3597	0	3642
17024	17	3551	16	56	0	3640
17025	27	50	12	3791	0	3880
17026	3770	24	13	66	0	3873
17027	53	16	3685	41	0	3795
17028	29	3940	46	29	0	4044
17029	4068	65	17	29	0	4179
17030	4449	36	13	24	0	4522
17031	109	28	8	5115	0	5260
17032	54	19	5072	118	0	5263
17033	46	14	104	5047	0	5211
17034	28	18	64	5450	0	5560
17035	30	17	5379	182	0	5608
17036	32	5585	134	88	0	5839
17037	5748	147	63	44	0	6002
17038	5774	70	26	57	0	5927
17039	5951	37	32	33	0	6053
17040	232	25	19	5803	0	6079
17041	120	20	17	6108	0	6265
17042	6160	16	26	231	0	6433
17043	220	20	15	5760	0	6015
17044	117	5906	12	198	0	6233
17045	6196	163	21	104	0	6484
17046	6180	81	20	96	0	6377
17047	6763	36	17	69	0	6885
17048	6878	25	21	65	0	6989
17049	331	34	6456	54	0	6875
17050	181	14	6555	50	0	6800
17051	111	28	258	6421	0	6818
17052	109	24	113	6640	0	6886
17053	95	16	6497	282	0	6890
17054	70	18	6585	134	0	6807
17055	82	9	275	6519	0	6885
17056	6561	14	130	239	0	6944
17057	224	17	87	6485	0	6813
17058	130	14	6512	260	0	6916
17059	87	6567	219	143	0	7016
17060	6644	187	114	100	0	7045
17061	6862	83	78	80	0	7103
17062	6961	49	81	60	0	7151
17063	6978	30	59	66	0	7133
17064	358	25	6491	77	0	6951
17065	202	13	227	6560	0	7002
17066	6650	25	134	225	0	7034
17067	271	26	82	6664	0	7043
17068	182	20	65	6396	0	6663
17069	131	6346	56	311	0	6844
17070	122	179	46	6642	0	6989
17071	6427	101	56	278	0	6862
17072	254	6454	57	173	0	6938
17073	6491	217	46	118	0	6872
17074	301	6449	36	101	0	6887
17075	202	229	30	6082	0	6543
17076	144	6114	47	218	0	6523
17077	110	6501	45	145	0	6801
17078	6395	280	40	106	0	6821
17079	282	156	6253	102	0	6793
17080	171	80	6147	103	0	6501
17081	123	87	6137	100	0	6447
17082	5742	73	296	119	0	6230
17083	257	5876	165	101	0	6399
17084	152	6204	99	86	0	6541
17085	5897	286	63	101	0	6347
17086	300	5904	71	76	0	6351
17087	194	6268	67	81	0	6610
17088	127	305	68	6186	0	6686
17089	127	196	6095	262	0	6680
17090	154	115	6174	162	0	6605
17091	131	109	290	6219	0	6749
17092	6083	107	172	281	0	6643
17093	290	6204	135	161	0	6790
17094	200	248	108	6273	0	6829
17095	177	146	6217	279	0	6819
17096	162	120	6108	172	0	6562
17097	157	85	326	6091	0	6659
17098	6076	79	186	312	0	6653
17099	6247	100	116	197	0	6660
17100	395	77	6002	143	0	6617
17101	6059	86	276	147	0	6568
17102	335	93	6122	116	0	6666
17103	242	61	310	5767	0	6380
17104	193	5975	195	277	0	6640
17105	6235	234	154	167	0	6790
17106	337	141	129	6263	0	6870
17107	226	103	138	6198	0	6665
17108	188	67	121	6522	0	6898
17109	150	65	115	6564	0	6894
17110	139	53	6187	435	0	6814
17111	158	6109	293	235	0	6795
17112	132	224	203	6317	0	6876
17113	6250	123	118	342	0	6833
17114	321	97	122	6334	0	6874
17115	208	55	126	6426	0	6815
17116	167	97	6112	398	0	6774
17117	156	103	5899	232	0	6390
17118	161	5890	317	195	0	6563
17119	129	6203	179	167	0	6678
17120	142	306	120	6193	0	6761
17121	6111	167	108	342	0	6728
17122	263	116	6069	252	0	6700
17123	205	6217	249	177	0	6848
17124	148	255	159	5994	0	6556
17125	124	6231	99	293	0	6747
17126	147	279	89	5994	0	6509
17127	92	6172	92	294	0	6650
17128	102	238	69	5943	0	6352
17129	5659	165	85	249	0	6158
17130	216	5401	63	165	0	5845
17131	81	179	41	4660	0	4961
17132	4559	90	55	172	0	4876
17133	138	4486	38	124	0	4786
17134	68	4058	37	69	0	4232
17135	61	4135	35	64	0	4295
17136	74	118	53	3880	0	4125
17137	27	71	22	3799	0	3919
17138	18	3781	15	110	0	3924
17139	29	100	16	3798	0	3943
17140	40	60	3709	97	0	3906
17141	28	3738	61	56	0	3883
17142	25	205	29	3481	0	3740
17143	20	3725	12	63	0	3820
17144	44	56	3549	43	0	3692
17145	12	3616	46	34	0	3708
17146	3181	78	10	25	0	3294
17147	28	14	3	3150	0	3195
17148	3122	4	3	31	0	3160
17149	31	6	3052	13	0	3102
17150	14	4	27	3119	0	3164
17151	4	5	3174	33	0	3216
17152	6	4	31	3142	0	3183
17153	3274	4	11	38	0	3327
17154	27	3	6	3251	0	3287
17155	3262	4	7	38	0	3311
17156	29	3301	4	14	0	3348
17157	3289	30	4	16	0	3339
17158	33	11	3280	9	0	3333
17159	15	3281	28	6	0	3330
17160	9	31	7	3379	0	3426
17161	13	7	4	3344	0	3368
17162	5	11	3297	32	0	3345
17163	9	3270	27	13	0	3319
17164	5	27	10	3363	0	3405
17165	5	3380	6	25	0	3416
17166	1	33	2	3363	0	3399
17167	1	3352	1	34	0	3388
17168	3314	29	5	14	0	3362
17169	26	15	3	3386	0	3430
17170	4	7	3380	34	0	3425
17171	5	3337	22	11	0	3375
17172	1	3485	7	9	0	3502
17173	4	33	3414	4	0	3455
17174	7	3435	23	3	0	3468
17175	3	24	3	3443	0	3473
17176	2	8	3474	25	0	3509
17177	7	9	27	3410	0	3453
17178	3	4	3	3504	0	3514
17179	2	2	3530	26	0	3560
17180	3304	5	25	17	0	3351
17181	27	1	4	3642	0	3674
17182	4	2	3945	27	0	3978
17183	5	3981	25	8	0	4019
17184	4034	26	9	13	0	4082
17185	21	3992	8	5	0	4026
17186	9	25	4	4052	0	4090
17187	3939	6	0	32	0	3977
17188	22	4	4	3930	0	3960
17189	4	6	4073	27	0	4110
17190	11	3	27	4034	0	4075
17191	2	6	4030	29	0	4067
17192	3835	3	30	15	0	3883
17193	29	7	4033	8	0	4077
17194	3968	7	29	19	0	4023
17195	4137	3	11	8	0	4159
17196	36	2	4159	6	0	4203
17197	20	1	3872	10	0	3903
17198	10	4170	35	2	0	4217
17199	4323	25	20	14	0	4382
17200	31	9	8	4439	0	4487
17201	16	4	5	4364	0	4389
17202	4832	5	5	65	0	4907
17203	4902	0	7	30	0	4939
17204	4963	5	3	14	0	4985
17205	4972	3	2	12	0	4989
17206	39	2	4	4856	0	4901
17207	4943	1	6	41	0	4991
17208	35	4	1	4919	0	4959
17209	18	0	2	4893	0	4913
17210	13	1	4	4933	0	4951
17211	9	9	4825	37	0	4880
17212	8	4647	26	16	0	4697
17213	7	4771	9	9	0	4796
17214	4	31	7	4885	0	4927
17215	4875	8	16	37	0	4936
17216	29	8	3	4865	0	4905
17217	4846	4	6	38	0	4894
17218	37	5	4981	16	0	5039
17219	4809	5	31	16	0	4861
17220	36	5	7	5111	0	5159
17221	5276	2	8	48	0	5334
17222	5199	1	7	21	0	5228
17223	5172	6	3	18	0	5199
17224	45	3	8	5165	0	5221
17225	24	0	5127	33	0	5184
17226	14	7	35	5084	0	5140
17227	5219	1	10	50	0	5280
17228	50	4	5753	15	0	5822
17229	20	5	45	6003	0	6073
17230	6256	3	13	67	0	6339
17231	58	3	6278	16	0	6355
17232	6446	3	57	28	0	6534
17233	6849	2	17	20	0	6888
17234	84	3	15	6907	0	7009
17235	34	2	11	6983	0	7030
17236	7003	2	7	87	0	7099
17237	77	1	9	7204	0	7291
17238	7130	4	6	108	0	7248
17239	89	7104	4	40	0	7237
17240	29	7255	6	32	0	7322
17241	22	88	1	7220	0	7331
17242	19	26	7294	92	0	7431
17243	15	7223	87	22	0	7347
17244	7093	89	14	27	0	7223
17245	77	7059	14	22	0	7172
17246	22	87	7056	11	0	7176
17247	30	23	79	6828	0	6960
17248	19	23	7168	79	0	7289
17249	12	7314	85	27	0	7438
17250	14	76	29	7331	0	7450
17251	9	7279	23	76	0	7387
17252	6	89	7249	24	0	7368
17253	14	36	79	7136	0	7265
17254	6	23	7369	82	0	7480
17255	12	20	88	7245	0	7365
17256	7324	14	29	103	0	7470
17257	83	15	7203	29	0	7330
17258	6721	15	90	40	0	6866
17259	94	6	7146	24	0	7270
17260	30	12	89	7087	0	7218
17261	27	7	7415	87	0	7536
17262	27	11	90	7244	0	7372
17263	19	8	40	7387	0	7454
17264	15	12	30	7175	0	7232
17265	9	7	27	7386	0	7429
17266	12	9	7739	122	0	7882
17267	7378	5	84	76	0	7543
17268	80	6	25	8296	0	8407
17269	8255	9	29	111	0	8404
17270	8409	6	28	47	0	8490
17271	8546	7	16	49	0	8618
17272	132	5	26	8638	0	8801
17273	63	10	9	8757	0	8839
17274	43	9521	16	131	0	9711
17275	10468	152	12	66	0	10698
17276	11096	49	18	57	0	11220
17277	11240	34	12	59	0	11345
17278	327	31	11168	32	0	11558
17279	145	25	222	11141	0	11533
17280	101	17	11115	241	0	11474
17281	10858	21	253	98	0	11230
17282	11080	14	102	54	0	11250
17283	325	8	66	10799	0	11198
17284	147	14	57	10646	0	10864
17285	101	10961	44	278	0	11384
17286	11109	215	24	133	0	11481
17287	11238	77	31	96	0	11442
17288	337	11020	30	67	0	11454
17289	11238	254	23	69	0	11584
17290	335	88	29	11203	0	11655
17291	163	52	39	11376	0	11630
17292	11324	53	21	317	0	11715
17293	317	29	11154	137	0	11637
17294	11018	24	218	133	0	11393
17295	11393	32	87	94	0	11606
17296	358	11045	53	82	0	11538
17297	11320	225	48	70	0	11663
17298	338	94	11049	61	0	11542
17299	198	73	234	11040	0	11545
17300	11120	64	87	255	0	11526
17301	345	42	59	11089	0	11535
17302	183	30	10539	298	0	11050
17303	118	37	242	10243	0	10640
17304	115	11166	102	317	0	11700
17305	104	235	77	11607	0	12023
17306	96	93	67	11831	0	12087
17307	125	54	49	11590	0	11818
17308	86	63	45	11803	0	11997
17309	79	50	11469	421	0	12019
17310	94	41	241	11574	0	11950
17311	11504	48	96	385	0	12033
17312	292	11376	55	215	0	11938
17313	126	248	68	11808	0	12250
17314	107	89	11788	366	0	12350
17315	115	66	258	11885	0	12324
17316	11999	56	114	374	0	12543
17317	12049	53	82	191	0	12375
17318	11816	39	71	162	0	12088
17319	411	48	62	11783	0	12304
17320	228	19	11616	351	0	12214
17321	186	11422	262	190	0	12060
17322	11657	248	128	154	0	12187
17323	341	81	88	11595	0	12105
17324	197	79	91	11819	0	12186
17325	181	67	11436	385	0	12069
17326	166	10999	249	213	0	11627
17327	129	11648	136	161	0	12074
17328	142	342	87	10964	0	11535
17329	133	134	10677	332	0	11276
17330	9826	92	255	212	0	10385
17331	333	91	9874	151	0	10449
17332	9603	69	233	146	0	10051
17333	332	10260	118	123	0	10833
17334	190	233	10126	109	0	10658
17335	9840	112	269	120	0	10341
17336	335	10030	118	109	0	10592
17337	10272	246	94	96	0	10708
17338	323	116	10090	93	0	10622
17339	198	10145	227	84	0	10654
17340	10317	253	113	99	0	10782
17341	319	119	10102	85	0	10625
17342	10038	75	246	91	0	10450
17343	322	69	126	10090	0	10607
17344	10277	52	104	243	0	10676
17345	306	44	97	10225	0	10672
17346	10218	69	70	282	0	10639
17347	312	50	10187	179	0	10728
17348	166	45	237	10309	0	10757
17349	132	49	106	10339	0	10626
17350	122	44	10153	348	0	10667
17351	94	56	248	10135	0	10533
17352	111	8320	185	342	0	8958
17353	90	214	95	11149	0	11548
17354	82	102	99	11826	0	12109
17355	102	58	69	12955	0	13184
17356	92	52	12644	555	0	13343
17357	12374	44	380	287	0	13085
17358	427	46	150	13659	0	14282
17359	201	40	13783	530	0	14554
17360	13468	32	461	265	0	14226
17361	14101	46	169	175	0	14491
17362	14554	43	111	164	0	14872
17363	643	38	109	14243	0	15033
17364	297	55	79	15831	0	16262
17365	198	57	76	15377	0	15708
17366	138	15140	102	718	0	16098
17367	15117	521	59	345	0	16042
17368	15136	171	77	246	0	15630
17369	713	102	78	14923	0	15816
17370	302	80	14512	634	0	15528
17371	242	61	14662	279	0	15244
17372	176	13645	635	214	0	14670
17373	145	14710	247	154	0	15256
17374	13179	594	197	193	0	14163
17375	432	12833	68	116	0	13449
17376	12644	409	76	80	0	13209
17377	12743	118	44	53	0	12958
17378	12708	81	31	60	0	12880
17379	561	54	36	12470	0	13121
17380	229	40	41	13470	0	13780
17381	13526	44	27	571	0	14168
17382	543	43	31	13871	0	14488
17383	196	41	13688	559	0	14484
17384	13795	36	465	204	0	14500
17385	554	49	136	13770	0	14509
17386	209	37	71	14192	0	14509
17387	154	51	48	14433	0	14686
17388	112	39	13698	701	0	14550
17389	13007	40	498	280	0	13825
17390	566	40	13589	165	0	14360
17391	220	41	555	13536	0	14352
17392	150	47	13697	571	0	14465
17393	141	47	550	13419	0	14157
17394	105	44	179	13995	0	14323
17395	114	32	13852	691	0	14689
17396	141	49	544	12788	0	13522
17397	125	13773	176	541	0	14615
17398	13818	500	112	246	0	14676
17399	14280	148	89	191	0	14708
17400	695	82	84	13946	0	14807
17401	296	46	13801	622	0	14765
17402	176	13134	548	277	0	14135
17403	135	14190	196	223	0	14744
17404	13169	574	147	199	0	14089
17405	603	204	12931	154	0	13892
17406	12950	97	537	188	0	13772
17407	628	57	216	13042	0	13943
17408	274	66	153	13462	0	13955
17409	12739	67	124	724	0	13654
17410	571	12792	94	350	0	13807
17411	258	482	12902	234	0	13876
17412	173	168	547	12778	0	13666
17413	151	100	13012	640	0	13903
17414	148	12807	597	302	0	13854
17415	138	509	231	12967	0	13845
17416	12675	182	156	653	0	13666
17417	13216	122	139	307	0	13784
17418	728	113	12693	208	0	13742
17419	330	12637	556	197	0	13720
17420	12679	534	258	163	0	13634
17421	628	12779	153	193	0	13753
17422	276	589	138	12724	0	13727
17423	12706	222	125	620	0	13673
17424	673	152	105	12863	0	13793
17425	301	113	12539	708	0	13661
17426	233	110	565	12772	0	13680
17427	212	128	12649	686	0	13675
17428	208	109	597	12693	0	13607
17429	12552	94	257	723	0	13626
17430	645	12637	185	340	0	13807
17431	12779	577	162	269	0	13787
17432	671	211	142	12674	0	13698
17433	296	168	135	13058	0	13657
17434	231	161	11259	789	0	12440
17435	211	120	12737	365	0	13433
17436	199	12499	651	300	0	13649
17437	217	549	12563	238	0	13567
17438	11916	221	666	234	0	13037
17439	660	12313	287	221	0	13481
17440	286	12732	178	227	0	13423
17441	242	13014	180	196	0	13632
17442	205	756	142	12655	0	13758
17443	161	280	12765	721	0	13927
17444	183	12895	626	328	0	14032
17445	201	616	232	11918	0	12967
17446	176	13083	196	629	0	14084
17447	12828	636	157	320	0	13941
17448	13305	247	161	256	0	13969
17449	733	180	147	12891	0	13951
17450	324	150	155	13214	0	13843
17451	12345	149	165	782	0	13441
17452	623	11955	154	391	0	13123
17453	258	12320	148	261	0	12987
17454	248	703	125	11112	0	12188
17455	137	194	10273	507	0	11111
17456	109	10143	419	261	0	10932
17457	9407	387	219	174	0	10187
17458	368	9054	118	152	0	9692
17459	155	9231	79	115	0	9580
17460	8622	412	118	117	0	9269
17461	341	8894	72	108	0	9415
17462	154	365	8660	92	0	9271
17463	90	8683	311	125	0	9209
17464	7291	267	118	63	0	7739
17465	215	7341	57	56	0	7669
17466	7249	245	64	58	0	7616
17467	253	103	39	7149	0	7544
17468	116	80	32	7386	0	7614
17469	66	83	7279	246	0	7674
17470	59	7346	183	109	0	7697
17471	55	220	66	7457	0	7798
17472	7371	94	55	230	0	7750
17473	7466	73	50	99	0	7688
17474	239	7571	40	78	0	7928
17475	92	228	39	7588	0	7947
17476	7538	111	54	213	0	7916
17477	7674	74	54	110	0	7912
17478	282	73	7310	70	0	7735
17479	118	72	6817	63	0	7070
17480	88	54	6643	33	0	6818
17481	36	6493	130	27	0	6686
17482	6090	123	92	30	0	6335
17483	122	6053	20	31	0	6226
17484	5964	97	32	29	0	6122
17485	103	6287	27	20	0	6437
17486	39	101	26	6409	0	6575
17487	6470	40	29	96	0	6635
17488	103	31	6481	36	0	6651
17489	6329	31	90	15	0	6465
17490	6604	31	37	25	0	6697
17491	124	6543	17	19	0	6703
17492	49	6729	13	16	0	6807
17493	6910	105	26	23	0	7064
17494	109	40	7185	25	0	7359
17495	6791	45	113	15	0	6964
17496	7008	19	39	15	0	7081
17497	131	23	13	6907	0	7074
17498	7099	20	10	98	0	7227
17499	121	41	12	7202	0	7376
17500	55	34	10	7428	0	7527
17501	48	13	17	7329	0	7407
17502	42	7276	16	93	0	7427
17503	7376	87	17	41	0	7521
17504	7450	33	15	28	0	7526
17505	131	20	17	7457	0	7625
17506	54	17	17	7308	0	7396
17507	45	7327	11	108	0	7491
17508	7350	101	15	44	0	7510
17509	104	48	7233	33	0	7418
17510	65	35	84	7325	0	7509
17511	46	27	7271	98	0	7442
17512	49	22	84	7210	0	7365
17513	45	23	7316	109	0	7493
17514	33	35	88	7107	0	7263
17515	7275	32	30	106	0	7443
17516	128	26	7381	44	0	7579
17517	7080	21	109	46	0	7256
17518	117	7707	40	36	0	7900
17519	53	94	34	7856	0	8037
17520	42	29	34	8023	0	8128
17521	8218	22	25	136	0	8401
17522	120	28	20	8438	0	8606
17523	61	34	8410	117	0	8622
17524	8215	20	84	68	0	8387
17525	8718	26	25	47	0	8816
17526	8731	25	17	55	0	8828
17527	8722	22	18	50	0	8812
17528	139	8579	20	46	0	8784
17529	71	85	22	8715	0	8893
17530	8719	36	20	120	0	8895
17531	128	27	24	8613	0	8792
17532	8520	21	23	108	0	8672
17533	140	26	8265	37	0	8468
17534	75	20	8155	30	0	8280
17535	56	113	98	7659	0	7926
17536	46	8044	42	84	0	8216
17537	41	8398	26	59	0	8524
17538	8204	103	26	66	0	8399
17539	109	33	8218	43	0	8403
17540	7444	22	74	54	0	7594
17541	99	8174	39	35	0	8347
17542	8255	63	32	35	0	8385
17543	91	28	17	8102	0	8238
17544	56	29	8227	82	0	8394
17545	51	23	76	8071	0	8221
17546	50	13	36	8104	0	8203
17547	44	8005	30	102	0	8181
17548	37	8315	16	53	0	8421
17549	48	91	16	8294	0	8449
17550	48	8375	17	91	0	8531
17551	47	66	8292	49	0	8454
17552	47	33	7938	42	0	8060
17553	7539	21	83	58	0	7701
17554	8213	20	39	47	0	8319
17555	107	8116	17	32	0	8272
17556	59	81	17	8103	0	8260
17557	40	35	21	8202	0	8298
17558	36	29	8222	100	0	8387
17559	32	29	90	7652	0	7803
17560	29	8060	44	87	0	8220
17561	38	62	7909	50	0	8059
17562	38	38	7756	33	0	7865
17563	36	7402	92	37	0	7567
17564	38	76	7894	33	0	8041
17565	47	29	82	7696	0	7854
17566	56	26	58	6739	0	6879
17567	31	25	7971	108	0	8135
17568	34	26	68	7746	0	7874
17569	24	7587	47	93	0	7751
17570	22	8016	35	59	0	8132
17571	37	114	22	7922	0	8095
17572	23	42	8053	98	0	8216
17573	28	8066	93	40	0	8227
17574	12	99	38	8064	0	8213
17575	23	23	7935	86	0	8067
17576	7377	15	75	40	0	7507
17577	7931	9	22	18	0	7980
17578	7947	15	11	20	0	7993
17579	86	7	14	7787	0	7894
17580	33	5	11	7885	0	7934
17581	24	10	8127	89	0	8250
17582	21	7	74	7921	0	8023
17583	15	8	28	8056	0	8107
17584	13	13	8054	92	0	8172
17585	6722	5	76	61	0	6864
17586	72	7503	25	14	0	7614
17587	7541	67	6	19	0	7633
17588	63	7467	13	8	0	7551
17589	23	70	9	7553	0	7655
17590	24	31	7539	76	0	7670
17591	16	30	68	7258	0	7372
17592	11	11	7400	79	0	7501
17593	6099	5	67	56	0	6227
17594	57	7	6875	10	0	6949
17595	26	4	69	6545	0	6644
17596	14	5	6771	60	0	6850
17597	13	6843	60	25	0	6941
17598	21	66	24	6986	0	7097
17599	16	19	15	6935	0	6985
17600	11	6	11	7197	0	7225
17601	9	10	7127	105	0	7251
17602	14	7	7228	46	0	7295
17603	6	7	118	7277	0	7408
17604	19	2	37	8762	0	8820
17605	15	9	22	9525	0	9571
17606	9773	8	11	271	0	10063
17607	191	11	20	10260	0	10482
17608	110	6	10784	251	0	11151
17609	11270	12	236	133	0	11651
17610	267	7	117	11818	0	12209
17611	12377	6	45	292	0	12720
17612	12655	2	21	166	0	12844
17613	412	5	33	12559	0	13009
17614	12670	6	25	325	0	13026
17615	12809	3	26	178	0	13016
17616	455	10	12455	99	0	13019
17617	212	12564	293	64	0	13133
17618	123	281	141	12121	0	12666
17619	65	130	64	12819	0	13078
17620	12552	53	40	427	0	13072
17621	12400	24	40	220	0	12684
17622	12504	22	40	138	0	12704
17623	501	9	11714	86	0	12310
17624	244	11884	287	85	0	12500
17625	11948	277	159	73	0	12457
17626	368	12068	66	61	0	12563
17627	12255	328	39	75	0	12697
17628	394	162	48	12129	0	12733
17629	12218	81	29	322	0	12650
17630	12374	40	29	200	0	12643
17631	12490	41	31	120	0	12682
17632	553	25	12183	82	0	12843
17633	12340	27	308	102	0	12777
17634	441	12347	155	83	0	13026
17635	12808	303	68	70	0	13249
17636	12969	154	43	70	0	13236
17637	13145	71	63	84	0	13363
17638	594	62	37	12449	0	13142
17639	319	12607	36	346	0	13308
17640	12735	328	39	199	0	13301
17641	480	165	12493	98	0	13236
17642	292	12646	302	98	0	13338
17643	229	351	154	11643	0	12377
17644	178	12527	86	274	0	13065
17645	12501	375	50	165	0	13091
17646	13001	202	62	90	0	13355
17647	574	114	41	12738	0	13467
17648	317	80	12401	389	0	13187
17649	211	12422	329	225	0	13187
17650	326	365	184	10151	0	11026
17651	206	191	84	12762	0	13243
17652	182	83	71	13360	0	13696
17653	13047	109	81	550	0	13787
17654	13374	77	45	280	0	13776
17655	13448	70	70	170	0	13758
17656	13662	98	31	134	0	13925
17657	704	55	53	13169	0	13981
17658	386	102	13323	433	0	14244
17659	280	50	367	13521	0	14218
17660	246	63	192	13683	0	14184
17661	224	56	92	13822	0	14194
17662	218	55	100	13906	0	14279
17663	13475	80	62	660	0	14277
17664	517	54	92	13649	0	14312
17665	13564	60	77	580	0	14281
17666	13841	57	54	367	0	14319
17667	749	59	13192	239	0	14239
17668	469	63	13031	203	0	13766
17669	378	58	13598	189	0	14223
17670	317	60	523	13208	0	14108
17671	298	61	13486	505	0	14350
17672	296	63	481	13152	0	13992
17673	213	77	261	13403	0	13954
17674	13422	80	133	674	0	14309
17675	573	58	111	13223	0	13965
17676	390	13449	107	572	0	14518
17677	13925	362	108	334	0	14729
17678	561	13935	104	274	0	14874
17679	406	425	13825	230	0	14886
17680	306	14167	411	186	0	15070
17681	13926	462	237	196	0	14821
17682	585	249	166	13828	0	14828
17683	410	175	13683	451	0	14719
17684	13771	113	407	338	0	14629
17685	610	122	263	13859	0	14854
17686	450	114	13870	495	0	14929
17687	342	90	409	14017	0	14858
17688	325	82	249	14142	0	14798
17689	292	90	165	14112	0	14659
17690	305	13932	117	613	0	14967
17691	14220	400	100	381	0	15101
17692	610	253	128	13918	0	14909
17693	403	14123	111	519	0	15156
17694	306	472	69	14307	0	15154
17695	307	265	14094	517	0	15183
17696	271	14219	379	364	0	15233
17697	14075	416	279	225	0	14995
17698	14235	264	151	213	0	14863
17699	636	185	114	13838	0	14773
17700	388	134	135	14179	0	14836
17701	13984	126	125	658	0	14893
17702	13651	117	118	401	0	14287
17703	633	13712	99	293	0	14737
17704	12242	363	73	171	0	12849
17705	471	116	11586	145	0	12318
17706	230	89	11262	172	0	11753
17707	156	10842	307	123	0	11428
17708	107	10738	136	129	0	11110
17709	9705	254	213	75	0	10247
17710	210	9800	53	54	0	10117
17711	9550	179	52	57	0	9838
17712	9399	89	34	45	0	9567
17713	9304	45	38	70	0	9457
17714	228	46	36	9126	0	9436
17715	9250	32	35	188	0	9505
17716	237	43	8853	85	0	9218
17717	122	59	8742	59	0	8982
17718	109	8801	192	67	0	9169
17719	60	166	9017	66	0	9309
17720	78	67	208	8598	0	8951
17721	74	59	8969	189	0	9291
17722	52	62	8830	76	0	9020
17723	78	35	201	8803	0	9117
17724	8933	67	85	191	0	9276
17725	9037	27	74	89	0	9227
17726	229	48	9031	71	0	9379
17727	8837	42	163	68	0	9110
17728	207	29	9130	82	0	9448
17729	8983	31	186	63	0	9263
17730	9505	28	99	53	0	9685
17731	241	19	76	9344	0	9680
17732	116	44	44	8992	0	9196
17733	77	8696	64	220	0	9057
17734	67	9070	43	116	0	9296
17735	76	173	74	8858	0	9181
17736	73	69	65	8975	0	9182
17737	8634	49	47	210	0	8940
17738	186	8538	42	88	0	8854
17739	8507	157	37	65	0	8766
17740	175	8546	55	48	0	8824
17741	89	165	8462	43	0	8759
17742	64	81	161	8360	0	8666
17743	8519	41	45	160	0	8765
17744	8851	34	42	74	0	9001
17745	236	8871	34	56	0	9197
17746	93	9079	22	56	0	9250
17747	62	9358	28	45	0	9493
17748	71	267	19	9981	0	10338
17749	65	80	10254	207	0	10606
17750	40	10170	223	77	0	10510
17751	45	204	59	10223	0	10531
17752	37	63	38	10535	0	10673
17753	34	42	10240	256	0	10572
17754	25	31	10010	77	0	10143
17755	9810	33	250	52	0	10145
17756	227	30	10412	30	0	10699
17757	10205	18	236	36	0	10495
17758	10075	20	68	31	0	10194
17759	10153	28	38	31	0	10250
17760	10087	22	28	37	0	10174
17761	297	26	9700	27	0	10050
17762	104	9758	219	27	0	10108
17763	73	228	73	9678	0	10052
17764	54	65	9818	230	0	10167
17765	54	52	239	9403	0	9748
17766	53	8669	121	245	0	9088
17767	46	228	64	9922	0	10260
17768	58	67	45	10044	0	10214
17769	72	42	43	9791	0	9948
17770	9779	40	42	292	0	10153
17771	267	33	40	9738	0	10078
17772	107	33	38	9891	0	10069
17773	90	29	43	9761	0	9923
17774	50	9290	63	296	0	9699
17775	9235	228	55	108	0	9626
17776	252	8768	52	80	0	9152
17777	70	8930	40	63	0	9103
17778	75	235	47	8957	0	9314
17779	51	73	50	9090	0	9264
17780	8926	48	33	296	0	9303
17781	242	34	40	9097	0	9413
17782	9112	31	36	296	0	9475
17783	11001	30	43	111	0	11185
17784	384	38	34	10833	0	11289
17785	173	38	43	10796	0	11050
17786	93	11047	41	435	0	11616
17787	11447	360	21	204	0	12032
17788	385	11994	39	137	0	12555
17789	11995	439	42	91	0	12567
17790	477	165	11666	79	0	12387
17791	11648	112	375	93	0	12228
17792	12377	61	129	100	0	12667
17793	549	54	88	11845	0	12536
17794	242	60	11888	450	0	12640
17795	154	12042	395	192	0	12783
17796	124	462	142	12329	0	13057
17797	111	157	12247	527	0	13042
17798	87	141	449	12174	0	12851
17799	12004	55	168	568	0	12795
17800	505	52	11939	246	0	12742
17801	196	11597	464	162	0	12419
17802	157	12294	179	93	0	12723
17803	161	548	102	10426	0	11237
17804	121	12068	77	366	0	12632
17805	11921	490	56	175	0	12642
17806	12162	181	56	146	0	12545
17807	12212	127	66	113	0	12518
17808	617	92	11490	109	0	12308
17809	11778	97	435	95	0	12405
17810	541	79	164	11574	0	12358
17811	218	82	98	11870	0	12268
17812	165	72	68	11990	0	12295
17813	134	77	60	12000	0	12271
17814	117	79	11433	682	0	12311
17815	113	72	11519	303	0	12007
17816	114	79	11511	203	0	11907
17817	10881	66	567	184	0	11698
17818	474	11122	240	165	0	12001
17819	235	433	141	11123	0	11932
17820	10949	179	81	545	0	11754
17821	503	11142	82	241	0	11968
17822	207	11675	105	163	0	12150
17823	11254	570	75	133	0	12032
17824	11511	241	77	139	0	11968
17825	614	11330	70	158	0	12172
17826	284	480	78	10462	0	11304
17827	226	11096	58	461	0	11841
17828	11029	526	69	210	0	11834
17829	11028	237	80	171	0	11516
17830	11099	166	81	147	0	11493
17831	670	10661	61	137	0	11529
17832	323	484	64	10806	0	11677
17833	204	234	10687	514	0	11639
17834	193	181	412	10711	0	11497
17835	164	137	174	11174	0	11649
17836	178	101	10646	595	0	11520
17837	10539	89	463	285	0	11376
17838	537	89	186	10847	0	11659
17839	272	110	120	10794	0	11296
17840	191	10756	96	598	0	11641
17841	10720	475	84	326	0	11605
17842	519	236	86	10416	0	11257
17843	230	10586	98	528	0	11442
17844	10155	445	81	251	0	10932
17845	498	10212	86	195	0	10991
17846	9760	461	97	154	0	10472
17847	516	218	9574	135	0	10443
17848	235	132	8640	124	0	9131
17849	162	86	8449	104	0	8801
17850	115	8414	466	110	0	9105
17851	152	398	252	7385	0	8187
17852	106	8095	111	309	0	8621
17853	8175	384	84	162	0	8805
17854	373	173	8151	129	0	8826
17855	8026	125	347	81	0	8579
17856	8335	74	184	71	0	8664
17857	454	90	138	8006	0	8688
17858	8208	85	77	339	0	8709
17859	434	77	68	8176	0	8755
17860	210	87	8065	381	0	8743
17861	7943	79	334	184	0	8540
17862	398	8008	161	120	0	8687
17863	209	343	126	8036	0	8714
17864	8132	171	81	356	0	8740
17865	420	124	61	8137	0	8742
17866	218	72	7908	420	0	8618
17867	133	90	317	7847	0	8387
17868	130	7942	150	402	0	8624
17869	8040	340	107	181	0	8668
17870	399	163	74	8022	0	8658
17871	8198	119	58	380	0	8755
17872	419	79	47	8156	0	8701
17873	219	60	61	7966	0	8306
17874	152	8006	66	422	0	8646
17875	7896	333	53	244	0	8526
17876	377	8283	51	150	0	8861
17877	207	362	56	7606	0	8231
17878	128	7968	56	331	0	8483
17879	7911	354	38	206	0	8509
17880	7785	174	46	165	0	8170
17881	7817	118	38	135	0	8108
17882	455	7346	53	117	0	7971
17883	98	5800	17	52	0	5967
17884	5677	221	43	38	0	5979
17885	216	5776	21	44	0	6057
17886	124	289	32	5283	0	5728
17887	56	56	5113	161	0	5386
17888	4480	28	101	46	0	4655
17889	4631	26	27	32	0	4716
17890	4659	26	17	28	0	4730
17891	133	4640	11	17	0	4801
17892	4533	101	9	27	0	4670
17893	118	39	4589	10	0	4756
17894	47	4503	75	10	0	4635
17895	31	98	25	4117	0	4271
17896	16	4110	9	33	0	4168
17897	3988	38	3	19	0	4048
17898	39	4075	5	9	0	4128
17899	24	36	4	4065	0	4129
17900	10	4046	7	32	0	4095
17901	14	39	4	4140	0	4197
17902	11	19	7	4027	0	4064
17903	16	12	4035	44	0	4107
17904	20	8	34	3861	0	3923
17905	3937	9	13	46	0	4005
17906	3943	11	11	25	0	3990
17907	59	12	5	3920	0	3996
17908	27	8	3921	38	0	3994
17909	12	12	38	3888	0	3950
17910	3950	7	14	51	0	4022
17911	4114	11	8	37	0	4170
17912	4201	2	5	19	0	4227
17913	55	4292	8	6	0	4361
17914	4386	38	2	19	0	4445
17915	47	28	4272	7	0	4354
17916	4637	10	45	33	0	4725
17917	48	8	17	4827	0	4900
17918	26	6	9	4858	0	4899
17919	13	9	13	4918	0	4953
17920	4822	10	2	65	0	4899
17921	4704	11	3	40	0	4758
17922	62	9	5	4702	0	4778
17923	30	7	4803	56	0	4896
17924	27	5	41	4751	0	4824
17925	28	6	16	4719	0	4769
17926	14	8	4698	70	0	4790
17927	16	4701	52	37	0	4806
17928	16	44	19	4842	0	4921
17929	4967	19	7	68	0	5061
17930	63	11	21	4969	0	5064
17931	35	16	3	4992	0	5046
17932	5025	10	3	94	0	5132
17933	61	4939	6	37	0	5043
17934	33	5064	4	33	0	5134
17935	5054	57	8	20	0	5139
17936	71	25	5039	25	0	5160
17937	4685	23	47	40	0	4795
17938	71	24	5303	12	0	5410
17939	40	5317	47	20	0	5424
17940	5366	64	33	14	0	5477
17941	5467	21	8	11	0	5507
17942	5490	9	27	18	0	5544
17943	5501	14	4	23	0	5542
17944	92	5	5423	13	0	5533
17945	40	20	45	5260	0	5365
17946	5407	12	20	52	0	5491
17947	80	14	5621	27	0	5742
17948	45	12	5500	9	0	5566
17949	32	5509	58	22	0	5621
17950	5594	43	41	12	0	5690
17951	47	20	25	5550	0	5642
17952	5584	9	14	46	0	5653
17953	49	5661	19	21	0	5750
17954	36	35	18	6078	0	6167
17955	23	29	2	6068	0	6122
17956	37	8	5	6258	0	6308
17957	15	14	6353	99	0	6481
17958	20	6379	66	45	0	6510
17959	6905	78	20	30	0	7033
17960	105	21	13	6907	0	7046
17961	6897	9	19	116	0	7041
17962	6840	17	12	53	0	6922
17963	136	6	18	6869	0	7029
17964	50	27	7003	119	0	7199
17965	59	8	100	6941	0	7108
17966	29	6966	28	120	0	7143
17967	33	93	14	7121	0	7261
17968	30	27	7065	115	0	7237
17969	6851	11	98	75	0	7035
17970	111	18	44	7144	0	7317
17971	6986	9	20	135	0	7150
17972	112	22	6915	46	0	7095
17973	6527	10	96	52	0	6685
17974	137	4	6884	28	0	7053
17975	6525	10	98	30	0	6663
17976	118	6626	45	22	0	6811
17977	58	6912	22	15	0	7007
17978	30	114	31	6920	0	7095
17979	62	43	30	6165	0	6300
17980	17	41	17	6912	0	6987
17981	6949	18	13	139	0	7119
17982	108	24	7	7000	0	7139
17983	40	20	6959	135	0	7154
17984	6604	8	96	91	0	6799
17985	113	6983	35	42	0	7173
17986	7081	95	28	51	0	7255
17987	6999	32	23	22	0	7076
17988	160	20	7021	33	0	7234
17989	60	24	132	6867	0	7083
17990	65	17	38	7374	0	7494
17991	42	24	7449	159	0	7674
17992	21	7342	143	71	0	7577
17993	7233	124	41	45	0	7443
17994	7361	42	30	50	0	7483
17995	155	22	30	7497	0	7704
17996	63	28	20	7490	0	7601
17997	49	10	28	7896	0	7983
17998	7652	27	11	198	0	7888
17999	166	7839	12	87	0	8104
18000	7927	142	18	50	0	8137
18001	7945	47	18	56	0	8066
18002	218	24	8223	36	0	8501
18003	87	33	172	7937	0	8229
18004	67	8316	61	168	0	8612
18005	57	179	28	8539	0	8803
18006	45	70	34	8789	0	8938
18007	43	27	8873	265	0	9208
18008	9055	25	210	117	0	9407
18009	9963	18	72	86	0	10139
18010	10477	28	38	67	0	10610
18011	353	18	42	10121	0	10534
18012	159	19	22	9992	0	10192
18013	98	9714	37	331	0	10180
18014	89	10312	25	130	0	10556
18015	10150	329	29	75	0	10583
18016	321	9796	36	60	0	10213
18017	114	298	9719	75	0	10206
18018	70	110	278	9857	0	10315
18019	9964	64	89	325	0	10442
18020	324	62	9773	140	0	10299
18021	133	32	9760	84	0	10009
18022	9881	49	337	73	0	10340
18023	10072	40	125	50	0	10287
18024	418	27	55	9816	0	10316
18025	173	36	9812	326	0	10347
18026	104	32	312	9872	0	10320
18027	77	53	9385	357	0	9872
18028	88	53	9857	131	0	10129
18029	101	9843	358	84	0	10386
18030	9955	291	124	73	0	10443
18031	10046	100	90	55	0	10291
18032	391	9895	61	75	0	10422
18033	178	299	53	9860	0	10390
18034	108	95	67	10003	0	10273
18035	94	63	62	10157	0	10376
18036	9848	49	63	417	0	10377
18037	339	9769	51	174	0	10333
18038	9636	306	45	108	0	10095
18039	9722	111	57	98	0	9988
18040	425	67	9298	85	0	9875
18041	165	9383	305	85	0	9938
18042	140	298	135	9456	0	10029
18043	98	134	9474	311	0	10017
18044	9218	80	321	152	0	9771
18045	9680	58	113	98	0	9949
18046	9720	61	77	88	0	9946
18047	9582	57	71	101	0	9811
18048	466	39	61	9218	0	9784
18049	190	36	9101	343	0	9670
18050	142	44	314	9153	0	9653
18051	9123	56	116	355	0	9650
18052	9260	40	72	146	0	9518
18053	421	8878	79	94	0	9472
18054	8730	270	66	85	0	9151
18055	366	119	8528	65	0	9078
18056	179	60	8526	86	0	8851
18057	8201	67	357	86	0	8711
18058	340	8269	144	67	0	8820
18059	162	222	69	7545	0	7998
18060	141	7800	44	225	0	8210
18061	139	214	42	7988	0	8383
18062	103	116	46	8051	0	8316
18063	98	56	53	8319	0	8526
18064	7874	61	44	348	0	8327
18065	8188	51	50	143	0	8432
18066	8166	57	55	84	0	8362
18067	362	72	7850	72	0	8356
18068	7864	61	241	76	0	8242
18069	320	43	125	8186	0	8674
18070	166	51	91	8645	0	8953
18071	127	36	8571	366	0	9100
18072	134	41	295	9696	0	10166
18073	10170	36	116	402	0	10724
18074	407	60	10029	176	0	10672
18075	188	35	351	10119	0	10693
18076	10179	28	140	418	0	10765
18077	10261	26	100	188	0	10575
18078	501	31	10020	143	0	10695
18079	240	53	10275	84	0	10652
18080	170	40	438	10235	0	10883
18081	10413	38	183	390	0	11024
18082	10695	40	124	165	0	11024
18083	505	48	79	9914	0	10546
18084	215	10274	73	402	0	10964
18085	10367	318	68	186	0	10939
18086	422	10463	80	134	0	11099
18087	224	356	64	10518	0	11162
18088	167	117	10324	392	0	11000
18089	147	70	10120	192	0	10529
18090	153	49	10341	117	0	10660
18091	153	40	441	9870	0	10504
18092	125	50	187	10258	0	10620
18093	10014	33	124	446	0	10617
18094	384	9954	95	195	0	10628
18095	9993	324	74	133	0	10524
18096	442	126	72	9287	0	9927
18097	195	9555	74	343	0	10167
18098	138	10067	77	154	0	10436
18099	121	394	62	9835	0	10412
18100	9764	135	68	383	0	10350
18101	348	9854	58	180	0	10440
18102	9257	300	48	132	0	9737
18103	365	9518	68	73	0	10024
18104	9423	312	75	91	0	9901
18105	381	116	9114	79	0	9690
18106	198	77	9023	57	0	9355
18107	109	8908	322	62	0	9401
18108	8160	270	197	63	0	8690
18109	227	7684	67	57	0	8035
18110	105	7335	41	33	0	7514
18111	130	236	42	7394	0	7802
18112	7385	90	41	197	0	7713
18113	208	7501	28	77	0	7814
18114	7322	193	41	51	0	7607
18115	219	7341	28	33	0	7621
18116	7238	199	22	31	0	7490
18117	204	7183	33	22	0	7442
18118	74	7404	34	28	0	7540
18119	82	209	26	6957	0	7274
18120	44	7300	24	150	0	7518
18121	7224	202	21	67	0	7514
18122	191	88	7195	47	0	7521
18123	83	68	157	7206	0	7514
18124	70	46	7373	184	0	7673
18125	53	44	184	7241	0	7522
18126	36	48	65	7438	0	7587
18127	47	38	7012	229	0	7326
18128	6436	43	183	122	0	6784
18129	208	6877	71	71	0	7227
18130	6947	186	62	62	0	7257
18131	233	6980	35	58	0	7306
18132	107	199	38	7022	0	7366
18133	7023	75	45	186	0	7329
18134	7102	59	50	90	0	7301
18135	7140	53	55	69	0	7317
18136	283	40	35	6948	0	7306
18137	135	51	44	6968	0	7198
18138	117	7150	32	213	0	7512
18139	7246	198	42	120	0	7606
18140	7441	83	40	97	0	7661
18141	7413	75	52	62	0	7602
18142	7361	57	50	81	0	7549
18143	302	7074	51	57	0	7484
18144	153	186	62	7150	0	7551
18145	96	92	7096	188	0	7472
18146	6896	81	191	84	0	7252
18147	7422	76	58	100	0	7656
18148	293	68	7254	68	0	7683
18149	154	65	7314	61	0	7594
18150	131	59	226	7301	0	7717
18151	73	88	100	7575	0	7836
18152	87	64	62	7760	0	7973
18153	7522	91	59	287	0	7959
18154	237	60	39	7625	0	7961
18155	120	58	7376	264	0	7818
18156	98	66	220	7465	0	7849
18157	90	53	7574	251	0	7968
18158	85	79	221	7444	0	7829
18159	86	61	83	8008	0	8238
18160	76	71	7920	273	0	8340
18161	7405	70	214	157	0	7846
18162	251	7923	93	94	0	8361
18163	8065	226	65	77	0	8433
18164	271	121	43	8324	0	8759
18165	8277	106	43	250	0	8676
18166	276	8550	21	144	0	8991
18167	144	9109	24	93	0	9370
18168	133	434	32	9300	0	9899
18169	91	172	9592	290	0	10145
18170	81	117	9225	119	0	9542
18171	101	9307	352	79	0	9839
18172	7825	258	143	54	0	8280
18173	198	91	66	7753	0	8108
18174	7696	49	39	221	0	8005
18175	231	7586	53	85	0	7955
18176	107	7869	36	68	0	8080
18177	82	300	28	7800	0	8210
18178	7740	127	26	222	0	8115
18179	7879	87	13	114	0	8093
18180	304	60	7610	60	0	8034
18181	146	55	7371	48	0	7620
18182	7320	50	249	51	0	7670
18183	229	7426	126	45	0	7826
18184	7520	214	73	34	0	7841
18185	279	94	49	7338	0	7760
18186	121	64	7274	197	0	7656
18187	6929	45	198	93	0	7265
18188	231	7107	101	64	0	7503
18189	99	7345	78	45	0	7567
18190	108	235	49	7207	0	7599
18191	7355	126	45	217	0	7743
18192	235	81	48	7412	0	7776
18193	7701	55	40	245	0	8041
18194	244	65	7371	117	0	7797
18195	7500	52	160	94	0	7806
18196	7810	50	65	78	0	8003
18197	318	54	7408	61	0	7841
18198	7220	37	186	86	0	7529
18199	297	7108	114	44	0	7563
18200	168	182	89	7053	0	7492
18201	132	7188	53	179	0	7552
18202	7367	215	59	82	0	7723
18203	246	114	60	7180	0	7600
18204	179	7109	34	192	0	7514
18205	106	222	45	7165	0	7538
18206	98	7230	41	232	0	7601
18207	79	261	33	7321	0	7694
18208	7319	127	36	254	0	7736
18209	234	98	24	7354	0	7710
18210	131	97	7165	257	0	7650
18211	7001	53	183	161	0	7398
18212	232	81	79	7256	0	7648
18213	141	57	6989	274	0	7461
18214	126	56	6703	152	0	7037
18215	94	49	7072	122	0	7337
18216	107	34	299	6810	0	7250
18217	97	45	164	7171	0	7477
18218	74	28	118	7287	0	7507
18219	84	46	101	7264	0	7495
18220	7122	45	81	344	0	7592
18221	7296	47	84	198	0	7625
18222	7360	53	70	162	0	7645
18223	7500	42	63	123	0	7728
18224	335	49	56	7227	0	7667
18225	202	35	7330	282	0	7849
18226	7293	53	200	163	0	7709
18227	7747	51	96	140	0	8034
18228	355	44	74	7565	0	8038
18229	238	44	52	7792	0	8126
18230	7783	41	59	341	0	8224
18231	301	46	68	7433	0	7848
18232	203	7402	48	291	0	7944
18233	7669	200	66	172	0	8107
18234	7599	98	73	145	0	7915
18235	359	68	7769	118	0	8314
18236	222	60	211	7753	0	8246
18237	131	59	108	8140	0	8438
18238	8022	58	98	343	0	8521
18239	8134	39	67	197	0	8437
18240	370	46	67	7984	0	8467
18241	232	58	7811	299	0	8400
18242	188	34	7824	194	0	8240
18243	161	37	270	7950	0	8418
18244	151	44	142	8124	0	8461
18245	7895	44	94	368	0	8401
18246	315	7657	81	212	0	8265
18247	207	7632	74	139	0	8052
18248	149	7934	78	121	0	8282
18249	128	260	80	7803	0	8271
18250	7736	120	84	286	0	8226
18251	7736	83	57	164	0	8040
18252	323	7713	29	129	0	8194
18253	7839	254	27	99	0	8219
18254	309	133	43	7737	0	8222
18255	164	98	7823	268	0	8353
18256	158	68	201	7620	0	8047
18257	130	62	88	7839	0	8119
18258	160	63	53	7815	0	8091
18259	7436	48	41	326	0	7851
18260	246	63	48	7193	0	7550
18261	148	7125	55	281	0	7609
18262	6985	173	86	208	0	7452
18263	223	6896	54	156	0	7329
18264	124	6657	49	123	0	6953
18265	111	6849	41	108	0	7109
18266	80	161	6219	79	0	6539
18267	58	5988	110	64	0	6220
18268	46	77	5368	41	0	5532
18269	4879	22	63	38	0	5002
18270	5152	8	14	38	0	5212
18271	47	10	5344	27	0	5428
18272	5187	7	37	47	0	5278
18273	5530	10	8	30	0	5578
18274	47	16	5525	20	0	5608
18275	16	5690	33	21	0	5760
18276	37	50	11	5736	0	5834
18277	5890	20	6	55	0	5971
18278	58	18	2	5754	0	5832
18279	5981	23	11	72	0	6087
18280	5929	15	17	17	0	5978
18281	65	24	5960	13	0	6062
18282	5766	9	47	23	0	5845
18283	57	6139	8	19	0	6223
18284	6240	42	7	23	0	6312
18285	52	7	13	6251	0	6323
18286	26	16	6260	53	0	6355
18287	27	18	45	6091	0	6181
18288	6168	6	14	59	0	6247
18289	55	6173	11	23	0	6262
18290	20	53	6143	24	0	6240
18291	30	14	34	5812	0	5890
18292	23	13	6137	60	0	6233
18293	26	6003	48	18	0	6095
18294	6004	53	15	19	0	6091
18295	54	12	17	6026	0	6109
18296	28	13	6019	56	0	6116
18297	22	24	5580	20	0	5646
18298	5958	15	56	28	0	6057
18299	69	12	12	6138	0	6231
18300	29	13	19	6151	0	6212
18301	29	16	6216	60	0	6321
18302	26	22	6110	20	0	6178
18303	20	6413	55	21	0	6509
18304	24	56	23	6470	0	6573
18305	30	17	21	6438	0	6506
18306	20	6406	19	63	0	6508
18307	29	63	6302	19	0	6413
18308	6035	15	58	30	0	6138
18309	62	14	23	6499	0	6598
18310	29	11	6616	66	0	6722
18311	35	10	65	6276	0	6386
18312	33	6530	21	73	0	6657
18313	28	66	6574	33	0	6701
18314	6262	23	63	44	0	6392
18315	75	18	6723	24	0	6840
18316	33	16	6526	18	0	6593
18317	24	19	6392	22	0	6457
18318	25	17	6989	24	0	7055
18319	24	14	93	6907	0	7038
18320	14	26	7513	93	0	7646
18321	20	21	113	7251	0	7405
18322	24	7488	28	90	0	7630
18323	7943	94	21	50	0	8108
18324	136	22	26	8042	0	8226
18325	41	9	7992	143	0	8185
18326	22	7989	130	55	0	8196
18327	28	131	47	8073	0	8279
18328	8014	31	27	143	0	8215
18329	122	8053	26	37	0	8238
18330	33	125	31	8191	0	8380
18331	8239	31	24	139	0	8433
18332	134	17	8102	45	0	8298
18333	7946	10	131	43	0	8130
18334	140	12	8298	21	0	8471
18335	7676	8	129	28	0	7841
18336	7855	14	41	14	0	7924
18337	156	8	7722	20	0	7906
18338	40	7562	112	10	0	7724
18339	36	111	41	7207	0	7395
18340	17	33	7745	113	0	7908
18341	21	23	116	7294	0	7454
18342	16	12	40	7460	0	7528
18343	14	10	7722	136	0	7882
18344	11	12	7561	51	0	7635
18345	16	8	139	7582	0	7745
18346	7770	5	51	121	0	7947
18347	113	7581	27	47	0	7768
18348	41	7721	20	20	0	7802
18349	7770	132	9	31	0	7942
18350	7928	38	17	25	0	8008
18351	147	21	14	7902	0	8084
18352	52	14	12	8015	0	8093
18353	26	7	14	8158	0	8205
18354	7941	8	16	152	0	8117
18355	104	7634	16	55	0	7809
18356	42	7835	16	40	0	7933
18357	24	137	18	7882	0	8061
18358	19	42	19	7988	0	8068
18359	24	21	10	7981	0	8036
18360	7876	12	18	157	0	8063
18361	113	7993	13	64	0	8183
18362	8116	120	22	29	0	8287
18363	147	39	8100	22	0	8308
18364	57	8157	130	35	0	8379
18365	24	137	59	8147	0	8367
18366	8110	49	31	156	0	8346
18367	158	24	8101	67	0	8350
18368	64	24	8034	44	0	8166
18369	34	31	182	8097	0	8344
18370	40	22	57	8269	0	8388
18371	24	19	41	8135	0	8219
18372	36	22	29	7806	0	7893
18373	32	21	26	7859	0	7938
18374	26	7639	28	220	0	7913
18375	39	152	18	7781	0	7990
18376	7546	54	31	198	0	7829
18377	149	7638	33	97	0	7917
18378	7584	171	18	71	0	7844
18379	183	61	7324	75	0	7643
18380	86	34	7404	60	0	7584
18381	42	32	202	7862	0	8138
18382	50	30	9897	196	0	10173
18383	56	21	296	9709	0	10082
18384	49	37	147	9696	0	9929
18385	10023	25	75	425	0	10548
18386	10038	17	61	195	0	10311
18387	398	10428	52	108	0	10986
18388	181	11050	48	89	0	11368
18389	98	429	45	10892	0	11464
18390	11019	195	50	368	0	11632
18391	346	100	11084	190	0	11720
18392	166	58	350	11058	0	11632
18393	106	36	155	11268	0	11565
18394	72	49	11004	500	0	11625
18395	51	10925	370	245	0	11591
18396	61	348	173	10819	0	11401
18397	53	160	11142	410	0	11765
18398	52	92	367	11087	0	11598
18399	10501	51	170	454	0	11176
18400	337	10549	104	239	0	11229
18401	162	10988	78	146	0	11374
18402	89	441	61	10807	0	11398
18403	10484	211	60	418	0	11173
18404	342	10678	66	233	0	11319
18405	10768	376	64	179	0	11387
18406	417	185	10663	146	0	11411
18407	218	116	11126	131	0	11591
18408	139	90	498	10567	0	11294
18409	121	88	222	11456	0	11887
18410	11074	90	139	571	0	11874
18411	460	93	85	11136	0	11774
18412	248	86	10963	523	0	11820
18413	173	104	385	10957	0	11619
18414	135	100	199	11356	0	11790
18415	119	93	10753	606	0	11571
18416	10161	93	425	357	0	11036
18417	418	80	221	10942	0	11661
18418	10390	60	155	511	0	11116
18419	392	10079	153	308	0	10932
18420	9915	357	110	248	0	10630
18421	401	9692	96	223	0	10412
18422	207	10032	130	168	0	10537
18423	169	475	123	9411	0	10178
18424	9285	227	130	407	0	10049
18425	9443	151	87	241	0	9922
18426	450	133	68	9264	0	9915
18427	9337	117	72	389	0	9915
18428	9425	118	70	249	0	9862
18429	493	131	58	9277	0	9959
18430	8997	111	66	422	0	9596
18431	465	9084	81	239	0	9869
18432	9278	355	90	184	0	9907
18433	437	190	8783	180	0	9590
18434	9296	100	322	211	0	9929
18435	461	63	179	9326	0	10029
18436	268	47	150	9580	0	10045
18437	199	57	126	9707	0	10089
18438	160	73	109	9656	0	9998
18439	124	62	118	9558	0	9862
18440	141	8566	133	586	0	9426
18441	161	9344	84	368	0	9957
18442	9280	403	105	274	0	10062
18443	402	233	9129	223	0	9987
18444	9181	162	307	208	0	9858
18445	469	155	9193	187	0	10004
18446	301	164	351	9061	0	9877
18447	216	157	168	9505	0	10046
18448	9233	116	112	536	0	9997
18449	468	135	9067	304	0	9974
18450	342	131	315	9224	0	10012
18451	246	116	9475	458	0	10295
18452	254	9583	381	290	0	10508
18453	241	347	205	9938	0	10731
18454	9918	161	124	512	0	10715
18455	9605	136	104	302	0	10147
18456	10057	109	85	269	0	10520
18457	569	9654	117	249	0	10589
18458	335	10207	115	223	0	10880
18459	9098	480	100	260	0	9938
18460	432	9961	100	256	0	10749
18461	248	10115	93	235	0	10691
18462	218	463	9677	258	0	10616
18463	164	9509	321	239	0	10233
18464	139	9830	172	218	0	10359
18465	155	474	124	9737	0	10490
18466	145	287	9710	420	0	10562
18467	153	189	9486	278	0	10106
18468	9232	139	427	224	0	10022
18469	439	123	9710	165	0	10437
18470	9847	90	419	162	0	10518
18471	451	86	248	9658	0	10443
18472	291	9769	153	409	0	10622
18473	10233	333	129	259	0	10954
18474	10636	186	119	242	0	11183
18475	538	114	111	10578	0	11341
18476	336	101	121	10687	0	11245
18477	232	97	118	10848	0	11295
18478	10466	97	100	595	0	11258
18479	9676	118	91	343	0	10228
18480	10505	107	63	243	0	10918
18481	570	9702	56	196	0	10524
18482	7849	183	40	57	0	8129
18483	253	7606	36	68	0	7963
18484	124	7706	36	66	0	7932
18485	110	318	55	7198	0	7681
18486	70	7311	32	153	0	7566
18487	6788	137	29	61	0	7015
18488	142	51	16	6724	0	6933
18489	6602	27	15	126	0	6770
18490	112	6311	16	62	0	6501
18491	56	6599	9	57	0	6721
18492	6719	121	18	25	0	6883
18493	119	6874	13	19	0	7025
18494	63	103	21	6898	0	7085
18495	61	44	15	7019	0	7139
18496	6994	29	8	140	0	7171
18497	128	24	7	7000	0	7159
18498	57	23	7178	134	0	7392
18499	36	26	115	7205	0	7382
18500	7312	22	38	147	0	7519
18501	131	7483	26	55	0	7695
18502	7863	144	12	54	0	8073
18503	7566	64	16	47	0	7693
18504	7950	44	10	29	0	8033
18505	224	36	7701	21	0	7982
18506	97	27	7502	24	0	7650
18507	7179	26	169	29	0	7403
18508	143	7400	68	32	0	7643
18509	69	137	33	7518	0	7757
18510	51	64	20	7477	0	7612
18511	38	7225	21	171	0	7455
18512	27	7485	20	82	0	7614
18513	29	183	17	7464	0	7693
18514	31	76	17	7572	0	7696
18515	43	43	7297	189	0	7572
18516	37	35	6930	91	0	7093
18517	7081	27	167	54	0	7329
18518	7557	29	79	35	0	7700
18519	210	25	47	7449	0	7731
18520	106	21	7479	154	0	7760
18521	84	28	147	7372	0	7631
18522	7379	40	61	184	0	7664
18523	168	33	7365	84	0	7650
18524	95	23	153	7434	0	7705
18525	63	43	7451	159	0	7716
18526	42	7313	170	86	0	7611
18527	42	155	7415	63	0	7675
18528	47	119	161	7153	0	7480
18529	7373	51	78	168	0	7670
18530	147	47	55	7501	0	7750
18531	7432	29	38	184	0	7683
18532	7606	32	30	92	0	7760
18533	7427	33	32	64	0	7556
18534	221	19	7202	51	0	7493
18535	7296	20	149	46	0	7511
18536	203	12	74	7376	0	7665
18537	104	25	58	7430	0	7617
18538	70	24	7369	199	0	7662
18539	69	28	143	7350	0	7590
18540	7433	35	66	193	0	7727
18541	151	7392	47	106	0	7696
18542	7587	132	34	81	0	7834
18543	7752	54	28	56	0	7890
18544	7794	43	24	54	0	7915
18545	234	26	28	7610	0	7898
18546	123	22	7642	181	0	7968
18547	89	27	153	7861	0	8130
18548	68	30	62	8022	0	8182
18549	7941	20	50	235	0	8246
18550	7723	23	30	133	0	7909
18551	233	30	7374	84	0	7721
18552	108	24	166	7312	0	7610
18553	81	18	7422	203	0	7724
18554	7501	16	201	91	0	7809
18555	216	8204	84	83	0	8587
18556	8305	179	66	50	0	8600
18557	242	8494	37	60	0	8833
18558	8424	233	34	45	0	8736
18559	257	8472	27	41	0	8797
18560	133	234	38	8403	0	8808
18561	85	98	22	8714	0	8919
18562	8627	59	33	278	0	8997
18563	8583	26	33	132	0	8774
18564	8682	31	23	76	0	8812
18565	8315	25	22	78	0	8440
18566	8568	30	30	58	0	8686
18567	358	20	28	8176	0	8582
18568	164	8180	17	229	0	8590
18569	128	199	19	8047	0	8393
18570	88	8014	22	243	0	8367
18571	81	229	21	7799	0	8130
18572	67	7903	19	251	0	8240
18573	71	240	30	7797	0	8138
18574	65	91	7442	274	0	7872
18575	7112	60	197	118	0	7487
18576	234	7418	74	92	0	7818
18577	7512	219	44	72	0	7847
18578	261	80	7401	70	0	7812
18579	7294	56	205	52	0	7607
18580	281	33	7705	54	0	8073
18581	129	46	238	7599	0	8012
18582	99	8216	85	220	0	8620
18583	80	242	8341	90	0	8753
18584	67	107	266	8380	0	8820
18585	7980	68	133	297	0	8478
18586	271	47	67	8502	0	8887
18587	148	37	35	8700	0	8920
18588	88	37	49	8843	0	9017
18589	88	30	8439	421	0	8978
18590	76	35	261	8315	0	8687
18591	72	8169	118	343	0	8702
18592	55	249	64	8283	0	8651
18593	85	111	38	8362	0	8596
18594	8164	68	36	374	0	8642
18595	293	46	21	8430	0	8790
18596	139	46	8459	332	0	8976
18597	95	27	8434	194	0	8750
18598	66	24	8372	126	0	8588
18599	65	8252	365	84	0	8766
18600	8033	265	200	93	0	8591
18601	262	8091	83	63	0	8499
18602	7944	260	57	68	0	8329
18603	288	136	46	7827	0	8297
18604	143	64	7973	276	0	8456
18605	96	52	7805	134	0	8087
18606	62	8129	338	87	0	8616
18607	71	271	161	8141	0	8644
18608	59	133	74	8374	0	8640
18609	61	83	68	8544	0	8756
18610	48	64	8237	410	0	8759
18611	7750	50	272	222	0	8294
18612	298	48	8280	122	0	8748
18613	166	37	313	8083	0	8599
18614	112	45	143	8533	0	8833
18615	88	39	8242	387	0	8756
18616	7853	40	292	225	0	8410
18617	286	8231	161	155	0	8833
18618	8297	269	94	115	0	8775
18619	337	138	69	8056	0	8600
18620	172	8241	61	302	0	8776
18621	103	286	49	8435	0	8873
18622	8354	139	51	364	0	8908
18623	324	80	58	8402	0	8864
18624	160	59	8124	367	0	8710
18625	7984	66	281	206	0	8537
18626	8328	65	136	153	0	8682
18627	400	56	8029	115	0	8600
18628	211	47	293	8102	0	8653
18629	8290	60	174	328	0	8852
18630	352	40	88	8188	0	8668
18631	205	44	82	8153	0	8484
18632	107	40	87	8244	0	8478
18633	114	44	87	8293	0	8538
18634	104	39	7850	479	0	8472
18635	101	55	300	7971	0	8427
18636	88	37	7834	405	0	8364
18637	7696	55	313	260	0	8324
18638	7968	39	162	175	0	8344
18639	7983	36	121	163	0	8303
18640	8040	40	88	157	0	8325
18641	437	42	87	7725	0	8291
18642	7659	37	81	356	0	8133
18643	363	23	7424	248	0	8058
18644	208	30	7393	150	0	7781
18645	7090	28	377	141	0	7636
18646	326	7019	193	131	0	7669
18647	203	7123	110	105	0	7541
18648	104	333	106	6952	0	7495
18649	119	143	6923	297	0	7482
18650	6585	77	262	233	0	7157
18651	300	64	6992	118	0	7474
18652	164	6619	281	145	0	7209
18653	126	212	6620	105	0	7063
18654	104	6189	229	87	0	6609
18655	5438	241	196	90	0	5965
18656	202	5394	104	80	0	5780
18657	128	5229	60	67	0	5484
18658	95	235	60	5168	0	5558
18659	83	117	5125	200	0	5525
18660	68	64	183	4962	0	5277
18661	55	55	128	5173	0	5411
18662	61	33	5042	267	0	5403
18663	68	41	197	4843	0	5149
18664	61	4849	122	192	0	5224
18665	59	175	68	5124	0	5426
18666	5061	89	73	220	0	5443
18667	194	60	59	5133	0	5446
18668	132	45	5045	209	0	5431
18669	81	52	162	5169	0	5464
18670	73	30	5071	231	0	5405
18671	4943	48	199	149	0	5339
18672	188	46	116	5071	0	5421
18673	5121	40	69	228	0	5458
18674	218	40	5044	142	0	5444
18675	4779	34	183	120	0	5116
18676	193	5059	123	93	0	5468
18677	147	158	5141	83	0	5529
18678	78	103	208	5029	0	5418
18679	85	35	5176	198	0	5494
18680	77	4704	177	144	0	5102
18681	65	5059	128	87	0	5339
18682	4360	145	55	76	0	4636
18683	128	4661	52	59	0	4900
18684	4727	143	42	64	0	4976
18685	159	88	54	4726	0	5027
18686	94	41	4683	156	0	4974
18687	46	4718	154	98	0	5016
18688	76	148	85	4719	0	5028
18689	47	78	35	4998	0	5158
18690	48	46	39	5077	0	5210
18691	55	41	42	4930	0	5068
18692	51	4707	38	216	0	5012
18693	49	5010	31	114	0	5204
18694	4726	159	37	74	0	4996
18695	127	4692	41	54	0	4914
18696	54	128	32	4407	0	4621
18697	45	62	4328	125	0	4560
18698	33	4324	112	73	0	4542
18699	37	114	55	4241	0	4447
18700	32	76	24	4245	0	4377
18701	26	4313	29	139	0	4507
18702	4106	107	22	70	0	4305
18703	100	47	4121	49	0	4317
18704	3767	38	83	32	0	3920
18705	80	3945	44	32	0	4101
18706	3582	72	13	18	0	3685
18707	76	3701	11	12	0	3800
18708	54	93	14	3792	0	3953
18709	28	45	4	3871	0	3948
18710	3800	28	12	96	0	3936
18711	80	23	6	3820	0	3929
18712	36	19	3770	94	0	3919
18713	19	3612	72	55	0	3758
18714	18	3728	27	37	0	3810
18715	28	89	16	3687	0	3820
18716	12	41	3699	85	0	3837
18717	14	43	72	3620	0	3749
18718	12	24	25	3744	0	3805
18719	15	25	3656	101	0	3797
18720	16	17	3502	58	0	3593
18721	7	3617	98	40	0	3762
18722	3616	81	35	30	0	3762
18723	70	46	16	3582	0	3714
18724	26	3522	18	82	0	3648
18725	3628	84	15	45	0	3772
18726	79	43	11	3635	0	3768
18727	33	26	15	3658	0	3732
18728	19	3582	17	106	0	3724
18729	15	92	18	3558	0	3683
18730	3547	45	9	105	0	3706
18731	80	35	11	3583	0	3709
18732	37	31	12	3619	0	3699
18733	23	27	3489	122	0	3661
18734	24	26	3298	61	0	3409
18735	3463	19	87	48	0	3617
18736	84	25	38	3512	0	3659
18737	40	30	24	3527	0	3621
18738	26	29	16	3612	0	3683
18739	26	27	3469	131	0	3653
18740	3420	20	78	67	0	3585
18741	84	22	36	3505	0	3647
18742	42	18	26	3585	0	3671
18743	3473	24	30	126	0	3653
18744	85	3454	29	69	0	3637
18745	44	88	3455	52	0	3639
18746	26	43	83	3353	0	3505
18747	29	3463	42	101	0	3635
18748	26	86	29	3545	0	3686
18749	3493	44	30	113	0	3680
18750	91	33	19	3514	0	3657
18751	3407	28	20	127	0	3582
18752	3426	22	20	73	0	3541
18753	106	28	19	3356	0	3509
18754	53	3251	25	114	0	3443
18755	34	3411	20	72	0	3537
18756	23	108	3373	56	0	3560
18757	32	50	84	3146	0	3312
18758	25	33	42	3376	0	3476
18759	32	32	27	3437	0	3528
18760	3332	27	18	140	0	3517
18761	88	24	17	3386	0	3515
18762	49	25	3338	125	0	3537
18763	3323	22	80	97	0	3522
18764	94	23	39	3505	0	3661
18765	53	20	32	3571	0	3676
18766	34	18	3475	145	0	3672
18767	3394	19	78	87	0	3578
18768	96	14	40	3519	0	3669
18769	43	22	3628	127	0	3820
18770	43	18	85	3611	0	3757
18771	32	18	56	3389	0	3495
18772	38	3583	31	135	0	3787
18773	3563	75	25	98	0	3761
18774	3558	37	25	76	0	3696
18775	123	3517	22	60	0	3722
18776	3447	85	27	51	0	3610
18777	3383	35	20	50	0	3488
18778	125	22	18	3388	0	3553
18779	52	20	3275	117	0	3464
18780	40	11	3103	74	0	3228
18781	27	17	3062	38	0	3144
18782	20	16	3112	44	0	3192
18783	39	58	86	2775	0	2958
18784	18	14	43	2929	0	3004
18785	18	10	16	2900	0	2944
18786	30	12	12	2927	0	2981
18787	2880	12	14	91	0	2997
18788	60	2947	11	46	0	3064
18789	2972	45	12	42	0	3071
18790	58	24	2985	28	0	3095
18791	32	9	3076	26	0	3143
18792	22	31	71	3137	0	3261
18793	3200	8	47	81	0	3336
18794	3056	2	11	44	0	3113
18795	79	3110	16	23	0	3228
18796	29	3219	13	24	0	3285
18797	27	70	8	3211	0	3316
18798	3203	27	15	54	0	3299
18799	56	3194	13	31	0	3294
18800	3198	55	9	21	0	3283
18801	3209	22	10	33	0	3274
18802	3227	12	2	24	0	3265
18803	78	14	3237	15	0	3344
18804	38	3277	48	14	0	3377
18805	3229	41	25	25	0	3320
18806	3209	29	15	16	0	3269
18807	75	3107	11	14	0	3207
18808	27	3017	10	6	0	3060
18809	3039	53	8	10	0	3110
18810	50	21	4	3051	0	3126
18811	28	9	3027	38	0	3102
18812	2912	12	41	18	0	2983
18813	46	10	18	3077	0	3151
18814	30	3204	3	39	0	3276
18815	16	44	6	3321	0	3387
18816	14	23	3368	43	0	3448
18817	14	12	38	3292	0	3356
18818	3470	8	19	52	0	3549
18819	52	6	7	3496	0	3561
18820	31	4	6	3504	0	3545
18821	9	13	3607	57	0	3686
18822	13	10	34	3469	0	3526
18823	16	3606	20	40	0	3682
18824	3631	39	8	28	0	3706
18825	3516	20	10	27	0	3573
18826	63	10	3627	23	0	3723
18827	32	4	49	3511	0	3596
18828	13	3511	24	58	0	3606
18829	12	3667	11	27	0	3717
18830	3664	61	8	16	0	3749
18831	61	24	9	3764	0	3858
18832	28	8	3778	53	0	3867
18833	15	12	3706	39	0	3772
18834	13	18	60	3793	0	3884
18835	3805	18	26	56	0	3905
18836	3781	16	12	33	0	3842
18837	68	14	13	3971	0	4066
18838	32	9	4038	53	0	4132
18839	18	4016	58	39	0	4131
18840	4044	38	32	36	0	4150
18841	61	4101	15	20	0	4197
18842	4175	53	10	22	0	4260
18843	63	25	13	4144	0	4245
18844	38	11	4140	69	0	4258
18845	21	27	54	4028	0	4130
18846	4125	12	28	61	0	4226
18847	69	27	4084	38	0	4218
18848	49	4114	55	16	0	4234
18849	22	59	23	4151	0	4255
18850	4181	30	30	55	0	4296
18851	63	12	4213	46	0	4334
18852	52	9	61	4175	0	4297
18853	20	16	42	4323	0	4401
18854	25	21	4306	73	0	4425
18855	25	12	57	4190	0	4284
18856	29	15	4278	66	0	4388
18857	4072	11	65	41	0	4189
18858	60	10	34	4538	0	4642
18859	37	6	4830	82	0	4955
18860	16	4842	83	41	0	4982
18861	4987	66	34	36	0	5123
18862	5391	29	27	35	0	5482
18863	120	14	16	5743	0	5893
18864	45	5931	26	130	0	6132
18865	6010	115	29	54	0	6208
18866	130	52	14	6040	0	6236
18867	64	19	6013	133	0	6229
18868	5761	17	120	54	0	5952
18869	126	5888	42	43	0	6099
18870	55	124	21	5964	0	6164
18871	5981	36	17	129	0	6163
18872	133	23	5915	64	0	6135
18873	55	20	5989	25	0	6089
18874	54	28	147	5730	0	5959
18875	28	26	6114	129	0	6297
18876	25	14	140	5879	0	6058
18877	39	5917	51	129	0	6136
18878	24	126	42	6212	0	6404
18879	6147	34	43	149	0	6373
18880	127	15	6177	74	0	6393
18881	44	6235	146	37	0	6462
18882	34	135	44	6208	0	6421
18883	27	58	6407	145	0	6637
18884	29	22	123	6061	0	6235
18885	37	6207	51	112	0	6407
18886	13	6501	44	54	0	6612
18887	6284	143	31	43	0	6501
18888	112	6425	24	44	0	6605
18889	45	118	6134	28	0	6325
18890	5629	57	115	44	0	5845
18891	111	46	6157	14	0	6328
18892	45	31	118	5643	0	5837
18893	45	22	6165	95	0	6327
18894	17	6067	113	30	0	6227
18895	29	94	51	6078	0	6252
18896	28	24	33	6082	0	6167
18897	17	22	37	5980	0	6056
18898	18	18	6064	150	0	6250
18899	18	24	115	5851	0	6008
18900	15	30	23	6195	0	6263
18901	5988	13	27	150	0	6178
18902	5978	10	24	80	0	6092
18903	122	13	6032	50	0	6217
18904	46	5897	117	37	0	6097
18905	28	101	6030	40	0	6199
18906	34	27	117	6039	0	6217
18907	41	34	6249	112	0	6436
18908	41	16	132	6098	0	6287
18909	20	16	57	6339	0	6432
18910	11	28	6261	138	0	6438
18911	5557	12	136	80	0	5785
18912	107	6412	39	61	0	6619
18913	30	102	37	6488	0	6657
18914	29	29	6604	146	0	6808
18915	28	22	6234	63	0	6347
18916	6041	27	134	45	0	6247
18917	115	6420	50	27	0	6612
18918	33	112	31	6506	0	6682
18919	6647	23	37	129	0	6836
18920	117	24	31	6647	0	6819
18921	45	17	28	6934	0	7024
18922	37	24	6903	143	0	7107
18923	6382	19	116	83	0	6600
18924	7020	14	38	56	0	7128
18925	141	12	41	7017	0	7211
18926	6973	18	26	140	0	7157
18927	149	10	31	6984	0	7174
18928	57	6694	31	152	0	6934
18929	50	7122	30	47	0	7249
18930	38	145	26	7207	0	7416
18931	7053	47	20	141	0	7261
18932	117	32	20	7099	0	7268
18933	7146	20	20	167	0	7353
18934	7186	29	24	55	0	7294
18935	158	23	13	7138	0	7332
18936	74	8	19	7270	0	7371
18937	55	6	7034	172	0	7267
18938	36	15	7061	66	0	7178
18939	28	21	154	7093	0	7296
18940	25	14	7527	168	0	7734
18941	7332	10	168	76	0	7586
18942	143	13	63	7972	0	8191
18943	45	13	8396	181	0	8635
18944	8185	9	194	97	0	8485
18945	9033	10	73	62	0	9178
18946	263	9316	48	38	0	9665
18947	126	211	22	9534	0	9893
18948	75	70	9806	223	0	10174
18949	9602	51	218	112	0	9983
18950	10170	24	90	71	0	10355
18951	290	28	10072	43	0	10433
18952	10135	13	236	55	0	10439
18953	280	16	95	10048	0	10439
18954	110	24	70	10326	0	10530
18955	10193	11	36	298	0	10538
18956	10244	16	35	136	0	10431
18957	319	17	36	10118	0	10490
18958	150	16	9973	253	0	10392
18959	92	9607	204	112	0	10015
18960	79	196	9700	80	0	10055
18961	59	73	9601	55	0	9788
18962	45	9274	266	54	0	9639
18963	63	160	142	8564	0	8929
18964	36	60	64	8828	0	8988
18965	37	43	8730	200	0	9010
18966	43	16	166	8501	0	8726
18967	8713	10	77	218	0	9018
18968	181	11	8804	90	0	9086
18969	8688	14	165	85	0	8952
18970	9090	7	80	41	0	9218
18971	9133	10	57	44	0	9244
18972	277	13	8863	38	0	9191
18973	129	20	8936	39	0	9124
18974	102	18	211	8808	0	9139
18975	68	13	112	8488	0	8681
18976	49	8938	72	181	0	9240
18977	8951	161	36	103	0	9251
18978	8915	64	48	72	0	9099
18979	226	8966	41	53	0	9286
18980	9025	161	29	51	0	9266
18981	213	8867	28	52	0	9160
18982	9036	185	39	48	0	9308
18983	242	73	35	8744	0	9094
18984	124	51	8768	184	0	9127
18985	82	19	8648	92	0	8841
18986	58	26	234	8665	0	8983
18987	55	19	120	8755	0	8949
18988	48	16	8628	231	0	8923
18989	47	26	197	8413	0	8683
18990	50	22	107	8299	0	8478
18991	8519	21	69	240	0	8849
18992	8669	20	50	127	0	8866
18993	8466	25	43	94	0	8628
18994	288	26	8291	47	0	8652
18995	144	8305	178	44	0	8671
18996	108	157	79	8456	0	8800
18997	79	77	8689	178	0	9023
18998	73	8659	193	76	0	9001
18999	8774	164	99	89	0	9126
19000	191	75	86	8792	0	9144
19001	112	52	48	8952	0	9164
19002	8887	23	53	245	0	9208
19003	205	27	48	8896	0	9176
19004	119	25	43	8939	0	9126
19005	8893	20	31	271	0	9215
19006	207	40	8684	144	0	9075
19007	117	8597	179	98	0	8991
19008	8641	171	86	67	0	8965
19009	213	74	8801	49	0	9137
19010	8499	60	185	68	0	8812
19011	218	8988	108	64	0	9378
19012	8864	163	85	68	0	9180
19013	8903	79	62	70	0	9114
19014	8731	56	47	85	0	8919
19015	290	32	52	8470	0	8844
19016	159	33	54	8568	0	8814
19017	114	8442	42	271	0	8869
19018	96	8531	50	135	0	8812
19019	95	8620	61	92	0	8868
19020	8594	208	41	61	0	8904
19021	193	95	8376	68	0	8732
19022	114	64	170	8245	0	8593
19023	91	43	85	8323	0	8542
19024	69	8307	64	228	0	8668
19025	72	164	53	8429	0	8718
19026	80	80	45	8250	0	8455
19027	61	8436	45	225	0	8767
19028	8322	171	45	148	0	8686
19029	193	8410	29	91	0	8723
19030	101	183	8167	59	0	8510
19031	7987	84	160	77	0	8308
19032	190	8331	72	64	0	8657
19033	8201	147	64	61	0	8473
19034	201	84	43	8183	0	8511
19035	122	51	47	8178	0	8398
19036	90	43	8138	206	0	8477
19037	90	34	8022	103	0	8249
19038	73	74	178	8041	0	8366
19039	8000	41	81	164	0	8286
19040	7757	22	59	85	0	7923
19041	204	7840	34	63	0	8141
19042	95	7557	28	40	0	7720
19043	55	7404	22	28	0	7509
19044	95	233	50	6951	0	7329
19045	6857	30	108	113	0	7108
19046	6993	15	5	39	0	7052
19047	6929	6	6	25	0	6966
19048	137	8	6646	10	0	6801
19049	37	8043	113	11	0	8204
19050	23	125	28	9007	0	9183
19051	9183	30	21	171	0	9405
19052	198	14	6	9276	0	9494
19053	43	10	6	9808	0	9867
19054	9687	9	5	242	0	9943
19055	10587	5	10	74	0	10676
19056	293	17	10584	30	0	10924
19057	98	8	241	10595	0	10942
19058	42	14	10536	267	0	10859
19059	35	8	263	10580	0	10886
19060	35	12	10520	281	0	10848
19061	41	41	268	10485	0	10835
19062	10211	10	87	303	0	10611
19063	264	10218	45	106	0	10633
19064	77	10787	27	73	0	10964
19065	91	312	22	9551	0	9976
19066	46	10769	19	222	0	11056
19067	10710	284	23	98	0	11115
19068	10524	88	23	69	0	10704
19069	350	43	10311	55	0	10759
19070	118	10204	268	51	0	10641
19071	71	242	89	10410	0	10812
19072	49	78	10352	297	0	10776
19073	10241	42	280	122	0	10685
19074	307	33	87	10389	0	10816
19075	107	42	10472	294	0	10915
19076	60	48	282	10478	0	10868
19077	10464	39	91	322	0	10916
19078	301	38	10351	112	0	10802
19079	10241	34	280	72	0	10627
19080	10611	32	96	61	0	10800
19081	369	47	54	10318	0	10788
19082	131	43	10261	297	0	10732
19083	83	45	10099	118	0	10345
19084	9975	32	348	86	0	10441
19085	10386	15	122	67	0	10590
19086	381	33	10199	55	0	10668
19087	159	27	312	10123	0	10621
19088	107	22	126	10041	0	10296
19089	76	10213	81	365	0	10735
19090	84	280	68	10390	0	10822
19091	10383	79	53	350	0	10865
19092	352	39	58	10437	0	10886
19093	143	31	10250	368	0	10792
19094	10017	24	331	141	0	10513
19095	346	29	130	10134	0	10639
19096	166	35	10125	329	0	10655
19097	108	9880	315	149	0	10452
19098	9616	282	133	114	0	10145
19099	317	9949	93	114	0	10473
19100	9994	318	65	96	0	10473
19101	366	111	9785	111	0	10373
19102	173	9437	303	104	0	10017
19103	132	9972	127	97	0	10328
19104	102	359	74	9638	0	10173
19105	120	127	94	9944	0	10285
19106	104	76	9629	449	0	10258
19107	100	58	340	9759	0	10257
19108	9666	57	128	415	0	10266
19109	368	61	9466	162	0	10057
19110	169	67	340	9469	0	10045
19111	132	73	9300	367	0	9872
19112	8965	68	366	191	0	9590
19113	340	9293	168	136	0	9937
19114	9296	326	114	139	0	9875
19115	9670	151	102	128	0	10051
19116	9773	89	91	135	0	10088
19117	487	90	9153	125	0	9855
19118	209	9195	359	123	0	9886
19119	142	349	161	9300	0	9952
19120	138	131	111	9897	0	10277
19121	9982	92	115	466	0	10655
19122	447	65	115	10140	0	10767
19123	10147	60	137	469	0	10813
19124	10270	60	157	222	0	10709
19125	10349	73	107	168	0	10697
19126	10457	66	111	139	0	10773
19127	587	66	91	9966	0	10710
19128	10080	53	99	457	0	10689
19129	503	82	9645	181	0	10411
19130	9757	79	375	157	0	10368
19131	10202	60	170	137	0	10569
19132	603	65	9467	233	0	10368
19133	9765	65	388	130	0	10348
19134	10227	47	179	123	0	10576
19135	577	49	133	9747	0	10506
19136	308	52	113	10028	0	10501
19137	9636	167	124	514	0	10441
19138	520	50	100	9723	0	10393
19139	297	30	94	9559	0	9980
19140	233	9220	98	487	0	10038
19141	207	275	96	9358	0	9936
19142	9178	91	95	450	0	9814
19143	485	65	76	9141	0	9767
19144	248	50	74	9020	0	9392
19145	189	8419	93	480	0	9181
19146	193	289	74	8221	0	8777
19147	205	92	81	8242	0	8620
19148	7893	69	72	411	0	8445
19149	378	136	63	6148	0	6725
19150	147	24	5283	272	0	5726
19151	90	4807	169	148	0	5214
19152	59	4938	67	97	0	5161
19153	4545	197	42	92	0	4876
19154	197	4650	39	61	0	4947
19155	3832	123	44	49	0	4048
19156	150	3820	11	39	0	4020
19157	3871	129	16	29	0	4045
19158	145	46	7	3871	0	4069
19159	78	36	8	3956	0	4078
19160	45	3897	8	167	0	4117
19161	52	126	2	4009	0	4189
19162	45	45	3970	149	0	4209
19163	3826	22	111	73	0	4032
19164	143	4211	30	45	0	4429
19165	4172	139	16	40	0	4367
19166	4232	52	16	44	0	4344
19167	4317	32	18	26	0	4393
19168	216	26	15	4110	0	4367
19169	89	28	14	4109	0	4240
19170	65	4089	6	187	0	4347
19171	4105	160	11	71	0	4347
19172	189	4150	3	59	0	4401
19173	4157	164	5	39	0	4365
19174	197	49	4181	41	0	4468
19175	4392	28	141	50	0	4611
19176	211	18	47	4381	0	4657
19177	80	25	4345	195	0	4645
19178	63	24	4434	80	0	4601
19179	54	28	214	4390	0	4686
19180	55	12	4441	194	0	4702
19181	55	13	192	4364	0	4624
19182	4209	16	73	201	0	4499
19183	190	16	36	4299	0	4541
19184	95	9	4186	209	0	4499
19185	59	3967	170	109	0	4305
19186	48	4258	66	73	0	4445
19187	54	198	44	4113	0	4409
19188	4111	74	33	185	0	4403
19189	185	42	22	4164	0	4413
19190	99	38	19	4249	0	4405
19191	68	30	25	4334	0	4457
19192	59	29	28	4333	0	4449
19193	56	27	4156	247	0	4486
19194	54	23	4140	125	0	4342
19195	4084	22	193	88	0	4387
19196	4241	12	79	85	0	4417
19197	224	13	52	4148	0	4437
19198	105	21	26	4290	0	4442
19199	62	26	4075	242	0	4405
19200	50	4127	161	117	0	4455
19201	4152	164	68	75	0	4459
19202	4295	64	42	55	0	4456
19203	241	57	24	4172	0	4494
19204	115	34	4128	207	0	4484
19205	84	31	154	3985	0	4254
19206	62	4121	63	209	0	4455
19207	56	162	4112	117	0	4447
19208	4082	71	172	73	0	4398
19209	188	49	69	4180	0	4486
19210	4245	39	45	206	0	4535
19211	198	27	4074	112	0	4411
19212	4125	32	165	92	0	4414
19213	217	30	77	4154	0	4478
19214	4108	27	53	211	0	4399
19215	218	34	48	3944	0	4244
19216	111	3781	47	206	0	4145
19217	84	3994	35	101	0	4214
19218	84	219	42	3862	0	4207
19219	60	66	3663	178	0	3967
19220	35	3561	128	99	0	3823
19221	75	116	57	3218	0	3466
19222	3051	49	29	127	0	3256
19223	3131	29	17	73	0	3250
19224	138	24	26	3113	0	3301
19225	81	14	31	3106	0	3232
19226	62	2939	26	143	0	3170
19227	44	3138	17	89	0	3288
19228	3051	130	17	71	0	3269
19229	110	57	20	3086	0	3273
19230	59	42	27	3163	0	3291
19231	46	28	3035	166	0	3275
19232	39	18	108	3073	0	3238
19233	37	15	58	3063	0	3173
19234	28	26	35	3129	0	3218
19235	37	19	3029	179	0	3264
19236	35	16	112	3090	0	3253
19237	3066	22	60	155	0	3303
19238	111	15	3006	86	0	3218
19239	3209	19	120	81	0	3429
19240	132	21	59	3272	0	3484
19241	79	16	26	3422	0	3543
19242	49	11	37	3534	0	3631
19243	30	9	3371	201	0	3611
19244	3229	15	113	116	0	3473
19245	126	3553	61	63	0	3803
19246	3574	108	38	58	0	3778
19247	143	3586	23	56	0	3808
19248	71	117	15	3652	0	3855
19249	3646	44	29	167	0	3886
19250	135	37	3552	80	0	3804
19251	3450	34	106	72	0	3662
19252	143	20	3620	59	0	3842
19253	84	22	130	3554	0	3790
19254	57	16	3533	132	0	3738
19255	42	3467	117	84	0	3710
19256	64	90	49	3306	0	3509
19257	3250	41	61	125	0	3477
19258	112	33	28	3153	0	3326
19259	52	3083	25	110	0	3270
19260	53	88	17	3167	0	3325
19261	3105	47	11	119	0	3282
19262	3009	29	20	74	0	3132
19263	127	2956	16	60	0	3159
19264	45	2692	20	32	0	2789
19265	50	74	9	2690	0	2823
19266	23	37	18	2712	0	2790
19267	2663	23	17	94	0	2797
19268	2652	19	15	59	0	2745
19269	77	2638	16	43	0	2774
19270	45	65	12	2623	0	2745
19271	39	37	8	2650	0	2734
19272	23	18	2589	82	0	2712
19273	17	2535	47	61	0	2660
19274	15	2482	22	40	0	2559
19275	26	52	9	2282	0	2369
19276	10	22	2269	41	0	2342
19277	9	19	2253	19	0	2300
19278	10	11	41	2256	0	2318
19279	15	7	18	2297	0	2337
19280	9	7	2277	47	0	2340
19281	12	14	35	2270	0	2331
19282	10	7	2335	49	0	2401
19283	2398	10	43	32	0	2483
19284	49	6	25	2474	0	2554
19285	31	8	2509	59	0	2607
19286	21	12	2477	31	0	2541
19287	14	19	60	2671	0	2764
19288	10	5	2895	84	0	2994
19289	10	12	2845	32	0	2899
19290	13	2798	81	20	0	2912
19291	2903	57	29	23	0	3012
19292	67	23	2988	17	0	3095
19293	23	16	79	2927	0	3045
19294	22	13	25	2968	0	3028
19295	16	9	25	3086	0	3136
19296	9	5	3013	94	0	3121
19297	11	12	63	2968	0	3054
19298	2983	9	24	89	0	3105
19299	63	9	27	2942	0	3041
19300	24	9	2948	84	0	3065
19301	25	5	59	2917	0	3006
19302	2965	9	26	92	0	3092
19303	2987	8	32	38	0	3065
19304	2975	11	19	33	0	3038
19305	93	6	15	2969	0	3083
19306	2967	2	16	81	0	3066
19307	2976	1	21	42	0	3040
19308	2990	7	23	36	0	3056
19309	95	2884	12	33	0	3024
19310	2948	61	20	20	0	3049
19311	91	15	20	2941	0	3067
19312	37	14	2914	75	0	3040
19313	25	2897	65	39	0	3026
19314	2948	62	34	32	0	3076
19315	72	19	33	2957	0	3081
19316	34	18	27	2915	0	2994
19317	32	2866	19	85	0	3002
19318	23	2999	17	55	0	3094
19319	2851	74	21	48	0	2994
19320	72	2883	21	29	0	3005
19321	2807	72	17	22	0	2918
19322	80	2824	12	26	0	2942
19323	2779	64	11	30	0	2884
19324	68	2776	15	25	0	2884
19325	31	2910	18	30	0	2989
19326	2870	65	13	26	0	2974
19327	71	31	2844	23	0	2969
19328	37	2874	56	20	0	2987
19329	29	66	17	2879	0	2991
19330	30	24	23	3007	0	3084
19331	31	21	13	2943	0	3008
19332	29	18	12	2960	0	3019
19333	35	10	2942	97	0	3084
19334	2904	11	61	59	0	3035
19335	79	13	26	3039	0	3157
19336	3063	12	24	86	0	3185
19337	3275	13	20	39	0	3347
19338	3330	23	11	32	0	3396
19339	3231	16	18	31	0	3296
19340	117	17	3092	25	0	3251
19341	48	17	75	3089	0	3229
19342	42	17	3067	84	0	3210
19343	24	3033	87	44	0	3188
19344	36	72	52	2735	0	2895
19345	16	31	26	2897	0	2970
19346	17	18	18	2936	0	2989
19347	13	18	15	2939	0	2985
19348	21	12	2849	112	0	2994
19349	10	22	76	2834	0	2942
19350	22	11	31	2916	0	2980
19351	2909	9	24	112	0	3054
19352	3050	11	17	52	0	3130
19353	97	13	12	3058	0	3180
19354	47	11	21	3079	0	3158
19355	42	7	23	3122	0	3194
19356	3049	8	16	136	0	3209
19357	3152	12	17	66	0	3247
19358	2990	7	14	55	0	3066
19359	3138	16	14	42	0	3210
19360	121	3092	13	41	0	3267
19361	3132	78	19	28	0	3257
19362	3194	23	11	34	0	3262
19363	127	16	6	3084	0	3233
19364	63	10	13	3129	0	3215
19365	3073	8	14	117	0	3212
19366	107	2962	7	62	0	3138
19367	66	3143	8	35	0	3252
19368	3253	99	8	48	0	3408
19369	108	31	15	3329	0	3483
19370	43	25	8	3379	0	3455
19371	51	11	9	3440	0	3511
19372	42	21	6	3439	0	3508
19373	46	12	6	3378	0	3442
19374	25	3291	2	134	0	3452
19375	37	79	8	3310	0	3434
19376	3287	29	6	107	0	3429
19377	94	20	7	3264	0	3385
19378	44	16	4	3313	0	3377
19379	3233	13	4	120	0	3370
19380	88	3261	7	59	0	3415
19381	46	96	13	3228	0	3383
19382	33	3247	5	89	0	3374
19383	26	100	11	3148	0	3285
19384	29	26	3107	92	0	3254
19385	2870	25	58	47	0	3000
19386	76	3002	19	31	0	3128
19387	2803	48	10	29	0	2890
19388	62	20	2769	18	0	2869
19389	26	22	50	2605	0	2703
19390	16	2611	20	59	0	2706
19391	20	2727	14	31	0	2792
19392	2625	62	18	22	0	2727
19393	59	21	2	2639	0	2721
19394	26	9	2731	63	0	2829
19395	14	10	41	2772	0	2837
19396	18	6	2759	65	0	2848
19397	2577	6	51	31	0	2665
19398	56	7	2796	32	0	2891
19399	23	9	46	2768	0	2846
19400	23	2842	17	60	0	2942
19401	20	47	9	2828	0	2904
19402	12	2865	11	58	0	2946
19403	2887	46	2	36	0	2971
19404	66	17	9	3035	0	3127
19405	32	14	3048	67	0	3161
19406	28	16	2922	34	0	3000
19407	2979	8	60	31	0	3078
19408	3231	13	18	27	0	3289
19409	3228	11	8	26	0	3273
19410	3189	2	3	28	0	3222
19411	84	3130	9	22	0	3245
19412	3201	52	7	34	0	3294
19413	3233	19	6	30	0	3288
19414	86	17	3119	22	0	3244
19415	48	16	45	3087	0	3196
19416	3193	9	15	68	0	3285
19417	67	11	3129	36	0	3243
19418	35	8	43	3144	0	3230
19419	22	13	3301	64	0	3400
19420	25	7	52	3272	0	3356
19421	17	3341	19	69	0	3446
19422	3425	49	8	37	0	3519
19423	54	26	3340	29	0	3449
19424	3303	7	46	34	0	3390
19425	70	12	18	3371	0	3471
19426	3430	18	8	70	0	3526
19427	66	13	7	3401	0	3487
19428	3646	10	6	89	0	3751
19429	59	13	3572	38	0	3682
19430	3771	11	46	33	0	3861
19431	69	13	21	3880	0	3983
19432	38	11	8	3962	0	4019
19433	3889	9	14	81	0	3993
19434	58	18	10	3906	0	3992
19435	28	16	3890	61	0	3995
19436	35	14	46	3841	0	3936
19437	3619	11	22	51	0	3703
19438	41	3539	12	36	0	3628
19439	29	3542	7	15	0	3593
19440	3531	34	7	20	0	3592
19441	35	3706	12	16	0	3769
19442	26	24	10	3703	0	3763
19443	3657	11	21	36	0	3725
19444	3671	7	9	16	0	3703
19445	3646	10	2	9	0	3667
19446	37	7	3692	8	0	3744
19447	16	24	18	3603	0	3661
19448	13	3679	11	24	0	3727
19449	12	20	8	3732	0	3772
19450	10	11	3802	29	0	3852
19451	14	3581	28	10	0	3633
19452	12	33	10	3645	0	3700
19453	3583	4	3	18	0	3608
19454	14	3617	6	10	0	3647
19455	12	16	3740	3	0	3771
19456	14	6	17	3661	0	3698
19457	10	6	3713	24	0	3753
19458	9	3	27	3550	0	3589
19459	3815	1	6	37	0	3859
19460	26	8	7	3814	0	3855
19461	3840	2	5	31	0	3878
19462	3896	1	4	14	0	3915
19463	29	3964	3	9	0	4005
19464	4037	22	5	12	0	4076
19465	28	3951	4	9	0	3992
19466	12	24	4015	7	0	4058
19467	21	6	32	3790	0	3849
19468	13	6	7	4106	0	4132
19469	11	5	3974	36	0	4026
19470	6	3934	35	17	0	3992
19471	4027	34	10	11	0	4082
19472	4088	5	13	12	0	4118
19473	45	10	4	4159	0	4218
19474	16	6	6	4112	0	4140
19475	15	4	4	4258	0	4281
19476	4215	5	7	46	0	4273
19477	45	5	4132	18	0	4200
19478	15	3	4099	23	0	4140
19479	14	6	44	4202	0	4266
19480	14	7	4154	41	0	4216
19481	12	2	4104	16	0	4134
19482	12	4	44	3985	0	4045
19483	9	6	4276	42	0	4333
19484	9	4210	39	27	0	4285
19485	11	37	12	4346	0	4406
19486	15	12	4436	43	0	4506
19487	14	7	39	4323	0	4383
19488	12	4172	18	47	0	4249
19489	12	37	12	4347	0	4408
19490	13	14	4456	48	0	4531
19491	13	7	42	4223	0	4285
19492	4391	4	19	53	0	4467
19493	44	7	4427	25	0	4503
19494	4045	5	43	23	0	4116
19495	44	4380	16	11	0	4451
19496	4457	38	11	17	0	4523
19497	48	15	6	4472	0	4541
19498	13	4430	7	49	0	4499
19499	4586	43	9	26	0	4664
19500	47	15	6	4708	0	4776
19501	15	8	4730	64	0	4817
19502	17	4720	61	25	0	4823
19503	7	62	25	4799	0	4893
19504	4720	13	12	69	0	4814
19505	4607	8	8	23	0	4646
19506	71	6	6	4605	0	4688
19507	26	7	4566	60	0	4659
19508	4174	5	60	27	0	4266
19509	63	8	4541	14	0	4626
19510	19	9	61	4447	0	4536
19511	4556	2	19	77	0	4654
19512	56	4539	16	20	0	4631
19513	4559	60	11	21	0	4651
19514	71	14	4474	16	0	4575
19515	4462	9	62	16	0	4549
19516	70	7	22	4607	0	4706
19517	20	7	15	4684	0	4726
19518	20	9	4679	72	0	4780
19519	21	6	66	4420	0	4513
19520	4510	5	17	85	0	4617
19521	73	7	15	4527	0	4622
19522	22	4531	13	72	0	4638
19523	24	58	13	4597	0	4692
19524	14	4592	14	68	0	4688
19525	22	59	4499	29	0	4609
19526	4256	18	69	34	0	4377
19527	70	13	17	4625	0	4725
19528	27	14	4402	73	0	4516
19529	16	4275	67	34	0	4392
19530	25	68	20	4210	0	4323
19531	17	18	12	4278	0	4325
19532	4221	13	16	87	0	4337
19533	68	12	17	4302	0	4399
19534	4346	16	15	86	0	4463
19535	4347	13	17	38	0	4415
19536	91	4328	17	23	0	4459
19537	4442	79	13	33	0	4567
19538	97	23	10	4800	0	4930
19539	34	17	4789	106	0	4946
19540	4751	13	90	43	0	4897
19541	105	10	20	4701	0	4836
19542	43	10	4667	106	0	4826
19543	4392	11	99	49	0	4551
19544	116	11	21	4686	0	4834
19545	40	4788	29	106	0	4963
19546	34	96	15	4671	0	4816
19547	24	4757	23	109	0	4913
19548	4701	101	15	47	0	4864
19549	115	24	4863	35	0	5037
19550	29	4819	97	43	0	4988
19551	36	108	32	4829	0	5005
19552	25	30	4822	115	0	4992
19553	38	21	4587	40	0	4686
19554	25	4721	115	30	0	4891
19555	50	122	32	4658	0	4862
19556	14	23	24	4812	0	4873
19557	24	23	28	5986	0	6061
19558	6202	22	15	221	0	6460
19559	203	10	6843	66	0	7122
19560	48	6917	247	47	0	7259
19561	34	240	45	6911	0	7230
19562	26	54	33	7363	0	7476
19563	28	26	7102	304	0	7460
19564	37	28	260	7111	0	7436
19565	16	22	7126	303	0	7467
19566	21	12	7028	93	0	7154
19567	30	11	7158	62	0	7261
19568	36	17	318	6686	0	7057
19569	25	12	95	7013	0	7145
19570	29	15	50	7261	0	7355
19571	6930	21	36	325	0	7312
19572	251	6940	27	109	0	7327
19573	7053	249	34	72	0	7408
19574	6856	67	22	68	0	7013
19575	7277	35	26	51	0	7389
19576	316	7291	22	50	0	7679
19577	7362	249	32	44	0	7687
19578	7610	62	25	47	0	7744
19579	318	39	33	7341	0	7731
19580	106	25	32	7568	0	7731
19581	70	24	34	7732	0	7860
19582	44	27	7386	356	0	7813
19583	7105	19	254	127	0	7505
19584	279	22	70	7387	0	7758
19585	7220	29	56	310	0	7615
19586	291	7213	38	105	0	7647
19587	88	261	46	7287	0	7682
19588	69	61	39	7537	0	7706
19589	7297	41	31	343	0	7712
19590	292	30	31	7329	0	7682
19591	6575	56	35	349	0	7015
19592	7284	34	34	124	0	7476
19593	321	6908	31	86	0	7346
19594	108	7325	31	69	0	7533
19595	83	311	28	6958	0	7380
19596	54	7206	32	265	0	7557
19597	48	289	38	7165	0	7540
19598	52	75	7104	309	0	7540
19599	49	55	6952	99	0	7155
19600	6597	36	288	98	0	7019
19601	6941	31	81	79	0	7132
19602	293	6774	46	120	0	7233
19603	6844	241	49	73	0	7207
19604	289	7104	37	68	0	7498
19605	94	260	38	7147	0	7539
19606	77	75	34	7363	0	7549
19607	55	62	50	7355	0	7522
19608	46	37	41	7426	0	7550
19609	7093	30	56	370	0	7549
19610	241	7141	37	156	0	7575
19611	7197	238	48	108	0	7591
19612	7384	62	46	91	0	7583
19613	338	45	7108	68	0	7559
19614	6988	44	255	70	0	7357
19615	310	7059	60	62	0	7491
19616	118	270	37	7052	0	7477
19617	104	90	35	7037	0	7266
19618	74	6999	24	300	0	7397
19619	7139	266	31	144	0	7580
19620	303	82	6993	98	0	7476
19621	6934	61	260	122	0	7377
19622	341	44	7103	99	0	7587
19623	142	43	290	7068	0	7543
19624	117	59	97	7359	0	7632
19625	92	45	86	7532	0	7755
19626	7360	58	69	429	0	7916
19627	297	56	7476	191	0	8020
19628	7404	66	292	197	0	7959
19629	7741	35	126	173	0	8075
19630	7732	42	108	178	0	8060
19631	7789	40	112	128	0	8069
19632	374	31	99	7576	0	8080
19633	161	38	7471	331	0	8001
19634	135	63	279	7422	0	7899
19635	127	35	7438	364	0	7964
19636	123	65	7281	186	0	7655
19637	123	7298	264	148	0	7833
19638	117	252	85	6710	0	7164
19639	147	90	50	7116	0	7403
19640	151	106	51	6144	0	6452
19641	158	55	36	6998	0	7247
19642	6978	55	33	317	0	7383
19643	7111	36	40	137	0	7324
19644	351	53	31	6885	0	7320
19645	184	31	6680	324	0	7219
19646	112	32	224	6808	0	7176
19647	108	26	72	7069	0	7275
19648	71	31	6820	371	0	7293
19649	100	24	234	6756	0	7114
19650	6783	42	82	323	0	7230
19651	6935	37	50	164	0	7186
19652	6994	47	20	152	0	7213
19653	353	40	25	6802	0	7220
19654	6760	62	20	307	0	7149
19655	6754	39	25	158	0	6976
19656	345	38	6503	130	0	7016
19657	117	13	5013	57	0	5200
19658	67	11	5034	55	0	5167
19659	4233	16	66	19	0	4334
19660	54	4301	25	20	0	4400
19661	4277	29	12	16	0	4334
19662	36	4708	6	21	0	4771
19663	22	34	11	4718	0	4785
19664	17	9	10	4737	0	4773
19665	15	9	4	4741	0	4769
19666	20	7	4713	42	0	4782
19667	4388	1	33	30	0	4452
19668	37	8	10	4689	0	4744
19669	12	1	4697	37	0	4747
19670	12	3	4391	21	0	4427
19671	4416	0	35	16	0	4467
19672	25	4653	17	22	0	4717
19673	4642	29	11	11	0	4693
19674	4618	5	3	13	0	4639
19675	37	4591	5	8	0	4641
19676	4488	28	11	10	0	4537
19677	39	7	4620	10	0	4676
19678	16	6	4384	5	0	4411
19679	16	3	4602	4	0	4625
19680	11	11	40	4553	0	4615
19681	4	2	4647	24	0	4677
19682	4377	1	28	15	0	4421
19683	4533	3	13	11	0	4560
19684	32	1	4675	11	0	4719
19685	22	4	25	4535	0	4586
19686	4669	6	16	24	0	4715
19687	35	4854	7	14	0	4910
19688	17	4958	6	9	0	4990
19689	4991	28	4	17	0	5040
19690	32	7	5058	2	0	5099
19691	11	26	25	4900	0	4962
19692	10	1	18	4928	0	4957
19693	5	2	14	5023	0	5044
19694	2	4968	9	26	0	5005
19695	29	19	20	4645	0	4713
19696	5391	6	3	29	0	5429
19697	42	4	4	5524	0	5574
19698	9	5565	10	45	0	5629
19699	5698	38	2	27	0	5765
19700	48	12	3	5674	0	5737
19701	16	12	0	5920	0	5948
19702	6036	10	5	59	0	6110
19703	6059	7	5	22	0	6093
19704	71	7	7	6096	0	6181
19705	6238	1	5	80	0	6324
19706	6249	4	4	33	0	6290
19707	82	6334	2	20	0	6438
19708	6380	71	1	15	0	6467
19709	78	6330	3	16	0	6427
19710	42	74	1	6377	0	6494
19711	23	26	6511	78	0	6638
19712	21	17	68	6396	0	6502
19713	19	8	24	6451	0	6502
19714	17	5	8	6671	0	6701
19715	6617	6	8	112	0	6743
19716	84	6584	4	50	0	6722
19717	6854	77	2	27	0	6960
19718	98	7056	4	24	0	7182
19719	7227	93	7	24	0	7351
19720	7245	29	6	20	0	7300
19721	7282	23	1	22	0	7328
19722	7231	11	5	23	0	7270
19723	133	16	7173	14	0	7336
19724	61	8	94	7128	0	7291
19725	32	12	33	7358	0	7435
19726	26	12	7264	154	0	7456
19727	6884	7	120	57	0	7068
19728	132	11	30	7177	0	7350
19729	56	9	7057	137	0	7259
19730	46	20	6991	37	0	7094
19731	42	10	145	7193	0	7390
19732	27	17	7462	137	0	7643
19733	41	12	141	7316	0	7510
19734	30	16	43	7422	0	7511
19735	34	10	7280	168	0	7492
19736	6899	6	134	75	0	7114
19737	146	12	46	7286	0	7490
19738	55	6	7386	160	0	7607
19739	40	8	146	7372	0	7566
19740	7400	9	47	170	0	7626
19741	154	12	7375	61	0	7602
19742	7064	11	142	54	0	7271
19743	7571	9	53	38	0	7671
19744	181	7	40	7503	0	7731
19745	68	9	28	7534	0	7639
19746	51	8	7458	177	0	7694
19747	37	10	148	7405	0	7600
19748	48	10	66	6717	0	6841
19749	34	9	37	7525	0	7605
19750	34	10	7235	194	0	7473
19751	6960	8	151	89	0	7208
19752	7348	9	48	68	0	7473
19753	7534	10	28	72	0	7644
19754	7718	10	36	40	0	7804
19755	213	9	29	7642	0	7893
19756	7627	12	20	170	0	7829
19757	7650	17	26	70	0	7763
19758	6156	75	47	105	0	6383
19759	7623	13	29	63	0	7728
19760	192	7604	31	52	0	7879
19761	7682	125	26	60	0	7893
19762	7421	30	34	49	0	7534
19763	204	7371	27	58	0	7660
19764	7400	161	29	51	0	7641
19765	213	35	26	7392	0	7666
19766	83	27	26	7502	0	7638
19767	7326	18	25	214	0	7583
19768	195	7198	24	83	0	7500
19769	83	7299	29	73	0	7484
19770	78	169	23	7361	0	7631
19771	65	44	7379	183	0	7671
19772	58	34	160	7167	0	7419
19773	51	19	53	7467	0	7590
19774	7294	15	42	213	0	7564
19775	7363	13	26	86	0	7488
19776	221	11	30	7271	0	7533
19777	94	18	7118	188	0	7418
19778	75	11	163	7159	0	7408
19779	7282	9	55	207	0	7553
19780	202	13	7676	81	0	7972
19781	79	7794	208	78	0	8159
19782	8036	190	68	63	0	8357
19783	247	42	47	8080	0	8416
19784	88	35	31	8126	0	8280
19785	74	21	40	8330	0	8465
19786	70	18	7960	296	0	8344
19787	7165	13	203	151	0	7532
19788	254	12	7611	88	0	7965
19789	93	7522	241	66	0	7922
19790	86	182	69	7649	0	7986
19791	74	45	57	7796	0	7972
19792	69	36	37	8164	0	8306
19793	69	27	7968	329	0	8393
19794	55	23	7827	151	0	8056
19795	58	15	7931	95	0	8099
19796	56	7816	297	71	0	8240
19797	75	208	99	7813	0	8195
19798	7974	53	59	255	0	8341
19799	8540	35	39	97	0	8711
19800	325	23	8766	79	0	9193
19801	120	8723	265	65	0	9173
19802	92	234	8748	57	0	9131
19803	65	9059	281	45	0	9450
19804	8666	305	120	71	0	9162
19805	8728	92	74	52	0	8946
19806	298	8635	47	38	0	9018
19807	8676	265	50	37	0	9028
19808	315	83	35	8596	0	9029
19809	106	63	34	8848	0	9051
19810	8708	42	30	310	0	9090
19811	8472	31	22	127	0	8652
19812	8555	21	27	93	0	8696
19813	344	8234	29	55	0	8662
19814	140	8682	33	71	0	8926
19815	8602	287	30	59	0	8978
19816	315	99	8441	46	0	8901
19817	126	134	249	8147	0	8656
19818	7969	62	77	255	0	8363
19819	306	7759	49	85	0	8199
19820	114	8245	38	73	0	8470
19821	8181	286	31	65	0	8563
19822	293	98	7921	61	0	8373
19823	7717	84	228	53	0	8082
19824	317	48	7685	34	0	8084
19825	133	52	7693	28	0	7906
19826	103	53	273	7581	0	8010
19827	96	67	7811	212	0	8186
19828	7581	44	250	81	0	7956
19829	7896	26	104	76	0	8102
19830	7962	37	86	58	0	8143
19831	7924	29	60	52	0	8065
19832	333	34	51	7536	0	7954
19833	7592	37	46	219	0	7894
19834	297	7417	40	74	0	7828
19835	147	208	43	7163	0	7561
19836	119	7626	48	209	0	8002
19837	7876	240	40	97	0	8253
19838	7889	71	46	72	0	8078
19839	300	67	49	7735	0	8151
19840	7863	55	46	243	0	8207
19841	8028	55	43	91	0	8217
19842	326	52	40	7829	0	8247
19843	191	40	26	7896	0	8153
19844	141	39	37	8026	0	8243
19845	135	36	7630	303	0	8104
19846	108	43	7277	155	0	7583
19847	97	36	7653	114	0	7900
19848	88	55	280	7649	0	8072
19849	94	45	7886	261	0	8286
19850	102	33	267	7739	0	8141
19851	99	38	8321	277	0	8735
19852	92	43	8142	123	0	8400
19853	7766	45	296	114	0	8221
19854	263	7960	145	84	0	8452
19855	8195	207	109	91	0	8602
19856	284	87	78	8051	0	8500
19857	150	63	68	8206	0	8487
19858	120	56	8072	278	0	8526
19859	97	8031	239	143	0	8510
19860	96	221	112	8182	0	8611
19861	98	77	8235	239	0	8649
19862	83	8018	226	117	0	8444
19863	89	195	106	8102	0	8492
19864	8027	85	90	241	0	8443
19865	8082	77	69	104	0	8332
19866	269	60	67	8058	0	8454
19867	8097	43	70	230	0	8440
19868	282	8094	51	113	0	8540
19869	146	203	60	8252	0	8661
19870	131	82	8334	231	0	8778
19871	102	76	209	8389	0	8776
19872	102	56	8444	266	0	8868
19873	8214	54	240	138	0	8646
19874	260	69	103	8446	0	8878
19875	130	8588	84	248	0	9050
19876	113	231	69	8910	0	9323
19877	110	64	8826	301	0	9301
19878	91	66	8602	135	0	8894
19879	106	56	8589	105	0	8856
19880	7926	64	271	90	0	8351
19881	193	8139	109	62	0	8503
19882	81	160	77	8076	0	8394
19883	8086	51	79	195	0	8411
19884	179	8070	62	95	0	8406
19885	8417	176	71	95	0	8759
19886	8573	54	50	87	0	8764
19887	8767	53	55	61	0	8936
19888	8868	40	42	71	0	9021
19889	252	40	8544	54	0	8890
19890	8383	29	178	73	0	8663
19891	235	25	8445	59	0	8764
19892	7782	22	164	49	0	8017
19893	197	23	79	8215	0	8514
19894	103	23	8173	124	0	8423
19895	87	7891	133	68	0	8179
19896	106	308	73	7520	0	8007
19897	63	7752	61	111	0	7987
19898	55	7795	47	74	0	7971
19899	7070	82	49	46	0	7247
19900	109	26	6910	25	0	7070
19901	43	6681	61	21	0	6806
19902	6537	50	34	17	0	6638
19903	60	6579	12	15	0	6666
19904	6626	42	12	14	0	6694
19905	55	30	15	6541	0	6641
19906	6640	7	11	41	0	6699
19907	55	7	13	6513	0	6588
19908	6595	11	10	44	0	6660
19909	50	10	7	6576	0	6643
19910	17	6827	14	44	0	6902
19911	19	47	12	6934	0	7012
19912	6920	16	10	48	0	6994
19913	48	6868	13	21	0	6950
19914	21	59	9	6914	0	7003
19915	6983	18	8	55	0	7064
19916	50	14	10	7030	0	7104
19917	23	20	7	7004	0	7054
19918	21	14	7075	52	0	7162
19919	22	13	6763	19	0	6817
19920	21	9	52	6785	0	6867
19921	20	10	7219	48	0	7297
19922	22	10	44	7107	0	7183
19923	36	15	38	6155	0	6244
19924	19	9	9	7202	0	7239
19925	20	15	7208	54	0	7297
19926	18	15	41	6749	0	6823
19927	18	9	17	7032	0	7076
19928	22	7128	10	53	0	7213
19929	15	40	9	7256	0	7320
19930	7210	17	19	62	0	7308
19931	51	11	7	7305	0	7374
19932	23	9	8417	59	0	8508
19933	7914	9	101	53	0	8077
19934	110	8950	52	30	0	9142
19935	62	106	47	9146	0	9361
19936	53	49	8964	136	0	9202
19937	8246	46	119	82	0	8493
19938	129	8909	56	64	0	9158
19939	8981	128	47	50	0	9206
19940	167	51	32	8909	0	9159
19941	8827	48	31	139	0	9045
19942	177	41	8713	72	0	9003
19943	87	8573	114	77	0	8851
19944	62	9221	53	47	0	9383
19945	9277	154	61	49	0	9541
19946	9278	90	32	32	0	9432
19947	176	68	9206	21	0	9471
19948	8886	40	128	35	0	9089
19949	9199	21	60	27	0	9307
19950	9256	16	52	29	0	9353
19951	206	8736	37	27	0	9006
19952	121	8853	30	18	0	9022
19953	8875	159	14	27	0	9075
19954	8938	96	12	23	0	9069
19955	187	9005	14	23	0	9229
19956	117	158	12	9027	0	9314
19957	84	74	9017	131	0	9306
19958	8639	59	134	72	0	8904
19959	8114	87	80	109	0	8390
19960	9290	43	56	46	0	9435
19961	211	9140	31	28	0	9410
19962	128	141	9147	18	0	9434
19963	9313	57	148	31	0	9549
19964	182	68	56	9436	0	9742
19965	107	41	49	9463	0	9660
19966	85	26	41	9805	0	9957
19967	74	25	9674	209	0	9982
19968	54	32	145	9373	0	9604
19969	50	26	9497	203	0	9776
19970	30	9220	159	98	0	9507
19971	9027	134	74	63	0	9298
19972	130	9066	62	46	0	9304
19973	69	9234	36	30	0	9369
19974	9129	170	36	26	0	9361
19975	150	9329	17	21	0	9517
19976	84	160	9	9097	0	9350
19977	61	9100	13	99	0	9273
19978	9126	159	8	41	0	9334
19979	150	9113	7	39	0	9309
19980	77	171	12	9243	0	9503
19981	68	89	9086	132	0	9375
19982	44	68	128	9086	0	9326
19983	31	9085	65	194	0	9375
19984	31	131	48	9346	0	9556
19985	23	79	33	9134	0	9269
19986	38	62	21	8766	0	8887
19987	26	37	18	9267	0	9348
19988	28	28	20	9340	0	9416
19989	35	25	15	9433	0	9508
19990	31	18	9282	292	0	9623
19991	8887	27	163	178	0	9255
19992	186	16	87	10050	0	10339
19993	101	26	10044	263	0	10434
19994	72	31	10033	148	0	10284
19995	45	23	304	10234	0	10606
19996	10305	31	152	287	0	10775
19997	240	35	10131	130	0	10536
19998	9867	39	265	131	0	10302
19999	299	34	10386	71	0	10790
20000	159	45	294	10251	0	10749
20001	148	36	135	10635	0	10954
20002	96	41	10490	334	0	10961
20003	9851	43	271	200	0	10365
20004	274	31	147	10347	0	10799
20005	149	47	10298	290	0	10784
20006	132	29	10263	176	0	10600
20007	103	36	345	9750	0	10234
20008	79	10303	207	254	0	10843
20009	10434	227	141	158	0	10960
20010	10384	107	96	115	0	10702
20011	360	86	10400	75	0	10921
20012	238	63	260	9987	0	10548
20013	10418	54	145	274	0	10891
20014	317	39	10325	175	0	10856
20015	10002	35	286	139	0	10462
20016	332	9986	164	103	0	10585
20017	197	230	110	10379	0	10916
20018	145	108	94	10563	0	10910
20019	10689	71	88	353	0	11201
20020	306	53	90	10702	0	11151
20021	169	40	72	10659	0	10940
20022	127	42	67	10802	0	11038
20023	10460	36	64	447	0	11007
20024	326	34	10344	250	0	10954
20025	10209	23	276	214	0	10722
20026	10387	29	138	170	0	10724
20027	10720	27	140	116	0	11003
20028	446	44	94	10350	0	10934
20029	269	35	10491	306	0	11101
20030	180	10031	298	194	0	10703
20031	156	10321	145	174	0	10796
20032	81	9740	76	94	0	9991
20033	112	269	9649	82	0	10112
20034	67	185	247	10822	0	11321
20035	11171	62	108	371	0	11712
20036	12324	41	56	196	0	12617
20037	493	36	50	12755	0	13334
20038	248	28	12628	426	0	13330
20039	161	30	12701	212	0	13104
20040	117	16	502	12744	0	13379
20041	105	14	13038	455	0	13612
20042	90	12	474	12982	0	13558
20043	75	12	244	12710	0	13041
20044	58	12807	165	561	0	13591
20045	63	374	112	13188	0	13737
20046	78	161	90	13689	0	14018
20047	13189	104	101	658	0	14052
20048	448	54	84	13440	0	14026
20049	223	40	82	13677	0	14022
20050	13034	32	90	698	0	13854
20051	457	13015	99	388	0	13959
20052	13264	391	107	258	0	14020
20053	524	184	12938	208	0	13854
20054	12930	118	437	183	0	13668
20055	13171	65	238	189	0	13663
20056	655	46	12705	170	0	13576
20057	350	71	12744	137	0	13302
20058	266	75	588	12199	0	13128
20059	12373	36	332	534	0	13275
20060	523	54	12221	286	0	13084
20061	299	37	526	12143	0	13005
20062	207	28	12147	542	0	12924
20063	178	37	569	11974	0	12758
20064	159	46	297	12265	0	12767
20065	11908	62	224	690	0	12884
20066	11741	53	188	415	0	12397
20067	12323	58	135	324	0	12840
20068	751	49	11932	237	0	12969
20069	391	33	12192	222	0	12838
20070	277	43	624	11915	0	12859
20071	231	45	340	12202	0	12818
20072	212	53	225	12553	0	13043
20073	11838	32	194	737	0	12801
20074	500	11831	194	430	0	12955
20075	11635	403	150	311	0	12499
20076	11464	189	153	258	0	12064
20077	639	11298	142	251	0	12330
20078	411	11726	155	213	0	12505
20079	11459	529	142	231	0	12361
20080	566	258	104	11134	0	12062
20081	331	11273	130	591	0	12325
20082	342	420	122	11501	0	12385
20083	313	224	11218	596	0	12351
20084	220	167	461	11340	0	12188
20085	11163	86	308	701	0	12258
20086	537	81	11008	404	0	12030
20087	304	92	10977	357	0	11730
20088	295	252	633	9971	0	11151
20089	213	9977	383	544	0	11117
20090	191	10227	235	403	0	11056
20091	177	10657	189	345	0	11368
20092	10025	497	171	319	0	11012
20093	10045	220	145	329	0	10739
20094	9700	163	87	296	0	10246
20095	597	9634	125	316	0	10672
20096	9927	348	137	296	0	10708
20097	9943	206	123	255	0	10527
20098	635	188	9572	207	0	10602
20099	422	9362	437	173	0	10394
20100	342	373	303	9427	0	10445
20101	9432	212	249	461	0	10354
20102	579	158	9311	308	0	10356
20103	327	107	456	9130	0	10020
20104	265	9178	320	502	0	10265
20105	247	348	234	9364	0	10193
20106	272	162	191	9555	0	10180
20107	9350	134	213	635	0	10332
20108	9442	118	198	460	0	10218
20109	582	120	185	9384	0	10271
20110	366	132	9082	548	0	10128
20111	311	127	8993	394	0	9825
20112	9140	123	477	315	0	10055
20113	637	109	9185	235	0	10166
20114	446	115	480	8253	0	9294
20115	363	8697	329	417	0	9806
20116	8757	334	288	287	0	9666
20117	512	8798	224	266	0	9800
20118	8980	380	190	315	0	9865
20119	531	177	209	8850	0	9767
20120	378	155	180	9070	0	9783
20121	8895	153	153	572	0	9773
20122	9163	150	159	353	0	9825
20123	643	138	169	8890	0	9840
20124	433	165	120	9037	0	9755
20125	348	175	8589	517	0	9629
20126	273	140	8602	354	0	9369
20127	8381	127	469	298	0	9275
20128	470	158	8065	275	0	8968
20129	8266	104	413	307	0	9090
20130	8507	75	296	295	0	9173
20131	608	83	8103	243	0	9037
20132	384	7525	370	247	0	8526
20133	324	7833	280	186	0	8623
20134	158	183	6250	87	0	6678
20135	237	486	331	5195	0	6249
20136	4768	105	207	238	0	5318
20137	4611	24	17	44	0	4696
20138	5272	15	28	36	0	5351
20139	6286	13	20	47	0	6366
20140	6456	16	14	44	0	6530
20141	258	6562	23	32	0	6875
20142	6469	191	19	29	0	6708
20143	216	6424	19	15	0	6674
20144	6265	197	18	11	0	6491
20145	221	50	6034	14	0	6319
20146	87	16	174	5823	0	6100
20147	65	15	48	5678	0	5806
20148	51	5830	19	191	0	6091
20149	5888	184	16	61	0	6149
20150	6058	68	9	24	0	6159
20151	258	41	10	5837	0	6146
20152	102	21	19	6003	0	6145
20153	5859	18	20	245	0	6142
20154	204	12	17	5909	0	6142
20155	77	18	11	6042	0	6148
20156	5897	25	8	242	0	6172
20157	229	16	6	5887	0	6138
20158	5901	17	8	219	0	6145
20159	5996	6	8	97	0	6107
20160	258	4	5842	63	0	6167
20161	5893	8	166	65	0	6132
20162	6010	10	51	59	0	6130
20163	6030	20	16	47	0	6113
20164	275	9	5691	47	0	6022
20165	127	14	170	5592	0	5903
20166	87	12	50	5853	0	6002
20167	67	9	5666	236	0	5978
20168	5579	11	180	80	0	5850
20169	255	10	60	5505	0	5830
20170	120	9	5445	194	0	5768
20171	92	9	5598	74	0	5773
20172	63	10	227	5550	0	5850
20173	62	10	5673	225	0	5970
20174	50	12	213	5630	0	5905
20175	66	8	83	5822	0	5979
20176	64	8	5612	269	0	5953
20177	62	18	203	5393	0	5676
20178	64	5309	89	217	0	5679
20179	41	5786	58	99	0	5984
20180	5637	209	57	76	0	5979
20181	5690	67	47	72	0	5876
20182	241	5600	39	80	0	5960
20183	5664	190	38	60	0	5952
20184	5778	65	34	64	0	5941
20185	271	35	36	5624	0	5966
20186	118	45	30	5790	0	5983
20187	5589	47	19	268	0	5923
20188	259	5466	24	104	0	5853
20189	139	5662	23	63	0	5887
20190	120	230	19	5595	0	5964
20191	99	84	5638	231	0	6052
20192	5429	38	185	120	0	5772
20193	5678	32	70	91	0	5871
20194	5521	39	32	83	0	5675
20195	307	5469	37	73	0	5886
20196	166	218	32	5316	0	5732
20197	106	103	24	5628	0	5861
20198	5456	51	49	285	0	5841
20199	274	5449	42	124	0	5889
20200	158	199	38	5488	0	5883
20201	141	87	38	5614	0	5880
20202	149	63	27	5626	0	5865
20203	5454	57	29	314	0	5854
20204	276	5408	40	155	0	5879
20205	158	236	27	5166	0	5587
20206	133	5425	47	250	0	5855
20207	5450	233	42	156	0	5881
20208	287	92	5304	136	0	5819
20209	5253	57	210	137	0	5657
20210	269	52	5151	148	0	5620
20211	168	86	187	5006	0	5447
20212	5033	62	75	249	0	5419
20213	273	51	4993	143	0	5460
20214	5086	43	192	118	0	5439
20215	5265	28	80	139	0	5512
20216	5346	29	70	104	0	5549
20217	323	25	62	5048	0	5458
20218	187	22	54	5098	0	5361
20219	137	26	57	5252	0	5472
20220	4992	23	54	307	0	5376
20221	278	5039	50	149	0	5516
20222	5120	157	65	92	0	5434
20223	5308	54	63	84	0	5509
20224	322	39	5027	94	0	5482
20225	5095	22	195	113	0	5425
20226	5338	28	97	119	0	5582
20227	290	30	72	5251	0	5643
20228	140	42	58	5315	0	5555
20229	127	35	64	5372	0	5598
20230	5129	38	66	278	0	5511
20231	5072	41	64	142	0	5319
20232	4937	29	69	94	0	5129
20233	261	4571	67	102	0	5001
20234	108	4407	63	85	0	4663
20235	71	4530	50	108	0	4759
20236	4387	175	71	129	0	4762
20237	202	64	4280	104	0	4650
20238	99	35	3575	78	0	3787
20239	2355	7	78	30	0	2470
20240	54	3	2623	16	0	2696
20241	10	7	13	2102	0	2132
20242	4	2063	8	14	0	2089
20243	2216	13	5	7	0	2241
20244	2203	6	0	5	0	2214
20245	2210	3	1	6	0	2220
20246	19	2	3	2356	0	2380
20247	10	2	2431	11	0	2454
20248	4	2	2320	4	0	2330
20249	2361	1	12	4	0	2378
20250	2487	3	4	4	0	2498
20251	2446	4	3	6	0	2459
20252	21	4	0	2476	0	2501
20253	9	3	2	2500	0	2514
20254	5	3	2502	16	0	2526
20255	2387	4	11	12	0	2414
20256	12	2	6	2590	0	2610
20257	6	0	3	2579	0	2588
20258	5	1	1	2620	0	2627
20259	4	2597	1	17	0	2619
20260	4	11	0	2618	0	2633
20261	4	5	2	2581	0	2592
20262	2565	1	4	21	0	2591
20263	20	1	2513	5	0	2539
20264	2373	2	12	4	0	2391
20265	2562	0	5	7	0	2574
20266	15	3	1	2535	0	2554
20267	8	2	1	2525	0	2536
20268	2511	1	1	22	0	2535
20269	18	1	2463	8	0	2490
20270	8	2455	13	2	0	2478
20271	4	7	10	2430	0	2451
20272	2442	0	1	8	0	2451
20273	10	6	2	2370	0	2388
20274	5	0	2359	11	0	2375
20275	3	3	2343	6	0	2355
20276	2367	5	7	6	0	2385
20277	9	1	1	2518	0	2529
20278	8	1	2511	8	0	2528
20279	2433	0	6	15	0	2454
20280	2665	0	3	9	0	2677
20281	10	1	2	2662	0	2675
20282	8	0	1	2678	0	2687
20283	5	2696	0	6	0	2707
20284	2793	4	2	13	0	2812
20285	10	1	2	2823	0	2836
20286	5	1	2	2855	0	2863
20287	2	1	2916	7	0	2926
20288	2629	0	5	9	0	2643
20289	2804	0	1	9	0	2814
20290	7	2773	1	3	0	2784
20291	1	4	2686	1	0	2692
20292	5	3	2689	1	0	2698
20293	2	5	5	2592	0	2604
20294	2836	3	2	15	0	2856
20295	6	0	0	2832	0	2838
20296	2938	0	0	11	0	2949
20297	2952	0	1	7	0	2960
20298	2971	1	0	5	0	2977
20299	7	0	0	2930	0	2937
20300	6	0	1	2925	0	2932
20301	3030	0	0	11	0	3041
20302	5	0	3108	2	0	3115
20303	2832	0	5	5	0	2842
20304	2892	0	1	5	0	2898
20305	1	0	3061	1	0	3063
20306	2	1	2979	0	0	2982
20307	3	3044	3	0	0	3050
20308	1	5	1	3093	0	3100
20309	2848	2	5	16	0	2871
20310	4	0	1	3092	0	3097
20311	1	0	3151	3	0	3155
20312	2	3054	4	1	0	3061
20313	1	3039	2	0	0	3042
20314	0	4	0	3132	0	3136
20315	0	3	1	3043	0	3047
20316	2	3025	0	3	0	3030
20317	1	5	3027	2	0	3035
20318	2773	3	5	6	0	2787
20319	3123	0	3	6	0	3132
20320	6	3127	3	7	0	3143
20321	3019	9	8	6	0	3042
20322	10	3	1	2973	0	2987
20323	2969	0	1	11	0	2981
20324	10	1	1	2907	0	2919
20325	2	3116	1	9	0	3128
20326	1	13	3111	1	0	3126
20327	2	2	13	3352	0	3369
20328	9	2	10	3197	0	3218
20329	0	0	1	3585	0	3586
20330	3695	2	2	43	0	3742
20331	48	4	1	3737	0	3790
20332	9	0	3945	48	0	4002
20333	10	5	4058	12	0	4085
20334	4230	3	71	13	0	4317
20335	75	2	4416	4	0	4497
20336	4394	0	79	6	0	4479
20337	87	1	9	4922	0	5019
20338	12	1	10	5064	0	5087
20339	11	1	14	5424	0	5450
20340	9	1	9	5350	0	5369
20341	5273	2	5	156	0	5436
20342	133	0	5300	42	0	5475
20343	35	1	131	5143	0	5310
20344	23	5346	24	128	0	5521
20345	5378	134	18	36	0	5566
20346	138	16	10	5273	0	5437
20347	5190	15	9	151	0	5365
20348	162	4	5189	34	0	5389
20349	38	2	143	4884	0	5067
20350	27	5120	24	146	0	5317
20351	5164	138	21	37	0	5360
20352	158	18	5137	46	0	5359
20353	36	17	152	5056	0	5261
20354	32	5	30	5287	0	5354
20355	5123	13	26	175	0	5337
20356	154	16	5076	51	0	5297
20357	38	11	5194	41	0	5284
20358	46	7	163	5104	0	5320
20359	31	9	5117	154	0	5311
20360	23	3	5219	52	0	5297
20361	29	17	167	5014	0	5227
20362	36	10	56	5139	0	5241
20363	21	7	55	5408	0	5491
20364	5242	5	32	210	0	5489
20365	165	5292	29	75	0	5561
20366	5389	137	39	57	0	5622
20367	183	21	36	5283	0	5523
20368	46	5362	29	186	0	5623
20369	38	151	30	5538	0	5757
20370	5678	22	25	215	0	5940
20371	171	5868	40	73	0	6152
20372	51	188	32	6078	0	6349
20373	44	31	6071	249	0	6395
20374	6005	38	195	92	0	6330
20375	229	25	44	6068	0	6366
20376	68	22	54	6222	0	6366
20377	60	27	5945	266	0	6298
20378	50	20	5977	107	0	6154
20379	5724	25	238	88	0	6075
20380	237	5758	69	76	0	6140
20381	81	197	60	5823	0	6161
20382	5827	43	45	263	0	6178
20383	225	43	5839	108	0	6215
20384	70	5787	241	80	0	6178
20385	84	204	65	5840	0	6193
20386	5856	47	65	261	0	6229
20387	5767	43	51	114	0	5975
20388	5944	29	56	108	0	6137
20389	268	5717	60	79	0	6124
20390	98	212	5744	83	0	6137
20391	90	47	243	5817	0	6197
20392	76	58	98	5250	0	5482
20393	67	32	68	5996	0	6163
20394	71	33	58	5980	0	6142
20395	5774	46	53	293	0	6166
20396	5776	35	59	140	0	6010
20397	273	27	5550	123	0	5973
20398	108	31	5594	99	0	5832
20399	5463	30	237	103	0	5833
20400	5654	32	93	97	0	5876
20401	286	32	79	5336	0	5733
20402	101	5406	74	253	0	5834
20403	5414	208	62	118	0	5802
20404	252	5310	59	107	0	5728
20405	94	5415	47	107	0	5663
20406	94	214	44	5563	0	5915
20407	90	68	47	5728	0	5933
20408	78	60	60	5706	0	5904
20409	86	48	58	5757	0	5949
20410	85	38	5452	313	0	5888
20411	5327	58	231	121	0	5737
20412	5622	42	75	118	0	5857
20413	285	50	63	5392	0	5790
20414	119	55	44	5578	0	5796
20415	5441	46	47	310	0	5844
20416	257	50	5130	137	0	5574
20417	5362	46	221	114	0	5743
20418	5559	44	53	108	0	5764
20419	279	47	5307	105	0	5738
20420	5473	32	213	118	0	5836
20421	288	34	77	5553	0	5952
20422	109	29	82	5718	0	5938
20423	117	34	61	5671	0	5883
20424	104	29	52	5691	0	5876
20425	5307	28	49	320	0	5704
20426	300	21	49	5233	0	5603
20427	98	19	60	4980	0	5157
20428	84	4563	55	268	0	4970
20429	81	4782	41	128	0	5032
20430	87	170	33	4655	0	4945
20431	4546	51	45	235	0	4877
20432	230	38	34	4306	0	4608
20433	71	29	3973	209	0	4282
20434	64	35	3647	82	0	3828
20435	3606	15	141	89	0	3851
20436	165	3695	52	69	0	3981
20437	3271	106	41	36	0	3454
20438	134	24	3250	41	0	3449
20439	50	112	91	2893	0	3146
20440	2879	8	24	95	0	3006
20441	93	2835	20	32	0	2980
20442	2773	70	15	31	0	2889
20443	88	17	2982	29	0	3116
20444	32	14	65	2942	0	3053
20445	30	14	25	3032	0	3101
20446	3066	15	17	90	0	3188
20447	3097	12	12	36	0	3157
20448	3177	6	14	41	0	3238
20449	3172	7	11	30	0	3220
20450	3238	10	9	22	0	3279
20451	85	3179	11	24	0	3299
20452	44	58	8	3262	0	3372
20453	3318	7	7	80	0	3412
20454	89	16	5	3290	0	3400
20455	28	14	10	3335	0	3387
20456	30	12	9	3344	0	3395
20457	31	3243	6	72	0	3352
20458	3279	57	11	32	0	3379
20459	70	12	6	3287	0	3375
20460	3188	10	12	84	0	3294
20461	3161	8	6	37	0	3212
20462	77	3118	2	34	0	3231
20463	3119	55	6	27	0	3207
20464	73	11	3068	24	0	3176
20465	2972	6	61	21	0	3060
20466	77	32	29	2991	0	3129
20467	30	8	3108	49	0	3195
20468	24	3068	55	27	0	3174
20469	30	46	3070	17	0	3163
20470	19	2840	27	14	0	2900
20471	2669	32	27	16	0	2744
20472	2692	12	3	10	0	2717
20473	2639	0	1	3	0	2643
20474	8	2630	2	1	0	2641
20475	2599	7	0	8	0	2614
20476	11	3	2590	2	0	2606
20477	5	1	2600	3	0	2609
20478	3	12	13	2551	0	2579
20479	5	3	15	2728	0	2751
20480	4	2728	2	5	0	2739
20481	2790	5	2	2	0	2799
20482	7	1	1	2828	0	2837
20483	1	2751	0	8	0	2760
20484	3	10	1	2852	0	2866
20485	2812	3	3	15	0	2833
20486	2751	3	1	13	0	2768
20487	18	3	2681	8	0	2710
20488	5	2	11	2703	0	2721
20489	5	3	2722	13	0	2743
20490	6	0	13	2703	0	2722
20491	8	2	2713	16	0	2739
20492	1	2	19	2705	0	2727
20493	2	2	2759	23	0	2786
20494	5	5	20	2728	0	2758
20495	8	2	2823	19	0	2852
20496	3	2	21	2767	0	2793
20497	2	5	10	2846	0	2863
20498	3	2871	8	32	0	2914
20499	8	15	5	2981	0	3009
20500	9	5	2957	24	0	2995
20501	5	2	27	2903	0	2937
20502	3	2	13	2940	0	2958
20503	2953	2	12	35	0	3002
20504	16	4	5	3003	0	3028
20505	6	1	8	2955	0	2970
20506	3	6	2864	34	0	2907
20507	2804	2	23	18	0	2847
20508	18	0	11	2955	0	2984
20509	8	1	13	2927	0	2949
20510	3	1	4	2970	0	2978
20511	2966	2	3	38	0	3009
20512	21	7	4	3012	0	3044
20513	9	2	4	3020	0	3035
20514	2997	0	8	37	0	3042
20515	19	2988	6	21	0	3034
20516	11	17	1	2931	0	2960
20517	9	6	2	2960	0	2977
20518	7	5	2897	41	0	2950
20519	2489	3	20	33	0	2545
20520	20	3	11	2833	0	2867
20521	15	2	2752	29	0	2798
20522	2734	2	14	33	0	2783
20523	24	4	9	2890	0	2927
20524	13	3	5	2965	0	2986
20525	9	1	3	3002	0	3015
20526	7	0	6	3055	0	3068
20527	9	4	3251	43	0	3307
20528	14	2	32	3251	0	3299
20529	7	5	14	4078	0	4104
20530	10	4	4785	96	0	4895
20531	5016	0	123	58	0	5197
20532	5309	1	60	36	0	5406
20533	5418	1	38	26	0	5483
20534	228	2	26	5276	0	5532
20535	5387	1	24	147	0	5559
20536	5481	2	19	82	0	5584
20537	252	1	10	5405	0	5668
20538	5407	1	8	190	0	5606
20539	5467	2	13	92	0	5574
20540	5486	0	5	74	0	5565
20541	5560	0	8	60	0	5628
20542	280	0	12	5245	0	5537
20543	161	5024	8	172	0	5365
20544	126	5060	16	74	0	5276
20545	94	5232	9	49	0	5384
20546	5012	220	7	44	0	5283
20547	5286	123	2	31	0	5442
20548	243	71	5040	33	0	5387
20549	5203	55	134	31	0	5423
20550	235	38	69	5224	0	5566
20551	139	31	42	5291	0	5503
20552	111	21	30	5384	0	5546
20553	5209	13	22	260	0	5504
20554	202	12	19	5192	0	5425
20555	128	5036	8	243	0	5415
20556	82	146	7	5229	0	5464
20557	54	78	5172	231	0	5535
20558	57	56	139	5275	0	5527
20559	5242	42	71	228	0	5583
20560	201	27	5216	132	0	5576
20561	122	25	167	5228	0	5542
20562	104	20	89	5197	0	5410
20563	74	15	65	5321	0	5475
20564	47	5254	39	283	0	5623
20565	57	155	24	5418	0	5654
20566	5328	68	27	262	0	5685
20567	5330	45	18	159	0	5552
20568	262	34	5110	115	0	5521
20569	152	27	5205	92	0	5476
20570	102	29	222	5188	0	5541
20571	77	18	112	5426	0	5633
20572	67	14	5340	267	0	5688
20573	78	21	191	5052	0	5342
20574	48	5208	110	232	0	5598
20575	5428	169	75	143	0	5815
20576	5460	84	48	111	0	5703
20577	5469	52	38	95	0	5654
20578	301	45	5301	80	0	5727
20579	186	30	173	5339	0	5728
20580	133	26	5293	201	0	5653
20581	5185	17	195	122	0	5519
20582	225	5213	113	98	0	5649
20583	144	153	79	5246	0	5622
20584	5220	83	58	204	0	5565
20585	210	48	40	5258	0	5556
20586	123	50	38	5439	0	5650
20587	103	27	5204	278	0	5612
20588	5053	30	184	163	0	5430
20589	213	5176	100	122	0	5611
20590	161	151	63	5298	0	5673
20591	5263	82	61	231	0	5637
20592	246	49	39	5327	0	5661
20593	5240	50	40	246	0	5576
20594	254	5206	31	171	0	5662
20595	5366	174	23	114	0	5677
20596	289	83	5264	99	0	5735
20597	5410	45	152	80	0	5687
20598	5433	49	88	88	0	5658
20599	5495	33	72	85	0	5685
20600	345	41	59	5214	0	5659
20601	232	46	38	5004	0	5320
20602	163	46	38	5233	0	5480
20603	134	5092	32	284	0	5542
20604	5203	175	29	173	0	5580
20605	244	87	31	5204	0	5566
20606	175	55	25	5290	0	5545
20607	127	39	26	5339	0	5531
20608	5160	33	30	324	0	5547
20609	225	39	34	5259	0	5557
20610	156	33	5003	299	0	5491
20611	106	5066	154	222	0	5548
20612	98	176	76	5204	0	5554
20613	85	103	58	5337	0	5583
20614	71	65	51	5437	0	5624
20615	73	50	5095	341	0	5559
20616	73	32	5137	217	0	5459
20617	61	29	249	5217	0	5556
20618	64	24	5337	292	0	5717
20619	69	20	224	5459	0	5772
20620	5365	30	123	322	0	5840
20621	5602	25	74	221	0	5922
20622	5638	20	65	162	0	5885
20623	316	36	5328	121	0	5801
20624	5368	33	188	86	0	5675
20625	285	32	116	5411	0	5844
20626	184	16	5303	229	0	5732
20627	126	11	5131	157	0	5425
20628	121	4933	254	124	0	5432
20629	51	4352	116	74	0	4593
20630	3426	93	116	30	0	3665
20631	53	23	23	3268	0	3367
20632	30	10	3310	52	0	3402
20633	8	10	48	3265	0	3331
20634	3311	3	31	52	0	3397
20635	50	7	3573	30	0	3660
20636	3560	5	50	22	0	3637
20637	3803	9	23	27	0	3862
20638	3796	4	12	22	0	3834
20639	80	3734	11	14	0	3839
20640	3887	49	6	21	0	3963
20641	73	22	16	3880	0	3991
20642	51	7	17	3847	0	3922
20643	28	10	12	3926	0	3976
20644	30	5	7	3923	0	3965
20645	3804	11	6	86	0	3907
20646	67	3722	12	41	0	3842
20647	31	3558	8	26	0	3623
20648	25	3696	4	28	0	3753
20649	3694	62	11	28	0	3795
20650	3693	23	7	23	0	3746
20651	3656	8	5	17	0	3686
20652	3665	18	5	18	0	3706
20653	73	11	7	3608	0	3699
20654	37	17	9	3621	0	3684
20655	3619	6	7	75	0	3707
20656	67	3606	7	38	0	3718
20657	3552	47	7	29	0	3635
20658	3592	19	8	27	0	3646
20659	79	5	11	3575	0	3670
20660	33	3589	6	69	0	3697
20661	30	52	10	3711	0	3803
20662	3656	29	12	66	0	3763
20663	79	6	3703	37	0	3825
20664	43	17	50	3497	0	3607
20665	17	3645	23	57	0	3742
20666	3661	54	11	24	0	3750
20667	3603	21	14	36	0	3674
20668	84	9	3621	17	0	3731
20669	31	3512	54	15	0	3612
20670	23	44	3595	20	0	3682
20671	19	39	51	3401	0	3510
20672	20	7	3395	56	0	3478
20673	23	8	3316	22	0	3369
20674	10	3314	63	17	0	3404
20675	3282	51	16	12	0	3361
20676	3349	19	17	12	0	3397
20677	56	3392	8	23	0	3479
20678	25	3415	19	10	0	3469
20679	25	49	3272	16	0	3362
20680	18	31	3194	18	0	3261
20681	28	21	3317	9	0	3375
20682	27	9	55	3295	0	3386
20683	16	12	3360	47	0	3435
20684	12	22	45	3221	0	3300
20685	19	10	34	3184	0	3247
20686	12	7	3308	65	0	3392
20687	15	3281	58	22	0	3376
20688	21	42	19	3313	0	3395
20689	3312	22	16	54	0	3404
20690	56	11	11	3318	0	3396
20691	33	11	3321	60	0	3425
20692	19	3265	52	28	0	3364
20693	13	3464	29	12	0	3518
20694	14	66	15	3392	0	3487
20695	3343	24	6	58	0	3431
20696	3323	8	13	33	0	3377
20697	69	5	17	3281	0	3372
20698	27	3417	16	51	0	3511
20699	23	66	12	3466	0	3567
20700	24	29	6	3563	0	3622
20701	26	12	9	3580	0	3627
20702	3824	11	12	81	0	3928
20703	72	3817	7	49	0	3945
20704	3865	82	10	22	0	3979
20705	3944	38	7	27	0	4016
20706	3959	13	10	30	0	4012
20707	4091	19	7	29	0	4146
20708	122	18	8	3966	0	4114
20709	58	19	3959	88	0	4124
20710	36	3967	76	46	0	4125
20711	4079	79	38	28	0	4224
20712	4145	32	19	24	0	4220
20713	4243	15	13	15	0	4286
20714	128	12	4080	28	0	4248
20715	4049	6	87	22	0	4164
20716	4160	25	39	13	0	4237
20717	139	25	12	4087	0	4263
20718	73	14	3902	79	0	4068
20719	51	3819	80	39	0	3989
20720	47	78	39	3822	0	3986
20721	3766	42	21	99	0	3928
20722	99	17	11	3739	0	3866
20723	49	20	9	3854	0	3932
20724	3855	11	21	111	0	3998
20725	114	22	3813	42	0	3991
20726	3825	12	93	35	0	3965
20727	3846	11	35	26	0	3918
20728	3861	4	20	24	0	3909
20729	3890	7	12	25	0	3934
20730	140	9	3717	33	0	3899
20731	66	10	103	3678	0	3857
20732	36	20	3712	96	0	3864
20733	38	19	98	3627	0	3782
20734	46	12	3641	100	0	3799
20735	3210	5	99	60	0	3374
20736	103	3125	33	28	0	3289
20737	55	3232	19	11	0	3317
20738	30	97	18	3381	0	3526
20739	39	45	18	3486	0	3588
20740	31	3616	14	115	0	3776
20741	3660	97	12	47	0	3816
20742	3964	38	12	21	0	4035
20743	4124	24	12	16	0	4176
20744	4410	13	9	22	0	4454
20745	188	5	16	4293	0	4502
20746	74	7	9	4469	0	4559
20747	4477	15	17	177	0	4686
20748	170	6	4	4442	0	4622
20749	75	13	4308	152	0	4548
20750	48	17	4375	68	0	4508
20751	39	5	175	4382	0	4601
20752	27	11	4404	161	0	4603
20753	4323	11	151	82	0	4567
20754	176	4	69	4362	0	4611
20755	4420	7	32	167	0	4626
20756	175	9	4377	68	0	4629
20757	82	3	143	4410	0	4638
20758	37	8	4465	173	0	4683
20759	36	4417	164	85	0	4702
20760	4374	134	80	55	0	4643
20761	4459	52	40	46	0	4597
20762	211	4338	24	31	0	4604
20763	4332	140	29	33	0	4534
20764	188	57	21	4241	0	4507
20765	99	22	26	4371	0	4518
20766	4264	23	13	206	0	4506
20767	190	4145	19	88	0	4442
20768	95	4275	23	51	0	4444
20769	56	190	24	4186	0	4456
20770	4132	71	25	163	0	4391
20771	4264	43	19	83	0	4409
20772	4332	21	21	58	0	4432
20773	252	24	4120	39	0	4435
20774	110	29	4127	35	0	4301
20775	77	4111	189	30	0	4407
20776	4103	153	72	44	0	4372
20777	199	63	34	4007	0	4303
20778	4073	30	35	166	0	4304
20779	4168	29	21	78	0	4296
20780	241	30	28	3966	0	4265
20781	128	18	3991	182	0	4319
20782	4042	20	160	92	0	4314
20783	207	10	72	4036	0	4325
20784	116	21	4020	179	0	4336
20785	4026	20	167	88	0	4301
20786	4137	15	80	65	0	4297
20787	242	18	41	4008	0	4309
20788	126	17	3992	191	0	4326
20789	94	13	159	3851	0	4117
20790	69	3948	82	185	0	4284
20791	79	139	3935	88	0	4241
20792	76	4013	162	56	0	4307
20793	3964	160	86	42	0	4252
20794	4075	63	51	58	0	4247
20795	4091	37	46	51	0	4225
20796	4093	19	40	53	0	4205
20797	265	23	31	3869	0	4188
20798	3803	17	43	150	0	4013
20799	206	25	28	3723	0	3982
20800	3625	23	33	171	0	3852
20801	196	3550	23	103	0	3872
20802	109	127	15	3190	0	3441
20803	66	3294	24	132	0	3516
20804	3320	142	16	77	0	3555
20805	3360	47	22	52	0	3481
20806	188	3178	35	47	0	3448
20807	106	118	20	3119	0	3363
20808	70	56	3073	140	0	3339
20809	54	52	116	3086	0	3308
20810	74	24	3054	136	0	3288
20811	59	25	119	2755	0	2958
20812	64	2860	57	126	0	3107
20813	2857	114	35	61	0	3067
20814	2942	41	27	53	0	3063
20815	163	31	33	2830	0	3057
20816	2966	23	20	139	0	3148
20817	166	21	24	2952	0	3163
20818	83	27	19	3027	0	3156
20819	58	21	24	3078	0	3181
20820	3008	16	20	161	0	3205
20821	3055	21	18	89	0	3183
20822	3067	17	31	51	0	3166
20823	168	2865	15	49	0	3097
20824	2879	104	13	36	0	3032
20825	136	2790	17	39	0	2982
20826	2840	101	21	42	0	3004
20827	143	41	18	2786	0	2988
20828	96	30	17	2850	0	2993
20829	2791	28	15	150	0	2984
20830	2840	27	19	68	0	2954
20831	153	2753	12	56	0	2974
20832	2762	110	12	29	0	2913
20833	161	37	12	2695	0	2905
20834	85	32	9	2783	0	2909
20835	2728	20	12	146	0	2906
20836	152	13	2641	70	0	2876
20837	68	2565	85	52	0	2770
20838	86	93	39	2338	0	2556
20839	45	31	2166	93	0	2335
20840	51	65	75	2017	0	2208
20841	2015	18	37	93	0	2163
20842	89	1753	13	40	0	1895
20843	35	1614	14	29	0	1692
20844	22	1413	14	18	0	1467
20845	28	57	22	1309	0	1416
20846	1287	15	38	52	0	1392
20847	33	4	3	1246	0	1286
20848	1240	5	5	33	0	1283
20849	1263	6	0	13	0	1282
20850	36	3	2	1251	0	1292
20851	1252	5	4	30	0	1291
20852	40	3	1	1276	0	1320
20853	15	6	1298	34	0	1353
20854	1274	11	28	10	0	1323
20855	37	3	1414	12	0	1466
20856	1352	5	29	11	0	1397
20857	35	2	1373	13	0	1423
20858	9	3	21	1275	0	1308
20859	6	2	3	1319	0	1330
20860	1342	7	1	27	0	1377
20861	27	4	1	1359	0	1391
20862	1354	6	2	26	0	1388
20863	30	1342	1	8	0	1381
20864	1402	17	4	8	0	1431
20865	29	6	3	1454	0	1492
20866	11	4	2	1465	0	1482
20867	5	3	4	1477	0	1489
20868	7	5	2	1466	0	1480
20869	10	2	1418	31	0	1461
20870	8	2	1431	11	0	1452
20871	7	1	22	1426	0	1456
20872	5	2	1442	25	0	1474
20873	6	1423	20	9	0	1458
20874	5	20	7	1436	0	1468
20875	3	6	1471	25	0	1505
20876	5	2	1466	12	0	1485
20877	3	5	26	1512	0	1546
20878	2	0	6	1514	0	1522
20879	4	1538	2	29	0	1573
20880	5	27	1	1566	0	1599
20881	2	6	1535	27	0	1570
20882	1491	2	31	6	0	1530
20883	30	1	10	1545	0	1586
20884	1561	1	2	34	0	1598
20885	1578	2	2	16	0	1598
20886	1606	6	10	8	0	1630
20887	30	4	1610	8	0	1652
20888	10	3	1581	5	0	1599
20889	1491	0	37	7	0	1535
20890	28	2	1613	9	0	1652
20891	12	1	26	1550	0	1589
20892	8	2	11	1566	0	1587
20893	10	7	1580	33	0	1630
20894	6	1574	31	10	0	1621
20895	1569	28	11	6	0	1614
20896	34	1588	4	8	0	1634
20897	12	1652	8	6	0	1678
20898	1640	29	7	11	0	1687
20899	33	7	1693	9	0	1742
20900	10	3	1706	9	0	1728
20901	7	4	40	1653	0	1704
20902	1681	3	8	37	0	1729
20903	32	1692	4	18	0	1746
20904	1715	36	6	7	0	1764
20905	36	10	1797	7	0	1850
20906	9	1933	43	5	0	1990
20907	7	40	15	2000	0	2062
20908	6	11	2040	51	0	2108
20909	10	6	46	2034	0	2096
20910	7	7	27	1771	0	1812
20911	10	6	11	2110	0	2137
20912	6	4	11	2104	0	2125
20913	2057	8	10	59	0	2134
20914	2069	7	4	27	0	2107
20915	62	7	2106	12	0	2187
20916	2020	4	52	15	0	2091
20917	48	2035	23	14	0	2120
20918	2063	41	8	13	0	2125
20919	49	14	2064	20	0	2147
20920	23	4	51	2030	0	2108
20921	17	2	2090	51	0	2160
20922	15	3	2074	28	0	2120
20923	14	4	59	2030	0	2107
20924	12	6	19	2103	0	2140
20925	20	4	2057	55	0	2136
20926	14	1995	52	18	0	2079
20927	13	2063	22	15	0	2113
20928	6	53	16	2080	0	2155
20929	2049	15	15	52	0	2131
20930	51	2114	7	25	0	2197
20931	21	40	2133	16	0	2210
20932	9	17	2105	12	0	2143
20933	7	11	2155	9	0	2182
20934	15	9	62	2058	0	2144
20935	2133	8	25	54	0	2220
20936	50	2088	9	24	0	2171
20937	20	45	2066	16	0	2147
20938	8	2058	56	4	0	2126
20939	5	54	29	2096	0	2184
20940	6	17	2112	49	0	2184
20941	10	2140	48	28	0	2226
20942	13	49	17	2125	0	2204
20943	10	21	12	2236	0	2279
20944	7	8	2284	52	0	2351
20945	10	12	50	2208	0	2280
20946	10	2227	17	51	0	2305
20947	10	43	2227	22	0	2302
20948	2202	19	45	21	0	2287
20949	45	12	23	2270	0	2350
20950	25	10	13	2252	0	2300
20951	8	2254	17	60	0	2339
20952	2244	38	12	24	0	2318
20953	47	23	2189	11	0	2270
20954	2143	8	50	26	0	2227
20955	44	11	20	2080	0	2155
20956	17	2129	11	49	0	2206
20957	13	36	13	2158	0	2220
20958	6	18	12	2242	0	2278
20959	2217	10	11	59	0	2297
20960	2219	3	19	22	0	2263
20961	56	5	11	2236	0	2308
20962	21	8	2209	53	0	2291
20963	2028	8	45	27	0	2108
20964	38	2193	20	14	0	2265
20965	23	47	10	2178	0	2258
20966	17	21	9	2243	0	2290
20967	9	6	9	2245	0	2269
20968	10	8	2185	65	0	2268
20969	3	9	50	2163	0	2225
20970	6	2205	24	53	0	2288
20971	10	49	11	2174	0	2244
20972	9	2188	11	46	0	2254
20973	12	47	8	2223	0	2290
20974	9	22	2187	52	0	2270
20975	2000	9	48	25	0	2082
20976	48	13	26	2178	0	2265
20977	16	7	2145	47	0	2215
20978	5	2127	33	32	0	2197
20979	2105	31	18	16	0	2170
20980	31	18	2113	9	0	2171
20981	2073	13	44	22	0	2152
20982	32	6	23	2157	0	2218
20983	23	2	10	2213	0	2248
20984	7	2235	5	42	0	2289
20985	2241	35	9	19	0	2304
20986	2223	16	8	10	0	2257
20987	45	2295	8	13	0	2361
20988	14	33	9	2378	0	2434
20989	9	14	8	2394	0	2425
20990	8	7	6	2378	0	2399
20991	7	4	2326	49	0	2386
20992	2235	5	39	19	0	2298
20993	34	6	16	2326	0	2382
20994	16	13	6	2358	0	2393
20995	6	6	2307	50	0	2369
20996	9	6	2252	27	0	2294
20997	8	14	38	2319	0	2379
20998	12	4	2379	34	0	2429
20999	2235	4	32	23	0	2294
21000	29	3	21	2362	0	2415
21001	19	3	11	2432	0	2465
21002	10	6	2545	46	0	2607
21003	5	3	41	2579	0	2628
21004	3	1	2602	50	0	2656
21005	5	2474	40	36	0	2555
21006	2333	31	31	19	0	2414
21007	2306	9	6	10	0	2331
21008	30	2291	7	8	0	2336
21009	14	24	6	2347	0	2391
21010	4	12	2379	27	0	2422
21011	7	4	24	2341	0	2376
21012	2353	2	12	27	0	2394
21013	24	2362	4	15	0	2405
21014	2374	20	7	7	0	2408
21015	27	6	3	2329	0	2365
21016	2339	5	3	30	0	2377
21017	26	2304	4	12	0	2346
21018	2341	26	3	6	0	2376
21019	30	7	2278	8	0	2323
21020	11	2310	22	5	0	2348
21021	17	25	6	2338	0	2386
21022	2538	6	2	30	0	2576
21023	2558	5	7	12	0	2582
21024	43	4	5	2556	0	2608
21025	2608	6	3	37	0	2654
21026	2608	2	4	13	0	2627
21027	2646	3	5	11	0	2665
21028	44	4	3	2610	0	2661
21029	15	2	2614	39	0	2670
21030	16	5	2454	13	0	2488
21031	13	2	2524	6	0	2545
21032	2538	4	37	9	0	2588
21033	41	3	8	2566	0	2618
21034	9	2621	11	39	0	2680
21035	11	34	8	2617	0	2670
21036	7	2672	4	39	0	2722
21037	2792	35	4	19	0	2850
21038	44	9	7	2827	0	2887
21039	9	9	3	2903	0	2924
21040	2913	3	5	55	0	2976
21041	48	7	5	2931	0	2991
21042	14	7	4	2980	0	3005
21043	3006	3	5	63	0	3077
21044	55	4	3086	14	0	3159
21045	19	2	51	3087	0	3159
21046	9	3	3089	68	0	3169
21047	2997	2	47	23	0	3069
21048	65	1	12	3125	0	3203
21049	3122	4	9	65	0	3200
21050	66	6	6	3169	0	3247
21051	20	1	3272	73	0	3366
21052	17	2	66	3301	0	3386
21053	3400	8	14	71	0	3493
21054	66	3419	13	19	0	3517
21055	21	55	3423	19	0	3518
21056	3270	15	71	14	0	3370
21057	72	3359	13	19	0	3463
21058	18	3354	9	20	0	3401
21059	18	3602	5	51	0	3676
21060	18	75	5	3851	0	3949
21061	3929	15	15	86	0	4045
21062	4094	9	6	19	0	4128
21063	100	13	3969	16	0	4098
21064	3940	12	78	12	0	4042
21065	98	3926	18	15	0	4057
21066	27	93	11	4060	0	4191
21067	4221	18	10	95	0	4344
21068	4289	11	11	24	0	4335
21069	4321	10	9	25	0	4365
21070	4264	14	11	12	0	4301
21071	4310	12	10	19	0	4351
21072	116	11	4	4216	0	4347
21073	41	17	4208	92	0	4358
21074	34	6	87	4224	0	4351
21075	39	8	16	4328	0	4391
21076	4266	11	11	101	0	4389
21077	112	4134	15	36	0	4297
21078	4219	86	15	24	0	4344
21079	4292	22	12	31	0	4357
21080	4411	14	11	38	0	4474
21081	4496	9	9	29	0	4543
21082	136	18	4316	26	0	4496
21083	4299	5	91	26	0	4421
21084	4438	11	19	24	0	4492
21085	3770	23	25	45	0	3863
21086	4429	8	9	36	0	4482
21087	138	11	19	4206	0	4374
21088	55	8	4104	112	0	4279
21089	4041	9	102	39	0	4191
21090	135	4098	26	36	0	4295
21091	70	95	11	4031	0	4207
21092	55	4155	14	106	0	4330
21093	55	88	21	4252	0	4416
21094	4327	18	13	116	0	4474
21095	4375	21	17	31	0	4444
21096	4388	13	17	43	0	4461
21097	155	19	4065	27	0	4266
21098	4073	13	88	33	0	4207
21099	136	12	4059	27	0	4234
21100	75	14	3982	25	0	4096
21101	54	13	4087	24	0	4178
21102	54	22	112	3726	0	3914
21103	47	14	31	3927	0	4019
21104	35	21	15	3934	0	4005
21105	42	14	18	3913	0	3987
21106	52	14	23	3701	0	3790
21107	38	15	14	3882	0	3949
21108	47	3892	19	104	0	4062
21109	3862	87	16	47	0	4012
21110	114	3909	20	29	0	4072
21111	49	85	20	3967	0	4121
21112	36	18	22	4037	0	4113
21113	3977	13	15	130	0	4135
21114	107	3921	19	48	0	4095
21115	4005	89	17	32	0	4143
21116	117	32	13	3985	0	4147
21117	52	14	11	4052	0	4129
21118	47	17	16	4040	0	4120
21119	45	17	3951	127	0	4140
21120	43	18	95	3893	0	4049
21121	46	16	3860	114	0	4036
21122	34	25	3580	42	0	3681
21123	45	12	3798	44	0	3899
21124	52	24	89	3768	0	3933
21125	43	16	26	3912	0	3997
21126	53	10	17	3980	0	4060
21127	4020	14	25	111	0	4170
21128	118	17	21	4152	0	4308
21129	4223	15	31	127	0	4396
21130	110	4223	31	55	0	4419
21131	4522	91	18	61	0	4692
21132	4693	29	19	66	0	4807
21133	148	4816	22	45	0	5031
21134	4821	97	11	50	0	4979
21135	4833	27	21	44	0	4925
21136	4955	16	26	37	0	5034
21137	4939	13	22	31	0	5005
21138	158	18	4748	37	0	4961
21139	65	4671	101	40	0	4877
21140	75	93	32	4613	0	4813
21141	4624	35	16	116	0	4791
21142	128	15	4567	55	0	4765
21143	79	4449	87	39	0	4654
21144	53	84	21	4259	0	4417
21145	63	4386	17	81	0	4547
21146	60	88	13	4416	0	4577
21147	47	37	23	4454	0	4561
21148	60	20	4433	93	0	4606
21149	54	15	4339	37	0	4445
21150	4048	22	94	32	0	4196
21151	105	13	4287	23	0	4428
21152	63	16	4278	25	0	4382
21153	52	28	95	4136	0	4311
21154	42	26	36	4147	0	4251
21155	41	4164	26	105	0	4336
21156	29	4501	26	43	0	4599
21157	37	109	4575	30	0	4751
21158	49	61	118	4605	0	4833
21159	34	22	4552	111	0	4719
21160	22	14	4175	44	0	4255
21161	21	4145	109	28	0	4303
21162	24	78	42	4027	0	4171
21163	4036	29	28	81	0	4174
21164	79	20	12	4037	0	4148
21165	4058	11	18	90	0	4177
21166	4029	12	14	37	0	4092
21167	4008	10	11	33	0	4062
21168	110	11	3931	15	0	4067
21169	3930	12	80	22	0	4044
21170	100	9	32	4084	0	4225
21171	4148	6	20	95	0	4269
21172	4194	7	25	38	0	4264
21173	107	4117	17	25	0	4266
21174	4110	77	20	19	0	4226
21175	98	23	4124	13	0	4258
21176	3988	16	85	22	0	4111
21177	4080	10	27	23	0	4140
21178	101	4125	19	16	0	4261
21179	4092	81	9	20	0	4202
21180	98	24	11	3921	0	4054
21181	38	19	15	3879	0	3951
21182	30	3848	20	84	0	3982
21183	29	66	19	3942	0	4056
21184	18	28	19	3993	0	4058
21185	26	20	3898	100	0	4044
21186	24	15	3812	44	0	3895
21187	3703	12	89	34	0	3838
21188	3927	12	37	24	0	4000
21189	111	10	26	3889	0	4036
21190	62	7	3876	84	0	4029
21191	36	3882	87	33	0	4038
21192	38	76	30	3877	0	4021
21193	30	27	3891	92	0	4040
21194	3647	18	86	47	0	3798
21195	103	16	29	3905	0	4053
21196	52	3982	24	92	0	4150
21197	40	89	16	4027	0	4172
21198	29	31	15	4120	0	4195
21199	28	21	28	4135	0	4212
21200	4061	15	27	127	0	4230
21201	117	15	21	4044	0	4197
21202	4123	18	17	122	0	4280
21203	4160	18	14	61	0	4253
21204	130	21	4052	51	0	4254
21205	65	4068	99	45	0	4277
21206	67	99	40	3731	0	3937
21207	38	4216	32	88	0	4374
21208	4297	110	33	41	0	4481
21209	129	50	25	4294	0	4498
21210	59	29	4263	133	0	4484
21211	57	22	4148	51	0	4278
21212	42	22	4199	51	0	4314
21213	4118	28	137	42	0	4325
21214	130	4215	54	39	0	4438
21215	4228	103	38	41	0	4410
21216	131	4272	40	29	0	4472
21217	72	118	39	4247	0	4476
21218	62	43	32	4202	0	4339
21219	45	4252	28	130	0	4455
21220	46	117	4236	64	0	4463
21221	33	4304	114	49	0	4500
21222	4225	131	38	45	0	4439
21223	130	44	32	4115	0	4321
21224	51	37	4050	132	0	4270
21225	49	34	4067	55	0	4205
21226	47	33	140	3998	0	4218
21227	49	28	3939	116	0	4132
21228	39	20	3713	58	0	3830
21229	3470	22	135	44	0	3671
21230	110	3578	58	26	0	3772
21231	3303	95	34	30	0	3462
21232	112	32	3319	38	0	3501
21233	47	3094	111	27	0	3279
21234	35	3211	52	19	0	3317
21235	37	121	89	3073	0	3320
21236	27	41	34	3165	0	3267
21237	25	26	23	3269	0	3343
21238	20	21	3192	133	0	3366
21239	23	27	100	3229	0	3379
21240	21	23	30	3332	0	3406
21241	3245	15	33	150	0	3443
21242	102	3238	19	76	0	3435
21243	39	94	21	3339	0	3493
21244	3304	39	23	124	0	3490
21245	3315	35	11	55	0	3416
21246	142	17	15	3268	0	3442
21247	59	24	3221	122	0	3426
21248	42	21	107	3273	0	3443
21249	27	16	3243	141	0	3427
21250	3252	19	120	53	0	3444
21251	3665	12	39	45	0	3761
21252	137	16	44	3757	0	3954
21253	60	20	3784	139	0	4003
21254	37	3891	147	63	0	4138
21255	37	140	3982	34	0	4193
21256	47	88	158	3409	0	3702
21257	21	3674	47	135	0	3877
21258	3524	122	25	30	0	3701
21259	130	35	18	3389	0	3572
21260	33	3473	15	121	0	3642
21261	3550	126	16	35	0	3727
21262	129	36	13	3487	0	3665
21263	33	3510	16	128	0	3687
21264	33	128	17	3547	0	3725
21265	37	31	3491	141	0	3700
21266	3396	31	127	54	0	3608
21267	3506	22	33	35	0	3596
21268	152	18	3343	29	0	3542
21269	44	3315	126	30	0	3515
21270	3377	120	46	28	0	3571
21271	137	35	28	3327	0	3527
21272	50	25	29	3341	0	3445
21273	37	16	31	3411	0	3495
21274	24	28	20	3427	0	3499
21275	30	18	23	3419	0	3490
21276	3265	21	16	174	0	3476
21277	3391	15	13	76	0	3495
21278	159	17	14	3301	0	3491
21279	57	16	17	3394	0	3484
21280	36	17	3243	169	0	3465
21281	41	13	3260	74	0	3388
21282	3194	12	136	64	0	3406
21283	138	26	50	3193	0	3407
21284	44	11	3158	160	0	3373
21285	32	17	140	3200	0	3389
21286	3166	14	44	167	0	3391
21287	3330	12	39	52	0	3433
21288	163	16	27	3217	0	3423
21289	53	19	30	3302	0	3404
21290	3230	11	17	185	0	3443
21291	146	11	33	3157	0	3347
21292	58	3162	15	165	0	3400
21293	46	118	24	3218	0	3406
21294	46	31	13	3301	0	3391
21295	47	25	3102	164	0	3338
21296	35	14	3019	67	0	3135
21297	32	3029	125	54	0	3240
21298	2942	119	43	49	0	3153
21299	2938	34	35	42	0	3049
21300	3014	16	32	38	0	3100
21301	144	2841	27	39	0	3051
21302	58	2945	24	30	0	3057
21303	2809	120	18	41	0	2988
21304	126	2867	15	39	0	3047
21305	52	126	2796	34	0	3008
21306	42	2799	108	40	0	2989
21307	23	135	2757	37	0	2952
21308	2648	29	114	45	0	2836
21309	2759	30	31	40	0	2860
21310	126	2683	38	27	0	2874
21311	2794	118	13	41	0	2966
21312	3088	36	21	37	0	3182
21313	3154	31	19	41	0	3245
21314	179	15	20	3058	0	3272
21315	3103	29	22	141	0	3295
21316	183	19	2956	46	0	3204
21317	3039	24	115	63	0	3241
21318	182	16	39	3061	0	3298
21319	70	17	2997	148	0	3232
21320	75	18	3098	59	0	3250
21321	50	22	141	3084	0	3297
21322	49	23	54	3212	0	3338
21323	3137	10	46	172	0	3365
21324	149	26	31	3128	0	3334
21325	53	11	3079	183	0	3326
21326	56	22	118	3026	0	3222
21327	46	3158	38	176	0	3418
21328	3233	112	37	69	0	3451
21329	142	24	28	3248	0	3442
21330	51	42	3179	152	0	3424
21331	66	3174	115	61	0	3416
21332	3075	109	36	64	0	3284
21333	136	24	37	3103	0	3300
21334	49	28	3064	137	0	3278
21335	60	3028	111	50	0	3249
21336	3044	104	49	62	0	3259
21337	3023	23	40	40	0	3126
21338	3069	28	23	46	0	3166
21339	147	22	34	2949	0	3152
21340	75	17	20	3056	0	3168
21341	2968	10	18	145	0	3141
21342	130	2894	18	64	0	3106
21343	2975	92	16	57	0	3140
21344	133	28	15	2979	0	3155
21345	3023	35	21	111	0	3190
21346	139	15	11	3022	0	3187
21347	58	23	15	3061	0	3157
21348	76	11	15	3069	0	3171
21349	52	18	16	3123	0	3209
21350	42	14	2873	147	0	3076
21351	32	13	2556	59	0	2660
21352	2229	11	63	39	0	2342
21353	71	11	2423	25	0	2530
21354	17	7	2138	21	0	2183
21355	2059	5	63	14	0	2141
21356	2182	1	35	12	0	2230
21357	57	3	23	2350	0	2433
21358	2384	3	19	39	0	2445
21359	59	2418	10	15	0	2502
21360	2535	31	8	28	0	2602
21361	2498	12	9	11	0	2530
21362	2629	18	5	20	0	2672
21363	60	14	3	2613	0	2690
21364	39	2526	5	36	0	2606
21365	34	2610	3	19	0	2666
21366	2641	40	7	23	0	2711
21367	2700	25	5	12	0	2742
21368	48	20	5	2656	0	2729
21369	33	11	7	2632	0	2683
21370	30	2613	9	33	0	2685
21371	2637	32	5	25	0	2699
21372	45	12	2671	22	0	2750
21373	25	19	28	2597	0	2669
21374	29	6	13	2696	0	2744
21375	15	7	2717	45	0	2784
21376	18	4	31	2646	0	2699
21377	21	2082	28	56	0	2187
21378	14	29	16	2755	0	2814
21379	18	11	7	2745	0	2781
21380	12	2495	7	50	0	2564
21381	14	2728	2	34	0	2778
21382	12	35	2	2802	0	2851
21383	2825	21	8	47	0	2901
21384	33	21	5	2832	0	2891
21385	18	9	7	2854	0	2888
21386	23	2915	10	48	0	2996
21387	12	29	12	3059	0	3112
21388	17	11	9	3034	0	3071
21389	10	16	12	3045	0	3083
21390	3071	7	6	68	0	3152
21391	43	6	3	3095	0	3147
21392	21	5	7	3073	0	3106
21393	21	14	4	3065	0	3104
21394	22	5	2990	51	0	3068
21395	2689	7	26	48	0	2770
21396	42	2995	15	32	0	3084
21397	3109	29	17	14	0	3169
21398	49	14	4	3098	0	3165
21399	22	16	3004	39	0	3081
21400	2830	12	28	18	0	2888
21401	50	12	3614	26	0	3702
21402	29	6	40	3651	0	3726
21403	3887	8	15	45	0	3955
21404	3844	6	18	22	0	3890
21405	3989	6	8	29	0	4032
21406	54	6	6	4007	0	4073
21407	39	3	4	4089	0	4135
21408	29	9	8	4107	0	4153
21409	12	3891	6	61	0	3970
21410	12	3916	4	37	0	3969
21411	7	3869	8	31	0	3915
21412	2	3821	3	7	0	3833
21413	9	13	8	4002	0	4032
21414	5	3	4	4017	0	4029
21415	4026	2	1	20	0	4049
21416	3935	4	2	4	0	3945
21417	3987	2	1	14	0	4004
21418	19	0	1	4040	0	4060
21419	9	3	2	4107	0	4121
21420	4035	1	1	20	0	4057
21421	3931	1	3	13	0	3948
21422	18	2	3933	10	0	3963
21423	8	6	3747	12	0	3773
21424	7	4	3817	12	0	3840
21425	4	4	4077	3	0	4088
21426	4	3	13	4088	0	4108
21427	4119	3	2	16	0	4140
21428	19	4049	7	11	0	4086
21429	6	16	2	4245	0	4269
21430	9	5	4255	16	0	4285
21431	1	4414	13	10	0	4438
21432	4	13	1	4618	0	4636
21433	3	3	4625	19	0	4650
21434	9	2	12	4507	0	4530
21435	4	2	1	4655	0	4662
21436	4772	0	4	22	0	4798
21437	15	0	3	4768	0	4786
21438	3	2	4834	16	0	4855
21439	13	0	12	4736	0	4761
21440	2	5186	5	15	0	5208
21441	7	14	3	5562	0	5586
21442	6	2	0	5607	0	5615
21443	3	3	6	5559	0	5571
21444	5695	0	2	31	0	5728
21445	5690	1	8	14	0	5713
21446	5752	1	3	17	0	5773
21447	5778	1	1	17	0	5797
21448	19	3	5699	6	0	5727
21449	5536	2	13	12	0	5563
21450	5786	1	1	14	0	5802
21451	18	2	5718	6	0	5744
21452	6	3	5960	4	0	5973
21453	3	2	11	6079	0	6095
21454	1	6173	2	12	0	6188
21455	6334	12	3	9	0	6358
21456	6504	1	0	20	0	6525
21457	6489	2	0	16	0	6507
21458	18	0	0	6436	0	6454
21459	4	6720	2	13	0	6739
21460	7002	13	4	24	0	7043
21461	7064	2	0	11	0	7077
21462	16	3	0	7023	0	7042
21463	6	1	6904	17	0	6928
21464	6860	3	15	16	0	6894
21465	16	0	3	7189	0	7208
21466	7305	0	4	23	0	7332
21467	20	0	1	7353	0	7374
21468	6	1	7302	23	0	7332
21469	7661	1	15	22	0	7699
21470	20	0	3	7936	0	7959
21471	6	2	2	7947	0	7957
21472	7	1	1	8021	0	8030
21473	6	0	1	7958	0	7965
21474	8044	0	1	28	0	8073
21475	17	1	1	8011	0	8030
21476	24	7908	1	24	0	7957
21477	4	24	1	8149	0	8178
21478	2	8161	2	24	0	8189
21479	5	24	0	8369	0	8398
21480	4	5	1	8396	0	8406
21481	2	8291	0	29	0	8322
21482	1	25	1	8469	0	8496
21483	2	4	3	8394	0	8403
21484	8360	4	0	47	0	8411
21485	29	3	8503	11	0	8546
21486	11	0	33	8538	0	8582
21487	8656	0	6	44	0	8706
21488	8608	1	3	12	0	8624
21489	8636	0	1	16	0	8653
21490	53	3	8552	5	0	8613
21491	21	3	8625	7	0	8656
21492	13	15	54	8810	0	8892
21493	9095	4	16	56	0	9171
21494	48	3	8924	11	0	8986
21495	8599	2	46	22	0	8669
21496	55	8965	9	14	0	9043
21497	11	46	8	9460	0	9525
21498	17	7	3	9633	0	9660
21499	9793	7	5	68	0	9873
21500	46	1	10	9826	0	9883
21501	9410	2	2	66	0	9480
21502	9528	2	4	31	0	9565
21503	59	0	2	9445	0	9506
21504	20	1	3	9476	0	9500
21505	9429	0	1	72	0	9502
21506	59	3	9756	18	0	9836
21507	9534	1	48	37	0	9620
21508	57	4	10179	8	0	10248
21509	10127	1	50	30	0	10208
21510	10745	1	9	32	0	10787
21511	10644	1	9	18	0	10672
21512	10461	0	4	18	0	10483
21513	72	10377	2	10	0	10461
21514	10667	47	6	12	0	10732
21515	10708	8	5	13	0	10734
21516	67	10989	5	12	0	11073
21517	11117	49	8	20	0	11194
21518	68	13	10938	9	0	11028
21519	10739	10	52	21	0	10822
21520	85	11	11055	3	0	11154
21521	27	3	68	11044	0	11142
21522	35	1	21	11116	0	11173
21523	17	5	11052	71	0	11145
21524	20	4	61	10978	0	11063
21525	188	88	230	6351	0	6857
21526	11545	6	17	111	0	11679
21527	89	4	4	11629	0	11726
21528	38	7	14	11618	0	11677
21529	32	2	9	11681	0	11724
21530	16	11397	9	123	0	11545
21531	28	74	7	11485	0	11594
21532	11518	22	8	118	0	11666
21533	91	16	11538	47	0	11692
21534	49	4	96	11641	0	11790
21535	28	9	11677	127	0	11841
21536	11368	2	119	62	0	11551
21537	127	4	42	12153	0	12326
21538	55	12	14775	146	0	14988
21539	43	3	306	14806	0	15158
21540	46	9	157	14629	0	14841
21541	22	14434	140	469	0	15065
21542	27	297	70	15089	0	15483
21543	24	156	37	15994	0	16211
21544	36	117	15508	599	0	16260
21545	35	73	348	15572	0	16028
21546	32	31	193	15976	0	16232
21547	15250	17	147	639	0	16053
21548	15243	12	88	393	0	15736
21549	496	15245	64	267	0	16072
21550	15629	336	46	196	0	16207
21551	15669	186	61	160	0	16076
21552	592	15776	71	156	0	16595
21553	346	420	43	15794	0	16603
21554	15886	224	42	497	0	16649
21555	15997	160	35	307	0	16499
21556	15733	110	33	254	0	16130
21557	716	15176	54	174	0	16120
21558	472	385	15602	138	0	16597
21559	15641	224	381	163	0	16409
21560	16025	189	191	145	0	16550
21561	703	15847	150	138	0	16838
21562	16068	475	92	136	0	16771
21563	16518	233	67	120	0	16938
21564	826	183	61	15891	0	16961
21565	470	166	15951	513	0	17100
21566	383	98	457	16227	0	17165
21567	325	64	211	16471	0	17071
21568	254	102	170	16616	0	17142
21569	217	107	15675	813	0	16812
21570	235	69	496	15293	0	16093
21571	208	71	254	16098	0	16631
21572	184	65	191	16299	0	16739
21573	163	60	138	16360	0	16721
21574	174	54	90	16339	0	16657
21575	161	15659	84	1005	0	16909
21576	157	460	75	16249	0	16941
21577	109	226	107	17016	0	17458
21578	124	164	16135	928	0	17351
21579	132	98	491	17710	0	18431
21580	120	81	226	18230	0	18657
21581	111	78	192	18992	0	19373
21582	135	62	150	19470	0	19817
21583	18657	79	105	1310	0	20151
21584	614	70	88	19517	0	20289
21585	345	80	93	19679	0	20197
21586	278	78	18248	1233	0	19837
21587	210	17350	579	860	0	18999
21588	121	18700	327	658	0	19806
21589	18110	753	287	527	0	19677
21590	618	18448	170	512	0	19748
21591	367	777	122	18289	0	19555
21592	18030	410	118	974	0	19532
21593	735	278	17946	688	0	19647
21594	388	223	617	18198	0	19426
21595	312	18208	336	963	0	19819
21596	272	673	235	18116	0	19296
21597	200	18354	183	1021	0	19758
21598	181	807	120	18571	0	19679
21599	18116	430	105	1060	0	19711
21600	770	338	18317	649	0	20074
21601	469	254	665	17671	0	19059
21602	373	18351	343	935	0	20002
21603	18312	776	266	593	0	19947
21604	780	442	18042	562	0	19826
21605	473	340	697	18142	0	19652
21606	398	248	17599	964	0	19209
21607	340	176	838	17663	0	19017
21608	261	190	17224	1091	0	18766
21609	216	184	906	17004	0	18310
21610	194	200	490	17441	0	18325
21611	16629	161	354	1257	0	18401
21612	17173	158	260	794	0	18385
21613	1044	160	215	16425	0	17844
21614	601	16416	206	1019	0	18242
21615	446	739	147	16921	0	18253
21616	315	378	192	17102	0	17987
21617	15902	266	181	1383	0	17732
21618	766	16062	178	924	0	17930
21619	16163	724	150	724	0	17761
21620	16336	420	168	583	0	17507
21621	1030	15274	148	572	0	17024
21622	617	16435	135	524	0	17711
21623	16096	911	134	597	0	17738
21624	896	516	15522	606	0	17540
21625	15735	386	688	556	0	17365
21626	15908	291	370	539	0	17108
21627	1165	15281	285	495	0	17226
21628	740	759	225	13854	0	15578
21629	514	15352	184	967	0	17017
21630	15168	915	207	654	0	16944
21631	15706	537	213	556	0	17012
21632	1113	430	196	15051	0	16790
21633	730	371	160	15549	0	16810
21634	14487	346	140	1177	0	16150
21635	901	14401	131	856	0	16289
21636	630	14232	129	672	0	15663
21637	518	14188	164	501	0	15371
21638	264	11026	87	319	0	11696
21639	246	11460	89	323	0	12118
21640	286	707	128	10958	0	12079
21641	203	384	10540	638	0	11765
21642	206	10634	403	401	0	11644
21643	9855	535	173	273	0	10836
21644	477	307	142	9821	0	10747
21645	9778	250	111	528	0	10667
21646	520	9754	112	322	0	10708
21647	9765	463	152	271	0	10651
21648	552	9780	171	235	0	10738
21649	315	506	159	9815	0	10795
21650	9782	282	158	513	0	10735
21651	10074	198	142	366	0	10780
21652	573	178	137	9910	0	10798
21653	348	156	136	9957	0	10597
21654	268	9658	110	674	0	10710
21655	264	447	106	9881	0	10698
21656	270	245	74	10082	0	10671
21657	261	234	67	9896	0	10458
21658	241	9198	44	726	0	10209
21659	8608	413	50	423	0	9494
21660	423	8777	53	343	0	9596
21661	8633	481	54	256	0	9424
21662	487	8664	63	250	0	9464
21663	315	474	8304	244	0	9337
21664	310	318	323	8340	0	9291
21665	253	261	8143	415	0	9072
21666	244	205	8140	231	0	8820
21667	256	212	439	8027	0	8934
21668	252	182	8092	394	0	8920
21669	260	166	413	7914	0	8753
21670	268	146	229	8107	0	8750
21671	199	172	177	8352	0	8900
21672	7989	134	129	599	0	8851
21673	470	150	111	8046	0	8777
21674	322	149	81	8167	0	8719
21675	7600	124	59	598	0	8381
21676	434	7295	49	399	0	8177
21677	294	6910	40	306	0	7550
21678	285	7194	30	246	0	7755
21679	175	534	39	5422	0	6170
21680	129	147	5334	308	0	5918
21681	4396	169	222	164	0	4951
21682	206	4533	60	101	0	4900
21683	4113	183	37	73	0	4406
21684	4155	91	26	53	0	4325
21685	4161	70	19	49	0	4299
21686	201	77	4057	36	0	4371
21687	109	94	115	4066	0	4384
21688	102	64	46	4195	0	4407
21689	89	52	40	4211	0	4392
21690	86	45	35	4070	0	4236
21691	85	3949	30	168	0	4232
21692	3987	134	20	99	0	4240
21693	151	65	3720	70	0	4006
21694	3438	41	89	59	0	3627
21695	134	91	37	3293	0	3555
21696	78	3210	17	129	0	3434
21697	52	3379	9	85	0	3525
21698	69	242	24	3003	0	3338
21699	44	3064	17	117	0	3242
21700	2610	51	9	43	0	2713
21701	58	32	2536	27	0	2653
21702	30	14	36	2378	0	2458
21703	14	11	18	2448	0	2491
21704	15	12	4	2496	0	2527
21705	13	11	7	2461	0	2492
21706	2452	13	5	54	0	2524
21707	38	2625	6	27	0	2696
21708	2899	45	6	17	0	2967
21709	54	22	6	2969	0	3051
21710	29	16	7	3031	0	3083
21711	17	3099	10	79	0	3205
21712	3152	62	7	45	0	3266
21713	3215	17	6	32	0	3270
21714	82	3172	9	24	0	3287
21715	32	61	10	2920	0	3023
21716	18	3059	7	61	0	3145
21717	3023	61	3	35	0	3122
21718	61	26	3045	23	0	3155
21719	27	18	2964	20	0	3029
21720	2839	9	73	15	0	2936
21721	61	2934	24	19	0	3038
21722	29	59	9	2953	0	3050
21723	13	22	8	2982	0	3025
21724	13	23	2952	74	0	3062
21725	15	17	54	2907	0	2993
21726	18	11	21	2960	0	3010
21727	17	2888	16	78	0	2999
21728	16	56	14	2917	0	3003
21729	12	27	15	2950	0	3004
21730	2865	17	7	89	0	2978
21731	63	2774	12	41	0	2890
21732	26	2852	13	25	0	2916
21733	16	71	13	2844	0	2944
21734	13	25	11	2910	0	2959
21735	7	18	5	2907	0	2937
21736	10	2811	5	103	0	2929
21737	8	59	5	2897	0	2969
21738	13	19	6	2877	0	2915
21739	14	22	3	2925	0	2964
21740	12	20	3	2890	0	2925
21741	11	2715	8	100	0	2834
21742	10	2923	3	46	0	2982
21743	2872	83	6	27	0	2988
21744	2931	37	5	28	0	3001
21745	93	18	6	2924	0	3041
21746	35	12	2975	92	0	3114
21747	20	19	65	3029	0	3133
21748	21	15	21	3074	0	3131
21749	2965	18	16	106	0	3105
21750	81	3035	7	44	0	3167
21751	45	82	5	3017	0	3149
21752	28	32	6	3089	0	3155
21753	19	24	2976	107	0	3126
21754	16	18	3024	55	0	3113
21755	19	13	92	3012	0	3136
21756	19	16	33	3004	0	3072
21757	18	2958	13	103	0	3092
21758	12	3076	14	53	0	3155
21759	3013	83	13	45	0	3154
21760	82	40	11	3033	0	3166
21761	35	24	3009	77	0	3145
21762	18	2962	63	52	0	3095
21763	25	71	23	3031	0	3150
21764	2995	37	20	89	0	3141
21765	66	21	12	3061	0	3160
21766	2999	14	11	97	0	3121
21767	71	3042	6	53	0	3172
21768	3004	67	7	48	0	3126
21769	73	44	7	3097	0	3221
21770	35	22	3200	88	0	3345
21771	17	22	74	3159	0	3272
21772	14	3327	43	96	0	3480
21773	18	97	19	3289	0	3423
21774	15	3457	7	114	0	3593
21775	16	116	5	3546	0	3683
21776	16	44	3429	140	0	3629
21777	19	33	3327	66	0	3445
21778	20	17	3428	61	0	3526
21779	3353	22	125	51	0	3551
21780	111	3396	51	32	0	3590
21781	46	3547	29	30	0	3652
21782	3432	129	11	41	0	3613
21783	3511	50	14	38	0	3613
21784	118	45	18	3446	0	3627
21785	63	24	3464	118	0	3669
21786	42	21	3338	57	0	3458
21787	25	15	124	3340	0	3504
21788	3325	26	63	126	0	3540
21789	106	3366	36	56	0	3564
21790	44	107	18	3424	0	3593
21791	3373	40	19	144	0	3576
21792	3398	30	25	73	0	3526
21793	120	27	3336	55	0	3538
21794	3184	21	99	63	0	3367
21795	121	30	3386	36	0	3573
21796	55	23	3455	43	0	3576
21797	43	22	123	3330	0	3518
21798	31	21	54	3414	0	3520
21799	28	25	36	3501	0	3590
21800	19	24	3371	166	0	3580
21801	3309	24	102	77	0	3512
21802	117	24	35	3529	0	3705
21803	3408	23	36	139	0	3606
21804	3477	31	19	73	0	3600
21805	133	3493	20	68	0	3714
21806	65	3610	22	57	0	3754
21807	30	3531	37	45	0	3643
21808	27	135	36	3166	0	3364
21809	18	45	3168	103	0	3334
21810	22	62	84	2976	0	3144
21811	28	3020	29	94	0	3171
21812	14	3076	19	37	0	3146
21813	19	96	17	2986	0	3118
21814	2882	37	13	83	0	3015
21815	85	2856	12	35	0	2988
21816	25	2895	21	34	0	2975
21817	2961	89	15	18	0	3083
21818	83	38	14	2952	0	3087
21819	32	34	11	2953	0	3030
21820	29	16	7	3013	0	3065
21821	2851	21	10	108	0	2990
21822	2923	13	6	63	0	3005
21823	104	10	15	2903	0	3032
21824	55	11	2794	83	0	2943
21825	2778	12	84	39	0	2913
21826	86	9	26	2882	0	3003
21827	37	10	2837	94	0	2978
21828	33	14	2807	48	0	2902
21829	22	19	90	2890	0	3021
21830	19	21	3111	103	0	3254
21831	28	14	103	3326	0	3471
21832	36	12	44	3221	0	3313
21833	23	9	28	3667	0	3727
21834	3538	18	21	177	0	3754
21835	134	17	13	3609	0	3773
21836	55	21	11	3703	0	3790
21837	37	23	21	3730	0	3811
21838	17	25	22	3743	0	3807
21839	25	25	3488	186	0	3724
21840	27	3457	120	85	0	3689
21841	22	106	41	3478	0	3647
21842	17	39	38	3440	0	3534
21843	17	3280	24	149	0	3470
21844	18	3467	25	75	0	3585
21845	3362	123	26	63	0	3574
21846	115	3294	18	52	0	3479
21847	43	130	13	3279	0	3465
21848	39	41	3352	137	0	3569
21849	3240	37	107	66	0	3450
21850	121	23	3249	66	0	3459
21851	3215	15	113	64	0	3407
21852	3326	15	39	50	0	3430
21853	141	21	3298	38	0	3498
21854	62	16	122	3107	0	3307
21855	49	3152	48	123	0	3372
21856	33	109	41	3435	0	3618
21857	3481	35	29	156	0	3701
21858	3603	35	32	62	0	3732
21859	149	3560	29	60	0	3798
21860	3622	122	33	59	0	3836
21861	149	40	19	3541	0	3749
21862	3521	32	26	157	0	3736
21863	3620	16	31	80	0	3747
21864	171	17	23	3547	0	3758
21865	3542	23	16	153	0	3734
21866	3440	21	22	84	0	3567
21867	157	15	3408	73	0	3653
21868	3346	18	112	71	0	3547
21869	141	27	3334	59	0	3561
21870	59	24	3170	43	0	3296
21871	46	3233	131	37	0	3447
21872	52	104	42	3046	0	3244
21873	31	28	3183	101	0	3343
21874	32	21	3095	42	0	3190
21875	3180	22	103	43	0	3348
21876	90	18	43	3250	0	3401
21877	44	21	23	3367	0	3455
21878	36	18	20	3398	0	3472
21879	33	12	19	3386	0	3450
21880	36	14	25	3430	0	3505
21881	36	11	3337	128	0	3512
21882	32	17	3298	63	0	3410
21883	38	9	100	3360	0	3507
21884	3324	14	39	115	0	3492
21885	93	3270	26	61	0	3450
21886	36	88	25	3319	0	3468
21887	3300	23	26	119	0	3468
21888	110	3286	33	46	0	3475
21889	55	83	21	3393	0	3552
21890	46	29	15	3478	0	3568
21891	36	20	14	3483	0	3553
21892	3387	15	21	138	0	3561
21893	103	12	3320	72	0	3507
21894	3349	12	89	57	0	3507
21895	104	12	40	3444	0	3600
21896	43	8	32	3383	0	3466
21897	34	3365	38	133	0	3570
21898	38	85	3374	67	0	3564
21899	3357	24	92	59	0	3532
21900	3500	19	46	49	0	3614
21901	119	21	3444	48	0	3632
21902	3245	20	81	53	0	3399
21903	98	3413	37	52	0	3600
21904	42	3448	29	47	0	3566
21905	39	3438	26	40	0	3543
21906	3314	100	21	40	0	3475
21907	106	38	3363	27	0	3534
21908	42	39	87	3221	0	3389
21909	36	3173	35	94	0	3338
21910	25	3235	15	49	0	3324
21911	19	3284	14	30	0	3347
21912	44	114	27	2505	0	2690
21913	3159	37	12	87	0	3295
21914	71	3201	19	43	0	3334
21915	44	77	7	3237	0	3365
21916	15	43	12	3295	0	3365
21917	3172	18	10	111	0	3311
21918	80	21	13	3197	0	3311
21919	52	15	12	3289	0	3368
21920	27	18	3244	103	0	3392
21921	27	13	68	3273	0	3381
21922	29	13	28	3413	0	3483
21923	3335	15	18	115	0	3483
21924	3373	13	19	47	0	3452
21925	111	7	7	3369	0	3494
21926	3214	10	12	97	0	3333
21927	3334	18	13	46	0	3411
21928	101	3314	16	31	0	3462
21929	56	65	3239	21	0	3381
21930	34	3083	66	16	0	3199
21931	46	87	39	2786	0	2958
21932	2729	22	17	30	0	2798
21933	35	2655	8	21	0	2719
21934	20	33	4	2697	0	2754
21935	2667	19	5	39	0	2730
21936	2638	10	6	22	0	2676
21937	41	15	4	2624	0	2684
21938	24	7	2692	45	0	2768
21939	15	6	22	2742	0	2785
21940	8	10	16	2801	0	2835
21941	9	6	2767	56	0	2838
21942	6	3	28	2739	0	2776
21943	14	0	18	2773	0	2805
21944	2878	5	10	53	0	2946
21945	31	3	7	2918	0	2959
21946	25	7	4	2885	0	2921
21947	2832	6	7	50	0	2895
21948	2745	5	5	36	0	2791
21949	2745	5	1	26	0	2777
21950	58	7	2701	9	0	2775
21951	32	9	26	2658	0	2725
21952	11	2678	18	44	0	2751
21953	21	30	4	2762	0	2817
21954	16	19	2784	38	0	2857
21955	21	9	30	2580	0	2640
21956	5	10	2695	30	0	2740
21957	2465	13	28	26	0	2532
21958	2554	2	22	7	0	2585
21959	33	3	5	2540	0	2581
21960	20	1	5	2560	0	2586
21961	9	3	3	2575	0	2590
21962	7	2627	2	36	0	2672
21963	2631	18	1	30	0	2680
21964	2669	15	4	11	0	2699
21965	34	6	4	2647	0	2691
21966	19	3	2	2609	0	2633
21967	10	2	4	2638	0	2654
21968	3	2	3	2627	0	2635
21969	8	1	2601	42	0	2652
21970	15	2	17	2606	0	2640
21971	2525	2	14	31	0	2572
21972	2516	2	5	24	0	2547
21973	38	0	5	2438	0	2481
21974	22	2	2366	25	0	2415
21975	2218	3	22	21	0	2264
21976	25	6	16	2338	0	2385
21977	16	2256	8	34	0	2314
21978	8	2425	4	14	0	2451
21979	2466	37	2	13	0	2518
21980	29	16	5	2505	0	2555
21981	23	8	2	2541	0	2574
21982	6	3	1	2721	0	2731
21983	7	3	3	2715	0	2728
21984	6	3	2	2862	0	2873
21985	6	2	2801	69	0	2878
21986	7	0	2732	39	0	2778
21987	4	2	2760	18	0	2784
21988	3	1	70	2752	0	2826
21989	4	3	2796	48	0	2851
21990	4	0	53	2741	0	2798
21991	6	2	31	2745	0	2784
21992	3	5	17	2897	0	2922
21993	2915	1	13	84	0	3013
21994	53	0	9	2923	0	2985
21995	33	0	12	2982	0	3027
21996	2904	1	14	89	0	3008
21997	51	2890	12	47	0	3000
21998	26	2984	7	29	0	3046
21999	2967	73	3	23	0	3066
22000	55	3035	7	15	0	3112
22001	2976	65	1	18	0	3060
22002	2990	28	1	20	0	3039
22003	2998	12	0	16	0	3026
22004	2920	8	0	14	0	2942
22005	2954	7	1	15	0	2977
22006	93	2893	1	10	0	2997
22007	2879	61	2	11	0	2953
22008	2931	35	4	5	0	2975
22009	96	2967	2	6	0	3071
22010	3285	67	4	12	0	3368
22011	3396	28	2	7	0	3433
22012	3733	18	2	17	0	3770
22013	3927	10	0	13	0	3950
22014	183	7	4103	6	0	4299
22015	76	9	130	4379	0	4594
22016	51	11	36	4577	0	4675
22017	27	15	4457	188	0	4687
22018	38	10	4387	71	0	4506
22019	4381	10	187	46	0	4624
22020	171	11	74	4508	0	4764
22021	73	9	4520	150	0	4752
22022	54	7	4494	51	0	4606
22023	4427	6	199	45	0	4677
22024	4597	6	77	26	0	4706
22025	4628	5	54	20	0	4707
22026	241	3	4491	25	0	4760
22027	110	8	164	4447	0	4729
22028	72	4	4494	168	0	4738
22029	4412	4	198	59	0	4673
22030	185	6	4563	50	0	4804
22031	74	8	188	4415	0	4685
22032	69	6	88	4375	0	4538
22033	45	4476	55	185	0	4761
22034	4563	146	45	81	0	4835
22035	186	42	4549	58	0	4835
22036	4558	28	189	32	0	4807
22037	220	13	4722	27	0	4982
22038	100	7	201	4560	0	4868
22039	74	7	87	4680	0	4848
22040	59	5	69	4765	0	4898
22041	4583	10	60	236	0	4889
22042	197	4	35	4541	0	4777
22043	94	9	41	4629	0	4773
22044	82	4410	35	214	0	4741
22045	62	146	38	4549	0	4795
22046	4459	46	44	228	0	4777
22047	206	32	4457	107	0	4802
22048	94	32	193	4450	0	4769
22049	90	8	4468	214	0	4780
22050	52	4289	221	111	0	4673
22051	54	158	4472	86	0	4770
22052	4364	45	216	82	0	4707
22053	4595	37	111	72	0	4815
22054	247	22	83	4444	0	4796
22055	4499	19	76	221	0	4815
22056	4591	17	59	115	0	4782
22057	254	15	82	4478	0	4829
22058	132	18	67	4659	0	4876
22059	120	20	4465	253	0	4858
22060	81	4420	213	140	0	4854
22061	4438	160	94	101	0	4793
22062	213	4371	96	69	0	4749
22063	128	179	58	4383	0	4748
22064	129	66	52	4507	0	4754
22065	92	50	58	4555	0	4755
22066	92	31	56	4584	0	4763
22067	65	30	4354	283	0	4732
22068	4246	30	187	161	0	4624
22069	4498	20	115	107	0	4740
22070	254	33	87	4369	0	4743
22071	4434	24	71	236	0	4765
22072	259	34	51	4443	0	4787
22073	140	37	4343	262	0	4782
22074	106	27	206	4303	0	4642
22075	100	4257	95	259	0	4711
22076	91	155	74	4198	0	4518
22077	78	4270	57	264	0	4669
22078	72	175	57	4084	0	4388
22079	72	4182	55	255	0	4564
22080	4079	196	55	141	0	4471
22081	217	66	4055	135	0	4473
22082	112	3779	184	108	0	4183
22083	94	4017	84	97	0	4292
22084	77	168	93	3830	0	4168
22085	60	72	62	3887	0	4081
22086	83	53	57	3874	0	4067
22087	78	41	69	3916	0	4104
22088	72	3726	66	258	0	4122
22089	76	159	56	3845	0	4136
22090	58	65	43	3927	0	4093
22091	3747	48	53	233	0	4081
22092	191	43	42	3802	0	4078
22093	87	30	3648	231	0	3996
22094	75	41	3582	132	0	3830
22095	3461	39	170	106	0	3776
22096	156	3492	71	112	0	3831
22097	60	3571	50	111	0	3792
22098	75	160	51	3483	0	3769
22099	46	77	45	3550	0	3718
22100	46	63	3361	214	0	3684
22101	3230	51	147	118	0	3546
22102	3465	51	45	121	0	3682
22103	175	39	3463	96	0	3773
22104	82	22	3396	113	0	3613
22105	3373	17	151	104	0	3645
22106	3576	25	76	109	0	3786
22107	3587	30	62	78	0	3757
22108	3533	31	38	78	0	3680
22109	198	3316	40	79	0	3633
22110	3034	106	22	70	0	3232
22111	150	43	2852	61	0	3106
22112	59	30	2603	50	0	2742
22113	42	23	2612	33	0	2710
22114	53	236	94	1869	0	2252
22115	1861	3	54	28	0	1946
22116	1867	2	9	19	0	1897
22117	30	3	3	1866	0	1902
22118	24	2	7	1723	0	1756
22119	16	3	4	1874	0	1897
22120	8	1942	3	29	0	1982
22121	1980	20	4	16	0	2020
22122	1994	7	8	14	0	2023
22123	1999	5	13	8	0	2025
22124	2016	3	12	11	0	2042
22125	2015	5	5	13	0	2038
22126	36	4	2	1928	0	1970
22127	19	1904	3	24	0	1950
22128	16	20	3	1841	0	1880
22129	4	16	2	1872	0	1894
22130	1829	2	5	30	0	1866
22131	20	6	1794	13	0	1833
22132	16	7	1725	5	0	1753
22133	11	3	1771	8	0	1793
22134	1881	1	21	10	0	1913
22135	1958	0	14	8	0	1980
22136	28	3	2	1955	0	1988
22137	10	1	1	1894	0	1906
22138	4	7	1	1947	0	1959
22139	2	3	1948	27	0	1980
22140	5	2	14	1914	0	1935
22141	7	1	2078	21	0	2107
22142	5	2	20	2058	0	2085
22143	7	2	12	2094	0	2115
22144	0	0	12	2158	0	2170
22145	2146	3	5	24	0	2178
22146	2132	3	2	11	0	2148
22147	23	6	2115	11	0	2155
22148	2080	2	14	20	0	2116
22149	2147	2	8	19	0	2176
22150	23	0	7	2155	0	2185
22151	2191	2	4	21	0	2218
22152	19	0	3	2214	0	2236
22153	11	0	4	2240	0	2255
22154	8	1	2172	29	0	2210
22155	2022	1	17	17	0	2057
22156	20	0	8	2190	0	2218
22157	16	0	2234	18	0	2268
22158	7	0	2325	17	0	2349
22159	4	1	23	2301	0	2329
22160	7	1	11	2335	0	2354
22161	2424	0	2	25	0	2451
22162	14	0	7	2433	0	2454
22163	11	1	7	2429	0	2448
22164	4	1	4	2510	0	2519
22165	1	0	1	2663	0	2665
22166	2722	0	4	38	0	2764
22167	2751	0	2	16	0	2769
22168	2833	0	0	15	0	2848
22169	2903	0	4	9	0	2916
22170	41	0	7	2989	0	3037
22171	3024	1	1	35	0	3061
22172	40	0	1	3013	0	3054
22173	3068	0	1	36	0	3105
22174	43	0	1	3044	0	3088
22175	21	0	1	3014	0	3036
22176	7	3008	0	55	0	3070
22177	8	31	1	3060	0	3100
22178	3009	14	2	37	0	3062
22179	2959	1	2	23	0	2985
22180	48	2	2992	12	0	3054
22181	21	2980	33	10	0	3044
22182	2982	34	15	16	0	3047
22183	39	3055	2	11	0	3107
22184	3045	33	3	10	0	3091
22185	47	3207	9	7	0	3270
22186	17	37	3259	8	0	3321
22187	9	3239	33	9	0	3290
22188	6	3282	15	10	0	3313
22189	10	53	3	3365	0	3431
22190	3418	16	3	45	0	3482
22191	43	4	4	3417	0	3468
22192	24	6	5	3411	0	3446
22193	3355	9	1	60	0	3425
22194	3391	3	2	28	0	3424
22195	60	5	1	3420	0	3486
22196	27	3	3	3414	0	3447
22197	10	6	1	3438	0	3455
22198	3365	2	4	62	0	3433
22199	51	2	3362	28	0	3443
22200	33	3	35	3352	0	3423
22201	13	4	3441	48	0	3506
22202	9	3355	39	47	0	3450
22203	14	36	3333	15	0	3398
22204	10	16	38	3287	0	3351
22205	15	4	3349	44	0	3412
22206	3192	7	42	30	0	3271
22207	37	7	25	3370	0	3439
22208	21	3445	8	41	0	3515
22209	9	38	7	3470	0	3524
22210	15	3424	6	45	0	3490
22211	20	3411	10	30	0	3471
22212	10	3383	5	17	0	3415
22213	12	52	4	3201	0	3269
22214	15	3287	2	48	0	3352
22215	3255	45	4	20	0	3324
22216	47	21	3139	17	0	3224
22217	24	11	2997	19	0	3051
22218	16	11	3129	15	0	3171
22219	13	8	50	3222	0	3293
22220	13	9	18	3064	0	3104
22221	16	4	9	3070	0	3099
22222	20	3	9	3098	0	3130
22223	19	8	14	2918	0	2959
22224	17	3114	12	64	0	3207
22225	22	40	3088	38	0	3188
22226	28	18	2988	24	0	3058
22227	23	3199	52	29	0	3303
22228	21	38	17	3277	0	3353
22229	16	24	9	3317	0	3366
22230	20	15	11	3293	0	3339
22231	3278	15	10	68	0	3371
22232	45	18	3243	40	0	3346
22233	3155	11	48	27	0	3241
22234	3185	18	18	33	0	3254
22235	68	3107	8	30	0	3213
22236	30	3192	9	25	0	3256
22237	3198	57	14	21	0	3290
22238	70	23	11	3211	0	3315
22239	24	15	8	3350	0	3397
22240	27	18	3429	71	0	3545
22241	23	19	3308	33	0	3383
22242	18	17	67	3457	0	3559
22243	3486	20	25	70	0	3601
22244	67	19	3652	35	0	3773
22245	3729	18	75	33	0	3855
22246	74	19	33	3935	0	4061
22247	42	14	16	4162	0	4234
22248	10	14	21	4296	0	4341
22249	17	8	4257	117	0	4399
22250	20	4082	86	47	0	4235
22251	17	4402	25	39	0	4483
22252	4406	106	11	39	0	4562
22253	4523	24	11	37	0	4595
22254	121	12	9	4540	0	4682
22255	4521	14	13	123	0	4671
22256	112	18	4384	44	0	4558
22257	36	17	4379	30	0	4462
22258	28	16	120	4240	0	4404
22259	4362	12	42	127	0	4543
22260	112	14	23	4416	0	4565
22261	38	14	31	4561	0	4644
22262	4428	9	24	140	0	4601
22263	4541	7	29	57	0	4634
22264	126	4743	27	36	0	4932
22265	4705	104	26	20	0	4855
22266	127	35	16	4655	0	4833
22267	35	4664	11	134	0	4844
22268	4627	105	8	54	0	4794
22269	117	4688	18	29	0	4852
22270	36	120	7	4648	0	4811
22271	4628	37	13	113	0	4791
22272	122	14	4519	35	0	4690
22273	43	8	4536	26	0	4613
22274	28	18	114	4445	0	4605
22275	29	6	33	4603	0	4671
22276	18	12	17	4462	0	4509
22277	16	4609	17	122	0	4764
22278	4746	106	12	45	0	4909
22279	4756	39	10	32	0	4837
22280	4798	15	9	27	0	4849
22281	137	4974	8	29	0	5148
22282	52	117	10	5361	0	5540
22283	35	37	10	5468	0	5550
22284	25	22	10	5505	0	5562
22285	5092	12	13	191	0	5308
22286	138	5074	9	63	0	5284
22287	50	142	8	5109	0	5309
22288	31	46	6	5229	0	5312
22289	28	22	5015	192	0	5257
22290	31	4980	136	62	0	5209
22291	37	144	37	5003	0	5221
22292	30	44	18	5128	0	5220
22293	32	25	9	5126	0	5192
22294	4915	21	11	199	0	5146
22295	151	4927	8	85	0	5171
22296	4959	146	7	60	0	5172
22297	169	49	12	4933	0	5163
22298	4983	30	10	175	0	5198
22299	160	24	4876	70	0	5130
22300	4915	17	132	59	0	5123
22301	5039	19	33	54	0	5145
22302	188	30	4944	45	0	5207
22303	64	28	133	5020	0	5245
22304	53	16	45	4936	0	5050
22305	5150	25	23	212	0	5410
22306	168	17	21	5204	0	5410
22307	70	21	20	5214	0	5325
22308	43	15	25	5303	0	5386
22309	44	22	5100	208	0	5374
22310	4834	21	138	97	0	5090
22311	170	5228	44	65	0	5507
22312	75	148	21	5105	0	5349
22313	63	5138	18	190	0	5409
22314	46	5476	31	77	0	5630
22315	44	182	28	5421	0	5675
22316	42	52	5367	213	0	5674
22317	55	35	5423	94	0	5607
22318	51	29	183	5508	0	5771
22319	47	29	5457	215	0	5748
22320	5403	34	159	96	0	5692
22321	192	38	56	5632	0	5918
22322	83	27	30	5694	0	5834
22323	40	5658	33	232	0	5963
22324	44	166	37	5676	0	5923
22325	45	55	32	5639	0	5771
22326	33	5520	36	233	0	5822
22327	44	161	26	5636	0	5867
22328	35	61	26	5651	0	5773
22329	52	5521	35	232	0	5840
22330	5575	173	21	106	0	5875
22331	192	65	5522	82	0	5861
22332	87	36	5438	74	0	5635
22333	56	48	173	5443	0	5720
22334	42	49	58	5649	0	5798
22335	44	40	5470	253	0	5807
22336	38	42	5366	114	0	5560
22337	5100	33	178	92	0	5403
22338	175	5426	58	73	0	5732
22339	5335	172	47	85	0	5639
22340	174	51	5258	96	0	5579
22341	59	5247	170	88	0	5564
22342	44	160	62	5407	0	5673
22343	40	57	5465	211	0	5773
22344	24	31	5348	95	0	5498
22345	42	63	178	5431	0	5714
22346	44	30	5468	208	0	5750
22347	40	5313	152	85	0	5590
22348	40	168	65	5239	0	5512
22349	49	59	5237	178	0	5523
22350	37	5333	153	92	0	5615
22351	5279	150	78	64	0	5571
22352	164	56	5245	57	0	5522
22353	68	5258	164	64	0	5554
22354	59	154	72	5207	0	5492
22355	37	66	53	5507	0	5663
22356	5419	33	48	212	0	5712
22357	156	31	37	5371	0	5595
22358	78	23	41	5447	0	5589
22359	5220	30	49	217	0	5516
22360	153	35	28	5247	0	5463
22361	73	17	5126	205	0	5421
22362	35	51	155	5112	0	5353
22363	38	26	5141	201	0	5406
22364	33	18	4772	112	0	4935
22365	32	31	4912	61	0	5036
22366	43	36	167	4597	0	4843
22367	25	17	71	4872	0	4985
22368	4770	19	42	174	0	5005
22369	125	23	36	4632	0	4816
22370	55	4856	37	151	0	5099
22371	28	118	39	5071	0	5256
22372	30	43	48	5044	0	5165
22373	19	5011	48	171	0	5249
22374	4995	121	40	105	0	5261
22375	4973	55	38	68	0	5134
22376	145	4869	46	74	0	5134
22377	50	4889	38	59	0	5036
22378	51	209	35	4779	0	5074
22379	4843	61	33	130	0	5067
22380	120	40	4760	80	0	5000
22381	50	37	4377	57	0	4521
22382	3998	22	103	41	0	4164
22383	69	4254	46	29	0	4398
22384	48	81	24	4302	0	4455
22385	24	40	30	4206	0	4300
22386	17	24	24	4316	0	4381
22387	22	24	17	4321	0	4384
22388	21	4258	20	126	0	4425
22389	25	73	21	4379	0	4498
22390	4351	43	18	109	0	4521
22391	74	14	22	4429	0	4539
22392	45	18	23	4484	0	4570
22393	4470	21	20	126	0	4637
22394	4504	14	26	76	0	4620
22395	4583	14	17	53	0	4667
22396	4636	10	14	49	0	4709
22397	114	15	24	4558	0	4711
22398	4583	18	22	104	0	4727
22399	94	10	13	4581	0	4698
22400	4517	9	14	118	0	4658
22401	4518	16	19	63	0	4616
22402	124	11	21	4479	0	4635
22403	69	12	4534	99	0	4714
22404	4505	21	82	69	0	4677
22405	4645	16	39	50	0	4750
22406	4669	12	21	52	0	4754
22407	4677	18	15	41	0	4751
22408	133	7	23	4603	0	4766
22409	65	15	4542	99	0	4721
22410	41	14	4458	47	0	4560
22411	4324	18	96	49	0	4487
22412	4576	14	44	46	0	4680
22413	112	4479	26	39	0	4656
22414	56	4468	16	34	0	4574
22415	4568	75	17	42	0	4702
22416	90	45	20	4482	0	4637
22417	58	30	24	4613	0	4725
22418	4593	14	15	112	0	4734
22419	92	4652	21	60	0	4825
22420	4782	73	13	38	0	4906
22421	96	43	4662	35	0	4836
22422	4651	21	66	46	0	4784
22423	91	25	36	4734	0	4886
22424	56	17	4819	88	0	4980
22425	42	4835	68	54	0	4999
22426	46	61	37	4977	0	5121
22427	46	26	5119	79	0	5270
22428	42	21	70	5060	0	5193
22429	5229	13	33	97	0	5372
22430	82	14	5176	58	0	5330
22431	4963	9	79	47	0	5098
22432	97	5224	35	39	0	5395
22433	61	63	21	5345	0	5490
22434	49	37	5606	75	0	5767
22435	40	16	77	5488	0	5621
22436	40	10	5730	88	0	5868
22437	29	5610	85	63	0	5787
22438	5591	62	36	44	0	5733
22439	70	5847	25	28	0	5970
22440	49	74	18	5795	0	5936
22441	35	33	26	5808	0	5902
22442	22	23	5600	105	0	5750
22443	4692	17	69	68	0	4846
22444	80	5319	34	34	0	5467
22445	33	4941	14	15	0	5003
22446	18	5088	10	20	0	5136
22447	22	79	16	4951	0	5068
22448	12	4979	16	44	0	5051
22449	24	63	14	4889	0	4990
22450	15	4867	18	54	0	4954
22451	14	61	12	4758	0	4845
22452	10	4894	5	33	0	4942
22453	4874	37	4	24	0	4939
22454	32	22	4832	14	0	4900
22455	4587	11	33	19	0	4650
22456	4796	7	12	19	0	4834
22457	4906	10	6	13	0	4935
22458	32	4925	6	9	0	4972
22459	5013	34	9	9	0	5065
22460	5015	16	3	9	0	5043
22461	5043	9	2	14	0	5068
22462	44	12	5007	6	0	5069
22463	18	9	29	4939	0	4995
22464	17	11	5100	35	0	5163
22465	12	11	34	4933	0	4990
22466	4978	13	13	42	0	5046
22467	42	4966	5	21	0	5034
22468	19	39	5523	9	0	5590
22469	19	20	75	5527	0	5641
22470	16	6	19	5918	0	5959
22471	16	8	6464	108	0	6596
22472	6215	11	125	26	0	6377
22473	6659	7	22	15	0	6703
22474	6820	7	17	9	0	6853
22475	170	8	11	6669	0	6858
22476	48	6400	14	134	0	6596
22477	20	6865	8	45	0	6938
22478	20	156	12	6830	0	7018
22479	21	32	11	6763	0	6827
22480	20	6729	10	155	0	6914
22481	6791	146	9	37	0	6983
22482	144	6775	16	38	0	6973
22483	37	136	12	6701	0	6886
22484	28	38	6602	148	0	6816
22485	17	20	144	6502	0	6683
22486	6643	19	33	159	0	6854
22487	155	20	6628	44	0	6847
22488	6630	20	142	26	0	6818
22489	6931	13	31	40	0	7015
22490	6958	28	19	25	0	7030
22491	6953	24	13	27	0	7017
22492	7160	18	14	30	0	7222
22493	208	13	6793	26	0	7040
22494	73	24	6717	28	0	6842
22495	7245	9	172	25	0	7451
22496	7651	17	44	23	0	7735
22497	230	17	18	7955	0	8220
22498	72	8046	26	177	0	8321
22499	50	190	15	8283	0	8538
22500	8456	52	9	223	0	8740
22501	225	31	24	8080	0	8360
22502	87	8502	15	205	0	8809
22503	8512	203	15	67	0	8797
22504	8341	61	17	52	0	8471
22505	8441	36	12	42	0	8531
22506	281	8280	13	37	0	8611
22507	102	207	18	8325	0	8652
22508	74	60	20	8312	0	8466
22509	65	8014	15	247	0	8341
22510	64	199	16	8240	0	8519
22511	8176	62	7	243	0	8488
22512	8245	47	8	83	0	8383
22513	283	8070	14	52	0	8419
22514	115	216	7	8139	0	8477
22515	75	64	18	8297	0	8454
22516	63	46	21	8344	0	8474
22517	8028	41	16	299	0	8384
22518	264	30	7799	113	0	8206
22519	7593	31	196	89	0	7909
22520	272	40	7795	62	0	8169
22521	113	41	202	7510	0	7866
22522	87	7486	62	242	0	7877
22523	80	7940	34	109	0	8163
22524	7667	279	26	94	0	8066
22525	7654	92	27	99	0	7872
22526	304	7428	32	90	0	7854
22527	112	7548	21	85	0	7766
22528	7565	271	18	69	0	7923
22529	7838	110	20	102	0	8070
22530	297	7894	21	74	0	8286
22531	8055	270	25	69	0	8419
22532	337	98	7912	53	0	8400
22533	7971	71	217	58	0	8317
22534	8010	80	72	63	0	8225
22535	337	65	52	7766	0	8220
22536	159	7734	28	277	0	8198
22537	146	266	21	7768	0	8201
22538	7891	104	20	299	0	8314
22539	333	72	26	7620	0	8051
22540	174	63	29	7859	0	8125
22541	133	67	7689	318	0	8207
22542	123	47	234	7803	0	8207
22543	118	42	72	8073	0	8305
22544	7914	54	50	351	0	8369
22545	312	54	7821	149	0	8336
22546	7819	56	262	118	0	8255
22547	336	38	81	7928	0	8383
22548	149	50	61	8098	0	8358
22549	100	64	42	7988	0	8194
22550	104	7607	28	338	0	8077
22551	120	7919	34	147	0	8220
22552	134	283	28	7722	0	8167
22553	7748	110	31	304	0	8193
22554	7893	91	38	122	0	8144
22555	357	67	40	7714	0	8178
22556	7766	48	33	320	0	8167
22557	366	62	28	7719	0	8175
22558	147	82	28	7948	0	8205
22559	7418	67	24	353	0	7862
22560	338	7745	39	147	0	8269
22561	7768	266	20	130	0	8184
22562	7802	91	16	136	0	8045
22563	7690	68	21	131	0	7910
22564	348	7543	21	107	0	8019
22565	164	285	21	7626	0	8096
22566	151	88	33	7863	0	8135
22567	129	41	7429	372	0	7971
22568	121	81	213	6980	0	7395
22569	106	35	6660	294	0	7095
22570	91	6198	187	131	0	6607
22571	74	5526	56	104	0	5760
22572	88	5667	38	77	0	5870
22573	84	211	68	5634	0	5997
22574	73	72	23	5741	0	5909
22575	53	48	24	5784	0	5909
22576	47	46	19	5854	0	5966
22577	36	48	5766	238	0	6088
22578	32	66	7272	114	0	7484
22579	44	56	202	7609	0	7911
22580	42	40	7772	255	0	8109
22581	7743	26	212	123	0	8104
22582	8031	24	72	86	0	8213
22583	251	29	7875	117	0	8272
22584	103	40	219	7914	0	8276
22585	83	28	72	8153	0	8336
22586	70	26	43	8235	0	8374
22587	74	31	54	8059	0	8218
22588	80	31	35	8236	0	8382
22589	5656	115	72	355	0	6198
22590	7973	29	33	147	0	8182
22591	255	7853	28	152	0	8288
22592	102	197	7570	104	0	7973
22593	58	7440	200	107	0	7805
22594	61	7717	56	117	0	7951
22595	7188	206	44	78	0	7516
22596	172	7089	49	90	0	7400
22597	43	6685	17	44	0	6789
22598	6524	182	48	31	0	6785
22599	176	52	6370	23	0	6621
22600	6234	37	144	25	0	6440
22601	151	39	51	6361	0	6602
22602	51	17	17	6257	0	6342
22603	35	20	25	6324	0	6404
22604	36	14	6124	191	0	6365
22605	28	6118	143	85	0	6374
22606	6173	137	48	66	0	6424
22607	157	35	25	6221	0	6438
22608	46	6293	38	172	0	6549
22609	29	161	34	6504	0	6728
22610	49	48	6514	174	0	6785
22611	53	39	155	6522	0	6769
22612	28	38	50	6752	0	6868
22613	33	27	26	6799	0	6885
22614	6674	35	30	228	0	6967
22615	164	30	21	6702	0	6917
22616	56	18	6577	226	0	6877
22617	35	6597	165	111	0	6908
22618	60	161	45	6674	0	6940
22619	42	48	46	6817	0	6953
22620	34	37	6577	243	0	6891
22621	34	39	6491	92	0	6656
22622	6366	40	227	96	0	6729
22623	6384	43	75	85	0	6587
22624	215	6408	77	61	0	6761
22625	6495	170	47	80	0	6792
22626	196	59	6420	77	0	6752
22627	80	30	6348	95	0	6553
22628	6224	28	183	127	0	6562
22629	6108	31	68	149	0	6356
22630	186	20	5828	130	0	6164
22631	5707	25	163	133	0	6028
22632	201	33	5808	85	0	6127
22633	5771	37	173	52	0	6033
22634	5790	70	75	50	0	5985
22635	190	72	49	5494	0	5805
22636	82	5977	55	160	0	6274
22637	4308	229	59	112	0	4708
22638	151	93	5897	55	0	6196
22639	90	5903	168	70	0	6231
22640	5935	203	73	60	0	6271
22641	5770	77	43	69	0	5959
22642	211	5704	67	78	0	6060
22643	100	157	76	5757	0	6090
22644	80	52	5661	226	0	6019
22645	72	34	179	5724	0	6009
22646	72	56	5669	224	0	6021
22647	63	48	177	5702	0	5990
22648	52	44	110	5772	0	5978
22649	64	74	5585	216	0	5939
22650	76	5596	191	126	0	5989
22651	81	179	74	5554	0	5888
22652	92	112	3923	247	0	4374
22653	5510	47	141	129	0	5827
22654	183	58	70	5646	0	5957
22655	89	33	68	5793	0	5983
22656	5643	43	58	243	0	5987
22657	215	35	54	5559	0	5863
22658	125	34	54	5404	0	5617
22659	68	5479	76	226	0	5849
22660	87	162	67	5406	0	5722
22661	60	78	5362	227	0	5727
22662	69	35	185	5142	0	5431
22663	80	5170	92	199	0	5541
22664	64	5381	100	102	0	5647
22665	80	180	67	5318	0	5645
22666	5348	79	64	170	0	5661
22667	171	73	75	5317	0	5636
22668	5319	84	67	167	0	5637
22669	218	36	80	5335	0	5669
22670	5334	35	93	175	0	5637
22671	5480	34	73	124	0	5711
22672	263	85	67	5230	0	5645
22673	147	293	76	4969	0	5485
22674	123	4991	74	208	0	5396
22675	103	5193	67	115	0	5478
22676	114	137	5098	109	0	5458
22677	89	4897	141	104	0	5231
22678	3108	132	135	55	0	3430
22679	103	39	36	3028	0	3206
22680	42	2884	23	65	0	3014
22681	2967	63	23	40	0	3093
22682	82	34	16	2971	0	3103
22683	50	8	19	2932	0	3009
22684	42	10	21	2975	0	3048
22685	32	19	15	2975	0	3041
22686	22	2927	30	101	0	3080
22687	29	3111	15	60	0	3215
22688	3125	71	21	29	0	3246
22689	87	3165	18	30	0	3300
22690	27	80	21	3136	0	3264
22691	28	25	13	3187	0	3253
22692	26	20	16	3207	0	3269
22693	27	16	6	3241	0	3290
22694	3141	13	10	109	0	3273
22695	3209	5	13	46	0	3273
22696	100	18	3156	33	0	3307
22697	45	7	75	3189	0	3316
22698	29	9	3246	97	0	3381
22699	23	18	85	3254	0	3380
22700	19	15	31	3328	0	3393
22701	3232	16	20	119	0	3387
22702	87	20	13	3283	0	3403
22703	33	15	3254	101	0	3403
22704	31	15	3167	43	0	3256
22705	3200	18	88	42	0	3348
22706	86	11	3302	29	0	3428
22707	29	28	76	3110	0	3243
22708	21	5	3259	96	0	3381
22709	13	20	79	3091	0	3203
22710	14	3071	24	81	0	3190
22711	13	65	15	3061	0	3154
22712	11	2974	13	74	0	3072
22713	5	3010	10	27	0	3052
22714	7	66	23	2952	0	3048
22715	2955	23	9	69	0	3056
22716	61	2966	5	38	0	3070
22717	17	62	7	3010	0	3096
22718	3017	21	15	69	0	3122
22719	3079	12	9	33	0	3133
22720	3155	6	10	25	0	3196
22721	79	8	8	3090	0	3185
22722	29	8	9	3137	0	3183
22723	3135	3	8	91	0	3237
22724	3120	13	8	37	0	3178
22725	3158	10	4	30	0	3202
22726	75	15	7	3129	0	3226
22727	26	21	3000	63	0	3110
22728	3000	11	44	34	0	3089
22729	73	2	15	3040	0	3130
22730	27	3118	10	67	0	3222
22731	30	65	7	3076	0	3178
22732	21	3076	4	71	0	3172
22733	29	57	6	3170	0	3262
22734	19	13	3130	76	0	3238
22735	15	3085	55	42	0	3197
22736	9	49	15	2863	0	2936
22737	23	13	9	2869	0	2914
22738	24	7	7	2855	0	2893
22739	2928	8	12	70	0	3018
22740	59	2915	5	40	0	3019
22741	18	53	15	3006	0	3092
22742	3104	17	10	80	0	3211
22743	3126	12	6	34	0	3178
22744	96	14	3	3158	0	3271
22745	30	18	3224	96	0	3368
22746	27	13	79	3151	0	3270
22747	20	3174	27	92	0	3313
22748	28	69	15	3287	0	3399
22749	3244	21	20	102	0	3387
22750	83	14	16	3387	0	3500
22751	28	10	3434	105	0	3577
22752	15	3648	67	56	0	3786
22753	3733	84	21	31	0	3869
22754	98	34	3758	25	0	3915
22755	3767	25	82	33	0	3907
22756	95	12	34	3927	0	4068
22757	39	13	16	3982	0	4050
22758	38	3938	16	109	0	4101
22759	4157	88	21	65	0	4331
22760	103	34	12	4228	0	4377
22761	46	20	12	4285	0	4363
22762	37	17	8	4428	0	4490
22763	25	21	4343	137	0	4526
22764	24	4	88	4325	0	4441
22765	4412	10	37	137	0	4596
22766	4572	14	16	59	0	4661
22767	130	14	8	4521	0	4673
22768	62	8	21	4578	0	4669
22769	4519	5	11	150	0	4685
22770	116	12	4409	58	0	4595
22771	4333	10	93	54	0	4490
22772	117	14	4305	41	0	4477
22773	52	18	4364	26	0	4460
22774	42	10	117	4393	0	4562
22775	28	11	4497	116	0	4652
22776	4431	4	100	67	0	4602
22777	103	15	55	4581	0	4754
22778	41	13	4595	115	0	4764
22779	4415	10	90	71	0	4586
22780	4598	12	38	43	0	4691
22781	136	10	4644	46	0	4836
22782	64	50	96	4392	0	4602
22783	40	4666	43	90	0	4839
22784	4775	82	22	71	0	4950
22785	131	29	4782	36	0	4978
22786	4428	19	90	37	0	4574
22787	102	4730	38	33	0	4903
22788	4567	76	33	33	0	4709
22789	4571	24	17	31	0	4643
22790	4671	15	16	25	0	4727
22791	118	17	14	4599	0	4748
22792	45	4618	24	86	0	4773
22793	37	61	4542	43	0	4683
22794	39	4633	68	34	0	4774
22795	40	88	38	4193	0	4359
22796	19	4497	18	84	0	4618
22797	22	4629	14	44	0	4709
22798	4502	85	17	25	0	4629
22799	77	40	4437	24	0	4578
22800	43	17	4521	25	0	4606
22801	31	16	4493	22	0	4562
22802	23	4600	80	19	0	4722
22803	4607	59	41	24	0	4731
22804	4608	27	21	23	0	4679
22805	4563	13	15	31	0	4622
22806	86	4511	15	23	0	4635
22807	39	60	12	4684	0	4795
22808	36	24	4498	72	0	4630
22809	29	14	4317	40	0	4400
22810	4506	10	77	37	0	4630
22811	4699	12	33	32	0	4776
22812	4713	8	21	30	0	4772
22813	92	8	4603	27	0	4730
22814	4579	7	65	35	0	4686
22815	84	8	35	4635	0	4762
22816	56	12	20	4690	0	4778
22817	46	10	4930	90	0	5076
22818	34	4898	78	46	0	5056
22819	38	53	38	4990	0	5119
22820	30	27	4920	85	0	5062
22821	4690	10	75	61	0	4836
22822	79	8	40	5015	0	5142
22823	49	6	33	5029	0	5117
22824	5037	6	25	102	0	5170
22825	92	7	28	5035	0	5162
22826	5054	10	22	89	0	5175
22827	5056	3	28	67	0	5154
22828	98	12	23	5019	0	5152
22829	71	11	27	5035	0	5144
22830	5001	12	25	108	0	5146
22831	96	9	32	5054	0	5191
22832	5125	13	33	91	0	5262
22833	5082	9	33	50	0	5174
22834	5073	15	29	47	0	5164
22835	133	11	21	4991	0	5156
22836	71	17	25	5048	0	5161
22837	5065	11	24	92	0	5192
22838	90	4903	26	48	0	5067
22839	47	4845	28	21	0	4941
22840	4853	62	34	20	0	4969
22841	71	25	4748	22	0	4866
22842	4637	11	45	19	0	4712
22843	69	14	21	4881	0	4985
22844	45	7	4812	49	0	4913
22845	4781	13	47	35	0	4876
22846	65	9	22	4908	0	5004
22847	36	16	15	4952	0	5019
22848	36	12	16	5057	0	5121
22849	33	14	7	5065	0	5119
22850	5037	11	14	54	0	5116
22851	54	4901	17	24	0	4996
22852	4582	25	11	10	0	4628
22853	33	20	4577	9	0	4639
22854	24	11	4305	7	0	4347
22855	16	4619	30	7	0	4672
22856	22	47	37	4569	0	4675
22857	14	11	4536	26	0	4587
22858	11	4142	25	24	0	4202
22859	5	10	4257	1	0	4273
22860	6	7	8	4181	0	4202
22861	4	2	4	4182	0	4192
22862	4297	1	2	15	0	4315
22863	13	0	2	4198	0	4213
22864	4236	1	0	17	0	4254
22865	12	0	4148	2	0	4162
22866	1	4190	10	5	0	4206
22867	2	9	3	4479	0	4493
22868	8	2	1	4782	0	4793
22869	3	2	4869	12	0	4886
22870	7	3	4422	7	0	4439
22871	4517	1	9	15	0	4542
22872	4962	0	3	8	0	4973
22873	10	2	0	4918	0	4930
22874	4	0	1	4865	0	4870
22875	4	4774	4	11	0	4793
22876	2	9	0	4944	0	4955
22877	4973	1	3	15	0	4992
22878	5016	0	2	12	0	5030
22879	12	5093	2	10	0	5117
22880	5152	18	2	6	0	5178
22881	5068	4	1	7	0	5080
22882	31	2	2	5403	0	5438
22883	7	5449	8	43	0	5507
22884	3	44	0	5529	0	5576
22885	6	9	2	5591	0	5608
22886	5	3	5465	54	0	5527
22887	5332	4	49	17	0	5402
22888	71	2	8	5932	0	6013
22889	15	2	4	6228	0	6249
22890	14	6927	1	101	0	7043
22891	7	140	2	7537	0	7686
22892	7615	32	5	180	0	7832
22893	8163	20	2	48	0	8233
22894	245	11	7930	34	0	8220
22895	76	11	7998	34	0	8119
22896	44	16	240	8172	0	8472
22897	32	17	63	8611	0	8723
22898	29	8	8368	296	0	8701
22899	27	8	8442	91	0	8568
22900	31	16	305	7967	0	8319
22901	23	5	8498	261	0	8787
22902	20	5	8615	99	0	8739
22903	21	10	305	8315	0	8651
22904	8533	11	114	265	0	8923
22905	8795	3	69	103	0	8970
22906	298	5	45	8690	0	9038
22907	96	7	44	8790	0	8937
22908	8654	5	65	321	0	9045
22909	268	5	44	8649	0	8966
22910	8505	3	32	328	0	8868
22911	8736	2	45	117	0	8900
22912	300	6	48	8605	0	8959
22913	113	5	33	8847	0	8998
22914	8556	9	30	336	0	8931
22915	277	8410	40	133	0	8860
22916	108	8661	30	99	0	8898
22917	91	271	24	8361	0	8747
22918	75	75	8225	295	0	8670
22919	60	31	245	8214	0	8550
22920	8205	26	71	326	0	8628
22921	268	28	51	8271	0	8618
22922	8266	25	34	323	0	8648
22923	291	23	8207	149	0	8670
22924	8203	19	253	121	0	8596
22925	301	22	81	8398	0	8802
22926	120	19	53	8696	0	8888
22927	103	12	8686	353	0	9154
22928	86	20	267	8725	0	9098
22929	59	28	88	9066	0	9241
22930	67	22	61	9234	0	9384
22931	8898	18	45	424	0	9385
22932	292	23	8791	184	0	9290
22933	113	20	8697	145	0	8975
22934	8630	10	299	127	0	9066
22935	8980	8	113	132	0	9233
22936	360	12	8964	107	0	9443
22937	162	12	297	8677	0	9148
22938	120	8979	115	307	0	9521
22939	92	232	97	9331	0	9752
22940	9208	64	99	353	0	9724
22941	9407	37	104	174	0	9722
22942	339	26	100	9182	0	9647
22943	136	9073	101	358	0	9668
22944	122	237	101	8972	0	9432
22945	104	9098	110	339	0	9651
22946	9182	260	106	180	0	9728
22947	8941	74	95	159	0	9269
22948	9147	54	94	134	0	9429
22949	395	8520	102	160	0	9177
22950	172	8971	82	162	0	9387
22951	160	288	72	9092	0	9612
22952	135	112	67	9243	0	9557
22953	161	60	64	9068	0	9353
22954	157	43	54	9386	0	9640
22955	139	58	8752	453	0	9402
22956	8488	59	274	262	0	9083
22957	368	59	8914	191	0	9532
22958	9036	56	291	188	0	9571
22959	385	56	9205	171	0	9817
22960	9148	43	316	167	0	9674
22961	390	47	9376	156	0	9969
22962	9131	55	326	154	0	9666
22963	383	52	142	9482	0	10059
22964	9654	46	110	391	0	10201
22965	401	42	97	9759	0	10299
22966	216	35	96	9829	0	10176
22967	168	26	95	9511	0	9800
22968	149	8918	88	493	0	9648
22969	8990	251	99	235	0	9575
22970	9091	85	79	203	0	9458
22971	419	8899	74	180	0	9572
22972	229	262	69	9035	0	9595
22973	163	96	8768	414	0	9441
22974	8683	58	292	232	0	9265
22975	9102	41	130	199	0	9472
22976	9063	54	83	166	0	9366
22977	432	46	79	8574	0	9131
22978	223	8457	78	343	0	9101
22979	170	259	91	8559	0	9079
22980	8496	92	70	383	0	9041
22981	388	66	75	8162	0	8691
22982	188	7959	68	310	0	8525
22983	7818	234	77	164	0	8293
22984	334	99	7808	138	0	8379
22985	230	67	7628	121	0	8046
22986	159	7550	278	121	0	8108
22987	113	7532	146	101	0	7892
22988	208	273	6986	85	0	7552
22989	147	123	6753	99	0	7122
22990	139	410	171	5366	0	6086
22991	5516	34	73	120	0	5743
22992	112	38	5469	48	0	5667
22993	42	5130	63	37	0	5272
22994	5161	51	42	28	0	5282
22995	51	5145	24	19	0	5239
22996	4942	38	13	16	0	5009
22997	33	4882	11	12	0	4938
22998	27	5023	13	9	0	5072
22999	17	39	14	5063	0	5133
23000	18	20	9	5045	0	5092
23001	19	11	4789	34	0	4853
23002	15	14	23	4655	0	4707
23003	4735	8	17	31	0	4791
23004	4744	10	5	29	0	4788
23005	42	11	6	4655	0	4714
23006	28	10	4534	29	0	4601
23007	14	8	4404	33	0	4459
23008	17	12	36	4535	0	4600
23009	8	5	4643	40	0	4696
23010	12	8	30	4549	0	4599
23011	16	5	26	4397	0	4444
23012	9	10	4963	46	0	5028
23013	4695	5	48	30	0	4778
23014	4965	9	38	17	0	5029
23015	67	7	5048	18	0	5140
23016	32	6	5129	15	0	5182
23017	16	4	110	5242	0	5372
23018	19	3	50	5816	0	5888
23019	19	9	19	6016	0	6063
23020	21	6	22	5939	0	5988
23021	6058	11	12	141	0	6222
23022	6497	8	15	59	0	6579
23023	170	13	11	6963	0	7157
23024	71	6	10	7343	0	7430
23025	17	13	7718	212	0	7960
23026	24	7	188	7989	0	8208
23027	19	5	83	8482	0	8589
23028	8733	6	36	359	0	9134
23029	271	9316	26	137	0	9750
23030	119	274	23	9433	0	9849
23031	51	97	12	9673	0	9833
23032	38	37	17	9465	0	9557
23033	32	8442	27	453	0	8954
23034	19	9317	22	185	0	9543
23035	37	347	20	9278	0	9682
23036	25	132	14	9334	0	9505
23037	30	52	16	9491	0	9589
23038	8712	50	17	477	0	9256
23039	284	8906	19	236	0	9445
23040	8957	299	12	130	0	9398
23041	9212	135	15	99	0	9461
23042	418	60	15	8811	0	9304
23043	158	8746	12	350	0	9266
23044	8752	313	19	186	0	9270
23045	352	125	10	8862	0	9349
23046	8940	68	17	395	0	9420
23047	367	65	10	9076	0	9518
23048	177	53	8864	394	0	9488
23049	95	43	9155	203	0	9496
23050	72	42	373	9104	0	9591
23051	75	38	137	9294	0	9544
23052	58	46	65	9038	0	9207
23053	66	8544	56	459	0	9125
23054	59	9290	33	249	0	9631
23055	9038	389	31	165	0	9623
23056	8953	154	32	126	0	9265
23057	401	8780	27	119	0	9327
23058	149	8637	22	111	0	8919
23059	91	9011	15	124	0	9241
23060	8385	393	20	112	0	8910
23061	287	8604	22	99	0	9012
23062	136	365	18	8562	0	9081
23063	8465	163	18	364	0	9010
23064	8646	85	22	183	0	8936
23065	410	70	15	8279	0	8774
23066	164	77	8060	369	0	8670
23067	114	70	8269	161	0	8614
23068	110	62	354	8228	0	8754
23069	88	69	8408	381	0	8946
23070	80	65	323	8415	0	8883
23071	75	59	142	8523	0	8799
23072	64	64	8356	461	0	8945
23073	75	52	8473	221	0	8821
23074	67	50	407	8309	0	8833
23075	73	57	155	8765	0	9050
23076	8295	59	93	485	0	8932
23077	314	8192	81	255	0	8842
23078	146	8749	58	201	0	9154
23079	8320	402	52	173	0	8947
23080	8756	184	52	160	0	9152
23081	406	8435	52	164	0	9057
23082	173	8777	53	164	0	9167
23083	8635	413	39	169	0	9256
23084	384	185	41	8597	0	9207
23085	8478	138	51	430	0	9097
23086	379	8503	46	264	0	9192
23087	8602	355	52	202	0	9211
23088	425	165	8367	190	0	9147
23089	8436	111	308	186	0	9041
23090	429	105	8456	161	0	9151
23091	214	113	343	8434	0	9104
23092	8334	77	144	470	0	9025
23093	408	94	8084	280	0	8866
23094	223	101	326	8219	0	8869
23095	8137	111	173	455	0	8876
23096	423	95	8060	281	0	8859
23097	221	101	341	8278	0	8941
23098	8064	82	139	495	0	8780
23099	386	7997	97	285	0	8765
23100	210	351	92	8179	0	8832
23101	151	200	79	8236	0	8666
23102	164	115	55	8314	0	8648
23103	141	8094	71	538	0	8844
23104	142	380	52	8422	0	8996
23105	152	196	54	8677	0	9079
23106	187	116	64	8642	0	9009
23107	157	128	57	8867	0	9209
23108	192	122	8310	552	0	9176
23109	8019	139	346	320	0	8824
23110	8550	89	135	221	0	8995
23111	517	8352	102	188	0	9159
23112	222	362	75	8106	0	8765
23113	159	166	77	8224	0	8626
23114	179	7901	88	498	0	8666
23115	120	308	76	8029	0	8533
23116	7568	130	95	456	0	8249
23117	318	7462	105	256	0	8141
23118	7130	285	105	177	0	7697
23119	334	141	77	7078	0	7630
23120	127	81	6976	415	0	7599
23121	109	7017	269	219	0	7614
23122	6481	287	118	172	0	7058
23123	246	5929	84	102	0	6361
23124	99	5984	61	89	0	6233
23125	5211	199	87	81	0	5578
23126	180	74	5081	75	0	5410
23127	56	4579	109	46	0	4790
23128	3622	171	195	70	0	4058
23129	3281	13	12	19	0	3325
23130	50	3259	7	9	0	3325
23131	15	44	6	3343	0	3408
23132	14	12	3428	46	0	3500
23133	11	13	41	3374	0	3439
23134	12	9	11	3239	0	3271
23135	10	5	10	3553	0	3578
23136	9	8	3533	61	0	3611
23137	9	9	43	3395	0	3456
23138	10	8	3521	53	0	3592
23139	9	9	3308	16	0	3342
23140	3096	5	48	29	0	3178
23141	40	3433	14	12	0	3499
23142	16	3520	10	11	0	3557
23143	18	44	6	3634	0	3702
23144	4003	20	6	74	0	4103
23145	4063	12	6	23	0	4104
23146	3926	7	8	16	0	3957
23147	3970	7	7	14	0	3998
23148	3861	8	6	13	0	3888
23149	65	12	3701	7	0	3785
23150	34	8	47	3658	0	3747
23151	20	3670	14	46	0	3750
23152	16	49	12	3758	0	3835
23153	3800	14	7	59	0	3880
23154	48	3695	6	18	0	3767
23155	25	63	3	3825	0	3916
23156	3873	14	6	70	0	3963
23157	4007	9	5	36	0	4057
23158	66	13	12	3970	0	4061
23159	40	6	7	3891	0	3944
23160	33	4	9	3975	0	4021
23161	22	10	3919	69	0	4020
23162	16	10	3902	38	0	3966
23163	17	5	57	4044	0	4123
23164	11	20	26	4115	0	4172
23165	4072	13	15	79	0	4179
23166	4086	7	13	38	0	4144
23167	4127	19	11	36	0	4193
23168	4238	10	3	47	0	4298
23169	4166	9	8	29	0	4212
23170	82	4178	10	21	0	4291
23171	4285	52	7	30	0	4374
23172	4355	13	7	33	0	4408
23173	4356	15	12	32	0	4415
23174	85	11	13	4528	0	4637
23175	40	11	4478	77	0	4606
23176	36	10	62	4568	0	4676
23177	30	8	4760	87	0	4885
23178	37	11	66	4528	0	4642
23179	26	4730	27	66	0	4849
23180	4778	68	13	27	0	4886
23181	4894	25	8	31	0	4958
23182	108	18	10	4923	0	5059
23183	56	20	5	5126	0	5207
23184	48	10	10	5182	0	5250
23185	35	5209	11	104	0	5359
23186	5237	71	11	38	0	5357
23187	5271	22	12	41	0	5346
23188	101	5306	17	17	0	5441
23189	45	74	10	5367	0	5496
23190	27	25	16	5289	0	5357
23191	22	5356	14	106	0	5498
23192	5433	80	13	46	0	5572
23193	5451	28	6	34	0	5519
23194	111	14	7	5417	0	5549
23195	49	10	5410	94	0	5563
23196	37	15	5180	54	0	5286
23197	28	9	93	5490	0	5620
23198	31	14	29	5464	0	5538
23199	29	12	23	5671	0	5735
23200	5577	14	9	127	0	5727
23201	5679	20	15	42	0	5756
23202	109	5892	12	53	0	6066
23203	5938	85	17	41	0	6081
23204	119	39	5943	25	0	6126
23205	54	22	5930	24	0	6030
23206	48	6236	110	30	0	6424
23207	6078	82	50	31	0	6241
23208	73	6065	24	24	0	6186
23209	6038	78	17	18	0	6151
23210	95	28	5981	23	0	6127
23211	44	29	5890	18	0	5981
23212	45	15	98	5798	0	5956
23213	32	8	6083	90	0	6213
23214	21	14	76	6125	0	6236
23215	40	27	48	5358	0	5473
23216	33	6127	21	92	0	6273
23217	30	74	15	6252	0	6371
23218	26	31	18	6339	0	6414
23219	6459	23	18	109	0	6609
23220	90	6374	18	66	0	6548
23221	42	91	17	6616	0	6766
23222	42	36	6545	91	0	6714
23223	5797	23	85	71	0	5976
23224	96	18	6428	39	0	6581
23225	54	13	97	6261	0	6425
23226	27	6677	51	85	0	6840
23227	28	85	29	6734	0	6876
23228	6894	39	12	125	0	7070
23229	6892	27	13	68	0	7000
23230	136	7169	18	52	0	7375
23231	7380	107	14	65	0	7566
23232	7441	48	15	42	0	7546
23233	7370	31	19	46	0	7466
23234	7638	23	15	42	0	7718
23235	7120	36	29	56	0	7241
23236	159	26	7399	31	0	7615
23237	77	13	129	7234	0	7453
23238	66	27	45	7095	0	7233
23239	49	32	27	7362	0	7470
23240	37	7373	27	164	0	7601
23241	39	115	22	7342	0	7518
23242	34	42	7316	132	0	7524
23243	34	7063	110	61	0	7268
23244	36	6979	37	45	0	7097
23245	34	132	28	6974	0	7168
23246	22	56	23	6996	0	7097
23247	43	24	15	6872	0	6954
23248	36	6691	25	138	0	6890
23249	31	6878	16	63	0	6988
23250	6886	133	18	48	0	7085
23251	6930	41	26	34	0	7031
23252	126	6911	23	33	0	7093
23253	7051	117	18	43	0	7229
23254	7314	41	26	64	0	7445
23255	156	33	25	7284	0	7498
23256	60	20	24	7446	0	7550
23257	43	27	25	7469	0	7564
23258	36	30	7353	165	0	7584
23259	43	23	7159	84	0	7309
23260	43	7685	152	46	0	7926
23261	7858	139	55	47	0	8099
23262	144	50	7925	51	0	8170
23263	7705	35	146	47	0	7933
23264	182	26	8241	40	0	8489
23265	8212	28	160	52	0	8452
23266	200	8638	68	40	0	8946
23267	8675	173	51	43	0	8942
23268	192	65	45	8485	0	8787
23269	94	40	27	8716	0	8877
23270	72	41	8453	213	0	8779
23271	47	8722	169	96	0	9034
23272	65	180	60	8772	0	9077
23273	54	82	8654	185	0	8975
23274	7941	36	171	85	0	8233
23275	161	8438	66	57	0	8722
23276	8348	168	36	54	0	8606
23277	170	8181	35	58	0	8444
23278	73	172	38	8189	0	8472
23279	8077	55	31	185	0	8348
23280	161	8181	37	77	0	8456
23281	67	168	27	8248	0	8510
23282	45	65	8087	184	0	8381
23283	7599	43	147	90	0	7879
23284	158	43	45	8023	0	8269
23285	72	34	7876	162	0	8144
23286	63	7858	132	73	0	8126
23287	38	162	55	7904	0	8159
23288	44	54	7874	177	0	8149
23289	51	35	151	7547	0	7784
23290	49	7806	55	152	0	8062
23291	45	7985	30	73	0	8133
23292	43	164	7931	42	0	8180
23293	48	73	143	7780	0	8044
23294	39	36	7974	152	0	8201
23295	7697	31	141	78	0	7947
23296	158	38	61	7690	0	7947
23297	57	7586	35	149	0	7827
23298	42	8027	26	57	0	8152
23299	7781	156	32	43	0	8012
23300	130	7984	22	42	0	8178
23301	7914	143	31	48	0	8136
23302	147	54	7686	24	0	7911
23303	7161	41	124	39	0	7365
23304	128	7480	41	23	0	7672
23305	7430	134	41	25	0	7630
23306	132	7297	27	32	0	7488
23307	50	131	14	7215	0	7410
23308	29	51	16	7449	0	7545
23309	26	35	7312	147	0	7520
23310	6795	35	119	76	0	7025
23311	133	40	7280	26	0	7479
23312	7308	29	132	26	0	7495
23313	149	36	45	7320	0	7550
23314	63	19	26	7371	0	7479
23315	34	7525	20	173	0	7752
23316	31	146	25	7767	0	7969
23317	42	56	19	7981	0	8098
23318	28	33	7792	193	0	8046
23319	7029	26	138	92	0	7285
23320	146	7546	50	54	0	7796
23321	7480	141	28	38	0	7687
23322	151	54	21	7457	0	7683
23323	57	29	27	7590	0	7703
23324	7458	24	27	186	0	7695
23325	146	7578	32	78	0	7834
23326	7209	137	20	46	0	7412
23327	144	7096	22	33	0	7295
23328	63	7127	14	30	0	7234
23329	7019	149	42	39	0	7249
23330	139	60	20	6771	0	6990
23331	62	41	6615	122	0	6840
23332	40	43	110	6498	0	6691
23333	41	28	40	6545	0	6654
23334	26	6516	26	157	0	6725
23335	38	134	23	6663	0	6858
23336	44	54	12	6677	0	6787
23337	22	43	18	6783	0	6866
23338	29	34	18	6917	0	6998
23339	23	28	6807	202	0	7060
23340	20	33	6923	91	0	7067
23341	30	36	170	7105	0	7341
23342	31	29	7130	178	0	7368
23343	25	36	7079	81	0	7221
23344	36	29	191	7073	0	7329
23345	17	29	7420	191	0	7657
23346	43	17	178	7031	0	7269
23347	21	7335	68	173	0	7597
23348	7645	167	46	91	0	7949
23349	175	57	8174	52	0	8458
23350	58	33	198	8131	0	8420
23351	34	29	8433	212	0	8708
23352	30	28	215	8898	0	9171
23353	24	26	73	9211	0	9334
23354	9016	27	55	320	0	9418
23355	246	17	54	9261	0	9578
23356	8718	30	46	289	0	9083
23357	9068	36	36	137	0	9277
23358	284	8943	43	90	0	9360
23359	8806	220	35	82	0	9143
23360	252	8617	35	70	0	8974
23361	100	8892	33	53	0	9078
23362	8615	263	53	65	0	8996
23363	250	89	8582	61	0	8982
23364	102	46	8435	54	0	8637
23365	7989	70	298	64	0	8421
23366	8211	23	88	43	0	8365
23367	280	8147	40	38	0	8505
23368	8297	217	32	54	0	8600
23369	8404	81	32	56	0	8573
23370	8368	61	28	44	0	8501
23371	302	42	19	8165	0	8528
23372	8138	30	43	233	0	8444
23373	226	8305	41	103	0	8675
23374	123	215	32	8458	0	8828
23375	91	76	29	8532	0	8728
23376	60	8425	58	274	0	8817
23377	70	212	32	8613	0	8927
23378	8473	81	38	261	0	8853
23379	8608	42	42	113	0	8805
23380	296	8127	35	91	0	8549
23381	125	8440	36	68	0	8669
23382	8384	246	31	64	0	8725
23383	264	100	8275	66	0	8705
23384	128	54	8311	72	0	8565
23385	93	55	263	8112	0	8523
23386	77	51	91	8431	0	8650
23387	75	46	8176	284	0	8581
23388	88	7821	225	133	0	8267
23389	104	222	92	7626	0	8044
23390	77	122	8250	238	0	8687
23391	95	66	218	8181	0	8560
23392	100	48	95	8229	0	8472
23393	76	8402	70	273	0	8821
23394	68	237	42	8445	0	8792
23395	96	93	49	8560	0	8798
23396	79	61	60	8670	0	8870
23397	8460	55	63	309	0	8887
23398	254	57	42	8189	0	8542
23399	125	8359	53	253	0	8790
23400	8294	223	58	135	0	8710
23401	254	100	8028	102	0	8484
23402	128	63	7894	103	0	8188
23403	7962	65	264	91	0	8382
23404	243	61	105	8110	0	8519
23405	130	42	8159	278	0	8609
23406	98	53	226	8126	0	8503
23407	86	42	110	8500	0	8738
23408	8255	58	58	342	0	8713
23409	8410	40	48	158	0	8656
23410	299	8453	65	126	0	8943
23411	125	254	55	8395	0	8829
23412	99	89	8398	272	0	8858
23413	86	8670	215	138	0	9109
23414	8558	221	99	108	0	8986
23415	233	8792	73	86	0	9184
23416	8702	225	46	99	0	9072
23417	257	96	8635	89	0	9077
23418	8522	52	230	83	0	8887
23419	9049	59	96	87	0	9291
23420	324	63	9207	79	0	9673
23421	148	65	247	8997	0	9457
23422	90	9031	101	279	0	9501
23423	102	9602	51	111	0	9866
23424	80	9758	51	89	0	9978
23425	100	326	50	9396	0	9872
23426	88	123	9555	258	0	10024
23427	85	88	254	9414	0	9841
23428	94	74	90	9791	0	10049
23429	95	54	9622	327	0	10098
23430	75	9625	261	138	0	10099
23431	89	260	95	9589	0	10033
23432	9724	109	69	283	0	10185
23433	261	82	66	9733	0	10142
23434	141	68	43	9701	0	9953
23435	87	9588	56	333	0	10064
23436	9781	260	47	142	0	10230
23437	288	123	28	10013	0	10452
23438	116	65	9875	297	0	10353
23439	80	9788	230	137	0	10235
23440	9655	233	96	103	0	10087
23441	237	90	9630	97	0	10054
23442	9405	72	235	75	0	9787
23443	255	62	89	9516	0	9922
23444	106	9663	57	226	0	10052
23445	9481	221	55	112	0	9869
23446	9395	102	46	88	0	9631
23447	251	9730	53	77	0	10111
23448	129	220	39	9563	0	9951
23449	86	86	30	9320	0	9522
23450	8974	59	47	233	0	9313
23451	188	8939	38	113	0	9278
23452	81	157	29	8340	0	8607
23453	48	8149	37	141	0	8375
23454	34	8131	28	65	0	8258
23455	48	149	24	7946	0	8167
23456	7844	69	34	136	0	8083
23457	116	7872	18	54	0	8060
23458	51	117	15	7854	0	8037
23459	31	44	15	7939	0	8029
23460	31	36	7769	131	0	7967
23461	32	34	7174	76	0	7316
23462	27	7566	116	56	0	7765
23463	24	110	7504	29	0	7667
23464	23	45	98	7457	0	7623
23465	19	38	7614	102	0	7773
23466	32	35	101	7690	0	7858
23467	21	28	35	7849	0	7933
23468	21	34	28	7895	0	7978
23469	7702	34	24	126	0	7886
23470	99	19	20	7643	0	7781
23471	46	22	15	7664	0	7747
23472	33	7563	24	125	0	7745
23473	29	94	22	7508	0	7653
23474	7567	42	17	151	0	7777
23475	94	7700	25	56	0	7875
23476	7727	101	18	65	0	7911
23477	113	41	7659	51	0	7864
23478	47	40	7710	46	0	7843
23479	42	30	104	7944	0	8120
23480	37	28	47	8254	0	8366
23481	30	8238	32	150	0	8450
23482	51	130	39	7563	0	7783
23483	8153	51	17	174	0	8395
23484	8111	41	29	64	0	8245
23485	141	42	22	8241	0	8446
23486	63	26	8772	169	0	9030
23487	52	40	128	8788	0	9008
23488	33	35	37	9177	0	9282
23489	35	21	42	9258	0	9356
23490	38	34	34	9088	0	9194
23491	29	37	22	8903	0	8991
23492	16	8864	27	217	0	9124
23493	8785	147	23	106	0	9061
23494	8872	46	26	110	0	9054
23495	8951	35	17	94	0	9097
23496	176	9104	27	61	0	9368
23497	9026	147	21	74	0	9268
23498	166	9058	24	76	0	9324
23499	73	166	8974	48	0	9261
23500	67	58	135	8694	0	8954
23501	57	34	9069	186	0	9346
23502	34	9147	149	90	0	9420
23503	9024	165	44	90	0	9323
23504	164	68	9286	64	0	9582
23505	62	61	9666	60	0	9849
23506	68	10148	214	59	0	10489
23507	58	202	88	10361	0	10709
23508	51	85	11004	218	0	11358
23509	64	62	234	10366	0	10726
23510	55	38	80	11921	0	12094
23511	38	35	70	12730	0	12873
23512	12939	43	42	391	0	13415
23513	13006	26	33	189	0	13254
23514	387	33	41	12823	0	13284
23515	12913	28	23	396	0	13360
23516	380	22	12594	157	0	13153
23517	134	28	12363	109	0	12634
23518	108	19	12514	99	0	12740
23519	85	18	12711	78	0	12892
23520	72	12316	375	82	0	12845
23521	107	283	170	12101	0	12661
23522	89	68	12537	257	0	12951
23523	11465	40	321	155	0	11981
23524	12477	28	145	92	0	12742
23525	351	12323	126	73	0	12873
23526	12310	277	127	50	0	12764
23527	335	76	131	12252	0	12794
23528	120	55	12634	284	0	13093
23529	108	66	359	11790	0	12323
23530	76	12619	147	298	0	13140
23531	12119	313	116	139	0	12687
23532	12635	97	98	100	0	12930
23533	378	12574	76	88	0	13116
23534	12744	313	63	78	0	13198
23535	12811	113	51	82	0	13057
23536	411	12648	54	76	0	13189
23537	192	297	65	12157	0	12711
23538	132	12373	60	289	0	12854
23539	12540	338	64	127	0	13069
23540	377	157	54	12446	0	13034
23541	12499	98	54	331	0	12982
23542	383	105	54	12446	0	12988
23543	198	95	12234	335	0	12862
23544	11928	88	279	134	0	12429
23545	414	87	12236	88	0	12825
23546	196	82	307	12129	0	12714
23547	149	91	12034	343	0	12617
23548	144	80	320	11991	0	12535
23549	151	60	12079	370	0	12660
23550	11629	59	333	200	0	12221
23551	352	12049	154	158	0	12713
23552	12213	287	128	145	0	12773
23553	385	113	129	12155	0	12782
23554	12009	67	121	365	0	12562
23555	357	11965	122	168	0	12612
23556	174	11862	129	129	0	12294
23557	115	12510	102	145	0	12872
23558	12427	368	108	124	0	13027
23559	372	149	101	12358	0	12980
23560	188	124	85	12599	0	12996
23561	153	124	12207	404	0	12888
23562	153	105	12019	187	0	12464
23563	153	97	346	12191	0	12787
23564	155	109	12441	358	0	13063
23565	117	12215	340	180	0	12852
23566	12086	372	151	140	0	12749
23567	395	160	12319	106	0	12980
23568	189	114	12299	121	0	12723
23569	145	87	405	12088	0	12725
23570	12469	80	209	387	0	13145
23571	380	69	163	12496	0	13108
23572	12491	65	158	412	0	13126
23573	385	62	156	12535	0	13138
23574	179	83	12480	397	0	13139
23575	153	12192	398	160	0	12903
23576	138	323	12465	138	0	13064
23577	119	12425	428	143	0	13115
23578	135	370	213	12243	0	12961
23579	12091	134	128	365	0	12718
23580	364	85	12064	201	0	12714
23581	197	65	334	11967	0	12563
23582	155	59	164	12346	0	12724
23583	12329	68	118	446	0	12961
23584	356	84	117	12045	0	12602
23585	150	12282	139	357	0	12928
23586	11745	325	130	171	0	12371
23587	337	154	11562	151	0	12204
23588	11067	118	320	144	0	11649
23589	363	11485	151	116	0	12115
23590	196	318	100	11011	0	11625
23591	151	11617	84	322	0	12174
23592	11575	318	75	179	0	12147
23593	374	141	11471	142	0	12128
23594	11042	137	296	149	0	11624
23595	366	11483	117	128	0	12094
23596	199	307	83	11504	0	12093
23597	11523	123	100	334	0	12080
23598	11729	119	92	144	0	12084
23599	397	104	80	11569	0	12150
23600	192	123	80	11661	0	12056
23601	160	11474	91	361	0	12086
23602	147	336	81	11505	0	12069
23603	164	13088	75	330	0	13657
23604	131	13950	92	157	0	14330
23605	135	521	73	12584	0	13313
23606	125	13179	52	366	0	13722
23607	183	343	13190	145	0	13861
23608	179	149	13344	151	0	13823
23609	104	13563	406	154	0	14227
23610	111	374	13469	85	0	14039
23611	74	119	13302	79	0	13574
23612	54	77	12592	23	0	12746
23613	21	12452	383	38	0	12894
23614	12031	296	221	44	0	12592
23615	233	12145	92	25	0	12495
23616	91	301	12241	12	0	12645
23617	61	132	307	11871	0	12371
23618	11998	105	133	256	0	12492
23619	267	64	11808	106	0	12245
23620	106	65	322	11760	0	12253
23621	66	54	12011	281	0	12412
23622	51	40	375	11648	0	12114
23623	11590	58	148	321	0	12117
23624	279	57	11746	116	0	12198
23625	101	11739	338	96	0	12274
23626	82	271	165	11525	0	12043
23627	11995	121	118	290	0	12524
23628	322	80	11643	119	0	12164
23629	141	80	320	10765	0	11306
23630	83	11508	182	273	0	12046
23631	11734	290	113	144	0	12281
23632	12149	110	94	111	0	12464
23633	406	91	108	11798	0	12403
23634	176	11792	88	336	0	12392
23635	105	12604	96	143	0	12948
23636	12853	408	61	131	0	13453
23637	396	173	77	12375	0	13021
23638	152	12807	89	347	0	13395
23639	12860	396	68	163	0	13487
23640	386	171	67	12969	0	13593
23641	188	125	67	13229	0	13609
23642	132	93	12235	462	0	12922
23643	88	12485	323	239	0	13135
23644	86	13343	144	150	0	13723
23645	112	428	90	13187	0	13817
23646	13189	200	77	389	0	13855
23647	372	13242	79	202	0	13895
23648	13206	422	68	146	0	13842
23649	408	13256	62	107	0	13833
23650	208	428	69	13259	0	13964
23651	13287	205	57	408	0	13957
23652	406	191	68	13278	0	13943
23653	208	137	13237	426	0	14008
23654	155	104	364	12485	0	13108
23655	113	13119	145	436	0	13813
23656	12956	397	123	196	0	13672
23657	387	13115	88	127	0	13717
23658	181	467	86	12707	0	13441
23659	142	215	74	13220	0	13651
23660	141	157	12662	489	0	13449
23661	105	155	12750	237	0	13247
23662	133	121	447	12685	0	13386
23663	74	148	12657	444	0	13323
23664	99	12582	422	227	0	13330
23665	12575	408	174	177	0	13334
23666	378	203	12738	170	0	13489
23667	12550	167	414	139	0	13270
23668	13082	117	203	166	0	13568
23669	13086	128	157	126	0	13497
23670	13144	121	137	100	0	13502
23671	530	127	131	12718	0	13506
23672	269	109	124	12433	0	12935
23673	184	12422	105	485	0	13196
23674	12407	391	137	229	0	13164
23675	444	190	12252	159	0	13045
23676	221	174	385	12097	0	12877
23677	184	137	218	12326	0	12865
23678	176	136	11934	486	0	12732
23679	178	11984	408	241	0	12811
23680	156	383	222	11437	0	12198
23681	151	198	155	12470	0	12974
23682	11995	158	127	520	0	12800
23683	422	11905	93	296	0	12716
23684	242	389	118	11633	0	12382
23685	169	11728	109	479	0	12485
23686	166	412	100	12092	0	12770
23687	11765	221	95	513	0	12594
23688	12150	154	109	275	0	12688
23689	471	142	134	11922	0	12669
23690	11858	110	73	529	0	12570
23691	11879	130	93	291	0	12393
23692	530	11643	108	224	0	12505
23693	300	417	83	11258	0	12058
23694	218	11654	72	448	0	12392
23695	212	449	63	11731	0	12455
23696	11698	225	70	480	0	12473
23697	452	210	59	11665	0	12386
23698	256	161	54	11883	0	12354
23699	227	162	11232	552	0	12173
23700	218	10581	321	339	0	11459
23701	192	11505	136	262	0	12095
23702	11173	442	100	251	0	11966
23703	374	232	59	9246	0	9911
23704	8533	119	50	319	0	9021
23705	296	8170	34	203	0	8703
23706	171	7695	40	146	0	8052
23707	129	8059	46	105	0	8339
23708	6917	256	124	117	0	7414
23709	176	6944	36	87	0	7243
23710	6413	135	108	76	0	6732
23711	6299	69	15	71	0	6454
23712	6451	30	21	59	0	6561
23713	139	50	19	6703	0	6911
23714	80	40	18	6833	0	6971
23715	54	37	26	6926	0	7043
23716	54	31	18	6757	0	6860
23717	6748	38	24	191	0	7001
23718	145	6621	16	111	0	6893
23719	75	126	17	6733	0	6951
23720	6772	57	23	161	0	7013
23721	163	35	14	6684	0	6896
23722	84	33	18	6696	0	6831
23723	6672	32	7	198	0	6909
23724	153	23	6500	98	0	6774
23725	83	25	113	6539	0	6760
23726	48	32	6672	155	0	6907
23727	48	33	117	6541	0	6739
23728	54	46	49	6612	0	6761
23729	6424	18	24	179	0	6645
23730	137	6203	22	94	0	6456
23731	62	6131	17	58	0	6268
23732	5900	102	13	60	0	6075
23733	100	5993	18	30	0	6141
23734	5893	86	38	45	0	6062
23735	98	30	5829	40	0	5997
23736	5240	10	52	32	0	5334
23737	5471	9	20	23	0	5523
23738	5523	5	10	28	0	5566
23739	77	8	11	5361	0	5457
23740	32	8	1	5350	0	5391
23741	15	5315	9	66	0	5405
23742	19	85	1	5317	0	5422
23743	5207	28	1	77	0	5313
23744	67	5144	3	27	0	5241
23745	19	5190	7	15	0	5231
23746	5169	64	3	19	0	5255
23747	63	14	5173	14	0	5264
23748	29	14	51	5024	0	5118
23749	16	5	5208	59	0	5288
23750	8	5	48	5013	0	5074
23751	13	5083	11	45	0	5152
23752	5	53	10	5273	0	5341
23753	5173	14	1	66	0	5254
23754	59	11	2	5179	0	5251
23755	22	6	5355	63	0	5446
23756	4839	7	52	36	0	4934
23757	60	5313	24	21	0	5418
23758	26	5760	8	5	0	5799
23759	5994	70	1	26	0	6091
23760	6479	29	6	17	0	6531
23761	122	16	6451	9	0	6598
23762	6163	7	95	16	0	6281
23763	108	6459	27	18	0	6612
23764	6548	93	16	21	0	6678
23765	108	26	5	6259	0	6398
23766	36	5932	7	88	0	6063
23767	6023	94	2	42	0	6161
23768	116	37	6013	18	0	6184
23769	59	16	97	6013	0	6185
23770	6266	14	33	126	0	6439
23771	112	19	6220	48	0	6399
23772	6193	18	98	36	0	6345
23773	122	18	34	6159	0	6333
23774	54	12	20	6348	0	6434
23775	45	12	6309	141	0	6507
23776	25	13	120	6209	0	6367
23777	6403	5	35	145	0	6588
23778	112	6300	34	63	0	6509
23779	6386	102	13	47	0	6548
23780	6444	37	11	32	0	6524
23781	152	28	12	6354	0	6546
23782	67	12	6443	134	0	6656
23783	43	19	115	6356	0	6533
23784	6475	10	38	151	0	6674
23785	131	6375	33	53	0	6592
23786	6555	112	13	50	0	6730
23787	155	38	15	6476	0	6684
23788	73	29	11	6622	0	6735
23789	50	19	20	6719	0	6808
23790	30	21	6533	172	0	6756
23791	37	15	112	6576	0	6740
23792	38	17	6561	144	0	6760
23793	39	25	6507	56	0	6627
23794	45	23	133	7121	0	7322
23795	46	24	7243	151	0	7464
23796	7798	21	150	105	0	8074
23797	184	12	68	8302	0	8566
23798	100	17	50	8161	0	8328
23799	64	8317	34	261	0	8676
23800	8463	171	43	136	0	8813
23801	8796	89	25	89	0	8999
23802	271	8886	26	61	0	9244
23803	163	189	26	8915	0	9293
23804	87	101	8925	216	0	9329
23805	8591	49	185	137	0	8962
23806	9088	32	100	96	0	9316
23807	283	46	64	8658	0	9051
23808	177	37	8486	220	0	8920
23809	120	8397	187	124	0	8828
23810	8262	210	109	86	0	8667
23811	256	119	8359	69	0	8803
23812	141	8277	210	60	0	8688
23813	7974	159	141	49	0	8323
23814	8047	103	61	40	0	8251
23815	289	56	37	7824	0	8206
23816	162	7928	44	190	0	8324
23817	93	200	42	8432	0	8767
23818	84	102	41	8519	0	8746
23819	83	73	55	8226	0	8437
23820	60	43	37	8615	0	8755
23821	68	50	8362	314	0	8794
23822	76	40	180	8417	0	8713
23823	83	31	97	8558	0	8769
23824	64	43	8344	321	0	8772
23825	52	8294	179	219	0	8744
23826	8300	192	109	144	0	8745
23827	8416	103	74	129	0	8722
23828	278	59	45	8462	0	8844
23829	8490	41	56	275	0	8862
23830	257	37	57	8646	0	8997
23831	160	42	8647	302	0	9151
23832	124	34	8430	198	0	8786
23833	78	8620	279	141	0	9118
23834	8545	211	174	99	0	9029
23835	274	119	8954	102	0	9449
23836	193	78	236	8571	0	9078
23837	126	46	171	9223	0	9566
23838	97	44	111	9690	0	9942
23839	101	39	63	9628	0	9831
23840	86	37	93	9522	0	9738
23841	73	54	9291	489	0	9907
23842	78	62	262	9454	0	9856
23843	9298	53	187	394	0	9932
23844	274	9309	113	276	0	9972
23845	9348	247	76	207	0	9878
23846	313	9437	67	180	0	9997
23847	9463	295	63	185	0	10006
23848	9758	166	64	178	0	10166
23849	412	97	69	9586	0	10164
23850	261	74	60	9793	0	10188
23851	9508	64	81	454	0	10107
23852	9268	82	55	315	0	9720
23853	9609	67	64	181	0	9921
23854	474	9031	71	149	0	9725
23855	275	9227	44	157	0	9703
23856	196	326	9057	133	0	9712
23857	156	228	248	8933	0	9565
23858	144	101	8810	349	0	9404
23859	123	8476	279	266	0	9144
23860	86	218	162	8148	0	8614
23861	104	150	83	8197	0	8534
23862	101	87	62	8414	0	8664
23863	8056	67	56	423	0	8602
23864	8088	80	61	272	0	8501
23865	321	8133	58	189	0	8701
23866	212	199	68	8257	0	8736
23867	132	152	8139	285	0	8708
23868	99	122	7790	235	0	8246
23869	7956	55	302	175	0	8488
23870	8159	68	196	140	0	8563
23871	341	72	98	8110	0	8621
23872	8219	46	80	270	0	8615
23873	293	54	7898	246	0	8491
23874	225	7856	222	172	0	8475
23875	147	195	175	7962	0	8479
23876	112	157	8167	264	0	8700
23877	109	95	228	8240	0	8672
23878	106	60	194	8404	0	8764
23879	103	60	8254	401	0	8818
23880	7870	45	228	310	0	8453
23881	8436	57	175	213	0	8881
23882	328	8767	106	192	0	9393
23883	9077	228	91	156	0	9552
23884	9352	171	86	167	0	9776
23885	439	82	9330	150	0	10001
23886	9202	81	270	135	0	9688
23887	361	9835	169	146	0	10511
23888	9957	266	98	131	0	10452
23889	10168	186	85	119	0	10558
23890	10583	102	66	118	0	10869
23891	9908	101	73	122	0	10204
23892	10506	75	60	110	0	10751
23893	540	10142	53	121	0	10856
23894	9747	252	65	94	0	10158
23895	385	9503	64	90	0	10042
23896	181	8465	44	71	0	8761
23897	132	8897	30	57	0	9116
23898	8713	277	94	65	0	9149
23899	8754	139	46	67	0	9006
23900	322	64	8445	66	0	8897
23901	8746	57	198	58	0	9059
23902	8800	59	92	73	0	9024
23903	349	53	8782	55	0	9239
23904	181	50	215	8648	0	9094
23905	130	61	124	8466	0	8781
23906	106	45	64	9254	0	9469
23907	121	47	39	9221	0	9428
23908	117	24	48	9281	0	9470
23909	88	37	8945	355	0	9425
23910	90	8921	246	171	0	9428
23911	8750	241	110	103	0	9204
23912	276	8860	72	81	0	9289
23913	8952	249	47	76	0	9324
23914	8952	121	34	81	0	9188
23915	370	71	8674	76	0	9191
23916	191	67	228	7975	0	8461
23917	99	8365	121	237	0	8822
23918	8470	217	84	134	0	8905
23919	8467	138	40	92	0	8737
23920	8646	62	35	71	0	8814
23921	359	8603	31	72	0	9065
23922	8767	220	49	54	0	9090
23923	8864	116	42	42	0	9064
23924	8929	78	44	33	0	9084
23925	391	54	35	8538	0	9018
23926	211	61	34	8690	0	8996
23927	161	48	25	8871	0	9105
23928	8594	42	34	325	0	8995
23929	309	8574	31	139	0	9053
23930	8657	233	23	66	0	8979
23931	8526	117	16	49	0	8708
23932	8260	69	23	45	0	8397
23933	8329	50	16	34	0	8429
23934	374	8009	14	50	0	8447
23935	7582	202	20	50	0	7854
23936	291	7403	22	44	0	7760
23937	152	7324	15	27	0	7518
23938	7258	207	21	42	0	7528
23939	246	7059	13	33	0	7351
23940	146	7336	16	33	0	7531
23941	7348	203	17	36	0	7604
23942	7481	98	13	26	0	7618
23943	265	78	12	7177	0	7532
23944	148	67	9	7306	0	7530
23945	7268	68	8	225	0	7569
23946	7527	59	19	82	0	7687
23947	7337	75	20	50	0	7482
23948	272	77	7058	30	0	7437
23949	7391	81	142	40	0	7654
23950	262	69	60	7347	0	7738
23951	166	52	34	7462	0	7714
23952	142	43	27	7543	0	7755
23953	110	52	27	7529	0	7718
23954	127	45	7145	236	0	7553
23955	118	43	7168	110	0	7439
23956	124	34	195	7254	0	7607
23957	96	45	7216	226	0	7583
23958	113	58	7231	127	0	7529
23959	120	41	204	7150	0	7515
23960	116	47	85	7406	0	7654
23961	109	49	61	7659	0	7878
23962	106	51	60	7428	0	7645
23963	7542	51	51	290	0	7934
23964	7901	47	52	167	0	8167
23965	295	45	51	7678	0	8069
23966	146	34	51	7781	0	8012
23967	120	41	62	7764	0	7987
23968	112	41	55	7753	0	7961
23969	117	45	41	7673	0	7876
23970	123	7493	43	301	0	7960
23971	7587	176	48	151	0	7962
23972	258	7566	35	128	0	7987
23973	7686	196	27	127	0	8036
23974	7723	101	17	140	0	7981
23975	7777	61	19	130	0	7987
23976	334	49	24	7305	0	7712
23977	7311	62	31	239	0	7643
23978	275	56	18	7226	0	7575
23979	184	96	17	7199	0	7496
23980	7155	58	20	261	0	7494
23981	273	6876	13	141	0	7303
23982	159	6571	7	83	0	6820
23983	6411	166	20	72	0	6669
23984	232	75	6200	51	0	6558
23985	5740	55	105	64	0	5964
23986	239	72	37	5844	0	6192
23987	130	5377	15	140	0	5662
23988	102	5524	7	86	0	5719
23989	5448	130	25	76	0	5679
23990	166	67	7	5389	0	5629
23991	86	5582	6	110	0	5784
23992	5521	97	5	70	0	5693
23993	5545	50	7	39	0	5641
23994	5511	34	6	33	0	5584
23995	5524	36	5	43	0	5608
23996	154	5268	5	34	0	5461
23997	52	5205	3	26	0	5286
23998	5279	88	2	19	0	5388
23999	5487	38	2	21	0	5548
24000	116	29	5315	23	0	5483
24001	37	5093	54	10	0	5194
24002	5099	64	8	16	0	5187
24003	5332	19	3	17	0	5371
24004	91	15	5305	11	0	5422
24005	5212	12	76	22	0	5322
24006	104	5	5479	7	0	5595
24007	28	2	5913	9	0	5952
24008	25	9	111	5376	0	5521
24009	10	5624	31	89	0	5754
24010	6127	92	14	28	0	6261
24011	108	21	8	6068	0	6205
24012	36	12	1	6174	0	6223
24013	18	7	3	6279	0	6307
24014	6186	3	1	156	0	6346
24015	112	12	1	6147	0	6272
24016	36	8	4	6339	0	6387
24017	23	3	6217	134	0	6377
24018	5954	5	108	53	0	6120
24019	6322	8	28	34	0	6392
24020	152	7	6272	9	0	6440
24021	6013	2	113	18	0	6146
24022	147	1	28	6018	0	6194
24023	44	6095	19	114	0	6272
24024	27	113	11	6160	0	6311
24025	6033	37	7	135	0	6212
24026	114	6164	9	48	0	6335
24027	43	120	7	6262	0	6432
24028	31	33	11	6434	0	6509
24029	26	20	5	6394	0	6445
24030	32	12	6	6075	0	6125
24031	23	6284	13	163	0	6483
24032	6342	128	9	62	0	6541
24033	6463	40	12	41	0	6556
24034	170	6634	8	33	0	6845
24035	7274	139	11	31	0	7455
24036	7614	47	6	26	0	7693
24037	7558	30	4	34	0	7626
24038	282	20	7229	30	0	7561
24039	126	6	181	7175	0	7488
24040	69	14	7008	217	0	7308
24041	7015	15	203	84	0	7317
24042	223	7195	70	55	0	7543
24043	7110	185	45	45	0	7385
24044	253	7224	37	27	0	7541
24045	113	223	26	6906	0	7268
24046	89	72	27	7209	0	7397
24047	64	52	7097	255	0	7468
24048	59	7287	206	115	0	7667
24049	7191	233	84	80	0	7588
24050	261	92	7180	50	0	7583
24051	7194	67	231	45	0	7537
24052	282	45	83	7253	0	7663
24053	119	40	7285	252	0	7696
24054	83	7253	229	122	0	7687
24055	78	231	86	7275	0	7670
24056	77	81	7305	257	0	7720
24057	57	74	7319	109	0	7559
24058	78	7228	271	80	0	7657
24059	75	245	112	7070	0	7502
24060	64	87	81	7047	0	7279
24061	67	7038	49	288	0	7442
24062	7169	231	57	132	0	7589
24063	255	110	58	7005	0	7428
24064	123	6885	50	257	0	7315
24065	7044	239	55	138	0	7476
24066	7108	91	51	100	0	7350
24067	7238	80	54	87	0	7459
24068	333	7077	51	72	0	7533
24069	7271	247	47	83	0	7648
24070	7392	103	43	89	0	7627
24071	345	82	50	7131	0	7608
24072	7269	75	48	275	0	7667
24073	328	66	37	7287	0	7718
24074	145	71	7064	326	0	7606
24075	118	58	7173	167	0	7516
24076	118	57	292	7244	0	7711
24077	126	58	7311	280	0	7775
24078	7133	52	273	172	0	7630
24079	310	54	115	7381	0	7860
24080	161	40	79	7583	0	7863
24081	144	44	7295	350	0	7833
24082	102	7013	264	184	0	7563
24083	97	7466	132	115	0	7810
24084	111	308	78	7265	0	7762
24085	104	127	66	7502	0	7799
24086	96	84	7135	344	0	7659
24087	96	73	7323	172	0	7664
24088	96	67	312	7356	0	7831
24089	74	75	7244	308	0	7701
24090	7096	68	297	171	0	7632
24091	324	60	122	7195	0	7701
24092	7237	55	96	329	0	7717
24093	343	70	74	7206	0	7693
24094	163	58	60	7493	0	7774
24095	122	54	7194	403	0	7773
24096	112	7234	299	198	0	7843
24097	100	278	122	7361	0	7861
24098	97	121	7266	318	0	7802
24099	104	7028	269	182	0	7583
24100	100	266	128	7182	0	7676
24101	7258	101	117	327	0	7803
24102	294	76	7249	160	0	7779
24103	6755	57	273	141	0	7226
24104	303	43	6817	103	0	7266
24105	6210	43	293	98	0	6644
24106	264	6321	129	111	0	6825
24107	121	6113	91	84	0	6409
24108	90	318	81	5680	0	6169
24109	68	5768	77	226	0	6139
24110	5762	221	66	160	0	6209
24111	224	94	78	5833	0	6229
24112	104	80	54	5989	0	6227
24113	67	72	56	6092	0	6287
24114	59	72	5728	310	0	6169
24115	38	67	209	5748	0	6062
24116	70	54	5660	253	0	6037
24117	46	5552	241	141	0	5980
24118	5382	185	106	106	0	5779
24119	209	5625	83	85	0	6002
24120	5772	203	65	88	0	6128
24121	5875	87	55	94	0	6111
24122	5940	66	55	78	0	6139
24123	5834	61	51	76	0	6022
24124	285	57	5520	68	0	5930
24125	142	56	186	5499	0	5883
24126	102	60	86	5388	0	5636
24127	85	46	58	5753	0	5942
24128	4984	47	54	294	0	5379
24129	5154	48	60	167	0	5429
24130	231	5488	59	108	0	5886
24131	126	166	5414	82	0	5788
24132	103	79	5366	89	0	5637
24133	68	5275	228	87	0	5658
24134	64	5362	94	75	0	5595
24135	112	186	100	4526	0	4924
24136	56	59	34	4297	0	4446
24137	4518	27	38	138	0	4721
24138	123	4490	25	66	0	4704
24139	69	107	31	4624	0	4831
24140	40	60	4690	124	0	4914
24141	45	33	120	4795	0	4993
24142	42	26	50	4898	0	5016
24143	49	20	28	5034	0	5131
24144	36	32	29	4962	0	5059
24145	45	17	4750	174	0	4986
24146	29	4464	124	93	0	4710
24147	30	4617	47	62	0	4756
24148	4338	130	35	47	0	4550
24149	110	4369	22	45	0	4546
24150	39	4604	28	38	0	4709
24151	49	125	29	4553	0	4756
24152	26	51	16	4597	0	4690
24153	33	28	19	4619	0	4699
24154	40	28	4504	141	0	4713
24155	26	4470	100	57	0	4653
24156	48	104	38	4389	0	4579
24157	28	4527	28	112	0	4695
24158	4532	98	22	61	0	4713
24159	88	4522	19	54	0	4683
24160	4496	96	25	57	0	4674
24161	99	51	4420	57	0	4627
24162	4409	26	106	49	0	4590
24163	109	43	27	4503	0	4682
24164	51	29	4523	111	0	4714
24165	4375	45	83	51	0	4554
24166	4518	37	41	42	0	4638
24167	4588	40	31	35	0	4694
24168	136	31	17	4489	0	4673
24169	46	35	4460	116	0	4657
24170	4424	27	93	68	0	4612
24171	111	28	40	4598	0	4777
24172	54	30	31	4636	0	4751
24173	48	35	4704	131	0	4918
24174	32	4730	84	62	0	4908
24175	49	99	38	4641	0	4827
24176	36	4801	25	82	0	4944
24177	4717	89	20	49	0	4875
24178	4723	34	22	47	0	4826
24179	111	36	19	4671	0	4837
24180	4668	22	20	106	0	4816
24181	99	4602	25	54	0	4780
24182	4595	88	18	37	0	4738
24183	107	4662	18	34	0	4821
24184	59	93	23	4668	0	4843
24185	37	34	16	4704	0	4791
24186	47	4718	26	89	0	4880
24187	34	92	12	4685	0	4823
24188	44	28	4646	112	0	4830
24189	25	4578	77	49	0	4729
24190	4375	63	36	37	0	4511
24191	69	4425	14	31	0	4539
24192	26	71	15	4468	0	4580
24193	26	29	4455	83	0	4593
24194	26	15	73	4453	0	4567
24195	22	22	20	4531	0	4595
24196	4347	18	9	100	0	4474
24197	94	20	4379	42	0	4535
24198	36	4453	61	36	0	4586
24199	30	67	4731	23	0	4851
24200	15	22	4553	31	0	4621
24201	8	11	4547	21	0	4587
24202	33	60	66	4348	0	4507
24203	4717	6	24	59	0	4806
24204	58	4709	6	27	0	4800
24205	4802	60	5	13	0	4880
24206	4949	21	3	22	0	4995
24207	73	7	6	4820	0	4906
24208	20	4930	11	56	0	5017
24209	4887	61	1	25	0	4974
24210	61	4973	7	18	0	5059
24211	20	65	2	4907	0	4994
24212	6	23	7	5120	0	5156
24213	7	5086	10	87	0	5190
24214	7	61	10	5130	0	5208
24215	13	24	4981	73	0	5091
24216	14	11	4964	25	0	5014
24217	14	14	76	5049	0	5153
24218	12	9	24	5178	0	5223
24219	13	8	4914	80	0	5015
24220	11	6	4787	30	0	4834
24221	4397	8	79	29	0	4513
24222	68	4680	31	14	0	4793
24223	26	5011	13	21	0	5071
24224	17	84	6	4854	0	4961
24225	13	29	4	4917	0	4963
24226	16	16	7	4976	0	5015
24227	11	16	4885	82	0	4994
24228	14	9	4805	37	0	4865
24229	14	8	80	4923	0	5025
24230	10	10	4882	75	0	4977
24231	11	4788	77	36	0	4912
24232	4721	73	37	16	0	4847
24233	71	23	4799	15	0	4908
24234	30	8	4787	13	0	4838
24235	12	14	91	4809	0	4926
24236	13	12	5211	79	0	5315
24237	8	5289	88	35	0	5420
24238	14	93	34	5308	0	5449
24239	11	20	5412	98	0	5541
24240	9	5296	87	42	0	5434
24241	5235	91	37	20	0	5383
24242	86	32	16	5224	0	5358
24243	33	15	17	5280	0	5345
24244	5228	16	15	106	0	5365
24245	84	5237	6	45	0	5372
24246	5314	82	12	26	0	5434
24247	5327	33	15	25	0	5400
24248	5370	17	12	26	0	5425
24249	114	15	13	5243	0	5385
24250	5113	19	16	89	0	5237
24251	98	4942	10	50	0	5100
24252	45	5146	15	36	0	5242
24253	5276	118	12	24	0	5430
24254	108	45	9	5347	0	5509
24255	50	25	15	5405	0	5495
24256	30	22	15	5456	0	5523
24257	36	16	5239	136	0	5427
24258	23	5198	91	66	0	5378
24259	21	101	36	5334	0	5492
24260	5384	46	16	113	0	5559
24261	109	27	14	5355	0	5505
24262	46	27	5307	121	0	5501
24263	32	5355	97	63	0	5547
24264	5351	100	46	44	0	5541
24265	5317	42	26	41	0	5426
24266	5330	24	27	38	0	5419
24267	132	33	24	5358	0	5547
24268	56	31	5385	119	0	5591
24269	49	12	5558	69	0	5688
24270	35	5770	150	43	0	5998
24271	36	145	55	5781	0	6017
24272	22	44	34	6007	0	6107
24273	5619	30	26	179	0	5854
24274	157	28	13	5745	0	5943
24275	5859	24	19	179	0	6081
24276	177	17	5748	70	0	6012
24277	66	19	5807	54	0	5946
24278	43	23	185	5735	0	5986
24279	35	20	67	5863	0	5985
24280	36	27	43	6049	0	6155
24281	6082	24	31	229	0	6366
24282	6480	19	35	100	0	6634
24283	231	19	42	6499	0	6791
24284	84	22	6376	232	0	6714
24285	56	26	6568	107	0	6757
24286	59	21	239	6580	0	6899
24287	6667	13	88	242	0	7010
24288	226	19	49	6605	0	6899
24289	92	15	45	6810	0	6962
24290	52	16	6644	291	0	7003
24291	54	13	6659	124	0	6850
24292	6363	20	258	109	0	6750
24293	226	22	6592	90	0	6930
24294	92	21	229	6332	0	6674
24295	79	18	100	6568	0	6765
24296	6475	12	65	275	0	6827
24297	232	6341	65	132	0	6770
24298	6284	182	72	96	0	6634
24299	215	6079	75	70	0	6439
24300	6052	196	52	85	0	6385
24301	243	67	5945	77	0	6332
24302	5540	42	243	97	0	5922
24303	5717	30	74	60	0	5881
24304	254	32	68	5603	0	5957
24305	119	27	5620	205	0	5971
24306	102	25	214	5287	0	5628
24307	81	19	102	5406	0	5608
24308	76	5307	60	259	0	5702
24309	71	175	46	5249	0	5541
24310	70	5235	49	233	0	5587
24311	67	201	43	5295	0	5606
24312	5221	65	39	251	0	5576
24313	228	64	40	5250	0	5582
24314	126	39	5178	248	0	5591
24315	5125	33	209	117	0	5484
24316	246	29	5251	97	0	5623
24317	5247	27	219	92	0	5585
24318	5385	24	87	100	0	5596
24319	252	5172	74	100	0	5598
24320	122	5551	63	101	0	5837
24321	5422	229	65	91	0	5807
24322	5611	109	50	75	0	5845
24323	5555	60	55	94	0	5764
24324	5553	60	43	95	0	5751
24325	5571	33	42	96	0	5742
24326	331	40	49	5351	0	5771
24327	171	36	41	5544	0	5792
24328	133	38	5380	268	0	5819
24329	5288	35	214	133	0	5670
24330	263	43	112	5299	0	5717
24331	160	32	74	5489	0	5755
24332	124	45	5328	283	0	5780
24333	138	5001	208	154	0	5501
24334	119	5365	108	113	0	5705
24335	5211	260	81	106	0	5658
24336	5036	83	73	77	0	5269
24337	299	4569	61	93	0	5022
24338	149	4720	54	72	0	4995
24339	4699	203	54	77	0	5033
24340	4889	74	46	81	0	5090
24341	271	44	43	4686	0	5044
24342	129	32	48	4827	0	5036
24343	116	37	52	4942	0	5147
24344	4683	42	58	292	0	5075
24345	4812	48	55	137	0	5052
24346	287	32	57	4778	0	5154
24347	4962	37	44	262	0	5305
24348	278	50	4912	136	0	5376
24349	149	61	200	4944	0	5354
24350	142	56	4918	234	0	5350
24351	122	4828	220	108	0	5278
24352	116	209	98	4817	0	5240
24353	4808	76	77	228	0	5189
24354	267	55	59	4762	0	5143
24355	152	39	42	4854	0	5087
24356	127	36	4598	284	0	5045
24357	105	41	4656	166	0	4968
24358	107	4706	213	118	0	5144
24359	4786	194	89	96	0	5165
24360	4900	85	60	96	0	5141
24361	4920	47	48	88	0	5103
24362	4948	50	58	77	0	5133
24363	295	42	40	4768	0	5145
24364	164	37	49	4690	0	4940
24365	133	4728	48	247	0	5156
24366	4781	193	48	147	0	5169
24367	4878	72	53	97	0	5100
24368	276	45	4562	79	0	4962
24369	4061	43	141	52	0	4297
24370	201	4126	66	50	0	4443
24371	110	181	25	3906	0	4222
24372	99	4090	30	149	0	4368
24373	4099	159	39	76	0	4373
24374	187	4008	28	55	0	4278
24375	110	149	22	3892	0	4173
24376	79	64	23	4022	0	4188
24377	75	40	7	3924	0	4046
24378	72	3778	20	200	0	4070
24379	73	160	18	3829	0	4080
24380	82	84	28	3771	0	3965
24381	46	3359	22	170	0	3597
24382	39	3290	23	68	0	3420
24383	3007	118	20	50	0	3195
24384	110	3054	14	40	0	3218
24385	2896	85	8	16	0	3005
24386	107	40	2789	24	0	2960
24387	46	2757	69	29	0	2901
24388	2728	78	46	30	0	2882
24389	2751	35	18	23	0	2827
24390	104	28	2671	18	0	2821
24391	45	20	69	2673	0	2807
24392	38	10	2734	89	0	2871
24393	26	2676	76	47	0	2825
24394	2624	84	32	25	0	2765
24395	80	2613	10	24	0	2727
24396	46	72	8	2601	0	2727
24397	31	38	10	2657	0	2736
24398	22	27	2616	91	0	2756
24399	33	25	2502	33	0	2593
24400	2475	22	87	31	0	2615
24401	2601	12	32	21	0	2666
24402	2617	17	19	25	0	2678
24403	2603	15	10	35	0	2663
24404	101	2581	6	28	0	2716
24405	55	73	13	2614	0	2755
24406	40	32	16	2647	0	2735
24407	24	2701	16	92	0	2833
24408	2771	82	10	48	0	2911
24409	2817	33	12	31	0	2893
24410	112	22	2774	19	0	2927
24411	2789	21	78	22	0	2910
24412	97	19	32	2819	0	2967
24413	51	16	2791	90	0	2948
24414	39	27	77	2765	0	2908
24415	39	18	2804	89	0	2950
24416	29	18	2741	48	0	2836
24417	24	25	100	2595	0	2744
24418	21	2643	36	63	0	2763
24419	2665	72	21	37	0	2795
24420	2580	35	14	17	0	2646
24421	92	2656	9	30	0	2787
24422	37	2796	19	17	0	2869
24423	2839	86	19	21	0	2965
24424	2876	30	10	25	0	2941
24425	2883	25	10	19	0	2937
24426	2888	14	8	16	0	2926
24427	106	15	5	2892	0	3018
24428	48	12	2808	70	0	2938
24429	27	2803	59	29	0	2918
24430	2771	60	26	20	0	2877
24431	71	2863	12	21	0	2967
24432	2902	62	10	15	0	2989
24433	2927	24	7	9	0	2967
24434	79	19	2934	10	0	3042
24435	36	2993	56	9	0	3094
24436	24	62	24	3000	0	3110
24437	23	20	11	3081	0	3135
24438	18	20	13	2895	0	2946
24439	3033	16	10	72	0	3131
24440	2918	8	8	31	0	2965
24441	2956	9	17	22	0	3004
24442	70	2927	11	29	0	3037
24443	2896	52	8	16	0	2972
24444	61	2900	5	14	0	2980
24445	38	47	2863	16	0	2964
24446	21	2873	50	5	0	2949
24447	44	74	29	2610	0	2757
24448	15	14	3	2582	0	2614
24449	10	11	2581	39	0	2641
24450	11	8	33	2457	0	2509
24451	11	9	9	2556	0	2585
24452	2600	5	10	48	0	2663
24453	2526	13	6	20	0	2565
24454	2590	4	6	16	0	2616
24455	46	2607	4	15	0	2672
24456	2608	34	6	9	0	2657
24457	2546	12	5	11	0	2574
24458	46	2574	5	11	0	2636
24459	21	38	5	2581	0	2645
24460	16	10	10	2593	0	2629
24461	2587	8	7	46	0	2648
24462	45	12	2540	13	0	2610
24463	14	2419	36	12	0	2481
24464	8	45	9	2380	0	2442
24465	10	2335	3	30	0	2378
24466	7	2389	7	10	0	2413
24467	2412	35	6	3	0	2456
24468	2401	9	2	12	0	2424
24469	50	8	4	2420	0	2482
24470	14	11	4	2390	0	2419
24471	16	5	3	2412	0	2436
24472	12	8	2	2405	0	2427
24473	8	10	2319	39	0	2376
24474	14	3	2215	20	0	2252
24475	12	3	39	2338	0	2392
24476	10	6	2480	39	0	2535
24477	12	2490	35	21	0	2558
24478	2553	36	10	16	0	2615
24479	2596	14	10	14	0	2634
24480	49	7	7	2591	0	2654
24481	19	8	8	2608	0	2643
24482	15	10	4	2654	0	2683
24483	12	2657	4	51	0	2724
24484	2673	44	4	23	0	2744
24485	2679	10	4	17	0	2710
24486	58	6	2671	8	0	2743
24487	20	15	36	2819	0	2890
24488	12	8	2990	61	0	3071
24489	15	9	53	3220	0	3297
24490	12	11	13	3169	0	3205
24491	16	12	11	3150	0	3189
24492	16	7	9	3310	0	3342
24493	3277	10	10	100	0	3397
24494	3356	13	5	44	0	3418
24495	3516	12	2	29	0	3559
24496	122	10	6	3466	0	3604
24497	52	7	3412	105	0	3576
24498	3325	16	85	46	0	3472
24499	107	7	38	3491	0	3643
24500	3514	8	18	96	0	3636
24501	97	12	20	3525	0	3654
24502	47	3367	8	114	0	3536
24503	35	3645	14	49	0	3743
24504	34	100	24	3636	0	3794
24505	30	37	11	3607	0	3685
24506	24	15	4	3616	0	3659
24507	19	3498	2	135	0	3654
24508	3481	84	2	47	0	3614
24509	99	3497	12	29	0	3637
24510	47	93	3504	18	0	3662
24511	26	30	91	3478	0	3625
24512	12	3617	44	103	0	3776
24513	24	86	16	3646	0	3772
24514	9	34	12	3704	0	3759
24515	20	15	3617	140	0	3792
24516	3347	11	88	79	0	3525
24517	97	3777	34	34	0	3942
24518	3832	98	12	28	0	3970
24519	3938	38	4	36	0	4016
24520	3965	26	7	31	0	4029
24521	146	17	3665	41	0	3869
24522	59	24	95	3604	0	3782
24523	44	9	39	3668	0	3760
24524	25	21	3548	154	0	3748
24525	3289	15	103	73	0	3480
24526	115	14	3587	42	0	3758
24527	52	32	3485	24	0	3593
24528	28	3541	117	35	0	3721
24529	30	91	43	3551	0	3715
24530	18	40	3571	111	0	3740
24531	3283	14	84	58	0	3439
24532	3452	27	37	37	0	3553
24533	137	15	3436	27	0	3615
24534	61	16	98	3396	0	3571
24535	47	22	3511	100	0	3680
24536	21	3561	102	57	0	3741
24537	3749	98	45	42	0	3934
24538	3829	40	25	33	0	3927
24539	3901	17	29	31	0	3978
24540	152	14	26	3802	0	3994
24541	58	13	27	3928	0	4026
24542	30	21	3795	143	0	3989
24543	3705	30	104	62	0	3901
24544	135	15	48	3827	0	4025
24545	3834	8	41	117	0	4000
24546	141	20	3794	58	0	4013
24547	64	16	3899	48	0	4027
24548	41	12	154	3727	0	3934
24549	43	14	65	3966	0	4088
24550	50	11	3912	145	0	4118
24551	3712	21	117	78	0	3928
24552	137	15	59	3760	0	3971
24553	64	3969	49	121	0	4203
24554	4005	105	31	77	0	4218
24555	128	4053	31	58	0	4270
24556	4084	103	35	41	0	4263
24557	153	43	4146	37	0	4379
24558	90	19	4026	36	0	4171
24559	46	4105	140	64	0	4355
24560	4105	113	78	45	0	4341
24561	144	50	4085	33	0	4312
24562	3923	22	132	41	0	4118
24563	142	4088	68	52	0	4350
24564	78	98	57	4199	0	4432
24565	44	51	62	4145	0	4302
24566	55	4104	31	147	0	4337
24567	4366	100	43	83	0	4592
24568	4582	59	46	31	0	4718
24569	4681	22	32	33	0	4768
24570	167	41	4565	44	0	4817
24571	92	25	118	4568	0	4803
24572	55	25	79	4632	0	4791
24573	56	30	53	4773	0	4912
24574	54	40	4605	164	0	4863
24575	64	4539	124	80	0	4807
24576	4430	117	74	43	0	4664
24577	147	57	4493	37	0	4734
24578	4359	43	119	51	0	4572
24579	139	4439	70	50	0	4698
24580	4520	101	53	48	0	4722
24581	142	75	39	4459	0	4715
24582	4530	37	37	123	0	4727
24583	152	20	44	4532	0	4748
24584	77	32	4630	128	0	4867
24585	76	46	105	4584	0	4811
24586	65	31	4585	124	0	4805
24587	4149	21	114	65	0	4349
24588	119	4279	57	59	0	4514
24589	65	86	42	3916	0	4109
24590	42	4173	30	91	0	4336
24591	4176	78	30	51	0	4335
24592	4149	28	41	40	0	4258
24593	108	4127	36	29	0	4300
24594	4129	69	25	44	0	4267
24595	4195	35	31	38	0	4299
24596	78	24	34	4122	0	4258
24597	50	28	22	4139	0	4239
24598	4260	22	21	81	0	4384
24599	4337	20	22	34	0	4413
24600	122	28	16	4208	0	4374
24601	70	22	17	4487	0	4596
24602	4531	19	15	118	0	4683
24603	105	22	4448	65	0	4640
24604	4226	13	87	45	0	4371
24605	121	20	4368	25	0	4534
24606	61	4298	89	33	0	4481
24607	50	94	38	4329	0	4511
24608	51	32	4409	87	0	4579
24609	47	4478	83	37	0	4645
24610	4420	79	37	37	0	4573
24611	98	36	4414	28	0	4576
24612	4272	29	72	27	0	4400
24613	4462	23	33	37	0	4555
24614	4540	14	24	39	0	4617
24615	105	22	25	4361	0	4513
24616	60	4455	23	68	0	4606
24617	4317	63	22	43	0	4445
24618	92	28	4393	28	0	4541
24619	4010	19	64	34	0	4127
24620	102	11	4386	27	0	4526
24621	49	4366	65	29	0	4509
24622	39	61	34	4417	0	4551
24623	35	31	31	4384	0	4481
24624	40	4361	28	76	0	4505
24625	49	66	25	4441	0	4581
24626	43	25	4485	74	0	4627
24627	28	4471	77	47	0	4623
24628	32	95	42	4430	0	4599
24629	4408	34	28	77	0	4547
24630	4597	23	21	45	0	4686
24631	110	32	20	4658	0	4820
24632	75	4812	24	84	0	4995
24633	33	84	32	4849	0	4998
24634	47	37	17	4810	0	4911
24635	44	20	4527	128	0	4719
24636	46	4553	69	53	0	4721
24637	29	63	22	4468	0	4582
24638	25	30	4372	80	0	4507
24639	22	4338	69	45	0	4474
24640	23	68	28	4422	0	4541
24641	4434	25	25	82	0	4566
24642	76	4530	25	33	0	4664
24643	47	68	10	4585	0	4710
24644	4741	43	16	85	0	4885
24645	4775	24	11	56	0	4866
24646	4780	23	12	39	0	4854
24647	4734	19	24	28	0	4805
24648	119	25	11	4676	0	4831
24649	60	23	4721	87	0	4891
24650	50	21	69	4592	0	4732
24651	40	4686	29	75	0	4830
24652	4730	60	20	61	0	4871
24653	90	30	4578	30	0	4728
24654	4391	30	58	20	0	4499
24655	85	22	4518	40	0	4665
24656	53	10	68	4511	0	4642
24657	38	15	4591	58	0	4702
24658	41	24	62	4471	0	4598
24659	43	8	4564	74	0	4689
24660	32	21	69	4465	0	4587
24661	4567	9	34	73	0	4683
24662	74	4797	30	47	0	4948
24663	48	64	18	4853	0	4983
24664	40	24	20	4840	0	4924
24665	35	25	4901	85	0	5046
24666	31	17	4598	59	0	4705
24667	4477	11	87	44	0	4619
24668	74	4658	41	25	0	4798
24669	4619	55	31	25	0	4730
24670	4646	31	13	35	0	4725
24671	89	15	23	4522	0	4649
24672	32	4660	22	83	0	4797
24673	4789	51	28	40	0	4908
24674	4833	28	25	35	0	4921
24675	4856	29	17	30	0	4932
24676	4891	16	13	31	0	4951
24677	4820	14	22	19	0	4875
24678	86	19	4658	24	0	4787
24679	4613	14	55	25	0	4707
24680	84	18	4716	20	0	4838
24681	58	14	66	4611	0	4749
24682	46	8	28	4817	0	4899
24683	42	10	4690	81	0	4823
24684	4537	16	59	47	0	4659
24685	85	9	35	4694	0	4823
24686	50	17	18	4850	0	4935
24687	33	13	27	4909	0	4982
24688	41	11	9	4870	0	4931
24689	30	9	15	4970	0	5024
24690	23	22	4910	101	0	5056
24691	37	10	69	4811	0	4927
24692	33	8	4917	99	0	5057
24693	34	17	4666	56	0	4773
24694	4738	14	99	52	0	4903
24695	5002	8	51	40	0	5101
24696	5393	12	33	39	0	5477
24697	136	9	5548	43	0	5736
24698	68	11	5604	36	0	5719
24699	42	6	5705	35	0	5788
24700	28	5852	153	35	0	6068
24701	39	143	90	5716	0	5988
24702	6025	43	34	132	0	6234
24703	134	12	20	6428	0	6594
24704	64	6533	33	136	0	6766
24705	6663	128	23	84	0	6898
24706	150	57	26	6607	0	6840
24707	74	6731	34	148	0	6987
24708	46	133	26	6855	0	7060
24709	43	61	26	6839	0	6969
24710	6705	27	21	217	0	6970
24711	162	22	34	6729	0	6947
24712	90	25	6617	178	0	6910
24713	54	26	162	6510	0	6752
24714	48	6330	88	168	0	6634
24715	39	6698	55	109	0	6901
24716	28	185	53	6478	0	6744
24717	48	84	47	6487	0	6666
24718	37	6353	30	228	0	6648
24719	34	6440	27	134	0	6635
24720	53	6609	23	80	0	6765
24721	46	217	18	6088	0	6369
24722	32	6557	18	160	0	6767
24723	6446	190	20	116	0	6772
24724	158	104	6473	101	0	6836
24725	94	80	137	6276	0	6587
24726	56	6542	63	193	0	6854
24727	6427	164	39	133	0	6763
24728	175	105	6467	87	0	6834
24729	85	6472	145	106	0	6808
24730	6252	184	90	81	0	6607
24731	156	6200	43	72	0	6471
24732	69	6282	38	66	0	6455
24733	40	239	25	6164	0	6468
24734	43	6345	27	162	0	6577
24735	6259	201	12	103	0	6575
24736	138	125	30	6211	0	6504
24737	73	103	6152	172	0	6500
24738	56	85	6130	95	0	6366
24739	33	81	179	6143	0	6436
24740	33	87	6243	158	0	6521
24741	44	73	151	6219	0	6487
24742	6070	65	80	173	0	6388
24743	158	51	6067	110	0	6386
24744	89	79	147	5748	0	6063
24745	76	5820	85	161	0	6142
24746	33	171	68	5992	0	6264
24747	47	119	39	5915	0	6120
24748	59	5916	50	200	0	6225
24749	39	180	48	6088	0	6355
24750	42	121	47	6131	0	6341
24751	41	77	6010	229	0	6357
24752	35	5949	151	115	0	6250
24753	5954	181	90	88	0	6313
24754	153	103	45	6051	0	6352
24755	82	67	6075	192	0	6416
24756	53	60	175	6000	0	6288
24757	39	45	5985	227	0	6296
24758	5682	55	213	127	0	6077
24759	137	5947	106	118	0	6308
24760	91	170	65	6073	0	6399
24761	65	89	74	6226	0	6454
24762	5844	56	52	259	0	6211
24763	156	83	46	5889	0	6174
24764	83	64	5830	222	0	6199
24765	55	58	150	5623	0	5886
24766	38	5534	84	203	0	5859
24767	33	5746	52	148	0	5979
24768	45	5834	37	140	0	6056
24769	40	234	50	5793	0	6117
24770	47	127	5656	202	0	6032
24771	44	5642	147	149	0	5982
24772	5477	185	103	96	0	5861
24773	156	5670	59	98	0	5983
24774	5708	197	45	98	0	6048
24775	5745	94	72	100	0	6011
24776	197	64	5668	96	0	6025
24777	5759	82	162	80	0	6083
24778	6075	65	81	105	0	6326
24779	5727	75	59	103	0	5964
24780	6077	75	44	83	0	6279
24781	217	77	6011	87	0	6392
24782	5927	63	154	73	0	6217
24783	6232	70	82	81	0	6465
24784	208	6286	55	77	0	6626
24785	108	192	51	6268	0	6619
24786	77	129	45	6262	0	6513
24787	76	6243	40	221	0	6580
24788	6205	195	55	110	0	6565
24789	164	6325	57	72	0	6618
24790	6181	177	42	47	0	6447
24791	6224	111	46	47	0	6428
24792	239	6232	33	44	0	6548
24793	142	180	25	6237	0	6584
24794	92	89	6313	153	0	6647
24795	89	6077	147	81	0	6394
24796	83	232	64	5438	0	5817
24797	65	5613	36	119	0	5833
24798	54	5966	20	55	0	6095
24799	53	212	26	5625	0	5916
24800	42	49	5805	128	0	6024
24801	42	5580	117	54	0	5793
24802	34	5570	45	29	0	5678
24803	4911	109	16	19	0	5055
24804	78	39	14	5005	0	5136
24805	29	29	7	5069	0	5134
24806	14	23	6	5189	0	5232
24807	18	13	5019	129	0	5179
24808	15	19	108	4992	0	5134
24809	9	5187	26	131	0	5353
24810	5338	119	11	51	0	5519
24811	123	37	10	5363	0	5533
24812	37	22	5308	143	0	5510
24813	5374	26	118	50	0	5568
24814	148	18	42	5609	0	5817
24815	46	22	5864	150	0	6082
24816	22	34	5880	46	0	5982
24817	5869	18	185	38	0	6110
24818	6231	15	58	41	0	6345
24819	6197	23	35	27	0	6282
24820	6282	24	25	27	0	6358
24821	208	21	6136	33	0	6398
24822	69	6236	158	37	0	6500
24823	6293	163	49	41	0	6546
24824	183	6274	24	25	0	6506
24825	6276	165	23	31	0	6495
24826	174	6307	20	31	0	6532
24827	82	169	21	6297	0	6569
24828	39	68	23	6416	0	6546
24829	32	35	15	6331	0	6413
24830	37	6100	35	192	0	6364
24831	38	6370	21	69	0	6498
24832	40	188	12	6037	0	6277
24833	29	6164	26	175	0	6394
24834	35	175	6146	62	0	6418
24835	36	68	154	6126	0	6384
24836	36	45	6196	179	0	6456
24837	6016	47	162	64	0	6289
24838	6241	55	57	45	0	6398
24839	213	39	6142	44	0	6438
24840	89	39	6132	50	0	6310
24841	63	39	198	6025	0	6325
24842	57	41	6147	185	0	6430
24843	55	38	192	5840	0	6125
24844	56	5536	90	184	0	5866
24845	42	183	44	6267	0	6536
24846	44	65	40	6390	0	6539
24847	44	44	42	6359	0	6489
24848	28	54	6101	232	0	6415
24849	45	51	173	5964	0	6233
24850	49	46	65	6067	0	6227
24851	44	60	48	5949	0	6101
24852	47	6047	59	204	0	6357
24853	6105	177	41	101	0	6424
24854	6136	74	46	96	0	6352
24855	6148	47	49	69	0	6313
24856	230	44	39	5997	0	6310
24857	106	38	5889	196	0	6229
24858	86	53	5829	108	0	6076
24859	62	5973	192	85	0	6312
24860	5753	183	85	84	0	6105
24861	163	5861	61	79	0	6164
24862	5932	201	53	79	0	6265
24863	172	5943	53	81	0	6249
24864	5823	193	50	94	0	6160
24865	191	6131	49	74	0	6445
24866	85	205	57	6181	0	6528
24867	84	97	6071	210	0	6462
24868	74	52	6101	128	0	6355
24869	74	48	212	6019	0	6353
24870	68	61	100	6078	0	6307
24871	65	63	79	6279	0	6486
24872	71	51	6129	243	0	6494
24873	84	49	190	5990	0	6313
24874	5896	45	89	244	0	6274
24875	5980	31	86	122	0	6219
24876	221	5822	80	91	0	6214
24877	5748	175	56	105	0	6084
24878	222	5686	52	96	0	6056
24879	5690	197	70	68	0	6025
24880	5754	110	48	74	0	5986
24881	5591	77	50	60	0	5778
24882	268	66	5480	57	0	5871
24883	125	65	5378	61	0	5629
24884	5332	54	208	71	0	5665
24885	5597	45	93	68	0	5803
24886	248	47	73	5424	0	5792
24887	140	37	53	5670	0	5900
24888	96	38	51	5802	0	5987
24889	81	51	51	5817	0	6000
24890	54	56	59	6079	0	6248
24891	5851	63	37	279	0	6230
24892	233	60	33	5896	0	6222
24893	106	65	5796	233	0	6200
24894	5583	49	176	134	0	5942
24895	5876	46	69	105	0	6096
24896	245	5703	57	91	0	6096
24897	92	5804	56	72	0	6024
24898	5271	168	31	42	0	5512
24899	150	5426	29	43	0	5648
24900	5278	141	56	34	0	5509
24901	5708	56	36	46	0	5846
24902	5816	33	27	44	0	5920
24903	218	18	32	5507	0	5775
24904	89	5636	29	153	0	5907
24905	5693	128	19	78	0	5918
24906	157	46	26	5666	0	5895
24907	74	28	24	5675	0	5801
24908	5426	17	12	187	0	5642
24909	131	5320	19	79	0	5549
24910	58	116	4	5351	0	5529
24911	5393	45	12	146	0	5596
24912	140	5523	9	68	0	5740
24913	5567	115	2	46	0	5730
24914	135	51	5115	39	0	5340
24915	5165	23	81	29	0	5298
24916	134	5361	24	23	0	5542
24917	5274	108	17	25	0	5424
24918	5295	34	10	17	0	5356
24919	146	5405	5	15	0	5571
24920	5421	112	3	21	0	5557
24921	132	5309	8	16	0	5465
24922	5412	118	0	18	0	5548
24923	135	47	3	5332	0	5517
24924	67	30	7	5366	0	5470
24925	49	21	3	5455	0	5528
24926	39	19	5225	148	0	5431
24927	36	16	106	5220	0	5378
24928	38	27	5218	132	0	5415
24929	36	32	110	5130	0	5308
24930	35	5232	42	126	0	5435
24931	43	105	22	5366	0	5536
24932	34	54	5340	126	0	5554
24933	41	34	5445	57	0	5577
24934	32	33	131	5388	0	5584
24935	5372	24	42	130	0	5568
24936	5435	24	24	68	0	5551
24937	149	5448	18	51	0	5666
24938	78	110	16	5519	0	5723
24939	44	45	5628	138	0	5855
24940	50	33	108	5624	0	5815
24941	46	19	5669	142	0	5876
24942	5436	27	129	66	0	5658
24943	146	28	44	5644	0	5862
24944	73	24	5510	142	0	5749
24945	46	29	120	5485	0	5680
24946	50	30	56	5597	0	5733
24947	46	18	5520	178	0	5762
24948	40	18	119	5541	0	5718
24949	5517	19	59	159	0	5754
24950	5649	23	29	80	0	5781
24951	173	26	23	5612	0	5834
24952	5659	16	34	155	0	5864
24953	163	28	5640	79	0	5910
24954	75	28	5560	58	0	5721
24955	5632	17	158	54	0	5861
24956	5923	13	66	59	0	6061
24957	178	20	46	5747	0	5991
24958	85	19	42	5867	0	6013
24959	58	18	5713	191	0	5980
24960	67	24	133	5416	0	5640
24961	36	5753	55	161	0	6005
24962	5770	125	34	80	0	6009
24963	6224	49	35	53	0	6361
24964	184	6212	33	66	0	6495
24965	5985	151	33	64	0	6233
24966	6070	57	37	47	0	6211
24967	213	6166	44	47	0	6470
24968	6198	157	41	50	0	6446
24969	211	6251	35	49	0	6546
24970	6283	187	33	53	0	6556
24971	200	79	6255	59	0	6593
24972	95	48	182	6226	0	6551
24973	68	29	65	6444	0	6606
24974	54	40	55	6746	0	6895
24975	6584	27	37	264	0	6912
24976	229	11	30	6789	0	7059
24977	93	36	6730	248	0	7107
24978	6705	27	196	132	0	7060
24979	233	22	70	6748	0	7073
24980	100	6553	62	236	0	6951
24981	70	6877	54	120	0	7121
24982	68	224	44	6749	0	7085
24983	81	86	37	6772	0	6976
24984	64	55	48	6879	0	7046
24985	60	36	6487	301	0	6884
24986	66	6427	196	146	0	6835
24987	6283	170	74	124	0	6651
24988	6266	73	60	90	0	6489
24989	248	6127	48	80	0	6503
24990	101	6274	43	75	0	6493
24991	105	210	41	6133	0	6489
24992	70	63	6074	209	0	6416
24993	5712	68	183	109	0	6072
24994	6032	50	62	88	0	6232
24995	214	20	63	5920	0	6217
24996	104	26	32	6013	0	6175
24997	5790	37	25	224	0	6076
24998	189	31	5762	106	0	6088
24999	5465	32	150	116	0	5763
25000	205	5611	60	70	0	5946
25001	77	146	38	5057	0	5318
25002	57	5149	21	149	0	5376
25003	5204	147	24	82	0	5457
25004	164	36	23	5098	0	5321
25005	91	36	27	4999	0	5153
25006	70	5023	31	160	0	5284
25007	5062	130	28	68	0	5288
25008	5093	47	23	64	0	5227
25009	165	44	4934	55	0	5198
25010	90	37	4728	38	0	4893
25011	4647	20	134	50	0	4851
25012	137	16	4655	48	0	4856
25013	50	30	4396	37	0	4513
25014	4312	32	135	41	0	4520
25015	129	12	4789	34	0	4964
25016	57	13	137	4767	0	4974
25017	40	17	60	4878	0	4995
25018	5137	7	50	175	0	5369
25019	180	22	5190	85	0	5477
25020	5396	13	185	53	0	5647
25021	216	22	68	5464	0	5770
25022	5555	16	60	189	0	5820
25023	5702	16	46	80	0	5844
25024	5787	9	28	94	0	5918
25025	289	14	32	5605	0	5940
25026	5708	11	29	193	0	5941
25027	287	9	27	5627	0	5950
25028	153	13	26	5734	0	5926
25029	124	18	20	5775	0	5937
25030	118	11	23	5822	0	5974
25031	5591	17	25	316	0	5949
25032	5668	14	24	175	0	5881
25033	287	15	5550	128	0	5980
25034	5650	12	184	100	0	5946
25035	5860	15	68	94	0	6037
25036	302	9	54	5609	0	5974
25037	165	5553	35	247	0	6000
25038	5733	175	31	125	0	6064
25039	305	63	31	5502	0	5901
25040	5479	43	28	254	0	5804
25041	294	5388	42	104	0	5828
25042	5566	185	24	92	0	5867
25043	299	72	18	5373	0	5762
25044	138	5319	16	241	0	5714
25045	5428	218	19	109	0	5774
25046	273	5262	21	110	0	5666
25047	137	5618	18	98	0	5871
25048	5600	260	28	84	0	5972
25049	262	127	5452	78	0	5919
25050	5599	93	181	61	0	5934
25051	311	64	72	5511	0	5958
25052	168	62	5514	210	0	5954
25053	171	46	202	5447	0	5866
25054	120	60	90	5632	0	5902
25055	122	57	5480	300	0	5959
25056	5436	40	218	153	0	5847
25057	263	33	91	5516	0	5903
25058	171	34	64	5697	0	5966
25059	146	35	44	5665	0	5890
25060	5501	36	51	358	0	5946
25061	282	24	5275	220	0	5801
25062	130	38	5340	171	0	5679
25063	124	35	216	4996	0	5371
25064	108	24	4928	238	0	5298
25065	4800	39	211	157	0	5207
25066	223	4839	105	136	0	5303
25067	4798	147	95	87	0	5127
25068	234	67	88	4592	0	4981
25069	148	4663	71	192	0	5074
25070	112	170	74	4638	0	4994
25071	114	4661	52	224	0	5051
25072	80	175	40	4780	0	5075
25073	95	90	4604	221	0	5010
25074	85	77	4381	152	0	4695
25075	96	4453	173	131	0	4853
25076	4197	146	93	108	0	4544
25077	168	85	75	4127	0	4455
25078	101	55	47	4177	0	4380
25079	4138	57	41	217	0	4453
25080	4172	43	58	134	0	4407
25081	211	40	55	4111	0	4417
25082	134	46	4015	190	0	4385
25083	116	4033	156	111	0	4416
25084	116	133	88	4101	0	4438
25085	102	73	63	4090	0	4328
25086	93	4193	48	232	0	4566
25087	4253	164	39	144	0	4600
25088	178	87	4224	114	0	4603
25089	113	70	136	4198	0	4517
25090	79	68	83	4202	0	4432
25091	70	61	4085	232	0	4448
25092	74	44	154	4186	0	4458
25093	4178	50	86	248	0	4562
25094	4235	55	72	146	0	4508
25095	4296	32	61	120	0	4509
25096	222	4111	66	129	0	4528
25097	4404	143	59	91	0	4697
25098	242	73	52	4283	0	4650
25099	142	57	55	4282	0	4536
25100	119	4721	43	232	0	5115
25101	5170	191	42	126	0	5529
25102	5436	108	47	113	0	5704
25103	5518	72	47	112	0	5749
25104	5634	75	35	115	0	5859
25105	5634	59	50	103	0	5846
25106	347	51	5402	93	0	5893
25107	5571	58	205	102	0	5936
25108	5725	43	98	103	0	5969
25109	5666	27	96	93	0	5882
25110	375	39	68	5414	0	5896
25111	233	35	51	5574	0	5893
25112	186	32	5289	294	0	5801
25113	4583	34	202	198	0	5017
25114	272	5145	116	142	0	5675
25115	151	4879	61	84	0	5175
25116	125	182	4731	76	0	5114
25117	85	4579	160	88	0	4912
25118	69	4577	62	67	0	4775
25119	108	255	66	3856	0	4285
25120	46	4096	26	116	0	4284
25121	4027	131	17	48	0	4223
25122	3982	54	21	40	0	4097
25123	175	37	21	3830	0	4063
25124	84	19	3783	120	0	4006
25125	3731	35	111	44	0	3921
25126	171	14	3766	40	0	3991
25127	88	13	3846	32	0	3979
25128	73	19	134	3624	0	3850
25129	60	12	57	3820	0	3949
25130	63	15	3807	138	0	4023
25131	47	3616	117	79	0	3859
25132	36	3887	52	57	0	4032
25133	3774	118	32	41	0	3965
25134	3852	41	22	25	0	3940
25135	138	27	3749	17	0	3931
25136	3684	16	84	20	0	3804
25137	3877	20	42	16	0	3955
25138	129	12	21	3791	0	3953
25139	75	13	6	3875	0	3969
25140	49	11	15	3918	0	3993
25141	3893	15	12	116	0	4036
25142	3963	19	6	53	0	4041
25143	4028	11	12	34	0	4085
25144	166	13	6	3954	0	4139
25145	84	10	3894	97	0	4085
25146	3872	11	84	49	0	4016
25147	3888	9	43	32	0	3972
25148	158	8	30	3732	0	3928
25149	94	3828	18	93	0	4033
25150	62	82	16	3827	0	3987
25151	48	3874	18	111	0	4051
25152	50	95	21	3765	0	3931
25153	45	3875	24	106	0	4050
25154	3770	102	22	45	0	3939
25155	115	44	16	3723	0	3898
25156	56	3748	18	94	0	3916
25157	41	103	3711	44	0	3899
25158	3619	47	95	41	0	3802
25159	110	50	33	3666	0	3859
25160	55	3655	29	89	0	3828
25161	51	95	14	3572	0	3732
25162	44	3534	18	101	0	3697
25163	42	3821	20	46	0	3929
25164	3760	107	30	38	0	3935
25165	3859	62	19	31	0	3971
25166	126	36	3818	23	0	4003
25167	3769	18	96	27	0	3910
25168	3851	27	48	20	0	3946
25169	125	3718	27	32	0	3902
25170	64	96	21	3781	0	3962
25171	46	35	25	3821	0	3927
25172	41	38	3751	114	0	3944
25173	48	28	3649	54	0	3779
25174	3731	22	116	32	0	3901
25175	3865	14	47	28	0	3954
25176	3888	15	41	30	0	3974
25177	150	13	3756	23	0	3942
25178	76	8	104	3697	0	3885
25179	3792	18	38	105	0	3953
25180	110	11	25	3788	0	3934
25181	55	11	3719	113	0	3898
25182	3569	11	92	55	0	3727
25183	116	9	3800	38	0	3963
25184	68	3732	89	26	0	3915
25185	3777	81	43	28	0	3929
25186	107	31	3741	19	0	3898
25187	65	24	84	3661	0	3834
25188	3743	16	35	97	0	3891
25189	109	13	26	3741	0	3889
25190	3786	22	10	116	0	3934
25191	101	21	13	3782	0	3917
25192	3790	16	11	119	0	3936
25193	3808	18	13	54	0	3893
25194	3778	18	11	46	0	3853
25195	3776	16	9	27	0	3828
25196	149	16	17	3672	0	3854
25197	69	17	3531	75	0	3692
25198	60	9	3507	45	0	3621
25199	34	3394	86	35	0	3549
25200	23	3051	26	17	0	3117
25201	2570	38	90	17	0	2715
25202	29	4	5	2409	0	2447
25203	4	5	2431	18	0	2458
25204	5	1	2453	9	0	2468
25205	11	15	26	2453	0	2505
25206	2510	2	5	21	0	2538
25207	21	2503	2	6	0	2532
25208	2733	17	1	10	0	2761
25209	19	3	3	2761	0	2786
25210	9	2	4	2776	0	2791
25211	7	2	4	2806	0	2819
25212	6	1	2793	22	0	2822
25213	7	1	2687	13	0	2708
25214	1	2729	23	5	0	2758
25215	8	21	7	2836	0	2872
25216	2773	5	5	28	0	2811
25217	23	4	2695	11	0	2733
25218	9	5	2733	7	0	2754
25219	9	4	28	2806	0	2847
25220	8	3	11	2915	0	2937
25221	5	7	6	2949	0	2967
25222	8	3	7	3193	0	3211
25223	3306	2	5	59	0	3372
25224	52	2	9	3343	0	3406
25225	3333	10	6	69	0	3418
25226	63	4	3422	23	0	3512
25227	19	3440	62	14	0	3535
25228	13	58	14	3464	0	3549
25229	11	15	3526	69	0	3621
25230	17	6	3421	24	0	3468
25231	11	3482	78	15	0	3586
25232	11	56	18	3389	0	3474
25233	10	14	18	3436	0	3478
25234	7	10	3445	76	0	3538
25235	3281	7	64	28	0	3380
25236	66	6	22	3442	0	3536
25237	17	2	18	3435	0	3472
25238	8	9	3498	78	0	3593
25239	12	3393	66	36	0	3507
25240	9	3738	19	23	0	3789
25241	3752	84	13	22	0	3871
25242	92	17	11	3768	0	3888
25243	3957	12	14	90	0	4073
25244	106	13	3938	34	0	4091
25245	33	6	104	3931	0	4074
25246	3917	13	35	111	0	4076
25247	4044	11	12	34	0	4101
25248	123	10	14	3976	0	4123
25249	41	2	3936	112	0	4091
25250	24	3	4055	40	0	4122
25251	17	9	127	3986	0	4139
25252	11	3	4048	111	0	4173
25253	3841	5	101	40	0	3987
25254	99	4041	39	23	0	4202
25255	4135	92	14	29	0	4270
25256	4203	24	20	26	0	4273
25257	128	8	23	4131	0	4290
25258	38	12	21	4214	0	4285
25259	4183	10	15	128	0	4336
25260	111	9	13	4194	0	4327
25261	40	12	4164	113	0	4329
25262	18	4132	93	52	0	4295
25263	30	86	34	4091	0	4241
25264	23	30	23	4138	0	4214
25265	19	13	15	4191	0	4238
25266	22	11	4046	133	0	4212
25267	23	3988	103	60	0	4174
25268	19	87	41	4114	0	4261
25269	14	29	4087	124	0	4254
25270	23	12	104	4054	0	4193
25271	4089	17	38	127	0	4271
25272	100	16	23	4127	0	4266
25273	45	12	4077	118	0	4252
25274	4007	14	110	66	0	4197
25275	108	4138	43	47	0	4336
25276	45	4348	34	34	0	4461
25277	4411	113	29	50	0	4603
25278	120	36	4545	33	0	4734
25279	49	22	106	4457	0	4634
25280	33	17	47	4662	0	4759
25281	31	16	4589	138	0	4774
25282	27	4562	98	70	0	4757
25283	29	90	54	4089	0	4262
25284	29	32	4541	123	0	4725
25285	24	18	119	4474	0	4635
25286	4520	27	46	134	0	4727
25287	109	17	4634	73	0	4833
25288	51	17	116	4652	0	4836
25289	36	21	42	4776	0	4875
25290	31	17	4640	154	0	4842
25291	38	16	117	4426	0	4597
25292	29	4100	49	157	0	4335
25293	38	100	41	4350	0	4529
25294	28	4578	37	114	0	4757
25295	4612	105	36	64	0	4817
25296	4571	40	30	60	0	4701
25297	131	17	4546	58	0	4752
25298	46	20	4520	42	0	4628
25299	35	21	4440	38	0	4534
25300	31	4448	133	42	0	4654
25301	34	95	58	4600	0	4787
25302	33	36	4710	120	0	4899
25303	40	23	120	4504	0	4687
25304	32	27	47	4637	0	4743
25305	39	17	4660	150	0	4866
25306	38	16	110	4618	0	4782
25307	21	20	51	4587	0	4679
25308	26	4422	35	150	0	4633
25309	25	94	39	4571	0	4729
25310	22	36	36	4695	0	4789
25311	24	22	4585	166	0	4797
25312	24	30	117	4512	0	4683
25313	24	13	4601	156	0	4794
25314	17	20	4524	79	0	4640
25315	4414	14	132	64	0	4624
25316	102	23	52	4392	0	4569
25317	41	4623	31	132	0	4827
25318	28	4799	31	73	0	4931
25319	42	134	42	4762	0	4980
25320	36	36	4723	144	0	4939
25321	25	4745	118	70	0	4958
25322	26	116	38	4542	0	4722
25323	17	29	4653	96	0	4795
25324	16	4702	80	41	0	4839
25325	4936	75	38	37	0	5086
25326	4927	27	27	39	0	5020
25327	4964	19	26	48	0	5057
25328	82	24	21	5299	0	5426
25329	33	16	27	5298	0	5374
25330	20	18	21	5332	0	5391
25331	18	11	5206	128	0	5363
25332	5181	15	91	64	0	5351
25333	87	12	40	5274	0	5413
25334	34	22	5158	103	0	5317
25335	5198	19	83	61	0	5361
25336	5438	16	43	46	0	5543
25337	128	59	4290	66	0	4543
25338	5195	14	71	47	0	5327
25339	91	5405	37	49	0	5582
25340	27	67	5285	22	0	5401
25341	5039	31	71	33	0	5174
25342	71	5173	35	28	0	5307
25343	11	47	20	4953	0	5031
25344	21	5034	10	64	0	5129
25345	7	58	14	5094	0	5173
25346	8	14	5085	60	0	5167
25347	4571	8	57	41	0	4677
25348	53	13	5054	22	0	5142
25349	13	4873	63	28	0	4977
25350	14	5011	13	15	0	5053
25351	4946	57	16	18	0	5037
25352	53	18	4953	10	0	5034
25353	23	8	56	4818	0	4905
25354	16	4	4939	55	0	5014
25355	8	4939	62	19	0	5028
25356	12	62	19	4654	0	4747
25357	13	4967	17	52	0	5049
25358	5098	62	24	17	0	5201
25359	5166	10	8	23	0	5207
25360	5151	10	15	16	0	5192
25361	66	11	5074	13	0	5164
25362	17	7	4939	20	0	4983
25363	4918	9	70	21	0	5018
25364	63	7	5213	12	0	5295
25365	24	4	70	4851	0	4949
25366	13	5068	17	57	0	5155
25367	5263	56	28	13	0	5360
25368	5205	14	17	21	0	5257
25369	5322	9	10	20	0	5361
25370	75	6	20	5306	0	5407
25371	16	9	10	5388	0	5423
25372	5335	14	10	79	0	5438
25373	67	5288	15	28	0	5398
25374	5224	61	8	23	0	5316
25375	70	18	6	5142	0	5236
25376	18	9	7	5150	0	5184
25377	4974	4	8	82	0	5068
25378	64	4870	8	25	0	4967
25379	4892	62	10	21	0	4985
25380	71	4920	5	11	0	5007
25381	4881	62	9	15	0	4967
25382	75	16	7	5342	0	5440
25383	5386	12	5	72	0	5475
25384	5570	10	6	24	0	5610
25385	6091	9	6	18	0	6124
25386	119	6269	6	13	0	6407
25387	44	104	6055	14	0	6217
25388	6028	27	111	20	0	6186
25389	6236	16	28	14	0	6294
25390	140	6148	16	9	0	6313
25391	50	116	8	6202	0	6376
25392	34	33	12	6327	0	6406
25393	6270	11	15	139	0	6435
25394	139	10	13	6317	0	6479
25395	49	15	6269	127	0	6460
25396	29	16	6165	44	0	6254
25397	6326	10	133	37	0	6506
25398	134	13	32	6330	0	6509
25399	46	10	20	6414	0	6490
25400	41	6	22	6498	0	6567
25401	25	15	6464	156	0	6660
25402	33	6	127	6315	0	6481
25403	29	12	31	6480	0	6552
25404	25	11	20	6587	0	6643
25405	6405	17	12	180	0	6614
25406	145	9	17	6457	0	6628
25407	53	10	6473	162	0	6698
25408	6547	18	144	61	0	6770
25409	173	9	6846	47	0	7075
25410	6866	13	166	42	0	7087
25411	6855	16	45	42	0	6958
25412	209	17	31	7063	0	7320
25413	69	7087	26	185	0	7367
25414	59	164	29	7210	0	7462
25415	59	75	28	7251	0	7413
25416	41	7278	30	221	0	7570
25417	7222	170	27	75	0	7494
25418	181	7118	19	56	0	7374
25419	7205	174	18	55	0	7452
25420	7342	57	17	47	0	7463
25421	228	27	16	7174	0	7445
25422	84	27	16	7195	0	7322
25423	64	22	6839	231	0	7156
25424	52	18	6572	89	0	6731
25425	6404	41	199	69	0	6713
25426	6665	24	56	66	0	6811
25427	226	6159	39	139	0	6563
25428	76	155	42	6110	0	6383
25429	63	32	6338	180	0	6613
25430	67	61	175	6256	0	6559
25431	6207	31	65	188	0	6491
25432	6072	18	22	77	0	6189
25433	211	5940	27	70	0	6248
25434	63	163	21	5995	0	6242
25435	54	49	24	6133	0	6260
25436	53	27	27	6089	0	6196
25437	61	35	5668	225	0	5989
25438	5285	28	146	104	0	5563
25439	5708	25	43	75	0	5851
25440	228	29	5601	68	0	5926
25441	85	5606	176	62	0	5929
25442	5677	152	57	59	0	5945
25443	5786	49	31	57	0	5923
25444	232	30	5549	61	0	5872
25445	90	40	5803	60	0	5993
25446	72	34	187	5770	0	6063
25447	88	21	5824	184	0	6117
25448	5688	36	183	85	0	5992
25449	5864	27	76	54	0	6021
25450	6032	22	44	69	0	6167
25451	232	28	48	5674	0	5982
25452	104	6126	48	176	0	6454
25453	6321	158	40	86	0	6605
25454	6342	50	37	70	0	6499
25455	265	32	6100	75	0	6472
25456	117	39	5958	75	0	6189
25457	5847	39	191	77	0	6154
25458	225	28	64	6133	0	6450
25459	106	28	6049	188	0	6371
25460	97	6011	183	92	0	6383
25461	112	167	64	6024	0	6367
25462	5972	51	60	206	0	6289
25463	190	6168	60	95	0	6513
25464	106	174	52	6091	0	6423
25465	101	6000	46	204	0	6351
25466	93	6254	48	96	0	6491
25467	97	185	47	6228	0	6557
25468	75	67	51	6309	0	6502
25469	71	6293	59	230	0	6653
25470	6335	190	43	102	0	6670
25471	242	71	6345	75	0	6733
25472	6277	48	191	77	0	6593
25473	241	52	72	6450	0	6815
25474	123	49	54	6600	0	6826
25475	95	38	67	6625	0	6825
25476	91	40	56	6588	0	6775
25477	98	36	6507	232	0	6873
25478	103	33	189	6449	0	6774
25479	93	43	72	6563	0	6771
25480	66	6740	54	271	0	7131
25481	66	194	6839	116	0	7215
25482	70	7019	209	110	0	7408
25483	73	203	7209	89	0	7574
25484	83	7159	200	66	0	7508
25485	93	219	77	6558	0	6947
25486	6504	53	43	174	0	6774
25487	169	6541	38	66	0	6814
25488	80	169	38	6641	0	6928
25489	69	53	6712	180	0	7014
25490	57	6834	169	85	0	7145
25491	6745	166	83	66	0	7060
25492	6935	63	53	54	0	7105
25493	200	6867	41	45	0	7153
25494	77	165	6731	46	0	7019
25495	6538	72	174	51	0	6835
25496	185	56	56	6942	0	7239
25497	6881	39	40	201	0	7161
25498	193	7032	43	67	0	7335
25499	83	7349	31	59	0	7522
25500	55	195	7167	60	0	7477
25501	7021	86	182	60	0	7349
25502	205	71	57	7233	0	7566
25503	7227	33	39	192	0	7491
25504	177	7247	47	84	0	7555
25505	7296	172	49	58	0	7575
25506	7269	66	37	60	0	7432
25507	209	40	7313	58	0	7620
25508	81	6856	121	42	0	7100
25509	49	7027	65	40	0	7181
25510	48	193	28	6515	0	6784
25511	32	6506	27	113	0	6678
25512	6618	125	26	45	0	6814
25513	119	6636	25	42	0	6822
25514	59	135	16	6397	0	6607
25515	34	6368	18	97	0	6517
25516	46	6257	10	38	0	6351
25517	47	6483	12	26	0	6568
25518	52	161	28	6411	0	6652
25519	22	69	19	6479	0	6589
25520	32	44	17	6390	0	6483
25521	22	6295	9	131	0	6457
25522	32	100	6219	44	0	6395
25523	35	52	6115	19	0	6221
25524	6070	63	100	19	0	6252
25525	93	35	43	6332	0	6503
25526	51	32	6378	102	0	6563
25527	37	41	6267	53	0	6398
25528	30	6630	99	32	0	6791
25529	29	117	39	6313	0	6498
25530	14	61	19	6538	0	6632
25531	6478	31	22	133	0	6664
25532	104	39	18	6473	0	6634
25533	40	32	28	6534	0	6634
25534	33	37	6701	130	0	6901
25535	30	37	95	6538	0	6700
25536	29	42	39	6930	0	7040
25537	28	34	6970	130	0	7162
25538	22	27	6849	46	0	6944
25539	21	6798	117	44	0	6980
25540	25	123	6838	52	0	7038
25541	17	53	108	6720	0	6898
25542	73	59	106	5038	0	5276
25543	34	32	6922	140	0	7128
25544	12	6825	99	92	0	7028
25545	6492	103	59	63	0	6717
25546	84	6657	43	57	0	6841
25547	40	124	28	6693	0	6885
25548	30	53	47	6766	0	6896
25549	15	6702	57	139	0	6913
25550	23	122	46	6699	0	6890
25551	15	74	42	6712	0	6843
25552	24	41	6277	160	0	6502
25553	28	6186	111	89	0	6414
25554	27	124	54	6336	0	6541
25555	34	67	6276	137	0	6514
25556	38	50	113	6242	0	6443
25557	35	46	56	6253	0	6390
25558	32	36	52	6404	0	6524
25559	29	54	39	6347	0	6469
25560	50	65	34	6195	0	6344
25561	40	6266	34	159	0	6499
25562	6211	114	36	90	0	6451
25563	101	52	6076	76	0	6305
25564	5309	53	114	91	0	5567
25565	101	54	6240	75	0	6470
25566	54	6439	116	71	0	6680
25567	36	121	6368	68	0	6593
25568	30	6434	130	61	0	6655
25569	36	129	66	5969	0	6200
25570	48	65	37	6191	0	6341
25571	35	6256	26	141	0	6458
25572	30	6541	26	81	0	6678
25573	6554	134	27	68	0	6783
25574	6702	67	41	60	0	6870
25575	6745	50	31	44	0	6870
25576	6810	40	44	53	0	6947
25577	128	54	33	6713	0	6928
25578	44	6739	30	126	0	6939
25579	6729	108	24	81	0	6942
25580	73	63	25	6499	0	6660
25581	6305	41	15	85	0	6446
25582	6054	31	16	48	0	6149
25583	73	5816	16	35	0	5940
25584	37	5643	18	21	0	5719
25585	21	5969	10	23	0	6023
25586	22	112	18	5767	0	5919
25587	11	5875	8	62	0	5956
25588	5850	58	10	35	0	5953
25589	5957	13	8	25	0	6003
25590	5922	16	1	26	0	5965
25591	5994	6	8	19	0	6027
25592	6062	11	8	23	0	6104
25593	71	8	6210	21	0	6310
25594	6217	8	64	22	0	6311
25595	77	12	6354	13	0	6456
25596	6278	2	66	12	0	6358
25597	82	11	23	6291	0	6407
25598	28	11	5947	68	0	6054
25599	15	10	6250	23	0	6298
25600	8	6685	87	17	0	6797
25601	6747	81	41	14	0	6883
25602	6930	23	10	23	0	6986
25603	107	7558	11	11	0	7687
25604	44	116	4	8704	0	8868
25605	9340	39	10	156	0	9545
25606	198	24	9436	55	0	9713
25607	63	9394	176	38	0	9671
25608	9257	190	52	24	0	9523
25609	195	9453	41	13	0	9702
25610	86	217	18	9031	0	9352
25611	56	9530	20	156	0	9762
25612	47	235	12	9164	0	9458
25613	39	9206	17	200	0	9462
25614	28	9698	12	79	0	9817
25615	9386	256	14	54	0	9710
25616	9650	107	27	42	0	9826
25617	244	87	9506	42	0	9879
25618	119	60	9267	34	0	9480
25619	92	48	9493	23	0	9656
25620	58	56	281	9520	0	9915
25621	51	53	9746	196	0	10046
25622	54	56	251	9495	0	9856
25623	55	45	103	9579	0	9782
25624	30	9648	73	266	0	10017
25625	9650	231	55	137	0	10073
25626	213	9824	39	90	0	10166
25627	90	256	38	10117	0	10501
25628	82	126	41	10143	0	10392
25629	82	93	40	10216	0	10431
25630	70	74	10043	313	0	10500
25631	63	62	247	9958	0	10330
25632	60	57	117	10142	0	10376
25633	66	55	89	10289	0	10499
25634	40	68	9826	355	0	10289
25635	53	9781	231	202	0	10267
25636	9652	253	101	150	0	10156
25637	9371	135	71	136	0	9713
25638	265	9870	60	113	0	10308
25639	149	273	56	9923	0	10401
25640	99	128	58	10242	0	10527
25641	75	119	9933	329	0	10456
25642	67	9867	238	212	0	10384
25643	69	256	119	10047	0	10491
25644	72	115	10069	317	0	10573
25645	52	105	272	9926	0	10355
25646	73	104	114	9982	0	10273
25647	74	83	10024	368	0	10549
25648	71	101	273	9835	0	10280
25649	95	99	129	9787	0	10110
25650	90	94	10054	371	0	10609
25651	91	77	280	10048	0	10496
25652	75	97	145	9665	0	9982
25653	53	80	100	10381	0	10614
25654	52	54	10096	432	0	10634
25655	50	63	275	10123	0	10511
25656	9900	73	141	418	0	10532
25657	9955	65	145	233	0	10398
25658	280	10001	117	205	0	10603
25659	10178	233	96	209	0	10716
25660	293	113	10497	174	0	11077
25661	137	96	274	10587	0	11094
25662	113	76	135	10749	0	11073
25663	88	67	114	11032	0	11301
25664	10431	59	120	431	0	11041
25665	218	10412	95	275	0	11000
25666	110	242	70	10059	0	10481
25667	86	10234	89	367	0	10776
25668	10115	271	93	236	0	10715
25669	244	10223	80	223	0	10770
25670	10096	271	65	202	0	10634
25671	285	9867	84	165	0	10401
25672	136	10026	72	172	0	10406
25673	113	325	93	9943	0	10474
25674	97	140	82	10049	0	10368
25675	81	116	87	9883	0	10167
25676	66	112	74	10014	0	10266
25677	80	104	9681	432	0	10297
25678	84	9610	231	268	0	10193
25679	76	278	104	9339	0	9797
25680	65	9633	90	360	0	10148
25681	73	289	9550	214	0	10126
25682	77	163	248	9451	0	9939
25683	91	130	121	9878	0	10220
25684	79	112	9627	373	0	10191
25685	73	9337	256	253	0	9919
25686	56	248	129	9422	0	9855
25687	47	110	9342	395	0	9894
25688	41	9258	289	292	0	9880
25689	52	258	132	9263	0	9705
25690	63	128	9090	378	0	9659
25691	63	128	8816	215	0	9222
25692	50	8695	265	197	0	9207
25693	55	9422	125	175	0	9777
25694	96	303	129	9599	0	10127
25695	65	167	92	10293	0	10617
25696	48	124	10158	425	0	10755
25697	9590	92	283	282	0	10247
25698	9989	101	144	215	0	10449
25699	311	101	9925	182	0	10519
25700	138	9452	282	181	0	10053
25701	103	9461	140	157	0	9861
25702	78	9282	120	137	0	9617
25703	81	7340	137	172	0	7730
25704	153	384	141	7328	0	8006
25705	32	87	15	8835	0	8969
25706	11	44	19	9017	0	9091
25707	14	33	13	9222	0	9282
25708	13	9230	12	371	0	9626
25709	10	224	12	9256	0	9502
25710	9	9310	5	286	0	9610
25711	9	264	11	9495	0	9779
25712	9271	141	14	299	0	9725
25713	219	68	8	9376	0	9671
25714	119	9202	12	325	0	9658
25715	56	262	10	9533	0	9861
25716	37	139	10	9741	0	9927
25717	21	79	9	9839	0	9948
25718	9311	63	6	500	0	9880
25719	239	72	3	9662	0	9976
25720	125	81	9233	394	0	9833
25721	61	9428	220	281	0	9990
25722	57	280	117	9781	0	10235
25723	54	165	56	10080	0	10355
25724	57	98	37	10223	0	10415
25725	9663	86	23	558	0	10330
25726	279	95	9388	312	0	10074
25727	175	66	250	9077	0	9568
25728	87	9276	130	413	0	9906
25729	67	297	57	9560	0	9981
25730	8898	196	45	433	0	9572
25731	253	9217	44	326	0	9840
25732	148	318	46	9308	0	9820
25733	69	204	35	9430	0	9738
25734	62	9094	19	594	0	9769
25735	67	307	34	9490	0	9898
25736	60	196	45	9632	0	9933
25737	66	123	9097	555	0	9841
25738	40	9071	266	375	0	9752
25739	9052	329	143	278	0	9802
25740	312	209	8954	240	0	9715
25741	8898	130	288	232	0	9548
25742	361	107	8979	231	0	9678
25743	197	111	308	9087	0	9703
25744	8860	113	183	526	0	9682
25745	326	113	84	9252	0	9775
25746	9114	108	61	559	0	9842
25747	9183	119	78	403	0	9783
25748	9149	123	71	306	0	9649
25749	491	8988	91	238	0	9808
25750	279	366	67	8967	0	9679
25751	198	231	69	9210	0	9708
25752	153	126	90	9330	0	9699
25753	168	101	8806	640	0	9715
25754	144	107	340	9137	0	9728
25755	8876	91	182	579	0	9728
25756	9117	94	103	420	0	9734
25757	540	66	8767	307	0	9680
25758	8960	94	335	251	0	9640
25759	9130	120	202	231	0	9683
25760	547	106	122	8551	0	9326
25761	8492	115	72	550	0	9229
25762	8628	103	85	407	0	9223
25763	548	77	95	8547	0	9267
25764	8522	84	97	533	0	9236
25765	8618	100	121	374	0	9213
25766	587	89	98	8442	0	9216
25767	404	132	6456	495	0	7487
25768	8067	100	280	336	0	8783
25769	494	87	8228	270	0	9079
25770	372	85	8297	252	0	9006
25771	276	8137	443	271	0	9127
25772	266	311	220	8176	0	8973
25773	247	180	132	8507	0	9066
25774	249	102	115	8506	0	8972
25775	254	86	8148	650	0	9138
25776	255	82	8170	398	0	8905
25777	250	8118	470	273	0	9111
25778	229	316	278	7998	0	8821
25779	221	171	194	8392	0	8978
25780	237	92	171	8556	0	9056
25781	208	70	8142	623	0	9043
25782	189	7952	406	418	0	8965
25783	214	316	233	8161	0	8924
25784	216	173	8130	529	0	9048
25785	221	92	8213	399	0	8925
25786	8079	99	496	266	0	8940
25787	8191	97	310	258	0	8856
25788	8391	93	188	269	0	8941
25789	569	110	127	8016	0	8822
25790	317	72	7881	537	0	8807
25791	221	7699	361	419	0	8700
25792	214	8079	266	290	0	8849
25793	201	369	7183	228	0	7981
25794	231	345	382	6417	0	7375
25795	216	118	271	5874	0	6479
25796	184	5642	180	395	0	6401
25797	196	5972	163	232	0	6563
25798	5858	298	117	156	0	6429
25799	6054	153	101	164	0	6472
25800	6155	65	106	186	0	6512
25801	6082	70	111	172	0	6435
25802	5845	90	94	172	0	6201
25803	436	5423	102	156	0	6117
25804	176	4347	58	115	0	4696
25805	86	3460	59	66	0	3671
25806	3112	117	214	74	0	3517
25807	179	120	66	2813	0	3178
25808	64	20	28	2763	0	2875
25809	2676	12	34	107	0	2829
25810	76	2672	25	73	0	2846
25811	59	60	31	2695	0	2845
25812	45	30	33	2762	0	2870
25813	50	20	32	2800	0	2902
25814	2712	17	32	94	0	2855
25815	87	14	23	2739	0	2863
25816	56	9	2592	96	0	2753
25817	2511	17	66	51	0	2645
25818	81	18	42	2596	0	2737
25819	52	19	2595	70	0	2736
25820	42	2595	64	48	0	2749
25821	35	2469	26	24	0	2554
25822	2283	56	55	26	0	2420
25823	2280	25	16	16	0	2337
25824	52	2446	7	13	0	2518
25825	31	41	8	2579	0	2659
25826	2673	17	8	66	0	2764
25827	60	9	11	2963	0	3043
25828	29	7	10	3074	0	3120
25829	16	4	9	3112	0	3141
25830	18	5	7	3075	0	3105
25831	9	2987	7	120	0	3123
25832	5	62	11	3081	0	3159
25833	11	32	11	3084	0	3138
25834	8	23	9	3073	0	3113
25835	13	13	2923	123	0	3072
25836	10	2917	71	66	0	3064
25837	8	76	34	2941	0	3059
25838	9	38	2904	90	0	3041
25839	16	18	2701	63	0	2798
25840	9	2863	91	37	0	3000
25841	2810	69	51	22	0	2952
25842	61	39	22	2880	0	3002
25843	2889	22	9	79	0	2999
25844	74	2901	10	52	0	3037
25845	35	68	12	2930	0	3045
25846	2791	37	9	82	0	2919
25847	2902	25	9	52	0	2988
25848	93	17	8	2878	0	2996
25849	44	13	9	2896	0	2962
25850	24	12	2859	108	0	3003
25851	14	13	64	2886	0	2977
25852	18	7	38	2944	0	3007
25853	2839	11	20	107	0	2977
25854	67	2880	7	67	0	3021
25855	43	60	2827	47	0	2977
25856	2795	35	64	31	0	2925
25857	69	2900	35	31	0	3035
25858	40	60	17	2904	0	3021
25859	2867	33	12	79	0	2991
25860	70	23	7	2858	0	2958
25861	41	16	9	2864	0	2930
25862	26	6	2788	113	0	2933
25863	16	10	56	2868	0	2950
25864	2829	14	36	101	0	2980
25865	69	5	22	2885	0	2981
25866	2798	14	6	103	0	2921
25867	82	2703	11	67	0	2863
25868	42	2808	13	42	0	2905
25869	25	90	14	2791	0	2920
25870	23	56	7	2814	0	2900
25871	2683	23	13	105	0	2824
25872	61	2675	7	88	0	2831
25873	2739	70	5	45	0	2859
25874	2754	44	10	39	0	2847
25875	99	27	8	2727	0	2861
25876	2751	13	9	91	0	2864
25877	97	13	2632	57	0	2799
25878	52	17	65	2674	0	2808
25879	48	13	2706	84	0	2851
25880	37	13	77	2709	0	2836
25881	2644	18	37	111	0	2810
25882	2722	17	24	73	0	2836
25883	117	2674	17	39	0	2847
25884	56	81	10	2724	0	2871
25885	54	38	11	2734	0	2837
25886	37	2724	14	122	0	2897
25887	27	81	7	2851	0	2966
25888	32	49	15	2824	0	2920
25889	28	2793	6	133	0	2960
25890	2709	84	6	89	0	2888
25891	2763	41	9	73	0	2886
25892	111	30	18	2739	0	2898
25893	55	30	6	2806	0	2897
25894	45	13	2704	141	0	2903
25895	37	17	72	2706	0	2832
25896	36	2688	36	121	0	2881
25897	2754	82	30	74	0	2940
25898	87	58	13	2732	0	2890
25899	51	29	15	2732	0	2827
25900	2607	22	16	141	0	2786
25901	85	2615	17	89	0	2806
25902	55	89	9	2690	0	2843
25903	54	49	15	2700	0	2818
25904	40	2651	10	158	0	2859
25905	2683	83	11	86	0	2863
25906	104	51	2633	51	0	2839
25907	55	45	2681	53	0	2834
25908	44	20	93	2692	0	2849
25909	28	23	2689	107	0	2847
25910	2602	25	81	82	0	2790
25911	95	17	46	2688	0	2846
25912	64	15	2698	99	0	2876
25913	42	25	2712	73	0	2852
25914	31	2769	99	60	0	2959
25915	2770	74	56	48	0	2948
25916	82	2821	33	43	0	2979
25917	2844	78	29	51	0	3002
25918	2827	43	23	41	0	2934
25919	105	2748	25	34	0	2912
25920	2740	73	15	38	0	2866
25921	2717	41	20	28	0	2806
25922	111	31	2638	41	0	2821
25923	77	159	61	2388	0	2685
25924	35	2297	30	62	0	2424
25925	20	2250	14	32	0	2316
25926	70	79	37	1965	0	2151
25927	1820	16	24	40	0	1900
25928	26	5	4	1800	0	1835
25929	10	4	4	1848	0	1866
25930	6	8	2	1898	0	1914
25931	6	1931	3	38	0	1978
25932	7	27	4	2081	0	2119
25933	11	12	2228	42	0	2293
25934	2143	8	41	25	0	2217
25935	2326	4	19	13	0	2362
25936	60	2290	4	7	0	2361
25937	2372	40	6	17	0	2435
25938	48	20	10	2401	0	2479
25939	31	4	2397	38	0	2470
25940	2315	9	34	19	0	2377
25941	48	2444	20	11	0	2523
25942	28	39	3	2459	0	2529
25943	2539	17	6	47	0	2609
25944	40	2560	9	21	0	2630
25945	22	2609	5	11	0	2647
25946	2613	57	2	10	0	2682
25947	48	24	2515	10	0	2597
25948	2572	9	37	10	0	2628
25949	45	17	15	2559	0	2636
25950	21	14	3	2567	0	2605
25951	17	6	2513	56	0	2592
25952	11	6	2480	19	0	2516
25953	15	9	51	2552	0	2627
25954	13	4	2512	57	0	2586
25955	11	4	2489	24	0	2528
25956	9	5	62	2480	0	2556
25957	13	8	26	2558	0	2605
25958	2559	5	14	60	0	2638
25959	46	7	21	2552	0	2626
25960	2570	10	12	50	0	2642
25961	44	2532	8	32	0	2616
25962	28	40	7	2621	0	2696
25963	23	22	2641	46	0	2732
25964	2599	12	42	32	0	2685
25965	2720	13	19	13	0	2765
25966	2752	12	10	16	0	2790
25967	2723	8	17	21	0	2769
25968	2739	7	16	16	0	2778
25969	70	9	12	2670	0	2761
25970	39	4	2613	51	0	2707
25971	28	4	2573	28	0	2633
25972	22	6	2640	19	0	2687
25973	2578	7	61	21	0	2667
25974	2723	6	31	20	0	2780
25975	61	4	24	2622	0	2711
25976	37	2718	19	50	0	2824
25977	17	44	15	2800	0	2876
25978	28	17	2748	53	0	2846
25979	20	6	2663	35	0	2724
25980	2649	11	59	18	0	2737
25981	57	12	2801	18	0	2888
25982	32	11	48	2818	0	2909
25983	3005	3	38	52	0	3098
25984	2841	6	20	29	0	2896
25985	3051	5	12	19	0	3087
25986	3048	3	17	16	0	3084
25987	70	4	2983	16	0	3073
25988	2883	5	54	15	0	2957
25989	64	2947	25	18	0	3054
25990	46	41	15	3003	0	3105
25991	31	22	2999	46	0	3098
25992	26	10	54	2978	0	3068
25993	30	6	3041	56	0	3133
25994	16	13	55	2996	0	3080
25995	18	10	36	3071	0	3135
25996	25	7	3031	68	0	3131
25997	21	5	57	3003	0	3086
25998	3058	0	42	64	0	3164
25999	64	4	20	3069	0	3157
26000	33	8	16	3137	0	3194
26001	3082	6	19	77	0	3184
26002	65	3078	20	36	0	3199
26003	3117	42	11	26	0	3196
26004	58	3113	17	20	0	3208
26005	3175	44	12	31	0	3262
26006	67	23	3176	17	0	3283
26007	40	12	56	3130	0	3238
26008	27	13	28	3225	0	3293
26009	3161	11	14	73	0	3259
26010	55	3122	22	36	0	3235
26011	37	45	22	3108	0	3212
26012	20	24	14	3131	0	3189
26013	21	3017	15	83	0	3136
26014	2977	45	28	36	0	3086
26015	63	2989	11	25	0	3088
26016	37	47	7	2968	0	3059
26017	28	25	17	2865	0	2935
26018	19	2874	9	74	0	2976
26019	2864	47	18	40	0	2969
26020	57	26	2837	30	0	2950
26021	2772	17	50	28	0	2867
26022	59	2818	31	32	0	2940
26023	37	53	18	2857	0	2965
26024	2895	21	9	60	0	2985
26025	53	11	20	2891	0	2975
26026	38	18	14	2910	0	2980
26027	2874	16	9	84	0	2983
26028	56	2773	13	55	0	2897
26029	40	2860	15	29	0	2944
26030	2865	55	9	30	0	2959
26031	58	22	2872	26	0	2978
26032	34	2748	33	24	0	2839
26033	33	32	22	2733	0	2820
26034	14	20	3176	26	0	3236
26035	13	20	52	3058	0	3143
26036	3143	7	24	64	0	3238
26037	57	3170	13	33	0	3273
26038	39	52	5	3031	0	3127
26039	15	3150	11	54	0	3230
26040	3154	60	5	30	0	3249
26041	3183	32	7	22	0	3244
26042	91	3205	8	14	0	3318
26043	38	70	6	3065	0	3179
26044	16	3175	6	73	0	3270
26045	3251	80	7	38	0	3376
26046	3328	38	8	28	0	3402
26047	115	17	6	3266	0	3404
26048	59	18	2	3335	0	3414
26049	23	14	3227	121	0	3385
26050	3040	16	78	59	0	3193
26051	92	16	3218	21	0	3347
26052	50	10	84	3197	0	3341
26053	3172	13	40	79	0	3304
26054	81	3262	13	59	0	3415
26055	3202	86	10	31	0	3329
26056	86	51	2998	21	0	3156
26057	3128	17	64	19	0	3228
26058	101	3247	33	18	0	3399
26059	3265	84	15	27	0	3391
26060	93	3342	11	21	0	3467
26061	47	96	16	3323	0	3482
26062	41	41	3243	84	0	3409
26063	19	25	3139	54	0	3237
26064	15	13	113	3177	0	3318
26065	25	20	3228	89	0	3362
26066	24	22	88	3202	0	3336
26067	25	12	43	3203	0	3283
26068	16	10	3281	128	0	3435
26069	2865	11	83	80	0	3039
26070	3269	22	49	26	0	3366
26071	120	3215	19	18	0	3372
26072	3260	83	16	20	0	3379
26073	92	40	18	3224	0	3374
26074	53	19	3311	89	0	3472
26075	25	20	84	3315	0	3444
26076	30	10	41	3388	0	3469
26077	3242	9	25	117	0	3393
26078	90	3177	10	64	0	3341
26079	44	3276	10	33	0	3363
26080	27	102	17	3301	0	3447
26081	28	48	13	3253	0	3342
26082	22	3203	11	105	0	3341
26083	22	72	12	3129	0	3235
26084	17	41	9	3110	0	3177
26085	8	3038	12	120	0	3178
26086	3018	73	14	57	0	3162
26087	78	34	11	3028	0	3151
26088	42	3020	6	88	0	3156
26089	26	72	12	3079	0	3189
26090	3015	48	8	88	0	3159
26091	77	3024	7	52	0	3160
26092	3072	80	5	35	0	3192
26093	3169	41	6	27	0	3243
26094	108	18	7	3188	0	3321
26095	3267	18	9	93	0	3387
26096	3286	13	9	49	0	3357
26097	3314	20	3	30	0	3367
26098	3360	13	5	27	0	3405
26099	116	17	6	3296	0	3435
26100	58	18	8	3357	0	3441
26101	36	10	3291	127	0	3464
26102	24	13	78	3347	0	3462
26103	30	16	32	3361	0	3439
26104	28	9	3299	131	0	3467
26105	3185	11	85	74	0	3355
26106	100	11	36	3362	0	3509
26107	56	11	3418	104	0	3589
26108	3233	9	85	63	0	3390
26109	100	15	3675	34	0	3824
26110	56	3722	111	28	0	3917
26111	30	4020	39	43	0	4132
26112	25	129	31	4240	0	4425
26113	24	50	4557	125	0	4756
26114	4526	16	113	82	0	4737
26115	4865	12	59	54	0	4990
26116	175	17	4773	16	0	4981
26117	4776	8	119	37	0	4940
26118	4900	11	68	34	0	5013
26119	168	4850	34	24	0	5076
26120	4881	118	19	39	0	5057
26121	136	42	35	4843	0	5056
26122	69	34	4863	119	0	5085
26123	50	22	116	4637	0	4825
26124	31	4828	54	121	0	5034
26125	40	5074	42	49	0	5205
26126	5023	146	22	32	0	5223
26127	5048	60	25	30	0	5163
26128	5082	36	31	25	0	5174
26129	195	26	13	4937	0	5171
26130	74	54	36	4800	0	4964
26131	48	4837	24	159	0	5068
26132	4756	127	26	79	0	4988
26133	143	4860	38	52	0	5093
26134	4361	92	25	22	0	4500
26135	119	4378	34	19	0	4550
26136	4387	98	30	13	0	4528
26137	4278	40	16	25	0	4359
26138	143	38	16	4260	0	4457
26139	88	4417	20	78	0	4603
26140	60	91	4204	52	0	4407
26141	4033	42	77	46	0	4198
26142	94	4146	28	40	0	4308
26143	46	96	4282	33	0	4457
26144	48	48	4309	18	0	4423
26145	53	44	75	4043	0	4215
26146	64	27	20	3985	0	4096
26147	44	4304	9	80	0	4437
26148	4406	76	10	42	0	4534
26149	94	39	14	4302	0	4449
26150	53	4393	4	70	0	4520
26151	49	4607	8	35	0	4699
26152	43	93	4516	19	0	4671
26153	49	50	4469	15	0	4583
26154	4343	39	64	27	0	4473
26155	89	40	4549	28	0	4706
26156	61	38	64	4435	0	4598
26157	44	35	33	4640	0	4752
26158	53	33	4665	90	0	4841
26159	39	44	69	4491	0	4643
26160	46	29	57	4197	0	4329
26161	4545	34	36	80	0	4695
26162	4653	32	49	44	0	4778
26163	85	41	34	4585	0	4745
26164	38	4542	47	77	0	4704
26165	45	4842	39	52	0	4978
26166	4871	90	28	44	0	5033
26167	97	48	4854	34	0	5033
26168	55	30	72	4821	0	4978
26169	4974	39	51	105	0	5169
26170	5051	40	40	49	0	5180
26171	116	41	35	5013	0	5205
26172	48	36	5035	94	0	5213
26173	67	41	4642	46	0	4796
26174	4608	30	104	56	0	4798
26175	4921	31	60	49	0	5061
26176	99	4908	48	61	0	5116
26177	56	5078	44	66	0	5244
26178	5225	98	40	68	0	5431
26179	5338	39	42	61	0	5480
26180	146	33	29	5376	0	5584
26181	85	34	33	5487	0	5639
26182	69	45	42	5526	0	5682
26183	5516	31	36	117	0	5700
26184	135	44	39	5496	0	5714
26185	81	50	5533	105	0	5769
26186	5404	49	92	49	0	5594
26187	144	43	45	5614	0	5846
26188	92	46	5600	99	0	5837
26189	5391	40	94	63	0	5588
26190	5168	55	49	70	0	5342
26191	111	5770	52	64	0	5997
26192	84	5928	45	58	0	6115
26193	83	111	5518	56	0	5768
26194	5552	59	79	56	0	5746
26195	123	5918	34	50	0	6125
26196	85	114	5637	49	0	5885
26197	5583	42	89	53	0	5767
26198	142	6149	28	57	0	6376
26199	72	92	6089	76	0	6329
26200	5783	51	78	70	0	5982
26201	133	6119	28	65	0	6345
26202	69	77	33	6086	0	6265
26203	6090	33	28	112	0	6263
26204	94	6093	33	67	0	6287
26205	63	91	48	6054	0	6256
26206	6008	25	22	109	0	6164
26207	88	24	6032	40	0	6184
26208	53	5928	70	28	0	6079
26209	42	58	5818	27	0	5945
26210	27	48	68	5583	0	5726
26211	21	19	5515	73	0	5628
26212	22	5164	48	19	0	5253
26213	19	4952	22	8	0	5001
26214	14	33	11	4902	0	4960
26215	9	11	12	4646	0	4678
26216	9	6	9	4726	0	4750
26217	8	7	4902	37	0	4954
26218	6	0	39	4885	0	4930
26219	4897	9	13	36	0	4955
26220	4798	10	9	13	0	4830
26221	45	4	5012	7	0	5068
26222	20	5015	30	8	0	5073
26223	5015	30	13	15	0	5073
26224	26	4981	6	14	0	5027
26225	4963	30	12	22	0	5027
26226	4978	10	8	20	0	5016
26227	40	4	4949	15	0	5008
26228	19	5020	36	13	0	5088
26229	18	29	12	5083	0	5142
26230	10	9	5098	37	0	5154
26231	4761	12	37	14	0	4824
26232	43	18	11	5012	0	5084
26233	15	8	4952	31	0	5006
26234	4628	5	37	18	0	4688
26235	43	8	5049	6	0	5106
26236	22	1	37	5005	0	5065
26237	5169	6	16	46	0	5237
26238	42	5308	7	17	0	5374
26239	19	38	5360	8	0	5425
26240	5240	14	42	21	0	5317
26241	5765	4	17	11	0	5797
26242	72	5894	15	4	0	5985
26243	22	61	13	5986	0	6082
26244	15	16	7	5916	0	5954
26245	5847	10	4	76	0	5937
26246	63	12	11	5848	0	5934
26247	23	10	5908	66	0	6007
26248	18	4	62	5850	0	5934
26249	5871	7	17	70	0	5965
26250	62	5804	9	25	0	5900
26251	21	67	10	5604	0	5702
26252	13	5663	8	70	0	5754
26253	5830	69	5	30	0	5934
26254	71	23	8	6293	0	6395
26255	23	13	11	6359	0	6406
26256	21	6429	11	111	0	6572
26257	15	99	6262	46	0	6422
26258	13	33	101	6194	0	6341
26259	17	22	26	6369	0	6434
26260	15	16	17	6343	0	6391
26261	14	6254	12	129	0	6409
26262	18	98	6262	48	0	6426
26263	19	36	6216	39	0	6310
26264	6173	17	131	36	0	6357
26265	6346	15	37	35	0	6433
26266	131	15	6424	18	0	6588
26267	6171	11	104	41	0	6327
26268	127	19	6439	20	0	6605
26269	6166	14	122	25	0	6327
26270	127	6468	45	29	0	6669
26271	6553	109	23	23	0	6708
26272	134	38	6589	20	0	6781
26273	51	19	6708	21	0	6799
26274	44	15	138	7082	0	7279
26275	7348	12	55	149	0	7564
26276	161	7833	31	71	0	8096
26277	62	201	8771	30	0	9064
26278	64	55	250	8897	0	9266
26279	32	24	88	9287	0	9431
26280	9022	23	39	334	0	9418
26281	9192	13	33	118	0	9356
26282	349	23	26	9086	0	9484
26283	9164	19	33	290	0	9506
26284	329	12	8975	103	0	9419
26285	119	15	270	8886	0	9290
26286	73	21	87	9267	0	9448
26287	9030	13	51	347	0	9441
26288	9145	12	35	139	0	9331
26289	370	16	31	8986	0	9403
26290	9013	12	35	305	0	9365
26291	327	19	8707	122	0	9175
26292	125	8628	277	81	0	9111
26293	87	263	8736	62	0	9148
26294	64	113	306	8752	0	9235
26295	8563	39	106	340	0	9048
26296	304	8543	55	121	0	9023
26297	109	282	49	8523	0	8963
26298	78	88	36	8311	0	8513
26299	51	8268	38	367	0	8724
26300	47	278	39	8501	0	8865
26301	61	92	42	8565	0	8760
26302	52	56	35	8715	0	8858
26303	57	31	37	8683	0	8808
26304	65	15	27	8557	0	8664
26305	66	8168	29	418	0	8681
26306	56	272	44	8386	0	8758
26307	67	84	39	8519	0	8709
26308	72	56	8024	420	0	8572
26309	69	7989	290	188	0	8536
26310	66	274	106	8130	0	8576
26311	80	88	57	8251	0	8476
26312	79	52	56	8202	0	8389
26313	64	7919	54	431	0	8468
26314	70	289	7925	212	0	8496
26315	78	104	301	8165	0	8648
26316	91	68	8088	404	0	8651
26317	80	45	8113	178	0	8416
26318	73	47	375	8057	0	8552
26319	8130	39	131	427	0	8727
26320	329	48	93	8192	0	8662
26321	141	38	81	8112	0	8372
26322	95	8119	51	431	0	8696
26323	85	286	59	8455	0	8885
26324	82	93	55	8696	0	8926
26325	85	68	8421	474	0	9048
26326	62	8378	295	245	0	8980
26327	70	278	114	8610	0	9072
26328	8323	113	76	412	0	8924
26329	303	75	8303	212	0	8893
26330	117	59	317	8359	0	8852
26331	87	51	126	8672	0	8936
26332	8286	66	83	475	0	8910
26333	324	8281	68	285	0	8958
26334	8187	308	56	216	0	8767
26335	340	8227	56	190	0	8813
26336	122	320	53	8293	0	8788
26337	8027	121	52	457	0	8657
26338	328	73	7936	244	0	8581
26339	130	7755	286	220	0	8391
26340	108	7949	120	207	0	8384
26341	7465	344	95	166	0	8070
26342	286	138	80	7265	0	7769
26343	137	7181	77	376	0	7771
26344	101	7570	72	230	0	7973
26345	106	332	64	7489	0	7991
26346	88	152	54	7709	0	8003
26347	7306	94	51	468	0	7919
26348	289	7271	60	264	0	7884
26349	117	316	78	7320	0	7831
26350	95	146	7219	374	0	7834
26351	74	7226	300	231	0	7831
26352	68	292	7164	207	0	7731
26353	84	7113	313	187	0	7697
26354	123	294	158	6672	0	7247
26355	66	114	69	6659	0	6908
26356	66	6521	59	385	0	7031
26357	57	268	6525	213	0	7063
26358	6472	127	246	180	0	7025
26359	235	111	92	6760	0	7198
26360	101	88	67	6998	0	7254
26361	64	86	6719	389	0	7258
26362	52	96	257	6804	0	7209
26363	51	93	6754	382	0	7280
26364	65	75	265	6824	0	7229
26365	49	69	6917	378	0	7413
26366	39	6971	274	224	0	7508
26367	36	282	7207	177	0	7702
26368	42	130	285	7265	0	7722
26369	7111	92	98	392	0	7693
26370	275	7064	69	197	0	7605
26371	109	320	62	7025	0	7516
26372	78	143	6857	348	0	7426
26373	56	6929	273	177	0	7435
26374	53	292	107	6291	0	6743
26375	34	116	6317	261	0	6728
26376	27	5629	180	90	0	5926
26377	4426	198	106	82	0	4812
26378	4199	22	28	27	0	4276
26379	90	15	10	4166	0	4281
26380	4206	10	4	89	0	4309
26381	92	6	5	4158	0	4261
26382	26	6	8	4239	0	4279
26383	16	6	4336	97	0	4455
26384	12	6	81	4229	0	4328
26385	13	6	22	4335	0	4376
26386	4229	4	15	114	0	4362
26387	4185	5	8	38	0	4236
26388	97	4146	6	26	0	4275
26389	34	72	4257	14	0	4377
26390	15	19	85	4207	0	4326
26391	14	11	4128	85	0	4238
26392	3754	11	85	29	0	3879
26393	76	11	4044	29	0	4160
26394	29	4	72	3895	0	4000
26395	15	3965	22	62	0	4064
26396	8	60	16	3991	0	4075
26397	10	31	14	3989	0	4044
26398	7	17	4116	88	0	4228
26399	15	8	65	4049	0	4137
26400	4060	6	26	81	0	4173
26401	4068	5	13	35	0	4121
26402	4080	11	11	22	0	4124
26403	4084	4	14	24	0	4126
26404	81	3969	8	27	0	4085
26405	31	4003	17	15	0	4066
26406	33	82	14	3551	0	3680
26407	15	26	12	3952	0	4005
26408	14	3807	9	81	0	3911
26409	20	63	5	4008	0	4096
26410	20	22	4	4043	0	4089
26411	11	14	12	4016	0	4053
26412	13	12	19	4029	0	4073
26413	9	7	12	4093	0	4121
26414	3988	6	12	98	0	4104
26415	69	3887	16	43	0	4015
26416	31	68	3812	35	0	3946
26417	24	24	68	3806	0	3922
26418	13	22	21	3887	0	3943
26419	10	15	18	3776	0	3819
26420	3760	11	19	103	0	3893
26421	71	4130	11	58	0	4270
26422	35	114	12	4076	0	4237
26423	29	4234	14	138	0	4415
26424	27	147	6	4147	0	4327
26425	26	4143	9	151	0	4329
26426	16	148	4465	71	0	4700
26427	17	55	170	4757	0	4999
26428	13	27	5818	204	0	6062
26429	11	19	242	5805	0	6077
26430	13	18	88	6542	0	6661
26431	6396	12	48	350	0	6806
26432	6492	30	20	151	0	6693
26433	6704	18	18	95	0	6835
26434	6727	35	19	51	0	6832
26435	6736	17	35	47	0	6835
26436	378	23	29	6237	0	6667
26437	138	6349	45	276	0	6808
26438	70	260	37	6398	0	6765
26439	46	94	6157	354	0	6651
26440	6120	55	243	134	0	6552
26441	6593	24	86	85	0	6788
26442	416	16	42	6355	0	6829
26443	207	15	25	6329	0	6576
26444	128	6089	13	357	0	6587
26445	63	265	17	6389	0	6734
26446	50	113	20	6402	0	6585
26447	46	6185	20	398	0	6649
26448	49	258	46	6389	0	6742
26449	5899	88	32	365	0	6384
26450	313	47	6063	147	0	6570
26451	6030	46	246	134	0	6456
26452	319	29	6121	121	0	6590
26453	134	51	283	6032	0	6500
26454	82	35	99	6012	0	6228
26455	58	5786	54	399	0	6297
26456	44	6255	34	172	0	6505
26457	51	338	32	5871	0	6292
26458	72	123	5938	332	0	6465
26459	5721	60	288	123	0	6192
26460	319	36	107	5825	0	6287
26461	125	5799	97	301	0	6322
26462	81	253	44	5957	0	6335
26463	73	111	17	5945	0	6146
26464	46	5738	23	384	0	6191
26465	76	287	19	5546	0	5928
26466	45	107	5109	329	0	5590
26467	51	63	5085	136	0	5335
26468	76	50	271	4711	0	5108
26469	40	5013	104	259	0	5416
26470	23	244	48	5135	0	5450
26471	5052	99	25	296	0	5472
26472	5228	53	21	161	0	5463
26473	5037	62	22	85	0	5206
26474	300	4917	21	92	0	5330
26475	109	218	4934	62	0	5323
26476	4851	90	249	66	0	5256
26477	5085	64	88	81	0	5318
26478	280	4906	55	66	0	5307
26479	133	223	35	4939	0	5330
26480	4993	91	26	263	0	5373
26481	5127	51	25	121	0	5324
26482	5238	38	29	88	0	5393
26483	342	54	35	4800	0	5231
26484	4960	36	60	257	0	5313
26485	327	22	45	4906	0	5300
26486	172	26	32	5104	0	5334
26487	4913	55	15	344	0	5327
26488	290	40	27	4966	0	5323
26489	4930	39	23	328	0	5320
26490	341	33	31	4898	0	5303
26491	210	27	24	5106	0	5367
26492	4879	37	28	394	0	5338
26493	337	33	4755	205	0	5330
26494	174	33	231	4951	0	5389
26495	145	31	100	5081	0	5357
26496	144	27	58	5055	0	5284
26497	122	44	35	5150	0	5351
26498	124	29	19	4931	0	5103
26499	100	4673	32	438	0	5243
26500	99	222	33	4897	0	5251
26501	125	97	4674	340	0	5236
26502	120	67	245	4834	0	5266
26503	100	41	107	4976	0	5224
26504	97	45	54	5119	0	5315
26505	87	33	4723	455	0	5298
26506	72	57	4753	260	0	5142
26507	4661	51	292	198	0	5202
26508	4884	71	129	155	0	5239
26509	313	4851	81	141	0	5386
26510	172	230	68	5043	0	5513
26511	113	115	43	5259	0	5530
26512	67	78	51	5409	0	5605
26513	5099	52	40	457	0	5648
26514	5331	38	90	231	0	5690
26515	343	37	69	5259	0	5708
26516	184	56	44	5411	0	5695
26517	123	65	34	5441	0	5663
26518	74	81	48	5460	0	5663
26519	5052	45	46	454	0	5597
26520	253	49	4945	264	0	5511
26521	126	4198	184	181	0	4689
26522	90	4308	78	143	0	4619
26523	4107	185	52	113	0	4457
26524	176	156	76	4049	0	4457
26525	88	65	3998	243	0	4394
26526	64	55	3596	136	0	3851
26527	36	3692	124	132	0	3984
26528	2671	50	63	31	0	2815
26529	52	21	2638	22	0	2733
26530	2083	6	45	7	0	2141
26531	15	3	7	2172	0	2197
26532	9	3	1	2204	0	2217
26533	2	2171	3	19	0	2195
26534	3	2159	3	9	0	2174
26535	2218	18	2	8	0	2246
26536	2235	7	2	3	0	2247
26537	20	2281	2	2	0	2305
26538	6	11	2238	2	0	2257
26539	4	4	2236	3	0	2247
26540	5	1	13	2267	0	2286
26541	2363	2	2	13	0	2380
26542	12	2345	3	5	0	2365
26543	3	12	2	2437	0	2454
26544	2467	6	0	16	0	2489
26545	17	3	1	2517	0	2538
26546	6	3	0	2580	0	2589
26547	2605	3	1	20	0	2629
26548	16	2606	3	10	0	2635
26549	7	2724	3	3	0	2737
26550	3	18	2769	3	0	2793
26551	7	6	17	2805	0	2835
26552	4	2	8	2759	0	2773
26553	5	2	2891	21	0	2919
26554	2475	1	22	20	0	2518
26555	2682	1	4	11	0	2698
26556	24	1	2849	5	0	2879
26557	2400	2	20	16	0	2438
26558	25	3	2878	3	0	2909
26559	7	3013	21	7	0	3048
26560	2	20	5	3175	0	3202
26561	4	6	3	3214	0	3227
26562	3237	2	4	23	0	3266
26563	3190	3	3	13	0	3209
26564	3159	2	4	7	0	3172
26565	3198	1	2	3	0	3204
26566	3202	2	2	3	0	3209
26567	27	0	3139	1	0	3167
26568	9	3132	22	2	0	3165
26569	3	17	6	3181	0	3207
26570	4	3156	3	15	0	3178
26571	4	3225	3	6	0	3238
26572	1	22	10	3198	0	3231
26573	4	6	2	3212	0	3224
26574	4	2	3253	27	0	3286
26575	3003	0	16	15	0	3034
26576	3276	0	6	5	0	3287
26577	18	3236	4	1	0	3259
26578	3294	18	2	1	0	3315
26579	3353	6	0	11	0	3370
26580	23	3	1	3383	0	3410
26581	7	2	3485	19	0	3513
26582	2	1	3416	7	0	3426
26583	3407	0	21	8	0	3436
26584	3486	1	3	4	0	3494
26585	24	3427	3	1	0	3455
26586	10	3605	0	2	0	3617
26587	7	23	1	3722	0	3753
26588	3705	8	1	27	0	3741
26589	22	7	3677	7	0	3713
26590	7	0	20	3726	0	3753
26591	3810	1	8	27	0	3846
26592	3820	1	4	11	0	3836
26593	32	1	1	3891	0	3925
26594	3906	2	1	27	0	3936
26595	24	2	3795	7	0	3828
26596	10	2	3943	5	0	3960
26597	11	1	23	3859	0	3894
26598	3	1	9	4146	0	4159
26599	4	3	5	4109	0	4121
26600	3	3989	1	24	0	4017
26601	4	4110	4	11	0	4129
26602	3	26	2	4161	0	4192
26603	4222	9	3	26	0	4260
26604	21	6	1	4263	0	4291
26605	9	3	3	4291	0	4306
26606	7	4230	3	28	0	4268
26607	4	4403	1	14	0	4422
26608	6	23	1	4443	0	4473
26609	5	11	2	4289	0	4307
26610	4225	7	5	26	0	4263
26611	24	4203	2	11	0	4240
26612	4223	18	2	9	0	4252
26613	22	11	1	4227	0	4261
26614	10	6	4138	21	0	4175
26615	6	3	4013	12	0	4034
26616	4110	3	26	13	0	4152
26617	22	2	12	4344	0	4380
26618	8	2	7	4314	0	4331
26619	8	2	1	4383	0	4394
26620	2	1	4442	30	0	4475
26621	5	4	19	4447	0	4475
26622	0	4401	8	28	0	4437
26623	4	26	2	4612	0	4644
26624	6	8	2	4582	0	4598
26625	4	4581	0	35	0	4620
26626	6	28	1	4670	0	4705
26627	4535	9	1	41	0	4586
26628	45	4547	2	12	0	4606
26629	4748	57	3	12	0	4820
26630	4788	12	2	6	0	4808
26631	69	7	4	4741	0	4821
26632	18	3	2	4687	0	4710
26633	10	4	1	4797	0	4812
26634	10	3	4630	84	0	4727
26635	2	4503	63	29	0	4597
26636	8	4722	11	16	0	4757
26637	6	70	4	4626	0	4706
26638	4550	13	5	69	0	4637
26639	66	11	3	4506	0	4586
26640	13	5	4540	80	0	4638
26641	11	4382	68	21	0	4482
26642	6	4567	11	16	0	4600
26643	4559	73	3	19	0	4654
26644	4602	17	5	14	0	4638
26645	69	4892	4	14	0	4979
26646	5032	69	4	15	0	5120
26647	86	14	4851	12	0	4963
26648	21	14	4750	12	0	4797
26649	4811	10	88	18	0	4927
26650	5014	9	19	20	0	5062
26651	101	7	9	4985	0	5102
26652	4974	6	7	92	0	5079
26653	94	12	4965	24	0	5095
26654	29	7	5358	16	0	5410
26655	31	8	114	5917	0	6070
26656	19	10	22	6836	0	6887
26657	12	5	12	7061	0	7090
26658	23	3	13	6928	0	6967
26659	10	12	4	7598	0	7624
26660	17	11	7302	303	0	7633
26661	21	9	211	7290	0	7531
26662	7336	8	47	286	0	7677
26663	222	10	24	7400	0	7656
26664	7363	3	20	300	0	7686
26665	232	5	22	7417	0	7676
26666	7469	8	14	314	0	7805
26667	7782	12	17	150	0	7961
26668	297	11	34	7663	0	8005
26669	106	14	21	7904	0	8045
26670	7687	8	16	333	0	8044
26671	7782	5	14	144	0	7945
26672	345	13	7551	103	0	8012
26673	126	12	219	7651	0	8008
26674	117	6	76	7931	0	8130
26675	7751	8	31	343	0	8133
26676	7932	13	19	155	0	8119
26677	323	7	17	7872	0	8219
26678	151	4	23	8045	0	8223
26679	109	5	27	8050	0	8191
26680	107	5	46	7875	0	8033
26681	80	7248	31	386	0	7745
26682	52	7579	22	208	0	7861
26683	82	250	15	7505	0	7852
26684	93	7519	23	320	0	7955
26685	76	241	27	7708	0	8052
26686	54	84	7456	362	0	7956
26687	42	47	7275	223	0	7587
26688	50	7501	253	179	0	7983
26689	66	260	74	7524	0	7924
26690	61	95	7439	331	0	7926
26691	49	62	257	7405	0	7773
26692	36	77	85	7750	0	7948
26693	7394	43	56	418	0	7911
26694	280	39	68	7621	0	8008
26695	108	47	7608	355	0	8118
26696	95	59	7575	182	0	7911
26697	84	7383	293	177	0	7937
26698	68	8120	120	133	0	8441
26699	8125	264	79	170	0	8638
26700	285	80	8631	145	0	9141
26701	138	45	280	8655	0	9118
26702	8732	55	80	379	0	9246
26703	8803	29	80	184	0	9096
26704	328	8734	112	130	0	9304
26705	154	254	76	8523	0	9007
26706	88	102	54	9154	0	9398
26707	125	65	48	9056	0	9294
26708	8812	55	56	414	0	9337
26709	297	43	8643	227	0	9210
26710	140	8774	266	163	0	9343
26711	114	273	80	8798	0	9265
26712	100	118	52	9192	0	9462
26713	85	68	8855	413	0	9421
26714	65	65	273	8805	0	9208
26715	60	51	86	9180	0	9377
26716	99	48	69	9182	0	9398
26717	90	49	84	9150	0	9373
26718	48	75	8769	468	0	9360
26719	50	52	293	8883	0	9278
26720	50	36	8777	472	0	9335
26721	65	8656	304	258	0	9283
26722	82	236	128	8881	0	9327
26723	69	71	108	9177	0	9425
26724	62	53	8748	499	0	9362
26725	70	8648	270	292	0	9280
26726	93	245	114	8767	0	9219
26727	86	79	8725	378	0	9268
26728	87	8503	247	228	0	9065
26729	78	232	110	8704	0	9124
26730	73	98	8629	359	0	9159
26731	86	61	225	8577	0	8949
26732	89	47	146	8461	0	8743
26733	72	70	87	8937	0	9166
26734	8627	52	88	398	0	9165
26735	240	8561	79	233	0	9113
26736	8623	218	56	207	0	9104
26737	253	92	8592	211	0	9148
26738	8698	65	252	232	0	9247
26739	9353	68	99	221	0	9741
26740	277	48	64	9388	0	9777
26741	9484	56	81	356	0	9977
26742	9629	65	62	236	0	9992
26743	9780	76	49	209	0	10114
26744	311	65	66	9675	0	10117
26745	157	61	73	9484	0	9775
26746	119	39	8945	336	0	9439
26747	93	43	8508	209	0	8853
26748	8556	40	218	187	0	9001
26749	222	96	101	8876	0	9295
26750	132	8873	92	262	0	9359
26751	8948	171	93	178	0	9390
26752	220	8812	64	162	0	9258
26753	113	8769	77	172	0	9131
26754	98	224	8170	154	0	8646
26755	67	69	7941	95	0	8172
26756	80	146	142	7638	0	8006
26757	46	20	8128	126	0	8320
26758	24	29	7333	63	0	7449
26759	6866	11	27	35	0	6939
26760	7421	8	15	27	0	7471
26761	24	5	13	7516	0	7558
26762	20	3	16	7578	0	7617
26763	15	10	7768	22	0	7815
26764	11	7797	16	28	0	7852
26765	20	13	14	7702	0	7749
26766	8124	8	16	49	0	8197
26767	21	11	6	8177	0	8215
26768	13	8176	9	32	0	8230
26769	16	17	8031	20	0	8084
26770	7	8276	23	17	0	8323
26771	8388	26	11	20	0	8445
26772	8295	10	9	24	0	8338
26773	37	8	8	8261	0	8314
26774	16	9	8441	25	0	8491
26775	22	7	7756	19	0	7804
26776	12	8369	30	17	0	8428
26777	26	31	21	7872	0	7950
26778	13	13	10	8494	0	8530
26779	8	8	8438	40	0	8494
26780	15	3	35	8206	0	8259
26781	8	8725	16	44	0	8793
26782	11	41	9	8922	0	8983
26783	10	11	8	8919	0	8948
26784	13	15	8867	55	0	8950
26785	14	7	47	8577	0	8645
26786	8668	7	19	59	0	8753
26787	50	9	8721	19	0	8799
26788	26	5	8446	15	0	8492
26789	14	8790	63	13	0	8880
26790	8	55	26	9042	0	9131
26791	13	19	15	9415	0	9462
26792	12	7	9287	74	0	9380
26793	8536	2	66	50	0	8654
26794	64	9	24	9300	0	9397
26795	24	6	9111	71	0	9212
26796	22	8	73	8686	0	8789
26797	5	6	8999	77	0	9087
26798	15	10	8470	30	0	8525
26799	8	8590	90	23	0	8711
26800	15	65	35	8016	0	8131
26801	1	8301	15	71	0	8388
26802	8090	70	12	28	0	8200
26803	66	23	8198	16	0	8303
26804	19	8068	69	11	0	8167
26805	19	62	30	8124	0	8235
26806	8017	27	14	81	0	8139
26807	58	8023	13	35	0	8129
26808	24	59	13	8164	0	8260
26809	12	30	14	8170	0	8226
26810	3	8243	10	84	0	8340
26811	8333	91	5	51	0	8480
26812	91	29	11	9593	0	9724
26813	25	15	14	10127	0	10181
26814	14	12	9958	212	0	10196
26815	5	10475	172	96	0	10748
26816	18	199	58	10662	0	10937
26817	19	63	33	11825	0	11940
26818	7	11992	15	286	0	12300
26819	9	252	15	12114	0	12390
26820	12	93	13	12651	0	12769
26821	27	44	11	12620	0	12702
26822	3	12519	18	388	0	12928
26823	12365	289	19	144	0	12817
26824	295	92	12488	69	0	12944
26825	11925	54	290	69	0	12338
26826	318	12398	102	41	0	12859
26827	98	293	53	12349	0	12793
26828	57	98	12436	333	0	12924
26829	25	71	305	12315	0	12716
26830	32	36	95	12459	0	12622
26831	26	27	59	12729	0	12841
26832	25	39	12344	428	0	12836
26833	32	12137	314	186	0	12669
26834	24	281	12335	121	0	12761
26835	22	12428	353	77	0	12880
26836	22	355	12606	63	0	13046
26837	29	107	362	12463	0	12961
26838	12057	80	126	372	0	12635
26839	285	12249	83	172	0	12789
26840	93	328	12189	115	0	12725
26841	55	12114	317	86	0	12572
26842	40	337	12233	87	0	12697
26843	37	144	359	11677	0	12217
26844	47	98	135	11578	0	11858
26845	24	11768	104	418	0	12314
26846	49	12433	53	191	0	12726
26847	12269	422	62	136	0	12889
26848	349	179	57	12434	0	13019
26849	122	121	12437	390	0	13070
26850	88	73	375	12441	0	12977
26851	50	76	12586	448	0	13160
26852	60	87	12621	204	0	12972
26853	49	89	437	11842	0	12417
26854	37	12371	189	392	0	12989
26855	12071	360	121	218	0	12770
26856	337	177	74	11902	0	12490
26857	143	114	88	11690	0	12035
26858	66	11943	79	494	0	12582
26859	11780	370	111	213	0	12474
26860	12071	174	77	171	0	12493
26861	439	127	88	11520	0	12174
26862	174	11441	92	405	0	12112
26863	100	12255	111	193	0	12659
26864	11908	457	84	173	0	12622
26865	359	220	11892	142	0	12613
26866	11464	140	376	148	0	12128
26867	11699	114	186	142	0	12141
26868	11689	119	113	140	0	12061
26869	457	11499	95	156	0	12207
26870	191	386	88	11625	0	12290
26871	11571	192	88	445	0	12296
26872	11605	140	94	231	0	12070
26873	418	11640	105	156	0	12319
26874	11704	382	87	146	0	12319
26875	396	186	102	11714	0	12398
26876	187	154	82	11719	0	12142
26877	115	11625	107	465	0	12312
26878	121	359	78	11865	0	12423
26879	97	185	100	11901	0	12283
26880	93	11741	75	515	0	12424
26881	107	390	82	10984	0	11563
26882	103	11491	78	449	0	12121
26883	11454	389	89	245	0	12177
26884	11192	216	72	191	0	11671
26885	420	11278	76	159	0	11933
26886	216	350	11154	159	0	11879
26887	138	217	335	11137	0	11827
26888	102	156	11121	403	0	11782
26889	106	10595	342	260	0	11303
26890	105	11118	165	165	0	11553
26891	10463	387	113	130	0	11093
26892	330	10844	74	127	0	11375
26893	198	378	90	10328	0	10994
26894	157	10578	91	295	0	11121
26895	128	10837	66	338	0	11369
26896	10753	420	65	154	0	11392
26897	362	217	69	10664	0	11312
26898	180	152	10560	364	0	11256
26899	146	140	10403	186	0	10875
26900	112	10583	368	150	0	11213
26901	10464	351	168	139	0	11122
26902	333	10713	114	113	0	11273
26903	178	425	69	10801	0	11473
26904	10825	211	79	364	0	11479
26905	378	156	65	10937	0	11536
26906	193	109	68	10987	0	11357
26907	144	10873	60	451	0	11528
26908	140	390	53	11028	0	11611
26909	124	194	10953	398	0	11669
26910	10689	139	313	208	0	11349
26911	360	11115	134	160	0	11769
26912	140	10805	65	92	0	11102
26913	10257	335	49	81	0	10722
26914	338	156	10201	77	0	10772
26915	9366	106	286	77	0	9835
26916	283	10634	97	72	0	11086
26917	81	11097	58	44	0	11280
26918	51	356	11060	38	0	11505
26919	44	11270	326	52	0	11692
26920	68	361	109	10082	0	10620
26921	31	102	50	10421	0	10604
26922	23	10604	20	310	0	10957
26923	29	319	12	10770	0	11130
26924	10771	111	12	330	0	11224
26925	307	79	10600	103	0	11089
26926	10609	63	288	75	0	11035
26927	11125	47	92	54	0	11318
26928	10984	52	63	48	0	11147
26929	429	60	10611	34	0	11134
26930	142	50	306	10641	0	11139
26931	90	60	10733	312	0	11195
26932	10304	43	355	121	0	10823
26933	10440	51	105	88	0	10684
26934	374	10603	65	70	0	11112
26935	168	315	40	10437	0	10960
26936	116	10864	42	292	0	11314
26937	78	347	10912	118	0	11455
26938	80	131	329	10875	0	11415
26939	10802	82	139	343	0	11366
26940	11161	42	71	126	0	11400
26941	454	64	49	10426	0	10993
26942	187	10495	44	360	0	11086
26943	95	350	10655	110	0	11210
26944	79	122	10849	94	0	11144
26945	10238	94	421	84	0	10837
26946	378	69	10726	52	0	11225
26947	161	10567	370	60	0	11158
26948	102	366	135	10499	0	11102
26949	81	126	10645	352	0	11204
26950	81	91	379	10366	0	10917
26951	60	53	10479	398	0	10990
26952	9799	52	388	162	0	10401
26953	383	41	169	9969	0	10562
26954	163	9909	104	346	0	10522
26955	94	10385	87	172	0	10738
26956	60	417	102	10085	0	10664
26957	72	162	80	10062	0	10376
26958	74	9989	101	413	0	10577
26959	108	351	9944	171	0	10574
26960	61	140	352	10016	0	10569
26961	64	116	10157	374	0	10711
26962	67	84	9989	175	0	10315
26963	9155	60	467	136	0	9818
26964	361	9535	181	111	0	10188
26965	9546	374	124	97	0	10141
26966	419	152	90	9156	0	9817
26967	152	9581	77	388	0	10198
26968	109	415	99	9601	0	10224
26969	86	172	116	9592	0	9966
26970	92	9515	102	459	0	10168
26971	94	399	9440	214	0	10147
26972	87	178	395	9568	0	10228
26973	9469	129	189	420	0	10207
26974	399	112	136	9447	0	10094
26975	184	86	120	9644	0	10034
26976	133	91	9233	501	0	9958
26977	123	9197	391	223	0	9934
26978	112	406	172	9180	0	9870
26979	103	184	9175	451	0	9913
26980	91	162	9151	221	0	9625
26981	8659	134	500	214	0	9507
26982	382	9060	203	202	0	9847
26983	8951	402	176	157	0	9686
26984	430	8899	131	165	0	9625
26985	209	9255	137	155	0	9756
26986	8984	492	130	171	0	9777
26987	444	214	134	8658	0	9450
26988	224	8961	130	424	0	9739
26989	157	416	145	9166	0	9884
26990	9134	171	109	470	0	9884
26991	475	158	9057	206	0	9896
26992	211	143	8899	178	0	9431
26993	8682	112	503	161	0	9458
26994	422	8878	249	149	0	9698
26995	237	418	8890	113	0	9658
26996	175	8895	416	148	0	9634
26997	195	429	194	8772	0	9590
26998	126	242	8957	419	0	9744
26999	105	175	421	8928	0	9629
27000	139	126	8849	478	0	9592
27001	8324	109	481	271	0	9185
27002	384	8759	230	193	0	9566
27003	8716	414	158	144	0	9432
27004	463	182	140	8396	0	9181
27005	186	9175	177	394	0	9932
27006	9093	458	168	217	0	9936
27007	8798	197	178	166	0	9339
27008	472	156	9148	163	0	9939
27009	202	135	9222	130	0	9689
27010	8123	135	494	113	0	8865
27011	359	8305	237	168	0	9069
27012	151	8064	177	112	0	8504
27013	204	475	163	7521	0	8363
27014	105	187	7618	314	0	8224
27015	130	7202	309	160	0	7801
27016	77	6547	136	90	0	6850
27017	186	144	74	4698	0	5102
27018	4798	55	29	121	0	5003
27019	4803	42	24	60	0	4929
27020	4911	21	25	36	0	4993
27021	155	22	4793	21	0	4991
27022	4720	23	120	32	0	4895
27023	4798	29	55	26	0	4908
27024	4927	29	35	25	0	5016
27025	152	44	22	4665	0	4883
27026	62	4762	18	106	0	4948
27027	4810	105	24	57	0	4996
27028	110	4785	38	23	0	4956
27029	58	113	14	4742	0	4927
27030	44	55	4912	99	0	5110
27031	37	37	105	4886	0	5065
27032	47	23	51	4936	0	5057
27033	38	26	4943	137	0	5144
27034	42	4838	96	64	0	5040
27035	31	98	48	4580	0	4757
27036	4539	43	17	103	0	4702
27037	98	4424	21	48	0	4591
27038	4392	88	14	22	0	4516
27039	94	43	8	4288	0	4433
27040	41	4425	14	86	0	4566
27041	4376	78	20	37	0	4511
27042	89	4455	14	23	0	4581
27043	49	77	4359	23	0	4508
27044	4194	41	88	27	0	4350
27045	4409	32	40	20	0	4501
27046	107	4366	16	28	0	4517
27047	44	93	4246	9	0	4392
27048	21	4457	76	11	0	4565
27049	78	132	56	3036	0	3302
27050	30	41	14	4484	0	4569
27051	15	36	12	4495	0	4558
27052	27	4525	8	116	0	4676
27053	22	103	8	4560	0	4693
27054	18	53	16	4596	0	4683
27055	4504	25	9	120	0	4658
27056	108	20	13	4502	0	4643
27057	46	18	20	4591	0	4675
27058	4496	20	8	128	0	4652
27059	123	4563	12	53	0	4751
27060	4648	114	11	30	0	4803
27061	4652	43	20	24	0	4739
27062	4764	33	8	26	0	4831
27063	141	21	14	4644	0	4820
27064	55	26	11	4823	0	4915
27065	45	15	4634	143	0	4837
27066	29	44	4525	58	0	4656
27067	39	24	4517	48	0	4628
27068	4336	22	134	46	0	4538
27069	130	20	4474	39	0	4663
27070	54	4502	114	38	0	4708
27071	48	115	37	4500	0	4700
27072	46	50	28	4439	0	4563
27073	39	4581	26	122	0	4768
27074	49	118	4609	63	0	4839
27075	42	4711	107	41	0	4901
27076	4688	117	43	37	0	4885
27077	128	60	4723	48	0	4959
27078	58	4707	115	36	0	4916
27079	58	116	4765	24	0	4963
27080	40	63	120	4726	0	4949
27081	41	30	4826	124	0	5021
27082	41	28	134	4704	0	4907
27083	4864	35	41	135	0	5075
27084	129	31	4822	61	0	5043
27085	56	4851	121	57	0	5085
27086	4892	120	49	44	0	5105
27087	136	54	4945	44	0	5179
27088	72	35	4969	41	0	5117
27089	39	36	149	4885	0	5109
27090	41	29	4992	149	0	5211
27091	4691	29	135	73	0	4928
27092	125	4848	51	67	0	5091
27093	61	127	39	4875	0	5102
27094	40	5154	31	129	0	5354
27095	5217	144	30	63	0	5454
27096	149	44	5139	64	0	5396
27097	68	49	5290	49	0	5456
27098	48	33	154	5212	0	5447
27099	34	44	66	5365	0	5509
27100	51	31	42	5457	0	5581
27101	49	32	43	5471	0	5595
27102	45	34	5447	171	0	5697
27103	40	5374	124	80	0	5618
27104	37	127	36	5002	0	5202
27105	28	35	4792	114	0	4969
27106	18	4749	106	50	0	4923
27107	4775	90	54	41	0	4960
27108	131	67	29	4726	0	4953
27109	4631	23	36	102	0	4792
27110	93	4623	26	42	0	4784
27111	4624	95	20	44	0	4783
27112	99	24	4831	32	0	4986
27113	42	43	85	4611	0	4781
27114	36	4785	35	85	0	4941
27115	21	85	4752	43	0	4901
27116	25	4749	88	35	0	4897
27117	70	119	65	3307	0	3561
27118	4522	29	22	82	0	4655
27119	75	4524	16	42	0	4657
27120	4489	69	20	36	0	4614
27121	81	30	4470	16	0	4597
27122	23	30	4353	20	0	4426
27123	4432	7	79	24	0	4542
27124	70	18	39	4413	0	4540
27125	25	30	19	4444	0	4518
27126	28	16	4579	78	0	4701
27127	21	14	4420	32	0	4487
27128	19	4616	81	22	0	4738
27129	4589	74	43	26	0	4732
27130	4450	17	18	12	0	4497
27131	58	4397	22	14	0	4491
27132	32	57	19	4566	0	4674
27133	4652	19	25	63	0	4759
27134	62	17	16	4640	0	4735
27135	4742	15	14	70	0	4841
27136	4811	11	18	38	0	4878
27137	4947	13	18	37	0	5015
27138	74	18	13	4855	0	4960
27139	26	11	15	5044	0	5096
27140	4878	8	20	69	0	4975
27141	4874	13	12	30	0	4929
27142	4830	17	13	22	0	4882
27143	73	4786	14	21	0	4894
27144	4725	47	11	18	0	4801
27145	59	4683	11	18	0	4771
27146	4663	49	13	17	0	4742
27147	61	14	4652	12	0	4739
27148	4220	12	48	12	0	4292
27149	38	4453	12	10	0	4513
27150	10	4495	8	11	0	4524
27151	4590	30	9	12	0	4641
27152	38	6	6	4554	0	4604
27153	14	10	6	4643	0	4673
27154	14	4644	8	45	0	4711
27155	12	4925	5	20	0	4962
27156	5035	46	4	11	0	5096
27157	60	13	5141	10	0	5224
27158	21	32	46	5327	0	5426
27159	5498	12	8	60	0	5578
27160	86	10	5447	11	0	5554
27161	18	5886	63	9	0	5976
27162	6235	93	13	12	0	6353
27163	118	11	6385	11	0	6525
27164	31	15	114	6634	0	6794
27165	21	13	6855	117	0	7006
27166	6487	11	125	34	0	6657
27167	124	6986	32	23	0	7165
27168	7105	121	15	30	0	7271
27169	7171	32	12	16	0	7231
27170	146	29	7	7100	0	7282
27171	7194	15	5	127	0	7341
27172	145	10	13	7176	0	7344
27173	43	9	10	7289	0	7351
27174	29	8	7024	151	0	7212
27175	23	7059	119	43	0	7244
27176	13	114	32	7198	0	7357
27177	18	27	10	7249	0	7304
27178	17	15	9	7287	0	7328
27179	4	13	7180	156	0	7353
27180	10	7022	114	51	0	7197
27181	16	110	34	7182	0	7342
27182	14	33	16	7282	0	7345
27183	18	17	7092	142	0	7269
27184	18	8	112	6852	0	6990
27185	7039	7	32	146	0	7224
27186	114	7089	18	44	0	7265
27187	7092	112	11	32	0	7247
27188	129	28	7120	24	0	7301
27189	44	13	117	7116	0	7290
27190	7227	14	33	118	0	7392
27191	7208	16	14	40	0	7278
27192	143	5	7277	27	0	7452
27193	56	12	115	7180	0	7363
27194	27	4	7247	126	0	7404
27195	6867	6	128	45	0	7046
27196	113	7274	34	23	0	7444
27197	7428	116	15	32	0	7591
27198	7429	35	20	18	0	7502
27199	153	7450	19	18	0	7640
27200	7548	131	9	24	0	7712
27201	154	39	7489	7	0	7689
27202	7488	18	122	17	0	7645
27203	152	17	34	7601	0	7804
27204	53	10	7843	138	0	8044
27205	35	7	138	7787	0	7967
27206	49	4	43	7544	0	7640
27207	25	9	34	7818	0	7886
27208	24	7803	17	173	0	8017
27209	7894	132	21	62	0	8109
27210	153	33	24	7860	0	8070
27211	54	7757	11	151	0	7973
27212	43	138	13	7531	0	7725
27213	43	7582	13	154	0	7792
27214	38	147	7601	70	0	7856
27215	43	43	145	7536	0	7767
27216	27	23	54	7661	0	7765
27217	36	36	7654	180	0	7906
27218	6942	14	144	96	0	7196
27219	146	7592	53	63	0	7854
27220	53	149	39	7734	0	7975
27221	46	49	30	7645	0	7770
27222	55	31	16	7545	0	7647
27223	46	7593	24	189	0	7852
27224	7571	148	32	94	0	7845
27225	162	47	7596	64	0	7869
27226	77	26	7195	66	0	7364
27227	48	34	162	7238	0	7482
27228	35	27	60	7507	0	7629
27229	7420	23	51	199	0	7693
27230	139	7314	42	99	0	7594
27231	64	137	23	7482	0	7706
27232	7344	56	30	184	0	7614
27233	174	36	26	7270	0	7506
27234	7279	33	29	187	0	7528
27235	167	37	7018	104	0	7326
27236	74	7123	144	77	0	7418
27237	7175	144	50	72	0	7441
27238	168	65	7194	36	0	7463
27239	6919	27	151	56	0	7153
27240	177	38	7051	46	0	7312
27241	7083	23	159	48	0	7313
27242	173	19	60	7191	0	7443
27243	7239	25	42	161	0	7467
27244	184	24	25	7210	0	7443
27245	80	25	28	7268	0	7401
27246	7187	19	46	203	0	7455
27247	169	7124	30	103	0	7426
27248	72	147	31	7274	0	7524
27249	7409	62	24	175	0	7670
27250	7674	41	32	77	0	7824
27251	209	29	27	7524	0	7789
27252	90	30	23	7822	0	7965
27253	7851	24	22	228	0	8125
27254	222	22	21	7995	0	8260
27255	96	34	27	7956	0	8113
27256	7822	13	27	245	0	8107
27257	203	17	21	7653	0	7894
27258	78	13	7128	208	0	7427
27259	6794	15	145	98	0	7052
27260	172	13	7128	63	0	7376
27261	68	19	6553	41	0	6681
27262	6159	36	183	32	0	6410
27263	111	6205	68	24	0	6408
27264	44	79	38	5998	0	6159
27265	38	23	24	5989	0	6074
27266	34	16	16	6312	0	6378
27267	17	12	6	6569	0	6604
27268	6244	19	9	171	0	6443
27269	6949	8	5	65	0	7027
27270	7263	2	7	46	0	7318
27271	196	5	7879	23	0	8103
27272	75	7	185	8228	0	8495
27273	44	6	92	8500	0	8642
27274	33	2	39	8291	0	8365
27275	30	7931	20	352	0	8333
27276	19	8246	17	187	0	8469
27277	8392	311	7	112	0	8822
27278	251	159	4	8490	0	8904
27279	123	67	11	8999	0	9200
27280	73	28	10	9275	0	9386
27281	49	16	8775	457	0	9297
27282	49	17	8669	221	0	8956
27283	8575	12	381	120	0	9088
27284	9137	19	183	75	0	9414
27285	405	20	85	8764	0	9274
27286	194	8796	49	298	0	9337
27287	107	264	30	8930	0	9331
27288	74	125	21	9024	0	9244
27289	50	64	8602	444	0	9160
27290	8653	32	279	246	0	9210
27291	323	18	137	9127	0	9605
27292	161	21	72	9109	0	9363
27293	8715	13	42	470	0	9240
27294	334	8928	40	235	0	9537
27295	9193	308	32	140	0	9673
27296	405	148	27	8966	0	9546
27297	188	8852	24	347	0	9411
27298	8961	324	17	188	0	9490
27299	368	168	25	8907	0	9468
27300	8895	85	24	376	0	9380
27301	8816	41	26	227	0	9110
27302	8864	34	23	152	0	9073
27303	530	8360	21	108	0	9019
27304	272	8417	27	91	0	8807
27305	175	415	28	8096	0	8714
27306	109	8407	29	334	0	8879
27307	8485	367	14	203	0	9069
27308	381	185	17	8500	0	9083
27309	8537	108	23	392	0	9060
27310	8766	74	24	224	0	9088
27311	520	48	26	8430	0	9024
27312	299	45	31	8814	0	9189
27313	8569	52	26	517	0	9164
27314	8711	60	14	296	0	9081
27315	9043	64	22	197	0	9326
27316	9116	55	20	160	0	9351
27317	9263	50	17	131	0	9461
27318	611	48	16	8800	0	9475
27319	347	43	25	8999	0	9414
27320	222	41	27	9214	0	9504
27321	8825	43	22	577	0	9467
27322	444	35	29	8769	0	9277
27323	275	8566	25	485	0	9351
27324	202	325	21	8898	0	9446
27325	8701	169	21	477	0	9368
27326	8925	106	20	287	0	9338
27327	549	78	8432	202	0	9261
27328	336	69	294	8283	0	8982
27329	208	8526	139	432	0	9305
27330	8655	325	75	283	0	9338
27331	436	8727	41	199	0	9403
27332	288	386	43	8787	0	9504
27333	8868	190	44	412	0	9514
27334	9038	119	22	272	0	9451
27335	561	8726	29	198	0	9514
27336	324	356	24	8711	0	9415
27337	223	191	8566	422	0	9402
27338	8360	121	302	269	0	9052
27339	462	96	8557	189	0	9304
27340	8663	72	369	146	0	9250
27341	8951	70	166	161	0	9348
27342	597	62	87	8685	0	9431
27343	8911	62	56	466	0	9495
27344	9089	77	36	262	0	9464
27345	9243	75	42	186	0	9546
27346	676	63	31	8782	0	9552
27347	8952	51	37	432	0	9472
27348	549	59	31	8821	0	9460
27349	355	47	41	8728	0	9171
27350	241	8396	48	544	0	9229
27351	229	319	40	8219	0	8807
27352	203	8277	30	434	0	8944
27353	8127	345	16	243	0	8731
27354	8150	181	22	205	0	8558
27355	542	124	15	7942	0	8623
27356	352	64	18	8068	0	8502
27357	7893	58	26	537	0	8514
27358	435	65	7563	293	0	8356
27359	7816	58	254	198	0	8326
27360	472	57	132	7628	0	8289
27361	302	60	7178	382	0	7922
27362	7188	54	264	262	0	7768
27363	7526	54	140	183	0	7903
27364	542	47	7189	145	0	7923
27365	7233	43	261	140	0	7677
27366	420	45	6872	129	0	7466
27367	306	6779	276	93	0	7454
27368	6794	243	202	121	0	7360
27369	6726	138	108	121	0	7093
27370	433	6242	53	87	0	6815
27371	185	5578	37	63	0	5863
27372	5164	160	84	58	0	5466
27373	5193	57	26	57	0	5333
27374	240	37	29	5203	0	5509
27375	128	31	4995	154	0	5308
27376	95	27	4824	77	0	5023
27377	4920	27	148	60	0	5155
27378	173	25	4973	48	0	5219
27379	4722	50	112	29	0	4913
27380	159	21	35	4590	0	4805
27381	76	14	24	4654	0	4768
27382	53	13	4671	128	0	4865
27383	4631	11	82	70	0	4794
27384	114	22	53	4731	0	4920
27385	79	12	31	4984	0	5106
27386	4919	7	21	128	0	5075
27387	4909	13	18	86	0	5026
27388	4939	7	20	66	0	5032
27389	141	5021	20	39	0	5221
27390	71	62	4779	31	0	4943
27391	4647	21	63	36	0	4767
27392	4821	19	30	30	0	4900
27393	105	4653	24	32	0	4814
27394	4416	32	26	14	0	4488
27395	57	12	11	4345	0	4425
27396	23	10	4482	41	0	4556
27397	4329	6	52	22	0	4409
27398	4504	4	18	19	0	4545
27399	4561	3	9	12	0	4585
27400	4569	5	8	18	0	4600
27401	65	3	7	4558	0	4633
27402	28	10	7	4561	0	4606
27403	4598	5	7	53	0	4663
27404	52	5	10	4579	0	4646
27405	33	2	8	4548	0	4591
27406	23	4473	11	51	0	4558
27407	20	39	3	4593	0	4655
27408	15	14	8	4597	0	4634
27409	21	6	8	4618	0	4653
27410	22	9	4	4631	0	4666
27411	13	4574	5	65	0	4657
27412	24	38	3	4510	0	4575
27413	21	17	2	4404	0	4444
27414	14	8	4372	61	0	4455
27415	15	4	4024	27	0	4070
27416	8	4257	46	10	0	4321
27417	4955	31	19	10	0	5015
27418	75	5092	13	11	0	5191
27419	25	83	3	5388	0	5499
27420	18	22	5778	98	0	5916
27421	6047	7	108	47	0	6209
27422	121	6	29	6391	0	6547
27423	6310	9	10	137	0	6466
27424	6448	3	15	47	0	6513
27425	148	6462	4	20	0	6634
27426	6463	118	4	21	0	6606
27427	133	6648	8	17	0	6806
27428	55	151	5	6750	0	6961
27429	18	6758	10	123	0	6909
27430	21	133	6711	49	0	6914
27431	18	6854	130	22	0	7024
27432	22	158	46	6675	0	6901
27433	6656	47	12	141	0	6856
27434	131	6920	6	48	0	7105
27435	54	153	6	6959	0	7172
27436	25	50	6	7192	0	7273
27437	26	19	7069	199	0	7313
27438	30	18	149	6998	0	7195
27439	24	14	7040	179	0	7257
27440	6742	14	167	75	0	6998
27441	178	8	7214	29	0	7429
27442	68	7244	169	26	0	7507
27443	48	167	56	7222	0	7493
27444	43	61	17	7300	0	7421
27445	39	32	19	7328	0	7418
27446	7295	28	14	243	0	7580
27447	186	30	14	7118	0	7348
27448	72	7176	21	199	0	7468
27449	7013	190	19	91	0	7313
27450	178	7012	20	64	0	7274
27451	72	194	17	7001	0	7284
27452	6977	77	15	208	0	7277
27453	191	6815	18	100	0	7124
27454	75	7147	16	55	0	7293
27455	7050	214	16	74	0	7354
27456	7231	78	24	55	0	7388
27457	242	49	7027	45	0	7363
27458	7075	39	183	56	0	7353
27459	205	48	7274	48	0	7575
27460	98	38	199	7296	0	7631
27461	45	34	7382	224	0	7685
27462	51	37	209	7357	0	7654
27463	55	32	7420	227	0	7734
27464	36	34	204	7291	0	7565
27465	40	37	74	7528	0	7679
27466	7319	29	47	284	0	7679
27467	208	38	7222	128	0	7596
27468	6900	31	207	86	0	7224
27469	242	27	7142	61	0	7472
27470	94	38	7142	55	0	7329
27471	74	60	235	7017	0	7386
27472	7081	29	94	221	0	7425
27473	200	7098	44	107	0	7449
27474	6995	192	47	71	0	7305
27475	7063	79	38	60	0	7240
27476	246	6932	37	83	0	7298
27477	6996	203	41	53	0	7293
27478	239	82	7116	50	0	7487
27479	116	61	201	7121	0	7499
27480	7155	32	96	233	0	7516
27481	220	7163	58	104	0	7545
27482	97	191	56	7172	0	7516
27483	71	73	46	7252	0	7442
27484	62	51	45	7378	0	7536
27485	64	39	44	7411	0	7558
27486	7205	30	53	295	0	7583
27487	7312	26	53	137	0	7528
27488	7318	32	47	91	0	7488
27489	7089	28	55	85	0	7257
27490	281	42	7033	66	0	7422
27491	6984	32	189	77	0	7282
27492	7270	37	94	63	0	7464
27493	296	7028	48	71	0	7443
27494	145	7269	52	71	0	7537
27495	109	245	48	7018	0	7420
27496	97	100	37	7110	0	7344
27497	94	63	6923	246	0	7326
27498	66	6992	200	121	0	7379
27499	76	192	95	6850	0	7213
27500	74	7020	60	223	0	7377
27501	54	210	50	7230	0	7544
27502	68	89	38	7247	0	7442
27503	78	7382	46	270	0	7776
27504	68	199	37	7542	0	7846
27505	80	93	7536	251	0	7960
27506	90	41	7437	132	0	7700
27507	7271	41	274	109	0	7695
27508	7687	24	104	93	0	7908
27509	287	7534	74	63	0	7958
27510	7674	204	55	68	0	8001
27511	277	92	41	7618	0	8028
27512	7637	62	39	247	0	7985
27513	243	7628	40	138	0	8049
27514	145	202	7475	91	0	7913
27515	7307	79	226	106	0	7718
27516	268	75	7657	65	0	8065
27517	98	48	6783	49	0	6978
27518	79	41	6752	52	0	6924
27519	59	6541	178	40	0	6818
27520	6009	165	231	50	0	6455
27521	5785	51	52	45	0	5933
27522	138	34	39	5699	0	5910
27523	74	30	37	5624	0	5765
27524	50	5763	28	140	0	5981
27525	5774	90	32	68	0	5964
27526	116	5734	26	43	0	5919
27527	77	5624	16	41	0	5758
27528	5514	98	18	36	0	5666
27529	104	48	29	5483	0	5664
27530	57	22	28	5477	0	5584
27531	47	30	23	5529	0	5629
27532	49	5472	14	106	0	5641
27533	5384	78	20	60	0	5542
27534	96	50	13	5308	0	5467
27535	43	5073	14	87	0	5217
27536	28	5092	14	43	0	5177
27537	32	80	7	4937	0	5056
27538	22	4983	13	73	0	5091
27539	29	82	10	4957	0	5078
27540	4857	30	7	74	0	4968
27541	68	18	4716	38	0	4840
27542	23	4762	48	31	0	4864
27543	21	57	19	4849	0	4946
27544	22	30	4980	55	0	5087
27545	4781	24	57	37	0	4899
27546	74	26	25	5014	0	5139
27547	5043	9	23	72	0	5147
27548	4999	11	14	38	0	5062
27549	79	5263	13	25	0	5380
27550	5383	51	17	23	0	5474
27551	5355	29	8	18	0	5410
27552	5385	21	12	19	0	5437
27553	98	14	7	5194	0	5313
27554	61	14	5	5196	0	5276
27555	41	13	4	5303	0	5361
27556	26	13	5181	82	0	5302
27557	32	5130	47	39	0	5248
27558	5046	49	22	40	0	5157
27559	53	4993	19	26	0	5091
27560	24	57	9	4995	0	5085
27561	26	24	4920	51	0	5021
27562	4474	19	40	42	0	4575
27563	47	4895	17	27	0	4986
27564	26	60	12	4877	0	4975
27565	25	22	5	4877	0	4929
27566	10	32	4793	61	0	4896
27567	14	4781	46	38	0	4879
27568	18	46	18	4817	0	4899
27569	14	24	15	4850	0	4903
27570	17	20	9	4729	0	4775
27571	4603	15	7	79	0	4704
27572	50	19	4573	40	0	4682
27573	29	4521	47	40	0	4637
27574	4528	45	20	29	0	4622
27575	55	4565	20	19	0	4659
27576	28	62	8	4503	0	4601
27577	33	4573	9	53	0	4668
27578	4370	56	12	20	0	4458
27579	4455	29	6	33	0	4523
27580	75	26	5	4602	0	4708
27581	39	15	11	4627	0	4692
27582	28	19	4	4752	0	4803
27583	28	11	4781	104	0	4924
27584	21	4991	80	46	0	5138
27585	25	82	27	5923	0	6057
27586	14	32	24	6087	0	6157
27587	18	30	9	6174	0	6231
27588	23	10	19	6164	0	6216
27589	11	29	6026	216	0	6282
27590	16	6437	133	101	0	6687
27591	23	164	57	6758	0	7002
27592	15	79	24	7412	0	7530
27593	13	43	7225	277	0	7558
27594	20	21	189	7008	0	7238
27595	15	6947	83	239	0	7284
27596	10	7354	44	133	0	7541
27597	11	250	20	7276	0	7557
27598	14	105	7025	244	0	7388
27599	6412	56	191	165	0	6824
27600	176	6910	96	98	0	7280
27601	85	209	6686	66	0	7046
27602	52	99	6695	69	0	6915
27603	19	6612	260	71	0	6962
27604	35	197	6737	53	0	7022
27605	43	165	230	6532	0	6970
27606	6484	62	116	212	0	6874
27607	6635	44	76	114	0	6869
27608	6637	46	49	76	0	6808
27609	6802	49	46	51	0	6948
27610	265	6868	46	67	0	7246
27611	6967	202	47	64	0	7280
27612	239	7057	48	52	0	7396
27613	120	234	6967	49	0	7370
27614	89	116	202	6685	0	7092
27615	51	7121	98	202	0	7472
27616	63	222	60	6963	0	7308
27617	6737	123	40	238	0	7138
27618	225	66	57	6669	0	7017
27619	115	6904	54	236	0	7309
27620	6948	230	38	124	0	7340
27621	216	121	6933	92	0	7362
27622	130	74	217	6892	0	7313
27623	70	59	107	7139	0	7375
27624	6722	65	59	306	0	7152
27625	231	6747	43	163	0	7184
27626	139	221	6676	98	0	7134
27627	92	118	201	6705	0	7116
27628	60	82	6787	245	0	7174
27629	67	6514	228	143	0	6952
27630	54	6930	105	100	0	7189
27631	6744	295	84	84	0	7207
27632	209	151	6741	107	0	7208
27633	6800	89	231	108	0	7228
27634	243	80	130	6550	0	7003
27635	112	6829	81	239	0	7261
27636	6819	243	67	137	0	7266
27637	234	144	6883	95	0	7356
27638	141	85	223	6896	0	7345
27639	96	71	134	7024	0	7325
27640	73	79	103	6908	0	7163
27641	81	6835	68	327	0	7311
27642	6671	240	73	159	0	7143
27643	213	6656	67	133	0	7069
27644	129	6785	66	92	0	7072
27645	94	291	74	6716	0	7175
27646	6712	165	72	235	0	7184
27647	6649	81	64	152	0	6946
27648	6713	100	63	102	0	6978
27649	305	6356	55	80	0	6796
27650	149	247	49	6337	0	6782
27651	116	133	6340	226	0	6815
27652	114	84	198	6345	0	6741
27653	99	98	103	6262	0	6562
27654	92	6395	62	297	0	6846
27655	6445	234	59	195	0	6933
27656	236	142	58	6346	0	6782
27657	139	6483	57	273	0	6952
27658	6482	235	57	179	0	6953
27659	241	163	6366	115	0	6885
27660	6321	101	209	111	0	6742
27661	254	6541	109	121	0	7025
27662	6620	259	82	96	0	7057
27663	6712	173	57	90	0	7032
27664	317	110	6567	79	0	7073
27665	6603	102	206	93	0	7004
27666	295	87	6787	84	0	7253
27667	196	79	6837	71	0	7183
27668	6680	92	279	63	0	7114
27669	6900	82	147	81	0	7210
27670	341	79	6878	69	0	7367
27671	190	72	254	6681	0	7197
27672	128	84	149	6713	0	7074
27673	126	7002	97	275	0	7500
27674	6710	217	83	163	0	7173
27675	7205	136	63	105	0	7509
27676	342	97	6986	73	0	7498
27677	7132	72	215	84	0	7503
27678	7375	77	125	72	0	7649
27679	340	7182	98	76	0	7696
27680	213	227	62	7112	0	7614
27681	158	141	80	6940	0	7319
27682	160	84	62	7049	0	7355
27683	6712	65	62	266	0	7105
27684	256	6461	60	145	0	6922
27685	100	170	47	5468	0	5785
27686	70	5483	50	126	0	5729
27687	73	279	38	5166	0	5556
27688	57	5285	32	128	0	5502
27689	66	5397	34	68	0	5565
27690	4744	138	45	64	0	4991
27691	4667	51	60	57	0	4835
27692	71	14	9	4331	0	4425
27693	25	4	10	4359	0	4398
27694	12	9	7	4404	0	4432
27695	11	16	3	4377	0	4407
27696	23	4	6	4258	0	4291
27697	10	4228	9	65	0	4312
27698	11	46	8	4294	0	4359
27699	12	19	1	4354	0	4386
27700	4256	13	3	68	0	4340
27701	69	12	3	4282	0	4366
27702	23	6	13	4297	0	4339
27703	13	8	4302	76	0	4399
27704	8	9	59	4177	0	4253
27705	18	22	13	4362	0	4415
27706	29	12	4399	66	0	4506
27707	16	4431	57	30	0	4534
27708	8	65	4594	21	0	4688
27709	7	13	4475	23	0	4518
27710	6	4311	52	12	0	4381
27711	4335	46	19	18	0	4418
27712	4314	11	1	10	0	4336
27713	61	0	5	4234	0	4300
27714	4248	4	3	59	0	4314
27715	52	5	4377	16	0	4450
27716	11	5	51	4377	0	4444
27717	6	6	4893	66	0	4971
27718	14	3	57	4886	0	4960
27719	12	4	14	4883	0	4913
27720	12	6	5	4980	0	5003
27721	4901	2	8	81	0	4992
27722	68	6	4	4960	0	5038
27723	4935	6	5	77	0	5023
27724	5006	8	6	28	0	5048
27725	63	5000	10	22	0	5095
27726	5073	57	8	23	0	5161
27727	61	5184	13	27	0	5285
27728	24	58	6	5170	0	5258
27729	24	16	2	5248	0	5290
27730	16	3	12	5362	0	5393
27731	13	14	5203	100	0	5330
27732	10	5183	78	30	0	5301
27733	18	83	17	4979	0	5097
27734	19	20	15	5041	0	5095
27735	16	5185	5	74	0	5280
27736	5208	79	7	27	0	5321
27737	81	5078	12	28	0	5199
27738	5042	79	6	28	0	5155
27739	87	5087	7	26	0	5207
27740	27	84	8	4952	0	5071
27741	21	5144	6	82	0	5253
27742	5245	85	5	45	0	5380
27743	5330	20	7	36	0	5393
27744	5281	15	10	32	0	5338
27745	5275	13	4	37	0	5329
27746	97	10	5309	32	0	5448
27747	5260	12	75	37	0	5384
27748	5473	13	17	43	0	5546
27749	5476	13	10	35	0	5534
27750	99	23	5366	22	0	5510
27751	5239	14	74	27	0	5354
27752	87	5477	18	28	0	5610
27753	5571	88	13	20	0	5692
27754	97	27	5827	22	0	5973
27755	5753	16	68	25	0	5862
27756	5927	14	20	21	0	5982
27757	101	14	7	5868	0	5990
27758	39	9	5807	85	0	5940
27759	5791	6	71	46	0	5914
27760	92	16	26	5970	0	6104
27761	38	11	15	6002	0	6066
27762	25	9	6042	99	0	6175
27763	5583	10	73	57	0	5723
27764	6105	12	24	23	0	6164
27765	87	6063	10	28	0	6188
27766	46	76	7	6088	0	6217
27767	35	25	14	6082	0	6156
27768	30	17	9	6032	0	6088
27769	30	6091	13	95	0	6229
27770	6103	82	10	37	0	6232
27771	95	20	12	6087	0	6214
27772	42	12	10	6145	0	6209
27773	5966	10	7	107	0	6090
27774	5882	12	13	48	0	5955
27775	97	12	18	5910	0	6037
27776	50	13	11	5857	0	5931
27777	26	15	5603	86	0	5730
27778	5171	17	61	53	0	5302
27779	83	5585	25	30	0	5723
27780	48	78	8	5913	0	6047
27781	36	29	4	6030	0	6099
27782	31	6230	4	133	0	6398
27783	28	102	16	6429	0	6575
27784	6902	44	17	130	0	7093
27785	142	20	10	8143	0	8315
27786	70	11	9	8407	0	8497
27787	38	12	10	8661	0	8721
27788	33	11	8331	355	0	8730
27789	34	13	204	8433	0	8684
27790	33	11	8309	300	0	8653
27791	32	8052	233	163	0	8480
27792	31	199	124	8152	0	8506
27793	25	96	59	8291	0	8471
27794	28	48	37	8441	0	8554
27795	17	32	31	8380	0	8460
27796	21	26	23	8537	0	8607
27797	8006	16	25	406	0	8453
27798	200	24	8111	222	0	8557
27799	107	7825	192	147	0	8271
27800	43	8434	96	112	0	8685
27801	44	282	51	8328	0	8705
27802	40	132	28	8584	0	8784
27803	30	64	34	8459	0	8587
27804	27	8283	18	361	0	8689
27805	28	216	27	8441	0	8712
27806	22	120	8116	301	0	8559
27807	14	7981	192	186	0	8373
27808	21	220	98	8117	0	8456
27809	8031	113	40	290	0	8474
27810	194	54	32	8186	0	8466
27811	110	49	28	8139	0	8326
27812	57	7737	20	337	0	8151
27813	43	8260	23	189	0	8515
27814	28	263	24	8299	0	8614
27815	29	140	17	8331	0	8517
27816	22	72	7998	363	0	8455
27817	24	63	188	7705	0	7980
27818	10	40	108	7873	0	8031
27819	16	37	59	7915	0	8027
27820	13	44	39	7996	0	8092
27821	7559	33	33	426	0	8051
27822	7711	29	33	258	0	8031
27823	286	26	26	7854	0	8192
27824	144	24	23	8137	0	8328
27825	7844	20	16	453	0	8333
27826	253	16	30	8220	0	8519
27827	150	23	8081	401	0	8655
27828	75	8078	227	266	0	8646
27829	64	224	133	8290	0	8711
27830	42	130	71	8526	0	8769
27831	8313	78	61	429	0	8881
27832	215	62	48	8590	0	8915
27833	136	43	32	8778	0	8989
27834	8559	47	30	472	0	9108
27835	243	43	23	8721	0	9030
27836	149	8646	27	390	0	9212
27837	75	228	30	9211	0	9544
27838	71	142	27	9576	0	9816
27839	61	64	37	9569	0	9731
27840	47	66	36	9659	0	9808
27841	40	71	9117	516	0	9744
27842	35	72	9004	325	0	9436
27843	19	68	332	9188	0	9607
27844	27	53	162	9218	0	9460
27845	24	9089	69	501	0	9683
27846	34	252	63	8953	0	9302
27847	36	8985	66	417	0	9504
27848	8848	286	58	298	0	9490
27849	254	9310	50	211	0	9825
27850	146	311	36	9539	0	10032
27851	80	188	23	9825	0	10116
27852	70	112	9334	518	0	10034
27853	8781	82	235	361	0	9459
27854	9059	67	140	247	0	9513
27855	358	9000	76	211	0	9645
27856	191	264	62	8911	0	9428
27857	96	157	9341	356	0	9950
27858	73	9473	279	278	0	10103
27859	9345	287	144	209	0	9985
27860	9455	173	59	196	0	9883
27861	419	80	8986	192	0	9677
27862	9045	76	250	194	0	9565
27863	364	64	134	9164	0	9726
27864	213	9134	71	372	0	9790
27865	9152	272	80	248	0	9752
27866	334	168	56	9169	0	9727
27867	9266	75	51	406	0	9798
27868	9612	66	40	289	0	10007
27869	433	67	44	9387	0	9931
27870	220	69	9355	420	0	10064
27871	9330	64	259	305	0	9958
27872	9748	54	147	191	0	10140
27873	9757	50	74	182	0	10063
27874	438	9775	54	190	0	10457
27875	254	268	40	9870	0	10432
27876	152	157	45	10332	0	10686
27877	114	87	10054	520	0	10775
27878	119	94	279	9886	0	10378
27879	74	9941	151	438	0	10604
27880	9642	255	75	296	0	10268
27881	282	9706	50	217	0	10255
27882	160	264	9372	168	0	9964
27883	100	9362	265	148	0	9875
27884	85	9299	130	111	0	9625
27885	101	183	120	7758	0	8162
27886	7771	64	32	137	0	8004
27887	7725	29	13	67	0	7834
27888	7641	23	4	52	0	7720
27889	153	7861	10	42	0	8066
27890	74	120	7784	33	0	8011
27891	7694	48	117	40	0	7899
27892	8019	29	52	28	0	8128
27893	165	7907	18	27	0	8117
27894	8174	124	18	33	0	8349
27895	146	57	19	8139	0	8361
27896	77	37	8408	132	0	8654
27897	8298	23	120	77	0	8518
27898	8453	34	48	42	0	8577
27899	8777	16	26	37	0	8856
27900	181	17	13	8583	0	8794
27901	91	20	20	8703	0	8834
27902	58	21	14	9232	0	9325
27903	35	9110	21	219	0	9385
27904	84	182	35	9139	0	9440
27905	38	68	12	10695	0	10813
27906	31	46	10517	311	0	10905
27907	39	34	232	10502	0	10807
27908	31	30	80	10826	0	10967
27909	44	28	45	10730	0	10847
27910	49	18	29	10574	0	10670
27911	37	10416	28	382	0	10863
27912	39	245	28	10578	0	10890
27913	45	82	24	10623	0	10774
27914	10273	53	29	385	0	10740
27915	268	41	10199	188	0	10696
27916	107	40	9970	139	0	10256
27917	9779	36	316	110	0	10241
27918	10363	35	132	99	0	10629
27919	353	34	72	9532	0	9991
27920	145	10167	67	250	0	10629
27921	10313	243	42	146	0	10744
27922	319	81	41	10032	0	10473
27923	138	10180	39	290	0	10647
27924	10174	238	25	122	0	10559
27925	263	10278	22	91	0	10654
27926	10040	249	18	96	0	10403
27927	9812	98	27	93	0	10030
27928	337	9576	29	59	0	10001
27929	147	240	33	9543	0	9963
27930	103	97	9493	240	0	9933
27931	110	89	209	9291	0	9699
27932	9350	63	63	284	0	9760
27933	261	51	9198	137	0	9647
27934	110	9103	218	125	0	9556
27935	115	259	76	9007	0	9457
27936	58	95	8915	275	0	9343
27937	48	8781	221	129	0	9179
27938	8615	209	88	119	0	9031
27939	223	94	71	8680	0	9068
27940	113	65	55	8779	0	9012
27941	96	50	60	8626	0	8832
27942	53	8561	38	307	0	8959
27943	8540	208	33	171	0	8952
27944	216	8396	52	126	0	8790
27945	101	8685	18	112	0	8916
27946	8693	250	18	96	0	9057
27947	8754	119	39	88	0	9000
27948	268	102	8470	73	0	8913
27949	8244	72	182	77	0	8575
27950	8287	58	90	43	0	8478
27951	312	75	56	8011	0	8454
27952	175	62	7957	216	0	8410
27953	129	46	191	7958	0	8324
27954	8098	37	75	275	0	8485
27955	255	41	8212	145	0	8653
27956	140	50	217	8876	0	9283
27957	145	35	96	9603	0	9879
27958	91	52	62	10757	0	10962
27959	10511	50	56	524	0	11141
27960	426	10758	52	220	0	11456
27961	10872	400	31	165	0	11468
27962	478	115	10831	116	0	11540
27963	182	81	401	10422	0	11086
27964	131	10832	118	463	0	11544
27965	10915	405	83	222	0	11625
27966	456	138	86	10952	0	11632
27967	180	97	10687	491	0	11455
27968	136	74	399	10662	0	11271
27969	10236	90	150	510	0	10986
27970	441	10262	87	250	0	11040
27971	178	438	58	9382	0	10056
27972	114	10187	61	444	0	10806
27973	10141	434	61	211	0	10847
27974	10164	166	43	163	0	10536
27975	524	9913	49	138	0	10624
27976	9869	418	75	113	0	10475
27977	490	152	38	9272	0	9952
27978	201	9681	39	396	0	10317
27979	9631	419	42	162	0	10254
27980	9970	151	48	131	0	10300
27981	544	9278	62	80	0	9964
27982	247	9679	34	118	0	10078
27983	9521	464	28	95	0	10108
27984	485	219	30	9398	0	10132
27985	9558	122	27	435	0	10142
27986	517	124	29	9487	0	10157
27987	238	96	9285	442	0	10061
27988	192	96	358	9497	0	10143
27989	9351	109	92	492	0	10044
27990	477	83	9354	198	0	10112
27991	203	59	391	9391	0	10044
27992	148	72	112	9835	0	10167
27993	161	60	9392	522	0	10135
27994	9082	52	391	229	0	9754
27995	445	76	138	9364	0	10023
27996	169	69	8909	467	0	9614
27997	8274	56	409	216	0	8955
27998	409	8717	149	182	0	9457
27999	185	8781	119	135	0	9220
28000	135	8969	74	183	0	9361
28001	97	444	8401	133	0	9075
28002	114	208	362	7959	0	8643
28003	113	80	7886	393	0	8472
28004	76	251	292	6846	0	7465
28005	51	6587	104	302	0	7044
28006	53	6781	56	112	0	7002
28007	57	314	50	6586	0	7007
28008	6582	116	38	310	0	7046
28009	263	74	38	6721	0	7096
28010	92	81	33	6736	0	6942
28011	65	6617	28	335	0	7045
28012	6585	269	26	154	0	7034
28013	274	6672	35	104	0	7085
28014	115	282	32	6696	0	7125
28015	79	112	31	6739	0	6961
28016	78	6608	31	352	0	7069
28017	92	295	26	6732	0	7145
28018	6630	121	24	357	0	7132
28019	318	123	25	6662	0	7128
28020	169	97	30	6738	0	7034
28021	144	6578	43	347	0	7112
28022	102	298	58	6765	0	7223
28023	6419	132	44	362	0	6957
28024	6687	115	38	169	0	7009
28025	6843	105	37	153	0	7138
28026	403	94	29	6662	0	7188
28027	189	79	6446	362	0	7076
28028	151	67	6537	178	0	6933
28029	142	80	294	6599	0	7115
28030	6637	107	99	350	0	7193
28031	360	92	64	6691	0	7207
28032	6776	92	37	377	0	7282
28033	388	88	55	6787	0	7318
28034	207	77	52	7066	0	7402
28035	6934	87	42	395	0	7458
28036	391	90	6666	181	0	7328
28037	6733	88	264	152	0	7237
28038	391	83	6741	131	0	7346
28039	196	67	284	6730	0	7277
28040	6834	76	97	355	0	7362
28041	368	74	6864	144	0	7450
28042	184	76	6937	117	0	7314
28043	6833	79	348	131	0	7391
28044	360	61	6907	145	0	7473
28045	176	6773	328	132	0	7409
28046	131	278	129	7115	0	7653
28047	7449	98	133	388	0	8068
28048	346	70	7510	183	0	8109
28049	7509	41	336	154	0	8040
28050	7837	55	155	139	0	8186
28051	7818	60	115	164	0	8157
28052	7904	52	98	155	0	8209
28053	416	115	100	7367	0	7998
28054	191	7495	90	365	0	8141
28055	7340	277	87	190	0	7894
28056	330	74	6577	115	0	7096
28057	107	5327	135	72	0	5641
28058	4663	62	68	58	0	4851
28059	74	4269	41	29	0	4413
28060	53	4428	15	29	0	4525
28061	136	73	56	4302	0	4567
28062	27	22	22	4426	0	4497
28063	25	13	13	4401	0	4452
28064	4520	8	13	87	0	4628
28065	4719	6	16	49	0	4790
28066	92	7	21	4901	0	5021
28067	52	5	18	5251	0	5326
28068	40	5	5430	120	0	5595
28069	5311	9	116	62	0	5498
28070	5653	12	46	29	0	5740
28071	158	9	20	5574	0	5761
28072	79	8	22	5648	0	5757
28073	38	10	5543	165	0	5756
28074	40	5	131	5526	0	5702
28075	38	6	5751	137	0	5932
28076	41	5688	137	55	0	5921
28077	39	107	5816	38	0	6000
28078	36	52	138	5629	0	5855
28079	22	26	5942	116	0	6106
28080	28	20	5677	63	0	5788
28081	5725	13	159	32	0	5929
28082	132	17	69	6181	0	6399
28083	68	9	6240	127	0	6444
28084	5718	10	139	79	0	5946
28085	146	17	6259	42	0	6464
28086	74	20	6825	27	0	6946
28087	36	6919	175	65	0	7195
28088	30	121	69	6890	0	7110
28089	27	42	6886	135	0	7090
28090	31	22	6630	55	0	6738
28091	34	13	165	6655	0	6867
28092	36	7	80	6698	0	6821
28093	29	6782	51	158	0	7020
28094	38	123	19	6922	0	7102
28095	7018	40	38	177	0	7273
28096	7018	26	48	62	0	7154
28097	7211	14	23	63	0	7311
28098	202	7	32	6995	0	7236
28099	82	7091	43	151	0	7367
28100	7173	129	36	79	0	7417
28101	145	7154	38	63	0	7400
28102	65	7016	39	55	0	7175
28103	47	7242	43	40	0	7372
28104	7305	165	48	52	0	7570
28105	147	65	45	7250	0	7507
28106	75	35	44	7211	0	7365
28107	48	7252	43	166	0	7509
28108	7170	135	42	84	0	7431
28109	150	50	7142	55	0	7397
28110	76	28	152	7176	0	7432
28111	7232	20	83	153	0	7488
28112	153	7528	53	68	0	7802
28113	7845	137	40	91	0	8113
28114	162	62	44	7815	0	8083
28115	74	7985	41	145	0	8245
28116	53	136	7881	69	0	8139
28117	7843	57	151	63	0	8114
28118	154	45	70	8173	0	8442
28119	8290	24	44	182	0	8540
28120	172	30	35	8190	0	8427
28121	87	8025	30	187	0	8329
28122	49	135	8177	89	0	8450
28123	65	60	8149	69	0	8343
28124	54	81	168	8150	0	8453
28125	8316	31	85	150	0	8582
28126	8354	24	40	81	0	8499
28127	163	27	38	8263	0	8491
28128	87	25	41	8295	0	8448
28129	8375	24	39	181	0	8619
28130	142	27	36	8435	0	8640
28131	8409	31	30	171	0	8641
28132	160	8345	45	81	0	8631
28133	8329	113	44	88	0	8574
28134	159	68	8439	58	0	8724
28135	90	39	140	8377	0	8646
28136	64	34	79	8607	0	8784
28137	55	22	62	8668	0	8807
28138	62	8350	45	215	0	8672
28139	79	7494	55	116	0	7744
28140	40	159	40	8516	0	8755
28141	37	73	8376	178	0	8664
28142	38	47	139	8273	0	8497
28143	45	34	81	8506	0	8666
28144	55	8334	63	188	0	8640
28145	8274	127	49	85	0	8535
28146	143	8068	50	63	0	8324
28147	76	8201	55	59	0	8391
28148	62	160	43	8181	0	8446
28149	49	70	54	8237	0	8410
28150	63	43	35	8149	0	8290
28151	42	38	41	8266	0	8387
28152	8118	32	52	199	0	8401
28153	130	8085	46	130	0	8391
28154	8221	137	47	72	0	8477
28155	8396	57	49	91	0	8593
28156	165	46	39	8320	0	8570
28157	84	43	27	8444	0	8598
28158	8377	23	40	199	0	8639
28159	8468	40	28	110	0	8646
28160	177	46	26	8324	0	8573
28161	102	33	16	8418	0	8569
28162	59	49	8370	184	0	8662
28163	52	8078	92	114	0	8336
28164	73	8491	42	72	0	8678
28165	8194	106	27	56	0	8383
28166	114	55	8237	56	0	8462
28167	60	27	7595	47	0	7729
28168	7032	30	81	32	0	7175
28169	7507	7	36	33	0	7583
28170	56	8059	16	25	0	8156
28171	32	8510	7	29	0	8578
28172	25	60	5	8657	0	8747
28173	8977	30	11	71	0	9089
28174	8966	10	5	47	0	9028
28175	9056	12	5	51	0	9124
28176	63	11	9	8905	0	8988
28177	39	12	13	9057	0	9121
28178	26	14	8836	68	0	8944
28179	16	20	8165	44	0	8245
28180	23	17	8752	22	0	8814
28181	31	93	66	8649	0	8839
28182	8596	2	22	57	0	8677
28183	47	6	8777	21	0	8851
28184	26	11	37	8652	0	8726
28185	13	8881	15	44	0	8953
28186	22	38	4	8593	0	8657
28187	9	15	9	8567	0	8600
28188	10	4	8917	81	0	9012
28189	13	5	68	8721	0	8807
28190	9394	5	18	82	0	9499
28191	114	10	9708	25	0	9857
28192	37	9	116	9603	0	9765
28193	20	4	9913	121	0	10058
28194	15	9776	132	46	0	9969
28195	19	118	9912	18	0	10067
28196	31	38	162	9089	0	9320
28197	13	17	53	9999	0	10082
28198	9	17	10316	167	0	10509
28199	10	15	146	9876	0	10047
28200	18	14	48	9750	0	9830
28201	10	9957	29	176	0	10172
28202	13	134	10077	70	0	10294
28203	14	37	154	9870	0	10075
28204	13	16	53	10259	0	10341
28205	17	10206	27	187	0	10437
28206	10	149	38	10429	0	10626
28207	10399	46	25	186	0	10656
28208	147	23	27	10461	0	10658
28209	44	32	10524	186	0	10786
28210	10252	15	158	98	0	10523
28211	11191	13	58	62	0	11324
28212	234	12	11192	59	0	11497
28213	10607	11	205	68	0	10891
28214	219	11161	64	61	0	11505
28215	85	192	49	11441	0	11767
28216	55	74	48	12634	0	12811
28217	49	29	47	12316	0	12441
28218	43	31	26	12766	0	12866
28219	29	25	30	12803	0	12887
28220	12582	21	25	412	0	13040
28221	268	23	12438	199	0	12928
28222	11839	20	262	155	0	12276
28223	297	16	12332	148	0	12793
28224	130	18	288	12327	0	12763
28225	12463	14	121	346	0	12944
28226	305	7	85	12308	0	12705
28227	153	12431	68	315	0	12967
28228	12949	239	71	173	0	13432
28229	314	86	59	13635	0	14094
28230	138	64	12849	354	0	13405
28231	12564	41	241	201	0	13047
28232	305	13943	89	144	0	14481
28233	152	268	14256	129	0	14805
28234	106	112	294	14066	0	14578
28235	132	65	148	13448	0	13793
28236	91	14037	92	411	0	14631
28237	73	284	14134	188	0	14679
28238	85	105	315	13872	0	14377
28239	72	77	14623	390	0	15162
28240	68	62	353	14354	0	14837
28241	60	55	143	14643	0	14901
28242	70	59	14562	471	0	15162
28243	64	51	343	14510	0	14968
28244	152	76	286	11406	0	11920
28245	79	38	117	15442	0	15676
28246	74	36	112	15426	0	15648
28247	14741	32	111	600	0	15484
28248	364	23	14635	323	0	15345
28249	14974	42	366	271	0	15653
28250	420	52	183	15896	0	16551
28251	203	39	138	16246	0	16626
28252	130	43	114	16085	0	16372
28253	114	15751	119	596	0	16580
28254	15982	352	95	340	0	16769
28255	407	147	96	16318	0	16968
28256	179	16268	107	501	0	17055
28257	123	353	95	16698	0	17269
28258	16602	134	94	588	0	17418
28259	16496	114	90	350	0	17050
28260	16448	100	105	272	0	16925
28261	507	16316	99	241	0	17163
28262	236	345	16341	256	0	17178
28263	16047	167	378	266	0	16858
28264	16789	102	172	256	0	17319
28265	521	16668	134	223	0	17546
28266	16714	380	117	231	0	17442
28267	16476	167	114	229	0	16986
28268	16885	104	96	232	0	17317
28269	581	17157	114	218	0	18070
28270	312	367	106	17070	0	17855
28271	17059	175	82	534	0	17850
28272	17561	127	75	311	0	18074
28273	17060	98	63	283	0	17504
28274	17467	91	48	242	0	17848
28275	632	102	72	16978	0	17784
28276	357	110	16754	500	0	17721
28277	325	61	389	16595	0	17370
28278	264	16868	159	547	0	17838
28279	236	392	111	17511	0	18250
28280	244	161	17414	577	0	18396
28281	17296	123	411	318	0	18148
28282	570	98	187	17842	0	18697
28283	17688	118	129	570	0	18505
28284	17864	109	106	365	0	18444
28285	653	96	111	17853	0	18713
28286	411	87	17814	542	0	18854
28287	346	90	16629	301	0	17366
28288	16327	110	482	231	0	17150
28289	565	16961	217	213	0	17956
28290	297	16592	141	198	0	17228
28291	280	16485	104	171	0	17040
28292	234	17184	93	188	0	17699
28293	16722	440	149	169	0	17480
28294	16879	203	117	131	0	17330
28295	16825	143	72	162	0	17202
28296	16940	146	67	157	0	17310
28297	557	131	67	16350	0	17105
28298	333	16192	58	357	0	16940
28299	16175	345	56	219	0	16795
28300	477	162	15942	172	0	16753
28301	325	15873	299	165	0	16662
28302	275	300	16024	161	0	16760
28303	15681	146	336	156	0	16319
28304	16357	121	161	155	0	16794
28305	16458	136	122	153	0	16869
28306	544	124	100	16123	0	16891
28307	326	107	16239	357	0	17029
28308	250	16199	312	202	0	16963
28309	15903	338	144	150	0	16535
28310	468	15774	102	149	0	16493
28311	306	15249	54	143	0	15752
28312	258	15205	60	122	0	15645
28313	225	15328	66	143	0	15762
28314	209	321	14531	108	0	15169
28315	187	14908	240	125	0	15460
28316	13835	222	109	73	0	14239
28317	260	117	49	13790	0	14216
28318	164	95	44	13980	0	14283
28319	13906	80	46	240	0	14272
28320	240	13676	60	148	0	14124
28321	171	223	13917	74	0	14385
28322	157	115	187	13675	0	14134
28323	171	83	80	14044	0	14378
28324	165	78	54	14184	0	14481
28325	122	81	14013	264	0	14480
28326	132	69	13737	132	0	14070
28327	171	87	218	13841	0	14317
28328	149	80	13877	193	0	14299
28329	121	93	12711	103	0	13028
28330	11273	84	235	120	0	11712
28331	238	12757	109	92	0	13196
28332	139	12268	68	75	0	12550
28333	147	12455	51	62	0	12715
28334	137	231	52	12176	0	12596
28335	113	12817	61	151	0	13142
28336	13008	180	74	81	0	13343
28337	212	104	13083	102	0	13501
28338	13098	84	183	105	0	13470
28339	250	69	106	13379	0	13804
28340	141	78	87	13451	0	13757
28341	99	14010	55	246	0	14410
28342	13995	214	76	140	0	14425
28343	14027	97	92	103	0	14319
28344	366	14973	52	80	0	15471
28345	155	307	52	14563	0	15077
28346	125	115	14805	275	0	15320
28347	92	84	14579	122	0	14877
28348	82	15020	347	94	0	15543
28349	14748	335	142	114	0	15339
28350	324	116	14859	35	0	15334
28351	148	71	297	14561	0	15077
28352	14955	68	113	281	0	15417
28353	15198	46	61	134	0	15439
28354	390	18045	61	74	0	18570
28355	157	19272	59	65	0	19553
28356	19317	590	61	52	0	20020
28357	536	240	19193	38	0	20007
28358	19127	141	492	44	0	19804
28359	19759	106	173	59	0	20097
28360	701	80	117	19209	0	20107
28361	280	78	19659	497	0	20514
28362	189	75	19413	174	0	19851
28363	18882	58	674	106	0	19720
28364	611	83	19731	73	0	20498
28365	18773	65	619	66	0	19523
28366	19541	56	236	55	0	19888
28367	724	19182	139	61	0	20106
28368	303	534	19108	51	0	19996
28369	222	18818	557	49	0	19646
28370	18625	586	252	57	0	19520
28371	606	247	18503	48	0	19404
28372	296	157	597	17597	0	18647
28373	218	95	18348	508	0	19169
28374	187	65	18329	182	0	18763
28375	180	77	18355	93	0	18705
28376	179	76	18315	83	0	18653
28377	126	17661	801	65	0	18653
28378	155	509	17750	55	0	18469
28379	144	17381	675	57	0	18257
28380	154	575	17234	59	0	18022
28381	16886	223	688	65	0	17862
28382	631	144	293	16023	0	17091
28383	288	17301	233	430	0	18252
28384	17059	530	230	165	0	17984
28385	17312	234	204	115	0	17865
28386	16018	205	207	87	0	16517
28387	17089	153	218	57	0	17517
28388	782	16839	217	85	0	17923
28389	15865	570	198	102	0	16735
28390	17015	273	187	85	0	17560
28391	763	16368	223	91	0	17445
28392	361	617	15688	83	0	16749
28393	317	277	624	15297	0	16515
28394	260	16203	358	460	0	17281
28395	244	610	16278	205	0	17337
28396	251	311	16448	122	0	17132
28397	279	15813	806	108	0	17006
28398	291	16154	424	81	0	16950
28399	266	17013	323	126	0	17728
28400	277	17188	255	95	0	17815
28401	17111	868	257	91	0	18327
28402	17545	463	221	103	0	18332
28403	934	293	17344	97	0	18668
28404	524	266	17639	79	0	18508
28405	425	210	865	16973	0	18473
28406	370	247	468	17411	0	18496
28407	374	223	354	17771	0	18722
28408	17320	236	324	775	0	18655
28409	793	17184	301	361	0	18639
28410	460	17981	301	211	0	18953
28411	407	18644	295	140	0	19486
28412	17983	1040	296	126	0	19445
28413	18596	538	338	119	0	19591
28414	1113	375	317	17899	0	19704
28415	18548	319	411	679	0	19957
28416	18937	312	346	302	0	19897
28417	1215	313	318	18264	0	20110
28418	18491	320	333	816	0	19960
28419	1088	18102	416	331	0	19937
28420	646	858	448	17973	0	19925
28421	581	459	17796	734	0	19570
28422	476	17709	1055	330	0	19570
28423	537	903	18037	267	0	19744
28424	586	483	1022	16599	0	18690
28425	489	18070	679	687	0	19925
28426	536	884	584	17796	0	19800
28427	484	524	528	18334	0	19870
28428	561	387	17905	992	0	19845
28429	490	364	19340	450	0	20644
28430	437	362	1185	18857	0	20841
28431	513	354	737	17933	0	19537
28432	433	19104	624	913	0	21074
28433	18372	967	519	435	0	20293
28434	1024	18643	531	334	0	20532
28435	596	19320	418	294	0	20628
28436	463	1162	18206	263	0	20094
28437	343	18332	1007	329	0	20011
28438	399	1062	699	16428	0	18588
28439	371	18079	543	772	0	19765
28440	360	977	434	16987	0	18758
28441	306	17649	479	826	0	19260
28442	17225	1025	379	437	0	19066
28443	953	17536	416	322	0	19227
28444	482	946	298	15112	0	16838
28445	421	16410	283	645	0	17759
28446	16187	939	319	294	0	17739
28447	16228	554	150	291	0	17223
28448	1020	16008	223	208	0	17459
28449	15636	895	144	194	0	16869
28450	934	569	206	14832	0	16541
28451	495	408	14800	700	0	16403
28452	401	381	14948	340	0	16070
28453	355	14977	799	277	0	16408
28454	10964	455	258	128	0	11805
28455	10932	192	132	111	0	11367
28456	489	146	10650	101	0	11386
28457	206	133	10593	108	0	11040
28458	10226	144	399	112	0	10881
28459	10790	107	159	112	0	11168
28460	444	141	10380	97	0	11062
28461	9616	118	355	109	0	10198
28462	379	9828	147	99	0	10453
28463	157	10351	110	90	0	10708
28464	103	446	127	9873	0	10549
28465	116	193	80	10154	0	10543
28466	10087	135	99	389	0	10710
28467	10172	131	96	156	0	10555
28468	10211	96	104	142	0	10553
28469	420	124	91	9970	0	10605
28470	199	113	70	10079	0	10461
28471	142	9414	79	397	0	10032
28472	150	9677	71	164	0	10062
28473	108	10185	75	115	0	10483
28474	134	442	76	9442	0	10094
28475	126	9860	67	312	0	10365
28476	124	403	9499	140	0	10166
28477	9012	194	308	137	0	9651
28478	389	153	9570	127	0	10239
28479	182	144	9628	101	0	10055
28480	9233	146	366	98	0	9843
28481	384	9662	134	101	0	10281
28482	9779	387	91	106	0	10363
28483	9886	200	71	109	0	10266
28484	439	166	9357	93	0	10055
28485	198	139	9792	90	0	10219
28486	171	9868	367	82	0	10488
28487	172	404	9956	91	0	10623
28488	155	182	366	9874	0	10577
28489	197	131	162	8388	0	8878
28490	143	9858	141	366	0	10508
28491	160	10441	132	135	0	10868
28492	10297	448	103	105	0	10953
28493	10878	223	100	121	0	11322
28494	473	170	102	10667	0	11412
28495	222	137	125	10991	0	11475
28496	10613	145	120	398	0	11276
28497	10770	132	119	169	0	11190
28498	455	10841	109	127	0	11532
28499	10144	342	101	111	0	10698
28500	411	9636	83	79	0	10209
28501	184	10172	81	92	0	10529
28502	10084	398	89	104	0	10675
28503	10157	173	71	102	0	10503
28504	422	139	71	9994	0	10626
28505	10052	113	61	299	0	10525
28506	434	110	9823	97	0	10464
28507	215	10018	262	94	0	10589
28508	9910	292	97	134	0	10433
28509	344	116	10015	127	0	10602
28510	147	136	244	9063	0	9590
28511	130	9297	86	210	0	9723
28512	141	9679	69	73	0	9962
28513	9601	258	65	68	0	9992
28514	304	120	9305	61	0	9790
28515	8919	64	207	48	0	9238
28516	302	54	93	9093	0	9542
28517	137	61	9109	177	0	9484
28518	8770	63	199	96	0	9128
28519	247	9412	89	55	0	9803
28520	107	9879	75	45	0	10106
28521	9999	245	93	53	0	10390
28522	10085	113	46	55	0	10299
28523	10338	75	28	82	0	10523
28524	287	72	40	10035	0	10434
28525	151	51	59	10191	0	10452
28526	135	33	9993	204	0	10365
28527	113	39	9633	101	0	9886
28528	94	9942	185	86	0	10307
28529	70	166	60	9058	0	9354
28530	8975	51	33	114	0	9173
28531	125	8935	19	47	0	9126
28532	56	134	18	9002	0	9210
28533	8941	42	30	130	0	9143
28534	130	8841	25	52	0	9048
28535	61	9406	19	43	0	9529
28536	63	118	9009	31	0	9221
28537	8851	46	121	36	0	9054
28538	9362	34	39	38	0	9473
28539	139	33	9109	25	0	9306
28540	8396	37	87	39	0	8559
28541	125	21	9085	16	0	9247
28542	40	8909	71	19	0	9039
28543	38	82	29	8911	0	9060
28544	8869	21	16	79	0	8985
28545	82	8734	22	20	0	8858
28546	31	8876	15	12	0	8934
28547	8639	74	17	12	0	8742
28548	76	21	9185	12	0	9294
28549	8804	11	58	33	0	8906
28550	65	9318	16	18	0	9417
28551	32	63	8949	6	0	9050
28552	8767	21	60	11	0	8859
28553	9231	13	15	9	0	9268
28554	65	14	9	9080	0	9168
28555	24	8	8	9245	0	9285
28556	15	9059	5	70	0	9149
28557	21	75	9065	10	0	9171
28558	26	14	65	9035	0	9140
28559	27	8	9637	72	0	9744
28560	14	13	9544	16	0	9587
28561	21	13	99	10043	0	10176
28562	16	10	10331	121	0	10478
28563	28	13	10078	29	0	10148
28564	13	8	142	9739	0	9902
28565	16	7	10255	123	0	10401
28566	9277	8	132	48	0	9465
28567	111	9949	43	25	0	10128
28568	45	116	10183	13	0	10357
28569	24	29	10759	15	0	10827
28570	32	16	147	10121	0	10316
28571	11199	15	53	131	0	11398
28572	11247	11	35	41	0	11334
28573	11205	15	21	26	0	11267
28574	11283	13	29	21	0	11346
28575	167	10	16	10985	0	11178
28576	48	15	11261	129	0	11453
28577	11055	12	127	51	0	11245
28578	11429	10	46	27	0	11512
28579	11557	12	25	27	0	11621
28580	165	8	11206	12	0	11391
28581	10555	4	127	25	0	10711
28582	155	5	51	11715	0	11926
28583	64	11812	37	129	0	12042
28584	45	166	26	11592	0	11829
28585	30	11792	31	124	0	11977
28586	11774	148	28	51	0	12001
28587	172	46	11919	30	0	12167
28588	62	16	180	11473	0	11731
28589	39	11656	66	158	0	11919
28590	39	12118	48	53	0	12258
28591	12105	191	40	28	0	12364
28592	12027	62	32	24	0	12145
28593	214	35	11385	24	0	11658
28594	11441	20	190	16	0	11667
28595	210	15	53	11585	0	11863
28596	79	12	11958	187	0	12236
28597	59	21	11767	47	0	11894
28598	55	14	222	12046	0	12337
28599	12954	15	71	217	0	13257
28600	235	8	48	12871	0	13162
28601	96	16	33	12924	0	13069
28602	60	16	41	12880	0	12997
28603	58	12844	34	270	0	13206
28604	58	196	32	13057	0	13343
28605	12678	64	51	268	0	13061
28606	227	12746	46	99	0	13118
28607	95	225	20	12932	0	13272
28608	12805	81	31	262	0	13179
28609	251	12505	31	100	0	12887
28610	83	12883	37	67	0	13070
28611	61	299	33	12775	0	13168
28612	12543	106	23	281	0	12953
28613	267	55	12517	111	0	12950
28614	120	32	12268	65	0	12485
28615	12301	40	324	48	0	12713
28616	13100	32	119	61	0	13312
28617	367	13158	73	52	0	13650
28618	135	287	47	12810	0	13279
28619	91	99	12832	291	0	13313
28620	85	52	12429	104	0	12670
28621	68	35	13487	76	0	13666
28622	69	13086	424	47	0	13626
28623	62	13497	150	63	0	13772
28624	13358	360	75	82	0	13875
28625	347	117	13445	69	0	13978
28626	13058	71	342	66	0	13537
28627	13643	55	110	67	0	13875
28628	443	49	13593	56	0	14141
28629	171	13927	347	50	0	14495
28630	137	344	120	13512	0	14113
28631	95	123	14322	345	0	14885
28632	76	89	13673	125	0	13963
28633	13226	67	420	103	0	13816
28634	380	14098	153	68	0	14699
28635	151	378	93	13615	0	14237
28636	108	143	69	13686	0	14006
28637	80	13514	83	433	0	14110
28638	83	13902	74	155	0	14214
28639	73	14196	80	102	0	14451
28640	79	469	59	14448	0	15055
28641	14802	185	51	426	0	15464
28642	453	103	64	15066	0	15686
28643	158	90	14938	481	0	15667
28644	124	69	14846	182	0	15221
28645	96	76	528	15008	0	15708
28646	85	94	15123	451	0	15753
28647	91	15028	493	210	0	15822
28648	84	445	205	15615	0	16349
28649	16448	170	141	526	0	17285
28650	16599	99	112	220	0	17030
28651	607	16800	101	135	0	17643
28652	16906	579	78	120	0	17683
28653	17431	180	80	155	0	17846
28654	17597	119	89	121	0	17926
28655	761	141	15375	111	0	16388
28656	16339	104	442	112	0	16997
28657	648	16442	176	115	0	17381
28658	244	520	16515	92	0	17371
28659	207	190	16466	95	0	16958
28660	153	16191	586	123	0	17053
28661	15929	534	266	73	0	16802
28662	557	213	135	15276	0	16181
28663	216	15529	117	470	0	16332
28664	15858	510	113	170	0	16651
28665	565	231	96	15911	0	16803
28666	16103	131	87	561	0	16882
28667	636	108	89	16193	0	17026
28668	257	120	15760	594	0	16731
28669	199	119	15483	214	0	16015
28670	156	100	15723	171	0	16150
28671	168	114	697	14902	0	15881
28672	138	114	274	15938	0	16464
28673	162	102	15539	664	0	16467
28674	167	15342	589	263	0	16361
28675	15748	578	263	170	0	16759
28676	15885	201	204	147	0	16437
28677	699	15921	169	154	0	16943
28678	342	621	158	16186	0	17307
28679	234	248	16586	596	0	17664
28680	16215	167	667	255	0	17304
28681	707	133	16640	183	0	17663
28682	345	128	15568	132	0	16173
28683	241	121	16223	131	0	16716
28684	15508	121	808	142	0	16579
28685	695	133	15885	122	0	16835
28686	317	15064	700	127	0	16208
28687	251	15947	360	127	0	16685
28688	235	672	255	15154	0	16316
28689	235	279	198	15644	0	16356
28690	196	183	15417	653	0	16449
28691	14788	154	646	287	0	15875
28692	15849	169	298	182	0	16498
28693	754	140	247	15497	0	16638
28694	15498	125	213	608	0	16444
28695	686	15427	213	281	0	16607
28696	15232	597	193	202	0	16224
28697	712	14654	177	211	0	15754
28698	310	15015	165	184	0	15674
28699	14337	639	170	167	0	15313
28700	14372	270	157	167	0	14966
28701	14904	171	186	151	0	15412
28702	15113	168	176	136	0	15593
28703	796	169	13879	143	0	14987
28704	14067	129	581	155	0	14932
28705	735	138	300	13559	0	14732
28706	365	13957	207	511	0	15040
28707	14066	528	195	225	0	15014
28708	659	14057	189	167	0	15072
28709	14077	583	161	134	0	14955
28710	694	245	146	13828	0	14913
28711	367	186	169	14321	0	15043
28712	327	172	13243	619	0	14361
28713	264	188	13749	292	0	14493
28714	287	13856	629	209	0	14981
28715	13507	510	305	167	0	14489
28716	619	13329	193	171	0	14312
28717	362	13079	178	165	0	13784
28718	305	13752	179	154	0	14390
28719	303	635	13125	116	0	14179
28720	289	13413	509	113	0	14324
28721	12378	574	254	118	0	13324
28722	12595	282	168	120	0	13165
28723	649	224	153	12006	0	13032
28724	348	11829	169	443	0	12789
28725	258	12372	165	202	0	12997
28726	271	576	139	12001	0	12987
28727	283	264	12016	436	0	12999
28728	241	11698	435	212	0	12586
28729	267	567	194	11267	0	12295
28730	10908	281	139	444	0	11772
28731	11116	204	132	231	0	11683
28732	546	11256	146	170	0	12118
28733	11310	484	143	139	0	12076
28734	11511	239	147	168	0	12065
28735	638	201	147	10954	0	11940
28736	335	194	10843	414	0	11786
28737	254	10971	431	224	0	11880
28738	252	509	213	10771	0	11745
28739	234	260	10689	382	0	11565
28740	203	10462	365	197	0	11227
28741	9788	408	202	148	0	10546
28742	10081	232	129	110	0	10552
28743	497	197	87	9626	0	10407
28744	285	9822	119	329	0	10555
28745	243	387	9684	152	0	10466
28746	226	248	339	9550	0	10363
28747	182	194	9797	351	0	10524
28748	152	8870	295	156	0	9473
28749	249	308	181	7676	0	8414
28750	7577	138	106	215	0	8036
28751	248	7579	76	124	0	8027
28752	7482	256	67	89	0	7894
28753	7421	151	63	82	0	7717
28754	321	7464	50	87	0	7922
28755	200	244	64	7405	0	7913
28756	147	164	55	7418	0	7784
28757	130	7131	64	260	0	7585
28758	106	7441	63	147	0	7757
28759	123	272	49	6911	0	7355
28760	111	7239	56	179	0	7585
28761	7206	238	53	101	0	7598
28762	7208	141	48	74	0	7471
28763	279	109	6996	74	0	7458
28764	149	84	6771	64	0	7068
28765	6617	77	194	64	0	6952
28766	6949	93	95	53	0	7190
28767	223	7103	70	64	0	7460
28768	7101	200	72	61	0	7434
28769	7062	128	43	56	0	7289
28770	241	6973	24	54	0	7292
28771	7015	181	35	65	0	7296
28772	227	126	36	7930	0	8319
28773	133	105	36	8263	0	8537
28774	99	90	8463	306	0	8958
28775	85	7974	235	127	0	8421
28776	68	8593	77	74	0	8812
28777	7727	413	149	147	0	8436
28778	7778	92	39	67	0	7976
28779	7451	61	18	67	0	7597
28780	7964	40	28	48	0	8080
28781	286	43	7242	32	0	7603
28782	87	58	7706	29	0	7880
28783	71	7827	237	31	0	8166
28784	70	246	75	7711	0	8102
28785	70	78	42	7653	0	7843
28786	89	7906	27	213	0	8235
28787	94	232	25	7772	0	8123
28788	7739	79	34	229	0	8081
28789	255	7782	42	61	0	8140
28790	124	231	7859	61	0	8275
28791	86	8027	202	68	0	8383
28792	8014	247	79	64	0	8404
28793	245	103	7958	55	0	8361
28794	7726	72	226	58	0	8082
28795	8065	58	85	48	0	8256
28796	274	74	7828	47	0	8223
28797	111	65	7768	48	0	7992
28798	102	49	7670	35	0	7856
28799	7250	51	270	36	0	7607
28800	264	49	7759	20	0	8092
28801	111	7575	231	27	0	7944
28802	7624	211	86	23	0	7944
28803	244	79	7609	21	0	7953
28804	7253	50	255	20	0	7578
28805	264	38	7511	24	0	7837
28806	133	26	7791	34	0	7984
28807	82	7827	287	12	0	8208
28808	69	219	7919	14	0	8221
28809	90	80	7884	15	0	8069
28810	78	6960	314	32	0	7384
28811	7640	219	139	17	0	8015
28812	245	78	7841	13	0	8177
28813	123	65	267	7144	0	7599
28814	76	7817	124	165	0	8182
28815	7909	230	107	64	0	8310
28816	7915	79	105	50	0	8149
28817	277	72	7882	31	0	8262
28818	129	7491	272	23	0	7915
28819	85	7932	151	32	0	8200
28820	86	304	97	7545	0	8032
28821	79	7362	88	198	0	7727
28822	121	302	74	6941	0	7438
28823	113	118	76	7895	0	8202
28824	107	7862	91	273	0	8333
28825	106	273	84	7715	0	8178
28826	73	7832	82	243	0	8230
28827	81	296	7723	109	0	8209
28828	83	154	265	7638	0	8140
28829	72	108	135	7787	0	8102
28830	70	7664	92	287	0	8113
28831	73	8046	74	135	0	8328
28832	86	346	57	7562	0	8051
28833	90	7827	74	260	0	8251
28834	7731	329	81	122	0	8263
28835	291	144	85	7715	0	8235
28836	138	7802	78	270	0	8288
28837	7687	312	85	107	0	8191
28838	286	7684	99	100	0	8169
28839	129	315	7550	97	0	8091
28840	92	165	294	7495	0	8046
28841	7660	114	159	283	0	8216
28842	287	123	7667	131	0	8208
28843	139	114	292	7312	0	7857
28844	115	7524	132	248	0	8019
28845	123	321	7388	98	0	7930
28846	108	7651	302	106	0	8167
28847	7252	318	140	82	0	7792
28848	7556	154	142	60	0	7912
28849	334	7479	142	63	0	8018
28850	7475	315	123	60	0	7973
28851	307	148	7344	64	0	7863
28852	132	129	331	7111	0	7703
28853	122	107	175	7038	0	7442
28854	128	7292	122	281	0	7823
28855	7848	308	122	136	0	8414
28856	8207	167	123	96	0	8593
28857	334	147	8098	54	0	8633
28858	8077	113	291	50	0	8531
28859	8384	99	167	60	0	8710
28860	8447	94	128	71	0	8740
28861	380	117	98	8070	0	8665
28862	211	108	104	8071	0	8494
28863	133	8110	110	271	0	8624
28864	7935	299	115	122	0	8471
28865	8048	134	112	107	0	8401
28866	346	7982	74	89	0	8491
28867	165	312	73	7672	0	8222
28868	118	7635	89	262	0	8104
28869	116	8205	56	116	0	8493
28870	7930	307	78	94	0	8409
28871	317	123	7680	111	0	8231
28872	121	89	6501	47	0	6758
28873	81	6556	158	57	0	6852
28874	5985	127	65	41	0	6218
28875	118	62	5982	32	0	6194
28876	58	5477	107	29	0	5671
28877	5448	92	27	18	0	5585
28878	90	29	5382	17	0	5518
28879	29	22	85	5243	0	5379
28880	5628	28	24	89	0	5769
28881	108	18	5718	35	0	5879
28882	39	17	5964	21	0	6041
28883	18	18	6225	20	0	6281
28884	26	16	6201	9	0	6252
28885	5889	17	118	23	0	6047
28886	6552	13	42	13	0	6620
28887	119	6530	13	13	0	6675
28888	35	112	16	6690	0	6853
28889	20	31	8	6990	0	7049
28890	17	6728	8	145	0	6898
28891	19	140	5	6887	0	7051
28892	10	6990	11	143	0	7154
28893	12	7209	8	53	0	7282
28894	9	184	14	7117	0	7324
28895	13	68	7124	147	0	7352
28896	17	7186	137	50	0	7390
28897	15	157	46	7265	0	7483
28898	7312	52	27	158	0	7549
28899	157	28	7185	57	0	7427
28900	6998	31	158	23	0	7210
28901	7356	22	54	32	0	7464
28902	221	19	29	7471	0	7740
28903	85	24	7676	187	0	7972
28904	42	16	7633	70	0	7761
28905	35	8064	259	37	0	8395
28906	29	224	84	7864	0	8201
28907	28	71	7972	218	0	8289
28908	27	37	7933	68	0	8065
28909	20	8139	268	38	0	8465
28910	8160	219	103	32	0	8514
28911	8413	72	52	35	0	8572
28912	276	42	52	8490	0	8860
28913	109	33	8884	232	0	9258
28914	60	36	8805	104	0	9005
28915	48	9173	310	79	0	9610
28916	48	238	9375	44	0	9705
28917	31	101	9337	45	0	9514
28918	27	83	353	8479	0	8942
28919	19	46	9392	235	0	9692
28920	8820	40	298	109	0	9267
28921	240	28	151	9339	0	9758
28922	106	33	9693	257	0	10089
28923	57	9760	283	122	0	10222
28924	46	233	144	9853	0	10276
28925	48	110	9975	257	0	10390
28926	38	10125	289	127	0	10579
28927	38	261	159	9880	0	10338
28928	31	10296	93	245	0	10665
28929	27	277	98	10388	0	10790
28930	41	130	98	10314	0	10583
28931	45	88	10277	359	0	10769
28932	43	10339	293	180	0	10855
28933	39	282	153	10457	0	10931
28934	23	121	108	10583	0	10835
28935	37	74	103	10744	0	10958
28936	32	74	10371	384	0	10861
28937	25	10202	305	196	0	10728
28938	34	281	162	10411	0	10888
28939	36	132	10355	325	0	10848
28940	27	10292	326	184	0	10829
28941	36	290	167	10405	0	10898
28942	34	152	10594	331	0	11111
28943	23	10524	303	197	0	11047
28944	27	298	181	10433	0	10939
28945	28	145	124	10839	0	11136
28946	28	95	10963	403	0	11489
28947	9918	91	312	238	0	10559
28948	234	10872	177	164	0	11447
28949	10968	295	123	154	0	11540
28950	276	170	11017	133	0	11596
28951	11000	107	338	125	0	11570
28952	295	90	186	11234	0	11805
28953	122	108	111	11646	0	11987
28954	72	84	11355	423	0	11934
28955	10098	84	328	242	0	10752
28956	10494	84	165	180	0	10923
28957	329	10458	142	147	0	11076
28958	150	11002	110	151	0	11413
28959	10907	366	125	129	0	11527
28960	309	192	10912	102	0	11515
28961	149	11575	305	145	0	12174
28962	104	295	181	11943	0	12523
28963	83	168	148	12268	0	12667
28964	87	113	12012	419	0	12631
28965	11265	82	344	261	0	11952
28966	305	105	12188	159	0	12757
28967	11976	95	352	172	0	12595
28968	336	90	12806	119	0	13351
28969	173	12848	382	107	0	13510
28970	13053	336	209	129	0	13727
28971	13256	166	171	116	0	13709
28972	13067	114	123	127	0	13431
28973	13237	97	132	128	0	13594
28974	469	105	131	12923	0	13628
28975	251	87	12872	352	0	13562
28976	187	74	347	12627	0	13235
28977	134	12868	203	342	0	13547
28978	134	326	129	13128	0	13717
28979	108	139	13006	383	0	13636
28980	113	114	12853	184	0	13264
28981	111	106	418	12631	0	13266
28982	12565	83	224	349	0	13221
28983	12229	96	149	192	0	12666
28984	12401	74	141	139	0	12755
28985	442	78	12355	131	0	13006
28986	253	83	12137	127	0	12600
28987	185	12167	377	109	0	12838
28988	143	12550	203	102	0	12998
28989	12024	293	185	121	0	12623
28990	12169	142	121	122	0	12554
28991	326	12542	120	111	0	13099
28992	12456	250	96	94	0	12896
28993	12508	125	79	97	0	12809
28994	334	12487	110	94	0	13025
28995	12792	241	92	111	0	13236
28996	12707	139	91	93	0	13030
28997	335	12849	74	103	0	13361
28998	12987	230	93	89	0	13399
28999	12950	122	87	81	0	13240
29000	357	96	12910	75	0	13438
29001	218	70	12676	74	0	13038
29002	135	12550	249	73	0	13007
29003	121	12838	157	54	0	13170
29004	12771	198	148	74	0	13191
29005	12426	118	86	52	0	12682
29006	12244	79	75	47	0	12445
29007	271	12306	67	35	0	12679
29008	152	163	55	12379	0	12749
29009	128	92	12411	133	0	12764
29010	141	108	152	11911	0	12312
29011	120	12360	95	136	0	12711
29012	12198	140	56	61	0	12455
29013	167	11811	48	39	0	12065
29014	103	131	44	11920	0	12198
29015	12435	57	42	146	0	12680
29016	12357	48	33	50	0	12488
29017	230	55	12179	26	0	12490
29018	12205	44	137	41	0	12427
29019	13137	44	78	24	0	13283
29020	13321	51	51	36	0	13459
29021	254	45	39	12782	0	13120
29022	124	12833	37	163	0	13157
29023	108	170	40	13069	0	13387
29024	102	79	13295	175	0	13651
29025	85	13444	185	90	0	13804
29026	86	205	71	13287	0	13649
29027	95	72	13355	183	0	13705
29028	68	13284	175	73	0	13600
29029	88	178	82	12694	0	13042
29030	85	94	13235	163	0	13577
29031	11426	57	186	139	0	11808
29032	242	44	13381	43	0	13710
29033	145	59	13084	36	0	13324
29034	105	13392	242	39	0	13778
29035	94	202	107	13359	0	13762
29036	89	118	57	13049	0	13313
29037	82	13059	64	226	0	13431
29038	88	213	57	13700	0	14058
29039	13808	98	45	216	0	14167
29040	13837	67	45	113	0	14062
29041	313	67	13085	75	0	13540
29042	13513	54	202	71	0	13840
29043	14113	60	95	68	0	14336
29044	295	55	14075	59	0	14484
29045	135	13978	228	58	0	14399
29046	100	14084	109	48	0	14341
29047	115	278	85	12617	0	13095
29048	77	13827	70	173	0	14147
29049	110	272	12556	93	0	13031
29050	122	108	12926	76	0	13232
29051	99	13484	268	52	0	13903
29052	13413	246	126	57	0	13842
29053	13747	120	77	55	0	13999
29054	13857	85	48	52	0	14042
29055	13849	74	64	51	0	14038
29056	12933	117	53	58	0	13161
29057	321	13502	41	58	0	13922
29058	158	241	13309	46	0	13754
29059	127	118	231	13049	0	13525
29060	12904	83	90	227	0	13304
29061	257	12665	61	96	0	13079
29062	176	287	40	12278	0	12781
29063	115	117	12392	202	0	12826
29064	85	11834	248	99	0	12266
29065	86	12470	103	54	0	12713
29066	11873	317	63	93	0	12346
29067	224	11830	37	38	0	12129
29068	117	209	36	11273	0	11635
29069	11344	76	42	190	0	11652
29070	11325	47	28	72	0	11472
29071	11408	46	19	37	0	11510
29072	278	48	11065	28	0	11419
29073	114	11213	180	27	0	11534
29074	11480	195	68	36	0	11779
29075	219	89	38	11292	0	11638
29076	11386	67	35	200	0	11688
29077	209	11314	44	95	0	11662
29078	11895	198	34	51	0	12178
29079	12955	101	28	44	0	13128
29080	328	60	34	12865	0	13287
29081	155	47	13472	249	0	13923
29082	107	50	264	13646	0	14067
29083	13546	52	105	303	0	14006
29084	13775	62	62	104	0	14003
29085	396	13499	44	73	0	14012
29086	13132	271	47	58	0	13508
29087	351	13348	46	63	0	13808
29088	13397	301	28	75	0	13801
29089	13066	122	46	75	0	13309
29090	388	86	13155	58	0	13687
29091	177	13112	257	74	0	13620
29092	125	303	118	13176	0	13722
29093	100	135	73	13467	0	13775
29094	97	96	61	12917	0	13171
29095	88	12980	50	378	0	13496
29096	81	325	12902	146	0	13454
29097	108	135	12996	79	0	13318
29098	88	15929	367	71	0	16455
29099	15958	433	144	80	0	16615
29100	458	177	15877	59	0	16571
29101	15445	101	434	82	0	16062
29102	508	15721	169	67	0	16465
29103	213	456	15859	54	0	16582
29104	128	185	437	15601	0	16351
29105	122	122	16077	434	0	16755
29106	121	89	16348	184	0	16742
29107	161	67	557	14647	0	15432
29108	133	15272	227	405	0	16037
29109	129	16194	126	137	0	16586
29110	16036	527	102	87	0	16752
29111	484	219	15853	77	0	16633
29112	15898	143	438	96	0	16575
29113	16154	105	192	68	0	16519
29114	537	16357	138	36	0	17068
29115	15701	427	74	54	0	16256
29116	15884	182	67	51	0	16184
29117	15284	111	71	62	0	15528
29118	563	14819	69	57	0	15508
29119	247	13623	82	52	0	14004
29120	155	14776	65	42	0	15038
29121	14674	474	120	44	0	15312
29122	14747	200	83	48	0	15078
29123	528	137	13656	43	0	14364
29124	253	91	13721	40	0	14105
29125	14032	73	412	35	0	14552
29126	14445	79	170	40	0	14734
29127	14696	78	93	50	0	14917
29128	504	69	79	14134	0	14786
29129	240	56	62	14480	0	14838
29130	166	71	52	14729	0	15018
29131	121	82	64	14750	0	15017
29132	120	88	13374	453	0	14035
29133	131	56	14020	179	0	14386
29134	134	62	14113	93	0	14402
29135	138	47	13962	64	0	14211
29136	13869	64	445	72	0	14450
29137	386	13981	179	66	0	14612
29138	199	14612	120	61	0	14992
29139	14456	388	78	81	0	15003
29140	400	198	14326	68	0	14992
29141	209	118	13982	63	0	14372
29142	13716	86	465	96	0	14363
29143	14226	66	233	88	0	14613
29144	451	14146	134	76	0	14807
29145	255	324	98	14178	0	14855
29146	14461	148	101	306	0	15016
29147	14795	120	92	110	0	15117
29148	502	106	74	14336	0	15018
29149	245	14993	79	300	0	15617
29150	15117	363	57	142	0	15679
29151	436	174	14801	106	0	15517
29152	14479	116	362	84	0	15041
29153	408	14901	176	86	0	15571
29154	15232	345	142	87	0	15806
29155	14862	158	105	86	0	15211
29156	466	110	15184	85	0	15845
29157	233	104	14878	77	0	15292
29158	15006	88	456	66	0	15616
29159	15500	91	226	66	0	15883
29160	453	15521	140	63	0	16177
29161	259	376	109	15751	0	16495
29162	187	156	15748	308	0	16399
29163	15438	104	386	118	0	16046
29164	433	107	195	15749	0	16484
29165	254	82	153	16055	0	16544
29166	15892	89	136	408	0	16525
29167	411	16355	105	186	0	17057
29168	16644	349	104	128	0	17225
29169	16735	146	115	96	0	17092
29170	16853	117	89	105	0	17164
29171	528	16592	90	72	0	17282
29172	16827	363	101	70	0	17361
29173	495	153	95	16623	0	17366
29174	290	115	85	16688	0	17178
29175	272	115	16526	416	0	17329
29176	241	106	16167	175	0	16689
29177	192	16372	402	137	0	17103
29178	187	16605	174	82	0	17048
29179	189	341	15532	40	0	16102
29180	140	15573	302	46	0	16061
29181	15477	337	143	70	0	16027
29182	15623	118	63	50	0	15854
29183	15831	83	51	61	0	16026
29184	433	69	55	14998	0	15555
29185	196	58	52	15549	0	15855
29186	129	54	15572	350	0	16105
29187	103	15346	283	151	0	15883
29188	15351	278	112	91	0	15832
29189	295	15480	81	52	0	15908
29190	15556	315	47	43	0	15961
29191	15630	116	57	42	0	15845
29192	412	79	57	15039	0	15587
29193	215	49	61	15126	0	15451
29194	146	50	50	15693	0	15939
29195	155	47	15001	387	0	15590
29196	107	14623	263	189	0	15182
29197	84	14770	112	131	0	15097
29198	42	11835	24	34	0	11935
29199	32	11855	20	31	0	11938
29200	43	12013	20	20	0	12096
29201	11153	132	33	35	0	11353
29202	115	51	11416	18	0	11600
29203	52	11468	102	23	0	11645
29204	37	106	11019	18	0	11180
29205	38	11400	94	23	0	11555
29206	114	186	84	8214	0	8598
29207	38	49	30	10867	0	10984
29208	31	11262	20	105	0	11418
29209	11014	112	28	49	0	11203
29210	115	51	10875	23	0	11064
29211	48	11108	94	22	0	11272
29212	43	120	10728	23	0	10914
29213	37	43	104	10612	0	10796
29214	52	31	41	9951	0	10075
29215	34	10568	28	119	0	10749
29216	37	103	19	10726	0	10885
29217	41	34	21	10757	0	10853
29218	31	10695	20	112	0	10858
29219	36	117	10445	38	0	10636
29220	36	54	10255	28	0	10373
29221	9871	32	121	36	0	10060
29222	10771	34	33	27	0	10865
29223	133	31	19	10374	0	10557
29224	48	29	10356	116	0	10549
29225	46	28	97	9915	0	10086
29226	32	10473	55	116	0	10676
29227	18	123	10420	48	0	10609
29228	33	10298	104	29	0	10464
29229	36	135	10153	26	0	10350
29230	32	10310	101	33	0	10476
29231	10283	133	39	29	0	10484
29232	114	55	27	10177	0	10373
29233	56	39	36	10013	0	10144
29234	42	44	10159	126	0	10371
29235	37	39	9592	56	0	9724
29236	36	10061	123	42	0	10262
29237	10084	116	45	58	0	10303
29238	115	56	37	9894	0	10102
29239	47	41	10125	111	0	10324
29240	38	44	9514	49	0	9645
29241	8767	33	125	46	0	8971
29242	9366	36	44	39	0	9485
29243	128	35	9628	27	0	9818
29244	54	54	110	9088	0	9306
29245	32	9485	43	108	0	9668
29246	9565	107	29	56	0	9757
29247	100	9501	33	46	0	9680
29248	9109	89	17	32	0	9247
29249	92	9054	20	23	0	9189
29250	34	9194	24	29	0	9281
29251	27	98	25	9209	0	9359
29252	21	48	14	9238	0	9321
29253	22	9182	25	110	0	9339
29254	20	101	8842	39	0	9002
29255	20	48	8753	19	0	8840
29256	23	42	8794	12	0	8871
29257	8216	36	107	24	0	8383
29258	8792	29	45	26	0	8892
29259	90	9221	24	28	0	9363
29260	30	124	9157	26	0	9337
29261	22	65	109	9076	0	9272
29262	21	34	9763	132	0	9950
29263	11	39	10003	51	0	10104
29264	22	26	189	10971	0	11208
29265	17	30	75	11824	0	11946
29266	18	28	12907	303	0	13256
29267	12455	28	256	165	0	12904
29268	280	13565	132	90	0	14067
29269	144	14421	79	56	0	14700
29270	74	440	64	14015	0	14593
29271	14461	217	46	312	0	15036
29272	343	14784	42	156	0	15325
29273	14773	412	24	95	0	15304
29274	388	15039	33	80	0	15540
29275	15698	458	21	74	0	16251
29276	512	242	15551	59	0	16364
29277	274	154	15865	45	0	16338
29278	173	155	534	15238	0	16100
29279	126	101	15468	389	0	16084
29280	104	14441	511	182	0	15238
29281	114	14747	246	95	0	15202
29282	14790	559	182	82	0	15613
29283	419	285	127	14256	0	15087
29284	199	14945	108	407	0	15659
29285	15130	477	91	182	0	15880
29286	15066	277	80	107	0	15530
29287	15641	183	74	74	0	15972
29288	695	136	55	15087	0	15973
29289	375	99	63	15499	0	16036
29290	249	92	15278	592	0	16211
29291	180	96	15187	301	0	15764
29292	14969	80	591	199	0	15839
29293	529	69	294	14971	0	15863
29294	268	96	15038	504	0	15906
29295	14727	93	494	271	0	15585
29296	531	15507	297	178	0	16513
29297	15791	443	188	154	0	16576
29298	16076	242	133	124	0	16575
29299	16171	148	122	129	0	16570
29300	811	95	15483	110	0	16499
29301	15484	93	480	98	0	16155
29302	711	83	243	14772	0	15809
29303	411	14448	160	461	0	15480
29304	310	15664	150	235	0	16359
29305	15627	548	150	143	0	16468
29306	15846	279	124	103	0	16352
29307	16101	182	101	125	0	16509
29308	819	141	99	15295	0	16354
29309	498	129	75	15664	0	16366
29310	347	149	79	15213	0	15788
29311	329	15429	77	646	0	16481
29312	15496	480	67	340	0	16383
29313	15797	247	70	240	0	16354
29314	16114	183	85	184	0	16566
29315	866	132	15630	184	0	16812
29316	15986	134	461	179	0	16760
29317	802	152	228	14998	0	16180
29318	480	15644	146	471	0	16741
29319	15726	521	111	238	0	16596
29320	15753	261	105	190	0	16309
29321	870	181	15573	149	0	16773
29322	539	127	484	15177	0	16327
29323	363	15810	241	549	0	16963
29324	16400	540	171	296	0	17407
29325	729	303	130	16231	0	17393
29326	485	224	115	16366	0	17190
29327	384	128	119	16822	0	17453
29328	302	150	113	17350	0	17915
29329	280	136	16566	882	0	17864
29330	289	16608	541	475	0	17913
29331	271	581	253	16797	0	17902
29332	270	295	16757	729	0	18051
29333	16533	228	556	443	0	17760
29334	17289	174	301	338	0	18102
29335	835	166	244	17059	0	18304
29336	17231	161	193	688	0	18273
29337	17665	164	151	412	0	18392
29338	941	160	17063	311	0	18475
29339	581	16955	576	277	0	18389
29340	17417	569	298	270	0	18554
29341	810	269	232	17367	0	18678
29342	17803	218	198	694	0	18913
29343	869	183	187	17533	0	18772
29344	525	154	166	18010	0	18855
29345	427	161	17179	864	0	18631
29346	16076	131	583	545	0	17335
29347	782	17336	279	412	0	18809
29348	496	556	17201	339	0	18592
29349	394	17451	580	322	0	18747
29350	17349	661	301	280	0	18591
29351	810	308	251	17226	0	18595
29352	17246	214	199	674	0	18333
29353	813	17178	181	389	0	18561
29354	17660	616	147	326	0	18749
29355	17968	311	157	295	0	18731
29356	18142	215	146	247	0	18750
29357	17878	167	128	243	0	18416
29358	1022	17323	121	262	0	18728
29359	17356	556	165	192	0	18269
29360	952	304	127	16848	0	18231
29361	619	276	99	16747	0	17741
29362	493	15417	110	671	0	16691
29363	448	15351	96	382	0	16277
29364	373	15078	66	230	0	15747
29365	14003	534	114	211	0	14862
29366	519	12678	70	171	0	13438
29367	299	11759	42	103	0	12203
29368	11500	358	176	142	0	12176
29369	11239	154	48	101	0	11542
29370	415	11226	54	84	0	11779
29371	11125	281	34	103	0	11543
29372	374	142	10626	77	0	11219
29373	10353	122	229	77	0	10781
29374	371	114	10421	88	0	10994
29375	157	9377	176	60	0	9770
29376	131	9659	63	62	0	9915
29377	230	258	98	9230	0	9816
29378	9458	82	69	187	0	9796
29379	9600	74	26	97	0	9797
29380	9718	63	21	80	0	9882
29381	9722	40	46	79	0	9887
29382	9525	57	41	65	0	9688
29383	236	76	9166	54	0	9532
29384	126	70	8699	65	0	8960
29385	9084	60	141	70	0	9355
29386	209	9310	67	67	0	9653
29387	9163	141	46	46	0	9396
29388	9376	71	26	61	0	9534
29389	9631	47	27	62	0	9767
29390	9550	46	36	47	0	9679
29391	9552	46	30	59	0	9687
29392	200	48	9299	61	0	9608
29393	9506	55	121	72	0	9754
29394	9658	36	65	61	0	9820
29395	197	77	9094	61	0	9429
29396	8637	66	90	68	0	8861
29397	9256	52	53	61	0	9422
29398	230	50	9526	45	0	9851
29399	157	41	9255	34	0	9487
29400	131	9608	117	50	0	9906
29401	145	131	60	9599	0	9935
29402	124	56	9695	118	0	9993
29403	9598	57	117	51	0	9823
29404	196	65	49	10089	0	10399
29405	126	50	10286	121	0	10583
29406	10101	48	134	53	0	10336
29407	10371	64	43	45	0	10523
29408	10416	43	43	57	0	10559
29409	207	10535	43	59	0	10844
29410	147	147	39	10285	0	10618
29411	129	10462	36	127	0	10754
29412	10586	147	45	48	0	10826
29413	10437	65	62	56	0	10620
29414	184	65	10327	34	0	10610
29415	108	9862	105	21	0	10096
29416	96	9972	35	29	0	10132
29417	99	122	35	9830	0	10086
29418	85	58	26	9913	0	10082
29419	9892	55	17	107	0	10071
29420	181	9831	18	36	0	10066
29421	110	9663	18	20	0	9811
29422	132	119	9515	24	0	9790
29423	74	9745	97	21	0	9937
29424	9540	118	31	41	0	9730
29425	145	47	9351	30	0	9573
29426	8232	31	87	42	0	8392
29427	123	31	8897	14	0	9065
29428	7669	22	74	46	0	7811
29429	92	9056	18	12	0	9178
29430	9365	107	16	16	0	9504
29431	137	29	9687	9	0	9862
29432	9573	25	120	22	0	9740
29433	9683	21	31	21	0	9756
29434	142	14	9943	0	0	10099
29435	9756	18	111	12	0	9897
29436	10210	14	19	6	0	10249
29437	9985	8	23	11	0	10027
29438	156	9746	15	10	0	9927
29439	9947	111	15	14	0	10087
29440	158	35	9786	2	0	9981
29441	54	10371	118	5	0	10548
29442	10413	126	32	9	0	10580
29443	10192	29	33	8	0	10262
29444	10493	18	23	11	0	10545
29445	191	10366	11	11	0	10579
29446	82	127	11	11983	0	12203
29447	54	32	11990	194	0	12270
29448	46	30	217	11915	0	12208
29449	43	19	12402	240	0	12704
29450	11732	19	255	67	0	12073
29451	255	12437	79	38	0	12809
29452	110	245	43	12199	0	12597
29453	66	12530	25	219	0	12840
29454	44	275	25	12506	0	12850
29455	42	92	22	12419	0	12575
29456	41	12778	31	312	0	13162
29457	48	284	29	12900	0	13261
29458	49	106	33	13322	0	13510
29459	38	13320	37	371	0	13766
29460	49	13873	42	154	0	14118
29461	47	385	61	13765	0	14258
29462	54	133	13692	358	0	14237
29463	67	13963	327	146	0	14503
29464	67	371	113	14015	0	14566
29465	74	156	14571	388	0	15189
29466	45	14803	353	174	0	15375
29467	14669	416	109	132	0	15326
29468	370	176	14592	113	0	15251
29469	14419	120	382	108	0	15029
29470	422	122	125	14417	0	15086
29471	157	90	82	14716	0	15045
29472	107	93	54	14852	0	15106
29473	72	128	14396	538	0	15134
29474	78	123	14288	244	0	14733
29475	13711	105	473	184	0	14473
29476	400	87	220	14308	0	15015
29477	165	100	14573	422	0	15260
29478	14239	95	409	244	0	14987
29479	438	88	186	14522	0	15234
29480	202	123	129	14711	0	15165
29481	185	89	111	14581	0	14966
29482	139	14592	120	523	0	15374
29483	150	408	80	14072	0	14710
29484	101	14168	82	515	0	14866
29485	94	14932	77	273	0	15376
29486	14682	489	96	204	0	15471
29487	13354	239	131	192	0	13916
29488	14748	124	112	152	0	15136
29489	538	14404	87	153	0	15182
29490	14296	417	90	180	0	14983
29491	14674	179	102	168	0	15123
29492	543	139	113	14249	0	15044
29493	239	117	91	14530	0	14977
29494	168	101	14049	590	0	14908
29495	137	14257	389	306	0	15089
29496	13913	469	157	223	0	14762
29497	14056	214	104	193	0	14567
29498	479	14100	103	156	0	14838
29499	14040	480	71	168	0	14759
29500	14175	199	64	179	0	14617
29501	596	157	95	13654	0	14502
29502	299	13283	63	458	0	14103
29503	213	14150	74	244	0	14681
29504	13848	505	89	205	0	14647
29505	508	232	60	13684	0	14484
29506	219	170	13518	528	0	14435
29507	13130	134	396	319	0	13979
29508	464	144	13745	243	0	14596
29509	209	13597	429	184	0	14419
29510	13636	449	171	190	0	14446
29511	497	229	13586	193	0	14505
29512	250	227	425	13649	0	14551
29513	224	164	14032	482	0	14902
29514	227	14140	414	273	0	15054
29515	164	468	196	14261	0	15089
29516	168	287	14084	491	0	15030
29517	13297	228	405	295	0	14225
29518	474	14338	196	230	0	15238
29519	257	426	156	13661	0	14500
29520	201	14437	183	460	0	15281
29521	14303	476	160	240	0	15179
29522	14272	257	137	254	0	14920
29523	492	14275	133	243	0	15143
29524	302	454	152	13854	0	14762
29525	199	14352	167	456	0	15174
29526	14222	460	141	288	0	15111
29527	462	263	14155	221	0	15101
29528	243	252	13851	199	0	14545
29529	206	13623	424	207	0	14460
29530	174	13903	269	155	0	14501
29531	189	477	162	13474	0	14302
29532	13376	255	108	437	0	14176
29533	13480	186	126	231	0	14023
29534	13126	170	82	192	0	13570
29535	540	13540	117	166	0	14363
29536	302	366	111	13139	0	13918
29537	231	13597	100	382	0	14310
29538	13611	403	112	224	0	14350
29539	443	204	93	13535	0	14275
29540	264	144	13339	384	0	14131
29541	177	13258	369	195	0	13999
29542	13112	367	198	148	0	13825
29543	387	207	13179	144	0	13917
29544	12639	216	292	172	0	13319
29545	388	12906	119	190	0	13603
29546	157	11651	51	69	0	11928
29547	11363	230	61	65	0	11719
29548	243	11626	27	78	0	11974
29549	11224	239	38	50	0	11551
29550	202	11349	47	67	0	11665
29551	11403	230	50	56	0	11739
29552	11445	91	46	55	0	11637
29553	245	70	11551	50	0	11916
29554	110	84	11276	24	0	11494
29555	101	11482	149	25	0	11757
29556	11315	150	91	37	0	11593
29557	167	64	11046	25	0	11302
29558	10453	42	150	31	0	10676
29559	135	94	62	10465	0	10756
29560	60	42	10716	94	0	10912
29561	52	33	10000	42	0	10127
29562	57	39	10629	22	0	10747
29563	42	10648	93	20	0	10803
29564	116	191	140	10154	0	10601
29565	9949	12	31	41	0	10033
29566	49	6	6	10080	0	10141
29567	10161	5	16	53	0	10235
29568	63	10	11	10168	0	10252
29569	10425	12	4	73	0	10514
29570	10351	13	10	47	0	10421
29571	11707	7	9	22	0	11745
29572	123	12015	7	20	0	12165
29573	35	108	12092	11	0	12246
29574	27	31	119	12111	0	12288
29575	213	141	218	6150	0	6722
29576	12	17	24	12447	0	12500
29577	12	20	10	12086	0	12128
29578	15	11754	12	179	0	11960
29579	18	129	11540	57	0	11744
29580	19	11758	123	42	0	11942
29581	27	169	37	11221	0	11454
29582	17	43	20	12007	0	12087
29583	25	28	9	12044	0	12106
29584	21	21	14	11944	0	12000
29585	22	11574	15	186	0	11797
29586	12	11720	13	69	0	11814
29587	19	165	11437	39	0	11660
29588	21	61	136	11511	0	11729
29589	11	34	42	11661	0	11748
29590	9	30	22	12011	0	12072
29591	12020	29	12	223	0	12284
29592	154	11969	14	75	0	12212
29593	54	151	11871	45	0	12121
29594	11856	55	148	38	0	12097
29595	161	37	40	12142	0	12380
29596	12343	25	23	193	0	12584
29597	178	26	17	12410	0	12631
29598	12559	16	15	209	0	12799
29599	190	31	13	12537	0	12771
29600	12416	26	21	192	0	12655
29601	211	27	12712	62	0	13012
29602	83	25	148	12594	0	12850
29603	48	12993	49	172	0	13262
29604	46	172	32	13346	0	13596
29605	13211	51	12	202	0	13476
29606	184	13126	27	79	0	13416
29607	64	200	31	13818	0	14113
29608	45	13756	23	219	0	14043
29609	41	240	13	14012	0	14306
29610	38	74	18	14144	0	14274
29611	37	52	13794	284	0	14167
29612	48	20	219	13384	0	13671
29613	34	34	13231	274	0	13573
29614	35	13004	241	105	0	13385
29615	13084	236	74	68	0	13462
29616	248	67	13110	48	0	13473
29617	12563	48	237	64	0	12912
29618	13600	31	66	79	0	13776
29619	324	31	46	13586	0	13987
29620	96	42	14050	259	0	14447
29621	13624	24	265	130	0	14043
29622	14841	43	82	94	0	15060
29623	330	27	55	14470	0	14882
29624	122	24	36	14714	0	14896
29625	77	14647	48	341	0	15113
29626	55	289	33	14678	0	15055
29627	50	14761	50	297	0	15158
29628	42	293	14748	128	0	15211
29629	45	91	253	14602	0	14991
29630	14374	56	85	288	0	14803
29631	14629	36	44	131	0	14840
29632	304	14525	25	104	0	14958
29633	110	260	28	14851	0	15249
29634	14847	90	40	298	0	15275
29635	275	14273	23	136	0	14707
29636	14423	260	18	104	0	14805
29637	301	109	26	14879	0	15315
29638	15535	59	25	343	0	15962
29639	368	75	16566	118	0	17127
29640	137	16630	367	114	0	17248
29641	16556	398	111	90	0	17155
29642	366	17226	83	96	0	17771
29643	17487	445	39	95	0	18066
29644	18028	141	29	89	0	18287
29645	562	109	17690	80	0	18441
29646	236	57	430	17353	0	18076
29647	18106	65	133	482	0	18786
29648	498	65	17739	155	0	18457
29649	17709	70	445	129	0	18353
29650	534	77	134	17785	0	18530
29651	213	50	17706	480	0	18449
29652	165	54	434	17402	0	18055
29653	17234	50	158	516	0	17958
29654	508	63	17573	191	0	18335
29655	218	65	448	17557	0	18288
29656	167	71	172	17860	0	18270
29657	17864	38	117	584	0	18603
29658	17830	50	90	252	0	18222
29659	588	17871	99	179	0	18737
29660	261	422	68	17941	0	18692
29661	212	151	101	18064	0	18528
29662	159	98	109	17972	0	18338
29663	17523	61	89	628	0	18301
29664	17722	67	93	306	0	18188
29665	646	63	92	17355	0	18156
29666	299	17058	75	528	0	17960
29667	287	424	80	16818	0	17609
29668	187	17274	92	502	0	18055
29669	16989	462	75	280	0	17806
29670	540	16648	87	253	0	17528
29671	15648	397	84	140	0	16269
29672	542	139	76	15330	0	16087
29673	15282	119	86	454	0	15941
29674	507	75	15055	269	0	15906
29675	257	15379	373	226	0	16235
29676	15385	386	177	185	0	16133
29677	15709	138	125	161	0	16133
29678	556	129	76	15169	0	15930
29679	291	15280	95	463	0	16129
29680	235	376	73	15993	0	16677
29681	222	136	82	16127	0	16567
29682	186	138	83	16082	0	16489
29683	15877	87	72	578	0	16614
29684	16003	120	84	310	0	16517
29685	612	105	48	15640	0	16405
29686	314	15708	42	503	0	16567
29687	16030	381	67	261	0	16739
29688	479	155	15676	267	0	16577
29689	289	161	319	15832	0	16601
29690	256	104	15854	519	0	16733
29691	241	107	358	15773	0	16479
29692	215	116	15836	537	0	16704
29693	228	128	376	15743	0	16475
29694	15819	133	139	537	0	16628
29695	15885	101	97	313	0	16396
29696	557	15416	78	235	0	16286
29697	15838	374	90	196	0	16498
29698	536	193	101	15433	0	16263
29699	308	136	78	15852	0	16374
29700	15721	130	110	566	0	16527
29701	555	113	14937	298	0	15903
29702	322	124	14692	229	0	15367
29703	281	128	14580	232	0	15221
29704	14203	106	425	255	0	14989
29705	545	90	14801	235	0	15671
29706	291	103	14071	232	0	14697
29707	13503	100	431	222	0	14256
29708	438	13980	190	224	0	14832
29709	282	305	134	14250	0	14971
29710	227	155	135	14554	0	15071
29711	219	109	14392	473	0	15193
29712	14043	76	371	314	0	14804
29713	14420	78	191	258	0	14947
29714	13741	86	157	224	0	14208
29715	482	89	14293	200	0	15064
29716	13648	57	391	225	0	14321
29717	455	82	13727	230	0	14494
29718	276	13490	362	199	0	14327
29719	248	13848	173	209	0	14478
29720	13145	322	156	172	0	13795
29721	408	12841	123	202	0	13574
29722	240	12930	109	164	0	13443
29723	12804	302	99	177	0	13382
29724	364	12855	125	186	0	13530
29725	12717	307	141	161	0	13326
29726	434	138	114	12883	0	13569
29727	271	112	111	13055	0	13549
29728	223	126	112	13133	0	13594
29729	179	111	144	12856	0	13290
29730	202	12814	136	409	0	13561
29731	13054	327	138	205	0	13724
29732	408	14050	110	168	0	14736
29733	232	14795	145	176	0	15348
29734	257	492	15278	140	0	16167
29735	14700	194	491	167	0	15552
29736	586	147	16182	138	0	17053
29737	307	93	16778	142	0	17320
29738	163	16219	578	137	0	17097
29739	97	16814	165	88	0	17164
29740	16951	590	143	74	0	17758
29741	503	17908	93	89	0	18593
29742	208	569	17447	49	0	18273
29743	131	17260	513	62	0	17966
29744	74	579	17370	29	0	18052
29745	89	256	17245	20	0	17610
29746	16295	190	706	36	0	17227
29747	535	107	17050	22	0	17714
29748	228	91	662	16418	0	17399
29749	16215	82	320	483	0	17100
29750	497	16224	226	205	0	17152
29751	234	493	16490	107	0	17324
29752	16166	211	583	67	0	17027
29753	565	127	285	15421	0	16398
29754	273	15165	173	465	0	16076
29755	168	489	15828	191	0	16676
29756	15554	219	578	119	0	16470
29757	570	138	16043	71	0	16822
29758	272	75	639	15745	0	16731
29759	184	74	15675	526	0	16459
29760	125	66	662	15570	0	16423
29761	15147	57	315	613	0	16132
29762	511	15569	217	299	0	16596
29763	15957	504	125	186	0	16772
29764	625	228	15716	115	0	16684
29765	287	137	594	15950	0	16968
29766	200	78	16280	570	0	17128
29767	15789	88	643	268	0	16788
29768	16372	88	301	152	0	16913
29769	761	16233	214	89	0	17297
29770	16563	550	162	85	0	17360
29771	16941	242	136	76	0	17395
29772	857	145	120	16214	0	17336
29773	427	101	16098	552	0	17178
29774	274	15484	588	268	0	16614
29775	212	571	253	15726	0	16762
29776	15953	258	164	574	0	16949
29777	681	163	15638	267	0	16749
29778	335	121	15796	168	0	16420
29779	203	118	15603	124	0	16048
29780	15046	112	863	125	0	16146
29781	673	103	15437	86	0	16299
29782	15071	96	784	73	0	16024
29783	726	98	14092	51	0	14967
29784	368	14748	736	50	0	15902
29785	277	539	388	14592	0	15796
29786	188	238	14869	554	0	15849
29787	158	14080	707	250	0	15195
29788	141	14828	380	154	0	15503
29789	157	764	252	14530	0	15703
29790	14450	368	204	579	0	15601
29791	600	233	220	14599	0	15652
29792	14315	183	190	678	0	15366
29793	701	196	161	14314	0	15372
29794	353	159	14085	696	0	15293
29795	286	121	14363	336	0	15106
29796	13846	108	843	252	0	15049
29797	14357	110	461	200	0	15128
29798	831	111	13900	194	0	15036
29799	13742	103	722	174	0	14741
29800	802	112	13834	127	0	14875
29801	456	12897	785	93	0	14231
29802	363	13215	422	110	0	14110
29803	288	13469	334	113	0	14204
29804	262	812	266	13008	0	14348
29805	12987	402	272	596	0	14257
29806	13446	283	228	285	0	14242
29807	880	225	207	12985	0	14297
29808	471	223	12473	614	0	13781
29809	325	196	695	12607	0	13823
29810	299	145	12595	717	0	13756
29811	274	131	766	12474	0	13645
29812	12221	111	424	768	0	13524
29813	12743	97	349	394	0	13583
29814	12807	107	277	307	0	13498
29815	12928	116	262	229	0	13535
29816	979	121	228	12078	0	13406
29817	562	91	236	12604	0	13493
29818	12302	85	211	839	0	13437
29819	12763	90	183	425	0	13461
29820	1018	113	172	12158	0	13461
29821	587	83	159	12557	0	13386
29822	416	73	150	12546	0	13185
29823	330	86	158	12710	0	13284
29824	12043	96	166	1000	0	13305
29825	751	94	11719	565	0	13129
29826	436	78	590	11706	0	12810
29827	11616	83	325	755	0	12779
29828	748	84	11244	467	0	12543
29829	481	77	619	11409	0	12586
29830	367	73	11351	723	0	12514
29831	288	10629	729	432	0	12078
29832	336	444	381	9491	0	10652
29833	8778	208	288	510	0	9784
29834	496	229	227	7827	0	8779
29835	309	7426	209	541	0	8485
29836	264	6933	153	291	0	7641
29837	192	5514	116	185	0	6007
29838	150	5317	124	144	0	5735
29839	2736	415	371	270	0	3792
29840	163	119	103	1855	0	2240
29841	38	19	1526	97	0	1680
29842	35	10	66	1486	0	1597
29843	43	9	1449	74	0	1575
29844	1451	10	62	43	0	1566
29845	87	9	36	1433	0	1565
29846	54	8	21	1475	0	1558
29847	36	8	17	1474	0	1535
29848	31	15	12	1493	0	1551
29849	1427	12	13	93	0	1545
29850	1479	13	17	42	0	1551
29851	92	11	12	1428	0	1543
29852	1397	11	12	92	0	1512
29853	65	5	1357	61	0	1488
29854	27	1330	58	55	0	1470
29855	39	54	21	1354	0	1468
29856	34	15	27	1337	0	1413
29857	30	1304	13	96	0	1443
29858	29	46	15	1328	0	1418
29859	26	50	26	1328	0	1430
29860	1308	6	16	98	0	1428
29861	72	7	1251	34	0	1364
29862	29	13	1167	23	0	1232
29863	1099	10	53	29	0	1191
29864	75	10	1062	18	0	1165
29865	518	3	67	11	0	599
29866	422	3	14	9	0	448
29867	34	10	11	326	0	381
29868	8	4	232	10	0	254
29869	187	1	10	9	0	207
29870	14	181	5	6	0	206
29871	107	13	26	3	0	149
29872	106	2	10	1	0	119
29873	124	0	3	1	0	128
29874	230	0	0	0	0	230
29875	232	0	0	0	0	232
29876	232	0	0	0	0	232
29877	231	0	0	0	0	231
29878	233	0	0	0	0	233
29879	233	0	0	0	0	233
29880	230	0	1	0	0	231
29881	222	0	2	0	0	224
29882	227	0	0	0	0	227
29883	228	0	0	0	0	228
29884	227	0	0	0	0	227
29885	226	0	0	0	0	226
29886	228	0	0	0	0	228
29887	228	0	0	0	0	228
29888	228	0	0	0	0	228
29889	219	0	0	0	0	219
29890	227	0	0	0	0	227
29891	213	0	0	0	0	213
29892	222	0	0	0	0	222
29893	223	0	0	0	0	223
29894	225	0	0	0	0	225
29895	221	0	0	0	0	221
29896	222	0	0	0	0	222
29897	216	0	0	0	0	216
29898	231	0	0	0	0	231
29899	230	0	0	0	0	230
29900	224	0	0	0	0	224
29901	208	0	0	0	0	208
29902	169	0	0	0	0	169
29903	140	0	9	0	0	149
