Pos	A	C	G	T	Other	Total
1	15	0	0	0	0	15
2	0	0	0	58	0	58
3	0	0	0	147	0	147
4	177	0	0	9	0	186
5	358	0	0	0	0	358
6	365	0	0	0	0	365
7	3	0	365	0	0	368
8	1	0	364	0	0	365
9	1	0	3	377	0	381
10	0	0	2	392	0	394
11	3	0	1	401	0	405
12	750	0	0	12	0	762
13	5	12	0	1675	0	1692
14	2791	0	0	70	0	2861
15	5	4374	1	2	0	4382
16	5	8309	7	20	0	8341
17	96	14	5	21752	0	21867
18	95	10	10	23565	0	23680
19	18	32104	16	44	0	32182
20	9	35115	9	27	0	35160
21	9	39892	21	51	0	39973
22	42088	11	34	379	0	42512
23	31	41	42631	8	0	42711
24	44	58	41928	13	0	42043
25	93	6	21	46401	0	46521
26	49405	1	3	334	0	49743
27	50035	2	6	266	0	50309
28	17	50175	21	70	0	50283
29	58997	12	5	491	0	59505
30	63597	40	14	529	0	64180
31	65483	7	12	381	0	65883
32	33	66252	28	46	0	66359
33	15	68276	38	45	0	68374
34	71149	19	16	347	0	71531
35	71749	8	6	369	0	72132
36	34	73255	40	63	0	73392
37	19	78002	34	75	0	78130
38	78431	17	6	359	0	78813
39	78499	17	5	287	0	78808
40	35	79360	44	80	0	79519
41	82	84	3	82620	0	82789
42	117	19	1	83204	0	83341
43	109	18	6	82853	0	82986
44	16	83050	17	94	0	83177
45	47	99	81580	19	0	81745
46	76251	49	67	239	0	76606
47	79	8	11	84998	0	85096
48	15	84831	46	66	0	84958
49	46	47	4	86573	0	86670
50	14	86589	35	111	0	86749
51	71	58	8	87572	0	87709
52	77	33	1	88445	0	88556
53	33	75	89336	88	0	89532
54	142	18	75	87397	0	87632
55	88918	6	20	403	0	89347
56	112	75	88201	13	0	88401
57	85418	7	118	336	0	85879
58	175	10	21	90895	0	91101
59	21	91333	52	112	0	91518
60	89	100	6	92603	0	92798
61	41	93	92744	118	0	92996
62	193	32	110	89797	0	90132
63	112	14	23	92907	0	93056
64	13	94795	59	170	0	95037
65	98	128	2	95977	0	96205
66	46	94846	31	159	0	95082
67	65	123	8	96298	0	96494
68	95565	25	8	615	0	96213
69	93048	43	33	461	0	93585
70	94167	15	17	543	0	94742
71	338	96678	55	299	0	97370
72	140	219	95404	27	0	95790
73	92046	48	178	466	0	92738
74	99315	24	43	472	0	99854
75	312	103636	76	110	0	104134
76	318	383	6	96322	0	97029
77	325	154	15	100091	0	100585
78	354	99	21	98123	0	98597
79	99358	56	29	1604	0	101047
80	99967	46	26	973	0	101012
81	99906	33	27	882	0	100848
82	101949	17	22	640	0	102628
83	1323	25	34	101146	0	102528
84	449	101433	76	806	0	102764
85	492	746	10	104595	0	105843
86	258	354	105144	952	0	106708
87	655	127	852	107292	0	108926
88	205	154	111655	1363	0	113377
89	588	74	1307	110213	0	112182
90	141	153	115287	1528	0	117109
91	212	204	114037	573	0	115026
92	80	119964	1879	479	0	122402
93	598	1512	640	124388	0	127138
94	207	509	130720	1608	0	133044
95	696	249	1740	126228	0	128913
96	134	131079	674	1691	0	133578
97	130115	1613	359	1548	0	133635
98	1552	137341	342	462	0	139697
99	958	1868	242	134055	0	137123
100	272	139284	321	1510	0	141387
101	241	2019	135399	653	0	138312
102	264	752	133781	571	0	135368
103	151	136699	2342	468	0	139660
104	643	1815	868	138124	0	141450
105	319	942	139656	1681	0	142598
106	198	138865	1978	1017	0	142058
107	137766	1947	790	1285	0	141788
108	2130	763	527	139282	0	142702
109	677	706	144193	1858	0	147434
110	431	144734	1974	771	0	147910
111	712	2027	730	145200	0	148669
112	724	861	470	145733	0	147788
113	141740	600	394	3451	0	146185
114	1826	503	144134	945	0	147408
115	1144	446	1951	141830	0	145371
116	506	490	141851	2014	0	144861
117	232	132574	2159	1063	0	136028
118	126871	1947	948	1393	0	131159
119	1660	126947	670	596	0	129873
120	1113	2153	440	121521	0	125227
121	467	123140	518	1890	0	126015
122	119034	2142	486	1440	0	123102
123	1806	121675	529	726	0	124736
124	772	2324	118957	607	0	122660
125	473	119956	2034	628	0	123091
126	116026	2330	791	1034	0	120181
127	2107	977	120618	549	0	124251
128	1123	750	2189	119875	0	123937
129	116387	528	974	2625	0	120514
130	2478	662	648	113604	0	117392
131	114832	563	544	2888	0	118827
132	116425	630	450	1382	0	118887
133	3165	541	461	114673	0	118840
134	1497	643	364	115787	0	118291
135	113212	523	373	3375	0	117483
136	112775	560	433	1625	0	115393
137	3237	529	381	111114	0	115261
138	111414	541	416	2911	0	115282
139	111887	495	440	1566	0	114388
140	3097	111665	505	974	0	116241
141	1729	2236	454	112715	0	117134
142	113598	893	432	3246	0	118169
143	116244	581	429	1676	0	118930
144	3476	507	403	114809	0	119195
145	1818	479	357	117012	0	119666
146	114796	380	409	3663	0	119248
147	2679	116191	424	1700	0	120994
148	1675	2266	368	116156	0	120465
149	1121	1029	116776	2769	0	121695
150	1297	671	2192	113080	0	117240
151	957	115890	951	2779	0	120577
152	965	2330	116051	1375	0	120721
153	1166	1051	2277	113596	0	118090
154	1460	752	994	110568	0	113774
155	894	649	116112	3237	0	120892
156	108225	575	2439	2142	0	113381
157	2613	118812	1061	1400	0	123886
158	118380	2398	747	1690	0	123215
159	2896	1132	117708	1106	0	122842
160	1446	937	119783	869	0	123035
161	112821	672	2882	1443	0	117818
162	2596	121098	1313	1081	0	126088
163	119055	2355	827	1496	0	123733
164	2714	121413	761	871	0	125759
165	1462	2660	120943	842	0	125907
166	116683	1202	2426	1449	0	121760
167	2885	831	123627	885	0	128228
168	1789	674	2594	121276	0	126333
169	122101	619	1187	3094	0	127001
170	121603	585	785	1787	0	124760
171	3199	120920	747	987	0	125853
172	1825	3756	700	116795	0	123076
173	1146	119449	695	2409	0	123699
174	1070	2361	117759	1089	0	122279
175	1557	1764	2137	108264	0	113722
176	933	109597	887	2018	0	113435
177	1064	1940	574	107986	0	111564
178	101346	793	597	2356	0	105092
179	2030	531	431	104952	0	107944
180	982	105343	507	1865	0	108697
181	989	1547	395	106247	0	109178
182	929	698	425	105733	0	107785
183	793	104927	428	2075	0	108223
184	946	1701	452	105387	0	108486
185	815	771	103385	1821	0	106792
186	619	101981	1488	1073	0	105161
187	93731	1140	520	1129	0	96520
188	1366	564	96108	543	0	98581
189	791	478	93524	408	0	95201
190	524	92351	1173	506	0	94554
191	1200	1381	851	87714	0	91146
192	494	387	86401	846	0	88128
193	508	73722	968	508	0	75706
194	563	662	308	77251	0	78784
195	470	310	190	79083	0	80053
196	76587	223	193	1278	0	78281
197	731	77307	218	465	0	78721
198	431	757	71945	334	0	73467
199	362	413	72340	335	0	73450
200	456	294	725	71333	0	72808
201	553	244	318	83264	0	84379
202	420	244	233	85083	0	85980
203	267	101053	260	2047	0	103627
204	285	2516	103792	944	0	107537
205	755	1173	2438	106111	0	110477
206	260	112460	1231	2860	0	116811
207	210	119473	604	1360	0	121647
208	262	4434	122727	752	0	128175
209	861	1786	3782	118347	0	124776
210	236	988	132533	3974	0	137731
211	967	563	4764	129063	0	135357
212	920	439	2181	135202	0	138742
213	326	488	133433	6130	0	140377
214	215	131954	4735	2931	0	139835
215	128348	4290	2224	2011	0	136873
216	4208	2125	132988	972	0	140293
217	1844	131927	4766	886	0	139423
218	880	137997	2474	694	0	142045
219	575	6413	131826	658	0	139472
220	126918	2937	4974	989	0	135818
221	5111	1754	2491	118641	0	127997
222	1991	132253	1599	3691	0	139534
223	131179	4917	1037	2454	0	139587
224	5311	2518	1039	124571	0	133439
225	2275	130271	898	4620	0	138064
226	130537	4931	853	3038	0	139359
227	4758	2598	127590	1374	0	136320
228	2259	128599	4743	1039	0	136640
229	123704	5049	2517	1503	0	132773
230	4492	126688	1618	951	0	133749
231	123176	5728	1077	1171	0	131152
232	5540	3266	971	117338	0	127115
233	2455	120476	1351	4194	0	128476
234	2174	4987	960	121458	0	129579
235	119269	2596	1170	6008	0	129043
236	4637	1878	118028	3007	0	127550
237	2617	1453	121202	1925	0	127197
238	2292	1207	6397	114762	0	124658
239	1728	1496	3267	118397	0	124888
240	1938	1396	1883	115736	0	120953
241	995	114416	1830	6539	0	123780
242	1015	5217	111604	3300	0	121136
243	1752	3003	4846	105960	0	115561
244	970	106810	2971	4941	0	115692
245	1397	114187	1782	2665	0	120031
246	1235	6286	111611	1920	0	121052
247	1127	3858	112141	1378	0	118504
248	1301	2430	115083	1335	0	120149
249	1685	1787	7015	108290	0	118777
250	1100	1765	112754	4847	0	120466
251	1666	1504	6094	109643	0	118907
252	1213	1477	111348	5585	0	119623
253	102280	1606	5986	3498	0	113370
254	5020	111204	3195	2206	0	121625
255	2627	121867	2024	1663	0	128181
256	1923	7207	123170	1497	0	133797
257	117853	3640	5765	2090	0	129348
258	124794	2596	3071	1680	0	132141
259	126140	1967	2290	1748	0	132145
260	8128	1636	117931	1447	0	129142
261	3893	1378	122584	1618	0	129473
262	2593	1403	8066	117468	0	129530
263	118769	1403	4202	6683	0	131057
264	121301	1535	2921	3955	0	129712
265	7353	1571	116548	2892	0	128364
266	117234	1794	6763	2256	0	128047
267	7109	1765	4130	114684	0	127688
268	3353	2010	117762	6447	0	129572
269	2161	2070	120712	3585	0	128528
270	111919	1895	9019	3078	0	125911
271	6015	1617	120097	2361	0	130090
272	116100	1473	8453	2472	0	128498
273	6804	1560	119874	2152	0	130390
274	3594	111901	8640	2385	0	126520
275	2639	120166	5491	2081	0	130377
276	2717	7542	3971	113768	0	127998
277	2527	4149	3581	121093	0	131350
278	2346	2875	118046	7840	0	131107
279	2483	2417	7860	112784	0	125544
280	2505	110937	4804	6951	0	125197
281	2582	116106	3622	3871	0	126181
282	2853	121669	3360	2428	0	130310
283	3313	8488	3151	114988	0	129940
284	3051	4637	116416	6115	0	130219
285	2741	3187	119777	3444	0	129149
286	3189	2681	8831	114201	0	128902
287	3079	2318	5128	117428	0	127953
288	3398	2211	3542	111290	0	120441
289	3232	114607	2746	7995	0	128580
290	115273	6196	2666	4618	0	128753
291	116587	3674	2517	3396	0	126174
292	8371	115035	2707	2728	0	128841
293	4837	6514	116113	2568	0	130032
294	117181	3932	6926	2388	0	130427
295	7720	2771	119013	2046	0	131550
296	116904	2344	7950	2136	0	129334
297	120615	2088	4636	2461	0	129800
298	120259	2047	3704	2642	0	128652
299	118865	1945	2999	2929	0	126738
300	8789	115478	2803	3103	0	130173
301	102252	5013	2185	2893	0	112343
302	6095	103174	2377	2801	0	114447
303	84616	4244	1791	1834	0	92485
304	4560	81959	1726	1492	0	89737
305	2282	3264	72652	989	0	79187
306	1705	7228	3220	60927	0	73080
307	1251	65956	2185	2639	0	72031
308	1157	63012	1151	1357	0	66677
309	56805	2866	2734	1845	0	64250
310	51005	787	670	670	0	53132
311	1985	52853	639	522	0	55999
312	1136	1356	640	50253	0	53385
313	900	56039	525	1181	0	58645
314	56655	1513	568	642	0	59378
315	1950	634	56654	390	0	59628
316	1178	662	1633	54361	0	57834
317	1012	397	904	54656	0	56969
318	944	442	682	55773	0	57841
319	719	466	54887	1722	0	57794
320	732	53744	1580	735	0	56791
321	780	56412	782	448	0	58422
322	941	1670	603	56087	0	59301
323	770	830	57594	1412	0	60606
324	831	729	1581	56276	0	59417
325	705	759	787	57785	0	60036
326	759	698	636	57521	0	59614
327	863	641	502	57803	0	59809
328	56090	518	586	2178	0	59372
329	1496	57050	661	1061	0	60268
330	56837	1583	682	1018	0	60120
331	1653	851	56927	793	0	60224
332	843	824	57977	690	0	60334
333	935	723	1706	55842	0	59206
334	766	662	861	57315	0	59604
335	517	59379	791	1900	0	62587
336	547	1487	59788	1129	0	62951
337	460	60709	1664	1097	0	63930
338	472	1603	61363	890	0	64328
339	56617	832	1665	1096	0	60210
340	1571	61579	726	802	0	64678
341	846	1695	61795	645	0	64981
342	977	876	1583	60357	0	63793
343	662	834	61848	1583	0	64927
344	557	61615	1677	846	0	64695
345	765	1560	902	59517	0	62744
346	675	61453	697	1730	0	64555
347	731	1602	61702	902	0	64937
348	909	837	1449	60288	0	63483
349	60702	767	610	1802	0	63881
350	1662	60778	627	712	0	63779
351	852	1736	59504	560	0	62652
352	972	1603	1447	56349	0	60371
353	604	775	59034	1391	0	61804
354	473	600	52875	601	0	54549
355	321	48420	1251	484	0	50476
356	465	524	421	42567	0	43977
357	220	264	212	42850	0	43546
358	238	205	186	42329	0	42958
359	114	209	43784	604	0	44711
360	137	162	42965	271	0	43535
361	38902	170	590	407	0	40069
362	457	159	42820	136	0	43572
363	39480	118	524	287	0	40409
364	452	42215	256	163	0	43086
365	242	447	180	41276	0	42145
366	99	43415	200	462	0	44176
367	85	44635	164	251	0	45135
368	88	547	43433	179	0	44247
369	178	293	504	42538	0	43513
370	76	218	43552	473	0	44319
371	106	177	40367	246	0	40896
372	39626	100	542	353	0	40621
373	379	130	42092	216	0	42817
374	153	140	41046	185	0	41524
375	38872	94	546	338	0	39850
376	436	114	41281	213	0	42044
377	166	144	42159	164	0	42633
378	226	139	519	40126	0	41010
379	131	42433	265	394	0	43223
380	133	411	244	42852	0	43640
381	133	169	236	41846	0	42384
382	42840	124	190	708	0	43862
383	420	159	200	42362	0	43141
384	158	44016	220	519	0	44913
385	43020	427	193	419	0	44059
386	442	239	43544	217	0	44442
387	40995	168	534	369	0	42066
388	532	182	47085	160	0	47959
389	229	161	48840	140	0	49370
390	134	50918	790	203	0	52045
391	51126	589	377	339	0	52431
392	577	53003	312	224	0	54116
393	240	735	53432	207	0	54614
394	367	304	695	49216	0	50582
395	125	54925	357	616	0	56023
396	55568	711	266	399	0	56944
397	55270	307	231	342	0	56150
398	857	55815	250	155	0	57077
399	56567	775	249	224	0	57815
400	890	326	236	54409	0	55861
401	292	56043	320	723	0	57378
402	333	776	270	57352	0	58731
403	342	353	231	60959	0	61885
404	61657	318	226	1128	0	63329
405	61070	261	216	520	0	62067
406	61107	222	228	435	0	61992
407	1132	238	61100	219	0	62689
408	59451	187	896	337	0	60871
409	1176	416	379	61720	0	63691
410	498	204	62102	912	0	63716
411	436	191	58674	354	0	59655
412	282	59254	1079	265	0	60880
413	54413	788	451	343	0	55995
414	808	56661	225	198	0	57892
415	489	762	118	56200	0	57569
416	428	249	138	57004	0	57819
417	273	137	58141	914	0	59465
418	552	187	803	54646	0	56188
419	272	101	58373	852	0	59598
420	261	159	56097	303	0	56820
421	174	58152	962	228	0	59516
422	401	688	345	56633	0	58067
423	298	264	225	56478	0	57265
424	56241	166	178	987	0	57572
425	731	165	56321	309	0	57526
426	383	157	717	57132	0	58389
427	57879	117	284	979	0	59259
428	751	144	58309	364	0	59568
429	56703	107	807	439	0	58056
430	58661	127	337	388	0	59513
431	949	184	60391	162	0	61686
432	583	156	804	58117	0	59660
433	398	160	365	59437	0	60360
434	256	122	61001	954	0	62333
435	58555	153	848	637	0	60193
436	61159	120	386	478	0	62143
437	59651	125	359	395	0	60530
438	60417	150	296	368	0	61231
439	59941	180	333	385	0	60839
440	1178	380	51159	644	0	53361
441	598	230	60373	317	0	61518
442	407	61112	981	315	0	62815
443	419	810	61544	319	0	63092
444	520	357	909	59923	0	61709
445	1165	361	697	46623	0	48846
446	589	212	303	61699	0	62803
447	627	198	275	62306	0	63406
448	532	188	62395	1077	0	64192
449	523	60532	940	545	0	62540
450	531	64902	455	430	0	66318
451	543	993	395	62113	0	64044
452	377	66011	345	975	0	67708
453	66031	985	308	701	0	68025
454	65744	358	331	604	0	67037
455	1309	69021	334	453	0	71117
456	749	954	295	69174	0	71172
457	625	288	393	71387	0	72693
458	455	255	71792	1394	0	73896
459	65213	242	1209	925	0	67589
460	72036	259	620	707	0	73622
461	1405	74183	467	462	0	76517
462	74493	1213	439	615	0	76760
463	1451	550	76235	473	0	78709
464	730	74658	1242	512	0	77142
465	569	77995	573	527	0	79664
466	515	78218	518	498	0	79749
467	666	1530	410	77193	0	79799
468	76774	568	404	1607	0	79353
469	1652	377	473	78144	0	80646
470	815	370	80826	1655	0	83666
471	938	327	1624	80292	0	83181
472	657	402	84524	1754	0	87337
473	803	385	1816	80438	0	83442
474	862	377	802	79585	0	81626
475	535	84107	631	1798	0	87071
476	85523	1578	626	1033	0	88760
477	1907	599	577	83342	0	86425
478	832	85446	506	1815	0	88599
479	84843	1632	489	1101	0	88065
480	68686	866	767	1357	0	71676
481	84725	536	525	997	0	86783
482	1984	85646	577	818	0	89025
483	926	1601	85972	731	0	89230
484	806	684	1770	84646	0	87906
485	926	779	751	82082	0	84538
486	646	85042	715	2013	0	88416
487	693	1595	84243	949	0	87480
488	638	591	81615	811	0	83655
489	77703	473	1741	784	0	80701
490	1925	647	637	78419	0	81628
491	757	336	81265	1503	0	83861
492	540	83332	1416	734	0	86022
493	884	1481	533	78357	0	81255
494	594	84026	569	1256	0	86445
495	521	1412	82410	555	0	84898
496	76866	501	1394	826	0	79587
497	81677	390	645	710	0	83422
498	1594	82868	500	548	0	85510
499	943	1284	317	82055	0	84599
500	615	500	82643	1440	0	85198
501	522	81621	1426	590	0	84159
502	79616	1331	491	718	0	82156
503	1268	76908	334	351	0	78861
504	423	77710	297	296	0	78726
505	596	1414	236	75440	0	77686
506	280	77094	282	1128	0	78784
507	76633	1239	224	596	0	78692
508	1356	497	225	76109	0	78187
509	366	364	73833	1061	0	75624
510	312	340	70498	376	0	71526
511	438	386	1067	71002	0	72893
512	241	72720	375	982	0	74318
513	72962	1061	277	489	0	74789
514	1112	400	230	71391	0	73133
515	357	384	71296	1037	0	73074
516	430	293	980	70281	0	71984
517	356	291	327	71230	0	72204
518	70028	298	258	1397	0	71981
519	1098	279	206	69770	0	71353
520	454	289	69655	1114	0	71512
521	346	279	68672	469	0	69766
522	406	259	1110	69845	0	71620
523	392	279	439	70852	0	71962
524	253	286	73062	1187	0	74788
525	64259	275	1060	850	0	66444
526	1020	340	71912	436	0	73708
527	361	71931	1100	394	0	73786
528	381	984	419	73015	0	74799
529	319	386	73170	1084	0	74959
530	312	346	71746	483	0	72887
531	343	295	1174	69567	0	71379
532	70936	232	491	1383	0	73042
533	1036	263	72702	463	0	74464
534	324	72942	1079	465	0	74810
535	72857	1005	466	695	0	75023
536	1049	358	74463	398	0	76268
537	69978	250	1107	660	0	71995
538	73984	238	457	634	0	75313
539	1171	76949	447	376	0	78943
540	571	979	410	73783	0	75743
541	366	75744	352	1005	0	77467
542	333	1111	75016	463	0	76923
543	73566	416	1145	681	0	75808
544	77558	339	457	605	0	78959
545	1288	370	78269	316	0	80243
546	619	323	76816	302	0	78060
547	439	80897	1353	295	0	82984
548	82338	1168	629	503	0	84638
549	1438	466	442	81337	0	83683
550	644	350	380	77791	0	79165
551	392	80587	391	1113	0	82483
552	78814	1156	371	788	0	81129
553	1183	439	81049	385	0	83056
554	637	350	1162	86172	0	88321
555	87560	280	484	1751	0	90075
556	1581	89638	462	513	0	92194
557	591	1532	99214	282	0	101619
558	494	487	100830	252	0	102063
559	750	948	2277	95476	0	99451
560	276	101109	744	1783	0	103912
561	316	2048	101877	417	0	104658
562	626	579	2016	99177	0	102398
563	102014	316	620	2391	0	105341
564	2085	322	105718	499	0	108624
565	911	274	2200	104468	0	107853
566	403	292	107656	2199	0	110550
567	314	227	110137	533	0	111211
568	736	758	2753	107285	0	111532
569	347	208	111844	2240	0	114639
570	92734	225	2521	1142	0	96622
571	2002	216	109350	374	0	111942
572	99625	127	2299	710	0	102761
573	2046	106890	741	270	0	109947
574	109577	1920	512	744	0	112753
575	2013	113024	485	260	0	115782
576	955	2023	389	112518	0	115885
577	828	448	362	116118	0	117756
578	368	360	114593	2409	0	117730
579	283	305	114736	755	0	116079
580	621	155	2620	115847	0	119243
581	277	240	118323	2259	0	121099
582	625	205	2595	111947	0	115372
583	267	113965	970	2364	0	117566
584	403	120348	786	699	0	122236
585	722	2481	635	117692	0	121530
586	737	749	514	119460	0	121460
587	349	641	118051	2562	0	121603
588	727	445	2293	114044	0	117509
589	287	114133	850	2491	0	117761
590	214	115843	717	978	0	117752
591	258	116977	654	867	0	118756
592	591	2403	649	109211	0	112854
593	209	111513	802	2267	0	114791
594	110075	2261	637	1171	0	114144
595	2358	724	654	109949	0	113685
596	573	594	109999	2455	0	113621
597	836	534	2454	106988	0	110812
598	392	574	111355	2624	0	114945
599	383	575	110792	975	0	112725
600	422	460	111242	836	0	112960
601	352	110534	2910	833	0	114629
602	395	2349	112093	673	0	115510
603	109287	791	2705	1050	0	113833
604	112626	723	1020	986	0	115355
605	114437	612	954	921	0	116924
606	2834	556	791	113265	0	117446
607	112388	569	762	2999	0	116718
608	2443	110075	974	1077	0	114569
609	826	116917	851	1021	0	119615
610	115530	2486	931	1280	0	120227
611	2475	980	118290	858	0	122603
612	1063	753	2726	116375	0	120917
613	700	726	119942	2578	0	123946
614	553	883	119401	1050	0	121887
615	423	119963	3052	943	0	124381
616	993	2506	1346	112041	0	116886
617	722	939	1142	121770	0	124573
618	119199	773	898	3353	0	124223
619	2450	119509	913	1398	0	124270
620	965	123275	902	1180	0	126322
621	955	2937	122398	1027	0	127317
622	766	124494	2696	910	0	128866
623	120955	2995	1375	1293	0	126618
624	120648	1166	1426	1377	0	124617
625	2737	1033	124720	952	0	129442
626	889	905	125580	1085	0	128459
627	1096	805	3849	117259	0	123009
628	905	928	2014	119236	0	123083
629	825	121078	1601	3137	0	126641
630	1082	2837	1372	120283	0	125574
631	1154	1008	1437	120815	0	124414
632	960	120566	1305	3410	0	126241
633	1145	2641	1379	120314	0	125479
634	943	1115	1523	116508	0	120089
635	717	115773	1596	3491	0	121577
636	869	2598	115840	1635	0	120942
637	1120	1039	3376	117640	0	123175
638	117835	947	1580	3439	0	123801
639	115988	1011	1538	1590	0	120127
640	3387	1124	115376	1083	0	120970
641	111339	1216	2889	1529	0	116973
642	116811	1170	1077	1649	0	120707
643	2944	116395	986	1526	0	121851
644	1253	2834	112882	1418	0	118387
645	819	1185	113073	1609	0	116686
646	919	1262	3276	118343	0	123800
647	119341	844	1762	3708	0	125655
648	125693	775	1609	1751	0	129828
649	3606	996	1227	136498	0	142327
650	147957	1002	1070	4201	0	154230
651	153365	1022	1030	2003	0	157420
652	148182	1028	1075	2224	0	152509
653	4711	1139	147374	1360	0	154584
654	1825	883	146560	1140	0	150408
655	140834	441	3619	1675	0	146569
656	3387	547	145618	977	0	150529
657	944	134762	2684	439	0	138829
658	1510	2485	1238	132046	0	137279
659	526	684	137483	2150	0	140843
660	546	542	134891	738	0	136717
661	1103	885	2785	128759	0	133532
662	556	231	134502	2165	0	137454
663	460	330	130406	832	0	132028
664	507	120116	2648	674	0	123945
665	394	129622	1040	331	0	131387
666	128528	2220	797	611	0	132156
667	2563	732	435	126186	0	129916
668	126642	368	532	2328	0	129870
669	2330	275	125018	554	0	128177
670	1255	268	2176	122436	0	126135
671	945	399	743	125959	0	128046
672	123069	193	600	2919	0	126781
673	2059	124779	505	1032	0	128375
674	909	1997	115614	635	0	119155
675	750	763	119179	404	0	121096
676	419	122220	2514	485	0	125638
677	417	1908	121199	407	0	123931
678	446	120662	2260	327	0	123695
679	477	117895	908	339	0	119619
680	711	2327	115881	279	0	119198
681	110668	742	2224	507	0	114141
682	2422	516	796	117060	0	120794
683	757	120508	742	1867	0	123874
684	950	1887	552	120358	0	123747
685	119945	705	470	2443	0	123563
686	114473	454	565	1091	0	116583
687	113683	342	590	842	0	115457
688	2472	368	112638	416	0	115894
689	1263	396	2150	108361	0	112170
690	497	113685	1046	1760	0	116988
691	118190	1817	745	1032	0	121784
692	2303	785	548	118667	0	122303
693	1349	660	497	116829	0	119335
694	950	432	561	122097	0	124040
695	624	415	125841	2641	0	129521
696	114352	372	2071	1669	0	118464
697	2372	125718	827	836	0	129753
698	1365	1994	649	125298	0	129306
699	1334	695	522	126978	0	129529
700	125269	451	559	3006	0	129285
701	2553	505	120159	1120	0	124337
702	1163	406	126850	690	0	129109
703	813	125420	2798	705	0	129736
704	561	2230	129573	591	0	132955
705	117490	906	2870	1164	0	122430
706	2305	129302	1237	755	0	133599
707	939	2406	129917	647	0	133909
708	117924	1012	2791	1039	0	122766
709	2447	863	133778	698	0	137786
710	1264	134556	2892	676	0	139388
711	1326	2405	1272	133378	0	138381
712	1178	1121	899	136646	0	139844
713	954	861	134432	2901	0	139148
714	1171	591	130832	1284	0	133878
715	985	132256	3152	975	0	137368
716	128323	2376	1593	1111	0	133403
717	2540	134956	1273	868	0	139637
718	1509	2663	1002	133356	0	138530
719	1121	1137	133601	2581	0	138440
720	120150	909	3074	1417	0	125550
721	2958	752	1561	128369	0	133640
722	1292	126358	1498	2507	0	131655
723	862	133596	1423	1214	0	137095
724	890	3067	1152	132153	0	137262
725	1003	1477	1106	134447	0	138033
726	131892	1134	1010	3506	0	137542
727	2785	994	998	134437	0	139214
728	1237	928	134112	3155	0	139432
729	128606	816	3010	1829	0	134261
730	134865	717	1426	1604	0	138612
731	3299	934	135446	1097	0	140776
732	131199	795	3033	1233	0	136260
733	3471	826	1396	139267	0	144960
734	1929	859	1160	140723	0	144671
735	1602	845	990	142192	0	145629
736	1453	831	948	137209	0	140441
737	815	139901	1086	3881	0	145683
738	141993	3013	1021	2104	0	148131
739	145635	1375	931	1821	0	149762
740	3967	1124	146872	1427	0	153390
741	150799	805	3195	1780	0	156579
742	161375	854	1439	1505	0	165173
743	163939	823	1248	1480	0	167490
744	169702	737	1049	1383	0	172871
745	5360	167152	955	1103	0	174570
746	2758	3993	656	160714	0	168121
747	1478	1425	162348	3671	0	168922
748	1344	992	151983	1498	0	155817
749	129523	2150	4947	1804	0	138424
750	130702	707	2145	970	0	134524
751	3015	126051	672	428	0	130166
752	126706	2094	523	686	0	130009
753	2797	128033	398	364	0	131592
754	1802	2406	362	126765	0	131335
755	129448	926	283	2825	0	133482
756	127679	575	235	1311	0	129800
757	128455	388	265	1012	0	130120
758	3454	126836	360	517	0	131167
759	127392	2297	318	737	0	130744
760	3368	902	340	127296	0	131906
761	129657	512	470	2751	0	133390
762	3119	494	126234	838	0	130685
763	1601	128015	2270	594	0	132480
764	128132	2236	816	768	0	131952
765	2923	1087	128629	378	0	133017
766	1986	665	2241	125918	0	130810
767	1177	608	130403	2260	0	134448
768	1077	545	128118	983	0	130723
769	1633	362	2913	126051	0	130959
770	1179	454	131720	2312	0	135665
771	1542	399	2647	128681	0	133269
772	1366	513	1099	131161	0	134139
773	131004	406	757	3602	0	135769
774	2812	131590	683	1539	0	136624
775	1494	135037	692	979	0	138202
776	1151	137504	749	673	0	140077
777	1015	3406	134850	595	0	139866
778	1529	1393	2696	131664	0	137282
779	880	898	138019	2626	0	142423
780	127805	584	3057	1715	0	133161
781	134653	505	1418	1365	0	137941
782	3332	136371	1157	761	0	141621
783	2097	2646	728	132528	0	137999
784	1170	137379	797	2618	0	141964
785	137216	2908	628	1621	0	142373
786	3421	1248	526	136703	0	141898
787	1690	1023	136836	2878	0	142427
788	1241	134860	2721	1404	0	140226
789	1127	3056	137093	929	0	142205
790	1431	1388	3004	133706	0	139529
791	962	956	135757	2975	0	140650
792	124839	718	3275	1857	0	130689
793	3245	777	134804	1050	0	139876
794	1710	134869	3295	885	0	140759
795	1723	2830	1410	133729	0	139692
796	1365	1430	1157	137776	0	141728
797	134652	975	963	4081	0	140671
798	135278	848	938	2229	0	139293
799	3736	134019	1033	1348	0	140136
800	1805	2755	132788	1123	0	138471
801	1387	1329	131361	952	0	135029
802	127398	1078	3687	1245	0	133408
803	3435	909	132978	925	0	138247
804	1703	814	129750	966	0	133233
805	1346	861	130074	940	0	133221
806	1369	842	129913	767	0	132891
807	1169	129134	4191	835	0	135329
808	129386	3115	2196	1148	0	135845
809	3524	1372	1425	126132	0	132453
810	125597	1009	1235	3326	0	131167
811	3728	124673	1143	1410	0	130954
812	124229	2989	1125	1372	0	129715
813	3533	128599	1213	866	0	134211
814	2177	3309	1343	126731	0	133560
815	1530	133775	1511	2855	0	139671
816	1539	3449	132230	1333	0	138551
817	1339	136025	3750	1051	0	142165
818	1520	3579	2066	147137	0	154302
819	148226	1691	1632	3656	0	155205
820	4026	1353	1403	148434	0	155216
821	1988	1336	148678	3797	0	155799
822	2241	1111	3590	142618	0	149560
823	1417	148024	1830	3828	0	155099
824	1547	3596	148528	1818	0	155489
825	146443	1939	3877	1622	0	153881
826	4329	1463	1915	152268	0	159975
827	148828	1294	1566	4305	0	155993
828	150037	1134	1389	2566	0	155126
829	4259	151512	1444	1728	0	158943
830	145501	3547	1585	1982	0	152615
831	151545	1821	1403	1733	0	156502
832	4471	150815	1441	1310	0	158037
833	2672	3422	1273	149367	0	156734
834	1984	1629	1321	149528	0	154462
835	1202	149953	1519	4217	0	156891
836	1656	3507	1304	152856	0	159323
837	1210	1878	151186	3841	0	158115
838	1755	1808	3685	146795	0	154043
839	1545	1060	147587	3806	0	153998
840	1179	845	134249	1665	0	137938
841	983	132603	3557	1402	0	138545
842	945	131749	1669	1020	0	135383
843	919	134730	1197	872	0	137718
844	1782	3085	1050	125270	0	131187
845	649	1200	127239	2164	0	131252
846	120493	821	2257	1422	0	124993
847	2340	626	1001	127329	0	131296
848	863	619	127761	2227	0	131470
849	675	745	126309	961	0	128690
850	494	129516	2522	838	0	133370
851	756	2353	1207	127175	0	131491
852	124977	934	836	2629	0	129376
853	1853	124128	781	1039	0	127801
854	808	124267	755	739	0	126569
855	582	124132	658	654	0	126026
856	762	2768	672	122355	0	126557
857	371	127213	690	2108	0	130382
858	774	2459	562	135076	0	138871
859	891	1047	606	138320	0	140864
860	603	797	135617	3150	0	140167
861	118790	668	2724	2074	0	124256
862	2575	698	137285	821	0	141379
863	1452	926	2907	134416	0	139701
864	660	818	138391	2790	0	142659
865	459	137026	2962	1360	0	141807
866	135442	2841	1251	1367	0	140901
867	3010	1338	781	132926	0	138055
868	1434	862	645	137001	0	139942
869	135175	682	646	3802	0	140305
870	133203	537	631	2083	0	136454
871	136937	658	654	1527	0	139776
872	3450	638	136012	926	0	141026
873	126377	547	2609	1350	0	130883
874	2914	131471	1178	837	0	136400
875	1344	133932	743	700	0	136719
876	1326	3041	645	129040	0	134052
877	1132	1265	455	126957	0	129809
878	669	128600	632	3071	0	132972
879	1130	2816	452	128686	0	133084
880	126635	1092	452	3299	0	131478
881	2650	847	127607	1457	0	132561
882	1116	126921	2467	1163	0	131667
883	121277	2645	960	1357	0	126239
884	2555	125605	712	1019	0	129891
885	1136	2840	124986	754	0	129716
886	1209	1246	2601	122852	0	127908
887	795	994	125071	2658	0	129518
888	571	123990	2721	1316	0	128598
889	995	2752	1086	123307	0	128140
890	616	1261	123218	2820	0	127915
891	663	1103	122850	1341	0	125957
892	998	844	3034	122531	0	127407
893	122690	670	1382	3170	0	127912
894	123793	637	961	1528	0	126919
895	123901	652	788	1402	0	126743
896	3283	789	125713	839	0	130624
897	1450	125756	2657	779	0	130642
898	1148	2693	1161	124961	0	129963
899	948	1124	987	123438	0	126497
900	701	126299	782	3115	0	130897
901	124838	2653	762	1796	0	130049
902	2868	1275	609	126196	0	130948
903	1226	957	126565	2845	0	131593
904	871	126529	2720	1450	0	131570
905	122031	2588	1417	1496	0	127532
906	2448	125720	967	1216	0	130351
907	1518	2784	817	123347	0	128466
908	1302	1292	826	124480	0	127900
909	1254	953	841	125447	0	128495
910	804	987	124189	3447	0	129427
911	1023	1098	2617	119831	0	124569
912	790	120206	1338	3245	0	125579
913	801	120227	984	1701	0	123713
914	1015	2865	116016	1180	0	121076
915	105783	1287	2473	1669	0	111212
916	112918	853	1135	1656	0	116562
917	2836	111369	1013	1108	0	116326
918	98867	2162	849	1126	0	103004
919	98966	897	532	1148	0	101543
920	2431	102754	606	895	0	106686
921	1376	2257	584	103748	0	107965
922	987	1053	108258	2487	0	112785
923	955	991	103624	1209	0	106779
924	104249	800	2789	1376	0	109214
925	2378	107984	1087	1046	0	112495
926	1372	2476	731	107301	0	111880
927	1083	1255	552	108480	0	111370
928	1127	825	694	108567	0	111213
929	106463	690	612	3498	0	111263
930	2953	668	659	106891	0	111171
931	1564	778	546	107633	0	110521
932	1031	778	104012	2872	0	108693
933	94537	636	2250	1907	0	99330
934	2317	102613	1055	1135	0	107120
935	100647	2169	709	1379	0	104904
936	2328	99712	749	838	0	103627
937	1349	2202	724	99346	0	103621
938	99468	963	607	2732	0	103770
939	100710	770	627	1605	0	103712
940	2671	754	98519	1012	0	102956
941	99653	609	2000	1347	0	103609
942	2701	649	101431	903	0	105684
943	1301	698	97734	699	0	100432
944	941	639	97628	824	0	100032
945	806	702	105458	816	0	107782
946	1074	737	3346	106346	0	111503
947	849	667	109153	2786	0	113455
948	1077	671	3114	106149	0	111011
949	106772	593	1316	3391	0	112072
950	3103	671	990	106145	0	110909
951	103894	539	832	3728	0	108993
952	3027	105163	767	1507	0	110464
953	1762	2862	753	104814	0	110191
954	1056	1076	104797	3131	0	110060
955	872	107838	2833	1525	0	113068
956	1396	3406	1059	105010	0	110871
957	810	932	106734	2980	0	111456
958	488	101014	2549	1094	0	105145
959	401	103948	1005	818	0	106172
960	584	2846	102210	602	0	106242
961	1062	1522	2753	97536	0	102873
962	426	649	98951	2546	0	102572
963	92371	308	2661	1184	0	96524
964	96260	248	881	1081	0	98470
965	2812	95650	665	417	0	99544
966	96094	2360	400	653	0	99507
967	3057	744	358	95712	0	99871
968	897	595	95186	2435	0	99113
969	89679	366	2452	1269	0	93766
970	2570	328	93020	738	0	96656
971	833	92451	2760	422	0	96466
972	93613	2418	988	677	0	97696
973	2859	792	610	93056	0	97317
974	865	559	94277	2353	0	98054
975	91615	296	2529	1161	0	95601
976	92503	292	1026	911	0	94732
977	93817	275	708	653	0	95453
978	3671	263	438	90937	0	95309
979	1671	336	413	93279	0	95699
980	922	304	92251	2972	0	96449
981	622	91412	2525	1285	0	95844
982	960	2303	983	89631	0	93877
983	949	724	686	93948	0	96307
984	501	579	92402	3070	0	96552
985	494	536	92540	1222	0	94792
986	894	326	3119	91269	0	95608
987	89276	346	1367	3179	0	94168
988	2480	91032	1019	1156	0	95687
989	90414	2462	651	1177	0	94704
990	2881	91210	745	669	0	95505
991	1257	2797	90818	640	0	95512
992	942	1009	92624	736	0	95311
993	88494	752	3371	1036	0	93653
994	99427	514	1444	1020	0	102405
995	3637	98653	1067	919	0	104276
996	1789	3047	96107	840	0	101783
997	1787	1216	3270	94483	0	100756
998	1438	1020	1575	92756	0	96789
999	966	95587	1327	3901	0	101781
1000	1185	3095	868	97093	0	102241
1001	894	1462	97022	3876	0	103254
1002	93562	1187	3415	1972	0	100136
1003	97069	796	1546	1606	0	101017
1004	95030	767	1294	1321	0	98412
1005	99590	607	1047	1053	0	102297
1006	5179	592	95272	764	0	101807
1007	95135	462	3638	905	0	100140
1008	4802	510	95490	573	0	101375
1009	2355	94080	4164	627	0	101226
1010	2100	3085	2034	95124	0	102343
1011	96889	1253	1635	3586	0	103363
1012	4022	1049	1248	101005	0	107324
1013	1847	809	101204	4225	0	108085
1014	99596	672	3845	2272	0	106385
1015	103590	620	1925	1819	0	107954
1016	5271	624	1406	100929	0	108230
1017	3071	527	1064	104219	0	108881
1018	2064	609	100553	4836	0	108062
1019	1519	101065	3796	2562	0	108942
1020	97469	3342	1787	1835	0	104433
1021	4043	1522	93273	1025	0	99863
1022	88140	1112	3534	1048	0	93834
1023	4200	90290	1789	822	0	97101
1024	89130	3188	1392	921	0	94631
1025	4319	86808	1114	729	0	92970
1026	2210	89250	904	753	0	93117
1027	2331	3992	905	86359	0	93587
1028	1778	2007	843	89383	0	94011
1029	1618	1393	753	90124	0	93888
1030	1393	907	724	91280	0	94304
1031	1054	782	87114	5110	0	94060
1032	85082	700	3300	2835	0	91917
1033	89312	682	1547	2076	0	93617
1034	91485	508	1368	1479	0	94840
1035	5396	539	1121	87455	0	94511
1036	3337	483	878	89829	0	94527
1037	88886	533	789	4481	0	94689
1038	89322	603	808	2446	0	93179
1039	90322	705	720	1803	0	93550
1040	5388	785	742	85291	0	92206
1041	3022	579	749	84877	0	89227
1042	2054	596	81268	4060	0	87978
1043	1459	534	79805	2375	0	84173
1044	1361	79474	3549	1762	0	86146
1045	69688	3039	2894	1714	0	77335
1046	69406	1212	1414	1081	0	73113
1047	69530	842	794	1187	0	72353
1048	3679	584	69321	905	0	74489
1049	69286	490	2200	1111	0	73087
1050	71297	375	1200	1127	0	73999
1051	72272	392	993	1010	0	74667
1052	4140	328	741	69076	0	74285
1053	2773	334	683	69642	0	73432
1054	2279	309	582	69752	0	72922
1055	1489	384	60997	3436	0	66306
1056	58768	430	1729	2171	0	63098
1057	2596	61395	992	1442	0	66425
1058	55007	1478	602	852	0	57939
1059	2293	53551	461	692	0	56997
1060	1447	54752	385	639	0	57223
1061	1531	2081	451	53429	0	57492
1062	1155	1222	647	52770	0	55794
1063	889	52887	342	2085	0	56203
1064	52173	1602	336	1455	0	55566
1065	52802	843	311	1176	0	55132
1066	2360	702	375	51428	0	54865
1067	1618	454	51122	1777	0	54971
1068	1360	342	50142	1219	0	53063
1069	1137	267	52178	993	0	54575
1070	1041	326	51968	697	0	54032
1071	49280	451	2582	740	0	53053
1072	50145	258	1319	561	0	52283
1073	2362	242	824	48433	0	51861
1074	1551	282	48301	1595	0	51729
1075	1343	272	1432	48769	0	51816
1076	882	49164	934	1823	0	52803
1077	859	55997	732	1100	0	58688
1078	56309	1746	526	1065	0	59646
1079	57214	1132	363	789	0	59498
1080	57750	761	329	810	0	59650
1081	2560	541	430	56070	0	59601
1082	1697	407	408	57545	0	60057
1083	1454	396	426	57927	0	60203
1084	1292	331	298	57727	0	59648
1085	1088	248	56620	2504	0	60460
1086	1053	228	1295	57181	0	59757
1087	59504	232	821	2391	0	62948
1088	1822	198	776	60292	0	63088
1089	1288	300	571	61610	0	63769
1090	1220	552	475	60938	0	63185
1091	875	58095	445	2644	0	62059
1092	854	58151	392	1579	0	60976
1093	668	59341	310	1157	0	61476
1094	722	1188	224	52352	0	54486
1095	578	495	180	53278	0	54531
1096	53237	293	167	1581	0	55278
1097	53152	223	200	945	0	54520
1098	53998	212	200	747	0	55157
1099	1523	236	192	53438	0	55389
1100	863	217	185	53298	0	54563
1101	633	52807	192	1346	0	54978
1102	601	55561	152	786	0	57100
1103	54882	1019	139	676	0	56716
1104	1263	416	123	54644	0	56446
1105	54484	251	140	1258	0	56133
1106	56078	172	156	823	0	57229
1107	1319	170	177	55166	0	56832
1108	598	58794	211	1061	0	60664
1109	59783	819	158	801	0	61561
1110	61590	325	117	725	0	62757
1111	1294	252	64389	417	0	66352
1112	59425	122	533	476	0	60556
1113	830	61534	225	228	0	62817
1114	482	607	104	63646	0	64839
1115	71441	255	72	1158	0	72926
1116	1016	181	45	72144	0	73386
1117	644	118	51	72199	0	73012
1118	351	72785	102	1038	0	74276
1119	72532	682	46	791	0	74051
1120	72972	337	55	551	0	73915
1121	1087	72288	75	287	0	73737
1122	537	78433	78	193	0	79241
1123	78672	889	126	508	0	80195
1124	78276	411	47	415	0	79149
1125	1054	306	76091	177	0	77628
1126	708	224	70507	198	0	71637
1127	469	204	78045	148	0	78866
1128	455	140	976	79771	0	81342
1129	391	126	448	81728	0	82693
1130	268	159	81572	947	0	82946
1131	78850	113	727	831	0	80521
1132	85022	144	336	598	0	86100
1133	85589	144	213	490	0	86436
1134	84534	122	122	496	0	85274
1135	1302	150	93938	171	0	95561
1136	94094	141	699	691	0	95625
1137	97330	140	540	690	0	98700
1138	97681	116	266	624	0	98687
1139	99174	93	191	518	0	99976
1140	98543	91	190	509	0	99333
1141	1299	174	101047	208	0	102728
1142	696	101407	787	227	0	103117
1143	736	709	324	100456	0	102225
1144	543	344	223	104283	0	105393
1145	429	286	103705	1011	0	105431
1146	94722	170	734	848	0	96474
1147	1155	125	361	102599	0	104240
1148	712	177	104896	822	0	106607
1149	708	239	97954	474	0	99375
1150	458	108760	1030	420	0	110668
1151	586	696	509	110996	0	112787
1152	556	389	296	112248	0	113489
1153	563	317	207	110932	0	112019
1154	112861	186	169	1532	0	114748
1155	1130	125	191	112498	0	113944
1156	622	210	111810	1054	0	113696
1157	624	281	99948	699	0	101552
1158	504	242	114846	478	0	116070
1159	686	175	1154	117057	0	119072
1160	121257	154	659	1360	0	123430
1161	1057	244	121500	491	0	123292
1162	117473	159	893	801	0	119326
1163	135755	128	513	1187	0	137583
1164	1477	139	384	139522	0	141522
1165	1033	154	294	139954	0	141435
1166	616	140842	291	1275	0	143024
1167	548	812	140863	745	0	142968
1168	136405	378	935	990	0	138708
1169	1268	283	510	146757	0	148818
1170	672	146390	425	1000	0	148487
1171	703	823	282	149146	0	150954
1172	510	472	148733	1099	0	150814
1173	746	358	989	144677	0	146770
1174	443	147209	562	1140	0	149354
1175	611	780	359	148046	0	149796
1176	146769	367	307	1582	0	149025
1177	1216	275	281	144117	0	145889
1178	639	141672	362	1102	0	143775
1179	461	144864	335	717	0	146377
1180	138683	1011	267	1122	0	141083
1181	1074	638	146222	371	0	148305
1182	984	384	905	143310	0	145583
1183	755	238	448	150170	0	151611
1184	500	269	152259	1241	0	154269
1185	355	151824	997	905	0	154081
1186	387	966	153180	499	0	155032
1187	549	715	1006	149604	0	151874
1188	291	156564	577	874	0	158306
1189	158811	737	357	1271	0	161176
1190	829	158389	334	487	0	160039
1191	428	161186	271	457	0	162342
1192	163557	846	288	1078	0	165769
1193	166448	392	238	1173	0	168251
1194	170081	254	188	1071	0	171594
1195	1247	179	233	171786	0	173445
1196	549	246	171450	765	0	173010
1197	166055	117	817	1369	0	168358
1198	178448	140	356	980	0	179924
1199	1720	136	278	186925	0	189059
1200	620	324	187701	1257	0	189902
1201	388	187089	1315	553	0	189345
1202	186297	1240	373	1197	0	189107
1203	193722	343	246	1550	0	195861
1204	1570	196907	308	308	0	199093
1205	611	203381	272	294	0	204558
1206	202795	1504	158	1195	0	205652
1207	201357	487	159	1158	0	203161
1208	199263	318	123	934	0	200638
1209	2102	207	138	199167	0	201614
1210	692	366	202594	1367	0	205019
1211	1032	250	1301	195480	0	198063
1212	462	278	199797	1486	0	202023
1213	363	194651	1478	632	0	197124
1214	311	198847	500	392	0	200050
1215	925	1342	282	186873	0	189422
1216	690	316	184	191254	0	192444
1217	881	273	199	186858	0	188211
1218	315	192309	233	1479	0	194336
1219	190013	1248	193	1476	0	192930
1220	187540	426	229	1511	0	189706
1221	1443	193533	264	444	0	195684
1222	994	1360	148	186731	0	189233
1223	545	189365	192	1234	0	191336
1224	832	1496	122	188271	0	190721
1225	491	190584	184	1292	0	192551
1226	189266	1427	190	1480	0	192363
1227	1843	519	155	187514	0	190031
1228	660	468	186260	1425	0	188813
1229	178521	280	1287	1723	0	181811
1230	183266	312	425	1626	0	185629
1231	1495	488	183825	537	0	186345
1232	1056	369	1312	182250	0	184987
1233	465	574	186192	1489	0	188720
1234	815	460	1302	184578	0	187155
1235	410	685	177176	1562	0	179833
1236	165839	405	1317	1475	0	169036
1237	1734	457	355	173668	0	176214
1238	575	174954	382	1545	0	177456
1239	178825	1595	189	1489	0	182098
1240	2079	632	236	180710	0	183657
1241	1057	539	215	179767	0	181578
1242	634	615	178334	1974	0	181557
1243	1154	497	1512	183175	0	186338
1244	550	570	190612	2470	0	194202
1245	718	621	191394	901	0	193634
1246	1236	405	2840	199488	0	203969
1247	648	483	216830	2819	0	220780
1248	211293	366	3688	2204	0	217551
1249	249316	397	1180	2032	0	252925
1250	262253	417	779	2030	0	265479
1251	7228	276353	753	881	0	285215
1252	4732	5764	648	275011	0	286155
1253	3365	2426	585	268931	0	275307
1254	1273	284256	795	7280	0	293604
1255	281466	6304	601	4465	0	292836
1256	7738	2628	521	281068	0	291955
1257	3017	1856	286625	6973	0	298471
1258	2106	1401	275512	3226	0	282245
1259	1302	276319	8130	2479	0	288230
1260	275854	6173	3505	2957	0	288489
1261	6763	2765	276901	1407	0	287836
1262	257585	1664	7223	2793	0	269265
1263	7584	259523	3479	1578	0	272164
1264	3490	6505	263031	1095	0	274121
1265	2457	3044	253723	1358	0	260582
1266	1754	2011	264013	1432	0	269210
1267	1554	256159	9615	1354	0	268682
1268	1801	6886	259390	926	0	269003
1269	249512	2716	8205	1827	0	262260
1270	8565	2090	4071	240594	0	255320
1271	4530	1474	2875	257712	0	266591
1272	3561	1373	1950	261669	0	268553
1273	3162	1303	1459	263152	0	269076
1274	1848	1321	258732	9994	0	271895
1275	2872	956	6946	255853	0	266627
1276	2869	1138	3200	262571	0	269778
1277	253636	1077	2653	10703	0	268069
1278	260110	901	2467	5922	0	269400
1279	244916	1071	2307	5367	0	253661
1280	9481	1476	253581	2501	0	267039
1281	4677	253966	7294	2356	0	268293
1282	3234	268952	3754	2127	0	278067
1283	248440	8774	2580	3558	0	263352
1284	7168	261764	2122	2211	0	273265
1285	4844	8400	2058	255842	0	271144
1286	3893	3850	1901	264081	0	273725
1287	2032	2851	258798	9632	0	273313
1288	1783	252712	8119	5059	0	267673
1289	1773	7732	249771	3594	0	262870
1290	238981	3417	8605	4112	0	255115
1291	254843	2340	4358	3036	0	264577
1292	10620	1702	3120	249139	0	264581
1293	5582	1581	2633	247120	0	256916
1294	3830	1452	2698	248446	0	256426
1295	3377	1783	2207	250760	0	258127
1296	2310	1568	244255	11679	0	259812
1297	3395	1986	7504	239026	0	251911
1298	1986	1308	239461	9972	0	252727
1299	1856	1011	229567	5779	0	238213
1300	1489	229277	9676	4354	0	244796
1301	226986	6696	5248	4160	0	243090
1302	6803	235452	3500	3033	0	248788
1303	4634	7912	2755	224133	0	239434
1304	2969	3736	234617	7901	0	249223
1305	223702	2538	7889	5270	0	239399
1306	8077	1786	231075	3774	0	244712
1307	229098	1615	9041	3611	0	243365
1308	235076	1449	4632	3193	0	244350
1309	11535	1565	3582	234901	0	251583
1310	6579	1594	3002	234127	0	245302
1311	4950	1603	2904	238297	0	247754
1312	3387	1950	228842	11766	0	245945
1313	221085	2059	8540	6822	0	238506
1314	8887	225885	4392	4922	0	244086
1315	5862	7832	3393	227457	0	244544
1316	227964	4034	2869	10432	0	245299
1317	233528	2960	3135	6096	0	245719
1318	236460	2450	2693	4923	0	246526
1319	13756	2533	223736	3709	0	243734
1320	230217	2503	8817	4295	0	245832
1321	234345	3018	4631	4742	0	246736
1322	12818	2371	207787	5416	0	228392
1323	7046	2402	235336	4523	0	249307
1324	6126	2440	11684	230207	0	250457
1325	4670	1772	236580	10064	0	253086
1326	3303	221546	13066	5953	0	243868
1327	3415	236489	8435	3565	0	251904
1328	224738	10959	5961	3683	0	245341
1329	10229	235428	4498	2943	0	253098
1330	7463	9942	4375	232067	0	253847
1331	222691	5174	4342	10268	0	242475
1332	10269	234082	3862	5709	0	253922
1333	5893	10034	4281	231706	0	251914
1334	4947	4505	4886	238522	0	252860
1335	3798	3354	231408	13035	0	251595
1336	4137	2755	10819	231805	0	249516
1337	3557	2802	231003	12839	0	250201
1338	3928	1617	231451	7968	0	244964
1339	4741	1754	11362	223090	0	240947
1340	3925	1941	5727	230715	0	242308
1341	220854	1683	3930	15197	0	241664
1342	9550	235555	3681	8809	0	257595
1343	6140	8564	2987	228919	0	246610
1344	5447	6456	2941	231344	0	246188
1345	217110	2899	2002	14206	0	236217
1346	10351	208632	2036	7855	0	228874
1347	5860	195477	1962	4888	0	208187
1348	3796	183112	2063	3431	0	192402
1349	1866	157414	1551	1925	0	162756
1350	125002	5322	5612	1686	0	137622
1351	122420	1802	1386	1471	0	127079
1352	119296	1140	665	1299	0	122400
1353	119765	862	525	1205	0	122357
1354	5502	773	562	115173	0	122010
1355	2149	861	114033	3948	0	120991
1356	1429	112697	3734	1692	0	119552
1357	1572	3777	1397	110619	0	117365
1358	1147	1330	111683	3938	0	118098
1359	1622	1053	3747	109593	0	116015
1360	1497	828	1360	112153	0	115838
1361	961	834	110109	4908	0	116812
1362	1381	805	3847	109421	0	115454
1363	1845	899	1741	104572	0	109057
1364	109665	689	1059	5381	0	116794
1365	109805	649	948	2608	0	114010
1366	109652	587	742	1966	0	112947
1367	109941	677	684	1693	0	112995
1368	5606	635	774	105507	0	112522
1369	2667	718	757	107861	0	112003
1370	2045	807	714	108756	0	112322
1371	104687	755	754	5780	0	111976
1372	4862	702	730	105626	0	111920
1373	2587	681	748	107520	0	111536
1374	1886	719	101616	5456	0	109677
1375	1981	912	3747	99139	0	105779
1376	1505	96528	1573	4821	0	104427
1377	1408	103791	1023	2465	0	108687
1378	98032	4090	794	1952	0	104868
1379	4417	1595	96987	1573	0	104572
1380	1989	92805	3380	1415	0	99589
1381	90939	3343	1673	1466	0	97421
1382	4251	1269	973	90836	0	97329
1383	1640	1048	90578	4118	0	97384
1384	1685	1167	3383	87435	0	93670
1385	1223	91591	1361	4225	0	98400
1386	89717	3374	1093	2260	0	96444
1387	3635	92762	890	1726	0	99013
1388	91886	3716	750	1602	0	97954
1389	94768	1398	699	1577	0	98442
1390	4807	1120	614	92298	0	98839
1391	2286	947	600	90843	0	94676
1392	1518	91437	650	4465	0	98070
1393	92031	3438	597	2425	0	98491
1394	3947	1452	90987	1661	0	98047
1395	88629	1075	3149	1590	0	94443
1396	89417	780	1107	1560	0	92864
1397	4907	683	84889	1386	0	91865
1398	2120	1121	3024	81665	0	87930
1399	82627	684	1129	4066	0	88506
1400	3779	720	81889	1813	0	88201
1401	1651	724	79025	1405	0	82805
1402	72404	578	3560	1435	0	77977
1403	3300	72817	1467	1135	0	78719
1404	1395	68521	851	957	0	71724
1405	1594	3185	852	65811	0	71442
1406	1033	1356	65755	2737	0	70881
1407	62388	872	2583	1435	0	67278
1408	2905	665	64516	996	0	69082
1409	1328	59037	2497	696	0	63558
1410	58795	2495	1101	882	0	63273
1411	2770	1004	691	58749	0	63214
1412	59070	709	523	2904	0	63206
1413	3020	536	58133	1298	0	62987
1414	1526	551	2357	56017	0	60451
1415	1021	58619	995	2304	0	62939
1416	1035	2512	646	57989	0	62182
1417	1029	1283	532	59965	0	62809
1418	1023	859	58508	2995	0	63385
1419	1034	55893	2340	1480	0	60747
1420	1003	57333	1032	1048	0	60416
1421	990	2270	54177	763	0	58200
1422	49683	973	2289	843	0	53788
1423	52088	607	995	856	0	54546
1424	2917	573	784	49791	0	54065
1425	48194	380	599	2260	0	51433
1426	2302	45275	650	1066	0	49293
1427	1018	48498	531	911	0	50958
1428	47961	2124	544	920	0	51549
1429	2377	1037	569	47722	0	51705
1430	48914	508	528	2332	0	52282
1431	50305	387	455	1239	0	52386
1432	2772	477	406	47348	0	51003
1433	1382	570	47103	2073	0	51128
1434	46544	529	1847	1004	0	49924
1435	48337	397	785	714	0	50233
1436	2841	386	607	45899	0	49733
1437	1365	46185	477	2071	0	50098
1438	1109	1926	416	46655	0	50106
1439	890	745	45991	2305	0	49931
1440	724	629	45606	1124	0	48083
1441	710	45101	2186	980	0	48977
1442	1169	1056	615	27962	0	30802
1443	312	283	299	28705	0	29599
1444	279	206	28346	847	0	29678
1445	26893	179	744	447	0	28263
1446	28804	153	311	356	0	29624
1447	28589	139	235	319	0	29282
1448	28939	143	195	308	0	29585
1449	1037	27798	185	233	0	29253
1450	446	29143	184	223	0	29996
1451	29448	863	176	294	0	30781
1452	955	359	196	30097	0	31607
1453	477	234	190	30429	0	31330
1454	325	30593	175	962	0	32055
1455	358	829	146	30851	0	32184
1456	360	309	143	30341	0	31153
1457	264	30322	171	1026	0	31783
1458	328	859	30109	438	0	31734
1459	345	356	785	30180	0	31666
1460	30238	247	307	1000	0	31792
1461	30257	214	192	508	0	31171
1462	1117	198	29302	280	0	30897
1463	533	189	28773	279	0	29774
1464	401	210	29253	226	0	30090
1465	420	257	981	28364	0	30022
1466	302	165	28912	873	0	30252
1467	261	186	28755	411	0	29613
1468	387	439	987	27581	0	29394
1469	259	29653	425	854	0	31191
1470	281	737	30076	407	0	31501
1471	241	30462	829	301	0	31833
1472	29623	841	421	349	0	31234
1473	759	30388	268	253	0	31668
1474	456	785	216	29947	0	31404
1475	30010	291	219	876	0	31396
1476	855	212	226	29784	0	31077
1477	444	172	215	30437	0	31268
1478	267	190	30836	933	0	32226
1479	258	29247	780	472	0	30757
1480	228	30635	368	321	0	31552
1481	299	834	294	29095	0	30522
1482	273	285	206	29337	0	30101
1483	267	210	162	28763	0	29402
1484	160	166	27960	842	0	29128
1485	155	175	26148	349	0	26827
1486	24338	130	654	369	0	25491
1487	544	123	25564	171	0	26402
1488	204	114	25550	168	0	26036
1489	137	24945	612	143	0	25837
1490	265	538	251	24940	0	25994
1491	97	165	25460	536	0	26258
1492	182	110	533	24225	0	25050
1493	96	125	26059	554	0	26834
1494	160	101	541	25808	0	26610
1495	104	90	28004	600	0	28798
1496	173	72	545	27450	0	28240
1497	135	81	227	27669	0	28112
1498	69	28791	203	609	0	29672
1499	140	483	181	28862	0	29666
1500	104	29601	140	573	0	30418
1501	138	510	187	30063	0	30898
1502	117	198	178	30343	0	30836
1503	29561	159	150	769	0	30639
1504	532	123	134	29563	0	30352
1505	164	92	29526	652	0	30434
1506	194	95	542	29056	0	29887
1507	168	95	234	29663	0	30160
1508	81	102	29229	762	0	30174
1509	97	119	28700	344	0	29260
1510	190	113	626	28288	0	29217
1511	148	105	237	29506	0	29996
1512	86	133	29424	731	0	30374
1513	72	28153	574	448	0	29247
1514	55	29596	255	313	0	30219
1515	28934	584	187	384	0	30089
1516	566	239	161	29648	0	30614
1517	30330	137	158	802	0	31427
1518	29707	116	204	471	0	30498
1519	551	30362	211	288	0	31412
1520	30508	499	142	391	0	31540
1521	30682	185	178	352	0	31397
1522	607	148	30378	226	0	31359
1523	290	162	585	30288	0	31325
1524	176	117	31548	660	0	32501
1525	193	160	634	31451	0	32438
1526	104	98	31890	682	0	32774
1527	100	30270	638	314	0	31322
1528	76	31472	287	253	0	32088
1529	285	643	216	30170	0	31314
1530	29811	192	175	653	0	30831
1531	531	144	141	29907	0	30723
1532	276	104	124	29986	0	30490
1533	136	129	30556	660	0	31481
1534	136	99	30190	318	0	30743
1535	132	104	30748	239	0	31223
1536	164	90	659	30178	0	31091
1537	143	102	255	29922	0	30422
1538	87	30365	250	624	0	31326
1539	85	31886	205	359	0	32535
1540	30994	562	183	399	0	32138
1541	427	31588	182	279	0	32476
1542	164	591	31215	231	0	32201
1543	206	200	541	30578	0	31525
1544	130	165	32495	607	0	33397
1545	67	32823	595	336	0	33821
1546	188	598	243	33025	0	34054
1547	31718	163	222	754	0	32857
1548	453	151	32458	283	0	33345
1549	148	32833	548	273	0	33802
1550	134	456	32674	256	0	33520
1551	87	32573	531	212	0	33403
1552	207	607	244	30795	0	31853
1553	31286	192	182	577	0	32237
1554	30836	141	118	316	0	31411
1555	401	31086	141	212	0	31840
1556	31264	365	127	298	0	32054
1557	452	137	134	31328	0	32051
1558	31406	133	151	590	0	32280
1559	430	142	32281	236	0	33089
1560	183	108	32038	234	0	32563
1561	283	112	550	30935	0	31880
1562	187	122	233	33553	0	34095
1563	120	140	33344	584	0	34188
1564	214	113	482	33032	0	33841
1565	33204	117	201	752	0	34274
1566	33123	94	167	420	0	33804
1567	601	32326	159	242	0	33328
1568	231	32657	167	160	0	33215
1569	31372	542	143	296	0	32353
1570	615	183	141	30858	0	31797
1571	30551	132	134	682	0	31499
1572	490	30483	174	240	0	31387
1573	30185	453	138	342	0	31118
1574	558	184	29683	159	0	30584
1575	217	178	29548	156	0	30099
1576	273	219	552	29599	0	30643
1577	128	158	30652	519	0	31457
1578	233	97	503	29271	0	30104
1579	257	102	191	28467	0	29017
1580	145	111	31205	556	0	32017
1581	223	129	531	30876	0	31759
1582	276	108	196	32678	0	33258
1583	140	98	33704	672	0	34614
1584	145	115	33470	282	0	34012
1585	32293	94	658	389	0	33434
1586	625	96	34563	169	0	35453
1587	35862	94	783	319	0	37058
1588	39434	66	261	299	0	40060
1589	1034	99	40261	148	0	41542
1590	384	102	41476	136	0	42098
1591	456	131	1190	39110	0	40887
1592	353	76	473	38699	0	39601
1593	157	39307	332	1045	0	40841
1594	155	40804	264	508	0	41731
1595	134	1067	39112	290	0	40603
1596	37437	371	993	359	0	39160
1597	39057	204	432	300	0	39993
1598	1153	141	38243	182	0	39719
1599	465	109	38291	189	0	39054
1600	462	127	1153	36297	0	38039
1601	231	38142	521	847	0	39741
1602	381	896	334	38469	0	40080
1603	341	294	270	39447	0	40352
1604	39073	179	221	1265	0	40738
1605	39185	136	181	622	0	40124
1606	1306	116	179	39555	0	41156
1607	495	137	39648	1015	0	41295
1608	37580	133	954	599	0	39266
1609	1011	40386	420	312	0	42129
1610	40618	885	292	409	0	42204
1611	39873	281	223	389	0	40766
1612	1126	40242	249	194	0	41811
1613	487	41602	220	222	0	42531
1614	447	1134	187	40623	0	42391
1615	411	443	188	41006	0	42048
1616	211	40761	191	1167	0	42330
1617	382	969	149	40492	0	41992
1618	371	375	191	41318	0	42255
1619	223	272	40312	1296	0	42103
1620	39280	177	1013	720	0	41190
1621	41050	161	443	514	0	42168
1622	41839	111	315	411	0	42676
1623	1537	161	235	40458	0	42391
1624	39842	102	235	1147	0	41326
1625	1231	39465	205	443	0	41344
1626	674	973	217	37302	0	39166
1627	404	38202	248	945	0	39799
1628	327	40655	220	377	0	41579
1629	40121	1089	251	475	0	41936
1630	40514	448	224	390	0	41576
1631	40176	282	186	330	0	40974
1632	40103	235	164	346	0	40848
1633	40004	191	185	324	0	40704
1634	1464	211	39855	207	0	41737
1635	39089	190	909	349	0	40537
1636	1308	193	40752	179	0	42432
1637	39084	149	1069	369	0	40671
1638	40371	103	488	350	0	41312
1639	39766	142	391	332	0	40631
1640	1427	168	41177	279	0	43051
1641	818	261	957	39890	0	41926
1642	517	42896	449	881	0	44743
1643	43614	907	328	500	0	45349
1644	43224	409	273	405	0	44311
1645	1391	43562	270	381	0	45604
1646	44717	953	240	356	0	46266
1647	1413	419	279	43332	0	45443
1648	616	44910	277	959	0	46762
1649	45032	991	221	565	0	46809
1650	45531	417	248	465	0	46661
1651	1524	329	258	44928	0	47039
1652	45657	257	314	1168	0	47396
1653	1464	188	333	45864	0	47849
1654	818	229	297	46497	0	47841
1655	680	240	45788	1389	0	48097
1656	722	276	1027	45090	0	47115
1657	650	277	478	46141	0	47546
1658	542	269	45888	1348	0	48047
1659	478	279	44786	583	0	46126
1660	576	211	1186	45186	0	47159
1661	439	230	45763	1106	0	47538
1662	42541	230	1068	640	0	44479
1663	1082	46561	499	429	0	48571
1664	617	900	275	47167	0	48959
1665	512	394	240	48270	0	49416
1666	566	248	185	48103	0	49102
1667	48360	220	168	1435	0	50183
1668	48294	184	206	770	0	49454
1669	48727	180	167	574	0	49648
1670	1384	48637	166	431	0	50618
1671	883	884	119	49470	0	51356
1672	680	383	123	50306	0	51492
1673	49997	306	113	1286	0	51702
1674	50154	319	91	670	0	51234
1675	1414	304	114	49687	0	51519
1676	678	302	49550	1055	0	51585
1677	48993	296	806	719	0	50814
1678	50755	217	300	595	0	51867
1679	1357	232	51149	401	0	53139
1680	47674	156	809	505	0	49144
1681	1229	150	51147	292	0	52818
1682	50126	101	859	429	0	51515
1683	1227	539	421	51907	0	54094
1684	697	55917	267	843	0	57724
1685	565	746	58299	394	0	60004
1686	457	57738	909	327	0	59431
1687	328	54791	303	279	0	55701
1688	57230	801	442	621	0	59094
1689	672	220	113	57259	0	58264
1690	277	61	44	56362	0	56744
1691	59677	57	70	804	0	60608
1692	562	36	73	60778	0	61449
1693	287	63	58	60745	0	61153
1694	234	54	50	60979	0	61317
1695	239	46	45	60231	0	60561
1696	103	84	61186	592	0	61965
1697	125	91	59234	221	0	59671
1698	96	60561	511	164	0	61332
1699	62632	429	135	413	0	63609
1700	572	143	67	63781	0	64563
1701	225	64947	90	542	0	65804
1702	253	462	42	68708	0	69465
1703	224	141	87	68999	0	69451
1704	255	99	57	68722	0	69133
1705	217	85	58	70155	0	70515
1706	242	69	49	70255	0	70615
1707	102	69968	90	679	0	70839
1708	182	483	59	70939	0	71663
1709	121	187	69779	596	0	70683
1710	121	69978	470	307	0	70876
1711	207	491	128	70654	0	71480
1712	220	173	82	70388	0	70863
1713	107	69274	91	669	0	70141
1714	86	70727	91	332	0	71236
1715	69573	594	66	478	0	70711
1716	404	69485	123	255	0	70267
1717	69396	433	75	477	0	70381
1718	68813	138	130	460	0	69541
1719	511	150	73917	157	0	74735
1720	429	154	421	69898	0	70902
1721	124	141	74991	484	0	75740
1722	122	76124	461	390	0	77097
1723	521	618	168	70085	0	71392
1724	252	222	66	76187	0	76727
1725	248	105	59	76967	0	77379
1726	220	120	59	78023	0	78422
1727	93	123	79916	756	0	80888
1728	259	96	510	78675	0	79540
1729	112	142	80494	659	0	81407
1730	157	146	78446	293	0	79042
1731	75522	108	727	618	0	76975
1732	78791	79	3123	528	0	82521
1733	82373	80	134	526	0	83113
1734	619	81457	140	209	0	82425
1735	332	562	64	82853	0	83811
1736	178	226	86164	625	0	87193
1737	358	136	560	84413	0	85467
1738	208	173	89753	676	0	90810
1739	87644	116	620	722	0	89102
1740	89063	88	231	504	0	89886
1741	88910	74	160	524	0	89668
1742	743	136	86378	157	0	87414
1743	326	158	85879	153	0	86516
1744	389	121	629	89200	0	90339
1745	503	97	274	85615	0	86489
1746	249	64	117	91986	0	92416
1747	147	122	92191	720	0	93180
1748	223	170	84420	345	0	85158
1749	88225	76	701	556	0	89558
1750	657	71	259	94657	0	95644
1751	389	60	190	94991	0	95630
1752	97302	57	140	1110	0	98609
1753	721	65	135	97268	0	98189
1754	105768	68	144	1385	0	107365
1755	110037	51	131	1071	0	111290
1756	109470	85	126	929	0	110610
1757	737	128	113295	269	0	114429
1758	261	112851	602	393	0	114107
1759	118097	513	221	730	0	119561
1760	815	151	164	119015	0	120145
1761	508	71	147	118193	0	118919
1762	227	119372	163	750	0	120512
1763	119020	541	110	765	0	120436
1764	118199	162	152	785	0	119298
1765	119920	137	129	738	0	120924
1766	777	122309	176	255	0	123517
1767	129217	566	106	959	0	130848
1768	129742	185	113	836	0	130876
1769	130673	125	148	669	0	131615
1770	997	84	133	129365	0	130579
1771	483	100	99	130781	0	131463
1772	327	186	134608	823	0	135944
1773	618	130	592	129489	0	130829
1774	627	91	185	130992	0	131895
1775	278	181	135158	805	0	136422
1776	127464	85	579	822	0	128950
1777	135414	87	170	707	0	136378
1778	986	115	121	134612	0	135834
1779	360	133118	219	629	0	134326
1780	274	134798	174	344	0	135590
1781	452	872	137	134199	0	135660
1782	269	259	131871	648	0	133047
1783	564	321	511	125994	0	127390
1784	193	136	130288	518	0	131135
1785	220	204	129833	211	0	130468
1786	421	59	373	134502	0	135355
1787	136802	49	141	1011	0	138003
1788	133436	45	92	676	0	134249
1789	602	47	92	138384	0	139125
1790	460	65	78	137707	0	138310
1791	300	55	80	139205	0	139640
1792	280	48	86	137792	0	138206
1793	139781	30	103	1145	0	141059
1794	137631	31	91	851	0	138604
1795	137016	44	99	856	0	138015
1796	504	119	138639	143	0	139405
1797	516	41	323	136667	0	137547
1798	356	61	106	141194	0	141717
1799	140336	39	82	1006	0	141463
1800	415	139004	144	260	0	139823
1801	138040	319	80	818	0	139257
1802	137066	132	71	741	0	138010
1803	136410	80	91	747	0	137328
1804	135671	50	96	768	0	136585
1805	728	189	140353	136	0	141406
1806	592	256	131326	173	0	132347
1807	143066	58	666	876	0	144666
1808	147494	37	198	756	0	148485
1809	147037	62	122	701	0	147922
1810	149134	50	89	767	0	150040
1811	1001	219	159193	166	0	160579
1812	419	166401	1419	279	0	168518
1813	825	1555	517	176348	0	179245
1814	186354	596	263	3003	0	190216
1815	189118	316	173	1885	0	191492
1816	200617	152	146	1474	0	202389
1817	203999	111	126	1180	0	205416
1818	206566	79	130	1016	0	207791
1819	200028	125	129	1047	0	201329
1820	5163	386	185277	546	0	191372
1821	2451	267	192328	201	0	195247
1822	2089	208	3542	190125	0	195964
1823	1139	260	197225	2691	0	201315
1824	989	191210	3505	1312	0	197016
1825	988	195664	1670	761	0	199083
1826	1486	3658	945	199145	0	205234
1827	788	1643	207358	2755	0	212544
1828	760	1052	197084	1321	0	200217
1829	196353	525	4350	1711	0	202939
1830	220619	406	2112	1388	0	224525
1831	5836	476	1153	222762	0	230227
1832	226858	452	752	5392	0	233454
1833	6070	403	651	225191	0	232315
1834	3204	241	668	226925	0	231038
1835	1494	308	230300	6212	0	238314
1836	1271	406	220325	2579	0	224581
1837	1809	282	6002	220393	0	228486
1838	1091	394	222140	5197	0	228822
1839	204984	208	5565	3394	0	214151
1840	223650	151	2278	2501	0	228580
1841	6532	226247	1543	1231	0	235553
1842	228667	4622	1096	1944	0	236329
1843	6484	1768	224977	725	0	233954
1844	220762	781	5470	1641	0	228654
1845	228564	396	2262	1775	0	232997
1846	231089	296	1513	1429	0	234327
1847	8788	425	1037	218550	0	228800
1848	3918	223136	1061	4621	0	232736
1849	225699	4989	887	2958	0	234533
1850	228063	1849	988	2080	0	232980
1851	8528	1096	960	226360	0	236944
1852	227143	548	869	6981	0	235541
1853	7657	231031	940	2719	0	242347
1854	4421	5845	750	224876	0	235892
1855	2724	2360	220389	6415	0	231888
1856	199689	1278	6129	4008	0	211104
1857	7428	847	220453	1796	0	230524
1858	4444	750	6833	215054	0	227081
1859	2630	214077	2844	6306	0	225857
1860	2132	234265	1819	2649	0	240865
1861	2952	8288	1293	228809	0	241342
1862	2473	229965	1836	7207	0	241481
1863	3432	8725	1313	297550	0	311020
1864	3662	3144	1245	312678	0	320729
1865	3356	2124	1207	319705	0	326392
1866	303496	1724	922	16498	0	322640
1867	13462	1465	810	303470	0	319207
1868	5131	1503	298034	13845	0	318513
1869	3723	297811	11016	5781	0	318331
1870	297804	10961	3467	4932	0	317164
1871	14410	3627	1984	295006	0	315027
1872	7294	2213	1494	302140	0	313141
1873	5614	1706	1437	308626	0	317383
1874	3568	1822	295283	16144	0	316817
1875	2934	295544	11690	6988	0	317156
1876	294909	11531	4261	5832	0	316533
1877	13732	4355	2747	281462	0	302296
1878	4908	299846	2437	12771	0	319962
1879	297021	12365	2130	7282	0	318798
1880	13028	4784	294677	4451	0	316940
1881	291561	3040	12558	4800	0	311959
1882	14510	2905	298139	2838	0	318392
1883	6354	2823	300316	2940	0	312433
1884	4494	293813	14839	3622	0	316768
1885	5387	12194	5742	280252	0	303575
1886	3436	4626	286624	13324	0	308010
1887	3140	276408	13869	6210	0	299627
1888	4221	12155	5899	266983	0	289258
1889	2748	276842	4154	12756	0	296500
1890	2559	13229	276073	5895	0	297756
1891	4060	5370	13114	271243	0	293787
1892	2700	3963	277173	14437	0	298273
1893	4376	2971	13988	273248	0	294583
1894	4261	2634	6007	284138	0	297040
1895	2973	2609	274780	17211	0	297573
1896	4185	2200	14070	274735	0	295190
1897	263599	2163	6079	17493	0	289334
1898	12697	269230	4459	8260	0	294646
1899	5766	12456	269499	6368	0	294089
1900	265194	4924	13528	6086	0	289732
1901	15219	3734	5732	255210	0	279895
1902	6549	266799	4259	13492	0	291099
1903	270259	12813	3554	7734	0	294360
1904	279352	5399	3271	6306	0	294328
1905	17588	4013	3167	260090	0	284858
1906	8494	3530	2864	269998	0	284886
1907	5946	3040	2782	272446	0	284214
1908	5144	3017	2827	266940	0	277928
1909	4081	255675	3016	19326	0	282098
1910	5414	16985	2872	241045	0	266316
1911	3648	240134	2655	15090	0	261527
1912	3308	240370	2784	8385	0	254847
1913	2647	236624	3076	6468	0	248815
1914	3253	14100	215661	5812	0	238826
1915	2685	221011	11433	5757	0	240886
1916	201353	12361	5295	6256	0	225265
1917	10482	205138	3226	5847	0	224693
1918	5171	11630	2940	186649	0	206390
1919	3692	206202	2984	12626	0	225504
1920	3929	12072	2840	204689	0	223530
1921	4017	5661	3046	213357	0	226081
1922	3268	4718	203338	15207	0	226531
1923	196261	4453	10996	8457	0	220167
1924	203353	4148	4574	7340	0	219415
1925	202307	3866	3686	6862	0	216721
1926	12822	196559	3663	6814	0	219858
1927	6026	11108	3732	191442	0	212308
1928	4221	5327	188947	13660	0	212155
1929	3916	186933	11267	7262	0	209378
1930	4548	11343	4744	155029	0	175664
1931	3488	171708	3541	9436	0	188173
1932	169055	10108	3459	5662	0	188284
1933	172349	5233	3325	4775	0	185682
1934	176097	3925	3432	4445	0	187899
1935	175224	3356	4066	4011	0	186657
1936	12134	3115	3988	166465	0	185702
1937	5887	3287	3738	166891	0	179803
1938	4042	166124	3784	11117	0	185067
1939	4137	9839	2964	169514	0	186454
1940	2979	4865	164237	11849	0	183930
1941	2773	3755	8967	162794	0	178289
1942	2076	4209	159394	11701	0	177380
1943	1964	157196	9495	6908	0	175563
1944	2067	9504	158902	5459	0	175932
1945	2677	4699	10159	157895	0	175430
1946	2269	3493	161680	11390	0	178832
1947	2798	3209	9985	160167	0	176159
1948	3029	3253	4866	164258	0	175406
1949	3275	3046	3578	165263	0	175162
1950	3271	3155	3435	164625	0	174486
1951	153742	3230	2686	12253	0	171911
1952	8353	156337	2490	6826	0	174006
1953	149536	8553	2153	5437	0	165679
1954	8396	4269	143937	4868	0	161470
1955	144343	3178	6930	4825	0	159276
1956	150571	2892	2860	4736	0	161059
1957	10500	3138	143065	4315	0	161018
1958	6296	2622	140655	4163	0	153736
1959	4157	135425	7840	4632	0	152054
1960	2960	129550	3038	4459	0	140007
1961	3458	7385	118029	4660	0	133532
1962	1986	104254	5794	4856	0	116890
1963	2585	3536	1988	49223	0	57332
1964	44732	467	839	1341	0	47379
1965	927	266	176	44983	0	46352
1966	46001	227	126	1098	0	47452
1967	46120	222	127	679	0	47148
1968	1005	47415	164	386	0	48970
1969	47249	712	119	465	0	48545
1970	47573	355	79	404	0	48411
1971	1090	250	100	46526	0	47966
1972	47575	217	96	942	0	48830
1973	815	48411	103	464	0	49793
1974	481	699	72	49014	0	50266
1975	48807	310	98	971	0	50186
1976	782	288	48476	381	0	49927
1977	47853	175	634	392	0	49054
1978	941	295	261	49398	0	50895
1979	398	151	49991	639	0	51179
1980	310	143	47993	321	0	48767
1981	47843	305	897	390	0	49435
1982	49922	71	326	335	0	50654
1983	849	72	186	49589	0	50696
1984	431	79	123	50043	0	50676
1985	370	76	95	50047	0	50588
1986	170	50536	96	779	0	51581
1987	50585	533	79	611	0	51808
1988	588	50807	85	276	0	51756
1989	50367	601	90	416	0	51474
1990	725	296	50111	137	0	51269
1991	510	162	550	50174	0	51396
1992	51733	119	255	842	0	52949
1993	781	105	191	51717	0	52794
1994	448	95	155	51216	0	51914
1995	274	49954	133	820	0	51181
1996	50678	571	108	596	0	51953
1997	646	53035	144	338	0	54163
1998	438	678	85	53775	0	54976
1999	255	363	52740	690	0	54048
2000	46164	191	654	630	0	47639
2001	747	175	51982	239	0	53143
2002	47844	130	713	431	0	49118
2003	802	52474	345	213	0	53834
2004	501	703	197	50654	0	52055
2005	260	52235	181	741	0	53417
2006	52550	791	142	535	0	54018
2007	915	363	89	53038	0	54405
2008	522	195	108	54154	0	54979
2009	300	267	52322	1049	0	53938
2010	48319	185	728	737	0	49969
2011	966	164	304	53313	0	54747
2012	441	182	52299	896	0	53818
2013	319	51744	853	450	0	53366
2014	392	715	356	52460	0	53923
2015	52669	314	229	1147	0	54359
2016	968	211	212	52866	0	54257
2017	445	229	53186	951	0	54811
2018	55800	166	791	718	0	57475
2019	1222	144	349	57191	0	58906
2020	471	213	62949	1159	0	64792
2021	546	119	1281	62750	0	64696
2022	513	130	488	62716	0	63847
2023	289	64319	345	1630	0	66583
2024	63194	1261	258	1010	0	65723
2025	1370	64650	196	509	0	66725
2026	64255	1477	156	633	0	66521
2027	1663	542	182	62773	0	65160
2028	672	64359	164	1343	0	66538
2029	652	1416	133	64223	0	66424
2030	373	571	63125	1554	0	65623
2031	59975	322	1279	869	0	62445
2032	1610	257	467	61462	0	63796
2033	897	208	304	61191	0	62600
2034	667	201	243	62040	0	63151
2035	325	287	60108	2036	0	62756
2036	364	257	59067	946	0	60634
2037	294	59848	1703	672	0	62517
2038	516	1334	602	58598	0	61050
2039	58219	474	358	1797	0	60848
2040	1317	59549	299	751	0	61916
2041	787	1396	206	60575	0	62964
2042	60415	556	237	1946	0	63154
2043	60494	344	244	1016	0	62098
2044	1774	60695	234	611	0	63314
2045	64271	1398	214	785	0	66668
2046	68844	592	172	698	0	70306
2047	2554	440	188	70366	0	73548
2048	980	70563	292	2156	0	73991
2049	1018	1928	235	72428	0	75609
2050	71475	797	233	2687	0	75192
2051	2333	575	71660	1089	0	75657
2052	1437	426	1886	70415	0	74164
2053	1130	425	667	72411	0	74633
2054	658	491	70770	2983	0	74902
2055	917	454	2046	70822	0	74239
2056	70365	368	829	3096	0	74658
2057	65735	352	622	1969	0	68678
2058	2927	317	538	69610	0	73392
2059	1256	271	68837	2862	0	73226
2060	934	310	67216	1553	0	70013
2061	692	65749	2665	1325	0	70431
2062	718	69047	1073	1097	0	71935
2063	1018	2307	660	66385	0	70370
2064	64995	853	589	2710	0	69147
2065	2023	65828	636	1351	0	69838
2066	64420	2095	631	1166	0	68312
2067	2457	942	567	63997	0	67963
2068	1242	759	442	64275	0	66718
2069	61143	639	345	3070	0	65197
2070	2316	62289	345	1462	0	66412
2071	62638	2135	286	1197	0	66256
2072	2593	1001	60238	878	0	64710
2073	1256	684	59464	813	0	62217
2074	1200	624	2387	57550	0	61761
2075	776	559	58671	2416	0	62422
2076	849	553	58160	1156	0	60718
2077	1020	577	2493	54798	0	58888
2078	770	471	56685	2311	0	60237
2079	883	361	2480	54680	0	58404
2080	819	367	1263	55481	0	57930
2081	609	340	55995	2965	0	59909
2082	689	398	2380	54541	0	58008
2083	793	359	1269	53758	0	56179
2084	574	53374	948	3017	0	57913
2085	53315	1910	849	1731	0	57805
2086	2130	831	53302	1381	0	57644
2087	1185	563	2266	52779	0	56793
2088	882	444	1227	54723	0	57276
2089	586	491	52880	3128	0	57085
2090	49871	451	2269	1921	0	54512
2091	2071	51776	1150	1894	0	56891
2092	1170	1967	904	52096	0	56137
2093	842	839	837	52972	0	55490
2094	647	52320	798	3150	0	56915
2095	687	2031	52115	1802	0	56635
2096	624	52714	2279	1377	0	56994
2097	50510	2276	1011	1362	0	55159
2098	2115	1089	50053	1125	0	54382
2099	1192	806	2095	49737	0	53830
2100	855	659	50612	2482	0	54608
2101	693	734	50817	1334	0	53578
2102	668	49856	2626	1159	0	54309
2103	1012	1955	1376	47551	0	51894
2104	47771	903	924	2334	0	51932
2105	48338	656	902	1310	0	51206
2106	2260	48282	879	1121	0	52542
2107	1175	1832	792	48768	0	52567
2108	47870	933	821	2429	0	52053
2109	49315	704	728	1421	0	52168
2110	2355	48835	654	1144	0	52988
2111	50058	1785	622	1034	0	53499
2112	2407	852	651	48315	0	52225
2113	1175	49851	643	2289	0	53958
2114	1084	1864	678	51155	0	54781
2115	1042	954	694	51555	0	54245
2116	1113	1083	626	51543	0	54365
2117	748	647	49742	2730	0	53867
2118	747	589	44487	1333	0	47156
2119	634	44837	1902	1126	0	48499
2120	38207	1321	851	916	0	41295
2121	1254	37945	548	968	0	40715
2122	710	1197	488	37966	0	40361
2123	495	564	39667	1516	0	42242
2124	516	561	1331	38588	0	40996
2125	534	498	748	39592	0	41372
2126	463	526	491	40729	0	42209
2127	39582	490	393	1750	0	42215
2128	1140	413	491	40321	0	42365
2129	484	359	42540	1715	0	45098
2130	40585	287	1322	1221	0	43415
2131	41868	283	730	1019	0	43900
2132	43503	242	505	948	0	45198
2133	43513	285	434	899	0	45131
2134	43685	232	432	769	0	45118
2135	1613	42519	447	679	0	45258
2136	942	973	433	41149	0	43497
2137	813	42230	366	1206	0	44615
2138	42591	1045	259	818	0	44713
2139	42376	454	305	671	0	43806
2140	41187	395	262	621	0	42465
2141	1562	39723	301	490	0	42076
2142	763	39237	281	488	0	40769
2143	636	39938	285	445	0	41304
2144	740	1219	39016	366	0	41341
2145	1087	2194	857	32005	0	36143
2146	294	27884	198	422	0	28798
2147	80	26199	53	72	0	26404
2148	121	135	49	26018	0	26323
2149	84	79	21	25790	0	25974
2150	39	40	26393	196	0	26668
2151	25690	53	152	166	0	26061
2152	215	27	46	27645	0	27933
2153	146	28	35	27609	0	27818
2154	73	45	27699	197	0	28014
2155	74	83	26370	74	0	26601
2156	39	28355	192	56	0	28642
2157	84	190	56	28709	0	29039
2158	85	52	65	28998	0	29200
2159	30	52	28466	229	0	28777
2160	26202	58	163	213	0	26636
2161	28287	67	69	135	0	28558
2162	237	55	29020	72	0	29384
2163	28256	37	182	206	0	28681
2164	247	53	29473	51	0	29824
2165	29244	34	187	140	0	29605
2166	30080	36	71	208	0	30395
2167	281	43	30715	119	0	31158
2168	217	35	233	30608	0	31093
2169	232	43	137	30120	0	30532
2170	133	73	51	32893	0	33150
2171	32696	43	38	478	0	33255
2172	32284	36	34	336	0	32690
2173	352	43	33926	92	0	34413
2174	198	80	32507	74	0	32859
2175	34592	25	350	231	0	35198
2176	35688	32	165	221	0	36106
2177	427	53	35301	82	0	35863
2178	178	62	34922	65	0	35227
2179	252	30	392	35516	0	36190
2180	149	60	36675	345	0	37229
2181	195	41	403	35065	0	35704
2182	37385	23	171	583	0	38162
2183	434	35	39865	216	0	40550
2184	37700	19	506	350	0	38575
2185	577	57	45208	127	0	45969
2186	405	16	599	44442	0	45462
2187	321	27	253	46906	0	47507
2188	311	19	168	47171	0	47669
2189	166	47872	144	764	0	48946
2190	541	623	103	44039	0	45306
2191	346	141	136	48278	0	48901
2192	47771	48	168	924	0	48911
2193	712	70	47271	323	0	48376
2194	44120	32	684	368	0	45204
2195	724	48	47027	142	0	47941
2196	42364	41	637	347	0	43389
2197	721	46760	286	136	0	47903
2198	307	586	46695	93	0	47681
2199	204	172	46252	127	0	46755
2200	479	171	812	41704	0	43166
2201	316	40	216	46258	0	46830
2202	110	50	46852	784	0	47796
2203	148	106	46845	257	0	47356
2204	123	91	51481	188	0	51883
2205	53051	20	831	475	0	54377
2206	54551	33	301	365	0	55250
2207	54884	20	207	283	0	55394
2208	945	31	178	53778	0	54932
2209	424	28	192	54374	0	55018
2210	220	61	57832	810	0	58923
2211	362	72	707	55548	0	56689
2212	490	68	328	53339	0	54225
2213	57065	34	214	1063	0	58376
2214	56507	42	167	548	0	57264
2215	57952	48	140	442	0	58582
2216	935	50	207	57641	0	58833
2217	406	38	215	57757	0	58416
2218	331	42	203	58113	0	58689
2219	57558	31	188	1041	0	58818
2220	895	63	177	56173	0	57308
2221	367	57079	219	682	0	58347
2222	398	606	200	55648	0	56852
2223	223	55246	227	719	0	56415
2224	55244	633	263	473	0	56613
2225	53620	168	210	499	0	54497
2226	782	54826	246	340	0	56194
2227	345	56331	244	282	0	57202
2228	363	766	233	55806	0	57168
2229	261	220	54253	817	0	55551
2230	398	108	774	51993	0	53273
2231	253	124	54357	916	0	55650
2232	258	54283	814	436	0	55791
2233	402	654	318	54746	0	56120
2234	357	198	225	55610	0	56390
2235	252	154	58586	994	0	59986
2236	407	533	802	57007	0	58749
2237	276	147	59972	958	0	61353
2238	58344	102	863	570	0	59879
2239	60540	92	342	508	0	61482
2240	61336	128	246	529	0	62239
2241	1133	146	225	60411	0	61915
2242	536	74	237	61125	0	61972
2243	318	143	62472	1115	0	64048
2244	460	167	863	60057	0	61547
2245	298	61709	404	1054	0	63465
2246	347	755	62979	491	0	64572
2247	297	267	61266	450	0	62280
2248	558	252	927	57326	0	59063
2249	300	157	63313	1007	0	64777
2250	339	196	61999	549	0	63083
2251	58295	141	888	716	0	60040
2252	838	70564	383	417	0	72202
2253	73067	707	260	817	0	74851
2254	73329	230	238	694	0	74491
2255	74645	171	246	654	0	75716
2256	1093	143	246	74309	0	75791
2257	523	152	286	75683	0	76644
2258	348	179	76358	1030	0	77915
2259	485	163	780	73807	0	75235
2260	272	76576	479	943	0	78270
2261	76933	640	390	708	0	78671
2262	762	76926	367	392	0	78447
2263	348	77990	343	354	0	79035
2264	432	799	321	78180	0	79732
2265	355	323	79851	816	0	81345
2266	521	208	795	77634	0	79158
2267	335	174	79557	901	0	80967
2268	311	78635	820	456	0	80222
2269	78793	597	348	672	0	80410
2270	79141	179	267	657	0	80244
2271	80685	145	243	807	0	81880
2272	898	185	86318	355	0	87756
2273	502	235	79948	363	0	81048
2274	85175	129	823	681	0	86808
2275	88522	119	312	656	0	89609
2276	89669	123	254	556	0	90602
2277	978	120	186	88913	0	90197
2278	535	98	178	90282	0	91093
2279	90339	90	184	1111	0	91724
2280	88605	112	163	764	0	89644
2281	834	190	92722	343	0	94089
2282	498	154	88255	256	0	89163
2283	86239	95	451	588	0	87373
2284	526	133	91417	185	0	92261
2285	84264	51	352	474	0	85141
2286	346	97	88522	149	0	89114
2287	273	138	217	85665	0	86293
2288	129	72	92765	160	0	93126
2289	334	88	174	92887	0	93483
2290	217	55	83	95051	0	95406
2291	74	97787	145	259	0	98265
2292	98746	149	49	699	0	99643
2293	210	115	102076	53	0	102454
2294	95246	48	197	559	0	96050
2295	199	104065	138	104	0	104506
2296	109023	163	64	593	0	109843
2297	361	66	52	109228	0	109707
2298	243	59	52	109763	0	110117
2299	104	114698	100	426	0	115328
2300	208	329	59	119677	0	120273
2301	299	121	53	119648	0	120121
2302	253	84	41	121520	0	121898
2303	118588	31	45	1265	0	119929
2304	112002	43	54	796	0	112895
2305	795	133	112207	191	0	113326
2306	299	114156	604	200	0	115259
2307	339	543	184	116970	0	118036
2308	308	189	101	121042	0	121640
2309	140	206	122261	903	0	123510
2310	460	71	746	116650	0	117927
2311	119981	34	228	1443	0	121686
2312	120127	42	174	896	0	121239
2313	121608	99	84	677	0	122468
2314	1394	56	69	123382	0	124901
2315	129911	37	71	1913	0	131932
2316	129842	35	96	1169	0	131142
2317	132384	26	78	887	0	133375
2318	1518	38	65	132199	0	133820
2319	787	33	111	132956	0	133887
2320	609	81	72	133615	0	134377
2321	684	54	73	129535	0	130346
2322	647	49	55	130287	0	131038
2323	301	134	130930	1374	0	132739
2324	289	146	128537	576	0	129548
2325	266	128999	1100	415	0	130780
2326	545	812	324	131526	0	133207
2327	533	234	158	132573	0	133498
2328	500	122	98	133380	0	134100
2329	290	181	132591	1439	0	134501
2330	624	108	984	129457	0	131173
2331	265	164	132374	1296	0	134099
2332	545	66	1027	130327	0	131965
2333	218	187	137210	1379	0	138994
2334	139	136704	1227	861	0	138931
2335	410	1204	386	135654	0	137654
2336	188	380	134509	1355	0	136432
2337	116625	194	1249	1544	0	119612
2338	1146	134814	562	462	0	136984
2339	680	1162	257	136196	0	138295
2340	240	136744	278	1356	0	138618
2341	569	1276	187	135384	0	137416
2342	136818	325	169	2193	0	139505
2343	1529	212	223	135415	0	137379
2344	470	135932	240	1506	0	138148
2345	135480	1212	202	1319	0	138213
2346	1598	402	160	139000	0	141160
2347	828	399	184	140941	0	142352
2348	142218	201	152	3041	0	145612
2349	2230	197	150	153861	0	156438
2350	1528	160	187	189179	0	191054
2351	607	322	192895	5183	0	199007
2352	514	361	188248	1744	0	190867
2353	1401	164	5821	185172	0	192558
2354	418	305	189898	5210	0	195831
2355	431	292	186164	1952	0	188839
2356	173375	148	6463	2391	0	182377
2357	5086	265	188637	957	0	194945
2358	1573	184370	6057	2489	0	194489
2359	2231	4740	2038	184258	0	193267
2360	190014	1332	1371	6223	0	198940
2361	193213	842	1004	2870	0	197929
2362	192297	414	897	2658	0	196266
2363	7109	190788	1028	1275	0	200200
2364	3952	5066	944	188176	0	198138
2365	2852	1624	1009	193592	0	199077
2366	181168	1059	1213	8125	0	191565
2367	190390	596	1047	4021	0	196054
2368	191250	490	949	3135	0	195824
2369	7845	535	190280	1452	0	200112
2370	3453	185527	6119	1589	0	196688
2371	2341	211015	2707	1452	0	217515
2372	3067	7868	2069	198745	0	211749
2373	2910	3479	1196	208820	0	216405
2374	1691	1992	207214	9662	0	220559
2375	199482	1146	7563	5523	0	213714
2376	210907	895	3271	3727	0	218800
2377	11050	1039	2307	204848	0	219244
2378	6370	1071	1279	209212	0	217932
2379	4642	677	982	213262	0	219563
2380	207411	673	809	12204	0	221097
2381	9108	882	200333	5523	0	215846
2382	4692	1005	203602	3662	0	212961
2383	4289	1158	9528	197422	0	212397
2384	2041	1133	201172	8937	0	213283
2385	192367	1038	9051	5595	0	208051
2386	198143	687	4281	4404	0	207515
2387	202371	476	2923	3555	0	209325
2388	11918	189485	2276	2549	0	206228
2389	191862	6870	1867	2848	0	203447
2390	11317	3216	1360	186277	0	202170
2391	6036	2225	1386	189119	0	198766
2392	4720	1141	1488	193477	0	200826
2393	2612	962	183044	12631	0	199249
2394	3484	865	8411	176832	0	189592
2395	2568	179497	4465	10113	0	196643
2396	172866	6776	3416	5935	0	188993
2397	8246	178438	2403	4785	0	193872
2398	4764	8296	175494	3492	0	192046
2399	4135	174680	8168	2886	0	189869
2400	166058	8529	4305	3155	0	182047
2401	8603	168665	3510	2615	0	183393
2402	5478	8764	2727	148684	0	165653
2403	3499	168072	2489	7706	0	181766
2404	165764	8458	2260	5274	0	181756
2405	170114	4011	2244	4191	0	180560
2406	160557	2945	2127	4050	0	169679
2407	11744	2514	163551	2653	0	180462
2408	6505	2316	162915	2447	0	174183
2409	4823	2351	162200	2489	0	171863
2410	157217	2091	10911	2953	0	173172
2411	9789	2189	5640	154376	0	171994
2412	5781	2006	3904	159678	0	171369
2413	4129	2246	154486	10171	0	171032
2414	3892	2094	7800	155487	0	169273
2415	144438	2311	4150	10328	0	161227
2416	8982	145663	3170	5776	0	163591
2417	149246	7590	2546	4171	0	163553
2418	10778	4140	145296	2712	0	162926
2419	148465	3206	8084	2640	0	162395
2420	153130	2381	4549	2556	0	162616
2421	154574	2272	3814	2740	0	163400
2422	12526	1908	145151	2807	0	162392
2423	7927	1679	8212	144455	0	162273
2424	6103	1440	146619	8482	0	162644
2425	5296	1333	9081	146876	0	162586
2426	4083	1498	147838	9843	0	163262
2427	4200	1493	9633	145738	0	161064
2428	3789	1661	5251	152039	0	162740
2429	146231	1349	3873	11381	0	162834
2430	148353	1386	2971	6642	0	159352
2431	152941	1127	2861	4899	0	161828
2432	13101	1106	3010	141141	0	158358
2433	7379	127766	2982	8632	0	146759
2434	5595	141372	2425	5420	0	154812
2435	140617	8154	2196	4534	0	155501
2436	9504	4414	137696	3338	0	154952
2437	139751	2697	8014	3428	0	153890
2438	10096	1927	137341	3041	0	152405
2439	140647	1628	8889	3343	0	154507
2440	130837	1432	4961	4062	0	141292
2441	11372	1237	138464	3231	0	154304
2442	142339	1090	8115	3665	0	155209
2443	144982	1209	4597	3194	0	153982
2444	146111	1444	3571	2804	0	153930
2445	12821	138301	2577	2871	0	156570
2446	7735	8076	2767	134771	0	153349
2447	5221	3771	135721	7847	0	152560
2448	4511	2881	137449	4413	0	149254
2449	4219	120744	8652	3153	0	136768
2450	2360	86464	3914	1414	0	94152
2451	3353	3539	3170	76615	0	86677
2452	75110	2057	1672	3307	0	82146
2453	3708	77406	1224	2248	0	84586
2454	3343	2909	1038	75275	0	82565
2455	2491	77889	987	2994	0	84361
2456	77424	3217	789	2219	0	83649
2457	3940	2358	828	76026	0	83152
2458	2712	1588	75029	3142	0	82471
2459	2044	71937	2758	2367	0	79106
2460	1488	73138	2252	1740	0	78618
2461	1650	3393	1630	66131	0	72804
2462	1378	71287	1174	2297	0	76136
2463	1500	3356	974	70466	0	76296
2464	70288	2329	640	3233	0	76490
2465	71322	1684	740	2277	0	76023
2466	74657	1211	719	1608	0	78195
2467	75119	1203	789	1223	0	78334
2468	4796	1054	72441	1103	0	79394
2469	3173	68796	2285	882	0	75136
2470	2219	69370	1708	836	0	74133
2471	744	54001	439	369	0	55553
2472	469	51757	398	298	0	52922
2473	49725	988	992	299	0	52004
2474	48646	332	203	310	0	49491
2475	50147	209	104	287	0	50747
2476	50662	146	63	301	0	51172
2477	914	177	50599	77	0	51767
2478	53454	102	534	318	0	54408
2479	55566	97	242	252	0	56157
2480	56553	93	149	212	0	57007
2481	1056	109	108	55827	0	57100
2482	620	116	103	56298	0	57137
2483	57157	125	82	883	0	58247
2484	775	142	79	56451	0	57447
2485	392	56359	94	671	0	57516
2486	391	545	58	57678	0	58672
2487	357	277	63	57490	0	58187
2488	256	58827	98	782	0	59963
2489	357	569	65	59651	0	60642
2490	367	297	93	59745	0	60502
2491	59045	182	61	1010	0	60298
2492	687	197	56708	393	0	57985
2493	55210	129	510	475	0	56324
2494	770	157	57124	224	0	58275
2495	484	163	54284	209	0	55140
2496	369	138	56307	161	0	56975
2497	55397	109	785	381	0	56672
2498	684	174	60538	124	0	61520
2499	58823	93	688	413	0	60017
2500	60712	104	329	396	0	61541
2501	61431	121	203	339	0	62094
2502	846	61630	160	165	0	62801
2503	61918	550	117	357	0	62942
2504	770	63164	97	134	0	64165
2505	538	596	109	64128	0	65371
2506	443	314	87	63983	0	64827
2507	264	63583	141	729	0	64717
2508	268	63864	164	427	0	64723
2509	250	65968	149	221	0	66588
2510	65450	743	111	389	0	66693
2511	603	67137	158	178	0	68076
2512	67222	656	82	407	0	68367
2513	740	409	65851	131	0	67131
2514	64962	276	518	389	0	66145
2515	67758	208	249	376	0	68591
2516	912	218	66879	174	0	68183
2517	686	162	552	66138	0	67538
2518	376	181	68400	562	0	69519
2519	452	131	611	67428	0	68622
2520	375	147	337	68178	0	69037
2521	68870	136	209	987	0	70202
2522	68396	146	148	677	0	69367
2523	832	68350	170	294	0	69646
2524	69266	587	120	507	0	70480
2525	866	355	69532	168	0	70921
2526	68105	208	642	461	0	69416
2527	936	213	74050	135	0	75334
2528	629	230	72821	130	0	73810
2529	75053	113	1028	418	0	76612
2530	77718	147	464	464	0	78793
2531	1215	166	80244	140	0	81765
2532	912	147	916	75737	0	77712
2533	598	160	426	80805	0	81989
2534	418	170	79990	1021	0	81599
2535	558	162	882	77511	0	79113
2536	401	75642	546	946	0	77535
2537	465	830	284	82409	0	83988
2538	497	402	230	82048	0	83177
2539	442	315	80149	1079	0	81985
2540	72892	205	865	940	0	74902
2541	79213	185	424	661	0	80483
2542	78727	122	295	614	0	79758
2543	78302	104	275	584	0	79265
2544	1477	77668	333	235	0	79713
2545	1013	739	182	75644	0	77578
2546	668	337	75083	879	0	76967
2547	525	243	73885	508	0	75161
2548	661	287	983	72109	0	74040
2549	345	226	75132	1025	0	76728
2550	72072	123	964	809	0	73968
2551	988	173	494	75348	0	77003
2552	613	130	350	75382	0	76475
2553	473	132	229	75851	0	76685
2554	74320	136	226	1636	0	76318
2555	917	74651	281	701	0	76550
2556	74092	744	216	848	0	75900
2557	74060	318	219	727	0	75324
2558	1197	72716	330	366	0	74609
2559	678	73788	342	266	0	75074
2560	74920	936	302	468	0	76626
2561	1203	379	341	74606	0	76529
2562	801	236	336	73630	0	75003
2563	76878	175	308	1378	0	78739
2564	1214	198	75476	495	0	77383
2565	73636	143	1033	703	0	75515
2566	76239	118	481	718	0	77556
2567	1507	78496	327	331	0	80661
2568	83341	916	218	589	0	85064
2569	82680	424	177	794	0	84075
2570	1687	93068	220	343	0	95318
2571	662	96008	221	230	0	97121
2572	848	2052	136	93653	0	96689
2573	95141	833	143	1984	0	98101
2574	1715	98623	124	705	0	101167
2575	1173	1991	47	99813	0	103024
2576	100807	734	100	2457	0	104098
2577	2260	433	99441	807	0	102941
2578	1455	326	1874	96829	0	100484
2579	549	312	99206	2159	0	102226
2580	93774	157	2232	1196	0	97359
2581	98649	148	902	825	0	100524
2582	2758	225	97974	414	0	101371
2583	1142	96812	2236	334	0	100524
2584	1228	2004	874	97201	0	101307
2585	601	858	98809	2056	0	102324
2586	918	454	2293	96987	0	100652
2587	1012	349	917	99741	0	102019
2588	444	356	98609	3017	0	102426
2589	92600	236	2405	1739	0	96980
2590	98142	221	958	1254	0	100575
2591	3097	291	98657	598	0	102643
2592	1310	98705	2541	568	0	103124
2593	1337	2254	1070	93928	0	98589
2594	738	96100	736	2102	0	99676
2595	593	99638	578	931	0	101740
2596	98153	2952	442	1029	0	102576
2597	2801	1254	364	98220	0	102639
2598	1503	750	325	98156	0	100734
2599	756	581	97593	3148	0	102078
2600	760	448	96825	1403	0	99436
2601	1056	341	3047	95063	0	99507
2602	1072	329	1276	98026	0	100703
2603	598	482	96919	3252	0	101251
2604	650	461	97385	1471	0	99967
2605	968	425	3380	95255	0	100028
2606	96151	464	1457	3340	0	101412
2607	2614	97411	974	1561	0	102560
2608	96628	2705	731	1390	0	101454
2609	3046	96022	681	866	0	100615
2610	1504	99180	564	783	0	102031
2611	95972	3320	509	1113	0	100914
2612	3110	1450	96627	738	0	101925
2613	1784	900	2885	95488	0	101057
2614	1416	736	1325	97190	0	100667
2615	1189	624	906	103902	0	106621
2616	816	661	102307	4028	0	107812
2617	1129	497	3192	101766	0	106584
2618	103097	553	1488	4112	0	109250
2619	3482	560	987	105631	0	110660
2620	1883	481	885	110371	0	113620
2621	108290	532	710	4887	0	114419
2622	107665	489	674	2616	0	111444
2623	4154	106591	762	1605	0	113112
2624	1913	3167	107703	1161	0	113944
2625	1395	1283	105752	1037	0	109467
2626	1216	803	106767	953	0	109739
2627	884	100086	4308	989	0	106267
2628	1461	2962	2164	95923	0	102510
2629	1054	1189	1190	100243	0	103676
2630	98296	805	1039	4259	0	104399
2631	3514	694	851	96741	0	101800
2632	1495	620	96002	3959	0	102076
2633	1360	522	3293	96066	0	101241
2634	1192	486	1516	97923	0	101117
2635	895	576	95540	4557	0	101568
2636	861	93891	3504	2247	0	100503
2637	1236	3074	1598	84635	0	90543
2638	770	93409	1368	3337	0	98884
2639	768	3281	93649	1729	0	99427
2640	91826	1461	3594	1580	0	98461
2641	94344	1042	1688	1435	0	98509
2642	95593	894	1158	1433	0	99078
2643	4565	768	986	91398	0	97717
2644	2059	93052	955	3614	0	99680
2645	92352	3191	980	2109	0	98632
2646	94773	1303	1029	1731	0	98836
2647	94310	900	954	1698	0	97862
2648	4378	755	91507	1537	0	98177
2649	88520	606	3484	1539	0	94149
2650	3891	90488	1631	1285	0	97295
2651	89235	3093	1147	1469	0	94944
2652	3672	90632	1142	1215	0	96661
2653	91331	3460	1035	1274	0	97100
2654	4067	1577	91286	1114	0	98044
2655	90506	1030	3335	1294	0	96165
2656	93967	923	1447	1207	0	97544
2657	79145	966	1249	1868	0	83228
2658	94682	872	932	1131	0	97617
2659	4873	846	90459	1007	0	97185
2660	2863	669	3239	89909	0	96680
2661	89804	651	1542	3676	0	95673
2662	3969	88925	1228	1887	0	96009
2663	2201	2900	1001	87267	0	93369
2664	1528	1295	86513	3579	0	92915
2665	1797	1446	3143	85710	0	92096
2666	1314	789	86118	3711	0	91932
2667	1292	81036	3362	1931	0	87621
2668	1088	75777	1553	1362	0	79780
2669	1179	76077	1025	1195	0	79476
2670	1467	2836	876	62656	0	67835
2671	1207	824	498	62888	0	65417
2672	828	594	61401	2216	0	65039
2673	716	58282	1766	926	0	61690
2674	53554	1566	698	829	0	56647
2675	1612	51581	512	615	0	54320
2676	685	51966	426	574	0	53651
2677	1222	1662	623	49507	0	53014
2678	49052	595	424	1634	0	51705
2679	49735	441	436	793	0	51405
2680	1777	373	369	49183	0	51702
2681	48896	414	332	1655	0	51297
2682	1666	441	312	48749	0	51168
2683	677	404	48012	1686	0	50779
2684	47721	401	1309	838	0	50269
2685	1649	375	587	47749	0	50360
2686	596	363	46245	1375	0	48579
2687	583	392	45518	609	0	47102
2688	617	435	1322	45700	0	48074
2689	46800	388	595	1381	0	49164
2690	46565	395	355	784	0	48099
2691	1483	46922	350	566	0	49321
2692	48791	1149	313	624	0	50877
2693	48991	459	336	619	0	50405
2694	49679	322	311	582	0	50894
2695	1635	50004	312	477	0	52428
2696	50344	1100	300	563	0	52307
2697	51550	441	251	508	0	52750
2698	1712	338	275	50516	0	52841
2699	48905	277	255	1190	0	50627
2700	1361	48095	308	534	0	50298
2701	762	49594	302	372	0	51030
2702	731	1062	285	49332	0	51410
2703	771	465	216	49490	0	50942
2704	614	50231	250	1085	0	52180
2705	49688	977	199	573	0	51437
2706	1217	48293	211	304	0	50025
2707	47655	896	168	348	0	49067
2708	1215	48783	192	291	0	50481
2709	783	926	175	46949	0	48833
2710	611	49658	130	846	0	51245
2711	49768	1049	416	482	0	51715
2712	49308	422	233	434	0	50397
2713	48614	359	218	474	0	49665
2714	1266	331	46903	227	0	48727
2715	550	310	42759	171	0	43790
2716	337	42784	648	237	0	44006
2717	387	671	41905	174	0	43137
2718	325	319	39767	218	0	40629
2719	362	796	499	34121	0	35778
2720	146	106	36338	288	0	36878
2721	88	36914	322	123	0	37447
2722	36514	284	114	227	0	37139
2723	283	36304	91	85	0	36763
2724	130	36865	79	84	0	37158
2725	37589	335	48	204	0	38176
2726	38152	130	60	242	0	38584
2727	343	39557	77	59	0	40036
2728	39790	293	53	224	0	40360
2729	39509	120	69	172	0	39870
2730	39392	119	49	210	0	39770
2731	397	125	38128	45	0	38695
2732	215	125	37277	59	0	37676
2733	254	101	296	38592	0	39243
2734	200	98	123	38596	0	39017
2735	40188	70	83	404	0	40745
2736	328	39419	74	107	0	39928
2737	215	290	67	40599	0	41171
2738	195	155	70	40925	0	41345
2739	206	91	58	41028	0	41383
2740	221	67	54	40737	0	41079
2741	125	96	41296	483	0	42000
2742	173	113	40093	199	0	40578
2743	210	76	434	41672	0	42392
2744	113	97	42676	411	0	43297
2745	40816	54	456	319	0	41645
2746	554	55	173	43454	0	44236
2747	208	75	43604	450	0	44337
2748	39547	37	485	403	0	40472
2749	471	43193	219	131	0	44014
2750	43154	381	96	258	0	43889
2751	466	45305	117	83	0	45971
2752	328	446	83	45184	0	46041
2753	146	192	45447	419	0	46204
2754	224	108	434	42980	0	43746
2755	135	101	43578	455	0	44269
2756	42542	92	449	324	0	43407
2757	555	57	178	45192	0	45982
2758	45569	72	103	681	0	46425
2759	542	88	45041	208	0	45879
2760	46113	50	486	318	0	46967
2761	50393	42	182	311	0	50928
2762	808	79	51985	80	0	52952
2763	509	47	652	50844	0	52052
2764	226	74	53338	602	0	54240
2765	164	53397	677	230	0	54468
2766	53249	628	357	358	0	54592
2767	53183	169	160	325	0	53837
2768	807	118	54333	82	0	55340
2769	312	128	53956	85	0	54481
2770	416	64	755	53219	0	54454
2771	294	58	295	55079	0	55726
2772	55855	76	189	945	0	57065
2773	655	56388	180	276	0	57499
2774	57474	563	111	417	0	58565
2775	57586	169	149	381	0	58285
2776	821	126	56853	115	0	57915
2777	53643	79	643	397	0	54762
2778	777	113	57459	110	0	58459
2779	547	83	675	57751	0	59056
2780	277	124	61559	587	0	62547
2781	392	83	704	60712	0	61891
2782	221	84	62134	642	0	63081
2783	59173	65	738	520	0	60496
2784	61530	37	321	353	0	62241
2785	894	58	241	61564	0	62757
2786	63144	44	200	940	0	64328
2787	875	63	201	64670	0	65809
2788	344	66163	198	699	0	67404
2789	66214	536	177	628	0	67555
2790	747	66189	201	215	0	67352
2791	484	621	138	66965	0	68208
2792	397	207	119	65714	0	66437
2793	397	120	147	64832	0	65496
2794	395	138	140	63958	0	64631
2795	188	153	62779	901	0	64021
2796	55504	110	633	692	0	56939
2797	61248	89	223	475	0	62035
2798	767	62180	194	274	0	63415
2799	452	555	153	62816	0	63976
2800	375	187	155	63240	0	63957
2801	261	165	61602	821	0	62849
2802	58896	102	685	549	0	60232
2803	804	103	267	61954	0	63128
2804	320	138	61367	710	0	62535
2805	60100	76	679	644	0	61499
2806	62619	68	275	550	0	63512
2807	62595	61	224	554	0	63434
2808	887	68	61637	218	0	62810
2809	523	124	57920	181	0	58748
2810	58905	62	682	366	0	60015
2811	798	78	335	61023	0	62234
2812	440	59	205	62234	0	62938
2813	276	88	62245	696	0	63305
2814	59309	63	607	548	0	60527
2815	765	70	259	63385	0	64479
2816	65056	57	207	999	0	66319
2817	65117	50	174	626	0	65967
2818	64976	42	142	565	0	65725
2819	982	120	66961	235	0	68298
2820	598	50	749	66612	0	68009
2821	67537	48	302	1057	0	68944
2822	909	69542	238	400	0	71089
2823	564	734	175	70700	0	72173
2824	469	251	140	70839	0	71699
2825	69955	116	117	1406	0	71594
2826	69350	88	170	735	0	70343
2827	1262	64	157	68843	0	70326
2828	572	82	68098	969	0	69721
2829	65462	104	875	729	0	67170
2830	1106	133	69392	282	0	70913
2831	69062	52	952	554	0	70620
2832	71135	67	376	528	0	72106
2833	1366	87	71302	221	0	72976
2834	795	82	1048	70967	0	72892
2835	435	109	75592	1142	0	77278
2836	387	79924	1310	454	0	82075
2837	609	1445	448	76808	0	79310
2838	298	81567	355	1332	0	83552
2839	607	1617	211	82561	0	84996
2840	308	478	84576	1698	0	87060
2841	272	83535	1758	653	0	86218
2842	252	87710	595	337	0	88894
2843	711	2362	320	87706	0	91099
2844	88376	686	191	2175	0	91428
2845	2294	320	179	97037	0	99830
2846	98187	194	149	2970	0	101500
2847	2430	100885	233	860	0	104408
2848	110348	2385	139	851	0	113723
2849	3032	786	114045	343	0	118206
2850	1708	389	2720	111198	0	116015
2851	1326	243	774	112045	0	114388
2852	472	235	112578	3461	0	116746
2853	106212	216	2844	1698	0	110970
2854	112077	232	842	1189	0	114340
2855	3514	111180	602	517	0	115813
2856	1979	2958	391	103429	0	108757
2857	804	110173	432	2539	0	113948
2858	637	3011	109165	993	0	113806
2859	561	1031	110892	787	0	113271
2860	1159	1335	3473	105623	0	111590
2861	105438	358	1200	3150	0	110146
2862	2828	103854	707	1091	0	108480
2863	104226	2722	469	1030	0	108447
2864	3172	1051	101998	538	0	106759
2865	101431	648	2791	857	0	105727
2866	105530	498	1050	837	0	107915
2867	3722	473	103614	449	0	108258
2868	2064	409	2981	100486	0	105940
2869	102860	391	1090	3282	0	107623
2870	103599	378	720	1501	0	106198
2871	104301	443	531	1021	0	106296
2872	4419	363	569	100853	0	106204
2873	1771	418	100035	2909	0	105133
2874	98067	322	2925	1565	0	102879
2875	3608	381	101830	784	0	106603
2876	2064	346	3197	98855	0	104462
2877	1765	370	1166	99750	0	103051
2878	1103	100782	888	3445	0	106218
2879	1094	2806	99862	1393	0	105155
2880	975	95081	3101	1080	0	100237
2881	939	98942	1365	908	0	102154
2882	1194	3433	963	97002	0	102592
2883	974	1259	97250	3194	0	102677
2884	1370	814	3133	96485	0	101802
2885	977	692	97880	3520	0	103069
2886	1316	646	3369	95699	0	101030
2887	1219	735	1448	96876	0	100278
2888	920	794	92097	4097	0	97908
2889	1123	663	3507	91250	0	96543
2890	881	599	92856	3932	0	98268
2891	892	611	92456	1898	0	95857
2892	888	91025	4069	1452	0	97434
2893	91489	3039	1886	1437	0	97851
2894	3524	1312	91712	1119	0	97667
2895	89486	925	3611	1283	0	95305
2896	3970	723	1749	91905	0	98347
2897	1745	744	91691	3593	0	97773
2898	1201	90346	3755	1852	0	97154
2899	1308	3135	1960	90851	0	97254
2900	1063	1338	91837	3701	0	97939
2901	1468	1033	3723	86250	0	92474
2902	1182	90613	1872	3519	0	97186
2903	91453	3211	1421	1844	0	97929
2904	3944	1365	1258	91560	0	98127
2905	89364	1027	1251	4014	0	95656
2906	91597	883	1174	2159	0	95813
2907	91955	708	1180	1804	0	95647
2908	92931	727	1256	1680	0	96594
2909	91442	688	1137	1598	0	94865
2910	4703	87671	1149	1409	0	94932
2911	2638	3166	1062	88328	0	95194
2912	2061	1399	1034	90159	0	94653
2913	1947	913	1078	90545	0	94483
2914	1670	796	86448	4632	0	93546
2915	1563	85526	3592	2396	0	93077
2916	87054	3106	1785	1810	0	93755
2917	87709	1291	1454	1714	0	92168
2918	4474	84637	1315	1599	0	92025
2919	2069	87393	1301	1586	0	92349
2920	85501	3862	1258	1691	0	92312
2921	3908	1773	83565	1400	0	90646
2922	2202	1473	3705	80584	0	87964
2923	81069	1065	1915	3781	0	87830
2924	4054	1008	1343	78656	0	85061
2925	1912	79480	1259	3820	0	86471
2926	1823	3196	1160	80489	0	86668
2927	1402	1469	80593	3951	0	87415
2928	78372	999	3760	2150	0	85281
2929	83050	917	1751	1724	0	87442
2930	4714	769	1325	79088	0	85896
2931	2669	711	1274	81158	0	85812
2932	77228	830	1091	4251	0	83400
2933	3939	76254	1043	2231	0	83467
2934	2412	2676	1116	74956	0	81160
2935	2064	1117	978	75927	0	80086
2936	68116	678	819	3756	0	73369
2937	3092	68074	927	2019	0	74112
2938	66422	2188	673	1707	0	70990
2939	3212	64569	666	1300	0	69747
2940	1620	66248	690	1243	0	69801
2941	63313	2525	772	1121	0	67731
2942	2603	63727	624	1128	0	68082
2943	1719	3238	1112	59889	0	65958
2944	1124	989	60027	2515	0	64655
2945	720	613	49926	1072	0	52331
2946	555	494	47635	769	0	49453
2947	485	46092	1931	555	0	49063
2948	35220	1048	1655	348	0	38271
2949	1007	367	303	32805	0	34482
2950	460	256	150	33612	0	34478
2951	273	181	32951	1094	0	34499
2952	32589	139	860	620	0	34208
2953	965	142	383	34313	0	35803
2954	516	134	256	34800	0	35706
2955	414	137	159	34856	0	35566
2956	33390	119	141	1404	0	35054
2957	931	120	32814	651	0	34516
2958	32689	94	862	490	0	34135
2959	1091	124	381	33100	0	34696
2960	500	151	33002	929	0	34582
2961	31848	123	857	587	0	33415
2962	1006	164	33506	384	0	35060
2963	601	254	952	32591	0	34398
2964	398	146	33829	925	0	35298
2965	318	129	32842	420	0	33709
2966	30740	126	1121	487	0	32474
2967	883	113	32156	307	0	33459
2968	512	99	1060	31275	0	32946
2969	31529	79	563	940	0	33111
2970	961	121	422	31722	0	33226
2971	491	146	31538	1005	0	33180
2972	396	115	31834	519	0	32864
2973	277	31521	1114	435	0	33347
2974	344	789	603	31063	0	32799
2975	29989	335	412	967	0	31703
2976	832	29775	285	505	0	31397
2977	30004	766	244	482	0	31496
2978	1009	333	228	29636	0	31206
2979	29514	231	226	1027	0	30998
2980	1005	29065	257	499	0	30826
2981	600	766	202	29250	0	30818
2982	29392	354	176	997	0	30919
2983	940	29472	197	559	0	31168
2984	571	838	231	29504	0	31144
2985	453	397	241	29556	0	30647
2986	29627	255	253	1173	0	31308
2987	955	218	223	29800	0	31196
2988	545	168	259	30123	0	31095
2989	448	156	244	30774	0	31622
2990	370	158	28767	1305	0	30600
2991	28109	139	918	815	0	29981
2992	1036	108	450	34087	0	35681
2993	547	157	35559	1240	0	37503
2994	34782	117	1204	792	0	36895
2995	1317	140	36584	529	0	38570
2996	699	144	1364	35096	0	37303
2997	432	36146	645	1287	0	38510
2998	478	1090	429	37060	0	39057
2999	388	446	36940	1516	0	39290
3000	343	327	38099	730	0	39499
3001	438	233	1558	37989	0	40218
3002	356	177	38057	1483	0	40073
3003	36257	173	1489	839	0	38758
3004	1352	213	37607	578	0	39750
3005	714	186	1483	36308	0	38691
3006	589	198	682	37487	0	38956
3007	460	171	565	37675	0	38871
3008	36521	171	392	1989	0	39073
3009	36959	177	378	1082	0	38596
3010	37853	145	335	857	0	39190
3011	1932	142	310	36803	0	39187
3012	952	165	319	37630	0	39066
3013	532	117	35925	1921	0	38495
3014	464	97	36285	977	0	37823
3015	414	35564	1605	726	0	38309
3016	532	1152	683	31761	0	34128
3017	467	297	411	31382	0	32557
3018	304	31861	344	1262	0	33771
3019	31493	885	310	782	0	33470
3020	1047	31849	276	549	0	33721
3021	31659	1027	285	529	0	33500
3022	1276	397	264	31546	0	33483
3023	31619	254	290	1238	0	33401
3024	1296	159	281	31805	0	33541
3025	489	178	31107	1308	0	33082
3026	462	179	1076	31574	0	33291
3027	30767	149	513	1378	0	32807
3028	1187	152	416	31100	0	32855
3029	582	135	268	31526	0	32511
3030	351	197	30697	1540	0	32785
3031	425	111	1007	31247	0	32790
3032	421	127	454	30801	0	31803
3033	372	30202	335	1454	0	32363
3034	469	878	221	31105	0	32673
3035	427	309	244	31876	0	32856
3036	497	193	195	31402	0	32287
3037	252	29337	251	1556	0	31396
3038	356	772	151	28920	0	30199
3039	27390	248	176	1238	0	29052
3040	771	26627	188	664	0	28250
3041	326	25419	133	452	0	26330
3042	220	25625	145	369	0	26359
3043	268	981	192	24093	0	25534
3044	210	23676	343	897	0	25126
3045	260	25216	368	473	0	26317
3046	24502	718	461	475	0	26156
3047	800	318	23996	412	0	25526
3048	23601	310	838	496	0	25245
3049	795	254	397	24324	0	25770
3050	241	231	24105	1057	0	25634
3051	23206	204	1044	659	0	25113
3052	736	188	23318	555	0	24797
3053	321	136	23328	519	0	24304
3054	23427	131	1202	534	0	25294
3055	973	155	745	24058	0	25931
3056	436	147	24302	1142	0	26027
3057	23742	120	1022	870	0	25754
3058	24618	127	438	892	0	26075
3059	1146	123	24470	757	0	26496
3060	25109	106	860	706	0	26781
3061	26024	65	380	656	0	27125
3062	1338	99	24388	647	0	26472
3063	24629	108	886	762	0	26385
3064	25135	100	537	749	0	26521
3065	1075	162	24062	589	0	25888
3066	516	250	26311	531	0	27608
3067	401	279	1151	26357	0	28188
3068	337	322	26489	1285	0	28433
3069	26270	337	951	809	0	28367
3070	1193	394	365	26199	0	28151
3071	756	418	268	26892	0	28334
3072	709	393	25570	1223	0	27895
3073	707	345	860	25629	0	27541
3074	649	234	25824	1308	0	28015
3075	26089	226	979	839	0	28133
3076	26968	210	482	739	0	28399
3077	1266	162	26136	746	0	28310
3078	26195	156	1019	788	0	28158
3079	27325	138	464	812	0	28739
3080	1269	141	26448	850	0	28708
3081	26882	146	1045	901	0	28974
3082	26861	136	523	957	0	28477
3083	1120	163	26692	862	0	28837
3084	26551	238	952	904	0	28645
3085	1077	273	26819	929	0	29098
3086	511	243	986	26927	0	28667
3087	458	226	399	27436	0	28519
3088	444	281	295	28067	0	29087
3089	370	315	26477	1644	0	28806
3090	25008	327	834	991	0	27160
3091	1120	379	25791	663	0	27953
3092	369	20303	664	359	0	21695
3093	249	19539	248	220	0	20256
3094	18673	441	280	211	0	19605
3095	507	175	155	18003	0	18840
3096	250	18273	144	378	0	19045
3097	17612	300	110	212	0	18234
3098	17539	95	118	173	0	17925
3099	427	18069	129	92	0	18717
3100	258	297	92	16657	0	17304
3101	153	17277	122	305	0	17857
3102	17532	318	110	174	0	18134
3103	17723	109	95	152	0	18079
3104	483	63	93	17088	0	17727
3105	17235	53	114	375	0	17777
3106	482	45	89	17187	0	17803
3107	199	58	17088	395	0	17740
3108	16646	65	389	171	0	17271
3109	488	69	16972	88	0	17617
3110	224	58	391	16514	0	17187
3111	16990	49	160	396	0	17595
3112	477	59	95	16988	0	17619
3113	212	43	16955	410	0	17620
3114	188	48	16699	135	0	17070
3115	239	127	408	16650	0	17424
3116	16693	57	229	427	0	17406
3117	421	16957	114	151	0	17643
3118	268	305	84	17058	0	17715
3119	165	102	17166	348	0	17781
3120	16776	58	393	207	0	17434
3121	17801	35	164	165	0	18165
3122	493	56	17295	113	0	17957
3123	17410	34	370	126	0	17940
3124	473	43	156	17918	0	18590
3125	183	44	17805	371	0	18403
3126	17312	52	380	213	0	17957
3127	435	31	161	17402	0	18029
3128	229	56	105	17137	0	17527
3129	17433	38	107	445	0	18023
3130	378	16648	94	171	0	17291
3131	184	17236	98	101	0	17619
3132	17220	333	100	131	0	17784
3133	16748	103	81	158	0	17090
3134	440	45	17190	99	0	17774
3135	207	51	16924	85	0	17267
3136	197	66	353	17059	0	17675
3137	17667	24	177	361	0	18229
3138	17432	30	103	208	0	17773
3139	17756	26	68	183	0	18033
3140	405	17287	92	117	0	17901
3141	207	17814	104	85	0	18210
3142	194	315	79	18349	0	18937
3143	177	106	86	18131	0	18500
3144	214	57	74	18861	0	19206
3145	153	42	19157	423	0	19775
3146	160	72	17536	175	0	17943
3147	18800	54	429	133	0	19416
3148	19821	44	170	157	0	20192
3149	547	39	107	19427	0	20120
3150	298	35	84	19348	0	19765
3151	206	33	71	20164	0	20474
3152	114	56	19582	477	0	20229
3153	131	59	19328	194	0	19712
3154	134	45	376	19307	0	19862
3155	99	40	19725	383	0	20247
3156	84	18972	358	191	0	19605
3157	105	19755	145	122	0	20127
3158	19490	367	111	172	0	20140
3159	364	19309	89	67	0	19829
3160	220	353	74	19391	0	20038
3161	138	112	86	19636	0	19972
3162	103	20708	62	450	0	21323
3163	151	398	62	21061	0	21672
3164	94	159	20641	473	0	21367
3165	83	20519	420	211	0	21233
3166	133	345	118	19115	0	19711
3167	67	109	19154	326	0	19656
3168	51	18872	338	142	0	19403
3169	106	313	124	18312	0	18855
3170	58	19091	84	289	0	19522
3171	121	331	60	19053	0	19565
3172	117	127	56	18500	0	18800
3173	69	18811	59	393	0	19332
3174	18245	321	52	222	0	18840
3175	17923	128	51	193	0	18295
3176	386	17883	70	105	0	18444
3177	154	18458	59	113	0	18784
3178	164	394	52	18392	0	19002
3179	67	160	18183	362	0	18772
3180	17353	95	326	217	0	17991
3181	17793	70	128	178	0	18169
3182	408	74	17678	95	0	18255
3183	17255	73	333	133	0	17794
3184	17933	71	126	139	0	18269
3185	411	77	17607	106	0	18201
3186	16998	70	329	153	0	17550
3187	385	80	18011	89	0	18565
3188	165	18168	363	86	0	18782
3189	18393	343	139	108	0	18983
3190	18558	129	78	123	0	18888
3191	460	107	18380	88	0	19035
3192	18526	96	336	128	0	19086
3193	19456	64	139	175	0	19834
3194	453	75	19225	82	0	19835
3195	19609	73	325	136	0	20143
3196	20206	68	130	154	0	20558
3197	464	83	19893	81	0	20521
3198	20258	83	340	131	0	20812
3199	467	65	147	19704	0	20383
3200	229	79	107	19911	0	20326
3201	140	81	19652	445	0	20318
3202	138	74	19237	197	0	19646
3203	158	90	440	19655	0	20343
3204	177	80	182	20080	0	20519
3205	21129	53	88	467	0	21737
3206	451	64	20745	177	0	21437
3207	21058	66	377	138	0	21639
3208	512	62	152	21869	0	22595
3209	191	87	22351	382	0	23011
3210	23280	56	407	251	0	23994
3211	491	39	164	24732	0	25426
3212	203	55	24878	433	0	25569
3213	24454	54	449	253	0	25210
3214	523	43	185	25133	0	25884
3215	25608	70	128	462	0	26268
3216	498	54	27154	162	0	27868
3217	313	34	440	25472	0	26259
3218	153	28084	191	397	0	28825
3219	28509	416	135	263	0	29323
3220	28000	145	92	222	0	28459
3221	573	29112	115	106	0	29906
3222	29906	412	108	173	0	30599
3223	29586	154	91	173	0	30004
3224	29669	79	103	166	0	30017
3225	684	29304	122	92	0	30202
3226	381	430	69	29592	0	30472
3227	196	178	30244	474	0	31092
3228	267	83	481	29495	0	30326
3229	222	59	216	30016	0	30513
3230	156	61	30216	648	0	31081
3231	158	82	29675	254	0	30169
3232	249	60	606	28344	0	29259
3233	132	30555	248	436	0	31371
3234	30585	460	132	257	0	31434
3235	30155	179	81	207	0	30622
3236	670	31736	96	99	0	32601
3237	32198	474	84	181	0	32937
3238	32086	177	68	221	0	32552
3239	680	116	32322	105	0	33223
3240	31237	100	497	240	0	32074
3241	587	33160	204	151	0	34102
3242	255	443	32569	108	0	33375
3243	213	185	31422	112	0	31932
3244	143	32224	589	113	0	33069
3245	32010	417	229	171	0	32827
3246	507	172	32774	83	0	33536
3247	324	89	441	32460	0	33314
3248	184	87	32889	413	0	33573
3249	30911	75	482	272	0	31740
3250	551	78	40434	144	0	41207
3251	277	103	39519	100	0	39999
3252	39544	54	556	250	0	40404
3253	496	42082	241	93	0	42912
3254	43433	399	144	264	0	44240
3255	44690	163	146	198	0	45197
3256	629	118	103	44303	0	45153
3257	265	49999	101	354	0	50719
3258	50730	377	97	455	0	51659
3259	524	205	51872	94	0	52695
3260	50076	110	408	316	0	50910
3261	478	52722	215	124	0	53539
3262	51900	285	109	230	0	52524
3263	51877	112	113	227	0	52329
3264	426	53366	105	112	0	54009
3265	257	301	95	54428	0	55081
3266	55148	129	104	477	0	55858
3267	423	54850	123	144	0	55540
3268	265	375	80	55410	0	56130
3269	56673	134	119	531	0	57457
3270	507	110	75	58748	0	59440
3271	336	84	66	58246	0	58732
3272	175	59140	120	565	0	60000
3273	59101	468	76	453	0	60098
3274	59846	191	98	339	0	60474
3275	60748	98	69	284	0	61199
3276	691	63148	112	88	0	64039
3277	64228	486	83	349	0	65146
3278	64513	191	76	280	0	65060
3279	791	125	65	63897	0	64878
3280	410	98	69	64197	0	64774
3281	226	112	64335	637	0	65310
3282	326	81	495	62287	0	63189
3283	433	97	186	60707	0	61423
3284	190	125	64269	619	0	65203
3285	56638	103	537	565	0	57843
3286	638	115	64180	131	0	65064
3287	356	154	65139	114	0	65763
3288	360	90	619	65052	0	66121
3289	311	102	218	65976	0	66607
3290	189	67306	163	592	0	68250
3291	67187	510	101	501	0	68299
3292	65898	194	95	390	0	66577
3293	695	67239	134	189	0	68257
3294	326	71404	129	145	0	72004
3295	385	804	69	71691	0	72949
3296	174	74534	138	636	0	75482
3297	74511	800	111	498	0	75920
3298	74297	246	91	426	0	75060
3299	1110	176	114	73703	0	75103
3300	578	114	99	74113	0	74904
3301	74334	82	97	1209	0	75722
3302	887	160	72285	359	0	73691
3303	71037	120	742	471	0	72370
3304	996	165	72188	150	0	73499
3305	71047	70	770	345	0	72232
3306	971	149	230	72453	0	73803
3307	376	136	73810	718	0	75040
3308	325	139	71194	257	0	71915
3309	70265	158	977	467	0	71867
3310	72121	64	302	436	0	72923
3311	854	74401	197	119	0	75571
3312	545	667	108	76881	0	78201
3313	421	218	63	78782	0	79484
3314	78076	125	81	1478	0	79760
3315	961	77938	104	474	0	79477
3316	75941	851	63	602	0	77457
3317	999	75548	115	150	0	76812
3318	340	75962	88	124	0	76514
3319	75287	976	50	499	0	76812
3320	1010	375	74574	103	0	76062
3321	547	206	841	73703	0	75297
3322	434	123	225	74847	0	75629
3323	183	160	75123	1084	0	76550
3324	410	91	869	73247	0	74617
3325	890	128	319	65165	0	66502
3326	155	74909	223	1065	0	76352
3327	74099	889	157	798	0	75943
3328	1003	334	75235	285	0	76857
3329	70514	208	868	576	0	72166
3330	1042	75174	315	198	0	76729
3331	541	890	182	75952	0	77565
3332	78346	267	110	1363	0	80086
3333	1240	181	111	78278	0	79810
3334	602	118	105	78718	0	79543
3335	309	168	78294	1274	0	80045
3336	72572	113	977	943	0	74605
3337	77004	85	302	762	0	78153
3338	1299	152	77346	237	0	79034
3339	728	106	975	76274	0	78083
3340	402	139	77384	1023	0	78948
3341	74181	89	1106	800	0	76176
3342	78437	87	370	650	0	79544
3343	1418	114	237	78017	0	79786
3344	77772	96	146	1482	0	79496
3345	1261	171	82132	423	0	83987
3346	728	87	1010	81028	0	82853
3347	724	97	339	80503	0	81663
3348	482	117	261	83917	0	84777
3349	455	103	173	83592	0	84323
3350	75213	94	142	1877	0	77326
3351	1156	131	74247	636	0	76170
3352	651	73	1025	74838	0	76587
3353	385	131	73784	1249	0	75549
3354	363	122	71982	523	0	72990
3355	439	85	1279	71172	0	72975
3356	386	80	495	72718	0	73679
3357	68041	93	319	1596	0	70049
3358	1249	86	237	68060	0	69632
3359	631	105	184	68026	0	68946
3360	498	77	167	69233	0	69975
3361	67591	81	178	2046	0	69896
3362	68068	89	162	1101	0	69420
3363	68737	89	181	829	0	69836
3364	67041	104	162	665	0	67972
3365	1634	72433	197	434	0	74698
3366	865	1365	154	72456	0	74840
3367	652	468	173	74297	0	75590
3368	75128	263	164	2306	0	77861
3369	1771	79066	207	1038	0	82082
3370	990	1712	120	83101	0	85923
3371	493	626	89026	2135	0	92280
3372	93031	305	2175	1387	0	96898
3373	2791	99705	771	665	0	103932
3374	104173	2744	420	737	0	108074
3375	107903	884	260	636	0	109683
3376	4697	423	197	104389	0	109706
3377	1553	387	105010	3363	0	110313
3378	1494	211	3119	107081	0	111905
3379	108077	215	982	4087	0	113361
3380	4009	157	517	108138	0	112821
3381	108220	172	354	4027	0	112773
3382	3789	107324	307	1548	0	112968
3383	112234	3220	272	1213	0	116939
3384	4501	1016	293	111516	0	117326
3385	2333	536	293	119324	0	122486
3386	119701	408	274	4910	0	125293
3387	120216	330	213	2206	0	122965
3388	121218	330	193	1489	0	123230
3389	121127	301	222	1297	0	122947
3390	121141	221	251	1087	0	122700
3391	5952	249	314	115725	0	122240
3392	2411	378	112756	3899	0	119444
3393	1579	113238	3131	1776	0	119724
3394	110591	3132	1074	1556	0	116353
3395	4221	1087	107102	899	0	113309
3396	105723	697	3193	1060	0	110673
3397	4427	106698	1168	790	0	113083
3398	109462	3188	688	1087	0	114425
3399	4954	1129	445	107698	0	114226
3400	2926	663	375	110474	0	114438
3401	1782	563	108977	4480	0	115802
3402	2331	372	3266	107556	0	113525
3403	1598	445	111243	4189	0	117475
3404	1637	443	111202	1991	0	115273
3405	111594	436	4175	1822	0	118027
3406	117330	484	1624	1615	0	121053
3407	5147	606	112903	1292	0	119948
3408	111879	480	3573	1578	0	117510
3409	116344	492	1420	1490	0	119746
3410	5664	559	111478	1127	0	118828
3411	2919	110606	3556	1193	0	118274
3412	3144	3321	1456	115147	0	123068
3413	119731	1215	982	4165	0	126093
3414	123237	724	764	2341	0	127066
3415	124018	556	808	1716	0	127098
3416	124922	550	794	1587	0	127853
3417	124813	511	965	1340	0	127629
3418	5953	551	120241	1110	0	127855
3419	3535	668	123531	1028	0	128762
3420	3259	854	4157	123376	0	131646
3421	126462	685	1894	4218	0	133259
3422	129135	655	1277	2392	0	133459
3423	129807	664	1165	1965	0	133601
3424	124977	631	1129	2186	0	128923
3425	5962	123653	1228	1806	0	132649
3426	3585	133910	1179	1939	0	140613
3427	134228	3631	1077	2450	0	141386
3428	137038	1480	1049	2162	0	141729
3429	6265	134933	1020	1568	0	143786
3430	138393	3361	915	1864	0	144533
3431	6230	1624	135609	1537	0	145000
3432	4360	969	3608	134097	0	143034
3433	3513	952	135847	3965	0	144277
3434	3521	934	134922	2102	0	141479
3435	3707	706	4336	135922	0	144671
3436	4036	618	1880	140520	0	147054
3437	3767	710	142609	4454	0	151540
3438	3852	738	3826	136928	0	145344
3439	3517	829	1849	144396	0	150591
3440	144377	891	1454	5250	0	151972
3441	145280	854	1523	2730	0	150387
3442	6620	878	1432	143755	0	152685
3443	4008	1093	144090	4212	0	153403
3444	3461	144536	3942	2147	0	154086
3445	143606	3323	2228	2206	0	151363
3446	5702	1453	149879	1774	0	158808
3447	3621	145330	4350	1742	0	155043
3448	2989	154484	2323	1846	0	161642
3449	155871	3628	1883	2140	0	163522
3450	158591	1512	1809	2069	0	163981
3451	6238	994	1802	154736	0	163770
3452	3650	1038	163404	4104	0	172196
3453	3615	794	4381	162201	0	170991
3454	3537	788	2425	165183	0	171933
3455	3564	721	1843	168277	0	174405
3456	166348	706	1685	5392	0	174131
3457	5787	160926	1763	2483	0	170959
3458	3620	171576	1744	1883	0	178823
3459	3391	4016	1537	168813	0	177757
3460	3082	1720	1536	174680	0	181018
3461	172845	1194	1489	5721	0	181249
3462	170006	991	1438	3201	0	175636
3463	172373	851	1217	2586	0	177027
3464	6805	169262	1362	1765	0	179194
3465	166802	2730	1236	1755	0	172523
3466	5563	1610	1278	163879	0	172330
3467	3270	845	161491	3791	0	169397
3468	3079	785	148310	1993	0	154167
3469	147024	441	3373	2234	0	153072
3470	3653	536	148185	1248	0	153622
3471	2172	563	138403	870	0	142008
3472	125139	365	1631	1150	0	128285
3473	1802	305	129891	473	0	132471
3474	790	249	126665	330	0	128034
3475	1083	950	1155	120912	0	124100
3476	518	204	130723	661	0	132106
3477	740	135	786	123225	0	124886
3478	806	142	380	122776	0	124104
3479	363	227	131664	771	0	133025
3480	280	132820	758	493	0	134351
3481	131964	494	422	1053	0	133933
3482	771	309	137092	218	0	138390
3483	398	267	134086	204	0	134955
3484	114930	122	817	939	0	116808
3485	683	152	130895	115	0	131845
3486	285	126396	696	148	0	127525
3487	504	115584	609	195	0	116892
3488	355	530	225	130467	0	131577
3489	432	247	184	127306	0	128169
3490	133171	108	109	1476	0	134864
3491	130895	85	164	965	0	132109
3492	131889	104	109	816	0	132918
3493	951	144	100	132626	0	133821
3494	133718	86	123	1241	0	135168
3495	130339	102	130	1058	0	131629
3496	883	153	133678	209	0	134923
3497	580	216	127038	175	0	128009
3498	287	134016	743	183	0	135229
3499	343	537	303	135748	0	136931
3500	136029	230	215	1155	0	137629
3501	627	134658	239	323	0	135847
3502	458	562	155	137601	0	138776
3503	135542	198	194	1376	0	137310
3504	132427	143	132	1186	0	133888
3505	795	135553	186	346	0	136880
3506	134623	568	118	945	0	136254
3507	133911	255	121	784	0	135071
3508	1142	167	111	134276	0	135696
3509	485	238	136963	611	0	138297
3510	323	132863	694	413	0	134293
3511	198	134788	364	323	0	135673
3512	129495	696	205	812	0	131208
3513	973	355	139	128647	0	130114
3514	390	286	129276	601	0	130553
3515	210	128474	705	320	0	129709
3516	128609	641	271	955	0	130476
3517	128439	272	150	1036	0	129897
3518	940	247	130225	133	0	131545
3519	838	128	673	125162	0	126801
3520	511	109	285	133252	0	134157
3521	265	221	146014	950	0	147450
3522	143882	126	1294	1326	0	146628
3523	181913	102	503	1020	0	183538
3524	4461	160	392	209501	0	214514
3525	1415	214814	477	4681	0	221387
3526	2135	4934	186	223414	0	230669
3527	759	2286	221805	6058	0	230908
3528	216149	1164	5224	3779	0	226316
3529	6789	806	2319	227527	0	237441
3530	2726	934	226137	6464	0	236261
3531	215146	630	5983	4213	0	225972
3532	7386	474	3034	223714	0	234608
3533	4594	360	1845	225419	0	232218
3534	222217	216	1359	9428	0	233220
3535	6597	223460	1402	4347	0	235806
3536	223333	5380	957	3530	0	233200
3537	8658	2438	675	220391	0	232162
3538	221395	1454	554	7932	0	231335
3539	8137	1202	217381	3950	0	230670
3540	4296	217878	5735	2736	0	230645
3541	4146	6000	2689	221500	0	234335
3542	221495	2907	1714	8137	0	234253
3543	7439	220446	1682	3928	0	233495
3544	5715	6401	1485	221822	0	235423
3545	223448	3230	1223	8368	0	236269
3546	220740	1935	1089	5380	0	229144
3547	11129	1604	945	213476	0	227154
3548	5557	1781	210530	8158	0	226026
3549	3934	1549	209452	5111	0	220046
3550	205461	1212	8375	4669	0	219717
3551	8702	205869	4154	3111	0	221836
3552	4915	206658	2833	2838	0	217244
3553	200237	7908	2632	3364	0	214141
3554	8190	206111	2301	2471	0	219073
3555	6329	7776	1865	203046	0	219016
3556	5192	4421	1489	210046	0	221148
3557	206891	3379	1223	10473	0	221966
3558	204089	2764	964	6095	0	213912
3559	206239	2355	797	4649	0	214040
3560	11744	2156	194285	3613	0	211798
3561	8181	1582	6321	195821	0	211905
3562	5554	1458	196628	8346	0	211986
3563	4867	1441	194518	5086	0	205912
3564	4358	1322	201591	3763	0	211034
3565	4616	1522	10713	193475	0	210326
3566	3385	1838	200626	8386	0	214235
3567	3169	2047	203493	4877	0	213586
3568	3694	1734	11101	196505	0	213034
3569	197700	1568	6367	9608	0	215243
3570	8667	1476	200393	5555	0	216091
3571	5927	1374	9382	194075	0	210758
3572	4999	1322	5503	202185	0	214009
3573	4030	1405	200832	11177	0	217444
3574	4758	1547	8462	198355	0	213122
3575	3766	1624	201556	10258	0	217204
3576	4235	1639	9165	195295	0	210334
3577	3924	1684	5389	199334	0	210331
3578	3589	1329	4251	201797	0	210966
3579	3304	1224	3870	201677	0	210075
3580	188667	1089	3860	13943	0	207559
3581	190591	1020	3495	8928	0	204034
3582	10801	1230	185551	6208	0	203790
3583	6177	180712	8559	5774	0	201222
3584	4771	6441	188370	4858	0	204440
3585	4230	3198	188486	4389	0	200303
3586	180992	1837	11594	4598	0	199021
3587	8872	185542	7305	4042	0	205761
3588	187164	7102	5704	4245	0	204215
3589	9252	188972	5349	3591	0	207164
3590	188785	8088	5078	3822	0	205773
3591	194038	4128	4199	3950	0	206315
3592	12172	3063	3661	184594	0	203490
3593	6853	186936	3309	9612	0	206710
3594	5585	7952	2668	190253	0	206458
3595	5092	4068	2768	195315	0	207243
3596	4190	2731	187924	12676	0	207521
3597	3666	187722	8843	7992	0	208223
3598	3826	7681	5301	191238	0	208046
3599	181768	3767	4256	12014	0	201805
3600	193818	2624	3864	7746	0	208052
3601	196522	2082	3627	6077	0	208308
3602	11915	190461	3597	5059	0	211032
3603	195503	8056	3048	4971	0	211578
3604	11601	202503	3100	3898	0	221102
3605	7867	9378	2944	205942	0	226131
3606	5876	4924	204519	9934	0	225253
3607	5503	3430	9444	201457	0	219834
3608	4392	202195	5370	10763	0	222720
3609	4204	9205	3935	204462	0	221806
3610	3812	4980	3141	207463	0	219396
3611	3141	204898	3143	13546	0	224728
3612	205541	9708	2747	8196	0	226192
3613	10630	5354	2416	205662	0	224062
3614	5805	3630	199681	11982	0	221098
3615	5121	3066	8855	203452	0	220494
3616	4996	2867	4580	210508	0	222951
3617	3833	2848	202129	14452	0	223262
3618	4481	2510	9348	194436	0	210775
3619	3299	197095	5292	12658	0	218344
3620	3516	8992	196951	7794	0	217253
3621	4655	4464	187041	5584	0	201744
3622	2514	171485	10951	4491	0	189441
3623	1765	146307	4545	3330	0	155947
3624	989	117386	1865	1458	0	121698
3625	103605	4485	3274	1579	0	112943
3626	83421	17054	1032	1313	0	102820
3627	98057	1208	585	1105	0	100955
3628	4099	872	573	95755	0	101299
3629	1374	684	94074	3399	0	99531
3630	1283	636	3017	92771	0	97707
3631	1149	534	1168	95392	0	98243
3632	92608	550	830	4274	0	98262
3633	93152	581	612	2103	0	96448
3634	3558	93016	666	1172	0	98412
3635	92121	2927	582	1301	0	96931
3636	94111	1132	538	1198	0	96979
3637	95737	782	498	1156	0	98173
3638	4001	713	91856	856	0	97426
3639	1594	627	91937	770	0	94928
3640	1521	653	3400	89296	0	94870
3641	811	585	90489	3116	0	95001
3642	85788	565	2969	1492	0	90814
3643	89067	471	1154	1180	0	91872
3644	3522	462	85700	664	0	90348
3645	83040	403	2600	894	0	86937
3646	3146	84446	1113	610	0	89315
3647	85412	2549	678	801	0	89440
3648	3362	988	498	83796	0	88644
3649	1696	620	500	82007	0	84823
3650	1097	83968	456	3109	0	88630
3651	83356	2622	433	1485	0	87896
3652	84439	1017	526	1069	0	87051
3653	3428	83435	516	648	0	88027
3654	1771	2688	445	80541	0	85445
3655	1382	1089	455	81166	0	84092
3656	924	80617	482	3266	0	85289
3657	1140	2737	455	80254	0	84586
3658	1121	1175	488	82764	0	85548
3659	80163	749	417	3768	0	85097
3660	81106	644	422	1891	0	84063
3661	3535	655	79032	1065	0	84287
3662	78070	532	2492	1293	0	82387
3663	3135	605	79011	952	0	83703
3664	1724	748	2612	76833	0	81917
3665	1063	565	77238	2918	0	81784
3666	894	75844	2700	1395	0	80833
3667	1203	2519	1150	73511	0	78383
3668	1054	999	677	75618	0	78348
3669	73752	596	512	3337	0	78197
3670	2879	526	444	72662	0	76511
3671	1246	532	70365	2890	0	75033
3672	70097	530	2338	1615	0	74580
3673	72480	507	996	1155	0	75138
3674	73392	536	624	1017	0	75569
3675	72774	504	535	965	0	74778
3676	3693	431	500	74267	0	78891
3677	1832	412	449	77762	0	80455
3678	1349	422	473	81040	0	83284
3679	1264	407	528	81890	0	84089
3680	78437	352	520	4308	0	83617
3681	79866	348	466	1945	0	82625
3682	4095	328	462	73643	0	78528
3683	1733	75030	511	3152	0	80426
3684	75776	2634	485	1670	0	80565
3685	3393	1085	74613	1080	0	80171
3686	1591	74645	2682	952	0	79870
3687	70621	2479	965	1031	0	75096
3688	3025	71074	574	701	0	75374
3689	1493	2568	70471	656	0	75188
3690	70393	999	2502	921	0	74815
3691	72318	597	986	812	0	74713
3692	3794	528	69550	604	0	74476
3693	2058	377	2555	70012	0	75002
3694	1610	400	982	70368	0	73360
3695	1152	70097	649	3357	0	75255
3696	1290	2512	506	70276	0	74584
3697	67977	938	470	3305	0	72690
3698	3012	68499	457	1473	0	73441
3699	1626	2253	409	64232	0	68520
3700	1282	909	358	65601	0	68150
3701	898	537	62407	3097	0	66939
3702	786	62348	2103	1337	0	66574
3703	56470	2241	785	1088	0	60584
3704	1911	47688	380	592	0	50571
3705	769	45040	266	377	0	46452
3706	43667	1710	511	550	0	46438
3707	1684	579	242	42481	0	44986
3708	819	422	222	43473	0	44936
3709	42526	308	207	2025	0	45066
3710	1802	270	151	43124	0	45347
3711	1023	274	123	43981	0	45401
3712	43711	301	136	2112	0	46260
3713	1845	249	116	43001	0	45211
3714	748	42757	177	1753	0	45435
3715	42763	1386	148	996	0	45293
3716	1721	577	41036	579	0	43913
3717	808	39546	1314	515	0	42183
3718	567	1478	410	38854	0	41309
3719	415	554	37964	1521	0	40454
3720	436	295	38031	721	0	39483
3721	515	1314	1490	34992	0	38311
3722	35131	236	537	1489	0	37393
3723	1342	159	272	34947	0	36720
3724	633	188	243	35503	0	36567
3725	460	205	190	35933	0	36788
3726	450	162	186	35936	0	36734
3727	370	221	211	36025	0	36827
3728	289	233	33828	1862	0	36212
3729	330	200	33483	775	0	34788
3730	388	187	1358	33418	0	35351
3731	246	216	33619	1420	0	35501
3732	257	33413	1223	756	0	35649
3733	331	1066	571	33739	0	35707
3734	227	434	32924	1461	0	35046
3735	30187	245	1183	906	0	32521
3736	1163	31791	546	552	0	34052
3737	430	30762	267	531	0	31990
3738	294	31914	214	492	0	32914
3739	363	1337	182	30993	0	32875
3740	30933	493	194	1461	0	33081
3741	1130	324	217	31193	0	32864
3742	30271	254	250	1397	0	32172
3743	1132	29613	198	672	0	31615
3744	30225	1118	183	570	0	32096
3745	1285	544	158	30082	0	32069
3746	617	375	118	30407	0	31517
3747	420	29632	159	1457	0	31668
3748	423	1095	177	30017	0	31712
3749	454	455	138	30675	0	31722
3750	337	386	124	30848	0	31695
3751	29281	300	162	1713	0	31456
3752	28092	262	159	1045	0	29558
3753	1320	227	28956	658	0	31161
3754	28924	259	1007	626	0	30816
3755	1318	237	29327	522	0	31404
3756	686	224	1113	29003	0	31026
3757	480	257	479	29976	0	31192
3758	416	227	308	30623	0	31574
3759	317	204	29187	1692	0	31400
3760	283	248	1151	29524	0	31206
3761	247	236	29751	1468	0	31702
3762	303	179	1151	29853	0	31486
3763	29406	173	464	1651	0	31694
3764	1118	214	29449	847	0	31628
3765	29415	170	1075	738	0	31398
3766	1252	156	518	30012	0	31938
3767	29739	165	346	1470	0	31720
3768	1206	29551	310	793	0	31860
3769	589	986	293	30209	0	32077
3770	370	433	30536	1386	0	32725
3771	408	305	1055	30385	0	32153
3772	381	612	491	29638	0	31122
3773	262	29362	303	1540	0	31467
3774	332	977	28832	760	0	30901
3775	233	28673	1022	550	0	30478
3776	23676	721	378	477	0	25252
3777	630	23738	228	343	0	24939
3778	21215	552	272	267	0	22306
3779	21366	187	136	284	0	21973
3780	21448	145	89	242	0	21924
3781	821	92	94	21348	0	22355
3782	312	123	21219	649	0	22303
3783	242	104	543	20508	0	21397
3784	158	21325	219	640	0	22342
3785	187	510	147	21546	0	22390
3786	20946	192	112	759	0	22009
3787	531	21067	152	317	0	22067
3788	281	560	114	20060	0	21015
3789	223	238	111	20274	0	20846
3790	19992	148	75	843	0	21058
3791	620	148	19862	335	0	20965
3792	299	19432	532	247	0	20510
3793	249	409	157	18056	0	18871
3794	142	138	17984	445	0	18709
3795	179	114	381	17236	0	17910
3796	64	17615	207	445	0	18331
3797	135	377	119	18441	0	19072
3798	111	145	81	18157	0	18494
3799	112	99	76	18160	0	18447
3800	87	75	17843	562	0	18567
3801	17326	116	352	266	0	18060
3802	410	81	119	19395	0	20005
3803	21069	55	79	624	0	21827
3804	21639	49	79	325	0	22092
3805	22077	54	101	209	0	22441
3806	21647	87	92	207	0	22033
3807	22240	79	45	217	0	22581
3808	756	46	74	21648	0	22524
3809	269	21448	73	574	0	22364
3810	241	460	35	20937	0	21673
3811	115	20988	60	539	0	21702
3812	157	416	28	20001	0	20602
3813	19741	100	21	546	0	20408
3814	459	78	53	19627	0	20217
3815	172	57	19455	418	0	20102
3816	18479	35	339	295	0	19148
3817	441	19507	99	144	0	20191
3818	19636	341	78	140	0	20195
3819	19759	90	44	138	0	20031
3820	19330	60	22	169	0	19581
3821	514	19987	30	74	0	20605
3822	256	338	24	19963	0	20581
3823	190	138	20	20214	0	20562
3824	108	109	19883	472	0	20572
3825	194	98	326	18985	0	19603
3826	175	69	89	19105	0	19438
3827	200	33	63	19681	0	19977
3828	113	19931	57	497	0	20598
3829	20070	359	70	298	0	20797
3830	19502	96	58	239	0	19895
3831	506	130	20128	84	0	20848
3832	224	20207	337	113	0	20881
3833	307	356	90	20467	0	21220
3834	278	93	48	20854	0	21273
3835	207	130	69	20812	0	21218
3836	182	88	35	20998	0	21303
3837	179	59	29	21513	0	21780
3838	99	79	20935	604	0	21717
3839	99	98	19822	298	0	20317
3840	20932	59	435	351	0	21777
3841	22164	80	124	307	0	22675
3842	22339	104	99	225	0	22767
3843	665	88	73	22130	0	22956
3844	308	61	21791	491	0	22651
3845	21602	52	464	246	0	22364
3846	22531	102	160	244	0	23037
3847	592	95	21629	200	0	22516
3848	21596	47	444	261	0	22348
3849	607	57	23356	209	0	24229
3850	319	54	476	23571	0	24420
3851	189	60	23888	586	0	24723
3852	23182	64	538	309	0	24093
3853	24127	49	255	272	0	24703
3854	24385	57	151	230	0	24823
3855	24428	37	103	271	0	24839
3856	740	57	25087	161	0	26045
3857	323	25267	464	221	0	26275
3858	25804	426	212	232	0	26674
3859	26016	122	151	212	0	26501
3860	743	124	25840	96	0	26803
3861	422	69	513	25076	0	26080
3862	356	70	212	26202	0	26840
3863	224	62	25621	658	0	26565
3864	24104	63	561	388	0	25116
3865	25876	48	215	326	0	26465
3866	700	25942	180	185	0	27007
3867	26921	435	128	262	0	27746
3868	26806	127	112	266	0	27311
3869	27308	77	147	194	0	27726
3870	26621	84	130	182	0	27017
3871	803	118	25831	108	0	26860
3872	25404	81	468	194	0	26147
3873	859	175	190	25326	0	26550
3874	388	26095	192	511	0	27186
3875	294	437	25651	253	0	26635
3876	247	26135	519	236	0	27137
3877	300	550	225	24732	0	25807
3878	213	113	25437	386	0	26149
3879	23581	109	404	208	0	24302
3880	494	70	25097	109	0	25770
3881	24686	58	412	138	0	25294
3882	554	42	138	25098	0	25832
3883	322	39	123	25038	0	25522
3884	257	24635	121	432	0	25445
3885	205	25694	125	170	0	26194
3886	216	391	90	26622	0	27319
3887	26420	150	76	464	0	27110
3888	26319	106	110	206	0	26741
3889	26242	81	101	201	0	26625
3890	560	71	26440	113	0	27184
3891	25724	56	382	198	0	26360
3892	531	49	27361	134	0	28075
3893	249	58	25689	104	0	26100
3894	26295	70	442	143	0	26950
3895	27326	42	217	182	0	27767
3896	493	77	27302	80	0	27952
3897	333	47	349	26623	0	27352
3898	248	85	154	27996	0	28483
3899	28177	63	126	443	0	28809
3900	27347	33	120	264	0	27764
3901	525	48	30064	137	0	30774
3902	253	28875	316	103	0	29547
3903	153	28001	122	64	0	28340
3904	27918	210	156	141	0	28425
3905	290	82	80	27944	0	28396
3906	178	59	84	28357	0	28678
3907	172	34	58	28887	0	29151
3908	28298	29	52	306	0	28685
3909	310	52	59	28883	0	29304
3910	29128	30	85	280	0	29523
3911	29563	21	44	206	0	29834
3912	347	32603	78	102	0	33130
3913	297	223	55	36000	0	36575
3914	182	93	36268	334	0	36877
3915	35381	76	372	269	0	36098
3916	36766	65	158	220	0	37209
3917	37162	43	117	218	0	37540
3918	587	42	38276	109	0	39014
3919	392	29	405	38084	0	38910
3920	39131	35	147	523	0	39836
3921	37727	33	127	291	0	38178
3922	37873	40	95	242	0	38250
3923	642	37445	83	117	0	38287
3924	342	39678	86	111	0	40217
3925	315	451	68	40590	0	41424
3926	291	203	56	40269	0	40819
3927	180	40164	78	531	0	40953
3928	40206	414	82	309	0	41011
3929	504	201	41202	173	0	42080
3930	333	102	373	41215	0	42023
3931	292	86	158	41335	0	41871
3932	177	108	41109	492	0	41886
3933	38551	52	409	372	0	39384
3934	41789	51	182	254	0	42276
3935	597	40989	148	181	0	41915
3936	41233	364	101	223	0	41921
3937	551	191	43005	96	0	43843
3938	43246	107	422	296	0	44071
3939	605	86	44771	101	0	45563
3940	43902	109	506	229	0	44746
3941	45655	65	181	261	0	46162
3942	45675	52	163	196	0	46086
3943	45395	37	118	219	0	45769
3944	633	45318	122	96	0	46169
3945	46746	308	80	260	0	47394
3946	47801	131	81	254	0	48267
3947	675	130	47993	85	0	48883
3948	48110	73	384	208	0	48775
3949	668	87	143	48840	0	49738
3950	361	96	48564	389	0	49410
3951	48488	67	441	289	0	49285
3952	615	61	182	49909	0	50767
3953	51116	62	132	637	0	51947
3954	56189	72	98	630	0	56989
3955	688	99	59659	162	0	60608
3956	59294	51	411	410	0	60166
3957	61467	67	211	326	0	62071
3958	61718	68	115	243	0	62144
3959	62644	51	104	251	0	63050
3960	860	49	122	61388	0	62419
3961	433	61614	137	455	0	62639
3962	60457	434	153	581	0	61625
3963	62924	157	98	327	0	63506
3964	63220	100	87	299	0	63706
3965	874	113	63013	130	0	64130
3966	446	63101	528	124	0	64199
3967	492	451	204	63746	0	64893
3968	444	159	156	64414	0	65173
3969	380	136	66440	634	0	67590
3970	538	96	719	65753	0	67106
3971	371	102	67691	801	0	68965
3972	490	89	822	66860	0	68261
3973	463	80	287	68036	0	68866
3974	316	147	69387	971	0	70821
3975	66466	95	812	706	0	68079
3976	70660	80	307	626	0	71673
3977	1106	150	72603	228	0	74087
3978	70738	94	819	527	0	72178
3979	73445	70	356	500	0	74371
3980	1178	117	76234	219	0	77748
3981	796	93	837	74845	0	76571
3982	625	51	374	76499	0	77549
3983	77329	47	290	1201	0	78867
3984	1017	79169	249	467	0	80902
3985	73842	814	309	957	0	75922
3986	78938	235	183	607	0	79963
3987	1166	81768	215	295	0	83444
3988	82773	746	214	566	0	84299
3989	82877	306	145	476	0	83804
3990	1286	82266	174	195	0	83921
3991	860	784	187	83244	0	85075
3992	587	84110	190	774	0	85661
3993	667	859	170	84954	0	86650
3994	499	381	84557	933	0	86370
3995	492	331	82681	415	0	83919
3996	81464	150	1030	677	0	83321
3997	84794	173	425	597	0	85989
3998	1291	242	85203	229	0	86965
3999	83545	125	966	518	0	85154
4000	86796	137	395	510	0	87838
4001	84514	94	326	543	0	85477
4002	1451	86415	317	201	0	88384
4003	853	812	224	88237	0	90126
4004	88042	300	205	1303	0	89850
4005	86996	180	193	833	0	88202
4006	1405	265	89109	351	0	91130
4007	963	143	910	87360	0	89376
4008	752	107	409	89539	0	90807
4009	537	88856	341	1082	0	90816
4010	503	93911	274	531	0	95219
4011	660	1413	221	91266	0	93560
4012	443	92746	235	1036	0	94460
4013	90175	912	160	698	0	91945
4014	1133	95184	199	292	0	96808
4015	96733	1217	138	649	0	98737
4016	1573	462	98049	191	0	100275
4017	100646	282	1363	629	0	102920
4018	106287	156	444	558	0	107445
4019	106493	129	278	543	0	107443
4020	105145	160	182	631	0	106118
4021	2487	103994	218	269	0	106968
4022	1407	1578	152	105328	0	108465
4023	1093	602	144	104972	0	106811
4024	546	454	104792	2168	0	107960
4025	920	235	1553	101893	0	104601
4026	729	219	609	105185	0	106742
4027	105951	190	323	2659	0	109123
4028	1913	106873	288	1037	0	110111
4029	1292	1687	226	107502	0	110707
4030	1035	659	234	109582	0	111510
4031	913	416	208	111066	0	112603
4032	110011	286	203	3059	0	113559
4033	2376	261	171	110960	0	113768
4034	111379	225	214	2833	0	114651
4035	2576	251	224	111476	0	114527
4036	1328	219	212	113285	0	115044
4037	839	233	107905	2751	0	111728
4038	99337	287	1893	1771	0	103288
4039	2218	107448	730	847	0	111243
4040	110767	1791	393	1121	0	114072
4041	2663	669	276	109882	0	113490
4042	1447	441	196	111873	0	113957
4043	112480	279	173	3217	0	116149
4044	114139	273	234	1759	0	116405
4045	3378	255	149	118945	0	122727
4046	1456	273	119787	2624	0	124140
4047	962	299	118176	1251	0	120688
4048	732	124322	2687	868	0	128609
4049	125875	2453	1146	1263	0	130737
4050	127140	858	486	1110	0	129594
4051	3787	521	340	126009	0	130657
4052	1420	129141	326	2781	0	133668
4053	1410	2754	221	128657	0	133042
4054	1250	923	254	123480	0	125907
4055	754	117998	344	3548	0	122644
4056	118079	2678	308	1863	0	122928
4057	3435	1027	359	117570	0	122391
4058	1441	119279	423	2959	0	124102
4059	974	126308	346	1392	0	129020
4060	124762	3184	323	1290	0	129559
4061	3257	1318	123425	759	0	128759
4062	124341	913	2683	1023	0	128960
4063	3914	722	846	125249	0	130731
4064	1987	598	500	125416	0	128501
4065	1204	125993	435	3775	0	131407
4066	1502	3153	372	125994	0	131021
4067	1016	1161	126552	3563	0	132292
4068	890	123427	2649	1805	0	128771
4069	758	127361	949	1137	0	130205
4070	123442	3169	578	1438	0	128627
4071	2858	126220	464	994	0	130536
4072	1666	3033	371	124917	0	129987
4073	995	126448	360	3012	0	130815
4074	1348	3051	281	126727	0	131407
4075	1198	1272	337	128146	0	130953
4076	850	985	123769	4050	0	129654
4077	1147	739	2624	121281	0	125791
4078	1072	691	931	125180	0	127874
4079	121570	775	628	4413	0	127386
4080	3228	779	120490	2012	0	126509
4081	1858	733	2696	122602	0	127889
4082	1221	818	122501	3694	0	128234
4083	118504	727	3015	2407	0	124653
4084	3279	123799	1212	1723	0	130013
4085	130694	3102	806	1914	0	136516
4086	4058	1250	625	134187	0	140120
4087	2133	1082	571	134973	0	138759
4088	1367	890	132340	4739	0	139336
4089	121886	786	3095	3054	0	128821
4090	3657	133691	1218	1888	0	140454
4091	132007	3476	816	1989	0	138288
4092	4350	1391	674	133905	0	140320
4093	1962	135930	748	3943	0	142583
4094	135367	3494	662	2429	0	141952
4095	3869	139663	562	1822	0	145916
4096	2154	3757	593	139656	0	146160
4097	1957	1616	523	141646	0	145742
4098	1631	1337	586	140286	0	143840
4099	1268	137164	667	5110	0	144209
4100	1475	3659	585	139248	0	144967
4101	1587	1656	485	142224	0	145952
4102	136378	1277	603	5452	0	143710
4103	137839	1169	521	2915	0	142444
4104	138241	1280	436	2331	0	142288
4105	5004	1186	136548	1892	0	144630
4106	136184	1142	3164	2180	0	142670
4107	140621	1186	1207	2021	0	145035
4108	136012	1106	875	2261	0	140254
4109	4900	1258	130965	1711	0	138834
4110	131032	1011	2844	1918	0	136805
4111	4686	933	1087	135059	0	141765
4112	2153	918	132834	4111	0	140016
4113	1611	131673	3243	2152	0	138679
4114	1854	4418	1201	124576	0	132049
4115	1279	124451	971	3363	0	130064
4116	1220	126982	776	1744	0	130722
4117	119432	2757	958	1523	0	124670
4118	3043	1109	517	119380	0	124049
4119	120220	722	571	3090	0	124603
4120	3138	733	459	120166	0	124496
4121	120107	726	476	3138	0	124447
4122	3150	677	438	120188	0	124453
4123	119868	819	441	3256	0	124384
4124	3052	716	115661	1345	0	120774
4125	1627	827	2140	116891	0	121485
4126	1199	884	118115	2832	0	123030
4127	1306	853	110571	1478	0	114208
4128	999	727	117256	1322	0	120304
4129	1241	961	2642	115021	0	119865
4130	908	676	116433	2839	0	120856
4131	114122	538	2314	1745	0	118719
4132	2623	582	845	116834	0	120884
4133	1262	505	124889	2865	0	129521
4134	1336	483	2223	123734	0	127776
4135	1204	435	906	126814	0	129359
4136	1012	551	134123	3052	0	138738
4137	1394	390	2351	131875	0	136010
4138	1346	401	1023	132030	0	134800
4139	994	135479	843	2954	0	140270
4140	135441	1844	828	1928	0	140041
4141	136000	596	787	1655	0	139038
4142	2898	556	132340	1155	0	136949
4143	127368	389	2123	1581	0	131461
4144	2648	419	126561	926	0	130554
4145	1258	377	118325	786	0	120746
4146	963	449	120779	732	0	122923
4147	1129	1869	2438	116473	0	121909
4148	633	340	120794	1711	0	123478
4149	657	362	1486	117219	0	119724
4150	703	251	606	117773	0	119333
4151	737	190	472	118907	0	120306
4152	672	230	396	118721	0	120019
4153	116943	230	380	2279	0	119832
4154	116614	184	378	1450	0	118626
4155	1571	119477	449	886	0	122383
4156	860	1144	444	121588	0	124036
4157	665	473	123595	1567	0	126300
4158	507	124736	1620	900	0	127763
4159	727	1529	720	128792	0	131768
4160	474	570	130724	1902	0	133670
4161	820	274	1787	125821	0	128702
4162	380	324	129070	2072	0	131846
4163	503	303	125862	931	0	127599
4164	670	221	2109	128688	0	131688
4165	657	265	948	129329	0	131199
4166	129687	150	640	2897	0	133374
4167	1906	150	572	129918	0	132546
4168	128084	178	518	2785	0	131565
4169	1730	127398	539	1187	0	130854
4170	697	131944	550	947	0	134138
4171	865	1761	433	134665	0	137724
4172	133948	657	409	2666	0	137680
4173	1922	135515	497	1148	0	139082
4174	1090	1702	516	139289	0	142597
4175	141948	531	449	2984	0	145912
4176	142831	437	518	1601	0	145387
4177	139543	339	556	1634	0	142072
4178	139578	302	479	1599	0	141958
4179	144493	250	382	1406	0	146531
4180	2739	378	140005	670	0	143792
4181	1216	495	137102	762	0	139575
4182	865	139691	2113	607	0	143276
4183	1129	2017	913	139444	0	143503
4184	690	738	142417	1794	0	145639
4185	603	671	136717	751	0	138742
4186	1074	511	1988	134188	0	137761
4187	450	428	143794	1828	0	146500
4188	464	386	141134	763	0	142747
4189	397	177414	2371	636	0	180818
4190	175942	2890	902	1225	0	180959
4191	2945	192705	702	503	0	196855
4192	1794	3694	530	194794	0	200812
4193	197377	772	499	4411	0	203059
4194	3778	201751	758	1144	0	207431
4195	2237	3761	636	197245	0	203879
4196	798	1173	200805	3798	0	206574
4197	197770	698	3882	1909	0	204259
4198	204624	551	1055	1639	0	207869
4199	207983	429	832	1280	0	210524
4200	5860	452	575	206114	0	213001
4201	1667	707	206912	4307	0	213593
4202	1014	206739	4315	1321	0	213389
4203	1964	4199	1146	207497	0	214806
4204	205916	1074	802	5126	0	212918
4205	4759	1044	204620	1209	0	211632
4206	1548	200061	4349	1254	0	207212
4207	1294	4073	205434	840	0	211641
4208	197831	1234	4568	1625	0	205258
4209	208582	881	1394	1624	0	212481
4210	208698	652	1072	1624	0	212046
4211	5914	649	203330	630	0	210523
4212	2191	199702	4521	804	0	207218
4213	2602	4093	1465	198576	0	206736
4214	2149	1183	1199	203372	0	207903
4215	2096	856	1134	204426	0	208512
4216	1169	877	200314	5516	0	207876
4217	192005	574	4653	2851	0	200083
4218	5182	770	201013	1313	0	208278
4219	199553	730	5137	1935	0	207355
4220	206252	869	1751	1934	0	210806
4221	207409	757	1313	1888	0	211367
4222	204126	778	1004	2003	0	207911
4223	6543	955	201738	907	0	210143
4224	3865	814	4690	199682	0	209051
4225	2144	1130	200797	4689	0	208760
4226	1902	193571	5049	1824	0	202346
4227	1843	204271	1772	1681	0	209567
4228	200625	5290	1319	2288	0	209522
4229	197096	1930	1320	2415	0	202761
4230	6046	203057	1658	1451	0	212212
4231	204691	5144	1336	2009	0	213180
4232	6605	2252	183063	1705	0	193625
4233	191778	1452	4205	2013	0	199448
4234	6649	199082	2022	1401	0	209154
4235	202894	5284	1467	1855	0	211500
4236	198724	1910	1531	1610	0	203775
4237	8373	1502	1530	191610	0	203015
4238	4376	1354	1477	195525	0	202732
4239	193081	1364	1772	6692	0	202909
4240	7460	1650	1440	192571	0	203121
4241	193052	1534	1601	6563	0	202750
4242	8215	1382	1392	192849	0	203838
4243	190828	1213	1606	6634	0	200281
4244	191450	1277	1493	3135	0	197355
4245	7884	182561	1923	2007	0	194375
4246	4084	191669	1844	1722	0	199319
4247	185168	6104	1533	2226	0	195031
4248	7118	187267	1637	1799	0	197821
4249	4385	6017	1687	183864	0	195953
4250	4083	2391	1587	188362	0	196423
4251	181102	1992	1533	7738	0	192365
4252	6777	181574	1766	3493	0	193610
4253	3999	178245	1789	2732	0	186765
4254	3625	183792	1825	2445	0	191687
4255	4053	6525	177993	2179	0	190750
4256	3826	2654	177168	2146	0	185794
4257	4039	2230	178414	1911	0	186594
4258	4452	3751	6339	154003	0	168545
4259	3377	168904	2524	4862	0	179667
4260	169322	5544	1701	2877	0	179444
4261	6943	2374	166602	2188	0	178107
4262	3764	1959	165937	2208	0	173868
4263	3232	1768	170316	2015	0	177331
4264	3812	1676	6440	165664	0	177592
4265	3828	1637	2774	168920	0	177159
4266	4047	1855	2038	170725	0	178665
4267	169116	1842	1720	6165	0	178843
4268	168425	1871	1826	2745	0	174867
4269	170050	1579	1935	2267	0	175831
4270	7892	1496	2188	162699	0	174275
4271	3706	1557	157995	5143	0	168401
4272	3240	1856	161530	2301	0	168927
4273	3742	1421	5450	159654	0	170267
4274	3764	1430	2272	159444	0	166910
4275	155233	1373	1878	6072	0	164556
4276	6432	152805	1779	2897	0	163913
4277	154011	4261	1515	2678	0	162465
4278	6485	151684	1430	2567	0	162166
4279	4127	4534	1229	152478	0	162368
4280	3333	1750	151751	5595	0	162429
4281	3874	1753	4502	151008	0	161137
4282	153739	1375	1693	5955	0	162762
4283	6458	1316	150967	2818	0	161559
4284	146170	1249	4523	2581	0	154523
4285	6672	1223	145401	1881	0	155177
4286	3820	1512	142019	1728	0	149079
4287	132453	1210	4741	2224	0	140628
4288	5931	1230	135397	1756	0	144314
4289	2009	685	98481	947	0	102122
4290	2250	96610	3910	930	0	103700
4291	81296	2508	3560	1251	0	88615
4292	77348	565	875	740	0	79528
4293	76985	307	399	652	0	78343
4294	1709	316	73978	351	0	76354
4295	70863	263	1277	637	0	73040
4296	1439	74258	556	370	0	76623
4297	72712	1139	348	495	0	74694
4298	1426	430	73182	250	0	75288
4299	897	697	1208	69439	0	72241
4300	403	254	69802	1011	0	71470
4301	318	69580	1079	454	0	71431
4302	496	751	539	67603	0	69389
4303	438	300	250	69022	0	70010
4304	70297	138	241	1261	0	71937
4305	69804	123	232	632	0	70791
4306	70101	150	176	540	0	70967
4307	70123	86	214	472	0	70895
4308	69143	123	216	427	0	69909
4309	1252	124	69103	202	0	70681
4310	673	98	918	68001	0	69690
4311	366	164	72188	871	0	73589
4312	433	163	983	72034	0	73613
4313	73296	92	442	1260	0	75090
4314	74502	111	272	692	0	75577
4315	74827	114	221	500	0	75662
4316	75546	129	251	477	0	76403
4317	1467	180	77632	237	0	79516
4318	843	141	1017	76077	0	78078
4319	455	180	77025	1105	0	78765
4320	425	77171	1143	486	0	79225
4321	408	77791	521	323	0	79043
4322	886	1324	347	75161	0	77718
4323	584	396	282	83168	0	84430
4324	779	172	312	83446	0	84709
4325	616	86	308	88950	0	89960
4326	87762	127	299	2317	0	90505
4327	1682	87552	291	777	0	90302
4328	85049	1397	168	614	0	87228
4329	1912	429	214	84158	0	86713
4330	1029	231	196	82550	0	84006
4331	474	84384	256	1685	0	86799
4332	637	1442	198	84536	0	86813
4333	84256	462	161	1902	0	86781
4334	1589	80016	225	699	0	82529
4335	528	79233	174	438	0	80373
4336	78628	1535	122	514	0	80799
4337	1671	550	123	78694	0	81038
4338	596	78907	167	1481	0	81151
4339	685	1358	158	80217	0	82418
4340	80482	445	144	1887	0	82958
4341	1760	283	132	79767	0	81942
4342	864	203	103	81027	0	82197
4343	80394	166	110	2130	0	82800
4344	1761	176	119	79869	0	81925
4345	654	79973	139	1701	0	82467
4346	817	1336	101	79459	0	81713
4347	371	79842	173	1554	0	81940
4348	615	1441	101	80524	0	82681
4349	79835	490	102	1957	0	82384
4350	80676	308	135	1014	0	82133
4351	2087	232	109	80887	0	83315
4352	741	282	79452	1584	0	82059
4353	76170	214	1306	1058	0	78748
4354	1629	244	78931	547	0	81351
4355	77675	175	1409	806	0	80065
4356	78678	162	477	792	0	80109
4357	1910	223	77288	395	0	79816
4358	745	76426	1372	404	0	78947
4359	76306	1377	508	703	0	78894
4360	76448	490	262	871	0	78071
4361	1785	347	79289	346	0	81767
4362	77918	228	1262	773	0	80181
4363	78160	207	399	760	0	79526
4364	78879	198	240	628	0	79945
4365	2177	194	169	77879	0	80419
4366	1110	205	155	78391	0	79861
4367	620	78860	198	1713	0	81391
4368	751	1276	161	80620	0	82808
4369	682	481	147	81129	0	82439
4370	426	376	79118	1908	0	81828
4371	463	365	75245	908	0	76981
4372	71083	271	1581	900	0	73835
4373	75933	229	559	803	0	77524
4374	1879	75832	362	515	0	78588
4375	1082	1408	213	76589	0	79292
4376	641	587	78590	1683	0	81501
4377	829	384	1436	79078	0	81727
4378	927	328	515	79247	0	81017
4379	638	308	285	83279	0	84510
4380	409	82615	239	2431	0	85694
4381	698	1658	149	84093	0	86598
4382	681	607	176	86101	0	87565
4383	502	467	83962	2468	0	87399
4384	530	333	84334	1130	0	86327
4385	79922	286	2027	1141	0	83376
4386	83960	338	922	956	0	86176
4387	2541	331	437	88191	0	91500
4388	1320	297	321	86692	0	88630
4389	958	303	295	88884	0	90440
4390	557	354	84657	3060	0	88628
4391	521	83062	2082	1481	0	87146
4392	590	2166	83297	931	0	86984
4393	80976	718	2277	1057	0	85028
4394	2474	507	83567	715	0	87263
4395	82257	343	2323	905	0	85828
4396	81268	321	820	945	0	83354
4397	84355	315	533	837	0	86040
4398	3294	264	388	81680	0	85626
4399	1280	330	81638	2561	0	85809
4400	837	81679	2249	1190	0	85955
4401	1120	2167	746	80118	0	84151
4402	1002	639	520	83138	0	85299
4403	656	506	84658	2958	0	88778
4404	563	83029	2507	1300	0	87399
4405	85627	2380	898	1108	0	90013
4406	2761	88748	668	735	0	92912
4407	95519	2800	519	869	0	99707
4408	4058	867	461	95425	0	100811
4409	1367	582	98364	3262	0	103575
4410	991	98938	3163	1270	0	104362
4411	99241	3057	1060	1287	0	104645
4412	3551	952	98433	721	0	103657
4413	97573	613	3365	890	0	102441
4414	99947	477	1095	898	0	102417
4415	4157	436	97582	592	0	102767
4416	95061	400	3359	801	0	99621
4417	96237	295	1178	775	0	98485
4418	94075	312	869	820	0	96076
4419	4278	91820	696	522	0	97316
4420	88525	2863	445	725	0	92558
4421	3642	89671	539	526	0	94378
4422	1385	3036	89111	545	0	94077
4423	902	88502	2962	541	0	92907
4424	83864	2984	1201	651	0	88700
4425	84811	874	553	668	0	86906
4426	86024	534	548	568	0	87674
4427	4034	469	423	81795	0	86721
4428	1964	336	452	85131	0	87883
4429	80702	360	512	3372	0	84946
4430	85153	319	420	1142	0	87034
4431	3969	324	334	82059	0	86686
4432	1548	317	81758	2700	0	86323
4433	1009	77719	2574	905	0	82207
4434	860	82578	768	660	0	84866
4435	1163	2939	578	80001	0	84681
4436	727	919	81080	2505	0	85231
4437	1138	794	2545	75690	0	80167
4438	826	78843	850	2473	0	82992
4439	1250	2471	554	78808	0	83083
4440	843	814	78868	2676	0	83201
4441	1113	591	2474	78418	0	82596
4442	696	511	82261	2963	0	86431
4443	1172	449	2771	81171	0	85563
4444	763	542	84428	2927	0	88660
4445	692	513	84136	1121	0	86462
4446	80982	476	3255	938	0	85651
4447	84683	520	1113	879	0	87195
4448	85110	534	852	829	0	87325
4449	3511	83158	683	707	0	88059
4450	1822	2498	669	84537	0	89526
4451	81435	762	644	3154	0	85995
4452	85895	683	564	1194	0	88336
4453	85431	512	573	1079	0	87595
4454	3663	512	83871	670	0	88716
4455	1566	78348	2774	708	0	83396
4456	1237	85696	1045	640	0	88618
4457	84357	2863	839	864	0	88923
4458	3404	1043	788	83675	0	88910
4459	83972	753	724	2852	0	88301
4460	3612	677	82427	843	0	87559
4461	1941	573	2703	79513	0	84730
4462	1723	629	948	81515	0	84815
4463	1539	678	748	79173	0	82138
4464	1165	80512	719	3188	0	85584
4465	79736	2668	612	1451	0	84467
4466	80923	916	689	1084	0	83612
4467	3670	78964	715	771	0	84120
4468	1886	2682	701	78123	0	83392
4469	78807	1000	621	2897	0	83325
4470	3591	880	539	78396	0	83406
4471	78486	665	563	3211	0	82925
4472	3608	77900	561	1224	0	83293
4473	77743	2777	519	969	0	82008
4474	3616	1023	75899	814	0	81352
4475	1636	77047	2610	826	0	82119
4476	1376	2683	75368	844	0	80271
4477	1823	2065	2909	72593	0	79390
4478	72358	839	1060	2774	0	77031
4479	73790	635	737	1037	0	76199
4480	73307	581	630	882	0	75400
4481	3662	553	563	70079	0	74857
4482	70718	479	587	2766	0	74550
4483	3395	379	518	69936	0	74228
4484	69829	441	546	2988	0	73804
4485	71508	476	464	1330	0	73778
4486	3431	562	69989	913	0	74895
4487	1396	446	64764	642	0	67248
4488	1113	480	64596	544	0	66733
4489	941	658	2273	62034	0	65906
4490	62913	384	1227	2218	0	66742
4491	2366	411	657	63029	0	66463
4492	1240	341	511	64911	0	67003
4493	67650	305	460	2677	0	71092
4494	68501	237	478	1281	0	70497
4495	68822	298	417	1072	0	70609
4496	69769	268	428	903	0	71368
4497	2776	237	446	67998	0	71457
4498	67321	241	424	2282	0	70268
4499	2385	66550	468	836	0	70239
4500	66737	1541	482	925	0	69685
4501	67138	520	578	849	0	69085
4502	2372	448	63301	510	0	66631
4503	59073	329	1429	660	0	61491
4504	2138	263	59155	505	0	62061
4505	853	192	53794	440	0	55279
4506	756	235	54125	376	0	55492
4507	810	1124	1180	44315	0	47429
4508	345	93	46005	616	0	47059
4509	395	237	577	41856	0	43065
4510	208	53	43476	468	0	44205
4511	231	62	46204	170	0	46667
4512	308	101	494	44638	0	45541
4513	296	35	167	47684	0	48182
4514	153	76	49865	465	0	50559
4515	47664	27	444	355	0	48490
4516	583	25	161	50062	0	50831
4517	322	28	111	50796	0	51257
4518	50808	34	97	714	0	51653
4519	571	50	94	51828	0	52543
4520	252	58	51869	524	0	52703
4521	226	62	48402	200	0	48890
4522	210	61	510	48610	0	49391
4523	131	58	50060	433	0	50682
4524	97	51664	523	243	0	52527
4525	230	336	231	51104	0	51901
4526	51942	115	121	644	0	52822
4527	426	82	52154	196	0	52858
4528	50746	40	444	354	0	51584
4529	540	25	190	54155	0	54910
4530	331	27	127	54362	0	54847
4531	245	25	115	54876	0	55261
4532	191	34	73	54585	0	54883
4533	54643	19	104	844	0	55610
4534	464	58955	115	320	0	59854
4535	291	638	81	59767	0	60777
4536	257	222	100	60016	0	60595
4537	247	114	91	60219	0	60671
4538	250	56	106	59909	0	60321
4539	59438	38	99	1219	0	60794
4540	682	59334	152	488	0	60656
4541	58768	622	95	511	0	59996
4542	707	55494	151	299	0	56651
4543	274	56591	126	249	0	57240
4544	54707	786	78	361	0	55932
4545	755	313	55626	204	0	56898
4546	453	152	691	55523	0	56819
4547	57018	93	273	979	0	58363
4548	57880	57	159	540	0	58636
4549	50856	322	222	981	0	52381
4550	58316	90	82	521	0	59009
4551	966	60845	117	293	0	62221
4552	61482	802	97	500	0	62881
4553	63285	285	61	457	0	64088
4554	1209	67084	105	247	0	68645
4555	723	1156	75	68989	0	70943
4556	329	403	68979	1318	0	71029
4557	527	255	1228	68556	0	70566
4558	68036	148	402	1738	0	70324
4559	1355	167	70932	539	0	72993
4560	504	69703	1362	402	0	71971
4561	367	1320	72055	263	0	74005
4562	489	389	1399	67706	0	69983
4563	263	70081	526	1159	0	72029
4564	71092	1285	247	719	0	73343
4565	1339	72163	178	348	0	74028
4566	742	1424	160	71669	0	73995
4567	583	522	115	73695	0	74915
4568	72609	327	132	1918	0	74986
4569	1608	191	125	71018	0	72942
4570	544	71846	214	1435	0	74039
4571	71941	1318	144	957	0	74360
4572	72578	472	127	695	0	73872
4573	1634	73452	207	365	0	75658
4574	73137	1407	105	628	0	75277
4575	1542	72590	212	290	0	74634
4576	71782	1508	125	633	0	74048
4577	1511	72477	121	362	0	74471
4578	945	1521	137	68536	0	71139
4579	644	591	123	73157	0	74515
4580	71864	427	112	1916	0	74319
4581	72991	260	150	1054	0	74455
4582	1772	72566	152	478	0	74968
4583	815	1457	71341	359	0	73972
4584	71985	604	1292	510	0	74391
4585	1815	417	428	73103	0	75763
4586	755	73092	300	1447	0	75594
4587	755	1461	148	74290	0	76654
4588	74063	565	118	1937	0	76683
4589	74630	459	129	1021	0	76239
4590	75363	355	137	761	0	76616
4591	2288	329	106	74011	0	76734
4592	938	404	73450	1614	0	76406
4593	68257	331	1311	1072	0	70971
4594	69862	322	472	905	0	71561
4595	72119	287	288	718	0	73412
4596	2133	70384	250	398	0	73165
4597	1115	1485	208	71089	0	73897
4598	715	73228	208	1532	0	75683
4599	772	1698	203	73282	0	75955
4600	788	747	149	74964	0	76648
4601	596	533	78442	2092	0	81663
4602	892	385	1682	84628	0	87587
4603	821	383	572	88467	0	90243
4604	87373	323	337	3392	0	91425
4605	2578	88851	251	1257	0	92937
4606	88249	2528	239	1117	0	92133
4607	93475	941	186	862	0	95464
4608	3789	663	203	91714	0	96369
4609	1539	519	93322	2737	0	98117
4610	972	90238	2453	1130	0	94793
4611	718	90941	823	831	0	93313
4612	87364	3214	573	1013	0	92164
4613	2826	89807	362	712	0	93707
4614	1518	2850	284	87102	0	91754
4615	1245	1109	312	90347	0	93013
4616	767	737	87981	3337	0	92822
4617	700	646	87291	1373	0	90010
4618	724	87758	3087	795	0	92364
4619	940	2854	1014	86988	0	91796
4620	86752	1113	511	2964	0	91340
4621	3066	780	375	88186	0	92407
4622	1165	665	89081	3043	0	93954
4623	1063	620	2654	88183	0	92520
4624	85184	582	891	3481	0	90138
4625	86187	558	521	1687	0	88953
4626	3393	85777	436	1019	0	90625
4627	85483	2754	320	1101	0	89658
4628	3084	86085	347	742	0	90258
4629	85585	2894	297	942	0	89718
4630	3592	1181	306	83612	0	88691
4631	1433	790	83160	2808	0	88191
4632	1088	681	81835	1149	0	84753
4633	849	84181	2996	878	0	88904
4634	1217	2424	1067	79419	0	84127
4635	1073	980	513	82818	0	85384
4636	81659	656	354	3344	0	86013
4637	82794	517	253	1631	0	85195
4638	84874	507	276	1127	0	86784
4639	3684	505	324	82534	0	87047
4640	1805	557	320	84614	0	87296
4641	1389	507	320	85751	0	87967
4642	859	569	83096	3370	0	87894
4643	814	565	82117	1449	0	84945
4644	80818	515	2847	1301	0	85481
4645	81702	448	1077	1292	0	84519
4646	3224	489	81912	755	0	86380
4647	80045	453	2455	1048	0	84001
4648	79858	444	915	1190	0	82407
4649	3337	381	79048	858	0	83624
4650	1498	78824	2538	836	0	83696
4651	1356	2337	1111	76401	0	81205
4652	910	905	78466	2588	0	82869
4653	819	80463	2453	1290	0	85025
4654	1162	2564	887	72501	0	77114
4655	695	76194	634	2097	0	79620
4656	730	2245	74705	995	0	78675
4657	739	941	75428	707	0	77815
4658	999	969	2669	74794	0	79431
4659	75679	508	1160	2531	0	79878
4660	2611	489	621	75975	0	79696
4661	75796	516	481	2723	0	79516
4662	2851	490	435	75846	0	79622
4663	1172	555	75016	2628	0	79371
4664	72754	475	2260	1553	0	77042
4665	2396	512	75887	932	0	79727
4666	75884	418	2546	932	0	79780
4667	2729	471	1153	74253	0	78606
4668	1218	75881	784	2503	0	80386
4669	1136	2147	610	75711	0	79604
4670	859	77896	591	2571	0	81917
4671	1095	2248	587	73646	0	77576
4672	834	77980	646	2475	0	81935
4673	76463	2295	632	1577	0	80967
4674	77796	954	540	1234	0	80524
4675	77565	640	540	1136	0	79881
4676	3267	561	75783	834	0	80445
4677	1810	500	2332	75669	0	80311
4678	1208	558	77490	2495	0	81751
4679	983	74075	2624	1241	0	78923
4680	857	78177	1233	917	0	81184
4681	75256	2688	899	960	0	79803
4682	2628	1155	75942	718	0	80443
4683	1296	75498	2441	670	0	79905
4684	1175	2405	1067	76667	0	81314
4685	76138	1024	801	2821	0	80784
4686	2452	77932	746	1219	0	82349
4687	78781	2427	664	1142	0	83014
4688	2819	1176	78347	794	0	83136
4689	1528	728	2418	79705	0	84379
4690	1258	560	1165	81954	0	84937
4691	1024	481	848	85046	0	87399
4692	779	83595	749	3436	0	88559
4693	1479	2576	646	79151	0	83852
4694	952	1108	85107	3136	0	90303
4695	1297	665	2612	83504	0	88078
4696	1115	567	1193	85850	0	88725
4697	1175	425	833	84274	0	86707
4698	837	82067	718	3422	0	87044
4699	1129	2322	661	82212	0	86324
4700	1201	1043	654	82374	0	85272
4701	587	76221	550	3112	0	80470
4702	68169	1643	352	1306	0	71470
4703	1603	67920	373	813	0	70709
4704	663	67870	333	612	0	69478
4705	771	1968	353	66177	0	69269
4706	394	754	66041	1652	0	68841
4707	59374	490	1407	953	0	62224
4708	1478	328	519	62942	0	65267
4709	494	286	61613	1567	0	63960
4710	317	61551	1356	768	0	63992
4711	453	1360	551	61590	0	63954
4712	303	634	62370	1533	0	64840
4713	498	462	1393	59997	0	62350
4714	490	313	569	61211	0	62583
4715	59467	237	368	2048	0	62120
4716	1335	59558	334	923	0	62150
4717	58983	1325	242	807	0	61357
4718	1480	611	59581	469	0	62141
4719	630	60170	1347	480	0	62627
4720	406	1383	60505	405	0	62699
4721	529	735	1429	60910	0	63603
4722	60673	366	646	1664	0	63349
4723	1464	279	358	60672	0	62773
4724	60996	260	283	1744	0	63283
4725	62384	245	240	937	0	63806
4726	1859	246	242	62843	0	65190
4727	787	283	65470	1582	0	68122
4728	527	339	66931	751	0	68548
4729	567	278	1701	68587	0	71133
4730	534	252	737	70307	0	71830
4731	69733	239	418	2180	0	72570
4732	1665	249	337	69512	0	71763
4733	747	68138	310	1815	0	71010
4734	710	1450	279	69546	0	71985
4735	551	639	278	70981	0	72449
4736	69038	445	267	2383	0	72133
4737	1531	69523	337	1134	0	72525
4738	862	1490	263	70362	0	72977
4739	710	661	222	70487	0	72080
4740	416	69315	282	2184	0	72197
4741	540	1549	264	70668	0	73021
4742	516	686	268	70429	0	71899
4743	306	68721	260	2363	0	71650
4744	487	1534	238	69792	0	72051
4745	486	702	224	69381	0	70793
4746	277	68116	277	2357	0	71027
4747	388	1584	240	69474	0	71686
4748	68029	725	206	2434	0	71394
4749	68566	526	179	1471	0	70742
4750	66889	452	223	1261	0	68825
4751	67601	428	179	1117	0	69325
4752	1979	65127	206	888	0	68200
4753	61075	1372	165	912	0	63524
4754	1504	59777	166	766	0	62213
4755	588	59647	184	597	0	61016
4756	696	1595	263	59340	0	61894
4757	365	692	59563	1495	0	62115
4758	56228	440	1151	960	0	58779
4759	58955	292	428	797	0	60472
4760	1549	359	60385	524	0	62817
4761	59626	274	1141	787	0	61828
4762	62773	261	352	776	0	64162
4763	1638	60806	292	464	0	63200
4764	67110	1272	182	884	0	69448
4765	1692	518	172	66455	0	68837
4766	858	427	222	67015	0	68522
4767	761	296	176	67478	0	68711
4768	636	323	196	67368	0	68523
4769	66687	324	221	2027	0	69259
4770	1604	278	180	66218	0	68280
4771	856	258	221	66944	0	68279
4772	636	318	65059	1749	0	67762
4773	60548	283	1143	1163	0	63137
4774	65457	277	451	990	0	67175
4775	65646	248	298	907	0	67099
4776	1721	63547	248	716	0	66232
4777	798	65765	224	667	0	67454
4778	65045	1456	185	837	0	67523
4779	1614	583	160	65069	0	67426
4780	712	65800	182	1677	0	68371
4781	682	1271	147	65209	0	67309
4782	495	65845	186	1634	0	68160
4783	65343	1305	110	1181	0	67939
4784	1427	66035	145	756	0	68363
4785	777	1340	113	65279	0	67509
4786	717	598	145	66411	0	67871
4787	576	425	67122	1735	0	69858
4788	497	70345	1211	935	0	72988
4789	791	1734	409	71913	0	74847
4790	469	784	73820	1861	0	76934
4791	414	554	74824	875	0	76667
4792	672	330	2147	75269	0	78418
4793	635	284	980	75730	0	77629
4794	341	72952	471	2614	0	76378
4795	301	76823	294	1393	0	78811
4796	542	2479	237	76640	0	79898
4797	76334	1158	175	2406	0	80073
4798	2265	595	177	80048	0	83085
4799	80132	431	141	2915	0	83619
4800	83120	392	145	1677	0	85334
4801	84462	350	167	1132	0	86111
4802	3272	453	83305	580	0	87610
4803	82984	317	2012	841	0	86154
4804	2946	245	990	83437	0	87618
4805	1756	231	513	84521	0	87021
4806	888	360	83032	3100	0	87380
4807	664	341	82688	1669	0	85362
4808	885	513	2721	79864	0	83983
4809	472	78518	1357	2320	0	82667
4810	524	82482	589	1296	0	84891
4811	800	2645	392	82081	0	85918
4812	81198	1226	292	2680	0	85396
4813	2412	592	304	82254	0	85562
4814	1556	438	285	81777	0	84056
4815	775	81539	293	3038	0	85645
4816	836	2023	262	83554	0	86675
4817	554	1126	83865	2583	0	88128
4818	551	637	80263	1559	0	83010
4819	78094	375	2699	1316	0	82484
4820	2014	82014	1349	793	0	86170
4821	81468	2016	666	939	0	85089
4822	82623	1059	444	913	0	85039
4823	3051	642	336	78249	0	82278
4824	1424	81085	386	1899	0	84794
4825	1043	2075	276	82093	0	85487
4826	81232	1056	236	2595	0	85119
4827	2065	79157	274	1476	0	82972
4828	76716	1890	217	1121	0	79944
4829	2110	76993	223	667	0	79993
4830	77609	2050	190	856	0	80705
4831	77634	1116	255	706	0	79711
4832	2676	75958	308	513	0	79455
4833	1612	1871	242	76417	0	80142
4834	76733	1052	257	2121	0	80163
4835	2238	573	73795	1076	0	77682
4836	1300	468	73702	654	0	76124
4837	1004	801	2336	72656	0	76797
4838	73989	327	1061	2144	0	77521
4839	2015	339	501	74491	0	77346
4840	74365	344	337	2371	0	77417
4841	2192	404	75021	1185	0	78802
4842	75893	290	1718	1037	0	78938
4843	80854	322	910	788	0	82874
4844	2935	287	428	79184	0	82834
4845	1758	264	290	80040	0	82352
4846	1080	272	275	80538	0	82165
4847	728	79762	289	2757	0	83536
4848	733	1590	326	80045	0	82694
4849	641	820	354	82216	0	84031
4850	80325	439	354	2995	0	84113
4851	80697	304	349	1887	0	83237
4852	2583	373	78953	924	0	82833
4853	77744	262	1690	1072	0	80768
4854	2296	385	79562	635	0	82878
4855	74755	324	1939	946	0	77964
4856	2277	333	78560	642	0	81812
4857	1433	329	77176	563	0	79501
4858	1095	378	2367	75629	0	79469
4859	670	258	77251	2010	0	80189
4860	74014	259	2028	1546	0	77847
4861	1970	316	1166	78506	0	81958
4862	79808	282	601	2389	0	83080
4863	80507	294	493	1572	0	82866
4864	76406	279	480	972	0	78137
4865	75720	241	316	922	0	77199
4866	3095	240	74233	564	0	78132
4867	2046	157	1685	73911	0	77799
4868	1184	208	75830	1855	0	79077
4869	1067	195	1894	74932	0	78088
4870	74836	218	1150	2262	0	78466
4871	2133	224	678	76253	0	79288
4872	76558	222	529	2392	0	79701
4873	2319	205	488	77064	0	80076
4874	1455	226	368	78101	0	80150
4875	76983	251	407	2925	0	80566
4876	2080	75984	375	1616	0	80055
4877	76577	1551	283	1091	0	79502
4878	2142	76092	277	848	0	79359
4879	1492	1740	264	76757	0	80253
4880	76123	929	288	2146	0	79486
4881	2019	521	75216	1294	0	79050
4882	1471	292	1596	76318	0	79677
4883	76458	317	942	2322	0	80039
4884	79039	248	507	1444	0	81238
4885	3046	307	345	78011	0	81709
4886	1643	78529	383	2101	0	82656
4887	1056	77989	321	1226	0	80592
4888	1061	3285	251	72251	0	76848
4889	73378	850	251	1851	0	76330
4890	1615	69802	154	875	0	72446
4891	552	67139	118	350	0	68159
4892	65232	1286	90	456	0	67064
4893	1075	65630	98	215	0	67018
4894	67173	1150	156	444	0	68923
4895	1476	508	98	66783	0	68865
4896	758	320	42	66614	0	67734
4897	307	65528	76	1383	0	67294
4898	209	65359	61	620	0	66249
4899	61454	1195	33	505	0	63187
4900	945	63384	73	256	0	64658
4901	382	69179	78	146	0	69785
4902	488	1536	32	69172	0	71228
4903	70227	780	25	1547	0	72579
4904	1429	428	74036	701	0	76594
4905	74312	208	1525	567	0	76612
4906	2233	144	848	80707	0	83932
4907	1083	175	82138	1947	0	85343
4908	583	173	83879	1120	0	85755
4909	629	114	2951	84441	0	88135
4910	309	189	88262	2154	0	90914
4911	85721	145	2606	1621	0	90093
4912	88636	126	1418	955	0	91135
4913	3251	161	88466	402	0	92280
4914	2037	120	2427	86451	0	91035
4915	1173	119	1450	87481	0	90223
4916	88490	74	741	3565	0	92870
4917	2688	120	532	84436	0	87776
4918	1463	85320	485	2651	0	89919
4919	85935	2048	346	1852	0	90181
4920	2484	84998	395	962	0	88839
4921	1542	89174	320	678	0	91714
4922	1147	3198	321	86930	0	91596
4923	960	1647	224	88389	0	91220
4924	948	798	230	89230	0	91206
4925	577	648	85528	3799	0	90552
4926	79259	445	2254	2433	0	84391
4927	2313	83599	1286	1364	0	88562
4928	85393	2339	611	1180	0	89523
4929	86679	1372	401	1010	0	89462
4930	3932	826	341	85002	0	90101
4931	2044	85130	334	2676	0	90184
4932	1428	2480	322	87974	0	92204
4933	1244	1399	225	89828	0	92696
4934	88860	849	271	4140	0	94120
4935	88761	585	283	2559	0	92188
4936	3766	633	85205	1355	0	90959
4937	88478	444	2104	1387	0	92413
4938	3376	90277	1194	903	0	95750
4939	91117	2573	665	1081	0	95436
4940	3411	95475	420	765	0	100071
4941	2346	3128	346	92370	0	98190
4942	1678	1716	320	92462	0	96176
4943	1105	91889	325	3913	0	97232
4944	1204	2927	271	94745	0	99147
4945	1046	1790	274	95791	0	98901
4946	1028	1043	244	94718	0	97033
4947	788	91640	325	4732	0	97485
4948	1096	3041	264	94055	0	98456
4949	1027	1808	245	95016	0	98096
4950	908	1234	319	96532	0	98993
4951	814	892	91154	5125	0	97985
4952	87344	941	2584	3301	0	94170
4953	3118	812	91918	1975	0	97823
4954	90667	753	3130	1904	0	96454
4955	3579	699	92558	1598	0	98434
4956	91493	660	3323	1515	0	96991
4957	93960	738	1829	1455	0	97982
4958	4701	634	92533	1223	0	99091
4959	3040	663	3043	91255	0	98001
4960	1780	743	88409	3403	0	94335
4961	86038	641	3078	2442	0	92199
4962	3637	649	92379	1718	0	98383
4963	2353	620	91102	1420	0	95495
4964	89051	589	4278	1559	0	95477
4965	3530	90560	2660	1115	0	97865
4966	2653	2808	1468	91994	0	98923
4967	93427	1656	1305	3620	0	100008
4968	3950	1004	1095	93824	0	99873
4969	2690	742	1122	96096	0	100650
4970	93905	670	997	4999	0	100571
4971	94890	553	955	3166	0	99564
4972	4917	557	91996	1984	0	99454
4973	2954	516	92936	1822	0	98228
4974	2155	479	4395	92740	0	99769
4975	1648	544	95053	3915	0	101160
4976	1591	492	3889	93711	0	99683
4977	1665	539	2453	93870	0	98527
4978	1695	526	1462	97914	0	101597
4979	93158	594	1147	5754	0	100653
4980	3547	94939	1146	3363	0	102995
4981	95780	2864	770	2783	0	102197
4982	96078	1704	873	2406	0	101061
4983	4623	94654	828	2034	0	102139
4984	92649	2786	644	1885	0	97964
4985	3928	1768	90819	1493	0	98008
4986	2721	1273	2504	89374	0	95872
4987	91386	943	1529	3511	0	97369
4988	3455	890	87741	2227	0	94313
4989	87511	655	2443	1871	0	92480
4990	3256	92356	1531	1503	0	98646
4991	102101	2256	977	1647	0	106981
4992	103673	1344	843	1496	0	107356
4993	5104	104211	767	1180	0	111262
4994	107882	3049	765	1211	0	112907
4995	4949	1734	713	107412	0	114808
4996	3297	1158	526	110676	0	115657
4997	108631	899	568	4897	0	114995
4998	106136	654	510	3093	0	110393
4999	5062	106271	619	1953	0	113905
5000	2926	107502	510	1632	0	112570
5001	2068	3851	389	98331	0	104639
5002	1354	100455	547	2897	0	105253
5003	1331	104348	477	1662	0	107818
5004	96236	3154	583	1336	0	101309
5005	2711	97835	382	743	0	101671
5006	91876	2375	223	731	0	95205
5007	2431	96673	269	526	0	99899
5008	1235	2277	95735	472	0	99719
5009	830	97428	1657	575	0	100490
5010	94892	2429	969	854	0	99144
5011	94425	861	442	668	0	96396
5012	2390	685	94138	251	0	97464
5013	1571	445	1672	89644	0	93332
5014	1074	343	721	95912	0	98050
5015	616	382	95098	2121	0	98217
5016	866	288	1741	92046	0	94941
5017	491	356	95081	2171	0	98099
5018	531	308	91518	1020	0	93377
5019	90199	232	2157	1089	0	93677
5020	1784	93908	1068	529	0	97289
5021	93690	1637	694	604	0	96625
5022	2444	676	461	93701	0	97282
5023	1061	626	95671	1617	0	98975
5024	1209	396	1623	91872	0	95100
5025	662	95950	792	1771	0	99175
5026	97163	1588	592	1223	0	100566
5027	98103	685	320	1026	0	100134
5028	2492	514	304	97938	0	101248
5029	1239	390	95970	1773	0	99372
5030	90561	344	1566	1170	0	93641
5031	1999	94701	696	673	0	98069
5032	95150	1658	491	657	0	97956
5033	2519	811	297	94203	0	97830
5034	94594	643	265	1886	0	97388
5035	2598	534	186	93577	0	96895
5036	1198	534	93793	2073	0	97598
5037	1126	397	89641	1067	0	92231
5038	88135	274	1883	1429	0	91721
5039	1922	94291	965	638	0	97816
5040	92421	1402	714	754	0	95291
5041	93219	720	348	662	0	94949
5042	1848	93891	292	265	0	96296
5043	92324	1673	191	653	0	94841
5044	2055	904	97569	325	0	100853
5045	1225	851	1312	97970	0	101358
5046	1162	576	546	98564	0	100848
5047	873	540	445	101223	0	103081
5048	727	525	99442	2097	0	102791
5049	641	525	99029	1051	0	101246
5050	681	473	1954	98822	0	101930
5051	499	98355	1087	1584	0	101525
5052	534	102809	645	792	0	104780
5053	102222	1992	398	1043	0	105655
5054	102940	909	487	897	0	105233
5055	2004	106330	531	594	0	109459
5056	1227	1803	300	108177	0	111507
5057	912	875	335	109702	0	111824
5058	110270	667	452	2654	0	114043
5059	2162	416	417	112604	0	115599
5060	1225	431	499	112534	0	114689
5061	1119	447	464	113675	0	115705
5062	798	602	106715	2560	0	110675
5063	903	639	98435	1365	0	101342
5064	105357	264	2084	1456	0	109161
5065	2107	267	1087	113004	0	116465
5066	986	364	112297	2221	0	115868
5067	896	478	107957	1113	0	110444
5068	108239	448	2463	1361	0	112511
5069	2482	464	122918	603	0	126467
5070	1155	125077	2590	712	0	129534
5071	1169	2192	1168	136037	0	140566
5072	871	979	136219	2661	0	140730
5073	134273	813	2814	1542	0	139442
5074	3606	552	1188	144514	0	149860
5075	1505	493	144049	3329	0	149376
5076	1492	369	3222	144416	0	149499
5077	1183	318	1484	147500	0	150485
5078	147133	254	1044	4722	0	153153
5079	3374	148561	937	2115	0	154987
5080	2055	2935	789	148047	0	153826
5081	148952	1228	602	3971	0	154753
5082	150596	839	495	2139	0	154069
5083	151733	459	499	1752	0	154443
5084	154091	570	460	1316	0	156437
5085	5401	484	487	150243	0	156615
5086	147706	277	630	4152	0	152765
5087	149836	279	586	2300	0	153001
5088	143463	291	498	2211	0	146463
5089	145928	267	604	1778	0	148577
5090	4941	137761	638	1181	0	144521
5091	1553	129852	255	538	0	132198
5092	1438	2745	220	127991	0	132394
5093	719	127810	298	2191	0	131018
5094	127572	2348	235	1456	0	131611
5095	2978	970	147	127052	0	131147
5096	126784	488	171	2758	0	130201
5097	128525	301	177	1494	0	130497
5098	3481	237	140	130724	0	134582
5099	1846	243	202	129932	0	132223
5100	1008	129660	267	2843	0	133778
5101	129691	2009	166	1877	0	133743
5102	2627	129371	302	837	0	133137
5103	130603	2257	176	1091	0	134127
5104	3150	998	163	131388	0	135699
5105	1412	713	129294	2343	0	133762
5106	126450	447	2023	1747	0	130667
5107	123018	499	756	1354	0	125627
5108	3354	461	121577	616	0	126008
5109	1729	436	121473	620	0	124258
5110	1713	332	2637	118464	0	123146
5111	127905	301	1062	2888	0	132156
5112	132183	290	525	1852	0	134850
5113	134272	324	399	1634	0	136629
5114	136336	375	332	1235	0	138278
5115	4114	133735	361	714	0	138924
5116	139295	2630	272	1143	0	143340
5117	4132	1001	289	136980	0	142402
5118	2317	599	298	138147	0	141361
5119	1863	367	348	142009	0	144587
5120	1674	404	281	144593	0	146952
5121	141644	430	334	4701	0	147109
5122	3984	349	450	147574	0	152357
5123	1748	484	143852	4012	0	150096
5124	1788	294	3039	147107	0	152228
5125	1730	274	1194	149417	0	152615
5126	1729	280	651	149446	0	152106
5127	1698	287	456	149280	0	151721
5128	144122	303	386	5715	0	150526
5129	3929	142711	480	2448	0	149568
5130	2034	145988	477	1632	0	150131
5131	1785	4102	443	144350	0	150680
5132	141653	1667	459	4686	0	148465
5133	147256	810	418	2687	0	151171
5134	5320	492	423	146919	0	153154
5135	2496	576	142317	4340	0	149729
5136	141881	465	3277	2755	0	148378
5137	4691	483	1414	147926	0	154514
5138	2321	599	146711	4502	0	154133
5139	139225	448	3556	3109	0	146338
5140	4547	145305	1381	1962	0	153195
5141	160911	3478	710	2019	0	167118
5142	5971	165398	546	1364	0	173279
5143	3913	5197	354	164112	0	173576
5144	2321	167390	481	5412	0	175604
5145	2410	6259	318	171887	0	180874
5146	164274	2712	315	7561	0	174862
5147	5947	168167	399	3777	0	178290
5148	3282	5436	166351	2433	0	177502
5149	3021	2761	4901	167478	0	178161
5150	1810	1826	169172	6068	0	178876
5151	2308	1122	5912	165224	0	174566
5152	2125	844	2809	171938	0	177716
5153	1515	887	166258	8022	0	176682
5154	151272	801	5590	5305	0	162968
5155	6168	798	163469	2864	0	173299
5156	3392	937	162094	1994	0	168417
5157	2282	160922	7175	2100	0	172479
5158	2211	5369	3539	159670	0	170789
5159	1989	2699	2030	163620	0	170338
5160	2340	1875	1154	159897	0	165266
5161	1862	1328	936	166733	0	170859
5162	1260	1017	158021	9278	0	169576
5163	148442	817	5298	5987	0	160544
5164	5732	706	159277	3467	0	169182
5165	3561	598	6122	154652	0	164933
5166	152603	516	3068	7037	0	163224
5167	5684	153118	2287	4033	0	165122
5168	3760	5883	1472	149206	0	160321
5169	142585	2348	1327	6337	0	152597
5170	5496	136904	1262	3508	0	147170
5171	2556	135051	843	2207	0	140657
5172	130540	5878	769	2283	0	139470
5173	4707	132412	660	1580	0	139359
5174	125329	5127	614	1898	0	132968
5175	5051	128047	660	1391	0	135149
5176	127563	4970	726	1515	0	134774
5177	129321	2430	551	1494	0	133796
5178	6216	128374	804	1364	0	136758
5179	3861	4460	561	126098	0	134980
5180	2340	2417	124141	4474	0	133372
5181	122351	1801	3959	2818	0	130929
5182	5082	1159	1948	122535	0	130724
5183	2808	119680	1418	4735	0	128641
5184	1848	125067	892	2784	0	130591
5185	1521	5600	732	124612	0	132465
5186	123054	2900	731	5258	0	131943
5187	4510	1965	122361	2900	0	131736
5188	3012	1173	4013	124454	0	132652
5189	2153	1200	2070	127270	0	132693
5190	1713	909	1481	129772	0	133875
5191	1649	792	932	126767	0	130140
5192	1024	122252	982	7362	0	131620
5193	1294	4169	756	126417	0	132636
5194	1114	2377	121407	6234	0	131132
5195	1061	1778	120924	3483	0	127246
5196	1004	1272	123108	2644	0	128028
5197	1237	1229	6229	119231	0	127926
5198	116289	1154	3319	5163	0	125925
5199	4467	1106	117079	2990	0	125642
5200	2713	944	118947	2285	0	124889
5201	2235	794	6156	115383	0	124568
5202	115326	783	3330	5494	0	124933
5203	4504	115378	2159	3265	0	125306
5204	115772	4300	1407	2868	0	124347
5205	5655	2392	1235	115175	0	124457
5206	3014	2060	116088	4965	0	126127
5207	2394	1921	4373	111367	0	120055
5208	1547	115565	2640	5342	0	125094
5209	119055	4576	1874	3218	0	128723
5210	4796	2621	118861	2397	0	128675
5211	2484	115430	4327	1968	0	124209
5212	112580	4635	2847	1891	0	121953
5213	5211	2562	1985	112261	0	122019
5214	3068	1749	1320	115721	0	121858
5215	114262	1077	1231	6647	0	123217
5216	115922	920	1115	4045	0	122002
5217	120342	999	1138	2689	0	125168
5218	7841	914	941	113525	0	123221
5219	4032	111540	888	5207	0	121667
5220	113152	4087	918	3455	0	121612
5221	5115	113155	872	2625	0	121767
5222	107909	4670	810	1764	0	115153
5223	5401	105846	897	1309	0	113453
5224	3252	4627	804	103578	0	112261
5225	104581	2636	601	4538	0	112356
5226	106564	1864	526	2939	0	111893
5227	108263	1241	472	2462	0	112438
5228	109672	991	501	1874	0	113038
5229	109931	848	526	1592	0	112897
5230	7351	920	103291	1217	0	112779
5231	4896	830	3565	102883	0	112174
5232	3027	847	104408	4013	0	112295
5233	2251	977	104064	2410	0	109702
5234	101904	864	5310	1960	0	110038
5235	104811	960	2957	1496	0	110224
5236	106135	865	1759	1157	0	109916
5237	7184	1019	1009	99816	0	109028
5238	100474	799	859	4303	0	106435
5239	5815	96827	771	2631	0	106044
5240	3711	98741	710	1890	0	105052
5241	1967	87197	395	886	0	90445
5242	78590	2904	715	923	0	83132
5243	2724	79802	393	716	0	83635
5244	75717	2043	507	667	0	78934
5245	75184	882	291	664	0	77021
5246	2953	602	73862	444	0	77861
5247	1979	464	1900	72079	0	76422
5248	1479	418	807	76486	0	79190
5249	76471	381	543	2762	0	80157
5250	77457	346	344	1455	0	79602
5251	3401	386	304	75754	0	79845
5252	1800	388	74665	2256	0	79109
5253	1325	473	75354	1111	0	78263
5254	1316	458	2439	75533	0	79746
5255	1286	424	1036	75753	0	78499
5256	1104	462	533	78072	0	80171
5257	74276	402	391	3150	0	78219
5258	75443	461	334	1565	0	77803
5259	3192	74238	401	954	0	78785
5260	2011	2076	410	74042	0	78539
5261	1502	879	401	74974	0	77756
5262	1140	74844	404	2798	0	79186
5263	1317	2115	389	75814	0	79635
5264	75693	926	369	2877	0	79865
5265	3001	548	465	75174	0	79188
5266	1906	447	417	76805	0	79575
5267	74664	395	410	3303	0	78772
5268	75100	390	387	1889	0	77766
5269	75853	386	441	1383	0	78063
5270	3840	636	444	72941	0	77861
5271	1941	446	69908	2443	0	74738
5272	1544	450	69022	1326	0	72342
5273	1268	449	69142	1021	0	71880
5274	1126	66650	2451	869	0	71096
5275	65275	1929	1304	1001	0	69509
5276	2500	969	64373	706	0	68548
5277	63187	554	1789	833	0	66363
5278	2667	426	964	62918	0	66975
5279	59034	467	686	2632	0	62819
5280	64908	389	499	1530	0	67326
5281	2823	64912	501	915	0	69151
5282	66426	1698	367	1091	0	69582
5283	66857	835	420	1061	0	69173
5284	3017	65573	517	815	0	69922
5285	2058	1670	494	66828	0	71050
5286	1359	876	66908	2147	0	71290
5287	1338	536	1792	65553	0	69219
5288	1201	477	950	67272	0	69900
5289	66660	460	625	2919	0	70664
5290	2615	457	504	66158	0	69734
5291	1564	66962	497	2353	0	71376
5292	1359	1936	407	67095	0	70797
5293	1135	967	379	68794	0	71275
5294	1091	659	66445	2955	0	71150
5295	1061	64966	1790	1809	0	69626
5296	1159	67645	881	1228	0	70913
5297	64988	2367	551	1242	0	69148
5298	2274	67660	451	1049	0	71434
5299	1596	2242	467	66933	0	71238
5300	1149	1155	66776	2367	0	71447
5301	966	67242	1954	1510	0	71672
5302	67430	1983	1077	1245	0	71735
5303	2515	1129	757	67226	0	71627
5304	1628	748	594	69048	0	72018
5305	1132	618	67675	2891	0	72316
5306	1130	535	1898	65533	0	69096
5307	1164	474	999	67929	0	70566
5308	65424	487	720	3158	0	69789
5309	61576	491	452	1814	0	64333
5310	2776	60371	430	1142	0	64719
5311	56451	1440	316	991	0	59198
5312	1946	55364	318	776	0	58404
5313	1198	1836	316	51124	0	54474
5314	799	51938	314	1475	0	54526
5315	684	53861	295	1010	0	55850
5316	50733	1544	577	950	0	53804
5317	49586	693	262	787	0	51328
5318	1487	49041	235	543	0	51306
5319	49467	1093	267	608	0	51435
5320	49392	520	178	697	0	50787
5321	51398	335	220	710	0	52663
5322	1638	312	221	51974	0	54145
5323	52048	362	182	1436	0	54028
5324	1410	361	49658	718	0	52147
5325	48851	272	946	738	0	50807
5326	1414	363	51491	413	0	53681
5327	878	311	1060	52269	0	54518
5328	728	343	444	53715	0	55230
5329	566	364	52866	1422	0	55218
5330	50596	268	955	996	0	52815
5331	52960	298	506	705	0	54469
5332	1537	304	56176	497	0	58514
5333	1016	260	1026	55058	0	57360
5334	759	221	502	55717	0	57199
5335	607	219	296	57552	0	58674
5336	56165	219	272	1723	0	58379
5337	56562	206	313	922	0	58003
5338	1628	230	255	54590	0	56703
5339	716	52452	215	1088	0	54471
5340	464	51887	216	558	0	53125
5341	49449	915	159	544	0	51067
5342	927	49623	187	353	0	51090
5343	444	48835	129	350	0	49758
5344	423	683	141	44894	0	46141
5345	224	288	45458	517	0	46487
5346	161	44415	441	282	0	45299
5347	283	714	205	43760	0	44962
5348	157	44238	119	464	0	44978
5349	230	431	90	43682	0	44433
5350	43486	139	77	656	0	44358
5351	410	44542	64	273	0	45289
5352	44896	380	51	366	0	45693
5353	43790	146	72	328	0	44336
5354	496	155	43303	133	0	44087
5355	42552	110	334	260	0	43256
5356	519	114	103	44573	0	45309
5357	185	115	45237	369	0	45906
5358	136	45017	331	184	0	45668
5359	195	410	114	44130	0	44849
5360	173	155	79	44628	0	45035
5361	44522	98	66	529	0	45215
5362	397	99	37	44537	0	45070
5363	224	97	47	44516	0	44884
5364	44513	81	32	607	0	45233
5365	353	44390	55	233	0	45031
5366	43554	306	57	366	0	44283
5367	385	147	43829	118	0	44479
5368	39941	98	298	366	0	40703
5369	436	119	45749	78	0	46382
5370	190	46673	340	98	0	47301
5371	46950	370	108	316	0	47744
5372	45472	159	91	338	0	46060
5373	491	144	46326	95	0	47056
5374	289	123	46907	122	0	47441
5375	231	132	48363	103	0	48829
5376	143	51131	592	122	0	51988
5377	239	513	207	52049	0	53008
5378	174	205	57142	529	0	58050
5379	174	195	55497	187	0	56053
5380	371	106	1016	56030	0	57523
5381	199	119	58352	747	0	59417
5382	56726	86	906	624	0	58342
5383	65350	76	398	522	0	66346
5384	1472	138	65430	114	0	67154
5385	663	65159	1176	183	0	67181
5386	625	1048	547	64815	0	67035
5387	247	531	66961	1060	0	68799
5388	186	66041	1208	576	0	68011
5389	495	1258	610	65226	0	67589
5390	65931	501	344	1430	0	68206
5391	65759	241	202	962	0	67164
5392	1393	67910	231	362	0	69896
5393	934	1085	174	68161	0	70354
5394	588	467	168	68791	0	70014
5395	489	322	185	67842	0	68838
5396	446	186	135	69052	0	69819
5397	243	178	67904	1793	0	70118
5398	448	127	1082	66848	0	68505
5399	158	194	67368	1384	0	69104
5400	139	66191	1227	751	0	68308
5401	65340	1007	584	750	0	67681
5402	1010	69149	359	291	0	70809
5403	713	1190	178	69478	0	71559
5404	570	556	140	69824	0	71090
5405	68964	308	98	1812	0	71182
5406	1201	178	106	69562	0	71047
5407	518	68738	141	1354	0	70751
5408	522	984	105	70634	0	72245
5409	383	546	109	70746	0	71784
5410	69319	309	110	1944	0	71682
5411	1071	229	68777	873	0	70950
5412	580	67766	897	480	0	69723
5413	338	70277	475	331	0	71421
5414	351	1336	240	69098	0	71025
5415	67702	648	118	1422	0	69890
5416	919	68058	138	693	0	69808
5417	684	1041	74	68804	0	70603
5418	328	573	67993	1149	0	70043
5419	356	337	937	67655	0	69285
5420	68165	194	468	1583	0	70410
5421	67009	171	300	876	0	68356
5422	1560	138	148	66462	0	68308
5423	67440	176	116	1450	0	69182
5424	66850	167	97	982	0	68096
5425	1522	159	66434	468	0	68583
5426	63225	147	996	553	0	64921
5427	1278	65990	523	292	0	68083
5428	66357	1019	276	541	0	68193
5429	1366	578	65320	216	0	67480
5430	835	349	1046	65903	0	68133
5431	67679	177	540	1428	0	69824
5432	1335	177	63668	642	0	65822
5433	770	145	64424	438	0	65777
5434	754	133	1594	63322	0	65803
5435	367	144	65894	1254	0	67659
5436	63530	106	1490	932	0	66058
5437	1361	182	67167	428	0	69138
5438	962	127	1485	67561	0	70135
5439	621	117	773	69850	0	71361
5440	72147	111	519	2301	0	75078
5441	1630	162	72573	1034	0	75399
5442	885	141	76297	561	0	77884
5443	841	104	2324	79741	0	83010
5444	357	122	82172	1948	0	84599
5445	79258	107	2376	1112	0	82853
5446	2260	92	1130	81129	0	84611
5447	962	129	82025	2147	0	85263
5448	896	106	2305	80976	0	84283
5449	776	93	1086	82959	0	84914
5450	82375	96	636	3103	0	86210
5451	2258	178	82088	1309	0	85833
5452	78500	152	2216	1083	0	81951
5453	2516	175	84123	665	0	87479
5454	81909	130	2563	827	0	85429
5455	83817	170	1218	798	0	86003
5456	84047	111	755	867	0	85780
5457	3130	81255	588	628	0	85601
5458	82978	1859	508	779	0	86124
5459	83843	776	428	772	0	85819
5460	3346	394	378	82359	0	86477
5461	1509	257	81859	2397	0	86022
5462	78843	146	2234	1541	0	82764
5463	2484	174	83803	965	0	87426
5464	1628	169	2516	81817	0	86130
5465	1264	150	1292	85609	0	88315
5466	84722	124	792	3222	0	88860
5467	2443	86464	682	1444	0	91033
5468	1691	1980	489	85621	0	89781
5469	1376	866	391	86921	0	89554
5470	832	558	85617	3015	0	90022
5471	1073	306	2172	84330	0	87881
5472	1095	207	1054	87023	0	89379
5473	1110	170	713	84606	0	86599
5474	628	82897	603	3126	0	87254
5475	80696	1860	459	1944	0	84959
5476	81469	762	428	1488	0	84147
5477	2799	81282	469	861	0	85411
5478	76275	1777	320	884	0	79256
5479	2591	749	299	79979	0	83618
5480	1151	442	84040	2232	0	87865
5481	728	83223	2118	1180	0	87249
5482	636	87023	913	999	0	89571
5483	84313	1966	738	840	0	87857
5484	88829	636	485	721	0	90671
5485	2909	368	344	88574	0	92195
5486	1507	248	317	90356	0	92428
5487	1060	218	249	90929	0	92456
5488	88016	265	301	3329	0	91911
5489	2545	300	86782	1289	0	90916
5490	87119	203	2145	1086	0	90553
5491	2896	222	815	88232	0	92165
5492	1507	228	587	86872	0	89194
5493	904	86836	526	2817	0	91083
5494	1099	1952	496	89202	0	92749
5495	1017	731	462	91181	0	93391
5496	809	545	90827	3029	0	95210
5497	784	91558	2119	1486	0	95947
5498	93461	2118	823	1444	0	97846
5499	90687	778	580	1530	0	93575
5500	95453	480	505	1255	0	97693
5501	94922	346	456	1247	0	96971
5502	3262	389	90601	769	0	95021
5503	88978	302	2290	933	0	92503
5504	3109	350	91800	705	0	95964
5505	1849	269	2359	88832	0	93309
5506	1152	91992	974	2509	0	96627
5507	1279	2123	657	92751	0	96810
5508	1232	844	588	94686	0	97350
5509	930	597	93415	3226	0	98168
5510	88864	449	2414	1935	0	93662
5511	92455	418	1058	1556	0	95487
5512	3076	91053	852	1254	0	96235
5513	1619	2173	92072	1081	0	96945
5514	1570	873	2367	92350	0	97160
5515	1200	708	93334	2739	0	97981
5516	1161	652	92143	1410	0	95366
5517	1369	552	2874	92343	0	97138
5518	1169	529	93428	2822	0	97948
5519	1343	472	2622	92818	0	97255
5520	1252	494	95908	3134	0	100788
5521	1360	448	2689	95747	0	100244
5522	96533	378	1255	3628	0	101794
5523	97196	408	1002	2167	0	100773
5524	96998	417	781	1861	0	100057
5525	96187	451	710	1666	0	99014
5526	3438	95521	720	1296	0	100975
5527	1923	2281	662	96131	0	100997
5528	1551	838	697	98285	0	101371
5529	1239	708	95549	3531	0	101027
5530	1360	639	2431	94357	0	98787
5531	1059	607	94782	3255	0	99703
5532	1054	582	91230	1802	0	94668
5533	88439	445	2826	1748	0	93458
5534	2526	95674	1439	1415	0	101054
5535	96444	2126	1002	1581	0	101153
5536	97147	856	848	1458	0	100309
5537	3377	98243	814	1162	0	103596
5538	98599	1937	774	1495	0	102805
5539	2968	835	98745	980	0	103528
5540	1389	97547	2086	885	0	101907
5541	97167	1868	1106	1328	0	101469
5542	2331	845	93643	976	0	97795
5543	87659	537	1645	1132	0	90973
5544	1957	92594	835	819	0	96205
5545	92596	1526	627	1152	0	95901
5546	92434	641	558	1080	0	94713
5547	2165	91024	655	627	0	94471
5548	1163	90374	633	544	0	92714
5549	887	94113	595	582	0	96177
5550	890	1780	656	94812	0	98138
5551	831	705	616	95823	0	97975
5552	96414	454	670	2407	0	99945
5553	94269	368	630	1491	0	96758
5554	2140	402	94295	865	0	97702
5555	1123	410	91002	832	0	93367
5556	886	345	94636	821	0	96688
5557	1098	287	2325	94777	0	98487
5558	973	313	97746	1956	0	100988
5559	1203	317	2044	96281	0	99845
5560	97523	342	833	2531	0	101229
5561	2286	422	97943	866	0	101517
5562	96088	394	1985	1176	0	99643
5563	97925	387	886	1174	0	100372
5564	2357	384	99557	787	0	103085
5565	1102	100670	2183	748	0	104703
5566	1277	1684	1025	99526	0	103512
5567	809	695	101966	2063	0	105533
5568	1311	451	2341	97841	0	101944
5569	1081	350	1098	108046	0	110575
5570	106080	427	761	2788	0	110056
5571	2747	465	640	105850	0	109702
5572	1196	476	105973	2409	0	110054
5573	1363	431	2161	105174	0	109129
5574	106631	423	938	2821	0	110813
5575	2551	107347	784	992	0	111674
5576	107513	2083	749	1111	0	111456
5577	3001	1128	751	106670	0	111550
5578	1273	644	107384	2129	0	111430
5579	1039	528	102440	824	0	104831
5580	1021	408	101089	617	0	103135
5581	578	97091	2319	433	0	100421
5582	93809	2032	1408	1033	0	98282
5583	1727	91862	501	317	0	94407
5584	87054	1366	283	650	0	89353
5585	1483	87315	245	182	0	89225
5586	726	1414	203	87247	0	89590
5587	640	369	200	88087	0	89296
5588	495	272	193	87923	0	88883
5589	210	87515	259	1671	0	89655
5590	544	1390	202	91508	0	93644
5591	581	404	186	105437	0	106608
5592	110337	276	198	2800	0	113611
5593	3120	193	199	114980	0	118492
5594	704	345	119993	2788	0	123830
5595	115841	208	2751	1409	0	120209
5596	120544	214	745	1106	0	122609
5597	3445	121327	557	586	0	125915
5598	121350	3043	295	905	0	125593
5599	124291	823	244	892	0	126250
5600	4593	490	248	121171	0	126502
5601	2255	292	280	124038	0	126865
5602	1632	270	288	127687	0	129877
5603	124823	273	267	4922	0	130285
5604	126930	313	233	2101	0	129577
5605	4498	365	123408	933	0	129204
5606	121863	277	3155	1337	0	126632
5607	125503	245	983	1224	0	127955
5608	125866	248	571	1200	0	127885
5609	4910	264	120791	709	0	126674
5610	1977	334	122674	690	0	125675
5611	2063	229	4045	120888	0	127225
5612	1213	313	124222	3688	0	129436
5613	1718	195	3896	119299	0	125108
5614	1954	319	1368	111487	0	115128
5615	1049	122512	997	3816	0	128374
5616	122339	3307	798	2122	0	128566
5617	4251	1039	123980	1059	0	130329
5618	124045	596	3805	1202	0	129648
5619	5152	450	1423	126413	0	133438
5620	123277	383	988	4563	0	129211
5621	4776	120506	823	1783	0	127888
5622	2057	126928	781	1490	0	131256
5623	2164	4376	948	123311	0	130799
5624	2027	1420	693	127413	0	131553
5625	1361	892	124393	5181	0	131827
5626	1973	577	3923	123791	0	130264
5627	119510	484	1405	5574	0	126973
5628	4341	121809	1115	2118	0	129383
5629	2192	3896	121729	1425	0	129242
5630	2310	1320	4034	120698	0	128362
5631	1561	856	123228	4430	0	130075
5632	2012	577	4426	121416	0	128431
5633	1263	578	123626	4947	0	130414
5634	1167	669	120475	2212	0	124523
5635	1551	711	4966	118387	0	125615
5636	118978	621	2047	5070	0	126716
5637	118327	583	1403	2417	0	122730
5638	114740	544	1196	2113	0	118593
5639	5340	112217	1215	1494	0	120266
5640	114079	3670	1033	1628	0	120410
5641	114210	1330	987	1716	0	118243
5642	5427	929	110291	1279	0	117926
5643	2459	108763	4063	1341	0	116626
5644	2317	4042	1637	106602	0	114598
5645	106316	1363	1136	4623	0	113438
5646	4482	106802	1038	2130	0	114452
5647	109022	3933	979	1847	0	115781
5648	111265	1430	999	1653	0	115347
5649	110144	1020	892	1656	0	113712
5650	109974	919	915	1438	0	113246
5651	6209	854	823	105020	0	112906
5652	105652	709	851	4569	0	111781
5653	5372	763	861	102791	0	109787
5654	2466	100501	976	4420	0	108363
5655	2234	3220	886	103060	0	109400
5656	102504	1149	956	4663	0	109272
5657	4673	842	101270	2188	0	108973
5658	2772	595	3580	101730	0	108677
5659	100372	559	1566	4535	0	107032
5660	4684	99666	1146	2129	0	107625
5661	100406	3414	928	1837	0	106585
5662	102424	1340	906	1569	0	106239
5663	5389	100756	998	1367	0	108510
5664	100582	3487	966	1395	0	106430
5665	5013	1421	95319	1187	0	102940
5666	2656	1003	95121	1267	0	100047
5667	93343	862	4010	1382	0	99597
5668	4683	966	93547	1111	0	100307
5669	2859	851	3343	84487	0	91540
5670	2285	87646	1495	3047	0	94473
5671	89085	3169	1088	1619	0	94961
5672	4362	87027	947	1261	0	93597
5673	2608	87612	1032	1057	0	92309
5674	2284	3576	919	90454	0	97233
5675	2060	1483	823	91751	0	96117
5676	1963	1060	752	91059	0	94834
5677	1840	913	732	91847	0	95332
5678	1479	871	87558	4399	0	94307
5679	1570	784	3031	85698	0	91083
5680	1527	762	1314	87835	0	91438
5681	85103	747	925	4240	0	91015
5682	3698	718	868	85282	0	90566
5683	1845	732	82368	3905	0	88850
5684	82017	690	2759	2075	0	87541
5685	3923	804	1170	83414	0	89311
5686	2056	806	85635	3239	0	91736
5687	1886	919	2949	83723	0	89477
5688	1470	85826	1349	3262	0	91907
5689	86227	2587	1085	1905	0	91804
5690	3480	1027	82259	1288	0	88054
5691	1339	68704	2196	843	0	73082
5692	62336	1558	1161	779	0	65834
5693	1701	56046	597	544	0	58888
5694	726	52149	349	413	0	53637
5695	50895	1227	751	449	0	53322
5696	1172	49200	311	386	0	51069
5697	565	48892	299	305	0	50061
5698	878	1128	390	47744	0	50140
5699	398	424	47805	825	0	49452
5700	365	48770	729	451	0	50315
5701	420	804	267	47439	0	48930
5702	250	46945	157	569	0	47921
5703	46601	546	97	437	0	47681
5704	617	263	45711	318	0	46909
5705	405	206	471	46197	0	47279
5706	48258	141	218	752	0	49369
5707	635	186	140	49203	0	50164
5708	325	151	48959	652	0	50087
5709	46166	136	521	448	0	47271
5710	49182	148	235	363	0	49928
5711	677	52353	175	254	0	53459
5712	423	504	121	52552	0	53600
5713	313	240	136	53800	0	54489
5714	54410	158	140	807	0	55515
5715	52775	147	157	434	0	53513
5716	750	203	54615	198	0	55766
5717	312	53342	518	149	0	54321
5718	53568	364	157	232	0	54321
5719	486	146	102	53422	0	54156
5720	201	131	55055	443	0	55830
5721	195	131	52137	170	0	52633
5722	196	464	390	53291	0	54341
5723	54532	33	144	465	0	55174
5724	296	54173	81	113	0	54663
5725	60443	276	35	389	0	61143
5726	408	80	37	61905	0	62430
5727	178	61	36	62295	0	62570
5728	173	45	24	63422	0	63664
5729	63650	33	43	576	0	64302
5730	278	64942	64	203	0	65487
5731	167	251	32	66378	0	66828
5732	129	73	31	66291	0	66524
5733	65	78	66522	326	0	66991
5734	192	55	241	64519	0	65007
5735	64	76	67564	296	0	68000
5736	56	66142	292	165	0	66655
5737	90	244	82	67479	0	67895
5738	66473	76	49	432	0	67030
5739	279	79	66690	103	0	67151
5740	186	29	258	67188	0	67661
5741	81	69	67281	253	0	67684
5742	62279	25	274	368	0	62946
5743	287	84	68506	70	0	68947
5744	209	71	284	65950	0	66514
5745	68099	18	80	454	0	68651
5746	327	61422	169	140	0	62058
5747	65311	237	44	242	0	65834
5748	349	61175	121	99	0	61744
5749	191	276	50	67892	0	68409
5750	108	122	66880	271	0	67381
5751	144	204	63606	152	0	64106
5752	201	40	338	67240	0	67819
5753	69915	30	155	524	0	70624
5754	68100	56	79	344	0	68579
5755	499	39	53	68908	0	69499
5756	259	49	58	69663	0	70029
5757	68978	36	53	624	0	69691
5758	357	66188	84	210	0	66839
5759	151	70084	77	126	0	70438
5760	70813	368	45	322	0	71548
5761	395	204	69999	94	0	70692
5762	338	77	335	69375	0	70125
5763	128	107	70296	392	0	70923
5764	248	54	364	69696	0	70362
5765	114	104	70945	411	0	71574
5766	167	133	68169	196	0	68665
5767	239	45	451	71590	0	72325
5768	88	68974	254	355	0	69671
5769	73256	337	116	369	0	74078
5770	386	72518	131	149	0	73184
5771	266	380	95	74411	0	75152
5772	74876	130	91	639	0	75736
5773	518	84	92	76543	0	77237
5774	76898	63	95	754	0	77810
5775	76085	71	69	495	0	76720
5776	77124	61	87	408	0	77680
5777	521	74847	116	205	0	75689
5778	79071	361	67	359	0	79858
5779	542	275	68	80968	0	81853
5780	83854	86	83	765	0	84788
5781	659	99	62	86069	0	86889
5782	86215	67	69	936	0	87287
5783	87359	90	74	545	0	88068
5784	852	86475	127	256	0	87710
5785	492	638	68	95086	0	96284
5786	428	228	83	95253	0	95992
5787	215	100459	124	1188	0	101986
5788	378	1148	85	103624	0	105235
5789	103257	380	77	1734	0	105448
5790	107663	201	93	922	0	108879
5791	105316	137	96	837	0	106386
5792	1942	205	112005	261	0	114413
5793	114112	99	1350	714	0	116275
5794	121243	75	473	562	0	122353
5795	122434	84	256	645	0	123419
5796	2248	121691	198	251	0	124388
5797	1247	1479	110	123739	0	126575
5798	873	590	92	125481	0	127036
5799	720	293	98	124313	0	125424
5800	362	224	121754	2355	0	124695
5801	705	195	1544	121819	0	124263
5802	123737	128	595	2423	0	126883
5803	2142	112	327	124732	0	127313
5804	1283	118	168	128043	0	129612
5805	721	191	126224	2376	0	129512
5806	489	124029	1841	1160	0	127519
5807	128836	1724	653	1008	0	132221
5808	2357	617	341	129037	0	132352
5809	129383	354	218	2495	0	132450
5810	2301	359	126781	891	0	130332
5811	118241	196	1782	1259	0	121478
5812	2182	129753	709	733	0	133377
5813	1022	1746	129199	538	0	132505
5814	671	710	129289	476	0	131146
5815	1072	519	2306	123738	0	127635
5816	513	323	133810	1942	0	136588
5817	403	133196	2051	1058	0	136708
5818	881	1695	788	132270	0	135634
5819	727	678	511	135309	0	137225
5820	758	448	332	136180	0	137718
5821	133747	275	293	2937	0	137252
5822	1950	133639	301	1355	0	137245
5823	1275	1660	273	136764	0	139972
5824	985	666	363	138706	0	140720
5825	133524	425	298	2877	0	137124
5826	1911	133791	323	1432	0	137457
5827	135906	1814	341	1379	0	139440
5828	135510	793	376	1191	0	137870
5829	134562	427	299	1304	0	136592
5830	2856	400	133088	654	0	136998
5831	1714	383	1768	129768	0	133633
5832	985	132291	880	2034	0	136190
5833	804	136136	546	1224	0	138710
5834	1094	2325	330	134644	0	138393
5835	800	134931	421	2082	0	138234
5836	142545	2168	300	1794	0	146807
5837	2268	1072	141470	942	0	145752
5838	137420	592	1826	1402	0	141240
5839	145732	429	742	1274	0	148177
5840	3104	478	546	147492	0	151620
5841	148300	419	474	2848	0	152041
5842	2730	159143	438	1302	0	163613
5843	162044	2064	380	1882	0	166370
5844	162847	949	453	1611	0	165860
5845	174904	697	487	1611	0	177699
5846	3893	711	177153	867	0	182624
5847	2153	924	177368	871	0	181316
5848	2020	527	3459	178333	0	184339
5849	1340	176328	1654	3083	0	182405
5850	1269	183409	1069	1543	0	187290
5851	1496	3452	673	181583	0	187204
5852	183451	1694	512	3914	0	189571
5853	3657	1061	559	183660	0	188937
5854	2084	698	533	187033	0	190348
5855	184788	581	544	4898	0	190811
5856	3449	184832	693	2344	0	191318
5857	2013	3000	183715	1592	0	190320
5858	1774	1451	180128	1284	0	184637
5859	185380	952	3647	1682	0	191661
5860	3879	784	1859	184642	0	191164
5861	1782	728	191090	3336	0	196936
5862	1940	639	3166	185286	0	191031
5863	1683	740	1392	185901	0	189716
5864	1383	712	1015	192025	0	195135
5865	1370	705	725	189144	0	191944
5866	1071	185810	771	4620	0	192272
5867	1298	2952	682	189588	0	194520
5868	187025	1319	700	4711	0	193755
5869	3361	186257	868	2164	0	192650
5870	190557	3141	758	2299	0	196755
5871	192661	1430	798	2060	0	196949
5872	193150	1106	831	1968	0	197055
5873	4694	1036	186531	1175	0	193436
5874	185767	782	2937	1986	0	191472
5875	193070	692	1432	1750	0	196944
5876	188977	720	1012	2014	0	192723
5877	192424	622	713	1975	0	195734
5878	4623	190315	735	1371	0	197044
5879	188631	3001	524	1786	0	193942
5880	4038	1622	187474	1089	0	194223
5881	2505	1105	2647	183428	0	189685
5882	2214	787	1062	187477	0	191540
5883	190298	631	815	4390	0	196134
5884	3715	188469	603	2005	0	194792
5885	182115	2465	376	1992	0	186948
5886	3449	182849	476	821	0	187595
5887	177568	2383	340	1339	0	181630
5888	176912	904	285	1247	0	179348
5889	3179	191982	351	497	0	196009
5890	192661	2804	300	1189	0	196954
5891	200391	1121	413	1188	0	203113
5892	4504	187711	422	431	0	193068
5893	1828	193176	388	419	0	195811
5894	201660	3845	701	975	0	207181
5895	5139	1526	252	205269	0	212186
5896	206186	981	224	4809	0	212200
5897	213045	578	158	2202	0	215983
5898	214827	498	157	1858	0	217340
5899	214202	482	162	1639	0	216485
5900	6664	206339	425	673	0	214101
5901	2925	214407	391	614	0	218337
5902	213812	5109	328	1451	0	220700
5903	5405	2310	213055	418	0	221188
5904	3384	1324	4237	207518	0	216463
5905	2441	723	1579	215956	0	220699
5906	212631	687	926	6611	0	220855
5907	5020	211656	576	2771	0	220023
5908	3277	4610	381	210504	0	218772
5909	2505	1847	281	218326	0	222959
5910	215406	1132	349	7333	0	224220
5911	6474	809	287	216633	0	224203
5912	216268	791	292	7132	0	224483
5913	217500	886	315	3498	0	222199
5914	218770	966	262	2425	0	222423
5915	8850	708	328	213404	0	223290
5916	4787	568	387	216289	0	222031
5917	2907	708	226385	6942	0	236942
5918	2397	783	222293	3367	0	228840
5919	225026	627	8111	2641	0	236405
5920	8585	705	3310	232296	0	244896
5921	3930	979	246811	7287	0	259007
5922	2776	825	249307	3544	0	256452
5923	3121	653	10406	246027	0	260207
5924	2110	739	249813	8761	0	261423
5925	3078	754	9337	244944	0	258113
5926	3445	670	3970	248644	0	256729
5927	2121	804	247458	11617	0	262000
5928	3095	631	8657	247315	0	259698
5929	3745	726	4189	240202	0	248862
5930	3032	542	2265	257138	0	262977
5931	2098	792	246774	13175	0	262839
5932	3211	622	8420	250904	0	263157
5933	247855	576	3798	12253	0	264482
5934	9308	247739	2587	5806	0	265440
5935	250571	8051	1687	4685	0	264994
5936	10697	3623	245004	3118	0	262442
5937	246022	1817	8978	3491	0	260308
5938	251573	1218	4457	3374	0	260622
5939	252340	1144	2793	3067	0	259344
5940	14730	1151	1897	240465	0	258243
5941	8098	1141	1872	246976	0	258087
5942	4451	1074	225443	12758	0	243726
5943	214479	687	8945	7405	0	231516
5944	10616	217224	4542	4368	0	236750
5945	5181	207205	2535	3269	0	218190
5946	3487	214927	1947	3116	0	223477
5947	4277	10525	1895	203368	0	220065
5948	200892	4385	1801	10016	0	217094
5949	205135	2213	1835	5926	0	215109
5950	11929	1526	197387	3711	0	214553
5951	7063	1419	8208	196689	0	213379
5952	4861	1389	3934	202874	0	213058
5953	3391	1517	195761	12110	0	212779
5954	3097	1459	192718	6740	0	204014
5955	188925	1043	10703	5064	0	205735
5956	9526	192055	5304	3748	0	210633
5957	196062	7463	3147	3912	0	210584
5958	200482	3567	2316	3627	0	209992
5959	12898	2216	1961	192383	0	209458
5960	7362	1430	1985	199468	0	210245
5961	192119	1256	1987	12461	0	207823
5962	10997	1213	1917	192890	0	207017
5963	6602	1275	2071	197012	0	206960
5964	191832	1161	2087	13066	0	208146
5965	10808	1202	1992	194443	0	208445
5966	194008	1107	1915	12116	0	209146
5967	198556	968	2277	7244	0	209045
5968	12726	1020	189387	4878	0	208011
5969	190931	985	8714	4681	0	205311
5970	194753	1051	4765	4421	0	204990
5971	195175	1015	3282	4347	0	203819
5972	13526	1558	153900	4692	0	173676
5973	183437	971	7278	4418	0	196104
5974	11250	179094	4191	4250	0	198785
5975	186485	7160	2980	4420	0	201045
5976	191786	3168	2477	4327	0	201758
5977	13740	1768	2124	184595	0	202227
5978	8137	1012	2129	187286	0	198564
5979	5434	182496	2048	12809	0	202787
5980	5249	7418	1789	187499	0	201955
5981	5007	3595	1976	193069	0	203647
5982	186317	1962	2126	13180	0	203585
5983	11594	1387	1805	185290	0	200076
5984	7801	1279	1549	188370	0	198999
5985	5922	1366	1787	186787	0	195862
5986	4993	174818	1839	13404	0	195054
5987	173347	7507	2050	7801	0	190705
5988	11057	174398	2016	5302	0	192773
5989	159861	7365	1542	4135	0	172903
5990	10228	3274	150622	3810	0	167934
5991	143236	1767	6506	3804	0	155313
5992	9177	1496	143529	3506	0	157708
5993	5354	137842	7078	3171	0	153445
5994	130022	5927	5203	2847	0	143999
5995	127058	2992	2011	2835	0	134896
5996	8680	119292	1508	2542	0	132022
5997	4998	120956	1289	2207	0	129450
5998	117932	6139	1299	2630	0	128000
5999	121169	2965	1092	2346	0	127572
6000	8592	1714	1041	116213	0	127560
6001	5269	1513	929	120307	0	128018
6002	3593	1389	114116	7390	0	126488
6003	112704	1357	4574	4104	0	122739
6004	7223	1113	2398	111985	0	122719
6005	4396	112290	1666	5625	0	123977
6006	3641	4530	898	113473	0	122542
6007	3113	2485	769	115838	0	122205
6008	2559	1502	109691	7516	0	121268
6009	2918	1210	4271	111319	0	119718
6010	108041	1138	2021	6792	0	117992
6011	5555	104624	1273	3971	0	115423
6012	3423	106268	788	2659	0	113138
6013	105111	5474	768	2389	0	113742
6014	106688	2751	809	2392	0	112640
6015	106579	1601	824	2149	0	111153
6016	7760	98840	926	1730	0	109256
6017	2734	87896	651	1032	0	92313
6018	91731	3445	803	1131	0	97110
6019	92902	1696	795	1285	0	96678
6020	4995	86986	567	965	0	93513
6021	1098	72488	231	574	0	74391
6022	70920	2005	391	699	0	74015
6023	2278	738	206	69795	0	73017
6024	70515	497	137	2080	0	73229
6025	2375	522	107	69629	0	72633
6026	997	70037	162	1842	0	73038
6027	803	71386	147	707	0	73043
6028	73338	2085	229	690	0	76342
6029	73133	913	180	808	0	75034
6030	76128	581	124	609	0	77442
6031	2863	74854	162	348	0	78227
6032	1012	1992	70285	249	0	73538
6033	606	71195	1651	246	0	73698
6034	68855	2169	637	455	0	72116
6035	67301	663	255	580	0	68799
6036	2228	460	65988	165	0	68841
6037	779	65049	1557	177	0	67562
6038	836	1777	448	64719	0	67780
6039	771	592	222	63526	0	65111
6040	573	59213	297	1780	0	61863
6041	435	1839	63327	523	0	66124
6042	64328	634	1607	480	0	67049
6043	2158	487	447	65472	0	68564
6044	65896	341	290	1961	0	68488
6045	67201	335	223	834	0	68593
6046	2648	322	199	68169	0	71338
6047	1340	369	154	72049	0	73912
6048	1026	388	170	73709	0	75293
6049	925	405	123	74617	0	76070
6050	71833	406	156	3346	0	75741
6051	73210	354	191	1543	0	75298
6052	3106	379	72141	728	0	76354
6053	1693	309	2070	72144	0	76216
6054	1172	361	733	74158	0	76424
6055	991	372	382	75354	0	77099
6056	713	393	72228	3201	0	76535
6057	999	296	2098	71539	0	74932
6058	70494	277	784	3108	0	74663
6059	2818	324	429	71273	0	74844
6060	1217	402	70881	2830	0	75330
6061	1110	336	2247	71039	0	74732
6062	735	412	71493	2857	0	75497
6063	71771	327	2407	1596	0	76101
6064	2863	289	938	72847	0	76937
6065	72951	291	566	2975	0	76783
6066	72820	335	389	1624	0	75168
6067	3512	294	326	71510	0	75642
6068	72782	285	322	3249	0	76638
6069	3172	323	374	70991	0	74860
6070	1464	74524	429	2815	0	79232
6071	77480	2253	366	1607	0	81706
6072	77850	872	367	1178	0	80267
6073	78933	544	301	1029	0	80807
6074	4016	363	349	76334	0	81062
6075	2031	322	285	77586	0	80224
6076	1369	330	280	78774	0	80753
6077	1008	368	73713	3906	0	78995
6078	958	72679	2332	1867	0	77836
6079	1185	2247	791	71780	0	76003
6080	986	907	70793	2781	0	75467
6081	70139	494	2439	1619	0	74691
6082	2973	350	916	71407	0	75646
6083	1428	300	70384	3028	0	75140
6084	72345	257	2255	1864	0	76721
6085	3044	260	940	74007	0	78251
6086	1700	228	565	75450	0	77943
6087	1289	249	422	76948	0	78908
6088	74802	216	373	4070	0	79461
6089	75886	223	468	2213	0	78790
6090	75167	253	457	1634	0	77511
6091	3505	70522	567	1125	0	75719
6092	1599	73399	519	998	0	76515
6093	73675	2422	368	1211	0	77676
6094	2920	897	72366	1126	0	77309
6095	1714	464	2229	71376	0	75783
6096	1317	283	844	74429	0	76873
6097	72175	225	571	3602	0	76573
6098	70492	246	454	1925	0	73117
6099	3193	70037	393	1309	0	74932
6100	1817	2078	388	71156	0	75439
6101	1285	815	69848	2815	0	74763
6102	1145	478	70541	1598	0	73762
6103	1216	353	2700	71108	0	75377
6104	1135	273	1067	74224	0	76699
6105	71872	295	666	3746	0	76579
6106	2905	337	530	73670	0	77442
6107	75658	262	446	3535	0	79901
6108	75532	284	484	2037	0	78337
6109	3345	288	73884	1385	0	78902
6110	75607	236	2078	1406	0	79327
6111	77490	249	944	1324	0	80007
6112	77744	204	633	1399	0	79980
6113	3452	74647	591	1202	0	79892
6114	1670	76326	482	1266	0	79744
6115	1437	2390	488	75911	0	80226
6116	1124	885	75191	2802	0	80002
6117	1007	71783	1949	1574	0	76313
6118	978	1807	871	66674	0	70330
6119	1015	610	509	65521	0	67655
6120	821	65466	409	2097	0	68793
6121	66198	1377	355	1355	0	69285
6122	67148	602	345	1062	0	69157
6123	2373	418	67743	760	0	71294
6124	65785	265	1350	996	0	68396
6125	2034	300	66245	721	0	69300
6126	60985	252	1441	893	0	63571
6127	1935	342	63690	647	0	66614
6128	1022	61728	1278	528	0	64556
6129	1065	951	873	58896	0	61785
6130	753	456	399	59418	0	61026
6131	60250	253	302	1609	0	62414
6132	60527	155	245	1094	0	62021
6133	59965	147	210	858	0	61180
6134	1618	239	60926	541	0	63324
6135	1136	164	957	60868	0	63125
6136	799	168	577	62682	0	64226
6137	62760	173	401	1684	0	65018
6138	1286	63045	301	862	0	65494
6139	67189	904	252	991	0	69336
6140	1483	517	247	69249	0	71496
6141	1018	294	279	70974	0	72565
6142	700	263	228	71467	0	72658
6143	605	243	192	71878	0	72918
6144	627	261	176	71679	0	72743
6145	523	68928	207	1817	0	71475
6146	472	66630	144	784	0	68030
6147	324	64884	104	325	0	65637
6148	343	691	137	65434	0	66605
6149	278	243	64398	608	0	65527
6150	58173	145	524	545	0	59387
6151	668	66549	257	204	0	67678
6152	422	512	180	66807	0	67921
6153	346	196	156	67493	0	68191
6154	68587	132	106	963	0	69788
6155	67136	101	108	669	0	68014
6156	67771	103	90	508	0	68472
6157	1014	88	82	72181	0	73365
6158	420	134	73460	741	0	74755
6159	342	172	74864	316	0	75694
6160	346	105	798	76083	0	77332
6161	223	136	76775	810	0	77944
6162	73068	79	764	616	0	74527
6163	913	85	282	75627	0	76907
6164	405	122	76447	801	0	77775
6165	509	118	699	73808	0	75134
6166	256	125	79374	920	0	80675
6167	264	134	82800	445	0	83643
6168	605	207	943	88000	0	89755
6169	250	124	93739	1097	0	95210
6170	246	170	88471	392	0	89279
6171	142	86489	1616	290	0	88537
6172	516	1209	754	90743	0	93222
6173	96771	449	384	1623	0	99227
6174	1412	264	176	95807	0	97659
6175	815	141	148	99518	0	100622
6176	352	146	98988	1697	0	101183
6177	92028	73	1144	1189	0	94434
6178	1366	44	517	100854	0	102781
6179	810	29	313	103167	0	104319
6180	101663	35	190	2075	0	103963
6181	1420	35	194	102981	0	104630
6182	102916	50	168	2053	0	105187
6183	102302	64	177	1247	0	103790
6184	102276	55	168	949	0	103448
6185	1864	100314	158	374	0	102710
6186	102368	1106	104	716	0	104294
6187	1585	101789	166	274	0	103814
6188	1028	1296	107	103144	0	105575
6189	103998	590	107	1672	0	106367
6190	1347	104242	199	758	0	106546
6191	104807	1300	124	882	0	107113
6192	1544	104598	174	380	0	106696
6193	103336	1470	118	691	0	105615
6194	1664	102763	174	269	0	104870
6195	814	105621	143	306	0	106884
6196	596	111991	146	252	0	112985
6197	720	2061	105	108244	0	111130
6198	344	112736	146	1277	0	114503
6199	591	1876	107	112095	0	114669
6200	586	902	115	113357	0	114960
6201	579	569	102	113072	0	114322
6202	507	353	99	114600	0	115559
6203	112634	240	95	2850	0	115819
6204	113037	284	117	1671	0	115109
6205	2254	300	112482	732	0	115768
6206	115446	246	1546	1054	0	118292
6207	123401	208	650	945	0	125204
6208	128128	245	413	850	0	129636
6209	3121	356	125901	325	0	129703
6210	1454	418	126759	349	0	128980
6211	124222	234	2699	933	0	128088
6212	2840	335	131832	378	0	135385
6213	1207	137792	2730	481	0	142210
6214	1336	2486	1000	139073	0	143895
6215	142891	926	619	3229	0	147665
6216	143083	547	483	1771	0	145884
6217	144959	359	390	1249	0	146957
6218	4269	318	372	143277	0	148236
6219	2285	248	367	146396	0	149296
6220	1177	354	147198	3625	0	152354
6221	1745	238	2605	145899	0	150487
6222	1471	239	1019	150884	0	153613
6223	148556	224	756	4381	0	153917
6224	3073	150438	706	1769	0	155986
6225	152695	2694	440	1623	0	157452
6226	3862	1114	458	153300	0	158734
6227	151963	730	393	3828	0	156914
6228	150815	517	346	2206	0	153884
6229	146645	391	376	1911	0	149323
6230	4210	146041	482	956	0	151689
6231	2116	151248	454	840	0	154658
6232	1717	3226	346	151776	0	157065
6233	152474	1281	418	3842	0	158015
6234	3715	784	530	150281	0	155310
6235	2161	606	408	152388	0	155563
6236	1314	650	150605	4127	0	156696
6237	1834	540	2696	148175	0	153245
6238	1612	575	1030	149056	0	152273
6239	1729	417	619	149443	0	152208
6240	1129	412	146811	4513	0	152865
6241	1202	454	143082	2303	0	147041
6242	1143	144192	3509	1661	0	150505
6243	145021	2778	1414	1761	0	150974
6244	3773	1245	895	146064	0	151977
6245	1822	982	146876	3462	0	153142
6246	2051	585	2902	144737	0	150275
6247	2011	475	1142	155485	0	159113
6248	152750	456	796	5127	0	159129
6249	152323	431	717	3006	0	156477
6250	4100	152212	915	1750	0	158977
6251	151348	2771	789	2044	0	156952
6252	151505	1182	733	1758	0	155178
6253	4780	916	679	150841	0	157216
6254	2301	913	149469	3401	0	156084
6255	1739	149611	3002	1833	0	156185
6256	149193	3092	1175	2046	0	155506
6257	150929	1293	738	2031	0	154991
6258	4394	153858	647	1524	0	160423
6259	2738	2904	633	160184	0	166459
6260	164959	1166	585	4879	0	171589
6261	167306	821	515	2790	0	171432
6262	5430	678	507	167292	0	173907
6263	166390	697	575	5467	0	173129
6264	177928	723	555	2953	0	182159
6265	179897	618	581	2529	0	183625
6266	6331	726	177482	1488	0	186027
6267	3108	170515	3719	1599	0	178941
6268	2202	175540	1418	1422	0	180582
6269	167568	4105	941	1967	0	174581
6270	4604	170283	662	1206	0	176755
6271	2270	4100	169102	1027	0	176499
6272	2482	1475	3575	167789	0	175321
6273	167440	1014	1104	4679	0	174237
6274	5219	887	766	166990	0	173862
6275	167559	724	616	5131	0	174030
6276	168431	681	552	2694	0	172358
6277	167580	607	660	2237	0	171084
6278	5507	160958	804	1579	0	168848
6279	2563	171181	798	1370	0	175912
6280	169473	4289	758	1976	0	176496
6281	166691	1791	607	2117	0	171206
6282	171585	1285	604	1794	0	175268
6283	6315	986	546	167791	0	175638
6284	166640	868	552	5034	0	173094
6285	5143	161311	865	2094	0	169413
6286	2632	169216	606	1879	0	174333
6287	2866	4218	468	166920	0	174472
6288	2125	1660	164823	4497	0	173105
6289	2093	1215	162748	1859	0	167915
6290	2600	922	4108	163150	0	170780
6291	1975	1024	164993	4297	0	172289
6292	2396	1146	3904	164085	0	171531
6293	166004	1087	1228	4927	0	173246
6294	5577	909	935	165074	0	172495
6295	163316	786	852	5129	0	170083
6296	5042	158657	854	2054	0	166607
6297	2522	3920	159698	1575	0	167715
6298	2910	1548	3650	154302	0	162410
6299	2477	1373	1250	161520	0	166620
6300	1732	1354	160029	4904	0	168019
6301	2448	940	3787	153823	0	160998
6302	1710	159506	1555	4445	0	167216
6303	2353	3794	1096	161985	0	169228
6304	2510	1355	820	164287	0	168972
6305	2824	927	742	167430	0	171923
6306	2001	786	164851	5757	0	173395
6307	1749	738	154879	2430	0	159796
6308	140869	659	4287	2239	0	148054
6309	4396	769	146266	1146	0	152577
6310	1758	145392	3876	1053	0	152079
6311	144713	3204	1487	1489	0	150893
6312	3859	146630	999	1103	0	152591
6313	140674	3359	961	1433	0	146427
6314	142000	1159	851	1318	0	145328
6315	140056	862	682	1381	0	142981
6316	140165	869	549	1395	0	142978
6317	4416	135141	622	1072	0	141251
6318	2038	138612	580	932	0	142162
6319	138110	3515	606	1228	0	143459
6320	4043	1429	133755	780	0	140007
6321	2402	1010	3117	130522	0	137051
6322	2130	773	1111	135106	0	139120
6323	1529	795	133837	3751	0	139912
6324	123508	801	3190	1950	0	129449
6325	132767	788	1138	1498	0	136191
6326	131730	895	814	1368	0	134807
6327	4680	129650	775	958	0	136063
6328	134296	3258	725	1327	0	139606
6329	4729	1302	783	129436	0	136250
6330	2236	139216	840	3328	0	145620
6331	142268	3715	751	1883	0	148617
6332	144947	1782	698	1630	0	149057
6333	155253	1219	713	1388	0	158573
6334	7023	1043	716	151081	0	159863
6335	3926	1006	618	152006	0	157556
6336	2289	147320	764	5794	0	156167
6337	1974	4280	149731	2600	0	158585
6338	2722	1904	4153	148628	0	157407
6339	2751	1206	1939	147868	0	153764
6340	2483	966	1142	156579	0	161170
6341	1714	973	152216	6612	0	161515
6342	147825	906	4414	3635	0	156780
6343	5711	921	1921	154250	0	162803
6344	2832	1048	155144	5317	0	164341
6345	2771	798	4688	152898	0	161155
6346	155320	695	2257	6183	0	164455
6347	5441	154193	1521	3090	0	164245
6348	3253	4637	1131	157520	0	166541
6349	2000	2121	157479	5722	0	167322
6350	150925	1387	4989	3352	0	160653
6351	158240	904	2395	2647	0	164186
6352	6837	883	156443	2016	0	166179
6353	3955	1111	5036	145088	0	155190
6354	2169	153530	2518	4893	0	163110
6355	155574	4685	1821	2959	0	165039
6356	5985	2070	152512	1954	0	162521
6357	148462	1227	5103	2232	0	157024
6358	6227	938	146519	1388	0	155072
6359	3216	780	136593	1322	0	141911
6360	128228	737	5731	1587	0	136283
6361	4751	133543	2731	1263	0	142288
6362	3240	3949	131688	1250	0	140127
6363	1865	127933	4448	1200	0	135446
6364	1782	3900	123875	1034	0	130591
6365	1295	123552	4153	908	0	129908
6366	115508	3875	2624	1315	0	123322
6367	3706	1797	113976	1071	0	120550
6368	2131	1197	112838	927	0	117093
6369	1485	864	111075	857	0	114281
6370	106089	827	5129	945	0	112990
6371	109425	535	2472	964	0	113396
6372	4659	533	1467	106203	0	112862
6373	2326	515	111269	3185	0	117295
6374	1584	542	111825	1849	0	115800
6375	110269	545	4489	1282	0	116585
6376	3852	595	2540	112382	0	119369
6377	113273	525	1551	3571	0	118920
6378	114619	442	1370	1957	0	118388
6379	5102	619	1037	107189	0	113947
6380	2849	107666	1149	3158	0	114822
6381	1999	2908	1258	109319	0	115484
6382	1829	1537	1005	111743	0	116114
6383	1457	1091	109584	4402	0	116534
6384	1492	105934	3457	2472	0	113355
6385	1290	110456	2184	1462	0	115392
6386	1437	3922	1469	106519	0	113347
6387	1030	2034	108581	3258	0	114903
6388	1054	108101	3813	1995	0	114963
6389	1301	3241	109139	1393	0	115074
6390	104215	1844	4092	1539	0	111690
6391	110015	1115	2526	1263	0	114919
6392	4627	991	108706	897	0	115221
6393	107292	786	3937	1161	0	113176
6394	4336	954	2397	108159	0	115846
6395	2606	114102	1752	3171	0	121631
6396	2115	3141	1617	116450	0	123323
6397	113084	1753	1493	3927	0	120257
6398	115045	1111	1449	2314	0	119919
6399	115373	912	1270	1627	0	119182
6400	114281	756	1196	1459	0	117692
6401	5236	109169	1427	1157	0	116989
6402	2798	110909	1390	900	0	115997
6403	110037	3611	1305	1161	0	116114
6404	4136	1907	110866	850	0	117759
6405	2799	2553	3123	105652	0	114127
6406	1700	112117	2034	2886	0	118737
6407	1731	3121	1314	110083	0	116249
6408	1051	114872	1200	3340	0	120463
6409	1359	3776	1044	115272	0	121451
6410	1130	1916	115180	3748	0	121974
6411	111671	1141	3636	2390	0	118838
6412	115720	927	2164	1512	0	120323
6413	4703	1072	114463	857	0	121095
6414	113268	991	3769	1131	0	119159
6415	116443	829	2203	1144	0	120619
6416	5035	861	113811	739	0	120446
6417	3125	776	3928	110231	0	118060
6418	113956	620	2394	3596	0	120566
6419	4332	650	113485	1811	0	120278
6420	3009	665	3815	109950	0	117439
6421	1823	621	117204	3478	0	123126
6422	1639	718	115852	1969	0	120178
6423	113587	647	4955	1682	0	120871
6424	120107	720	2553	1185	0	124565
6425	121186	514	1489	1245	0	124434
6426	125145	563	1132	1064	0	127904
6427	6331	660	1048	118529	0	126568
6428	3156	112157	1100	3585	0	119998
6429	2037	117945	1027	1987	0	122996
6430	1760	3944	764	110099	0	116567
6431	110375	1442	824	3455	0	116096
6432	3742	106050	769	1436	0	111997
6433	1181	102427	528	593	0	104729
6434	100991	2587	483	672	0	104733
6435	3013	1106	425	100019	0	104563
6436	100715	553	469	2685	0	104422
6437	2742	100617	449	943	0	104751
6438	102015	2265	343	912	0	105535
6439	3020	861	105465	487	0	109833
6440	115030	602	2584	764	0	118980
6441	120524	432	782	849	0	122587
6442	123388	468	556	732	0	125144
6443	4929	689	109477	690	0	115785
6444	117184	409	2566	807	0	120966
6445	4276	118612	1055	467	0	124410
6446	1953	2974	118052	298	0	123277
6447	1947	1553	3227	110210	0	116937
6448	1628	690	1243	108682	0	112243
6449	797	111907	795	3570	0	117069
6450	1104	2871	503	113441	0	117919
6451	1053	1097	454	115874	0	118478
6452	751	721	111781	3999	0	117252
6453	102647	424	3031	2230	0	108332
6454	3483	373	113039	1037	0	117932
6455	1972	329	3484	110648	0	116433
6456	1131	317	114960	3250	0	119658
6457	1248	266	3714	113634	0	118862
6458	115919	260	1619	4058	0	121856
6459	120782	319	983	1860	0	123944
6460	4866	283	772	119197	0	125118
6461	2039	324	122751	3963	0	129077
6462	1898	287	3533	122783	0	128501
6463	1133	390	122218	4216	0	127957
6464	116413	317	3915	2271	0	122916
6465	123134	287	1598	1656	0	126675
6466	120903	354	1114	1386	0	123757
6467	121692	359	770	1196	0	124017
6468	5266	115759	791	823	0	122639
6469	2984	3310	624	117889	0	124807
6470	116437	1289	586	4108	0	122420
6471	4257	113843	713	1820	0	120633
6472	2198	119095	631	1242	0	123166
6473	1728	4248	110050	915	0	116941
6474	109764	1684	3662	1057	0	116167
6475	115120	963	1647	915	0	118645
6476	5281	723	110482	701	0	117187
6477	3128	483	3923	107771	0	115305
6478	2432	462	1675	113566	0	118135
6479	1758	428	112067	4612	0	118865
6480	1986	374	4045	109721	0	116126
6481	111033	398	1795	4711	0	117937
6482	4429	546	108283	2044	0	115302
6483	2219	480	111926	1500	0	116125
6484	108338	402	4754	1472	0	114966
6485	4631	582	112168	967	0	118348
6486	109475	566	4502	1124	0	115667
6487	4783	109691	2207	906	0	117587
6488	112689	3463	1402	1138	0	118692
6489	5202	1367	1076	110249	0	117894
6490	2671	1040	1029	113359	0	118099
6491	111894	819	807	5246	0	118766
6492	4879	669	786	111892	0	118226
6493	111640	585	851	4915	0	117991
6494	4814	111576	823	2317	0	119530
6495	2840	3532	795	106769	0	113936
6496	2225	1423	832	110880	0	115360
6497	107701	978	898	5070	0	114647
6498	108606	742	766	2616	0	112730
6499	109134	622	730	1908	0	112394
6500	5878	101772	770	1462	0	109882
6501	3059	106353	711	1179	0	111302
6502	105557	4046	720	1187	0	111510
6503	4928	1712	101618	1056	0	109314
6504	2431	100724	3503	1039	0	107697
6505	94531	3226	2316	1131	0	101204
6506	92058	1233	1134	975	0	95400
6507	92461	795	740	819	0	94815
6508	4721	703	685	87488	0	93597
6509	90484	508	580	3183	0	94755
6510	91012	425	494	1638	0	93569
6511	4813	392	460	86096	0	91761
6512	88213	446	584	3267	0	92510
6513	4112	486	83248	1502	0	89348
6514	2449	554	2559	84274	0	89836
6515	1828	625	1226	86273	0	89952
6516	1575	410	965	89774	0	92724
6517	86592	336	718	4345	0	91991
6518	89674	425	569	2484	0	93152
6519	90385	408	483	1784	0	93060
6520	89912	253	466	1544	0	92175
6521	86910	261	461	1294	0	88926
6522	4977	251	564	80720	0	86512
6523	2951	287	489	83289	0	87016
6524	81454	225	580	3685	0	85944
6525	3540	78499	529	2078	0	84646
6526	79583	2101	568	1452	0	83704
6527	3568	965	74393	1142	0	80068
6528	80783	615	2158	1029	0	84585
6529	85257	499	960	1056	0	87772
6530	4243	439	87981	878	0	93541
6531	93230	306	2996	765	0	97297
6532	4638	339	94061	694	0	99732
6533	3010	288	101155	543	0	104996
6534	2752	427	4830	98111	0	106120
6535	2170	341	2679	105507	0	110697
6536	1539	285	105457	4916	0	112197
6537	1241	316	106485	2927	0	110969
6538	1021	99692	4930	2134	0	107777
6539	908	100393	2665	1490	0	105456
6540	85461	3286	1924	891	0	91562
6541	2522	92372	942	625	0	96461
6542	89171	3008	750	841	0	93770
6543	2943	88616	592	528	0	92679
6544	88350	2966	608	520	0	92444
6545	3233	1685	83498	334	0	88750
6546	85054	1288	2420	373	0	89135
6547	3589	833	1269	83412	0	89103
6548	1951	85481	952	2127	0	90511
6549	1770	2297	626	87163	0	91856
6550	86521	1343	538	2896	0	91298
6551	88714	1001	390	1676	0	91781
6552	3924	741	401	86219	0	91285
6553	2366	624	85352	2491	0	90833
6554	1749	438	82971	1575	0	86733
6555	1132	85722	2995	1120	0	90969
6556	1245	2650	1756	85323	0	90974
6557	820	1349	86311	2360	0	90840
6558	781	81229	2497	1258	0	85765
6559	1040	2324	1570	81814	0	86748
6560	746	1229	995	83942	0	86912
6561	78099	814	749	3133	0	82795
6562	2108	660	549	78628	0	81945
6563	1233	601	76804	2990	0	81628
6564	1211	329	1983	77281	0	80804
6565	75063	342	1257	2946	0	79608
6566	2177	347	75646	1884	0	80054
6567	73770	241	2214	1606	0	77831
6568	2664	76449	1474	954	0	81541
6569	79542	1899	1025	914	0	83380
6570	80701	1121	775	782	0	83379
6571	3451	787	733	77471	0	82442
6572	2399	568	513	78761	0	82241
6573	1461	77145	495	3121	0	82222
6574	1297	1830	401	80653	0	84181
6575	78003	1204	407	3149	0	82763
6576	2384	939	76994	1856	0	82173
6577	1760	711	1974	76929	0	81374
6578	1266	76747	1234	2502	0	81749
6579	1128	1986	859	79519	0	83492
6580	955	1329	634	80863	0	83781
6581	78321	1023	463	3533	0	83340
6582	2325	77446	355	2281	0	82407
6583	1822	2128	405	78922	0	83277
6584	77948	1242	441	2913	0	82544
6585	2650	975	392	78343	0	82360
6586	1721	730	338	80313	0	83102
6587	79966	655	327	4035	0	84983
6588	79754	399	338	2834	0	83325
6589	3497	436	78947	1769	0	84649
6590	78501	399	1964	1520	0	82384
6591	81572	401	1274	1307	0	84554
6592	82305	451	971	1137	0	84864
6593	3864	76645	745	1042	0	82296
6594	2569	77501	586	866	0	81522
6595	2087	2679	423	77848	0	83037
6596	78369	1770	550	2340	0	83029
6597	79518	1277	416	1622	0	82833
6598	3650	802	320	78011	0	82783
6599	2588	602	78782	2643	0	84615
6600	80049	519	1924	1982	0	84474
6601	85520	557	1152	1531	0	88760
6602	3665	488	930	82988	0	88071
6603	2591	394	719	84577	0	88281
6604	84618	364	528	3344	0	88854
6605	3320	362	395	83598	0	87675
6606	2177	83083	488	3153	0	88901
6607	1786	2038	368	86675	0	90867
6608	86371	1256	353	3262	0	91242
6609	2829	934	84620	2105	0	90488
6610	80529	620	1840	2037	0	85026
6611	3143	580	84105	1388	0	89216
6612	2154	423	2430	84808	0	89815
6613	87002	439	1489	2831	0	91761
6614	2951	368	1090	87303	0	91712
6615	2149	341	710	88343	0	91543
6616	86131	315	624	4000	0	91070
6617	2742	344	84481	2654	0	90221
6618	2071	314	87558	1840	0	91783
6619	1638	277	2777	90294	0	94986
6620	1336	317	1793	93970	0	97416
6621	1124	323	1223	96129	0	98799
6622	946	294	94230	4007	0	99477
6623	90546	221	2072	3006	0	95845
6624	96947	216	1392	2165	0	100720
6625	97798	237	1158	1701	0	100894
6626	98145	190	774	1553	0	100662
6627	4120	92235	637	1140	0	98132
6628	2674	92284	501	1267	0	96726
6629	1696	92788	453	991	0	95928
6630	1249	1711	428	79934	0	83322
6631	1113	483	378	81667	0	83641
6632	657	176	78640	1066	0	80539
6633	414	71133	612	491	0	72650
6634	811	510	213	68314	0	69848
6635	66831	136	148	748	0	67863
6636	343	66979	143	298	0	67763
6637	243	361	77	67075	0	67756
6638	142	67803	95	464	0	68504
6639	69724	343	51	440	0	70558
6640	533	176	62	68772	0	69543
6641	206	86	67857	439	0	68588
6642	200	127	65772	180	0	66279
6643	259	167	591	68812	0	69829
6644	301	36	198	67608	0	68143
6645	188	39	91	71227	0	71545
6646	70099	32	96	1002	0	71229
6647	642	99	69467	275	0	70483
6648	243	68432	561	195	0	69431
6649	259	494	166	69139	0	70058
6650	124	204	69411	551	0	70290
6651	93	69452	568	283	0	70396
6652	200	544	162	71538	0	72444
6653	118	172	71744	540	0	72574
6654	229	92	525	70054	0	70900
6655	182	67	178	71712	0	72139
6656	72976	33	109	930	0	74048
6657	72389	36	72	486	0	72983
6658	776	31	53	72592	0	73452
6659	72591	26	43	976	0	73636
6660	735	77	73157	208	0	74177
6661	332	29	663	73813	0	74837
6662	142	78	76623	730	0	77573
6663	286	45	695	77116	0	78142
6664	108	75645	256	882	0	76891
6665	118	77132	160	327	0	77737
6666	86	79167	115	268	0	79636
6667	469	919	115	78806	0	80309
6668	281	238	76	89251	0	89846
6669	118	176	88282	1594	0	90170
6670	185	233	88770	467	0	89655
6671	163	194	94610	249	0	95216
6672	98625	92	2132	418	0	101267
6673	2320	114	453	103796	0	106683
6674	105960	89	226	2569	0	108844
6675	2359	109546	215	545	0	112665
6676	866	2521	165	111360	0	114912
6677	113518	721	185	3062	0	117486
6678	3097	414	124	114080	0	117715
6679	113759	192	156	3534	0	117641
6680	3204	217	114751	1047	0	119219
6681	1018	116463	2678	697	0	120856
6682	937	2710	804	118727	0	123178
6683	118221	773	514	3391	0	122899
6684	121348	453	343	1462	0	123606
6685	3801	271	264	120296	0	124632
6686	1674	211	306	122392	0	124583
6687	118869	204	355	4079	0	123507
6688	3497	217	393	117256	0	121363
6689	1186	217	117029	3478	0	121910
6690	900	115738	2965	1349	0	120952
6691	970	2635	1007	118636	0	123248
6692	117722	803	653	3740	0	122918
6693	117383	555	409	1894	0	120241
6694	4212	454	118499	1069	0	124234
6695	1712	114182	3084	963	0	119941
6696	1136	122136	1025	903	0	125200
6697	1282	3759	604	120889	0	126534
6698	1354	1338	518	122133	0	125343
6699	1124	845	403	121664	0	124036
6700	1148	533	438	122247	0	124366
6701	758	118108	541	4845	0	124252
6702	1146	3354	409	120306	0	125215
6703	1146	1163	362	123794	0	126465
6704	119648	725	316	5437	0	126126
6705	119693	504	271	2884	0	123352
6706	4316	119326	380	1895	0	125917
6707	121636	3369	353	1954	0	127312
6708	123279	1261	372	1760	0	126672
6709	123552	831	381	1785	0	126549
6710	5122	697	118362	1197	0	125378
6711	2665	521	3315	118726	0	125227
6712	1901	536	1166	123878	0	127481
6713	1296	671	119204	4777	0	125948
6714	1442	626	3470	118080	0	123618
6715	1793	680	1353	112286	0	116112
6716	117804	619	850	5561	0	124834
6717	3895	579	116996	2652	0	124122
6718	1932	521	3418	114092	0	119963
6719	111894	555	1293	5079	0	118821
6720	3814	111668	949	2527	0	118958
6721	111604	3492	550	2487	0	118133
6722	111290	1291	456	2098	0	115135
6723	4867	107967	466	1668	0	114968
6724	2511	3604	431	109444	0	115990
6725	109527	1337	386	4590	0	115840
6726	4552	108445	475	2118	0	115590
6727	2408	3809	441	109991	0	116649
6728	107994	1410	495	4616	0	114515
6729	107734	1027	497	2485	0	111743
6730	5034	104708	594	1877	0	112213
6731	106170	4145	588	1919	0	112822
6732	4896	1416	552	106502	0	113366
6733	106761	960	507	4929	0	113157
6734	4847	746	103762	2376	0	111731
6735	2563	584	3448	105074	0	111669
6736	2060	592	1297	106964	0	110913
6737	103078	605	925	5588	0	110196
6738	4427	101024	802	2667	0	108920
6739	99601	3556	676	2295	0	106128
6740	4866	99092	617	1681	0	106256
6741	2419	3902	95130	1420	0	102871
6742	2068	1564	95445	1478	0	100555
6743	2014	1541	4030	93915	0	101500
6744	1596	1128	94613	4134	0	101471
6745	1665	983	3548	95035	0	101231
6746	1855	783	1270	94663	0	98571
6747	1669	838	844	99074	0	102425
6748	97028	771	702	5608	0	104109
6749	96824	788	576	2926	0	101114
6750	99694	736	525	2328	0	103283
6751	5553	96458	573	1704	0	104288
6752	2860	105791	501	1685	0	110837
6753	2221	4535	111847	1609	0	120212
6754	2191	1867	4306	114376	0	122740
6755	1617	1392	114604	5425	0	123038
6756	1909	1025	4915	113591	0	121440
6757	1979	884	2049	117468	0	122380
6758	1755	917	1439	118703	0	122814
6759	1415	957	111636	7266	0	121274
6760	1632	742	4773	112519	0	119666
6761	109643	711	2134	6950	0	119438
6762	4935	106323	1692	3553	0	116503
6763	2543	4194	1157	108969	0	116863
6764	107539	1729	1005	6348	0	116621
6765	109498	1216	905	3472	0	115091
6766	6524	918	925	105376	0	113743
6767	3585	674	690	104825	0	109774
6768	95259	534	616	6172	0	102581
6769	5262	522	532	95091	0	101407
6770	86555	351	440	5290	0	92636
6771	4887	337	325	83992	0	89541
6772	2316	295	76702	4447	0	83760
6773	1620	70680	2561	2738	0	77599
6774	1318	73888	1242	1819	0	78267
6775	1536	2682	1274	68412	0	73904
6776	1593	1108	918	69649	0	73268
6777	66703	733	420	3512	0	71368
6778	2495	551	373	67852	0	71271
6779	1277	500	311	68548	0	70636
6780	954	422	273	64108	0	65757
6781	693	60934	220	3865	0	65712
6782	874	1953	202	63628	0	66657
6783	846	795	192	64507	0	66340
6784	777	509	204	64713	0	66203
6785	59353	421	339	4282	0	64395
6786	2121	60508	284	2365	0	65278
6787	1177	2086	249	62414	0	65926
6788	895	951	207	63744	0	65797
6789	752	626	196	64598	0	66172
6790	60946	421	178	4132	0	65677
6791	2595	366	167	62172	0	65300
6792	1385	330	154	62501	0	64370
6793	787	357	57562	3816	0	62522
6794	575	55986	1657	2343	0	60561
6795	672	1807	673	58373	0	61525
6796	55579	781	470	3131	0	59961
6797	1899	56687	356	1778	0	60720
6798	55493	1769	319	1548	0	59129
6799	56768	881	297	1191	0	59137
6800	2609	674	251	55597	0	59131
6801	1447	521	170	57141	0	59279
6802	1057	450	55754	2894	0	60155
6803	1006	358	1583	57755	0	60702
6804	715	336	57344	2856	0	61251
6805	777	231	1909	58741	0	61658
6806	54795	209	926	3132	0	59062
6807	1817	56344	675	1894	0	60730
6808	1006	1734	584	60466	0	63790
6809	812	895	499	61585	0	63791
6810	710	569	460	61594	0	63333
6811	671	480	360	62038	0	63549
6812	58933	385	292	3791	0	63401
6813	2001	58394	306	2323	0	63024
6814	1088	1745	270	61680	0	64783
6815	60421	767	241	3452	0	64881
6816	2143	537	58872	2215	0	63767
6817	59087	424	1766	1836	0	63113
6818	61246	427	829	1516	0	64018
6819	2940	460	59311	1210	0	63921
6820	1735	429	1928	60414	0	64506
6821	61992	393	950	2801	0	66136
6822	2612	62787	732	1623	0	67754
6823	64608	1805	553	1556	0	68522
6824	65687	774	444	1421	0	68326
6825	66275	529	373	1370	0	68547
6826	3432	459	286	64202	0	68379
6827	2012	427	265	66779	0	69483
6828	1498	71753	234	3200	0	76685
6829	1490	2202	221	74192	0	78105
6830	73912	1045	218	3367	0	78542
6831	2849	710	72123	1938	0	77620
6832	71001	541	1985	1775	0	75302
6833	75955	479	897	1541	0	78872
6834	3455	455	577	74210	0	78697
6835	2034	385	434	76444	0	79297
6836	75461	328	383	3700	0	79872
6837	75751	267	343	2299	0	78660
6838	70348	299	340	2003	0	72990
6839	3572	308	73101	1451	0	78432
6840	1971	72929	1871	1326	0	78097
6841	74574	1991	825	1332	0	78722
6842	3000	980	538	73747	0	78265
6843	1767	73457	373	2674	0	78271
6844	1591	2231	353	74848	0	79023
6845	74414	1113	351	3029	0	78907
6846	2848	842	313	74914	0	78917
6847	1794	614	73009	3143	0	78560
6848	1058	71086	1694	2040	0	75878
6849	895	74494	831	1561	0	77781
6850	815	2135	69737	1216	0	73903
6851	60332	1753	2102	1428	0	65615
6852	1639	61289	749	829	0	64506
6853	925	897	342	50856	0	53020
6854	50460	285	163	853	0	51761
6855	707	50017	132	329	0	51185
6856	449	657	86	50635	0	51827
6857	50842	302	62	827	0	52033
6858	852	147	99	50626	0	51724
6859	50981	116	53	929	0	52079
6860	824	157	51120	416	0	52517
6861	426	51781	591	321	0	53119
6862	54034	626	242	432	0	55334
6863	53398	284	132	396	0	54210
6864	53386	162	119	374	0	54041
6865	1102	171	50999	174	0	52446
6866	50462	126	553	385	0	51526
6867	53492	107	235	353	0	54187
6868	1097	147	159	53040	0	54443
6869	53575	134	119	895	0	54723
6870	939	52591	127	381	0	54038
6871	591	607	98	53540	0	54836
6872	404	325	53370	751	0	54850
6873	415	221	675	52517	0	53828
6874	371	205	264	54366	0	55206
6875	54089	175	157	1140	0	55561
6876	53490	129	145	725	0	54489
6877	1066	168	52745	331	0	54310
6878	51296	160	630	482	0	52568
6879	980	149	52790	256	0	54175
6880	677	142	729	53025	0	54573
6881	415	156	53830	802	0	55203
6882	477	120	739	53051	0	54387
6883	378	53434	343	805	0	54960
6884	395	684	54055	386	0	55520
6885	353	359	55507	277	0	56496
6886	913	260	1118	46115	0	48406
6887	56611	166	460	1021	0	58258
6888	56647	158	255	646	0	57706
6889	57354	138	220	480	0	58192
6890	1279	141	181	56295	0	57896
6891	776	153	143	57265	0	58337
6892	587	122	176	57510	0	58395
6893	514	114	139	57395	0	58162
6894	398	171	55719	1252	0	57540
6895	447	170	724	54882	0	56223
6896	351	54550	386	1013	0	56300
6897	380	700	236	55540	0	56856
6898	55629	316	182	1257	0	57384
6899	1051	212	55306	604	0	57173
6900	51092	161	866	681	0	52800
6901	1248	157	56715	325	0	58445
6902	643	136	56161	258	0	57198
6903	407	55362	1431	291	0	57491
6904	832	1180	740	49525	0	52277
6905	483	443	350	55307	0	56583
6906	509	48434	621	1487	0	51051
6907	59090	1330	260	771	0	61451
6908	1830	623	182	61637	0	64272
6909	1139	305	239	67244	0	68927
6910	728	194	241	71053	0	72216
6911	77406	185	186	3532	0	81309
6912	83224	135	195	1799	0	85353
6913	3792	121	186	81688	0	85787
6914	1892	127	191	83395	0	85605
6915	80944	118	186	4102	0	85350
6916	3292	142	186	81191	0	84811
6917	1783	149	203	82989	0	85124
6918	1407	133	177	84419	0	86136
6919	934	158	79251	4503	0	84846
6920	75748	100	2456	2592	0	80896
6921	79321	115	970	1952	0	82358
6922	4013	138	75312	1389	0	80852
6923	2334	376	2577	69927	0	75214
6924	1231	74282	1177	3269	0	79959
6925	73291	2398	710	2142	0	78541
6926	3086	73713	670	1489	0	78958
6927	1563	71680	562	1156	0	74961
6928	1474	2972	421	66821	0	71688
6929	65747	1205	511	3062	0	70525
6930	68587	718	342	1702	0	71349
6931	3763	584	276	66577	0	71200
6932	2061	542	307	67725	0	70635
6933	1527	578	280	67794	0	70179
6934	1376	667	208	67357	0	69608
6935	1233	494	204	65916	0	67847
6936	921	63248	261	4255	0	68685
6937	1208	2384	144	65609	0	69345
6938	64002	1026	133	4132	0	69293
6939	65697	635	135	2569	0	69036
6940	65539	458	124	2207	0	68328
6941	3767	62695	205	1899	0	68566
6942	2198	2326	169	63617	0	68310
6943	1496	1082	62571	3534	0	68683
6944	61639	730	2262	2277	0	66908
6945	3497	596	869	63301	0	68263
6946	63086	476	569	3598	0	67729
6947	62406	435	342	2187	0	65370
6948	62988	537	294	1725	0	65544
6949	4311	563	306	59866	0	65046
6950	60573	515	463	3340	0	64891
6951	4016	461	403	60130	0	65010
6952	2520	360	314	62040	0	65234
6953	60619	327	345	4038	0	65329
6954	3892	352	230	61113	0	65587
6955	60149	454	191	3960	0	64754
6956	61760	384	181	2492	0	64817
6957	4370	317	195	60031	0	64913
6958	2647	344	147	61745	0	64883
6959	1935	287	104	62943	0	65269
6960	1776	269	56146	4753	0	62944
6961	1741	267	57257	2831	0	62096
6962	1780	182	2754	56745	0	61461
6963	1714	195	1129	58078	0	61116
6964	1426	242	644	59264	0	61576
6965	1318	198	464	59223	0	61203
6966	1203	240	459	60124	0	62026
6967	55172	233	575	5153	0	61133
6968	3018	54161	670	2998	0	60847
6969	1980	2187	544	56875	0	61586
6970	56283	891	472	4133	0	61779
6971	3365	584	422	57076	0	61447
6972	1926	420	357	58097	0	60800
6973	54785	400	329	5016	0	60530
6974	56194	363	387	3104	0	60048
6975	4091	485	53039	2238	0	59853
6976	2418	414	2182	55026	0	60040
6977	1907	356	53759	4143	0	60165
6978	1750	292	2501	55433	0	59976
6979	1577	193	984	56363	0	59117
6980	1686	186	653	57116	0	59641
6981	1634	220	52278	4966	0	59098
6982	1268	49685	2602	3148	0	56703
6983	1109	53421	1288	2631	0	58449
6984	1253	2593	961	53041	0	57848
6985	50719	1079	755	4234	0	56787
6986	2946	649	49895	2885	0	56375
6987	1680	460	52085	2332	0	56557
6988	1390	400	3310	51759	0	56859
6989	1069	507	1728	51346	0	54650
6990	937	50898	1099	4210	0	57144
6991	934	2518	927	52061	0	56440
6992	1055	1112	777	54897	0	57841
6993	1003	780	744	55972	0	58499
6994	52122	498	804	4934	0	58358
6995	53627	486	691	3001	0	57805
6996	3644	565	541	52990	0	57740
6997	1903	50977	493	4018	0	57391
6998	1502	2266	392	52796	0	56956
6999	50199	959	384	4302	0	55844
7000	2795	50423	497	2802	0	56517
7001	1805	2161	370	47188	0	51524
7002	1310	47130	316	3376	0	52132
7003	46962	2185	338	2419	0	51904
7004	45193	1168	367	1972	0	48700
7005	2990	45169	389	1756	0	50304
7006	1618	45230	399	1476	0	48723
7007	1093	2185	40635	1238	0	45151
7008	748	37252	1446	1126	0	40572
7009	1113	1979	709	30755	0	34556
7010	652	605	29900	1570	0	32727
7011	173	19979	647	398	0	21197
7012	146	440	197	16173	0	16956
7013	135	136	84	16610	0	16965
7014	103	94	46	16744	0	16987
7015	16187	62	49	581	0	16879
7016	346	79	15847	272	0	16544
7017	171	74	15910	164	0	16319
7018	124	90	418	15958	0	16590
7019	51	81	17173	404	0	17709
7020	97	92	375	17217	0	17781
7021	124	55	172	16535	0	16886
7022	100	59	97	17671	0	17927
7023	88	53	60	17841	0	18042
7024	17276	42	69	610	0	17997
7025	17356	44	63	320	0	17783
7026	477	44	55	17554	0	18130
7027	205	52	18620	458	0	19335
7028	150	42	346	18726	0	19264
7029	78	18283	161	461	0	18983
7030	85	311	115	18579	0	19090
7031	18252	133	90	519	0	18994
7032	18666	89	66	310	0	19131
7033	486	56	65	18757	0	19364
7034	236	77	59	18995	0	19367
7035	165	57	52	19352	0	19626
7036	18650	56	47	641	0	19394
7037	391	84	18473	314	0	19262
7038	203	62	18250	214	0	18729
7039	125	17958	408	143	0	18634
7040	18216	303	171	186	0	18876
7041	364	133	99	18496	0	19092
7042	161	100	18885	381	0	19527
7043	122	18294	307	222	0	18945
7044	97	19238	129	166	0	19630
7045	109	359	79	19175	0	19722
7046	116	169	47	19423	0	19755
7047	89	19147	53	435	0	19724
7048	112	292	46	19690	0	20140
7049	97	146	64	19836	0	20143
7050	19381	109	56	515	0	20061
7051	294	19346	71	227	0	19938
7052	167	301	83	19364	0	19915
7053	98	178	18951	372	0	19599
7054	120	99	266	18912	0	19397
7055	18969	82	133	471	0	19655
7056	278	19055	118	208	0	19659
7057	161	311	52	19353	0	19877
7058	92	163	19173	383	0	19811
7059	63	115	20152	243	0	20573
7060	127	110	442	20608	0	21287
7061	102	83	177	21429	0	21791
7062	21486	60	97	598	0	22241
7063	386	22429	79	274	0	23168
7064	22619	425	64	232	0	23340
7065	473	191	23006	154	0	23824
7066	22417	104	460	231	0	23212
7067	538	79	23887	167	0	24671
7068	23423	76	529	228	0	24256
7069	24383	73	212	203	0	24871
7070	678	95	25248	141	0	26162
7071	304	103	24834	159	0	25400
7072	173	24809	679	209	0	25870
7073	192	493	285	25929	0	26899
7074	26246	190	155	638	0	27229
7075	582	122	106	26651	0	27461
7076	320	86	97	27151	0	27654
7077	232	77	97	27503	0	27909
7078	130	68	26926	801	0	27925
7079	24933	66	573	448	0	26020
7080	27318	59	233	304	0	27914
7081	719	27725	175	268	0	28887
7082	409	477	110	27476	0	28472
7083	191	28769	133	587	0	29680
7084	207	593	127	29323	0	30250
7085	29014	212	125	813	0	30164
7086	595	29153	101	314	0	30163
7087	323	555	65	28349	0	29292
7088	28086	217	68	717	0	29088
7089	28396	121	72	361	0	28950
7090	833	70	65	27600	0	28568
7091	317	77	27731	642	0	28767
7092	261	243	544	26237	0	27285
7093	145	27578	203	557	0	28483
7094	27246	515	107	318	0	28186
7095	530	27391	78	188	0	28187
7096	273	556	55	27061	0	27945
7097	27431	223	64	644	0	28362
7098	622	125	48	28327	0	29122
7099	348	73	43	28664	0	29128
7100	189	121	28297	690	0	29297
7101	127	28315	505	340	0	29287
7102	27723	464	199	261	0	28647
7103	24950	237	169	430	0	25786
7104	533	27387	73	150	0	28143
7105	191	27777	79	112	0	28159
7106	187	488	58	27399	0	28132
7107	27078	198	52	517	0	27845
7108	448	27034	54	179	0	27715
7109	227	443	30	27455	0	28155
7110	160	157	27323	463	0	28103
7111	172	104	389	27275	0	27940
7112	27592	73	131	630	0	28426
7113	415	27928	105	258	0	28706
7114	225	417	85	28872	0	29599
7115	157	203	28540	452	0	29352
7116	150	153	28277	200	0	28780
7117	180	80	514	28601	0	29375
7118	159	123	186	28738	0	29206
7119	114	28498	110	551	0	29273
7120	161	449	67	28573	0	29250
7121	28838	186	70	615	0	29709
7122	503	148	77	29379	0	30107
7123	29309	96	87	701	0	30193
7124	548	29038	112	272	0	29970
7125	255	30236	94	244	0	30829
7126	267	588	90	31011	0	31956
7127	227	263	84	30259	0	30833
7128	154	169	30066	722	0	31111
7129	207	106	550	29617	0	30480
7130	30023	126	266	735	0	31150
7131	571	144	29969	340	0	31024
7132	333	113	521	30675	0	31642
7133	215	164	32375	672	0	33426
7134	217	134	619	32532	0	33502
7135	269	105	253	32407	0	33034
7136	218	89	161	33560	0	34028
7137	203	121	33435	893	0	34652
7138	232	149	552	32699	0	33632
7139	115	33497	248	784	0	34644
7140	158	567	164	34306	0	35195
7141	182	229	136	34314	0	34861
7142	33521	177	118	969	0	34785
7143	620	151	33112	487	0	34370
7144	346	147	539	33400	0	34432
7145	222	130	33323	773	0	34448
7146	203	162	32223	426	0	33014
7147	235	133	724	34015	0	35107
7148	261	106	315	33396	0	34078
7149	191	151	167	35807	0	36316
7150	35040	114	124	1075	0	36353
7151	655	144	34779	520	0	36098
7152	36132	130	622	503	0	37387
7153	766	126	262	38293	0	39447
7154	370	157	182	39313	0	40022
7155	235	41291	138	959	0	42623
7156	271	610	126	42828	0	43835
7157	267	246	145	42786	0	43444
7158	281	169	167	42967	0	43584
7159	40033	100	146	1021	0	41300
7160	551	99	38839	508	0	39997
7161	35747	86	519	515	0	36867
7162	591	39277	248	370	0	40486
7163	38373	427	140	333	0	39273
7164	523	38219	108	238	0	39088
7165	235	38514	113	221	0	39083
7166	340	482	136	38419	0	39377
7167	38825	195	171	636	0	39827
7168	462	137	62	39169	0	39830
7169	179	38162	79	619	0	39039
7170	148	41206	72	335	0	41761
7171	148	603	87	42057	0	42895
7172	171	236	67	41911	0	42385
7173	117	42020	81	803	0	43021
7174	166	562	62	44094	0	44884
7175	206	221	58	44368	0	44853
7176	155	170	70	45398	0	45793
7177	45055	129	56	1006	0	46246
7178	585	133	44713	421	0	45852
7179	44863	111	527	499	0	46000
7180	47850	94	197	366	0	48507
7181	47461	75	121	298	0	47955
7182	777	46707	83	216	0	47783
7183	340	511	51	46436	0	47338
7184	46938	177	62	693	0	47870
7185	596	106	46	48097	0	48845
7186	48178	74	59	742	0	49053
7187	524	52496	61	313	0	53394
7188	55508	454	43	450	0	56455
7189	56768	171	55	373	0	57367
7190	57727	121	32	296	0	58176
7191	765	97	43	57834	0	58739
7192	425	61	44	60085	0	60615
7193	61195	70	33	977	0	62275
7194	566	60665	55	345	0	61631
7195	223	60947	72	239	0	61481
7196	64316	535	44	395	0	65290
7197	641	219	35	64886	0	65781
7198	366	128	49	65626	0	66169
7199	257	73	35	67432	0	67797
7200	143	66589	77	903	0	67712
7201	67364	586	38	569	0	68557
7202	721	220	32	68334	0	69307
7203	284	69655	55	802	0	70796
7204	287	698	26	73640	0	74651
7205	282	260	32	74668	0	75242
7206	244	162	33	74365	0	74804
7207	216	143	27	75346	0	75732
7208	74941	108	33	1185	0	76267
7209	74251	107	30	728	0	75116
7210	76168	84	23	594	0	76869
7211	966	89	25	76783	0	77863
7212	469	137	74860	777	0	76243
7213	417	206	67328	469	0	68420
7214	289	199	72564	318	0	73370
7215	79809	103	806	584	0	81302
7216	764	93	310	81674	0	82841
7217	406	94	157	81149	0	81806
7218	320	81	74	82744	0	83219
7219	82018	67	62	1225	0	83372
7220	81320	103	72	784	0	82279
7221	857	87976	108	377	0	89318
7222	459	567	62	89812	0	90900
7223	315	252	88559	706	0	89832
7224	202	90141	592	415	0	91350
7225	284	720	194	92123	0	93321
7226	282	236	134	92747	0	93399
7227	298	167	111	91486	0	92062
7228	361	152	45	89253	0	89811
7229	202	138	90807	944	0	92091
7230	253	176	85061	531	0	86021
7231	166	91946	672	410	0	93194
7232	247	500	246	93398	0	94391
7233	241	209	153	92411	0	93014
7234	91055	127	93	1082	0	92357
7235	645	188	92419	388	0	93640
7236	444	79	531	92121	0	93175
7237	342	113	287	96007	0	96749
7238	224	154	99055	776	0	100209
7239	121	98730	577	448	0	99876
7240	99001	523	201	821	0	100546
7241	622	279	98014	280	0	99195
7242	94603	157	549	607	0	95916
7243	701	221	105373	244	0	106539
7244	480	115	565	106956	0	108116
7245	254	153	108486	689	0	109582
7246	276	229	110534	398	0	111437
7247	348	93	702	114150	0	115293
7248	1502	324	780	92866	0	95472
7249	243	75	200	119551	0	120069
7250	387	82	143	116325	0	116937
7251	384	123	137	115384	0	116028
7252	161	150	119283	907	0	120501
7253	275	207	110672	527	0	111681
7254	131	119637	795	387	0	120950
7255	120346	572	304	675	0	121897
7256	795	253	189	121611	0	122848
7257	121987	108	130	1287	0	123512
7258	894	99	133	122168	0	123294
7259	126702	52	137	1695	0	128586
7260	938	60	144	128811	0	129953
7261	472	75	118	129667	0	130332
7262	210	131781	199	1142	0	133332
7263	307	712	108	135970	0	137097
7264	313	290	89	135611	0	136303
7265	348	122	116	135111	0	135697
7266	288	85	112	135078	0	135563
7267	130	132823	164	1164	0	134281
7268	132671	614	93	1063	0	134441
7269	667	132368	153	434	0	133622
7270	303	598	56	131628	0	132585
7271	129121	189	60	1316	0	130686
7272	681	241	125462	309	0	126693
7273	305	242	124498	283	0	125328
7274	562	163	721	122970	0	124416
7275	244	78	261	129342	0	129925
7276	195	86	135	129689	0	130105
7277	548	105	149	119624	0	120426
7278	272	83	74	125970	0	126399
7279	84	124963	153	858	0	126058
7280	183	532	58	127289	0	128062
7281	125689	145	78	1415	0	127327
7282	699	110	87	126814	0	127710
7283	219	178	128098	768	0	129263
7284	323	65	621	125474	0	126483
7285	125531	42	227	1529	0	127329
7286	637	129872	200	453	0	131162
7287	438	672	90	134927	0	136127
7288	418	218	66	139443	0	140145
7289	192	218	137068	1875	0	139353
7290	294	303	168776	599	0	169972
7291	202475	96	4022	1045	0	207638
7292	6362	167	1275	204963	0	212767
7293	3654	91	1062	212970	0	217777
7294	2113	247	220851	8254	0	231465
7295	1515	347	222687	4566	0	229115
7296	676	222235	8939	3584	0	235434
7297	1897	6238	4495	220043	0	232673
7298	381	2699	224816	6966	0	234862
7299	189	222542	8613	3242	0	234586
7300	220185	7552	4057	3311	0	235105
7301	229174	3421	3079	2490	0	238164
7302	10092	2821	1984	218580	0	233477
7303	4848	224894	1573	7074	0	238389
7304	224534	7470	1466	4045	0	237515
7305	10150	3802	1104	208279	0	223335
7306	4726	2926	218957	7366	0	233975
7307	3477	221542	7139	4106	0	236264
7308	218943	7683	3401	4100	0	234127
7309	226321	3805	2754	3086	0	235966
7310	11090	3031	1966	219694	0	235781
7311	6907	2036	1392	225519	0	235854
7312	4208	1735	218586	10076	0	234605
7313	4659	1482	7201	219597	0	232939
7314	4390	1151	3383	209616	0	218540
7315	3175	761	2564	222867	0	229367
7316	2685	783	1963	223830	0	229261
7317	2408	873	1466	217163	0	221910
7318	1349	212669	1490	13950	0	229458
7319	210826	6791	1029	9665	0	228311
7320	7546	3231	211598	6595	0	228970
7321	3681	207138	7425	4982	0	223226
7322	4358	7899	3374	210521	0	226152
7323	208983	3656	2795	10412	0	225846
7324	9239	2936	2253	210739	0	225167
7325	5242	2186	1717	214214	0	223359
7326	4270	1549	1731	216318	0	223868
7327	3407	1483	1483	218531	0	224904
7328	2249	1346	204649	15605	0	223849
7329	2074	204983	7538	9846	0	224441
7330	204477	7494	3375	8799	0	224145
7331	8227	3683	205370	6025	0	223305
7332	4971	3085	9233	206062	0	223351
7333	205314	2550	4636	11037	0	223537
7334	9268	205320	3985	5943	0	224516
7335	207121	8442	3044	5867	0	224474
7336	11908	4449	2450	193572	0	212379
7337	6847	3340	2030	210843	0	223060
7338	5664	2601	1522	210054	0	219841
7339	4685	1992	1201	212191	0	220069
7340	198703	1992	1289	16810	0	218794
7341	9799	1866	1283	205663	0	218611
7342	5801	1324	1375	211647	0	220147
7343	192292	1415	1416	16051	0	211174
7344	10272	1557	188297	9674	0	209800
7345	6195	1412	7600	194506	0	209713
7346	184257	1124	3542	13429	0	202352
7347	188686	1068	2744	8410	0	200908
7348	12451	1164	2249	183104	0	198968
7349	7885	1107	2018	183927	0	194937
7350	5660	170868	2046	13902	0	192476
7351	4765	7169	1466	180503	0	193903
7352	4084	3289	1096	182276	0	190745
7353	3118	2550	166389	16054	0	188111
7354	2515	2049	166839	10721	0	182124
7355	2035	164570	9880	9114	0	185599
7356	2740	7829	5447	166703	0	182719
7357	2729	3724	4524	175162	0	186139
7358	166012	3156	3749	14227	0	187144
7359	8673	2637	3039	167909	0	182258
7360	5070	2195	160158	13955	0	181378
7361	4932	1963	8123	166430	0	181448
7362	3432	1696	155267	14681	0	175076
7363	2859	1704	160213	9507	0	174283
7364	2892	1797	11838	155809	0	172336
7365	2553	1728	6811	164739	0	175831
7366	155533	1778	5202	14408	0	176921
7367	161467	1456	4014	9571	0	176508
7368	11684	1404	3546	161150	0	177784
7369	161307	1532	2618	13139	0	178596
7370	166630	1089	1925	8822	0	178466
7371	14008	1305	1708	162573	0	179594
7372	9010	1489	1624	167815	0	179938
7373	161349	1200	1727	14529	0	178805
7374	162860	767	1802	10255	0	175684
7375	13082	659	1728	159206	0	174675
7376	8134	151174	1934	13327	0	174569
7377	7082	6946	1474	160201	0	175703
7378	5747	3012	1145	166658	0	176562
7379	4216	2434	151310	16242	0	174202
7380	4031	1805	6969	163675	0	176480
7381	148794	1394	3694	15977	0	169859
7382	8366	152595	3410	10302	0	174673
7383	155187	7230	2297	8647	0	173361
7384	157954	3384	1771	7284	0	170393
7385	162177	2906	1478	6328	0	172889
7386	14793	3306	1473	149942	0	169514
7387	9798	2015	134938	10596	0	157347
7388	8044	1927	132467	6563	0	149001
7389	5416	128470	8862	6434	0	149182
7390	2886	93080	3487	3938	0	103391
7391	1475	57204	1191	1365	0	61235
7392	1381	54914	1601	1355	0	59251
7393	1912	1814	51503	1225	0	56454
7394	37988	1440	2452	864	0	42744
7395	911	370	308	38135	0	39724
7396	431	163	154	37562	0	38310
7397	391	144	110	37635	0	38280
7398	264	37308	132	867	0	38571
7399	36477	615	161	553	0	37806
7400	756	210	36671	334	0	37971
7401	205	34544	599	260	0	35608
7402	265	544	220	35223	0	36252
7403	35286	165	144	745	0	36340
7404	683	127	87	35241	0	36138
7405	226	122	34385	708	0	35441
7406	214	137	34346	259	0	34956
7407	240	89	608	35598	0	36535
7408	240	43	219	35921	0	36423
7409	35843	55	123	908	0	36929
7410	617	78	35808	321	0	36824
7411	34661	56	574	366	0	35657
7412	35891	71	164	333	0	36459
7413	810	75	124	36080	0	37089
7414	287	88	37016	625	0	38016
7415	261	63	579	36977	0	37880
7416	37201	55	191	882	0	38329
7417	641	37205	150	305	0	38301
7418	38182	543	114	385	0	39224
7419	742	159	118	38914	0	39933
7420	256	40292	147	781	0	41476
7421	281	687	87	40727	0	41782
7422	249	220	99	41540	0	42108
7423	139	41302	103	1018	0	42562
7424	279	753	82	42150	0	43264
7425	275	237	87	43367	0	43966
7426	304	146	88	44643	0	45181
7427	169	113	44364	1283	0	45929
7428	115	44048	910	586	0	45659
7429	44684	897	299	512	0	46392
7430	1107	322	194	45460	0	47083
7431	348	48114	153	1047	0	49662
7432	50902	1055	124	661	0	52742
7433	1348	365	91	51345	0	53149
7434	625	256	66	51913	0	52860
7435	509	185	93	51095	0	51882
7436	413	150	81	50484	0	51128
7437	49698	147	111	1971	0	51927
7438	1463	155	72	50521	0	52211
7439	675	134	80	51453	0	52342
7440	50567	117	81	2080	0	52845
7441	1544	124	107	51118	0	52893
7442	579	174	50244	1711	0	52708
7443	604	152	1179	50643	0	52578
7444	49041	143	382	1933	0	51499
7445	1498	183	221	49851	0	51753
7446	619	200	49426	1716	0	51961
7447	436	166	48276	909	0	49787
7448	48966	115	1592	918	0	51591
7449	51859	119	568	802	0	53348
7450	52373	104	339	734	0	53550
7451	52594	129	211	677	0	53611
7452	2026	146	51274	441	0	53887
7453	1068	93	1302	50837	0	53300
7454	822	96	468	52752	0	54138
7455	51558	95	284	2105	0	54042
7456	1632	76	281	52301	0	54290
7457	642	106	51286	1792	0	53826
7458	660	86	1302	51688	0	53736
7459	391	119	52176	1845	0	54531
7460	351	51944	1490	887	0	54672
7461	52913	1179	695	816	0	55603
7462	1664	417	384	52875	0	55340
7463	779	254	51669	1577	0	54279
7464	746	146	1364	51760	0	54016
7465	667	121	564	54444	0	55796
7466	407	154	53878	2132	0	56571
7467	577	96	1548	54168	0	56389
7468	53615	103	641	2333	0	56692
7469	1688	200	49860	1088	0	52836
7470	49505	117	1374	1048	0	52044
7471	1732	50130	666	741	0	53269
7472	808	1326	50047	677	0	52858
7473	594	599	50594	636	0	52423
7474	997	719	1913	42522	0	46151
7475	633	213	778	47343	0	48967
7476	368	204	47531	2027	0	50130
7477	466	135	1520	47658	0	49779
7478	47709	123	703	2131	0	50666
7479	48534	109	496	1326	0	50465
7480	1867	127	467	47715	0	50176
7481	1069	151	383	47745	0	49348
7482	679	47405	366	2034	0	50484
7483	48785	1180	407	1293	0	51665
7484	1802	487	356	49019	0	51664
7485	851	49507	341	1888	0	52587
7486	50181	1288	409	1263	0	53141
7487	50985	531	431	1106	0	53053
7488	1955	51795	364	973	0	55087
7489	1161	1364	318	52408	0	55251
7490	878	548	352	52902	0	54680
7491	676	357	50379	2366	0	53778
7492	788	252	1492	50336	0	52868
7493	50004	233	709	2335	0	53281
7494	1887	203	490	50359	0	52939
7495	959	213	48826	2329	0	52327
7496	48659	234	1568	1425	0	51886
7497	2001	184	756	49643	0	52584
7498	1081	231	48940	2139	0	52391
7499	964	216	1616	49168	0	51964
7500	760	217	49171	2177	0	52325
7501	912	182	1746	49103	0	51943
7502	770	183	886	50691	0	52530
7503	48658	166	674	2626	0	52124
7504	1680	48612	590	1462	0	52344
7505	49393	1274	551	1340	0	52558
7506	49205	525	540	1118	0	51388
7507	49426	326	458	1122	0	51332
7508	2318	48184	561	905	0	51968
7509	1293	1361	48260	782	0	51696
7510	1099	565	1632	48323	0	51619
7511	48957	351	834	2053	0	52195
7512	49932	308	678	1285	0	52203
7513	2275	271	608	48171	0	51325
7514	48141	251	538	2137	0	51067
7515	2017	248	46936	1352	0	50553
7516	46655	231	1653	1171	0	49710
7517	2158	231	46796	971	0	50156
7518	1236	45566	1636	886	0	49324
7519	45499	1219	864	863	0	48445
7520	44005	530	693	848	0	46076
7521	2039	43315	593	749	0	46696
7522	43157	1272	593	861	0	45883
7523	42714	522	541	843	0	44620
7524	2020	362	41087	732	0	44201
7525	39603	258	1292	764	0	41917
7526	1649	252	39358	609	0	41868
7527	1043	488	1188	36122	0	38841
7528	849	37259	702	1169	0	39979
7529	730	956	37451	671	0	39808
7530	34042	984	1406	1076	0	37508
7531	33164	445	573	672	0	34854
7532	1225	241	338	31022	0	32826
7533	722	201	30748	857	0	32528
7534	639	219	785	30760	0	32403
7535	30858	147	415	1014	0	32434
7536	1026	31338	305	507	0	33176
7537	30840	633	272	517	0	32262
7538	31119	259	225	422	0	32025
7539	1101	30495	243	286	0	32125
7540	667	626	197	30633	0	32123
7541	31144	308	215	846	0	32513
7542	966	228	232	31316	0	32742
7543	666	187	219	32808	0	33880
7544	544	214	33001	934	0	34693
7545	558	166	697	32727	0	34148
7546	539	159	332	33234	0	34264
7547	32687	135	252	1128	0	34202
7548	33227	141	237	635	0	34240
7549	1259	177	224	32961	0	34621
7550	683	151	32099	974	0	33907
7551	560	148	31703	531	0	32942
7552	593	196	945	31668	0	33402
7553	485	169	32904	950	0	34508
7554	481	177	899	32274	0	33831
7555	478	142	456	32215	0	33291
7556	32572	113	329	1176	0	34190
7557	930	110	32178	591	0	33809
7558	31522	99	802	573	0	32996
7559	31743	84	395	535	0	32757
7560	1137	117	30652	391	0	32297
7561	638	122	30822	294	0	31876
7562	640	980	860	28821	0	31301
7563	469	28725	436	698	0	30328
7564	407	29849	326	389	0	30971
7565	570	607	210	27527	0	28914
7566	405	200	193	26960	0	27758
7567	307	138	167	27982	0	28594
7568	304	85	173	28293	0	28855
7569	27390	94	171	861	0	28516
7570	677	103	163	27613	0	28556
7571	365	93	27047	729	0	28234
7572	386	78	512	26297	0	27273
7573	294	26226	230	626	0	27376
7574	325	427	190	26683	0	27625
7575	26549	146	199	697	0	27591
7576	678	87	180	26869	0	27814
7577	302	109	26482	702	0	27595
7578	196	25734	589	358	0	26877
7579	246	431	254	26350	0	27281
7580	26093	148	170	740	0	27151
7581	26313	94	174	390	0	26971
7582	758	81	137	26195	0	27171
7583	368	74	24553	581	0	25576
7584	328	103	23145	250	0	23826
7585	23317	58	591	316	0	24282
7586	601	76	24112	187	0	24976
7587	274	66	23464	165	0	23969
7588	292	151	471	21527	0	22441
7589	22880	26	208	505	0	23619
7590	22377	22	136	294	0	22829
7591	22665	29	91	234	0	23019
7592	537	46	23502	132	0	24217
7593	249	45	23731	116	0	24141
7594	153	24921	483	118	0	25675
7595	177	350	193	24459	0	25179
7596	132	93	140	25283	0	25648
7597	192	61	135	24051	0	24439
7598	150	26	111	25247	0	25534
7599	116	28	25105	541	0	25790
7600	108	25186	425	273	0	25992
7601	26804	358	177	301	0	27640
7602	30483	113	160	330	0	31086
7603	31431	53	112	272	0	31868
7604	807	31867	125	196	0	32995
7605	393	640	94	31981	0	33108
7606	33010	182	107	852	0	34151
7607	778	34390	112	305	0	35585
7608	33667	717	99	380	0	34863
7609	824	33908	139	184	0	35055
7610	33868	798	99	279	0	35044
7611	34348	265	100	303	0	35016
7612	1092	166	125	34154	0	35537
7613	587	106	87	35634	0	36414
7614	294	131	35287	1097	0	36809
7615	259	156	34469	432	0	35316
7616	34699	92	1101	382	0	36274
7617	36484	92	387	301	0	37264
7618	1365	87	228	35199	0	36879
7619	663	89	167	35978	0	36897
7620	422	110	35076	1274	0	36882
7621	408	144	932	34680	0	36164
7622	261	156	35126	1212	0	36755
7623	405	139	1035	35085	0	36664
7624	426	130	379	36424	0	37359
7625	35553	106	249	1513	0	37421
7626	35603	114	172	747	0	36636
7627	1460	104	160	35084	0	36808
7628	722	81	186	35640	0	36629
7629	404	112	34720	1396	0	36632
7630	477	83	1006	34957	0	36523
7631	324	112	35036	1348	0	36820
7632	34399	97	1101	746	0	36343
7633	1302	85	456	35378	0	37221
7634	34845	69	333	1336	0	36583
7635	1228	34545	268	708	0	36749
7636	34857	926	262	658	0	36703
7637	1368	360	232	34506	0	36466
7638	758	227	232	34459	0	35676
7639	560	34067	219	1358	0	36204
7640	583	958	175	34899	0	36615
7641	396	360	34115	1397	0	36268
7642	582	222	1025	33991	0	35820
7643	387	143	32690	1315	0	34535
7644	303	31297	1047	795	0	33442
7645	376	796	552	31808	0	33532
7646	284	308	31715	1155	0	33462
7647	308	178	31178	645	0	32309
7648	510	194	1155	30364	0	32223
7649	30214	128	574	1214	0	32130
7650	990	93	30009	646	0	31738
7651	530	97	958	29782	0	31367
7652	30016	94	447	1277	0	31834
7653	955	29180	363	624	0	31122
7654	30839	797	278	724	0	32638
7655	1103	310	234	31026	0	32673
7656	604	222	169	31691	0	32686
7657	548	149	219	32187	0	33103
7658	31283	169	192	1544	0	33188
7659	1064	111	204	31939	0	33318
7660	533	128	290	32655	0	33606
7661	30734	128	312	1500	0	32674
7662	1048	150	30593	830	0	32621
7663	624	137	978	30961	0	32700
7664	479	120	30849	1235	0	32683
7665	30203	133	1038	830	0	32204
7666	1244	156	461	31031	0	32892
7667	638	239	31375	1175	0	33427
7668	30439	175	942	799	0	32355
7669	31785	156	443	704	0	33088
7670	1295	222	32287	623	0	34427
7671	785	190	930	32167	0	34072
7672	593	182	499	33378	0	34652
7673	410	138	33502	1495	0	35545
7674	338	32965	1065	964	0	35332
7675	449	829	33925	659	0	35862
7676	32066	348	1107	740	0	34261
7677	1048	202	34602	662	0	36514
7678	33097	130	1239	695	0	35161
7679	1159	111	34662	572	0	36504
7680	33241	55	1218	697	0	35211
7681	1148	34549	711	527	0	36935
7682	721	752	504	34543	0	36520
7683	625	295	385	35989	0	37294
7684	493	214	35514	1366	0	37587
7685	567	188	973	33877	0	35605
7686	459	34378	505	1267	0	36609
7687	33864	710	401	918	0	35893
7688	912	34050	316	773	0	36051
7689	529	764	348	34890	0	36531
7690	34692	314	332	1309	0	36647
7691	1028	35175	316	820	0	37339
7692	34613	846	330	670	0	36459
7693	1203	378	34986	490	0	37057
7694	722	210	1095	35059	0	37086
7695	606	204	550	35505	0	36865
7696	517	172	449	36639	0	37777
7697	35772	149	352	1571	0	37844
7698	36014	164	374	925	0	37477
7699	36257	152	335	727	0	37471
7700	35818	179	278	616	0	36891
7701	1435	138	33338	418	0	35329
7702	27571	92	611	303	0	28577
7703	783	27904	318	288	0	29293
7704	375	28137	207	166	0	28885
7705	28262	598	640	289	0	29789
7706	28610	203	227	259	0	29299
7707	661	89	116	27296	0	28162
7708	27989	83	98	580	0	28750
7709	27977	71	82	307	0	28437
7710	30720	35	92	276	0	31123
7711	834	44	103	30241	0	31222
7712	313	29755	81	544	0	30693
7713	170	30580	78	140	0	30968
7714	189	530	70	30502	0	31291
7715	30212	135	53	529	0	30929
7716	443	30469	56	168	0	31136
7717	190	400	42	30394	0	31026
7718	112	132	30686	404	0	31334
7719	28109	67	378	321	0	28875
7720	451	30699	106	101	0	31357
7721	120	31634	73	128	0	31955
7722	30830	433	40	224	0	31527
7723	462	138	31542	63	0	32205
7724	263	57	383	30454	0	31157
7725	125	31715	106	365	0	32311
7726	183	402	66	32046	0	32697
7727	201	103	44	31825	0	32173
7728	150	28901	128	491	0	29670
7729	198	401	27	32807	0	33433
7730	200	147	35	33039	0	33421
7731	32640	83	37	640	0	33400
7732	444	32443	39	195	0	33121
7733	32636	468	29	231	0	33364
7734	538	128	24	32548	0	33238
7735	175	33302	50	473	0	34000
7736	196	451	33131	123	0	33901
7737	234	223	414	33104	0	33975
7738	230	104	121	34435	0	34890
7739	91	108	34826	536	0	35561
7740	32990	94	466	308	0	33858
7741	625	69	139	38343	0	39176
7742	38452	72	73	854	0	39451
7743	760	102	37671	255	0	38788
7744	419	77	669	38118	0	39283
7745	221	97	40536	757	0	41611
7746	293	130	757	40536	0	41716
7747	261	78	256	41668	0	42263
7748	41455	80	153	1083	0	42771
7749	708	41826	109	444	0	43087
7750	41983	723	64	407	0	43177
7751	858	297	41918	183	0	43256
7752	449	164	700	41974	0	43287
7753	224	142	43901	800	0	45067
7754	38038	123	831	601	0	39593
7755	42498	77	268	416	0	43259
7756	979	120	42854	163	0	44116
7757	41979	69	772	336	0	43156
7758	44223	95	294	282	0	44894
7759	1155	65	175	43684	0	45079
7760	455	99	42967	834	0	44355
7761	343	122	44064	360	0	44889
7762	380	83	950	44921	0	46334
7763	360	90	386	44615	0	45451
7764	230	43808	288	1046	0	45372
7765	216	45714	211	479	0	46620
7766	45508	883	177	473	0	47041
7767	999	339	162	45208	0	46708
7768	408	44488	186	879	0	45961
7769	309	46300	191	404	0	47204
7770	44368	940	194	436	0	45938
7771	1050	360	163	45011	0	46584
7772	395	45383	171	937	0	46886
7773	464	854	150	45634	0	47102
7774	393	319	163	45776	0	46651
7775	430	222	149	45845	0	46646
7776	44943	170	157	1399	0	46669
7777	961	44818	186	587	0	46552
7778	569	871	176	45150	0	46766
7779	482	352	167	45573	0	46574
7780	433	239	171	45772	0	46615
7781	284	195	43880	1286	0	45645
7782	41879	182	909	774	0	43744
7783	1090	142	393	44481	0	46106
7784	43679	136	282	1236	0	45333
7785	43875	167	227	712	0	44981
7786	43819	166	238	594	0	44817
7787	1324	188	43410	352	0	45274
7788	552	43032	920	379	0	44883
7789	527	818	322	42622	0	44289
7790	312	400	42643	951	0	44306
7791	290	311	40840	475	0	41916
7792	393	358	954	39773	0	41478
7793	227	39895	425	862	0	41409
7794	40307	737	297	706	0	42047
7795	41029	338	180	625	0	42172
7796	41567	270	135	617	0	42589
7797	41506	202	140	519	0	42367
7798	1151	206	40755	336	0	42448
7799	39858	162	692	554	0	41266
7800	968	41733	359	344	0	43404
7801	559	724	254	42466	0	44003
7802	457	309	215	43231	0	44212
7803	42848	191	195	1236	0	44470
7804	985	140	206	42929	0	44260
7805	509	129	41363	1026	0	43027
7806	39217	121	755	694	0	40787
7807	41046	138	344	574	0	42102
7808	40894	113	282	533	0	41822
7809	1150	160	39905	291	0	41506
7810	36564	110	675	453	0	37802
7811	868	37623	405	309	0	39205
7812	38069	566	329	446	0	39410
7813	943	373	209	37322	0	38847
7814	524	263	156	37452	0	38395
7815	366	37078	174	872	0	38490
7816	367	626	163	37464	0	38620
7817	314	37209	162	782	0	38467
7818	359	710	153	36907	0	38129
7819	312	36607	172	727	0	37818
7820	359	652	130	36681	0	37822
7821	313	36746	146	758	0	37963
7822	367	707	128	37909	0	39111
7823	273	38170	156	826	0	39425
7824	41594	828	107	655	0	43184
7825	1196	351	111	42343	0	44001
7826	644	254	104	43088	0	44090
7827	517	164	87	45382	0	46150
7828	453	179	96	45997	0	46725
7829	286	174	46008	1815	0	48283
7830	425	168	1144	46229	0	47966
7831	432	139	445	47666	0	48682
7832	46354	136	250	1932	0	48672
7833	46119	127	173	1007	0	47426
7834	1611	46591	171	551	0	48924
7835	955	1114	116	46490	0	48675
7836	682	464	127	49739	0	51012
7837	50876	313	114	2049	0	53352
7838	1642	292	47910	879	0	50723
7839	47628	193	1231	788	0	49840
7840	1621	49561	516	474	0	52172
7841	46152	1159	186	409	0	47906
7842	46209	392	126	436	0	47163
7843	1621	45255	155	239	0	47270
7844	636	46797	116	235	0	47784
7845	674	1474	154	43567	0	45869
7846	319	540	43248	1159	0	45266
7847	41971	250	1120	671	0	44012
7848	1263	242	43161	296	0	44962
7849	41644	161	1180	400	0	43385
7850	1348	143	42742	229	0	44462
7851	575	42240	1258	217	0	44290
7852	496	1117	499	42143	0	44255
7853	40825	403	217	1315	0	42760
7854	41808	250	186	568	0	42812
7855	1728	189	132	41390	0	43439
7856	42423	163	115	1398	0	44099
7857	42631	194	97	697	0	43619
7858	1762	41630	126	359	0	43877
7859	42053	1213	113	454	0	43833
7860	1545	42334	163	256	0	44298
7861	867	1302	131	41630	0	43930
7862	40945	479	148	1496	0	43068
7863	42597	266	111	664	0	43638
7864	42902	239	98	441	0	43680
7865	1945	218	39454	2100	0	43717
7866	816	221	42247	282	0	43566
7867	736	140	1575	41993	0	44444
7868	703	148	521	43952	0	45324
7869	397	46015	315	1716	0	48443
7870	46112	1485	222	740	0	48559
7871	1852	580	189	45691	0	48312
7872	961	339	139	46910	0	48349
7873	529	261	45756	2088	0	48634
7874	432	44180	1488	890	0	46990
7875	417	46702	555	535	0	48209
7876	611	1877	277	46143	0	48908
7877	45291	718	221	1834	0	48064
7878	1855	354	209	45278	0	47696
7879	899	285	226	46863	0	48273
7880	45543	280	193	2300	0	48316
7881	46797	260	172	1134	0	48363
7882	2352	187	152	46003	0	48694
7883	1024	263	45227	1892	0	48406
7884	826	192	1487	45987	0	48492
7885	688	188	562	47284	0	48722
7886	45970	178	348	2540	0	49036
7887	1947	170	266	46588	0	48971
7888	46411	213	246	2304	0	49174
7889	2021	250	46458	1094	0	49823
7890	1138	223	1552	47573	0	50486
7891	904	215	605	48944	0	50668
7892	757	238	339	49822	0	51156
7893	695	229	272	49186	0	50382
7894	786	240	252	48561	0	49839
7895	523	279	45815	2779	0	49396
7896	45435	224	1687	1493	0	48839
7897	2052	208	705	46447	0	49412
7898	956	236	45164	2298	0	48654
7899	730	240	45929	1239	0	48138
7900	828	210	2115	45146	0	48299
7901	44764	256	896	2255	0	48171
7902	45537	256	509	1311	0	47613
7903	46252	258	477	1018	0	48005
7904	2795	242	414	42858	0	46309
7905	1272	44085	394	2153	0	47904
7906	44998	1646	342	1315	0	48301
7907	46227	687	374	926	0	48214
7908	46467	449	342	911	0	48169
7909	46519	360	360	781	0	48020
7910	2915	338	346	44388	0	47987
7911	1523	291	43764	2210	0	47788
7912	1181	249	1788	44354	0	47572
7913	903	294	44021	2413	0	47631
7914	43730	202	1890	1368	0	47190
7915	45329	191	841	1067	0	47428
7916	2670	185	43250	944	0	47049
7917	43320	155	1869	911	0	46255
7918	46016	186	842	1001	0	48045
7919	2889	245	530	43814	0	47478
7920	1559	43828	461	2125	0	47973
7921	44639	1560	420	1207	0	47826
7922	2516	928	360	41894	0	45698
7923	1351	41267	351	2029	0	44998
7924	961	1314	258	39448	0	41981
7925	710	481	38710	1793	0	41694
7926	717	38985	1245	1037	0	41984
7927	36912	1250	632	932	0	39726
7928	36742	570	615	786	0	38713
7929	35607	236	356	622	0	36821
7930	35968	161	322	626	0	37077
7931	1778	266	312	34092	0	36448
7932	986	34045	300	1300	0	36631
7933	32598	914	302	908	0	34722
7934	1424	401	33252	593	0	35670
7935	845	32306	1068	544	0	34763
7936	646	769	30205	450	0	32070
7937	533	370	863	26675	0	28441
7938	500	25140	434	843	0	26917
7939	520	671	282	27905	0	29378
7940	516	317	29127	944	0	30904
7941	559	208	735	28565	0	30067
7942	518	153	345	29783	0	30799
7943	490	162	243	30405	0	31300
7944	29202	122	206	1249	0	30779
7945	973	29250	231	651	0	31105
7946	623	676	213	29729	0	31241
7947	28873	268	231	1039	0	30411
7948	954	29145	214	622	0	30935
7949	29455	673	214	485	0	30827
7950	1051	314	29731	390	0	31486
7951	693	224	737	28906	0	30560
7952	563	29692	355	792	0	31402
7953	29956	700	254	503	0	31413
7954	1040	344	29268	371	0	31023
7955	637	27838	763	353	0	29591
7956	459	623	308	27836	0	29226
7957	396	319	231	28308	0	29254
7958	27787	236	185	908	0	29116
7959	852	166	207	27562	0	28787
7960	444	213	26737	753	0	28147
7961	468	180	518	25989	0	27155
7962	362	130	26997	735	0	28224
7963	422	200	579	25681	0	26882
7964	347	26761	295	636	0	28039
7965	26791	494	238	464	0	27987
7966	26019	264	148	396	0	26827
7967	757	24800	143	208	0	25908
7968	256	23155	96	154	0	23661
7969	347	286	134	22124	0	22891
7970	22008	101	75	342	0	22526
7971	332	90	55	21891	0	22368
7972	21752	57	59	357	0	22225
7973	296	21306	61	132	0	21795
7974	176	214	47	21889	0	22326
7975	134	115	22398	244	0	22891
7976	179	108	228	21973	0	22488
7977	148	71	98	22595	0	22912
7978	22999	65	51	413	0	23528
7979	243	23567	52	160	0	24022
7980	144	210	43	23836	0	24233
7981	23598	105	49	317	0	24069
7982	251	83	23842	125	0	24301
7983	23203	39	221	184	0	23647
7984	318	114	76	24190	0	24698
7985	150	25095	73	243	0	25561
7986	24884	232	79	218	0	25413
7987	290	115	25442	82	0	25929
7988	155	81	24818	67	0	25121
7989	84	24844	290	97	0	25315
7990	24219	182	167	121	0	24689
7991	217	65	32	24466	0	24780
7992	119	28	21	24565	0	24733
7993	24984	28	17	404	0	25433
7994	294	30	25002	118	0	25444
7995	165	27	268	25440	0	25900
7996	67	61	26933	305	0	27366
7997	120	27	312	26462	0	26921
7998	29	27222	139	443	0	27833
7999	109	301	65	28019	0	28494
8000	41	129	27696	371	0	28237
8001	26963	56	326	237	0	27582
8002	394	49	133	28375	0	28951
8003	145	49	28789	388	0	29371
8004	169	28	377	28059	0	28633
8005	146	22	150	28572	0	28890
8006	64	49	28146	476	0	28735
8007	66	62	28221	224	0	28573
8008	145	38	470	28770	0	29423
8009	72	44	29267	408	0	29791
8010	28341	27	457	289	0	29114
8011	426	27	200	29474	0	30127
8012	29314	23	113	533	0	29983
8013	444	46	28968	209	0	29667
8014	297	33	405	29295	0	30030
8015	120	53	31334	428	0	31935
8016	79	30877	491	252	0	31699
8017	77	372	31523	133	0	32105
8018	92	167	29872	127	0	30258
8019	29170	64	573	210	0	30017
8020	30527	49	242	220	0	31038
8021	557	53	31693	99	0	32402
8022	379	34	477	29903	0	30793
8023	282	46	260	31260	0	31848
8024	110	59	32460	577	0	33206
8025	68	31272	542	294	0	32176
8026	30635	423	242	284	0	31584
8027	477	178	32610	129	0	33394
8028	341	84	533	32360	0	33318
8029	265	61	268	33225	0	33819
8030	33850	43	168	804	0	34865
8031	34289	30	149	461	0	34929
8032	34352	37	159	316	0	34864
8033	34589	49	139	271	0	35048
8034	800	40	141	34252	0	35233
8035	315	67	35967	541	0	36890
8036	302	46	558	35618	0	36524
8037	269	64	274	36164	0	36771
8038	258	35	223	37920	0	38436
8039	170	68	37167	794	0	38199
8040	34927	26	584	454	0	35991
8041	749	30	273	37147	0	38199
8042	316	42	38316	711	0	39385
8043	190	38844	679	349	0	40062
8044	271	545	304	39678	0	40798
8045	257	205	222	40302	0	40986
8046	39591	100	169	1035	0	40895
8047	660	40418	183	427	0	41688
8048	316	584	40459	291	0	41650
8049	371	222	673	39539	0	40805
8050	295	116	305	40373	0	41089
8051	39853	73	229	1021	0	41176
8052	39588	60	173	555	0	40376
8053	921	65	155	40430	0	41571
8054	40136	63	162	939	0	41300
8055	794	39643	182	429	0	41048
8056	337	620	42189	322	0	43468
8057	434	243	679	41997	0	43353
8058	339	134	325	43657	0	44455
8059	309	93	214	43849	0	44465
8060	345	56	163	43102	0	43666
8061	181	42853	165	1020	0	44219
8062	42349	605	174	639	0	43767
8063	831	252	133	42636	0	43852
8064	370	45098	164	794	0	46426
8065	45408	630	128	656	0	46822
8066	45294	262	141	507	0	46204
8067	851	46626	165	348	0	47990
8068	570	643	130	47421	0	48764
8069	390	280	120	48018	0	48808
8070	371	178	151	46805	0	47505
8071	359	113	123	47687	0	48282
8072	48414	97	119	1272	0	49902
8073	48984	107	131	779	0	50001
8074	1094	49861	116	471	0	51542
8075	455	919	49766	296	0	51436
8076	434	344	880	49962	0	51620
8077	50639	172	316	1236	0	52363
8078	990	49181	210	547	0	50928
8079	441	50319	163	457	0	51380
8080	51460	1104	125	485	0	53174
8081	52406	421	111	417	0	53355
8082	1481	226	95	51592	0	53394
8083	578	211	52816	1156	0	54761
8084	467	223	53631	522	0	54843
8085	55869	189	1205	613	0	57876
8086	58898	160	421	546	0	60025
8087	58823	138	249	441	0	59651
8088	58472	154	163	435	0	59224
8089	58365	113	187	476	0	59141
8090	1404	58976	183	365	0	60928
8091	785	954	125	58151	0	60015
8092	383	62850	160	883	0	64276
8093	64001	994	146	673	0	65814
8094	63160	362	142	637	0	64301
8095	63106	216	98	465	0	63885
8096	63347	163	112	428	0	64050
8097	1220	62394	162	235	0	64011
8098	62661	820	146	421	0	64048
8099	1067	63016	119	269	0	64471
8100	694	907	77	63838	0	65516
8101	63575	280	66	1093	0	65014
8102	1064	227	65246	363	0	66900
8103	699	168	734	63585	0	65186
8104	535	182	238	66313	0	67268
8105	334	195	66830	1006	0	68365
8106	299	67093	780	489	0	68661
8107	67282	782	235	532	0	68831
8108	66963	303	167	477	0	67910
8109	1101	66642	151	288	0	68182
8110	655	846	89	66970	0	68560
8111	424	389	70247	857	0	71917
8112	322	73148	748	434	0	74652
8113	72552	863	261	600	0	74276
8114	1007	410	72908	214	0	74539
8115	66552	266	750	395	0	67963
8116	71387	196	274	396	0	72253
8117	1164	187	75273	239	0	76863
8118	533	75298	782	260	0	76873
8119	672	857	280	73510	0	75319
8120	391	335	77083	782	0	78591
8121	71403	238	828	552	0	73021
8122	75486	174	244	506	0	76410
8123	1076	76049	222	287	0	77634
8124	616	729	164	76249	0	77758
8125	461	318	146	77786	0	78711
8126	346	260	78075	850	0	79531
8127	301	79036	712	362	0	80411
8128	83834	766	222	728	0	85550
8129	84604	288	165	601	0	85658
8130	86204	248	138	580	0	87170
8131	1080	229	85356	172	0	86837
8132	82741	159	688	468	0	84056
8133	87134	164	299	419	0	88016
8134	1142	176	202	87458	0	88978
8135	539	198	85964	652	0	87353
8136	603	138	627	84583	0	85951
8137	413	240	87049	713	0	88415
8138	469	254	664	84040	0	85427
8139	281	85605	322	661	0	86869
8140	228	90865	200	292	0	91585
8141	394	746	170	91993	0	93303
8142	433	311	144	88563	0	89451
8143	90377	176	100	1183	0	91836
8144	777	210	90053	279	0	91319
8145	85451	115	631	589	0	86786
8146	734	91900	268	192	0	93094
8147	92441	623	144	536	0	93744
8148	92409	237	167	426	0	93239
8149	983	170	117	92456	0	93726
8150	490	177	96318	624	0	97609
8151	562	108	648	95641	0	96959
8152	311	100876	286	687	0	102160
8153	398	804	139	102170	0	103511
8154	360	293	141	102853	0	103647
8155	101856	181	115	1413	0	103565
8156	1020	148	114	100387	0	101669
8157	442	98947	182	907	0	100478
8158	452	766	88	101303	0	102609
8159	101365	318	92	1314	0	103089
8160	922	102263	154	447	0	103786
8161	556	893	92	105200	0	106741
8162	469	348	92	105574	0	106483
8163	446	223	112	108789	0	109570
8164	494	189	85	107402	0	108170
8165	108765	139	82	2015	0	111001
8166	1511	140	111	110188	0	111950
8167	777	121	103	111299	0	112300
8168	686	214	86	113106	0	114092
8169	254	114316	185	1896	0	116651
8170	112079	1462	124	1385	0	115050
8171	1699	604	114114	512	0	116929
8172	583	112950	1419	423	0	115375
8173	109158	1356	434	744	0	111692
8174	1503	543	113318	242	0	115606
8175	516	113590	1383	288	0	115777
8176	710	1648	496	111524	0	114378
8177	219	114669	291	1217	0	116396
8178	259	1470	113030	503	0	115262
8179	298	594	112229	371	0	113492
8180	143	113952	1594	357	0	116046
8181	113419	1292	614	830	0	116155
8182	112649	512	297	887	0	114345
8183	1562	420	109676	202	0	111860
8184	771	312	101006	203	0	102292
8185	390	306	106332	166	0	107194
8186	651	225	1766	104917	0	107559
8187	671	183	705	103596	0	105155
8188	560	158	417	108878	0	110013
8189	212	268	111886	1825	0	114191
8190	675	176	1467	105403	0	107721
8191	467	202	571	110280	0	111520
8192	171	216	108584	1953	0	110924
8193	102535	161	1653	1298	0	105647
8194	1867	202	664	112023	0	114756
8195	1114	172	412	111089	0	112787
8196	442	113499	381	2118	0	116440
8197	112650	1554	421	1486	0	116111
8198	1791	704	112735	573	0	115803
8199	109931	367	1812	853	0	112963
8200	2255	264	721	112724	0	115964
8201	827	373	114271	1966	0	117437
8202	911	243	1847	111613	0	114614
8203	112444	223	899	2632	0	116198
8204	1896	253	112413	1028	0	115590
8205	108446	202	1938	1219	0	111805
8206	111725	204	991	1064	0	113984
8207	113014	184	600	1008	0	114806
8208	2548	111330	573	584	0	115035
8209	1451	1690	412	114213	0	117766
8210	115997	730	388	2445	0	119560
8211	114587	399	426	1464	0	116876
8212	115562	302	1150	1212	0	118226
8213	3123	344	112917	533	0	116917
8214	116026	243	2143	924	0	119336
8215	3282	224	1035	123537	0	128078
8216	1419	250	122816	2833	0	127318
8217	1500	224	2750	125942	0	130416
8218	1187	185	1163	128247	0	130782
8219	737	283	128963	4144	0	134127
8220	1251	177	3321	127955	0	132704
8221	1217	180	1474	132639	0	135510
8222	661	387	147190	4782	0	153020
8223	150558	170	4295	3022	0	158045
8224	166270	186	2168	2006	0	170630
8225	7255	182	1478	170278	0	179193
8226	3564	301	169685	5466	0	179016
8227	3329	214	5577	163205	0	172325
8228	2270	162283	2557	6246	0	173356
8229	2856	4549	1788	162995	0	172188
8230	2254	1883	1467	167723	0	173327
8231	162915	1236	1440	9141	0	174732
8232	162393	898	1342	5863	0	170496
8233	167952	974	1318	4192	0	174436
8234	8947	911	948	163534	0	174340
8235	5349	746	778	167888	0	174761
8236	3793	704	161290	8729	0	174516
8237	4402	576	5256	155999	0	166233
8238	3333	159259	2563	7602	0	172757
8239	160475	4793	1805	5326	0	172399
8240	6558	157418	1716	4120	0	169812
8241	159063	5835	1608	4022	0	170528
8242	7655	3030	1478	150216	0	162379
8243	3784	155235	1350	7010	0	167379
8244	154944	6159	1152	4558	0	166813
8245	157427	3397	1002	3630	0	165456
8246	9639	2488	936	151898	0	164961
8247	5442	153021	1063	7080	0	166606
8248	4609	6116	940	154584	0	166249
8249	3469	3144	151663	8044	0	166320
8250	145703	2300	5566	5106	0	158675
8251	7310	148620	2684	4115	0	162729
8252	146329	6125	1870	3568	0	157892
8253	8377	3168	1391	145747	0	158683
8254	148266	2583	1613	7495	0	159957
8255	8460	1903	147206	4181	0	161750
8256	151404	1716	5867	3980	0	162967
8257	153887	1730	2856	3475	0	161948
8258	10343	1509	149533	3309	0	164694
8259	7563	1198	6239	147423	0	162423
8260	5985	1006	3422	151348	0	161761
8261	147046	1277	2712	9361	0	160396
8262	8577	144052	2340	5704	0	160673
8263	5732	5838	2325	141689	0	155584
8264	4476	2723	139420	8081	0	154700
8265	3568	2286	138572	5436	0	149862
8266	3674	135621	6899	4622	0	150816
8267	3581	5672	136400	3930	0	149583
8268	130457	3372	7019	3861	0	144709
8269	7239	2443	4164	127630	0	141476
8270	132308	1791	3406	7168	0	144673
8271	7393	1964	131122	4075	0	144554
8272	4955	1737	6803	129833	0	143328
8273	4460	1731	3677	134039	0	143907
8274	3632	1636	128906	8487	0	142661
8275	4266	1446	6164	129449	0	141325
8276	125696	1680	3528	8650	0	139554
8277	130087	1318	3053	5755	0	140213
8278	8600	1137	2633	128525	0	140895
8279	127108	1217	2610	8254	0	139189
8280	128662	1260	2044	5700	0	137666
8281	9381	122061	2109	4627	0	138178
8282	7215	4816	1729	124964	0	138724
8283	126897	2399	1567	8060	0	138923
8284	9378	1960	1585	126205	0	139128
8285	125696	1560	1775	8392	0	137423
8286	9124	1781	1589	124447	0	136941
8287	5849	1717	121632	8705	0	137903
8288	4944	120999	5607	5777	0	137327
8289	5144	5360	2911	108520	0	121935
8290	4698	118983	2416	7250	0	133347
8291	117612	5922	2170	5263	0	130967
8292	7304	113896	2321	4457	0	127978
8293	4845	115453	2208	3664	0	126170
8294	4338	7218	1991	111762	0	125309
8295	111190	4736	1886	7199	0	125011
8296	7159	3467	1499	111924	0	124049
8297	110821	3035	1452	7932	0	123240
8298	111052	2993	1339	5284	0	120668
8299	8313	109409	1515	4413	0	123650
8300	112306	5830	1562	4103	0	123801
8301	113518	3228	1760	3828	0	122334
8302	114302	2777	1599	3349	0	122027
8303	10455	2197	104618	3052	0	120322
8304	7381	2271	4895	104849	0	119396
8305	6731	1891	2515	108835	0	119972
8306	5393	1894	102462	7762	0	117511
8307	106211	1711	5306	5022	0	118250
8308	110010	1263	3273	4671	0	119217
8309	109381	1252	2639	4134	0	117406
8310	105327	1120	2254	4300	0	113001
8311	9860	98211	2096	3753	0	113920
8312	100140	4206	1575	3245	0	109166
8313	9969	2473	1400	95419	0	109261
8314	7006	1936	86271	5484	0	100697
8315	87760	1385	3576	3466	0	96187
8316	7935	86021	2059	2831	0	98846
8317	80390	3836	1607	2452	0	88285
8318	6684	76649	1311	2602	0	87246
8319	4526	73635	1258	2628	0	82047
8320	3928	72899	1409	2322	0	80558
8321	3598	72664	1479	2250	0	79991
8322	2998	3483	54529	1607	0	62617
8323	2740	4507	2583	41563	0	51393
8324	1220	879	37214	1725	0	41038
8325	28536	503	1080	792	0	30911
8326	1228	28724	482	579	0	31013
8327	604	29203	327	548	0	30682
8328	623	1181	340	27983	0	30127
8329	705	634	188	28658	0	30185
8330	526	599	27868	1170	0	30163
8331	565	550	28000	579	0	29694
8332	547	481	981	27535	0	29544
8333	526	360	27774	1092	0	29752
8334	568	27601	934	614	0	29717
8335	690	927	441	26714	0	28772
8336	723	443	336	29108	0	30610
8337	626	295	28424	1259	0	30604
8338	778	230	891	27858	0	29757
8339	28416	213	439	1206	0	30274
8340	1225	277	382	27933	0	29817
8341	676	243	300	28158	0	29377
8342	476	205	27298	1449	0	29428
8343	26093	190	926	901	0	28110
8344	1213	27346	533	535	0	29627
8345	904	803	278	27319	0	29304
8346	782	383	27209	1013	0	29387
8347	746	364	836	27155	0	29101
8348	27539	346	302	1128	0	29315
8349	1256	340	27292	606	0	29494
8350	836	344	810	27248	0	29238
8351	593	234	28146	1045	0	30018
8352	553	27885	926	675	0	30039
8353	660	933	27735	377	0	29705
8354	408	27026	915	480	0	28829
8355	326	723	23512	282	0	24843
8356	293	504	682	20164	0	21643
8357	196	21393	325	431	0	22345
8358	20767	536	149	272	0	21724
8359	543	264	111	20929	0	21847
8360	21408	179	146	512	0	22245
8361	621	120	91	21985	0	22817
8362	403	130	92	22559	0	23184
8363	22256	129	128	712	0	23225
8364	22958	86	95	412	0	23551
8365	807	94	135	23729	0	24765
8366	404	148	24329	594	0	25475
8367	316	23900	560	291	0	25067
8368	254	549	24378	185	0	25366
8369	208	24597	590	143	0	25538
8370	23914	497	289	263	0	24963
8371	566	269	23558	148	0	24541
8372	324	118	23409	136	0	23987
8373	251	104	635	22489	0	23479
8374	23241	74	268	608	0	24191
8375	567	79	24367	312	0	25325
8376	313	25671	523	154	0	26661
8377	26342	452	248	225	0	27267
8378	26696	204	137	248	0	27285
8379	27113	128	125	238	0	27604
8380	27345	105	160	168	0	27778
8381	27086	182	112	175	0	27555
8382	728	122	26726	107	0	27683
8383	373	224	471	25326	0	26394
8384	223	25885	261	409	0	26778
8385	26368	452	180	294	0	27294
8386	500	26771	139	111	0	27521
8387	25278	373	90	169	0	25910
8388	25212	133	78	162	0	25585
8389	448	25020	109	108	0	25685
8390	25609	367	60	159	0	26195
8391	500	139	61	25544	0	26244
8392	288	83	58	25812	0	26241
8393	181	75	25413	461	0	26130
8394	160	25771	368	198	0	26497
8395	185	370	166	25882	0	26603
8396	174	153	147	26309	0	26783
8397	181	94	68	26414	0	26757
8398	125	108	25730	458	0	26421
8399	24001	85	378	272	0	24736
8400	430	117	178	25996	0	26721
8401	26332	63	94	471	0	26960
8402	498	58	84	26277	0	26917
8403	227	113	26806	411	0	27557
8404	230	108	26680	202	0	27220
8405	25936	50	450	257	0	26693
8406	27506	67	206	180	0	27959
8407	518	27003	131	101	0	27753
8408	261	347	27196	97	0	27901
8409	269	147	375	26396	0	27187
8410	515	178	295	21529	0	22517
8411	28131	70	104	579	0	28884
8412	28111	85	73	319	0	28588
8413	28115	70	103	238	0	28526
8414	523	75	27820	110	0	28528
8415	28284	59	349	205	0	28897
8416	498	70	164	28764	0	29496
8417	307	71	101	28897	0	29376
8418	245	63	81	29093	0	29482
8419	130	28657	93	510	0	29390
8420	28407	320	101	310	0	29138
8421	451	162	89	28398	0	29100
8422	241	106	28333	402	0	29082
8423	226	64	344	27769	0	28403
8424	137	28289	203	408	0	29037
8425	28530	321	128	336	0	29315
8426	443	152	92	28404	0	29091
8427	267	105	88	28188	0	28648
8428	212	72	28386	501	0	29171
8429	211	72	348	27860	0	28491
8430	162	28364	183	469	0	29178
8431	192	335	124	28883	0	29534
8432	162	157	28863	431	0	29613
8433	25702	88	367	359	0	26516
8434	27880	67	171	294	0	28412
8435	465	28709	127	142	0	29443
8436	28052	283	86	238	0	28659
8437	29050	131	61	215	0	29457
8438	453	29057	90	143	0	29743
8439	263	351	58	29314	0	29986
8440	29992	133	66	473	0	30664
8441	372	30513	88	213	0	31186
8442	205	343	30791	105	0	31444
8443	30269	151	376	245	0	31041
8444	32078	76	147	192	0	32493
8445	32278	50	82	228	0	32638
8446	32307	58	58	221	0	32644
8447	572	33063	68	115	0	33818
8448	33538	391	45	261	0	34235
8449	34492	142	42	230	0	34906
8450	35144	88	38	178	0	35448
8451	776	55	42	35218	0	36091
8452	34934	58	52	650	0	35694
8453	534	37188	69	201	0	37992
8454	243	537	39433	100	0	40313
8455	333	176	564	40741	0	41814
8456	41507	90	183	873	0	42653
8457	828	79	41758	217	0	42882
8458	477	86	720	41432	0	42715
8459	198	90	41851	733	0	42872
8460	144	41474	770	323	0	42711
8461	310	724	224	40591	0	41849
8462	125	263	41248	753	0	42389
8463	121	40983	732	255	0	42091
8464	343	671	240	40530	0	41784
8465	40964	192	141	859	0	42156
8466	41128	77	93	427	0	41725
8467	41465	110	81	267	0	41923
8468	41172	76	112	288	0	41648
8469	41090	48	90	296	0	41524
8470	951	87	40759	109	0	41906
8471	40591	51	661	264	0	41567
8472	42296	52	218	268	0	42834
8473	1023	52	163	41948	0	43186
8474	42165	87	94	799	0	43145
8475	40495	75	81	449	0	41100
8476	869	39829	134	146	0	40978
8477	527	670	104	40354	0	41655
8478	407	180	71	41167	0	41825
8479	40685	94	60	996	0	41835
8480	840	40153	110	352	0	41455
8481	394	41642	103	189	0	42328
8482	468	748	70	42156	0	43442
8483	423	270	75	42760	0	43528
8484	431	131	107	42051	0	42720
8485	401	94	84	43212	0	43791
8486	42096	110	69	1117	0	43392
8487	41836	96	55	569	0	42556
8488	1071	115	42240	241	0	43667
8489	656	100	668	41229	0	42653
8490	481	117	187	42529	0	43314
8491	254	128	41964	1005	0	43351
8492	40086	94	716	598	0	41494
8493	869	41752	261	296	0	43178
8494	41912	732	120	324	0	43088
8495	1059	282	109	41670	0	43120
8496	386	180	42240	901	0	43707
8497	455	103	724	42745	0	44027
8498	276	113	44750	950	0	46089
8499	241	45315	792	469	0	46817
8500	44488	735	310	492	0	46025
8501	44822	242	167	362	0	45593
8502	974	45025	198	214	0	46411
8503	499	719	139	44382	0	45739
8504	43537	255	135	997	0	44924
8505	829	43349	185	419	0	44782
8506	523	737	125	44027	0	45412
8507	44290	285	110	966	0	45651
8508	1001	202	43406	356	0	44965
8509	42323	140	738	488	0	43689
8510	907	44015	324	311	0	45557
8511	44308	727	196	419	0	45650
8512	44188	278	216	364	0	45046
8513	1059	242	43656	258	0	45215
8514	724	188	757	41985	0	43654
8515	543	172	270	43907	0	44892
8516	369	218	43791	969	0	45347
8517	462	170	777	42540	0	43949
8518	586	176	332	40890	0	41984
8519	44291	134	204	1146	0	45775
8520	44719	142	185	566	0	45612
8521	1160	135	172	44147	0	45614
8522	539	157	44519	916	0	46131
8523	519	155	790	44432	0	45896
8524	419	166	305	45257	0	46147
8525	370	141	45580	1091	0	47182
8526	498	124	767	45998	0	47387
8527	45755	97	334	1087	0	47273
8528	45780	116	196	663	0	46755
8529	989	45533	224	433	0	47179
8530	46386	706	189	507	0	47788
8531	46408	232	155	518	0	47313
8532	1072	46788	205	343	0	48408
8533	47685	760	115	484	0	49044
8534	48054	246	121	439	0	48860
8535	49050	151	132	439	0	49772
8536	1251	156	47399	317	0	49123
8537	46729	104	814	451	0	48098
8538	1192	108	263	48488	0	50051
8539	48397	112	213	1124	0	49846
8540	1103	136	47893	434	0	49566
8541	595	46769	832	308	0	48504
8542	46973	774	275	387	0	48409
8543	1001	48556	214	232	0	50003
8544	576	827	190	48113	0	49706
8545	481	266	111	49665	0	50523
8546	49434	198	121	1178	0	50931
8547	48851	121	139	578	0	49689
8548	1194	146	47782	272	0	49394
8549	582	145	43956	227	0	44910
8550	360	120	45532	199	0	46211
8551	501	384	916	44398	0	46199
8552	274	97	45368	813	0	46552
8553	240	148	42318	270	0	42976
8554	633	908	760	39554	0	41855
8555	43041	167	280	851	0	44339
8556	43833	37	143	382	0	44395
8557	44256	34	110	321	0	44721
8558	44481	33	102	237	0	44853
8559	733	28	80	44439	0	45280
8560	395	34	90	44956	0	45475
8561	190	50	46406	588	0	47234
8562	269	40	555	45145	0	46009
8563	457	74	239	43436	0	44206
8564	47807	41	132	884	0	48864
8565	47704	35	115	429	0	48283
8566	867	27	73	47691	0	48658
8567	48161	24	104	848	0	49137
8568	48815	24	99	401	0	49339
8569	950	34	103	48894	0	49981
8570	488	30	79	48800	0	49397
8571	270	45	47885	869	0	49069
8572	244	82	46541	412	0	47279
8573	306	74	811	48160	0	49351
8574	283	37	333	49568	0	50221
8575	199	59	49687	865	0	50810
8576	46691	30	707	589	0	48017
8577	47959	20	261	458	0	48698
8578	957	52	47967	184	0	49160
8579	417	48098	706	220	0	49441
8580	49205	546	293	385	0	50429
8581	754	217	53423	151	0	54545
8582	510	122	709	52666	0	54007
8583	371	91	275	54925	0	55662
8584	57407	31	222	1096	0	58756
8585	60656	23	180	704	0	61563
8586	1018	41	122	61532	0	62713
8587	591	29	108	65078	0	65806
8588	65078	26	127	1205	0	66436
8589	65305	33	136	683	0	66157
8590	64729	35	100	577	0	65441
8591	1182	69	65511	229	0	66991
8592	722	35	828	65349	0	66934
8593	469	30	311	67487	0	68297
8594	67227	14	207	1392	0	68840
8595	954	67286	199	509	0	68948
8596	72215	754	134	616	0	73719
8597	1320	73197	166	310	0	74993
8598	671	1079	147	75107	0	77004
8599	576	275	135	76166	0	77152
8600	320	184	75100	1709	0	77313
8601	539	82	1288	74269	0	76178
8602	311	108	75166	1602	0	77187
8603	492	62	1438	75101	0	77093
8604	483	89	476	75540	0	76588
8605	313	72901	366	1837	0	75417
8606	296	76260	293	802	0	77651
8607	503	1478	221	74547	0	76749
8608	564	457	219	77193	0	78433
8609	471	264	204	77667	0	78606
8610	533	161	181	77902	0	78777
8611	481	152	185	79529	0	80347
8612	317	173	77819	2158	0	80467
8613	563	117	1444	76331	0	78455
8614	479	112	461	79417	0	80469
8615	316	172	76324	2178	0	78990
8616	301	75636	1556	1036	0	78529
8617	495	1325	490	77071	0	79381
8618	318	431	76689	1841	0	79279
8619	269	77657	1557	920	0	80403
8620	531	1391	512	78521	0	80955
8621	80261	420	383	2160	0	83224
8622	1768	302	298	80009	0	82377
8623	812	231	239	80811	0	82093
8624	581	181	257	82135	0	83154
8625	550	231	233	80411	0	81425
8626	318	77891	268	2377	0	80854
8627	477	1363	239	80839	0	82918
8628	82811	470	233	2615	0	86129
8629	1743	309	244	84398	0	86694
8630	828	223	241	84113	0	85405
8631	593	198	235	85887	0	86913
8632	82097	222	272	2890	0	85481
8633	82379	196	212	1692	0	84479
8634	2095	180	211	83628	0	86114
8635	79632	223	220	2448	0	82523
8636	81009	212	185	1536	0	82942
8637	1723	82158	232	1030	0	85143
8638	81458	1278	217	1284	0	84237
8639	1587	81561	256	856	0	84260
8640	612	82325	238	857	0	84032
8641	627	1513	289	83735	0	86164
8642	415	606	85009	1777	0	87807
8643	654	454	1258	81827	0	84193
8644	563	311	449	83801	0	85124
8645	307	83191	345	1933	0	85776
8646	82769	1378	216	1324	0	85687
8647	1488	488	189	83663	0	85828
8648	539	432	90158	1807	0	92936
8649	662	341	1191	88787	0	90981
8650	303	91700	473	1877	0	94353
8651	92209	1298	299	1453	0	95259
8652	1521	482	201	93607	0	95811
8653	577	391	94504	1902	0	97374
8654	649	360	1223	93750	0	95982
8655	368	91421	473	1954	0	94216
8656	421	1372	296	93710	0	95799
8657	97184	534	266	2505	0	100489
8658	98307	369	246	1698	0	100620
8659	99131	288	299	1532	0	101250
8660	2136	101206	277	1091	0	104710
8661	102160	1657	273	1201	0	105291
8662	2196	615	210	103289	0	106310
8663	102128	417	244	2710	0	105499
8664	2016	103081	249	1282	0	106628
8665	1056	1818	223	104779	0	107876
8666	559	860	105420	2295	0	109134
8667	96103	549	1584	1848	0	100084
8668	1811	105871	589	1069	0	109340
8669	976	1796	331	106685	0	109788
8670	770	727	243	108849	0	110589
8671	790	439	239	106747	0	108215
8672	703	339	241	104362	0	105645
8673	417	105644	259	2718	0	109038
8674	106147	1740	204	1837	0	109928
8675	106000	738	204	1437	0	108379
8676	2302	558	107793	869	0	111522
8677	1286	381	1646	108245	0	111558
8678	674	408	109305	2278	0	112665
8679	105103	351	1831	1637	0	108922
8680	108384	359	631	1361	0	110735
8681	104337	310	416	1131	0	106194
8682	2728	292	293	101870	0	105183
8683	1071	101996	281	2196	0	105544
8684	103523	1719	206	1453	0	106901
8685	2418	766	172	101613	0	104969
8686	101351	440	243	2649	0	104683
8687	2339	386	97409	1058	0	101192
8688	1059	409	95497	809	0	97774
8689	98562	312	1973	910	0	101757
8690	2469	267	722	99572	0	103030
8691	98780	219	433	2532	0	101964
8692	2265	98848	330	1074	0	102517
8693	99623	1765	290	1175	0	102853
8694	100585	697	238	1088	0	102608
8695	2818	573	99090	548	0	103029
8696	1170	417	90821	348	0	92756
8697	731	92184	1887	482	0	95284
8698	1032	1455	958	91605	0	95050
8699	92268	473	639	1840	0	95220
8700	1765	300	221	91851	0	94137
8701	1084	253	183	94036	0	95556
8702	663	282	92053	1808	0	94806
8703	88891	226	1267	1194	0	91578
8704	1797	295	535	94444	0	97071
8705	912	296	93001	1567	0	95776
8706	732	352	90403	708	0	92195
8707	801	420	1681	92177	0	95079
8708	607	269	93352	1551	0	95779
8709	617	321	92400	760	0	94098
8710	921	225	1717	86472	0	89335
8711	431	304	94799	1522	0	97056
8712	749	239	1514	90820	0	93322
8713	413	90718	733	1634	0	93498
8714	94922	1265	429	1402	0	98018
8715	1478	96850	432	671	0	99431
8716	963	1523	333	95821	0	98640
8717	583	98328	405	1785	0	101101
8718	481	1748	102072	833	0	105134
8719	1117	627	1795	114021	0	117560
8720	539	532	133961	2819	0	137851
8721	129107	284	3466	1855	0	134712
8722	3571	139916	1497	730	0	145714
8723	141005	3518	878	964	0	146365
8724	4839	1413	562	138095	0	144909
8725	140277	829	558	4186	0	145850
8726	4596	593	138945	1588	0	145722
8727	2002	139588	3733	1014	0	146337
8728	137722	3553	1467	1182	0	143924
8729	4664	1525	963	130514	0	137666
8730	2049	137598	772	3330	0	143749
8731	1995	3818	577	137990	0	144380
8732	137103	1660	531	5161	0	144455
8733	4145	147700	679	2120	0	154644
8734	147555	4447	710	1937	0	154649
8735	5400	2063	144955	896	0	153314
8736	144207	1281	4292	1186	0	150966
8737	6173	764	1749	144708	0	153394
8738	144207	603	1147	5308	0	151265
8739	5341	143986	901	1996	0	152224
8740	3134	4259	958	143547	0	151898
8741	2457	1951	581	147250	0	152239
8742	1481	1219	140125	5827	0	148652
8743	1994	830	4225	138601	0	145650
8744	1736	932	1769	142943	0	147380
8745	1697	713	1095	143684	0	147189
8746	1903	607	786	144715	0	148011
8747	996	854	140733	6773	0	149356
8748	1282	132495	4558	3224	0	141559
8749	1615	4214	2127	134264	0	142220
8750	131919	1690	1258	5747	0	140614
8751	132860	1088	995	3425	0	138368
8752	5876	133043	970	2177	0	142066
8753	131466	4699	780	2118	0	139063
8754	132418	1830	942	2133	0	137323
8755	131769	1218	801	2208	0	135996
8756	6476	128301	1072	1653	0	137502
8757	123931	4161	658	1804	0	130554
8758	5905	1935	657	119917	0	128414
8759	2407	1214	117774	4805	0	126200
8760	1734	117036	3899	2412	0	125081
8761	1979	4240	1907	115194	0	123320
8762	1288	2032	114228	4326	0	121874
8763	111806	1179	3949	2542	0	119476
8764	4981	864	1590	112843	0	120278
8765	2882	822	996	114420	0	119120
8766	2109	954	733	113560	0	117356
8767	2122	716	616	114297	0	117751
8768	1492	845	107981	5957	0	116275
8769	102173	687	3829	3377	0	110066
8770	4275	106993	1625	2034	0	114927
8771	106012	3811	1065	1854	0	112742
8772	4566	107395	808	1605	0	114374
8773	107926	4301	902	1585	0	114714
8774	5156	2044	704	106793	0	114697
8775	2308	1265	105825	4702	0	114100
8776	1736	881	105725	2420	0	110762
8777	1780	883	4811	103724	0	111198
8778	1587	693	2054	105971	0	110305
8779	1396	695	1214	108030	0	111335
8780	102885	656	958	6696	0	111195
8781	4334	713	102798	3409	0	111254
8782	2110	100225	4179	2322	0	108836
8783	1948	105917	1688	1672	0	111225
8784	100341	4938	1046	1753	0	108078
8785	4768	2133	100299	1355	0	108555
8786	2221	99983	3948	1495	0	107647
8787	2029	3988	98798	1235	0	106050
8788	1566	1939	4195	97890	0	105590
8789	1383	1288	98317	4303	0	105291
8790	1303	1080	99184	2292	0	103859
8791	1446	992	4814	97206	0	104458
8792	1239	904	97074	4637	0	103854
8793	1220	873	98219	2623	0	102935
8794	1603	795	4987	94851	0	102236
8795	93835	867	2571	4573	0	101846
8796	4060	1132	94080	2302	0	101574
8797	2226	997	4193	92773	0	100189
8798	1760	860	2037	96074	0	100731
8799	92582	797	1764	5464	0	100607
8800	4225	943	1212	94231	0	100611
8801	91672	627	1403	5206	0	98908
8802	4355	90503	1207	2908	0	98973
8803	2341	3449	1336	93090	0	100216
8804	92252	1427	1320	4830	0	99829
8805	94720	941	1086	2986	0	99733
8806	5301	694	1173	92995	0	100163
8807	2505	777	91844	4691	0	99817
8808	88939	595	3878	2897	0	96309
8809	4297	91571	1800	2123	0	99791
8810	87187	3443	1559	2183	0	94372
8811	92685	1493	1004	1977	0	97159
8812	93433	1006	911	1876	0	97226
8813	5806	737	88910	1580	0	97033
8814	2667	87387	3566	1701	0	95321
8815	2564	3942	1741	85619	0	93866
8816	2132	2403	1259	87979	0	93773
8817	1470	1172	84706	4867	0	92215
8818	1478	77756	3187	2613	0	85034
8819	1149	62528	1208	1431	0	66316
8820	630	46946	521	610	0	48707
8821	41754	1490	2141	541	0	45926
8822	1483	500	364	39586	0	41933
8823	625	284	274	40296	0	41479
8824	501	220	39800	1223	0	41744
8825	38179	264	967	598	0	40008
8826	1217	205	348	39420	0	41190
8827	704	369	326	39972	0	41371
8828	480	233	39189	1189	0	41091
8829	302	38809	962	564	0	40637
8830	482	1227	360	38505	0	40574
8831	281	307	38697	1040	0	40325
8832	161	34567	740	415	0	35883
8833	28163	314	199	278	0	28954
8834	360	120	29433	122	0	30035
8835	210	87	283	28195	0	28775
8836	101	29152	130	279	0	29662
8837	29118	288	90	211	0	29707
8838	345	76	57	29085	0	29563
8839	29192	70	85	396	0	29743
8840	29108	67	52	206	0	29433
8841	348	29352	57	148	0	29905
8842	29453	261	65	224	0	30003
8843	30452	77	52	278	0	30859
8844	328	113	30842	68	0	31351
8845	30128	48	264	214	0	30654
8846	332	60	30827	77	0	31296
8847	30053	49	258	170	0	30530
8848	30659	38	84	158	0	30939
8849	301	84	31578	52	0	32015
8850	221	61	205	31166	0	31653
8851	103	69	32060	226	0	32458
8852	115	71	29230	109	0	29525
8853	141	73	32448	71	0	32733
8854	187	94	240	32216	0	32737
8855	140	28	82	35608	0	35858
8856	126	31	38	35980	0	36175
8857	143	35	50	36789	0	37017
8858	67	42	37898	484	0	38491
8859	212	29	435	36971	0	37647
8860	65	37002	142	477	0	37686
8861	66	438	40056	136	0	40696
8862	199	117	489	38892	0	39697
8863	64	76	41353	556	0	42049
8864	48	40469	558	228	0	41303
8865	45	41934	214	133	0	42326
8866	133	619	115	41686	0	42553
8867	54	244	41630	542	0	42470
8868	70	139	41497	182	0	41888
8869	173	59	712	41613	0	42557
8870	195	44	232	41878	0	42349
8871	157	59	127	43221	0	43564
8872	50	108	42667	721	0	43546
8873	41	42190	583	319	0	43133
8874	31	44262	254	155	0	44702
8875	147	704	174	43735	0	44760
8876	61	235	43501	647	0	44444
8877	66	137	43086	287	0	43576
8878	37	45298	780	195	0	46310
8879	45059	646	265	303	0	46273
8880	569	46250	198	136	0	47153
8881	180	741	48489	95	0	49505
8882	47455	268	797	274	0	48794
8883	866	103	291	50094	0	51354
8884	51478	63	188	1071	0	52800
8885	986	91	135	51671	0	52883
8886	460	108	100	52741	0	53409
8887	52626	126	93	1310	0	54155
8888	887	54620	139	428	0	56074
8889	314	981	54447	211	0	55953
8890	161	55539	962	184	0	56846
8891	54641	1019	340	369	0	56369
8892	902	55549	219	167	0	56837
8893	55257	1037	146	374	0	56814
8894	55485	380	123	392	0	56380
8895	1221	55915	153	136	0	57425
8896	593	1022	123	55209	0	56947
8897	55019	373	131	1213	0	56736
8898	55658	200	118	548	0	56524
8899	1387	163	92	54863	0	56505
8900	510	151	53607	1058	0	55326
8901	328	165	53530	381	0	54404
8902	357	188	1194	54156	0	55895
8903	158	174	53505	1068	0	54905
8904	50187	184	1066	626	0	52063
8905	1028	52873	387	350	0	54638
8906	535	969	212	53539	0	55255
8907	398	347	163	53858	0	54766
8908	357	198	161	53393	0	54109
8909	391	175	132	52387	0	53085
8910	355	124	138	53355	0	53972
8911	226	174	52483	1358	0	54241
8912	194	52379	973	577	0	54123
8913	52945	981	353	523	0	54802
8914	1173	357	246	52455	0	54231
8915	542	196	198	53066	0	54002
8916	382	156	176	53101	0	53815
8917	186	52804	218	1438	0	54646
8918	335	1047	170	54091	0	55643
8919	324	438	159	54804	0	55725
8920	52855	229	140	1665	0	54889
8921	1032	51438	174	712	0	53356
8922	387	52544	177	500	0	53608
8923	353	1205	130	52919	0	54607
8924	51796	467	135	1465	0	53863
8925	1115	295	52639	568	0	54617
8926	48962	229	1039	728	0	50958
8927	1232	206	54346	350	0	56134
8928	623	217	1124	53921	0	55885
8929	453	203	411	55168	0	56235
8930	370	205	220	54932	0	55727
8931	331	175	170	54737	0	55413
8932	395	190	200	53638	0	54423
8933	53705	190	165	1813	0	55873
8934	1125	205	52815	714	0	54859
8935	558	191	1050	53586	0	55385
8936	305	221	55762	1317	0	57605
8937	234	55983	1152	680	0	58049
8938	55066	1066	451	712	0	57295
8939	1160	397	58321	447	0	60325
8940	647	240	1113	58832	0	60832
8941	455	174	461	60460	0	61550
8942	246	208	60802	1685	0	62941
8943	237	212	60728	746	0	61923
8944	490	208	1486	56920	0	59104
8945	61119	146	527	1767	0	63559
8946	61721	152	353	922	0	63148
8947	1504	61340	257	538	0	63639
8948	62678	1185	217	684	0	64764
8949	1507	414	216	60409	0	62546
8950	565	63589	267	1385	0	65806
8951	516	1198	199	64723	0	66636
8952	384	446	65938	1515	0	68283
8953	538	262	1205	62922	0	64927
8954	557	240	417	65534	0	66748
8955	62501	136	290	1772	0	64699
8956	1033	62718	270	797	0	64818
8957	61434	1026	207	662	0	63329
8958	1143	61735	224	437	0	63539
8959	58896	1023	213	487	0	60619
8960	1098	58967	190	337	0	60592
8961	450	59152	160	354	0	60116
8962	59589	1070	164	471	0	61294
8963	1204	516	198	57435	0	59353
8964	419	58735	178	946	0	60278
8965	59930	883	192	701	0	61706
8966	60011	318	139	620	0	61088
8967	61235	219	156	564	0	62174
8968	60511	174	163	500	0	61348
8969	1153	60863	168	342	0	62526
8970	567	849	137	61904	0	63457
8971	453	338	132	62874	0	63797
8972	63146	247	133	1379	0	64905
8973	1074	208	109	62513	0	63904
8974	62050	152	104	1263	0	63569
8975	996	199	60587	489	0	62271
8976	58688	139	729	670	0	60226
8977	954	216	61416	330	0	62916
8978	593	357	803	60181	0	61934
8979	60931	136	290	1094	0	62451
8980	904	60404	193	433	0	61934
8981	57762	622	157	444	0	58985
8982	792	56913	128	267	0	58100
8983	450	746	128	61351	0	62675
8984	257	269	59752	616	0	60894
8985	53897	283	652	551	0	55383
8986	549	59418	183	233	0	60383
8987	407	648	111	58738	0	59904
8988	275	167	85	57904	0	58431
8989	250	123	55	57315	0	57743
8990	152	123	58212	568	0	59055
8991	118	57806	432	317	0	58673
8992	57205	431	133	425	0	58194
8993	57159	131	106	361	0	57757
8994	516	57669	90	148	0	58423
8995	59034	423	68	422	0	59947
8996	573	173	120	59358	0	60224
8997	210	59031	99	467	0	59807
8998	58909	436	76	471	0	59892
8999	547	221	57551	146	0	58465
9000	249	59074	417	139	0	59879
9001	284	461	154	59694	0	60593
9002	220	173	81	60798	0	61272
9003	159	163	59619	523	0	60464
9004	316	132	410	57459	0	58317
9005	148	148	59555	516	0	60367
9006	292	95	448	58490	0	59325
9007	228	87	148	59606	0	60069
9008	242	107	100	59752	0	60201
9009	251	95	84	60108	0	60538
9010	128	151	59846	650	0	60775
9011	191	128	62191	316	0	62826
9012	116	70785	834	281	0	72016
9013	301	879	319	74938	0	76437
9014	188	387	78133	1031	0	79739
9015	131	77745	1163	443	0	79482
9016	393	1226	384	80362	0	82365
9017	149	437	83200	1212	0	84998
9018	77562	230	1378	805	0	79975
9019	86724	173	435	578	0	87910
9020	2037	119	243	86643	0	89042
9021	673	185	86825	1511	0	89194
9022	716	173	1434	85278	0	87601
9023	85991	101	532	2097	0	88721
9024	1395	88990	397	726	0	91508
9025	90653	1430	186	938	0	93207
9026	92309	492	197	716	0	93714
9027	2240	283	146	89112	0	91781
9028	1131	182	176	90004	0	91493
9029	731	137	162	91266	0	92296
9030	651	142	181	90645	0	91619
9031	664	190	124	89611	0	90589
9032	89225	137	116	2691	0	92169
9033	89838	145	164	1357	0	91504
9034	89671	119	129	1073	0	90992
9035	2236	212	85628	515	0	88591
9036	84990	117	1341	780	0	87228
9037	2062	178	495	86386	0	89121
9038	821	201	86228	1874	0	89124
9039	546	83840	1608	887	0	86881
9040	742	1509	662	82680	0	85593
9041	778	539	359	83421	0	85097
9042	434	83910	355	1937	0	86636
9043	765	1420	296	85667	0	88148
9044	461	640	85048	1963	0	88112
9045	429	365	85545	992	0	87331
9046	596	265	2139	86262	0	89262
9047	85360	239	902	2444	0	88945
9048	84430	233	464	1480	0	86607
9049	2280	317	85132	758	0	88487
9050	1054	79306	1723	762	0	82845
9051	690	83322	801	653	0	85466
9052	77990	1943	536	1052	0	81521
9053	1808	842	80467	711	0	83828
9054	1196	401	1682	79175	0	82454
9055	79585	285	672	2334	0	82876
9056	1998	77851	521	1091	0	81461
9057	1004	80571	408	813	0	82796
9058	78893	2061	376	844	0	82174
9059	2246	858	234	79828	0	83166
9060	83405	454	333	2351	0	86543
9061	2637	284	320	92219	0	95460
9062	1614	255	349	94851	0	97069
9063	945	385	93990	3550	0	98870
9064	1081	414	2388	95943	0	99826
9065	939	392	1059	98384	0	100774
9066	96676	329	715	4374	0	102094
9067	3243	289	507	98423	0	102462
9068	1425	369	97021	3829	0	102644
9069	94938	315	2784	2376	0	100413
9070	3210	278	1410	98085	0	102983
9071	97280	276	912	3965	0	102433
9072	3411	92630	706	2156	0	98903
9073	1808	97935	565	1554	0	101862
9074	96386	3467	548	1506	0	101907
9075	97634	1760	590	1262	0	101246
9076	4438	1024	552	95630	0	101644
9077	2289	623	94686	3336	0	100934
9078	1894	418	2894	96116	0	101322
9079	93943	577	1426	4165	0	100111
9080	3327	94398	969	2003	0	100697
9081	2138	2996	687	94683	0	100504
9082	94112	1507	556	3662	0	99837
9083	3643	1043	89219	2156	0	96061
9084	90269	649	2856	1865	0	95639
9085	86588	614	1412	1987	0	90601
9086	4323	587	90488	1229	0	96627
9087	2566	609	91529	1144	0	95848
9088	2070	453	3913	87516	0	93952
9089	1774	459	1917	89642	0	93792
9090	1190	91266	1320	4158	0	97934
9091	1456	2867	836	93018	0	98177
9092	1211	1456	93067	4132	0	99866
9093	1472	937	3161	93811	0	99381
9094	1348	554	1673	99029	0	102604
9095	1113	441	94817	4985	0	101356
9096	1017	93348	3410	2978	0	100753
9097	1267	2974	1662	94977	0	100880
9098	1283	1460	1099	98286	0	102128
9099	95532	965	911	5062	0	102470
9100	3799	586	823	96328	0	101536
9101	1926	600	93637	4686	0	100849
9102	91796	516	3257	2973	0	98542
9103	95852	694	1615	2137	0	100298
9104	97011	596	1180	1829	0	100616
9105	5079	625	92437	1409	0	99550
9106	2956	511	3361	91386	0	98214
9107	2074	443	1739	94682	0	98938
9108	1635	436	1466	96103	0	99640
9109	90866	527	960	5511	0	97864
9110	3702	90826	922	3063	0	98513
9111	2086	2613	83856	1995	0	90550
9112	1383	79512	2694	1531	0	85120
9113	973	76424	1473	1299	0	80169
9114	806	75464	1103	1200	0	78573
9115	1590	3642	1297	71677	0	78206
9116	995	1587	70659	2841	0	76082
9117	62214	1148	2218	2069	0	67649
9118	2319	67566	1359	1464	0	72708
9119	63591	1996	943	1356	0	67886
9120	2400	65685	656	1068	0	69809
9121	65972	2423	535	1244	0	70174
9122	2682	67190	471	936	0	71279
9123	1541	2621	67638	788	0	72588
9124	1492	1318	2139	65285	0	70234
9125	1134	1043	1141	68251	0	71569
9126	67028	680	828	3318	0	71854
9127	2632	661	607	71744	0	75644
9128	1512	601	70587	3336	0	76036
9129	1458	553	2349	71381	0	75741
9130	1085	575	71444	3232	0	76336
9131	818	70565	2804	1939	0	76126
9132	1087	2397	1406	66886	0	71776
9133	852	71832	1051	2688	0	76423
9134	71414	2821	785	1671	0	76691
9135	2924	1402	682	71540	0	76548
9136	1566	1004	71166	2937	0	76673
9137	1216	729	70676	1699	0	74320
9138	68954	678	3204	1596	0	74432
9139	2786	629	1692	70113	0	75220
9140	1482	674	69524	2882	0	74562
9141	1197	699	67802	1674	0	71372
9142	792	67739	3318	1436	0	73285
9143	850	2387	1959	61989	0	67185
9144	588	66649	1340	2425	0	71002
9145	801	2509	808	65878	0	69996
9146	66318	1260	709	3049	0	71336
9147	2353	931	701	67250	0	71235
9148	1345	605	679	68998	0	71627
9149	67661	562	681	3627	0	72531
9150	2585	491	647	72080	0	75803
9151	1577	609	616	70870	0	73672
9152	1124	72374	614	3465	0	77577
9153	72663	2280	587	2253	0	77783
9154	74781	1137	632	1659	0	78209
9155	3391	895	581	73658	0	78525
9156	1917	570	623	74779	0	77889
9157	1424	569	538	74349	0	76880
9158	889	69404	519	4183	0	74995
9159	810	73142	558	2350	0	76860
9160	1267	2717	488	68954	0	73426
9161	56910	755	334	2080	0	60079
9162	57116	479	294	1176	0	59065
9163	1726	55358	294	786	0	58164
9164	51396	1280	242	765	0	53683
9165	1378	51123	249	606	0	53356
9166	591	51562	256	515	0	52924
9167	1072	1520	388	49916	0	52896
9168	48937	542	293	1470	0	51242
9169	1168	47731	250	631	0	49780
9170	488	49162	228	507	0	50385
9171	476	1218	196	48671	0	50561
9172	496	510	195	49679	0	50880
9173	308	458	48455	1405	0	50626
9174	46733	354	996	863	0	48946
9175	47404	333	309	782	0	48828
9176	1280	304	49061	538	0	51183
9177	605	365	49167	483	0	50620
9178	575	329	1223	49554	0	51681
9179	519	316	445	50611	0	51891
9180	348	50389	305	1545	0	52587
9181	462	1228	238	51149	0	53077
9182	365	521	50800	1570	0	53256
9183	496	414	1115	50217	0	52242
9184	459	372	397	51222	0	52450
9185	49965	349	337	1830	0	52481
9186	1318	321	49217	855	0	51711
9187	47646	307	1210	876	0	50039
9188	1404	307	48445	651	0	50807
9189	706	332	1253	46924	0	49215
9190	427	318	46822	1455	0	49022
9191	339	311	46833	722	0	48205
9192	482	544	1411	45185	0	47622
9193	43100	370	835	1729	0	46034
9194	42301	254	384	858	0	43797
9195	1227	43352	364	611	0	45554
9196	42689	1076	360	670	0	44795
9197	42670	433	329	631	0	44063
9198	1262	42648	355	530	0	44795
9199	686	1158	341	43266	0	45451
9200	560	468	325	44320	0	45673
9201	502	358	293	44189	0	45342
9202	474	315	337	44390	0	45516
9203	351	323	43359	1648	0	45681
9204	41506	235	1158	965	0	43864
9205	1366	217	492	43570	0	45645
9206	592	268	412	43313	0	44585
9207	484	43743	334	1536	0	46097
9208	578	1152	220	44806	0	46756
9209	372	506	43616	1600	0	46094
9210	41943	391	1103	1002	0	44439
9211	1351	358	45273	730	0	47712
9212	721	328	1113	44018	0	46180
9213	43955	282	373	1696	0	46306
9214	1264	44982	263	892	0	47401
9215	752	1130	197	46744	0	48823
9216	496	458	46988	1620	0	49562
9217	523	380	1163	47118	0	49184
9218	46617	309	412	1776	0	49114
9219	1416	318	46931	797	0	49462
9220	621	306	46123	640	0	47690
9221	476	45649	1396	585	0	48106
9222	43699	1223	514	633	0	46069
9223	1314	43048	383	504	0	45249
9224	579	1241	42245	449	0	44514
9225	350	443	40881	387	0	42061
9226	307	40334	1193	411	0	42245
9227	35129	779	488	372	0	36768
9228	738	35718	284	257	0	36997
9229	380	774	189	35221	0	36564
9230	329	241	192	35955	0	36717
9231	223	180	35697	937	0	37037
9232	304	130	836	35134	0	36404
9233	166	147	36217	876	0	37406
9234	34645	142	893	413	0	36093
9235	36013	152	305	367	0	36837
9236	36260	136	257	356	0	37009
9237	964	155	35330	231	0	36680
9238	35161	125	824	319	0	36429
9239	960	178	318	34464	0	35920
9240	343	35488	244	816	0	36891
9241	35080	722	194	470	0	36466
9242	821	270	34018	298	0	35407
9243	33812	116	740	372	0	35040
9244	34302	107	315	355	0	35079
9245	914	96	33235	245	0	34490
9246	370	33176	853	279	0	34678
9247	411	904	384	32808	0	34507
9248	298	206	33401	779	0	34684
9249	275	176	32214	299	0	32964
9250	298	582	743	27697	0	29320
9251	185	89	28315	545	0	29134
9252	214	52	576	26762	0	27604
9253	242	106	226	25368	0	25942
9254	190	96	156	27433	0	27875
9255	144	86	27074	642	0	27946
9256	188	84	597	26672	0	27541
9257	164	66	27356	607	0	28193
9258	178	61	628	27397	0	28264
9259	28271	82	252	715	0	29320
9260	645	103	202	28332	0	29282
9261	209	29385	180	682	0	30456
9262	213	605	171	30580	0	31569
9263	30763	193	153	862	0	31971
9264	690	31119	185	318	0	32312
9265	281	665	173	31426	0	32545
9266	31298	208	135	863	0	32504
9267	748	155	31568	346	0	32817
9268	389	114	754	31402	0	32659
9269	196	115	32241	820	0	33372
9270	147	109	32031	365	0	32652
9271	261	107	909	31559	0	32836
9272	31740	94	368	887	0	33089
9273	791	101	31126	325	0	32343
9274	30646	110	765	298	0	31819
9275	897	141	312	31481	0	32831
9276	322	101	31723	717	0	32863
9277	251	120	30852	308	0	31531
9278	172	132	31200	224	0	31728
9279	261	312	847	29327	0	30747
9280	30399	64	542	749	0	31754
9281	610	30481	287	292	0	31670
9282	319	555	215	30094	0	31183
9283	238	183	223	30967	0	31611
9284	30768	111	222	848	0	31949
9285	30911	71	190	454	0	31626
9286	763	30746	219	214	0	31942
9287	31202	576	194	233	0	32205
9288	31238	191	152	252	0	31833
9289	861	117	169	30940	0	32087
9290	318	122	30932	667	0	32039
9291	30541	98	716	322	0	31677
9292	752	79	286	31416	0	32533
9293	413	78	176	31757	0	32424
9294	31434	91	146	872	0	32543
9295	784	132	134	30078	0	31128
9296	389	83	114	30693	0	31279
9297	29894	47	160	967	0	31068
9298	758	30746	148	386	0	32038
9299	30666	553	145	351	0	31715
9300	755	216	30666	196	0	31833
9301	30376	103	663	258	0	31400
9302	852	48	237	30722	0	31859
9303	336	31375	216	707	0	32634
9304	324	571	167	32050	0	33112
9305	307	188	139	32114	0	32748
9306	298	112	121	32397	0	32928
9307	31469	66	152	971	0	32658
9308	671	30600	136	414	0	31821
9309	237	30847	138	307	0	31529
9310	30144	590	82	313	0	31129
9311	626	214	31340	183	0	32363
9312	281	176	30556	139	0	31152
9313	29749	140	905	282	0	31076
9314	607	103	31126	159	0	31995
9315	296	49	509	29584	0	30438
9316	359	108	203	27161	0	27831
9317	162	112	109	30341	0	30724
9318	192	66	74	30004	0	30336
9319	134	28433	109	695	0	29371
9320	173	451	87	30348	0	31059
9321	139	200	29729	589	0	30657
9322	199	123	494	29458	0	30274
9323	111	121	29310	602	0	30144
9324	168	84	28893	260	0	29405
9325	164	63	638	29482	0	30347
9326	142	69	29983	577	0	30771
9327	193	55	575	29609	0	30432
9328	29732	64	252	760	0	30808
9329	551	65	29920	353	0	30889
9330	28776	65	548	329	0	29718
9331	616	73	206	29888	0	30783
9332	247	90	29727	638	0	30702
9333	174	29399	560	311	0	30444
9334	206	485	248	30489	0	31428
9335	145	166	32130	632	0	33073
9336	196	87	602	31925	0	32810
9337	32828	52	292	787	0	33959
9338	33045	51	231	450	0	33777
9339	33749	63	161	347	0	34320
9340	826	73	148	33948	0	34995
9341	401	65	145	34687	0	35298
9342	268	81	149	35618	0	36116
9343	35752	42	153	1019	0	36966
9344	744	36785	159	419	0	38107
9345	399	691	128	37456	0	38674
9346	271	255	143	38704	0	39373
9347	37854	167	108	1232	0	39361
9348	852	38658	139	549	0	40198
9349	453	822	122	40858	0	42255
9350	41053	261	115	1210	0	42639
9351	41221	158	130	575	0	42084
9352	1444	89	97	40624	0	42254
9353	40827	83	118	1224	0	42252
9354	1285	65	117	40786	0	42253
9355	512	102	40711	1250	0	42575
9356	445	83	960	40717	0	42205
9357	396	84	342	41877	0	42699
9358	383	82	217	42211	0	42893
9359	39749	81	131	1511	0	41472
9360	968	39640	130	637	0	41375
9361	38301	847	97	556	0	39801
9362	979	37879	124	287	0	39269
9363	354	38864	112	255	0	39585
9364	38136	1036	137	366	0	39675
9365	910	38831	139	255	0	40135
9366	500	916	90	38784	0	40290
9367	38055	304	133	1075	0	39567
9368	38575	179	91	584	0	39429
9369	1197	101	109	38161	0	39568
9370	557	109	75	37945	0	38686
9371	286	38126	98	1146	0	39656
9372	38678	821	62	684	0	40245
9373	37760	308	79	563	0	38710
9374	1030	39473	105	318	0	40926
9375	493	40244	92	261	0	41090
9376	404	1101	69	40268	0	41842
9377	40193	429	74	1231	0	41927
9378	1169	235	67	40148	0	41619
9379	549	190	61	41220	0	42020
9380	361	135	39542	1409	0	41447
9381	330	139	39399	586	0	40454
9382	372	139	1112	39314	0	40937
9383	212	148	39705	1211	0	41276
9384	230	39508	1045	553	0	41336
9385	335	992	321	39591	0	41239
9386	335	327	184	40662	0	41508
9387	298	255	102	41096	0	41751
9388	184	207	40255	1481	0	42127
9389	244	194	38967	646	0	40051
9390	37958	129	1118	644	0	39849
9391	1086	39807	413	377	0	41683
9392	39819	969	209	448	0	41445
9393	1219	334	124	39830	0	41507
9394	40482	243	133	1225	0	42083
9395	1233	162	141	40003	0	41539
9396	459	40852	106	1197	0	42614
9397	40970	971	136	714	0	42791
9398	1123	387	40006	441	0	41957
9399	464	39818	933	386	0	41601
9400	39719	962	318	488	0	41487
9401	1129	353	201	39131	0	40814
9402	479	38576	190	1038	0	40283
9403	414	972	136	40139	0	41661
9404	39798	369	79	1348	0	41594
9405	1171	316	96	40090	0	41673
9406	39985	223	101	1394	0	41703
9407	1269	217	39237	606	0	41329
9408	666	209	911	39386	0	41172
9409	39195	173	306	1410	0	41084
9410	1163	247	38528	610	0	40548
9411	565	36927	990	461	0	38943
9412	563	982	387	35829	0	37761
9413	333	462	36197	1138	0	38130
9414	324	354	35583	536	0	36797
9415	389	325	1179	35445	0	37338
9416	291	234	35734	1201	0	37460
9417	315	196	35324	582	0	36417
9418	376	243	1165	34440	0	36224
9419	35033	152	493	1270	0	36948
9420	1142	153	304	35120	0	36719
9421	531	162	255	35960	0	36908
9422	361	179	35553	1388	0	37481
9423	425	181	954	36189	0	37749
9424	36348	155	454	1465	0	38422
9425	1045	217	36489	613	0	38364
9426	465	36468	995	537	0	38465
9427	452	928	425	37623	0	39428
9428	37517	374	353	1246	0	39490
9429	1115	320	231	37265	0	38931
9430	469	37279	254	1223	0	39225
9431	395	990	38286	544	0	40215
9432	355	419	1056	39150	0	40980
9433	41269	299	405	1375	0	43348
9434	1306	220	40361	604	0	42491
9435	611	182	1211	41462	0	43466
9436	42421	120	487	1578	0	44606
9437	45077	144	347	823	0	46391
9438	1842	44893	251	555	0	47541
9439	44990	1418	263	440	0	47111
9440	1899	550	210	44500	0	47159
9441	681	346	44818	1608	0	47453
9442	478	42880	1447	694	0	45499
9443	319	44790	552	496	0	46157
9444	472	1725	440	42331	0	44968
9445	440	592	300	43648	0	44980
9446	257	323	41926	1597	0	44103
9447	251	40893	1264	712	0	43120
9448	202	41536	522	509	0	42769
9449	408	1401	345	38918	0	41072
9450	38354	468	233	1288	0	40343
9451	1038	38695	169	506	0	40408
9452	543	1072	149	39612	0	41376
9453	40997	379	173	1402	0	42951
9454	1220	294	181	41439	0	43134
9455	563	268	156	41214	0	42201
9456	431	254	142	41747	0	42574
9457	367	196	139	42044	0	42746
9458	40539	217	157	1677	0	42590
9459	1188	209	178	40904	0	42479
9460	420	258	39547	1336	0	41561
9461	38324	216	1028	713	0	40281
9462	1096	207	38933	565	0	40801
9463	474	203	40153	408	0	41238
9464	448	212	1246	39817	0	41723
9465	365	166	487	40625	0	41643
9466	418	154	272	41658	0	42502
9467	40585	153	195	1633	0	42566
9468	1153	159	40034	741	0	42087
9469	39325	130	1038	684	0	41177
9470	40946	122	408	574	0	42050
9471	1419	161	40834	435	0	42849
9472	39671	120	1042	639	0	41472
9473	1286	161	41147	439	0	43033
9474	534	41526	1044	402	0	43506
9475	592	956	589	41353	0	43490
9476	343	311	351	42810	0	43815
9477	382	193	224	42125	0	42924
9478	344	131	248	41838	0	42561
9479	244	170	41777	1389	0	43580
9480	286	162	41840	619	0	42907
9481	293	157	1175	41504	0	43129
9482	232	175	42263	1147	0	43817
9483	40178	122	1041	719	0	42060
9484	42842	148	452	579	0	44021
9485	1277	118	284	42396	0	44075
9486	42110	113	268	1231	0	43722
9487	1080	43215	281	546	0	45122
9488	42960	835	215	660	0	44670
9489	1141	342	43659	419	0	45561
9490	584	231	945	42882	0	44642
9491	389	43993	417	1070	0	45869
9492	45004	842	339	703	0	46888
9493	1103	306	285	45580	0	47274
9494	494	254	45131	1225	0	47104
9495	491	131	1041	44707	0	46370
9496	44495	132	495	1368	0	46490
9497	1152	178	45270	666	0	47266
9498	631	147	1030	45352	0	47160
9499	557	171	479	46340	0	47547
9500	413	213	45857	1423	0	47906
9501	404	44482	1072	744	0	46702
9502	732	36422	732	684	0	38570
9503	439	1095	326	46232	0	48092
9504	459	475	324	47369	0	48627
9505	431	288	260	48310	0	49289
9506	46916	254	262	1727	0	49159
9507	47302	288	324	871	0	48785
9508	1406	287	253	47583	0	49529
9509	47428	273	263	1457	0	49421
9510	1129	48041	343	748	0	50261
9511	550	1029	249	49593	0	51421
9512	471	449	206	50518	0	51644
9513	382	273	276	50999	0	51930
9514	48393	216	237	1910	0	50756
9515	1139	47921	245	935	0	50240
9516	619	993	239	49182	0	51033
9517	48535	448	185	1611	0	50779
9518	1212	294	195	49443	0	51144
9519	727	210	179	49321	0	50437
9520	499	46726	216	1678	0	49119
9521	391	49061	200	1011	0	50663
9522	505	1096	197	48950	0	50748
9523	452	442	202	49141	0	50237
9524	47230	235	189	1809	0	49463
9525	1236	161	207	47694	0	49298
9526	578	179	46555	1565	0	48877
9527	550	168	1018	45896	0	47632
9528	334	45456	448	1450	0	47688
9529	47034	902	336	1016	0	49288
9530	1354	337	281	47298	0	49270
9531	657	203	236	46754	0	47850
9532	385	45998	250	1498	0	48131
9533	44226	754	160	836	0	45976
9534	908	46509	174	519	0	48110
9535	511	906	124	45821	0	47362
9536	288	272	45462	906	0	46928
9537	405	580	603	41488	0	43076
9538	41916	74	234	916	0	43140
9539	598	42361	108	281	0	43348
9540	303	601	49	42420	0	43373
9541	124	41809	54	613	0	42600
9542	175	673	43	42940	0	43831
9543	85	258	42655	733	0	43731
9544	205	186	570	41565	0	42526
9545	183	101	163	42648	0	43095
9546	150	81	82	43518	0	43831
9547	41446	73	74	1097	0	42690
9548	42148	108	51	587	0	42894
9549	730	42764	80	265	0	43839
9550	42424	629	72	398	0	43523
9551	646	42389	49	241	0	43325
9552	230	43430	62	188	0	43910
9553	41183	755	44	387	0	42369
9554	702	266	40601	211	0	41780
9555	342	173	586	40514	0	41615
9556	252	119	180	41967	0	42518
9557	199	111	95	42842	0	43247
9558	41376	107	53	1136	0	42672
9559	715	40926	101	406	0	42148
9560	344	730	45	41714	0	42833
9561	227	41627	82	804	0	42740
9562	43563	839	53	484	0	44939
9563	910	311	53	43724	0	44998
9564	464	184	46	51751	0	52445
9565	194	56956	97	1469	0	58716
9566	349	1294	43	59938	0	61624
9567	353	485	56	61114	0	62008
9568	58345	297	67	2296	0	61005
9569	1399	57326	88	1005	0	59818
9570	519	59931	86	656	0	61192
9571	499	1755	48	58420	0	60722
9572	265	787	56571	1685	0	59308
9573	271	477	56419	830	0	57997
9574	396	386	1717	55851	0	58350
9575	217	334	56049	1689	0	58289
9576	381	313	1577	55874	0	58145
9577	579	266	707	53279	0	54831
9578	325	230	369	58050	0	58974
9579	55735	248	293	2531	0	58807
9580	1595	174	236	56557	0	58562
9581	782	181	183	56451	0	57597
9582	386	55303	229	2323	0	58241
9583	427	1550	150	57601	0	59728
9584	229	671	55939	2139	0	58978
9585	445	342	1477	56654	0	58918
9586	419	260	687	58227	0	59593
9587	54751	268	424	2662	0	58105
9588	1647	245	281	55831	0	58004
9589	774	235	275	55391	0	56675
9590	483	163	185	56639	0	57470
9591	51488	158	188	2996	0	54830
9592	1497	52784	167	1521	0	55969
9593	848	1438	146	53754	0	56186
9594	629	627	144	54741	0	56141
9595	285	439	52364	2576	0	55664
9596	463	351	1402	52865	0	55081
9597	49558	263	622	2500	0	52943
9598	1436	50857	411	1324	0	54028
9599	734	1492	271	50699	0	53196
9600	597	624	217	51923	0	53361
9601	390	398	49713	2531	0	53032
9602	46820	282	1461	1646	0	50209
9603	1432	48796	618	1244	0	52090
9604	48496	1478	346	1113	0	51433
9605	1737	770	249	49069	0	51825
9606	917	503	241	50050	0	51711
9607	619	346	202	50703	0	51870
9608	528	360	274	50922	0	52084
9609	48574	381	251	2774	0	51980
9610	1618	349	234	47521	0	49722
9611	766	45916	332	2326	0	49340
9612	537	1423	320	47347	0	49627
9613	473	569	330	49024	0	50396
9614	46502	365	351	2812	0	50030
9615	1541	46284	353	1583	0	49761
9616	940	1447	214	48039	0	50640
9617	46485	716	170	2536	0	49907
9618	48037	415	148	1649	0	50249
9619	2077	323	160	48227	0	50787
9620	989	363	46329	2416	0	50097
9621	46539	376	1287	1662	0	49864
9622	1801	344	596	47946	0	50687
9623	930	297	47644	2348	0	51219
9624	704	290	1512	49040	0	51546
9625	631	345	707	49403	0	51086
9626	657	248	400	49383	0	50688
9627	525	49361	338	2885	0	53109
9628	700	1389	267	51199	0	53555
9629	521	701	211	51781	0	53214
9630	567	393	220	52046	0	53226
9631	613	357	207	51755	0	52932
9632	651	333	170	51280	0	52434
9633	581	388	241	51281	0	52491
9634	45866	310	302	2939	0	49417
9635	1416	273	44463	1890	0	48042
9636	716	43850	1232	1417	0	47215
9637	43767	1163	613	1316	0	46859
9638	1317	44188	375	1175	0	47055
9639	43758	1299	338	1172	0	46567
9640	1725	694	358	43629	0	46406
9641	44107	473	292	1961	0	46833
9642	1623	358	269	44369	0	46619
9643	1010	332	204	43170	0	44716
9644	649	42951	181	2286	0	46067
9645	43448	1124	139	1693	0	46404
9646	1390	601	43924	1343	0	47258
9647	973	350	985	45451	0	47759
9648	660	304	45233	1944	0	48141
9649	550	359	43439	1390	0	45738
9650	44404	357	1473	1158	0	47392
9651	1380	353	713	45634	0	48080
9652	809	316	44950	1829	0	47904
9653	653	273	46593	1274	0	48793
9654	631	251	1444	46618	0	48944
9655	641	220	680	48392	0	49933
9656	47767	226	442	2144	0	50579
9657	1494	220	339	48559	0	50612
9658	857	234	49807	1903	0	52801
9659	809	175	1182	50859	0	53025
9660	695	324	656	50720	0	52395
9661	422	51226	473	1969	0	54090
9662	49836	912	467	1549	0	52764
9663	1101	49614	404	1060	0	52179
9664	41566	512	226	765	0	43069
9665	415	35103	98	232	0	35848
9666	172	33904	135	151	0	34362
9667	190	288	177	33838	0	34493
9668	143	126	147	33716	0	34132
9669	143	99	35	33485	0	33762
9670	32582	60	33	427	0	33102
9671	199	71	32717	163	0	33150
9672	156	54	139	32247	0	32596
9673	31822	45	69	326	0	32262
9674	174	31868	66	152	0	32260
9675	94	31974	37	153	0	32258
9676	155	226	42	32332	0	32755
9677	104	88	46	32549	0	32787
9678	115	65	33	32757	0	32970
9679	50	33508	66	247	0	33871
9680	78	148	39	33923	0	34188
9681	71	101	33574	209	0	33955
9682	64	104	30912	128	0	31208
9683	31792	46	124	234	0	32196
9684	155	38	83	33514	0	33790
9685	33502	23	48	338	0	33911
9686	33117	25	40	271	0	33453
9687	134	33740	43	95	0	34012
9688	34023	99	29	244	0	34395
9689	34846	66	41	216	0	35169
9690	191	35	38	35083	0	35347
9691	149	23	31	35445	0	35648
9692	75	62	36520	160	0	36817
9693	63	37286	116	142	0	37607
9694	384	135	72	33612	0	34203
9695	98	49	34	38418	0	38599
9696	38359	41	32	317	0	38749
9697	168	37	30	38596	0	38831
9698	39221	36	23	339	0	39619
9699	198	30	21	40253	0	40502
9700	84	40539	51	257	0	40931
9701	41831	259	22	340	0	42452
9702	362	85	23	46901	0	47371
9703	249	50	28	50385	0	50712
9704	193	30	19	53479	0	53721
9705	74	58	53150	1039	0	54321
9706	230	51	801	53456	0	54538
9707	54795	40	227	1268	0	56330
9708	992	44	112	57660	0	58808
9709	486	27	86	64199	0	64798
9710	356	38	97	64447	0	64938
9711	125	63467	137	1858	0	65587
9712	124	67050	76	679	0	67929
9713	65550	1660	42	760	0	68012
9714	1342	67054	63	380	0	68839
9715	66585	1575	30	542	0	68732
9716	66954	506	42	494	0	67996
9717	67160	282	36	613	0	68091
9718	2001	245	66620	197	0	69063
9719	676	67970	1418	215	0	70279
9720	68854	1467	359	535	0	71215
9721	1905	456	152	68906	0	71419
9722	917	281	109	69474	0	70781
9723	627	221	92	69564	0	70504
9724	289	67760	122	2073	0	70244
9725	540	1505	60	68607	0	70712
9726	68186	533	49	2067	0	70835
9727	1846	309	54	66787	0	68996
9728	853	293	64	68035	0	69245
9729	458	284	66512	2115	0	69369
9730	428	247	67231	891	0	68797
9731	677	179	1751	67355	0	69962
9732	574	154	633	68362	0	69723
9733	287	68560	379	2130	0	71356
9734	612	1486	250	68773	0	71121
9735	534	499	200	70286	0	71519
9736	479	304	141	70738	0	71662
9737	68266	280	104	2795	0	71445
9738	1658	412	68760	1118	0	71948
9739	858	303	1423	69917	0	72501
9740	69826	254	438	2334	0	72852
9741	70223	249	277	1242	0	71991
9742	2289	215	222	69334	0	72060
9743	1131	258	289	70822	0	72500
9744	68539	244	284	2600	0	71667
9745	1774	67902	284	1124	0	71084
9746	822	69280	226	853	0	71181
9747	786	2011	163	69112	0	72072
9748	68853	683	141	2453	0	72130
9749	69725	397	137	1403	0	71662
9750	68917	344	121	1254	0	70636
9751	2255	362	69128	782	0	72527
9752	65821	329	1579	1003	0	68732
9753	2181	308	66722	760	0	69971
9754	64619	260	1664	1030	0	67573
9755	2011	66027	638	816	0	69492
9756	918	1650	66362	851	0	69781
9757	838	650	1659	66166	0	69313
9758	630	513	65844	2215	0	69202
9759	797	488	1757	65447	0	68489
9760	65298	425	655	2567	0	68945
9761	1939	396	65910	1288	0	69533
9762	1101	307	1789	65356	0	68553
9763	795	68651	828	2180	0	72454
9764	926	1563	549	71743	0	74781
9765	825	541	529	71719	0	73614
9766	869	457	443	69348	0	71117
9767	70129	356	424	2935	0	73844
9768	71050	416	330	1619	0	73415
9769	2381	408	326	70944	0	74059
9770	1106	416	69072	2521	0	73115
9771	906	442	68066	1397	0	70811
9772	886	400	2021	70616	0	73923
9773	838	455	73111	2343	0	76747
9774	966	375	1873	73175	0	76389
9775	1070	377	823	71291	0	73561
9776	909	334	578	74420	0	76241
9777	845	70157	563	2768	0	74333
9778	822	69864	589	1555	0	72830
9779	853	1978	455	74132	0	77418
9780	795	857	457	74583	0	76692
9781	921	554	400	74461	0	76336
9782	72659	480	398	3059	0	76596
9783	2153	419	73702	1592	0	77866
9784	1180	332	1890	74501	0	77903
9785	73986	273	945	2744	0	77948
9786	1966	74103	760	1594	0	78423
9787	1114	1646	650	76294	0	79704
9788	785	673	587	77967	0	80012
9789	681	479	477	77313	0	78950
9790	686	403	449	77186	0	78724
9791	535	467	74291	3170	0	78463
9792	69873	406	1715	2123	0	74117
9793	73331	327	707	1760	0	76125
9794	2311	351	73090	1313	0	77065
9795	71881	260	1817	1563	0	75521
9796	74507	282	790	1314	0	76893
9797	2429	286	74486	1127	0	78328
9798	1097	76432	1925	1146	0	80600
9799	1139	1775	930	76688	0	80532
9800	773	563	79533	2137	0	83006
9801	735	76932	1705	1379	0	80751
9802	646	1272	73312	938	0	76168
9803	408	70446	1285	749	0	72888
9804	613	1017	866	68409	0	70905
9805	393	325	68730	1166	0	70614
9806	626	306	1035	66476	0	68443
9807	422	201	70231	1147	0	72001
9808	272	68773	911	595	0	70551
9809	62434	269	321	397	0	63421
9810	251	61609	139	141	0	62140
9811	101	67220	111	247	0	67679
9812	517	282	195	67934	0	68928
9813	143	94	45	68386	0	68668
9814	149	35	13	67841	0	68038
9815	174	41	33	66466	0	66714
9816	114	29	23	68860	0	69026
9817	63	71	77061	250	0	77445
9818	280	24	194	74809	0	75307
9819	138	28	67	78361	0	78594
9820	79873	8	44	719	0	80644
9821	80526	14	35	488	0	81063
9822	81807	26	28	376	0	82237
9823	511	34	21	82581	0	83147
9824	91885	40	18	817	0	92760
9825	99379	36	30	692	0	100137
9826	101756	24	31	530	0	102341
9827	1094	90	101670	93	0	102947
9828	98945	14	878	455	0	100292
9829	104960	20	159	519	0	105658
9830	106035	19	108	384	0	106546
9831	1475	24	92	106181	0	107772
9832	448	128	107605	975	0	109156
9833	611	21	963	106177	0	107772
9834	110577	9	223	1553	0	112362
9835	1388	32	152	111674	0	113246
9836	394	117122	187	1031	0	118734
9837	585	911	66	121115	0	122677
9838	120877	152	79	1757	0	122865
9839	122043	106	125	889	0	123163
9840	121037	73	79	772	0	121961
9841	1562	124	125277	187	0	127150
9842	1022	60	1174	122421	0	124677
9843	681	104	266	128551	0	129602
9844	335	131	129404	1559	0	131429
9845	298	125585	1338	562	0	127783
9846	351	1245	127082	317	0	128995
9847	644	306	1321	127654	0	129925
9848	129491	135	426	1771	0	131823
9849	1474	228	133262	459	0	135423
9850	832	89	1318	133485	0	135724
9851	365	156	134771	1451	0	136743
9852	130612	124	1432	887	0	133055
9853	1683	100	457	136307	0	138547
9854	564	190	142568	1486	0	144808
9855	849	80	1405	140425	0	142759
9856	370	178	145021	1569	0	147138
9857	346	145664	1563	761	0	148334
9858	702	1243	539	146914	0	149398
9859	148338	326	367	2093	0	151124
9860	1900	195	362	148351	0	150808
9861	977	131	359	147108	0	148575
9862	146788	70	309	2425	0	149592
9863	1760	140068	397	832	0	143057
9864	682	143672	340	703	0	145397
9865	789	1484	308	144793	0	147374
9866	479	144768	347	1727	0	147321
9867	762	1402	252	146703	0	149119
9868	736	438	201	147319	0	148694
9869	147044	303	216	2580	0	150143
9870	1672	145831	308	925	0	148736
9871	771	1615	144366	669	0	147421
9872	654	148999	1444	631	0	151728
9873	147737	1563	421	1133	0	150854
9874	151051	467	399	1091	0	153008
9875	2290	336	356	149805	0	152787
9876	152918	281	298	2525	0	156022
9877	2282	317	316	153052	0	155967
9878	152835	321	347	2698	0	156201
9879	155148	347	347	1495	0	157337
9880	2673	263	340	160048	0	163324
9881	160741	193	329	3030	0	164293
9882	2447	299	160930	979	0	164655
9883	156402	171	1775	1328	0	159676
9884	2656	230	677	161175	0	164738
9885	162831	187	509	2810	0	166337
9886	2594	163897	568	985	0	168044
9887	1725	1639	441	164533	0	168338
9888	1529	449	549	165009	0	167536
9889	164201	302	579	3287	0	168369
9890	2643	535	163461	1182	0	167821
9891	1396	162477	1953	1213	0	167039
9892	1517	1725	645	164930	0	168817
9893	1084	164945	710	2374	0	169113
9894	1266	1863	518	167935	0	171582
9895	1495	660	519	164257	0	166931
9896	1291	538	458	168509	0	170796
9897	166769	584	434	3582	0	171369
9898	2477	587	366	164765	0	168195
9899	165201	554	392	3527	0	169674
9900	163866	491	415	2309	0	167081
9901	3003	417	428	165535	0	169383
9902	164331	349	548	3505	0	168733
9903	161337	425	529	2378	0	164669
9904	2793	538	163289	1254	0	167874
9905	1754	518	2065	158056	0	162393
9906	163481	522	805	3296	0	168104
9907	2446	162467	817	1297	0	167027
9908	163740	1872	601	2145	0	168358
9909	163842	580	508	2014	0	166944
9910	2996	511	160515	1106	0	165128
9911	1939	366	2127	151465	0	155897
9912	165708	339	839	3598	0	170484
9913	3157	343	657	168900	0	173057
9914	1920	387	549	173426	0	176282
9915	1664	377	578	176335	0	178954
9916	1646	281	576	184833	0	187336
9917	180058	293	586	5295	0	186232
9918	4116	508	183880	1943	0	190447
9919	2384	649	3514	189002	0	195549
9920	1391	580	207649	4551	0	214171
9921	1130	646	213535	2189	0	217500
9922	208304	277	7482	2629	0	218692
9923	6835	413	225484	1351	0	234083
9924	2972	215308	7362	1002	0	226644
9925	214420	5753	3714	1688	0	225575
9926	218339	2555	1723	1411	0	224028
9927	9534	1242	854	210667	0	222297
9928	4262	713	215482	5873	0	226330
9929	2263	672	212234	2931	0	218100
9930	214475	329	8441	2451	0	225696
9931	7633	470	3989	218931	0	231023
9932	221163	285	2020	7263	0	230731
9933	7465	226542	1387	3231	0	238625
9934	226842	6019	1189	2712	0	236762
9935	226849	2767	976	2157	0	232749
9936	9595	221421	1038	974	0	233028
9937	5685	6535	735	220501	0	233456
9938	220952	3124	604	7416	0	232096
9939	7962	1708	220196	3223	0	233089
9940	4229	221201	6773	1929	0	234132
9941	3620	6613	3287	218002	0	231522
9942	218676	3049	2052	7598	0	231375
9943	7307	222342	1341	3517	0	234507
9944	225186	6987	1007	2864	0	236044
9945	8787	3816	220866	1369	0	234838
9946	218930	2030	6949	1966	0	229875
9947	9253	1482	224793	983	0	236511
9948	220150	1013	8156	1761	0	231080
9949	219370	845	4001	1902	0	226118
9950	10870	1028	216665	957	0	229520
9951	5804	216805	7613	1218	0	231440
9952	4963	6785	3991	208007	0	223746
9953	2720	3448	218907	6918	0	231993
9954	2353	213202	7793	3743	0	227091
9955	3474	7158	4115	206363	0	221110
9956	3217	3663	2681	216793	0	226354
9957	2216	2364	211357	9931	0	225868
9958	3487	1456	7985	204892	0	217820
9959	3065	1233	4717	214086	0	223101
9960	2335	1262	210751	10657	0	225005
9961	2980	1231	8558	201198	0	213967
9962	2215	208551	5001	8896	0	224663
9963	210993	7188	3404	5453	0	227038
9964	8874	3891	2990	206858	0	222613
9965	5025	212885	2972	8199	0	229081
9966	4716	7788	2828	198298	0	213630
9967	3357	217138	2980	7873	0	231348
9968	3503	8989	213493	4436	0	230421
9969	3120	217759	8629	3429	0	232937
9970	213300	9311	5092	3547	0	231250
9971	216177	4796	3775	3466	0	228214
9972	220613	3418	2872	3717	0	230620
9973	13220	2477	217784	2744	0	236225
9974	7410	2405	218190	2597	0	230602
9975	5319	222630	11912	2426	0	242287
9976	5330	8980	6463	208713	0	229486
9977	4534	228595	3982	8087	0	245198
9978	5449	10560	3096	201978	0	221083
9979	4169	228478	2967	8498	0	244112
9980	224920	10840	2664	5825	0	244249
9981	245420	6222	2691	4187	0	258520
9982	15050	4269	2652	249586	0	271557
9983	8662	3540	247951	10974	0	271127
9984	242725	3075	10587	7185	0	263572
9985	12929	251734	6128	4608	0	275399
9986	8718	10845	4585	245867	0	270015
9987	7405	6210	3459	243820	0	260894
9988	5179	254100	3568	13014	0	275861
9989	253294	11787	3183	8187	0	276451
9990	13145	7042	251165	4667	0	276019
9991	9158	5097	11166	250279	0	275700
9992	252760	3815	6434	12448	0	275457
9993	253968	3613	4905	7641	0	270127
9994	16479	250765	3817	5082	0	276143
9995	10867	11202	3773	240827	0	266669
9996	6628	255143	3662	11476	0	276909
9997	257157	12756	3479	7941	0	281333
9998	13037	7353	256276	5314	0	281980
9999	8132	5995	259004	4276	0	277407
10000	6997	4228	14199	250549	0	275973
10001	5414	3904	8014	252019	0	269351
10002	4322	254756	5671	14770	0	279519
10003	5281	11609	4320	256725	0	277935
10004	4116	6658	253661	14396	0	278831
10005	247931	4909	11941	9314	0	274095
10006	12525	4089	6594	257024	0	280232
10007	7049	4210	253758	13561	0	278578
10008	6231	3942	11744	253811	0	275728
10009	4778	3749	7023	250359	0	265909
10010	3746	252797	5180	15660	0	277383
10011	5016	11425	3772	253685	0	273898
10012	4752	6843	3812	250729	0	266136
10013	4784	5185	3655	251776	0	265400
10014	229673	3601	3125	17937	0	254336
10015	10585	225109	3308	10193	0	249195
10016	6411	227482	2711	6755	0	243359
10017	216033	11325	2460	5823	0	235641
10018	210744	6115	2704	5120	0	224683
10019	11924	199946	2707	3724	0	218301
10020	5407	187408	1827	2765	0	197407
10021	166945	6827	1383	2687	0	177842
10022	5807	166282	1151	2084	0	175324
10023	2829	166258	881	1941	0	171909
10024	159911	6515	2024	2357	0	170807
10025	5047	163285	758	1741	0	170831
10026	160348	6080	813	2476	0	169717
10027	158344	3171	888	2340	0	164743
10028	158952	2571	836	2038	0	164397
10029	7146	155715	874	1428	0	165163
10030	3844	157238	750	1471	0	163303
10031	3480	6177	529	149426	0	159612
10032	2522	153632	691	4521	0	161366
10033	2790	6354	560	154372	0	164076
10034	155373	3406	695	6033	0	165507
10035	5866	2750	755	152824	0	162195
10036	3112	152768	860	5960	0	162700
10037	150316	5340	800	3525	0	159981
10038	5550	149506	819	2699	0	158574
10039	3137	155984	667	2184	0	161972
10040	3313	7190	554	145301	0	156358
10041	2259	152562	650	4588	0	160059
10042	149972	5876	956	3066	0	159870
10043	5216	3368	147228	2271	0	158083
10044	2756	147121	4365	2108	0	156350
10045	2782	5137	2067	146614	0	156600
10046	2011	3307	146529	5291	0	157138
10047	2394	2696	4347	143709	0	153146
10048	2348	2172	2230	147300	0	154050
10049	2178	2025	1748	149569	0	155520
10050	2077	2007	1434	149334	0	154852
10051	1930	1858	144692	7551	0	156031
10052	1613	143860	4805	4837	0	155115
10053	142113	4952	2477	4318	0	153860
10054	4713	3084	141239	3330	0	152366
10055	139250	2666	4491	3580	0	149987
10056	5692	2193	143282	2705	0	153872
10057	3585	1952	5352	142823	0	153712
10058	2869	1996	143645	5532	0	154042
10059	2388	1815	146812	3395	0	154410
10060	2412	1702	6398	143613	0	154125
10061	2776	1644	3795	136887	0	145102
10062	2173	1776	2412	149182	0	155543
10063	2050	1865	1760	147471	0	153146
10064	143430	1859	1628	8483	0	155400
10065	4821	1731	143673	5123	0	155348
10066	143163	1788	4501	4428	0	153880
10067	146104	1693	2315	3682	0	153794
10068	146586	1769	1963	3229	0	153547
10069	146309	1905	1375	2785	0	152374
10070	147484	1864	1215	2683	0	153246
10071	8597	1717	998	141500	0	152812
10072	4944	1792	134639	5201	0	146576
10073	3656	1595	130994	3131	0	139376
10074	2808	132618	4563	2816	0	142805
10075	125276	4154	2755	2709	0	134894
10076	4471	3079	1675	122360	0	131585
10077	3053	3240	1035	120555	0	127883
10078	2612	120271	871	4852	0	128606
10079	2272	119566	796	3108	0	125742
10080	2325	118772	620	2133	0	123850
10081	99532	3864	578	1702	0	105676
10082	2390	2391	409	87263	0	92453
10083	962	86878	337	1677	0	89854
10084	839	1663	224	86842	0	89568
10085	550	954	86562	1778	0	89844
10086	638	653	90084	883	0	92258
10087	886	495	1865	96539	0	99785
10088	100761	529	857	2633	0	104780
10089	107640	473	418	1451	0	109982
10090	108165	520	321	1148	0	110154
10091	3507	597	107978	622	0	112704
10092	1990	589	2329	106148	0	111056
10093	1356	627	987	111236	0	114206
10094	926	613	107687	3253	0	112479
10095	100462	554	2504	1975	0	105495
10096	2969	589	108496	1091	0	113145
10097	1327	491	106141	749	0	108708
10098	868	430	108309	652	0	110259
10099	1033	380	3533	103057	0	108003
10100	948	301	1519	107160	0	109928
10101	477	383	108795	3479	0	113134
10102	991	300	2867	108086	0	112244
10103	109829	232	1485	3584	0	115130
10104	2991	272	1079	111889	0	116231
10105	1231	313	113465	3415	0	118424
10106	830	309	118881	1796	0	121816
10107	1050	331	3668	117189	0	122238
10108	121474	252	1742	3850	0	127318
10109	3251	129051	1353	1747	0	135402
10110	132602	3169	1032	1730	0	138533
10111	134780	1361	996	1526	0	138663
10112	5240	675	136493	1158	0	143566
10113	3068	394	4109	135207	0	142778
10114	137660	269	2451	4687	0	145067
10115	136177	228	1477	3124	0	141006
10116	5208	136692	1136	1662	0	144698
10117	3222	3321	1045	136388	0	143976
10118	2200	1478	953	141712	0	146343
10119	1364	832	137920	5359	0	145475
10120	1805	419	4095	135130	0	141449
10121	1179	418	138278	4975	0	144850
10122	1413	428	136163	2608	0	140612
10123	1744	376	5285	133333	0	140738
10124	133286	332	2683	4929	0	141230
10125	4079	130627	1748	2716	0	139170
10126	130463	3325	1378	2239	0	137405
10127	131723	1588	1196	1931	0	136438
10128	5583	131521	1160	1332	0	139596
10129	3386	3518	997	126507	0	134408
10130	126913	1810	877	4068	0	133668
10131	4298	127700	809	2297	0	135104
10132	125499	3390	767	1885	0	131541
10133	4204	122529	794	1121	0	128648
10134	2788	3279	700	118650	0	125417
10135	2042	1686	756	122303	0	126787
10136	118603	1011	738	4943	0	125295
10137	117438	749	622	3045	0	121854
10138	4685	119331	770	1794	0	126580
10139	2502	3077	116983	1377	0	123939
10140	1751	1557	115807	1297	0	120412
10141	1740	1044	4320	110493	0	117597
10142	1099	116850	2473	3380	0	123802
10143	1461	2853	1646	119346	0	125306
10144	1620	1486	1241	118820	0	123167
10145	1652	1053	1126	119251	0	123082
10146	1183	972	117841	4964	0	124960
10147	1225	832	116533	2771	0	121361
10148	1114	119712	4438	2007	0	127271
10149	1561	3161	2254	119875	0	126851
10150	1721	1761	1317	125669	0	130468
10151	1382	1282	121772	4907	0	129343
10152	107877	1056	3655	3458	0	116046
10153	4019	790	2219	123248	0	130276
10154	2264	831	123622	4128	0	130845
10155	115729	730	3741	3437	0	123637
10156	3811	122693	2159	2134	0	130797
10157	2621	3224	127641	1835	0	135321
10158	2190	1818	3762	126874	0	134644
10159	127043	1147	2397	4550	0	135137
10160	3911	948	129811	2725	0	137395
10161	2541	846	4132	129629	0	137148
10162	2091	808	2513	130645	0	136057
10163	1631	799	1746	142523	0	146699
10164	141082	814	1546	6537	0	149979
10165	4101	137502	1426	3733	0	146762
10166	2756	3625	1265	140262	0	147908
10167	1699	1938	142254	5066	0	150957
10168	1836	1323	4381	137825	0	145365
10169	1361	137018	2493	5229	0	146101
10170	1197	146421	1735	3227	0	152580
10171	142830	4855	1360	2997	0	152042
10172	145655	2394	1182	2518	0	151749
10173	5818	1709	142981	1742	0	152250
10174	139777	1173	4302	2265	0	147517
10175	5030	143741	2413	1735	0	152919
10176	146239	4175	1457	2282	0	154153
10177	5539	2331	1206	145201	0	154277
10178	3300	1796	147030	4625	0	156751
10179	3034	1372	4089	146537	0	155032
10180	2052	1285	147226	5185	0	155748
10181	142147	992	4876	3627	0	151642
10182	4855	1049	2662	147994	0	156560
10183	2546	152654	1685	5041	0	161926
10184	2481	4391	1240	154918	0	163030
10185	1735	2426	154053	5457	0	163671
10186	1379	150299	4294	3503	0	159475
10187	140240	3788	2250	2929	0	149207
10188	3499	137221	1681	1702	0	144103
10189	1710	134988	1285	1284	0	139267
10190	1676	4302	929	129512	0	136419
10191	975	132714	931	3267	0	137887
10192	1428	3516	735	134097	0	139776
10193	1074	2000	132076	3664	0	138814
10194	121706	1254	2929	2455	0	128344
10195	130082	1021	1544	1728	0	134375
10196	4234	1005	129972	1082	0	136293
10197	124287	803	2909	1658	0	129657
10198	3499	128433	1652	1011	0	134595
10199	129827	2899	1035	1388	0	135149
10200	3889	1604	851	127872	0	134216
10201	2054	1212	129892	2947	0	136105
10202	1323	133460	2843	1888	0	139514
10203	1359	2967	1676	132695	0	138697
10204	1144	1540	844	134929	0	138457
10205	128819	943	649	4346	0	134757
10206	122776	807	676	2608	0	126867
10207	3495	121790	742	1384	0	127411
10208	1427	115412	567	827	0	118233
10209	686	113174	430	549	0	114839
10210	1052	1882	533	110700	0	114167
10211	109790	638	506	1966	0	112900
10212	107832	349	171	902	0	109254
10213	1855	356	175	107219	0	109605
10214	876	302	207	107908	0	109293
10215	106829	324	185	2088	0	109426
10216	1682	319	206	108793	0	111000
10217	622	408	109986	1607	0	112623
10218	107346	292	1212	1350	0	110200
10219	110404	275	389	1126	0	112194
10220	1851	414	113726	461	0	116452
10221	115243	365	1208	892	0	117708
10222	1902	404	387	119787	0	122480
10223	951	383	303	119572	0	121209
10224	731	402	284	121293	0	122710
10225	118763	296	285	2493	0	121837
10226	1536	122558	377	918	0	125389
10227	926	1433	260	123275	0	125894
10228	662	121151	328	1632	0	123773
10229	121795	1500	313	1253	0	124861
10230	1946	579	311	123034	0	125870
10231	1121	449	269	124155	0	125994
10232	748	124458	372	2054	0	127632
10233	768	1768	123195	823	0	126554
10234	906	619	1569	124715	0	127809
10235	125317	476	573	2552	0	128918
10236	138206	374	412	1598	0	140590
10237	3265	509	146210	781	0	150765
10238	1787	373	2996	148649	0	153805
10239	754	154048	1172	3217	0	159191
10240	1064	3279	614	157909	0	162866
10241	156123	1266	392	4479	0	162260
10242	157410	805	451	2024	0	160690
10243	4825	583	358	154650	0	160416
10244	1831	153634	401	3629	0	159495
10245	164221	3502	267	2215	0	170205
10246	4368	1341	296	169891	0	175896
10247	169516	948	249	4761	0	175474
10248	179692	664	317	2499	0	183172
10249	5469	604	248	179189	0	185510
10250	2838	539	392	179826	0	183595
10251	2091	453	288	184080	0	186912
10252	1126	182353	446	5553	0	189478
10253	1734	3858	262	185173	0	191027
10254	1837	1459	293	186234	0	189823
10255	1137	962	179502	5602	0	187203
10256	1091	783	174818	2564	0	179256
10257	1411	596	4523	174786	0	181316
10258	173011	515	1743	5459	0	180728
10259	3974	175094	987	2425	0	182480
10260	171177	3794	631	2360	0	177962
10261	4832	1564	173176	1445	0	181017
10262	2244	1036	166418	1333	0	171031
10263	1199	169639	4436	1404	0	176678
10264	1884	3693	2001	170052	0	177630
10265	789	1488	171448	3802	0	177527
10266	712	1049	174216	1884	0	177861
10267	1310	746	4189	171910	0	178155
10268	172709	375	1906	4588	0	179578
10269	173699	421	1168	2321	0	177609
10270	4884	337	818	171487	0	177526
10271	2062	501	185094	3867	0	191524
10272	2010	446	3382	186657	0	192495
10273	1616	489	1429	184560	0	188094
10274	823	187847	1125	4351	0	194146
10275	187028	3188	892	2791	0	193899
10276	186636	1305	815	2248	0	191004
10277	4312	189115	805	1397	0	195629
10278	2571	3340	673	181836	0	188420
10279	1260	187419	849	3785	0	193313
10280	186498	3593	657	2546	0	193294
10281	4185	1613	183483	1350	0	190631
10282	2211	1157	175818	1207	0	180393
10283	1507	815	176817	976	0	180115
10284	1352	644	4547	176411	0	182954
10285	1271	478	1984	178803	0	182536
10286	177768	532	1172	5240	0	184712
10287	3781	498	768	178416	0	183463
10288	2241	615	727	183700	0	187283
10289	1331	577	192860	4797	0	199565
10290	1201	687	185513	2482	0	189883
10291	183739	535	4173	2645	0	191092
10292	3483	191739	1997	1443	0	198662
10293	194783	3158	1171	2028	0	201140
10294	4346	1344	1009	194880	0	201579
10295	2316	819	1047	194191	0	198373
10296	1307	193368	1136	4393	0	200204
10297	1362	3345	905	195611	0	201223
10298	192276	1401	803	5119	0	199599
10299	3975	1041	713	194306	0	200035
10300	1994	837	194380	4597	0	201808
10301	1441	190815	3502	2677	0	198435
10302	187531	3318	1638	2679	0	195166
10303	191573	1398	1303	2543	0	196817
10304	191645	1010	1034	2326	0	196015
10305	193603	788	836	2229	0	197456
10306	5624	780	741	190405	0	197550
10307	3090	749	706	193936	0	198481
10308	2022	839	190806	5204	0	198871
10309	2039	691	3246	190782	0	196758
10310	1540	861	190924	4943	0	198268
10311	1803	658	3638	190200	0	196299
10312	188820	635	1677	5810	0	196942
10313	3847	195025	1367	2887	0	203126
10314	2462	3334	1054	196516	0	203366
10315	1956	1585	1039	201721	0	206301
10316	197105	980	958	6142	0	205185
10317	190475	697	1006	3818	0	195996
10318	5158	820	192328	2167	0	200473
10319	2416	192700	3786	2099	0	201001
10320	1963	3394	1808	191533	0	198698
10321	1722	1490	1411	193366	0	197989
10322	188906	978	1270	6160	0	197314
10323	187778	726	1301	3806	0	193611
10324	5043	856	189340	2067	0	197306
10325	2708	917	186427	1591	0	191643
10326	2300	781	4663	183443	0	191187
10327	1944	658	2189	188770	0	193561
10328	1526	783	185921	5160	0	193390
10329	177378	645	4010	3574	0	185607
10330	4748	553	1939	186906	0	194146
10331	183351	484	1527	5463	0	190825
10332	4077	182204	1257	2733	0	190271
10333	185865	3264	1075	3205	0	193409
10334	4687	1601	199243	1904	0	207435
10335	2543	195687	3896	1860	0	203986
10336	1502	189179	1572	1088	0	193341
10337	175652	2547	2716	2064	0	182979
10338	171551	897	666	1543	0	174657
10339	3090	565	475	170140	0	174270
10340	1205	169416	489	2224	0	173334
10341	731	174288	532	1305	0	176856
10342	982	2360	388	175288	0	179018
10343	174059	988	376	3202	0	178625
10344	173942	579	349	2360	0	177230
10345	2955	565	164813	697	0	169030
10346	154856	303	1692	1500	0	158351
10347	2179	171219	738	435	0	174571
10348	173058	2208	304	1402	0	176972
10349	2967	210322	417	455	0	214161
10350	1058	230738	425	440	0	232661
10351	2315	6701	333	253012	0	262361
10352	269125	2565	521	7926	0	280137
10353	276285	1491	175	4015	0	281966
10354	10171	1135	269649	1758	0	282713
10355	6270	600	7066	269026	0	282962
10356	273191	421	2772	9180	0	285564
10357	10588	336	1668	274470	0	287062
10358	276286	339	1243	10419	0	288287
10359	279208	353	993	5555	0	286109
10360	11716	593	273057	2788	0	288154
10361	7440	434	7348	265204	0	280426
10362	5152	475	2922	273396	0	281945
10363	4301	519	1758	276324	0	282902
10364	2173	556	265017	11815	0	279561
10365	3021	378	8087	263117	0	274603
10366	2899	470	3269	255323	0	261961
10367	1257	258103	2329	11522	0	273211
10368	1251	7574	255967	5926	0	270718
10369	1009	261368	8221	4334	0	274932
10370	258247	8871	3146	4079	0	274343
10371	9474	4061	2098	239785	0	255418
10372	5556	2745	1681	235337	0	245319
10373	2873	245759	1629	9799	0	260060
10374	243855	8379	1023	6029	0	259286
10375	248138	3493	773	4783	0	257187
10376	114981	136528	920	3821	0	256250
10377	8512	247133	980	2667	0	259292
10378	245958	9470	833	2756	0	259017
10379	10809	4442	240861	1851	0	257963
10380	5550	3228	241193	1825	0	251796
10381	230767	2452	10092	2768	0	246079
10382	9099	241488	5052	1559	0	257198
10383	242325	8227	3231	2510	0	256293
10384	10313	4090	238953	1861	0	255217
10385	238345	2674	8308	3035	0	252362
10386	10696	246982	3879	1884	0	263441
10387	7047	8836	2602	245369	0	263854
10388	5944	3867	2071	248625	0	260507
10389	5635	2821	1825	230366	0	240647
10390	4638	2237	1297	239709	0	247881
10391	3863	2047	1223	232799	0	239932
10392	2696	232096	1402	13963	0	250157
10393	232146	8037	1350	8535	0	250068
10394	9558	3958	230207	5660	0	249383
10395	5890	2833	7996	233445	0	250164
10396	4047	2487	234444	10404	0	251382
10397	4059	1980	9946	233380	0	249365
10398	3749	1492	5132	239739	0	250112
10399	231810	1613	3717	13934	0	251074
10400	9338	1858	228865	7720	0	247781
10401	4764	227925	9358	5688	0	247735
10402	4446	8375	4459	229434	0	246714
10403	4064	4123	3062	237472	0	248721
10404	2984	3396	231407	12666	0	250453
10405	3472	2865	8989	231512	0	246838
10406	3211	2620	4132	240800	0	250763
10407	224691	1859	2942	15020	0	244512
10408	8959	230187	2511	8324	0	249981
10409	230632	8880	2129	6678	0	248319
10410	236984	4537	1594	5671	0	248786
10411	13736	3404	1511	230864	0	249515
10412	7758	2930	227475	10267	0	248430
10413	5819	2645	229106	5507	0	243077
10414	5217	2196	11396	223129	0	241938
10415	4594	1986	6002	219812	0	232394
10416	3168	223892	4644	12580	0	244284
10417	222321	8382	3823	7741	0	242267
10418	9828	219917	3283	5733	0	238761
10419	5680	229776	2390	5197	0	243043
10420	224738	11969	1935	5116	0	243758
10421	11529	6271	1971	220080	0	239851
10422	6576	231683	2016	10606	0	250881
10423	5282	10276	1786	233914	0	251258
10424	3840	5282	227513	12837	0	249472
10425	3418	3578	230135	8134	0	245265
10426	3454	2918	11468	230699	0	248539
10427	2591	2617	232601	12513	0	250322
10428	3124	2034	11433	230738	0	247329
10429	3024	2118	6437	232585	0	244164
10430	2834	2033	4845	240258	0	249970
10431	224427	2005	3650	16378	0	246460
10432	8790	219279	3308	9601	0	240978
10433	4404	228704	2565	7247	0	242920
10434	210136	10451	2089	6291	0	228967
10435	217019	5688	1792	5257	0	229756
10436	12092	4390	1699	210695	0	228876
10437	6219	3959	209919	9917	0	230014
10438	5302	3027	8235	212084	0	228648
10439	4156	2536	211884	11265	0	229841
10440	3273	210723	9427	6892	0	230315
10441	3428	8321	4931	214157	0	230837
10442	211964	4121	3707	11113	0	230905
10443	9865	3211	2834	214725	0	230635
10444	5296	2759	207466	10515	0	226036
10445	202000	2518	8552	6832	0	219902
10446	10185	2095	208857	4903	0	226040
10447	6056	1946	202411	3745	0	214158
10448	3847	189083	10191	3854	0	206975
10449	2241	151102	4385	2113	0	159841
10450	1909	138605	3176	1844	0	145534
10451	98509	3645	4606	2866	0	109626
10452	90462	404	548	855	0	92269
10453	875	217	161	93347	0	94600
10454	495	172	113	93352	0	94132
10455	338	111	101	96292	0	96842
10456	198	96598	159	933	0	97888
10457	96583	590	123	866	0	98162
10458	655	97153	208	299	0	98315
10459	394	696	134	98471	0	99695
10460	97399	267	166	1180	0	99012
10461	832	222	157	97685	0	98896
10462	474	233	114	99573	0	100394
10463	99836	195	115	1525	0	101671
10464	97571	185	137	981	0	98874
10465	999	224	99190	277	0	100690
10466	519	226	96292	289	0	97326
10467	283	239	100827	259	0	101608
10468	462	152	988	100410	0	102012
10469	399	174	374	102348	0	103295
10470	173	102997	290	1057	0	104517
10471	105263	817	185	1002	0	107267
10472	1105	332	158	107089	0	108684
10473	565	189	143	108454	0	109351
10474	280	109415	191	1380	0	111266
10475	221	115588	179	613	0	116601
10476	445	1238	132	118191	0	120006
10477	596	406	140	130953	0	132095
10478	130480	223	157	2825	0	133685
10479	130376	179	200	1384	0	132139
10480	2552	201	199	130228	0	133180
10481	840	269	129658	2042	0	132809
10482	558	385	124873	849	0	126665
10483	733	188	2131	127904	0	130956
10484	761	211	702	125531	0	127205
10485	364	126316	413	2406	0	129499
10486	122139	1751	253	1611	0	125754
10487	2169	591	227	123042	0	126029
10488	683	418	122907	2052	0	126060
10489	790	255	1783	123508	0	126336
10490	373	266	123453	2317	0	126409
10491	468	335	123091	978	0	124872
10492	856	455	2284	124726	0	128321
10493	124933	213	880	2917	0	128943
10494	1850	233	124857	968	0	127908
10495	1083	183	1980	122540	0	125786
10496	477	289	130904	2105	0	133775
10497	779	132	1980	129289	0	132180
10498	793	242	775	129353	0	131163
10499	445	241	129354	2531	0	132571
10500	496	326	124286	1179	0	126287
10501	1306	182	2560	116261	0	120309
10502	641	157	991	127829	0	129618
10503	587	139	745	129386	0	130857
10504	631	150	627	127385	0	128793
10505	125695	117	543	3493	0	129848
10506	125625	132	478	2095	0	128330
10507	2254	126016	616	1009	0	129895
10508	126383	1743	463	1550	0	130139
10509	2298	544	591	127801	0	131234
10510	127598	255	512	3223	0	131588
10511	2201	267	126516	1257	0	130241
10512	126070	166	2181	1500	0	129917
10513	2475	176	984	129087	0	132722
10514	1319	158	637	133947	0	136061
10515	132122	146	510	3794	0	136572
10516	2855	167	466	143723	0	147211
10517	986	274	150011	3572	0	154843
10518	145997	195	3000	2576	0	151768
10519	3260	154523	1273	1302	0	160358
10520	1839	2836	652	160410	0	165737
10521	1032	1043	172332	3835	0	178242
10522	1337	525	3708	169016	0	174586
10523	816	501	170888	4684	0	176889
10524	1309	313	4152	169182	0	174956
10525	743	171809	1643	4743	0	178938
10526	1302	3639	968	171188	0	177097
10527	722	178312	870	4765	0	184669
10528	2125	4635	793	168443	0	175996
10529	1539	1469	646	186749	0	190403
10530	1513	809	765	187978	0	191065
10531	1661	568	773	187635	0	190637
10532	1617	553	832	189268	0	192270
10533	861	661	182540	7253	0	191315
10534	1532	521	4790	182236	0	189079
10535	1194	477	2018	186903	0	190592
10536	181893	436	1494	7991	0	191814
10537	4339	182576	1187	3915	0	192017
10538	182215	4721	914	3419	0	191269
10539	5912	1764	768	183019	0	191463
10540	2025	1348	182150	6281	0	191804
10541	1158	182327	4961	3574	0	192020
10542	177478	4675	2044	3705	0	187902
10543	4688	178004	1484	2790	0	186966
10544	1686	185207	1139	2550	0	190582
10545	180092	5735	944	3134	0	189905
10546	5702	2238	905	189963	0	198808
10547	189142	1288	952	7332	0	198714
10548	6572	887	940	186110	0	194509
10549	2442	880	184859	7333	0	195514
10550	1622	1020	183217	3678	0	189537
10551	175074	908	6510	3445	0	185937
10552	183955	843	2855	2931	0	190584
10553	7500	832	1774	176816	0	186922
10554	3797	916	1288	180999	0	187000
10555	171363	967	1037	8463	0	181830
10556	5872	170620	1073	3873	0	181438
10557	2669	177534	967	2848	0	184018
10558	172227	6388	846	3027	0	182488
10559	175097	2504	936	2718	0	181255
10560	7215	173199	1027	2044	0	183485
10561	4252	5556	805	172179	0	182792
10562	2465	2389	170561	6361	0	181776
10563	2013	1719	171348	3174	0	178254
10564	165978	1152	6726	2976	0	176832
10565	6555	1028	171340	2161	0	181084
10566	3924	970	5936	164339	0	175169
10567	2995	1027	2332	162930	0	169284
10568	1969	165556	1679	7190	0	176394
10569	165372	5443	1345	3921	0	176081
10570	6929	2440	1156	164584	0	175109
10571	3117	1851	161484	6251	0	172703
10572	2415	161437	5145	3377	0	172374
10573	2622	5824	2125	159394	0	169965
10574	1892	2418	158418	6136	0	168864
10575	1700	1815	154915	3274	0	161704
10576	1386	150994	6508	2639	0	161527
10577	135046	4464	2679	2311	0	144500
10578	4509	139904	1890	1764	0	148067
10579	139040	4734	1476	2132	0	147382
10580	5061	2150	137262	1899	0	146372
10581	132761	1541	4641	2222	0	141165
10582	4896	138029	2209	1863	0	146997
10583	2900	4535	1582	137741	0	146758
10584	2111	2120	1486	143381	0	149098
10585	140008	1669	1298	6448	0	149423
10586	4794	1543	139247	3349	0	148933
10587	138093	1463	4622	2840	0	147018
10588	141682	1339	2215	2499	0	147735
10589	5960	1294	136159	2078	0	145491
10590	2793	1308	139896	1935	0	145932
10591	2475	1491	5613	135468	0	145047
10592	136790	1382	2632	5691	0	146495
10593	138314	1280	1915	3094	0	144603
10594	5924	139014	1697	2360	0	148995
10595	3493	4557	1336	140670	0	150056
10596	2799	2128	1280	138123	0	144330
10597	2520	1694	1125	139468	0	144807
10598	2382	1291	1141	142281	0	147095
10599	137932	1109	1407	7202	0	147650
10600	5932	1116	1356	140817	0	149221
10601	3080	1360	139157	5939	0	149536
10602	2742	1253	138589	2969	0	145553
10603	133424	1148	5756	2699	0	143027
10604	5682	134849	2864	2016	0	145411
10605	2972	141576	2150	1969	0	148667
10606	3096	5415	1669	140041	0	150221
10607	2631	2493	1466	143766	0	150356
10608	2611	1690	1376	142101	0	147778
10609	2405	1364	1319	145096	0	150184
10610	1874	1354	139913	7260	0	150401
10611	2429	1141	4588	139238	0	147396
10612	2599	994	2013	141219	0	146825
10613	1912	1128	134538	6651	0	144229
10614	125080	903	4735	4109	0	134827
10615	4846	130675	2475	3445	0	141441
10616	119494	3385	1664	2429	0	126972
10617	4325	1299	116294	1738	0	123656
10618	2184	1001	111817	1433	0	116435
10619	1535	110092	4066	1355	0	117048
10620	98247	4474	6638	2013	0	111372
10621	91240	1201	1321	1389	0	95151
10622	92187	653	781	1249	0	94870
10623	3035	90227	711	1013	0	94986
10624	87439	2035	656	1039	0	91169
10625	2582	919	88304	836	0	92641
10626	1182	88041	2070	820	0	92113
10627	84149	1813	1019	1043	0	88024
10628	2137	86291	697	682	0	89807
10629	82415	1876	504	742	0	85537
10630	80044	745	501	826	0	82116
10631	2281	516	82503	437	0	85737
10632	1040	83045	1864	429	0	86378
10633	81487	1738	811	675	0	84711
10634	2060	782	81747	345	0	84934
10635	1028	82036	1740	397	0	85201
10636	1031	1629	716	79664	0	83040
10637	596	691	80335	1481	0	83103
10638	501	577	77850	659	0	79587
10639	787	544	1720	77892	0	80943
10640	77518	301	835	1760	0	80414
10641	1495	77681	518	747	0	80441
10642	715	1332	76850	490	0	79387
10643	679	569	75416	302	0	76966
10644	70987	409	1690	557	0	73643
10645	1373	76803	785	297	0	79258
10646	67538	734	500	363	0	69135
10647	794	68346	209	167	0	69516
10648	68954	804	272	425	0	70455
10649	67814	286	200	360	0	68660
10650	1024	67589	234	116	0	68963
10651	562	842	170	68133	0	69707
10652	71918	328	140	1064	0	73450
10653	1082	275	147	73179	0	74683
10654	674	167	172	77505	0	78518
10655	77795	132	171	1609	0	79707
10656	1132	77803	211	508	0	79654
10657	78450	1106	146	657	0	80359
10658	1388	442	78495	190	0	80515
10659	732	276	1122	78811	0	80941
10660	576	199	383	79090	0	80248
10661	78873	171	240	1740	0	81024
10662	79053	230	143	850	0	80276
10663	1712	175	129	78836	0	80852
10664	732	250	80043	1272	0	82297
10665	728	182	1105	79192	0	81207
10666	614	205	388	80177	0	81384
10667	601	154	309	80724	0	81788
10668	597	160	206	80898	0	81861
10669	79760	158	147	2145	0	82210
10670	1432	213	79638	784	0	82067
10671	644	80474	1234	579	0	82931
10672	708	1138	439	79678	0	81963
10673	533	423	338	83112	0	84406
10674	396	323	82593	1759	0	85071
10675	401	313	81035	878	0	82627
10676	613	157	1577	83768	0	86115
10677	583	182	631	85174	0	86570
10678	403	213	83296	2073	0	85985
10679	666	188	1555	82022	0	84431
10680	83559	216	694	2235	0	86704
10681	1625	86469	488	943	0	89525
10682	747	1516	85298	790	0	88351
10683	485	85722	1652	651	0	88510
10684	721	1700	703	86051	0	89175
10685	469	713	86796	1803	0	89781
10686	413	86183	1709	949	0	89254
10687	636	1575	777	86421	0	89409
10688	366	698	88172	1814	0	91050
10689	734	463	1715	86342	0	89254
10690	642	359	756	87272	0	89029
10691	86963	267	608	2750	0	90588
10692	1971	320	448	87590	0	90329
10693	87379	310	409	2614	0	90712
10694	83895	252	487	1486	0	86120
10695	84134	331	415	1213	0	86093
10696	2658	307	340	82924	0	86229
10697	1003	266	81534	2041	0	84844
10698	742	348	78727	1084	0	80901
10699	78890	230	1963	1281	0	82364
10700	1812	271	81029	681	0	83793
10701	76227	214	1780	1046	0	79267
10702	1825	79398	838	768	0	82829
10703	79702	1370	584	1000	0	82656
10704	2002	579	81030	678	0	84289
10705	981	392	82595	637	0	84605
10706	1080	213	2146	83302	0	86741
10707	557	228	87474	2032	0	90291
10708	566	283	88729	989	0	90567
10709	1084	220	2463	91308	0	95075
10710	938	235	1091	95516	0	97780
10711	788	250	706	98290	0	100034
10712	466	98296	689	3294	0	102745
10713	918	2262	594	95478	0	99252
10714	426	100534	712	2777	0	104449
10715	99593	2594	652	1783	0	104622
10716	101737	1016	554	1409	0	104716
10717	3423	632	607	96721	0	101383
10718	1433	96800	639	2974	0	101846
10719	862	2428	99203	1532	0	104025
10720	99125	947	2860	1430	0	104362
10721	3221	687	1296	98829	0	104033
10722	1791	422	875	100362	0	103450
10723	1447	417	615	102886	0	105365
10724	98889	391	578	4585	0	104443
10725	3032	95461	664	2087	0	101244
10726	1366	99178	665	1390	0	102599
10727	94082	3252	552	1397	0	99283
10728	2802	96267	682	1004	0	100755
10729	96145	3053	572	1262	0	101032
10730	96887	1186	578	1340	0	99991
10731	3688	95156	691	998	0	100533
10732	2018	2922	573	92373	0	97886
10733	1108	95347	634	3070	0	100159
10734	1399	2999	582	94824	0	99804
10735	1291	1386	471	100684	0	103832
10736	99584	908	432	4665	0	105589
10737	103640	734	513	2483	0	107370
10738	4773	806	536	102340	0	108455
10739	2208	790	100290	3748	0	107036
10740	97330	825	3033	2339	0	103527
10741	3608	99632	1469	1574	0	106283
10742	2247	3288	938	99133	0	105606
10743	1913	1525	699	101932	0	106069
10744	1740	1056	558	103329	0	106683
10745	97363	960	521	5417	0	104261
10746	98334	818	548	3154	0	102854
10747	4368	93094	601	2040	0	100103
10748	2188	96314	649	1526	0	100677
10749	2063	3825	539	94448	0	100875
10750	1934	1804	512	97027	0	101277
10751	1363	1287	94842	4539	0	102031
10752	1584	984	2872	92320	0	97760
10753	1031	744	90626	4209	0	96610
10754	1049	696	85340	2057	0	89142
10755	830	84606	3502	1598	0	90536
10756	1313	2924	1641	84758	0	90636
10757	84968	1292	956	3878	0	91094
10758	3495	911	699	84614	0	89719
10759	1836	921	83203	3689	0	89649
10760	81705	785	2728	2177	0	87395
10761	84236	899	1328	1604	0	88067
10762	3986	1055	82063	1240	0	88344
10763	2424	665	2769	83821	0	89679
10764	82329	578	1324	3797	0	88028
10765	3437	83074	1130	2119	0	89760
10766	84426	2859	870	2012	0	90167
10767	87149	1455	817	1682	0	91103
10768	4590	1096	828	84709	0	91223
10769	2561	996	674	88603	0	92834
10770	87102	753	600	4879	0	93334
10771	4263	686	544	87779	0	93272
10772	2099	831	86077	4486	0	93493
10773	83726	616	3111	2637	0	90090
10774	85132	617	1406	1924	0	89079
10775	4404	81593	871	1629	0	88497
10776	2079	83886	796	1465	0	88226
10777	1866	3639	527	80008	0	86040
10778	1375	82939	535	3472	0	88321
10779	1506	3635	612	83192	0	88945
10780	81383	1441	555	3950	0	87329
10781	80150	961	513	2206	0	83830
10782	3722	78532	617	1682	0	84553
10783	77772	2905	582	1689	0	82948
10784	3740	77812	555	1317	0	83424
10785	77679	3133	523	1479	0	82814
10786	79021	1474	711	1515	0	82721
10787	4335	1004	75855	1167	0	82361
10788	74873	821	2642	1189	0	79525
10789	3724	73479	1220	1082	0	79505
10790	2111	76543	792	1084	0	80530
10791	76072	3384	629	1281	0	81366
10792	3813	1786	443	75571	0	81613
10793	2126	1179	75274	3175	0	81754
10794	2134	926	2539	75296	0	80895
10795	1951	843	1059	77909	0	81762
10796	1347	990	74694	3904	0	80935
10797	72161	805	2629	2295	0	77890
10798	3487	73873	1207	1679	0	80246
10799	73573	2614	817	1521	0	78525
10800	4001	1294	702	71377	0	77374
10801	71693	914	640	3195	0	76442
10802	3597	70505	547	1859	0	76508
10803	2284	2979	544	70860	0	76667
10804	70273	1410	406	3301	0	75390
10805	3341	1033	66061	1818	0	72253
10806	1799	680	61768	1452	0	65699
10807	57913	669	3003	1306	0	62891
10808	2842	57000	1291	1033	0	62166
10809	1252	50357	582	748	0	52939
10810	1669	2270	872	46415	0	51226
10811	1018	47397	393	1733	0	50541
10812	1039	1927	424	47560	0	50950
10813	1006	883	390	49217	0	51496
10814	900	510	427	48624	0	50461
10815	891	46954	462	2124	0	50431
10816	853	1578	380	46630	0	49441
10817	704	816	45530	1836	0	48886
10818	819	44635	1251	983	0	47688
10819	685	1471	594	40823	0	43573
10820	520	41885	509	1209	0	44123
10821	41682	1149	353	857	0	44041
10822	41612	687	296	703	0	43298
10823	41740	460	365	678	0	43243
10824	1688	42379	337	605	0	45009
10825	1045	1204	236	41781	0	44266
10826	715	680	41291	1187	0	43873
10827	694	564	40180	693	0	42131
10828	38771	591	1201	727	0	41290
10829	39725	429	521	640	0	41315
10830	1511	365	305	41077	0	43258
10831	1022	386	270	42659	0	44337
10832	612	376	43138	1633	0	45759
10833	563	42378	1169	899	0	45009
10834	612	42622	650	603	0	44487
10835	479	992	39150	326	0	40947
10836	489	778	913	35833	0	38013
10837	501	275	353	31625	0	32754
10838	318	179	139	36533	0	37169
10839	300	186	161	36399	0	37046
10840	36141	222	128	995	0	37486
10841	803	241	34981	325	0	36350
10842	34654	189	650	294	0	35787
10843	855	195	236	35391	0	36677
10844	35494	164	142	870	0	36670
10845	841	179	122	35648	0	36790
10846	361	181	36186	808	0	37536
10847	384	172	645	36308	0	37509
10848	241	204	37824	773	0	39042
10849	311	213	648	36859	0	38031
10850	223	179	39088	749	0	40239
10851	162	39397	640	361	0	40560
10852	289	627	237	39433	0	40586
10853	259	234	142	39514	0	40149
10854	161	40159	158	747	0	41225
10855	40944	638	131	480	0	42193
10856	827	249	128	40902	0	42106
10857	368	160	140	40729	0	41397
10858	41004	148	111	1079	0	42342
10859	41534	138	113	537	0	42322
10860	42648	135	129	462	0	43374
10861	42796	101	123	417	0	43437
10862	998	139	41141	242	0	42520
10863	40252	98	694	410	0	41454
10864	42329	104	275	348	0	43056
10865	1039	135	141	40388	0	41703
10866	465	116	141	40448	0	41170
10867	39426	81	92	977	0	40576
10868	711	39131	108	354	0	40304
10869	373	563	82	38046	0	39064
10870	176	201	39766	597	0	40740
10871	126	38938	517	270	0	39851
10872	38537	462	283	342	0	39624
10873	39152	160	110	282	0	39704
10874	39255	69	78	249	0	39651
10875	39845	66	41	245	0	40197
10876	672	58	64	38640	0	39434
10877	273	81	37971	505	0	38830
10878	158	82	39814	257	0	40311
10879	235	62	725	42701	0	43723
10880	45124	47	230	842	0	46243
10881	949	30	104	45380	0	46463
10882	351	70	46079	849	0	47349
10883	45928	43	774	507	0	47252
10884	46808	24	286	328	0	47446
10885	1208	61	156	47246	0	48671
10886	450	69	49647	880	0	51046
10887	294	70	50485	332	0	51181
10888	47965	31	1050	454	0	49500
10889	946	50169	353	219	0	51687
10890	411	774	51292	197	0	52674
10891	397	230	902	50702	0	52231
10892	51236	97	356	1125	0	52814
10893	962	49936	220	390	0	51508
10894	401	51159	201	247	0	52008
10895	51009	998	197	380	0	52584
10896	1086	326	181	50934	0	52527
10897	54816	139	177	1165	0	56297
10898	1265	121	151	55876	0	57413
10899	593	151	178	56625	0	57547
10900	343	139	56171	1259	0	57912
10901	334	181	53139	529	0	54183
10902	321	156	56545	275	0	57297
10903	411	139	1320	56458	0	58328
10904	57312	114	448	1339	0	59213
10905	1283	113	57564	496	0	59456
10906	689	100	1135	57299	0	59223
10907	399	212	58720	1245	0	60576
10908	330	60064	1231	569	0	62194
10909	525	1039	494	60871	0	62929
10910	504	301	333	61392	0	62530
10911	503	147	325	62231	0	63206
10912	61325	104	320	1784	0	63533
10913	1409	116	302	61355	0	63182
10914	711	119	329	62286	0	63445
10915	61524	109	354	1852	0	63839
10916	1321	176	60812	711	0	63020
10917	60183	114	1275	671	0	62243
10918	60978	167	478	655	0	62278
10919	1611	181	60435	377	0	62604
10920	58661	163	1215	564	0	60603
10921	1581	151	500	61909	0	64141
10922	695	157	63104	1336	0	65292
10923	61757	143	1248	960	0	64108
10924	63656	89	491	730	0	64966
10925	1803	94	361	63404	0	65662
10926	891	71	356	64007	0	65325
10927	726	85	335	64789	0	65935
10928	62903	60	308	2009	0	65280
10929	1433	63579	387	847	0	66246
10930	61735	912	352	818	0	63817
10931	1461	59101	375	482	0	61419
10932	607	59344	430	417	0	60798
10933	612	1149	344	59874	0	61979
10934	582	333	322	60670	0	61907
10935	554	199	259	59896	0	60908
10936	561	154	305	60145	0	61165
10937	428	183	58986	1551	0	61148
10938	57184	161	1132	950	0	59427
10939	1279	210	416	60013	0	61918
10940	627	224	60855	1408	0	63114
10941	582	212	1085	60825	0	62704
10942	619	190	398	62262	0	63469
10943	473	230	65047	1583	0	67333
10944	616	201	1095	64538	0	66450
10945	631	184	451	64750	0	66016
10946	64813	163	358	1983	0	67317
10947	1248	155	65452	863	0	67718
10948	61802	97	1144	1035	0	64078
10949	1263	65802	584	689	0	68338
10950	64819	939	438	871	0	67067
10951	63957	305	423	796	0	65481
10952	1644	176	398	63897	0	66115
10953	718	162	63723	1466	0	66069
10954	514	66500	1216	820	0	69050
10955	592	1023	524	64797	0	66936
10956	406	69415	383	1341	0	71545
10957	69139	1167	345	1013	0	71664
10958	1375	438	68322	625	0	70760
10959	601	342	67544	587	0	69074
10960	665	252	1352	67068	0	69337
10961	482	273	70613	1478	0	72846
10962	640	241	1290	70474	0	72645
10963	647	237	484	70284	0	71652
10964	72642	201	374	2078	0	75295
10965	1414	73525	402	918	0	76259
10966	740	1259	357	74672	0	77028
10967	627	347	392	76188	0	77554
10968	561	239	395	75493	0	76688
10969	433	74011	447	1841	0	76732
10970	428	75478	453	907	0	77266
10971	73860	1367	374	980	0	76581
10972	74211	424	375	968	0	75978
10973	73851	247	345	953	0	75396
10974	1731	257	73099	627	0	75714
10975	861	393	1262	72489	0	75005
10976	512	343	72866	1645	0	75366
10977	465	72943	1294	895	0	75597
10978	69776	1187	502	878	0	72343
10979	1270	392	69639	483	0	71784
10980	674	281	968	67606	0	69529
10981	410	197	69655	1120	0	71382
10982	66802	161	1057	860	0	68880
10983	70028	155	437	742	0	71362
10984	70287	154	281	648	0	71370
10985	68816	170	258	641	0	69885
10986	1237	206	70980	309	0	72732
10987	68103	167	906	607	0	69783
10988	70338	113	376	602	0	71429
10989	1134	70082	335	301	0	71852
10990	69389	751	280	562	0	70982
10991	70467	249	235	510	0	71461
10992	1310	171	279	68521	0	70281
10993	570	71659	236	884	0	73349
10994	75139	832	190	684	0	76845
10995	80838	278	193	598	0	81907
10996	1728	277	91686	392	0	94083
10997	739	217	92006	244	0	93206
10998	457	209	95064	209	0	95939
10999	675	414	2876	92392	0	96357
11000	93193	142	1129	2352	0	96816
11001	2136	93876	616	998	0	97626
11002	92629	1982	388	806	0	95805
11003	2341	93910	353	386	0	96990
11004	92286	2220	328	556	0	95390
11005	2328	91750	271	315	0	94664
11006	1035	94616	269	224	0	96144
11007	90628	2598	218	633	0	94077
11008	2119	93259	206	214	0	95798
11009	1220	2290	244	92109	0	95863
11010	676	955	93177	1862	0	96670
11011	444	628	93425	719	0	95216
11012	657	373	2578	91317	0	94925
11013	770	238	1037	94485	0	96530
11014	317	411	94209	2623	0	97560
11015	709	237	2090	91936	0	94972
11016	655	277	927	94406	0	96265
11017	93516	233	561	3118	0	97428
11018	2123	94363	372	1293	0	98151
11019	1217	2167	336	89677	0	93397
11020	652	96255	450	1934	0	99291
11021	94857	2439	324	1329	0	98949
11022	2137	96280	348	750	0	99515
11023	95986	2411	330	777	0	99504
11024	96431	1053	307	664	0	98455
11025	3253	632	221	94390	0	98496
11026	1721	532	301	94862	0	97416
11027	1271	376	415	96407	0	98469
11028	936	430	379	96689	0	98434
11029	582	413	93017	3343	0	97355
11030	86185	386	2134	1959	0	90664
11031	2334	93169	911	924	0	97338
11032	1431	2257	505	94725	0	98918
11033	1104	1066	383	95588	0	98141
11034	706	95651	414	2900	0	99671
11035	95123	2442	478	1747	0	99790
11036	2492	96885	417	914	0	100708
11037	1469	2714	354	97211	0	101748
11038	1090	1142	341	99736	0	102309
11039	968	773	277	100181	0	102199
11040	890	658	281	99149	0	100978
11041	96449	469	306	4050	0	101274
11042	2639	592	96405	1658	0	101294
11043	1505	467	2429	93691	0	98092
11044	1092	551	1132	94968	0	97743
11045	839	495	825	96543	0	98702
11046	886	434	644	96069	0	98033
11047	91874	503	492	4186	0	97055
11048	2842	499	92647	1919	0	97907
11049	1593	658	2222	88289	0	92762
11050	965	87909	1037	2771	0	92682
11051	733	93194	667	1467	0	96061
11052	90831	2978	370	1549	0	95728
11053	2793	1508	90952	880	0	96133
11054	84868	1014	2134	1069	0	89085
11055	2918	756	88143	753	0	92570
11056	1489	579	2295	85035	0	89398
11057	86821	480	1035	3031	0	91367
11058	2223	88873	846	1626	0	93568
11059	1194	2148	756	85249	0	89347
11060	969	84660	733	2358	0	88720
11061	87403	2456	631	1736	0	92226
11062	88748	1048	532	1542	0	91870
11063	3145	805	440	88275	0	92665
11064	1541	720	86234	2780	0	91275
11065	1198	662	85527	1545	0	88932
11066	1034	801	2674	84335	0	88844
11067	824	86138	1261	2395	0	90618
11068	814	2571	685	89933	0	94003
11069	972	1321	337	86805	0	89435
11070	1186	994	314	85918	0	88412
11071	794	811	87176	3534	0	92315
11072	944	544	2112	86726	0	90326
11073	715	566	1029	88015	0	90325
11074	527	86108	765	4043	0	91443
11075	612	2371	512	86510	0	90005
11076	609	941	461	90778	0	92789
11077	617	518	640	92264	0	94039
11078	646	388	580	91918	0	93532
11079	717	374	467	90498	0	92056
11080	610	621	360	90944	0	92535
11081	602	510	312	89252	0	90676
11082	588	627	296	87855	0	89366
11083	626	697	68005	15944	0	85272
11084	788	605	1716	84207	0	87316
11085	82554	520	756	3717	0	87547
11086	2570	372	499	82055	0	85496
11087	1267	476	81861	3364	0	86968
11088	78533	383	2096	2378	0	83390
11089	83584	396	972	1829	0	86781
11090	83915	417	637	1566	0	86535
11091	83920	377	467	1494	0	86258
11092	3621	325	371	83661	0	87978
11093	1628	277	81484	3112	0	86501
11094	981	77476	2071	1981	0	82509
11095	661	72039	1015	1407	0	75122
11096	1206	1594	1818	57568	0	62186
11097	334	288	541	59869	0	61032
11098	307	145	110	58912	0	59474
11099	273	86	76	61955	0	62390
11100	241	86	68	69676	0	70071
11101	74577	76	93	2312	0	77058
11102	1783	75230	120	855	0	77988
11103	709	78997	128	506	0	80340
11104	693	2477	113	79132	0	82415
11105	519	966	88	81743	0	83316
11106	488	459	71	81420	0	82438
11107	420	248	98	81683	0	82449
11108	221	241	77369	3487	0	81318
11109	212	76364	2033	1655	0	80264
11110	466	2025	680	77067	0	80238
11111	75286	820	367	2768	0	79241
11112	2185	525	188	76757	0	79655
11113	829	370	76098	2833	0	80130
11114	562	358	73712	1505	0	76137
11115	449	314	77326	1085	0	79174
11116	529	514	2959	74629	0	78631
11117	77126	371	1313	2877	0	81687
11118	2193	216	643	78521	0	81573
11119	1073	192	374	81055	0	82694
11120	78512	170	344	3663	0	82689
11121	2444	180	360	80392	0	83376
11122	1190	150	554	81473	0	83367
11123	614	350	83818	3204	0	87986
11124	408	83634	2340	1818	0	88200
11125	731	2089	996	87142	0	90958
11126	85921	693	658	3362	0	90634
11127	2527	401	549	87671	0	91148
11128	1074	310	87272	3164	0	91820
11129	970	356	2427	86329	0	90082
11130	454	87392	947	3347	0	92140
11131	831	2230	580	89373	0	93014
11132	409	971	88003	3377	0	92760
11133	308	93401	2442	1910	0	98061
11134	869	2846	958	95144	0	99817
11135	701	1145	623	105997	0	108466
11136	684	672	459	108134	0	109949
11137	636	396	532	108868	0	110432
11138	310	550	104813	5158	0	110831
11139	223	105033	3154	2848	0	111258
11140	104781	3083	1341	2048	0	111253
11141	107468	1278	837	1750	0	111333
11142	4267	756	705	106053	0	111781
11143	1624	550	104932	4084	0	111190
11144	102368	520	3241	2359	0	108488
11145	3610	339	1404	106621	0	111974
11146	1368	392	109132	4100	0	114992
11147	1301	503	3419	109274	0	114497
11148	1082	315	1421	110538	0	113356
11149	1010	294	836	112771	0	114911
11150	658	353	111709	5584	0	118304
11151	1183	398	3417	106465	0	111463
11152	702	111368	1703	4236	0	118009
11153	110923	3341	962	2624	0	117850
11154	112679	1287	778	2094	0	116838
11155	113170	743	665	1921	0	116499
11156	4674	110553	690	1763	0	117680
11157	110770	3239	806	1801	0	116616
11158	4493	1284	659	108502	0	114938
11159	108041	836	649	4834	0	114360
11160	108731	646	767	2753	0	112897
11161	4784	573	105006	2031	0	112394
11162	2196	104564	3420	1757	0	111937
11163	104657	3328	1474	1753	0	111212
11164	4198	1491	1152	104269	0	111110
11165	2016	1037	103399	4125	0	110577
11166	1519	103828	3366	2170	0	110883
11167	102496	3357	1412	1856	0	109121
11168	4424	1477	869	102925	0	109695
11169	2512	993	712	104994	0	109211
11170	1771	969	606	104952	0	108298
11171	1501	101907	591	5356	0	109355
11172	1387	3309	624	103301	0	108621
11173	1204	101569	806	4633	0	108212
11174	1394	3709	712	103308	0	109123
11175	1014	1763	101993	4689	0	109459
11176	1227	1284	3439	102894	0	108844
11177	1348	778	1598	105043	0	108767
11178	1084	693	1145	107150	0	110072
11179	816	820	102672	5946	0	110254
11180	1105	884	3476	102671	0	108136
11181	1307	657	1639	106330	0	109933
11182	1040	672	1146	107859	0	110717
11183	1041	682	980	107466	0	110169
11184	1073	671	840	108743	0	111327
11185	912	933	103707	6417	0	111969
11186	1157	686	3382	105253	0	110478
11187	1137	743	1695	105934	0	109509
11188	99483	543	1198	6575	0	107799
11189	3545	97602	1148	3720	0	106015
11190	1941	102110	840	3060	0	107951
11191	1536	3905	796	102553	0	108790
11192	1301	1765	855	102652	0	106573
11193	919	97395	1022	5646	0	104982
11194	1235	3451	734	98858	0	104278
11195	945	97328	699	5554	0	104526
11196	1383	3489	661	98322	0	103855
11197	1300	1645	642	97696	0	101283
11198	836	1124	92460	5227	0	99647
11199	807	89422	3025	3208	0	96462
11200	784	85956	1173	2197	0	90110
11201	73573	2418	999	1700	0	78690
11202	1937	75337	508	1106	0	78888
11203	1178	2153	396	73835	0	77562
11204	789	1148	72020	2423	0	76380
11205	822	862	1671	71416	0	74771
11206	70597	640	764	2872	0	74873
11207	1877	725	72233	1532	0	76367
11208	943	74266	1753	1263	0	78225
11209	1444	1958	922	65742	0	70066
11210	711	830	577	77312	0	79430
11211	76846	552	600	3246	0	81244
11212	1810	596	519	78113	0	81038
11213	970	598	410	78776	0	80754
11214	749	626	374	79083	0	80832
11215	725	587	336	78656	0	80304
11216	75788	520	399	3453	0	80160
11217	75544	474	389	2287	0	78694
11218	2255	419	405	76391	0	79470
11219	74528	396	393	2879	0	78196
11220	2088	386	403	73755	0	76632
11221	974	441	71330	2652	0	75397
11222	713	508	69231	1761	0	72213
11223	852	728	1791	64379	0	67750
11224	558	65629	769	2352	0	69308
11225	639	1378	481	65867	0	68365
11226	64276	619	397	2552	0	67844
11227	1428	464	335	66010	0	68237
11228	64498	400	330	2616	0	67844
11229	1733	373	306	65977	0	68389
11230	937	432	66006	2211	0	69586
11231	604	64442	1253	1492	0	67791
11232	503	66731	595	1334	0	69163
11233	644	1888	357	58663	0	61552
11234	267	494	59169	1464	0	61394
11235	116	49858	445	464	0	50883
11236	289	500	214	48041	0	49044
11237	47013	126	161	632	0	47932
11238	265	131	48090	206	0	48692
11239	208	85	256	48040	0	48589
11240	114	61	93	49707	0	49975
11241	69	69	49654	426	0	50218
11242	98	100	46155	267	0	46620
11243	67	101	49626	189	0	49983
11244	153	91	394	49909	0	50547
11245	49	61	51271	419	0	51800
11246	46366	20	437	373	0	47196
11247	527	43	153	52132	0	52855
11248	255	71	61841	511	0	62678
11249	123	63565	618	332	0	64638
11250	89	572	63349	168	0	64178
11251	201	297	789	62638	0	63925
11252	65336	128	322	996	0	66782
11253	811	62	155	67169	0	68197
11254	406	54	98	68296	0	68854
11255	73058	69	73	1305	0	74505
11256	1177	68	75	74748	0	76068
11257	370	76	76131	1302	0	77879
11258	73647	43	1159	741	0	75590
11259	1180	77164	421	352	0	79117
11260	78616	1061	221	389	0	80287
11261	1493	331	107	78516	0	80447
11262	475	258	77748	1194	0	79675
11263	331	153	77768	436	0	78688
11264	398	134	1483	78494	0	80509
11265	397	101	563	78129	0	79190
11266	189	107	79198	1445	0	80939
11267	209	140	75506	681	0	76536
11268	77378	48	1586	578	0	79590
11269	1468	63	648	79136	0	81315
11270	79943	47	411	1550	0	81951
11271	1632	60	225	79385	0	81302
11272	559	133	82081	1531	0	84304
11273	426	156	84705	529	0	85816
11274	511	74	1789	85982	0	88356
11275	428	50	690	88399	0	89567
11276	227	85	90611	1985	0	92908
11277	87859	46	1815	1121	0	90841
11278	2008	42	603	93469	0	96122
11279	96939	26	498	2336	0	99799
11280	2151	109927	446	778	0	113302
11281	981	2576	291	112725	0	116573
11282	113360	622	264	3419	0	117665
11283	3144	384	113992	1006	0	118526
11284	1381	212	3005	113611	0	118209
11285	1074	127	948	114256	0	116405
11286	857	220	635	118101	0	119813
11287	402	214	115177	4234	0	120027
11288	962	124	3086	111728	0	115900
11289	335	114934	1216	3496	0	119981
11290	718	2785	707	116385	0	120595
11291	363	799	115842	3704	0	120708
11292	380	481	117037	1470	0	119368
11293	804	272	3928	115246	0	120250
11294	784	224	1382	117502	0	119892
11295	817	259	809	119498	0	121383
11296	718	151	638	120616	0	122123
11297	116998	117	663	4976	0	122754
11298	117263	128	596	2294	0	120281
11299	3888	155	115536	1444	0	121023
11300	1300	116857	3361	1138	0	122656
11301	1153	2820	1120	120201	0	125294
11302	122595	805	742	4406	0	128548
11303	109788	697	834	2822	0	114141
11304	125326	292	573	1680	0	127871
11305	126140	218	731	1497	0	128586
11306	4428	364	122956	973	0	128721
11307	117505	224	3373	1521	0	122623
11308	3956	118481	1250	1097	0	124784
11309	1931	2944	843	120567	0	126285
11310	1223	919	121539	3772	0	127453
11311	1477	547	3485	119413	0	124922
11312	853	447	120662	4152	0	126114
11313	1209	347	3815	119749	0	125120
11314	1042	456	1440	124362	0	127300
11315	121640	272	1015	5286	0	128213
11316	4005	267	954	122703	0	127929
11317	1524	374	123222	4688	0	129808
11318	1428	305	3739	126047	0	131519
11319	125858	272	1517	5129	0	132776
11320	4036	262	1179	127529	0	133006
11321	1665	372	126870	4562	0	133469
11322	1081	124664	3737	2446	0	131928
11323	129753	3098	1613	2500	0	136964
11324	3976	961	1252	125746	0	131935
11325	1655	132640	1121	3963	0	139379
11326	131455	3345	954	2623	0	138377
11327	3975	1161	131462	1793	0	138391
11328	1628	130601	3834	1566	0	137629
11329	1624	3343	1610	133079	0	139656
11330	1084	1082	132202	4349	0	138717
11331	1362	754	3886	128373	0	134375
11332	129292	521	1577	5161	0	136551
11333	3937	494	128311	2418	0	135160
11334	2034	523	3834	128073	0	134464
11335	1442	527	129612	4594	0	136175
11336	1581	469	4227	128119	0	134396
11337	1397	493	1716	132560	0	136166
11338	127964	497	1184	5696	0	135341
11339	3920	128428	1257	2648	0	136253
11340	1955	3125	1024	131239	0	137343
11341	128969	1043	1152	5049	0	136213
11342	130181	717	1014	2840	0	134752
11343	4748	571	1017	127802	0	134138
11344	2039	123953	1040	4497	0	131529
11345	1364	130002	950	2354	0	134670
11346	1366	3545	937	127900	0	133748
11347	1332	1228	908	128231	0	131699
11348	115889	696	844	5046	0	122475
11349	3580	545	846	115597	0	120568
11350	1280	590	111262	4242	0	117374
11351	103690	469	3031	2565	0	109755
11352	3246	107920	1195	1828	0	114189
11353	106862	2595	816	1899	0	112172
11354	3635	865	109901	1375	0	115776
11355	1299	111657	2700	1305	0	116961
11356	109975	2826	1477	1468	0	115746
11357	111435	866	892	1313	0	114506
11358	3572	695	111379	866	0	116512
11359	108734	573	2874	1141	0	113322
11360	112331	420	1105	1152	0	115008
11361	3514	113067	717	881	0	118179
11362	1793	2708	584	116124	0	121209
11363	1323	949	114968	3145	0	120385
11364	1261	577	3070	116910	0	121818
11365	909	615	119569	3616	0	124709
11366	1042	463	3309	117726	0	122540
11367	119610	490	1263	4096	0	125459
11368	3598	332	778	123114	0	127822
11369	1283	380	133544	3873	0	139080
11370	134375	310	3713	2079	0	140477
11371	4696	282	1377	139218	0	145573
11372	1525	340	136142	4348	0	142355
11373	129867	247	3916	2110	0	136140
11374	4692	425	1413	133565	0	140095
11375	1623	410	131220	4315	0	137568
11376	1373	460	128189	1663	0	131685
11377	1555	1510	4150	125525	0	132740
11378	840	359	130395	3881	0	135475
11379	937	124832	3940	1493	0	131202
11380	1144	2348	1130	111130	0	115752
11381	111150	540	924	2731	0	115345
11382	2306	426	112848	892	0	116472
11383	926	249	111928	877	0	113980
11384	105275	132	3087	1008	0	109502
11385	2371	266	113365	431	0	116433
11386	106194	88	2794	1062	0	110138
11387	2679	145	112280	494	0	115598
11388	1373	150	2806	109691	0	114020
11389	711	240	113905	2282	0	117138
11390	1153	160	2760	110566	0	114639
11391	500	251	116324	2519	0	119594
11392	578	216	113469	1042	0	115305
11393	105978	145	3144	1255	0	110522
11394	2116	115031	1568	716	0	119431
11395	116235	1903	1275	911	0	120324
11396	2534	117585	943	517	0	121579
11397	1444	2166	1006	117815	0	122431
11398	1309	729	923	120886	0	123847
11399	120254	427	879	3093	0	124653
11400	2742	415	806	118471	0	122434
11401	1269	263	118585	2609	0	122726
11402	111418	271	2638	1661	0	115988
11403	115450	204	1325	1367	0	118346
11404	3142	234	1133	114853	0	119362
11405	1527	336	116757	2499	0	121119
11406	1273	353	2619	114587	0	118832
11407	761	116387	1339	2775	0	121262
11408	1054	2105	965	117006	0	121130
11409	1191	741	737	120125	0	122794
11410	784	605	117129	3349	0	121867
11411	103926	436	2692	2183	0	109237
11412	2559	115516	1270	1377	0	120722
11413	115113	2245	974	1435	0	119767
11414	2791	117085	879	1134	0	121889
11415	1575	2356	845	114006	0	118782
11416	1068	117416	930	2549	0	121963
11417	980	2561	114866	1422	0	119829
11418	1190	1005	2689	107754	0	112638
11419	1263	683	1335	110334	0	113615
11420	1014	509	1168	115721	0	118412
11421	112314	413	1016	4082	0	117825
11422	2874	626	1004	112945	0	117449
11423	109195	492	1005	3824	0	114516
11424	110553	623	860	2184	0	114220
11425	108539	543	898	2094	0	112074
11426	3574	673	108158	1378	0	113783
11427	2349	482	2812	108215	0	113858
11428	1606	538	1478	114169	0	117791
11429	1415	487	1492	116727	0	120121
11430	119100	428	1264	4596	0	125388
11431	3848	509	1159	119407	0	124923
11432	1965	397	1401	123949	0	127712
11433	128597	479	1290	5195	0	135561
11434	4345	396	1255	131854	0	137850
11435	2125	482	134261	4870	0	141738
11436	1840	574	135441	2465	0	140320
11437	1852	351	4834	136515	0	143552
11438	134750	314	2338	5415	0	142817
11439	132237	309	2022	2784	0	137352
11440	5616	321	1591	132821	0	140349
11441	2612	429	132847	4740	0	140628
11442	1980	129962	4540	2414	0	138896
11443	2055	3329	2077	132727	0	140188
11444	1849	1177	1682	135597	0	140305
11445	1973	815	1531	136295	0	140614
11446	132864	572	1502	6645	0	141583
11447	4547	520	133589	3231	0	141887
11448	132397	633	4375	2801	0	140206
11449	5428	498	1941	131122	0	138989
11450	2519	132903	1680	4831	0	141933
11451	133745	3648	1312	3140	0	141845
11452	132667	1275	1150	2903	0	137995
11453	5556	1103	136567	1902	0	145128
11454	2844	125098	4227	2285	0	134454
11455	1885	127781	1811	2067	0	133544
11456	126413	3983	1467	2150	0	134013
11457	4928	1451	1045	125919	0	133343
11458	2815	1130	950	125993	0	130888
11459	2283	862	1049	124958	0	129152
11460	1694	117571	858	5709	0	125832
11461	1320	123471	764	2925	0	128480
11462	119052	3975	671	2576	0	126274
11463	4587	1480	617	118751	0	125435
11464	1744	1129	125493	4163	0	132529
11465	2103	822	4111	129605	0	136641
11466	1318	925	141447	5573	0	149263
11467	1482	983	141823	2550	0	146838
11468	1509	860	142460	2020	0	146849
11469	675	123955	6663	1003	0	132296
11470	1792	4315	4144	113907	0	124158
11471	612	121280	2211	3850	0	127953
11472	1739	4895	1458	111941	0	120033
11473	1095	2217	931	122879	0	127122
11474	119867	1564	703	6549	0	128683
11475	4548	916	616	122489	0	128569
11476	119196	740	562	6400	0	126898
11477	121577	499	500	3547	0	126123
11478	6349	462	481	115623	0	122915
11479	3238	114326	611	5116	0	123291
11480	2635	3859	582	112513	0	119589
11481	1583	114714	685	5334	0	122316
11482	1593	4820	551	114383	0	121347
11483	930	2388	112128	5935	0	121381
11484	1335	1667	4025	113705	0	120732
11485	1230	1029	1874	117974	0	122107
11486	109639	807	1450	7429	0	119325
11487	4123	111453	1123	4153	0	120852
11488	2725	4153	867	113128	0	120873
11489	2274	1900	666	112769	0	117609
11490	1396	109142	855	6652	0	118045
11491	1591	4472	715	111121	0	117899
11492	101518	2366	577	7165	0	111626
11493	108081	1681	537	4226	0	114525
11494	5785	104872	571	3009	0	114237
11495	3523	4569	529	106152	0	114773
11496	101625	2124	673	6129	0	110551
11497	5099	104217	729	3378	0	113423
11498	3215	4826	683	98311	0	107035
11499	2221	103229	719	5361	0	111530
11500	102510	5324	690	3402	0	111926
11501	5239	2906	100163	2468	0	110776
11502	2652	2202	101615	2180	0	108649
11503	2400	1541	5754	100504	0	110199
11504	1618	1370	102529	5432	0	110949
11505	1755	1082	5951	100195	0	108983
11506	98705	1012	3274	6419	0	109410
11507	4900	1119	101134	3668	0	110821
11508	2904	1113	5037	101313	0	110367
11509	2430	1072	2645	104488	0	110635
11510	100328	1185	1853	7490	0	110856
11511	4916	102009	1364	4554	0	112843
11512	102360	4497	1030	3910	0	111797
11513	104174	2408	806	3034	0	110422
11514	6806	99384	1018	2286	0	109494
11515	4472	4762	960	100541	0	110735
11516	2930	2780	98913	5305	0	109928
11517	2508	2161	4285	97945	0	106899
11518	1665	99495	2243	6051	0	109454
11519	100657	4985	1775	3805	0	111222
11520	4992	2684	1448	102506	0	111630
11521	2517	2292	102066	6156	0	113031
11522	2208	1683	4467	104728	0	113086
11523	1875	1464	2456	107385	0	113180
11524	1742	1405	1758	109003	0	113908
11525	1679	1209	1260	109867	0	114015
11526	1726	1190	1087	106963	0	110966
11527	1271	1206	99578	9186	0	111241
11528	1474	1083	96495	5760	0	104812
11529	1134	89078	5543	4175	0	99930
11530	973	92743	2893	3083	0	99692
11531	89603	4600	2065	2543	0	98811
11532	4251	2577	89833	1959	0	98620
11533	80770	1910	4017	1810	0	88507
11534	4229	1370	79609	1487	0	86695
11535	2350	1023	75792	1232	0	80397
11536	1874	859	4645	72097	0	79475
11537	75152	801	2888	3776	0	82617
11538	3534	698	1884	77120	0	83236
11539	2033	678	1365	78976	0	83052
11540	1506	518	83982	5365	0	91371
11541	1261	532	3340	86438	0	91571
11542	1143	508	1869	87432	0	90952
11543	987	451	1359	89123	0	91920
11544	1173	484	971	88817	0	91445
11545	1102	412	787	89573	0	91874
11546	84033	406	634	6557	0	91630
11547	3291	454	535	86576	0	90856
11548	1781	533	81492	5367	0	89173
11549	1640	634	2657	83851	0	88782
11550	1207	617	81914	4737	0	88475
11551	1161	743	3414	83149	0	88467
11552	784	461	85096	4759	0	91100
11553	680	622	3910	81027	0	86239
11554	567	415	2224	85828	0	89034
11555	484	426	82679	5046	0	88635
11556	76848	377	3200	3708	0	84133
11557	2697	493	84219	2530	0	89939
11558	1967	444	3484	84767	0	90662
11559	85788	261	2151	4002	0	92202
11560	3338	328	1566	87114	0	92346
11561	2344	388	986	88752	0	92470
11562	1557	432	86596	4973	0	93558
11563	1050	83052	2667	3671	0	90440
11564	612	75230	1396	2345	0	79583
11565	325	72832	945	1580	0	75682
11566	1292	582	907	58598	0	61379
11567	60073	187	220	662	0	61142
11568	366	132	64	60308	0	60870
11569	257	61	77	60858	0	61253
11570	193	28	76	61821	0	62118
11571	149	36	65	61641	0	61891
11572	69	60960	103	643	0	61775
11573	114	320	60	62837	0	63331
11574	130	123	55	62878	0	63186
11575	43	62450	72	618	0	63183
11576	63747	372	54	540	0	64713
11577	415	180	47	64345	0	64987
11578	64308	138	55	712	0	65213
11579	63694	73	52	515	0	64334
11580	518	65544	79	253	0	66394
11581	391	385	52	70373	0	71201
11582	194	182	69532	482	0	70390
11583	164	174	67876	267	0	68481
11584	202	224	475	69054	0	69955
11585	70868	51	266	721	0	71906
11586	72549	45	177	553	0	73324
11587	586	42	108	74292	0	75028
11588	74609	42	89	844	0	75584
11589	529	74257	112	300	0	75198
11590	74483	392	78	485	0	75438
11591	545	79839	101	194	0	80679
11592	388	495	69	82322	0	83274
11593	331	263	69	82232	0	82895
11594	144	82373	104	607	0	83228
11595	81848	444	109	721	0	83122
11596	499	276	80841	284	0	81900
11597	386	158	426	81582	0	82552
11598	265	162	83088	530	0	84045
11599	365	94	527	82028	0	83014
11600	84144	76	244	939	0	85403
11601	605	89	173	84391	0	85258
11602	83686	69	116	969	0	84840
11603	82608	86	97	658	0	83449
11604	758	86	85	83296	0	84225
11605	387	168	82174	658	0	83387
11606	282	85810	469	424	0	86985
11607	301	437	200	86344	0	87282
11608	84940	210	172	1023	0	86345
11609	592	253	84115	366	0	85326
11610	525	120	477	84011	0	85133
11611	419	111	235	84292	0	85057
11612	268	106	206	86609	0	87189
11613	86136	87	141	1203	0	87567
11614	648	107	130	84630	0	85515
11615	384	76	130	86734	0	87324
11616	312	148	86534	801	0	87795
11617	448	69	533	85695	0	86745
11618	367	78	288	87421	0	88154
11619	309	100	227	89068	0	89704
11620	208	87965	170	976	0	89319
11621	347	462	115	87216	0	88140
11622	330	219	111	87034	0	87694
11623	84196	175	127	1289	0	85787
11624	645	199	82703	595	0	84142
11625	448	217	77554	480	0	78699
11626	288	83354	685	366	0	84693
11627	342	507	386	86311	0	87546
11628	85562	213	263	1079	0	87117
11629	729	192	169	84017	0	85107
11630	479	107	156	85094	0	85836
11631	340	96	137	86334	0	86907
11632	342	85	92	84860	0	85379
11633	297	118	86	84775	0	85276
11634	195	177	83826	1103	0	85301
11635	318	73	523	83294	0	84208
11636	83440	64	249	1417	0	85170
11637	577	81614	254	581	0	83026
11638	393	515	171	83177	0	84256
11639	327	224	135	83285	0	83971
11640	204	276	77892	976	0	79348
11641	391	124	569	75824	0	76908
11642	289	104	267	81892	0	82552
11643	82792	91	187	1734	0	84804
11644	875	84824	198	759	0	86656
11645	529	892	120	86571	0	88112
11646	474	328	140	87591	0	88533
11647	362	363	134	87851	0	88710
11648	225	209	87674	1693	0	89801
11649	295	229	81626	984	0	83134
11650	183	85491	1427	754	0	87855
11651	160	89566	602	593	0	90921
11652	296	1313	333	87797	0	89739
11653	254	83953	421	1421	0	86049
11654	391	1639	217	94618	0	96865
11655	367	617	155	104053	0	105192
11656	423	351	129	109148	0	110051
11657	430	260	130	122640	0	123460
11658	148	257	121468	4373	0	126246
11659	562	189	2567	121624	0	124942
11660	471	158	1355	124083	0	126067
11661	450	131	822	127372	0	128775
11662	120500	155	536	6148	0	127339
11663	2615	124219	724	3293	0	130851
11664	1856	2824	462	117976	0	123118
11665	854	125526	527	4077	0	130984
11666	120507	3601	382	3492	0	127982
11667	108049	2179	313	3580	0	114121
11668	3667	123033	288	2059	0	129047
11669	2096	127787	286	1741	0	131910
11670	1387	5063	122588	1434	0	130472
11671	1070	127132	2920	1504	0	132626
11672	1427	4472	1673	123496	0	131068
11673	124133	2727	1024	4340	0	132224
11674	3445	127486	617	2541	0	134089
11675	2264	4316	695	128011	0	135286
11676	1677	2890	507	130192	0	135266
11677	1397	2057	564	133036	0	137054
11678	128180	1472	468	6650	0	136770
11679	3779	1649	126773	3793	0	135994
11680	121594	1202	3135	3275	0	129206
11681	4421	125095	1729	2229	0	133474
11682	2667	4102	1067	125830	0	133666
11683	1824	2486	124090	4572	0	132972
11684	117524	1683	3792	3394	0	126393
11685	4320	124325	1989	2012	0	132646
11686	2846	4235	1328	120159	0	128568
11687	1814	123579	981	4272	0	130646
11688	1614	4685	894	124379	0	131572
11689	1611	2595	750	127124	0	132080
11690	1052	1975	122722	6043	0	131792
11691	1097	1465	117282	3893	0	123737
11692	1372	1530	4638	118599	0	126139
11693	809	1254	120703	5329	0	128095
11694	1114	1086	4454	120109	0	126763
11695	1289	1021	2790	117655	0	122755
11696	993	869	2044	125044	0	128950
11697	119420	760	1683	7364	0	129227
11698	3868	796	1647	122880	0	129191
11699	2050	943	120669	6345	0	130007
11700	120293	810	3838	4868	0	129809
11701	4000	865	2334	124863	0	132062
11702	2639	753	1735	127389	0	132516
11703	122482	702	1326	7496	0	132006
11704	4018	126204	1587	4644	0	136453
11705	2850	3421	1354	130160	0	137785
11706	1902	2014	1170	129831	0	134917
11707	124713	1337	1168	7619	0	134837
11708	4358	1114	124152	5075	0	134699
11709	2802	1162	3506	125681	0	133151
11710	2185	997	2234	127725	0	133141
11711	1961	1034	1532	125408	0	129935
11712	1585	123067	1265	7525	0	133442
11713	1515	3514	1378	127643	0	134050
11714	122810	2133	1026	7138	0	133107
11715	4049	123399	1066	5097	0	133611
11716	120783	3988	975	4467	0	130213
11717	4532	124408	871	3532	0	133343
11718	124021	4762	780	3703	0	133266
11719	5157	2935	121609	2952	0	132653
11720	3186	2433	120823	2885	0	129327
11721	120924	1678	4648	2979	0	130229
11722	4799	1810	124555	2453	0	133617
11723	3514	1450	4509	122301	0	131774
11724	3209	1494	3089	112373	0	120165
11725	2188	1161	2293	128091	0	133733
11726	123952	1207	1876	7009	0	134044
11727	4482	1188	121681	4485	0	131836
11728	121342	1106	4224	3738	0	130410
11729	5222	1246	2511	128760	0	137739
11730	128729	1042	1875	6191	0	137837
11731	5764	1161	1508	130516	0	138949
11732	134028	1058	1508	6458	0	143052
11733	6410	1077	1405	143128	0	152020
11734	3700	1044	145125	6741	0	156610
11735	145400	973	4730	4618	0	155721
11736	152479	798	2765	4036	0	160078
11737	8036	790	1997	150098	0	160921
11738	4903	827	1630	148396	0	155756
11739	3242	148394	1854	7580	0	161070
11740	145159	4144	1617	5325	0	156245
11741	6120	147601	1545	3828	0	159094
11742	143409	4705	1247	3786	0	153147
11743	6538	2356	141809	3201	0	153904
11744	4013	1910	141545	2810	0	150278
11745	3192	1226	139298	2783	0	146499
11746	136606	1274	6655	2725	0	147260
11747	6101	139887	3543	2151	0	151682
11748	4214	4168	2526	138005	0	148913
11749	137826	2194	1985	5438	0	147443
11750	5544	139882	1821	3491	0	150738
11751	3909	5892	1596	133475	0	144872
11752	2601	134466	1554	5213	0	143834
11753	2342	131303	1423	3485	0	138553
11754	2256	132508	1108	2385	0	138257
11755	117226	5028	1467	2257	0	125978
11756	3696	117088	877	1671	0	123332
11757	1405	101951	622	912	0	104890
11758	938	102254	516	735	0	104443
11759	99541	2789	870	902	0	104102
11760	100194	1137	447	988	0	102766
11761	2840	856	97102	607	0	101405
11762	93379	466	1971	772	0	96588
11763	98371	438	783	734	0	100326
11764	2976	444	519	96428	0	100367
11765	97699	440	354	2390	0	100883
11766	2579	520	96159	850	0	100108
11767	1085	101764	1912	643	0	105404
11768	102335	2152	754	780	0	106021
11769	2759	935	408	104984	0	109086
11770	105427	645	289	2567	0	108928
11771	2739	563	101267	908	0	105477
11772	101664	427	1972	841	0	104904
11773	3034	477	687	103983	0	108181
11774	1174	425	104001	2157	0	107757
11775	828	99218	2193	910	0	103149
11776	649	104798	827	585	0	106859
11777	998	2645	563	101035	0	105241
11778	926	1059	284	99915	0	102184
11779	477	103130	316	2268	0	106191
11780	102987	2128	246	1193	0	106554
11781	102510	790	223	860	0	104383
11782	101789	518	217	818	0	103342
11783	2975	103517	236	418	0	107146
11784	1649	2084	244	98113	0	102090
11785	834	104648	258	1819	0	107559
11786	103844	2250	227	1057	0	107378
11787	103558	854	239	895	0	105546
11788	2806	102547	225	384	0	105962
11789	104266	2202	195	719	0	107382
11790	2868	858	212	103720	0	107658
11791	1454	595	264	105028	0	107341
11792	105357	456	372	3042	0	109227
11793	102734	411	322	1462	0	104929
11794	104577	438	293	927	0	106235
11795	3409	438	273	102489	0	106609
11796	1639	466	250	105011	0	107366
11797	950	618	102513	2869	0	106950
11798	1173	623	2008	101220	0	105024
11799	1123	644	687	101436	0	103890
11800	973	612	98060	2807	0	102452
11801	877	667	94243	1223	0	97010
11802	780	584	99111	747	0	101222
11803	950	553	2963	96888	0	101354
11804	852	635	95325	2427	0	99239
11805	1075	663	2392	93793	0	97923
11806	1106	675	883	96629	0	99293
11807	908	684	95499	2935	0	100026
11808	782	775	95523	1338	0	98418
11809	1068	663	2655	93445	0	97831
11810	749	696	100083	2567	0	104095
11811	839	731	98749	1201	0	101520
11812	819	98858	2839	903	0	103419
11813	100330	2386	1256	939	0	104911
11814	100816	1150	782	938	0	103686
11815	101506	883	592	1007	0	103988
11816	3254	99080	528	799	0	103661
11817	1614	101163	594	717	0	104088
11818	1475	2754	496	100971	0	105696
11819	1255	1194	585	100993	0	104027
11820	1043	813	99094	2959	0	103909
11821	1285	585	2436	98151	0	102457
11822	98969	533	1022	3271	0	103795
11823	3006	516	812	94579	0	98913
11824	1369	98709	748	2669	0	103495
11825	101658	2524	583	1576	0	106341
11826	103571	1060	553	1253	0	106437
11827	104900	709	542	1279	0	107430
11828	3848	605	102248	851	0	107552
11829	1954	822	2281	102805	0	107862
11830	111089	477	1166	3484	0	116216
11831	3323	425	115289	1407	0	120444
11832	1387	108643	3013	1073	0	114116
11833	922	105292	985	612	0	107811
11834	96148	2416	864	794	0	100222
11835	2234	97315	395	486	0	100430
11836	1157	2128	344	94256	0	97885
11837	537	743	96511	2118	0	99909
11838	867	527	2047	95264	0	98705
11839	95396	341	652	2653	0	99042
11840	2107	95254	459	886	0	98706
11841	94445	1969	419	800	0	97633
11842	2246	636	94370	539	0	97791
11843	1171	576	2073	89802	0	93622
11844	513	96943	783	1986	0	100225
11845	813	2005	494	98369	0	101681
11846	98730	657	387	2556	0	102330
11847	100283	387	356	1116	0	102142
11848	100321	319	392	876	0	101908
11849	101400	325	362	778	0	102865
11850	2885	330	357	97406	0	100978
11851	1047	335	100610	2167	0	104159
11852	1120	407	1976	96427	0	99930
11853	622	100664	710	2093	0	104089
11854	101370	1915	479	1076	0	104840
11855	2221	677	100817	595	0	104310
11856	97795	351	2021	775	0	100942
11857	2392	348	716	100042	0	103498
11858	851	362	104050	2183	0	107446
11859	1014	271	1950	103307	0	106542
11860	105340	240	699	2698	0	108977
11861	105802	248	522	1223	0	107795
11862	106005	236	454	999	0	107694
11863	2631	364	104553	541	0	108089
11864	1466	545	1949	103484	0	107444
11865	721	438	107147	2050	0	110356
11866	694	106910	2023	801	0	110428
11867	101547	1780	774	867	0	104968
11868	1874	100362	510	470	0	103216
11869	97084	1542	433	653	0	99712
11870	1930	485	288	94713	0	97416
11871	666	96861	364	1451	0	99342
11872	97476	1494	328	876	0	100174
11873	1802	492	98016	392	0	100702
11874	906	357	1483	96823	0	99569
11875	98167	281	480	1934	0	100862
11876	1856	346	98045	582	0	100829
11877	1013	277	1548	94353	0	97191
11878	726	94337	651	1563	0	97277
11879	800	1590	448	98681	0	101519
11880	812	626	293	99333	0	101064
11881	97639	493	246	2181	0	100559
11882	1846	97914	297	750	0	100807
11883	904	1632	314	95011	0	97861
11884	601	97400	407	1719	0	100127
11885	802	1701	399	95952	0	98854
11886	635	98406	419	1619	0	101079
11887	97710	1715	366	978	0	100769
11888	1989	758	98905	483	0	102135
11889	1099	404	1641	97356	0	100500
11890	854	358	669	98033	0	99914
11891	767	381	437	99084	0	100669
11892	907	408	301	97453	0	99069
11893	803	330	96841	2221	0	100195
11894	800	98552	1624	1036	0	102012
11895	98488	1612	547	1025	0	101672
11896	98849	571	441	1019	0	100880
11897	1976	99098	419	725	0	102218
11898	99851	1747	411	957	0	102966
11899	99872	654	421	992	0	101939
11900	2082	102316	386	645	0	105429
11901	1315	1751	325	99452	0	102843
11902	907	103297	455	1489	0	106148
11903	101970	1805	379	1146	0	105300
11904	2077	651	101690	699	0	105117
11905	93432	425	1745	1218	0	96820
11906	2024	454	103005	704	0	106187
11907	1215	371	1761	101963	0	105310
11908	102845	384	605	2199	0	106033
11909	2283	383	101147	756	0	104569
11910	95041	368	1729	1017	0	98155
11911	99774	360	641	990	0	101765
11912	2364	389	512	99097	0	102362
11913	976	100191	486	1749	0	103402
11914	101811	1835	327	1052	0	105025
11915	2211	721	270	101044	0	104246
11916	1081	99537	329	1770	0	102717
11917	100437	1678	338	1092	0	103545
11918	2109	650	385	101119	0	104263
11919	870	105036	471	1790	0	108167
11920	908	1591	446	108404	0	111349
11921	109024	542	462	2515	0	112543
11922	108274	437	349	1451	0	110511
11923	109241	323	459	1110	0	111133
11924	2443	346	405	106418	0	109612
11925	1203	388	334	106300	0	108225
11926	674	482	105954	2115	0	109225
11927	1220	584	1502	105109	0	108415
11928	768	455	110266	2005	0	113494
11929	620	434	99896	792	0	101742
11930	302	206	94192	306	0	95006
11931	170	99400	1263	227	0	101060
11932	599	1112	849	94816	0	97376
11933	196	108131	297	777	0	109401
11934	110437	1319	213	816	0	112785
11935	111374	394	143	720	0	112631
11936	1931	258	135	115046	0	117370
11937	614	223	120014	1538	0	122389
11938	745	133	1841	118489	0	121208
11939	265	300	122962	2075	0	125602
11940	793	204	2013	117431	0	120441
11941	259	120377	667	2071	0	123374
11942	245	125566	389	706	0	126906
11943	122048	2277	274	892	0	125491
11944	2118	768	122233	350	0	125469
11945	1198	387	2052	119360	0	122997
11946	912	259	588	122348	0	124107
11947	122042	247	367	2995	0	125651
11948	2045	123460	346	956	0	126807
11949	122706	2021	276	1101	0	126104
11950	2137	125478	378	540	0	128533
11951	121978	2201	299	885	0	125363
11952	124331	699	324	920	0	126274
11953	3037	470	283	123863	0	127653
11954	988	472	124327	2246	0	128033
11955	117085	350	2163	1401	0	120999
11956	2301	124807	750	656	0	128514
11957	125497	2239	435	897	0	129068
11958	2820	766	345	120023	0	123954
11959	1373	514	296	119917	0	122100
11960	780	119540	366	2578	0	123264
11961	1016	2224	252	117089	0	120581
11962	602	120511	332	2321	0	123766
11963	1061	2380	285	118699	0	122425
11964	1024	831	292	117846	0	119993
11965	114108	580	298	3233	0	118219
11966	2557	540	114276	1110	0	118483
11967	984	113170	2147	864	0	117165
11968	1155	2235	659	114452	0	118501
11969	114464	796	500	2963	0	118723
11970	116711	594	365	1591	0	119261
11971	115777	509	397	1383	0	118066
11972	3150	551	114242	776	0	118719
11973	114004	543	2341	1093	0	117981
11974	3196	527	799	116302	0	120824
11975	115008	511	538	3157	0	119214
11976	2856	113828	543	1253	0	118480
11977	1548	2429	422	115353	0	119752
11978	113676	890	473	3240	0	118279
11979	2873	116563	447	1305	0	121188
11980	1645	2590	427	117440	0	122102
11981	1117	1193	115159	2928	0	120397
11982	116064	837	2407	1691	0	120999
11983	122996	638	813	1452	0	125899
11984	4052	638	121644	841	0	127175
11985	1765	117271	2843	935	0	122814
11986	1345	123060	1046	944	0	126395
11987	1579	3272	801	121258	0	126910
11988	1781	1317	639	116604	0	120341
11989	1425	915	572	122398	0	125310
11990	1070	878	122486	4009	0	128443
11991	119997	871	2875	2303	0	126046
11992	127743	839	1078	1737	0	131397
11993	130122	762	812	1678	0	133374
11994	130373	746	687	1632	0	133438
11995	131142	735	656	1720	0	134253
11996	133563	708	718	1637	0	136626
11997	5321	750	690	137169	0	143930
11998	2336	902	134940	4133	0	142311
11999	1763	986	138073	1812	0	142634
12000	2023	888	4253	136156	0	143320
12001	2186	850	1463	135684	0	140183
12002	2083	722	945	135652	0	139402
12003	1577	138151	874	5138	0	145740
12004	138213	3953	808	2721	0	145695
12005	4897	142819	876	1655	0	150247
12006	2843	4310	709	140316	0	148178
12007	138465	1523	695	5305	0	145988
12008	4984	139805	631	2277	0	147697
12009	2804	4372	636	139847	0	147659
12010	2548	1705	582	143342	0	148177
12011	2112	1332	602	143299	0	147345
12012	1498	139930	713	5997	0	148138
12013	1990	4196	731	142693	0	149610
12014	1539	1722	141634	5679	0	150574
12015	2014	1331	4161	143286	0	150792
12016	2002	1149	1361	146449	0	150961
12017	1990	1249	805	153541	0	157585
12018	2147	1189	626	156680	0	160642
12019	1643	1262	150169	7526	0	160600
12020	1451	149856	5048	3947	0	160302
12021	2169	5248	1848	150168	0	159433
12022	2090	2088	1261	156968	0	162407
12023	1998	1478	956	154217	0	158649
12024	1446	146959	1045	8354	0	157804
12025	1302	157495	905	4411	0	164113
12026	151881	6513	710	3553	0	162657
12027	6464	2541	624	149308	0	158937
12028	2262	1745	145858	6703	0	156568
12029	1545	146262	4951	3643	0	156401
12030	140903	5258	1884	3291	0	151336
12031	5534	2127	138128	2421	0	148210
12032	2410	1570	137849	2185	0	144014
12033	1573	1132	134515	1789	0	139009
12034	2002	2174	6331	126011	0	136518
12035	1055	1004	129232	5336	0	136627
12036	740	122681	5477	2749	0	131647
12037	1274	4192	2141	115557	0	123164
12038	683	1709	118570	4659	0	125621
12039	1092	1296	4616	115438	0	122442
12040	113998	941	2066	5399	0	122404
12041	4080	868	114946	2688	0	122582
12042	111064	745	4585	2426	0	118820
12043	4379	116985	2058	1687	0	125109
12044	116841	4121	1442	1810	0	124214
12045	5171	1667	1325	116276	0	124439
12046	116810	1160	1297	5084	0	124351
12047	118330	892	1275	2688	0	123185
12048	114938	914	1178	2331	0	119361
12049	5575	116844	1229	1724	0	125372
12050	116941	4115	1098	1812	0	123966
12051	119017	1642	1052	1822	0	123533
12052	5821	1198	115947	1465	0	124431
12053	2886	115657	4269	1438	0	124250
12054	2684	4253	1932	114880	0	123749
12055	2261	1829	1465	118402	0	123957
12056	2022	1372	1190	119787	0	124371
12057	1486	1251	115618	5903	0	124258
12058	1838	987	4230	116336	0	123391
12059	1482	896	116768	5657	0	124803
12060	115666	842	4690	3304	0	124502
12061	120852	818	2146	2477	0	126293
12062	5713	902	119947	1952	0	128514
12063	119620	934	4489	2030	0	127073
12064	123731	809	2206	1940	0	128686
12065	125554	731	1623	1845	0	129753
12066	6628	718	1543	120786	0	129675
12067	3371	925	122408	4732	0	131436
12068	2425	123136	4400	2636	0	132597
12069	2459	4002	2021	123100	0	131582
12070	1855	1737	125334	4943	0	133869
12071	1761	1314	120170	2601	0	125846
12072	116895	1075	5118	2436	0	125524
12073	4231	125159	2622	2011	0	134023
12074	127026	3891	1924	2209	0	135050
12075	128979	1682	1585	2050	0	134296
12076	5337	128232	1587	1670	0	136826
12077	128281	3916	1536	1747	0	135480
12078	5334	1817	131770	1417	0	140338
12079	3089	1211	130526	1302	0	136128
12080	2516	1115	131127	1275	0	136033
12081	2039	127347	5326	1240	0	135952
12082	123458	3531	3253	1242	0	131484
12083	125121	1561	1916	1391	0	129989
12084	4896	121032	1738	1118	0	128784
12085	2654	127252	1628	1108	0	132642
12086	2272	4161	1423	124827	0	132683
12087	1862	2179	1302	127418	0	132761
12088	126415	1611	1125	4655	0	133806
12089	4123	128165	1178	2214	0	135680
12090	126565	3656	1127	1855	0	133203
12091	124569	1722	1092	1608	0	128991
12092	4854	1434	123054	1023	0	130365
12093	2797	121072	3445	1014	0	128328
12094	2724	3609	1906	120343	0	128582
12095	119448	1587	1333	3194	0	125562
12096	4438	1167	1148	116999	0	123752
12097	112042	884	1042	3095	0	117063
12098	3559	878	109851	1318	0	115606
12099	2091	106870	2819	1174	0	112954
12100	1588	111284	1483	1001	0	115356
12101	1726	3441	1296	105149	0	111612
12102	1424	111454	928	2107	0	115913
12103	110519	2782	890	1504	0	115695
12104	2658	1609	108352	942	0	113561
12105	102654	1173	2207	1205	0	107239
12106	2847	1034	111113	790	0	115784
12107	1958	828	2358	109551	0	114695
12108	1752	785	1232	110547	0	114316
12109	1655	706	1001	112252	0	115614
12110	111175	655	821	3172	0	115823
12111	2799	563	112673	1538	0	117573
12112	1888	526	2106	111713	0	116233
12113	1510	720	1105	112301	0	115636
12114	1187	109631	818	2598	0	114234
12115	1074	109567	665	1546	0	112852
12116	1133	113354	642	1135	0	116264
12117	998	2173	542	108043	0	111756
12118	841	858	358	104161	0	106218
12119	256	100722	245	936	0	102159
12120	268	101660	219	474	0	102621
12121	101258	629	369	829	0	103085
12122	784	395	165	101660	0	103004
12123	209	100661	117	447	0	101434
12124	102199	359	131	625	0	103314
12125	633	196	90	104242	0	105161
12126	114160	94	73	924	0	115251
12127	1213	110	88	117212	0	118623
12128	332	196	122367	990	0	123885
12129	210	123500	926	331	0	124967
12130	119808	938	239	872	0	121857
12131	1059	318	125094	143	0	126614
12132	282	126049	944	158	0	127433
12133	470	925	224	127105	0	128724
12134	332	212	147	128439	0	129130
12135	442	179	71	124095	0	124787
12136	596	86	64	121486	0	122232
12137	122	141	127309	1083	0	128655
12138	56	126151	907	411	0	127525
12139	340	867	184	126772	0	128163
12140	123873	194	139	1535	0	125741
12141	777	126453	132	418	0	127780
12142	498	897	66	132553	0	134014
12143	267	351	131696	1236	0	133550
12144	105	132036	1354	453	0	133948
12145	832	1453	370	122338	0	124993
12146	108	136163	303	884	0	137458
12147	136010	1625	79	890	0	138604
12148	135840	450	63	917	0	137270
12149	1933	359	133019	204	0	135515
12150	129688	166	1512	756	0	132122
12151	134487	138	422	788	0	135835
12152	2039	244	131939	138	0	134360
12153	731	132571	1606	178	0	135086
12154	1063	1542	410	130801	0	133816
12155	693	454	294	136753	0	138194
12156	135277	286	178	2590	0	138331
12157	2073	142	144	135697	0	138056
12158	598	233	136064	1927	0	138822
12159	126608	197	1718	1204	0	129727
12160	1942	293	132212	432	0	134879
12161	609	132846	1954	318	0	135727
12162	128011	1751	588	761	0	131111
12163	1953	610	130676	247	0	133486
12164	822	460	125500	247	0	127029
12165	479	129191	2079	258	0	132007
12166	658	1800	761	130546	0	133765
12167	286	681	128664	1781	0	131412
12168	1167	431	2014	113358	0	116970
12169	695	190	593	126178	0	127656
12170	283	197	124459	2258	0	127197
12171	226	123273	2002	895	0	126396
12172	570	1772	654	124360	0	127356
12173	121162	545	511	2391	0	124609
12174	120122	422	345	1073	0	121962
12175	2494	286	218	120385	0	123383
12176	858	287	118921	1990	0	122056
12177	591	353	121871	660	0	123475
12178	606	240	2410	120174	0	123430
12179	336	289	119867	2157	0	122649
12180	115885	212	2363	1074	0	119534
12181	2611	176	737	121282	0	124806
12182	1077	177	557	122905	0	124716
12183	542	122660	507	2659	0	126368
12184	672	2184	359	124927	0	128142
12185	330	714	120978	2696	0	124718
12186	113526	452	2374	1380	0	117732
12187	119862	234	722	1287	0	122105
12188	2911	267	120736	600	0	124514
12189	1441	220	2423	126094	0	130178
12190	976	226	822	131097	0	133121
12191	462	256	130334	3939	0	134991
12192	923	214	3366	130660	0	135163
12193	1304	221	1188	130207	0	132920
12194	461	136784	842	4311	0	142398
12195	933	3486	515	142280	0	147214
12196	892	961	407	146648	0	148908
12197	145418	592	477	5975	0	152462
12198	149990	342	518	2640	0	153490
12199	153555	258	463	1855	0	156131
12200	152672	295	470	1383	0	154820
12201	152095	277	422	1286	0	154080
12202	6368	364	144493	872	0	152097
12203	3131	250	4398	142779	0	150558
12204	2081	258	1450	148490	0	152279
12205	1092	338	145778	5750	0	152958
12206	136997	304	4679	2825	0	144805
12207	144422	293	1547	1892	0	148154
12208	5941	471	134184	1159	0	141755
12209	140872	242	4311	1545	0	146970
12210	146724	205	1525	1348	0	149802
12211	6412	349	142191	849	0	149801
12212	3482	276	4817	135333	0	143908
12213	1960	143626	1831	4396	0	151813
12214	1935	4471	1214	149723	0	157343
12215	1849	1342	823	152700	0	156714
12216	1840	749	751	150869	0	154209
12217	1019	509	146562	6900	0	154990
12218	141211	277	5024	3311	0	149823
12219	148785	301	1857	2114	0	153057
12220	6931	248	1209	144866	0	153254
12221	2679	315	142651	5527	0	151172
12222	2343	387	5137	141008	0	148875
12223	1235	290	145230	5957	0	152712
12224	1207	304	147220	2394	0	151125
12225	941	144633	6329	1705	0	153608
12226	1857	4003	2312	134995	0	143167
12227	133423	1244	1541	5120	0	141328
12228	129251	704	863	2465	0	133283
12229	132698	357	848	1863	0	135766
12230	6587	308	797	126620	0	134312
12231	2584	133231	813	4811	0	141439
12232	2239	4286	654	135709	0	142888
12233	1285	1388	140611	5666	0	148950
12234	147975	850	4941	2786	0	156552
12235	160661	454	1776	2137	0	165028
12236	7634	348	1295	157049	0	166326
12237	3700	404	920	160769	0	165793
12238	2791	337	853	163635	0	167616
12239	1607	409	156724	7929	0	166669
12240	143411	299	5672	4161	0	153543
12241	6284	150983	2184	2468	0	161919
12242	2255	152435	1497	1751	0	157938
12243	1779	5482	150388	1407	0	159056
12244	2211	2105	5317	146064	0	155697
12245	1242	1232	150298	5792	0	158564
12246	143016	893	5755	2613	0	152277
12247	6314	664	2065	144814	0	153857
12248	2540	523	145224	5614	0	153901
12249	1974	149158	5274	2457	0	158863
12250	147972	4620	1924	2575	0	157091
12251	5842	1504	152354	1673	0	161373
12252	2349	146298	5612	1625	0	155884
12253	1740	155343	2287	1444	0	160814
12254	153256	5837	1641	1633	0	162367
12255	6407	2214	1277	152328	0	162226
12256	2439	1458	157928	5794	0	167619
12257	1826	158117	5774	2529	0	168246
12258	158230	5269	2195	2362	0	168056
12259	161208	1801	1650	2058	0	166717
12260	6879	159313	1445	1477	0	169114
12261	2886	5668	162712	1529	0	172795
12262	2725	2050	5872	162723	0	173370
12263	163722	1591	2279	6286	0	173878
12264	167222	1057	1749	2811	0	172839
12265	7591	952	163334	1797	0	173674
12266	4148	1021	5801	159264	0	170234
12267	3167	975	2300	166969	0	173411
12268	2162	950	165673	7056	0	175841
12269	2046	1003	164199	3042	0	170290
12270	163493	890	7262	2644	0	174289
12271	170218	1037	3091	2133	0	176479
12272	171929	1037	2108	2018	0	177092
12273	173440	833	1759	1976	0	178008
12274	8429	1003	164587	1638	0	175657
12275	166686	768	6101	1873	0	175428
12276	8390	719	2484	164845	0	176438
12277	3746	794	168728	6290	0	179558
12278	2929	839	169836	2954	0	176558
12279	2266	167582	7157	2500	0	179505
12280	2389	5073	3265	164164	0	174891
12281	1991	1995	168236	5882	0	178104
12282	161408	1571	6200	2948	0	172127
12283	6597	1420	3072	149365	0	160454
12284	3087	166811	2472	4726	0	177096
12285	169078	4961	1938	2972	0	178949
12286	172061	1711	1993	2492	0	178257
12287	7534	1349	168541	1742	0	179166
12288	3700	165989	6078	1773	0	177540
12289	3013	4273	2523	159872	0	169681
12290	159723	1898	1975	5009	0	168605
12291	6091	1545	1829	158081	0	167546
12292	2771	1206	154530	4756	0	163263
12293	137420	1116	4348	2626	0	145510
12294	4761	147020	2171	1839	0	155791
12295	2259	138188	1649	1535	0	143631
12296	1929	148444	1593	1392	0	153358
12297	145070	3848	2534	1734	0	153186
12298	143748	1796	1487	1291	0	148322
12299	145009	1235	1183	1093	0	148520
12300	4997	1004	1057	141853	0	148911
12301	2433	999	143560	3266	0	150258
12302	2214	890	3424	143953	0	150481
12303	145804	729	1541	4116	0	152190
12304	4493	713	1248	146402	0	152856
12305	150457	683	1153	4200	0	156493
12306	150761	718	1321	2176	0	154976
12307	148533	722	1278	2021	0	152554
12308	4349	149041	1281	1406	0	156077
12309	149021	3136	1284	1372	0	154813
12310	4536	1328	146554	931	0	153349
12311	2812	994	147784	795	0	152385
12312	2352	145997	3698	786	0	152833
12313	2612	2850	1834	140655	0	147951
12314	140753	1019	1215	3215	0	146202
12315	3830	878	139016	1208	0	144932
12316	135346	599	3129	1379	0	140453
12317	4024	603	1493	136318	0	142438
12318	1864	139203	1408	2901	0	145376
12319	1885	2636	1267	142856	0	148644
12320	1670	1202	142221	3042	0	148135
12321	133436	871	3122	1962	0	139391
12322	3676	842	143603	1174	0	149295
12323	2114	771	137561	903	0	141349
12324	132467	607	3222	1327	0	137623
12325	3424	135637	1666	835	0	141562
12326	139284	2694	1241	1115	0	144334
12327	140569	1013	1007	1309	0	143898
12328	4202	846	136625	764	0	142437
12329	131276	685	3120	1305	0	136386
12330	3599	643	133788	1003	0	139033
12331	1797	493	126541	940	0	129771
12332	1663	533	127459	907	0	130562
12333	1154	121540	2871	693	0	126258
12334	109420	2105	3239	1006	0	115770
12335	107873	544	691	756	0	109864
12336	107959	263	365	709	0	109296
12337	107751	207	388	690	0	109036
12338	1984	237	107751	187	0	110159
12339	1296	202	1330	106200	0	109028
12340	1018	202	555	107785	0	109560
12341	109060	174	453	1893	0	111580
12342	1530	108485	452	610	0	111077
12343	880	1138	380	108577	0	110975
12344	107519	386	398	1745	0	110048
12345	1549	341	108912	450	0	111252
12346	1151	288	1310	106319	0	109068
12347	623	358	110445	1292	0	112718
12348	561	108754	1461	563	0	111339
12349	830	1345	619	104656	0	107450
12350	104186	418	447	1578	0	106629
12351	1582	277	334	106085	0	108278
12352	664	312	106810	1524	0	109310
12353	451	106901	1481	615	0	109448
12354	104322	1346	521	883	0	107072
12355	1636	498	105565	261	0	107960
12356	99222	290	1506	709	0	101727
12357	1686	105283	617	297	0	107883
12358	106419	1440	459	619	0	108937
12359	107351	514	252	601	0	108718
12360	2497	283	217	107356	0	110353
12361	956	264	105726	1717	0	108663
12362	548	106317	1784	693	0	109342
12363	736	1682	669	109939	0	113026
12364	800	616	382	111320	0	113118
12365	884	315	317	118198	0	119714
12366	898	283	301	122057	0	123539
12367	427	136127	400	3411	0	140365
12368	141446	3127	294	1805	0	146672
12369	3505	142782	395	698	0	147380
12370	2038	3692	285	147031	0	153046
12371	149816	1172	313	4310	0	155611
12372	4920	736	270	149677	0	155603
12373	1761	563	149562	4418	0	156304
12374	1029	148996	3816	1835	0	155676
12375	1593	3875	1265	147974	0	154707
12376	1426	1468	751	153300	0	156945
12377	144644	952	431	5693	0	151720
12378	4285	762	143076	2273	0	150396
12379	139961	559	3817	2170	0	146507
12380	143362	500	1394	1889	0	147145
12381	144167	601	804	1702	0	147274
12382	5922	811	140336	1020	0	148089
12383	3471	760	4057	136472	0	144760
12384	2464	758	1486	140204	0	144912
12385	1371	725	140081	5711	0	147888
12386	1188	717	141856	2763	0	146524
12387	140025	544	5343	2261	0	148173
12388	5617	600	2250	143039	0	151506
12389	145102	613	1334	5694	0	152743
12390	149564	591	970	3062	0	154187
12391	7088	545	825	146892	0	155350
12392	3091	568	152918	5620	0	162197
12393	149785	506	5097	3192	0	158580
12394	6789	498	2058	155022	0	164367
12395	3128	650	155290	5874	0	164942
12396	2375	152473	5306	2956	0	163110
12397	150929	4921	2350	2833	0	161033
12398	6013	154438	1675	1981	0	164107
12399	4400	5755	1269	139696	0	151120
12400	2651	155974	1390	5343	0	165358
12401	150214	5814	1421	3637	0	161086
12402	154021	2236	1421	3284	0	160962
12403	7535	151700	1434	2695	0	163364
12404	152107	5278	1437	2965	0	161787
12405	151196	2419	1470	2984	0	158069
12406	7852	146894	1529	2544	0	158819
12407	148943	5359	1361	2974	0	158637
12408	8418	2142	1500	145527	0	157587
12409	5251	1502	1658	149586	0	157997
12410	148079	1253	1565	7515	0	158412
12411	8410	1156	1465	137344	0	148375
12412	4757	141061	1467	6130	0	153415
12413	140700	5388	1631	3795	0	151514
12414	141162	2468	1644	3435	0	148709
12415	7586	141324	1659	2825	0	153394
12416	142666	5622	1718	2929	0	152935
12417	145804	2560	1804	2439	0	152607
12418	9470	1780	1537	139011	0	151798
12419	5425	1647	137954	6461	0	151487
12420	4612	137602	5248	3553	0	151015
12421	140818	5587	2162	3214	0	151781
12422	142886	2618	1591	3086	0	150181
12423	9106	2048	135394	2702	0	149250
12424	138190	1565	5559	3091	0	148405
12425	8521	1802	132588	2598	0	145509
12426	135549	1866	5828	2763	0	146006
12427	8598	2153	2612	133803	0	147166
12428	5084	2376	132420	6137	0	146017
12429	4346	2535	134571	3199	0	144651
12430	4360	2706	6392	130771	0	144229
12431	4324	2444	2664	133540	0	142972
12432	4222	2161	127372	7304	0	141059
12433	4827	1975	5525	127637	0	139964
12434	4364	2234	128278	6632	0	141508
12435	4737	2175	6032	126886	0	139830
12436	5079	2169	2765	126365	0	136378
12437	4712	120643	2144	7262	0	134761
12438	4526	121092	1921	4398	0	131937
12439	4055	128541	1997	3839	0	138432
12440	4398	6561	1822	126543	0	139324
12441	4337	2998	1830	131083	0	140248
12442	3717	2273	124115	8613	0	138718
12443	121262	2034	6047	5044	0	134387
12444	128157	1984	2970	3977	0	137088
12445	9122	122665	2364	3279	0	137430
12446	125038	5807	2037	3059	0	135941
12447	9017	2872	2061	121581	0	135531
12448	124512	2092	2308	7101	0	136013
12449	128084	1683	2241	4255	0	136263
12450	9439	1891	2186	122211	0	135727
12451	117197	2006	2183	6806	0	128192
12452	7578	112900	2255	3734	0	126467
12453	5013	117043	2023	2891	0	126970
12454	4626	6357	2256	108287	0	121526
12455	4081	115649	2350	5496	0	127576
12456	4290	5562	2133	110683	0	122668
12457	4389	2634	1889	114802	0	123714
12458	110774	1806	1939	7016	0	121535
12459	6806	107934	2066	4104	0	120910
12460	106634	4715	2065	3484	0	116898
12461	105784	2296	2000	3446	0	113526
12462	6676	104426	1899	3415	0	116416
12463	102846	4505	1684	3332	0	112367
12464	6206	2206	98753	3109	0	110274
12465	3149	92471	4186	2752	0	102558
12466	87357	3532	1848	2662	0	95399
12467	3861	1396	74990	1638	0	81885
12468	1767	65280	2388	1288	0	70723
12469	1610	68107	1501	1231	0	72449
12470	61216	2203	1540	925	0	65884
12471	60414	1042	471	784	0	62711
12472	60490	759	421	752	0	62422
12473	2804	59112	434	679	0	63029
12474	1668	1719	421	60352	0	64160
12475	60460	836	491	2087	0	63874
12476	61451	724	497	1055	0	63727
12477	2694	601	488	60055	0	63838
12478	1460	596	60522	1895	0	64473
12479	1157	658	60643	893	0	63351
12480	1243	490	2064	60784	0	64581
12481	1173	423	1016	62305	0	64917
12482	984	457	62134	2214	0	65789
12483	1130	390	1850	59843	0	63213
12484	835	61067	961	2129	0	64992
12485	60139	1583	780	1071	0	63573
12486	2196	678	596	59007	0	62477
12487	56666	421	495	1863	0	59445
12488	1668	57381	589	1032	0	60670
12489	817	58946	498	874	0	61135
12490	57485	1245	499	912	0	60141
12491	1391	517	56319	698	0	58925
12492	46713	456	972	562	0	48703
12493	901	48652	540	405	0	50498
12494	436	488	288	45316	0	46528
12495	44888	190	122	759	0	45959
12496	605	144	130	44645	0	45524
12497	45948	98	120	841	0	47007
12498	45160	103	129	477	0	45869
12499	635	47798	124	255	0	48812
12500	46727	378	61	334	0	47500
12501	445	46151	70	157	0	46823
12502	46717	403	89	220	0	47429
12503	545	174	44	46805	0	47568
12504	47758	110	66	554	0	48488
12505	522	101	46	48765	0	49434
12506	50792	88	41	660	0	51581
12507	51784	105	36	402	0	52327
12508	52355	88	28	346	0	52817
12509	52673	73	30	256	0	53032
12510	53100	59	38	268	0	53465
12511	671	76	37	53973	0	54757
12512	53085	65	41	611	0	53802
12513	538	52135	56	221	0	52950
12514	282	442	52101	104	0	52929
12515	301	167	384	52089	0	52941
12516	182	127	54068	455	0	54832
12517	295	80	403	56020	0	56798
12518	164	103	57290	617	0	58174
12519	55717	56	534	404	0	56711
12520	724	65	163	58198	0	59150
12521	237	92	57641	522	0	58492
12522	233	105	59259	190	0	59787
12523	283	175	637	60613	0	61708
12524	68005	45	284	890	0	69224
12525	704	72604	140	351	0	73799
12526	73167	768	81	465	0	74481
12527	73774	309	60	354	0	74497
12528	1082	74078	100	118	0	75378
12529	78011	790	46	453	0	79300
12530	1115	345	58	78477	0	79995
12531	644	175	47	78657	0	79523
12532	446	98	51	79577	0	80172
12533	79026	71	50	1483	0	80630
12534	881	80307	96	582	0	81866
12535	570	913	48	81752	0	83283
12536	425	369	64	83021	0	83879
12537	82249	200	43	1630	0	84122
12538	1274	136	43	81851	0	83304
12539	530	189	84309	1161	0	86189
12540	291	88358	1129	557	0	90335
12541	89902	1246	422	547	0	92117
12542	1660	589	229	87871	0	90349
12543	668	91747	163	1235	0	93813
12544	91500	1404	82	929	0	93915
12545	1629	656	90611	393	0	93289
12546	717	91576	1319	312	0	93924
12547	92955	1448	547	474	0	95424
12548	1826	657	286	91881	0	94650
12549	1019	353	201	92614	0	94187
12550	476	295	92270	1982	0	95023
12551	731	196	1348	90462	0	92737
12552	313	195	98544	1869	0	100921
12553	326	276	92728	914	0	94244
12554	307	263	98384	497	0	99451
12555	97647	213	2156	718	0	100734
12556	100416	159	974	667	0	102216
12557	102869	175	560	548	0	104152
12558	2432	150	339	100154	0	103075
12559	1129	100583	305	1403	0	103420
12560	698	103700	260	714	0	105372
12561	104355	1795	191	961	0	107302
12562	104222	851	223	989	0	106285
12563	1856	106071	274	429	0	108630
12564	105488	1450	230	654	0	107822
12565	1826	737	103130	235	0	105928
12566	991	494	102756	223	0	104464
12567	1061	318	1904	97186	0	100469
12568	765	194	918	105448	0	107325
12569	443	228	105600	1846	0	108117
12570	724	163	1568	102308	0	104763
12571	104335	171	749	2210	0	107465
12572	1568	228	104212	905	0	106913
12573	100794	224	1577	832	0	103427
12574	2113	200	720	105836	0	108869
12575	1041	205	109499	1566	0	112311
12576	653	110532	1678	814	0	113677
12577	111180	1453	792	990	0	114415
12578	1733	715	109573	429	0	112450
12579	107479	418	1740	603	0	110240
12580	2039	299	843	109456	0	112637
12581	109991	185	552	1894	0	112622
12582	2041	268	116597	835	0	119741
12583	1343	186	1682	117388	0	120599
12584	122366	164	818	2295	0	125643
12585	125076	213	541	1384	0	127214
12586	129344	196	439	1066	0	131045
12587	130964	197	337	837	0	132335
12588	3087	209	321	125935	0	129552
12589	1693	209	331	125999	0	128232
12590	1006	268	125707	2487	0	129468
12591	1064	224	1899	124414	0	127601
12592	1219	192	882	121645	0	123938
12593	587	128673	625	2658	0	132543
12594	130325	2002	419	1669	0	134415
12595	133211	742	374	1286	0	135613
12596	3014	136952	425	773	0	141164
12597	1736	2431	347	135969	0	140483
12598	1366	841	291	138940	0	141438
12599	133829	488	329	3683	0	138329
12600	3040	401	139771	1433	0	144645
12601	1724	257	2523	141259	0	145763
12602	890	319	143951	3039	0	148199
12603	138685	261	2914	1819	0	143679
12604	144459	225	1160	1334	0	147178
12605	146294	237	726	1149	0	148406
12606	4123	285	483	141574	0	146465
12607	2148	256	359	142505	0	145268
12608	142226	247	371	3826	0	146670
12609	3244	381	139929	1524	0	145078
12610	1758	271	2506	140431	0	144966
12611	141409	202	977	3463	0	146051
12612	3323	207	723	141914	0	146167
12613	1533	268	148274	3120	0	153195
12614	1218	284	142767	1464	0	145733
12615	141534	228	3197	1652	0	146611
12616	2890	148282	1400	898	0	153470
12617	151199	2232	792	1299	0	155522
12618	154316	752	534	1212	0	156814
12619	3830	472	473	153911	0	158686
12620	1985	401	423	153080	0	155889
12621	1182	153586	508	3276	0	158552
12622	151917	2290	409	1969	0	156585
12623	2847	154225	488	1089	0	158649
12624	1245	153195	402	823	0	155665
12625	1203	2464	286	148660	0	152613
12626	148482	844	352	2820	0	152498
12627	151377	486	397	1463	0	153723
12628	3228	332	371	149066	0	152997
12629	1695	333	274	146430	0	148732
12630	1414	306	231	147011	0	148962
12631	144817	204	269	3607	0	148897
12632	2690	324	144827	1483	0	149324
12633	1286	144822	2128	1188	0	149424
12634	144225	1885	703	1416	0	148229
12635	2829	813	535	143780	0	147957
12636	1293	531	144317	2392	0	148533
12637	1113	455	142404	1176	0	145148
12638	755	143557	2561	1035	0	147908
12639	702	147040	976	807	0	149525
12640	1247	2093	943	139796	0	144079
12641	886	127478	565	1827	0	130756
12642	979	1667	288	136931	0	139865
12643	766	569	269	140913	0	142517
12644	140983	369	244	2761	0	144357
12645	2069	345	305	140872	0	143591
12646	1048	312	287	142407	0	144054
12647	752	417	140545	2235	0	143949
12648	886	335	1625	141516	0	144362
12649	142082	299	608	2782	0	145771
12650	143147	273	457	1510	0	145387
12651	2404	147917	414	807	0	151542
12652	143145	2008	324	1254	0	146731
12653	2732	779	142418	720	0	146649
12654	1084	143706	2167	855	0	147812
12655	1149	2310	631	145530	0	149620
12656	1026	738	444	148930	0	151138
12657	1021	582	366	150065	0	152034
12658	148022	403	373	3884	0	152682
12659	140805	403	518	2117	0	143843
12660	3000	501	144667	923	0	149091
12661	1321	485	141654	926	0	144386
12662	1063	475	144064	882	0	146484
12663	933	144081	2931	836	0	148781
12664	885	148301	958	899	0	151043
12665	146275	2837	516	1443	0	151071
12666	147485	914	477	1367	0	150243
12667	3382	578	483	148835	0	153278
12668	1596	425	516	146686	0	149223
12669	882	149150	588	3268	0	153888
12670	1019	2550	441	152452	0	156462
12671	870	954	151658	3145	0	156627
12672	807	152242	2724	1372	0	157145
12673	1078	2595	902	153587	0	158162
12674	794	985	157498	2952	0	162229
12675	1270	777	2644	146010	0	150701
12676	686	153561	901	3035	0	158183
12677	156610	2877	544	1952	0	161983
12678	156651	997	417	1744	0	159809
12679	162325	689	430	1589	0	165033
12680	4388	576	433	161358	0	166755
12681	1965	526	380	166252	0	169123
12682	160524	632	357	4861	0	166374
12683	3718	161572	513	1606	0	167409
12684	161570	3356	426	1808	0	167160
12685	4013	1148	168903	812	0	174876
12686	167358	607	3880	1443	0	173288
12687	174010	457	1295	1476	0	177238
12688	6028	490	607	170816	0	177941
12689	174622	431	425	5042	0	180520
12690	179451	483	470	2400	0	182804
12691	6452	491	488	177115	0	184546
12692	2249	491	175778	4495	0	183013
12693	165248	396	4153	2669	0	172466
12694	4662	511	176630	1030	0	182833
12695	1801	178929	4223	831	0	185784
12696	1684	3769	1677	177227	0	184357
12697	1388	1294	657	184607	0	187946
12698	194562	541	429	5883	0	201415
12699	4667	538	196825	1891	0	203921
12700	2381	568	4352	182381	0	189682
12701	1041	190823	1567	4305	0	197736
12702	694	193891	852	1706	0	197143
12703	1472	5387	511	192661	0	200031
12704	823	1806	191906	4822	0	199357
12705	1511	851	4490	191071	0	197923
12706	1517	612	1640	191386	0	195155
12707	790	738	188360	5753	0	195641
12708	651	192304	4511	2203	0	199669
12709	184271	4791	1508	2085	0	192655
12710	4519	192583	903	1268	0	199273
12711	2438	4754	611	190785	0	198588
12712	182478	1662	584	5878	0	190602
12713	4526	182827	908	2086	0	190347
12714	1782	4750	182405	1260	0	190197
12715	175027	1837	4561	1820	0	183245
12716	4737	185661	1737	1002	0	193137
12717	183576	4769	856	1723	0	190924
12718	5460	1859	177376	881	0	185576
12719	175406	912	4710	1511	0	182539
12720	5796	714	1675	176456	0	184641
12721	2235	816	172352	10140	0	185543
12722	1920	933	4636	169408	0	176897
12723	1332	170884	1729	5028	0	178973
12724	1707	4709	980	173385	0	180781
12725	1644	1716	725	176181	0	180266
12726	1345	1083	169562	6357	0	178347
12727	1746	933	4728	169429	0	176836
12728	1268	1279	148486	6022	0	157055
12729	1353	170043	4215	2494	0	178105
12730	1709	5118	1533	168888	0	177248
12731	1452	1971	170982	5399	0	179804
12732	1241	168334	5295	2437	0	177307
12733	1372	177255	2038	1659	0	182324
12734	1506	6130	173256	1478	0	182370
12735	1406	2246	173874	1358	0	178884
12736	1879	1202	6250	169097	0	178428
12737	167246	1049	2238	6121	0	176654
12738	5451	168352	1315	2762	0	177880
12739	2953	5206	1032	165192	0	174383
12740	165158	1933	1161	6063	0	174315
12741	5797	167207	1082	2782	0	176868
12742	164378	5268	1145	2333	0	173124
12743	5995	169358	1120	1633	0	178106
12744	169272	5608	1012	2075	0	177967
12745	168730	2326	1159	2130	0	174345
12746	172341	1557	1027	2073	0	176998
12747	7505	176302	1172	1834	0	186813
12748	3956	5695	1141	176407	0	187199
12749	2437	2243	174076	6140	0	184896
12750	2066	173505	5747	3270	0	184588
12751	2973	5866	2284	167022	0	178145
12752	2838	2525	1484	170546	0	177393
12753	1997	1755	164101	6900	0	174753
12754	1962	161032	5566	3157	0	171717
12755	157876	5398	2423	2584	0	168281
12756	6013	159325	1431	1992	0	168761
12757	3205	5571	1154	157561	0	167491
12758	1984	2308	157875	5981	0	168148
12759	152274	1585	5472	2976	0	162307
12760	6260	1515	2117	158770	0	168662
12761	2217	1579	156999	6057	0	166852
12762	146603	1477	5513	3321	0	156914
12763	5247	152751	2551	2246	0	162795
12764	152972	5593	1886	2280	0	162731
12765	155107	2595	1177	2517	0	161396
12766	6610	1669	1220	153103	0	162602
12767	2717	1540	151906	5928	0	162091
12768	1929	151211	5438	2644	0	161222
12769	1454	5569	150110	2016	0	159149
12770	1844	2942	5257	144264	0	154307
12771	1672	2251	2327	151279	0	157529
12772	145413	1630	1670	7056	0	155769
12773	5227	1402	144632	3220	0	154481
12774	2219	139952	5349	2144	0	149664
12775	2021	5088	2234	138459	0	147802
12776	2069	2221	1448	142374	0	148112
12777	135951	1833	1317	6178	0	145279
12778	5233	138043	1041	2619	0	146936
12779	2970	4631	959	131676	0	140236
12780	125648	2308	905	5620	0	134481
12781	4142	127789	1079	2462	0	135472
12782	122750	4281	835	1736	0	129602
12783	122986	1912	1000	1460	0	127358
12784	4952	119491	1066	1401	0	126910
12785	103717	3011	584	1213	0	108525
12786	3437	104930	680	830	0	109877
12787	103410	3071	674	959	0	108114
12788	103049	1150	683	1064	0	105946
12789	3531	101398	531	958	0	106418
12790	95153	2637	441	1058	0	99289
12791	97855	944	411	923	0	100133
12792	97858	912	415	956	0	100141
12793	3401	780	94263	754	0	99198
12794	1501	633	87863	707	0	90704
12795	977	695	87400	527	0	89599
12796	84791	678	3196	725	0	89390
12797	2642	521	83417	502	0	87082
12798	1034	493	70346	316	0	72189
12799	1002	628	2284	62897	0	66811
12800	64184	324	930	1757	0	67195
12801	1851	340	64320	579	0	67090
12802	945	329	67039	445	0	68758
12803	898	310	2064	65155	0	68427
12804	791	318	858	66730	0	68697
12805	734	277	500	67568	0	69079
12806	684	295	66176	2088	0	69243
12807	702	290	1816	65581	0	68389
12808	64961	288	868	2128	0	68245
12809	1816	66044	535	939	0	69334
12810	1028	1676	407	66150	0	69261
12811	876	615	391	67910	0	69792
12812	576	518	68495	2098	0	71687
12813	547	67132	1808	997	0	70484
12814	66600	1802	708	812	0	69922
12815	1922	67827	579	564	0	70892
12816	999	1872	469	67520	0	70860
12817	667	739	67764	2005	0	71175
12818	834	481	2005	69833	0	73153
12819	718	517	812	72144	0	74191
12820	72671	337	673	2632	0	76313
12821	2321	419	563	69836	0	73139
12822	909	70205	544	2487	0	74145
12823	693	75413	644	993	0	77743
12824	629	2334	74909	847	0	78719
12825	74165	829	2208	962	0	78164
12826	2622	562	870	75302	0	79356
12827	1265	402	679	75963	0	78309
12828	1007	507	605	77102	0	79221
12829	76311	440	464	3127	0	80342
12830	2184	77825	620	1416	0	82045
12831	77024	1958	460	1165	0	80607
12832	2371	762	73390	851	0	77374
12833	1027	555	72975	777	0	75334
12834	74703	368	2465	945	0	78481
12835	2706	419	1193	75099	0	79417
12836	1144	487	739	77009	0	79379
12837	1020	369	627	77944	0	79960
12838	565	359	76908	2866	0	80698
12839	75401	323	2240	1526	0	79490
12840	77820	337	856	1237	0	80250
12841	76340	335	684	1139	0	78498
12842	3062	493	554	74355	0	78464
12843	1222	391	72923	2424	0	76960
12844	1024	389	71509	1138	0	74060
12845	911	403	74239	949	0	76502
12846	740	70967	2454	797	0	74958
12847	1139	1466	1284	62778	0	66667
12848	62324	497	600	1799	0	65220
12849	1459	343	62901	840	0	65543
12850	63597	250	1460	870	0	66177
12851	1761	223	676	64947	0	67607
12852	909	286	504	64684	0	66383
12853	628	63124	460	1886	0	66098
12854	540	64454	468	979	0	66441
12855	502	67405	493	748	0	69148
12856	652	1616	476	67521	0	70265
12857	66594	578	483	1878	0	69533
12858	67313	362	451	1090	0	69216
12859	1829	364	65794	733	0	68720
12860	64772	271	1435	845	0	67323
12861	1681	290	65926	669	0	68566
12862	983	241	1580	65779	0	68583
12863	677	276	66147	1570	0	68670
12864	65390	258	1655	922	0	68225
12865	1678	299	827	67595	0	70399
12866	790	310	70670	1634	0	73404
12867	633	319	66886	907	0	68745
12868	66707	258	1790	982	0	69737
12869	69871	277	845	890	0	71883
12870	1774	71774	596	673	0	74817
12871	966	1207	526	73406	0	76105
12872	676	570	73314	1531	0	76091
12873	652	438	72547	825	0	74462
12874	789	516	1680	73268	0	76253
12875	74197	316	969	1834	0	77316
12876	1433	73771	644	922	0	76770
12877	856	1240	495	75459	0	78050
12878	75621	555	451	1770	0	78397
12879	1647	385	439	76113	0	78584
12880	857	75991	493	1719	0	79060
12881	810	1192	480	77613	0	80095
12882	77098	517	521	1758	0	79894
12883	1705	375	495	77765	0	80340
12884	78588	299	490	1858	0	81235
12885	1555	81346	550	1070	0	84521
12886	81585	1236	555	1053	0	84429
12887	1699	520	80293	739	0	83251
12888	77322	393	1475	922	0	80112
12889	82324	378	791	879	0	84372
12890	1904	83699	605	722	0	86930
12891	1097	1331	540	82642	0	85610
12892	794	557	82083	1299	0	84733
12893	704	442	79308	823	0	81277
12894	76589	481	1582	1044	0	79696
12895	76655	308	732	923	0	78618
12896	1296	78082	492	670	0	80540
12897	812	79727	404	568	0	81511
12898	78729	1133	420	805	0	81087
12899	1314	78463	460	455	0	80692
12900	783	81326	463	417	0	82989
12901	810	1039	419	81357	0	83625
12902	671	462	354	79998	0	81485
12903	549	340	80979	1434	0	83302
12904	670	238	1024	79548	0	81480
12905	80203	255	559	1577	0	82594
12906	1255	285	80140	630	0	82310
12907	877	267	78897	499	0	80540
12908	1050	201	1230	77821	0	80302
12909	795	254	616	81412	0	83077
12910	649	260	493	81855	0	83257
12911	516	269	81008	1304	0	83097
12912	571	259	1107	76877	0	78814
12913	561	256	595	80796	0	82208
12914	79472	262	384	1261	0	81379
12915	908	79003	332	651	0	80894
12916	78500	681	291	665	0	80137
12917	1028	313	79424	357	0	81122
12918	70318	163	699	559	0	71739
12919	766	78586	351	267	0	79970
12920	74772	333	180	351	0	75636
12921	405	74957	143	170	0	75675
12922	71609	352	217	339	0	72517
12923	309	71101	79	143	0	71632
12924	165	71303	119	136	0	71723
12925	293	358	144	72212	0	73007
12926	72595	109	58	506	0	73268
12927	72144	72	27	350	0	72593
12928	72253	57	34	352	0	72696
12929	472	102	71059	55	0	71688
12930	273	121	70502	58	0	70954
12931	246	57	408	72575	0	73286
12932	93	73672	202	365	0	74332
12933	93	76208	108	164	0	76573
12934	175	499	48	74323	0	75045
12935	74024	192	41	648	0	74905
12936	73940	105	46	389	0	74480
12937	74461	61	46	371	0	74939
12938	649	108	74606	44	0	75407
12939	408	61	413	75497	0	76379
12940	178	91	77278	484	0	78031
12941	75521	63	500	449	0	76533
12942	77469	54	202	464	0	78189
12943	711	100	78734	63	0	79608
12944	483	59	530	77733	0	78805
12945	79591	53	200	889	0	80733
12946	705	65	114	81761	0	82645
12947	444	73	72	82151	0	82740
12948	555	109	94	84856	0	85614
12949	92257	47	76	1501	0	93881
12950	1442	70	80	98262	0	99854
12951	101033	49	59	2024	0	103165
12952	1826	109379	128	623	0	111956
12953	945	1758	66	112679	0	115448
12954	726	648	79	113779	0	115232
12955	526	355	84	113620	0	114585
12956	112164	154	74	3262	0	115654
12957	2332	118	85	111729	0	114264
12958	1187	104	72	113154	0	114517
12959	113339	75	71	3207	0	116692
12960	114167	92	78	1627	0	115964
12961	114265	74	88	1097	0	115524
12962	3233	132	109938	491	0	113794
12963	1505	187	106155	432	0	108279
12964	111594	97	2553	608	0	114852
12965	2698	140	1013	110843	0	114694
12966	1401	134	484	108820	0	110839
12967	111103	92	230	3283	0	114708
12968	108293	88	224	1817	0	110422
12969	108661	103	186	1281	0	110231
12970	3067	106826	202	781	0	110876
12971	107619	1866	158	781	0	110424
12972	105781	662	138	808	0	107389
12973	3063	105433	194	461	0	109151
12974	1500	108193	174	407	0	110274
12975	1271	2290	142	108726	0	112429
12976	110799	863	208	2387	0	114257
12977	111085	450	158	1300	0	112993
12978	111271	257	124	987	0	112639
12979	3574	208	96	108914	0	112792
12980	109610	170	98	2700	0	112578
12981	2980	222	107144	1096	0	111442
12982	105333	214	1926	1156	0	108629
12983	2977	257	108118	535	0	111887
12984	1517	281	105479	477	0	107754
12985	1300	236	2520	102608	0	106664
12986	104272	208	1113	2621	0	108214
12987	2592	244	560	104451	0	107847
12988	1292	250	104777	2804	0	109123
12989	1060	239	105127	1371	0	107797
12990	1121	149	2563	103617	0	107450
12991	103364	132	1131	2906	0	107533
12992	2537	105395	704	1326	0	109962
12993	1626	1885	439	107155	0	111105
12994	1471	757	439	109491	0	112158
12995	958	492	109236	3024	0	113710
12996	954	350	106449	1589	0	109342
12997	1001	221	2840	109075	0	113137
12998	109256	177	1305	3185	0	113923
12999	2831	212	109328	1624	0	113995
13000	1859	228	2247	107644	0	111978
13001	1536	240	1004	108739	0	111519
13002	1230	247	687	111510	0	113674
13003	107145	248	491	3992	0	111876
13004	2973	426	100327	1982	0	105708
13005	1662	106737	1862	1404	0	111665
13006	1481	2191	841	108491	0	113004
13007	1115	945	108321	2975	0	113356
13008	1079	105395	2420	1872	0	110766
13009	1211	110135	1144	1399	0	113889
13010	108538	2720	799	1474	0	113531
13011	3047	110110	600	1225	0	114982
13012	111055	2619	550	1439	0	115663
13013	3489	1178	109600	1073	0	115340
13014	2107	738	2515	111017	0	116377
13015	111265	472	1133	3627	0	116497
13016	3254	113132	918	1816	0	119120
13017	1952	2614	112322	1437	0	118325
13018	2092	1099	2717	101739	0	107647
13019	1428	112987	1290	2589	0	118294
13020	1565	2687	886	115494	0	120632
13021	113640	1181	776	3842	0	119439
13022	3287	118041	716	1851	0	123895
13023	119156	2915	658	1830	0	124559
13024	120918	1258	590	1515	0	124281
13025	4646	901	119461	1068	0	126076
13026	2498	125062	3203	1073	0	131836
13027	2135	3337	1420	130618	0	137510
13028	1552	1254	136866	3715	0	143387
13029	1593	889	148257	1610	0	152349
13030	1968	947	5108	150147	0	158170
13031	154693	466	2251	4964	0	162374
13032	155514	503	1348	2251	0	159616
13033	6567	498	942	154516	0	162523
13034	2646	624	155400	5146	0	163816
13035	1825	155607	4474	2245	0	164151
13036	157478	4264	1634	2181	0	165557
13037	160111	1466	1211	1812	0	164600
13038	5944	160103	1016	1131	0	168194
13039	161657	4612	893	1360	0	168522
13040	5709	1818	157088	844	0	165459
13041	156452	1110	4636	1274	0	163472
13042	152931	861	1891	1641	0	157324
13043	5904	820	157826	867	0	165417
13044	3477	625	4725	153978	0	162805
13045	2059	557	156220	4622	0	163458
13046	1531	150116	5056	2073	0	158776
13047	1300	154578	2215	1467	0	159560
13048	1928	5450	1338	142703	0	151419
13049	961	1542	145835	3685	0	152023
13050	653	134785	3603	1431	0	140472
13051	568	137224	1307	876	0	139975
13052	122539	3495	1119	1237	0	128390
13053	125791	1021	517	860	0	128189
13054	3677	654	422	125290	0	130043
13055	1685	489	400	123078	0	125652
13056	759	126646	455	3025	0	130885
13057	124717	2712	407	1600	0	129436
13058	126483	865	331	1372	0	129051
13059	3284	126402	385	679	0	130750
13060	1854	2794	284	127112	0	132044
13061	907	1022	127238	2776	0	131943
13062	1355	623	2647	126344	0	130969
13063	128006	542	886	3573	0	133007
13064	3444	542	562	128928	0	133476
13065	1685	425	458	132314	0	134882
13066	131392	404	486	4156	0	136438
13067	3571	393	398	127105	0	131467
13068	1243	129616	489	3208	0	134556
13069	1408	2769	416	131440	0	136033
13070	1335	930	375	133825	0	136465
13071	1156	685	405	129747	0	131993
13072	691	131056	518	3701	0	135966
13073	954	3059	390	130002	0	134405
13074	710	1153	128028	3562	0	133453
13075	1080	785	2898	126498	0	131261
13076	712	773	127014	3621	0	132120
13077	706	125537	3118	1587	0	130948
13078	1111	2935	1128	127830	0	133004
13079	1091	1051	771	129887	0	132800
13080	1182	747	669	130125	0	132723
13081	1151	691	657	129181	0	131680
13082	763	815	126328	4357	0	132263
13083	709	125055	3123	2068	0	130955
13084	1033	3147	1108	128318	0	133606
13085	847	1327	129280	3753	0	135207
13086	1228	892	3391	129460	0	134971
13087	129808	757	1400	4598	0	136563
13088	3624	863	125550	1900	0	131937
13089	125518	671	3280	1845	0	131314
13090	4354	685	1273	129255	0	135567
13091	1946	763	129230	3961	0	135900
13092	1471	126968	3556	2049	0	134044
13093	1589	3377	1387	126302	0	132655
13094	1344	1427	130002	4002	0	136775
13095	1220	128514	3780	1877	0	135391
13096	1437	3642	1459	129068	0	135606
13097	128408	1634	1146	4610	0	135798
13098	131882	1130	1128	2383	0	136523
13099	132919	989	1055	1958	0	136921
13100	4955	989	129900	1553	0	137397
13101	2402	131967	3758	1367	0	139494
13102	2085	3802	1506	131708	0	139101
13103	1791	1497	1150	139446	0	143884
13104	138777	1167	1074	5378	0	146396
13105	4137	142311	1022	2334	0	149804
13106	141601	4332	808	2388	0	149129
13107	140552	1755	862	2316	0	145485
13108	145336	1427	889	2090	0	149742
13109	5425	1311	141494	1543	0	149773
13110	142350	1095	4059	1830	0	149334
13111	5583	967	1392	143432	0	151374
13112	2857	939	1062	145051	0	149909
13113	142022	840	900	5924	0	149686
13114	5025	839	821	139336	0	146021
13115	2002	138978	778	5131	0	146889
13116	1963	3956	573	138311	0	144803
13117	134648	1457	568	5592	0	142265
13118	4327	1178	132896	2655	0	141056
13119	1790	132242	3589	2208	0	139829
13120	1892	3650	1211	131713	0	138466
13121	131056	1402	863	4907	0	138228
13122	4164	945	128690	2283	0	136082
13123	2451	2444	3659	125586	0	134140
13124	1638	812	126111	4499	0	133060
13125	1821	694	121844	2312	0	126671
13126	1375	598	117382	1693	0	121048
13127	1187	545	114553	1419	0	117704
13128	927	492	108816	1175	0	111410
13129	89093	1327	4205	1150	0	95775
13130	1787	91685	1145	629	0	95246
13131	87589	1306	613	741	0	90249
13132	87067	438	424	894	0	88823
13133	1762	86831	463	352	0	89408
13134	722	89183	425	330	0	90660
13135	88155	1508	409	771	0	90843
13136	88013	571	317	671	0	89572
13137	2027	415	299	84952	0	87693
13138	857	87240	351	1291	0	89739
13139	88114	1293	281	987	0	90675
13140	1528	87725	347	452	0	90052
13141	1043	1394	283	88221	0	90941
13142	88721	541	314	1781	0	91357
13143	88801	388	281	951	0	90421
13144	2025	334	287	88206	0	90852
13145	1156	299	267	89065	0	90787
13146	700	342	88244	1703	0	90989
13147	858	298	1342	86221	0	88719
13148	536	350	87976	1667	0	90529
13149	808	265	1453	83833	0	86359
13150	690	256	649	86477	0	88072
13151	85559	220	471	2171	0	88421
13152	85133	275	442	1242	0	87092
13153	1848	292	84336	655	0	87131
13154	82291	263	1440	763	0	84757
13155	1941	248	624	84071	0	86884
13156	911	277	85654	1574	0	88416
13157	984	244	1522	84587	0	87337
13158	903	266	624	91584	0	93377
13159	594	292	91351	2135	0	94372
13160	937	244	1746	92336	0	95263
13161	585	321	96613	2212	0	99731
13162	883	389	2052	100209	0	103533
13163	107126	219	900	2978	0	111223
13164	2593	110390	678	1304	0	114965
13165	111988	2464	531	1303	0	116286
13166	3104	115164	510	798	0	119576
13167	113056	2944	485	981	0	117466
13168	3241	114361	508	634	0	118744
13169	112215	3054	452	1133	0	116854
13170	3327	114202	493	655	0	118677
13171	2238	3183	364	113559	0	119344
13172	1318	1537	114187	2823	0	119865
13173	1088	1077	113491	1385	0	117041
13174	1462	753	3552	112635	0	118402
13175	112484	675	1666	3474	0	118299
13176	3288	114774	1061	1569	0	120692
13177	2199	3072	673	114563	0	120507
13178	1323	1590	115055	3282	0	121250
13179	1085	1142	116856	1738	0	120821
13180	1498	997	3986	108352	0	114833
13181	811	116607	2043	2944	0	122405
13182	115123	3060	1200	2107	0	121490
13183	3325	1582	118731	1223	0	124861
13184	1700	1094	116592	955	0	120341
13185	1039	117878	4066	960	0	123943
13186	116078	3044	2339	1378	0	122839
13187	118123	1492	1478	1037	0	122130
13188	4299	946	1032	116297	0	122574
13189	117968	712	912	3476	0	123068
13190	116528	711	874	2034	0	120147
13191	4153	116570	917	1196	0	122836
13192	116926	2882	970	1159	0	121937
13193	3882	1535	118736	691	0	124844
13194	2553	993	3081	114976	0	121603
13195	2037	801	1654	116016	0	120508
13196	114647	699	1062	4191	0	120599
13197	3385	114534	968	2001	0	120888
13198	113222	2880	775	1571	0	118448
13199	3625	116269	704	922	0	121520
13200	2086	117461	603	774	0	120924
13201	1735	3626	113884	743	0	119988
13202	1354	2106	110838	738	0	115036
13203	104228	1493	3263	1063	0	110047
13204	107419	904	1611	982	0	110916
13205	3538	818	104892	480	0	109728
13206	1942	99697	2327	498	0	104464
13207	1316	104014	1408	459	0	107197
13208	102067	3035	1040	812	0	106954
13209	102620	1637	684	804	0	105745
13210	3450	1144	640	102093	0	107327
13211	104862	848	611	2496	0	108817
13212	3227	716	626	103426	0	107995
13213	1803	741	103862	2441	0	108847
13214	1325	801	98987	1340	0	102453
13215	101356	681	3054	1205	0	106296
13216	2883	696	1722	100496	0	105797
13217	1796	108907	1080	1970	0	113753
13218	110914	2256	860	1709	0	115739
13219	111475	1287	867	1301	0	114930
13220	3460	993	111126	718	0	116297
13221	111394	782	2311	1093	0	115580
13222	116075	667	1470	869	0	119081
13223	3972	693	1074	112926	0	118665
13224	2384	111355	907	2422	0	117068
13225	1736	116072	808	1416	0	120032
13226	1700	3211	657	119421	0	124989
13227	1692	1812	688	116539	0	120731
13228	1593	1126	691	120038	0	123448
13229	1412	912	117648	3968	0	123940
13230	1502	964	113497	2125	0	118088
13231	1502	888	3512	113962	0	119864
13232	1387	861	116838	2896	0	121982
13233	1295	973	115378	1711	0	119357
13234	1417	799	3846	112206	0	118268
13235	1147	809	122348	3074	0	127378
13236	1131	120280	3569	1981	0	126961
13237	125616	2937	1993	1947	0	132493
13238	3472	1737	1419	123234	0	129862
13239	1888	124494	1132	3104	0	130618
13240	1357	3095	128242	1781	0	134475
13241	1451	1669	3598	127094	0	133812
13242	1026	1100	134439	3526	0	140091
13243	1417	819	4024	133655	0	139915
13244	1501	699	2178	139656	0	144034
13245	1161	806	143228	4777	0	149972
13246	1514	762	3935	138218	0	144429
13247	1029	140097	2366	4007	0	147499
13248	1396	3485	1482	146630	0	152993
13249	1193	1931	146147	4263	0	153534
13250	1456	1229	3746	144275	0	150706
13251	142962	806	2100	4945	0	150813
13252	3741	144532	1600	2814	0	152687
13253	2480	3578	1157	145313	0	152528
13254	1580	1906	148546	3988	0	156020
13255	1188	143363	3854	2518	0	150923
13256	1059	148364	2140	1832	0	153395
13257	1135	4401	144809	1545	0	151890
13258	1518	2194	3449	135874	0	143035
13259	1640	1806	2000	136104	0	141550
13260	993	895	138348	4286	0	144522
13261	799	129707	3290	2436	0	136232
13262	689	131621	1771	1468	0	135549
13263	120041	2565	985	1119	0	124710
13264	1859	122134	659	736	0	125388
13265	120028	2144	450	864	0	123486
13266	2248	950	269	117129	0	120596
13267	123059	589	403	2652	0	126703
13268	2125	529	122765	997	0	126416
13269	119673	421	1915	1062	0	123071
13270	2546	386	971	124331	0	128234
13271	957	126135	739	2030	0	129861
13272	127881	1831	439	1337	0	131488
13273	2293	1156	437	127660	0	131546
13274	940	128829	438	2064	0	132271
13275	614	136848	505	964	0	138931
13276	135298	2255	451	1270	0	139274
13277	137250	1029	265	1045	0	139589
13278	138947	686	321	903	0	140857
13279	2807	468	256	133918	0	137449
13280	1084	131053	390	1997	0	134524
13281	685	136125	358	944	0	138112
13282	690	2320	305	136178	0	139493
13283	134294	1025	313	2581	0	138213
13284	128220	721	316	1928	0	131185
13285	132993	488	255	1287	0	135023
13286	2709	499	131263	647	0	135118
13287	1412	604	131512	538	0	134066
13288	139663	454	2212	945	0	143274
13289	2388	404	1005	140084	0	143881
13290	1396	421	616	141414	0	143847
13291	1153	398	393	139694	0	141638
13292	882	409	357	141548	0	143196
13293	524	542	137731	3066	0	141863
13294	744	454	1985	136072	0	139255
13295	561	525	137407	2635	0	141128
13296	126357	414	2245	2022	0	131038
13297	2079	137532	1104	1168	0	141883
13298	1354	1936	779	141045	0	145114
13299	983	934	558	139315	0	141790
13300	137199	741	601	3421	0	141962
13301	136072	560	514	2212	0	139358
13302	136858	567	512	1664	0	139601
13303	136349	528	438	1479	0	138794
13304	3113	651	136133	924	0	140821
13305	1744	614	133010	877	0	136245
13306	1370	441	2560	135206	0	139577
13307	137288	447	1295	2934	0	141964
13308	135027	469	969	2003	0	138468
13309	2823	600	134903	1210	0	139536
13310	1775	458	2077	132506	0	136816
13311	134075	468	1136	3098	0	138777
13312	2523	519	828	134562	0	138432
13313	1395	653	136332	2756	0	141136
13314	1523	521	2090	134621	0	138755
13315	136646	586	1139	3244	0	141615
13316	2342	147865	952	1552	0	152711
13317	146441	2058	621	2070	0	151190
13318	147049	1006	569	1756	0	150380
13319	148496	718	573	1625	0	151412
13320	3528	554	548	147148	0	151778
13321	144842	575	447	2897	0	148761
13322	2695	150347	605	1359	0	155006
13323	1514	155991	627	1042	0	159174
13324	1458	3390	495	152181	0	157524
13325	152782	1412	467	3443	0	158104
13326	3044	159892	465	1529	0	164930
13327	183895	3007	409	1852	0	189163
13328	195761	1433	352	1809	0	199355
13329	6262	204866	445	843	0	212416
13330	3640	4961	332	205827	0	214760
13331	2849	2101	312	212051	0	217313
13332	1849	1373	211565	6554	0	221341
13333	2942	914	4784	206089	0	214729
13334	1839	1058	211470	6315	0	220682
13335	1511	204301	5495	3153	0	214460
13336	2037	5263	2133	207936	0	217369
13337	198803	2167	1507	7147	0	209624
13338	204158	1245	1168	4217	0	210788
13339	7307	1002	1294	204247	0	213850
13340	2936	1142	200615	6118	0	210811
13341	185179	980	5129	4139	0	195427
13342	5641	191600	2327	2616	0	202184
13343	2886	190375	1355	2004	0	196620
13344	2279	195802	954	1856	0	200891
13345	2892	6039	1080	185484	0	195495
13346	1755	2616	192134	5006	0	201511
13347	2142	1766	4665	188912	0	197485
13348	1370	1604	192851	5165	0	200990
13349	1173	1815	190009	2380	0	195377
13350	978	1696	196414	1811	0	200899
13351	2004	1395	6416	184438	0	194253
13352	1575	1080	2968	195613	0	201236
13353	1377	865	2301	199314	0	203857
13354	1468	771	2122	193830	0	198191
13355	193952	598	1979	7941	0	204470
13356	4255	193797	2017	3767	0	203836
13357	192858	4368	1648	3532	0	202406
13358	4763	199102	1303	2707	0	207875
13359	2773	4841	934	200223	0	208771
13360	2293	2038	829	208769	0	213929
13361	205034	1445	646	8112	0	215237
13362	208386	1220	677	4482	0	214765
13363	211458	1374	663	3262	0	216757
13364	210380	1251	658	2900	0	215189
13365	209537	1191	474	3021	0	214223
13366	7339	206476	468	2079	0	216362
13367	199701	4518	341	2949	0	207509
13368	6598	200631	476	1591	0	209296
13369	199513	4774	340	1969	0	206596
13370	7023	2218	198790	975	0	209006
13371	4565	1665	3969	193503	0	203702
13372	3103	202121	1654	3971	0	210849
13373	2794	5063	1045	201632	0	210534
13374	2391	2658	200426	4862	0	210337
13375	2705	1869	4507	191010	0	200091
13376	189916	1430	2047	6637	0	200030
13377	4897	192178	1621	3251	0	201947
13378	2442	197733	1349	2728	0	204252
13379	1924	6066	200696	2251	0	210937
13380	1992	3145	4676	194773	0	204586
13381	1497	204483	2514	5504	0	213998
13382	1770	5249	1688	209419	0	218126
13383	1617	2874	210138	5833	0	220462
13384	1309	205608	5173	3522	0	215612
13385	1412	5651	206786	2465	0	216314
13386	1550	3310	203934	2123	0	210917
13387	2005	2209	5947	201734	0	211895
13388	204756	1973	3017	6303	0	216049
13389	5330	1857	2186	207674	0	217047
13390	2547	1818	209696	5958	0	220019
13391	2245	1897	5889	210908	0	220939
13392	1458	1992	220993	6304	0	230747
13393	1669	1853	217499	3561	0	224582
13394	216461	1363	7487	4172	0	229483
13395	231545	1261	3950	3982	0	240738
13396	232862	1053	3009	4231	0	241155
13397	7121	1010	229868	2914	0	240913
13398	3423	1045	232315	2743	0	239526
13399	3081	772	8309	224755	0	236917
13400	2955	786	4558	232239	0	240538
13401	231529	931	2986	8289	0	243735
13402	7204	1017	2364	232424	0	243009
13403	3695	1081	233850	7401	0	246027
13404	2869	1085	226635	4298	0	234887
13405	2175	231753	7500	3637	0	245065
13406	2812	5098	3592	236792	0	248294
13407	2417	2513	241102	6998	0	253030
13408	3208	1676	6561	235566	0	247011
13409	237228	1392	3551	8636	0	250807
13410	6343	1540	242810	4086	0	254779
13411	3982	1288	6899	239944	0	252113
13412	3262	1310	3600	246072	0	254244
13413	2444	1325	241262	8505	0	253536
13414	3158	1048	6678	235067	0	245951
13415	2424	1085	239102	7832	0	250443
13416	219643	993	7023	5299	0	232958
13417	6748	1031	3797	225623	0	237199
13418	3197	224972	2991	7103	0	238263
13419	224264	5299	2283	5385	0	237231
13420	224637	2182	2322	4523	0	233664
13421	7547	224002	2323	3232	0	237104
13422	5109	13428	2138	201710	0	222385
13423	2694	210641	1685	5162	0	220182
13424	2386	213824	1401	3264	0	220875
13425	4002	6180	203145	2452	0	215779
13426	2396	200538	4503	2214	0	209651
13427	1876	3697	173292	1324	0	180189
13428	144977	1537	2381	1557	0	150452
13429	148647	446	809	1444	0	151346
13430	1973	152973	590	479	0	156015
13431	778	153260	462	523	0	155023
13432	460	157384	428	362	0	158634
13433	157168	2156	376	1162	0	160862
13434	2664	844	374	160682	0	164564
13435	780	651	170913	2068	0	174412
13436	476	171277	2693	791	0	175237
13437	966	2661	742	174836	0	179205
13438	984	852	472	171770	0	174078
13439	276	195319	486	3112	0	199193
13440	205607	3705	398	2204	0	211914
13441	4306	1163	211269	709	0	217447
13442	2882	686	4430	246087	0	254085
13443	651	277049	1291	5970	0	284961
13444	274219	7202	662	2784	0	284867
13445	7460	2110	274491	1141	0	285202
13446	1780	268228	7324	915	0	278247
13447	3085	7498	1682	267447	0	279712
13448	962	2144	269242	7105	0	279453
13449	257590	1246	7761	2819	0	269416
13450	9037	950	1980	262107	0	274074
13451	2116	1010	265073	7671	0	275870
13452	1261	263496	7969	2320	0	275046
13453	254160	7618	2141	2804	0	266723
13454	7114	264288	1682	1330	0	274414
13455	261195	8266	1148	2282	0	272891
13456	266905	2399	864	2137	0	272305
13457	10658	1818	834	255413	0	268723
13458	3309	250897	1171	7549	0	262926
13459	2153	7443	252549	2043	0	264188
13460	3303	2289	7698	247540	0	260830
13461	5055	2435	3180	215509	0	226179
13462	2971	1123	1680	251253	0	257027
13463	3255	951	1276	251132	0	256614
13464	2936	978	993	253380	0	258287
13465	245589	1060	1184	11615	0	259448
13466	239054	1258	1264	5220	0	246796
13467	239605	1074	955	4275	0	245909
13468	9271	240489	1103	2268	0	253131
13469	3750	7670	243531	1865	0	256816
13470	2759	2381	243104	1732	0	249976
13471	1896	1961	247590	1793	0	253240
13472	3188	1761	9981	232672	0	247602
13473	3015	1366	3740	242127	0	250248
13474	2991	1105	2371	243892	0	250359
13475	1336	1309	237803	10984	0	251432
13476	1214	232646	8629	5006	0	247495
13477	1368	7990	235978	3395	0	248731
13478	1634	2651	240511	2641	0	247437
13479	3187	1855	9951	227611	0	242604
13480	1940	1829	234911	8815	0	247495
13481	3300	1595	9581	225784	0	240260
13482	224735	1658	3753	10478	0	240624
13483	227133	1601	2971	4446	0	236151
13484	10101	1661	222316	2908	0	236986
13485	4905	1572	9328	217853	0	233658
13486	2980	1727	222554	9703	0	236964
13487	2174	221853	9800	4204	0	238031
13488	220181	8811	3806	4015	0	236813
13489	9418	3303	222265	2696	0	237682
13490	3665	211289	9894	2609	0	227457
13491	2699	214091	4134	2744	0	223668
13492	2456	213379	3382	2793	0	222010
13493	2527	10577	200045	2681	0	215830
13494	3539	5034	9360	184861	0	202794
13495	2515	195585	3658	8626	0	210384
13496	3575	9251	3194	193164	0	209184
13497	3594	3758	2950	200090	0	210392
13498	189508	2809	2922	11408	0	206647
13499	8561	191351	2980	5689	0	208581
13500	187406	8701	3058	4761	0	203926
13501	9359	185184	2693	4009	0	201245
13502	4286	194886	2667	3498	0	205337
13503	3518	10455	186691	3171	0	203835
13504	3805	5124	8908	182706	0	200543
13505	3076	4048	184095	9281	0	200500
13506	2823	180781	9399	4883	0	197886
13507	3083	9061	181083	3857	0	197084
13508	3093	3742	184311	3940	0	195086
13509	2626	181180	10422	3964	0	198192
13510	172575	9046	4764	4370	0	190755
13511	8187	178328	4043	4528	0	195086
13512	178026	9342	3608	4540	0	195516
13513	9387	4237	177690	4289	0	195603
13514	4322	2870	181581	4330	0	193103
13515	3216	176129	10626	4264	0	194235
13516	173433	8925	4736	4159	0	191253
13517	9324	175160	4379	3647	0	192510
13518	4832	8915	4138	175505	0	193390
13519	177510	3978	3992	9188	0	194668
13520	9354	3636	177170	3879	0	194039
13521	4218	3133	10631	176884	0	194866
13522	172717	2831	5125	10117	0	190790
13523	8798	174454	4486	4863	0	192601
13524	4487	8862	3731	175772	0	192852
13525	3158	3654	175342	10438	0	192592
13526	173362	2925	9904	5254	0	191445
13527	8845	2794	5161	175433	0	192233
13528	2981	2726	174172	10007	0	189886
13529	3004	2590	10198	167157	0	182949
13530	2609	170303	4841	10094	0	187847
13531	2599	8375	171266	5214	0	187454
13532	3631	3189	9335	165090	0	181245
13533	160001	2447	4257	9382	0	176087
13534	9468	2208	3579	156165	0	171420
13535	144509	2102	3138	8268	0	158017
13536	7840	145206	3039	3685	0	159770
13537	141632	7145	3150	3025	0	154952
13538	7319	3458	138583	2643	0	152003
13539	3028	2525	120263	2021	0	127837
13540	2323	1937	104874	1487	0	110621
13541	1872	97253	8036	1703	0	108864
13542	2943	1257	6364	30796	0	41360
13543	326	364	603	30415	0	31708
13544	232	253	210	30106	0	30801
13545	246	148	201	30700	0	31295
13546	141	168	30498	944	0	31751
13547	28432	141	705	530	0	29808
13548	665	31081	367	247	0	32360
13549	30690	624	199	242	0	31755
13550	719	313	167	30489	0	31688
13551	352	31649	175	620	0	32796
13552	263	678	162	32345	0	33448
13553	31872	333	143	802	0	33150
13554	589	33709	177	354	0	34829
13555	33566	618	131	307	0	34622
13556	33540	289	183	233	0	34245
13557	821	207	131	33960	0	35119
13558	371	154	34087	618	0	35230
13559	33583	134	649	395	0	34761
13560	672	176	279	35638	0	36765
13561	36248	155	154	754	0	37311
13562	37258	137	171	416	0	37982
13563	37215	103	157	305	0	37780
13564	890	154	37008	168	0	38220
13565	511	162	598	36085	0	37356
13566	36692	115	277	771	0	37855
13567	730	129	38148	311	0	39318
13568	332	38730	627	189	0	39878
13569	485	629	309	35602	0	37025
13570	166	273	38885	512	0	39836
13571	186	158	38334	279	0	38957
13572	306	234	678	38066	0	39284
13573	208	79	283	39624	0	40194
13574	200	83	172	40066	0	40521
13575	204	79	130	39415	0	39828
13576	151	85	39532	728	0	40496
13577	133	39895	521	365	0	40914
13578	225	442	240	40792	0	41699
13579	41417	214	145	675	0	42451
13580	40787	123	128	407	0	41445
13581	41540	87	113	286	0	42026
13582	757	92	109	41347	0	42305
13583	378	146	114	40832	0	41470
13584	196	38879	116	605	0	39796
13585	132	41072	107	329	0	41640
13586	282	570	113	40306	0	41271
13587	39796	249	157	649	0	40851
13588	39656	98	76	292	0	40122
13589	39554	49	71	284	0	39958
13590	39783	47	61	255	0	40146
13591	40147	43	65	247	0	40502
13592	399	40434	87	128	0	41048
13593	221	272	67	41639	0	42199
13594	42811	93	48	522	0	43474
13595	43394	70	70	328	0	43862
13596	434	49	70	43221	0	43774
13597	241	62	60	43620	0	43983
13598	152	92	44842	382	0	45468
13599	277	52	276	42871	0	43476
13600	231	46	115	44218	0	44610
13601	127	94	47263	385	0	47869
13602	239	65	231	46202	0	46737
13603	119	48875	110	364	0	49468
13604	161	289	48734	175	0	49359
13605	122	49548	267	156	0	50093
13606	270	268	117	48239	0	48894
13607	181	88	75	49380	0	49724
13608	88	48840	82	293	0	49303
13609	94	49614	69	166	0	49943
13610	50837	203	104	360	0	51504
13611	50258	91	56	308	0	50713
13612	288	92	50256	113	0	50749
13613	51421	31	198	390	0	52040
13614	55445	25	130	404	0	56004
13615	55996	31	70	327	0	56424
13616	55419	66	131	271	0	55887
13617	312	93	53895	147	0	54447
13618	217	148	49840	88	0	50293
13619	54848	37	227	312	0	55424
13620	273	57683	126	133	0	58215
13621	124	218	58309	87	0	58738
13622	58075	47	224	272	0	58618
13623	59172	36	77	306	0	59591
13624	331	85	58364	46	0	58826
13625	57681	43	268	213	0	58205
13626	414	43	104	66612	0	67173
13627	161	90	69692	294	0	70237
13628	64184	37	319	557	0	65097
13629	293	71310	167	134	0	71904
13630	73989	264	87	509	0	74849
13631	85002	92	58	823	0	85975
13632	498	54	73	86223	0	86848
13633	394	51	77	84935	0	85457
13634	224	46	53	87935	0	88258
13635	87884	44	48	779	0	88755
13636	91210	34	51	570	0	91865
13637	680	37	55	91985	0	92757
13638	404	38	50	91522	0	92014
13639	223	102	90717	630	0	91672
13640	86164	43	465	661	0	87333
13641	635	74	169	93810	0	94688
13642	377	50	97	93541	0	94065
13643	177	92353	92	818	0	93440
13644	298	533	56	93843	0	94730
13645	334	207	54	92965	0	93560
13646	92384	135	36	1197	0	93752
13647	653	93551	80	443	0	94727
13648	487	627	34	95202	0	96350
13649	463	227	36	94427	0	95153
13650	422	135	30	95350	0	95937
13651	193	129	94688	1004	0	96014
13652	401	71	637	92711	0	93820
13653	93751	59	220	1334	0	95364
13654	812	131	92132	424	0	93499
13655	596	50	696	93648	0	94990
13656	419	59	260	96132	0	96870
13657	96244	64	163	1511	0	97982
13658	93349	54	121	1040	0	94564
13659	1024	128	94918	382	0	96452
13660	86527	77	754	839	0	88197
13661	971	180	94148	268	0	95567
13662	92234	96	850	780	0	93960
13663	1113	102030	372	392	0	103907
13664	104174	967	167	761	0	106069
13665	1230	105346	202	317	0	107095
13666	107420	1213	140	733	0	109506
13667	1327	108622	164	317	0	110430
13668	731	1315	126	110767	0	112939
13669	662	406	107	110802	0	111977
13670	537	304	101	110238	0	111180
13671	238	108123	134	1834	0	110329
13672	503	1146	138	108633	0	110420
13673	240	109052	191	1493	0	110976
13674	440	1364	128	110912	0	112844
13675	110271	434	133	2035	0	112873
13676	108994	332	116	1153	0	110595
13677	1677	108711	177	511	0	111076
13678	1027	1329	108	109917	0	112381
13679	108547	495	109	1894	0	111045
13680	1504	109557	162	647	0	111870
13681	652	111009	159	570	0	112390
13682	110806	1751	115	895	0	113567
13683	111327	738	93	895	0	113053
13684	1831	111197	143	490	0	113661
13685	111341	1514	87	786	0	113728
13686	2054	680	90	112095	0	114919
13687	828	631	116776	1590	0	119825
13688	115147	347	1484	1390	0	118368
13689	117727	278	517	1230	0	119752
13690	2352	376	118959	414	0	122101
13691	117770	291	1626	1092	0	120779
13692	121776	289	580	1188	0	123833
13693	126789	280	361	1137	0	128567
13694	2614	125713	309	422	0	129058
13695	127620	1857	131	1020	0	130628
13696	128952	805	145	970	0	130872
13697	3028	592	129	128154	0	131903
13698	1851	455	128	128844	0	131278
13699	1310	405	107	131865	0	133687
13700	131023	383	124	3362	0	134892
13701	2586	328	130	129055	0	132099
13702	129983	357	148	3161	0	133649
13703	131115	332	160	1837	0	133444
13704	3255	366	152	130461	0	134234
13705	1941	338	188	133352	0	135819
13706	1447	353	175	136003	0	137978
13707	135129	366	111	3868	0	139474
13708	2687	134952	230	1523	0	139392
13709	1783	2250	157	138711	0	142901
13710	1483	982	142	141963	0	144570
13711	139218	636	134	4133	0	144121
13712	139750	497	141	2458	0	142846
13713	3682	574	135309	1262	0	140827
13714	1999	622	133936	972	0	137529
13715	143342	413	3013	1386	0	148154
13716	4069	453	1111	146458	0	152091
13717	2526	418	627	169669	0	173240
13718	1523	575	170299	5336	0	177733
13719	1895	568	3886	164649	0	170998
13720	1069	166700	1294	5036	0	174099
13721	1150	175293	835	2141	0	179419
13722	169246	4818	485	2205	0	176754
13723	4755	1800	168713	1342	0	176610
13724	1873	173708	3798	1238	0	180617
13725	2333	4382	1042	175399	0	183156
13726	1504	1534	172321	4626	0	179985
13727	2048	1110	4196	164993	0	172347
13728	1949	792	1297	169494	0	173532
13729	1340	657	168764	5604	0	176365
13730	1165	167889	4426	2429	0	175909
13731	1818	4252	1339	158903	0	166312
13732	159130	1275	1129	5624	0	167158
13733	160867	958	879	2599	0	165303
13734	161365	764	632	2294	0	165055
13735	5898	158460	822	1587	0	166767
13736	156924	4159	712	1703	0	163498
13737	5886	1490	659	156634	0	164669
13738	2299	1094	154579	4885	0	162857
13739	151257	836	3919	2653	0	158665
13740	4912	156829	1477	1768	0	164986
13741	2492	3987	967	156034	0	163480
13742	2140	1383	798	157037	0	161358
13743	1395	155102	845	5414	0	162756
13744	1916	4334	765	159102	0	166117
13745	2055	1491	823	161560	0	165929
13746	1952	1290	686	165425	0	169353
13747	159291	1108	841	6817	0	168057
13748	159406	844	807	3745	0	164802
13749	5441	1238	159800	2498	0	168977
13750	3046	1226	4161	158389	0	166822
13751	2609	943	1462	165078	0	170092
13752	2188	951	1416	166600	0	171155
13753	162000	1045	1136	6921	0	171102
13754	5083	1130	158200	3238	0	167651
13755	153917	867	4374	3100	0	162258
13756	162599	857	1589	2858	0	167903
13757	6111	876	1246	161841	0	170074
13758	161928	724	1225	6222	0	170099
13759	5751	1059	156108	2889	0	165807
13760	153716	782	3973	3423	0	161894
13761	5852	172810	1593	2412	0	182667
13762	3044	4315	169068	1834	0	178261
13763	2477	1742	171196	2054	0	177469
13764	2876	1983	5135	167877	0	177871
13765	2084	1103	172339	5320	0	180846
13766	163572	998	4775	3435	0	172780
13767	4927	168023	1960	2419	0	177329
13768	168720	4152	1427	2729	0	177028
13769	5690	1595	1200	170757	0	179242
13770	2511	1228	170265	5530	0	179534
13771	1989	1021	169488	3128	0	175626
13772	2242	1148	4841	172354	0	180585
13773	173715	860	1997	6364	0	182936
13774	4852	169797	1488	3369	0	179506
13775	2230	177795	1293	2956	0	184274
13776	175884	4611	1345	3119	0	184959
13777	5266	177844	1393	2372	0	186875
13778	179085	4549	1377	2675	0	187686
13779	6038	1783	1251	178366	0	187438
13780	178294	1191	1221	5640	0	186346
13781	5946	1151	1354	178477	0	186928
13782	179520	1015	1232	5904	0	187671
13783	5855	918	1324	177906	0	186003
13784	2806	176347	1568	5436	0	186157
13785	176846	3901	1377	3413	0	185537
13786	5058	176726	1327	2867	0	185978
13787	2756	4244	169430	1920	0	178350
13788	2800	1844	4217	161256	0	170117
13789	2053	172015	1779	4220	0	180067
13790	166053	4322	1316	2625	0	174316
13791	165993	1819	1366	2309	0	171487
13792	5503	166155	1442	1587	0	174687
13793	2431	4325	163979	1700	0	172435
13794	2655	1538	4179	158200	0	166572
13795	1960	159482	1934	4489	0	167865
13796	2125	4125	1492	164667	0	172409
13797	2516	1529	1234	166601	0	171880
13798	162970	1561	976	5704	0	171211
13799	4782	161846	1126	2424	0	170178
13800	2662	4005	975	164283	0	171925
13801	163838	1833	863	5346	0	171880
13802	163605	1359	911	2935	0	168810
13803	162655	1364	951	2537	0	167507
13804	6075	1387	905	159848	0	168215
13805	157553	1095	783	4828	0	164259
13806	5068	156923	956	1937	0	164884
13807	154739	3635	905	2323	0	161602
13808	4495	156309	821	1898	0	163523
13809	155528	3606	743	2135	0	162012
13810	154346	1475	593	2250	0	158664
13811	5460	1470	721	151596	0	159247
13812	2450	932	153942	3897	0	161221
13813	2306	1206	147742	1723	0	152977
13814	1855	151902	3215	1444	0	158416
13815	145564	3076	1577	2093	0	152310
13816	3788	1322	144996	860	0	150966
13817	110581	544	1362	944	0	113431
13818	1687	115965	513	332	0	118497
13819	850	120196	359	359	0	121764
13820	886	1615	256	123715	0	126472
13821	632	127962	283	1406	0	130283
13822	574	1951	130641	634	0	133800
13823	1144	829	1651	125088	0	128712
13824	541	134638	622	1814	0	137615
13825	872	2310	329	136173	0	139684
13826	135199	861	289	3153	0	139502
13827	2890	760	315	135315	0	139280
13828	983	682	137845	2786	0	142296
13829	738	138620	2454	1198	0	143010
13830	1111	3023	902	137044	0	142080
13831	1122	1058	623	139274	0	142077
13832	1027	815	476	142427	0	144745
13833	137859	696	423	4398	0	143376
13834	136429	542	384	2282	0	139637
13835	3546	727	136858	1145	0	142276
13836	1609	680	134550	874	0	137713
13837	952	137273	3223	944	0	142392
13838	139015	2821	1179	1344	0	144359
13839	3508	1070	775	138798	0	144151
13840	1869	800	597	139540	0	142806
13841	1568	643	453	140635	0	143299
13842	1569	533	326	140939	0	143367
13843	967	728	134968	4193	0	140856
13844	130073	566	2718	2464	0	135821
13845	3827	452	915	149790	0	154984
13846	1601	578	148650	4184	0	155013
13847	148786	528	3726	2524	0	155564
13848	165095	388	1460	1970	0	168913
13849	5870	692	183581	984	0	191127
13850	3067	544	190745	841	0	195197
13851	2960	543	6317	185588	0	195408
13852	189057	470	2619	6147	0	198293
13853	193491	393	1642	2938	0	198464
13854	7880	518	1242	184637	0	194277
13855	4095	408	1348	191760	0	197611
13856	2045	538	189585	7048	0	199216
13857	2736	693	5698	184680	0	193807
13858	1954	509	186804	6851	0	196118
13859	175558	448	6078	3817	0	185901
13860	5879	184915	2862	2515	0	196171
13861	174161	4616	1531	2486	0	182794
13862	5929	174255	1504	1628	0	183316
13863	172459	5363	1474	1746	0	181042
13864	7239	1969	1094	166674	0	176976
13865	3955	1256	949	170863	0	177023
13866	168924	1033	731	7371	0	178059
13867	171010	937	642	3698	0	176287
13868	171859	730	735	2771	0	176095
13869	172775	764	661	2225	0	176425
13870	8565	611	164556	1697	0	175429
13871	162651	471	5190	2333	0	170645
13872	169189	542	1998	1958	0	173687
13873	169864	463	1402	1571	0	173300
13874	9874	479	1056	162347	0	173756
13875	158618	482	1031	6558	0	166689
13876	7895	157251	1337	2697	0	169180
13877	5402	4797	1039	158230	0	169468
13878	4721	1706	1041	162926	0	170394
13879	3340	1226	157047	7628	0	169241
13880	3787	854	5615	152559	0	162815
13881	2788	156493	2640	7252	0	169173
13882	154732	5341	1780	4364	0	166217
13883	7037	156787	1735	3244	0	168803
13884	158126	5819	1389	3667	0	169001
13885	8510	2449	1404	157064	0	169427
13886	154848	1710	1397	7727	0	165682
13887	7660	152449	1367	4019	0	165495
13888	154232	5898	1219	3530	0	164879
13889	157775	2790	1243	2989	0	164797
13890	9763	2149	1190	151814	0	164916
13891	5983	1710	1000	156673	0	165366
13892	4467	1570	150333	8210	0	164580
13893	4579	1537	5263	151132	0	162511
13894	4089	1432	2155	154819	0	162495
13895	3778	1104	148903	8940	0	162725
13896	3992	1022	5713	151586	0	162313
13897	3343	942	148862	8575	0	161722
13898	147931	803	6530	4918	0	160182
13899	8302	735	3138	148637	0	160812
13900	4816	889	145306	7721	0	158732
13901	146169	856	6355	4306	0	157686
13902	8800	800	3084	147055	0	159739
13903	4929	855	146853	7785	0	160422
13904	147618	671	6392	4741	0	159422
13905	8534	851	2885	148381	0	160651
13906	5009	825	2302	152146	0	160282
13907	149643	809	1976	9613	0	162041
13908	8387	811	1703	148534	0	159435
13909	4974	812	1833	151668	0	159287
13910	4286	1013	1768	146108	0	153175
13911	3732	142847	1515	9492	0	157586
13912	139365	5385	1345	6014	0	152109
13913	143554	2383	1313	4533	0	151783
13914	9395	1759	1167	139686	0	152007
13915	140301	1368	1107	8404	0	151180
13916	141552	1270	1061	5301	0	149184
13917	143000	1307	1231	4141	0	149679
13918	115657	1582	1692	5082	0	124013
13919	139339	918	1360	3967	0	145584
13920	10050	834	123163	3520	0	137567
13921	5710	970	119756	3285	0	129721
13922	117651	757	5999	3088	0	127495
13923	7671	114415	2992	3237	0	128315
13924	4409	3931	2175	110949	0	121464
13925	3559	1725	110536	5974	0	121794
13926	3280	1190	111239	3471	0	119180
13927	3484	2009	6062	107287	0	118842
13928	105881	1133	4073	6440	0	117527
13929	6240	863	2052	105964	0	115119
13930	3551	926	104666	6055	0	115198
13931	108270	494	4686	4146	0	117596
13932	6129	464	2705	109118	0	118416
13933	3995	448	2060	111585	0	118088
13934	3494	317	1572	113619	0	119002
13935	3318	365	1394	112010	0	117087
13936	2847	473	105642	7690	0	116652
13937	3061	430	4226	108046	0	115763
13938	106291	410	2080	6964	0	115745
13939	5304	486	101024	4852	0	111666
13940	103041	568	4127	4063	0	111799
13941	107991	573	1956	3396	0	113916
13942	107555	550	1626	3196	0	112927
13943	106619	513	1487	3094	0	111713
13944	7562	100054	1245	2720	0	111581
13945	3614	86300	884	1883	0	92681
13946	3002	89721	1080	1761	0	95564
13947	80960	3976	2902	2358	0	90196
13948	4141	1028	73003	1540	0	79712
13949	46425	1025	2218	717	0	50385
13950	1956	199	642	43813	0	46610
13951	43850	150	339	1389	0	45728
13952	1425	109	251	43784	0	45569
13953	43994	98	267	1478	0	45837
13954	1464	85	232	43996	0	45777
13955	935	75	186	45835	0	47031
13956	42330	77	204	1611	0	44222
13957	1328	49835	212	817	0	52192
13958	774	847	49249	528	0	51398
13959	663	48793	889	480	0	50825
13960	477	726	46397	334	0	47934
13961	549	618	752	43245	0	45164
13962	44702	174	526	785	0	46187
13963	808	132	200	43940	0	45080
13964	43753	73	172	872	0	44870
13965	830	47732	153	428	0	49143
13966	498	545	48961	316	0	50320
13967	378	48661	529	297	0	49865
13968	338	49293	277	251	0	50159
13969	46694	502	302	311	0	47809
13970	45587	159	167	285	0	46198
13971	554	46328	99	154	0	47135
13972	338	396	85	46845	0	47664
13973	248	133	85	47225	0	47691
13974	47128	107	85	737	0	48057
13975	524	118	47529	291	0	48462
13976	267	105	46140	228	0	46740
13977	305	88	506	47002	0	47901
13978	213	107	47864	548	0	48732
13979	45076	87	547	393	0	46103
13980	47602	95	216	362	0	48275
13981	627	48109	186	173	0	49095
13982	367	499	49493	154	0	50513
13983	395	204	482	48733	0	49814
13984	265	158	52632	557	0	53612
13985	309	125	566	51679	0	52679
13986	52512	99	246	751	0	53608
13987	618	54434	192	340	0	55584
13988	319	570	56924	242	0	58055
13989	243	57581	630	238	0	58692
13990	231	60295	289	234	0	61049
13991	60513	657	199	438	0	61807
13992	58876	238	178	398	0	59690
13993	825	198	60710	242	0	61975
13994	381	62411	641	378	0	63811
13995	396	581	253	63298	0	64528
13996	347	240	204	63179	0	63970
13997	370	176	196	62516	0	63258
13998	254	195	64126	871	0	65446
13999	403	153	637	62494	0	63687
14000	365	141	310	66056	0	66872
14001	66734	141	195	1101	0	68171
14002	66639	160	169	655	0	67623
14003	66938	148	198	598	0	67882
14004	65966	149	142	538	0	66795
14005	66031	180	150	483	0	66844
14006	917	65812	202	229	0	67160
14007	64552	576	117	388	0	65633
14008	827	295	64784	177	0	66083
14009	512	302	541	63795	0	65150
14010	65278	178	200	733	0	66389
14011	705	65787	198	269	0	66959
14012	66762	563	184	475	0	67984
14013	68763	234	120	521	0	69638
14014	851	184	103	69840	0	70978
14015	485	163	150	69777	0	70575
14016	326	75049	162	758	0	76295
14017	401	596	119	77233	0	78349
14018	261	306	80035	751	0	81353
14019	483	185	663	80281	0	81612
14020	265	187	81707	824	0	82983
14021	76330	153	858	736	0	78077
14022	1007	125	335	82440	0	83907
14023	452	158	84625	831	0	86066
14024	322	82113	828	459	0	83722
14025	240	83857	362	295	0	84754
14026	83171	789	298	461	0	84719
14027	885	383	198	83706	0	85172
14028	322	267	90031	617	0	91237
14029	220	89252	608	392	0	90472
14030	280	612	90690	192	0	91774
14031	87062	265	685	573	0	88585
14032	88743	168	295	458	0	89664
14033	89892	157	182	370	0	90601
14034	935	108	147	90495	0	91685
14035	466	146	90448	586	0	91646
14036	253	90878	639	369	0	92139
14037	346	549	352	92652	0	93899
14038	210	335	91126	623	0	92294
14039	236	372	86805	324	0	87737
14040	387	144	775	90903	0	92209
14041	93117	114	352	1020	0	94603
14042	773	95	309	92867	0	94044
14043	537	135	215	94013	0	94900
14044	279	159	96254	836	0	97528
14045	512	110	685	94590	0	95897
14046	439	109	319	95194	0	96061
14047	242	161	97886	885	0	99174
14048	263	210	95185	478	0	96136
14049	376	113	867	96899	0	98255
14050	218	194	99266	790	0	100468
14051	336	120	797	98225	0	99478
14052	99301	83	446	1244	0	101074
14053	636	103378	402	516	0	104932
14054	458	598	247	105165	0	106468
14055	328	280	103345	774	0	104727
14056	90240	190	758	1082	0	92270
14057	657	97099	409	468	0	98633
14058	98616	603	325	666	0	100210
14059	853	268	250	98608	0	99979
14060	530	204	232	97609	0	98575
14061	99970	155	296	1501	0	101922
14062	758	163	100964	531	0	102416
14063	97391	97	786	760	0	99034
14064	939	122	421	101961	0	103443
14065	98774	93	292	1258	0	100417
14066	98206	102	258	848	0	99414
14067	1213	149	234	98965	0	100561
14068	515	101622	269	1109	0	103515
14069	104168	902	271	919	0	106260
14070	104203	329	257	880	0	105669
14071	1588	312	105570	342	0	107812
14072	103161	177	1172	629	0	105139
14073	1688	166	523	105379	0	107756
14074	735	106557	449	1222	0	108963
14075	843	1100	285	105069	0	107297
14076	454	106483	332	1193	0	108462
14077	106496	1238	231	1066	0	109031
14078	108527	511	269	860	0	110167
14079	2048	387	179	115680	0	118294
14080	981	304	114846	1681	0	117812
14081	728	331	112333	920	0	114312
14082	734	213	2105	118142	0	121194
14083	118717	203	1161	2383	0	122464
14084	125513	116	670	1581	0	127880
14085	2862	127660	508	757	0	131787
14086	1995	2109	265	128041	0	132410
14087	957	1053	131432	2432	0	135874
14088	564	791	135089	1277	0	137721
14089	1058	598	3679	145508	0	150843
14090	157141	250	1909	4243	0	163543
14091	4678	189	921	159487	0	165275
14092	1775	264	157725	4768	0	164532
14093	156203	162	4137	2597	0	163099
14094	4875	191	1842	156975	0	163883
14095	2523	163	1284	159461	0	163431
14096	1930	191	703	157840	0	160664
14097	974	156330	623	6029	0	163956
14098	907	3804	156843	2806	0	164360
14099	676	1678	159353	1820	0	163527
14100	1303	903	5525	157810	0	165541
14101	657	572	160387	4680	0	166296
14102	154415	340	5354	2749	0	162858
14103	5022	293	2151	157240	0	164706
14104	2805	353	1389	158157	0	162704
14105	2040	344	1058	158015	0	161457
14106	880	157083	1235	6476	0	165674
14107	159359	4027	905	3750	0	168041
14108	5099	1569	748	160214	0	167630
14109	157951	1003	711	6246	0	165911
14110	5109	159335	708	2894	0	168046
14111	158271	4476	758	2627	0	166132
14112	153369	1804	912	2536	0	158621
14113	157847	1138	913	2259	0	162157
14114	6704	151254	872	1625	0	160455
14115	3316	155031	904	1425	0	160676
14116	147654	5312	627	1856	0	155449
14117	5184	150135	634	1535	0	157488
14118	2464	5144	144702	1475	0	153785
14119	1783	139728	4060	1591	0	147162
14120	1418	147644	1843	1214	0	152119
14121	143890	5551	1286	1507	0	152234
14122	4845	2729	142115	1087	0	150776
14123	2589	1859	141141	903	0	146492
14124	2553	1406	5507	137930	0	147396
14125	111688	1020	32550	4882	0	150140
14126	4422	927	143028	2166	0	150543
14127	2935	955	4841	141529	0	150260
14128	1681	1232	136635	4927	0	144475
14129	1468	1242	134128	2443	0	139281
14130	129360	971	5887	2241	0	138459
14131	4951	1059	135903	1278	0	143191
14132	2965	876	5647	131515	0	141003
14133	2422	1034	2673	131738	0	137867
14134	1600	130874	2004	5622	0	140100
14135	1679	136806	1604	2956	0	143045
14136	1852	5267	1632	132496	0	141247
14137	1296	2575	133996	5198	0	143065
14138	1754	1658	4870	133301	0	141583
14139	1623	1242	2574	137693	0	143132
14140	1254	1038	137971	6666	0	146929
14141	1464	983	5103	139050	0	146600
14142	138895	938	2995	6663	0	149491
14143	4844	1053	138601	3207	0	147705
14144	136526	885	5446	2816	0	145673
14145	5963	781	3030	137684	0	147458
14146	3269	743	2213	141647	0	147872
14147	2127	141733	1838	7075	0	152773
14148	2044	4855	1698	143669	0	152266
14149	1848	2251	1603	150245	0	155947
14150	145693	1532	1803	8165	0	157193
14151	5670	1084	1769	148095	0	156618
14152	3123	1015	1516	151452	0	157106
14153	142714	1032	1613	8614	0	153973
14154	5842	1057	1814	145390	0	154103
14155	3258	1086	1807	139298	0	145449
14156	2351	141800	1786	7698	0	153635
14157	143212	4757	1798	4905	0	154672
14158	6068	2205	1336	144453	0	154062
14159	3305	1713	1223	148651	0	154892
14160	2530	1412	142229	8202	0	154373
14161	2237	1263	5033	142482	0	151015
14162	1917	1048	2649	147540	0	153154
14163	139795	1014	1812	8903	0	151524
14164	141744	1197	1417	5308	0	149666
14165	7272	1158	1251	141898	0	151579
14166	3758	1199	136983	6857	0	148797
14167	2864	130746	4992	3918	0	142520
14168	2086	136042	2675	3478	0	144281
14169	2478	5394	1995	135171	0	145038
14170	133819	2655	1409	6425	0	144308
14171	5553	1837	1010	136328	0	144728
14172	136312	1377	781	7138	0	145608
14173	5912	1267	1000	138997	0	147176
14174	3367	1115	1169	140913	0	146564
14175	134979	1214	1008	7785	0	144986
14176	134325	1357	998	4533	0	141213
14177	6768	133417	903	3146	0	144234
14178	3603	140127	944	2567	0	147241
14179	2463	4882	941	127492	0	135778
14180	2070	2332	1041	131110	0	136553
14181	1762	1623	125903	5597	0	134885
14182	113973	1222	3733	3850	0	122778
14183	4249	121000	1811	2732	0	129792
14184	1642	116264	1186	1941	0	121033
14185	111662	3256	1283	2135	0	118336
14186	3798	1276	111727	1442	0	118243
14187	1704	917	107358	1367	0	111346
14188	1472	1009	99129	1213	0	102823
14189	763	89092	2258	678	0	92791
14190	826	830	1124	78400	0	81180
14191	379	324	218	78140	0	79061
14192	354	242	164	79155	0	79915
14193	76884	151	146	1589	0	78770
14194	75873	162	148	1005	0	77188
14195	996	77252	212	503	0	78963
14196	571	789	126	79271	0	80757
14197	403	409	80364	957	0	82133
14198	269	80896	803	555	0	82523
14199	78660	821	292	868	0	80641
14200	903	370	79915	361	0	81549
14201	70704	252	804	846	0	72606
14202	938	264	79907	332	0	81441
14203	544	375	807	77366	0	79092
14204	303	80118	330	911	0	81662
14205	80334	756	221	871	0	82182
14206	857	81605	209	492	0	83163
14207	80338	846	161	771	0	82116
14208	1064	317	150	80091	0	81622
14209	438	329	82303	1057	0	84127
14210	606	184	790	83733	0	85313
14211	488	209	275	92112	0	93084
14212	338	317	91239	1546	0	93440
14213	85087	178	1248	1246	0	87759
14214	1318	93301	432	583	0	95634
14215	92357	1240	255	920	0	94772
14216	1396	93955	263	456	0	96070
14217	779	1408	181	96799	0	99167
14218	453	492	95653	1583	0	98181
14219	108173	292	1409	1210	0	111084
14220	2274	114844	455	642	0	118215
14221	1231	2264	269	113831	0	117595
14222	987	741	223	119017	0	120968
14223	122178	558	207	3378	0	126321
14224	128029	348	216	1863	0	130456
14225	3483	131086	331	816	0	135716
14226	139662	3050	233	1111	0	144056
14227	140942	1111	201	1123	0	143377
14228	143276	714	229	1140	0	145359
14229	5454	588	141723	531	0	148296
14230	2457	137564	3496	639	0	144156
14231	1390	145485	1384	551	0	148810
14232	1846	4690	787	134980	0	142303
14233	1799	2001	410	141181	0	145391
14234	140654	1106	342	5127	0	147229
14235	4012	140373	465	2044	0	146894
14236	141227	4040	321	1574	0	147162
14237	5144	1892	276	138136	0	145448
14238	2681	1162	246	142257	0	146346
14239	137696	703	300	5719	0	144418
14240	136647	570	324	2848	0	140389
14241	5556	778	132482	1322	0	140138
14242	3468	769	3547	130557	0	138341
14243	1752	597	130062	4008	0	136419
14244	1284	696	128494	1972	0	132446
14245	1179	704	130533	1204	0	133620
14246	123430	765	5357	1246	0	130798
14247	4480	547	2275	122013	0	129315
14248	2505	474	1227	122452	0	126658
14249	1961	449	887	126419	0	129716
14250	1021	480	123720	5287	0	130508
14251	1710	370	3724	122508	0	128312
14252	1693	381	1601	126698	0	130373
14253	122748	382	906	5802	0	129838
14254	124357	393	624	3194	0	128568
14255	126397	397	576	2215	0	129585
14256	127277	451	694	1614	0	130036
14257	6593	438	678	122262	0	129971
14258	124217	526	630	4679	0	130052
14259	5896	603	571	123099	0	130169
14260	3004	702	117043	4769	0	125518
14261	118769	568	3364	2969	0	125670
14262	5055	120059	1516	1875	0	128505
14263	3377	3650	971	118780	0	126778
14264	2774	1818	722	119862	0	125176
14265	1827	120926	706	5250	0	128709
14266	118943	3921	691	3271	0	126826
14267	5035	118948	653	2047	0	126683
14268	3025	4332	117459	1577	0	126393
14269	2263	2102	118791	1573	0	124729
14270	115924	1372	4804	2011	0	124111
14271	120165	1100	2339	1910	0	125514
14272	5914	916	116441	1484	0	124755
14273	114936	907	4237	1825	0	121905
14274	5710	880	115641	1323	0	123554
14275	114819	778	4853	1746	0	122196
14276	5837	785	115153	1581	0	123356
14277	3404	757	116724	1673	0	122558
14278	2938	764	5530	108071	0	117303
14279	2691	756	3011	110955	0	117413
14280	111819	667	2050	6177	0	120713
14281	110924	656	1664	3776	0	117020
14282	113300	617	1539	2746	0	118202
14283	115469	661	1521	2186	0	119837
14284	7032	108979	1549	1882	0	119442
14285	4533	3530	1237	107178	0	116478
14286	3418	109753	1305	4701	0	119177
14287	3252	3991	1270	110782	0	119295
14288	3053	1878	1283	110887	0	117101
14289	3058	1330	1210	110915	0	116513
14290	2498	1218	105036	6733	0	115485
14291	102331	889	4212	4386	0	111818
14292	5533	100570	2234	3146	0	111483
14293	3464	106657	1646	2550	0	114317
14294	3048	4941	105435	2356	0	115780
14295	2883	2411	4191	104817	0	114302
14296	2887	1589	2390	106292	0	113158
14297	103829	1186	1673	6455	0	113143
14298	5813	1210	1454	103236	0	111713
14299	3693	1177	1437	105193	0	111500
14300	2943	1046	1597	106400	0	111986
14301	2746	932	1561	107572	0	112811
14302	101344	753	1553	7350	0	111000
14303	103802	713	1690	4170	0	110375
14304	105247	674	1661	2988	0	110570
14305	7205	755	1648	102676	0	112284
14306	103313	636	1632	5770	0	111351
14307	6172	684	1657	104250	0	112763
14308	4110	623	1834	107772	0	114339
14309	3268	507	100643	6743	0	111161
14310	2861	498	98607	3923	0	105889
14311	2414	445	93838	2702	0	99399
14312	90846	493	5872	2353	0	99564
14313	5491	693	3105	84956	0	94245
14314	3329	88022	2007	4627	0	97985
14315	90930	3122	1665	3027	0	98744
14316	5252	1526	88008	2381	0	97167
14317	85035	887	4010	2180	0	92112
14318	5393	81913	2287	1925	0	91518
14319	66394	2205	1122	1255	0	70976
14320	4123	1274	781	64931	0	71109
14321	64373	704	721	3052	0	68850
14322	3509	60501	705	2014	0	66729
14323	2062	59695	714	1424	0	63895
14324	51047	2090	814	1029	0	54980
14325	2256	51502	636	866	0	55260
14326	737	38454	308	415	0	39914
14327	736	39353	424	407	0	40920
14328	36450	1269	996	455	0	39170
14329	35302	466	160	307	0	36235
14330	35602	392	95	270	0	36359
14331	1227	335	104	34511	0	36177
14332	720	265	87	35208	0	36280
14333	473	267	34644	933	0	36317
14334	509	251	672	34703	0	36135
14335	401	278	35412	865	0	36956
14336	499	163	745	35217	0	36624
14337	422	163	304	36213	0	37102
14338	35605	158	262	1138	0	37163
14339	35519	147	187	691	0	36544
14340	965	35409	211	453	0	37038
14341	608	735	209	35370	0	36922
14342	404	387	37004	891	0	38686
14343	464	261	767	36919	0	38411
14344	469	180	361	37347	0	38357
14345	448	192	256	38076	0	38972
14346	364	194	37214	1149	0	38921
14347	370	190	35350	598	0	36508
14348	35905	134	856	561	0	37456
14349	831	139	421	37463	0	38854
14350	415	138	37260	944	0	38757
14351	35048	100	773	710	0	36631
14352	765	37496	424	526	0	39211
14353	37766	614	289	518	0	39187
14354	879	325	38855	358	0	40417
14355	37453	210	716	426	0	38805
14356	947	176	357	38429	0	39909
14357	483	222	39298	713	0	40716
14358	368	38978	690	424	0	40460
14359	39201	585	469	413	0	40668
14360	801	371	290	39044	0	40506
14361	527	219	220	39183	0	40149
14362	336	39935	273	845	0	41389
14363	367	591	228	40258	0	41444
14364	324	324	39993	837	0	41478
14365	224	39859	677	519	0	41279
14366	40006	591	368	461	0	41426
14367	734	382	250	39874	0	41240
14368	494	239	158	39987	0	40878
14369	334	215	39527	908	0	40984
14370	363	298	601	39534	0	40796
14371	323	269	42001	787	0	43380
14372	265	42390	711	482	0	43848
14373	41675	632	381	559	0	43247
14374	41587	358	265	407	0	42617
14375	41566	233	185	471	0	42455
14376	825	44426	225	389	0	45865
14377	527	575	237	44971	0	46310
14378	417	282	179	45258	0	46136
14379	651	297	290	39050	0	40288
14380	44740	184	171	1081	0	46176
14381	44692	190	155	649	0	45686
14382	914	153	138	44760	0	45965
14383	538	176	50322	838	0	51874
14384	482	157	592	50080	0	51311
14385	372	138	294	50852	0	51656
14386	375	113	232	50923	0	51643
14387	349	119	151	51320	0	51939
14388	51555	99	194	1220	0	53068
14389	812	152	172	52578	0	53714
14390	500	110	132	52823	0	53565
14391	282	52676	155	1086	0	54199
14392	331	584	127	54219	0	55261
14393	274	55368	130	1060	0	56832
14394	314	776	113	56028	0	57231
14395	55290	321	112	1316	0	57039
14396	792	56327	137	606	0	57862
14397	55510	789	96	704	0	57099
14398	982	406	56272	425	0	58085
14399	589	264	722	56136	0	57711
14400	405	196	58059	1038	0	59698
14401	360	221	850	57645	0	59076
14402	391	214	384	57838	0	58827
14403	268	56980	331	1199	0	58778
14404	211	58095	211	725	0	59242
14405	187	59841	181	422	0	60631
14406	58687	735	184	550	0	60156
14407	606	57117	88	290	0	58101
14408	167	56919	76	236	0	57398
14409	489	562	109	57416	0	58576
14410	57675	190	76	746	0	58687
14411	454	60892	85	254	0	61685
14412	61320	478	72	456	0	62326
14413	61092	184	49	436	0	61761
14414	587	150	63169	151	0	64057
14415	425	136	439	61084	0	62084
14416	264	137	125	63965	0	64491
14417	213	119	100	64509	0	64941
14418	262	94	67	63179	0	63602
14419	131	145	61964	648	0	62888
14420	186	205	55741	268	0	56400
14421	56876	79	498	409	0	57862
14422	439	61034	186	143	0	61802
14423	160	61895	103	139	0	62297
14424	62032	535	86	326	0	62979
14425	444	61997	82	140	0	62663
14426	255	506	53	63181	0	63995
14427	63128	197	61	747	0	64133
14428	532	182	63400	237	0	64351
14429	330	94	504	63915	0	64843
14430	143	153	65228	567	0	66091
14431	62381	103	561	527	0	63572
14432	618	144	71102	187	0	72051
14433	71174	104	631	508	0	72417
14434	75069	129	204	542	0	75944
14435	75525	110	122	462	0	76219
14436	75843	110	102	389	0	76444
14437	76212	96	93	376	0	76777
14438	918	110	95	76201	0	77324
14439	79449	106	78	1045	0	80678
14440	776	98	89	80033	0	80996
14441	439	103	89	79786	0	80417
14442	315	130	91	80462	0	80998
14443	230	124	80377	837	0	81568
14444	400	119	569	78222	0	79310
14445	295	102	214	82035	0	82646
14446	216	153	80470	822	0	81661
14447	72589	121	652	639	0	74001
14448	813	97	200	81660	0	82770
14449	326	123	82004	719	0	83172
14450	303	119	79316	312	0	80050
14451	333	118	755	79100	0	80306
14452	216	129	82405	744	0	83494
14453	344	137	688	82142	0	83311
14454	354	92	269	81738	0	82453
14455	156	81928	226	860	0	83170
14456	149	83577	176	391	0	84293
14457	83970	689	141	618	0	85418
14458	776	246	132	84725	0	85879
14459	436	150	122	83367	0	84075
14460	317	100	133	86284	0	86834
14461	203	171	86663	996	0	88033
14462	351	109	674	84470	0	85604
14463	85767	131	275	1190	0	87363
14464	815	215	87881	355	0	89266
14465	490	94	723	89681	0	90988
14466	398	105	272	90322	0	91097
14467	343	90	177	91999	0	92609
14468	170	96607	217	1069	0	98063
14469	96751	1019	183	871	0	98824
14470	100655	329	144	767	0	101895
14471	1692	103318	180	306	0	105496
14472	904	1272	149	108685	0	111010
14473	374	451	109582	1677	0	112084
14474	362	331	106558	677	0	107928
14475	109248	134	2286	741	0	112409
14476	2382	96	871	112671	0	116020
14477	117429	74	431	2486	0	120420
14478	2559	118894	366	967	0	122786
14479	1042	122880	248	588	0	124758
14480	120602	3047	201	977	0	124827
14481	2533	126652	297	423	0	129905
14482	1544	2855	224	127111	0	131734
14483	1200	1124	210	121681	0	124215
14484	543	129867	235	2943	0	133588
14485	130500	2888	161	1702	0	135251
14486	2854	1401	131916	736	0	136907
14487	125475	706	2705	1093	0	129979
14488	3452	626	133749	419	0	138246
14489	121830	433	3116	1062	0	126441
14490	3565	404	134685	488	0	139142
14491	1532	132323	3341	445	0	137641
14492	1513	3154	1403	132908	0	138978
14493	132284	1187	747	3234	0	137452
14494	3285	685	131167	1057	0	136194
14495	1525	548	131874	616	0	134563
14496	1432	383	3755	126688	0	132258
14497	793	372	133113	2947	0	137225
14498	1235	418	3453	128815	0	133921
14499	1408	389	1591	126726	0	130114
14500	712	379	131935	3880	0	136906
14501	1251	274	3353	128724	0	133602
14502	132845	221	1678	4032	0	138776
14503	2968	132894	1138	1729	0	138729
14504	135019	2811	865	1552	0	140247
14505	3714	1164	729	132634	0	138241
14506	133205	591	607	3895	0	138298
14507	136133	482	692	2101	0	139408
14508	4646	417	725	134145	0	139933
14509	1943	136725	760	3137	0	142565
14510	138103	2853	600	2100	0	143656
14511	3601	1338	133811	1068	0	139818
14512	1769	786	133072	1058	0	136685
14513	130547	573	3841	1355	0	136316
14514	3855	444	1731	133157	0	139187
14515	1809	510	134840	3308	0	140467
14516	1599	525	3338	133542	0	139004
14517	134758	533	1528	4106	0	140925
14518	137786	425	1083	2374	0	141668
14519	137331	367	993	1794	0	140485
14520	4600	140539	855	1085	0	147079
14521	2755	2910	620	142048	0	148333
14522	1920	1329	634	143594	0	147477
14523	141796	861	644	4649	0	147950
14524	3685	141574	697	2081	0	148037
14525	141383	2990	714	1759	0	146846
14526	4323	1395	700	140445	0	146863
14527	140022	879	672	3939	0	145512
14528	4038	887	135147	1820	0	141892
14529	2116	136031	3168	1460	0	142775
14530	2126	3135	1469	131072	0	137802
14531	1539	140862	1022	2695	0	146118
14532	1657	3423	784	136105	0	141969
14533	134852	1552	684	4075	0	141163
14534	3740	1134	130212	1850	0	136936
14535	125612	813	3158	1914	0	131497
14536	3842	135289	1631	1251	0	142013
14537	2350	3121	1024	138198	0	144693
14538	1863	1521	820	140901	0	145105
14539	135398	1033	740	4917	0	142088
14540	3894	922	134418	2212	0	141446
14541	2406	687	3179	135809	0	142081
14542	1863	682	1640	136649	0	140834
14543	1585	763	1134	137468	0	140950
14544	1508	735	909	138707	0	141859
14545	134496	671	836	5492	0	141495
14546	134108	610	749	3239	0	138706
14547	4679	640	133606	1772	0	140697
14548	2531	761	129223	1547	0	134062
14549	133705	551	3950	2190	0	140396
14550	140454	556	1741	2029	0	144780
14551	4769	564	1164	138402	0	144899
14552	2744	511	1023	138960	0	143238
14553	136568	434	985	5056	0	143043
14554	3973	135265	1121	2430	0	142789
14555	2484	2683	1020	137455	0	143642
14556	1948	1078	897	140576	0	144499
14557	1637	816	135386	4685	0	142524
14558	1900	587	3093	134956	0	140536
14559	1506	620	136939	4458	0	143523
14560	1728	506	3480	136177	0	141891
14561	134794	571	1777	4668	0	141810
14562	4049	525	1139	136149	0	141862
14563	2246	506	134561	4333	0	141646
14564	1596	128649	3379	2658	0	136282
14565	1821	2801	1577	133965	0	140164
14566	1431	1238	133679	4018	0	140366
14567	1299	133748	3226	2348	0	140621
14568	1660	3077	1358	130897	0	136992
14569	1188	1339	129524	3571	0	135622
14570	107127	718	2848	2968	0	113661
14571	2720	122885	1532	1581	0	128718
14572	1311	117600	950	1308	0	121169
14573	900	121117	791	1115	0	123923
14574	1514	3060	637	115726	0	120937
14575	802	1110	119713	2456	0	124081
14576	737	118210	2295	1363	0	122605
14577	1212	2555	993	115362	0	120122
14578	120399	757	534	2607	0	124297
14579	2722	509	345	158921	0	162497
14580	1131	516	185190	3972	0	190809
14581	696	185551	4603	1617	0	192467
14582	177884	4628	1393	1993	0	185898
14583	4624	184080	1010	1013	0	190727
14584	1519	5291	176025	820	0	183655
14585	850	177540	4938	1138	0	184466
14586	1974	5753	2056	170390	0	180173
14587	823	2587	173437	4284	0	181131
14588	1011	172343	5272	1384	0	180010
14589	2385	5938	1749	165801	0	175873
14590	1755	2896	1680	166725	0	173056
14591	368	171444	1785	5448	0	179045
14592	1540	5861	1485	169867	0	178753
14593	402	2813	170577	6066	0	179858
14594	473	2359	173213	2632	0	178677
14595	1283	2253	5955	170240	0	179731
14596	167995	1836	2200	7546	0	179577
14597	169215	1792	1612	4139	0	176758
14598	5901	1876	1497	164774	0	174048
14599	1731	168019	2206	6211	0	178167
14600	2303	5050	2487	167347	0	177187
14601	165157	1933	2157	7158	0	176405
14602	6494	1412	1335	164517	0	173758
14603	3964	1368	868	168485	0	174685
14604	163653	1430	796	8085	0	173964
14605	5436	163132	1057	4176	0	173801
14606	2928	5806	944	163772	0	173450
14607	161864	2256	833	7819	0	172772
14608	6279	1517	157221	4127	0	169144
14609	156083	1212	4703	4234	0	166232
14610	7234	1310	1476	159751	0	169771
14611	158709	1675	1108	7483	0	168975
14612	160056	1836	985	4396	0	167273
14613	150708	1401	1135	4486	0	157730
14614	7570	155151	1532	2932	0	167185
14615	4303	4924	154550	2307	0	166084
14616	3666	156145	5225	2446	0	167482
14617	153667	5513	1677	3146	0	164003
14618	7503	153931	1330	2192	0	164956
14619	5458	5910	1032	152942	0	165342
14620	148807	2931	1225	6179	0	159142
14621	6405	150628	1572	2500	0	161105
14622	3189	6704	149846	2059	0	161798
14623	3627	3553	5124	147960	0	160264
14624	3012	3058	149697	6047	0	161814
14625	2619	150827	5440	3862	0	162748
14626	2983	6569	2139	146761	0	158452
14627	3041	3231	1955	151513	0	159740
14628	2505	2987	2088	152029	0	159609
14629	2343	2264	2346	146402	0	153355
14630	1530	147156	2250	8053	0	158989
14631	143030	6389	1898	5020	0	156337
14632	5829	3413	143710	4010	0	156962
14633	2859	2587	5427	145847	0	156720
14634	142830	2111	2282	9042	0	156265
14635	6158	2279	143384	5086	0	156907
14636	2985	139994	5815	3934	0	152728
14637	3216	6986	2854	136178	0	149234
14638	2748	3346	139338	6661	0	152093
14639	2310	139552	6693	4288	0	152843
14640	132660	6183	3243	4428	0	146514
14641	6356	138445	2759	3360	0	150920
14642	3271	7337	2496	136079	0	149183
14643	2478	4109	2217	142301	0	151105
14644	135157	3419	2313	8830	0	149719
14645	6123	137328	2675	4711	0	150837
14646	3620	7466	2392	138230	0	151708
14647	133852	4099	2295	7817	0	148063
14648	133358	3682	1966	5201	0	144207
14649	7390	132600	1691	4955	0	146636
14650	132445	7115	1562	4515	0	145637
14651	136076	4284	1376	3974	0	145710
14652	8731	3987	1332	131722	0	145772
14653	4898	3293	128906	8006	0	145103
14654	5092	2707	5496	128602	0	141897
14655	4739	2815	2271	132137	0	141962
14656	4117	2782	126054	8744	0	141697
14657	4215	124593	5723	5006	0	139537
14658	4189	6246	2449	125660	0	138544
14659	3334	2913	2506	130724	0	139477
14660	3015	2372	2725	131822	0	139934
14661	2888	2095	2527	127931	0	135441
14662	2743	124106	2429	9902	0	139180
14663	125640	6142	2209	5929	0	139920
14664	126805	3155	1487	5677	0	137124
14665	125902	2459	1058	5737	0	135156
14666	8076	119094	1154	5802	0	134126
14667	4366	6302	1054	120637	0	132359
14668	3415	3553	117762	8569	0	133299
14669	4291	3594	5033	115645	0	128563
14670	4714	119144	1888	7329	0	133075
14671	116778	5963	1290	4326	0	128357
14672	117395	3380	1077	4266	0	126118
14673	116279	2943	1263	4156	0	124641
14674	7450	110946	1820	3744	0	123960
14675	4000	105768	2255	3390	0	115413
14676	3712	110163	1970	3288	0	119133
14677	4240	6444	105785	2744	0	119213
14678	4630	4335	96537	2650	0	108152
14679	4359	13025	3845	41098	0	62327
14680	28404	390	1513	1067	0	31374
14681	27734	144	167	415	0	28460
14682	757	167	122	28486	0	29532
14683	428	180	124	28023	0	28755
14684	298	160	90	29179	0	29727
14685	297	152	101	29308	0	29858
14686	29009	172	109	894	0	30184
14687	29713	195	91	440	0	30439
14688	812	30493	100	306	0	31711
14689	30731	703	103	392	0	31929
14690	31231	281	122	361	0	31995
14691	31666	209	118	332	0	32325
14692	933	260	28034	305	0	29532
14693	30142	166	496	331	0	31135
14694	865	31224	187	238	0	32514
14695	509	718	121	31820	0	33168
14696	369	321	85	32120	0	32895
14697	274	31250	119	953	0	32596
14698	315	751	133	32827	0	34026
14699	32471	301	127	1033	0	33932
14700	953	180	127	32921	0	34181
14701	433	194	32394	937	0	33958
14702	30960	165	659	538	0	32322
14703	902	33165	232	344	0	34643
14704	489	765	133	33374	0	34761
14705	404	281	96	33813	0	34594
14706	390	206	83	33977	0	34656
14707	341	213	32955	1118	0	34627
14708	317	32457	675	554	0	34003
14709	397	752	192	32756	0	34097
14710	337	321	32127	808	0	33593
14711	374	206	643	31510	0	32733
14712	295	199	31560	879	0	32933
14713	364	235	672	30361	0	31632
14714	243	30703	288	828	0	32062
14715	293	672	181	30794	0	31940
14716	30507	263	141	943	0	31854
14717	30466	211	104	552	0	31333
14718	898	186	30009	373	0	31466
14719	348	138	27841	285	0	28612
14720	244	140	31427	272	0	32083
14721	233	145	804	31537	0	32719
14722	245	118	319	33369	0	34051
14723	196	122	181	33960	0	34459
14724	139	34174	153	1048	0	35514
14725	270	748	137	33817	0	34972
14726	269	290	140	35241	0	35940
14727	244	175	136	36486	0	37041
14728	35687	154	155	1264	0	37260
14729	35949	134	134	665	0	36882
14730	1072	140	36118	391	0	37721
14731	444	146	35706	335	0	36631
14732	35408	109	1022	441	0	36980
14733	37166	122	435	386	0	38109
14734	1113	137	38632	329	0	40211
14735	473	159	37674	323	0	38629
14736	37204	106	1097	441	0	38848
14737	38582	122	438	415	0	39557
14738	1164	144	39481	292	0	41081
14739	612	108	986	38490	0	40196
14740	417	91	408	39609	0	40525
14741	271	40755	320	1138	0	42484
14742	361	875	246	41691	0	43173
14743	291	312	44525	1155	0	46283
14744	426	175	1098	44258	0	45957
14745	392	133	469	45283	0	46277
14746	295	126	44141	1444	0	46006
14747	42285	100	1158	820	0	44363
14748	45063	95	478	567	0	46203
14749	1484	99	330	44323	0	46236
14750	736	99	277	45297	0	46409
14751	44636	84	279	1547	0	46546
14752	44388	106	290	814	0	45598
14753	40879	176	286	876	0	42217
14754	44981	104	267	556	0	45908
14755	1446	43822	247	432	0	45947
14756	43539	949	226	485	0	45199
14757	1238	43523	247	431	0	45439
14758	635	985	225	43757	0	45602
14759	515	320	224	43685	0	44744
14760	381	42833	275	1393	0	44882
14761	511	934	222	43501	0	45168
14762	437	351	225	43187	0	44200
14763	349	42535	201	1492	0	44577
14764	478	994	197	43077	0	44746
14765	478	365	202	43566	0	44611
14766	471	215	225	43772	0	44683
14767	367	211	42539	1533	0	44650
14768	362	41070	1014	729	0	43175
14769	478	1106	416	39585	0	41585
14770	341	41361	306	1130	0	43138
14771	40736	998	240	691	0	42665
14772	1095	369	40484	506	0	42454
14773	507	297	39081	464	0	40349
14774	38206	200	1050	514	0	39970
14775	1126	253	465	39250	0	41094
14776	391	154	38254	1015	0	39814
14777	343	183	37428	516	0	38470
14778	405	342	982	36810	0	38539
14779	36608	106	409	1123	0	38246
14780	36775	116	266	557	0	37714
14781	1130	113	251	36366	0	37860
14782	486	154	35766	976	0	37382
14783	317	37600	782	543	0	39242
14784	376	768	351	37858	0	39353
14785	301	284	37851	939	0	39375
14786	257	37512	804	550	0	39123
14787	399	743	353	37013	0	38508
14788	36798	254	207	961	0	38220
14789	855	202	173	35877	0	37107
14790	353	36311	249	875	0	37788
14791	36110	714	205	649	0	37678
14792	808	279	38018	420	0	39525
14793	404	37476	717	361	0	38958
14794	349	687	37511	310	0	38857
14795	36108	279	783	435	0	37605
14796	862	171	355	35726	0	37114
14797	441	156	249	37476	0	38322
14798	37441	139	206	987	0	38773
14799	850	99	262	37632	0	38843
14800	350	151	37022	848	0	38371
14801	34922	131	718	577	0	36348
14802	807	37514	362	346	0	39029
14803	461	596	231	36969	0	38257
14804	36820	254	196	902	0	38172
14805	770	36622	223	436	0	38051
14806	462	622	161	37884	0	39129
14807	37939	283	185	962	0	39369
14808	772	201	199	38036	0	39208
14809	394	37687	153	854	0	39088
14810	273	671	38140	461	0	39545
14811	333	294	611	38848	0	40086
14812	513	206	277	36581	0	37577
14813	39440	162	191	1049	0	40842
14814	818	165	146	39801	0	40930
14815	39675	142	158	994	0	40969
14816	39876	185	132	593	0	40786
14817	1024	147	119	39370	0	40660
14818	466	39690	144	784	0	41084
14819	369	697	93	39626	0	40785
14820	36568	284	94	1010	0	37956
14821	787	37181	94	470	0	38532
14822	254	38184	81	336	0	38855
14823	37955	688	104	402	0	39149
14824	38675	275	85	354	0	39389
14825	753	38661	104	270	0	39788
14826	38838	687	177	341	0	40043
14827	38834	250	102	259	0	39445
14828	905	179	84	38865	0	40033
14829	347	149	40228	708	0	41432
14830	389	232	651	40034	0	41306
14831	205	167	41014	825	0	42211
14832	329	221	728	40854	0	42132
14833	165	131	41516	840	0	42652
14834	38865	76	726	459	0	40126
14835	830	95	325	39706	0	40956
14836	41347	53	158	851	0	42409
14837	926	148	162	40406	0	41642
14838	366	41075	101	774	0	42316
14839	41670	638	98	558	0	42964
14840	844	320	39832	254	0	41250
14841	38321	186	523	345	0	39375
14842	742	39787	273	137	0	40939
14843	37025	522	121	276	0	37944
14844	37584	228	92	239	0	38143
14845	824	37865	90	128	0	38907
14846	488	603	99	39324	0	40514
14847	39449	222	65	847	0	40583
14848	781	39639	90	304	0	40814
14849	533	689	52	40047	0	41321
14850	40457	285	56	931	0	41729
14851	968	188	41	40533	0	41730
14852	527	136	61	40493	0	41217
14853	429	122	53	41123	0	41727
14854	293	157	39862	1047	0	41359
14855	375	124	669	39881	0	41049
14856	40426	124	254	1063	0	41867
14857	893	145	40291	465	0	41794
14858	580	103	723	40507	0	41913
14859	451	113	280	41243	0	42087
14860	263	131	40568	1100	0	42062
14861	39053	100	793	738	0	40684
14862	41487	105	331	539	0	42462
14863	1099	118	41583	324	0	43124
14864	647	95	805	40974	0	42521
14865	453	87	331	42848	0	43719
14866	279	122	44851	1165	0	46417
14867	458	73	913	45531	0	46975
14868	463	88	382	45489	0	46422
14869	268	112	47726	1385	0	49491
14870	46257	92	1074	827	0	48250
14871	1260	65	425	49268	0	51018
14872	48643	71	306	1479	0	50499
14873	49237	79	216	834	0	50366
14874	1511	88	49075	509	0	51183
14875	803	71	1163	48469	0	50506
14876	49215	55	447	1528	0	51245
14877	1276	50188	340	743	0	52547
14878	727	1063	247	51867	0	53904
14879	610	343	235	52600	0	53788
14880	483	181	223	54157	0	55044
14881	313	128	52809	1863	0	55113
14882	48312	98	1353	1074	0	50837
14883	1474	97	484	50806	0	52861
14884	746	70	334	51496	0	52646
14885	454	100	50609	1833	0	52996
14886	559	76	1286	50100	0	52021
14887	454	76	522	51903	0	52955
14888	49934	80	367	2081	0	52462
14889	1373	49935	297	972	0	52577
14890	600	1142	50054	708	0	52504
14891	49538	368	1340	704	0	51950
14892	1547	205	504	49040	0	51296
14893	664	153	49824	1618	0	52259
14894	509	144	50576	799	0	52028
14895	509	131	1579	51194	0	53413
14896	343	119	52742	1652	0	54856
14897	392	166	51981	854	0	53393
14898	335	51388	1713	701	0	54137
14899	444	1119	710	54716	0	56989
14900	349	391	55268	1582	0	57590
14901	489	240	1418	54173	0	56320
14902	57090	167	675	1926	0	59858
14903	1497	122	495	57527	0	59641
14904	726	142	372	59202	0	60442
14905	57553	111	374	2152	0	60190
14906	58658	126	395	1095	0	60274
14907	1812	127	365	60872	0	63176
14908	757	136	61657	1781	0	64331
14909	479	60916	1538	974	0	63907
14910	485	1232	676	62282	0	64675
14911	61780	413	497	1924	0	64614
14912	62427	233	440	1064	0	64164
14913	1842	60615	433	760	0	63650
14914	750	63019	412	671	0	64852
14915	63136	1529	387	772	0	65824
14916	63477	537	360	802	0	65176
14917	1931	349	66120	607	0	69007
14918	1056	254	1513	64084	0	66907
14919	618	67229	638	1704	0	70189
14920	69213	1356	481	1015	0	72065
14921	1822	600	419	68279	0	71120
14922	753	67632	402	1749	0	70536
14923	587	1393	68885	862	0	71727
14924	740	807	1460	64979	0	67986
14925	402	71394	643	1571	0	74010
14926	71862	1352	439	1028	0	74681
14927	72110	524	327	843	0	73804
14928	1711	71953	313	576	0	74553
14929	70238	1244	273	634	0	72389
14930	69757	466	270	626	0	71119
14931	1600	69374	269	518	0	71761
14932	674	71128	288	485	0	72575
14933	694	1404	293	70609	0	73000
14934	70722	511	234	1547	0	73014
14935	1324	353	73536	671	0	75884
14936	68863	272	1143	693	0	70971
14937	1256	74266	470	442	0	76434
14938	74718	1114	328	587	0	76747
14939	75479	462	253	536	0	76730
14940	76364	295	213	549	0	77421
14941	1743	277	240	74396	0	76656
14942	729	75003	262	1228	0	77222
14943	75695	1083	207	744	0	77729
14944	1361	499	76032	388	0	78280
14945	617	76003	1178	326	0	78124
14946	568	1129	357	78930	0	80984
14947	402	439	76403	1100	0	78344
14948	421	337	76007	455	0	77220
14949	577	322	1289	75408	0	77596
14950	479	224	489	80213	0	81405
14951	475	206	328	81341	0	82350
14952	530	205	215	79321	0	80271
14953	362	77423	246	1455	0	79486
14954	355	81044	254	625	0	82278
14955	82160	1197	178	665	0	84200
14956	1300	486	187	82401	0	84374
14957	670	315	172	82928	0	84085
14958	518	247	194	84503	0	85462
14959	83568	250	197	1683	0	85698
14960	84207	224	196	800	0	85427
14961	1491	260	163	84425	0	86339
14962	85799	222	196	1470	0	87687
14963	85637	188	201	839	0	86865
14964	87355	221	169	736	0	88481
14965	1620	266	152	85987	0	88025
14966	661	252	81482	1071	0	83466
14967	603	329	74821	491	0	76244
14968	464	293	79027	357	0	80141
14969	383	230	82246	278	0	83137
14970	569	401	1003	81529	0	83502
14971	83010	122	369	1093	0	84594
14972	81794	134	198	662	0	82788
14973	1010	165	82257	284	0	83716
14974	567	179	81636	263	0	82645
14975	335	91435	846	273	0	92889
14976	520	702	336	92621	0	94179
14977	93379	239	273	1079	0	94970
14978	804	188	93040	323	0	94355
14979	87839	130	631	596	0	89196
14980	725	97526	360	214	0	98825
14981	432	635	218	100912	0	102197
14982	383	229	189	104651	0	105452
14983	465	175	188	101543	0	102371
14984	105460	111	155	1587	0	107313
14985	1157	109	106	105668	0	107040
14986	712	112	111	106524	0	107459
14987	106372	102	143	1560	0	108177
14988	1173	123	161	105601	0	107058
14989	542	195	107360	1154	0	109251
14990	103904	124	882	1006	0	105916
14991	1244	88	385	108832	0	110549
14992	798	98	275	107013	0	108184
14993	391	107400	203	1249	0	109243
14994	108355	903	97	995	0	110350
14995	109362	410	109	786	0	110667
14996	1553	192	105	108409	0	110259
14997	686	179	108729	1104	0	110698
14998	99024	104	1004	1043	0	101175
14999	1247	139	109265	410	0	111061
15000	860	102	1150	106700	0	108812
15001	622	89	466	111846	0	113023
15002	110440	95	278	1837	0	112650
15003	1512	74	228	113719	0	115533
15004	664	179	113703	1406	0	115952
15005	107716	82	1186	1153	0	110137
15006	1398	124	119948	546	0	122016
15007	706	227	118093	354	0	119380
15008	121153	96	1986	665	0	123900
15009	2101	250	751	126012	0	129114
15010	751	130569	437	1478	0	133235
15011	131147	1428	320	1092	0	133987
15012	130676	493	297	872	0	132338
15013	2173	318	130749	345	0	133585
15014	127755	129	1655	720	0	130259
15015	2200	154	644	131430	0	134428
15016	896	231	134113	1638	0	136878
15017	599	130407	1720	853	0	133579
15018	129185	1474	678	1048	0	132385
15019	1629	132279	460	425	0	134793
15020	1184	1651	399	131463	0	134697
15021	878	652	288	132802	0	134620
15022	817	300	306	132085	0	133508
15023	871	230	208	127609	0	128918
15024	384	128585	334	2308	0	131611
15025	476	1578	125079	954	0	128087
15026	393	127123	1575	735	0	129826
15027	126695	1615	668	796	0	129774
15028	1873	717	373	126828	0	129791
15029	127776	361	304	2069	0	130510
15030	2061	334	272	128698	0	131365
15031	131843	266	274	2526	0	134909
15032	1868	134430	294	978	0	137570
15033	136519	1651	230	1187	0	139587
15034	137393	643	288	1096	0	139420
15035	133740	394	239	1015	0	135388
15036	134756	272	222	1104	0	136354
15037	2438	133510	257	556	0	136761
15038	1214	1642	134397	401	0	137654
15039	1152	651	1565	133858	0	137226
15040	134900	415	613	2268	0	138196
15041	138154	305	398	1194	0	140051
15042	2689	255	265	139550	0	142759
15043	1302	292	144315	2026	0	147935
15044	1222	244	1859	139653	0	142978
15045	750	145042	797	2135	0	148724
15046	145951	2115	448	1428	0	149942
15047	2702	819	384	146578	0	150483
15048	1187	143727	421	2387	0	147722
15049	923	151881	322	1072	0	154198
15050	702	155806	324	853	0	157685
15051	891	3106	308	156983	0	161288
15052	157164	1256	341	3142	0	161903
15053	2677	159552	321	1277	0	163827
15054	1610	2659	279	161664	0	166212
15055	160034	1021	244	3344	0	164643
15056	3205	667	275	160818	0	164965
15057	159803	558	289	3622	0	164272
15058	160637	492	211	1916	0	163256
15059	3587	167213	275	903	0	171978
15060	2287	2695	233	159253	0	164468
15061	1160	168604	312	2304	0	172380
15062	166258	3043	240	1616	0	171157
15063	166265	1265	294	1448	0	169272
15064	169555	853	282	1202	0	171892
15065	4316	580	375	168616	0	173887
15066	2086	576	167006	2877	0	172545
15067	160470	602	2568	1842	0	165482
15068	168438	543	936	1515	0	171432
15069	4278	541	536	164070	0	169425
15070	1995	168906	484	2870	0	174255
15071	1915	2823	352	170258	0	175348
15072	1575	1337	332	173776	0	177020
15073	172098	964	366	4258	0	177686
15074	169413	743	344	2442	0	172942
15075	4063	814	162103	1185	0	168165
15076	2407	621	2667	160831	0	166526
15077	163481	599	954	3682	0	168716
15078	4094	675	607	163972	0	169348
15079	1759	773	163785	3854	0	170171
15080	1283	153731	2949	1956	0	159919
15081	1194	161914	991	1428	0	165527
15082	175098	3362	567	1568	0	180595
15083	4268	1421	408	185309	0	191406
15084	2365	1003	346	208129	0	211843
15085	206582	742	368	6825	0	214517
15086	5970	806	205336	2963	0	215075
15087	3734	640	4728	206205	0	215307
15088	2140	737	209068	6031	0	217976
15089	1648	209722	5590	2950	0	219910
15090	212983	5137	2441	2724	0	223285
15091	218096	2247	1383	2362	0	224088
15092	221777	1395	1159	2063	0	226394
15093	8223	1317	213855	1353	0	224748
15094	215861	1127	5128	1821	0	223937
15095	224153	977	2208	1631	0	228969
15096	9433	869	1358	218612	0	230272
15097	182414	1192	2288	8224	0	194118
15098	6559	874	214946	2933	0	225312
15099	210378	751	5107	2519	0	218755
15100	7590	794	214389	1623	0	224396
15101	4218	217444	5680	1950	0	229292
15102	3799	6591	3038	198149	0	211577
15103	2647	217797	1859	4963	0	227266
15104	2813	5710	213359	2138	0	224020
15105	2327	217297	5443	1754	0	226821
15106	203501	5502	2374	2080	0	213457
15107	5262	201017	1755	1246	0	209280
15108	2868	201779	1317	1233	0	207197
15109	2381	6435	195898	984	0	205698
15110	2344	3284	4818	192600	0	203046
15111	196049	2195	2240	5177	0	205661
15112	5383	1919	195391	2219	0	204912
15113	3043	196310	5094	1712	0	206159
15114	2816	4997	2569	194176	0	204558
15115	1942	2781	197683	5170	0	207576
15116	1958	1717	195854	2820	0	202349
15117	2329	1704	6552	195397	0	205982
15118	1746	1351	199428	5574	0	208099
15119	2120	1426	6344	181083	0	190973
15120	1689	190076	3429	5258	0	200452
15121	2193	4949	2340	189274	0	198756
15122	1645	194158	2120	5508	0	203431
15123	2362	5376	1748	194498	0	203984
15124	191701	2571	1620	6616	0	202508
15125	6011	1822	1422	191369	0	200624
15126	2959	191859	1542	6156	0	202516
15127	2574	5296	1193	196458	0	205521
15128	2200	2575	194234	6446	0	205455
15129	2291	1823	5264	194340	0	203718
15130	193047	1546	2937	6928	0	204458
15131	5515	1548	188614	3640	0	199317
15132	3313	1616	5650	186571	0	197150
15133	183117	1297	2804	6944	0	194162
15134	5735	182931	2133	3514	0	194313
15135	3625	5122	1987	183781	0	194515
15136	184747	2809	1631	6380	0	195567
15137	6595	1875	1659	185096	0	195225
15138	3580	1829	182134	6283	0	193826
15139	174623	1741	5184	4364	0	185912
15140	6092	178974	2986	2767	0	190819
15141	3262	183778	2090	2829	0	191959
15142	181149	5612	2259	2660	0	191680
15143	178052	2750	1881	2243	0	184926
15144	7309	2188	1625	174382	0	185504
15145	175176	1851	1715	5372	0	184114
15146	6300	1861	169003	3099	0	180263
15147	167949	1593	4720	3073	0	177335
15148	6090	169358	2800	2429	0	180677
15149	168598	4267	2225	2573	0	177663
15150	6227	2397	167356	2032	0	178012
15151	4256	1977	5073	165468	0	176774
15152	3218	1782	3114	167151	0	175265
15153	3073	1878	2216	156966	0	164133
15154	2531	164506	2069	5787	0	174893
15155	165725	4465	1664	3667	0	175521
15156	5954	2368	1812	154766	0	164900
15157	3920	159485	1709	5160	0	170274
15158	171355	4352	1675	3950	0	181332
15159	166037	2608	1703	3059	0	173407
15160	169652	1914	1685	2862	0	176113
15161	168747	1754	1624	2755	0	174880
15162	166921	1642	1659	2467	0	172689
15163	7641	1593	1755	163023	0	174012
15164	5222	1742	1700	163308	0	171972
15165	161581	1644	1404	6560	0	171189
15166	6085	1990	1314	161714	0	171103
15167	4187	2058	1388	162856	0	170489
15168	2927	2083	153576	6929	0	165515
15169	155221	1924	4270	4407	0	165822
15170	159389	1805	2673	3822	0	167689
15171	161004	2359	1772	3094	0	168229
15172	7157	2054	1905	146189	0	157305
15173	4225	154041	1764	5061	0	165091
15174	164593	4209	1885	3572	0	174259
15175	160462	2432	1746	3398	0	168038
15176	8045	1835	1534	171052	0	182466
15177	171780	1743	1762	6479	0	181764
15178	7553	3097	137418	5224	0	153292
15179	4704	171316	4336	3415	0	183771
15180	4245	178219	2806	3636	0	188906
15181	4401	6433	174211	2830	0	187875
15182	2125	153361	5064	2517	0	163067
15183	1944	146219	2876	2332	0	153371
15184	123552	3033	2228	1580	0	130393
15185	2360	123984	917	1212	0	128473
15186	1915	2805	757	125114	0	130591
15187	128033	1585	521	3139	0	133278
15188	2856	1346	124112	1697	0	130011
15189	121351	987	1951	1909	0	126198
15190	3083	990	121533	1241	0	126847
15191	1975	657	119791	1105	0	123528
15192	116524	624	2797	1381	0	121326
15193	2706	572	122177	1022	0	126477
15194	1607	118179	2474	727	0	122987
15195	1803	1980	1652	116230	0	121665
15196	117163	1125	950	2372	0	121610
15197	2417	114550	581	1309	0	118857
15198	1745	1974	552	115306	0	119577
15199	1226	1254	114763	2220	0	119463
15200	1475	841	1731	114349	0	118396
15201	112254	562	1121	2793	0	116730
15202	2489	569	111143	1497	0	115698
15203	2080	478	1953	110087	0	114598
15204	111706	536	1150	2567	0	115959
15205	114392	431	840	1814	0	117477
15206	3738	383	582	113093	0	117796
15207	2564	448	476	113390	0	116878
15208	1498	594	115502	2861	0	120455
15209	1383	480	111194	1772	0	114829
15210	112224	367	2543	1535	0	116669
15211	118069	429	1384	1208	0	121090
15212	3007	116961	942	850	0	121760
15213	117166	1697	737	773	0	120373
15214	119689	909	531	1006	0	122135
15215	3286	783	126844	540	0	131453
15216	1901	130818	2022	551	0	135292
15217	132252	1962	1249	944	0	136407
15218	132894	971	708	732	0	135305
15219	136318	646	458	605	0	138027
15220	3641	490	328	132839	0	137298
15221	2226	361	267	133819	0	136673
15222	1317	133130	359	2613	0	137419
15223	1067	1922	290	136715	0	139994
15224	135334	966	215	3049	0	139564
15225	2581	691	218	136046	0	139536
15226	1360	558	133945	2781	0	138644
15227	1217	503	129339	1426	0	132485
15228	1108	231	2742	131498	0	135579
15229	691	263	135522	2468	0	138944
15230	692	445	131465	1420	0	134022
15231	1007	221	3266	130239	0	134733
15232	946	231	1764	135452	0	138393
15233	623	263	137489	3125	0	141500
15234	639	301	136217	1752	0	138909
15235	450	138544	3206	1227	0	143427
15236	138322	2129	1771	1304	0	143526
15237	2278	143558	1164	788	0	147788
15238	143345	2594	791	1000	0	147730
15239	144926	1284	612	919	0	147741
15240	3252	146442	571	443	0	150708
15241	147752	2594	496	703	0	151545
15242	3493	1312	371	145460	0	150636
15243	1736	907	147407	2369	0	152419
15244	1676	576	2440	143513	0	148205
15245	1105	497	1141	150115	0	152858
15246	142360	351	856	4099	0	147666
15247	143241	263	666	2362	0	146532
15248	144843	274	574	1695	0	147386
15249	144211	335	477	1305	0	146328
15250	139730	291	367	1161	0	141549
15251	4279	134661	486	645	0	140071
15252	2577	2199	406	138310	0	143492
15253	1580	1117	139487	2557	0	144741
15254	1568	747	2467	138148	0	142930
15255	1438	466	1268	138416	0	141588
15256	1066	362	956	147868	0	150252
15257	154667	289	743	4729	0	160428
15258	3954	246	591	155119	0	159910
15259	157606	293	512	5029	0	163440
15260	4685	378	160903	2156	0	168122
15261	2986	299	3745	186709	0	193739
15262	1683	349	194560	5636	0	202228
15263	191986	283	5820	2796	0	200885
15264	6443	382	2115	195428	0	204368
15265	2418	469	198782	5864	0	207533
15266	2349	299	5696	198411	0	206755
15267	199906	264	2340	7170	0	209680
15268	5954	414	200402	2896	0	209666
15269	199077	287	5580	2736	0	207680
15270	208501	242	2311	2145	0	213199
15271	206493	230	1606	2138	0	210467
15272	204435	227	1169	2160	0	207991
15273	8286	197398	1179	1281	0	208144
15274	3426	191413	1032	1244	0	197115
15275	2633	188516	1088	1128	0	193365
15276	2671	7212	1109	169414	0	180406
15277	1334	177990	906	4001	0	184231
15278	173452	4453	812	2041	0	180758
15279	4615	170589	823	1257	0	177284
15280	1972	175829	789	1037	0	179627
15281	2238	4911	778	173512	0	181439
15282	1994	1820	705	178042	0	182561
15283	174390	1182	764	5949	0	182285
15284	5498	887	726	174668	0	181779
15285	2357	826	170633	5168	0	178984
15286	1959	1000	161226	2176	0	166361
15287	1845	831	168401	1476	0	172553
15288	2509	726	5322	163602	0	172159
15289	2417	694	1926	176381	0	181418
15290	1739	914	171451	5724	0	179828
15291	1773	975	166852	2326	0	171926
15292	1506	1076	174220	1529	0	178331
15293	173311	1086	6066	1805	0	182268
15294	5736	1060	2376	175658	0	184830
15295	2688	1107	1454	179988	0	185237
15296	177372	1054	1209	6748	0	186383
15297	5679	1043	1085	176080	0	183887
15298	2180	175389	1130	5998	0	184697
15299	1687	184263	1072	2842	0	189864
15300	2024	5475	979	182794	0	191272
15301	181829	1991	951	6670	0	191441
15302	183162	1134	1112	3597	0	189005
15303	185898	816	1295	2738	0	190747
15304	6992	690	1284	182726	0	191692
15305	2877	703	179790	5851	0	189221
15306	2475	562	5386	179186	0	187609
15307	1708	655	179778	6203	0	188344
15308	170457	533	5913	3487	0	180390
15309	6031	615	2699	174460	0	183805
15310	169927	492	1995	6807	0	179221
15311	5837	572	173254	3011	0	182674
15312	160994	534	5546	3050	0	170124
15313	6485	578	177273	2155	0	186491
15314	3285	167087	5435	2061	0	177868
15315	2375	169262	2243	1968	0	175848
15316	163635	5398	1585	2222	0	172840
15317	6410	2055	1119	162299	0	171883
15318	2937	1482	163808	5376	0	173603
15319	2298	160806	4735	2566	0	170405
15320	2036	167895	2085	1789	0	173805
15321	2344	5741	1360	165367	0	174812
15322	165355	2217	1270	5999	0	174841
15323	166679	1418	1222	3124	0	172443
15324	6233	165425	1395	2387	0	175440
15325	166632	4980	1383	2322	0	175317
15326	6445	1889	1450	165938	0	175722
15327	2994	1464	165148	5702	0	175308
15328	2280	165861	5332	2920	0	176393
15329	2622	4861	2443	166090	0	176016
15330	2360	1882	1764	169107	0	175113
15331	165675	1279	1670	6970	0	175594
15332	6059	1280	163637	2725	0	173701
15333	161068	1226	5265	2477	0	170036
15334	165888	1200	2350	2128	0	171566
15335	6898	1260	1771	161496	0	171425
15336	3569	1220	1397	165864	0	172050
15337	158858	1431	1301	6900	0	168490
15338	6321	1434	1208	159784	0	168747
15339	2735	1511	157334	6176	0	167756
15340	2109	1369	155287	2790	0	161555
15341	1983	151985	5617	2174	0	161759
15342	1971	164169	2168	2095	0	170403
15343	2457	5763	1279	152073	0	161572
15344	1919	156576	1120	5166	0	164781
15345	157233	5329	1225	3280	0	167067
15346	5257	160651	1210	2382	0	169500
15347	2792	5278	1141	160591	0	169802
15348	2092	2326	1136	165071	0	170625
15349	1653	1655	160624	6807	0	170739
15350	2340	1149	5120	158652	0	167261
15351	2219	925	2296	163429	0	168869
15352	1817	163775	1809	6688	0	174089
15353	2283	4718	1494	164288	0	172783
15354	2198	1803	1410	168805	0	174216
15355	2033	1300	163406	7257	0	173996
15356	1467	159648	5404	3740	0	170259
15357	1824	10512	1838	138480	0	152654
15358	1214	147756	1281	4574	0	154825
15359	1102	4028	142087	2282	0	149499
15360	869	136671	3966	1731	0	143237
15361	106226	3272	2177	1828	0	113503
15362	102651	902	541	970	0	105064
15363	102545	599	392	913	0	104449
15364	2251	102991	342	481	0	106065
15365	101453	1919	233	776	0	104381
15366	2295	823	246	100025	0	103389
15367	97359	546	274	2312	0	100491
15368	1980	96020	281	908	0	99189
15369	95126	1923	269	1078	0	98396
15370	97461	807	227	1158	0	99653
15371	2417	99830	287	645	0	103179
15372	1142	2188	99817	455	0	103602
15373	1120	1029	2012	107097	0	111258
15374	660	709	115462	2446	0	119277
15375	1055	534	2726	117135	0	121450
15376	948	469	985	124981	0	127383
15377	484	506	126360	3896	0	131246
15378	914	472	3094	125885	0	130365
15379	126444	394	1479	4266	0	132583
15380	3237	468	127046	1529	0	132280
15381	1206	126947	3325	1121	0	132599
15382	1430	3133	1159	122927	0	128649
15383	1183	1092	728	129393	0	132396
15384	683	796	127072	4186	0	132737
15385	1250	578	3171	119937	0	124936
15386	501	125784	1206	3634	0	131125
15387	120918	3199	826	2074	0	127017
15388	2846	123448	710	1179	0	128183
15389	114556	3130	414	1362	0	119462
15390	2888	115690	592	745	0	119915
15391	889	120362	492	804	0	122547
15392	817	3501	114285	568	0	119171
15393	1084	1370	2993	112236	0	117683
15394	1056	949	941	111015	0	113961
15395	852	681	640	115316	0	117489
15396	420	120547	552	3879	0	125398
15397	862	3436	479	121113	0	125890
15398	119618	1298	460	4520	0	125896
15399	3835	933	485	120332	0	125585
15400	119512	629	452	4852	0	125445
15401	4048	638	119237	1935	0	125858
15402	118792	590	3544	1707	0	124633
15403	4434	650	1248	118512	0	124844
15404	1998	655	853	125033	0	128539
15405	124320	613	676	5385	0	130994
15406	4144	688	124568	2316	0	131716
15407	1540	123906	3967	1675	0	131088
15408	1560	3746	1372	125536	0	132214
15409	124696	1490	942	4780	0	131908
15410	128268	1063	637	2299	0	132267
15411	5368	903	491	126417	0	133179
15412	2059	790	125087	4587	0	132523
15413	118930	760	3813	2374	0	125877
15414	4357	795	122023	1601	0	128776
15415	2358	722	4290	120019	0	127389
15416	1378	684	121941	4646	0	128649
15417	1457	733	4238	119716	0	126144
15418	1063	589	118283	5027	0	124962
15419	990	117602	4353	2505	0	125450
15420	1777	3758	1821	103497	0	110853
15421	934	118843	1301	3672	0	124750
15422	118293	3977	923	2151	0	125344
15423	120647	1527	856	1912	0	124942
15424	4910	1159	117192	1310	0	124571
15425	2665	837	3858	116527	0	123887
15426	118388	766	1640	4625	0	125419
15427	4647	722	1217	117237	0	123823
15428	2462	691	974	118780	0	122907
15429	1635	669	114883	5321	0	122508
15430	109816	633	4052	2995	0	117496
15431	4361	596	115602	2082	0	122641
15432	2434	592	4328	114398	0	121752
15433	1673	595	115846	4706	0	122820
15434	113666	637	4473	2761	0	121537
15435	115771	501	2118	2422	0	120812
15436	116778	578	1716	1888	0	120960
15437	5724	542	1398	113870	0	121534
15438	2601	606	112158	4554	0	119919
15439	1877	697	114871	2494	0	119939
15440	1910	853	4823	105547	0	113133
15441	1414	112342	2515	4240	0	120511
15442	109059	3490	1759	2484	0	116792
15443	4568	1444	1364	109466	0	116842
15444	2247	1104	109063	4597	0	117011
15445	2136	845	4093	110147	0	117221
15446	1686	703	112679	4940	0	120008
15447	1871	790	4561	113432	0	120654
15448	1640	644	115070	5136	0	122490
15449	1634	701	115101	2722	0	120158
15450	1441	112143	5137	2407	0	121128
15451	1409	3357	113204	1971	0	119941
15452	1482	1357	113805	1905	0	118549
15453	2142	1155	5215	93841	0	102353
15454	1728	673	2675	102240	0	107316
15455	1418	107168	1948	4429	0	114963
15456	106950	3195	1729	2645	0	114519
15457	3972	106768	1677	1920	0	114337
15458	2314	3494	1610	106632	0	114050
15459	107493	1440	1572	4286	0	114791
15460	4188	941	1478	107637	0	114244
15461	107834	758	1647	4755	0	114994
15462	4493	620	1535	109768	0	116416
15463	2127	829	110575	4765	0	118296
15464	1979	792	3938	110967	0	117676
15465	1703	654	2059	114581	0	118997
15466	111615	654	1913	5418	0	119600
15467	112044	498	1666	3255	0	117463
15468	110498	543	1623	2501	0	115165
15469	4753	104844	1823	1997	0	113417
15470	2208	106185	1493	1910	0	111796
15471	105351	3271	1678	1940	0	112240
15472	3840	1433	105863	1660	0	112796
15473	1932	931	99476	1470	0	103809
15474	1908	3186	3940	87845	0	96879
15475	1036	534	89180	2834	0	93584
15476	989	378	84194	1521	0	87082
15477	76207	538	3433	1543	0	81721
15478	79470	353	1530	1223	0	82576
15479	2901	79489	1064	945	0	84399
15480	1547	82829	882	936	0	86194
15481	1378	2376	896	72896	0	77546
15482	872	81749	861	1974	0	85456
15483	83247	2144	848	1453	0	87692
15484	2540	1004	774	80150	0	84468
15485	1343	83418	729	2213	0	87703
15486	85217	1969	789	1437	0	89412
15487	2443	964	85079	998	0	89484
15488	1335	725	83329	895	0	86284
15489	83090	428	2864	1082	0	87464
15490	2438	471	83491	898	0	87298
15491	81343	331	2438	912	0	85024
15492	2688	496	1334	83091	0	87609
15493	1230	466	83791	2104	0	87591
15494	935	80993	2333	1209	0	85470
15495	826	83814	1286	893	0	86819
15496	74693	1587	803	718	0	77801
15497	1408	76818	603	496	0	79325
15498	73307	1231	518	649	0	75705
15499	73408	457	553	608	0	75026
15500	1492	73518	530	309	0	75849
15501	845	1190	453	72845	0	75333
15502	453	464	74557	1188	0	76662
15503	362	77916	1426	486	0	80190
15504	665	2467	611	76225	0	79968
15505	579	595	482	83362	0	85018
15506	81588	275	158	1833	0	83854
15507	1562	225	169	81354	0	83310
15508	483	270	80932	1620	0	83305
15509	326	80415	1351	692	0	82784
15510	516	1351	431	81814	0	84112
15511	81743	435	328	1859	0	84365
15512	84227	320	249	768	0	85564
15513	2022	232	214	84535	0	87003
15514	87222	218	214	1996	0	89650
15515	2157	224	87659	665	0	90705
15516	1168	156	1837	87051	0	90212
15517	576	247	89540	2012	0	92375
15518	776	189	2022	95608	0	98595
15519	711	190	817	95369	0	97087
15520	783	180	456	96558	0	97977
15521	654	158	359	96429	0	97600
15522	650	152	323	96230	0	97355
15523	94097	178	240	3899	0	98414
15524	95714	155	218	1983	0	98070
15525	2932	95395	295	1116	0	99738
15526	96656	2235	253	1136	0	100280
15527	3044	758	230	96652	0	100684
15528	1559	446	203	98345	0	100553
15529	1293	325	281	97719	0	99618
15530	732	264	98039	3609	0	102644
15531	1029	242	2433	91889	0	95593
15532	524	96640	866	3082	0	101112
15533	96672	2362	534	1775	0	101343
15534	96832	768	432	1513	0	99545
15535	3212	523	95358	1006	0	100099
15536	1302	95479	2456	1098	0	100335
15537	1202	2394	824	96011	0	100431
15538	820	903	97394	2998	0	102115
15539	1068	583	2563	89390	0	93604
15540	666	94423	941	2987	0	99017
15541	91169	2492	646	1851	0	96158
15542	2671	93847	529	1249	0	98296
15543	1187	2755	93476	960	0	98378
15544	960	1151	92972	862	0	95945
15545	710	90237	3018	986	0	94951
15546	572	92014	1159	939	0	94684
15547	87965	2918	901	1183	0	92967
15548	89283	1197	587	1087	0	92154
15549	3341	819	552	87836	0	92548
15550	1365	714	87821	2864	0	92764
15551	1300	572	2447	86795	0	91114
15552	1160	505	999	88514	0	91178
15553	86178	468	678	3853	0	91177
15554	86132	585	641	1826	0	89184
15555	3520	514	518	89646	0	94198
15556	1464	561	90490	3204	0	95719
15557	973	90790	2716	1629	0	96108
15558	90418	2689	1129	1532	0	95768
15559	2914	93855	753	1129	0	98651
15560	1610	3111	602	95081	0	100404
15561	1387	1258	560	99519	0	102724
15562	1203	886	646	98803	0	101538
15563	1090	758	597	96797	0	99242
15564	93287	751	589	4571	0	99198
15565	3447	658	457	93561	0	98123
15566	1566	91859	491	3992	0	97908
15567	1403	2677	506	93787	0	98373
15568	90113	1150	539	4363	0	96165
15569	2994	91064	590	2313	0	96961
15570	1673	2919	590	91748	0	96930
15571	1139	1301	89348	3801	0	95589
15572	88032	911	2668	2164	0	93775
15573	3634	821	1054	89113	0	94622
15574	1650	717	87452	3586	0	93405
15575	1230	740	86923	1921	0	90814
15576	1342	836	3511	86644	0	92333
15577	86138	651	1632	3876	0	92297
15578	86774	638	982	2384	0	90778
15579	3502	88150	749	1919	0	94320
15580	86930	2645	588	2025	0	92188
15581	88632	1065	544	1973	0	92214
15582	88239	769	610	1805	0	91423
15583	87669	722	569	1689	0	90649
15584	4399	605	555	84882	0	90441
15585	2428	698	555	86241	0	89922
15586	1758	695	81452	4068	0	87973
15587	1307	76355	2591	2351	0	82604
15588	1104	80554	1215	1917	0	84790
15589	1007	3025	79776	1686	0	85494
15590	78180	1200	2685	1657	0	83722
15591	3174	934	1204	79970	0	85282
15592	80296	733	861	3485	0	85375
15593	80983	686	768	1961	0	84398
15594	3824	717	77920	1370	0	83831
15595	2251	722	2548	77673	0	83194
15596	79063	573	1103	3284	0	84023
15597	3543	631	801	78356	0	83331
15598	1808	704	77841	3392	0	83745
15599	1611	2424	2570	72579	0	79184
15600	1345	77894	1311	2965	0	83515
15601	1150	81031	833	1622	0	84636
15602	1140	2889	76809	1324	0	82162
15603	967	73695	2469	1007	0	78138
15604	67791	2534	1256	1360	0	72941
15605	65978	853	703	906	0	68440
15606	2566	518	557	64671	0	68312
15607	1369	428	502	65460	0	67759
15608	1035	432	390	66780	0	68637
15609	64148	368	336	2756	0	67608
15610	2228	64249	331	1276	0	68084
15611	63241	1673	297	1009	0	66220
15612	62526	683	287	824	0	64320
15613	2460	61449	347	702	0	64958
15614	57436	1276	252	657	0	59621
15615	1719	57769	257	516	0	60261
15616	57947	1391	266	768	0	60372
15617	1688	537	56626	593	0	59444
15618	47054	508	1232	513	0	49307
15619	1071	48787	416	325	0	50599
15620	792	907	466	48528	0	50693
15621	524	324	158	50773	0	51779
15622	527	243	125	51134	0	52029
15623	51695	149	126	1593	0	53563
15624	1211	174	141	52493	0	54019
15625	598	213	50866	1330	0	53007
15626	49218	212	928	817	0	51175
15627	1154	288	50542	506	0	52490
15628	732	349	976	50091	0	52148
15629	541	264	51135	1183	0	53123
15630	471	329	1023	48601	0	50424
15631	319	50202	457	1118	0	52096
15632	441	891	317	49134	0	50783
15633	319	49734	302	1090	0	51445
15634	486	897	242	50342	0	51967
15635	49979	443	226	1284	0	51932
15636	1151	297	205	51472	0	53125
15637	51448	196	228	1363	0	53235
15638	1217	250	49034	586	0	51087
15639	49446	231	850	598	0	51125
15640	50787	174	351	554	0	51866
15641	51092	208	259	398	0	51957
15642	1563	184	171	50805	0	52723
15643	50073	183	193	1120	0	51569
15644	1242	205	48277	530	0	50254
15645	48144	188	876	575	0	49783
15646	1262	202	48480	414	0	50358
15647	48702	177	931	425	0	50235
15648	1316	195	408	49483	0	51402
15649	708	228	50552	966	0	52454
15650	721	168	909	49854	0	51652
15651	652	169	447	51041	0	52309
15652	492	135	50642	1300	0	52569
15653	46702	125	934	982	0	48743
15654	1079	51479	502	583	0	53643
15655	49334	688	297	552	0	50871
15656	926	48483	273	380	0	50062
15657	47281	675	256	492	0	48704
15658	869	263	46602	286	0	48020
15659	41279	369	909	485	0	43042
15660	671	42607	314	227	0	43819
15661	459	358	204	41249	0	42270
15662	294	183	111	42311	0	42899
15663	332	105	77	42535	0	43049
15664	187	109	42844	613	0	43753
15665	343	66	443	42351	0	43203
15666	166	113	45612	588	0	46479
15667	47207	53	567	478	0	48305
15668	50881	71	258	413	0	51623
15669	1026	64	166	52003	0	53259
15670	376	89	52993	798	0	54256
15671	50678	55	785	581	0	52099
15672	951	82	64782	244	0	66059
15673	645	46	1287	63741	0	65719
15674	523	66	404	66444	0	67437
15675	450	50	271	68495	0	69266
15676	441	58	227	69649	0	70375
15677	66769	50	195	2106	0	69120
15678	1369	68441	221	732	0	70763
15679	496	1266	65994	482	0	68238
15680	332	66663	1379	409	0	68783
15681	67034	1395	395	482	0	69306
15682	1689	389	296	66978	0	69352
15683	67955	257	224	1719	0	70155
15684	1742	179	202	68264	0	70387
15685	817	149	205	68448	0	69619
15686	605	128	171	69523	0	70427
15687	357	172	67748	1983	0	70260
15688	278	66757	1415	862	0	69312
15689	326	1331	68354	590	0	70601
15690	512	373	1517	68472	0	70874
15691	69589	268	495	1922	0	72274
15692	69005	202	340	1056	0	70603
15693	69940	180	289	889	0	71298
15694	1812	69984	301	580	0	72677
15695	72279	1362	259	730	0	74630
15696	1908	418	235	72219	0	74780
15697	908	273	248	72812	0	74241
15698	741	229	228	72831	0	74029
15699	505	73021	283	1981	0	75790
15700	656	1400	209	68413	0	70678
15701	445	71075	311	1747	0	73578
15702	70827	1509	253	1103	0	73692
15703	71917	480	254	852	0	73503
15704	2060	362	225	72385	0	75032
15705	835	328	70877	1771	0	73811
15706	70305	270	1389	1049	0	73013
15707	1905	267	442	73305	0	75919
15708	746	277	72479	1829	0	75331
15709	69951	268	1465	1030	0	72714
15710	1881	265	473	73810	0	76429
15711	73287	263	334	2062	0	75946
15712	1742	72760	316	906	0	75724
15713	934	1447	251	72015	0	74647
15714	638	75044	308	1830	0	77820
15715	766	1687	245	76120	0	78818
15716	527	76745	310	1882	0	79464
15717	666	1541	278	78740	0	81225
15718	502	551	77655	1783	0	80491
15719	63223	394	1421	1446	0	66484
15720	1594	77504	533	764	0	80395
15721	719	1317	76013	572	0	78621
15722	73592	403	1389	826	0	76210
15723	1738	350	442	77676	0	80206
15724	683	331	77898	1575	0	80487
15725	534	79253	1292	806	0	81885
15726	578	1243	457	81147	0	83425
15727	490	500	82500	1621	0	85111
15728	640	407	1306	81951	0	84304
15729	559	356	405	84489	0	85809
15730	454	387	86967	1852	0	89660
15731	674	361	1351	86830	0	89216
15732	464	389	89782	1832	0	92467
15733	605	305	1477	89848	0	92235
15734	503	416	96319	1951	0	99189
15735	724	307	1493	96936	0	99460
15736	785	330	615	98031	0	99761
15737	756	350	492	97725	0	99323
15738	467	97204	529	2132	0	100332
15739	97437	1403	511	1487	0	100838
15740	98406	473	460	1288	0	100627
15741	1884	380	441	100141	0	102846
15742	100070	342	430	2455	0	103297
15743	1723	408	100136	1084	0	103351
15744	715	102490	1404	1081	0	105690
15745	103324	1333	557	1488	0	106702
15746	1588	104995	554	928	0	108065
15747	853	1530	437	106585	0	109405
15748	690	669	471	107695	0	109525
15749	104678	534	410	2305	0	107927
15750	1793	458	350	105301	0	107902
15751	885	410	104928	1973	0	108196
15752	759	103920	1387	1070	0	107136
15753	104762	1406	470	1226	0	107864
15754	1776	518	386	104318	0	106998
15755	719	106210	445	1886	0	109260
15756	802	1466	422	106026	0	108716
15757	530	108591	437	1753	0	111311
15758	108487	1588	390	1439	0	111904
15759	107671	567	369	1370	0	109977
15760	1907	536	106887	824	0	110154
15761	953	515	104985	744	0	107197
15762	944	391	1470	106232	0	109037
15763	633	109168	630	1618	0	112049
15764	738	1300	469	111519	0	114026
15765	110203	448	389	2337	0	113377
15766	1422	457	107194	970	0	110043
15767	844	328	1144	101835	0	104151
15768	460	292	102963	1311	0	105026
15769	504	324	97042	634	0	98504
15770	373	104508	1213	544	0	106638
15771	1306	1848	658	100407	0	104219
15772	93148	180	220	1054	0	94602
15773	485	161	93814	175	0	94635
15774	160	92223	427	215	0	93025
15775	91372	243	176	490	0	92281
15776	362	106	85	92485	0	93038
15777	94671	116	67	937	0	95791
15778	94007	63	71	797	0	94938
15779	93645	75	74	776	0	94570
15780	380	110	99761	107	0	100358
15781	92703	80	372	703	0	93858
15782	99674	37	166	656	0	100533
15783	435	102912	178	128	0	103653
15784	366	396	89	104583	0	105434
15785	341	143	73	103052	0	103609
15786	240	103	66	105679	0	106088
15787	105664	71	98	1032	0	106865
15788	100872	96	83	813	0	101864
15789	656	179	104202	159	0	105196
15790	570	70	436	102794	0	103870
15791	214	103430	240	522	0	104406
15792	103839	426	110	883	0	105258
15793	597	282	104454	140	0	105473
15794	598	126	544	101028	0	102296
15795	482	74	216	103244	0	104016
15796	231	103394	207	635	0	104467
15797	287	539	106	104895	0	105827
15798	593	261	135	97840	0	98829
15799	311	148	99	104470	0	105028
15800	103720	86	86	1463	0	105355
15801	812	84	114	103438	0	104448
15802	482	91	112	103460	0	104145
15803	103999	75	150	1408	0	105632
15804	788	122	98	104882	0	105890
15805	413	116763	129	810	0	118115
15806	121167	1280	95	1089	0	123631
15807	124922	630	138	1066	0	126756
15808	128711	294	98	1003	0	130106
15809	141204	157	99	1115	0	142575
15810	3180	150226	200	376	0	153982
15811	168018	2618	102	1109	0	171847
15812	171384	966	113	1091	0	173554
15813	5251	634	76	168933	0	174894
15814	1952	425	166850	3640	0	172867
15815	1999	196	3318	165510	0	171023
15816	1542	190	975	167149	0	169856
15817	1438	181	559	165766	0	167944
15818	1331	233	373	166029	0	167966
15819	1257	245	255	168051	0	169808
15820	161809	173	207	6223	0	168412
15821	4562	138	150	163499	0	168349
15822	1584	261	163827	4861	0	170533
15823	1852	188	3431	158937	0	164408
15824	788	161935	1140	4509	0	168372
15825	1495	3467	634	161684	0	167280
15826	708	1107	161902	4570	0	168287
15827	145609	621	3740	2856	0	152826
15828	154325	451	1332	2188	0	158296
15829	4784	396	161006	1258	0	167444
15830	1966	158001	3785	1056	0	164808
15831	160498	3496	1272	1709	0	166975
15832	161176	1182	753	1586	0	164697
15833	162091	787	516	1446	0	164840
15834	157664	511	399	1199	0	159773
15835	6768	439	389	151695	0	159291
15836	3047	557	151427	4096	0	159127
15837	2968	405	3777	151461	0	158611
15838	2468	519	1352	157042	0	161381
15839	1533	492	154215	5785	0	162025
15840	1483	614	151819	2709	0	156625
15841	149199	350	5051	2777	0	157377
15842	4966	152361	2273	1955	0	161555
15843	3082	3800	1498	152653	0	161033
15844	1893	1440	149892	5309	0	158534
15845	142087	865	4544	3734	0	151230
15846	5155	699	148248	2620	0	156722
15847	143605	489	4840	3102	0	152036
15848	5495	147168	2177	2575	0	157415
15849	3244	3881	1473	148406	0	157004
15850	2240	1582	147183	5548	0	156553
15851	137776	1051	4561	3894	0	147282
15852	5374	143731	2378	2489	0	153972
15853	2691	152501	1887	2068	0	159147
15854	2754	5366	1680	149146	0	158946
15855	2558	2438	1336	155699	0	162031
15856	158887	1942	1233	7018	0	169080
15857	6300	157594	1206	3684	0	168784
15858	4076	5002	1295	160768	0	171141
15859	157621	2023	1203	7172	0	168019
15860	164189	1503	1323	3942	0	170957
15861	167119	1235	1124	3630	0	173108
15862	8614	1225	164738	2757	0	177334
15863	4817	998	167089	2837	0	175741
15864	173536	816	6754	3334	0	184440
15865	7828	173944	3241	3005	0	188018
15866	3875	180574	2548	2781	0	189778
15867	3922	7119	1939	167498	0	180478
15868	2526	177414	2037	7115	0	189092
15869	177435	6842	1948	4370	0	190595
15870	8171	3087	1958	176044	0	189260
15871	4089	2523	174230	7495	0	188337
15872	174216	1876	6798	4363	0	187253
15873	180588	1755	3091	3462	0	188896
15874	10278	1707	2442	175146	0	189573
15875	5981	1528	2168	178768	0	188445
15876	4883	1605	2379	180230	0	189097
15877	4560	1443	2039	178945	0	186987
15878	3623	1808	168431	9967	0	183829
15879	3348	167385	6481	5449	0	182663
15880	3961	6685	3018	151791	0	165455
15881	3076	166595	2397	8002	0	180070
15882	3629	7409	2077	151990	0	165105
15883	3018	162933	1926	8072	0	175949
15884	161125	7458	1864	5267	0	175714
15885	162432	3387	1928	4665	0	172412
15886	8949	161203	2164	3658	0	175974
15887	162814	6946	1892	3643	0	175295
15888	9660	3383	1892	160756	0	175691
15889	159229	2995	1803	8297	0	172324
15890	9154	159074	1967	4189	0	174384
15891	160599	7268	1928	3646	0	173441
15892	165218	3545	2285	2869	0	173917
15893	10755	3132	2030	157717	0	173634
15894	5746	2931	156749	7386	0	172812
15895	4576	156144	6671	4035	0	171426
15896	4646	7200	2982	158115	0	172943
15897	159062	4074	2255	8161	0	173552
15898	8436	3564	155828	4446	0	172274
15899	5462	2829	6228	154485	0	169004
15900	4680	2674	2816	160520	0	170690
15901	158212	2064	2362	9797	0	172435
15902	159901	2174	2123	5888	0	170086
15903	158294	2004	1917	5064	0	167279
15904	10008	152572	1969	4310	0	168859
15905	142218	5626	1341	4047	0	153232
15906	7792	2543	132065	3601	0	146001
15907	4264	2159	127830	3614	0	137867
15908	3490	1928	127646	2910	0	135974
15909	3933	7501	6708	104795	0	122937
15910	2469	1467	103344	4360	0	111640
15911	85245	1201	2963	2097	0	91506
15912	3607	994	1332	86608	0	92541
15913	2190	995	88050	3298	0	94533
15914	90636	1027	2712	2304	0	96679
15915	4064	920	1304	91313	0	97601
15916	2658	985	1138	93587	0	98368
15917	93849	840	1011	3984	0	99684
15918	3840	964	1046	95924	0	101774
15919	2363	1044	96198	3569	0	103174
15920	2196	918	2938	96946	0	102998
15921	1928	877	98261	3655	0	104721
15922	2049	777	3265	96259	0	102350
15923	94852	716	1548	4204	0	101320
15924	3576	91494	1373	2370	0	98813
15925	2272	96473	1145	2023	0	101913
15926	2306	3024	970	95176	0	101476
15927	2024	1438	1046	95373	0	99881
15928	1727	92352	1085	4026	0	99190
15929	1783	92460	1112	2400	0	97755
15930	1678	2989	1068	91260	0	96995
15931	1633	1368	1206	92448	0	96655
15932	88697	1036	1075	4336	0	95144
15933	3244	86927	1134	2556	0	93861
15934	1844	86353	1000	2252	0	91449
15935	1639	90758	1050	1715	0	95162
15936	86898	3257	1091	1878	0	93124
15937	3103	1518	86438	1677	0	92736
15938	84353	1044	2878	1822	0	90097
15939	3278	939	1361	85142	0	90720
15940	1765	80609	1170	3259	0	86803
15941	1523	86919	883	2004	0	91329
15942	85931	2871	848	1886	0	91536
15943	3238	1471	964	83129	0	88802
15944	1671	91804	1015	3186	0	97676
15945	92996	2694	1019	2192	0	98901
15946	94617	1344	855	1959	0	98775
15947	3650	1231	93134	1579	0	99594
15948	92674	1143	2605	1660	0	98082
15949	95778	1094	1271	1588	0	99731
15950	3914	937	953	92550	0	98354
15951	1908	89721	962	3347	0	95938
15952	1636	93398	715	1955	0	97704
15953	1766	3225	553	90970	0	96514
15954	87462	1489	604	3404	0	92959
15955	2877	1210	81308	1849	0	87244
15956	1560	806	77282	1120	0	80768
15957	1717	732	75449	1023	0	78921
15958	1498	664	77588	891	0	80641
15959	729	77166	2621	883	0	81399
15960	846	77009	1180	887	0	79922
15961	1190	2418	71076	691	0	75375
15962	823	1238	69246	810	0	72117
15963	364	62047	1844	470	0	64725
15964	424	919	645	56189	0	58177
15965	105	380	60359	743	0	61587
15966	343	204	863	57454	0	58864
15967	255	124	352	61590	0	62321
15968	240	101	208	63360	0	63909
15969	274	102	151	67440	0	67967
15970	109	126	66705	1423	0	68363
15971	347	73	1092	63916	0	65428
15972	65580	73	437	1478	0	67568
15973	1076	154	64730	480	0	66440
15974	64800	103	1106	491	0	66500
15975	1391	73	431	67276	0	69171
15976	486	123	68350	1149	0	70108
15977	67008	116	1174	622	0	68920
15978	1428	77	455	69008	0	70968
15979	69651	69	290	1515	0	71525
15980	1485	93	240	68219	0	70037
15981	513	68460	208	1396	0	70577
15982	370	1094	70610	589	0	72663
15983	457	405	1204	70772	0	72838
15984	71799	246	500	1574	0	74119
15985	72041	200	309	836	0	73386
15986	72140	151	255	675	0	73221
15987	71712	165	242	568	0	72687
15988	70916	180	221	606	0	71923
15989	1575	71065	273	375	0	73288
15990	71741	1178	256	556	0	73731
15991	1462	536	70808	310	0	73116
15992	70087	358	1192	534	0	72171
15993	1540	295	503	67719	0	70057
15994	647	279	70957	1182	0	73065
15995	459	318	69909	547	0	71233
15996	524	250	1554	69688	0	72016
15997	71282	200	706	1603	0	73791
15998	1385	70830	474	687	0	73376
15999	70845	1232	305	716	0	73098
16000	1525	71763	299	428	0	74015
16001	1023	1377	284	74037	0	76721
16002	767	582	262	75474	0	77085
16003	75096	376	281	1974	0	77727
16004	1711	280	280	75370	0	77641
16005	848	246	74960	1602	0	77656
16006	74172	194	1377	954	0	76697
16007	1780	189	608	76942	0	79519
16008	978	228	428	76783	0	78417
16009	620	268	76178	1738	0	78804
16010	68663	274	1419	1288	0	71644
16011	75298	248	582	917	0	77045
16012	1835	76381	463	505	0	79184
16013	906	1276	74657	355	0	77194
16014	709	597	72247	360	0	73913
16015	767	517	1677	70749	0	73710
16016	732	389	759	70128	0	72008
16017	500	71853	507	1665	0	74525
16018	471	1203	70098	656	0	72428
16019	624	474	1345	67242	0	69685
16020	421	305	70479	1365	0	72570
16021	573	245	1421	66684	0	68923
16022	360	69133	690	1412	0	71595
16023	466	1180	524	70779	0	72949
16024	543	408	444	70972	0	72367
16025	533	312	359	70005	0	71209
16026	69106	225	346	2014	0	71691
16027	1354	268	68634	887	0	71143
16028	585	71865	1392	713	0	74555
16029	611	1315	598	76015	0	78539
16030	77493	531	419	1943	0	80386
16031	1775	340	376	79065	0	81556
16032	79294	229	368	2201	0	82092
16033	1914	220	79825	977	0	82936
16034	79304	175	1676	886	0	82041
16035	2232	154	705	82838	0	85929
16036	988	221	83158	1965	0	86332
16037	709	82563	1779	995	0	86046
16038	817	1564	735	81839	0	84955
16039	784	634	497	84230	0	86145
16040	82173	392	428	2491	0	85484
16041	1814	81033	454	1139	0	84440
16042	873	79362	436	763	0	81434
16043	682	82810	408	660	0	84560
16044	75821	1856	399	779	0	78855
16045	1743	76864	338	506	0	79451
16046	1004	1565	360	75574	0	78503
16047	845	604	339	76699	0	78487
16048	75833	374	279	2185	0	78671
16049	1541	75427	310	967	0	78245
16050	881	1439	303	76804	0	79427
16051	78276	617	293	2053	0	81239
16052	78495	360	266	1176	0	80297
16053	78411	255	238	970	0	79874
16054	2035	77679	308	600	0	80622
16055	76662	1336	269	626	0	78893
16056	1732	635	240	75477	0	78084
16057	770	73883	248	1440	0	76341
16058	555	76103	237	720	0	77615
16059	787	1537	222	75464	0	78010
16060	74599	627	219	1729	0	77174
16061	75991	360	200	1048	0	77599
16062	1762	310	199	73932	0	76203
16063	744	73595	250	1373	0	75962
16064	74061	1264	200	906	0	76431
16065	1434	619	71598	518	0	74169
16066	720	463	69384	428	0	70995
16067	67877	340	1232	661	0	70110
16068	1258	339	68682	396	0	70675
16069	678	182	943	63267	0	65070
16070	64642	184	388	1193	0	66407
16071	1132	213	221	66079	0	67645
16072	461	264	65940	1132	0	67797
16073	390	66610	930	582	0	68512
16074	492	935	355	68063	0	69845
16075	325	397	67757	1025	0	69504
16076	63726	333	881	681	0	65621
16077	1120	246	337	67372	0	69075
16078	524	224	67656	1040	0	69444
16079	481	224	911	65844	0	67460
16080	306	65952	395	1072	0	67725
16081	382	954	240	68770	0	70346
16082	436	401	172	68065	0	69074
16083	460	263	150	66362	0	67235
16084	300	66599	195	1357	0	68451
16085	68010	945	162	923	0	70040
16086	1109	419	183	68950	0	70661
16087	604	325	200	68952	0	70081
16088	484	200	200	69887	0	70771
16089	356	266	69203	1442	0	71267
16090	539	164	954	68859	0	70516
16091	69264	199	393	1663	0	71519
16092	1049	69931	323	731	0	72034
16093	642	1084	180	71715	0	73621
16094	500	496	184	72308	0	73488
16095	71222	357	147	1823	0	73549
16096	1147	71915	178	885	0	74125
16097	72577	1142	154	870	0	74743
16098	74640	503	144	672	0	75959
16099	1841	323	126	73912	0	76202
16100	73812	244	156	1711	0	75923
16101	1472	71325	173	718	0	73688
16102	71935	1221	161	765	0	74082
16103	1633	502	164	73819	0	76118
16104	79495	354	107	1767	0	81723
16105	82575	299	103	1000	0	83977
16106	2326	406	78169	608	0	81509
16107	80845	253	1359	796	0	83253
16108	84290	217	364	743	0	85614
16109	87568	267	246	1049	0	89130
16110	3031	310	91332	425	0	95098
16111	1189	92160	2504	380	0	96233
16112	1189	2529	707	91923	0	96348
16113	92005	760	452	3052	0	96269
16114	2834	91206	313	941	0	95294
16115	91521	2701	211	915	0	95348
16116	3580	781	190	92128	0	96679
16117	1307	568	91746	2825	0	96446
16118	93927	381	2572	1169	0	98049
16119	3632	264	794	96511	0	101201
16120	1407	261	96303	2920	0	100891
16121	95460	228	2879	1423	0	99990
16122	3585	291	98936	722	0	103534
16123	2018	257	3249	100171	0	105695
16124	1552	313	1172	106974	0	110011
16125	104945	270	711	4657	0	110583
16126	105810	266	446	2217	0	108739
16127	4557	104495	399	1191	0	110642
16128	104713	3137	332	1049	0	109231
16129	4179	1040	98979	558	0	104756
16130	1731	685	99528	537	0	102481
16131	96430	488	3857	904	0	101679
16132	3727	98641	1480	543	0	104391
16133	96004	2898	960	770	0	100632
16134	3629	96627	667	421	0	101344
16135	96249	3152	541	643	0	100585
16136	4183	1134	518	93808	0	99643
16137	1809	707	94686	3026	0	100228
16138	1872	494	2945	93870	0	99181
16139	1657	373	1096	97886	0	101012
16140	95999	376	805	4276	0	101456
16141	3666	492	94923	1589	0	100670
16142	92697	332	3164	1543	0	97736
16143	3792	93626	1299	887	0	99604
16144	95038	2945	907	963	0	99853
16145	4342	1157	695	92798	0	98992
16146	1995	896	92683	3222	0	98796
16147	1879	693	3156	92566	0	98294
16148	93313	521	1280	3829	0	98943
16149	4151	495	899	93484	0	99029
16150	2110	444	836	92717	0	96107
16151	1456	88328	765	4192	0	94741
16152	1534	2901	698	91176	0	96309
16153	1208	1053	89682	4069	0	96012
16154	1442	705	3246	89554	0	94947
16155	1538	526	1300	92580	0	95944
16156	89629	521	954	4741	0	95845
16157	4059	500	810	89915	0	95284
16158	1884	533	88073	4339	0	94829
16159	1551	88085	3350	2110	0	95096
16160	1732	2986	1457	88707	0	94882
16161	1583	1177	1005	90714	0	94479
16162	88748	913	863	4613	0	95137
16163	3925	86563	752	2268	0	93508
16164	2039	3227	765	88697	0	94728
16165	85041	1282	713	4369	0	91405
16166	89065	972	717	2264	0	93018
16167	4785	739	716	88007	0	94247
16168	2313	690	87563	4363	0	94929
16169	88018	562	3350	2403	0	94333
16170	4487	613	1366	91434	0	97900
16171	90427	538	1148	4781	0	96894
16172	92031	585	972	2597	0	96185
16173	5022	87403	839	1902	0	95166
16174	87539	3351	716	1930	0	93536
16175	4776	87617	807	1515	0	94715
16176	2649	3615	832	87476	0	94572
16177	2222	1545	808	87204	0	91779
16178	1790	86827	805	4525	0	93947
16179	88403	3486	690	2682	0	95261
16180	88716	1458	714	2308	0	93196
16181	4939	1138	84433	1716	0	92226
16182	2682	986	85058	1514	0	90240
16183	2212	757	3967	85659	0	92595
16184	86417	661	1698	4603	0	93379
16185	4570	653	1212	85949	0	92384
16186	2486	708	958	88601	0	92753
16187	1947	642	86106	5155	0	93850
16188	1816	751	86305	2629	0	91501
16189	1554	695	87968	2166	0	92383
16190	83191	712	4531	2051	0	90485
16191	86314	738	1980	1844	0	90876
16192	4684	82156	1422	1580	0	89842
16193	2534	85297	1086	1428	0	90345
16194	2190	3800	883	84063	0	90936
16195	1652	1630	83782	4047	0	91111
16196	81630	1074	3385	2438	0	88527
16197	4086	931	86384	1801	0	93202
16198	2233	707	3612	84446	0	90998
16199	1889	577	1557	87911	0	91934
16200	1707	587	1214	88523	0	92031
16201	1620	545	1018	89829	0	93012
16202	86438	543	930	5341	0	93252
16203	4307	590	817	85899	0	91613
16204	1796	479	80921	4091	0	87287
16205	74332	412	2742	2564	0	80050
16206	3335	445	78292	1679	0	83751
16207	1682	483	77404	1430	0	80999
16208	1350	76216	3515	1245	0	82326
16209	1723	1823	2220	66436	0	72202
16210	66196	667	1124	2217	0	70204
16211	2066	449	493	66542	0	69550
16212	969	405	66399	2136	0	69909
16213	895	243	1613	67220	0	69971
16214	66185	211	821	2490	0	69707
16215	1797	66986	606	1319	0	70708
16216	65381	1393	510	1231	0	68515
16217	1841	65261	433	813	0	68348
16218	64120	1418	416	984	0	66938
16219	1689	63529	365	583	0	66166
16220	914	64260	342	475	0	65991
16221	707	1605	62061	356	0	64729
16222	524	61185	1371	433	0	63513
16223	55180	875	501	318	0	56874
16224	901	340	203	54753	0	56197
16225	54959	199	153	993	0	56304
16226	868	56091	129	397	0	57485
16227	55150	802	124	467	0	56543
16228	1004	387	55406	188	0	56985
16229	601	221	852	54482	0	56156
16230	294	56057	333	854	0	57538
16231	397	891	214	57809	0	59311
16232	327	354	161	58297	0	59139
16233	65725	256	123	1539	0	67643
16234	1486	66966	177	646	0	69275
16235	67750	1540	129	616	0	70035
16236	1928	680	68477	241	0	71326
16237	854	456	66588	221	0	68119
16238	508	67711	2104	231	0	70554
16239	550	1616	916	67861	0	70943
16240	310	683	69428	1571	0	71992
16241	684	417	1811	64899	0	67811
16242	509	308	730	70863	0	72410
16243	258	281	68232	2428	0	71199
16244	287	261	68347	1084	0	69979
16245	246	256	71722	685	0	72909
16246	328	218	71916	406	0	72868
16247	250	73339	2627	400	0	76616
16248	554	1769	1253	72720	0	76296
16249	428	783	765	75964	0	77940
16250	266	510	74681	2412	0	77869
16251	499	410	1943	73376	0	76228
16252	260	314	78340	2345	0	81259
16253	519	238	2196	77191	0	80144
16254	504	193	1107	77363	0	79167
16255	211	77944	731	2623	0	81509
16256	447	1814	523	79217	0	82001
16257	496	778	472	78703	0	80449
16258	443	534	428	80237	0	81642
16259	248	452	77803	2864	0	81367
16260	219	77364	1905	1525	0	81013
16261	76841	1872	912	1228	0	80853
16262	77842	809	607	1018	0	80276
16263	2520	528	507	76826	0	80381
16264	1343	431	412	76052	0	78238
16265	699	78099	414	2445	0	81657
16266	77398	1861	339	1611	0	81209
16267	1816	79243	373	1009	0	82441
16268	76911	1951	370	931	0	80163
16269	2014	992	75852	534	0	79392
16270	71864	564	1813	894	0	75135
16271	1968	75923	914	544	0	79349
16272	1167	1743	579	76378	0	79867
16273	829	825	507	76267	0	78428
16274	463	76223	410	2351	0	79447
16275	76730	1874	348	1502	0	80454
16276	2064	895	360	78436	0	81755
16277	1040	601	391	80797	0	82829
16278	79745	516	378	2975	0	83614
16279	81167	404	341	1710	0	83622
16280	2656	447	80007	899	0	84009
16281	80802	366	1958	971	0	84097
16282	2656	294	961	82119	0	86030
16283	1183	405	82384	2275	0	86247
16284	1043	378	2164	81075	0	84660
16285	549	437	81393	2563	0	84942
16286	449	362	82013	1393	0	84217
16287	571	364	2738	81141	0	84814
16288	425	416	82876	2449	0	86166
16289	401	82902	2565	1412	0	87280
16290	590	1900	1216	82812	0	86518
16291	620	828	832	86833	0	89113
16292	446	649	85784	2894	0	89773
16293	452	85237	2250	1677	0	89616
16294	85199	2051	1147	1419	0	89816
16295	2387	921	784	87385	0	91477
16296	86908	667	647	2952	0	91174
16297	2478	85569	639	1475	0	90161
16298	1229	2331	86559	1054	0	91173
16299	1082	1079	2435	85253	0	89849
16300	85113	745	1298	2893	0	90049
16301	2318	634	85334	1461	0	89747
16302	80724	465	2518	1490	0	85197
16303	2605	82839	1350	948	0	87742
16304	1119	83380	840	844	0	86183
16305	82290	2419	781	1057	0	86547
16306	2361	1182	742	81405	0	85690
16307	1282	907	646	80723	0	83558
16308	786	82203	579	2849	0	86417
16309	771	1957	546	84364	0	87638
16310	644	989	578	85293	0	87504
16311	82801	661	457	3539	0	87458
16312	2217	490	543	83330	0	86580
16313	1069	452	82349	2802	0	86672
16314	1035	312	2160	82234	0	85741
16315	787	388	1121	85224	0	87520
16316	534	463	84398	3138	0	88533
16317	599	548	2080	84722	0	87949
16318	82071	386	965	3451	0	86873
16319	80649	334	780	2074	0	83837
16320	82033	336	577	1630	0	84576
16321	3025	359	458	81591	0	85433
16322	1496	454	81212	2525	0	85687
16323	1024	81392	1877	1655	0	85948
16324	1060	1814	903	82509	0	86286
16325	719	956	82800	2386	0	86861
16326	839	604	1926	81267	0	84636
16327	700	455	931	83455	0	85541
16328	79978	328	679	3227	0	84212
16329	1898	82349	614	1612	0	86473
16330	1125	1759	80498	1092	0	84474
16331	74395	783	1843	1273	0	78294
16332	2138	78678	1001	804	0	82621
16333	646	71517	360	483	0	73006
16334	73144	1254	756	675	0	75829
16335	1421	598	285	74327	0	76631
16336	599	463	82478	1294	0	84834
16337	722	331	1293	80752	0	83098
16338	308	82864	578	1488	0	85238
16339	83671	1311	337	1095	0	86414
16340	1559	521	243	84378	0	86701
16341	85539	336	198	1887	0	87960
16342	1755	284	179	84195	0	86413
16343	662	87539	313	1580	0	90094
16344	88947	1368	206	1119	0	91640
16345	88027	550	227	950	0	89754
16346	1896	88498	258	528	0	91180
16347	86900	1488	179	729	0	89296
16348	1944	556	194	84770	0	87464
16349	681	85694	261	1568	0	88204
16350	85999	1483	223	1079	0	88784
16351	1648	87383	220	564	0	89815
16352	85554	1612	192	798	0	88156
16353	1995	592	171	85697	0	88455
16354	86757	396	176	1964	0	89293
16355	86754	359	194	1134	0	88441
16356	87322	380	196	838	0	88736
16357	2361	354	114	86693	0	89522
16358	1252	329	124	88006	0	89711
16359	86996	299	146	2257	0	89698
16360	1857	397	88639	864	0	91757
16361	1077	342	1412	87682	0	90513
16362	742	90437	476	1787	0	93442
16363	903	1674	269	91438	0	94284
16364	920	650	201	92506	0	94277
16365	683	555	91192	2184	0	94614
16366	900	454	1580	95338	0	98272
16367	585	101479	610	2407	0	105081
16368	946	2372	325	104592	0	108235
16369	678	1145	113431	2777	0	118031
16370	1205	678	2776	112289	0	116948
16371	1056	428	1155	117169	0	119808
16372	113774	336	619	4896	0	119625
16373	114313	322	436	2621	0	117692
16374	4588	344	308	112812	0	118052
16375	2044	109624	400	3552	0	115620
16376	1189	113244	290	1942	0	116665
16377	922	3828	110615	1239	0	116604
16378	1257	1952	2856	109692	0	115757
16379	110256	931	1373	3894	0	116454
16380	3374	703	678	111550	0	116305
16381	1481	643	112276	3712	0	118112
16382	1438	454	2902	111403	0	116197
16383	1311	362	1364	113592	0	116629
16384	1131	322	715	116483	0	118651
16385	756	428	113366	4785	0	119335
16386	706	113521	2835	2474	0	119536
16387	112095	2777	1305	2044	0	118221
16388	112275	1363	723	1584	0	115945
16389	4404	913	481	110100	0	115898
16390	2053	781	110358	3287	0	116479
16391	1210	111227	2940	1862	0	117239
16392	1297	3218	1297	107071	0	112883
16393	847	111369	843	3023	0	116082
16394	579	115579	576	1721	0	118455
16395	111307	3694	614	1630	0	117245
16396	3034	1809	112013	988	0	117844
16397	1566	1154	112077	897	0	115694
16398	1615	726	3481	111237	0	117059
16399	1176	544	1767	116019	0	119506
16400	735	644	116649	3888	0	121916
16401	1212	499	2866	113676	0	118253
16402	835	465	116274	3746	0	121320
16403	109272	383	3205	2533	0	115393
16404	3211	446	1614	115588	0	120859
16405	1593	624	119791	3383	0	125391
16406	1502	581	2956	113630	0	118669
16407	814	124784	1530	3352	0	130480
16408	123411	2815	969	2548	0	129743
16409	2892	125336	766	1454	0	130448
16410	125689	3100	682	1678	0	131149
16411	3322	1638	123022	1047	0	129029
16412	123462	979	2778	1502	0	128721
16413	3636	779	1389	126832	0	132636
16414	1836	644	127315	3315	0	133110
16415	1362	530	3085	126119	0	131096
16416	977	589	125099	3785	0	130450
16417	116730	480	3270	2683	0	123163
16418	3083	125795	1703	1698	0	132279
16419	1985	2743	1161	121069	0	126958
16420	1101	128092	989	3074	0	133256
16421	126303	3256	740	2420	0	132719
16422	126683	1606	730	1941	0	130960
16423	3880	127829	710	1348	0	133767
16424	2305	3199	621	127598	0	133723
16425	1674	1619	695	128933	0	132921
16426	1378	1033	671	129079	0	132161
16427	126259	766	665	5320	0	133010
16428	2908	126043	883	2882	0	132716
16429	1765	2858	734	125707	0	131064
16430	1172	1506	889	127531	0	131098
16431	123664	932	733	5036	0	130365
16432	3159	926	121312	2645	0	128042
16433	1845	701	118286	2115	0	122947
16434	113320	555	3615	2053	0	119543
16435	3130	540	117563	1251	0	122484
16436	1661	567	107295	918	0	110441
16437	1357	645	3543	104326	0	109871
16438	107775	424	1995	3052	0	113246
16439	2718	423	1196	107696	0	112033
16440	1517	477	107137	2967	0	112098
16441	99666	465	2609	2149	0	104889
16442	2809	507	105175	1172	0	109663
16443	1430	106610	2750	1007	0	111797
16444	1297	2359	1669	109481	0	114806
16445	110551	1154	1037	2948	0	115690
16446	2360	741	890	111196	0	115187
16447	1508	437	762	112477	0	115184
16448	114043	342	551	3887	0	118823
16449	2563	266	594	115586	0	119009
16450	1558	292	613	117633	0	120096
16451	905	389	116509	3548	0	121351
16452	996	291	2068	115648	0	119003
16453	116900	295	1241	3684	0	122120
16454	116525	317	799	2407	0	120048
16455	117641	361	691	1587	0	120280
16456	3536	436	526	115504	0	120002
16457	1882	114887	479	2297	0	119545
16458	116113	1959	441	1966	0	120479
16459	2514	117023	513	1070	0	121120
16460	114581	2144	401	1275	0	118401
16461	2655	1170	416	114761	0	119002
16462	113922	633	391	2647	0	117593
16463	113176	420	374	2086	0	116056
16464	113200	289	485	1559	0	115533
16465	3087	111277	572	761	0	115697
16466	1327	106477	419	571	0	108794
16467	101484	1220	260	940	0	103904
16468	1314	103208	224	452	0	105198
16469	262	94786	107	160	0	95315
16470	128	95532	156	100	0	95916
16471	95101	718	405	625	0	96849
16472	763	271	14	94738	0	95786
16473	503	143	17	95354	0	96017
16474	95664	99	27	1455	0	97245
16475	721	157	98519	310	0	99707
16476	717	51	621	108987	0	110376
16477	536	80	248	110382	0	111246
16478	488	85	111	121985	0	122669
16479	656	92	65	124980	0	125793
16480	108	124518	193	3082	0	127901
16481	73	149150	157	1266	0	150646
16482	149662	3652	76	1336	0	154726
16483	3911	1388	41	149815	0	155155
16484	1981	699	70	153143	0	155893
16485	790	471	150009	4594	0	155864
16486	1240	202	3303	149624	0	154369
16487	290	277	152490	4544	0	157601
16488	1039	162	3966	151151	0	156318
16489	303	253	158658	4574	0	163788
16490	153	156817	4589	2040	0	163599
16491	1006	3764	1609	157345	0	163724
16492	156378	1377	925	5141	0	163821
16493	157580	826	511	2508	0	161425
16494	5879	510	386	155701	0	162476
16495	2125	486	156011	4688	0	163310
16496	1313	405	155398	2002	0	159118
16497	145094	276	5318	2268	0	152956
16498	4038	152029	2270	1260	0	159597
16499	154152	4079	1382	1596	0	161209
16500	154144	1489	830	1662	0	158125
16501	5775	1037	151414	842	0	159068
16502	3419	654	4352	147382	0	155807
16503	2488	493	1850	150497	0	155328
16504	1927	469	1164	157924	0	161484
16505	1840	383	866	151552	0	154641
16506	1971	357	758	149033	0	152119
16507	863	459	142140	7348	0	150810
16508	818	423	143523	3536	0	148300
16509	1767	373	5853	141574	0	149567
16510	1684	470	2668	145758	0	150580
16511	1799	426	1575	148545	0	152345
16512	142884	538	1103	7812	0	152337
16513	5689	508	855	144260	0	151312
16514	143828	383	795	7066	0	152072
16515	6484	376	848	147239	0	154947
16516	147752	293	815	7539	0	156399
16517	151664	291	911	4260	0	157126
16518	149201	261	973	3313	0	153748
16519	150221	348	920	2779	0	154268
16520	150571	350	871	2507	0	154299
16521	8317	409	837	145596	0	155159
16522	145208	386	835	6618	0	153047
16523	6387	143021	866	3309	0	153583
16524	145696	4471	805	3046	0	154018
16525	6881	1592	748	146995	0	156216
16526	3270	1070	144929	6400	0	155669
16527	2903	614	5008	147197	0	155722
16528	2083	569	146890	6990	0	156532
16529	2505	424	5766	146395	0	155090
16530	2417	424	2498	151741	0	157080
16531	1901	515	146917	7870	0	157203
16532	1846	519	147905	4244	0	154514
16533	2233	445	6532	147601	0	156811
16534	146476	332	2900	7494	0	157202
16535	6057	488	146766	3826	0	157137
16536	3011	147399	5703	3179	0	159292
16537	2297	4691	152464	2647	0	162099
16538	150182	1702	6191	2786	0	160861
16539	6581	1080	2731	152473	0	162865
16540	153560	725	2098	7010	0	163393
16541	156694	554	1549	3977	0	162774
16542	8096	432	1496	153788	0	163812
16543	3990	557	148468	7105	0	160120
16544	3226	402	5601	147561	0	156790
16545	2658	428	2629	150273	0	155988
16546	142320	439	2035	8979	0	153773
16547	6114	144719	1755	4735	0	157323
16548	3692	4676	1496	146469	0	156333
16549	2601	1860	143182	7120	0	154763
16550	137672	1233	5663	4210	0	148778
16551	6471	140443	2806	3141	0	152861
16552	3903	4891	1950	142596	0	153340
16553	3084	1878	1589	145383	0	151934
16554	2618	1194	1490	148328	0	153630
16555	141209	773	1401	9301	0	152684
16556	145445	654	1316	5271	0	152686
16557	8322	551	1373	144206	0	154452
16558	4086	692	141147	7640	0	153565
16559	2900	141185	5740	4356	0	154181
16560	141802	4971	2645	3709	0	153127
16561	147375	1910	1934	3260	0	154479
16562	8336	1211	1488	142569	0	153604
16563	4652	848	1416	148027	0	154943
16564	2998	791	144346	8586	0	156721
16565	2367	144811	5932	4660	0	157770
16566	147872	5149	2657	3926	0	159604
16567	146747	1976	1832	3483	0	154038
16568	7420	144854	1565	2732	0	156571
16569	143772	5135	1180	2571	0	152658
16570	7670	1972	1095	141939	0	152676
16571	3646	1343	140299	6818	0	152106
16572	3468	847	5358	142222	0	151895
16573	2436	878	140450	7391	0	151155
16574	136400	690	5900	4323	0	147313
16575	6246	136923	2608	3340	0	149117
16576	3185	4478	1380	125019	0	134062
16577	2180	1482	124322	5364	0	133348
16578	1821	1049	117405	2424	0	122699
16579	107747	1103	4347	2399	0	115596
16580	3990	108804	2007	1690	0	116491
16581	87735	2158	1914	1175	0	92982
16582	86273	743	828	1121	0	88965
16583	86824	449	591	1003	0	88867
16584	3189	546	591	84435	0	88761
16585	1450	405	84309	2400	0	88564
16586	1109	84277	1962	1135	0	88483
16587	1276	2139	953	83901	0	88269
16588	880	729	85167	2208	0	88984
16589	598	528	78176	870	0	80172
16590	757	444	1815	77176	0	80192
16591	510	312	77271	1713	0	79806
16592	72705	244	1664	1031	0	75644
16593	1800	263	707	77075	0	79845
16594	943	262	577	79603	0	81385
16595	78862	228	476	2164	0	81730
16596	1618	78009	502	879	0	81008
16597	82133	1346	439	1027	0	84945
16598	1951	498	442	81531	0	84422
16599	1089	396	406	82490	0	84381
16600	940	324	384	82983	0	84631
16601	903	286	411	81315	0	82915
16602	80141	280	416	2297	0	83134
16603	1720	311	79824	1062	0	82917
16604	779	78834	1464	830	0	81907
16605	760	1218	657	79862	0	82497
16606	76111	524	502	2037	0	79174
16607	79089	368	413	1148	0	81018
16608	1702	79756	495	712	0	82665
16609	77495	1186	348	945	0	79974
16610	1434	78262	461	643	0	80800
16611	723	81824	410	612	0	83569
16612	751	1430	423	81968	0	84572
16613	591	577	82522	1537	0	85227
16614	805	560	1227	79946	0	82538
16615	79061	372	554	1935	0	81922
16616	1395	77940	403	849	0	80587
16617	809	1152	326	78499	0	80786
16618	648	531	83793	1455	0	86427
16619	82707	366	1261	1228	0	85562
16620	86815	294	526	1105	0	88740
16621	87444	328	385	945	0	89102
16622	1784	316	85234	493	0	87827
16623	82001	265	1173	773	0	84212
16624	1487	85422	561	445	0	87915
16625	763	1125	363	82274	0	84525
16626	571	85198	388	1133	0	87290
16627	85229	1172	281	934	0	87616
16628	81845	477	295	952	0	83569
16629	1500	446	86403	391	0	88740
16630	701	86505	1096	445	0	88747
16631	668	1132	488	86615	0	88903
16632	609	420	387	87237	0	88653
16633	646	373	302	86071	0	87392
16634	752	265	298	86517	0	87832
16635	676	265	300	89615	0	90856
16636	512	328	85814	1898	0	88552
16637	430	84775	1437	903	0	87545
16638	83201	1392	526	974	0	86093
16639	1732	580	86245	463	0	89020
16640	798	87703	1500	472	0	90473
16641	87447	1437	562	792	0	90238
16642	1804	593	91176	390	0	93963
16643	87747	434	1601	786	0	90568
16644	87815	414	590	913	0	89732
16645	90433	345	360	796	0	91934
16646	2042	91304	358	548	0	94252
16647	887	1654	89331	432	0	92304
16648	566	90859	1639	467	0	93531
16649	1356	1874	707	76953	0	80890
16650	460	91027	450	1347	0	93284
16651	90219	1652	359	983	0	93213
16652	93419	568	304	834	0	95125
16653	90970	419	291	996	0	92676
16654	2443	381	93375	428	0	96627
16655	1043	97361	1824	438	0	100666
16656	1141	1842	680	105796	0	109459
16657	113838	734	435	2622	0	117629
16658	2836	114203	385	958	0	118382
16659	1715	2698	274	113229	0	117916
16660	926	1054	116444	2676	0	121100
16661	114304	664	2796	1460	0	119224
16662	3255	543	122400	691	0	126889
16663	1366	430	125428	477	0	127701
16664	116139	333	3924	896	0	121292
16665	3561	400	120826	306	0	125093
16666	113345	257	3518	684	0	117804
16667	3448	115570	1540	300	0	120858
16668	118706	2817	1010	788	0	123321
16669	4115	1155	734	117625	0	123629
16670	2516	725	594	117502	0	121337
16671	1755	460	553	120799	0	123567
16672	118285	321	576	4661	0	123843
16673	117554	276	490	2417	0	120737
16674	118855	323	542	1540	0	121260
16675	4711	115607	486	725	0	121529
16676	2757	2842	460	116704	0	122763
16677	1481	1195	116555	3163	0	122394
16678	1747	707	2921	111613	0	116988
16679	886	112172	1398	3657	0	118113
16680	1516	2860	763	112873	0	118012
16681	1392	1367	511	115544	0	118814
16682	113702	809	408	4689	0	119608
16683	3981	582	383	114504	0	119450
16684	1680	603	112991	4154	0	119428
16685	1282	579	112235	2112	0	116208
16686	1590	448	3975	112437	0	118450
16687	111991	445	1836	4207	0	118479
16688	4015	525	1152	110952	0	116644
16689	2317	518	794	114212	0	117841
16690	1365	426	112302	4764	0	118857
16691	1085	110937	3583	2345	0	117950
16692	1352	2824	1689	112428	0	118293
16693	109333	1262	1296	4271	0	116162
16694	3488	109899	1036	2054	0	116477
16695	2384	3138	676	110893	0	117091
16696	1572	1449	110403	3828	0	117252
16697	1611	968	3281	107438	0	113298
16698	105304	681	1726	4697	0	112408
16699	3434	105111	1373	2326	0	112244
16700	1907	3185	106702	1760	0	113554
16701	1968	1510	3160	105483	0	112121
16702	1307	1042	108111	4036	0	114496
16703	104747	798	3728	2663	0	111936
16704	107702	672	1857	2222	0	112453
16705	4582	793	107035	1420	0	113830
16706	2786	673	3563	105317	0	112339
16707	1811	788	108957	3781	0	115337
16708	1297	107306	4079	2197	0	114879
16709	1461	3211	2170	108806	0	115648
16710	1261	1421	108938	4142	0	115762
16711	1588	1139	3937	102127	0	108791
16712	1283	104857	2147	3928	0	112215
16713	1480	3246	1528	105867	0	112121
16714	1020	1481	105135	4357	0	111993
16715	99885	1035	3698	2970	0	107588
16716	3552	103906	2131	1985	0	111574
16717	105398	3279	1536	2018	0	112231
16718	4238	1577	100373	1595	0	107783
16719	98384	1111	3744	1741	0	104980
16720	4330	991	99651	1576	0	106548
16721	98456	865	4086	1600	0	105007
16722	102915	855	2150	1692	0	107612
16723	5071	772	1615	100183	0	107641
16724	2990	787	1402	102937	0	108116
16725	101405	870	1074	5105	0	108454
16726	4242	101142	1199	2768	0	109351
16727	103000	3212	1242	2270	0	109724
16728	4654	1515	1342	100712	0	108223
16729	2617	100626	1375	4044	0	108662
16730	2337	3232	1211	104431	0	111211
16731	2232	1442	1101	107087	0	111862
16732	1887	989	1178	105848	0	109902
16733	1558	103353	1142	5457	0	111510
16734	102917	2977	1001	3058	0	109953
16735	3990	1620	871	103358	0	109839
16736	2216	1148	100983	4146	0	108493
16737	1599	932	98499	2902	0	103932
16738	1285	859	100409	2384	0	104937
16739	98848	726	4204	2180	0	105958
16740	100327	835	2233	2004	0	105399
16741	4311	743	98634	1548	0	105236
16742	2625	769	3180	91738	0	98312
16743	1903	828	1812	95449	0	99992
16744	1222	647	99005	4439	0	105313
16745	1127	695	98113	2646	0	102581
16746	1367	567	3917	99525	0	105376
16747	99566	581	2318	3830	0	106295
16748	98335	487	1618	2322	0	102762
16749	98763	431	1282	2106	0	102582
16750	4204	95770	1323	1654	0	102951
16751	2310	98450	1268	1460	0	103488
16752	1872	2844	1105	97338	0	103159
16753	96772	1355	1040	3219	0	102386
16754	3040	938	94316	1781	0	100075
16755	84761	652	2387	1831	0	89631
16756	2579	80371	1109	1246	0	85305
16757	942	73733	532	628	0	75835
16758	72389	1552	629	769	0	75339
16759	1405	72032	536	490	0	74463
16760	665	69340	369	434	0	70808
16761	67448	1698	1371	1034	0	71551
16762	820	69286	257	294	0	70657
16763	434	598	102	67891	0	69025
16764	333	294	128	68229	0	68984
16765	68069	167	111	909	0	69256
16766	67239	133	130	556	0	68058
16767	720	68698	161	264	0	69843
16768	347	69605	184	196	0	70332
16769	297	630	69260	135	0	70322
16770	69857	276	661	348	0	71142
16771	73796	160	211	350	0	74517
16772	76145	105	135	328	0	76713
16773	1044	137	107	77016	0	78304
16774	544	139	90	79904	0	80677
16775	81146	112	76	1143	0	82477
16776	1079	113	79	81067	0	82338
16777	402	121	82200	1007	0	83730
16778	502	115	789	81157	0	82563
16779	232	84839	300	1000	0	86371
16780	387	908	175	86156	0	87626
16781	410	336	109	87767	0	88622
16782	391	231	104	88651	0	89377
16783	87324	144	103	1713	0	89284
16784	1040	87816	133	650	0	89639
16785	636	974	88	89496	0	91194
16786	300	408	89686	1231	0	91625
16787	282	327	84970	589	0	86168
16788	500	155	1331	86980	0	88966
16789	408	134	516	89046	0	90104
16790	87934	127	271	1723	0	90055
16791	1350	162	170	86186	0	87868
16792	452	86944	195	1415	0	89006
16793	363	1144	89525	629	0	91661
16794	516	523	1091	90052	0	92182
16795	261	315	92540	1315	0	94431
16796	458	169	1240	91892	0	93759
16797	92166	168	473	1684	0	94491
16798	92537	160	303	886	0	93886
16799	1462	92292	315	468	0	94537
16800	791	1100	226	93002	0	95119
16801	95122	401	214	1638	0	97375
16802	95798	237	199	978	0	97212
16803	97127	160	183	848	0	98318
16804	96590	157	190	748	0	97685
16805	96387	156	198	696	0	97437
16806	1701	94778	270	380	0	97129
16807	94885	1015	208	545	0	96653
16808	1461	454	94209	325	0	96449
16809	907	251	1051	94390	0	96599
16810	96485	141	380	1545	0	98551
16811	95952	175	246	916	0	97289
16812	95944	160	150	719	0	96973
16813	1729	233	95980	375	0	98317
16814	1092	184	1104	97166	0	99546
16815	100419	146	390	1667	0	102622
16816	1344	101240	336	606	0	103526
16817	105759	1112	187	942	0	108000
16818	104157	423	169	792	0	105541
16819	104950	323	174	681	0	106128
16820	1959	268	148	106236	0	108611
16821	107432	222	174	1825	0	109653
16822	1696	298	106580	691	0	109265
16823	854	271	105092	591	0	106808
16824	105869	164	1501	863	0	108397
16825	1544	255	109713	372	0	111884
16826	102103	135	1271	775	0	104284
16827	1552	182	108122	326	0	110182
16828	971	189	1330	105610	0	108100
16829	105579	135	503	1773	0	107990
16830	1434	104652	434	664	0	107184
16831	106005	1070	256	901	0	108232
16832	1513	103814	309	424	0	106060
16833	712	108781	242	382	0	110117
16834	827	1248	233	110495	0	112803
16835	683	450	262	110953	0	112348
16836	630	267	270	110453	0	111620
16837	450	258	109143	1663	0	111514
16838	104946	185	1269	1127	0	107527
16839	113084	164	500	947	0	114695
16840	114146	186	317	821	0	115470
16841	114302	210	225	758	0	115495
16842	113925	180	239	721	0	115065
16843	2202	270	106950	475	0	109897
16844	1115	246	108406	408	0	110175
16845	1035	159	1652	110802	0	113648
16846	665	268	112316	1520	0	114769
16847	109955	194	1578	999	0	112726
16848	2083	117976	627	506	0	121192
16849	1256	1712	360	125097	0	128425
16850	126107	515	292	2471	0	129385
16851	2839	315	283	128108	0	131545
16852	1262	258	129157	2348	0	133025
16853	936	294	128289	952	0	130471
16854	1066	160	2800	132736	0	136762
16855	728	207	133851	2355	0	137141
16856	128061	139	2639	1317	0	132156
16857	2771	230	1114	132753	0	136868
16858	1317	243	133221	2424	0	137205
16859	907	132347	2455	1193	0	136902
16860	1170	2063	1003	135125	0	139361
16861	794	844	137032	2439	0	141109
16862	1087	487	2517	130496	0	134587
16863	1078	260	1091	133246	0	135675
16864	659	325	135249	3375	0	139608
16865	1087	209	2696	133377	0	137369
16866	1239	196	1248	129988	0	132671
16867	989	244	820	135760	0	137813
16868	130772	199	614	3967	0	135552
16869	2668	127769	679	1775	0	132891
16870	1211	131290	544	1110	0	134155
16871	834	2879	127062	833	0	131608
16872	120670	987	2389	1152	0	125198
16873	2503	598	124358	561	0	128020
16874	1029	450	122307	595	0	124381
16875	997	353	2780	119446	0	123576
16876	121503	161	1195	2819	0	125678
16877	2188	121446	789	1263	0	125686
16878	120299	1954	648	1337	0	124238
16879	118792	790	457	1265	0	121304
16880	2623	120348	473	645	0	124089
16881	119573	1939	502	1001	0	123015
16882	118792	770	433	993	0	120988
16883	2588	120348	515	496	0	123947
16884	1480	2102	403	120261	0	124246
16885	1115	823	402	123103	0	125443
16886	125301	443	449	2949	0	129142
16887	2389	128023	501	1271	0	132184
16888	131261	2417	441	1223	0	135342
16889	132114	964	406	1187	0	134671
16890	138724	489	352	1089	0	140654
16891	4254	410	343	135581	0	140588
16892	2057	393	283	139578	0	142311
16893	136757	325	274	4089	0	141445
16894	139640	347	320	2025	0	142332
16895	141502	371	265	1438	0	143576
16896	4699	349	282	144531	0	149861
16897	1861	416	144961	3628	0	150866
16898	1663	319	3282	146520	0	151784
16899	1531	287	1212	158145	0	161175
16900	929	406	154474	5103	0	160912
16901	940	437	167748	2122	0	171247
16902	1549	338	5616	169638	0	177141
16903	979	409	171916	5218	0	178522
16904	171633	249	5424	2972	0	180278
16905	5809	304	2274	174375	0	182762
16906	2983	262	1329	179715	0	184289
16907	179446	263	822	7546	0	188077
16908	6067	267	905	178752	0	185991
16909	3367	258	804	181128	0	185557
16910	2269	320	793	183793	0	187175
16911	1986	269	660	184827	0	187742
16912	1213	402	176724	8076	0	186415
16913	1673	305	4880	177723	0	184581
16914	1121	365	174215	6961	0	182662
16915	961	174258	5663	3744	0	184626
16916	1620	4741	2338	173449	0	182148
16917	1006	1907	170016	6418	0	179347
16918	158142	889	5511	4182	0	168724
16919	5466	167823	2649	2444	0	178382
16920	169365	4806	1444	2485	0	178100
16921	6575	1944	1159	163277	0	172955
16922	2728	164454	1074	5772	0	174028
16923	164454	4912	907	3802	0	174075
16924	5595	166780	1058	2446	0	175879
16925	167702	5444	858	2384	0	176388
16926	6718	2466	894	165747	0	175825
16927	167301	1354	857	6456	0	175968
16928	6071	168926	974	3368	0	179339
16929	169159	5464	839	2778	0	178240
16930	6781	2445	165424	1864	0	176514
16931	3921	1429	5331	166655	0	177336
16932	165362	918	2374	6773	0	175427
16933	168647	914	1371	3840	0	174772
16934	8395	797	1022	164804	0	175018
16935	3842	957	163765	6572	0	175136
16936	2541	154734	5344	3590	0	166209
16937	2052	166191	2594	2488	0	173325
16938	166042	6296	1693	2730	0	176761
16939	6772	2558	1097	163706	0	174133
16940	3935	1356	1081	168143	0	174515
16941	164578	948	1057	8338	0	174921
16942	165498	1011	1271	4514	0	172294
16943	7697	1066	162987	2717	0	174467
16944	4494	954	5292	162068	0	172808
16945	2681	927	161409	6575	0	171592
16946	2278	159737	5479	4063	0	171557
16947	152175	4534	2481	3670	0	162860
16948	5359	153010	1763	2582	0	162714
16949	2848	153939	1361	2282	0	160430
16950	2759	5611	1351	151233	0	160954
16951	146354	2532	1209	6131	0	156226
16952	4915	147219	1305	3409	0	156848
16953	144946	4787	1069	3074	0	153876
16954	5479	143920	1254	2101	0	152754
16955	3368	5129	921	144928	0	154346
16956	144172	2381	1094	6066	0	153713
16957	5502	1722	144244	3438	0	154906
16958	3689	1500	4583	144206	0	153978
16959	2436	1474	142986	5776	0	152672
16960	2282	135195	4864	3444	0	145785
16961	1850	143482	2236	2809	0	150377
16962	137345	5564	1654	3013	0	147576
16963	4952	142138	1299	2471	0	150860
16964	141587	5088	1386	2672	0	150733
16965	144425	2502	1338	2627	0	150892
16966	6274	2037	140527	2067	0	150905
16967	138561	1629	4498	2435	0	147123
16968	5991	1844	143756	1882	0	153473
16969	3645	143202	4788	1969	0	153604
16970	143898	4822	2399	2271	0	153390
16971	5819	143468	1796	1977	0	153060
16972	3686	4951	1328	144526	0	154491
16973	145818	2435	1367	5474	0	155094
16974	6295	1903	1065	145268	0	154531
16975	3399	1792	146382	5808	0	157381
16976	2963	1845	4471	145056	0	154335
16977	2600	1821	2137	149803	0	156361
16978	146603	1805	1359	6897	0	156664
16979	5862	1675	144277	3629	0	155443
16980	144461	1500	4725	2820	0	153506
16981	151477	1335	2335	2540	0	157687
16982	7416	1429	1691	147942	0	158478
16983	4480	1448	1238	150179	0	157345
16984	147162	1393	1245	6949	0	156749
16985	6252	148065	1278	3366	0	158961
16986	4020	4491	1125	144814	0	154450
16987	2764	2205	140759	4733	0	150461
16988	2454	1723	133927	2748	0	140852
16989	2069	140335	4728	2181	0	149313
16990	2437	4285	2000	134344	0	143066
16991	2190	2386	1221	137324	0	143121
16992	133637	1674	985	5594	0	141890
16993	5141	1411	1049	132510	0	140111
16994	127552	1130	1000	4829	0	134511
16995	4555	124418	980	2748	0	132701
16996	2343	122646	782	1907	0	127678
16997	1866	126899	683	1628	0	131076
16998	122366	3690	1053	2092	0	129201
16999	113165	1559	959	1630	0	117313
17000	3578	111413	670	1152	0	116813
17001	94459	1095	413	614	0	96581
17002	1283	93311	219	324	0	95137
17003	717	1275	129	90993	0	93114
17004	367	91109	182	1188	0	92846
17005	90735	1277	303	836	0	93151
17006	90903	466	134	642	0	92145
17007	1474	357	123	88012	0	89966
17008	88241	308	138	1348	0	90035
17009	1363	315	112	87514	0	89304
17010	525	89222	186	1134	0	91067
17011	617	1385	131	89088	0	91221
17012	441	89423	200	1103	0	91167
17013	88685	1029	124	820	0	90658
17014	1145	464	86438	359	0	88406
17015	82755	275	774	564	0	84368
17016	1123	224	200	86265	0	87812
17017	474	283	85197	903	0	86857
17018	81463	232	793	754	0	83242
17019	1039	264	87877	300	0	89480
17020	675	245	879	84787	0	86586
17021	539	199	302	87060	0	88100
17022	503	195	164	86199	0	87061
17023	522	205	155	86260	0	87142
17024	323	85073	207	1347	0	86950
17025	477	1057	144	90437	0	92115
17026	89611	356	136	1791	0	91894
17027	1314	300	89277	519	0	91410
17028	478	94699	1174	423	0	96774
17029	96353	1504	355	725	0	98937
17030	104475	668	218	662	0	106023
17031	2806	336	140	116612	0	119894
17032	1005	421	116996	2798	0	121220
17033	1131	322	2592	114605	0	118650
17034	1067	244	1085	124345	0	126741
17035	455	299	123307	4216	0	128277
17036	430	127228	3326	1869	0	132853
17037	128889	3447	1473	1232	0	135041
17038	129155	1649	520	1175	0	132499
17039	133223	758	444	1016	0	135441
17040	6292	495	622	128329	0	135738
17041	3411	351	272	136291	0	140325
17042	137074	273	303	5977	0	143627
17043	5327	333	340	129986	0	135986
17044	2461	133142	375	4661	0	140639
17045	138276	3898	305	2920	0	145399
17046	138024	1878	442	2414	0	142758
17047	148139	864	354	1677	0	151034
17048	150809	594	277	1600	0	153280
17049	7853	571	140091	945	0	149460
17050	4046	592	141877	826	0	147341
17051	3182	510	6082	137962	0	147736
17052	2711	458	2569	143278	0	149016
17053	1760	456	141241	6542	0	149999
17054	1606	470	143180	3104	0	148360
17055	2087	331	6435	140497	0	149350
17056	141377	342	2922	5879	0	150520
17057	6215	323	1693	138947	0	147178
17058	3099	432	140902	5759	0	150192
17059	1981	141765	5154	3139	0	152039
17060	141494	4507	2659	2480	0	151140
17061	144915	2030	1672	2185	0	150802
17062	146768	925	1471	1908	0	151072
17063	147425	628	1399	1800	0	151252
17064	8158	606	138056	1390	0	148210
17065	4804	443	5162	138072	0	148481
17066	140263	444	2759	6024	0	149490
17067	6800	509	1788	139797	0	148894
17068	4385	449	1491	134804	0	141129
17069	2594	133860	1182	7111	0	144747
17070	3026	4551	933	137977	0	146487
17071	134754	2091	978	6863	0	144686
17072	5995	135617	1226	3631	0	146469
17073	134967	5169	960	2705	0	143801
17074	6731	135160	973	1978	0	144842
17075	4694	5327	773	124887	0	135681
17076	2984	127573	979	5400	0	136936
17077	2427	135418	1045	3168	0	142058
17078	131527	6541	1110	2671	0	141849
17079	6273	3188	128792	2327	0	140580
17080	3759	1953	127841	2040	0	135593
17081	2654	1619	127623	2025	0	133921
17082	119405	1388	7003	2648	0	130444
17083	5726	122967	3626	2045	0	134364
17084	3574	128651	2025	1947	0	136197
17085	120141	6735	1388	2190	0	130454
17086	6379	120690	1337	1603	0	130009
17087	4048	126058	1339	1555	0	133000
17088	3170	7223	1275	123163	0	134831
17089	2671	3824	122378	5769	0	134642
17090	2722	2562	124719	3444	0	133447
17091	2745	2190	6826	123339	0	135100
17092	121211	1827	3587	6452	0	133077
17093	6350	123340	2570	3523	0	135783
17094	4455	5671	2119	124463	0	136708
17095	3339	3373	123304	5922	0	135938
17096	3253	2409	121435	3664	0	130761
17097	3159	1983	7168	119469	0	131779
17098	118701	1884	3920	6765	0	131270
17099	122899	1690	2547	4280	0	131416
17100	8257	1795	118306	2830	0	131188
17101	118705	1729	6003	3014	0	129451
17102	7627	1549	119808	2589	0	131573
17103	5022	1248	6758	112337	0	125365
17104	3619	117110	4378	5684	0	130791
17105	121008	5250	2955	3879	0	133092
17106	7523	2991	2387	120998	0	133899
17107	5286	2058	2271	121342	0	130957
17108	4054	1506	2322	126778	0	134660
17109	3574	1209	2535	127210	0	134528
17110	3136	1258	119205	8790	0	132389
17111	3109	117264	6293	5216	0	131882
17112	3484	5045	3835	120741	0	133105
17113	119565	2811	2650	7285	0	132311
17114	7073	1817	2521	121477	0	132888
17115	4731	1505	2314	123939	0	132489
17116	3245	1587	118043	8899	0	131774
17117	3083	1678	115464	5502	0	125727
17118	2767	113122	7345	4152	0	127386
17119	2627	119504	4087	3583	0	129801
17120	2717	6745	2685	118124	0	130271
17121	116808	3508	2135	7476	0	129927
17122	6232	2478	115738	4916	0	129364
17123	4216	116853	5540	3722	0	130331
17124	3488	5526	3509	111462	0	123985
17125	2463	115556	2221	5943	0	126183
17126	2793	5914	1898	110088	0	120693
17127	2143	113465	1742	6155	0	123505
17128	2638	5432	1421	106933	0	116424
17129	102439	3180	1381	5903	0	112903
17130	4490	95118	1492	3273	0	104373
17131	2167	4030	1029	80738	0	87964
17132	78894	2107	854	3674	0	85529
17133	3129	78304	821	2282	0	84536
17134	1350	69156	642	1542	0	72690
17135	1304	70741	606	1387	0	74038
17136	1267	2481	921	65162	0	69831
17137	640	1266	529	64653	0	67088
17138	532	63655	387	2148	0	66722
17139	663	1979	365	63995	0	67002
17140	676	1033	64296	1845	0	67850
17141	427	63488	1357	822	0	66094
17142	543	3596	497	57390	0	62026
17143	507	61533	358	1139	0	63537
17144	449	1325	59217	633	0	61624
17145	266	59419	963	503	0	61151
17146	52189	935	540	487	0	54151
17147	606	296	127	52095	0	53124
17148	52033	120	81	675	0	52909
17149	535	134	51725	221	0	52615
17150	350	86	490	52636	0	53562
17151	127	113	53906	555	0	54701
17152	219	136	527	53423	0	54305
17153	55500	70	217	797	0	56584
17154	640	96	115	55880	0	56731
17155	55983	92	93	849	0	57017
17156	511	57181	95	322	0	58109
17157	56414	511	98	418	0	57441
17158	574	243	57225	157	0	58199
17159	251	58329	546	155	0	59281
17160	277	503	193	58974	0	59947
17161	268	182	95	59284	0	59829
17162	120	163	58521	633	0	59437
17163	106	58627	508	333	0	59574
17164	206	530	196	59097	0	60029
17165	76	59874	158	501	0	60609
17166	191	547	73	59015	0	59826
17167	76	59354	80	570	0	60080
17168	58614	538	75	419	0	59646
17169	567	278	64	59626	0	60535
17170	237	200	59595	491	0	60523
17171	105	59417	472	250	0	60244
17172	57	61865	193	197	0	62312
17173	107	626	60899	116	0	61748
17174	60	61536	489	124	0	62209
17175	200	468	154	61308	0	62130
17176	101	213	62629	397	0	63340
17177	253	100	421	61070	0	61844
17178	206	101	164	62784	0	63255
17179	59	134	63329	545	0	64067
17180	59077	106	457	466	0	60106
17181	524	78	193	64633	0	65428
17182	187	95	69909	480	0	70671
17183	99	70634	488	237	0	71458
17184	71011	403	190	529	0	72133
17185	423	70807	149	151	0	71530
17186	236	447	80	72268	0	73031
17187	71341	163	64	735	0	72303
17188	539	99	71	71287	0	71996
17189	206	132	73615	499	0	74452
17190	269	98	478	73348	0	74193
17191	117	160	73878	507	0	74662
17192	69854	80	528	614	0	71076
17193	509	126	74471	165	0	75271
17194	73456	76	512	482	0	74526
17195	74746	73	233	520	0	75572
17196	647	106	76386	113	0	77252
17197	348	187	71652	119	0	72306
17198	157	76720	651	125	0	77653
17199	78945	482	284	413	0	80124
17200	659	204	171	81073	0	82107
17201	431	119	109	80246	0	80905
17202	89277	100	122	1309	0	90808
17203	90903	68	113	854	0	91938
17204	91519	93	124	551	0	92287
17205	91614	119	121	425	0	92279
17206	773	122	94	90856	0	91845
17207	91956	78	99	841	0	92974
17208	714	76	88	92548	0	93426
17209	432	76	99	91408	0	92015
17210	310	75	118	93217	0	93720
17211	219	157	91597	719	0	92692
17212	191	89020	562	396	0	90169
17213	145	91052	285	242	0	91724
17214	232	575	147	92709	0	93663
17215	92402	263	85	896	0	93646
17216	624	116	102	92123	0	92965
17217	91771	101	118	1068	0	93058
17218	632	154	96869	327	0	97982
17219	92941	103	555	617	0	94216
17220	689	108	215	99534	0	100546
17221	102376	99	159	1170	0	103804
17222	101405	82	104	825	0	102416
17223	102933	80	99	677	0	103789
17224	948	81	110	103569	0	104708
17225	434	167	103112	629	0	104342
17226	443	104	643	102372	0	103562
17227	104621	83	274	1141	0	106119
17228	815	179	116495	309	0	117798
17229	714	106	705	122665	0	124190
17230	127480	68	302	1634	0	129484
17231	1085	191	129604	403	0	131283
17232	132958	90	1002	992	0	135042
17233	142121	96	372	824	0	143413
17234	1736	83	234	143620	0	145673
17235	921	98	168	145764	0	146951
17236	146179	64	163	2236	0	148642
17237	1686	73	136	149913	0	151808
17238	148651	49	117	2535	0	151352
17239	1730	149444	191	868	0	152233
17240	654	151352	170	497	0	152673
17241	730	1854	61	150898	0	153543
17242	339	717	153555	1609	0	156220
17243	219	152713	1546	738	0	155216
17244	149511	1656	523	1156	0	152846
17245	1420	149160	352	371	0	151303
17246	583	1710	148694	203	0	151190
17247	1001	643	1388	144700	0	147732
17248	268	549	152520	1521	0	154858
17249	177	156308	1687	686	0	158858
17250	591	1456	556	155480	0	158083
17251	180	155458	413	1359	0	157410
17252	289	1694	154989	450	0	157422
17253	640	645	1454	151389	0	154128
17254	207	533	156262	1505	0	158507
17255	609	243	1612	153054	0	155518
17256	154858	174	686	2369	0	158087
17257	1526	353	153049	661	0	155589
17258	141473	155	1570	1193	0	144391
17259	1750	302	152048	334	0	154434
17260	1056	128	1754	150468	0	153406
17261	498	245	160266	1647	0	162656
17262	844	136	1751	158167	0	160898
17263	595	185	713	160939	0	162432
17264	796	152	454	157378	0	158780
17265	642	187	343	160933	0	162105
17266	292	248	170904	2301	0	173745
17267	162887	172	1633	2024	0	166716
17268	1806	158	654	183421	0	186039
17269	183240	144	444	2803	0	186631
17270	186317	160	335	1736	0	188548
17271	189768	174	325	1412	0	191679
17272	2987	192	267	193914	0	197360
17273	1525	199	323	196592	0	198639
17274	680	215549	415	2759	0	219403
17275	235049	3029	339	2151	0	240568
17276	247561	1317	261	1901	0	251040
17277	250034	816	294	1692	0	252836
17278	6825	777	251807	571	0	259980
17279	4436	346	4219	250100	0	259101
17280	2427	497	253066	4441	0	260431
17281	246603	264	5072	2916	0	254855
17282	253541	235	2535	2304	0	258615
17283	7089	273	1520	249401	0	258283
17284	4159	357	1206	243103	0	248825
17285	2388	253799	973	5764	0	262924
17286	256096	4147	710	3933	0	264886
17287	257842	1875	549	3170	0	263436
17288	6780	255858	787	1768	0	265193
17289	258597	4803	666	2358	0	266424
17290	7229	2230	673	258569	0	268701
17291	4614	1323	678	261677	0	268292
17292	261794	921	618	7569	0	270902
17293	6048	958	259525	3474	0	270005
17294	254684	639	4302	3854	0	263479
17295	262787	537	1936	3401	0	268661
17296	7184	259160	1359	1719	0	269422
17297	263557	4409	981	2455	0	271402
17298	7033	2378	258968	988	0	269367
17299	4961	1494	4436	258638	0	269529
17300	261318	1118	2044	5837	0	270317
17301	7199	847	1332	261017	0	270395
17302	3881	871	254013	5868	0	264633
17303	3619	494	5173	243673	0	252959
17304	2359	274481	2730	6213	0	285783
17305	3057	4428	1715	281215	0	290415
17306	3032	2109	1303	285775	0	292219
17307	3146	1406	1147	279413	0	285112
17308	2718	1167	911	285619	0	290415
17309	1627	1221	280813	8591	0	292252
17310	2591	983	4546	280911	0	289031
17311	279855	658	2270	8893	0	291676
17312	5417	278686	1762	4551	0	290416
17313	3782	4676	1276	287876	0	297610
17314	2538	2404	288620	6699	0	300261
17315	2939	1474	4891	289860	0	299164
17316	291525	1129	2393	8584	0	303631
17317	291714	944	1753	5695	0	300106
17318	284731	811	1621	4356	0	291519
17319	9168	617	1280	287028	0	298093
17320	5326	766	286703	6435	0	299230
17321	4041	282639	5131	4024	0	295835
17322	286421	4649	2759	4074	0	297903
17323	7112	2271	2095	285236	0	296714
17324	4736	1582	1736	288336	0	296390
17325	3589	1546	284264	7760	0	297159
17326	3356	277096	5315	4853	0	290620
17327	2945	288986	2874	3722	0	298527
17328	3364	6784	1999	275312	0	287459
17329	2360	3261	268905	6732	0	281258
17330	246469	2196	5130	5484	0	259279
17331	6417	2031	255511	3038	0	266997
17332	241291	1437	4787	4363	0	251878
17333	6377	263211	2978	3071	0	275637
17334	4123	4565	260447	2478	0	271613
17335	249344	2526	5106	3398	0	260374
17336	6405	257798	2840	2004	0	269047
17337	264621	4799	2051	3217	0	274688
17338	6433	2878	265125	1741	0	276177
17339	4173	267220	4736	1952	0	278081
17340	269300	4600	2553	3162	0	279615
17341	6588	2833	265881	1751	0	277053
17342	263874	1738	4962	2564	0	273138
17343	6958	1437	3100	265793	0	277288
17344	269486	1369	2344	5806	0	279005
17345	7239	1249	1966	268731	0	279185
17346	268578	1335	1646	6861	0	278420
17347	6686	1358	268990	3859	0	280893
17348	4705	1061	4730	270941	0	281437
17349	3479	1164	2633	271415	0	278691
17350	2928	1291	269071	7273	0	280563
17351	2903	1165	5174	268355	0	277597
17352	3350	228046	4817	7324	0	243537
17353	2369	4603	2228	291057	0	300257
17354	2887	2333	1940	305500	0	312660
17355	3311	1580	1538	331460	0	337889
17356	2289	1488	328453	12134	0	344364
17357	317382	1199	7974	8152	0	334707
17358	10471	1044	3985	348273	0	363773
17359	5076	1041	353523	11408	0	371048
17360	341305	892	10162	7586	0	359945
17361	356016	952	4784	5665	0	367417
17362	366888	1023	3014	4638	0	375563
17363	16555	1107	2330	359043	0	379035
17364	9520	1136	1931	396455	0	409042
17365	6731	1151	1910	388630	0	398422
17366	3975	386588	2000	17273	0	409836
17367	380269	11339	1648	10423	0	403679
17368	384179	4392	1771	7759	0	398101
17369	18459	2696	1649	378147	0	400951
17370	8777	2018	372997	14017	0	397809
17371	6419	1784	375414	7109	0	390726
17372	4341	353170	15980	5507	0	378998
17373	3682	373734	7240	4479	0	389135
17374	336600	14506	5390	6037	0	362533
17375	10768	333173	2006	2627	0	348574
17376	326021	10417	1524	3185	0	341147
17377	326601	3887	1137	3590	0	335215
17378	327438	2259	1153	3187	0	334037
17379	15930	1582	1167	320013	0	338692
17380	8393	1574	933	342205	0	353105
17381	345218	1332	899	14882	0	362331
17382	14531	1154	971	349594	0	366250
17383	5797	1403	346565	13362	0	367127
17384	346597	1255	10834	6413	0	365099
17385	14486	1354	4055	343986	0	363881
17386	7843	1593	2163	351658	0	363257
17387	6287	1627	1328	360076	0	369318
17388	3755	1459	346246	16666	0	368126
17389	322123	1421	11309	9000	0	343853
17390	13673	1287	344088	4592	0	363640
17391	8059	1092	12709	339303	0	361163
17392	4824	1422	347723	13143	0	367112
17393	5520	1056	12939	337068	0	356583
17394	5182	1148	5284	349891	0	361505
17395	3768	1272	349656	16940	0	371636
17396	5589	1271	12769	318382	0	338011
17397	3427	346243	5634	13733	0	369037
17398	345421	11085	3432	8468	0	368406
17399	354355	3903	2536	7054	0	367848
17400	17781	2224	2385	347782	0	370172
17401	7853	1531	348979	14925	0	373288
17402	5092	328942	13246	7975	0	355255
17403	4071	352586	5878	5802	0	368337
17404	323281	13868	4293	6003	0	347445
17405	13884	5816	319029	4883	0	343612
17406	317750	3090	12967	5466	0	339273
17407	16155	1914	5943	317601	0	341613
17408	8354	1777	4034	329494	0	343659
17409	311336	1823	3613	19049	0	335821
17410	14022	314552	2960	9868	0	341402
17411	6989	12054	317434	6545	0	343022
17412	7335	4499	12904	311148	0	335886
17413	4765	3053	317863	15249	0	340930
17414	3982	310567	14691	8391	0	337631
17415	5343	11931	6967	313732	0	337973
17416	308359	5477	4524	16771	0	335131
17417	317495	3724	3885	9430	0	334534
17418	17899	3109	308046	6499	0	335553
17419	8760	306677	13905	5616	0	334958
17420	304695	12383	6527	6013	0	329618
17421	15058	308815	4671	5558	0	334102
17422	8935	14005	3756	305317	0	332013
17423	305736	6061	3314	16001	0	331112
17424	15941	4291	3464	309237	0	332933
17425	8211	3351	302345	16556	0	330463
17426	7240	2928	13528	306485	0	330181
17427	5360	3466	304585	16774	0	330185
17428	6229	3296	14631	302616	0	326772
17429	298596	2747	6910	18396	0	326649
17430	15403	301260	5191	9576	0	331430
17431	302827	13041	4329	7823	0	328020
17432	17364	5990	4159	299208	0	326721
17433	9020	4902	3923	304685	0	322530
17434	6860	4168	268110	19993	0	299131
17435	5779	3903	297512	10137	0	317331
17436	5462	292545	16639	7955	0	322601
17437	6084	13294	291254	6325	0	316957
17438	271997	6003	16107	7272	0	301379
17439	15202	281420	8229	6234	0	311085
17440	7925	290527	5752	6372	0	310576
17441	6386	296054	5108	5789	0	313337
17442	6340	18440	3837	284243	0	312860
17443	5464	8350	286862	15820	0	316496
17444	4943	288491	14641	9190	0	317265
17445	6143	14671	7027	264324	0	292165
17446	4815	289728	5544	15055	0	315142
17447	281000	15105	4547	9352	0	310004
17448	290861	6867	4571	7595	0	309894
17449	18553	5192	4752	282164	0	310661
17450	9926	4586	4315	287647	0	306474
17451	268475	3903	4321	19500	0	296199
17452	14591	260829	4308	10429	0	290157
17453	7379	267232	3936	7275	0	285822
17454	7034	15682	3194	238297	0	264207
17455	3660	5578	218193	11526	0	238957
17456	3058	214354	9780	6471	0	233663
17457	197339	8964	5358	5122	0	216783
17458	8180	191071	3536	4193	0	206980
17459	3991	192924	2841	3421	0	203177
17460	179673	9658	2923	3445	0	195699
17461	7917	187021	2152	2806	0	199896
17462	4137	8515	178812	2689	0	194153
17463	2940	177687	7063	3009	0	190699
17464	141301	5475	3048	2082	0	151906
17465	4214	142056	1600	1389	0	149259
17466	139990	4944	1677	1607	0	148218
17467	5062	2610	1062	138051	0	146785
17468	2673	1915	998	142872	0	148458
17469	1772	1831	141298	4958	0	149859
17470	1616	142826	3697	2586	0	150725
17471	1924	4374	1518	144901	0	152717
17472	142508	2190	1253	4975	0	150926
17473	143167	1696	1044	2762	0	148669
17474	4896	145468	1047	2000	0	153411
17475	2642	4554	1007	145060	0	153263
17476	145243	2246	967	4753	0	153209
17477	147431	1846	966	2517	0	152760
17478	5538	1675	140754	1570	0	149537
17479	2595	1499	131768	1196	0	137058
17480	1685	1236	127727	911	0	131559
17481	934	120482	3493	772	0	125681
17482	111662	2617	2700	927	0	117906
17483	2472	112236	953	525	0	116186
17484	109841	2709	782	764	0	114096
17485	2455	117059	463	534	0	120511
17486	1535	2537	391	119965	0	124428
17487	121856	1175	322	2613	0	125966
17488	2596	909	122019	886	0	126410
17489	118938	720	2156	1041	0	122855
17490	123881	575	895	894	0	126245
17491	3109	123337	604	477	0	127527
17492	1199	127044	505	409	0	129157
17493	129741	2694	654	814	0	133903
17494	2648	1215	135627	309	0	139799
17495	127242	1168	2321	760	0	131491
17496	132012	681	908	662	0	134263
17497	3241	527	443	130111	0	134322
17498	133704	508	315	2380	0	136907
17499	3046	541	244	136775	0	140606
17500	1593	496	244	140804	0	143137
17501	1270	456	273	138372	0	140371
17502	793	138774	400	2635	0	142602
17503	140308	2084	364	1578	0	144334
17504	142365	911	358	1037	0	144671
17505	3165	670	357	141392	0	145584
17506	1751	640	311	139366	0	142068
17507	999	141076	420	2508	0	145003
17508	141157	2233	348	1494	0	145232
17509	2635	1121	139348	667	0	143771
17510	1597	782	2005	140512	0	144896
17511	1009	737	139741	2305	0	143792
17512	1244	591	2174	138812	0	142821
17513	876	642	142149	2451	0	146118
17514	1216	578	2233	137883	0	141910
17515	140681	500	884	2989	0	145054
17516	2616	615	145413	1192	0	149836
17517	139531	488	2229	1417	0	143665
17518	2834	153633	1056	778	0	158301
17519	1655	2157	745	156474	0	161031
17520	1360	967	585	159692	0	162604
17521	164451	803	509	3436	0	169199
17522	3018	713	439	172094	0	176264
17523	1553	719	177177	2678	0	182127
17524	171251	553	1988	2255	0	176047
17525	182536	475	807	1811	0	185629
17526	183120	496	610	1593	0	185819
17527	182965	401	502	1549	0	185417
17528	3476	180630	606	849	0	185561
17529	1911	1913	421	183085	0	187330
17530	182333	735	488	2815	0	186371
17531	2910	648	392	180763	0	184713
17532	178638	598	376	2789	0	182401
17533	2606	635	175423	1121	0	179785
17534	1551	479	175215	878	0	178123
17535	1761	1858	2090	165522	0	171231
17536	1026	173748	1042	2005	0	177821
17537	872	181017	716	1190	0	183795
17538	176113	1808	707	1965	0	180593
17539	2024	781	179303	790	0	182898
17540	159724	447	1613	1717	0	163501
17541	1969	178252	873	736	0	181830
17542	179552	1397	551	1273	0	182773
17543	2250	675	390	178916	0	182231
17544	1218	740	185052	1731	0	188741
17545	1503	378	1424	182383	0	185688
17546	1204	354	677	183475	0	185710
17547	793	182524	587	2177	0	186081
17548	747	189114	551	1181	0	191593
17549	1066	1753	425	188879	0	192123
17550	930	190365	523	2037	0	193855
17551	956	1722	187861	1005	0	191544
17552	1000	889	180442	856	0	183187
17553	169343	554	2015	1593	0	173505
17554	185539	440	859	1534	0	188372
17555	2236	184678	604	755	0	188273
17556	1562	1537	411	184814	0	188324
17557	1265	691	435	186822	0	189213
17558	899	650	186470	2133	0	190152
17559	1323	672	1678	175143	0	178816
17560	692	184283	838	2135	0	187948
17561	720	1702	181149	1040	0	184611
17562	851	853	178407	821	0	180932
17563	873	171682	2202	960	0	175717
17564	861	1836	179833	628	0	183158
17565	1268	758	1863	176786	0	180675
17566	2066	710	990	160536	0	164302
17567	871	665	183120	2177	0	186833
17568	1337	603	1724	176906	0	180570
17569	650	175414	916	2190	0	179170
17570	574	182766	745	1259	0	185344
17571	892	1951	510	180676	0	184029
17572	685	773	182711	1921	0	186090
17573	511	184415	1829	916	0	187671
17574	1049	1878	660	183511	0	187098
17575	459	637	180552	1512	0	183160
17576	165922	339	1343	1628	0	169232
17577	178072	286	525	1407	0	180290
17578	178671	346	363	1220	0	180600
17579	1861	251	289	175965	0	178366
17580	1025	208	387	177428	0	179048
17581	527	367	182897	1584	0	185375
17582	1054	228	1351	177893	0	180526
17583	941	300	520	181801	0	183562
17584	387	424	182837	1676	0	185324
17585	151788	234	1379	2193	0	155594
17586	1258	172001	691	536	0	174486
17587	170856	1131	316	1521	0	173824
17588	1236	170755	301	415	0	172707
17589	724	1235	284	171583	0	173826
17590	488	489	172137	1248	0	174362
17591	972	572	1182	163160	0	165886
17592	361	334	167270	1364	0	169329
17593	138467	250	1309	2003	0	142029
17594	1091	312	157963	406	0	159772
17595	795	121	1358	151333	0	153607
17596	270	244	157955	1346	0	159815
17597	237	160074	1532	571	0	162414
17598	987	1394	509	163542	0	166432
17599	1050	377	436	162456	0	164319
17600	848	247	236	170293	0	171624
17601	369	294	169900	2654	0	173217
17602	353	416	171366	974	0	173109
17603	790	168	2756	171961	0	175675
17604	1039	162	956	207243	0	209400
17605	957	133	550	225280	0	226920
17606	228405	134	499	7709	0	236747
17607	5939	139	390	237138	0	243606
17608	2240	363	247262	6104	0	255969
17609	255363	171	5816	3716	0	265066
17610	7687	246	2365	266557	0	276855
17611	277310	205	1493	8253	0	287261
17612	284278	194	728	4578	0	289778
17613	11172	133	645	281324	0	293274
17614	283382	99	731	9195	0	293407
17615	286294	134	624	5199	0	292251
17616	10933	268	276498	2425	0	290124
17617	5226	278293	7149	1899	0	292567
17618	4523	6735	3150	263737	0	278145
17619	3555	2842	1618	279634	0	287649
17620	274913	1389	1012	11319	0	288633
17621	271470	724	1083	6178	0	279455
17622	270606	548	952	4267	0	276373
17623	12257	611	251134	2380	0	266382
17624	6149	254072	7483	2056	0	269760
17625	254266	6951	3415	2710	0	267342
17626	9265	257684	2157	1664	0	270770
17627	259443	8335	1110	2457	0	271345
17628	11197	3599	1038	255297	0	271131
17629	256745	2096	1068	8988	0	268897
17630	260427	1373	1013	5122	0	267935
17631	263779	1102	806	3905	0	269592
17632	13102	1039	254737	2450	0	271328
17633	258910	702	7184	3306	0	270102
17634	11298	259034	3422	2016	0	275770
17635	266614	7375	1961	2602	0	278552
17636	269617	3491	1390	2735	0	277233
17637	272691	2094	1376	2474	0	278635
17638	15238	1492	1185	254646	0	272561
17639	7853	259510	1119	7939	0	276421
17640	262520	7947	994	4930	0	276391
17641	11499	3813	257734	2974	0	276020
17642	7048	260164	7649	2462	0	277323
17643	7144	8266	3340	237541	0	256291
17644	4794	256426	2276	7075	0	270571
17645	255529	9255	1692	4410	0	270886
17646	266270	4605	1502	3162	0	275539
17647	14607	2931	1219	258864	0	277621
17648	7993	2256	253501	9338	0	273088
17649	5849	254354	8061	5163	0	273427
17650	7116	8865	4336	210112	0	230429
17651	5604	4293	2520	261418	0	273835
17652	5216	2774	1837	274083	0	283910
17653	266952	2102	1596	14383	0	285033
17654	273321	1977	1618	7543	0	284459
17655	276227	1912	1424	5109	0	284672
17656	280634	2020	1239	4215	0	288108
17657	17214	1863	1214	269114	0	289405
17658	9811	2021	272852	10692	0	295376
17659	8291	1500	8644	277020	0	295455
17660	7177	1432	4136	281246	0	293991
17661	6531	1455	2678	284064	0	294728
17662	6423	1647	2082	286941	0	297093
17663	278203	1618	1811	16633	0	298265
17664	13460	1462	2115	281226	0	298263
17665	279198	1260	1954	14648	0	297060
17666	285052	1411	1786	9193	0	297442
17667	17403	1625	270702	6388	0	296118
17668	11704	1566	268899	5136	0	287305
17669	9200	1388	280557	5247	0	296392
17670	8757	1653	13079	272045	0	295534
17671	7541	1712	279532	11798	0	300583
17672	7408	1697	11490	272908	0	293503
17673	6683	2063	5997	278807	0	293550
17674	277511	1897	3877	16536	0	299821
17675	14240	1945	2865	273413	0	292463
17676	9807	279208	2686	13924	0	305625
17677	287153	8815	2767	9260	0	307995
17678	14939	288764	2635	6180	0	312518
17679	10059	10602	289285	5239	0	315185
17680	7445	295534	10351	4805	0	318135
17681	290619	11340	5761	4956	0	312676
17682	14520	6283	3830	288228	0	312861
17683	10167	4345	284154	11529	0	310195
17684	287714	3026	10104	7783	0	308627
17685	15489	2962	5478	289262	0	313191
17686	10409	2656	289588	12102	0	314755
17687	9435	2493	10157	291372	0	313457
17688	8255	2415	5695	296524	0	312889
17689	7909	2542	3897	295457	0	309805
17690	7155	289902	3157	15018	0	315232
17691	296157	9925	2750	9254	0	318086
17692	14938	5548	2767	290144	0	313397
17693	9638	292865	2631	12069	0	317203
17694	8758	10494	1882	296127	0	317261
17695	6889	6241	291231	13037	0	317398
17696	6549	293679	9775	7978	0	317981
17697	288438	10167	5683	6950	0	311238
17698	288671	6140	3731	5576	0	304118
17699	15146	3852	2976	279264	0	301238
17700	9337	3485	2569	284926	0	300317
17701	281193	2644	2429	14821	0	301087
17702	273629	2604	2420	9732	0	288385
17703	13963	275073	2345	6643	0	298024
17704	238354	6085	1771	4408	0	250618
17705	8847	2954	223511	3098	0	238410
17706	5426	2021	217990	2879	0	228316
17707	3185	211848	6328	2899	0	224260
17708	2397	209889	3294	2068	0	217648
17709	188517	4487	4061	2143	0	199208
17710	3755	190670	1242	1347	0	197014
17711	184108	3236	919	1667	0	189930
17712	180674	1634	694	1746	0	184748
17713	180025	849	703	1624	0	183201
17714	4545	792	562	177844	0	183743
17715	180048	658	511	3896	0	185113
17716	3935	798	177166	1565	0	183464
17717	2201	791	176776	1169	0	180937
17718	1570	179548	3487	1166	0	185771
17719	1336	2651	182545	964	0	187496
17720	1956	1305	3179	173020	0	179460
17721	1019	1032	182917	3212	0	188180
17722	1293	847	178416	1604	0	182160
17723	1433	765	3545	179019	0	184762
17724	180664	684	1700	3907	0	186955
17725	181022	661	1072	2461	0	185216
17726	3946	738	186530	1086	0	192300
17727	180084	542	2966	2235	0	185827
17728	3559	687	190065	990	0	195301
17729	186081	506	3418	1727	0	191732
17730	196672	461	1698	1830	0	200661
17731	4401	568	1076	194895	0	200940
17732	2641	456	930	189101	0	193128
17733	1940	184255	1025	3796	0	191016
17734	1261	191810	1012	1958	0	196041
17735	1659	3204	987	187963	0	193813
17736	1670	1474	821	190750	0	194715
17737	185706	818	678	4376	0	191578
17738	3098	185087	801	1736	0	190722
17739	183884	2669	761	2177	0	189491
17740	3154	185724	817	1018	0	190713
17741	1710	3247	184094	695	0	189746
17742	1867	1418	2730	181335	0	187350
17743	183183	805	1257	3883	0	189128
17744	190907	706	705	2552	0	194870
17745	4437	195514	727	1207	0	201885
17746	1936	201494	643	987	0	205060
17747	1309	206975	668	842	0	209794
17748	1941	4855	650	219807	0	227253
17749	1091	1830	224654	4295	0	231870
17750	954	223821	4320	1581	0	230676
17751	1798	4266	1390	223231	0	230685
17752	1650	1315	684	228360	0	232009
17753	637	984	224409	4786	0	230816
17754	738	796	219708	1699	0	222941
17755	212593	527	4911	2248	0	220279
17756	4479	573	227913	732	0	233697
17757	221198	478	4496	1783	0	227955
17758	218553	602	1549	1552	0	222256
17759	219726	611	975	1488	0	222800
17760	218418	618	767	1596	0	221399
17761	5674	763	211666	644	0	218747
17762	2135	213422	4311	767	0	220635
17763	2586	4151	1534	209661	0	217932
17764	1234	1626	214575	4112	0	221547
17765	2035	987	4251	205403	0	212676
17766	1480	194953	2402	4341	0	203176
17767	2018	4173	1222	216577	0	223990
17768	2146	1558	928	218018	0	222650
17769	2226	972	954	213268	0	217420
17770	213635	828	869	6443	0	221775
17771	5598	816	844	212635	0	219893
17772	3007	751	840	214267	0	218865
17773	2300	821	958	212306	0	216385
17774	1104	205113	1323	5863	0	213403
17775	202653	4335	998	3595	0	211581
17776	4544	194139	1189	1975	0	201847
17777	1685	198870	1094	1433	0	203082
17778	2452	4680	1084	197477	0	205693
17779	2227	1823	917	198895	0	203862
17780	196373	1097	763	6382	0	204615
17781	5755	742	849	198163	0	205509
17782	198936	755	775	6287	0	206753
17783	236196	743	808	3300	0	241047
17784	9474	763	849	232941	0	244027
17785	4660	924	817	232742	0	239143
17786	1944	236857	1069	9096	0	248966
17787	240837	7354	788	5204	0	254183
17788	7921	251113	964	2745	0	262743
17789	250771	8626	803	2821	0	263021
17790	9201	3714	244522	2004	0	259441
17791	244039	2081	7402	2893	0	256415
17792	258219	1403	2796	2951	0	265369
17793	12270	1117	1564	248195	0	263146
17794	4996	1400	250561	9124	0	266081
17795	3183	249747	8270	4552	0	265752
17796	4024	8869	3277	253606	0	269776
17797	2529	3806	254964	9704	0	271003
17798	3476	2282	8837	251892	0	266487
17799	248123	1658	3541	11458	0	264780
17800	10177	1408	248407	4610	0	264602
17801	4385	242799	9000	3414	0	259598
17802	3233	254360	3935	2440	0	263968
17803	4512	11180	2392	215032	0	233116
17804	2454	248501	1729	7397	0	260081
17805	243397	9793	1541	4573	0	259304
17806	246076	4107	1239	3983	0	255405
17807	248781	2494	1293	3401	0	255969
17808	12348	2338	234158	2250	0	251094
17809	239328	2019	8461	2937	0	252745
17810	11532	2057	3557	233747	0	250893
17811	5958	1720	2104	239783	0	249565
17812	4681	1733	1535	241992	0	249941
17813	4121	1572	1688	242581	0	249962
17814	2899	1789	232696	13222	0	250606
17815	2747	2041	233814	6205	0	244807
17816	2477	1827	232233	4271	0	240808
17817	217272	1682	11750	4041	0	234745
17818	9829	223914	4920	3412	0	242075
17819	5897	8879	2861	221922	0	239559
17820	219873	3741	2062	11088	0	236764
17821	9982	222380	2025	5596	0	239983
17822	5092	232341	2231	3595	0	243259
17823	223529	11307	1989	3621	0	240446
17824	228539	5060	1823	3557	0	238979
17825	12198	226540	1859	3063	0	243660
17826	6985	9604	1580	207397	0	225566
17827	4174	220329	1616	9375	0	235494
17828	218070	9858	1636	5159	0	234723
17829	217100	4580	1843	3976	0	227499
17830	219092	3223	1597	3359	0	227271
17831	13396	209786	1561	2871	0	227614
17832	7096	9352	1321	211945	0	229714
17833	4322	4684	209957	10404	0	229367
17834	4584	3229	8400	209998	0	226211
17835	4306	2848	3535	217516	0	228205
17836	3488	2739	207846	12364	0	226437
17837	205265	2179	8937	6307	0	222688
17838	11252	2159	3923	209643	0	226977
17839	6280	2331	2518	208618	0	219747
17840	4094	207157	1893	12119	0	225263
17841	206335	9345	1786	6429	0	223895
17842	11304	4695	1566	201718	0	219283
17843	5613	203994	1673	10381	0	221661
17844	193237	8674	1762	5790	0	209463
17845	9374	193060	1647	3984	0	208065
17846	181501	8532	1727	3495	0	195255
17847	9697	4090	177587	3029	0	194403
17848	4411	2713	157894	2469	0	167487
17849	3073	1847	155502	2053	0	162475
17850	2463	152101	9322	2143	0	166029
17851	3427	7063	5138	133316	0	148944
17852	2584	146205	2221	5948	0	156958
17853	146810	7485	1634	3502	0	159431
17854	7410	3719	146426	2128	0	159683
17855	144957	2484	6550	2184	0	156175
17856	149979	2191	3337	1716	0	157223
17857	9412	1859	2203	144249	0	157723
17858	145537	2022	3642	6914	0	158115
17859	8866	1478	1615	146502	0	158461
17860	4137	1930	145037	7323	0	158427
17861	142783	1709	6459	3865	0	154816
17862	7350	144094	3695	2443	0	157582
17863	4440	6597	2210	145285	0	158532
17864	146758	3173	1508	7018	0	158457
17865	7985	2338	1333	146723	0	158379
17866	4578	1671	141765	7752	0	155766
17867	3489	1417	6367	140698	0	151971
17868	2619	141981	3356	7443	0	155399
17869	143603	6260	2067	3895	0	155825
17870	7532	3153	1502	142980	0	155167
17871	144913	2034	1382	7539	0	155868
17872	8327	1531	1146	144664	0	155668
17873	4297	1324	1291	142731	0	149643
17874	2984	141871	1414	8446	0	154715
17875	140339	6280	1210	4785	0	152614
17876	7048	146911	1214	3034	0	158207
17877	4368	6791	1062	134022	0	146243
17878	2321	138381	967	6497	0	148166
17879	137507	6486	865	3762	0	148620
17880	136673	3255	863	3206	0	143997
17881	137496	2337	773	2822	0	143428
17882	8672	129394	1033	1991	0	141090
17883	1897	95224	487	842	0	98450
17884	92944	3175	519	998	0	97636
17885	3160	95253	403	886	0	99702
17886	2164	3826	559	87526	0	94075
17887	1121	1034	85515	2253	0	89923
17888	76512	558	1534	1130	0	79734
17889	79069	429	461	969	0	80928
17890	78896	468	273	716	0	80353
17891	2078	79052	202	365	0	81697
17892	76587	1426	115	577	0	78705
17893	1774	640	79642	279	0	82335
17894	675	78915	1147	274	0	81011
17895	617	1487	414	73650	0	76168
17896	239	75105	155	586	0	76085
17897	72087	609	169	446	0	73311
17898	596	75041	113	169	0	75919
17899	361	556	75	75039	0	76031
17900	184	75811	116	499	0	76610
17901	290	584	72	77803	0	78749
17902	332	206	57	76036	0	76631
17903	159	243	76901	610	0	77913
17904	345	138	518	74094	0	75095
17905	75177	133	170	866	0	76346
17906	74914	122	120	435	0	75591
17907	818	129	85	75844	0	76876
17908	323	201	75791	588	0	76903
17909	380	136	518	74708	0	75742
17910	75636	124	166	982	0	76908
17911	80221	117	158	805	0	81301
17912	81951	127	98	686	0	82862
17913	758	87513	161	214	0	88646
17914	88448	562	95	692	0	89797
17915	786	288	87004	159	0	88237
17916	94985	178	621	765	0	96549
17917	932	161	234	99682	0	101009
17918	549	143	186	100011	0	100889
17919	460	155	88	101167	0	101870
17920	99393	170	93	1341	0	100997
17921	97555	123	90	794	0	98562
17922	1130	151	104	98243	0	99628
17923	556	203	101620	866	0	103245
17924	597	126	689	100157	0	101569
17925	545	135	187	99942	0	100809
17926	367	200	100043	976	0	101586
17927	252	100461	724	563	0	102000
17928	415	712	252	102641	0	104020
17929	103975	271	204	1284	0	105734
17930	1032	228	132	104262	0	105654
17931	602	199	72	104657	0	105530
17932	105779	181	91	1495	0	107546
17933	910	104981	152	594	0	106637
17934	424	107206	136	460	0	108226
17935	105704	927	94	844	0	107569
17936	923	456	106280	249	0	107908
17937	99680	271	698	871	0	101520
17938	1003	280	113232	223	0	114738
17939	409	115755	809	303	0	117276
17940	115982	749	328	841	0	117900
17941	117052	305	212	655	0	118224
17942	117439	229	110	735	0	118513
17943	117403	180	118	808	0	118509
17944	1233	318	117495	182	0	119228
17945	908	232	725	114836	0	116701
17946	117803	169	292	1305	0	119569
17947	1058	258	123280	334	0	124930
17948	528	290	120600	241	0	121659
17949	390	122387	940	199	0	123916
17950	123983	666	417	585	0	125651
17951	1042	260	204	123445	0	124951
17952	124413	162	140	1314	0	126029
17953	900	127338	199	343	0	128780
17954	691	792	132	136721	0	138336
17955	703	231	95	136267	0	137296
17956	631	171	100	140097	0	140999
17957	312	195	143032	1684	0	145223
17958	218	145242	1318	755	0	147533
17959	155459	1358	451	976	0	158244
17960	2254	494	283	156331	0	159362
17961	155684	276	176	2616	0	158752
17962	154586	165	180	1289	0	156220
17963	2878	153	147	154980	0	158158
17964	1078	327	158882	2045	0	162332
17965	1218	137	1794	156454	0	159603
17966	487	159285	728	2052	0	162552
17967	867	1817	360	162060	0	165104
17968	461	760	161352	2239	0	164812
17969	157180	340	1907	1593	0	161020
17970	2390	232	699	162931	0	166252
17971	160794	180	490	2879	0	164343
17972	2320	362	159943	903	0	163528
17973	149923	217	1885	1596	0	153621
17974	2464	236	160061	482	0	163243
17975	149598	147	2089	1275	0	153109
17976	2360	155145	848	497	0	158850
17977	1000	160332	602	487	0	162421
17978	1066	2380	429	159570	0	163445
17979	1654	1005	472	146149	0	149280
17980	989	533	272	159756	0	161550
17981	160057	305	289	3428	0	164079
17982	2496	246	247	161854	0	164843
17983	967	404	161996	2410	0	165777
17984	152004	252	1868	2241	0	156365
17985	2031	163857	821	947	0	167656
17986	164727	1848	528	1574	0	168677
17987	161338	733	427	1443	0	163941
17988	2926	596	164011	507	0	168040
17989	2278	386	2092	159526	0	164282
17990	1485	346	794	171267	0	173892
17991	802	498	174101	2854	0	178255
17992	654	172494	2351	1440	0	176939
17993	168860	2163	927	1938	0	173888
17994	170417	784	599	1648	0	173448
17995	3420	560	488	173688	0	178156
17996	2071	393	425	172452	0	175341
17997	1420	365	441	181737	0	183963
17998	175805	373	451	5029	0	181658
17999	3078	180399	490	1914	0	185881
18000	180610	2874	372	2048	0	185904
18001	179755	985	431	1890	0	183061
18002	4306	779	188465	829	0	194379
18003	2613	466	3452	180858	0	187389
18004	1308	190847	1436	3687	0	197278
18005	1609	3582	798	194278	0	200267
18006	1658	1445	599	200253	0	203955
18007	1130	951	204198	5161	0	211440
18008	206647	556	4109	3329	0	214641
18009	227962	463	1594	2840	0	232859
18010	236968	455	955	2340	0	240718
18011	8032	560	678	229027	0	238297
18012	4102	648	599	225611	0	230960
18013	2015	221846	801	6838	0	231500
18014	1546	233434	843	2965	0	238788
18015	227147	6726	722	2764	0	237359
18016	6375	223031	815	1652	0	231873
18017	2805	6282	220980	1296	0	231363
18018	2964	2460	5540	222200	0	233164
18019	225281	1403	2120	7272	0	236076
18020	6633	1247	222793	2889	0	233562
18021	3175	1188	221652	1927	0	227942
18022	223132	876	7413	2325	0	233746
18023	226574	923	2922	2071	0	232490
18024	9363	817	1681	221045	0	232906
18025	3912	1042	221855	6868	0	233677
18026	3479	908	6091	221531	0	232009
18027	2148	1384	213911	7502	0	224945
18028	2046	1310	223283	3201	0	229840
18029	2109	224248	7591	2257	0	236205
18030	223938	6027	3335	2665	0	235965
18031	224506	2371	2219	2700	0	231796
18032	8164	223472	1805	1861	0	235302
18033	4998	6440	1508	219705	0	232651
18034	3914	2514	1702	222833	0	230963
18035	3278	1634	1666	227366	0	233944
18036	221291	1219	1437	9705	0	233652
18037	7166	220919	1396	4372	0	233853
18038	216189	6057	1338	3617	0	227201
18039	216624	2640	1498	2984	0	223746
18040	8882	1814	209120	2051	0	221867
18041	4242	209748	6581	1985	0	222556
18042	3956	6230	2967	211001	0	224154
18043	2639	3005	212140	6481	0	224265
18044	205716	1942	6514	4059	0	218231
18045	214449	1482	2796	3189	0	221916
18046	215038	1423	1956	2858	0	221275
18047	212204	1162	1635	2887	0	217888
18048	10276	1179	1395	204273	0	217123
18049	4769	1183	202617	7093	0	215662
18050	4375	1132	6259	202485	0	214251
18051	202141	1231	2814	8055	0	214241
18052	203316	1033	1934	4353	0	210636
18053	8961	197367	1753	2541	0	210622
18054	192087	5387	1540	2487	0	201501
18055	7762	2575	189221	1878	0	201436
18056	4180	1654	188061	1800	0	195695
18057	180696	1441	7271	2403	0	191811
18058	7298	182000	3330	1550	0	194178
18059	4533	4584	1680	166084	0	176881
18060	3082	172198	1319	4569	0	181168
18061	3223	5106	1103	174084	0	183516
18062	2877	2285	1174	175816	0	182152
18063	2619	1570	1230	181340	0	186759
18064	172565	1254	1207	7921	0	182947
18065	178245	1294	1102	3922	0	184563
18066	176958	1324	1108	2711	0	182101
18067	7930	1482	171179	1757	0	182348
18068	170524	1149	5312	2048	0	179033
18069	7429	996	2793	175578	0	186796
18070	4510	897	2022	184254	0	191683
18071	3254	1087	182618	7222	0	194181
18072	3666	1135	5875	199662	0	210338
18073	207773	1048	2591	8352	0	219764
18074	7832	1140	206967	3812	0	219751
18075	4699	906	6787	208148	0	220540
18076	209027	803	3070	8492	0	221392
18077	210566	802	2119	4472	0	217959
18078	9849	963	207809	2707	0	221328
18079	5217	1085	211066	2211	0	219579
18080	4439	940	8353	210970	0	224702
18081	214520	1011	3896	8041	0	227468
18082	218732	1012	2431	4243	0	226418
18083	10158	1104	1803	204086	0	217151
18084	4906	212885	1785	7381	0	226957
18085	213046	6131	1823	4402	0	225402
18086	8231	215118	1976	3125	0	228450
18087	5491	6597	1748	215235	0	229071
18088	3701	2646	213108	7601	0	227056
18089	3469	1651	208942	3738	0	217800
18090	3320	1244	211438	2590	0	218592
18091	3850	1087	8851	200797	0	214585
18092	3511	959	4166	207760	0	216396
18093	203308	937	2813	9220	0	216278
18094	7544	201945	2203	4637	0	216329
18095	203375	5709	1838	3440	0	214362
18096	9115	2404	1769	190063	0	203351
18097	4210	193797	1747	6213	0	205967
18098	3157	203341	1555	3255	0	211308
18099	3564	7160	1327	198593	0	210644
18100	197070	2914	1412	7415	0	208811
18101	6884	199371	1545	3656	0	211456
18102	186292	5218	1372	2943	0	195825
18103	6384	192356	1523	2033	0	202296
18104	189104	5624	1529	2155	0	198412
18105	6718	2580	185264	1770	0	196332
18106	3624	1719	181910	1606	0	188859
18107	2646	177299	5849	1342	0	187136
18108	159934	5417	4462	1757	0	171570
18109	4011	149925	1451	875	0	156262
18110	1778	141631	927	768	0	145104
18111	2677	4101	932	142945	0	150655
18112	142619	1504	886	3579	0	148588
18113	3283	145288	753	1442	0	150766
18114	140129	2944	566	1280	0	144919
18115	3247	140750	515	662	0	145174
18116	137073	3039	395	1005	0	141512
18117	3050	137167	415	602	0	141234
18118	1367	139504	430	575	0	141876
18119	1410	3341	515	132274	0	137540
18120	762	137323	507	2263	0	140855
18121	135132	2969	370	1382	0	139853
18122	2818	1354	134824	648	0	139644
18123	1617	989	2352	134244	0	139202
18124	930	1033	137203	2632	0	141798
18125	1085	679	2673	134979	0	139416
18126	1180	659	998	137777	0	140614
18127	778	801	131084	3324	0	135987
18128	118063	573	2711	2181	0	123528
18129	2853	127855	1257	1140	0	133105
18130	129310	2557	861	1359	0	134087
18131	3163	130855	794	966	0	135778
18132	1866	2904	653	130807	0	136230
18133	130740	1167	674	3300	0	135881
18134	131331	965	764	1590	0	134650
18135	132741	758	681	1380	0	135560
18136	4190	746	649	129920	0	135505
18137	2467	801	567	130208	0	134043
18138	1558	134887	689	3173	0	140307
18139	135333	2894	586	2136	0	140949
18140	138114	1322	586	1655	0	141677
18141	137524	1099	713	1278	0	140614
18142	136362	887	686	1298	0	139233
18143	4050	132334	851	946	0	138181
18144	2210	2843	764	133742	0	139559
18145	1550	1586	132378	2859	0	138373
18146	127960	1076	2658	1910	0	133604
18147	136913	1023	1006	1628	0	140570
18148	4336	1039	134888	848	0	141111
18149	2305	1158	135255	811	0	139529
18150	2001	1129	3262	134485	0	140877
18151	1525	1189	1432	139371	0	143517
18152	1436	1091	1053	142313	0	145893
18153	138704	1096	787	4518	0	145105
18154	3911	952	750	139819	0	145432
18155	1952	943	135999	3773	0	142667
18156	1773	951	3170	137029	0	142923
18157	1219	978	139371	3899	0	145467
18158	1415	947	3378	137524	0	143264
18159	1545	840	1441	147565	0	151391
18160	1295	962	147070	4551	0	153878
18161	136727	963	3678	2761	0	144129
18162	3831	148245	1638	1509	0	155223
18163	149747	3905	1017	1547	0	156216
18164	4896	1900	689	153484	0	160969
18165	152517	1413	560	4895	0	159385
18166	4713	157876	643	2218	0	165450
18167	2396	166672	593	1605	0	171266
18168	2625	7016	610	170126	0	180377
18169	1589	2804	177677	4729	0	186799
18170	1369	1967	171240	1964	0	176540
18171	1214	172714	5834	1613	0	181375
18172	146407	4288	2532	1304	0	154531
18173	4189	1730	1281	145367	0	152567
18174	143310	1098	967	4337	0	149712
18175	4219	142112	977	1818	0	149126
18176	1880	147925	943	1311	0	152059
18177	2133	5115	850	145203	0	153301
18178	143712	2467	672	4586	0	151437
18179	145795	1712	412	2297	0	150216
18180	5422	1426	141773	1466	0	150087
18181	2848	1208	137500	1113	0	142669
18182	135118	1084	4493	1503	0	142198
18183	4335	138202	2298	962	0	145797
18184	137204	3965	1456	1217	0	143842
18185	5548	1892	987	134437	0	142864
18186	2712	1291	133205	3642	0	140850
18187	125560	810	4094	2292	0	132756
18188	4237	129832	2232	1217	0	137518
18189	2214	134680	1536	872	0	139302
18190	2384	4866	1087	130898	0	139235
18191	132857	2219	910	4272	0	140258
18192	4701	1511	862	133758	0	140832
18193	137061	1179	1075	4800	0	144115
18194	4834	1397	131671	2027	0	139929
18195	132295	1379	3264	2026	0	138964
18196	137946	1189	1302	1825	0	142262
18197	5912	1089	131377	1337	0	139715
18198	127544	791	3623	1580	0	133538
18199	5395	126205	2023	1291	0	134914
18200	3639	3513	1558	124591	0	133301
18201	2782	127474	1246	3264	0	134766
18202	130446	4244	1187	1765	0	137642
18203	5371	2007	1114	125087	0	133579
18204	2813	124695	1195	3814	0	132517
18205	2738	4041	967	124338	0	132084
18206	1920	126625	715	4382	0	133642
18207	2079	4695	556	127931	0	135261
18208	127530	2492	636	5033	0	135691
18209	4847	1824	604	128217	0	135492
18210	2680	1506	125511	4990	0	134687
18211	122996	1463	3550	3015	0	131024
18212	4919	1388	1516	126817	0	134640
18213	2560	1466	123515	4844	0	132385
18214	2415	1144	119594	3016	0	126169
18215	2281	1008	126288	2292	0	131869
18216	2442	804	5585	121028	0	129859
18217	2175	845	3052	127611	0	133683
18218	2107	981	2268	128460	0	133816
18219	1930	879	1831	129871	0	134511
18220	126976	992	1822	6471	0	136261
18221	130590	883	1668	3990	0	137131
18222	131838	999	1465	3287	0	137589
18223	133953	1092	1180	2954	0	139179
18224	6514	961	982	130219	0	138676
18225	3903	1134	132601	5401	0	143039
18226	131923	866	3718	3812	0	140319
18227	139961	967	1923	2782	0	145633
18228	6894	958	1540	136099	0	145491
18229	4403	937	1336	140165	0	146841
18230	140653	852	1293	6341	0	149139
18231	6003	761	1281	134012	0	142057
18232	3509	133549	1566	5710	0	144334
18233	137641	3676	1392	3788	0	146497
18234	135918	1769	1362	3296	0	142345
18235	6893	1428	137260	2598	0	148179
18236	4390	1199	4159	137332	0	147080
18237	3487	1169	2195	142815	0	149666
18238	139293	1042	1778	6735	0	148848
18239	141723	1138	1498	3759	0	148118
18240	7446	991	1156	139593	0	149186
18241	4543	1002	137766	5681	0	148992
18242	3681	824	139045	3606	0	147156
18243	3327	638	5070	140503	0	149538
18244	3503	834	2660	143284	0	150281
18245	139684	754	1823	6773	0	149034
18246	6103	135771	1631	3912	0	147417
18247	3603	135156	1606	3185	0	143550
18248	2940	141283	1658	2529	0	148410
18249	2971	4989	1746	138343	0	148049
18250	137584	2258	1513	5680	0	147035
18251	137354	1747	943	3579	0	143623
18252	6116	137472	783	2679	0	147050
18253	139560	4347	654	2480	0	147041
18254	5761	2305	760	138037	0	146863
18255	3246	1935	139418	4887	0	149486
18256	3392	1395	3559	135798	0	144144
18257	3388	1131	1533	138682	0	144734
18258	3186	980	1277	138042	0	143485
18259	130323	875	1052	6097	0	138347
18260	4507	1115	1102	125374	0	132098
18261	2704	124531	1077	5150	0	133462
18262	121243	2655	1410	3734	0	129042
18263	3809	119531	998	2794	0	127132
18264	2058	115528	834	2234	0	120654
18265	1750	119758	821	1980	0	124309
18266	1493	2533	109702	1440	0	115168
18267	1085	106703	2015	1396	0	111199
18268	982	1499	94719	949	0	98149
18269	84633	457	945	784	0	86819
18270	88943	176	270	884	0	90273
18271	987	236	93594	432	0	95249
18272	93323	186	696	1020	0	95225
18273	98547	178	244	877	0	99846
18274	1052	229	99930	344	0	101555
18275	493	103540	672	357	0	105062
18276	625	759	286	104490	0	106160
18277	106508	300	166	1208	0	108182
18278	1030	261	147	105805	0	107243
18279	111549	241	159	1403	0	113352
18280	110312	217	166	870	0	111565
18281	1068	281	111582	339	0	113270
18282	108386	192	708	782	0	110068
18283	980	115092	302	338	0	116712
18284	116634	746	157	672	0	118209
18285	1093	304	189	117251	0	118837
18286	599	256	117830	858	0	119543
18287	627	208	730	115764	0	117329
18288	116627	203	324	1309	0	118463
18289	887	117345	242	747	0	119221
18290	552	818	117250	466	0	119086
18291	827	303	741	111446	0	113317
18292	481	291	117764	972	0	119508
18293	452	118339	843	571	0	120205
18294	118005	820	334	786	0	119945
18295	1086	325	275	118611	0	120297
18296	589	352	119317	911	0	121169
18297	607	503	111625	480	0	113215
18298	118621	355	927	759	0	120662
18299	1203	294	416	121883	0	123796
18300	776	314	311	121666	0	123067
18301	516	314	124282	1168	0	126280
18302	562	347	121681	510	0	123100
18303	512	128689	1133	470	0	130804
18304	683	955	520	129410	0	131568
18305	705	391	384	129066	0	130546
18306	440	130694	368	1188	0	132690
18307	490	1114	129417	545	0	131566
18308	122924	456	1021	850	0	125251
18309	1336	296	432	132159	0	134223
18310	623	371	134715	1212	0	136921
18311	878	325	1136	127864	0	130203
18312	564	134163	518	1214	0	136459
18313	535	1236	133848	599	0	136218
18314	125526	531	1260	1182	0	128499
18315	1418	463	135533	431	0	137845
18316	679	478	132005	405	0	133567
18317	585	405	129605	341	0	130936
18318	479	344	141546	393	0	142762
18319	873	320	2082	142289	0	145564
18320	424	343	153410	1940	0	156117
18321	839	272	2155	146116	0	149382
18322	316	152734	739	1970	0	155759
18323	162007	2004	441	1172	0	165624
18324	3059	557	369	163486	0	167471
18325	961	476	162842	2756	0	167035
18326	556	162796	2781	1158	0	167291
18327	997	2626	943	163686	0	168252
18328	162248	800	731	3412	0	167191
18329	2508	164804	629	1108	0	169049
18330	1400	2658	420	167846	0	172324
18331	169049	855	402	3506	0	173812
18332	2877	553	167468	964	0	171862
18333	163302	354	2793	1371	0	167820
18334	3031	328	170912	484	0	174755
18335	160511	223	2954	976	0	164664
18336	163685	245	1036	1021	0	165987
18337	3464	310	162614	381	0	166769
18338	1218	160581	2686	405	0	164890
18339	1708	2750	1067	152814	0	158339
18340	532	865	164515	2560	0	168472
18341	1148	718	2773	154791	0	159430
18342	1145	387	910	158035	0	160477
18343	398	346	162551	3305	0	166600
18344	494	313	160164	1262	0	162233
18345	927	277	3340	159830	0	164374
18346	163094	156	1386	3429	0	168065
18347	2653	160589	956	1145	0	165343
18348	1027	163303	687	772	0	165789
18349	163366	3034	403	1173	0	167976
18350	166204	1093	482	1036	0	168815
18351	3852	644	465	165475	0	170436
18352	1782	443	400	166618	0	169243
18353	1269	282	439	169507	0	171497
18354	164394	261	449	4425	0	169529
18355	2666	158223	550	1809	0	163248
18356	1090	163226	550	1069	0	165935
18357	1152	3178	574	163224	0	168128
18358	1105	1135	479	165853	0	168572
18359	984	680	435	165749	0	167848
18360	163276	484	383	4645	0	168788
18361	2805	166570	444	1766	0	171585
18362	167569	2931	411	1735	0	172646
18363	3675	1182	168007	744	0	173608
18364	1452	170013	3196	808	0	175469
18365	1257	3265	1250	169297	0	175069
18366	168557	1150	819	4370	0	174896
18367	3750	928	168715	1518	0	174911
18368	1624	866	167725	1100	0	171315
18369	1653	646	4308	166301	0	172908
18370	1197	619	1803	170147	0	173766
18371	1067	575	1121	168335	0	171098
18372	1258	471	842	160682	0	163253
18373	1226	468	676	161984	0	164354
18374	732	157070	812	5318	0	163932
18375	1129	3294	715	159501	0	164639
18376	154896	1259	794	5201	0	162150
18377	3463	157928	822	2290	0	164503
18378	155560	3700	652	2398	0	162310
18379	4239	1539	151465	1478	0	158721
18380	1957	1104	152473	1286	0	156820
18381	1846	833	4603	158095	0	165377
18382	1105	711	194169	4501	0	200486
18383	1665	603	6370	190324	0	198962
18384	1884	673	2786	189877	0	195220
18385	195553	557	1679	8971	0	206760
18386	194968	640	1196	4745	0	201549
18387	8143	200197	1114	2485	0	211939
18388	3720	211497	1014	1805	0	218036
18389	2769	8505	932	207469	0	219675
18390	209160	3774	865	8119	0	221918
18391	7337	2207	210321	3662	0	223527
18392	4098	1275	7016	209020	0	221409
18393	2992	947	3177	213619	0	220735
18394	1561	990	209387	9937	0	221875
18395	1259	208064	7562	5186	0	222071
18396	2397	7030	3242	204443	0	217112
18397	1362	3240	211109	8537	0	224248
18398	2088	1882	7531	208736	0	220237
18399	198958	1188	3421	9747	0	213314
18400	7045	200406	2396	4628	0	214475
18401	3262	207734	1717	3085	0	215798
18402	2812	9126	1403	202878	0	216219
18403	196329	3960	1313	9118	0	210720
18404	7080	199851	1608	4574	0	213113
18405	200977	7549	1408	4091	0	214025
18406	8505	3543	198489	3129	0	213666
18407	4150	2383	205870	2805	0	215208
18408	3759	1882	9708	194022	0	209371
18409	2849	1797	4383	210426	0	219455
18410	202765	1713	2648	11208	0	218334
18411	9551	1715	1717	204459	0	217442
18412	4629	1958	200513	9853	0	216953
18413	3959	2173	7569	198841	0	212542
18414	3263	1912	3575	207167	0	215917
18415	2276	1685	195702	11468	0	211131
18416	186170	1446	8140	6941	0	202697
18417	8597	1584	4148	196776	0	211105
18418	186825	1353	2763	9921	0	200862
18419	7610	177631	2546	5483	0	193270
18420	174636	6506	2068	4644	0	187854
18421	7501	172750	1847	3804	0	185902
18422	3787	177002	2027	3359	0	186175
18423	3574	8223	2129	163166	0	177092
18424	161054	3831	2069	7545	0	174499
18425	163286	2753	1352	4464	0	171855
18426	8222	2410	1296	160302	0	172230
18427	160510	1932	1348	7754	0	171544
18428	162098	1793	1301	4764	0	169956
18429	9324	1869	1272	159205	0	171670
18430	153431	1662	1295	7671	0	164059
18431	7861	154620	1626	4419	0	168526
18432	156302	6218	1674	3683	0	167877
18433	7777	3381	150131	3393	0	164682
18434	158287	1962	5585	3872	0	169706
18435	8323	1389	3117	158739	0	171568
18436	5013	1103	2434	163763	0	172313
18437	3597	1090	2191	165259	0	172137
18438	3353	1221	1983	164616	0	171173
18439	2736	1228	1870	163088	0	168922
18440	2463	146559	2061	10637	0	161720
18441	2740	159525	1781	6379	0	170425
18442	157488	7042	1607	5125	0	171262
18443	7509	3924	155357	3746	0	170536
18444	154404	3176	5663	3687	0	166930
18445	8191	2779	156109	3193	0	170272
18446	5494	2563	6366	153202	0	167625
18447	4376	2498	2949	161079	0	170902
18448	156049	2164	1886	9731	0	169830
18449	8537	2272	154117	5290	0	170216
18450	6105	2038	5676	156323	0	170142
18451	4456	1771	161933	8269	0	176429
18452	4142	164750	6804	5276	0	180972
18453	4373	6052	3240	169920	0	183585
18454	169950	3146	2326	8999	0	184421
18455	167291	2259	1925	5688	0	177163
18456	172762	1902	1789	4865	0	181318
18457	10385	165535	2092	4213	0	182225
18458	5912	175066	2024	3873	0	186875
18459	159037	7800	1954	5175	0	173966
18460	7871	170246	1872	4365	0	184354
18461	4418	172786	1762	4563	0	183529
18462	3758	7885	166080	4386	0	182109
18463	2886	163378	5891	4174	0	176329
18464	2687	166862	3161	3544	0	176254
18465	3113	8133	2017	164302	0	177565
18466	2659	4874	163682	7201	0	178416
18467	2973	3274	159124	4368	0	169739
18468	156592	2266	7551	4013	0	170422
18469	7818	1906	162928	2912	0	175564
18470	164842	1732	7304	3033	0	176911
18471	8189	1729	3901	162848	0	176667
18472	5121	165073	2606	7328	0	180128
18473	171913	5850	2197	4866	0	184826
18474	179928	3252	2075	4268	0	189523
18475	9526	2059	1919	177766	0	191270
18476	5986	1748	2182	180159	0	190075
18477	4698	1675	1860	182666	0	190899
18478	177047	1485	1620	10233	0	190385
18479	164469	1751	1545	6571	0	174336
18480	177602	1775	1165	4589	0	185131
18481	9671	164697	1059	3167	0	178594
18482	132564	2839	783	1600	0	137786
18483	3998	129161	625	1283	0	135067
18484	2365	130664	541	1172	0	134742
18485	2180	4523	1120	122093	0	129916
18486	1321	124763	595	2573	0	129252
18487	117781	2080	408	1302	0	121571
18488	2602	1059	288	116180	0	120129
18489	113394	641	248	2269	0	116552
18490	2022	109801	313	879	0	113015
18491	900	115160	307	621	0	116988
18492	116536	1872	313	1002	0	119723
18493	2064	119950	293	493	0	122800
18494	1264	1824	346	120815	0	124249
18495	1098	720	386	122701	0	124905
18496	122308	428	259	2640	0	125635
18497	2346	386	226	123035	0	125993
18498	941	491	126054	2278	0	129764
18499	997	346	1974	126116	0	129433
18500	128679	387	669	2900	0	132635
18501	2342	132510	476	919	0	136247
18502	138248	2372	302	1152	0	142074
18503	134499	886	293	1234	0	136912
18504	139822	587	174	1025	0	141608
18505	3488	572	137666	497	0	142223
18506	1412	553	133186	430	0	135581
18507	129033	359	2764	841	0	132997
18508	2659	134118	981	500	0	138258
18509	1380	2538	494	134961	0	139373
18510	1104	927	355	134669	0	137055
18511	624	130710	416	2897	0	134647
18512	559	135626	408	1038	0	137631
18513	920	2948	334	134982	0	139184
18514	896	1078	298	136934	0	139206
18515	615	757	133217	3085	0	137674
18516	832	693	126835	1242	0	129602
18517	129017	416	2973	1269	0	133675
18518	137396	388	1142	1066	0	139992
18519	3656	404	702	135369	0	140131
18520	1480	552	136488	2723	0	141243
18521	1368	543	2580	134236	0	138727
18522	134208	459	894	3624	0	139185
18523	3017	543	134692	1327	0	139579
18524	1746	572	2656	136230	0	141204
18525	990	636	137707	2868	0	142201
18526	875	135717	2855	1422	0	140869
18527	695	2748	137599	900	0	141942
18528	1275	1319	3028	133232	0	138854
18529	136925	643	1246	3249	0	142063
18530	3210	575	719	139192	0	143696
18531	138698	457	551	3720	0	143426
18532	141492	464	530	1971	0	144457
18533	138297	476	527	1597	0	140897
18534	3808	556	134368	847	0	139579
18535	135886	404	2667	1160	0	140117
18536	3759	339	1168	137467	0	142733
18537	1978	345	726	139080	0	142129
18538	1184	495	137710	3304	0	142693
18539	1335	633	2648	136908	0	141524
18540	138549	429	1126	3808	0	143912
18541	2846	139825	773	1600	0	145044
18542	142944	2517	538	1731	0	147730
18543	144654	876	428	1757	0	147715
18544	146377	593	424	1442	0	148836
18545	4185	492	484	143485	0	148646
18546	1882	491	145554	3069	0	150996
18547	1682	386	2754	147523	0	152345
18548	1618	355	1068	150540	0	153581
18549	148888	391	779	4486	0	154544
18550	144360	385	654	2403	0	147802
18551	3985	431	140015	1219	0	145650
18552	2335	486	2793	139124	0	144738
18553	1299	438	141540	3404	0	146681
18554	141274	392	3430	2172	0	147268
18555	3682	156620	1440	1307	0	163049
18556	156241	3135	967	1383	0	161726
18557	4091	160049	771	868	0	165779
18558	158391	3562	621	1375	0	163949
18559	4088	159363	761	878	0	165090
18560	2523	3742	620	158130	0	165015
18561	2003	1289	556	163285	0	167133
18562	162059	833	492	5110	0	168494
18563	161055	603	466	2639	0	164763
18564	163057	490	596	1896	0	166039
18565	157612	519	452	1882	0	160465
18566	161776	510	561	1265	0	164112
18567	6023	482	484	155238	0	162227
18568	2670	155975	605	3833	0	163083
18569	2618	3482	422	152384	0	158906
18570	1746	153289	481	3939	0	159455
18571	2054	3970	367	148527	0	154918
18572	1519	151804	479	4047	0	157849
18573	1971	3947	381	149574	0	155873
18574	1465	1418	143401	4387	0	150671
18575	135809	971	3275	2564	0	142619
18576	4306	142600	1209	1534	0	149649
18577	143267	3471	762	1622	0	149122
18578	4730	1433	140660	1170	0	147993
18579	137242	1034	3404	1410	0	143090
18580	4699	926	146500	1112	0	153237
18581	2586	863	3906	144013	0	151368
18582	1593	155833	1596	4073	0	163095
18583	1397	4300	157281	1711	0	164689
18584	1886	1802	4324	156863	0	164875
18585	149799	1285	2025	5270	0	158379
18586	5219	885	1234	159089	0	166427
18587	2970	770	990	161611	0	166341
18588	2634	630	847	164113	0	168224
18589	1600	914	158508	6434	0	167456
18590	2193	776	4283	154467	0	161719
18591	1322	153881	2003	5565	0	162771
18592	1923	3901	1261	153655	0	160740
18593	1889	1601	853	155334	0	159677
18594	151210	1047	800	6463	0	159520
18595	5276	886	540	154921	0	161623
18596	2383	869	155344	5385	0	163981
18597	1832	616	154591	2924	0	159963
18598	1377	613	153975	2199	0	158164
18599	1186	151474	5704	1755	0	160119
18600	146845	4010	3222	2278	0	156355
18601	4037	147207	1590	1520	0	154354
18602	143288	4297	1157	1568	0	150310
18603	5065	1924	926	141112	0	149027
18604	2269	1401	143900	4241	0	151811
18605	1735	1173	140099	2079	0	145086
18606	1140	145735	5006	1818	0	153699
18607	1786	4096	2403	144312	0	152597
18608	1666	1912	1572	147858	0	153008
18609	1535	1362	1138	150106	0	154141
18610	902	1026	146684	6347	0	154959
18611	136174	844	4596	3805	0	145419
18612	4511	875	147231	2176	0	154793
18613	2992	1023	4893	142928	0	151836
18614	2524	761	2195	150072	0	155552
18615	1400	988	146465	6139	0	154992
18616	138080	665	4649	4015	0	147409
18617	4435	146153	2539	2800	0	155927
18618	146663	4206	1830	2371	0	155070
18619	5549	1990	1483	142761	0	151783
18620	2411	145866	1218	4994	0	154489
18621	2301	4439	1058	148495	0	156293
18622	147011	2118	1071	6378	0	156578
18623	5402	1437	1068	146846	0	154753
18624	2658	1237	142838	5895	0	152628
18625	139851	1020	4447	3618	0	148936
18626	144526	883	2431	2983	0	150823
18627	6224	1013	141714	2195	0	151146
18628	3619	951	4612	141274	0	150456
18629	144449	872	2558	5679	0	153558
18630	5903	848	1736	142077	0	150564
18631	3331	1086	1312	141419	0	147148
18632	2889	868	1211	141671	0	146639
18633	2321	780	1071	143068	0	147240
18634	1621	1032	136143	7459	0	146255
18635	1897	760	4626	137579	0	144862
18636	1644	758	136403	6700	0	145505
18637	132621	682	5284	4319	0	142906
18638	137896	739	2943	3334	0	144912
18639	137600	713	2063	2801	0	143177
18640	138570	699	1512	2681	0	143462
18641	7433	661	1711	132159	0	141964
18642	130698	621	1309	6201	0	138829
18643	6064	639	128094	3519	0	138316
18644	3323	592	127894	2961	0	134770
18645	121937	556	5595	2882	0	130970
18646	4948	120659	3147	2546	0	131300
18647	2643	122048	2114	2186	0	128991
18648	2610	4687	1933	119247	0	128477
18649	1889	2238	119591	4926	0	128644
18650	113281	1446	4589	3301	0	122617
18651	5005	988	119644	2362	0	127999
18652	2918	111613	4390	2101	0	121022
18653	2523	3311	111643	1823	0	119300
18654	1775	103153	4076	1580	0	110584
18655	91027	3474	2754	1822	0	99077
18656	3269	90932	1581	1387	0	97169
18657	1787	88215	1202	1233	0	92437
18658	1634	3335	1172	86940	0	93081
18659	1263	1862	86285	3010	0	92420
18660	1358	1245	2857	83096	0	88556
18661	1171	946	1653	86242	0	90012
18662	1036	751	83941	4149	0	89877
18663	1259	639	3109	80915	0	85922
18664	1173	80736	1870	3417	0	87196
18665	1204	2534	1430	84713	0	89881
18666	83686	1433	1227	3663	0	90009
18667	3186	954	1061	85040	0	90241
18668	1877	842	84266	3575	0	90560
18669	1701	775	2843	85358	0	90677
18670	1146	784	84644	3785	0	90359
18671	82736	830	3164	2415	0	89145
18672	3124	612	1793	85443	0	90972
18673	85032	595	1472	3738	0	90837
18674	3357	568	84640	2378	0	90943
18675	79768	504	3044	2135	0	85451
18676	3337	84973	1892	1438	0	91640
18677	1888	2524	85870	1412	0	91694
18678	1776	2089	3062	82952	0	89879
18679	1250	991	86581	3155	0	91977
18680	1142	78975	3124	1902	0	85143
18681	988	83513	1836	1498	0	87835
18682	71095	2267	1047	1200	0	75609
18683	2079	76117	800	952	0	79948
18684	76170	2183	828	1020	0	80201
18685	2749	1027	734	76312	0	80822
18686	1270	710	75606	2382	0	79968
18687	928	76814	2212	1202	0	81156
18688	1164	2248	1207	76246	0	80865
18689	1057	1023	701	80089	0	82870
18690	943	811	616	81615	0	83985
18691	968	643	648	79448	0	81707
18692	664	75293	693	3387	0	80037
18693	568	79974	734	1673	0	82949
18694	75280	2387	589	1265	0	79521
18695	2000	74712	512	907	0	78131
18696	983	2038	451	70787	0	74259
18697	638	842	70656	2023	0	74159
18698	532	70085	1740	1065	0	73422
18699	729	1764	760	68519	0	71772
18700	689	1034	509	68190	0	70422
18701	324	69198	385	2153	0	72060
18702	66723	1745	308	1251	0	70027
18703	1655	768	66919	784	0	70126
18704	60877	513	1457	881	0	63728
18705	1600	65349	654	480	0	68083
18706	59164	1446	257	514	0	61381
18707	1400	61335	235	298	0	63268
18708	801	1604	191	63851	0	66447
18709	607	652	191	65517	0	66967
18710	64036	440	251	2150	0	66877
18711	1731	453	188	64726	0	67098
18712	678	402	64076	1781	0	66937
18713	381	61700	1400	864	0	64345
18714	368	63919	507	534	0	65328
18715	558	1749	348	62872	0	65527
18716	348	785	63810	1462	0	66405
18717	576	556	1293	61982	0	64407
18718	510	439	488	63493	0	64930
18719	275	420	62224	1973	0	64892
18720	304	413	60388	943	0	62048
18721	220	62169	1578	757	0	64724
18722	61880	1449	654	812	0	64795
18723	1544	730	413	60727	0	63414
18724	603	60175	331	1467	0	62576
18725	61750	1574	273	1023	0	64620
18726	1568	770	303	61992	0	64633
18727	704	562	257	61948	0	63471
18728	319	61004	270	2052	0	63645
18729	497	1485	297	60870	0	63149
18730	60643	704	283	2099	0	63729
18731	1595	610	283	61386	0	63874
18732	883	493	307	62219	0	63902
18733	464	517	60503	2061	0	63545
18734	479	567	57101	1011	0	59158
18735	59230	446	1701	988	0	62365
18736	1581	451	681	59852	0	62565
18737	911	440	415	60317	0	62083
18738	701	471	287	61402	0	62861
18739	475	474	59303	2309	0	62561
18740	58309	429	1387	1401	0	61526
18741	1650	477	667	59445	0	62239
18742	954	454	460	60700	0	62568
18743	58539	427	417	2446	0	61829
18744	1505	58347	413	1474	0	61739
18745	783	1468	58221	1072	0	61544
18746	623	710	1529	56089	0	58951
18747	489	57859	777	1935	0	61060
18748	598	1481	550	59472	0	62101
18749	57866	748	530	2245	0	61389
18750	1737	601	365	58360	0	61063
18751	56986	571	392	2296	0	60245
18752	57048	445	421	1488	0	59402
18753	2100	475	394	55417	0	58386
18754	950	54150	422	2114	0	57636
18755	671	56984	395	1355	0	59405
18756	562	1825	56045	1088	0	59520
18757	716	966	1552	52973	0	56207
18758	645	640	735	56514	0	58534
18759	629	576	511	57848	0	59564
18760	55830	516	444	2696	0	59486
18761	1795	508	305	56848	0	59456
18762	984	496	56128	2308	0	59916
18763	56021	367	1489	1667	0	59544
18764	1892	432	681	58947	0	61952
18765	1082	441	518	60386	0	62427
18766	651	423	58791	2561	0	62426
18767	57083	466	1525	1652	0	60726
18768	1764	437	725	59653	0	62579
18769	863	420	60634	2335	0	64252
18770	852	358	1636	60493	0	63339
18771	795	342	853	56543	0	58533
18772	643	60966	643	2347	0	64599
18773	60264	1451	537	1712	0	63964
18774	59889	701	480	1467	0	62537
18775	2024	59485	481	1204	0	63194
18776	58285	1455	506	1224	0	61470
18777	58037	671	424	1207	0	60339
18778	2285	435	386	57705	0	60811
18779	1058	363	55104	2084	0	58609
18780	850	319	52760	1234	0	55163
18781	595	282	51635	898	0	53410
18782	511	346	52664	833	0	54354
18783	645	861	1659	46990	0	50155
18784	477	228	767	49438	0	50910
18785	473	254	398	49294	0	50419
18786	604	206	292	50437	0	51539
18787	49149	186	273	2081	0	51689
18788	1358	50475	286	1147	0	53266
18789	50890	1024	267	825	0	53006
18790	1457	492	50875	552	0	53376
18791	730	285	53513	499	0	55027
18792	662	432	1559	54089	0	56742
18793	55018	147	962	1743	0	57870
18794	53042	110	506	1014	0	54672
18795	1632	53886	410	625	0	56553
18796	681	55044	290	523	0	56538
18797	648	1349	244	54644	0	56885
18798	54236	526	273	1509	0	56544
18799	1209	55242	229	759	0	57439
18800	55323	1142	193	756	0	57414
18801	55762	511	173	612	0	57058
18802	56173	325	194	554	0	57246
18803	1703	262	56118	338	0	58421
18804	856	56610	1079	322	0	58867
18805	55581	985	464	503	0	57533
18806	55663	440	318	572	0	56993
18807	1529	53854	238	289	0	55910
18808	551	51562	102	126	0	52341
18809	51399	991	160	297	0	52847
18810	1091	444	86	51182	0	52803
18811	454	293	51712	815	0	53274
18812	49609	212	758	433	0	51012
18813	1038	206	254	52107	0	53605
18814	481	54406	180	903	0	55970
18815	447	844	116	55486	0	56893
18816	317	384	56185	883	0	57769
18817	451	202	851	55320	0	56824
18818	58739	210	339	1221	0	60509
18819	1112	168	206	59247	0	60733
18820	680	146	133	60078	0	61037
18821	349	196	62998	1219	0	64762
18822	484	188	857	59983	0	61512
18823	275	62842	355	984	0	64456
18824	62997	872	213	683	0	64765
18825	61405	336	209	543	0	62493
18826	1258	247	63390	274	0	65169
18827	733	164	879	60666	0	62442
18828	329	61111	396	1493	0	63329
18829	283	64164	252	483	0	65182
18830	63245	1086	203	499	0	65033
18831	1135	445	127	64645	0	66352
18832	532	269	64599	1019	0	66419
18833	385	243	63483	536	0	64647
18834	357	201	1194	64860	0	66612
18835	64749	172	523	1293	0	66737
18836	64641	179	287	700	0	65807
18837	1451	203	214	67192	0	69060
18838	674	212	68702	1082	0	70670
18839	418	68927	1015	535	0	70895
18840	68661	931	473	669	0	70734
18841	1051	69763	319	397	0	71530
18842	70245	1119	205	504	0	72073
18843	1278	498	185	70320	0	72281
18844	608	343	70525	1095	0	72571
18845	591	214	1004	68986	0	70795
18846	69852	202	489	1523	0	72066
18847	1181	279	70627	547	0	72634
18848	590	70994	1064	494	0	73142
18849	657	977	472	71100	0	73206
18850	71531	412	308	1461	0	73712
18851	1221	341	71692	578	0	73832
18852	789	254	1129	71901	0	74073
18853	636	270	467	74028	0	75401
18854	460	284	74222	1382	0	76348
18855	607	260	1123	72044	0	74034
18856	444	270	73985	1338	0	76037
18857	70165	263	1169	996	0	72593
18858	1390	249	578	77024	0	79241
18859	693	287	82154	1323	0	84457
18860	511	83627	1309	755	0	86202
18861	85183	1254	612	921	0	87970
18862	91863	572	406	802	0	93643
18863	2210	367	316	99878	0	102771
18864	950	102945	361	1960	0	106216
18865	103695	2054	329	1087	0	107165
18866	2668	737	246	103951	0	107602
18867	986	533	103997	2363	0	107879
18868	98782	411	2108	1319	0	102620
18869	2380	101925	787	691	0	105783
18870	1310	2029	519	103175	0	107033
18871	103311	726	389	2600	0	107026
18872	2474	576	101512	889	0	105451
18873	1092	460	103101	658	0	105311
18874	1123	405	2601	99272	0	103401
18875	712	314	105316	2307	0	108649
18876	1008	287	2505	100277	0	104077
18877	462	102511	1090	2370	0	106433
18878	703	2214	698	107169	0	110784
18879	105422	683	541	3132	0	109778
18880	2306	518	106076	1208	0	110108
18881	862	106961	2425	1007	0	111255
18882	1089	2176	850	106317	0	110432
18883	567	889	110346	2515	0	114317
18884	933	735	2262	103751	0	107681
18885	478	106578	1022	2383	0	110461
18886	363	110802	737	1000	0	112902
18887	105790	2260	645	1268	0	109963
18888	1829	110200	548	673	0	113250
18889	624	2102	106152	462	0	109340
18890	96975	833	2086	952	0	100846
18891	1881	645	107150	346	0	110022
18892	1222	386	1858	98652	0	102118
18893	511	399	108096	1668	0	110674
18894	401	107531	1956	645	0	110533
18895	750	1691	731	106567	0	109739
18896	627	521	533	106991	0	108672
18897	703	404	415	105165	0	106687
18898	272	408	107157	2284	0	110121
18899	656	391	1686	103365	0	106098
18900	500	372	609	108008	0	109489
18901	104979	331	470	2677	0	108457
18902	104332	310	378	1534	0	106554
18903	2094	275	106528	759	0	109656
18904	888	104700	1887	669	0	108144
18905	662	1666	106830	478	0	109636
18906	753	602	1923	106211	0	109489
18907	452	490	110237	1884	0	113063
18908	624	412	2089	107357	0	110482
18909	488	325	853	111563	0	113229
18910	267	285	111000	2404	0	113956
18911	98468	237	2011	1755	0	102471
18912	1664	112938	952	896	0	116450
18913	814	1701	565	113422	0	116502
18914	506	655	117741	2084	0	120986
18915	613	562	111872	849	0	113896
18916	108268	358	2148	1147	0	111921
18917	1675	115327	1056	542	0	118600
18918	739	1721	667	115777	0	118904
18919	117732	568	626	2337	0	121263
18920	2083	411	487	117796	0	120777
18921	1005	362	426	120722	0	122515
18922	559	449	120699	2500	0	124207
18923	111873	309	1909	1821	0	115912
18924	121588	282	880	1277	0	124027
18925	2516	292	619	122245	0	125672
18926	121554	274	540	2478	0	124846
18927	2473	293	513	121456	0	124735
18928	1007	117712	587	2409	0	121715
18929	760	124187	624	1086	0	126657
18930	877	2275	448	125258	0	128858
18931	122610	967	440	2745	0	126762
18932	2058	606	308	123855	0	126827
18933	124825	429	345	2936	0	128535
18934	125751	364	404	1623	0	128142
18935	2854	259	377	125350	0	128840
18936	1587	287	380	127338	0	129592
18937	976	324	124779	2865	0	128944
18938	937	343	125918	1307	0	128505
18939	1000	274	2678	125735	0	129687
18940	561	337	135652	2723	0	139273
18941	132222	282	2867	1802	0	137173
18942	2741	353	1201	144952	0	149247
18943	965	493	153848	3097	0	158403
18944	149342	264	3390	2181	0	155177
18945	164476	235	1554	1698	0	167963
18946	4931	172845	985	1025	0	179786
18947	3225	3554	670	178047	0	185496
18948	1702	1686	184628	3793	0	191809
18949	182116	951	3851	2855	0	189773
18950	191323	550	1920	2188	0	195981
18951	5397	586	193355	996	0	200334
18952	194705	319	4170	1460	0	200654
18953	5506	389	2110	192937	0	200942
18954	3232	297	1265	197874	0	202668
18955	195850	267	934	6002	0	203053
18956	196566	245	782	3289	0	200882
18957	6329	618	797	194055	0	201799
18958	3179	374	195004	4453	0	203010
18959	2094	189211	3771	2542	0	197618
18960	1558	3610	190975	1532	0	197675
18961	1444	1717	187498	1294	0	191953
18962	1028	183883	5413	1119	0	191443
18963	2088	3099	2916	169111	0	177214
18964	1627	1420	1333	173645	0	178025
18965	796	889	173123	3825	0	178633
18966	1679	470	3182	167757	0	173088
18967	172320	326	1730	4588	0	178964
18968	3311	420	174974	2257	0	180962
18969	172682	294	3235	2330	0	178541
18970	179662	191	1992	1763	0	183608
18971	180312	270	1261	1773	0	183616
18972	5535	471	175834	846	0	182686
18973	3008	648	176634	829	0	181119
18974	2670	449	4438	173990	0	181547
18975	2266	458	2628	169114	0	174466
18976	1270	177912	1626	3981	0	184789
18977	176780	2857	1223	3081	0	183941
18978	176475	1403	1116	2399	0	181393
18979	4602	178402	1178	1306	0	185488
18980	179243	2912	946	2025	0	185126
18981	4355	178154	900	1298	0	184707
18982	180516	3378	915	1805	0	186614
18983	4982	1652	804	175372	0	182810
18984	2815	1183	177424	3348	0	184770
18985	2180	834	174928	1934	0	179876
18986	1975	751	4660	174774	0	182160
18987	1819	556	2803	176808	0	181986
18988	1079	715	176364	4592	0	182750
18989	1612	613	3784	171442	0	177451
18990	1868	693	2391	170248	0	175200
18991	174411	517	1688	5671	0	182287
18992	176658	481	1241	3581	0	181961
18993	173011	604	1039	2764	0	177418
18994	5556	587	170794	1449	0	178386
18995	3205	171857	3545	1278	0	179885
18996	2868	2884	2003	174162	0	181917
18997	2059	1592	178847	3406	0	185904
18998	1718	178785	3892	2002	0	186397
18999	181294	3119	2429	2169	0	189011
19000	4309	1664	1706	182260	0	189939
19001	2926	1091	1326	185037	0	190380
19002	183094	752	1281	5526	0	190653
19003	4398	778	1102	183721	0	189999
19004	3227	678	1033	183945	0	188883
19005	184407	684	854	6261	0	192206
19006	4555	880	181521	3089	0	190045
19007	2956	181266	3603	2206	0	190031
19008	181037	3241	2169	2498	0	188945
19009	4387	2141	185534	1440	0	193502
19010	178584	1236	3780	2428	0	186028
19011	4471	188929	2702	1519	0	197621
19012	187162	3408	1858	2240	0	194668
19013	187085	1781	1422	2349	0	192637
19014	182841	1197	1301	2335	0	187674
19015	6087	772	1190	179123	0	187172
19016	3844	1015	1246	179563	0	185668
19017	2565	178515	1158	5388	0	187626
19018	2150	180410	1270	3214	0	187044
19019	2168	183335	1136	2089	0	188728
19020	180434	4107	1036	2491	0	188068
19021	4090	2353	179276	1412	0	187131
19022	3200	1428	3197	177406	0	185231
19023	2341	1040	1980	178972	0	184333
19024	1751	179764	1579	4356	0	187450
19025	2041	3491	1091	181192	0	187815
19026	2229	1997	1118	178086	0	183430
19027	1726	182875	1050	4741	0	190392
19028	180468	3279	1158	3811	0	188716
19029	3636	184696	983	2244	0	191559
19030	2372	3765	180138	1834	0	188109
19031	175906	2015	2994	2546	0	183461
19032	3686	184646	1746	1671	0	191749
19033	181711	3244	1265	2099	0	188319
19034	4510	1871	1033	181544	0	188958
19035	3195	1255	1045	181478	0	186973
19036	2094	1128	181314	4105	0	188641
19037	2011	1172	178145	2305	0	183633
19038	2154	1290	3629	178723	0	185796
19039	177837	780	1943	4138	0	184698
19040	171378	636	1282	2757	0	176053
19041	4391	175628	968	1511	0	182498
19042	2150	170707	710	981	0	174548
19043	1187	167813	529	731	0	170260
19044	2770	4331	1547	159677	0	168325
19045	158195	803	1691	3627	0	164316
19046	157413	333	167	1633	0	159546
19047	154908	233	121	1272	0	156534
19048	3526	342	149192	292	0	153352
19049	1032	183395	2836	353	0	187616
19050	1318	3168	701	202926	0	208113
19051	204371	816	377	5010	0	210574
19052	5593	454	240	205340	0	211627
19053	2163	283	167	216288	0	218901
19054	214294	258	170	7005	0	221727
19055	230779	313	164	2560	0	233816
19056	7429	494	229793	883	0	238599
19057	3578	300	6045	228537	0	238460
19058	1330	345	229007	6475	0	237157
19059	2297	283	6580	227460	0	236620
19060	870	470	228994	7228	0	237562
19061	2043	402	6735	226747	0	235927
19062	221374	262	2089	8298	0	232023
19063	6341	222360	1263	2659	0	232623
19064	2027	234666	903	1661	0	239257
19065	2891	7811	662	208208	0	219572
19066	853	234594	693	5581	0	241721
19067	231454	7182	528	2855	0	242019
19068	228123	2212	589	2207	0	233131
19069	8443	1328	224186	981	0	234938
19070	2744	223625	6635	1060	0	234064
19071	3038	6425	1945	224765	0	236173
19072	1214	2222	226924	6598	0	236958
19073	222366	1123	6821	3089	0	233399
19074	8065	845	2089	226096	0	237095
19075	2722	855	229733	6911	0	240221
19076	2782	730	6880	227797	0	238189
19077	228206	809	2325	8372	0	239712
19078	7081	909	226810	2728	0	237528
19079	222229	600	7035	2685	0	232549
19080	231926	622	2357	1997	0	236902
19081	10118	584	1316	224672	0	236690
19082	3276	787	224768	7179	0	236010
19083	2130	941	222014	2741	0	227826
19084	217060	632	8312	2709	0	228713
19085	226399	478	2972	2492	0	232341
19086	9218	613	222426	1362	0	233619
19087	4963	533	7324	218315	0	231135
19088	3571	494	2737	217016	0	223818
19089	1841	220016	2047	8382	0	232286
19090	2862	6572	1578	222549	0	233561
19091	222706	1961	1401	8951	0	235019
19092	8938	1044	1292	223171	0	234445
19093	3408	875	220228	8520	0	233031
19094	214246	647	7563	4327	0	226783
19095	8670	711	2892	217370	0	229643
19096	3432	1113	217521	8004	0	230070
19097	2312	212172	7737	3635	0	225856
19098	205248	6973	2913	3648	0	218782
19099	7882	213351	2047	2516	0	225796
19100	212269	7567	1623	3095	0	224554
19101	8966	2778	209601	2321	0	223666
19102	3955	203307	7522	2420	0	217204
19103	2812	214747	3108	2215	0	222882
19104	3359	8753	2260	204914	0	219286
19105	3293	3104	1885	212514	0	220796
19106	2287	2063	206025	9965	0	220340
19107	2915	1369	8046	207281	0	219611
19108	203846	1183	3488	10139	0	218656
19109	8405	1418	201188	4305	0	215316
19110	4339	1512	8312	199989	0	214152
19111	2847	1682	198908	9025	0	212462
19112	189766	1627	8672	4860	0	204925
19113	8362	198058	3895	3529	0	213844
19114	198073	7620	2872	3661	0	212226
19115	205603	3033	2320	3321	0	214277
19116	207536	2122	2210	3124	0	214992
19117	11503	1966	194813	2538	0	210820
19118	5235	194848	8544	2637	0	211264
19119	4252	7700	3838	194178	0	209968
19120	3672	3095	2910	206755	0	216432
19121	207572	1962	2525	11187	0	223246
19122	10903	1479	2463	209185	0	224030
19123	209687	1393	2689	11287	0	225056
19124	212531	1420	3234	5683	0	222868
19125	215158	1426	2527	4330	0	223441
19126	216465	1593	2514	3492	0	224064
19127	13896	1434	2127	204602	0	222059
19128	206685	1345	2148	10497	0	220675
19129	11969	1440	196910	4761	0	215080
19130	198406	1421	9212	3974	0	213013
19131	207920	1517	3941	3144	0	216522
19132	13354	1699	193301	4935	0	213289
19133	199166	1506	9167	2886	0	212725
19134	208209	1323	3956	2959	0	216447
19135	13493	1272	2993	197511	0	215269
19136	7217	1243	2669	203803	0	214932
19137	196229	3597	2406	11722	0	213954
19138	12099	1153	2279	197251	0	212782
19139	6704	1105	2318	195477	0	205604
19140	4707	185117	2264	11589	0	203677
19141	4709	6429	2001	186636	0	199775
19142	182300	2143	2108	10121	0	196672
19143	10206	1386	1847	181320	0	194759
19144	5648	990	1818	179126	0	187582
19145	4005	166207	2060	9996	0	182268
19146	4535	6128	1681	162349	0	174693
19147	5157	2361	1683	162251	0	171452
19148	155141	1438	1537	9164	0	167280
19149	7641	2105	931	115289	0	125966
19150	2768	632	97449	5304	0	106153
19151	1769	89098	3641	2922	0	97430
19152	1380	89621	1631	1815	0	94447
19153	82816	3724	1058	1700	0	89298
19154	3661	84374	734	1253	0	90022
19155	69300	2167	1010	1065	0	73542
19156	2517	69153	301	734	0	72705
19157	70298	2285	338	856	0	73777
19158	2985	923	143	70630	0	74681
19159	1559	658	137	71593	0	73947
19160	988	70949	182	3021	0	75140
19161	1171	2289	136	72306	0	75902
19162	814	868	71631	2837	0	76150
19163	68156	565	2030	1675	0	72426
19164	2516	75200	771	1000	0	79487
19165	74002	2376	415	896	0	77689
19166	74771	930	299	856	0	76856
19167	76121	628	244	692	0	77685
19168	4027	454	180	72234	0	76895
19169	2068	386	222	72697	0	75373
19170	1229	72453	206	3267	0	77155
19171	72336	2468	137	1794	0	76735
19172	2854	73478	157	1087	0	77576
19173	73994	2788	137	1025	0	77944
19174	3276	1167	73866	713	0	79022
19175	76811	703	2408	876	0	80798
19176	3836	460	879	77075	0	82250
19177	1786	558	76745	3099	0	82188
19178	1400	451	77869	1432	0	81152
19179	1348	390	3654	77188	0	82580
19180	1050	322	78524	3259	0	83155
19181	1080	349	3417	77145	0	81991
19182	73911	326	1368	3775	0	79380
19183	3482	327	856	75691	0	80356
19184	1687	360	73765	3706	0	79518
19185	1259	70600	2951	1804	0	76614
19186	972	74878	1276	1266	0	78392
19187	1183	3452	907	71746	0	77288
19188	72005	1470	679	3444	0	77598
19189	3405	845	392	72842	0	77484
19190	1825	501	391	74701	0	77418
19191	1448	428	482	75655	0	78013
19192	1159	440	422	76099	0	78120
19193	867	505	73100	4530	0	79002
19194	830	446	72234	2369	0	75879
19195	71486	343	3511	1811	0	77151
19196	75063	331	1566	1423	0	78383
19197	4068	384	999	72794	0	78245
19198	2229	395	623	75011	0	78258
19199	1341	456	72058	4119	0	77974
19200	983	72359	2839	2231	0	78412
19201	71843	2731	1234	1844	0	77652
19202	74626	1213	790	1363	0	77992
19203	4224	859	474	72840	0	78397
19204	2054	629	72598	3544	0	78825
19205	1634	575	2723	70507	0	75439
19206	1013	71991	1317	3575	0	77896
19207	1016	2861	72484	1705	0	78066
19208	71549	1287	2971	1539	0	77346
19209	3512	886	1287	73276	0	78961
19210	74391	588	949	3719	0	79647
19211	3617	535	71276	1954	0	77382
19212	72151	534	2945	1684	0	77314
19213	3871	603	1476	72090	0	78040
19214	72302	529	1089	3523	0	77443
19215	4045	472	712	69855	0	75084
19216	1955	66593	776	3780	0	73104
19217	1496	70243	706	1915	0	74360
19218	1492	3706	694	68028	0	73920
19219	979	1475	65793	3044	0	71291
19220	754	64290	2539	1680	0	69263
19221	1242	2150	1139	57716	0	62247
19222	55139	884	814	2609	0	59446
19223	56199	558	496	1410	0	58663
19224	2711	424	436	55794	0	59365
19225	1577	363	462	55663	0	58065
19226	978	52616	538	2808	0	56940
19227	787	56174	429	1608	0	58998
19228	54885	2292	386	1390	0	58953
19229	2160	1167	411	55185	0	58923
19230	1194	752	394	56390	0	58730
19231	884	507	54443	3083	0	58917
19232	762	398	2017	54522	0	57699
19233	753	411	1028	54860	0	57052
19234	716	392	733	55950	0	57791
19235	722	374	54078	3240	0	58414
19236	769	304	1968	55136	0	58177
19237	54199	298	1010	3120	0	58627
19238	2056	365	53274	1740	0	57435
19239	55681	403	2047	1665	0	59796
19240	2492	399	1060	57242	0	61193
19241	1408	321	793	59851	0	62373
19242	1109	268	598	61967	0	63942
19243	742	241	59113	3493	0	63589
19244	56819	214	2168	2207	0	61408
19245	2235	61840	1157	1473	0	66705
19246	62009	1969	754	1286	0	66018
19247	2528	62852	605	1025	0	67010
19248	1424	2282	511	63387	0	67604
19249	63426	997	444	2914	0	67781
19250	2528	681	61757	1595	0	66561
19251	60524	374	2158	1377	0	64433
19252	2752	376	62975	929	0	67032
19253	1579	449	2413	61609	0	66050
19254	972	332	61732	2512	0	65548
19255	706	60403	2409	1501	0	65019
19256	1056	1870	1167	57572	0	61665
19257	55858	920	856	2372	0	60006
19258	1956	536	407	54338	0	57237
19259	1028	53798	381	2067	0	57274
19260	914	1538	348	54933	0	57733
19261	53605	775	291	2280	0	56951
19262	52726	502	298	1388	0	54914
19263	2363	51734	341	978	0	55416
19264	935	48577	258	466	0	50236
19265	739	1502	236	47602	0	50079
19266	553	718	249	48474	0	49994
19267	47351	401	209	1894	0	49855
19268	46908	297	224	1094	0	48523
19269	1577	47262	202	666	0	49707
19270	961	1197	167	45984	0	48309
19271	710	551	171	46989	0	48421
19272	444	398	46246	1676	0	48764
19273	348	45210	1082	1036	0	47676
19274	329	44378	455	588	0	45750
19275	329	1075	228	41504	0	43136
19276	222	403	41295	863	0	42783
19277	205	290	40928	364	0	41787
19278	327	214	911	40596	0	42048
19279	307	155	403	41655	0	42520
19280	183	149	41439	1032	0	42803
19281	304	111	846	41417	0	42678
19282	188	149	42270	1054	0	43661
19283	42567	243	954	665	0	44429
19284	1172	145	407	43822	0	45546
19285	452	173	44945	1215	0	46785
19286	314	177	44982	616	0	46089
19287	399	158	1437	47332	0	49326
19288	227	141	51387	1481	0	53236
19289	220	167	51786	674	0	52847
19290	183	50962	1780	510	0	53435
19291	52098	1319	716	522	0	54655
19292	1445	493	53753	299	0	55990
19293	715	333	1548	52527	0	55123
19294	600	217	638	53863	0	55318
19295	444	163	427	55843	0	56877
19296	237	201	54014	2172	0	56624
19297	428	161	1545	53200	0	55334
19298	53472	128	632	2080	0	56312
19299	1617	169	477	53485	0	55748
19300	618	162	53271	1913	0	55964
19301	539	135	1543	53029	0	55246
19302	53384	117	720	2138	0	56359
19303	54408	155	519	1068	0	56150
19304	54177	140	366	834	0	55517
19305	2250	117	372	53339	0	56078
19306	53781	94	330	1970	0	56175
19307	53969	109	348	1044	0	55470
19308	53996	84	326	881	0	55287
19309	2144	51899	375	529	0	54947
19310	52894	1343	315	645	0	55197
19311	2125	498	292	52339	0	55254
19312	878	337	51920	1719	0	54854
19313	657	51839	1593	806	0	54895
19314	52000	1428	682	861	0	54971
19315	1854	541	531	52132	0	55058
19316	992	369	393	51545	0	53299
19317	643	50570	414	1940	0	53567
19318	465	53119	383	1062	0	55029
19319	50308	1765	402	835	0	53310
19320	1597	51074	339	622	0	53632
19321	49536	1664	306	577	0	52083
19322	1759	49908	322	531	0	52520
19323	49076	1628	299	655	0	51658
19324	1760	49367	256	593	0	51976
19325	789	51724	297	510	0	53320
19326	50415	1848	256	692	0	53211
19327	1718	872	50154	437	0	53181
19328	837	50354	1443	528	0	53162
19329	814	1642	595	50223	0	53274
19330	687	663	450	52647	0	54447
19331	744	505	327	51628	0	53204
19332	707	367	243	52514	0	53831
19333	587	371	51631	2295	0	54884
19334	50926	273	1594	1256	0	54049
19335	1963	303	627	53893	0	56786
19336	54661	289	461	2241	0	57652
19337	57368	303	338	1099	0	59108
19338	58154	305	320	948	0	59727
19339	56630	304	316	814	0	58064
19340	2721	363	54296	585	0	57965
19341	1402	323	1840	53452	0	57017
19342	787	297	53769	2093	0	56946
19343	633	52669	2171	988	0	56461
19344	1067	1968	964	48004	0	52003
19345	822	617	557	50732	0	52728
19346	618	370	394	51333	0	52715
19347	596	295	395	50727	0	52013
19348	451	297	49089	2593	0	52430
19349	607	233	1804	49210	0	51854
19350	610	264	756	50897	0	52527
19351	49960	299	511	2635	0	53405
19352	52529	268	365	1350	0	54512
19353	2671	247	370	52326	0	55614
19354	1338	245	391	53739	0	55713
19355	945	270	351	54705	0	56271
19356	52571	251	357	3270	0	56449
19357	54787	226	364	1652	0	57029
19358	52274	285	365	1359	0	54283
19359	54548	275	264	1067	0	56154
19360	2944	53218	302	832	0	57296
19361	54324	1800	280	953	0	57357
19362	55449	636	285	966	0	57336
19363	2974	446	242	53113	0	56775
19364	1689	273	231	53734	0	55927
19365	51860	220	237	2923	0	55240
19366	2549	49860	238	1411	0	54058
19367	1369	52823	203	1004	0	55399
19368	54105	2163	185	920	0	57373
19369	2699	889	192	54516	0	58296
19370	1602	550	186	55698	0	58036
19371	1312	369	174	56650	0	58505
19372	1154	354	151	56396	0	58055
19373	1071	350	195	55303	0	56919
19374	783	53156	191	2912	0	57042
19375	880	1790	153	53106	0	55929
19376	52679	708	130	2597	0	56114
19377	2206	464	150	52494	0	55314
19378	1121	384	146	53603	0	55254
19379	51541	342	175	2865	0	54923
19380	2091	51759	170	1446	0	55466
19381	1109	1939	168	51005	0	54221
19382	796	51767	163	2158	0	54884
19383	737	2214	158	50316	0	53425
19384	622	605	49111	2064	0	52402
19385	45214	491	1273	1268	0	48246
19386	1570	47053	455	812	0	49890
19387	44017	1156	208	694	0	46075
19388	1449	470	42722	480	0	45121
19389	754	558	1019	39281	0	41612
19390	447	39561	421	1217	0	41646
19391	403	41451	241	695	0	42790
19392	40058	1218	204	580	0	42060
19393	1316	490	90	40381	0	42277
19394	543	306	42429	1267	0	44545
19395	565	173	951	43117	0	44806
19396	352	204	43098	1387	0	45041
19397	40594	176	1089	859	0	42718
19398	1231	184	43598	545	0	45558
19399	724	142	1092	42738	0	44696
19400	418	44845	443	1278	0	46984
19401	504	1049	220	44726	0	46499
19402	367	45148	210	1355	0	47080
19403	46473	1133	158	847	0	48611
19404	1395	446	134	48635	0	50610
19405	628	323	48863	1464	0	51278
19406	577	296	46608	752	0	48233
19407	48184	186	1331	795	0	50496
19408	51668	179	526	672	0	53045
19409	51589	179	260	657	0	52685
19410	51260	178	229	667	0	52334
19411	1712	50585	191	542	0	53030
19412	51888	1124	197	603	0	53812
19413	52224	470	128	664	0	53486
19414	1708	392	50731	490	0	53321
19415	984	242	1037	50428	0	52691
19416	51950	254	366	1544	0	54114
19417	1477	255	50654	759	0	53145
19418	854	192	1096	50936	0	53078
19419	611	211	53901	1474	0	56197
19420	683	200	1189	53020	0	55092
19421	543	55365	456	1396	0	57760
19422	56572	1098	241	856	0	58767
19423	1463	529	54590	563	0	57145
19424	54571	340	1048	572	0	56531
19425	1601	300	409	55729	0	58039
19426	56531	222	243	1485	0	58481
19427	1565	209	188	56414	0	58376
19428	61640	211	219	1886	0	63956
19429	1477	272	59801	796	0	62346
19430	64698	275	1063	865	0	66901
19431	1537	237	503	67275	0	69552
19432	808	210	273	68215	0	69506
19433	67184	215	216	1786	0	69401
19434	1454	209	174	67423	0	69260
19435	584	229	66670	1326	0	68809
19436	669	283	853	65477	0	67282
19437	63086	143	370	1338	0	64937
19438	935	62053	281	629	0	63898
19439	454	62288	175	484	0	63401
19440	61846	735	134	484	0	63199
19441	788	65772	168	345	0	67073
19442	512	603	125	65389	0	66629
19443	65484	200	222	949	0	66855
19444	65485	146	92	584	0	66307
19445	65016	134	71	513	0	65734
19446	820	181	65782	236	0	67019
19447	474	179	520	65034	0	66207
19448	244	66462	248	661	0	67615
19449	353	550	167	67099	0	68169
19450	230	271	68895	621	0	70017
19451	259	66083	557	314	0	67213
19452	318	572	193	67306	0	68389
19453	65761	126	110	639	0	66636
19454	373	66530	92	181	0	67176
19455	209	382	68888	100	0	69579
19456	337	126	461	67033	0	67957
19457	157	115	68846	486	0	69604
19458	331	78	533	65889	0	66831
19459	69689	53	205	827	0	70774
19460	639	50	120	69943	0	70752
19461	70232	66	108	815	0	71221
19462	70569	57	94	571	0	71291
19463	653	72624	127	180	0	73584
19464	73868	489	96	425	0	74878
19465	648	73089	135	153	0	74025
19466	335	627	74523	118	0	75603
19467	660	197	616	72176	0	73649
19468	441	102	192	78832	0	79567
19469	191	133	76928	847	0	78099
19470	153	76495	781	320	0	77749
19471	77847	667	221	567	0	79302
19472	80168	211	144	481	0	81004
19473	1117	122	121	81859	0	83219
19474	605	100	89	81034	0	81828
19475	408	77	103	83955	0	84543
19476	82644	83	103	1340	0	84170
19477	857	189	80333	381	0	81760
19478	416	187	80240	239	0	81082
19479	476	90	870	82553	0	83989
19480	234	137	82741	862	0	83974
19481	243	153	81743	382	0	82521
19482	464	84	921	79384	0	80853
19483	228	118	84860	906	0	86112
19484	189	84525	919	450	0	86083
19485	481	748	307	85945	0	87481
19486	223	260	88686	958	0	90127
19487	420	154	894	86016	0	87484
19488	168	84478	386	1023	0	86055
19489	406	728	234	87730	0	89098
19490	215	274	89588	1003	0	91080
19491	558	183	917	84727	0	86385
19492	87593	117	364	1526	0	89600
19493	895	167	87977	397	0	89436
19494	81039	114	908	787	0	82848
19495	989	87910	366	282	0	89547
19496	88813	826	255	617	0	90511
19497	1124	280	173	89561	0	91138
19498	319	89305	215	1003	0	90842
19499	92098	931	188	788	0	94005
19500	1286	333	174	93521	0	95314
19501	392	230	94601	1205	0	96428
19502	228	94751	1204	485	0	96668
19503	449	1105	392	95796	0	97742
19504	93821	300	235	1668	0	96024
19505	91667	199	204	788	0	92858
19506	1660	137	174	91712	0	93683
19507	553	191	91255	1265	0	93264
19508	83155	135	1215	1063	0	85568
19509	1280	213	91143	369	0	93005
19510	763	162	1310	89167	0	91402
19511	91105	163	499	1781	0	93548
19512	1235	90964	347	608	0	93154
19513	91286	1129	249	917	0	93581
19514	1448	449	89617	377	0	91891
19515	89518	226	1306	702	0	91752
19516	1638	205	549	91464	0	93856
19517	840	186	368	93458	0	94852
19518	588	244	92889	1547	0	95268
19519	660	194	1258	88313	0	90425
19520	90412	175	468	1918	0	92973
19521	1564	190	350	90353	0	92457
19522	636	90904	383	1463	0	93386
19523	683	1136	341	90993	0	93153
19524	407	91500	389	1535	0	93831
19525	415	1339	90291	719	0	92764
19526	84741	443	1352	1011	0	87547
19527	1634	288	521	91796	0	94239
19528	640	289	86705	1553	0	89187
19529	486	85375	1390	732	0	87983
19530	597	1301	522	83330	0	85750
19531	608	528	383	84124	0	85643
19532	83228	357	359	2180	0	86124
19533	1654	330	316	84817	0	87117
19534	85404	261	389	2138	0	88192
19535	85128	287	402	1228	0	87045
19536	1885	85724	402	700	0	88711
19537	87438	1536	322	1002	0	90298
19538	2161	493	334	94362	0	97350
19539	867	414	93661	2143	0	97085
19540	92909	270	1848	1258	0	96285
19541	2377	237	591	91984	0	95189
19542	969	310	91380	2105	0	94764
19543	87625	287	1874	1213	0	90999
19544	2347	322	586	90953	0	94208
19545	935	93015	473	2161	0	96584
19546	1026	1855	393	89655	0	92929
19547	622	92519	533	2078	0	95752
19548	90855	1931	440	1369	0	94595
19549	2285	681	93311	801	0	97078
19550	914	92033	2048	779	0	95774
19551	1078	1901	662	92242	0	95883
19552	629	723	92993	2244	0	96589
19553	672	624	88849	983	0	91128
19554	592	91019	2225	916	0	94752
19555	978	2196	846	88941	0	92961
19556	826	664	584	91544	0	93618
19557	1028	515	466	110418	0	112427
19558	114233	412	450	3892	0	118987
19559	3228	518	123993	1198	0	128937
19560	1004	125036	3542	961	0	130543
19561	1252	3560	1016	122621	0	128449
19562	1119	992	730	129658	0	132499
19563	632	717	125795	4523	0	131667
19564	1187	605	3672	124829	0	130293
19565	601	436	125064	4509	0	130610
19566	623	462	121712	1537	0	124334
19567	666	414	122485	1140	0	124705
19568	1173	420	4275	114566	0	120434
19569	980	408	1444	118880	0	121712
19570	944	377	865	123338	0	125524
19571	118923	308	750	5126	0	125107
19572	3521	118541	847	1773	0	124682
19573	120261	3527	821	1612	0	126221
19574	116785	1003	663	1743	0	120194
19575	122359	604	665	1515	0	125143
19576	4419	122446	726	1124	0	128715
19577	123020	3602	660	1344	0	128626
19578	125615	1107	546	1236	0	128504
19579	5157	753	660	121535	0	128105
19580	2333	599	618	123962	0	127512
19581	1811	522	597	126793	0	129723
19582	1047	624	122139	5143	0	128953
19583	118345	482	3845	2333	0	125005
19584	4557	550	1146	121623	0	127876
19585	118825	508	907	4895	0	125135
19586	4243	118401	834	1970	0	125448
19587	2130	3579	748	119289	0	125746
19588	1728	1017	776	123154	0	126675
19589	119474	757	754	5334	0	126319
19590	4563	652	718	119510	0	125443
19591	108399	679	687	5569	0	115334
19592	118205	660	567	2403	0	121835
19593	4676	113086	623	1903	0	120288
19594	1637	117637	630	1588	0	121492
19595	1864	4395	610	111488	0	118357
19596	1068	115779	730	4133	0	121710
19597	1675	4053	617	115361	0	121706
19598	1143	1194	114295	4513	0	121145
19599	1018	1041	111440	1788	0	115287
19600	105468	890	3847	1776	0	111981
19601	109268	584	1256	1635	0	112743
19602	4185	107962	942	1359	0	114448
19603	107578	3368	735	1607	0	113288
19604	4000	112421	803	1316	0	118540
19605	1766	3560	860	113425	0	119611
19606	1519	1126	815	115616	0	119076
19607	1356	872	814	115732	0	118774
19608	1121	803	830	116833	0	119587
19609	112659	598	797	5347	0	119401
19610	3485	113644	815	2471	0	120415
19611	113849	3321	826	2262	0	120258
19612	116858	983	818	1903	0	120562
19613	4701	813	113243	1454	0	120211
19614	110955	805	3422	1554	0	116736
19615	4612	112301	1026	1266	0	119205
19616	2218	3889	726	112577	0	119410
19617	2047	1379	591	111573	0	115590
19618	1476	112135	654	4366	0	118631
19619	113777	3672	761	2383	0	120593
19620	4412	1205	111750	1905	0	119272
19621	110283	912	3579	2256	0	117030
19622	4760	791	112593	1919	0	120063
19623	2462	757	4097	112367	0	119683
19624	2129	1091	1565	116479	0	121264
19625	1937	943	1452	118634	0	122966
19626	116507	1118	1284	6081	0	124990
19627	4392	969	118046	3138	0	126545
19628	117099	1057	4146	3256	0	125558
19629	121567	812	1959	3102	0	127440
19630	121288	702	1726	3057	0	126773
19631	121515	639	1936	2493	0	126583
19632	5621	717	1702	118946	0	126986
19633	2560	696	117295	4806	0	125357
19634	2657	891	3853	115872	0	123273
19635	2161	709	115978	5141	0	123989
19636	1999	1022	113442	2798	0	119261
19637	2244	113634	3551	2436	0	121865
19638	2438	3489	1094	104617	0	111638
19639	2643	1368	745	108968	0	113724
19640	2979	1429	762	97286	0	102456
19641	2914	1001	703	107033	0	111651
19642	107780	1028	674	4295	0	113777
19643	109550	765	478	2236	0	113029
19644	5158	822	520	106318	0	112818
19645	2634	693	103756	4704	0	111787
19646	2061	576	2999	105529	0	111165
19647	1843	513	1059	109053	0	112468
19648	1567	527	105412	5189	0	112695
19649	2031	486	2966	104241	0	109724
19650	104744	778	1108	4792	0	111422
19651	105936	730	780	2666	0	110112
19652	106405	932	490	2506	0	110333
19653	4863	748	364	104394	0	110369
19654	103446	691	424	4552	0	109113
19655	103194	593	483	2599	0	106869
19656	4624	559	99183	2068	0	106434
19657	1581	281	75562	999	0	78423
19658	1245	257	74900	840	0	77242
19659	62476	133	889	461	0	63959
19660	814	64618	402	289	0	66123
19661	64071	456	368	415	0	65310
19662	673	70525	169	265	0	71632
19663	429	563	150	70760	0	71902
19664	388	188	100	71175	0	71851
19665	364	92	123	71599	0	72178
19666	246	129	71110	854	0	72339
19667	66313	68	609	556	0	67546
19668	792	94	232	71092	0	72210
19669	274	76	70966	625	0	71941
19670	296	124	66387	270	0	67077
19671	66461	64	612	483	0	67620
19672	626	70886	280	244	0	72036
19673	69813	429	181	391	0	70814
19674	69255	140	114	399	0	69908
19675	637	69268	118	163	0	70186
19676	67915	446	107	368	0	68836
19677	593	182	70056	136	0	70967
19678	311	121	67016	121	0	67569
19679	231	105	70481	120	0	70937
19680	318	250	685	69936	0	71189
19681	154	54	71816	436	0	72460
19682	67910	64	509	411	0	68894
19683	70248	34	210	382	0	70874
19684	673	61	72169	99	0	73002
19685	434	48	464	70330	0	71276
19686	71969	49	191	713	0	72922
19687	523	75977	156	205	0	76861
19688	209	77766	135	152	0	78262
19689	77241	507	117	447	0	78312
19690	500	223	79282	78	0	80083
19691	378	339	403	76443	0	77563
19692	234	61	177	77536	0	78008
19693	211	35	96	79146	0	79488
19694	84	78854	104	538	0	79580
19695	694	491	114	73391	0	74690
19696	84467	116	52	871	0	85506
19697	793	66	63	86832	0	87754
19698	220	87976	103	776	0	89075
19699	90182	720	60	566	0	91528
19700	949	207	66	90643	0	91865
19701	444	145	68	94161	0	94818
19702	95661	90	110	1342	0	97203
19703	96143	62	58	654	0	96917
19704	1387	64	62	96007	0	97520
19705	98757	46	40	1544	0	100387
19706	99321	74	50	720	0	100165
19707	1505	101126	92	300	0	103023
19708	101739	1214	38	558	0	103549
19709	1470	101220	76	226	0	102992
19710	849	1297	43	101552	0	103741
19711	416	456	103722	1305	0	105899
19712	686	258	1172	102072	0	104188
19713	629	155	311	103467	0	104562
19714	552	115	201	107636	0	108504
19715	106314	127	99	2276	0	108816
19716	1568	106180	135	786	0	108669
19717	109101	1407	59	873	0	111440
19718	1779	113290	100	426	0	115595
19719	115145	1677	90	796	0	117708
19720	115476	600	60	736	0	116872
19721	116337	392	90	724	0	117543
19722	115122	266	95	701	0	116184
19723	2375	285	114250	332	0	117242
19724	1364	225	1589	113788	0	116966
19725	1178	161	463	118361	0	120163
19726	540	308	117545	2275	0	120668
19727	111863	203	1866	1230	0	115162
19728	2481	197	501	116139	0	119318
19729	971	325	115058	2143	0	118497
19730	846	346	113310	733	0	115235
19731	1095	257	2281	116006	0	119639
19732	686	277	120090	2196	0	123249
19733	1055	194	2217	116879	0	120345
19734	1073	162	788	118286	0	120309
19735	661	206	116802	2704	0	120373
19736	110710	155	2160	1423	0	114448
19737	2675	161	819	116566	0	120221
19738	977	233	118174	2446	0	121830
19739	1167	212	2229	117928	0	121536
19740	118357	165	897	2979	0	122398
19741	2439	182	118070	1150	0	121841
19742	112719	169	2298	1406	0	116592
19743	120774	129	921	1091	0	122915
19744	3091	156	719	119965	0	123931
19745	1552	168	593	119662	0	121975
19746	957	252	118856	2866	0	122931
19747	1136	214	2204	118198	0	121752
19748	1648	301	1011	108013	0	110973
19749	1017	203	739	120500	0	122459
19750	773	231	117196	3147	0	121347
19751	112554	167	2284	1973	0	116978
19752	118198	157	935	1652	0	120942
19753	120216	183	736	1463	0	122598
19754	123390	201	612	1333	0	125536
19755	3593	235	506	122895	0	127229
19756	122318	245	538	3149	0	126250
19757	122904	255	525	1758	0	125442
19758	98799	777	882	2971	0	103429
19759	122195	193	559	1618	0	124565
19760	3248	121152	660	1116	0	126176
19761	122652	1894	563	1397	0	126506
19762	120637	558	535	1444	0	123174
19763	3447	119784	539	1114	0	124884
19764	120847	2302	553	1188	0	124890
19765	3842	703	520	120289	0	125354
19766	2204	447	456	122204	0	125311
19767	119830	370	509	3676	0	124385
19768	3418	117499	545	1568	0	123030
19769	1709	119179	573	1261	0	122722
19770	1745	2671	522	120056	0	124994
19771	1312	938	120857	2948	0	126055
19772	1611	539	2545	117549	0	122244
19773	1477	387	921	121900	0	124685
19774	119321	392	699	3921	0	124333
19775	120602	381	645	1924	0	123552
19776	3836	356	577	119867	0	124636
19777	1709	476	118004	3281	0	123470
19778	1706	311	2670	118612	0	123299
19779	120259	302	1025	3905	0	125491
19780	3382	338	125450	1779	0	130949
19781	1590	125768	3149	1417	0	131924
19782	128766	2630	1085	1512	0	133993
19783	3937	808	826	128524	0	134095
19784	2026	542	725	129244	0	132537
19785	1850	346	646	132186	0	135028
19786	1250	354	127746	4511	0	133861
19787	114270	303	3133	2633	0	120339
19788	3726	368	121890	1586	0	127570
19789	1875	120885	3328	1400	0	127488
19790	1781	2587	1300	121588	0	127256
19791	1691	803	987	124341	0	127822
19792	1664	618	830	130488	0	133600
19793	1278	470	127697	4928	0	134373
19794	1293	422	126063	2326	0	130104
19795	1138	428	127787	1695	0	131048
19796	1000	126054	4197	1549	0	132800
19797	1636	3154	1852	125016	0	131658
19798	126694	874	1167	4506	0	133241
19799	134742	566	982	2235	0	138525
19800	5134	493	138487	1348	0	145462
19801	2277	138175	4340	1384	0	146176
19802	1697	3830	137729	1043	0	144299
19803	1187	141835	4430	1162	0	148614
19804	134731	4643	2610	1805	0	143789
19805	135046	1513	1184	1480	0	139223
19806	4964	133734	997	1018	0	140713
19807	133201	4026	926	1093	0	139246
19808	5341	1567	853	130448	0	138209
19809	2745	1060	837	134277	0	138919
19810	132270	893	625	5200	0	138988
19811	128926	683	561	2529	0	132699
19812	128994	586	513	1977	0	132070
19813	5786	124573	624	1398	0	132381
19814	2577	130757	673	1282	0	135289
19815	128740	4542	611	1505	0	135398
19816	4911	1872	127629	961	0	135373
19817	2883	1942	3634	123088	0	131547
19818	120284	922	1369	4234	0	126809
19819	4807	116108	938	1595	0	123448
19820	2198	122759	764	1166	0	126887
19821	121608	4626	615	1225	0	128074
19822	4675	1864	118207	992	0	125738
19823	114525	1471	3731	1241	0	120968
19824	4864	1013	114547	807	0	121231
19825	2385	901	114277	602	0	118165
19826	2291	988	4321	111305	0	118905
19827	1433	965	115918	3286	0	121602
19828	111739	787	4120	1634	0	118280
19829	115511	591	1898	1381	0	119381
19830	117625	579	1459	1177	0	120840
19831	117491	589	1110	1100	0	120290
19832	5830	613	925	111694	0	119062
19833	112882	666	856	3785	0	118189
19834	4820	111202	836	1509	0	118367
19835	3167	3296	714	106590	0	113767
19836	2167	113629	852	3142	0	119790
19837	117554	3631	701	1838	0	123724
19838	118196	1498	727	1431	0	121852
19839	5385	1121	789	115599	0	122894
19840	117498	948	772	4051	0	123269
19841	119390	903	815	1922	0	123030
19842	5689	853	773	116173	0	123488
19843	3416	844	657	117286	0	122203
19844	2792	695	634	119799	0	123920
19845	2275	724	114653	5003	0	122655
19846	2077	670	111027	2583	0	116357
19847	1908	709	114651	1737	0	119005
19848	1938	880	4613	113806	0	121237
19849	1636	766	116948	4205	0	123555
19850	1914	788	4313	115313	0	122328
19851	1796	724	123386	4487	0	130393
19852	1799	664	120483	2219	0	125165
19853	115741	631	4914	2229	0	123515
19854	4199	117328	2518	1521	0	125566
19855	120115	3413	1843	1618	0	126989
19856	4806	1443	1542	118096	0	125887
19857	2865	1054	1338	120791	0	126048
19858	2142	902	119277	4711	0	127032
19859	1812	118398	3901	2461	0	126572
19860	2024	3467	1854	120511	0	127856
19861	1641	1564	121838	4029	0	129072
19862	1495	118195	3632	2085	0	125407
19863	1786	3078	2041	118252	0	125157
19864	117245	1453	1670	4048	0	124416
19865	118702	1177	1374	2140	0	123393
19866	4632	951	1324	117653	0	124560
19867	118239	937	1117	3930	0	124223
19868	4392	118006	1095	2023	0	125516
19869	2842	3151	1015	119663	0	126671
19870	2255	1515	121545	3775	0	129090
19871	2293	1207	3313	121253	0	128066
19872	1946	983	122216	4153	0	129298
19873	116713	1078	3638	2431	0	123860
19874	4450	891	1644	121469	0	128454
19875	2386	122596	1459	3931	0	130372
19876	2285	3576	1046	127114	0	134021
19877	1816	1391	125276	4431	0	132914
19878	1874	1058	123517	2433	0	128882
19879	1786	902	121658	1780	0	126126
19880	112048	1035	4402	1612	0	119097
19881	3404	115961	2088	1299	0	122752
19882	2002	2787	1452	114831	0	121072
19883	115106	1215	1265	3484	0	121070
19884	3157	115437	1372	1828	0	121794
19885	120428	2663	1117	1973	0	126181
19886	122321	1322	1239	1531	0	126413
19887	124853	953	1008	1460	0	128274
19888	126339	752	987	1321	0	129399
19889	4452	859	121649	995	0	127955
19890	117502	523	2948	1395	0	122368
19891	3935	485	119761	947	0	125128
19892	107935	411	2915	1017	0	112278
19893	3610	519	1656	114823	0	120608
19894	2105	400	113228	2124	0	117857
19895	1609	110603	2247	1319	0	115778
19896	1932	5769	1487	104000	0	113188
19897	1303	108227	920	1758	0	112208
19898	1086	109591	732	1219	0	112628
19899	96942	1419	956	955	0	100272
19900	1339	413	94524	403	0	96679
19901	502	91393	749	272	0	92916
19902	89426	615	717	455	0	91213
19903	614	91830	232	166	0	92842
19904	92470	503	154	428	0	93555
19905	738	324	119	91753	0	92934
19906	92804	138	115	741	0	93798
19907	686	148	135	91981	0	92950
19908	92739	126	127	791	0	93783
19909	694	154	140	92719	0	93707
19910	328	97036	158	550	0	98072
19911	352	506	123	99292	0	100273
19912	98963	243	125	894	0	100225
19913	566	98344	151	305	0	99366
19914	391	513	111	98776	0	99791
19915	99745	237	113	833	0	100928
19916	689	182	99	100627	0	101597
19917	478	142	102	99838	0	100560
19918	273	192	101934	644	0	103043
19919	300	207	98459	331	0	99297
19920	440	147	571	98224	0	99382
19921	215	233	104761	565	0	105774
19922	336	152	532	103138	0	104158
19923	865	202	335	91329	0	92731
19924	324	155	142	104508	0	105129
19925	235	208	104981	732	0	106156
19926	498	132	499	98770	0	99899
19927	351	178	211	102123	0	102863
19928	180	104209	199	751	0	105339
19929	270	474	147	105664	0	106555
19930	104919	217	149	1017	0	106302
19931	731	143	143	106368	0	107385
19932	342	187	122953	818	0	124300
19933	115041	109	1568	1005	0	117723
19934	1668	130803	1039	409	0	133919
19935	1501	1697	611	132263	0	136072
19936	824	1095	131269	1882	0	135070
19937	120373	684	1902	1805	0	124764
19938	1949	130022	1282	915	0	134168
19939	130914	1950	810	881	0	134555
19940	2775	1213	467	129823	0	134278
19941	129574	775	331	2400	0	133080
19942	2762	479	129175	1260	0	133676
19943	1591	127327	1905	1007	0	131830
19944	1016	138114	1209	651	0	140990
19945	137723	2616	818	1070	0	142227
19946	137589	1609	466	948	0	140612
19947	3032	1109	136857	256	0	141254
19948	131780	540	1949	763	0	135032
19949	136714	426	1180	716	0	139036
19950	138542	285	839	884	0	140550
19951	3746	132284	540	295	0	136865
19952	2290	135197	342	291	0	138120
19953	134509	2715	265	814	0	138303
19954	135819	1619	203	761	0	138402
19955	3124	138114	269	303	0	141810
19956	2291	2305	163	138116	0	142875
19957	1291	1484	138201	1849	0	142825
19958	133895	903	1932	1645	0	138375
19959	129362	780	1409	2236	0	133787
19960	144419	390	890	1169	0	146868
19961	3361	142605	543	484	0	146993
19962	2149	2121	143702	354	0	148326
19963	147328	1189	2000	757	0	151274
19964	3008	929	1132	149807	0	154876
19965	2154	562	835	149465	0	153016
19966	1652	413	484	154738	0	157287
19967	988	444	153157	3469	0	158058
19968	1198	281	2002	147867	0	151348
19969	669	464	152903	3071	0	157107
19970	342	148133	2433	1800	0	152708
19971	144697	1864	1377	1738	0	149676
19972	1881	146955	958	687	0	150481
19973	1234	150078	596	463	0	152371
19974	148366	2853	450	1030	0	152699
19975	2100	153137	428	283	0	155948
19976	1684	2633	183	149477	0	153977
19977	1096	150512	275	1619	0	153502
19978	148989	2581	154	1562	0	153286
19979	2092	151473	203	739	0	154507
19980	1704	2618	156	152579	0	157057
19981	1055	1712	151228	2059	0	156054
19982	1013	1105	1931	151311	0	155360
19983	516	153176	1270	2956	0	157918
19984	815	2272	878	155988	0	159953
19985	702	1676	507	153146	0	156031
19986	1094	1016	438	147514	0	150062
19987	831	555	366	155694	0	157446
19988	862	532	264	156462	0	158120
19989	778	469	261	158754	0	160262
19990	540	509	155581	4723	0	161353
19991	149098	404	2530	3374	0	155406
19992	3047	447	1481	165424	0	170399
19993	1796	494	164469	3775	0	170534
19994	1327	583	162901	2411	0	167222
19995	1289	448	4538	165986	0	172261
19996	167812	486	2753	4214	0	175265
19997	3459	658	164501	2415	0	171033
19998	159931	478	3745	2517	0	166671
19999	4397	507	170321	1197	0	176422
20000	3194	531	4195	168099	0	176019
20001	2484	645	2346	174129	0	179604
20002	1538	760	172582	4686	0	179566
20003	160635	629	3816	3531	0	168611
20004	4185	576	2267	169853	0	176881
20005	2520	583	170426	4075	0	177604
20006	2060	664	170211	2565	0	175500
20007	2169	585	5018	161307	0	169079
20008	1362	170712	3314	3402	0	178790
20009	172940	3144	2035	2827	0	180946
20010	170055	1937	1469	2333	0	175794
20011	5458	1563	171653	1090	0	179764
20012	4143	986	3845	164040	0	173014
20013	171009	836	2147	4595	0	178587
20014	4606	796	170954	2544	0	178900
20015	163827	433	4137	2754	0	171151
20016	5031	166568	2720	1584	0	175903
20017	3422	3196	1980	171767	0	180365
20018	2762	1796	1323	174591	0	180472
20019	177422	1267	1236	6036	0	185961
20020	4728	916	1200	178386	0	185230
20021	3174	861	940	177049	0	182024
20022	2507	706	800	180263	0	184276
20023	174463	507	863	7666	0	183499
20024	4540	631	173365	4222	0	182758
20025	171232	558	4003	3687	0	179480
20026	174779	474	2446	3096	0	180795
20027	179240	502	1923	2375	0	184040
20028	7584	738	1347	174123	0	183792
20029	4233	792	177548	4590	0	187163
20030	2793	170244	4478	3106	0	180621
20031	2003	174357	2467	2665	0	181492
20032	1321	164967	1209	1525	0	169022
20033	1362	3580	165246	1388	0	171576
20034	1880	2343	3316	183597	0	191136
20035	188758	876	1636	5950	0	197220
20036	204759	601	992	3557	0	209909
20037	7642	487	784	211843	0	220756
20038	3858	484	211023	6250	0	221615
20039	2521	482	211122	3191	0	217316
20040	2455	298	7187	211507	0	221447
20041	1430	446	216515	6456	0	224847
20042	2145	324	7101	214248	0	223818
20043	2170	423	3448	209055	0	215096
20044	1016	212016	2585	8055	0	223672
20045	1967	5413	1725	215824	0	224929
20046	2001	2318	1369	222996	0	228684
20047	216658	1590	1492	10006	0	229746
20048	7089	816	1382	219509	0	228796
20049	4341	611	1191	222188	0	228331
20050	212920	544	1398	10472	0	225334
20051	6526	213094	1729	5563	0	226912
20052	215124	5436	1656	4525	0	226741
20053	7737	2645	211385	2851	0	224618
20054	209201	1646	6495	3339	0	220681
20055	212143	1006	3431	3318	0	219898
20056	9338	915	206282	2352	0	218887
20057	4977	1048	206114	2329	0	214468
20058	4519	1027	8680	196743	0	210969
20059	199781	622	4694	7947	0	213044
20060	7642	648	197759	4254	0	210303
20061	5174	512	7525	195528	0	208739
20062	3305	656	195981	7829	0	207771
20063	3439	593	8175	191688	0	203895
20064	3290	727	4386	196921	0	205324
20065	191775	697	3258	10542	0	206272
20066	189151	714	2644	6735	0	199244
20067	198084	732	2059	5004	0	205879
20068	10528	772	194576	3529	0	209405
20069	5806	704	196153	3274	0	205937
20070	4772	715	9162	191981	0	206630
20071	3904	847	5191	196085	0	206027
20072	3747	765	3648	202033	0	210193
20073	191122	666	2885	11313	0	205986
20074	7684	191152	2695	6433	0	207964
20075	186871	5729	2474	5350	0	200424
20076	185499	2664	2112	4748	0	195023
20077	9616	182334	2179	3685	0	197814
20078	5907	189746	2056	3280	0	200989
20079	186117	7353	2016	3863	0	199349
20080	8265	3679	1941	180924	0	194809
20081	5157	181841	1985	8659	0	197642
20082	5471	6140	1819	184902	0	198332
20083	4390	3257	180688	9179	0	197514
20084	4091	2297	6719	182519	0	195626
20085	180680	1430	4606	10460	0	197176
20086	7856	1320	178195	6190	0	193561
20087	4939	1327	178356	5210	0	189832
20088	4703	3627	9615	163307	0	181252
20089	3462	164594	5906	8308	0	182270
20090	3096	168148	3639	6065	0	180948
20091	2770	175618	2808	5260	0	186456
20092	166978	7427	2308	5134	0	181847
20093	168150	3430	1942	5071	0	178593
20094	162872	2243	1879	4994	0	171988
20095	8969	162603	2076	4853	0	178501
20096	166361	5041	2142	4955	0	178499
20097	165187	2926	2029	4443	0	174585
20098	9604	2768	161082	3348	0	176802
20099	6502	156657	6655	3006	0	172820
20100	5341	5445	4666	158030	0	173482
20101	157584	3178	3608	7273	0	171643
20102	8301	2220	156233	4733	0	171487
20103	5265	1611	7139	150814	0	164829
20104	4150	153847	4762	7750	0	170509
20105	4256	5313	3373	155186	0	168128
20106	4490	2676	2888	157859	0	167913
20107	155743	1937	3186	9837	0	170703
20108	157000	1837	2918	6967	0	168722
20109	9256	1643	2922	155385	0	169206
20110	5734	1853	150871	8485	0	166943
20111	4777	1878	149269	6062	0	161986
20112	149642	1716	7381	5069	0	163808
20113	9256	1676	153634	3567	0	168133
20114	7008	1641	7166	138678	0	154493
20115	5129	144651	5113	6181	0	161074
20116	145143	4878	4510	4621	0	159152
20117	7169	145488	3764	4384	0	160805
20118	147955	5627	2942	5020	0	161544
20119	8142	2913	2757	146438	0	160250
20120	5835	2419	2461	149498	0	160213
20121	146812	2501	2270	8738	0	160321
20122	150808	2085	2197	5520	0	160610
20123	10177	2099	2113	147001	0	161390
20124	6939	2595	1996	148251	0	159781
20125	5198	2516	141939	7786	0	157439
20126	4417	2138	141058	5102	0	152715
20127	137561	1947	6907	4895	0	151310
20128	6916	2415	135787	3839	0	148957
20129	134760	1815	6348	4412	0	147335
20130	139122	1389	4413	4347	0	149271
20131	8588	1460	133681	3865	0	147594
20132	5897	126590	5957	3399	0	141843
20133	4602	131245	4347	2597	0	142791
20134	2228	2773	104917	1327	0	111245
20135	3968	7040	4998	88171	0	104177
20136	82346	1376	3051	3614	0	90387
20137	79708	335	489	1153	0	81685
20138	88685	293	399	1011	0	90388
20139	104441	290	273	1007	0	106011
20140	106171	308	326	950	0	107755
20141	3637	108144	522	510	0	112813
20142	105550	2615	279	809	0	109253
20143	3201	105418	382	397	0	109398
20144	103416	2607	294	508	0	106825
20145	3165	796	100142	177	0	104280
20146	1898	352	2359	96828	0	101437
20147	1600	325	608	94737	0	97270
20148	707	98253	399	2620	0	101979
20149	98383	2611	233	1179	0	102406
20150	100497	993	163	679	0	102332
20151	4005	596	219	96976	0	101796
20152	1964	348	369	99279	0	101960
20153	97989	252	292	3685	0	102218
20154	3341	287	211	98062	0	101901
20155	1616	485	171	99844	0	102116
20156	98512	363	138	3607	0	102620
20157	3681	298	136	98044	0	102159
20158	98000	217	181	3675	0	102073
20159	98966	140	207	1923	0	101236
20160	3650	212	96768	1029	0	101659
20161	96502	200	2337	1534	0	100573
20162	97801	202	638	1284	0	99925
20163	98183	180	370	1089	0	99822
20164	3995	243	92908	821	0	97967
20165	2374	156	2419	91311	0	96260
20166	1829	190	764	94773	0	97556
20167	1190	218	92559	3189	0	97156
20168	89977	196	2686	1400	0	94259
20169	3968	137	794	89365	0	94264
20170	1748	213	88428	2883	0	93272
20171	1284	223	90674	1113	0	93294
20172	1413	182	3152	89350	0	94097
20173	974	225	91329	3218	0	95746
20174	1326	151	3225	89543	0	94245
20175	1492	173	1082	92272	0	95019
20176	1035	231	89960	3738	0	94964
20177	1303	221	3162	85827	0	90513
20178	878	84922	1446	3238	0	90484
20179	701	90913	1021	1622	0	94257
20180	88134	2914	933	1496	0	93477
20181	88793	866	710	1553	0	91922
20182	3537	87886	668	1271	0	93362
20183	87856	2647	752	1348	0	92603
20184	89693	913	597	1214	0	92417
20185	4141	839	490	87261	0	92731
20186	2101	790	456	89794	0	93141
20187	86611	629	404	3955	0	91599
20188	3820	84563	448	1620	0	90451
20189	1896	87158	484	1150	0	90688
20190	2181	3265	421	85758	0	91625
20191	1779	1211	85729	3339	0	92058
20192	82996	737	2811	2035	0	88579
20193	86104	605	964	1805	0	89478
20194	83634	619	600	1557	0	86410
20195	4624	83336	572	978	0	89510
20196	2652	3223	482	81430	0	87787
20197	2162	1161	522	85563	0	89408
20198	83012	833	738	4270	0	88853
20199	4293	82394	659	1970	0	89316
20200	2830	3002	551	81867	0	88250
20201	2703	1211	502	84434	0	88850
20202	2370	1154	481	84808	0	88813
20203	82189	876	492	4937	0	88494
20204	4347	81696	591	2581	0	89215
20205	2878	3561	541	78155	0	85135
20206	2280	81966	659	3656	0	88561
20207	81724	3393	607	2332	0	88056
20208	4350	1312	79676	2190	0	87528
20209	79258	908	2983	2469	0	85618
20210	4402	846	78145	2162	0	85555
20211	2652	1397	2892	75568	0	82509
20212	75862	865	1193	4170	0	82090
20213	4193	934	74048	2180	0	81355
20214	74980	632	2858	2082	0	80552
20215	77602	423	1406	2055	0	81486
20216	78613	378	1015	1941	0	81947
20217	4903	369	1095	74318	0	80685
20218	2771	399	973	75446	0	79589
20219	2522	326	908	76690	0	80446
20220	73211	321	968	4690	0	79190
20221	4304	73654	997	2327	0	81282
20222	74609	2252	938	1758	0	79557
20223	76898	689	1002	1595	0	80184
20224	4486	591	73259	1535	0	79871
20225	74018	453	2789	1781	0	79041
20226	77742	413	1280	1788	0	81223
20227	4507	519	1100	75575	0	81701
20228	2501	648	1052	76568	0	80769
20229	2296	565	942	77252	0	81055
20230	74124	538	1016	3950	0	79628
20231	73754	460	1132	2210	0	77556
20232	70671	367	973	1800	0	73811
20233	3655	65376	971	1558	0	71560
20234	1481	61454	916	1437	0	65288
20235	1126	63414	800	1559	0	66899
20236	62042	2152	1063	1791	0	67048
20237	2700	736	60842	1503	0	65781
20238	1287	484	50390	1125	0	53286
20239	32759	199	1034	537	0	34529
20240	884	112	36887	360	0	38243
20241	206	52	263	29773	0	30294
20242	114	29935	115	262	0	30426
20243	31709	269	64	228	0	32270
20244	31954	72	42	159	0	32227
20245	32087	53	38	134	0	32312
20246	462	30	41	35826	0	36359
20247	145	70	37335	275	0	37825
20248	139	82	36106	82	0	36409
20249	36711	33	313	184	0	37241
20250	38125	37	84	170	0	38416
20251	37534	37	57	137	0	37765
20252	394	35	56	38576	0	39061
20253	224	30	58	38831	0	39143
20254	147	59	38754	312	0	39272
20255	37939	40	258	219	0	38456
20256	379	42	76	40643	0	41140
20257	206	39	51	40385	0	40681
20258	139	31	36	40577	0	40783
20259	93	40726	52	348	0	41219
20260	127	256	55	41034	0	41472
20261	156	59	43	40756	0	41014
20262	40572	36	32	478	0	41118
20263	342	55	40031	135	0	40563
20264	38341	40	266	214	0	38861
20265	41109	37	71	209	0	41426
20266	393	26	50	40860	0	41329
20267	202	48	40	40976	0	41266
20268	40933	30	46	440	0	41449
20269	347	41	40374	121	0	40883
20270	142	40594	262	137	0	41135
20271	135	201	64	40655	0	41055
20272	40486	43	59	339	0	40927
20273	325	25	23	39904	0	40277
20274	132	36	39721	237	0	40126
20275	135	68	39542	115	0	39860
20276	40112	35	203	229	0	40579
20277	292	39	84	42917	0	43332
20278	131	34	42662	208	0	43035
20279	41676	20	174	281	0	42151
20280	45612	18	69	318	0	46017
20281	261	26	42	45830	0	46159
20282	158	21	27	45891	0	46097
20283	67	46076	71	198	0	46412
20284	48118	136	26	268	0	48548
20285	248	33	24	48543	0	48848
20286	145	30	29	49063	0	49267
20287	76	45	50226	198	0	50545
20288	45562	30	158	332	0	46082
20289	49453	13	38	235	0	49739
20290	194	49122	59	70	0	49445
20291	85	140	47989	53	0	48267
20292	88	49	47765	32	0	47934
20293	140	125	116	46965	0	47346
20294	50062	5	93	356	0	50516
20295	156	22	20	50260	0	50458
20296	52382	9	18	341	0	52750
20297	52578	7	16	251	0	52852
20298	52826	12	16	248	0	53102
20299	195	26	9	53193	0	53423
20300	143	12	28	53214	0	53397
20301	54344	9	14	337	0	54704
20302	119	52	55589	36	0	55796
20303	50500	18	66	278	0	50862
20304	52046	4	20	259	0	52329
20305	79	43	54758	17	0	54897
20306	54	70	53310	13	0	53447
20307	25	54390	98	21	0	54534
20308	74	78	36	55381	0	55569
20309	50728	53	92	277	0	51150
20310	88	20	10	55255	0	55373
20311	48	38	56138	52	0	56276
20312	21	54594	68	31	0	54714
20313	23	55330	29	41	0	55423
20314	65	55	19	56878	0	57017
20315	72	28	7	55837	0	55944
20316	12	55408	39	93	0	55552
20317	39	100	54998	20	0	55157
20318	50920	22	80	268	0	51290
20319	56342	5	17	223	0	56587
20320	78	56861	35	44	0	57018
20321	55525	78	13	193	0	55809
20322	142	34	12	54977	0	55165
20323	54761	13	17	296	0	55087
20324	159	5	13	54265	0	54442
20325	32	56767	43	162	0	57004
20326	44	267	56475	39	0	56825
20327	162	54	282	60774	0	61272
20328	318	52	82	58320	0	58772
20329	163	18	28	64778	0	64987
20330	66102	14	30	1130	0	67276
20331	1057	14	21	66175	0	67267
20332	364	86	70531	981	0	71962
20333	217	104	72077	356	0	72754
20334	72945	20	1575	490	0	75030
20335	1413	63	75969	87	0	77532
20336	75266	14	1499	295	0	77074
20337	1838	23	439	81820	0	84120
20338	802	21	234	84244	0	85301
20339	576	30	128	89620	0	90354
20340	501	35	140	87950	0	88626
20341	86338	23	120	3192	0	89673
20342	2262	72	86982	1005	0	90321
20343	1151	30	2171	83881	0	87233
20344	427	88336	750	2133	0	91646
20345	88597	2112	289	1088	0	92086
20346	2567	571	236	85321	0	88695
20347	84507	236	189	2807	0	87739
20348	2668	175	83445	952	0	87240
20349	1275	93	2366	78794	0	82528
20350	518	82664	760	2304	0	86246
20351	83487	2226	367	1196	0	87276
20352	2604	674	82827	705	0	86810
20353	1312	331	2396	80597	0	84636
20354	927	160	799	84626	0	86512
20355	82080	172	492	3354	0	86098
20356	2673	196	81365	1258	0	85492
20357	978	247	82370	868	0	84463
20358	1107	177	3009	81122	0	85415
20359	590	164	81725	2739	0	85218
20360	516	162	82500	1281	0	84459
20361	874	190	3250	79537	0	83851
20362	972	124	1266	82478	0	84840
20363	764	149	869	85799	0	87581
20364	82519	179	630	3992	0	87320
20365	2702	83283	663	1646	0	88294
20366	84598	2383	659	1310	0	88950
20367	3321	711	620	83188	0	87840
20368	1201	83538	629	3209	0	88577
20369	1140	2416	525	86964	0	91045
20370	87513	746	616	3940	0	92815
20371	3005	90691	666	1723	0	96085
20372	1629	2868	517	94054	0	99068
20373	983	988	93813	3730	0	99514
20374	92540	583	3279	2103	0	98505
20375	3739	458	1195	93224	0	98616
20376	1822	460	814	95570	0	98666
20377	1276	399	91679	4629	0	97983
20378	985	473	92222	2264	0	95944
20379	87882	472	4001	1969	0	94324
20380	3603	87653	1801	1431	0	94488
20381	1894	3054	1120	88645	0	94713
20382	88867	1195	956	4176	0	95194
20383	3787	719	88547	2082	0	95135
20384	1644	87003	3661	1661	0	93969
20385	1515	3235	1597	87339	0	93686
20386	87010	1138	1183	4537	0	93868
20387	85529	724	1067	2573	0	89893
20388	88537	524	1009	2045	0	92115
20389	4515	85056	1046	1860	0	92477
20390	2132	3173	85508	1616	0	92429
20391	1782	1283	3626	86414	0	93105
20392	2166	958	1921	79384	0	84429
20393	1585	664	1247	89192	0	92688
20394	1388	698	1078	89503	0	92667
20395	85481	650	979	5657	0	92767
20396	85773	612	984	2924	0	90293
20397	4795	668	82202	2174	0	89839
20398	2282	671	82424	2022	0	87399
20399	80295	515	4328	2099	0	87237
20400	83500	634	1977	1858	0	87969
20401	5062	658	1460	78502	0	85682
20402	2488	79650	1200	4329	0	87667
20403	79700	3342	1112	2598	0	86752
20404	4152	77443	1208	2163	0	84966
20405	2155	79849	1057	2082	0	85143
20406	1973	4031	978	81013	0	87995
20407	1819	1561	950	83934	0	88264
20408	1705	1062	1108	84299	0	88174
20409	1718	910	1112	84654	0	88394
20410	1559	878	79501	5476	0	87414
20411	78319	830	3718	2928	0	85795
20412	82254	865	1727	2293	0	87139
20413	4967	829	1194	78997	0	85987
20414	2697	790	1022	81275	0	85784
20415	79091	853	945	5404	0	86293
20416	4401	966	73420	2902	0	81689
20417	78270	755	3375	2330	0	84730
20418	80521	799	1701	2120	0	85141
20419	5129	807	76106	1975	0	84017
20420	79559	659	3578	2146	0	85942
20421	4835	627	1763	79921	0	87146
20422	2674	578	1317	82186	0	86755
20423	2228	569	1200	82701	0	86698
20424	2205	584	1109	82726	0	86624
20425	76612	632	963	5383	0	83590
20426	4586	544	984	75724	0	81838
20427	2103	473	845	70280	0	73701
20428	1608	63031	847	4425	0	69911
20429	1368	66605	818	2506	0	71297
20430	1601	2522	739	65215	0	70077
20431	64641	990	578	3534	0	69743
20432	3423	768	467	59411	0	64069
20433	1399	507	53840	2832	0	58578
20434	1145	456	50481	1499	0	53581
20435	49694	428	2107	1437	0	53666
20436	2313	50713	972	1226	0	55224
20437	44796	1299	786	959	0	47840
20438	1958	510	45113	708	0	48289
20439	1342	1564	1227	40024	0	44157
20440	40125	255	602	1289	0	42271
20441	1197	39907	409	667	0	42180
20442	39076	809	390	633	0	40908
20443	1277	332	43446	489	0	45544
20444	738	276	852	42734	0	44600
20445	557	213	430	44293	0	45493
20446	45168	202	360	1334	0	47064
20447	45161	205	288	708	0	46362
20448	47439	200	224	727	0	48590
20449	47362	233	151	629	0	48375
20450	47836	206	144	604	0	48790
20451	1296	47773	190	568	0	49827
20452	799	711	161	49208	0	50879
20453	50481	314	157	1212	0	52164
20454	1191	256	143	50342	0	51932
20455	802	163	148	50409	0	51522
20456	696	145	136	50819	0	51796
20457	474	49388	198	1240	0	51300
20458	50140	718	144	845	0	51847
20459	968	281	173	50346	0	51768
20460	49388	184	182	1251	0	51005
20461	48986	129	131	805	0	50051
20462	1140	47981	159	538	0	49818
20463	48349	609	129	539	0	49626
20464	1153	253	47003	319	0	48728
20465	46105	189	702	402	0	47398
20466	1034	309	491	46876	0	48710
20467	544	137	48484	686	0	49851
20468	463	48272	577	498	0	49810
20469	554	534	48241	354	0	49683
20470	210	45236	418	178	0	46042
20471	42121	495	560	488	0	43664
20472	41781	86	52	317	0	42236
20473	41559	23	33	268	0	41883
20474	180	41719	38	62	0	41999
20475	41142	99	14	239	0	41494
20476	165	74	40834	20	0	41093
20477	101	78	40768	27	0	40974
20478	177	96	105	40652	0	41030
20479	98	16	37	43698	0	43849
20480	33	43605	41	164	0	43843
20481	44164	133	19	207	0	44523
20482	207	54	8	44824	0	45093
20483	51	44807	37	182	0	45077
20484	81	179	29	46296	0	46585
20485	46137	48	25	465	0	46675
20486	44944	36	13	394	0	45387
20487	256	76	43681	52	0	44065
20488	212	36	184	44119	0	44551
20489	80	70	44418	199	0	44767
20490	148	16	196	44655	0	45015
20491	43	74	45251	234	0	45602
20492	149	17	246	44744	0	45156
20493	54	52	45353	271	0	45730
20494	143	25	262	44856	0	45286
20495	47	65	46333	306	0	46751
20496	195	23	277	45483	0	45978
20497	133	16	119	47194	0	47462
20498	43	48666	121	370	0	49200
20499	111	245	59	50455	0	50870
20500	38	128	49450	350	0	49966
20501	203	53	312	48594	0	49162
20502	114	28	129	49292	0	49563
20503	49289	18	92	730	0	50129
20504	372	46	56	49944	0	50418
20505	207	26	51	49502	0	49786
20506	78	78	48065	427	0	48648
20507	46357	17	324	510	0	47208
20508	365	23	126	49703	0	50217
20509	204	27	89	49608	0	49928
20510	146	24	59	50239	0	50468
20511	49875	19	62	796	0	50752
20512	387	27	56	50499	0	50969
20513	201	20	57	50587	0	50865
20514	49863	13	69	891	0	50836
20515	356	50351	83	272	0	51062
20516	220	299	38	50076	0	50633
20517	175	99	47	50420	0	50741
20518	72	113	49378	548	0	50111
20519	41265	68	402	667	0	42402
20520	459	36	135	48459	0	49089
20521	151	67	47216	468	0	47902
20522	46467	27	332	519	0	47345
20523	449	41	114	49322	0	49926
20524	265	25	89	50188	0	50567
20525	199	24	65	50869	0	51157
20526	211	30	65	51459	0	51765
20527	110	79	54660	746	0	55595
20528	249	34	618	54609	0	55510
20529	378	34	205	68111	0	68728
20530	134	79	78299	1779	0	80291
20531	79281	26	2104	1100	0	82511
20532	83921	27	908	1015	0	85871
20533	85264	33	692	672	0	86661
20534	4067	31	491	82845	0	87434
20535	84663	31	289	2764	0	87747
20536	86303	32	162	1453	0	87950
20537	4338	38	184	84619	0	89179
20538	84012	31	132	3358	0	87533
20539	84566	33	118	1813	0	86530
20540	84632	36	132	1457	0	86257
20541	85731	25	140	1171	0	87067
20542	4868	30	113	80986	0	85997
20543	2657	76272	210	2560	0	81699
20544	1915	77521	296	1254	0	80986
20545	1455	79554	238	974	0	82221
20546	75488	3672	124	1068	0	80352
20547	78809	1941	101	863	0	81714
20548	3886	1385	75134	577	0	80982
20549	76993	841	2412	772	0	81018
20550	4502	541	1021	76853	0	82917
20551	2760	343	755	77386	0	81244
20552	2225	248	557	79019	0	82049
20553	76146	163	343	4516	0	81168
20554	3762	148	178	76143	0	80231
20555	1807	73851	286	4115	0	80059
20556	1754	2462	140	76426	0	80782
20557	1113	1245	76021	3919	0	82298
20558	1168	1034	2464	77429	0	82095
20559	76580	819	1075	4139	0	82613
20560	3470	546	76799	2002	0	82817
20561	2290	285	2965	76990	0	82530
20562	2045	291	1424	76524	0	80284
20563	1673	226	1007	78168	0	81074
20564	1011	76713	741	4591	0	83056
20565	1137	2491	389	79260	0	83277
20566	77334	1060	292	4805	0	83491
20567	77383	804	300	2785	0	81272
20568	4184	684	74107	1920	0	80895
20569	2415	563	75666	1471	0	80115
20570	2200	367	3423	74504	0	80494
20571	1813	310	1802	77534	0	81459
20572	1056	287	76818	4337	0	82498
20573	1332	346	3340	72125	0	77143
20574	902	74803	1640	3859	0	81204
20575	76884	2707	1238	2529	0	83358
20576	77967	1156	890	2084	0	82097
20577	78205	917	575	1760	0	81457
20578	4864	764	75533	1267	0	82428
20579	3206	538	2869	75879	0	82492
20580	2394	341	75553	3511	0	81799
20581	73697	304	3386	2053	0	79440
20582	3711	73944	1855	1707	0	81217
20583	2112	2577	1350	74234	0	80273
20584	74321	1128	945	3781	0	80175
20585	3856	957	694	74398	0	79905
20586	2221	752	645	77198	0	80816
20587	1746	567	73569	4663	0	80545
20588	71152	474	2843	2987	0	77456
20589	3897	73062	1439	2118	0	80516
20590	2565	2525	1130	74708	0	80928
20591	74589	1113	900	3825	0	80427
20592	4151	943	711	74784	0	80589
20593	73958	762	593	4435	0	79748
20594	4169	73769	636	2553	0	81127
20595	75579	2813	426	2193	0	81011
20596	4721	1438	74118	1568	0	81845
20597	75556	1107	2840	1544	0	81047
20598	76222	796	1474	1383	0	79875
20599	77063	585	1324	1417	0	80389
20600	5709	553	999	72785	0	80046
20601	3857	642	757	71113	0	76369
20602	3082	605	609	73713	0	78009
20603	2259	70834	561	4873	0	78527
20604	72642	2867	396	3329	0	79234
20605	4291	1303	474	72810	0	78878
20606	2745	1063	491	74412	0	78711
20607	2377	847	492	75030	0	78746
20608	72088	683	524	5398	0	78693
20609	4185	546	504	73533	0	78768
20610	2390	573	69948	5078	0	77989
20611	2009	70512	2749	3171	0	78441
20612	1903	2965	1206	72399	0	78473
20613	1644	1573	962	74467	0	78646
20614	1402	1232	878	75868	0	79380
20615	1294	887	71205	5514	0	78900
20616	1294	642	72163	3592	0	77691
20617	1268	522	3877	73534	0	79201
20618	1222	563	76154	4508	0	82447
20619	1290	372	3729	78008	0	83399
20620	76783	391	1867	5444	0	84485
20621	80630	411	1355	3624	0	86020
20622	81406	429	1057	2824	0	85716
20623	5116	525	77001	2047	0	84689
20624	76865	545	3002	1774	0	82186
20625	5175	672	1659	77760	0	85266
20626	2793	388	76988	3730	0	83899
20627	2216	291	74847	2344	0	79698
20628	1665	71967	3882	2271	0	79785
20629	1041	61596	1509	1211	0	65357
20630	49263	1167	1809	693	0	52932
20631	1139	311	274	47553	0	49277
20632	398	197	48533	915	0	50043
20633	408	117	673	48450	0	49648
20634	48902	77	288	1129	0	50396
20635	819	124	52205	428	0	53576
20636	51495	88	823	593	0	52999
20637	55297	89	316	504	0	56206
20638	55161	77	203	520	0	55961
20639	1168	54171	232	291	0	55862
20640	56596	798	155	438	0	57987
20641	1232	281	176	57086	0	58775
20642	728	195	189	56369	0	57481
20643	610	102	129	57593	0	58434
20644	483	112	160	57316	0	58071
20645	56066	73	157	1484	0	57780
20646	1019	54753	193	657	0	56622
20647	424	52697	163	341	0	53625
20648	306	55515	131	307	0	56259
20649	55605	892	245	489	0	57231
20650	56049	298	124	463	0	56934
20651	55588	171	125	437	0	56321
20652	55421	122	130	375	0	56048
20653	1226	125	104	55626	0	57081
20654	592	103	92	55650	0	56437
20655	55573	102	131	1197	0	57003
20656	852	55391	140	485	0	56868
20657	54372	707	91	477	0	55647
20658	55380	248	99	453	0	56180
20659	1162	159	88	55224	0	56633
20660	465	55364	131	864	0	56824
20661	463	742	117	56780	0	58102
20662	56078	246	92	1158	0	57574
20663	1008	239	57242	399	0	58888
20664	604	218	750	55094	0	56666
20665	357	57132	260	824	0	58573
20666	57144	724	184	619	0	58671
20667	55834	261	110	570	0	56775
20668	1086	231	57317	269	0	58903
20669	524	56392	768	234	0	57918
20670	371	812	57849	236	0	59268
20671	536	377	760	55205	0	56878
20672	263	194	56277	794	0	57528
20673	268	177	55102	328	0	55875
20674	232	55598	836	221	0	56887
20675	55200	655	330	406	0	56591
20676	56067	247	217	492	0	57023
20677	859	57835	208	199	0	59101
20678	407	58157	151	201	0	58916
20679	372	883	55277	164	0	56696
20680	334	407	53378	176	0	54295
20681	277	267	56342	159	0	57045
20682	349	175	913	56584	0	58021
20683	262	186	58010	730	0	59188
20684	384	138	803	55644	0	56969
20685	476	159	328	54321	0	55284
20686	262	185	57743	879	0	59069
20687	255	57168	774	418	0	58615
20688	325	755	288	57670	0	59038
20689	57783	264	211	979	0	59237
20690	967	198	151	57621	0	58937
20691	415	211	58250	841	0	59717
20692	325	57484	773	397	0	58979
20693	258	60826	344	330	0	61758
20694	337	950	238	59709	0	61234
20695	58914	360	185	1192	0	60651
20696	58992	226	182	607	0	60007
20697	1173	184	179	58262	0	59798
20698	482	60640	171	891	0	62184
20699	510	1003	140	61516	0	63169
20700	539	331	133	63131	0	64134
20701	518	260	151	63427	0	64356
20702	66843	206	140	1683	0	68872
20703	1395	67539	183	602	0	69719
20704	68075	1339	152	752	0	70318
20705	69272	477	176	656	0	70581
20706	69205	333	138	618	0	70294
20707	71575	272	129	511	0	72487
20708	2246	271	127	69646	0	72290
20709	870	279	69962	1537	0	72648
20710	535	69945	1401	772	0	72653
20711	71005	1443	488	820	0	73756
20712	72258	543	284	677	0	73762
20713	73422	330	205	672	0	74629
20714	2239	309	70955	280	0	73783
20715	69597	232	1498	517	0	71844
20716	72440	235	472	434	0	73581
20717	2467	265	291	71247	0	74270
20718	1005	293	67866	1543	0	70707
20719	660	66764	1548	596	0	69568
20720	790	1519	534	66844	0	69687
20721	66029	482	353	1828	0	68692
20722	1869	278	223	65700	0	68070
20723	967	239	257	67862	0	69325
20724	69201	258	216	2201	0	71876
20725	1937	267	67559	723	0	70486
20726	67378	179	1568	782	0	69907
20727	68250	178	563	671	0	69662
20728	68118	150	407	646	0	69321
20729	68263	180	280	589	0	69312
20730	2435	170	65848	311	0	68764
20731	1253	188	1643	64850	0	67934
20732	658	207	66016	1670	0	68551
20733	799	259	1737	64373	0	67168
20734	493	190	65357	1893	0	67933
20735	57951	100	1700	1006	0	60757
20736	1822	58276	700	499	0	61297
20737	766	60884	345	333	0	62328
20738	907	1773	281	63709	0	66670
20739	816	596	264	66337	0	68013
20740	491	68316	285	2271	0	71363
20741	68913	2036	161	1107	0	72217
20742	73272	649	175	764	0	74860
20743	76302	331	189	615	0	77437
20744	80121	213	254	529	0	81117
20745	3841	174	209	77696	0	81920
20746	1855	176	210	81080	0	83321
20747	80910	153	198	3621	0	84882
20748	3287	181	217	79933	0	83618
20749	1412	248	77409	3091	0	82160
20750	929	300	78467	1256	0	80952
20751	1068	240	3264	78632	0	83204
20752	671	212	79314	2951	0	83148
20753	77402	152	2982	1473	0	82009
20754	3296	187	1120	78402	0	83005
20755	79290	156	687	3219	0	83352
20756	3427	187	78973	1286	0	83873
20757	1954	148	2682	78121	0	82905
20758	1082	184	79420	2975	0	83661
20759	738	78314	3110	1423	0	83585
20760	77344	2631	1275	1309	0	82559
20761	79178	923	735	1010	0	81846
20762	3762	77389	529	767	0	82447
20763	77093	2654	486	831	0	81064
20764	3898	949	467	75282	0	80596
20765	2005	528	421	77704	0	80658
20766	75386	349	453	3951	0	80139
20767	3371	73496	443	1675	0	78985
20768	1677	75872	390	1079	0	79018
20769	1583	3369	360	73980	0	79292
20770	72894	1323	463	3210	0	77890
20771	74886	741	417	1667	0	77711
20772	75458	473	474	1086	0	77491
20773	4543	529	71455	711	0	77238
20774	2285	453	71828	730	0	75296
20775	1541	71014	3494	706	0	76755
20776	70980	2864	1373	835	0	76052
20777	3868	1167	804	68553	0	74392
20778	69839	676	556	3276	0	74347
20779	71360	523	512	1622	0	74017
20780	4807	401	496	68319	0	74023
20781	2372	487	68358	3209	0	74426
20782	68747	448	2844	1711	0	73750
20783	4051	328	1236	68582	0	74197
20784	2099	365	68408	3329	0	74201
20785	67936	325	2963	1825	0	73049
20786	70384	278	1336	1374	0	73372
20787	4493	313	988	67741	0	73535
20788	2180	347	67344	3422	0	73293
20789	1788	426	3013	65289	0	70516
20790	1421	66791	1475	3406	0	73093
20791	1483	2637	66872	1690	0	72682
20792	1451	67625	3073	1165	0	73314
20793	66275	2882	1438	1008	0	71603
20794	68190	1134	975	1090	0	71389
20795	68380	647	903	1036	0	70966
20796	68562	489	724	1020	0	70795
20797	4963	496	652	64517	0	70628
20798	63780	433	710	3142	0	68065
20799	4143	415	631	62116	0	67305
20800	60253	319	589	3366	0	64527
20801	3536	58376	583	1758	0	64253
20802	1927	2205	526	53421	0	58079
20803	1286	54678	489	2503	0	58956
20804	54675	2366	464	1432	0	58937
20805	55329	1089	460	1075	0	57953
20806	3326	53331	457	859	0	57973
20807	1993	2171	409	51960	0	56533
20808	1339	943	51349	2426	0	56057
20809	1326	714	2060	51098	0	55198
20810	1207	531	50907	2490	0	55135
20811	1283	565	2259	46829	0	50936
20812	988	48899	1050	2310	0	53247
20813	48747	1921	689	1293	0	52650
20814	50075	842	490	975	0	52382
20815	3193	600	401	48499	0	52693
20816	50836	413	437	2461	0	54147
20817	2949	414	414	50341	0	54118
20818	1742	453	364	51517	0	54076
20819	1337	407	401	52387	0	54532
20820	50883	383	359	3223	0	54848
20821	52023	347	338	1726	0	54434
20822	52266	307	408	1180	0	54161
20823	3176	48508	411	868	0	52963
20824	47579	1674	409	846	0	50508
20825	2554	46465	420	635	0	50074
20826	47336	1964	317	722	0	50339
20827	2691	831	342	46151	0	50015
20828	1628	518	302	47698	0	50146
20829	46577	442	283	2482	0	49784
20830	47283	371	251	1376	0	49281
20831	2760	45485	286	959	0	49490
20832	46146	1662	243	851	0	48902
20833	2645	705	200	44577	0	48127
20834	1594	514	175	45779	0	48062
20835	44854	335	199	2491	0	47879
20836	2410	327	43637	1242	0	47616
20837	1384	42094	1408	891	0	45777
20838	1210	1389	526	37448	0	40573
20839	701	479	34296	1128	0	36604
20840	753	1185	858	31315	0	34111
20841	31467	213	469	1262	0	33411
20842	1019	28279	286	661	0	30245
20843	488	25295	224	427	0	26434
20844	310	23120	115	232	0	23777
20845	656	789	376	21344	0	23165
20846	21185	168	585	541	0	22479
20847	423	101	34	20829	0	21387
20848	20739	57	34	424	0	21254
20849	20830	56	33	260	0	21179
20850	451	61	32	20702	0	21246
20851	20802	36	49	422	0	21309
20852	398	60	31	21049	0	21538
20853	179	64	21151	355	0	21749
20854	20823	48	273	251	0	21395
20855	362	51	23205	135	0	23753
20856	21746	52	293	192	0	22283
20857	370	73	22498	82	0	23023
20858	195	34	226	21274	0	21729
20859	137	47	70	21796	0	22050
20860	22162	28	35	385	0	22610
20861	328	43	23	22949	0	23343
20862	23088	22	17	393	0	23520
20863	326	23093	15	128	0	23562
20864	23991	234	19	214	0	24458
20865	360	80	15	24726	0	25181
20866	187	47	35	24892	0	25161
20867	160	33	20	25050	0	25263
20868	112	28	60	24947	0	25147
20869	92	38	24614	370	0	25114
20870	88	45	24101	148	0	24382
20871	113	65	289	24535	0	25002
20872	68	51	25040	309	0	25468
20873	82	25113	312	125	0	25632
20874	106	289	97	25199	0	25691
20875	102	90	25898	333	0	26423
20876	94	89	25651	152	0	25986
20877	148	101	341	26757	0	27347
20878	166	28	116	27002	0	27312
20879	59	27534	83	429	0	28105
20880	132	347	37	28107	0	28623
20881	63	111	28344	433	0	28951
20882	27643	77	405	250	0	28375
20883	478	35	137	29123	0	29773
20884	29266	39	91	623	0	30019
20885	29506	35	68	299	0	29908
20886	30220	31	67	301	0	30619
20887	539	66	30377	148	0	31130
20888	205	56	30102	118	0	30481
20889	28430	47	503	237	0	29217
20890	473	54	30966	115	0	31608
20891	282	35	453	29225	0	29995
20892	227	44	136	30070	0	30477
20893	126	71	30412	533	0	31142
20894	97	30221	469	237	0	31024
20895	29963	406	160	270	0	30799
20896	454	30338	130	156	0	31078
20897	187	31513	97	163	0	31960
20898	31175	475	101	252	0	32003
20899	504	163	32434	104	0	33205
20900	210	128	32736	104	0	33178
20901	242	57	610	31986	0	32895
20902	32680	57	225	622	0	33584
20903	504	33130	175	203	0	34012
20904	33149	494	131	276	0	34050
20905	586	175	33826	141	0	34728
20906	193	36129	580	147	0	37049
20907	261	605	187	37024	0	38077
20908	142	199	37705	668	0	38714
20909	267	138	678	37451	0	38534
20910	521	175	298	32613	0	33607
20911	247	86	188	38286	0	38807
20912	244	78	140	38417	0	38879
20913	37556	52	142	999	0	38749
20914	37267	70	127	473	0	37937
20915	851	74	37696	244	0	38865
20916	35446	58	694	290	0	36488
20917	761	36310	282	181	0	37534
20918	36285	598	193	290	0	37366
20919	767	194	36657	135	0	37753
20920	369	168	652	35630	0	36819
20921	203	99	36618	700	0	37620
20922	162	83	36501	280	0	37026
20923	258	122	855	35381	0	36616
20924	262	58	292	36201	0	36813
20925	140	81	36191	834	0	37246
20926	146	35235	733	347	0	36461
20927	171	36173	232	241	0	36817
20928	241	761	199	36112	0	37313
20929	35403	226	204	874	0	36707
20930	652	37335	197	290	0	38474
20931	244	698	37343	221	0	38506
20932	205	216	36420	190	0	37031
20933	164	177	37498	188	0	38027
20934	253	120	896	35841	0	37110
20935	36854	102	337	877	0	38170
20936	699	36579	282	383	0	37943
20937	251	704	36567	232	0	37754
20938	182	36483	818	206	0	37689
20939	247	721	277	36685	0	37930
20940	150	244	37090	746	0	38230
20941	151	37172	778	319	0	38420
20942	240	704	284	36632	0	37860
20943	228	240	246	37944	0	38658
20944	161	218	38519	822	0	39720
20945	281	130	788	36870	0	38069
20946	153	38069	340	798	0	39360
20947	155	715	38119	313	0	39302
20948	37077	210	821	325	0	38433
20949	813	212	288	38155	0	39468
20950	330	147	290	37877	0	38644
20951	229	38261	245	831	0	39566
20952	37697	740	190	435	0	39062
20953	758	249	37166	254	0	38427
20954	36023	201	787	310	0	37321
20955	775	172	268	35841	0	37056
20956	224	36338	252	668	0	37482
20957	234	635	209	36489	0	37567
20958	212	198	156	37779	0	38345
20959	36967	203	170	965	0	38305
20960	37535	113	190	452	0	38290
20961	851	113	151	37613	0	38728
20962	279	149	37155	772	0	38355
20963	34263	122	729	462	0	35576
20964	689	36975	270	267	0	38201
20965	339	671	219	36730	0	37959
20966	303	219	171	37777	0	38470
20967	275	185	159	38019	0	38638
20968	129	170	37383	974	0	38656
20969	238	130	741	36228	0	37337
20970	133	37389	324	877	0	38723
20971	218	683	252	36572	0	37725
20972	142	37284	194	853	0	38473
20973	266	769	129	37028	0	38192
20974	139	274	36642	891	0	37946
20975	33449	186	727	452	0	34814
20976	792	191	258	36349	0	37590
20977	226	155	36728	699	0	37808
20978	156	36643	678	315	0	37792
20979	36210	593	252	459	0	37514
20980	573	209	36197	281	0	37260
20981	34814	208	716	354	0	36092
20982	680	116	258	36286	0	37340
20983	261	122	186	36161	0	36730
20984	156	36201	176	635	0	37168
20985	36070	521	146	419	0	37156
20986	35407	197	104	356	0	36064
20987	584	37295	135	211	0	38225
20988	334	540	114	37930	0	38918
20989	258	185	107	38148	0	38698
20990	194	155	127	37868	0	38344
20991	117	148	37099	745	0	38109
20992	35885	112	531	456	0	36984
20993	599	111	214	37505	0	38429
20994	268	127	171	37906	0	38472
20995	188	137	37192	695	0	38212
20996	130	111	36535	357	0	37133
20997	202	162	615	37922	0	38901
20998	167	134	39030	651	0	39982
20999	36887	77	646	398	0	38008
21000	603	106	209	38397	0	39315
21001	316	84	170	39024	0	39594
21002	169	91	40792	687	0	41739
21003	216	127	511	41303	0	42157
21004	99	91	42625	676	0	43491
21005	101	41902	605	295	0	42903
21006	38767	485	297	464	0	40013
21007	38609	97	148	289	0	39143
21008	420	38806	114	139	0	39479
21009	225	374	82	39587	0	40268
21010	119	135	40270	452	0	40976
21011	173	95	396	39848	0	40512
21012	39958	47	148	586	0	40739
21013	391	40417	116	229	0	41153
21014	40675	374	80	302	0	41431
21015	506	151	80	40586	0	41323
21016	40616	94	87	585	0	41382
21017	430	40631	89	220	0	41370
21018	40688	392	90	318	0	41488
21019	463	175	39972	136	0	40746
21020	206	40667	385	136	0	41394
21021	218	352	126	40937	0	41633
21022	42886	131	142	569	0	43728
21023	43402	101	79	314	0	43896
21024	557	70	63	43543	0	44233
21025	44059	50	63	633	0	44805
21026	43622	76	62	347	0	44107
21027	44601	77	76	307	0	45061
21028	655	48	59	44413	0	45175
21029	266	90	44162	467	0	44985
21030	241	108	41094	196	0	41639
21031	161	107	42549	187	0	43004
21032	42989	49	530	237	0	43805
21033	557	63	208	43839	0	44667
21034	204	44644	138	513	0	45499
21035	301	392	76	44340	0	45109
21036	185	45394	99	458	0	46136
21037	46322	470	86	378	0	47256
21038	577	147	95	47097	0	47916
21039	334	113	107	48251	0	48805
21040	48987	73	93	799	0	49952
21041	676	77	75	49340	0	50168
21042	329	65	89	50367	0	50850
21043	51285	81	108	929	0	52403
21044	715	98	51856	321	0	52990
21045	407	70	669	51622	0	52768
21046	245	88	52053	757	0	53143
21047	50830	66	718	443	0	52057
21048	849	68	191	52657	0	53765
21049	52639	63	144	988	0	53834
21050	947	76	99	53404	0	54526
21051	345	82	55310	887	0	56624
21052	417	61	718	55818	0	57014
21053	56822	50	279	1147	0	58298
21054	804	58282	239	373	0	59698
21055	309	761	57972	295	0	59337
21056	54727	177	767	482	0	56153
21057	882	57978	268	238	0	59366
21058	313	58680	197	270	0	59460
21059	221	63746	140	232	0	64339
21060	453	1067	126	68814	0	70460
21061	69945	310	134	1452	0	71841
21062	72147	165	130	596	0	73038
21063	1598	167	71006	286	0	73057
21064	69410	106	1235	462	0	71213
21065	1499	70361	371	223	0	72454
21066	745	1232	191	71521	0	73689
21067	74519	302	150	1667	0	76638
21068	75502	219	108	721	0	76550
21069	75934	172	221	563	0	76890
21070	75078	146	206	497	0	75927
21071	76112	171	194	363	0	76840
21072	2071	212	105	74712	0	77100
21073	691	290	74640	1442	0	77063
21074	882	183	1238	74905	0	77208
21075	833	170	284	76646	0	77933
21076	75676	119	214	1832	0	77841
21077	1762	73329	216	670	0	75977
21078	74240	1308	169	688	0	76405
21079	75314	359	236	619	0	76528
21080	77628	247	232	751	0	78858
21081	79452	177	209	728	0	80566
21082	2191	222	76869	411	0	79693
21083	77047	231	1300	650	0	79228
21084	79762	211	347	571	0	80891
21085	70166	316	378	1114	0	71974
21086	79969	151	213	529	0	80862
21087	2508	155	199	76599	0	79461
21088	1173	176	74969	1570	0	77888
21089	73598	139	1405	857	0	75999
21090	2058	75721	480	524	0	78783
21091	1288	1293	329	74264	0	77174
21092	1070	76748	293	1387	0	79498
21093	1158	1406	204	78386	0	81154
21094	78984	406	239	1910	0	81539
21095	79249	298	268	845	0	80660
21096	79324	291	339	720	0	80674
21097	2421	308	74287	474	0	77490
21098	74267	276	1372	624	0	76539
21099	2296	284	73218	458	0	76256
21100	1310	317	72666	445	0	74738
21101	1112	249	75013	462	0	76836
21102	1451	355	1723	69721	0	73250
21103	1151	178	673	72692	0	74694
21104	1100	232	463	72259	0	74054
21105	1047	247	378	71980	0	73652
21106	1179	300	411	68838	0	70728
21107	963	208	421	71691	0	73283
21108	851	72431	370	1810	0	75462
21109	71174	1368	316	1051	0	73909
21110	1843	72802	315	769	0	75729
21111	1120	1457	310	73619	0	76506
21112	1043	431	311	75169	0	76954
21113	73860	304	381	2177	0	76722
21114	1946	73593	393	910	0	76842
21115	74712	1449	390	930	0	77481
21116	2159	515	371	74575	0	77620
21117	1296	410	365	74897	0	76968
21118	1047	380	343	75557	0	77327
21119	936	332	74125	2100	0	77493
21120	1079	370	1425	73468	0	76342
21121	939	392	72606	2029	0	75966
21122	939	379	69278	992	0	71588
21123	1028	341	74270	828	0	76467
21124	1080	310	1699	73937	0	77026
21125	1042	278	706	76947	0	78973
21126	967	310	465	78466	0	80208
21127	77818	319	422	2488	0	81047
21128	2212	350	438	80441	0	83441
21129	81713	300	502	2477	0	84992
21130	2336	81849	463	1201	0	85849
21131	86413	1636	395	1350	0	89794
21132	90372	459	390	1449	0	92670
21133	2593	92769	450	999	0	96811
21134	92315	1797	355	1430	0	95897
21135	93105	522	382	1221	0	95230
21136	94560	392	444	1133	0	96529
21137	94737	311	467	947	0	96462
21138	3174	370	91797	644	0	95985
21139	1542	90745	1918	717	0	94922
21140	1637	1875	663	89162	0	93337
21141	89785	519	577	2472	0	93353
21142	2541	418	89787	1000	0	93746
21143	1228	87869	1849	905	0	91851
21144	1384	1630	527	84715	0	88256
21145	1071	87958	449	1896	0	91374
21146	1228	1988	337	87827	0	91380
21147	1265	763	308	88675	0	91011
21148	1132	580	88221	2235	0	92168
21149	1128	531	85999	880	0	88538
21150	81174	417	1979	1072	0	84642
21151	2330	461	86767	585	0	90143
21152	1159	449	86082	570	0	88260
21153	1342	447	1992	83649	0	87430
21154	1141	324	819	83957	0	86241
21155	847	83553	834	2102	0	87336
21156	791	90938	722	1008	0	93459
21157	734	2055	91065	813	0	94667
21158	1245	1095	2347	91664	0	96351
21159	501	473	91262	2219	0	94455
21160	345	288	82509	705	0	83847
21161	242	82488	1972	516	0	85218
21162	679	1556	685	80192	0	83112
21163	80637	420	531	1698	0	83286
21164	1743	302	336	81073	0	83454
21165	81346	183	322	1976	0	83827
21166	81367	167	274	899	0	82707
21167	80762	154	247	798	0	81961
21168	2019	244	79210	349	0	81822
21169	78766	203	1519	493	0	80981
21170	2053	220	527	80970	0	83770
21171	81628	148	448	1940	0	84164
21172	82126	181	327	923	0	83557
21173	1913	80969	340	460	0	83682
21174	81056	1478	241	633	0	83408
21175	1860	513	81579	271	0	84223
21176	78581	340	1516	587	0	81024
21177	80196	213	495	669	0	81573
21178	1956	81463	414	301	0	84134
21179	81634	1450	282	478	0	83844
21180	2152	480	234	77421	0	80287
21181	1044	330	282	76885	0	78541
21182	648	76602	319	1695	0	79264
21183	815	1441	220	77946	0	80422
21184	733	476	266	79067	0	80542
21185	545	442	77331	1915	0	80233
21186	570	467	75516	768	0	77321
21187	73582	207	1799	895	0	76483
21188	77468	212	696	696	0	79072
21189	2287	245	503	77162	0	80197
21190	1035	232	77600	1697	0	80564
21191	816	77071	1691	600	0	80178
21192	846	1576	604	76408	0	79434
21193	581	528	77468	1789	0	80366
21194	73505	433	1766	993	0	76697
21195	2172	367	567	79286	0	82392
21196	806	80989	543	1997	0	84335
21197	909	1848	382	81715	0	84854
21198	879	640	435	82323	0	84277
21199	811	424	458	83164	0	84857
21200	81094	331	455	2826	0	84706
21201	2404	297	389	80932	0	84022
21202	81488	286	366	2703	0	84843
21203	82096	335	385	1291	0	84107
21204	2780	306	81263	801	0	85150
21205	1198	81698	2037	703	0	85636
21206	1330	2055	733	74180	0	78298
21207	783	85156	656	1736	0	88331
21208	85976	2271	482	1149	0	89878
21209	2660	823	423	85953	0	89859
21210	1094	594	85480	2451	0	89619
21211	953	452	83967	1100	0	86472
21212	779	426	84825	856	0	86886
21213	82151	333	2797	1103	0	86384
21214	2432	84841	1152	697	0	89122
21215	83963	2199	714	900	0	87776
21216	2748	85414	542	651	0	89355
21217	1457	2410	530	83790	0	88187
21218	1307	900	576	82976	0	85759
21219	845	84972	530	2680	0	89027
21220	772	2389	84919	1222	0	89302
21221	725	86012	2322	954	0	90013
21222	83799	2368	829	1100	0	88096
21223	2591	942	630	80565	0	84728
21224	1043	741	79487	2292	0	83563
21225	866	527	79491	1007	0	81891
21226	1139	604	2565	78084	0	82392
21227	752	407	78171	2222	0	81552
21228	667	451	74767	918	0	76803
21229	68940	448	2420	937	0	72745
21230	1972	71428	1036	636	0	75072
21231	67090	1693	615	768	0	70166
21232	2112	740	66253	474	0	69579
21233	924	61908	1935	515	0	65282
21234	681	64624	842	507	0	66654
21235	959	2289	882	62499	0	66629
21236	722	801	471	64324	0	66318
21237	647	546	436	65720	0	67349
21238	496	424	64426	2504	0	67850
21239	720	340	1821	64511	0	67392
21240	648	313	770	66735	0	68466
21241	65107	332	567	2730	0	68736
21242	1990	64504	422	1159	0	68075
21243	1000	1883	381	66269	0	69533
21244	65962	815	340	2432	0	69549
21245	66078	492	417	1249	0	68236
21246	2664	506	378	65034	0	68582
21247	1093	486	64705	2211	0	68495
21248	873	315	1964	65113	0	68265
21249	504	344	64940	2481	0	68269
21250	65315	316	2165	1373	0	69169
21251	71838	297	1007	1010	0	74152
21252	3091	466	684	72679	0	76920
21253	1181	301	73754	2492	0	77728
21254	843	76923	2362	1061	0	81189
21255	607	2564	78704	631	0	82506
21256	948	1340	2536	66836	0	71660
21257	456	72694	972	2084	0	76206
21258	68459	2028	466	831	0	71784
21259	2396	605	350	65129	0	68480
21260	671	67992	401	2020	0	71084
21261	68618	2045	369	907	0	71939
21262	2349	677	347	67350	0	70723
21263	762	68300	397	2110	0	71569
21264	854	2117	303	68466	0	71740
21265	408	742	67781	2372	0	71303
21266	65202	463	2088	1061	0	68814
21267	67177	399	695	773	0	69044
21268	2531	397	65251	500	0	68679
21269	839	64965	2100	467	0	68371
21270	65113	2096	699	611	0	68519
21271	2451	733	462	64249	0	67895
21272	1161	442	324	64464	0	66391
21273	805	404	372	65450	0	67031
21274	818	328	373	65395	0	66914
21275	729	288	344	65346	0	66707
21276	62850	315	308	3012	0	66485
21277	64829	328	318	1297	0	66772
21278	2790	267	353	63026	0	66436
21279	1247	239	324	64697	0	66507
21280	713	288	62549	2806	0	66356
21281	553	277	63246	1173	0	65249
21282	61482	301	2456	995	0	65234
21283	2539	317	784	62016	0	65656
21284	977	312	61358	2462	0	65109
21285	874	260	2116	61787	0	65037
21286	61248	227	812	2864	0	65151
21287	63355	263	529	1393	0	65540
21288	2814	245	487	61708	0	65254
21289	1271	247	459	63420	0	65397
21290	62265	265	419	2956	0	65905
21291	2624	228	389	60909	0	64150
21292	960	61074	393	2673	0	65100
21293	975	1947	458	60529	0	63909
21294	924	625	439	61109	0	63097
21295	620	372	58204	2691	0	61887
21296	610	357	56684	1193	0	58844
21297	535	56846	2178	971	0	60530
21298	55195	1780	874	985	0	58834
21299	55086	628	453	901	0	57068
21300	56202	410	380	810	0	57802
21301	2433	53570	442	826	0	57271
21302	968	55702	381	781	0	57832
21303	53200	1972	371	930	0	56473
21304	1967	54634	488	775	0	57864
21305	775	1938	52871	767	0	56351
21306	697	52943	1744	803	0	56187
21307	621	1815	50632	721	0	53789
21308	48352	654	1849	758	0	51613
21309	50058	485	666	722	0	51931
21310	2014	49036	499	618	0	52167
21311	49927	1771	399	725	0	52822
21312	54494	678	355	747	0	56274
21313	55450	530	355	718	0	57053
21314	2941	473	386	53658	0	57458
21315	54513	471	335	2306	0	57625
21316	2664	515	52057	1032	0	56268
21317	53502	453	1775	946	0	56676
21318	2737	410	801	53397	0	57345
21319	1370	454	52367	2188	0	56379
21320	1126	418	53457	1064	0	56065
21321	1122	357	2331	52435	0	56245
21322	1014	401	1040	54269	0	56724
21323	53740	367	736	2745	0	57588
21324	2416	364	516	53844	0	57140
21325	1202	357	52769	2663	0	56991
21326	1179	287	1888	51745	0	55099
21327	822	53616	823	2635	0	57896
21328	54421	1730	596	1482	0	58229
21329	2455	647	531	54573	0	58206
21330	1202	549	53492	2406	0	57649
21331	1021	53156	1914	1315	0	57406
21332	51449	1673	798	1053	0	54973
21333	2301	691	707	52040	0	55739
21334	1101	512	51790	2115	0	55518
21335	921	50901	1866	1126	0	54814
21336	50408	1720	1002	1035	0	54165
21337	49975	645	606	889	0	52115
21338	51052	449	523	838	0	52862
21339	2600	332	466	49107	0	52505
21340	1436	306	384	50328	0	52454
21341	48964	265	316	2353	0	51898
21342	2042	48328	338	1297	0	52005
21343	48440	1369	322	1031	0	51162
21344	2083	584	319	48068	0	51054
21345	49367	480	309	1929	0	52085
21346	2183	364	342	48939	0	51828
21347	1223	311	333	49530	0	51397
21348	1072	330	340	49917	0	51659
21349	1149	290	377	49966	0	51782
21350	729	296	45679	2097	0	48801
21351	569	260	41126	1055	0	43010
21352	36161	159	1141	846	0	38307
21353	1059	164	37558	537	0	39318
21354	501	107	31625	313	0	32546
21355	30245	82	1042	289	0	31658
21356	31180	71	770	249	0	32270
21357	1012	162	391	33774	0	35339
21358	34685	56	279	748	0	35768
21359	845	35440	165	498	0	36948
21360	36696	492	136	467	0	37791
21361	36259	314	112	360	0	37045
21362	38240	249	97	364	0	38950
21363	1142	200	95	37825	0	39262
21364	754	36793	149	579	0	38275
21365	514	38204	152	436	0	39306
21366	38633	693	115	398	0	39839
21367	39077	466	120	328	0	39991
21368	923	337	113	38701	0	40074
21369	682	190	112	38537	0	39521
21370	435	38364	140	789	0	39728
21371	38494	522	87	626	0	39729
21372	750	330	38845	415	0	40340
21373	553	247	460	38547	0	39807
21374	488	131	300	39355	0	40274
21375	281	149	39666	881	0	40977
21376	308	109	573	38811	0	39801
21377	342	32366	506	830	0	34044
21378	258	498	255	40580	0	41591
21379	280	304	204	40196	0	40984
21380	220	37782	161	891	0	39054
21381	213	40647	139	620	0	41619
21382	224	676	108	41127	0	42135
21383	41495	416	108	864	0	42883
21384	574	311	109	41775	0	42769
21385	432	183	156	42095	0	42866
21386	352	44257	173	812	0	45594
21387	339	493	142	46268	0	47242
21388	327	273	118	45919	0	46637
21389	297	225	117	46292	0	46931
21390	45915	143	97	1169	0	47324
21391	625	139	96	46618	0	47478
21392	522	116	72	46276	0	46986
21393	430	128	58	46982	0	47598
21394	347	122	45652	1016	0	47137
21395	42046	90	429	893	0	43458
21396	621	45552	299	506	0	46978
21397	46540	432	218	435	0	47625
21398	748	285	150	46507	0	47690
21399	485	248	45633	580	0	46946
21400	43093	176	470	590	0	44329
21401	724	192	58074	346	0	59336
21402	641	96	621	59051	0	60409
21403	62587	72	422	873	0	63954
21404	61977	66	288	547	0	62878
21405	64181	82	178	549	0	64990
21406	1042	75	95	65279	0	66491
21407	744	72	80	65863	0	66759
21408	554	135	79	66471	0	67239
21409	330	63905	85	934	0	65254
21410	222	63922	90	654	0	64888
21411	201	63272	94	475	0	64042
21412	63	63195	49	79	0	63386
21413	181	140	57	65189	0	65567
21414	109	56	24	65271	0	65460
21415	65521	33	24	370	0	65948
21416	64142	18	31	260	0	64451
21417	66015	25	26	322	0	66388
21418	269	31	21	66751	0	67072
21419	143	42	24	67778	0	67987
21420	67490	31	14	457	0	67992
21421	65672	32	58	357	0	66119
21422	225	86	65758	104	0	66173
21423	237	143	62745	142	0	63267
21424	175	105	64864	98	0	65242
21425	110	89	69854	64	0	70117
21426	144	36	186	70121	0	70487
21427	70606	37	56	414	0	71113
21428	195	70258	79	155	0	70687
21429	136	171	16	72712	0	73035
21430	120	115	73208	205	0	73648
21431	73	77200	200	159	0	77632
21432	143	185	57	79513	0	79898
21433	89	102	79613	220	0	80024
21434	200	56	157	78300	0	78713
21435	147	52	63	80044	0	80306
21436	81954	35	54	450	0	82493
21437	264	31	36	82429	0	82760
21438	105	90	83119	220	0	83534
21439	182	36	175	81780	0	82173
21440	70	89298	101	300	0	89769
21441	154	179	65	94286	0	94684
21442	176	54	58	94652	0	94940
21443	159	48	55	94453	0	94715
21444	96499	22	48	610	0	97179
21445	96188	21	57	482	0	96748
21446	97968	26	40	511	0	98545
21447	97706	15	34	493	0	98248
21448	313	112	96969	91	0	97485
21449	94409	27	170	378	0	94984
21450	98169	25	51	429	0	98674
21451	266	89	96885	101	0	97341
21452	202	95	100586	70	0	100953
21453	240	34	191	103086	0	103551
21454	52	104198	119	202	0	104571
21455	106844	157	59	435	0	107495
21456	108257	45	37	445	0	108784
21457	109249	37	27	478	0	109791
21458	349	28	24	109146	0	109547
21459	114	113197	86	215	0	113612
21460	118520	177	35	690	0	119422
21461	119919	53	46	551	0	120569
21462	367	57	24	119936	0	120384
21463	164	87	117478	242	0	117971
21464	116736	35	217	459	0	117447
21465	323	26	76	122892	0	123317
21466	124568	18	63	604	0	125253
21467	380	21	32	126748	0	127181
21468	154	93	125651	249	0	126147
21469	131503	43	222	776	0	132544
21470	417	40	76	136904	0	137437
21471	323	31	67	135956	0	136377
21472	219	45	30	137835	0	138129
21473	181	31	40	137416	0	137668
21474	138950	29	45	764	0	139788
21475	354	26	23	138680	0	139083
21476	182	137822	69	393	0	138466
21477	193	335	17	141485	0	142030
21478	71	140737	96	399	0	141303
21479	154	392	22	144179	0	144747
21480	224	125	35	144590	0	144974
21481	71	143511	97	549	0	144228
21482	170	409	15	146569	0	147163
21483	209	133	39	144992	0	145373
21484	144690	55	35	1135	0	145915
21485	557	147	147247	214	0	148165
21486	374	40	600	148538	0	149552
21487	150311	22	137	1292	0	151762
21488	149637	27	78	781	0	150523
21489	150168	27	72	689	0	150956
21490	1124	129	150399	91	0	151743
21491	464	211	150881	135	0	151691
21492	624	125	1126	154865	0	156740
21493	159311	26	396	1666	0	161399
21494	1117	171	156882	312	0	158482
21495	150805	40	1107	801	0	152753
21496	1118	159803	409	258	0	161588
21497	665	945	182	170045	0	171837
21498	537	272	138	173456	0	174403
21499	175333	138	121	2014	0	177606
21500	1327	148	90	177550	0	179115
21501	168010	82	79	1974	0	170145
21502	170796	70	79	1133	0	172078
21503	1598	76	70	169620	0	171364
21504	794	55	68	170195	0	171112
21505	170427	21	66	2085	0	172599
21506	1305	152	179665	534	0	181656
21507	175256	48	1094	1493	0	177891
21508	1410	199	188519	275	0	190403
21509	188070	69	1135	1197	0	190471
21510	202039	42	364	1421	0	203866
21511	200047	78	247	1149	0	201521
21512	197803	61	181	1051	0	199096
21513	1633	197750	233	301	0	199917
21514	202732	1023	147	1019	0	204921
21515	203531	262	101	1010	0	204904
21516	1675	211444	230	283	0	213632
21517	213211	1130	106	1301	0	215748
21518	1695	506	210952	191	0	213344
21519	206553	196	1188	1058	0	208995
21520	1949	492	213337	144	0	215922
21521	1237	108	1547	214123	0	217015
21522	926	85	559	216824	0	218394
21523	593	222	215550	1825	0	218190
21524	933	105	1629	214615	0	217282
21525	5871	1728	2869	136430	0	146898
21526	225531	91	371	3122	0	229115
21527	2280	126	276	227340	0	230022
21528	1285	118	237	225762	0	227402
21529	927	157	211	228514	0	229809
21530	543	222776	354	2678	0	226351
21531	741	1689	199	224410	0	227039
21532	223077	519	185	3248	0	227029
21533	2305	442	224935	1096	0	228778
21534	1376	217	2132	227234	0	230959
21535	768	317	228477	2706	0	232268
21536	220252	156	2565	1816	0	224789
21537	3174	118	850	237610	0	241752
21538	1246	437	290181	3430	0	295294
21539	1692	160	6200	290148	0	298200
21540	1651	187	4328	288431	0	294597
21541	692	287826	3424	10334	0	302276
21542	1670	5947	1834	300682	0	310133
21543	1753	4088	780	317790	0	324411
21544	862	3254	310751	13475	0	328342
21545	2050	1688	7416	311462	0	322616
21546	1695	754	4765	320494	0	327708
21547	306499	500	3446	15586	0	326031
21548	305626	387	2247	10846	0	319106
21549	11390	307324	1467	6776	0	326957
21550	313990	7387	1240	5537	0	328154
21551	315819	4762	1343	4843	0	326767
21552	14048	312451	1826	3578	0	331903
21553	10197	9248	1270	311734	0	332449
21554	315694	5524	843	11793	0	333854
21555	317344	3983	934	8637	0	330898
21556	313032	2674	928	7242	0	323876
21557	16958	302541	1530	4444	0	325473
21558	11989	8816	308189	3449	0	332443
21559	310546	5609	8161	4652	0	328968
21560	317451	4969	4932	4628	0	331980
21561	16048	314297	3896	3624	0	337865
21562	319876	10185	2276	4781	0	337118
21563	328267	6234	1750	3828	0	340079
21564	20195	4777	1295	315338	0	341605
21565	12537	3859	315838	11322	0	343556
21566	10562	2455	9898	320397	0	343312
21567	8744	1784	5967	324868	0	341363
21568	7476	2238	4116	329639	0	343469
21569	5500	2613	310438	18781	0	337332
21570	7566	1967	10235	302351	0	322119
21571	6604	1920	6123	319138	0	333785
21572	5739	1596	4624	324421	0	336380
21573	5773	1501	3470	324132	0	334876
21574	5545	1530	2102	324242	0	333419
21575	4084	308756	1969	24048	0	338857
21576	4844	10133	1788	321518	0	338283
21577	4304	5752	2736	333641	0	346433
21578	3102	4417	315852	21632	0	345003
21579	4614	2556	10726	341887	0	359783
21580	4268	2016	6201	349961	0	362446
21581	4374	1704	4664	361914	0	372656
21582	4411	1648	3461	369573	0	379093
21583	348000	1971	2573	30388	0	382932
21584	14447	1884	2263	365349	0	383943
21585	9738	1938	1858	368903	0	382437
21586	6927	2168	340457	26995	0	376547
21587	4992	323498	12235	19913	0	360638
21588	3196	348216	8197	15675	0	375284
21589	333469	15943	6690	13940	0	370042
21590	12298	344113	4522	11621	0	372554
21591	9445	15967	2661	340283	0	368356
21592	332971	9528	2367	21882	0	366748
21593	15014	6693	331786	16065	0	369558
21594	10348	5058	12735	335319	0	363460
21595	7421	333521	8336	20586	0	369864
21596	6700	13595	5657	333944	0	359896
21597	4328	334983	4219	22587	0	366117
21598	5452	17047	2697	338928	0	364124
21599	326625	10634	2168	24658	0	364085
21600	15784	8047	329133	16014	0	368978
21601	11983	5792	13637	319821	0	351233
21602	8558	328203	8979	20174	0	365914
21603	326942	15203	6575	15911	0	364631
21604	16281	10131	324240	13200	0	363852
21605	11818	7891	14190	325145	0	359044
21606	9513	6073	314581	20454	0	350621
21607	9071	4378	17661	315605	0	346715
21608	6206	4185	308441	23457	0	342289
21609	5741	4488	18897	303696	0	332822
21610	5382	4362	11776	310100	0	331620
21611	290934	4119	8119	27839	0	331011
21612	300670	4041	6536	18985	0	330232
21613	22834	3687	4713	293478	0	324712
21614	14729	285382	4754	21803	0	326668
21615	11651	14203	3792	297399	0	327045
21616	8311	9224	4243	298585	0	320363
21617	273868	6371	4331	30247	0	314817
21618	15596	276347	4144	21727	0	317814
21619	277567	14814	3866	17080	0	313327
21620	280376	9593	3708	13890	0	307567
21621	22103	261161	3538	12599	0	299401
21622	14516	280182	3208	12522	0	310428
21623	273620	18639	3774	13248	0	309281
21624	18767	11439	262651	13761	0	306618
21625	267162	8188	14049	12644	0	302043
21626	270959	6762	8707	11830	0	298258
21627	24868	257234	7187	11000	0	300289
21628	18040	15179	5331	235308	0	273858
21629	11913	261366	4696	19447	0	297422
21630	257486	18993	4730	15229	0	296438
21631	267248	12474	4775	12673	0	297170
21632	23617	9644	4523	254581	0	292365
21633	17675	8046	3645	263197	0	292563
21634	248271	6265	3064	25945	0	283545
21635	19287	242072	2897	19900	0	284156
21636	14128	239568	3054	16118	0	272868
21637	11715	239740	3741	11956	0	267152
21638	5722	174719	2395	7503	0	190339
21639	5336	181488	2190	7692	0	196706
21640	6114	14239	2650	172781	0	195784
21641	4600	7649	164050	13685	0	189984
21642	5031	166420	7728	8413	0	187592
21643	149524	9905	3520	5814	0	168763
21644	10048	5852	3045	147932	0	166877
21645	147507	4841	2468	9978	0	164794
21646	9793	147111	2540	6460	0	165904
21647	147735	8774	2886	5451	0	164846
21648	10193	146546	3369	6157	0	166265
21649	6763	9214	3320	148174	0	167471
21650	148251	5218	3096	9871	0	166436
21651	153019	4257	2947	7019	0	167242
21652	11016	3658	2587	150615	0	167876
21653	7288	3477	2427	151547	0	164739
21654	5856	145731	2102	12265	0	165954
21655	5833	8131	1762	150547	0	166273
21656	5735	4917	1268	154325	0	166245
21657	5649	4642	1207	151798	0	163296
21658	4771	140441	1197	13337	0	159746
21659	129359	7042	1087	8319	0	145807
21660	7697	132542	1117	6362	0	147718
21661	128376	7976	1131	5037	0	142520
21662	8785	128701	1182	4205	0	142873
21663	6353	8080	122654	3696	0	140783
21664	5836	5436	5326	122092	0	138690
21665	4857	4462	119659	6815	0	135793
21666	4469	3963	119111	4284	0	131827
21667	4651	3675	7455	116577	0	132358
21668	4523	3219	118163	6862	0	132767
21669	4838	2856	6992	115972	0	130658
21670	5010	2828	3990	118009	0	129837
21671	4532	2949	2802	122080	0	132363
21672	116954	3032	2035	10024	0	132045
21673	8071	2992	1612	118589	0	131264
21674	6081	2786	1260	119637	0	129764
21675	111528	2325	896	10077	0	124826
21676	7994	107100	945	7013	0	123052
21677	5229	99293	643	5757	0	110922
21678	4774	103426	619	4381	0	113200
21679	3100	7488	566	79624	0	90778
21680	2447	2462	78450	4452	0	87811
21681	64603	2248	2782	2711	0	72344
21682	3098	67795	1051	1754	0	73698
21683	63240	2571	725	1346	0	67882
21684	63792	1535	453	1001	0	66781
21685	63938	1433	373	896	0	66640
21686	3368	1533	62649	710	0	68260
21687	2168	1278	1760	63229	0	68435
21688	1915	1099	967	64815	0	68796
21689	1954	945	668	65540	0	69107
21690	1769	945	572	63794	0	67080
21691	1589	61777	522	2924	0	66812
21692	62336	2066	365	1917	0	66684
21693	2292	1167	58547	1179	0	63185
21694	55274	800	1436	1088	0	58598
21695	2436	1202	575	54159	0	58372
21696	1355	52382	289	2059	0	56085
21697	1065	54531	219	1380	0	57195
21698	1286	3213	284	49689	0	54472
21699	719	50240	220	1627	0	52806
21700	43995	637	195	692	0	45519
21701	728	335	42984	386	0	44433
21702	374	210	391	41127	0	42102
21703	248	134	171	42264	0	42817
21704	200	152	112	42911	0	43375
21705	218	167	99	42337	0	42821
21706	42984	153	102	804	0	44043
21707	606	172	67	44480	0	45325
21708	49873	117	79	846	0	50915
21709	902	130	73	51513	0	52618
21710	455	159	105	53799	0	54518
21711	292	45558	118	11268	0	57236
21712	57651	718	64	972	0	59405
21713	58717	312	89	662	0	59780
21714	1336	58288	102	385	0	60111
21715	749	999	65	55056	0	56869
21716	378	57536	95	955	0	58964
21717	50496	1123	6215	661	0	58495
21718	1034	497	57065	382	0	58978
21719	511	386	55667	292	0	56856
21720	52614	208	1193	451	0	54466
21721	1057	55566	548	268	0	57439
21722	690	1003	303	55143	0	57139
21723	499	452	195	55800	0	56946
21724	238	364	55841	1356	0	57799
21725	485	244	962	55092	0	56783
21726	418	181	399	56015	0	57013
21727	171	54874	330	1492	0	56867
21728	307	995	202	55494	0	56998
21729	306	490	140	55514	0	56450
21730	53893	351	116	1701	0	56061
21731	1013	52901	159	857	0	54930
21732	442	53945	200	593	0	55180
21733	487	1231	176	53830	0	55724
21734	385	596	104	54824	0	55909
21735	336	404	71	54239	0	55050
21736	165	53626	136	1583	0	55510
21737	304	1006	105	54754	0	56169
21738	336	469	106	54442	0	55353
21739	341	319	88	55122	0	55870
21740	324	277	60	54682	0	55343
21741	153	53809	153	1829	0	55944
21742	168	57963	109	1032	0	59272
21743	56667	1602	75	946	0	59290
21744	57760	738	68	669	0	59235
21745	1981	474	54	57516	0	60025
21746	800	341	57724	1665	0	60530
21747	682	275	1299	58013	0	60269
21748	503	244	471	58302	0	59520
21749	55855	256	298	2297	0	58706
21750	1469	57517	209	1040	0	60235
21751	852	1445	145	57217	0	59659
21752	628	996	122	58148	0	59894
21753	395	443	56479	2142	0	59459
21754	284	407	56888	1078	0	58657
21755	425	316	1763	56055	0	58559
21756	401	311	764	55812	0	57288
21757	272	55007	496	2055	0	57830
21758	267	57200	336	1043	0	58846
21759	55851	1803	283	924	0	58861
21760	1603	761	235	56833	0	59432
21761	618	517	56862	1779	0	59776
21762	411	56613	1344	980	0	59348
21763	452	1490	586	57653	0	60181
21764	57003	715	333	2018	0	60069
21765	1473	523	217	58029	0	60242
21766	56615	393	215	2194	0	59417
21767	1549	57247	217	1140	0	60153
21768	55986	1511	159	1025	0	58681
21769	1792	742	125	56974	0	59633
21770	787	602	58353	1907	0	61649
21771	690	472	1389	57261	0	59812
21772	426	59445	606	1975	0	62452
21773	610	1688	349	59200	0	61847
21774	337	61615	294	2069	0	64315
21775	476	1884	242	63414	0	66016
21776	373	893	61388	2401	0	65055
21777	425	621	60129	1385	0	62560
21778	331	530	61616	1130	0	63607
21779	59404	493	2259	1156	0	63312
21780	1785	60330	970	872	0	63957
21781	920	62962	649	719	0	65250
21782	60496	2247	433	966	0	64142
21783	61552	1062	403	895	0	63912
21784	2379	737	397	60435	0	63948
21785	1092	578	60417	2215	0	64302
21786	780	558	58170	1149	0	60657
21787	718	463	2219	57818	0	61218
21788	57572	440	1022	2453	0	61487
21789	1774	57764	664	1404	0	61606
21790	948	1834	533	58746	0	62061
21791	57440	855	531	2500	0	61326
21792	57748	588	497	1575	0	60408
21793	2212	504	56744	1207	0	60667
21794	54356	576	1755	1159	0	57846
21795	2119	611	57496	950	0	61176
21796	1126	514	58484	815	0	60939
21797	1035	426	2237	56131	0	59829
21798	789	439	1071	57609	0	59908
21799	709	481	757	58957	0	60904
21800	580	502	56630	2738	0	60450
21801	55900	462	1800	1681	0	59843
21802	2030	405	836	58951	0	62222
21803	57299	406	566	2572	0	60843
21804	57568	469	457	1561	0	60055
21805	2398	56948	490	1148	0	60984
21806	1197	58220	522	947	0	60886
21807	800	57732	499	948	0	59979
21808	790	2110	525	50760	0	54185
21809	453	758	50619	1632	0	53462
21810	592	1673	1441	45317	0	49023
21811	376	46076	669	1516	0	48637
21812	366	46225	385	687	0	47663
21813	547	1459	319	44988	0	47313
21814	44013	567	322	1482	0	46384
21815	1284	43393	344	681	0	45702
21816	517	44263	329	531	0	45640
21817	44666	1421	269	643	0	46999
21818	1404	615	268	44958	0	47245
21819	735	426	233	45185	0	46579
21820	570	379	235	46309	0	47493
21821	44207	334	213	1872	0	46626
21822	45151	291	266	994	0	46702
21823	1729	274	328	44831	0	47162
21824	764	273	43360	1447	0	45844
21825	43130	277	1205	881	0	45493
21826	1471	289	506	44319	0	46585
21827	684	315	43528	1449	0	45976
21828	585	266	43328	755	0	44934
21829	607	248	1519	44608	0	46982
21830	398	266	46636	1564	0	48864
21831	525	268	1499	49807	0	52099
21832	699	287	692	48699	0	50377
21833	531	216	427	53755	0	54929
21834	52110	236	379	2540	0	55265
21835	1902	255	321	52587	0	55065
21836	969	312	306	53449	0	55036
21837	687	322	317	53728	0	55054
21838	685	318	354	53883	0	55240
21839	402	343	50532	2511	0	53788
21840	318	50199	1624	1278	0	53419
21841	420	1243	574	47424	0	49661
21842	363	538	413	46252	0	47566
21843	247	44524	359	1740	0	46870
21844	244	47488	359	858	0	48949
21845	46165	1432	312	805	0	48714
21846	1216	44927	291	962	0	47396
21847	664	1350	230	45117	0	47361
21848	457	619	45419	1473	0	47968
21849	43382	442	1131	931	0	45886
21850	1338	347	43586	676	0	45947
21851	42796	264	1281	718	0	45059
21852	43865	181	538	728	0	45312
21853	1644	215	43948	559	0	46366
21854	973	205	1288	41101	0	43567
21855	610	42528	624	1441	0	45203
21856	590	1157	432	45357	0	47536
21857	46153	463	351	1801	0	48768
21858	47041	315	351	989	0	48696
21859	1700	46542	395	779	0	49416
21860	46789	1241	315	772	0	49117
21861	1650	443	317	45687	0	48097
21862	45551	284	359	1775	0	47969
21863	46627	205	315	1044	0	48191
21864	1936	259	273	46102	0	48570
21865	45858	243	235	1844	0	48180
21866	44508	254	238	1224	0	46224
21867	1697	292	44641	838	0	47468
21868	43797	291	1215	864	0	46167
21869	1599	314	43860	712	0	46485
21870	787	260	41496	594	0	43137
21871	572	42844	1445	583	0	45444
21872	606	1121	701	40744	0	43172
21873	425	476	42268	1198	0	44367
21874	384	340	41110	632	0	42466
21875	41999	265	1272	553	0	44089
21876	1127	267	528	42609	0	44531
21877	557	223	372	44058	0	45210
21878	478	218	302	44678	0	45676
21879	435	237	235	44604	0	45511
21880	444	269	226	44913	0	45852
21881	396	261	43809	1632	0	46098
21882	427	251	43393	839	0	44910
21883	477	174	1245	44291	0	46187
21884	43798	208	540	1447	0	45993
21885	1156	43353	360	787	0	45656
21886	699	950	307	43893	0	45849
21887	43699	329	312	1490	0	45830
21888	1244	43539	324	792	0	45899
21889	800	983	295	44166	0	46244
21890	652	411	270	45251	0	46584
21891	560	246	272	45424	0	46502
21892	44429	178	326	1777	0	46710
21893	1259	209	43659	934	0	46061
21894	43500	156	1123	797	0	45576
21895	1394	175	531	44582	0	46682
21896	751	159	401	43350	0	44661
21897	509	43655	381	1620	0	46165
21898	436	959	43314	931	0	45640
21899	42562	374	1052	881	0	44869
21900	44519	241	552	808	0	46120
21901	1463	217	43601	689	0	45970
21902	41338	197	1055	738	0	43328
21903	1305	43387	572	660	0	45924
21904	664	44249	413	544	0	45870
21905	529	44684	345	542	0	46100
21906	42496	1227	379	583	0	44685
21907	1228	590	42994	402	0	45214
21908	638	592	988	40577	0	42795
21909	413	40360	463	1038	0	42274
21910	341	41293	310	543	0	42487
21911	369	41724	266	453	0	42812
21912	891	1453	339	33076	0	35759
21913	39734	407	175	1140	0	41456
21914	913	40724	198	525	0	42360
21915	523	866	147	41229	0	42765
21916	434	386	157	41872	0	42849
21917	40795	247	204	1278	0	42524
21918	1058	199	196	40799	0	42252
21919	572	182	160	42097	0	43011
21920	413	200	41823	1221	0	43657
21921	455	183	812	41525	0	42975
21922	441	159	339	43333	0	44272
21923	42727	132	279	1348	0	44486
21924	42918	149	203	711	0	43981
21925	1266	114	169	43031	0	44580
21926	41352	158	171	1222	0	42903
21927	42279	160	166	662	0	43267
21928	1170	42381	216	416	0	44183
21929	602	772	41354	276	0	43004
21930	403	40015	842	299	0	41559
21931	500	1163	343	36313	0	38319
21932	35508	229	279	564	0	36580
21933	404	35027	133	207	0	35771
21934	244	374	88	35392	0	36098
21935	35242	171	85	563	0	36061
21936	34911	123	91	304	0	35429
21937	492	126	64	35111	0	35793
21938	214	91	36204	508	0	37017
21939	242	88	333	36722	0	37385
21940	153	102	137	37658	0	38050
21941	119	83	37547	584	0	38333
21942	201	74	371	36806	0	37452
21943	210	77	155	37330	0	37772
21944	38930	51	92	774	0	39847
21945	454	85	82	39438	0	40059
21946	253	79	73	39631	0	40036
21947	38900	73	59	737	0	39769
21948	37967	78	84	462	0	38591
21949	37787	73	82	378	0	38320
21950	549	100	37680	214	0	38543
21951	318	104	379	37347	0	38148
21952	170	38097	164	439	0	38870
21953	228	391	64	39411	0	40094
21954	206	205	40222	447	0	41080
21955	379	192	363	37384	0	38318
21956	152	154	39171	393	0	39870
21957	36112	83	353	314	0	36862
21958	37473	44	130	260	0	37907
21959	376	47	55	38945	0	39423
21960	206	27	37	38999	0	39269
21961	166	27	38	39106	0	39337
21962	101	40948	67	349	0	41465
21963	40951	233	40	418	0	41642
21964	41459	90	56	301	0	41906
21965	391	51	33	41519	0	41994
21966	203	62	35	41266	0	41566
21967	142	39	45	41596	0	41822
21968	145	34	52	41597	0	41828
21969	113	55	41104	402	0	41674
21970	175	24	253	41135	0	41587
21971	40320	33	104	528	0	40985
21972	39942	47	61	326	0	40376
21973	385	57	28	39339	0	39809
21974	168	66	38252	335	0	38821
21975	36206	30	253	323	0	36812
21976	357	88	111	38534	0	39090
21977	158	38170	69	375	0	38772
21978	97	39612	53	155	0	39917
21979	40385	327	96	421	0	41229
21980	388	129	49	41193	0	41759
21981	227	65	29	41892	0	42213
21982	175	20	41	44053	0	44289
21983	165	36	47	44080	0	44328
21984	164	32	29	46027	0	46252
21985	100	69	45829	741	0	46739
21986	125	44	44789	347	0	45305
21987	93	61	45311	242	0	45707
21988	163	19	765	44936	0	45883
21989	97	66	46714	638	0	47515
21990	183	39	655	46038	0	46915
21991	199	46	281	46235	0	46761
21992	166	40	173	48440	0	48819
21993	48468	25	142	1239	0	49874
21994	765	34	156	49012	0	49967
21995	368	51	160	49911	0	50490
21996	49091	23	165	1246	0	50525
21997	709	49335	171	604	0	50819
21998	275	51251	179	376	0	52081
21999	50724	927	139	545	0	52335
22000	779	52106	151	291	0	53327
22001	51579	861	90	563	0	53093
22002	52178	349	105	515	0	53147
22003	52114	173	74	492	0	52853
22004	51228	148	53	505	0	51934
22005	51648	127	46	501	0	52322
22006	1267	51174	89	266	0	52796
22007	50869	879	56	457	0	52261
22008	51622	376	68	471	0	52537
22009	1278	52203	98	219	0	53798
22010	56761	915	86	442	0	58204
22011	58343	419	68	458	0	59288
22012	63829	257	69	428	0	64583
22013	66862	227	54	440	0	67583
22014	2529	277	68973	201	0	71980
22015	1582	210	1725	71799	0	75316
22016	1141	209	537	74613	0	76500
22017	675	234	73501	2489	0	76899
22018	683	244	72193	953	0	74073
22019	72126	201	2495	753	0	75575
22020	2846	189	901	72839	0	76775
22021	1171	189	74138	2057	0	77555
22022	897	210	73550	774	0	75431
22023	72154	175	2675	798	0	75802
22024	74806	141	1083	725	0	76755
22025	75208	122	644	655	0	76629
22026	3313	149	73256	347	0	77065
22027	1929	132	2278	72234	0	76573
22028	1103	153	73876	2137	0	77269
22029	72231	110	2527	1212	0	76080
22030	2665	161	74976	701	0	78503
22031	1619	122	2816	72109	0	76666
22032	1391	137	1227	72304	0	75059
22033	860	74297	843	2693	0	78693
22034	75362	2078	649	1418	0	79507
22035	2697	700	75303	785	0	79485
22036	74827	366	2678	831	0	78702
22037	3061	262	77075	522	0	80920
22038	1909	160	2861	73594	0	78524
22039	1456	161	1334	75353	0	78304
22040	1342	160	927	76610	0	79039
22041	74435	162	772	3586	0	78955
22042	3349	190	707	73054	0	77300
22043	1881	190	708	74587	0	77366
22044	1125	71690	805	3296	0	76916
22045	1372	2029	735	73586	0	77722
22046	71942	672	749	3512	0	76875
22047	2964	546	72137	1520	0	77167
22048	1872	278	2667	71613	0	76430
22049	1258	248	72030	3125	0	76661
22050	1141	69570	2992	1576	0	75279
22051	1030	2172	71943	1294	0	76439
22052	69629	773	3179	1539	0	75120
22053	72884	498	1556	1332	0	76270
22054	3682	342	1320	70115	0	75459
22055	70730	239	1158	3355	0	75482
22056	71567	213	1159	1932	0	74871
22057	3868	269	1110	70137	0	75384
22058	2202	290	1140	71882	0	75514
22059	1592	326	69116	3641	0	74675
22060	1419	67664	2964	1887	0	73934
22061	68008	2170	1581	1651	0	73410
22062	3340	66108	1238	1242	0	71928
22063	2179	2507	1074	66402	0	72162
22064	1962	980	900	68028	0	71870
22065	1781	579	1053	68462	0	71875
22066	1544	508	1048	68648	0	71748
22067	1224	478	65727	4172	0	71601
22068	63931	420	3071	2439	0	69861
22069	67722	472	1509	1847	0	71550
22070	3991	413	1235	65841	0	71480
22071	66368	422	916	3715	0	71421
22072	3758	415	833	66654	0	71660
22073	1934	490	65157	3804	0	71385
22074	1874	441	2809	64112	0	69236
22075	1542	63696	1418	3643	0	70299
22076	1465	2124	1148	62134	0	66871
22077	1274	62913	1066	3539	0	68792
22078	1315	2447	912	60246	0	64920
22079	1163	61701	834	3663	0	67361
22080	60240	2466	855	2365	0	65926
22081	3026	1086	59680	1848	0	65640
22082	1629	55451	2673	1744	0	61497
22083	1332	57859	1341	1656	0	62188
22084	1557	2474	1426	55069	0	60526
22085	1370	987	879	56171	0	59407
22086	1318	690	990	56217	0	59215
22087	1285	558	986	56508	0	59337
22088	1117	53713	988	3523	0	59341
22089	1279	2149	831	54357	0	58616
22090	1253	941	851	55129	0	58174
22091	52467	770	756	3460	0	57453
22092	2844	630	609	53372	0	57455
22093	1430	640	51436	3323	0	56829
22094	1247	552	51062	2068	0	54929
22095	48907	537	2326	1998	0	53768
22096	2273	49753	1117	1741	0	54884
22097	1126	50859	741	1532	0	54258
22098	1124	2189	726	49322	0	53361
22099	917	1049	586	50731	0	53283
22100	793	797	47774	3071	0	52435
22101	46263	656	1858	1981	0	50758
22102	48511	621	876	1669	0	51677
22103	2383	570	49232	1651	0	53836
22104	1272	445	48569	1547	0	51833
22105	48580	444	2172	1643	0	52839
22106	51206	463	1068	1529	0	54266
22107	51174	446	827	1433	0	53880
22108	50511	447	594	1349	0	52901
22109	2826	47753	502	1233	0	52314
22110	43330	1521	383	1060	0	46294
22111	1933	590	40815	953	0	44291
22112	771	394	35297	727	0	37189
22113	536	342	34971	615	0	36464
22114	756	2672	1438	25087	0	29953
22115	24967	77	517	511	0	26072
22116	25021	79	118	240	0	25458
22117	456	80	124	24980	0	25640
22118	299	71	138	23986	0	24494
22119	224	84	88	25306	0	25702
22120	161	27327	92	488	0	28068
22121	27886	299	81	398	0	28664
22122	28153	108	77	321	0	28659
22123	28447	98	90	283	0	28918
22124	28437	72	91	245	0	28845
22125	28560	68	83	254	0	28965
22126	507	63	97	27892	0	28559
22127	242	27388	111	409	0	28150
22128	297	329	61	26567	0	27254
22129	244	132	53	26727	0	27156
22130	26313	56	59	409	0	26837
22131	301	66	25577	213	0	26157
22132	137	63	24070	105	0	24375
22133	134	60	24264	93	0	24551
22134	25689	16	240	159	0	26104
22135	26741	21	228	129	0	27119
22136	278	19	61	27627	0	27985
22137	163	26	52	27040	0	27281
22138	112	22	36	27825	0	27995
22139	67	30	28228	283	0	28608
22140	131	13	183	27335	0	27662
22141	57	40	30412	273	0	30782
22142	108	27	220	30301	0	30656
22143	89	19	115	30506	0	30729
22144	70	46	74	31620	0	31810
22145	31488	20	58	418	0	31984
22146	31461	18	39	293	0	31811
22147	290	29	31796	115	0	32230
22148	31101	13	207	209	0	31530
22149	32088	10	101	178	0	32377
22150	341	8	69	32287	0	32705
22151	32978	13	51	354	0	33396
22152	279	14	58	33520	0	33871
22153	197	10	30	33658	0	33895
22154	108	23	33010	368	0	33509
22155	31225	9	201	340	0	31775
22156	318	6	122	33695	0	34141
22157	180	16	34108	282	0	34586
22158	126	37	36005	209	0	36377
22159	199	38	337	35610	0	36184
22160	154	6	171	36194	0	36525
22161	37291	6	68	526	0	37891
22162	288	4	75	37554	0	37921
22163	202	6	56	37412	0	37676
22164	171	2	54	38239	0	38466
22165	135	7	63	40283	0	40488
22166	41703	6	60	721	0	42490
22167	41591	3	46	483	0	42123
22168	42794	4	59	355	0	43212
22169	43767	2	73	302	0	44144
22170	839	17	51	45371	0	46278
22171	45991	5	35	798	0	46829
22172	845	8	60	46066	0	46979
22173	46616	5	49	870	0	47540
22174	879	4	50	46389	0	47322
22175	482	12	59	46206	0	46759
22176	250	46668	65	856	0	47839
22177	262	550	40	47312	0	48164
22178	46572	209	41	978	0	47800
22179	45535	87	49	651	0	46322
22180	928	65	46682	281	0	47956
22181	414	47417	623	256	0	48710
22182	47430	585	279	397	0	48691
22183	736	49153	161	212	0	50262
22184	48781	658	83	416	0	49938
22185	783	51801	117	206	0	52907
22186	431	737	52176	168	0	53512
22187	266	52140	659	233	0	53298
22188	229	52968	277	215	0	53689
22189	319	888	123	54552	0	55882
22190	55621	373	99	1017	0	57110
22191	868	192	89	56152	0	57301
22192	562	145	81	56386	0	57174
22193	55765	110	80	1270	0	57225
22194	56942	128	67	745	0	57882
22195	1174	100	50	57381	0	58705
22196	673	95	69	57338	0	58175
22197	468	86	59	58005	0	58618
22198	56593	92	72	1383	0	58140
22199	924	163	56774	575	0	58436
22200	624	88	689	56671	0	58072
22201	358	155	58891	906	0	60310
22202	271	58033	791	565	0	59660
22203	291	731	57131	384	0	58537
22204	406	306	786	56030	0	57528
22205	264	205	57120	955	0	58544
22206	54140	151	841	702	0	55834
22207	971	118	378	57468	0	58935
22208	444	59269	227	1000	0	60940
22209	453	735	166	59605	0	60959
22210	286	59114	164	981	0	60545
22211	324	59715	165	558	0	60762
22212	299	60341	148	388	0	61176
22213	409	984	120	57310	0	58823
22214	240	58441	158	923	0	59762
22215	57537	873	120	724	0	59254
22216	870	465	56035	377	0	57747
22217	543	343	53657	330	0	54873
22218	360	276	56282	285	0	57203
22219	389	178	1006	57377	0	58950
22220	381	176	407	55014	0	55978
22221	389	208	228	54993	0	55818
22222	423	169	194	55461	0	56247
22223	548	219	175	52827	0	53769
22224	340	56493	217	1242	0	58292
22225	363	853	55372	613	0	57201
22226	411	475	53605	484	0	54975
22227	341	56934	912	510	0	58697
22228	460	805	418	57971	0	59654
22229	443	366	229	58956	0	59994
22230	404	285	232	58393	0	59314
22231	57816	244	204	1570	0	59834
22232	932	230	57417	765	0	59344
22233	55466	225	803	812	0	57306
22234	56734	218	354	781	0	58087
22235	1146	55694	268	563	0	57671
22236	561	57010	204	424	0	58199
22237	57340	1007	242	592	0	59181
22238	1121	502	227	57620	0	59470
22239	658	309	211	59585	0	60763
22240	432	347	61276	1244	0	63299
22241	348	403	58232	1645	0	60628
22242	473	319	1151	61499	0	63442
22243	62478	362	491	1446	0	64777
22244	1153	334	66055	604	0	68146
22245	66079	306	1225	735	0	68345
22246	1419	317	517	69223	0	71476
22247	792	293	345	72624	0	74054
22248	664	247	275	75296	0	76482
22249	401	289	75122	2006	0	77818
22250	376	72380	1462	953	0	75171
22251	348	77285	570	672	0	78875
22252	76754	1636	278	955	0	79623
22253	78934	513	269	864	0	80580
22254	2089	291	263	79132	0	81775
22255	79261	215	297	2224	0	81997
22256	1897	247	77374	824	0	80342
22257	708	311	76926	583	0	78528
22258	771	210	1937	74955	0	77873
22259	77476	201	766	2172	0	80615
22260	1957	201	513	78270	0	80941
22261	915	170	401	80925	0	82411
22262	78956	196	393	2721	0	82266
22263	80757	196	501	1224	0	82678
22264	2207	84256	406	756	0	87625
22265	83799	1799	288	799	0	86685
22266	2480	665	214	81685	0	85044
22267	747	83173	295	1991	0	86206
22268	82654	1754	234	1050	0	85692
22269	2026	83490	280	550	0	86346
22270	980	1846	277	82168	0	85271
22271	81973	435	306	2135	0	84849
22272	1926	303	80644	632	0	83505
22273	699	264	80394	464	0	81821
22274	867	227	1893	78872	0	81859
22275	686	243	533	81215	0	82677
22276	790	200	321	78677	0	79988
22277	450	82068	277	1898	0	84693
22278	83673	1912	189	1040	0	86814
22279	84117	557	215	956	0	85845
22280	84510	344	200	919	0	85973
22281	2443	87593	220	554	0	90810
22282	1372	2002	188	93822	0	97384
22283	1009	686	196	95053	0	96944
22284	918	420	199	96009	0	97546
22285	89595	304	238	3509	0	93646
22286	2352	90276	412	1098	0	94138
22287	1245	2210	311	90427	0	94193
22288	927	690	218	92300	0	94135
22289	577	471	88858	3112	0	93018
22290	531	87891	2111	1358	0	91891
22291	865	2417	617	87324	0	91223
22292	1000	784	308	89316	0	91408
22293	1025	484	224	89578	0	91311
22294	85438	432	219	3523	0	89612
22295	2445	85991	247	1640	0	90323
22296	86432	2352	243	1432	0	90459
22297	2912	792	264	86500	0	90468
22298	86734	590	247	3230	0	90801
22299	2802	605	84702	1363	0	89472
22300	84810	508	2203	1452	0	88973
22301	85960	484	662	1464	0	88570
22302	3096	494	84558	1032	0	89180
22303	1570	500	2320	84657	0	89047
22304	1431	582	781	84234	0	87028
22305	86749	461	472	3790	0	91472
22306	2987	447	401	87830	0	91665
22307	1648	409	414	87931	0	90402
22308	1347	500	382	88316	0	90545
22309	1079	567	84502	3493	0	89641
22310	79869	419	2352	2098	0	84738
22311	2947	85831	833	1434	0	91045
22312	1682	2383	607	83669	0	88341
22313	1237	84673	624	2946	0	89480
22314	1075	89686	588	1532	0	92881
22315	1293	2893	452	89231	0	93869
22316	961	1093	88467	3547	0	94068
22317	939	806	88901	1842	0	92488
22318	1275	625	2871	89517	0	94288
22319	1025	702	89095	3581	0	94403
22320	87724	660	2746	2141	0	93271
22321	3281	656	979	91124	0	96040
22322	1637	659	728	92266	0	95290
22323	1074	91140	708	4016	0	96938
22324	1215	2752	645	91330	0	95942
22325	1120	1121	601	90916	0	93758
22326	827	88592	683	4142	0	94244
22327	1090	2868	586	90416	0	94960
22328	1111	1118	548	90373	0	93150
22329	942	88709	670	4026	0	94347
22330	88937	2726	695	2372	0	94730
22331	3162	1151	88226	1701	0	94240
22332	1494	902	87685	1598	0	91679
22333	1445	846	3001	87150	0	92442
22334	1235	842	1107	90162	0	93346
22335	987	725	87598	4198	0	93508
22336	890	782	86149	2367	0	90188
22337	79837	747	2994	2274	0	85852
22338	2852	85661	1240	1739	0	91492
22339	83780	2649	801	1890	0	89120
22340	2928	1044	82148	1702	0	87822
22341	1213	81591	2720	1583	0	87107
22342	1221	2900	1151	82837	0	88109
22343	865	1085	84041	3438	0	89429
22344	774	789	81341	1679	0	84583
22345	1167	1261	3069	82552	0	88049
22346	735	618	82602	3403	0	87358
22347	683	79191	2774	1696	0	84344
22348	997	2553	1215	77752	0	82517
22349	707	995	78662	2968	0	83332
22350	699	78934	2747	1525	0	83905
22351	77161	2419	1288	1379	0	82247
22352	2631	1019	76194	1058	0	80902
22353	1097	76173	2612	1082	0	80964
22354	1144	2440	1225	74730	0	79539
22355	828	1034	947	78900	0	81709
22356	76787	800	848	3569	0	82004
22357	2650	543	760	76939	0	80892
22358	1310	479	751	77590	0	80130
22359	74571	547	847	3584	0	79549
22360	2516	676	633	74645	0	78470
22361	1055	516	72047	3152	0	76770
22362	1099	648	2231	71747	0	75725
22363	687	541	70949	3051	0	75228
22364	682	395	66003	1573	0	68653
22365	533	495	67749	1198	0	69975
22366	963	487	2563	63332	0	67345
22367	669	274	1386	66696	0	69025
22368	65353	295	845	2827	0	69320
22369	2000	301	688	63403	0	66392
22370	899	67158	692	2488	0	71237
22371	832	1630	723	69412	0	72597
22372	597	731	791	68666	0	70785
22373	322	68641	725	2807	0	72495
22374	68312	1639	706	1837	0	72494
22375	67615	751	649	1485	0	70500
22376	2090	66684	740	1154	0	70668
22377	813	66272	599	964	0	68648
22378	992	3482	790	63290	0	68554
22379	64804	945	608	2206	0	68563
22380	1741	673	64512	1161	0	68087
22381	829	542	58617	805	0	60793
22382	51635	321	1419	607	0	53982
22383	1199	54702	766	432	0	57099
22384	676	1254	475	54499	0	56904
22385	667	583	347	54272	0	55869
22386	525	410	335	55433	0	56703
22387	480	275	353	55451	0	56559
22388	304	54454	387	1740	0	56885
22389	405	1138	283	56175	0	58001
22390	55691	607	222	1743	0	58263
22391	1260	384	232	56792	0	58668
22392	632	250	262	57614	0	58758
22393	57186	213	285	2043	0	59727
22394	57349	227	293	1216	0	59085
22395	58286	270	262	886	0	59704
22396	59000	212	245	778	0	60235
22397	1913	175	229	58066	0	60383
22398	58350	189	216	1714	0	60469
22399	1562	166	223	58180	0	60131
22400	57587	145	214	1820	0	59766
22401	58014	185	225	993	0	59417
22402	1859	145	211	58125	0	60340
22403	997	146	58070	1478	0	60691
22404	58123	150	1110	1127	0	60510
22405	59781	176	519	865	0	61341
22406	59825	173	369	802	0	61169
22407	60114	156	240	658	0	61168
22408	2071	179	225	59899	0	62374
22409	992	184	60097	1415	0	62688
22410	721	241	59338	811	0	61111
22411	56725	210	1438	915	0	59288
22412	60829	171	762	620	0	62382
22413	1658	60330	441	443	0	62872
22414	897	60513	283	432	0	62125
22415	61978	1158	312	649	0	64097
22416	1335	562	367	60832	0	63096
22417	852	376	285	63273	0	64786
22418	62952	204	226	1661	0	65043
22419	1240	64233	218	797	0	66488
22420	65780	1019	157	884	0	67840
22421	1327	542	64830	478	0	67177
22422	64149	324	944	648	0	66065
22423	1391	220	431	65718	0	67760
22424	721	189	67186	1203	0	69299
22425	648	67298	910	784	0	69640
22426	630	908	434	69294	0	71266
22427	530	476	72237	1165	0	74408
22428	621	337	1061	71269	0	73288
22429	73587	146	565	1724	0	76022
22430	1235	193	72578	856	0	74862
22431	69799	135	1161	886	0	71981
22432	1340	74150	647	461	0	76598
22433	900	997	452	75485	0	77834
22434	607	541	79643	1153	0	81944
22435	745	301	1085	78180	0	80311
22436	513	268	81439	1410	0	83630
22437	464	79899	1276	787	0	82426
22438	78586	938	602	821	0	80947
22439	1081	82997	422	409	0	84909
22440	840	1108	255	82417	0	84620
22441	661	558	251	82891	0	84361
22442	407	395	80335	1415	0	82552
22443	67755	273	1010	1225	0	70263
22444	1079	76622	563	486	0	78750
22445	422	71821	232	245	0	72720
22446	288	73248	175	297	0	74008
22447	438	1130	230	71450	0	73248
22448	187	71814	190	678	0	72869
22449	355	800	172	70837	0	72164
22450	168	71315	159	653	0	72295
22451	248	621	82	70685	0	71636
22452	119	72577	93	475	0	73264
22453	71536	502	113	653	0	72804
22454	483	351	71070	211	0	72115
22455	67364	157	444	432	0	68397
22456	71149	131	216	446	0	71942
22457	72883	129	108	421	0	73541
22458	607	73549	130	117	0	74403
22459	74477	426	94	418	0	75415
22460	73955	237	91	414	0	74697
22461	74565	133	100	406	0	75204
22462	817	136	74434	105	0	75492
22463	589	108	452	74440	0	75589
22464	303	150	77476	495	0	78424
22465	344	117	532	75465	0	76458
22466	76193	90	283	879	0	77445
22467	638	75983	196	357	0	77174
22468	432	608	84713	190	0	85943
22469	655	303	873	83338	0	85169
22470	402	162	341	90520	0	91425
22471	207	194	98706	1367	0	100474
22472	94491	132	1538	847	0	97008
22473	100187	122	502	609	0	101420
22474	102801	123	247	497	0	103668
22475	2370	109	185	101261	0	103925
22476	768	98364	242	1737	0	101111
22477	458	104068	260	678	0	105464
22478	707	1944	172	103113	0	105936
22479	754	722	146	102136	0	103758
22480	332	102523	190	2040	0	105085
22481	102066	1635	136	1147	0	104984
22482	1664	102601	184	472	0	104921
22483	973	1811	139	101304	0	104227
22484	392	750	100573	1788	0	103503
22485	674	384	1632	98889	0	101579
22486	100902	353	539	2299	0	104093
22487	1934	343	100702	740	0	103719
22488	99637	284	1700	866	0	102487
22489	103596	280	756	897	0	105529
22490	105042	288	349	814	0	106493
22491	104894	330	264	896	0	106384
22492	107783	215	271	838	0	109107
22493	2694	258	103238	338	0	106528
22494	1292	370	102596	293	0	104551
22495	110432	186	2281	602	0	113501
22496	116589	247	854	564	0	118254
22497	3623	205	421	119827	0	124076
22498	1486	121764	426	2664	0	126340
22499	1255	2538	335	124444	0	128572
22500	126416	1050	312	3351	0	131129
22501	3543	509	313	121579	0	125944
22502	1544	127602	298	2870	0	132314
22503	127846	2708	238	1884	0	132676
22504	125653	1189	206	1341	0	128389
22505	126809	578	217	1191	0	128795
22506	4058	125086	286	651	0	130081
22507	2268	2715	314	125141	0	130438
22508	1625	1192	298	124259	0	127374
22509	1143	120939	267	3496	0	125845
22510	1454	2743	195	123615	0	128007
22511	121542	1254	177	3788	0	126761
22512	122260	780	170	2010	0	125220
22513	3994	120098	260	1127	0	125479
22514	2292	2846	227	120896	0	126261
22515	1603	1293	250	122469	0	125615
22516	1382	797	315	123350	0	125844
22517	118212	556	307	4693	0	123768
22518	3632	600	116090	1961	0	122283
22519	111367	562	2622	1826	0	116377
22520	3831	850	115336	1185	0	121202
22521	2421	591	2880	110559	0	116451
22522	1390	111556	1294	3410	0	117650
22523	1307	117592	685	1897	0	121481
22524	113255	3758	552	1827	0	119392
22525	113437	1747	462	1727	0	117373
22526	4239	110902	484	1205	0	116830
22527	1947	112155	443	1168	0	115713
22528	111808	3850	392	1472	0	117522
22529	114810	1810	418	1528	0	118566
22530	4402	115732	436	1130	0	121700
22531	117972	3374	421	1289	0	123056
22532	4307	1772	116060	834	0	122973
22533	116659	1174	2827	1204	0	121864
22534	116940	973	1235	1261	0	120409
22535	5120	900	702	113533	0	120255
22536	2674	112682	605	3408	0	119369
22537	2530	3271	523	113476	0	119800
22538	115685	1472	545	3880	0	121582
22539	4848	984	453	111376	0	117661
22540	3025	907	484	114412	0	118828
22541	2065	971	113651	4530	0	121217
22542	2275	787	2942	114305	0	120309
22543	2024	792	1304	118192	0	122312
22544	116276	865	769	5171	0	123081
22545	4096	914	115034	2525	0	122569
22546	115678	875	3181	2068	0	121802
22547	4668	824	1348	116899	0	123739
22548	2790	849	780	118598	0	123017
22549	2013	917	606	117771	0	121307
22550	1764	112109	634	4757	0	119264
22551	1788	116076	590	2670	0	121124
22552	2161	3866	528	114160	0	120715
22553	114144	1759	518	4265	0	120686
22554	115905	1196	535	2443	0	120079
22555	5302	1009	581	114018	0	120910
22556	114343	1002	463	4256	0	120064
22557	4842	969	438	113841	0	120090
22558	3049	915	419	115898	0	120281
22559	109202	852	547	5240	0	115841
22560	4385	113812	517	2657	0	121371
22561	114337	3227	418	2319	0	120301
22562	114041	1523	414	2237	0	118215
22563	112265	963	417	2256	0	115901
22564	4959	110250	460	1762	0	117431
22565	3002	3532	433	111103	0	118070
22566	2395	1606	466	113606	0	118073
22567	1967	1091	108407	4853	0	116318
22568	2137	1374	2657	100829	0	106997
22569	1650	899	97302	3828	0	103679
22570	1425	90332	2526	2161	0	96444
22571	974	80692	1100	1442	0	84208
22572	1074	82998	679	1191	0	85942
22573	1514	2633	1073	83196	0	88416
22574	1119	1279	440	84044	0	86882
22575	866	836	288	84596	0	86586
22576	872	699	280	85172	0	87023
22577	694	677	84445	3360	0	89176
22578	664	741	99902	2014	0	103321
22579	945	638	2900	104684	0	109167
22580	775	527	107539	3456	0	112297
22581	106110	417	2900	2228	0	111655
22582	109350	369	1310	1743	0	112772
22583	3672	503	108128	1428	0	113731
22584	2131	430	2805	107900	0	113266
22585	1671	447	1401	110359	0	113878
22586	1557	462	827	111706	0	114552
22587	1606	431	777	109654	0	112468
22588	1578	429	635	111327	0	113969
22589	78643	1192	882	6036	0	86753
22590	106554	455	605	3004	0	110618
22591	3434	106516	456	2206	0	112612
22592	1615	2641	102701	1693	0	108650
22593	1048	100860	2597	1720	0	106225
22594	957	103473	1183	1500	0	107113
22595	95752	2662	695	1448	0	100557
22596	2413	94504	598	1049	0	98564
22597	896	88654	424	551	0	90525
22598	86354	2311	499	775	0	89939
22599	1973	938	85549	480	0	88940
22600	82528	703	1629	705	0	85565
22601	2044	583	573	84738	0	87938
22602	1173	391	343	82394	0	84301
22603	806	394	314	83583	0	85097
22604	598	404	81111	2488	0	84601
22605	591	81302	1757	1237	0	84887
22606	81375	1588	752	1195	0	84910
22607	2019	591	564	81665	0	84839
22608	667	83063	457	2386	0	86573
22609	695	1837	605	85762	0	88899
22610	622	858	85571	2302	0	89353
22611	956	603	1888	85403	0	88850
22612	872	589	768	88131	0	90360
22613	891	482	430	89239	0	91042
22614	87439	436	361	3410	0	91646
22615	2206	391	422	88526	0	91545
22616	823	283	87036	3205	0	91347
22617	627	86845	2031	1867	0	91370
22618	870	1854	697	88223	0	91644
22619	935	730	553	89381	0	91599
22620	553	707	86740	3070	0	91070
22621	685	538	85248	1359	0	87830
22622	83332	682	2866	1514	0	88394
22623	82689	658	1336	1425	0	86108
22624	2695	84387	1028	1072	0	89182
22625	84438	2105	677	1298	0	88518
22626	2564	923	83882	1120	0	88489
22627	1323	548	83059	1087	0	86017
22628	81313	512	2752	1685	0	86262
22629	80768	421	1038	1639	0	83866
22630	2727	393	78004	1525	0	82649
22631	75790	428	2171	1589	0	79978
22632	2596	402	77676	1151	0	81825
22633	76367	460	2593	844	0	80264
22634	77931	786	1134	805	0	80656
22635	2988	867	869	73352	0	78076
22636	1376	79417	885	2199	0	83877
22637	59634	2740	1228	1943	0	65545
22638	2250	1161	79355	837	0	83603
22639	1363	79862	2349	686	0	84260
22640	80042	2557	841	1098	0	84538
22641	77228	1111	649	1155	0	80143
22642	2869	76575	801	1162	0	81407
22643	1633	2154	961	77006	0	81754
22644	1340	804	75954	2728	0	80826
22645	1105	599	2486	76522	0	80712
22646	970	863	75802	2990	0	80625
22647	1017	606	2557	75626	0	79806
22648	966	655	1314	76929	0	79864
22649	807	874	74892	2967	0	79540
22650	931	74592	2526	1808	0	79857
22651	1064	2181	1184	74314	0	78743
22652	984	1296	57507	3369	0	63156
22653	73400	801	1984	1744	0	77929
22654	2529	603	1117	75522	0	79771
22655	1274	509	971	77196	0	79950
22656	75317	509	976	3388	0	80190
22657	2944	588	699	74650	0	78881
22658	1848	472	620	73394	0	76334
22659	1032	73402	1029	3029	0	78492
22660	1287	2093	862	72928	0	77170
22661	849	993	71754	2987	0	76583
22662	1100	517	2295	69348	0	73260
22663	1089	69205	1257	2664	0	74215
22664	844	71492	1164	1558	0	75058
22665	1015	2444	916	71104	0	75479
22666	71080	1215	808	2471	0	75574
22667	2516	993	951	71102	0	75562
22668	71184	1042	894	2620	0	75740
22669	3037	610	902	71565	0	76114
22670	71243	626	1036	2782	0	75687
22671	73338	667	864	1686	0	76555
22672	3486	900	722	70979	0	76087
22673	2291	2668	1092	68468	0	74519
22674	1463	67304	979	3153	0	72899
22675	1482	69719	887	1624	0	73712
22676	1363	2054	68589	1607	0	73613
22677	1312	65894	1922	1449	0	70577
22678	46050	1585	1571	1098	0	50304
22679	1410	543	547	44945	0	47445
22680	561	43360	387	1084	0	45392
22681	44560	977	315	788	0	46640
22682	1212	458	300	44733	0	46703
22683	744	298	327	43994	0	45363
22684	600	250	285	45023	0	46158
22685	512	302	332	45025	0	46171
22686	412	44138	386	1493	0	46429
22687	455	47138	329	755	0	48677
22688	48404	984	272	719	0	50379
22689	1277	49439	281	525	0	51522
22690	654	1114	295	49228	0	51291
22691	655	448	204	49748	0	51055
22692	580	376	240	49828	0	51024
22693	509	326	200	50414	0	51449
22694	49215	291	191	1814	0	51511
22695	50347	255	255	984	0	51841
22696	1508	277	49445	656	0	51886
22697	869	222	1124	49998	0	52213
22698	571	249	50902	1537	0	53259
22699	639	278	1279	50778	0	52974
22700	568	295	528	52499	0	53890
22701	51863	234	380	2015	0	54492
22702	1539	274	372	52166	0	54351
22703	658	254	51818	1702	0	54432
22704	509	280	49699	878	0	51366
22705	50486	272	1427	966	0	53151
22706	1343	251	52119	695	0	54408
22707	751	278	1295	49657	0	51981
22708	400	197	51652	1508	0	53757
22709	528	363	1204	49422	0	51517
22710	273	49845	553	1448	0	52119
22711	407	1079	373	49589	0	51448
22712	228	48970	319	1234	0	50751
22713	182	49760	246	728	0	50916
22714	304	1145	250	48580	0	50279
22715	47756	412	189	1342	0	49699
22716	857	48815	157	572	0	50401
22717	463	910	121	49092	0	50586
22718	49002	396	119	1313	0	50830
22719	49832	269	109	769	0	50979
22720	50878	222	96	601	0	51797
22721	1328	191	113	50099	0	51731
22722	643	199	129	50822	0	51793
22723	50889	165	117	1533	0	52704
22724	50747	162	137	854	0	51900
22725	51444	159	105	692	0	52400
22726	1426	169	121	51003	0	52719
22727	621	209	49133	1037	0	51000
22728	48611	151	730	737	0	50229
22729	1134	156	283	48717	0	50290
22730	560	49907	199	1080	0	51746
22731	560	858	127	49478	0	51023
22732	361	49633	156	1063	0	51213
22733	475	845	121	50718	0	52159
22734	347	387	49597	1091	0	51422
22735	241	49172	737	628	0	50778
22736	351	745	284	46952	0	48332
22737	308	303	176	47153	0	47940
22738	312	244	121	47005	0	47682
22739	47643	182	104	1340	0	49269
22740	865	48199	134	670	0	49868
22741	503	921	126	49773	0	51323
22742	50476	373	122	1346	0	52317
22743	51013	255	123	728	0	52119
22744	1424	206	85	51235	0	52950
22745	646	192	52142	1281	0	54261
22746	544	211	964	51180	0	52899
22747	291	52056	402	1376	0	54125
22748	419	1023	238	53474	0	55154
22749	53048	397	176	1565	0	55186
22750	1299	270	144	55591	0	57304
22751	582	193	56380	1508	0	58663
22752	388	60265	1111	802	0	62566
22753	61197	1352	442	750	0	63741
22754	1481	590	61833	507	0	64411
22755	62327	307	1425	582	0	64641
22756	1812	214	554	64718	0	67298
22757	958	141	342	65344	0	66785
22758	469	65565	270	1949	0	68253
22759	68686	1429	193	1103	0	71411
22760	1879	558	241	69650	0	72328
22761	1081	287	206	71097	0	72671
22762	777	190	214	73298	0	74479
22763	413	220	72830	2477	0	75940
22764	559	180	1616	72692	0	75047
22765	73783	154	646	2369	0	76952
22766	76020	193	349	1335	0	77897
22767	2372	168	234	75546	0	78320
22768	1134	179	212	76758	0	78283
22769	75396	177	205	2627	0	78405
22770	1895	220	73921	1172	0	77208
22771	72745	169	1639	979	0	75532
22772	2089	257	72790	556	0	75692
22773	964	206	73286	543	0	74999
22774	870	170	2074	73055	0	76169
22775	541	178	75395	1930	0	78044
22776	74436	166	1865	1158	0	77625
22777	2042	157	782	77885	0	80866
22778	843	160	77853	1921	0	80777
22779	75481	162	1729	1205	0	78577
22780	78319	151	679	987	0	80136
22781	2312	163	81652	599	0	84726
22782	1412	341	1664	77628	0	81045
22783	726	83226	734	1655	0	86341
22784	84388	1460	531	1158	0	87537
22785	2003	611	85583	592	0	88789
22786	79519	414	1617	873	0	82423
22787	1921	84078	763	526	0	87288
22788	82108	1291	565	723	0	84687
22789	82084	497	295	775	0	83651
22790	84049	264	275	655	0	85243
22791	2125	332	321	83249	0	86027
22792	1009	83893	321	1474	0	86697
22793	684	1353	82873	778	0	85688
22794	539	85148	1362	576	0	87625
22795	857	1531	596	77958	0	80942
22796	448	82952	427	1292	0	85119
22797	409	85301	342	697	0	86749
22798	82829	1497	257	737	0	85320
22799	1460	632	82449	400	0	84941
22800	770	410	84656	372	0	86208
22801	601	339	85142	356	0	86438
22802	486	86831	1568	399	0	89284
22803	87231	1142	726	682	0	89781
22804	87449	477	399	614	0	88939
22805	86958	296	330	623	0	88207
22806	1666	86452	305	475	0	88898
22807	903	1106	269	89780	0	92058
22808	570	552	88835	1385	0	91342
22809	593	445	87562	793	0	89393
22810	90736	300	1511	997	0	93544
22811	94743	258	681	789	0	96471
22812	94944	278	467	749	0	96438
22813	1927	243	92634	569	0	95373
22814	92583	163	1397	760	0	94903
22815	1826	203	654	94384	0	97067
22816	1152	203	439	94819	0	96613
22817	790	280	100391	1836	0	103297
22818	704	100786	1349	991	0	103830
22819	768	1173	699	102673	0	105313
22820	590	543	101345	1672	0	104150
22821	96349	291	1513	1305	0	99458
22822	1696	226	826	102925	0	105673
22823	1054	188	666	103662	0	105570
22824	103116	205	568	2199	0	106088
22825	1972	147	395	103733	0	106247
22826	103481	136	486	2214	0	106317
22827	103737	172	502	1432	0	105843
22828	2193	177	495	103899	0	106764
22829	1372	204	579	104425	0	106580
22830	104077	191	572	2220	0	107060
22831	1947	168	661	105254	0	108030
22832	106359	208	679	2065	0	109311
22833	105512	246	640	1345	0	107743
22834	105354	219	589	1055	0	107217
22835	2404	217	589	104605	0	107815
22836	1535	232	545	105144	0	107456
22837	105594	201	527	2151	0	108473
22838	1864	103180	660	869	0	106573
22839	1073	101985	556	477	0	104091
22840	101534	1066	565	852	0	104017
22841	1450	568	99056	445	0	101519
22842	98372	305	1124	684	0	100485
22843	1493	255	569	104125	0	106442
22844	852	306	103178	967	0	105303
22845	102334	215	1026	860	0	104435
22846	1465	273	446	105332	0	107516
22847	1125	235	307	106376	0	108043
22848	990	268	288	108524	0	110070
22849	1033	240	188	108291	0	109752
22850	107261	236	329	1705	0	109531
22851	1075	105731	308	604	0	107718
22852	99234	546	141	746	0	100667
22853	758	323	99492	166	0	100739
22854	538	237	94485	125	0	95385
22855	349	100756	556	130	0	101791
22856	713	841	458	99387	0	101399
22857	230	290	99216	376	0	100112
22858	215	91725	417	395	0	92752
22859	118	260	94080	60	0	94518
22860	278	49	163	92330	0	92820
22861	195	36	57	91856	0	92144
22862	93480	15	47	619	0	94161
22863	267	24	30	91604	0	91925
22864	91352	17	24	646	0	92039
22865	221	70	91230	63	0	91584
22866	74	91941	193	72	0	92280
22867	225	150	45	95847	0	96267
22868	179	57	36	101728	0	102000
22869	81	95	102643	187	0	103006
22870	163	183	94798	106	0	95250
22871	95603	37	216	600	0	96456
22872	103132	17	67	564	0	103780
22873	304	17	55	103699	0	104075
22874	236	21	35	102663	0	102955
22875	68	101997	69	224	0	102358
22876	122	157	28	105318	0	105625
22877	105420	52	27	934	0	106433
22878	106233	31	29	712	0	107005
22879	413	109304	95	110	0	109922
22880	110222	497	16	599	0	111334
22881	108292	149	31	504	0	108976
22882	972	84	26	117161	0	118243
22883	289	117626	104	1261	0	119280
22884	451	1306	25	119752	0	121534
22885	399	250	21	120452	0	121122
22886	145	226	117732	1686	0	119789
22887	116882	69	1405	867	0	119223
22888	2020	114	256	128950	0	131340
22889	927	91	121	136337	0	137476
22890	333	156058	171	2774	0	159336
22891	851	3207	49	166607	0	170714
22892	168460	884	79	4923	0	174346
22893	180596	575	67	2145	0	183383
22894	5563	671	176263	1019	0	183516
22895	1914	512	178329	826	0	181581
22896	2268	369	5408	178210	0	186255
22897	1993	209	1639	187804	0	191645
22898	981	238	185902	5966	0	193087
22899	793	291	187479	2034	0	190597
22900	1610	130	6456	176751	0	184947
22901	608	204	186453	5806	0	193071
22902	611	278	187224	2203	0	190316
22903	1306	142	7009	180756	0	189213
22904	185107	170	2834	6512	0	194623
22905	190204	143	2032	2795	0	195174
22906	6768	163	1608	186253	0	194792
22907	3077	134	1347	189466	0	194024
22908	185456	106	1234	7299	0	194095
22909	6640	139	961	182910	0	190650
22910	180169	145	945	7470	0	188729
22911	183161	135	836	3570	0	187702
22912	7658	222	682	181246	0	189808
22913	3727	285	709	185472	0	190193
22914	179420	179	673	8141	0	188413
22915	6457	176340	813	3539	0	187149
22916	2803	181682	895	2787	0	188167
22917	2905	5658	763	173905	0	183231
22918	1921	1901	171956	6706	0	182484
22919	2431	1281	5244	171701	0	180657
22920	171507	1049	1791	7670	0	182017
22921	6393	792	1398	172954	0	181537
22922	173203	708	1311	7755	0	182977
22923	6500	813	170907	3735	0	181955
22924	171341	585	5683	3246	0	180855
22925	7333	512	2125	173880	0	183850
22926	3850	378	1376	180013	0	185617
22927	2559	477	180329	7821	0	191186
22928	3263	449	5630	179849	0	189191
22929	2484	465	2184	185747	0	190880
22930	2241	564	1694	189852	0	194351
22931	182894	597	1490	9693	0	194674
22932	6287	523	181589	5004	0	193403
22933	3200	557	180348	3938	0	188043
22934	178591	335	6848	4182	0	189956
22935	185162	293	3189	3915	0	192559
22936	7996	477	185467	2975	0	196915
22937	4419	435	6816	177767	0	189437
22938	3079	184420	3458	6863	0	197820
22939	3125	4956	2912	191117	0	202110
22940	188404	1426	2718	8667	0	201215
22941	192918	943	2676	5039	0	201576
22942	8000	855	2743	188502	0	200100
22943	3836	185770	2558	8380	0	200544
22944	3936	5162	2260	182191	0	193549
22945	3378	186306	2387	7710	0	199781
22946	187670	5638	2226	5290	0	200824
22947	181477	2228	2235	4844	0	190784
22948	185442	1354	2147	4685	0	193628
22949	8858	173695	2166	4059	0	188778
22950	4732	182822	2170	4123	0	193847
22951	4524	6637	1758	183925	0	196844
22952	4308	2623	1657	187500	0	196088
22953	4125	1786	1647	185977	0	193535
22954	3958	1517	1511	190328	0	197314
22955	3622	1407	178410	10504	0	193943
22956	173175	1411	6111	6721	0	187418
22957	8125	1548	180668	5260	0	195601
22958	182906	1296	6767	5480	0	196449
22959	8665	1380	186351	4534	0	200930
22960	185841	1117	7161	5178	0	199297
22961	9077	1180	190321	4210	0	204788
22962	189531	965	7561	4425	0	202482
22963	9694	1044	3780	192582	0	207100
22964	196442	1033	3110	9033	0	209618
22965	9741	961	2691	197318	0	210711
22966	5707	919	2451	200263	0	209340
22967	4683	855	2451	194498	0	202487
22968	4078	182988	2345	10545	0	199956
22969	184651	5612	2101	6849	0	199213
22970	186791	2038	1852	5930	0	196611
22971	9550	183489	1960	5014	0	200013
22972	5571	6130	1694	187450	0	200845
22973	4441	2473	181849	9221	0	197984
22974	181047	1679	6551	5891	0	195168
22975	188875	1480	2912	5174	0	198441
22976	188134	1240	2420	4768	0	196562
22977	10534	1113	2323	176345	0	190315
22978	5700	173757	2121	8146	0	189724
22979	5108	5742	2002	175246	0	188098
22980	174621	2155	1949	8678	0	187403
22981	9203	1650	1842	166242	0	178937
22982	4476	160367	1771	6912	0	173526
22983	157775	4906	1548	4747	0	168976
22984	7511	2393	156962	3439	0	170305
22985	4914	1918	154154	3387	0	164373
22986	3582	152930	5971	3145	0	165628
22987	3420	151240	2678	2666	0	160004
22988	4348	5043	141482	2393	0	153266
22989	3606	2534	132235	2017	0	140392
22990	2760	7900	3848	99712	0	114220
22991	103426	699	1674	2661	0	108460
22992	2273	646	102723	1046	0	106688
22993	789	94073	1339	695	0	96896
22994	93622	1128	985	990	0	96725
22995	1300	92997	460	393	0	95150
22996	88892	895	276	663	0	90726
22997	968	88294	295	268	0	89825
22998	527	89769	277	300	0	90873
22999	602	967	357	90376	0	92302
23000	537	482	284	90194	0	91497
23001	427	382	85534	868	0	87211
23002	568	238	697	83325	0	84828
23003	84473	270	320	1336	0	86399
23004	84663	229	184	913	0	85989
23005	1072	249	157	83483	0	84961
23006	567	311	81848	877	0	83603
23007	465	257	79248	566	0	80536
23008	469	180	885	82290	0	83824
23009	322	194	84287	896	0	85699
23010	437	185	906	83226	0	84754
23011	623	176	475	81483	0	82757
23012	277	221	92053	1116	0	93667
23013	86528	515	1353	1057	0	89453
23014	91941	179	723	875	0	93718
23015	1685	235	93762	318	0	96000
23016	885	218	95068	329	0	96500
23017	932	160	2294	96856	0	100242
23018	699	144	929	107576	0	109348
23019	591	169	523	111418	0	112701
23020	719	200	420	109985	0	111324
23021	110014	172	370	3631	0	114187
23022	116298	173	353	1667	0	118491
23023	3433	200	331	123614	0	127578
23024	1710	180	283	130508	0	132681
23025	701	268	136839	4112	0	141920
23026	1110	158	3486	139665	0	144419
23027	941	138	1519	147760	0	150358
23028	148096	123	771	6581	0	155571
23029	4449	158114	590	2788	0	165941
23030	2428	4543	371	158846	0	166188
23031	1682	1617	340	162322	0	165961
23032	1331	775	400	159349	0	161855
23033	566	143406	625	7761	0	152358
23034	539	157214	518	3559	0	161830
23035	1189	5923	380	155766	0	163258
23036	1136	2249	323	156111	0	159819
23037	1066	1160	379	158874	0	161479
23038	146271	712	428	8708	0	156119
23039	4597	149748	444	4090	0	158879
23040	150299	5008	394	2947	0	158648
23041	154640	2167	342	2316	0	159465
23042	7179	1304	294	147889	0	156666
23043	2843	147376	358	6058	0	156635
23044	147722	5225	244	3644	0	156835
23045	6158	2274	212	148525	0	157169
23046	149204	1398	283	6836	0	157721
23047	6733	1105	264	150766	0	158868
23048	2966	1010	147859	6772	0	158607
23049	1831	932	151308	3567	0	157638
23050	2007	731	6077	149951	0	158766
23051	1777	750	2405	152703	0	157635
23052	1864	801	1204	149868	0	153737
23053	1374	142880	840	7939	0	153033
23054	1321	154413	689	4094	0	160517
23055	149083	6252	635	3248	0	159218
23056	149290	2789	603	2842	0	155524
23057	6637	146598	684	2302	0	156221
23058	2762	144270	537	1992	0	149561
23059	1659	149816	470	1974	0	153919
23060	137897	6664	520	2521	0	147602
23061	4872	141576	538	1855	0	148841
23062	2816	5629	523	140821	0	149789
23063	138906	2520	534	6085	0	148045
23064	140989	1616	486	3347	0	146438
23065	6930	1285	401	135605	0	144221
23066	3071	1391	132168	5879	0	142509
23067	1927	1421	134885	2981	0	141214
23068	2025	1296	5652	134045	0	143018
23069	1567	1214	136391	5877	0	145049
23070	1845	1197	5225	135405	0	143672
23071	1763	1169	2208	136990	0	142130
23072	1320	1178	134255	7363	0	144116
23073	1433	1168	136095	3754	0	142450
23074	1669	1103	6427	132967	0	142166
23075	1498	1018	2920	140347	0	145783
23076	132763	932	1813	8201	0	143709
23077	5318	131231	1360	4530	0	142439
23078	2585	139734	1203	3473	0	146995
23079	131930	6211	1177	3403	0	142721
23080	138195	2818	1219	3267	0	145499
23081	6622	133812	1260	3093	0	144787
23082	3248	138729	1225	2962	0	146164
23083	136179	6602	953	3304	0	147038
23084	6153	3239	903	135909	0	146204
23085	132927	2013	959	7467	0	143366
23086	6269	133517	1032	4464	0	145282
23087	134832	5576	983	3815	0	145206
23088	6716	2910	131542	3271	0	144439
23089	132109	2019	4823	3236	0	142187
23090	6924	1884	132576	2955	0	144339
23091	3941	1818	5384	131390	0	142533
23092	130113	1721	2451	7356	0	141641
23093	6448	1727	126644	4535	0	139354
23094	3820	1787	5301	128983	0	139891
23095	127755	1801	2494	7444	0	139494
23096	6585	1926	126208	4534	0	139253
23097	3955	1707	5281	129144	0	140087
23098	125615	1749	2338	7690	0	137392
23099	6185	124703	1642	4803	0	137333
23100	3832	5651	1250	127781	0	138514
23101	3284	3121	1121	128498	0	136024
23102	2881	2368	1102	129427	0	135778
23103	2527	125670	1227	8515	0	137939
23104	2877	5788	1049	131318	0	141032
23105	2912	2934	1076	134423	0	141345
23106	3069	2189	1024	135002	0	141284
23107	3202	1833	998	138063	0	144096
23108	2853	1874	128874	8948	0	142549
23109	124548	1786	5261	5319	0	136914
23110	130906	1467	2574	4134	0	139081
23111	7720	127561	1816	3471	0	140568
23112	3964	5099	1191	121671	0	131925
23113	2937	2496	1189	123749	0	130371
23114	2120	119607	1354	7926	0	131007
23115	2098	4338	1283	120519	0	128238
23116	113425	2070	1408	6853	0	123756
23117	4390	110970	1509	3974	0	120843
23118	104397	3942	1338	2934	0	112611
23119	4598	1909	948	103740	0	111195
23120	2099	1410	101791	5474	0	110774
23121	1478	102185	3659	3408	0	110730
23122	94503	3766	2190	2578	0	103037
23123	3461	86194	1089	1556	0	92300
23124	1864	84838	699	1215	0	88616
23125	71912	2521	1179	1165	0	76777
23126	2266	1059	70983	844	0	75152
23127	718	61769	1341	666	0	64494
23128	49793	2412	3438	1280	0	56923
23129	44517	343	449	326	0	45635
23130	686	44549	86	151	0	45472
23131	398	586	50	45760	0	46794
23132	194	242	47025	616	0	48077
23133	243	192	534	46234	0	47203
23134	339	149	202	44516	0	45206
23135	235	124	104	48565	0	49028
23136	161	174	48258	765	0	49358
23137	303	138	521	46262	0	47224
23138	156	155	48197	669	0	49177
23139	181	155	45195	301	0	45832
23140	41270	135	665	390	0	42460
23141	568	46538	253	181	0	47540
23142	237	47713	156	166	0	48272
23143	305	669	100	49617	0	50691
23144	54618	276	92	919	0	55905
23145	55226	152	130	513	0	56021
23146	53627	121	121	412	0	54281
23147	54646	126	85	323	0	55180
23148	52780	131	92	279	0	53282
23149	903	142	51404	170	0	52619
23150	474	107	620	50952	0	52153
23151	222	51126	248	642	0	52238
23152	244	657	155	52311	0	53367
23153	52688	238	94	884	0	53904
23154	702	52057	116	340	0	53215
23155	394	692	95	53463	0	54644
23156	53515	259	94	896	0	54764
23157	55168	177	113	536	0	55994
23158	1026	136	109	55012	0	56283
23159	565	122	99	53966	0	54752
23160	371	136	86	55143	0	55736
23161	242	156	54288	970	0	55656
23162	256	198	54818	458	0	55730
23163	357	128	830	55829	0	57144
23164	280	143	315	57262	0	58000
23165	56998	144	169	1123	0	58434
23166	56698	135	120	636	0	57589
23167	57746	123	134	539	0	58542
23168	59198	162	112	539	0	60011
23169	58791	136	136	490	0	59553
23170	1026	59909	141	315	0	61391
23171	61749	725	111	525	0	63110
23172	62216	287	105	528	0	63136
23173	62215	202	125	447	0	62989
23174	1197	147	102	64321	0	65767
23175	533	153	63662	989	0	65337
23176	497	137	846	64826	0	66306
23177	362	147	69429	1124	0	71062
23178	495	167	927	66385	0	67974
23179	322	69679	374	1002	0	71377
23180	70239	918	187	661	0	72005
23181	72935	337	152	585	0	74009
23182	1435	208	128	74069	0	75840
23183	737	156	140	76898	0	77931
23184	546	160	112	77245	0	78063
23185	402	78363	157	1265	0	80187
23186	78130	981	107	809	0	80027
23187	78387	336	129	606	0	79458
23188	1379	79309	131	354	0	81173
23189	720	999	162	79849	0	81730
23190	527	349	125	79180	0	80181
23191	312	80162	187	1306	0	81967
23192	80950	1034	114	870	0	82968
23193	81312	392	122	608	0	82434
23194	1669	224	103	81083	0	83079
23195	680	201	81462	1243	0	83586
23196	504	235	78373	608	0	79720
23197	529	153	1278	83562	0	85522
23198	526	184	434	83504	0	84648
23199	470	198	244	86827	0	87739
23200	85676	147	155	2007	0	87985
23201	87134	164	163	1061	0	88522
23202	1719	90826	210	611	0	93366
23203	91205	1281	208	813	0	93507
23204	1673	433	91617	379	0	94102
23205	717	359	90966	299	0	92341
23206	504	95575	1590	364	0	98033
23207	92516	1280	676	640	0	95112
23208	1302	92962	315	325	0	94904
23209	92637	1292	219	559	0	94707
23210	1464	473	92458	271	0	94666
23211	610	305	91090	313	0	92318
23212	772	190	1403	89075	0	91440
23213	415	254	94624	1340	0	96633
23214	723	164	1289	94448	0	96624
23215	1219	270	570	83919	0	85978
23216	314	95681	352	1550	0	97897
23217	554	1216	265	97189	0	99224
23218	500	448	311	98127	0	99386
23219	99870	305	268	2065	0	102508
23220	1420	99925	265	729	0	102339
23221	831	1339	256	102410	0	104836
23222	478	556	102103	1544	0	104681
23223	90273	319	1448	1220	0	93260
23224	1623	289	101666	560	0	104138
23225	905	250	1543	98796	0	101494
23226	445	105918	582	1571	0	108516
23227	678	1672	395	105835	0	108580
23228	107359	574	272	2365	0	110570
23229	107495	361	263	1268	0	109387
23230	2342	110912	296	652	0	114202
23231	113419	1858	232	1125	0	116634
23232	113935	719	249	1086	0	115989
23233	114103	487	255	1207	0	116052
23234	117984	345	249	890	0	119468
23235	111741	306	356	1162	0	113565
23236	2637	361	115337	402	0	118737
23237	1462	290	1877	113548	0	117177
23238	1230	307	769	112482	0	114788
23239	849	308	441	115363	0	116961
23240	546	115781	373	2546	0	119246
23241	908	1857	290	115173	0	118228
23242	712	758	115520	2145	0	119135
23243	589	112256	1876	956	0	115677
23244	521	111222	773	670	0	113186
23245	870	2165	481	109955	0	113471
23246	817	790	383	110392	0	112382
23247	831	496	323	108614	0	110264
23248	488	106381	393	2556	0	109818
23249	491	109778	386	1192	0	111847
23250	108128	2140	356	1168	0	111792
23251	108330	872	273	1121	0	110596
23252	2242	109846	350	703	0	113141
23253	111398	1849	338	1129	0	114714
23254	116154	809	392	1199	0	118554
23255	2643	556	406	117048	0	120653
23256	1480	463	406	119692	0	122041
23257	1036	489	323	120747	0	122595
23258	687	580	119513	2817	0	123597
23259	773	571	118411	1287	0	121042
23260	704	126485	2572	895	0	130656
23261	128432	2340	964	1262	0	132998
23262	2800	1128	129685	595	0	134208
23263	127148	657	2543	1205	0	131553
23264	3197	514	138967	631	0	143309
23265	136565	481	2985	1188	0	141219
23266	3248	145042	1210	674	0	150174
23267	145090	2869	700	1162	0	149821
23268	3733	1093	520	142926	0	148272
23269	1967	713	483	146568	0	149731
23270	1052	725	145472	3832	0	151081
23271	789	149612	2712	1766	0	154879
23272	1218	2977	1169	150781	0	156145
23273	814	1327	150406	3105	0	155652
23274	136618	798	2920	1978	0	142314
23275	2838	148017	1225	1006	0	153086
23276	144873	2746	635	1400	0	149654
23277	2880	142538	588	819	0	146825
23278	1650	2941	468	142475	0	147534
23279	140235	1107	511	3478	0	145331
23280	2676	140700	639	2705	0	146720
23281	1616	2657	455	142180	0	146908
23282	892	1261	139843	2964	0	144960
23283	130815	741	2575	1756	0	135887
23284	3199	651	890	138603	0	143343
23285	1305	712	137488	2898	0	142403
23286	969	136996	2488	1520	0	141973
23287	1123	2607	967	137644	0	142341
23288	895	1134	137629	2878	0	142536
23289	1273	905	2580	131321	0	136079
23290	822	136646	1137	2706	0	141311
23291	741	140247	772	1445	0	143205
23292	849	3113	137998	795	0	142755
23293	1329	1305	2524	134982	0	140140
23294	667	865	139000	2819	0	143351
23295	133010	606	2743	1785	0	138144
23296	2985	667	1118	133733	0	138503
23297	1202	132082	731	2506	0	136521
23298	847	139159	576	1206	0	141788
23299	134282	2900	482	1364	0	139028
23300	2265	139489	509	802	0	143065
23301	136625	2506	543	1352	0	141026
23302	2558	1058	134787	570	0	138973
23303	125027	651	2187	1142	0	129007
23304	2391	132121	922	493	0	135927
23305	130691	2351	646	954	0	134642
23306	2394	129949	447	554	0	133344
23307	1337	2492	356	127953	0	132138
23308	999	1028	333	132110	0	134470
23309	573	784	129964	2776	0	134097
23310	121509	573	2156	1793	0	126031
23311	2357	698	131153	687	0	134895
23312	131256	552	2470	862	0	135140
23313	3040	595	901	131585	0	136121
23314	1513	553	578	133261	0	135905
23315	774	135841	521	3320	0	140456
23316	977	2702	503	140536	0	144718
23317	1046	1118	444	143730	0	146338
23318	574	804	141378	3642	0	146398
23319	127692	572	2770	2279	0	133313
23320	2744	137612	1150	969	0	142475
23321	136402	2684	622	1228	0	140936
23322	3202	1115	525	136137	0	140979
23323	1627	632	470	138372	0	141101
23324	135313	446	566	4148	0	140473
23325	2839	138327	642	1593	0	143401
23326	132207	2457	388	1353	0	136405
23327	2776	131397	487	707	0	135367
23328	1158	132432	371	566	0	134527
23329	130363	3068	577	1002	0	135010
23330	3038	1259	470	127327	0	132094
23331	1218	822	126344	2592	0	130976
23332	1282	612	2425	123794	0	128113
23333	1074	553	942	124192	0	126761
23334	667	124708	676	3141	0	129192
23335	1138	2729	337	126334	0	130538
23336	957	1228	313	127038	0	129536
23337	987	706	319	128894	0	130906
23338	904	590	390	131044	0	132928
23339	545	697	128816	3965	0	134023
23340	599	699	131320	1703	0	134321
23341	946	675	3357	133075	0	138053
23342	562	700	134494	3455	0	139211
23343	711	629	133322	1546	0	136208
23344	1096	558	3640	133110	0	138404
23345	546	697	139118	3583	0	143944
23346	1135	531	3407	131429	0	136502
23347	472	138587	1474	3471	0	144004
23348	142613	3139	812	2436	0	149000
23349	3340	1339	152332	1200	0	158211
23350	1924	832	3859	150812	0	157427
23351	888	635	156582	4370	0	162475
23352	1261	533	4266	163965	0	170025
23353	1278	567	1736	169299	0	172880
23354	164467	610	1112	6629	0	172818
23355	5249	549	879	168364	0	175041
23356	159156	601	892	6286	0	166935
23357	164506	489	838	3315	0	169148
23358	5876	162099	864	1710	0	170549
23359	158389	4345	678	1909	0	165321
23360	4904	155311	703	1405	0	162323
23361	1923	160299	647	1165	0	164034
23362	153311	5314	882	1643	0	161150
23363	4777	1982	153090	1057	0	160906
23364	1826	1043	147969	909	0	151747
23365	139171	1145	5871	1302	0	147489
23366	142393	577	2090	1437	0	146497
23367	5007	142163	1049	895	0	149114
23368	144527	3911	699	1324	0	150461
23369	145854	1552	611	1492	0	149509
23370	144579	829	689	1097	0	147194
23371	6253	588	602	139392	0	146835
23372	138680	665	637	4603	0	144585
23373	4828	142935	597	1932	0	150292
23374	2691	4014	570	145741	0	153016
23375	2088	1644	554	147060	0	151346
23376	1317	145993	697	5212	0	153219
23377	1634	3888	667	148516	0	154705
23378	145697	1580	724	5289	0	153290
23379	148211	946	555	2643	0	152355
23380	5638	142626	602	1542	0	150408
23381	2533	147821	609	1198	0	152161
23382	145971	4882	450	1595	0	152898
23383	4969	2102	143826	1089	0	151986
23384	2513	1169	144950	1156	0	149788
23385	2238	948	4969	140611	0	148766
23386	2061	818	1872	146738	0	151489
23387	1473	991	143755	5262	0	151481
23388	1359	138262	4278	2479	0	146378
23389	2491	4163	1810	132951	0	141415
23390	1411	2057	143814	4392	0	151674
23391	1892	1097	4260	141803	0	149052
23392	1818	978	1879	141991	0	146666
23393	1396	146607	1205	5301	0	154509
23394	1637	4368	966	146245	0	153216
23395	1732	2036	884	148352	0	153004
23396	1665	1155	916	150510	0	154246
23397	146537	919	1005	6285	0	154746
23398	4894	829	863	142563	0	149149
23399	2389	144883	826	5103	0	153201
23400	144018	4089	746	2985	0	151838
23401	4815	1964	140265	1868	0	148912
23402	2671	1341	138974	1623	0	144609
23403	139383	895	5051	1891	0	147220
23404	5084	842	2229	142323	0	150478
23405	2418	968	144186	4829	0	152401
23406	2066	954	4179	142850	0	150049
23407	1771	928	1937	148926	0	153562
23408	144489	884	1279	6413	0	153065
23409	145319	837	1083	3549	0	150788
23410	5655	145579	1003	2216	0	154453
23411	3207	4085	968	143827	0	152087
23412	1926	1853	144232	4625	0	152636
23413	1461	149996	4056	2649	0	158162
23414	147245	3982	1872	2344	0	155443
23415	4395	151748	1301	1616	0	159060
23416	148655	4071	1057	1872	0	155655
23417	4797	1884	147870	1336	0	155887
23418	145226	1182	3835	1865	0	152108
23419	153186	987	1752	1762	0	157687
23420	5572	1086	156445	1345	0	164448
23421	3039	1250	4111	151602	0	160002
23422	1936	154168	1844	4293	0	162241
23423	1614	163700	1168	2186	0	168668
23424	1514	165706	975	1528	0	169723
23425	2006	5430	842	158184	0	166462
23426	1542	2271	162121	4248	0	170182
23427	1941	1394	3863	159108	0	166306
23428	1913	1108	1567	164994	0	169582
23429	1488	1169	162650	5232	0	170539
23430	1419	162534	4064	2393	0	170410
23431	1653	4118	1697	160907	0	168375
23432	162576	1678	1160	4943	0	170357
23433	4690	1148	987	163407	0	170232
23434	2408	989	855	163087	0	167339
23435	1553	162110	797	5340	0	169800
23436	162953	4071	709	3004	0	170737
23437	4792	1844	738	168739	0	176113
23438	2103	1227	167159	4425	0	174914
23439	1395	166406	3580	2430	0	173811
23440	162234	3606	1594	2112	0	169546
23441	3866	1685	163981	1248	0	170780
23442	160489	1155	3623	1687	0	166954
23443	4229	1058	1663	162038	0	168988
23444	1745	165148	1138	3552	0	171583
23445	162333	3445	873	2361	0	169012
23446	161945	1574	774	1936	0	166229
23447	4233	168104	915	1213	0	174465
23448	2385	3239	653	163914	0	170191
23449	1443	1278	574	160023	0	163318
23450	155028	767	613	4006	0	160414
23451	2729	156010	668	1744	0	161151
23452	1289	2457	422	144953	0	149121
23453	546	143161	436	1975	0	146118
23454	433	142772	358	909	0	144472
23455	833	1746	369	139266	0	142214
23456	138033	663	335	2112	0	141143
23457	1285	139905	315	782	0	142287
23458	819	1415	192	140512	0	142938
23459	639	550	195	141224	0	142608
23460	410	487	140178	1603	0	142678
23461	555	500	131633	758	0	133446
23462	312	139385	1477	576	0	141750
23463	375	1406	137756	462	0	139999
23464	655	585	1339	137423	0	140002
23465	361	538	143154	1344	0	145397
23466	709	345	1305	143540	0	145899
23467	603	359	437	146697	0	148096
23468	528	361	329	147989	0	149207
23469	145134	325	263	2435	0	148157
23470	1513	327	253	145178	0	147271
23471	777	314	223	145254	0	146568
23472	417	144872	266	1711	0	147266
23473	482	1338	212	143557	0	145589
23474	145186	536	215	2518	0	148455
23475	1240	149536	286	802	0	151864
23476	148856	1365	216	1546	0	151983
23477	1526	742	148386	528	0	151182
23478	726	701	149040	566	0	151033
23479	1023	456	1571	153824	0	156874
23480	652	405	609	159939	0	161605
23481	398	160122	520	2193	0	163233
23482	1385	1879	451	147540	0	151255
23483	158618	681	305	2818	0	162422
23484	155886	570	346	1557	0	158359
23485	2273	465	320	161024	0	164082
23486	876	641	171610	2039	0	175166
23487	953	481	1799	172061	0	175294
23488	854	457	717	178788	0	180816
23489	697	459	527	180882	0	182565
23490	667	415	479	178930	0	180491
23491	733	480	441	175854	0	177508
23492	318	177496	452	2989	0	181255
23493	174198	2056	407	2248	0	178909
23494	176165	785	414	2017	0	179381
23495	177603	528	363	1889	0	180383
23496	2616	181558	476	1045	0	185695
23497	179474	2250	281	1809	0	183814
23498	2439	181770	399	1030	0	185638
23499	1042	2532	179799	903	0	184276
23500	1442	994	2184	173487	0	178107
23501	739	745	182246	2774	0	186504
23502	617	182657	2490	1483	0	187247
23503	178846	2493	845	2033	0	184217
23504	2540	1127	185572	999	0	190238
23505	1265	952	191938	953	0	195108
23506	877	202489	3633	928	0	207927
23507	1383	3179	1653	205551	0	211766
23508	903	1585	221636	3471	0	227595
23509	2112	1031	3687	212056	0	218886
23510	1644	730	1638	239246	0	243258
23511	1535	639	1041	256954	0	260169
23512	266794	558	725	7561	0	275638
23513	267401	494	617	3939	0	272451
23514	7447	559	501	265539	0	274046
23515	268552	397	578	7017	0	276544
23516	6275	620	264644	2840	0	274379
23517	2773	560	261053	2008	0	266394
23518	2022	549	264006	1683	0	268260
23519	1637	559	270036	1571	0	273803
23520	1368	265444	7009	1512	0	275333
23521	3498	4748	3540	258373	0	270159
23522	1753	1681	269033	4855	0	277322
23523	246306	950	5977	3654	0	256887
23524	266391	601	2905	3072	0	272969
23525	6611	265539	2704	1930	0	276784
23526	265319	4707	2488	2027	0	274541
23527	7302	1829	2494	264297	0	275922
23528	2881	1504	274810	5252	0	284447
23529	3358	1210	6432	258187	0	269187
23530	1649	276976	3479	5378	0	287482
23531	265292	5242	2638	4298	0	277470
23532	274595	2207	1979	3181	0	281962
23533	6993	276853	1740	1684	0	287270
23534	279109	5569	1395	2774	0	288847
23535	277827	2443	1318	2791	0	284379
23536	7743	278212	1516	1703	0	289174
23537	5204	5580	1299	268031	0	280114
23538	2983	273920	1331	5467	0	283701
23539	276178	6215	1192	3569	0	287154
23540	7665	3357	1189	273807	0	286018
23541	275101	2176	1225	6764	0	285266
23542	8253	2018	1065	273180	0	284516
23543	4451	2163	268995	6128	0	281737
23544	260664	1791	5067	4091	0	271613
23545	7452	1962	268586	2285	0	280285
23546	5143	1759	5732	265481	0	278115
23547	3320	1847	266547	6145	0	277859
23548	4055	1576	6092	263430	0	275153
23549	2973	1521	266507	6922	0	277923
23550	253685	1315	6379	4958	0	266337
23551	6624	265089	3301	3251	0	278265
23552	266215	5201	2636	3531	0	277583
23553	7958	2198	2466	265393	0	278015
23554	262588	1455	2497	7600	0	274140
23555	6873	262560	2560	3755	0	275748
23556	3707	260914	2692	2944	0	270257
23557	2948	274007	2505	2771	0	282231
23558	273809	7042	2336	3440	0	286627
23559	7357	3391	2075	272365	0	285188
23560	4545	2504	1757	276461	0	285267
23561	3315	2435	270049	7606	0	283405
23562	3333	2286	264214	3969	0	273802
23563	3972	2084	6582	268876	0	281514
23564	3070	2452	275298	6565	0	287385
23565	2701	270988	6505	3723	0	283917
23566	266369	6563	3165	4142	0	280239
23567	7036	3404	273028	2569	0	286037
23568	3798	2729	271711	2633	0	280871
23569	3676	2123	7990	266868	0	280657
23570	274612	1722	4438	7974	0	288746
23571	7322	1443	3593	276230	0	288588
23572	274834	1345	3213	8670	0	288062
23573	7781	1400	3251	276281	0	288713
23574	3899	1702	278946	7309	0	291856
23575	3290	270596	7830	3863	0	285579
23576	2955	5974	277163	2990	0	289082
23577	2516	275700	8172	3062	0	289450
23578	3280	7008	4513	271061	0	285862
23579	267439	2731	3172	7879	0	281221
23580	6893	2091	268826	3954	0	281764
23581	4825	1641	6561	264141	0	277168
23582	4057	1592	3428	272055	0	281132
23583	273536	1604	2782	9086	0	287008
23584	7189	1828	2547	268382	0	279946
23585	3590	271836	2753	7127	0	285306
23586	260601	6057	2699	5051	0	274408
23587	6633	3290	259519	3096	0	272538
23588	246200	2497	6071	3796	0	258564
23589	7057	256982	3314	2558	0	269911
23590	4703	6027	2248	248521	0	261499
23591	3361	260176	1925	6223	0	271685
23592	256606	6101	1779	4679	0	269165
23593	7209	3126	257375	3013	0	270723
23594	245292	2845	5364	3955	0	257456
23595	7220	258588	2768	2521	0	271097
23596	4739	5790	2003	259739	0	272271
23597	261036	2922	1840	7243	0	273041
23598	263957	2403	2018	4121	0	272499
23599	8217	2132	1790	261091	0	273230
23600	5031	2249	1728	262167	0	271175
23601	3551	260571	1925	7124	0	273171
23602	3886	6127	1776	260828	0	272617
23603	3101	295392	1898	6915	0	307306
23604	2806	313098	1905	3936	0	321745
23605	3925	10151	1597	283918	0	299591
23606	2680	296920	1593	7377	0	308570
23607	3315	7719	297587	3300	0	311921
23608	3893	3437	297748	2985	0	308063
23609	2225	304597	8533	3432	0	318787
23610	2201	7610	303431	1999	0	315241
23611	1689	3040	299870	1697	0	306296
23612	810	1892	281815	728	0	285245
23613	542	276144	9144	832	0	286662
23614	263658	6817	4629	2086	0	277190
23615	5266	268841	2273	656	0	277036
23616	2032	7073	269011	406	0	278522
23617	2963	2965	6408	258641	0	270977
23618	261215	2049	2638	6863	0	272765
23619	5954	1439	259820	2198	0	269411
23620	3604	1150	6842	254800	0	266396
23621	1540	1022	262789	6013	0	271364
23622	2241	898	7685	253350	0	264174
23623	251399	881	3430	8029	0	263739
23624	6087	997	257910	2673	0	267667
23625	2362	257631	7447	1956	0	269396
23626	3111	6426	3357	247920	0	260814
23627	258991	2788	2244	7049	0	271072
23628	6740	2095	254138	2331	0	265304
23629	4067	1543	7183	233683	0	246476
23630	1879	250709	3610	5883	0	262081
23631	250851	6479	2595	3802	0	263727
23632	257958	2710	2186	2810	0	265664
23633	9401	2027	2046	250875	0	264349
23634	3925	253883	1941	7141	0	266890
23635	2459	269395	1904	3273	0	277031
23636	270256	8929	1586	3172	0	283943
23637	9096	4253	1648	259959	0	274956
23638	3312	271379	1842	7429	0	283962
23639	269985	8284	1475	4226	0	283970
23640	9154	3544	1497	271736	0	285931
23641	5012	2529	1622	277005	0	286168
23642	2669	2013	261980	10122	0	276784
23643	1942	266013	7234	5160	0	280349
23644	1850	281983	3357	3093	0	290283
23645	2939	9518	2326	276097	0	290880
23646	275416	4397	1647	9479	0	290939
23647	7817	278595	1648	4023	0	292083
23648	275249	8990	1395	3865	0	289499
23649	9073	277853	1594	2141	0	290661
23650	5143	9498	1380	275683	0	291704
23651	276750	4395	1293	9299	0	291737
23652	9769	3344	1235	276714	0	291062
23653	4392	2670	276065	9477	0	292604
23654	3960	2348	7910	259604	0	273822
23655	2328	273025	3584	9086	0	288023
23656	266902	8982	2535	5135	0	283554
23657	8375	270228	1906	3288	0	283797
23658	4826	9892	1637	258809	0	275164
23659	3919	4673	1474	269854	0	279920
23660	2619	3546	261118	10577	0	277860
23661	2376	3008	262324	5240	0	272948
23662	3010	9565	9996	251856	0	274427
23663	2376	2865	259970	9294	0	274505
23664	1836	257260	9337	4942	0	273375
23665	253303	8778	4342	4279	0	270702
23666	8220	4533	258276	3098	0	274127
23667	250976	3459	8926	3556	0	266917
23668	262134	2987	4269	3358	0	272748
23669	261963	2796	3232	3101	0	271092
23670	263645	2588	2574	2856	0	271663
23671	12397	2641	2478	253997	0	271513
23672	6485	2374	2458	247326	0	258643
23673	3988	249434	2812	10174	0	266408
23674	245238	8493	2868	5768	0	262367
23675	9158	4721	242513	3757	0	260149
23676	5320	3559	8723	238944	0	256546
23677	4275	2939	4711	244383	0	256308
23678	3089	2905	238312	10748	0	255054
23679	3159	239143	9312	5792	0	257406
23680	4235	8683	4971	228204	0	246093
23681	3728	4318	3574	247087	0	258707
23682	236876	3390	2730	11804	0	254800
23683	8975	235531	2447	6673	0	253626
23684	5492	8471	2258	232511	0	248732
23685	3695	233556	2482	9935	0	249668
23686	3797	9175	2269	239489	0	254730
23687	233266	4517	2144	11178	0	251105
23688	240469	3390	2171	6152	0	252182
23689	11396	2581	2264	235983	0	252224
23690	233883	2361	2002	10969	0	249215
23691	235190	2356	2051	6419	0	246016
23692	11475	229757	1999	4602	0	247833
23693	7151	8545	1546	220906	0	238148
23694	4774	229360	1795	8992	0	244921
23695	4540	9361	1297	229880	0	245078
23696	227933	4773	1312	10633	0	244651
23697	9795	4006	1431	227489	0	242721
23698	5986	3184	1303	232366	0	242839
23699	4284	3373	220441	11655	0	239753
23700	3864	208910	6844	6975	0	226593
23701	3758	224075	3026	5103	0	235962
23702	216213	9302	2157	5326	0	232998
23703	7717	4901	1270	175272	0	189160
23704	161357	2557	901	6367	0	171182
23705	6041	156151	897	3877	0	166966
23706	3359	147177	852	2903	0	154291
23707	2385	154661	729	2501	0	160276
23708	128492	4844	2923	2361	0	138620
23709	3308	130968	828	1628	0	136732
23710	120615	2817	1960	1970	0	127362
23711	117638	1063	477	1359	0	120537
23712	121571	808	389	1226	0	123994
23713	3100	776	325	127979	0	132180
23714	1716	745	325	131236	0	134022
23715	1329	630	330	133051	0	135340
23716	1220	633	319	131528	0	133700
23717	130295	509	314	4234	0	135352
23718	2918	128444	386	1721	0	133469
23719	1572	2474	335	130746	0	135127
23720	131626	962	350	3565	0	136503
23721	3118	664	310	130680	0	134772
23722	1648	574	323	131402	0	133947
23723	129673	570	298	4032	0	134573
23724	3011	645	126824	1607	0	132087
23725	1685	566	2212	126954	0	131417
23726	1026	495	129232	3045	0	133798
23727	1115	458	2363	126177	0	130113
23728	1083	759	854	127707	0	130403
23729	123643	413	500	3902	0	128458
23730	2493	120996	494	1749	0	125732
23731	1125	120656	376	1076	0	123233
23732	115699	2087	284	1289	0	119359
23733	1989	119976	288	707	0	122960
23734	119045	1646	383	1471	0	122545
23735	2086	630	117482	687	0	120885
23736	106353	227	1239	883	0	108702
23737	110921	144	332	764	0	112161
23738	111764	127	263	642	0	112796
23739	1774	122	132	109500	0	111528
23740	812	147	150	109284	0	110393
23741	279	109017	160	1538	0	110994
23742	564	1381	93	108650	0	110688
23743	107320	389	107	1851	0	109667
23744	1190	108330	134	581	0	110235
23745	376	108742	107	326	0	109551
23746	107025	1194	47	801	0	109067
23747	1194	479	107574	187	0	109434
23748	788	216	987	104987	0	106978
23749	290	229	108400	1075	0	109994
23750	553	101	1057	105201	0	106912
23751	274	107327	340	1023	0	108964
23752	461	1008	125	109628	0	111222
23753	107559	284	86	1649	0	109578
23754	1301	174	73	107751	0	109299
23755	389	231	111661	1227	0	113508
23756	101950	144	1167	1162	0	104423
23757	1353	112452	459	410	0	114674
23758	486	119876	262	276	0	120900
23759	123158	1652	122	913	0	125845
23760	130866	579	110	860	0	132415
23761	2478	417	131671	182	0	134748
23762	126345	182	2013	870	0	129410
23763	2260	132452	674	255	0	135641
23764	133437	2054	271	799	0	136561
23765	2681	733	169	128484	0	132067
23766	850	124169	206	1887	0	127112
23767	126221	2086	146	1207	0	129660
23768	2513	797	126960	407	0	130677
23769	1517	394	2097	126822	0	130830
23770	130195	361	631	2907	0	134094
23771	2604	462	129450	770	0	133286
23772	129130	366	2151	1094	0	132741
23773	3047	345	666	128381	0	132439
23774	1596	270	392	131809	0	134067
23775	773	397	132112	2824	0	136106
23776	1105	209	2279	129455	0	133048
23777	132033	243	759	3449	0	136484
23778	2485	130763	625	1188	0	135061
23779	131719	2227	340	1463	0	135749
23780	133053	803	278	1256	0	135390
23781	3434	493	248	131721	0	135896
23782	1263	510	133642	2669	0	138084
23783	1211	295	2354	132091	0	135951
23784	133775	248	803	3581	0	138407
23785	2654	132630	635	1185	0	137104
23786	135496	2289	337	1402	0	139524
23787	3314	795	288	134678	0	139075
23788	1684	489	311	137218	0	139702
23789	1220	301	473	139206	0	141200
23790	755	393	135544	3689	0	140381
23791	1223	295	2501	135624	0	139643
23792	764	544	135682	3104	0	140094
23793	965	544	135594	1250	0	138353
23794	1391	401	3059	148630	0	153481
23795	759	478	152431	3654	0	157322
23796	164380	327	3577	2371	0	170655
23797	5059	265	1470	171600	0	178394
23798	2831	330	924	170360	0	174445
23799	1197	175125	909	5689	0	182920
23800	175753	4247	685	3377	0	184062
23801	181923	1784	583	2632	0	186922
23802	6326	182728	700	1289	0	191043
23803	3728	4623	473	182438	0	191262
23804	1779	2026	183859	4943	0	192607
23805	176949	1043	4590	3311	0	185893
23806	187196	780	2017	2338	0	192331
23807	7331	667	1128	177155	0	186281
23808	3305	816	174020	5099	0	183240
23809	1939	170934	4822	2495	0	180190
23810	167579	4715	2050	2254	0	176598
23811	5647	2183	168736	1402	0	177968
23812	2732	166007	5098	1353	0	175190
23813	157796	4335	2545	1706	0	166382
23814	159900	1925	1344	1468	0	164637
23815	6878	1174	931	154327	0	163310
23816	3290	156926	884	4205	0	165305
23817	2846	4372	710	163923	0	171851
23818	2176	2032	925	167152	0	172285
23819	2354	1353	808	162560	0	167075
23820	2220	923	748	167732	0	171623
23821	1462	882	163006	7181	0	172531
23822	2198	732	4476	163279	0	170685
23823	1945	969	2029	167807	0	172750
23824	1447	891	162961	6997	0	172296
23825	1114	163238	4751	3925	0	173028
23826	161215	4741	2190	3399	0	171545
23827	164941	2167	1370	2779	0	171257
23828	6950	1255	1086	164269	0	173560
23829	165598	850	928	6531	0	173907
23830	6504	896	873	167595	0	175868
23831	3070	855	166885	6602	0	177412
23832	2134	975	165644	3789	0	172542
23833	1571	162923	6356	2840	0	173690
23834	159988	4677	2950	2959	0	170574
23835	5767	2391	169508	2055	0	179721
23836	4239	1325	5635	162173	0	173372
23837	3397	945	2901	174479	0	181722
23838	2582	823	2066	182167	0	187638
23839	2513	987	1461	181399	0	186360
23840	2634	992	1368	181105	0	186099
23841	1912	1063	175014	10015	0	188004
23842	2456	1063	6010	176876	0	186405
23843	172759	1029	3083	9097	0	185968
23844	6503	171978	2099	5164	0	185744
23845	170937	5632	1632	4425	0	182626
23846	6932	173851	1649	3254	0	185686
23847	173808	6627	1402	3514	0	185351
23848	179308	3173	1408	3321	0	187210
23849	9625	1849	1518	174111	0	187103
23850	5526	1447	1181	178925	0	187079
23851	174008	1154	1344	10146	0	186652
23852	169594	1284	1360	6252	0	178490
23853	174655	1359	1234	4516	0	181764
23854	9534	164605	1379	3261	0	178779
23855	4957	168719	1488	2883	0	178047
23856	3366	7297	164679	2869	0	178211
23857	3796	4052	5657	160224	0	173729
23858	2735	2193	158639	7375	0	170942
23859	2510	153052	6073	4774	0	166409
23860	2541	5311	2979	144677	0	155508
23861	2395	2734	1573	147528	0	154230
23862	2382	1660	1279	151492	0	156813
23863	144861	1329	1116	9064	0	156370
23864	146272	1218	1233	5575	0	154298
23865	7250	145457	1247	3390	0	157344
23866	4626	4971	1127	146227	0	156951
23867	2937	2852	145003	6313	0	157105
23868	2330	2089	141135	4064	0	149618
23869	141176	1840	6490	3365	0	152871
23870	146206	1268	3508	3077	0	154059
23871	7797	1147	2079	143667	0	154690
23872	145113	1011	1751	7091	0	154966
23873	6833	1192	141612	4339	0	153976
23874	4066	140233	5431	3349	0	153079
23875	3428	4851	3117	140691	0	152087
23876	2448	2838	145084	6472	0	156842
23877	2695	1829	5551	145942	0	156017
23878	2858	1352	3183	149651	0	157044
23879	2163	1336	147193	8517	0	159209
23880	141250	1138	5427	6157	0	153972
23881	149786	978	3159	4912	0	158835
23882	7214	154754	2352	3824	0	168144
23883	158754	5337	1666	3902	0	169659
23884	164181	2924	1557	3472	0	172134
23885	9120	1970	159242	3165	0	173497
23886	157576	1508	5754	3333	0	168171
23887	8038	166582	3361	2758	0	180739
23888	168270	6248	2052	3065	0	179635
23889	173484	3245	1686	3012	0	181427
23890	178416	2146	1655	2643	0	184860
23891	169884	1570	1356	3254	0	176064
23892	176899	1331	1239	3020	0	182489
23893	10891	169002	1344	2582	0	183819
23894	157883	5326	1098	2520	0	166827
23895	8034	153834	1203	1819	0	164890
23896	3489	132465	884	1318	0	138156
23897	2455	138166	993	1305	0	142919
23898	133445	5480	2413	1573	0	142911
23899	134079	2407	989	1525	0	139000
23900	6273	1378	129559	1091	0	138301
23901	133220	1097	3783	1443	0	139543
23902	134931	922	1786	1436	0	139075
23903	6498	1016	134393	1084	0	142991
23904	4024	769	4137	131710	0	140640
23905	3285	823	2079	130537	0	136724
23906	2332	833	1134	140029	0	144328
23907	2324	888	885	139285	0	143382
23908	2389	760	703	140869	0	144721
23909	1651	955	135835	6360	0	144801
23910	1624	135365	4197	3009	0	144195
23911	131896	4125	1891	2099	0	140011
23912	4951	134148	1167	1353	0	141619
23913	135160	4520	803	1493	0	141976
23914	135418	2091	873	1403	0	139785
23915	6601	1298	131166	982	0	140047
23916	4043	1350	3973	119692	0	129058
23917	2193	126175	2188	3844	0	134400
23918	127832	3905	1220	2483	0	135440
23919	128701	1855	874	2004	0	133434
23920	131292	1136	757	1593	0	134778
23921	6355	131242	776	1070	0	139443
23922	133654	3787	755	1426	0	139622
23923	135787	2006	760	1177	0	139730
23924	136510	1428	572	1079	0	139589
23925	7081	991	615	130454	0	139141
23926	4034	1051	569	133047	0	138701
23927	3114	872	507	135755	0	140248
23928	131807	939	535	5612	0	138893
23929	5127	132095	650	2431	0	140303
23930	132741	3732	476	1684	0	138633
23931	131524	1992	529	1085	0	135130
23932	128910	1112	487	1229	0	131738
23933	130533	927	447	999	0	132906
23934	6580	125491	506	750	0	133327
23935	117384	3335	302	972	0	121993
23936	4825	114348	441	671	0	120285
23937	2434	113777	277	506	0	116994
23938	113137	3228	331	866	0	117562
23939	3680	110943	275	599	0	115497
23940	2156	115020	290	542	0	118008
23941	114712	3285	528	901	0	119426
23942	116109	1672	286	713	0	118780
23943	4353	1222	201	112236	0	118012
23944	2712	908	181	115300	0	119101
23945	117341	856	216	3800	0	122213
23946	121691	780	325	2060	0	124856
23947	119982	784	324	1499	0	122589
23948	4367	959	116259	568	0	122153
23949	121521	805	2306	974	0	125606
23950	4153	874	943	122231	0	128201
23951	2670	726	596	123693	0	127685
23952	2129	676	422	125078	0	128305
23953	1862	667	374	124964	0	127867
23954	1533	771	120259	3892	0	126455
23955	1640	685	121099	1903	0	125327
23956	1737	641	3054	121719	0	127151
23957	1427	676	121974	3296	0	127373
23958	1599	752	120322	1889	0	124562
23959	2022	644	3247	120761	0	126674
23960	1962	603	1510	123965	0	128040
23961	1773	655	949	128963	0	132340
23962	1972	693	763	123862	0	127290
23963	127449	647	652	4681	0	133429
23964	132618	673	609	2836	0	136736
23965	4640	612	497	130598	0	136347
23966	2790	639	570	131632	0	135631
23967	2094	652	512	132566	0	135824
23968	1939	597	598	131663	0	134797
23969	1885	661	578	130875	0	133999
23970	1762	128810	528	4464	0	135564
23971	128801	2781	550	2771	0	134903
23972	3716	129656	557	1825	0	135754
23973	129933	3032	351	2077	0	135393
23974	130771	1426	278	2017	0	134492
23975	131245	947	324	1809	0	134325
23976	5089	816	308	124251	0	130464
23977	125089	758	289	3570	0	129706
23978	4389	878	255	123217	0	128739
23979	2967	786	265	122657	0	126675
23980	122278	759	200	4256	0	127493
23981	3868	118306	269	2125	0	124568
23982	1933	113240	195	1276	0	116644
23983	110876	2107	183	1423	0	114589
23984	2788	1017	109628	822	0	114255
23985	101185	660	1687	1145	0	104677
23986	3118	1172	611	106859	0	111760
23987	1495	99903	309	1887	0	103594
23988	1195	102480	207	945	0	104827
23989	102026	1710	273	1159	0	105168
23990	2021	851	115	103518	0	106505
23991	1105	107139	162	1463	0	109869
23992	105638	1192	158	1216	0	108204
23993	105691	546	75	1058	0	107370
23994	106287	452	60	965	0	107764
23995	106707	427	64	1025	0	108223
23996	1873	103462	136	530	0	106001
23997	742	103421	109	333	0	104605
23998	104212	1047	95	691	0	106045
23999	107118	478	98	690	0	108384
24000	1586	344	105630	245	0	107805
24001	497	103540	880	191	0	105108
24002	104210	975	298	614	0	106097
24003	107784	304	119	602	0	108809
24004	1506	280	109513	126	0	111425
24005	105404	165	1235	746	0	107550
24006	1753	182	115512	99	0	117546
24007	540	192	124020	86	0	124838
24008	1047	282	2151	113908	0	117388
24009	315	118877	803	1664	0	121659
24010	127042	1951	380	1067	0	130440
24011	2509	559	192	126572	0	129832
24012	1265	337	151	127682	0	129435
24013	954	165	158	130209	0	131486
24014	128374	139	147	3356	0	132016
24015	2664	133	145	127166	0	130108
24016	1225	114	132	130931	0	132402
24017	563	222	129628	2853	0	133266
24018	123781	147	2204	1795	0	127927
24019	130607	133	670	1229	0	132639
24020	3200	210	129713	483	0	133606
24021	124197	154	2472	806	0	127629
24022	3363	155	763	123970	0	128251
24023	1136	125758	492	2504	0	129890
24024	1244	2377	276	126848	0	130745
24025	124996	664	254	3495	0	129409
24026	2687	126385	315	1226	0	130613
24027	1525	2588	204	127207	0	131524
24028	1379	788	196	129786	0	132149
24029	1157	438	205	129953	0	131753
24030	1157	320	250	124614	0	126341
24031	568	130960	363	3458	0	135349
24032	130956	2803	259	1953	0	135971
24033	132857	955	254	1549	0	135615
24034	3841	136356	362	893	0	141452
24035	147885	3321	234	1250	0	152690
24036	153820	1132	214	1301	0	156467
24037	152097	712	204	1277	0	154290
24038	6008	551	146056	693	0	153308
24039	3526	404	3775	144370	0	152075
24040	1746	514	142350	4269	0	148879
24041	141439	355	4038	2579	0	148411
24042	4675	144849	1684	1372	0	152580
24043	142576	3889	944	1619	0	149028
24044	4926	145587	701	870	0	152084
24045	3189	4549	634	137020	0	145392
24046	2590	1819	563	141224	0	146196
24047	1482	1195	140346	5196	0	148219
24048	1243	142483	4253	2467	0	150446
24049	139564	4620	1791	1988	0	147963
24050	5164	2032	140137	1135	0	148468
24051	139937	1276	4495	1391	0	147099
24052	6056	897	2115	139918	0	148986
24053	2652	954	141254	5002	0	149862
24054	1844	139991	4856	2593	0	149284
24055	2218	4525	2093	139152	0	147988
24056	1501	2237	141467	4940	0	150145
24057	1482	1414	141942	2472	0	147310
24058	1347	139691	5927	1758	0	148723
24059	1887	4703	2659	135907	0	145156
24060	1833	2002	1617	135329	0	140781
24061	1301	136381	1377	5790	0	144849
24062	137124	4840	1151	3295	0	146410
24063	5773	2347	986	133924	0	143030
24064	2632	133294	1233	5133	0	142292
24065	134708	4797	1051	3186	0	143742
24066	134405	2321	1089	2588	0	140403
24067	137384	1492	1173	2228	0	142277
24068	6931	134320	1108	1703	0	144062
24069	137406	5016	998	2141	0	145561
24070	139450	2392	1045	1974	0	144861
24071	7635	1707	1031	134576	0	144949
24072	137352	1510	826	5811	0	145499
24073	7014	1479	685	136684	0	145862
24074	3665	1351	133138	6258	0	144412
24075	2803	1383	136787	3216	0	144189
24076	2801	1175	5991	137349	0	147316
24077	2263	1190	138942	6100	0	148495
24078	134364	1210	5705	3652	0	144931
24079	6702	1057	2683	138526	0	148968
24080	3908	1008	1784	142146	0	148846
24081	2778	1020	137586	7435	0	148819
24082	2205	131603	5551	3826	0	143185
24083	2247	140446	2697	2543	0	147933
24084	2551	6213	1757	134883	0	145404
24085	2290	2808	1397	139661	0	146156
24086	1949	1896	133522	7134	0	144501
24087	1881	1565	136305	3718	0	143469
24088	2203	1362	6607	135498	0	145670
24089	1700	1315	134057	6396	0	143468
24090	130515	1407	6027	3727	0	141676
24091	6539	1295	2888	131220	0	141942
24092	132384	1230	1907	6823	0	142344
24093	6912	1263	1487	131760	0	141422
24094	3709	1232	1463	136033	0	142437
24095	2634	1182	130058	7912	0	141786
24096	2160	131323	5789	4099	0	143371
24097	2632	5529	2723	131513	0	142397
24098	1994	2547	131394	6650	0	142585
24099	1921	126655	5601	3600	0	137777
24100	2332	5084	2962	128536	0	138914
24101	128524	2343	2126	6493	0	139486
24102	5648	1523	128771	3650	0	139592
24103	120145	1149	5625	2766	0	129685
24104	6026	1198	120642	1966	0	129832
24105	109405	848	5520	2334	0	118107
24106	5411	110427	2988	1913	0	120739
24107	2363	105794	1828	1527	0	111512
24108	2003	5278	1516	98575	0	107372
24109	1289	100945	1437	4125	0	107796
24110	99518	4299	1175	2982	0	107974
24111	4168	2093	1110	100384	0	107755
24112	2358	1419	1092	102894	0	107763
24113	1662	1220	965	104759	0	108606
24114	1086	1175	99256	5828	0	107345
24115	1550	966	3823	99353	0	105692
24116	1060	946	98639	4964	0	105609
24117	1017	95423	4341	2770	0	103551
24118	90450	3298	2121	2104	0	97973
24119	3581	95485	1550	1597	0	102213
24120	97322	3597	1154	1840	0	103913
24121	98964	1788	1035	1718	0	103505
24122	100227	1194	877	1761	0	104059
24123	98831	972	963	1563	0	102329
24124	5137	1041	93440	1275	0	100893
24125	2954	904	3452	92665	0	99975
24126	2187	970	1754	91993	0	96904
24127	1797	846	1183	96981	0	100807
24128	85746	885	1146	5358	0	93135
24129	88274	703	1023	3282	0	93282
24130	4349	91926	987	2131	0	99393
24131	2334	2700	88255	1423	0	94712
24132	1822	1294	87151	1421	0	91688
24133	1362	84800	3789	1434	0	91385
24134	1252	85495	1899	1263	0	89909
24135	2273	2696	2394	69114	0	76477
24136	914	815	486	67899	0	70114
24137	68954	584	455	2397	0	72390
24138	1818	69153	517	1100	0	72588
24139	1076	1647	461	71203	0	74387
24140	706	766	72734	2076	0	76282
24141	853	559	1791	74805	0	78008
24142	789	443	770	76653	0	78655
24143	795	357	576	78211	0	79939
24144	831	366	567	77506	0	79270
24145	665	445	75060	2595	0	78765
24146	582	71442	1896	1334	0	75254
24147	509	73748	818	931	0	76006
24148	69111	1733	510	803	0	72157
24149	1605	69313	449	629	0	71996
24150	717	73288	386	651	0	75042
24151	782	1807	380	72941	0	75910
24152	716	697	360	73310	0	75083
24153	674	538	418	73592	0	75222
24154	541	479	72562	2174	0	75756
24155	454	72028	1485	1137	0	75104
24156	597	1537	582	70174	0	72890
24157	417	72962	432	1675	0	75486
24158	72106	1459	419	1153	0	75137
24159	1403	72663	469	766	0	75301
24160	72265	1559	414	916	0	75154
24161	1513	743	71407	657	0	74320
24162	71038	587	1472	696	0	73793
24163	1709	609	524	73085	0	75927
24164	703	629	73659	1615	0	76606
24165	71201	508	1418	978	0	74105
24166	73777	541	520	867	0	75705
24167	74641	468	401	790	0	76300
24168	1949	434	382	73741	0	76506
24169	814	463	73541	1730	0	76548
24170	72831	383	1377	1217	0	75808
24171	1757	368	602	75981	0	78708
24172	869	421	450	76489	0	78229
24173	664	443	78932	1847	0	81886
24174	555	78507	1383	857	0	81302
24175	736	1467	514	76124	0	78841
24176	506	78573	461	1300	0	80840
24177	77006	1401	378	925	0	79710
24178	77446	521	323	774	0	79064
24179	1730	452	268	76999	0	79449
24180	76735	296	287	1739	0	79057
24181	1412	76998	297	743	0	79450
24182	76556	1109	279	893	0	78837
24183	1391	77423	282	573	0	79669
24184	826	1189	301	77808	0	80124
24185	682	531	244	77140	0	78597
24186	514	77939	333	1471	0	80257
24187	611	1270	253	77572	0	79706
24188	452	571	77554	1433	0	80010
24189	399	75912	1125	654	0	78090
24190	72005	894	330	746	0	73975
24191	929	72899	284	379	0	74491
24192	606	874	207	73270	0	74957
24193	430	395	73401	970	0	75196
24194	554	319	806	73071	0	74750
24195	461	284	265	74139	0	75149
24196	72083	213	220	1457	0	73973
24197	1025	267	72590	562	0	74444
24198	446	73097	847	602	0	74992
24199	346	959	76860	450	0	78615
24200	215	370	74279	324	0	75188
24201	188	292	74273	273	0	75026
24202	642	764	1087	71382	0	73875
24203	75342	126	538	1239	0	77245
24204	850	75634	264	343	0	77091
24205	76736	954	130	552	0	78372
24206	79454	311	156	591	0	80512
24207	1260	226	126	78366	0	79978
24208	376	79360	175	1002	0	80913
24209	78961	939	128	742	0	80770
24210	931	80161	153	366	0	81611
24211	593	1028	114	79616	0	81351
24212	457	379	131	83166	0	84133
24213	199	83425	205	1131	0	84960
24214	358	997	155	84127	0	85637
24215	196	431	82354	1090	0	84071
24216	259	350	81094	412	0	82115
24217	442	241	1108	82497	0	84288
24218	407	207	373	84270	0	85257
24219	242	214	81123	1217	0	82796
24220	239	261	78811	530	0	79841
24221	72392	191	1153	757	0	74493
24222	1034	78090	455	328	0	79907
24223	385	84190	339	282	0	85196
24224	449	1275	233	81362	0	83319
24225	408	425	174	82224	0	83231
24226	427	286	157	83239	0	84109
24227	226	257	82780	1317	0	84580
24228	310	266	80721	517	0	81814
24229	476	221	1208	82925	0	84830
24230	222	249	83643	1137	0	85251
24231	185	82565	1226	566	0	84542
24232	81300	1048	557	716	0	83621
24233	1116	406	82037	367	0	83926
24234	479	273	81104	297	0	82153
24235	570	309	1349	81721	0	83949
24236	284	252	88888	1242	0	90666
24237	222	90653	1473	720	0	93068
24238	684	1370	545	90409	0	93008
24239	242	535	92780	1492	0	95049
24240	199	90228	1565	696	0	92688
24241	88447	1406	630	722	0	91205
24242	1530	590	440	88188	0	90748
24243	688	352	335	89454	0	90829
24244	88940	274	276	2076	0	91566
24245	1323	89281	298	833	0	91735
24246	89493	1384	285	878	0	92040
24247	89579	563	251	768	0	91161
24248	90322	364	271	692	0	91649
24249	2163	259	287	88581	0	91290
24250	86305	255	277	1885	0	88722
24251	1681	83306	333	766	0	86086
24252	790	85782	308	549	0	87429
24253	87943	1738	250	687	0	90618
24254	1967	755	224	88928	0	91874
24255	1151	516	224	89252	0	91143
24256	847	378	220	90252	0	91697
24257	515	390	86898	2290	0	90093
24258	409	87023	1554	1103	0	90089
24259	635	1654	636	88992	0	91917
24260	88698	695	421	2168	0	91982
24261	1891	480	355	88867	0	91593
24262	786	428	88516	2070	0	91800
24263	599	88407	1648	1032	0	91686
24264	88356	1652	717	1173	0	91898
24265	88368	739	545	1014	0	90666
24266	89174	581	439	916	0	91110
24267	2609	493	416	89312	0	92830
24268	1141	511	89059	2023	0	92734
24269	904	417	91314	1083	0	93718
24270	654	94539	2384	807	0	98384
24271	1041	2150	995	93668	0	97854
24272	935	881	548	96843	0	99207
24273	91665	590	422	3119	0	95796
24274	2563	490	339	93093	0	96485
24275	94650	395	376	3050	0	98471
24276	2720	461	92596	1339	0	97116
24277	1258	435	94460	977	0	97130
24278	1334	410	2783	92507	0	97034
24279	1054	349	1166	95238	0	97807
24280	998	386	665	98246	0	100295
24281	97845	360	568	3731	0	102504
24282	104073	396	564	1886	0	106919
24283	3977	539	559	104127	0	109202
24284	1488	352	102973	3559	0	108372
24285	943	369	105430	1797	0	108539
24286	1105	293	3906	105334	0	110638
24287	107182	280	1673	4033	0	113168
24288	3660	327	942	105948	0	110877
24289	1969	309	728	108915	0	111921
24290	1093	325	106841	4483	0	112742
24291	887	368	107170	2189	0	110614
24292	101724	296	4145	1879	0	108044
24293	3453	361	106625	1288	0	111727
24294	2090	265	3710	101565	0	107630
24295	1598	243	1706	105003	0	108550
24296	103460	196	1119	4719	0	109494
24297	3578	101761	964	2316	0	108619
24298	100550	2850	1054	1893	0	106347
24299	3446	98134	1011	1305	0	103896
24300	96230	3017	886	1459	0	101592
24301	3756	1178	94462	1148	0	100544
24302	87671	750	3441	1437	0	93299
24303	91190	439	1444	1251	0	94324
24304	4391	531	1053	89797	0	95772
24305	2129	407	89606	3235	0	95377
24306	1807	376	3292	84471	0	89946
24307	1503	381	1549	86349	0	89782
24308	1080	84718	1122	4123	0	91043
24309	1436	2667	793	83397	0	88293
24310	1090	84611	783	3655	0	90139
24311	1573	2907	652	84896	0	90028
24312	83250	1276	690	4023	0	89239
24313	3776	802	688	83778	0	89044
24314	1882	651	82828	3830	0	89191
24315	81001	536	3175	2300	0	87012
24316	3646	510	84778	1765	0	90699
24317	83746	451	3366	1748	0	89311
24318	86283	471	1600	1751	0	90105
24319	4321	83824	1227	1504	0	90876
24320	2244	88971	1042	1370	0	93627
24321	86685	3781	952	1573	0	92991
24322	89845	1522	923	1687	0	93977
24323	88514	910	908	1436	0	91768
24324	88470	670	846	1601	0	91587
24325	88965	634	800	1440	0	91839
24326	5365	575	738	85015	0	91693
24327	2901	617	833	88052	0	92403
24328	2049	711	85408	4437	0	92605
24329	83996	623	3410	2311	0	90340
24330	4680	610	1575	83852	0	90717
24331	2727	564	1160	86503	0	90954
24332	2168	632	84002	4571	0	91373
24333	1918	79538	3515	2442	0	87413
24334	1871	84842	1728	1831	0	90272
24335	82274	3589	1231	1841	0	88935
24336	78332	1289	950	1562	0	82133
24337	4456	71946	892	1303	0	78597
24338	2283	73260	818	1089	0	77450
24339	72461	3074	900	1296	0	77731
24340	75335	1277	747	1436	0	78795
24341	4232	730	774	72624	0	78360
24342	2348	722	706	74249	0	78025
24343	1886	602	757	76317	0	79562
24344	72691	596	682	4420	0	78389
24345	74774	581	627	2354	0	78336
24346	4370	723	716	74017	0	79826
24347	76150	771	715	3694	0	81330
24348	4126	781	75565	1818	0	82290
24349	2707	645	2868	75886	0	82106
24350	1928	712	75586	3630	0	81856
24351	1665	74577	3183	1972	0	81397
24352	1849	3058	1551	74395	0	80853
24353	74128	1262	1034	3504	0	79928
24354	3962	704	779	73463	0	78908
24355	2497	608	687	74884	0	78676
24356	1746	624	72480	4267	0	79117
24357	1533	696	73352	2292	0	77873
24358	1578	74315	3288	1581	0	80762
24359	74281	2834	1430	1557	0	80102
24360	76360	1285	819	1403	0	79867
24361	76424	838	786	1310	0	79358
24362	77082	675	660	1384	0	79801
24363	4776	558	706	74091	0	80131
24364	2620	508	693	73879	0	77700
24365	1771	73905	745	3763	0	80184
24366	74061	2683	672	2015	0	79431
24367	75060	1178	660	1567	0	78465
24368	4199	749	71024	1184	0	77156
24369	63133	578	2325	1108	0	67144
24370	3280	64620	1097	872	0	69869
24371	2113	2931	661	61454	0	67159
24372	1514	64514	506	2425	0	68959
24373	64163	2477	500	1584	0	68724
24374	3032	64151	404	971	0	68558
24375	1927	2233	396	61839	0	66395
24376	1430	962	341	63550	0	66283
24377	1315	532	382	62070	0	64299
24378	1043	59806	402	3125	0	64376
24379	1255	2366	357	60185	0	64163
24380	1344	1485	361	59423	0	62613
24381	848	53602	356	2620	0	57426
24382	649	51715	281	1114	0	53759
24383	48083	1608	238	768	0	50697
24384	1560	48815	229	589	0	51193
24385	46213	1220	155	635	0	48223
24386	1454	536	45634	383	0	48007
24387	651	44855	975	397	0	46878
24388	44673	1105	433	516	0	46727
24389	44679	474	222	497	0	45872
24390	1462	325	43645	406	0	45838
24391	863	319	932	42862	0	44976
24392	471	273	44547	1205	0	46496
24393	423	43691	1059	580	0	45753
24394	42777	1084	514	561	0	44936
24395	1097	42904	277	381	0	44659
24396	647	1108	183	42805	0	44743
24397	585	475	141	43756	0	44957
24398	429	354	43154	1277	0	45214
24399	420	277	41529	565	0	42791
24400	40802	245	1174	574	0	42795
24401	43061	273	403	503	0	44240
24402	43172	258	278	426	0	44134
24403	42983	244	190	470	0	43887
24404	1467	42724	217	322	0	44730
24405	787	1053	199	42630	0	44669
24406	595	448	205	43185	0	44433
24407	438	44089	176	1292	0	45995
24408	44751	1121	159	737	0	46768
24409	45485	449	160	570	0	46664
24410	1481	360	44736	365	0	46942
24411	44851	244	1056	470	0	46621
24412	1503	282	438	45021	0	47244
24413	720	238	44850	1218	0	47026
24414	743	303	1157	43973	0	46176
24415	494	230	45311	1291	0	47326
24416	405	252	43385	494	0	44536
24417	544	510	1231	40896	0	43181
24418	277	41901	527	932	0	43637
24419	41623	919	316	599	0	43457
24420	40310	390	225	465	0	41390
24421	1247	43334	182	293	0	45056
24422	546	44819	166	289	0	45820
24423	45300	1041	267	504	0	47112
24424	45937	450	181	424	0	46992
24425	46128	289	154	393	0	46964
24426	46193	231	173	330	0	46927
24427	1479	176	176	46431	0	48262
24428	642	185	45905	853	0	47585
24429	460	45710	853	363	0	47386
24430	45079	795	325	457	0	46656
24431	945	47247	196	246	0	48634
24432	47226	923	154	349	0	48652
24433	47406	325	88	330	0	48149
24434	1180	239	48248	155	0	49822
24435	481	50256	816	148	0	51701
24436	512	939	282	50087	0	51820
24437	447	354	182	51286	0	52269
24438	469	272	151	48867	0	49759
24439	50099	206	89	1276	0	51670
24440	48396	190	98	615	0	49299
24441	48923	185	119	500	0	49727
24442	1133	49255	139	220	0	50747
24443	48144	766	97	387	0	49394
24444	923	48793	135	247	0	50098
24445	410	863	48008	210	0	49491
24446	286	47975	674	179	0	49114
24447	602	965	490	44812	0	46869
24448	275	183	116	44209	0	44783
24449	161	166	44194	576	0	45097
24450	306	113	481	42343	0	43243
24451	255	82	156	44024	0	44517
24452	44308	103	128	815	0	45354
24453	43469	108	126	408	0	44111
24454	44381	81	67	379	0	44908
24455	693	44778	113	164	0	45748
24456	44373	515	102	301	0	45291
24457	42999	171	76	300	0	43546
24458	659	44096	96	161	0	45012
24459	400	513	110	43856	0	44879
24460	365	190	66	44249	0	44870
24461	43815	125	81	771	0	44792
24462	605	173	43262	253	0	44293
24463	260	41863	486	196	0	42805
24464	322	602	132	40417	0	41473
24465	184	40200	108	441	0	40933
24466	169	41610	100	156	0	42035
24467	41417	523	139	333	0	42412
24468	41425	168	59	265	0	41917
24469	660	164	56	41785	0	42665
24470	360	135	69	40940	0	41504
24471	306	103	64	41140	0	41613
24472	273	122	57	40837	0	41289
24473	172	152	40001	614	0	40939
24474	178	160	37691	262	0	38291
24475	287	81	478	40553	0	41399
24476	162	144	43575	529	0	44410
24477	147	44005	545	231	0	44928
24478	44428	518	143	465	0	45554
24479	45120	187	127	328	0	45762
24480	771	157	103	45571	0	46602
24481	431	122	78	45562	0	46193
24482	341	98	89	46333	0	46861
24483	179	46696	84	699	0	47658
24484	46724	608	74	532	0	47938
24485	46702	200	51	510	0	47463
24486	831	174	46109	202	0	47316
24487	485	119	610	48858	0	50072
24488	273	162	50792	857	0	52084
24489	397	141	819	55614	0	56971
24490	416	141	191	55758	0	56506
24491	481	156	137	55654	0	56428
24492	391	149	125	57837	0	58502
24493	57545	128	108	1857	0	59638
24494	59171	131	132	970	0	60404
24495	60478	141	76	700	0	61395
24496	1969	125	81	59828	0	62003
24497	744	151	59009	1378	0	61282
24498	57326	86	1199	782	0	59393
24499	1532	122	451	59834	0	61939
24500	59747	117	282	1621	0	61767
24501	1655	82	168	59727	0	61632
24502	598	57904	187	1563	0	60252
24503	420	61791	173	720	0	63104
24504	529	1440	143	61490	0	63602
24505	599	508	136	61153	0	62396
24506	510	306	78	61638	0	62532
24507	290	60417	119	1844	0	62670
24508	59381	1192	96	1076	0	61745
24509	1321	60307	126	561	0	62315
24510	546	1381	60243	333	0	62503
24511	668	487	1168	58965	0	61288
24512	256	61924	465	1324	0	63969
24513	467	1252	293	61609	0	63621
24514	398	493	170	62529	0	63590
24515	266	323	61746	1841	0	64176
24516	57062	189	1175	1306	0	59732
24517	1328	63552	455	672	0	66007
24518	63465	1252	279	841	0	65837
24519	65481	449	131	697	0	66758
24520	65549	331	131	685	0	66696
24521	2031	232	61137	400	0	63800
24522	1145	204	1320	59460	0	62129
24523	811	205	490	60934	0	62440
24524	449	235	59533	1870	0	62087
24525	54787	192	1386	1189	0	57554
24526	1629	202	59748	653	0	62232
24527	581	252	58295	482	0	59610
24528	419	58736	1597	467	0	61219
24529	608	1285	652	58921	0	61466
24530	327	495	59334	1491	0	61647
24531	54602	319	1334	921	0	57176
24532	57127	239	499	651	0	58516
24533	1745	255	57247	340	0	59587
24534	994	202	1334	56597	0	59127
24535	483	238	58140	1446	0	60307
24536	324	58577	1503	725	0	61129
24537	62182	1327	570	806	0	64885
24538	63312	494	409	626	0	64841
24539	65195	347	315	545	0	66402
24540	2400	231	279	63710	0	66620
24541	1117	238	301	65817	0	67473
24542	614	268	64383	2100	0	67365
24543	62864	231	1593	1083	0	65771
24544	2021	179	595	64917	0	67712
24545	64718	155	448	1998	0	67319
24546	2088	172	64573	855	0	67688
24547	909	220	66108	631	0	67868
24548	878	175	2067	62986	0	66106
24549	722	180	873	66920	0	68695
24550	527	198	66223	2173	0	69121
24551	63768	190	1809	1145	0	66912
24552	2125	227	810	64040	0	67202
24553	853	67440	606	1854	0	70753
24554	67721	1586	458	1138	0	70903
24555	1884	68976	449	742	0	72051
24556	68986	1783	421	769	0	71959
24557	2274	642	70297	522	0	73735
24558	1103	437	68771	492	0	70803
24559	771	70032	2160	556	0	73519
24560	70225	1673	976	735	0	73609
24561	2069	660	69947	506	0	73182
24562	67457	411	1840	722	0	70430
24563	2216	69574	891	524	0	73205
24564	1266	1591	636	70536	0	74029
24565	974	618	519	69697	0	71808
24566	597	69161	567	2154	0	72479
24567	72157	1718	428	1298	0	75601
24568	74659	709	466	896	0	76730
24569	76235	437	432	779	0	77883
24570	2698	405	75177	501	0	78781
24571	1432	312	1930	74903	0	78577
24572	1046	316	898	76095	0	78355
24573	863	355	638	78338	0	80194
24574	652	383	76315	2601	0	79951
24575	663	74343	1914	1187	0	78107
24576	71660	1765	827	891	0	75143
24577	2080	778	72968	451	0	76277
24578	70310	502	1920	735	0	73467
24579	2071	72323	952	511	0	75857
24580	72965	1740	623	655	0	75983
24581	2413	748	498	71964	0	75623
24582	73226	470	535	1995	0	76226
24583	2438	354	454	73429	0	76675
24584	1109	363	74877	2012	0	78361
24585	1132	639	1748	73975	0	77494
24586	700	394	74392	2024	0	77510
24587	66671	312	1716	1177	0	69876
24588	1749	69778	878	671	0	73076
24589	1041	1252	455	61783	0	64531
24590	563	65914	413	1130	0	68020
24591	65274	1123	536	756	0	67689
24592	65145	452	391	704	0	66692
24593	1492	64767	410	446	0	67115
24594	63820	1004	338	636	0	65798
24595	65397	426	372	578	0	66773
24596	1484	313	286	64390	0	66473
24597	845	271	271	65227	0	66614
24598	67248	226	294	1496	0	69264
24599	68088	221	291	728	0	69328
24600	1726	242	233	66884	0	69085
24601	970	251	208	71690	0	73119
24602	72880	199	254	1835	0	75168
24603	1623	252	72178	711	0	74764
24604	67837	203	1315	876	0	70231
24605	1680	245	71223	427	0	73575
24606	750	70094	1469	366	0	72679
24607	829	1244	584	69419	0	72076
24608	574	498	72223	1298	0	74593
24609	534	74063	1359	590	0	76546
24610	72664	1358	559	807	0	75388
24611	1533	557	73325	326	0	75741
24612	70451	341	1296	572	0	72660
24613	73893	277	440	620	0	75230
24614	74639	239	297	628	0	75803
24615	1956	243	307	71216	0	73722
24616	877	73929	320	1263	0	76389
24617	71920	1112	268	1012	0	74312
24618	1521	430	73626	442	0	76019
24619	66343	258	1198	837	0	68636
24620	1467	263	73445	347	0	75522
24621	709	72489	1258	462	0	74918
24622	733	1131	538	72992	0	75394
24623	724	455	361	72840	0	74380
24624	536	72471	371	1354	0	74732
24625	669	1201	352	73329	0	75551
24626	499	521	74057	1327	0	76404
24627	459	74343	1287	560	0	76649
24628	646	1322	450	73395	0	75813
24629	72693	510	351	1707	0	75261
24630	75482	357	286	857	0	76982
24631	2076	321	294	76140	0	78831
24632	936	77769	296	1496	0	80497
24633	881	1367	307	77977	0	80532
24634	873	521	256	77227	0	78877
24635	576	382	73647	1944	0	76549
24636	537	73975	1403	857	0	76772
24637	674	1310	381	71222	0	73587
24638	370	497	70370	1348	0	72585
24639	370	69096	1196	544	0	71206
24640	540	1139	465	69590	0	71734
24641	69613	447	328	1495	0	71883
24642	1324	71851	262	556	0	73993
24643	784	1215	194	72233	0	74426
24644	73798	490	185	1691	0	76164
24645	74413	338	215	893	0	75859
24646	74599	287	227	717	0	75830
24647	73915	277	247	644	0	75083
24648	1820	244	238	73185	0	75487
24649	736	305	74207	1336	0	76584
24650	766	402	1133	71776	0	74077
24651	445	73544	451	1310	0	75750
24652	74209	1149	317	990	0	76665
24653	1317	518	72072	466	0	74373
24654	68868	326	1158	712	0	71064
24655	1380	346	70772	349	0	72847
24656	812	281	1138	70301	0	72532
24657	540	264	71055	1199	0	73058
24658	710	281	1138	69642	0	71771
24659	533	296	70540	1253	0	72622
24660	724	217	1139	69164	0	71244
24661	70405	193	430	1658	0	72686
24662	1231	74115	380	691	0	76417
24663	789	1128	334	74850	0	77101
24664	727	470	275	74944	0	76416
24665	516	333	77021	1456	0	79326
24666	508	295	73193	617	0	74613
24667	70392	258	1377	910	0	72937
24668	1228	74051	619	467	0	76365
24669	73079	996	493	649	0	75217
24670	74109	379	349	672	0	75509
24671	1468	262	368	72626	0	74724
24672	654	74764	398	1066	0	76882
24673	75899	1041	386	894	0	78220
24674	76909	384	286	751	0	78330
24675	78018	294	272	771	0	79355
24676	77975	256	279	760	0	79270
24677	77083	222	287	727	0	78319
24678	1528	257	74287	364	0	76436
24679	74180	243	1083	595	0	76101
24680	1500	257	75410	304	0	77471
24681	1013	217	1129	73920	0	76279
24682	781	198	466	77389	0	78834
24683	561	213	75359	1332	0	77465
24684	73494	197	1126	816	0	75633
24685	1456	223	503	76816	0	78998
24686	832	237	343	79047	0	80459
24687	720	204	303	80045	0	81272
24688	665	203	280	79002	0	80150
24689	667	198	261	80537	0	81663
24690	470	262	80583	1768	0	83083
24691	682	197	1274	78916	0	81069
24692	443	237	80924	1642	0	83246
24693	540	242	79017	801	0	80600
24694	78436	164	1747	939	0	81286
24695	82678	165	721	849	0	84413
24696	87810	181	883	849	0	89723
24697	2311	244	91008	488	0	94051
24698	1032	225	90013	562	0	91832
24699	686	182	92918	542	0	94328
24700	522	96208	2618	572	0	99920
24701	1332	2241	1479	93431	0	98483
24702	97778	556	664	2336	0	101334
24703	2389	316	420	102986	0	106111
24704	875	105328	456	2512	0	109171
24705	106756	2162	379	1456	0	110753
24706	2808	775	388	105509	0	109480
24707	1147	108212	499	2492	0	112350
24708	1172	2164	453	109101	0	112890
24709	953	845	462	109373	0	111633
24710	106714	457	475	3551	0	111197
24711	2808	335	511	107341	0	110995
24712	1149	432	105764	2937	0	110282
24713	1199	310	2478	103673	0	107660
24714	660	101791	1108	2917	0	106476
24715	640	106520	808	1462	0	109430
24716	917	2912	603	102891	0	107323
24717	821	1230	570	102880	0	105501
24718	540	101405	585	3402	0	105932
24719	668	102640	545	1801	0	105654
24720	578	105534	514	1372	0	107998
24721	1008	3548	344	96866	0	101766
24722	608	104364	406	2781	0	108159
24723	102319	3001	367	2084	0	107771
24724	2717	1567	104291	1308	0	109883
24725	1669	1157	2305	100930	0	106061
24726	821	105213	1072	2951	0	110057
24727	102606	2875	612	2209	0	108302
24728	2684	1615	104880	1401	0	110580
24729	1179	105114	2448	1286	0	110027
24730	101198	2759	1024	1657	0	106638
24731	2359	101445	702	1171	0	105677
24732	1045	104122	618	1010	0	106795
24733	1150	3374	524	101070	0	106118
24734	559	104471	438	2566	0	108034
24735	102594	2981	398	1817	0	107790
24736	2624	1666	362	102905	0	107557
24737	1174	1425	101863	2614	0	107076
24738	851	1238	101219	1392	0	104700
24739	832	1190	2627	101973	0	106622
24740	589	1257	103926	2608	0	108380
24741	973	1112	2395	103465	0	107945
24742	100003	983	1155	3359	0	105500
24743	2413	1036	101568	1507	0	106524
24744	1522	900	2326	98085	0	102833
24745	845	99184	1221	2587	0	103837
24746	870	2639	915	100997	0	105421
24747	907	1373	712	100951	0	103943
24748	688	100928	842	3189	0	105647
24749	972	2665	763	102761	0	107161
24750	953	1436	729	103900	0	107018
24751	585	1266	102421	3353	0	107625
24752	536	101421	2488	1933	0	106378
24753	100811	2767	1157	1908	0	106643
24754	2494	1520	912	102400	0	107326
24755	1148	1193	103194	3177	0	108712
24756	1186	979	2444	102172	0	106781
24757	706	969	102615	3293	0	107583
24758	96416	822	2861	2532	0	102631
24759	2287	102164	1559	1662	0	107672
24760	1426	2538	1134	103360	0	108458
24761	1212	1304	941	106520	0	109977
24762	100588	1098	898	4065	0	106649
24763	2811	919	947	101982	0	106659
24764	1320	998	100230	3677	0	106225
24765	1147	967	2678	96003	0	100795
24766	723	94940	1437	3524	0	100624
24767	721	98578	1055	2284	0	102638
24768	745	100370	823	1994	0	103932
24769	889	3554	771	98587	0	103801
24770	679	2005	96767	3494	0	102945
24771	594	96884	2555	2188	0	102221
24772	93325	2963	1273	2034	0	99595
24773	2344	96825	925	1689	0	101783
24774	96288	3152	736	2013	0	102189
24775	96698	1597	830	2010	0	101135
24776	3153	1337	95369	1511	0	101370
24777	96291	1128	2604	1852	0	101875
24778	101366	1131	1388	1818	0	105703
24779	96924	1187	996	2037	0	101144
24780	101376	1123	760	1770	0	105029
24781	3535	1256	99857	1306	0	105954
24782	98217	1136	2553	1514	0	103420
24783	102403	1075	1212	1749	0	106439
24784	3302	104037	1063	1161	0	109563
24785	1960	2930	629	101684	0	107203
24786	1564	1722	590	102414	0	106290
24787	1103	103152	686	3155	0	108096
24788	101294	2858	644	2083	0	106879
24789	2717	103037	800	1085	0	107639
24790	99944	2927	747	1224	0	104842
24791	101044	1503	611	1281	0	104439
24792	3406	102182	586	797	0	106971
24793	2219	2758	504	100905	0	106386
24794	1559	1351	101855	2560	0	107325
24795	1232	99215	2492	1293	0	104232
24796	1489	3229	1011	89953	0	95682
24797	1027	93568	762	1878	0	97235
24798	807	99146	470	912	0	101335
24799	1349	3350	520	92850	0	98069
24800	615	1236	94952	2226	0	99029
24801	494	91076	2078	1120	0	94768
24802	413	91017	954	614	0	92998
24803	80701	2026	515	686	0	83928
24804	1639	892	221	82584	0	85336
24805	950	559	142	83220	0	84871
24806	643	363	90	85567	0	86663
24807	309	300	83931	2366	0	86906
24808	590	241	1715	83680	0	86226
24809	176	86980	710	2217	0	90083
24810	89521	1972	310	1245	0	93048
24811	2432	808	250	89679	0	93169
24812	845	507	89498	2272	0	93122
24813	89833	399	2085	1234	0	93551
24814	2836	260	764	93999	0	97859
24815	1031	315	99345	2434	0	103125
24816	573	368	99949	993	0	101883
24817	98987	266	3163	1002	0	103418
24818	104992	218	1154	966	0	107330
24819	104522	218	636	920	0	106296
24820	105692	217	465	808	0	107182
24821	3836	341	103361	411	0	107949
24822	1614	104563	2584	527	0	109288
24823	104321	2625	962	918	0	108826
24824	2926	104407	579	400	0	108312
24825	103504	2872	436	839	0	107651
24826	2982	104939	396	432	0	108749
24827	1852	2940	342	103941	0	109075
24828	1252	1240	331	105216	0	108039
24829	999	699	354	104529	0	106581
24830	606	101171	480	3638	0	105895
24831	591	104716	393	1663	0	107363
24832	1073	3316	310	98760	0	103459
24833	626	101944	361	2733	0	105664
24834	601	3236	101026	1152	0	106015
24835	978	1422	2718	99919	0	105037
24836	586	938	101732	2900	0	106156
24837	98037	746	2944	1658	0	103385
24838	101237	598	1216	1191	0	104242
24839	3770	614	100547	703	0	105634
24840	1728	640	99996	600	0	102964
24841	1382	568	3513	98204	0	103667
24842	828	598	100306	3000	0	104732
24843	1057	592	3198	94297	0	99144
24844	786	90534	1717	2979	0	96016
24845	959	3031	784	99288	0	104062
24846	943	1421	665	100637	0	103666
24847	913	903	554	101029	0	103399
24848	598	838	96934	4176	0	102546
24849	931	570	2948	95286	0	99735
24850	908	648	1324	96257	0	99137
24851	949	667	888	94450	0	96954
24852	726	96039	774	3804	0	101343
24853	96063	2864	667	2173	0	101767
24854	96895	1320	685	1714	0	100614
24855	97099	851	672	1455	0	100077
24856	4178	785	656	94359	0	99978
24857	1910	689	94190	3281	0	100070
24858	1561	725	93266	1801	0	97353
24859	934	94196	3632	1351	0	100113
24860	90971	2925	1594	1716	0	97206
24861	2779	93213	1089	1221	0	98302
24862	93067	3112	936	1399	0	98514
24863	3137	93586	760	1211	0	98694
24864	92398	3285	697	1361	0	97741
24865	3229	96867	740	1136	0	101972
24866	1937	3461	627	96670	0	102695
24867	1323	1757	95739	3333	0	102152
24868	1214	1148	96863	1817	0	101042
24869	1318	954	3798	94951	0	101021
24870	1212	814	1894	96311	0	100231
24871	1187	762	1193	99190	0	102332
24872	1047	801	96264	4265	0	102377
24873	1264	722	3103	94710	0	99799
24874	92533	697	1528	4272	0	99030
24875	93960	682	1106	2458	0	98206
24876	3877	92123	1026	1536	0	98562
24877	90202	2976	841	1502	0	95521
24878	3621	89933	747	1169	0	95470
24879	89823	3307	689	1322	0	95141
24880	90983	1672	815	1280	0	94750
24881	89209	1055	832	1333	0	92429
24882	4335	949	87785	969	0	94038
24883	2257	857	86551	1012	0	90677
24884	84724	607	3667	1249	0	90247
24885	89331	619	1831	1133	0	92914
24886	4368	696	1180	86659	0	92903
24887	2590	611	849	90388	0	94438
24888	1922	623	777	92595	0	95917
24889	1595	691	755	93400	0	96441
24890	1384	796	714	96354	0	99248
24891	92292	800	705	5040	0	98837
24892	3756	835	539	92706	0	97836
24893	1934	811	90983	3897	0	97625
24894	87012	756	2832	2418	0	93018
24895	91098	608	1428	1838	0	94972
24896	4176	88963	987	1487	0	95613
24897	1811	90515	737	1180	0	94243
24898	82199	2691	583	1025	0	86498
24899	2436	85876	500	777	0	89589
24900	83789	2363	715	958	0	87825
24901	88818	962	520	937	0	91237
24902	90860	481	430	953	0	92724
24903	3892	373	429	85828	0	90522
24904	1583	86782	480	2595	0	91440
24905	88020	2201	340	1382	0	91943
24906	3155	856	333	87577	0	91921
24907	1662	529	320	86601	0	89112
24908	82021	291	230	3275	0	85817
24909	2212	80858	277	1494	0	84841
24910	1332	1856	180	80168	0	83536
24911	80658	775	124	2566	0	84123
24912	2092	82344	199	1111	0	85746
24913	83085	1784	76	1004	0	85949
24914	2376	887	76955	508	0	80726
24915	75461	443	1328	678	0	77910
24916	2292	78633	529	358	0	81812
24917	77692	1687	367	570	0	80316
24918	77664	700	134	601	0	79099
24919	2351	79492	164	339	0	82346
24920	79844	1640	102	603	0	82189
24921	2113	78853	154	332	0	81452
24922	82046	1816	86	601	0	84549
24923	2422	821	100	81877	0	85220
24924	1438	550	90	82349	0	84427
24925	1132	368	67	83898	0	85465
24926	612	476	80358	2318	0	83764
24927	940	340	1455	80254	0	82989
24928	587	362	81009	2001	0	83959
24929	904	278	1719	79589	0	82490
24930	554	80930	683	1891	0	84058
24931	852	1711	346	82218	0	85127
24932	638	820	82102	1987	0	85547
24933	517	664	84113	909	0	86203
24934	756	401	2005	83812	0	86974
24935	83492	398	855	2302	0	87047
24936	84422	293	510	1324	0	86549
24937	2314	84884	347	859	0	88404
24938	1395	1658	277	85635	0	88965
24939	809	774	87682	2060	0	91325
24940	892	545	1711	87601	0	90749
24941	653	420	88508	2250	0	91831
24942	85220	387	2024	1325	0	88956
24943	2349	410	787	88929	0	92475
24944	1182	442	88357	2107	0	92088
24945	1114	398	1840	88021	0	91373
24946	963	414	872	89935	0	92184
24947	713	345	88945	2675	0	92678
24948	832	332	1882	88567	0	91613
24949	88572	319	859	2799	0	92549
24950	89895	330	601	1537	0	92363
24951	2729	423	414	90310	0	93876
24952	90928	341	377	2679	0	94325
24953	2513	400	90437	1338	0	94688
24954	1359	391	88716	1061	0	91527
24955	89797	260	2476	1196	0	93729
24956	94334	259	1172	1087	0	96852
24957	2970	288	697	91798	0	95753
24958	1641	345	585	93733	0	96304
24959	1113	302	92004	2862	0	96281
24960	1105	362	2022	87332	0	90821
24961	796	91536	1070	2307	0	95709
24962	92558	1888	706	1713	0	96865
24963	99008	850	583	1314	0	101755
24964	3181	99260	509	886	0	103836
24965	96197	2231	454	1168	0	100050
24966	97002	866	461	1083	0	99412
24967	3181	98029	593	812	0	102615
24968	98414	2293	547	1135	0	102389
24969	2972	98824	570	755	0	103121
24970	99405	2516	461	1121	0	103503
24971	3058	1105	98752	796	0	103711
24972	1842	689	2342	98403	0	103276
24973	1414	501	1013	101270	0	104198
24974	1131	463	752	106351	0	108697
24975	104609	433	590	4038	0	109670
24976	3310	391	470	107226	0	111397
24977	1710	450	106347	3424	0	111931
24978	106406	464	2675	1956	0	111501
24979	3618	454	1085	106992	0	112149
24980	1711	104115	834	3281	0	109941
24981	1215	109389	689	1615	0	112908
24982	1518	3164	569	106971	0	112222
24983	1441	1431	667	106649	0	110188
24984	1496	811	565	109155	0	112027
24985	1043	610	104150	4130	0	109933
24986	866	102964	2627	2199	0	108656
24987	100172	2421	970	1906	0	105469
24988	98947	1076	788	1654	0	102465
24989	3247	97386	631	1152	0	102416
24990	1437	99839	550	1116	0	102942
24991	1630	2659	702	97753	0	102744
24992	927	1072	96676	2688	0	101363
24993	91688	996	2300	1813	0	96797
24994	96181	572	889	1305	0	98947
24995	3019	493	673	95152	0	99337
24996	1553	458	526	95919	0	98456
24997	92197	379	414	3418	0	96408
24998	2470	415	91244	1636	0	95765
24999	86900	412	2031	1556	0	90899
25000	2559	88791	930	896	0	93176
25001	1236	1586	334	81955	0	85111
25002	719	83025	348	1816	0	85908
25003	83924	1650	350	1212	0	87136
25004	2071	707	391	82630	0	85799
25005	1174	515	367	81791	0	83847
25006	817	82014	387	2027	0	85245
25007	82683	1544	274	1285	0	85786
25008	82967	660	239	1143	0	85009
25009	2212	587	81065	778	0	84642
25010	1093	495	76736	717	0	79041
25011	76587	336	1748	898	0	79569
25012	1957	383	77315	575	0	80230
25013	977	418	73302	544	0	75241
25014	72752	378	1898	866	0	75894
25015	1783	307	83276	576	0	85942
25016	1170	253	2230	82391	0	86044
25017	981	277	990	83954	0	86202
25018	88542	261	661	3262	0	92726
25019	2861	398	89504	1460	0	94223
25020	92738	330	2782	1173	0	97023
25021	3892	382	1198	93062	0	98534
25022	93760	288	881	3355	0	98284
25023	94763	249	655	1885	0	97552
25024	96462	186	519	1414	0	98581
25025	5454	261	477	92938	0	99130
25026	95503	214	460	3618	0	99795
25027	5126	204	409	94346	0	100085
25028	3110	237	447	95482	0	99276
25029	2503	224	508	96300	0	99535
25030	2139	241	381	97471	0	100232
25031	93844	289	433	5680	0	100246
25032	95374	272	389	3336	0	99371
25033	4908	302	92808	2125	0	100143
25034	94068	217	3169	2053	0	99507
25035	97615	172	1448	1961	0	101196
25036	5733	243	900	92781	0	99657
25037	3198	92171	664	3937	0	99970
25038	95138	2944	646	2224	0	100952
25039	5271	1221	582	91399	0	98473
25040	91579	735	612	4237	0	97163
25041	4967	89767	615	2259	0	97608
25042	92597	3193	485	1953	0	98228
25043	5212	1487	402	89573	0	96674
25044	2778	88900	397	4035	0	96110
25045	91170	3413	366	2475	0	97424
25046	4526	88772	467	1988	0	95753
25047	2579	94762	538	1578	0	99457
25048	94243	4309	595	1786	0	100933
25049	4538	2219	91706	1498	0	99961
25050	94096	1451	3069	1639	0	100255
25051	5658	1178	1401	92439	0	100676
25052	3231	972	93451	3605	0	101259
25053	3168	837	3509	91595	0	99109
25054	2785	790	1714	94450	0	99739
25055	2374	761	92219	5198	0	100552
25056	91853	608	3789	3106	0	99356
25057	5286	487	1735	93300	0	100808
25058	3259	534	1183	95369	0	100345
25059	2816	516	843	95789	0	99964
25060	92656	583	752	6762	0	100753
25061	4752	607	89919	3961	0	99239
25062	2845	574	91093	2914	0	97426
25063	2444	472	4048	85643	0	92607
25064	2038	400	85260	4484	0	92182
25065	82447	419	3842	3066	0	89774
25066	4124	83153	2303	2179	0	91759
25067	83524	2806	1730	1854	0	89914
25068	5086	1352	1247	79920	0	87605
25069	2815	80511	1218	3853	0	88397
25070	2658	3322	1064	80577	0	87621
25071	2263	81492	879	4176	0	88810
25072	2267	3655	639	82572	0	89133
25073	1950	1881	79869	4648	0	88348
25074	1682	1592	76615	2723	0	82612
25075	1604	77111	3603	2399	0	84717
25076	73498	2920	1944	2173	0	80535
25077	3382	1777	1228	72512	0	78899
25078	2311	1318	1005	73737	0	78371
25079	72808	1029	928	4294	0	79059
25080	73602	1028	951	2688	0	78269
25081	4723	786	930	72917	0	79356
25082	2969	750	71074	3554	0	78347
25083	2409	70779	2914	2281	0	78383
25084	2074	2678	1502	71428	0	77682
25085	1909	1506	1380	71042	0	75837
25086	1656	72858	910	4210	0	79634
25087	73141	2953	822	3132	0	80048
25088	3462	1749	73292	2084	0	80587
25089	2433	1401	2919	72377	0	79130
25090	1928	1079	1447	73639	0	78093
25091	1283	1086	71414	4977	0	78760
25092	1557	915	3046	72892	0	78410
25093	72513	783	1754	4633	0	79683
25094	73007	737	1611	2973	0	78328
25095	73595	594	1380	2613	0	78182
25096	4571	71216	1219	2196	0	79202
25097	76421	2708	1205	1903	0	82237
25098	4900	1400	1010	74970	0	82280
25099	3008	1257	874	75249	0	80388
25100	2510	81253	867	4485	0	89115
25101	87971	3575	718	2996	0	95260
25102	92407	1932	824	2413	0	97576
25103	93941	1511	798	2231	0	98481
25104	95654	1228	636	2223	0	99741
25105	95469	991	769	2293	0	99522
25106	6643	1001	90355	1758	0	99757
25107	93871	922	3984	1681	0	100458
25108	96109	920	1841	1682	0	100552
25109	95833	643	1544	1541	0	99561
25110	7486	656	1126	90304	0	99572
25111	4635	596	1022	92665	0	98918
25112	3426	589	88423	5363	0	97801
25113	77392	698	3762	3944	0	85796
25114	4875	85552	1943	2598	0	94968
25115	2463	78008	1033	1543	0	83047
25116	1934	3097	75553	1279	0	81863
25117	1435	73838	2791	1308	0	79372
25118	1145	72716	1244	955	0	76060
25119	1736	4031	1342	60485	0	67594
25120	637	64372	439	1729	0	67177
25121	63340	2203	264	939	0	66746
25122	63069	834	265	724	0	64892
25123	2842	601	227	61282	0	64952
25124	1290	462	60793	1893	0	64438
25125	59756	278	1831	998	0	62863
25126	2429	337	61046	648	0	64460
25127	1189	287	62289	458	0	64223
25128	1215	227	2311	57883	0	61636
25129	992	212	986	60858	0	63048
25130	613	228	61204	2276	0	64321
25131	597	58888	1995	1085	0	62565
25132	526	62972	851	780	0	65129
25133	60689	2112	658	863	0	64322
25134	62212	767	320	621	0	63920
25135	2323	520	60315	333	0	63491
25136	59488	343	1705	429	0	61965
25137	63318	306	553	503	0	64680
25138	2562	296	396	61498	0	64752
25139	1449	243	308	62450	0	64450
25140	1271	211	224	63109	0	64815
25141	62669	249	224	2440	0	65582
25142	63692	186	228	1197	0	65303
25143	64739	151	188	806	0	65884
25144	3032	179	213	63335	0	66759
25145	1587	242	61860	1853	0	65542
25146	61106	179	1658	947	0	63890
25147	61672	191	653	730	0	63246
25148	2830	203	523	59196	0	62752
25149	1516	60193	399	1752	0	63860
25150	1355	1644	272	59948	0	63219
25151	885	60998	326	2074	0	64283
25152	981	1945	329	58687	0	61942
25153	842	61442	365	2002	0	64651
25154	60727	1835	323	969	0	63854
25155	2242	844	291	60184	0	63561
25156	1075	60579	302	1787	0	63743
25157	913	1831	60136	741	0	63621
25158	58821	772	1760	745	0	62098
25159	2131	665	605	59520	0	62921
25160	1020	59819	487	1747	0	63073
25161	1048	1658	360	58053	0	61119
25162	733	57545	346	1878	0	60502
25163	752	62125	354	810	0	64041
25164	60497	2000	365	905	0	63767
25165	62323	882	375	813	0	64393
25166	2214	778	61687	452	0	65131
25167	61129	550	1705	544	0	63928
25168	62330	481	735	627	0	64173
25169	2245	61047	593	493	0	64378
25170	1320	1720	408	61228	0	64676
25171	1200	702	316	62011	0	64229
25172	912	623	60615	1978	0	64128
25173	890	554	59643	875	0	61962
25174	60128	363	1963	883	0	63337
25175	62359	302	929	675	0	64265
25176	62518	264	743	628	0	64153
25177	2693	209	60476	507	0	63885
25178	1528	218	1787	59727	0	63260
25179	60701	228	787	2018	0	63734
25180	2124	254	578	60569	0	63525
25181	1012	276	59179	2069	0	62536
25182	56807	330	1580	1086	0	59803
25183	2134	362	61392	653	0	64541
25184	1057	60289	1741	620	0	63707
25185	60846	1515	737	618	0	63716
25186	2059	567	60415	451	0	63492
25187	1154	525	1664	59170	0	62513
25188	60110	327	732	1757	0	62926
25189	2079	277	446	60374	0	63176
25190	61106	330	349	2175	0	63960
25191	2130	358	206	60810	0	63504
25192	61988	292	237	2249	0	64766
25193	62581	288	257	1194	0	64320
25194	62453	319	231	920	0	63923
25195	62111	265	230	747	0	63353
25196	2753	398	305	60339	0	63795
25197	1214	297	57771	1393	0	60675
25198	957	242	57538	704	0	59441
25199	740	56320	1582	586	0	59228
25200	489	50466	615	328	0	51898
25201	43533	632	1338	267	0	45770
25202	654	207	89	41707	0	42657
25203	200	97	42192	449	0	42938
25204	175	104	43063	181	0	43523
25205	247	209	495	43229	0	44180
25206	43549	92	167	550	0	44358
25207	439	44069	124	179	0	44811
25208	46188	372	67	346	0	46973
25209	540	131	65	46498	0	47234
25210	318	81	128	46417	0	46944
25211	269	62	125	46371	0	46827
25212	144	104	46663	556	0	47467
25213	184	115	45081	242	0	45622
25214	139	45949	521	177	0	46786
25215	247	404	183	47056	0	47890
25216	46460	139	145	682	0	47426
25217	496	134	45398	226	0	46254
25218	218	135	46483	223	0	47059
25219	301	76	619	46884	0	47880
25220	231	94	249	48360	0	48934
25221	224	126	158	48843	0	49351
25222	327	87	136	53568	0	54118
25223	55088	69	114	1337	0	56608
25224	1146	63	139	56100	0	57448
25225	56010	66	172	1325	0	57573
25226	1166	80	56923	380	0	58549
25227	355	57174	1048	349	0	58926
25228	408	983	295	56988	0	58674
25229	245	265	58254	1147	0	59911
25230	257	168	57344	437	0	58206
25231	189	58530	1289	343	0	60351
25232	330	955	402	56628	0	58315
25233	342	273	224	57606	0	58445
25234	186	193	57681	1239	0	59299
25235	54996	153	1139	670	0	56958
25236	1235	115	382	57473	0	59205
25237	519	104	289	57024	0	57936
25238	279	160	58055	1421	0	59915
25239	221	56856	1259	595	0	58931
25240	166	63006	450	424	0	64046
25241	62742	1522	303	538	0	65105
25242	1542	489	288	63224	0	65543
25243	66098	269	282	1758	0	68407
25244	1778	216	65792	645	0	68431
25245	809	182	1659	65400	0	68050
25246	65370	152	584	2055	0	68161
25247	66897	170	409	913	0	68389
25248	2300	207	240	65921	0	68668
25249	909	167	65324	1843	0	68243
25250	535	158	66447	827	0	67967
25251	668	179	1972	65351	0	68170
25252	361	163	66341	1768	0	68633
25253	62078	157	1821	1050	0	65106
25254	1741	64693	685	652	0	67771
25255	65429	1524	489	669	0	68111
25256	66745	516	359	735	0	68355
25257	2399	327	418	65899	0	69043
25258	1065	215	545	67071	0	68896
25259	66858	230	334	2447	0	69869
25260	2072	184	396	66843	0	69495
25261	880	228	66418	2082	0	69608
25262	566	66116	1802	899	0	69383
25263	626	1668	755	64747	0	67796
25264	693	555	487	65657	0	67392
25265	677	337	394	66422	0	67830
25266	467	246	64286	2607	0	67606
25267	604	63409	1778	1210	0	67001
25268	605	1582	759	64774	0	67720
25269	494	581	64606	2125	0	67806
25270	630	477	1846	64310	0	67263
25271	64068	347	723	2519	0	67657
25272	2021	325	563	65439	0	68348
25273	896	329	64502	2361	0	68088
25274	62626	231	1946	1515	0	66318
25275	1880	64919	956	918	0	68673
25276	760	68155	768	927	0	70610
25277	67948	1922	594	1125	0	71589
25278	2065	771	69703	842	0	73381
25279	1252	442	1925	68974	0	72593
25280	957	357	857	71363	0	73534
25281	529	396	70971	2576	0	74472
25282	603	70396	2074	1359	0	74432
25283	1037	1756	990	63578	0	67361
25284	592	748	70032	2233	0	73605
25285	895	511	2030	69589	0	73025
25286	69434	435	1006	2641	0	73516
25287	2039	396	71431	1322	0	75188
25288	1152	441	1930	71904	0	75427
25289	921	490	909	73039	0	75359
25290	723	548	70913	2744	0	74928
25291	884	385	2021	68073	0	71363
25292	686	63934	1258	2623	0	68501
25293	823	1741	934	65179	0	68677
25294	619	70215	746	2389	0	73969
25295	69857	1871	774	1576	0	74078
25296	69328	790	680	1453	0	72251
25297	2389	537	69072	1269	0	73267
25298	1090	502	68661	1020	0	71273
25299	763	509	67650	1007	0	69929
25300	616	67190	2594	908	0	71308
25301	750	1721	1344	68754	0	72569
25302	698	758	70162	2274	0	73892
25303	1027	549	2031	67355	0	70962
25304	893	411	991	68541	0	70836
25305	723	426	68954	2601	0	72704
25306	794	426	2074	68618	0	71912
25307	662	467	1032	67703	0	69864
25308	606	66224	874	2659	0	70363
25309	828	1751	658	68248	0	71485
25310	683	734	832	70478	0	72727
25311	512	560	69171	2885	0	73128
25312	570	418	2130	68532	0	71650
25313	490	397	69805	2764	0	73456
25314	426	474	68794	1624	0	71318
25315	66583	421	2449	1599	0	71052
25316	1927	637	1369	65899	0	69832
25317	810	68812	907	2497	0	73026
25318	675	70697	765	1559	0	73696
25319	808	2141	902	70206	0	74057
25320	571	823	70008	2676	0	74078
25321	518	69668	2274	1578	0	74038
25322	553	1467	867	65243	0	68130
25323	398	598	67909	1668	0	70573
25324	328	68421	1416	889	0	71054
25325	70462	1387	709	961	0	73519
25326	70501	641	556	840	0	72538
25327	71141	416	457	976	0	72990
25328	1688	311	519	74911	0	77429
25329	826	316	476	75305	0	76923
25330	535	328	425	75520	0	76808
25331	276	341	74034	2151	0	76802
25332	72728	406	1612	1292	0	76038
25333	1688	265	747	73652	0	76352
25334	668	263	73719	1748	0	76398
25335	73369	307	1575	1181	0	76432
25336	76320	217	803	1120	0	78460
25337	1983	829	63291	1057	0	67160
25338	73487	244	1157	1028	0	75916
25339	1595	77502	744	700	0	80541
25340	518	1001	74657	421	0	76597
25341	70822	410	1405	622	0	73259
25342	1046	73348	535	473	0	75402
25343	419	783	230	69539	0	70971
25344	152	71009	219	838	0	72218
25345	286	812	182	71764	0	73044
25346	212	270	71855	914	0	73251
25347	63871	130	952	713	0	65666
25348	862	143	71895	317	0	73217
25349	275	69825	926	296	0	71322
25350	161	71746	371	232	0	72510
25351	70047	933	240	439	0	71659
25352	857	337	70571	201	0	71966
25353	444	213	864	68890	0	70411
25354	177	206	71437	850	0	72670
25355	165	72242	907	341	0	73655
25356	427	846	312	67470	0	69055
25357	115	72160	272	684	0	73231
25358	73285	865	184	574	0	74908
25359	73855	298	235	498	0	74886
25360	73685	185	170	453	0	74493
25361	1053	187	72790	188	0	74218
25362	376	207	70590	170	0	71343
25363	70007	131	1076	432	0	71646
25364	929	195	74946	179	0	76249
25365	604	107	997	70117	0	71825
25366	211	73669	422	789	0	75091
25367	75647	861	233	620	0	77361
25368	74894	289	252	538	0	75973
25369	76980	177	191	480	0	77828
25370	1326	155	186	76948	0	78615
25371	592	111	180	78145	0	79028
25372	77331	116	193	1484	0	79124
25373	1049	76847	229	481	0	78606
25374	76324	917	171	533	0	77945
25375	1237	308	192	75190	0	76927
25376	570	135	167	75175	0	76047
25377	73373	126	133	1486	0	75118
25378	1024	72322	200	423	0	73969
25379	71931	925	137	625	0	73618
25380	1075	72664	160	242	0	74141
25381	71799	1012	143	403	0	73357
25382	1315	345	115	73180	0	74955
25383	73786	191	90	1260	0	75327
25384	75688	160	123	690	0	76661
25385	81892	191	94	643	0	82820
25386	1722	84988	136	266	0	87112
25387	675	1528	82727	168	0	85098
25388	81996	503	1404	464	0	84367
25389	84679	260	404	522	0	85865
25390	1971	83824	289	250	0	86334
25391	1037	1468	178	84444	0	87127
25392	837	517	163	85231	0	86748
25393	84725	326	205	2034	0	87290
25394	2039	344	180	85220	0	87783
25395	869	253	85111	1729	0	87962
25396	678	312	83456	696	0	85142
25397	85255	188	1798	777	0	88018
25398	2051	224	558	85874	0	88707
25399	1127	190	330	86895	0	88542
25400	837	185	297	88356	0	89675
25401	539	189	88301	2175	0	91204
25402	816	144	1709	86500	0	89169
25403	823	158	662	89108	0	90751
25404	691	170	378	90613	0	91852
25405	88096	174	276	2726	0	91272
25406	2187	173	253	88927	0	91540
25407	825	219	89844	2289	0	93177
25408	90392	203	1810	1432	0	93837
25409	2178	273	94475	763	0	97689
25410	94467	207	2116	980	0	97770
25411	94435	205	757	836	0	96233
25412	3224	214	395	97664	0	101497
25413	1281	98555	410	2568	0	102814
25414	1239	2050	360	99385	0	103034
25415	1179	913	420	100229	0	102741
25416	726	100975	467	3013	0	105181
25417	99513	2104	405	1720	0	103742
25418	2439	99620	446	973	0	103478
25419	99426	2302	359	1087	0	103174
25420	100540	919	276	1070	0	102805
25421	3362	554	277	98647	0	102840
25422	1775	458	267	98725	0	101225
25423	1031	408	94078	3169	0	98686
25424	912	389	90773	1495	0	93569
25425	88365	339	2570	1372	0	92646
25426	91264	292	1059	1285	0	93900
25427	2962	86620	667	881	0	91130
25428	1714	1838	516	84809	0	88877
25429	1026	699	90181	2415	0	94321
25430	1236	1073	2205	89443	0	93957
25431	88715	490	1118	2742	0	93065
25432	87979	318	639	1526	0	90462
25433	2843	88057	512	961	0	92373
25434	1718	1870	320	88895	0	92803
25435	1268	825	346	90521	0	92960
25436	1087	564	353	90583	0	92587
25437	780	513	85912	3118	0	90323
25438	78529	427	1982	1906	0	82844
25439	84087	460	800	1321	0	86668
25440	3078	485	84789	986	0	89338
25441	1553	85054	2019	989	0	89615
25442	85173	1905	873	1273	0	89224
25443	86217	787	678	1282	0	88964
25444	3082	540	83506	1028	0	88156
25445	1730	481	87074	893	0	90178
25446	1558	460	2598	86619	0	91235
25447	1160	544	88263	2216	0	92183
25448	85411	440	2429	1432	0	89712
25449	87996	435	1138	1183	0	90752
25450	89970	392	865	1093	0	92320
25451	3442	372	769	85761	0	90344
25452	1754	92168	790	2350	0	97062
25453	93993	1860	684	1769	0	98306
25454	93528	782	701	1395	0	96406
25455	3363	669	90956	1018	0	96006
25456	2062	621	88461	926	0	92070
25457	86177	478	2500	1246	0	90401
25458	3033	488	1210	90888	0	95619
25459	1698	518	90648	2548	0	95412
25460	1438	89819	2338	1546	0	95141
25461	1541	1943	1218	90759	0	95461
25462	90121	898	1009	2677	0	94705
25463	2752	92516	899	1377	0	97544
25464	1828	2118	737	91050	0	95733
25465	1413	89723	770	2523	0	94429
25466	1233	93050	826	1470	0	96579
25467	1402	2293	768	92905	0	97368
25468	1323	1091	829	92838	0	96081
25469	1167	93180	864	2864	0	98075
25470	92775	2137	786	1763	0	97461
25471	2905	1069	93149	1103	0	98226
25472	91434	831	2075	1292	0	95632
25473	3117	774	1010	95565	0	100466
25474	1780	676	851	96477	0	99784
25475	1543	621	773	97379	0	100316
25476	1597	523	749	97102	0	99971
25477	1296	561	96958	3104	0	101919
25478	1497	505	2330	96490	0	100822
25479	1400	681	1166	97810	0	101057
25480	1209	101765	861	3259	0	107094
25481	1133	2288	103486	1930	0	108837
25482	980	107074	2500	1614	0	112168
25483	1062	2719	109236	1293	0	114310
25484	984	110216	2681	1176	0	115057
25485	1525	2516	1465	100953	0	106459
25486	100833	896	740	2457	0	104926
25487	2341	101684	672	1160	0	105857
25488	1616	2124	600	102922	0	107262
25489	991	1031	104468	2401	0	108891
25490	771	107139	2337	1238	0	111485
25491	104804	2355	1172	1482	0	109813
25492	106346	1102	892	1312	0	109652
25493	2823	107149	805	741	0	111518
25494	1483	2387	104792	644	0	109306
25495	101692	1091	2237	907	0	105927
25496	2835	909	1042	107555	0	112341
25497	106603	707	782	2864	0	110956
25498	2666	107564	626	1356	0	112212
25499	1381	111272	567	1087	0	114307
25500	1158	2873	108795	753	0	113579
25501	106193	1396	2290	985	0	110864
25502	2922	1064	1061	108942	0	113989
25503	109573	608	770	2625	0	113576
25504	2479	110649	650	1187	0	114965
25505	110709	2158	555	1247	0	114669
25506	109581	1071	541	1205	0	112398
25507	2993	854	110609	689	0	115145
25508	1388	105614	1929	550	0	109481
25509	969	108874	917	602	0	111362
25510	930	2551	549	100295	0	104325
25511	581	100858	412	1551	0	103402
25512	100756	1930	311	1086	0	104083
25513	1738	101947	291	545	0	104521
25514	981	1994	248	99151	0	102374
25515	634	98799	278	1455	0	101166
25516	534	97456	264	663	0	98917
25517	544	101207	244	440	0	102435
25518	865	2129	308	99654	0	102956
25519	814	999	215	101050	0	103078
25520	686	766	214	100078	0	101744
25521	410	99065	274	1872	0	101621
25522	413	1802	97672	828	0	100715
25523	452	1068	96352	628	0	98500
25524	94492	821	1630	827	0	97770
25525	1810	678	687	98793	0	101968
25526	768	754	99845	1506	0	102873
25527	632	784	99371	726	0	101513
25528	441	103945	1788	659	0	106833
25529	710	1823	745	97314	0	100592
25530	566	966	455	101023	0	103010
25531	100201	786	349	2376	0	103712
25532	1659	651	340	100397	0	103047
25533	842	601	352	101060	0	102855
25534	562	645	103753	2147	0	107107
25535	794	609	1520	102682	0	105605
25536	693	573	741	107877	0	109884
25537	459	570	108531	2153	0	111713
25538	463	567	107323	1140	0	109493
25539	363	106982	2012	882	0	110239
25540	410	1727	107042	723	0	109902
25541	579	936	1841	104162	0	107518
25542	1795	1000	1228	84497	0	88520
25543	410	676	108117	2260	0	111463
25544	366	106877	1686	1312	0	110241
25545	102036	1679	890	1432	0	106037
25546	1435	105507	756	930	0	108628
25547	800	1917	674	106066	0	109457
25548	662	1053	679	107250	0	109644
25549	403	107222	760	2259	0	110644
25550	550	1925	709	106945	0	110129
25551	578	1039	733	107297	0	109647
25552	455	932	101806	2430	0	105623
25553	373	100844	1843	1552	0	104612
25554	531	1961	954	102350	0	105796
25555	497	1098	102430	2171	0	106196
25556	729	889	1869	100932	0	104419
25557	769	850	987	100938	0	103544
25558	696	766	796	103793	0	106051
25559	736	795	688	102752	0	104971
25560	749	785	564	101016	0	103114
25561	591	102128	587	2633	0	105939
25562	100022	1824	621	1956	0	104423
25563	1694	1041	99093	1286	0	103114
25564	86094	845	1852	1871	0	90662
25565	1797	770	103570	1063	0	107200
25566	763	107078	1979	1135	0	110955
25567	722	2087	106025	939	0	109773
25568	492	107626	2172	1075	0	111365
25569	940	2189	1062	100562	0	104753
25570	729	978	775	103964	0	106446
25571	569	105333	621	2457	0	108980
25572	486	110216	522	1641	0	112865
25573	108873	2413	540	1611	0	113437
25574	111745	1270	550	1495	0	115060
25575	111919	906	550	1343	0	114718
25576	114001	802	580	1227	0	116610
25577	2564	989	593	112162	0	116308
25578	1023	112870	556	1962	0	116411
25579	112037	1983	456	1549	0	116025
25580	1756	997	439	108521	0	111713
25581	105037	663	389	1961	0	108050
25582	101135	455	333	1432	0	103355
25583	1519	97627	325	774	0	100245
25584	599	94991	251	569	0	96410
25585	390	99507	262	467	0	100626
25586	535	1866	381	95304	0	98086
25587	318	98770	264	1014	0	100366
25588	98157	870	197	922	0	100146
25589	99723	393	140	881	0	101137
25590	99383	238	161	821	0	100603
25591	101185	272	147	788	0	102392
25592	102557	272	152	807	0	103788
25593	1438	306	104993	268	0	107005
25594	103874	199	1241	815	0	106129
25595	1561	226	106578	262	0	108627
25596	104447	212	1370	534	0	106563
25597	1703	260	401	106112	0	108476
25598	656	348	103506	1285	0	105795
25599	473	305	106732	474	0	107984
25600	296	116059	1511	353	0	118219
25601	116894	1489	653	796	0	119832
25602	120917	453	350	789	0	122509
25603	2257	133108	230	352	0	135947
25604	1427	2167	169	151722	0	155485
25605	161860	769	206	3575	0	166410
25606	3650	588	165811	1078	0	171127
25607	1459	165748	3501	656	0	171364
25608	161222	3552	1263	1198	0	167235
25609	3700	165960	716	475	0	170851
25610	2431	4029	425	156276	0	163161
25611	972	167443	488	3039	0	171942
25612	1501	4476	325	159043	0	165345
25613	766	163277	440	3585	0	168068
25614	565	170772	356	1562	0	173255
25615	163516	5081	241	1652	0	170490
25616	168777	2375	273	1391	0	172816
25617	4829	1569	166896	791	0	174085
25618	2353	1330	162690	631	0	167004
25619	1526	1144	167007	504	0	170181
25620	1712	1028	5282	165296	0	173318
25621	1053	1153	170723	3623	0	176552
25622	1695	1029	4582	165093	0	172399
25623	1492	1019	2068	165959	0	170538
25624	713	168668	1419	5147	0	175947
25625	167670	4172	986	3144	0	175972
25626	3805	171231	1029	1604	0	177669
25627	2395	4692	738	174159	0	181984
25628	1857	2299	792	176025	0	180973
25629	1833	1432	762	177403	0	181430
25630	1288	1130	174815	5787	0	183020
25631	1657	1021	4441	171805	0	178924
25632	1580	928	2244	174884	0	179636
25633	1498	940	1448	178284	0	182170
25634	826	1120	171253	6530	0	179729
25635	771	170091	4308	3508	0	178678
25636	166851	4404	1762	3276	0	176293
25637	162337	2269	1103	3209	0	168918
25638	4997	170573	956	2029	0	178555
25639	2964	4915	866	169197	0	177942
25640	2137	2593	790	175622	0	181142
25641	1548	1789	171240	6096	0	180673
25642	1291	170060	4332	3479	0	179162
25643	1637	4595	2172	172501	0	180905
25644	1125	2245	173389	5466	0	182225
25645	1517	1638	4664	170613	0	178432
25646	1565	1471	2287	171411	0	176734
25647	1045	1570	172298	6646	0	181559
25648	1571	1466	4775	169411	0	177223
25649	1892	1543	2386	168181	0	174002
25650	1552	1405	172998	6573	0	182528
25651	1751	1293	4814	172392	0	180250
25652	1669	1360	2618	167414	0	173061
25653	1125	1094	1802	178653	0	182674
25654	732	1131	173612	7650	0	183125
25655	1161	1017	5131	173334	0	180643
25656	169185	1065	2567	7583	0	180400
25657	170349	951	2015	5019	0	178334
25658	5059	171554	1854	3538	0	182005
25659	173340	4221	1541	3855	0	182957
25660	5088	2130	178822	2977	0	189017
25661	2998	1385	4833	180431	0	189647
25662	2149	1173	2433	182931	0	188686
25663	1749	1214	1811	188162	0	192936
25664	177377	982	1628	8288	0	188275
25665	4261	177551	1528	4783	0	188123
25666	2333	4178	1237	170904	0	178652
25667	1425	174934	1431	6033	0	183823
25668	170697	4606	1387	4547	0	181237
25669	4431	174401	1391	2970	0	183193
25670	170746	4856	1075	3349	0	180026
25671	4920	169400	1124	2652	0	178096
25672	2569	171666	1136	2522	0	177893
25673	2121	5542	1252	169420	0	178335
25674	1669	2817	1285	170752	0	176523
25675	1700	2044	1225	169837	0	174806
25676	1388	1831	1048	170119	0	174386
25677	1227	1895	163882	7422	0	174426
25678	1255	163796	4010	4511	0	173572
25679	1279	4731	1929	158361	0	166300
25680	974	164115	1546	5898	0	172533
25681	1235	5092	162724	3685	0	172736
25682	1719	2711	4309	159419	0	168158
25683	1552	2138	2142	168388	0	174220
25684	1291	1795	164459	6497	0	174042
25685	1044	160630	4585	4083	0	170342
25686	1150	4366	2396	161651	0	169563
25687	845	2173	159556	6524	0	169098
25688	607	158398	4709	4638	0	168352
25689	1103	4275	2350	157434	0	165162
25690	865	2370	155325	6085	0	164645
25691	920	2002	149852	3728	0	156502
25692	865	149014	5047	2965	0	157891
25693	828	160444	2420	2576	0	166268
25694	1228	5431	1999	162684	0	171342
25695	1451	2822	1597	172658	0	178528
25696	746	1963	171012	7111	0	180832
25697	160309	1668	4879	5103	0	171959
25698	165750	1620	2551	4025	0	173946
25699	5625	1747	165451	2867	0	175690
25700	2578	156779	4772	2543	0	166672
25701	1657	157727	2628	2273	0	164285
25702	1281	153396	1660	2011	0	158348
25703	1980	121944	2265	2074	0	128263
25704	3534	6144	1849	116384	0	127911
25705	768	1378	449	138237	0	140832
25706	633	915	191	138784	0	140523
25707	667	678	156	140732	0	142233
25708	174	140838	242	5966	0	147220
25709	689	3583	244	140285	0	144801
25710	197	141833	296	4845	0	147171
25711	748	4189	168	143680	0	148785
25712	140380	2079	213	5296	0	147968
25713	3843	1308	212	141699	0	147062
25714	1700	140559	297	5039	0	147595
25715	1550	4017	216	143947	0	149730
25716	1256	2075	173	147315	0	150819
25717	1051	1326	183	148680	0	151240
25718	140734	1019	230	8410	0	150393
25719	4216	1254	148	146504	0	152122
25720	1840	1221	141218	6766	0	151045
25721	1114	144056	3615	4310	0	153095
25722	1438	4770	1701	147620	0	155529
25723	1575	2491	947	152268	0	157281
25724	1392	1842	600	154744	0	158578
25725	146466	1435	493	9040	0	157434
25726	4670	1383	142919	5096	0	154068
25727	2950	1126	3952	137612	0	145640
25728	1516	141811	1868	6616	0	151811
25729	1723	4752	1031	144584	0	152090
25730	135192	2586	741	7973	0	146492
25731	4170	140422	883	4798	0	150273
25732	2759	5264	568	140962	0	149553
25733	1855	2824	466	143123	0	148268
25734	948	138865	591	8651	0	149055
25735	1513	5048	443	142780	0	149784
25736	1653	2859	532	145618	0	150662
25737	944	2035	138068	9021	0	150068
25738	835	137617	4387	5945	0	148784
25739	136356	5396	2135	4902	0	148789
25740	4856	3166	136312	3842	0	148176
25741	133335	2233	4632	4180	0	144380
25742	5739	2151	135599	3546	0	147035
25743	3498	1744	5186	136697	0	147125
25744	134022	1551	2571	8227	0	146371
25745	5766	1854	1589	138176	0	147385
25746	136038	1543	1230	9246	0	148057
25747	137974	1724	1029	6418	0	147145
25748	137345	1931	1224	5060	0	145560
25749	7647	135003	1161	3952	0	147763
25750	4850	5582	1071	134412	0	145915
25751	3496	3107	1409	138826	0	146838
25752	2971	2273	1275	139979	0	146498
25753	2400	1717	133150	9782	0	147049
25754	2336	1551	5357	137503	0	146747
25755	133575	1254	2865	9317	0	147011
25756	137285	1269	2020	6374	0	146948
25757	8061	1320	132341	4806	0	146528
25758	134707	1329	5245	3991	0	145272
25759	138356	1525	2873	3791	0	146545
25760	8939	1780	1965	127727	0	140411
25761	127664	1512	1421	8201	0	138798
25762	130078	1510	1277	6032	0	138897
25763	8687	1509	1247	127963	0	139406
25764	127575	1245	1511	8772	0	139103
25765	129434	1293	1491	6112	0	138330
25766	9219	1494	1504	126024	0	138241
25767	6079	1805	101275	8133	0	117292
25768	120687	1496	4646	5368	0	132197
25769	7951	1420	123504	4196	0	137071
25770	5701	1238	124575	3779	0	135293
25771	4216	121412	7204	4035	0	136867
25772	4455	4825	3750	120974	0	134004
25773	4333	2568	2323	125989	0	135213
25774	4303	1616	1765	125986	0	133670
25775	4208	1348	121396	9718	0	136670
25776	4318	1274	121853	6127	0	133572
25777	3717	120669	6926	4967	0	136279
25778	4061	4928	3950	119033	0	131972
25779	3995	2499	2865	124789	0	134148
25780	3539	1680	2586	127414	0	135219
25781	3288	1273	120827	9613	0	135001
25782	3146	118567	6010	6464	0	134187
25783	3158	4843	3585	121298	0	132884
25784	3292	2541	121280	8157	0	135270
25785	3154	1797	122604	5711	0	133266
25786	119328	1317	7895	4604	0	133144
25787	121953	1312	4806	3967	0	132038
25788	124618	1359	3210	3968	0	133155
25789	8994	1343	2680	117527	0	130544
25790	5503	1206	117544	7657	0	131910
25791	3823	113236	5857	5886	0	128802
25792	3184	119902	3781	5122	0	131989
25793	3027	5656	105932	3744	0	118359
25794	3247	4760	5897	94212	0	108116
25795	2666	2278	3809	87313	0	96066
25796	2593	84102	2904	5647	0	95246
25797	2725	88531	2282	3674	0	97212
25798	86348	4392	2174	2824	0	95738
25799	88952	2264	1830	2587	0	95633
25800	90381	1409	1711	2741	0	96242
25801	88770	1146	1789	2563	0	94268
25802	85224	1287	1563	2535	0	90609
25803	6492	79138	1729	2427	0	89786
25804	2722	62772	1272	1612	0	68378
25805	1278	50537	892	972	0	53679
25806	46476	1751	2469	954	0	51650
25807	2616	1106	1002	43166	0	47890
25808	967	318	404	42507	0	44196
25809	41706	234	422	1698	0	44060
25810	1412	41381	505	884	0	44182
25811	814	1092	444	41979	0	44329
25812	712	557	504	42584	0	44357
25813	676	420	522	42546	0	44164
25814	40730	307	421	1635	0	43093
25815	1421	248	444	41370	0	43483
25816	779	280	39420	1265	0	41744
25817	38135	341	937	770	0	40183
25818	1395	364	465	39029	0	41253
25819	763	274	39131	1036	0	41204
25820	692	38207	915	622	0	40436
25821	428	36604	350	362	0	37744
25822	34479	804	681	451	0	36415
25823	34274	248	326	359	0	35207
25824	692	35262	121	141	0	36216
25825	355	544	111	37274	0	38284
25826	38864	165	95	949	0	40073
25827	928	100	91	41323	0	42442
25828	472	96	82	43097	0	43747
25829	395	78	81	43643	0	44197
25830	324	73	101	43327	0	43825
25831	112	42396	120	1494	0	44122
25832	224	898	108	43325	0	44555
25833	296	312	95	43578	0	44281
25834	245	254	91	44073	0	44663
25835	150	182	42262	1551	0	44145
25836	99	42500	979	799	0	44377
25837	240	986	348	42869	0	44443
25838	114	386	42418	1219	0	44137
25839	147	297	40064	585	0	41093
25840	113	42046	1206	457	0	43822
25841	41625	1020	530	471	0	43646
25842	1045	384	340	42325	0	44094
25843	42227	272	200	1296	0	43995
25844	1091	42963	185	519	0	44758
25845	564	1035	136	43251	0	44986
25846	41260	401	128	1398	0	43187
25847	42619	315	108	673	0	43715
25848	1413	188	100	42332	0	44033
25849	739	169	115	42253	0	43276
25850	416	202	41835	1445	0	43898
25851	424	153	966	41535	0	43078
25852	354	164	411	43081	0	44010
25853	41315	146	302	1634	0	43397
25854	1055	41890	195	801	0	43941
25855	431	958	41128	605	0	43122
25856	39485	379	900	630	0	41394
25857	1086	41771	347	413	0	43617
25858	617	1012	250	41928	0	43807
25859	41588	403	162	1294	0	43447
25860	1186	304	136	41222	0	42848
25861	609	229	132	41721	0	42691
25862	379	189	40710	1527	0	42805
25863	363	150	923	41096	0	42532
25864	40634	125	373	1614	0	42746
25865	1115	120	282	41426	0	42943
25866	40381	120	188	1640	0	42329
25867	1178	39228	183	819	0	41408
25868	513	40852	196	640	0	42201
25869	491	1194	172	40678	0	42535
25870	431	544	141	41289	0	42405
25871	39230	409	125	1654	0	41418
25872	1039	39357	134	899	0	41429
25873	39641	1051	143	806	0	41641
25874	40295	470	119	697	0	41581
25875	1415	364	141	39765	0	41685
25876	39900	238	160	1444	0	41742
25877	1432	250	38086	687	0	40455
25878	794	196	957	38704	0	40651
25879	567	229	39234	1317	0	41347
25880	506	201	1147	39674	0	41528
25881	38755	197	470	1609	0	41031
25882	39545	227	340	902	0	41014
25883	1376	39157	268	734	0	41535
25884	824	1052	197	39111	0	41184
25885	671	450	173	39610	0	40904
25886	482	39268	156	1539	0	41445
25887	543	1121	137	40227	0	42028
25888	488	481	144	40559	0	41672
25889	400	39557	146	1699	0	41802
25890	38269	1140	164	1103	0	40676
25891	38960	474	170	911	0	40515
25892	1457	400	187	38729	0	40773
25893	787	306	164	39395	0	40652
25894	630	283	38321	1681	0	40915
25895	594	244	964	37661	0	39463
25896	475	37829	426	1497	0	40227
25897	38599	1073	306	948	0	40926
25898	1196	469	228	38884	0	40777
25899	631	407	176	38773	0	39987
25900	37081	336	175	1804	0	39396
25901	1217	37251	157	1027	0	39652
25902	713	1066	137	38532	0	40448
25903	631	511	139	38635	0	39916
25904	518	37929	154	1664	0	40265
25905	37907	1080	159	1078	0	40224
25906	1286	495	37157	803	0	39741
25907	637	437	37541	637	0	39252
25908	614	319	1272	37824	0	40029
25909	424	298	37773	1377	0	39872
25910	36573	284	1191	853	0	38901
25911	1349	217	530	37835	0	39931
25912	642	224	38403	1433	0	40702
25913	593	233	38032	814	0	39672
25914	456	38800	1243	691	0	41190
25915	38446	1009	587	636	0	40678
25916	1142	39337	406	555	0	41440
25917	39061	1112	303	619	0	41095
25918	39217	530	270	580	0	40597
25919	1312	38031	252	425	0	40020
25920	38025	1002	231	472	0	39730
25921	38008	454	206	442	0	39110
25922	1446	383	37021	342	0	39192
25923	934	1692	861	33979	0	37466
25924	527	33631	369	871	0	35398
25925	294	32632	223	353	0	33502
25926	621	1324	280	29621	0	31846
25927	27810	265	207	799	0	29081
25928	418	95	60	27542	0	28115
25929	241	80	38	28500	0	28859
25930	227	65	48	29296	0	29636
25931	153	31030	58	603	0	31844
25932	213	495	37	33217	0	33962
25933	115	232	35277	687	0	36311
25934	33548	165	679	388	0	34780
25935	36563	78	212	299	0	37152
25936	950	35850	152	125	0	37077
25937	36637	718	64	198	0	37617
25938	1035	266	42	37096	0	38439
25939	349	160	36801	763	0	38073
25940	35302	95	695	394	0	36486
25941	804	37258	257	208	0	38527
25942	390	714	145	37283	0	38532
25943	38242	246	92	912	0	39492
25944	787	38238	79	310	0	39414
25945	310	39374	62	201	0	39947
25946	38729	989	81	268	0	40067
25947	850	441	37456	106	0	38853
25948	37915	226	726	179	0	39046
25949	981	156	268	37849	0	39254
25950	519	105	154	38375	0	39153
25951	291	124	37604	981	0	39000
25952	230	152	37114	420	0	37916
25953	330	102	941	37824	0	39197
25954	184	137	37353	846	0	38520
25955	211	133	37517	360	0	38221
25956	352	117	1032	36967	0	38468
25957	281	99	434	37927	0	38741
25958	37840	90	293	1137	0	39360
25959	978	111	177	38010	0	39276
25960	37965	137	149	1082	0	39333
25961	975	38104	139	489	0	39707
25962	550	806	150	38892	0	40398
25963	322	338	40065	926	0	41651
25964	39569	227	816	540	0	41152
25965	41443	155	353	444	0	42395
25966	41931	133	238	344	0	42646
25967	41548	120	182	346	0	42196
25968	41512	95	181	316	0	42104
25969	1388	98	170	40394	0	42050
25970	599	118	39859	933	0	41509
25971	429	117	39124	467	0	40137
25972	328	100	40427	353	0	41208
25973	38823	88	1193	370	0	40474
25974	41340	101	520	338	0	42299
25975	1298	85	322	39582	0	41287
25976	582	41395	276	865	0	43118
25977	533	809	218	42282	0	43842
25978	348	318	42117	1084	0	43867
25979	334	237	41083	497	0	42151
25980	39649	158	1162	494	0	41463
25981	1096	130	43588	288	0	45102
25982	647	118	1094	43315	0	45174
25983	45203	100	489	1198	0	46990
25984	42500	138	354	758	0	43750
25985	46355	108	267	492	0	47222
25986	46998	117	266	382	0	47763
25987	1578	140	45320	264	0	47302
25988	44356	95	1058	359	0	45868
25989	1382	45560	509	256	0	47707
25990	795	948	351	46261	0	48355
25991	544	390	46464	1081	0	48479
25992	577	260	1112	45987	0	47936
25993	468	217	47247	1220	0	49152
25994	501	178	1220	46436	0	48335
25995	471	161	558	47623	0	48813
25996	436	151	46633	1440	0	48660
25997	523	128	1211	46387	0	48249
25998	47159	127	586	1484	0	49356
25999	1339	116	407	47599	0	49461
26000	703	151	385	48571	0	49810
26001	47519	121	350	1678	0	49668
26002	1283	47780	383	748	0	50194
26003	48391	981	334	686	0	50392
26004	1344	48491	335	431	0	50601
26005	49962	1089	317	530	0	51898
26006	1418	461	49566	412	0	51857
26007	816	266	1119	49506	0	51707
26008	609	196	541	50662	0	52008
26009	50105	142	425	1608	0	52280
26010	1230	49661	392	776	0	52059
26011	747	978	316	49300	0	51341
26012	612	361	341	49520	0	50834
26013	437	46898	325	2581	0	50241
26014	47739	942	290	892	0	49863
26015	1174	47950	291	623	0	50038
26016	655	990	284	47612	0	49541
26017	600	387	281	46742	0	48010
26018	423	46364	263	1333	0	48383
26019	45973	969	218	844	0	48004
26020	1189	456	45381	528	0	47554
26021	43793	276	1045	556	0	45670
26022	1249	45332	496	398	0	47475
26023	717	928	285	45980	0	47910
26024	46395	365	269	1212	0	48241
26025	1279	238	235	46454	0	48206
26026	747	213	203	47258	0	48421
26027	47077	186	216	1550	0	49029
26028	1183	45565	204	781	0	47733
26029	574	46771	231	500	0	48076
26030	45899	909	197	537	0	47542
26031	973	332	45152	307	0	46764
26032	421	43269	746	264	0	44700
26033	559	753	391	42117	0	43820
26034	234	242	48161	530	0	49167
26035	290	269	822	46308	0	47689
26036	47340	92	355	1063	0	48850
26037	866	48459	188	461	0	49974
26038	551	855	121	46023	0	47550
26039	216	48310	103	818	0	49447
26040	48548	948	71	533	0	50100
26041	49524	415	85	396	0	50420
26042	1231	49843	88	193	0	51355
26043	657	966	42	48766	0	50431
26044	299	50651	144	860	0	51954
26045	51432	1123	86	525	0	53166
26046	52497	492	96	373	0	53458
26047	1559	282	95	51427	0	53363
26048	851	195	79	52551	0	53676
26049	417	212	50927	1485	0	53041
26050	48034	189	1015	867	0	50105
26051	1245	194	51155	415	0	53009
26052	725	173	1166	50450	0	52514
26053	50534	149	486	1332	0	52501
26054	1215	52172	277	570	0	54234
26055	50220	1155	209	624	0	52208
26056	1272	603	47876	397	0	50148
26057	49190	323	907	441	0	50861
26058	1377	52219	395	262	0	54253
26059	52463	1153	217	429	0	54262
26060	1387	54148	198	309	0	56042
26061	851	1288	153	53367	0	55659
26062	461	632	52622	1222	0	54937
26063	427	458	50166	627	0	51678
26064	541	333	1410	50632	0	52916
26065	425	277	51883	1249	0	53834
26066	506	280	1283	51154	0	53223
26067	561	232	568	50945	0	52306
26068	334	271	52728	1644	0	54977
26069	45067	233	1277	1092	0	47669
26070	51916	216	555	660	0	53347
26071	1638	51469	370	407	0	53884
26072	51721	1105	345	467	0	53638
26073	1531	526	252	51482	0	53791
26074	722	331	52739	1252	0	55044
26075	647	272	1198	52302	0	54419
26076	518	264	628	53488	0	54898
26077	52014	199	368	1747	0	54328
26078	1183	50904	300	896	0	53283
26079	623	52091	232	566	0	53512
26080	534	1318	259	52146	0	54257
26081	485	591	235	50884	0	52195
26082	369	50426	202	1413	0	52410
26083	459	1137	192	50142	0	51930
26084	439	614	175	49848	0	51076
26085	304	49129	197	1563	0	51193
26086	48694	1052	202	976	0	50924
26087	1105	478	251	48841	0	50675
26088	539	48970	236	1294	0	51039
26089	490	1033	207	49525	0	51255
26090	48590	543	200	1481	0	50814
26091	1117	48720	175	811	0	50823
26092	49421	1136	160	707	0	51424
26093	49712	636	144	616	0	51108
26094	1690	423	131	49697	0	51941
26095	50928	390	120	1451	0	52889
26096	51919	339	120	906	0	53284
26097	51941	324	138	697	0	53100
26098	52346	306	164	568	0	53384
26099	1868	242	147	51260	0	53517
26100	992	292	163	52071	0	53518
26101	672	286	50756	1689	0	53403
26102	695	261	991	50729	0	52676
26103	661	316	449	51670	0	53096
26104	520	294	50403	1839	0	53056
26105	48699	240	1199	1166	0	51304
26106	1517	271	544	51002	0	53334
26107	819	270	51473	1575	0	54137
26108	49118	246	1285	1115	0	51764
26109	1707	256	55770	663	0	58396
26110	929	56568	1507	727	0	59731
26111	756	60350	723	565	0	62394
26112	704	1725	456	63910	0	66795
26113	537	782	71133	1809	0	74261
26114	70178	485	1830	1231	0	73724
26115	75189	320	797	952	0	77258
26116	2594	378	73896	563	0	77431
26117	73908	296	1969	759	0	76932
26118	76139	220	877	736	0	77972
26119	2714	75429	670	507	0	79320
26120	76167	1747	477	633	0	79024
26121	2622	719	473	75095	0	78909
26122	1170	519	75730	1995	0	79414
26123	1112	425	1843	71091	0	74471
26124	649	75931	890	1964	0	79434
26125	607	79505	590	999	0	81701
26126	78268	2205	509	875	0	81857
26127	78021	930	498	798	0	80247
26128	78285	607	534	654	0	80080
26129	2928	489	451	76456	0	80324
26130	1598	752	441	74377	0	77168
26131	1028	75113	482	2391	0	79014
26132	74837	1871	478	1426	0	78612
26133	2450	76395	592	1014	0	80451
26134	69317	1444	422	690	0	71873
26135	2099	69667	519	492	0	72777
26136	69510	1551	580	546	0	72187
26137	68231	734	353	596	0	69914
26138	2683	703	383	66815	0	70584
26139	1494	69553	433	1397	0	72877
26140	1428	1456	66765	769	0	70418
26141	63697	778	1316	939	0	66730
26142	1816	65137	624	633	0	68210
26143	1034	1524	66625	599	0	69782
26144	811	872	67015	513	0	69211
26145	1044	772	1378	64129	0	67323
26146	1068	566	466	62682	0	64782
26147	897	67270	265	1301	0	69733
26148	69252	1434	173	833	0	71692
26149	1931	714	144	67488	0	70277
26150	1122	69762	220	1339	0	72443
26151	962	74441	222	787	0	76412
26152	895	1613	72840	586	0	75934
26153	857	1038	72370	455	0	74720
26154	70161	824	1329	542	0	72856
26155	1829	743	73192	364	0	76128
26156	1270	702	1251	71415	0	74638
26157	1109	657	532	74003	0	76301
26158	864	723	74083	1550	0	77220
26159	1002	685	1294	72067	0	75048
26160	1151	550	706	68451	0	70858
26161	72094	573	595	1816	0	75078
26162	73697	651	678	929	0	75955
26163	1756	689	800	72446	0	75691
26164	908	71349	828	1472	0	74557
26165	696	75862	703	858	0	78119
26166	75667	1545	717	908	0	78837
26167	1644	917	75229	724	0	78514
26168	1104	657	1403	74979	0	78143
26169	76985	684	764	2006	0	80439
26170	78004	833	624	1122	0	80583
26171	2001	757	642	77566	0	80966
26172	1004	729	77864	1671	0	81268
26173	1041	764	72825	861	0	75491
26174	71678	636	1970	966	0	75250
26175	76080	566	1258	952	0	78856
26176	2072	76245	967	917	0	80201
26177	1283	79066	948	990	0	82287
26178	80986	1597	931	1249	0	84763
26179	82859	798	751	1421	0	85829
26180	2560	605	684	84314	0	88163
26181	1793	565	735	85893	0	88986
26182	1595	603	573	86909	0	89680
26183	85957	714	664	2351	0	89686
26184	2658	800	587	85907	0	89952
26185	1795	827	86118	1811	0	90551
26186	84903	730	1522	1306	0	88461
26187	2394	869	785	87067	0	91115
26188	1593	870	87932	1900	0	92295
26189	84364	809	1495	1433	0	88101
26190	81241	771	941	1477	0	84430
26191	2194	91263	845	1132	0	95434
26192	1564	94315	874	850	0	97603
26193	1534	1836	89003	914	0	93287
26194	90017	1016	1401	1233	0	93667
26195	2413	95069	830	861	0	99173
26196	1680	1917	90173	856	0	94626
26197	88950	1034	1379	1240	0	92603
26198	2449	99257	586	949	0	103241
26199	1477	1984	98500	1010	0	102971
26200	93485	1133	1450	1381	0	97449
26201	2459	99354	643	1016	0	103472
26202	1628	1672	455	98921	0	102676
26203	98855	796	600	2291	0	102542
26204	2087	98977	658	1353	0	103075
26205	1402	1635	663	98557	0	102257
26206	97739	550	674	2216	0	101179
26207	1863	473	97960	1099	0	101395
26208	918	95920	1628	829	0	99295
26209	1035	1349	94111	663	0	97158
26210	916	1028	1372	89912	0	93228
26211	620	484	90770	1165	0	93039
26212	476	84751	1090	606	0	86923
26213	259	79956	366	187	0	80768
26214	448	762	240	78476	0	79926
26215	321	196	99	74680	0	75296
26216	255	116	103	76182	0	76656
26217	131	155	79238	644	0	80168
26218	269	102	530	78728	0	79629
26219	78904	94	189	968	0	80155
26220	77107	88	123	636	0	77954
26221	754	121	80861	190	0	81926
26222	239	80486	590	191	0	81506
26223	80103	552	182	522	0	81359
26224	578	79924	179	196	0	80877
26225	79734	554	134	509	0	80931
26226	79511	217	115	506	0	80349
26227	762	203	79358	157	0	80480
26228	290	80877	599	179	0	81945
26229	353	545	177	81971	0	83046
26230	222	243	82046	563	0	83074
26231	76600	166	659	468	0	77893
26232	805	193	206	81213	0	82417
26233	319	167	80421	575	0	81482
26234	75471	102	625	610	0	76808
26235	773	178	82919	109	0	83979
26236	542	111	705	82178	0	83536
26237	83869	140	260	1171	0	85440
26238	802	87229	199	356	0	88586
26239	414	753	89530	163	0	90860
26240	86238	248	852	616	0	87954
26241	94666	149	346	590	0	95751
26242	1220	98185	260	229	0	99894
26243	744	989	174	98830	0	100737
26244	572	385	169	98418	0	99544
26245	97039	219	132	1754	0	99144
26246	1343	177	147	97566	0	99233
26247	559	219	98062	1245	0	100085
26248	564	127	1123	96117	0	97931
26249	96069	117	469	1774	0	98429
26250	1231	95417	313	668	0	97629
26251	720	1227	160	91893	0	94000
26252	314	93948	207	1278	0	95747
26253	95049	1338	176	866	0	97429
26254	1668	535	146	101469	0	103818
26255	861	325	137	103133	0	104456
26256	356	103853	222	2275	0	106706
26257	362	1865	101792	939	0	104958
26258	772	670	1787	99206	0	102435
26259	573	406	608	102758	0	104345
26260	589	293	367	102140	0	103389
26261	237	101464	330	2503	0	104534
26262	352	1859	101223	1039	0	104473
26263	349	828	101228	632	0	103037
26264	99452	429	2359	1027	0	103267
26265	103261	360	879	940	0	105440
26266	2511	305	104345	392	0	107553
26267	100049	201	2055	950	0	103255
26268	2340	267	106043	460	0	109110
26269	100244	244	2201	971	0	103660
26270	2177	105573	985	546	0	109281
26271	106249	1936	646	917	0	109748
26272	2449	749	108171	439	0	111808
26273	1095	502	109804	463	0	111864
26274	1155	339	2721	115574	0	119789
26275	119586	328	1153	3387	0	124454
26276	3090	127917	893	1145	0	133045
26277	1308	3270	141822	618	0	147018
26278	1701	980	4270	140011	0	146962
26279	1278	592	1395	147789	0	151054
26280	143456	392	876	5769	0	150493
26281	146173	321	646	2238	0	149378
26282	6025	348	527	143758	0	150658
26283	144917	412	466	5255	0	151050
26284	5316	489	141837	1663	0	149305
26285	2640	359	4375	139185	0	146559
26286	1758	269	1566	145864	0	149457
26287	142659	317	936	6282	0	150194
26288	143980	371	657	2705	0	147713
26289	6320	401	555	141707	0	148983
26290	141472	395	621	5525	0	148013
26291	5376	430	136018	2112	0	143936
26292	2055	134358	4462	1656	0	142531
26293	1414	4162	135879	1261	0	142716
26294	1871	1687	4770	135286	0	143614
26295	132837	683	1744	5400	0	140664
26296	4828	132503	1123	2077	0	140531
26297	2611	4265	846	129538	0	137260
26298	1981	1433	829	127273	0	131516
26299	1132	128751	834	5551	0	136268
26300	1541	4582	774	130422	0	137319
26301	1747	1591	792	132151	0	136281
26302	1764	875	727	134184	0	137550
26303	1666	656	706	133579	0	136607
26304	1810	501	761	131312	0	134384
26305	1178	126640	920	6678	0	135416
26306	1635	4330	870	129070	0	135905
26307	1697	1477	874	131385	0	135433
26308	1377	987	124978	6731	0	134073
26309	1290	124091	4566	3295	0	133242
26310	1721	4634	1680	125569	0	133604
26311	1720	1622	1097	127638	0	132077
26312	1688	1015	960	126683	0	130346
26313	1327	122727	917	7142	0	132113
26314	1406	4467	123113	3532	0	132518
26315	1792	1631	4685	126001	0	134109
26316	1322	1204	125154	6247	0	133927
26317	1225	908	124318	3278	0	129729
26318	1533	815	5723	123599	0	131670
26319	123605	868	2256	6733	0	133462
26320	5249	915	1409	124820	0	132393
26321	2556	827	1189	123247	0	127819
26322	1578	123283	1205	6839	0	132905
26323	1722	4505	989	127374	0	134590
26324	1576	1668	1047	130614	0	134905
26325	1173	1230	126866	7488	0	136757
26326	1132	126145	4774	4024	0	136075
26327	1332	4658	1937	129287	0	137214
26328	124259	1844	1463	6871	0	134437
26329	4742	1466	124837	3600	0	134645
26330	2316	1021	4895	125995	0	134227
26331	1676	943	2102	130057	0	134778
26332	123788	1011	1441	7801	0	134041
26333	4863	124023	1148	4241	0	134275
26334	121287	4618	929	3942	0	130776
26335	4829	121673	993	3339	0	130834
26336	2261	4993	970	122087	0	130311
26337	118299	1980	989	6995	0	128263
26338	4806	1392	117228	3937	0	127363
26339	2143	113047	4655	3294	0	123139
26340	1553	116604	2080	2971	0	123208
26341	107716	4975	1589	2895	0	117175
26342	4564	2052	1277	104260	0	112153
26343	1962	102800	1231	5858	0	111851
26344	1557	108755	1005	3616	0	114933
26345	1671	4892	859	107718	0	115140
26346	1664	2183	808	110839	0	115494
26347	104837	1513	937	6980	0	114267
26348	4491	104755	1039	3798	0	114083
26349	2084	4573	1354	105562	0	113573
26350	1476	1911	104053	5749	0	113189
26351	1371	104263	4273	3381	0	113288
26352	1346	4229	102967	2794	0	111336
26353	1285	102286	4401	2715	0	110687
26354	1731	4232	2122	95658	0	103743
26355	1394	1626	825	95219	0	99064
26356	1057	94271	797	5146	0	101271
26357	1039	3819	94034	2827	0	101719
26358	93267	1792	3326	2582	0	100967
26359	3584	1467	1377	97671	0	104099
26360	1595	1274	1019	100681	0	104569
26361	1106	1313	97226	5306	0	104951
26362	1065	1480	3491	98309	0	104345
26363	797	1423	97824	5148	0	105192
26364	984	1445	3644	98264	0	104337
26365	785	1277	100102	4944	0	107108
26366	610	100037	3633	3101	0	107381
26367	670	4081	102488	2537	0	109776
26368	962	1887	3611	102645	0	109105
26369	100631	1353	1284	5517	0	108785
26370	3540	100214	965	2849	0	107568
26371	1701	4191	906	100075	0	106873
26372	1050	1795	97949	4696	0	105490
26373	658	99454	3805	2557	0	106474
26374	1069	3667	1380	89108	0	95224
26375	582	1445	89501	3225	0	94753
26376	341	78710	2349	1369	0	82769
26377	60937	1835	1304	1105	0	65181
26378	57934	409	505	448	0	59296
26379	1083	187	145	57967	0	59382
26380	58242	145	137	1081	0	59605
26381	964	113	151	57803	0	59031
26382	451	113	116	59132	0	59812
26383	233	160	62483	1077	0	63953
26384	346	152	809	61056	0	62363
26385	226	144	283	63059	0	63712
26386	61789	122	190	1407	0	63508
26387	60544	118	143	781	0	61586
26388	943	61992	138	330	0	63403
26389	393	829	62479	210	0	63911
26390	339	333	823	61902	0	63397
26391	202	233	62000	880	0	63315
26392	56095	145	837	702	0	57779
26393	895	129	60722	284	0	62030
26394	506	138	745	58765	0	60154
26395	186	60324	324	782	0	61616
26396	308	692	202	60308	0	61510
26397	266	272	203	60035	0	60776
26398	145	196	62567	1047	0	63955
26399	330	111	758	61955	0	63154
26400	61773	102	310	1288	0	63473
26401	61720	124	202	698	0	62744
26402	61480	130	180	560	0	62350
26403	62238	118	172	562	0	63090
26404	981	61086	209	312	0	62588
26405	403	61688	232	334	0	62657
26406	702	849	203	56270	0	58024
26407	378	288	202	60830	0	61698
26408	202	58635	209	1042	0	60088
26409	246	721	146	62239	0	63352
26410	284	336	134	62273	0	63027
26411	311	208	157	61934	0	62610
26412	311	181	194	61739	0	62425
26413	262	153	188	62783	0	63386
26414	61044	147	171	1512	0	62874
26415	874	60333	204	581	0	61992
26416	453	795	59618	421	0	61287
26417	473	326	799	59093	0	60691
26418	305	261	327	60438	0	61331
26419	254	241	245	59784	0	60524
26420	59354	222	186	1563	0	61325
26421	849	65996	217	759	0	67821
26422	517	1217	193	65584	0	67511
26423	308	68072	214	1659	0	70253
26424	496	1773	156	66505	0	68930
26425	294	66806	216	1957	0	69273
26426	333	1894	70825	876	0	73928
26427	579	695	1958	74682	0	77914
26428	314	503	89104	2495	0	92416
26429	659	340	2925	88174	0	92098
26430	624	322	1049	96981	0	98976
26431	95242	298	626	4433	0	100599
26432	96061	314	411	2143	0	98929
26433	98577	301	353	1486	0	100717
26434	98320	291	319	1202	0	100132
26435	98873	314	401	1014	0	100602
26436	4635	305	377	93052	0	98369
26437	1724	95123	481	3443	0	100771
26438	1476	3061	400	94276	0	99213
26439	854	1142	92018	4043	0	98057
26440	90446	702	3016	1979	0	96143
26441	96490	383	1047	1355	0	99275
26442	4844	267	663	93608	0	99382
26443	2449	311	376	93196	0	96332
26444	1513	90519	323	4279	0	96634
26445	1434	2918	288	93322	0	97962
26446	1220	1147	313	93169	0	95849
26447	917	91303	348	4437	0	97005
26448	1198	3070	408	94107	0	98783
26449	86846	1063	418	4884	0	93211
26450	3535	871	89742	1906	0	96054
26451	87214	617	3055	2061	0	92947
26452	3796	569	90008	1508	0	95881
26453	1803	593	3495	88222	0	94113
26454	1433	582	1182	87299	0	90496
26455	867	85584	791	4639	0	91881
26456	814	90415	567	2336	0	94132
26457	1381	3952	491	84760	0	90584
26458	925	1492	86302	4000	0	92719
26459	82569	816	3333	2011	0	88729
26460	3789	491	1272	84055	0	89607
26461	1512	84016	1026	3959	0	90513
26462	1576	3158	572	85242	0	90548
26463	1318	1306	384	84800	0	87808
26464	1020	82468	440	4467	0	88395
26465	1449	3321	426	79559	0	84755
26466	988	1158	75045	3811	0	81002
26467	849	795	74135	1702	0	77481
26468	1037	678	3082	68056	0	72853
26469	573	71803	1156	3064	0	76596
26470	629	2853	676	72675	0	76833
26471	71622	1188	422	3802	0	77034
26472	73240	812	422	2015	0	76489
26473	69470	606	430	1744	0	72250
26474	3472	68681	480	1214	0	73847
26475	1331	2682	68308	1240	0	73561
26476	67031	1161	2796	1314	0	72302
26477	69736	960	1084	1412	0	73192
26478	3327	68045	724	1292	0	73388
26479	1707	2874	481	68343	0	73405
26480	68502	1186	478	3440	0	73606
26481	69823	869	569	1720	0	72981
26482	70799	618	616	1327	0	73360
26483	4373	608	714	64501	0	70196
26484	66004	588	676	3396	0	70664
26485	3956	574	668	65361	0	70559
26486	2289	597	481	67501	0	70868
26487	65563	743	407	4314	0	71027
26488	3801	772	499	65452	0	70524
26489	64833	682	505	4134	0	70154
26490	4380	546	530	64585	0	70041
26491	2532	597	488	67042	0	70659
26492	64185	679	399	4984	0	70247
26493	4063	619	62224	2840	0	69746
26494	2494	669	2704	64742	0	70609
26495	2215	564	1101	65923	0	69803
26496	2027	559	809	65268	0	68663
26497	1837	624	608	66595	0	69664
26498	1804	547	572	63250	0	66173
26499	1646	60284	646	5091	0	67667
26500	1701	2770	647	62575	0	67693
26501	1770	1252	60326	4557	0	67905
26502	1947	939	2845	62377	0	68108
26503	1737	661	1172	64016	0	67586
26504	1718	732	731	65510	0	68691
26505	1376	789	60797	5506	0	68468
26506	1199	908	61516	3217	0	66840
26507	60178	856	3572	2651	0	67257
26508	61757	801	1716	2367	0	66641
26509	4046	62928	1110	2115	0	70199
26510	2283	3015	774	65120	0	71192
26511	1687	1405	708	68774	0	72574
26512	1357	1055	776	69961	0	73149
26513	66107	795	776	5545	0	73223
26514	68785	697	919	3185	0	73586
26515	4211	694	941	67853	0	73699
26516	2253	849	751	69112	0	72965
26517	1857	842	615	69792	0	73106
26518	1424	905	692	69928	0	72949
26519	65503	809	772	5692	0	72776
26520	3419	632	63638	3348	0	71037
26521	1534	52737	2382	2443	0	59096
26522	1176	53424	893	1988	0	57481
26523	50794	2042	589	1731	0	55156
26524	2382	1855	618	50228	0	55083
26525	1015	715	49497	3011	0	54238
26526	711	600	44404	1702	0	47417
26527	522	44336	1597	1516	0	47971
26528	30696	551	728	571	0	32546
26529	630	191	30254	391	0	31466
26530	23775	192	373	233	0	24573
26531	267	30	110	24881	0	25288
26532	152	40	50	25161	0	25403
26533	60	24827	53	308	0	25248
26534	91	25438	37	155	0	25721
26535	25675	205	45	207	0	26132
26536	25760	67	46	153	0	26026
26537	226	26320	38	134	0	26718
26538	135	170	25985	105	0	26395
26539	102	111	26363	102	0	26678
26540	109	91	216	26923	0	27339
26541	27964	35	128	276	0	28403
26542	199	27828	73	165	0	28265
26543	154	170	33	29296	0	29653
26544	29438	100	52	326	0	29916
26545	256	56	59	30067	0	30438
26546	172	34	44	30917	0	31167
26547	30908	32	30	440	0	31410
26548	255	31080	57	208	0	31600
26549	144	32944	42	127	0	33257
26550	112	328	34311	92	0	34843
26551	149	141	226	34679	0	35195
26552	133	69	128	34521	0	34851
26553	76	62	35893	369	0	36400
26554	31070	49	253	401	0	31773
26555	33181	49	139	283	0	33652
26556	347	65	36136	93	0	36641
26557	30202	62	271	351	0	30886
26558	315	67	37290	94	0	37766
26559	174	39329	293	100	0	39896
26560	176	251	143	41471	0	42041
26561	152	138	81	42891	0	43262
26562	42836	73	65	544	0	43518
26563	42077	61	59	377	0	42574
26564	42209	47	61	275	0	42592
26565	42573	52	66	219	0	42910
26566	42066	45	54	265	0	42430
26567	413	75	41687	113	0	42288
26568	217	42102	248	121	0	42688
26569	174	235	154	42691	0	43254
26570	114	42630	93	245	0	43082
26571	102	43235	69	164	0	43570
26572	147	314	82	43026	0	43569
26573	129	154	56	43407	0	43746
26574	95	110	42851	352	0	43408
26575	39009	45	262	401	0	39717
26576	42650	48	135	267	0	43100
26577	336	42322	102	114	0	42874
26578	42959	207	58	210	0	43434
26579	44612	127	53	279	0	45071
26580	366	74	56	44840	0	45336
26581	217	76	46838	226	0	47357
26582	136	91	45888	160	0	46275
26583	46287	33	241	231	0	46792
26584	47327	31	119	218	0	47695
26585	322	46927	86	66	0	47401
26586	201	48857	49	79	0	49186
26587	155	299	38	50849	0	51341
26588	50671	157	43	445	0	51316
26589	281	137	51261	136	0	51815
26590	244	65	269	52244	0	52822
26591	53973	50	139	540	0	54702
26592	54115	40	85	392	0	54632
26593	470	40	43	56342	0	56895
26594	56464	31	54	588	0	57137
26595	408	78	54475	173	0	55134
26596	270	92	57548	117	0	58027
26597	390	43	404	56917	0	57754
26598	163	39	222	60787	0	61211
26599	178	42	117	60383	0	60720
26600	111	59264	99	476	0	59950
26601	128	60824	80	254	0	61286
26602	140	398	55	61607	0	62200
26603	61567	203	63	682	0	62515
26604	402	103	68	62558	0	63131
26605	285	59	83	62447	0	62874
26606	133	61888	103	502	0	62626
26607	120	63591	77	332	0	64120
26608	145	420	57	64224	0	64846
26609	148	248	71	61832	0	62299
26610	60914	145	28	740	0	61827
26611	341	60106	52	356	0	60855
26612	60497	320	46	465	0	61328
26613	482	169	40	61033	0	61724
26614	250	154	59982	399	0	60785
26615	194	157	57984	258	0	58593
26616	59672	93	486	425	0	60676
26617	422	80	206	63082	0	63790
26618	291	76	103	62908	0	63378
26619	216	85	56	63804	0	64161
26620	133	117	64074	558	0	64882
26621	226	64	327	64172	0	64789
26622	102	64268	224	589	0	65183
26623	176	425	136	66829	0	67566
26624	201	210	91	66463	0	66965
26625	142	67686	83	688	0	68599
26626	207	516	49	69922	0	70694
26627	67726	208	61	1108	0	69103
26628	669	68317	122	375	0	69483
26629	71081	767	68	585	0	72501
26630	71746	295	82	453	0	72576
26631	1334	175	57	71337	0	72903
26632	706	127	49	70443	0	71325
26633	432	109	57	72820	0	73418
26634	234	131	70322	1428	0	72115
26635	189	68237	934	663	0	70023
26636	172	71138	340	375	0	72025
26637	297	1150	149	70053	0	71649
26638	68982	405	108	1326	0	70821
26639	1171	222	70	68446	0	69909
26640	419	286	69006	1228	0	70939
26641	204	67185	929	600	0	68918
26642	205	69437	341	378	0	70361
26643	67818	1135	174	606	0	69733
26644	68838	429	178	589	0	70034
26645	1152	72792	152	281	0	74377
26646	73248	1010	90	692	0	75040
26647	1275	408	71775	222	0	73680
26648	506	345	69964	219	0	71034
26649	70944	275	1361	459	0	73039
26650	73080	198	427	497	0	74202
26651	1746	164	242	72441	0	74593
26652	72098	166	151	1721	0	74136
26653	1574	217	71442	428	0	73661
26654	640	253	74583	303	0	75779
26655	973	243	1678	81955	0	84849
26656	627	159	595	94426	0	95807
26657	676	109	331	98199	0	99315
26658	928	212	291	97024	0	98455
26659	818	134	151	106794	0	107897
26660	362	179	103367	3952	0	107860
26661	733	126	2621	102818	0	106298
26662	102720	137	922	4070	0	107849
26663	3126	105	588	104331	0	108150
26664	103164	82	421	4336	0	108003
26665	3501	115	317	104288	0	108221
26666	105154	143	428	4468	0	110193
26667	109463	157	389	2545	0	112554
26668	4219	169	408	107910	0	112706
26669	2103	205	454	110746	0	113508
26670	108225	151	333	4861	0	113570
26671	109091	152	273	2805	0	112321
26672	4384	232	107972	1910	0	114498
26673	2750	194	2672	108248	0	113864
26674	2088	183	905	112966	0	116142
26675	110426	205	620	4808	0	116059
26676	112829	194	419	2585	0	116027
26677	4821	191	377	111598	0	116987
26678	2677	176	464	113607	0	116924
26679	2283	140	430	113063	0	115916
26680	1890	150	483	111318	0	113841
26681	1299	103372	679	5146	0	110496
26682	1121	107265	501	3090	0	111977
26683	1440	3089	354	106097	0	110980
26684	1227	106144	423	4253	0	112047
26685	1452	3065	373	108372	0	113262
26686	876	1159	105535	4928	0	112498
26687	782	972	102339	2999	0	107092
26688	686	105694	3300	2623	0	112303
26689	1118	3212	1245	105320	0	110895
26690	777	1492	104854	4266	0	111389
26691	1055	1113	3095	102831	0	108094
26692	1008	880	1320	107330	0	110538
26693	102403	763	1108	5400	0	109674
26694	3621	747	991	105425	0	110784
26695	1621	694	106059	4789	0	113163
26696	1399	656	105387	2693	0	110135
26697	1258	102392	3751	2539	0	109940
26698	1231	111915	1756	2355	0	117257
26699	112617	3176	1355	2579	0	119727
26700	3704	1215	120729	2269	0	127917
26701	2176	806	3472	121293	0	127747
26702	122253	586	1545	4877	0	129261
26703	122404	534	1349	2925	0	127212
26704	4201	123614	1301	2289	0	131405
26705	2759	3026	1060	121368	0	128213
26706	2099	1273	946	129050	0	133368
26707	1984	983	760	128613	0	132340
26708	125331	705	793	5747	0	132576
26709	3970	697	123194	3226	0	131087
26710	1973	126602	3149	2804	0	134528
26711	2150	3182	1164	126676	0	133172
26712	1779	1450	893	131420	0	135542
26713	1369	1269	128167	5398	0	136203
26714	1553	955	3169	127392	0	133069
26715	1350	837	1378	132376	0	135941
26716	1466	861	1059	132550	0	135936
26717	1429	777	1089	132224	0	135519
26718	950	893	127710	6333	0	135886
26719	1173	865	3513	128167	0	133718
26720	835	753	129927	6210	0	137725
26721	827	128306	3858	4082	0	137073
26722	1110	2793	1907	131027	0	136837
26723	1171	1186	1554	134349	0	138260
26724	1032	907	129416	6178	0	137533
26725	1029	126819	3264	4377	0	135489
26726	1378	2928	1789	127448	0	133543
26727	1226	1233	127445	4769	0	134673
26728	1121	125168	3212	3477	0	132978
26729	1252	2700	1574	126395	0	131921
26730	1244	1303	126180	4241	0	132968
26731	1583	1067	2843	124993	0	130486
26732	1508	811	1678	123898	0	127895
26733	1228	845	1542	129955	0	133570
26734	126299	1004	1044	5190	0	133537
26735	2891	125779	1067	3351	0	133088
26736	126372	2571	1104	3030	0	133077
26737	3154	1299	126279	2769	0	133501
26738	127946	1009	2705	3477	0	135137
26739	137512	809	1368	3236	0	142925
26740	3669	768	1094	138154	0	143685
26741	139960	906	976	4901	0	146743
26742	141269	926	848	3469	0	146512
26743	144630	890	823	3293	0	149636
26744	4018	962	780	143856	0	149616
26745	2428	849	803	141480	0	145560
26746	1604	767	135499	4293	0	142163
26747	1584	731	128228	2863	0	133406
26748	130642	624	2760	2686	0	136712
26749	2903	1056	1542	134788	0	140289
26750	1522	136548	1431	3298	0	142799
26751	136863	1884	1341	2775	0	142863
26752	2475	135503	1123	2234	0	141335
26753	1385	136365	1065	2314	0	141129
26754	1620	2445	129931	2165	0	136161
26755	887	917	131806	1249	0	134859
26756	1314	2332	2012	128205	0	133863
26757	672	408	136605	1451	0	139136
26758	388	334	124320	582	0	125624
26759	116554	103	449	909	0	118015
26760	125764	50	150	775	0	126739
26761	449	67	98	128120	0	128734
26762	359	59	94	129514	0	130026
26763	144	165	132204	303	0	132816
26764	94	132900	317	234	0	133545
26765	317	278	116	132225	0	132936
26766	137674	96	94	1136	0	139000
26767	457	65	86	139174	0	139782
26768	140	140425	140	417	0	141122
26769	199	430	139274	179	0	140082
26770	79	142257	392	201	0	142929
26771	142614	357	147	888	0	144006
26772	140081	134	120	781	0	141116
26773	710	89	67	139848	0	140714
26774	228	185	142378	401	0	143192
26775	287	244	131553	250	0	132334
26776	102	141439	705	235	0	142481
26777	707	523	289	134840	0	136359
26778	256	182	170	143897	0	144505
26779	141	247	142671	681	0	143740
26780	480	80	507	138604	0	139671
26781	81	147436	293	654	0	148464
26782	316	797	154	149535	0	150802
26783	387	286	108	149226	0	150007
26784	113	289	149714	1098	0	151214
26785	602	107	934	142767	0	144410
26786	145649	70	362	1859	0	147940
26787	1087	180	147351	381	0	148999
26788	485	199	143056	240	0	143980
26789	172	148766	1460	202	0	150600
26790	466	1142	532	152436	0	154576
26791	410	350	223	159780	0	160763
26792	130	284	158307	1743	0	160464
26793	146765	123	1583	1433	0	149904
26794	1794	92	620	157999	0	160505
26795	621	292	156766	1526	0	159205
26796	883	109	1557	148257	0	150806
26797	211	192	156050	1772	0	158225
26798	241	178	149566	739	0	150724
26799	132	150296	2145	489	0	153062
26800	574	1441	841	141668	0	144524
26801	129	146623	541	1412	0	148705
26802	140930	1629	309	1557	0	144425
26803	1499	752	144059	408	0	146718
26804	543	142088	1669	376	0	144676
26805	643	1481	693	142768	0	145585
26806	140972	589	456	2535	0	144552
26807	1405	141939	410	846	0	144600
26808	953	1561	251	142983	0	145748
26809	647	653	294	143488	0	145082
26810	173	145353	405	2139	0	148070
26811	145134	1773	307	1777	0	148991
26812	2151	739	335	165051	0	168276
26813	1217	470	241	173617	0	175545
26814	451	459	170581	4237	0	175728
26815	222	178267	3405	1899	0	183793
26816	921	3616	1345	179876	0	185758
26817	973	1399	738	197589	0	200699
26818	229	202183	645	5219	0	208276
26819	1097	4779	329	202701	0	208906
26820	1355	1760	379	210447	0	213941
26821	1134	964	273	212236	0	214607
26822	195	212189	450	7082	0	219916
26823	208116	5128	351	4057	0	217652
26824	5236	2157	210625	1495	0	219513
26825	199740	982	5146	2466	0	208334
26826	5594	210389	2004	1225	0	219212
26827	2708	5283	1014	209450	0	218455
26828	1092	2266	211081	5632	0	220071
26829	1772	1265	5347	207850	0	216234
26830	1464	854	2102	209606	0	214026
26831	1556	636	1144	216112	0	219448
26832	561	971	211525	7824	0	220881
26833	433	208756	5550	3970	0	218709
26834	564	5305	212745	2191	0	220805
26835	412	213436	6158	1947	0	221953
26836	529	6138	216548	1594	0	224809
26837	1485	2365	6297	211796	0	221943
26838	205427	1508	2646	7611	0	217192
26839	4936	211555	1602	3188	0	221281
26840	1821	5914	211774	2260	0	221769
26841	953	211426	5783	2023	0	220185
26842	819	6544	213028	1756	0	222147
26843	1779	2637	6470	200953	0	211839
26844	1691	1783	2664	199880	0	206018
26845	617	205160	1951	7252	0	214980
26846	691	215835	1631	3568	0	221725
26847	211375	7775	1334	3299	0	223783
26848	6416	3407	1487	213821	0	225131
26849	2360	2374	214817	7206	0	226757
26850	2440	1651	6247	211932	0	222270
26851	1029	1753	216613	7933	0	227328
26852	1019	1790	216240	3968	0	223017
26853	1907	1543	7931	203552	0	214933
26854	896	211394	3758	6745	0	222793
26855	201217	6511	2502	4412	0	214642
26856	6467	3021	1879	199300	0	210667
26857	3068	2234	1894	194955	0	202151
26858	1385	199488	1883	8349	0	211105
26859	195167	6835	1591	4860	0	208453
26860	198768	3287	1699	3545	0	207299
26861	8227	2146	1644	191642	0	203659
26862	3202	190984	1815	7527	0	203528
26863	1707	206368	1992	4117	0	214184
26864	199386	8181	1879	3722	0	213168
26865	6264	4010	200437	2533	0	213244
26866	191930	2733	6888	2833	0	204384
26867	196941	2149	3194	3093	0	205377
26868	196261	2087	2118	3058	0	203524
26869	8141	193956	1653	2618	0	206368
26870	4172	6775	1649	196281	0	208877
26871	195989	3383	1700	7749	0	208821
26872	197277	2412	1746	4388	0	205823
26873	7732	196229	1931	3030	0	208922
26874	199190	6549	1569	3011	0	210319
26875	7252	3520	1593	199893	0	212258
26876	3704	2423	1554	200341	0	208022
26877	2181	198625	1626	8382	0	210814
26878	2510	6636	1461	201832	0	212439
26879	2484	3340	1427	203810	0	211061
26880	2021	200855	1584	8944	0	213404
26881	2194	6252	1414	190303	0	200163
26882	1567	198728	1503	7674	0	209472
26883	196985	7022	1587	4524	0	210118
26884	191930	3572	1606	3928	0	201036
26885	7105	194802	1398	3208	0	206513
26886	3606	6502	191950	2742	0	204800
26887	2910	3851	5288	190995	0	203044
26888	2203	2895	191686	6583	0	203367
26889	2086	183861	6062	4234	0	196243
26890	2054	190814	2714	3226	0	198808
26891	178934	6543	1785	2775	0	190037
26892	5676	186096	1555	2057	0	195384
26893	3619	6023	1475	177936	0	189053
26894	2321	181896	1728	5216	0	191161
26895	2360	188405	1208	2925	0	194898
26896	183707	7105	1133	2886	0	194831
26897	6392	3360	1215	182710	0	193677
26898	3209	2689	181835	5728	0	193461
26899	2324	2285	179237	3642	0	187488
26900	1971	183371	5905	2735	0	193982
26901	180361	6072	2649	2964	0	192046
26902	5494	185151	2043	1913	0	194601
26903	3295	6762	1306	189319	0	200682
26904	189534	3467	1444	6465	0	200910
26905	6479	2707	1191	192135	0	202512
26906	3522	2436	1193	193169	0	200320
26907	2560	192225	1024	7616	0	203425
26908	2896	6302	916	195074	0	205188
26909	1689	3694	194409	6673	0	206465
26910	188140	2337	5321	4426	0	200224
26911	5663	197660	2407	2970	0	208700
26912	2060	191330	1294	1756	0	196440
26913	180281	4925	730	1955	0	187891
26914	4646	2402	181813	1185	0	190046
26915	166623	1924	4173	1976	0	174696
26916	4226	189689	1569	1197	0	196681
26917	1201	202124	819	718	0	204862
26918	857	5503	200439	490	0	207289
26919	639	202901	4845	641	0	209026
26920	2085	5184	1894	180713	0	189876
26921	1429	1912	722	186978	0	191041
26922	334	192504	445	4785	0	198068
26923	1212	4407	309	193345	0	199273
26924	192794	1953	281	5417	0	200445
26925	4205	1343	191402	1795	0	198745
26926	188172	960	4117	1938	0	195187
26927	195766	863	1628	1687	0	199944
26928	195389	845	922	1610	0	198766
26929	6323	1062	191376	623	0	199384
26930	3657	827	4298	189178	0	197960
26931	1520	1062	193461	4439	0	200482
26932	183694	782	5089	2875	0	192440
26933	185504	774	2000	2434	0	190712
26934	5824	189097	1228	1074	0	197223
26935	3708	4444	760	185123	0	194035
26936	1729	192975	829	4415	0	199948
26937	1318	5122	193260	1996	0	201696
26938	2544	2141	4743	189977	0	199405
26939	189028	1232	2142	5918	0	198320
26940	192634	800	1151	2875	0	197460
26941	7252	912	908	181404	0	190476
26942	3048	184399	902	4669	0	193018
26943	1801	4855	186714	2017	0	195387
26944	1321	2298	188791	1381	0	193791
26945	175887	1275	6471	1853	0	185486
26946	5424	1175	187010	843	0	194452
26947	2556	183717	5709	1228	0	193210
26948	2454	5100	2327	180497	0	190378
26949	1238	2363	185287	4765	0	193653
26950	2159	1473	5345	178039	0	187016
26951	1149	1093	182927	5511	0	190680
26952	169868	913	5878	3107	0	179766
26953	5817	795	2765	174029	0	183406
26954	2643	173380	1828	5101	0	182952
26955	1662	180023	1459	2653	0	185797
26956	1917	6352	1424	174226	0	183919
26957	1987	2759	1350	173198	0	179294
26958	1118	173620	1684	6533	0	182955
26959	1430	5307	173782	2873	0	183392
26960	1870	2441	5367	172328	0	182006
26961	1122	1938	176661	5468	0	185189
26962	1132	1473	172078	2976	0	177659
26963	156518	1184	6969	2681	0	167352
26964	5175	163587	3350	1803	0	173915
26965	163141	5409	2052	1981	0	172583
26966	6259	2835	1589	157367	0	168050
26967	2740	162736	1475	5448	0	172399
26968	2394	5974	1583	163256	0	173207
26969	1973	3092	1613	162259	0	168937
26970	1392	160925	1471	7131	0	170919
26971	1480	5886	159400	3668	0	170434
26972	2025	3048	5588	159858	0	170519
26973	158738	2118	3068	6637	0	170561
26974	6048	1710	2107	158147	0	168012
26975	3502	1572	1921	159316	0	166311
26976	2156	1696	154887	7524	0	166263
26977	1981	153517	5744	3848	0	165090
26978	2189	5873	2948	152421	0	163431
26979	1687	3222	153250	6376	0	164535
26980	1572	2482	152989	3807	0	160850
26981	143714	2054	7467	3506	0	156741
26982	5577	150115	3835	2853	0	162380
26983	147672	5885	2632	2946	0	159135
26984	6087	148487	2227	2679	0	159480
26985	3249	153046	2118	2635	0	161048
26986	148234	7419	2024	2811	0	160488
26987	6681	3699	2043	142900	0	155323
26988	3540	147535	2335	6143	0	159553
26989	3199	5967	1906	150426	0	161498
26990	149034	3017	1996	7006	0	161053
26991	6731	2510	148265	3571	0	161077
26992	3603	2161	146512	2778	0	155054
26993	141086	1803	7648	2638	0	153175
26994	6274	143974	4309	2230	0	156787
26995	3785	5909	144682	1845	0	156221
26996	2961	144300	6237	2052	0	155550
26997	2820	6618	3314	141323	0	154075
26998	2258	3781	143842	6030	0	155911
26999	2203	2702	6243	142241	0	153389
27000	1832	2273	141938	6884	0	152927
27001	133010	1957	6865	4407	0	146239
27002	5886	139244	3832	2803	0	151765
27003	134829	5485	2672	2436	0	145422
27004	6298	3118	2263	131685	0	143364
27005	3052	142053	2456	5716	0	153277
27006	140291	6319	2403	3419	0	152432
27007	134514	3059	2567	3168	0	143308
27008	7072	2504	140938	2121	0	152635
27009	3417	2028	140848	1935	0	148228
27010	121719	1678	7325	2027	0	132749
27011	5292	124254	3741	2187	0	135474
27012	2251	120636	2642	1612	0	127141
27013	3453	7475	2500	111322	0	124750
27014	1700	2689	113114	4745	0	122248
27015	1762	106489	4846	2335	0	115432
27016	1287	94689	2193	1478	0	99647
27017	2590	2695	1218	61309	0	67812
27018	62293	777	451	1961	0	65482
27019	62961	536	324	920	0	64741
27020	63877	382	341	649	0	65249
27021	2275	389	62782	341	0	65787
27022	61801	336	1733	488	0	64358
27023	62656	359	751	514	0	64280
27024	64529	394	440	461	0	65824
27025	2501	434	309	60897	0	64141
27026	906	62349	322	1615	0	65192
27027	62088	1673	274	816	0	64851
27028	1757	62497	382	414	0	65050
27029	896	1687	329	61809	0	64721
27030	471	714	64558	1655	0	67398
27031	668	500	1641	63601	0	66410
27032	737	288	630	64920	0	66575
27033	484	341	64916	1986	0	67727
27034	456	64222	1649	759	0	67086
27035	605	1514	560	59617	0	62296
27036	58624	545	280	1663	0	61112
27037	1411	58399	264	582	0	60656
27038	57169	1327	174	457	0	59127
27039	1627	651	154	55503	0	57935
27040	602	57759	215	1238	0	59814
27041	56679	1315	204	659	0	58857
27042	1342	57773	233	300	0	59648
27043	569	1331	56412	160	0	58472
27044	54223	658	1294	484	0	56659
27045	57435	396	401	394	0	58626
27046	1634	57544	229	270	0	59677
27047	609	1410	56134	145	0	58298
27048	324	58795	1317	178	0	60614
27049	1354	1793	738	43989	0	47874
27050	427	505	246	59721	0	60899
27051	445	347	152	59695	0	60639
27052	277	59560	144	1795	0	61776
27053	457	1477	115	59729	0	61778
27054	430	538	161	60723	0	61852
27055	59122	364	123	1904	0	61513
27056	1690	244	127	58983	0	61044
27057	800	209	109	60481	0	61599
27058	58964	213	101	2032	0	61310
27059	1574	60232	143	740	0	62689
27060	60992	1488	117	621	0	63218
27061	60927	594	154	502	0	62177
27062	61807	338	157	446	0	62748
27063	2156	297	168	60275	0	62896
27064	973	269	190	62024	0	63456
27065	594	321	59764	1957	0	62636
27066	515	376	58674	803	0	60368
27067	459	344	59189	526	0	60518
27068	55903	306	1886	569	0	58664
27069	1777	355	58448	409	0	60989
27070	723	59075	1683	485	0	61966
27071	684	1631	621	58502	0	61438
27072	603	733	429	57780	0	59545
27073	517	60115	356	1775	0	62763
27074	512	1732	61495	732	0	64471
27075	493	62763	1531	554	0	65341
27076	62044	1847	640	577	0	65108
27077	1861	839	62582	408	0	65690
27078	885	62362	1679	589	0	65515
27079	726	1681	63245	397	0	66049
27080	729	759	1712	62388	0	65588
27081	583	567	63543	1701	0	66394
27082	696	439	1786	61725	0	64646
27083	63405	378	670	2062	0	66515
27084	1921	407	63368	832	0	66528
27085	843	63715	1683	732	0	66973
27086	63894	1756	679	779	0	67108
27087	1917	759	65370	597	0	68643
27088	886	550	66421	592	0	68449
27089	772	405	2017	65396	0	68590
27090	566	408	66474	2014	0	69462
27091	63106	391	1897	1123	0	66517
27092	1827	66132	752	806	0	69517
27093	994	1747	507	65969	0	69217
27094	636	70020	466	1774	0	72896
27095	70656	1943	419	1086	0	74104
27096	2018	846	69935	725	0	73524
27097	984	599	72884	622	0	75089
27098	832	543	2215	72000	0	75590
27099	671	502	899	74043	0	76115
27100	720	434	616	75110	0	76880
27101	740	464	537	75422	0	77163
27102	591	505	75799	2401	0	79296
27103	497	74910	1942	1094	0	78443
27104	568	1485	594	68057	0	70704
27105	293	511	65688	1278	0	67770
27106	285	64709	1240	596	0	66830
27107	64013	1184	696	558	0	66451
27108	1612	555	434	63815	0	66416
27109	62680	331	276	1303	0	64590
27110	1105	62927	282	534	0	64848
27111	62616	1048	267	586	0	64517
27112	1210	434	65758	332	0	67734
27113	683	529	1085	62689	0	64986
27114	382	65671	475	1056	0	67584
27115	315	1028	65199	477	0	67019
27116	219	64904	1096	399	0	66618
27117	1234	1461	639	47269	0	50603
27118	62483	364	305	1134	0	64286
27119	882	62769	282	422	0	64355
27120	62342	887	264	495	0	63988
27121	1015	399	61807	294	0	63515
27122	462	308	60365	260	0	61395
27123	61149	211	1077	355	0	62792
27124	995	258	522	62256	0	64031
27125	542	173	367	62705	0	63787
27126	337	198	64811	1033	0	66379
27127	292	240	61898	492	0	62922
27128	207	65770	1072	358	0	67407
27129	64174	851	672	471	0	66168
27130	62134	291	342	320	0	63087
27131	849	61614	244	213	0	62920
27132	471	741	194	63608	0	65014
27133	64517	260	198	976	0	65951
27134	827	223	201	64488	0	65739
27135	65339	161	190	1077	0	66767
27136	65656	130	208	568	0	66562
27137	67887	137	180	505	0	68709
27138	1060	170	180	66974	0	68384
27139	532	147	171	70376	0	71226
27140	68693	150	145	1145	0	70133
27141	68240	122	180	626	0	69168
27142	68680	151	173	512	0	69516
27143	1020	68113	177	238	0	69548
27144	66315	537	131	334	0	67317
27145	642	66350	141	228	0	67361
27146	65051	581	150	370	0	66152
27147	697	242	66081	143	0	67163
27148	58094	221	528	451	0	59294
27149	538	62924	202	140	0	63804
27150	198	63670	137	110	0	64115
27151	65165	435	115	331	0	66046
27152	552	166	69	65288	0	66075
27153	296	125	70	67429	0	67920
27154	155	67711	110	547	0	68523
27155	144	72469	99	228	0	72940
27156	74330	665	85	413	0	75493
27157	850	269	77883	93	0	79095
27158	452	137	759	81375	0	82723
27159	84229	107	196	1316	0	85848
27160	1203	146	84875	193	0	86417
27161	276	92260	1113	167	0	93816
27162	96783	1323	213	462	0	98781
27163	1749	336	99796	118	0	101999
27164	789	199	1725	104754	0	107467
27165	336	177	109589	1852	0	111954
27166	103109	104	2068	905	0	106186
27167	1871	112349	508	331	0	115059
27168	113651	1978	287	559	0	116475
27169	114702	448	173	439	0	115762
27170	2637	261	127	113882	0	116907
27171	115407	163	196	2339	0	118105
27172	2533	169	111	115539	0	118352
27173	967	159	88	116804	0	118018
27174	428	211	114100	2331	0	117070
27175	332	114369	1931	674	0	117306
27176	608	1918	406	115855	0	118787
27177	584	453	254	117238	0	118529
27178	561	239	187	117604	0	118591
27179	236	214	116121	2424	0	118995
27180	240	114853	1943	725	0	117761
27181	508	1895	440	117005	0	119848
27182	558	433	227	118661	0	119879
27183	267	294	117048	2290	0	119899
27184	609	222	1878	112676	0	115385
27185	115804	136	462	2643	0	119045
27186	1856	117164	317	671	0	120008
27187	115913	1849	195	817	0	118774
27188	2142	498	116993	332	0	119965
27189	857	327	1941	116759	0	119884
27190	119104	193	459	2478	0	122234
27191	118348	135	283	1022	0	119788
27192	2382	238	120658	387	0	123665
27193	1202	305	1991	117696	0	121194
27194	526	249	119576	2029	0	122380
27195	111779	119	2076	1149	0	115123
27196	1989	118956	599	537	0	122081
27197	119945	1871	381	687	0	122884
27198	120356	449	313	674	0	121792
27199	2521	121294	297	301	0	124413
27200	123164	2150	234	730	0	126278
27201	2547	550	121649	253	0	124999
27202	121294	337	2072	635	0	124338
27203	2662	250	522	123547	0	126981
27204	955	256	127348	2199	0	130758
27205	971	252	2211	126439	0	129873
27206	1055	261	654	123126	0	125096
27207	742	194	493	128180	0	129609
27208	527	127258	487	2596	0	130868
27209	128552	2157	338	1286	0	132333
27210	2586	609	350	128835	0	132380
27211	902	127492	407	2441	0	131242
27212	930	2202	330	124904	0	128366
27213	629	125500	442	2573	0	129144
27214	631	2415	125980	989	0	130015
27215	944	630	2267	123816	0	127657
27216	898	431	684	126935	0	128948
27217	550	510	126382	2923	0	130365
27218	114704	391	2345	1799	0	119239
27219	2371	125520	739	1040	0	129670
27220	1072	2345	553	127594	0	131564
27221	921	649	512	126325	0	128407
27222	933	545	424	125518	0	127420
27223	657	125622	532	2942	0	129753
27224	124294	2286	538	1774	0	128892
27225	2583	863	124479	1031	0	128956
27226	973	640	119822	1033	0	122468
27227	990	470	2640	121420	0	125520
27228	868	446	904	125229	0	127447
27229	123712	392	658	3516	0	128278
27230	2582	121860	661	1401	0	126504
27231	1123	2286	602	124773	0	128784
27232	122859	717	590	3190	0	127356
27233	2890	618	513	121675	0	125696
27234	121580	445	529	3479	0	126033
27235	2958	468	117532	1284	0	122242
27236	1201	120301	2486	1073	0	125061
27237	120233	2424	812	1469	0	124938
27238	2989	852	120479	790	0	125110
27239	114699	488	2567	1403	0	119157
27240	2973	523	117247	888	0	121631
27241	117629	404	2617	1124	0	121774
27242	3018	464	891	120162	0	124535
27243	120913	424	648	3063	0	125048
27244	2952	488	592	120628	0	124660
27245	1314	393	500	121937	0	124144
27246	120553	396	564	3642	0	125155
27247	2789	119862	529	1476	0	124656
27248	1296	2383	453	123526	0	127658
27249	124709	779	487	3507	0	129482
27250	129243	594	478	1670	0	131985
27251	3466	488	445	128283	0	132682
27252	1563	435	456	132433	0	134887
27253	134403	436	418	4033	0	139290
27254	3862	410	394	137543	0	142209
27255	1682	470	405	137422	0	139979
27256	134047	365	390	4357	0	139159
27257	3816	325	354	130518	0	135013
27258	1131	331	122659	3448	0	127569
27259	116066	232	2501	1935	0	120734
27260	3176	301	122016	854	0	126347
27261	1113	343	111620	685	0	113761
27262	105807	433	3228	968	0	110436
27263	2233	107307	950	368	0	110858
27264	1040	1740	634	103602	0	107016
27265	777	418	297	102912	0	104404
27266	898	235	163	107565	0	108861
27267	659	142	183	110749	0	111733
27268	105124	171	267	3531	0	109093
27269	115881	83	101	1420	0	117485
27270	120124	137	128	1063	0	121452
27271	3252	153	129263	505	0	133173
27272	1634	87	3146	134219	0	139086
27273	1185	79	1030	137936	0	140230
27274	1102	137	584	134271	0	136094
27275	523	128823	472	5276	0	135094
27276	475	135110	356	2367	0	138308
27277	136842	4671	198	1875	0	143586
27278	4538	1851	237	137469	0	144095
27279	2284	942	161	145819	0	149206
27280	1669	552	172	149135	0	151528
27281	811	479	142249	6641	0	150180
27282	772	514	139455	2968	0	143709
27283	138402	292	5471	2297	0	146462
27284	147002	189	2175	1672	0	151038
27285	6275	251	1237	141452	0	149215
27286	2461	142231	911	4749	0	150352
27287	2307	4238	574	142859	0	149978
27288	1757	1508	524	144958	0	148747
27289	912	982	139323	6472	0	147689
27290	137798	571	4255	3456	0	146080
27291	5466	421	1631	145129	0	152647
27292	2705	354	1019	144474	0	148552
27293	139339	347	750	7242	0	147678
27294	5134	142231	686	3504	0	151555
27295	145589	4533	533	2684	0	153339
27296	6539	1862	530	141900	0	150831
27297	2563	140183	394	5593	0	148733
27298	142138	4883	341	3033	0	150395
27299	5981	2029	386	141286	0	149682
27300	140104	1234	355	6060	0	147753
27301	138861	835	370	3428	0	143494
27302	139637	573	320	2621	0	143151
27303	7316	133146	539	1782	0	142783
27304	3499	133723	569	1579	0	139370
27305	3076	5842	422	127712	0	137052
27306	1850	131413	472	5334	0	139069
27307	133877	5554	373	2849	0	142653
27308	6282	2479	398	133563	0	142722
27309	134088	1584	432	6143	0	142247
27310	137712	1129	396	3415	0	142652
27311	7858	959	535	132497	0	141849
27312	4453	770	512	138417	0	144152
27313	134921	836	454	7981	0	144192
27314	137280	785	427	4385	0	142877
27315	141638	743	424	3324	0	146129
27316	143125	903	364	2684	0	147076
27317	145214	864	326	2507	0	148911
27318	9064	809	308	138969	0	149150
27319	5087	868	392	142098	0	148445
27320	3892	893	420	144543	0	149748
27321	139701	760	407	8673	0	149541
27322	7275	602	422	138204	0	146503
27323	3938	135390	464	7490	0	147282
27324	3453	4975	385	140532	0	149345
27325	137084	2155	441	7873	0	147553
27326	140366	1510	470	4379	0	146725
27327	8326	1313	133856	3033	0	146528
27328	5158	1202	4577	129983	0	140920
27329	3285	134037	1889	6459	0	145670
27330	136510	5032	1126	4226	0	146894
27331	6821	137203	820	3243	0	148087
27332	4356	5652	638	139132	0	149778
27333	139921	2534	609	7080	0	150144
27334	142241	1760	583	4285	0	148869
27335	8527	138101	488	3130	0	150246
27336	5134	5457	314	138595	0	149500
27337	3740	2646	136052	6777	0	149215
27338	134163	1764	4777	4193	0	144897
27339	7509	1406	136414	3049	0	148378
27340	138001	1183	5536	2839	0	147559
27341	142429	1120	2327	2848	0	148724
27342	8971	1160	1283	138790	0	150204
27343	142027	1213	843	7274	0	151357
27344	145807	1203	751	4093	0	151854
27345	147576	1358	550	3229	0	152713
27346	10047	1229	592	141009	0	152877
27347	142396	963	565	6970	0	150894
27348	8710	1009	561	140013	0	150293
27349	5244	996	771	140064	0	147075
27350	3922	134876	796	8190	0	147784
27351	4142	4761	751	131081	0	140735
27352	3457	130692	563	6566	0	141278
27353	127233	4859	366	3749	0	136207
27354	125975	2293	297	3107	0	131672
27355	7604	1614	253	121979	0	131450
27356	4693	1145	296	123611	0	129745
27357	121291	980	339	6924	0	129534
27358	6452	871	115907	3946	0	127176
27359	119181	744	3557	2988	0	126470
27360	7122	735	1441	117102	0	126400
27361	4044	846	109312	5333	0	119535
27362	109761	778	3529	3595	0	117663
27363	114107	782	1596	2875	0	119360
27364	7099	884	109782	2127	0	119892
27365	110024	662	3582	2384	0	116652
27366	6160	794	105879	1773	0	114606
27367	3931	104998	3760	1634	0	114323
27368	106063	3092	2696	1910	0	113761
27369	104135	1612	1377	1922	0	109046
27370	5780	95913	831	1419	0	103943
27371	2646	85809	677	1012	0	90144
27372	79588	1920	999	968	0	83475
27373	79497	777	475	931	0	81680
27374	3018	616	304	80054	0	83992
27375	1632	417	76976	1817	0	80842
27376	1396	494	72647	942	0	75479
27377	75390	388	1666	983	0	78427
27378	2174	414	76603	629	0	79820
27379	71788	565	1828	746	0	74927
27380	1881	273	625	71331	0	74110
27381	1165	202	357	72137	0	73861
27382	870	273	72302	1547	0	74992
27383	71876	139	1155	1121	0	74291
27384	1682	178	551	74117	0	76528
27385	1111	161	426	75761	0	77459
27386	74587	132	293	1865	0	76877
27387	74210	110	251	1248	0	75819
27388	74139	139	320	1030	0	75628
27389	1857	76067	383	527	0	78834
27390	987	796	72624	373	0	74780
27391	70545	320	861	664	0	72390
27392	73087	194	429	712	0	74422
27393	1454	71473	321	355	0	73603
27394	68486	536	352	516	0	69890
27395	1065	290	141	67845	0	69341
27396	508	234	70209	654	0	71605
27397	68662	207	581	757	0	70207
27398	71438	125	299	685	0	72547
27399	71686	138	137	693	0	72654
27400	71995	135	133	491	0	72754
27401	1145	117	137	71773	0	73172
27402	719	105	145	71569	0	72538
27403	72347	110	177	1074	0	73708
27404	964	65	177	72281	0	73487
27405	700	61	153	71920	0	72834
27406	474	70779	195	822	0	72270
27407	513	551	127	72586	0	73777
27408	525	201	153	72305	0	73184
27409	520	119	137	72736	0	73512
27410	501	92	155	72928	0	73676
27411	373	72007	155	931	0	73466
27412	427	573	116	71280	0	72396
27413	511	276	89	69267	0	70143
27414	313	209	68943	857	0	70322
27415	289	192	64167	470	0	65118
27416	238	66921	651	375	0	68185
27417	80703	503	266	664	0	82136
27418	1048	83216	211	264	0	84739
27419	729	1054	124	88377	0	90284
27420	294	389	94490	1243	0	96416
27421	97935	182	1400	931	0	100448
27422	1948	131	398	102938	0	105415
27423	101410	129	290	2275	0	104104
27424	103492	105	190	1141	0	104928
27425	1922	104169	198	449	0	106738
27426	103065	1470	141	958	0	105634
27427	1824	106447	212	337	0	108820
27428	1220	1874	149	106468	0	109711
27429	496	107873	238	1729	0	110336
27430	515	1979	107096	561	0	110151
27431	430	108938	1748	436	0	111552
27432	946	2265	448	105279	0	108938
27433	105850	635	304	2620	0	109409
27434	1727	109365	423	719	0	112234
27435	1411	1908	186	108836	0	112341
27436	1065	721	132	111501	0	113419
27437	602	543	110309	2562	0	114016
27438	1164	374	1992	108879	0	112409
27439	491	476	110563	2457	0	113987
27440	104351	319	2279	1571	0	108520
27441	2463	480	112140	619	0	115702
27442	958	112162	2326	722	0	116168
27443	1304	2401	751	110219	0	114675
27444	1129	851	623	110756	0	113359
27445	1059	792	360	111230	0	113441
27446	110789	467	320	3812	0	115388
27447	3119	534	253	108679	0	112585
27448	999	110559	393	2793	0	114744
27449	106438	2642	273	1953	0	111306
27450	2406	106464	443	1219	0	110532
27451	1635	2665	504	105667	0	110471
27452	105469	1044	378	3471	0	110362
27453	2725	104619	522	1389	0	109255
27454	1274	109077	403	1064	0	111818
27455	107153	3053	542	1409	0	112157
27456	108979	1455	366	1389	0	112189
27457	3203	1014	107087	1001	0	112305
27458	107078	749	2440	1564	0	111831
27459	3124	781	110095	1015	0	115015
27460	1981	744	2735	110122	0	115582
27461	985	798	111377	3163	0	116323
27462	1375	840	2851	110515	0	115581
27463	990	798	111699	3391	0	116878
27464	1263	887	2857	107545	0	112552
27465	1178	663	1034	111605	0	114480
27466	108219	650	814	4316	0	113999
27467	2998	855	107146	1874	0	112873
27468	101488	862	2885	1721	0	106956
27469	3415	709	105658	1258	0	111040
27470	1655	709	106167	986	0	109517
27471	1723	753	3462	103179	0	109117
27472	104522	644	1468	3484	0	110118
27473	2948	104973	1173	1605	0	110699
27474	102609	2707	799	1819	0	107934
27475	103713	1069	875	1567	0	107224
27476	3588	102638	838	1418	0	108482
27477	102740	2807	927	1257	0	107731
27478	3477	1243	103589	1156	0	109465
27479	1938	944	2888	103576	0	109346
27480	103781	712	1225	3570	0	109288
27481	3217	104350	1155	1575	0	110297
27482	1992	2751	833	103011	0	108587
27483	1664	1158	983	103831	0	107636
27484	1410	953	924	105316	0	108603
27485	1477	751	848	106190	0	109266
27486	103592	658	796	4339	0	109385
27487	105029	701	886	2284	0	108900
27488	104558	645	979	1759	0	107941
27489	102090	547	859	1744	0	105240
27490	4236	791	101414	1197	0	107638
27491	100806	656	2912	1440	0	105814
27492	103826	614	1495	1440	0	107375
27493	4174	100735	1063	1350	0	107322
27494	2242	103829	949	1154	0	108174
27495	1996	3436	797	100697	0	106926
27496	1751	1355	799	101660	0	105565
27497	1492	1039	99100	3869	0	105500
27498	1337	100047	3058	2032	0	106474
27499	1676	2860	1336	97719	0	103591
27500	1353	100697	1169	3230	0	106449
27501	1674	3052	830	102975	0	108531
27502	1783	1225	709	102858	0	106575
27503	1479	105274	841	3905	0	111499
27504	1582	2972	897	107063	0	112514
27505	1599	1297	108061	3701	0	114658
27506	1615	984	107422	1923	0	111944
27507	104206	982	3721	1718	0	110627
27508	109498	859	1586	1643	0	113586
27509	4037	107838	1228	1570	0	114673
27510	109324	3022	842	1596	0	114784
27511	4250	1339	850	108535	0	114974
27512	108145	1206	740	3821	0	113912
27513	3690	108243	690	2222	0	114845
27514	2194	3161	106792	1575	0	113722
27515	104172	1314	3325	1982	0	110793
27516	3907	1156	110376	1423	0	116862
27517	1664	736	92979	810	0	96189
27518	1271	668	91962	809	0	94710
27519	921	87478	2878	722	0	91999
27520	79252	2644	3063	1072	0	86031
27521	76591	772	784	873	0	79020
27522	2418	518	493	74776	0	78205
27523	1316	494	422	74352	0	76584
27524	773	77812	507	2079	0	81171
27525	78495	1526	428	1423	0	81872
27526	1850	78809	489	746	0	81894
27527	952	77427	466	537	0	79382
27528	75917	1525	535	729	0	78706
27529	1842	617	413	75174	0	78046
27530	981	379	350	75137	0	76847
27531	800	346	349	76176	0	77671
27532	596	75234	336	1731	0	77897
27533	74235	1194	251	950	0	76630
27534	1686	715	213	73260	0	75874
27535	689	71109	276	1249	0	73323
27536	501	71336	245	571	0	72653
27537	579	1247	229	69106	0	71161
27538	430	69985	236	1031	0	71682
27539	566	1131	218	69747	0	71662
27540	67958	453	192	1448	0	70051
27541	957	385	66174	481	0	67997
27542	412	67896	783	379	0	69470
27543	523	906	304	68575	0	70308
27544	342	428	70272	846	0	71888
27545	66937	296	857	709	0	68799
27546	1251	320	367	70776	0	72714
27547	70489	168	223	1361	0	72241
27548	70324	181	157	850	0	71512
27549	1146	74104	183	329	0	75762
27550	75085	934	144	695	0	76858
27551	75102	436	147	623	0	76308
27552	75499	265	114	525	0	76403
27553	1452	216	111	73529	0	75308
27554	754	219	138	73024	0	74135
27555	576	213	125	74161	0	75075
27556	340	260	73013	1233	0	74846
27557	304	72312	833	552	0	74001
27558	70512	777	326	692	0	72307
27559	786	70571	200	269	0	71826
27560	506	788	109	70051	0	71454
27561	243	366	69039	744	0	70392
27562	62475	226	672	863	0	64236
27563	700	69353	291	261	0	70605
27564	525	722	129	68834	0	70210
27565	394	312	96	69178	0	69980
27566	212	251	68145	872	0	69480
27567	162	68234	666	463	0	69525
27568	309	748	282	68246	0	69585
27569	322	310	142	68869	0	69643
27570	317	219	94	67660	0	68290
27571	65466	163	113	1429	0	67171
27572	765	213	66126	443	0	67547
27573	342	65787	681	333	0	67143
27574	64469	669	266	682	0	66086
27575	710	66022	183	235	0	67150
27576	456	790	117	64810	0	66173
27577	279	66031	140	674	0	67124
27578	63229	699	101	765	0	64794
27579	63846	351	115	605	0	64917
27580	1034	241	120	65471	0	66866
27581	611	206	97	65457	0	66371
27582	432	153	98	69151	0	69834
27583	242	206	70167	1388	0	72003
27584	245	73291	1193	617	0	75346
27585	587	1318	415	86651	0	88971
27586	524	541	199	89613	0	90877
27587	653	293	137	90533	0	91616
27588	665	209	134	90644	0	91652
27589	249	293	89678	2929	0	93149
27590	205	94743	2011	1268	0	98227
27591	679	2368	709	96985	0	100741
27592	691	925	282	105844	0	107742
27593	215	585	104001	3642	0	108443
27594	733	390	2569	99258	0	102950
27595	240	100151	1117	3184	0	104692
27596	184	105064	529	1710	0	107487
27597	699	3446	320	102655	0	107120
27598	236	1416	100301	3328	0	105281
27599	90600	691	2756	2564	0	96611
27600	2460	99114	1229	1357	0	104160
27601	948	2837	97343	996	0	102124
27602	468	1344	97445	946	0	100203
27603	309	95731	3645	830	0	100515
27604	365	2997	97315	766	0	101443
27605	1033	1859	3159	92811	0	98862
27606	91974	750	1401	3302	0	97427
27607	93568	622	913	1811	0	96914
27608	92680	608	694	1411	0	95393
27609	96000	595	678	1160	0	98433
27610	3530	97613	634	763	0	102540
27611	97085	2844	625	1263	0	101817
27612	3124	99503	740	686	0	104053
27613	1639	3234	97481	547	0	102901
27614	1582	1551	2879	92250	0	98262
27615	770	99270	1422	2693	0	104155
27616	1251	3101	853	95696	0	100901
27617	93269	1607	595	3517	0	98988
27618	3366	920	666	91740	0	96692
27619	1436	95403	624	3187	0	100650
27620	95435	3065	543	1933	0	100976
27621	3328	1527	95519	1061	0	101435
27622	2202	942	2857	94036	0	100037
27623	1497	790	1257	97452	0	100996
27624	91000	799	750	4338	0	96887
27625	3210	91256	667	2100	0	97233
27626	1486	3254	90119	1196	0	96055
27627	1426	1525	2946	89872	0	95769
27628	809	1017	91257	3491	0	96574
27629	738	88008	3170	1930	0	93846
27630	691	92436	1449	1472	0	96048
27631	89585	3782	974	1424	0	95765
27632	2998	1849	89916	1235	0	95998
27633	90627	1185	3207	1339	0	96358
27634	3530	964	1589	88146	0	94229
27635	1528	91083	1137	3185	0	96933
27636	90509	3239	856	2096	0	96700
27637	3247	1746	91558	1264	0	97815
27638	2118	1107	3112	90453	0	96790
27639	1392	1016	1633	92510	0	96551
27640	1233	1053	1113	91773	0	95172
27641	889	90593	941	4350	0	96773
27642	87085	3225	953	2415	0	93678
27643	3100	87891	874	1425	0	93290
27644	1520	89776	873	1249	0	93418
27645	1402	3783	810	88558	0	94553
27646	88816	1901	901	3454	0	95072
27647	88191	1274	740	2080	0	92285
27648	88564	1214	696	1585	0	92059
27649	3958	83949	717	1214	0	89838
27650	2294	3205	641	83861	0	90001
27651	1439	1822	83803	3226	0	90290
27652	1510	1168	2865	83157	0	88700
27653	1460	1076	1333	82847	0	86716
27654	1144	84182	831	4054	0	90211
27655	84730	3333	707	2394	0	91164
27656	3494	1807	699	83024	0	89024
27657	1743	85107	771	3486	0	91107
27658	84924	3418	704	2169	0	91215
27659	3396	1942	83899	1553	0	90790
27660	83111	1326	2757	1612	0	88806
27661	3544	85795	1417	1360	0	92116
27662	86580	3354	903	1378	0	92215
27663	87712	1937	773	1398	0	91820
27664	4172	1475	86020	1208	0	92875
27665	86402	1222	3015	1248	0	91887
27666	3823	1123	89509	1155	0	95610
27667	2219	1071	90979	1080	0	95349
27668	88480	1154	3768	1041	0	94443
27669	91224	1066	1878	1073	0	95241
27670	4409	1037	90789	967	0	97202
27671	2571	962	3392	88868	0	95793
27672	2028	946	1808	88901	0	93683
27673	1682	93160	1314	3503	0	99659
27674	90139	3085	1063	2161	0	96448
27675	95168	1688	864	1360	0	99080
27676	4653	1137	93687	977	0	100454
27677	94624	882	3106	1146	0	99758
27678	97641	939	1583	1209	0	101372
27679	4633	95335	1114	954	0	102036
27680	2666	3127	1013	94099	0	100905
27681	2340	1516	957	92722	0	97535
27682	1988	980	833	92222	0	96023
27683	87699	803	802	3621	0	92925
27684	2906	83899	748	1826	0	89379
27685	1341	1900	432	68582	0	72255
27686	924	68123	398	1735	0	71180
27687	954	2934	341	64245	0	68474
27688	743	65224	365	1522	0	67854
27689	654	66701	423	1028	0	68806
27690	58556	1441	804	910	0	61711
27691	58824	507	583	736	0	60650
27692	902	241	174	54676	0	55993
27693	494	149	128	55166	0	55937
27694	406	126	122	56144	0	56798
27695	322	145	113	55839	0	56419
27696	349	144	106	54677	0	55276
27697	190	54636	130	910	0	55866
27698	324	632	96	55282	0	56334
27699	336	269	87	56300	0	56992
27700	55379	201	99	987	0	56666
27701	897	167	105	55492	0	56661
27702	483	163	97	55618	0	56361
27703	367	152	56342	893	0	57754
27704	463	143	626	54479	0	55711
27705	341	293	196	57721	0	58551
27706	199	130	59196	1031	0	60556
27707	220	60406	705	570	0	61901
27708	236	727	61694	368	0	63025
27709	201	245	60064	254	0	60764
27710	118	58905	757	192	0	59972
27711	59797	640	339	424	0	61200
27712	59671	153	137	347	0	60308
27713	846	112	57	58777	0	59792
27714	59543	73	54	922	0	60592
27715	764	80	61269	239	0	62352
27716	440	68	670	61765	0	62943
27717	190	122	68233	759	0	69304
27718	330	78	778	68279	0	69465
27719	286	97	259	68811	0	69453
27720	262	80	173	69838	0	70353
27721	69361	71	106	1252	0	70790
27722	898	92	96	70215	0	71301
27723	69918	89	107	1209	0	71323
27724	70533	90	109	674	0	71406
27725	940	70480	160	297	0	71877
27726	71126	714	98	525	0	72463
27727	866	73226	156	287	0	74535
27728	518	797	88	72600	0	74003
27729	498	257	129	72933	0	73817
27730	382	157	94	74229	0	74862
27731	228	170	72600	1224	0	74222
27732	201	72189	859	633	0	73882
27733	439	880	263	69925	0	71507
27734	370	319	168	70590	0	71447
27735	223	72585	131	944	0	73883
27736	72504	861	106	778	0	74249
27737	910	71554	137	449	0	73050
27738	70679	911	84	558	0	72232
27739	992	72360	142	383	0	73877
27740	570	960	92	70839	0	72461
27741	255	73284	141	938	0	74618
27742	74025	969	80	849	0	75923
27743	74540	360	75	745	0	75720
27744	73913	272	97	689	0	74971
27745	73359	207	109	639	0	74314
27746	1228	272	73188	289	0	74977
27747	72831	207	801	633	0	74472
27748	75529	175	273	631	0	76608
27749	75190	234	155	626	0	76205
27750	1247	237	74106	333	0	75923
27751	72760	217	766	622	0	74365
27752	1086	75792	312	357	0	77547
27753	76583	855	189	639	0	78266
27754	1136	466	82169	335	0	84106
27755	80924	267	831	785	0	82807
27756	83695	173	278	641	0	84787
27757	1329	168	184	83436	0	85117
27758	657	193	82275	942	0	84067
27759	82360	122	812	808	0	84102
27760	1205	145	315	85261	0	86926
27761	727	174	234	86489	0	87624
27762	431	230	87554	1156	0	89371
27763	80596	143	897	1039	0	82675
27764	87422	153	362	808	0	88745
27765	1199	88441	266	421	0	90327
27766	693	883	213	88834	0	90623
27767	598	331	182	88801	0	89912
27768	565	232	187	88189	0	89173
27769	357	89737	255	1254	0	91603
27770	89559	870	184	1020	0	91633
27771	1185	350	175	89679	0	91389
27772	683	249	166	90190	0	91288
27773	87309	168	158	1623	0	89258
27774	86502	180	163	958	0	87803
27775	1335	160	184	87958	0	89637
27776	781	162	167	86890	0	88000
27777	432	251	83679	1160	0	85522
27778	77843	151	761	1069	0	79824
27779	993	84876	337	453	0	86659
27780	675	812	156	89311	0	90954
27781	647	311	126	91399	0	92483
27782	414	94368	172	1521	0	96475
27783	526	1381	147	98028	0	100082
27784	105719	538	155	2257	0	108669
27785	2508	359	141	123282	0	126290
27786	1312	205	131	126846	0	128494
27787	1082	225	128	130515	0	131950
27788	491	279	126956	5201	0	132927
27789	999	176	2928	127304	0	131407
27790	439	241	127106	4672	0	132458
27791	326	123519	3553	2527	0	129925
27792	855	2954	1715	124195	0	129719
27793	810	1333	971	126304	0	129418
27794	756	767	624	128835	0	130982
27795	708	488	494	128189	0	129879
27796	688	451	367	130924	0	132430
27797	123593	284	350	6535	0	130762
27798	3080	377	125468	3241	0	132166
27799	1448	121883	3032	2546	0	128909
27800	849	130659	1478	1950	0	134936
27801	1048	4026	805	129631	0	135510
27802	928	1874	772	132671	0	136245
27803	864	1125	587	131091	0	133667
27804	336	129337	628	5386	0	135687
27805	814	3455	435	130659	0	135363
27806	339	1836	127469	4723	0	134367
27807	232	126110	2919	3021	0	132282
27808	634	3320	1339	127871	0	133164
27809	125111	1603	850	4919	0	132483
27810	3144	937	566	127888	0	132535
27811	1979	780	422	127210	0	130391
27812	971	121933	636	4964	0	128504
27813	714	130838	514	2804	0	134870
27814	938	4187	307	129974	0	135406
27815	889	2090	234	131322	0	134535
27816	358	1265	128207	5465	0	135295
27817	824	937	2751	124482	0	128994
27818	702	841	1413	127075	0	130031
27819	664	712	901	127553	0	129830
27820	641	570	891	129233	0	131335
27821	123106	691	675	6795	0	131267
27822	125508	520	466	4517	0	131011
27823	4618	362	408	127908	0	133296
27824	2654	324	341	132399	0	135718
27825	128086	324	304	7167	0	135881
27826	4227	529	349	134163	0	139268
27827	2035	772	134786	6040	0	143633
27828	1202	135047	3398	4253	0	143900
27829	1276	3196	1848	138851	0	145171
27830	981	1631	1373	142552	0	146537
27831	138831	1080	1069	7111	0	148091
27832	3707	922	734	143422	0	148785
27833	1992	799	533	147359	0	150683
27834	143705	627	431	7968	0	152731
27835	4390	613	389	146703	0	152095
27836	2339	145582	470	6379	0	154770
27837	1866	3620	433	154226	0	160145
27838	1625	1898	439	159843	0	163805
27839	1595	1248	522	158703	0	162068
27840	1263	1089	515	160665	0	163532
27841	741	1233	152874	7895	0	162743
27842	587	1312	150968	4969	0	157836
27843	858	1103	4784	154232	0	160977
27844	808	754	2305	154741	0	158608
27845	600	153238	1580	7513	0	162931
27846	975	3975	1145	151328	0	157423
27847	531	152250	1082	6964	0	160827
27848	149902	4532	961	4977	0	160372
27849	3836	158861	914	3901	0	167512
27850	2287	5031	554	164368	0	172240
27851	1752	2618	421	168481	0	173272
27852	1069	1853	161877	7951	0	172750
27853	151994	1271	3690	6140	0	163095
27854	155233	1214	1836	4613	0	162896
27855	5180	156433	1591	3484	0	166688
27856	2931	4151	1431	154768	0	163281
27857	1808	2201	162449	5866	0	172324
27858	1282	164988	4222	4395	0	174887
27859	162430	4599	2020	4166	0	173215
27860	163983	2398	1158	3763	0	171302
27861	5959	1742	156990	3015	0	167706
27862	158318	1420	3914	3077	0	166729
27863	6059	1256	1860	160377	0	169552
27864	3212	159563	1415	5827	0	170017
27865	159358	4194	1065	4506	0	169123
27866	5497	2143	1057	159802	0	168499
27867	160169	1458	864	6470	0	168961
27868	166244	1262	792	4543	0	172841
27869	6753	1390	652	163139	0	171934
27870	3356	1233	163836	6567	0	174992
27871	162204	985	4165	4999	0	172353
27872	169337	986	2065	3920	0	176308
27873	170085	841	1208	3791	0	175925
27874	6952	170600	1105	2952	0	181609
27875	4366	4232	969	170995	0	180562
27876	3238	2138	747	178328	0	184451
27877	2047	1734	174596	7508	0	185885
27878	2315	1618	4119	171305	0	179357
27879	1546	172034	2033	6973	0	182586
27880	167153	4030	1242	5027	0	177452
27881	4447	167800	1105	3526	0	176878
27882	2534	4194	165259	2556	0	174543
27883	1641	165503	4094	2613	0	173851
27884	1195	162259	2281	1806	0	167541
27885	1632	2439	1572	139545	0	145188
27886	138743	935	586	2710	0	142974
27887	137838	504	255	1699	0	140296
27888	136370	416	242	1462	0	138490
27889	2423	141770	346	875	0	145414
27890	1116	1980	139801	570	0	143467
27891	137457	859	1767	1204	0	141287
27892	142752	468	719	1309	0	145248
27893	2544	141851	475	638	0	145508
27894	144643	1885	286	1196	0	148010
27895	2653	860	294	145158	0	148965
27896	1125	714	153333	2108	0	157280
27897	151257	475	2094	1968	0	155794
27898	153883	442	773	1642	0	156740
27899	159630	365	412	1285	0	161692
27900	3382	443	326	156331	0	160482
27901	1942	409	328	158956	0	161635
27902	1360	397	253	167445	0	169455
27903	787	165601	469	3596	0	170453
27904	2448	2981	442	166223	0	172094
27905	1407	1179	271	188948	0	191805
27906	785	870	188332	4656	0	194643
27907	1520	583	3561	185375	0	191039
27908	1354	512	1233	190990	0	194089
27909	1264	466	733	189670	0	192133
27910	1416	506	533	188401	0	190856
27911	734	187470	625	5690	0	194519
27912	1334	3751	440	189388	0	194913
27913	1306	1374	617	189599	0	192896
27914	184330	812	519	6718	0	192379
27915	4246	792	182888	2880	0	190806
27916	1899	794	177625	2074	0	182392
27917	172495	634	4824	2771	0	180724
27918	183306	680	1795	2251	0	188032
27919	5787	731	964	170153	0	177635
27920	2255	181392	854	4165	0	188666
27921	182373	3781	637	2781	0	189572
27922	5166	1484	779	178254	0	185683
27923	2029	181911	910	4284	0	189134
27924	180669	3467	580	2892	0	187608
27925	4288	183315	525	1367	0	189495
27926	178413	3888	452	2174	0	184927
27927	173817	1669	380	2123	0	177989
27928	5135	170981	486	1164	0	177766
27929	2849	3703	474	170242	0	177268
27930	1641	1740	169287	4036	0	176704
27931	1973	1346	3355	165875	0	172549
27932	165783	940	1215	5209	0	173147
27933	4214	954	164051	2152	0	171371
27934	1945	163042	3427	1587	0	170001
27935	2165	3956	1226	159999	0	167346
27936	1054	1708	159754	4043	0	166559
27937	828	157343	3593	2201	0	163965
27938	155038	3445	1499	2377	0	162359
27939	4088	1492	983	156752	0	163315
27940	2248	932	860	158092	0	162132
27941	1737	934	780	156476	0	159927
27942	874	156149	713	4948	0	162684
27943	154136	3389	646	3398	0	161569
27944	3497	153512	840	1806	0	159655
27945	1695	158208	549	1609	0	162061
27946	155856	4137	483	2319	0	162795
27947	156794	1763	516	2300	0	161373
27948	4525	1486	153040	1291	0	160342
27949	147103	1060	3154	1779	0	153096
27950	147229	1050	1289	1477	0	151045
27951	5256	1091	778	143895	0	151020
27952	2598	1151	142612	3642	0	150003
27953	2380	955	3147	141642	0	148124
27954	143938	661	1296	4914	0	150809
27955	4361	789	145870	1999	0	153019
27956	2867	774	3710	157161	0	164512
27957	2905	679	1549	174973	0	180106
27958	2233	797	1004	194819	0	198853
27959	191437	736	897	9248	0	202318
27960	6713	196602	913	3528	0	207756
27961	196850	6492	710	3034	0	207086
27962	7747	2104	196991	1889	0	208731
27963	3817	1279	6637	187939	0	199672
27964	1922	198612	2155	7241	0	209930
27965	199091	6730	1287	3924	0	211032
27966	8357	2252	1002	199544	0	211155
27967	2874	1798	196920	7888	0	209480
27968	2954	1205	6529	194433	0	205121
27969	187426	1105	2336	9107	0	199974
27970	6755	189163	1550	3864	0	201332
27971	3821	7047	980	171090	0	182938
27972	2042	187408	1017	7108	0	197575
27973	185307	7091	870	3930	0	197198
27974	185184	2564	852	3332	0	191932
27975	8329	182935	925	2165	0	194354
27976	182016	6630	974	2286	0	191906
27977	8623	2542	780	171060	0	183005
27978	3047	179010	815	6585	0	189457
27979	176799	6948	674	3208	0	187629
27980	182461	2528	657	2594	0	188240
27981	8873	170736	984	1743	0	182336
27982	3727	176557	780	1682	0	182746
27983	172822	7455	640	1845	0	182762
27984	8557	3002	562	170751	0	182872
27985	173036	2090	582	7309	0	183017
27986	8882	1771	487	171627	0	182767
27987	3750	1579	168189	7239	0	180757
27988	3706	1481	5758	170534	0	181479
27989	167255	1618	1583	8146	0	178602
27990	7930	1406	166880	2874	0	179090
27991	4039	1131	6187	165987	0	177344
27992	3234	1198	1885	173227	0	179544
27993	2178	1202	167842	8520	0	179742
27994	161938	888	6467	3956	0	173249
27995	8125	1085	2168	165337	0	176715
27996	2920	1152	155320	7373	0	166765
27997	143949	981	6534	3747	0	155211
27998	6434	151858	2388	2978	0	163658
27999	2736	151663	1756	2527	0	158682
28000	2145	155824	1458	2312	0	161739
28001	1920	6747	146767	1954	0	157388
28002	2381	3369	5675	138899	0	150324
28003	1653	1584	139181	6304	0	148722
28004	1776	3655	5226	119717	0	130374
28005	1135	116733	1713	5459	0	125040
28006	1014	120228	1111	2060	0	124413
28007	1757	5276	947	116647	0	124627
28008	116252	1873	775	5416	0	124316
28009	5098	1297	632	118126	0	125153
28010	2083	1066	678	118427	0	122254
28011	1416	116842	726	5559	0	124543
28012	115107	4606	556	2815	0	123084
28013	4764	117684	607	1909	0	124964
28014	2388	5125	571	117932	0	126016
28015	1997	1981	630	118272	0	122880
28016	1420	117336	724	6091	0	125571
28017	1802	4854	732	119652	0	127040
28018	117828	2024	503	6750	0	127105
28019	6023	2173	499	118659	0	127354
28020	3248	2107	593	118501	0	124449
28021	2612	116748	897	5940	0	126197
28022	2606	4990	1172	119187	0	127955
28023	113987	2244	934	6605	0	123770
28024	117228	2142	655	3462	0	123487
28025	119008	2025	711	2809	0	124553
28026	7095	1658	793	115611	0	125157
28027	3366	1728	112531	6114	0	123739
28028	2918	1576	113923	3124	0	121541
28029	3015	1651	4887	115153	0	124706
28030	115893	2132	1609	6140	0	125774
28031	6084	1973	1012	116743	0	125812
28032	118163	1896	920	6443	0	127422
28033	7101	1697	814	118194	0	127806
28034	4120	1532	777	122454	0	128883
28035	120086	1835	785	6652	0	129358
28036	6455	1851	115692	3114	0	127112
28037	116357	1659	4396	2978	0	125390
28038	6663	1722	116008	2389	0	126782
28039	3988	1368	4700	115503	0	125559
28040	116632	1308	1709	6075	0	125724
28041	6249	1551	116320	2703	0	126823
28042	3045	1773	116658	2149	0	123625
28043	114956	1439	5393	2481	0	124269
28044	6379	1214	116182	2485	0	126260
28045	2969	114461	5101	2674	0	125205
28046	2711	4426	2230	119459	0	128826
28047	123734	1572	2053	7025	0	134384
28048	5624	1268	124516	3370	0	134778
28049	124334	989	5320	3323	0	133966
28050	130115	968	2668	2847	0	136598
28051	129657	1026	2121	3057	0	135861
28052	130646	1073	1785	3092	0	136596
28053	6671	1857	1784	123909	0	134221
28054	3093	124051	1625	5731	0	134500
28055	121420	4288	1637	3473	0	130818
28056	4788	1413	107631	2275	0	116107
28057	1455	79916	2353	1097	0	84821
28058	67221	1056	1021	802	0	70100
28059	959	61390	441	361	0	63151
28060	465	64716	265	380	0	65826
28061	2166	911	1084	62121	0	66282
28062	552	264	278	63495	0	64589
28063	413	159	160	63462	0	64194
28064	65241	127	154	1207	0	66729
28065	68625	102	141	676	0	69544
28066	1433	104	134	71236	0	72907
28067	783	136	159	78314	0	79392
28068	401	214	83020	1690	0	85325
28069	80274	112	1537	975	0	82898
28070	85612	122	555	637	0	86926
28071	2235	146	286	84995	0	87662
28072	1092	100	201	86584	0	87977
28073	523	218	85431	2115	0	88287
28074	750	126	1660	84629	0	87165
28075	374	130	88543	2021	0	91068
28076	375	88037	1855	927	0	91194
28077	359	1545	89904	564	0	92372
28078	809	507	1853	86158	0	89327
28079	346	296	91565	1760	0	93967
28080	331	278	87315	768	0	88692
28081	88905	185	2182	743	0	92015
28082	2077	204	865	94506	0	97652
28083	712	176	95799	1842	0	98529
28084	87965	115	1986	1103	0	91169
28085	1969	198	96053	558	0	98778
28086	764	201	104522	454	0	105941
28087	445	107649	2362	567	0	111023
28088	743	1558	901	106826	0	110028
28089	363	538	107564	1731	0	110196
28090	417	400	104133	631	0	105581
28091	630	185	2206	105393	0	108414
28092	631	136	961	105658	0	107386
28093	302	108330	694	2008	0	111334
28094	594	1620	471	109586	0	112271
28095	111305	481	398	2498	0	114682
28096	110789	282	406	1398	0	112875
28097	113076	179	448	1094	0	114797
28098	2647	168	461	111363	0	114639
28099	977	114332	586	2001	0	117896
28100	114156	1640	491	1383	0	117670
28101	1999	115080	532	706	0	118317
28102	844	113860	501	687	0	115892
28103	524	116081	552	627	0	117784
28104	116518	1999	548	996	0	120061
28105	2147	712	533	115234	0	118626
28106	985	492	504	115344	0	117325
28107	467	116649	566	2151	0	119833
28108	114123	1801	509	1410	0	117843
28109	1935	762	114917	626	0	118240
28110	1035	449	1997	114753	0	118234
28111	115463	344	873	2389	0	119069
28112	1906	120687	739	928	0	124260
28113	126102	1774	532	1365	0	129773
28114	2401	665	487	129304	0	132857
28115	885	132915	567	1915	0	136282
28116	745	1985	130623	735	0	134088
28117	129342	723	1962	1020	0	133047
28118	2197	544	818	134926	0	138485
28119	136446	474	601	2571	0	140092
28120	2291	484	471	135996	0	139242
28121	939	135576	567	2200	0	139282
28122	794	1802	138815	998	0	142409
28123	670	811	138101	907	0	140489
28124	861	906	2097	139731	0	143595
28125	142785	418	975	2668	0	146846
28126	143156	364	562	1439	0	145521
28127	2590	321	386	142162	0	145459
28128	1491	339	374	142901	0	145105
28129	144647	397	396	2896	0	148336
28130	2341	426	435	145697	0	148899
28131	145885	397	469	2998	0	149749
28132	2251	145500	532	1105	0	149388
28133	143552	1911	426	1569	0	147458
28134	2407	925	147531	857	0	151720
28135	1474	604	2068	146737	0	150883
28136	1299	483	971	149642	0	152395
28137	1104	369	837	150658	0	152968
28138	895	146659	708	2931	0	151193
28139	1154	132412	809	1679	0	136054
28140	886	2164	714	149808	0	153572
28141	646	959	149934	2656	0	154195
28142	1010	653	2299	147629	0	151591
28143	987	523	1161	151894	0	154565
28144	943	696	854	154071	0	156564
28145	148644	592	801	3536	0	153573
28146	2108	145882	873	1564	0	150427
28147	1066	147718	941	1137	0	150862
28148	1158	2448	860	145170	0	149636
28149	1134	919	792	147717	0	150562
28150	1207	632	662	146011	0	148512
28151	1086	537	640	148340	0	150603
28152	145299	532	764	3603	0	150198
28153	2080	146517	901	1553	0	151051
28154	147308	2043	802	1837	0	151990
28155	150605	939	816	1678	0	154038
28156	2657	785	634	149636	0	153712
28157	1458	581	471	151573	0	154083
28158	150142	427	543	3705	0	154817
28159	150084	506	468	2228	0	153286
28160	2936	587	256	147840	0	151619
28161	1755	646	156	148682	0	151239
28162	1268	677	148099	2787	0	152831
28163	1137	144360	1645	1643	0	148785
28164	1061	150042	568	1179	0	152850
28165	143644	1582	358	1530	0	147114
28166	1836	710	146970	826	0	150342
28167	796	549	135026	565	0	136936
28168	122372	325	1211	1041	0	124949
28169	131748	174	535	946	0	133403
28170	881	144384	261	385	0	145911
28171	407	149944	200	371	0	150922
28172	528	768	89	152248	0	153633
28173	157200	312	101	1828	0	159441
28174	157357	200	88	1328	0	158973
28175	158324	147	120	1208	0	159799
28176	1195	184	109	157770	0	159258
28177	652	203	86	159412	0	160353
28178	360	298	157762	965	0	159385
28179	462	316	147045	529	0	148352
28180	319	252	157046	370	0	157987
28181	634	1168	951	154584	0	157337
28182	154258	76	324	1555	0	156213
28183	812	179	159839	311	0	161141
28184	652	114	672	157386	0	158824
28185	246	163079	307	819	0	164451
28186	383	651	174	159591	0	160799
28187	485	210	135	159883	0	160713
28188	264	255	167702	1118	0	169339
28189	642	105	1127	163314	0	165188
28190	176814	77	353	2313	0	179557
28191	1962	229	184384	486	0	187061
28192	1182	131	1929	182430	0	185672
28193	474	229	190119	1989	0	192811
28194	304	190068	2433	819	0	193624
28195	360	2162	191911	543	0	194976
28196	1148	790	2572	179502	0	184012
28197	676	454	1013	192979	0	195122
28198	266	441	199591	2959	0	203257
28199	894	281	2597	192186	0	195958
28200	917	278	1045	191137	0	193377
28201	253	194561	760	3414	0	198988
28202	325	2338	196905	1508	0	201076
28203	1023	809	2646	192857	0	197335
28204	829	491	1091	198407	0	200818
28205	286	199491	868	3441	0	204086
28206	676	2526	550	203045	0	206797
28207	202274	938	598	4060	0	207870
28208	2976	613	499	203565	0	207653
28209	927	526	204939	3602	0	209994
28210	197546	357	2991	2699	0	203593
28211	216684	298	1218	2264	0	220464
28212	4382	425	217765	1104	0	223676
28213	203831	278	3792	2118	0	210019
28214	4048	215247	1720	1049	0	222064
28215	2394	3571	1062	216955	0	223982
28216	1905	1410	841	238733	0	242889
28217	1762	848	738	234654	0	238002
28218	1562	602	642	241457	0	244263
28219	1496	493	572	242784	0	245345
28220	238505	364	574	8496	0	247939
28221	5167	477	235977	3555	0	245176
28222	223276	334	4976	3411	0	231997
28223	5729	524	232795	2091	0	241139
28224	3190	368	5632	230624	0	239814
28225	232486	389	2362	6704	0	241941
28226	6233	485	1604	229214	0	237536
28227	2496	233372	1367	6225	0	243460
28228	239142	4726	1165	4046	0	249079
28229	6573	1665	1018	247483	0	256739
28230	2648	1296	231925	6880	0	242749
28231	227583	717	4782	4483	0	237565
28232	5876	250690	2132	2814	0	261512
28233	2862	5261	255871	2147	0	266141
28234	2877	2040	5917	249715	0	260549
28235	2889	1282	2684	241983	0	248838
28236	1562	250931	1824	7712	0	262029
28237	1509	5611	252620	3806	0	263546
28238	2232	2149	5857	249126	0	259364
28239	1344	1549	259096	7586	0	269575
28240	2091	1086	6484	254879	0	264540
28241	1990	1013	2862	258423	0	264288
28242	1425	979	255967	8908	0	267279
28243	2270	723	6519	253403	0	262915
28244	4408	1330	4263	212005	0	222006
28245	2283	764	2358	268572	0	273977
28246	2178	799	2098	269928	0	275003
28247	258350	650	2035	11900	0	272935
28248	6936	848	256491	6029	0	270304
28249	261140	850	7027	5457	0	274474
28250	8629	974	3439	274514	0	287556
28251	4482	831	2669	280535	0	288517
28252	3419	886	2267	277852	0	284424
28253	2065	274103	2444	11443	0	290055
28254	276304	6788	1899	7147	0	292138
28255	8167	2855	1924	281476	0	294422
28256	3299	281613	2256	10044	0	297212
28257	2952	6909	1819	288232	0	299912
28258	286046	2842	1823	11739	0	302450
28259	286160	2089	1827	7367	0	297443
28260	284634	1580	2058	6224	0	294496
28261	9850	284283	2121	4779	0	301033
28262	4512	7239	285113	4598	0	301462
28263	279856	3074	7534	5395	0	295859
28264	290009	1913	3403	5719	0	301044
28265	9840	291521	2568	4636	0	308565
28266	289103	7355	2035	5258	0	303751
28267	284247	3244	1865	5404	0	294760
28268	292487	2065	1677	5180	0	301409
28269	11236	296281	1988	4385	0	313890
28270	6714	7473	1845	292178	0	308210
28271	292724	3167	1737	10712	0	308340
28272	302709	2260	1654	6327	0	312950
28273	293381	1863	1423	5821	0	302488
28274	300838	1783	1309	5089	0	309019
28275	12995	1962	1347	292481	0	308785
28276	6778	1895	289863	10040	0	308576
28277	6348	1564	7521	286104	0	301537
28278	4738	292338	3235	10269	0	310580
28279	5105	7786	2179	302282	0	317352
28280	4434	3389	302395	10811	0	321029
28281	300865	2108	8145	6530	0	317648
28282	11710	1936	3469	308458	0	325573
28283	305653	2041	2409	11356	0	321459
28284	308717	1875	2057	7169	0	319818
28285	13708	1640	1950	308353	0	325651
28286	7464	1651	308571	10656	0	328342
28287	6375	1893	291389	5602	0	305259
28288	282661	1747	9317	5188	0	298913
28289	10703	291727	4285	4094	0	310809
28290	5542	283759	2577	3437	0	295315
28291	4501	283158	2117	3432	0	293208
28292	4020	293766	1962	3141	0	302889
28293	280182	8671	2995	4203	0	296051
28294	283411	3585	1844	3515	0	292355
28295	281545	2428	1342	3377	0	288692
28296	282964	2295	1223	3445	0	289927
28297	11379	2165	1280	271957	0	286781
28298	5986	268939	1431	7339	0	283695
28299	268271	6529	1411	4693	0	280904
28300	9042	3124	267269	2871	0	282306
28301	5252	266886	6337	2985	0	281460
28302	4609	6541	267718	2665	0	281533
28303	261649	3009	6800	3212	0	274670
28304	271326	2371	2911	3334	0	279942
28305	273050	2384	1989	3100	0	280523
28306	10986	2065	1725	267574	0	282350
28307	6181	1806	269115	6877	0	283979
28308	4978	268611	6126	3609	0	283324
28309	261013	6064	2853	3691	0	273621
28310	8536	261067	2083	2723	0	274409
28311	4746	250109	1292	2435	0	258582
28312	3992	249414	1195	2258	0	256859
28313	3829	252099	1333	2134	0	259395
28314	3536	6508	239085	1716	0	250845
28315	3269	242450	5098	1869	0	252686
28316	220900	4528	2401	2037	0	229866
28317	5538	2141	1058	220910	0	229647
28318	3511	1647	916	224247	0	230321
28319	222601	1393	907	5357	0	230258
28320	4972	220814	1110	2427	0	229323
28321	3102	4162	225920	1511	0	234695
28322	3406	2223	3593	221138	0	230360
28323	3344	1625	1541	227093	0	233603
28324	3033	1651	1146	229867	0	235697
28325	2387	1805	227897	4735	0	236824
28326	2322	1912	225160	2181	0	231575
28327	3001	1671	4363	226009	0	235044
28328	2492	1602	226895	3767	0	234756
28329	2478	1712	211240	1769	0	217199
28330	192796	1449	4353	2422	0	201020
28331	4460	213339	2075	1631	0	221505
28332	2435	206200	1170	1378	0	211183
28333	2520	211642	1090	1310	0	216562
28334	2767	4452	1106	202142	0	210467
28335	2059	215513	1278	2892	0	221742
28336	216816	3620	1119	2796	0	224351
28337	4240	2036	220433	1529	0	228238
28338	221761	1472	3677	2155	0	229065
28339	4991	1325	1850	224669	0	232835
28340	2978	1282	1525	225497	0	231282
28341	1841	235312	1379	4678	0	243210
28342	234175	4330	1416	3032	0	242953
28343	235525	2036	1676	2428	0	241665
28344	6359	251135	1257	1456	0	260207
28345	3665	5511	851	242625	0	252652
28346	2003	2542	247585	4797	0	256927
28347	7061	1902	241224	2160	0	252347
28348	1530	252154	6191	1717	0	261592
28349	242727	5700	2595	2522	0	253544
28350	5707	2183	249197	768	0	257855
28351	3737	1295	5102	242167	0	252301
28352	247908	1058	2181	5725	0	256872
28353	251248	1022	1281	3220	0	256771
28354	6727	295316	1318	1567	0	304928
28355	2849	311004	1325	1032	0	316210
28356	307582	9065	1013	1899	0	319559
28357	8444	3747	307799	748	0	320738
28358	303537	2204	7499	1827	0	315067
28359	312814	1560	2757	1889	0	319020
28360	11569	1419	1863	305346	0	320197
28361	4263	1540	313296	7310	0	326409
28362	2901	1504	310060	2456	0	316921
28363	297593	1000	9974	2629	0	311196
28364	9125	1249	313180	1085	0	324639
28365	293078	973	9145	2287	0	305483
28366	304086	991	3377	2257	0	310711
28367	10421	304037	2347	1091	0	317896
28368	9906	8354	296209	741	0	315210
28369	3240	297422	8395	801	0	309858
28370	290051	8444	3784	1850	0	304129
28371	9213	3399	290172	712	0	303496
28372	6042	2065	8186	273480	0	289773
28373	3248	1427	286994	7391	0	299060
28374	2878	1203	288082	2689	0	294852
28375	2426	1156	288560	1413	0	293555
28376	2574	1100	285870	1025	0	290569
28377	2086	274076	11737	1027	0	288926
28378	2595	7431	274505	819	0	285350
28379	2279	268853	9336	956	0	281424
28380	2129	8362	265291	750	0	276532
28381	256424	3217	9566	1452	0	270659
28382	9291	2346	4237	240966	0	256840
28383	4043	263847	3232	5630	0	276752
28384	257315	7495	2929	3253	0	270992
28385	259559	3322	2799	2685	0	268365
28386	240941	2472	3113	2753	0	249279
28387	256057	1666	3201	1886	0	262810
28388	10398	254016	3299	1261	0	268974
28389	239745	7776	2959	2578	0	253058
28390	254660	3797	2813	2009	0	263279
28391	10323	245736	3015	1643	0	260717
28392	5244	8671	237989	1040	0	252944
28393	5119	3884	8677	228001	0	245681
28394	3741	244697	4605	6481	0	259524
28395	3379	8543	246256	2867	0	261045
28396	3622	4357	247934	1887	0	257800
28397	3783	240863	11116	1305	0	257067
28398	4008	245950	5556	1196	0	256710
28399	3939	255509	3995	1391	0	264834
28400	4239	253632	3224	1262	0	262357
28401	249203	12029	3301	1894	0	266427
28402	253185	6027	3170	1948	0	264330
28403	12915	4072	256380	1310	0	274677
28404	6848	3689	261216	1092	0	272845
28405	5965	3147	12584	248496	0	270192
28406	5263	3204	6518	256576	0	271561
28407	5210	3418	4589	261999	0	275216
28408	255152	3259	4787	11376	0	274574
28409	10871	254497	4673	4914	0	274955
28410	6393	267142	4354	2738	0	280627
28411	5239	274839	4243	2127	0	286448
28412	261843	13733	4046	2506	0	282128
28413	269701	7197	4176	2326	0	283400
28414	15297	4923	3973	260874	0	285067
28415	269933	3907	4794	9518	0	288152
28416	274859	3735	4642	4255	0	287491
28417	15815	3872	4632	267047	0	291366
28418	269857	3943	4361	11066	0	289227
28419	13694	266272	5170	4949	0	290085
28420	8517	10804	5500	263277	0	288098
28421	7387	5830	262013	9679	0	284909
28422	6042	261462	13061	4440	0	285005
28423	6326	12681	264869	3357	0	287233
28424	7399	7027	13600	241822	0	269848
28425	6314	265491	8468	8665	0	288938
28426	8114	11461	6889	259280	0	285744
28427	7040	6564	6490	267147	0	287241
28428	6967	5200	262210	12823	0	287200
28429	6478	4504	278380	5745	0	295107
28430	6472	4332	15836	269108	0	295748
28431	6995	4310	9601	257958	0	278864
28432	5517	274405	7930	11912	0	299764
28433	259960	12402	6243	6512	0	285117
28434	13058	267162	6863	4224	0	291307
28435	7285	275185	5534	3571	0	291575
28436	5521	14975	260392	3217	0	284105
28437	4080	259381	12847	3552	0	279860
28438	5489	13520	8041	231054	0	258104
28439	4296	253006	6369	9866	0	273537
28440	4963	12514	4970	236893	0	259340
28441	3432	245334	5896	10374	0	265036
28442	239477	11995	5043	5722	0	262237
28443	11074	244656	5442	3765	0	264937
28444	5980	11027	4033	209824	0	230864
28445	4363	226990	3541	7757	0	242651
28446	222882	11092	3585	3797	0	241356
28447	222358	6894	2205	3375	0	234832
28448	11446	220310	3085	2471	0	237312
28449	211630	9765	2109	2361	0	225865
28450	10752	7302	2330	201521	0	221905
28451	5045	4713	204273	7908	0	221939
28452	4804	3921	207131	3746	0	219602
28453	4027	206113	8991	3182	0	222313
28454	147990	4967	3283	1847	0	158087
28455	147374	2192	1358	1647	0	152571
28456	5172	1775	145041	1225	0	153213
28457	2369	1564	143389	1160	0	148482
28458	137245	1432	4558	1590	0	144825
28459	144024	1444	1833	1504	0	148805
28460	4921	1457	140098	1091	0	147567
28461	128972	1447	3861	1388	0	135668
28462	4234	132920	1803	1108	0	140065
28463	1776	139697	1242	1074	0	143789
28464	1881	4834	1189	133568	0	141472
28465	1551	2439	1072	136831	0	141893
28466	136338	1666	1038	4636	0	143678
28467	135469	1551	1083	2282	0	140385
28468	136785	1454	1035	1775	0	141049
28469	5038	1400	989	134538	0	141965
28470	2543	1386	898	135287	0	140114
28471	1708	129305	992	4522	0	136527
28472	1524	132480	899	2081	0	136984
28473	1564	138268	878	1526	0	142236
28474	1798	4862	844	129221	0	136725
28475	1579	136220	826	3541	0	142166
28476	1445	4528	131724	1584	0	139281
28477	123869	2294	3208	1781	0	131152
28478	4054	2024	133070	1279	0	140427
28479	2015	1760	132693	1177	0	137645
28480	126793	1611	4054	1471	0	133929
28481	4058	134273	1646	1173	0	141150
28482	134971	4056	1120	1438	0	141585
28483	135687	2116	1017	1563	0	140383
28484	4712	1786	134100	1255	0	141853
28485	2425	1754	136095	1095	0	141369
28486	1970	138733	4262	1080	0	146045
28487	1792	4389	140044	1031	0	147256
28488	2178	2126	4037	138917	0	147258
28489	2772	2073	2200	120259	0	127304
28490	1635	140353	1743	4091	0	147822
28491	1804	146278	1481	1768	0	151331
28492	143080	5248	1252	1642	0	151222
28493	149588	2722	1260	1498	0	155068
28494	5347	2118	1273	148385	0	157123
28495	2842	1909	1300	152285	0	158336
28496	148538	1563	1361	4759	0	156221
28497	149614	1652	1265	2379	0	154910
28498	4776	152460	1335	1757	0	160328
28499	144484	3789	1085	1358	0	150716
28500	4359	140045	976	1018	0	146398
28501	2174	146485	967	984	0	150610
28502	144897	4211	964	1374	0	151446
28503	144661	2277	862	1282	0	149082
28504	4795	1743	699	143598	0	150835
28505	144040	1473	718	3260	0	149491
28506	4434	1421	142947	1192	0	149994
28507	2561	144668	2719	1228	0	151176
28508	142366	3059	1112	1669	0	148206
28509	3741	1353	145976	1252	0	152322
28510	2023	1741	2771	133297	0	139832
28511	1595	136729	1271	2208	0	141803
28512	1773	141676	917	928	0	145294
28513	140672	2997	976	1065	0	145710
28514	3251	1440	137802	672	0	143165
28515	131497	897	2515	636	0	135545
28516	3468	719	1177	134721	0	140085
28517	1859	719	135011	1907	0	139496
28518	129760	601	2484	1478	0	134323
28519	2839	140893	1116	664	0	145512
28520	1218	147790	966	527	0	150501
28521	148868	2734	821	921	0	153344
28522	149182	1259	523	1126	0	152090
28523	152985	895	446	1230	0	155556
28524	3454	781	411	150036	0	154682
28525	2213	640	450	151282	0	154585
28526	1548	605	150297	2165	0	154615
28527	1367	592	144371	1202	0	147532
28528	1011	149954	2030	1158	0	154153
28529	941	1656	827	139777	0	143201
28530	138797	461	487	1431	0	141176
28531	1188	138923	294	633	0	141038
28532	700	1215	181	139882	0	141978
28533	139592	557	277	1469	0	141895
28534	1230	139879	283	553	0	141945
28535	651	147741	251	420	0	149063
28536	701	1304	141683	317	0	144005
28537	138280	533	1096	741	0	140650
28538	145317	415	438	729	0	146899
28539	1318	435	143617	339	0	145709
28540	132505	264	987	653	0	134409
28541	1202	369	144435	169	0	146175
28542	486	142443	958	189	0	144076
28543	788	1169	534	141405	0	143896
28544	140387	367	337	1198	0	142289
28545	967	140019	284	379	0	141649
28546	437	141038	260	277	0	142012
28547	135581	799	186	606	0	137172
28548	840	458	144266	121	0	145685
28549	136677	285	684	822	0	138468
28550	776	148552	344	234	0	149906
28551	470	749	142695	93	0	144007
28552	138443	313	644	529	0	139929
28553	145732	208	254	515	0	146709
28554	1072	179	178	144175	0	145604
28555	605	168	186	146475	0	147434
28556	292	147453	184	703	0	148632
28557	352	757	147763	302	0	149174
28558	699	299	694	147051	0	148743
28559	343	334	158029	988	0	159694
28560	329	334	156540	325	0	157528
28561	607	151	1350	164476	0	166584
28562	313	229	170721	1572	0	172835
28563	396	255	166894	488	0	168033
28564	809	209	2126	163466	0	166610
28565	256	277	171012	1659	0	173204
28566	154820	149	2081	1206	0	158256
28567	1729	166203	812	547	0	169291
28568	632	1658	171967	334	0	174591
28569	567	655	181286	292	0	182800
28570	950	474	2246	172750	0	176420
28571	188254	231	938	2329	0	191752
28572	188589	157	589	1168	0	190503
28573	187321	161	485	990	0	188957
28574	188870	163	421	836	0	190290
28575	2699	149	381	184568	0	187797
28576	1015	271	188262	1743	0	191291
28577	184111	191	1993	1367	0	187662
28578	189593	147	725	1259	0	191724
28579	191929	170	604	997	0	193700
28580	2689	263	187762	262	0	190976
28581	176031	285	1972	687	0	178975
28582	2557	244	929	194435	0	198165
28583	911	198900	867	1850	0	202528
28584	1216	1907	496	193526	0	197145
28585	648	198663	556	1917	0	201784
28586	197819	2022	495	1357	0	201693
28587	2523	738	202496	576	0	206333
28588	1548	533	2374	194116	0	198571
28589	671	199374	1141	2191	0	203377
28590	473	205917	945	988	0	208323
28591	203961	2621	756	1298	0	208636
28592	203196	946	611	1150	0	205903
28593	3154	818	196192	393	0	200557
28594	194486	408	2760	885	0	198539
28595	3695	325	1063	197588	0	202671
28596	1378	450	206389	2594	0	210811
28597	1289	565	202979	917	0	205750
28598	1668	355	3084	206882	0	211989
28599	219687	379	1313	3879	0	225258
28600	4243	271	882	218462	0	223858
28601	2322	229	846	218259	0	221656
28602	1844	251	702	218661	0	221458
28603	1046	220586	770	4353	0	226755
28604	1575	3102	604	222694	0	227975
28605	216088	1084	674	4823	0	222669
28606	3647	219110	747	1831	0	225335
28607	2200	3388	714	221348	0	227650
28608	218692	1306	613	4844	0	225455
28609	3829	214962	740	2002	0	221533
28610	1560	220573	902	1366	0	224401
28611	1813	4542	735	219124	0	226214
28612	213970	1886	581	5046	0	221483
28613	4357	1201	213936	1950	0	221444
28614	2059	1028	210472	1488	0	215047
28615	210214	783	4904	2077	0	217978
28616	223477	736	2074	1948	0	228235
28617	5653	227265	1415	1057	0	235390
28618	3357	4310	971	219196	0	227834
28619	1967	1788	221633	4355	0	229743
28620	1584	1330	215503	1986	0	220403
28621	1395	909	231666	1536	0	235506
28622	1317	225730	6935	1305	0	235287
28623	1206	232257	2924	1241	0	237628
28624	226436	5940	1695	2101	0	236172
28625	5625	2393	229616	1294	0	238928
28626	221573	1433	5484	1942	0	230432
28627	229174	938	2552	2092	0	234756
28628	7088	1052	230847	1222	0	240209
28629	3203	236195	5698	1256	0	246352
28630	3700	5708	2303	226675	0	238386
28631	1953	2475	240677	5520	0	250625
28632	1871	1850	231588	2401	0	237710
28633	221214	1318	7001	2687	0	232220
28634	5928	235985	3249	1408	0	246570
28635	3545	5920	2070	225537	0	237072
28636	2728	2670	1513	226440	0	233351
28637	1716	228664	1612	6712	0	238704
28638	1781	234452	1619	2876	0	240728
28639	1789	239462	1706	1869	0	244826
28640	2570	7724	1364	241420	0	253078
28641	248374	3149	1183	7364	0	260070
28642	8013	2080	1376	251131	0	262600
28643	2969	1988	251193	7698	0	263848
28644	2143	1703	250992	3286	0	258124
28645	2627	1535	8698	250676	0	263536
28646	1687	1667	255181	7275	0	265810
28647	1848	253368	8093	3322	0	266631
28648	2694	7316	3290	261612	0	274912
28649	273400	2919	2381	8998	0	287698
28650	274163	2088	1922	4627	0	282800
28651	9767	278264	1998	2796	0	292825
28652	274715	8975	1784	3168	0	288642
28653	282846	3651	1581	3044	0	291122
28654	285305	2345	1669	3145	0	292464
28655	11852	2399	256102	2138	0	272491
28656	264722	1724	7758	3079	0	277283
28657	10016	269605	3508	2233	0	285362
28658	4325	8160	268479	1667	0	282631
28659	3267	3256	268673	1860	0	277056
28660	2527	263600	10110	1910	0	278147
28661	256305	8417	4411	2265	0	271398
28662	9627	3307	2621	244568	0	260123
28663	3969	250477	2036	7091	0	263573
28664	252695	8055	1731	3727	0	266208
28665	9691	3543	1748	252699	0	267681
28666	255369	2368	1695	9194	0	268626
28667	10465	1951	1715	256429	0	270560
28668	4579	1980	251773	8856	0	267188
28669	3254	2029	246043	3820	0	255146
28670	2939	2156	249038	2566	0	256699
28671	4003	2219	10584	234395	0	251201
28672	3569	2102	4559	248055	0	258285
28673	2891	2042	245498	9932	0	260363
28674	2802	242804	9092	4489	0	259187
28675	245273	8299	4118	3508	0	261198
28676	245709	3563	3185	3126	0	255583
28677	10904	246567	2959	2335	0	262765
28678	6584	8970	2635	246293	0	264482
28679	3976	3826	253274	8913	0	269989
28680	246170	2685	9689	4629	0	263173
28681	10327	2363	254578	2988	0	270256
28682	5075	2124	241040	2203	0	250442
28683	3867	2144	246924	1954	0	254889
28684	232703	2076	12201	2447	0	249427
28685	10075	2131	240603	2124	0	254933
28686	4840	228242	10653	2155	0	245890
28687	3914	239104	5320	1892	0	250230
28688	4522	9994	4044	224670	0	243230
28689	4292	4242	3359	232264	0	244157
28690	3239	2905	229841	9775	0	245760
28691	219378	2441	9421	4906	0	236146
28692	234157	2326	4841	3417	0	244741
28693	11688	2177	3980	229061	0	246906
28694	228401	1954	3551	9045	0	242951
28695	9938	227108	3534	4144	0	244724
28696	222084	8215	3072	3564	0	236935
28697	9923	214983	3311	2891	0	231108
28698	4751	218964	2706	2568	0	228989
28699	208010	8801	2709	3009	0	222529
28700	207510	3977	2567	2886	0	216940
28701	215588	2727	2584	2530	0	223429
28702	218235	2334	2704	2635	0	225908
28703	11225	2239	201838	2127	0	217429
28704	202016	2009	8215	2341	0	214581
28705	10421	2089	3928	195375	0	211813
28706	5204	200646	3149	6967	0	215966
28707	201249	7138	2605	3613	0	214605
28708	9198	201703	2633	2491	0	216025
28709	203147	7752	2468	2288	0	215655
28710	9993	3329	2515	199311	0	215148
28711	5649	2929	2306	204999	0	215883
28712	4231	2626	195309	8580	0	210746
28713	4084	2365	201626	3754	0	211829
28714	3905	200486	8592	2851	0	215834
28715	192459	6984	4153	2843	0	206439
28716	8634	190246	3017	2103	0	204000
28717	4825	187452	2647	2121	0	197045
28718	4312	197246	2343	2117	0	206018
28719	4159	8325	188630	1757	0	202871
28720	3592	191803	6972	1699	0	204066
28721	175644	7567	3416	2061	0	188688
28722	178082	3485	2461	1889	0	185917
28723	8658	2758	1997	170023	0	183436
28724	4428	169634	2196	5878	0	182136
28725	3546	176109	2108	2819	0	184582
28726	3996	7314	2025	171256	0	184591
28727	3586	3814	172609	5680	0	185689
28728	3397	168402	6048	2733	0	180580
28729	3954	6832	2627	162424	0	175837
28730	157326	3559	2024	6233	0	169142
28731	159795	2837	1805	3269	0	167706
28732	7103	162078	2023	2111	0	173315
28733	162535	6263	1929	2154	0	172881
28734	165291	3131	1915	1973	0	172310
28735	8412	2568	1826	157596	0	170402
28736	4518	2145	155767	5474	0	167904
28737	3243	157548	5592	2827	0	169210
28738	3483	6729	2888	153303	0	166403
28739	2776	3390	153961	4930	0	165057
28740	2535	148000	4800	2589	0	157924
28741	136993	4995	2516	2183	0	146687
28742	139220	2810	1700	1889	0	145619
28743	6163	2176	1472	135168	0	144979
28744	3439	137710	1505	4049	0	146703
28745	2832	4439	136871	2155	0	146297
28746	3099	3149	4231	132962	0	143441
28747	2430	2312	137489	3953	0	146184
28748	1795	123235	3633	1927	0	130590
28749	2935	3279	2121	105267	0	113602
28750	104172	1495	1061	2636	0	109364
28751	2469	103914	759	1405	0	108547
28752	102214	2387	721	1330	0	106652
28753	100578	1572	652	1174	0	103976
28754	3209	103229	574	886	0	107898
28755	2312	2393	586	102365	0	107656
28756	1735	1790	491	102342	0	106358
28757	1356	99274	600	2716	0	103946
28758	1206	103074	596	1579	0	106455
28759	1350	2706	554	96676	0	101286
28760	1138	100264	547	1947	0	103896
28761	99685	2315	510	1363	0	103873
28762	98634	1369	415	1100	0	101518
28763	2810	1120	97227	693	0	101850
28764	1694	998	94799	642	0	98133
28765	92833	936	2042	956	0	96767
28766	97462	795	1068	940	0	100265
28767	2392	100861	728	705	0	104686
28768	100015	2218	613	986	0	103832
28769	99561	1268	483	935	0	102247
28770	2686	97978	397	662	0	101723
28771	99281	2113	372	878	0	102644
28772	2643	1466	364	114108	0	118581
28773	1734	1067	410	118751	0	121962
28774	993	928	125182	3167	0	130270
28775	834	120032	2640	1243	0	124749
28776	751	126556	920	705	0	128932
28777	117073	4144	1442	1663	0	124322
28778	118018	941	531	1091	0	120581
28779	114477	613	332	1218	0	116640
28780	120873	426	331	894	0	122524
28781	3017	635	115015	437	0	119104
28782	1105	643	119974	269	0	121991
28783	818	122007	2610	331	0	125766
28784	1310	2610	807	119281	0	124008
28785	1282	920	461	117920	0	120583
28786	854	123788	379	2380	0	127401
28787	1281	2523	417	121165	0	125386
28788	120745	872	503	2826	0	124946
28789	2661	121769	518	813	0	125761
28790	1157	2655	123767	538	0	128117
28791	894	127007	2377	631	0	130909
28792	125779	2728	770	980	0	130257
28793	2701	1125	125292	656	0	129774
28794	122848	776	2591	1002	0	127217
28795	128005	702	831	942	0	130480
28796	3109	772	126533	498	0	130912
28797	1159	809	125368	434	0	127770
28798	938	745	124255	450	0	126388
28799	114496	613	3037	830	0	118976
28800	2837	598	124861	360	0	128656
28801	1260	123083	2686	383	0	127412
28802	122034	2393	1071	734	0	126232
28803	2732	841	123106	218	0	126897
28804	114987	591	2906	570	0	119054
28805	2939	553	121711	214	0	125417
28806	1335	431	125573	211	0	127550
28807	1037	126661	3208	288	0	131194
28808	1002	2458	128105	195	0	131760
28809	997	871	125916	187	0	127971
28810	983	113615	3549	319	0	118466
28811	121455	2402	1538	583	0	125978
28812	2751	940	125084	175	0	128950
28813	1646	756	2956	113713	0	119071
28814	842	125426	1414	1946	0	129628
28815	125305	2506	1169	1038	0	130018
28816	123982	1041	1142	924	0	127089
28817	3131	849	125208	378	0	129566
28818	1352	120258	3091	349	0	125050
28819	947	125925	1603	389	0	128864
28820	1254	3315	1148	119663	0	125380
28821	1148	117014	1083	2381	0	121626
28822	2093	3141	910	110682	0	116826
28823	1561	1295	950	123820	0	127626
28824	1218	125768	1072	2796	0	130854
28825	1402	3117	1031	122937	0	128487
28826	1078	125291	1011	2750	0	130130
28827	1072	3371	123369	1140	0	128952
28828	1350	1591	2897	120944	0	126782
28829	1252	1330	1290	121737	0	125609
28830	937	122622	1091	3131	0	127781
28831	1055	127135	975	1510	0	130675
28832	1277	3849	822	119947	0	125895
28833	891	124649	1044	2802	0	129386
28834	122111	3535	973	1751	0	128370
28835	3285	1710	987	122051	0	128033
28836	1334	124351	1135	3077	0	129897
28837	120799	3414	953	1673	0	126839
28838	3074	121948	1096	1104	0	127222
28839	1447	3600	120066	1064	0	126177
28840	1582	1792	3240	118042	0	124656
28841	119803	1465	1625	3445	0	126338
28842	3353	1289	121851	1376	0	127869
28843	1912	1422	3325	115410	0	122069
28844	1521	120147	1594	2702	0	125964
28845	1479	3493	117797	1090	0	123859
28846	1332	120707	3527	952	0	126518
28847	112938	3278	1900	1145	0	119261
28848	117949	1594	1809	1062	0	122414
28849	3609	118024	1707	866	0	124206
28850	117119	3329	1661	1022	0	123131
28851	3348	1681	116181	700	0	121910
28852	1772	1423	3745	112195	0	119135
28853	1677	1449	1942	111156	0	116224
28854	1536	115832	1701	2778	0	121847
28855	121850	3286	1708	1660	0	128504
28856	126291	1635	1361	1454	0	130741
28857	3500	1670	125485	576	0	131231
28858	124452	1253	3496	1019	0	130220
28859	128904	1284	1683	1092	0	132963
28860	129817	1209	1521	995	0	133542
28861	4168	1273	1261	125090	0	131792
28862	2114	1403	1231	125170	0	129918
28863	1622	127150	1220	2901	0	132893
28864	122587	3165	1267	1610	0	128629
28865	123368	1464	1039	1531	0	127402
28866	3620	123573	1071	968	0	129232
28867	2009	3348	916	118246	0	124519
28868	1388	119336	802	2786	0	124312
28869	1886	125088	807	1306	0	129087
28870	121619	3262	1033	1584	0	127498
28871	3176	1678	119644	1130	0	125628
28872	1006	859	100969	557	0	103391
28873	746	101315	1656	557	0	104274
28874	90806	1200	983	720	0	93709
28875	1134	631	91403	277	0	93445
28876	512	85989	1042	400	0	87943
28877	84198	833	377	508	0	85916
28878	828	367	83521	179	0	84895
28879	508	311	758	81253	0	82830
28880	88368	215	249	1182	0	90014
28881	1116	251	88006	378	0	89751
28882	439	290	90747	270	0	91746
28883	325	283	94321	182	0	95111
28884	293	263	94586	161	0	95303
28885	89558	286	1460	473	0	91777
28886	98947	139	523	472	0	100081
28887	1280	100131	302	228	0	101941
28888	750	1216	158	102693	0	104817
28889	804	348	164	105772	0	107088
28890	218	103438	212	1647	0	105515
28891	502	1602	126	104024	0	106254
28892	202	107358	243	1625	0	109428
28893	168	110326	212	635	0	111341
28894	547	2118	147	107743	0	110555
28895	211	854	109427	1757	0	112249
28896	173	109526	1832	634	0	112165
28897	470	1869	627	110082	0	113048
28898	110646	707	403	2211	0	113967
28899	1935	499	106612	4018	0	113064
28900	106426	353	1855	829	0	109463
28901	112425	314	689	700	0	114128
28902	2809	329	414	114587	0	118139
28903	979	379	120490	2234	0	124082
28904	657	361	120564	776	0	122358
28905	388	127592	3090	524	0	131594
28906	896	2760	1083	123389	0	128128
28907	349	992	126736	2576	0	130653
28908	338	631	127083	957	0	129009
28909	298	129309	3498	681	0	133786
28910	128269	2819	1396	874	0	133358
28911	131483	996	850	758	0	134087
28912	4020	586	684	136020	0	141310
28913	1540	474	141831	3267	0	147112
28914	1051	478	141629	1269	0	144427
28915	681	147130	4508	986	0	153305
28916	599	3386	149327	601	0	153913
28917	493	1384	149353	457	0	151687
28918	1209	1249	5073	138760	0	146291
28919	375	656	149683	3586	0	154300
28920	141170	430	4506	1721	0	147827
28921	3808	386	2135	149177	0	155506
28922	1413	539	154957	3657	0	160566
28923	920	155119	4198	1548	0	161785
28924	1195	3485	1943	155046	0	161669
28925	649	1445	159589	3790	0	165473
28926	468	161637	4492	1763	0	168360
28927	1021	3998	2275	155709	0	163003
28928	539	165055	1655	3658	0	170907
28929	917	4449	1378	164429	0	171173
28930	1056	1762	1350	165178	0	169346
28931	465	1209	164633	5364	0	171671
28932	502	165727	4577	2489	0	173295
28933	1004	4106	2494	164820	0	172424
28934	931	1689	1644	166948	0	171212
28935	885	1165	1418	170188	0	173656
28936	428	1079	165877	5863	0	173247
28937	408	163989	4684	2893	0	171974
28938	787	4222	2251	164587	0	171847
28939	493	1904	165384	4694	0	172475
28940	383	164409	4776	2449	0	172017
28941	818	4512	2248	164134	0	171712
28942	524	2158	166808	4872	0	174362
28943	375	166694	4790	2715	0	174574
28944	818	4508	2445	163402	0	171173
28945	727	2259	1722	170302	0	175010
28946	411	1666	172714	5977	0	180768
28947	156382	1235	4831	3815	0	166263
28948	3636	172071	2463	2414	0	180584
28949	172372	4569	1806	2435	0	181182
28950	4387	2281	173545	1739	0	181952
28951	171418	1640	5021	2154	0	180233
28952	4781	1337	2571	174627	0	183316
28953	2071	1294	1885	181326	0	186576
28954	1080	1379	177549	6156	0	186164
28955	159415	1187	5074	3764	0	169440
28956	166085	1220	2550	2863	0	172718
28957	5055	165433	1939	2166	0	174593
28958	2083	173759	1769	1940	0	179551
28959	170705	5571	1515	2229	0	180020
28960	4737	2671	170834	1747	0	179989
28961	2144	178930	5074	1744	0	187892
28962	1900	4970	2530	181416	0	190816
28963	1621	2269	1982	187765	0	193637
28964	1252	1630	184651	6039	0	193572
28965	174288	1360	5204	3783	0	184635
28966	4925	1311	188257	2427	0	196920
28967	182083	1127	5968	2569	0	191747
28968	5664	1164	194939	1641	0	203408
28969	2595	195422	6067	1561	0	205645
28970	197071	5212	3045	2091	0	207419
28971	199335	2485	2166	2104	0	206090
28972	196770	1692	1986	2050	0	202498
28973	199903	1395	1852	1713	0	204863
28974	7416	1349	1687	195122	0	205574
28975	3408	1349	195473	5517	0	205747
28976	2662	1224	5555	189665	0	199106
28977	1801	194944	2929	5599	0	205273
28978	2165	4704	2211	197683	0	206763
28979	1611	2355	196741	5600	0	206307
28980	1602	1604	194931	2695	0	200832
28981	2073	1631	6323	190025	0	200052
28982	189482	1117	3500	5744	0	199843
28983	185470	1109	2300	3187	0	192066
28984	188327	1041	1760	2547	0	193675
28985	6844	1105	189188	1663	0	198800
28986	3532	1034	187176	1580	0	193322
28987	2377	184868	5972	1639	0	194856
28988	1783	191438	2970	1528	0	197719
28989	183428	4793	2763	1926	0	192910
28990	185248	2275	1681	1900	0	191104
28991	5127	191766	1363	1563	0	199819
28992	188399	3808	1323	1879	0	195409
28993	189100	1772	1300	1908	0	194080
28994	5137	190346	1314	1282	0	198079
28995	194102	3876	1196	1862	0	201036
28996	193158	1901	1226	1775	0	198060
28997	5355	195879	1302	1199	0	203735
28998	197748	3808	1169	1720	0	204445
28999	196477	1861	1290	1692	0	201320
29000	5572	1466	197696	1026	0	205760
29001	3169	1192	194914	890	0	200165
29002	2051	190982	4412	950	0	198395
29003	1707	195093	2121	856	0	199777
29004	191504	4118	2649	1394	0	199665
29005	185604	1684	1003	1219	0	189510
29006	184703	1023	842	1047	0	187615
29007	4474	185768	899	531	0	191672
29008	2490	2738	750	187269	0	193247
29009	1730	1433	190683	2365	0	196211
29010	2027	2062	2665	181840	0	188594
29011	1391	190318	1411	2506	0	195626
29012	185864	2060	766	1344	0	190034
29013	2534	182095	559	607	0	185795
29014	1578	2163	445	182857	0	187043
29015	191736	912	456	2685	0	195789
29016	190125	671	443	1504	0	192743
29017	3259	686	190427	492	0	194864
29018	190589	547	2239	1069	0	194444
29019	204453	524	973	948	0	206898
29020	207574	516	662	947	0	209699
29021	4300	610	532	198913	0	204355
29022	1927	201303	588	2505	0	206323
29023	1859	2718	468	204926	0	209971
29024	1239	1245	208838	2835	0	214157
29025	1048	209458	2935	1363	0	214804
29026	1409	2793	1052	206285	0	211539
29027	984	1212	208517	2488	0	213201
29028	942	206903	2739	1105	0	211689
29029	1937	2788	1098	197417	0	203240
29030	1029	1335	206927	2490	0	211781
29031	177241	858	2904	2450	0	183453
29032	3275	696	209279	708	0	213958
29033	1796	810	207124	509	0	210239
29034	1261	210502	3581	626	0	215970
29035	1643	2956	1529	209950	0	216078
29036	1569	1432	933	206240	0	210174
29037	1089	205960	935	3254	0	211238
29038	1590	3009	744	215975	0	221318
29039	216958	1329	674	4101	0	223062
29040	216087	876	737	2208	0	219908
29041	4188	936	209457	1006	0	215587
29042	209953	864	2842	1430	0	215089
29043	218508	730	1175	1644	0	222057
29044	4317	813	219893	749	0	225772
29045	2070	217759	3343	713	0	223885
29046	1397	219623	1582	723	0	223325
29047	2089	4138	1079	198359	0	205665
29048	1167	216732	858	2539	0	221296
29049	1354	3816	200721	1265	0	207156
29050	1537	1758	203321	859	0	207475
29051	1220	214039	3889	677	0	219825
29052	211301	3470	1657	1529	0	217957
29053	216093	1699	946	1434	0	220172
29054	218166	1306	693	1525	0	221690
29055	217552	990	791	1388	0	220721
29056	204860	1136	755	2034	0	208785
29057	4523	212969	823	632	0	218947
29058	2261	3630	211237	464	0	217592
29059	2451	1667	3194	207709	0	215021
29060	206338	1204	1348	3979	0	212869
29061	3816	203762	990	1407	0	209975
29062	2556	3607	745	199554	0	206462
29063	1540	1546	201263	2887	0	207236
29064	1232	193593	3426	1277	0	199528
29065	998	201459	1452	851	0	204760
29066	191187	4243	1321	1867	0	198618
29067	3086	192354	679	699	0	196818
29068	2041	2988	544	185452	0	191025
29069	184879	1222	513	3425	0	190039
29070	183253	897	499	1714	0	186363
29071	183683	811	545	1445	0	186484
29072	3778	885	180614	433	0	185710
29073	1641	182580	2663	560	0	187444
29074	185108	2892	962	1224	0	190186
29075	3590	1379	620	183009	0	188598
29076	184593	968	504	3680	0	189745
29077	3428	183283	662	1167	0	188540
29078	191433	3047	533	1526	0	196539
29079	206222	1385	520	1286	0	209413
29080	5452	1033	537	202161	0	209183
29081	2394	1068	210555	3752	0	217769
29082	2474	888	3911	212028	0	219301
29083	212035	757	1533	5345	0	219670
29084	214393	784	1008	2726	0	218911
29085	5802	210443	1004	1299	0	218548
29086	204688	4098	771	1752	0	211309
29087	5184	207189	840	1194	0	214407
29088	206222	4552	598	1687	0	213059
29089	201245	1952	673	2014	0	205884
29090	5899	1539	203587	863	0	211888
29091	2790	201620	4032	915	0	209357
29092	2704	4617	1604	201734	0	210659
29093	2398	1954	1153	205309	0	210814
29094	2246	1470	932	197718	0	202366
29095	1350	199981	1114	5626	0	208071
29096	1351	4674	198659	2589	0	207273
29097	1641	2145	201153	1527	0	206466
29098	1432	246369	5499	1306	0	254606
29099	244828	6548	2240	1949	0	255565
29100	6768	2993	245200	961	0	255922
29101	236666	2201	6451	1741	0	247059
29102	7727	242503	3066	876	0	254172
29103	3799	6603	244444	802	0	255648
29104	3909	3081	6774	237590	0	251354
29105	1848	2581	248252	6235	0	258916
29106	1791	1685	253590	2942	0	260008
29107	3177	1344	8582	227984	0	241087
29108	1799	238015	4225	5928	0	249967
29109	1750	248555	2595	2341	0	255241
29110	242337	8072	1984	3230	0	255623
29111	6964	3892	241935	1246	0	254037
29112	238974	2927	6765	1750	0	250416
29113	244631	1611	3449	1742	0	251433
29114	8582	244669	2715	959	0	256925
29115	235425	6469	1284	1299	0	244477
29116	236384	3529	1135	1230	0	242278
29117	227697	2128	1368	1513	0	232706
29118	9360	219739	1343	1262	0	231704
29119	4516	203851	1571	892	0	210830
29120	3031	218135	1346	723	0	223235
29121	215045	7756	2107	1273	0	226181
29122	216097	4056	1114	1215	0	222482
29123	8195	2727	203267	638	0	214827
29124	4744	1821	202908	528	0	210001
29125	206176	1352	6837	1006	0	215371
29126	212384	1182	3255	1172	0	217993
29127	214982	1065	2195	1216	0	219458
29128	8988	1270	1551	205603	0	217412
29129	5691	977	1088	209670	0	217426
29130	4118	1109	1081	213286	0	219594
29131	3414	1287	1002	214234	0	219937
29132	2208	1642	197998	7632	0	209480
29133	2087	1492	204100	3522	0	211201
29134	2101	1326	204067	2051	0	209545
29135	2367	1030	202338	1278	0	207013
29136	198087	993	7629	1370	0	208079
29137	6018	201866	4199	1011	0	213094
29138	3606	211099	2675	1019	0	218399
29139	207662	6396	1593	1375	0	217026
29140	6716	3544	206469	897	0	217626
29141	3794	2517	201632	1059	0	209002
29142	198595	1754	7326	1909	0	209584
29143	205873	1297	3785	1921	0	212876
29144	7434	205183	2604	1462	0	216683
29145	4942	4980	1953	205078	0	216953
29146	208986	2497	2017	4984	0	218484
29147	213994	2155	1848	2579	0	220576
29148	8614	1655	1652	207724	0	219645
29149	5052	216694	1491	4765	0	228002
29150	219317	5415	1062	2982	0	228776
29151	6728	3341	214241	2087	0	226397
29152	209340	2409	5324	2276	0	219349
29153	7136	215372	3112	1584	0	227204
29154	218811	5309	2780	1786	0	228686
29155	213188	2791	2411	2099	0	220489
29156	7866	2287	218136	1276	0	229565
29157	4979	1862	215030	1063	0	222934
29158	214774	1776	7458	1481	0	225489
29159	221844	1612	4129	1740	0	229325
29160	7781	225649	2827	916	0	237173
29161	5510	5519	2026	227373	0	240428
29162	3706	2864	227383	4911	0	238864
29163	223336	2418	6127	2639	0	234520
29164	7328	1738	3571	228499	0	241136
29165	4885	1420	2956	233230	0	242491
29166	232191	1521	2093	6953	0	242758
29167	6513	239927	1924	3860	0	252224
29168	242938	5423	1668	3134	0	253163
29169	244470	2624	1919	2157	0	251170
29170	246942	2353	1953	2036	0	253284
29171	8938	242759	1788	1396	0	254881
29172	247819	5595	1560	1656	0	256630
29173	8931	2943	1619	243746	0	257239
29174	5836	2647	1473	244346	0	254302
29175	4540	1873	244121	6822	0	257356
29176	4028	1645	239858	3401	0	248932
29177	3645	240946	6744	2347	0	253682
29178	2990	245581	3578	1734	0	253883
29179	2865	5445	230602	989	0	239901
29180	2641	234143	4573	1070	0	242427
29181	231870	5656	2742	1960	0	242228
29182	233999	2323	1475	1340	0	239137
29183	237684	1700	1013	1328	0	241725
29184	7656	1347	971	225774	0	235748
29185	4603	1161	976	233143	0	239883
29186	2940	1103	237383	5444	0	246870
29187	1880	236563	4153	3359	0	245955
29188	234925	4169	2123	2744	0	243961
29189	4842	238566	1858	949	0	246215
29190	239062	4928	1221	1274	0	246485
29191	241066	2414	825	1334	0	245639
29192	7194	1748	939	233425	0	243306
29193	4750	1102	1208	233524	0	240584
29194	3484	1133	814	242758	0	248189
29195	2668	1019	233611	6366	0	243664
29196	2079	228142	3877	3801	0	237899
29197	1760	229647	2279	2494	0	236180
29198	675	182548	459	742	0	184424
29199	575	182736	386	738	0	184435
29200	488	185622	511	795	0	187416
29201	171028	2205	676	1104	0	175013
29202	1825	1135	178597	344	0	181901
29203	852	179302	1527	428	0	182109
29204	839	1801	172913	226	0	175779
29205	645	179552	1498	381	0	182076
29206	2699	2494	929	135388	0	141510
29207	915	857	393	170503	0	172668
29208	395	177193	423	1819	0	179830
29209	171715	1509	408	1553	0	175185
29210	1564	1004	172139	448	0	175155
29211	736	176622	1411	439	0	179208
29212	636	1939	174106	327	0	177008
29213	926	994	1458	171257	0	174635
29214	1072	804	646	162569	0	165091
29215	670	173791	451	1667	0	176579
29216	857	1548	449	175799	0	178653
29217	892	880	308	175817	0	177897
29218	472	177077	571	1876	0	179996
29219	489	1848	174226	876	0	177439
29220	573	1080	169492	717	0	171862
29221	163002	758	1796	1220	0	166776
29222	175673	677	720	1004	0	178074
29223	2296	603	495	171794	0	175188
29224	1041	721	173437	1504	0	176703
29225	1066	625	1528	165980	0	169199
29226	585	178415	922	1821	0	181743
29227	578	1711	178659	933	0	181881
29228	443	175653	1630	863	0	178589
29229	527	1980	175486	610	0	178603
29230	399	177272	1691	663	0	180025
29231	175012	1854	716	1195	0	178777
29232	1729	1164	555	173496	0	176944
29233	1258	795	603	170128	0	172784
29234	706	817	174303	1748	0	177574
29235	900	773	165483	874	0	168030
29236	684	172302	1878	716	0	175580
29237	171304	1643	879	1351	0	175177
29238	1775	885	699	169280	0	172639
29239	794	856	172565	1693	0	175908
29240	698	960	162191	902	0	164751
29241	151869	703	2114	1407	0	156093
29242	161246	809	981	1225	0	164261
29243	1906	755	167067	450	0	170178
29244	1302	1168	1678	158652	0	162800
29245	790	165171	873	1451	0	168285
29246	165021	1592	576	1730	0	168919
29247	1505	165239	593	972	0	168309
29248	158454	1412	638	1282	0	161786
29249	1381	158457	585	547	0	160970
29250	662	161248	468	468	0	162846
29251	931	1684	427	160196	0	163238
29252	773	839	393	159940	0	161945
29253	370	160619	531	1715	0	163235
29254	496	1612	155711	719	0	158538
29255	645	934	149813	508	0	151900
29256	616	731	151786	404	0	153537
29257	142439	554	1852	1122	0	145967
29258	151125	494	833	1261	0	153713
29259	1456	159524	628	569	0	162177
29260	772	1969	156444	421	0	159606
29261	900	1092	1765	154797	0	158554
29262	434	884	164606	1931	0	167855
29263	445	858	167568	796	0	169667
29264	957	710	3053	181504	0	186224
29265	1017	615	1212	193837	0	196681
29266	386	651	212049	5015	0	218101
29267	200091	583	4226	3980	0	208880
29268	4333	220030	2642	1734	0	228739
29269	2334	232282	1865	1017	0	237498
29270	2436	6926	1117	224403	0	234882
29271	231520	3740	932	5483	0	241675
29272	5585	237333	850	2817	0	246585
29273	234938	6608	506	2858	0	244910
29274	6451	240162	708	1373	0	248694
29275	248505	7370	496	2175	0	258546
29276	7841	4060	247177	1056	0	260134
29277	4277	3022	251357	823	0	259479
29278	4457	2621	8133	239116	0	254327
29279	2116	1912	246071	5852	0	255951
29280	1762	231522	8031	3027	0	244342
29281	1637	233305	4455	1867	0	241264
29282	230897	8580	3104	1958	0	244539
29283	7186	4802	1986	221973	0	235947
29284	3328	234416	1861	5917	0	245522
29285	235855	7376	1394	3744	0	248369
29286	230961	4491	1234	2657	0	239343
29287	239383	2984	1110	1899	0	245376
29288	11818	2297	1078	229399	0	244592
29289	7420	1856	1008	235626	0	245910
29290	4265	1743	233443	8723	0	248174
29291	3100	1637	232986	4730	0	242453
29292	227605	1202	8847	3877	0	241531
29293	8693	1226	4851	227404	0	242174
29294	4398	1558	230254	7407	0	243617
29295	222242	1531	7594	5097	0	236464
29296	8052	235741	4602	2920	0	251315
29297	236732	6438	3194	3152	0	249516
29298	241169	3690	2172	2974	0	250005
29299	243258	2402	1958	2605	0	250223
29300	12397	1657	232485	1683	0	248222
29301	231547	1568	7120	1876	0	242111
29302	11555	3971	3860	218014	0	237400
29303	6578	218434	2987	6801	0	234800
29304	5142	234430	2485	3647	0	245704
29305	231603	8319	2533	3176	0	245631
29306	234649	4436	1970	2482	0	243537
29307	238252	2970	1557	2532	0	245311
29308	13312	2281	1529	226297	0	243419
29309	8737	2071	1424	230526	0	242758
29310	6774	2172	1213	224109	0	234268
29311	5011	226672	1376	10245	0	243304
29312	225209	6959	1297	6296	0	239761
29313	229655	3943	1147	4749	0	239494
29314	234115	3024	1388	3921	0	242448
29315	12964	2477	227265	2888	0	245594
29316	233469	2389	6667	3036	0	245561
29317	12589	2509	3492	217545	0	236135
29318	7795	227295	2504	6879	0	244473
29319	228411	7502	1707	4510	0	242130
29320	228609	3974	1794	3689	0	238066
29321	13336	3028	226841	2471	0	245676
29322	9103	2231	7203	219459	0	237996
29323	5859	228543	4050	8085	0	246537
29324	235660	7705	2823	5277	0	251465
29325	11265	4770	2168	233357	0	251560
29326	8010	3495	2158	231377	0	245040
29327	6779	2451	1856	237819	0	248905
29328	5797	2440	1752	244920	0	254909
29329	4810	2310	235986	13354	0	256460
29330	4513	236125	8073	7874	0	256585
29331	4931	8388	4036	238736	0	256091
29332	3861	5068	239713	10944	0	259586
29333	235380	3791	8551	7263	0	254985
29334	246045	2833	4852	5653	0	259383
29335	13283	2857	3956	242055	0	262151
29336	245414	2491	3079	10845	0	261829
29337	252449	2582	2626	7106	0	264763
29338	14582	2600	244874	4876	0	266932
29339	9365	244324	8563	4375	0	266627
29340	249477	8147	4685	4870	0	267179
29341	12696	4498	3802	247880	0	268876
29342	253617	3356	3122	10621	0	270716
29343	13458	2623	3300	249060	0	268441
29344	8807	3015	2696	255212	0	269730
29345	6960	2701	244475	12967	0	267103
29346	227631	2138	8645	9178	0	247592
29347	11800	247229	4679	6262	0	269970
29348	8239	8170	246156	5249	0	267814
29349	6472	248071	8806	5110	0	268459
29350	245877	9744	5021	4473	0	265115
29351	12769	5246	3762	243251	0	265028
29352	244256	3836	3127	10340	0	261559
29353	12234	242674	2954	6322	0	264184
29354	248854	9056	2556	5292	0	265758
29355	252992	4650	2286	4951	0	264879
29356	254611	3419	2120	4695	0	264845
29357	252873	2478	2122	4705	0	262178
29358	15906	243875	2207	4056	0	266044
29359	245302	8099	2409	3353	0	259163
29360	14799	4947	2179	236684	0	258609
29361	10673	4466	1596	234090	0	250825
29362	7973	216626	2015	10189	0	236803
29363	6767	216727	1695	6317	0	231506
29364	5915	210341	1291	3861	0	221408
29365	194736	7540	1638	3960	0	207874
29366	7447	175853	999	2663	0	186962
29367	4065	161135	944	1604	0	167748
29368	158032	4708	2889	2042	0	167671
29369	154406	2101	827	1790	0	159124
29370	5770	155523	776	1453	0	163522
29371	151915	3656	612	1750	0	157933
29372	5065	1942	145776	1249	0	154032
29373	141205	1610	2707	1719	0	147241
29374	4916	1395	144366	1442	0	152119
29375	2234	128668	2370	1105	0	134377
29376	1781	132126	1025	992	0	135924
29377	3309	3616	1581	126191	0	134697
29378	129313	1165	622	2580	0	133680
29379	131715	993	430	1528	0	134666
29380	133768	905	444	1475	0	136592
29381	133472	758	471	1463	0	136164
29382	131090	815	419	1408	0	133732
29383	3030	908	125780	972	0	130690
29384	1744	1203	120385	837	0	124169
29385	126200	905	1906	1191	0	130202
29386	2704	130320	893	865	0	134782
29387	128663	1768	747	1077	0	132255
29388	132148	1000	516	1153	0	134817
29389	136557	766	410	1291	0	139024
29390	136578	695	404	1299	0	138976
29391	136618	667	452	1308	0	139045
29392	2969	800	134505	834	0	139108
29393	137255	832	1700	1273	0	141060
29394	139201	782	820	1322	0	142125
29395	2961	1020	133186	979	0	138146
29396	127600	897	1368	1541	0	131406
29397	135855	904	830	1211	0	138800
29398	3115	935	141534	825	0	146409
29399	2288	874	138062	718	0	141942
29400	2069	143281	2079	666	0	148095
29401	2240	1963	967	144043	0	149213
29402	2060	1138	145252	1637	0	150087
29403	145083	899	1870	1297	0	149149
29404	3248	781	986	154161	0	159176
29405	2025	907	158382	1774	0	163088
29406	154307	833	1961	1478	0	158579
29407	159415	907	847	1264	0	162433
29408	160315	824	647	1203	0	162989
29409	3564	163422	530	894	0	168410
29410	2691	2061	518	160466	0	165736
29411	1964	163595	724	1927	0	168210
29412	164735	2199	673	1464	0	169071
29413	162065	1189	834	1315	0	165403
29414	3188	1067	160982	510	0	165747
29415	1730	154209	1796	464	0	158199
29416	1348	156191	843	439	0	158821
29417	1727	2064	633	153983	0	158407
29418	1771	1025	409	155199	0	158404
29419	154335	742	362	2244	0	157683
29420	2821	153457	383	804	0	157465
29421	1844	153367	309	505	0	156025
29422	1963	2009	151429	313	0	155714
29423	1414	154540	1504	339	0	157797
29424	151400	1798	679	1015	0	154892
29425	2418	986	149832	375	0	153611
29426	130791	600	1389	1143	0	133923
29427	1991	540	144606	321	0	147458
29428	122399	338	1303	1135	0	125175
29429	1478	147822	527	266	0	150093
29430	151349	1466	321	755	0	153891
29431	1938	678	155845	169	0	158630
29432	152608	387	1706	934	0	155635
29433	155331	277	710	921	0	157239
29434	2303	414	159465	117	0	162299
29435	157198	333	1579	816	0	159926
29436	164751	295	633	851	0	166530
29437	161451	298	386	883	0	163018
29438	2664	158948	342	186	0	162140
29439	161638	1812	336	882	0	164668
29440	2580	971	160972	203	0	164726
29441	1162	171606	1936	318	0	175022
29442	173880	2195	822	935	0	177832
29443	171139	802	485	917	0	173343
29444	174782	452	332	856	0	176422
29445	3364	173930	440	229	0	177963
29446	2170	2410	341	198807	0	203728
29447	1081	944	199063	3377	0	204465
29448	1647	502	3731	196905	0	202785
29449	902	538	204655	3978	0	210073
29450	193313	373	4342	2094	0	200122
29451	4540	205580	1528	785	0	212433
29452	2781	4168	736	199589	0	207274
29453	1266	208218	596	3519	0	213599
29454	1807	4648	481	208224	0	215160
29455	1736	1739	460	208352	0	212287
29456	886	214630	542	5379	0	221437
29457	1775	4866	380	214608	0	221629
29458	1789	1805	395	223369	0	227358
29459	830	223608	662	6106	0	231206
29460	761	232434	669	2544	0	236408
29461	1755	6376	716	227262	0	236109
29462	961	2436	228427	5500	0	237324
29463	852	231666	5395	2333	0	240246
29464	2169	5721	1743	228540	0	238173
29465	1205	2582	237558	5638	0	246983
29466	846	239945	5849	2601	0	249241
29467	235690	6465	1913	2694	0	246762
29468	6014	2732	236531	1432	0	246709
29469	231137	1647	6007	2228	0	241019
29470	7300	1584	2072	231252	0	242208
29471	3405	1404	1262	235248	0	241319
29472	2657	1337	898	237781	0	242673
29473	1248	1690	232035	8290	0	243263
29474	1252	1738	230549	3379	0	236918
29475	218348	1501	7332	3124	0	230305
29476	6991	1300	3048	229353	0	240692
29477	2524	1544	232143	6786	0	242997
29478	225733	1411	6477	3781	0	237402
29479	7513	1344	2757	228303	0	239917
29480	3893	1593	1892	230707	0	238085
29481	3200	1351	1491	229505	0	235547
29482	1812	229971	1687	8284	0	241754
29483	2684	6363	1274	221270	0	231591
29484	1639	223235	1395	7462	0	233731
29485	1389	234552	1328	3770	0	241039
29486	226640	7754	1283	3780	0	239457
29487	206948	3357	1732	4175	0	216212
29488	226778	2057	1606	2957	0	233398
29489	8149	221755	1560	2211	0	233675
29490	219770	6644	1277	3046	0	230737
29491	224111	2729	1513	2751	0	231104
29492	9163	1954	1416	216207	0	228740
29493	4396	1727	1364	220489	0	227976
29494	2574	1751	214172	8969	0	227466
29495	1871	216803	6422	4788	0	229884
29496	210331	6718	2707	3944	0	223700
29497	212606	3111	1951	3432	0	221100
29498	7722	211214	1602	2642	0	223180
29499	209575	7081	1402	3090	0	221148
29500	210784	3151	1117	3095	0	218147
29501	8936	2350	1205	204224	0	216715
29502	4270	199086	1470	7117	0	211943
29503	2872	209572	1302	3694	0	217440
29504	202549	7622	1207	3547	0	214925
29505	7932	3565	1034	198806	0	211337
29506	3412	2649	196187	7628	0	209876
29507	190171	2128	5991	4820	0	203110
29508	7023	2279	199560	3245	0	212107
29509	3373	196923	6581	2734	0	209611
29510	195745	6776	2608	3320	0	208449
29511	7467	3424	196027	2748	0	209666
29512	4142	2909	6306	197425	0	210782
29513	2953	2562	204041	7562	0	217118
29514	2620	205400	6827	4098	0	218945
29515	3189	7100	2898	206011	0	219198
29516	2516	3719	205003	7660	0	218898
29517	192464	3033	6446	4854	0	206797
29518	6984	208623	2836	3457	0	221900
29519	4205	6828	2090	199180	0	212303
29520	2697	209640	2181	7330	0	221848
29521	206013	7474	1873	4278	0	219638
29522	205760	3772	1788	4095	0	215415
29523	7709	206381	2185	3429	0	219704
29524	4620	7219	2099	199771	0	213709
29525	2950	207740	2042	6906	0	219638
29526	204917	7194	2066	4575	0	218752
29527	7244	3798	204135	3238	0	218415
29528	3709	3425	200488	2689	0	210311
29529	2982	196669	6866	2813	0	209330
29530	2449	199599	3670	2466	0	208184
29531	2949	7098	2560	193176	0	205783
29532	191831	3434	1972	6601	0	203838
29533	194337	2380	1955	3647	0	202319
29534	189696	2088	1583	3274	0	196641
29535	7818	196558	1933	2615	0	208924
29536	4427	5294	1646	189995	0	201362
29537	3298	195476	1560	5623	0	205957
29538	195177	5810	1680	3525	0	206192
29539	6777	2764	1511	192876	0	203928
29540	3536	1991	188376	5836	0	199739
29541	2465	185193	5015	3264	0	195937
29542	181509	4932	2546	2661	0	191648
29543	5485	2778	181940	1829	0	192032
29544	175156	2440	4298	2565	0	184459
29545	5696	179357	1903	2240	0	189196
29546	1984	158253	739	1042	0	162018
29547	154254	3348	741	1279	0	159622
29548	3290	159825	628	895	0	164638
29549	153739	2814	608	1142	0	158303
29550	2763	155775	516	757	0	159811
29551	156427	2735	689	1123	0	160974
29552	156134	1309	599	1000	0	159042
29553	3199	1106	160424	592	0	165321
29554	1522	988	153234	430	0	156174
29555	1095	156710	2154	497	0	160456
29556	153136	1996	1335	871	0	157338
29557	2137	886	149684	343	0	153050
29558	139492	660	1612	609	0	142373
29559	1845	951	710	140889	0	144395
29560	745	509	144872	1060	0	147186
29561	748	469	134988	449	0	136654
29562	633	470	145511	259	0	146873
29563	399	147249	1311	248	0	149207
29564	1470	2508	1247	142082	0	147307
29565	139484	188	215	895	0	140782
29566	716	118	108	141358	0	142300
29567	142415	70	155	930	0	143570
29568	830	98	116	143476	0	144520
29569	145987	100	82	1395	0	147564
29570	144841	187	154	1371	0	146553
29571	165411	95	129	928	0	166563
29572	1688	170518	142	182	0	172530
29573	671	1665	173235	105	0	175676
29574	737	551	1637	173050	0	175975
29575	4831	1875	2457	98980	0	108143
29576	595	189	289	179159	0	180232
29577	790	199	156	174483	0	175628
29578	368	173295	236	2598	0	176497
29579	334	1992	170427	1006	0	173759
29580	232	174177	1984	651	0	177044
29581	1166	2302	717	163018	0	167203
29582	529	843	338	176438	0	178148
29583	551	425	185	177616	0	178777
29584	670	337	175	175945	0	177127
29585	245	172125	263	2914	0	175547
29586	232	174337	478	1182	0	176229
29587	261	2670	170559	747	0	174237
29588	667	998	2006	170298	0	173969
29589	657	596	707	173025	0	174985
29590	514	417	360	179294	0	180585
29591	178471	501	237	3969	0	183178
29592	2234	180072	415	1382	0	184103
29593	953	2675	178287	693	0	182608
29594	176748	919	2320	1235	0	181222
29595	2621	580	759	181812	0	185772
29596	185357	411	396	3541	0	189705
29597	2893	398	252	187226	0	190769
29598	188428	496	282	3436	0	192642
29599	2967	602	290	188567	0	192426
29600	186823	361	531	3467	0	191182
29601	2937	496	192427	1247	0	197107
29602	1700	321	2215	190476	0	194712
29603	899	197730	917	2625	0	202171
29604	1180	2401	473	202688	0	206742
29605	200245	1086	325	3704	0	205360
29606	2724	200912	557	1434	0	205627
29607	1818	2779	339	209049	0	213985
29608	776	208873	505	3153	0	213307
29609	1257	3210	296	212129	0	216892
29610	1087	1334	234	213553	0	216208
29611	833	826	209874	4134	0	215667
29612	1319	543	2942	203481	0	208285
29613	694	677	202714	3699	0	207784
29614	471	200076	3467	2027	0	206041
29615	198543	3160	1200	1961	0	204864
29616	3238	1344	199644	1007	0	205233
29617	191518	744	3313	1816	0	197391
29618	205696	531	1308	1572	0	209107
29619	4531	630	851	207083	0	213095
29620	1568	671	214227	3750	0	220216
29621	202925	711	3740	2600	0	209976
29622	223314	445	1513	2086	0	227358
29623	5306	461	983	218739	0	225489
29624	2715	401	743	221315	0	225174
29625	1445	221766	616	5303	0	229130
29626	1506	3806	767	220522	0	226601
29627	867	223635	757	4660	0	229919
29628	1087	4252	221564	2165	0	229068
29629	1360	1704	3624	218428	0	225116
29630	214263	916	1434	5297	0	221910
29631	216960	667	804	2949	0	221380
29632	4614	218126	607	1848	0	225195
29633	2399	3814	603	220974	0	227790
29634	221151	1534	539	5108	0	228332
29635	4220	213545	668	2279	0	220712
29636	214741	4097	353	2405	0	221596
29637	5298	1638	355	223211	0	230502
29638	232451	1271	406	5645	0	239773
29639	5406	1262	249929	2340	0	258937
29640	2182	252274	5609	1846	0	261911
29641	248996	5860	1947	2517	0	259320
29642	5856	258880	1335	1705	0	267776
29643	261572	6465	816	2150	0	271003
29644	267688	2295	564	2248	0	272795
29645	8518	1806	265148	1103	0	276575
29646	4781	1205	6183	258683	0	270852
29647	268854	1146	2072	7430	0	279502
29648	7364	1230	263870	2687	0	275151
29649	262982	1068	6570	2493	0	273113
29650	8667	1074	2087	264630	0	276458
29651	3631	1017	263785	6913	0	275346
29652	3386	892	6763	258553	0	269594
29653	255370	888	2510	8402	0	267170
29654	7555	1030	262927	3101	0	274613
29655	4321	1105	6676	261873	0	273975
29656	3676	932	2445	267088	0	274141
29657	267063	789	1830	9427	0	279109
29658	266751	661	1708	4753	0	273873
29659	8756	270408	1490	3241	0	283895
29660	5276	6324	1357	268922	0	281879
29661	4023	2309	1580	271199	0	279111
29662	3557	1688	1284	269842	0	276371
29663	262996	1080	1322	10330	0	275728
29664	265622	1049	1367	4976	0	273014
29665	10152	1060	1148	261139	0	273499
29666	4857	257070	1259	7889	0	271075
29667	4455	6294	1372	253086	0	265207
29668	3011	260658	1373	7735	0	272777
29669	254322	6818	1162	5150	0	267452
29670	8025	250913	1368	3427	0	263733
29671	234304	5682	1120	2940	0	244046
29672	8321	2330	1139	229908	0	241698
29673	228059	1614	1302	6996	0	237971
29674	7495	1416	226265	3520	0	238696
29675	3833	231488	5458	3262	0	244041
29676	230034	5628	2739	3456	0	241857
29677	234317	2183	1693	3076	0	241269
29678	8497	1690	1338	226219	0	237744
29679	4303	229836	1402	6416	0	241957
29680	4147	5320	1135	238380	0	248982
29681	3633	2209	1141	240332	0	247315
29682	3498	1711	1274	240008	0	246491
29683	236675	1468	1063	9225	0	248431
29684	238518	1382	1110	5235	0	246245
29685	8742	1479	923	234850	0	245994
29686	4808	236509	839	6975	0	249131
29687	239889	5305	885	4696	0	250775
29688	7392	2522	235828	3477	0	249219
29689	4673	2154	4842	238506	0	250175
29690	3605	1935	239024	7193	0	251757
29691	3966	1537	5324	238202	0	249029
29692	3138	1754	242364	7659	0	254915
29693	3762	1603	5526	240673	0	251564
29694	240966	1715	2249	8475	0	253405
29695	242140	1707	1596	5039	0	250482
29696	8208	235945	1410	3387	0	248950
29697	242060	5721	1149	3697	0	252627
29698	8401	2699	1281	238608	0	250989
29699	5152	2197	1214	243585	0	252148
29700	242246	1858	1568	8744	0	254416
29701	7942	1856	234100	4536	0	248434
29702	4809	1730	232339	3739	0	242617
29703	4169	1892	231827	3435	0	241323
29704	224007	1544	6568	4114	0	236233
29705	7716	1524	235749	3166	0	248155
29706	4610	1518	225426	3339	0	234893
29707	215141	1421	6409	3838	0	226809
29708	6937	228229	3167	3288	0	241621
29709	4497	4766	2299	232058	0	243620
29710	4047	2213	1964	237295	0	245519
29711	3242	1685	237317	7546	0	249790
29712	230331	1341	5513	5383	0	242568
29713	235758	1090	2871	4746	0	244465
29714	227223	1210	2512	4563	0	235508
29715	7633	1146	236542	3343	0	248664
29716	224706	1126	5581	4313	0	235726
29717	7514	1284	230169	3320	0	242287
29718	4326	224852	5396	3350	0	237924
29719	3612	230312	2750	3168	0	239842
29720	219029	4852	2073	3500	0	229454
29721	5941	216075	1975	2820	0	226811
29722	3548	218254	1634	2740	0	226176
29723	214357	4753	1791	3330	0	224231
29724	5800	217216	1883	2518	0	227417
29725	215956	4618	1820	2913	0	225307
29726	6764	2105	1589	220445	0	230903
29727	4100	1845	1639	223115	0	230699
29728	3676	1647	1657	224509	0	231489
29729	3179	1848	1772	220248	0	227047
29730	2756	220455	1856	6251	0	231318
29731	224229	4644	1731	3937	0	234541
29732	6139	242665	1836	2716	0	253356
29733	3718	252419	1860	2710	0	260707
29734	3407	7191	260623	2093	0	273314
29735	246938	2600	7337	3298	0	260173
29736	8717	2066	273896	2122	0	286801
29737	4178	1435	281188	1876	0	288677
29738	2518	270854	9000	1991	0	284363
29739	1177	276059	3045	1024	0	281305
29740	271954	8660	2251	2521	0	285386
29741	7027	290376	1327	1155	0	299885
29742	3327	8715	286009	768	0	298819
29743	1919	283580	7772	821	0	294092
29744	1477	8726	286455	447	0	297105
29745	1299	3784	283204	322	0	288609
29746	262869	2657	10689	1345	0	277560
29747	7502	1775	279458	352	0	289087
29748	4795	1343	9471	266027	0	281636
29749	264848	957	4673	8205	0	278683
29750	7211	266818	3411	3239	0	280679
29751	3507	7218	271020	1653	0	283398
29752	262531	2942	8589	2082	0	276144
29753	9356	1935	3718	252749	0	267758
29754	3987	251082	2546	6558	0	264173
29755	2298	7336	259166	3035	0	271835
29756	250319	3085	8326	2612	0	264342
29757	8356	2024	260770	965	0	272115
29758	5065	1231	9206	252774	0	268276
29759	2421	1227	254867	7290	0	265805
29760	3326	794	9551	249253	0	262924
29761	244960	742	4376	10072	0	260150
29762	7358	253160	3239	3965	0	267722
29763	255099	7503	1999	3417	0	268018
29764	9190	3470	254479	1453	0	268592
29765	5561	1941	8503	254752	0	270757
29766	2953	1429	262237	7923	0	274542
29767	250215	1356	9646	4429	0	265646
29768	259428	1059	4484	3460	0	268431
29769	10579	260357	3423	1565	0	275924
29770	263030	8010	2257	2328	0	275625
29771	268101	3374	2222	1944	0	275641
29772	13443	2084	1733	256748	0	274008
29773	6076	1726	258526	7833	0	274161
29774	3809	248433	8461	3735	0	264438
29775	4452	8200	3656	249234	0	265542
29776	252290	3755	2411	9179	0	267635
29777	9378	2529	249789	3799	0	265495
29778	4555	1817	252755	2355	0	261482
29779	2983	1724	249295	1744	0	255746
29780	236877	1379	12673	2468	0	253397
29781	9683	1399	246655	1169	0	258906
29782	236581	1352	11466	1810	0	251209
29783	10375	1446	231107	1109	0	244037
29784	5225	236869	10638	924	0	253656
29785	4509	8124	5437	232097	0	250167
29786	2796	3710	238165	7827	0	252498
29787	2563	228372	10409	3447	0	244791
29788	2076	237818	5418	2364	0	247676
29789	2759	11170	3734	231714	0	249377
29790	229432	5284	2997	9272	0	246985
29791	9473	3416	2999	231624	0	247512
29792	226084	2876	2613	10307	0	241880
29793	10914	2456	2342	225959	0	241671
29794	5179	2246	224179	10044	0	241648
29795	4052	2000	226784	4856	0	237692
29796	215941	1527	12204	4288	0	233960
29797	223377	1457	6489	3369	0	234692
29798	12265	1650	217819	2481	0	234215
29799	211985	1552	10861	2722	0	227120
29800	11652	1985	216291	1594	0	231522
29801	6576	203427	11456	1424	0	222883
29802	4954	207609	6261	1459	0	220283
29803	4076	208359	4936	1547	0	218918
29804	4358	11935	3820	198874	0	218987
29805	198579	5776	3683	8966	0	217004
29806	204213	4042	3453	4431	0	216139
29807	12852	3227	3070	198320	0	217469
29808	6660	3099	189856	9127	0	208742
29809	5126	2565	9939	189573	0	207203
29810	4263	2216	189917	10191	0	206587
29811	4225	1847	11424	184872	0	202368
29812	181061	1486	6456	11286	0	200289
29813	188509	1429	4999	5645	0	200582
29814	188941	1393	4306	4326	0	198966
29815	190411	1552	3788	3315	0	199066
29816	14788	1504	3341	178007	0	197640
29817	8634	1383	3087	185320	0	198424
29818	181248	1393	2923	12117	0	197681
29819	187504	1448	2591	6104	0	197647
29820	14548	1413	2529	178956	0	197446
29821	8350	1414	2435	184507	0	196706
29822	6092	1346	2255	183828	0	193521
29823	5277	1379	2231	185635	0	194522
29824	175986	1319	2404	14471	0	194180
29825	10626	1309	171786	7913	0	191634
29826	6570	1131	8973	168926	0	185600
29827	167330	1069	4704	11295	0	184398
29828	10688	1107	163660	6457	0	181912
29829	7423	1118	9390	163748	0	181679
29830	5068	1013	164483	10101	0	180665
29831	4118	151080	10435	7140	0	172773
29832	4820	5956	5392	131837	0	148005
29833	122932	2584	3902	7035	0	136453
29834	6928	3528	2907	107426	0	120789
29835	4250	102120	2584	6802	0	115756
29836	3215	94313	2047	3750	0	103325
29837	2322	74487	1320	2535	0	80664
29838	2266	70533	1444	1790	0	76033
29839	38518	5539	5068	3703	0	52828
29840	2905	1677	1242	26924	0	32748
29841	648	226	22298	1120	0	24292
29842	563	171	974	20667	0	22375
29843	572	145	20307	1084	0	22108
29844	20343	141	906	586	0	21976
29845	1240	151	384	20109	0	21884
29846	785	147	287	20652	0	21871
29847	628	176	297	20635	0	21736
29848	511	193	237	20869	0	21810
29849	20035	257	184	1213	0	21689
29850	20544	227	178	683	0	21632
29851	1152	188	209	20045	0	21594
29852	19505	193	208	1174	0	21080
29853	967	160	18925	772	0	20824
29854	456	18652	753	791	0	20652
29855	570	628	362	18854	0	20414
29856	488	182	397	18623	0	19690
29857	376	18151	287	1185	0	19999
29858	508	593	274	18160	0	19535
29859	413	507	325	18194	0	19439
29860	17723	102	293	1157	0	19275
29861	872	114	16519	517	0	18022
29862	367	155	15156	432	0	16110
29863	14580	108	677	477	0	15842
29864	774	103	13767	295	0	14939
29865	6372	114	646	166	0	7298
29866	5387	53	237	164	0	5841
29867	385	142	127	3964	0	4618
29868	96	46	3048	164	0	3354
29869	2222	44	123	80	0	2469
29870	131	2185	58	51	0	2425
29871	1013	145	233	64	0	1455
29872	621	39	104	70	0	834
29873	290	8	13	8	0	319
29874	251	1	2	8	0	262
29875	214	7	7	8	0	236
29876	209	1	7	3	0	220
29877	204	9	2	10	0	225
29878	191	2	2	8	0	203
29879	208	1	3	3	0	215
29880	196	3	3	4	0	206
29881	184	0	3	4	0	191
29882	172	2	1	3	0	178
29883	175	0	3	6	0	184
29884	166	1	1	4	0	172
29885	156	1	5	4	0	166
29886	173	6	1	0	0	180
29887	150	4	1	3	0	158
29888	157	3	0	5	0	165
29889	150	2	0	5	0	157
29890	158	1	2	7	0	168
29891	136	1	0	8	0	145
29892	149	1	3	3	0	156
29893	152	1	0	4	0	157
29894	156	1	1	1	0	159
29895	155	0	0	2	0	157
29896	150	0	1	4	0	155
29897	140	0	3	4	0	147
29898	125	0	6	2	0	133
29899	154	0	0	2	0	156
29900	150	0	3	2	0	155
29901	141	0	0	1	0	142
29902	125	0	5	2	0	132
29903	100	1	19	1	0	121
29904	1	0	1	1	0	3
29905	0	1	0	1	0	2
29906	0	1	0	1	0	2
29907	0	0	0	2	0	2
29908	0	0	0	1	0	1
29909	1	0	0	1	0	2
29910	0	0	1	1	0	2
29911	1	0	1	0	0	2
29912	1	0	1	0	0	2
29913	0	0	2	0	0	2
29914	2	0	0	0	0	2
